sha,is_bug,committer_name,commit_time,parents,all_del,all_add,all_change_lines,all_lines,files_change_nums,dmm_unit_size,dmm_unit_complexity,dmm_unit_interfacing,file_nums
97eb7fae8786e0beecf6b00863e4c7d5746fdff0,1,Suresh Marru,2011-07-09 19:21:43+00:00,[],0,171082,171082,171082,974,0.389244956,0.641661363,0.843425746,974
fbe4b54a7472ef9f5f059cc17eb0376f850de383,0,Suresh Marru,2011-07-09 19:57:14+00:00,['97eb7fae8786e0beecf6b00863e4c7d5746fdff0'],3,34,37,171119,1,,,,974
894139230ecd4b80be605037f7785fc1deabdd08,0,Suresh Marru,2011-07-11 20:56:39+00:00,['fbe4b54a7472ef9f5f059cc17eb0376f850de383'],63,27,90,171209,4,,,,974
8118f98dd87aa358939fd46b46bfeb434a19b2d1,0,Suresh Marru,2011-07-11 21:10:36+00:00,['894139230ecd4b80be605037f7785fc1deabdd08'],21,40979,41000,212209,531,0.530407062,0.789602746,0.92177538,1500
87abdfbec7edeb848169b52aa1c927a34a0f1619,0,Nanayakkara Kuruppuge Thilena Gunarathne,2011-07-12 18:12:59+00:00,['8118f98dd87aa358939fd46b46bfeb434a19b2d1'],54,54,108,212317,28,,,,1500
0ffd5d7d0687383649e8535cbd37074d3a10a467,0,Nanayakkara Kuruppuge Thilena Gunarathne,2011-07-12 18:40:02+00:00,['87abdfbec7edeb848169b52aa1c927a34a0f1619'],3,3,6,212323,3,,,,1500
0e5d49861cb0e1dd167e7c6b7d90f2ab6f7a5e6f,1,Suresh Marru,2011-07-15 15:47:29+00:00,['0ffd5d7d0687383649e8535cbd37074d3a10a467'],637,823,1460,213783,58,0,0,1,1505
2039fda011c5f4b774902ebfd0769ef17a09431b,0,Suresh Marru,2011-07-15 16:03:32+00:00,['0e5d49861cb0e1dd167e7c6b7d90f2ab6f7a5e6f'],0,41,41,213824,2,,,,1506
ab91258fd45c21b9da5976f1de6d66c53b0016b3,0,Suresh Marru,2011-07-15 16:05:58+00:00,['2039fda011c5f4b774902ebfd0769ef17a09431b'],0,0,0,213824,3,,,,1506
5cddbb7b37ca9de2b219673cbd096fdf6a2988d6,0,Suresh Marru,2011-07-15 16:08:21+00:00,['ab91258fd45c21b9da5976f1de6d66c53b0016b3'],0,0,0,213824,1,,,,1506
45b7bf4fc47c5523c212f9709e3cc500082d0adc,1,Suresh Marru,2011-07-15 16:19:05+00:00,['5cddbb7b37ca9de2b219673cbd096fdf6a2988d6'],0,40,40,213864,2,,,,1507
c91ddf581c57f6e12bd1758f7002db99d3c70ceb,0,Suresh Marru,2011-07-15 18:50:43+00:00,['45b7bf4fc47c5523c212f9709e3cc500082d0adc'],15,10,25,213889,8,,,,1507
71aa33833ac8435477cf3d5862a6f0fc5fa77f1a,0,Alek Slominski,2011-07-15 19:11:38+00:00,['c91ddf581c57f6e12bd1758f7002db99d3c70ceb'],2,1,3,213892,1,,,,1507
c507033cb807650498697edb28384e2e26314817,0,Suresh Marru,2011-07-15 21:26:32+00:00,['71aa33833ac8435477cf3d5862a6f0fc5fa77f1a'],24,27,51,213943,7,1,0,0,1507
1e7d5ef6c890c02f34be469ae6e52a8c24e6bade,0,Alek Slominski,2011-07-20 15:30:36+00:00,['c507033cb807650498697edb28384e2e26314817'],111,275,386,214329,13,,,,1509
63fd0127aa42877f78573269a832974e9bc842ff,0,Alek Slominski,2011-07-20 15:30:45+00:00,['1e7d5ef6c890c02f34be469ae6e52a8c24e6bade'],0,0,0,214329,0,,,,1509
36b2ea4d81c8fa1949f59666d911836b7ad165f4,0,Nanayakkara Kuruppuge Thilena Gunarathne,2011-07-22 19:58:49+00:00,['63fd0127aa42877f78573269a832974e9bc842ff'],39389,125,39514,253843,535,0.469722971,0.210345673,0.078205443,1510
67031fad671d452a2153ead3244c7f2d56bf6c0b,0,Raminderjeet Singh,2011-07-25 14:30:48+00:00,['36b2ea4d81c8fa1949f59666d911836b7ad165f4'],0,127,127,253970,1,,,,1511
d1310afff6ad993905ca9b69057aeaab62a313ee,0,Raminderjeet Singh,2011-07-25 14:31:43+00:00,['67031fad671d452a2153ead3244c7f2d56bf6c0b'],4,4,8,253978,1,,,,1511
27b217d5b4c212c738d6f2d9d401afa9825fd10c,0,Suresh Marru,2011-07-25 16:42:07+00:00,['d1310afff6ad993905ca9b69057aeaab62a313ee'],453,0,453,254431,27,,,,1511
e7bd1ac59f64292590e538f6e5d624b73a32a8df,0,Nanayakkara Kuruppuge Thilena Gunarathne,2011-07-27 14:04:13+00:00,['27b217d5b4c212c738d6f2d9d401afa9825fd10c'],51,323,374,254805,29,,,,1513
f7b114ae378605dec42ba1c846b353016f41f40c,0,Nanayakkara Kuruppuge Thilena Gunarathne,2011-07-27 14:14:54+00:00,['e7bd1ac59f64292590e538f6e5d624b73a32a8df'],3,2,5,254810,1,,,,1513
5a5a9672d38aa58287310aad82627b467fff1d25,0,Raminderjeet Singh,2011-07-27 17:44:02+00:00,['f7b114ae378605dec42ba1c846b353016f41f40c'],200,328,528,255338,1,0,0,0.432432432,1513
7c7ff0d5b6927daac4c4f2c051433050543659f1,0,Suresh Marru,2011-07-30 22:22:12+00:00,['5a5a9672d38aa58287310aad82627b467fff1d25'],69,36,105,255443,10,,,,1513
c01dcc6b0ea2caac10b68a602d972893a0f5efa2,0,Suresh Marru,2011-07-31 05:26:35+00:00,['7c7ff0d5b6927daac4c4f2c051433050543659f1'],3010,171,3181,258624,67,,,,1513
c652c626749ca46142f24318cdd9742825698da6,0,Suresh Marru,2011-07-31 17:46:05+00:00,['c01dcc6b0ea2caac10b68a602d972893a0f5efa2'],4781,262,5043,263667,90,,,,1513
05c6b9fc4d73d68af4607c231b59333978d36e6e,0,Raminderjeet Singh,2011-07-31 18:21:58+00:00,['c652c626749ca46142f24318cdd9742825698da6'],834,1067,1901,265568,10,0,0.277108434,0.969879518,1513
672f2d3f46ec9e279ba5d066b110ad59c0f72e5d,0,Raminderjeet Singh,2011-07-31 18:22:25+00:00,['05c6b9fc4d73d68af4607c231b59333978d36e6e'],0,111,111,265679,1,,,,1514
3dab8adf92314b7f899cbf7f8e296d867d0deca5,0,Raminderjeet Singh,2011-07-31 18:31:34+00:00,['672f2d3f46ec9e279ba5d066b110ad59c0f72e5d'],19,0,19,265698,1,,,,1514
d7f92d4cdf47252623dc512ba9aeef0432bdc5e4,0,Suresh Marru,2011-08-01 01:02:57+00:00,['3dab8adf92314b7f899cbf7f8e296d867d0deca5'],64,11,75,265773,5,0,0,0,1514
8ad130756e5851565fae45597e80d32ccfbe7f7d,0,Suresh Marru,2011-08-01 02:36:48+00:00,['d7f92d4cdf47252623dc512ba9aeef0432bdc5e4'],4220,282,4502,270275,42,0.704314721,0.384517766,0.112944162,1514
8bef7380a104c753a0f96b874fce76ba6e537e5c,0,Suresh Marru,2011-08-01 02:38:12+00:00,['8ad130756e5851565fae45597e80d32ccfbe7f7d'],0,0,0,270275,0,,,,1514
babf944e4eb5ccc51e52ec37407697b6e10a09c7,0,Suresh Marru,2011-08-01 02:48:21+00:00,['8bef7380a104c753a0f96b874fce76ba6e537e5c'],6,3,9,270284,1,,,,1514
a58790271ecfa4900bd210b8e931c7200633f3f8,0,Raminderjeet Singh,2011-08-01 13:59:00+00:00,['babf944e4eb5ccc51e52ec37407697b6e10a09c7'],2,15,17,270301,2,,,,1514
f85dfeb6d2ca85a9e3bfa761b0ef43e8aac31735,0,Lahiru Gunathilake,2011-08-01 19:48:27+00:00,['a58790271ecfa4900bd210b8e931c7200633f3f8'],2,6,8,270309,1,0,0,1,1514
702ac578cd9552ad14077e7f1e8286b81f598e68,0,Lahiru Gunathilake,2011-08-01 20:14:36+00:00,['f85dfeb6d2ca85a9e3bfa761b0ef43e8aac31735'],2521,344,2865,273174,29,0.545202952,0.25,0.328413284,1515
5c7e33cb34f984026fcc9ae62c74188ce143b4d9,0,Lahiru Gunathilake,2011-08-01 21:18:39+00:00,['702ac578cd9552ad14077e7f1e8286b81f598e68'],96,86,182,273356,60,,,,1518
1e6b1e3519123e764191c7cd6fea4ce0debfe9a7,0,Suresh Marru,2011-08-02 23:52:12+00:00,['5c7e33cb34f984026fcc9ae62c74188ce143b4d9'],0,0,0,273356,942,,,,1518
e0ae8d688c69917628d808311a204371bda41896,0,Suresh Marru,2011-08-03 00:25:07+00:00,['1e6b1e3519123e764191c7cd6fea4ce0debfe9a7'],0,0,0,273356,0,,,,1518
afd863a84630ecd56c25b8cd7b00e8383346f683,0,Suresh Marru,2011-08-03 02:11:17+00:00,['e0ae8d688c69917628d808311a204371bda41896'],6,6,12,273368,1,,,,1518
0e458ccb650a078f8a46c87d8ebf8eb2f03773ad,0,Suresh Marru,2011-08-03 14:31:40+00:00,['afd863a84630ecd56c25b8cd7b00e8383346f683'],1,0,1,273369,1,,,,1518
278b9e7fa6637020418ba17afeffb8267456ae3d,0,Suresh Marru,2011-08-03 14:47:40+00:00,['0e458ccb650a078f8a46c87d8ebf8eb2f03773ad'],0,574,574,273943,1,,,,1519
2d98c105ab8869be78bc9b65b34163e2c9a2ae9f,0,Suresh Marru,2011-08-03 14:48:23+00:00,['278b9e7fa6637020418ba17afeffb8267456ae3d'],0,0,0,273943,87,,,,1519
6f4cddb561eea822d8e8c02b96c649833a2e25aa,0,Suresh Marru,2011-08-03 19:47:35+00:00,['2d98c105ab8869be78bc9b65b34163e2c9a2ae9f'],0,817,817,274760,9,,,,1528
cbf336ee35ae970464d5a76045855de94bf7ce9b,1,Suresh Marru,2011-08-05 12:22:03+00:00,['6f4cddb561eea822d8e8c02b96c649833a2e25aa'],0,878,878,275638,9,1,1,1,1537
2a3bc800a384ed7dc484a88ba09d8f601b2b49d7,0,Lahiru Gunathilake,2011-08-05 16:47:44+00:00,['cbf336ee35ae970464d5a76045855de94bf7ce9b'],15,18,33,275671,7,1,1,1,1537
3f3858dd793308134ec39860c5893eb7b1237284,0,Suresh Marru,2011-08-05 17:34:26+00:00,['2a3bc800a384ed7dc484a88ba09d8f601b2b49d7'],462,7,469,276140,9,0,0,0,1537
0c18b326dd49694a4f8940c4763378b638b54be1,0,Suresh Marru,2011-08-06 00:32:54+00:00,['3f3858dd793308134ec39860c5893eb7b1237284'],525,680,1205,277345,31,1,1,0.884615385,1548
f533fd0cd060847021441aeb9a46c7da521692ec,0,Suresh Marru,2011-08-07 14:30:33+00:00,['0c18b326dd49694a4f8940c4763378b638b54be1'],468,0,468,277813,6,0.553763441,0.204301075,0.209677419,1548
b9c7941f280995426f7f5c5ef96cc0a43f524731,0,Suresh Marru,2011-08-07 15:46:57+00:00,['f533fd0cd060847021441aeb9a46c7da521692ec'],0,0,0,277813,87,,,,1548
946e50fe9dd1720b13f6692fbea8be150287d6fe,0,Suresh Marru,2011-08-07 19:53:01+00:00,['b9c7941f280995426f7f5c5ef96cc0a43f524731'],429,50,479,278292,17,0.09375,0,0.625,1548
cecf6a7ae6e1c39827a1dfe0fddacce099d37e37,0,Lahiru Gunathilake,2011-08-08 15:24:40+00:00,['946e50fe9dd1720b13f6692fbea8be150287d6fe'],86,115,201,278493,14,1,1,0.888888889,1548
06fa205d1775d914492fc09e58e88d332dd13e8c,0,Lahiru Gunathilake,2011-08-09 14:54:05+00:00,['cecf6a7ae6e1c39827a1dfe0fddacce099d37e37'],38,194,232,278725,7,,,,1549
a243aa54559edf73388b39752c2d00ec7733da07,1,Suresh Marru,2011-08-09 17:35:09+00:00,['06fa205d1775d914492fc09e58e88d332dd13e8c'],193,152,345,279070,13,1,1,0,1549
d71b6b74782afbefc6f6a0451d849b03cac0859e,1,Suresh Marru,2011-08-10 19:10:46+00:00,['a243aa54559edf73388b39752c2d00ec7733da07'],0,499,499,279569,4,0.265765766,1,0.81981982,1552
5d76fd3d09c8ae03e1e80d68d2ff52b3694e10e6,1,Suresh Marru,2011-08-10 19:53:21+00:00,['d71b6b74782afbefc6f6a0451d849b03cac0859e'],0,469,469,280038,3,0.265765766,1,0.81981982,1552
1c8ad94e85cc743fc4de583495cedca999a72d03,0,Lahiru Gunathilake,2011-08-11 14:00:30+00:00,['5d76fd3d09c8ae03e1e80d68d2ff52b3694e10e6'],1,1,2,280040,1,,,,1552
517496051fa3c8150c800599bad96423ad28eba1,1,Raminderjeet Singh,2011-08-11 20:33:38+00:00,['1c8ad94e85cc743fc4de583495cedca999a72d03'],817,417,1234,281274,12,0.504807692,0,0.1875,1552
91f784f1bb98558cdbca1033f0574d817cecfdf4,0,Raminderjeet Singh,2011-08-11 22:28:55+00:00,['517496051fa3c8150c800599bad96423ad28eba1'],8,8,16,281290,1,,,,1552
9380481a5f6660180a915fba3dc59b283c39a9a7,0,Lahiru Gunathilake,2011-08-12 03:25:19+00:00,['91f784f1bb98558cdbca1033f0574d817cecfdf4'],16,335,351,281641,9,0.47826087,0.47826087,1,1557
80c4d53da7aacd8745c46fec5e08c14869b744c7,0,Suresh Marru,2011-08-12 17:00:56+00:00,['9380481a5f6660180a915fba3dc59b283c39a9a7'],404,121,525,282166,2,,,,1557
1cc035fffa315a83514ffb3fa04e20276d5d314c,0,Suresh Marru,2011-08-12 21:26:05+00:00,['80c4d53da7aacd8745c46fec5e08c14869b744c7'],13,77,90,282256,7,,,,1557
1800caf6d32e96debee1422dd7d902d2614fcdb3,0,Lahiru Gunathilake,2011-08-12 21:35:21+00:00,['1cc035fffa315a83514ffb3fa04e20276d5d314c'],10,39,49,282305,2,0,0,1,1558
66922e7fed822cc0c66c2725c96ed0bc896a0015,0,Lahiru Gunathilake,2011-08-12 21:36:10+00:00,['1800caf6d32e96debee1422dd7d902d2614fcdb3'],88,204,292,282597,4,0.107692308,1,1,1559
a8b01f82b9a7849336ce553852ff7417b3a9d81c,0,Raminderjeet Singh,2011-08-15 17:24:09+00:00,['66922e7fed822cc0c66c2725c96ed0bc896a0015'],21,237,258,282855,6,0,0.189655172,0.00862069,1559
035787cacc5a24128f1245f1c5c7d7f274fa644c,0,Raminderjeet Singh,2011-08-15 17:30:50+00:00,['a8b01f82b9a7849336ce553852ff7417b3a9d81c'],0,43,43,282898,1,1,1,1,1560
c605e76fc825477fdba115575d8ab3f3170eeb6d,0,Raminderjeet Singh,2011-08-15 17:33:33+00:00,['035787cacc5a24128f1245f1c5c7d7f274fa644c'],0,371,371,283269,3,0.176100629,0.440251572,0.559748428,1563
f6287bd6a12d95eb5cd3d03cc2abcb2a9b5bcb0f,0,Lahiru Gunathilake,2011-08-16 04:21:44+00:00,['c605e76fc825477fdba115575d8ab3f3170eeb6d'],6,13,19,283288,3,0,1,1,1563
8d163f28b066f13d0c47628099b34bb542446c9e,0,Lahiru Gunathilake,2011-08-16 04:26:57+00:00,['f6287bd6a12d95eb5cd3d03cc2abcb2a9b5bcb0f'],1,5,6,283294,1,0,1,1,1563
a8aada611983a52dc1dbb7c4c49438c25c0799d7,0,Lahiru Gunathilake,2011-08-16 15:20:33+00:00,['8d163f28b066f13d0c47628099b34bb542446c9e'],1,8,9,283303,1,,,,1563
ef1e20111d8e078107fed24ab15924027c18a699,0,Lahiru Gunathilake,2011-08-17 12:46:46+00:00,['a8aada611983a52dc1dbb7c4c49438c25c0799d7'],28,20,48,283351,3,1,1,0,1563
4c9caa1e0387fb992597058caedc4ecc002ffe93,1,Lahiru Gunathilake,2011-08-17 12:48:03+00:00,['ef1e20111d8e078107fed24ab15924027c18a699'],0,5,5,283356,1,1,1,1,1563
dbad483cc0a2bc41a962aefbbb51f3869f2cc0c5,0,Lahiru Gunathilake,2011-08-17 12:50:28+00:00,['4c9caa1e0387fb992597058caedc4ecc002ffe93'],10,9,19,283375,1,1,0,0,1563
6aed8edc92c63fa51ee2c21ac140c44bb1212024,0,Lahiru Gunathilake,2011-08-17 15:38:00+00:00,['dbad483cc0a2bc41a962aefbbb51f3869f2cc0c5'],12,19,31,283406,1,0,1,0,1563
988b1ad873c96d47024301b4fd7745a0d5686145,0,Lahiru Gunathilake,2011-08-17 15:39:02+00:00,['6aed8edc92c63fa51ee2c21ac140c44bb1212024'],12,7,19,283425,2,1,1,0,1563
4af5dcdf42c52189ced656950f95bc9bcd813319,0,Lahiru Gunathilake,2011-08-18 21:19:22+00:00,['988b1ad873c96d47024301b4fd7745a0d5686145'],8,4,12,283437,2,,,,1563
9d3fa57f6f6b8613e5cedfa1b6a074ff50c3610a,0,Lahiru Gunathilake,2011-08-19 16:31:18+00:00,['4af5dcdf42c52189ced656950f95bc9bcd813319'],4,506,510,283947,6,,,,1566
73ba379e1b200218d0f955f9890e305cda5e6a46,0,Lahiru Gunathilake,2011-08-19 19:56:09+00:00,['9d3fa57f6f6b8613e5cedfa1b6a074ff50c3610a'],3,3,6,283953,1,,,,1566
ef7fe7c98a940e128fe0cb883cca47fefd73108f,0,Patanachai Tangchaisin,2011-08-23 00:00:08+00:00,['73ba379e1b200218d0f955f9890e305cda5e6a46'],40,73,113,284066,3,0.958333333,1,1,1566
3a4a0635c70b14ddfb41c0237898afdedebc512a,0,Patanachai Tangchaisin,2011-08-23 18:39:53+00:00,['ef7fe7c98a940e128fe0cb883cca47fefd73108f'],1645,101,1746,285812,19,0.437062937,0.367132867,0.146853147,1566
1c61dc03b27197de09cc107ec7bd0385862fc47a,0,Patanachai Tangchaisin,2011-08-23 20:04:27+00:00,['3a4a0635c70b14ddfb41c0237898afdedebc512a'],46,150,196,286008,3,0.285714286,0.285714286,1,1567
5125a7fa32a810216378d8fa7e5a10b4cc368b66,0,Patanachai Tangchaisin,2011-08-23 20:11:25+00:00,['1c61dc03b27197de09cc107ec7bd0385862fc47a'],1,1,2,286010,1,,,,1567
b5de7b5140e3114335ec90c7edea8cc10c22b9d7,0,Patanachai Tangchaisin,2011-08-23 20:14:37+00:00,['5125a7fa32a810216378d8fa7e5a10b4cc368b66'],0,4,4,286014,2,,,,1567
02430a09756f7430a993b4dfb72d5f810576429e,0,Lahiru Gunathilake,2011-08-24 16:25:25+00:00,['b5de7b5140e3114335ec90c7edea8cc10c22b9d7'],9,7,16,286030,1,,,,1567
75da367ecbca4ade20436098ed98c2c4dbc85ef1,0,Patanachai Tangchaisin,2011-08-24 18:21:21+00:00,['02430a09756f7430a993b4dfb72d5f810576429e'],2,2,4,286034,1,,,,1567
6d0cefb1469f74844341b439ff5d56324e7f2464,1,Patanachai Tangchaisin,2011-08-24 19:39:39+00:00,['75da367ecbca4ade20436098ed98c2c4dbc85ef1'],2,106,108,286142,2,0.071428571,1,1,1568
0854a5254402d444f42b12e13fd262ee9227615a,0,Lahiru Gunathilake,2011-08-25 15:17:05+00:00,['6d0cefb1469f74844341b439ff5d56324e7f2464'],6,4,10,286152,2,0,1,1,1568
8f2bd5730e70108eeaded84be88e58d96f94a06f,0,Lahiru Gunathilake,2011-08-25 15:17:33+00:00,['0854a5254402d444f42b12e13fd262ee9227615a'],6,3,9,286161,2,1,0,0,1568
7dc7c596c49829c9da32572408571da8efafcba7,0,Suresh Marru,2011-08-25 20:32:24+00:00,['8f2bd5730e70108eeaded84be88e58d96f94a06f'],0,145,145,286306,3,1,1,1,1571
fb25be88d24ae207d4d3d49c18c6322b0235a542,0,Suresh Marru,2011-08-25 20:44:05+00:00,['7dc7c596c49829c9da32572408571da8efafcba7'],35,57,92,286398,3,,,,1571
2227e23ea9c85fe9cbf503244088fc5c50543832,0,Patanachai Tangchaisin,2011-08-26 17:54:38+00:00,['fb25be88d24ae207d4d3d49c18c6322b0235a542'],60,66,126,286524,2,0,1,1,1571
a6812e991a2e4d89a7324c24e3fc4b40bd0f77bc,0,Patanachai Tangchaisin,2011-08-26 20:29:29+00:00,['2227e23ea9c85fe9cbf503244088fc5c50543832'],23,162,185,286709,3,0.476190476,0.095238095,1,1572
4a6abde222592b83632329e1f0d26d7395ace8bb,0,Patanachai Tangchaisin,2011-08-26 21:36:05+00:00,['a6812e991a2e4d89a7324c24e3fc4b40bd0f77bc'],63,117,180,286889,2,0,0,0.653846154,1572
49b083d76fb6c647243285cc0a02ccd3d6a59410,0,Lahiru Gunathilake,2011-08-26 21:51:08+00:00,['4a6abde222592b83632329e1f0d26d7395ace8bb'],158,162,320,287209,11,0,1,0,1572
02169bdbbaed1b9570a8ee831df1836b138074f4,0,Lahiru Gunathilake,2011-08-29 19:02:19+00:00,['49b083d76fb6c647243285cc0a02ccd3d6a59410'],13,10,23,287232,3,1,0,0,1572
36e7c10b5c9f320c0a8cb8832eb1f99a5a89e9f3,0,Patanachai Tangchaisin,2011-08-29 21:03:20+00:00,['02169bdbbaed1b9570a8ee831df1836b138074f4'],1759,371,2130,289362,21,0.739776952,0.252788104,0.094795539,1573
0f732c3b2b360ebd3b0696cd2a0a0e185437c2f1,0,Patanachai Tangchaisin,2011-08-29 23:48:01+00:00,['36e7c10b5c9f320c0a8cb8832eb1f99a5a89e9f3'],95,18,113,289475,3,1,1,0,1573
bd1011b015c7e1f23654aa403b5fdc18004574c3,0,Lahiru Gunathilake,2011-08-30 21:59:21+00:00,['0f732c3b2b360ebd3b0696cd2a0a0e185437c2f1'],12,13,25,289500,6,0,0,1,1573
6b2117b216e86f71118b204a1d68a5fc49262e13,1,Lahiru Gunathilake,2011-08-30 22:00:32+00:00,['bd1011b015c7e1f23654aa403b5fdc18004574c3'],2,2,4,289504,1,,,,1573
aeb247eeb94edbc7508e2173db77061299cd3b6f,0,Lahiru Gunathilake,2011-08-31 14:39:59+00:00,['6b2117b216e86f71118b204a1d68a5fc49262e13'],2,13,15,289519,2,0.75,0.75,0.75,1573
cd5846615d801f07219cf8e2aefeb2d6f01f71d0,0,Lahiru Gunathilake,2011-08-31 15:54:28+00:00,['aeb247eeb94edbc7508e2173db77061299cd3b6f'],0,524,524,290043,8,0.438461538,0.846153846,1,1581
0a3d54be8c7afa8f4055a22fdf6fcf6c016a9f04,0,Lahiru Gunathilake,2011-08-31 19:14:29+00:00,['cd5846615d801f07219cf8e2aefeb2d6f01f71d0'],1,0,1,290044,1,,,,1581
ad5d717f474d0e3b4c918d456c996e01b63a4fbe,0,Patanachai Tangchaisin,2011-08-31 20:17:34+00:00,['0a3d54be8c7afa8f4055a22fdf6fcf6c016a9f04'],217,157,374,290418,11,0.5,0.875,0,1583
197a080b153865ee9d720c11aa295e24059020b8,0,Lahiru Gunathilake,2011-08-31 21:12:43+00:00,['ad5d717f474d0e3b4c918d456c996e01b63a4fbe'],0,987,987,291405,6,,,,1589
6af8dbb0126a5b66640d8cb71a9988ef21669790,0,Lahiru Gunathilake,2011-08-31 21:29:32+00:00,['197a080b153865ee9d720c11aa295e24059020b8'],1,4,5,291410,2,,,,1589
32ea21f5eb0d4caf80c5e164e54b051877f527b7,0,Patanachai Tangchaisin,2011-09-01 16:28:41+00:00,['6af8dbb0126a5b66640d8cb71a9988ef21669790'],1,1,2,291412,1,,,,1589
3ca6e9d873299eb8992667b48045d26aca2477c6,0,Patanachai Tangchaisin,2011-09-01 16:28:44+00:00,['32ea21f5eb0d4caf80c5e164e54b051877f527b7'],9,7,16,291428,3,,,,1589
b04e4f44f7d1205b375944011ef2e01e19115449,0,Patanachai Tangchaisin,2011-09-01 16:58:48+00:00,['3ca6e9d873299eb8992667b48045d26aca2477c6'],105,338,443,291871,10,0.940594059,1,0.138613861,1591
3232cff604947c552cf120913add9c06f47e420b,0,Patanachai Tangchaisin,2011-09-01 18:18:11+00:00,['b04e4f44f7d1205b375944011ef2e01e19115449'],7,347,354,292225,11,0.513513514,1,0.945945946,1594
46e6a83e17382f3460fd0d00189dda27c3d68096,0,Patanachai Tangchaisin,2011-09-01 18:20:17+00:00,['3232cff604947c552cf120913add9c06f47e420b'],0,5,5,292230,1,,,,1594
958166165c2929aff1c290019c51aa0486506545,0,Lahiru Gunathilake,2011-09-01 19:50:57+00:00,['46e6a83e17382f3460fd0d00189dda27c3d68096'],16,145,161,292391,7,,,,1595
12a405e39687a17110706eed39ef180e56f2157e,0,Lahiru Gunathilake,2011-09-01 20:46:21+00:00,['958166165c2929aff1c290019c51aa0486506545'],0,46,46,292437,3,,,,1596
402037e2f51849f951df9eda5bdbea15818b108d,1,Patanachai Tangchaisin,2011-09-01 23:14:33+00:00,['12a405e39687a17110706eed39ef180e56f2157e'],2,21,23,292460,1,0,1,1,1596
c805bf14adfece51300b5ef5c19f2a3e2e2ca089,0,Patanachai Tangchaisin,2011-09-02 01:02:58+00:00,['402037e2f51849f951df9eda5bdbea15818b108d'],2,1,3,292463,1,,,,1596
800c66dd2800b34a9b51e7d53ec8c1bbddb11650,0,Chathura Herath,2011-09-02 20:22:43+00:00,['c805bf14adfece51300b5ef5c19f2a3e2e2ca089'],1,0,1,292464,1,1,1,0,1596
a73f5fbe8e44058d61e3b57e0c076efe91b2e96a,0,Chathura Herath,2011-09-02 20:46:46+00:00,['800c66dd2800b34a9b51e7d53ec8c1bbddb11650'],951,277,1228,293692,24,0.834710744,0.363636364,0.123966942,1596
59fd85112e2c9330d96944c8e8a9d80c1af6034f,0,Chathura Herath,2011-09-02 20:52:17+00:00,['a73f5fbe8e44058d61e3b57e0c076efe91b2e96a'],4,3,7,293699,2,1,1,0,1596
b21f1aa498923c84fe6be67217edc2782785cbff,0,Chathura Herath,2011-09-02 21:26:03+00:00,['59fd85112e2c9330d96944c8e8a9d80c1af6034f'],1456,910,2366,296065,96,0.317073171,0.243902439,0.780487805,1596
de031f9523fbb21d3aa39bfc5030c80d2a22a19c,0,Patanachai Tangchaisin,2011-09-06 20:07:02+00:00,['b21f1aa498923c84fe6be67217edc2782785cbff'],36,15,51,296116,3,,,,1596
158851a35b35384eb5bddc22ce176c9d92573fdb,0,Patanachai Tangchaisin,2011-09-06 20:07:22+00:00,['de031f9523fbb21d3aa39bfc5030c80d2a22a19c'],2,2,4,296120,1,,,,1596
d8bf07e8b7428f212d78003c705c7e06e62549f8,0,Patanachai Tangchaisin,2011-09-06 20:20:00+00:00,['158851a35b35384eb5bddc22ce176c9d92573fdb'],10,13,23,296143,3,1,0,0,1596
614800da1a0184b79d782708e8c047017a7b15d1,0,Lahiru Gunathilake,2011-09-06 21:08:52+00:00,['d8bf07e8b7428f212d78003c705c7e06e62549f8'],2,58,60,296203,3,0,0.228571429,1,1596
0ecf4439ba7f78d4a6af631cf19f8e24f1972d2a,0,Lahiru Gunathilake,2011-09-06 21:09:27+00:00,['614800da1a0184b79d782708e8c047017a7b15d1'],0,5,5,296208,2,0,0,1,1596
286afddada241bd7bd96f0fb393ddc31416546c8,0,Lahiru Gunathilake,2011-09-06 21:25:10+00:00,['0ecf4439ba7f78d4a6af631cf19f8e24f1972d2a'],2,14,16,296224,2,,,,1596
3f328c4621776f3e7eec7f08f1971fd5f6f2f271,0,Lahiru Gunathilake,2011-09-06 21:54:30+00:00,['286afddada241bd7bd96f0fb393ddc31416546c8'],0,4,4,296228,1,0,0,1,1596
68284c8e6d2c6cc9d8144341f642247c5670f098,0,Patanachai Tangchaisin,2011-09-06 22:21:39+00:00,['3f328c4621776f3e7eec7f08f1971fd5f6f2f271'],114,132,246,296474,2,0,1,1,1596
7886d1cb9ab60da01a562c96b12eb5c03cf92b29,0,Marlon Pierce,2011-09-07 13:26:30+00:00,['68284c8e6d2c6cc9d8144341f642247c5670f098'],0,16,16,296490,1,,,,1597
c98c3866bc02528c368637d666f298c9c1282d63,0,Marlon Pierce,2011-09-07 14:00:02+00:00,['7886d1cb9ab60da01a562c96b12eb5c03cf92b29'],0,12,12,296502,2,,,,1598
372240e51688ef1a2b0102416d74475c6ebae82c,1,Patanachai Tangchaisin,2011-09-07 20:16:10+00:00,['c98c3866bc02528c368637d666f298c9c1282d63'],653,815,1468,297970,75,0.680412371,0.319587629,0.175257732,1603
c65cf1d32455010de001597ef224cf8b45fdbc60,0,Patanachai Tangchaisin,2011-09-07 20:29:10+00:00,['372240e51688ef1a2b0102416d74475c6ebae82c'],71,1,72,298042,3,0,0,0,1603
698670202d08992d515faca7b1157a5274f44a2d,0,Patanachai Tangchaisin,2011-09-07 20:48:14+00:00,['c65cf1d32455010de001597ef224cf8b45fdbc60'],0,0,0,298042,0,,,,1603
9c552f3ebaf2bef63214a208e2dda7b3c3b64fdd,0,Patanachai Tangchaisin,2011-09-07 20:49:10+00:00,['698670202d08992d515faca7b1157a5274f44a2d'],0,0,0,298042,0,,,,1603
c837367200e79faf647b335c0d223d281451f86d,0,Patanachai Tangchaisin,2011-09-07 20:50:04+00:00,['9c552f3ebaf2bef63214a208e2dda7b3c3b64fdd'],0,0,0,298042,0,,,,1603
b04852f6ea0ef375ed28f99aaa0c31e3ea911b2c,0,Marlon Pierce,2011-09-07 21:51:48+00:00,['c837367200e79faf647b335c0d223d281451f86d'],2,33,35,298077,4,,,,1603
1ae857bfedd03f9ab49eb739dc25a176e645fbe0,0,Patanachai Tangchaisin,2011-09-07 22:23:37+00:00,['b04852f6ea0ef375ed28f99aaa0c31e3ea911b2c'],19,48,67,298144,2,0,0,0,1603
1e4faa00a7ebe9de87f17f694bdad3a144b1a94a,0,Patanachai Tangchaisin,2011-09-07 22:25:25+00:00,['1ae857bfedd03f9ab49eb739dc25a176e645fbe0'],10,21,31,298175,2,0,0,1,1603
d220d6e906ae39a762490375ce4da7c3a0006d46,0,Patanachai Tangchaisin,2011-09-07 22:32:29+00:00,['1e4faa00a7ebe9de87f17f694bdad3a144b1a94a'],1,1,2,298177,1,,,,1603
c8a3e9df3263c078de7eff1f4359640229df520a,0,Patanachai Tangchaisin,2011-09-08 00:49:49+00:00,['d220d6e906ae39a762490375ce4da7c3a0006d46'],648,35,683,298860,16,0.625322997,0.098191214,0.196382429,1603
d15b0c42c782e7f7445c262891c45c2f0ab3a8ef,0,Patanachai Tangchaisin,2011-09-08 00:50:10+00:00,['c8a3e9df3263c078de7eff1f4359640229df520a'],93,5,98,298958,2,0.870967742,0,0,1603
ba0dcad676447c5c92c452c9c5663e4a0c77ef6b,0,Patanachai Tangchaisin,2011-09-08 14:58:26+00:00,['d15b0c42c782e7f7445c262891c45c2f0ab3a8ef'],29,67,96,299054,12,1,1,1,1603
7c0d997dbab4d8724844612c870bb228f583bb0d,0,Patanachai Tangchaisin,2011-09-08 14:58:42+00:00,['ba0dcad676447c5c92c452c9c5663e4a0c77ef6b'],5,5,10,299064,1,,,,1603
0c1862dbcb161853e8c2b5121731d4322355390f,0,Lahiru Gunathilake,2011-09-08 15:24:14+00:00,['7c0d997dbab4d8724844612c870bb228f583bb0d'],52,1327,1379,300443,7,0.429672447,0.603082852,0.894026975,1607
40971a543ad34bb34930f7ef6b884c2ba4bccf3f,0,Lahiru Gunathilake,2011-09-08 15:27:16+00:00,['0c1862dbcb161853e8c2b5121731d4322355390f'],11,5,16,300459,5,,,,1607
e77dbdf1afa02593dbd8812455331ac1adc2a51b,0,Lahiru Gunathilake,2011-09-08 15:30:54+00:00,['40971a543ad34bb34930f7ef6b884c2ba4bccf3f'],0,0,0,300459,0,,,,1607
b7380d95f79e96442a2f587cd75190620af9ef80,0,Lahiru Gunathilake,2011-09-08 15:41:21+00:00,['e77dbdf1afa02593dbd8812455331ac1adc2a51b'],51,74,125,300584,10,,,,1607
63b5af25b52c74528ab0e07a6b6e6e0e1d29aa7f,0,Lahiru Gunathilake,2011-09-08 15:53:00+00:00,['b7380d95f79e96442a2f587cd75190620af9ef80'],2,2,4,300588,2,,,,1607
ecda53c13d696cdf437cbf3e1d17eed2fe6550a2,0,Patanachai Tangchaisin,2011-09-08 16:35:00+00:00,['63b5af25b52c74528ab0e07a6b6e6e0e1d29aa7f'],9,2,11,300599,1,1,1,0,1607
25b9decfe26912a456da2f626319f89d8e28406f,0,Lahiru Gunathilake,2011-09-08 17:50:20+00:00,['ecda53c13d696cdf437cbf3e1d17eed2fe6550a2'],81,106,187,300786,10,,,,1607
126e0d5d28d20bd8357d082be1d5a28e30705d5b,0,Lahiru Gunathilake,2011-09-08 18:30:12+00:00,['25b9decfe26912a456da2f626319f89d8e28406f'],141,123,264,301050,6,,,,1607
f97395a0a2dc8a7bdbb4c67dc57ab7d8aad4de1f,0,Lahiru Gunathilake,2011-09-08 19:33:59+00:00,['126e0d5d28d20bd8357d082be1d5a28e30705d5b'],0,2994,2994,304044,14,0.482328482,0.624740125,0.833679834,1620
9e17099066d5cd7908f536178ae18d9265af323c,0,Patanachai Tangchaisin,2011-09-08 19:46:01+00:00,['f97395a0a2dc8a7bdbb4c67dc57ab7d8aad4de1f'],524,843,1367,305411,35,0,0.08045977,0.689655172,1626
f8dc8d465b81289c7a53fe60a9749f2c332c3cbc,0,Patanachai Tangchaisin,2011-09-08 20:34:56+00:00,['9e17099066d5cd7908f536178ae18d9265af323c'],22,2,24,305435,1,,,,1626
c1e50c516afa96862e1fe48337fcebb72c3925ee,0,Lahiru Gunathilake,2011-09-08 20:39:26+00:00,['f8dc8d465b81289c7a53fe60a9749f2c332c3cbc'],1,1,2,305437,1,,,,1626
7f5a19c9bbc1fae0c44730d8644816f7bb1311c8,0,Patanachai Tangchaisin,2011-09-08 20:42:23+00:00,['c1e50c516afa96862e1fe48337fcebb72c3925ee'],2,1,3,305440,1,,,,1626
124dc0a3cede9ff672d83400e68c4e8df765edb1,0,Lahiru Gunathilake,2011-09-08 20:47:48+00:00,['7f5a19c9bbc1fae0c44730d8644816f7bb1311c8'],2,1,3,305443,2,,,,1626
ae17b2020291f9a9e4ec6281f5b815de02651b46,0,Lahiru Gunathilake,2011-09-08 21:08:38+00:00,['124dc0a3cede9ff672d83400e68c4e8df765edb1'],768,280,1048,306491,30,0.335740072,0.36101083,0.075812274,1627
1fe86c561195f3aeddefabeadfdf68ebc4eee6ac,0,Marlon Pierce,2011-09-08 21:19:14+00:00,['ae17b2020291f9a9e4ec6281f5b815de02651b46'],1,1,2,306493,1,,,,1627
c4e8e0b3213385fc9eeaa1bea3df66460fc1eccc,0,Patanachai Tangchaisin,2011-09-08 21:33:41+00:00,['1fe86c561195f3aeddefabeadfdf68ebc4eee6ac'],35,53,88,306581,5,1,1,1,1627
91c2a917d482ffcc36cf4704ff73b11eeaa7f6fc,0,Lahiru Gunathilake,2011-09-08 21:43:25+00:00,['c4e8e0b3213385fc9eeaa1bea3df66460fc1eccc'],109,9,118,306699,5,0.928571429,1,0,1627
51f9c2b3069914b815b46794ba067b5c7e3bcc48,0,Lahiru Gunathilake,2011-09-08 21:49:33+00:00,['91c2a917d482ffcc36cf4704ff73b11eeaa7f6fc'],1,1,2,306701,1,,,,1627
d347dd85139c90cacdffb8455dc850f5b5947ad4,0,Lahiru Gunathilake,2011-09-08 22:08:23+00:00,['51f9c2b3069914b815b46794ba067b5c7e3bcc48'],3,30,33,306734,2,,,,1627
1bce9c41148e22b5cae57e9fd8ddf84937c709bd,0,Patanachai Tangchaisin,2011-09-08 22:33:16+00:00,['d347dd85139c90cacdffb8455dc850f5b5947ad4'],193,223,416,307150,4,1,0,1,1627
890fe6799f7a6866b7b696c0bc24ad4d36d197d5,0,Lahiru Gunathilake,2011-09-08 22:41:07+00:00,['1bce9c41148e22b5cae57e9fd8ddf84937c709bd'],2,0,2,307152,1,,,,1627
340b1b025a6ed4da4597e6ef9db8037f7fa05cad,0,Lahiru Gunathilake,2011-09-08 23:00:57+00:00,['890fe6799f7a6866b7b696c0bc24ad4d36d197d5'],131,128,259,307411,6,,,,1627
ae719d4c1b16c58032e8e82e28467910b3c65cdd,0,Chathura Herath,2011-09-08 23:39:23+00:00,['340b1b025a6ed4da4597e6ef9db8037f7fa05cad'],178,1088,1266,308677,15,0.603174603,1,0.865079365,1634
affb78daf18db2c350f2d13fcb5eb49d479be845,0,Lahiru Gunathilake,2011-09-09 03:50:49+00:00,['ae719d4c1b16c58032e8e82e28467910b3c65cdd'],576,0,576,309253,2,0.533333333,0.240740741,0.103703704,1634
7c199e0a67d43c3bf9449863450d46598bd5c87c,0,Lahiru Gunathilake,2011-09-09 03:51:46+00:00,['affb78daf18db2c350f2d13fcb5eb49d479be845'],132,151,283,309536,85,0,0,0.4375,1634
ea75727e2a9e5787bd9edd0aaacaf99d749feef4,0,Lahiru Gunathilake,2011-09-09 03:59:03+00:00,['7c199e0a67d43c3bf9449863450d46598bd5c87c'],27,27,54,309590,27,,,,1634
5948c6ecc66f57a57386404a8605b0d6cf28aadc,0,Lahiru Gunathilake,2011-09-09 04:09:42+00:00,['ea75727e2a9e5787bd9edd0aaacaf99d749feef4'],236,56,292,309882,55,,,,1634
f1a40f6bd806972bd53e89fe3552bfef0ac12856,0,Lahiru Gunathilake,2011-09-09 04:10:21+00:00,['5948c6ecc66f57a57386404a8605b0d6cf28aadc'],831,0,831,310713,5,0.438485804,0.261829653,0.331230284,1634
7685ca5d0eee9582affeed3e8c64441694aab9a9,0,Patanachai Tangchaisin,2011-09-09 05:33:51+00:00,['f1a40f6bd806972bd53e89fe3552bfef0ac12856'],47,23,70,310783,11,0.5,0.5,0,1634
f04968a5c535e4c0528f4429789dc561bf2d186d,0,Marlon Pierce,2011-09-09 14:05:51+00:00,['7685ca5d0eee9582affeed3e8c64441694aab9a9'],0,7,7,310790,1,,,,1634
18c08702673e4a105390bd78329426252f64238d,0,Lahiru Gunathilake,2011-09-09 15:04:05+00:00,['f04968a5c535e4c0528f4429789dc561bf2d186d'],0,336,336,311126,4,1,1,1,1636
1e8da39156ae125ad6622b5f7a148cea5e44cab7,0,Patanachai Tangchaisin,2011-09-09 16:22:58+00:00,['18c08702673e4a105390bd78329426252f64238d'],58,75,133,311259,3,1,0,0,1636
fb3494aa2d11c0cc6f0eaa64ab24a2267d4e3436,0,Patanachai Tangchaisin,2011-09-09 19:58:54+00:00,['1e8da39156ae125ad6622b5f7a148cea5e44cab7'],952,570,1522,312781,23,1,1,0.082969432,1639
28797bf88f41fc22306dfe0446cdf7ccd94dfc01,0,Patanachai Tangchaisin,2011-09-09 20:52:34+00:00,['fb3494aa2d11c0cc6f0eaa64ab24a2267d4e3436'],261,427,688,313469,46,1,1,0,1639
441e03a6c03662c41dfd21bc9a29bf031dc13f12,0,Lahiru Gunathilake,2011-09-09 20:58:21+00:00,['28797bf88f41fc22306dfe0446cdf7ccd94dfc01'],618,103,721,314190,19,,,,1640
ece9ca7d7a0223821a86151354c4ff5ace92b4c6,0,Patanachai Tangchaisin,2011-09-09 21:19:09+00:00,['441e03a6c03662c41dfd21bc9a29bf031dc13f12'],36,70,106,314296,2,,,,1640
8a53ecaebce1115e0ff113b8dd6c7e1f7360f391,0,Patanachai Tangchaisin,2011-09-09 23:37:36+00:00,['ece9ca7d7a0223821a86151354c4ff5ace92b4c6'],6,6,12,314308,6,,,,1640
de24fe5d7ed64907a5ae1ba2cba9f45382502f75,0,Patanachai Tangchaisin,2011-09-12 14:47:30+00:00,['8a53ecaebce1115e0ff113b8dd6c7e1f7360f391'],1,1,2,314310,1,,,,1640
e6d3c1f71bfb8df9406acc52f303d9eceb61f6a8,0,Suresh Marru,2011-09-12 17:39:06+00:00,['de24fe5d7ed64907a5ae1ba2cba9f45382502f75'],574,0,574,314884,1,,,,1640
12b0dcdf41aee32c7f137d0003300b6b81b56d67,0,Suresh Marru,2011-09-12 17:44:50+00:00,['e6d3c1f71bfb8df9406acc52f303d9eceb61f6a8'],1,0,1,314885,1,,,,1640
c71267deb47f5b7f54440432188053962b380acf,0,Lahiru Gunathilake,2011-09-12 21:15:50+00:00,['12b0dcdf41aee32c7f137d0003300b6b81b56d67'],1,5,6,314891,1,0,0,0,1640
d4c6c13dd0a8f0007c959d1d405a60c1d1f70259,0,Lahiru Gunathilake,2011-09-12 21:19:53+00:00,['c71267deb47f5b7f54440432188053962b380acf'],77,132,209,315100,6,1,0,1,1640
7947534c75e8bbcf2f6bfca2a7c735dd137102bd,0,Lahiru Gunathilake,2011-09-12 21:25:16+00:00,['d4c6c13dd0a8f0007c959d1d405a60c1d1f70259'],1,1,2,315102,1,,,,1640
3779df322b8d366e01439b7b42953d6324050b90,0,Lahiru Gunathilake,2011-09-12 21:31:30+00:00,['7947534c75e8bbcf2f6bfca2a7c735dd137102bd'],11,11,22,315124,9,,,,1640
49b85c775f4915c228f188a852c02dbf26af2e4e,1,Lahiru Gunathilake,2011-09-12 21:52:58+00:00,['3779df322b8d366e01439b7b42953d6324050b90'],70,38,108,315232,1,0,1,1,1640
7ab8deb08b34d9cea725841e3db7a37eb231af35,0,Suresh Marru,2011-09-13 15:20:17+00:00,['49b85c775f4915c228f188a852c02dbf26af2e4e'],0,463,463,315695,3,,,,1643
7e2ee3a3a7c9c75cfa819170802c2dec57a0c54f,0,Lahiru Gunathilake,2011-09-13 17:15:55+00:00,['7ab8deb08b34d9cea725841e3db7a37eb231af35'],258,450,708,316403,3,1,1,1,1644
449d83e30ddd17d25a52c1c5b80af256fe913e15,0,Suresh Marru,2011-09-13 19:35:51+00:00,['7e2ee3a3a7c9c75cfa819170802c2dec57a0c54f'],38,8,46,316449,1,,,,1644
b58dac6efd0df383090b2f018216948199358905,0,Patanachai Tangchaisin,2011-09-13 19:53:45+00:00,['449d83e30ddd17d25a52c1c5b80af256fe913e15'],210,229,439,316888,8,0.724137931,1,0.344827586,1645
bfafd46dcf209944ec236cd486e7f625d9e25edb,0,Patanachai Tangchaisin,2011-09-13 21:24:20+00:00,['b58dac6efd0df383090b2f018216948199358905'],311,278,589,317477,6,1,1,0,1646
4e82afbcc88263230e01c71985fe17e6f7f82c25,0,Lahiru Gunathilake,2011-09-14 17:58:04+00:00,['bfafd46dcf209944ec236cd486e7f625d9e25edb'],39,60,99,317576,1,0.875,0.8125,0.8125,1646
d625f18feca7a661023e463e860afec21d4f1fc1,0,Lahiru Gunathilake,2011-09-14 17:58:22+00:00,['4e82afbcc88263230e01c71985fe17e6f7f82c25'],9,1,10,317586,1,0,0,1,1646
ec4a6dc2597d8334a000adeb002071e861170dd2,0,Patanachai Tangchaisin,2011-09-14 22:56:19+00:00,['d625f18feca7a661023e463e860afec21d4f1fc1'],0,4773,4773,322359,39,0.431279621,0.818009479,0.821327014,1685
5aa6955474cef2541b785ef23a35d13a61349efb,0,Patanachai Tangchaisin,2011-09-14 23:14:15+00:00,['ec4a6dc2597d8334a000adeb002071e861170dd2'],0,1614,1614,323973,9,0.352417303,0.56870229,0.840966921,1694
81320782a0f2112c08547b71aa6d85795354832d,0,Patanachai Tangchaisin,2011-09-15 02:22:57+00:00,['5aa6955474cef2541b785ef23a35d13a61349efb'],156,50,206,324179,10,0.666666667,0.666666667,0.960784314,1694
d26f35db1b5043e84dffe00973f3cb571f82ec35,0,Patanachai Tangchaisin,2011-09-15 02:37:48+00:00,['81320782a0f2112c08547b71aa6d85795354832d'],1395,23,1418,325597,11,0.606493506,0.319480519,0.066233766,1694
83d3f4ea56fca79acc621e0f9bb0725e4657502f,0,Patanachai Tangchaisin,2011-09-15 02:47:52+00:00,['d26f35db1b5043e84dffe00973f3cb571f82ec35'],4735,73,4808,330405,46,0.5734714,0.218934911,0.17504931,1694
26cbe8ccabd3effcf51158a2d0e1a64289024ef8,0,Patanachai Tangchaisin,2011-09-15 02:51:41+00:00,['83d3f4ea56fca79acc621e0f9bb0725e4657502f'],0,29,29,330434,2,,,,1694
0d14b12740c733cd28aacdcc203007840f4c1270,0,Patanachai Tangchaisin,2011-09-15 03:20:36+00:00,['26cbe8ccabd3effcf51158a2d0e1a64289024ef8'],216,0,216,330650,2,0.64,0,0,1694
d517e6e9dabbd35566ec40010a03dd9f1547ca54,0,Patanachai Tangchaisin,2011-09-15 03:29:02+00:00,['0d14b12740c733cd28aacdcc203007840f4c1270'],8,3,11,330661,2,,,,1694
937c04ca1b6cf298e9eb55a4a2e26205fdd1af9a,0,Lahiru Gunathilake,2011-09-15 15:54:26+00:00,['d517e6e9dabbd35566ec40010a03dd9f1547ca54'],2,3,5,330666,1,1,1,1,1694
d8aab2340eefa51b9ee94575d98b6d192b665790,0,Patanachai Tangchaisin,2011-09-15 16:52:13+00:00,['937c04ca1b6cf298e9eb55a4a2e26205fdd1af9a'],5,3,8,330674,3,,,,1694
8a506ef62fca389b95665b4935c590ddf6baf82a,0,Lahiru Gunathilake,2011-09-15 18:31:03+00:00,['d8aab2340eefa51b9ee94575d98b6d192b665790'],6,4,10,330684,1,,,,1694
362d36a28d57143f96836e67cff66aa91c0c7d21,0,Lahiru Gunathilake,2011-09-16 20:29:13+00:00,['8a506ef62fca389b95665b4935c590ddf6baf82a'],47,48,95,330779,11,,,,1694
c25673af6bb46301de8f705bca01890922072956,0,Lahiru Gunathilake,2011-09-16 21:13:44+00:00,['362d36a28d57143f96836e67cff66aa91c0c7d21'],108,108,216,330995,9,,,1,1694
4c418e3f68eae1f62dc209d456d1ea3fde5bd8b9,1,Patanachai Tangchaisin,2011-09-17 02:32:24+00:00,['c25673af6bb46301de8f705bca01890922072956'],1153,917,2070,333065,18,0,0,0,1695
a7a9950550a0df3036867c514d4311b4d75fd788,1,Patanachai Tangchaisin,2011-09-17 06:00:58+00:00,['4c418e3f68eae1f62dc209d456d1ea3fde5bd8b9'],28,51,79,333144,4,0,0,0.5,1695
03c2756cbd1fcf0a4599a114926e4aa5ac77b62d,0,Patanachai Tangchaisin,2011-09-17 06:01:50+00:00,['a7a9950550a0df3036867c514d4311b4d75fd788'],40,27,67,333211,2,1,0,0.777777778,1695
cfb3eb58e1d4fc3a1c9a9d92ecadb4fb3a22c4c3,0,Patanachai Tangchaisin,2011-09-17 06:12:22+00:00,['03c2756cbd1fcf0a4599a114926e4aa5ac77b62d'],94,2,96,333307,3,0,0,0,1695
4933e220fb27e38065a2ccc4739f8ede66197ffd,0,Patanachai Tangchaisin,2011-09-17 06:32:52+00:00,['cfb3eb58e1d4fc3a1c9a9d92ecadb4fb3a22c4c3'],8,12,20,333327,3,,,,1695
e137e8298e6a69d8db1af8a24b2f2a6bbb83e2d5,0,Patanachai Tangchaisin,2011-09-17 07:02:30+00:00,['4933e220fb27e38065a2ccc4739f8ede66197ffd'],4,5,9,333336,1,,,,1695
3a7c92b515317bb533204124b96f4c21f022b67f,0,Patanachai Tangchaisin,2011-09-17 18:17:52+00:00,['e137e8298e6a69d8db1af8a24b2f2a6bbb83e2d5'],2337,162,2499,335835,43,0.521167883,0.306569343,0.02189781,1695
4ef0ca14a0b017c4ed1ebc3295da7d83caa3e17d,0,Lahiru Gunathilake,2011-09-19 15:10:32+00:00,['3a7c92b515317bb533204124b96f4c21f022b67f'],0,20,20,335855,1,,,,1695
bdaceb4140adafd6e17b6fff341d44488ad05d1e,0,Lahiru Gunathilake,2011-09-19 15:22:31+00:00,['4ef0ca14a0b017c4ed1ebc3295da7d83caa3e17d'],7,5,12,335867,2,0,0,1,1695
9b9ef310a039f668d67302a3788a39fc95b81ef9,1,Lahiru Gunathilake,2011-09-19 16:03:08+00:00,['bdaceb4140adafd6e17b6fff341d44488ad05d1e'],4,8,12,335879,2,1,0.75,1,1695
3478b0c97c0887ef70b052fe72d8545956507cc3,0,Patanachai Tangchaisin,2011-09-19 23:13:33+00:00,['9b9ef310a039f668d67302a3788a39fc95b81ef9'],306,387,693,336572,6,0,1,0.867924528,1695
1e514e1d048858742be827ac0f27a45e3164e9c8,0,Patanachai Tangchaisin,2011-09-20 03:17:31+00:00,['3478b0c97c0887ef70b052fe72d8545956507cc3'],10,10,20,336592,31,,,,1695
3628ff43b6d28b204b4c43a1564d199710652b22,1,Lahiru Gunathilake,2011-09-20 17:08:29+00:00,['1e514e1d048858742be827ac0f27a45e3164e9c8'],1,37,38,336630,2,0,1,1,1695
dec415ede8a362fef7b739a686fe9823b0d2aee9,0,Lahiru Gunathilake,2011-09-20 17:09:02+00:00,['3628ff43b6d28b204b4c43a1564d199710652b22'],13,29,42,336672,3,0,0.818181818,0.818181818,1695
7564da44867ded11c9e393cf792967a10abecc20,0,Lahiru Gunathilake,2011-09-20 18:30:20+00:00,['dec415ede8a362fef7b739a686fe9823b0d2aee9'],8,8,16,336688,2,0,,,1695
0d204ee9f0e50cffa20089569450f9e3599e4399,0,Lahiru Gunathilake,2011-09-20 18:59:25+00:00,['7564da44867ded11c9e393cf792967a10abecc20'],2,8,10,336698,1,0.75,1,1,1695
9464a119beb0088bfa4f1a9d0609035d23e3ae9e,1,Lahiru Gunathilake,2011-09-20 18:59:35+00:00,['0d204ee9f0e50cffa20089569450f9e3599e4399'],5,38,43,336741,2,0,1,1,1695
444b666869ac60872bb90c0cfe31b351b6ad536a,0,Lahiru Gunathilake,2011-09-20 20:35:31+00:00,['9464a119beb0088bfa4f1a9d0609035d23e3ae9e'],5,719,724,337465,9,0.974358974,1,0.928205128,1702
6ee6d8516d2afe2e8cfedda184dc13ba393ee706,1,Lahiru Gunathilake,2011-09-20 20:44:30+00:00,['444b666869ac60872bb90c0cfe31b351b6ad536a'],2,586,588,338053,7,0.96,1,0.96,1708
6756763a885272e0386ba71d5487a7e3416be02e,0,Patanachai Tangchaisin,2011-09-21 06:20:38+00:00,['6ee6d8516d2afe2e8cfedda184dc13ba393ee706'],814,665,1479,339532,24,1,1,0,1709
32f9f227877b547c5122c9c5666d84c1b1124fa2,0,Patanachai Tangchaisin,2011-09-21 06:28:18+00:00,['6756763a885272e0386ba71d5487a7e3416be02e'],1,1,2,339534,1,,,,1709
c0cee2a0e25052c14df24a5844067eb05387752c,0,Patanachai Tangchaisin,2011-09-21 06:33:43+00:00,['32f9f227877b547c5122c9c5666d84c1b1124fa2'],1,3,4,339538,1,,,,1709
eba467efad0846dd90c9945ea6a26c98a73be74d,0,Lahiru Gunathilake,2011-09-21 13:35:31+00:00,['c0cee2a0e25052c14df24a5844067eb05387752c'],0,473,473,340011,2,0.590759076,0.795379538,0.805280528,1711
926cfef1665ef0cc179c2460005f31a2ea8dcdfd,0,Patanachai Tangchaisin,2011-09-21 20:36:37+00:00,['eba467efad0846dd90c9945ea6a26c98a73be74d'],7,23,30,340041,6,0,1,0.75,1711
54b4c795f6212b7ab5e4ef9b7105869ea406c857,0,Patanachai Tangchaisin,2011-09-21 21:43:45+00:00,['926cfef1665ef0cc179c2460005f31a2ea8dcdfd'],71,82,153,340194,17,0.066666667,1,1,1712
cf37cf373aeb61d9ad0b71d90a2de8c015ac24aa,0,Patanachai Tangchaisin,2011-09-22 03:11:37+00:00,['54b4c795f6212b7ab5e4ef9b7105869ea406c857'],9,3,12,340206,5,,,,1712
a3b285233660c24c2917d01d310c62d6ec4fcbb7,0,Patanachai Tangchaisin,2011-09-22 03:20:37+00:00,['cf37cf373aeb61d9ad0b71d90a2de8c015ac24aa'],399,136,535,340741,12,0.458823529,0.388235294,0.2,1712
532807d14345c3281b4c1bf91529bd1b8bc0e410,0,Lahiru Gunathilake,2011-09-22 18:00:01+00:00,['a3b285233660c24c2917d01d310c62d6ec4fcbb7'],2,26,28,340769,1,0.947368421,1,1,1712
b410bd912dc9a9dfc849a0ed24d6aca06d4fbd19,1,Lahiru Gunathilake,2011-09-22 18:00:29+00:00,['532807d14345c3281b4c1bf91529bd1b8bc0e410'],19,42,61,340830,2,0,1,1,1712
dd543ebb4dab9ff608156e997c4f6d375816c7f4,0,Lahiru Gunathilake,2011-09-22 18:04:41+00:00,['b410bd912dc9a9dfc849a0ed24d6aca06d4fbd19'],20,62,82,340912,6,0.230769231,0.820512821,1,1712
8e2667a16bd6f01c88123fe7c0108f928e144972,0,Lahiru Gunathilake,2011-09-22 18:08:16+00:00,['dd543ebb4dab9ff608156e997c4f6d375816c7f4'],1,0,1,340913,1,,,,1712
4d0a3bb707ec5028a81792f8c2e2fb0b07c42a1b,0,Patanachai Tangchaisin,2011-09-22 18:17:28+00:00,['8e2667a16bd6f01c88123fe7c0108f928e144972'],333,270,603,341516,36,1,1,0,1712
ff525748db38eff253ec48974bad371000d60192,0,Patanachai Tangchaisin,2011-09-22 21:37:45+00:00,['4d0a3bb707ec5028a81792f8c2e2fb0b07c42a1b'],390,109,499,342015,3,,,,1712
e9830d346701154dd3e412f564042a97faeb9dc8,0,Patanachai Tangchaisin,2011-09-22 22:04:49+00:00,['ff525748db38eff253ec48974bad371000d60192'],2,2,4,342019,1,,,,1712
969118f0a6a8296001e27c0f71557c3da24c6c4e,0,Patanachai Tangchaisin,2011-09-22 22:10:23+00:00,['e9830d346701154dd3e412f564042a97faeb9dc8'],124,77,201,342220,22,0.611111111,0.611111111,0,1713
70df3c245b076f09a1a3d1bd9d0c2355e0e3ec04,0,Patanachai Tangchaisin,2011-09-22 22:35:09+00:00,['969118f0a6a8296001e27c0f71557c3da24c6c4e'],2,3,5,342225,1,,,,1713
5597ffdfeb685d1c6664b40936e414d8eb0b682f,0,Patanachai Tangchaisin,2011-09-23 05:27:52+00:00,['70df3c245b076f09a1a3d1bd9d0c2355e0e3ec04'],997,191,1188,343413,32,0.55799373,0,0,1713
d87b2e0823c7efa400a2ff1a4af09b6bc6d3fd3a,0,Patanachai Tangchaisin,2011-09-23 05:30:06+00:00,['5597ffdfeb685d1c6664b40936e414d8eb0b682f'],0,55,55,343468,1,,,,1714
27a738aaf47e112e3b260796f3b3ea55fad50c9f,0,Patanachai Tangchaisin,2011-09-23 05:37:32+00:00,['d87b2e0823c7efa400a2ff1a4af09b6bc6d3fd3a'],4,10,14,343482,1,,,,1714
c0433214cc3cda6587d4cd2a89f729b503b6dcc2,0,Patanachai Tangchaisin,2011-09-23 19:36:50+00:00,['27a738aaf47e112e3b260796f3b3ea55fad50c9f'],378,218,596,344078,17,0.493975904,0.265060241,0.048192771,1714
df1a3affb70fa7f6cdc9d9c548a7dbbc8d840669,0,Patanachai Tangchaisin,2011-09-23 20:18:47+00:00,['c0433214cc3cda6587d4cd2a89f729b503b6dcc2'],11,12,23,344101,1,0,1,1,1714
79ccc70d75bad111af1dc6ab16a555b097894018,0,Patanachai Tangchaisin,2011-09-23 23:37:01+00:00,['df1a3affb70fa7f6cdc9d9c548a7dbbc8d840669'],638,408,1046,345147,12,0,0,0,1717
8933d2009f00a1e0bf9091e85f03c2cf5cb8120e,0,Patanachai Tangchaisin,2011-09-24 01:45:09+00:00,['79ccc70d75bad111af1dc6ab16a555b097894018'],67,84,151,345298,4,0,1,0.9,1717
45a1159a9c662c197931b7bc42a92c068d52263e,0,Patanachai Tangchaisin,2011-09-26 17:30:06+00:00,['8933d2009f00a1e0bf9091e85f03c2cf5cb8120e'],97,71,168,345466,3,0,0,0.588235294,1717
2f060b2b9062f9b0a865c41ff499870ab892c89f,0,Patanachai Tangchaisin,2011-09-26 19:20:19+00:00,['45a1159a9c662c197931b7bc42a92c068d52263e'],71,38,109,345575,3,0,0,0,1717
6cc8328504e506e59cb07a8e070f0691a683b0f6,1,Patanachai Tangchaisin,2011-09-26 20:32:31+00:00,['2f060b2b9062f9b0a865c41ff499870ab892c89f'],42,128,170,345745,8,0.333333333,0.62962963,1,1717
02d4d4b761b0c903f703332facaf4fe9a128a454,1,Lahiru Gunathilake,2011-09-26 21:27:08+00:00,['6cc8328504e506e59cb07a8e070f0691a683b0f6'],105,286,391,346136,6,0.684931507,0.924657534,1,1717
4557d8bf589c1fe57d393ec060658b9d0cef2725,0,Patanachai Tangchaisin,2011-09-27 04:00:30+00:00,['02d4d4b761b0c903f703332facaf4fe9a128a454'],32,29,61,346197,1,1,0.125,0,1717
f2d4a1c97a2ab152aad78d0b962daefbfed141fa,0,Lahiru Gunathilake,2011-09-27 20:49:58+00:00,['4557d8bf589c1fe57d393ec060658b9d0cef2725'],85,134,219,346416,6,1,1,0,1717
0b4aff76fead687b4718a946cb94e60d8361357c,0,Lahiru Gunathilake,2011-09-27 21:19:25+00:00,['f2d4a1c97a2ab152aad78d0b962daefbfed141fa'],3,3,6,346422,1,,,,1717
3a871cc0b79c51ffcfd5e4fcc796aaf9da5c5a1f,0,Patanachai Tangchaisin,2011-10-04 22:31:53+00:00,['0b4aff76fead687b4718a946cb94e60d8361357c'],21,49,70,346492,8,1,1,1,1717
199793316cda6dd5f4d7a6bce7b4d72c988af5c6,0,Lahiru Gunathilake,2011-10-05 01:25:51+00:00,['3a871cc0b79c51ffcfd5e4fcc796aaf9da5c5a1f'],4,1,5,346497,2,1,1,0,1717
c8ed3cade7a700d1a27c9e2c76fc0c31a1b56bf2,0,Lahiru Gunathilake,2011-10-05 18:27:27+00:00,['199793316cda6dd5f4d7a6bce7b4d72c988af5c6'],2,2,4,346501,2,,,,1717
ab9af79a8faba69cb2211db84a210f81ca6e4162,0,Lahiru Gunathilake,2011-10-05 18:27:36+00:00,['c8ed3cade7a700d1a27c9e2c76fc0c31a1b56bf2'],1,1,2,346503,1,,,,1717
59f4dc7b504d635120bb58e19a7ab20e5ef870d6,0,Lahiru Gunathilake,2011-10-05 18:27:44+00:00,['ab9af79a8faba69cb2211db84a210f81ca6e4162'],2,2,4,346507,1,,,,1717
75aadd6fd77247c9e18dd8e3ea7d75b2141799bc,0,Patanachai Tangchaisin,2011-10-05 18:59:25+00:00,['59f4dc7b504d635120bb58e19a7ab20e5ef870d6'],1,1,2,346509,1,,,,1717
9cd3607abf80544a35de98c107efc5dcec9fad02,0,Lahiru Gunathilake,2011-10-05 20:00:00+00:00,['75aadd6fd77247c9e18dd8e3ea7d75b2141799bc'],0,1,1,346510,1,1,1,1,1717
5b4b6cb63f7894ed26249902de07f67ba8593101,0,Patanachai Tangchaisin,2011-10-05 22:31:52+00:00,['9cd3607abf80544a35de98c107efc5dcec9fad02'],123,145,268,346778,23,,,,1717
72fb9eb92b6e6c1df01d9ba1d032143db63ac5b4,0,Lahiru Gunathilake,2011-10-06 03:19:46+00:00,['5b4b6cb63f7894ed26249902de07f67ba8593101'],12,69,81,346859,1,0.291666667,1,1,1717
addc2664ae06946b3bf70832ce4d07c4bcb1636d,0,Lahiru Gunathilake,2011-10-06 03:24:28+00:00,['72fb9eb92b6e6c1df01d9ba1d032143db63ac5b4'],2,4,6,346865,1,1,1,1,1717
e8de0de719ec5d1f253635929288fe0c39d8f763,0,Patanachai Tangchaisin,2011-10-06 16:04:13+00:00,['addc2664ae06946b3bf70832ce4d07c4bcb1636d'],2,2,4,346869,1,,,,1717
ecf370870b402daf66da91108a8bdfbaa36b8039,0,Lahiru Gunathilake,2011-10-06 16:11:33+00:00,['e8de0de719ec5d1f253635929288fe0c39d8f763'],1,2,3,346872,1,1,1,1,1717
722822b58db786f361130099f53361783b99e3c2,0,Lahiru Gunathilake,2011-10-06 17:21:59+00:00,['ecf370870b402daf66da91108a8bdfbaa36b8039'],44,50,94,346966,2,0.692307692,0,0,1717
3c78ccd91a938c74807a4c095d3b3ac0d0f63037,0,Patanachai Tangchaisin,2011-10-06 18:20:08+00:00,['722822b58db786f361130099f53361783b99e3c2'],5,47,52,347018,1,0,0,1,1717
72fecdd6fe5b3a5aa00a0c6a7539be17d35bfb80,0,Patanachai Tangchaisin,2011-10-06 18:54:30+00:00,['3c78ccd91a938c74807a4c095d3b3ac0d0f63037'],53,69,122,347140,6,0,0,0,1717
649175a24fe431ee28d0148d5cced8639f206b75,0,Patanachai Tangchaisin,2011-10-06 19:47:45+00:00,['72fecdd6fe5b3a5aa00a0c6a7539be17d35bfb80'],650,637,1287,348427,112,0.836363636,0.4,0.090909091,1717
003296dd8c9430b874b362723e85ac7ce7911b30,1,Patanachai Tangchaisin,2011-10-06 19:53:42+00:00,['649175a24fe431ee28d0148d5cced8639f206b75'],134,162,296,348723,7,0,1,0.333333333,1717
3ab88db6dfbb9430f933c7b481321e0b5f642c78,1,Lahiru Gunathilake,2011-10-06 21:31:07+00:00,['003296dd8c9430b874b362723e85ac7ce7911b30'],2,3,5,348728,1,0,1,0,1717
c14364cf02a9dfeb7b399ea989de71f9e263ff36,0,Lahiru Gunathilake,2011-10-06 21:31:31+00:00,['3ab88db6dfbb9430f933c7b481321e0b5f642c78'],5,17,22,348750,3,0.4,1,0.6,1717
782e03bea60010eff0348c497f6c6d118ce62384,0,Lahiru Gunathilake,2011-10-06 21:32:58+00:00,['c14364cf02a9dfeb7b399ea989de71f9e263ff36'],2,6,8,348758,1,0,0,1,1717
6c17a0bce308c54893e9ba250c9f09b35d9d542d,0,Lahiru Gunathilake,2011-10-07 17:31:42+00:00,['782e03bea60010eff0348c497f6c6d118ce62384'],255,256,511,349269,21,0.799107143,0.700892857,0.026785714,1717
cc27d3d2246ba0c574d4bb59e94fb6cef2e23556,0,Lahiru Gunathilake,2011-10-07 17:35:28+00:00,['6c17a0bce308c54893e9ba250c9f09b35d9d542d'],0,743,743,350012,4,0.062937063,1,1,1721
39ace70249fe25c80f4bd82281bc899fb10d8bec,0,Patanachai Tangchaisin,2011-10-07 18:46:37+00:00,['cc27d3d2246ba0c574d4bb59e94fb6cef2e23556'],67,65,132,350144,2,,,,1721
ad205963b11d3c5d65abdfd8b6814d37f2ef8f17,0,Lahiru Gunathilake,2011-10-07 19:18:07+00:00,['39ace70249fe25c80f4bd82281bc899fb10d8bec'],5,4,9,350153,1,1,0,0,1721
1b92b0f181aecca2d55714d6a766a98c198213c9,0,Patanachai Tangchaisin,2011-10-10 17:42:04+00:00,['ad205963b11d3c5d65abdfd8b6814d37f2ef8f17'],32,31,63,350216,1,,,,1721
68797ba08750b23305a1cdc97fdadbcdc6a5495b,0,Lahiru Gunathilake,2011-10-10 20:09:18+00:00,['1b92b0f181aecca2d55714d6a766a98c198213c9'],303,438,741,350957,2,,,,1721
1cd2fdcd14a33d30b0c2bda0c860161f9a016be0,1,Patanachai Tangchaisin,2011-10-10 21:26:43+00:00,['68797ba08750b23305a1cdc97fdadbcdc6a5495b'],4,256,260,351217,8,0.209302326,0.720930233,0.965116279,1724
996831f749c3efb889fca53173aea7e472009d76,1,Lahiru Gunathilake,2011-10-10 21:47:14+00:00,['1cd2fdcd14a33d30b0c2bda0c860161f9a016be0'],5,84,89,351306,2,0.193548387,1,0.548387097,1724
747ce65d72789a8e25b60fb9be1fd76417aa80a2,0,Lahiru Gunathilake,2011-10-10 21:48:20+00:00,['996831f749c3efb889fca53173aea7e472009d76'],122,159,281,351587,10,0,1,1,1724
2f39adbb2649846ed3d53d103725b227a927dbd7,0,Lahiru Gunathilake,2011-10-11 14:12:14+00:00,['747ce65d72789a8e25b60fb9be1fd76417aa80a2'],6,3,9,351596,2,0,0,0,1724
d98a2639e8502d5a383d3ee061181e7e7dec7b62,1,Lahiru Gunathilake,2011-10-11 14:12:21+00:00,['2f39adbb2649846ed3d53d103725b227a927dbd7'],29,50,79,351675,2,0,1,1,1724
f63ee64ed45df8f6e58ad5bc029fb74d6ca63c85,1,Lahiru Gunathilake,2011-10-11 14:18:50+00:00,['d98a2639e8502d5a383d3ee061181e7e7dec7b62'],396,1207,1603,353278,14,0.628318584,0.798230088,0.978761062,1727
36488da9c5f94dcd06110cdab8752d4031b67a2d,1,Lahiru Gunathilake,2011-10-11 15:32:46+00:00,['f63ee64ed45df8f6e58ad5bc029fb74d6ca63c85'],21,156,177,353455,6,0,0,0.722222222,1727
b8fd2e9f2d095cc023df9cb0dbcb8b27b686df6b,1,Patanachai Tangchaisin,2011-10-11 16:57:06+00:00,['36488da9c5f94dcd06110cdab8752d4031b67a2d'],512,475,987,354442,17,1,1,0.25,1727
59c594029fe9790d1343c0a9efcb55c93019b275,1,Lahiru Gunathilake,2011-10-11 18:02:44+00:00,['b8fd2e9f2d095cc023df9cb0dbcb8b27b686df6b'],178,403,581,355023,6,0,0,1,1727
4757d6a67245b228bd7d5f63b3a30953f8b2a9da,1,Patanachai Tangchaisin,2011-10-11 18:17:48+00:00,['59c594029fe9790d1343c0a9efcb55c93019b275'],10,15,25,355048,2,,,,1727
5551e4ad7fe77f6fef3ec8abbb5ecb2d157e718e,1,Patanachai Tangchaisin,2011-10-11 18:33:02+00:00,['4757d6a67245b228bd7d5f63b3a30953f8b2a9da'],2,84,86,355134,2,0.183333333,0.183333333,1,1728
48c6fe123ea06152a618bf0aed099f4da45aa3d1,0,Patanachai Tangchaisin,2011-10-11 20:21:22+00:00,['5551e4ad7fe77f6fef3ec8abbb5ecb2d157e718e'],13,6,19,355153,1,,,,1728
7c59d4c0f87ae0683d5170636e93d485c9eeca13,0,Patanachai Tangchaisin,2011-10-11 20:21:24+00:00,['48c6fe123ea06152a618bf0aed099f4da45aa3d1'],6,0,6,355159,1,,,,1728
8ffce103f7cd950e945d68e5d595d97427a99c38,0,Patanachai Tangchaisin,2011-10-11 20:22:37+00:00,['7c59d4c0f87ae0683d5170636e93d485c9eeca13'],575,638,1213,356372,4,0.068181818,0.068181818,1,1729
035f9fc4cea0a2ef3fb1d3dda67129985308661a,0,Patanachai Tangchaisin,2011-10-11 20:22:56+00:00,['8ffce103f7cd950e945d68e5d595d97427a99c38'],87,50,137,356509,1,,,,1729
bd822fa3500aa9ab0505975b6560dc4e5b589b22,0,Patanachai Tangchaisin,2011-10-11 20:33:06+00:00,['035f9fc4cea0a2ef3fb1d3dda67129985308661a'],238,0,238,356747,4,0.931818182,0.931818182,0,1729
eee284190ac1ef67ca27ab77e1dadf1f639f85a5,0,Patanachai Tangchaisin,2011-10-11 21:16:58+00:00,['bd822fa3500aa9ab0505975b6560dc4e5b589b22'],384,366,750,357497,1,,,,1729
1a2d68c880d2971576c6c97a2dfc59ae6538dfe7,0,Patanachai Tangchaisin,2011-10-12 04:09:19+00:00,['eee284190ac1ef67ca27ab77e1dadf1f639f85a5'],1286,232,1518,359015,6,0.514606742,0.462921348,0.123595506,1729
974942dbfc5d98b40b024228efb769b29429514f,0,Lahiru Gunathilake,2011-10-12 14:08:30+00:00,['1a2d68c880d2971576c6c97a2dfc59ae6538dfe7'],6,411,417,359432,5,1,1,1,1730
87e4564b1970b01191d05fc1769a289af41e61a1,0,Lahiru Gunathilake,2011-10-12 15:09:02+00:00,['974942dbfc5d98b40b024228efb769b29429514f'],54,11,65,359497,5,,,,1731
e31561a678a95a18756150934a336992fc7cb790,0,Lahiru Gunathilake,2011-10-12 15:22:37+00:00,['87e4564b1970b01191d05fc1769a289af41e61a1'],0,33,33,359530,3,,,,1731
7753f7c04438b17f355e9687b20c1ade141f6237,0,Patanachai Tangchaisin,2011-10-12 21:57:23+00:00,['e31561a678a95a18756150934a336992fc7cb790'],126,208,334,359864,25,0.717948718,1,1,1733
4a75889652de3bd7d1b6fa2b8b93a71a5d4f3bd4,0,Patanachai Tangchaisin,2011-10-12 22:01:40+00:00,['7753f7c04438b17f355e9687b20c1ade141f6237'],128,124,252,360116,2,,,,1733
aa06178f967a69bb2a5300853ebeb9dc1ed2d640,1,Patanachai Tangchaisin,2011-10-12 22:10:49+00:00,['4a75889652de3bd7d1b6fa2b8b93a71a5d4f3bd4'],9,11,20,360136,2,1,1,1,1733
b8b27fa3b28c9e44c67efdf25ee06c2a70141828,0,Lahiru Gunathilake,2011-10-12 22:48:19+00:00,['aa06178f967a69bb2a5300853ebeb9dc1ed2d640'],57,137,194,360330,6,0.224489796,0.183673469,1,1733
08d4cd059e8fce508d12eb74fa5fdd7e74216277,0,Patanachai Tangchaisin,2011-10-12 23:07:46+00:00,['b8b27fa3b28c9e44c67efdf25ee06c2a70141828'],38,3,41,360371,1,1,1,0,1733
0cc599bd56cdabadb7eaf9f7d1251cc1437d96f8,0,Lahiru Gunathilake,2011-10-13 00:05:23+00:00,['08d4cd059e8fce508d12eb74fa5fdd7e74216277'],3,31,34,360405,2,0,0,1,1733
5aee0d81f9014806dac760f4cd98a5dafa5f8387,0,Lahiru Gunathilake,2011-10-13 13:49:44+00:00,['0cc599bd56cdabadb7eaf9f7d1251cc1437d96f8'],1,1,2,360407,1,0,0,0,1733
dac0cd22612b576d6d6d0d54dc536357f195e6dd,0,Lahiru Gunathilake,2011-10-13 14:09:33+00:00,['5aee0d81f9014806dac760f4cd98a5dafa5f8387'],19,1,20,360427,2,0.125,0,0,1733
d540201ecf9b9e705fdd73fa33548995451e2a74,0,Lahiru Gunathilake,2011-10-13 16:22:19+00:00,['dac0cd22612b576d6d6d0d54dc536357f195e6dd'],7,20,27,360454,5,1,0,1,1733
24c1e320bfe87ea34dbb1ae702c8bac883da7d2c,0,Patanachai Tangchaisin,2011-10-13 17:11:54+00:00,['d540201ecf9b9e705fdd73fa33548995451e2a74'],4,4,8,360462,2,,,,1733
447a34c6d6a2239bc2a7676537342ed29db7138e,0,Patanachai Tangchaisin,2011-10-13 17:25:21+00:00,['24c1e320bfe87ea34dbb1ae702c8bac883da7d2c'],0,4,4,360466,1,1,1,0,1733
fdffe787e5549127e29f67b7a901ff47c267d6dc,0,Patanachai Tangchaisin,2011-10-13 17:39:53+00:00,['447a34c6d6a2239bc2a7676537342ed29db7138e'],1,1,2,360468,1,,,,1733
028dc777f37f14709c56c433e94709dd13c99e14,0,Patanachai Tangchaisin,2011-10-13 17:46:07+00:00,['fdffe787e5549127e29f67b7a901ff47c267d6dc'],1,3,4,360472,1,0,1,1,1733
dd1ca9a08dfc890b2fc24fc89383d12c83db915c,0,Patanachai Tangchaisin,2011-10-13 19:13:12+00:00,['028dc777f37f14709c56c433e94709dd13c99e14'],1,1,2,360474,1,,,,1733
4d6056cc020eaffb1efd4a145b52ce33b60ba57c,0,Patanachai Tangchaisin,2011-10-13 23:47:11+00:00,['dd1ca9a08dfc890b2fc24fc89383d12c83db915c'],0,22,22,360496,1,,,,1734
bb7f3db4dacc69632092e8fbc79a440ef1568e2a,0,Patanachai Tangchaisin,2011-10-14 00:02:05+00:00,['4d6056cc020eaffb1efd4a145b52ce33b60ba57c'],0,22,22,360518,1,,,,1735
229f4899739a5582b642f803742e59bdbf3eafbe,0,Patanachai Tangchaisin,2011-10-14 00:03:06+00:00,['bb7f3db4dacc69632092e8fbc79a440ef1568e2a'],22,0,22,360540,1,,,,1735
992cb9f19150c419c25c584749ef943cfb106d92,0,Patanachai Tangchaisin,2011-10-14 01:08:32+00:00,['229f4899739a5582b642f803742e59bdbf3eafbe'],22,0,22,360562,1,,,,1735
1f7718fcb8d3b9af142962098e29acf988e9c4f1,0,Patanachai Tangchaisin,2011-10-14 01:09:26+00:00,['992cb9f19150c419c25c584749ef943cfb106d92'],0,22,22,360584,1,,,,1736
eff3b35d66ac5124d2ff309adea7f6b40e5c9504,0,Lahiru Gunathilake,2011-10-14 03:11:39+00:00,['1f7718fcb8d3b9af142962098e29acf988e9c4f1'],138,131,269,360853,4,1,0,0,1736
99ffe1c12841ba61fbeda5babbe72bef94b9b2e9,0,Suresh Marru,2011-10-16 15:27:31+00:00,['eff3b35d66ac5124d2ff309adea7f6b40e5c9504'],14340,0,14340,375193,68,0.559112825,0.295274831,0.194792671,1736
131d9a3fa85fbdb134bb0a537a2853899d051d35,0,Suresh Marru,2011-10-17 01:14:07+00:00,['99ffe1c12841ba61fbeda5babbe72bef94b9b2e9'],4252,1718,5970,381163,36,0.632905138,0.327075099,0.059288538,1737
9d235821988567b034b8962af4b920d4e31e0d84,0,Patanachai Tangchaisin,2011-10-17 22:26:55+00:00,['131d9a3fa85fbdb134bb0a537a2853899d051d35'],318,95,413,381576,7,,,,1737
da209f8803cbbe22eb9b9d411771bc56d7aa5166,0,Patanachai Tangchaisin,2011-10-17 22:28:47+00:00,['9d235821988567b034b8962af4b920d4e31e0d84'],1,1,2,381578,2,,,,1737
ec8b5ddd42449f56bbda16401463e48eac48864f,0,Patanachai Tangchaisin,2011-10-17 23:01:40+00:00,['da209f8803cbbe22eb9b9d411771bc56d7aa5166'],1,4,5,381583,1,,,,1737
804c8c9c13f9d4049e825c72d26d384ba886c84f,0,Suresh Marru,2011-10-17 23:35:58+00:00,['ec8b5ddd42449f56bbda16401463e48eac48864f'],0,5,5,381588,1,,,,1737
575f4955aeba55467402938d2bb1ec9a37f9f1da,0,Chathura Herath,2011-10-18 04:26:56+00:00,['804c8c9c13f9d4049e825c72d26d384ba886c84f'],898,915,1813,383401,1,0.875,0.875,0.5625,1737
17ac1699e824bced1df1b94e1e2218217e59d636,0,Chathura Herath,2011-10-18 04:27:12+00:00,['575f4955aeba55467402938d2bb1ec9a37f9f1da'],472,0,472,383873,1,0.978527607,0.665644172,0.812883436,1737
9c4321107beeba26c2c11213876911861887623e,0,Chathura Herath,2011-10-18 04:27:26+00:00,['17ac1699e824bced1df1b94e1e2218217e59d636'],46,0,46,383919,1,0,0,0,1737
761056765b575db1f05fcd3e379e24cf53fa7707,0,Chathura Herath,2011-10-18 04:27:38+00:00,['9c4321107beeba26c2c11213876911861887623e'],46,0,46,383965,1,0,0,0,1737
a9379cf57c51a74dcec73a5f174c56e6496e8488,0,Chathura Herath,2011-10-18 04:27:51+00:00,['761056765b575db1f05fcd3e379e24cf53fa7707'],61,0,61,384026,1,0,0,0.4,1737
fff25dfc8019cca53415590a6440e2bfcf1ace08,0,Chathura Herath,2011-10-18 04:28:03+00:00,['a9379cf57c51a74dcec73a5f174c56e6496e8488'],96,0,96,384122,1,1,0,0,1737
dbea311f32c7e20d03d2910f697a10dd36ab21a3,0,Chathura Herath,2011-10-18 04:28:15+00:00,['fff25dfc8019cca53415590a6440e2bfcf1ace08'],98,0,98,384220,1,,,,1737
4628d1a851d91682a7110541d4e79a02c7415436,0,Chathura Herath,2011-10-18 04:28:27+00:00,['dbea311f32c7e20d03d2910f697a10dd36ab21a3'],267,77,344,384564,1,1,1,0.324675325,1737
b9d6c79291166d79bfbb0cd76a8c448d18e03cf5,0,Chathura Herath,2011-10-18 04:28:38+00:00,['4628d1a851d91682a7110541d4e79a02c7415436'],4,1,5,384569,1,0,0,0,1737
f15dddbbd69d9b3294741c578cf6366ea71028db,0,Chathura Herath,2011-10-18 04:38:12+00:00,['b9d6c79291166d79bfbb0cd76a8c448d18e03cf5'],744,0,744,385313,1,0,0,0.137931034,1737
09447cb39b354f1752a82140612e67e8e4c68cb5,0,Chathura Herath,2011-10-18 04:38:27+00:00,['f15dddbbd69d9b3294741c578cf6366ea71028db'],57,0,57,385370,1,,,,1737
d3c1c9433b7650d8ba41db36051fc943c3602b52,0,Chathura Herath,2011-10-18 04:38:43+00:00,['09447cb39b354f1752a82140612e67e8e4c68cb5'],8,0,8,385378,1,,,,1737
b4973f1be2e2c3d30742ab3cd1783d144710b2a2,0,Chathura Herath,2011-10-18 04:40:41+00:00,['d3c1c9433b7650d8ba41db36051fc943c3602b52'],31,1,32,385410,1,1,0,0,1737
30baacac80916dcf34bc365f7774379cbbe5aab3,0,Chathura Herath,2011-10-18 04:40:57+00:00,['b4973f1be2e2c3d30742ab3cd1783d144710b2a2'],2,0,2,385412,1,1,1,0,1737
8a038a17b3dd5d6e1bf6d96a476c7c2b59caf469,0,Chathura Herath,2011-10-18 04:41:28+00:00,['30baacac80916dcf34bc365f7774379cbbe5aab3'],335,0,335,385747,1,0.86,0.6,0,1737
bebb29ca0ef9edd030116b6264383aa9b4a324bb,0,Chathura Herath,2011-10-18 04:41:40+00:00,['8a038a17b3dd5d6e1bf6d96a476c7c2b59caf469'],122,0,122,385869,1,0.76,0.36,0.4,1737
f098e512152b42813ac29dc107468ab6d626628a,0,Chathura Herath,2011-10-18 04:42:01+00:00,['bebb29ca0ef9edd030116b6264383aa9b4a324bb'],238,0,238,386107,1,0.859813084,0.205607477,0,1737
dcbd3062d0f2715a023157b9e56403537b412676,0,Chathura Herath,2011-10-18 04:42:16+00:00,['f098e512152b42813ac29dc107468ab6d626628a'],2,0,2,386109,1,,,,1737
a667b42e873ba01f8d84233034c89de8541102e9,0,Chathura Herath,2011-10-18 04:42:38+00:00,['dcbd3062d0f2715a023157b9e56403537b412676'],5,0,5,386114,1,,,,1737
41a68b0d67f5c646dcd35b04b03c83384a10fadb,0,Chathura Herath,2011-10-18 04:46:45+00:00,['a667b42e873ba01f8d84233034c89de8541102e9'],0,0,0,386114,0,,,,1737
5817151d7cedadccc20714b76f87187960dba8fa,0,Lahiru Gunathilake,2011-10-18 14:31:48+00:00,['41a68b0d67f5c646dcd35b04b03c83384a10fadb'],6,241,247,386361,2,0.253731343,0.626865672,1,1738
91afbccb0504c65b1281d4cf12ed1dab2c4daf59,0,Lahiru Gunathilake,2011-10-18 14:48:13+00:00,['5817151d7cedadccc20714b76f87187960dba8fa'],22,4,26,386387,2,,,,1738
472c2da4029c88e44d62aa61a7f8c1a75eb4eec8,0,Lahiru Gunathilake,2011-10-18 15:14:46+00:00,['91afbccb0504c65b1281d4cf12ed1dab2c4daf59'],86,12,98,386485,2,,,,1738
05e01a9e8ccf268ada62b735117c01411317fe2d,0,Lahiru Gunathilake,2011-10-18 15:22:22+00:00,['472c2da4029c88e44d62aa61a7f8c1a75eb4eec8'],305,9,314,386799,7,0.857142857,0,0.241071429,1738
395412e91660ffdafbbf7f8517b053e89682017d,0,Lahiru Gunathilake,2011-10-18 16:25:49+00:00,['05e01a9e8ccf268ada62b735117c01411317fe2d'],2,6,8,386807,1,0,1,1,1738
79a513110537df55ad9b7f48f627bf22c5507760,0,Lahiru Gunathilake,2011-10-18 16:37:02+00:00,['395412e91660ffdafbbf7f8517b053e89682017d'],4,11,15,386822,2,,,,1738
ac23404eee160008770dfa72b5fc86de93404735,1,Lahiru Gunathilake,2011-10-18 19:14:32+00:00,['79a513110537df55ad9b7f48f627bf22c5507760'],14,1389,1403,388225,36,0.740740741,0.970625798,0.863346105,1767
037adb156d4dfe3d6e5ef84e1205fb65d9d05f02,0,Suresh Marru,2011-10-19 14:02:07+00:00,['ac23404eee160008770dfa72b5fc86de93404735'],133,854,987,389212,22,0.654069767,0.747093023,0.959302326,1770
65bbe67bb3ad133f4434512f7222701b286d3580,0,Suresh Marru,2011-10-19 14:05:39+00:00,['037adb156d4dfe3d6e5ef84e1205fb65d9d05f02'],509,0,509,389721,1,0.355223881,0.259701493,0.041791045,1770
4cf01e99633cea464a09508ad807b55756032a27,0,Lahiru Gunathilake,2011-10-19 14:54:46+00:00,['65bbe67bb3ad133f4434512f7222701b286d3580'],282,298,580,390301,15,0.90990991,0.315315315,0.900900901,1770
8d3ec460a0c95f0c554a3f7d29b23d7504b81b79,0,Lahiru Gunathilake,2011-10-19 15:37:33+00:00,['4cf01e99633cea464a09508ad807b55756032a27'],565,573,1138,391439,7,,0,,1771
1b500ff4a3be4b3741e2ba80da736196a0ab0124,1,Lahiru Gunathilake,2011-10-19 16:08:30+00:00,['8d3ec460a0c95f0c554a3f7d29b23d7504b81b79'],2,2,4,391443,2,,,,1771
0843927d7aa95ad44d27619807649d98c6cb16ef,0,Lahiru Gunathilake,2011-10-19 16:16:22+00:00,['1b500ff4a3be4b3741e2ba80da736196a0ab0124'],8,9,17,391460,1,0,0,0,1771
90a9e29923ae7f6fb90c3d8ba2e71141757f32db,0,Lahiru Gunathilake,2011-10-19 16:30:21+00:00,['0843927d7aa95ad44d27619807649d98c6cb16ef'],6,461,467,391927,5,0.221088435,0.775510204,0.897959184,1774
d56ff141c2b84d051a1a69ef27bcca273e71a885,1,Lahiru Gunathilake,2011-10-19 20:00:50+00:00,['90a9e29923ae7f6fb90c3d8ba2e71141757f32db'],8,240,248,392175,13,0.557377049,0.967213115,0.868852459,1780
2604f128b1f1d36fa5dc199b35667e421a66dfa5,1,Lahiru Gunathilake,2011-10-19 20:09:50+00:00,['d56ff141c2b84d051a1a69ef27bcca273e71a885'],1,11,12,392187,3,1,1,1,1780
29d4c96d4cb0a17d0af043011ca656204456be17,0,Lahiru Gunathilake,2011-10-20 02:03:23+00:00,['2604f128b1f1d36fa5dc199b35667e421a66dfa5'],86,146,232,392419,10,1,1,1,1780
6adbd24cb2504fcab3a72a478e502ffb0018f5ef,0,Suresh Marru,2011-10-20 03:33:34+00:00,['29d4c96d4cb0a17d0af043011ca656204456be17'],4,0,4,392423,1,,,,1780
49f42f236576a95cb65b0c24b240fa47201874cf,0,Lahiru Gunathilake,2011-10-20 10:33:02+00:00,['6adbd24cb2504fcab3a72a478e502ffb0018f5ef'],0,160,160,392583,1,1,1,0.88372093,1781
55dbb7edff2b1357d46b3d7ad44a26a468a6a287,0,Lahiru Gunathilake,2011-10-20 10:33:34+00:00,['49f42f236576a95cb65b0c24b240fa47201874cf'],14,27,41,392624,2,,,,1781
c2143f4000297b16061b7c2dd198266ff487977e,0,Lahiru Gunathilake,2011-10-20 10:34:00+00:00,['55dbb7edff2b1357d46b3d7ad44a26a468a6a287'],0,1,1,392625,1,,,,1781
e1cbd95a494db23d881ec4e571c97b9a9c96f956,0,Suresh Marru,2011-10-20 12:46:22+00:00,['c2143f4000297b16061b7c2dd198266ff487977e'],328,502,830,393455,1,,,,1781
c4871764bb1b6d076c0abd387a394f5917cef362,0,Lahiru Gunathilake,2011-10-20 19:06:24+00:00,['e1cbd95a494db23d881ec4e571c97b9a9c96f956'],523,780,1303,394758,4,0.898305085,1,0.700564972,1783
1f98a29943597b213e5faf7db3363ccce6058b96,0,Lahiru Gunathilake,2011-10-20 19:38:03+00:00,['c4871764bb1b6d076c0abd387a394f5917cef362'],872,0,872,395630,4,0.101694915,0,0.299435028,1783
4618ae373022c5c23e98bf0257cb3749548b13de,0,Lahiru Gunathilake,2011-10-20 19:42:28+00:00,['1f98a29943597b213e5faf7db3363ccce6058b96'],0,1389,1389,397019,5,0.898305085,1,0.700564972,1788
aa98c864439053fc0dbc60ad5ed3228769e08004,0,Lahiru Gunathilake,2011-10-20 19:43:31+00:00,['4618ae373022c5c23e98bf0257cb3749548b13de'],505,0,505,397524,1,,,,1788
8083574ac7014d49ed423cf38cb953884dcc4181,0,Lahiru Gunathilake,2011-10-20 19:48:31+00:00,['aa98c864439053fc0dbc60ad5ed3228769e08004'],2,2,4,397528,3,,,,1788
3ad044951456f5ca693538eb3b8d30871bb6b997,0,Lahiru Gunathilake,2011-10-20 20:14:24+00:00,['8083574ac7014d49ed423cf38cb953884dcc4181'],160,0,160,397688,1,0,0,0.11627907,1788
3e7774f2c38f6f0523912152203af3027ea5cb5a,0,Lahiru Gunathilake,2011-10-20 20:53:21+00:00,['3ad044951456f5ca693538eb3b8d30871bb6b997'],15,15,30,397718,1,0,0,0,1788
83b3b15e1056ed48ee8e17119c2604cb786fe5ad,0,Lahiru Gunathilake,2011-10-20 21:59:53+00:00,['3e7774f2c38f6f0523912152203af3027ea5cb5a'],1,75,76,397794,3,1,1,1,1790
b0d24e4536b3b162c82f3f64191c575d22c0e62f,0,Lahiru Gunathilake,2011-10-20 22:07:24+00:00,['83b3b15e1056ed48ee8e17119c2604cb786fe5ad'],5,260,265,398059,2,0.899441341,1,0.703910615,1791
49001a00e5fb81655521d2a82603da2800051c5c,0,Lahiru Gunathilake,2011-10-20 22:16:42+00:00,['b0d24e4536b3b162c82f3f64191c575d22c0e62f'],260,0,260,398319,1,0.100558659,0,0.296089385,1791
7f420b977f71706d03aad8f93acf9543f657c1bc,0,Lahiru Gunathilake,2011-10-20 22:17:34+00:00,['49001a00e5fb81655521d2a82603da2800051c5c'],0,71,71,398390,1,0,0,1,1791
006560a4b7d2723a57b9085c61e3c3e027ac2d59,0,Lahiru Gunathilake,2011-10-20 22:27:32+00:00,['7f420b977f71706d03aad8f93acf9543f657c1bc'],23,21,44,398434,2,1,1,1,1791
0cf7bdc80150891f23767e88c8a6ce93712af0b1,0,Lahiru Gunathilake,2011-10-20 22:53:23+00:00,['006560a4b7d2723a57b9085c61e3c3e027ac2d59'],0,7,7,398441,1,,,,1791
6cb69b0519178a4f72df761c4a164a7cae147f16,0,Lahiru Gunathilake,2011-10-20 23:56:29+00:00,['0cf7bdc80150891f23767e88c8a6ce93712af0b1'],47,110,157,398598,8,0.090909091,0.454545455,1,1791
ff2190d878633cd7428b9d30d326ac5b6bf3752b,1,Lahiru Gunathilake,2011-10-21 13:11:14+00:00,['6cb69b0519178a4f72df761c4a164a7cae147f16'],9,8,17,398615,2,,0,,1791
3924ea0510c26380bc2c1fd171bc9dac2608bc0d,0,Lahiru Gunathilake,2011-10-21 15:25:35+00:00,['ff2190d878633cd7428b9d30d326ac5b6bf3752b'],38,113,151,398766,6,0.2,0.6,0.466666667,1791
f814e3ba0477ef27c9a5b5513d17290312211efd,1,Lahiru Gunathilake,2011-10-21 16:10:55+00:00,['3924ea0510c26380bc2c1fd171bc9dac2608bc0d'],39,86,125,398891,5,0.428571429,0.571428571,0.666666667,1791
7dc73bc5b2571fab5f3fc8a5ff47d7943c560187,1,Lahiru Gunathilake,2011-10-21 19:01:28+00:00,['f814e3ba0477ef27c9a5b5513d17290312211efd'],133,950,1083,399974,26,0.798922801,0.879712747,0.937163375,1796
dcc08766a45149c5147149a2edc1a6b9f29f4080,0,Lahiru Gunathilake,2011-10-21 19:33:24+00:00,['7dc73bc5b2571fab5f3fc8a5ff47d7943c560187'],42,11,53,400027,3,1,1,1,1796
94da078743a9d0273573cbc34f5c3c1071e1cfbe,0,Lahiru Gunathilake,2011-10-21 19:41:46+00:00,['dcc08766a45149c5147149a2edc1a6b9f29f4080'],2,1,3,400030,2,,,,1796
f078b99ab4ee6e86318726a6198bf60b64151c07,0,Lahiru Gunathilake,2011-10-21 20:10:18+00:00,['94da078743a9d0273573cbc34f5c3c1071e1cfbe'],1,1,2,400032,1,,,,1796
6a1be28744f74e4132ef5301dabf9b2cfd2e320b,1,Suresh Marru,2011-10-22 19:29:52+00:00,['f078b99ab4ee6e86318726a6198bf60b64151c07'],9645,9634,19279,419311,299,0,0,1,1796
546a6d968ee601f8143c3d756f9de4114437a4d4,0,Suresh Marru,2011-10-23 12:05:13+00:00,['6a1be28744f74e4132ef5301dabf9b2cfd2e320b'],98,30,128,419439,14,0.75,0.25,0,1796
fc592ac71cf5f7c80ba4301c11be5b02c44a637c,0,Lahiru Gunathilake,2011-10-23 19:28:24+00:00,['546a6d968ee601f8143c3d756f9de4114437a4d4'],17,759,776,420215,11,0.142493639,0.185750636,0.554707379,1802
ce70a8789a35488a543ca885d384ac58e5f29a30,0,Lahiru Gunathilake,2011-10-23 20:25:13+00:00,['fc592ac71cf5f7c80ba4301c11be5b02c44a637c'],54,68,122,420337,1,1,1,1,1802
7f5094eeea05b5785bd1e6689804f9b0ec8fc358,0,Lahiru Gunathilake,2011-10-24 15:36:58+00:00,['ce70a8789a35488a543ca885d384ac58e5f29a30'],12,5,17,420354,1,1,0.166666667,0,1802
bc0ab4248351c01d9f69243663a1df3db3b9563d,1,Lahiru Gunathilake,2011-10-24 15:54:46+00:00,['7f5094eeea05b5785bd1e6689804f9b0ec8fc358'],0,19,19,420373,2,1,1,0,1802
0df1d3fbc72a3cdb524038f801633ce058e570d0,0,Lahiru Gunathilake,2011-10-24 15:59:30+00:00,['bc0ab4248351c01d9f69243663a1df3db3b9563d'],62,74,136,420509,3,0,0.92,0.76,1802
2e2803a52d2cb158dd9af4b5f948b89fd254364d,0,Lahiru Gunathilake,2011-10-24 16:29:05+00:00,['0df1d3fbc72a3cdb524038f801633ce058e570d0'],80,97,177,420686,20,,,,1802
aca6b460f413a08c439dc1bf367d10aa18556d7f,0,Lahiru Gunathilake,2011-10-24 17:15:53+00:00,['2e2803a52d2cb158dd9af4b5f948b89fd254364d'],1,1,2,420688,1,,,,1802
83d3f1ff12fcefb16b6ce550ba3cfc40797423fc,0,Lahiru Gunathilake,2011-10-24 17:36:06+00:00,['aca6b460f413a08c439dc1bf367d10aa18556d7f'],66,66,132,420820,19,,,,1802
7b6fed9b0f1a74cc062ebc20b64dd04dda5586da,1,Patanachai Tangchaisin,2011-10-24 17:48:53+00:00,['83d3f1ff12fcefb16b6ce550ba3cfc40797423fc'],848,946,1794,422614,8,0,1,0.545454545,1803
797895d148626c4584056440761a7abc45510936,0,Lahiru Gunathilake,2011-10-24 18:03:56+00:00,['7b6fed9b0f1a74cc062ebc20b64dd04dda5586da'],0,7,7,422621,1,,,,1803
451b20005df56a22e93a1fe9ae3a3449a0daef86,0,Patanachai Tangchaisin,2011-10-24 18:12:16+00:00,['797895d148626c4584056440761a7abc45510936'],62,62,124,422745,3,,,,1803
2d383956b23c5e3d12cf88eb60b6008619935399,0,Patanachai Tangchaisin,2011-10-24 18:17:34+00:00,['451b20005df56a22e93a1fe9ae3a3449a0daef86'],0,66,66,422811,1,0,1,1,1804
ba4db24b125afc48118c554e1c7675765423ef88,0,Patanachai Tangchaisin,2011-10-24 18:19:50+00:00,['2d383956b23c5e3d12cf88eb60b6008619935399'],0,24,24,422835,1,,,,1804
5787b0fbc2ed3f7db8bd0ee27778c78886aa172b,0,Lahiru Gunathilake,2011-10-24 18:23:47+00:00,['ba4db24b125afc48118c554e1c7675765423ef88'],303,130,433,423268,1,,,,1804
18a4fc3465f1c6a22b6161c31df99d251ae3d259,1,Patanachai Tangchaisin,2011-10-24 19:11:28+00:00,['5787b0fbc2ed3f7db8bd0ee27778c78886aa172b'],129,200,329,423597,10,1,1,1,1804
53bcd0e1dab2ec2df733737dc2e310d407ce5f21,0,Patanachai Tangchaisin,2011-10-24 19:14:22+00:00,['18a4fc3465f1c6a22b6161c31df99d251ae3d259'],7,6,13,423610,1,1,0,0,1804
943bd6408f1c3e3a7ea955e31cf6358a3efaa3ea,0,Lahiru Gunathilake,2011-10-24 19:21:19+00:00,['53bcd0e1dab2ec2df733737dc2e310d407ce5f21'],0,1,1,423611,1,0,1,0,1804
952597654896ee9be709ccd68747de04490abb3f,0,Patanachai Tangchaisin,2011-10-24 19:31:50+00:00,['943bd6408f1c3e3a7ea955e31cf6358a3efaa3ea'],2,8,10,423621,2,,,,1804
ed3e102f30474f3f6623ef999024ddad5dd617d4,0,Patanachai Tangchaisin,2011-10-24 19:34:14+00:00,['952597654896ee9be709ccd68747de04490abb3f'],16,5,21,423642,1,1,1,0,1804
420af389c786bdccda81a53448519f8d9e00b05a,1,Patanachai Tangchaisin,2011-10-24 20:39:20+00:00,['ed3e102f30474f3f6623ef999024ddad5dd617d4'],19,63,82,423724,3,1,1,1,1804
53175f64d91cf9f4cc997dcc8174490b186cc6f9,0,Patanachai Tangchaisin,2011-10-25 02:45:09+00:00,['420af389c786bdccda81a53448519f8d9e00b05a'],66,15,81,423805,6,0,0,0,1804
52501a216958b2b082a4eca97df5162b9edeb7d0,0,Patanachai Tangchaisin,2011-10-25 02:45:51+00:00,['53175f64d91cf9f4cc997dcc8174490b186cc6f9'],42,1,43,423848,3,0,0,0,1804
35fa811718a78bd1fce503ee7ff1fbd111566ec4,0,Patanachai Tangchaisin,2011-10-25 03:04:51+00:00,['52501a216958b2b082a4eca97df5162b9edeb7d0'],89,53,142,423990,14,0.857142857,0.80952381,0,1804
48cf8315eb306c5a2095b1d47e10d1e3166f63ac,1,Patanachai Tangchaisin,2011-10-25 03:27:21+00:00,['35fa811718a78bd1fce503ee7ff1fbd111566ec4'],12,98,110,424100,3,0,0,1,1804
2a3d85383ae877e4c3919d3d3ce668b3fbc67dd7,0,Lahiru Gunathilake,2011-10-25 15:40:13+00:00,['48cf8315eb306c5a2095b1d47e10d1e3166f63ac'],12,50,62,424162,3,0.551724138,0.448275862,1,1804
de0cd86fc56088fd61abf0bf52420891b6f251d8,0,Lahiru Gunathilake,2011-10-25 15:43:24+00:00,['2a3d85383ae877e4c3919d3d3ce668b3fbc67dd7'],1,1,2,424164,1,,,,1804
8305581024d530a41aed7e362b93aea4ca63ad5a,0,Lahiru Gunathilake,2011-10-25 16:12:20+00:00,['de0cd86fc56088fd61abf0bf52420891b6f251d8'],2,2,4,424168,1,1,0,1,1804
531a99f6dabb0ed231c0eace5220bb18d8d4ab0f,0,Lahiru Gunathilake,2011-10-25 16:34:24+00:00,['8305581024d530a41aed7e362b93aea4ca63ad5a'],9,36,45,424213,2,0,1,0,1804
d4c274d99b7583b0f83f4996f5a9262edb333a90,0,Lahiru Gunathilake,2011-10-25 16:35:22+00:00,['531a99f6dabb0ed231c0eace5220bb18d8d4ab0f'],3,3,6,424219,2,0,0,0,1804
56be945992ab7be84f3b333ae75e66637b8fd70c,0,Patanachai Tangchaisin,2011-10-25 19:01:28+00:00,['d4c274d99b7583b0f83f4996f5a9262edb333a90'],148,165,313,424532,4,0.6875,1,1,1804
4c1ae363bb6d29021bae1654c5cb954f37a3ed85,0,Patanachai Tangchaisin,2011-10-25 19:03:05+00:00,['56be945992ab7be84f3b333ae75e66637b8fd70c'],4,0,4,424536,1,1,1,0,1804
83c01630e05266ef8d9a541bd235d9a75ae7cb73,0,Suresh Marru,2011-10-25 20:04:06+00:00,['4c1ae363bb6d29021bae1654c5cb954f37a3ed85'],0,23,23,424559,1,1,1,1,1804
d2cad961212393786016847a6a6e5c26ae98d455,0,Lahiru Gunathilake,2011-10-25 20:43:53+00:00,['83c01630e05266ef8d9a541bd235d9a75ae7cb73'],18,18,36,424595,1,0,0,0,1804
6496f8d5c698facf0baff9a3f44df196380d7f13,0,Lahiru Gunathilake,2011-10-25 21:39:32+00:00,['d2cad961212393786016847a6a6e5c26ae98d455'],23,0,23,424618,1,,,,1804
420d10fb2cdbe9304dc775270fbcc938d31dc2d5,0,Lahiru Gunathilake,2011-10-25 21:52:47+00:00,['6496f8d5c698facf0baff9a3f44df196380d7f13'],306,998,1304,425922,28,1,1,0.752321981,1821
5a671c00e3cb23c9a67d11e07bb948ba88a51135,0,Lahiru Gunathilake,2011-10-25 22:57:19+00:00,['420d10fb2cdbe9304dc775270fbcc938d31dc2d5'],121,364,485,426407,14,0.612244898,0.727891156,0.850340136,1826
ed41ff9bc63122b02fb534440273908ac447df81,0,Patanachai Tangchaisin,2011-10-25 23:22:21+00:00,['5a671c00e3cb23c9a67d11e07bb948ba88a51135'],512,231,743,427150,22,0.013245033,0,0,1826
b868ca17a4ee64e7d8ef14b50fb1da2890fe3eb5,0,Patanachai Tangchaisin,2011-10-25 23:32:36+00:00,['ed41ff9bc63122b02fb534440273908ac447df81'],22,22,44,427194,11,,,,1826
5174fa692f8066522a4188241834f1fb13c94f63,0,Lahiru Gunathilake,2011-10-25 23:51:24+00:00,['b868ca17a4ee64e7d8ef14b50fb1da2890fe3eb5'],89,62,151,427345,6,0.857142857,0.857142857,1,1826
4540266592d40905b317954273c851f700ce26eb,0,Lahiru Gunathilake,2011-10-26 13:26:25+00:00,['5174fa692f8066522a4188241834f1fb13c94f63'],1,1,2,427347,1,,,,1826
e50bd742d89307ff013480dc4bb14ac5eecbfe6d,0,Patanachai Tangchaisin,2011-10-26 17:26:19+00:00,['4540266592d40905b317954273c851f700ce26eb'],825,161,986,428333,28,0.221428571,0.021428571,0.035714286,1827
cda1a044b132fa18b19732738f958ae850fcba7e,0,Patanachai Tangchaisin,2011-10-26 21:02:44+00:00,['e50bd742d89307ff013480dc4bb14ac5eecbfe6d'],13,89,102,428435,5,0.472222222,0.138888889,1,1828
41f3caca91df2a079a2d2950e10d2b8b2acec75f,0,Patanachai Tangchaisin,2011-10-26 21:11:00+00:00,['cda1a044b132fa18b19732738f958ae850fcba7e'],2,0,2,428437,1,,,,1828
116e10b2c90a80d00d1e7e398bb83fece3b0186c,0,Lahiru Gunathilake,2011-10-27 13:24:53+00:00,['41f3caca91df2a079a2d2950e10d2b8b2acec75f'],11,19,30,428467,2,0.75,0.75,1,1828
f75a16d87761a991fe94d2665aa416a83f99b610,0,Lahiru Gunathilake,2011-10-27 13:34:15+00:00,['116e10b2c90a80d00d1e7e398bb83fece3b0186c'],3,346,349,428816,4,0,1,1,1831
a4246e2875d0ffea9990c2e84868711fe0184150,0,Lahiru Gunathilake,2011-10-27 13:49:41+00:00,['f75a16d87761a991fe94d2665aa416a83f99b610'],9,9,18,428834,1,,,,1831
538c31594f0513b76d98135543766943cbd49612,0,Lahiru Gunathilake,2011-10-27 15:14:37+00:00,['a4246e2875d0ffea9990c2e84868711fe0184150'],346,3,349,429183,4,1,0,0,1831
440efbdeac55e06eb82365f85cabb4af95265e1b,0,Lahiru Gunathilake,2011-10-27 15:18:41+00:00,['538c31594f0513b76d98135543766943cbd49612'],3,346,349,429532,4,0,1,1,1834
3464c2a437dab90741b2302bfbc33cadf99ea679,0,Lahiru Gunathilake,2011-10-27 16:26:26+00:00,['440efbdeac55e06eb82365f85cabb4af95265e1b'],23,18,41,429573,13,,,,1834
452a18c1a00f32f4017af1fd21cf947d739f5a3f,0,Lahiru Gunathilake,2011-10-27 18:56:48+00:00,['3464c2a437dab90741b2302bfbc33cadf99ea679'],0,53,53,429626,1,1,1,1,1835
0e7552e522e75d4dd4337446ae5a3a509c9de945,0,Lahiru Gunathilake,2011-10-27 19:05:49+00:00,['452a18c1a00f32f4017af1fd21cf947d739f5a3f'],12,17,29,429655,4,0,0,0,1835
3b15882b4c0dd5f12d907937c4b7d9b8ad1db637,0,Lahiru Gunathilake,2011-10-27 19:41:43+00:00,['0e7552e522e75d4dd4337446ae5a3a509c9de945'],38,38,76,429731,21,,,,1835
72a7c15b74870455eecbb96975e0de4de7ff70ca,0,Lahiru Gunathilake,2011-10-27 21:08:57+00:00,['3b15882b4c0dd5f12d907937c4b7d9b8ad1db637'],2,10,12,429743,2,,,,1835
ca542d8c19696af02a1e56732497e0b537c3e169,0,Patanachai Tangchaisin,2011-10-27 21:38:59+00:00,['72a7c15b74870455eecbb96975e0de4de7ff70ca'],533,818,1351,431094,24,0,0,0,1839
9a2185fa22821cea71f68f6909be17d0c23d9461,0,Patanachai Tangchaisin,2011-10-27 21:52:44+00:00,['ca542d8c19696af02a1e56732497e0b537c3e169'],8,8,16,431110,4,,,,1839
27f90326386037ebd32a0a232eb75125931d15ad,0,Lahiru Gunathilake,2011-10-28 10:24:53+00:00,['9a2185fa22821cea71f68f6909be17d0c23d9461'],118,104,222,431332,9,1,0.166666667,0,1839
856c77e74b2afb22596621b190d78d57b5bd075b,0,Lahiru Gunathilake,2011-10-28 12:02:08+00:00,['27f90326386037ebd32a0a232eb75125931d15ad'],86,86,172,431504,1,,,,1839
d364592c0835da453b6c557d349332d20464d91d,0,Lahiru Gunathilake,2011-10-28 12:29:06+00:00,['856c77e74b2afb22596621b190d78d57b5bd075b'],1,3,4,431508,2,,,,1839
3f5f0f73ddbff27029a932463f7ccb34d82f7da7,0,Patanachai Tangchaisin,2011-10-28 16:55:13+00:00,['d364592c0835da453b6c557d349332d20464d91d'],1,79,80,431588,1,0,0,1,1839
1e4bdb6bcdfaf6e37105150a358a99bb8e940955,0,Lahiru Gunathilake,2011-10-28 17:29:17+00:00,['3f5f0f73ddbff27029a932463f7ccb34d82f7da7'],32,86,118,431706,4,0.014925373,0.253731343,0.970149254,1839
94ad58c9b6833492e3acc34bfd37fbb0954f9229,0,Lahiru Gunathilake,2011-10-28 18:17:44+00:00,['1e4bdb6bcdfaf6e37105150a358a99bb8e940955'],27,77,104,431810,10,0.433333333,0.333333333,1,1839
899729a6e9854efd0fc5196e3ff535fc184bc8e8,0,Lahiru Gunathilake,2011-10-28 19:31:22+00:00,['94ad58c9b6833492e3acc34bfd37fbb0954f9229'],18,85,103,431913,6,0.133333333,0.511111111,1,1839
2391b23654a90d8d0d42e846b29a8e2d4dd094ab,0,Lahiru Gunathilake,2011-10-28 20:14:52+00:00,['899729a6e9854efd0fc5196e3ff535fc184bc8e8'],5,18,23,431936,1,0,1,0.615384615,1839
3fd156ad620bd7354a5dc24ac0f3fd0973c66d70,0,Lahiru Gunathilake,2011-10-29 15:43:53+00:00,['2391b23654a90d8d0d42e846b29a8e2d4dd094ab'],40,10,50,431986,4,0,0,0,1839
2efdcadeaa276f7b93d06f91b925458f7b9d9cdc,0,Lahiru Gunathilake,2011-10-29 16:23:20+00:00,['3fd156ad620bd7354a5dc24ac0f3fd0973c66d70'],5,1600,1605,433591,76,,,,1839
532ddffa945043b21a8464e452aea7de80941f21,0,Lahiru Gunathilake,2011-10-30 01:58:36+00:00,['2efdcadeaa276f7b93d06f91b925458f7b9d9cdc'],7,11,18,433609,2,0,0,0,1839
d119bb01445804b7daadd10bdef707f1dc0f8e56,0,Lahiru Gunathilake,2011-10-30 03:35:48+00:00,['532ddffa945043b21a8464e452aea7de80941f21'],8,29,37,433646,5,0.5625,0.5625,0,1839
7ddf76caac6b020e2d73ebfbcc0eba39c6769a9f,0,Lahiru Gunathilake,2011-10-30 16:08:51+00:00,['d119bb01445804b7daadd10bdef707f1dc0f8e56'],32,65,97,433743,1,0,1,1,1839
ffa2821dd1a1c6793fd2b898086764dc83a4e905,0,Lahiru Gunathilake,2011-10-30 16:27:54+00:00,['7ddf76caac6b020e2d73ebfbcc0eba39c6769a9f'],1,1,2,433745,1,,,,1839
2b599d949015138bad8108a2024b1677b7eea9ba,0,Suresh Marru,2011-10-30 16:40:59+00:00,['ffa2821dd1a1c6793fd2b898086764dc83a4e905'],101,138,239,433984,7,0,0.272727273,1,1839
b02633077ecd36459118feac36dc474623d3631c,0,Suresh Marru,2011-10-31 06:04:40+00:00,['2b599d949015138bad8108a2024b1677b7eea9ba'],126,1954,2080,436064,11,0.252314815,0.46412037,0.34375,1848
ddd8c34d3e51e3688fdc2799624f39b26d4b233c,0,Suresh Marru,2011-10-31 06:15:01+00:00,['b02633077ecd36459118feac36dc474623d3631c'],226,214,440,436504,9,1,0,0,1848
d68fda81d936a597c79f797ee062f0e410458a5a,0,Suresh Marru,2011-10-31 06:19:31+00:00,['ddd8c34d3e51e3688fdc2799624f39b26d4b233c'],0,139,139,436643,1,0.6,1,1,1849
1719ac04b934332f1485c8676eff6fc0b4d4f703,0,Suresh Marru,2011-10-31 06:48:11+00:00,['d68fda81d936a597c79f797ee062f0e410458a5a'],6542,7151,13693,450336,342,0,0.723502304,1,1849
6f78b6667da6a5b28ff32d468ab5f448ebf17925,0,Lahiru Gunathilake,2011-10-31 14:30:45+00:00,['1719ac04b934332f1485c8676eff6fc0b4d4f703'],2,4,6,450342,1,,,,1849
414499235bccf77a27fc52a3b5975bdb7a0094c1,0,Lahiru Gunathilake,2011-10-31 16:13:39+00:00,['6f78b6667da6a5b28ff32d468ab5f448ebf17925'],2,2,4,450346,2,,,,1849
0bdf761d69af7fafcfa5120d2ea9a88d795eedf6,0,Lahiru Gunathilake,2011-10-31 16:34:45+00:00,['414499235bccf77a27fc52a3b5975bdb7a0094c1'],8,285,293,450639,3,,,,1851
6e875753a2eedcf7976f5d7f56937a93f92aac3b,0,Lahiru Gunathilake,2011-10-31 16:35:45+00:00,['0bdf761d69af7fafcfa5120d2ea9a88d795eedf6'],4,1,5,450644,1,,,,1851
6408dcc8cf9e211b65e1628fbcf5705b4cb179a0,0,Lahiru Gunathilake,2011-10-31 16:54:29+00:00,['6e875753a2eedcf7976f5d7f56937a93f92aac3b'],0,30,30,450674,2,,,,1851
31e3a4a6a304010f4da4012a1b106142a0754c82,0,Suresh Marru,2011-10-31 19:25:19+00:00,['6408dcc8cf9e211b65e1628fbcf5705b4cb179a0'],0,48,48,450722,2,0.448275862,1,1,1852
56857d63d21b24abfa4258171854fec92de862b6,0,Patanachai Tangchaisin,2011-10-31 19:40:03+00:00,['31e3a4a6a304010f4da4012a1b106142a0754c82'],118,76,194,450916,3,1,1,1,1852
948cd5bcdab2607e64643b3319600140c9d99c89,0,Patanachai Tangchaisin,2011-10-31 20:04:39+00:00,['56857d63d21b24abfa4258171854fec92de862b6'],3,17,20,450936,2,1,1,1,1852
80a1daabcb54499bf60ffc056a70314a01ee3d78,0,Patanachai Tangchaisin,2011-10-31 20:11:07+00:00,['948cd5bcdab2607e64643b3319600140c9d99c89'],1,1,2,450938,1,,,,1852
1acf493bd29c98875748534a0ee40dbe37eef251,0,Patanachai Tangchaisin,2011-10-31 20:18:01+00:00,['80a1daabcb54499bf60ffc056a70314a01ee3d78'],0,2,2,450940,1,0,1,1,1852
03bc880aab4f6fe3f98b8d2e406960cfb05b5fc5,0,Patanachai Tangchaisin,2011-10-31 20:31:10+00:00,['1acf493bd29c98875748534a0ee40dbe37eef251'],2,41,43,450983,2,0,0,1,1852
084d12b9d195e8af6c074146392d8c93ad4c9b9d,0,Patanachai Tangchaisin,2011-10-31 20:43:51+00:00,['03bc880aab4f6fe3f98b8d2e406960cfb05b5fc5'],0,7,7,450990,1,1,1,1,1852
a1400a1f936a3df28d1037cc12880d583ad62c92,0,Lahiru Gunathilake,2011-10-31 20:56:37+00:00,['084d12b9d195e8af6c074146392d8c93ad4c9b9d'],6033,5291,11324,462314,340,1,0.115523466,0,1852
34fb029399a35a9c69997e00aa5e98b6dbab8f1d,0,Patanachai Tangchaisin,2011-10-31 21:00:16+00:00,['a1400a1f936a3df28d1037cc12880d583ad62c92'],8,1,9,462323,3,1,1,1,1852
a7318abb23881e7e1c356e306a219dbfc56a1fb0,0,Patanachai Tangchaisin,2011-10-31 21:02:38+00:00,['34fb029399a35a9c69997e00aa5e98b6dbab8f1d'],0,1,1,462324,1,0,1,1,1852
a375c295cd4f35022725c680a9b63b4324d94681,0,Lahiru Gunathilake,2011-11-01 00:46:53+00:00,['a7318abb23881e7e1c356e306a219dbfc56a1fb0'],9,15,24,462348,4,0,0,0.333333333,1852
2159b873292ffec4b7bc59d52e775538eb9f097b,0,Lahiru Gunathilake,2011-11-01 02:48:00+00:00,['a375c295cd4f35022725c680a9b63b4324d94681'],0,496,496,462844,8,0.462184874,1,0.764705882,1860
ee164769d3232ce64bb3f2a88bf66ad2e3ccbd4c,0,Lahiru Gunathilake,2011-11-01 02:52:48+00:00,['2159b873292ffec4b7bc59d52e775538eb9f097b'],0,30,30,462874,2,,,,1860
57c54cb313879bfdf57f0023e215bdd27c0783d0,0,Lahiru Gunathilake,2011-11-01 03:29:27+00:00,['ee164769d3232ce64bb3f2a88bf66ad2e3ccbd4c'],14,70,84,462958,3,0,1,1,1860
929b57f6e0a0d29012ba620f3a46c2ace065fac8,0,Lahiru Gunathilake,2011-11-01 03:38:13+00:00,['57c54cb313879bfdf57f0023e215bdd27c0783d0'],3,5,8,462966,1,0,0,0,1860
fab77bdb817794e90b1591c9fef444844cb3f048,0,Lahiru Gunathilake,2011-11-01 13:50:50+00:00,['929b57f6e0a0d29012ba620f3a46c2ace065fac8'],0,139,139,463105,1,0.6,1,1,1861
99a1d0bdb5988ef2780d2fd5fe826603ee909a96,0,Lahiru Gunathilake,2011-11-01 14:31:09+00:00,['fab77bdb817794e90b1591c9fef444844cb3f048'],1449,8,1457,464562,8,0.675710594,0.218346253,0.009043928,1861
38743265a3d50ecbde955d53a9636615646380b4,0,Lahiru Gunathilake,2011-11-01 17:01:44+00:00,['99a1d0bdb5988ef2780d2fd5fe826603ee909a96'],18,46,64,464626,1,0,0,0,1861
fc6069ed70e24eac1601d6df2b52fd7bb3e57d22,0,Lahiru Gunathilake,2011-11-01 18:48:14+00:00,['38743265a3d50ecbde955d53a9636615646380b4'],7,58,65,464691,8,1,1,1,1862
e0e6423e521e7a5c7862ea6f131ac0841a778121,0,Lahiru Gunathilake,2011-11-01 18:49:26+00:00,['fc6069ed70e24eac1601d6df2b52fd7bb3e57d22'],1,1,2,464693,1,,,,1862
b05f9ef67a1757b7ed7272be6998f01febbafa31,0,Patanachai Tangchaisin,2011-11-01 19:02:25+00:00,['e0e6423e521e7a5c7862ea6f131ac0841a778121'],11,13,24,464717,2,,,,1862
b8c6233871463d4147e81b9e156e579ecbce3b0c,0,Lahiru Gunathilake,2011-11-01 19:45:49+00:00,['b05f9ef67a1757b7ed7272be6998f01febbafa31'],14,16,30,464747,3,1,1,1,1862
08fcc6212e631f3e6f2e3892b31e32616f88420b,0,Lahiru Gunathilake,2011-11-01 21:08:47+00:00,['b8c6233871463d4147e81b9e156e579ecbce3b0c'],3,15,18,464765,1,0,0,0,1862
7d5a75a4d9fe199a0cbe2f2557d7c28e6e89c5a6,0,Lahiru Gunathilake,2011-11-01 22:45:46+00:00,['08fcc6212e631f3e6f2e3892b31e32616f88420b'],6,13,19,464784,1,0,0,0,1862
4285099168c2a3de52ca907a03cce0042efd1249,0,Lahiru Gunathilake,2011-11-01 22:46:33+00:00,['7d5a75a4d9fe199a0cbe2f2557d7c28e6e89c5a6'],0,6,6,464790,1,0,1,1,1862
edb1f87e6f5c28b5170c01c2c14e3b425e51175a,0,Lahiru Gunathilake,2011-11-02 18:51:34+00:00,['4285099168c2a3de52ca907a03cce0042efd1249'],262,242,504,465294,9,1,0,0,1862
5d6d0431f750fc0d169146ec98fd26189ad69e14,0,Lahiru Gunathilake,2011-11-02 19:25:44+00:00,['edb1f87e6f5c28b5170c01c2c14e3b425e51175a'],0,1,1,465295,1,0,0,1,1862
8cebb166a08f847d3021ffac7d858a3cc8abc4c8,0,Lahiru Gunathilake,2011-11-02 21:14:36+00:00,['5d6d0431f750fc0d169146ec98fd26189ad69e14'],37,97,134,465429,1,0,0,1,1862
1daebbf8b48b227b9ea6f6e9fd124bc62062cf7d,0,Suresh Marru,2011-11-03 12:10:38+00:00,['8cebb166a08f847d3021ffac7d858a3cc8abc4c8'],320,331,651,466080,2,,,,1862
c5acc2a78cfa9956c559ebb3addd0cee307f7cf5,0,Lahiru Gunathilake,2011-11-03 13:47:21+00:00,['1daebbf8b48b227b9ea6f6e9fd124bc62062cf7d'],1,0,1,466081,1,,,,1862
babed810b87edff9166c85a2ba2fb6bb28304585,0,Lahiru Gunathilake,2011-11-03 14:24:03+00:00,['c5acc2a78cfa9956c559ebb3addd0cee307f7cf5'],478,2116,2594,468675,18,0.374647887,0.614084507,1,1873
6b552c1ec875d26e44b38c771220f631ee161518,0,Lahiru Gunathilake,2011-11-03 14:25:38+00:00,['babed810b87edff9166c85a2ba2fb6bb28304585'],2,0,2,468677,1,0,0,0,1873
53ab63b4244eb6b744ce4463fdea5c14b048ab8f,0,Lahiru Gunathilake,2011-11-03 14:32:47+00:00,['6b552c1ec875d26e44b38c771220f631ee161518'],2,3,5,468682,1,0,1,1,1873
ca7d9282812c9c19a82390130d012d9b7d0518bb,0,Lahiru Gunathilake,2011-11-03 17:24:11+00:00,['53ab63b4244eb6b744ce4463fdea5c14b048ab8f'],3,3,6,468688,2,,,,1873
41538cac5ed31844c1eaf583356723e0758c034f,0,Suresh Marru,2011-11-04 11:45:55+00:00,['ca7d9282812c9c19a82390130d012d9b7d0518bb'],0,42,42,468730,1,,,,1874
438d58cd920a01e63dc43293dc8c5ba427d46090,0,Lahiru Gunathilake,2011-11-04 13:44:48+00:00,['41538cac5ed31844c1eaf583356723e0758c034f'],109,202,311,469041,7,1,1,1,1875
d860431f2e9c6965d439509f664dee4cc25b4730,0,Lahiru Gunathilake,2011-11-04 13:59:36+00:00,['438d58cd920a01e63dc43293dc8c5ba427d46090'],8,5,13,469054,1,,,,1875
42c346838b28356320d77ca237d2707d2fc46585,0,Lahiru Gunathilake,2011-11-04 14:44:48+00:00,['d860431f2e9c6965d439509f664dee4cc25b4730'],1,1,2,469056,1,,,,1875
e3a4a6cf8a4948cce1a03f3ac366cf958f9bc169,0,Lahiru Gunathilake,2011-11-04 16:06:27+00:00,['42c346838b28356320d77ca237d2707d2fc46585'],20,23,43,469099,2,0,1,1,1875
1bae1b4d51e185b3613755dbb3c48972aa4082df,0,Patanachai Tangchaisin,2011-11-04 18:22:32+00:00,['e3a4a6cf8a4948cce1a03f3ac366cf958f9bc169'],8,1,9,469108,1,,,,1875
414de25da918954c7e42d4235aa778f88512b21f,0,Patanachai Tangchaisin,2011-11-04 18:41:45+00:00,['1bae1b4d51e185b3613755dbb3c48972aa4082df'],82,74,156,469264,1,,,,1875
a3bb63b6055af1a6c7b847aa966b4fda580d10c9,0,Patanachai Tangchaisin,2011-11-04 18:50:54+00:00,['414de25da918954c7e42d4235aa778f88512b21f'],0,7,7,469271,1,,,,1875
9e15ba503800ec67f563a2ed82eb08e289f4f474,0,Patanachai Tangchaisin,2011-11-04 18:56:06+00:00,['a3bb63b6055af1a6c7b847aa966b4fda580d10c9'],4,1,5,469276,1,,,,1875
7e2afbd92945822789adac8706adc8cb02239441,0,Patanachai Tangchaisin,2011-11-04 19:52:16+00:00,['9e15ba503800ec67f563a2ed82eb08e289f4f474'],1,0,1,469277,1,,,,1875
662859e293cab11a46f3c5af0484b429fcc6477d,0,Heshan Theekshana Suriyaarachchi,2011-11-05 06:10:44+00:00,['7e2afbd92945822789adac8706adc8cb02239441'],1,0,1,469278,1,,,,1875
21cbc6655bc316766275e70d018685dd6704e9e2,0,Suresh Marru,2011-11-05 12:01:14+00:00,['662859e293cab11a46f3c5af0484b429fcc6477d'],1,1,2,469280,1,,,,1875
2e61b78dc4f463264495ed94b5cbebc984de497e,0,Suresh Marru,2011-11-05 12:29:59+00:00,['21cbc6655bc316766275e70d018685dd6704e9e2'],35,68,103,469383,1,,,,1875
430f2aeb9df994ce2bd6d07b2d84a8a1626d0a8e,0,Suresh Marru,2011-11-05 12:42:47+00:00,['2e61b78dc4f463264495ed94b5cbebc984de497e'],0,222,222,469605,3,,,,1878
dd50022baa888daa47e4a008dedca12ac6858b41,0,Suresh Marru,2011-11-05 13:05:12+00:00,['430f2aeb9df994ce2bd6d07b2d84a8a1626d0a8e'],1,1,2,469607,1,,,,1878
41a55a5bac8c2c8c72e2da3479afe8cbfd6272ac,0,Suresh Marru,2011-11-05 14:08:23+00:00,['dd50022baa888daa47e4a008dedca12ac6858b41'],1,60,61,469668,2,,,,1878
64c0dd2c85db4dfaf1ce0c15b40e9d40bbeedd43,0,Suresh Marru,2011-11-05 14:24:02+00:00,['41a55a5bac8c2c8c72e2da3479afe8cbfd6272ac'],1,1,2,469670,1,,,,1878
489bd8b16f04921445084d058c735c40ae922ed9,0,Suresh Marru,2011-11-05 14:55:26+00:00,['64c0dd2c85db4dfaf1ce0c15b40e9d40bbeedd43'],420,391,811,470481,4,,,,1878
2012584533436297aee74c53587f18af178c345f,0,Suresh Marru,2011-11-05 16:47:49+00:00,['489bd8b16f04921445084d058c735c40ae922ed9'],786,842,1628,472109,8,1,,,1878
98640edaf2289c420dfea4bb152d992bba1ef221,0,Suresh Marru,2011-11-05 19:09:41+00:00,['2012584533436297aee74c53587f18af178c345f'],0,0,0,472109,4,,,,1878
ea371ff4f91a57e786cf8cf325d98de7ab9f2397,0,Suresh Marru,2011-11-05 19:16:36+00:00,['98640edaf2289c420dfea4bb152d992bba1ef221'],756,1111,1867,473976,27,,,,1878
b0331774b951eac670e0d0fa6846ee1d50616ace,0,Suresh Marru,2011-11-05 19:36:08+00:00,['ea371ff4f91a57e786cf8cf325d98de7ab9f2397'],594,570,1164,475140,5,0,0,0,1878
a25663328867d9e253f7ffca9fa40720f1aef681,0,Suresh Marru,2011-11-05 19:58:20+00:00,['b0331774b951eac670e0d0fa6846ee1d50616ace'],165,469,634,475774,3,,,,1878
a3453fc1fec407366b95b6a4085a3dddfb42574a,0,Suresh Marru,2011-11-05 20:50:19+00:00,['a25663328867d9e253f7ffca9fa40720f1aef681'],442,163,605,476379,1,,,,1878
000a2df8effadb8611681b07822ce6aac9058f71,0,Suresh Marru,2011-11-05 23:03:36+00:00,['a3453fc1fec407366b95b6a4085a3dddfb42574a'],48,53,101,476480,2,,,,1878
7a6c28ce8556ac654a3927facc3426ca29b1beba,0,Lahiru Gunathilake,2011-11-07 19:37:34+00:00,['000a2df8effadb8611681b07822ce6aac9058f71'],3,30,33,476513,3,,,,1878
b5b9d8571e0b15a8d4511278dda141af91301824,0,Lahiru Gunathilake,2011-11-08 18:07:16+00:00,['7a6c28ce8556ac654a3927facc3426ca29b1beba'],43,179,222,476735,8,0.922330097,0.796116505,1,1878
38fd36e454fb3bb7fe261103f34ada2a40473448,0,Suresh Marru,2011-11-09 00:20:41+00:00,['b5b9d8571e0b15a8d4511278dda141af91301824'],783,747,1530,478265,13,,,,1878
16273fe7c27eae5eb3bd55e31f68bae9a85e8fe5,0,Suresh Marru,2011-11-09 01:03:43+00:00,['38fd36e454fb3bb7fe261103f34ada2a40473448'],78,343,421,478686,21,,,,1878
eb7a37602b996886680734c1ec38ced61db34886,0,Suresh Marru,2011-11-09 01:09:10+00:00,['16273fe7c27eae5eb3bd55e31f68bae9a85e8fe5'],24,0,24,478710,1,,,,1878
c4ac3331edbbf24509443f43e977396fb3ca241d,0,Suresh Marru,2011-11-09 19:34:41+00:00,['eb7a37602b996886680734c1ec38ced61db34886'],0,367,367,479077,2,,,,1880
0b8bc39328947cc91ff343cc1a454c1f070cf5b4,0,Suresh Marru,2011-11-09 20:00:43+00:00,['c4ac3331edbbf24509443f43e977396fb3ca241d'],39,14,53,479130,1,,,,1880
a07cc22819cf95d5a83f0d7b30ba293d690785a7,0,Suresh Marru,2011-11-09 20:00:45+00:00,['0b8bc39328947cc91ff343cc1a454c1f070cf5b4'],60,2,62,479192,2,,,,1880
aa377abe8486270319a65599f53940c26ad7753a,0,Suresh Marru,2011-11-10 01:00:07+00:00,['a07cc22819cf95d5a83f0d7b30ba293d690785a7'],1,1,2,479194,1,,,,1880
8887279df75bcb88d4295901be0f35f934f77170,0,Suresh Marru,2011-11-10 01:32:23+00:00,['aa377abe8486270319a65599f53940c26ad7753a'],478,461,939,480133,19,,,,1880
cbdcb7f72b7aeb04853fd80880e952ff086a31cc,0,Suresh Marru,2011-11-10 01:32:34+00:00,['8887279df75bcb88d4295901be0f35f934f77170'],22,22,44,480177,19,,,,1880
11d2b94a4b9c4f4a1079757377cf555865298e13,0,Suresh Marru,2011-11-10 04:21:21+00:00,['cbdcb7f72b7aeb04853fd80880e952ff086a31cc'],458,475,933,481110,19,,,,1880
b79b166e21d84f00bbd1dd01992a6c2601ab367c,0,Suresh Marru,2011-11-10 04:48:12+00:00,['11d2b94a4b9c4f4a1079757377cf555865298e13'],5,2,7,481117,2,,,,1880
d9919ac54001bcfc2ff7cfdd4915ba1291a39515,0,Suresh Marru,2011-11-10 05:07:20+00:00,['b79b166e21d84f00bbd1dd01992a6c2601ab367c'],478,461,939,482056,19,,,,1880
40987a6b0f0f5afe8c9523dd9d5dc0fd20746065,0,Suresh Marru,2011-11-10 05:07:33+00:00,['d9919ac54001bcfc2ff7cfdd4915ba1291a39515'],22,22,44,482100,19,,,,1880
06bad6bde6940ac253c33a17ae41950c337f7d82,0,Suresh Marru,2011-11-11 02:44:01+00:00,['40987a6b0f0f5afe8c9523dd9d5dc0fd20746065'],457,487,944,483044,19,,,,1880
f13eec09d1636d3d1fbc4b43f865471588dc4e57,0,Suresh Marru,2011-11-11 16:17:48+00:00,['06bad6bde6940ac253c33a17ae41950c337f7d82'],11,2,13,483057,2,,,,1880
2e83b87c74a0df0f97d1e95b727a9980be4d4ee2,0,Suresh Marru,2011-11-11 16:55:59+00:00,['f13eec09d1636d3d1fbc4b43f865471588dc4e57'],1,1,2,483059,1,,,,1880
fdeb24b948ad416a3f5b8699300808615ff79cfe,0,Suresh Marru,2011-11-11 17:07:01+00:00,['2e83b87c74a0df0f97d1e95b727a9980be4d4ee2'],478,461,939,483998,19,,,,1880
faaae6b4545dbc30860fc61e40ad1c344f339fa2,0,Suresh Marru,2011-11-11 17:09:22+00:00,['fdeb24b948ad416a3f5b8699300808615ff79cfe'],22,22,44,484042,19,,,,1880
5cfd24ef41dd2c97685369551a0f1a87504631e7,0,Lahiru Gunathilake,2011-11-12 02:37:57+00:00,['faaae6b4545dbc30860fc61e40ad1c344f339fa2'],1,187,188,484230,4,0.179487179,0.683760684,1,1881
135467b092d42d55b1c638f3cf621436987d1306,0,Lahiru Gunathilake,2011-11-13 05:39:39+00:00,['5cfd24ef41dd2c97685369551a0f1a87504631e7'],73,372,445,484675,13,0.628205128,1,0.884615385,1889
47870f9ee4b192562d72c2cf9bb3bf33d6d6b3dd,1,Heshan Theekshana Suriyaarachchi,2011-11-14 14:19:06+00:00,['135467b092d42d55b1c638f3cf621436987d1306'],0,413,413,485088,1,,,,1890
9dd61ac288c33e7d5333c51df45bdc9e40e7df12,0,Heshan Theekshana Suriyaarachchi,2011-11-14 15:39:54+00:00,['47870f9ee4b192562d72c2cf9bb3bf33d6d6b3dd'],70,50,120,485208,1,0.140776699,0.257281553,0.883495146,1890
e572c75cacaa9a52670eee373e1af32d101e67d9,0,Lahiru Gunathilake,2011-11-14 15:47:16+00:00,['9dd61ac288c33e7d5333c51df45bdc9e40e7df12'],1,1,2,485210,1,,,,1890
4d7301e9cf1a1bd3da084012a826de07322fd5d6,0,Heshan Theekshana Suriyaarachchi,2011-11-14 15:48:59+00:00,['e572c75cacaa9a52670eee373e1af32d101e67d9'],1,28,29,485239,2,,,,1890
9494168758b1df898a3cc3df8c202527b5007122,0,Lahiru Gunathilake,2011-11-14 16:45:51+00:00,['4d7301e9cf1a1bd3da084012a826de07322fd5d6'],9,23,32,485271,6,0.909090909,1,1,1890
ff9c5fa37392e4ac1e38018e101b722f0ca61ab8,0,Lahiru Gunathilake,2011-11-14 19:42:30+00:00,['9494168758b1df898a3cc3df8c202527b5007122'],4,18,22,485293,3,0.769230769,0.923076923,1,1890
29b9a0aae23fc52aafa260771bddeba035d5492d,0,Lahiru Gunathilake,2011-11-14 23:43:46+00:00,['ff9c5fa37392e4ac1e38018e101b722f0ca61ab8'],38,183,221,485514,14,0.387387387,1,1,1894
7ad316bae4ff995e490978b6aedb5f3b8fbce023,0,Lahiru Gunathilake,2011-11-15 14:37:52+00:00,['29b9a0aae23fc52aafa260771bddeba035d5492d'],3,4,7,485521,1,1,0,0,1894
2e2960eccd4a771c7381f0784c12f91039af79f8,0,Lahiru Gunathilake,2011-11-15 18:05:17+00:00,['7ad316bae4ff995e490978b6aedb5f3b8fbce023'],4,50,54,485575,1,0.384615385,0.435897436,0.948717949,1894
47ca9a23ab7cf530f5269127cc69fb7cd7ae008a,0,Lahiru Gunathilake,2011-11-15 18:05:32+00:00,['2e2960eccd4a771c7381f0784c12f91039af79f8'],7,3,10,485585,1,1,0,0,1894
3a753c6a1d5529174c41f50b0874737ffef0222c,0,Lahiru Gunathilake,2011-11-15 21:59:55+00:00,['47ca9a23ab7cf530f5269127cc69fb7cd7ae008a'],11,4,15,485600,2,,,,1894
90b9b86318e2583f3a013090ca2b1c5c28039814,0,Lahiru Gunathilake,2011-11-16 15:31:56+00:00,['3a753c6a1d5529174c41f50b0874737ffef0222c'],74,151,225,485825,23,0,0.40625,1,1895
ad8131546caef7d0fb114a4a0e7582278027d351,0,Lahiru Gunathilake,2011-11-16 15:57:38+00:00,['90b9b86318e2583f3a013090ca2b1c5c28039814'],0,97,97,485922,2,,,,1896
9bbcdca03d837dff138043d4cc0daa729a63d68b,0,Lahiru Gunathilake,2011-11-16 16:51:27+00:00,['ad8131546caef7d0fb114a4a0e7582278027d351'],1,0,1,485923,1,0,0,0,1896
c4425ef08b70d19f0b153298f01a2353fce7a00b,0,Lahiru Gunathilake,2011-11-16 16:55:49+00:00,['9bbcdca03d837dff138043d4cc0daa729a63d68b'],3,6,9,485932,1,,,,1896
0a5c462a9f5ccddb3781dc78195de270ad178701,0,Heshan Theekshana Suriyaarachchi,2011-11-20 21:58:24+00:00,['c4425ef08b70d19f0b153298f01a2353fce7a00b'],0,28,28,485960,1,,,,1896
111de34cfb90fc56e59432ab097843917cb54454,0,Heshan Theekshana Suriyaarachchi,2011-11-20 22:08:10+00:00,['0a5c462a9f5ccddb3781dc78195de270ad178701'],1,17,18,485978,2,1,1,1,1896
6815ea04f337ed4e277d3546cde63b12b63baa62,0,Heshan Theekshana Suriyaarachchi,2011-11-20 22:08:43+00:00,['111de34cfb90fc56e59432ab097843917cb54454'],10,16,26,486004,1,0.857142857,0.857142857,0.857142857,1896
9aee10dddfb2b6514fb5fba1dacab16d4218e510,0,Heshan Theekshana Suriyaarachchi,2011-11-20 22:24:54+00:00,['6815ea04f337ed4e277d3546cde63b12b63baa62'],0,5,5,486009,1,,,,1896
f510dbd6fd8525c586de3d04844ba7a445f8d7a4,1,Heshan Theekshana Suriyaarachchi,2011-11-20 22:28:05+00:00,['9aee10dddfb2b6514fb5fba1dacab16d4218e510'],15,61,76,486085,2,0,0,1,1896
3e5ded2248c4bcaf977f3cfb1d8ea91a06e6c908,0,Heshan Theekshana Suriyaarachchi,2011-11-20 23:24:40+00:00,['f510dbd6fd8525c586de3d04844ba7a445f8d7a4'],3,8,11,486096,1,0,0,1,1896
5ee74b4b877b706d3d952e56247e6d4ca5fc813c,0,Heshan Theekshana Suriyaarachchi,2011-11-21 06:46:45+00:00,['3e5ded2248c4bcaf977f3cfb1d8ea91a06e6c908'],10,5,15,486111,1,1,1,1,1896
10ddf45a8c4d9f37274211259e0939bfc9d87804,0,Lahiru Gunathilake,2011-11-22 14:44:03+00:00,['5ee74b4b877b706d3d952e56247e6d4ca5fc813c'],1,1,2,486113,1,,,,1896
66e7761083f9238f6665aef5eb64a6cebe182973,0,Lahiru Gunathilake,2011-11-22 16:16:41+00:00,['10ddf45a8c4d9f37274211259e0939bfc9d87804'],2,3,5,486118,2,0,1,1,1896
ed03e8caf923edaa6a106d6100111afa53106245,0,Lahiru Gunathilake,2011-11-22 16:17:03+00:00,['66e7761083f9238f6665aef5eb64a6cebe182973'],0,3,3,486121,1,0,0,1,1896
36afecefe1e6f1929733069e7cc3b3bddd4948bb,0,Lahiru Gunathilake,2011-11-22 21:41:07+00:00,['ed03e8caf923edaa6a106d6100111afa53106245'],49,47,96,486217,15,1,0.210526316,0.157894737,1896
22dda6771d8cfb149f4e6a41d92d88767075a1ef,0,Lahiru Gunathilake,2011-11-23 14:57:43+00:00,['36afecefe1e6f1929733069e7cc3b3bddd4948bb'],27,25,52,486269,8,0.5,0,1,1896
9cc7ca18e94355c2afaf64441e939180efb26755,0,Lahiru Gunathilake,2011-11-23 15:04:04+00:00,['22dda6771d8cfb149f4e6a41d92d88767075a1ef'],10,17,27,486296,1,1,1,1,1896
0096683751242691ae04855377e9020e516cbb39,0,Lahiru Gunathilake,2011-11-23 15:28:33+00:00,['9cc7ca18e94355c2afaf64441e939180efb26755'],8,6,14,486310,1,0,0,0,1896
71f47b1296ef00aa44a3ad9cd3ddfd951fd61ea4,0,Lahiru Gunathilake,2011-11-23 15:35:35+00:00,['0096683751242691ae04855377e9020e516cbb39'],3,3,6,486316,1,,,,1896
e2bf60333daf595709534ff4cac9b8835082e407,0,Lahiru Gunathilake,2011-11-23 16:06:19+00:00,['71f47b1296ef00aa44a3ad9cd3ddfd951fd61ea4'],29,12,41,486357,3,0,0,0,1896
5dcf8ff7161a2c009aef37d6506952b3842cf52e,0,Lahiru Gunathilake,2011-11-23 16:23:34+00:00,['e2bf60333daf595709534ff4cac9b8835082e407'],11,11,22,486379,6,0.25,0,1,1896
1549f1602dc88aebe9745c5eb4f25a6204f77a12,0,Suresh Marru,2011-11-23 21:01:21+00:00,['5dcf8ff7161a2c009aef37d6506952b3842cf52e'],1,1,2,486381,1,,,,1896
bd8482576fe9792b6e0a3c5361308e6d0e76c9dc,0,Heshan Theekshana Suriyaarachchi,2011-11-23 21:57:32+00:00,['1549f1602dc88aebe9745c5eb4f25a6204f77a12'],1,1,2,486383,1,,,,1896
c981bef80be6ee050cad0ff154a1b2f3e395c230,0,Heshan Theekshana Suriyaarachchi,2011-11-28 23:06:37+00:00,['bd8482576fe9792b6e0a3c5361308e6d0e76c9dc'],1,1,2,486385,1,0,0,0,1896
f226b165eb212c2591f9e0267ab4f8aec3184dcb,0,Lahiru Gunathilake,2011-12-01 16:03:41+00:00,['c981bef80be6ee050cad0ff154a1b2f3e395c230'],1,1,2,486387,1,,,,1896
c83b1e3186c2369f8dcaf4a6ddacf0e0db7cd4bd,0,samindaw,2011-12-05 00:06:40+00:00,['f226b165eb212c2591f9e0267ab4f8aec3184dcb'],649,374,1023,487410,3,1,0.549479167,0,1896
67edcc9144a5f41f9164c2aeaa94cba08be9008b,0,Lahiru Gunathilake,2011-12-05 22:24:50+00:00,['c83b1e3186c2369f8dcaf4a6ddacf0e0db7cd4bd'],7,62,69,487479,2,0,0,1,1896
cda3c412e5a3e208c129d3f51f4228d4894c9ee0,0,Lahiru Gunathilake,2011-12-05 22:25:55+00:00,['67edcc9144a5f41f9164c2aeaa94cba08be9008b'],1,9,10,487489,2,1,1,0,1896
2cc3bb7799b75b3fc9f27b31df4b8c99455b5c24,0,Lahiru Gunathilake,2011-12-05 22:30:21+00:00,['cda3c412e5a3e208c129d3f51f4228d4894c9ee0'],1,3,4,487493,1,0,0,1,1896
1e382dfb00a90f4b394e3852bfbd8fd59369f84b,0,Lahiru Gunathilake,2011-12-05 22:32:24+00:00,['2cc3bb7799b75b3fc9f27b31df4b8c99455b5c24'],9,59,68,487561,1,0,0,0.482758621,1896
78077bf40b757ecbd5c484b10d352f1a1aea70c8,0,Lahiru Gunathilake,2011-12-05 22:33:31+00:00,['1e382dfb00a90f4b394e3852bfbd8fd59369f84b'],4,4,8,487569,1,,,,1896
009e3bcb2ca1fabdf30f0df8091bab567e877dcb,0,Lahiru Gunathilake,2011-12-07 18:34:00+00:00,['78077bf40b757ecbd5c484b10d352f1a1aea70c8'],2,2,4,487573,1,,,,1896
9653faa702db6cb8f424f63926755d1f364e0e85,0,Lahiru Gunathilake,2011-12-07 18:36:28+00:00,['009e3bcb2ca1fabdf30f0df8091bab567e877dcb'],15,50,65,487638,2,0,0.739130435,0.739130435,1896
6537ce324451e5afcc6c28eeed3e46b98b5829bf,0,Lahiru Gunathilake,2011-12-07 18:47:48+00:00,['9653faa702db6cb8f424f63926755d1f364e0e85'],1,5,6,487644,3,0,1,1,1896
4ea2c64e1d009b4d354e591522f28cee80f1e6b1,0,Lahiru Gunathilake,2011-12-07 18:54:11+00:00,['6537ce324451e5afcc6c28eeed3e46b98b5829bf'],4,210,214,487858,4,0.315315315,0.711711712,1,1897
40dd168aa6c7c8d7416de6efd78ef0efb81b640b,0,Lahiru Gunathilake,2011-12-07 18:55:25+00:00,['4ea2c64e1d009b4d354e591522f28cee80f1e6b1'],8,1,9,487867,2,0,0,1,1897
3de410bcffb1183284b0f8da8ba0ca04fbc908e5,0,samindaw,2011-12-09 18:59:10+00:00,['40dd168aa6c7c8d7416de6efd78ef0efb81b640b'],4,15,19,487886,1,,,,1897
06926673e34f6f7b730cac8d5b500e5c6f23080b,0,samindaw,2011-12-09 21:04:34+00:00,['3de410bcffb1183284b0f8da8ba0ca04fbc908e5'],9,9,18,487904,21,,,,1907
f29ce973ebdd58a69a4f75d34a451297407dc3a2,0,samindaw,2011-12-09 22:59:59+00:00,['06926673e34f6f7b730cac8d5b500e5c6f23080b'],7,70,77,487981,6,0.272727273,0.977272727,1,1908
a19b28ccfc1b408f4248f8d77fad21cab54a5c19,1,Lahiru Gunathilake,2011-12-13 16:35:51+00:00,['f29ce973ebdd58a69a4f75d34a451297407dc3a2'],1228,2125,3353,491334,15,0.048973144,0.072669826,0.742496051,1909
294b1df4dc861fed5c51166c2bf0c0b1b786d0a7,0,samindaw,2011-12-14 21:10:54+00:00,['a19b28ccfc1b408f4248f8d77fad21cab54a5c19'],25,24,49,491383,2,1,,,1909
82f254e835c02a828af58e36114f29df0377ecd1,0,samindaw,2011-12-14 21:14:24+00:00,['294b1df4dc861fed5c51166c2bf0c0b1b786d0a7'],8,8,16,491399,1,0,0,0,1909
8f4b6125067df844c6827b985d4ef141af5c21a0,0,samindaw,2011-12-14 23:28:59+00:00,['82f254e835c02a828af58e36114f29df0377ecd1'],7,26,33,491432,1,1,1,1,1909
d8a237f051f96869375ad5e8244fa3a0dcca1c6f,0,samindaw,2011-12-16 15:58:19+00:00,['8f4b6125067df844c6827b985d4ef141af5c21a0'],6,27,33,491465,3,0,0.363636364,0.363636364,1909
f1d07aab41bc73ece53538cbd4f18e9e2fcd4df5,0,Suresh Marru,2011-12-16 16:38:39+00:00,['d8a237f051f96869375ad5e8244fa3a0dcca1c6f'],4,4,8,491473,1,1,0,0,1909
5cc91f8ca108f908394d7c2210797f5326a3cb77,0,samindaw,2011-12-16 21:29:25+00:00,['f1d07aab41bc73ece53538cbd4f18e9e2fcd4df5'],247,582,829,492302,15,0.511111111,0.853333333,0.995555556,1910
67560454df401e444eaa9601aec5cf8574121d16,1,Chathura Herath,2011-12-16 21:45:07+00:00,['5cc91f8ca108f908394d7c2210797f5326a3cb77'],2376,10,2386,494688,13,0.798107256,0.539432177,0.144321767,1910
12927686d1610c36fdcae3639a446488456c7e91,0,Chathura Herath,2011-12-16 21:47:27+00:00,['67560454df401e444eaa9601aec5cf8574121d16'],0,0,0,494688,0,,,,1910
b34d1b1124e06475a56aa3647893159a2d840778,0,Chathura Herath,2011-12-16 21:57:59+00:00,['12927686d1610c36fdcae3639a446488456c7e91'],1597,1661,3258,497946,1,0.015151515,0.03030303,0.712121212,1910
228d723e5f4a98b2921813d257c480ff3fd5e5e9,0,samindaw,2011-12-16 21:59:42+00:00,['b34d1b1124e06475a56aa3647893159a2d840778'],17,63,80,498026,1,0,0,1,1910
3efcf84463c3896df9b1d99e3839eba6f37c69a4,0,Chathura Herath,2011-12-17 05:20:17+00:00,['228d723e5f4a98b2921813d257c480ff3fd5e5e9'],243,0,243,498269,1,,,,1910
566c052870f12ff47832337b35cecf0f4c43ff5a,0,Chathura Herath,2011-12-17 05:20:27+00:00,['3efcf84463c3896df9b1d99e3839eba6f37c69a4'],15,0,15,498284,1,0,0,0,1910
22d88bba0b0a0006c43a25a934947a803eac8ed4,0,Chathura Herath,2011-12-17 05:20:38+00:00,['566c052870f12ff47832337b35cecf0f4c43ff5a'],27,0,27,498311,1,,,,1910
15e0273777a426297acfbd1ef7b1768b23a754dd,0,Chathura Herath,2011-12-17 05:20:51+00:00,['22d88bba0b0a0006c43a25a934947a803eac8ed4'],1,2,3,498314,1,,,,1910
a88d844abe82536121250705650df2ebf054f068,0,Chathura Herath,2011-12-17 05:21:02+00:00,['15e0273777a426297acfbd1ef7b1768b23a754dd'],4,8,12,498326,1,,,,1910
3758f479c06e157cb0d35b51fd38ae632ea6bb70,0,Chathura Herath,2011-12-17 05:21:13+00:00,['a88d844abe82536121250705650df2ebf054f068'],1,2,3,498329,1,,,,1910
a01e80951e35cf99c9e48778e1021551ff00ea86,0,Chathura Herath,2011-12-17 05:21:24+00:00,['3758f479c06e157cb0d35b51fd38ae632ea6bb70'],89,6,95,498424,1,0,0,0,1910
5b13eced197d467960825a6b3e611a7bd2b035d7,0,Chathura Herath,2011-12-17 05:21:35+00:00,['a01e80951e35cf99c9e48778e1021551ff00ea86'],8,0,8,498432,1,1,0,0,1910
a433867e26077837c179a1d0c167c3a72a1d31b2,0,Chathura Herath,2011-12-17 05:21:47+00:00,['5b13eced197d467960825a6b3e611a7bd2b035d7'],13,1,14,498446,1,,,,1910
282127e1cc08bfa93e5722dae6f3eb5aea88598d,0,Chathura Herath,2011-12-17 05:21:58+00:00,['a433867e26077837c179a1d0c167c3a72a1d31b2'],2,0,2,498448,1,,,,1910
dc103e3c3f51789f1b07657b852e198be4f74141,0,Chathura Herath,2011-12-17 05:22:09+00:00,['282127e1cc08bfa93e5722dae6f3eb5aea88598d'],6,0,6,498454,1,,,,1910
efba4697b0282402632489b22d98ac4dad6d3c4a,0,Chathura Herath,2011-12-17 05:22:24+00:00,['dc103e3c3f51789f1b07657b852e198be4f74141'],649,0,649,499103,1,0.96124031,0.788113695,0.131782946,1910
43f3adc3fc106398b1b3a8bcc068f2740514d723,0,Chathura Herath,2011-12-17 05:22:34+00:00,['efba4697b0282402632489b22d98ac4dad6d3c4a'],121,0,121,499224,1,0,0.352941176,0.323529412,1910
83eac2f56350e527d543dae0effc645147b38ac4,0,Chathura Herath,2011-12-17 05:22:44+00:00,['43f3adc3fc106398b1b3a8bcc068f2740514d723'],64,0,64,499288,1,0,0,0,1910
84b991057c977b1cda6f7b0ad2a816bcb7e97da3,0,Chathura Herath,2011-12-17 05:22:55+00:00,['83eac2f56350e527d543dae0effc645147b38ac4'],55,0,55,499343,1,0,0,0,1910
077458d46d882612c2d9cbe3183f2860397c8065,0,Chathura Herath,2011-12-17 05:23:06+00:00,['84b991057c977b1cda6f7b0ad2a816bcb7e97da3'],75,0,75,499418,1,0,0,0,1910
a8e860d02f865198c6d74760e51911cb8e5af1d9,0,Chathura Herath,2011-12-17 05:23:15+00:00,['077458d46d882612c2d9cbe3183f2860397c8065'],137,0,137,499555,1,0.596153846,0.596153846,0.115384615,1910
0eb2a883d6ebcc7bb77f8a33078488ff4c0d0160,0,Chathura Herath,2011-12-17 05:23:25+00:00,['a8e860d02f865198c6d74760e51911cb8e5af1d9'],86,0,86,499641,1,0.892857143,0.892857143,0,1910
81c8746e2501b3e58fb6910a538de8384c5c9f99,0,Chathura Herath,2011-12-17 05:23:36+00:00,['0eb2a883d6ebcc7bb77f8a33078488ff4c0d0160'],163,0,163,499804,1,0.782051282,0,0,1910
40e4d9a7e144c80f9e739bbbd22ea58afb988fc1,0,Chathura Herath,2011-12-17 05:23:48+00:00,['81c8746e2501b3e58fb6910a538de8384c5c9f99'],21,1,22,499826,1,,,,1910
3b558e90e76f9f3490b343e2a5cf5fc3e060d251,0,Chathura Herath,2011-12-17 05:23:58+00:00,['40e4d9a7e144c80f9e739bbbd22ea58afb988fc1'],9,0,9,499835,1,,,,1910
661dacf4c72a1a76352ebb4c44aa360070802fd8,0,Chathura Herath,2011-12-17 05:24:10+00:00,['3b558e90e76f9f3490b343e2a5cf5fc3e060d251'],1,1,2,499837,1,,,,1910
de26d463f460c2c7e6800984200028fef1fc8d06,0,Chathura Herath,2011-12-17 05:24:26+00:00,['661dacf4c72a1a76352ebb4c44aa360070802fd8'],2,0,2,499839,1,,,,1910
63766620778c0595147b626b35f392475bf7feb3,0,Chathura Herath,2011-12-17 05:25:18+00:00,['de26d463f460c2c7e6800984200028fef1fc8d06'],129,0,129,499968,1,,,,1910
8d0b65504bc6acafa0a8c4e082020b818761d6b8,0,Chathura Herath,2011-12-17 05:25:35+00:00,['63766620778c0595147b626b35f392475bf7feb3'],60,0,60,500028,1,,,,1910
120c08c25bb5be5ff3ac6ed0a7df2c0cd3f0203b,0,Chathura Herath,2011-12-17 05:25:50+00:00,['8d0b65504bc6acafa0a8c4e082020b818761d6b8'],88,0,88,500116,1,0.5,0,0.941176471,1910
ee85e1fd6852d4e81df670cdc7808e316f80ef1e,0,Chathura Herath,2011-12-17 05:26:02+00:00,['120c08c25bb5be5ff3ac6ed0a7df2c0cd3f0203b'],1,2,3,500119,1,,,,1910
c64ad72dbca7c2dd986369b3d5d0bf85881a53ab,0,Chathura Herath,2011-12-17 05:26:14+00:00,['ee85e1fd6852d4e81df670cdc7808e316f80ef1e'],1,1,2,500121,1,,,,1910
6da30acbba97cde7ff1c32394a6f4a0956a89503,0,Chathura Herath,2011-12-17 05:26:28+00:00,['c64ad72dbca7c2dd986369b3d5d0bf85881a53ab'],1,0,1,500122,1,,,,1910
714f9393f22ec5b7e8594ea28d22faf2f957b4b8,0,Chathura Herath,2011-12-17 05:26:42+00:00,['6da30acbba97cde7ff1c32394a6f4a0956a89503'],0,27,27,500149,1,,,,1911
7928c4869a1dc877cf4a228c88106cf687ffea7c,0,Chathura Herath,2011-12-17 05:26:56+00:00,['714f9393f22ec5b7e8594ea28d22faf2f957b4b8'],1,0,1,500150,1,,,,1911
8cf876ea6a57f969993d56082fd7ef9591e46211,0,Chathura Herath,2011-12-17 05:27:08+00:00,['7928c4869a1dc877cf4a228c88106cf687ffea7c'],9,0,9,500159,1,,,,1911
b22ddb41fcd564abbc18c87f83596267ae343720,0,Chathura Herath,2011-12-17 05:27:20+00:00,['8cf876ea6a57f969993d56082fd7ef9591e46211'],4,0,4,500163,1,,,,1911
c12cb8ac522a7620d8ee2408460a71785509b59f,0,Chathura Herath,2011-12-17 05:27:33+00:00,['b22ddb41fcd564abbc18c87f83596267ae343720'],1,2,3,500166,1,,,,1911
cee2d749eb3eb498a4237d79a64a6a8204692ad3,0,Chathura Herath,2011-12-17 05:27:44+00:00,['c12cb8ac522a7620d8ee2408460a71785509b59f'],233,0,233,500399,1,0.951219512,0,0,1911
df0b21ab1cefbe0d83162f043042dc6f94b7f006,0,Chathura Herath,2011-12-17 05:27:55+00:00,['cee2d749eb3eb498a4237d79a64a6a8204692ad3'],1,2,3,500402,1,0,1,1,1911
3049d4307b60f7ccf71a9df3091955c8c05b2e7a,0,Chathura Herath,2011-12-17 05:28:09+00:00,['df0b21ab1cefbe0d83162f043042dc6f94b7f006'],1,1,2,500404,1,,,,1911
40b306a4836c6c2e70f4ae2e82478b94355cf251,0,Chathura Herath,2011-12-17 05:28:22+00:00,['3049d4307b60f7ccf71a9df3091955c8c05b2e7a'],8,2,10,500414,1,,,,1911
484763fb7f890a3e9d346d1218154fc28dee5371,0,samindaw,2011-12-17 10:34:32+00:00,['40b306a4836c6c2e70f4ae2e82478b94355cf251'],5,6,11,500425,1,,,,1911
1f320af3f4ec4ae33ae7810aec6d78ce57c7da34,0,samindaw,2011-12-18 16:06:05+00:00,['484763fb7f890a3e9d346d1218154fc28dee5371'],1,0,1,500426,1,,,,1911
158a808ce040164b06254c7fa9c6fa48d5c2b437,0,Lahiru Gunathilake,2011-12-18 16:31:37+00:00,['1f320af3f4ec4ae33ae7810aec6d78ce57c7da34'],5,57,62,500488,3,0.111111111,0,1,1912
e31e03a35d1658df11afd4f9e0f7863b4d6bbd32,0,Chathura Herath,2011-12-18 17:48:08+00:00,['158a808ce040164b06254c7fa9c6fa48d5c2b437'],15,0,15,500503,1,0,0,0,1912
4970ab54a3a7794384138b2be3bc1234c36512e5,0,Chathura Herath,2011-12-18 17:48:22+00:00,['e31e03a35d1658df11afd4f9e0f7863b4d6bbd32'],177,0,177,500680,1,0,0,0,1912
a63a5f4407968ec1f755b8e864ba8a070de83208,0,Chathura Herath,2011-12-18 17:48:36+00:00,['4970ab54a3a7794384138b2be3bc1234c36512e5'],65,0,65,500745,1,0,0,0,1912
897a3e147026ec3dc788a500dd8ba0aaff5d51a5,0,Chathura Herath,2011-12-18 17:48:45+00:00,['a63a5f4407968ec1f755b8e864ba8a070de83208'],52,0,52,500797,1,0,0,0,1912
4efe4985fa8eda9e4fd77c62441a56475f49d4ef,0,Chathura Herath,2011-12-18 17:48:57+00:00,['897a3e147026ec3dc788a500dd8ba0aaff5d51a5'],101,0,101,500898,1,0.486486486,0,0,1912
a4d1f0d5265750eb4a05df05619aecd34020f1ec,0,Chathura Herath,2011-12-18 17:49:07+00:00,['4efe4985fa8eda9e4fd77c62441a56475f49d4ef'],38,0,38,500936,1,0,0,0,1912
8b2cabb43fc78be600566e289bba6a865c4219c2,0,Chathura Herath,2011-12-18 17:49:17+00:00,['a4d1f0d5265750eb4a05df05619aecd34020f1ec'],53,0,53,500989,1,0,0,0.416666667,1912
2f6c8610149c62f0000ec647f70dbe5dea0fc065,0,Chathura Herath,2011-12-18 17:49:27+00:00,['8b2cabb43fc78be600566e289bba6a865c4219c2'],29,1,30,501019,1,1,0,0,1912
640bc76c2bbdc5bdcd7f6c2fd3640d8df3387093,0,Chathura Herath,2011-12-18 17:49:37+00:00,['2f6c8610149c62f0000ec647f70dbe5dea0fc065'],4,0,4,501023,1,1,0,0,1912
55f4602463570a5b99dec77fcc63c9a9e1bdf0f0,0,Chathura Herath,2011-12-18 17:49:54+00:00,['640bc76c2bbdc5bdcd7f6c2fd3640d8df3387093'],0,0,0,501023,0,,,,1912
a39364ebd6b7fa28fe632ddb1df23aa9bc18d81f,0,Chathura Herath,2011-12-18 17:50:05+00:00,['55f4602463570a5b99dec77fcc63c9a9e1bdf0f0'],19,2,21,501044,1,,,,1912
bc9ce9de7fb91a66bb7904194421ee17c3e792c8,0,Chathura Herath,2011-12-18 17:50:16+00:00,['a39364ebd6b7fa28fe632ddb1df23aa9bc18d81f'],230,0,230,501274,1,0.438596491,0,0,1912
a2973f2559a7f77431c75331479a145c5dea5a9c,0,Chathura Herath,2011-12-18 17:50:27+00:00,['bc9ce9de7fb91a66bb7904194421ee17c3e792c8'],110,0,110,501384,1,0,0,0,1912
447e93fa63dceea618693eeb87208f844d84225c,0,Chathura Herath,2011-12-18 17:50:39+00:00,['a2973f2559a7f77431c75331479a145c5dea5a9c'],65,0,65,501449,1,0,0,0,1912
d7e079eb910ea2ee4c2de6183bfc768959bf9ab4,0,Chathura Herath,2011-12-18 17:50:50+00:00,['447e93fa63dceea618693eeb87208f844d84225c'],91,0,91,501540,1,0.696969697,0.696969697,0,1912
35d5e11b4c3ce38bb455d1f29d97a3ed13773472,0,Chathura Herath,2011-12-18 17:51:00+00:00,['d7e079eb910ea2ee4c2de6183bfc768959bf9ab4'],230,0,230,501770,1,0.873873874,0.315315315,0,1912
6da4ecbb35fa9e8c06e1956bb5df37ddf9251de5,0,Chathura Herath,2011-12-18 17:51:11+00:00,['35d5e11b4c3ce38bb455d1f29d97a3ed13773472'],80,0,80,501850,1,0.71875,0.71875,0,1912
036c8c1e1cf5dc94ddcc3ab40c25a6ee61b89b1c,0,Chathura Herath,2011-12-18 17:51:22+00:00,['6da4ecbb35fa9e8c06e1956bb5df37ddf9251de5'],170,0,170,502020,1,0.743243243,0.337837838,0,1912
61fc9b4163610960196d1042b9aa7554731da94c,0,Chathura Herath,2011-12-18 17:51:33+00:00,['036c8c1e1cf5dc94ddcc3ab40c25a6ee61b89b1c'],4,0,4,502024,1,,,,1912
09d236c09d3c2475425f5ee70306968e4e05fef0,0,Chathura Herath,2011-12-18 17:51:45+00:00,['61fc9b4163610960196d1042b9aa7554731da94c'],19,1,20,502044,1,1,1,0,1912
bb32bad876df0d13ea21076e4bffb7c1ee22a916,0,Chathura Herath,2011-12-18 17:52:01+00:00,['09d236c09d3c2475425f5ee70306968e4e05fef0'],93,2,95,502139,1,1,0.984375,0,1912
db99e0ca2559fcd63b3cfb73e70b8d26e447c3e4,0,Chathura Herath,2011-12-18 17:52:12+00:00,['bb32bad876df0d13ea21076e4bffb7c1ee22a916'],22,0,22,502161,1,0,0,0,1912
b410866c775c62fe92e179b284e7898dcc136636,0,Chathura Herath,2011-12-18 17:52:22+00:00,['db99e0ca2559fcd63b3cfb73e70b8d26e447c3e4'],99,0,99,502260,1,1,1,0,1912
589606eedde97a68ecf414f8a8d547bd2b1a524f,0,Chathura Herath,2011-12-18 17:52:37+00:00,['b410866c775c62fe92e179b284e7898dcc136636'],51,0,51,502311,1,0,0,0,1912
4b962b4bfe1d3d27eea2bf3e4ccaaae51e2e9219,0,Chathura Herath,2011-12-18 17:52:49+00:00,['589606eedde97a68ecf414f8a8d547bd2b1a524f'],241,12,253,502564,1,0.782352941,0.641176471,0.464705882,1912
c39668552be7a985919befcaf247bcb94904c771,0,Chathura Herath,2011-12-18 17:53:00+00:00,['4b962b4bfe1d3d27eea2bf3e4ccaaae51e2e9219'],220,1,221,502785,1,0.823899371,0.823899371,0,1912
c107a53aac95f0673d6b6f2798ef37a60bf620e9,0,Chathura Herath,2011-12-18 17:53:11+00:00,['c39668552be7a985919befcaf247bcb94904c771'],7,1,8,502793,1,1,1,0,1912
2c5d5e0f1dda0d302942d5f6a1979e6d5af41e9a,0,Chathura Herath,2011-12-18 17:53:25+00:00,['c107a53aac95f0673d6b6f2798ef37a60bf620e9'],0,0,0,502793,0,,,,1912
ca5f2b7fda4623faf7881470a2eeba6c08fa1c3c,0,Chathura Herath,2011-12-18 17:53:36+00:00,['2c5d5e0f1dda0d302942d5f6a1979e6d5af41e9a'],133,1,134,502927,1,0.842696629,0.842696629,0,1912
d856814fbd5bb76099e9390b3712c1fb6fa8b102,0,Chathura Herath,2011-12-18 17:53:58+00:00,['ca5f2b7fda4623faf7881470a2eeba6c08fa1c3c'],51,2,53,502980,1,1,1,0,1912
4ea2cc9cdc4533bc1c88669ee0743c7e8e4f6ad2,0,Chathura Herath,2011-12-18 17:54:09+00:00,['d856814fbd5bb76099e9390b3712c1fb6fa8b102'],0,0,0,502980,0,,,,1912
5557263de7744ce49614a044baa7e4dfdf22d80e,0,Chathura Herath,2011-12-18 17:54:19+00:00,['4ea2cc9cdc4533bc1c88669ee0743c7e8e4f6ad2'],133,0,133,503113,1,0,0,0,1912
848c5fabc9c3fd64fe5e760a9f0c0810aa6f4743,0,Chathura Herath,2011-12-18 17:54:31+00:00,['5557263de7744ce49614a044baa7e4dfdf22d80e'],10791,0,10791,513904,1,0.748871244,0.618402616,0.375681146,1912
04af0c3e72fb8f4d8e2a08b1b2283a4ff13f4688,0,Chathura Herath,2011-12-18 17:54:42+00:00,['848c5fabc9c3fd64fe5e760a9f0c0810aa6f4743'],26,0,26,513930,1,,,,1912
fb0bd38b21eb189e20ee3ca295f868528df3bcee,0,Chathura Herath,2011-12-18 17:54:51+00:00,['04af0c3e72fb8f4d8e2a08b1b2283a4ff13f4688'],138,0,138,514068,1,0.32,0,0,1912
3a2c2a9611e4dbd074c82de2c309deda77e3473a,0,Chathura Herath,2011-12-18 17:55:41+00:00,['fb0bd38b21eb189e20ee3ca295f868528df3bcee'],62,1,63,514131,1,0.928571429,0.928571429,0.928571429,1912
e0cc39583f8b36c37565f43b94c1590f5f9eff91,0,Chathura Herath,2011-12-18 17:57:38+00:00,['3a2c2a9611e4dbd074c82de2c309deda77e3473a'],0,0,0,514131,0,,,,1912
a187791f4e9a8328bba31f8951a9e74429c82dd4,0,Heshan Theekshana Suriyaarachchi,2011-12-18 18:34:25+00:00,['e0cc39583f8b36c37565f43b94c1590f5f9eff91'],4,0,4,514135,1,0,0,0,1912
7d838f2b4256e9410a1c4becd4477bb4a47e8b47,0,Heshan Theekshana Suriyaarachchi,2011-12-18 19:41:18+00:00,['a187791f4e9a8328bba31f8951a9e74429c82dd4'],1,5,6,514141,1,1,1,1,1912
6c36b85b906e30ab8a4d53499826ad7685946856,0,Lahiru Gunathilake,2011-12-18 20:30:45+00:00,['7d838f2b4256e9410a1c4becd4477bb4a47e8b47'],74,101,175,514316,2,0.479452055,1,0.780821918,1912
2547b8b85422e9c40074840ac7f5c355975c9956,0,Lahiru Gunathilake,2011-12-18 21:23:27+00:00,['6c36b85b906e30ab8a4d53499826ad7685946856'],74,154,228,514544,3,1,1,1,1914
761760cc9c9a49556d7ff425c9135a1d0f0dab12,0,Heshan Theekshana Suriyaarachchi,2011-12-18 22:37:06+00:00,['2547b8b85422e9c40074840ac7f5c355975c9956'],26,45,71,514615,1,0.461538462,1,1,1914
90de7734a6a91a078fa3969f25132dddd53b4d1c,0,samindaw,2011-12-18 23:28:47+00:00,['761760cc9c9a49556d7ff425c9135a1d0f0dab12'],62,513,575,515190,6,0.251552795,0.618012422,0.860248447,1915
90c8403a4307d03de58de452b9860ff5db6f8b9c,0,samindaw,2011-12-19 03:33:04+00:00,['90de7734a6a91a078fa3969f25132dddd53b4d1c'],54,47,101,515291,5,0,0,0,1915
fa69eeb1394c39adbd32975d0ee74ece8443d91a,0,samindaw,2011-12-19 14:19:50+00:00,['90c8403a4307d03de58de452b9860ff5db6f8b9c'],78,185,263,515554,5,0.49122807,0.438596491,0.631578947,1915
508a8b959aa9c119da286b30135cd65bb06fb9a3,0,Lahiru Gunathilake,2011-12-19 17:18:28+00:00,['fa69eeb1394c39adbd32975d0ee74ece8443d91a'],0,70,70,515624,1,0,1,1,1916
76c8d8f91f059778f825d02e140dd065519f08f4,0,samindaw,2011-12-19 17:18:32+00:00,['508a8b959aa9c119da286b30135cd65bb06fb9a3'],30,103,133,515757,7,0.568965517,1,0.879310345,1916
5be38ad2f53ca0c5e3399fa4ffa122e2e1c93793,0,Lahiru Gunathilake,2011-12-19 17:19:27+00:00,['76c8d8f91f059778f825d02e140dd065519f08f4'],0,3,3,515760,1,1,1,1,1916
3385562d7b2795bb306c1b7b60a581009008ea9a,0,Lahiru Gunathilake,2011-12-19 17:24:02+00:00,['5be38ad2f53ca0c5e3399fa4ffa122e2e1c93793'],0,62,62,515822,1,0,1,1,1917
81940d6afc478c8b2873ecc9e5468f37e7d7407c,0,samindaw,2011-12-19 17:24:40+00:00,['3385562d7b2795bb306c1b7b60a581009008ea9a'],0,37,37,515859,1,1,1,1,1918
e3307a6fb3ad213bfc95e2d54810fbeb2653dc72,0,Heshan Theekshana Suriyaarachchi,2011-12-19 17:31:46+00:00,['81940d6afc478c8b2873ecc9e5468f37e7d7407c'],22,16,38,515897,1,0,0,1,1918
b8febdf7b611fa8a1f8c0170d5b0d1c9682adf31,0,samindaw,2011-12-19 18:15:36+00:00,['e3307a6fb3ad213bfc95e2d54810fbeb2653dc72'],45,101,146,516043,3,0.14,0.76,0.68,1918
e7e2e238f69a6a298dc385d4d2508b33677377ad,0,Heshan Theekshana Suriyaarachchi,2011-12-19 18:29:34+00:00,['b8febdf7b611fa8a1f8c0170d5b0d1c9682adf31'],0,408,408,516451,1,,,,1919
6880f3851fd782dbf674805da9c36a06b6d32f80,0,Heshan Theekshana Suriyaarachchi,2011-12-19 18:31:26+00:00,['e7e2e238f69a6a298dc385d4d2508b33677377ad'],0,38,38,516489,1,1,0.285714286,0.857142857,1920
cf369b5e125896163df56ab7a7319b32f203eddc,0,Heshan Theekshana Suriyaarachchi,2011-12-19 18:35:25+00:00,['6880f3851fd782dbf674805da9c36a06b6d32f80'],0,35,35,516524,1,1,1,1,1921
f049e24221b329373587d9514c03c6fc44e45f63,0,Heshan Theekshana Suriyaarachchi,2011-12-19 18:38:04+00:00,['cf369b5e125896163df56ab7a7319b32f203eddc'],2,7,9,516533,1,0,1,1,1921
1aca751b27b570dcb7015c31e802361362b35a98,0,Heshan Theekshana Suriyaarachchi,2011-12-19 18:41:06+00:00,['f049e24221b329373587d9514c03c6fc44e45f63'],14,42,56,516589,2,,,,1921
7089c7dd609879d1532ada3924bcc328f6bdd1a5,0,Heshan Theekshana Suriyaarachchi,2011-12-19 18:54:56+00:00,['1aca751b27b570dcb7015c31e802361362b35a98'],2,1,3,516592,1,,,,1921
a4d5f6259159f9dc107d6baa5dc4eb42918a8755,0,Heshan Theekshana Suriyaarachchi,2011-12-19 19:08:20+00:00,['7089c7dd609879d1532ada3924bcc328f6bdd1a5'],133,130,263,516855,1,,,,1921
827bd36772e1cb7c6912850c0854e98cf1da973f,0,samindaw,2011-12-19 19:13:58+00:00,['a4d5f6259159f9dc107d6baa5dc4eb42918a8755'],11,69,80,516935,4,0.36,1,1,1922
406a023fa622da0ed0a0040d8644f69021b9bb59,0,samindaw,2011-12-19 19:29:51+00:00,['827bd36772e1cb7c6912850c0854e98cf1da973f'],2,2,4,516939,1,,,,1922
65a4edfab9c3843de21e8edd8a2067d08fdf850e,0,Lahiru Gunathilake,2011-12-19 20:57:46+00:00,['406a023fa622da0ed0a0040d8644f69021b9bb59'],9,25,34,516973,3,0,0,1,1922
016a9f75b86bd87fb23e065f417c073ee5550f05,0,Heshan Theekshana Suriyaarachchi,2011-12-20 18:37:51+00:00,['65a4edfab9c3843de21e8edd8a2067d08fdf850e'],0,843,843,517816,1,,,,1923
5d8e47dc0539d0c53f758b4164224bd86819f519,0,Heshan Theekshana Suriyaarachchi,2011-12-20 18:38:16+00:00,['016a9f75b86bd87fb23e065f417c073ee5550f05'],0,841,841,518657,1,,,,1924
dbaa609e38eee163a73b9f729815b025d4947432,0,Heshan Theekshana Suriyaarachchi,2011-12-20 18:39:56+00:00,['5d8e47dc0539d0c53f758b4164224bd86819f519'],0,5,5,518662,1,0,1,1,1924
19ac6e3295eab504fe803d42572b18c892fe1a29,0,Heshan Theekshana Suriyaarachchi,2011-12-20 18:41:11+00:00,['dbaa609e38eee163a73b9f729815b025d4947432'],0,20,20,518682,2,1,1,1,1926
79782ecd1d344aff7cb4f587908e4d58284588a5,0,Heshan Theekshana Suriyaarachchi,2011-12-20 18:42:53+00:00,['19ac6e3295eab504fe803d42572b18c892fe1a29'],5,2,7,518689,1,0,0,0,1926
48491959c1e9bf2524f6cdc874ebf2f693715a95,0,Heshan Theekshana Suriyaarachchi,2011-12-20 18:45:25+00:00,['79782ecd1d344aff7cb4f587908e4d58284588a5'],0,11,11,518700,1,1,1,1,1927
f89ae6426b9745efaf2534cfa0b6ad19bce0a3e0,0,Heshan Theekshana Suriyaarachchi,2011-12-20 18:47:01+00:00,['48491959c1e9bf2524f6cdc874ebf2f693715a95'],0,28,28,518728,1,1,1,1,1928
d321f9b5afb12d8a6b9d1c188c157a64773015da,0,Heshan Theekshana Suriyaarachchi,2011-12-20 18:47:57+00:00,['f89ae6426b9745efaf2534cfa0b6ad19bce0a3e0'],0,27,27,518755,1,1,1,1,1929
4bbd534574a53e04345807565fa5d7ed5e100afa,0,Heshan Theekshana Suriyaarachchi,2011-12-20 18:54:00+00:00,['d321f9b5afb12d8a6b9d1c188c157a64773015da'],0,854,854,519609,1,,,,1930
37409b0a27a08e277105549098fbe04f79f2d329,0,Heshan Theekshana Suriyaarachchi,2011-12-20 19:01:57+00:00,['4bbd534574a53e04345807565fa5d7ed5e100afa'],20,0,20,519629,2,0,0,0,1930
20ee2b32d8fb4a422e325d8d291e84a950d09463,0,Lahiru Gunathilake,2011-12-20 20:04:28+00:00,['37409b0a27a08e277105549098fbe04f79f2d329'],1,677,678,520307,7,0.436363636,0.927272727,0.963636364,1936
aabfb9baa0aba6ec898dc24258ccdc2a52c654b5,0,Heshan Theekshana Suriyaarachchi,2011-12-20 20:22:31+00:00,['20ee2b32d8fb4a422e325d8d291e84a950d09463'],40,16,56,520363,1,,,,1936
676cae0dd00f9d6e8ff3ab3cbf475bcfc7bfa01a,0,Heshan Theekshana Suriyaarachchi,2011-12-20 20:31:49+00:00,['aabfb9baa0aba6ec898dc24258ccdc2a52c654b5'],11,1,12,520375,1,,,,1936
bb818505266c890dbc5f232c3e89ce0e332d3d30,0,Heshan Theekshana Suriyaarachchi,2011-12-20 20:40:50+00:00,['676cae0dd00f9d6e8ff3ab3cbf475bcfc7bfa01a'],2,0,2,520377,1,,,,1936
b2aba0028b5844133e43775cc228d14d78728949,0,Heshan Theekshana Suriyaarachchi,2011-12-20 20:56:58+00:00,['bb818505266c890dbc5f232c3e89ce0e332d3d30'],854,0,854,521231,1,,,,1936
0c02ea009b723fb9b5a6bcda9eefeb84d19b46d6,0,Heshan Theekshana Suriyaarachchi,2011-12-20 21:47:04+00:00,['b2aba0028b5844133e43775cc228d14d78728949'],0,63,63,521294,3,,,,1936
9f260657a109c69b4c2976778b81f9caaa831d6b,0,Heshan Theekshana Suriyaarachchi,2011-12-20 21:53:31+00:00,['0c02ea009b723fb9b5a6bcda9eefeb84d19b46d6'],3,27,30,521324,3,,,,1936
47cd88db74e19459f526d7610fb45f1246081e08,0,Lahiru Gunathilake,2011-12-21 03:48:13+00:00,['9f260657a109c69b4c2976778b81f9caaa831d6b'],0,176,176,521500,1,0,1,1,1937
c616b3cacfec09cefe8fd994b7d41ca219fe6f37,0,Heshan Theekshana Suriyaarachchi,2011-12-21 15:19:00+00:00,['47cd88db74e19459f526d7610fb45f1246081e08'],1,1,2,521502,2,,,,1937
c52372d85e1218be5dc5bbb855f3f39dacdc0fef,0,Heshan Theekshana Suriyaarachchi,2011-12-21 17:16:59+00:00,['c616b3cacfec09cefe8fd994b7d41ca219fe6f37'],13,13,26,521528,5,,,,1937
a7a28b06d027c8682b598464418a1bb62f4b3033,0,Lahiru Gunathilake,2011-12-21 20:09:58+00:00,['c52372d85e1218be5dc5bbb855f3f39dacdc0fef'],27,78,105,521633,3,0,1,1,1937
023c1c300f0027b389208749e2f527832ba0f7c4,0,Heshan Theekshana Suriyaarachchi,2011-12-21 23:36:05+00:00,['a7a28b06d027c8682b598464418a1bb62f4b3033'],0,247,247,521880,5,1,1,1,1942
1d93193e0eae9bf5812b77fea14be97f2298049a,0,Heshan Theekshana Suriyaarachchi,2011-12-21 23:37:45+00:00,['023c1c300f0027b389208749e2f527832ba0f7c4'],0,211,211,522091,5,1,0.166666667,0.833333333,1947
e083c078d4c4b501bf0106ede62a66fb19526cce,0,Heshan Theekshana Suriyaarachchi,2011-12-21 23:43:07+00:00,['1d93193e0eae9bf5812b77fea14be97f2298049a'],3,3,6,522097,2,,,,1947
03af5ab165d48bdc4b005c4401bc0435b193d904,0,Heshan Theekshana Suriyaarachchi,2011-12-21 23:44:02+00:00,['e083c078d4c4b501bf0106ede62a66fb19526cce'],3,19,22,522119,2,,,,1947
34896958dfc04af8cb0e94e7112f09847d592697,0,Heshan Theekshana Suriyaarachchi,2011-12-22 00:03:55+00:00,['03af5ab165d48bdc4b005c4401bc0435b193d904'],4,0,4,522123,1,,,,1947
2a8fd047dca321b3c9f2d1811817deb0765f2c9b,0,Heshan Theekshana Suriyaarachchi,2011-12-22 00:24:32+00:00,['34896958dfc04af8cb0e94e7112f09847d592697'],6,6,12,522135,2,,,,1947
8342c2ad2ad1def3d277998d4b00d11dc32bea6e,0,Heshan Theekshana Suriyaarachchi,2011-12-22 01:25:51+00:00,['2a8fd047dca321b3c9f2d1811817deb0765f2c9b'],2,2,4,522139,1,,,,1947
de80a85615baebb14ebec9bd679ef99ee5ed74c0,0,Lahiru Gunathilake,2011-12-22 01:40:36+00:00,['8342c2ad2ad1def3d277998d4b00d11dc32bea6e'],0,169,169,522308,1,0,1,1,1948
47a9bae2a519cb79b40c73f8df2f15941b946b0e,0,Lahiru Gunathilake,2011-12-22 01:46:01+00:00,['de80a85615baebb14ebec9bd679ef99ee5ed74c0'],20,20,40,522348,1,1,0,0,1948
b5d16c7586623369a3d113089bc940a2cf86b22c,0,Heshan Theekshana Suriyaarachchi,2011-12-22 01:52:22+00:00,['47a9bae2a519cb79b40c73f8df2f15941b946b0e'],6,6,12,522360,2,,,,1948
b64e7a4c7c0b48e4e8549204a33427f4a4a04100,0,Lahiru Gunathilake,2011-12-22 02:13:36+00:00,['b5d16c7586623369a3d113089bc940a2cf86b22c'],3,0,3,522363,2,,,,1948
eaf420e288b802473a67c89acdcb30d23dae98bb,0,Heshan Theekshana Suriyaarachchi,2011-12-22 02:24:03+00:00,['b64e7a4c7c0b48e4e8549204a33427f4a4a04100'],3,0,3,522366,2,,,,1948
0e8034d90fc84b081b771be6889ee1f320fdef0e,0,Heshan Theekshana Suriyaarachchi,2011-12-22 02:24:15+00:00,['eaf420e288b802473a67c89acdcb30d23dae98bb'],3,0,3,522369,2,,,,1948
4e9ef18c7630fb52ff09fb48d6c12fff7419f258,0,Lahiru Gunathilake,2011-12-22 02:50:36+00:00,['0e8034d90fc84b081b771be6889ee1f320fdef0e'],20,70,90,522459,5,0.571428571,1,1,1948
d6e2e6699c2f48ef85ce969ef75db60ecd85adbd,0,Heshan Theekshana Suriyaarachchi,2011-12-22 03:10:46+00:00,['4e9ef18c7630fb52ff09fb48d6c12fff7419f258'],0,7,7,522466,1,,,,1948
9cd1b7d80f2d466f5e19dd1ef6c0f6b078cb6707,0,Heshan Theekshana Suriyaarachchi,2011-12-22 16:18:49+00:00,['d6e2e6699c2f48ef85ce969ef75db60ecd85adbd'],0,3,3,522469,2,,,,1948
2c99306de227a9ddf4bf6639b97410dd58acb4b5,0,Lahiru Gunathilake,2011-12-22 19:57:15+00:00,['9cd1b7d80f2d466f5e19dd1ef6c0f6b078cb6707'],1,65,66,522535,1,0,1,1,1948
c4d3a40ff1714de9b5a92fa91681ca9bd9d8d67d,0,Heshan Theekshana Suriyaarachchi,2011-12-27 15:09:43+00:00,['2c99306de227a9ddf4bf6639b97410dd58acb4b5'],0,56,56,522591,4,,,,1948
25bb75a09ac765f7bc15abfb555a41985290bc8b,0,Heshan Theekshana Suriyaarachchi,2011-12-28 16:52:27+00:00,['c4d3a40ff1714de9b5a92fa91681ca9bd9d8d67d'],2,22,24,522615,2,,,,1948
62313d0afe296a2853157857938fc2a19b61ede3,0,Heshan Theekshana Suriyaarachchi,2011-12-28 17:29:14+00:00,['25bb75a09ac765f7bc15abfb555a41985290bc8b'],20,276,296,522911,3,,,,1948
3bcca84a74f954ce8f51dd8bad4b1b761649f002,0,Heshan Theekshana Suriyaarachchi,2011-12-28 18:09:15+00:00,['62313d0afe296a2853157857938fc2a19b61ede3'],1,1,2,522913,1,,,,1948
4f93a0677eebed2c51b1de34c820e4806ce67695,0,Heshan Theekshana Suriyaarachchi,2011-12-28 18:20:49+00:00,['3bcca84a74f954ce8f51dd8bad4b1b761649f002'],1,2,3,522916,1,,,,1948
18c854ede25d5491ea511d92e982f79e9750d64f,0,samindaw,2011-12-29 00:10:13+00:00,['4f93a0677eebed2c51b1de34c820e4806ce67695'],4,4,8,522924,1,1,0,0,1948
b8ca79f552e7781657182f84e20c9bfce0645e55,0,Heshan Theekshana Suriyaarachchi,2011-12-29 15:46:10+00:00,['18c854ede25d5491ea511d92e982f79e9750d64f'],2,2,4,522928,2,,,,1948
cd54769abb9ccd9fcc41e9a9accd7345c0bd9368,0,Lahiru Gunathilake,2011-12-29 17:16:55+00:00,['b8ca79f552e7781657182f84e20c9bfce0645e55'],67,721,788,523716,9,0.517915309,0.768729642,0.925081433,1953
4640144f5559237f2f4170b51a47b444f75cc6e5,0,samindaw,2011-12-30 02:24:21+00:00,['cd54769abb9ccd9fcc41e9a9accd7345c0bd9368'],11,0,11,523727,3,,,,1953
5be14a59eb50f6935c1a164de31760488f6861dc,0,Heshan Theekshana Suriyaarachchi,2011-12-30 02:47:40+00:00,['4640144f5559237f2f4170b51a47b444f75cc6e5'],0,30,30,523757,1,,,,1953
2bf64e5004c5476722e550b6442e9484dbc0c7a7,0,Heshan Theekshana Suriyaarachchi,2011-12-30 03:16:28+00:00,['5be14a59eb50f6935c1a164de31760488f6861dc'],5,0,5,523762,1,,,,1953
81a5638f714a2c71cf612269456245d8952a5fc9,0,Lahiru Gunathilake,2011-12-30 17:09:46+00:00,['2bf64e5004c5476722e550b6442e9484dbc0c7a7'],2,4,6,523768,2,,,,1953
11bb622164935c5b6c95bbda81d930fa6906e3a7,0,Lahiru Gunathilake,2012-01-02 15:40:39+00:00,['81a5638f714a2c71cf612269456245d8952a5fc9'],2,2,4,523772,7,,,,1953
1daf804093f1192a29786df2027f2a977c64be80,0,Lahiru Gunathilake,2012-01-02 15:45:31+00:00,['11bb622164935c5b6c95bbda81d930fa6906e3a7'],2,2,4,523776,3,,,,1953
6cc230323bc28a44727ca7b090e94a02c04beac7,0,Lahiru Gunathilake,2012-01-02 19:33:56+00:00,['1daf804093f1192a29786df2027f2a977c64be80'],23,17,40,523816,1,1,0,0,1953
02bcc07b2438f7a356be8aeba272bc0c4c9897b5,0,Lahiru Gunathilake,2012-01-06 19:13:19+00:00,['6cc230323bc28a44727ca7b090e94a02c04beac7'],0,3,3,523819,1,0,0,1,1953
4608bd1d3f9e9e88d82e1194c368612e0ee44b1c,0,Lahiru Gunathilake,2012-01-06 20:49:07+00:00,['02bcc07b2438f7a356be8aeba272bc0c4c9897b5'],7,21,28,523847,1,0,0.727272727,0,1953
d5c9339290e670178167b11850545729a8674342,0,Lahiru Gunathilake,2012-01-06 21:42:29+00:00,['4608bd1d3f9e9e88d82e1194c368612e0ee44b1c'],1,2,3,523850,1,0,0,1,1953
a95c1c01752f9f68e28ef9192e9553b5e68e99ab,0,Lahiru Gunathilake,2012-01-07 02:13:34+00:00,['d5c9339290e670178167b11850545729a8674342'],70,0,70,523920,1,,,,1953
166e52609d49726107899c6df5c0d9c3057a0d22,0,Lahiru Gunathilake,2012-01-07 02:14:37+00:00,['a95c1c01752f9f68e28ef9192e9553b5e68e99ab'],1,71,72,523992,2,,,,1954
fff9ec0312c432126e9835b66bc0cc89d1be083d,0,Lahiru Gunathilake,2012-01-07 02:15:54+00:00,['166e52609d49726107899c6df5c0d9c3057a0d22'],5,4,9,524001,1,,,,1954
977ca6bf76f17a5f5965becc0adbda72e1f5d218,0,Lahiru Gunathilake,2012-01-09 17:48:56+00:00,['fff9ec0312c432126e9835b66bc0cc89d1be083d'],7,9,16,524017,2,0,0,1,1954
3132ac44b5a897c31abc8649e8df08749369c63f,0,Lahiru Gunathilake,2012-01-09 18:32:55+00:00,['977ca6bf76f17a5f5965becc0adbda72e1f5d218'],1,1,2,524019,1,,,,1954
db2fedc004dc85e7c1f80dff80fd8d5f7c8cc25a,0,Lahiru Gunathilake,2012-01-09 18:38:03+00:00,['3132ac44b5a897c31abc8649e8df08749369c63f'],1,1,2,524021,1,,,,1954
829931b5475d89707e84c4812a9aec54c7bbf5da,0,Lahiru Gunathilake,2012-01-09 18:58:51+00:00,['db2fedc004dc85e7c1f80dff80fd8d5f7c8cc25a'],1,1,2,524023,1,,,,1954
3a90a1b1291957985fe0a5cf6a3cc8f1ccf61925,0,Lahiru Gunathilake,2012-01-09 19:03:46+00:00,['829931b5475d89707e84c4812a9aec54c7bbf5da'],1,1,2,524025,1,,,,1954
be5121aaf36cd2aa73d71dc0fbc805bcd205a86a,0,Lahiru Gunathilake,2012-01-09 20:49:13+00:00,['3a90a1b1291957985fe0a5cf6a3cc8f1ccf61925'],3,25,28,524053,3,1,1,1,1954
b3579bbdefd52e2255b7058b70d188e0bb133601,0,Lahiru Gunathilake,2012-01-09 20:52:45+00:00,['be5121aaf36cd2aa73d71dc0fbc805bcd205a86a'],0,9,9,524062,2,,,,1955
7a1e2f4862fdd49af89c6c2047fcdd0558bacc8b,0,Lahiru Gunathilake,2012-01-09 21:00:52+00:00,['b3579bbdefd52e2255b7058b70d188e0bb133601'],2,4,6,524068,1,,,,1955
ed6780e108641faf8affc6fd8def67d3f2bfbd43,0,Lahiru Gunathilake,2012-01-09 22:24:49+00:00,['7a1e2f4862fdd49af89c6c2047fcdd0558bacc8b'],4,4,8,524076,1,,,,1955
6eba54cf0b7786e3c22a6fd03ecf81fece01dddd,0,Heshan Theekshana Suriyaarachchi,2012-01-10 03:00:33+00:00,['ed6780e108641faf8affc6fd8def67d3f2bfbd43'],10,0,10,524086,2,,,,1955
5c412773b4dd63325c0e007d38bce14057193f68,0,Lahiru Gunathilake,2012-01-11 22:35:44+00:00,['6eba54cf0b7786e3c22a6fd03ecf81fece01dddd'],4,4,8,524094,1,,,,1955
d86bba5f77715b6f63a5610925df758fcd699587,0,Lahiru Gunathilake,2012-01-12 17:08:08+00:00,['5c412773b4dd63325c0e007d38bce14057193f68'],0,5,5,524099,1,0,0,1,1955
bd7ec0c1ea2af34054443cec5b1fbb95c08b169c,0,Lahiru Gunathilake,2012-01-12 21:03:04+00:00,['d86bba5f77715b6f63a5610925df758fcd699587'],3,3,6,524105,14,,,,1955
ef45295ea30acb1a38a03efe7765f92a9355842b,0,Lahiru Gunathilake,2012-01-12 21:03:19+00:00,['bd7ec0c1ea2af34054443cec5b1fbb95c08b169c'],8,8,16,524121,10,,,,1955
39ef224a73f9488c24a31683be945d0b3499fcef,0,Lahiru Gunathilake,2012-01-12 21:03:51+00:00,['ef45295ea30acb1a38a03efe7765f92a9355842b'],1,1,2,524123,1,,,,1955
6c36cebf6e5c326a231c6c13569e51ea79a6746b,0,Lahiru Gunathilake,2012-01-13 19:33:06+00:00,['39ef224a73f9488c24a31683be945d0b3499fcef'],0,43,43,524166,2,0,1,1,1955
0d526145668d74805b0c446445462a0c3088c547,0,Lahiru Gunathilake,2012-01-13 19:40:31+00:00,['6c36cebf6e5c326a231c6c13569e51ea79a6746b'],4,12,16,524182,1,0.428571429,0.857142857,1,1955
32839d134f02a86f68500268c1fbf3287c1eddc5,0,Lahiru Gunathilake,2012-01-13 20:28:36+00:00,['0d526145668d74805b0c446445462a0c3088c547'],12,44,56,524238,2,0,0.45,0.55,1955
2e1106b0e85e28fd1326b629573b22c9c20be218,0,Lahiru Gunathilake,2012-01-13 20:29:11+00:00,['32839d134f02a86f68500268c1fbf3287c1eddc5'],5,8,13,524251,2,,,,1955
f231d6d25a5f5a81220783febf74afed9f266f87,0,Lahiru Gunathilake,2012-01-13 20:56:54+00:00,['2e1106b0e85e28fd1326b629573b22c9c20be218'],3,10,13,524264,1,,,,1955
9f5a6d03351bf76a51c4c519c783eccef2de8768,0,Lahiru Gunathilake,2012-01-13 21:40:17+00:00,['f231d6d25a5f5a81220783febf74afed9f266f87'],1,2,3,524267,1,1,1,0,1955
565f14fb87cc55c333b62f9d608bc7420cc61e80,0,Lahiru Gunathilake,2012-01-13 21:52:08+00:00,['9f5a6d03351bf76a51c4c519c783eccef2de8768'],1,11,12,524279,1,0,0,1,1955
ab2448bf13f5bc7168646a200d162bbad008aeb3,0,samindaw,2012-01-17 15:11:10+00:00,['565f14fb87cc55c333b62f9d608bc7420cc61e80'],435,693,1128,525407,75,0.25,1,0.84375,1958
38bf6fa833a23422e8c7e9676b51832dcddaa542,0,samindaw,2012-01-17 15:22:25+00:00,['ab2448bf13f5bc7168646a200d162bbad008aeb3'],11,0,11,525418,1,,,,1958
ecadf2279fb3538126519f4fa2b17afa463e6a71,0,Lahiru Gunathilake,2012-01-17 16:08:13+00:00,['38bf6fa833a23422e8c7e9676b51832dcddaa542'],5,14,19,525437,1,0,0,1,1958
d49e0edd7f7cfef5ea3b741c797e5766f13c2054,0,Lahiru Gunathilake,2012-01-17 16:35:29+00:00,['ecadf2279fb3538126519f4fa2b17afa463e6a71'],6,21,27,525464,1,,,,1958
f02ad1963fc94cc39b5e4c48ad2eeeb441665e8f,0,Lahiru Gunathilake,2012-01-17 17:18:43+00:00,['d49e0edd7f7cfef5ea3b741c797e5766f13c2054'],0,17,17,525481,2,1,1,0.666666667,1958
96814dad1ecb8acd1860e643682a7bb76fecb921,0,samindaw,2012-01-17 17:47:10+00:00,['f02ad1963fc94cc39b5e4c48ad2eeeb441665e8f'],15,68,83,525564,1,0.346938776,1,0.734693878,1958
893fd419337821b2a39c3b996a6e4df90845afe6,0,samindaw,2012-01-17 18:00:37+00:00,['96814dad1ecb8acd1860e643682a7bb76fecb921'],9,10,19,525583,2,0,1,1,1958
3bfbb2dfc9c1fb0e3b30b66bab100d1f98e688d0,0,Lahiru Gunathilake,2012-01-17 19:04:17+00:00,['893fd419337821b2a39c3b996a6e4df90845afe6'],18,34,52,525635,1,0,0,1,1958
ff48b5f523a03721b038ce271947c554e246bb96,0,Lahiru Gunathilake,2012-01-17 21:20:46+00:00,['3bfbb2dfc9c1fb0e3b30b66bab100d1f98e688d0'],1,3,4,525639,1,0,1,1,1958
3a9c4fdf6ccf5063b5a2bf7cf06e8009ad4f29a9,0,Lahiru Gunathilake,2012-01-18 19:30:37+00:00,['ff48b5f523a03721b038ce271947c554e246bb96'],0,78,78,525717,2,0.205882353,1,1,1958
34de37c705eda52d2cb768ce3a7f95fc1e28d86d,0,Lahiru Gunathilake,2012-01-20 17:44:44+00:00,['3a9c4fdf6ccf5063b5a2bf7cf06e8009ad4f29a9'],6,9,15,525732,1,1,1,1,1958
55ffe1490b478eef236bcde82f7516330aba2d34,0,Lahiru Gunathilake,2012-01-20 17:45:56+00:00,['34de37c705eda52d2cb768ce3a7f95fc1e28d86d'],0,1,1,525733,1,,,,1958
0be648b138437c51b1a3ad55467a7d43c780e6f1,0,Lahiru Gunathilake,2012-01-20 17:48:36+00:00,['55ffe1490b478eef236bcde82f7516330aba2d34'],2,11,13,525746,2,0,1,1,1958
e4dc21ae45a56b9d3e16ef74520a90aeebe08de4,0,samindaw,2012-01-20 19:25:19+00:00,['0be648b138437c51b1a3ad55467a7d43c780e6f1'],218,538,756,526502,28,0.427927928,0.468468468,0.900900901,1959
06799fb081cbbe5c6684ae7221de07058b261036,0,samindaw,2012-01-20 21:42:59+00:00,['e4dc21ae45a56b9d3e16ef74520a90aeebe08de4'],88,429,517,527019,10,0.664596273,1,1,1963
3dd202dc4aa38c7d363b6b2cf1aae39902bda542,0,samindaw,2012-01-20 21:43:55+00:00,['06799fb081cbbe5c6684ae7221de07058b261036'],1,1,2,527021,1,,,,1963
89b869bb59edd1a20e342cc84fc363642000fe14,0,samindaw,2012-01-20 22:19:31+00:00,['3dd202dc4aa38c7d363b6b2cf1aae39902bda542'],3,62,65,527086,2,0.255319149,0.659574468,0.574468085,1963
93471c323f8187594fbf4a82540d3ff57412cc72,0,samindaw,2012-01-20 22:30:52+00:00,['89b869bb59edd1a20e342cc84fc363642000fe14'],3,21,24,527110,1,0.857142857,1,0.571428571,1963
80370e2ee298104706187d2feeb6e88dd723d400,0,Heshan Theekshana Suriyaarachchi,2012-01-20 22:43:55+00:00,['93471c323f8187594fbf4a82540d3ff57412cc72'],1,1,2,527112,1,,,,1963
165f3690d95c6425b5cd1f9568026f3f5ee355b6,0,Heshan Theekshana Suriyaarachchi,2012-01-20 22:48:38+00:00,['80370e2ee298104706187d2feeb6e88dd723d400'],132,141,273,527385,1,1,1,1,1963
8477d68d94e87c9775efe9303ff44d7ec35a0bbb,0,samindaw,2012-01-20 22:50:48+00:00,['165f3690d95c6425b5cd1f9568026f3f5ee355b6'],6,76,82,527467,5,0.459016393,1,0.524590164,1963
674e16093e1f47112519145dbd886ce67ac77177,0,samindaw,2012-01-20 23:14:50+00:00,['8477d68d94e87c9775efe9303ff44d7ec35a0bbb'],9,28,37,527504,4,0.333333333,1,1,1963
4b6ca8799086c8f62eab9983b8e15ededeebaba6,0,Lahiru Gunathilake,2012-01-23 23:03:10+00:00,['674e16093e1f47112519145dbd886ce67ac77177'],70,134,204,527708,3,0,0,0.679245283,1963
fa553cd35fd41c99c70b118238e5040574967ee3,0,Lahiru Gunathilake,2012-01-23 23:47:54+00:00,['4b6ca8799086c8f62eab9983b8e15ededeebaba6'],2,3,5,527713,1,0,0,0,1963
3a07103779b56deabccffa6656f7da41e3327b7b,0,Lahiru Gunathilake,2012-01-24 18:55:34+00:00,['fa553cd35fd41c99c70b118238e5040574967ee3'],8,8,16,527729,1,0,0,0,1963
783fdc75dea3332ee18130f62439fbd5187497ab,0,Lahiru Gunathilake,2012-01-24 20:06:03+00:00,['3a07103779b56deabccffa6656f7da41e3327b7b'],5,11,16,527745,1,0,1,1,1963
285786752bf9ad10ef29c8859ebf22f13e9a5150,0,Lahiru Gunathilake,2012-01-24 20:42:44+00:00,['783fdc75dea3332ee18130f62439fbd5187497ab'],1,1,2,527747,1,,,,1963
f919573b6845a25da03dc8ea03ee94df46a31f00,0,Lahiru Gunathilake,2012-01-24 21:12:30+00:00,['285786752bf9ad10ef29c8859ebf22f13e9a5150'],1,1,2,527749,1,,,,1963
86959dc40c949689e516ee45b23c2a4e3ec84dd8,0,samindaw,2012-01-25 19:11:33+00:00,['f919573b6845a25da03dc8ea03ee94df46a31f00'],12,26,38,527787,1,0,1,1,1963
2209f9ea57e1e7f7d211aaee53830d5aebb6ed15,0,Lahiru Gunathilake,2012-01-25 20:43:58+00:00,['86959dc40c949689e516ee45b23c2a4e3ec84dd8'],0,1,1,527788,1,,,,1963
61ef490ff15444d10d1a4fbca4944801959f9424,0,Lahiru Gunathilake,2012-01-25 20:44:45+00:00,['2209f9ea57e1e7f7d211aaee53830d5aebb6ed15'],0,1,1,527789,1,1,1,1,1963
963714c19c2ce2ebbe48a61b8f453efd3a1c8c8e,0,samindaw,2012-01-25 22:43:17+00:00,['61ef490ff15444d10d1a4fbca4944801959f9424'],13,23,36,527825,1,0,0,0,1963
b86d1b895aae30ef3c0b810c3264340c537ab213,0,samindaw,2012-01-26 21:26:59+00:00,['963714c19c2ce2ebbe48a61b8f453efd3a1c8c8e'],4,8,12,527837,3,1,1,1,1963
0bf3ce0deaafe7913fd2f80bc0d13596ab59b892,1,Lahiru Gunathilake,2012-01-27 19:00:20+00:00,['b86d1b895aae30ef3c0b810c3264340c537ab213'],79,142,221,528058,6,0.34375,0.34375,0.8125,1964
7cf2e2c1b2193962644630eeae3a4678dc769aaa,0,Lahiru Gunathilake,2012-01-27 19:09:28+00:00,['0bf3ce0deaafe7913fd2f80bc0d13596ab59b892'],12,12,24,528082,2,0,0,0,1964
1ccbdf362e44c493128f347bca21ec09429be508,0,Lahiru Gunathilake,2012-01-28 16:11:17+00:00,['7cf2e2c1b2193962644630eeae3a4678dc769aaa'],0,8,8,528090,1,0,0,1,1964
c34cf50d730a902870375e4bf46976aca6191c7b,0,Lahiru Gunathilake,2012-01-28 16:19:40+00:00,['1ccbdf362e44c493128f347bca21ec09429be508'],1,1,2,528092,1,,,,1964
28256aa301b8b87203185405ac641f60b5ec0ffa,0,Lahiru Gunathilake,2012-01-28 16:47:25+00:00,['c34cf50d730a902870375e4bf46976aca6191c7b'],2,14,16,528108,1,0,0,1,1964
10ab7fd420a6750a28555a1f78073ec060f1a28c,1,Lahiru Gunathilake,2012-01-29 17:42:55+00:00,['28256aa301b8b87203185405ac641f60b5ec0ffa'],2,13,15,528123,1,0,0,0.5,1964
63edf11de1471c0c00ee9552ff2c306ca715dbd3,1,Lahiru Gunathilake,2012-01-29 22:13:32+00:00,['10ab7fd420a6750a28555a1f78073ec060f1a28c'],1,7,8,528131,1,0,0,1,1964
ff2d32a4ad11c33b5aacba1b6290e7e204224dcc,0,Lahiru Gunathilake,2012-01-30 20:21:30+00:00,['63edf11de1471c0c00ee9552ff2c306ca715dbd3'],42,60,102,528233,5,0.666666667,0.777777778,0.888888889,1964
69f70c1b10e2c25f936dcd3e0b5d0d39be52b868,0,Heshan Theekshana Suriyaarachchi,2012-01-31 15:16:37+00:00,['ff2d32a4ad11c33b5aacba1b6290e7e204224dcc'],0,8,8,528241,1,1,1,1,1964
06161335cb05dd328b676d3b7abf9c1f2f8937f3,0,Heshan Theekshana Suriyaarachchi,2012-01-31 15:17:50+00:00,['69f70c1b10e2c25f936dcd3e0b5d0d39be52b868'],0,8,8,528249,1,1,1,1,1964
5104b8170383aca322939fcb4ed99cdd01ba09ce,0,Heshan Theekshana Suriyaarachchi,2012-01-31 16:45:32+00:00,['06161335cb05dd328b676d3b7abf9c1f2f8937f3'],24,40,64,528313,6,0,0,0,1965
93f126815162bab9f2582092bfbcdbe4ea2dd7a0,0,Heshan Theekshana Suriyaarachchi,2012-01-31 16:46:04+00:00,['5104b8170383aca322939fcb4ed99cdd01ba09ce'],0,14,14,528327,1,,,,1965
78fbb84dc4719d987d4ee1bab3a7da307ba74145,0,Heshan Theekshana Suriyaarachchi,2012-01-31 18:37:40+00:00,['93f126815162bab9f2582092bfbcdbe4ea2dd7a0'],10,13,23,528350,7,0.714285714,1,1,1965
ae0906d91290587ca95925b897d3dac45f152c62,0,Lahiru Gunathilake,2012-01-31 19:30:10+00:00,['78fbb84dc4719d987d4ee1bab3a7da307ba74145'],18,87,105,528455,4,0,1,1,1965
36bf37fac378eb583452e03b297dad79ae2d6e8f,0,Lahiru Gunathilake,2012-01-31 19:58:43+00:00,['ae0906d91290587ca95925b897d3dac45f152c62'],91,22,113,528568,4,1,0,0,1965
bbf76d1849b519ead331e25b6fdce18b62d238fa,0,Lahiru Gunathilake,2012-01-31 20:45:42+00:00,['36bf37fac378eb583452e03b297dad79ae2d6e8f'],4,8,12,528580,1,0,0,0.666666667,1965
37caee28685f4481ef409bad4b94336d4d326ab6,0,Lahiru Gunathilake,2012-02-01 16:14:11+00:00,['bbf76d1849b519ead331e25b6fdce18b62d238fa'],1,2,3,528583,1,,,,1965
5b99f1cfa16aaf3f08df7aad42746e9a61a857d9,0,Lahiru Gunathilake,2012-02-01 16:39:12+00:00,['37caee28685f4481ef409bad4b94336d4d326ab6'],4,2,6,528589,1,1,1,0,1965
b8b2c4b66e4baa5597708a5d6dd2686b707bbe3f,0,Lahiru Gunathilake,2012-02-01 17:06:19+00:00,['5b99f1cfa16aaf3f08df7aad42746e9a61a857d9'],2,5,7,528596,1,0,0,1,1965
4c49f7ba4a4d441c77ccdd49803d7f7ec0b62fdf,0,Lahiru Gunathilake,2012-02-01 19:09:54+00:00,['b8b2c4b66e4baa5597708a5d6dd2686b707bbe3f'],3,20,23,528619,2,0,0,1,1965
69a5002cc5834c4eeb0aaba29b492f421f484bae,0,Heshan Theekshana Suriyaarachchi,2012-02-02 14:48:56+00:00,['4c49f7ba4a4d441c77ccdd49803d7f7ec0b62fdf'],1,1,2,528621,1,,,,1965
7b51312ed8d46d758b81ca385f8ddbd3252c2772,0,Heshan Theekshana Suriyaarachchi,2012-02-02 15:22:54+00:00,['69a5002cc5834c4eeb0aaba29b492f421f484bae'],6,31,37,528658,7,1,1,1,1965
a3416af808c20d8e8e4ad3dbe56cbedbaa3c95e0,0,Heshan Theekshana Suriyaarachchi,2012-02-02 15:43:20+00:00,['7b51312ed8d46d758b81ca385f8ddbd3252c2772'],14,124,138,528796,10,1,1,1,1965
443a9062aaa0709e42dc1e8e9009e0a5409d39bf,0,Heshan Theekshana Suriyaarachchi,2012-02-02 16:03:54+00:00,['a3416af808c20d8e8e4ad3dbe56cbedbaa3c95e0'],2,2,4,528800,1,,,,1965
c043d225a8db12cc0d059ce8f3605a425121e815,0,Heshan Theekshana Suriyaarachchi,2012-02-02 18:55:45+00:00,['443a9062aaa0709e42dc1e8e9009e0a5409d39bf'],0,0,0,528800,6,,,,1971
e499670c2ddec329c3b0b7ed6943792dd22af4a3,0,Heshan Theekshana Suriyaarachchi,2012-02-02 20:51:45+00:00,['c043d225a8db12cc0d059ce8f3605a425121e815'],1,15,16,528816,1,,,,1971
aa76aa135905deb0b8f17d211b8bbeb383321bb2,0,samindaw,2012-02-02 21:38:07+00:00,['e499670c2ddec329c3b0b7ed6943792dd22af4a3'],86,242,328,529144,2,0.408,0.84,1,1971
942d2314f5b2eedb76e43898873d1a6f87192edc,0,Lahiru Gunathilake,2012-02-02 21:59:24+00:00,['aa76aa135905deb0b8f17d211b8bbeb383321bb2'],1,1419,1420,530564,13,,,,1983
74edb5b15040d2c5f410080ed18c9d860b824663,0,Heshan Theekshana Suriyaarachchi,2012-02-02 22:20:14+00:00,['942d2314f5b2eedb76e43898873d1a6f87192edc'],1,1,2,530566,1,,,,1983
cc33e5dfdb65a62e12d1e299e64d87c5fd86091f,0,Heshan Theekshana Suriyaarachchi,2012-02-02 22:43:06+00:00,['74edb5b15040d2c5f410080ed18c9d860b824663'],0,12384,12384,542950,36,,,,2019
7c95166003e9d5b4e571531a398d93cf74f7ac9f,0,samindaw,2012-02-02 23:01:30+00:00,['cc33e5dfdb65a62e12d1e299e64d87c5fd86091f'],43,96,139,543089,3,0,0,0,2019
a71c991a8bf74f54417557dba36fd9475ec8720c,0,Lahiru Gunathilake,2012-02-03 04:21:05+00:00,['7c95166003e9d5b4e571531a398d93cf74f7ac9f'],4,4,8,543097,4,,,,2019
6ce5ec360e7ee82c303b4e6db66c412958c5d501,0,samindaw,2012-02-03 21:23:47+00:00,['a71c991a8bf74f54417557dba36fd9475ec8720c'],6,73,79,543176,2,0.534482759,0.862068966,1,2019
f18de6ff65e37b2ba91ee0a7f2c1beaacd14a376,0,Heshan Theekshana Suriyaarachchi,2012-02-03 21:26:21+00:00,['6ce5ec360e7ee82c303b4e6db66c412958c5d501'],73,941,1014,544190,31,,,,2019
8fcb1df08b77a30853e866f23f9a3af0a6d67518,0,samindaw,2012-02-03 21:38:48+00:00,['f18de6ff65e37b2ba91ee0a7f2c1beaacd14a376'],1,1,2,544192,1,,,,2019
032c8eb6248a25218577c5a63a87277dfa7547c4,0,samindaw,2012-02-03 21:43:39+00:00,['8fcb1df08b77a30853e866f23f9a3af0a6d67518'],4,4,8,544200,1,,,,2019
1cb1cacc7f5652978ff67e450a38dd97aa39ec01,0,samindaw,2012-02-03 21:46:09+00:00,['032c8eb6248a25218577c5a63a87277dfa7547c4'],0,5,5,544205,1,1,1,1,2019
e9a37c3a90af479b1e94bb388f630ca498dd8714,0,Heshan Theekshana Suriyaarachchi,2012-02-03 21:56:44+00:00,['1cb1cacc7f5652978ff67e450a38dd97aa39ec01'],12,10,22,544227,12,,,,2019
a04634f8c139690ee4bb43d5609f72dd88397197,0,samindaw,2012-02-03 21:57:15+00:00,['e9a37c3a90af479b1e94bb388f630ca498dd8714'],3,7,10,544237,1,0,1,1,2019
cfdac00bd9b3a1fedc81a609340df267db7eb36f,0,samindaw,2012-02-03 22:01:11+00:00,['a04634f8c139690ee4bb43d5609f72dd88397197'],5,9,14,544251,1,0,1,1,2019
ff756179ae464c60a133365144b1f797314f3d7a,0,Heshan Theekshana Suriyaarachchi,2012-02-03 22:45:41+00:00,['cfdac00bd9b3a1fedc81a609340df267db7eb36f'],1,181,182,544433,2,,,,2019
a3955d079f7f204c905a17a5872c65edf8eeb204,0,Lahiru Gunathilake,2012-02-03 22:49:01+00:00,['ff756179ae464c60a133365144b1f797314f3d7a'],0,22,22,544455,25,,,,2019
8aed140c0095f83551c711a44dbe02d415ce19e0,0,Heshan Theekshana Suriyaarachchi,2012-02-04 00:41:13+00:00,['a3955d079f7f204c905a17a5872c65edf8eeb204'],529,530,1059,545514,1,,,,2019
db7f3d35d8eec485ac5eeb0db331de3978af309a,0,Lahiru Gunathilake,2012-02-06 18:54:10+00:00,['8aed140c0095f83551c711a44dbe02d415ce19e0'],6,6,12,545526,3,,,,2019
5a926df15ba548c67ec9f4fcf02fc2508fa0db16,0,Lahiru Gunathilake,2012-02-06 18:55:30+00:00,['db7f3d35d8eec485ac5eeb0db331de3978af309a'],3,5,8,545534,2,,,,2019
9bc2647fe311d02ee91b45fe1ef21df008fe2175,0,Lahiru Gunathilake,2012-02-06 23:32:46+00:00,['5a926df15ba548c67ec9f4fcf02fc2508fa0db16'],0,1,1,545535,1,,,,2019
a5c7c5aa49a969c3615fcfcc6a24a3825475656a,0,Suresh Marru,2012-02-07 01:41:34+00:00,['9bc2647fe311d02ee91b45fe1ef21df008fe2175'],22,22,44,545579,22,,,,2019
3537419f8cbb88c846e023ee31c824e10a0fdc0d,0,Suresh Marru,2012-02-07 01:58:57+00:00,['a5c7c5aa49a969c3615fcfcc6a24a3825475656a'],1055,0,1055,546634,6,0.4,0,0,2019
e5ec02b1477d2b6bb24508a098ff16f658acfbc9,0,Lahiru Gunathilake,2012-02-08 17:43:59+00:00,['3537419f8cbb88c846e023ee31c824e10a0fdc0d'],9,32,41,546675,5,1,1,1,2019
0a566030fbfebf875a277b7e4fd18f64b3ae22ff,0,Lahiru Gunathilake,2012-02-08 18:08:51+00:00,['e5ec02b1477d2b6bb24508a098ff16f658acfbc9'],12,158,170,546845,5,0,0.264705882,0.068627451,2019
7fa031208a80c5903136309ffb6d1e1967f23f85,0,Lahiru Gunathilake,2012-02-08 18:14:02+00:00,['0a566030fbfebf875a277b7e4fd18f64b3ae22ff'],6,18,24,546869,3,0.625,0.625,1,2019
a42f340bb62dea101c12c7ffdb3ff218e881ddaf,0,Lahiru Gunathilake,2012-02-08 20:18:45+00:00,['7fa031208a80c5903136309ffb6d1e1967f23f85'],160,33,193,547062,5,1,0.790697674,1,2019
c922a0eae9283427a01febbbfc674a7c38728f8b,0,Lahiru Gunathilake,2012-02-08 20:22:37+00:00,['a42f340bb62dea101c12c7ffdb3ff218e881ddaf'],0,3,3,547065,1,,,,2019
22907afcc0a7893d6098ed4eb020515555f226e0,0,Lahiru Gunathilake,2012-02-08 20:42:23+00:00,['c922a0eae9283427a01febbbfc674a7c38728f8b'],14,0,14,547079,1,,,,2019
a253d2bdb7fe2df9ab0986f2007a2fcace1a619a,0,Lahiru Gunathilake,2012-02-08 21:52:40+00:00,['22907afcc0a7893d6098ed4eb020515555f226e0'],1,9,10,547089,1,1,1,1,2019
236c15806cf7010e2da00c1d8617e04c8cd887dc,0,Lahiru Gunathilake,2012-02-08 21:53:05+00:00,['a253d2bdb7fe2df9ab0986f2007a2fcace1a619a'],12,17,29,547118,1,0.5,0,1,2019
efaef673420ac55985792c2c5b0bc2bb30ef4122,0,samindaw,2012-02-09 14:44:30+00:00,['236c15806cf7010e2da00c1d8617e04c8cd887dc'],12,16,28,547146,1,0,0,1,2019
bebf4e6f2691b14d5b2c354073504c9010ab1916,0,samindaw,2012-02-09 14:50:14+00:00,['efaef673420ac55985792c2c5b0bc2bb30ef4122'],9,1,10,547156,1,0.666666667,1,0,2019
f06d7454801bb57169319d03d268618bce8b2c29,0,samindaw,2012-02-09 15:50:25+00:00,['bebf4e6f2691b14d5b2c354073504c9010ab1916'],3,15,18,547174,2,1,0.875,1,2019
2f937401b2053c5211cd7bf96b3a5fd9caad19e4,0,Heshan Theekshana Suriyaarachchi,2012-02-09 16:17:31+00:00,['f06d7454801bb57169319d03d268618bce8b2c29'],0,397,397,547571,9,,,,2020
266239ca8b8929eca3d52dfcbcc00220078d641a,0,Heshan Theekshana Suriyaarachchi,2012-02-09 16:35:20+00:00,['2f937401b2053c5211cd7bf96b3a5fd9caad19e4'],1,23,24,547595,1,,,,2020
d5e15294ca02bce6d778f86fbf4a8f58b56a7c2c,0,Heshan Theekshana Suriyaarachchi,2012-02-09 18:39:16+00:00,['266239ca8b8929eca3d52dfcbcc00220078d641a'],0,96,96,547691,2,,,,2020
3b55b3897dc588a685e83b54d5354f7afd119576,0,Heshan Theekshana Suriyaarachchi,2012-02-09 19:19:40+00:00,['d5e15294ca02bce6d778f86fbf4a8f58b56a7c2c'],0,79,79,547770,1,,,,2020
c3f64c0e8090e97d863976941ec7af35de5ddbc5,0,Heshan Theekshana Suriyaarachchi,2012-02-09 19:26:50+00:00,['3b55b3897dc588a685e83b54d5354f7afd119576'],0,188,188,547958,1,,,,2020
8066ab712eaf0e4a022cbd80bdbda4b5c1f11a58,0,Heshan Theekshana Suriyaarachchi,2012-02-09 19:36:31+00:00,['c3f64c0e8090e97d863976941ec7af35de5ddbc5'],0,105,105,548063,1,,,,2020
931d9b45036121c5f39773493a9b29d6e47714d2,0,Heshan Theekshana Suriyaarachchi,2012-02-09 19:54:07+00:00,['8066ab712eaf0e4a022cbd80bdbda4b5c1f11a58'],0,39,39,548102,1,,,,2020
3db83a3d6b22f60f56f25c0fffffac5c686d77a8,0,Heshan Theekshana Suriyaarachchi,2012-02-09 22:13:37+00:00,['931d9b45036121c5f39773493a9b29d6e47714d2'],24,24,48,548150,1,1,0,0,2020
354368321b6b74ebd38b3da060460acc15a02725,0,Lahiru Gunathilake,2012-02-10 03:05:47+00:00,['3db83a3d6b22f60f56f25c0fffffac5c686d77a8'],1,11,12,548162,1,,,,2020
6bcb8d00b1f92c9a6ce42bd04b06f0aba5146d5e,0,samindaw,2012-02-10 15:17:55+00:00,['354368321b6b74ebd38b3da060460acc15a02725'],10,20,30,548192,2,0,0,0,2020
61ad70590021e4b92a8db8eecf6ae4eae6a65b80,0,samindaw,2012-02-10 16:09:55+00:00,['6bcb8d00b1f92c9a6ce42bd04b06f0aba5146d5e'],17,8,25,548217,6,0.111111111,0.111111111,0,2020
ca39f367a15586c8f5aac68d9020f5d71518e335,0,Lahiru Gunathilake,2012-02-10 18:49:49+00:00,['61ad70590021e4b92a8db8eecf6ae4eae6a65b80'],7,14,21,548238,2,0.6,0.6,0,2020
bd94d5033440a1de80a085d5276d8eed64cd77dd,0,Lahiru Gunathilake,2012-02-10 18:55:26+00:00,['ca39f367a15586c8f5aac68d9020f5d71518e335'],0,3,3,548241,1,1,1,1,2020
c7eeb714d6cc104d7f5363dba24d3639498be538,0,Lahiru Gunathilake,2012-02-13 14:33:33+00:00,['bd94d5033440a1de80a085d5276d8eed64cd77dd'],79,20,99,548340,24,,,,2020
660245af72128dafc5dc42d817cb456361b609f9,0,Lahiru Gunathilake,2012-02-13 14:47:16+00:00,['c7eeb714d6cc104d7f5363dba24d3639498be538'],0,6,6,548346,1,0,0,1,2020
b36acebc43b9dc5c06281ff8904e5a9a4bffe6b3,0,samindaw,2012-02-13 15:47:08+00:00,['660245af72128dafc5dc42d817cb456361b609f9'],9,15,24,548370,2,0.428571429,0.428571429,1,2020
a9333bc3b3b4112eb83da3cc2bec6504dff126a0,0,samindaw,2012-02-13 16:32:08+00:00,['b36acebc43b9dc5c06281ff8904e5a9a4bffe6b3'],3,3,6,548376,1,1,0.666666667,0.333333333,2020
5c78eb1bf37679056c4131f824ec86fbd8a28607,0,Lahiru Gunathilake,2012-02-13 16:53:55+00:00,['a9333bc3b3b4112eb83da3cc2bec6504dff126a0'],21,58,79,548455,9,0,0.870967742,1,2020
e6a49c56e01920b73eb0863ece9b13175d071978,0,samindaw,2012-02-14 15:14:01+00:00,['5c78eb1bf37679056c4131f824ec86fbd8a28607'],4,21,25,548480,3,0.363636364,0.818181818,1,2020
a23cbe114384b8294cea83fce92dc649f86a48eb,0,Heshan Theekshana Suriyaarachchi,2012-02-14 16:50:35+00:00,['e6a49c56e01920b73eb0863ece9b13175d071978'],2,3,5,548485,1,0,1,1,2020
bf41c0bf90f7edf22805fb736b5f4ec141402989,0,Lahiru Gunathilake,2012-02-16 12:06:28+00:00,['a23cbe114384b8294cea83fce92dc649f86a48eb'],852,613,1465,549950,19,,,,2020
e2f83e8c466558def7a833b7529030426877a2ca,0,Lahiru Gunathilake,2012-02-16 16:43:37+00:00,['bf41c0bf90f7edf22805fb736b5f4ec141402989'],0,7,7,549957,2,0.142857143,1,1,2020
859a7240773adc262fe5fc0978269f4f18f46845,0,Lahiru Gunathilake,2012-02-16 19:07:57+00:00,['e2f83e8c466558def7a833b7529030426877a2ca'],75,339,414,550371,4,0,1,1,2020
84bf53585475bfd55401a8e9881da7dfa4e414d0,0,Lahiru Gunathilake,2012-02-17 18:36:16+00:00,['859a7240773adc262fe5fc0978269f4f18f46845'],1,13,14,550385,2,,,,2020
36ca830b76d1e6b6cdda9acf9abae6735338c03a,0,Lahiru Gunathilake,2012-02-20 22:15:27+00:00,['84bf53585475bfd55401a8e9881da7dfa4e414d0'],14,51,65,550450,1,0.75,0.916666667,1,2020
44c47e9827af367e6a90df486c924d149a3ba722,0,Heshan Theekshana Suriyaarachchi,2012-02-23 16:31:06+00:00,['36ca830b76d1e6b6cdda9acf9abae6735338c03a'],0,333,333,550783,6,0.060606061,0.434343434,1,2026
e43ad3bf15b1529636d4cdc8b9355c11c484011e,0,Heshan Theekshana Suriyaarachchi,2012-02-23 19:54:20+00:00,['44c47e9827af367e6a90df486c924d149a3ba722'],73,122,195,550978,2,0.454545455,0.212121212,1,2027
89f36bf8198161ddd3cab72152aa7cc3d5818fbc,0,Heshan Theekshana Suriyaarachchi,2012-02-23 19:58:31+00:00,['e43ad3bf15b1529636d4cdc8b9355c11c484011e'],20,24,44,551022,1,0,1,1,2027
8776ab30fbc98536738113d96fac53af53637c91,0,Heshan Theekshana Suriyaarachchi,2012-02-23 20:59:51+00:00,['89f36bf8198161ddd3cab72152aa7cc3d5818fbc'],2,20,22,551044,2,,,,2027
191d8c299c23445adba852cf30e254c1fb418355,0,Heshan Theekshana Suriyaarachchi,2012-02-24 16:42:59+00:00,['8776ab30fbc98536738113d96fac53af53637c91'],33,75,108,551152,1,0.411764706,1,0.235294118,2027
8604bd8ce2a3c62bdd543d35647b8e91d0e755f8,0,Heshan Theekshana Suriyaarachchi,2012-02-24 16:47:13+00:00,['191d8c299c23445adba852cf30e254c1fb418355'],7,7,14,551166,1,,,,2027
967c8a6c670e225f5a1d42289fd16fca5db17c83,0,Heshan Theekshana Suriyaarachchi,2012-02-24 17:34:04+00:00,['8604bd8ce2a3c62bdd543d35647b8e91d0e755f8'],0,1,1,551167,1,,,,2027
9042b9efc93f2580ce1d015feb62d97690f6a5c0,0,Heshan Theekshana Suriyaarachchi,2012-02-24 19:36:23+00:00,['967c8a6c670e225f5a1d42289fd16fca5db17c83'],8,18,26,551193,1,0.166666667,0.5,0.833333333,2027
c1f750b632cbbe30c602955bf9b6c7fd2843165a,0,Heshan Theekshana Suriyaarachchi,2012-02-24 20:49:39+00:00,['9042b9efc93f2580ce1d015feb62d97690f6a5c0'],0,89,89,551282,1,,,,2028
d7049b5e15885217220afead89276382b2648f92,0,Lahiru Gunathilake,2012-02-24 21:51:16+00:00,['c1f750b632cbbe30c602955bf9b6c7fd2843165a'],0,487,487,551769,4,0.809090909,1,0.827272727,2031
f9131c6bdb4c9ca6d2447da40c067b1ae1a358f0,0,Lahiru Gunathilake,2012-02-24 21:51:38+00:00,['d7049b5e15885217220afead89276382b2648f92'],1,18,19,551788,3,,,,2032
ff707949e19bd2ba11fd4f67fe4aac5da23395d6,0,Heshan Theekshana Suriyaarachchi,2012-02-24 21:58:43+00:00,['f9131c6bdb4c9ca6d2447da40c067b1ae1a358f0'],58,20,78,551866,4,,,,2032
45f3a56912d98686b9f8760e36b3d69094d68363,0,Heshan Theekshana Suriyaarachchi,2012-02-24 22:01:40+00:00,['ff707949e19bd2ba11fd4f67fe4aac5da23395d6'],10,10,20,551886,2,,,,2032
06436e05c898c314c35e29a57f0dd944c4d7a503,0,Heshan Theekshana Suriyaarachchi,2012-02-24 23:17:53+00:00,['45f3a56912d98686b9f8760e36b3d69094d68363'],1,2,3,551889,2,,,,2032
225e0826ed3375dcfe7dfc90cb99c8d1746652b9,0,Lahiru Gunathilake,2012-02-24 23:21:52+00:00,['06436e05c898c314c35e29a57f0dd944c4d7a503'],87,0,87,551976,1,0.880952381,0.880952381,0,2032
02fa85c8378da81c4f8e5123f15bc8b454f2c7b4,0,Lahiru Gunathilake,2012-02-26 00:40:04+00:00,['225e0826ed3375dcfe7dfc90cb99c8d1746652b9'],30,1381,1411,553387,2,,,,2033
015b09186f3313bd467ebc237c68314400ac187c,0,Heshan Theekshana Suriyaarachchi,2012-02-28 15:28:48+00:00,['02fa85c8378da81c4f8e5123f15bc8b454f2c7b4'],3,10,13,553400,1,0,1,1,2033
6bf38779312bf935599f5d2098440066ae6a1065,0,Heshan Theekshana Suriyaarachchi,2012-02-28 15:37:32+00:00,['015b09186f3313bd467ebc237c68314400ac187c'],3,22,25,553425,1,0,1,1,2033
51feb87464507952024b63cebc4431003b2d4b0c,0,Heshan Theekshana Suriyaarachchi,2012-02-28 15:40:27+00:00,['6bf38779312bf935599f5d2098440066ae6a1065'],7,10,17,553442,2,,,,2034
a27d8086195c686866ae5f3eb50aa142f40b18be,0,Heshan Theekshana Suriyaarachchi,2012-03-01 16:21:23+00:00,['51feb87464507952024b63cebc4431003b2d4b0c'],13,26,39,553481,1,0,1,1,2034
6ea1fb3146c4f7fe946c8eb472788741c2bc3226,0,Heshan Theekshana Suriyaarachchi,2012-03-01 16:24:47+00:00,['a27d8086195c686866ae5f3eb50aa142f40b18be'],6,10,16,553497,1,0,1,1,2034
6cb1119d996b1b1e24a5f9d41c6aca4f4cd1a7ca,0,Heshan Theekshana Suriyaarachchi,2012-03-01 16:44:55+00:00,['6ea1fb3146c4f7fe946c8eb472788741c2bc3226'],1,7,8,553505,1,0,0,0,2034
5750daf9acc6fbaaf9e1ad0c7f64622e63c4b3a8,0,Heshan Theekshana Suriyaarachchi,2012-03-01 17:36:15+00:00,['6cb1119d996b1b1e24a5f9d41c6aca4f4cd1a7ca'],4,14,18,553523,1,1,1,1,2034
9e26d94f9501b21a65e49d3e64e312e3726c6545,0,Heshan Theekshana Suriyaarachchi,2012-03-01 17:48:23+00:00,['5750daf9acc6fbaaf9e1ad0c7f64622e63c4b3a8'],7,4,11,553534,1,,,,2034
b4516e4238952a8759f36ee60d0f6147c30f6dac,0,Heshan Theekshana Suriyaarachchi,2012-03-01 18:00:40+00:00,['9e26d94f9501b21a65e49d3e64e312e3726c6545'],3,1,4,553538,1,,,,2034
38c4463554d86c7332ff1562645699281da9ed06,0,Heshan Theekshana Suriyaarachchi,2012-03-02 14:26:12+00:00,['b4516e4238952a8759f36ee60d0f6147c30f6dac'],7,15,22,553560,1,0,1,1,2034
dc494749e33da24b8260e9e3b7ab36382c401146,0,Heshan Theekshana Suriyaarachchi,2012-03-02 15:38:32+00:00,['38c4463554d86c7332ff1562645699281da9ed06'],1,1,2,553562,1,,,,2034
eec0b721c315c645af0cd075abffca3a9b686eb5,0,Heshan Theekshana Suriyaarachchi,2012-03-02 15:41:54+00:00,['dc494749e33da24b8260e9e3b7ab36382c401146'],5,5,10,553572,1,0,0,0,2034
0f139a7852c6cae883a6797554301ff0241e694a,0,Heshan Theekshana Suriyaarachchi,2012-03-02 15:51:45+00:00,['eec0b721c315c645af0cd075abffca3a9b686eb5'],5,6,11,553583,1,,,,2034
c5939b105ee0c046da45d6ec41035819f0e2bff9,0,Heshan Theekshana Suriyaarachchi,2012-03-02 15:53:41+00:00,['0f139a7852c6cae883a6797554301ff0241e694a'],6,6,12,553595,1,,,,2034
8a02228552cbb1411ec7093ad18c9ffe552e8c24,0,Heshan Theekshana Suriyaarachchi,2012-03-02 16:20:15+00:00,['c5939b105ee0c046da45d6ec41035819f0e2bff9'],8,16,24,553619,1,1,1,1,2034
9831f53dfc16bc16e94ec0c0e8a80ff7bb8692d4,0,Heshan Theekshana Suriyaarachchi,2012-03-02 16:34:16+00:00,['8a02228552cbb1411ec7093ad18c9ffe552e8c24'],3,7,10,553629,1,0,1,1,2034
b34975b93fb617baf58b5c11783c72579e5d3697,0,Heshan Theekshana Suriyaarachchi,2012-03-02 16:41:42+00:00,['9831f53dfc16bc16e94ec0c0e8a80ff7bb8692d4'],3,7,10,553639,1,0,1,1,2034
910db7e548c68570539f9920956ac87632b19f66,0,Heshan Theekshana Suriyaarachchi,2012-03-02 16:42:39+00:00,['b34975b93fb617baf58b5c11783c72579e5d3697'],14,0,14,553653,1,0,0,0,2034
2f37c0a77403cd7e73f0cf619d6af5888f618406,0,Heshan Theekshana Suriyaarachchi,2012-03-02 17:16:57+00:00,['910db7e548c68570539f9920956ac87632b19f66'],9,40,49,553702,2,,,,2034
870b57b47c51760c280dfea67af16525ada43ac7,0,Heshan Theekshana Suriyaarachchi,2012-03-02 17:18:18+00:00,['2f37c0a77403cd7e73f0cf619d6af5888f618406'],0,63,63,553765,3,,,,2034
4175c6af300d3efe0c6a7af50ca35c12e5b8d48e,0,Heshan Theekshana Suriyaarachchi,2012-03-05 15:49:00+00:00,['870b57b47c51760c280dfea67af16525ada43ac7'],7,4,11,553776,1,1,1,0,2034
eb5d6a1084beae0f036f4a36d7a87a2ac6f7f147,0,Heshan Theekshana Suriyaarachchi,2012-03-05 18:56:06+00:00,['4175c6af300d3efe0c6a7af50ca35c12e5b8d48e'],0,20,20,553796,1,1,1,1,2034
9dc1abb49a9460dafa080a15d0bb8e7637e4f03e,0,Heshan Theekshana Suriyaarachchi,2012-03-05 18:59:30+00:00,['eb5d6a1084beae0f036f4a36d7a87a2ac6f7f147'],10,29,39,553835,2,0,0,0.3,2034
55ee13c3895d562d23d31d1145bdf657f3b2a0d2,0,Heshan Theekshana Suriyaarachchi,2012-03-05 19:38:30+00:00,['9dc1abb49a9460dafa080a15d0bb8e7637e4f03e'],0,50,50,553885,1,0,1,1,2034
0aa17d452f51c301d307c0a6d35bac6902481277,0,Heshan Theekshana Suriyaarachchi,2012-03-05 19:40:32+00:00,['55ee13c3895d562d23d31d1145bdf657f3b2a0d2'],9,27,36,553921,1,0,0,1,2034
300f3ea473c3e0e8837200fa7ef2f43c517107c7,0,Heshan Theekshana Suriyaarachchi,2012-03-05 20:18:52+00:00,['0aa17d452f51c301d307c0a6d35bac6902481277'],12,48,60,553981,1,0.176470588,1,1,2034
b361cd176ab2cc7074873b0ef6078701cde2e990,0,Heshan Theekshana Suriyaarachchi,2012-03-05 20:28:42+00:00,['300f3ea473c3e0e8837200fa7ef2f43c517107c7'],1,7,8,553989,1,0,1,1,2034
9aa14fa766129ce64c805085aab04388cb0d6b2b,0,Heshan Theekshana Suriyaarachchi,2012-03-05 20:40:18+00:00,['b361cd176ab2cc7074873b0ef6078701cde2e990'],8,41,49,554038,1,0,1,1,2034
b6d597602af05a4901ac896385c7b9f421a4a06d,0,Heshan Theekshana Suriyaarachchi,2012-03-05 20:41:39+00:00,['9aa14fa766129ce64c805085aab04388cb0d6b2b'],1,6,7,554045,1,0,1,1,2034
c687e6af0115832b6deae88c20656d979517c7bd,0,Heshan Theekshana Suriyaarachchi,2012-03-06 14:53:09+00:00,['b6d597602af05a4901ac896385c7b9f421a4a06d'],2,2,4,554049,1,,,,2034
85491e983cd0b66563ca2f440ba04502ffbc7088,0,Heshan Theekshana Suriyaarachchi,2012-03-06 15:36:27+00:00,['c687e6af0115832b6deae88c20656d979517c7bd'],0,8,8,554057,1,0,1,1,2034
12b7b90fb3b30dd163c83d7e33596d775fefce96,0,Heshan Theekshana Suriyaarachchi,2012-03-08 16:46:34+00:00,['85491e983cd0b66563ca2f440ba04502ffbc7088'],28,49,77,554134,1,0.380952381,1,1,2034
5668c97ee11001a0b8ae1a2defe9cbcc23cd734d,0,Heshan Theekshana Suriyaarachchi,2012-03-08 21:57:19+00:00,['12b7b90fb3b30dd163c83d7e33596d775fefce96'],0,24,24,554158,1,,,,2034
301c36fddc1a7b711582901cfc09c9176c1ab4c5,0,Heshan Theekshana Suriyaarachchi,2012-03-09 00:12:11+00:00,['5668c97ee11001a0b8ae1a2defe9cbcc23cd734d'],68,148,216,554374,3,0.010989011,0.263736264,0.802197802,2034
a1181576992b374544a2b15bcc0efcaf006bf888,0,Heshan Theekshana Suriyaarachchi,2012-03-09 00:13:27+00:00,['301c36fddc1a7b711582901cfc09c9176c1ab4c5'],0,12,12,554386,1,1,1,1,2035
fbdb5bc2b6ea450cb5e6a77e55f0a6bf9d2cd4e9,0,Heshan Theekshana Suriyaarachchi,2012-03-09 00:52:22+00:00,['a1181576992b374544a2b15bcc0efcaf006bf888'],87,144,231,554617,2,0,0,0.788461538,2035
442a144bf442ba60456484417456ce33fad7ff5c,0,Heshan Theekshana Suriyaarachchi,2012-03-09 00:53:15+00:00,['fbdb5bc2b6ea450cb5e6a77e55f0a6bf9d2cd4e9'],0,21,21,554638,1,,,,2035
9f435f79672d734b30f5e49fdbb11c7ecd26fca5,0,Heshan Theekshana Suriyaarachchi,2012-03-09 00:57:19+00:00,['442a144bf442ba60456484417456ce33fad7ff5c'],53,21,74,554712,2,1,0,0,2035
37e8d9eac5d10cc48a32eef229f9566c6837a722,0,Heshan Theekshana Suriyaarachchi,2012-03-09 01:08:28+00:00,['9f435f79672d734b30f5e49fdbb11c7ecd26fca5'],0,23,23,554735,1,,,,2036
e788bf7caf8c23687dc4f1db8baa3fcb668bf956,0,Heshan Theekshana Suriyaarachchi,2012-03-09 01:40:52+00:00,['37e8d9eac5d10cc48a32eef229f9566c6837a722'],0,1,1,554736,1,,,,2036
82c8623d0301a6115de589a89b81039fae0274f0,0,Heshan Theekshana Suriyaarachchi,2012-03-09 01:44:27+00:00,['e788bf7caf8c23687dc4f1db8baa3fcb668bf956'],3,19,22,554758,1,,,,2036
d9e31d9405bb98ec64db548fa4f672908495b9f5,0,Heshan Theekshana Suriyaarachchi,2012-03-09 15:23:35+00:00,['82c8623d0301a6115de589a89b81039fae0274f0'],4,12,16,554774,1,0,0,1,2036
fe55038461700000a36307fc443ca096807af21b,0,Heshan Theekshana Suriyaarachchi,2012-03-09 15:32:59+00:00,['d9e31d9405bb98ec64db548fa4f672908495b9f5'],5,1,6,554780,1,,,,2036
c85867062a58359b3322f15318e1479910ed9e4a,0,Heshan Theekshana Suriyaarachchi,2012-03-09 17:38:22+00:00,['fe55038461700000a36307fc443ca096807af21b'],5,12,17,554797,3,,,,2036
d214d803d906b373ab2c3d5b54353fc1a49e6a0d,0,Heshan Theekshana Suriyaarachchi,2012-03-09 18:16:32+00:00,['c85867062a58359b3322f15318e1479910ed9e4a'],101,86,187,554984,3,1,1,0.333333333,2036
c66eb48a063c2e721716147445606d5dc1a14bb8,0,Heshan Theekshana Suriyaarachchi,2012-03-09 18:24:01+00:00,['d214d803d906b373ab2c3d5b54353fc1a49e6a0d'],26,0,26,555010,1,,,,2036
ea3cc6df1f6477dce1e6f847bab427f85d0f5ed8,0,Heshan Theekshana Suriyaarachchi,2012-03-09 18:24:32+00:00,['c66eb48a063c2e721716147445606d5dc1a14bb8'],20,24,44,555054,1,1,1,1,2036
53721fafd6fa62e512da6905efd55161d395687f,0,Heshan Theekshana Suriyaarachchi,2012-03-15 00:45:50+00:00,['ea3cc6df1f6477dce1e6f847bab427f85d0f5ed8'],0,5,5,555059,1,,,,2036
041af496bae42fcbf8d653ab7335a0ecf29ae8ba,0,Heshan Theekshana Suriyaarachchi,2012-03-15 14:47:52+00:00,['53721fafd6fa62e512da6905efd55161d395687f'],0,31,31,555090,1,,,,2036
c1847b688b7b9179527cc76b5df5f858c08f2d1c,0,Heshan Theekshana Suriyaarachchi,2012-03-15 14:59:16+00:00,['041af496bae42fcbf8d653ab7335a0ecf29ae8ba'],0,29,29,555119,1,,,,2036
d06442c28a52d9ea2d814b760c2d8eeb94c4edcf,0,Heshan Theekshana Suriyaarachchi,2012-03-15 15:18:52+00:00,['c1847b688b7b9179527cc76b5df5f858c08f2d1c'],1,15,16,555135,1,,,,2036
a84a1f3742fa038755cc7b1b1f74144a589ae82c,0,samindaw,2012-03-16 22:27:35+00:00,['d06442c28a52d9ea2d814b760c2d8eeb94c4edcf'],303,548,851,555986,2,0.265060241,0.590361446,0.915662651,2037
d5046762eb6f87c78acf4159dce3b6f7ba131cc2,0,samindaw,2012-03-16 22:32:16+00:00,['a84a1f3742fa038755cc7b1b1f74144a589ae82c'],17,34,51,556037,1,,,,2037
5ad25394856e546da3156dc371c0ed42bed28bd5,0,samindaw,2012-03-16 22:43:07+00:00,['d5046762eb6f87c78acf4159dce3b6f7ba131cc2'],28,5,33,556070,1,1,1,0.25,2037
b0a845bb5d63436afd86964f584cc4b93c780e46,0,samindaw,2012-03-19 12:47:44+00:00,['5ad25394856e546da3156dc371c0ed42bed28bd5'],3,9,12,556082,1,1,1,1,2037
0374820fc77ccc56cad4bf9373ed59641b98b056,0,samindaw,2012-03-19 21:39:22+00:00,['b0a845bb5d63436afd86964f584cc4b93c780e46'],2,15,17,556099,1,1,1,0,2037
ee88daff338a89afc70b0e16e628d07c15a37f97,0,Suresh Marru,2012-03-21 21:41:30+00:00,['0374820fc77ccc56cad4bf9373ed59641b98b056'],0,0,0,556099,0,,,,2037
13ad398dd7d84b5b92bc51b77f2d8f750671b533,0,Suresh Marru,2012-03-21 21:50:08+00:00,['ee88daff338a89afc70b0e16e628d07c15a37f97'],0,36,36,556135,1,,,,2038
214710030b7d9e5057e22378c0a8c2b3d1d21e2e,0,Heshan Theekshana Suriyaarachchi,2012-03-22 15:28:19+00:00,['13ad398dd7d84b5b92bc51b77f2d8f750671b533'],0,192,192,556327,1,0,1,1,2039
79296d4ab58fedcae1e512508e5acf6dd9bfbd2e,0,Heshan Theekshana Suriyaarachchi,2012-03-22 15:38:30+00:00,['214710030b7d9e5057e22378c0a8c2b3d1d21e2e'],0,16,16,556343,1,1,1,1,2040
2b33ec082da5bb12e35ab4326123ed68ecf855ef,0,Heshan Theekshana Suriyaarachchi,2012-03-22 15:43:32+00:00,['79296d4ab58fedcae1e512508e5acf6dd9bfbd2e'],0,16,16,556359,1,,,,2041
b139fc1f31f715ecc3976aa4adf80068cfc5ff6f,0,Heshan Theekshana Suriyaarachchi,2012-03-22 15:47:11+00:00,['2b33ec082da5bb12e35ab4326123ed68ecf855ef'],0,21,21,556380,1,,,,2041
a4183cb4e8f35b93e7e9f8ca4f22e827d668cd9d,0,Heshan Theekshana Suriyaarachchi,2012-03-23 15:13:14+00:00,['b139fc1f31f715ecc3976aa4adf80068cfc5ff6f'],1,1,2,556382,1,,,,2041
00332cfb49752dd23bfd1d8f23738120c584fa70,0,Heshan Theekshana Suriyaarachchi,2012-03-23 15:14:14+00:00,['a4183cb4e8f35b93e7e9f8ca4f22e827d668cd9d'],31,12,43,556425,1,0,1,1,2041
17ca2e7150b20660fa3f9600964c9bac2ef4c6d1,0,Heshan Theekshana Suriyaarachchi,2012-03-23 15:15:32+00:00,['00332cfb49752dd23bfd1d8f23738120c584fa70'],0,5,5,556430,1,,,,2041
b2578a13ed4b44c75632492e2c7bd3dfbef6569e,0,samindaw,2012-03-23 15:32:48+00:00,['17ca2e7150b20660fa3f9600964c9bac2ef4c6d1'],37,49,86,556516,1,0,1,1,2041
60c15c09d986b03d44984d79e93bca62da73ad9f,0,samindaw,2012-03-23 17:20:10+00:00,['b2578a13ed4b44c75632492e2c7bd3dfbef6569e'],73,104,177,556693,2,0,0.655172414,1,2041
ea343981039d54e6abfbb8e74b428660bb753a0d,0,samindaw,2012-03-23 17:22:56+00:00,['60c15c09d986b03d44984d79e93bca62da73ad9f'],0,466,466,557159,2,,,,2043
901d0c1e102d52c51d12a8768a9e590b3f82e756,0,samindaw,2012-03-23 17:28:12+00:00,['ea343981039d54e6abfbb8e74b428660bb753a0d'],0,9,9,557168,1,,,,2043
1ad4a07617d825c80bc7210575fb2e7d2d04f0a6,0,samindaw,2012-03-23 18:06:43+00:00,['901d0c1e102d52c51d12a8768a9e590b3f82e756'],3,7,10,557178,1,,,,2043
7a1cdf357eb5b1e9c3b8d259439b8b607b19969e,0,samindaw,2012-03-23 18:07:01+00:00,['1ad4a07617d825c80bc7210575fb2e7d2d04f0a6'],6,1,7,557185,1,,,,2043
5880d4f5fc3a48b57eb9acdc25bb51646ff227be,0,Heshan Theekshana Suriyaarachchi,2012-03-23 20:23:41+00:00,['7a1cdf357eb5b1e9c3b8d259439b8b607b19969e'],0,216,216,557401,6,0,0,1,2049
f2c28ee4ab2b404239f239e5aceae29c3a776642,0,Heshan Theekshana Suriyaarachchi,2012-03-23 20:33:46+00:00,['5880d4f5fc3a48b57eb9acdc25bb51646ff227be'],0,52,52,557453,1,,,,2050
c9e288e784c55ac565d8dfb80c84cbcce902e244,0,Heshan Theekshana Suriyaarachchi,2012-03-23 20:34:43+00:00,['f2c28ee4ab2b404239f239e5aceae29c3a776642'],16,0,16,557469,1,,,,2050
816553b17b00d743b1bfbd30a35ab3b73736047b,1,Chathura Herath,2012-03-26 18:32:32+00:00,['c9e288e784c55ac565d8dfb80c84cbcce902e244'],416,1540,1956,559425,9,0.367117117,0.594594595,0.975225225,2055
7ceb2818a1f69c2711f95242f8b2332a8ec395e0,0,samindaw,2012-03-27 14:14:27+00:00,['816553b17b00d743b1bfbd30a35ab3b73736047b'],51,92,143,559568,1,0.314285714,0.971428571,1,2055
c29b6a45d0a4d5eead1cf3a10680ee8caf69c4ce,0,samindaw,2012-03-27 20:04:33+00:00,['7ceb2818a1f69c2711f95242f8b2332a8ec395e0'],1,2,3,559571,1,0,1,1,2055
24b177f165ab74091ac616bf1ff81c82b765a96d,0,samindaw,2012-03-30 14:17:32+00:00,['c29b6a45d0a4d5eead1cf3a10680ee8caf69c4ce'],0,14,14,559585,1,1,1,1,2055
788bd3fec1ba53203d768d1e10fcc7211c1de2a0,0,samindaw,2012-03-30 16:52:25+00:00,['24b177f165ab74091ac616bf1ff81c82b765a96d'],2,29,31,559616,1,0,1,1,2055
f9fb8cc2e5dcaffa3816714e1aa501179c318ba4,0,Heshan Theekshana Suriyaarachchi,2012-03-30 21:58:10+00:00,['788bd3fec1ba53203d768d1e10fcc7211c1de2a0'],0,148,148,559764,1,0,1,1,2056
a41761c34d0fed830cf78d958cc690139bd0fb86,0,Heshan Theekshana Suriyaarachchi,2012-03-30 22:09:02+00:00,['f9fb8cc2e5dcaffa3816714e1aa501179c318ba4'],0,172,172,559936,1,0,1,1,2057
c00d11385b0b07d2cf30331f3f6fef4e05bb6314,0,Heshan Theekshana Suriyaarachchi,2012-03-30 22:10:11+00:00,['a41761c34d0fed830cf78d958cc690139bd0fb86'],173,0,173,560109,1,1,0,0,2057
4d25e52457c2aa2d692d3f85e7c2f4e271794f71,0,samindaw,2012-03-30 22:17:42+00:00,['c00d11385b0b07d2cf30331f3f6fef4e05bb6314'],0,0,0,560109,0,,,,2057
5520e97c0cf5335845344bd0ac49f54f6789d6f4,0,samindaw,2012-03-30 22:24:45+00:00,['4d25e52457c2aa2d692d3f85e7c2f4e271794f71'],0,89003,89003,649112,483,0.474221147,0.577137013,0.825247562,2540
e4025a33e61370a3f2b4aa4718dea2c4752e4211,1,Lahiru Gunathilake,2012-04-03 14:42:31+00:00,['5520e97c0cf5335845344bd0ac49f54f6789d6f4'],185,105,290,649402,2,0.625,0.275,0.25,2540
c9d6b1f011ce19ab2b7f135c2f0a4f54b0cfb473,0,Raminderjeet Singh,2012-04-05 21:39:45+00:00,['e4025a33e61370a3f2b4aa4718dea2c4752e4211'],0,1,1,649403,1,,,,2541
d09b5937d986f32b2ac6b8f8e28b7915848f13bc,0,Lahiru Gunathilake,2012-04-09 14:51:25+00:00,['c9d6b1f011ce19ab2b7f135c2f0a4f54b0cfb473'],1,271,272,649675,4,0.403669725,0.403669725,0.871559633,2544
a86e8bf6faff64886ca2d30d5851f6a7f6a2e3d1,0,Lahiru Gunathilake,2012-04-09 14:51:45+00:00,['d09b5937d986f32b2ac6b8f8e28b7915848f13bc'],263,146,409,650084,2,1,0.852459016,0.852459016,2544
e7a6f386f69e5b0b93b5e499f97ec847fce65bdb,0,Lahiru Gunathilake,2012-04-09 19:08:40+00:00,['a86e8bf6faff64886ca2d30d5851f6a7f6a2e3d1'],0,183,183,650267,1,0,0,1,2544
1f938bbe763a90e359173b9c46b13d74f23cd586,0,Lahiru Gunathilake,2012-04-09 19:09:10+00:00,['e7a6f386f69e5b0b93b5e499f97ec847fce65bdb'],96,2,98,650365,1,1,1,0,2544
9e3d7a3e4fefa8730284c2d4c63d91416c2ce8ea,0,Lahiru Gunathilake,2012-04-09 19:11:30+00:00,['1f938bbe763a90e359173b9c46b13d74f23cd586'],27,595,622,650987,5,0.193877551,0.193877551,0.884353741,2545
e910adcf0743b75fead79e08a1eb5f1ac571135d,0,Lahiru Gunathilake,2012-04-09 19:37:08+00:00,['9e3d7a3e4fefa8730284c2d4c63d91416c2ce8ea'],16,35,51,651038,4,0,0.875,0.9375,2545
abc722312d05cc2c3e5833cfc8f4c6f9cecf7e5c,0,Lahiru Gunathilake,2012-04-09 19:44:09+00:00,['e910adcf0743b75fead79e08a1eb5f1ac571135d'],1,0,1,651039,1,,,,2545
e87d6c29387d32dca48b5418feaa8cfa8ff56d7d,0,Lahiru Gunathilake,2012-04-09 20:28:02+00:00,['abc722312d05cc2c3e5833cfc8f4c6f9cecf7e5c'],3,8,11,651050,1,1,1,1,2545
a4bbac992f7b9d12f5b5f59b9bcc7cbb20bd01d4,0,Lahiru Gunathilake,2012-04-09 21:01:28+00:00,['e87d6c29387d32dca48b5418feaa8cfa8ff56d7d'],31,30,61,651111,1,1,1,0,2545
e3e749a37c4e6d5d27787a9f700cdcf67e6e9b80,0,Heshan Theekshana Suriyaarachchi,2012-04-10 14:50:25+00:00,['a4bbac992f7b9d12f5b5f59b9bcc7cbb20bd01d4'],1,1,2,651113,1,,,,2545
1f4e294bab499c59373c765636b4ab933f057daf,0,Heshan Theekshana Suriyaarachchi,2012-04-10 14:55:04+00:00,['e3e749a37c4e6d5d27787a9f700cdcf67e6e9b80'],8,12,20,651133,1,,,,2545
ffe98f28d870cc030af8a2629e74f8f9057071e0,0,Lahiru Gunathilake,2012-04-10 17:21:27+00:00,['1f4e294bab499c59373c765636b4ab933f057daf'],1,51,52,651185,3,,,,2546
11b3622200318580df2a497c2fa917a99d3dd7af,0,Lahiru Gunathilake,2012-04-10 17:48:11+00:00,['ffe98f28d870cc030af8a2629e74f8f9057071e0'],3,11,14,651199,2,0.4,0.4,1,2546
eb5572c46b1693418eb9557bb80f7a25279ac490,0,Lahiru Gunathilake,2012-04-10 17:49:39+00:00,['11b3622200318580df2a497c2fa917a99d3dd7af'],11,7,18,651217,2,0,0,0,2546
afc9e808bbbb7ed69495ce1faaf9fd6370a918de,0,Lahiru Gunathilake,2012-04-10 19:16:48+00:00,['eb5572c46b1693418eb9557bb80f7a25279ac490'],21,82,103,651320,9,0.555555556,0.888888889,1,2547
fab4836033ecc1571c0f0c2fc5c2634d2a25f14f,0,Lahiru Gunathilake,2012-04-10 20:44:56+00:00,['afc9e808bbbb7ed69495ce1faaf9fd6370a918de'],3,4,7,651327,3,1,1,1,2547
f6f38ea19b4f8f7145e85e2f2aa0aa901c07c24b,0,Lahiru Gunathilake,2012-04-10 20:54:13+00:00,['fab4836033ecc1571c0f0c2fc5c2634d2a25f14f'],6,5,11,651338,1,1,1,0,2547
9cf47a43310481c6396d3d4248affb44b1ddc297,0,Raminderjeet Singh,2012-04-11 15:13:53+00:00,['f6f38ea19b4f8f7145e85e2f2aa0aa901c07c24b'],1,0,1,651339,1,,,,2547
73eeb88624addb298c457e981b6ddf387bb2ec36,0,samindaw,2012-04-11 15:14:25+00:00,['9cf47a43310481c6396d3d4248affb44b1ddc297'],21,44,65,651404,1,0,0,1,2547
143e49b1ef9e77206c43d33c005f8f0474b155d9,0,Lahiru Gunathilake,2012-04-12 17:57:45+00:00,['73eeb88624addb298c457e981b6ddf387bb2ec36'],11,41,52,651456,4,0,0,1,2548
3368bb5fecf376bdbca8e92cc2696fcbc64f8793,0,Lahiru Gunathilake,2012-04-12 18:33:24+00:00,['143e49b1ef9e77206c43d33c005f8f0474b155d9'],10,25,35,651491,1,0,0,0,2548
f1ca0a920d580ec6ae208f1c95d1664bfe2f0a66,0,Lahiru Gunathilake,2012-04-13 20:39:19+00:00,['3368bb5fecf376bdbca8e92cc2696fcbc64f8793'],4,7,11,651502,1,0,1,1,2548
7b6f21db5b79bc79d1e9413363156ba3d876fba3,0,Raminderjeet Singh,2012-04-16 18:41:21+00:00,['f1ca0a920d580ec6ae208f1c95d1664bfe2f0a66'],3,4,7,651509,1,,,,2548
25e245d109c5a8890a289dd37287b64d0777592a,0,Raminderjeet Singh,2012-04-16 18:43:22+00:00,['7b6f21db5b79bc79d1e9413363156ba3d876fba3'],2,2,4,651513,1,,,,2548
d88b4fb5318aab5362a13a0bf2be382d07978bb8,0,Lahiru Gunathilake,2012-04-17 19:17:38+00:00,['25e245d109c5a8890a289dd37287b64d0777592a'],15,2,17,651530,1,1,0,1,2548
0bd463784a0c24176331046086029e70a892c2ae,0,Lahiru Gunathilake,2012-04-17 19:19:35+00:00,['d88b4fb5318aab5362a13a0bf2be382d07978bb8'],2,27,29,651559,1,0,1,1,2548
e3ccfffd3e43504bff5044918d6abc0d4e37d5c6,0,Lahiru Gunathilake,2012-04-17 20:25:05+00:00,['0bd463784a0c24176331046086029e70a892c2ae'],3,3,6,651565,1,,,,2548
702ce276afbeda22491382582653de0b35b58a87,0,Lahiru Gunathilake,2012-04-18 20:33:16+00:00,['e3ccfffd3e43504bff5044918d6abc0d4e37d5c6'],1,51,52,651617,3,0,0,1,2548
80f3f950313138721c88c6f6df7c0d55d793eff2,0,Heshan Theekshana Suriyaarachchi,2012-04-19 15:29:44+00:00,['702ce276afbeda22491382582653de0b35b58a87'],4,13,17,651634,1,0,0.555555556,1,2548
248d68a4824210ca3b0793425190004915714f38,0,Heshan Theekshana Suriyaarachchi,2012-04-20 14:38:58+00:00,['80f3f950313138721c88c6f6df7c0d55d793eff2'],0,1,1,651635,1,0,0,1,2548
3877d7444c2d4057e4324dd0c0e7f163af496a14,0,samindaw,2012-04-20 21:15:44+00:00,['248d68a4824210ca3b0793425190004915714f38'],7,30,37,651672,2,0.684210526,0.684210526,1,2548
47dab03b4707c334e11ee53cb5da874fac774969,0,Heshan Theekshana Suriyaarachchi,2012-04-20 22:23:47+00:00,['3877d7444c2d4057e4324dd0c0e7f163af496a14'],7,16,23,651695,1,,,,2548
893a94377e651126961e9052697be634b091fd19,0,Heshan Theekshana Suriyaarachchi,2012-04-20 22:30:47+00:00,['47dab03b4707c334e11ee53cb5da874fac774969'],0,16,16,651711,1,,,,2549
6a2a1db4df1f14da6072818d975719de88b0e556,0,Lahiru Gunathilake,2012-04-21 02:36:55+00:00,['893a94377e651126961e9052697be634b091fd19'],1,1,2,651713,1,,,,2549
5511d9e8f449f2f1f69d851e216b40327596ddaf,0,Lahiru Gunathilake,2012-04-21 02:51:09+00:00,['6a2a1db4df1f14da6072818d975719de88b0e556'],56,175,231,651944,15,0.185185185,0.518518519,0.666666667,2549
38788e250e5aed06c0a52ffbb3705c106f180e70,0,Raminderjeet Singh,2012-04-21 03:37:57+00:00,['5511d9e8f449f2f1f69d851e216b40327596ddaf'],4,1,5,651949,1,,,,2549
3423fffea55c236fd3c7e8409be692ba50e9a32a,0,Lahiru Gunathilake,2012-04-21 22:24:58+00:00,['38788e250e5aed06c0a52ffbb3705c106f180e70'],38,121,159,652108,1,0,0,1,2549
4f7938cdb6a1be3957f32dea4a3b0b11a4993302,0,Lahiru Gunathilake,2012-04-22 06:03:51+00:00,['3423fffea55c236fd3c7e8409be692ba50e9a32a'],3,3,6,652114,1,,,,2549
83518c10340e689e7cfb9cae4aa7b6df9586c7a0,0,Lahiru Gunathilake,2012-04-22 20:53:52+00:00,['4f7938cdb6a1be3957f32dea4a3b0b11a4993302'],6,41,47,652161,2,0,0,1,2549
0e770a417bede11c8b6c80de701063299e3d5877,0,Suresh Marru,2012-04-22 21:26:18+00:00,['83518c10340e689e7cfb9cae4aa7b6df9586c7a0'],0,0,0,652161,1,,,,2549
9a6aae8a82af7e5b09dc9d0528d7071b78f36c32,0,Suresh Marru,2012-04-22 22:50:05+00:00,['0e770a417bede11c8b6c80de701063299e3d5877'],25,69,94,652255,5,,,,2549
170bc45640d647caca781d49ff2716b708db1747,0,Patanachai Tangchaisin,2012-04-22 23:07:31+00:00,['9a6aae8a82af7e5b09dc9d0528d7071b78f36c32'],7,52,59,652314,2,0,1,1,2550
44b55c029889b0b8cc4f70f66bfe14aa71d7bf6c,0,Suresh Marru,2012-04-23 02:44:44+00:00,['170bc45640d647caca781d49ff2716b708db1747'],2,198,200,652514,4,0,1,1,2551
d02d40106419d17f7c7467a4823f0a7a45e2144a,0,Suresh Marru,2012-04-23 15:57:23+00:00,['44b55c029889b0b8cc4f70f66bfe14aa71d7bf6c'],6,4,10,652524,1,1,0,0,2551
d68429a64b0ec9ad7ff91181e8b300bdb56d1e8a,0,Lahiru Gunathilake,2012-04-24 13:52:28+00:00,['d02d40106419d17f7c7467a4823f0a7a45e2144a'],7,41,48,652572,3,0.04,0.04,1,2551
b3e65f674003a895106026464c30c1be38e69022,0,Lahiru Gunathilake,2012-04-24 13:58:17+00:00,['d68429a64b0ec9ad7ff91181e8b300bdb56d1e8a'],1,5,6,652578,1,0,0,0,2551
b8e763a02fa4f374bf6679570d8b33cfde9c7fb5,0,Suresh Marru,2012-04-24 14:01:45+00:00,['b3e65f674003a895106026464c30c1be38e69022'],4,30,34,652612,7,0,0.315789474,1,2552
2e86dde7e338f7e407cd5d2623ec00276581f216,0,Suresh Marru,2012-04-24 14:08:25+00:00,['b8e763a02fa4f374bf6679570d8b33cfde9c7fb5'],5,0,5,652617,1,,,,2552
4c20bfa45f37f113eb695ab4097070d4ff43e176,0,Lahiru Gunathilake,2012-04-24 15:32:10+00:00,['2e86dde7e338f7e407cd5d2623ec00276581f216'],2,46,48,652665,3,1,1,1,2552
c061ea2b0eb9ff9b5e16f661399deb86aa481650,0,Lahiru Gunathilake,2012-04-24 16:32:18+00:00,['4c20bfa45f37f113eb695ab4097070d4ff43e176'],14,14,28,652693,1,,,,2552
322f218b0ebe0a54e48fff07109564cdd84077ee,0,Suresh Marru,2012-04-24 16:40:07+00:00,['c061ea2b0eb9ff9b5e16f661399deb86aa481650'],5,0,5,652698,1,,,,2552
2c5b87ab49490bdc76ffe21dacc10eb0c72081fe,0,Suresh Marru,2012-04-24 16:40:10+00:00,['322f218b0ebe0a54e48fff07109564cdd84077ee'],5,0,5,652703,1,,,,2552
42db756a424cf88f1b2ea59bc45f85fc76417aeb,0,Lahiru Gunathilake,2012-04-24 18:01:29+00:00,['2c5b87ab49490bdc76ffe21dacc10eb0c72081fe'],1,2,3,652706,1,0,1,1,2552
5177ef1d1a378a53f467514cfabf029911fe8e75,0,Raminderjeet Singh,2012-04-24 18:28:22+00:00,['42db756a424cf88f1b2ea59bc45f85fc76417aeb'],11,12,23,652729,1,1,1,0.5,2552
e76ac427c20649aa2a63bb4419afda3ec76e21c2,0,Lahiru Gunathilake,2012-04-24 19:58:13+00:00,['5177ef1d1a378a53f467514cfabf029911fe8e75'],9,10,19,652748,1,,,,2552
f6f81aca854186567ad1baa33264d311ae8275fb,0,Lahiru Gunathilake,2012-04-25 00:10:45+00:00,['e76ac427c20649aa2a63bb4419afda3ec76e21c2'],22,21,43,652791,1,,,,2552
7b2970f3b70b3f94083cd56bcc7fbf0e58a40d70,0,Lahiru Gunathilake,2012-04-25 00:11:11+00:00,['f6f81aca854186567ad1baa33264d311ae8275fb'],3,25,28,652819,1,1,1,1,2552
8e9852b6e3b015e27b71da617476699a412bc39f,0,Lahiru Gunathilake,2012-04-25 21:53:09+00:00,['7b2970f3b70b3f94083cd56bcc7fbf0e58a40d70'],25,42,67,652886,2,0,0,0.619047619,2552
50ff854e5e15ed0c42da64747b4c9665aebb0b83,0,Suresh Marru,2012-04-26 02:24:41+00:00,['8e9852b6e3b015e27b71da617476699a412bc39f'],13,7,20,652906,1,,,,2552
00378aaed0f95f8bf9bb3b717af6ff7b937b26ec,1,Lahiru Gunathilake,2012-04-26 13:41:34+00:00,['50ff854e5e15ed0c42da64747b4c9665aebb0b83'],12,11,23,652929,1,0,0,0.5,2552
5b8d038fdfdb25fd74bf2a31829d5048b9a39a54,0,Heshan Theekshana Suriyaarachchi,2012-04-26 18:27:57+00:00,['00378aaed0f95f8bf9bb3b717af6ff7b937b26ec'],1,5,6,652935,1,0,0,1,2552
9afc3caffc57355fa15f5a6611b8cfa36477e05c,0,Lahiru Gunathilake,2012-04-27 14:45:27+00:00,['5b8d038fdfdb25fd74bf2a31829d5048b9a39a54'],2,6,8,652943,1,0,0,1,2552
20c3066ade5c76f737086877c05cf2a4744a893e,0,Marlon Pierce,2012-04-27 18:43:19+00:00,['9afc3caffc57355fa15f5a6611b8cfa36477e05c'],3,3,6,652949,1,,,,2552
1d6a0556d62d59199605cf2bf3a4d7059949e448,0,samindaw,2012-04-30 16:58:02+00:00,['20c3066ade5c76f737086877c05cf2a4744a893e'],47,164,211,653160,8,0.872727273,0.945454545,1,2553
c05cd59b455b06572d4c0e17c54f1343056fa2a0,0,Lahiru Gunathilake,2012-04-30 17:10:01+00:00,['1d6a0556d62d59199605cf2bf3a4d7059949e448'],0,9,9,653169,1,1,1,1,2553
cd1d5c6c0d3492bde72a6fec9423ec93010a6fe8,0,Lahiru Gunathilake,2012-04-30 17:11:38+00:00,['c05cd59b455b06572d4c0e17c54f1343056fa2a0'],20,56,76,653245,1,1,1,1,2553
a17eba21d2c25b7c6e489374e63533b63b836aa9,0,Lahiru Gunathilake,2012-04-30 18:01:38+00:00,['cd1d5c6c0d3492bde72a6fec9423ec93010a6fe8'],8,8,16,653261,3,,,,2553
7a8d2b6ecd2be9b7545c443dcce7ab2caaf9b5be,0,samindaw,2012-05-02 01:26:31+00:00,['a17eba21d2c25b7c6e489374e63533b63b836aa9'],98,147,245,653506,6,0.666666667,0.666666667,1,2553
96ea398a9b7fd4aea9bf3477bc286c3f4217f05b,0,Suresh Marru,2012-05-02 02:10:31+00:00,['7a8d2b6ecd2be9b7545c443dcce7ab2caaf9b5be'],17,3,20,653526,2,,,,2553
ccce11aeaf6b1ef4fa0575f9b07784bd53110a4e,0,Suresh Marru,2012-05-02 03:29:16+00:00,['96ea398a9b7fd4aea9bf3477bc286c3f4217f05b'],57,62,119,653645,1,,,,2553
899ba50312d7a701a24bfca5d9369b9fb3a3a9ce,0,Lahiru Gunathilake,2012-05-02 20:44:03+00:00,['ccce11aeaf6b1ef4fa0575f9b07784bd53110a4e'],1,1,2,653647,1,,,,2553
8bb9b8fecbeca9780cb3a4f24cec0b822dadbc0a,0,Suresh Marru,2012-05-03 13:11:52+00:00,['899ba50312d7a701a24bfca5d9369b9fb3a3a9ce'],8,25,33,653680,2,,,,2553
5f54916818f1e43310c53f834620b1b11e49df39,0,Lahiru Gunathilake,2012-05-03 20:45:10+00:00,['8bb9b8fecbeca9780cb3a4f24cec0b822dadbc0a'],0,23,23,653703,3,,,,2553
cc28d8797d2bb9ae6f26dbce78ac429dc8641fea,0,Suresh Marru,2012-05-06 15:21:54+00:00,['5f54916818f1e43310c53f834620b1b11e49df39'],2571,2321,4892,658595,26,,,,2553
1bc63ce32474d062f795b0e65c5fbdffce95eab0,0,Suresh Marru,2012-05-06 21:13:59+00:00,['cc28d8797d2bb9ae6f26dbce78ac429dc8641fea'],236,200,436,659031,2,,,,2553
b10def5669215eadbeebd09f2496e895f5ac63f2,0,Suresh Marru,2012-05-08 02:05:01+00:00,['1bc63ce32474d062f795b0e65c5fbdffce95eab0'],10,0,10,659041,2,,,,2553
400254f3e3df93a040bbff6f0090bbcfc2cf0173,0,Suresh Marru,2012-05-08 02:37:08+00:00,['b10def5669215eadbeebd09f2496e895f5ac63f2'],454,77,531,659572,6,,,,2553
edd914c4455aa4f20207ebb690714f2875481fcd,0,Lahiru Gunathilake,2012-05-08 21:20:25+00:00,['400254f3e3df93a040bbff6f0090bbcfc2cf0173'],89,39,128,659700,6,1,0.583333333,0.472222222,2553
bab9ce372b87b497cca85b99e22ed7989c7dfc6a,0,Lahiru Gunathilake,2012-05-08 21:21:09+00:00,['edd914c4455aa4f20207ebb690714f2875481fcd'],99,42,141,659841,1,1,0.254901961,0.117647059,2553
2a9be857a1f80a61b2234b0f22a1dd8747eb5167,0,samindaw,2012-05-09 14:41:18+00:00,['bab9ce372b87b497cca85b99e22ed7989c7dfc6a'],133,164,297,660138,1,0,0.827586207,0.827586207,2553
be97aea4fefb7ceabbf427130b3007c6abbd0091,0,samindaw,2012-05-09 14:42:45+00:00,['2a9be857a1f80a61b2234b0f22a1dd8747eb5167'],52,152,204,660342,8,0.489361702,0.489361702,1,2554
c6aafd113f26a2c832c526c2a23a3858cb592c17,0,Lahiru Gunathilake,2012-05-09 16:25:25+00:00,['be97aea4fefb7ceabbf427130b3007c6abbd0091'],169,172,341,660683,6,1,1,0,2554
44a6735bfdce733f599b793db83360ef407330e7,0,Lahiru Gunathilake,2012-05-09 16:33:31+00:00,['c6aafd113f26a2c832c526c2a23a3858cb592c17'],9,10,19,660702,1,,,,2554
30583bc7cf2cc2b65acf56fd68cc2bb746cff229,0,Lahiru Gunathilake,2012-05-09 16:53:53+00:00,['44a6735bfdce733f599b793db83360ef407330e7'],1,5,6,660708,1,0,0.25,1,2554
d1d8809db52c5a9402892821b7ed27b4a17ea1f0,0,samindaw,2012-05-09 17:39:41+00:00,['30583bc7cf2cc2b65acf56fd68cc2bb746cff229'],19,15,34,660742,4,1,0,0,2554
cc36adceb32af1f332a13f697fa598c07431948b,0,samindaw,2012-05-09 17:57:54+00:00,['d1d8809db52c5a9402892821b7ed27b4a17ea1f0'],0,14,14,660756,1,,,,2554
e5fcbb7a07fb500d784439befa6c882da05ac2ad,0,samindaw,2012-05-10 14:00:19+00:00,['cc36adceb32af1f332a13f697fa598c07431948b'],5,18,23,660779,1,0.545454545,0.272727273,1,2554
5864e3840c9441c7d2289d60c496b5d07173f0d4,0,Suresh Marru,2012-05-13 00:03:11+00:00,['e5fcbb7a07fb500d784439befa6c882da05ac2ad'],5,0,5,660784,1,,,,2554
7b638f3d80eed8de94e4f43e03600f4b8485d63c,0,Suresh Marru,2012-05-13 15:20:50+00:00,['5864e3840c9441c7d2289d60c496b5d07173f0d4'],819,1733,2552,663336,2,,,,2554
e6805edb160998cc43fe6fe6336fc7ff2f051f8a,0,Suresh Marru,2012-05-13 18:48:08+00:00,['7b638f3d80eed8de94e4f43e03600f4b8485d63c'],54,20,74,663410,7,,,,2554
6f0742fc39f5c441333299f9eb9fb5abc72d1123,0,Lahiru Gunathilake,2012-05-14 20:50:05+00:00,['e6805edb160998cc43fe6fe6336fc7ff2f051f8a'],13,46,59,663469,1,0.846153846,0.115384615,0.807692308,2554
8ff37d2b55da910f8c481799e085fd95f09bfcc7,0,Lahiru Gunathilake,2012-05-14 20:50:29+00:00,['6f0742fc39f5c441333299f9eb9fb5abc72d1123'],31,65,96,663565,3,0.32,0.72,0.92,2554
3dd505dd7badb13bf123588a91aebc52125fd651,0,Lahiru Gunathilake,2012-05-14 20:50:59+00:00,['8ff37d2b55da910f8c481799e085fd95f09bfcc7'],5,6,11,663576,1,,,,2554
71499bc0bc4eb05f336cce151e8091c599c6bdf8,0,Suresh Marru,2012-05-15 01:56:05+00:00,['3dd505dd7badb13bf123588a91aebc52125fd651'],7,0,7,663583,1,,,,2554
e147a123aa3bbb1c660efc8ad747752bbe3bc8ec,0,Suresh Marru,2012-05-15 02:18:29+00:00,['71499bc0bc4eb05f336cce151e8091c599c6bdf8'],1,0,1,663584,1,,,,2554
4b6f333f6753378604600602b00d3cc5f454d5ba,0,Suresh Marru,2012-05-15 02:44:42+00:00,['e147a123aa3bbb1c660efc8ad747752bbe3bc8ec'],156,54,210,663794,3,,,,2554
68eda3ce7d1e5cb52dc8091af6d8a73a7c367a2c,0,Lahiru Gunathilake,2012-05-15 03:29:23+00:00,['4b6f333f6753378604600602b00d3cc5f454d5ba'],12,2,14,663808,1,,,,2554
0baaf6fe83abdd0675d65805adb69354c622c83c,0,Lahiru Gunathilake,2012-05-15 13:37:55+00:00,['68eda3ce7d1e5cb52dc8091af6d8a73a7c367a2c'],1,5,6,663814,1,0,0,0,2554
8d1b79fae6191d5d27123dd77aec2d81b5e5ee94,0,Lahiru Gunathilake,2012-05-15 13:38:30+00:00,['0baaf6fe83abdd0675d65805adb69354c622c83c'],2,56,58,663872,1,0,0,1,2554
b32f5a9643661dbb0df029f8c0876f8d8fc663dd,0,Suresh Marru,2012-05-15 14:26:29+00:00,['8d1b79fae6191d5d27123dd77aec2d81b5e5ee94'],72,56,128,664000,24,,,,2554
5267d775dae5f975397006cf36c9084bdf212d61,0,Lahiru Gunathilake,2012-05-15 18:42:26+00:00,['b32f5a9643661dbb0df029f8c0876f8d8fc663dd'],9,6,15,664015,1,1,1,0,2554
d31854b89135855f1fa439eb27328bf0c7f6a45a,0,Lahiru Gunathilake,2012-05-15 18:42:58+00:00,['5267d775dae5f975397006cf36c9084bdf212d61'],2,0,2,664017,1,0,0,0,2554
adbaf0897f92c4140a8de1124024f94aa56623c2,0,samindaw,2012-05-17 12:58:10+00:00,['d31854b89135855f1fa439eb27328bf0c7f6a45a'],2,5,7,664024,2,0,1,1,2554
d991fb59f7f9553bfe177bd4f8865677d25d688a,0,samindaw,2012-05-17 13:07:39+00:00,['adbaf0897f92c4140a8de1124024f94aa56623c2'],682,515,1197,665221,84,0,0,0,2555
281333924da10577f0c7f1f0bf53555d89c85ea0,0,samindaw,2012-05-17 15:53:59+00:00,['d991fb59f7f9553bfe177bd4f8865677d25d688a'],131,148,279,665500,16,0,1,1,2556
48451c2ce644526b43f8ce31b3ba391367f3cf48,0,samindaw,2012-05-17 15:55:27+00:00,['281333924da10577f0c7f1f0bf53555d89c85ea0'],4,0,4,665504,2,0,0,0,2556
8adf9e5b6cd666fa1fb0a98806ad56a37c810b79,0,samindaw,2012-05-17 16:05:10+00:00,['48451c2ce644526b43f8ce31b3ba391367f3cf48'],1,0,1,665505,1,,,,2556
80df06c72cf330b164b3ddbbd7f0ac8e37dbf2e7,1,samindaw,2012-05-17 16:39:54+00:00,['8adf9e5b6cd666fa1fb0a98806ad56a37c810b79'],1889,1890,3779,669284,273,,,,2556
a65926bc59cfeff8e3c55bef1ebfae6d25fa245a,0,samindaw,2012-05-17 17:12:15+00:00,['80df06c72cf330b164b3ddbbd7f0ac8e37dbf2e7'],62,507,569,669853,114,1,1,1,2560
761c4bc1315efa83f17ddf653db1d711205edd79,1,samindaw,2012-05-17 17:54:09+00:00,['a65926bc59cfeff8e3c55bef1ebfae6d25fa245a'],757,757,1514,671367,231,,,,2560
ccbee130c2287482baf727db0114d34476818db7,0,samindaw,2012-05-17 17:55:14+00:00,['761c4bc1315efa83f17ddf653db1d711205edd79'],0,0,0,671367,0,,,,2560
ef4ca6a66480f45e52653711e5035d59f54e4910,0,samindaw,2012-05-17 19:39:42+00:00,['ccbee130c2287482baf727db0114d34476818db7'],1,1,2,671369,1,,,,2560
9e2f214435934f75cb9ed09bb140010e091c52b8,0,samindaw,2012-05-18 02:05:16+00:00,['ef4ca6a66480f45e52653711e5035d59f54e4910'],49,59,108,671477,2,0,0,1,2561
f6a63b65341719c15a1c5b85942d22677f2dfb39,0,samindaw,2012-05-18 15:44:22+00:00,['9e2f214435934f75cb9ed09bb140010e091c52b8'],2593,619,3212,674689,188,0.70156438,0.294825511,0,2561
a8096429f24476bb3fbcf59a7c3f50183b495107,0,samindaw,2012-05-18 15:48:30+00:00,['f6a63b65341719c15a1c5b85942d22677f2dfb39'],0,0,0,674689,0,,,,2561
ed57856dd25c3f8f0b9a247e5039aa896e9e3f30,0,samindaw,2012-05-19 21:06:56+00:00,['a8096429f24476bb3fbcf59a7c3f50183b495107'],1379,327,1706,676395,63,0.67721519,0,0,2562
afa38fce4b80d975cd70b05be960a148ca18df3e,0,samindaw,2012-05-19 23:24:55+00:00,['ed57856dd25c3f8f0b9a247e5039aa896e9e3f30'],0,246,246,676641,4,1,1,1,2566
405d2d5a6c6f676ab2fc751c30c7527f539c96c9,0,samindaw,2012-05-20 03:45:50+00:00,['afa38fce4b80d975cd70b05be960a148ca18df3e'],10,10,20,676661,130,,,,2566
ca5ae9bc1acefd2cc211f7cb7909d5f25f9a7923,0,samindaw,2012-05-20 03:52:59+00:00,['405d2d5a6c6f676ab2fc751c30c7527f539c96c9'],6,6,12,676673,126,,,,2566
fea17abda088668898f0dcca2d73fe1bc4e8e047,0,samindaw,2012-05-21 17:17:54+00:00,['ca5ae9bc1acefd2cc211f7cb7909d5f25f9a7923'],0,4,4,676677,1,1,1,1,2566
833d787df78159ef566e6b8aac9e9b42a598dce3,0,samindaw,2012-05-22 17:58:06+00:00,['fea17abda088668898f0dcca2d73fe1bc4e8e047'],526,464,990,677667,84,0.592592593,0.592592593,0,2567
4e87cfea12acebfcb1354ba28c1a14a5cea68359,0,Lahiru Gunathilake,2012-05-22 18:05:02+00:00,['833d787df78159ef566e6b8aac9e9b42a598dce3'],0,19,19,677686,2,0,0,0,2567
6c50f61e34a7a8839880b44e4f3ba47b945ebea8,0,Suresh Marru,2012-05-23 01:57:13+00:00,['4e87cfea12acebfcb1354ba28c1a14a5cea68359'],89003,0,89003,766689,483,0.525778853,0.422862987,0.174752438,2567
7e04e116903ddf77d51ee9d7aaf6dc30941a1683,0,Lahiru Gunathilake,2012-05-23 17:48:10+00:00,['6c50f61e34a7a8839880b44e4f3ba47b945ebea8'],4,42,46,766735,3,0,0,0.388888889,2567
27217450135fa0a0ffc8737b95b9411f35c5ca5b,0,Lahiru Gunathilake,2012-05-24 13:53:09+00:00,['7e04e116903ddf77d51ee9d7aaf6dc30941a1683'],22,58,80,766815,1,0.25,0.25,0.75,2567
fef4348fdddac383d6e851f373cc26f3560b0c80,0,Lahiru Gunathilake,2012-05-24 15:12:57+00:00,['27217450135fa0a0ffc8737b95b9411f35c5ca5b'],45,61,106,766921,1,0,0,0,2567
6dace9a744c7b1a0dab716efe7e1502ac5e07712,0,Lahiru Gunathilake,2012-05-24 16:14:25+00:00,['fef4348fdddac383d6e851f373cc26f3560b0c80'],27,11,38,766959,1,1,1,0,2567
05c40cb5c561b2dae23e5635be74135e6ad3896f,0,samindaw,2012-05-25 17:23:11+00:00,['6dace9a744c7b1a0dab716efe7e1502ac5e07712'],421,1004,1425,768384,60,0.652173913,0.882608696,0.808695652,2572
b731bc943e48e0fbc8a951d26f2a94fce98a01aa,0,samindaw,2012-05-26 03:46:27+00:00,['05c40cb5c561b2dae23e5635be74135e6ad3896f'],195,245,440,768824,14,1,0,1,2572
d7ffbe3ee7192a32a9ac76c2a1bd82387bb99886,0,samindaw,2012-05-26 04:00:34+00:00,['b731bc943e48e0fbc8a951d26f2a94fce98a01aa'],1,1,2,768826,1,,,,2572
14c05f75a25aad99c5cd1bf5de7ed5e8fbae4a45,0,samindaw,2012-05-26 07:03:26+00:00,['d7ffbe3ee7192a32a9ac76c2a1bd82387bb99886'],23,40,63,768889,7,1,1,1,2572
3d974db55796ee6a28e9e67e0839e1db6ffa1732,0,samindaw,2012-05-27 04:35:10+00:00,['14c05f75a25aad99c5cd1bf5de7ed5e8fbae4a45'],84,89,173,769062,4,1,1,0.470588235,2572
575576f883cfa8b078826668018ffbae01fa73b5,0,Lahiru Gunathilake,2012-05-27 22:58:49+00:00,['3d974db55796ee6a28e9e67e0839e1db6ffa1732'],6,15,21,769083,1,0,1,1,2572
20e2fcb6dc227593eefa025f48683144fada4779,0,Lahiru Gunathilake,2012-05-29 19:04:36+00:00,['575576f883cfa8b078826668018ffbae01fa73b5'],4,1,5,769088,1,,,,2572
5ced7ece0c5f178038d6c4e1b3f2f5c9d24c6adb,0,Lahiru Gunathilake,2012-05-30 14:10:38+00:00,['20e2fcb6dc227593eefa025f48683144fada4779'],12,14,26,769114,2,0,0,0,2572
2624d4e483556a340561dc905a404250095f0314,0,Lahiru Gunathilake,2012-05-30 14:18:02+00:00,['5ced7ece0c5f178038d6c4e1b3f2f5c9d24c6adb'],2,29,31,769145,2,0.684210526,0.684210526,1,2572
cec528348ff0bb132a03579b5701bb70f46a564b,0,samindaw,2012-05-30 14:41:43+00:00,['2624d4e483556a340561dc905a404250095f0314'],1,5,6,769151,1,0,0,1,2572
9472646a06005437909903a4f3b8e9955ee7473f,0,Raminderjeet Singh,2012-05-30 15:11:29+00:00,['cec528348ff0bb132a03579b5701bb70f46a564b'],2,10,12,769163,1,0,0,1,2572
57ce94872be8d0538321e7156fa2bfe60efefb53,0,Raminderjeet Singh,2012-05-30 16:00:33+00:00,['9472646a06005437909903a4f3b8e9955ee7473f'],1,1,2,769165,1,,,,2572
75330b39249251afe428c2341e0cd6355824d70b,0,samindaw,2012-05-30 16:03:11+00:00,['57ce94872be8d0538321e7156fa2bfe60efefb53'],7,33,40,769205,2,0.125,0.916666667,0.958333333,2572
d1f81994982d8aee2809accb28e14d5c5f8ac2ff,0,Lahiru Gunathilake,2012-05-30 21:00:49+00:00,['75330b39249251afe428c2341e0cd6355824d70b'],7,4,11,769216,1,1,0,0,2572
c10460dc065553ca9e92975bd54082fb7d78d4aa,0,Raminderjeet Singh,2012-05-31 21:26:02+00:00,['d1f81994982d8aee2809accb28e14d5c5f8ac2ff'],15,88,103,769319,1,0,0,1,2572
dfef0db250b56bfe2dd698de450ca788004fa0b9,0,Raminderjeet Singh,2012-05-31 21:27:08+00:00,['c10460dc065553ca9e92975bd54082fb7d78d4aa'],3,6,9,769328,1,0,1,1,2572
fed5508b01f286580c56d4a46600cadc40f2785c,0,Raminderjeet Singh,2012-05-31 21:28:44+00:00,['dfef0db250b56bfe2dd698de450ca788004fa0b9'],65,49,114,769442,1,1,1,0,2572
64947a5690b8266f827e22de7ea8c597f2f7e50c,0,samindaw,2012-06-06 14:30:11+00:00,['fed5508b01f286580c56d4a46600cadc40f2785c'],1,14,15,769457,4,1,1,0.75,2572
f7eaef63520a9c9e43e948fa275d4cddf774d887,0,Lahiru Gunathilake,2012-06-07 03:29:21+00:00,['64947a5690b8266f827e22de7ea8c597f2f7e50c'],14,60,74,769531,2,0,0,1,2572
29cf6a873a41f9d1fa12ae9e0017d337e805b7f2,0,samindaw,2012-06-07 20:46:15+00:00,['f7eaef63520a9c9e43e948fa275d4cddf774d887'],75,40,115,769646,3,1,1,0,2572
61e87a9ccfc041c64777ba913474e5103f460269,0,Suresh Marru,2012-06-09 12:37:59+00:00,['29cf6a873a41f9d1fa12ae9e0017d337e805b7f2'],17,0,17,769663,1,,,,2572
8f5358a2c46c876c416de0f6bbc667bec15625f9,0,Suresh Marru,2012-06-09 12:54:46+00:00,['61e87a9ccfc041c64777ba913474e5103f460269'],0,0,0,769663,5,,,,2572
81a1f05d72e95b2eb7c4581b589eb438d6955e7a,0,Suresh Marru,2012-06-09 13:12:07+00:00,['8f5358a2c46c876c416de0f6bbc667bec15625f9'],14056,0,14056,783719,48,,,,2572
17b1928c25947cdf3cacc9badb4dae9c97a2cc6b,0,Suresh Marru,2012-06-09 14:03:08+00:00,['81a1f05d72e95b2eb7c4581b589eb438d6955e7a'],0,17,17,783736,1,,,,2572
13ef5e634740e29680e942d873fb908a7a3d6058,0,Suresh Marru,2012-06-09 16:13:05+00:00,['17b1928c25947cdf3cacc9badb4dae9c97a2cc6b'],0,0,0,783736,1,,,,2572
21ce430ca8f98123beab4dfeb0ef747d04ce6fa1,0,Lahiru Gunathilake,2012-06-11 02:31:57+00:00,['13ef5e634740e29680e942d873fb908a7a3d6058'],7,17,24,783760,2,0,1,1,2572
a523e17363b6fb7c54890c567c3edbb959c9c221,0,samindaw,2012-06-11 03:57:00+00:00,['21ce430ca8f98123beab4dfeb0ef747d04ce6fa1'],7,7,14,783774,1,,,,2572
b55f68b4d26d697abe6649ac970d89f4823fb7e2,0,samindaw,2012-06-11 18:29:19+00:00,['a523e17363b6fb7c54890c567c3edbb959c9c221'],30,62,92,783866,4,0,1,0.458333333,2572
ff0ce1b92e11486f5d41b8bc57b9512389f00b74,0,Lahiru Gunathilake,2012-06-11 18:48:48+00:00,['b55f68b4d26d697abe6649ac970d89f4823fb7e2'],13,7,20,783886,1,1,1,1,2572
184c805b1cd17115cf8c737deecfb444f00e4879,0,Lahiru Gunathilake,2012-06-13 15:21:24+00:00,['ff0ce1b92e11486f5d41b8bc57b9512389f00b74'],0,31,31,783917,1,,,,2572
05fe41a4c91c1802e342147deeb2df4f0c5966d8,0,Heshan Theekshana Suriyaarachchi,2012-06-13 20:47:25+00:00,['184c805b1cd17115cf8c737deecfb444f00e4879'],1,3,4,783921,2,0,0,1,2572
3719e2115d453da76c53fd5d712543dd754d40d9,0,Heshan Theekshana Suriyaarachchi,2012-06-13 21:49:21+00:00,['05fe41a4c91c1802e342147deeb2df4f0c5966d8'],2,2,4,783925,1,,,,2572
0e37845252b8fb2ab15912e88f6696c24700c7f0,0,Lahiru Gunathilake,2012-06-13 22:28:09+00:00,['3719e2115d453da76c53fd5d712543dd754d40d9'],0,5,5,783930,1,0,1,1,2572
b1d91897866b9dd992483363d9c2548dafee8b6d,0,Heshan Theekshana Suriyaarachchi,2012-06-14 22:15:30+00:00,['0e37845252b8fb2ab15912e88f6696c24700c7f0'],0,514,514,784444,1,,,,2573
352f0c8969ff857a61895481be2b39363dd65ae0,0,Heshan Theekshana Suriyaarachchi,2012-06-14 22:15:51+00:00,['b1d91897866b9dd992483363d9c2548dafee8b6d'],0,1691,1691,786135,1,,,,2574
5cc546ca7796712ff03dab847f5bbf051876d94a,1,Raminderjeet Singh,2012-06-15 15:34:38+00:00,['352f0c8969ff857a61895481be2b39363dd65ae0'],225,174,399,786534,1,1,0.957446809,0.531914894,2574
e96c87e3712adc43ae1606cd1bd61f751497859d,0,Raminderjeet Singh,2012-06-15 15:36:46+00:00,['5cc546ca7796712ff03dab847f5bbf051876d94a'],16,33,49,786583,7,0.133333333,0.133333333,1,2574
311d85d93c5ab8c2489e89c5126e8fac9e49500b,0,Heshan Theekshana Suriyaarachchi,2012-06-15 15:42:03+00:00,['e96c87e3712adc43ae1606cd1bd61f751497859d'],0,69,69,786652,1,1,1,1,2575
8467050eb894e5067616e200a10eb2d6b8a41690,0,Heshan Theekshana Suriyaarachchi,2012-06-15 15:42:50+00:00,['311d85d93c5ab8c2489e89c5126e8fac9e49500b'],1,2,3,786655,1,,,,2575
a724f6d53e6a5ca4113d1044e6b0769cc71c5909,0,Heshan Theekshana Suriyaarachchi,2012-06-15 18:26:40+00:00,['8467050eb894e5067616e200a10eb2d6b8a41690'],0,69,69,786724,1,1,1,1,2576
ad3a6ad189778258df92b8719277fc67f8625eac,0,Heshan Theekshana Suriyaarachchi,2012-06-15 18:27:25+00:00,['a724f6d53e6a5ca4113d1044e6b0769cc71c5909'],2,2,4,786728,1,,,,2576
1aeef7b5035129641cd34f6b056dd0b5ace52f2a,0,Heshan Theekshana Suriyaarachchi,2012-06-15 18:37:55+00:00,['ad3a6ad189778258df92b8719277fc67f8625eac'],1,1,2,786730,1,,,,2576
8c9ac85ff4165b0820095b25bb7508a50d1fee69,0,Heshan Theekshana Suriyaarachchi,2012-06-15 18:41:01+00:00,['1aeef7b5035129641cd34f6b056dd0b5ace52f2a'],0,20,20,786750,1,,,,2576
a762e89c351a2f878736489c696bfa5b6558ce3a,0,Heshan Theekshana Suriyaarachchi,2012-06-15 18:47:51+00:00,['8c9ac85ff4165b0820095b25bb7508a50d1fee69'],410,428,838,787588,2,,,,2576
e7ee96a903f02163f7f061e9314cf95a7487e93d,0,Heshan Theekshana Suriyaarachchi,2012-06-15 19:18:43+00:00,['a762e89c351a2f878736489c696bfa5b6558ce3a'],0,179,179,787767,1,,,,2577
f2afc5b9322e0401294d02326d31ad36e00c87f7,0,Heshan Theekshana Suriyaarachchi,2012-06-15 20:21:44+00:00,['e7ee96a903f02163f7f061e9314cf95a7487e93d'],2,1,3,787770,1,0,0,0,2577
def80a64f06a3411eae3db73aae6a1ecee73a565,0,samindaw,2012-06-19 16:36:35+00:00,['f2afc5b9322e0401294d02326d31ad36e00c87f7'],3,35,38,787808,1,0.185185185,1,1,2577
cd8ecd57ba1f6a60700ee4c85eb81f85c77315de,0,samindaw,2012-06-20 03:02:57+00:00,['def80a64f06a3411eae3db73aae6a1ecee73a565'],310,212,522,788330,6,1,0.344262295,0,2577
1d42814f1f4e62e2ee57d4468652561395ec5ab2,0,Suresh Marru,2012-06-20 12:33:51+00:00,['cd8ecd57ba1f6a60700ee4c85eb81f85c77315de'],12,0,12,788342,1,,,,2577
5c6b331ce4515c4fd0345e048d790f0339b4729b,0,Heshan Theekshana Suriyaarachchi,2012-06-20 13:02:52+00:00,['1d42814f1f4e62e2ee57d4468652561395ec5ab2'],6,5,11,788353,1,,,,2577
3a9fafcc6c9acaf77132e4413b749b1ddf48e21e,0,samindaw,2012-06-20 16:51:52+00:00,['5c6b331ce4515c4fd0345e048d790f0339b4729b'],2,6,8,788361,1,0,0,1,2577
705774ecc60e70414b71106a03aa17504c23d38b,0,Lahiru Gunathilake,2012-06-20 17:14:11+00:00,['3a9fafcc6c9acaf77132e4413b749b1ddf48e21e'],8,0,8,788369,1,0,0,0,2577
21e137ebe569673caa2218f117d978e99d567511,0,samindaw,2012-06-20 20:09:40+00:00,['705774ecc60e70414b71106a03aa17504c23d38b'],91,96,187,788556,13,0,0,1,2577
31ffa7dda5c7d91416122c2a5ec28e6c4947229d,0,Lahiru Gunathilake,2012-06-20 22:57:26+00:00,['21e137ebe569673caa2218f117d978e99d567511'],12,22,34,788590,6,0,0,0.666666667,2577
0998c291e52eb19e29045a59cf727bd437bf5181,0,samindaw,2012-06-21 06:51:01+00:00,['31ffa7dda5c7d91416122c2a5ec28e6c4947229d'],21,486,507,789097,7,0.267361111,0.972222222,1,2578
c00768081fa01f381bde9eff64261049ad05f5cc,0,samindaw,2012-06-21 08:19:47+00:00,['0998c291e52eb19e29045a59cf727bd437bf5181'],9,135,144,789241,4,0,0,1,2578
969c3b239c88622dd5d1ff0f1f96c569eba28770,0,samindaw,2012-06-21 09:17:58+00:00,['c00768081fa01f381bde9eff64261049ad05f5cc'],17,43,60,789301,1,1,0.291666667,0,2578
c9fbd52ac8ed35ba2b73e9e6da432676731b43ff,0,Lahiru Gunathilake,2012-06-21 16:34:22+00:00,['969c3b239c88622dd5d1ff0f1f96c569eba28770'],1,13,14,789315,1,1,1,1,2578
9906edf9f860e2c58eb5cd08c6d30d498910403b,0,Heshan Theekshana Suriyaarachchi,2012-06-21 17:40:31+00:00,['c9fbd52ac8ed35ba2b73e9e6da432676731b43ff'],0,65,65,789380,1,,,,2578
630fb632bc51a57bd4cdfd8e04fe58ccf68136bc,0,Heshan Theekshana Suriyaarachchi,2012-06-21 17:49:46+00:00,['9906edf9f860e2c58eb5cd08c6d30d498910403b'],50,0,50,789430,1,,,,2578
d5b63921576ad15fc621e1b4ae952328ee35436d,0,Lahiru Gunathilake,2012-06-21 19:15:54+00:00,['630fb632bc51a57bd4cdfd8e04fe58ccf68136bc'],1,20,21,789451,2,1,1,1,2578
523c2c6c63d4eb56cb16b98d825dce2d2d346b3c,0,samindaw,2012-06-22 07:49:26+00:00,['d5b63921576ad15fc621e1b4ae952328ee35436d'],88,2059,2147,791598,32,1,1,0.880555556,2597
7052f9b8db0a30b2a43409df156996ca38ff0389,0,samindaw,2012-06-22 20:35:00+00:00,['523c2c6c63d4eb56cb16b98d825dce2d2d346b3c'],68,219,287,791885,7,0.878980892,0.917197452,0.770700637,2597
7223d73c9eda21df6847f4c862eec01a358bfdd8,0,samindaw,2012-06-22 21:11:59+00:00,['7052f9b8db0a30b2a43409df156996ca38ff0389'],19,202,221,792106,4,0.965116279,0.965116279,0.720930233,2599
bd263d683d20444da35792b34f8586365166d1f9,0,Lahiru Gunathilake,2012-06-23 22:30:43+00:00,['7223d73c9eda21df6847f4c862eec01a358bfdd8'],47,445,492,792598,3,,,,2599
d4cddb479ecf5051a76ae659f3b9761a9989fb04,0,Raminderjeet Singh,2012-06-26 16:07:33+00:00,['bd263d683d20444da35792b34f8586365166d1f9'],169,1062,1231,793829,7,0.52393617,0.587765957,1,2603
35c1f6205f96a35b9c76f55fe82ac01f0c9f0f05,0,Lahiru Gunathilake,2012-06-26 16:09:02+00:00,['d4cddb479ecf5051a76ae659f3b9761a9989fb04'],19,61,80,793909,7,0,0.024390244,1,2603
009d3ab4b13f5c1338c2fb7515f6cac648bffcda,0,Raminderjeet Singh,2012-06-26 16:21:14+00:00,['35c1f6205f96a35b9c76f55fe82ac01f0c9f0f05'],15,781,796,794705,6,0.307479224,0.833795014,1,2607
91b8245b80cedcd851e455c4e23ad1286edbe6c2,1,Raminderjeet Singh,2012-06-26 17:57:14+00:00,['009d3ab4b13f5c1338c2fb7515f6cac648bffcda'],545,647,1192,795897,2,1,1,0.111111111,2608
238d38888fd1d875947b61f6c19bccfccdfd04b7,0,Raminderjeet Singh,2012-06-26 19:47:47+00:00,['91b8245b80cedcd851e455c4e23ad1286edbe6c2'],240,96,336,796233,1,1,1,0,2608
925ba12a2b3708a6f7a3e12b29ff1dbf96980905,0,Lahiru Gunathilake,2012-06-26 22:28:16+00:00,['238d38888fd1d875947b61f6c19bccfccdfd04b7'],8,6,14,796247,2,1,0,0,2608
07001cbeb59a1113499475395c2be1c02e065717,0,Lahiru Gunathilake,2012-06-27 14:50:24+00:00,['925ba12a2b3708a6f7a3e12b29ff1dbf96980905'],4,0,4,796251,1,1,1,1,2608
a50ef0d8705f00a1d3adff9e4074eb31f56041aa,0,Raminderjeet Singh,2012-06-27 15:37:08+00:00,['07001cbeb59a1113499475395c2be1c02e065717'],10,11,21,796272,1,1,1,1,2608
a02f5b818375d31e8b39d358d46d1de7a22270a3,0,Lahiru Gunathilake,2012-06-27 16:08:24+00:00,['a50ef0d8705f00a1d3adff9e4074eb31f56041aa'],4,66,70,796342,5,0.384615385,1,1,2608
0c85bea3dfdf76ea2e4e7d44e896e0dc600c23c8,0,Lahiru Gunathilake,2012-06-27 17:01:34+00:00,['a02f5b818375d31e8b39d358d46d1de7a22270a3'],5,1,6,796348,2,0,1,1,2608
c3579eaa293951bf81fb1e7180ee8987d14ae020,0,Heshan Theekshana Suriyaarachchi,2012-06-27 18:15:32+00:00,['0c85bea3dfdf76ea2e4e7d44e896e0dc600c23c8'],0,4,4,796352,1,1,1,1,2608
61911c3b8960ecd59e40fe9585bb52ed81d75742,0,Lahiru Gunathilake,2012-06-27 19:21:24+00:00,['c3579eaa293951bf81fb1e7180ee8987d14ae020'],5,2,7,796359,2,0,0,0,2608
efa29b619619438a3d15e2b240df03e6b3177cd3,0,Lahiru Gunathilake,2012-06-27 19:43:51+00:00,['61911c3b8960ecd59e40fe9585bb52ed81d75742'],30,318,348,796707,5,,,,2608
ff5733a259e03bd76fd89393de3fb5f1e8ffe993,0,Heshan Theekshana Suriyaarachchi,2012-06-27 19:52:28+00:00,['efa29b619619438a3d15e2b240df03e6b3177cd3'],4,4,8,796715,1,,,,2608
396d47b5ba5437b74f8d9c2617ea2383ecf0fc27,0,Heshan Theekshana Suriyaarachchi,2012-06-27 20:02:04+00:00,['ff5733a259e03bd76fd89393de3fb5f1e8ffe993'],3,3,6,796721,1,,,,2608
c45655dc3214feb093e39ea5c0211c4b25fad4f2,0,Heshan Theekshana Suriyaarachchi,2012-06-27 20:02:37+00:00,['396d47b5ba5437b74f8d9c2617ea2383ecf0fc27'],1,0,1,796722,1,,,,2608
71f600db8546015d0b8294c44e64b3182d4e6215,1,Raminderjeet Singh,2012-06-27 22:34:46+00:00,['c45655dc3214feb093e39ea5c0211c4b25fad4f2'],9,92,101,796823,3,0.046511628,0.790697674,1,2608
ff2417840a59d39de643243f6b9d3c912dfb3924,0,samindaw,2012-06-28 15:05:31+00:00,['71f600db8546015d0b8294c44e64b3182d4e6215'],103,564,667,797490,10,0.294339623,0.369811321,0.79245283,2611
2e5da42d8567682ed824a6546f516af0acc118cb,0,Heshan Theekshana Suriyaarachchi,2012-06-28 18:03:35+00:00,['ff2417840a59d39de643243f6b9d3c912dfb3924'],0,1,1,797491,1,,,,2611
720fd5addc8bec5ea8f23b06f42804dcb8650e72,0,samindaw,2012-06-28 18:11:24+00:00,['2e5da42d8567682ed824a6546f516af0acc118cb'],0,6,6,797497,1,,,,2611
847c30eb7aed6ee7c718cbfe0f7027d3d2cbe1cd,0,samindaw,2012-06-28 18:39:11+00:00,['720fd5addc8bec5ea8f23b06f42804dcb8650e72'],86,148,234,797731,5,1,0.666666667,1,2611
d9f8fc2735dd950ce30a8ace9b0a33fcd8046fd4,0,Heshan Theekshana Suriyaarachchi,2012-06-28 18:57:04+00:00,['847c30eb7aed6ee7c718cbfe0f7027d3d2cbe1cd'],5,5,10,797741,1,,,,2611
f123a54f48403f08a401ee29171e613290df84ec,0,Heshan Theekshana Suriyaarachchi,2012-06-28 19:12:07+00:00,['d9f8fc2735dd950ce30a8ace9b0a33fcd8046fd4'],1,0,1,797742,1,,,,2611
8d77cb7a69bbe8174b269bd3508afe30c6837850,0,Heshan Theekshana Suriyaarachchi,2012-06-28 19:13:20+00:00,['f123a54f48403f08a401ee29171e613290df84ec'],6,0,6,797748,2,,,,2611
b91a85eef2069f1c5d5df05291b520519645dcb4,0,Raminderjeet Singh,2012-06-28 22:14:30+00:00,['8d77cb7a69bbe8174b269bd3508afe30c6837850'],11,1,12,797760,2,,,,2611
33a3e6c1c7d91712aab3f75feb59a747e0683be6,0,Heshan Theekshana Suriyaarachchi,2012-06-28 22:29:06+00:00,['b91a85eef2069f1c5d5df05291b520519645dcb4'],4,6,10,797770,1,0,1,1,2611
0036a7effec70b650c523d5b847411b9bd214a80,1,Lahiru Gunathilake,2012-06-28 22:50:44+00:00,['33a3e6c1c7d91712aab3f75feb59a747e0683be6'],12,13,25,797795,2,1,1,0,2611
83ce9bab2a645a0995974e485c0dad1dba7c37f2,0,Lahiru Gunathilake,2012-06-28 22:52:42+00:00,['0036a7effec70b650c523d5b847411b9bd214a80'],69,75,144,797939,1,0,0,1,2611
6ac1bac6efc98a48fb18df03aefb44b9d5f79bf1,0,Suresh Marru,2012-06-29 02:30:30+00:00,['83ce9bab2a645a0995974e485c0dad1dba7c37f2'],3,3,6,797945,2,,,,2611
71d41260b5516f1e14a2a09148c307dbe91edc1e,0,Raminderjeet Singh,2012-06-29 05:14:32+00:00,['6ac1bac6efc98a48fb18df03aefb44b9d5f79bf1'],2,23,25,797970,2,0,0,0.571428571,2611
87d5132a0f7d308f426f09dc840a90381f901157,1,Lahiru Gunathilake,2012-06-29 13:53:08+00:00,['71d41260b5516f1e14a2a09148c307dbe91edc1e'],1,1,2,797972,1,,,,2611
c44400ff5b8b27e4602d8ec72e99bc6985dbb407,0,samindaw,2012-06-29 14:47:19+00:00,['87d5132a0f7d308f426f09dc840a90381f901157'],14,14,28,798000,4,,,,2611
fb640c68f12987c152a567c5934bd68265719b19,0,samindaw,2012-06-29 15:28:00+00:00,['c44400ff5b8b27e4602d8ec72e99bc6985dbb407'],32,109,141,798141,8,0.254901961,0.588235294,0.784313725,2611
7d95b2763ebb5221d415ed3cd81b0d6bfe2d9721,0,Lahiru Gunathilake,2012-06-29 16:11:58+00:00,['fb640c68f12987c152a567c5934bd68265719b19'],1,1,2,798143,1,,,,2611
882cb765551a507a64355f8c26cd9f802bbf5995,0,Raminderjeet Singh,2012-06-29 16:50:04+00:00,['7d95b2763ebb5221d415ed3cd81b0d6bfe2d9721'],8,1,9,798152,1,1,1,1,2611
087cdfae392d29597ce17b6a5af2c4efd89aad33,0,Raminderjeet Singh,2012-06-29 18:25:48+00:00,['882cb765551a507a64355f8c26cd9f802bbf5995'],1,1,2,798154,1,,,,2611
bae773dec5ba42df28a4cccf165a7f2760c28548,0,Heshan Theekshana Suriyaarachchi,2012-06-29 19:01:37+00:00,['087cdfae392d29597ce17b6a5af2c4efd89aad33'],0,19,19,798173,1,,,,2611
82d2dc6300b089558cf6e432f49be0ab601f6b7d,0,Heshan Theekshana Suriyaarachchi,2012-06-29 19:04:04+00:00,['bae773dec5ba42df28a4cccf165a7f2760c28548'],69,0,69,798242,3,,,,2611
47dc526329327fa57c34ce23fba1b1a75cc7831b,0,Heshan Theekshana Suriyaarachchi,2012-06-29 19:05:49+00:00,['82d2dc6300b089558cf6e432f49be0ab601f6b7d'],0,19,19,798261,1,,,,2611
4f8e727a8927790a0558b3674b1a980aa42810ea,0,Heshan Theekshana Suriyaarachchi,2012-06-29 19:06:59+00:00,['47dc526329327fa57c34ce23fba1b1a75cc7831b'],41,50,91,798352,1,,,,2611
96f4cd69598fe11e43cdd316012c9f7acd553251,0,Heshan Theekshana Suriyaarachchi,2012-06-29 19:29:27+00:00,['4f8e727a8927790a0558b3674b1a980aa42810ea'],18,58,76,798428,4,,,,2611
eadc450b68e2cc1d80d40b8ae3ebde6305d0dd6e,0,Heshan Theekshana Suriyaarachchi,2012-06-29 19:39:34+00:00,['96f4cd69598fe11e43cdd316012c9f7acd553251'],0,57,57,798485,3,,,,2611
c0695db2df54be3c27ecb0f6c00c40204a5f7f4e,0,Heshan Theekshana Suriyaarachchi,2012-06-29 19:42:06+00:00,['eadc450b68e2cc1d80d40b8ae3ebde6305d0dd6e'],21,30,51,798536,2,,,,2611
bf74bfba0eb9b68292593d607645ece6a26fdfea,0,Heshan Theekshana Suriyaarachchi,2012-06-29 19:42:57+00:00,['c0695db2df54be3c27ecb0f6c00c40204a5f7f4e'],14,35,49,798585,2,,,,2611
d7062c3b7102ba2c8ba901979f385ba0cbb9dc90,0,Heshan Theekshana Suriyaarachchi,2012-06-29 19:43:50+00:00,['bf74bfba0eb9b68292593d607645ece6a26fdfea'],1,22,23,798608,1,1,0,0,2611
17d866716fba88134649c5f9ce9efa2ca2fe9d2b,0,Heshan Theekshana Suriyaarachchi,2012-06-29 22:46:59+00:00,['d7062c3b7102ba2c8ba901979f385ba0cbb9dc90'],0,13,13,798621,1,,,,2611
615048a01e4a291bc61c622230e66f759943241a,0,Heshan Theekshana Suriyaarachchi,2012-06-29 22:48:06+00:00,['17d866716fba88134649c5f9ce9efa2ca2fe9d2b'],0,21,21,798642,1,,,,2611
5d5daca7b467c2700f43f4691d67561adaff19a9,0,Heshan Theekshana Suriyaarachchi,2012-06-29 22:52:06+00:00,['615048a01e4a291bc61c622230e66f759943241a'],0,40,40,798682,2,,,,2611
44a8fa1bc0d854b1bc5d1c33b9cba8d7315ae0b5,0,Heshan Theekshana Suriyaarachchi,2012-06-29 22:58:53+00:00,['5d5daca7b467c2700f43f4691d67561adaff19a9'],0,28,28,798710,2,,,,2611
8733e815bca0883dbf3c98fc4adf74987c7af901,0,Heshan Theekshana Suriyaarachchi,2012-06-29 23:00:26+00:00,['44a8fa1bc0d854b1bc5d1c33b9cba8d7315ae0b5'],1,77,78,798788,4,,,,2611
1a8aa5dfbd0c6915c9fdb4a51764de8197c9ac3f,0,Lahiru Gunathilake,2012-07-02 16:01:47+00:00,['8733e815bca0883dbf3c98fc4adf74987c7af901'],4,22,26,798814,2,0,0.611111111,1,2611
2bf474423b6976eef34af25012c64369e5fd80e6,0,Lahiru Gunathilake,2012-07-02 19:13:56+00:00,['1a8aa5dfbd0c6915c9fdb4a51764de8197c9ac3f'],0,10,10,798824,1,0,0,1,2611
e9efb3559a972b5fd161636535d24c7f1b906c80,0,Lahiru Gunathilake,2012-07-03 15:31:15+00:00,['2bf474423b6976eef34af25012c64369e5fd80e6'],14,21,35,798859,1,0,0,1,2611
972b0ec1ede14293df6fe445c09215b615ca943d,0,samindaw,2012-07-03 15:59:45+00:00,['e9efb3559a972b5fd161636535d24c7f1b906c80'],51,43,94,798953,8,1,1,0.071428571,2611
fb8fb0b3144370355bf49c651b044ee66b2166e5,0,samindaw,2012-07-03 16:02:19+00:00,['972b0ec1ede14293df6fe445c09215b615ca943d'],3,3,6,798959,1,,,,2611
91d09dcd50b9e68300f7cbb0e7b43929bf1f2be9,0,samindaw,2012-07-03 16:21:01+00:00,['fb8fb0b3144370355bf49c651b044ee66b2166e5'],1,0,1,798960,1,,,,2611
08370c3250cae97d10adfe85ac05201b7d077321,0,Lahiru Gunathilake,2012-07-03 19:27:25+00:00,['91d09dcd50b9e68300f7cbb0e7b43929bf1f2be9'],10,18,28,798988,1,1,1,1,2611
951b134fd253fa1af2e6166258b24a1f481d75b0,0,Lahiru Gunathilake,2012-07-03 20:59:40+00:00,['08370c3250cae97d10adfe85ac05201b7d077321'],28,31,59,799047,1,,,,2611
ce5fcf11302a8a905b4f2722190e9ffd4d7a6d7a,0,Heshan Theekshana Suriyaarachchi,2012-07-05 14:20:54+00:00,['951b134fd253fa1af2e6166258b24a1f481d75b0'],0,12,12,799059,1,0,1,1,2611
2b890cf65df1c41daac388845506a0182d85a9f6,0,Heshan Theekshana Suriyaarachchi,2012-07-05 15:32:16+00:00,['ce5fcf11302a8a905b4f2722190e9ffd4d7a6d7a'],0,2,2,799061,1,,,,2611
148dcc20ca58bc6b9fc7a02828c002c45b097f28,0,Heshan Theekshana Suriyaarachchi,2012-07-05 15:33:28+00:00,['2b890cf65df1c41daac388845506a0182d85a9f6'],21,4,25,799086,1,,,,2611
d856e2eaa7ec0d9c374c4fb87dc537efbf625b4e,0,Heshan Theekshana Suriyaarachchi,2012-07-05 15:34:38+00:00,['148dcc20ca58bc6b9fc7a02828c002c45b097f28'],0,1,1,799087,1,,,,2611
074690d7b6a77a77d7c0348e56ac65dc2df513ba,0,Heshan Theekshana Suriyaarachchi,2012-07-05 15:35:20+00:00,['d856e2eaa7ec0d9c374c4fb87dc537efbf625b4e'],0,2,2,799089,1,,,,2611
3d009057859cf180ee011560b14be8d3b5dfa7bc,0,samindaw,2012-07-05 15:46:26+00:00,['074690d7b6a77a77d7c0348e56ac65dc2df513ba'],6,1388,1394,800483,4,0.37254902,0.552941176,0.960784314,2613
cad899ed79c1588df7ef561b8e2b9090bdb36c10,0,samindaw,2012-07-05 15:49:30+00:00,['3d009057859cf180ee011560b14be8d3b5dfa7bc'],8,10,18,800501,3,1,0,0,2613
6e043a42049463b4bfcdeb84e9861f3f06797fa2,0,Heshan Theekshana Suriyaarachchi,2012-07-05 15:50:33+00:00,['cad899ed79c1588df7ef561b8e2b9090bdb36c10'],0,19,19,800520,1,,,,2613
0a5580e6f7391eabaf60f6db1dd4d45cfd70bec7,0,samindaw,2012-07-05 15:59:32+00:00,['6e043a42049463b4bfcdeb84e9861f3f06797fa2'],12,18,30,800550,3,0,0,0,2613
bd0c85b9e28f3a3df8d7b65057362f0e0239a432,0,samindaw,2012-07-05 16:02:30+00:00,['0a5580e6f7391eabaf60f6db1dd4d45cfd70bec7'],4,17,21,800571,1,0,0,1,2613
5fe51c1caa1983fa1dc617e7f4eaf5d9047eed8e,0,samindaw,2012-07-05 16:11:09+00:00,['bd0c85b9e28f3a3df8d7b65057362f0e0239a432'],5,5,10,800581,4,,,,2613
27ad85156e3c787e120e61d26f168bf39a1cb5ab,0,samindaw,2012-07-05 17:19:12+00:00,['5fe51c1caa1983fa1dc617e7f4eaf5d9047eed8e'],39,79,118,800699,6,0,0.947368421,1,2613
37db75fa80c33ae94a25e0d9839674539761bd22,0,Lahiru Gunathilake,2012-07-05 18:24:00+00:00,['27ad85156e3c787e120e61d26f168bf39a1cb5ab'],94,101,195,800894,1,0,0,1,2613
db13392853589a51a79db26506c107a42744ba2b,0,samindaw,2012-07-05 18:55:05+00:00,['37db75fa80c33ae94a25e0d9839674539761bd22'],16,1024,1040,801934,21,0.947368421,0.947368421,0.88365651,2627
9709e1926df48d14ba8375c27f183c5b845ba2f7,0,Heshan Theekshana Suriyaarachchi,2012-07-05 21:04:06+00:00,['db13392853589a51a79db26506c107a42744ba2b'],1,1,2,801936,1,,,,2627
0f2faecbc6572bc423de955543fef422dd47e695,0,samindaw,2012-07-05 21:12:40+00:00,['9709e1926df48d14ba8375c27f183c5b845ba2f7'],1,2,3,801939,3,,,,2628
69bffcb7409f2390e1be47487e2a678aafcaa444,0,samindaw,2012-07-06 11:06:25+00:00,['0f2faecbc6572bc423de955543fef422dd47e695'],7,21,28,801967,3,1,1,1,2628
b399b2c4eb2c1e7595c31083428baff387bdf2ad,0,samindaw,2012-07-06 12:13:31+00:00,['69bffcb7409f2390e1be47487e2a678aafcaa444'],18,88,106,802073,3,1,1,0.289473684,2628
6a7dbad89aa07acd7102ed0ef29da6773bf14c1d,0,samindaw,2012-07-06 14:23:43+00:00,['b399b2c4eb2c1e7595c31083428baff387bdf2ad'],74,73,147,802220,7,,,,2628
dd09ed9e5f6692e9fb3ba3bda1234493768d2ec7,0,Lahiru Gunathilake,2012-07-06 14:34:49+00:00,['6a7dbad89aa07acd7102ed0ef29da6773bf14c1d'],1,1,2,802222,1,,,,2628
53abdea72b08a9561553fe348b28ea4ee6971ec3,0,samindaw,2012-07-06 16:13:17+00:00,['dd09ed9e5f6692e9fb3ba3bda1234493768d2ec7'],352,44,396,802618,9,0,0,1,2628
1774f74494efe9e08f33a7b3c56b619c37039d95,0,samindaw,2012-07-06 19:50:46+00:00,['53abdea72b08a9561553fe348b28ea4ee6971ec3'],4,133,137,802755,6,1,1,0.873015873,2629
a520c520e42016eb10794371ee1d8cce976d9319,0,samindaw,2012-07-06 19:58:46+00:00,['1774f74494efe9e08f33a7b3c56b619c37039d95'],0,8,8,802763,1,0,0,1,2629
10b0642e0905b7005e8c641dcd4d9c1158566e15,0,samindaw,2012-07-06 20:02:13+00:00,['a520c520e42016eb10794371ee1d8cce976d9319'],1,6,7,802770,1,0,1,1,2629
27ce8a0eb278681f1f76599e712c40536d97b9fe,0,samindaw,2012-07-06 23:39:25+00:00,['10b0642e0905b7005e8c641dcd4d9c1158566e15'],13,59,72,802842,9,1,1,0.272727273,2630
50cb2ff4125616910c3b6603d59c4764d7c27410,0,samindaw,2012-07-07 00:02:50+00:00,['27ce8a0eb278681f1f76599e712c40536d97b9fe'],28,29,57,802899,1,,,,2630
e2d79ecc31a0bd146f1406b36a9065f6f77d754e,0,Heshan Theekshana Suriyaarachchi,2012-07-09 12:43:15+00:00,['50cb2ff4125616910c3b6603d59c4764d7c27410'],0,724,724,803623,8,,,,2638
675d49a9d70e16824c5f18d0126894c78ac4405c,0,Heshan Theekshana Suriyaarachchi,2012-07-09 12:48:41+00:00,['e2d79ecc31a0bd146f1406b36a9065f6f77d754e'],2,3,5,803628,1,,,,2638
2b5a0e1a112150f2b3dc0ce91134eb228e3bd382,0,Heshan Theekshana Suriyaarachchi,2012-07-09 12:54:42+00:00,['675d49a9d70e16824c5f18d0126894c78ac4405c'],98,16,114,803742,1,,,,2638
47bee1b4f2f6a5a5abede12d72d827185e23570f,0,Heshan Theekshana Suriyaarachchi,2012-07-09 13:00:18+00:00,['2b5a0e1a112150f2b3dc0ce91134eb228e3bd382'],512,293,805,804547,1,,,,2638
9a74cfa8d8b2c87b39ab9dc83a5297ce9e20cc08,0,Heshan Theekshana Suriyaarachchi,2012-07-09 13:04:30+00:00,['47bee1b4f2f6a5a5abede12d72d827185e23570f'],1,1,2,804549,3,,,,2639
a24da3c4bd04e8a64b1ad61d84b473a79660692e,0,Heshan Theekshana Suriyaarachchi,2012-07-09 13:05:57+00:00,['9a74cfa8d8b2c87b39ab9dc83a5297ce9e20cc08'],2,2,4,804553,2,,,,2639
988331285d77bb3cec117ef5cfd39e5a4f18958a,0,Heshan Theekshana Suriyaarachchi,2012-07-09 13:36:08+00:00,['a24da3c4bd04e8a64b1ad61d84b473a79660692e'],0,5,5,804558,1,,,,2639
1f9a611ca90d0d615473ab85171e74bd5d144ce0,0,Heshan Theekshana Suriyaarachchi,2012-07-09 13:36:31+00:00,['988331285d77bb3cec117ef5cfd39e5a4f18958a'],0,1,1,804559,1,,,,2639
ca9c592832a625c616955ad0c9fe2946a2ab517b,0,Lahiru Gunathilake,2012-07-09 15:10:19+00:00,['1f9a611ca90d0d615473ab85171e74bd5d144ce0'],1,5,6,804565,1,1,1,1,2639
5427812c3d1c20b614a388af64805e1addb91e9f,0,samindaw,2012-07-09 15:10:38+00:00,['ca9c592832a625c616955ad0c9fe2946a2ab517b'],64,76,140,804705,4,1,1,1,2639
009460dcce21f05158ee961bc213f11473f4a873,0,samindaw,2012-07-09 15:36:16+00:00,['5427812c3d1c20b614a388af64805e1addb91e9f'],19,19,38,804743,2,,,,2639
f76708aa2ded069344d7cee1f4c0fe1d493a867a,0,samindaw,2012-07-09 16:02:28+00:00,['009460dcce21f05158ee961bc213f11473f4a873'],3,3,6,804749,2,,,,2639
26b269ca687b4993acfca7251c188484d80baed4,0,Heshan Theekshana Suriyaarachchi,2012-07-09 18:06:20+00:00,['f76708aa2ded069344d7cee1f4c0fe1d493a867a'],0,19,19,804768,2,1,1,1,2639
a2a200152e228ee7ebf90274a15298493f2cd343,0,samindaw,2012-07-09 22:35:34+00:00,['26b269ca687b4993acfca7251c188484d80baed4'],3,15,18,804786,3,1,1,0,2639
ccc5f0a5769152e8853bea6c7fb905da2d123067,0,samindaw,2012-07-09 23:32:51+00:00,['a2a200152e228ee7ebf90274a15298493f2cd343'],3,208,211,804997,2,0.238938053,0.415929204,0.884955752,2640
9eb7239cc5ea0f213f29a68a9877c9ca0d0292c3,0,Heshan Theekshana Suriyaarachchi,2012-07-10 15:34:39+00:00,['ccc5f0a5769152e8853bea6c7fb905da2d123067'],5,0,5,805002,1,,,,2640
1495d09fd4a0f7e1b2a26f744fc0fdac06d58b3e,0,Lahiru Gunathilake,2012-07-10 15:52:12+00:00,['9eb7239cc5ea0f213f29a68a9877c9ca0d0292c3'],7,10,17,805019,1,0,0,1,2640
94560c8e62a7e017ca41d846c4e1ede8e292b5f7,0,samindaw,2012-07-10 21:58:41+00:00,['1495d09fd4a0f7e1b2a26f744fc0fdac06d58b3e'],29,180,209,805228,1,,,,2640
18f09dfde2efe707b525d1e4c88f3487cd8f0908,0,samindaw,2012-07-11 07:52:11+00:00,['94560c8e62a7e017ca41d846c4e1ede8e292b5f7'],0,350,350,805578,2,1,1,0.862433862,2642
4dd0164dc41cc02b0bf3dcc7e41b8186c1d10d07,0,samindaw,2012-07-11 07:54:12+00:00,['18f09dfde2efe707b525d1e4c88f3487cd8f0908'],1,3,4,805582,1,,,,2642
fa1ee7b75080131f2688944916bdbe299355d32f,0,Suresh Marru,2012-07-11 14:51:32+00:00,['4dd0164dc41cc02b0bf3dcc7e41b8186c1d10d07'],419,0,419,806001,8,,,,2642
c89def0568b2c77ddbdf819e1b3becb8f9eebac2,0,Lahiru Gunathilake,2012-07-11 15:34:02+00:00,['fa1ee7b75080131f2688944916bdbe299355d32f'],5,44,49,806050,4,0,0.9,1,2642
97532f77bbcb8d563feb7181df2ed91b8f01dc86,0,Suresh Marru,2012-07-11 15:42:22+00:00,['c89def0568b2c77ddbdf819e1b3becb8f9eebac2'],1,0,1,806051,1,,,,2642
8aabb5e703b4c11b059430777b2919903338a5dd,0,Heshan Theekshana Suriyaarachchi,2012-07-11 15:50:46+00:00,['97532f77bbcb8d563feb7181df2ed91b8f01dc86'],4,4,8,806059,1,1,0,0,2642
6ce289fd0b7f69470acc093a2599e558efdc122d,0,Suresh Marru,2012-07-11 15:59:47+00:00,['8aabb5e703b4c11b059430777b2919903338a5dd'],5,0,5,806064,1,,,,2642
8ade3fbf34384f58e0bb90208aedb373d1f4b509,0,Lahiru Gunathilake,2012-07-11 16:19:32+00:00,['6ce289fd0b7f69470acc093a2599e558efdc122d'],2,21,23,806087,4,0.8,1,1,2642
81a327e6cdbdcab55927d19d6922dd82ecacd8b2,0,samindaw,2012-07-11 17:53:43+00:00,['8ade3fbf34384f58e0bb90208aedb373d1f4b509'],3,128,131,806218,4,1,1,0.782608696,2643
d0d388f995be727c7cdd8c956b5ecaa4c9ce7990,0,Heshan Theekshana Suriyaarachchi,2012-07-12 01:54:49+00:00,['81a327e6cdbdcab55927d19d6922dd82ecacd8b2'],9,3,12,806230,1,0,1,1,2643
67d64d0aea98067bc36fbd5f639e127ad8081dfe,0,Lahiru Gunathilake,2012-07-12 04:08:03+00:00,['d0d388f995be727c7cdd8c956b5ecaa4c9ce7990'],2,2,4,806234,1,,,,2643
20687dbe1c7f3c261699933b0dfa4c375b707194,0,samindaw,2012-07-12 04:09:42+00:00,['67d64d0aea98067bc36fbd5f639e127ad8081dfe'],5,16,21,806255,4,0.272727273,0.272727273,1,2643
e644c7596f156ba578d38c1cbe61b9c1b53ebb42,0,samindaw,2012-07-12 15:50:42+00:00,['20687dbe1c7f3c261699933b0dfa4c375b707194'],4,11,15,806270,1,0,1,1,2643
27b4a733f2890df35395c619bd4f8f0fea3726b9,0,samindaw,2012-07-12 16:22:30+00:00,['e644c7596f156ba578d38c1cbe61b9c1b53ebb42'],17,28,45,806315,3,0.6,0.6,1,2643
b4e50f8059cad0f6039583c63a9dbc88e5fdb43f,0,Lahiru Gunathilake,2012-07-12 16:31:09+00:00,['27b4a733f2890df35395c619bd4f8f0fea3726b9'],0,4,4,806319,1,0,0,1,2643
f53194f2adf1ff18675ebdda8a635679a52a653a,0,Lahiru Gunathilake,2012-07-12 16:33:12+00:00,['b4e50f8059cad0f6039583c63a9dbc88e5fdb43f'],18,13,31,806350,1,0,0,1,2643
20fc633db22c63cd035c1a3a5b19aae69020b0df,0,samindaw,2012-07-12 19:33:18+00:00,['f53194f2adf1ff18675ebdda8a635679a52a653a'],14,28,42,806392,2,1,1,1,2643
f6b0a68060f38604e8776d89d407c3f1b7459cc6,0,samindaw,2012-07-12 20:09:02+00:00,['20fc633db22c63cd035c1a3a5b19aae69020b0df'],23,139,162,806554,9,0.865384615,1,1,2644
02ed756cd361eeb44ecb15441f38e8243e97cf8c,0,samindaw,2012-07-12 21:13:25+00:00,['f6b0a68060f38604e8776d89d407c3f1b7459cc6'],4,204,208,806762,4,0.329268293,1,0.914634146,2646
423c8843f7eadd8df3cc9881d7d3ac68ac229cc8,0,samindaw,2012-07-12 21:20:15+00:00,['02ed756cd361eeb44ecb15441f38e8243e97cf8c'],1,11,12,806774,1,0,0,0,2646
a25d8ee5425ed6cc0a0ace5d5ef441786ab4b081,0,Heshan Theekshana Suriyaarachchi,2012-07-13 00:57:49+00:00,['423c8843f7eadd8df3cc9881d7d3ac68ac229cc8'],6,6,12,806786,1,,,,2646
f2ddf341eb7e498afebeeefe762baae148944749,0,Heshan Theekshana Suriyaarachchi,2012-07-13 01:00:38+00:00,['a25d8ee5425ed6cc0a0ace5d5ef441786ab4b081'],404,447,851,807637,1,,,,2646
196abf7516793cb1355d7de864bfdf6d5db03290,0,Heshan Theekshana Suriyaarachchi,2012-07-13 01:06:53+00:00,['f2ddf341eb7e498afebeeefe762baae148944749'],7,81,88,807725,1,,,,2646
b2c4084dc93ffb1e9fdaa2c7aba23ac086de3dfb,0,Heshan Theekshana Suriyaarachchi,2012-07-13 01:22:42+00:00,['196abf7516793cb1355d7de864bfdf6d5db03290'],444,412,856,808581,1,,,,2646
0eebb422a4387dca5f1a1a97b61492edee871fbf,0,Heshan Theekshana Suriyaarachchi,2012-07-13 01:51:17+00:00,['b2c4084dc93ffb1e9fdaa2c7aba23ac086de3dfb'],1,1,2,808583,1,0,0,0,2646
8c076edd8985e787c344e696b1620111b004a24c,0,Heshan Theekshana Suriyaarachchi,2012-07-13 12:16:38+00:00,['0eebb422a4387dca5f1a1a97b61492edee871fbf'],34,14,48,808631,1,,,,2646
fb68502b140e586dea61c0d43e9b2f3cd71bcffa,0,Heshan Theekshana Suriyaarachchi,2012-07-13 14:48:42+00:00,['8c076edd8985e787c344e696b1620111b004a24c'],1,1,2,808633,1,,,,2646
1964e89f9b2eccbfc68b3429e4a2cd9cf87293e9,0,Heshan Theekshana Suriyaarachchi,2012-07-13 18:06:09+00:00,['fb68502b140e586dea61c0d43e9b2f3cd71bcffa'],1,1,2,808635,1,,,,2646
1427fac5dd00a61bbc0b488a8e40dbd7ae3db4c1,1,samindaw,2012-07-13 18:39:07+00:00,['1964e89f9b2eccbfc68b3429e4a2cd9cf87293e9'],61,72,133,808768,6,1,1,0,2646
476db37509748efec53a6b104eb1ee59bf153ebe,0,Heshan Theekshana Suriyaarachchi,2012-07-13 19:03:16+00:00,['1427fac5dd00a61bbc0b488a8e40dbd7ae3db4c1'],19,0,19,808787,1,,,,2646
5133190e51c6bbfa7785d18d0541e18f1f3ab88f,0,samindaw,2012-07-13 20:02:51+00:00,['476db37509748efec53a6b104eb1ee59bf153ebe'],8,44,52,808839,4,0.133333333,0.4,0.866666667,2646
2ab9d7532e850bd69912cd6f948b270276755153,0,samindaw,2012-07-13 20:24:42+00:00,['5133190e51c6bbfa7785d18d0541e18f1f3ab88f'],2,2,4,808843,1,,,,2646
fe5ad801e0877c76cbbdf2bdfc35c52865401d3e,0,samindaw,2012-07-16 02:24:32+00:00,['2ab9d7532e850bd69912cd6f948b270276755153'],8,22,30,808873,2,0,0,1,2646
606fb3885b160919002017fc767e3ee722462534,0,samindaw,2012-07-16 03:46:34+00:00,['fe5ad801e0877c76cbbdf2bdfc35c52865401d3e'],3,49,52,808925,5,0.435897436,0.923076923,0.820512821,2646
ac72b1254762fdeb576f22a9e8445cd6fda0add7,0,samindaw,2012-07-16 18:03:47+00:00,['606fb3885b160919002017fc767e3ee722462534'],47,59,106,809031,4,0.428571429,1,1,2646
ce9428070542c50643ccba951a9221f1cb44eacb,0,Raminderjeet Singh,2012-07-23 21:20:07+00:00,['ac72b1254762fdeb576f22a9e8445cd6fda0add7'],7,16,23,809054,4,0.2,0,0,2646
e07fb0fabbb750c81dc4eab3c221a46c195268ea,0,Suresh Marru,2012-07-24 11:27:02+00:00,['ce9428070542c50643ccba951a9221f1cb44eacb'],216,170,386,809440,1,,,,2646
6b73d67803f9335ca69af82b84e424f08ffa6060,0,Suresh Marru,2012-07-24 11:30:42+00:00,['e07fb0fabbb750c81dc4eab3c221a46c195268ea'],0,86,86,809526,1,,,,2646
2f54b15fe70add971e8b4ab796f500c8195a76f3,0,Suresh Marru,2012-07-24 11:40:21+00:00,['6b73d67803f9335ca69af82b84e424f08ffa6060'],1,23,24,809550,3,,,,2646
9f40d36d38d1f70751b9b3c59f12240f44d65286,0,Suresh Marru,2012-07-24 12:01:01+00:00,['2f54b15fe70add971e8b4ab796f500c8195a76f3'],28,28,56,809606,25,,,,2646
4b07284121d894a35262d00cb4575b32ca880544,0,Suresh Marru,2012-07-24 12:01:16+00:00,['9f40d36d38d1f70751b9b3c59f12240f44d65286'],28,28,56,809662,25,,,,2646
00f3ad86b48689de0b4ddb43163a3aabe783d534,0,samindaw,2012-07-25 02:55:58+00:00,['4b07284121d894a35262d00cb4575b32ca880544'],480,701,1181,810843,17,1,1,0.540740741,2647
1038316d28979897a0224d39d42f5d7798c48d2b,0,Heshan Theekshana Suriyaarachchi,2012-07-30 13:28:20+00:00,['00f3ad86b48689de0b4ddb43163a3aabe783d534'],0,7,7,810850,1,,,,2647
639eb51151ce92f644d191d7bffcd261d83ada0a,0,samindaw,2012-07-30 20:13:02+00:00,['1038316d28979897a0224d39d42f5d7798c48d2b'],2,2,4,810854,2,,,,2647
74f822e3e026db3ae606b73304b27e1473a0140c,0,samindaw,2012-07-30 21:10:22+00:00,['639eb51151ce92f644d191d7bffcd261d83ada0a'],2,3,5,810859,2,1,1,1,2647
fb15d096616e2043d0e07d74569cf1292297ce3f,0,samindaw,2012-07-31 02:44:18+00:00,['74f822e3e026db3ae606b73304b27e1473a0140c'],10,13,23,810882,4,0.5,0,1,2647
0be74594fee335b0fb6e6f5088e48758978b9b59,0,Suresh Marru,2012-07-31 13:38:49+00:00,['fb15d096616e2043d0e07d74569cf1292297ce3f'],1,0,1,810883,1,,,,2647
cff42e0eb1cd7605179f8ef87282d29178039480,0,Suresh Marru,2012-07-31 13:50:56+00:00,['0be74594fee335b0fb6e6f5088e48758978b9b59'],158,3,161,811044,3,,,,2647
b4faf138147fab6f9ed5f79d6dc22998eea682a4,0,Heshan Theekshana Suriyaarachchi,2012-07-31 16:27:27+00:00,['cff42e0eb1cd7605179f8ef87282d29178039480'],51,0,51,811095,1,,,,2647
f0ceca70b4aaf35d6a70dc19edb26127ea88d8d4,0,Heshan Theekshana Suriyaarachchi,2012-07-31 16:27:53+00:00,['b4faf138147fab6f9ed5f79d6dc22998eea682a4'],51,0,51,811146,1,,,,2647
0a7cf7646450082fb8a9ab5e678c608cb7f71054,0,Heshan Theekshana Suriyaarachchi,2012-07-31 16:29:11+00:00,['f0ceca70b4aaf35d6a70dc19edb26127ea88d8d4'],41,0,41,811187,1,,,,2647
6a138ca4e79bfeecf4a6c2ec54a391da7bbec79a,0,Heshan Theekshana Suriyaarachchi,2012-08-03 18:01:03+00:00,['0a7cf7646450082fb8a9ab5e678c608cb7f71054'],1,1,2,811189,2,,,,2647
b55a7c7681a775fde7b470f41d2c93e6d2b04308,0,Heshan Theekshana Suriyaarachchi,2012-08-03 18:30:46+00:00,['6a138ca4e79bfeecf4a6c2ec54a391da7bbec79a'],1,1,2,811191,1,,,,2647
97f2a0c19413f96ff6d0f6f99d61468fdc9d441f,0,Heshan Theekshana Suriyaarachchi,2012-08-07 15:01:29+00:00,['b55a7c7681a775fde7b470f41d2c93e6d2b04308'],3,3,6,811197,3,,,,2647
db1df171846fc6592ea940e2b7d255724f83dcdd,0,Heshan Theekshana Suriyaarachchi,2012-08-09 14:47:20+00:00,['97f2a0c19413f96ff6d0f6f99d61468fdc9d441f'],9,0,9,811206,1,,,,2647
698464edd83cbcc273a072b3c60a4d70b9caf5e0,0,Heshan Theekshana Suriyaarachchi,2012-08-10 14:29:23+00:00,['db1df171846fc6592ea940e2b7d255724f83dcdd'],0,124,124,811330,5,,,,2651
15c113db766c7136cc5649c3e774cc660a5bd8b7,0,Heshan Theekshana Suriyaarachchi,2012-08-10 14:33:04+00:00,['698464edd83cbcc273a072b3c60a4d70b9caf5e0'],1,1,2,811332,1,,,,2651
48c69b3ccdec8953aac3d6e4b8ab38cc8781fd4e,0,Lahiru Gunathilake,2012-08-14 13:35:35+00:00,['15c113db766c7136cc5649c3e774cc660a5bd8b7'],1,1,2,811334,1,,,,2651
c42ec8b625a14f9f4f870271f3197f8524626c25,0,Lahiru Gunathilake,2012-08-16 18:53:55+00:00,['48c69b3ccdec8953aac3d6e4b8ab38cc8781fd4e'],21,4,25,811359,2,1,0,0,2651
3f865a862aad81356841f976355d8baac623ce4b,0,Lahiru Gunathilake,2012-08-17 17:43:28+00:00,['c42ec8b625a14f9f4f870271f3197f8524626c25'],2,2,4,811363,1,1,0,0,2651
bbe8f49f98fb4381fb1d63386145ac778eae3020,0,samindaw,2012-08-18 19:26:21+00:00,['3f865a862aad81356841f976355d8baac623ce4b'],1,1,2,811365,1,,,,2651
cbd93eb661631141dd963a7468709ba0f4301546,0,samindaw,2012-08-19 03:10:55+00:00,['bbe8f49f98fb4381fb1d63386145ac778eae3020'],1,3,4,811369,1,,,,2651
2f644f38fd9abf7784e992e92fd396e36255b2ba,0,samindaw,2012-08-21 21:00:13+00:00,['cbd93eb661631141dd963a7468709ba0f4301546'],5,28,33,811402,2,0.315789474,0.526315789,1,2651
f74354dc23bc145c0f4a37c4eea7eefc99c98f97,0,Lahiru Gunathilake,2012-08-24 17:48:32+00:00,['2f644f38fd9abf7784e992e92fd396e36255b2ba'],26,339,365,811767,8,1,1,0.65625,2654
a5d719f1981df0784d853ecd3d15644856be33ac,0,Lahiru Gunathilake,2012-08-24 17:55:54+00:00,['f74354dc23bc145c0f4a37c4eea7eefc99c98f97'],69,270,339,812106,8,1,1,1,2656
11d0d59282218a9f3f2eb12d82af176d00a6258c,0,Lahiru Gunathilake,2012-08-24 18:56:29+00:00,['a5d719f1981df0784d853ecd3d15644856be33ac'],0,559,559,812665,7,0.737288136,1,1,2662
6ccfad905796b3f71dbc1559bc867b17d7587b52,0,Lahiru Gunathilake,2012-08-24 19:40:47+00:00,['11d0d59282218a9f3f2eb12d82af176d00a6258c'],0,416,416,813081,7,1,1,0.787878788,2664
91d5a6729d8dc69c9b458af1b32db7cba9fa435e,0,Lahiru Gunathilake,2012-08-24 19:55:47+00:00,['6ccfad905796b3f71dbc1559bc867b17d7587b52'],0,10,10,813091,1,1,1,1,2664
365a5b3a772ef6f24cd144bfacc159664abb5cd1,0,Lahiru Gunathilake,2012-08-24 20:43:02+00:00,['91d5a6729d8dc69c9b458af1b32db7cba9fa435e'],1,10,11,813102,1,1,1,1,2664
9141a857555e8dd98d825198bda60e7accdc6570,0,Lahiru Gunathilake,2012-08-24 20:45:12+00:00,['365a5b3a772ef6f24cd144bfacc159664abb5cd1'],0,8,8,813110,1,1,1,1,2664
d2a7992d0e2cb23ee446ad17d59d6f60f2ef4e9c,0,Lahiru Gunathilake,2012-08-24 21:04:14+00:00,['9141a857555e8dd98d825198bda60e7accdc6570'],47,92,139,813249,2,1,1,1,2664
ca8ea3efd19afe2b88da25c658ffe40233d75d52,0,Lahiru Gunathilake,2012-08-24 21:05:13+00:00,['d2a7992d0e2cb23ee446ad17d59d6f60f2ef4e9c'],10,10,20,813269,1,,,,2664
e472318fb6f9f74a65d690c31b7026765754f480,0,Lahiru Gunathilake,2012-08-24 21:56:56+00:00,['ca8ea3efd19afe2b88da25c658ffe40233d75d52'],6,122,128,813397,2,0,1,0.755102041,2665
b49c074076377adff28cec60f8d673da8b3f37f5,0,Suresh Marru,2012-08-25 12:07:34+00:00,['e472318fb6f9f74a65d690c31b7026765754f480'],855,0,855,814252,6,0.888429752,0.574380165,0.138429752,2665
1a87bbdea55c12bfac38fced9f5d7a843f071ba2,0,Suresh Marru,2012-08-25 12:12:46+00:00,['b49c074076377adff28cec60f8d673da8b3f37f5'],18,0,18,814270,4,,,,2665
e6270a84f6729ffc14b4662fb10d5738ae8a0cbb,0,Suresh Marru,2012-08-25 14:42:37+00:00,['1a87bbdea55c12bfac38fced9f5d7a843f071ba2'],4,2,6,814276,2,,,,2665
fa01bf23b50908b3ad384abaaa0f3dec5651126e,0,Suresh Marru,2012-08-25 16:24:12+00:00,['e6270a84f6729ffc14b4662fb10d5738ae8a0cbb'],311,2,313,814589,17,0,0,0,2665
5cd03462d6b7326a602842a1eb455d30301fb5df,0,Lahiru Gunathilake,2012-08-27 15:12:52+00:00,['fa01bf23b50908b3ad384abaaa0f3dec5651126e'],11,79,90,814679,3,0,1,1,2665
ed0de59e013562c0fed78206dc52fcd145e4261a,0,Lahiru Gunathilake,2012-08-27 15:24:42+00:00,['5cd03462d6b7326a602842a1eb455d30301fb5df'],0,0,0,814679,1,,,,2665
877e0a42609fb1a4de390a32d7f6d276905e70f7,0,Lahiru Gunathilake,2012-08-27 15:57:12+00:00,['ed0de59e013562c0fed78206dc52fcd145e4261a'],44,3,47,814726,1,1,0,0,2665
ccc82050ccfbb2cc2f8a015bc3892a7006c445de,0,Heshan Theekshana Suriyaarachchi,2012-08-28 02:40:31+00:00,['877e0a42609fb1a4de390a32d7f6d276905e70f7'],1,1792,1793,816519,4,0.387517147,0.665294925,0.816872428,2667
9ffb45055997fd3a2172ed8fb095d9d154472df0,0,Lahiru Gunathilake,2012-08-28 03:49:18+00:00,['ccc82050ccfbb2cc2f8a015bc3892a7006c445de'],7,5,12,816531,1,,,,2667
b225954587fcc119f1234e9264c0d22f19babfb6,0,Suresh Marru,2012-08-29 15:17:29+00:00,['9ffb45055997fd3a2172ed8fb095d9d154472df0'],81,79,160,816691,9,1,0,0.666666667,2667
00d625012ac70be1490d6d457195e643f6856e85,0,Lahiru Gunathilake,2012-08-29 16:02:33+00:00,['b225954587fcc119f1234e9264c0d22f19babfb6'],50,77,127,816818,8,1,1,0,2667
0b30b79a247cdb42053229e560ccdfb36b3e48f2,0,Lahiru Gunathilake,2012-08-29 16:24:22+00:00,['00d625012ac70be1490d6d457195e643f6856e85'],4,6,10,816828,1,1,1,0,2667
a8e09213fd3a451ecfe9de6245adea98b48227fc,0,samindaw,2012-08-29 16:53:46+00:00,['0b30b79a247cdb42053229e560ccdfb36b3e48f2'],1789,23,1812,818640,4,0.610807114,0.33378933,0.180574555,2667
bb17dbe18458b3c62eaf21eb72d7e7190a7393b2,0,samindaw,2012-08-29 16:59:00+00:00,['a8e09213fd3a451ecfe9de6245adea98b48227fc'],3,25,28,818668,6,0.380952381,0.380952381,0.666666667,2667
05d82059d94411f3e95cbd9b825666107155e802,0,Lahiru Gunathilake,2012-08-29 17:50:29+00:00,['bb17dbe18458b3c62eaf21eb72d7e7190a7393b2'],1,16,17,818685,2,0,0,1,2667
da67e061654f6d873157496317373f7f75eb5b39,0,Lahiru Gunathilake,2012-08-29 20:52:57+00:00,['05d82059d94411f3e95cbd9b825666107155e802'],3,15,18,818703,3,0,1,0.444444444,2667
5b1a346824c60f97d91f3ea9a30b7aedf272eec6,0,Lahiru Gunathilake,2012-08-29 20:53:48+00:00,['da67e061654f6d873157496317373f7f75eb5b39'],134,139,273,818976,2,0.666666667,0,0,2667
8f4c04867e4d16449e915cafbb28bd3b44d1209e,0,Lahiru Gunathilake,2012-08-30 18:50:25+00:00,['5b1a346824c60f97d91f3ea9a30b7aedf272eec6'],0,21,21,818997,4,,,,2667
4a73c465c79e9cb2248879283c4480fa11f8db41,0,Lahiru Gunathilake,2012-08-30 21:22:35+00:00,['8f4c04867e4d16449e915cafbb28bd3b44d1209e'],0,5,5,819002,2,,,,2667
8b9527273fd6ebbb3a74f863511b8ba12fe253b4,0,Suresh Marru,2012-09-03 13:28:34+00:00,['4a73c465c79e9cb2248879283c4480fa11f8db41'],0,0,0,819002,4,,,,2667
c8c697b9c79745aa51fe1dc8279bbbb8fb09634e,0,Suresh Marru,2012-09-03 16:34:02+00:00,['8b9527273fd6ebbb3a74f863511b8ba12fe253b4'],0,16,16,819018,1,,,,2667
1307e5013d00f5bbc9697702a4d6c55f6a8de78b,0,Suresh Marru,2012-09-04 02:05:10+00:00,['c8c697b9c79745aa51fe1dc8279bbbb8fb09634e'],0,21,21,819039,1,,,,2667
cdca9e35dc31bd81fc25fdc00dc9e73e0ec6539a,0,Raminderjeet Singh,2012-09-04 18:56:41+00:00,['1307e5013d00f5bbc9697702a4d6c55f6a8de78b'],1,1,2,819041,1,,,,2667
da55f920d7bcc1110247cf20b7538a0cd5dc26bd,0,Lahiru Gunathilake,2012-09-04 19:34:47+00:00,['cdca9e35dc31bd81fc25fdc00dc9e73e0ec6539a'],1,1,2,819043,1,,,,2667
e8631f61a6424e4ccca407f6c7a1e8fb267f5e85,0,Lahiru Gunathilake,2012-09-04 20:29:12+00:00,['da55f920d7bcc1110247cf20b7538a0cd5dc26bd'],11,14,25,819068,1,1,1,1,2667
5a5c5884c1d6489f7130babb06d11365a76aff73,0,samindaw,2012-09-04 20:31:10+00:00,['e8631f61a6424e4ccca407f6c7a1e8fb267f5e85'],0,444,444,819512,10,1,1,1,2677
4c76dadce80b6632ea3ab93d65c76f8eaae1e33c,1,samindaw,2012-09-05 05:04:20+00:00,['5a5c5884c1d6489f7130babb06d11365a76aff73'],0,115,115,819627,2,,,,2679
e4703abb4bf022014eea26fffd198896568804e6,0,samindaw,2012-09-05 06:07:46+00:00,['4c76dadce80b6632ea3ab93d65c76f8eaae1e33c'],4,350,354,819981,10,0.556818182,0.556818182,1,2686
11b5fd8f859b66348f64a24bea1190174eb07eb3,0,samindaw,2012-09-05 13:59:21+00:00,['e4703abb4bf022014eea26fffd198896568804e6'],2,132,134,820115,4,1,1,1,2688
c2ca0c54192a0a0caa150ae02e8f1f8e6f44ba37,0,samindaw,2012-09-05 17:26:34+00:00,['11b5fd8f859b66348f64a24bea1190174eb07eb3'],8,6,14,820129,3,,,,2688
620f247ceabeeeac7697dd10534bfc3773dc25d3,0,Lahiru Gunathilake,2012-09-05 19:05:52+00:00,['c2ca0c54192a0a0caa150ae02e8f1f8e6f44ba37'],4,9,13,820142,1,1,1,1,2688
5f40172773a4b8b429fb5c4e405670e4962e573f,1,Lahiru Gunathilake,2012-09-05 19:49:15+00:00,['620f247ceabeeeac7697dd10534bfc3773dc25d3'],1,2658,2659,822801,30,0.649262899,0.780712531,0.981572482,2716
c2d9ad970cd96aeba044db4c6416705c4ffa0c31,0,Lahiru Gunathilake,2012-09-05 19:49:59+00:00,['5f40172773a4b8b429fb5c4e405670e4962e573f'],288,0,288,823089,1,0,0,0.124223602,2716
82f284d5b60db817bb925ddad593cf3f79d2a65b,0,Lahiru Gunathilake,2012-09-05 20:52:05+00:00,['c2d9ad970cd96aeba044db4c6416705c4ffa0c31'],386,294,680,823769,2,1,0,0.298507463,2717
a153d35ad9c31aafa48a3edb9612068777461d4b,0,Lahiru Gunathilake,2012-09-06 05:45:09+00:00,['82f284d5b60db817bb925ddad593cf3f79d2a65b'],0,386,386,824155,1,0.684931507,1,0.817351598,2718
63cdbf4620e4832a03de474bfd4cd5fe87b6b165,0,Lahiru Gunathilake,2012-09-06 06:17:16+00:00,['a153d35ad9c31aafa48a3edb9612068777461d4b'],3,63,66,824221,1,1,1,0.625,2718
daee0c2aab955b89496ebca3724c33f1c9209e5a,1,Lahiru Gunathilake,2012-09-06 17:34:25+00:00,['63cdbf4620e4832a03de474bfd4cd5fe87b6b165'],444,1102,1546,825767,44,1,1,1,2726
5e5420a85d9ace3fd8ba53cd415a8aa47b7047c2,0,Lahiru Gunathilake,2012-09-06 19:29:29+00:00,['daee0c2aab955b89496ebca3724c33f1c9209e5a'],25,91,116,825883,3,0.666666667,1,0.823529412,2726
3afd5fb2ad42442e0e43b77197e089bc73cd6c2f,0,Lahiru Gunathilake,2012-09-06 20:38:27+00:00,['5e5420a85d9ace3fd8ba53cd415a8aa47b7047c2'],13,53,66,825949,2,1,1,1,2726
dfc7ff9d96aa3b8755ebcc66c19fe464ee8501e4,1,Lahiru Gunathilake,2012-09-06 21:23:58+00:00,['3afd5fb2ad42442e0e43b77197e089bc73cd6c2f'],349,391,740,826689,21,0,1,1,2726
90454eaba95a06a12c8826924978add5ed7ca64c,0,Lahiru Gunathilake,2012-09-06 21:25:02+00:00,['dfc7ff9d96aa3b8755ebcc66c19fe464ee8501e4'],6,45,51,826740,2,1,1,0.794871795,2726
8cb84c4a0464377ff23a01ad3583a83f78a47a3c,0,Lahiru Gunathilake,2012-09-07 15:41:37+00:00,['90454eaba95a06a12c8826924978add5ed7ca64c'],5,15,20,826760,2,1,1,1,2726
1d953aa26e733eb7a2a4c1a9d1c29c08ee5a5400,1,samindaw,2012-09-07 19:48:52+00:00,['8cb84c4a0464377ff23a01ad3583a83f78a47a3c'],297,1060,1357,828117,26,0.668997669,0.96969697,0.911421911,2727
e5fdaa7dcb92251318273f963a8215dad9a95843,0,samindaw,2012-09-07 19:56:09+00:00,['1d953aa26e733eb7a2a4c1a9d1c29c08ee5a5400'],9,28,37,828154,2,1,1,1,2727
69125009d4e62eb806ef3e2934657f26804b9604,0,samindaw,2012-09-07 20:16:47+00:00,['e5fdaa7dcb92251318273f963a8215dad9a95843'],0,2,2,828156,1,,,,2727
4b52803b1dd7183e11572fc2f8053297360f90df,0,samindaw,2012-09-07 20:27:31+00:00,['69125009d4e62eb806ef3e2934657f26804b9604'],8,11,19,828175,3,1,1,1,2727
7e0b88fee3fd2fdb40b4eaac2f3c6ba95e0cbfce,1,Lahiru Gunathilake,2012-09-07 20:51:27+00:00,['4b52803b1dd7183e11572fc2f8053297360f90df'],28,51,79,828254,1,1,1,0,2727
afda31110c1f4510706db2b90d6075eec54aff1e,0,Lahiru Gunathilake,2012-09-07 20:53:09+00:00,['7e0b88fee3fd2fdb40b4eaac2f3c6ba95e0cbfce'],434,385,819,829073,15,1,1,0.01754386,2727
149caba7793fb585ae1797621b2de41fa4297f21,0,Lahiru Gunathilake,2012-09-07 21:08:55+00:00,['afda31110c1f4510706db2b90d6075eec54aff1e'],5,81,86,829159,9,0.038461538,0.365384615,1,2727
8114d5ce047f63278e4b97a163c61db0a49731b5,1,samindaw,2012-09-08 15:02:48+00:00,['149caba7793fb585ae1797621b2de41fa4297f21'],360,838,1198,830357,18,0.902877698,1,0.928057554,2732
5551943ca1d92251b032e9b9169130903a6f2c8e,1,samindaw,2012-09-08 18:40:10+00:00,['8114d5ce047f63278e4b97a163c61db0a49731b5'],249,624,873,831230,22,0.645038168,0.751908397,1,2734
e6334e132a5af7b4ddceaaf3a24aced3c9a2b828,0,samindaw,2012-09-08 18:51:20+00:00,['5551943ca1d92251b032e9b9169130903a6f2c8e'],620,437,1057,832287,13,0.593220339,0.283898305,0.13559322,2740
4c8a208f99c7c7f88e11cff975dcef6cfc31006c,1,samindaw,2012-09-08 20:43:18+00:00,['e6334e132a5af7b4ddceaaf3a24aced3c9a2b828'],11,112,123,832410,2,0.489795918,1,1,2741
a4dae53e96ea483bbb9b1c7d1f151df3c499859c,1,Lahiru Gunathilake,2012-09-09 20:14:45+00:00,['4c8a208f99c7c7f88e11cff975dcef6cfc31006c'],666,829,1495,833905,17,0.945205479,0,1,2742
ee3797d7837912569fb31112fded47e3b932fa12,0,Lahiru Gunathilake,2012-09-09 22:15:51+00:00,['a4dae53e96ea483bbb9b1c7d1f151df3c499859c'],3,0,3,833908,1,,,,2742
6fcd14eabf7de22951aa3d2b7f9b3770c5f3b2b9,0,Lahiru Gunathilake,2012-09-09 23:16:22+00:00,['ee3797d7837912569fb31112fded47e3b932fa12'],14,45,59,833967,2,0,1,1,2742
982981dab58384a0ebf8ee826cd91d14b9fad1bc,0,Lahiru Gunathilake,2012-09-09 23:16:51+00:00,['6fcd14eabf7de22951aa3d2b7f9b3770c5f3b2b9'],0,6,6,833973,1,,,,2742
9e670006c91000c4f9fed02420fa8373a0c56ea9,0,Lahiru Gunathilake,2012-09-09 23:18:00+00:00,['982981dab58384a0ebf8ee826cd91d14b9fad1bc'],0,1,1,833974,1,,,,2742
a7016a438d7b2e035d4ffc192b186c6789bf6be6,0,Lahiru Gunathilake,2012-09-09 23:22:32+00:00,['9e670006c91000c4f9fed02420fa8373a0c56ea9'],512,62,574,834548,8,0.082474227,0,0.195876289,2742
1789806c3ed0e25eb1ef3f97d3492e075da3413a,1,samindaw,2012-09-10 06:32:08+00:00,['a7016a438d7b2e035d4ffc192b186c6789bf6be6'],577,1034,1611,836159,69,0.848484848,0,0.898989899,2743
1546e247dcb30e4a395a09000fb19cb6f8212e29,0,samindaw,2012-09-10 07:20:19+00:00,['1789806c3ed0e25eb1ef3f97d3492e075da3413a'],119,125,244,836403,10,1,0,0,2743
35105f3fd2ddce143ecaf06a42c53285d2f24c9c,0,Raminderjeet Singh,2012-09-10 13:41:47+00:00,['1546e247dcb30e4a395a09000fb19cb6f8212e29'],288,298,586,836989,1,0,0,0,2743
3546625f9586e388173116cc67e77a7a23106dee,0,Raminderjeet Singh,2012-09-10 13:46:25+00:00,['35105f3fd2ddce143ecaf06a42c53285d2f24c9c'],3,26,29,837018,2,0.666666667,0.666666667,1,2743
1512e3d988df9a4addf777216551eae0f3a1db9d,0,Raminderjeet Singh,2012-09-10 14:08:53+00:00,['3546625f9586e388173116cc67e77a7a23106dee'],2,2,4,837022,1,,,,2743
2f5ab5bf510d8443749a43d17a8e94badb8fbe2e,1,Lahiru Gunathilake,2012-09-10 15:25:15+00:00,['1512e3d988df9a4addf777216551eae0f3a1db9d'],253,1171,1424,838446,14,0,0.25,0.95,2743
81e87f721827a95db4704c82e340be057c56b1e4,0,Lahiru Gunathilake,2012-09-10 15:33:49+00:00,['2f5ab5bf510d8443749a43d17a8e94badb8fbe2e'],0,131,131,838577,2,0.558823529,0.558823529,0.838235294,2744
0e5dfb8023c8436024b5169cc11c87a89a2ac6d5,0,Lahiru Gunathilake,2012-09-10 15:34:57+00:00,['81e87f721827a95db4704c82e340be057c56b1e4'],27,27,54,838631,5,1,1,0,2744
a6f0da1e33e542cb509e2fc2efc364c760fad384,0,Lahiru Gunathilake,2012-09-10 15:48:26+00:00,['0e5dfb8023c8436024b5169cc11c87a89a2ac6d5'],59,59,118,838749,2,1,0,0,2744
f5b4122306e3500154b4aaa68d6e7de195891b8c,0,Lahiru Gunathilake,2012-09-10 16:18:08+00:00,['a6f0da1e33e542cb509e2fc2efc364c760fad384'],120,102,222,838971,2,1,1,0,2744
881db198cef6d5d0339ee56350c934a438c51a10,0,Lahiru Gunathilake,2012-09-10 16:28:56+00:00,['f5b4122306e3500154b4aaa68d6e7de195891b8c'],59,80,139,839110,6,1,1,1,2744
bfcf59fd05505e2b1353b554c3b5a7f4cce59d06,0,Lahiru Gunathilake,2012-09-10 17:24:06+00:00,['881db198cef6d5d0339ee56350c934a438c51a10'],31,125,156,839266,7,0.044444444,0.066666667,1,2744
d73678582ff3a9ebca350df0ec675140c4d2d855,0,Lahiru Gunathilake,2012-09-10 19:20:58+00:00,['bfcf59fd05505e2b1353b554c3b5a7f4cce59d06'],1,13,14,839280,2,,,,2744
ca2ae5945501435b5e198795dfb743637fc7fe29,0,Lahiru Gunathilake,2012-09-10 19:24:30+00:00,['d73678582ff3a9ebca350df0ec675140c4d2d855'],140,140,280,839560,1,1,0,0,2744
d64cbecf973b66a73c7a43a167435036f3c624dd,0,Lahiru Gunathilake,2012-09-10 21:32:46+00:00,['ca2ae5945501435b5e198795dfb743637fc7fe29'],12,12,24,839584,2,1,0,0,2744
67fc20f7460bbfb6e76e260cf9ba60a1e3ac81b1,1,Lahiru Gunathilake,2012-09-10 21:38:41+00:00,['d64cbecf973b66a73c7a43a167435036f3c624dd'],21,32,53,839637,6,0,0,1,2744
81fce1d27bb9d6c8c51d1b133ba36284c0f5c5b6,0,Lahiru Gunathilake,2012-09-10 22:31:08+00:00,['67fc20f7460bbfb6e76e260cf9ba60a1e3ac81b1'],0,1081,1081,840718,6,0.434137291,0.714285714,0.890538033,2750
9f377d1b78a4e28a064cbf118571844032d3ac81,1,Lahiru Gunathilake,2012-09-11 12:46:58+00:00,['81fce1d27bb9d6c8c51d1b133ba36284c0f5c5b6'],4,4,8,840726,2,1,1,1,2750
53c78123de5f74062e18ed9f789517a682e287b0,0,Lahiru Gunathilake,2012-09-11 16:35:48+00:00,['9f377d1b78a4e28a064cbf118571844032d3ac81'],51,88,139,840865,8,1,1,0,2750
a354c81810135dfd1fd30c794f59e6df107aabf0,0,Lahiru Gunathilake,2012-09-11 17:22:50+00:00,['53c78123de5f74062e18ed9f789517a682e287b0'],40,107,147,841012,12,0.407407407,1,1,2751
23b70a91c4047a837bf7e4a622033df57f20b130,0,Lahiru Gunathilake,2012-09-11 19:18:11+00:00,['a354c81810135dfd1fd30c794f59e6df107aabf0'],13,183,196,841208,12,0.181818182,1,1,2752
88a33daa715e18147674755848c7c479f70d1f83,0,Lahiru Gunathilake,2012-09-11 19:23:08+00:00,['23b70a91c4047a837bf7e4a622033df57f20b130'],1,0,1,841209,1,,,,2752
06e93469bf6651be0d76dac0f05f9b2dbe3f03fb,0,Lahiru Gunathilake,2012-09-11 21:21:56+00:00,['88a33daa715e18147674755848c7c479f70d1f83'],0,3,3,841212,1,0,1,1,2752
3ccc5bc65745afa3d10af5017903dfd0d9eeb873,0,Lahiru Gunathilake,2012-09-11 21:22:23+00:00,['06e93469bf6651be0d76dac0f05f9b2dbe3f03fb'],3,5,8,841220,1,,,,2752
59ff284b9e3430ec1decbd01507dc35fa48531e8,0,samindaw,2012-09-12 14:32:55+00:00,['3ccc5bc65745afa3d10af5017903dfd0d9eeb873'],14,21,35,841255,7,1,0,0,2752
b5e697f69a8c004d100fe76445a9b4bc10aa98a1,1,Lahiru Gunathilake,2012-09-12 14:43:20+00:00,['59ff284b9e3430ec1decbd01507dc35fa48531e8'],59,111,170,841425,5,1,1,1,2752
7c58cd601495e21ea7281f92646fccb7b7096ed0,0,Lahiru Gunathilake,2012-09-12 21:17:11+00:00,['b5e697f69a8c004d100fe76445a9b4bc10aa98a1'],0,87,87,841512,1,,,,2753
31a748d8cf542f0e102b73af1b3c7972d0aed86c,0,Lahiru Gunathilake,2012-09-12 21:24:24+00:00,['7c58cd601495e21ea7281f92646fccb7b7096ed0'],0,24,24,841536,2,0,1,1,2753
024af90463d9027ab29968a80af7296302b6e213,0,Lahiru Gunathilake,2012-09-12 21:25:38+00:00,['31a748d8cf542f0e102b73af1b3c7972d0aed86c'],0,5,5,841541,1,0,0,1,2753
963e44e4e1255e756ca13c29dc5f2c52b4c74dd6,0,Lahiru Gunathilake,2012-09-12 21:26:26+00:00,['024af90463d9027ab29968a80af7296302b6e213'],0,144,144,841685,1,,,,2754
e497ea98082ee41ec63e2e9c6098844307b3b8ac,1,Lahiru Gunathilake,2012-09-12 21:52:49+00:00,['963e44e4e1255e756ca13c29dc5f2c52b4c74dd6'],142,321,463,842148,17,0,0.666666667,1,2754
7232202e254631dd39457c6f3329347cfbc7b939,1,Lahiru Gunathilake,2012-09-13 13:43:47+00:00,['e497ea98082ee41ec63e2e9c6098844307b3b8ac'],348,550,898,843046,30,0.190789474,1,0.960526316,2761
71f52bcbd8e1e6dd9738d8befaff10742880c7c2,1,Lahiru Gunathilake,2012-09-13 14:52:41+00:00,['7232202e254631dd39457c6f3329347cfbc7b939'],68,20,88,843134,1,1,1,0,2761
58d31ee4eac6196fded6b3e59f6eb4a466bfa5b0,0,Lahiru Gunathilake,2012-09-13 16:26:10+00:00,['71f52bcbd8e1e6dd9738d8befaff10742880c7c2'],4,8,12,843146,1,0,0,1,2761
697060449573722dac41b8c4c9f5a7b426ba975c,0,Lahiru Gunathilake,2012-09-13 18:10:40+00:00,['58d31ee4eac6196fded6b3e59f6eb4a466bfa5b0'],3,3,6,843152,1,,,,2761
8490bd719eec5f36c6fc5ce0a1596ec129378c9b,0,Lahiru Gunathilake,2012-09-13 19:01:56+00:00,['697060449573722dac41b8c4c9f5a7b426ba975c'],3,10,13,843165,4,0.571428571,1,0.714285714,2761
4e7be3b070aa86055491822feda53a0b01b48505,0,Lahiru Gunathilake,2012-09-13 19:44:13+00:00,['8490bd719eec5f36c6fc5ce0a1596ec129378c9b'],9,29,38,843203,9,0,1,1,2761
c1312c179767c98664d3a2ce6166d8e367ba0826,0,Lahiru Gunathilake,2012-09-13 20:18:47+00:00,['4e7be3b070aa86055491822feda53a0b01b48505'],4,14,18,843221,2,1,1,1,2761
bc26f36265503420a5f1861778f6e9283ae58b47,0,Lahiru Gunathilake,2012-09-13 20:46:08+00:00,['c1312c179767c98664d3a2ce6166d8e367ba0826'],42,21,63,843284,7,0,0,0,2761
6c5ab97aeab078637c53f7e976d3a87c224475b0,0,Lahiru Gunathilake,2012-09-13 21:24:31+00:00,['bc26f36265503420a5f1861778f6e9283ae58b47'],2,55,57,843341,1,0,0.08,1,2761
084d395c9f1dc302fbad841bbed072abac650a2d,0,Lahiru Gunathilake,2012-09-13 21:24:45+00:00,['6c5ab97aeab078637c53f7e976d3a87c224475b0'],2,6,8,843349,2,1,1,0,2761
06abd812690e25b049943ea226414aac9af5c9c4,0,Lahiru Gunathilake,2012-09-14 13:39:14+00:00,['084d395c9f1dc302fbad841bbed072abac650a2d'],31,103,134,843483,6,0,1,0,2761
7b3df03b95aab7cc8294b1295bf7439d09f89fd4,0,Lahiru Gunathilake,2012-09-14 16:20:27+00:00,['06abd812690e25b049943ea226414aac9af5c9c4'],1,1,2,843485,1,,,,2761
42938f242eaf2eb4f6763dcaaa3d672eafa92b72,0,Lahiru Gunathilake,2012-09-14 19:47:00+00:00,['7b3df03b95aab7cc8294b1295bf7439d09f89fd4'],11,11,22,843507,2,,,,2761
cc5d0c70b2310a78bc29c4de0aa84cde546f191c,0,Lahiru Gunathilake,2012-09-14 20:52:30+00:00,['42938f242eaf2eb4f6763dcaaa3d672eafa92b72'],8,9,17,843524,1,0,0,0,2761
abb2032895845e51344c54f9779e1c57ee512083,0,Lahiru Gunathilake,2012-09-14 21:42:11+00:00,['cc5d0c70b2310a78bc29c4de0aa84cde546f191c'],170,88,258,843782,12,0.638888889,0,1,2761
be34e25f5995e274565e0e8a56c5f4de61606b4c,0,Lahiru Gunathilake,2012-09-17 14:28:50+00:00,['abb2032895845e51344c54f9779e1c57ee512083'],4,8,12,843794,4,,,,2761
0ed4e0179fea364e4dc2a3623d5090521d7e0f4b,0,Lahiru Gunathilake,2012-09-17 15:13:21+00:00,['be34e25f5995e274565e0e8a56c5f4de61606b4c'],31,13,44,843838,2,,,,2761
cd4f7c6dbc3a2cd16251a87e068afde1ba449790,0,Lahiru Gunathilake,2012-09-17 15:41:00+00:00,['0ed4e0179fea364e4dc2a3623d5090521d7e0f4b'],6,6,12,843850,2,1,1,0,2761
7393d65d103023cb3c6c5df47f2484e7f4feea9c,0,samindaw,2012-09-17 18:42:12+00:00,['cd4f7c6dbc3a2cd16251a87e068afde1ba449790'],0,73,73,843923,1,,,,2762
e485fcf95141aba24e72752f25450672ee8c1629,0,Lahiru Gunathilake,2012-09-17 20:05:12+00:00,['7393d65d103023cb3c6c5df47f2484e7f4feea9c'],42,64,106,844029,4,0.047619048,1,1,2762
b97361c8d1bea8ede2ed2d7841907dff9c86a290,1,Lahiru Gunathilake,2012-09-18 03:30:52+00:00,['e485fcf95141aba24e72752f25450672ee8c1629'],122,1143,1265,845294,22,0.475513428,0.816745656,1,2770
2a1b8a0fe73af06a1b10361259a8fb7facbee14e,0,samindaw,2012-09-18 16:47:51+00:00,['b97361c8d1bea8ede2ed2d7841907dff9c86a290'],253,259,512,845806,22,1,1,0.96875,2770
d4ea612742a3a25e2f2768e8576fa7164f520bd8,0,samindaw,2012-09-18 16:49:27+00:00,['2a1b8a0fe73af06a1b10361259a8fb7facbee14e'],0,66,66,845872,1,,,,2771
de3aefb8d0201cd3a55aa5853d624ba8dc1c50ce,0,Lahiru Gunathilake,2012-09-18 21:08:20+00:00,['d4ea612742a3a25e2f2768e8576fa7164f520bd8'],0,6,6,845878,1,0,1,1,2771
334e4201bd8782c086fac752b8a1814cfd03fd00,0,Lahiru Gunathilake,2012-09-19 14:06:50+00:00,['de3aefb8d0201cd3a55aa5853d624ba8dc1c50ce'],0,3,3,845881,3,0,1,1,2771
d9181c2b3fc10ed4246d0ccb3cfae5de845ed7bb,1,samindaw,2012-09-19 14:33:41+00:00,['334e4201bd8782c086fac752b8a1814cfd03fd00'],494,851,1345,847226,25,0.987068966,1,1,2774
bfc169db4033608e976eb1961a0e27fbdc0ecd13,0,Lahiru Gunathilake,2012-09-19 14:57:51+00:00,['d9181c2b3fc10ed4246d0ccb3cfae5de845ed7bb'],1,1,2,847228,1,1,1,0,2774
02b833858c2634e79a41b16ce0bfe6cec015f7e1,0,Lahiru Gunathilake,2012-09-19 17:25:47+00:00,['bfc169db4033608e976eb1961a0e27fbdc0ecd13'],40,153,193,847421,14,0,1,1,2774
b876a8207c8cd2548512556f0e93e720befefb32,0,Lahiru Gunathilake,2012-09-19 17:41:48+00:00,['02b833858c2634e79a41b16ce0bfe6cec015f7e1'],5,1,6,847427,1,0,0,0,2774
6bee1465968fb7ad51c0e23cc02899e3b214a1c2,0,Lahiru Gunathilake,2012-09-19 18:53:14+00:00,['b876a8207c8cd2548512556f0e93e720befefb32'],0,3,3,847430,1,,,,2774
06ff6ead9165acfb27b97e78e1bb5418d25d7240,0,Lahiru Gunathilake,2012-09-19 21:19:42+00:00,['6bee1465968fb7ad51c0e23cc02899e3b214a1c2'],9,12,21,847451,5,,,,2774
227c40f43772b0a6f55e1a4c513535315b7023ec,0,Tony Stevenson,2012-09-20 08:26:28+00:00,['06ff6ead9165acfb27b97e78e1bb5418d25d7240'],0,0,0,847451,0,,,,2774
039f1671d220b2a955567be38357ad04b5af5c41,0,Suresh Marru,2012-09-20 15:40:38+00:00,['227c40f43772b0a6f55e1a4c513535315b7023ec'],4,4,8,847459,1,,,,2774
ef5c2f142f4aab448d4e3f47ed782b598f7d2304,0,samindaw,2012-09-20 16:12:33+00:00,['039f1671d220b2a955567be38357ad04b5af5c41'],30,39,69,847528,1,0,0,0,2774
2940b0a7ab9e58e1e65b914a816697aed5e1a2f8,0,samindaw,2012-09-20 17:30:35+00:00,['ef5c2f142f4aab448d4e3f47ed782b598f7d2304'],279,369,648,848176,15,0.5625,1,1,2775
be727699b35c71fa877a652c4759a4753b819210,0,Lahiru Gunathilake,2012-09-20 17:46:37+00:00,['2940b0a7ab9e58e1e65b914a816697aed5e1a2f8'],107,338,445,848621,27,0.315789474,1,1,2777
49727d3487f0e401f054d7e5735041ddde3cbb7e,1,Lahiru Gunathilake,2012-09-21 14:51:23+00:00,['be727699b35c71fa877a652c4759a4753b819210'],57,35,92,848713,7,0.181818182,0,0,2777
1bdefd77f1460e54e0c8e939c8f750867f6defb3,0,Lahiru Gunathilake,2012-09-21 16:06:25+00:00,['49727d3487f0e401f054d7e5735041ddde3cbb7e'],2,2,4,848717,1,,,,2777
44a671f07ffd68530e63bab57a6349fae56bc737,0,Lahiru Gunathilake,2012-09-21 16:25:24+00:00,['1bdefd77f1460e54e0c8e939c8f750867f6defb3'],15,48,63,848780,8,0,1,1,2777
9efd2764ff7d89f43a757bf7691856acb19e2f55,0,samindaw,2012-09-21 17:07:07+00:00,['44a671f07ffd68530e63bab57a6349fae56bc737'],63,135,198,848978,8,0.639344262,1,0.950819672,2777
15b299153d899dd06c87b95a8e835d49390d7cc2,0,samindaw,2012-09-21 17:13:17+00:00,['9efd2764ff7d89f43a757bf7691856acb19e2f55'],1,1,2,848980,1,0,0,1,2777
7226ed07ad36464ee254ad430740692cca3174e8,0,Lahiru Gunathilake,2012-09-21 17:20:28+00:00,['15b299153d899dd06c87b95a8e835d49390d7cc2'],7,8,15,848995,1,0,1,1,2777
d301be9c3076475d83727bbc9dd4417fc618f792,0,samindaw,2012-09-21 18:09:56+00:00,['7226ed07ad36464ee254ad430740692cca3174e8'],62,118,180,849175,4,1,0,0,2777
d5586775d9ab8128fc0218844a9a97f0e7cd3d3b,0,samindaw,2012-09-21 18:27:03+00:00,['d301be9c3076475d83727bbc9dd4417fc618f792'],4,4,8,849183,2,,,,2777
6f9e285162f69662075d2cb2ee988a4aa577aadc,0,samindaw,2012-09-21 19:20:26+00:00,['d5586775d9ab8128fc0218844a9a97f0e7cd3d3b'],5,5,10,849193,1,,,,2777
5e8797f4f24ea72924fa268ff2b6eb3d2ef9ca9e,0,samindaw,2012-09-21 19:23:38+00:00,['6f9e285162f69662075d2cb2ee988a4aa577aadc'],1,7,8,849201,1,1,1,1,2777
6ccfec719fd92fa25c2c679352eb663bc574d04f,0,Lahiru Gunathilake,2012-09-21 19:31:31+00:00,['5e8797f4f24ea72924fa268ff2b6eb3d2ef9ca9e'],1,1,2,849203,1,,,,2777
eaa5b9fc359dbc1d6db11b28dbd90352b40e24d1,0,samindaw,2012-09-21 19:45:30+00:00,['6ccfec719fd92fa25c2c679352eb663bc574d04f'],28,76,104,849307,4,1,1,0,2778
95632cb4a8fb096c095f6deb1cdf3ed008d0fd8d,0,Lahiru Gunathilake,2012-09-21 20:08:01+00:00,['eaa5b9fc359dbc1d6db11b28dbd90352b40e24d1'],1,1,2,849309,1,,,,2778
25c11444207820d3c500672ad16c5c59b8805f5c,0,samindaw,2012-09-21 20:30:53+00:00,['95632cb4a8fb096c095f6deb1cdf3ed008d0fd8d'],4,5,9,849318,4,1,1,0,2778
7593d348ff6494851e128ba7eabcc6143176fd5b,0,Lahiru Gunathilake,2012-09-21 22:04:07+00:00,['25c11444207820d3c500672ad16c5c59b8805f5c'],1,1,2,849320,1,,,,2778
245d0e57978849f1a0e96e1f15561022433a76d3,1,Suresh Marru,2012-09-22 19:00:05+00:00,['7593d348ff6494851e128ba7eabcc6143176fd5b'],227,183,410,849730,37,,,,2778
c965a82dd9b39db116fa24f6e7b2614c79976df9,0,Suresh Marru,2012-09-22 19:26:42+00:00,['245d0e57978849f1a0e96e1f15561022433a76d3'],122,122,244,849974,1,1,0,0,2778
5302246f3917906e176ee9e5274600451f62e827,0,samindaw,2012-09-24 13:42:49+00:00,['c965a82dd9b39db116fa24f6e7b2614c79976df9'],17,33,50,850024,4,0,1,1,2778
459a642f65e0e471b22f5d4f8a5a6daff31150dc,0,Lahiru Gunathilake,2012-09-24 13:50:12+00:00,['5302246f3917906e176ee9e5274600451f62e827'],2,0,2,850026,1,1,1,0,2778
b445d4e50eda7990b28480473daca0e03b63c796,0,Lahiru Gunathilake,2012-09-24 15:33:39+00:00,['459a642f65e0e471b22f5d4f8a5a6daff31150dc'],1,3,4,850030,1,0,0,1,2778
26af8daef90c3f123567da2e417cf8b830340574,0,samindaw,2012-09-24 16:14:58+00:00,['b445d4e50eda7990b28480473daca0e03b63c796'],208,233,441,850471,14,1,1,1,2779
26542512d5f048c382e78a9ad705c4ca37c5ecc4,0,samindaw,2012-09-24 23:21:49+00:00,['26af8daef90c3f123567da2e417cf8b830340574'],3,3,6,850477,1,,,,2779
cab7fafc0d58f6f2187cc20ae8df393f47636047,0,samindaw,2012-09-25 02:40:06+00:00,['26542512d5f048c382e78a9ad705c4ca37c5ecc4'],6,8,14,850491,2,1,1,1,2779
ffa1c0c446cbf7732d6c0bec9d58e50a4520ffa6,0,samindaw,2012-09-25 02:40:32+00:00,['cab7fafc0d58f6f2187cc20ae8df393f47636047'],2,15,17,850508,1,0,0,0,2779
c627c73c3abcda124ae88c1f605aff8ec2c74d17,0,Lahiru Gunathilake,2012-09-26 18:36:09+00:00,['ffa1c0c446cbf7732d6c0bec9d58e50a4520ffa6'],2,432,434,850942,7,,,,2785
c15ced0ee688fd57a5f00cb27180ef6fa37353c1,0,Lahiru Gunathilake,2012-09-26 18:58:21+00:00,['c627c73c3abcda124ae88c1f605aff8ec2c74d17'],21,3,24,850966,1,,,,2785
e540ea87e59d094c3757996c81f364c47ea6e52a,0,Suresh Marru,2012-09-29 01:26:00+00:00,['c15ced0ee688fd57a5f00cb27180ef6fa37353c1'],9,9,18,850984,5,,,,2785
c5af55aae400984569440b58bd0dd8b3b4bd12b1,0,Suresh Marru,2012-09-30 20:30:12+00:00,['e540ea87e59d094c3757996c81f364c47ea6e52a'],67,121,188,851172,3,,,,2785
3b582080bf5b322c56b3e946d3967660c1f0ec74,0,Raminderjeet Singh,2012-10-01 14:37:02+00:00,['c5af55aae400984569440b58bd0dd8b3b4bd12b1'],4,46,50,851222,1,0.290322581,0.290322581,0.290322581,2785
cf4465409d33de6e790d4b514c6d9958829e733f,0,Lahiru Gunathilake,2012-10-01 20:49:32+00:00,['3b582080bf5b322c56b3e946d3967660c1f0ec74'],2,26,28,851250,10,0,1,0.791666667,2785
e8b8e273a8c0a8b475b56acb845cd365db238501,0,Lahiru Gunathilake,2012-10-01 20:50:37+00:00,['cf4465409d33de6e790d4b514c6d9958829e733f'],0,1,1,851251,1,0,0,0,2785
0128aadde70387fa55ed2571902ae042a357da18,1,samindaw,2012-10-02 17:15:24+00:00,['e8b8e273a8c0a8b475b56acb845cd365db238501'],16,105,121,851372,3,1,1,1,2786
b0c4e845ef7184814e15c50feded91140fb3aa46,1,samindaw,2012-10-02 17:31:26+00:00,['0128aadde70387fa55ed2571902ae042a357da18'],0,67,67,851439,2,1,1,1,2788
5b3da91371b4d7c341019b150caf44edf40576f4,0,Raminderjeet Singh,2012-10-02 20:46:23+00:00,['b0c4e845ef7184814e15c50feded91140fb3aa46'],2270,107,2377,853816,26,0.63853211,0.086238532,0.014678899,2788
9fa74a47cf46d2d11387cc04a0fd55bdd88fcd80,0,Lahiru Gunathilake,2012-10-02 21:57:34+00:00,['5b3da91371b4d7c341019b150caf44edf40576f4'],2,8,10,853826,1,0,1,1,2788
f04150722959c84f2f12fe6f3702c1e9beca1660,0,Lahiru Gunathilake,2012-10-02 22:01:28+00:00,['9fa74a47cf46d2d11387cc04a0fd55bdd88fcd80'],2,8,10,853836,1,1,1,1,2788
7f73f44451340d40117254c64460007ba1838775,0,samindaw,2012-10-03 13:56:00+00:00,['f04150722959c84f2f12fe6f3702c1e9beca1660'],16,15,31,853867,2,,0,,2788
cef88ea3eb0eab5de50c5b72778668fe7f93d984,0,Suresh Marru,2012-10-03 18:49:30+00:00,['7f73f44451340d40117254c64460007ba1838775'],2,2,4,853871,2,,,,2788
078f8ffae9524cc2f31f882faa85164123bfb0f7,0,Lahiru Gunathilake,2012-10-03 20:00:41+00:00,['cef88ea3eb0eab5de50c5b72778668fe7f93d984'],0,10,10,853881,2,0.888888889,0.888888889,0.111111111,2788
6d4aabf3eefcf7463584f17af0e54ab1039a3865,0,samindaw,2012-10-04 04:18:54+00:00,['078f8ffae9524cc2f31f882faa85164123bfb0f7'],19,32,51,853932,1,0,0,1,2788
a7f84444ef8d2577b75b375388103179b8008ec5,0,samindaw,2012-10-04 04:20:11+00:00,['6d4aabf3eefcf7463584f17af0e54ab1039a3865'],4,8,12,853944,1,0,0,1,2788
53752320fa1af351680ae7611433270944b56075,0,samindaw,2012-10-04 04:22:28+00:00,['a7f84444ef8d2577b75b375388103179b8008ec5'],0,27,27,853971,1,,,,2789
2908f75a7acadeed2b4b23735a5c22860f5536a0,0,Suresh Marru,2012-10-04 04:46:18+00:00,['53752320fa1af351680ae7611433270944b56075'],0,434,434,854405,1,,,,2790
0e1ed9379f6334f1ff4e199e110852dbd14eb8ec,1,Lahiru Gunathilake,2012-10-04 16:50:42+00:00,['2908f75a7acadeed2b4b23735a5c22860f5536a0'],35,195,230,854635,11,0.75257732,0.432989691,1,2791
27404840679fea0cc7795d6022392a06ecaa4287,0,Lahiru Gunathilake,2012-10-04 16:55:10+00:00,['0e1ed9379f6334f1ff4e199e110852dbd14eb8ec'],13,6,19,854654,2,0,0,1,2791
3476c51f288a049ec08c1ec6ec55021cecc94b34,0,Lahiru Gunathilake,2012-10-04 20:36:05+00:00,['27404840679fea0cc7795d6022392a06ecaa4287'],40,355,395,855049,6,0.021052632,0,1,2792
c74a3472255fd36b43be940e587a8e382e1c55c2,0,Suresh Marru,2012-10-05 00:23:39+00:00,['3476c51f288a049ec08c1ec6ec55021cecc94b34'],0,234,234,855283,2,,,,2794
879bb066bbb0ba512b62bd259ba088899c42335e,0,samindaw,2012-10-05 03:16:57+00:00,['c74a3472255fd36b43be940e587a8e382e1c55c2'],1,5,6,855289,1,0,1,1,2794
629752e4662cb8a86a703a04219a76a4d8d4e653,0,samindaw,2012-10-05 03:26:57+00:00,['879bb066bbb0ba512b62bd259ba088899c42335e'],1,1,2,855291,1,,,,2794
6e25add6ea82cfff6852e5b6934528b13fdc2282,0,samindaw,2012-10-05 03:47:42+00:00,['629752e4662cb8a86a703a04219a76a4d8d4e653'],355,40,395,855686,6,0.978947368,1,0,2794
947157f3068afae9783f48d4d15ddf602e9581fe,0,Lahiru Gunathilake,2012-10-05 13:31:04+00:00,['6e25add6ea82cfff6852e5b6934528b13fdc2282'],40,362,402,856088,6,0.020408163,0,1,2794
6575d407e8f5cc3067965f7018f67a67532d9f57,0,Lahiru Gunathilake,2012-10-05 15:11:34+00:00,['947157f3068afae9783f48d4d15ddf602e9581fe'],3,3,6,856094,1,,,,2794
394a9322627081dafe806761ee301ef4ce061254,0,Lahiru Gunathilake,2012-10-05 16:53:41+00:00,['6575d407e8f5cc3067965f7018f67a67532d9f57'],3,0,3,856097,1,1,1,0,2794
acedc32cc085a07f13faacf47d8d31f71a9b600e,0,samindaw,2012-10-05 17:12:53+00:00,['394a9322627081dafe806761ee301ef4ce061254'],51,155,206,856303,10,0.741935484,0.741935484,0.870967742,2795
0175939503aa2c0514751bb514e581bbabe34170,0,Lahiru Gunathilake,2012-10-05 18:49:58+00:00,['acedc32cc085a07f13faacf47d8d31f71a9b600e'],18,208,226,856529,8,0.226415094,0.232704403,1,2795
cbafc87bdd4c04b808da564f3a21aacde25be7cf,0,Lahiru Gunathilake,2012-10-05 19:17:55+00:00,['0175939503aa2c0514751bb514e581bbabe34170'],3,2,5,856534,1,1,1,0,2795
35c8597da1c9379c8453a31aae50392fadd06ace,0,Lahiru Gunathilake,2012-10-05 19:33:24+00:00,['cbafc87bdd4c04b808da564f3a21aacde25be7cf'],2,4,6,856540,1,,,,2795
9af18a6be0c08d8a08a861548112cc3bb23d0459,0,samindaw,2012-10-05 20:01:13+00:00,['35c8597da1c9379c8453a31aae50392fadd06ace'],0,10,10,856550,1,0,1,0,2795
f0933616f9249e9b6701b8106f3358e89e2f47d3,0,Lahiru Gunathilake,2012-10-05 20:02:41+00:00,['9af18a6be0c08d8a08a861548112cc3bb23d0459'],1,1,2,856552,1,,,,2795
0785e11af583b38a2a3a5517ce0c3e6686bbc861,0,samindaw,2012-10-05 20:53:46+00:00,['f0933616f9249e9b6701b8106f3358e89e2f47d3'],39,58,97,856649,2,1,1,0.176470588,2795
af56195a98a88b0726bafb7b01ef3e7aa4913725,0,Heshan Theekshana Suriyaarachchi,2012-10-05 20:56:55+00:00,['0785e11af583b38a2a3a5517ce0c3e6686bbc861'],4,22,26,856675,1,0,1,1,2795
f00686be4346797968b3f6b60c3f9858d61e8ca5,0,Lahiru Gunathilake,2012-10-05 21:00:55+00:00,['af56195a98a88b0726bafb7b01ef3e7aa4913725'],8,19,27,856702,7,1,1,1,2795
1a106cbdb2c651ea486b2d2cb05785c45ac835a7,0,samindaw,2012-10-05 21:02:28+00:00,['f00686be4346797968b3f6b60c3f9858d61e8ca5'],0,13,13,856715,1,1,1,1,2796
ba36d3441ea68a50fa5e5f5c9195c181d0ac27b2,1,Lahiru Gunathilake,2012-10-08 15:32:18+00:00,['1a106cbdb2c651ea486b2d2cb05785c45ac835a7'],58,189,247,856962,17,0.342465753,0.931506849,1,2796
c19ab82225c2c506015d24653ff807a7fafa7fde,0,Lahiru Gunathilake,2012-10-08 20:13:46+00:00,['ba36d3441ea68a50fa5e5f5c9195c181d0ac27b2'],221,107,328,857290,6,0.857142857,0.857142857,1,2796
8721908ce1a963d0bf6562727f571d9ab6a73bbc,0,Lahiru Gunathilake,2012-10-08 21:28:52+00:00,['c19ab82225c2c506015d24653ff807a7fafa7fde'],74,81,155,857445,2,0.666666667,1,0,2796
1159266d4d245df3361cd61fff63a3ce345e6361,0,samindaw,2012-10-08 23:02:12+00:00,['8721908ce1a963d0bf6562727f571d9ab6a73bbc'],1,8,9,857454,1,0,1,0,2796
cc048ff82067ddf82c1c310a02ea941712b56fbc,0,Lahiru Gunathilake,2012-10-08 23:28:26+00:00,['1159266d4d245df3361cd61fff63a3ce345e6361'],15,15,30,857484,1,0,0,0,2796
470bd8f302d6576cc748b4a9349cd1eeb1fdf1d7,1,Lahiru Gunathilake,2012-10-09 13:14:59+00:00,['cc048ff82067ddf82c1c310a02ea941712b56fbc'],0,2,2,857486,1,0,1,1,2796
73b5d98ded86b01e888f7efa5bfd3c498e7e2234,0,samindaw,2012-10-09 16:02:05+00:00,['470bd8f302d6576cc748b4a9349cd1eeb1fdf1d7'],7,3,10,857496,1,1,0,1,2796
0c2b6108e59eabd5b8d51622a4d1bf9746551831,0,Lahiru Gunathilake,2012-10-09 16:58:30+00:00,['73b5d98ded86b01e888f7efa5bfd3c498e7e2234'],0,1,1,857497,1,1,1,1,2796
f0e95364564ff2bcd391d6341cef6a339245d6e3,0,samindaw,2012-10-09 17:12:51+00:00,['0c2b6108e59eabd5b8d51622a4d1bf9746551831'],6,11,17,857514,1,0,1,1,2796
c38b261e10772f8078f57780b257cfe2cea82eaa,0,Heshan Theekshana Suriyaarachchi,2012-10-09 17:16:59+00:00,['f0e95364564ff2bcd391d6341cef6a339245d6e3'],0,3,3,857517,1,,,,2796
2b2318c61d161d96fe8a12c6c51ee54bc9845382,0,Heshan Theekshana Suriyaarachchi,2012-10-09 17:18:45+00:00,['c38b261e10772f8078f57780b257cfe2cea82eaa'],397,403,800,858317,1,,,,2796
b80e4cecc718f07a91561caee0ea3cf55ad6fbde,0,Suresh Marru,2012-10-09 17:33:32+00:00,['2b2318c61d161d96fe8a12c6c51ee54bc9845382'],10,11,21,858338,1,1,0,0,2796
5edf5fa6fd943311791158887eef649c56eb4ca2,0,Lahiru Gunathilake,2012-10-09 17:46:28+00:00,['b80e4cecc718f07a91561caee0ea3cf55ad6fbde'],1,1,2,858340,1,,,,2796
06973605693630b37c1341c77307b53df8ee6764,0,Lahiru Gunathilake,2012-10-10 18:28:50+00:00,['5edf5fa6fd943311791158887eef649c56eb4ca2'],1,11,12,858352,1,0,0,0,2796
2c815a00d7d4d87d7c56563cbb25cd15562ca06d,0,Raminderjeet Singh,2012-10-11 14:34:38+00:00,['06973605693630b37c1341c77307b53df8ee6764'],0,1,1,858353,1,,,,2796
43e3f3b56487e0f8370642266902e15dc51b918c,1,chathuri,2012-10-11 17:06:09+00:00,['2c815a00d7d4d87d7c56563cbb25cd15562ca06d'],62,2050,2112,860465,27,0.510791367,0.82853717,1,2815
a6b282f439f135f87aabda34dd8a34b62c6b8f93,0,Lahiru Gunathilake,2012-10-11 18:31:07+00:00,['43e3f3b56487e0f8370642266902e15dc51b918c'],4,12,16,860481,2,0.875,0.875,0.125,2815
5fd2f89bee02adef8d8b9f4ab60a4e39e29780c4,0,chathuri,2012-10-11 18:43:16+00:00,['a6b282f439f135f87aabda34dd8a34b62c6b8f93'],3,3,6,860487,1,1,0,0,2815
19b64ada166e2d09aac7eab99ac6660a8da5efe9,0,chathuri,2012-10-11 19:02:19+00:00,['5fd2f89bee02adef8d8b9f4ab60a4e39e29780c4'],1,1,2,860489,1,1,0,0,2815
1d2db31a83fd519a4d805ba2bfdc5c4bf417334f,1,chathuri,2012-10-11 21:06:56+00:00,['19b64ada166e2d09aac7eab99ac6660a8da5efe9'],3,22,25,860514,3,1,1,1,2815
e7b19e439791e35b8e8b873d346e375234186a6c,1,chathuri,2012-10-11 23:23:11+00:00,['1d2db31a83fd519a4d805ba2bfdc5c4bf417334f'],5,5,10,860524,2,,,,2815
6512355cd1968717919c9f2a3d6fd95d2c8b9920,0,chathuri,2012-10-12 05:34:49+00:00,['e7b19e439791e35b8e8b873d346e375234186a6c'],3,3,6,860530,2,,,,2815
3e4715ce06570b1c7fd80a641982f106b48b20ab,1,chathuri,2012-10-12 07:10:44+00:00,['6512355cd1968717919c9f2a3d6fd95d2c8b9920'],25,209,234,860764,18,0.65,0.98,1,2815
fdf9230309bfc5cf748dd05f3a7bf93b7412b093,1,chathuri,2012-10-12 13:52:28+00:00,['3e4715ce06570b1c7fd80a641982f106b48b20ab'],380,256,636,861400,18,0.857142857,0,0,2816
4ab15cbd58c71a582a7f946f8d47068aece42da9,0,Heshan Theekshana Suriyaarachchi,2012-10-12 14:52:18+00:00,['fdf9230309bfc5cf748dd05f3a7bf93b7412b093'],1,0,1,861401,1,,,,2816
829835f166219d81168f5983c63fa8d191a95161,0,chathuri,2012-10-12 14:55:35+00:00,['4ab15cbd58c71a582a7f946f8d47068aece42da9'],1,0,1,861402,1,0,0,0,2816
d357a4d6ed398ff3bcb9a1bc87bc6a3d7a44bcd1,0,chathuri,2012-10-12 15:29:00+00:00,['829835f166219d81168f5983c63fa8d191a95161'],29,34,63,861465,1,0,,,2816
d14336e02017d8e185d0833741b2586e4eae3eae,0,chathuri,2012-10-12 16:25:33+00:00,['d357a4d6ed398ff3bcb9a1bc87bc6a3d7a44bcd1'],106,113,219,861684,17,0,0,0,2816
be84b93f6771b7b4906a39945d98982edd603fb3,0,Lahiru Gunathilake,2012-10-15 18:41:43+00:00,['d14336e02017d8e185d0833741b2586e4eae3eae'],1,11,12,861696,1,0,0.5,1,2816
af823d131ec0d6bca1dcbddfcbc4f85c43609304,0,Lahiru Gunathilake,2012-10-15 19:15:17+00:00,['be84b93f6771b7b4906a39945d98982edd603fb3'],0,1,1,861697,1,0,1,1,2816
456acadc8ff89cc290033a1e1c1fa772f10e8d91,0,Suresh Marru,2012-10-15 19:27:18+00:00,['af823d131ec0d6bca1dcbddfcbc4f85c43609304'],2,3,5,861702,1,0,1,1,2816
53a063a5140e45303e9dc3f3c7ed055de175d36b,0,Lahiru Gunathilake,2012-10-15 19:34:26+00:00,['456acadc8ff89cc290033a1e1c1fa772f10e8d91'],1,1,2,861704,1,,,,2816
cbf9c123f084f3ac430b0ef2bf20a109d951069a,0,Heshan Theekshana Suriyaarachchi,2012-10-15 19:48:08+00:00,['53a063a5140e45303e9dc3f3c7ed055de175d36b'],11,11,22,861726,4,,,,2816
5eedfd4a607e232c6b3a59d07e1b7c44f285fd34,0,Lahiru Gunathilake,2012-10-15 21:18:24+00:00,['cbf9c123f084f3ac430b0ef2bf20a109d951069a'],2,6,8,861734,1,0,0,1,2816
020377f2e7d10ced898167c25fe1b61272e6b15b,0,Suresh Marru,2012-10-16 12:09:20+00:00,['5eedfd4a607e232c6b3a59d07e1b7c44f285fd34'],2,2,4,861738,1,,,,2816
76df4bae021e6a60af77954bc9b72365cb9688a8,0,Suresh Marru,2012-10-16 12:50:35+00:00,['020377f2e7d10ced898167c25fe1b61272e6b15b'],0,5,5,861743,1,,,,2816
c7809162450b4431cfcda5a35967a635de3cca20,0,chathuri,2012-10-16 20:04:27+00:00,['76df4bae021e6a60af77954bc9b72365cb9688a8'],1,2529,2530,864273,10,0.404552129,0.89133627,1,2821
9c9a8d3a0fc85bb095dda1e17a488fee948b7df1,0,chathuri,2012-10-17 17:27:13+00:00,['c7809162450b4431cfcda5a35967a635de3cca20'],4190,535,4725,868998,147,0.76318743,0.223905724,0.147586981,2821
47a3842c468e87dc3db69f04cb7349e80daa5eeb,0,chathuri,2012-10-17 18:13:03+00:00,['9c9a8d3a0fc85bb095dda1e17a488fee948b7df1'],4,7,11,869009,1,1,1,1,2821
55a4bb9ed4fa533f7e9b4d9808d6b68c04d82b29,0,Suresh Marru,2012-10-17 19:41:21+00:00,['47a3842c468e87dc3db69f04cb7349e80daa5eeb'],626,340,966,869975,57,1,0,0,2825
e795b3edea92a878f5d133e3046aff8c7ade4ccb,0,Suresh Marru,2012-10-17 20:20:52+00:00,['55a4bb9ed4fa533f7e9b4d9808d6b68c04d82b29'],14,8,22,869997,1,,,,2825
d68022c1102e1971f849e690eba18e50c8d98171,1,chathuri,2012-10-17 20:24:23+00:00,['e795b3edea92a878f5d133e3046aff8c7ade4ccb'],1,17,18,870015,5,1,1,1,2825
be8411b6ba60c1b8fe1cd75d4f488086703adefc,0,Lahiru Gunathilake,2012-10-17 21:06:12+00:00,['d68022c1102e1971f849e690eba18e50c8d98171'],1,1,2,870017,1,,,,2825
e6cf3d664a86f76378face04fd40e5bab338aefd,0,chathuri,2012-10-18 16:27:21+00:00,['be8411b6ba60c1b8fe1cd75d4f488086703adefc'],213,18,231,870248,4,1,1,1,2825
90c3e335485d412c13106f43e22cf52ec2533934,0,Raminderjeet Singh,2012-10-18 16:28:09+00:00,['e6cf3d664a86f76378face04fd40e5bab338aefd'],10,16,26,870274,1,1,1,0,2825
d52846d19b93b1b22f9fc678882acedb11bd29d6,0,Heshan Theekshana Suriyaarachchi,2012-10-18 19:44:00+00:00,['90c3e335485d412c13106f43e22cf52ec2533934'],1,4,5,870279,1,0,0,1,2825
e8a5e55e78382871957f490a5587431fcce7b6c7,1,Lahiru Gunathilake,2012-10-18 20:15:34+00:00,['d52846d19b93b1b22f9fc678882acedb11bd29d6'],1,47,48,870327,2,,,,2826
7bd5ac3f8470c4ed6473f0f8f38ca0a351cc2d24,0,Raminderjeet Singh,2012-10-18 20:20:36+00:00,['e8a5e55e78382871957f490a5587431fcce7b6c7'],1,1,2,870329,1,,,,2826
59179aeff76a3d3ba43bdbbe4bc2c1277cf01a55,0,Lahiru Gunathilake,2012-10-18 20:28:19+00:00,['7bd5ac3f8470c4ed6473f0f8f38ca0a351cc2d24'],1,1,2,870331,1,,,,2826
0eadcd0ffb008195e9c69dc8691e34c9b4c637ad,0,chathuri,2012-10-18 20:53:15+00:00,['59179aeff76a3d3ba43bdbbe4bc2c1277cf01a55'],8,76,84,870415,7,0.239130435,0.239130435,1,2826
284a9a3a7569a83907be18500c83b3aab51490ca,0,samindaw,2012-10-19 15:56:09+00:00,['0eadcd0ffb008195e9c69dc8691e34c9b4c637ad'],18,25,43,870458,2,1,0,1,2826
bd8e251ee05a26dc5613aad26e4bf9f2d1bb1420,0,samindaw,2012-10-19 15:59:41+00:00,['284a9a3a7569a83907be18500c83b3aab51490ca'],92,0,92,870550,1,,,,2826
25dce1672f550519aa53d82c2b9d5b651336b696,0,chathuri,2012-10-19 17:06:32+00:00,['bd8e251ee05a26dc5613aad26e4bf9f2d1bb1420'],47,38,85,870635,10,0.714285714,1,0.714285714,2826
70b5962179ae4cbf46494b45ffb64ff58f86d486,0,Lahiru Gunathilake,2012-10-19 21:10:06+00:00,['25dce1672f550519aa53d82c2b9d5b651336b696'],861,836,1697,872332,271,1,0,0,2826
1b41aecfe21760ff3595693644ae42106d3b274b,0,Suresh Marru,2012-10-19 21:24:39+00:00,['70b5962179ae4cbf46494b45ffb64ff58f86d486'],11,5,16,872348,1,,,,2826
ca1c7c4c816388076b99185439bbb3f54057e0c0,1,Patanachai Tangchaisin,2012-10-20 19:04:07+00:00,['1b41aecfe21760ff3595693644ae42106d3b274b'],836,896,1732,874080,272,0,1,1,2826
0fea43543a1551d895cb73882f7db6d16f3e25ea,0,Patanachai Tangchaisin,2012-10-20 19:40:50+00:00,['ca1c7c4c816388076b99185439bbb3f54057e0c0'],35,0,35,874115,1,,,,2826
e197fb58dc1a5920448bdd81f40b47c07b0b7338,0,Patanachai Tangchaisin,2012-10-20 19:49:59+00:00,['0fea43543a1551d895cb73882f7db6d16f3e25ea'],52,0,52,874167,11,,,,2826
55bb034ce25331f2fa1adee86a35cbe6e906bdd6,0,Patanachai Tangchaisin,2012-10-20 20:54:20+00:00,['e197fb58dc1a5920448bdd81f40b47c07b0b7338'],6,2,8,874175,1,,,,2826
758b8ec90a90b8fe9e953f694d2d485a4796a183,0,Suresh Marru,2012-10-21 01:19:13+00:00,['55bb034ce25331f2fa1adee86a35cbe6e906bdd6'],13,15,28,874203,4,,,,2826
090fd5e3a70787325efd00ca43318d919aff9ded,1,Suresh Marru,2012-10-21 03:09:16+00:00,['758b8ec90a90b8fe9e953f694d2d485a4796a183'],393,412,805,875008,13,,,,2826
6cff9ea5ae7eeee4444360caae7e2e610828c023,0,Suresh Marru,2012-10-21 14:10:07+00:00,['090fd5e3a70787325efd00ca43318d919aff9ded'],3855,678,4533,879541,45,0.79409994,0.492474413,0.125225768,2831
954248bea3417689c469c63fc6742db92c19c535,0,Suresh Marru,2012-10-21 14:44:32+00:00,['6cff9ea5ae7eeee4444360caae7e2e610828c023'],1204,0,1204,880745,5,,,,2831
e463a1ef1dc87834344b258efc1150a87de24c77,0,Suresh Marru,2012-10-22 04:06:04+00:00,['954248bea3417689c469c63fc6742db92c19c535'],0,52,52,880797,1,,,,2831
4d28702ecdf3f5a91a274cee8291e715fee20325,0,chathuri,2012-10-22 14:07:08+00:00,['e463a1ef1dc87834344b258efc1150a87de24c77'],7,8,15,880812,2,1,1,1,2831
817dff02393586dd8a1f2a33754f680deb6dc741,0,chathuri,2012-10-22 14:24:18+00:00,['4d28702ecdf3f5a91a274cee8291e715fee20325'],86,0,86,880898,3,,,,2831
1541dda3c6fb6e4a19926d623a091d5b94bb2bcc,0,Raminderjeet Singh,2012-10-22 14:57:12+00:00,['817dff02393586dd8a1f2a33754f680deb6dc741'],7,8,15,880913,1,0,0,1,2831
ccda037e46c95c07cca874b689fcf539f688e9b9,0,Lahiru Gunathilake,2012-10-22 15:11:53+00:00,['1541dda3c6fb6e4a19926d623a091d5b94bb2bcc'],4,4,8,880921,1,1,0,0,2831
478a24b2c04ec7e5267e71711572b8cdd6a7717e,0,chathuri,2012-10-22 15:12:15+00:00,['ccda037e46c95c07cca874b689fcf539f688e9b9'],2,214,216,881137,4,,,,2833
83493c79be443e0ab5db2f236cecdc6f08df2e08,0,Lahiru Gunathilake,2012-10-22 15:17:17+00:00,['478a24b2c04ec7e5267e71711572b8cdd6a7717e'],1,1,2,881139,1,,,,2833
cdcbe3749eb3a5f8f2de00828b68c3e8b9465f97,0,chathuri,2012-10-22 15:28:16+00:00,['83493c79be443e0ab5db2f236cecdc6f08df2e08'],0,1,1,881140,1,,,,2833
9ffc260ea4a4237acda8ab46b9a45fc89423a095,0,Lahiru Gunathilake,2012-10-22 15:36:48+00:00,['cdcbe3749eb3a5f8f2de00828b68c3e8b9465f97'],0,18,18,881158,2,,,,2833
15189112e35f30ec00f3a6d32e25e6efa62a6393,0,Lahiru Gunathilake,2012-10-22 18:32:51+00:00,['9ffc260ea4a4237acda8ab46b9a45fc89423a095'],4,6,10,881168,2,0.5,1,1,2833
7c56097d6d739a650a4260fcbad3bff837a9fc49,0,Lahiru Gunathilake,2012-10-22 19:03:40+00:00,['15189112e35f30ec00f3a6d32e25e6efa62a6393'],2,2,4,881172,2,,,,2833
4d4ecf7b367b7b739013894f53f194e2a1f13be5,0,Lahiru Gunathilake,2012-10-22 19:15:44+00:00,['7c56097d6d739a650a4260fcbad3bff837a9fc49'],11,16,27,881199,1,0,1,1,2833
26e28506b818fc1d6a556b03bc8b30873878366f,0,chathuri,2012-10-22 20:24:08+00:00,['4d4ecf7b367b7b739013894f53f194e2a1f13be5'],111,108,219,881418,7,1,0,0,2834
6c72f9ac7a6f5f034b523199bb45978a298ed40f,0,chathuri,2012-10-23 12:57:26+00:00,['26e28506b818fc1d6a556b03bc8b30873878366f'],2,2,4,881422,1,0,0,0,2834
a30d2eace222cb49c9a6ed3b75527e7c1f138437,0,Lahiru Gunathilake,2012-10-23 20:11:39+00:00,['6c72f9ac7a6f5f034b523199bb45978a298ed40f'],7,13,20,881442,4,0,0,1,2834
2a4e5b646f171406645728f318f089f2a471a5ea,0,Lahiru Gunathilake,2012-10-23 20:15:19+00:00,['a30d2eace222cb49c9a6ed3b75527e7c1f138437'],16,17,33,881475,1,,,,2834
6a152d3a9376676edf61deaa5d14dd79fc0492f8,0,Lahiru Gunathilake,2012-10-24 15:25:09+00:00,['2a4e5b646f171406645728f318f089f2a471a5ea'],11,27,38,881513,3,0.333333333,0.333333333,0.666666667,2834
5332026fd7225747fd2c52789663938d123d1d07,0,Lahiru Gunathilake,2012-10-24 18:25:06+00:00,['6a152d3a9376676edf61deaa5d14dd79fc0492f8'],3,3,6,881519,1,1,1,0,2834
b3f857513db99403595b0946bbed0f88f62b8024,0,chathuri,2012-10-24 19:24:44+00:00,['5332026fd7225747fd2c52789663938d123d1d07'],52,36,88,881607,3,0.090909091,0,0.181818182,2834
749bcc146a1dbca2fc5c55b3bbad1ee3c20b24c1,0,chathuri,2012-10-24 19:54:43+00:00,['b3f857513db99403595b0946bbed0f88f62b8024'],58,57,115,881722,18,,,,2834
71fbad19473d83e341130d5ce32fc4a965c0c0d4,0,samindaw,2012-10-26 01:57:14+00:00,['749bcc146a1dbca2fc5c55b3bbad1ee3c20b24c1'],0,44,44,881766,3,,,,2835
a74df6bb69bda178dc9dde6815e8bee4db8fc8d3,0,samindaw,2012-10-26 02:15:30+00:00,['71fbad19473d83e341130d5ce32fc4a965c0c0d4'],0,1,1,881767,1,,,,2835
b03eb24b5379baa539ac6b2435dff74f1be4f2d4,0,Lahiru Gunathilake,2012-10-26 15:15:01+00:00,['a74df6bb69bda178dc9dde6815e8bee4db8fc8d3'],1,3,4,881771,1,1,0,1,2835
aaf72e24d37c62005f2984e2ba0f65db91199f3e,0,chathuri,2012-10-26 17:39:01+00:00,['b03eb24b5379baa539ac6b2435dff74f1be4f2d4'],2,2,4,881775,2,,,,2835
a665ad3ffe9c940f38b62b7dddc52d83c96ab6bb,0,Suresh Marru,2012-10-27 02:32:04+00:00,['aaf72e24d37c62005f2984e2ba0f65db91199f3e'],0,0,0,881775,0,,,,2835
11eeb94be4107d16e4057f926734a7144fd0bd41,0,Suresh Marru,2012-10-27 03:12:56+00:00,['aaf72e24d37c62005f2984e2ba0f65db91199f3e'],33,30,63,881838,27,,,,2835
6de090a5b81beabacecc92b50166f0329af7a796,0,Suresh Marru,2012-10-28 00:09:53+00:00,['a665ad3ffe9c940f38b62b7dddc52d83c96ab6bb'],174,682,856,882694,21,1,1,1,2835
7a4006287d6d9f01ea7d2c2e77ff300d19a63654,0,Suresh Marru,2012-10-28 00:44:05+00:00,['6de090a5b81beabacecc92b50166f0329af7a796'],36,33,69,882763,27,,,,2835
ea68cdb7a80113b73f039b357218f59d7aa1a6ab,0,Suresh Marru,2012-10-28 00:44:12+00:00,['7a4006287d6d9f01ea7d2c2e77ff300d19a63654'],30,30,60,882823,27,,,,2835
e08d05ef4b17b10a382b3dc3b1781b19951ebaf6,0,Suresh Marru,2012-10-28 01:02:06+00:00,['ea68cdb7a80113b73f039b357218f59d7aa1a6ab'],27,27,54,882877,27,,,,2835
3df9fbe3a9e87c3e42aa6a5d76597514f304190c,0,Suresh Marru,2012-10-28 01:05:53+00:00,['e08d05ef4b17b10a382b3dc3b1781b19951ebaf6'],3,3,6,882883,1,,,,2835
1bd143e78a22af2b3dcf68b15c3eac5575d9c79e,0,Suresh Marru,2012-10-28 01:13:16+00:00,['3df9fbe3a9e87c3e42aa6a5d76597514f304190c'],30,30,60,882943,27,,,,2835
9fe4defaf33326ffdd1d5280f43e831e13cb5fab,0,Suresh Marru,2012-10-28 01:13:23+00:00,['1bd143e78a22af2b3dcf68b15c3eac5575d9c79e'],30,30,60,883003,27,,,,2835
740a8ff195bbdcbe273b7757a1c94243ad2beeba,0,Suresh Marru,2012-10-28 04:44:31+00:00,"['11eeb94be4107d16e4057f926734a7144fd0bd41', '9fe4defaf33326ffdd1d5280f43e831e13cb5fab']",177,685,862,883865,21,,,,2835
7dcf5b7bb793161a49e8c73d31c15e5f743beebe,0,Suresh Marru,2012-10-28 09:33:51+00:00,['740a8ff195bbdcbe273b7757a1c94243ad2beeba'],580,596,1176,885041,1,,,,2835
e3037686874039bbd4624c6ec4113224b95993e1,0,Lahiru Gunathilake,2012-10-29 17:06:38+00:00,['7dcf5b7bb793161a49e8c73d31c15e5f743beebe'],6,6,12,885053,1,0,0,1,2835
217c430b1dcea1f19ff21c6b5c9c5d02d0ba8b6c,0,Raminderjeet Singh,2012-10-29 18:58:11+00:00,['e3037686874039bbd4624c6ec4113224b95993e1'],396,509,905,885958,5,0.453608247,0.288659794,0.237113402,2835
15ff6b0cd9b49e77f785a44341dda154069637f6,0,chathuri,2012-10-31 18:25:14+00:00,['217c430b1dcea1f19ff21c6b5c9c5d02d0ba8b6c'],42,70,112,886070,3,0,0.692307692,0,2835
4edd81b3479021452c2988e35239a98834be63a2,0,samindaw,2012-11-02 22:22:07+00:00,['15ff6b0cd9b49e77f785a44341dda154069637f6'],5,247,252,886322,5,0.882352941,1,0.955882353,2836
d36c02c5becef3086ca7a2f32be498bb2d05042d,0,samindaw,2012-11-02 22:24:06+00:00,['4edd81b3479021452c2988e35239a98834be63a2'],5,0,5,886327,1,,,,2836
37bca5803b767b33fb8ea5806700b0afb8b67366,0,samindaw,2012-11-02 22:39:06+00:00,['d36c02c5becef3086ca7a2f32be498bb2d05042d'],2,76,78,886405,2,,,,2836
257611e283b720ddca478ec9afa4f92918cfadd5,0,chathuri,2012-11-05 15:39:52+00:00,['37bca5803b767b33fb8ea5806700b0afb8b67366'],16,103,119,886524,12,1,1,1,2836
c93ec863113b5f0ee7001c6e32ca919665c5e5d5,0,samindaw,2012-11-05 16:10:37+00:00,['257611e283b720ddca478ec9afa4f92918cfadd5'],4,68,72,886596,6,1,1,1,2837
738ac4595c96c53d0f3fa4515f8f8c8d3223e320,0,chathuri,2012-11-06 20:05:06+00:00,['c93ec863113b5f0ee7001c6e32ca919665c5e5d5'],9,59,68,886664,6,1,1,1,2837
5fd54dad1fdb2a4b9dda0c1b3a12a85ab4a50aff,0,Lahiru Gunathilake,2012-11-06 22:01:30+00:00,['738ac4595c96c53d0f3fa4515f8f8c8d3223e320'],4,38,42,886706,2,0,0.242424242,0.484848485,2837
9160312783536dc622afd22c7e44e7d14c3d07ab,0,Heshan Theekshana Suriyaarachchi,2012-11-07 15:03:46+00:00,['5fd54dad1fdb2a4b9dda0c1b3a12a85ab4a50aff'],0,5,5,886711,1,,,,2837
4c0231c36ee272fd023acf540cad24f87d459e2a,0,Heshan Theekshana Suriyaarachchi,2012-11-09 15:39:30+00:00,['9160312783536dc622afd22c7e44e7d14c3d07ab'],4,153,157,886868,1,,,,2837
7b0746d57dfcc2dcd978057ba92948a358e02961,0,Heshan Theekshana Suriyaarachchi,2012-11-09 19:36:33+00:00,['4c0231c36ee272fd023acf540cad24f87d459e2a'],153,4,157,887025,1,,,,2837
16d5477731d78c7145fca996517597cab7119314,0,Lahiru Gunathilake,2012-11-09 22:04:09+00:00,['7b0746d57dfcc2dcd978057ba92948a358e02961'],3,3,6,887031,1,,,,2837
95068889a6a1ad82dc965d9260944806ed307d4c,0,Lahiru Gunathilake,2012-11-09 22:11:33+00:00,['16d5477731d78c7145fca996517597cab7119314'],1,0,1,887032,1,1,1,1,2837
7ade1035251af27dc4b64e87191da49d8b89d059,0,chathuri,2012-11-12 18:16:24+00:00,['95068889a6a1ad82dc965d9260944806ed307d4c'],6,4,10,887042,2,0.5,0,0,2837
85820081af410649a2a32e9014e648c309d52523,0,chathuri,2012-11-13 15:52:16+00:00,['7ade1035251af27dc4b64e87191da49d8b89d059'],0,11260,11260,898302,49,0.356845834,0.943015555,0.868935777,2886
6052bdf4e06e31ba224615601a7c7edc61979926,0,chathuri,2012-11-13 15:54:11+00:00,['85820081af410649a2a32e9014e648c309d52523'],0,1,1,898303,1,,,,2886
67112f0d871db3f23f7e9c040f88fd4068740901,0,chathuri,2012-11-13 19:30:08+00:00,['6052bdf4e06e31ba224615601a7c7edc61979926'],3,3,6,898309,2,,,,2886
a9ec57d1165cc3639587f017ff49c72779c50abc,0,chathuri,2012-11-13 22:03:06+00:00,['67112f0d871db3f23f7e9c040f88fd4068740901'],4,33,37,898346,3,1,1,1,2886
65ba16069c8b5e447f029b0dff728a26346b4e4e,0,chathuri,2012-11-14 20:24:58+00:00,['a9ec57d1165cc3639587f017ff49c72779c50abc'],128,142,270,898616,9,0,1,0.727272727,2886
ebf853bc5a192ade67e4d4500c2fbaa7228b4f15,0,Lahiru Gunathilake,2012-11-14 21:10:13+00:00,['65ba16069c8b5e447f029b0dff728a26346b4e4e'],148,2458,2606,901222,32,0.507225434,0.637283237,0.867052023,2916
5bdffde812fedd38e9dfd9c593b9622bdac08b78,0,Lahiru Gunathilake,2012-11-14 21:23:10+00:00,['ebf853bc5a192ade67e4d4500c2fbaa7228b4f15'],0,1471,1471,902693,20,0.558080808,0.792929293,0.931818182,2936
1e9d67227579d7b81a57d28d4affdb6bc5509801,0,Lahiru Gunathilake,2012-11-14 21:23:49+00:00,['5bdffde812fedd38e9dfd9c593b9622bdac08b78'],0,0,0,902693,1,,,,2937
6a9c236660f0714405de97cf1941956d91dc40d0,0,chathuri,2012-11-14 21:33:24+00:00,['1e9d67227579d7b81a57d28d4affdb6bc5509801'],6,6,12,902705,2,,,,2937
3b90cd14f9873eaf3427fbd71922fbf333925453,0,Lahiru Gunathilake,2012-11-14 21:48:14+00:00,['6a9c236660f0714405de97cf1941956d91dc40d0'],605,611,1216,903921,1,,,,2937
65fdc735a2530c9af29e5b44a10c1e112983e602,0,chathuri,2012-11-15 15:28:20+00:00,['3b90cd14f9873eaf3427fbd71922fbf333925453'],33,435,468,904389,4,0,1,1,2937
c039b0449fffaaa3e7214b3c46a3dc91fcdada4f,0,Lahiru Gunathilake,2012-11-15 19:54:51+00:00,['65fdc735a2530c9af29e5b44a10c1e112983e602'],18,30,48,904437,6,,,,2937
be56a0c1bbd369a3d148f6fd1e1c9f3f9f008717,0,Lahiru Gunathilake,2012-11-15 20:07:11+00:00,['c039b0449fffaaa3e7214b3c46a3dc91fcdada4f'],0,18,18,904455,1,1,1,1,2937
2eda2da183b76de400fa6723ca5f76afed440330,0,chathuri,2012-11-15 20:09:58+00:00,['be56a0c1bbd369a3d148f6fd1e1c9f3f9f008717'],3,282,285,904740,6,0.736111111,1,0.840277778,2939
704cf01d194efd9ccdaca1c1dcaac821ff5d4548,0,chathuri,2012-11-15 21:00:39+00:00,['2eda2da183b76de400fa6723ca5f76afed440330'],0,4895,4895,909635,35,0.652605459,0.958643507,0.886269644,2974
c8b3bf2ca53dd757571be301714b10c4009cea43,0,chathuri,2012-11-15 21:06:01+00:00,['704cf01d194efd9ccdaca1c1dcaac821ff5d4548'],3202,245,3447,913082,16,0.710539846,0.075578406,0.155269923,2974
c7f81dcf226c958127f7706b9e86a586a05b0a6e,0,chathuri,2012-11-15 21:12:00+00:00,['c8b3bf2ca53dd757571be301714b10c4009cea43'],2550,0,2550,915632,8,0.322277501,0,0.118850193,2974
85cc04c85914b987da4704ea78d040a35114ccab,0,chathuri,2012-11-15 21:13:04+00:00,['c7f81dcf226c958127f7706b9e86a586a05b0a6e'],170,214,384,916016,8,1,1,1,2974
8a5fcf6dce0d4f48bd6a6dc3d08abdd00de1080a,0,chathuri,2012-11-16 15:38:01+00:00,['85cc04c85914b987da4704ea78d040a35114ccab'],2,9676,9678,925694,50,0.396279472,0.9556565,0.882760112,3023
6c3eeaa7b670717e823c977d59b9c224081e11f2,0,chathuri,2012-11-16 15:39:09+00:00,['8a5fcf6dce0d4f48bd6a6dc3d08abdd00de1080a'],4895,0,4895,930589,35,0.347394541,0.041356493,0.113730356,3023
c9656cbe09651fc0ceb7b0e4dae8ab4826035aeb,0,chathuri,2012-11-16 15:41:56+00:00,['6c3eeaa7b670717e823c977d59b9c224081e11f2'],0,1765,1765,932354,26,0.537769784,0.820143885,0.892086331,3049
22922db67c09882d8819c24921921c84e37558dc,0,chathuri,2012-11-16 15:42:55+00:00,['c9656cbe09651fc0ceb7b0e4dae8ab4826035aeb'],9,9,18,932372,2,,,,3049
7be50dc2fef618b3ab4e464ab5fa8a8776c138c1,0,chathuri,2012-11-16 15:48:31+00:00,['22922db67c09882d8819c24921921c84e37558dc'],7961,0,7961,940333,60,0.744263285,0.092089372,0.116847826,3049
f780903b71968098dd0316e2c16f1886bd9664fd,0,samindaw,2012-11-19 16:58:01+00:00,['7be50dc2fef618b3ab4e464ab5fa8a8776c138c1'],2309,121,2430,942763,51,0.434837093,0.315789474,0.020050125,3049
bdb65849508d2295ba2ae295483216f85f4fb2d7,0,samindaw,2012-11-19 17:05:10+00:00,['f780903b71968098dd0316e2c16f1886bd9664fd'],0,2283,2283,945046,13,0.566791511,0.685393258,0.980024969,3062
6249b09fe8fc4eb057bc4000d9f676a21b913980,0,chathuri,2012-11-19 17:13:56+00:00,['bdb65849508d2295ba2ae295483216f85f4fb2d7'],227,1447,1674,946720,18,0,0.236518448,0.883632923,3064
b5f9cee15c6ba1f50555e360c195163ce4a6cc7f,0,Lahiru Gunathilake,2012-11-19 20:03:08+00:00,['6249b09fe8fc4eb057bc4000d9f676a21b913980'],3,10,13,946733,2,1,1,1,3064
2170917dd0e7bd47445c3b808f59fcd47a6b05e8,0,Lahiru Gunathilake,2012-11-19 20:51:58+00:00,['b5f9cee15c6ba1f50555e360c195163ce4a6cc7f'],2,1,3,946736,1,,,,3064
7e91e0e62c7efd8804a84560b5ba2db79157ed6e,0,chathuri,2012-11-19 20:58:50+00:00,['2170917dd0e7bd47445c3b808f59fcd47a6b05e8'],17,28,45,946781,2,1,1,0,3064
dd5ff564116d6628fe669ff4d57c7b56ad089f07,0,Lahiru Gunathilake,2012-11-19 21:12:26+00:00,['7e91e0e62c7efd8804a84560b5ba2db79157ed6e'],0,4,4,946785,1,0,0,1,3064
bf18d2b5ed6a378ca5b6f3bdd74d59b776655ef6,0,chathuri,2012-11-19 22:31:01+00:00,['dd5ff564116d6628fe669ff4d57c7b56ad089f07'],153,965,1118,947903,11,0.969762419,0.995680346,0.866090713,3065
cb5df95da9def17912109bf1f2d4676cb937613a,1,Lahiru Gunathilake,2012-11-20 01:49:32+00:00,['bf18d2b5ed6a378ca5b6f3bdd74d59b776655ef6'],117,696,813,948716,10,0.189393939,0.712121212,0.897727273,3069
8cfc7da7495b4fee86668ef84128e250987ad84e,0,chathuri,2012-11-20 13:11:34+00:00,['cb5df95da9def17912109bf1f2d4676cb937613a'],3,53,56,948772,4,0,1,1,3069
f7d3e2d1b7f466f4a653536c5dc663e0fd80d328,0,samindaw,2012-11-20 14:18:47+00:00,['8cfc7da7495b4fee86668ef84128e250987ad84e'],69,634,703,949475,39,0,0,0,3071
3e24e244257fd0fa1c1f41fe471c96cc9be517e5,0,samindaw,2012-11-20 14:27:20+00:00,['f7d3e2d1b7f466f4a653536c5dc663e0fd80d328'],0,11,11,949486,3,,,,3071
80fb7e0efbd0b585b0438a653b6502b919425346,0,samindaw,2012-11-20 16:06:23+00:00,['3e24e244257fd0fa1c1f41fe471c96cc9be517e5'],82,163,245,949731,13,1,1,1,3071
1599a01a7e8922880ac05b519a9c75776eebeb22,0,samindaw,2012-11-20 16:31:00+00:00,['80fb7e0efbd0b585b0438a653b6502b919425346'],102,39,141,949872,4,1,1,1,3071
8815aa637b756e11bc0a9e7b62be08f1f48a38bf,0,chathuri,2012-11-20 21:03:32+00:00,['1599a01a7e8922880ac05b519a9c75776eebeb22'],21,389,410,950282,7,0.913636364,1,0.904545455,3072
60edbd273a355d352b378d0dbcdc43d9be3a84c4,0,chathuri,2012-11-20 21:04:16+00:00,['8815aa637b756e11bc0a9e7b62be08f1f48a38bf'],8,45,53,950335,2,0,0.783783784,0.918918919,3072
798f4f9bcf3a55d44837a2faa53959e3e0fb80d1,0,chathuri,2012-11-21 15:15:55+00:00,['60edbd273a355d352b378d0dbcdc43d9be3a84c4'],11,10,21,950356,10,,,,3072
4010022900df452d128c479e93b133f003493fc6,0,chathuri,2012-11-21 15:32:41+00:00,['798f4f9bcf3a55d44837a2faa53959e3e0fb80d1'],21,109,130,950486,11,1,1,0.625,3072
775fcdc96500ff3a7522bf36004c93c3fec9572e,0,samindaw,2012-11-21 15:56:17+00:00,['4010022900df452d128c479e93b133f003493fc6'],44,173,217,950703,11,1,1,0.625,3072
6ac9d3c1747c8fc069c40939d9bef59d7ea4e09a,0,chathuri,2012-11-21 19:39:38+00:00,['775fcdc96500ff3a7522bf36004c93c3fec9572e'],893,1209,2102,952805,115,0.508928571,0.366071429,0.758928571,3074
4314ccfc7688731c4d22ce35c693af7934cd6163,0,samindaw,2012-11-24 19:12:50+00:00,['6ac9d3c1747c8fc069c40939d9bef59d7ea4e09a'],19,6,25,952830,3,0,0,0.076923077,3074
f820c29ef5840f849a7153da111ec5dbdf5da46a,0,samindaw,2012-11-26 08:40:05+00:00,['4314ccfc7688731c4d22ce35c693af7934cd6163'],65,100,165,952995,9,1,1,0.5,3075
f5f4266f05bc69042ba5ac423865eb9a07c61940,0,Lahiru Gunathilake,2012-11-26 15:51:08+00:00,['f820c29ef5840f849a7153da111ec5dbdf5da46a'],2,10,12,953007,3,1,1,1,3075
1ff97534925db07b34ab27e3facc4e456213d819,0,Lahiru Gunathilake,2012-11-26 16:21:55+00:00,['f5f4266f05bc69042ba5ac423865eb9a07c61940'],0,77,77,953084,2,1,1,1,3077
6451d81f008ad2e5cd47e3351bb46265049e7fe3,0,chathuri,2012-11-26 19:16:30+00:00,['1ff97534925db07b34ab27e3facc4e456213d819'],468,1127,1595,954679,24,0,0.504132231,0.882231405,3081
7fa8e7f7383966588a4c97ab25b124817813808c,0,chathuri,2012-11-26 19:17:24+00:00,['6451d81f008ad2e5cd47e3351bb46265049e7fe3'],2,2,4,954683,1,,,,3081
ff528242be85f47e99eedf752c9772510256f5f1,0,chathuri,2012-11-26 20:59:03+00:00,['7fa8e7f7383966588a4c97ab25b124817813808c'],28,49,77,954760,10,1,1,0,3081
84f8a022dd1469dc2882bf03095c3561ebe3696d,0,samindaw,2012-11-27 19:14:20+00:00,['ff528242be85f47e99eedf752c9772510256f5f1'],13,12,25,954785,1,,,,3081
a804a7818330c8a75916823e7a003d1222a2d5a1,0,samindaw,2012-11-27 20:02:10+00:00,['84f8a022dd1469dc2882bf03095c3561ebe3696d'],64,95,159,954944,2,0.433333333,0.533333333,0.283333333,3081
cbf8f7d87113af121084b1b04cb0e993d8c0d487,0,chathuri,2012-11-27 20:29:30+00:00,['a804a7818330c8a75916823e7a003d1222a2d5a1'],154,252,406,955350,5,0.022222222,0.477777778,1,3081
245c3d74e5fd265509d5950d2762c8067113d0f6,0,samindaw,2012-11-27 20:29:50+00:00,['cbf8f7d87113af121084b1b04cb0e993d8c0d487'],16,16,32,955382,4,0,0,0.75,3081
28f2f1c6c7e6e711294137a52ce43eacb6585c67,0,Raminderjeet Singh,2012-11-27 20:41:49+00:00,['245c3d74e5fd265509d5950d2762c8067113d0f6'],5,2,7,955389,1,1,1,0,3081
30975e213355cbe9ea28cf66ef2fb06e2cd82416,0,Raminderjeet Singh,2012-11-27 20:42:29+00:00,['28f2f1c6c7e6e711294137a52ce43eacb6585c67'],29,30,59,955448,1,1,1,1,3081
42d4813bc0b700436ddd18e449723f977f287d42,0,samindaw,2012-11-27 20:42:32+00:00,['30975e213355cbe9ea28cf66ef2fb06e2cd82416'],3,5,8,955456,1,0,0,0,3081
7eef8d81c8e0c0b1c08c02303156fff5ddfe41b4,0,chathuri,2012-11-27 21:52:45+00:00,['42d4813bc0b700436ddd18e449723f977f287d42'],246,242,488,955944,9,,,,3081
4b721bba83123591748cf5735fd8149430a3d75e,0,Lahiru Gunathilake,2012-11-27 22:19:49+00:00,['7eef8d81c8e0c0b1c08c02303156fff5ddfe41b4'],13,457,470,956414,8,0.821428571,0.964285714,0.964285714,3085
f1cd3e23dd15229dcc5a18ed90ff10c8ace05df1,0,Raminderjeet Singh,2012-11-27 22:41:54+00:00,['4b721bba83123591748cf5735fd8149430a3d75e'],15,13,28,956442,1,1,1,0,3085
cf63f85b6ec65d90fbf94c9b7c9d96eaad560b42,0,samindaw,2012-11-28 19:50:25+00:00,['f1cd3e23dd15229dcc5a18ed90ff10c8ace05df1'],0,167,167,956609,4,1,1,1,3089
d26e0cc97ef13659edf91fb021be5553fc60d48c,0,samindaw,2012-11-28 20:38:58+00:00,['cf63f85b6ec65d90fbf94c9b7c9d96eaad560b42'],14,344,358,956967,10,1,1,1,3096
e3d91ded4e821a944ac10871c9e25d333b3a6a2e,0,samindaw,2012-11-28 21:21:27+00:00,['d26e0cc97ef13659edf91fb021be5553fc60d48c'],48,53,101,957068,6,1,1,0,3096
bd2281a34e2a7a312f504be941b0b792d9e55891,0,chathuri,2012-11-29 16:12:29+00:00,['e3d91ded4e821a944ac10871c9e25d333b3a6a2e'],792,915,1707,958775,20,0.357142857,0.833333333,0.738095238,3096
38c11cbcb98577a1851d8e08b049016b4bf85f41,0,chathuri,2012-11-29 16:15:04+00:00,['bd2281a34e2a7a312f504be941b0b792d9e55891'],94,193,287,959062,18,0.806451613,0.532258065,0.838709677,3096
d2672918319b20d27d34c9e5d8ef3f2cc803dd9d,0,samindaw,2012-11-29 17:24:07+00:00,['38c11cbcb98577a1851d8e08b049016b4bf85f41'],0,1,1,959063,1,,,,3096
de9c2f480752713042d8511afcf0dfd14645d30f,0,samindaw,2012-11-29 18:52:31+00:00,['d2672918319b20d27d34c9e5d8ef3f2cc803dd9d'],0,19,19,959082,2,1,1,1,3096
9db51876a36679d88ef2dbee2d3d70f156b5462b,0,samindaw,2012-11-29 18:56:36+00:00,['de9c2f480752713042d8511afcf0dfd14645d30f'],14,20,34,959116,2,1,1,1,3096
bcca64c89623b4a78ad879f9d0b85b7790275346,1,chathuri,2012-11-29 19:40:27+00:00,['9db51876a36679d88ef2dbee2d3d70f156b5462b'],330,278,608,959724,16,0.981818182,0.272727273,0.036363636,3096
8f49ad7932db06f0f9cc47b487600984d8e82e2f,0,samindaw,2012-11-29 20:06:16+00:00,['bcca64c89623b4a78ad879f9d0b85b7790275346'],296,276,572,960296,31,0.848484848,0.717171717,0,3096
b05ef567b0a6a69d4b408d5ea8f816f15db0178a,1,chathuri,2012-11-29 20:10:40+00:00,['8f49ad7932db06f0f9cc47b487600984d8e82e2f'],34,25,59,960355,6,,,,3096
02830f53e46555ce777f2b14704a279bd4ee7c68,0,samindaw,2012-11-29 20:13:39+00:00,['b05ef567b0a6a69d4b408d5ea8f816f15db0178a'],1,5,6,960361,1,,,,3096
6c2fd9ee24fc7995dc7db7c5b2932c5a702da6b5,0,chathuri,2012-11-29 20:49:38+00:00,['02830f53e46555ce777f2b14704a279bd4ee7c68'],2,3,5,960366,2,1,1,0,3096
c9dd494c2661353e36448c56f401498fdb4f574c,0,chathuri,2012-11-29 21:54:51+00:00,['6c2fd9ee24fc7995dc7db7c5b2932c5a702da6b5'],16,22,38,960404,6,0,0,0,3096
f7b14b8974642539313f19619fa332662413461d,0,chathuri,2012-11-30 04:06:27+00:00,['c9dd494c2661353e36448c56f401498fdb4f574c'],3,3,6,960410,3,,,,3096
00ee79f588791f517f670b866a34d7ffe84dca3e,0,samindaw,2012-11-30 05:22:24+00:00,['f7b14b8974642539313f19619fa332662413461d'],16,14,30,960440,3,1,0,1,3096
3d6eab596873053821765e55966b901733fc096f,0,Lahiru Gunathilake,2012-11-30 12:55:59+00:00,['00ee79f588791f517f670b866a34d7ffe84dca3e'],0,33,33,960473,2,,,,3096
636b376f5a9f45e633c358691f4dee4fa3693292,0,Lahiru Gunathilake,2012-11-30 12:56:56+00:00,['3d6eab596873053821765e55966b901733fc096f'],5,419,424,960897,4,0.141176471,0.352941176,1,3099
97f21733664b24f2a86ac374e4624f272a98ffcb,0,Lahiru Gunathilake,2012-11-30 14:18:33+00:00,['636b376f5a9f45e633c358691f4dee4fa3693292'],0,6,6,960903,1,,,,3099
744e84afbf7cb4072ab566ce57d97e6292c9fc29,0,chathuri,2012-11-30 14:22:49+00:00,['97f21733664b24f2a86ac374e4624f272a98ffcb'],1,0,1,960904,1,,,,3099
3dff27b0a4b6c8c57b4b8fc14f28705357d5dab8,0,chathuri,2012-11-30 14:48:58+00:00,['744e84afbf7cb4072ab566ce57d97e6292c9fc29'],2,6,8,960912,1,0,0,0.5,3099
6bc681f5f2bb61dacf972aa7542179cae0cf1616,0,samindaw,2012-11-30 16:38:12+00:00,['3dff27b0a4b6c8c57b4b8fc14f28705357d5dab8'],56,62,118,961030,2,1,0.96969697,0,3099
e7006a6a250e9be1b56de5586ccaf0e823356786,0,Lahiru Gunathilake,2012-11-30 16:44:41+00:00,['6bc681f5f2bb61dacf972aa7542179cae0cf1616'],1,1,2,961032,1,,,,3099
b6acd3bb8166962b7a60c83c90dad0cbc94def05,0,chathuri,2012-11-30 16:49:18+00:00,['e7006a6a250e9be1b56de5586ccaf0e823356786'],1,15,16,961048,1,0,0.166666667,0,3099
68dca9305d8a282cb7ec23e1d41a8a2945fc3af3,0,chathuri,2012-11-30 17:10:38+00:00,['b6acd3bb8166962b7a60c83c90dad0cbc94def05'],13,18,31,961079,1,1,1,1,3099
52b40cfda38d27979abd257d90a65b9690c4a0ed,0,chathuri,2012-11-30 19:14:11+00:00,['68dca9305d8a282cb7ec23e1d41a8a2945fc3af3'],99,196,295,961374,18,0,0,1,3099
f1ce83b506ec56879563e86107909082de7c2743,0,chathuri,2012-11-30 20:31:36+00:00,['52b40cfda38d27979abd257d90a65b9690c4a0ed'],9,11,20,961394,9,,,,3099
e0ba9787c9a1914f2c32a3cb59355f60ca591ef0,0,samindaw,2012-12-01 17:04:56+00:00,['f1ce83b506ec56879563e86107909082de7c2743'],11,17,28,961422,1,0,0,1,3099
2011141de59374640c4f1a3d21fd6da3fe2ca673,0,Suresh Marru,2012-12-01 17:06:46+00:00,['e0ba9787c9a1914f2c32a3cb59355f60ca591ef0'],221,173,394,961816,2,,,,3099
5e4b99eddc6fcbe995b6ab12c5922ee504b555f2,0,Suresh Marru,2012-12-01 17:27:54+00:00,['2011141de59374640c4f1a3d21fd6da3fe2ca673'],213,140,353,962169,2,,,,3099
de3ac2bda678b499ef9bc8a931efc1417359daa2,0,Suresh Marru,2012-12-01 18:41:25+00:00,['5e4b99eddc6fcbe995b6ab12c5922ee504b555f2'],117,60,177,962346,12,1,1,0,3099
a5194129c496e28c6f084c53dbffca7d99639750,0,Suresh Marru,2012-12-01 21:20:59+00:00,['de3ac2bda678b499ef9bc8a931efc1417359daa2'],13,13,26,962372,10,,,,3099
ec9e7174e38269529f15f926e16033c67333d9ad,0,Suresh Marru,2012-12-01 21:48:44+00:00,['a5194129c496e28c6f084c53dbffca7d99639750'],3,8,11,962383,5,,,,3099
d6c3cccac0814e711cc5dddc967aca4cdc4f0ed3,0,Suresh Marru,2012-12-01 22:01:11+00:00,['ec9e7174e38269529f15f926e16033c67333d9ad'],7,3,10,962393,2,,,,3099
edcc77ae86ed8c7b28ef71b938b564380772a710,1,Lahiru Gunathilake,2012-12-03 18:26:39+00:00,['d6c3cccac0814e711cc5dddc967aca4cdc4f0ed3'],0,550,550,962943,5,0.65625,1,0.7625,3103
6b85f903ce9157c121710f782315735e9dfb4548,0,Lahiru Gunathilake,2012-12-03 18:27:24+00:00,['edcc77ae86ed8c7b28ef71b938b564380772a710'],0,6,6,962949,1,1,1,1,3103
b25dd38a2bb176256aa847629786aa25885c9c9f,0,Lahiru Gunathilake,2012-12-03 18:29:45+00:00,['6b85f903ce9157c121710f782315735e9dfb4548'],2,2,4,962953,1,,,,3103
f95e95c4f159ddcca0ce1c9c270a93fa2525da5b,0,Lahiru Gunathilake,2012-12-03 18:36:29+00:00,['b25dd38a2bb176256aa847629786aa25885c9c9f'],35,110,145,963098,5,,,,3103
41e3968a0459b89413637b10e7109b4be3811f29,0,Lahiru Gunathilake,2012-12-03 18:52:34+00:00,['f95e95c4f159ddcca0ce1c9c270a93fa2525da5b'],1,1,2,963100,1,,,,3103
66de05f63e6c530bd6ba100bf8d4c87a2e08e8e4,0,Lahiru Gunathilake,2012-12-03 18:52:58+00:00,['41e3968a0459b89413637b10e7109b4be3811f29'],1,1,2,963102,1,,,,3103
03e5b4450ea47c1f6aeb2dc38160968e91cbd948,0,chathuri,2012-12-03 19:37:16+00:00,['66de05f63e6c530bd6ba100bf8d4c87a2e08e8e4'],635,1959,2594,965696,11,0.044595616,0,0.839758125,3103
80e88ee7090c3e103ca82c6732c0ddb419b6412c,0,Suresh Marru,2012-12-03 21:21:27+00:00,['03e5b4450ea47c1f6aeb2dc38160968e91cbd948'],17,17,34,965730,9,,,,3103
ccd3777c1c3f9602e91ae18941e349d1e4a7e1a4,0,Suresh Marru,2012-12-03 21:28:11+00:00,['80e88ee7090c3e103ca82c6732c0ddb419b6412c'],7,7,14,965744,5,,,,3103
cd9d318262e567ec46bad37bd75c3465c4ac4f08,0,chathuri,2012-12-04 13:57:30+00:00,['ccd3777c1c3f9602e91ae18941e349d1e4a7e1a4'],11,23,34,965778,4,0.4,0.4,1,3103
03376c6cf5092b63493d5ba072c3b31547977d0b,0,chathuri,2012-12-04 17:51:14+00:00,['cd9d318262e567ec46bad37bd75c3465c4ac4f08'],30,46,76,965854,14,0.357142857,0.785714286,0.857142857,3103
9d9b2a8b2fb4c8061a63fa2365cd6b9287334db7,0,Lahiru Gunathilake,2012-12-04 18:56:56+00:00,['03376c6cf5092b63493d5ba072c3b31547977d0b'],48,1,49,965903,1,,,,3103
425df3f989fac5f28cb32adc1420a447eb29bf6a,0,Lahiru Gunathilake,2012-12-04 19:34:23+00:00,['9d9b2a8b2fb4c8061a63fa2365cd6b9287334db7'],245,292,537,966440,2,,,,3103
e48c836549f91530e4f762d26eb55267a451032d,0,Lahiru Gunathilake,2012-12-04 19:34:56+00:00,['425df3f989fac5f28cb32adc1420a447eb29bf6a'],3,22,25,966465,1,0,1,1,3103
0136b52a285d217d22ed93bd88be56ef76c3853a,0,chathuri,2012-12-04 19:35:25+00:00,['e48c836549f91530e4f762d26eb55267a451032d'],35,188,223,966688,12,,,,3104
4b5a18d386674c5f2b81d1880ba6c55377a12757,0,Lahiru Gunathilake,2012-12-04 20:15:22+00:00,['0136b52a285d217d22ed93bd88be56ef76c3853a'],0,9,9,966697,1,,,,3104
47397fa2ab253d9cd8f7f54cb96fb901edcd0be9,0,Lahiru Gunathilake,2012-12-04 20:27:48+00:00,['4b5a18d386674c5f2b81d1880ba6c55377a12757'],4,1,5,966702,1,,,,3104
8764591bd5b070719c4a15f478467e4d0c7ad465,0,chathuri,2012-12-04 20:28:02+00:00,['47397fa2ab253d9cd8f7f54cb96fb901edcd0be9'],83,83,166,966868,5,,,,3104
59c2635fd9419b5e3b52948e0d211ee17ec8299d,0,chathuri,2012-12-04 21:59:27+00:00,['8764591bd5b070719c4a15f478467e4d0c7ad465'],3,5,8,966876,2,,,,3104
2b118a2bb9f5fa8c63e5b2e9ad2c87c94e8c2f0e,0,chathuri,2012-12-04 22:38:05+00:00,['59c2635fd9419b5e3b52948e0d211ee17ec8299d'],0,5,5,966881,1,,,,3104
f596eb3c4308f034b080d23b57fbf7c41d819e33,0,chathuri,2012-12-05 14:53:23+00:00,['2b118a2bb9f5fa8c63e5b2e9ad2c87c94e8c2f0e'],6,53,59,966940,4,,,,3104
4d8f409b5732096d1807272e3fabc41e69091cc9,0,Lahiru Gunathilake,2012-12-05 16:10:58+00:00,['f596eb3c4308f034b080d23b57fbf7c41d819e33'],13,11,24,966964,1,,,,3104
2991c455770e348242df81647973a51039515c78,0,Lahiru Gunathilake,2012-12-05 18:28:05+00:00,['4d8f409b5732096d1807272e3fabc41e69091cc9'],469,5543,6012,972976,53,,,,3131
7e2bf904f63e6b90bd014797e9f55b32f3e7b05e,0,Lahiru Gunathilake,2012-12-05 18:29:51+00:00,['2991c455770e348242df81647973a51039515c78'],0,0,0,972976,25,,,,3131
589d7b6c64a93ea207a7d441cb00f534c718ff0c,0,Lahiru Gunathilake,2012-12-05 18:30:38+00:00,['7e2bf904f63e6b90bd014797e9f55b32f3e7b05e'],0,4730,4730,977706,25,,,,3156
8d908fef9e3a5152234c47128c3e3ee8e562f57c,0,chathuri,2012-12-05 18:48:44+00:00,['589d7b6c64a93ea207a7d441cb00f534c718ff0c'],12,72,84,977790,5,1,1,1,3156
db5260bfa4831109315f2fce5f1666cf76431951,0,Lahiru Gunathilake,2012-12-05 19:39:21+00:00,['8d908fef9e3a5152234c47128c3e3ee8e562f57c'],793,39,832,978622,5,,,,3156
3a0840079571a2b342a31496fa5945d4c7a2d331,0,chathuri,2012-12-05 19:42:18+00:00,['db5260bfa4831109315f2fce5f1666cf76431951'],10,22,32,978654,5,1,1,0,3157
0ff2bca6d5377fd21876976d990900da00b3b705,0,chathuri,2012-12-05 19:44:08+00:00,['3a0840079571a2b342a31496fa5945d4c7a2d331'],1,1,2,978656,1,,,,3157
27a47a9b9f3e552608525e5591a76d4160b0c3eb,0,Lahiru Gunathilake,2012-12-05 19:58:15+00:00,['0ff2bca6d5377fd21876976d990900da00b3b705'],146,346,492,979148,3,,,,3158
e151ef84700890eba6d7e86a918f81978bae8e0c,0,Lahiru Gunathilake,2012-12-05 20:05:44+00:00,['27a47a9b9f3e552608525e5591a76d4160b0c3eb'],3,9,12,979160,3,,,,3158
bd249c92f138bf07d96b7d9dc151db2c630ca2d4,0,Lahiru Gunathilake,2012-12-05 20:09:16+00:00,['e151ef84700890eba6d7e86a918f81978bae8e0c'],5,5,10,979170,3,,,,3158
00d17faaf4e6d57569c37c84091709e3925bb9ff,0,Lahiru Gunathilake,2012-12-05 20:13:22+00:00,['bd249c92f138bf07d96b7d9dc151db2c630ca2d4'],3,3,6,979176,3,,,,3158
227fd5ebf7172fc303f9ad15b62186436821d815,0,chathuri,2012-12-05 21:06:28+00:00,['00d17faaf4e6d57569c37c84091709e3925bb9ff'],18,18,36,979212,3,,,,3158
907878552fed1313c20874f6fe432a719978cc0f,0,chathuri,2012-12-05 22:05:10+00:00,['227fd5ebf7172fc303f9ad15b62186436821d815'],364,66,430,979642,7,,,,3158
058131c0ae1881243c950997f744c6035f978c34,0,chathuri,2012-12-06 16:28:09+00:00,['907878552fed1313c20874f6fe432a719978cc0f'],220,207,427,980069,22,,,,3158
14d82cc3931e898c9cd9c45047f7e67ae2fb6059,0,chathuri,2012-12-06 18:01:47+00:00,['058131c0ae1881243c950997f744c6035f978c34'],2414,12,2426,982495,26,,,,3158
2a33d4f11d249c9670bbf4f06fd97657fd2c61c0,0,Lahiru Gunathilake,2012-12-06 20:25:13+00:00,['14d82cc3931e898c9cd9c45047f7e67ae2fb6059'],0,801,801,983296,10,0.347107438,1,1,3168
9f10dd01e954a9e03efaddeacf428aa43e94b53f,0,Lahiru Gunathilake,2012-12-06 20:41:46+00:00,['2a33d4f11d249c9670bbf4f06fd97657fd2c61c0'],1,1,2,983298,1,,,,3168
a7391b47e57e072c5c242d85fc18e485ec666546,0,Lahiru Gunathilake,2012-12-06 20:42:36+00:00,['9f10dd01e954a9e03efaddeacf428aa43e94b53f'],11,1,12,983310,1,,,,3168
01096a0b63daef08a2e20b33f406dd2e6cee9f4c,0,chathuri,2012-12-06 21:05:24+00:00,['a7391b47e57e072c5c242d85fc18e485ec666546'],5,29,34,983344,2,,,,3168
aa18857f5a7c02e6b7900c33038056680692e553,0,Lahiru Gunathilake,2012-12-06 21:47:10+00:00,['01096a0b63daef08a2e20b33f406dd2e6cee9f4c'],3,64,67,983411,3,0.818181818,1,1,3168
3bc908f8823f513bf5c0127c78a87fe9690f33bc,0,chathuri,2012-12-06 22:06:46+00:00,['aa18857f5a7c02e6b7900c33038056680692e553'],0,24,24,983435,1,,,,3168
b46d6b712350878f3a00cc8f491de3c83611f56c,0,Suresh Marru,2012-12-07 15:12:48+00:00,['3bc908f8823f513bf5c0127c78a87fe9690f33bc'],322,35,357,983792,6,,,,3168
646848b6893bf0f029d6d9711d63ef5232d38969,0,samindaw,2012-12-07 18:39:16+00:00,['b46d6b712350878f3a00cc8f491de3c83611f56c'],1,1,2,983794,1,,,,3168
a5a423d6211400dbc7de4918773045dedd5c4973,0,Lahiru Gunathilake,2012-12-07 20:30:03+00:00,['646848b6893bf0f029d6d9711d63ef5232d38969'],24,33,57,983851,3,0,0,0,3168
786ee152e4888c9d629f7412c06b64dcdf65f4da,0,chathuri,2012-12-10 13:50:58+00:00,['a5a423d6211400dbc7de4918773045dedd5c4973'],2,2,4,983855,2,,,,3168
ad19f8bd0e9560fe1754348bf5965b66ae07cbc5,0,chathuri,2012-12-10 15:24:28+00:00,['786ee152e4888c9d629f7412c06b64dcdf65f4da'],17,42,59,983914,7,0,0,0.92,3168
8f7988eeb4e8c369ed5ab2f711ddf2b6bca23015,0,samindaw,2012-12-10 18:40:34+00:00,['ad19f8bd0e9560fe1754348bf5965b66ae07cbc5'],18,12,30,983944,1,0,0,0,3168
6b5789714cc8c265a6c055d317235a2b67a4175f,0,chathuri,2012-12-10 18:50:43+00:00,['8f7988eeb4e8c369ed5ab2f711ddf2b6bca23015'],2,13,15,983959,1,0.75,1,0.75,3168
7b0d5a2b72aa74b430fc3d627edf1b1ed8c9aa9d,0,chathuri,2012-12-10 19:23:33+00:00,['6b5789714cc8c265a6c055d317235a2b67a4175f'],3,7,10,983969,1,1,1,1,3168
c429ba4e3975ea2d904712b0c185ad891746c976,0,Lahiru Gunathilake,2012-12-10 21:39:46+00:00,['7b0d5a2b72aa74b430fc3d627edf1b1ed8c9aa9d'],226,1790,2016,985985,19,0.391304348,0.895652174,1,3182
ba86f42a62d30c23cf5c748661a288b34c3c8aec,0,Lahiru Gunathilake,2012-12-10 22:00:56+00:00,['c429ba4e3975ea2d904712b0c185ad891746c976'],5,5,10,985995,1,,,,3182
8ed3dfded302c80972e0bc962822ccfeb6616dee,0,samindaw,2012-12-10 22:43:09+00:00,['ba86f42a62d30c23cf5c748661a288b34c3c8aec'],1,1,2,985997,1,,,,3182
482d19951f432240e03af9771a4d2319e6c3777f,0,chathuri,2012-12-11 19:31:45+00:00,['8ed3dfded302c80972e0bc962822ccfeb6616dee'],153,255,408,986405,11,0,1,0.753846154,3183
1330a91131b5906f4d4530cf63e7c3bea41d177a,0,Lahiru Gunathilake,2012-12-11 20:28:32+00:00,['482d19951f432240e03af9771a4d2319e6c3777f'],5,17,22,986427,1,0,0,1,3183
dba652933202bb1070b732755d5690702d788165,0,Lahiru Gunathilake,2012-12-11 21:50:35+00:00,['1330a91131b5906f4d4530cf63e7c3bea41d177a'],1,7,8,986435,1,0,0,1,3183
10068c96f26a116558a94c90df1bca6b583b0152,0,chathuri,2012-12-11 22:21:58+00:00,['dba652933202bb1070b732755d5690702d788165'],44,29,73,986508,8,1,0,0.538461538,3183
7c0738fb62f058635f7d4ae3b4dc7a9832cb6953,0,chathuri,2012-12-12 16:07:50+00:00,['10068c96f26a116558a94c90df1bca6b583b0152'],2,44,46,986554,2,1,1,1,3183
fb714014cb7970877525e854b92994cce772db23,1,chathuri,2012-12-13 14:36:48+00:00,['7c0738fb62f058635f7d4ae3b4dc7a9832cb6953'],6,20,26,986580,3,,,,3183
b356b82fa5704d356ecf267ef87c61fdd57fc74c,0,chathuri,2012-12-13 20:21:08+00:00,['fb714014cb7970877525e854b92994cce772db23'],2,44,46,986626,6,1,1,1,3183
0ff7e276186017a2ab688da0b001168dae16ad29,0,samindaw,2012-12-13 20:59:39+00:00,['b356b82fa5704d356ecf267ef87c61fdd57fc74c'],20,67,87,986713,5,1,1,1,3183
7ab1f4eb59dc141f6c63ccd4dede6f087f6901c0,0,samindaw,2012-12-13 21:10:08+00:00,['0ff7e276186017a2ab688da0b001168dae16ad29'],0,24,24,986737,2,1,1,1,3183
5e23e684447d8bdf93d2c75dbd4bbc8ad49b800c,0,chathuri,2012-12-13 21:13:20+00:00,['7ab1f4eb59dc141f6c63ccd4dede6f087f6901c0'],3,23,26,986763,8,0.8125,1,0.9375,3183
830c03211e6aa25b5f73976a8242a42361980202,0,chathuri,2012-12-13 21:58:11+00:00,['5e23e684447d8bdf93d2c75dbd4bbc8ad49b800c'],1,1,2,986765,1,,,,3183
4e448932f25e0cdc064783acf155f3d6a880a251,0,Lahiru Gunathilake,2012-12-14 00:28:59+00:00,['830c03211e6aa25b5f73976a8242a42361980202'],3,21,24,986789,2,,,,3183
e03ee9f131e573c35bbdc42c179bd1d502fb7d3a,0,samindaw,2012-12-14 14:34:29+00:00,['4e448932f25e0cdc064783acf155f3d6a880a251'],20,6,26,986815,1,,,,3183
fb7dd0bdafb7afa6067e8234b0d46c2bb693142f,0,Lahiru Gunathilake,2012-12-14 14:55:36+00:00,['e03ee9f131e573c35bbdc42c179bd1d502fb7d3a'],1,68,69,986884,1,,,,3183
404140758a72d79d122a18357600d0cc8ba220d3,0,samindaw,2012-12-14 16:02:57+00:00,['fb7dd0bdafb7afa6067e8234b0d46c2bb693142f'],564,747,1311,988195,38,1,1,0.795454545,3187
30b3c803b0957d9df49f5b8bedcc8253e8981063,0,samindaw,2012-12-14 16:23:42+00:00,['404140758a72d79d122a18357600d0cc8ba220d3'],7,16,23,988218,1,,,,3187
473ad9c24a05e6222c840aa1bc6a9c90aac270de,0,samindaw,2012-12-14 19:15:32+00:00,['30b3c803b0957d9df49f5b8bedcc8253e8981063'],186,426,612,988830,20,1,1,0.375,3188
8bd682674736a6aff7ebfa8d7d46629e5f6e6519,0,chathuri,2012-12-14 20:02:42+00:00,['473ad9c24a05e6222c840aa1bc6a9c90aac270de'],52,68,120,988950,12,0.666666667,1,1,3188
b0d3e82ec43207d352326e1e5490bcaf27dcddae,0,Lahiru Gunathilake,2012-12-14 20:33:05+00:00,['8bd682674736a6aff7ebfa8d7d46629e5f6e6519'],388,410,798,989748,26,0.79338843,1,0.801652893,3190
4b6c2eaa95cf5a9c91b05ea960c68f915cfe86af,0,Lahiru Gunathilake,2012-12-17 16:03:57+00:00,['b0d3e82ec43207d352326e1e5490bcaf27dcddae'],1,1,2,989750,1,,,,3190
10b57cad44817cd106cf440565c3028c2cf5f347,0,chathuri,2012-12-17 17:00:50+00:00,['4b6c2eaa95cf5a9c91b05ea960c68f915cfe86af'],413,214,627,990377,15,,,,3190
f4008f6bcee98ad31f8450fc4e5a64e294369123,0,Lahiru Gunathilake,2012-12-17 17:30:12+00:00,['10b57cad44817cd106cf440565c3028c2cf5f347'],2,5,7,990384,2,0,0,1,3190
b2129267f6b2cd3ad12a3eb62ea10c5692c48c39,0,chathuri,2012-12-17 17:56:24+00:00,['f4008f6bcee98ad31f8450fc4e5a64e294369123'],1,0,1,990385,1,,,,3190
4ed5e85bad6649367c4a7058274f8900de783962,0,chathuri,2012-12-17 22:34:38+00:00,['b2129267f6b2cd3ad12a3eb62ea10c5692c48c39'],5,5,10,990395,1,0,0,1,3190
34d19e8f9e4b2b9f068088be842b8629f230603f,0,Lahiru Gunathilake,2012-12-18 19:42:54+00:00,['4ed5e85bad6649367c4a7058274f8900de783962'],3,3,6,990401,3,,,,3190
b049c2c63d149ff4490c5bc116d08d1ec409c307,0,Lahiru Gunathilake,2012-12-18 20:29:28+00:00,['34d19e8f9e4b2b9f068088be842b8629f230603f'],0,2,2,990403,1,,,,3190
58163dd8e4f8b3c0999448870964c6d7d747d3e2,0,Lahiru Gunathilake,2012-12-18 22:02:11+00:00,['b049c2c63d149ff4490c5bc116d08d1ec409c307'],908,867,1775,992178,33,0.867052023,0.786127168,0.965317919,3196
d68b2ca42ae070bd55101782d74a368a691a3142,0,samindaw,2012-12-19 15:21:50+00:00,['58163dd8e4f8b3c0999448870964c6d7d747d3e2'],6,6,12,992190,1,,,,3196
8bbc910900c7aff7f4dd13b86fdd0f360fa7a2e8,0,Lahiru Gunathilake,2012-12-19 15:58:30+00:00,['d68b2ca42ae070bd55101782d74a368a691a3142'],3,7,10,992200,1,0,0,1,3196
6aeb311a10e75fa54797116a8a97d6d263b753a8,0,samindaw,2012-12-19 16:34:04+00:00,['8bbc910900c7aff7f4dd13b86fdd0f360fa7a2e8'],2,107,109,992309,2,,,,3197
5b028e7db464558deff30b64fc922291369d0782,0,samindaw,2012-12-19 16:53:20+00:00,['6aeb311a10e75fa54797116a8a97d6d263b753a8'],33,34,67,992376,2,,,,3197
82cacfb3120ba16b4053a21c2ca0ae33e7aecb42,1,Lahiru Gunathilake,2012-12-19 22:20:33+00:00,['5b028e7db464558deff30b64fc922291369d0782'],6,83,89,992465,17,0.3,1,0.833333333,3199
78da9bfbc5c4a38e03a857421fc97e3415756247,0,chathuri,2012-12-19 22:35:18+00:00,['82cacfb3120ba16b4053a21c2ca0ae33e7aecb42'],1600,2203,3803,996268,12,0,0.007843137,0.888235294,3199
0a8083f9c8c85f26793ca8fa7ccb4a07943d8d13,0,samindaw,2012-12-20 14:53:00+00:00,['78da9bfbc5c4a38e03a857421fc97e3415756247'],26,282,308,996576,5,0.583850932,0.689440994,0.447204969,3200
f8910a19581972123d3d48dc8990198469015b8e,0,samindaw,2012-12-20 16:12:58+00:00,['0a8083f9c8c85f26793ca8fa7ccb4a07943d8d13'],4,210,214,996790,5,0.863636364,0.863636364,0.893939394,3203
9f7bdde1f414dfc3c6c630b7fa435e188fd21ce5,1,Lahiru Gunathilake,2012-12-20 20:12:26+00:00,['f8910a19581972123d3d48dc8990198469015b8e'],7,16,23,996813,3,0,0,1,3203
478b586587568a90a57c6f8d310486a020ec29ab,0,samindaw,2012-12-20 20:47:37+00:00,['9f7bdde1f414dfc3c6c630b7fa435e188fd21ce5'],18,211,229,997042,7,1,1,1,3206
a685c572d2395afb16ab7804c5bb4f8f911e6812,0,chathuri,2012-12-21 18:49:50+00:00,['478b586587568a90a57c6f8d310486a020ec29ab'],1196,1121,2317,999359,8,1,1,0.064516129,3206
902b4450848e16a7c2305394c0b56cb332b5032d,0,chathuri,2012-12-21 20:26:46+00:00,['a685c572d2395afb16ab7804c5bb4f8f911e6812'],4,7,11,999370,1,0,0,1,3206
305e23b8b5708e64bc47b7cbc2af5f15b7d47209,0,samindaw,2012-12-21 21:40:54+00:00,['902b4450848e16a7c2305394c0b56cb332b5032d'],0,322,322,999692,4,,,,3210
be656ecbf2756f9899f53cb287b212913d49bbf1,0,amilaj,2012-12-21 23:04:23+00:00,['305e23b8b5708e64bc47b7cbc2af5f15b7d47209'],61,475,536,1000228,7,0.62345679,1,0.351851852,3212
848603a7551ea65863d5809807e18a33f131fd24,0,amilaj,2012-12-25 01:21:00+00:00,['be656ecbf2756f9899f53cb287b212913d49bbf1'],20,381,401,1000629,4,0.6171875,0.609375,0.609375,3212
ffe84bae42a52e85bee695b111b21f2d0e831aaf,0,chathuri,2012-12-26 15:32:51+00:00,['848603a7551ea65863d5809807e18a33f131fd24'],367,356,723,1001352,34,,,,3212
95619c83e4f4309b1baed36882e9dc5d2882c36c,0,chathuri,2012-12-27 21:24:37+00:00,['ffe84bae42a52e85bee695b111b21f2d0e831aaf'],4,0,4,1001356,1,,,,3212
95e940395e11743b905eb49ffcbf546076f0527f,0,samindaw,2012-12-31 17:09:15+00:00,['95619c83e4f4309b1baed36882e9dc5d2882c36c'],6,360,366,1001722,7,1,1,0.950704225,3216
74c0001f48d026ec51d87db47c1a2c0018079168,0,samindaw,2012-12-31 19:47:09+00:00,['95e940395e11743b905eb49ffcbf546076f0527f'],0,136,136,1001858,2,,,,3218
04d41d1b50596b9c8b5bc45898b70131cd73ece0,0,samindaw,2012-12-31 20:05:35+00:00,['74c0001f48d026ec51d87db47c1a2c0018079168'],0,159,159,1002017,2,1,1,0.819672131,3220
2c3f71067603ce1ebc0962383abd15672a08bddc,0,chathuri,2012-12-31 21:04:55+00:00,['04d41d1b50596b9c8b5bc45898b70131cd73ece0'],2,2,4,1002021,1,,,,3220
d41392abbf7422ec3745abc0839bab2c856a1220,1,amilaj,2012-12-31 21:29:02+00:00,['2c3f71067603ce1ebc0962383abd15672a08bddc'],511,301,812,1002833,12,1,0.070175439,0.135964912,3220
3c17149f10921f62844639acdb23d55a06ab4a86,0,amilaj,2012-12-31 21:36:39+00:00,['d41392abbf7422ec3745abc0839bab2c856a1220'],63,0,63,1002896,1,,,,3220
8daeeac113cb67cbdad99d714fd86a618be1aeba,0,Lahiru Gunathilake,2013-01-02 16:10:29+00:00,['3c17149f10921f62844639acdb23d55a06ab4a86'],0,10,10,1002906,1,,,,3220
cc31ce52337c999fae080c999da8fe9b0d0392a4,0,samindaw,2013-01-02 19:10:32+00:00,['8daeeac113cb67cbdad99d714fd86a618be1aeba'],174,135,309,1003215,9,0.666666667,0.583333333,0,3220
ae4244dbb862490f0d2ff71e61f1559fa251ff96,0,samindaw,2013-01-02 19:44:38+00:00,['cc31ce52337c999fae080c999da8fe9b0d0392a4'],16,116,132,1003347,6,0.824324324,1,1,3220
a994575001ed4b4071fe6689cdc676e5338ca9b5,0,samindaw,2013-01-02 20:18:25+00:00,['ae4244dbb862490f0d2ff71e61f1559fa251ff96'],2,28,30,1003377,2,,,,3220
70b2bfa561ed29dfd9fc53d53a832f5f70f17458,0,chathuri,2013-01-02 20:28:27+00:00,['a994575001ed4b4071fe6689cdc676e5338ca9b5'],2,1,3,1003380,1,,,,3220
57d9963bfc43b488b7ce122c4c898566ca85fdce,0,chathuri,2013-01-02 20:33:34+00:00,['70b2bfa561ed29dfd9fc53d53a832f5f70f17458'],11,0,11,1003391,1,,,,3220
8cf8be97bd2fcaf711bc7acf5a993cc4ff0c3c91,0,amilaj,2013-01-03 15:48:14+00:00,['57d9963bfc43b488b7ce122c4c898566ca85fdce'],0,5,5,1003396,1,,,,3220
7696946ea9c13ea5d887fcd036e7d58c5b02cc93,0,samindaw,2013-01-03 16:24:22+00:00,['8cf8be97bd2fcaf711bc7acf5a993cc4ff0c3c91'],0,19,19,1003415,2,0.846153846,1,1,3220
7cd4a4e9c9273d5451f6c336e0433b11f6b76006,0,chathuri,2013-01-03 16:24:25+00:00,['7696946ea9c13ea5d887fcd036e7d58c5b02cc93'],0,6,6,1003421,2,,,,3220
f23a9d52b0d22167a81ef5f6df507e52898ffe06,0,samindaw,2013-01-03 20:14:32+00:00,['7cd4a4e9c9273d5451f6c336e0433b11f6b76006'],26,55,81,1003502,4,1,1,1,3220
895e95f1257d3a14de578c0bb725bf4b86ad445e,0,amilaj,2013-01-03 20:50:29+00:00,['f23a9d52b0d22167a81ef5f6df507e52898ffe06'],51,54,105,1003607,3,1,1,1,3220
3e153920ca9c35312f6a4d00a748f7bb89a65558,0,chathuri,2013-01-03 21:03:08+00:00,['895e95f1257d3a14de578c0bb725bf4b86ad445e'],5,4,9,1003616,2,,,,3220
0b41264e221d8c4893e64d5f1a4f24e2ccb99fa7,0,amilaj,2013-01-03 22:58:07+00:00,['3e153920ca9c35312f6a4d00a748f7bb89a65558'],20,140,160,1003776,4,0,0,0.872340426,3220
0de6270bebe91b4d53084d19550d2aaa6432995b,0,samindaw,2013-01-04 14:41:42+00:00,['0b41264e221d8c4893e64d5f1a4f24e2ccb99fa7'],102,247,349,1004125,13,0.878787879,0.939393939,1,3224
9da2112530a7770182ba53381c7f61069bedac11,0,samindaw,2013-01-04 14:53:06+00:00,['0de6270bebe91b4d53084d19550d2aaa6432995b'],0,85,85,1004210,1,,,,3225
e6fcba0550c2c11e0a99a2493de9ef748cc5eded,0,samindaw,2013-01-04 15:30:41+00:00,['9da2112530a7770182ba53381c7f61069bedac11'],36,58,94,1004304,3,,,,3225
5aab1021416d0c938e656c9893ef5e373e07000c,0,chathuri,2013-01-04 15:33:52+00:00,['e6fcba0550c2c11e0a99a2493de9ef748cc5eded'],5,29,34,1004338,2,0.333333333,1,1,3225
1baa22cfe4abecaad1390430aaeb1308cbb833b6,0,samindaw,2013-01-04 16:31:18+00:00,['5aab1021416d0c938e656c9893ef5e373e07000c'],1,1,2,1004340,1,,,,3225
71cb27df55f914ac688c9f5593118557d6fd19ef,0,amilaj,2013-01-04 16:39:49+00:00,['1baa22cfe4abecaad1390430aaeb1308cbb833b6'],217,333,550,1004890,9,0,1,1,3228
519fa1bc67ab548a62baa03604edcf4a0d03db0b,0,samindaw,2013-01-04 16:58:44+00:00,['71cb27df55f914ac688c9f5593118557d6fd19ef'],3,48,51,1004941,2,,,,3228
6fdd0fcdc6b49c4d81a480821b08a27363ff7e13,0,Lahiru Gunathilake,2013-01-04 17:20:49+00:00,['519fa1bc67ab548a62baa03604edcf4a0d03db0b'],1,1,2,1004943,1,0,1,0,3228
adeb20d3e9e7fb3bb797c29d7750961c2f3b992d,0,chathuri,2013-01-04 17:47:22+00:00,['6fdd0fcdc6b49c4d81a480821b08a27363ff7e13'],7,26,33,1004976,1,0,0,1,3228
a70d0088c5c547b32c8151420472fc158bc8cc9a,0,chathuri,2013-01-04 19:38:38+00:00,['adeb20d3e9e7fb3bb797c29d7750961c2f3b992d'],17,351,368,1005344,10,0.063380282,0.165492958,0.820422535,3229
e58a59b30259bc8e4db6484c3cc3486c56bb016e,0,chathuri,2013-01-04 20:09:51+00:00,['a70d0088c5c547b32c8151420472fc158bc8cc9a'],5,52,57,1005401,3,0,0,1,3229
8a207223a076bd9b77aa499a260646415d107225,0,chathuri,2013-01-04 21:01:55+00:00,['e58a59b30259bc8e4db6484c3cc3486c56bb016e'],0,12,12,1005413,1,0,0,1,3229
f4ea954afad018e3f1291a4fb38926276d511d09,0,Lahiru Gunathilake,2013-01-04 21:42:15+00:00,['8a207223a076bd9b77aa499a260646415d107225'],1,2,3,1005416,1,1,1,1,3229
6cf580b9354ea5cd85c3454222486f06838618a3,0,samindaw,2013-01-04 21:48:40+00:00,['f4ea954afad018e3f1291a4fb38926276d511d09'],737,769,1506,1006922,22,1,1,1,3231
eca0c99820a9633e52fd521d8c9cd1437a6093ba,0,Raminderjeet Singh,2013-01-04 21:51:22+00:00,['6cf580b9354ea5cd85c3454222486f06838618a3'],10,10,20,1006942,1,,,,3231
a93b296e4cddaf8a3f9e924954f4df2ce413bbef,0,samindaw,2013-01-05 20:54:49+00:00,['eca0c99820a9633e52fd521d8c9cd1437a6093ba'],0,99,99,1007041,3,0.435897436,1,1,3232
a187a11fe5858e4b4a2af1b0fdffa7d863f87399,0,samindaw,2013-01-05 22:25:38+00:00,['a93b296e4cddaf8a3f9e924954f4df2ce413bbef'],11,28,39,1007080,6,0,0,1,3232
d9ae7e6abe257488070d458e54234634a0044539,0,samindaw,2013-01-05 22:40:58+00:00,['a187a11fe5858e4b4a2af1b0fdffa7d863f87399'],14,11,25,1007105,1,1,1,0,3232
4dd07fd8cc0295f404442fff131a6a3b77f863cc,0,amilaj,2013-01-06 13:09:51+00:00,['d9ae7e6abe257488070d458e54234634a0044539'],4,12,16,1007121,4,1,1,0,3232
148488367bef55845b4569d87f4413352844d154,0,samindaw,2013-01-06 20:14:27+00:00,['4dd07fd8cc0295f404442fff131a6a3b77f863cc'],69,96,165,1007286,6,1,0,0,3232
c5c91c43777eb205ef7b101ccb06278735ba1368,0,amilaj,2013-01-06 20:54:12+00:00,['148488367bef55845b4569d87f4413352844d154'],28,0,28,1007314,1,,,,3232
6511388e5eb587a6c17db7283f3ff8733bf5ffc3,0,amilaj,2013-01-06 22:42:46+00:00,['c5c91c43777eb205ef7b101ccb06278735ba1368'],19,22,41,1007355,3,0.65625,0.65625,0,3232
27d91dd66575a7a5836e45729738a5d646f66ee4,0,chathuri,2013-01-07 14:52:06+00:00,['6511388e5eb587a6c17db7283f3ff8733bf5ffc3'],11,14,25,1007380,1,0,0,1,3232
3c6bf8d4f310f8d04a1f6cdd4ae634e34b67b1f9,0,samindaw,2013-01-07 15:19:50+00:00,['27d91dd66575a7a5836e45729738a5d646f66ee4'],822,828,1650,1009030,8,0.504363002,0.301919721,0.378708551,3232
a4b175e9302a9f23cb161000dd6e04e3a706c50e,0,amilaj,2013-01-07 18:39:00+00:00,['3c6bf8d4f310f8d04a1f6cdd4ae634e34b67b1f9'],1,3,4,1009034,1,,,,3232
a99e24a1a4335de48ff1da67d2d49987c4768775,0,samindaw,2013-01-07 19:14:46+00:00,['a4b175e9302a9f23cb161000dd6e04e3a706c50e'],103,131,234,1009268,7,0,0,0,3232
646af5a897453244a198aa69941c1520ce0abd82,0,samindaw,2013-01-07 22:08:54+00:00,['a99e24a1a4335de48ff1da67d2d49987c4768775'],155,239,394,1009662,8,0.681818182,0,1,3233
145bf0dc65cc7dd2a144bab446fd0f2e97e8be77,0,chathuri,2013-01-08 18:39:51+00:00,['646af5a897453244a198aa69941c1520ce0abd82'],420,1076,1496,1011158,26,0.467091295,0.942675159,0.851380042,3233
0ed928543d5cbc30a03dbf5a80d0c7737e0c656d,0,Lahiru Gunathilake,2013-01-09 01:44:15+00:00,['145bf0dc65cc7dd2a144bab446fd0f2e97e8be77'],0,6,6,1011164,1,0,0,1,3233
22b64c7ba48602855c7203aca421549bac311e67,0,Lahiru Gunathilake,2013-01-09 01:46:32+00:00,['0ed928543d5cbc30a03dbf5a80d0c7737e0c656d'],2,14,16,1011180,1,0,0,0,3233
6083208377da73e5c98f1c2fc0b0725647bf09c0,0,Lahiru Gunathilake,2013-01-09 01:49:49+00:00,['22b64c7ba48602855c7203aca421549bac311e67'],6,0,6,1011186,1,,,,3233
d4ad23ba3862a7d051ac05292e51b0fcf23a9873,0,samindaw,2013-01-09 01:52:13+00:00,['6083208377da73e5c98f1c2fc0b0725647bf09c0'],853,336,1189,1012375,13,0.266666667,1,0.911111111,3238
4237ed049ca7b728ba34f90b2810f901c79497b3,0,amilaj,2013-01-09 02:03:32+00:00,['d4ad23ba3862a7d051ac05292e51b0fcf23a9873'],10,0,10,1012385,1,,,,3238
ad18e84b796bb1acd174f987409db9f45c667716,0,samindaw,2013-01-09 03:04:34+00:00,['4237ed049ca7b728ba34f90b2810f901c79497b3'],1,9,10,1012395,2,,,,3238
8d5b89ecaf62533f6616a53cd74be79285287330,0,samindaw,2013-01-09 03:09:13+00:00,['ad18e84b796bb1acd174f987409db9f45c667716'],28,40,68,1012463,3,1,0,1,3238
bb5246b9c00eb87e5ad3df3c9499ef40eeaf4541,0,samindaw,2013-01-09 03:40:28+00:00,['8d5b89ecaf62533f6616a53cd74be79285287330'],1,1,2,1012465,1,,,,3238
7d453e8159dea260ed46487c5adc899a439805a7,0,samindaw,2013-01-09 03:41:54+00:00,['bb5246b9c00eb87e5ad3df3c9499ef40eeaf4541'],1,1,2,1012467,1,,,,3238
9deef1c22e1275d874f062077e0fa350f29ca99a,0,amilaj,2013-01-09 04:47:56+00:00,['7d453e8159dea260ed46487c5adc899a439805a7'],3,56,59,1012526,1,,,,3238
f097e66228406f5cb6a588fbc8495438f8b18bae,0,amilaj,2013-01-09 05:27:55+00:00,['9deef1c22e1275d874f062077e0fa350f29ca99a'],3,15,18,1012544,2,0,0.857142857,1,3238
36841ae3fd9de74ff9059c84cc6c4fae0d3ada52,0,chathuri,2013-01-09 15:30:43+00:00,['f097e66228406f5cb6a588fbc8495438f8b18bae'],379,1,380,1012924,6,,,,3238
e2aec824661bc657e68fb5cb8a024b3b6841f0e5,0,samindaw,2013-01-09 16:13:40+00:00,['36841ae3fd9de74ff9059c84cc6c4fae0d3ada52'],33,75,108,1013032,1,0.085714286,0.114285714,1,3238
c4b7ccbf25488649f8320604034f211570d19fa1,0,Lahiru Gunathilake,2013-01-09 16:49:13+00:00,['e2aec824661bc657e68fb5cb8a024b3b6841f0e5'],139,89,228,1013260,3,1,1,0,3238
4d4388ea6a6396b21f17de04bf65333b1f0975e9,0,samindaw,2013-01-09 18:27:04+00:00,['c4b7ccbf25488649f8320604034f211570d19fa1'],244,267,511,1013771,21,0,0,0,3241
d8b114f6ad1a734d5f571a75f4b8a113adf8f5f0,0,chathuri,2013-01-09 18:42:17+00:00,['4d4388ea6a6396b21f17de04bf65333b1f0975e9'],490,39,529,1014300,9,,,,3241
95f6bdddd74a49a78cb0452511ec96d2e35910f1,0,samindaw,2013-01-09 19:00:53+00:00,['d8b114f6ad1a734d5f571a75f4b8a113adf8f5f0'],8,11,19,1014319,3,1,1,1,3241
4c78d48aa9fe4cafa54c751f74c6873ea457d892,1,samindaw,2013-01-09 20:50:01+00:00,['95f6bdddd74a49a78cb0452511ec96d2e35910f1'],240,245,485,1014804,71,0,0,0,3241
9dfa690997f265cd1d58f3b3fc0a0eab49ffbbbd,0,Lahiru Gunathilake,2013-01-09 20:57:52+00:00,['4c78d48aa9fe4cafa54c751f74c6873ea457d892'],1,2,3,1014807,1,0,1,1,3241
93bf9d6d7a89dd1b007a05884a8775e2df556c8f,0,samindaw,2013-01-09 21:00:46+00:00,['9dfa690997f265cd1d58f3b3fc0a0eab49ffbbbd'],7,7,14,1014821,1,,,,3241
2298b0fdac283c2126914e3323add27c38c28731,0,chathuri,2013-01-09 21:42:26+00:00,['93bf9d6d7a89dd1b007a05884a8775e2df556c8f'],81,54,135,1014956,10,0,1,1,3241
5fadd0a734d742a170275c8b549394008c54fd8f,0,Lahiru Gunathilake,2013-01-09 22:47:54+00:00,['2298b0fdac283c2126914e3323add27c38c28731'],2,5,7,1014963,2,0,0,1,3241
b967e96a3590c004b6aff4e724422824baad5625,0,samindaw,2013-01-09 22:54:56+00:00,['5fadd0a734d742a170275c8b549394008c54fd8f'],196,12,208,1015171,8,1,1,1,3241
c3e94e855c50210b19ebbd0216631646e1e0a1a9,0,samindaw,2013-01-09 23:01:55+00:00,['b967e96a3590c004b6aff4e724422824baad5625'],10,4,14,1015185,2,,,,3241
749a1d237888f99fcbe4ab5ea6bd1077004612a7,0,amilaj,2013-01-09 23:02:06+00:00,['c3e94e855c50210b19ebbd0216631646e1e0a1a9'],108,113,221,1015406,3,,,,3241
303843bc21e0a90b658f455f7684e3c6f0bd0e9c,0,samindaw,2013-01-09 23:09:46+00:00,['749a1d237888f99fcbe4ab5ea6bd1077004612a7'],58,0,58,1015464,1,,,,3241
8c1ddf1429ef87d501b6e0b7d41b5b7422fa4256,0,samindaw,2013-01-09 23:50:53+00:00,['303843bc21e0a90b658f455f7684e3c6f0bd0e9c'],88,336,424,1015888,4,,,,3241
f92497898ed38278128a16d6d0628e72e3c446cf,0,samindaw,2013-01-09 23:58:40+00:00,['8c1ddf1429ef87d501b6e0b7d41b5b7422fa4256'],4,34,38,1015926,2,1,1,1,3242
d44ebb77add452ad22ac2bd9bae5ad2743dba637,0,Lahiru Gunathilake,2013-01-10 15:29:15+00:00,['f92497898ed38278128a16d6d0628e72e3c446cf'],63,0,63,1015989,1,,,,3242
69062799c24bb0c7912bf1557b373ab1263f565c,0,Lahiru Gunathilake,2013-01-10 18:30:26+00:00,['d44ebb77add452ad22ac2bd9bae5ad2743dba637'],0,63,63,1016052,1,,,,3243
39bff771cdebe3faef86b9415f38e18e0d4ff36f,0,samindaw,2013-01-10 20:41:45+00:00,['69062799c24bb0c7912bf1557b373ab1263f565c'],25,28,53,1016105,2,,,,3243
8905ce3e6a370855c7a70c038f9d5f7210677898,0,amilaj,2013-01-10 21:30:47+00:00,['39bff771cdebe3faef86b9415f38e18e0d4ff36f'],0,74,74,1016179,12,0.8,0,0.76,3243
009379e03e8130676cf48be2af7de92bd0525d6b,0,Lahiru Gunathilake,2013-01-11 16:02:36+00:00,['8905ce3e6a370855c7a70c038f9d5f7210677898'],19,18,37,1016216,5,1,1,0,3243
83b794771969e69df64181f1f1c037bea7474980,0,chathuri,2013-01-11 16:07:34+00:00,['009379e03e8130676cf48be2af7de92bd0525d6b'],6,48,54,1016270,9,0.869565217,1,0.782608696,3243
a56a7ee42b4319a49f4f0561da3266c98865f168,0,chathuri,2013-01-11 17:35:26+00:00,['83b794771969e69df64181f1f1c037bea7474980'],8,62,70,1016340,13,0.848484848,0.909090909,0.848484848,3243
2243020e717ebeff411f8db55ff428a0cc5927aa,0,chathuri,2013-01-11 17:36:21+00:00,['a56a7ee42b4319a49f4f0561da3266c98865f168'],0,11,11,1016351,1,,,,3243
644e4ee8c56b699279b1e03eb82f8b8c1be71c9e,0,amilaj,2013-01-11 17:45:07+00:00,['2243020e717ebeff411f8db55ff428a0cc5927aa'],1,0,1,1016352,1,,,,3243
7164d46158a6553616a3264677d254c6feaab6b1,0,chathuri,2013-01-11 20:29:30+00:00,['644e4ee8c56b699279b1e03eb82f8b8c1be71c9e'],4,9,13,1016365,4,0,0,0,3243
3576ab5009242b397a49804a12b29fdbe24c0a88,0,Lahiru Gunathilake,2013-01-11 20:43:55+00:00,['7164d46158a6553616a3264677d254c6feaab6b1'],0,8,8,1016373,2,,,,3243
27735e07923e742f5ca55e8d8e5d8aedcb177ec6,0,Lahiru Gunathilake,2013-01-11 20:44:23+00:00,['3576ab5009242b397a49804a12b29fdbe24c0a88'],27,33,60,1016433,1,,,,3243
18d29a1afd664bdec624b6edabc0d11135eeb8c0,0,Lahiru Gunathilake,2013-01-14 16:30:09+00:00,['27735e07923e742f5ca55e8d8e5d8aedcb177ec6'],4,4,8,1016441,1,,,,3243
128c8115a6b5f215ae535b15422137bd65230d5e,0,Lahiru Gunathilake,2013-01-14 17:02:35+00:00,['18d29a1afd664bdec624b6edabc0d11135eeb8c0'],0,7,7,1016448,1,1,1,0.6,3243
d219571113dd49d2ecad60527e3cc529769460ac,0,Lahiru Gunathilake,2013-01-14 17:02:55+00:00,['128c8115a6b5f215ae535b15422137bd65230d5e'],1,4,5,1016453,1,0,0,1,3243
0a6ab742f676114c51db67797d225e011e052814,0,Lahiru Gunathilake,2013-01-14 19:37:46+00:00,['d219571113dd49d2ecad60527e3cc529769460ac'],2,7,9,1016462,1,,,,3243
36ec3c4e484771c502d4e64d7cfa656943fd5d84,0,chathuri,2013-01-14 22:17:43+00:00,['0a6ab742f676114c51db67797d225e011e052814'],2,5,7,1016469,1,0,0,1,3243
2deced8ad21d61487c93b7d3f3dafc8ed469d159,0,amilaj,2013-01-15 02:04:24+00:00,['36ec3c4e484771c502d4e64d7cfa656943fd5d84'],423,268,691,1017160,6,0.06741573,0.370786517,1,3246
915e9f8c4d0f9bb609e676064aa61387f5734cc2,0,amilaj,2013-01-15 03:29:34+00:00,['2deced8ad21d61487c93b7d3f3dafc8ed469d159'],2,4,6,1017166,1,,,,3246
4a223cf22c25c4c479e307ad02080dde262824b5,0,Lahiru Gunathilake,2013-01-15 15:20:16+00:00,['915e9f8c4d0f9bb609e676064aa61387f5734cc2'],1,2,3,1017169,1,,,,3246
4e63f52e5c52c9a1ab5ea9bee9fcfb653039deb9,0,Lahiru Gunathilake,2013-01-15 18:12:27+00:00,['4a223cf22c25c4c479e307ad02080dde262824b5'],25,29,54,1017223,1,0,1,1,3246
f5794748b1bcb779799ed9df9639e9933e694641,0,Lahiru Gunathilake,2013-01-15 22:11:17+00:00,['4e63f52e5c52c9a1ab5ea9bee9fcfb653039deb9'],18,24,42,1017265,3,0,0.8,0.9,3246
ab5883be130cfaa2a55dd837952a74c4780a4fb1,0,amilaj,2013-01-15 22:15:56+00:00,['f5794748b1bcb779799ed9df9639e9933e694641'],122,4,126,1017391,4,,,,3246
9b7ea7e10b6eac21b3d2ccc14402a788656b02ee,0,Lahiru Gunathilake,2013-01-16 17:46:22+00:00,['ab5883be130cfaa2a55dd837952a74c4780a4fb1'],0,24,24,1017415,2,0,0,1,3246
e5369e6aa729907d839ee4befc761927527742f2,0,chathuri,2013-01-16 18:12:36+00:00,['9b7ea7e10b6eac21b3d2ccc14402a788656b02ee'],1,14,15,1017430,1,0.666666667,0.777777778,1,3246
586501a4b28ff67afd4fc8e86ba39b4265f8a716,0,samindaw,2013-01-16 18:29:34+00:00,['e5369e6aa729907d839ee4befc761927527742f2'],3,14,17,1017447,1,1,1,0,3246
df0ddd589f87a8f7e3afcd7fbdaa355889a1579a,0,samindaw,2013-01-16 18:30:05+00:00,['586501a4b28ff67afd4fc8e86ba39b4265f8a716'],5,29,34,1017481,5,1,1,1,3246
d67f23f7fef8e60ebe09b1b9c07668837e21ec97,0,Lahiru Gunathilake,2013-01-16 19:15:32+00:00,['df0ddd589f87a8f7e3afcd7fbdaa355889a1579a'],0,4,4,1017485,1,0,0,1,3246
4e34f75269a56afc200aabe4d458c5272cfd6b19,0,samindaw,2013-01-16 19:48:28+00:00,['d67f23f7fef8e60ebe09b1b9c07668837e21ec97'],0,0,0,1017485,1,,,,3247
eac7b50a8302fb109d591758e9f7513af198f96b,0,samindaw,2013-01-16 20:31:15+00:00,['4e34f75269a56afc200aabe4d458c5272cfd6b19'],14,182,196,1017681,7,0.340909091,0.340909091,1,3247
76323160e8fd9ea2a8fef60f5ab10d8ae066acb7,0,samindaw,2013-01-16 21:03:19+00:00,['eac7b50a8302fb109d591758e9f7513af198f96b'],6,6,12,1017693,4,,,,3247
fbcd8949f639297af01e5f2abb6bfa2add920bb2,0,Lahiru Gunathilake,2013-01-16 21:41:05+00:00,['76323160e8fd9ea2a8fef60f5ab10d8ae066acb7'],28,19,47,1017740,3,0,0,1,3247
948d11529cd42e6c3b649cc212e5477a94d79de4,0,samindaw,2013-01-16 21:52:29+00:00,['fbcd8949f639297af01e5f2abb6bfa2add920bb2'],3,65,68,1017808,3,,,,3247
fe696ac8f1e655087547c1f9fe8638fba76e33af,0,samindaw,2013-01-16 23:24:34+00:00,['948d11529cd42e6c3b649cc212e5477a94d79de4'],4,307,311,1018119,6,0.06741573,0.370786517,1,3251
d138bc6134a2123add311a6dfadecb0327b07be5,0,Lahiru Gunathilake,2013-01-17 16:26:13+00:00,['fe696ac8f1e655087547c1f9fe8638fba76e33af'],8,0,8,1018127,1,1,1,0,3251
d6a877b84664dbb18808441202534b03b4f6ba62,0,Raminderjeet Singh,2013-01-17 16:36:03+00:00,['d138bc6134a2123add311a6dfadecb0327b07be5'],17,17,34,1018161,1,,,,3251
61444ea65a98c7b2acf18a8e4035c1fd8e98afab,0,Raminderjeet Singh,2013-01-17 17:10:18+00:00,['d6a877b84664dbb18808441202534b03b4f6ba62'],1,1,2,1018163,1,,,,3251
1bbbb58dee77b8d001d7ff5b656720a99c5b345b,0,Raminderjeet Singh,2013-01-17 17:15:16+00:00,['61444ea65a98c7b2acf18a8e4035c1fd8e98afab'],3,3,6,1018169,1,,,,3251
cd10e8b6f5ebc367a40a38834e54d34295084535,0,Raminderjeet Singh,2013-01-17 17:16:32+00:00,['1bbbb58dee77b8d001d7ff5b656720a99c5b345b'],0,1,1,1018170,1,1,1,0,3251
7b16ab76f6ae0e9c59cc71e6bafcef94294bb3ef,0,Lahiru Gunathilake,2013-01-17 17:18:28+00:00,['cd10e8b6f5ebc367a40a38834e54d34295084535'],1,3,4,1018174,1,,,,3251
bcb7e100efc350879737418cf49cd50bf5c5b918,0,samindaw,2013-01-17 18:21:07+00:00,['7b16ab76f6ae0e9c59cc71e6bafcef94294bb3ef'],51,95,146,1018320,8,0.25,0,0.541666667,3251
3bf5d7644c63186377621a4e7047d9faa8becebc,0,Lahiru Gunathilake,2013-01-17 19:06:50+00:00,['bcb7e100efc350879737418cf49cd50bf5c5b918'],1,1,2,1018322,1,,,,3251
cbf29ab8a55260c22c9b70acae236846f2c0eba2,0,samindaw,2013-01-17 19:56:24+00:00,['3bf5d7644c63186377621a4e7047d9faa8becebc'],307,0,307,1018629,5,0.93258427,0.629213483,0,3251
49eed392abf8b394dd90fa1e7dfab42d7acbb0f5,0,chathuri,2013-01-17 20:11:45+00:00,['cbf29ab8a55260c22c9b70acae236846f2c0eba2'],9,33,42,1018671,2,0.166666667,0.166666667,0.791666667,3251
ea82909927efc02ec3973a696ac492559994a245,0,Lahiru Gunathilake,2013-01-17 20:25:32+00:00,['49eed392abf8b394dd90fa1e7dfab42d7acbb0f5'],0,2,2,1018673,1,0,0,1,3251
b23bb3cdbc115e710a576f7064741a784a4ce34f,0,amilaj,2013-01-17 22:25:57+00:00,['ea82909927efc02ec3973a696ac492559994a245'],4,13,17,1018690,2,1,1,1,3251
3d2321550422a4324abd466937e189bfe4296880,0,samindaw,2013-01-18 04:29:53+00:00,['b23bb3cdbc115e710a576f7064741a784a4ce34f'],0,129,129,1018819,2,,,,3252
496014b75ebdfb27b304aa430a22ab36e8038cd1,0,chathuri,2013-01-18 13:38:50+00:00,['3d2321550422a4324abd466937e189bfe4296880'],1,159,160,1018979,3,0.323076923,0.323076923,1,3252
eebef371912f42de0225ff9cf729b27300304b66,0,amilaj,2013-01-20 14:36:13+00:00,['496014b75ebdfb27b304aa430a22ab36e8038cd1'],2,2,4,1018983,1,,,,3252
a73f31d137344a6c6b00e23d97dd608ae07ed191,0,Lahiru Gunathilake,2013-01-21 15:39:53+00:00,['eebef371912f42de0225ff9cf729b27300304b66'],52,25,77,1019060,7,,,,3252
cab8be771870aee04cc1453bb152769b3e40c7d7,0,chathuri,2013-01-21 16:26:58+00:00,['a73f31d137344a6c6b00e23d97dd608ae07ed191'],9,3,12,1019072,1,1,0,0,3252
21d04a7d8ecb0c1effc6331418656549760e9718,0,Raminderjeet Singh,2013-01-21 16:57:02+00:00,['cab8be771870aee04cc1453bb152769b3e40c7d7'],2,2,4,1019076,1,1,1,0,3252
071a15b73811b0391795b7407185f3ff9040a78d,0,Lahiru Gunathilake,2013-01-21 17:00:12+00:00,['21d04a7d8ecb0c1effc6331418656549760e9718'],5,0,5,1019081,1,1,0,1,3252
3215b6eb2779f215b773d576bb7c4922137e8f55,0,chathuri,2013-01-21 18:01:20+00:00,['071a15b73811b0391795b7407185f3ff9040a78d'],0,640,640,1019721,6,0.268867925,0.377358491,0.806603774,3257
8dca9dcaeaeb5ae59c5649549e01ccca5a8e24c5,0,Lahiru Gunathilake,2013-01-21 18:02:58+00:00,['3215b6eb2779f215b773d576bb7c4922137e8f55'],1,1,2,1019723,1,0,0,1,3257
fbffe379bd9ce9570e14a6bebe47f844aab7ba4a,0,Lahiru Gunathilake,2013-01-21 18:03:42+00:00,['8dca9dcaeaeb5ae59c5649549e01ccca5a8e24c5'],3,7,10,1019733,2,0,0,1,3257
55c6912bb4716495f8d5c12a28f4330f7e06fa6b,0,Lahiru Gunathilake,2013-01-21 19:44:54+00:00,['fbffe379bd9ce9570e14a6bebe47f844aab7ba4a'],1,1,2,1019735,1,,,,3257
9c904a3acb7c7aa15f8a93afec03a04825782fa3,0,chathuri,2013-01-22 15:43:21+00:00,['55c6912bb4716495f8d5c12a28f4330f7e06fa6b'],300,45,345,1020080,3,1,0,0,3257
111e46eb57cad6724d7dc48bc752f4cbc189446d,0,chathuri,2013-01-22 16:02:25+00:00,['9c904a3acb7c7aa15f8a93afec03a04825782fa3'],2,2,4,1020084,1,,,,3257
06f16faee165d87968390cb30cc08268e33f5255,0,chathuri,2013-01-22 22:18:46+00:00,['111e46eb57cad6724d7dc48bc752f4cbc189446d'],23,39,62,1020146,3,1,1,1,3258
166c639b39bfc5dfa0592a0d38bfec017062f4c8,0,samindaw,2013-01-23 02:33:43+00:00,['06f16faee165d87968390cb30cc08268e33f5255'],14,49,63,1020209,2,,,,3258
ac62918d118d31166b4d288e2b55f0dac00668d0,0,Lahiru Gunathilake,2013-01-23 15:05:29+00:00,['166c639b39bfc5dfa0592a0d38bfec017062f4c8'],38,26,64,1020273,1,,,,3258
2da38ca37eae48d6c24bb50d7f34229aea6bfdc0,0,samindaw,2013-01-23 15:15:32+00:00,['ac62918d118d31166b4d288e2b55f0dac00668d0'],528,0,528,1020801,2,,,,3258
58b664f2411f3268e63a465f0b91e6f7fe4f75bc,0,chathuri,2013-01-23 15:23:37+00:00,['2da38ca37eae48d6c24bb50d7f34229aea6bfdc0'],0,8,8,1020809,4,,,,3258
5072d9404a7023fc3555123cec2e9f3ba516d34b,0,samindaw,2013-01-23 15:30:56+00:00,['58b664f2411f3268e63a465f0b91e6f7fe4f75bc'],2,5,7,1020816,2,,,,3258
75cd574fdf90927e2cb3b1b109a853034afeb0f8,0,chathuri,2013-01-23 15:49:19+00:00,['5072d9404a7023fc3555123cec2e9f3ba516d34b'],2,2,4,1020820,2,,,,3258
cd46a3b5f61fd3b698783e361a2921786a5ff3bd,0,Raminderjeet Singh,2013-01-23 15:58:25+00:00,['75cd574fdf90927e2cb3b1b109a853034afeb0f8'],14,104,118,1020938,3,0.966666667,0.966666667,1,3260
13dd6375ed3bdf460605ab3d436480267c6b8817,0,chathuri,2013-01-23 16:42:26+00:00,['cd46a3b5f61fd3b698783e361a2921786a5ff3bd'],14,11,25,1020963,5,0.666666667,0.666666667,0,3260
f3719c67c6ac74b6f7ad4a354ba2e232739a1a2e,0,chathuri,2013-01-23 16:43:10+00:00,['13dd6375ed3bdf460605ab3d436480267c6b8817'],1,1,2,1020965,1,,,,3260
4b8218a067420a314887c592583ea8082af831b7,0,chathuri,2013-01-23 16:50:23+00:00,['f3719c67c6ac74b6f7ad4a354ba2e232739a1a2e'],0,0,0,1020965,5,,,,3260
3e00a37c4147ce92f547cf6903aa4c3da69d8362,0,chathuri,2013-01-23 19:20:53+00:00,['4b8218a067420a314887c592583ea8082af831b7'],9,56,65,1021030,3,0,0.714285714,0.714285714,3261
aa3095473d37342f6e9d934fd59d6526da89d58d,0,Suresh Marru,2013-01-25 03:11:06+00:00,['3e00a37c4147ce92f547cf6903aa4c3da69d8362'],427,436,863,1021893,1,,,,3261
de3886808463a824a9b8ab3b49c07d8308424b8b,0,Suresh Marru,2013-01-25 03:18:14+00:00,['aa3095473d37342f6e9d934fd59d6526da89d58d'],2,39,41,1021934,1,,,,3261
1c73b3aa28349971440849bb5d3ed6ceef882c2d,0,Suresh Marru,2013-01-25 03:43:20+00:00,['de3886808463a824a9b8ab3b49c07d8308424b8b'],697,1339,2036,1023970,39,0,0.111111111,1,3261
a192583d446c5a2387354240fff18eea06f459c6,0,Suresh Marru,2013-01-25 04:22:33+00:00,['1c73b3aa28349971440849bb5d3ed6ceef882c2d'],99,408,507,1024477,21,,1,,3261
3b473226b8312ed9e673dccd9c544895b2b3810b,0,Suresh Marru,2013-01-25 04:29:30+00:00,['a192583d446c5a2387354240fff18eea06f459c6'],6,5,11,1024488,5,,,,3261
40e1ff15a2e19cff9b99bfa47d296a2d96e784ad,0,Suresh Marru,2013-01-25 05:19:31+00:00,['3b473226b8312ed9e673dccd9c544895b2b3810b'],12,31,43,1024531,3,,,,3261
bad68e7a4ba20a3ced6cc146830641553b18be87,0,samindaw,2013-01-25 15:49:35+00:00,['40e1ff15a2e19cff9b99bfa47d296a2d96e784ad'],10,5198,5208,1029739,22,,,,3276
dbb379d7e4aeee577f4e9c61ea816b834ac2401d,0,Heshan Theekshana Suriyaarachchi,2013-01-25 17:46:10+00:00,['bad68e7a4ba20a3ced6cc146830641553b18be87'],1,1,2,1029741,1,,,,3276
9b0d0029fa023d9d51cea5dae19ee3404656e67a,0,samindaw,2013-01-25 17:52:39+00:00,['dbb379d7e4aeee577f4e9c61ea816b834ac2401d'],114,170,284,1030025,14,,,,3276
34bd48917ec7da50cfd83f0f541179fab7f7ecf3,0,samindaw,2013-01-25 19:50:51+00:00,['9b0d0029fa023d9d51cea5dae19ee3404656e67a'],0,166,166,1030191,6,,,,3276
41e78c1ccf4dfd4a180ba0c2f80d892d45fa1466,0,Suresh Marru,2013-01-25 20:36:07+00:00,['34bd48917ec7da50cfd83f0f541179fab7f7ecf3'],106,113,219,1030410,6,,,,3276
5afe1f036eb3c0b1c58a9282f310d7c88b6cf708,0,samindaw,2013-01-25 20:48:10+00:00,['41e78c1ccf4dfd4a180ba0c2f80d892d45fa1466'],0,1,1,1030411,1,,,,3276
986862a5e4dd9f44b707a99c16d4f1a93eeb6ba1,0,samindaw,2013-01-26 00:51:20+00:00,['5afe1f036eb3c0b1c58a9282f310d7c88b6cf708'],134,111,245,1030656,48,,,,3276
ba7311b283fc8d10e702325b2ed6a4dae4e7276c,0,samindaw,2013-01-26 00:51:42+00:00,['986862a5e4dd9f44b707a99c16d4f1a93eeb6ba1'],52,52,104,1030760,48,,,,3276
9864280825962ff2457e4998f38a395352cdf4e9,0,samindaw,2013-01-26 01:19:53+00:00,['ba7311b283fc8d10e702325b2ed6a4dae4e7276c'],108,131,239,1030999,48,,,,3276
52f399c4c81abf27047d05a0374804124e10d2b4,0,samindaw,2013-01-26 02:02:14+00:00,['9864280825962ff2457e4998f38a395352cdf4e9'],134,111,245,1031244,48,,,,3276
29fc5c0c6c3c3b65699a0b21ddceb6383c5205f1,0,samindaw,2013-01-26 02:02:49+00:00,['52f399c4c81abf27047d05a0374804124e10d2b4'],52,52,104,1031348,48,,,,3276
d93840a50563e9df1e246a110a49bc38eb48fe54,0,Suresh Marru,2013-01-27 01:04:09+00:00,['29fc5c0c6c3c3b65699a0b21ddceb6383c5205f1'],2,2,4,1031352,1,,,,3276
b2e6c57d6a0c09730190b4fcdef58ee845a12120,0,Lahiru Gunathilake,2013-01-29 03:57:41+00:00,['d93840a50563e9df1e246a110a49bc38eb48fe54'],0,2308,2308,1033660,31,0.520283976,0.632860041,0.927991886,3306
ef8bfeac11f7fbe9fec615e2e1f446e497f69687,0,Lahiru Gunathilake,2013-01-29 17:41:15+00:00,['b2e6c57d6a0c09730190b4fcdef58ee845a12120'],13,234,247,1033907,7,0.130434783,1,1,3308
8bf3e456badad61178e759a9ec6ad04c96cf8035,0,chathuri,2013-01-29 22:21:25+00:00,['ef8bfeac11f7fbe9fec615e2e1f446e497f69687'],27,39,66,1033973,6,1,1,1,3308
2f0c0d89bdb7db86ad47fa408a31ddfce717ce99,0,Lahiru Gunathilake,2013-01-30 21:31:37+00:00,['8bf3e456badad61178e759a9ec6ad04c96cf8035'],3,1205,1208,1035181,12,0.284539474,0.284539474,0.565789474,3318
42773c054214176f309cf249e64e5fbac6887d10,0,Lahiru Gunathilake,2013-01-31 19:52:57+00:00,['2f0c0d89bdb7db86ad47fa408a31ddfce717ce99'],16,654,670,1035851,9,0.13961039,0.376623377,0.977272727,3322
3654065ebe41846c50abf7299aded4b29f46510a,0,Lahiru Gunathilake,2013-01-31 19:58:25+00:00,['42773c054214176f309cf249e64e5fbac6887d10'],1,1,2,1035853,1,,,,3322
f96bbfe5861a8db73c9cebb98d57897f69b06c08,0,Lahiru Gunathilake,2013-01-31 21:29:55+00:00,['3654065ebe41846c50abf7299aded4b29f46510a'],12,184,196,1036049,4,0.011627907,0.011627907,0.953488372,3322
a2044e47a40d9c15ec1a3e2377bacf4781dd0a6a,0,Lahiru Gunathilake,2013-01-31 21:36:31+00:00,['f96bbfe5861a8db73c9cebb98d57897f69b06c08'],1,1,2,1036051,1,,,,3322
2aa31d6a2ab08f68379b3bc1a7edad5881dd0e54,0,Lahiru Gunathilake,2013-01-31 22:16:49+00:00,['a2044e47a40d9c15ec1a3e2377bacf4781dd0a6a'],6,3,9,1036060,1,,,,3322
8cc629f0a0e8e342d50c15bc757d3132e476214d,0,Lahiru Gunathilake,2013-02-01 21:59:14+00:00,['2aa31d6a2ab08f68379b3bc1a7edad5881dd0e54'],78,189,267,1036327,4,0.142857143,0.142857143,0.945578231,3322
121a88ed41520b1269f50e459fa2aef6bdcd2419,0,Lahiru Gunathilake,2013-02-01 22:00:30+00:00,['8cc629f0a0e8e342d50c15bc757d3132e476214d'],0,291,291,1036618,1,0.010989011,1,1,3323
d4efab1bfb24c498f1ec2b729f39bdb5c8508917,0,Heshan Theekshana Suriyaarachchi,2013-02-03 04:04:13+00:00,['121a88ed41520b1269f50e459fa2aef6bdcd2419'],0,611,611,1037229,5,0.280453258,0.628895184,0.538243626,3328
f42790f152148c703998ca02f47619a6e9ea0357,1,amilaj,2013-02-04 17:40:18+00:00,['d4efab1bfb24c498f1ec2b729f39bdb5c8508917'],87,2927,3014,1040243,42,0.41778697,0.901758014,0.971044467,3352
1535be0c76fd312e6cbd22f1766621f97bbb8002,0,amilaj,2013-02-04 20:24:37+00:00,['f42790f152148c703998ca02f47619a6e9ea0357'],0,122,122,1040365,8,,,,3360
0eaccbff02ac9cd4894800e71d6f5a5e69e76aaf,0,Lahiru Gunathilake,2013-02-05 16:23:42+00:00,['1535be0c76fd312e6cbd22f1766621f97bbb8002'],0,1,1,1040366,1,0,1,1,3360
1ba4587f0f352c66afc300f0470b2250eefc2db7,0,Lahiru Gunathilake,2013-02-05 23:08:46+00:00,['0eaccbff02ac9cd4894800e71d6f5a5e69e76aaf'],0,4,4,1040370,1,1,1,1,3360
444a9a31ce1a9a76f84416af6e80a2079ecb5c2f,0,Lahiru Gunathilake,2013-02-05 23:09:37+00:00,['1ba4587f0f352c66afc300f0470b2250eefc2db7'],0,452,452,1040822,4,0.101818182,0.101818182,0.912727273,3363
8e1913779478e19d89b8e6caba9748c455d76640,0,Lahiru Gunathilake,2013-02-05 23:10:18+00:00,['444a9a31ce1a9a76f84416af6e80a2079ecb5c2f'],331,145,476,1041298,7,1,1,0.033519553,3363
034fbeaf314291fe7578dfd86d05b6e3128695c2,0,Lahiru Gunathilake,2013-02-05 23:11:47+00:00,['8e1913779478e19d89b8e6caba9748c455d76640'],10,32,42,1041340,3,0,1,1,3364
65fa1b5bdc293123f6d3123ea275afa28d5a867d,0,Lahiru Gunathilake,2013-02-07 17:18:38+00:00,['034fbeaf314291fe7578dfd86d05b6e3128695c2'],177,228,405,1041745,22,0.388888889,1,0.388888889,3365
557a1aa9e2f925bcf23db5f465d398f07e43e17e,0,Lahiru Gunathilake,2013-02-07 17:19:58+00:00,['65fa1b5bdc293123f6d3123ea275afa28d5a867d'],52,21,73,1041818,2,0,0,0,3365
382acc03faa7dc5cb22b89304b6abb81d81a54ea,0,Lahiru Gunathilake,2013-02-07 17:20:35+00:00,['557a1aa9e2f925bcf23db5f465d398f07e43e17e'],185,240,425,1042243,10,0,1,0,3365
69ae1837238279a107b2df169ad48ca4a218e202,0,Lahiru Gunathilake,2013-02-07 17:21:14+00:00,['382acc03faa7dc5cb22b89304b6abb81d81a54ea'],231,264,495,1042738,3,,,,3366
3f0cc900d518e69c536fabd4a25b8352b0c661d3,0,Lahiru Gunathilake,2013-02-07 17:24:19+00:00,['69ae1837238279a107b2df169ad48ca4a218e202'],0,6,6,1042744,2,,,,3366
9428edaa3d2b6c49812e002cbf4d9f161c0f87b6,0,Lahiru Gunathilake,2013-02-07 18:43:44+00:00,['3f0cc900d518e69c536fabd4a25b8352b0c661d3'],19,48,67,1042811,5,0.24,0.24,1,3366
0296dd00bf917151418497674d316114b2548a38,0,samindaw,2013-02-08 19:59:02+00:00,['9428edaa3d2b6c49812e002cbf4d9f161c0f87b6'],1322,77,1399,1044210,17,0.847082495,0.428571429,0.175050302,3366
8eb7f2acc13fe354e3c57b7b023e1deb88d3e179,0,Lahiru Gunathilake,2013-02-08 23:05:26+00:00,['0296dd00bf917151418497674d316114b2548a38'],3,67,70,1044280,4,1,1,1,3367
97a2b09e6417a6e534f30a9b62421efd234e4731,0,Lahiru Gunathilake,2013-02-08 23:06:06+00:00,['8eb7f2acc13fe354e3c57b7b023e1deb88d3e179'],3,8,11,1044291,1,,,,3367
aa59f015a07b206e04ab600ad8b221421241f107,0,Raminderjeet Singh,2013-02-15 18:35:27+00:00,['97a2b09e6417a6e534f30a9b62421efd234e4731'],5,5,10,1044301,1,,,,3367
1b0126c163895500bc6ad80a7d348f27e56a9b25,0,Raminderjeet Singh,2013-02-15 18:37:32+00:00,['aa59f015a07b206e04ab600ad8b221421241f107'],3,10,13,1044314,1,0,0,1,3367
3f8ad4d6048d5063a8cb239efcb84c1169939bed,0,Lahiru Gunathilake,2013-02-19 15:58:25+00:00,['1b0126c163895500bc6ad80a7d348f27e56a9b25'],3,15,18,1044332,2,0.857142857,1,1,3367
254634222281f39fad578866ed2653aae3c57646,0,Lahiru Gunathilake,2013-02-19 16:02:07+00:00,['3f8ad4d6048d5063a8cb239efcb84c1169939bed'],43,60,103,1044435,2,0.117647059,0.117647059,1,3367
a3c8c03f4b666f0b586deedbb32844c038dba3fb,0,Lahiru Gunathilake,2013-02-21 15:19:13+00:00,['254634222281f39fad578866ed2653aae3c57646'],136,402,538,1044973,21,0.205882353,0.333333333,1,3367
e0023b9adf572697cf25b096d255484ae5b93e06,0,Lahiru Gunathilake,2013-02-21 15:35:22+00:00,['a3c8c03f4b666f0b586deedbb32844c038dba3fb'],0,717,717,1045690,3,0.084033613,0.084033613,1,3370
0490920ef4bac3bcb1023f8d38bb601ae7a81702,0,Lahiru Gunathilake,2013-02-21 15:37:25+00:00,['e0023b9adf572697cf25b096d255484ae5b93e06'],0,1494,1494,1047184,8,0.580217129,0.627261761,0.788902292,3378
a12bb2e6420f7e8e1c5ad8e25c98d8cbd21145a2,0,Lahiru Gunathilake,2013-02-21 16:18:40+00:00,['0490920ef4bac3bcb1023f8d38bb601ae7a81702'],5,5,10,1047194,1,0,0,0,3378
eadb74e002c59190467380cf9e39c8fb6ccb3fd0,0,Lahiru Gunathilake,2013-02-22 18:01:10+00:00,['a12bb2e6420f7e8e1c5ad8e25c98d8cbd21145a2'],88,25,113,1047307,1,,,,3378
7f106f195aa925718c9dc03edb41fa4f85b4b84a,0,Suresh Marru,2013-02-23 16:21:36+00:00,['eadb74e002c59190467380cf9e39c8fb6ccb3fd0'],20,35,55,1047362,2,,,,3378
07ee7840d4835ba3919c76d4a6c50d6f06ef7583,0,Suresh Marru,2013-02-24 03:07:31+00:00,['7f106f195aa925718c9dc03edb41fa4f85b4b84a'],21,8,29,1047391,2,,,,3378
00294df8ceca387f13579faa3ac23abdf14c7bce,0,Lahiru Gunathilake,2013-02-26 20:43:39+00:00,['07ee7840d4835ba3919c76d4a6c50d6f06ef7583'],29,62,91,1047482,2,,,,3378
9a611176fe5b372e65c0e46950f409ea1b26f5c8,0,Lahiru Gunathilake,2013-02-26 20:55:36+00:00,['00294df8ceca387f13579faa3ac23abdf14c7bce'],30,662,692,1048174,5,0.494699647,0.802120141,0.915194346,3382
b6dbf063992a1475e66f2dd4194af8e8559a87fc,0,Lahiru Gunathilake,2013-02-26 21:04:01+00:00,['9a611176fe5b372e65c0e46950f409ea1b26f5c8'],0,9,9,1048183,1,,,,3382
c6489e4c0f8dd904c73c476ec5542ec09fca5e01,0,Lahiru Gunathilake,2013-02-26 21:04:35+00:00,['b6dbf063992a1475e66f2dd4194af8e8559a87fc'],0,74,74,1048257,3,,,,3382
12c42d86dba0ee3390f39a97c33772a30fc658fd,0,Raminderjeet Singh,2013-02-28 00:26:09+00:00,['c6489e4c0f8dd904c73c476ec5542ec09fca5e01'],983,1490,2473,1050730,17,0.532818533,0.982625483,0.920849421,3390
ec8efb1e8495479145ae9d6e8e3f43ba7cab73a2,0,Heshan Theekshana Suriyaarachchi,2013-03-04 16:20:09+00:00,['12c42d86dba0ee3390f39a97c33772a30fc658fd'],21,13,34,1050764,12,,,,3390
68cddff72dd485490d452ec28a5ab80f4c20cf18,1,Heshan Theekshana Suriyaarachchi,2013-03-04 17:19:57+00:00,['ec8efb1e8495479145ae9d6e8e3f43ba7cab73a2'],1,1,2,1050766,1,,,,3390
6e68f3a5a6a62a478cc44f3a213850b4076e9331,0,Heshan Theekshana Suriyaarachchi,2013-03-04 20:38:54+00:00,['68cddff72dd485490d452ec28a5ab80f4c20cf18'],101,144,245,1051011,6,1,0,0.481481481,3391
8866c2d198734d580be2f956f29be31ae50c4b7e,0,Lahiru Gunathilake,2013-03-04 21:08:03+00:00,['6e68f3a5a6a62a478cc44f3a213850b4076e9331'],7109,0,7109,1058120,65,0.681997372,0.598226018,0.194480946,3391
d1ad8a160128ef91d1b4d50e06c27a0056e64572,0,Lahiru Gunathilake,2013-03-05 16:25:46+00:00,['8866c2d198734d580be2f956f29be31ae50c4b7e'],18,17,35,1058155,1,0,0,0,3391
17cc3b3fad68b2631593f2db0f5831d846fd5d2a,0,Lahiru Gunathilake,2013-03-05 16:26:42+00:00,['d1ad8a160128ef91d1b4d50e06c27a0056e64572'],781,0,781,1058936,4,1,0,0,3391
457ebc610ac3d2a5758f32554b06d01feaea8548,0,Heshan Theekshana Suriyaarachchi,2013-03-06 15:38:52+00:00,['17cc3b3fad68b2631593f2db0f5831d846fd5d2a'],1,6,7,1058943,1,1,1,1,3391
67c9499e33fb9499fa22f2dd287199eaba8d79bd,0,Heshan Theekshana Suriyaarachchi,2013-03-06 15:47:22+00:00,['457ebc610ac3d2a5758f32554b06d01feaea8548'],91,71,162,1059105,5,0,0,0,3391
fa9267c07961943c0855f838d2badaa51b71a752,0,Heshan Theekshana Suriyaarachchi,2013-03-06 15:57:54+00:00,['67c9499e33fb9499fa22f2dd287199eaba8d79bd'],372,377,749,1059854,3,0.668711656,0.392638037,0,3391
73edb60b5faf961dd50edf43446af38710287d67,0,Heshan Theekshana Suriyaarachchi,2013-03-06 16:40:32+00:00,['fa9267c07961943c0855f838d2badaa51b71a752'],0,5,5,1059859,1,,,,3391
b872a33248fcfc3c6c91d06b1665ff09cfa12141,0,Heshan Theekshana Suriyaarachchi,2013-03-06 16:43:23+00:00,['73edb60b5faf961dd50edf43446af38710287d67'],4,4,8,1059867,1,1,1,0,3391
44d63173fefddf17905782c4326cd4dc43997f3e,0,Heshan Theekshana Suriyaarachchi,2013-03-08 00:44:11+00:00,['b872a33248fcfc3c6c91d06b1665ff09cfa12141'],678,0,678,1060545,1,,,,3391
19cfaa490551caa2dd8c87a8e63c817d055e0d2b,0,Heshan Theekshana Suriyaarachchi,2013-03-08 00:48:23+00:00,['44d63173fefddf17905782c4326cd4dc43997f3e'],71,42,113,1060658,1,0.5,0.5,1,3391
c9e03668f22c2c1f63879f12ea3fac7021e7fc67,0,Heshan Theekshana Suriyaarachchi,2013-03-08 01:06:30+00:00,['19cfaa490551caa2dd8c87a8e63c817d055e0d2b'],33,54,87,1060745,1,0,1,1,3391
f5336641d4353ec391f21936808161cb459cbb51,0,Heshan Theekshana Suriyaarachchi,2013-03-08 01:13:33+00:00,['c9e03668f22c2c1f63879f12ea3fac7021e7fc67'],28,14,42,1060787,1,0,0,0,3391
1ceec900b178e63c362bbd575a9f0ebaaa4077c8,0,Heshan Theekshana Suriyaarachchi,2013-03-08 01:51:17+00:00,['f5336641d4353ec391f21936808161cb459cbb51'],1,78,79,1060866,1,0,0,1,3391
5ab04810e0d5dbe6f7a480901ffedfce1bafb226,0,Heshan Theekshana Suriyaarachchi,2013-03-08 15:45:47+00:00,['1ceec900b178e63c362bbd575a9f0ebaaa4077c8'],36,19,55,1060921,1,1,1,0,3391
d2c2dc6738513e5372b4eac3935a810ed17c769e,0,Heshan Theekshana Suriyaarachchi,2013-03-08 18:39:46+00:00,['5ab04810e0d5dbe6f7a480901ffedfce1bafb226'],15,34,49,1060970,3,0.769230769,0.923076923,0.846153846,3392
1a2a55ac23018dc2e97675f3e6542058ad14cd1e,0,Heshan Theekshana Suriyaarachchi,2013-03-08 19:14:13+00:00,['d2c2dc6738513e5372b4eac3935a810ed17c769e'],528,1,529,1061499,5,0.797297297,0.442567568,0.550675676,3392
aa47f3841cde2330a188c32e553d0d8d844d7857,0,Heshan Theekshana Suriyaarachchi,2013-03-08 21:07:22+00:00,['1a2a55ac23018dc2e97675f3e6542058ad14cd1e'],1,14,15,1061514,1,,,,3392
740c24d8f888afd4e29d98a463f75e7542a21df2,0,Heshan Theekshana Suriyaarachchi,2013-03-08 21:31:21+00:00,['aa47f3841cde2330a188c32e553d0d8d844d7857'],0,155,155,1061669,1,0.102941176,1,1,3393
f69cc18adf45b4bd5bcf6987a5e0afefcbbac6bb,0,Heshan Theekshana Suriyaarachchi,2013-03-08 21:32:58+00:00,['740c24d8f888afd4e29d98a463f75e7542a21df2'],3,25,28,1061697,2,0,1,0,3393
4382927034237f6b780e1321b69b0b7d0b194e55,0,Heshan Theekshana Suriyaarachchi,2013-03-08 21:36:06+00:00,['f69cc18adf45b4bd5bcf6987a5e0afefcbbac6bb'],3,2,5,1061702,1,,,,3393
8c8f667be61896fed1fb7a5aa2da104fd9a5a4c1,0,Heshan Theekshana Suriyaarachchi,2013-03-08 22:23:09+00:00,['4382927034237f6b780e1321b69b0b7d0b194e55'],0,5,5,1061707,1,,,,3393
07009cba4296d915c767114e50e778282dd25e08,0,Heshan Theekshana Suriyaarachchi,2013-03-08 23:56:19+00:00,['8c8f667be61896fed1fb7a5aa2da104fd9a5a4c1'],0,2,2,1061709,1,0,1,1,3393
d1e9717d5373a24075688e457a3bb8130022089d,0,Heshan Theekshana Suriyaarachchi,2013-03-09 02:07:32+00:00,['07009cba4296d915c767114e50e778282dd25e08'],13,15,28,1061737,1,0,0,1,3393
cdb3ccd2c9d31fde5a0d5917d7095022c7195a1f,0,Heshan Theekshana Suriyaarachchi,2013-03-09 02:24:55+00:00,['d1e9717d5373a24075688e457a3bb8130022089d'],7,37,44,1061781,1,0.636363636,0.636363636,1,3393
18d1d2c0707b741516b590783fc3c56a77efa4e6,0,Heshan Theekshana Suriyaarachchi,2013-03-09 04:05:01+00:00,['cdb3ccd2c9d31fde5a0d5917d7095022c7195a1f'],25,28,53,1061834,2,0,0,1,3393
9eea56025b0ff4d683ce1f45ffa2bce5ec3db154,0,Heshan Theekshana Suriyaarachchi,2013-03-09 05:00:21+00:00,['18d1d2c0707b741516b590783fc3c56a77efa4e6'],0,30,30,1061864,1,0,0.941176471,1,3393
8b63a82226c95489def3015ceb51c8ac1fb3b4b9,0,Heshan Theekshana Suriyaarachchi,2013-03-12 14:41:26+00:00,['9eea56025b0ff4d683ce1f45ffa2bce5ec3db154'],0,420,420,1062284,4,0.497326203,0.668449198,0.577540107,3397
318cfe15abff52952203913fa2f4d5579a433bce,0,Raminderjeet Singh,2013-03-12 16:43:01+00:00,['8b63a82226c95489def3015ceb51c8ac1fb3b4b9'],0,0,0,1062284,0,,,,3397
2336cccb595e4c8ff4291bc6cf7f37e330390666,0,Raminderjeet Singh,2013-03-12 16:44:26+00:00,['318cfe15abff52952203913fa2f4d5579a433bce'],10,20,30,1062314,1,,,,3397
56d0bf08309f5bc34692a47e844b5d8e24a5ec00,0,Raminderjeet Singh,2013-03-12 16:52:19+00:00,['2336cccb595e4c8ff4291bc6cf7f37e330390666'],726,1252,1978,1064292,32,0.119122257,0.692789969,1,3402
c636dc3fc7afc5fb2a32a2c04713f60138387992,0,Raminderjeet Singh,2013-03-12 16:56:11+00:00,['56d0bf08309f5bc34692a47e844b5d8e24a5ec00'],1,2,3,1064295,1,,,,3402
7d788df1714c542e797d49e3ca3569f07693eafb,0,Raminderjeet Singh,2013-03-12 16:59:08+00:00,['c636dc3fc7afc5fb2a32a2c04713f60138387992'],2,2,4,1064299,2,,,,3402
8f7ee8437bd9fe58c05bcf260f93d3fc38bf3ce4,0,Raminderjeet Singh,2013-03-12 20:52:58+00:00,['7d788df1714c542e797d49e3ca3569f07693eafb'],0,10,10,1064309,1,,,,3402
36a307b0759a0ec922dabb6bd82d1cf8ec9c5207,0,Raminderjeet Singh,2013-03-13 14:59:10+00:00,['8f7ee8437bd9fe58c05bcf260f93d3fc38bf3ce4'],9,72,81,1064390,1,0,1,0,3402
7c52fa8024c10cc92f150345cfce6b4aafd5beef,0,Raminderjeet Singh,2013-03-13 19:14:05+00:00,['36a307b0759a0ec922dabb6bd82d1cf8ec9c5207'],51,78,129,1064519,1,0,0,1,3402
3c412b4b653ef94dc36261eb658b7a8227106a73,0,Raminderjeet Singh,2013-03-13 19:17:40+00:00,['7c52fa8024c10cc92f150345cfce6b4aafd5beef'],42,75,117,1064636,3,0,0.277777778,0.722222222,3402
6f0a3778bf8bf5344ecd18cf800556859e2f3b32,0,Raminderjeet Singh,2013-03-13 19:39:20+00:00,['3c412b4b653ef94dc36261eb658b7a8227106a73'],9,10,19,1064655,1,,,,3402
5a4ff09e69a9db135f654c15344cd6a667667561,0,Lahiru Gunathilake,2013-03-19 15:29:03+00:00,['6f0a3778bf8bf5344ecd18cf800556859e2f3b32'],0,7,7,1064662,1,,,,3402
d52cdf742627fa3337e127a9c47580c9bf771233,0,Lahiru Gunathilake,2013-03-19 15:30:19+00:00,['5a4ff09e69a9db135f654c15344cd6a667667561'],1,6,7,1064669,1,0,0,1,3402
e7ed8a57e291b5ab13b2c5236269acb7a121c047,0,amilaj,2013-03-20 23:15:55+00:00,['d52cdf742627fa3337e127a9c47580c9bf771233'],9,14,23,1064692,3,,,,3402
2007337f201dbf384d164f51c0490926512ec3ac,0,Suresh Marru,2013-03-21 15:21:34+00:00,['e7ed8a57e291b5ab13b2c5236269acb7a121c047'],0,0,0,1064692,0,,,,3402
4bcbc312fe0b7ef751b7a599e8d362a8cd741374,0,Raminderjeet Singh,2013-03-21 18:06:55+00:00,['2007337f201dbf384d164f51c0490926512ec3ac'],559,824,1383,1066075,11,0.565789474,1,1,3403
4ab2a482ce196a384f8a0c540ece1103f995e936,0,Lahiru Gunathilake,2013-03-21 19:10:48+00:00,['4bcbc312fe0b7ef751b7a599e8d362a8cd741374'],1,11,12,1066087,2,1,1,1,3403
0f6c23164392b16a626eb954cc4f8bbac9f9af37,0,Lahiru Gunathilake,2013-03-21 19:30:24+00:00,['4ab2a482ce196a384f8a0c540ece1103f995e936'],1,12,13,1066100,1,0,0,1,3403
212078336b6c734aecee19d4e6c70ce45a8e97a9,0,amilaj,2013-03-21 20:09:43+00:00,['0f6c23164392b16a626eb954cc4f8bbac9f9af37'],3,30,33,1066133,1,0,0,1,3403
b18d20b8c45f1d3255b06098474884707f5a04c5,0,amilaj,2013-03-22 15:00:37+00:00,['212078336b6c734aecee19d4e6c70ce45a8e97a9'],1,3,4,1066137,1,1,1,1,3403
1483d80472f22d664425d431fdef3eaf44a1b2b7,0,Lahiru Gunathilake,2013-03-22 15:32:55+00:00,['b18d20b8c45f1d3255b06098474884707f5a04c5'],2,7,9,1066146,1,0,0,1,3403
7c0b6447b17e05e4f0d3d5eeb15b5edf0cdc748b,0,Heshan Theekshana Suriyaarachchi,2013-03-22 16:01:32+00:00,['1483d80472f22d664425d431fdef3eaf44a1b2b7'],0,139,139,1066285,1,0.227272727,1,1,3404
82acb6d31ad81eee1aa3d214aa01fd1b3e721fd7,0,Heshan Theekshana Suriyaarachchi,2013-03-22 16:02:21+00:00,['7c0b6447b17e05e4f0d3d5eeb15b5edf0cdc748b'],47,8,55,1066340,1,1,1,1,3404
cd201efbe9443bd5675d3ebd7f88cafdec5a0451,0,Heshan Theekshana Suriyaarachchi,2013-03-22 16:02:56+00:00,['82acb6d31ad81eee1aa3d214aa01fd1b3e721fd7'],2,2,4,1066344,1,,,,3404
7c1682287a7c76c1ee135e2073d6214f6c920042,0,Suresh Marru,2013-03-26 03:24:19+00:00,['cd201efbe9443bd5675d3ebd7f88cafdec5a0451'],1,1,2,1066346,1,,,,3404
1c04caa54a281063bec46b5e781c1eb82cdb5b39,0,Lahiru Gunathilake,2013-03-26 18:00:48+00:00,['7c1682287a7c76c1ee135e2073d6214f6c920042'],1,1,2,1066348,1,,,,3404
35317021e53484bd362d763d94407f3a8fffd057,0,Suresh Marru,2013-03-26 18:32:18+00:00,['1c04caa54a281063bec46b5e781c1eb82cdb5b39'],1,1,2,1066350,1,,,,3404
ec3e7e55a2e8a47f0dfda5a96e877eddd894dcd5,0,Heshan Theekshana Suriyaarachchi,2013-03-27 18:34:39+00:00,['35317021e53484bd362d763d94407f3a8fffd057'],25,38,63,1066413,2,,,,3405
498ea2d6f592530c311fa459ff1659581933237a,0,Heshan Theekshana Suriyaarachchi,2013-03-27 18:55:11+00:00,['ec3e7e55a2e8a47f0dfda5a96e877eddd894dcd5'],14,41,55,1066468,2,0,1,1,3405
c93994686c5139ca69c0b5e71cdcde18551e9fbb,0,Heshan Theekshana Suriyaarachchi,2013-03-28 14:46:04+00:00,['498ea2d6f592530c311fa459ff1659581933237a'],125,244,369,1066837,10,0.61971831,0.887323944,0.943661972,3407
e94a5a88900ca1fe35c7a0dd512cba9e7da99527,0,Heshan Theekshana Suriyaarachchi,2013-03-28 14:52:18+00:00,['c93994686c5139ca69c0b5e71cdcde18551e9fbb'],8,12,20,1066857,1,1,1,1,3407
a1a54f25f844c10f8aaf39bcafe3c462c5d9e4cf,0,samindaw,2013-03-28 19:47:14+00:00,['e94a5a88900ca1fe35c7a0dd512cba9e7da99527'],0,1,1,1066858,1,1,1,1,3407
af89a1580c8c53adb848397b42263b5384ca8520,0,samindaw,2013-03-28 19:55:23+00:00,['a1a54f25f844c10f8aaf39bcafe3c462c5d9e4cf'],1,1,2,1066860,1,,,,3407
e0a6fbdb9d6909b90a828a5e86f7758fb280455e,0,samindaw,2013-03-28 20:14:06+00:00,['af89a1580c8c53adb848397b42263b5384ca8520'],1,4,5,1066865,1,1,1,1,3407
1a2c2654df56636e0c373c4dd37cbfaf0196a820,0,Heshan Theekshana Suriyaarachchi,2013-03-29 03:17:51+00:00,['e0a6fbdb9d6909b90a828a5e86f7758fb280455e'],14,14,28,1066893,1,0,1,1,3407
afed7a368e8bcbeb96e7e0a3c34ef3d7d45f1dcc,0,Heshan Theekshana Suriyaarachchi,2013-03-29 03:21:09+00:00,['1a2c2654df56636e0c373c4dd37cbfaf0196a820'],1,1,2,1066895,1,,,,3407
04759d95d44a78ede5487187a74737812c08bfe9,0,Heshan Theekshana Suriyaarachchi,2013-03-29 04:26:17+00:00,['afed7a368e8bcbeb96e7e0a3c34ef3d7d45f1dcc'],3,2,5,1066900,1,,,,3407
86de17f8ffb98e5b6c919d08e7ab708bc078c8d5,0,Heshan Theekshana Suriyaarachchi,2013-03-29 04:58:38+00:00,['04759d95d44a78ede5487187a74737812c08bfe9'],216,120,336,1067236,9,0,0,0.5,3407
1806e4b79766a2af8a08ff65f6c01b1862c11761,0,samindaw,2013-03-29 21:16:52+00:00,['86de17f8ffb98e5b6c919d08e7ab708bc078c8d5'],0,18,18,1067254,1,,,,3408
e185a5e54a8d45e707c21ce46d6e8c7a02f4ae1d,0,samindaw,2013-03-31 17:31:11+00:00,['1806e4b79766a2af8a08ff65f6c01b1862c11761'],8,41,49,1067303,4,0,0,1,3408
67cf6ff818db82592cfc6ca9c2ebf5546ebcfdac,0,Heshan Theekshana Suriyaarachchi,2013-03-31 18:06:09+00:00,['e185a5e54a8d45e707c21ce46d6e8c7a02f4ae1d'],2,2,4,1067307,1,0,0,0,3408
082c769f16fb6c38f6e7989dd7d2f03162cefe52,0,samindaw,2013-03-31 21:38:48+00:00,['67cf6ff818db82592cfc6ca9c2ebf5546ebcfdac'],13,17,30,1067337,3,0.666666667,0.666666667,1,3408
09d5ca4cd77d14d83b78a614ee57086ee269e594,0,Heshan Theekshana Suriyaarachchi,2013-04-01 14:37:52+00:00,['082c769f16fb6c38f6e7989dd7d2f03162cefe52'],5,2,7,1067344,1,,,,3408
c9357a983e65325f6b52f38c8975ec20ab4e279a,0,Heshan Theekshana Suriyaarachchi,2013-04-01 14:41:17+00:00,['09d5ca4cd77d14d83b78a614ee57086ee269e594'],80,43,123,1067467,1,1,1,0,3408
0538d4a4b6ba5210884d763f857511b8ee30cf31,0,Heshan Theekshana Suriyaarachchi,2013-04-02 00:22:41+00:00,['c9357a983e65325f6b52f38c8975ec20ab4e279a'],4,29,33,1067500,1,0,0,1,3408
d6c18532e1b4b5df1feef19241e0617656f3acb6,0,Heshan Theekshana Suriyaarachchi,2013-04-02 00:26:37+00:00,['0538d4a4b6ba5210884d763f857511b8ee30cf31'],27,16,43,1067543,1,1,1,0,3408
a8f8a1a5911626f7d1dbb0dff57477a69ec90c06,0,Heshan Theekshana Suriyaarachchi,2013-04-02 00:58:01+00:00,['d6c18532e1b4b5df1feef19241e0617656f3acb6'],22,38,60,1067603,2,0,0.333333333,0.833333333,3408
0db9d10729fc79f938497ec4dbfde23067d092a6,0,Heshan Theekshana Suriyaarachchi,2013-04-02 01:00:57+00:00,['a8f8a1a5911626f7d1dbb0dff57477a69ec90c06'],20,10,30,1067633,3,0,0,1,3408
2618b0c1b18144f9083a6a367d6faea04da3413e,0,Heshan Theekshana Suriyaarachchi,2013-04-02 03:48:01+00:00,['0db9d10729fc79f938497ec4dbfde23067d092a6'],1,1,2,1067635,1,,,,3408
d5de803a2c53a205a45720ead3708eff9f062a81,0,Heshan Theekshana Suriyaarachchi,2013-04-02 03:48:58+00:00,['2618b0c1b18144f9083a6a367d6faea04da3413e'],5,2,7,1067642,1,,,,3408
c7b1c730eb6feb89b62b649bd3f5c63c7e3f42c1,0,Heshan Theekshana Suriyaarachchi,2013-04-02 13:03:06+00:00,['d5de803a2c53a205a45720ead3708eff9f062a81'],3,3,6,1067648,1,,,,3408
eeda792450452e9890ee25a3152db9f6fa687aad,0,Lahiru Gunathilake,2013-04-04 19:40:24+00:00,['c7b1c730eb6feb89b62b649bd3f5c63c7e3f42c1'],27,442,469,1068117,3,,,,3408
38bf2ffd7f913bb20070b371a16c06fedf4d6e2b,0,Lahiru Gunathilake,2013-04-04 19:42:09+00:00,['eeda792450452e9890ee25a3152db9f6fa687aad'],17,2324,2341,1070458,3,,,,3408
69e3add146a1543d4b9bda5da85ef9279bd4910d,0,Heshan Theekshana Suriyaarachchi,2013-04-05 15:16:27+00:00,['38bf2ffd7f913bb20070b371a16c06fedf4d6e2b'],1,13,14,1070472,2,,,,3408
93e5dd1ac9b45e20c9732bd8cd149ced144c5c6a,0,Lahiru Gunathilake,2013-04-05 15:41:05+00:00,['69e3add146a1543d4b9bda5da85ef9279bd4910d'],1,249,250,1070722,6,,,,3408
66ae0484d11eb2016939e34289821236d5ace074,0,samindaw,2013-04-05 17:29:17+00:00,['93e5dd1ac9b45e20c9732bd8cd149ced144c5c6a'],4,4,8,1070730,4,,,,3408
90f6d9900571d89b744a5b453b95b9375b26b6af,0,samindaw,2013-04-05 17:42:00+00:00,['66ae0484d11eb2016939e34289821236d5ace074'],15,15,30,1070760,1,,,,3408
553e1f26d2e2a221d0d956eb3acc7185d683a007,0,Lahiru Gunathilake,2013-04-05 18:55:52+00:00,['90f6d9900571d89b744a5b453b95b9375b26b6af'],1,1,2,1070762,1,,,,3408
d9c0a11bc7553f0fd78def8f3c35ef7fea0329a3,0,Lahiru Gunathilake,2013-04-08 18:15:16+00:00,['553e1f26d2e2a221d0d956eb3acc7185d683a007'],1,0,1,1070763,1,,,,3408
76d311e4bd6c136a001ef733071d2485c8dfa815,0,Lahiru Gunathilake,2013-04-08 18:16:56+00:00,['d9c0a11bc7553f0fd78def8f3c35ef7fea0329a3'],2,1,3,1070766,1,,,,3408
f2fa5574de6aa2b83807532692ffca9a7e67927c,0,Lahiru Gunathilake,2013-04-08 20:35:02+00:00,['76d311e4bd6c136a001ef733071d2485c8dfa815'],389,53,442,1071208,7,,,,3408
f8f2e469f8d087890baee10850d33763d9d77af7,0,Suresh Marru,2013-04-08 23:53:32+00:00,['f2fa5574de6aa2b83807532692ffca9a7e67927c'],39,1027,1066,1072274,52,,,,3408
60173c1ad1f5fcb8927116778b3c4d91461c8237,0,Lahiru Gunathilake,2013-04-09 13:29:00+00:00,['f8f2e469f8d087890baee10850d33763d9d77af7'],0,0,0,1072274,1,,,,3408
14fcffe3610689e624ecd05b9bc68d27af8b6c4a,0,Lahiru Gunathilake,2013-04-09 16:47:43+00:00,['60173c1ad1f5fcb8927116778b3c4d91461c8237'],56,54,110,1072384,48,,,,3408
fdbbed6783b0209a802aaf6d8781397fdd8f010f,0,Lahiru Gunathilake,2013-04-09 16:48:10+00:00,['14fcffe3610689e624ecd05b9bc68d27af8b6c4a'],52,52,104,1072488,48,,,,3408
406135bb6df58016860323b31e03bcda2233a904,0,Lahiru Gunathilake,2013-04-09 19:33:45+00:00,['fdbbed6783b0209a802aaf6d8781397fdd8f010f'],49,49,98,1072586,49,,,,3408
b49a34abf4e3620aa0f633f94246a32f5a4d2d8d,0,Suresh Marru,2013-04-09 19:52:25+00:00,['406135bb6df58016860323b31e03bcda2233a904'],19,413,432,1073018,1,,,,3408
a827dd906c139342e71b5cade56f96f81d9a5df4,0,Lahiru Gunathilake,2013-04-09 20:52:07+00:00,['b49a34abf4e3620aa0f633f94246a32f5a4d2d8d'],24,24,48,1073066,8,,,,3408
e10e1f32c45f6665e904ed6e9342d12cff11d268,0,Lahiru Gunathilake,2013-04-09 21:05:19+00:00,['a827dd906c139342e71b5cade56f96f81d9a5df4'],1,1,2,1073068,1,,,,3408
cfb702a39347bea80226658419e5f1ce9df95d67,0,Lahiru Gunathilake,2013-04-09 21:30:28+00:00,['e10e1f32c45f6665e904ed6e9342d12cff11d268'],52,52,104,1073172,48,,,,3408
4d5aa3868d5bbae8cf7a553885033bf35f1960ee,0,Lahiru Gunathilake,2013-04-09 21:30:42+00:00,['cfb702a39347bea80226658419e5f1ce9df95d67'],52,52,104,1073276,48,,,,3408
057a7bc327089ec41e457df1b521e30025853ff8,0,Lahiru Gunathilake,2013-04-16 18:57:42+00:00,['4d5aa3868d5bbae8cf7a553885033bf35f1960ee'],8,1386,1394,1074670,8,0.620528771,0.66251944,0.846034215,3415
702fc0cda16be4c2c74282d3625692982d120adb,0,Raminderjeet Singh,2013-04-17 20:44:01+00:00,['057a7bc327089ec41e457df1b521e30025853ff8'],0,22,22,1074692,2,1,1,1,3415
430eca8050f5ba34fec79d6e05cbda919b193fad,0,Raminderjeet Singh,2013-04-17 20:58:59+00:00,['702fc0cda16be4c2c74282d3625692982d120adb'],6,9,15,1074707,2,0,0,1,3415
a5549e08fac06c9c5c8f2049d3ec7680bfa3d53e,0,Raminderjeet Singh,2013-04-19 15:24:49+00:00,['430eca8050f5ba34fec79d6e05cbda919b193fad'],1,3,4,1074711,1,0,0,1,3415
f9c26a6a2398fda4cc60e7af6972c94c02510347,0,Suresh Marru,2013-04-21 12:28:47+00:00,['a5549e08fac06c9c5c8f2049d3ec7680bfa3d53e'],0,717,717,1075428,5,,,,3419
3bad8f71eaad934fa3e4a8fe830893dfc6ff9e32,0,Raminderjeet Singh,2013-04-22 13:54:04+00:00,['f9c26a6a2398fda4cc60e7af6972c94c02510347'],3,3,6,1075434,1,,,,3419
18b9756693df0519bce336e1ede7cd30a69107e4,0,Raminderjeet Singh,2013-04-22 17:34:46+00:00,['3bad8f71eaad934fa3e4a8fe830893dfc6ff9e32'],1,2,3,1075437,1,1,1,1,3419
d36f23538615a0f0b089c2ad5b42408797116c96,0,Lahiru Gunathilake,2013-04-22 20:07:59+00:00,['18b9756693df0519bce336e1ede7cd30a69107e4'],3,37,40,1075477,3,0.111111111,0,1,3419
a41cca7fa796528ebda7db1f7f530cc9404d63ab,0,Lahiru Gunathilake,2013-04-22 21:06:02+00:00,['d36f23538615a0f0b089c2ad5b42408797116c96'],2,1,3,1075480,1,,,,3419
b79d1d1404a379d7a2cd93ff27462612e8bb7365,0,Lahiru Gunathilake,2013-04-23 19:03:10+00:00,['a41cca7fa796528ebda7db1f7f530cc9404d63ab'],76,292,368,1075848,25,0.464912281,0.868421053,0.692982456,3421
31b3ce9c1d5f7b8b5012d61b4591ec08efbdc27d,0,Raminderjeet Singh,2013-04-23 20:55:42+00:00,['b79d1d1404a379d7a2cd93ff27462612e8bb7365'],8,13,21,1075869,3,1,1,0,3421
8bba905884ae99c960f4f86661af18edf5073f23,0,Raminderjeet Singh,2013-04-23 20:58:11+00:00,['31b3ce9c1d5f7b8b5012d61b4591ec08efbdc27d'],10,4,14,1075883,1,1,1,0,3421
c59bb89cefc6fc361abcb4eaabfadaf863175c54,0,Raminderjeet Singh,2013-04-23 21:03:54+00:00,['8bba905884ae99c960f4f86661af18edf5073f23'],36,46,82,1075965,4,0.090909091,0.090909091,1,3421
eaf10f823d6e00a28a7b1ecec7046472748b47c5,0,Raminderjeet Singh,2013-04-23 21:21:55+00:00,['c59bb89cefc6fc361abcb4eaabfadaf863175c54'],14,23,37,1076002,1,0,0,1,3421
aaaeecd59656e0828251fea800dacccb628056b6,0,Raminderjeet Singh,2013-04-23 21:25:46+00:00,['eaf10f823d6e00a28a7b1ecec7046472748b47c5'],22,32,54,1076056,2,1,1,0,3421
f9e0eb4a4f92ff6fd39bfdf48eaa52b999bbea7f,0,Raminderjeet Singh,2013-04-23 21:28:48+00:00,['aaaeecd59656e0828251fea800dacccb628056b6'],0,35,35,1076091,1,1,1,1,3422
df7e2b49c3fe238775344a30c6d8e6b0c17422a6,0,Raminderjeet Singh,2013-04-23 21:29:28+00:00,['f9e0eb4a4f92ff6fd39bfdf48eaa52b999bbea7f'],2,2,4,1076095,1,,,,3422
22fe407e6ea648d91e48668a8a8907855a92104c,0,Suresh Marru,2013-04-24 02:54:19+00:00,['df7e2b49c3fe238775344a30c6d8e6b0c17422a6'],1005,943,1948,1078043,10,0.75,1,0,3423
f40ec25c6601e096c8a548a5ccb529fef8292df9,0,Suresh Marru,2013-04-24 10:12:43+00:00,['22fe407e6ea648d91e48668a8a8907855a92104c'],943,1005,1948,1079991,10,0.25,0,1,3424
47b1b67b59f71696b102c19c79972752e4e9e5aa,0,Lahiru Gunathilake,2013-04-24 15:33:08+00:00,['f40ec25c6601e096c8a548a5ccb529fef8292df9'],14,14,28,1080019,12,,,,3424
b051e2ea7adad19700ee53a28f58bd4a1e763d13,0,Lahiru Gunathilake,2013-04-24 18:22:10+00:00,['47b1b67b59f71696b102c19c79972752e4e9e5aa'],60,73,133,1080152,6,1,1,0,3424
cb6e2233f93788221440b21434a90ba968fbb8ad,0,Lahiru Gunathilake,2013-04-24 18:22:52+00:00,['b051e2ea7adad19700ee53a28f58bd4a1e763d13'],23,26,49,1080201,1,,,,3424
da9987fcf0770e0ac08b561c404858e1f3605fa1,0,Raminderjeet Singh,2013-04-24 21:38:08+00:00,['cb6e2233f93788221440b21434a90ba968fbb8ad'],4,4,8,1080209,1,1,1,0,3424
8c6d7e5ca6afb24db48571575a4d045e99e64b54,0,Raminderjeet Singh,2013-04-24 21:46:21+00:00,['da9987fcf0770e0ac08b561c404858e1f3605fa1'],27,43,70,1080279,1,0,0,1,3424
3d523b5f06bf72186bbf1d92198121a77895695a,0,Lahiru Gunathilake,2013-04-25 14:04:16+00:00,['8c6d7e5ca6afb24db48571575a4d045e99e64b54'],0,2,2,1080281,1,0,0,1,3424
4a50faa39b3f6e432e5c960962d4ca9fa0ee8646,0,Raminderjeet Singh,2013-04-25 19:13:30+00:00,['3d523b5f06bf72186bbf1d92198121a77895695a'],13,4,17,1080298,1,,,,3424
5eb015e6e6d7c80d142c285651ee6cc24733cf3a,0,Lahiru Gunathilake,2013-04-25 19:16:06+00:00,['4a50faa39b3f6e432e5c960962d4ca9fa0ee8646'],2,15,17,1080315,1,0,0,1,3424
3d93bd7eed507f71b2054090e7e8d7537eedc111,0,Suresh Marru,2013-04-28 02:20:36+00:00,['5eb015e6e6d7c80d142c285651ee6cc24733cf3a'],1233,1176,2409,1082724,10,1,0.583333333,0,3424
78dae3f7f6f0f277224898b3057e1ecb4080fc2b,0,Suresh Marru,2013-04-28 02:58:26+00:00,['3d93bd7eed507f71b2054090e7e8d7537eedc111'],228,230,458,1083182,2,0.2,0,0.8,3424
a8f827f178880aaae3a931d4dd08473119b84ab0,0,Suresh Marru,2013-04-28 03:29:01+00:00,['78dae3f7f6f0f277224898b3057e1ecb4080fc2b'],6,6,12,1083194,5,,,,3424
6a498bc9037c4de63d3f8d082f103985a47ec805,0,Suresh Marru,2013-04-28 03:31:01+00:00,['a8f827f178880aaae3a931d4dd08473119b84ab0'],3,3,6,1083200,1,,,,3424
01300905a4630c9cb262e3946a59d72bc79b545a,0,Suresh Marru,2013-04-28 13:20:40+00:00,['6a498bc9037c4de63d3f8d082f103985a47ec805'],5,0,5,1083205,1,,,,3424
66e05b00198ecc3ee369843e566bf2b5fae22812,0,Raminderjeet Singh,2013-04-29 21:07:27+00:00,['01300905a4630c9cb262e3946a59d72bc79b545a'],1,136,137,1083342,6,0.52173913,0.608695652,0.608695652,3425
177218a66776b6b9886b05266ba9a918b7e3c766,0,Raminderjeet Singh,2013-04-29 21:12:21+00:00,['66e05b00198ecc3ee369843e566bf2b5fae22812'],2,0,2,1083344,1,1,1,0,3425
a7fdd250841a79403d601dfcfa51e5c9aa0d8ed3,0,Lahiru Gunathilake,2013-05-01 16:27:07+00:00,['177218a66776b6b9886b05266ba9a918b7e3c766'],11,31,42,1083386,1,0,0,0,3425
407c3c59ee98a5a3cd1930ecf07cca2802167947,0,Lahiru Gunathilake,2013-05-01 19:16:53+00:00,['a7fdd250841a79403d601dfcfa51e5c9aa0d8ed3'],0,3,3,1083389,1,0,0,0,3425
df4a6fb2518f9e39d45b1edb9829c12c48e5deb7,0,Raminderjeet Singh,2013-05-02 21:12:52+00:00,['407c3c59ee98a5a3cd1930ecf07cca2802167947'],9,13,22,1083411,1,1,1,0,3425
2f65d1dd2bde5e691f33c1a56de66a85765cc2ff,0,Lahiru Gunathilake,2013-05-02 21:31:30+00:00,['df4a6fb2518f9e39d45b1edb9829c12c48e5deb7'],0,9,9,1083420,1,0,0,1,3425
3958ab1dd6ce23e909c3c7a1fd216548bf1ea114,0,Lahiru Gunathilake,2013-05-03 18:39:22+00:00,['2f65d1dd2bde5e691f33c1a56de66a85765cc2ff'],1,2,3,1083423,1,0,0,1,3425
7848bcafa0e31b20aafe5509daf0fc2d6280eca3,0,Lahiru Gunathilake,2013-05-03 19:01:38+00:00,['3958ab1dd6ce23e909c3c7a1fd216548bf1ea114'],1,3,4,1083427,1,,,,3425
6168c9e4862225b91213a271de1622f4e2901c17,0,Lahiru Gunathilake,2013-05-04 07:14:38+00:00,['7848bcafa0e31b20aafe5509daf0fc2d6280eca3'],11,11,22,1083449,1,1,1,0,3425
5fc414b9ecd4049c19da3224dc1d513a6a595b5f,0,Lahiru Gunathilake,2013-05-06 19:11:48+00:00,['6168c9e4862225b91213a271de1622f4e2901c17'],5,3,8,1083457,1,,,,3425
006432e234209bccc9866583fc0464ef754a3eac,0,Suresh Marru,2013-05-06 22:45:44+00:00,['5fc414b9ecd4049c19da3224dc1d513a6a595b5f'],1,1,2,1083459,1,,,,3425
f024623886482047a63142d3ccb658459eded128,0,samindaw,2013-05-06 23:32:19+00:00,['006432e234209bccc9866583fc0464ef754a3eac'],1,1,2,1083461,1,,,,3425
977151ee65bb934baaf74d4ce2d04a357c64796b,1,amilaj,2013-05-06 23:34:43+00:00,['f024623886482047a63142d3ccb658459eded128'],1296,1506,2802,1086263,30,0.447674419,0.941860465,0,3436
c605f2ed05082d3a7ec55f16a959a4e9243220ea,0,Lahiru Gunathilake,2013-05-07 16:24:14+00:00,['977151ee65bb934baaf74d4ce2d04a357c64796b'],34,36,70,1086333,1,0,0,1,3436
e3ced6eedcfecb854bc52c7d8e81085418fbda14,0,Lahiru Gunathilake,2013-05-08 19:47:20+00:00,['c605f2ed05082d3a7ec55f16a959a4e9243220ea'],10,52,62,1086395,2,0.771428571,0.771428571,0.771428571,3436
f62f95704f7e857e6af6cc6a87d3282e71a6900a,1,chathuri,2013-05-08 21:07:14+00:00,['e3ced6eedcfecb854bc52c7d8e81085418fbda14'],26,493,519,1086914,13,0.496153846,0.873076923,1,3438
a29556b983eb8865387bd6d0d833c8c17025aaed,1,chathuri,2013-05-09 00:42:01+00:00,['f62f95704f7e857e6af6cc6a87d3282e71a6900a'],3,3,6,1086920,2,,,,3438
18c07658cd86c0dccd6edfa1daa6bc8795d431c7,0,Lahiru Gunathilake,2013-05-09 13:51:20+00:00,['a29556b983eb8865387bd6d0d833c8c17025aaed'],0,15,15,1086935,1,1,1,1,3438
d2836a6cfaced4c4e272322e5724908eb53a290f,0,chathuri,2013-05-09 20:09:26+00:00,['18c07658cd86c0dccd6edfa1daa6bc8795d431c7'],25,87,112,1087047,9,0.345454545,0.436363636,0.945454545,3438
63b3423a7da675c623a8309351acf811bb80694e,0,chathuri,2013-05-10 15:48:27+00:00,['d2836a6cfaced4c4e272322e5724908eb53a290f'],70,139,209,1087256,13,0.928571429,1,1,3438
0046a0ab0bd4bf567ed2991097cc562ff7108aa9,0,Heshan Theekshana Suriyaarachchi,2013-05-10 18:36:46+00:00,['63b3423a7da675c623a8309351acf811bb80694e'],1,2,3,1087259,1,,,,3438
ef5a42643d4bbba7d878407e9deaa1bb8cedc62a,0,chathuri,2013-05-10 20:11:06+00:00,['0046a0ab0bd4bf567ed2991097cc562ff7108aa9'],0,23,23,1087282,7,0.923076923,1,1,3438
8cae26475533520a82bec239e3447c35e5d7536b,0,Heshan Theekshana Suriyaarachchi,2013-05-11 16:47:44+00:00,['ef5a42643d4bbba7d878407e9deaa1bb8cedc62a'],210,307,517,1087799,3,0,0,1,3440
4c783331dd6c95d302f50804e50ea22b3e7a7e2e,0,Heshan Theekshana Suriyaarachchi,2013-05-11 19:00:12+00:00,['8cae26475533520a82bec239e3447c35e5d7536b'],0,65,65,1087864,1,0,0,1,3440
1954733a556cd78bad61f8a3b067e577d1d0f24b,0,amilaj,2013-05-12 23:38:06+00:00,['4c783331dd6c95d302f50804e50ea22b3e7a7e2e'],278,492,770,1088634,41,0.973684211,0.973684211,0.868421053,3442
9f31f8ed3a2138b919c5e249585c1455074c2763,1,Lahiru Gunathilake,2013-05-13 16:05:21+00:00,['1954733a556cd78bad61f8a3b067e577d1d0f24b'],8,14,22,1088656,1,0,1,1,3442
61e8d85104fdd05fcbf871305984b0942c25e278,0,Lahiru Gunathilake,2013-05-13 16:41:41+00:00,['9f31f8ed3a2138b919c5e249585c1455074c2763'],2,0,2,1088658,1,1,0,0,3442
57a5d522cf0ef90e4291e0f3c281b834f97ae438,0,samindaw,2013-05-13 20:05:01+00:00,['61e8d85104fdd05fcbf871305984b0942c25e278'],26,1040,1066,1089724,20,0.711206897,0.86637931,0.672413793,3448
152dc7669a7f1ee805c50e4b7bb9a3c1979b6967,0,samindaw,2013-05-13 20:09:05+00:00,['57a5d522cf0ef90e4291e0f3c281b834f97ae438'],1,1,2,1089726,1,,,,3448
5b8f1e37961830a3ac6be2c3ee7d3f397437745e,0,amilaj,2013-05-13 23:30:18+00:00,['152dc7669a7f1ee805c50e4b7bb9a3c1979b6967'],1,7,8,1089734,1,,,,3448
049fb4e2178010bdd8c6e19fd8bf56da3771a2ac,1,Lahiru Gunathilake,2013-05-14 00:58:53+00:00,['5b8f1e37961830a3ac6be2c3ee7d3f397437745e'],7,37,44,1089778,10,0,0.739130435,0.739130435,3448
081409962498133fb31d855318b9d65c1dc29fed,0,Lahiru Gunathilake,2013-05-14 02:36:07+00:00,['049fb4e2178010bdd8c6e19fd8bf56da3771a2ac'],0,2,2,1089780,1,1,1,1,3448
2f66788a978d868b37fe5a163485ca728d32c8c8,0,Lahiru Gunathilake,2013-05-14 21:46:45+00:00,['081409962498133fb31d855318b9d65c1dc29fed'],2,2,4,1089784,2,,,,3448
dc5896084b7172897179c90be424b2710f0c8292,0,Lahiru Gunathilake,2013-05-14 21:51:26+00:00,['2f66788a978d868b37fe5a163485ca728d32c8c8'],1,1,2,1089786,1,,,,3448
226922a72af14b4eb30ab9e4ec657ebc25bc55a0,1,chathuri,2013-05-15 01:13:30+00:00,['dc5896084b7172897179c90be424b2710f0c8292'],18,444,462,1090248,18,0.033210332,1,0.745387454,3449
674e82ac307f9729ff3c121b9195ed20e3317a7d,0,chathuri,2013-05-15 15:14:15+00:00,['226922a72af14b4eb30ab9e4ec657ebc25bc55a0'],23,582,605,1090853,7,0.063829787,0.089361702,0.676595745,3454
7a12320947af6e94419ae658e65b7b7bf576580f,0,amilaj,2013-05-15 15:19:44+00:00,['674e82ac307f9729ff3c121b9195ed20e3317a7d'],9,16,25,1090878,2,0.333333333,0.333333333,1,3454
516291728c370765658d4c529c86c61d009b4fa5,0,amilaj,2013-05-15 15:50:27+00:00,['7a12320947af6e94419ae658e65b7b7bf576580f'],9,38,47,1090925,2,0.611111111,0.611111111,0.611111111,3454
54133291c2b0581b127a6eacb11792d31a5faa23,0,amilaj,2013-05-15 17:38:40+00:00,['516291728c370765658d4c529c86c61d009b4fa5'],0,6,6,1090931,2,,,,3454
f23aac1ebaf884af530c54c27abe104aa5e13222,0,amilaj,2013-05-15 18:02:40+00:00,['54133291c2b0581b127a6eacb11792d31a5faa23'],6,6,12,1090943,1,,,,3454
e300f1ce334105363006d3b2968a5d855fb11b8c,0,Lahiru Gunathilake,2013-05-15 18:38:26+00:00,['f23aac1ebaf884af530c54c27abe104aa5e13222'],0,1,1,1090944,1,0,0,0,3454
167d1480d6fda8b43fa54641c6a42f6d8d146375,0,Raminderjeet Singh,2013-05-15 18:41:19+00:00,['e300f1ce334105363006d3b2968a5d855fb11b8c'],7,6,13,1090957,1,,,,3454
74e462d08100522230c537c61cbf21149b3c9170,0,amilaj,2013-05-15 19:32:59+00:00,['167d1480d6fda8b43fa54641c6a42f6d8d146375'],6,6,12,1090969,1,1,1,1,3454
b1b7798396512c91e3e6f9d0a0086daa34db8a29,0,Lahiru Gunathilake,2013-05-16 18:41:21+00:00,['74e462d08100522230c537c61cbf21149b3c9170'],0,1,1,1090970,1,0,0,0,3454
8d3af1bff18bbf21a63c246d4df881191600dbd1,0,amilaj,2013-05-17 19:38:41+00:00,['b1b7798396512c91e3e6f9d0a0086daa34db8a29'],4,4,8,1090978,2,,,,3454
7115013184681cb0321213bf04c47fafd89b9455,0,amilaj,2013-05-17 20:50:41+00:00,['8d3af1bff18bbf21a63c246d4df881191600dbd1'],0,2,2,1090980,1,0,0,1,3454
15fb7ca5f1b79a9f14990f0adb06337c4928ec99,0,Lahiru Gunathilake,2013-05-20 18:28:40+00:00,['7115013184681cb0321213bf04c47fafd89b9455'],1,1,2,1090982,1,,,,3454
d8b2c9c55c41ba58e91c4d7a1842a3a43a79c61e,0,Lahiru Gunathilake,2013-05-20 18:29:18+00:00,['15fb7ca5f1b79a9f14990f0adb06337c4928ec99'],1,1,2,1090984,1,,,,3454
7bb110050d0d7cb8aee755e2eb2f213ebd43e9ef,0,chathuri,2013-05-20 19:52:26+00:00,['d8b2c9c55c41ba58e91c4d7a1842a3a43a79c61e'],26,76,102,1091086,3,0.166666667,1,1,3455
bb63b01ba2db9a7b123060a1f5222b9c01fba317,1,Lahiru Gunathilake,2013-05-20 21:05:13+00:00,['7bb110050d0d7cb8aee755e2eb2f213ebd43e9ef'],2,24,26,1091112,5,0,1,1,3455
ccb9efcd3e47a8cccc932f73d1a182d9e9aa4499,0,chathuri,2013-05-21 03:11:04+00:00,['bb63b01ba2db9a7b123060a1f5222b9c01fba317'],5,4,9,1091121,5,1,1,1,3455
f8a569003b9e2241f17f4c2f69be6b4daa3998a8,0,amilaj,2013-05-21 14:49:26+00:00,['ccb9efcd3e47a8cccc932f73d1a182d9e9aa4499'],16,28,44,1091165,4,0,1,1,3455
095c55c4825719c54af8c5e2571de8166d58b53c,0,chathuri,2013-05-21 14:55:22+00:00,['f8a569003b9e2241f17f4c2f69be6b4daa3998a8'],5,5,10,1091175,1,,,,3455
15f586eada7e1abc1445b7ce0a5f544717b6298b,0,amilaj,2013-05-21 19:58:14+00:00,['095c55c4825719c54af8c5e2571de8166d58b53c'],7,7,14,1091189,1,,,,3455
2151978d68a9fce190e3f6097179636ca51a1719,0,chathuri,2013-05-21 20:52:24+00:00,['15f586eada7e1abc1445b7ce0a5f544717b6298b'],4,23,27,1091216,4,0,0.5,0,3455
638b47575a6994a5c8a48f2566c90e41810760b6,0,Lahiru Gunathilake,2013-05-21 20:53:08+00:00,['2151978d68a9fce190e3f6097179636ca51a1719'],9,21,30,1091246,2,0.636363636,0.636363636,1,3455
62f136019ca1f6b2c40ba370f9836509716bf8bb,0,Lahiru Gunathilake,2013-05-21 20:55:40+00:00,['638b47575a6994a5c8a48f2566c90e41810760b6'],0,13,13,1091259,3,,,,3455
515c5222198e361eca4fd7c58dc98ab89a32a2f4,0,samindaw,2013-05-22 03:20:14+00:00,['62f136019ca1f6b2c40ba370f9836509716bf8bb'],361,723,1084,1092343,15,1,1,1,3456
e001a6e95736d45433d00fe57f15d9e8f4a6f386,0,samindaw,2013-05-22 16:31:23+00:00,['515c5222198e361eca4fd7c58dc98ab89a32a2f4'],8,8,16,1092359,6,,,,3456
177f821f19ca19d6d6b8a6db610e6c36ec0194e4,0,samindaw,2013-05-22 16:42:57+00:00,['e001a6e95736d45433d00fe57f15d9e8f4a6f386'],19,19,38,1092397,1,,,,3456
f7c34425a47cdfb4e662b3c98ef837ef76b6bcfc,0,Lahiru Gunathilake,2013-05-22 16:55:24+00:00,['177f821f19ca19d6d6b8a6db610e6c36ec0194e4'],4,4,8,1092405,2,,,,3456
3d9aed88a51520cdd75017ebe7447e05fc4a1f2a,1,chathuri,2013-05-22 17:06:00+00:00,['f7c34425a47cdfb4e662b3c98ef837ef76b6bcfc'],51,666,717,1093122,12,0.475138122,0.787292818,1,3458
d52268e0957eb91b0d17c9fecb077db9eb5c3d9e,0,Lahiru Gunathilake,2013-05-22 17:34:58+00:00,['3d9aed88a51520cdd75017ebe7447e05fc4a1f2a'],13,14,27,1093149,1,1,1,1,3458
11e88521dc57a934a9f2dc25e409d6e8fdcb4708,0,Lahiru Gunathilake,2013-05-22 19:44:01+00:00,['d52268e0957eb91b0d17c9fecb077db9eb5c3d9e'],1,1,2,1093151,1,,,,3458
677bc082d376135814f36898bf0e92ba83913a50,0,Lahiru Gunathilake,2013-05-22 20:19:34+00:00,['11e88521dc57a934a9f2dc25e409d6e8fdcb4708'],5,31,36,1093187,2,0.647058824,0.647058824,1,3458
d782a4d66ee6f91a94ee624b7bdf31734097fa1d,0,chathuri,2013-05-22 20:23:55+00:00,['677bc082d376135814f36898bf0e92ba83913a50'],0,82,82,1093269,2,,,,3460
91c06e51c8068efd0897694b09e32dd144d861ab,0,samindaw,2013-05-23 12:29:45+00:00,['d782a4d66ee6f91a94ee624b7bdf31734097fa1d'],122,275,397,1093666,77,1,1,1,3463
67ae741932219bfbdaa1d82780d89994b3ca6742,0,samindaw,2013-05-23 12:31:29+00:00,['91c06e51c8068efd0897694b09e32dd144d861ab'],0,34,34,1093700,1,1,1,1,3464
0c36ea03ea3461d2e10d3a52b1bd74aa2ff2e55b,0,samindaw,2013-05-23 14:07:30+00:00,['67ae741932219bfbdaa1d82780d89994b3ca6742'],28,34,62,1093762,3,1,1,1,3464
43b5f322e1e218176a8eb8efc904bea32d96a7b2,0,amilaj,2013-05-23 15:08:05+00:00,['0c36ea03ea3461d2e10d3a52b1bd74aa2ff2e55b'],1,9,10,1093772,1,,,,3464
0454bdfb7391b96d80df349013180a2968e2e06e,0,chathuri,2013-05-23 18:23:05+00:00,['43b5f322e1e218176a8eb8efc904bea32d96a7b2'],10,328,338,1094110,11,0.165137615,0.747706422,0.779816514,3465
607d5c59a0986383832be36afd529db71d87f6c4,0,Lahiru Gunathilake,2013-05-23 18:25:24+00:00,['0454bdfb7391b96d80df349013180a2968e2e06e'],9,11,20,1094130,2,0,0,1,3465
9324c08528ca202ec779a6f711167e54dead82c7,0,Lahiru Gunathilake,2013-05-23 18:42:34+00:00,['607d5c59a0986383832be36afd529db71d87f6c4'],16,2,18,1094148,2,0,0,0,3465
9bf6407745c595c46433de6ba053329957b02512,0,chathuri,2013-05-23 19:46:31+00:00,['9324c08528ca202ec779a6f711167e54dead82c7'],18,487,505,1094653,3,0.015384615,0.015384615,0.793406593,3465
688b810832b72d597980934fe56ab91e76800266,0,samindaw,2013-05-24 13:54:43+00:00,['9bf6407745c595c46433de6ba053329957b02512'],85,58,143,1094796,8,0,0,0,3466
6340c72685ddf0cbfae289a958dc70a0e1f2a23b,0,samindaw,2013-05-24 14:12:19+00:00,['688b810832b72d597980934fe56ab91e76800266'],6,14,20,1094816,2,1,1,1,3466
6dfb9911ff260deb2d14d02459760ca163ec505b,0,samindaw,2013-05-24 14:20:14+00:00,['6340c72685ddf0cbfae289a958dc70a0e1f2a23b'],4,4,8,1094824,1,,,,3466
df28424181ad825c8b8cf2d82025188f0ee3af09,0,samindaw,2013-05-24 14:28:20+00:00,['6dfb9911ff260deb2d14d02459760ca163ec505b'],8,8,16,1094840,1,,,,3466
9ad72854e4dba7da2b9fef68fe9c25e949617d0b,0,samindaw,2013-05-24 14:34:51+00:00,['df28424181ad825c8b8cf2d82025188f0ee3af09'],1,2,3,1094843,1,,,,3466
b46d30a9328786abd77180b552a05273348ced02,0,chathuri,2013-05-24 16:49:15+00:00,['9ad72854e4dba7da2b9fef68fe9c25e949617d0b'],6,52,58,1094901,3,,,,3466
2b61c63ccdd8a29e71e1e85bf83d4f31b0efd74b,0,samindaw,2013-05-26 23:31:55+00:00,['b46d30a9328786abd77180b552a05273348ced02'],32,205,237,1095138,6,0.658536585,0.81300813,0.707317073,3466
0e0cd0c39c82cb47129eba8474db7ecb5e2b71f6,0,samindaw,2013-05-26 23:39:10+00:00,['2b61c63ccdd8a29e71e1e85bf83d4f31b0efd74b'],0,34,34,1095172,1,1,1,1,3467
f94d4e6ca540461b1c01bc2609d07dbca39c4a4c,0,Lahiru Gunathilake,2013-05-28 20:26:15+00:00,['0e0cd0c39c82cb47129eba8474db7ecb5e2b71f6'],9,92,101,1095273,6,0.461538462,0.461538462,1,3469
4c3cc7baed3d5e15d59d4f31c6eef7b753f3aee8,0,Raminderjeet Singh,2013-05-30 14:23:43+00:00,['f94d4e6ca540461b1c01bc2609d07dbca39c4a4c'],0,2,2,1095275,1,,,,3469
cb159f8fe3eccfeced77226c206616c2b7df66f4,0,samindaw,2013-05-30 17:23:16+00:00,['4c3cc7baed3d5e15d59d4f31c6eef7b753f3aee8'],28,63,91,1095366,3,1,1,1,3469
54c4c73ed7bd0c3c78a896534edc09f3185c7acc,0,samindaw,2013-05-30 18:14:06+00:00,['cb159f8fe3eccfeced77226c206616c2b7df66f4'],233,238,471,1095837,17,,,,3469
822a67ea281d426832169f5ed06f3767ea4dbb04,0,samindaw,2013-05-31 16:55:55+00:00,['54c4c73ed7bd0c3c78a896534edc09f3185c7acc'],38,58,96,1095933,9,0.142857143,0.571428571,0,3469
18c94b4a817840d578c74c534f410eabe72729e7,0,samindaw,2013-05-31 17:18:25+00:00,['822a67ea281d426832169f5ed06f3767ea4dbb04'],7,63,70,1096003,2,0,0.155555556,1,3469
82f2b6f1164a0db5110f74f6372d8fee88bdbb7f,0,chathuri,2013-06-03 15:41:41+00:00,['18c94b4a817840d578c74c534f410eabe72729e7'],22,21,43,1096046,9,,,,3469
fbb521ba2b5d8bdc0c9830af508c7670733f6a0d,0,chathuri,2013-06-03 15:42:25+00:00,['82f2b6f1164a0db5110f74f6372d8fee88bdbb7f'],4,4,8,1096054,1,,,,3469
5f5ed01848cebee3084d34e9411632a445602c0f,0,Raminderjeet Singh,2013-06-05 18:50:59+00:00,['fbb521ba2b5d8bdc0c9830af508c7670733f6a0d'],0,1,1,1096055,1,,,,3469
a0582dee7f0ae7537fc0b89f83fdce9078f03d63,0,samindaw,2013-06-06 15:16:42+00:00,['5f5ed01848cebee3084d34e9411632a445602c0f'],16,23,39,1096094,6,1,1,1,3469
05fc677e827377220855d79baebeb90410506d57,0,samindaw,2013-06-06 15:22:14+00:00,['a0582dee7f0ae7537fc0b89f83fdce9078f03d63'],1,1,2,1096096,1,,,,3469
507023bdd080a34130fce584ff5bfdb2beb30715,0,samindaw,2013-06-06 21:31:56+00:00,['05fc677e827377220855d79baebeb90410506d57'],1,18,19,1096115,3,0,0.928571429,0.5,3469
6cdd1923d47df0f2f63653f1cfaf94c98f203eef,0,chathuri,2013-06-07 14:52:53+00:00,['507023bdd080a34130fce584ff5bfdb2beb30715'],1,87,88,1096203,3,0.41025641,1,1,3470
ae2637208d9c92dd00d156df4006ad5a756a1b16,0,samindaw,2013-06-07 15:47:58+00:00,['6cdd1923d47df0f2f63653f1cfaf94c98f203eef'],4,10,14,1096217,2,0,0,0,3470
e5b89be1feb3611de13d2c1430daf582858a1a03,0,samindaw,2013-06-07 16:32:55+00:00,['ae2637208d9c92dd00d156df4006ad5a756a1b16'],9,101,110,1096327,2,0.4,0,1,3470
ea8610f1942f091b58bf67eda1992a3f9893888d,0,samindaw,2013-06-07 16:42:23+00:00,['e5b89be1feb3611de13d2c1430daf582858a1a03'],3,3,6,1096333,1,1,1,0,3470
f03622ae1917784b82af1a5feab39e7675a3ba96,0,chathuri,2013-06-07 17:24:52+00:00,['ea8610f1942f091b58bf67eda1992a3f9893888d'],4,5,9,1096342,4,1,1,1,3470
f9efdd205242ebd15b71f3e44ff2f61b43e2838c,0,chathuri,2013-06-07 17:45:34+00:00,['f03622ae1917784b82af1a5feab39e7675a3ba96'],91,91,182,1096524,4,,,,3470
a6578a4d164155a325495141f193f751c0e91c26,0,samindaw,2013-06-07 18:57:37+00:00,['f9efdd205242ebd15b71f3e44ff2f61b43e2838c'],2,15,17,1096541,1,0,0,1,3470
839f66abf6f915451add0a45c8ad51ab67aa3db5,0,samindaw,2013-06-07 19:05:54+00:00,['a6578a4d164155a325495141f193f751c0e91c26'],2,2,4,1096545,1,1,0,0,3470
dcf50a4a32329748818ca93e99977572b04715c0,0,samindaw,2013-06-08 05:48:07+00:00,['839f66abf6f915451add0a45c8ad51ab67aa3db5'],22,12,34,1096579,3,1,0,1,3470
cd1d84f0a8b7d75124d70c738e6a152adbbdf7ac,0,samindaw,2013-06-08 06:31:00+00:00,['dcf50a4a32329748818ca93e99977572b04715c0'],2,2,4,1096583,1,,,,3470
3f93347bb6a51e74394fc188c12b5ee9e04ad1a3,0,samindaw,2013-06-08 06:43:07+00:00,['cd1d84f0a8b7d75124d70c738e6a152adbbdf7ac'],0,18,18,1096601,1,0,0,0,3470
26e2f46a61672ac20c344445c2dec62cae3a3776,0,samindaw,2013-06-10 19:21:49+00:00,['3f93347bb6a51e74394fc188c12b5ee9e04ad1a3'],117,285,402,1097003,9,1,1,0.08,3470
a43e26aadf3d8188156b7a8f0589152e35a54018,0,samindaw,2013-06-10 23:21:50+00:00,['26e2f46a61672ac20c344445c2dec62cae3a3776'],1,22,23,1097026,1,0,1,1,3470
a2209f141ee92f346b2cf4984ac1876441548dc9,0,samindaw,2013-06-11 13:54:05+00:00,['a43e26aadf3d8188156b7a8f0589152e35a54018'],32,72,104,1097130,8,0.32,0.32,1,3470
fe5aa8640c9695f9f6db022defe7c1b06364133a,1,chathuri,2013-06-12 16:40:59+00:00,['a2209f141ee92f346b2cf4984ac1876441548dc9'],73,402,475,1097605,27,0.596590909,0.960227273,1,3473
d41db5d418a44c537c738581b6eded31b1bdc572,0,samindaw,2013-06-12 17:10:02+00:00,['fe5aa8640c9695f9f6db022defe7c1b06364133a'],1,160,161,1097766,9,0.766233766,1,0.779220779,3474
4cf3e337aba5641a1fee3abf0aaf5224a31c02e7,0,chathuri,2013-06-12 18:31:10+00:00,['d41db5d418a44c537c738581b6eded31b1bdc572'],2,120,122,1097888,6,0.084507042,0.394366197,1,3475
5de9df0f4a796edba1813256f681872e977cf75e,0,chathuri,2013-06-12 19:50:54+00:00,['4cf3e337aba5641a1fee3abf0aaf5224a31c02e7'],0,16,16,1097904,2,,,,3475
f543d5505b8ba635529f138b8a185e4858d8e0f5,0,Lahiru Gunathilake,2013-06-15 03:38:42+00:00,['5de9df0f4a796edba1813256f681872e977cf75e'],2,13,15,1097919,1,0,1,1,3475
6f63edddf0af7585f0f1506642af9f57a56655be,0,samindaw,2013-06-17 20:58:48+00:00,['f543d5505b8ba635529f138b8a185e4858d8e0f5'],32,32,64,1097983,1,,,,3475
bee005d623c68f43e90df14311ce7a108771ee4f,0,Lahiru Gunathilake,2013-06-21 15:53:21+00:00,['6f63edddf0af7585f0f1506642af9f57a56655be'],12,27,39,1098022,2,0,0.944444444,0.611111111,3475
282443774d691888c115a79ff6e3320b23c9164a,0,Suresh Marru,2013-06-29 18:20:44+00:00,['bee005d623c68f43e90df14311ce7a108771ee4f'],269,668,937,1098959,33,0,0,1,3475
2cc02953c286f5343ffbfd7e75f281afc9cdfef7,0,Suresh Marru,2013-06-29 18:27:32+00:00,['282443774d691888c115a79ff6e3320b23c9164a'],1,43,44,1099003,2,,,,3475
a4075d03ae82a901733de7424d9aa5de23d46619,0,Suresh Marru,2013-06-29 19:12:32+00:00,['2cc02953c286f5343ffbfd7e75f281afc9cdfef7'],0,3,3,1099006,1,,,,3475
d19b990d285f2a125f5dc535792a1921ff35137f,0,Suresh Marru,2013-06-30 14:34:17+00:00,['a4075d03ae82a901733de7424d9aa5de23d46619'],570,617,1187,1100193,4,,,,3475
3dd54e28f7c85e26c97ccd1d2f02c2a0ef9d9365,0,Suresh Marru,2013-06-30 14:46:19+00:00,['d19b990d285f2a125f5dc535792a1921ff35137f'],0,10,10,1100203,1,,,,3475
c97cc94f7b2475121dfc8d1e55f472c7e05f131b,0,Suresh Marru,2013-06-30 15:27:04+00:00,['3dd54e28f7c85e26c97ccd1d2f02c2a0ef9d9365'],1062,513,1575,1101778,12,,,,3475
49f12fcfed36fe47b5226ae4cffb1103d5fd6163,1,Suresh Marru,2013-06-30 23:47:23+00:00,['c97cc94f7b2475121dfc8d1e55f472c7e05f131b'],2,2,4,1101782,2,,,,3475
fcf46e276d5f0366c841e89f972cdb9a44f5ec76,0,Suresh Marru,2013-07-01 00:21:54+00:00,['49f12fcfed36fe47b5226ae4cffb1103d5fd6163'],0,2,2,1101784,1,,,,3475
f25c616ca300387189e5056568192db60f6d6e31,0,Suresh Marru,2013-07-01 02:46:19+00:00,['fcf46e276d5f0366c841e89f972cdb9a44f5ec76'],62,57,119,1101903,48,,,,3475
fa81f4a721d0c02cab5affb49718823490d360af,0,Suresh Marru,2013-07-01 02:46:28+00:00,['f25c616ca300387189e5056568192db60f6d6e31'],52,52,104,1102007,48,,,,3475
3268823aca3a1a22b302b9c76477f9e96c1df1c5,0,amilaj,2013-07-08 19:40:59+00:00,['fa81f4a721d0c02cab5affb49718823490d360af'],1296,591,1887,1103894,15,0.442477876,0.699115044,1,3478
9f6c725f3fc49fee746a7a08f3e27d13e5b7086c,0,Suresh Marru,2013-07-08 20:01:31+00:00,['3268823aca3a1a22b302b9c76477f9e96c1df1c5'],48,48,96,1103990,48,,,,3478
01183f4c1f5e69fdf3050e05fae5e9ebdd4e85cf,0,amilaj,2013-07-08 22:44:41+00:00,['9f6c725f3fc49fee746a7a08f3e27d13e5b7086c'],8,19,27,1104017,7,0.714285714,1,1,3478
a3c9ca4f98a00953e5b540fdf1d3c612439adadc,0,amilaj,2013-07-09 14:11:23+00:00,['01183f4c1f5e69fdf3050e05fae5e9ebdd4e85cf'],2,2,4,1104021,1,,,,3478
a2d350b30f35389fca072c5b6b8f450a700e6072,0,amilaj,2013-07-09 16:12:06+00:00,['a3c9ca4f98a00953e5b540fdf1d3c612439adadc'],1,1,2,1104023,1,,,,3478
1f23e9415033bdbb7ee4e07377d1a8085fcbe2ce,0,samindaw,2013-07-09 17:19:17+00:00,['a2d350b30f35389fca072c5b6b8f450a700e6072'],0,1,1,1104024,1,0,1,1,3478
c7e3b35ae37a96d994a4d7bfc488e03bdf1bf025,0,samindaw,2013-07-09 17:26:36+00:00,['1f23e9415033bdbb7ee4e07377d1a8085fcbe2ce'],0,1,1,1104025,1,,,,3478
0dfc1bb24e147f0a30ae27b7d9f1bb79fc702204,0,Suresh Marru,2013-07-09 18:34:31+00:00,['c7e3b35ae37a96d994a4d7bfc488e03bdf1bf025'],23,41,64,1104089,1,,,,3478
8e89ec9173587813e22de17bb8bc1bc10eb7f00d,0,Suresh Marru,2013-07-09 18:51:44+00:00,['0dfc1bb24e147f0a30ae27b7d9f1bb79fc702204'],51,51,102,1104191,48,,,,3478
68c5d71f002a92b1e27cb4c4c1a1914a2b19cf74,0,Suresh Marru,2013-07-09 18:51:52+00:00,['8e89ec9173587813e22de17bb8bc1bc10eb7f00d'],51,51,102,1104293,48,,,,3478
88f54cd6ceea1c16bbfc35f0e04ec7cbc28802bb,0,Suresh Marru,2013-07-10 19:55:46+00:00,['68c5d71f002a92b1e27cb4c4c1a1914a2b19cf74'],6,7,13,1104306,7,,,,3478
e2f97189187f1ea6a470a9b4c322a57c2cd8f00e,0,Suresh Marru,2013-07-11 11:39:38+00:00,['88f54cd6ceea1c16bbfc35f0e04ec7cbc28802bb'],214,223,437,1104743,1,,,,3478
28a5e57415be51a2455f5e9f333f85bf9185da55,0,Suresh Marru,2013-07-11 12:59:26+00:00,['e2f97189187f1ea6a470a9b4c322a57c2cd8f00e'],58,53,111,1104854,48,,,,3478
7e07fee807f1d31b4e553828b4fe3819dd08491c,0,Suresh Marru,2013-07-11 13:11:48+00:00,['28a5e57415be51a2455f5e9f333f85bf9185da55'],51,51,102,1104956,48,,,,3478
9555b860583b83b791fc2467b00a91d684055927,0,Suresh Marru,2013-07-11 13:11:56+00:00,['7e07fee807f1d31b4e553828b4fe3819dd08491c'],51,51,102,1105058,48,,,,3478
17f95690a6edd9d0276807f7a902f269c322fed3,0,Suresh Marru,2013-07-12 03:16:17+00:00,['9555b860583b83b791fc2467b00a91d684055927'],14,0,14,1105072,1,,,,3478
4d75d9ad2546d823842f4736e458da607b4e7247,0,Suresh Marru,2013-07-12 13:09:38+00:00,['17f95690a6edd9d0276807f7a902f269c322fed3'],37,19,56,1105128,1,,,,3478
ec1be5dd396496602bd378c1f505de37d6c36ff2,0,Suresh Marru,2013-07-12 13:21:45+00:00,['4d75d9ad2546d823842f4736e458da607b4e7247'],58,53,111,1105239,48,,,,3478
0a608d0b2fffdca74d6cc55fb7632e711f795de7,0,Suresh Marru,2013-07-12 14:03:52+00:00,['ec1be5dd396496602bd378c1f505de37d6c36ff2'],51,51,102,1105341,48,,,,3478
b842f60d67206538053635db4e9fe94903a4b6eb,0,Suresh Marru,2013-07-12 14:04:00+00:00,['0a608d0b2fffdca74d6cc55fb7632e711f795de7'],51,51,102,1105443,48,,,,3478
65e5a55206da37c04da712112ae91bf60f1abce0,0,amilaj,2013-07-13 00:49:09+00:00,['b842f60d67206538053635db4e9fe94903a4b6eb'],908,8220,9128,1114571,361,0.800464037,0.918793503,0.64037123,3798
bca52979a71e4a72615b091b430c2c6523d90d98,0,amilaj,2013-07-15 14:03:51+00:00,['65e5a55206da37c04da712112ae91bf60f1abce0'],16,16,32,1114603,5,,,,3798
3924583d6f93fffc1620c124c795d46c914c4abc,0,Suresh Marru,2013-07-20 15:39:17+00:00,['bca52979a71e4a72615b091b430c2c6523d90d98'],11,1695,1706,1116309,26,0.453961456,0.809421842,1,3820
3cff229897cbb626a239c6e117e2ecf4a02bf9a5,1,samindaw,2013-08-01 08:50:32+00:00,['3924583d6f93fffc1620c124c795d46c914c4abc'],161,379,540,1116849,15,0.896907216,0.958762887,0.948453608,3821
5c5b0c9e04c61e498e29f1a1bdf83244dbc8b89e,0,samindaw,2013-08-01 09:30:59+00:00,['3cff229897cbb626a239c6e117e2ecf4a02bf9a5'],54,26,80,1116929,2,,,,3821
b36d2192e3bedce8ea24919106bcfd978cfbaeef,0,samindaw,2013-08-07 13:59:44+00:00,['5c5b0c9e04c61e498e29f1a1bdf83244dbc8b89e'],74,303,377,1117306,10,1,1,0.76,3824
f223ec1e23958f1b015d8ab0c28a907dd4bd33f5,1,chathuri,2013-08-07 15:20:31+00:00,['b36d2192e3bedce8ea24919106bcfd978cfbaeef'],103,41,144,1117450,12,1,0,0,3824
6af342fcff4491c3d6f9b36f372ead500cdbd452,0,chathuri,2013-08-07 15:23:15+00:00,['f223ec1e23958f1b015d8ab0c28a907dd4bd33f5'],13,106,119,1117569,8,0.4,0.4,0.2,3826
003e8786c60201aaf37bc28813047493577a78d4,0,samindaw,2013-08-07 15:46:13+00:00,['6af342fcff4491c3d6f9b36f372ead500cdbd452'],25,46,71,1117640,13,0,1,1,3826
cc8c04c1cc1ebc8aeda07966c63b5d25070c9ec7,0,chathuri,2013-08-08 18:10:35+00:00,['003e8786c60201aaf37bc28813047493577a78d4'],1,1,2,1117642,1,0,0,0,3826
8e75280783b085e5bec892eec1af9e92a608123a,0,chathuri,2013-08-13 15:28:20+00:00,['cc8c04c1cc1ebc8aeda07966c63b5d25070c9ec7'],1,178,179,1117821,7,0.45,1,0.05,3829
289ab6f0576e256aa68805bbe0b5e4ae155fba3d,0,Lahiru Gunathilake,2013-08-13 18:41:13+00:00,['8e75280783b085e5bec892eec1af9e92a608123a'],1,1,2,1117823,1,,,,3829
b086d035ba9888f54b19666d375030cd18dbe10f,0,samindaw,2013-08-14 17:50:36+00:00,['289ab6f0576e256aa68805bbe0b5e4ae155fba3d'],8,59,67,1117890,3,0.019607843,1,1,3829
17993b3f9698ebc051935a6b8f2954adb38c38e2,0,samindaw,2013-08-14 18:01:48+00:00,['b086d035ba9888f54b19666d375030cd18dbe10f'],2,56,58,1117948,2,1,1,1,3830
7d4bb9836b4029048169ef58b55a25adccfd0b82,0,samindaw,2013-08-14 18:05:39+00:00,['17993b3f9698ebc051935a6b8f2954adb38c38e2'],3,2,5,1117953,1,0,0,0,3830
80e10cfafbeeb08d6fd9bec4e25b208486117c45,0,samindaw,2013-08-14 18:12:44+00:00,['7d4bb9836b4029048169ef58b55a25adccfd0b82'],1,9,10,1117963,1,0,1,1,3830
0afd312c0e7f68064c24ed1186ce7da69769dc37,0,samindaw,2013-08-14 18:18:56+00:00,['80e10cfafbeeb08d6fd9bec4e25b208486117c45'],3,4,7,1117970,1,,,,3830
fa9bf428c8b307301e9aaa49b09fa2096aecf4f8,0,Lahiru Gunathilake,2013-08-14 20:28:04+00:00,['0afd312c0e7f68064c24ed1186ce7da69769dc37'],0,6,6,1117976,1,0,0,1,3830
73fe015840bcd19bae31e3b84949aaab87832418,0,samindaw,2013-08-15 02:45:11+00:00,['fa9bf428c8b307301e9aaa49b09fa2096aecf4f8'],16,61,77,1118053,4,0.875,0.71875,1,3830
a65c993c38808be4fdf772bce7c04326826fafbd,0,Suresh Marru,2013-08-15 02:59:47+00:00,['73fe015840bcd19bae31e3b84949aaab87832418'],666,272,938,1118991,14,0.606299213,0.181102362,0.133858268,3830
81e675dca847d323ae58a548855603b457b645b9,0,samindaw,2013-08-15 16:19:32+00:00,['a65c993c38808be4fdf772bce7c04326826fafbd'],15,35,50,1119041,5,0.5,0.666666667,0,3830
d14797589a5626eeb26e9b8b0f1c13f30193f847,0,samindaw,2013-08-15 21:44:48+00:00,['81e675dca847d323ae58a548855603b457b645b9'],41,44,85,1119126,3,0.516129032,0.516129032,0.516129032,3830
58aed9de35040b91c02c7f4f3ec16f20b975a217,0,samindaw,2013-08-15 23:48:45+00:00,['d14797589a5626eeb26e9b8b0f1c13f30193f847'],1,4,5,1119131,1,0,1,1,3830
0e26e2d22c74641f4b03acbea7b472f3160304b2,0,Suresh Marru,2013-08-16 00:58:39+00:00,['58aed9de35040b91c02c7f4f3ec16f20b975a217'],11,10,21,1119152,4,,,,3830
0b0b1b615e45b7333fba8543ef63601469f18692,0,Suresh Marru,2013-08-16 12:47:50+00:00,['0e26e2d22c74641f4b03acbea7b472f3160304b2'],23,0,23,1119175,7,,,,3830
74f0608ab5cee1de0fa515f5c75d9de8a10eb7cc,0,Suresh Marru,2013-08-16 13:14:19+00:00,['0b0b1b615e45b7333fba8543ef63601469f18692'],138,121,259,1119434,5,,,,3830
8906f5e60c2af0e44246bb4fdca586608c5e2c38,0,samindaw,2013-08-16 23:14:48+00:00,['74f0608ab5cee1de0fa515f5c75d9de8a10eb7cc'],35,63,98,1119532,16,0,1,1,3831
1eaa69b3ca1db269460b39484626c6da9152fdc1,0,samindaw,2013-08-17 06:22:15+00:00,['8906f5e60c2af0e44246bb4fdca586608c5e2c38'],1,1,2,1119534,1,,,,3831
8ff1f9ac8f4d2ec0d6939a8983306061ade842f6,0,samindaw,2013-08-17 16:20:27+00:00,['1eaa69b3ca1db269460b39484626c6da9152fdc1'],16,1,17,1119551,1,0,0,0,3831
2ac97efdd16dd2926a570f76324a9f83fe3295a1,0,Suresh Marru,2013-08-17 17:01:07+00:00,['8ff1f9ac8f4d2ec0d6939a8983306061ade842f6'],42,46,88,1119639,11,,,,3831
2a287b01b6b68a4597594501ed4dbbe0ec17d0ab,0,Suresh Marru,2013-08-18 03:41:44+00:00,['2ac97efdd16dd2926a570f76324a9f83fe3295a1'],151,132,283,1119922,10,,,,3831
db2b45b2b9f3b432be18eb0dd77dbeb1b51c24f6,0,Suresh Marru,2013-08-18 04:21:33+00:00,['2a287b01b6b68a4597594501ed4dbbe0ec17d0ab'],77,57,134,1120056,8,,,,3831
2168b01665701f7ce472a7950b0a13d1db84ca5d,0,Suresh Marru,2013-08-18 04:46:34+00:00,['db2b45b2b9f3b432be18eb0dd77dbeb1b51c24f6'],10,11,21,1120077,8,,,,3831
c5049c3f8b409b6d4f2e88093b3f3016ae86be9b,0,Suresh Marru,2013-08-18 13:08:59+00:00,['2168b01665701f7ce472a7950b0a13d1db84ca5d'],71,49,120,1120197,7,0.666666667,0,0,3831
a4b0d008ac1c3ffd7d6153fbe484d9876d008841,0,Suresh Marru,2013-08-18 13:21:19+00:00,['c5049c3f8b409b6d4f2e88093b3f3016ae86be9b'],291,269,560,1120757,8,0.874251497,0.359281437,0.161676647,3831
6611a314815e9fc3736adf9956a613b95ff28ca6,0,Suresh Marru,2013-08-18 13:32:57+00:00,['a4b0d008ac1c3ffd7d6153fbe484d9876d008841'],18,0,18,1120775,2,,,,3831
5729d5d06a144d980be1074ae5e69db0585a709e,0,Suresh Marru,2013-08-18 13:47:59+00:00,['6611a314815e9fc3736adf9956a613b95ff28ca6'],5,0,5,1120780,1,,,,3831
a6b96636ca6204ad79f523f85340abd084a179f7,0,Suresh Marru,2013-08-18 14:08:59+00:00,['5729d5d06a144d980be1074ae5e69db0585a709e'],9,0,9,1120789,1,,,,3831
7ccccff505b7a7913cc2fbd1bd6f0f02d2eb8019,0,samindaw,2013-08-19 01:51:46+00:00,['a6b96636ca6204ad79f523f85340abd084a179f7'],5,39,44,1120833,2,0,0,1,3831
64b4c21b16e65942187fae6039c18b9fe1b74e47,0,samindaw,2013-08-19 19:05:49+00:00,['7ccccff505b7a7913cc2fbd1bd6f0f02d2eb8019'],8,49,57,1120890,1,0.787878788,0.787878788,1,3831
ff97940b6a8967e2c2b9dfa0236bfaa6d3909b59,0,samindaw,2013-08-20 01:26:48+00:00,['64b4c21b16e65942187fae6039c18b9fe1b74e47'],65,108,173,1121063,14,0,0,0,3831
4e11c1cc2ab9e7fee49c436ac1c570aab4af1400,0,samindaw,2013-08-20 03:08:37+00:00,['ff97940b6a8967e2c2b9dfa0236bfaa6d3909b59'],0,10,10,1121073,3,1,1,0.888888889,3831
ba84c4fcf838557fb23fc8a58653aa02f208d39f,0,samindaw,2013-08-20 16:08:52+00:00,['4e11c1cc2ab9e7fee49c436ac1c570aab4af1400'],15,21,36,1121109,1,0,1,1,3831
bfebc737111f42a91372ec47fdf9205023e413ea,0,Lahiru Gunathilake,2013-08-20 19:39:57+00:00,['ba84c4fcf838557fb23fc8a58653aa02f208d39f'],2,18,20,1121129,2,0.909090909,0.909090909,0.090909091,3831
553e3116fb15b8dcc82e2e5d8525ce939dca8c6d,0,samindaw,2013-08-20 21:35:02+00:00,['bfebc737111f42a91372ec47fdf9205023e413ea'],14,1101,1115,1122244,4,0.504504505,0.905405405,1,3834
859246c5d7a84118e178f11934bfa7de0aaadf29,0,samindaw,2013-08-20 21:37:47+00:00,['553e3116fb15b8dcc82e2e5d8525ce939dca8c6d'],4,1,5,1122249,1,,,,3834
06a1bb25125baf4a3568d8c740c5095d13beab96,0,samindaw,2013-08-20 21:48:48+00:00,['859246c5d7a84118e178f11934bfa7de0aaadf29'],2,4,6,1122255,1,0,1,1,3834
2be86e419cca0eba8fbf18c9bfa80658fd978b46,0,samindaw,2013-08-21 02:58:15+00:00,['06a1bb25125baf4a3568d8c740c5095d13beab96'],56,743,799,1123054,2,1,1,0,3835
e53e9f0a6a509d77a9c5c9fb889a02292a0d5284,0,samindaw,2013-08-21 14:54:16+00:00,['2be86e419cca0eba8fbf18c9bfa80658fd978b46'],1,1,2,1123056,1,,,,3835
ec87913e6b4a5db9394c3056c07e9fab2729055a,0,Lahiru Gunathilake,2013-08-21 17:23:37+00:00,['e53e9f0a6a509d77a9c5c9fb889a02292a0d5284'],8,10,18,1123074,1,0,0,1,3835
d470b75cbebdf57fdfb3b2301419e1463fcf6287,0,samindaw,2013-08-21 19:05:21+00:00,['ec87913e6b4a5db9394c3056c07e9fab2729055a'],4,0,4,1123078,1,1,1,0,3835
b469348cae059557c4e57145c9c984b76a0ed574,0,Lahiru Gunathilake,2013-08-21 21:05:36+00:00,['d470b75cbebdf57fdfb3b2301419e1463fcf6287'],5,25,30,1123108,1,1,1,1,3835
b3f65f227f0e9389c05f556a94d1618118b01e33,0,samindaw,2013-08-21 21:08:27+00:00,['b469348cae059557c4e57145c9c984b76a0ed574'],9,13,22,1123130,1,1,1,1,3835
d9e3d2b1ded20905c866c8382ac07e0fda849992,0,amilaj,2013-08-22 02:57:09+00:00,['b3f65f227f0e9389c05f556a94d1618118b01e33'],119,1015,1134,1124264,27,0.092783505,0.632302405,0.872852234,3846
af4676c694344a55709817b61d49ce96d4b47f34,0,Raminderjeet Singh,2013-08-22 15:55:48+00:00,['d9e3d2b1ded20905c866c8382ac07e0fda849992'],2,2,4,1124268,1,,,,3846
289247765c98a3b6da80968f9bc9caffb969646f,0,amilaj,2013-08-22 15:57:04+00:00,['af4676c694344a55709817b61d49ce96d4b47f34'],1,4,5,1124273,1,,,,3846
dcf91ac365af8002fbc1b5eb46707ec3dfa0c44d,0,amilaj,2013-08-22 19:31:59+00:00,['289247765c98a3b6da80968f9bc9caffb969646f'],0,4,4,1124277,1,,,,3846
7f29adf78a99c3a92496e56a4bdb1227dc8392dc,0,samindaw,2013-08-22 20:43:35+00:00,['dcf91ac365af8002fbc1b5eb46707ec3dfa0c44d'],1601,5634,7235,1131512,27,1,1,1,3855
925ec534846061f08802bb1e93b80fbfb6c9f42a,0,chathuri,2013-08-22 21:45:05+00:00,['7f29adf78a99c3a92496e56a4bdb1227dc8392dc'],1,2,3,1131515,1,0,0,1,3855
fa163259bc32230e143702d51580192dfb830cf6,0,samindaw,2013-08-23 04:05:48+00:00,['925ec534846061f08802bb1e93b80fbfb6c9f42a'],3,3,6,1131521,2,,,,3855
b011428f1467748275d09f0706f225007a135e18,0,samindaw,2013-08-23 04:08:40+00:00,['fa163259bc32230e143702d51580192dfb830cf6'],2,2,4,1131525,2,,,,3855
b6e992a000897a36fc0e6fb51bd5e86e4f08978c,0,samindaw,2013-08-23 04:22:45+00:00,['b011428f1467748275d09f0706f225007a135e18'],17,16,33,1131558,2,,,,3855
235beec861333415b6dd89a7da313b8570d2d785,0,samindaw,2013-08-23 14:36:58+00:00,['b6e992a000897a36fc0e6fb51bd5e86e4f08978c'],110,11497,11607,1143165,21,,,,3867
e4696b25a6a8c6a8675c484cad188820a91220ab,0,samindaw,2013-08-23 14:38:02+00:00,['235beec861333415b6dd89a7da313b8570d2d785'],0,45,45,1143210,1,,,,3868
d9b09183225e163e4d12c7204da434dd6c2f5e7a,0,samindaw,2013-08-23 16:06:48+00:00,['e4696b25a6a8c6a8675c484cad188820a91220ab'],8659,28,8687,1151897,7,,,,3868
ed4b6b273216ae8a5fd340663fa6aaba1a0db3bf,0,samindaw,2013-08-23 20:10:43+00:00,['d9b09183225e163e4d12c7204da434dd6c2f5e7a'],935,963,1898,1153795,3,0.608856089,0.193726937,0.04797048,3868
de2948ed61a453d46994d1c272bd34964739c2c1,0,samindaw,2013-08-23 20:11:39+00:00,['ed4b6b273216ae8a5fd340663fa6aaba1a0db3bf'],935,1275,2210,1156005,3,0.450068399,0.789329685,0.928864569,3869
0aa43982d0df3a0326eed6fe385b68aa57c51f83,0,samindaw,2013-08-23 20:29:43+00:00,['de2948ed61a453d46994d1c272bd34964739c2c1'],2,2,4,1156009,1,0,0,0,3869
3e8d4b2d558dd18bac60a25acddc6cf9dec0459d,0,amilaj,2013-08-23 20:34:41+00:00,['0aa43982d0df3a0326eed6fe385b68aa57c51f83'],7,205,212,1156221,3,1,1,1,3870
88f500f131f69777122a08995d80ac4a6fbbd535,0,samindaw,2013-08-23 20:45:32+00:00,['3e8d4b2d558dd18bac60a25acddc6cf9dec0459d'],445,1466,1911,1158132,2,,,,3870
ce47d298a45ffb220c42597b1df8db365ede0082,0,samindaw,2013-08-23 21:09:12+00:00,['88f500f131f69777122a08995d80ac4a6fbbd535'],0,6,6,1158138,1,,,,3870
7438c08e55e6c8fd14bf0faeae19a0c44d4aa44d,0,samindaw,2013-08-23 21:12:03+00:00,['ce47d298a45ffb220c42597b1df8db365ede0082'],0,10,10,1158148,2,,,,3870
9786b5c14a38f263cc6aeb1c3075fdb1cdf5832c,0,samindaw,2013-08-23 21:27:54+00:00,['7438c08e55e6c8fd14bf0faeae19a0c44d4aa44d'],2,2,4,1158152,2,,,,3870
d41911f22369300c43bf4393e66e3e908d4b2335,0,samindaw,2013-08-23 21:29:33+00:00,['9786b5c14a38f263cc6aeb1c3075fdb1cdf5832c'],0,3,3,1158155,3,,,,3870
3168890452323d0e0cc38999841ace9b4e5baad9,0,Suresh Marru,2013-08-24 22:34:32+00:00,['d41911f22369300c43bf4393e66e3e908d4b2335'],5,463,468,1158623,44,,,,3912
2af1f44401531b17640a7b04f72478aa497d3f2a,0,Suresh Marru,2013-08-25 23:22:59+00:00,['3168890452323d0e0cc38999841ace9b4e5baad9'],0,260,260,1158883,3,,,,3915
b393872c548214822ed1b64581ec0a14445c14fa,0,Suresh Marru,2013-08-25 23:44:31+00:00,['2af1f44401531b17640a7b04f72478aa497d3f2a'],0,421,421,1159304,32,,,,3947
fac3929a284902a257a74bb09b9b98ce7cd8dc9c,0,samindaw,2013-08-26 00:37:04+00:00,['b393872c548214822ed1b64581ec0a14445c14fa'],37,30,67,1159371,5,1,0,1,3947
eac7a61fd76603018928a64748c810ebe552e4b8,0,samindaw,2013-08-26 01:47:43+00:00,['fac3929a284902a257a74bb09b9b98ce7cd8dc9c'],10,21,31,1159402,5,1,0.9,1,3947
f56c49d45ed7d1660d1fc5f60bcdc51e246e0c21,0,samindaw,2013-08-26 17:23:16+00:00,['eac7a61fd76603018928a64748c810ebe552e4b8'],14,41,55,1159457,2,0,0,0,3947
faf7a2b63ebc68dd110895a54a5d1e3c4862ccb7,0,Lahiru Gunathilake,2013-08-26 21:08:31+00:00,['f56c49d45ed7d1660d1fc5f60bcdc51e246e0c21'],15,20,35,1159492,4,0,0,1,3947
2939ef6d31e2f31056f777274a72f4187aaf6da7,0,chathuri,2013-08-27 18:06:53+00:00,['faf7a2b63ebc68dd110895a54a5d1e3c4862ccb7'],5,8,13,1159505,2,0,0,1,3947
f8247d8f75869cb49316b265045635105469fd7d,0,chathuri,2013-08-27 21:00:15+00:00,['2939ef6d31e2f31056f777274a72f4187aaf6da7'],2,8,10,1159515,2,,,,3947
1698a9ef9c2fed7f5838fc86b74495e957902df0,0,samindaw,2013-08-28 20:48:55+00:00,['f8247d8f75869cb49316b265045635105469fd7d'],29,29,58,1159573,3,0,0,1,3947
eaf4f3fb6211e49e8324eef14d5da375aeecc6b9,0,Raminderjeet Singh,2013-08-29 16:02:02+00:00,['1698a9ef9c2fed7f5838fc86b74495e957902df0'],5,5,10,1159583,1,,,,3947
8558b789a60d7bddb856a909d9a8b1631b27792d,0,Lahiru Gunathilake,2013-08-29 16:45:23+00:00,['eaf4f3fb6211e49e8324eef14d5da375aeecc6b9'],7,0,7,1159590,1,1,1,0,3947
ffc1865f1dd8632a45f24a4a5b1b2347f4f1c265,0,chathuri,2013-08-30 16:49:52+00:00,['8558b789a60d7bddb856a909d9a8b1631b27792d'],1,8,9,1159599,2,0.666666667,1,1,3947
bf6ddf8eb9ae601b28f97d37d0ec7595de1d0c94,0,samindaw,2013-09-03 23:35:48+00:00,['ffc1865f1dd8632a45f24a4a5b1b2347f4f1c265'],3,3,6,1159605,1,,,,3947
fd8ff5e90470fe5bbb03e73f712b0e47cddc0834,0,samindaw,2013-09-04 17:06:07+00:00,['bf6ddf8eb9ae601b28f97d37d0ec7595de1d0c94'],0,36,36,1159641,2,0.5,0.5,1,3948
683d08ca9cc7ea02aa832fdcf9984a95045abd23,1,samindaw,2013-09-04 17:18:15+00:00,['fd8ff5e90470fe5bbb03e73f712b0e47cddc0834'],2,2,4,1159645,1,,,,3948
91737d5668445cd393f66b07c6a0d847bad3120f,0,Suresh Marru,2013-09-05 21:39:34+00:00,['683d08ca9cc7ea02aa832fdcf9984a95045abd23'],5,1,6,1159651,1,,,,3948
bca78bfaed4ab0210c27e5d48c462f2e0098c2b5,0,Suresh Marru,2013-09-05 21:42:53+00:00,['91737d5668445cd393f66b07c6a0d847bad3120f'],2149,0,2149,1161800,154,,,,3948
46697d047bfbee6023ae0f100ff2053eef10cff5,1,amilaj,2013-09-06 02:03:01+00:00,['bca78bfaed4ab0210c27e5d48c462f2e0098c2b5'],252,2205,2457,1164257,50,0.726315789,0.970526316,0.905263158,3966
a8d8f9a5fbc612db33c1191e2132c6da22246931,0,samindaw,2013-09-06 19:09:29+00:00,['46697d047bfbee6023ae0f100ff2053eef10cff5'],3,3,6,1164263,1,,,,3966
ed1d74658372a4b2cb0c3ac08c8aa40048d8bb1d,0,samindaw,2013-09-06 19:32:12+00:00,['a8d8f9a5fbc612db33c1191e2132c6da22246931'],121,121,242,1164505,4,0,0,0.266666667,3966
322941d2935d52476c7ac7c0a618f742af3ea1eb,0,samindaw,2013-09-06 19:44:51+00:00,['ed1d74658372a4b2cb0c3ac08c8aa40048d8bb1d'],121,121,242,1164747,4,1,1,0.733333333,3966
a18f98126cbdebe0e410eda176e4f275bc618f79,0,samindaw,2013-09-12 09:54:30+00:00,['322941d2935d52476c7ac7c0a618f742af3ea1eb'],1,1,2,1164749,1,,,,3966
8acbfe8c5393f3f4b522e8a0a8fb7eb82e4205bb,0,samindaw,2013-09-12 10:24:19+00:00,['a18f98126cbdebe0e410eda176e4f275bc618f79'],4,8,12,1164761,2,0,0,1,3966
994b786f7ac32fe999d8038142f27e54760b7043,0,amilaj,2013-09-12 20:38:19+00:00,['8acbfe8c5393f3f4b522e8a0a8fb7eb82e4205bb'],23,348,371,1165132,15,0,0.288135593,1,3968
fd52df96e96a914844aea6c6ed5ac7b1f9e32563,0,amilaj,2013-09-12 20:39:55+00:00,['994b786f7ac32fe999d8038142f27e54760b7043'],1,1,2,1165134,1,,,,3968
a1a04a0cdd93ff3b3c4b0adddaa35cbd1866b177,0,amilaj,2013-09-12 20:44:07+00:00,['fd52df96e96a914844aea6c6ed5ac7b1f9e32563'],3,0,3,1165137,1,,,,3968
014dbdd8aed9f36b5f292d0046fe5dd5427fa8f6,0,amilaj,2013-09-12 21:22:49+00:00,['a1a04a0cdd93ff3b3c4b0adddaa35cbd1866b177'],1,7,8,1165145,1,1,1,1,3968
506ad2628443c87ed2e9ca0fb97a7dbd5aeb7c03,0,Raminderjeet Singh,2013-09-13 18:54:19+00:00,['014dbdd8aed9f36b5f292d0046fe5dd5427fa8f6'],1,1,2,1165147,1,,,,3968
c0a71ca7bd43de140e7a44f4745cbd96c3f99082,0,chathuri,2013-09-13 20:15:49+00:00,['506ad2628443c87ed2e9ca0fb97a7dbd5aeb7c03'],18,18,36,1165183,4,,,,3968
c120e2748ac8a8ae758378d690ffd3d214c2718d,0,amilaj,2013-09-19 03:29:56+00:00,['c0a71ca7bd43de140e7a44f4745cbd96c3f99082'],7,43,50,1165233,3,,,,3968
e5f485c4b71a4ef5d1c11c82b7fa63025c94a8c9,0,amilaj,2013-09-19 14:27:00+00:00,['c120e2748ac8a8ae758378d690ffd3d214c2718d'],2535,2969,5504,1170737,29,,,,3968
ffd87ff495cb3d38b7ca8a035868658a22adeba0,0,amilaj,2013-09-19 19:36:30+00:00,['e5f485c4b71a4ef5d1c11c82b7fa63025c94a8c9'],101,78,179,1170916,53,,,,3968
ad38a3853d928c4285e68eca9c257d4a7a14f668,0,amilaj,2013-09-19 19:36:40+00:00,['ffd87ff495cb3d38b7ca8a035868658a22adeba0'],56,56,112,1171028,53,,,,3968
11c2f7d9a359bcfe89e64ce287219cc7d7a0427f,0,Suresh Marru,2013-09-23 22:18:03+00:00,['ad38a3853d928c4285e68eca9c257d4a7a14f668'],3,162,165,1171193,6,0.076335878,0.076335878,0.770992366,3968
666ea76d98c97b386f3bab89c9c8fce345140fc5,1,Suresh Marru,2013-09-23 22:25:39+00:00,['11c2f7d9a359bcfe89e64ce287219cc7d7a0427f'],1,212,213,1171406,9,0.438596491,0.824561404,1,3971
9d7af006b42101341733ca738b6d31fcae9aa458,0,samindaw,2013-09-23 22:57:38+00:00,['666ea76d98c97b386f3bab89c9c8fce345140fc5'],3,60,63,1171469,3,0,0,1,3971
ff2f17c4603bea89a8e06f11c6cb11126d49df74,0,chathuri,2013-09-25 21:43:20+00:00,['9d7af006b42101341733ca738b6d31fcae9aa458'],2,17,19,1171488,1,0,1,1,3971
8ca8def60300cfd8f6c6ff7702b72816a90806d0,0,chathuri,2013-09-25 21:44:36+00:00,['ff2f17c4603bea89a8e06f11c6cb11126d49df74'],10,96,106,1171594,7,0,1,1,3971
aa13472307f5a899dd2f25d0152d73af9c63041a,0,samindaw,2013-09-27 15:04:04+00:00,['8ca8def60300cfd8f6c6ff7702b72816a90806d0'],2,27,29,1171623,1,0,0,1,3971
d0cac1df0b9432fc0bf17696ea378bc1e8bc1ac0,0,Lahiru Gunathilake,2013-09-30 20:08:44+00:00,['aa13472307f5a899dd2f25d0152d73af9c63041a'],64,93,157,1171780,1,,,,3971
1e404dfe47bad873cb2fe37bdedfbbc5daa3d3d6,0,Lahiru Gunathilake,2013-09-30 20:17:04+00:00,['d0cac1df0b9432fc0bf17696ea378bc1e8bc1ac0'],12,180,192,1171972,4,0.209876543,0.530864198,1,3972
73eaa2fb7528b88e49ee818e6b7d0c41f1e2c850,0,samindaw,2013-10-01 00:43:27+00:00,['1e404dfe47bad873cb2fe37bdedfbbc5daa3d3d6'],6,52,58,1172030,4,0.782608696,1,1,3974
b72f68cd12a197fb9a5b98d1b1bfd43ddcbe107b,0,Lahiru Gunathilake,2013-10-04 14:22:28+00:00,['73eaa2fb7528b88e49ee818e6b7d0c41f1e2c850'],2,1,3,1172033,1,1,1,0,3974
3aa7271d530b887877e4d0290dc9c07430236008,0,Lahiru Gunathilake,2013-10-07 21:18:41+00:00,['b72f68cd12a197fb9a5b98d1b1bfd43ddcbe107b'],0,1,1,1172034,1,,,,3974
aca119dc886ca0e537c1a251fa441df680661f0a,0,Lahiru Gunathilake,2013-10-07 21:20:10+00:00,['3aa7271d530b887877e4d0290dc9c07430236008'],61,556,617,1172651,10,0.274285714,1,1,3977
8a7ee4a0a93c8971885e84d8892659b24d2b1b5c,0,Lahiru Gunathilake,2013-10-08 18:37:04+00:00,['aca119dc886ca0e537c1a251fa441df680661f0a'],1,2,3,1172654,2,,,,3977
40705ff40537578c0b9dd8d5347637ce24efb781,0,Lahiru Gunathilake,2013-10-08 18:45:03+00:00,['8a7ee4a0a93c8971885e84d8892659b24d2b1b5c'],27,28,55,1172709,6,0,0,1,3977
f16b9f41525d70cf3157b14638cc28f089157c2d,0,Lahiru Gunathilake,2013-10-08 20:19:30+00:00,['40705ff40537578c0b9dd8d5347637ce24efb781'],60,93,153,1172862,1,0,0,0,3977
96a78f68067db204bffb75465283e4cc62c4c5af,0,samindaw,2013-10-08 23:32:17+00:00,['f16b9f41525d70cf3157b14638cc28f089157c2d'],10,160,170,1173032,4,0.142857143,0,0.669642857,3977
26d094d2a4129dfc823c2fdcdf86d1feac422da6,0,Lahiru Gunathilake,2013-10-09 12:54:52+00:00,['96a78f68067db204bffb75465283e4cc62c4c5af'],14,6,20,1173052,4,1,1,0,3977
0b7c7849cd9233525b1d6b2b78af21726733b66c,0,Lahiru Gunathilake,2013-10-09 14:08:28+00:00,['26d094d2a4129dfc823c2fdcdf86d1feac422da6'],4,4,8,1173060,1,,,,3977
d7890971a5bbf8b0b0674e25e3b21317d568d67b,0,samindaw,2013-10-09 17:03:23+00:00,['0b7c7849cd9233525b1d6b2b78af21726733b66c'],3,7,10,1173070,1,1,1,1,3977
e493f7466ebb879a8090c978bff62b248df5e0a8,0,Lahiru Gunathilake,2013-10-09 17:13:07+00:00,['d7890971a5bbf8b0b0674e25e3b21317d568d67b'],15,19,34,1173104,1,0,0,1,3977
7a81a9ac90fbaec598865bddf9f36f509e990b08,0,samindaw,2013-10-09 17:32:59+00:00,['e493f7466ebb879a8090c978bff62b248df5e0a8'],8,33,41,1173145,2,1,1,1,3977
09c940b819f18f4c2cf4ba5d244fca90b7a31279,0,samindaw,2013-10-09 17:56:32+00:00,['7a81a9ac90fbaec598865bddf9f36f509e990b08'],1,7,8,1173153,1,0,0,1,3977
f341523346378402e4aa522dd3ddecdc80dcaf1a,0,samindaw,2013-10-09 18:28:38+00:00,['09c940b819f18f4c2cf4ba5d244fca90b7a31279'],68,74,142,1173295,1,1,1,0,3977
6d2ff2104689e88e5a6988aff5925c4a480e47a9,0,Lahiru Gunathilake,2013-10-09 18:33:09+00:00,['f341523346378402e4aa522dd3ddecdc80dcaf1a'],1,23,24,1173319,2,0.75,0.75,1,3977
c56f8342d6d7ea92f7f6508a5b1d7a176cae2710,0,Suresh Marru,2013-10-09 20:34:19+00:00,['6d2ff2104689e88e5a6988aff5925c4a480e47a9'],1,1,2,1173321,1,,,,3977
2ad169d342b391759991ab82ce4e076bd6053549,1,amilaj,2013-10-11 17:08:03+00:00,['c56f8342d6d7ea92f7f6508a5b1d7a176cae2710'],77,159,236,1173557,3,0.224489796,0,1,3978
0d9a4da365b2ee8940de5ce6baeae22986d2e110,0,amilaj,2013-10-11 17:08:24+00:00,['2ad169d342b391759991ab82ce4e076bd6053549'],2,254,256,1173813,4,1,1,0.373737374,3981
12db9756d85383b91fe75363a12bfbe55fffddf5,0,Lahiru Gunathilake,2013-10-12 15:12:20+00:00,['0d9a4da365b2ee8940de5ce6baeae22986d2e110'],214,374,588,1174401,10,0.35,0.466666667,0.966666667,3982
a97c842adf64268a395c304648f762072f193b4e,0,Lahiru Gunathilake,2013-10-12 15:13:10+00:00,['12db9756d85383b91fe75363a12bfbe55fffddf5'],13,11,24,1174425,1,,,,3982
a6455b8a96655e52c08aad722d0e53dff8b0e176,0,Lahiru Gunathilake,2013-10-12 15:14:17+00:00,['a97c842adf64268a395c304648f762072f193b4e'],0,102,102,1174527,3,,,,3983
2b069c32d121dc2031ee6cffc241c040b04ed150,0,Lahiru Gunathilake,2013-10-14 16:56:56+00:00,['a6455b8a96655e52c08aad722d0e53dff8b0e176'],34,82,116,1174643,3,0,0,1,3983
b019438e92132ed9b20b6098f820016fe3a6cb45,0,Raminderjeet Singh,2013-10-14 17:08:01+00:00,['2b069c32d121dc2031ee6cffc241c040b04ed150'],0,13542,13542,1188185,292,0.396216216,0.530540541,0.698648649,4275
72f0b46c7db846af7a87a27920e6ff35437a547d,0,Raminderjeet Singh,2013-10-14 17:09:45+00:00,['b019438e92132ed9b20b6098f820016fe3a6cb45'],4907,0,4907,1193092,232,,,,4275
d6e182ae25f8e2964255c0c08156ee29a45b2548,0,Lahiru Gunathilake,2013-10-14 19:50:20+00:00,['72f0b46c7db846af7a87a27920e6ff35437a547d'],75,104,179,1193271,16,0.473684211,0.578947368,1,4275
0365706f230ce3140e35f2632bbcced27456bf5a,0,Raminderjeet Singh,2013-10-14 21:23:26+00:00,['d6e182ae25f8e2964255c0c08156ee29a45b2548'],39,21,60,1193331,6,,,,4275
4db0c87632ad217bfd26b2e5f3bce9701cf2f17c,0,Raminderjeet Singh,2013-10-14 21:24:04+00:00,['0365706f230ce3140e35f2632bbcced27456bf5a'],1,1,2,1193333,1,,,,4275
912af9e56d01cd0683318f4e491cf988054cfd6c,0,Raminderjeet Singh,2013-10-14 21:25:14+00:00,['4db0c87632ad217bfd26b2e5f3bce9701cf2f17c'],1,1,2,1193335,1,,,,4275
36ff4e5b74b54ac2d5a2348ddb7b3fab082c1f64,0,Raminderjeet Singh,2013-10-14 21:39:46+00:00,['912af9e56d01cd0683318f4e491cf988054cfd6c'],5,5,10,1193345,1,,,,4275
4984417fc162a3e0966f45c10debd9c34f826b00,0,samindaw,2013-10-15 23:43:24+00:00,['36ff4e5b74b54ac2d5a2348ddb7b3fab082c1f64'],8,10,18,1193363,5,0,0,1,4275
9f1d8a22b1422e3f6f20c37618e18b5f65c013a8,0,Raminderjeet Singh,2013-10-16 14:39:09+00:00,['4984417fc162a3e0966f45c10debd9c34f826b00'],3,3,6,1193369,2,,,,4275
15ed13e737b67c06c0533b021723c510391d4527,0,Lahiru Gunathilake,2013-10-16 20:50:11+00:00,['9f1d8a22b1422e3f6f20c37618e18b5f65c013a8'],56,72,128,1193497,12,1,0.125,1,4275
aafab709b5858e437ec48e18f5b00c5099b3159b,0,samindaw,2013-10-17 18:25:56+00:00,['15ed13e737b67c06c0533b021723c510391d4527'],2,5,7,1193504,1,0,1,1,4275
053e5d734f82294c1b45bf48ce3e34525c260571,0,Lahiru Gunathilake,2013-10-17 19:01:58+00:00,['aafab709b5858e437ec48e18f5b00c5099b3159b'],18,34,52,1193556,3,0,0.428571429,1,4275
39852acdc6e6c599ad44614c9fdc53055703b638,0,Lahiru Gunathilake,2013-10-17 19:02:17+00:00,['053e5d734f82294c1b45bf48ce3e34525c260571'],2,2,4,1193560,1,,,,4275
97d1e8c119a74a92ba35ac731b4ed8e1e4cde3a3,0,Lahiru Gunathilake,2013-10-17 19:02:50+00:00,['39852acdc6e6c599ad44614c9fdc53055703b638'],13,5,18,1193578,4,,,,4276
2052db4714cc643db4413b6655b3e5e91ba01e4d,0,Lahiru Gunathilake,2013-10-17 19:04:10+00:00,['97d1e8c119a74a92ba35ac731b4ed8e1e4cde3a3'],28,37,65,1193643,3,1,1,0,4276
a7f3953f4563075908fc271a0b3c5d179170ddb3,0,amilaj,2013-10-17 20:44:42+00:00,['2052db4714cc643db4413b6655b3e5e91ba01e4d'],0,16,16,1193659,2,1,1,1,4276
63981f0e54637fbce4b8254760a8ea30cce36c26,0,Raminderjeet Singh,2013-10-21 18:14:10+00:00,['a7f3953f4563075908fc271a0b3c5d179170ddb3'],15,2,17,1193676,1,,,,4276
6aa8e5c4a65237b4b43fca1f0daa6347d3623880,0,samindaw,2013-10-21 18:28:42+00:00,['63981f0e54637fbce4b8254760a8ea30cce36c26'],129,117,246,1193922,4,0,0,0.266666667,4276
1a44c40afdd3a4a27f7ebe334957c44a36f2a1bc,0,samindaw,2013-10-21 19:24:05+00:00,['6aa8e5c4a65237b4b43fca1f0daa6347d3623880'],38,119,157,1194079,4,0.1875,1,1,4276
bcf8ff09d5c86d49d5c5a64320648ae48d96b3db,0,Raminderjeet Singh,2013-10-22 18:26:10+00:00,['1a44c40afdd3a4a27f7ebe334957c44a36f2a1bc'],3,2,5,1194084,1,,,,4276
b48ff90910dd1b91b102b9cdb5654adb74a8eec0,0,Raminderjeet Singh,2013-10-22 18:36:33+00:00,['bcf8ff09d5c86d49d5c5a64320648ae48d96b3db'],9,0,9,1194093,1,,,,4276
8c2efe2529e1bde661d81da7242a8979fcf79f79,0,Lahiru Gunathilake,2013-10-23 18:17:50+00:00,['b48ff90910dd1b91b102b9cdb5654adb74a8eec0'],21,27,48,1194141,3,0.666666667,0.666666667,0.666666667,4276
5eb253a852315621198407edcd41e0aeccd4b2d9,0,Raminderjeet Singh,2013-10-23 18:46:12+00:00,['8c2efe2529e1bde661d81da7242a8979fcf79f79'],6,8,14,1194155,1,,,,4276
4b622999881012c54e6ba4bbeb26a1b4ed71607b,0,samindaw,2013-10-23 19:42:56+00:00,['5eb253a852315621198407edcd41e0aeccd4b2d9'],162,66,228,1194383,4,0,0,0,4276
fdf484134a51e61b30deb31f71407c4e6b7c6f51,0,Suresh Marru,2013-10-24 01:27:34+00:00,['4b622999881012c54e6ba4bbeb26a1b4ed71607b'],1,0,1,1194384,2,,,,4276
636fa5cff9cb00773d0b69539e4f2fa71b70b0e0,0,samindaw,2013-10-24 13:49:11+00:00,['fdf484134a51e61b30deb31f71407c4e6b7c6f51'],9,4,13,1194397,5,0,0,0,4276
5aa7c5a08d5a81286c132d86b15ecc4387c88dd4,0,Raminderjeet Singh,2013-10-25 21:36:03+00:00,['636fa5cff9cb00773d0b69539e4f2fa71b70b0e0'],0,12,12,1194409,1,,,,4276
8b0d60fc11711d60196806a131dbb98db93ad206,0,Raminderjeet Singh,2013-10-25 21:41:12+00:00,['5aa7c5a08d5a81286c132d86b15ecc4387c88dd4'],2,2,4,1194413,2,,,,4276
400a0e60561d1f0f1c5d0a51fd1739483adf2e81,0,Raminderjeet Singh,2013-10-27 03:45:00+00:00,['8b0d60fc11711d60196806a131dbb98db93ad206'],1,2,3,1194416,1,,,,4276
70074d470839d6b3a25342f8a786e437090a8689,0,Raminderjeet Singh,2013-10-28 14:53:17+00:00,['400a0e60561d1f0f1c5d0a51fd1739483adf2e81'],0,629,629,1195045,1,,,,4276
3760a223ca45c148a722a8a6b9ce913b6f7245ff,0,Raminderjeet Singh,2013-10-28 15:57:22+00:00,['70074d470839d6b3a25342f8a786e437090a8689'],0,6,6,1195051,1,,,,4276
7282643d3c6e25f62e1e4c125b567fe6311a0b6e,0,Raminderjeet Singh,2013-10-28 15:58:36+00:00,['3760a223ca45c148a722a8a6b9ce913b6f7245ff'],515,0,515,1195566,1,,,,4276
fe94f41b5be3b08245cfb62575e95df2cca7dabc,0,Raminderjeet Singh,2013-10-28 18:44:41+00:00,['7282643d3c6e25f62e1e4c125b567fe6311a0b6e'],12,8,20,1195586,1,1,1,0,4276
4cc461523a9ea8255975ab4d0b1603d21029f96a,0,Raminderjeet Singh,2013-10-28 18:46:34+00:00,['fe94f41b5be3b08245cfb62575e95df2cca7dabc'],15,36,51,1195637,3,,,,4276
84f0b86b2f9a5d47498209009ced75cfdb3f3674,0,Raminderjeet Singh,2013-10-29 17:14:57+00:00,['4cc461523a9ea8255975ab4d0b1603d21029f96a'],0,31,31,1195668,1,,,,4276
2a8314e317e036b4489e37ea64c5411fcdcf7ef4,0,Raminderjeet Singh,2013-10-29 17:30:23+00:00,['84f0b86b2f9a5d47498209009ced75cfdb3f3674'],4907,0,4907,1200575,232,,,,4276
1d0a3ce3702e3eb391dffcbc96fce1356de82801,0,chathuri,2013-10-29 17:36:51+00:00,['2a8314e317e036b4489e37ea64c5411fcdcf7ef4'],5,6,11,1200586,5,,,,4276
b905396e3886dd82ed3bb2efef129dd4e3ff8a3d,0,chathuri,2013-10-29 17:42:44+00:00,['1d0a3ce3702e3eb391dffcbc96fce1356de82801'],1,1,2,1200588,1,,,,4276
37a17fe35e512d403e34821170c9dd742a744480,0,Raminderjeet Singh,2013-10-29 20:48:51+00:00,['b905396e3886dd82ed3bb2efef129dd4e3ff8a3d'],0,114,114,1200702,1,,,,4276
b6a394e7db754355c34ed12d918293c5d5d3ca68,0,Raminderjeet Singh,2013-10-29 21:05:37+00:00,['37a17fe35e512d403e34821170c9dd742a744480'],12,21,33,1200735,3,,,,4276
590d7ad1391bd639f4fa49b26122b75505a5fd17,0,Raminderjeet Singh,2013-10-29 21:07:08+00:00,['b6a394e7db754355c34ed12d918293c5d5d3ca68'],2,104,106,1200841,5,,,,4276
10d7f63b533ad737210f5846515eb1575da16780,0,Raminderjeet Singh,2013-10-29 21:12:43+00:00,['590d7ad1391bd639f4fa49b26122b75505a5fd17'],25,21,46,1200887,1,,,,4276
7215d2cf9e4820b19890b0852fd81d4af569c20e,0,Raminderjeet Singh,2013-10-29 21:14:30+00:00,['10d7f63b533ad737210f5846515eb1575da16780'],2,41,43,1200930,2,,,,4276
67c6f7092207fe570b5d5f8c8e51a43d683332f6,0,Raminderjeet Singh,2013-10-29 21:18:32+00:00,['7215d2cf9e4820b19890b0852fd81d4af569c20e'],1,39,40,1200970,2,,,,4276
d4df83746aabbd605059b18a0ff9c667d778e02a,0,Raminderjeet Singh,2013-10-29 21:19:35+00:00,['67c6f7092207fe570b5d5f8c8e51a43d683332f6'],0,21,21,1200991,1,,,,4276
7081387e4701fd7be43f6bac2be15bf8f873081f,0,Suresh Marru,2013-10-30 13:17:12+00:00,['d4df83746aabbd605059b18a0ff9c667d778e02a'],2186,1,2187,1203178,1,,,,4276
176c7443e49ccd00d7e7b8d9278680806f60ca19,0,Raminderjeet Singh,2013-10-30 13:51:58+00:00,['7081387e4701fd7be43f6bac2be15bf8f873081f'],0,1,1,1203179,1,,,,4276
e2b39294b73800f6e81a5d74f5cbc58f61726480,0,Raminderjeet Singh,2013-10-30 14:20:42+00:00,['176c7443e49ccd00d7e7b8d9278680806f60ca19'],1,1,2,1203181,1,,,,4276
7ec14335da5040b09ca2f031b86b91029c7f1e27,0,Raminderjeet Singh,2013-10-30 14:22:02+00:00,['e2b39294b73800f6e81a5d74f5cbc58f61726480'],1,0,1,1203182,1,,,,4276
2e5af758edc8dd11645f4a18e931c0506f74ec76,0,Raminderjeet Singh,2013-10-30 15:49:34+00:00,['7ec14335da5040b09ca2f031b86b91029c7f1e27'],59,58,117,1203299,54,,,,4276
0595430dbda827e727ed5223a742a42da0578d4e,0,Raminderjeet Singh,2013-10-30 15:49:42+00:00,['2e5af758edc8dd11645f4a18e931c0506f74ec76'],57,57,114,1203413,54,,,,4276
b6f6c17c509428ba92f2ed25ec5156fbe0b8b258,0,chathuri,2013-11-13 18:13:03+00:00,['0595430dbda827e727ed5223a742a42da0578d4e'],5,6,11,1203424,5,,,,4276
8c3bad18146bcf0b92a463e55ad9f98a23aff726,0,chathuri,2013-11-13 18:14:50+00:00,['b6f6c17c509428ba92f2ed25ec5156fbe0b8b258'],0,12436,12436,1215860,20,0.488711195,0.589840075,0.976952023,4295
eddedc8db695e87d7d5f222813a07640cb6c6dcf,0,chathuri,2013-11-13 18:22:07+00:00,['8c3bad18146bcf0b92a463e55ad9f98a23aff726'],8,751,759,1216619,7,0.529058116,0.689378758,0.789579158,4298
3a2cad30e00c4f0b01116e7b7771d0271138a122,0,chathuri,2013-11-13 18:23:58+00:00,['eddedc8db695e87d7d5f222813a07640cb6c6dcf'],7,53,60,1216679,8,,,,4298
350e6f59c09897ec947c8096da62b027125687eb,0,chathuri,2013-11-13 18:25:39+00:00,['3a2cad30e00c4f0b01116e7b7771d0271138a122'],0,5,5,1216684,1,,,,4298
7a2afc4d3f615baddbeb403c63f0b265d994120a,0,chathuri,2013-11-13 21:29:32+00:00,['350e6f59c09897ec947c8096da62b027125687eb'],12,21,33,1216717,2,0.4,1,0.4,4298
e099a8948f7f656bded7d99e3e82d694cb4ee70c,0,chathuri,2013-11-15 14:41:51+00:00,['7a2afc4d3f615baddbeb403c63f0b265d994120a'],11,131,142,1216859,19,0.151515152,0.151515152,1,4298
262b1cae8b6b4afe60bae83a87dca913697ed870,0,Lahiru Gunathilake,2013-11-20 19:18:59+00:00,['e099a8948f7f656bded7d99e3e82d694cb4ee70c'],3,6,9,1216868,1,0,0,1,4298
f5aa6178483e538bf21605375ba18c02771be959,0,Lahiru Gunathilake,2013-11-25 17:06:43+00:00,['262b1cae8b6b4afe60bae83a87dca913697ed870'],12,1,13,1216881,2,0,0,0.8,4298
2b1bb18792f66cc367140e565c31c7685a5b9c31,0,amilaj,2013-12-03 22:14:55+00:00,['f5aa6178483e538bf21605375ba18c02771be959'],0,293,293,1217174,6,0.736111111,1,0.805555556,4303
5d88f4f8d72494c83672bae000ca9592ace5edb3,0,Lahiru Gunathilake,2013-12-10 20:52:23+00:00,['2b1bb18792f66cc367140e565c31c7685a5b9c31'],126,1073,1199,1218373,140,0,0,1,4313
7c5f11e8ba6365ce64d96617d6ddaff73111049e,0,Lahiru Gunathilake,2013-12-10 20:52:41+00:00,['5d88f4f8d72494c83672bae000ca9592ace5edb3'],1,1,2,1218375,1,,,,4313
8b5e735addf45e2bb9c617e15143cfd4c5965d65,0,Lahiru Gunathilake,2013-12-10 20:56:35+00:00,['7c5f11e8ba6365ce64d96617d6ddaff73111049e'],8,4,12,1218387,4,0,0,0,4313
faad7890167a7c57109fe72b6dc144a859043077,0,Lahiru Gunathilake,2013-12-10 21:42:43+00:00,['8b5e735addf45e2bb9c617e15143cfd4c5965d65'],0,42,42,1218429,1,,,,4314
1703136ed530d6dee18fdafa30777a0d885e32fb,0,chathuri,2013-12-11 17:09:51+00:00,['faad7890167a7c57109fe72b6dc144a859043077'],155,113,268,1218697,12,,,,4314
d05b29df38f13b93dc0affcded6bf7ad289b3421,0,Lahiru Gunathilake,2013-12-11 17:51:47+00:00,['1703136ed530d6dee18fdafa30777a0d885e32fb'],0,14,14,1218711,4,,,,4314
f1761230702e0f82d94be91b6ea80afc7329c108,0,chathuri,2013-12-11 22:07:21+00:00,['d05b29df38f13b93dc0affcded6bf7ad289b3421'],10704,11014,21718,1240429,16,0,0,1,4314
f443a168885b78c13a3e49de1524bd32add11441,0,chathuri,2013-12-12 04:25:48+00:00,['f1761230702e0f82d94be91b6ea80afc7329c108'],431,48,479,1240908,27,0.711340206,0.628865979,0.190721649,4314
2a013efa74f6ea3ae271f240be9f2a2f823bb13a,0,chathuri,2013-12-12 04:28:22+00:00,['f443a168885b78c13a3e49de1524bd32add11441'],1,437,438,1241346,5,0.53968254,0.698412698,0.78968254,4318
1d29b77df8e6c82edb4251978b122c101d4ad4ab,0,chathuri,2013-12-12 20:53:47+00:00,['2a013efa74f6ea3ae271f240be9f2a2f823bb13a'],100,700,800,1242146,7,0.561253561,0.943019943,0.914529915,4322
7b484339cbc01b79c63930fef7bc9baa2d1187c5,0,samindaw,2013-12-12 23:03:24+00:00,['1d29b77df8e6c82edb4251978b122c101d4ad4ab'],1,3,4,1242150,1,0,1,1,4322
966ac918e6a5adeddff0e2785d6473de85d0b794,0,Raminderjeet Singh,2013-12-13 16:19:35+00:00,['7b484339cbc01b79c63930fef7bc9baa2d1187c5'],1431,1789,3220,1245370,24,0.344569288,0.348314607,0.812734082,4322
212020533b4e05c91327a74ce08abf46add239ae,0,Raminderjeet Singh,2013-12-13 16:22:01+00:00,['966ac918e6a5adeddff0e2785d6473de85d0b794'],0,1348,1348,1246718,8,0.333745365,0.467243511,0.611866502,4330
25132c71d57a70665bd1ef10d4448285a3b4dbdf,0,chathuri,2013-12-13 16:41:50+00:00,['212020533b4e05c91327a74ce08abf46add239ae'],788,467,1255,1247973,4,0.519417476,0.203883495,0.004854369,4331
d46ed7048697558c2f13bfdc7a8e0f4a072ef952,0,amilaj,2013-12-13 17:43:23+00:00,['25132c71d57a70665bd1ef10d4448285a3b4dbdf'],15,1005,1020,1248993,18,0.344036697,0.532110092,0.816513761,4339
23edda683786f7b2bd63a1c127aa8a22f5a5ce28,0,chathuri,2013-12-13 18:22:38+00:00,['d46ed7048697558c2f13bfdc7a8e0f4a072ef952'],38,0,38,1249031,4,,,,4339
f014c76d55a8cc0b56e9426089c889e9f6d9daf8,0,Suresh Marru,2013-12-13 19:18:56+00:00,['23edda683786f7b2bd63a1c127aa8a22f5a5ce28'],6,17,23,1249054,1,,,,4339
cae02da59780cad3d1f3bf449c3f015059b602cf,0,Raminderjeet Singh,2013-12-16 17:19:25+00:00,['f014c76d55a8cc0b56e9426089c889e9f6d9daf8'],10,28,38,1249092,6,,,,4339
cd878badb629acef71901bc06f266977f4ee300f,0,chathuri,2013-12-17 16:08:32+00:00,['cae02da59780cad3d1f3bf449c3f015059b602cf'],0,31,31,1249123,1,,,,4339
f1d190e0eecf5729fe6620b886b38a4197db0fef,0,chathuri,2013-12-17 16:16:20+00:00,['cd878badb629acef71901bc06f266977f4ee300f'],13,18,31,1249154,2,,,,4339
b8a1dcae0d661d5dfad82a4ed2c66e0b0cb56042,0,samindaw,2013-12-17 19:48:58+00:00,['f1d190e0eecf5729fe6620b886b38a4197db0fef'],3,3,6,1249160,3,,,,4339
ff490e369996ce43d04184b6474d9da5c4a8351a,0,chathuri,2013-12-18 15:33:58+00:00,['b8a1dcae0d661d5dfad82a4ed2c66e0b0cb56042'],1,4,5,1249165,1,,,,4339
3e3ab13a8346e5deb963a9cfbd4627fd1a98ba66,0,Lahiru Gunathilake,2013-12-18 16:00:58+00:00,['ff490e369996ce43d04184b6474d9da5c4a8351a'],5,2,7,1249172,1,0,0,0,4339
1b5eabb67aa384ed610330d5e70ba71bce8076a1,0,chathuri,2013-12-18 16:13:14+00:00,['3e3ab13a8346e5deb963a9cfbd4627fd1a98ba66'],1,358,359,1249531,17,,,,4339
77c3503b348c61cd8a747c5b714d772bbcf880fc,0,chathuri,2013-12-18 17:51:33+00:00,['1b5eabb67aa384ed610330d5e70ba71bce8076a1'],535,541,1076,1250607,7,0.651090343,0.062305296,0.093457944,4339
ac5de4a5cbebd090049522776bba0ba5dd1b2e27,0,chathuri,2013-12-18 18:22:59+00:00,['77c3503b348c61cd8a747c5b714d772bbcf880fc'],5,1,6,1250613,1,,,,4339
13b297e88626349bfc7f92ea794d8f29e9f63fdf,0,chathuri,2013-12-18 20:13:11+00:00,['ac5de4a5cbebd090049522776bba0ba5dd1b2e27'],23,16,39,1250652,1,,,,4339
8ea3ffe00e9425a98481fdbd20f682fc750d299c,0,chathuri,2013-12-18 21:07:38+00:00,['13b297e88626349bfc7f92ea794d8f29e9f63fdf'],73,68,141,1250793,60,,,,4339
fb8b3d6768f581933a477ba8b8dd09c95ae49616,0,chathuri,2013-12-18 21:07:54+00:00,['8ea3ffe00e9425a98481fdbd20f682fc750d299c'],63,63,126,1250919,60,,,,4339
909e4c14a7d872fa4d2112ef3e9abaaa9d718706,0,amilaj,2013-12-24 00:43:32+00:00,['fb8b3d6768f581933a477ba8b8dd09c95ae49616'],1,1,2,1250921,1,,,,4339
c14bef531b5528f196ac6c3c84b897ace04641ea,0,amilaj,2013-12-24 14:28:49+00:00,['909e4c14a7d872fa4d2112ef3e9abaaa9d718706'],1,1,2,1250923,1,,,,4339
faca9e1e548c60683e2d2f2607221b6cc3e39995,0,amilaj,2013-12-26 12:52:50+00:00,['c14bef531b5528f196ac6c3c84b897ace04641ea'],8,0,8,1250931,1,,,,4339
defe4dd29648a13c92815eba037e84dce4b4a6f1,0,amilaj,2013-12-26 15:04:56+00:00,['faca9e1e548c60683e2d2f2607221b6cc3e39995'],256,14,270,1251201,4,1,1,1,4340
0d4bf8d28e2b7331394c2495e5609a32b04c7747,0,amilaj,2013-12-26 16:50:54+00:00,['defe4dd29648a13c92815eba037e84dce4b4a6f1'],48,209,257,1251458,11,,,,4340
cf71bc3f11e91eb712d38e467a5f54dc38b2972a,0,amilaj,2013-12-26 17:14:05+00:00,['0d4bf8d28e2b7331394c2495e5609a32b04c7747'],60,60,120,1251578,60,,,,4340
3e4795884dad9909fbf8fc4d9e439ff04c41913e,0,amilaj,2013-12-26 18:28:46+00:00,['cf71bc3f11e91eb712d38e467a5f54dc38b2972a'],63,63,126,1251704,60,,,,4340
1965aa2300eacecd428412c15e91f20ed9fa0fc7,0,amilaj,2013-12-26 18:28:57+00:00,['3e4795884dad9909fbf8fc4d9e439ff04c41913e'],63,63,126,1251830,60,,,,4340
cc311afd4a54f73f7fd9b799c01eb87a2d8484ec,0,amilaj,2014-01-02 04:18:26+00:00,['1965aa2300eacecd428412c15e91f20ed9fa0fc7'],29,476,505,1252335,19,0.608938547,0.826815642,0.938547486,4344
165698795a24acc452804243502f3a58f72e0cea,0,samindaw,2014-01-05 04:16:02+00:00,['cc311afd4a54f73f7fd9b799c01eb87a2d8484ec'],0,2,2,1252337,1,0,1,1,4344
fe2f865dffbf4aa7f44e26bade9bd9cd0b2a218c,0,Lahiru Gunathilake,2014-01-09 16:29:29+00:00,['165698795a24acc452804243502f3a58f72e0cea'],22,180,202,1252539,3,1,1,1,4345
a4d6e4b28019480be4a091135e6ccbe89520313f,1,Lahiru Gunathilake,2014-01-09 16:36:55+00:00,['fe2f865dffbf4aa7f44e26bade9bd9cd0b2a218c'],0,1147,1147,1253686,18,0.591269841,0.726190476,1,4363
b7ec31f4868e9fff5f972f5865a4b13361ade321,0,Lahiru Gunathilake,2014-01-09 16:39:07+00:00,['a4d6e4b28019480be4a091135e6ccbe89520313f'],0,95,95,1253781,1,1,1,1,4364
715bd186d132c733fbed6e20a339ef8f055874a0,0,Lahiru Gunathilake,2014-01-09 16:52:37+00:00,['b7ec31f4868e9fff5f972f5865a4b13361ade321'],6,49,55,1253836,4,1,1,1,4365
32c8c4a74809f6362b4f5b4e9a552aee494bb9e0,0,Lahiru Gunathilake,2014-01-09 17:06:39+00:00,['715bd186d132c733fbed6e20a339ef8f055874a0'],9,46,55,1253891,3,1,1,1,4365
2dadd84d668b8d04390ac8301edbf5e7057e78ab,0,Raminderjeet Singh,2014-01-09 19:12:27+00:00,['32c8c4a74809f6362b4f5b4e9a552aee494bb9e0'],0,169,169,1254060,2,1,1,1,4367
2a62434569eb089572e7f04e4afcdbc9d9069902,0,Lahiru Gunathilake,2014-01-09 20:31:45+00:00,['2dadd84d668b8d04390ac8301edbf5e7057e78ab'],146,319,465,1254525,14,0.510638298,0.989361702,1,4369
d5c753258350273b61f93cf21d22d35669ce9469,1,Raminderjeet Singh,2014-01-09 20:47:07+00:00,['2a62434569eb089572e7f04e4afcdbc9d9069902'],231,232,463,1254988,2,0,1,0.7,4369
6e852db7448540f16e81d736419d350ef256ed1f,0,Raminderjeet Singh,2014-01-09 20:47:37+00:00,['d5c753258350273b61f93cf21d22d35669ce9469'],0,59,59,1255047,1,1,1,1,4370
1d105fe7706cf1857e7d9cca7e65152cca4b9709,0,Raminderjeet Singh,2014-01-10 18:18:33+00:00,['6e852db7448540f16e81d736419d350ef256ed1f'],1,187,188,1255235,3,0.439393939,1,1,4371
bfb89a0a62bd594ded40647d176f6c43f8a9e461,1,Lahiru Gunathilake,2014-01-10 18:42:50+00:00,['1d105fe7706cf1857e7d9cca7e65152cca4b9709'],1,248,249,1255484,11,0.460526316,1,1,4372
8abaaeec3855287fe38415032d125be561bb4e0f,0,Lahiru Gunathilake,2014-01-10 18:43:26+00:00,['bfb89a0a62bd594ded40647d176f6c43f8a9e461'],5,31,36,1255520,2,1,1,1,4372
d0966c62d52c30e51c2f5ea427a10622012d814f,0,Raminderjeet Singh,2014-01-10 18:54:00+00:00,['8abaaeec3855287fe38415032d125be561bb4e0f'],0,21,21,1255541,2,,,,4372
3bc294400763d2ab051af992ed445b486ce5d3e0,0,Lahiru Gunathilake,2014-01-10 20:53:53+00:00,['d0966c62d52c30e51c2f5ea427a10622012d814f'],33,145,178,1255719,5,0.142857143,0.446428571,1,4373
9126194a66b88688fe283d036c7c9f1e04b51c0d,0,Lahiru Gunathilake,2014-01-13 17:23:51+00:00,['3bc294400763d2ab051af992ed445b486ce5d3e0'],35,150,185,1255904,15,0.127272727,0.6,1,4373
923bbd700fa5e9ee80ed6674ae05a1f72abdd889,1,Raminderjeet Singh,2014-01-13 19:17:25+00:00,['9126194a66b88688fe283d036c7c9f1e04b51c0d'],47,166,213,1256117,10,0.897959184,0.918367347,0.489795918,4373
7b8af1b78e4ef89322e0924a99dfb86735a9dc22,0,Raminderjeet Singh,2014-01-13 21:41:04+00:00,['923bbd700fa5e9ee80ed6674ae05a1f72abdd889'],1,5,6,1256123,2,,,,4373
712d6b8b42380edfc469730062b8143739baabd2,1,Lahiru Gunathilake,2014-01-14 14:42:33+00:00,['7b8af1b78e4ef89322e0924a99dfb86735a9dc22'],36,706,742,1256865,16,0.223484848,0.435606061,1,4376
4d1735c03e1705c09b3ebd7f94ca38eda7b9173a,0,Lahiru Gunathilake,2014-01-14 14:58:32+00:00,['712d6b8b42380edfc469730062b8143739baabd2'],0,342,342,1257207,3,,,,4379
0853dbcad83057afe17eb3661a94198f050ece66,0,Lahiru Gunathilake,2014-01-14 15:02:17+00:00,['4d1735c03e1705c09b3ebd7f94ca38eda7b9173a'],0,70,70,1257277,1,,,,4380
ae9acba2cd9003e3f5a8486ca92238067cee53c0,1,Lahiru Gunathilake,2014-01-14 15:08:11+00:00,['0853dbcad83057afe17eb3661a94198f050ece66'],3,6,9,1257286,3,1,1,1,4380
5d46292b91fa8b08978fbcc9dfe3be29f0637611,0,Lahiru Gunathilake,2014-01-14 15:08:48+00:00,['ae9acba2cd9003e3f5a8486ca92238067cee53c0'],70,0,70,1257356,1,,,,4380
f608e82b7c9faa13a12f1cced4865836e2996e36,0,Raminderjeet Singh,2014-01-14 16:00:13+00:00,['5d46292b91fa8b08978fbcc9dfe3be29f0637611'],57,59,116,1257472,9,0.5,0,0,4380
1a9827abf100d49daf328df3761035941d55fca4,0,Raminderjeet Singh,2014-01-14 17:02:16+00:00,['f608e82b7c9faa13a12f1cced4865836e2996e36'],9,49,58,1257530,5,1,1,1,4381
7777ea572a11560cd64f9b01dfedbae83eb91fb2,0,Raminderjeet Singh,2014-01-14 17:26:17+00:00,['1a9827abf100d49daf328df3761035941d55fca4'],11,12,23,1257553,5,,,,4381
4ce9325204cfba1802d4a47f2a5863f0e793cd6b,1,Lahiru Gunathilake,2014-01-14 17:56:50+00:00,['7777ea572a11560cd64f9b01dfedbae83eb91fb2'],103,171,274,1257827,8,0.5,0,1,4381
de74d557a513c4dc804b556ecc1335c5a9c91ec7,1,Lahiru Gunathilake,2014-01-14 18:26:24+00:00,['4ce9325204cfba1802d4a47f2a5863f0e793cd6b'],25,24,49,1257876,2,1,1,1,4381
567295b1fa55c505bfb4e59460192e2274960862,0,Lahiru Gunathilake,2014-01-14 19:00:46+00:00,['de74d557a513c4dc804b556ecc1335c5a9c91ec7'],9,21,30,1257906,2,1,0,0,4381
fae85a81006c07ea0a77dad74de06d97366150d3,1,Lahiru Gunathilake,2014-01-14 19:00:59+00:00,['567295b1fa55c505bfb4e59460192e2274960862'],12,15,27,1257933,3,0.333333333,1,1,4381
5c8dc2721f9b1b0ca4cb1538706bf422a42df32c,1,Lahiru Gunathilake,2014-01-14 20:58:18+00:00,['fae85a81006c07ea0a77dad74de06d97366150d3'],36,249,285,1258218,3,0.384,0.576,1,4382
f15458a624756fb5b66895a0bb5cc3500f5a7aa2,0,Lahiru Gunathilake,2014-01-14 20:58:52+00:00,['5c8dc2721f9b1b0ca4cb1538706bf422a42df32c'],1,19,20,1258238,3,0.6,1,1,4382
9ac4bbc1f3445c86d016707d6f0e22d3faca8ffe,0,Raminderjeet Singh,2014-01-16 15:38:00+00:00,['f15458a624756fb5b66895a0bb5cc3500f5a7aa2'],51,178,229,1258467,18,0.409090909,0.920454545,1,4382
290432da7dc4e1e9da9c58b4da5473f731ff4134,0,chathuri,2014-01-16 20:20:10+00:00,['9ac4bbc1f3445c86d016707d6f0e22d3faca8ffe'],130,83,213,1258680,12,1,0,0,4382
841478ed3b953003a00ebd9b288eae1da7537d63,0,chathuri,2014-01-16 21:51:13+00:00,['290432da7dc4e1e9da9c58b4da5473f731ff4134'],8,58,66,1258746,3,1,1,0.951219512,4382
81c6b8c158a2cff24de04b27249a389131d32ef6,0,Suresh Marru,2014-01-20 17:03:05+00:00,['841478ed3b953003a00ebd9b288eae1da7537d63'],0,281,281,1259027,2,,,,4384
c6e6e597834e296a4604020563de3c8881e5fad1,0,Suresh Marru,2014-01-21 20:50:07+00:00,['81c6b8c158a2cff24de04b27249a389131d32ef6'],39,301,340,1259367,2,,,,4384
a387daab8ae44d0e3ae879702d28427f17f0dcd6,1,Raminderjeet Singh,2014-01-21 20:58:48+00:00,['c6e6e597834e296a4604020563de3c8881e5fad1'],9,1237,1246,1260613,13,0.787564767,1,1,4394
32332d08b429f8a7ac1a4d9903a63329986ee118,0,Marlon Pierce,2014-01-21 21:02:10+00:00,['a387daab8ae44d0e3ae879702d28427f17f0dcd6'],1,20,21,1260634,5,,,,4394
3198ccdc3f451efe77e622a3a64b7358e482dd14,0,Suresh Marru,2014-01-21 21:22:06+00:00,['32332d08b429f8a7ac1a4d9903a63329986ee118'],1,105,106,1260740,2,,,,4395
327524e2c39876ccb8edaf88e3b4c6ed1e0ee087,0,Suresh Marru,2014-01-22 14:36:45+00:00,['3198ccdc3f451efe77e622a3a64b7358e482dd14'],55,80,135,1260875,1,,,,4395
58f25fc01e069bf981f288a863fbe809cc5734b3,0,chathuri,2014-01-22 19:28:01+00:00,['327524e2c39876ccb8edaf88e3b4c6ed1e0ee087'],62,101,163,1261038,4,,,,4396
c38812ac636e8e97cbce8d2730e9ea46da3b00d4,1,Raminderjeet Singh,2014-01-22 20:28:29+00:00,['58f25fc01e069bf981f288a863fbe809cc5734b3'],160,438,598,1261636,24,0.825,1,1,4399
db5f4ebdeb9437182e41217198dab8ae7feed563,0,chathuri,2014-01-22 21:16:27+00:00,['c38812ac636e8e97cbce8d2730e9ea46da3b00d4'],5,6,11,1261647,2,,,,4399
6f7f2527bd5e4b49ce129559d2220e9dd53934cf,1,Raminderjeet Singh,2014-01-22 21:23:00+00:00,['db5f4ebdeb9437182e41217198dab8ae7feed563'],49,120,169,1261816,12,1,1,1,4401
9e5c9a1b78b386d5e32195e5a8998599ed5993af,0,Raminderjeet Singh,2014-01-22 21:32:59+00:00,['6f7f2527bd5e4b49ce129559d2220e9dd53934cf'],108,0,108,1261924,1,,,,4401
2e9a04a5165896ace2f5a3e12dd5b53015d2a57a,0,Raminderjeet Singh,2014-01-24 20:29:32+00:00,['9e5c9a1b78b386d5e32195e5a8998599ed5993af'],4,6,10,1261934,1,0,0,1,4401
ea18cec2e865dbea182efd726c7ead83d35a2be4,0,Suresh Marru,2014-01-24 20:38:41+00:00,['2e9a04a5165896ace2f5a3e12dd5b53015d2a57a'],39,0,39,1261973,1,,,,4401
f908ec2db4a2b8f946d575e28b3131eeb82e48d4,0,Suresh Marru,2014-01-26 19:57:29+00:00,['ea18cec2e865dbea182efd726c7ead83d35a2be4'],55,78,133,1262106,5,,,,4401
49b3fdf802cbcf51e14ad51fe47c29cadd075cce,0,Suresh Marru,2014-01-27 22:52:13-05:00,['f908ec2db4a2b8f946d575e28b3131eeb82e48d4'],3,3,6,1262112,1,,,,4401
f5b74edf60507bbea59dd8bcb1aa0f2c90084078,0,Suresh Marru,2014-01-27 23:02:13-05:00,['49b3fdf802cbcf51e14ad51fe47c29cadd075cce'],0,2,2,1262114,1,,,,4401
82336042e08fa6bc32f7ef5a21f6f07e592a424b,0,mpierce,2014-01-28 09:26:52-05:00,['f5b74edf60507bbea59dd8bcb1aa0f2c90084078'],0,1,1,1262115,1,,,,4402
aa494205583ae8ee8a61df1113789b7eaf1b6d41,0,chathuriw,2014-01-28 12:14:48-05:00,['82336042e08fa6bc32f7ef5a21f6f07e592a424b'],4,2,6,1262121,2,,,,4402
ab892f7b218e6bee991e7de5f7ec16e804345887,0,chathuriw,2014-01-28 14:04:49-05:00,['aa494205583ae8ee8a61df1113789b7eaf1b6d41'],6,240,246,1262367,4,1,1,0,4402
c750c236fdc10f853b529874fe2e4e80d3272885,0,Suresh Marru,2014-01-28 15:58:59-05:00,['f5b74edf60507bbea59dd8bcb1aa0f2c90084078'],0,0,0,1262367,1,,,,4402
361c2ff01d4d90d400d78c3bd893204c80258530,0,Suresh Marru,2014-01-28 15:59:15-05:00,"['c750c236fdc10f853b529874fe2e4e80d3272885', 'ab892f7b218e6bee991e7de5f7ec16e804345887']",10,243,253,1262620,7,,,,4402
f42c75f33217ca19aba3d53d213cdbdc252c4649,0,Suresh Marru,2014-01-28 16:32:29-05:00,['361c2ff01d4d90d400d78c3bd893204c80258530'],39,75,114,1262734,3,,,,4403
528d3ff41f2f0086e1c8835d3610822bd55bf45a,0,Saminda Wijeratne,2014-01-28 15:05:58-08:00,['f42c75f33217ca19aba3d53d213cdbdc252c4649'],1,25,26,1262760,2,1,1,1,4403
0d42feab5b8cb3648ab36d1a09d2108e687d6523,0,raminder,2014-01-29 11:33:29-05:00,['528d3ff41f2f0086e1c8835d3610822bd55bf45a'],0,14,14,1262774,2,,,,4404
05ba6eacb03556a0c22d2b222c0d32eae7f00769,0,Suresh Marru,2014-02-03 08:35:01-05:00,['0d42feab5b8cb3648ab36d1a09d2108e687d6523'],0,48,48,1262822,1,,,,4405
72f55e982ce4362497af55388a9f5b547b8e6a74,0,Suresh Marru,2014-02-03 12:38:22-05:00,['05ba6eacb03556a0c22d2b222c0d32eae7f00769'],33,32,65,1262887,1,,,,4405
5cf0a0f554fb2be52eac19b1af3e8506c63f2276,0,Suresh Marru,2014-02-03 15:50:25-05:00,['72f55e982ce4362497af55388a9f5b547b8e6a74'],25,26,51,1262938,2,,,,4405
4cfc32e39b8954390acadcad5003309e8b4bbb0b,0,lginnali,2014-02-04 10:57:35-05:00,['5cf0a0f554fb2be52eac19b1af3e8506c63f2276'],0,258,258,1263196,2,0.117021277,0.319148936,1,4407
926cd91d45e542cb61af83951af7d8a3339ce212,0,lahiru,2014-02-04 11:15:31-05:00,['4cfc32e39b8954390acadcad5003309e8b4bbb0b'],0,4,4,1263200,1,1,1,1,4407
0f06c3c5562d77cca70fc25473230de44aa7ba1b,0,lahiru,2014-02-04 14:40:13-05:00,['926cd91d45e542cb61af83951af7d8a3339ce212'],14,15,29,1263229,12,,,,4407
10b41d864bd3e9fe57802216bf2d5b11a9978539,1,chathuri,2014-02-04 14:52:04-05:00,['0f06c3c5562d77cca70fc25473230de44aa7ba1b'],3084,5143,8227,1271456,81,0.952095808,0.526946108,1,4422
f2eaba0510464a4d9b412123ea7643c43e648e1c,1,lahiru,2014-02-04 15:36:12-05:00,['0f06c3c5562d77cca70fc25473230de44aa7ba1b'],222,4,226,1271682,4,0.768518519,0.592592593,0,4422
45df543e98eae717f9c33b9fceed04ca8907b500,0,lahiru,2014-02-04 15:36:29-05:00,"['f2eaba0510464a4d9b412123ea7643c43e648e1c', '10b41d864bd3e9fe57802216bf2d5b11a9978539']",3084,5143,8227,1279909,81,,,,4422
43524f0639fce6a9da0b43f489f78ba9c8aa0855,0,lahiru,2014-02-04 15:57:24-05:00,['45df543e98eae717f9c33b9fceed04ca8907b500'],180,19,199,1280108,7,0.459770115,0.459770115,0,4422
25cc25147ff950f4b08e534a925adfedeb3b2883,0,chathuri,2014-02-05 10:42:34-05:00,['43524f0639fce6a9da0b43f489f78ba9c8aa0855'],0,106,106,1280214,3,,,,4424
68f57ff7af005750a1632d1c2373b491d0968b23,0,lahiru,2014-02-05 12:05:34-05:00,['43524f0639fce6a9da0b43f489f78ba9c8aa0855'],4,4,8,1280222,2,,,,4424
be563843b2132e76b0b5236416f2269f2f806be8,0,chathuri,2014-02-05 13:49:57-05:00,['25cc25147ff950f4b08e534a925adfedeb3b2883'],46,38,84,1280306,1,,,,4424
f747ffff28f1637789d8bd875cb7ece491610f13,0,chathuri,2014-02-05 14:25:29-05:00,['be563843b2132e76b0b5236416f2269f2f806be8'],0,60,60,1280366,1,,,,4425
1ebc29b457dacc6b741eccc00234a73845411b5f,0,lahiru,2014-02-05 14:26:52-05:00,"['68f57ff7af005750a1632d1c2373b491d0968b23', 'f747ffff28f1637789d8bd875cb7ece491610f13']",46,204,250,1280616,5,,,,4425
7b68f893b20ae0f7eac32298cace88773c8e9daf,0,chathuri,2014-02-05 14:27:38-05:00,['f747ffff28f1637789d8bd875cb7ece491610f13'],4,4,8,1280624,1,,,,4425
92bcd53101fac4fbd14287f94568cae3dc16db52,0,lahiru,2014-02-05 14:47:49-05:00,"['1ebc29b457dacc6b741eccc00234a73845411b5f', '7b68f893b20ae0f7eac32298cace88773c8e9daf']",4,4,8,1280632,1,,,,4425
8f457cb48a3f373f462bbadca2f6c2ec00dd9c83,0,chathuri,2014-02-05 14:49:19-05:00,['7b68f893b20ae0f7eac32298cace88773c8e9daf'],13,0,13,1280645,1,,,,4425
a1b1ff9f60c65a394583428112b14d3c5bfac03b,0,lahiru,2014-02-05 15:28:26-05:00,"['92bcd53101fac4fbd14287f94568cae3dc16db52', '8f457cb48a3f373f462bbadca2f6c2ec00dd9c83']",13,0,13,1280658,1,,,,4425
176acc23770d860dff1fc42ae32408e1f02d3944,0,lahiru,2014-02-05 15:29:55-05:00,['a1b1ff9f60c65a394583428112b14d3c5bfac03b'],89,306,395,1281053,9,0.647540984,0.672131148,1,4429
da4c153a44a0a3ed688e1274f8db73de44651785,1,Saminda Wijeratne,2014-02-05 13:13:47-08:00,['176acc23770d860dff1fc42ae32408e1f02d3944'],6,13,19,1281072,2,,,,4429
b8152e39f0441d1aa2ea93c9d230911947f473c7,1,chathuri,2014-02-06 11:31:44-05:00,['da4c153a44a0a3ed688e1274f8db73de44651785'],23,20772,20795,1301867,38,0.46783748,0.545473552,0.981671197,4455
4626b43a06775cf8f1e5d55cafa48d56e2057caa,0,lahiru,2014-02-06 15:18:48-05:00,['b8152e39f0441d1aa2ea93c9d230911947f473c7'],0,44,44,1301911,1,,,,4456
a52692e7ff8c0467c280d6937c1a838a5370bc8f,1,chathuri,2014-02-06 16:22:05-05:00,['4626b43a06775cf8f1e5d55cafa48d56e2057caa'],48,358,406,1302317,4,0.183673469,0.183673469,0.534693878,4457
3070c3d9b7002ad6057714a116f0d1ae7f94f562,0,Suresh Marru,2014-02-07 11:29:56-05:00,['a52692e7ff8c0467c280d6937c1a838a5370bc8f'],0,0,0,1302317,27,,,,4457
77d4925d680b54568d93000b4160ec52d3d1be09,0,Suresh Marru,2014-02-07 11:35:35-05:00,['3070c3d9b7002ad6057714a116f0d1ae7f94f562'],13222,1,13223,1315540,24,0.52337618,0.449323171,0.013081561,4457
57d3cf8d3c3549f791e3ab011a098d8b50a78059,0,Suresh Marru,2014-02-07 12:04:52-05:00,['77d4925d680b54568d93000b4160ec52d3d1be09'],0,93,93,1315633,1,,,,4457
03bd52d819b20e361108cf5c4d17608b6f02b085,1,chathuri,2014-02-07 13:35:22-05:00,['57d3cf8d3c3549f791e3ab011a098d8b50a78059'],18,226,244,1315877,7,0.476190476,0.992063492,0.888888889,4459
6282fa367c6f0ac4b519eb1a20b7f849f41fe9a9,0,chathuri,2014-02-07 14:22:09-05:00,['03bd52d819b20e361108cf5c4d17608b6f02b085'],3,3,6,1315883,2,,,,4459
fac34c0aa820e7c2d08df5dbd56aa731b53cef51,0,Suresh Marru,2014-02-07 14:29:03-05:00,['6282fa367c6f0ac4b519eb1a20b7f849f41fe9a9'],3,5,8,1315891,1,,,,4459
8697b2dff7f9e3298aa9a41927e79fb405372135,0,Suresh Marru,2014-02-07 14:53:59-05:00,['fac34c0aa820e7c2d08df5dbd56aa731b53cef51'],163,419,582,1316473,8,0,0,0.906976744,4459
3833de5454b2c1100dc6621fbc529477ced1e662,1,chathuri,2014-02-07 15:16:57-05:00,['8697b2dff7f9e3298aa9a41927e79fb405372135'],10,38,48,1316521,3,0,1,0.666666667,4459
f950deaec5c6a0aa452e4ef1d978a71fad84e52f,1,Suresh Marru,2014-02-08 13:51:50-05:00,['8697b2dff7f9e3298aa9a41927e79fb405372135'],58,118,176,1316697,1,,,,4459
299872ab6cb35d25e16d62c49940b2799df29b05,0,Suresh Marru,2014-02-08 13:52:25-05:00,"['f950deaec5c6a0aa452e4ef1d978a71fad84e52f', '3833de5454b2c1100dc6621fbc529477ced1e662']",10,38,48,1316745,3,,,,4459
a977952e6b724976ffbf689da6f65ca077c9a2cb,0,Suresh Marru,2014-02-08 18:46:46-05:00,['299872ab6cb35d25e16d62c49940b2799df29b05'],16,21,37,1316782,1,,,,4459
85f95280f72770116588bc6638d42fe380bf015d,0,Suresh Marru,2014-02-08 22:10:47-05:00,['a977952e6b724976ffbf689da6f65ca077c9a2cb'],13,6,19,1316801,1,,,,4459
28ac4b750801f6c5a2cc095569513ed37c297183,1,Suresh Marru,2014-02-08 22:12:45-05:00,['85f95280f72770116588bc6638d42fe380bf015d'],11740,37997,49737,1366538,39,0.426287647,0.492361414,0.986632475,4482
fc927c6c133aa1bf4b63e40553e69e5acfc8ed26,1,Suresh Marru,2014-02-10 06:20:45-05:00,['28ac4b750801f6c5a2cc095569513ed37c297183'],20553,626,21179,1387717,55,0.544095876,0.468029609,0.016214311,4488
b949a5c16718f80f51e9467d8e1bdac21082bd69,0,Shameera,2014-02-10 19:06:24+05:18,['28ac4b750801f6c5a2cc095569513ed37c297183'],0,11,11,1387728,1,,,,4488
cf0d15df31e705a702641b0e44bda5bf16630f7b,0,Suresh Marru,2014-02-10 09:36:06-05:00,['fc927c6c133aa1bf4b63e40553e69e5acfc8ed26'],1,4,5,1387733,1,,,,4488
e7ab72102a3eff48d2511f551163f71da4755b5e,0,Suresh Marru,2014-02-10 09:42:32-05:00,"['cf0d15df31e705a702641b0e44bda5bf16630f7b', 'b949a5c16718f80f51e9467d8e1bdac21082bd69']",0,11,11,1387744,1,,,,4488
37a21a83a94d53239b74022e38b2881990ad4a17,1,chathuri,2014-02-10 10:17:06-05:00,['e7ab72102a3eff48d2511f551163f71da4755b5e'],4,13,17,1387761,3,1,1,1,4488
a0f437c1be4f033d4cca7535a6f0b3656a48d169,1,chathuri,2014-02-10 10:58:30-05:00,['37a21a83a94d53239b74022e38b2881990ad4a17'],5,42,47,1387808,3,0,0,1,4488
728e04b3fd8e17b503b9bbfd186f7f12b5243a7e,1,chathuri,2014-02-10 12:17:23-05:00,['a0f437c1be4f033d4cca7535a6f0b3656a48d169'],32,159,191,1387999,7,0.416666667,0.388888889,0.847222222,4488
c6284b3a2a75930bbe64de026dd874a26aff20c5,1,lahiru,2014-02-10 14:28:06-05:00,['728e04b3fd8e17b503b9bbfd186f7f12b5243a7e'],22,294,316,1388315,7,0.436090226,0.939849624,1,4489
0eae7735926f96a1df07222f6cbb27a5f982a7bd,0,lahiru,2014-02-10 14:42:19-05:00,['c6284b3a2a75930bbe64de026dd874a26aff20c5'],11,0,11,1388326,1,,,,4489
098896ac98195a69165598a071eb758a25118437,0,lahiru,2014-02-10 14:45:13-05:00,['0eae7735926f96a1df07222f6cbb27a5f982a7bd'],8,0,8,1388334,1,,,,4489
c8a68118b8fdf3207b5373c0a01fc2c66c2e53d0,1,chathuri,2014-02-10 15:02:42-05:00,['098896ac98195a69165598a071eb758a25118437'],29,93,122,1388456,8,0.897435897,1,1,4490
e4a12c3458913f5cca47a8625ca48620ae6f1735,1,chathuri,2014-02-10 15:48:04-05:00,['c8a68118b8fdf3207b5373c0a01fc2c66c2e53d0'],11,138,149,1388605,7,0.803571429,1,1,4490
1d0dadadf5ffdf9c7bd88337c53269fd696aacd3,0,chathuri,2014-02-11 09:56:31-05:00,['e4a12c3458913f5cca47a8625ca48620ae6f1735'],1,1,2,1388607,1,,,,4490
9b59fb0002b7f33b862a9a618198ecee2679922b,0,chathuri,2014-02-11 09:58:04-05:00,['1d0dadadf5ffdf9c7bd88337c53269fd696aacd3'],1,1,2,1388609,1,,,,4490
46352680c202da613d654e49a1fbd54e1ddf385e,0,lahiru,2014-02-11 10:19:58-05:00,['9b59fb0002b7f33b862a9a618198ecee2679922b'],374,24,398,1389007,6,0.529761905,0,0,4490
548a0ba320d199d63ee3afe4348c32a4c6577c26,0,chathuri,2014-02-11 10:24:08-05:00,['9b59fb0002b7f33b862a9a618198ecee2679922b'],1,1,2,1389009,1,,,,4490
b1c3603667dc98bd76fb2cff6a60a4aa0efd650e,0,chathuri,2014-02-11 10:26:14-05:00,"['548a0ba320d199d63ee3afe4348c32a4c6577c26', '46352680c202da613d654e49a1fbd54e1ddf385e']",374,24,398,1389407,6,,,,4490
daa536fb2a4c9e0ba021d11d026789626ed4cca2,0,chathuri,2014-02-11 14:40:21-05:00,['b1c3603667dc98bd76fb2cff6a60a4aa0efd650e'],41,155,196,1389603,10,0.451612903,0.967741935,0.032258065,4491
dea7937d2aca49de85bc3cbf3c091882c0b9457f,0,lahiru,2014-02-11 15:48:14-05:00,['b1c3603667dc98bd76fb2cff6a60a4aa0efd650e'],17,110,127,1389730,6,0.090909091,0,1,4492
cb78c9264513f5a55f1c4ed88738261d82763634,0,lahiru,2014-02-11 15:49:35-05:00,"['dea7937d2aca49de85bc3cbf3c091882c0b9457f', 'daa536fb2a4c9e0ba021d11d026789626ed4cca2']",41,155,196,1389926,10,,,,4492
7456b462ba38a9a2adede47500b70274a0e380cd,1,Suresh Marru,2014-02-11 16:02:32-05:00,['daa536fb2a4c9e0ba021d11d026789626ed4cca2'],18,19,37,1389963,23,,,,4492
f6db43953c84f8e293c28cb599ac96884295ebc7,0,Suresh Marru,2014-02-11 16:02:46-05:00,"['7456b462ba38a9a2adede47500b70274a0e380cd', 'cb78c9264513f5a55f1c4ed88738261d82763634']",17,110,127,1390090,6,,,,4492
dff075cd59c860c5f3855fbeaa69639d7df1ba69,0,Suresh Marru,2014-02-11 16:20:16-05:00,['f6db43953c84f8e293c28cb599ac96884295ebc7'],2,2,4,1390094,1,,,,4492
b766421f9c60a79117c42ab86d54d43a4dc12492,0,raminder,2014-02-12 10:38:29-05:00,['dff075cd59c860c5f3855fbeaa69639d7df1ba69'],0,125,125,1390219,2,,,,4493
47a7c15669820256245eaf5cb2165b7e7d570f22,0,lahiru,2014-02-12 14:50:07-05:00,['cb78c9264513f5a55f1c4ed88738261d82763634'],134,0,134,1390353,1,0,0,0,4493
f78c0e15c568cd604a2f7dc02301a263a64b888a,0,lahiru,2014-02-12 14:57:12-05:00,['47a7c15669820256245eaf5cb2165b7e7d570f22'],364,181,545,1390898,11,0.576923077,1,0,4493
45aeb1fb92606d11233df523c83bc00f2f8c3820,0,lahiru,2014-02-12 14:57:36-05:00,"['f78c0e15c568cd604a2f7dc02301a263a64b888a', 'b766421f9c60a79117c42ab86d54d43a4dc12492']",20,146,166,1391064,26,,,,4493
8d163f4db0f76e60b1e7e5a54b6f9a63ae8e7642,0,lahiru,2014-02-12 15:04:05-05:00,['45aeb1fb92606d11233df523c83bc00f2f8c3820'],16,0,16,1391080,1,,,,4493
02606da17c4f7b570c27e987a5bb3e2a710e34d9,0,lahiru,2014-02-12 15:32:51-05:00,['8d163f4db0f76e60b1e7e5a54b6f9a63ae8e7642'],89,14,103,1391183,4,0.956521739,0,0,4493
029e604d03eb3c81bb30bf18b14fda3ff5f82e42,0,lahiru,2014-02-12 15:34:25-05:00,['02606da17c4f7b570c27e987a5bb3e2a710e34d9'],63,206,269,1391452,3,0.315789474,1,0.912280702,4494
0a1da56905801dc1d4764f555c8f907ada5d0d19,0,raminder,2014-02-12 15:40:42-05:00,['b766421f9c60a79117c42ab86d54d43a4dc12492'],4,4,8,1391460,1,,,,4494
8ee1188648dfb2b96bd9a11297f084bf894d0d9c,0,raminder,2014-02-12 15:41:09-05:00,"['0a1da56905801dc1d4764f555c8f907ada5d0d19', '029e604d03eb3c81bb30bf18b14fda3ff5f82e42']",657,392,1049,1392509,17,,,,4494
6f604649e7222308581ac9f3f5d4145f89500389,0,lahiru,2014-02-12 15:42:15-05:00,['029e604d03eb3c81bb30bf18b14fda3ff5f82e42'],27,28,55,1392564,3,0,0,0,4494
e59e25ec3f16f23807c211964ca48e936eaa3438,0,lahiru,2014-02-12 15:42:31-05:00,"['6f604649e7222308581ac9f3f5d4145f89500389', '8ee1188648dfb2b96bd9a11297f084bf894d0d9c']",4,4,8,1392572,1,,,,4494
6555180ecc23d501b72f494c464bcb87e1bd155c,0,chathuri,2014-02-12 16:42:55-05:00,['b766421f9c60a79117c42ab86d54d43a4dc12492'],30,1854,1884,1394456,13,0.437694704,0.666666667,0.908099688,4501
e31e00d48f6f8079408e7b99606f2e6deccd8b86,0,chathuri,2014-02-12 16:42:58-05:00,"['6555180ecc23d501b72f494c464bcb87e1bd155c', 'e59e25ec3f16f23807c211964ca48e936eaa3438']",675,411,1086,1395542,20,,,,4501
41da886a3dd768d1d9d074b496bea0f696fc2703,0,lahiru,2014-02-13 09:52:55-05:00,['e59e25ec3f16f23807c211964ca48e936eaa3438'],16,0,16,1395558,2,0,0,0.5,4501
99538d8648d1df5e6b6c6b2401d5f414a644ba13,0,chathuri,2014-02-13 09:55:42-05:00,"['e31e00d48f6f8079408e7b99606f2e6deccd8b86', '41da886a3dd768d1d9d074b496bea0f696fc2703']",16,0,16,1395574,2,,,,4501
5dd40195f0d9a1ecf560706cf1290d71532ea818,0,chathuri,2014-02-13 10:00:48-05:00,['99538d8648d1df5e6b6c6b2401d5f414a644ba13'],10,13,23,1395597,2,,,,4501
c4f80abbd83da9217646adf637a7acdc145c4ed7,0,lahiru,2014-02-13 10:24:25-05:00,['41da886a3dd768d1d9d074b496bea0f696fc2703'],10,22,32,1395629,4,0,1,1,4501
3c3040dda295b37c30ff7c47b02ca67e7fa1fe90,0,lahiru,2014-02-13 11:01:14-05:00,['c4f80abbd83da9217646adf637a7acdc145c4ed7'],140,148,288,1395917,18,1,1,1,4501
11191ef46e91fddf108cf98e18288a2a4996a911,0,lahiru,2014-02-13 11:01:28-05:00,"['3c3040dda295b37c30ff7c47b02ca67e7fa1fe90', '5dd40195f0d9a1ecf560706cf1290d71532ea818']",30,1857,1887,1397804,13,,,,4501
f52dc3b719a93625a8bf0701ae5d0facf4c148a2,0,lahiru,2014-02-13 14:39:22-05:00,['11191ef46e91fddf108cf98e18288a2a4996a911'],66,565,631,1398435,7,0.203252033,1,1,4504
e7849ef980bb49f3129bf972265e258fd10056ea,0,Suresh Marru,2014-02-14 08:22:16-05:00,['f52dc3b719a93625a8bf0701ae5d0facf4c148a2'],205,204,409,1398844,3,,,,4504
7d9ab4d81de13d02b4f3ac087e0bd19250dc8d49,0,Suresh Marru,2014-02-14 11:50:15-05:00,['e7849ef980bb49f3129bf972265e258fd10056ea'],43,74,117,1398961,1,,,,4504
6269881bd750f0f7145bfa1524ae6a537d0061fa,0,Suresh Marru,2014-02-14 14:24:24-05:00,['7d9ab4d81de13d02b4f3ac087e0bd19250dc8d49'],4,4,8,1398969,1,,,,4504
f94f9f87893cd24668eb448be337993fde4f75bc,0,Suresh Marru,2014-02-14 14:27:28-05:00,['6269881bd750f0f7145bfa1524ae6a537d0061fa'],2,3,5,1398974,1,,,,4504
997d5efe14ed91382bd9c9d5df9d84bbd3a7d711,1,chathuri,2014-02-14 17:42:57-05:00,['f94f9f87893cd24668eb448be337993fde4f75bc'],13,389,402,1399376,2,,,,4505
719cbf9e7acab14183be7d6295ba977c05685cde,1,Suresh Marru,2014-02-14 18:58:36-05:00,['997d5efe14ed91382bd9c9d5df9d84bbd3a7d711'],339,14004,14343,1413719,26,0.326620775,0.369978424,0.998767081,4527
7d5d102733858eabd6818ed9ad89d57b8420aa22,1,chathuri,2014-02-16 21:45:27-05:00,['719cbf9e7acab14183be7d6295ba977c05685cde'],0,379,379,1414098,1,,,,4528
ce902646a9bbf47ef32483b223a4097cdb55764c,0,lahiru,2014-02-17 12:24:17-05:00,['f52dc3b719a93625a8bf0701ae5d0facf4c148a2'],72,100,172,1414270,7,1,1,1,4529
cb3a8a55f8a244867aa7e3b70162dc9c0b0d7ca0,0,lahiru,2014-02-17 12:40:58-05:00,"['ce902646a9bbf47ef32483b223a4097cdb55764c', '7d5d102733858eabd6818ed9ad89d57b8420aa22']",553,15004,15557,1429827,31,,,,4529
b0421a25d3a5d46e9bc6732f872a67def78e82fc,0,lahiru,2014-02-17 12:43:47-05:00,['cb3a8a55f8a244867aa7e3b70162dc9c0b0d7ca0'],14,143,157,1429984,3,0,0.016949153,0.050847458,4529
0cd438c72742e0d248a049436abffcdde03d9183,0,chathuri,2014-02-17 13:10:03-05:00,['b0421a25d3a5d46e9bc6732f872a67def78e82fc'],4,4,8,1429992,1,0.5,0,1,4529
a0c1cbde996ad25a3530a6d322cab918261ccda6,1,chathuri,2014-02-17 14:29:38-05:00,['0cd438c72742e0d248a049436abffcdde03d9183'],5593,6052,11645,1441637,57,0.695685087,0.336109008,0.082134746,4547
7126528886030d0f6325f35d55dc122d28af74d2,0,Suresh Marru,2014-02-17 16:08:46-05:00,['a0c1cbde996ad25a3530a6d322cab918261ccda6'],35,114,149,1441786,4,,,,4548
b46488d5cc23e5f0a6794842b8b3b9ce60f115b2,1,Suresh Marru,2014-02-17 22:40:35-05:00,['7126528886030d0f6325f35d55dc122d28af74d2'],3477,5440,8917,1450703,39,0.605157131,0.794520548,0.979049154,4554
a584c2c768a825f686f53e8982e05b7de5e79304,1,chathuri,2014-02-18 00:27:28-05:00,['b46488d5cc23e5f0a6794842b8b3b9ce60f115b2'],3786,2482,6268,1456971,40,1,1,1,4569
0e2e21ce550f53c24302055285fa24adcfa5e991,1,chathuri,2014-02-18 13:27:30-05:00,['a584c2c768a825f686f53e8982e05b7de5e79304'],230,421,651,1457622,13,0.328025478,0.579617834,1,4569
4066c4777255661250f7237c319c2870d3b88149,0,raminder,2014-02-18 13:33:36-05:00,['a584c2c768a825f686f53e8982e05b7de5e79304'],21,124,145,1457767,3,0.222222222,1,1,4569
e8ac03899a6140a1128f81973864b07cd0a4dd72,0,raminder,2014-02-18 14:20:50-05:00,"['4066c4777255661250f7237c319c2870d3b88149', '0e2e21ce550f53c24302055285fa24adcfa5e991']",242,497,739,1458506,13,,,,4569
af9cd3b385018027b3183d45ca636efc61406d77,0,raminder,2014-02-18 14:38:06-05:00,['e8ac03899a6140a1128f81973864b07cd0a4dd72'],6,4,10,1458516,1,,,,4569
b66eba9439a9cde42d1c22dadec9119247be1c34,0,Suresh Marru,2014-02-18 16:43:38-05:00,['af9cd3b385018027b3183d45ca636efc61406d77'],68,364,432,1458948,5,0.5,0.215909091,1,4569
867cfee4c0fc7a09c5e58989eeaff4bd39ecc916,1,chathuri,2014-02-18 22:13:11-05:00,['b66eba9439a9cde42d1c22dadec9119247be1c34'],188,1008,1196,1460144,5,0,0.111461619,1,4569
136cfeabbc97ce1947c0d6738ffadf428ef47f95,1,chathuri,2014-02-19 11:21:21-05:00,['867cfee4c0fc7a09c5e58989eeaff4bd39ecc916'],223,621,844,1460988,12,0.114919355,0.824596774,1,4569
fe40a1d3dabf65f8402c59e3d9fa04ec69a256dd,0,Suresh Marru,2014-02-19 13:24:37-05:00,['136cfeabbc97ce1947c0d6738ffadf428ef47f95'],503,4,507,1461495,2,0,0,0.130434783,4569
a6200bbc1f0f60ba49d2bfdc5898488945979cf0,0,Suresh Marru,2014-02-19 13:30:11-05:00,['fe40a1d3dabf65f8402c59e3d9fa04ec69a256dd'],0,280,280,1461775,1,1,1,0.888888889,4570
e2647167d803b5b4c0dc5eaba5a478944ab3a4fe,0,lahiru,2014-02-19 15:42:01-05:00,['af9cd3b385018027b3183d45ca636efc61406d77'],0,1177,1177,1462952,20,1,1,1,4590
f0f290652160593dbd59da5d3dfdd94755b097cb,0,lahiru,2014-02-19 15:42:15-05:00,"['e2647167d803b5b4c0dc5eaba5a478944ab3a4fe', 'a6200bbc1f0f60ba49d2bfdc5898488945979cf0']",518,1813,2331,1465283,22,,,,4590
b1a6edc2aa937123ef895c7a2aab597dbac323d8,0,lahiru,2014-02-19 15:45:47-05:00,['f0f290652160593dbd59da5d3dfdd94755b097cb'],89,7,96,1465379,4,,,,4590
985151fc195dac2aed284087e3a72babac44542d,1,chathuri,2014-02-19 17:09:18-05:00,['b1a6edc2aa937123ef895c7a2aab597dbac323d8'],220,801,1021,1466400,20,0.721374046,0.748091603,0.958015267,4591
abb05c8f6f9f17b7868dc2be2a97d1598aa1a2a9,0,lahiru,2014-02-20 12:02:35-05:00,['b1a6edc2aa937123ef895c7a2aab597dbac323d8'],0,354,354,1466754,6,0.2890625,0.796875,0.4921875,4597
a7baac58affd336d0c019c53c9a60d9d3e724ec3,0,lahiru,2014-02-20 12:02:48-05:00,"['abb05c8f6f9f17b7868dc2be2a97d1598aa1a2a9', '985151fc195dac2aed284087e3a72babac44542d']",220,801,1021,1467775,20,,,,4597
a27cb89cf5b796194b5c96b097b2f7d5ac8c3b1f,0,raminder,2014-02-20 12:17:58-05:00,['136cfeabbc97ce1947c0d6738ffadf428ef47f95'],4,4,8,1467783,3,,,,4597
19965076e349d33c4afc6bfd36249e1b234345f7,0,raminder,2014-02-20 12:34:57-05:00,['a27cb89cf5b796194b5c96b097b2f7d5ac8c3b1f'],0,376,376,1468159,1,,,,4598
4d309584344a51a2653f9ee5f917381a9ba39f08,1,raminder,2014-02-20 12:36:49-05:00,['19965076e349d33c4afc6bfd36249e1b234345f7'],1319,1351,2670,1470829,20,0.536926148,0,0,4598
7d603e5a6710346344cedb00cd4250ba6fa5bde0,0,raminder,2014-02-20 12:42:01-05:00,"['4d309584344a51a2653f9ee5f917381a9ba39f08', 'a7baac58affd336d0c019c53c9a60d9d3e724ec3']",425,2255,2680,1473509,44,,,,4598
6cb5d825168627948806daeac827658546bebadb,0,chathuri,2014-02-20 13:00:57-05:00,['a7baac58affd336d0c019c53c9a60d9d3e724ec3'],0,18,18,1473527,1,0.857142857,1,1,4598
ed4713158bb40ca98cb314be3daa6d40dc1cd442,1,raminder,2014-02-20 13:10:11-05:00,['7d603e5a6710346344cedb00cd4250ba6fa5bde0'],0,15,15,1473542,3,,,,4598
64e2cc4961bd29db8d3cc433555a66289cf61455,1,chathuri,2014-02-20 13:18:13-05:00,"['6cb5d825168627948806daeac827658546bebadb', '7d603e5a6710346344cedb00cd4250ba6fa5bde0']",552,973,1525,1475067,17,,,,4598
59c77d35340a9d6cf6130d5d6a3cb26165788619,0,chathuri,2014-02-20 13:18:36-05:00,"['64e2cc4961bd29db8d3cc433555a66289cf61455', 'ed4713158bb40ca98cb314be3daa6d40dc1cd442']",0,15,15,1475082,3,,,,4598
ca3f8c4b4485faa755aab8e95d5783734330bc33,1,raminder,2014-02-20 15:05:00-05:00,['ed4713158bb40ca98cb314be3daa6d40dc1cd442'],34,45,79,1475161,4,1,1,1,4598
c28577ea95204b91e9ebcb79af87220150216e35,1,chathuri,2014-02-20 15:10:10-05:00,['59c77d35340a9d6cf6130d5d6a3cb26165788619'],168,217,385,1475546,5,0,0,0.608974359,4598
afddb4cb46f78c0174bc827643e45bb5c2309b55,1,raminder,2014-02-20 15:53:31-05:00,"['ca3f8c4b4485faa755aab8e95d5783734330bc33', '59c77d35340a9d6cf6130d5d6a3cb26165788619']",395,416,811,1476357,15,,,,4598
36281260281c4ebd20d7216d4f0e9464e06e50f8,0,raminder,2014-02-20 15:53:56-05:00,"['afddb4cb46f78c0174bc827643e45bb5c2309b55', 'c28577ea95204b91e9ebcb79af87220150216e35']",168,217,385,1476742,5,,,,4598
757fbb64aca7af1b4465807bac32485bb94403a0,0,Suresh Marru,2014-02-21 08:55:25-05:00,['36281260281c4ebd20d7216d4f0e9464e06e50f8'],0,3376,3376,1480118,7,0.667004049,0.843623482,0.981275304,4605
f8c74512a1b095a7da16830753748dede91af1b1,0,lahiru,2014-02-21 11:58:47-05:00,['a7baac58affd336d0c019c53c9a60d9d3e724ec3'],15,494,509,1480627,8,0.471014493,0.800724638,0.90942029,4607
0c58b97e05dd2f0c9760eb4a265558c43c4e8f79,0,lahiru,2014-02-21 11:59:03-05:00,"['f8c74512a1b095a7da16830753748dede91af1b1', '757fbb64aca7af1b4465807bac32485bb94403a0']",1816,5715,7531,1488158,43,,,,4607
d91a0133d69f375defd91da0fb4a1c8f657b7a0b,0,raminder,2014-02-21 13:45:29-05:00,['0c58b97e05dd2f0c9760eb4a265558c43c4e8f79'],0,141,141,1488299,2,0.393939394,1,1,4609
3b77227eabf1995d03ca0d137acc70b447c8af09,1,raminder,2014-02-21 13:47:27-05:00,['d91a0133d69f375defd91da0fb4a1c8f657b7a0b'],305,340,645,1488944,21,0.607476636,0.953271028,1,4609
9b858526db516d0821188540a6f2f198a3141a68,1,chathuri,2014-02-21 14:51:30-05:00,['3b77227eabf1995d03ca0d137acc70b447c8af09'],80,282,362,1489306,5,0.439189189,0.682432432,1,4610
eeddc5b92120c5f0449eadf5c21297a5e3752643,0,lahiru,2014-02-21 16:43:25-05:00,['0c58b97e05dd2f0c9760eb4a265558c43c4e8f79'],185,184,369,1489675,8,1,1,0,4612
16d6d176acc356bad156c6c0e93bfc45026a03a2,0,lahiru,2014-02-21 16:43:39-05:00,"['eeddc5b92120c5f0449eadf5c21297a5e3752643', '9b858526db516d0821188540a6f2f198a3141a68']",384,762,1146,1490821,27,,,,4612
84622574a8013dea0e302f2a24f86bd3a58a7bf8,1,chathuri,2014-02-21 17:15:23-05:00,['16d6d176acc356bad156c6c0e93bfc45026a03a2'],26,234,260,1491081,5,0.090425532,0.968085106,0.973404255,4612
f2445c28fd06cdd0bbe582388d4537e6bdd3a1c4,0,lahiru,2014-02-21 17:26:44-05:00,['16d6d176acc356bad156c6c0e93bfc45026a03a2'],33,89,122,1491203,3,0.095238095,1,0.952380952,4613
197daf118d1b04afe7ad1f6e0c7c8e3daa5a5f2a,0,lahiru,2014-02-21 17:27:02-05:00,"['f2445c28fd06cdd0bbe582388d4537e6bdd3a1c4', '84622574a8013dea0e302f2a24f86bd3a58a7bf8']",26,234,260,1491463,5,,,,4613
a7f35a3e087c8c2e71d6679aacc9d880c8bff2c9,0,Suresh Marru,2014-02-22 10:58:39-05:00,['197daf118d1b04afe7ad1f6e0c7c8e3daa5a5f2a'],150,0,150,1491613,3,,,,4613
5c7fa2df30da59deed4a0c7fe5becd8b5891f976,1,chathuri,2014-02-24 11:12:03-05:00,['a7f35a3e087c8c2e71d6679aacc9d880c8bff2c9'],29,161,190,1491803,3,0.026315789,0.98245614,0.98245614,4613
34d6c266d03a6da99277b547c8c6a086288ba2a6,0,lahiru,2014-02-24 14:14:32-05:00,['197daf118d1b04afe7ad1f6e0c7c8e3daa5a5f2a'],63,697,760,1492563,9,0.153846154,0.433333333,0.979487179,4615
81faafb914df5fa188a27045aedcb913f9c71aa0,0,lahiru,2014-02-24 14:16:45-05:00,"['34d6c266d03a6da99277b547c8c6a086288ba2a6', '5c7fa2df30da59deed4a0c7fe5becd8b5891f976']",179,161,340,1492903,6,,,,4615
bd217f86f5179581dff431176b37dc07f73379e7,0,lahiru,2014-02-24 14:31:39-05:00,['81faafb914df5fa188a27045aedcb913f9c71aa0'],15,37,52,1492955,7,,,,4616
dd5dbbd76c779177316693f9341d71d7cc7a794a,1,chathuri,2014-02-24 16:37:57-05:00,['bd217f86f5179581dff431176b37dc07f73379e7'],86,512,598,1493553,4,0.081339713,0.827751196,0.789473684,4616
94aee747dcf796178dcb17f9d994bd3f7428b585,1,Suresh Marru,2014-02-25 08:59:40-05:00,['dd5dbbd76c779177316693f9341d71d7cc7a794a'],2,3004,3006,1496559,9,0.804373522,0.961583924,0.986406619,4624
2ffc36cf5ea439ad152310e54617c4ed35f7f77b,1,chathuri,2014-02-25 10:31:41-05:00,['94aee747dcf796178dcb17f9d994bd3f7428b585'],35,313,348,1496907,2,0.609375,0.875,1,4624
102ee17a175bd0d2ea200dc5f37849aac4fdc061,1,chathuri,2014-02-25 11:39:42-05:00,['2ffc36cf5ea439ad152310e54617c4ed35f7f77b'],6,193,199,1497106,3,0.246666667,0.58,0.746666667,4624
23ed5039de7f0c071e82c4fa3c707b62dffd66bb,0,Suresh Marru,2014-02-25 12:00:41-05:00,['94aee747dcf796178dcb17f9d994bd3f7428b585'],3,54,57,1497163,3,1,1,1,4625
ee2824e2deb90c8b509583a75f8e82b5a1158ecd,0,Suresh Marru,2014-02-25 12:01:04-05:00,"['23ed5039de7f0c071e82c4fa3c707b62dffd66bb', '102ee17a175bd0d2ea200dc5f37849aac4fdc061']",41,506,547,1497710,3,,,,4625
49bb74874a2c7708f8235c8b30edc48b052333aa,1,chathuri,2014-02-25 13:52:15-05:00,['ee2824e2deb90c8b509583a75f8e82b5a1158ecd'],7,314,321,1498031,3,0.335689046,0.770318021,1,4625
605ffaa272cd3870bc23211b159b7890f91a00c9,0,chathuri,2014-02-25 14:12:17-05:00,['49bb74874a2c7708f8235c8b30edc48b052333aa'],4,36,40,1498071,2,0.212121212,0.212121212,1,4625
b5d57f8baa70018bb2c957d925fdae2baf8c9c56,1,chathuri,2014-02-25 15:09:27-05:00,['605ffaa272cd3870bc23211b159b7890f91a00c9'],3,117,120,1498191,4,0,0,0.922330097,4625
5f6d80a83cbee988ce23ea58070b0ff4b9c86f51,1,Suresh Marru,2014-02-25 16:22:11-05:00,['605ffaa272cd3870bc23211b159b7890f91a00c9'],1911,23644,25555,1523746,35,0.394409531,0.468185389,0.999410841,4656
204aab12f36ea14f5c15a7f376140cbcbd18d25a,0,Suresh Marru,2014-02-25 16:22:23-05:00,"['5f6d80a83cbee988ce23ea58070b0ff4b9c86f51', 'b5d57f8baa70018bb2c957d925fdae2baf8c9c56']",3,117,120,1523866,4,,,,4656
db954ff0ceecb89a2fa896f748ab8f92f216316d,1,chathuri,2014-02-25 16:45:23-05:00,['204aab12f36ea14f5c15a7f376140cbcbd18d25a'],82,177,259,1524125,6,0.357142857,1,1,4657
7849212bcd58af6a0109f4c53a56e0dd6da3541c,0,lahiru,2014-02-25 16:57:22-05:00,['b5d57f8baa70018bb2c957d925fdae2baf8c9c56'],92,195,287,1524412,18,0,0,1,4657
2a52bd743d7ca75a354e87bb6df81582d8edadc0,0,lahiru,2014-02-25 16:57:35-05:00,"['7849212bcd58af6a0109f4c53a56e0dd6da3541c', 'db954ff0ceecb89a2fa896f748ab8f92f216316d']",1993,23821,25814,1550226,41,,,,4657
ec63576715512a950ce359a11b64183e8d34535d,0,lahiru,2014-02-25 17:04:17-05:00,['2a52bd743d7ca75a354e87bb6df81582d8edadc0'],2,9,11,1550237,2,,,,4657
e202140889b842f5cf3291dc7285f90f79ae1110,0,chathuri,2014-02-25 17:08:05-05:00,['ec63576715512a950ce359a11b64183e8d34535d'],66,48,114,1550351,3,1,0,0,4657
cb4b7a38b0d4109494235dd3edde6a52224137ab,0,lahiru,2014-02-25 22:09:26-05:00,['ec63576715512a950ce359a11b64183e8d34535d'],8,8,16,1550367,1,,,,4657
adeba77c793242ccbda0025cc991ad9de8bf6900,0,lahiru,2014-02-25 22:09:39-05:00,"['cb4b7a38b0d4109494235dd3edde6a52224137ab', 'e202140889b842f5cf3291dc7285f90f79ae1110']",66,48,114,1550481,3,,,,4657
82be00b22a7d20b42fc1f0b5a49402e6842be323,0,lahiru,2014-02-26 11:28:09-05:00,['adeba77c793242ccbda0025cc991ad9de8bf6900'],1,1,2,1550483,1,,,,4657
548c2ebf8b468ea668c4b7cc8f30f30737fe8274,1,sgg,2014-02-26 13:33:05-05:00,['82be00b22a7d20b42fc1f0b5a49402e6842be323'],667,790,1457,1551940,9,1,1,1,4659
5d7cf007b6e8b91ee040871f180019937e19305b,0,raminder,2014-02-26 14:02:30-05:00,['82be00b22a7d20b42fc1f0b5a49402e6842be323'],2,2,4,1551944,1,,,,4659
bc954ece5dc079e17715baa8a11626a215ad384d,0,raminder,2014-02-26 14:02:49-05:00,"['5d7cf007b6e8b91ee040871f180019937e19305b', '548c2ebf8b468ea668c4b7cc8f30f30737fe8274']",667,790,1457,1553401,9,,,,4659
3a453bb14856f7cfe909cda650a1fe66f15f99a5,0,raminder,2014-02-26 16:25:44-05:00,['bc954ece5dc079e17715baa8a11626a215ad384d'],91,89,180,1553581,14,1,0.6,0.166666667,4659
67d283f25626cc6ff99bac55b1fa49d80d6ac1cc,0,raminder,2014-02-26 17:10:39-05:00,['3a453bb14856f7cfe909cda650a1fe66f15f99a5'],7,7,14,1553595,2,0.8,1,1,4659
7f4e406a16048afd077de5245389c77e7f295e2c,1,chathuri,2014-02-27 11:05:57-05:00,['67d283f25626cc6ff99bac55b1fa49d80d6ac1cc'],1689,1717,3406,1557001,23,0.975103734,0.124481328,0,4661
e0e1c9738ba0038374ff58890d47f4e34bd8ee6a,1,chathuri,2014-02-27 12:09:43-05:00,['7f4e406a16048afd077de5245389c77e7f295e2c'],8,98,106,1557107,4,1,1,0.941176471,4662
6ed27b9cec1fe9495877f04a662a0174ca50ddd8,1,chathuri,2014-02-27 14:15:38-05:00,['e0e1c9738ba0038374ff58890d47f4e34bd8ee6a'],176,280,456,1557563,4,0,0.235294118,1,4662
7322247078f5db2738f4f8203aee269522a5dfa0,0,raminder,2014-02-27 15:26:07-05:00,['6ed27b9cec1fe9495877f04a662a0174ca50ddd8'],208,186,394,1557957,9,0.868217054,1,0,4662
57ccaa5d0fe683c11eb31c2614438d690890bbb7,0,Suresh Marru,2014-02-27 16:11:12-05:00,['7322247078f5db2738f4f8203aee269522a5dfa0'],25634,7,25641,1583598,40,0.661839724,0.614447918,0.001864955,4662
04a8b5efd0e24cc7293b099c98c46f766a4db753,1,chathuri,2014-02-27 16:16:10-05:00,['57ccaa5d0fe683c11eb31c2614438d690890bbb7'],89,120,209,1583807,10,1,0,0,4662
8aa06df25968175bd21c275d1bff878e2e32d40d,0,Suresh Marru,2014-02-27 16:17:47-05:00,['57ccaa5d0fe683c11eb31c2614438d690890bbb7'],5,0,5,1583812,1,,,,4662
650b457ac7a14e4bdb40060f3561b7d182c43bfc,0,Suresh Marru,2014-02-27 16:17:56-05:00,"['8aa06df25968175bd21c275d1bff878e2e32d40d', '04a8b5efd0e24cc7293b099c98c46f766a4db753']",89,120,209,1584021,10,,,,4662
312a8efdd0d34f1fa77f07cd4a5b2d003752c557,0,chathuri,2014-02-27 16:20:25-05:00,['650b457ac7a14e4bdb40060f3561b7d182c43bfc'],1,1,2,1584023,1,,,,4662
0d5baf11e73d59e88d55cb26bc55da9614463618,0,Suresh Marru,2014-02-27 16:29:45-05:00,['650b457ac7a14e4bdb40060f3561b7d182c43bfc'],2,2,4,1584027,1,,,,4662
505971a429198f3fa0dbcc77d0460c97572406b6,0,Suresh Marru,2014-02-27 16:29:57-05:00,"['0d5baf11e73d59e88d55cb26bc55da9614463618', '312a8efdd0d34f1fa77f07cd4a5b2d003752c557']",1,1,2,1584029,1,,,,4662
2d2be146901881a9321a25d0d4a25768e24cf9ca,0,raminder,2014-02-27 16:38:19-05:00,['505971a429198f3fa0dbcc77d0460c97572406b6'],0,178,178,1584207,1,0,0,1,4662
fa2601a7d34e5f643ece14c5baa7b236497936f3,0,lahiru,2014-02-27 17:08:54-05:00,['7322247078f5db2738f4f8203aee269522a5dfa0'],419,571,990,1585197,22,1,1,0.714285714,4666
c9b9575a077a1b41f24475c919273e923f00e963,0,lahiru,2014-02-27 17:09:20-05:00,"['fa2601a7d34e5f643ece14c5baa7b236497936f3', '2d2be146901881a9321a25d0d4a25768e24cf9ca']",25730,307,26037,1611234,53,,,,4666
a33b8c6e027bc8e01aba21679978b03f57e42f95,0,lahiru,2014-02-27 17:13:45-05:00,['c9b9575a077a1b41f24475c919273e923f00e963'],20,20,40,1611274,3,0,0,0,4666
0aecca776937cd154f9d11fc5bca5f4eff2ce302,0,chathuri,2014-02-28 10:06:21-05:00,['a33b8c6e027bc8e01aba21679978b03f57e42f95'],5,7,12,1611286,1,1,1,1,4666
bead7c81cad189f9128bf6e3678c41603914746c,0,lahiru,2014-02-28 10:16:00-05:00,['a33b8c6e027bc8e01aba21679978b03f57e42f95'],3,16,19,1611305,2,1,1,1,4666
cd8d8910f1db80dcf913f02468c0723f693e84ae,0,lahiru,2014-02-28 10:16:11-05:00,"['bead7c81cad189f9128bf6e3678c41603914746c', '0aecca776937cd154f9d11fc5bca5f4eff2ce302']",5,7,12,1611317,1,,,,4666
2eabd51b2369c8ee1a4738d2c969100a50f3d5fb,0,chathuri,2014-02-28 11:22:59-05:00,['cd8d8910f1db80dcf913f02468c0723f693e84ae'],12,56,68,1611385,1,0.483870968,1,1,4666
48b0c5ebe2078e05cd417c6060f85c2ecc8928b0,0,lahiru,2014-02-28 11:39:16-05:00,['2eabd51b2369c8ee1a4738d2c969100a50f3d5fb'],29,739,768,1612153,16,0.833333333,0.833333333,1,4672
d29a148f610b0d92bfa9d1005f6cb712cf6ec182,0,chathuri,2014-02-28 12:05:03-05:00,['48b0c5ebe2078e05cd417c6060f85c2ecc8928b0'],18,28,46,1612199,2,0,1,1,4672
ab54c7d5f2c33ca24a96a73bff9400ead8165ab0,1,lahiru,2014-02-28 12:44:25-05:00,['d29a148f610b0d92bfa9d1005f6cb712cf6ec182'],12,39,51,1612250,5,0.3,0,0.75,4672
93545e1419042f6fb9c6e62e00547eab0f6f4439,0,lahiru,2014-02-28 13:16:56-05:00,['ab54c7d5f2c33ca24a96a73bff9400ead8165ab0'],2,2,4,1612254,2,,,,4672
66c88f6d262fd846e32f626d21ca6a4c2fb6ce05,1,chathuri,2014-02-28 13:21:06-05:00,['93545e1419042f6fb9c6e62e00547eab0f6f4439'],420,559,979,1613233,2,0,0.957627119,1,4672
6228daa4dd8f270bc223804a012ee6d772796430,0,lahiru,2014-02-28 13:22:06-05:00,['93545e1419042f6fb9c6e62e00547eab0f6f4439'],1,315,316,1613549,2,0.046632124,1,1,4673
99297f91cc01771e7679d35eeff3dc64f6918c83,0,lahiru,2014-02-28 13:22:17-05:00,"['6228daa4dd8f270bc223804a012ee6d772796430', '66c88f6d262fd846e32f626d21ca6a4c2fb6ce05']",420,559,979,1614528,2,,,,4673
bf11984c0ee4c3ea4ec54e0a38369e8b687f611d,1,chathuri,2014-02-28 15:52:50-05:00,['99297f91cc01771e7679d35eeff3dc64f6918c83'],32,73,105,1614633,6,0,0,1,4673
804190816880050e870076da0650a1b04d40b2d5,0,lahiru,2014-02-28 19:08:41-05:00,['bf11984c0ee4c3ea4ec54e0a38369e8b687f611d'],107,99,206,1614839,21,1,1,0,4673
a02132482a1e522769583f6cd4420c5e22d2dc8e,0,lahiru,2014-02-28 19:20:45-05:00,['804190816880050e870076da0650a1b04d40b2d5'],16,7,23,1614862,1,0,1,1,4673
a4c0adcbed12b7cae32b73bda2c08a794c4b1920,0,lahiru,2014-02-28 19:43:22-05:00,['a02132482a1e522769583f6cd4420c5e22d2dc8e'],19,13,32,1614894,8,1,0.5,0,4673
955dfe7182c539d823fccd0b3a6b4354b44d5f3f,0,Suresh Marru,2014-03-02 15:39:38-05:00,['a33b8c6e027bc8e01aba21679978b03f57e42f95'],0,166,166,1615060,1,,,,4674
1262568a93625c76627ad5301395dd90400969d7,0,Suresh Marru,2014-03-02 15:39:49-05:00,"['955dfe7182c539d823fccd0b3a6b4354b44d5f3f', 'a4c0adcbed12b7cae32b73bda2c08a794c4b1920']",560,1837,2397,1617457,34,,,,4674
4bd8af6f5adb87c37df22f96ce7a15a5709a5ebb,1,chathuri,2014-03-02 16:53:50-05:00,['1262568a93625c76627ad5301395dd90400969d7'],657,800,1457,1618914,2,0,0.706766917,0.954887218,4674
9f338e1b29425b65436517ff0bc8761742e47611,1,chathuri,2014-03-02 17:31:48-05:00,['4bd8af6f5adb87c37df22f96ce7a15a5709a5ebb'],352,458,810,1619724,3,0,0.406779661,0.491525424,4675
cce56e3c5ae0a1ce501eed41d5b6f0e36c416689,0,Shameera,2014-03-03 04:14:42+05:18,['1262568a93625c76627ad5301395dd90400969d7'],5,0,5,1619729,1,,,,4675
049ca1770ca69e81633f15f054594ff5eb4441a3,0,Shameera,2014-03-03 04:16:17+05:18,"['cce56e3c5ae0a1ce501eed41d5b6f0e36c416689', '9f338e1b29425b65436517ff0bc8761742e47611']",1009,1258,2267,1621996,5,,,,4675
5549c1d6f518f4574c09f88e2f8ba69fb066a41a,0,raminder,2014-03-03 09:31:51-05:00,['a4c0adcbed12b7cae32b73bda2c08a794c4b1920'],2,7,9,1622005,1,,,,4675
cb2a3899ff23b4b4e8ad17f9109e5b3647239f15,0,raminder,2014-03-03 09:33:05-05:00,"['5549c1d6f518f4574c09f88e2f8ba69fb066a41a', '049ca1770ca69e81633f15f054594ff5eb4441a3']",1014,1424,2438,1624443,7,,,,4675
f75fa7ef3fd0012b84bc05ab006a843dfc87b5b0,0,chathuri,2014-03-03 10:03:35-05:00,['cb2a3899ff23b4b4e8ad17f9109e5b3647239f15'],35,50,85,1624528,3,0,0,1,4675
0a470ce909fd6d1e041524792cb81f5f6059b5ce,1,chathuri,2014-03-03 12:02:08-05:00,['f75fa7ef3fd0012b84bc05ab006a843dfc87b5b0'],74,263,337,1624865,5,0.124137931,0.275862069,1,4676
3f8457a73cac42f923bdfc2bedf7925b4b09cdfd,0,lahiru,2014-03-03 12:05:35-05:00,['a4c0adcbed12b7cae32b73bda2c08a794c4b1920'],63,110,173,1625038,7,0.055555556,0.527777778,1,4676
22cd1a0917e7e4b08d6eb09a777462d14fe48ddf,0,lahiru,2014-03-03 12:08:40-05:00,"['3f8457a73cac42f923bdfc2bedf7925b4b09cdfd', '0a470ce909fd6d1e041524792cb81f5f6059b5ce']",1111,1732,2843,1627881,13,,,,4676
8252ea599eedbb07e197ef2d29a935de1a8b6f3b,0,chathuri,2014-03-03 13:11:11-05:00,['22cd1a0917e7e4b08d6eb09a777462d14fe48ddf'],3,3,6,1627887,1,,,,4676
ec4172700cb122332e0c5a3013467b5ff35d6fc0,0,lahiru,2014-03-03 13:15:09-05:00,['8252ea599eedbb07e197ef2d29a935de1a8b6f3b'],7,3,10,1627897,2,1,0,0,4676
47afa398b8f0a89c509e07347432333558bf4a90,0,lahiru,2014-03-03 13:48:09-05:00,['ec4172700cb122332e0c5a3013467b5ff35d6fc0'],11,17,28,1627925,2,0,0,1,4676
8a615ec049d4c4f8421cf8ac20046e3a6744da9d,0,raminder,2014-03-03 14:07:34-05:00,['22cd1a0917e7e4b08d6eb09a777462d14fe48ddf'],278,455,733,1628658,19,0,0,0.909090909,4677
5fb684b621202489eb62829569651bad41268853,0,raminder,2014-03-03 14:07:48-05:00,"['8a615ec049d4c4f8421cf8ac20046e3a6744da9d', '47afa398b8f0a89c509e07347432333558bf4a90']",21,23,44,1628702,5,,,,4677
119f7541c7dccf618fe852edcb282cdaddb51e9f,0,lahiru,2014-03-03 15:26:14-05:00,['47afa398b8f0a89c509e07347432333558bf4a90'],17,10,27,1628729,2,0,0,0,4677
2736d75c7cc04b1486190f86117cf1e545afc07b,0,raminder,2014-03-03 15:28:01-05:00,['5fb684b621202489eb62829569651bad41268853'],2,21,23,1628752,3,0.714285714,0.714285714,1,4677
1dc04ce7c4a2ac591c5168a26815f74d6f788bec,0,raminder,2014-03-03 15:29:33-05:00,"['2736d75c7cc04b1486190f86117cf1e545afc07b', '119f7541c7dccf618fe852edcb282cdaddb51e9f']",17,10,27,1628779,2,,,,4677
46b17de7364d47ba67080bfc2be428a912f51526,1,chathuri,2014-03-03 15:46:23-05:00,['1dc04ce7c4a2ac591c5168a26815f74d6f788bec'],789,754,1543,1630322,13,0.544052863,0.13215859,0.149779736,4680
c897d30b3f5596e31aef04cde32c05ef8938a006,0,chathuri,2014-03-04 09:42:40-05:00,['46b17de7364d47ba67080bfc2be428a912f51526'],11,212,223,1630545,3,0.225,0.7375,1,4681
adc3cc53203c84c90a401d050b54424a090d1483,0,lahiru,2014-03-04 10:17:08-05:00,['c897d30b3f5596e31aef04cde32c05ef8938a006'],6,29,35,1630580,1,0,0,1,4681
44fb8f904dce39d2a185cdccde4c7fc2df6bcbb3,0,chathuri,2014-03-04 10:53:03-05:00,['adc3cc53203c84c90a401d050b54424a090d1483'],18,23,41,1630621,7,0,0,1,4681
5e851e66599e0f1d74ea9b1f90e421c5611f157a,0,lahiru,2014-03-04 11:14:48-05:00,['44fb8f904dce39d2a185cdccde4c7fc2df6bcbb3'],7,5,12,1630633,4,,,,4681
3cf487ebfa154a9fc073b88f2e7f8521b1c0746d,0,Saminda Wijeratne,2014-03-04 12:59:35-05:00,['46b17de7364d47ba67080bfc2be428a912f51526'],2,2,4,1630637,1,,,,4681
d6b6693c941dc34e4f0e58df3e3a63a88cba9b71,0,Saminda Wijeratne,2014-03-04 13:02:42-05:00,"['3cf487ebfa154a9fc073b88f2e7f8521b1c0746d', '5e851e66599e0f1d74ea9b1f90e421c5611f157a']",34,261,295,1630932,11,,,,4681
bad1273b19c950ed507a38e5e44ec5ecacb6a78c,0,lahiru,2014-03-04 13:09:53-05:00,['5e851e66599e0f1d74ea9b1f90e421c5611f157a'],118,75,193,1631125,17,1,0.466666667,0,4681
b7b80180a47e95fae2a01e182e894e38cb4a1bf1,0,lahiru,2014-03-04 14:45:24-05:00,['bad1273b19c950ed507a38e5e44ec5ecacb6a78c'],3,13,16,1631141,1,0,0,1,4681
5b62ef6ac04b97b4f851d2bfe13a0c5385f2c588,0,chathuri,2014-03-04 14:51:48-05:00,['b7b80180a47e95fae2a01e182e894e38cb4a1bf1'],17,55,72,1631213,5,0.076923077,0,1,4681
0ec292f929d89e3f743bd848e9c19b8e7f3c88cf,0,Saminda Wijeratne,2014-03-04 16:30:52-05:00,"['d6b6693c941dc34e4f0e58df3e3a63a88cba9b71', '5b62ef6ac04b97b4f851d2bfe13a0c5385f2c588']",136,141,277,1631490,21,,,,4681
592f102762173e22c3a81f781d3c55e620058c28,0,raminder,2014-03-04 16:35:42-05:00,['5b62ef6ac04b97b4f851d2bfe13a0c5385f2c588'],17,79,96,1631586,10,0.393939394,0.393939394,0.363636364,4681
e0eb89a074ecca6e7e4ff641509875877a926343,0,lahiru,2014-03-04 17:00:50-05:00,['5b62ef6ac04b97b4f851d2bfe13a0c5385f2c588'],53,76,129,1631715,3,0.611111111,0.611111111,1,4681
4d6dbbeecd72137002b2054737c84918fc5bf8df,0,lahiru,2014-03-04 17:01:09-05:00,"['e0eb89a074ecca6e7e4ff641509875877a926343', '592f102762173e22c3a81f781d3c55e620058c28']",17,79,96,1631811,10,,,,4681
cead776ce4e45a48c708b21d0dce24b321d94e47,0,Saminda Wijeratne,2014-03-04 20:24:55-05:00,['0ec292f929d89e3f743bd848e9c19b8e7f3c88cf'],157,102,259,1632070,3,,,,4681
893156a89fb0b8935102c5a68d734caf32f0886c,0,Saminda Wijeratne,2014-03-04 20:26:00-05:00,"['cead776ce4e45a48c708b21d0dce24b321d94e47', '4d6dbbeecd72137002b2054737c84918fc5bf8df']",70,155,225,1632295,13,,,,4681
edd26be83e91048e103b222a07dd1c84b6a87f40,0,Saminda Wijeratne,2014-03-04 20:26:59-05:00,['893156a89fb0b8935102c5a68d734caf32f0886c'],183,207,390,1632685,6,1,1,1,4681
7cf63c7cccdbd83f7567efd32e80b83bef036deb,0,Saminda Wijeratne,2014-03-04 22:27:23-05:00,['edd26be83e91048e103b222a07dd1c84b6a87f40'],24,87,111,1632796,2,1,1,1,4682
1860a8ce2392525ec42d65539f648c4721581b62,0,Saminda Wijeratne,2014-03-04 22:53:18-05:00,['7cf63c7cccdbd83f7567efd32e80b83bef036deb'],0,276,276,1633072,1,,,,4683
908132809b395a7419c6ff9756c26fa61e7dd01d,0,Saminda Wijeratne,2014-03-04 23:07:39-05:00,['1860a8ce2392525ec42d65539f648c4721581b62'],29,41,70,1633142,2,,,,4683
d4ed9c58379e44f31c1aedb8ffebc47055b2b4fc,0,chathuri,2014-03-04 23:13:25-05:00,['908132809b395a7419c6ff9756c26fa61e7dd01d'],18,23,41,1633183,9,1,1,0,4683
79cb0ef511aa09b5e7a30f5f8d3018dfe6782e53,1,chathuri,2014-03-05 11:09:50-05:00,['d4ed9c58379e44f31c1aedb8ffebc47055b2b4fc'],2,34,36,1633219,2,0.2,0,0.9,4683
e40016ddb3b11560a6a94c90c5457e1bda39457d,0,chathuri,2014-03-05 12:22:46-05:00,['79cb0ef511aa09b5e7a30f5f8d3018dfe6782e53'],6,93,99,1633318,1,0,0,1,4683
d0617ee01c62dc81f328f4c66416cee790af9595,0,raminder,2014-03-05 15:17:29-05:00,['d4ed9c58379e44f31c1aedb8ffebc47055b2b4fc'],0,116,116,1633434,1,0,1,1,4683
5a807789e077ba8b68ca6684aabcf6e9dc0d8b08,0,raminder,2014-03-05 15:18:44-05:00,"['d0617ee01c62dc81f328f4c66416cee790af9595', 'e40016ddb3b11560a6a94c90c5457e1bda39457d']",8,127,135,1633569,2,,,,4683
76c31db500c5470e19d6b761ea3b21f755ba3ef1,0,Saminda Wijeratne,2014-03-05 23:25:30-05:00,['e40016ddb3b11560a6a94c90c5457e1bda39457d'],154,13,167,1633736,13,1,1,1,4683
c6d450e21c6509aca9674da8b7527f7724a357c7,0,Saminda Wijeratne,2014-03-05 23:25:56-05:00,"['76c31db500c5470e19d6b761ea3b21f755ba3ef1', '5a807789e077ba8b68ca6684aabcf6e9dc0d8b08']",0,116,116,1633852,1,,,,4683
1a946082b33e64133d25d7532f9c689159c6dbb9,0,Saminda Wijeratne,2014-03-05 23:49:55-05:00,['c6d450e21c6509aca9674da8b7527f7724a357c7'],2,2,4,1633856,1,,,,4683
ad03762659d71438007ab8148812e06708388260,0,Saminda Wijeratne,2014-03-05 23:51:24-05:00,['1a946082b33e64133d25d7532f9c689159c6dbb9'],2,2,4,1633860,1,,,,4683
8fa0405bf1614c580216756165ec959f7837c45e,0,Saminda Wijeratne,2014-03-05 23:54:20-05:00,['ad03762659d71438007ab8148812e06708388260'],2,2,4,1633864,1,,,,4683
e581557ea30dd3d7cfdd922ee7ec9fcd35726a63,0,Saminda Wijeratne,2014-03-05 23:57:35-05:00,['8fa0405bf1614c580216756165ec959f7837c45e'],2,2,4,1633868,1,,,,4683
bada8e4d24aacb6e801da50680eca03c86b7b9fb,0,Saminda Wijeratne,2014-03-06 00:17:43-05:00,['e581557ea30dd3d7cfdd922ee7ec9fcd35726a63'],0,5,5,1633873,2,,,,4683
f452dabf9cea9aebf8bc6e0c43caacc2709224bd,0,Saminda Wijeratne,2014-03-06 09:26:04-05:00,['bada8e4d24aacb6e801da50680eca03c86b7b9fb'],14,14,28,1633901,8,1,0,0,4683
50af1b0da12de5be8993ce411d65cabcb1867466,0,Marlon Pierce,2014-03-06 10:39:06-05:00,['bada8e4d24aacb6e801da50680eca03c86b7b9fb'],0,3,3,1633904,2,,,,4683
2d07714d23cbfa8afda547db60cd5e161e5ad87e,0,marpierc,2014-03-06 10:47:29-05:00,"['50af1b0da12de5be8993ce411d65cabcb1867466', 'f452dabf9cea9aebf8bc6e0c43caacc2709224bd']",14,14,28,1633932,8,,,,4683
0233dcf295d6ef16f6aefcc0adf01bb367be3dbd,0,marpierc,2014-03-06 10:52:36-05:00,['2d07714d23cbfa8afda547db60cd5e161e5ad87e'],1,0,1,1633933,1,,,,4683
d707fc2145e2b9ca26266c07545e4a951385ceff,0,raminder,2014-03-06 12:00:00-05:00,['0233dcf295d6ef16f6aefcc0adf01bb367be3dbd'],2,2,4,1633937,2,,,,4683
8718d9485be1036007ec3cca2bc0ac294b0fdab3,0,chathuri,2014-03-06 12:11:26-05:00,['d707fc2145e2b9ca26266c07545e4a951385ceff'],1101,0,1101,1635038,4,,,,4683
5e3f0cfdc8622d72c85584e88338b8451ed5032b,0,chathuri,2014-03-06 12:12:55-05:00,['8718d9485be1036007ec3cca2bc0ac294b0fdab3'],15,56,71,1635109,5,0,1,1,4683
28f0b429530b6d46fa3d5f57334cb28ad07a7269,0,chathuri,2014-03-06 12:13:47-05:00,['5e3f0cfdc8622d72c85584e88338b8451ed5032b'],1,3,4,1635113,1,1,1,1,4683
880003b67264c434330499a78893823340c32766,0,chathuri,2014-03-06 12:15:10-05:00,['28f0b429530b6d46fa3d5f57334cb28ad07a7269'],3,6,9,1635122,1,0,1,1,4683
59cc938b617435016de116df10c01462c5a5575d,0,raminder,2014-03-06 14:06:49-05:00,['880003b67264c434330499a78893823340c32766'],3,3,6,1635128,3,,,,4683
59dcfaa41ac0153fc442338b6de7543242ff1a93,0,chathuri,2014-03-06 15:10:16-05:00,['59cc938b617435016de116df10c01462c5a5575d'],4,10,14,1635142,4,1,1,1,4683
65d26eb2b5dcc6674c393f339c467dd5dcd6befb,0,Saminda Wijeratne,2014-03-06 15:12:25-05:00,['f452dabf9cea9aebf8bc6e0c43caacc2709224bd'],13,5,18,1635160,1,0,,,4683
f986e09c14c098c7d4c7b4e40a228e219d059f5c,0,Saminda Wijeratne,2014-03-06 15:37:51-05:00,"['65d26eb2b5dcc6674c393f339c467dd5dcd6befb', '59dcfaa41ac0153fc442338b6de7543242ff1a93']",1126,78,1204,1636364,21,,,,4683
b35810615eebd9f529dbcf79ca0d6fae909a7657,0,lahiru,2014-03-06 17:47:43-05:00,['79cb0ef511aa09b5e7a30f5f8d3018dfe6782e53'],1122,1408,2530,1638894,31,1,1,1,4692
532f2691e55c800947ef75ef9e30285c51b919f1,0,lahiru,2014-03-06 18:14:25-05:00,"['b35810615eebd9f529dbcf79ca0d6fae909a7657', 'f986e09c14c098c7d4c7b4e40a228e219d059f5c']",1305,374,1679,1640573,34,,,,4692
0315de482a079dc97d1a128f08d554629ad47721,0,lahiru,2014-03-06 22:27:38-05:00,['532f2691e55c800947ef75ef9e30285c51b919f1'],17,98,115,1640688,8,0,0.6,0.6,4693
c57378bda550db91d24bf6c596c7cc3765969895,0,lahiru,2014-03-06 22:28:32-05:00,['0315de482a079dc97d1a128f08d554629ad47721'],1,1,2,1640690,1,,,,4693
ccf48b25333a8d1285afbe642fc86ce9cc3321dd,0,chathuri,2014-03-06 23:27:52-05:00,['c57378bda550db91d24bf6c596c7cc3765969895'],451,401,852,1641542,6,0.771428571,0.20952381,0.028571429,4693
4ecf18e831892bdd3d7c43d8c8c9acba6f25ecca,0,lahiru,2014-03-07 10:19:33-05:00,['c57378bda550db91d24bf6c596c7cc3765969895'],5,11,16,1641558,2,0,0,1,4693
4523bd9db25e6257f674f9a223b3181414fe4f6f,0,lahiru,2014-03-07 10:20:12-05:00,"['4ecf18e831892bdd3d7c43d8c8c9acba6f25ecca', 'ccf48b25333a8d1285afbe642fc86ce9cc3321dd']",451,401,852,1642410,6,,,,4693
9c4f64a967d47611d0fe57481bb494c892b0929a,0,lahiru,2014-03-07 10:28:27-05:00,['4523bd9db25e6257f674f9a223b3181414fe4f6f'],2,45,47,1642457,1,0,1,1,4693
219063e0df324509d24b68dfdd2bc65032219e1b,0,chathuri,2014-03-07 10:38:19-05:00,['9c4f64a967d47611d0fe57481bb494c892b0929a'],2,195,197,1642654,5,0,,,4696
0a89a10a6c8256b80e6ae5f7734089dd0fa33352,0,lahiru,2014-03-07 10:50:26-05:00,['9c4f64a967d47611d0fe57481bb494c892b0929a'],2,5,7,1642661,3,0.333333333,1,1,4696
dda627b26bd306c04a7e142c647cc6f86de632ae,0,lahiru,2014-03-07 10:51:57-05:00,"['0a89a10a6c8256b80e6ae5f7734089dd0fa33352', '219063e0df324509d24b68dfdd2bc65032219e1b']",2,197,199,1642860,5,,,,4696
83dd7b0c42f5526ba4d90b49957f496b9c27cbea,0,lahiru,2014-03-07 10:53:07-05:00,['dda627b26bd306c04a7e142c647cc6f86de632ae'],4,1,5,1642865,2,1,0,0,4696
3dd2bf00087589a3849d0db479c5c6b216017ad9,0,chathuri,2014-03-07 11:04:15-05:00,['83dd7b0c42f5526ba4d90b49957f496b9c27cbea'],0,3,3,1642868,1,1,1,1,4696
21040aed6b3efdd2c07ff5af4725bc329f1b8086,0,raminder,2014-03-07 11:20:45-05:00,['59cc938b617435016de116df10c01462c5a5575d'],8,62,70,1642938,2,0,1,1,4696
ae4adec6c490b17c823a3f3b98551267e4804e3a,0,lahiru,2014-03-07 11:31:50-05:00,['83dd7b0c42f5526ba4d90b49957f496b9c27cbea'],18,47,65,1643003,6,0,0,1,4696
8b8451f3d79cea0fe41038e6d140b2b1ab796cc6,0,lahiru,2014-03-07 11:32:02-05:00,"['ae4adec6c490b17c823a3f3b98551267e4804e3a', '3dd2bf00087589a3849d0db479c5c6b216017ad9']",0,3,3,1643006,1,,,,4696
0f7a1940ebbd37269224d013dad3bf613853be28,0,lahiru,2014-03-07 11:52:29-05:00,['8b8451f3d79cea0fe41038e6d140b2b1ab796cc6'],1,26,27,1643033,2,0,0,1,4696
2ea8b5c415a8735f6a1b822ca10766a7cbcfb793,0,raminder,2014-03-07 12:21:27-05:00,"['21040aed6b3efdd2c07ff5af4725bc329f1b8086', '3dd2bf00087589a3849d0db479c5c6b216017ad9']",1435,2169,3604,1646637,51,,,,4696
99dd1bacc839ae7051fb8ac10eb07c5323c67d33,0,raminder,2014-03-07 12:22:28-05:00,"['2ea8b5c415a8735f6a1b822ca10766a7cbcfb793', '0f7a1940ebbd37269224d013dad3bf613853be28']",19,73,92,1646729,8,,,,4696
de5aa33ae1bf61767c6bd8b2948494c4ae952251,0,lahiru,2014-03-07 12:47:46-05:00,['0f7a1940ebbd37269224d013dad3bf613853be28'],7,23,30,1646759,4,0.916666667,0.916666667,1,4696
c45875eed7c4bca57a35cf9ee5a5c2265b52fa94,0,lahiru,2014-03-07 12:48:41-05:00,"['de5aa33ae1bf61767c6bd8b2948494c4ae952251', '99dd1bacc839ae7051fb8ac10eb07c5323c67d33']",11,180,191,1646950,3,,,,4696
d8d2945657b4d114b2bc67f0a48fadcdabefc4f5,0,lahiru,2014-03-07 12:53:06-05:00,['c45875eed7c4bca57a35cf9ee5a5c2265b52fa94'],2,5,7,1646957,1,,,,4696
4932605ec94c3978fe51586df4f1d9e4b2771ae6,0,chathuri,2014-03-07 13:55:36-05:00,['d8d2945657b4d114b2bc67f0a48fadcdabefc4f5'],13,17,30,1646987,13,,,,4696
9e71880b1be03fd98bd26e6bbaa2aef40c723711,1,Saminda Wijeratne,2014-03-07 15:50:51-05:00,['0f7a1940ebbd37269224d013dad3bf613853be28'],15,125,140,1647127,8,0.902439024,0.609756098,1,4698
1f298eabd66e847b9c656a11a4dfcd1d3c7bf906,0,Saminda Wijeratne,2014-03-07 15:51:03-05:00,"['9e71880b1be03fd98bd26e6bbaa2aef40c723711', '4932605ec94c3978fe51586df4f1d9e4b2771ae6']",33,225,258,1647385,20,,,,4698
1d7671ed69ea61f88db9b2633bc22e3fd4005270,0,chathuri,2014-03-07 16:28:25-05:00,['1f298eabd66e847b9c656a11a4dfcd1d3c7bf906'],6,529,535,1647920,7,0,0.525547445,1,4700
856da92449ef73e2ee1e5d3e87e2f194d5c3f9d4,0,lahiru,2014-03-07 16:49:29-05:00,['1d7671ed69ea61f88db9b2633bc22e3fd4005270'],39,0,39,1647959,1,,,,4700
9295006fe14575622c84779df2ef8b18f6d734c2,0,raminder,2014-03-08 10:48:44-05:00,['856da92449ef73e2ee1e5d3e87e2f194d5c3f9d4'],12,181,193,1648152,2,0.09375,1,1,4700
afcd6e381e7bec5207e66c59e1e2a7c97058f8e4,0,raminder,2014-03-08 10:49:48-05:00,['9295006fe14575622c84779df2ef8b18f6d734c2'],1,1,2,1648154,1,,,,4700
e54c7d058150c86559c323f5248212570d6a3d45,0,Saminda Wijeratne,2014-03-08 11:10:34-05:00,['856da92449ef73e2ee1e5d3e87e2f194d5c3f9d4'],372,90,462,1648616,6,0.066666667,0,0.506666667,4700
708f6a48381ae0cef9de1728bcf0740fa2853b24,0,Saminda Wijeratne,2014-03-08 11:10:53-05:00,"['e54c7d058150c86559c323f5248212570d6a3d45', 'afcd6e381e7bec5207e66c59e1e2a7c97058f8e4']",11,180,191,1648807,2,,,,4700
7b61c4801e6f95e6e8d4966e75eb3bb566294b31,0,Saminda Wijeratne,2014-03-08 11:48:36-05:00,['708f6a48381ae0cef9de1728bcf0740fa2853b24'],4,9,13,1648820,2,,,,4700
53acbbde5d290d7aca927c4d3b5ed82aa7de7eb9,0,Saminda Wijeratne,2014-03-08 17:53:25-05:00,['7b61c4801e6f95e6e8d4966e75eb3bb566294b31'],9,47,56,1648876,2,0.46875,0.46875,1,4700
5b3c75f71d88ab70a8a80639e95e1d7ff21f8e85,0,Saminda Wijeratne,2014-03-09 11:38:20-04:00,['53acbbde5d290d7aca927c4d3b5ed82aa7de7eb9'],32,53,85,1648961,4,1,0,1,4700
0b6e1e5aff029450cfb554022ebc4889ad3e72ca,0,Saminda Wijeratne,2014-03-09 15:27:15-04:00,['5b3c75f71d88ab70a8a80639e95e1d7ff21f8e85'],51,126,177,1649138,4,0.527272727,0.527272727,1,4700
74a5d2a56369f384b0433f0678e822764fbbec27,0,Saminda Wijeratne,2014-03-10 00:40:01-04:00,['0b6e1e5aff029450cfb554022ebc4889ad3e72ca'],25,77,102,1649240,2,0.121212121,0.606060606,1,4700
de76d89415ffd6f8eb0067b8262b144c975a7ebc,0,Saminda Wijeratne,2014-03-10 08:29:53-04:00,['74a5d2a56369f384b0433f0678e822764fbbec27'],6,18,24,1649264,1,,,,4700
8c0287ec4ec7636c1f098acc92484102ea2dc659,1,Suresh Marru,2014-03-10 11:35:55-04:00,['de76d89415ffd6f8eb0067b8262b144c975a7ebc'],4028,9925,13953,1663217,2,0.531417893,0.622050923,0.978743284,4700
659600d27ecab4b790443ea0ed2fe61c3303dc7a,0,Suresh Marru,2014-03-10 11:38:53-04:00,['8c0287ec4ec7636c1f098acc92484102ea2dc659'],0,62,62,1663279,1,1,1,1,4700
5920f22d3e4c9b6fbd98240829b58f2463c1be89,0,Suresh Marru,2014-03-10 11:40:00-04:00,['659600d27ecab4b790443ea0ed2fe61c3303dc7a'],4,0,4,1663283,1,0,0,0,4700
78365f46a86b1308532f78de1aa6cf350836d5e5,0,chathuri,2014-03-10 12:10:43-04:00,['5920f22d3e4c9b6fbd98240829b58f2463c1be89'],2,29,31,1663314,1,0,1,1,4700
5331b94baaeed74b6c7c2373adc96996b124c57b,0,Saminda Wijeratne,2014-03-10 12:28:23-04:00,['de76d89415ffd6f8eb0067b8262b144c975a7ebc'],0,7,7,1663321,2,,,,4700
85cde27cc71b7d77e6d377d263d3e7a69e327e08,0,Saminda Wijeratne,2014-03-10 12:28:42-04:00,"['5331b94baaeed74b6c7c2373adc96996b124c57b', '78365f46a86b1308532f78de1aa6cf350836d5e5']",4032,10014,14046,1677367,3,,,,4700
4ee0852d0a254800dc18ef3a518e6476d83c831c,0,Saminda Wijeratne,2014-03-10 12:38:19-04:00,['85cde27cc71b7d77e6d377d263d3e7a69e327e08'],1,0,1,1677368,1,,,,4700
24babee475123141141d21b98e71da7cdc4bc66b,0,lahiru,2014-03-10 14:55:48-04:00,['4ee0852d0a254800dc18ef3a518e6476d83c831c'],140,192,332,1677700,17,1,0.794117647,0.764705882,4700
71249304768b4d68ae98492363e9d5155881558c,0,Saminda Wijeratne,2014-03-10 15:14:44-04:00,['4ee0852d0a254800dc18ef3a518e6476d83c831c'],13,61,74,1677774,2,1,1,1,4700
1a86ed90724cbea1a5b42007a09faf9bc33bab6e,0,Saminda Wijeratne,2014-03-10 15:15:26-04:00,"['71249304768b4d68ae98492363e9d5155881558c', '24babee475123141141d21b98e71da7cdc4bc66b']",140,192,332,1678106,17,,,,4700
68a55896f31baadabad652279f63998ff09feb32,0,lahiru,2014-03-10 15:22:28-04:00,['24babee475123141141d21b98e71da7cdc4bc66b'],21,33,54,1678160,4,0.666666667,1,0.833333333,4700
1263b2b042b07943e1f2d841d217f2e6b9e52168,0,lahiru,2014-03-10 15:22:39-04:00,"['68a55896f31baadabad652279f63998ff09feb32', '1a86ed90724cbea1a5b42007a09faf9bc33bab6e']",13,61,74,1678234,2,,,,4700
35da60257e7a9e92089426f525895b359bad25af,0,lahiru,2014-03-10 15:44:57-04:00,['1263b2b042b07943e1f2d841d217f2e6b9e52168'],9,11,20,1678254,5,0,0,0,4700
eb3ae3163326d594e210ff7f42b58fe1df03c637,0,chathuri,2014-03-10 17:28:47-04:00,['35da60257e7a9e92089426f525895b359bad25af'],0,2,2,1678256,2,0,0.5,1,4700
67195e5356bd24f074f6198c9ebb51e1c93767fc,0,lahiru,2014-03-10 18:45:44-04:00,['eb3ae3163326d594e210ff7f42b58fe1df03c637'],1,25,26,1678282,2,1,1,1,4700
2a813b80626525b7136c9ffd13c16ae04aeba748,1,Saminda Wijeratne,2014-03-10 22:22:16-04:00,['1263b2b042b07943e1f2d841d217f2e6b9e52168'],86,172,258,1678540,7,0.231884058,0.942028986,1,4700
e5901e8e8fb08e909475997d32b60ba33fec5b01,0,Saminda Wijeratne,2014-03-10 22:22:24-04:00,"['2a813b80626525b7136c9ffd13c16ae04aeba748', '67195e5356bd24f074f6198c9ebb51e1c93767fc']",10,38,48,1678588,8,,,,4700
29e122151df1f416fdbec56e01a8312edf69dd2e,0,Saminda Wijeratne,2014-03-10 23:04:07-04:00,['e5901e8e8fb08e909475997d32b60ba33fec5b01'],7,17,24,1678612,1,0.75,1,1,4700
2e8dbe16f7570ba75763768c086fe18fc9cd2bf6,0,lahiru,2014-03-11 10:16:21-04:00,['29e122151df1f416fdbec56e01a8312edf69dd2e'],7,9,16,1678628,5,0,0,1,4700
58872cec2dcc121995d5db0541251a179d5b019e,0,lahiru,2014-03-11 11:09:52-04:00,['2e8dbe16f7570ba75763768c086fe18fc9cd2bf6'],12,56,68,1678696,10,0.21875,0.25,0.875,4700
583ed3010ca812348d7eb33a3581982d128c4a87,0,lahiru,2014-03-11 11:41:43-04:00,['58872cec2dcc121995d5db0541251a179d5b019e'],0,1549,1549,1680245,3,0.666666667,0.666666667,1,4701
4d254f1f397484280927b61fc53b10807d10575e,0,lahiru,2014-03-11 12:09:08-04:00,['583ed3010ca812348d7eb33a3581982d128c4a87'],2,3,5,1680250,3,,,,4701
f7dba4ecb54d62ab13437068ff4d471c8b40ff20,0,lahiru,2014-03-11 12:34:46-04:00,['4d254f1f397484280927b61fc53b10807d10575e'],2,3,5,1680255,2,1,1,1,4701
44ec4d31566fb2bab2f0b8c03bfa4af7e75f8287,1,chathuri,2014-03-11 12:40:46-04:00,['f7dba4ecb54d62ab13437068ff4d471c8b40ff20'],72,823,895,1681150,25,0.307865169,0.584269663,0.973033708,4705
4c50cabeb132c05f1591f6ece459f4aacde2e1ff,0,lahiru,2014-03-11 14:42:19-04:00,['f7dba4ecb54d62ab13437068ff4d471c8b40ff20'],13,19,32,1681182,2,0,0,1,4705
4c6f73dc373273642f3194ef9edb566dae96af30,0,raminder,2014-03-11 14:53:12-04:00,['44ec4d31566fb2bab2f0b8c03bfa4af7e75f8287'],6,0,6,1681188,1,1,0,0,4705
fc64bd0510bad08c3ee0a2dca9de33c4f62d7684,0,lahiru,2014-03-11 14:54:57-04:00,"['4c50cabeb132c05f1591f6ece459f4aacde2e1ff', '4c6f73dc373273642f3194ef9edb566dae96af30']",78,823,901,1682089,26,,,,4705
12dd3c6846902f9b07b5cc6d895af6a90571e009,1,chathuri,2014-03-11 14:57:48-04:00,['fc64bd0510bad08c3ee0a2dca9de33c4f62d7684'],14,33,47,1682136,5,0,0,1,4705
703a92be62d82756aa1f54f852c415609b55a14d,0,chathuri,2014-03-11 15:31:03-04:00,['12dd3c6846902f9b07b5cc6d895af6a90571e009'],3,9,12,1682148,1,0,0,1,4705
bbbc35d3e3ac455351a1efc4a71b9a9bfb41185b,0,lahiru,2014-03-11 15:40:40-04:00,['12dd3c6846902f9b07b5cc6d895af6a90571e009'],1555,2033,3588,1685736,42,0,0.263157895,1,4740
c00025f4935ce63f6f42d9c787f3400c3a2afb8d,0,lahiru,2014-03-11 15:40:58-04:00,"['bbbc35d3e3ac455351a1efc4a71b9a9bfb41185b', '703a92be62d82756aa1f54f852c415609b55a14d']",3,9,12,1685748,1,,,,4740
e181bfb24c01e142e8ee4e92ce30d80ca3c029e9,0,Saminda Wijeratne,2014-03-11 15:51:50-04:00,['58872cec2dcc121995d5db0541251a179d5b019e'],29,73,102,1685850,6,0.666666667,0.3125,1,4740
f9b95c93a269fa36dacae5a0595cbbbe7f20ad18,0,Saminda Wijeratne,2014-03-11 15:54:19-04:00,"['e181bfb24c01e142e8ee4e92ce30d80ca3c029e9', 'c00025f4935ce63f6f42d9c787f3400c3a2afb8d']",121,2926,3047,1688897,73,,,,4740
fc8f9681ddded80cb660fc6f7e1f4924b2fc8cf7,0,lahiru,2014-03-11 15:55:43-04:00,['c00025f4935ce63f6f42d9c787f3400c3a2afb8d'],1,3,4,1688901,2,0,0,1,4740
86bf411da1665a91fb14bbce878dd3f3b9ebec92,0,chathuri,2014-03-11 16:09:11-04:00,['fc8f9681ddded80cb660fc6f7e1f4924b2fc8cf7'],0,1,1,1688902,1,0,1,1,4740
258b5a7dc00eb6bf4975f55ccbe747d37155fcdf,0,chathuri,2014-03-11 16:33:11-04:00,['86bf411da1665a91fb14bbce878dd3f3b9ebec92'],9,11,20,1688922,1,1,1,0,4740
3a38bdfc3df85791deccc951e9b34b36fa04d92c,0,lahiru,2014-03-11 21:42:08-04:00,['258b5a7dc00eb6bf4975f55ccbe747d37155fcdf'],8,25,33,1688955,3,0,0,1,4740
6d1797d2ca9e8841cafa26f9b256508e54df8d1f,0,lahiru,2014-03-12 00:55:37-04:00,['3a38bdfc3df85791deccc951e9b34b36fa04d92c'],8,38,46,1689001,7,0,0,1,4740
b32cb524c7160e6736aaa59f14f8574a3a22174e,0,lahiru,2014-03-12 01:28:23-04:00,['6d1797d2ca9e8841cafa26f9b256508e54df8d1f'],5,7,12,1689013,3,,,,4740
4a0571d6b7baa3f7c8d67005a250bcc787d6bf4b,1,lahiru,2014-03-12 01:31:11-04:00,['b32cb524c7160e6736aaa59f14f8574a3a22174e'],1,1,2,1689015,1,,,,4740
9b4dedf0307687eef408f557c27bda56d76eb021,0,Saminda Wijeratne,2014-03-12 10:24:24-04:00,['f9b95c93a269fa36dacae5a0595cbbbe7f20ad18'],66,85,151,1689166,2,0.6,0.8,0,4740
13c67c460409df04edba83704e6ee50bd51bffd3,0,Saminda Wijeratne,2014-03-12 10:24:32-04:00,"['9b4dedf0307687eef408f557c27bda56d76eb021', '4a0571d6b7baa3f7c8d67005a250bcc787d6bf4b']",27,81,108,1689274,14,,,,4740
744b5462f1455f10f40127a2316c51bd14de90aa,0,lahiru,2014-03-12 10:49:33-04:00,['4a0571d6b7baa3f7c8d67005a250bcc787d6bf4b'],1,1,2,1689276,1,,,,4740
bb988d37738d4012592e1123f08ea282b85485c1,0,lahiru,2014-03-12 10:49:45-04:00,"['744b5462f1455f10f40127a2316c51bd14de90aa', '13c67c460409df04edba83704e6ee50bd51bffd3']",81,144,225,1689501,6,,,,4740
922686bfdb9d43f2856c9fdbfc9ec6c47af5f1a8,0,chathuri,2014-03-12 11:44:36-04:00,['bb988d37738d4012592e1123f08ea282b85485c1'],22,28,50,1689551,11,0,1,1,4740
86d2b622d662ac331bec376d4caca8c91fb9f2b3,0,Saminda Wijeratne,2014-03-12 12:33:00-04:00,['13c67c460409df04edba83704e6ee50bd51bffd3'],1,1,2,1689553,1,1,1,0,4740
cb6b7a831ad3d23f5b6fda290911df96d40e616f,0,Saminda Wijeratne,2014-03-12 12:33:29-04:00,"['86d2b622d662ac331bec376d4caca8c91fb9f2b3', '922686bfdb9d43f2856c9fdbfc9ec6c47af5f1a8']",23,29,52,1689605,12,,,,4740
199004da77ad25eb27fe1f0475283feb95848cbb,0,lahiru,2014-03-12 13:01:30-04:00,['bb988d37738d4012592e1123f08ea282b85485c1'],6,11,17,1689622,2,1,0,0,4740
56e65c100ce9f60e9bcf7a34e56650405c56f972,0,lahiru,2014-03-12 13:01:44-04:00,"['199004da77ad25eb27fe1f0475283feb95848cbb', 'cb6b7a831ad3d23f5b6fda290911df96d40e616f']",23,29,52,1689674,12,,,,4740
95fb3eb6483ea9f6c8c9f35d14a1426b454d9036,0,lahiru,2014-03-12 13:05:17-04:00,['56e65c100ce9f60e9bcf7a34e56650405c56f972'],0,1,1,1689675,1,0,0,1,4740
ef3e2e4c21b485f46a260699ffe13eb42fb69059,0,chathuri,2014-03-12 13:19:21-04:00,['95fb3eb6483ea9f6c8c9f35d14a1426b454d9036'],0,1,1,1689676,1,0,0,1,4740
576729b3ec3216a810e77b760cdaae5a21196558,0,raminder,2014-03-12 13:58:31-04:00,['ef3e2e4c21b485f46a260699ffe13eb42fb69059'],486,805,1291,1690967,5,0.198979592,0.653061224,1,4742
77758cb9f246d787393e02b6179ad0140f9db6c9,0,Suresh Marru,2014-03-12 14:01:42-04:00,['576729b3ec3216a810e77b760cdaae5a21196558'],8,15699,15707,1706674,26,0.281345002,0.350898204,0.908705666,4766
457e20d5552cd338ae8e65a6b7cb39b6d29ff64f,0,chathuri,2014-03-12 14:05:56-04:00,['77758cb9f246d787393e02b6179ad0140f9db6c9'],29,32,61,1706735,3,0.5,0,0,4766
47be5d49caf99932ee3f81c0835558fb02910e51,0,raminder,2014-03-12 14:12:03-04:00,['457e20d5552cd338ae8e65a6b7cb39b6d29ff64f'],1,1,2,1706737,1,,,,4766
8c6f9b5bf22282c71f89371a098bba7592adb964,0,raminder,2014-03-12 14:25:58-04:00,['47be5d49caf99932ee3f81c0835558fb02910e51'],2,2,4,1706741,2,,,,4766
c4bac758496930fdcd0b336cb7e2fbb7d0f1ba45,1,Suresh Marru,2014-03-12 14:29:17-04:00,['77758cb9f246d787393e02b6179ad0140f9db6c9'],1,15675,15676,1722417,49,0.386491228,0.542105263,0.923596491,4814
e8a6d419a9ce74052a161bbe1d97fe74f4be8da5,0,Suresh Marru,2014-03-12 14:29:26-04:00,"['c4bac758496930fdcd0b336cb7e2fbb7d0f1ba45', '8c6f9b5bf22282c71f89371a098bba7592adb964']",32,35,67,1722484,6,,,,4814
c0f20842c55c36ee56d6e9db9fa3c69dff831989,0,lahiru,2014-03-12 14:30:04-04:00,['95fb3eb6483ea9f6c8c9f35d14a1426b454d9036'],1,15,16,1722500,2,0,0,1,4814
0c08b94b859913d9b295b0732fd546ad25fa0f36,0,lahiru,2014-03-12 14:31:27-04:00,"['c0f20842c55c36ee56d6e9db9fa3c69dff831989', 'e8a6d419a9ce74052a161bbe1d97fe74f4be8da5']",526,32214,32740,1755240,86,,,,4814
53977e33c6c55b3a85120a74802fd768fef9a38a,0,raminder,2014-03-12 15:24:20-04:00,['8c6f9b5bf22282c71f89371a098bba7592adb964'],15,15,30,1755270,2,1,1,1,4814
57c8aae38a129d573b28aac79fe828447d5d5586,0,lahiru,2014-03-12 15:27:25-04:00,['0c08b94b859913d9b295b0732fd546ad25fa0f36'],7,16,23,1755293,1,0,0,1,4814
cbf5b686cc5a2dd89b0358197cf8a039e1295233,0,lahiru,2014-03-12 15:53:36-04:00,['57c8aae38a129d573b28aac79fe828447d5d5586'],3,3,6,1755299,1,,,,4814
dde86a59a8a233b89e193901f478147333147e21,0,lahiru,2014-03-12 16:02:53-04:00,['cbf5b686cc5a2dd89b0358197cf8a039e1295233'],7,15,22,1755321,5,0.2,0.4,1,4814
c9f9254b84e6ef4872deb769ce8f5dbf9fd3293b,0,chathuri,2014-03-12 16:03:33-04:00,['cbf5b686cc5a2dd89b0358197cf8a039e1295233'],6,14,20,1755341,3,0,1,1,4814
705dc5998c2731d3796d5013aa7eae3ade68e0b0,0,chathuri,2014-03-12 16:03:47-04:00,"['c9f9254b84e6ef4872deb769ce8f5dbf9fd3293b', 'dde86a59a8a233b89e193901f478147333147e21']",7,15,22,1755363,5,,,,4814
89ac4f93df8c22f54baac8529723d2702f2fa622,0,raminder,2014-03-12 16:12:54-04:00,['53977e33c6c55b3a85120a74802fd768fef9a38a'],5,6,11,1755374,2,,,,4814
0b6de0611dc3435ef710038d0afbf0e6f937d570,0,raminder,2014-03-12 16:13:45-04:00,"['89ac4f93df8c22f54baac8529723d2702f2fa622', '705dc5998c2731d3796d5013aa7eae3ade68e0b0']",22,15735,15757,1771131,60,,,,4814
05de4b430b14e3dcfdfcfe1b91f7f2f5bf892731,0,chathuri,2014-03-12 17:06:16-04:00,['0b6de0611dc3435ef710038d0afbf0e6f937d570'],3,9,12,1771143,2,0,0.333333333,1,4814
367a0ff20fc6922aa2e4b388e20ebaf56a3bbbbc,0,lahiru,2014-03-12 17:18:44-04:00,['dde86a59a8a233b89e193901f478147333147e21'],10,12,22,1771165,3,1,1,0,4814
f558deeb1a477bc6cddf5c0162224e068daa64ae,0,lahiru,2014-03-12 17:18:55-04:00,"['367a0ff20fc6922aa2e4b388e20ebaf56a3bbbbc', '05de4b430b14e3dcfdfcfe1b91f7f2f5bf892731']",26,41,67,1771232,7,,,,4814
7a8838fdb66c2587f2f70bb024fa844663e941cb,0,chathuri,2014-03-12 17:28:42-04:00,['f558deeb1a477bc6cddf5c0162224e068daa64ae'],20,17,37,1771269,1,,,,4814
964319800e6f5b7570d5c8be916976bb76954c44,0,raminder,2014-03-12 17:36:03-04:00,['0b6de0611dc3435ef710038d0afbf0e6f937d570'],1,83,84,1771353,5,0.230769231,0.692307692,0.980769231,4814
0a46c0cba6a9a05cc3cc76c95af01e18acb89b5d,0,raminder,2014-03-12 17:39:22-04:00,"['964319800e6f5b7570d5c8be916976bb76954c44', '7a8838fdb66c2587f2f70bb024fa844663e941cb']",33,38,71,1771424,6,,,,4814
1f7a8d946e580d5cdc79833ed38d647db9661ac5,0,lahiru,2014-03-12 23:43:07-04:00,['f558deeb1a477bc6cddf5c0162224e068daa64ae'],13,294,307,1771731,5,0.280373832,0.523364486,0.887850467,4816
eeb00a39c10a6b666084df356c5e11ef119abbf2,0,lahiru,2014-03-12 23:43:29-04:00,"['1f7a8d946e580d5cdc79833ed38d647db9661ac5', '0a46c0cba6a9a05cc3cc76c95af01e18acb89b5d']",21,99,120,1771851,6,,,,4816
bf37ea8ec57acd49ef845c25341d3218c5d85078,0,lahiru,2014-03-13 00:16:13-04:00,['eeb00a39c10a6b666084df356c5e11ef119abbf2'],2,4,6,1771857,2,1,1,1,4816
1441a8317967fc0f8b84b515d4d87dd78ca3e31a,0,Suresh Marru,2014-03-13 07:19:19-04:00,['e8a6d419a9ce74052a161bbe1d97fe74f4be8da5'],0,975,975,1772832,5,0.08095952,0.106446777,0.106446777,4821
5b6e610b2d672388edabca8e98aa7b89287ea349,0,Suresh Marru,2014-03-13 07:19:30-04:00,"['1441a8317967fc0f8b84b515d4d87dd78ca3e31a', 'bf37ea8ec57acd49ef845c25341d3218c5d85078']",87,496,583,1773415,25,,,,4821
1c06fe07c1a2761bd20e0f2504b2d322bddc1dbc,0,raminder,2014-03-13 07:24:04-04:00,['0a46c0cba6a9a05cc3cc76c95af01e18acb89b5d'],3,6,9,1773424,1,0,0,0,4821
dfb51fcc98d104472ede2a47aaf8d64310f606df,0,raminder,2014-03-13 07:24:26-04:00,"['1c06fe07c1a2761bd20e0f2504b2d322bddc1dbc', '5b6e610b2d672388edabca8e98aa7b89287ea349']",15,1272,1287,1774711,11,,,,4821
b424dfee18c91331e08ce16fe0fa60045fc1b8dd,0,raminder,2014-03-13 08:24:05-04:00,['dfb51fcc98d104472ede2a47aaf8d64310f606df'],112,20,132,1774843,2,0,0,1,4821
5d12010786a0a4836af5736e4996620d0b3f0a5a,0,lahiru,2014-03-13 09:22:50-04:00,['b424dfee18c91331e08ce16fe0fa60045fc1b8dd'],3,19,22,1774865,3,0.857142857,0.857142857,1,4821
1638e26a9efaf63d13c8ff2b7f80972143f43398,0,lahiru,2014-03-13 09:27:39-04:00,['5d12010786a0a4836af5736e4996620d0b3f0a5a'],7,0,7,1774872,2,,,,4821
a0960564c0ed514579144b6743cae84239f84160,0,lahiru,2014-03-13 09:56:01-04:00,['1638e26a9efaf63d13c8ff2b7f80972143f43398'],13,13,26,1774898,1,1,1,0,4821
a6451c9345d4e64cf6242c23a68e27c8a49daa8f,0,lahiru,2014-03-13 10:08:09-04:00,['a0960564c0ed514579144b6743cae84239f84160'],7,11,18,1774916,2,0,0,1,4821
cec965bb6310ec15cd4928fc06e4651facd97b33,0,lahiru,2014-03-13 10:24:35-04:00,['a6451c9345d4e64cf6242c23a68e27c8a49daa8f'],1,1,2,1774918,1,,,,4821
b568db932abf89d8a3ed357c2211c7ae34ad24d9,0,lahiru,2014-03-13 10:30:11-04:00,['cec965bb6310ec15cd4928fc06e4651facd97b33'],1,1,2,1774920,1,,,,4821
1c4433a98494905a20b5bef3b4bb37bb3d8d2487,0,lahiru,2014-03-13 10:39:21-04:00,['b568db932abf89d8a3ed357c2211c7ae34ad24d9'],1,0,1,1774921,1,1,1,0,4821
615820ac1542de225d43cfa45739968c6a2d2817,0,lahiru,2014-03-13 10:53:55-04:00,['1c4433a98494905a20b5bef3b4bb37bb3d8d2487'],6,17,23,1774944,3,0.777777778,1,1,4821
60c77db167ceec3a9ef61c46d86ca4503ebeada8,0,lahiru,2014-03-13 11:10:09-04:00,['615820ac1542de225d43cfa45739968c6a2d2817'],0,4,4,1774948,1,0,1,1,4821
30b04ca4fb573fddfd8676304adc04aa10e88dca,0,lahiru,2014-03-13 12:40:12-04:00,['60c77db167ceec3a9ef61c46d86ca4503ebeada8'],8,7,15,1774963,1,1,1,0,4821
b1b51786497237fc101c79491a30f1f1274be1c8,0,raminder,2014-03-13 12:50:58-04:00,['30b04ca4fb573fddfd8676304adc04aa10e88dca'],1,1,2,1774965,1,,,,4821
7437e11d029b38287271833f4253516e9e426d04,0,chathuri,2014-03-13 15:24:43-04:00,['b1b51786497237fc101c79491a30f1f1274be1c8'],4,8,12,1774977,1,1,1,1,4821
25e5e917590ad47ee91c4cd3690e0ec25dd4948d,0,raminder,2014-03-13 15:37:17-04:00,['b1b51786497237fc101c79491a30f1f1274be1c8'],12,19,31,1775008,2,0,1,1,4821
12c605453a31617fd4d0c99bce3a47516799c25a,0,raminder,2014-03-13 15:37:30-04:00,"['25e5e917590ad47ee91c4cd3690e0ec25dd4948d', '7437e11d029b38287271833f4253516e9e426d04']",4,8,12,1775020,1,,,,4821
49e74f57c6309acd8f54f99de9f670587d9d75e1,0,lahiru,2014-03-13 17:42:16-04:00,['7437e11d029b38287271833f4253516e9e426d04'],1,15,16,1775036,2,0.857142857,0.857142857,1,4821
96c11552b751d4a8e1953c41805767203180ed88,0,lahiru,2014-03-13 17:45:45-04:00,"['49e74f57c6309acd8f54f99de9f670587d9d75e1', '12c605453a31617fd4d0c99bce3a47516799c25a']",12,19,31,1775067,2,,,,4821
783a26a4cf09935d2ea24f798044e2ca64cb6ee4,0,Suresh Marru,2014-03-14 07:21:39-04:00,['96c11552b751d4a8e1953c41805767203180ed88'],15,35,50,1775117,1,,,,4821
23df890adde2b953118e78535c9fba48d658a22c,0,Suresh Marru,2014-03-14 06:12:36-07:00,[],0,205,205,1775322,2,,,,4823
c889112178c2994a47c0cf2cd2628675df6beaa4,0,Suresh Marru,2014-03-14 09:16:01-04:00,['23df890adde2b953118e78535c9fba48d658a22c'],0,16648,16648,1791970,53,0.36960305,0.518024364,0.878428773,4875
5afba8eec1c02eb4280c999c32156e80cac10514,0,Saminda Wijeratne,2014-03-14 09:33:02-04:00,['783a26a4cf09935d2ea24f798044e2ca64cb6ee4'],1,2,3,1791973,1,,,,4875
5d9bb847772436343a5b7cd03f279756f6d8c9f1,0,Suresh Marru,2014-03-14 09:40:58-04:00,['c889112178c2994a47c0cf2cd2628675df6beaa4'],0,15,15,1791988,1,,,,4875
230c700b4982d54db938355c9f4ccb61ca158a7b,0,dmreagan,2014-03-14 09:52:10-04:00,['5d9bb847772436343a5b7cd03f279756f6d8c9f1'],0,1,1,1791989,1,,,,4875
d3ad23a922e6af3c366473b87db55bdc3507fde9,0,Suresh Marru,2014-03-14 10:08:42-04:00,['230c700b4982d54db938355c9f4ccb61ca158a7b'],5,5,10,1791999,1,,,,4875
444f2df50ea660817d6a9bb1bf571da9b9d7d322,0,lahiru,2014-03-14 11:52:20-04:00,['783a26a4cf09935d2ea24f798044e2ca64cb6ee4'],7,6,13,1792012,2,0,0,1,4875
54674887f148d315ab2604402945808909077298,0,dmreagan,2014-03-14 12:20:30-04:00,['230c700b4982d54db938355c9f4ccb61ca158a7b'],2,3,5,1792017,1,,,,4875
713359cbd1d3eb5cb5be499ab744dca46a395243,0,dmreagan,2014-03-14 12:23:10-04:00,"['54674887f148d315ab2604402945808909077298', 'd3ad23a922e6af3c366473b87db55bdc3507fde9']",5,5,10,1792027,1,,,,4875
005c88b227c77cd46186d8fc276cedc9f00eafe3,0,dmreagan,2014-03-14 17:23:45-04:00,['713359cbd1d3eb5cb5be499ab744dca46a395243'],7,85,92,1792119,2,,,,4876
ab1ab84a269fa690162798e14c9a45645d841837,0,Suresh Marru,2014-03-16 18:31:17-04:00,['5afba8eec1c02eb4280c999c32156e80cac10514'],7,6,13,1792132,6,,,,4876
c2d006e65884eb0e7b64300fd2d09935d8bf8c95,0,lahiru,2014-03-18 00:41:12-04:00,['444f2df50ea660817d6a9bb1bf571da9b9d7d322'],0,0,0,1792132,65,,,,4876
0edfa860a57c9c178f42384aff0879830d3752e9,0,lahiru,2014-03-18 00:41:37-04:00,"['c2d006e65884eb0e7b64300fd2d09935d8bf8c95', 'ab1ab84a269fa690162798e14c9a45645d841837']",8,8,16,1792148,7,,,,4876
e58a4427a3deab446e5d56a44b9d9a5c69ccb851,0,lahiru,2014-03-18 00:46:08-04:00,['0edfa860a57c9c178f42384aff0879830d3752e9'],1,1,2,1792150,2,,,,4876
31f3883c23f0ae6eb92e306eddfbfa214bfb41c4,0,raminder,2014-03-18 16:17:36-04:00,['e58a4427a3deab446e5d56a44b9d9a5c69ccb851'],54,62,116,1792266,6,1,1,1,4876
0599edf0bb0b909a62ca963f46d6c8aa083dfed7,0,viknesb,2014-03-19 21:36:12-06:00,['31f3883c23f0ae6eb92e306eddfbfa214bfb41c4'],0,11,11,1792277,1,,,,4876
6b90e6427b9093ead5baf0cda3f599fa1aad363f,0,lahiru,2014-03-20 13:00:04-04:00,['0599edf0bb0b909a62ca963f46d6c8aa083dfed7'],118,265,383,1792660,13,0.218390805,0.827586207,0.103448276,4877
a052f5be8642a91c3252293887299a728dfb6129,0,lahiru,2014-03-24 11:53:07-04:00,['6b90e6427b9093ead5baf0cda3f599fa1aad363f'],165,501,666,1793326,20,0.440251572,0.459119497,0.72327044,4879
098992dc9eb3b2abef80a2c18910bdd0ccf28b0c,0,lahiru,2014-03-24 12:15:33-04:00,['a052f5be8642a91c3252293887299a728dfb6129'],6,35,41,1793367,3,0,0,0.074074074,4879
8d9a5cab4c3df2cc9100e2ef6f1bd6822d2fbb72,0,lahiru,2014-03-24 14:59:18-04:00,['098992dc9eb3b2abef80a2c18910bdd0ccf28b0c'],98,153,251,1793618,8,0,0.511627907,0.651162791,4879
f60565b393c62e50d9c8d2f46641cf3f4e7b7377,0,lahiru,2014-03-25 14:53:03-04:00,['8d9a5cab4c3df2cc9100e2ef6f1bd6822d2fbb72'],29,250,279,1793897,15,,,,4885
cb826d37dd608a78f11e85c5708ec659b07340f0,0,lahiru,2014-03-25 15:19:41-04:00,['f60565b393c62e50d9c8d2f46641cf3f4e7b7377'],0,8,8,1793905,2,0,0,1,4885
6435ad35bcf53d619a0d87a55841609c75e11d26,0,lahiru,2014-03-25 18:28:53-04:00,['cb826d37dd608a78f11e85c5708ec659b07340f0'],54,49,103,1794008,8,1,0,0,4885
9825ab203ac52b931780810fd4983bc8d5e8a61f,0,lahiru,2014-03-25 22:52:26-04:00,['6435ad35bcf53d619a0d87a55841609c75e11d26'],91,457,548,1794556,15,0.08372093,0.702325581,1,4887
dc01f7cec777f77aeb0e8ce3897df7fe4b96de5a,0,lahiru,2014-03-25 23:39:48-04:00,['9825ab203ac52b931780810fd4983bc8d5e8a61f'],116,306,422,1794978,6,0,1,0.970588235,4889
c1f3429eb7783776a4142a56f7ece2a71c0d0c8c,0,lahiru,2014-03-25 23:40:42-04:00,['dc01f7cec777f77aeb0e8ce3897df7fe4b96de5a'],274,0,274,1795252,2,1,0,0,4889
04c502b8c2dbab66c6f64a05a1433e8a800db11b,0,raminder,2014-03-26 10:42:25-04:00,['cb826d37dd608a78f11e85c5708ec659b07340f0'],20,134,154,1795406,7,0,1,1,4889
98519a7854b5a8b075d82254056bf3bc696bd491,0,lahiru,2014-03-26 11:20:53-04:00,['c1f3429eb7783776a4142a56f7ece2a71c0d0c8c'],18,55,73,1795479,3,0.862068966,0.344827586,1,4889
7e845c10441ea7067167f12bfd2e088adb39c060,0,raminder,2014-03-26 11:35:53-04:00,"['04c502b8c2dbab66c6f64a05a1433e8a800db11b', 'c1f3429eb7783776a4142a56f7ece2a71c0d0c8c']",167,159,326,1795805,17,,,,4889
007a111e80d832a59c02b3672ba850699ef6c6e5,0,raminder,2014-03-26 11:36:01-04:00,"['7e845c10441ea7067167f12bfd2e088adb39c060', '98519a7854b5a8b075d82254056bf3bc696bd491']",18,55,73,1795878,3,,,,4889
52e0fd345fe81190b86148d90da6de7381d0fe3b,0,chathuri,2014-03-26 16:20:34-04:00,['007a111e80d832a59c02b3672ba850699ef6c6e5'],0,158,158,1796036,1,0.252873563,0.252873563,1,4890
8f70e58aed3bf5061688b8328e20521a442198f3,0,raminder,2014-03-27 11:12:36-04:00,['52e0fd345fe81190b86148d90da6de7381d0fe3b'],29,318,347,1796383,4,0,1,1,4892
85f20a6730dccc037cb9748c4aeba3ea60cd7faa,0,Saminda Wijeratne,2014-03-28 00:19:30-04:00,['8f70e58aed3bf5061688b8328e20521a442198f3'],3,3,6,1796389,1,1,1,1,4892
460da0ef39ebf3a4b62f32148a7c4990d7d8214b,0,lahiru,2014-03-28 10:31:28-04:00,['52e0fd345fe81190b86148d90da6de7381d0fe3b'],149,0,149,1796538,1,,,,4892
192cd28ded5150dfb5f43015de450a6d496f7b4c,0,Saminda Wijeratne,2014-03-30 20:22:02-04:00,['85f20a6730dccc037cb9748c4aeba3ea60cd7faa'],279,0,279,1796817,2,1,0,0,4892
d68afe9b29a0ad968be6f8902a52e62d3dcfadd5,0,lahiru,2014-03-31 09:17:27-04:00,"['460da0ef39ebf3a4b62f32148a7c4990d7d8214b', '192cd28ded5150dfb5f43015de450a6d496f7b4c']",32,42,74,1796891,3,,,,4892
80cbc3e884cbc4f0609d5ff216b59430fee0abaf,0,lahiru,2014-03-31 09:54:30-04:00,['d68afe9b29a0ad968be6f8902a52e62d3dcfadd5'],9,17,26,1796917,1,0,0,1,4892
b47a807b4ca0a2bdf983f4933f4929cb561f8840,0,lahiru,2014-03-31 10:32:33-04:00,['80cbc3e884cbc4f0609d5ff216b59430fee0abaf'],1009,0,1009,1797926,5,,,,4892
346a3f5c5f48816a7825ff38096534280d28b686,0,lahiru,2014-03-31 17:01:35-04:00,['b47a807b4ca0a2bdf983f4933f4929cb561f8840'],9,417,426,1798352,9,0.077235772,0.512195122,0.87804878,4894
b57c333b26f85d1b00586a314a1985168cb5ffea,0,lahiru,2014-03-31 17:04:12-04:00,['346a3f5c5f48816a7825ff38096534280d28b686'],0,79,79,1798431,1,,,,4895
c7a9c8e97209f591b86a3f5e3da07498e5342021,0,lahiru,2014-03-31 17:05:07-04:00,['b57c333b26f85d1b00586a314a1985168cb5ffea'],0,1,1,1798432,1,,,,4895
74556fe42e01b120c6da2b7494cc7ba1da8b5a7d,0,Saminda Wijeratne,2014-03-31 21:02:15-07:00,['c7a9c8e97209f591b86a3f5e3da07498e5342021'],207,334,541,1798973,5,0,1,1,4896
b20d2f20d9ff7b39900fe7e83ce92c87baf94036,0,Saminda Wijeratne,2014-03-31 22:42:13-07:00,['74556fe42e01b120c6da2b7494cc7ba1da8b5a7d'],0,107,107,1799080,1,0.131578947,1,1,4897
42a4d2bc903b84e0c5c4858ed6a468d4496579b3,0,Saminda Wijeratne,2014-03-31 22:52:15-07:00,['b20d2f20d9ff7b39900fe7e83ce92c87baf94036'],0,288,288,1799368,1,,,,4898
9c555455162ed451bf3ec2b1e42df49a8a09a7a0,1,lahiru,2014-04-03 10:05:23-04:00,['42a4d2bc903b84e0c5c4858ed6a468d4496579b3'],3641,1051,4692,1804060,37,0.694810225,0,0,4900
1301e2a9e56afd3999ab4d90b4b6e3e45a297717,0,Suresh Marru,2014-04-03 10:18:27-04:00,['42a4d2bc903b84e0c5c4858ed6a468d4496579b3'],0,3,3,1804063,1,,,,4900
a2dcc366b97ccf2b31579f5f97d5c0c37e2726d4,0,Saminda Wijeratne,2014-04-04 02:02:31-07:00,['1301e2a9e56afd3999ab4d90b4b6e3e45a297717'],3588,293,3881,1807944,41,,,,4903
9ab16b97e47ca8dc5b981de7944f8a2a54bad745,0,lahiru,2014-04-04 09:22:39-04:00,"['9c555455162ed451bf3ec2b1e42df49a8a09a7a0', 'a2dcc366b97ccf2b31579f5f97d5c0c37e2726d4']",3588,282,3870,1811814,41,,,,4903
f2a7fc3e77dbe7682fc4f2bcd10ffefb781fd6a4,0,lahiru,2014-04-04 09:27:19-04:00,['9ab16b97e47ca8dc5b981de7944f8a2a54bad745'],0,3267,3267,1815081,17,0.28125,0.956380208,1,4920
e083a8f6fc2824bc2b6031257c6e0252d5b06d6a,0,lahiru,2014-04-04 11:25:14-04:00,['f2a7fc3e77dbe7682fc4f2bcd10ffefb781fd6a4'],65,24,89,1815170,9,0.675,0,0,4920
56eea3b4af89a15c7d44f2d0c65d30db2613d06d,0,Saminda Wijeratne,2014-04-05 21:21:09-07:00,['e083a8f6fc2824bc2b6031257c6e0252d5b06d6a'],3,3,6,1815176,3,,,,4920
ea57ef58e71946699ddf2dcf09b48f5f77b58738,1,Saminda Wijeratne,2014-04-06 17:05:37-07:00,['56eea3b4af89a15c7d44f2d0c65d30db2613d06d'],3024,401,3425,1818601,59,1,0.890243902,1,4920
de61d51162c182db20d54a39eab8bad49b2fad4c,0,Saminda Wijeratne,2014-04-06 19:33:21-07:00,['ea57ef58e71946699ddf2dcf09b48f5f77b58738'],12,67,79,1818680,3,0.638297872,1,1,4920
e16173855e7d8cc3bd6fe2c343c6f54c8cb504fb,0,lahiru,2014-04-09 00:24:50-04:00,['de61d51162c182db20d54a39eab8bad49b2fad4c'],222,156,378,1819058,12,0.903225806,1,0.483870968,4921
fa32f4dadc4dcadf1732be42b38995c4e152c862,0,lahiru,2014-04-09 01:07:50-04:00,['e16173855e7d8cc3bd6fe2c343c6f54c8cb504fb'],56,9,65,1819123,4,0.210526316,0,0,4921
f01ea07ea93f11a329e6253c8f120bf6500b0cdd,0,lahiru,2014-04-09 12:54:26-04:00,['fa32f4dadc4dcadf1732be42b38995c4e152c862'],269,55,324,1819447,3,0.769230769,0,0,4921
8b27819196c28d2baa9a62e239294c75025613e6,0,lahiru,2014-04-10 14:55:57-04:00,['f01ea07ea93f11a329e6253c8f120bf6500b0cdd'],90,53,143,1819590,8,0,0,0,4921
a8d53cdaaefbb9ed72c03e3dcd217619d5bebc40,0,lahiru,2014-04-10 16:27:46-04:00,['8b27819196c28d2baa9a62e239294c75025613e6'],804,872,1676,1821266,15,0.502336449,0,0,4921
848874c967b455a5f3cc1a95a52468c016cdcdcd,0,David Reagan,2014-04-11 13:24:18-04:00,['005c88b227c77cd46186d8fc276cedc9f00eafe3'],0,30,30,1821296,1,,,,4922
a5def09630000299a3cfcf8295c88da9ab4d8af1,0,lahiru,2014-04-11 16:09:35-04:00,['a8d53cdaaefbb9ed72c03e3dcd217619d5bebc40'],184,335,519,1821815,17,0.234375,1,1,4924
594098814e88c06deae3324a1560cbc48776445a,0,Saminda Wijeratne,2014-04-13 16:32:53-07:00,['a5def09630000299a3cfcf8295c88da9ab4d8af1'],1,6,7,1821822,1,0.5,1,1,4924
0e2c10f568f583d886657ad0b536ae62f7fa04ad,0,Saminda Wijeratne,2014-04-13 18:01:11-07:00,['594098814e88c06deae3324a1560cbc48776445a'],133865,0,133865,1955687,875,0.639083296,0.387434767,0.105485659,4924
9c47eec85f9bf56d311f14677cbeaa20b8474c70,1,Saminda Wijeratne,2014-04-13 22:33:09-07:00,['0e2c10f568f583d886657ad0b536ae62f7fa04ad'],0,75861,75861,2031548,544,0.417854262,0.670221983,0.908726958,5468
e488180cb8ce787f0c113062e88f07f3a8b25819,0,Suresh Marru,2014-04-14 10:29:47-04:00,['a5def09630000299a3cfcf8295c88da9ab4d8af1'],2,2,4,2031552,1,,,,5468
43dfd1d82993c529756d37c2a8b3fa5c0e96d6df,0,lahiru,2014-04-14 10:46:50-04:00,['a5def09630000299a3cfcf8295c88da9ab4d8af1'],5,5,10,2031562,2,0,0,1,5468
96aad5226d22d8f1f5539701a7fef32cab701bd6,0,Suresh Marru,2014-04-14 11:28:00-04:00,['e488180cb8ce787f0c113062e88f07f3a8b25819'],0,5,5,2031567,1,,,,5468
bb0f71025ede7e1c9cd5e961f9f2c28fdfeb7834,0,lahiru,2014-04-14 11:46:18-04:00,"['43dfd1d82993c529756d37c2a8b3fa5c0e96d6df', '96aad5226d22d8f1f5539701a7fef32cab701bd6']",2,7,9,2031576,2,,,,5468
b7122a9d21726b145c35df9e0dcdf51feeda0538,0,Saminda Wijeratne,2014-04-14 11:29:25-07:00,"['9c47eec85f9bf56d311f14677cbeaa20b8474c70', 'bb0f71025ede7e1c9cd5e961f9f2c28fdfeb7834']",7,12,19,2031595,4,,,,5468
b1bdbd91829e28ccac9f5d22eb9e28e992aab755,0,lahiru,2014-04-14 15:27:56-04:00,['b7122a9d21726b145c35df9e0dcdf51feeda0538'],14,344,358,2031953,5,0,1,1,5470
3330060ee9832f4c6f7abb111616489be0e34706,0,lahiru,2014-04-14 16:18:05-04:00,['b1bdbd91829e28ccac9f5d22eb9e28e992aab755'],10,6,16,2031969,2,,,,5470
2c186f68374a732ee0b55a5cffd49c94983fdcf7,0,dmreagan,2014-04-14 17:40:17-04:00,['848874c967b455a5f3cc1a95a52468c016cdcdcd'],25,51,76,2032045,2,1,1,1,5470
bc390e74ad5ee3428e7dce049b175d93db3eb82a,0,Suresh Marru,2014-04-14 19:14:49-04:00,['3330060ee9832f4c6f7abb111616489be0e34706'],4,0,4,2032049,1,,,,5470
00ce4a830855a146470ecd53f450ad90768ee046,0,Saminda Wijeratne,2014-04-15 06:30:50-07:00,['bc390e74ad5ee3428e7dce049b175d93db3eb82a'],117,390,507,2032556,9,0,1,1,5475
385871700a3eef48722771d20144535ed80f8529,0,Saminda Wijeratne,2014-04-16 06:13:09-07:00,['00ce4a830855a146470ecd53f450ad90768ee046'],26,50,76,2032632,25,,,,5476
d3fb569bc9eb062fb03c98ad3ee4be961cb8acb3,0,Saminda Wijeratne,2014-04-16 06:18:40-07:00,['385871700a3eef48722771d20144535ed80f8529'],1,1,2,2032634,1,,,,5476
46205e6c87f2011df91d7956a9f2347d63fb6c2f,1,Saminda Wijeratne,2014-04-16 19:06:34-07:00,['d3fb569bc9eb062fb03c98ad3ee4be961cb8acb3'],0,2643,2643,2035277,58,,,,5481
4903770b613e18ac460d8e7f2c78301eb613b9a5,0,Saminda Wijeratne,2014-04-16 19:14:47-07:00,['46205e6c87f2011df91d7956a9f2347d63fb6c2f'],0,2643,2643,2037920,29,,,,5486
03e40302a73f9e2038357902c863914551d78f9a,0,Saminda Wijeratne,2014-04-16 19:15:13-07:00,['4903770b613e18ac460d8e7f2c78301eb613b9a5'],1,1,2,2037922,1,,,,5486
dd7617fa27e5318ac2364c398072d5252f3f8a37,0,Saminda Wijeratne,2014-04-16 19:16:07-07:00,['03e40302a73f9e2038357902c863914551d78f9a'],3,3,6,2037928,2,,,,5486
eeb2c0dc48a2c2a70e86d40c4c6cdc3f446d4085,0,Saminda Wijeratne,2014-04-16 19:22:55-07:00,['dd7617fa27e5318ac2364c398072d5252f3f8a37'],1,34,35,2037963,2,,,,5486
603897c636e7029607ae8c1141150a7b4f2c74a0,0,lahiru,2014-04-17 09:08:14-04:00,['3330060ee9832f4c6f7abb111616489be0e34706'],14,95,109,2038072,6,0.648648649,1,1,5486
9edda85fa19b2cdb919b8762faf2715945346e76,0,lahiru,2014-04-17 09:10:12-04:00,"['603897c636e7029607ae8c1141150a7b4f2c74a0', 'eeb2c0dc48a2c2a70e86d40c4c6cdc3f446d4085']",140,5752,5892,2043964,121,,,,5486
0c0b6d4a6ea0eaddfa220291ee6961964a7c8c34,0,Saminda Wijeratne,2014-04-17 13:18:18-07:00,['eeb2c0dc48a2c2a70e86d40c4c6cdc3f446d4085'],35,103,138,2044102,5,0,0,1,5487
56574dd195e5e91f0486e452677d659966ada89f,0,Saminda Wijeratne,2014-04-17 13:18:40-07:00,"['0c0b6d4a6ea0eaddfa220291ee6961964a7c8c34', '9edda85fa19b2cdb919b8762faf2715945346e76']",14,95,109,2044211,6,,,,5487
20306cd044679cf5d0f61e4832eae02a2ae69e83,0,Saminda Wijeratne,2014-04-18 04:14:02-07:00,['56574dd195e5e91f0486e452677d659966ada89f'],39,81,120,2044331,8,0.176470588,0.176470588,1,5487
d4e3985454656d901244c1a5eb20d5e40bfe0fbc,0,Saminda Wijeratne,2014-04-18 05:23:42-07:00,['20306cd044679cf5d0f61e4832eae02a2ae69e83'],0,322,322,2044653,4,0.837209302,0.837209302,1,5491
3d229e2098a66e672f33d99b4c56253b1e782ff6,0,Saminda Wijeratne,2014-04-18 07:14:47-07:00,['d4e3985454656d901244c1a5eb20d5e40bfe0fbc'],1,1,2,2044655,1,,,,5491
18ee7cd24dc36732ff344c6cab67045c4e1775d1,0,Chathuri Wimalasena,2014-04-18 11:04:26-04:00,['3d229e2098a66e672f33d99b4c56253b1e782ff6'],7,16,23,2044678,4,0.625,1,1,5491
832a7151f2f3427dc56a75207fbb7d4a1d7aa5c1,0,Saminda Wijeratne,2014-04-18 18:57:10-07:00,['18ee7cd24dc36732ff344c6cab67045c4e1775d1'],66,88,154,2044832,5,1,1,0,5492
6fe3d3a5fba05c7d3fd8d6483e02ebcac1fda2a8,0,Saminda Wijeratne,2014-04-19 08:51:19-07:00,['832a7151f2f3427dc56a75207fbb7d4a1d7aa5c1'],8,5,13,2044845,2,1,1,0,5492
3013e74f867c93aa71b9f9dce56e0b8b7b0805cf,0,Saminda Wijeratne,2014-04-21 06:07:57-07:00,['6fe3d3a5fba05c7d3fd8d6483e02ebcac1fda2a8'],0,5,5,2044850,1,,,,5492
67910311d8001429e08b18481ce6cd7293c9f2e0,0,Suresh Marru,2014-04-21 11:21:48-04:00,['3013e74f867c93aa71b9f9dce56e0b8b7b0805cf'],39,54,93,2044943,5,0,0,1,5492
aed31d3eb08c410611ef4a42205bae89a6de923d,0,Saminda Wijeratne,2014-04-22 07:44:30-07:00,['67910311d8001429e08b18481ce6cd7293c9f2e0'],209,561,770,2045713,45,0.839416058,0.839416058,0.96350365,5497
5381d5999caf42dc14b7d288cc1817e5ef3236ce,0,lahiru,2014-04-22 16:40:19-04:00,['56574dd195e5e91f0486e452677d659966ada89f'],40,574,614,2046327,22,0,1,1,5503
f2b5df44482f3cf8912a0582bc0c5696c8839243,0,lahiru,2014-04-22 16:41:57-04:00,"['5381d5999caf42dc14b7d288cc1817e5ef3236ce', 'aed31d3eb08c410611ef4a42205bae89a6de923d']",300,1064,1364,2047691,62,,,,5503
67b44a15c5957baa18ad3cb883a9e31f3fc0b146,1,Saminda Wijeratne,2014-04-22 19:07:28-07:00,['aed31d3eb08c410611ef4a42205bae89a6de923d'],170,433,603,2048294,26,1,0.850574713,0.850574713,5508
49eea6f151b28f55933dc370cbc3f31c987eb030,0,Saminda Wijeratne,2014-04-22 19:08:02-07:00,"['67b44a15c5957baa18ad3cb883a9e31f3fc0b146', 'f2b5df44482f3cf8912a0582bc0c5696c8839243']",40,574,614,2048908,22,,,,5508
71de72f834907fdcc020909734d92c6f148b4552,0,lahiru,2014-04-23 09:47:01-04:00,['49eea6f151b28f55933dc370cbc3f31c987eb030'],20,24,44,2048952,1,0,0,1,5508
dd3b3f1945ed2e0d2a65bb27f1d3214ac899b906,0,Saminda Wijeratne,2014-04-23 09:28:06-07:00,['49eea6f151b28f55933dc370cbc3f31c987eb030'],28,28,56,2049008,9,0.888888889,0.888888889,0.888888889,5508
b4e41646f946817b6baee5cbddc71c3984229837,0,Saminda Wijeratne,2014-04-23 09:29:03-07:00,"['dd3b3f1945ed2e0d2a65bb27f1d3214ac899b906', '71de72f834907fdcc020909734d92c6f148b4552']",20,24,44,2049052,1,,,,5508
ede589806a5af9d17df6b4899c67d7e17cbfb513,0,Saminda Wijeratne,2014-04-23 10:07:58-07:00,['b4e41646f946817b6baee5cbddc71c3984229837'],5,7,12,2049064,1,0,0,1,5508
ab89c88305319160e34f2c4d6cdb91826e66f372,0,Chathuri Wimalasena,2014-04-23 13:39:38-04:00,['ede589806a5af9d17df6b4899c67d7e17cbfb513'],3,5,8,2049072,1,0,0,1,5508
d2814f66f910e2db7d1a7a579639d90e8104b051,0,Saminda Wijeratne,2014-04-23 11:30:18-07:00,['ab89c88305319160e34f2c4d6cdb91826e66f372'],0,1,1,2049073,1,0,1,1,5508
0364b6540512f295a123532520c5444c560bc9b2,0,Saminda Wijeratne,2014-04-23 12:05:40-07:00,['d2814f66f910e2db7d1a7a579639d90e8104b051'],5,7,12,2049085,2,0,0,0.2,5508
b02308493b0d9c9497ce25fac70da0aef910a822,0,lahiru,2014-04-23 15:42:00-04:00,['0364b6540512f295a123532520c5444c560bc9b2'],1293,1226,2519,2051604,115,0.893939394,0.284090909,0.852272727,5514
34a8147e4a6980d6fbbc59f7a8440d6797da9e1a,0,lahiru,2014-04-23 16:47:21-04:00,['b02308493b0d9c9497ce25fac70da0aef910a822'],292,121,413,2052017,11,0.036144578,0.036144578,0.204819277,5514
9c75294b32bad060bee770cb59f1f1a9f024392d,0,dmreagan,2014-04-23 17:22:38-04:00,['2c186f68374a732ee0b55a5cffd49c94983fdcf7'],0,360,360,2052377,4,,,,5518
b6c7c41e3ea54b625c695b54d525fa5d11c5f2be,0,lahiru,2014-04-23 23:19:30-04:00,['34a8147e4a6980d6fbbc59f7a8440d6797da9e1a'],85,635,720,2053097,17,0.084639498,0.394984326,0.987460815,5522
a6245bd58c85aff2c81bb19f6d8c9c89c0b7950c,0,lahiru,2014-04-23 23:35:04-04:00,['b6c7c41e3ea54b625c695b54d525fa5d11c5f2be'],24,62,86,2053183,2,0,0,1,5522
740bf8cd88c95ee4ba3327a98a825ffd41084218,0,Saminda Wijeratne,2014-04-24 01:47:06-07:00,['a6245bd58c85aff2c81bb19f6d8c9c89c0b7950c'],76,320,396,2053579,4,0.7421875,1,0.9296875,5524
3361df335ac2b3819ac916ec17c12f47212efaac,0,lahiru,2014-04-24 09:53:09-04:00,['a6245bd58c85aff2c81bb19f6d8c9c89c0b7950c'],986,838,1824,2055403,22,1,0,0,5531
2f1418691be11bc48f0f456075c27745f70b054b,0,lahiru,2014-04-24 09:53:51-04:00,"['3361df335ac2b3819ac916ec17c12f47212efaac', '740bf8cd88c95ee4ba3327a98a825ffd41084218']",76,320,396,2055799,4,,,,5531
e524d7ee827d859647c69b3fbf6ca1c3ec9fcfc8,0,lahiru,2014-04-24 09:59:12-04:00,['2f1418691be11bc48f0f456075c27745f70b054b'],455,0,455,2056254,4,0.368200837,0.368200837,0.054393305,5531
8c6a9a5a24764026fd05f2371370e6177c750634,0,lahiru,2014-04-24 14:24:15-04:00,['e524d7ee827d859647c69b3fbf6ca1c3ec9fcfc8'],31,22,53,2056307,5,,,,5531
55ff3aec6279341dd74915b0048b45ab2704cb0e,0,Saminda Wijeratne,2014-04-24 13:01:15-07:00,['740bf8cd88c95ee4ba3327a98a825ffd41084218'],7,13,20,2056327,2,1,1,0.666666667,5531
053ce56cf31a12a7dd090c2e993d21e8a0917a19,0,Saminda Wijeratne,2014-04-24 13:02:07-07:00,"['55ff3aec6279341dd74915b0048b45ab2704cb0e', '8c6a9a5a24764026fd05f2371370e6177c750634']",1472,860,2332,2058659,31,,,,5531
13b505aee64d7d91319038b6f6baa410f8aaff9d,0,lahiru,2014-04-24 16:51:18-04:00,['8c6a9a5a24764026fd05f2371370e6177c750634'],622,1603,2225,2060884,59,1,1,1,5545
7be9daea61cb90f29127b80c4ed2aaa33b3b034d,0,lahiru,2014-04-24 16:51:41-04:00,"['13b505aee64d7d91319038b6f6baa410f8aaff9d', '053ce56cf31a12a7dd090c2e993d21e8a0917a19']",7,13,20,2060904,2,,,,5545
ec1d2b84598ade42ff697fb04ab7d2480add8a43,0,lahiru,2014-04-24 16:54:46-04:00,['7be9daea61cb90f29127b80c4ed2aaa33b3b034d'],0,12,12,2060916,2,,,,5545
989a1fd5d4e62135a16c87531c1698f8e3e65304,0,Nipun Udara,2014-04-26 10:55:11+05:18,['ec1d2b84598ade42ff697fb04ab7d2480add8a43'],0,1162,1162,2062078,12,0.516363636,0.894545455,1,5557
cb0db780efa246a9cd4756223e41659823e1303a,0,Nipun Udara,2014-04-26 11:03:04+05:18,['989a1fd5d4e62135a16c87531c1698f8e3e65304'],613,2,615,2062693,8,0.483636364,0.105454545,0,5557
216e2d6ce2022304049df35f2d287dcaa35ecdab,0,Nipun Udara,2014-04-26 15:16:00+05:18,['cb0db780efa246a9cd4756223e41659823e1303a'],1,1,2,2062695,1,,,,5557
761b81e9bc4a157be2b72cd494dcb7eab16ef4ae,0,Nipun Udara,2014-04-26 19:46:52+05:18,['216e2d6ce2022304049df35f2d287dcaa35ecdab'],23,0,23,2062718,1,,,,5557
1852d7923251a93db5b40d4bc33d08c297fb92c1,0,Nipun Udara,2014-04-27 06:05:46+05:18,['761b81e9bc4a157be2b72cd494dcb7eab16ef4ae'],0,5,5,2062723,1,,,,5557
9a7873094ec2238f2e01fe0a001a556b749771fe,0,Nipun Udara,2014-04-27 08:27:16+05:18,['1852d7923251a93db5b40d4bc33d08c297fb92c1'],50,595,645,2063368,17,,,,5563
3a4dfd047e3da02f669e65f940d72ebf55d27125,0,Sachith Withana,2014-04-27 09:18:03-07:00,['ec1d2b84598ade42ff697fb04ab7d2480add8a43'],0,11,11,2063379,1,,,,5563
61a312a99e47881efe8c641acad9849530e579bd,0,Chathuri Wimalasena,2014-04-28 11:33:08-04:00,['3a4dfd047e3da02f669e65f940d72ebf55d27125'],1,35,36,2063415,2,0.8,0.8,1,5563
d0ff925b2221897dea5bc9d98822130d875c8af0,0,lahiru,2014-04-28 12:05:47-04:00,['9a7873094ec2238f2e01fe0a001a556b749771fe'],1,1,2,2063417,1,,,,5563
a2307f936baf2a6507ec8300e2c727bd19b6deeb,0,lahiru,2014-04-28 12:09:27-04:00,"['61a312a99e47881efe8c641acad9849530e579bd', 'd0ff925b2221897dea5bc9d98822130d875c8af0']",51,1129,1180,2064597,30,,,,5563
bca756a48b934afb1ce9f7001a8d60c7445e898b,0,Chathuri Wimalasena,2014-04-28 13:47:54-04:00,['a2307f936baf2a6507ec8300e2c727bd19b6deeb'],118,142,260,2064857,8,0,1,1,5563
c1f69ae2901dc88d9ceb6d49ba5d77fbaf3ecc4b,0,lahiru,2014-04-28 14:08:59-04:00,['a2307f936baf2a6507ec8300e2c727bd19b6deeb'],1,6,7,2064864,2,,,,5563
64c6657e7c73c26ff74789d72a80236af6692cc5,0,lahiru,2014-04-28 14:09:21-04:00,"['c1f69ae2901dc88d9ceb6d49ba5d77fbaf3ecc4b', 'bca756a48b934afb1ce9f7001a8d60c7445e898b']",118,142,260,2065124,8,,,,5563
e218fc08e28ffd5a27defa041bbf9785c71e730d,0,lahiru,2014-04-29 09:08:56-04:00,['64c6657e7c73c26ff74789d72a80236af6692cc5'],1384,2,1386,2066510,9,0.378504673,0.336448598,0.154205607,5563
e8453e231f53f9984865cfcaaf0614f0f49dc91b,0,dmreagan,2014-04-29 13:17:31-04:00,['9c75294b32bad060bee770cb59f1f1a9f024392d'],0,232,232,2066742,3,0,0,1,5565
418480cfc72a9023edf0fa65bcb756e27698ecdc,0,marie-iub,2014-04-29 15:01:11-04:00,['e8453e231f53f9984865cfcaaf0614f0f49dc91b'],0,104,104,2066846,1,,,,5566
596a1e995546153e506cb46eaacf87a6cd1c0eda,0,raminder,2014-04-29 16:49:08-04:00,['e218fc08e28ffd5a27defa041bbf9785c71e730d'],11,11,22,2066868,1,1,1,0,5566
322fc06bf5c05454ddf15f1a7623c06d42861122,0,David Reagan,2014-04-30 12:26:14-04:00,['418480cfc72a9023edf0fa65bcb756e27698ecdc'],18,22,40,2066908,4,,,,5566
8f8212e36b19170df28a092181189cbd6f99ad27,0,marie-iub,2014-04-30 13:58:50-04:00,['418480cfc72a9023edf0fa65bcb756e27698ecdc'],0,106,106,2067014,1,,,,5567
d9d08146f53cd06e7cceb1821f07874dda04ead3,0,marie-iub,2014-04-30 13:59:59-04:00,"['8f8212e36b19170df28a092181189cbd6f99ad27', '322fc06bf5c05454ddf15f1a7623c06d42861122']",18,22,40,2067054,4,,,,5567
42b29f3ffca518c0f831fc37712b62408c103e1b,0,David Reagan,2014-04-30 17:33:41-04:00,['d9d08146f53cd06e7cceb1821f07874dda04ead3'],2,578,580,2067634,5,0,0,1,5571
d4f7930a66a7396ce2aed54af8fcc34da945607e,0,marie-iub,2014-05-01 11:14:24-04:00,['42b29f3ffca518c0f831fc37712b62408c103e1b'],0,94,94,2067728,1,,,,5572
0eabb937288c9c8341d80405d132feca777fc335,0,raminder,2014-05-01 12:00:24-04:00,['596a1e995546153e506cb46eaacf87a6cd1c0eda'],2,6,8,2067736,1,0,1,1,5572
553caa0878fd8c16816583549d573b0c9257cee7,0,lahiru,2014-05-01 14:28:39-04:00,['0eabb937288c9c8341d80405d132feca777fc335'],1359,3922,5281,2073017,151,0,0,0,5624
b203064dfa23e9e5cba0e9716327f398a2595cbf,0,lahiru,2014-05-01 16:50:56-04:00,['553caa0878fd8c16816583549d573b0c9257cee7'],59,80,139,2073156,10,0,0,1,5624
0da59822c2a2736c045e1b16493d20fde54d19ad,0,lahiru,2014-05-01 17:40:10-04:00,['b203064dfa23e9e5cba0e9716327f398a2595cbf'],5,17,22,2073178,4,0.833333333,0.833333333,1,5624
9bb8c2befdfb242706c6bfe28e28b40e91227ff5,0,lahiru,2014-05-05 10:44:07-04:00,['0da59822c2a2736c045e1b16493d20fde54d19ad'],261,335,596,2073774,51,,,,5624
49b6987f36dcde718b07fb22cc8055a7178f5035,0,lahiru,2014-05-05 10:49:13-04:00,['9bb8c2befdfb242706c6bfe28e28b40e91227ff5'],61,28,89,2073863,23,,,,5624
6209ee096e2dea80863cabaaad6acce6f2910ee9,0,lahiru,2014-05-05 11:06:59-04:00,['49b6987f36dcde718b07fb22cc8055a7178f5035'],11,11,22,2073885,11,,,,5624
fc70a076a82edeccf09f64d5a2d00fe7bbae0b63,0,David Reagan,2014-05-05 11:44:35-04:00,['d4f7930a66a7396ce2aed54af8fcc34da945607e'],0,7,7,2073892,1,,,,5624
e38a9010fca144468a007a6b9f40a0d0f6d19046,0,David Reagan,2014-05-05 11:53:13-04:00,['fc70a076a82edeccf09f64d5a2d00fe7bbae0b63'],0,1,1,2073893,1,,,,5624
39370c526b5acf13e31b2f9136605a93bf84b939,0,lahiru,2014-05-05 11:59:49-04:00,['6209ee096e2dea80863cabaaad6acce6f2910ee9'],509,575,1084,2074977,142,0.77,0.77,0.9,5625
14c1841ca20d08bc1e9da254dbce5cb8a7266b26,0,lahiru,2014-05-05 17:06:10-04:00,['39370c526b5acf13e31b2f9136605a93bf84b939'],139,123,262,2075239,18,1,1,0.769230769,5625
9be225ac4013ffea801b7d1b516fc09f830740f4,0,raminder,2014-05-06 10:27:16-04:00,['0eabb937288c9c8341d80405d132feca777fc335'],29,98,127,2075366,3,0,0,0.229166667,5625
ee79b70b6ddc71ac8999ca6ccea240555ce5b967,0,raminder,2014-05-06 10:37:00-04:00,"['9be225ac4013ffea801b7d1b516fc09f830740f4', '14c1841ca20d08bc1e9da254dbce5cb8a7266b26']",2360,5047,7407,2082773,231,,,,5625
c11651bc5ca01aade5db78035895da2109a38dd5,0,raminder,2014-05-06 10:58:15-04:00,['ee79b70b6ddc71ac8999ca6ccea240555ce5b967'],6,0,6,2082779,1,,,,5625
70846f388c1af98bacbc1ddb6c937ba35d874045,0,raminder,2014-05-06 11:32:11-04:00,['c11651bc5ca01aade5db78035895da2109a38dd5'],1,15,16,2082795,1,,,,5625
04269ff81f40b50198aea00b7b919d789625e18a,0,raminder,2014-05-06 11:39:33-04:00,['70846f388c1af98bacbc1ddb6c937ba35d874045'],88,88,176,2082971,17,,,,5625
a9e022b9aed2e7bc3c79e45c1eb6cd2d8cef5fd5,0,lahiru,2014-05-06 12:04:38-04:00,['04269ff81f40b50198aea00b7b919d789625e18a'],32,46,78,2083049,8,1,0,1,5625
79750b7b51d740d0a2b00cee859a3462e6df4110,1,Chathuri Wimalasena,2014-05-06 13:25:59-04:00,['a9e022b9aed2e7bc3c79e45c1eb6cd2d8cef5fd5'],163,275,438,2083487,37,0.516129032,0.870967742,0.887096774,5626
7ec932b5e48b9b1c42355ffc42abada59bed1eb3,1,lahiru,2014-05-06 13:42:40-04:00,['a9e022b9aed2e7bc3c79e45c1eb6cd2d8cef5fd5'],95,102,197,2083684,10,0,0,0,5626
86f46412e885b70594a6d9ce22fe266ad0f5f892,0,lahiru,2014-05-06 13:43:01-04:00,"['7ec932b5e48b9b1c42355ffc42abada59bed1eb3', '79750b7b51d740d0a2b00cee859a3462e6df4110']",163,275,438,2084122,37,,,,5626
96fed6ec6a32853e9b7a561e32c06e3ee122fe86,0,Chathuri Wimalasena,2014-05-06 14:25:06-04:00,['86f46412e885b70594a6d9ce22fe266ad0f5f892'],132,159,291,2084413,16,0.272727273,0.272727273,1,5627
3132bf02da0d242fbc472bde89301322d88da5a9,0,lahiru,2014-05-06 14:55:47-04:00,['96fed6ec6a32853e9b7a561e32c06e3ee122fe86'],1,449,450,2084863,4,0.306122449,1,0.795918367,5630
b7fea71124ca5d9080b2f198c698d77205af1e80,0,raminder,2014-05-06 15:55:47-04:00,['3132bf02da0d242fbc472bde89301322d88da5a9'],3,2,5,2084868,1,,,,5630
bee2dac848e921c70e2190d190c929c29a668bf8,0,raminder,2014-05-06 17:02:23-04:00,['b7fea71124ca5d9080b2f198c698d77205af1e80'],12,21,33,2084901,1,0,0,1,5630
c1c82374696e9b604c69d25fb0807849dba40388,0,marie-iub,2014-05-07 10:08:43-04:00,['e38a9010fca144468a007a6b9f40a0d0f6d19046'],24,74,98,2084999,1,,,,5630
93db370991fc8a67af17312f8d9e00bb131078c0,0,marie-iub,2014-05-07 10:41:49-04:00,['c1c82374696e9b604c69d25fb0807849dba40388'],4,6,10,2085009,4,,,,5630
956e8d5949f5714273ff1daeb8545367e7aca5d7,0,lahiru,2014-05-07 11:25:51-04:00,['bee2dac848e921c70e2190d190c929c29a668bf8'],0,43,43,2085052,2,1,1,0,5631
f11b02de9f5b4ea58edeb6a72fcac83ec2402cef,0,lahiru,2014-05-07 12:16:45-04:00,['956e8d5949f5714273ff1daeb8545367e7aca5d7'],1,1,2,2085054,1,0,1,1,5631
4b4bd903a4cb8367ad6d9e32430ce23ffc062cc2,0,Chathuri Wimalasena,2014-05-08 13:44:36-04:00,['f11b02de9f5b4ea58edeb6a72fcac83ec2402cef'],270,340,610,2085664,4,0,0,1,5631
fd93ec3cf06bdfcc573f4107cccbe8123af6b251,0,raminder,2014-05-08 13:56:41-04:00,['93db370991fc8a67af17312f8d9e00bb131078c0'],49,74,123,2085787,1,,,,5631
4e76188742cac630d2d9794285d6d4466963abbd,0,raminder,2014-05-08 14:10:19-04:00,['fd93ec3cf06bdfcc573f4107cccbe8123af6b251'],4,4,8,2085795,1,,,,5631
501b43de66a7673f0742db24dbfd21c8a74b6abc,0,marie-iub,2014-05-08 14:20:03-04:00,['4e76188742cac630d2d9794285d6d4466963abbd'],8,11,19,2085814,3,,,,5631
6c1fa8359e811b409bdb5498a06077a16006420c,0,raminder,2014-05-08 14:37:23-04:00,['501b43de66a7673f0742db24dbfd21c8a74b6abc'],1,4,5,2085819,1,,,,5631
2fce90ee80f621fa0ccc360b45d81d67ca2d3bc9,0,Suresh Marru,2014-05-08 15:53:10-04:00,['4b4bd903a4cb8367ad6d9e32430ce23ffc062cc2'],31,43,74,2085893,1,,,,5631
6dbe34e972b8be126429fe1e8c08fc0b8c2b4658,0,Suresh Marru,2014-05-08 17:05:17-04:00,['2fce90ee80f621fa0ccc360b45d81d67ca2d3bc9'],3,8,11,2085904,1,,,,5631
cd8250db1e8fe0544c339cce9b1ef0dc9dd588ff,0,Saminda Wijeratne,2014-05-09 07:36:40-07:00,['6dbe34e972b8be126429fe1e8c08fc0b8c2b4658'],0,92,92,2085996,1,,,,5631
483a0f5294308a7afe12e3d6d48e52bb672a52e8,0,Saminda Wijeratne,2014-05-09 08:02:27-07:00,['cd8250db1e8fe0544c339cce9b1ef0dc9dd588ff'],35,11,46,2086042,1,,,,5631
011ec5e7a085f1cbcbb91802d2d43407d13a3016,0,Saminda Wijeratne,2014-05-11 23:43:36-07:00,['483a0f5294308a7afe12e3d6d48e52bb672a52e8'],0,392,392,2086434,2,,,,5633
c18a52faa317e63e06982fc741df75b3369218f6,0,lahiru,2014-05-12 13:52:19-04:00,['011ec5e7a085f1cbcbb91802d2d43407d13a3016'],313,2,315,2086749,7,1,1,1,5633
6328beae7e0b9e05c2dc5a3d7f0e68895435e1c9,0,Suresh Marru,2014-05-13 10:23:10-04:00,['c18a52faa317e63e06982fc741df75b3369218f6'],2,875,877,2087626,2,0.789380531,0.953982301,0.987610619,5633
3ba8cfa9cf344ddd22e8e8905e86b6854305a71d,1,Suresh Marru,2014-05-13 10:45:36-04:00,['6328beae7e0b9e05c2dc5a3d7f0e68895435e1c9'],16,2203,2219,2089845,11,0.372891566,0.43373494,0.952409639,5633
5e6040c6175df6c975723f2489af2f52d0c46228,0,Chathuri Wimalasena,2014-05-13 12:11:42-04:00,['3ba8cfa9cf344ddd22e8e8905e86b6854305a71d'],29,36,65,2089910,2,1,1,0,5633
b2e3fd98a3c96d90ce04def64939ca7e8f656c2e,0,lahiru,2014-05-13 16:41:17-04:00,['3ba8cfa9cf344ddd22e8e8905e86b6854305a71d'],11,6,17,2089927,3,1,1,0,5633
a5e696770636e9dffc7c68da9528d69b8aa2bd91,0,lahiru,2014-05-13 16:41:38-04:00,"['b2e3fd98a3c96d90ce04def64939ca7e8f656c2e', '5e6040c6175df6c975723f2489af2f52d0c46228']",29,36,65,2089992,2,,,,5633
131d967dbfadd53b3ae0222c9fff23513928622a,0,Saminda Wijeratne,2014-05-14 07:33:15-07:00,['a5e696770636e9dffc7c68da9528d69b8aa2bd91'],3,172,175,2090167,2,,,,5634
71477800f41c38e349e3899c29fa317a4acec287,0,Chathuri Wimalasena,2014-05-14 12:00:08-04:00,['131d967dbfadd53b3ae0222c9fff23513928622a'],220,74,294,2090461,16,1,1,0.2,5634
f05dd0fb7305aae98c47e427a9926f85e3c3e882,0,lahiru,2014-05-14 12:11:42-04:00,['a5e696770636e9dffc7c68da9528d69b8aa2bd91'],20,94,114,2090575,12,0.655172414,0.689655172,0.724137931,5635
d76c9d57fae4574d47624dddeadae28e444b0317,0,lahiru,2014-05-14 12:12:18-04:00,"['f05dd0fb7305aae98c47e427a9926f85e3c3e882', '71477800f41c38e349e3899c29fa317a4acec287']",223,246,469,2091044,18,,,,5635
22d0a6f49547a9143dc7ae68b8ffff4d8e18786f,1,Chathuri Wimalasena,2014-05-14 13:51:34-04:00,['d76c9d57fae4574d47624dddeadae28e444b0317'],450,322,772,2091816,16,1,1,0,5635
7d0ce7d56fbe85c1160ce8a54e15d96a906a5169,0,Chathuri Wimalasena,2014-05-14 13:53:19-04:00,['22d0a6f49547a9143dc7ae68b8ffff4d8e18786f'],0,26903,26903,2118719,16,0.497337371,0.587396888,0.982144722,5651
88e16cf4e679adb51946181bc62caa6024ed83eb,1,Chathuri Wimalasena,2014-05-14 15:34:06-04:00,['7d0ce7d56fbe85c1160ce8a54e15d96a906a5169'],141,158,299,2119018,14,0.5,0.833333333,1,5651
abc9134085c89c4857d4b698780ccbba9740957a,0,David Reagan,2014-05-14 17:58:06-04:00,['6c1fa8359e811b409bdb5498a06077a16006420c'],36,68,104,2119122,4,0,0,1,5651
bf702a5d97ce14c46d29fa01cdacf82aa191459d,0,Chathuri Wimalasena,2014-05-14 19:16:15-04:00,['88e16cf4e679adb51946181bc62caa6024ed83eb'],139,147,286,2119408,8,0,0.909090909,1,5651
8790244099a59ab8789ce5eb0176c9ad9a270295,0,Saminda Wijeratne,2014-05-15 00:30:53-07:00,['bf702a5d97ce14c46d29fa01cdacf82aa191459d'],172,0,172,2119580,1,,,,5651
c1a1bad5964bda60d0d3a748eccefb60336880a5,0,samindaw,2014-05-15 08:08:50-07:00,['8790244099a59ab8789ce5eb0176c9ad9a270295'],730,30803,31533,2151113,35,0.336473934,0.438824941,0.947602329,5679
da941018b6752e44b4bef4789d0b8bfa5470150c,1,Chathuri Wimalasena,2014-05-15 11:17:14-04:00,['8790244099a59ab8789ce5eb0176c9ad9a270295'],42,89,131,2151244,6,0.607142857,0.714285714,1,5679
84294a7b9e684d5990fb54de3b64c3f97ab4175b,0,Chathuri Wimalasena,2014-05-15 11:17:42-04:00,"['da941018b6752e44b4bef4789d0b8bfa5470150c', 'c1a1bad5964bda60d0d3a748eccefb60336880a5']",730,30803,31533,2182777,35,,,,5679
939f7bea750df401dbd006cc0759fffe5727b0d6,1,Chathuri Wimalasena,2014-05-15 11:42:42-04:00,['84294a7b9e684d5990fb54de3b64c3f97ab4175b'],15,60,75,2182852,1,0.311111111,0.866666667,1,5679
12e28691874d8204985ecc1613bf0c2c4ab4d947,0,raminder,2014-05-15 13:33:25-04:00,['abc9134085c89c4857d4b698780ccbba9740957a'],2,5,7,2182859,2,,,,5679
aa31eff99791102249463f7103a9d1f2bb2053da,0,raminder,2014-05-15 13:38:52-04:00,['12e28691874d8204985ecc1613bf0c2c4ab4d947'],0,5409,5409,2188268,2,0.291104051,0.512907069,1,5681
d48d67e24ef0d2eb30ce2546115a2487286f471f,0,raminder,2014-05-15 13:39:35-04:00,['aa31eff99791102249463f7103a9d1f2bb2053da'],84,334,418,2188686,3,0.377118644,0.673728814,1,5681
3d76388b55b47c3a8e67f4c7a008525502e4c340,0,Chathuri Wimalasena,2014-05-15 14:34:07-04:00,['939f7bea750df401dbd006cc0759fffe5727b0d6'],7,28,35,2188721,4,0,0.818181818,1,5681
a169a28a7a4c80a5834a033daad8530bce55dd53,0,David Reagan,2014-05-16 10:40:16-04:00,['d48d67e24ef0d2eb30ce2546115a2487286f471f'],11,11,22,2188743,2,,,,5681
37dea65f9d151315ca2431ee50fd578880cedfb8,0,David Reagan,2014-05-16 10:56:36-04:00,['a169a28a7a4c80a5834a033daad8530bce55dd53'],7,12,19,2188762,2,1,1,0,5681
e9c0b4d9e39bed9e1540456a77597dae765cd2d4,0,lahiru,2014-05-16 11:07:23-04:00,['3d76388b55b47c3a8e67f4c7a008525502e4c340'],0,17,17,2188779,1,,,,5681
63764cbb57e48ba720494320a8c60bb4bef5d57d,0,David Reagan,2014-05-16 11:12:26-04:00,['37dea65f9d151315ca2431ee50fd578880cedfb8'],75,88,163,2188942,1,,,,5681
23628a6d953b8ddc1d8bf06cef07b8b01eef9626,0,Chathuri Wimalasena,2014-05-16 11:20:54-04:00,['e9c0b4d9e39bed9e1540456a77597dae765cd2d4'],235,899,1134,2190076,12,0.309124767,0.106145251,0.962756052,5681
a0c369ae81fbff195252496fa91c353bf46129b4,0,Chathuri Wimalasena,2014-05-16 11:37:10-04:00,['23628a6d953b8ddc1d8bf06cef07b8b01eef9626'],0,1048,1048,2191124,2,0.546003017,0.736048265,1,5683
6edddf27bfe7a9ef8019a77d242f5756203f21b9,0,Saminda Wijeratne,2014-05-16 10:04:45-07:00,['8790244099a59ab8789ce5eb0176c9ad9a270295'],0,1,1,2191125,1,,,,5683
38f12a05ed9bb50fe40108d7f159b45bb55f38ec,0,Saminda Wijeratne,2014-05-16 10:05:11-07:00,"['6edddf27bfe7a9ef8019a77d242f5756203f21b9', 'a0c369ae81fbff195252496fa91c353bf46129b4']",1026,32941,33967,2225092,55,,,,5683
f9f173cd4435075e85d9aeeb8eb8ed2cc4dfa55a,0,Chathuri Wimalasena,2014-05-16 14:05:26-04:00,['38f12a05ed9bb50fe40108d7f159b45bb55f38ec'],266,1508,1774,2226866,15,0.44180791,0.572881356,1,5684
0317c4a6337a9da7349572ce597c57e40a580213,0,Chathuri Wimalasena,2014-05-16 16:02:12-04:00,['f9f173cd4435075e85d9aeeb8eb8ed2cc4dfa55a'],9191,720,9911,2236777,27,0.618736383,0.559549746,0.002723312,5684
5cded24a2d63679711b5bce9210dd7be02c89640,0,marpierc,2014-05-16 16:36:36-04:00,['63764cbb57e48ba720494320a8c60bb4bef5d57d'],0,91,91,2236868,1,,,,5685
692bc6bb37108f625336fb8dbf00154c4fefa24f,0,marpierc,2014-05-16 16:59:44-04:00,['5cded24a2d63679711b5bce9210dd7be02c89640'],1,0,1,2236869,1,,,,5685
2608266edc4cf1e6573872b009ca5bf0b0b70443,0,marpierc,2014-05-16 17:09:02-04:00,['692bc6bb37108f625336fb8dbf00154c4fefa24f'],1,1,2,2236871,1,,,,5685
b9eb7a95028c40674b2b047ad631bd820055be7e,1,Chathuri Wimalasena,2014-05-19 10:54:41-04:00,['0317c4a6337a9da7349572ce597c57e40a580213'],1,491,492,2237363,6,,,,5690
5632de388b2be1023f8082f2858cfaa2f16a4bfd,0,lahiru,2014-05-19 11:46:04-04:00,['0317c4a6337a9da7349572ce597c57e40a580213'],1677,1535,3212,2240575,34,0,0,0,5690
6f7d8244b527d936ca7c620bb8133f3c6a2e771d,0,lahiru,2014-05-19 11:46:23-04:00,"['5632de388b2be1023f8082f2858cfaa2f16a4bfd', 'b9eb7a95028c40674b2b047ad631bd820055be7e']",1,491,492,2241067,6,,,,5690
318886749836904a654813df8abd80b053c0313a,0,marie-iub,2014-05-19 13:11:10-04:00,['2608266edc4cf1e6573872b009ca5bf0b0b70443'],5,5,10,2241077,1,,,,5690
63ff50ceec15f99cbbad0087f82ed60969703776,1,Chathuri Wimalasena,2014-05-19 14:18:18-04:00,['6f7d8244b527d936ca7c620bb8133f3c6a2e771d'],35,1501,1536,2242613,26,0.949056604,1,0.981132075,5710
6cb07adb3cb887c1ebec486b30ac97422a0af1c9,0,marpierc,2014-05-19 15:41:23-04:00,['318886749836904a654813df8abd80b053c0313a'],7,9,16,2242629,1,,,,5710
400fa456622383bdb17ef69bc9c017028ff1b30e,0,marpierc,2014-05-19 17:00:52-04:00,['6cb07adb3cb887c1ebec486b30ac97422a0af1c9'],5,0,5,2242634,1,,,,5710
1fe6d45c92012c36ba6cf328e0a4aad7c80850c3,0,marpierc,2014-05-19 17:03:05-04:00,['400fa456622383bdb17ef69bc9c017028ff1b30e'],2,2,4,2242638,1,,,,5710
a6773c82ad7269067a5853fdc9845079e6c75899,0,marpierc,2014-05-19 17:03:55-04:00,['1fe6d45c92012c36ba6cf328e0a4aad7c80850c3'],1,1,2,2242640,1,,,,5710
3049a0b17442ee0d906aa241f84d3d31601987ce,0,Saminda Wijeratne,2014-05-20 06:18:03-07:00,['63ff50ceec15f99cbbad0087f82ed60969703776'],7,7,14,2242654,2,,,,5710
23c118418520c64a24606c3978b20e57465c35c0,0,samindaw,2014-05-20 06:22:49-07:00,['3049a0b17442ee0d906aa241f84d3d31601987ce'],715,1128,1843,2244497,15,0.286135693,0.395280236,0.926253687,5710
8973b88d06230eecf01bfdcf80f1bc51b78bcb2a,0,marie-iub,2014-05-20 11:07:31-04:00,['a6773c82ad7269067a5853fdc9845079e6c75899'],3,221,224,2244721,2,,,,5711
2b87aa240bb5cfc663038e7de276a2dd71fb1eb0,0,raminder,2014-05-20 11:41:41-04:00,['d48d67e24ef0d2eb30ce2546115a2487286f471f'],2,2,4,2244725,2,,,,5711
100562d349a9d12ad0e1e31bb8f0676bed03e117,0,raminder,2014-05-20 11:45:21-04:00,"['2b87aa240bb5cfc663038e7de276a2dd71fb1eb0', '8973b88d06230eecf01bfdcf80f1bc51b78bcb2a']",106,429,535,2245260,9,,,,5711
a40931641a9d39f753500abec1a0e478a6826d68,0,marpierc,2014-05-20 11:59:46-04:00,['a6773c82ad7269067a5853fdc9845079e6c75899'],214,0,214,2245474,2,,,,5711
054093f369dff258f9c3782a2d1bf165908be881,0,Chathuri Wimalasena,2014-05-20 11:59:55-04:00,['23c118418520c64a24606c3978b20e57465c35c0'],24,138,162,2245636,2,0,0,1,5711
44ebc62bb36a5fbd240a62a5a379225ded0c6917,0,marpierc,2014-05-20 12:00:11-04:00,"['a40931641a9d39f753500abec1a0e478a6826d68', '100562d349a9d12ad0e1e31bb8f0676bed03e117']",4,222,226,2245862,3,,,,5711
ddf262d3d344696707f1fb7a83597709736454d1,0,Chathuri Wimalasena,2014-05-20 12:26:09-04:00,['054093f369dff258f9c3782a2d1bf165908be881'],1,44,45,2245907,1,0,0,1,5711
24519d344f40e5e5a42f34ce6b9abe8975bf8f05,0,Chathuri Wimalasena,2014-05-20 12:47:45-04:00,['ddf262d3d344696707f1fb7a83597709736454d1'],8,19,27,2245934,1,0,0.090909091,1,5711
dab61520eec092c786a859d03a295223a350bfeb,1,Chathuri Wimalasena,2014-05-20 14:27:47-04:00,['24519d344f40e5e5a42f34ce6b9abe8975bf8f05'],1,1,2,2245936,1,,,,5711
6bb880a90fa2aa508d17a9da547225a6e7c6610d,0,lahiru,2014-05-20 15:14:01-04:00,['dab61520eec092c786a859d03a295223a350bfeb'],86,93,179,2246115,26,0,1,1,5711
2710f6e3aab71af1803d79ad8b77d4432a356d05,0,lahiru,2014-05-20 15:15:30-04:00,['6bb880a90fa2aa508d17a9da547225a6e7c6610d'],0,45,45,2246160,1,1,1,0,5712
af312c32e4f3daf994c3c1db30a586bc33849524,0,Saminda Wijeratne,2014-05-20 22:38:03-07:00,['23c118418520c64a24606c3978b20e57465c35c0'],1,17,18,2246178,2,,,,5712
e25c54174aaaa628214fb21826cc827bd7f391bb,0,Saminda Wijeratne,2014-05-20 22:41:11-07:00,['af312c32e4f3daf994c3c1db30a586bc33849524'],0,463,463,2246641,1,0.350574713,0.902298851,1,5713
029cfac4077edb65f2ea4dc122d86af201bdb5f0,0,Saminda Wijeratne,2014-05-20 22:41:17-07:00,"['e25c54174aaaa628214fb21826cc827bd7f391bb', '2710f6e3aab71af1803d79ad8b77d4432a356d05']",117,337,454,2247095,29,,,,5713
fef7c4ac0e8a13ad715428a9641bed914e552639,0,samindaw,2014-05-20 22:46:33-07:00,['029cfac4077edb65f2ea4dc122d86af201bdb5f0'],1188,7107,8295,2255390,16,0.440693642,0.56716763,0.96300578,5716
1bb816a829310b319e27d92fd73e99a8c9b19a70,0,Saminda Wijeratne,2014-05-20 22:50:20-07:00,['fef7c4ac0e8a13ad715428a9641bed914e552639'],2,20,22,2255412,1,1,1,1,5716
179367235edb374d763bf27e0e54bc2d6fce3d0a,0,raminder,2014-05-21 09:54:22-04:00,['1bb816a829310b319e27d92fd73e99a8c9b19a70'],1,8,9,2255421,1,0,1,1,5716
ee50805cf1e19dd1a15f33451feb5a5fe63d2604,0,lahiru,2014-05-21 10:48:32-04:00,['2710f6e3aab71af1803d79ad8b77d4432a356d05'],43,64,107,2255528,4,0.15,1,1,5716
61dd0fcb2b5e8bb48b6d7d15943b12df19ee4d8e,0,lahiru,2014-05-21 10:48:51-04:00,"['ee50805cf1e19dd1a15f33451feb5a5fe63d2604', '179367235edb374d763bf27e0e54bc2d6fce3d0a']",1190,7613,8803,2264331,20,,,,5716
4f2ca03e330ad625ce1e8d0d0b33bca400bb5c12,0,Chathuri Wimalasena,2014-05-21 11:19:31-04:00,['61dd0fcb2b5e8bb48b6d7d15943b12df19ee4d8e'],4,1,5,2264336,1,0,1,0,5716
c27266970bcab6b28ee3dd8f38a21736cae2a558,0,lahiru,2014-05-21 11:28:19-04:00,['4f2ca03e330ad625ce1e8d0d0b33bca400bb5c12'],1,5,6,2264342,1,1,1,1,5716
4792e8138c4c4eacb249f5dea471a2a2879ef4e6,0,raminder,2014-05-21 11:31:24-04:00,['c27266970bcab6b28ee3dd8f38a21736cae2a558'],4,1,5,2264347,1,,,,5716
1fd52a12dd915a8ae7d07fd59456e34cb1e1f8f8,0,raminder,2014-05-21 11:57:14-04:00,['44ebc62bb36a5fbd240a62a5a379225ded0c6917'],70,1210,1280,2265627,4,0.343925234,0.465420561,1,5716
dd0ba0d0dca23c372300dfdea6f9e4ef628e163e,0,marpierc,2014-05-21 12:06:06-04:00,['44ebc62bb36a5fbd240a62a5a379225ded0c6917'],0,20,20,2265647,1,,,,5717
68dff5dfb0bcd574e9298d823986f1bffdc6ed3e,0,marpierc,2014-05-21 12:06:42-04:00,"['dd0ba0d0dca23c372300dfdea6f9e4ef628e163e', '1fd52a12dd915a8ae7d07fd59456e34cb1e1f8f8']",70,1210,1280,2266927,4,,,,5717
76d9108ce80ca98e9b7177361b14f1b3f81c0abb,0,lahiru,2014-05-21 12:48:38-04:00,['c27266970bcab6b28ee3dd8f38a21736cae2a558'],0,15,15,2266942,2,0,0,1,5717
b04cbe9509b4947454e577e57d5e17c17844b0da,0,lahiru,2014-05-21 13:33:17-04:00,"['76d9108ce80ca98e9b7177361b14f1b3f81c0abb', '4792e8138c4c4eacb249f5dea471a2a2879ef4e6']",4,1,5,2266947,1,,,,5717
009ee0d7bb86c9757575b973c213fae760a4ae99,0,lahiru,2014-05-21 14:14:42-04:00,['b04cbe9509b4947454e577e57d5e17c17844b0da'],23,20,43,2266990,7,0,0,0.333333333,5717
2ce716cd840abbc1916f33cbf141db3ffe9d7eb5,1,lahiru,2014-05-21 14:28:02-04:00,['009ee0d7bb86c9757575b973c213fae760a4ae99'],0,4368,4368,2271358,17,0.642365887,0.837689133,0.983035305,5734
452419f170cd2e3b0d4bc05f018a53224a8929bd,0,lahiru,2014-05-21 15:34:03-04:00,['2ce716cd840abbc1916f33cbf141db3ffe9d7eb5'],188,20,208,2271566,2,0.234693878,0.234693878,0,5734
0193ff9dfdcea4f2d30df3becc87f7a161dbaef8,0,marie-iub,2014-05-21 15:53:01-04:00,['68dff5dfb0bcd574e9298d823986f1bffdc6ed3e'],7,35,42,2271608,2,,,,5734
c00a71a73430a1878e65b73f33ab8f5099c9d28d,0,marie-iub,2014-05-21 15:59:24-04:00,['0193ff9dfdcea4f2d30df3becc87f7a161dbaef8'],0,4,4,2271612,1,,,,5734
7592a619887d58463e1d26020532fbbb01d95767,0,marpierc,2014-05-21 17:12:57-04:00,['68dff5dfb0bcd574e9298d823986f1bffdc6ed3e'],0,7,7,2271619,1,,,,5735
222a14d92455be07a9fe5330a972f47f9dc3c7a4,0,marpierc,2014-05-21 17:13:44-04:00,['7592a619887d58463e1d26020532fbbb01d95767'],240,62,302,2271921,16,,,,5735
427056b143d7d3f025b5d488e9452ec83f24116e,0,marpierc,2014-05-21 17:15:02-04:00,"['222a14d92455be07a9fe5330a972f47f9dc3c7a4', 'c00a71a73430a1878e65b73f33ab8f5099c9d28d']",8,40,48,2271969,2,,,,5735
6f1ed7f0659463dd2b0f76056aacd873bfa11f9b,1,Chathuri Wimalasena,2014-05-21 20:26:08-04:00,['452419f170cd2e3b0d4bc05f018a53224a8929bd'],572,5253,5825,2277794,17,0.369209431,0.463522885,0.938418863,5735
59b9906317abab8e7b1131b6a3e57e45af18771d,0,marie-iub,2014-05-22 09:37:32-04:00,['427056b143d7d3f025b5d488e9452ec83f24116e'],1,1,2,2277796,1,,,,5735
94c1fb2bd70a82d2582d90b1193996828c8ab8b7,0,lahiru,2014-05-22 10:06:35-04:00,['452419f170cd2e3b0d4bc05f018a53224a8929bd'],3,92,95,2277891,3,0.980392157,0.980392157,1,5735
b9b8c258c2352a5ba038d97d3e574a17e45cdf6e,0,lahiru,2014-05-22 10:22:50-04:00,"['94c1fb2bd70a82d2582d90b1193996828c8ab8b7', '6f1ed7f0659463dd2b0f76056aacd873bfa11f9b']",572,5253,5825,2283716,17,,,,5735
a3658305082874a1e82a79fdbcfddecb5e1488cd,1,Chathuri Wimalasena,2014-05-22 11:06:10-04:00,['b9b8c258c2352a5ba038d97d3e574a17e45cdf6e'],568,6942,7510,2291226,17,0.343654512,0.404563047,0.952332451,5736
0f914f2a5d6b23fd7980eb98fd4d73fee3517d86,0,marie-iub,2014-05-22 11:31:45-04:00,['59b9906317abab8e7b1131b6a3e57e45af18771d'],22,14,36,2291262,1,,,,5736
43a3761c6f7b964a652f3fd1e6a250a586d8f214,1,Chathuri Wimalasena,2014-05-22 11:52:44-04:00,['a3658305082874a1e82a79fdbcfddecb5e1488cd'],149,308,457,2291719,9,0,0.151898734,0.955696203,5736
fd9e7f48fa8d32351e09757ead88da83ea9c9600,0,lahiru,2014-05-22 11:53:08-04:00,['a3658305082874a1e82a79fdbcfddecb5e1488cd'],26,145,171,2291890,6,0,0.300970874,1,5736
6208eee4dc286e019ca930e0da3d4f483f690bd0,0,lahiru,2014-05-22 12:04:07-04:00,"['fd9e7f48fa8d32351e09757ead88da83ea9c9600', '43a3761c6f7b964a652f3fd1e6a250a586d8f214']",149,308,457,2292347,9,,,,5736
fb0e725e4fc6388f5c3219345f22b0371b767c5f,0,raminder,2014-05-22 12:22:32-04:00,['0f914f2a5d6b23fd7980eb98fd4d73fee3517d86'],128,1674,1802,2294149,2,0.328976035,0.422657952,1,5736
169818fa0dfba4373a8df5db2eb73479460de435,0,raminder,2014-05-22 12:33:25-04:00,['fb0e725e4fc6388f5c3219345f22b0371b767c5f'],4,4,8,2294157,2,,,,5736
050fd1da100f9dfeb23182ee02a3d0d46fb0ce22,0,Suresh Marru,2014-05-22 13:58:23-04:00,['169818fa0dfba4373a8df5db2eb73479460de435'],17,0,17,2294174,1,0,0,0,5736
126ee28cdd8f2bfb61cc347897aef25887018ec2,0,marpierc,2014-05-22 14:05:39-04:00,['050fd1da100f9dfeb23182ee02a3d0d46fb0ce22'],0,1,1,2294175,1,,,,5736
693fe552637f223fbc4e4962411ad7e76d095931,0,lahiru,2014-05-22 14:11:10-04:00,['6208eee4dc286e019ca930e0da3d4f483f690bd0'],1,1,2,2294177,1,,,,5736
bf7bd51aa01e5c80c74b3897ce2d4d7a6a28d0ae,0,lahiru,2014-05-22 14:28:50-04:00,['693fe552637f223fbc4e4962411ad7e76d095931'],1,1,2,2294179,1,,,,5736
2c6ccedd706eaab7a8cf2b8a54a265bfeb34064e,0,Suresh Marru,2014-05-22 14:32:18-04:00,['050fd1da100f9dfeb23182ee02a3d0d46fb0ce22'],6,18,24,2294203,1,,,,5736
fdf34dc5f71cdb686cd634ef5960616169008cfd,0,Suresh Marru,2014-05-22 14:33:32-04:00,"['2c6ccedd706eaab7a8cf2b8a54a265bfeb34064e', '126ee28cdd8f2bfb61cc347897aef25887018ec2']",17,6,23,2294226,1,,,,5736
6c10f6e672884705f0d187c52dfe412b33e032c7,0,lahiru,2014-05-22 14:33:45-04:00,['bf7bd51aa01e5c80c74b3897ce2d4d7a6a28d0ae'],1,1,2,2294228,1,,,,5736
fe507e4b69fafebd471a46218e35ffc4cfe61cc3,0,lahiru,2014-05-22 14:49:24-04:00,['6c10f6e672884705f0d187c52dfe412b33e032c7'],2,11,13,2294241,1,0,1,1,5736
ce10da77634c48ec5b046348837e96a28eb20eea,1,Chathuri Wimalasena,2014-05-22 15:02:29-04:00,['fe507e4b69fafebd471a46218e35ffc4cfe61cc3'],19,57,76,2294317,7,0,0.583333333,0.777777778,5736
b7ae2349bee29f3e28af6e649ab14104a2e9e823,0,lahiru,2014-05-22 15:17:08-04:00,['ce10da77634c48ec5b046348837e96a28eb20eea'],4,11,15,2294332,1,0,0,1,5736
fc9d7629c7f325b70340d9022b59ec1defa46780,0,Chathuri Wimalasena,2014-05-22 15:39:05-04:00,['b7ae2349bee29f3e28af6e649ab14104a2e9e823'],1049,0,1049,2295381,3,0.453996983,0.263951735,0,5736
f06e75f4c063789d40090363f59dda8567a5bf8d,0,Suresh Marru,2014-05-22 15:53:49-04:00,['fc9d7629c7f325b70340d9022b59ec1defa46780'],187,713,900,2296281,9,0.02742616,0,0.955696203,5736
249a390f30ba4446d81db4b19da3f39692fe998e,0,Udara,2014-05-23 01:34:12+05:18,['a3658305082874a1e82a79fdbcfddecb5e1488cd'],3,119,122,2296403,2,0.392156863,0.784313725,1,5737
bb1cecbaeb119b042534dc2bfb9d28624d2d25cc,0,Udara,2014-05-23 01:43:47+05:18,"['249a390f30ba4446d81db4b19da3f39692fe998e', 'f06e75f4c063789d40090363f59dda8567a5bf8d']",1434,1243,2677,2299080,26,,,,5737
c6f4ceaa10d05c12feaddbe387ace48f305a7a8e,0,Saminda Wijeratne,2014-05-22 14:46:16-07:00,['fe507e4b69fafebd471a46218e35ffc4cfe61cc3'],8,8,16,2299096,1,,,,5737
1a5f1a2b321b8e3b9206b9ec4122f68abad85cad,0,Saminda Wijeratne,2014-05-22 14:46:45-07:00,"['c6f4ceaa10d05c12feaddbe387ace48f305a7a8e', 'bb1cecbaeb119b042534dc2bfb9d28624d2d25cc']",1261,899,2160,2301256,19,,,,5737
1d76b48c1b6756686ba8aa7312544eabe5d277af,0,samindaw,2014-05-22 14:56:40-07:00,['1a5f1a2b321b8e3b9206b9ec4122f68abad85cad'],312,1624,1936,2303192,5,0.082191781,0.328767123,0.892123288,5737
0ff241524aee09b36c2bb68bced56de646522e28,0,David Reagan,2014-05-22 19:29:23-04:00,['126ee28cdd8f2bfb61cc347897aef25887018ec2'],3,4,7,2303199,2,,,,5737
928e37bd9a2a96d3d03b4957f92d9415b27c04b2,1,Saminda Wijeratne,2014-05-23 04:08:29-07:00,['1d76b48c1b6756686ba8aa7312544eabe5d277af'],43,335,378,2303577,9,0.293814433,0.448453608,0.932989691,5738
2c24439cc4ce4436cb6c32d6a436290ed48992ba,0,samindaw,2014-05-23 05:26:44-07:00,['1d76b48c1b6756686ba8aa7312544eabe5d277af'],65,66,131,2303708,3,,,,5738
507686a6004428b8dfed4707b60d426713a4593e,0,samindaw,2014-05-23 05:27:11-07:00,"['2c24439cc4ce4436cb6c32d6a436290ed48992ba', '928e37bd9a2a96d3d03b4957f92d9415b27c04b2']",43,335,378,2304086,9,,,,5738
fb7f491545457672c6e7e22e08fb6d31d529652d,0,Saminda Wijeratne,2014-05-23 05:56:26-07:00,['507686a6004428b8dfed4707b60d426713a4593e'],0,1,1,2304087,1,0,0,1,5738
3c19939ba1ff220eaffa03c4781bc8800a101e58,0,Saminda Wijeratne,2014-05-23 06:15:37-07:00,['fb7f491545457672c6e7e22e08fb6d31d529652d'],4,0,4,2304091,1,1,0,0,5738
f0f9ac94d3fb22f8ce7d7d2151b830283a58539e,0,Saminda Wijeratne,2014-05-23 06:25:00-07:00,['3c19939ba1ff220eaffa03c4781bc8800a101e58'],5,6,11,2304102,1,,,,5738
593d5a7c04de46518c75220321b0cc5c14f1fdf2,0,Saminda Wijeratne,2014-05-23 06:35:20-07:00,['f0f9ac94d3fb22f8ce7d7d2151b830283a58539e'],0,90,90,2304192,1,1,1,1,5739
25bac696c8a8d30da7d25e745e478db28bf6283e,0,raminder,2014-05-23 10:32:53-04:00,['0ff241524aee09b36c2bb68bced56de646522e28'],5,5,10,2304202,1,,,,5739
baa69e8945d6eac98f0f2111eaf8dc8c752a03fc,0,Chathuri Wimalasena,2014-05-23 10:35:31-04:00,['593d5a7c04de46518c75220321b0cc5c14f1fdf2'],3,11,14,2304216,5,0,1,1,5739
b240462e02a4cdf3f5299324ffcef9db668b1493,0,Suresh Marru,2014-05-23 11:39:34-04:00,"['fdf34dc5f71cdb686cd634ef5960616169008cfd', '25bac696c8a8d30da7d25e745e478db28bf6283e']",8,9,17,2304233,3,,,,5739
123cf87d94f3702b1a169d2b86047c6995a4ee87,0,Suresh Marru,2014-05-23 11:42:44-04:00,['b240462e02a4cdf3f5299324ffcef9db668b1493'],19,94,113,2304346,2,0.047619048,0,1,5739
124e286d0c244b1a539acff727fe2e8675271369,1,Chathuri Wimalasena,2014-05-23 11:46:55-04:00,['baa69e8945d6eac98f0f2111eaf8dc8c752a03fc'],4,7,11,2304357,1,0,0,1,5739
effb4d71741bc830cf99872e997335e7c0731ceb,0,Saminda Wijeratne,2014-05-23 11:07:59-07:00,['593d5a7c04de46518c75220321b0cc5c14f1fdf2'],0,148,148,2304505,2,1,1,1,5741
93e6a37a58b70f53c2639baf6857993cc5562eec,0,Saminda Wijeratne,2014-05-23 11:08:35-07:00,['effb4d71741bc830cf99872e997335e7c0731ceb'],1,1,2,2304507,1,,,,5741
650e545f93c8d1fcdddbf9ef2503caf6285e99b5,0,Saminda Wijeratne,2014-05-23 11:08:54-07:00,"['93e6a37a58b70f53c2639baf6857993cc5562eec', '124e286d0c244b1a539acff727fe2e8675271369']",7,18,25,2304532,6,,,,5741
25cafc0cd076d66259e288e34fefd557de039944,0,marpierc,2014-05-23 14:12:27-04:00,['123cf87d94f3702b1a169d2b86047c6995a4ee87'],0,1,1,2304533,1,,,,5741
d233abda323480ef723d4fb94d7986b159059a9d,0,raminder,2014-05-23 14:23:12-04:00,['650e545f93c8d1fcdddbf9ef2503caf6285e99b5'],4,4,8,2304541,2,,,,5741
3eac761cd1b8e32902d7b84efe05869a8e73bf68,0,Saminda Wijeratne,2014-05-23 11:32:12-07:00,['650e545f93c8d1fcdddbf9ef2503caf6285e99b5'],2,10,12,2304553,2,0,1,1,5741
7e022eff0fa88ebcd27e33cb6fb5a5939b327fdd,0,Saminda Wijeratne,2014-05-23 11:32:26-07:00,"['3eac761cd1b8e32902d7b84efe05869a8e73bf68', 'd233abda323480ef723d4fb94d7986b159059a9d']",4,4,8,2304561,2,,,,5741
3bcac35f0c7a267c6dd091b2ea473ecbe34e1a54,0,Suresh Marru,2014-05-23 14:45:54-04:00,['25cafc0cd076d66259e288e34fefd557de039944'],108,71,179,2304740,17,,,,5742
719142d284f22f295b7fe36e438eb6bacb32bbc2,0,lahiru,2014-05-23 15:48:52-04:00,['7e022eff0fa88ebcd27e33cb6fb5a5939b327fdd'],12,14,26,2304766,1,1,0,0,5742
2ce9c126db5614bc4e5782dc7d3777cb260fcbbd,0,Saminda Wijeratne,2014-05-23 13:05:17-07:00,['3bcac35f0c7a267c6dd091b2ea473ecbe34e1a54'],0,245,245,2305011,3,1,1,1,5745
65b084f2e6d34fcd700a849304163fd06ceb2d10,0,Saminda Wijeratne,2014-05-23 13:17:03-07:00,['2ce9c126db5614bc4e5782dc7d3777cb260fcbbd'],7,22,29,2305040,4,,,,5745
d33b96e5ba4397e40eb189f7885ca68a1214a3d7,1,lahiru,2014-05-23 16:30:00-04:00,['719142d284f22f295b7fe36e438eb6bacb32bbc2'],4,3,7,2305047,1,0,0,0,5745
059d16b1a6554d915c63ea045bb46fa9ec84f9b5,0,Saminda Wijeratne,2014-05-23 13:33:41-07:00,['65b084f2e6d34fcd700a849304163fd06ceb2d10'],74,1894,1968,2307015,2,0.352417303,0.416666667,1,5746
353b7362458e0203a619e6b27ea33fd059c82c79,0,Saminda Wijeratne,2014-05-24 23:32:37-07:00,['d33b96e5ba4397e40eb189f7885ca68a1214a3d7'],1,15,16,2307031,1,1,1,1,5746
d8ef967f28c998ac9f68b53d6f331380272c368a,0,Saminda Wijeratne,2014-05-24 23:49:55-07:00,['353b7362458e0203a619e6b27ea33fd059c82c79'],19,28,47,2307078,1,0,0,1,5746
9564e89a5765bc7982d7e4fab87a35ae59216977,0,msmemon,2014-05-26 10:50:16+02:00,['d8ef967f28c998ac9f68b53d6f331380272c368a'],0,11,11,2307089,1,,,,5746
3dafb00672883ebd1e574f13528d1907c57aa5a2,0,raminder,2014-05-26 12:47:17-04:00,['9564e89a5765bc7982d7e4fab87a35ae59216977'],11,19,30,2307119,3,0,0,1,5746
e1f5140fa94b521a6d401543b208c8b2442c45ba,0,Saminda Wijeratne,2014-05-26 10:08:14-07:00,['059d16b1a6554d915c63ea045bb46fa9ec84f9b5'],4,5,9,2307128,3,,,,5746
2884bda6dd06354a181c176080c54a9746264020,0,raminder,2014-05-26 15:43:34-04:00,['3dafb00672883ebd1e574f13528d1907c57aa5a2'],2,5,7,2307135,4,0,0.333333333,1,5746
1a8a19f5e6a66220b3292d7ac74a16a4f2bc1069,0,raminder,2014-05-26 16:23:26-04:00,['2884bda6dd06354a181c176080c54a9746264020'],35,203,238,2307373,3,0,0,1,5746
6ff2f694be712d266c399329e023317a87b0ec6a,0,raminder,2014-05-26 16:30:56-04:00,['1a8a19f5e6a66220b3292d7ac74a16a4f2bc1069'],1,26,27,2307400,1,0,1,1,5746
277b467256065de0fc4c64ed1b51034601a0d5eb,0,marpierc,2014-05-27 10:55:09-04:00,['e1f5140fa94b521a6d401543b208c8b2442c45ba'],1,1,2,2307402,1,,,,5746
d91846803fbe894da063eff4f5b1b0bf139dca2d,0,Chathuri Wimalasena,2014-05-27 10:56:10-04:00,['6ff2f694be712d266c399329e023317a87b0ec6a'],251,2546,2797,2310199,9,0.374292186,0.456398641,0.937146093,5746
36a0b8c2094956570cbdc527edb0e4e68b5ffb64,0,Chathuri Wimalasena,2014-05-27 13:13:31-04:00,['d91846803fbe894da063eff4f5b1b0bf139dca2d'],1,5,6,2310205,1,0,0,1,5746
5153d0c82fb4954d6098fd85f26c6fd018e9a656,0,Chathuri Wimalasena,2014-05-27 13:41:28-04:00,['36a0b8c2094956570cbdc527edb0e4e68b5ffb64'],29,177,206,2310411,6,0.236220472,0.236220472,1,5746
11b1b9a8488a31cabecc557893287af3a28eda15,0,lahiru,2014-05-27 13:53:17-04:00,['6ff2f694be712d266c399329e023317a87b0ec6a'],70,166,236,2310647,17,1,1,1,5748
4b51e7f6a966e30ac200b929220d308bb64b2c9d,0,lahiru,2014-05-27 13:53:38-04:00,"['11b1b9a8488a31cabecc557893287af3a28eda15', '5153d0c82fb4954d6098fd85f26c6fd018e9a656']",281,2728,3009,2313656,16,,,,5748
92ddf3e4e1b385da67a9503a0ae88ac95933c445,0,raminder,2014-05-27 14:18:01-04:00,['d91846803fbe894da063eff4f5b1b0bf139dca2d'],2,4,6,2313662,1,0,1,1,5748
b3f7b256f731c17f067a1c74841932d63a405eea,0,raminder,2014-05-27 14:18:24-04:00,"['92ddf3e4e1b385da67a9503a0ae88ac95933c445', '4b51e7f6a966e30ac200b929220d308bb64b2c9d']",100,348,448,2314110,24,,,,5748
c06bd90341b5a337e124b4a44a1bb6dee9bc15cd,0,lahiru,2014-05-27 15:00:40-04:00,['4b51e7f6a966e30ac200b929220d308bb64b2c9d'],1,6,7,2314117,4,0,0.2,1,5748
1dd6486a5484e405f2ff1921a5893a3bbbdd61d0,0,lahiru,2014-05-27 15:01:07-04:00,"['c06bd90341b5a337e124b4a44a1bb6dee9bc15cd', 'b3f7b256f731c17f067a1c74841932d63a405eea']",2,4,6,2314123,1,,,,5748
233f7962c8e8c8794bf01b73339047ff0ca72aac,0,Chathuri Wimalasena,2014-05-28 10:02:16-04:00,['1dd6486a5484e405f2ff1921a5893a3bbbdd61d0'],1,1,2,2314125,1,,,,5748
a9c337da890bd028739f0f62bca75b4c74edb7a4,0,Chathuri Wimalasena,2014-05-28 10:29:05-04:00,['233f7962c8e8c8794bf01b73339047ff0ca72aac'],789,0,789,2314914,2,,,,5748
3c5774b85eeb5b6eefff092a8190950d20ea1561,0,lahiru,2014-05-28 10:52:18-04:00,['233f7962c8e8c8794bf01b73339047ff0ca72aac'],3,38,41,2314955,3,0,0.205882353,1,5748
d87023a113317853c2d3f311200a40b05523534c,0,lahiru,2014-05-28 10:52:34-04:00,"['3c5774b85eeb5b6eefff092a8190950d20ea1561', 'a9c337da890bd028739f0f62bca75b4c74edb7a4']",789,0,789,2315744,2,,,,5748
7100e38d0010c444411f4fa4455ba5bcf3edf8dd,0,Suresh Marru,2014-05-28 11:20:44-04:00,['1dd6486a5484e405f2ff1921a5893a3bbbdd61d0'],1,98,99,2315843,1,0,0,1,5748
a6de79bd63974a6ad200976bfc3f2babe2d79545,0,Suresh Marru,2014-05-28 11:20:56-04:00,"['7100e38d0010c444411f4fa4455ba5bcf3edf8dd', 'd87023a113317853c2d3f311200a40b05523534c']",793,39,832,2316675,6,,,,5748
ac038ce107a7b66f0133b6149fbd6acfc9e7f077,0,Suresh Marru,2014-05-28 12:07:41-04:00,['a6de79bd63974a6ad200976bfc3f2babe2d79545'],5,5,10,2316685,1,,,,5748
867778bf19bccbef86ae5238cdf7bd2b75f8ddf8,0,Suresh Marru,2014-05-28 13:08:56-04:00,['ac038ce107a7b66f0133b6149fbd6acfc9e7f077'],1,1,2,2316687,1,,,,5748
d8bd3d1a74e55a052530e63f377628807cece880,0,raminder,2014-05-28 14:29:32-04:00,['277b467256065de0fc4c64ed1b51034601a0d5eb'],48,388,436,2317123,2,0.332236842,0.447368421,1,5748
3e08f21494c50859c169bf735585950d0d3744fc,0,raminder,2014-05-28 15:10:08-04:00,['a6de79bd63974a6ad200976bfc3f2babe2d79545'],51,135,186,2317309,5,0,0.017241379,1,5748
c072a3965fcaa7d465377af2938b8073e919eb99,0,raminder,2014-05-28 15:12:21-04:00,"['3e08f21494c50859c169bf735585950d0d3744fc', '867778bf19bccbef86ae5238cdf7bd2b75f8ddf8']",1,1,2,2317311,1,,,,5748
79ea2f1640b53becd8cbecc76ec21a5f28afdd14,0,lahiru,2014-05-28 15:33:14-04:00,['c072a3965fcaa7d465377af2938b8073e919eb99'],5,9,14,2317325,1,0,0,1,5748
e3b0bf2bf9d130d2a4dba700b5b551a8997de650,0,raminder,2014-05-28 20:28:01-04:00,['79ea2f1640b53becd8cbecc76ec21a5f28afdd14'],4,38,42,2317367,2,0,0,1,5748
0fadb080674244b0eb62d93a0840b1dea342ea9c,1,Chathuri Wimalasena,2014-05-29 14:46:41-04:00,['e3b0bf2bf9d130d2a4dba700b5b551a8997de650'],2,650,652,2318019,28,0.315662651,0.826506024,0.831325301,5749
bf5f8c3c53f9aa8e1c86fc1238c6707fcbfbe091,1,Chathuri Wimalasena,2014-05-30 15:53:04-04:00,['0fadb080674244b0eb62d93a0840b1dea342ea9c'],4003,4777,8780,2326799,111,0,0,0.957055215,5749
8b5f2724eaab42297b943e78b01288b0a0dd7bbf,1,Chathuri Wimalasena,2014-06-03 11:29:31-04:00,['bf5f8c3c53f9aa8e1c86fc1238c6707fcbfbe091'],190,243,433,2327232,73,0,1,1,5749
ace68a6e72d672390fa8fda08a113ba576420ac9,0,Chathuri Wimalasena,2014-06-03 13:51:41-04:00,['8b5f2724eaab42297b943e78b01288b0a0dd7bbf'],6,6,12,2327244,2,1,0,0,5749
33fafe05d392e691b983a4b148eb6cd0dbb365f1,0,raminder,2014-06-04 11:17:16-04:00,['e3b0bf2bf9d130d2a4dba700b5b551a8997de650'],79,37,116,2327360,6,1,0.962962963,0.925925926,5749
c83330e98aecfd7d60865d69d1450faf759670d7,0,raminder,2014-06-04 11:18:32-04:00,"['33fafe05d392e691b983a4b148eb6cd0dbb365f1', 'ace68a6e72d672390fa8fda08a113ba576420ac9']",4105,5580,9685,2337045,157,,,,5749
125098de17fc5722d1937a6373c8bc3214799caa,0,Chathuri Wimalasena,2014-06-06 12:09:34-04:00,['c83330e98aecfd7d60865d69d1450faf759670d7'],193,1381,1574,2338619,26,0.355555556,0.272839506,0.981481481,5750
47f6ed33a5f312fe64df3944dca095ec73002ef1,0,Chathuri Wimalasena,2014-06-06 14:28:48-04:00,['125098de17fc5722d1937a6373c8bc3214799caa'],52,65,117,2338736,6,0,1,1,5750
013a815ce6b1938c0d1d48bbd9bddb3e66847cb6,1,Chathuri Wimalasena,2014-06-06 15:52:18-04:00,['47f6ed33a5f312fe64df3944dca095ec73002ef1'],12,228,240,2338976,31,0,0,1,5750
a728ab5003282f4c7645fa2bf7c40fd7df97f447,1,Chathuri Wimalasena,2014-06-09 12:19:38-04:00,['013a815ce6b1938c0d1d48bbd9bddb3e66847cb6'],93,45,138,2339114,5,0.974358974,0,0,5750
18fb76e31d0650ac5b950b7bcfcb8dafb8c227fa,0,lahiru,2014-06-11 11:15:32-04:00,['a728ab5003282f4c7645fa2bf7c40fd7df97f447'],13,57,70,2339184,8,0.086956522,0,1,5751
3f89830732a907061b56fa58afe4def10e6d2ab8,0,dmreagan,2014-06-12 18:03:58-04:00,['d8bd3d1a74e55a052530e63f377628807cece880'],0,246,246,2339430,3,,,,5754
6abdb5f1ee1698a3b416790437e1a75434f9abd2,0,Sachith Withana,2014-06-17 05:15:55+05:18,['18fb76e31d0650ac5b950b7bcfcb8dafb8c227fa'],0,360,360,2339790,3,,,,5757
b9cd25bfb2a0bd0f8a3e2a07cbbd584153de5540,0,Sachith Withana,2014-06-17 05:17:21+05:18,['6abdb5f1ee1698a3b416790437e1a75434f9abd2'],0,1,1,2339791,1,,,,5757
015176b256c6d0b3f481435bb620150d87f69be0,0,Suresh Marru,2014-06-18 11:46:43-04:00,['b9cd25bfb2a0bd0f8a3e2a07cbbd584153de5540'],101,81,182,2339973,58,,,,5757
49f3b111c9b571ac2618d4c7cdf769bfa5871cf9,0,Suresh Marru,2014-06-18 11:46:50-04:00,['015176b256c6d0b3f481435bb620150d87f69be0'],59,59,118,2340091,58,,,,5757
2bcadf5540be6f7e39f9553f4a4f81ab42070140,1,Chathuri Wimalasena,2014-06-18 15:02:37-04:00,['49f3b111c9b571ac2618d4c7cdf769bfa5871cf9'],2,2,4,2340095,2,,,,5757
48cd362a54293593d140c7ccd806c9f1be8283d4,0,Sachith Withana,2014-06-20 08:54:29+05:18,['2bcadf5540be6f7e39f9553f4a4f81ab42070140'],7,1703,1710,2341805,26,1,1,0.98540146,5782
87f6fbd8c4e99634a5b8efc5cf361c47abfcc6a2,0,Sachith Withana,2014-06-20 09:07:30+05:18,['48cd362a54293593d140c7ccd806c9f1be8283d4'],20,90,110,2341915,3,1,1,1,5782
1a7305895232983da3c81cde785c1628e8504a68,0,raminder,2014-06-20 11:23:53-04:00,['2bcadf5540be6f7e39f9553f4a4f81ab42070140'],1,8,9,2341924,1,0,0,1,5782
41a2c860efbc6897216c62cefa1b805c28188a37,0,raminder,2014-06-20 11:26:15-04:00,"['1a7305895232983da3c81cde785c1628e8504a68', '87f6fbd8c4e99634a5b8efc5cf361c47abfcc6a2']",7,1773,1780,2343704,26,,,,5782
e088226fc52f1dcf666b96102b38c87adc2e312f,0,Saminda Wijeratne,2014-06-20 15:08:11-04:00,['41a2c860efbc6897216c62cefa1b805c28188a37'],10,19,29,2343733,1,0,1,1,5782
f92e9a73da0379267d3fa19a418c51f326ca5baf,0,Sachith Withana,2014-06-23 06:16:31+05:18,['e088226fc52f1dcf666b96102b38c87adc2e312f'],1,1,2,2343735,1,,,,5782
bc20a06d14714753a317944f563cdbd435b6068e,0,raminder,2014-06-23 11:28:40-04:00,['f92e9a73da0379267d3fa19a418c51f326ca5baf'],0,0,0,2343735,1,,,,5782
64582600a429fc71fdf6d823a3a83cba0d880578,0,raminder,2014-06-23 17:56:33-04:00,['bc20a06d14714753a317944f563cdbd435b6068e'],1,147,148,2343883,4,0.1875,0.25,0.25,5782
362da4e88c5ab8ddeba234b3ad7c5f829477c272,0,lahiru,2014-06-24 00:44:33-04:00,['2bcadf5540be6f7e39f9553f4a4f81ab42070140'],243,2052,2295,2346178,37,0.377300613,0.498977505,0.965235174,5790
e44da0d7d74c90f82f7668cf3555a7ddcc3d9658,0,Suresh Marru,2014-06-24 11:20:50-04:00,['64582600a429fc71fdf6d823a3a83cba0d880578'],57,57,114,2346292,57,,,,5790
c35e21a38b912c1a00b6dde9dac1696a3db7a0b6,0,Suresh Marru,2014-06-24 11:40:48-04:00,['e44da0d7d74c90f82f7668cf3555a7ddcc3d9658'],58,58,116,2346408,57,,,,5790
3029ff4143604ac27ceb3d72bf62def8953d5f89,0,Suresh Marru,2014-06-24 11:44:48-04:00,['e44da0d7d74c90f82f7668cf3555a7ddcc3d9658'],3,144,147,2346555,2,,,,5790
5f1845429ace304897eccd46f8c5e19f80ed2459,0,Suresh Marru,2014-06-24 11:44:57-04:00,"['3029ff4143604ac27ceb3d72bf62def8953d5f89', 'c35e21a38b912c1a00b6dde9dac1696a3db7a0b6']",58,58,116,2346671,57,,,,5790
2233d42b3da5efd375da95547a5d0be6169ac54d,0,Suresh Marru,2014-06-24 11:45:34-04:00,['c35e21a38b912c1a00b6dde9dac1696a3db7a0b6'],58,58,116,2346787,57,,,,5790
054cc52ac3fe9e32ab12e326b53953764c064349,0,Suresh Marru,2014-06-24 11:47:06-04:00,"['2233d42b3da5efd375da95547a5d0be6169ac54d', '5f1845429ace304897eccd46f8c5e19f80ed2459']",3,144,147,2346934,2,,,,5790
2eb31e004165ed1fc68608084a67b704c171c69b,0,Suresh Marru,2014-06-24 11:58:47-04:00,['054cc52ac3fe9e32ab12e326b53953764c064349'],58,58,116,2347050,57,,,,5790
f723d4937b2cc46d7749c75d20eee9a429a1afdf,0,Suresh Marru,2014-06-24 11:58:54-04:00,['2eb31e004165ed1fc68608084a67b704c171c69b'],58,58,116,2347166,57,,,,5790
e86504aae30401d109690d8814cbf4bcc6f77ae9,0,lahiru,2014-06-24 13:46:33-04:00,['362da4e88c5ab8ddeba234b3ad7c5f829477c272'],801,483,1284,2348450,15,0,0,0,5792
34816536df1c384aca6bd4d39bc0f6c778c1daa0,0,lahiru,2014-06-24 14:04:11-04:00,"['f723d4937b2cc46d7749c75d20eee9a429a1afdf', 'e86504aae30401d109690d8814cbf4bcc6f77ae9']",246,1737,1983,2350433,37,,,,5792
d56dd443e6fb4242d475e15264e08e9cab2edc59,0,lahiru,2014-06-24 14:05:28-04:00,['34816536df1c384aca6bd4d39bc0f6c778c1daa0'],0,109,109,2350542,2,1,1,1,5794
4c34a512205fba869559eb2cee3254c8a93bc3ab,0,lahiru,2014-06-24 14:14:00-04:00,['d56dd443e6fb4242d475e15264e08e9cab2edc59'],1,0,1,2350543,1,1,1,0,5794
5c7acf3012060cdc69e0f6cf1c02b4ddd426827d,0,Chathuri Wimalasena,2014-06-24 14:23:26-04:00,['4c34a512205fba869559eb2cee3254c8a93bc3ab'],8,1096,1104,2351647,63,0.433121019,0.439490446,0.789808917,5811
4d9b92e5d829a3bbe0482a30e7accfe3e03fceed,0,Chathuri Wimalasena,2014-06-24 14:50:44-04:00,['5c7acf3012060cdc69e0f6cf1c02b4ddd426827d'],2,1531,1533,2353180,10,0.143356643,0.674825175,0.884615385,5820
4217a17e763e2ed5aebca1468c7b76a0bf7d133a,0,Chathuri Wimalasena,2014-06-24 15:03:08-04:00,['4d9b92e5d829a3bbe0482a30e7accfe3e03fceed'],0,1,1,2353181,1,,,,5820
d7c711667cc4be267fc85c149a3fd372c07b4f53,0,lahiru,2014-06-24 15:49:01-04:00,['4217a17e763e2ed5aebca1468c7b76a0bf7d133a'],205,333,538,2353719,9,0.08496732,0.431372549,0.431372549,5820
a1bb763521cd80092df674e90663bf36fc37d913,0,lahiru,2014-06-24 17:05:21-04:00,['d7c711667cc4be267fc85c149a3fd372c07b4f53'],4,240,244,2353963,11,0.36,0.6,1,5823
9526ceb2bb7869a75667b3b8ceeb8a2509836bc7,0,Chathuri Wimalasena,2014-06-24 19:49:01-04:00,['a1bb763521cd80092df674e90663bf36fc37d913'],13,13,26,2353989,2,,,,5823
236c04a7a6ff928a5628d1f6ef95502fd3015d93,0,lahiru,2014-06-25 02:05:46-04:00,['9526ceb2bb7869a75667b3b8ceeb8a2509836bc7'],93,376,469,2354458,11,0.103825137,0.464480874,0.683060109,5824
b62e67d5024fa5a81394e37958bbcfb7f8291df5,0,Suresh Marru,2014-06-25 09:36:36-04:00,['236c04a7a6ff928a5628d1f6ef95502fd3015d93'],203,683,886,2355344,8,0.714285714,0,0,5828
59ffdfd5e1c2610691f877cef20cc8bc4e102d4c,0,Saminda Wijeratne,2014-06-25 12:27:40-04:00,['236c04a7a6ff928a5628d1f6ef95502fd3015d93'],10,22,32,2355376,2,,,,5828
29f94c39055f7435803d21944c46b47228873576,0,Saminda Wijeratne,2014-06-25 12:28:08-04:00,"['59ffdfd5e1c2610691f877cef20cc8bc4e102d4c', 'b62e67d5024fa5a81394e37958bbcfb7f8291df5']",203,683,886,2356262,8,,,,5828
f9ceaeb5c4ce5fccaff177bbad372c8c83da28f2,0,Suresh Marru,2014-06-25 13:33:56-04:00,['b62e67d5024fa5a81394e37958bbcfb7f8291df5'],1,0,1,2356263,1,,,,5828
3456236a6534c353f83b780df14645b6b9bb8731,0,Suresh Marru,2014-06-25 13:34:20-04:00,"['f9ceaeb5c4ce5fccaff177bbad372c8c83da28f2', '29f94c39055f7435803d21944c46b47228873576']",10,22,32,2356295,2,,,,5828
c6d78a45b85f158922e8fa1196bbebe67eae1f8c,0,samindaw,2014-06-25 10:41:50-07:00,['3456236a6534c353f83b780df14645b6b9bb8731'],18,18,36,2356331,2,,,,5828
b9c9d2456c1dd9f5a1e53c9057c6bd7d1dc48774,0,samindaw,2014-06-25 10:49:44-07:00,['c6d78a45b85f158922e8fa1196bbebe67eae1f8c'],114,1252,1366,2357697,6,0.614443084,0.733170135,0.991432069,5828
441bf7658d1b1f6f8e53cfb7849a69a5e45bdfcb,0,Saminda Wijeratne,2014-06-25 14:09:33-04:00,['b9c9d2456c1dd9f5a1e53c9057c6bd7d1dc48774'],0,7,7,2357704,1,1,1,1,5828
c05fd14b01589d0d69b90fbf1b2d7a21667f205e,0,lahiru,2014-06-25 16:15:49-04:00,['236c04a7a6ff928a5628d1f6ef95502fd3015d93'],277,381,658,2358362,8,0.258823529,0.294117647,0.352941176,5828
109b679ad94775136d29b050578b70eac690fb47,0,lahiru,2014-06-25 16:16:45-04:00,"['c05fd14b01589d0d69b90fbf1b2d7a21667f205e', '441bf7658d1b1f6f8e53cfb7849a69a5e45bdfcb']",329,1965,2294,2360656,18,,,,5828
5e81196d18310551b3a484f2cef2bc544ea27556,0,lahiru,2014-06-26 10:08:37-04:00,['109b679ad94775136d29b050578b70eac690fb47'],7,42,49,2360705,7,0.523809524,0.523809524,1,5828
90c47ded4e6e162052f317b9b304b870a352a0a3,1,Chathuri Wimalasena,2014-06-26 11:45:11-04:00,['5e81196d18310551b3a484f2cef2bc544ea27556'],50,154,204,2360909,7,0.967741935,0.967741935,1,5829
6da674fdd7e415e07df88c3de0f106eec597542f,0,lahiru,2014-06-26 12:47:44-04:00,['90c47ded4e6e162052f317b9b304b870a352a0a3'],25,72,97,2361006,3,0.024390244,0.024390244,1,5829
3a84ee8c3e953d3b364c6075d84b2fa506759529,0,lahiru,2014-06-26 15:25:19-04:00,['6da674fdd7e415e07df88c3de0f106eec597542f'],27,84,111,2361117,2,0.054545455,0.054545455,1,5829
5662d5ca48d50115f7b511d267f4d1cd8338c20e,0,Suresh Marru,2014-06-26 15:46:37-04:00,['6da674fdd7e415e07df88c3de0f106eec597542f'],382,52,434,2361551,4,,,,5829
fdb3daa5ef3a27b440f7f374943620c523eccc73,0,Suresh Marru,2014-06-26 15:46:45-04:00,"['5662d5ca48d50115f7b511d267f4d1cd8338c20e', '3a84ee8c3e953d3b364c6075d84b2fa506759529']",27,84,111,2361662,2,,,,5829
dde984af95ea301e731bc8e29745c964322df6c3,0,Suresh Marru,2014-06-26 16:06:08-04:00,['fdb3daa5ef3a27b440f7f374943620c523eccc73'],142,6,148,2361810,2,,,,5829
bb958aadc0e08e675679296951c135a58d1c9ea6,0,Suresh Marru,2014-06-26 18:10:56-04:00,['dde984af95ea301e731bc8e29745c964322df6c3'],7,46,53,2361863,2,,,,5829
ffb186f0a69ca6efa7bdaf7d20e64381981ad09d,0,Suresh Marru,2014-06-26 22:20:23-04:00,['bb958aadc0e08e675679296951c135a58d1c9ea6'],33,142,175,2362038,3,,,,5829
bed07458dd1b9364d2b838d523926fa1112f03c8,1,Sachith Withana,2014-06-27 14:15:05+05:18,['ffb186f0a69ca6efa7bdaf7d20e64381981ad09d'],0,207,207,2362245,5,1,1,1,5832
e7bb5659554a351e2b8dd4d99ef46c033fe41612,1,Chathuri Wimalasena,2014-06-27 09:52:17-04:00,['bed07458dd1b9364d2b838d523926fa1112f03c8'],0,1413,1413,2363658,19,1,1,1,5848
37df1e0a6dddc1205f2e3196b42e6f9c82e7d665,1,Chathuri Wimalasena,2014-06-27 11:28:59-04:00,['e7bb5659554a351e2b8dd4d99ef46c033fe41612'],34,578,612,2364270,6,0.254019293,0.546623794,1,5852
e31265cba96b26fafcd855e7f8aacdf8011b8573,1,Saminda Wijeratne,2014-06-27 11:31:54-04:00,['bed07458dd1b9364d2b838d523926fa1112f03c8'],322,864,1186,2365456,18,0.362229102,0.53869969,1,5853
f0aae9f174d177826f373c42f26f79c73b64ba7c,0,Saminda Wijeratne,2014-06-27 11:32:13-04:00,"['e31265cba96b26fafcd855e7f8aacdf8011b8573', '37df1e0a6dddc1205f2e3196b42e6f9c82e7d665']",34,1991,2025,2367481,25,,,,5853
a886c0c5beceb12cc3f49588c037d1f3a06349fd,1,Chathuri Wimalasena,2014-06-27 12:01:56-04:00,['f0aae9f174d177826f373c42f26f79c73b64ba7c'],1,91,92,2367573,1,,,,5853
91e2c0a61a8387f51e7ebfe244a3399fe50e32c5,1,Sachith Withana,2014-06-27 21:55:45+05:18,['a886c0c5beceb12cc3f49588c037d1f3a06349fd'],0,212,212,2367785,1,0.156626506,0.156626506,1,5854
407c9bac813bb83e22c0f4bb3a7659daa781db2a,1,Chathuri Wimalasena,2014-06-27 15:25:02-04:00,['91e2c0a61a8387f51e7ebfe244a3399fe50e32c5'],42,1362,1404,2369189,10,0.16,0.299487179,1,5858
07bb535c2102ff0f67b5a8d1e9a0860044dce0ec,0,Saminda Wijeratne,2014-06-27 16:01:01-04:00,['f0aae9f174d177826f373c42f26f79c73b64ba7c'],1,3,4,2369193,1,,,,5858
20d1d7d75d6f63ac8755b5ac5833b353b9ef4206,0,Saminda Wijeratne,2014-06-27 16:01:36-04:00,"['07bb535c2102ff0f67b5a8d1e9a0860044dce0ec', '407c9bac813bb83e22c0f4bb3a7659daa781db2a']",35,1657,1692,2370885,10,,,,5858
8d51973ff88e262077a918fdc197bda6373c1d7d,0,Chathuri Wimalasena,2014-06-27 16:04:58-04:00,['20d1d7d75d6f63ac8755b5ac5833b353b9ef4206'],12,115,127,2371012,1,0,0.188235294,0.917647059,5858
e565ae493b2d7d01f8e7ae5d434079460bf20bec,0,Saminda Wijeratne,2014-06-27 16:08:31-04:00,['8d51973ff88e262077a918fdc197bda6373c1d7d'],4,5,9,2371021,2,0,1,0,5858
33a6d8b78b99e535df34cf5108ec85a041f702c9,0,lahiru,2014-06-27 17:30:56-04:00,['e565ae493b2d7d01f8e7ae5d434079460bf20bec'],253,405,658,2371679,16,0.892307692,0.907692308,0.046153846,5859
2e36ba4af4d416e2c0f854b7f1d04bf450254e30,1,Chathuri Wimalasena,2014-06-27 22:53:25-04:00,['33a6d8b78b99e535df34cf5108ec85a041f702c9'],7,866,873,2372552,5,0.134351145,0.238167939,1,5862
69be6c770cc49f7612ccb5b635eaf6f268d8c8a9,1,Sachith Withana,2014-06-28 10:17:56+05:18,['2e36ba4af4d416e2c0f854b7f1d04bf450254e30'],2131,736,2867,2375419,32,0,0,0.084745763,5865
da5d2f3ae3030a28c634b7e2e5a9a97b7a379249,1,Sachith Withana,2014-06-28 12:22:30+05:18,['69be6c770cc49f7612ccb5b635eaf6f268d8c8a9'],31,1099,1130,2376549,6,0.104008667,0.252437703,1,5867
9c4a19fae61980801a7d9f43ce453177645cddd3,1,Sachith Withana,2014-06-28 13:47:33+05:18,['da5d2f3ae3030a28c634b7e2e5a9a97b7a379249'],28,987,1015,2377564,7,0.094775213,0.261239368,1,5870
f048c8a61c09b7a0353815d15d871d488ad140d8,1,Sachith Withana,2014-06-28 20:03:25+05:18,['9c4a19fae61980801a7d9f43ce453177645cddd3'],12,996,1008,2378572,6,0.085918854,0.168257757,1,5873
856b557fe7186e9308ad35afe571c6dc2a246a92,1,Sachith Withana,2014-06-28 21:30:01+05:18,['f048c8a61c09b7a0353815d15d871d488ad140d8'],0,1010,1010,2379582,3,0.126760563,0.207746479,1,5876
9dcb8ba43a7e0b79495103389518887cf6fa02f3,1,Chathuri Wimalasena,2014-06-28 13:20:05-04:00,['856b557fe7186e9308ad35afe571c6dc2a246a92'],11,232,243,2379825,1,0.5625,0.5625,1,5876
3868d50cdea83b6a17c3f272ef39049fdd68d59c,1,Chathuri Wimalasena,2014-06-28 13:26:53-04:00,['9dcb8ba43a7e0b79495103389518887cf6fa02f3'],36,85,121,2379946,36,,,,5876
77970e0c429ccfccfa5a3fb1467e4a82dbb54c00,0,Chathuri Wimalasena,2014-06-28 18:27:02-04:00,['3868d50cdea83b6a17c3f272ef39049fdd68d59c'],6,183,189,2380135,7,0.424242424,0.585858586,1,5877
8ebb254ffde04734bfdfcf88a3d9708be199c2c0,0,Chathuri Wimalasena,2014-06-28 18:45:48-04:00,['77970e0c429ccfccfa5a3fb1467e4a82dbb54c00'],1024,12397,13421,2393556,32,0.360299359,0.464837254,0.961392255,5891
c97832e292407bf3a26e4fc5138c21181a4e7fff,0,Suresh Marru,2014-06-28 23:29:28-04:00,['8ebb254ffde04734bfdfcf88a3d9708be199c2c0'],13,9,22,2393578,5,,,,5891
c84bc06167054c5065fe254e7a8ca89e5d74d2ab,0,Suresh Marru,2014-06-28 23:35:09-04:00,['c97832e292407bf3a26e4fc5138c21181a4e7fff'],20,0,20,2393598,4,,,,5891
3d5b9a67f5be5d6229a05c960ab09fdf26721489,0,Chathuri Wimalasena,2014-06-29 00:19:37-04:00,['8ebb254ffde04734bfdfcf88a3d9708be199c2c0'],1,64,65,2393663,4,,,,5894
df55c5b299df88e51e38c00ca9c022760da67450,0,Suresh Marru,2014-06-29 00:30:31-04:00,['c84bc06167054c5065fe254e7a8ca89e5d74d2ab'],13,2,15,2393678,1,,,,5894
8994fc86a2412a8c78df5622dfb99965a1924e2a,0,Suresh Marru,2014-06-29 07:22:02-04:00,"['df55c5b299df88e51e38c00ca9c022760da67450', '3d5b9a67f5be5d6229a05c960ab09fdf26721489']",1,64,65,2393743,4,,,,5894
41dd801d307bf910f9aa98a269e34bd0476e3335,0,Suresh Marru,2014-06-29 08:22:51-04:00,['8994fc86a2412a8c78df5622dfb99965a1924e2a'],33015,15,33030,2426773,9,0.492264941,0.379743685,0.023682137,5894
eaf09bd90df4ed5efec765ad5d86c3516399b009,0,Suresh Marru,2014-06-29 08:38:04-04:00,['41dd801d307bf910f9aa98a269e34bd0476e3335'],0,8,8,2426781,1,,,,5894
ac8bbf0710713c3ad69287ce145a532b14cd7676,0,lahiru,2014-06-29 09:05:23-04:00,['33a6d8b78b99e535df34cf5108ec85a041f702c9'],2,2,4,2426785,2,,,,5894
abd7f198168bab499ea40f178ba888572d3d1c9f,0,lahiru,2014-06-29 09:05:43-04:00,"['ac8bbf0710713c3ad69287ce145a532b14cd7676', 'eaf09bd90df4ed5efec765ad5d86c3516399b009']",30911,13252,44163,2470948,142,,,,5894
227c78dbe423d266a133b25a27e200ba401cb87f,0,Suresh Marru,2014-06-29 09:55:40-04:00,['abd7f198168bab499ea40f178ba888572d3d1c9f'],0,5903,5903,2476851,9,0.327498177,0.358862144,0.991004133,5903
a1bf4397f797ecde03499696c156c2a847ec6c2d,0,Suresh Marru,2014-06-29 09:57:05-04:00,['227c78dbe423d266a133b25a27e200ba401cb87f'],0,24,24,2476875,1,,,,5904
e0f21e4553970db777cb5aacbea780a83635db07,0,Suresh Marru,2014-06-29 10:14:52-04:00,['a1bf4397f797ecde03499696c156c2a847ec6c2d'],6,10,16,2476891,6,0.696691176,0.356617647,0,5904
6843720ac523bf7befa6da3a1769c1e292832484,0,Suresh Marru,2014-06-29 10:36:20-04:00,['e0f21e4553970db777cb5aacbea780a83635db07'],5935,32,5967,2482858,13,0.672501823,0.641137856,0.008995867,5904
45b3c4b8404c93f4b8ca69c434298b70a7f9019a,0,Suresh Marru,2014-06-29 10:54:25-04:00,['6843720ac523bf7befa6da3a1769c1e292832484'],0,6680,6680,2489538,11,0.335798173,0.371465855,0.991953023,5915
373d1dd9b1b168cfc307616ad9f3c02e4c7828d4,1,Chathuri Wimalasena,2014-06-29 12:43:12-04:00,['45b3c4b8404c93f4b8ca69c434298b70a7f9019a'],2,237,239,2489777,4,,,,5915
8b8dca6aca749e96c8e363ae07fe38608433301b,1,Chathuri Wimalasena,2014-06-29 21:39:52-04:00,['373d1dd9b1b168cfc307616ad9f3c02e4c7828d4'],68,1072,1140,2490917,21,0.353571429,0.385714286,1,5924
ce1279854f8e695d2de0b6a515043132c76f0a5b,0,Suresh Marru,2014-06-29 22:34:21-04:00,['373d1dd9b1b168cfc307616ad9f3c02e4c7828d4'],8,8,16,2490933,3,,,,5924
6f0b74c5116361df06709ce21cbcff7189fb40bc,0,Suresh Marru,2014-06-29 22:34:31-04:00,"['ce1279854f8e695d2de0b6a515043132c76f0a5b', '8b8dca6aca749e96c8e363ae07fe38608433301b']",68,1072,1140,2492073,21,,,,5924
c1718d6a73450c4b32940ffe8ad60fd10e7afbe1,1,Chathuri Wimalasena,2014-06-29 23:34:19-04:00,['6f0b74c5116361df06709ce21cbcff7189fb40bc'],71,640,711,2492784,18,0.251219512,0.43902439,1,5927
673c0fc366b00377d7432dfd5dc215f9b7eb0540,0,Saminda Wijeratne,2014-06-30 10:47:32-04:00,['e565ae493b2d7d01f8e7ae5d434079460bf20bec'],5,14,19,2492803,1,,,,5927
714702096b5c0c1670bbd3275e88becfe00de7c4,0,Saminda Wijeratne,2014-06-30 10:48:31-04:00,"['673c0fc366b00377d7432dfd5dc215f9b7eb0540', 'c1718d6a73450c4b32940ffe8ad60fd10e7afbe1']",30589,21598,52187,2544990,185,,,,5927
515eb10cc5b61cb327a1cd469218c429adc584d9,0,samindaw,2014-06-30 09:11:57-07:00,['714702096b5c0c1670bbd3275e88becfe00de7c4'],176,577,753,2545743,6,0.315789474,0.315789474,0.962406015,5928
2d0ebede8b32a5d25043294b8188b755b48075b8,1,Chathuri Wimalasena,2014-06-30 12:18:50-04:00,['515eb10cc5b61cb327a1cd469218c429adc584d9'],108,404,512,2546255,7,0.605166052,0.605166052,1,5928
f36f43a1bd27df2f0ba1519ee84b8ba4ff7f6350,0,lahiru,2014-06-30 12:58:18-04:00,['2d0ebede8b32a5d25043294b8188b755b48075b8'],17,4,21,2546276,3,0,0,1,5928
462b2417e20384df25a699d3d565a3b93ae838a6,0,Saminda Wijeratne,2014-06-30 13:13:14-04:00,['515eb10cc5b61cb327a1cd469218c429adc584d9'],5,116,121,2546397,8,0.761904762,0.80952381,1,5928
98b738e9155b2b24a72477be8d3541cc66e1241e,0,Saminda Wijeratne,2014-06-30 13:13:28-04:00,"['462b2417e20384df25a699d3d565a3b93ae838a6', 'f36f43a1bd27df2f0ba1519ee84b8ba4ff7f6350']",125,408,533,2546930,10,,,,5928
31c84b6feb81a2e16a88b0197746e59d6ed63fc5,0,Saminda Wijeratne,2014-06-30 13:19:38-04:00,['98b738e9155b2b24a72477be8d3541cc66e1241e'],1,3,4,2546934,1,,,,5928
2fe5d9e3d09bba6d8b3dd169399603eedb5d190c,0,lahiru,2014-06-30 14:24:45-04:00,['31c84b6feb81a2e16a88b0197746e59d6ed63fc5'],33,82,115,2547049,2,0.065217391,0.065217391,1,5928
3a2c052c76dbf0df4c7a8500abb7a1cf4df5e063,1,Chathuri Wimalasena,2014-06-30 15:00:14-04:00,['2fe5d9e3d09bba6d8b3dd169399603eedb5d190c'],97,393,490,2547539,14,0.545454545,0.545454545,1,5928
45a73f4325c2f699cd810a87cc2fac69a65728a2,0,Suresh Marru,2014-06-30 15:12:28-04:00,['714702096b5c0c1670bbd3275e88becfe00de7c4'],0,8,8,2547547,1,,,,5928
506593c4887853adb5fc2fdcbb3aa530a1c57ef2,0,Suresh Marru,2014-06-30 15:23:09-04:00,"['45a73f4325c2f699cd810a87cc2fac69a65728a2', '3a2c052c76dbf0df4c7a8500abb7a1cf4df5e063']",434,1576,2010,2549557,38,,,,5928
3c2b11cb2fa6a20a3606950090dd7ae85500c36b,1,Chathuri Wimalasena,2014-06-30 15:54:10-04:00,['506593c4887853adb5fc2fdcbb3aa530a1c57ef2'],8,199,207,2549764,3,0.242774566,0.346820809,1,5928
76607a2137606ac2ec3bf85b2189d9eccefdfb06,1,Chathuri Wimalasena,2014-06-30 17:06:08-04:00,['3c2b11cb2fa6a20a3606950090dd7ae85500c36b'],51,680,731,2550495,21,0.219512195,0.508130081,1,5931
0aec0da4ca9a9ecae280cd05f1d8cb4e65e8ad7d,0,Suresh Marru,2014-06-30 18:50:22-04:00,['3f89830732a907061b56fa58afe4def10e6d2ab8'],0,29393,29393,2579888,77,0.340908058,0.492887334,0.933327274,6008
9800cd399dd20e7646e1bb8c024150cdefbe73e8,0,Suresh Marru,2014-06-30 18:54:11-04:00,['0aec0da4ca9a9ecae280cd05f1d8cb4e65e8ad7d'],29594,0,29594,2609482,78,0.659091942,0.507112666,0.066672726,6008
7034f503fafd864e516cd090ee48ae1f882a5b31,0,Suresh Marru,2014-06-30 18:54:40-04:00,"['76607a2137606ac2ec3bf85b2189d9eccefdfb06', '9800cd399dd20e7646e1bb8c024150cdefbe73e8']",0,29423,29423,2638905,78,,,,6008
c09963aaf0efd366548ac58bafdc9cd2399b771a,0,Suresh Marru,2014-06-30 23:01:33-04:00,['7034f503fafd864e516cd090ee48ae1f882a5b31'],25917,34811,60728,2699633,89,1,1,1,6016
465ca53d6a91542560fd3fd1d0ea2fdc797f52d3,0,Suresh Marru,2014-06-30 23:14:43-04:00,['c09963aaf0efd366548ac58bafdc9cd2399b771a'],135,78,213,2699846,17,,,,6016
01f648a5c6cf4b95122bac17cb373e01d9341fb7,1,Suresh Marru,2014-07-01 06:25:21-04:00,['465ca53d6a91542560fd3fd1d0ea2fdc797f52d3'],14678,14421,29099,2728945,15,1,0.684497817,0,6018
4d338df243292ca5b526285a9362cf63512695f8,0,Suresh Marru,2014-07-01 06:28:56-04:00,['01f648a5c6cf4b95122bac17cb373e01d9341fb7'],356,0,356,2729301,30,0,0,0,6018
409c9863ed906f7fe151cd483202b12e72d8639b,0,Suresh Marru,2014-07-01 06:48:02-04:00,['4d338df243292ca5b526285a9362cf63512695f8'],23,19,42,2729343,4,,,,6018
6a30776cdd0d35afa0b3d11097d99acd9f2fa1ac,0,msmemon,2014-07-01 13:39:19+02:00,['409c9863ed906f7fe151cd483202b12e72d8639b'],11,9,20,2729363,1,,,,6018
535ed32224f9e9cec319e6e0fb029e8d13e7bef5,1,Suresh Marru,2014-07-01 08:51:41-04:00,['409c9863ed906f7fe151cd483202b12e72d8639b'],11417,34611,46028,2775391,16,0.411203607,0.522256908,0.952537866,6024
f03e6ec54f8f6b80b9757b2e6ad4b506bf973a70,0,Suresh Marru,2014-07-01 08:51:57-04:00,"['535ed32224f9e9cec319e6e0fb029e8d13e7bef5', '6a30776cdd0d35afa0b3d11097d99acd9f2fa1ac']",11,9,20,2775411,1,,,,6024
a2a27146aa46829c34899cedb43864467d0834d2,1,Chathuri Wimalasena,2014-07-01 11:47:50-04:00,['f03e6ec54f8f6b80b9757b2e6ad4b506bf973a70'],20,470,490,2775901,10,0.525525526,0.582582583,1,6025
8456e5bffd6604b398d3c0f825d6bda1fded0ef9,1,Chathuri Wimalasena,2014-07-01 14:09:19-04:00,['a2a27146aa46829c34899cedb43864467d0834d2'],502,169,671,2776572,19,0.838842975,0.863636364,0,6025
81e2b9f8dcaa9b2b48196bda19aee25c781b0576,0,Chathuri Wimalasena,2014-07-01 14:15:16-04:00,['8456e5bffd6604b398d3c0f825d6bda1fded0ef9'],4,2,6,2776578,2,,,,6025
a30f8ae679b8b05b6643b8a6fde1b58383bf3ea4,1,Chathuri Wimalasena,2014-07-01 15:29:39-04:00,['81e2b9f8dcaa9b2b48196bda19aee25c781b0576'],15,61,76,2776654,8,0.259259259,0.740740741,1,6025
a460074a709d395595c073fb45a3119947b91210,0,Chathuri Wimalasena,2014-07-01 16:23:03-04:00,['a30f8ae679b8b05b6643b8a6fde1b58383bf3ea4'],5,139,144,2776798,2,0.533333333,1,0.8,6026
72654907f333cbe1947fedb5f8b7e033032c10dc,0,Suresh Marru,2014-07-01 22:13:55-04:00,['a460074a709d395595c073fb45a3119947b91210'],4,4,8,2776806,1,,,,6026
54d02d48fe31dcd9b45379c38faee45a11a9d963,1,Chathuri Wimalasena,2014-07-02 11:39:28-04:00,['72654907f333cbe1947fedb5f8b7e033032c10dc'],22,249,271,2777077,9,0.127388535,0.50955414,1,6027
85348aec99e734b8c0e49b1771ac06af3a9578f4,0,Saminda Wijeratne,2014-07-02 13:56:56-04:00,['54d02d48fe31dcd9b45379c38faee45a11a9d963'],55,66,121,2777198,9,0,0,1,6027
c60ba81c0a4a2b8f9f7399327b84642ba7607407,0,Chathuri Wimalasena,2014-07-02 14:06:03-04:00,['85348aec99e734b8c0e49b1771ac06af3a9578f4'],360,230,590,2777788,6,0.770491803,0.754098361,0,6027
ab566e1b66c769b8721823d3e2ca522b96396d82,1,Chathuri Wimalasena,2014-07-02 14:49:14-04:00,['c60ba81c0a4a2b8f9f7399327b84642ba7607407'],15,71,86,2777874,7,0,1,1,6027
bd9c12d0daff8a6e263ad3488b77117be2f72fb8,0,Chathuri Wimalasena,2014-07-02 16:06:13-04:00,['ab566e1b66c769b8721823d3e2ca522b96396d82'],0,205,205,2778079,3,0.841121495,1,0.261682243,6030
07c3f788dc8b0a4d81d2faa14ac0cd6112e0231f,1,Chathuri Wimalasena,2014-07-02 16:18:35-04:00,['bd9c12d0daff8a6e263ad3488b77117be2f72fb8'],81,81,162,2778241,9,,,,6030
720be0449de60c430b75c97d09d876e050b0be61,0,Saminda Wijeratne,2014-07-02 16:40:52-04:00,['c60ba81c0a4a2b8f9f7399327b84642ba7607407'],115,331,446,2778687,8,0.15862069,0.055172414,0.827586207,6030
1fc24132210e8ae9e88336b55eb852356d03529f,0,Saminda Wijeratne,2014-07-02 16:42:45-04:00,"['720be0449de60c430b75c97d09d876e050b0be61', '07c3f788dc8b0a4d81d2faa14ac0cd6112e0231f']",95,356,451,2779138,17,,,,6030
1ae4201d19f321626269200511647d6d8ef9d3c1,0,Saminda Wijeratne,2014-07-03 08:47:28-04:00,['1fc24132210e8ae9e88336b55eb852356d03529f'],1,1,2,2779140,1,,,,6030
169e6f9d167a1495556b1bffd23b4a5d367a2d4d,0,Suresh Marru,2014-07-03 10:09:56-04:00,['1ae4201d19f321626269200511647d6d8ef9d3c1'],36936,27,36963,2816103,33,0.510428715,0.408193724,0.02175292,6030
0a002531b7de367ebaa90b14a16f1859acde1b83,0,Suresh Marru,2014-07-03 10:15:04-04:00,['169e6f9d167a1495556b1bffd23b4a5d367a2d4d'],1293,31,1324,2817427,6,0.624636275,0.581959263,0,6031
15c863015480c4265fc671f496a5f940353aec86,0,Suresh Marru,2014-07-03 11:23:32-04:00,['0a002531b7de367ebaa90b14a16f1859acde1b83'],5,36,41,2817468,1,,,,6031
ca1662b7f916bdc77357d7f5ccd98b669aba1013,0,raminder,2014-07-03 11:32:24-04:00,['0a002531b7de367ebaa90b14a16f1859acde1b83'],133,110,243,2817711,26,,,,6032
2262500388ee719b042e1a30fb4fab06034dfb6f,0,raminder,2014-07-03 11:32:51-04:00,"['ca1662b7f916bdc77357d7f5ccd98b669aba1013', '15c863015480c4265fc671f496a5f940353aec86']",5,36,41,2817752,1,,,,6032
f0f3bf17a5db7d3a321f6b5af0016c8e314a2021,0,Suresh Marru,2014-07-03 11:45:03-04:00,['15c863015480c4265fc671f496a5f940353aec86'],7,7,14,2817766,1,,,,6032
efca3d60e90a25dcef1e04dcaf3df618709a737e,0,Suresh Marru,2014-07-03 11:45:18-04:00,"['f0f3bf17a5db7d3a321f6b5af0016c8e314a2021', '2262500388ee719b042e1a30fb4fab06034dfb6f']",133,110,243,2818009,26,,,,6032
527900b829678f238eafbb5dad1783950b40947d,0,Suresh Marru,2014-07-03 11:54:25-04:00,['efca3d60e90a25dcef1e04dcaf3df618709a737e'],0,1,1,2818010,1,,,,6032
4d109fd18301adbbe557e444bc25b2ce686d8413,1,Chathuri Wimalasena,2014-07-03 14:25:17-04:00,['527900b829678f238eafbb5dad1783950b40947d'],29,663,692,2818702,13,0.401069519,0.401069519,1,6035
2338739ead4370ea2b2f3f31482bf907fd171746,0,Suresh Marru,2014-07-03 15:28:10-04:00,['4d109fd18301adbbe557e444bc25b2ce686d8413'],41,139,180,2818882,1,,,,6035
52cedaccccbc78d09ffabaffe352e9907392619f,0,Suresh Marru,2014-07-03 16:04:09-04:00,['2338739ead4370ea2b2f3f31482bf907fd171746'],7,36,43,2818925,2,,,,6035
59a7443ac68488fb9ec4e9312bdbae33d1fa9e3a,1,Suresh Marru,2014-07-03 16:13:44-04:00,['52cedaccccbc78d09ffabaffe352e9907392619f'],757,14534,15291,2834216,31,0.353690865,0.400897227,0.993576672,6054
a7ce476c03ab129b08da452636c6a8a0959299e2,1,Chathuri Wimalasena,2014-07-03 16:53:32-04:00,['59a7443ac68488fb9ec4e9312bdbae33d1fa9e3a'],3,297,300,2834516,5,0.37037037,0.777777778,1,6056
cc191f90f841d8b6ffd28b08dc3ecfedf10501ac,0,Suresh Marru,2014-07-03 18:38:49-04:00,['a7ce476c03ab129b08da452636c6a8a0959299e2'],2,2,4,2834520,3,,,,6056
c4268c1e00fbef973df4c6ae1b52621d7d1fa69e,0,Suresh Marru,2014-07-03 22:38:50-04:00,['cc191f90f841d8b6ffd28b08dc3ecfedf10501ac'],1264,57,1321,2835841,4,0.724532225,0.724532225,0,6057
2c32d42b9ea7eba07c2e635071401ac391f1a8a1,1,Saminda Wijeratne,2014-07-04 20:06:52-04:00,['c4268c1e00fbef973df4c6ae1b52621d7d1fa69e'],37,2542,2579,2838420,23,0.293950178,0.533807829,0.965124555,6072
b103e797cb3de8c099cd49ba2fd3b131baa8da26,0,Saminda Wijeratne,2014-07-04 20:41:06-04:00,['2c32d42b9ea7eba07c2e635071401ac391f1a8a1'],2,2,4,2838424,1,,,,6072
e5688a7675692cdd2b0f17807ccc0ab202e13875,0,Suresh Marru,2014-07-04 20:43:14-04:00,['c4268c1e00fbef973df4c6ae1b52621d7d1fa69e'],1249,1996,3245,2841669,13,0.533333333,0.789333333,1,6074
429505a380481a79bd1326dcc8edd42819dd695c,0,Suresh Marru,2014-07-04 20:43:22-04:00,"['e5688a7675692cdd2b0f17807ccc0ab202e13875', 'b103e797cb3de8c099cd49ba2fd3b131baa8da26']",37,2542,2579,2844248,23,,,,6074
8288ee0fb980e602a7d2547ce555e08ac15c13f4,1,Saminda Wijeratne,2014-07-04 20:46:51-04:00,['b103e797cb3de8c099cd49ba2fd3b131baa8da26'],11,2089,2100,2846348,25,0.341540905,0.341540905,1,6087
2e04f68d079311b685365f60d532ad84941fb105,0,Saminda Wijeratne,2014-07-04 20:47:20-04:00,"['8288ee0fb980e602a7d2547ce555e08ac15c13f4', '429505a380481a79bd1326dcc8edd42819dd695c']",1249,1996,3245,2849593,13,,,,6087
d650ddbe224967308c49bf7175a77b3ec6da3674,0,Suresh Marru,2014-07-04 21:22:25-04:00,['2e04f68d079311b685365f60d532ad84941fb105'],25,26,51,2849644,2,,,,6087
c42adb46c1914ac07dde618cfba29487ddcc6221,1,Saminda Wijeratne,2014-07-04 21:28:16-04:00,['2e04f68d079311b685365f60d532ad84941fb105'],705,1742,2447,2852091,15,1,0.340277778,1,6094
30388a1083bad11c0596a89bf72e543e5f8487c4,0,Saminda Wijeratne,2014-07-04 21:28:31-04:00,"['c42adb46c1914ac07dde618cfba29487ddcc6221', 'd650ddbe224967308c49bf7175a77b3ec6da3674']",25,26,51,2852142,2,,,,6094
ae1fe88ad5b13af4e7103ffeb968d5b59a7ebac9,1,Saminda Wijeratne,2014-07-05 00:43:31-04:00,['30388a1083bad11c0596a89bf72e543e5f8487c4'],1411,2695,4106,2856248,32,0.542553191,0.740121581,1,6110
046e2fab9707dd770cd68896531299a851384625,1,Saminda Wijeratne,2014-07-05 00:44:29-04:00,['ae1fe88ad5b13af4e7103ffeb968d5b59a7ebac9'],6,7,13,2856261,1,,,,6110
b085e96fbbaff47c86d7d799bda7b7adb5dc23c1,1,Saminda Wijeratne,2014-07-05 01:01:48-04:00,['046e2fab9707dd770cd68896531299a851384625'],439,489,928,2857189,36,1,1,1,6112
097d955e3beeb9474e3418a6c2295cccce54832e,1,Saminda Wijeratne,2014-07-05 21:30:38-04:00,['b085e96fbbaff47c86d7d799bda7b7adb5dc23c1'],1012,1147,2159,2859348,10,0.921348315,0.74906367,0.056179775,6112
c18872cbe909a9a664b6969a074fd603d8326038,0,Saminda Wijeratne,2014-07-05 22:51:49-04:00,['097d955e3beeb9474e3418a6c2295cccce54832e'],3,0,3,2859351,1,,,,6112
fd5288a7bd7a1c0b0cdb6434c1f3d18bff6bf503,0,Saminda Wijeratne,2014-07-05 23:01:36-04:00,['c18872cbe909a9a664b6969a074fd603d8326038'],5,6,11,2859362,1,,,,6112
08245f259f41c7c7464d9dd23e918d22874be932,1,Suresh Marru,2014-07-05 23:04:11-04:00,['fd5288a7bd7a1c0b0cdb6434c1f3d18bff6bf503'],3335,11601,14936,2874298,14,0.409418549,0.533877943,0.951786,6112
b0062bbecf1bffb2804605da663ffd2dfbab85a8,1,Saminda Wijeratne,2014-07-05 23:09:33-04:00,['08245f259f41c7c7464d9dd23e918d22874be932'],0,64,64,2874362,2,1,1,1,6112
6a84bdb08d8957258a960ef275b4710dbb610bd7,1,Saminda Wijeratne,2014-07-05 23:26:15-04:00,['b0062bbecf1bffb2804605da663ffd2dfbab85a8'],8,51,59,2874421,2,0.972222222,1,1,6112
fa71e067a06fa8abe0ce83f271caf50cc9f25008,1,Saminda Wijeratne,2014-07-06 00:02:13-04:00,['6a84bdb08d8957258a960ef275b4710dbb610bd7'],0,18,18,2874439,6,1,1,1,6112
268dd34e984ad263f02b6ac8a39a58559e6a16f4,0,Suresh Marru,2014-07-06 00:11:41-04:00,['fa71e067a06fa8abe0ce83f271caf50cc9f25008'],186,0,186,2874625,1,,,,6112
2909ae969480e2a621bb553c15c3f3805268cf91,1,Saminda Wijeratne,2014-07-06 00:13:51-04:00,['fa71e067a06fa8abe0ce83f271caf50cc9f25008'],164,127,291,2874916,4,0.25,1,1,6112
b12dac5f7efdd6e632a6b3e38ecc68b5301a00c1,0,Saminda Wijeratne,2014-07-06 00:14:10-04:00,"['2909ae969480e2a621bb553c15c3f3805268cf91', '268dd34e984ad263f02b6ac8a39a58559e6a16f4']",186,0,186,2875102,1,,,,6112
e13ea829183b116810dfc056261a789b5032352f,0,Saminda Wijeratne,2014-07-06 00:20:19-04:00,['b12dac5f7efdd6e632a6b3e38ecc68b5301a00c1'],0,5,5,2875107,1,,,,6112
9d5f017086f716713f44927c5be878a7c2bfb85f,0,Suresh Marru,2014-07-06 00:31:45-04:00,['268dd34e984ad263f02b6ac8a39a58559e6a16f4'],106,106,212,2875319,10,,,,6112
4ccab010c1e213364cbc37ac174db79e8db51d9b,0,Suresh Marru,2014-07-06 00:31:56-04:00,"['9d5f017086f716713f44927c5be878a7c2bfb85f', 'e13ea829183b116810dfc056261a789b5032352f']",164,132,296,2875615,5,,,,6112
a9cdafd702f9c7f1aca705421081d55bdc7a67cf,1,Saminda Wijeratne,2014-07-06 00:34:25-04:00,['4ccab010c1e213364cbc37ac174db79e8db51d9b'],2,2,4,2875619,2,,,,6112
53d62d155d84215368ddb9ca5b9ab8e8c60d0ce4,0,Suresh Marru,2014-07-06 07:08:24-04:00,['a9cdafd702f9c7f1aca705421081d55bdc7a67cf'],4,54,58,2875677,2,1,1,1,6112
fe4ac34b87d3191faeec83c0213715be045f43a5,0,Suresh Marru,2014-07-06 09:40:24-04:00,['53d62d155d84215368ddb9ca5b9ab8e8c60d0ce4'],3376,0,3376,2879053,7,0.332995951,0.156376518,0.018724696,6112
10915860231515f91212510f48040e3b74757e9b,0,Suresh Marru,2014-07-06 15:02:55-04:00,['fe4ac34b87d3191faeec83c0213715be045f43a5'],93,307,400,2879453,5,0.116666667,0.258333333,0.983333333,6112
5ba1bb7b3b465fccb2a174bf27f2593cb0a70950,0,Suresh Marru,2014-07-06 15:21:31-04:00,['10915860231515f91212510f48040e3b74757e9b'],0,83,83,2879536,1,1,1,1,6113
b60c43e44ca2414f2305a1902cd1b1311680823d,1,Saminda Wijeratne,2014-07-06 15:23:28-04:00,['5ba1bb7b3b465fccb2a174bf27f2593cb0a70950'],1,30,31,2879567,7,0.722222222,0.722222222,1,6113
ec20d1e682fa3c4453550b5bf9f999f9768bb692,0,Saminda Wijeratne,2014-07-06 16:26:38-04:00,['b60c43e44ca2414f2305a1902cd1b1311680823d'],510,210,720,2880287,1,0.038095238,1,1,6113
192fc8b6630b75f3491ffe6b9abf48a1115afa43,0,Saminda Wijeratne,2014-07-06 16:33:11-04:00,['ec20d1e682fa3c4453550b5bf9f999f9768bb692'],9,131,140,2880427,2,,,,6113
fb09b38adc15d25f0db2d80f2106d262a216cc97,0,Saminda Wijeratne,2014-07-06 16:46:36-04:00,['192fc8b6630b75f3491ffe6b9abf48a1115afa43'],0,177,177,2880604,1,0.578512397,0.842975207,0,6114
989ee45809844ddec2b3f9bd0d62094a8c5fb2de,0,Saminda Wijeratne,2014-07-06 16:53:25-04:00,['fb09b38adc15d25f0db2d80f2106d262a216cc97'],2,2,4,2880608,2,,,,6114
ac050e79df9c2c5c2714c31d590ea242420f14b0,0,Saminda Wijeratne,2014-07-06 17:03:52-04:00,['989ee45809844ddec2b3f9bd0d62094a8c5fb2de'],2,10,12,2880620,2,,,,6114
cb1c4bf3a4543c663d40aa56be75a9d0fb4ae1ed,0,Saminda Wijeratne,2014-07-06 17:45:40-04:00,['ac050e79df9c2c5c2714c31d590ea242420f14b0'],2,2,4,2880624,2,,,,6114
c853ffd3fb64262a4d7cc065d037d09cc99132eb,0,Saminda Wijeratne,2014-07-06 17:56:10-04:00,['cb1c4bf3a4543c663d40aa56be75a9d0fb4ae1ed'],104,2,106,2880730,2,,,,6114
152acbf208ebb9e495360b492fbeba3a30f01f83,1,Suresh Marru,2014-07-06 23:00:59-04:00,['c853ffd3fb64262a4d7cc065d037d09cc99132eb'],3855,15470,19325,2900055,7,0.368540602,0.505394662,0.908006814,6114
8808aaa65cedf549c0c8bf2fa68d05bb1cfa4862,0,Saminda Wijeratne,2014-07-06 23:23:21-04:00,['152acbf208ebb9e495360b492fbeba3a30f01f83'],10,131,141,2900196,1,1,1,0.322033898,6114
f7008b97ce521bcae825a901a70e635c832ceafb,1,Suresh Marru,2014-07-06 23:55:41-04:00,['8808aaa65cedf549c0c8bf2fa68d05bb1cfa4862'],15807,39150,54957,2955153,7,0.397943532,0.527466909,0.95006533,6114
e085880b5b1691eb4b38bd02e96d8b9a5df7bf59,1,Suresh Marru,2014-07-07 00:30:22-04:00,['f7008b97ce521bcae825a901a70e635c832ceafb'],124,58,182,2955335,12,,,,6114
5328757d6a46ecdcab163bc0a92acdef71b70016,1,Suresh Marru,2014-07-07 00:51:19-04:00,['e085880b5b1691eb4b38bd02e96d8b9a5df7bf59'],17695,36881,54576,3009911,7,0.397394361,0.515819949,0.939753223,6114
2d5d054bcc33f1a2a782ac3aaae79909056dc776,1,Suresh Marru,2014-07-07 01:25:10-04:00,['5328757d6a46ecdcab163bc0a92acdef71b70016'],3264,7320,10584,3020495,7,0.409722222,0.474867725,0.949074074,6114
e36c04248cc7da64794dd70c25ce8a00a2d60004,0,Saminda Wijeratne,2014-07-07 01:32:53-04:00,['2d5d054bcc33f1a2a782ac3aaae79909056dc776'],99,68,167,3020662,2,1,0,0.6,6114
8e5f057e7f960baabce85929cd76f3418770aac7,1,Saminda Wijeratne,2014-07-07 08:44:01-04:00,['e36c04248cc7da64794dd70c25ce8a00a2d60004'],20,175,195,3020857,4,0.691729323,1,0.902255639,6114
c290a0444a383780758b583d7af77f8af8ef0631,0,Suresh Marru,2014-07-07 09:24:27-04:00,['8e5f057e7f960baabce85929cd76f3418770aac7'],0,5,5,3020862,1,,,,6114
0d4a7d1da618c2f7847cdd5daf50b36d9ec72908,1,Suresh Marru,2014-07-07 09:30:22-04:00,['c290a0444a383780758b583d7af77f8af8ef0631'],75,56,131,3020993,7,1,1,0,6114
964b6afd391e240cafb4dea76c624e4fabd3683d,0,lahiru,2014-07-07 09:44:56-04:00,['c290a0444a383780758b583d7af77f8af8ef0631'],359,590,949,3021942,14,0.166666667,0.790123457,0.956790123,6114
a022bbaded2862c41d71f60d50042d376e419ba6,0,lahiru,2014-07-07 09:45:46-04:00,"['964b6afd391e240cafb4dea76c624e4fabd3683d', '0d4a7d1da618c2f7847cdd5daf50b36d9ec72908']",75,56,131,3022073,7,,,,6114
25f4f5f01fbf3e7eb2690d5ec2b06e2eab6d3cfc,1,Chathuri Wimalasena,2014-07-07 10:09:47-04:00,['a022bbaded2862c41d71f60d50042d376e419ba6'],5,25,30,3022103,2,0.181818182,0.181818182,1,6114
2c54484dba97a43827aeaca4ada9265ded4fcb53,0,Suresh Marru,2014-07-07 10:36:15-04:00,['25f4f5f01fbf3e7eb2690d5ec2b06e2eab6d3cfc'],227,316,543,3022646,11,0.314685315,0.076923077,0,6114
66a672b0f82844ff0ba4d1302206da26779562b7,0,lahiru,2014-07-07 10:40:44-04:00,['a022bbaded2862c41d71f60d50042d376e419ba6'],4,177,181,3022827,2,0.494117647,0.741176471,1,6115
b2c2204c0aaf17a35b9abcebf1f2920183071d34,0,lahiru,2014-07-07 10:41:15-04:00,"['66a672b0f82844ff0ba4d1302206da26779562b7', '2c54484dba97a43827aeaca4ada9265ded4fcb53']",232,341,573,3023400,13,,,,6115
beb7471df9a0f2766a8a524cd6248ec925419174,1,Chathuri Wimalasena,2014-07-07 11:03:56-04:00,['b2c2204c0aaf17a35b9abcebf1f2920183071d34'],55,145,200,3023600,12,0.222222222,0.222222222,1,6115
2f3ece547f15bcabdaac2b841a4d2f3272a7b84f,1,Saminda Wijeratne,2014-07-07 11:52:36-04:00,['beb7471df9a0f2766a8a524cd6248ec925419174'],5,79,84,3023684,2,0.256756757,1,0.662162162,6115
b71499c89701c707095c928ab089fef9f3773a9d,0,Saminda Wijeratne,2014-07-07 11:53:50-04:00,['2f3ece547f15bcabdaac2b841a4d2f3272a7b84f'],1,0,1,3023685,1,0,0,0,6115
f5826458a90c10de7340d7b65348f1ca2672af6f,1,Chathuri Wimalasena,2014-07-07 11:56:17-04:00,['b71499c89701c707095c928ab089fef9f3773a9d'],152,174,326,3024011,8,0.198529412,1,1,6115
a509e5a431c62f3c61c7f86aaa6fbf49f33e41fe,0,Chathuri Wimalasena,2014-07-07 13:24:53-04:00,['f5826458a90c10de7340d7b65348f1ca2672af6f'],1,1,2,3024013,1,,,,6115
fa44d6277f4cc1b0261420cd01e40370bcd2bd65,1,Chathuri Wimalasena,2014-07-07 13:57:16-04:00,['a509e5a431c62f3c61c7f86aaa6fbf49f33e41fe'],128,555,683,3024696,14,0.313099042,0.313099042,1,6119
afe4141a3e7cedc71049695186ac061161fb49bb,0,Suresh Marru,2014-07-07 14:14:10-04:00,['fa44d6277f4cc1b0261420cd01e40370bcd2bd65'],1,1,2,3024698,1,,,,6119
0fde9bce730035ca44060bcf77ff3a566e9340b1,1,Suresh Marru,2014-07-07 14:32:08-04:00,['afe4141a3e7cedc71049695186ac061161fb49bb'],3140,7029,10169,3034867,7,0.391560014,0.459356624,0.947423037,6119
c7a330069980d952f92a2b788ff34cb7a6e07158,1,Chathuri Wimalasena,2014-07-07 14:53:00-04:00,['0fde9bce730035ca44060bcf77ff3a566e9340b1'],26,674,700,3035567,45,0.572062084,0.598669623,1,6119
9a7ee5b85c3865609d29112b58bfc65cc30af1fa,0,Chathuri Wimalasena,2014-07-07 15:02:55-04:00,['c7a330069980d952f92a2b788ff34cb7a6e07158'],2,27,29,3035596,1,0.24,1,1,6119
07e6009b18c70263b520bef52ef46a1ff1a8cb35,0,Saminda Wijeratne,2014-07-07 15:27:15-04:00,['9a7ee5b85c3865609d29112b58bfc65cc30af1fa'],54,72,126,3035722,1,0,0,0,6119
d9df541750987e0d9207790bb95d81e383eee333,1,Chathuri Wimalasena,2014-07-07 15:39:27-04:00,['07e6009b18c70263b520bef52ef46a1ff1a8cb35'],7,42,49,3035771,3,0,0.435897436,1,6119
a167caf9df094583c3173d57509e477d9b9317d4,0,Saminda Wijeratne,2014-07-07 15:43:10-04:00,['07e6009b18c70263b520bef52ef46a1ff1a8cb35'],26,26,52,3035823,1,1,0,0,6119
38c629e54de8f9bd338f6576d6b4f85198585118,0,Saminda Wijeratne,2014-07-07 15:43:23-04:00,"['a167caf9df094583c3173d57509e477d9b9317d4', 'd9df541750987e0d9207790bb95d81e383eee333']",7,42,49,3035872,3,,,,6119
a1b5882e6a4f3e0e9aebd9ee03ee9bccd7848e9d,0,Saminda Wijeratne,2014-07-07 15:46:06-04:00,['38c629e54de8f9bd338f6576d6b4f85198585118'],0,1,1,3035873,1,0,1,1,6119
2511edf47b383e8a73f48c00d9bccba326a3ade6,0,Saminda Wijeratne,2014-07-07 15:48:02-04:00,['a1b5882e6a4f3e0e9aebd9ee03ee9bccd7848e9d'],2,2,4,3035877,1,,,,6119
f96ff8903c681c67176615e85a1bb1765939af82,1,Saminda Wijeratne,2014-07-07 15:57:58-04:00,['2511edf47b383e8a73f48c00d9bccba326a3ade6'],1,1,2,3035879,1,,,,6119
0b881737067eeb2bf7a6226e4755e1e4a28eaaf4,1,Saminda Wijeratne,2014-07-07 16:02:32-04:00,['f96ff8903c681c67176615e85a1bb1765939af82'],6,8,14,3035893,1,0,1,1,6119
d76cf9e34dfc1eebd51de10a202f85b2a7c4bc72,0,Saminda Wijeratne,2014-07-07 16:10:38-04:00,['0b881737067eeb2bf7a6226e4755e1e4a28eaaf4'],0,10,10,3035903,2,0.3,0.9,0.6,6119
4d2805f86ef433421d5dc3f8c3fefc1e41924037,1,Chathuri Wimalasena,2014-07-07 16:19:43-04:00,['d76cf9e34dfc1eebd51de10a202f85b2a7c4bc72'],6,74,80,3035983,4,0.974358974,1,1,6119
7295d102532de1ae9262603d2d90b8e554d07824,0,Saminda Wijeratne,2014-07-07 16:20:31-04:00,['d76cf9e34dfc1eebd51de10a202f85b2a7c4bc72'],2,9,11,3035994,2,0,1,0,6119
8ac30e2c8e71df2bfd85679063029f5d3d7e0bba,0,Saminda Wijeratne,2014-07-07 16:20:51-04:00,"['7295d102532de1ae9262603d2d90b8e554d07824', '4d2805f86ef433421d5dc3f8c3fefc1e41924037']",6,74,80,3036074,4,,,,6119
55d3aeeb0aacfbf6c3aa7ada9245b432e8f6a6c6,0,Saminda Wijeratne,2014-07-07 16:28:30-04:00,['8ac30e2c8e71df2bfd85679063029f5d3d7e0bba'],1,1,2,3036076,1,,,,6119
58686d1a07580a52b1a7b964cf7c37945df99b88,0,Suresh Marru,2014-07-07 16:33:47-04:00,['0fde9bce730035ca44060bcf77ff3a566e9340b1'],48,737,785,3036861,10,0.223157895,0.288421053,1,6123
d52e8f78a3dcf002d1ec2ffa555cc2c5037810a3,0,Suresh Marru,2014-07-07 16:33:54-04:00,"['58686d1a07580a52b1a7b964cf7c37945df99b88', '55d3aeeb0aacfbf6c3aa7ada9245b432e8f6a6c6']",130,944,1074,3037935,53,,,,6123
43ee9ea2120c9bfbe02b2789a671c16b667462f2,1,Chathuri Wimalasena,2014-07-07 16:42:59-04:00,['d52e8f78a3dcf002d1ec2ffa555cc2c5037810a3'],1,29,30,3037965,9,0.684210526,0.789473684,1,6123
d6307719323a2888d97e71706599bd73ca3448c7,1,Saminda Wijeratne,2014-07-07 19:43:29-04:00,['55d3aeeb0aacfbf6c3aa7ada9245b432e8f6a6c6'],56,147,203,3038168,6,0.333333333,0,1,6123
ea351772781bb104b858577fb955caf1746d9d43,0,Saminda Wijeratne,2014-07-07 19:43:56-04:00,"['d6307719323a2888d97e71706599bd73ca3448c7', '43ee9ea2120c9bfbe02b2789a671c16b667462f2']",49,766,815,3038983,19,,,,6123
b70474ca5761e55811a3c69e24ccca803547aed9,0,Saminda Wijeratne,2014-07-07 21:17:54-04:00,['ea351772781bb104b858577fb955caf1746d9d43'],1,3,4,3038987,1,1,1,1,6123
3630458b21a3b3e9918f6b96c0f7e1e25f264c1a,1,Chathuri Wimalasena,2014-07-07 21:49:04-04:00,['b70474ca5761e55811a3c69e24ccca803547aed9'],2,132,134,3039121,4,0.205882353,0.970588235,1,6124
9c5d4bf24df8d2e3f0d2551ff58b791d86ea5fdc,0,Chathuri Wimalasena,2014-07-08 11:48:41-04:00,['3630458b21a3b3e9918f6b96c0f7e1e25f264c1a'],1010,467,1477,3040598,33,0.708061002,0.666666667,0.063180828,6124
76fb56db39a6cabc1168ceda7d8f2902b0efc7ed,0,Suresh Marru,2014-07-08 11:59:46-04:00,['3630458b21a3b3e9918f6b96c0f7e1e25f264c1a'],10,12,22,3040620,1,0,0,0,6124
cf945f01ad0f34d02f7a3fc654826aae540761ed,0,Suresh Marru,2014-07-08 12:00:04-04:00,"['76fb56db39a6cabc1168ceda7d8f2902b0efc7ed', '9c5d4bf24df8d2e3f0d2551ff58b791d86ea5fdc']",1010,467,1477,3042097,33,,,,6124
d1d3fae860faf508db8a01c6e54118384082aaa9,0,Suresh Marru,2014-07-08 12:33:26-04:00,['cf945f01ad0f34d02f7a3fc654826aae540761ed'],176,479,655,3042752,14,,,,6131
40198cc57cbfdb9c9e8d7e692b6ebe04988c8c2f,0,Chathuri Wimalasena,2014-07-08 13:05:41-04:00,['d1d3fae860faf508db8a01c6e54118384082aaa9'],15,50,65,3042817,2,0.041666667,1,1,6131
bdad5c67a0896d5e478c4d95ac5dc73904b1d37a,0,Saminda Wijeratne,2014-07-08 13:22:46-04:00,['40198cc57cbfdb9c9e8d7e692b6ebe04988c8c2f'],2,2,4,3042821,1,,,,6131
5d6cb2911a3dd9a8e1d2604b7cb5538e1103d27a,1,Chathuri Wimalasena,2014-07-08 13:35:07-04:00,['bdad5c67a0896d5e478c4d95ac5dc73904b1d37a'],0,21,21,3042842,2,0,1,1,6131
a34c0d9f2caf77b2b58ea00641db7fa36f3ec86f,0,Saminda Wijeratne,2014-07-08 13:41:57-04:00,['5d6cb2911a3dd9a8e1d2604b7cb5538e1103d27a'],9,18,27,3042869,1,0,0,0,6131
e53cba93e5ff9be9f5239801244f2a11a2233c78,0,Suresh Marru,2014-07-08 13:54:44-04:00,['d1d3fae860faf508db8a01c6e54118384082aaa9'],3,3,6,3042875,1,,,,6131
962389c91236f14e9c43b4d801fbb7bb29bc60b9,0,Suresh Marru,2014-07-08 13:54:51-04:00,"['e53cba93e5ff9be9f5239801244f2a11a2233c78', 'a34c0d9f2caf77b2b58ea00641db7fa36f3ec86f']",26,91,117,3042992,6,,,,6131
d953a3f9fca179dd2e7c8537f9d7696241a46ba6,0,Saminda Wijeratne,2014-07-08 14:18:11-04:00,['a34c0d9f2caf77b2b58ea00641db7fa36f3ec86f'],1,4,5,3042997,2,,,,6131
a33dd2a91f920ee3b4190af863eb1b27bae7b6d2,0,Chathuri Wimalasena,2014-07-08 14:19:16-04:00,['962389c91236f14e9c43b4d801fbb7bb29bc60b9'],33,55,88,3043085,12,0,0,1,6131
f8f280f967b5e1cd5e314fffca1ee7bb08256b02,0,Saminda Wijeratne,2014-07-08 14:19:26-04:00,['d953a3f9fca179dd2e7c8537f9d7696241a46ba6'],3,2,5,3043090,2,1,0,0,6131
ea73b0be9a495549ad19391930b0befebea4e13e,0,Saminda Wijeratne,2014-07-08 14:20:13-04:00,['f8f280f967b5e1cd5e314fffca1ee7bb08256b02'],2,2,4,3043094,2,,,,6131
6ed83484164c288e3ca422bb82a3bc543784c912,0,Saminda Wijeratne,2014-07-08 14:20:38-04:00,['ea73b0be9a495549ad19391930b0befebea4e13e'],1,1,2,3043096,1,,,,6131
e53dd346b13c86c07448d5fd108e3924c10da5b8,0,Saminda Wijeratne,2014-07-08 14:21:25-04:00,"['6ed83484164c288e3ca422bb82a3bc543784c912', 'a33dd2a91f920ee3b4190af863eb1b27bae7b6d2']",36,58,94,3043190,13,,,,6131
5c00a8c5bd8b0c350be96b30d4ab58488d8c05cc,0,Saminda Wijeratne,2014-07-08 14:41:14-04:00,['e53dd346b13c86c07448d5fd108e3924c10da5b8'],1,1,2,3043192,1,,,,6131
c6bf09089b559afd19c6fac0625938ec910e8399,0,Saminda Wijeratne,2014-07-08 16:50:07-04:00,['5c00a8c5bd8b0c350be96b30d4ab58488d8c05cc'],18,2,20,3043212,1,0,0,0,6131
de2f7ceb9671ba60a4a2373563c17e14e7aa7362,0,Saminda Wijeratne,2014-07-08 16:51:51-04:00,['c6bf09089b559afd19c6fac0625938ec910e8399'],190,190,380,3043592,5,0.649484536,0,0,6131
b26219fe3ac9020e3319c32aba36aed0b19b7878,0,Chathuri Wimalasena,2014-07-08 16:56:59-04:00,['de2f7ceb9671ba60a4a2373563c17e14e7aa7362'],431,41,472,3044064,2,0.753246753,0.035714286,0.181818182,6131
8dc80579f695c0e8852d8182af422320b7f5254b,0,Chathuri Wimalasena,2014-07-08 17:22:01-04:00,['b26219fe3ac9020e3319c32aba36aed0b19b7878'],183,64,247,3044311,6,0.900990099,1,0.108910891,6131
4639e381050e33808086bceb72e191991843d71b,0,Chathuri Wimalasena,2014-07-08 17:27:19-04:00,['8dc80579f695c0e8852d8182af422320b7f5254b'],1,0,1,3044312,1,0,0,1,6131
d0a8c443f491762863057e4a8a125f9ebce7e12a,0,Saminda Wijeratne,2014-07-08 21:19:07-04:00,['de2f7ceb9671ba60a4a2373563c17e14e7aa7362'],22,35,57,3044369,1,0,0,0,6131
fe2fec56bb742a493a34425589607a06b137f847,1,Saminda Wijeratne,2014-07-08 21:19:16-04:00,['d0a8c443f491762863057e4a8a125f9ebce7e12a'],5,5,10,3044379,2,,,,6131
98f60f3b563603d63bbf13231be1ed943e0f4ea4,0,Saminda Wijeratne,2014-07-08 21:19:34-04:00,"['fe2fec56bb742a493a34425589607a06b137f847', '4639e381050e33808086bceb72e191991843d71b']",602,92,694,3045073,8,,,,6131
8318768fc3f3249a08620aeba3eff33fb8ae4efb,0,Chathuri Wimalasena,2014-07-08 23:45:48-04:00,['98f60f3b563603d63bbf13231be1ed943e0f4ea4'],177,38,215,3045288,6,0.991596639,0.663865546,0.008403361,6131
6d0d4f15a40bdba91af4ef95821c36a94bdba020,0,lahiru,2014-07-09 00:11:28-04:00,['98f60f3b563603d63bbf13231be1ed943e0f4ea4'],31,49,80,3045368,6,0,1,1,6131
7661ac6010065306d5be90a99c56939743a39dec,0,lahiru,2014-07-09 00:12:15-04:00,"['6d0d4f15a40bdba91af4ef95821c36a94bdba020', '8318768fc3f3249a08620aeba3eff33fb8ae4efb']",177,38,215,3045583,6,,,,6131
36393ace37881474c213c05a8f84e488e191ec45,0,Saminda Wijeratne,2014-07-09 10:41:58-04:00,['7661ac6010065306d5be90a99c56939743a39dec'],0,66,66,3045649,1,0,1,1,6131
28fd065ece638940e58e1e56623342b2f0ce4ceb,0,Saminda Wijeratne,2014-07-09 10:50:10-04:00,['36393ace37881474c213c05a8f84e488e191ec45'],6,6,12,3045661,1,,,,6131
3b9fae4e14da0b045a679a6f45bda999c62a72af,0,Suresh Marru,2014-07-09 11:07:29-04:00,['7661ac6010065306d5be90a99c56939743a39dec'],21,72,93,3045754,6,,,,6132
dfb744d28a337df456babf433e85946b9f3a52c6,0,Suresh Marru,2014-07-09 11:07:36-04:00,"['3b9fae4e14da0b045a679a6f45bda999c62a72af', '28fd065ece638940e58e1e56623342b2f0ce4ceb']",6,72,78,3045832,2,,,,6132
58e8fb9f96d3837706d2334ebbb1a39bf40bf7c0,0,Saminda Wijeratne,2014-07-09 11:23:50-04:00,['dfb744d28a337df456babf433e85946b9f3a52c6'],2,3,5,3045837,1,0,1,1,6132
bfaf8175965b55cd9f38df0b094d1dd6cd922962,0,lahiru,2014-07-09 12:03:15-04:00,['dfb744d28a337df456babf433e85946b9f3a52c6'],15,15,30,3045867,2,1,1,0,6132
407dbbc866ff64daa8a71d2f5d5180a609690d37,0,lahiru,2014-07-09 12:03:45-04:00,"['bfaf8175965b55cd9f38df0b094d1dd6cd922962', '58e8fb9f96d3837706d2334ebbb1a39bf40bf7c0']",2,3,5,3045872,1,,,,6132
a125a6b61d100fa627340107d902242566a50474,0,Suresh Marru,2014-07-09 12:04:11-04:00,['dfb744d28a337df456babf433e85946b9f3a52c6'],0,79,79,3045951,1,,,,6133
7e2c4f03a84401a60b3bc2cfd2de5a674ad0bd2d,0,Suresh Marru,2014-07-09 12:04:17-04:00,"['a125a6b61d100fa627340107d902242566a50474', '407dbbc866ff64daa8a71d2f5d5180a609690d37']",17,18,35,3045986,3,,,,6133
417a31093f9cf390dd84ca1d7ade71a780c2cc5f,1,Chathuri Wimalasena,2014-07-09 12:30:03-04:00,['7e2c4f03a84401a60b3bc2cfd2de5a674ad0bd2d'],26,30,56,3046042,2,0,0,1,6133
2bd6d33349b6b0a9b4a92e7d8ebe945533dbf393,0,Saminda Wijeratne,2014-07-09 12:42:23-04:00,['58e8fb9f96d3837706d2334ebbb1a39bf40bf7c0'],2,15,17,3046059,2,,,,6133
4244103cb6281c708c1d81cd21776143434fa288,0,Saminda Wijeratne,2014-07-09 12:42:49-04:00,"['2bd6d33349b6b0a9b4a92e7d8ebe945533dbf393', '417a31093f9cf390dd84ca1d7ade71a780c2cc5f']",36,119,155,3046214,4,,,,6133
b61f6a071eec2b4eababbee070d46b02e4b79e51,0,Suresh Marru,2014-07-09 12:50:46-04:00,['417a31093f9cf390dd84ca1d7ade71a780c2cc5f'],731,147,878,3047092,22,0,0,0,6133
607dd92ba460bfcfd9e49beaa1b3aa5e0c84b4ad,0,Suresh Marru,2014-07-09 12:50:52-04:00,"['b61f6a071eec2b4eababbee070d46b02e4b79e51', '4244103cb6281c708c1d81cd21776143434fa288']",2,15,17,3047109,2,,,,6133
1725ccb5eaed9eabd650ae59909342e1dbed9994,1,Chathuri Wimalasena,2014-07-09 13:31:54-04:00,['607dd92ba460bfcfd9e49beaa1b3aa5e0c84b4ad'],22,30,52,3047161,1,0,0,1,6133
e796062babe0e3d9c850bf8f4119f33a74ee328f,0,Suresh Marru,2014-07-09 14:09:23-04:00,['607dd92ba460bfcfd9e49beaa1b3aa5e0c84b4ad'],1519,1526,3045,3050206,48,,,,6133
4a8e95766626eb4e836bfe966b9a86028c376f12,0,Suresh Marru,2014-07-09 14:09:29-04:00,"['e796062babe0e3d9c850bf8f4119f33a74ee328f', '1725ccb5eaed9eabd650ae59909342e1dbed9994']",22,30,52,3050258,1,,,,6133
8577cea4043bea1ed518cffb10868c32b177edce,0,Saminda Wijeratne,2014-07-09 14:13:29-04:00,['4244103cb6281c708c1d81cd21776143434fa288'],0,124,124,3050382,3,,,,6135
fa6e188b229e421180741ef22dc6a7f867202589,0,Saminda Wijeratne,2014-07-09 14:13:58-04:00,"['8577cea4043bea1ed518cffb10868c32b177edce', '4a8e95766626eb4e836bfe966b9a86028c376f12']",2272,1703,3975,3054357,71,,,,6135
57c4e99ec5041809ac19a8d7cab5a2d38a4e2593,0,Chathuri Wimalasena,2014-07-09 14:22:34-04:00,['fa6e188b229e421180741ef22dc6a7f867202589'],1,4,5,3054362,4,0.666666667,1,1,6135
850c4a387bc592d2b28b090d62cc2cdf076a8133,1,samindaw,2014-07-09 11:27:43-07:00,['fa6e188b229e421180741ef22dc6a7f867202589'],0,15158,15158,3069520,19,0.42549937,0.539949613,0.94988303,6152
6d62eda8b4d9e26f6a8eb8b0a21aab69cb32c031,0,samindaw,2014-07-09 11:28:03-07:00,"['850c4a387bc592d2b28b090d62cc2cdf076a8133', '57c4e99ec5041809ac19a8d7cab5a2d38a4e2593']",1,4,5,3069525,4,,,,6152
b04478b363d5548c1639bbdb70714dde8f9fe349,0,Saminda Wijeratne,2014-07-09 15:33:47-04:00,['6d62eda8b4d9e26f6a8eb8b0a21aab69cb32c031'],608,203,811,3070336,7,0.607843137,0.784313725,1,6153
40d6a8517dad40e8f9fc88eaf299cc693cb1c980,0,samindaw,2014-07-09 12:35:31-07:00,['b04478b363d5548c1639bbdb70714dde8f9fe349'],183,34,217,3070553,5,1,0.916030534,0.183206107,6153
533129f898b419117bed6ad5f89c4ad08de5e671,0,Chathuri Wimalasena,2014-07-09 15:39:50-04:00,['40d6a8517dad40e8f9fc88eaf299cc693cb1c980'],0,7,7,3070560,1,0,1,1,6153
fcbbc7e687f4d974fa48eea8750055a6899f1d62,0,lahiru,2014-07-09 15:50:57-04:00,['533129f898b419117bed6ad5f89c4ad08de5e671'],136,54,190,3070750,10,1,1,0,6153
53edab460fc63f4244f7e5b6c70fabe1980a4c92,1,Chathuri Wimalasena,2014-07-09 16:25:24-04:00,['fcbbc7e687f4d974fa48eea8750055a6899f1d62'],6,15,21,3070771,3,0,1,1,6153
5e5ee1b624a3e45dd1e9ddc814a015eb6efead86,0,Saminda Wijeratne,2014-07-09 16:28:17-04:00,['fcbbc7e687f4d974fa48eea8750055a6899f1d62'],1,2,3,3070774,1,0,1,1,6153
e2ebec172fad64b04c1518491258c32d9afb3e93,0,Saminda Wijeratne,2014-07-09 16:28:56-04:00,"['5e5ee1b624a3e45dd1e9ddc814a015eb6efead86', '53edab460fc63f4244f7e5b6c70fabe1980a4c92']",6,15,21,3070795,3,,,,6153
bee906831ba31ba9f9531b6a1bdf5daaa0501c3f,0,Suresh Marru,2014-07-09 16:51:59-04:00,['e2ebec172fad64b04c1518491258c32d9afb3e93'],2,2,4,3070799,1,,,,6153
567437a27d8540495e8e5ff62d94f7d0884d991e,0,Suresh Marru,2014-07-09 21:41:48-04:00,['bee906831ba31ba9f9531b6a1bdf5daaa0501c3f'],12,5,17,3070816,1,1,0,0,6153
210ebad3bdc33cbf07729749ac82f9d220e62ef7,0,Suresh Marru,2014-07-09 23:11:30-04:00,['567437a27d8540495e8e5ff62d94f7d0884d991e'],322,344,666,3071482,8,0.217391304,0.217391304,0.652173913,6153
afdba81cc5902b3e72dd95021e38d8b4c1734da9,0,Chathuri Wimalasena,2014-07-10 10:20:58-04:00,['210ebad3bdc33cbf07729749ac82f9d220e62ef7'],1,1,2,3071484,1,,,,6153
78cd7b3246aa2d9468efbe9f48b90cb3f6f1ecc4,1,Chathuri Wimalasena,2014-07-10 11:22:45-04:00,['afdba81cc5902b3e72dd95021e38d8b4c1734da9'],3,15,18,3071502,1,0,0,1,6153
7d72e22fec64ccd83099e6a7e903c73ecb17d1bb,1,Chathuri Wimalasena,2014-07-10 11:50:23-04:00,['78cd7b3246aa2d9468efbe9f48b90cb3f6f1ecc4'],22,22,44,3071546,1,,,,6153
f891b7dcbc7ce214fa9a0e2b1e73f2fd2c838e24,0,ixxi-2013,2014-07-10 18:19:55+02:00,['210ebad3bdc33cbf07729749ac82f9d220e62ef7'],0,105384,105384,3176930,226,0.318107356,0.402624254,0.870727634,6379
4925c2e3ad0cb6549b1705270039c99ce5d083c5,0,lahiru,2014-07-10 13:09:09-04:00,['afdba81cc5902b3e72dd95021e38d8b4c1734da9'],109,123,232,3177162,2,0,0.125,0.125,6379
8ea2f0e980ddb74518df532f70f964b08a5eeb2c,0,lahiru,2014-07-10 13:09:45-04:00,"['4925c2e3ad0cb6549b1705270039c99ce5d083c5', '7d72e22fec64ccd83099e6a7e903c73ecb17d1bb']",25,37,62,3177224,2,,,,6379
85a2c4a23d16d2f5ab08a2fdded9f710d29065e4,1,Chathuri Wimalasena,2014-07-10 15:23:44-04:00,['8ea2f0e980ddb74518df532f70f964b08a5eeb2c'],24,38,62,3177286,4,0,1,1,6379
e5dbd05acd7c21d84ecc711d82224d7abfdacea6,0,Saminda Wijeratne,2014-07-10 15:42:49-04:00,['fcbbc7e687f4d974fa48eea8750055a6899f1d62'],1,1,2,3177288,1,,,,6379
2c968136952ad370f34344a6c5310e754dc865ec,0,Saminda Wijeratne,2014-07-10 15:43:35-04:00,"['e5dbd05acd7c21d84ecc711d82224d7abfdacea6', '85a2c4a23d16d2f5ab08a2fdded9f710d29065e4']",499,564,1063,3178351,19,,,,6379
6c52e86584273f2324f045cf3f3c01397a6afcbd,0,Saminda Wijeratne,2014-07-10 15:46:24-04:00,['2c968136952ad370f34344a6c5310e754dc865ec'],1,1,2,3178353,1,,,,6379
3c4c5840b104acf90af3f8e1f4f80a007998e2dd,0,Saminda Wijeratne,2014-07-10 16:01:43-04:00,['6c52e86584273f2324f045cf3f3c01397a6afcbd'],2,2,4,3178357,1,,,,6379
eeefbc2b6e3587a76b1d21f9b209c1bfbdde6fcc,0,Chathuri Wimalasena,2014-07-10 16:22:58-04:00,['3c4c5840b104acf90af3f8e1f4f80a007998e2dd'],7,5,12,3178369,1,0,0,0,6379
ea7c19be06a78a49ea28af32183fae13f2959a4f,0,raminder,2014-07-10 16:32:01-04:00,['eeefbc2b6e3587a76b1d21f9b209c1bfbdde6fcc'],8,10,18,3178387,2,,,,6379
672d146dd3c96733f7bb4c95ad6139d971b7d6a0,0,Suresh Marru,2014-07-10 17:11:28-04:00,['ea7c19be06a78a49ea28af32183fae13f2959a4f'],9,157,166,3178553,4,,,,6382
743d9cfea2dc63ee55cb876bea3b59f50a0afbec,0,lahiru,2014-07-10 17:40:19-04:00,['8ea2f0e980ddb74518df532f70f964b08a5eeb2c'],171,304,475,3179028,7,0.065217391,0.989130435,0.989130435,6382
8b3b25478404af13b6ca7d18cb64815ae69f7273,0,lahiru,2014-07-10 17:40:54-04:00,"['743d9cfea2dc63ee55cb876bea3b59f50a0afbec', '672d146dd3c96733f7bb4c95ad6139d971b7d6a0']",51,213,264,3179292,13,,,,6382
12fd04e5fad352b1fbe21c708aa379c9754ee318,0,lahiru,2014-07-10 18:04:24-04:00,['8b3b25478404af13b6ca7d18cb64815ae69f7273'],1,1,2,3179294,1,,,,6382
5a43021528fe0e87722ff72ddcd0c3e639a34d10,0,lahiru,2014-07-10 19:12:01-04:00,['12fd04e5fad352b1fbe21c708aa379c9754ee318'],1,1,2,3179296,1,,,,6382
00b8aaf0521ecfc17b0dc4ef53fc30376d4716be,0,ixxi-2013,2014-07-11 11:50:12+02:00,['f891b7dcbc7ce214fa9a0e2b1e73f2fd2c838e24'],71683,34,71717,3251013,82,0.731489193,0.667102915,0.122585762,6382
81ad6eadf2df50a5f9abfbbe8f18fe6f98fc63d1,0,ixxi-2013,2014-07-11 11:51:54+02:00,['00b8aaf0521ecfc17b0dc4ef53fc30376d4716be'],55,0,55,3251068,2,,,,6382
ff8f14c27c646dd64fd323ac47498d0bba28d7f2,0,ixxi-2013,2014-07-11 12:08:36+02:00,['81ad6eadf2df50a5f9abfbbe8f18fe6f98fc63d1'],1,1,2,3251070,1,,,,6382
b6392ef33f780dc53ebe18f2782415820bffc543,0,Suresh Marru,2014-07-11 07:57:55-04:00,['5a43021528fe0e87722ff72ddcd0c3e639a34d10'],6,582,588,3251658,6,0.331147541,0.937704918,0.590163934,6385
3e151ce37690a1664b2a18747153ef12466e82ec,0,Suresh Marru,2014-07-11 09:17:32-04:00,['b6392ef33f780dc53ebe18f2782415820bffc543'],31,148,179,3251837,2,0.41025641,0.948717949,0.666666667,6385
c37054be449b70b62b7fd19aa1acc04aa2fbef55,1,Chathuri Wimalasena,2014-07-11 10:14:31-04:00,['3e151ce37690a1664b2a18747153ef12466e82ec'],153,223,376,3252213,2,0.771428571,1,1,6385
1c5b22ac2c88d954f910e5a670eb95c13ffffa74,0,raminder,2014-07-11 11:22:21-04:00,['c37054be449b70b62b7fd19aa1acc04aa2fbef55'],0,10,10,3252223,1,0,0,1,6385
d8059128e41b4f3f9984fa0f631d51ef592ba3ff,0,Chathuri Wimalasena,2014-07-11 11:28:57-04:00,['1c5b22ac2c88d954f910e5a670eb95c13ffffa74'],18,44,62,3252285,1,0,0,1,6385
2beace387b507a1467447e8df9b3456011b93dc0,0,Chathuri Wimalasena,2014-07-11 11:35:31-04:00,['d8059128e41b4f3f9984fa0f631d51ef592ba3ff'],6,18,24,3252309,1,0,0,1,6385
90569d84317fbd18f774415962d0715c08e85352,0,raminder,2014-07-11 12:20:02-04:00,['1c5b22ac2c88d954f910e5a670eb95c13ffffa74'],0,6,6,3252315,1,0,0,1,6385
c3ca7af335eb4b7d0ead2f66685c5078f3398331,0,raminder,2014-07-11 12:20:07-04:00,"['90569d84317fbd18f774415962d0715c08e85352', '2beace387b507a1467447e8df9b3456011b93dc0']",24,62,86,3252401,2,,,,6385
d813b8b1bba5f64c0b23795cefcb6d32a10abb84,0,Saminda Wijeratne,2014-07-11 12:30:30-04:00,['c37054be449b70b62b7fd19aa1acc04aa2fbef55'],3,2,5,3252406,2,,,,6385
f21be5526b12dc80b18da22d169b90752e36ba66,0,Saminda Wijeratne,2014-07-11 12:30:45-04:00,"['d813b8b1bba5f64c0b23795cefcb6d32a10abb84', 'c3ca7af335eb4b7d0ead2f66685c5078f3398331']",24,78,102,3252508,4,,,,6385
383373e1294a37d2888a63d52843a2a40b945ae3,0,Saminda Wijeratne,2014-07-11 13:29:40-04:00,['f21be5526b12dc80b18da22d169b90752e36ba66'],3,2,5,3252513,2,1,0,0,6385
f903d84e2df41e526dcb39cec89035f257bf1568,0,Suresh Marru,2014-07-11 13:58:50-04:00,['3e151ce37690a1664b2a18747153ef12466e82ec'],59,353,412,3252925,2,0.052631579,1,1,6385
8a6298998d286f5d03662c617fe1c1824c02376a,0,Suresh Marru,2014-07-11 13:58:56-04:00,"['f903d84e2df41e526dcb39cec89035f257bf1568', '383373e1294a37d2888a63d52843a2a40b945ae3']",183,305,488,3253413,9,,,,6385
40c5db4f4cd8797b5e4bf065ee8c22b3ab7d00ba,0,Chathuri Wimalasena,2014-07-11 14:47:17-04:00,['8a6298998d286f5d03662c617fe1c1824c02376a'],4,13,17,3253430,1,1,1,1,6385
da56dcbb170b7d8ccae77af50121a25c120fbcc6,0,lahiru,2014-07-11 14:57:13-04:00,['5a43021528fe0e87722ff72ddcd0c3e639a34d10'],1052,154,1206,3254636,7,0.694072658,0.248565966,0.028680688,6385
50c747567c4e744d6b810a6d14837d945ed5f224,0,lahiru,2014-07-11 14:57:49-04:00,"['da56dcbb170b7d8ccae77af50121a25c120fbcc6', '40c5db4f4cd8797b5e4bf065ee8c22b3ab7d00ba']",193,1311,1504,3256140,16,,,,6385
f13b4eb0eb54ec0f8d9789490cad6a44b5deb5da,0,raminder,2014-07-11 15:14:23-04:00,['50c747567c4e744d6b810a6d14837d945ed5f224'],0,20,20,3256160,1,0,0,1,6385
4e192562d367e2dea4f7b5a920522de12af7b155,1,Saminda Wijeratne,2014-07-11 15:25:25-04:00,['50c747567c4e744d6b810a6d14837d945ed5f224'],16,35,51,3256211,2,0,0,1,6385
d64741c74ced10c10dc377304864bdddcd92af10,0,Saminda Wijeratne,2014-07-11 15:25:36-04:00,"['4e192562d367e2dea4f7b5a920522de12af7b155', 'f13b4eb0eb54ec0f8d9789490cad6a44b5deb5da']",0,20,20,3256231,1,,,,6385
0714710f187ee10da39361c72522445f423459d6,0,Saminda Wijeratne,2014-07-11 15:53:21-04:00,['d64741c74ced10c10dc377304864bdddcd92af10'],4,4,8,3256239,2,,,,6385
add6eee8209653cb66f0e58d9cf47a4a8b19bd5a,0,lahiru,2014-07-11 15:56:37-04:00,['d64741c74ced10c10dc377304864bdddcd92af10'],2,244,246,3256485,2,0,1,1,6385
95d35adefddad7c1e1ff8cc25c5e71f15d82bf50,0,lahiru,2014-07-11 15:57:07-04:00,"['add6eee8209653cb66f0e58d9cf47a4a8b19bd5a', '0714710f187ee10da39361c72522445f423459d6']",4,4,8,3256493,2,,,,6385
8121d469966b944ea2e74d5134bf9e6d6a43b57d,0,Saminda Wijeratne,2014-07-11 16:27:40-04:00,['0714710f187ee10da39361c72522445f423459d6'],831,1094,1925,3258418,3,0,0.336099585,0.68879668,6385
7a378a6b430135d3d11f754e08364630a7e43a85,0,Saminda Wijeratne,2014-07-11 16:29:28-04:00,"['8121d469966b944ea2e74d5134bf9e6d6a43b57d', '95d35adefddad7c1e1ff8cc25c5e71f15d82bf50']",2,244,246,3258664,2,,,,6385
beb139e85482cfe253038dc364313a99d69fccc5,0,Saminda Wijeratne,2014-07-11 16:49:20-04:00,['7a378a6b430135d3d11f754e08364630a7e43a85'],1,1,2,3258666,1,,,,6385
fcfbec3c8266fb6ec38170eed2335dfd0844b180,0,Suresh Marru,2014-07-11 17:20:43-04:00,['beb139e85482cfe253038dc364313a99d69fccc5'],47,86,133,3258799,4,0,1,0.827586207,6386
8117f63324b9ea551556eb2fa2bdd2fe54c41a64,0,raminder,2014-07-11 17:31:53-04:00,['fcfbec3c8266fb6ec38170eed2335dfd0844b180'],5,5,10,3258809,1,1,1,0,6386
21ffc69aab6bb6dbe99777dba0bb0c0a623b9ccf,0,lahiru,2014-07-11 18:01:42-04:00,['95d35adefddad7c1e1ff8cc25c5e71f15d82bf50'],6,6,12,3258821,1,,,,6386
eed477b8d0872d907e932ea89de312c3ee33b104,0,lahiru,2014-07-11 18:02:05-04:00,"['21ffc69aab6bb6dbe99777dba0bb0c0a623b9ccf', '8117f63324b9ea551556eb2fa2bdd2fe54c41a64']",884,1186,2070,3260891,8,,,,6386
8d116e9227f8283aaeb15670a1969e36dab9428c,0,Saminda Wijeratne,2014-07-11 18:11:09-04:00,['8117f63324b9ea551556eb2fa2bdd2fe54c41a64'],2,3,5,3260896,1,0,1,1,6386
3e6c815a5f072db11fef133304c5557c9cc1181a,0,Saminda Wijeratne,2014-07-11 18:19:42-04:00,['8d116e9227f8283aaeb15670a1969e36dab9428c'],24258,7788,32046,3292942,169,0.599497039,0.348584408,0.110245802,6387
feb30440068ea9f2ea3030c6ac9006412c8772eb,0,Saminda Wijeratne,2014-07-11 18:20:47-04:00,"['3e6c815a5f072db11fef133304c5557c9cc1181a', 'eed477b8d0872d907e932ea89de312c3ee33b104']",6,6,12,3292954,1,,,,6387
606388efac223d8a287a66dc01ce5bc587cc7c1d,0,lahiru,2014-07-11 18:38:38-04:00,['feb30440068ea9f2ea3030c6ac9006412c8772eb'],2,3,5,3292959,2,0,0,0,6387
1416f2ffc4cba89eba1ed547539589cd071f450b,0,lahiru,2014-07-11 18:59:41-04:00,['606388efac223d8a287a66dc01ce5bc587cc7c1d'],1,1,2,3292961,1,,,,6387
498c5c59fc9a1a6436fae3e839772a36ae53755f,0,Suresh Marru,2014-07-11 19:37:47-04:00,['606388efac223d8a287a66dc01ce5bc587cc7c1d'],1,1,2,3292963,1,,,,6387
d55cc6cf6a9da1cdc54de2a48f944c549964739f,0,lahiru,2014-07-11 20:32:42-04:00,['1416f2ffc4cba89eba1ed547539589cd071f450b'],0,1,1,3292964,1,0,0,1,6387
5d68f7bc11e0027b409fb24518dea6a0e01a557c,0,lahiru,2014-07-11 20:32:53-04:00,"['d55cc6cf6a9da1cdc54de2a48f944c549964739f', '498c5c59fc9a1a6436fae3e839772a36ae53755f']",1,1,2,3292966,1,,,,6387
dfe99b8464f42bc61e7d30ab1c1ada67826f81ca,0,Chathuri Wimalasena,2014-07-11 20:50:47-04:00,['5d68f7bc11e0027b409fb24518dea6a0e01a557c'],4,4,8,3292974,2,1,1,0,6387
1c73a8498fd758d6a0c01d1891c7164cb05780b6,0,Chathuri Wimalasena,2014-07-11 21:41:02-04:00,['dfe99b8464f42bc61e7d30ab1c1ada67826f81ca'],1,1,2,3292976,1,,,,6387
a6ba18886d528f045b009d3d9cf7975986bd6fb2,0,lahiru,2014-07-11 21:47:46-04:00,['5d68f7bc11e0027b409fb24518dea6a0e01a557c'],8,4,12,3292988,1,,,,6387
a563e94ac1488689aaa3ad0e8eb39a4f791b2601,0,lahiru,2014-07-11 21:47:54-04:00,"['a6ba18886d528f045b009d3d9cf7975986bd6fb2', '1c73a8498fd758d6a0c01d1891c7164cb05780b6']",5,5,10,3292998,3,,,,6387
a8974b7cbad93b57b109b270e3e7c07794a8a338,1,Saminda Wijeratne,2014-07-11 21:52:23-04:00,['dfe99b8464f42bc61e7d30ab1c1ada67826f81ca'],682,10653,11335,3304333,150,0.47778248,0.539568345,0.908167584,6511
0095c915145ff26a0d1a39c2059c09687098e602,0,Saminda Wijeratne,2014-07-11 22:31:17-04:00,['a8974b7cbad93b57b109b270e3e7c07794a8a338'],1,154,155,3304488,5,0.444444444,1,1,6515
780351d8ea407b6f95842a971797082f6fe8677b,0,lahiru,2014-07-11 22:40:06-04:00,['a563e94ac1488689aaa3ad0e8eb39a4f791b2601'],6,8,14,3304502,1,,,,6515
4b7689a87fb6a13c4bb37b609a34a85bccfb1e18,0,lahiru,2014-07-11 22:44:20-04:00,['780351d8ea407b6f95842a971797082f6fe8677b'],1,1,2,3304504,1,,,,6515
bceaed3aba8b7d5c4a5cb006ff915f8274cafc32,0,ixxi-2013,2014-07-12 04:45:48+02:00,['ff8f14c27c646dd64fd323ac47498d0bba28d7f2'],0,1158,1158,3305662,19,0,1,0.657794677,6534
f0486a2d237f6f29706da592049bb1e102dceba0,0,ixxi-2013,2014-07-12 04:48:19+02:00,['bceaed3aba8b7d5c4a5cb006ff915f8274cafc32'],588,0,588,3306250,12,,,,6534
c9af2836772da59ce8fe78fba56a4c46fd126118,0,ixxi-2013,2014-07-12 04:52:23+02:00,['f0486a2d237f6f29706da592049bb1e102dceba0'],570,0,570,3306820,7,1,0,0.342205323,6534
a0f5419e0e7b0961b4515164cf074909fdcb7afa,0,lahiru,2014-07-11 23:29:56-04:00,['4b7689a87fb6a13c4bb37b609a34a85bccfb1e18'],2,2,4,3306824,1,,,,6534
69769b8df043dc9173261832851a453f19dc457a,0,Suresh Marru,2014-07-12 00:07:33-04:00,"['c9af2836772da59ce8fe78fba56a4c46fd126118', 'a0f5419e0e7b0961b4515164cf074909fdcb7afa']",26709,11364,38073,3344897,223,,,,6534
53dd791bd1689c3d43196f7654b6b91f17cab189,0,lahiru,2014-07-12 00:08:55-04:00,['a0f5419e0e7b0961b4515164cf074909fdcb7afa'],7,8,15,3344912,1,0,0,1,6534
b991fe3184457a1f113880018f07638586ce658f,0,lahiru,2014-07-12 00:09:33-04:00,"['53dd791bd1689c3d43196f7654b6b91f17cab189', '69769b8df043dc9173261832851a453f19dc457a']",0,33680,33680,3378592,213,,,,6534
779b6186431d5f748135b24b7ff6abe8b782cf01,0,lahiru,2014-07-12 01:12:24-04:00,['b991fe3184457a1f113880018f07638586ce658f'],2,0,2,3378594,1,1,1,0,6534
c424c37a6928773599e5a6cbcba0d993e6b10d46,0,Saminda Wijeratne,2014-07-12 02:20:24-04:00,['0095c915145ff26a0d1a39c2059c09687098e602'],147,408,555,3379149,8,0.971962617,1,0.934579439,6536
b197a6a34c88f329e089915afb48325a9ee0600c,0,Suresh Marru,2014-07-12 09:23:50-04:00,['498c5c59fc9a1a6436fae3e839772a36ae53755f'],4,4,8,3379157,1,,,,6536
731688c2d3199d8a3499cfe6c590b981e2dcb3f4,0,Suresh Marru,2014-07-12 09:25:15-04:00,"['b197a6a34c88f329e089915afb48325a9ee0600c', '779b6186431d5f748135b24b7ff6abe8b782cf01']",18,33696,33714,3412871,219,,,,6536
e18f5525e36135660b0386d63ba5aa3a7f478bd5,0,Suresh Marru,2014-07-12 10:05:28-04:00,['731688c2d3199d8a3499cfe6c590b981e2dcb3f4'],31,151,182,3413053,6,0.166666667,1,1,6538
b0fde67c03f2787c5f6d7ec576dc92ab41322c53,0,lahiru,2014-07-12 12:58:38-04:00,['779b6186431d5f748135b24b7ff6abe8b782cf01'],10,17,27,3413080,3,0,0,1,6538
82f34a4ff74d3da3044b2efcb6fd64df3cbbdf8b,0,lahiru,2014-07-12 13:00:08-04:00,"['b0fde67c03f2787c5f6d7ec576dc92ab41322c53', 'e18f5525e36135660b0386d63ba5aa3a7f478bd5']",35,155,190,3413270,7,,,,6538
feb1d323af7a9ddd25c2388c5c98ee75f505d67f,0,lahiru,2014-07-12 13:50:06-04:00,['82f34a4ff74d3da3044b2efcb6fd64df3cbbdf8b'],0,11,11,3413281,1,0,0,1,6538
80d1b2edf1338060673711290660f40f00af8ccf,1,Chathuri Wimalasena,2014-07-12 14:52:12-04:00,['feb1d323af7a9ddd25c2388c5c98ee75f505d67f'],3,4,7,3413288,2,0,0,1,6538
4752d1a3fbf1a7742a71eacc42a0d2eee31aa5c7,0,Saminda Wijeratne,2014-07-12 15:12:01-04:00,['c424c37a6928773599e5a6cbcba0d993e6b10d46'],113,457,570,3413858,10,0.292792793,0.657657658,0.977477477,6539
601d5add58e51046ffffa974f0dcb3b686c7db4e,0,Saminda Wijeratne,2014-07-12 16:20:46-04:00,['4752d1a3fbf1a7742a71eacc42a0d2eee31aa5c7'],162,319,481,3414339,11,1,1,0.727272727,6541
fdb54d0202315df044096f2234fb31869ab8e0d8,0,lahiru,2014-07-12 16:30:28-04:00,['feb1d323af7a9ddd25c2388c5c98ee75f505d67f'],2,12,14,3414353,2,0,0,1,6541
d89835bc7dcafc0ae11c08c00578bc848d2d764f,0,lahiru,2014-07-12 16:35:23-04:00,"['fdb54d0202315df044096f2234fb31869ab8e0d8', '80d1b2edf1338060673711290660f40f00af8ccf']",3,4,7,3414360,2,,,,6541
1e8331fd629412e982a840b7df728182a929dc17,1,Chathuri Wimalasena,2014-07-12 17:39:21-04:00,['d89835bc7dcafc0ae11c08c00578bc848d2d764f'],0,8,8,3414368,1,0,0,1,6541
e019c864848b45ba796c6cf4533d232be46ca3b5,0,Suresh Marru,2014-07-12 18:22:51-04:00,['82f34a4ff74d3da3044b2efcb6fd64df3cbbdf8b'],1,1,2,3414370,1,,,,6541
92244d67ee589207cf7ee45b367464338c25d368,0,Suresh Marru,2014-07-12 18:23:29-04:00,"['e019c864848b45ba796c6cf4533d232be46ca3b5', '1e8331fd629412e982a840b7df728182a929dc17']",4,34,38,3414408,4,,,,6541
6a4b162fb8617b31e2698bc13d048d93b8417d13,0,Suresh Marru,2014-07-13 00:25:24-04:00,['92244d67ee589207cf7ee45b367464338c25d368'],501,282,783,3415191,16,1,1,0,6541
16d2d38f01f67435469287aa375fce80c57255c4,0,Suresh Marru,2014-07-13 08:08:34-04:00,['6a4b162fb8617b31e2698bc13d048d93b8417d13'],44,17,61,3415252,2,1,1,0,6541
b0618e404c7688597d356dcf2c3db8179b3c175a,0,raminder,2014-07-13 09:30:36-04:00,['16d2d38f01f67435469287aa375fce80c57255c4'],64,60,124,3415376,1,,,,6541
d83a84416e6785a00cfa558ffa7aad87192ab88b,0,Suresh Marru,2014-07-13 09:59:29-04:00,['16d2d38f01f67435469287aa375fce80c57255c4'],48,48,96,3415472,2,0.909090909,0,0,6541
1a223e8c08d518c198f5432363105f8915269e64,0,Suresh Marru,2014-07-13 09:59:40-04:00,"['d83a84416e6785a00cfa558ffa7aad87192ab88b', 'b0618e404c7688597d356dcf2c3db8179b3c175a']",64,60,124,3415596,1,,,,6541
cc0bc994ebf5c8c9ca26202e5156fc1124914a1c,0,Suresh Marru,2014-07-13 21:49:12-04:00,['1a223e8c08d518c198f5432363105f8915269e64'],2058,4,2062,3417658,5,,,,6541
f4b384bfe36cd6a71e3db8b1e62a1e8161382724,0,Saminda Wijeratne,2014-07-13 22:20:51-04:00,['1a223e8c08d518c198f5432363105f8915269e64'],1,15,16,3417674,6,1,1,1,6541
e2f03a1b85cd5cd92245e3613dbe0be20ba190b1,0,Saminda Wijeratne,2014-07-13 22:21:10-04:00,"['f4b384bfe36cd6a71e3db8b1e62a1e8161382724', 'cc0bc994ebf5c8c9ca26202e5156fc1124914a1c']",2058,4,2062,3419736,5,,,,6541
4b266f29424fe697cd4dfbb5bdb75fd31d7dd3fc,0,Suresh Marru,2014-07-13 22:52:13-04:00,['e2f03a1b85cd5cd92245e3613dbe0be20ba190b1'],4,4,8,3419744,2,,,,6541
8edd7114f23ccb5fb5d951ab817e764406b53fb1,0,raminder,2014-07-14 08:31:07-04:00,['4b266f29424fe697cd4dfbb5bdb75fd31d7dd3fc'],16,4,20,3419764,1,,,,6541
565ea4b6862a9ca15c789a206dfd4b83b93424e0,0,lahiru,2014-07-15 12:20:43-04:00,['d89835bc7dcafc0ae11c08c00578bc848d2d764f'],0,145,145,3419909,1,0.205479452,0.767123288,1,6542
92838e4a8d9a678e795c9deedaba76aeac652dc3,0,Saminda Wijeratne,2014-07-19 09:23:19-04:00,['601d5add58e51046ffffa974f0dcb3b686c7db4e'],572,1190,1762,3421671,41,0.047619048,0.671428571,1,6549
9a7299fe29805e48760dc76cc5fd15c92a1ce99a,0,lahiru,2014-07-20 22:46:07-04:00,"['565ea4b6862a9ca15c789a206dfd4b83b93424e0', '8edd7114f23ccb5fb5d951ab817e764406b53fb1']",2703,409,3112,3424783,32,,,,6549
cd29e740b051b40b7bd179e4218019850430d12d,1,Chathuri Wimalasena,2014-07-21 11:32:51-04:00,['8edd7114f23ccb5fb5d951ab817e764406b53fb1'],0,1046,1046,3425829,5,0.252380952,0.793650794,0.976190476,6554
61515272b4120d911c8425d974d9e51d1af3c262,0,lahiru,2014-07-21 22:15:30-04:00,"['9a7299fe29805e48760dc76cc5fd15c92a1ce99a', 'cd29e740b051b40b7bd179e4218019850430d12d']",0,1046,1046,3426875,5,,,,6554
a66dbe4a81595f975119ab48ece236d6c4ad2850,0,Suresh Marru,2014-07-22 09:48:03-04:00,['cd29e740b051b40b7bd179e4218019850430d12d'],17801,2963,20764,3447639,153,0.72529148,0.656681614,0.138923767,6554
c8935391d2afcf2dda803881a856a20f36055814,0,Suresh Marru,2014-07-22 10:07:53-04:00,['a66dbe4a81595f975119ab48ece236d6c4ad2850'],136,975,1111,3448750,179,,,,6554
d63455a317472b35a4270f56494e51c990175b5d,0,Suresh Marru,2014-07-22 10:31:59-04:00,['c8935391d2afcf2dda803881a856a20f36055814'],3,724,727,3449477,39,,,,6554
0643c3ad92c28cc5a8fe8773578a3faf84a02611,0,Suresh Marru,2014-07-22 10:53:07-04:00,['d63455a317472b35a4270f56494e51c990175b5d'],70,66,136,3449613,61,,,,6554
d5b1b2d9766f831aa0d14d4b7ffa85319db23382,0,Suresh Marru,2014-07-22 10:53:17-04:00,['0643c3ad92c28cc5a8fe8773578a3faf84a02611'],62,62,124,3449737,61,,,,6554
16cd757f2bee40aa8407ea76b012389d72d2dea7,0,Saminda Wijeratne,2014-07-22 11:04:00-04:00,"['92838e4a8d9a678e795c9deedaba76aeac652dc3', 'd5b1b2d9766f831aa0d14d4b7ffa85319db23382']",21241,40535,61776,3511513,487,,,,6554
d9d3546d64a6f1689eb250075677a3066833294f,0,lahiru,2014-07-22 11:56:56-04:00,"['61515272b4120d911c8425d974d9e51d1af3c262', 'd5b1b2d9766f831aa0d14d4b7ffa85319db23382']",17873,4591,22464,3533977,296,,,,6554
10103a44594ad0c4d11e7416da3e96d4991be4e1,0,Chathuri Wimalasena,2014-07-22 12:51:27-04:00,['d5b1b2d9766f831aa0d14d4b7ffa85319db23382'],2426,341,2767,3536744,25,0.578821656,0.36544586,0.069267516,6554
342d8e9c62f9589d3bf9fa15eb2236700c1ea2e3,1,Chathuri Wimalasena,2014-07-22 14:13:43-04:00,['10103a44594ad0c4d11e7416da3e96d4991be4e1'],1,2,3,3536747,2,0,1,1,6554
915eda2e4b39301ca95b76ba5785239250ec9e76,0,Saminda Wijeratne,2014-07-22 17:22:19-04:00,['16cd757f2bee40aa8407ea76b012389d72d2dea7'],29,54,83,3536830,8,0,0.611111111,1,6554
b69cf69ee2fa77c89d8349a24a1071be58857c67,0,Saminda Wijeratne,2014-07-22 17:41:31-04:00,['915eda2e4b39301ca95b76ba5785239250ec9e76'],1,1,2,3536832,1,,,,6554
4ea83c8f48344b90f6e5afa0fd790c2fb67ffb80,0,Saminda Wijeratne,2014-07-22 22:23:42-04:00,['b69cf69ee2fa77c89d8349a24a1071be58857c67'],1,1,2,3536834,1,,,,6554
81a21c5762f32e1605e3f0dd8a6704829d051f8d,0,Saminda Wijeratne,2014-07-23 12:20:19-04:00,"['342d8e9c62f9589d3bf9fa15eb2236700c1ea2e3', '4ea83c8f48344b90f6e5afa0fd790c2fb67ffb80']",1349,12876,14225,3551059,204,,,,6554
88269c4334625414ff750b4f2299ac9cccbc8c9d,0,Chathuri Wimalasena,2014-07-23 12:24:48-04:00,['342d8e9c62f9589d3bf9fa15eb2236700c1ea2e3'],18,18,36,3551095,1,0,1,1,6554
c61d438ca2f5c285c70fe4e088cc1f9c086f7cb2,0,lahiru,2014-07-23 12:25:50-04:00,"['d9d3546d64a6f1689eb250075677a3066833294f', '88269c4334625414ff750b4f2299ac9cccbc8c9d']",2445,361,2806,3553901,28,,,,6554
e6126da9ec066d08deaba7b1e045274450af3a7c,0,Saminda Wijeratne,2014-07-23 12:47:49-04:00,"['81a21c5762f32e1605e3f0dd8a6704829d051f8d', '88269c4334625414ff750b4f2299ac9cccbc8c9d']",27,27,54,3553955,1,,,,6554
4ae0104b2809f514c1309ed9f96378e1935436eb,0,lahiru,2014-07-23 14:21:26-04:00,['c61d438ca2f5c285c70fe4e088cc1f9c086f7cb2'],5,107,112,3554067,2,0.206896552,0.206896552,1,6554
dd7e6c750460b4c47cb51f5988db60f1721c944b,0,lahiru,2014-07-23 14:23:07-04:00,"['4ae0104b2809f514c1309ed9f96378e1935436eb', 'e6126da9ec066d08deaba7b1e045274450af3a7c']",1336,12863,14199,3568266,204,,,,6554
2e28d53a7357def58edb60626cb6cb01eb72f392,0,Saminda Wijeratne,2014-07-24 11:08:42-04:00,['dd7e6c750460b4c47cb51f5988db60f1721c944b'],1,1,2,3568268,1,,,,6554
f5693907c0c6e964ced9e03896d64adf873c1aeb,0,Saminda Wijeratne,2014-07-24 11:11:31-04:00,['2e28d53a7357def58edb60626cb6cb01eb72f392'],1,1,2,3568270,1,,,,6554
5a22a3557396959d7a8c94f5658dcf158d9fbf38,0,lahiru,2014-07-24 14:43:47-04:00,['dd7e6c750460b4c47cb51f5988db60f1721c944b'],188,1382,1570,3569840,23,0.522316043,0.572979493,0.971049457,6556
03ecceab1e89565a2ef868522184780a8bd61aa8,0,lahiru,2014-07-24 14:44:09-04:00,"['5a22a3557396959d7a8c94f5658dcf158d9fbf38', 'f5693907c0c6e964ced9e03896d64adf873c1aeb']",2,2,4,3569844,2,,,,6556
0f10016ddd1e61870f7b32de12f7c0278b2bbf15,0,raminder,2014-07-25 16:40:51-04:00,['03ecceab1e89565a2ef868522184780a8bd61aa8'],37,279,316,3570160,2,0.1875,1,0.741071429,6557
e61a290d4d9bed36f0674a8f30260b4d9e0ec841,0,raminder,2014-07-25 16:54:17-04:00,['0f10016ddd1e61870f7b32de12f7c0278b2bbf15'],2,3,5,3570165,1,0,1,1,6557
d9f4dc0efd82f9b956c2bc9f6e355453df72f420,0,lahiru,2014-07-26 07:09:51-04:00,['e61a290d4d9bed36f0674a8f30260b4d9e0ec841'],4,12,16,3570181,6,0,0,0.333333333,6557
1a2411d2e70e2138aad5b5e8508e53a5bd1a3665,0,lahiru,2014-07-26 09:22:23-04:00,['d9f4dc0efd82f9b956c2bc9f6e355453df72f420'],10,11,21,3570202,7,1,1,0,6557
aef99c061ec1b2f61f3d99f27182a43897f2ec2e,0,lahiru,2014-07-29 13:30:18-04:00,['1a2411d2e70e2138aad5b5e8508e53a5bd1a3665'],723,161,884,3571086,12,0,0.660714286,1,6558
3bf8e23f85d5c2d957084a23fa3c8444999a59ad,0,raminder,2014-07-29 17:22:42-04:00,['e61a290d4d9bed36f0674a8f30260b4d9e0ec841'],1,1,2,3571088,1,,,,6558
5398ba79b14d3e26ae0e9ce2913030ed2cd03b12,0,raminder,2014-07-29 17:23:28-04:00,"['3bf8e23f85d5c2d957084a23fa3c8444999a59ad', 'aef99c061ec1b2f61f3d99f27182a43897f2ec2e']",736,183,919,3572007,20,,,,6558
d498c7b23916f3e2f7bde31b90bf4ce4a74c66d9,0,raminder,2014-07-29 17:24:41-04:00,['5398ba79b14d3e26ae0e9ce2913030ed2cd03b12'],9,15,24,3572031,1,,,,6558
f5a7376eded244c8770c74384453ce367afde5c9,0,Chathuri Wimalasena,2014-07-31 10:35:41-04:00,['d498c7b23916f3e2f7bde31b90bf4ce4a74c66d9'],1,1,2,3572033,1,1,1,1,6558
f65c5a8a66b0dfc4a495b3a12125da3420a2a3a9,1,Chathuri Wimalasena,2014-07-31 10:51:19-04:00,['f5a7376eded244c8770c74384453ce367afde5c9'],137,137,274,3572307,2,0.745762712,0.288135593,0,6558
7d07911c9d1389ac957067dc5314580382dbe1ad,1,lahiru,2014-08-02 02:29:12+05:18,['f65c5a8a66b0dfc4a495b3a12125da3420a2a3a9'],79,126,205,3572512,11,1,1,1,6560
744ef76a2d919cf18c626d2baf9099711b53ee64,0,lahiru,2014-08-05 07:39:23+05:18,['7d07911c9d1389ac957067dc5314580382dbe1ad'],1,28,29,3572541,1,,,,6560
0fc00b499ae453833ca85e6bf185b84800842df3,0,lahiru,2014-08-05 08:35:53+05:18,['744ef76a2d919cf18c626d2baf9099711b53ee64'],92,1512,1604,3574145,11,0.285140562,0.326305221,0.983935743,6562
3f216348fb9af0415dea57805e498a2d2aa19079,1,lahiru,2014-08-05 12:18:25+05:18,['0fc00b499ae453833ca85e6bf185b84800842df3'],4373,10188,14561,3588706,19,0.375028689,0.498508148,0.937801239,6565
40c44779cc31c3e20d06039667c0cc43a6204d2e,0,Saminda Wijeratne,2014-08-07 10:29:00-04:00,['3f216348fb9af0415dea57805e498a2d2aa19079'],184,168,352,3589058,25,0.714285714,0.771428571,1,6567
d9e82a34d65bf4b35ce56fa6ab1d27421fafb0f3,1,Chathuri Wimalasena,2014-08-07 11:18:16-04:00,['40c44779cc31c3e20d06039667c0cc43a6204d2e'],344,681,1025,3590083,27,0.249122807,0.354385965,1,6570
7536fb689d69c7b7c7f8e6988c9a219f7c3cda26,0,Chathuri Wimalasena,2014-08-07 11:29:32-04:00,['d9e82a34d65bf4b35ce56fa6ab1d27421fafb0f3'],0,20,20,3590103,1,,,,6571
c29a6a9be0dfad105cb8b741bad88b5135ddd39d,0,raminder,2014-08-07 16:32:15-04:00,['3f216348fb9af0415dea57805e498a2d2aa19079'],144,369,513,3590616,7,0.028169014,0.985915493,0.802816901,6571
d6ffefa815ccfc3598d2eca9f7ec5c3f461b293d,0,raminder,2014-08-07 16:32:44-04:00,"['c29a6a9be0dfad105cb8b741bad88b5135ddd39d', '7536fb689d69c7b7c7f8e6988c9a219f7c3cda26']",528,869,1397,3592013,53,,,,6571
f29d7e66a865108e16a42f1641dabd4b06b8ef7d,0,raminder,2014-08-07 17:22:56-04:00,['d6ffefa815ccfc3598d2eca9f7ec5c3f461b293d'],8,7,15,3592028,2,1,0.333333333,0,6571
1fe3d1d8e86feb3ade9c55bc8ee13931c5454910,0,Chathuri Wimalasena,2014-08-08 15:32:57-04:00,['f29d7e66a865108e16a42f1641dabd4b06b8ef7d'],0,7552,7552,3599580,21,0.414600551,0.509248327,0.992129083,6589
785394d34f71452f3ecfe91be8057117bc35ad85,0,Chathuri Wimalasena,2014-08-11 13:38:55-04:00,['1fe3d1d8e86feb3ade9c55bc8ee13931c5454910'],1335,731,2066,3601646,23,0.56497948,0.616963064,0.049247606,6590
dcc647ebc683b9da454ba113765d5521acabd6a7,0,Chathuri Wimalasena,2014-08-11 15:31:29-04:00,['785394d34f71452f3ecfe91be8057117bc35ad85'],323,1129,1452,3603098,21,0.476190476,0.658456486,0.986863711,6591
722de6d1fe5eea90bad2ccf9815e4cb28e633274,0,Chathuri Wimalasena,2014-08-11 15:44:15-04:00,['f29d7e66a865108e16a42f1641dabd4b06b8ef7d'],2,4,6,3603104,1,0,1,1,6591
8a8a02b8814c75e8db1b069e2e7056cd8c3d0551,0,Chathuri Wimalasena,2014-08-11 15:44:51-04:00,"['dcc647ebc683b9da454ba113765d5521acabd6a7', '722de6d1fe5eea90bad2ccf9815e4cb28e633274']",0,0,0,3603104,0,,,,6591
c1d7cf77a0f623b33eb5ac5812442db753e5d05c,0,raminder,2014-08-13 16:03:33-04:00,['f29d7e66a865108e16a42f1641dabd4b06b8ef7d'],7,7,14,3603118,1,,,,6591
9e6c04b3b07a8b1dc46bc15543933e5462513cca,0,raminder,2014-08-13 16:04:09-04:00,"['c1d7cf77a0f623b33eb5ac5812442db753e5d05c', '722de6d1fe5eea90bad2ccf9815e4cb28e633274']",2,4,6,3603124,1,,,,6591
23924b9a63cba55b71d293618d6a70faaf1dc938,0,raminder,2014-08-13 16:39:48-04:00,['9e6c04b3b07a8b1dc46bc15543933e5462513cca'],7,7,14,3603138,1,,,,6591
3a0d21f27729704203e16767d3636508f734b69b,0,raminder,2014-08-13 17:06:38-04:00,['23924b9a63cba55b71d293618d6a70faaf1dc938'],9,14,23,3603161,2,0,0,0,6591
ff009a11f653f15a828017e7e726d55ac10c0826,0,raminder,2014-08-13 17:27:16-04:00,['3a0d21f27729704203e16767d3636508f734b69b'],1,1,2,3603163,1,,,,6591
3721954ddd11632418a19894390d711ccfbf67cc,0,raminder,2014-08-13 17:36:50-04:00,['ff009a11f653f15a828017e7e726d55ac10c0826'],2,3,5,3603168,1,,,,6591
f37dad87a0d86692abbab89cf3abd6010d7302e0,0,raminder,2014-08-13 22:33:13-04:00,['3721954ddd11632418a19894390d711ccfbf67cc'],84,90,174,3603342,3,0.6,0.6,0.6,6591
34e0b87e2a57366b695d71a3560dbcfb7bc93d6c,0,raminder,2014-08-13 23:07:49-04:00,['f37dad87a0d86692abbab89cf3abd6010d7302e0'],4,4,8,3603350,3,1,0,0,6591
538e37f0efef020ed0d34c7519a1744798524ebd,0,raminder,2014-08-13 23:32:23-04:00,['34e0b87e2a57366b695d71a3560dbcfb7bc93d6c'],15,17,32,3603382,3,,,,6591
b19a8e06d17b853f2fe1fe41b67ff8f2d83747bc,0,Chathuri Wimalasena,2014-08-14 09:38:45-04:00,['538e37f0efef020ed0d34c7519a1744798524ebd'],4,4,8,3603390,1,,,,6591
1c554482790423daa242325d1167d5df8b326409,0,lahiru,2014-08-14 21:53:53+05:18,['538e37f0efef020ed0d34c7519a1744798524ebd'],37,160,197,3603587,7,0,0,0.970873786,6591
404913acd380787b98ddf8c0673dcb10bf6e1087,1,Chathuri Wimalasena,2014-08-14 16:24:26-04:00,['b19a8e06d17b853f2fe1fe41b67ff8f2d83747bc'],1157,1973,3130,3606717,45,1,1,0.035714286,6591
a429677293c7b3677658ef9d82beca9b52d8b84d,0,lahiru,2014-08-15 01:53:39+05:18,['1c554482790423daa242325d1167d5df8b326409'],48,268,316,3607033,17,0.21978022,0.532967033,0.956043956,6591
d62a957dbb159ba41a42c03b242c5c3b21241d98,0,lahiru,2014-08-15 02:02:12+05:18,"['a429677293c7b3677658ef9d82beca9b52d8b84d', '404913acd380787b98ddf8c0673dcb10bf6e1087']",1161,1977,3138,3610171,46,,,,6591
c44ec6366d7cd85cd13c97729d9c1970d437bef0,0,Eroma Abeysinghe,2014-08-15 14:30:30-04:00,['b19a8e06d17b853f2fe1fe41b67ff8f2d83747bc'],198,205,403,3610574,32,,,,6591
010b85fcf44d75f706c85e632f372b07fb52d296,0,Eroma Abeysinghe,2014-08-15 14:35:45-04:00,"['c44ec6366d7cd85cd13c97729d9c1970d437bef0', 'd62a957dbb159ba41a42c03b242c5c3b21241d98']",1233,2390,3623,3614197,64,,,,6591
c21f1d1a6426da635f4dd3a8b8cbb1d069f87f6a,1,Chathuri Wimalasena,2014-08-15 15:07:13-04:00,['010b85fcf44d75f706c85e632f372b07fb52d296'],19,21,40,3614237,4,1,0,0,6591
bb8e448cf1c4b88b27aaeca10b9147afec04e619,1,Chathuri Wimalasena,2014-08-15 15:41:27-04:00,['c21f1d1a6426da635f4dd3a8b8cbb1d069f87f6a'],35,49,84,3614321,19,1,1,1,6591
6b519e2a5f485af5499212bc2eee324be8ca93a1,0,Nadeem Anjum,2014-08-17 06:26:17+05:18,['bb8e448cf1c4b88b27aaeca10b9147afec04e619'],3,406,409,3614730,2,0.061983471,0.061983471,1,6592
3cab2d63a4c82a85795c8742442300e0247854bc,1,Chathuri Wimalasena,2014-08-18 12:21:55-04:00,['bb8e448cf1c4b88b27aaeca10b9147afec04e619'],2916,5274,8190,3622920,11,0.375553097,0.455752212,0.938606195,6592
011f01965fb4b17953cf5edf7a3b3663a1501cd4,0,lahiru,2014-08-19 01:31:47+05:18,['3cab2d63a4c82a85795c8742442300e0247854bc'],174,552,726,3623646,18,0.154605263,0.486842105,0.625,6593
d0fcdb172473a6f3997df5c0ed143f871bdb136f,0,Chathuri Wimalasena,2014-08-18 17:00:00-04:00,['011f01965fb4b17953cf5edf7a3b3663a1501cd4'],5,5,10,3623656,5,,,,6593
bedf7c0fbe6fecf041119a0bf3c4aa4e23965dbd,0,Suresh Marru,2014-08-18 17:52:53-04:00,['d0fcdb172473a6f3997df5c0ed143f871bdb136f'],3,406,409,3624065,2,0.061983471,0.061983471,1,6594
eb9bda8736fce7c0ca4f367248d5c896ed9f0f34,0,lahiru,2014-08-19 14:59:36+05:18,['011f01965fb4b17953cf5edf7a3b3663a1501cd4'],44,102,146,3624211,11,0.078431373,0.196078431,0.960784314,6594
414f2b9cf5d8ce2c742cd3351918750e42b0bd1a,0,lahiru,2014-08-19 14:59:56+05:18,"['eb9bda8736fce7c0ca4f367248d5c896ed9f0f34', 'd0fcdb172473a6f3997df5c0ed143f871bdb136f']",5,5,10,3624221,5,,,,6594
9c1f44d04b768f4f9d360d71e19aeaaf7c25a218,1,Chathuri Wimalasena,2014-08-19 10:43:34-04:00,['414f2b9cf5d8ce2c742cd3351918750e42b0bd1a'],3169,5667,8836,3633057,11,0.344702842,0.440826873,0.891989664,6594
5a750b398ecb675b2ca3ed41a5bf3a4dadeb9ee2,0,Chathuri Wimalasena,2014-08-19 13:01:23-04:00,['9c1f44d04b768f4f9d360d71e19aeaaf7c25a218'],6,43,49,3633106,2,0,0,1,6594
7420d8c52785bd26c691374225b0a77631d358e4,0,raminder,2014-08-19 15:52:29-04:00,['414f2b9cf5d8ce2c742cd3351918750e42b0bd1a'],1,1,2,3633108,1,,,,6594
83cb4bf21677b67098e7f8cecf23dd796a9c2bbe,0,raminder,2014-08-19 15:52:59-04:00,"['7420d8c52785bd26c691374225b0a77631d358e4', '5a750b398ecb675b2ca3ed41a5bf3a4dadeb9ee2']",3174,5709,8883,3641991,11,,,,6594
4056bb916e4de9acafbf3a8740c28152ea9b5ef4,0,Nadeem Anjum,2014-08-20 02:45:48+05:18,['6b519e2a5f485af5499212bc2eee324be8ca93a1'],59,150,209,3642200,4,0.227272727,0.484848485,1,6595
91dc82dc05a3be2d64adaf4111795be4137a7d75,0,Suresh Marru,2014-08-20 01:29:48-04:00,"['bedf7c0fbe6fecf041119a0bf3c4aa4e23965dbd', '83cb4bf21677b67098e7f8cecf23dd796a9c2bbe']",3219,5812,9031,3651231,23,,,,6595
4fbe57dac658f0b24141c85f43ae41c8d1feaa44,0,lahiru,2014-08-20 11:50:18+05:18,['83cb4bf21677b67098e7f8cecf23dd796a9c2bbe'],22,121,143,3651374,6,0,0,0.614457831,6595
3a927d855d02985309dd3f9090b784a50298a05f,0,lahiru,2014-08-20 16:46:39+05:18,['4fbe57dac658f0b24141c85f43ae41c8d1feaa44'],65,60,125,3651499,9,1,1,0,6595
5bdb49d7716461fcb1e70180ac0315eef3ee7442,0,lahiru,2014-08-20 17:39:01+05:18,['3a927d855d02985309dd3f9090b784a50298a05f'],6,6,12,3651511,1,,,,6595
6305d3a51ffd51b19a77ae255e01425e0ca0e1c7,1,Chathuri Wimalasena,2014-08-20 11:38:37-04:00,['5bdb49d7716461fcb1e70180ac0315eef3ee7442'],930,6926,7856,3659367,12,0.316802678,0.256120527,0.95647625,6595
aa4cd2cb655a59e5e76d4fcc3da108c092be9a20,0,Chathuri Wimalasena,2014-08-20 13:59:32-04:00,['6305d3a51ffd51b19a77ae255e01425e0ca0e1c7'],4,31,35,3659402,3,0,0,1,6595
b1532829c7079a7038a7b64dea14d9a38c64cd4b,0,raminder,2014-08-20 15:05:48-04:00,['6305d3a51ffd51b19a77ae255e01425e0ca0e1c7'],12,55,67,3659469,5,0,0,1,6595
55579022036d838a9a42019495bb604a04456955,0,raminder,2014-08-20 15:06:13-04:00,"['b1532829c7079a7038a7b64dea14d9a38c64cd4b', 'aa4cd2cb655a59e5e76d4fcc3da108c092be9a20']",4,31,35,3659504,3,,,,6595
abdaa8bd444cc9e668fa45cc5ee4bb1e29d7b150,0,lahiru,2014-08-21 20:47:37+05:18,['5bdb49d7716461fcb1e70180ac0315eef3ee7442'],17,4,21,3659525,1,1,1,0,6595
bf9b277e7f522093be1f804ee24fc299e1d460ac,0,lahiru,2014-08-21 20:47:53+05:18,"['abdaa8bd444cc9e668fa45cc5ee4bb1e29d7b150', '55579022036d838a9a42019495bb604a04456955']",946,7012,7958,3667483,18,,,,6595
9ee9dd2af9099920989978882edcab05126c7d5a,0,raminder,2014-08-21 13:48:22-04:00,['55579022036d838a9a42019495bb604a04456955'],3,6,9,3667492,2,0,0,1,6595
21cae7eab8022769262525e60bb89e13a2770195,0,raminder,2014-08-21 13:48:41-04:00,"['9ee9dd2af9099920989978882edcab05126c7d5a', 'bf9b277e7f522093be1f804ee24fc299e1d460ac']",17,4,21,3667513,1,,,,6595
56b5375199aabd76cf6a2907e413020f55f766f0,0,lahiru,2014-08-22 01:21:53+05:18,['21cae7eab8022769262525e60bb89e13a2770195'],36,39,75,3667588,1,0,0,1,6595
963f42deb43f3651a10692f2b10d8d586cb2876a,0,Chathuri Wimalasena,2014-08-22 10:09:07-04:00,['21cae7eab8022769262525e60bb89e13a2770195'],1,2,3,3667591,2,0,1,1,6595
208e9f4d09dbdbb84719781c203e710117064a79,0,Chathuri Wimalasena,2014-08-22 10:23:26-04:00,"['963f42deb43f3651a10692f2b10d8d586cb2876a', '56b5375199aabd76cf6a2907e413020f55f766f0']",36,39,75,3667666,1,,,,6595
f72637f211f5defca1bd7bee22fb3633c9f84808,1,Chathuri Wimalasena,2014-08-22 14:54:47-04:00,['208e9f4d09dbdbb84719781c203e710117064a79'],11715,1724,13439,3681105,175,0.33926097,0.228406467,0.138337182,6595
98f411019bed5a24d9ccf7b6237cb27311a74114,0,Chathuri Wimalasena,2014-08-22 16:10:15-04:00,['f72637f211f5defca1bd7bee22fb3633c9f84808'],2211,2100,4311,3685416,20,0.213798978,0.108177172,0.264906303,6595
84cabd37238c9473b3ce21a3b2c2818875e1840e,0,Suresh Marru,2014-08-22 20:51:19-04:00,"['91dc82dc05a3be2d64adaf4111795be4137a7d75', '98f411019bed5a24d9ccf7b6237cb27311a74114']",14971,11023,25994,3711410,212,,,,6595
5901e082633354b34be51374709b8110785c32e1,0,Suresh Marru,2014-08-25 10:58:17-04:00,['84cabd37238c9473b3ce21a3b2c2818875e1840e'],112,94,206,3711616,10,0.789473684,0.052631579,0,6595
36d0b76200123608cd66d593b5887c071e81ea16,0,Suresh Marru,2014-08-25 11:22:04-04:00,['5901e082633354b34be51374709b8110785c32e1'],17,17,34,3711650,1,,,,6595
b3775eca9affdbb9cc5306697913790f763ce443,0,raminder,2014-08-25 12:00:09-04:00,['21cae7eab8022769262525e60bb89e13a2770195'],9,57,66,3711716,2,0,1,1,6595
6c4471ada3585716426ff3ed1d8712b53e9b7126,0,raminder,2014-08-25 12:00:17-04:00,"['b3775eca9affdbb9cc5306697913790f763ce443', '36d0b76200123608cd66d593b5887c071e81ea16']",14086,4373,18459,3730175,198,,,,6595
acac1b01a6136ee198e9f6b305f58214c561d9f1,0,lahiru,2014-08-25 23:13:48+05:18,['36d0b76200123608cd66d593b5887c071e81ea16'],2,12,14,3730189,2,0.375,0.375,1,6595
fb9856001c5a220d388084f5f04707f88cd82335,0,lahiru,2014-08-25 23:37:41+05:18,['acac1b01a6136ee198e9f6b305f58214c561d9f1'],1,1,2,3730191,1,,,,6595
e8e6949c8b1873d956052f32dcbd9b7d22d55e41,1,Chathuri Wimalasena,2014-08-26 14:05:09-04:00,['fb9856001c5a220d388084f5f04707f88cd82335'],4,4,8,3730199,2,,,,6595
6821ce1ac4722e7ef05f2e1f34c13c2878dcdb48,1,Chathuri Wimalasena,2014-08-28 10:59:24-04:00,['e8e6949c8b1873d956052f32dcbd9b7d22d55e41'],3,158,161,3730360,9,0.973684211,1,1,6597
6c500f2cc923c58600a4d1094e119094c618cf2c,0,raminder,2014-08-28 11:17:06-04:00,['6c4471ada3585716426ff3ed1d8712b53e9b7126'],47,90,137,3730497,2,0,0,1,6597
4adcce9866c8e32f13e782d1ef3a62c2d4a7bd2c,0,raminder,2014-08-28 11:21:31-04:00,"['6c500f2cc923c58600a4d1094e119094c618cf2c', '6821ce1ac4722e7ef05f2e1f34c13c2878dcdb48']",9,174,183,3730680,12,,,,6597
ce09a50e2ddd817cbe3b2d6081e2c99de2a5e5b7,0,lahiru,2014-08-29 18:21:27+05:18,['4adcce9866c8e32f13e782d1ef3a62c2d4a7bd2c'],7,1,8,3730688,1,1,1,0,6597
9e713abf28a2737ba70dc69cb69c7b5461135e03,0,raminder,2014-09-01 10:58:53-04:00,['ce09a50e2ddd817cbe3b2d6081e2c99de2a5e5b7'],4,4,8,3730696,1,1,1,0,6597
0cc27dfcb4bc5a57291336ed33f740f03f50473c,0,raminder,2014-09-01 11:21:45-04:00,['9e713abf28a2737ba70dc69cb69c7b5461135e03'],13,13,26,3730722,4,1,1,0,6597
360a5be1aae0661f3b785d631705bada1de09a34,0,lahiru,2014-09-04 15:07:12-04:00,['0cc27dfcb4bc5a57291336ed33f740f03f50473c'],1,1,2,3730724,1,,,,6597
3f28978a89bc8dfa4a05426edbfb0f5b96d7bec6,0,lahiru,2014-09-05 09:40:30-04:00,['360a5be1aae0661f3b785d631705bada1de09a34'],0,2,2,3730726,1,1,1,0,6597
1718264c41e1c3eee3bca2bc4e05e9f830e9210a,0,lahiru,2014-09-05 09:51:44-04:00,['3f28978a89bc8dfa4a05426edbfb0f5b96d7bec6'],2,1,3,3730729,1,1,1,1,6597
0231873b391dd6cb5dfcb249babe92bea549f899,0,lahiru,2014-09-05 10:04:58-04:00,['1718264c41e1c3eee3bca2bc4e05e9f830e9210a'],5,2,7,3730736,1,0,0,1,6597
36e93a6d923a3a6c27e2a3f2967359c014d1772f,0,shamrath,2014-09-05 12:06:02-04:00,['360a5be1aae0661f3b785d631705bada1de09a34'],2,8,10,3730746,1,1,1,1,6597
93e37db8b599f35537e641bdd60fbb7435a5f001,0,shamrath,2014-09-06 09:49:02-04:00,"['0231873b391dd6cb5dfcb249babe92bea549f899', '36e93a6d923a3a6c27e2a3f2967359c014d1772f']",2,8,10,3730756,1,,,,6597
ca5104474b230bd583d14b0a997922fd9c575367,0,marpierc,2014-09-09 15:07:27-04:00,['93e37db8b599f35537e641bdd60fbb7435a5f001'],0,3310,3310,3734066,142,0,0,1,6739
787cb3bc968cf2ac03d7fa6c82e91a14027f8b12,0,marpierc,2014-09-09 15:09:51-04:00,['ca5104474b230bd583d14b0a997922fd9c575367'],0,0,0,3734066,1,,,,6739
ea5da3399f8dca441e0d54341793134f792c33f9,0,marpierc,2014-09-09 15:24:28-04:00,['787cb3bc968cf2ac03d7fa6c82e91a14027f8b12'],0,0,0,3734066,1,,,,6739
39798cb51f5d9c4c0a1d5ace69b8ce6d1501990e,0,shamrath,2014-09-09 16:37:09-04:00,"['93e37db8b599f35537e641bdd60fbb7435a5f001', '4056bb916e4de9acafbf3a8740c28152ea9b5ef4']",53,188,241,3734307,3,,,,6739
6b9d3c59b07c5f20fcffc5125a908956959c884f,0,shamrath,2014-09-09 16:38:49-04:00,"['ea5da3399f8dca441e0d54341793134f792c33f9', '39798cb51f5d9c4c0a1d5ace69b8ce6d1501990e']",53,188,241,3734548,3,,,,6739
16cd6e10acfdfb24faf9c9cd591e5629cda22ae4,0,marpierc,2014-09-10 09:20:56-04:00,['ea5da3399f8dca441e0d54341793134f792c33f9'],0,34,34,3734582,1,,,,6740
b46fffedac25acf4084b18f633648d77d28d94d7,0,marpierc,2014-09-10 09:21:41-04:00,"['16cd6e10acfdfb24faf9c9cd591e5629cda22ae4', '6b9d3c59b07c5f20fcffc5125a908956959c884f']",53,188,241,3734823,3,,,,6740
f15a9d7396fd48ea594cb89e9b90f75e39ce6fa0,0,marpierc,2014-09-10 09:25:01-04:00,['b46fffedac25acf4084b18f633648d77d28d94d7'],0,1,1,3734824,1,,,,6740
2936cea043b9b4d12a3eee3a1b509f3c2e5fa513,0,marpierc,2014-09-10 16:42:35-04:00,['f15a9d7396fd48ea594cb89e9b90f75e39ce6fa0'],1,5,6,3734830,1,,,,6740
92ad9f12287a6cd8d712e63ad4a108a8655174b8,0,lahiru,2014-09-11 00:15:59-04:00,['2936cea043b9b4d12a3eee3a1b509f3c2e5fa513'],2,3,5,3734835,1,0,0,1,6740
68e81ef80a81b1e88efeb39f0e13a0191ba2e4ce,0,lahiru,2014-09-11 15:12:25-04:00,['92ad9f12287a6cd8d712e63ad4a108a8655174b8'],110,252,362,3735197,15,0.350649351,0.74025974,0.935064935,6741
78ad2ef58b04051bc5c41791b7c03f90da914e5c,0,shamrath,2014-09-11 21:35:41-04:00,['92ad9f12287a6cd8d712e63ad4a108a8655174b8'],1,110,111,3735308,2,0.112676056,0.112676056,1,6741
d004df145c9e9be964c5028fca7744e7635fc4eb,0,shamrath,2014-09-11 21:36:59-04:00,"['78ad2ef58b04051bc5c41791b7c03f90da914e5c', '68e81ef80a81b1e88efeb39f0e13a0191ba2e4ce']",110,252,362,3735670,15,,,,6741
45f0d68fd3da85f692a899cc371b3247267cac74,0,shamrath,2014-09-11 22:02:56-04:00,['d004df145c9e9be964c5028fca7744e7635fc4eb'],4,18,22,3735692,1,0,0,1,6741
e45607a493dd60e40e4c405d5dd7f94ba074c666,0,lahiru,2014-09-12 10:27:36-04:00,['45f0d68fd3da85f692a899cc371b3247267cac74'],1,1,2,3735694,1,1,1,0,6741
2207eceaba64e928d37750d70833409da8008280,0,lahiru,2014-09-12 12:30:43-04:00,['e45607a493dd60e40e4c405d5dd7f94ba074c666'],2,2,4,3735698,2,,,,6741
9c23aa81147268b70472df3001bd04575a457e9e,0,shamrath,2014-09-12 17:24:59-04:00,['e45607a493dd60e40e4c405d5dd7f94ba074c666'],134,149,283,3735981,3,0.9,1,0,6741
d1d8759fd81de460752bfebf845e8293c3b3b04c,0,shamrath,2014-09-12 17:25:33-04:00,"['9c23aa81147268b70472df3001bd04575a457e9e', '2207eceaba64e928d37750d70833409da8008280']",2,2,4,3735985,2,,,,6741
59d66754474dfc4e6e3218a0a8e4b2295c65912c,0,lahiru,2014-09-15 11:02:55-04:00,['2207eceaba64e928d37750d70833409da8008280'],33,9,42,3736027,1,1,1,0,6741
87c0ee2073b24c5b47ab563038ecde1314e1a534,0,lahiru,2014-09-15 11:03:02-04:00,"['59d66754474dfc4e6e3218a0a8e4b2295c65912c', 'd1d8759fd81de460752bfebf845e8293c3b3b04c']",134,149,283,3736310,3,,,,6741
8eb65c6b0b2315ad67d3df5f509298b48ae81265,0,raminder,2014-09-15 12:09:30-04:00,['d1d8759fd81de460752bfebf845e8293c3b3b04c'],3,6,9,3736319,1,1,1,0,6741
ed5f886e5835d671401e6cf0b8395a7002b32b2a,0,raminder,2014-09-15 12:09:51-04:00,"['8eb65c6b0b2315ad67d3df5f509298b48ae81265', '87c0ee2073b24c5b47ab563038ecde1314e1a534']",33,9,42,3736361,1,,,,6741
05b9be77a7df69008f13dee7b680ab7ca350fd9d,0,raminder,2014-09-15 14:22:33-04:00,['ed5f886e5835d671401e6cf0b8395a7002b32b2a'],1,1,2,3736363,1,,,,6741
2e109fa194946d573ebb860103b94a597fe411cf,1,Chathuri Wimalasena,2014-09-15 14:52:13-04:00,['05b9be77a7df69008f13dee7b680ab7ca350fd9d'],291,433,724,3737087,6,0,0,1,6741
8abc4d3ca105f5a9f656dfaca5fa94419ca9ae95,0,Suresh Marru,2014-09-15 15:58:50-04:00,['2e109fa194946d573ebb860103b94a597fe411cf'],14,156,170,3737257,5,0.243902439,0.25203252,1,6741
e257af7219415ba31b840b5b9c80620463b77c0c,0,Chathuri Wimalasena,2014-09-16 14:21:41-04:00,['8a8a02b8814c75e8db1b069e2e7056cd8c3d0551'],11,49,60,3737317,9,0.666666667,0.666666667,0.833333333,6741
1e79c244d30a2c157566cd57a022271a3397f357,0,raminder,2014-09-17 09:29:30-04:00,['05b9be77a7df69008f13dee7b680ab7ca350fd9d'],1,1,2,3737319,1,,,,6741
014c12384a0ced0ba1c4d33b5e6f8efd4aaf6f9a,0,raminder,2014-09-17 09:29:47-04:00,"['1e79c244d30a2c157566cd57a022271a3397f357', '8abc4d3ca105f5a9f656dfaca5fa94419ca9ae95']",305,589,894,3738213,11,,,,6741
ee1df1b4ad3c12901ef225b1515d190fe2e64bc2,0,raminder,2014-09-17 09:45:08-04:00,['014c12384a0ced0ba1c4d33b5e6f8efd4aaf6f9a'],1,1,2,3738215,1,,,,6741
b8bb82ce835062dd741d8ff76041f25049499977,0,lahiru,2014-09-17 11:28:34-04:00,['ee1df1b4ad3c12901ef225b1515d190fe2e64bc2'],42,54,96,3738311,4,0,0.666666667,1,6741
288fb82aaa3752daffa9af840e5f05f5398a1f9b,0,Chathuri Wimalasena,2014-09-17 11:30:59-04:00,['e257af7219415ba31b840b5b9c80620463b77c0c'],12,19,31,3738342,1,,,,6741
17e8fd3b3c9dfd2eab8d811561d8357215f3d77d,0,Chathuri Wimalasena,2014-09-17 11:55:36-04:00,['b8bb82ce835062dd741d8ff76041f25049499977'],1,1,2,3738344,1,,,,6741
d7bb140510ce61404ada0be28b50099573bd0d64,0,lahiru,2014-09-17 11:58:21-04:00,['17e8fd3b3c9dfd2eab8d811561d8357215f3d77d'],1,6,7,3738351,1,0,1,1,6741
5df1c0484f1b6ca7debfb94331c62661cb58e0fc,0,Chathuri Wimalasena,2014-09-17 13:26:42-04:00,['17e8fd3b3c9dfd2eab8d811561d8357215f3d77d'],1,1,2,3738353,1,,,,6741
024fc5d778b82e4e3f882d1963e4a01116dd5a42,0,Chathuri Wimalasena,2014-09-17 13:31:30-04:00,"['5df1c0484f1b6ca7debfb94331c62661cb58e0fc', 'd7bb140510ce61404ada0be28b50099573bd0d64']",1,6,7,3738360,1,,,,6741
2a55d83895986e4cfac5ed3a06f39e1b2ab7b00f,0,lahiru,2014-09-17 13:55:42-04:00,['d7bb140510ce61404ada0be28b50099573bd0d64'],2,8,10,3738370,3,0,0,1,6741
c65389506a0ca0f4d0642ffc5ee351fc9de9a48b,0,lahiru,2014-09-17 13:55:49-04:00,"['2a55d83895986e4cfac5ed3a06f39e1b2ab7b00f', '024fc5d778b82e4e3f882d1963e4a01116dd5a42']",1,1,2,3738372,1,,,,6741
a7581e747f26704a6236df16bd4530ef095143c3,0,Chathuri Wimalasena,2014-09-17 16:21:24-04:00,['288fb82aaa3752daffa9af840e5f05f5398a1f9b'],0,195,195,3738567,2,0.578947368,0.827067669,0.939849624,6742
9dac178fbbe6f6cbad115da0edb2620f936a9410,0,lahiru,2014-09-18 02:24:45-04:00,['c65389506a0ca0f4d0642ffc5ee351fc9de9a48b'],54,100,154,3738721,9,0,0,1,6742
c625126fb61fdb32233a3906fad57f031387c8a8,0,msmemon,2014-09-18 11:33:30+02:00,['8abc4d3ca105f5a9f656dfaca5fa94419ca9ae95'],806,0,806,3739527,4,,,,6742
7542f69006fe819d65e0badb0cb897e196a2e0f0,0,msmemon,2014-09-18 11:43:16+02:00,"['c625126fb61fdb32233a3906fad57f031387c8a8', '9dac178fbbe6f6cbad115da0edb2620f936a9410']",100,169,269,3739796,15,,,,6742
003832ce3b756ae324f1b30f322234021ff6b569,0,lahiru,2014-09-18 15:36:13-04:00,['7542f69006fe819d65e0badb0cb897e196a2e0f0'],8,2,10,3739806,3,1,0,0,6742
e88723225d0f1dbeb0a9e5206298d624ee5b4d29,0,lahiru,2014-09-18 15:55:14-04:00,['003832ce3b756ae324f1b30f322234021ff6b569'],2,2,4,3739810,2,,,,6742
69ada188dac7fb25bc56b72fa50c487bb91ca7c3,0,lahiru,2014-09-18 16:40:07-04:00,['e88723225d0f1dbeb0a9e5206298d624ee5b4d29'],19,38,57,3739867,5,1,1,1,6742
966142339cfc93abb3ff005572982ec3a61eac01,0,lahiru,2014-09-18 17:21:25-04:00,['69ada188dac7fb25bc56b72fa50c487bb91ca7c3'],11,16,27,3739894,1,0,0,1,6742
5305b303dc99b5638212c0f200600e03cdb106e4,0,lahiru,2014-09-18 17:26:53-04:00,['966142339cfc93abb3ff005572982ec3a61eac01'],26,8,34,3739928,1,0,0,0,6742
716b85fd44dcd2cab77805a0f87f79888627e8e3,0,lahiru,2014-09-18 17:59:09-04:00,['5305b303dc99b5638212c0f200600e03cdb106e4'],15,23,38,3739966,2,0,0,0,6742
822bbe8602a00408bea7ef9ad402cfce0f30a153,0,lahiru,2014-09-18 18:11:11-04:00,['716b85fd44dcd2cab77805a0f87f79888627e8e3'],10,0,10,3739976,2,1,1,1,6742
b8deb9e9919a1096b850e961e58f1fa42881a5d5,0,lahiru,2014-09-18 18:15:53-04:00,['822bbe8602a00408bea7ef9ad402cfce0f30a153'],0,9,9,3739985,2,0,0,0,6742
450d249d6c7c8271d8f8ffce6b0b30bf317876aa,0,lahiru,2014-09-18 19:12:18-04:00,['b8deb9e9919a1096b850e961e58f1fa42881a5d5'],7,13,20,3740005,3,0,0,0,6742
e5c4d33d140463549187f16543676c923a9102f8,0,lahiru,2014-09-19 12:46:47-04:00,['450d249d6c7c8271d8f8ffce6b0b30bf317876aa'],126,132,258,3740263,1,0,1,1,6742
5996b5cc6619ecc7f7d1b35455f5be7d56a4bed8,0,lahiru,2014-09-22 10:54:03-04:00,['e5c4d33d140463549187f16543676c923a9102f8'],20,78,98,3740361,4,1,1,0.5,6743
6a11b29db44f88d5bc9a7b4b34b67b8277a6ac9a,0,raminder,2014-09-22 12:17:37-04:00,['5996b5cc6619ecc7f7d1b35455f5be7d56a4bed8'],8,14,22,3740383,4,0,0,1,6743
cc0f8ecebcadd07e4a3295f2df2739af7864f1f6,0,shamrath,2014-09-23 18:58:58-04:00,['6a11b29db44f88d5bc9a7b4b34b67b8277a6ac9a'],25,20,45,3740428,1,1,0,0,6743
412f1e7af00b7800b6794454b1c4265529eafbe7,0,Chathuri Wimalasena,2014-09-24 10:19:15-04:00,['a7581e747f26704a6236df16bd4530ef095143c3'],0,9,9,3740437,2,1,1,1,6743
dac39e04d608f44c8cd56ac7e01fc51478a04e24,0,raminder,2014-09-24 12:20:54-04:00,['6a11b29db44f88d5bc9a7b4b34b67b8277a6ac9a'],8,14,22,3740459,3,0.666666667,0.666666667,1,6743
d6e8b19d48952831c67764f8f926be6ef0d78d80,0,raminder,2014-09-24 12:25:55-04:00,"['dac39e04d608f44c8cd56ac7e01fc51478a04e24', 'cc0f8ecebcadd07e4a3295f2df2739af7864f1f6']",25,20,45,3740504,1,,,,6743
5ea8f2c0b94f3eaf200436ed5d658af6e964e18b,0,raminder,2014-09-24 12:38:02-04:00,['d6e8b19d48952831c67764f8f926be6ef0d78d80'],4,3,7,3740511,3,,,,6743
bdd025ee293edeabf2e2e635a901e0ec74ad79a2,0,lahiru,2014-09-24 13:03:05-04:00,['cc0f8ecebcadd07e4a3295f2df2739af7864f1f6'],35,132,167,3740678,7,0.45,0.55,0.85,6745
75fd7e40c5f2f193cedb9d46e1d13b18fb279864,0,lahiru,2014-09-24 13:03:13-04:00,"['bdd025ee293edeabf2e2e635a901e0ec74ad79a2', '5ea8f2c0b94f3eaf200436ed5d658af6e964e18b']",12,17,29,3740707,6,,,,6745
c366adeeed8dda19f03300076ecab70a4622ddd8,0,lahiru,2014-09-24 13:05:58-04:00,['75fd7e40c5f2f193cedb9d46e1d13b18fb279864'],1,1,2,3740709,1,,,,6745
3f89868814759f62a743a118cec6f4a299954b8e,0,lahiru,2014-09-24 14:51:25-04:00,['c366adeeed8dda19f03300076ecab70a4622ddd8'],41,38,79,3740788,1,0,0,1,6745
21c9a9266c9a509ba50990077b14d6f21fc5b619,0,lahiru,2014-09-24 15:32:19-04:00,['3f89868814759f62a743a118cec6f4a299954b8e'],6,8,14,3740802,1,0,0,1,6745
88d8638f27b18e0b38c24985906142460ef92d47,0,Chathuri Wimalasena,2014-09-24 15:54:05-04:00,['412f1e7af00b7800b6794454b1c4265529eafbe7'],35,529,564,3741366,13,0.161290323,0.307917889,1,6745
1c00c54b9b444a45d85dc50e957a0532b32e24f9,0,raminder,2014-09-24 15:59:32-04:00,['5ea8f2c0b94f3eaf200436ed5d658af6e964e18b'],64,112,176,3741542,10,0,1,1,6745
0df74e91142322d2116de42b7afb1ec4d01dcbaa,0,raminder,2014-09-24 16:07:04-04:00,"['1c00c54b9b444a45d85dc50e957a0532b32e24f9', '21c9a9266c9a509ba50990077b14d6f21fc5b619']",77,166,243,3741785,6,,,,6745
aba775e74423441740812c8e5b926b20a371122b,0,Chathuri Wimalasena,2014-09-25 09:13:18-04:00,['88d8638f27b18e0b38c24985906142460ef92d47'],4,8,12,3741797,4,0,0.25,1,6745
7ed2e3479e8af2d36ccf4244edcd6ca4e7d64f6b,0,Chathuri Wimalasena,2014-09-25 09:14:10-04:00,['aba775e74423441740812c8e5b926b20a371122b'],0,1020,1020,3742817,4,0.398026316,0.463815789,0.983552632,6749
61214dbfaa66ead4a40ad786a04d90f1375f8224,1,Chathuri Wimalasena,2014-09-25 11:14:02-04:00,['7ed2e3479e8af2d36ccf4244edcd6ca4e7d64f6b'],23,230,253,3743070,6,0.346153846,0.538461538,1,6752
cc71bac08a8539da4190eb4ef81b850fc1d75743,0,Chathuri Wimalasena,2014-09-25 15:24:33-04:00,['61214dbfaa66ead4a40ad786a04d90f1375f8224'],68,96,164,3743234,9,1,1,0.166666667,6752
aaba6d6ec687ee132c6166f1ee7efa75b73b0d83,0,lahiru,2014-09-25 17:02:56-04:00,['21c9a9266c9a509ba50990077b14d6f21fc5b619'],22,34,56,3743290,11,1,1,0.5,6752
72f3524f722979ef3af4858de7fc4ae20e81a065,0,lahiru,2014-09-26 00:44:28-04:00,"['aaba6d6ec687ee132c6166f1ee7efa75b73b0d83', '0df74e91142322d2116de42b7afb1ec4d01dcbaa']",57,98,155,3743445,9,,,,6752
7a4f2021db03021574c3072f04028f5a4c3a64b2,0,msmemon,2014-09-26 17:17:53+02:00,['72f3524f722979ef3af4858de7fc4ae20e81a065'],0,516,516,3743961,8,0.319672131,0.770491803,0.725409836,6760
2b73d478b155e6d437a7240fe6db924d7ca635bf,0,msmemon,2014-09-26 17:43:45+02:00,['7a4f2021db03021574c3072f04028f5a4c3a64b2'],482,480,962,3744923,7,0.814814815,0.888888889,0.5,6760
fa52958905e3c849083fb2f2f6824f99a4408678,0,msmemon,2014-09-26 17:51:18+02:00,['7a4f2021db03021574c3072f04028f5a4c3a64b2'],483,481,964,3745887,8,0.814814815,0.888888889,0.5,6760
7c803ce7d17ecde4876b0a3e836f204c24b60470,0,raminder,2014-09-26 12:26:33-04:00,['72f3524f722979ef3af4858de7fc4ae20e81a065'],4,14,18,3745905,2,0,0,1,6760
45e0185ccb1e8669a26d3ab54094894d20c3cf69,0,raminder,2014-09-26 12:26:55-04:00,"['7c803ce7d17ecde4876b0a3e836f204c24b60470', '2b73d478b155e6d437a7240fe6db924d7ca635bf']",479,993,1472,3747377,13,,,,6760
bf8f3d0c95b656b87e06d5b6b613ddb5ea7ea7de,0,raminder,2014-09-26 14:19:15-04:00,['45e0185ccb1e8669a26d3ab54094894d20c3cf69'],4,32,36,3747413,2,0,0,1,6760
255dd9e397890ac24aa7853e382613e10102164f,0,Chathuri Wimalasena,2014-09-26 16:03:52-04:00,['cc71bac08a8539da4190eb4ef81b850fc1d75743'],1487,1926,3413,3750826,31,1,1,1,6762
5c389b977650b5230a5d83183dfb0223905f6a8b,0,raminder,2014-09-28 09:44:04-04:00,['bf8f3d0c95b656b87e06d5b6b613ddb5ea7ea7de'],20,105,125,3750951,9,0,0,0.552631579,6762
1090843d77a4301d83474ac7c96346cd4d1a2c41,0,raminder,2014-09-28 10:57:27-04:00,['5c389b977650b5230a5d83183dfb0223905f6a8b'],23,25,48,3750999,1,,,0,6762
be767f169c5063759713d81aa0b39f9dedf7f43f,0,msmemon,2014-09-29 10:19:08+02:00,"['fa52958905e3c849083fb2f2f6824f99a4408678', '1090843d77a4301d83474ac7c96346cd4d1a2c41']",43,168,211,3751210,9,,,,6762
94f5bcb7f3ec6145f665b220db0f04665feb52b0,0,raminder,2014-09-29 11:03:31-04:00,['1090843d77a4301d83474ac7c96346cd4d1a2c41'],62,59,121,3751331,6,1,1,0,6762
9018dc8b64994308597c85b3b64b790982ca990a,0,lahiru,2014-09-29 14:07:28-04:00,['94f5bcb7f3ec6145f665b220db0f04665feb52b0'],26,63,89,3751420,3,0,0,1,6762
71de39d9eb7532c92357e28bedfaffda76002b45,0,raminder,2014-09-29 16:08:32-04:00,['9018dc8b64994308597c85b3b64b790982ca990a'],65,4,69,3751489,8,1,1,0,6762
b78e04e7808cb8e1e709efb599c55f00370fc263,0,msmemon,2014-09-30 12:56:43+02:00,"['be767f169c5063759713d81aa0b39f9dedf7f43f', '71de39d9eb7532c92357e28bedfaffda76002b45']",109,82,191,3751680,11,,,,6762
4917ce2a9d83d62219639ed57a37a9b0c5ab2f3c,0,raminder,2014-09-30 12:49:19-04:00,['71de39d9eb7532c92357e28bedfaffda76002b45'],31,67,98,3751778,2,0,0,1,6762
ffe8b9fd1486a223000ccc175cd58b4799d76cb4,0,lahiru,2014-09-30 16:02:06-04:00,['9018dc8b64994308597c85b3b64b790982ca990a'],2,3,5,3751783,1,0,1,1,6762
55285038f5a9945ebb4b709b19927f3319579549,0,lahiru,2014-09-30 16:02:23-04:00,"['ffe8b9fd1486a223000ccc175cd58b4799d76cb4', '4917ce2a9d83d62219639ed57a37a9b0c5ab2f3c']",96,71,167,3751950,10,,,,6762
ec87ecb485b86423069949026da9bcbcf9cad239,0,msmemon,2014-10-01 13:54:48+02:00,"['b78e04e7808cb8e1e709efb599c55f00370fc263', '55285038f5a9945ebb4b709b19927f3319579549']",33,70,103,3752053,3,,,,6762
9372890cab9aedd3c08ecf6b0d10dfe6ecd51892,0,lahiru,2014-10-01 14:59:11-04:00,['55285038f5a9945ebb4b709b19927f3319579549'],53,151,204,3752257,2,0,0,1,6762
3800bc19b6eb80314fb18d4d292aed72e88a3b73,0,lahiru,2014-10-01 22:36:43-04:00,['9372890cab9aedd3c08ecf6b0d10dfe6ecd51892'],2,2,4,3752261,1,,,,6762
44dc03b2e8d49eb58859339bd582b382114898f6,0,lahiru,2014-10-02 09:29:54-04:00,['3800bc19b6eb80314fb18d4d292aed72e88a3b73'],3,3,6,3752267,3,,,,6762
2bbeb7a996652ab812ffeed96b7944ab6dbfe80d,0,lahiru,2014-10-02 10:27:49-04:00,['44dc03b2e8d49eb58859339bd582b382114898f6'],16,60,76,3752343,3,0.020833333,0.125,1,6762
1e6a7ba4ba1d868aac534c1dbf22a7e25ef637ed,0,msmemon,2014-10-02 16:44:06+02:00,"['ec87ecb485b86423069949026da9bcbcf9cad239', '2bbeb7a996652ab812ffeed96b7944ab6dbfe80d']",74,216,290,3752633,7,,,,6762
3cca77d0a5913c98b316c967878a6246783224b7,0,lahiru,2014-10-02 14:02:29-04:00,['2bbeb7a996652ab812ffeed96b7944ab6dbfe80d'],9,8,17,3752650,2,1,1,0,6762
af6b9d51362c190c706baa034dfd15be08bfe2af,0,lahiru,2014-10-02 14:06:57-04:00,['3cca77d0a5913c98b316c967878a6246783224b7'],14,9,23,3752673,1,1,1,0,6762
c6825295db58a7011458e26d70798eed5fdff9e0,0,lahiru,2014-10-02 14:43:01-04:00,['af6b9d51362c190c706baa034dfd15be08bfe2af'],2,4,6,3752679,1,0,0,1,6762
9258b90199cd59a281f2eb05b89ea0c9e558537e,0,lahiru,2014-10-02 15:53:07-04:00,['c6825295db58a7011458e26d70798eed5fdff9e0'],40,22,62,3752741,2,1,1,0,6762
a256f3516536920c97e26676e2fcc45213bfa2b2,0,lahiru,2014-10-02 17:24:47-04:00,['9258b90199cd59a281f2eb05b89ea0c9e558537e'],8,4,12,3752753,2,1,1,0,6762
595be55fd0dfe89fd045e0c2eacc5ab234f69731,1,shamrath,2014-10-02 20:57:14-04:00,['2bbeb7a996652ab812ffeed96b7944ab6dbfe80d'],214,1274,1488,3754241,12,0.769230769,0.963800905,0.642533937,6765
075744e51b8433fc9ef6d7d3a338b2c1512226e7,0,shamrath,2014-10-02 21:10:47-04:00,"['595be55fd0dfe89fd045e0c2eacc5ab234f69731', 'a256f3516536920c97e26676e2fcc45213bfa2b2']",58,39,97,3754338,3,,,,6765
881d169c654080c9cb55540fc7982728a0f52871,1,shamrath,2014-10-02 21:39:57-04:00,['075744e51b8433fc9ef6d7d3a338b2c1512226e7'],0,2,2,3754340,1,,,,6765
3c5fd4bb7024b9abf29e31ac3cba65707eb411fb,0,lahiru,2014-10-02 23:12:43-04:00,['a256f3516536920c97e26676e2fcc45213bfa2b2'],18,5,23,3754363,1,1,1,0,6765
06b79c3b473ab546cac2800823f22006e8f28b92,0,lahiru,2014-10-02 23:14:09-04:00,['3c5fd4bb7024b9abf29e31ac3cba65707eb411fb'],1,1,2,3754365,1,,,,6765
36158985cbf959046fb0c27e84a32269086772a1,0,lahiru,2014-10-02 23:15:10-04:00,"['06b79c3b473ab546cac2800823f22006e8f28b92', '881d169c654080c9cb55540fc7982728a0f52871']",214,1283,1497,3755862,13,,,,6765
667343064f8a22f5d4ab562482643accd39e4759,0,lahiru,2014-10-02 23:35:16-04:00,['36158985cbf959046fb0c27e84a32269086772a1'],1,3,4,3755866,2,1,1,0,6765
10139baa62ff52d6fcbb6aac131e4707f51458d6,0,lahiru,2014-10-03 10:17:28-04:00,['667343064f8a22f5d4ab562482643accd39e4759'],0,2,2,3755868,1,1,1,0,6765
c2b9158eaacf8ce54add5dfb37c69e3518c03544,0,Chathuri Wimalasena,2014-10-03 11:25:24-04:00,['10139baa62ff52d6fcbb6aac131e4707f51458d6'],2,2,4,3755872,1,,,,6765
b810ee505b1c5a50bf099f3f1dfddf98ff114ca1,0,lahiru,2014-10-03 12:34:05-04:00,['10139baa62ff52d6fcbb6aac131e4707f51458d6'],2,3,5,3755877,1,0,0,1,6765
18f70920ddf5c2be329a6ccd0cc9038193aeb904,0,lahiru,2014-10-03 12:34:12-04:00,"['b810ee505b1c5a50bf099f3f1dfddf98ff114ca1', 'c2b9158eaacf8ce54add5dfb37c69e3518c03544']",2,2,4,3755881,1,,,,6765
73856bd2a9a96e01d6c1b50a0a599f18c758ed15,0,lahiru,2014-10-03 12:42:31-04:00,['18f70920ddf5c2be329a6ccd0cc9038193aeb904'],1,1,2,3755883,1,,,,6765
1ef608cd6c729f8fe0ddf431e65cb1c076865e81,0,lahiru,2014-10-03 13:26:29-04:00,['73856bd2a9a96e01d6c1b50a0a599f18c758ed15'],0,4,4,3755887,1,0,0,1,6765
cbfeb2c36d563743894402ffc4b0c870485f3b98,0,raminder,2014-10-03 13:54:53-04:00,['1ef608cd6c729f8fe0ddf431e65cb1c076865e81'],7,25,32,3755919,2,0,0,1,6765
2b0b6a27200cce66cb2e15a89009407b48647f97,0,Chathuri Wimalasena,2014-10-03 15:19:20-04:00,['cbfeb2c36d563743894402ffc4b0c870485f3b98'],13,22,35,3755954,8,0,0,1,6765
42fee53eb8cc956480a0fc6888ccf720020a2dc9,0,lahiru,2014-10-03 16:05:00-04:00,['1ef608cd6c729f8fe0ddf431e65cb1c076865e81'],11,10,21,3755975,3,0.909090909,0.454545455,0.454545455,6765
65093348446c86cf1f94c84086c5ca8c2065d1f0,0,lahiru,2014-10-03 16:05:57-04:00,"['42fee53eb8cc956480a0fc6888ccf720020a2dc9', '2b0b6a27200cce66cb2e15a89009407b48647f97']",20,47,67,3756042,10,,,,6765
552f9b1e537ae12d54f8e455f11c6bb3b825c676,0,lahiru,2014-10-03 16:18:16-04:00,['65093348446c86cf1f94c84086c5ca8c2065d1f0'],9,9,18,3756060,2,1,0.444444444,0.555555556,6765
60de53978f8fdd2441366772648b195000cb4391,0,lahiru,2014-10-03 17:12:44-04:00,['552f9b1e537ae12d54f8e455f11c6bb3b825c676'],0,10,10,3756070,1,0,0,1,6765
dbb1c97a11d806c2c726b0bfb1ed04b0a24c22bb,1,Chathuri Wimalasena,2014-10-06 11:16:50-04:00,['60de53978f8fdd2441366772648b195000cb4391'],37,2066,2103,3758173,21,0.20836143,0.196898179,1,6771
282362f1088918d1dfd8c88c9b71bac119a665c9,0,Chathuri Wimalasena,2014-10-06 15:54:40-04:00,"['dbb1c97a11d806c2c726b0bfb1ed04b0a24c22bb', '255dd9e397890ac24aa7853e382613e10102164f']",814,11037,11851,3770024,65,,,,6771
00e242033abde3a447520b1ca1b0589240bb1b90,0,raminder,2014-10-06 18:15:10-04:00,['cbfeb2c36d563743894402ffc4b0c870485f3b98'],0,313,313,3770337,1,0.397515528,1,0.645962733,6772
57adb55db728c7f871361f97394da877b8f91173,0,raminder,2014-10-06 18:15:19-04:00,"['00e242033abde3a447520b1ca1b0589240bb1b90', '282362f1088918d1dfd8c88c9b71bac119a665c9']",878,13148,14026,3784363,94,,,,6772
42219ba5f629f8cc81a262f944a9fae4f257c801,0,lahiru,2014-10-07 17:06:16-04:00,['dbb1c97a11d806c2c726b0bfb1ed04b0a24c22bb'],102,161,263,3784626,15,0,0.476190476,0.857142857,6772
d70b9d39d8aa9f1e7aa823b025dfe0c963fb0d55,0,shamrath,2014-10-08 11:40:32-04:00,['2b73d478b155e6d437a7240fe6db924d7ca635bf'],159,1063,1222,3785848,16,0,0.940063091,0.675078864,6774
ede952309f3ec1265e4e6b4876f1112878968b0e,0,shamrath,2014-10-08 11:42:01-04:00,['d70b9d39d8aa9f1e7aa823b025dfe0c963fb0d55'],5,7,12,3785860,1,0.678571429,0,0,6774
896d34599f35d1269120ef90bc5b71dadeaa19e1,0,shamrath,2014-10-08 11:43:07-04:00,"['ede952309f3ec1265e4e6b4876f1112878968b0e', '57adb55db728c7f871361f97394da877b8f91173']",1319,15236,16555,3802415,121,,,,6774
a9a370d19b02499dc371baa5e95eb34a42fbb4c6,0,shamrath,2014-10-08 12:01:20-04:00,['896d34599f35d1269120ef90bc5b71dadeaa19e1'],42,54,96,3802511,4,0.214285714,0,0.928571429,6774
7de087118259a68e8c3ea30bfdf3a1568460cefc,0,lahiru,2014-10-08 12:12:44-04:00,"['42219ba5f629f8cc81a262f944a9fae4f257c801', '57adb55db728c7f871361f97394da877b8f91173']",812,11352,12164,3814675,66,,,,6774
a4c186c15b4a277a1a60b3e6393767dfcaa7ff76,0,lahiru,2014-10-08 13:05:07-04:00,['7de087118259a68e8c3ea30bfdf3a1568460cefc'],12,12,24,3814699,1,,,,6774
3b63a288695efec8a6a0cacbb478983f49d98963,0,lahiru,2014-10-08 14:10:28-04:00,['a4c186c15b4a277a1a60b3e6393767dfcaa7ff76'],181,122,303,3815002,4,1,1,0,6774
532233f7b46e20ab66967740e58c289cc3dbe79b,0,lahiru,2014-10-08 14:36:09-04:00,['3b63a288695efec8a6a0cacbb478983f49d98963'],6,33,39,3815041,3,0,0,1,6774
cc8722249c26a73741e757c424278ca698a27183,0,lahiru,2014-10-08 14:50:06-04:00,['532233f7b46e20ab66967740e58c289cc3dbe79b'],6,21,27,3815068,3,0,0,1,6774
9b5a4fe7d74b2a98a2bee9ebb4d189b2131f9d9d,0,lahiru,2014-10-08 14:52:19-04:00,['cc8722249c26a73741e757c424278ca698a27183'],0,50,50,3815118,1,1,1,0.642857143,6775
f84eeeae281a5d7f2a8caa573006693fa2ba98a3,0,lahiru,2014-10-08 15:19:43-04:00,['9b5a4fe7d74b2a98a2bee9ebb4d189b2131f9d9d'],1,1,2,3815120,1,,,,6775
b6ca98a52005c2bcc1e3168dd9fe31ffa525c308,0,shamrath,2014-10-08 18:36:43-04:00,['a9a370d19b02499dc371baa5e95eb34a42fbb4c6'],14,87,101,3815221,2,0.018518519,0,1,6775
3fa5c502e20378b74d1990e1c133ea58894887f5,0,lahiru,2014-10-09 02:43:52-04:00,['f84eeeae281a5d7f2a8caa573006693fa2ba98a3'],1,4,5,3815226,1,0,0,1,6775
fd81a3d40979a76306ce6f16911f6add67e93003,0,lahiru,2014-10-09 02:58:39-04:00,['3fa5c502e20378b74d1990e1c133ea58894887f5'],1,1,2,3815228,1,,,,6775
ad02735f15937616d19f802e060fb0cc99df49b2,0,lahiru,2014-10-09 03:04:23-04:00,['fd81a3d40979a76306ce6f16911f6add67e93003'],4,6,10,3815238,1,0,0,1,6775
8b978c62ec74950fb1c37ca37d38301c7506033e,0,Chathuri Wimalasena,2014-10-09 12:23:45-04:00,['ad02735f15937616d19f802e060fb0cc99df49b2'],7,218,225,3815463,7,0.253164557,0.455696203,1,6778
61fa9e5e3211feb82252c973875590a463846885,0,shamrath,2014-10-09 13:26:55-04:00,['b6ca98a52005c2bcc1e3168dd9fe31ffa525c308'],20,32,52,3815515,2,1,1,1,6778
8cfe4f9eabeff73e528b38c2c47672ed54c88305,0,shamrath,2014-10-09 13:27:33-04:00,"['61fa9e5e3211feb82252c973875590a463846885', '8b978c62ec74950fb1c37ca37d38301c7506033e']",302,614,916,3816431,27,,,,6778
42bc8defb0bd9c6f25af25b1f2e9d5f41ede1bc4,0,raminder,2014-10-10 15:17:02-04:00,['8cfe4f9eabeff73e528b38c2c47672ed54c88305'],1,11,12,3816443,1,0,0,1,6778
7781079dd6687eecd7afed0399c5ec681ed437c5,0,lahiru,2014-10-10 19:01:50-04:00,['42bc8defb0bd9c6f25af25b1f2e9d5f41ede1bc4'],27,28,55,3816498,4,1,0.454545455,0.818181818,6778
2fa6af64b1846257e27289e60a982dfda6facecf,0,raminder,2014-10-11 10:31:35-04:00,['7781079dd6687eecd7afed0399c5ec681ed437c5'],5,12,17,3816515,1,0,0,1,6778
3989e08fb2d728b901a685ec2e633019fbd06038,0,lahiru,2014-10-11 13:26:38-04:00,['7781079dd6687eecd7afed0399c5ec681ed437c5'],8,12,20,3816535,2,1,1,0,6778
7496f507fa67bfdd801bef2a71d08b4d459046e2,0,lahiru,2014-10-11 13:28:26-04:00,"['3989e08fb2d728b901a685ec2e633019fbd06038', '2fa6af64b1846257e27289e60a982dfda6facecf']",5,12,17,3816552,1,,,,6778
e7be1f4e896cbe5f11924377771cdc85411354f8,0,lahiru,2014-10-11 14:55:44-04:00,['7496f507fa67bfdd801bef2a71d08b4d459046e2'],1,3,4,3816556,1,0,0,0,6778
6e1aa3ede5e2f94f8711b53a203e15c81959fe3e,0,lahiru,2014-10-14 10:57:26-04:00,['e7be1f4e896cbe5f11924377771cdc85411354f8'],7,21,28,3816584,2,0,0.545454545,0.727272727,6778
166ea52373877b5253dc7362571c486539c20867,0,Chathuri Wimalasena,2014-10-14 11:21:56-04:00,['6e1aa3ede5e2f94f8711b53a203e15c81959fe3e'],2,4,6,3816590,2,0,0,1,6778
a82045d623b3d4b9dbd8d28e1c278a5880a89f06,0,Chathuri Wimalasena,2014-10-14 12:17:02-04:00,['166ea52373877b5253dc7362571c486539c20867'],37,58,95,3816685,4,0,0.5,0.583333333,6779
e515651957befb461f741be3e0214145556624ca,0,Chathuri Wimalasena,2014-10-14 16:23:31-04:00,['a82045d623b3d4b9dbd8d28e1c278a5880a89f06'],8,12,20,3816705,4,0,0.666666667,1,6779
11002b7eb0db3afa6ec9ac1841d768d88a0cccee,0,Chathuri Wimalasena,2014-10-14 20:36:36-04:00,['e515651957befb461f741be3e0214145556624ca'],8,18,26,3816731,3,0,0,1,6779
ccebc44de18d8be695e75197a2bf60b1320ef6d8,0,Chathuri Wimalasena,2014-10-14 20:41:42-04:00,['11002b7eb0db3afa6ec9ac1841d768d88a0cccee'],2,2,4,3816735,2,,,,6779
c39d0fce2407ea4f610f8bcc23c9ec07db004b63,0,Chathuri Wimalasena,2014-10-15 15:35:59-04:00,['ccebc44de18d8be695e75197a2bf60b1320ef6d8'],16,100,116,3816851,5,0.595744681,0.723404255,1,6780
007c14382f5e0bb72717c2590d5bc35c47380487,0,shamrath,2014-10-16 00:49:34-04:00,['ccebc44de18d8be695e75197a2bf60b1320ef6d8'],336,1936,2272,3819123,30,0.889891697,1,1,6790
1e520bc69323117c53aa15bdd5f906891afffa8b,0,shamrath,2014-10-16 00:50:30-04:00,"['007c14382f5e0bb72717c2590d5bc35c47380487', 'c39d0fce2407ea4f610f8bcc23c9ec07db004b63']",16,100,116,3819239,5,,,,6790
9aeed4d321f84beea8c84d7f0b657597e6c2bf58,0,raminder,2014-10-16 10:23:24-04:00,['1e520bc69323117c53aa15bdd5f906891afffa8b'],1154,337,1491,3820730,24,0.564705882,1,0,6790
7e498ac54b5e135311b60923fad80247f04470f9,0,Chathuri Wimalasena,2014-10-16 10:25:52-04:00,['9aeed4d321f84beea8c84d7f0b657597e6c2bf58'],371,189,560,3821290,10,0.722222222,0.455555556,0,6790
6e49e375f2cc0da3c7d679ee43f73c72f48e57c8,0,raminder,2014-10-16 10:37:34-04:00,['9aeed4d321f84beea8c84d7f0b657597e6c2bf58'],3,2,5,3821295,1,0,0,0,6790
ce7fad1b3b571ef0bd6c5f980fb91131a199ead7,0,Chathuri Wimalasena,2014-10-16 11:20:14-04:00,"['7e498ac54b5e135311b60923fad80247f04470f9', '6e49e375f2cc0da3c7d679ee43f73c72f48e57c8']",3,2,5,3821300,1,,,,6790
51f456d8c7e8ae912d43aafc459532f2477600e6,0,Chathuri Wimalasena,2014-10-16 11:22:12-04:00,['ce7fad1b3b571ef0bd6c5f980fb91131a199ead7'],14,6,20,3821320,2,,,,6790
0c981d6fc97e748ff5746bd6e3d92c94228b0f1d,0,lahiru,2014-10-16 15:37:33-04:00,['51f456d8c7e8ae912d43aafc459532f2477600e6'],54,80,134,3821454,1,0.08,0.12,0.96,6790
589c71c230aaf81ab7d133d3bb697b34f017aece,0,raminder,2014-10-16 15:54:08-04:00,['6e49e375f2cc0da3c7d679ee43f73c72f48e57c8'],10,493,503,3821957,6,0,0,1,6794
82da3d2a77ca94dfa623a7c985bf43cc2e1e0586,0,raminder,2014-10-16 15:54:28-04:00,"['589c71c230aaf81ab7d133d3bb697b34f017aece', '0c981d6fc97e748ff5746bd6e3d92c94228b0f1d']",435,271,706,3822663,11,,,,6794
50101e9841917ed26bfb4700d8e9500b7032444a,0,lahiru,2014-10-16 19:07:05-04:00,['0c981d6fc97e748ff5746bd6e3d92c94228b0f1d'],10,1,11,3822674,1,1,1,0,6794
62ba4710fadb249c2ad0a185ed97892d2877dcda,0,shamrath,2014-10-16 22:50:55-04:00,['1e520bc69323117c53aa15bdd5f906891afffa8b'],0,16,16,3822690,2,0.857142857,0.857142857,1,6794
7c2af98553ef0a243242a2c48aeb969eb226711d,0,shamrath,2014-10-16 23:00:04-04:00,"['62ba4710fadb249c2ad0a185ed97892d2877dcda', '82da3d2a77ca94dfa623a7c985bf43cc2e1e0586']",1602,1103,2705,3825395,42,,,,6794
8d18255f3858bfd39a7b3ac2e177560047701561,0,Chathuri Wimalasena,2014-10-17 11:37:53-04:00,['82da3d2a77ca94dfa623a7c985bf43cc2e1e0586'],141,273,414,3825809,5,0,0,1,6794
3b2ea90441a575b8b6e900fbe7438b9e77f7ee67,0,lahiru,2014-10-17 12:01:36-04:00,"['50101e9841917ed26bfb4700d8e9500b7032444a', '8d18255f3858bfd39a7b3ac2e177560047701561']",151,766,917,3826726,11,,,,6794
d4bf1e9cd73650e4c37857625f9191311f5223ee,0,shamrath,2014-10-17 12:10:36-04:00,['7c2af98553ef0a243242a2c48aeb969eb226711d'],150,15,165,3826891,5,1,1,0,6794
60937d3620df587a34c6be0405f16469cf1b3943,0,shamrath,2014-10-17 12:13:09-04:00,"['d4bf1e9cd73650e4c37857625f9191311f5223ee', '8d18255f3858bfd39a7b3ac2e177560047701561']",141,273,414,3827305,5,,,,6794
97e94d9d5c7b59cddb1253f331057867a0df859a,0,Chathuri Wimalasena,2014-10-17 13:00:53-04:00,['60937d3620df587a34c6be0405f16469cf1b3943'],0,2,2,3827307,1,0,0,1,6794
cb94631e32a10a66e0986f45454fe50d29419fd2,0,Chathuri Wimalasena,2014-10-17 14:36:59-04:00,['97e94d9d5c7b59cddb1253f331057867a0df859a'],0,4,4,3827311,1,0,0,1,6794
1da5054a26b23096a111f15ddba616c29219b654,1,msmemon,2014-10-20 16:32:26+02:00,['1e6a7ba4ba1d868aac534c1dbf22a7e25ef637ed'],326,684,1010,3828321,18,0.532608696,0.657608696,0.706521739,6794
19f9ae7b878d0c2fe4f7d78bfae57f93131bfc63,0,msmemon,2014-10-20 17:23:58+02:00,"['1da5054a26b23096a111f15ddba616c29219b654', 'cb94631e32a10a66e0986f45454fe50d29419fd2']",3326,19584,22910,3851231,200,,,,6794
6c6c7468835546cab63d632e9226cdf1c40765ba,1,msmemon,2014-10-20 17:30:44+02:00,['19f9ae7b878d0c2fe4f7d78bfae57f93131bfc63'],5314,7598,12912,3864143,5,0.367463026,0.504550626,0.909556314,6794
1c95b2d1b1763c79ed48066b3c37a07c3a417591,1,msmemon,2014-10-20 17:34:54+02:00,['6c6c7468835546cab63d632e9226cdf1c40765ba'],0,359,359,3864502,2,0.153284672,0.412408759,1,6796
83471ba8218ac89b2bfedfe56d2adfafb07b059f,0,msmemon,2014-10-20 17:41:05+02:00,['1c95b2d1b1763c79ed48066b3c37a07c3a417591'],27,1024,1051,3865553,4,0.373814042,0.447817837,0.743833017,6798
66de22254f02099ab1cffeb2d59901738d839569,0,Chathuri Wimalasena,2014-10-20 13:48:59-04:00,['83471ba8218ac89b2bfedfe56d2adfafb07b059f'],0,1,1,3865554,1,,,,6798
98f03190ae4779f5fbf1b4d37a0076093f8c7751,0,Chathuri Wimalasena,2014-10-20 14:05:20-04:00,['66de22254f02099ab1cffeb2d59901738d839569'],26,1,27,3865581,1,,,,6798
4e47079e0337cb347f54dde088c67a99107aabe9,1,Chathuri Wimalasena,2014-10-20 14:15:37-04:00,['98f03190ae4779f5fbf1b4d37a0076093f8c7751'],0,59,59,3865640,2,,,,6798
ff380e00fbad7ca78e5ef280f768539a762355fe,0,raminder,2014-10-20 14:33:05-04:00,['4e47079e0337cb347f54dde088c67a99107aabe9'],0,16,16,3865656,1,,,,6798
9bcef2c04a8306a0e56ac9a77d4bc5a893488a32,0,Suresh Marru,2014-10-20 15:34:51-04:00,['ff380e00fbad7ca78e5ef280f768539a762355fe'],2,48,50,3865706,1,0,1,1,6798
cbd947cfd616b4a75562cfa3e289c58015afa108,0,msmemon,2014-10-21 17:18:10+02:00,['9bcef2c04a8306a0e56ac9a77d4bc5a893488a32'],160,157,317,3866023,4,1,1,0,6798
adb9b956bf6b65aca60af423819b103f673b54f8,0,Chathuri Wimalasena,2014-10-21 17:29:48-04:00,['cbd947cfd616b4a75562cfa3e289c58015afa108'],86,701,787,3866810,23,0.125925926,0.001851852,0.940740741,6798
6cf4f876cc0b49383deaf735b02f0a11e16c28df,0,lahiru,2014-10-21 21:47:25-04:00,"['3b2ea90441a575b8b6e900fbe7438b9e77f7ee67', 'adb9b956bf6b65aca60af423819b103f673b54f8']",6052,10670,16722,3883532,59,,,,6798
1acec7bdaab946bc70b577608f62a0bfd99f3cdc,0,lahiru,2014-10-21 21:48:21-04:00,['6cf4f876cc0b49383deaf735b02f0a11e16c28df'],2,14,16,3883548,3,1,1,1,6798
100a35a0474ac834fb90495493013389aa203f5b,0,lahiru,2014-10-21 22:14:58-04:00,['1acec7bdaab946bc70b577608f62a0bfd99f3cdc'],10,10,20,3883568,2,,,,6798
58528ae69479fcdfd752ab449ea023fac6285cf0,0,msmemon,2014-10-22 15:13:55+02:00,['100a35a0474ac834fb90495493013389aa203f5b'],479,911,1390,3884958,12,0.389908257,0.550458716,1,6801
18c14f701a731aacdf0f73bc5c7e5baedffacd2a,0,lahiru,2014-10-22 14:13:02-04:00,['100a35a0474ac834fb90495493013389aa203f5b'],0,1,1,3884959,1,0,0,1,6801
a3024417aece2e2ddaa69306de8e85c384116882,0,lahiru,2014-10-22 14:13:09-04:00,"['18c14f701a731aacdf0f73bc5c7e5baedffacd2a', '58528ae69479fcdfd752ab449ea023fac6285cf0']",479,911,1390,3886349,12,,,,6801
5b0dfd80bfd2252ec1e02fbe36c3b1097b62df37,0,lahiru,2014-10-22 14:32:25-04:00,['a3024417aece2e2ddaa69306de8e85c384116882'],23,24,47,3886396,1,0,0,1,6801
9e750d8ad8170b4034bdbd4552eb2608766a9fb9,0,lahiru,2014-10-22 21:01:51-04:00,['5b0dfd80bfd2252ec1e02fbe36c3b1097b62df37'],1,2,3,3886399,1,0,0,1,6801
9ae7c6ec3930f55b4de5214b80bd7ebb0d0b2836,0,msmemon,2014-10-23 17:32:30+02:00,['9e750d8ad8170b4034bdbd4552eb2608766a9fb9'],1383,1385,2768,3889167,19,0,0.1,1,6801
ce4b324907381fb1d79733c5605b30c5f3311993,0,Chathuri Wimalasena,2014-10-23 11:36:57-04:00,['9ae7c6ec3930f55b4de5214b80bd7ebb0d0b2836'],13,61,74,3889241,4,0.236842105,0.736842105,0.736842105,6801
6e42be782c35abe7082ed6e0589f70b04349c25b,0,shamrath,2014-10-23 13:08:31-04:00,['60937d3620df587a34c6be0405f16469cf1b3943'],234,960,1194,3890435,35,0.48024948,0.61954262,1,6802
1d83a48b7d929e8a3b710ca5ede3ac791a7f4ae8,1,Chathuri Wimalasena,2014-10-23 13:54:39-04:00,['ce4b324907381fb1d79733c5605b30c5f3311993'],601,553,1154,3891589,12,0.25,0,1,6802
723b2e9484585c2a0ce90ccb64ec61597c48df05,0,shamrath,2014-10-23 16:44:24-04:00,['6e42be782c35abe7082ed6e0589f70b04349c25b'],3,5,8,3891597,2,0,0.5,1,6802
e5131ad8780045412660b5f4a9fa59848998e1fc,0,lahiru,2014-10-24 02:55:48-04:00,['1d83a48b7d929e8a3b710ca5ede3ac791a7f4ae8'],56,78,134,3891731,3,1,1,1,6802
fc25c7284a77f51a68b7509a6366e733f66c59be,0,lahiru,2014-10-24 11:09:02-04:00,['e5131ad8780045412660b5f4a9fa59848998e1fc'],0,37,37,3891768,1,1,1,1,6803
b95e9206037a712c93d51759d4287cac740b0e94,1,Chathuri Wimalasena,2014-10-24 11:26:52-04:00,['fc25c7284a77f51a68b7509a6366e733f66c59be'],197,183,380,3892148,15,1,0.714285714,0,6803
47e82148945907939bbb82ecde4d05c7b9ebe6d1,1,Chathuri Wimalasena,2014-10-24 14:34:54-04:00,['b95e9206037a712c93d51759d4287cac740b0e94'],4127,18130,22257,3914405,7,0.426023778,0.540290621,0.951783355,6803
6e0ea93502cb5527f48ba985b963746665e75702,0,shamrath,2014-10-28 11:42:12-04:00,"['47e82148945907939bbb82ecde4d05c7b9ebe6d1', '723b2e9484585c2a0ce90ccb64ec61597c48df05']",235,962,1197,3915602,36,,,,6803
3b330c0d39e6bf156550a7293bb9fe051344ed6b,0,shamrath,2014-10-28 14:12:36-04:00,['6e0ea93502cb5527f48ba985b963746665e75702'],3,3,6,3915608,3,,,,6803
478d9e5559a0fed5c9b7fee04c6fa92af9e9dcf2,0,Chathuri Wimalasena,2014-10-28 16:23:38-04:00,['3b330c0d39e6bf156550a7293bb9fe051344ed6b'],334,160,494,3916102,8,1,1,1,6803
0cacb10e02d0016f705336a031902518738ebc51,0,Chathuri Wimalasena,2014-10-30 10:11:19-04:00,['478d9e5559a0fed5c9b7fee04c6fa92af9e9dcf2'],51,148,199,3916301,6,0.181818182,0.03030303,0.515151515,6803
b3769516eec7d7127e17d2e24e4001718763c1ec,0,lahiru,2014-10-30 11:27:12-04:00,['3b330c0d39e6bf156550a7293bb9fe051344ed6b'],85,146,231,3916532,8,0.229166667,0.229166667,0.979166667,6803
8b82bee96cc6e16b7f9c24b072f9c7cf76738d6c,1,Chathuri Wimalasena,2014-10-30 12:16:59-04:00,['b3769516eec7d7127e17d2e24e4001718763c1ec'],11490,19622,31112,3947644,9,0.418529838,0.548978607,0.951584365,6803
a15be7ca5056249c6a623c8177f51393349b9942,0,shamrath,2014-10-30 12:20:54-04:00,['0cacb10e02d0016f705336a031902518738ebc51'],204,511,715,3948359,11,0.209459459,0,1,6804
99e47f16b20c80f5338eabde53cf9a0c9f46e5d4,0,lahiru,2014-10-30 14:19:11-04:00,['b3769516eec7d7127e17d2e24e4001718763c1ec'],45,51,96,3948455,3,1,1,0,6804
a728bf2127dfacab50718b4188b7bcc0aa742a2d,0,lahiru,2014-10-30 14:19:22-04:00,"['99e47f16b20c80f5338eabde53cf9a0c9f46e5d4', '8b82bee96cc6e16b7f9c24b072f9c7cf76738d6c']",11490,19622,31112,3979567,9,,,,6804
a3cef493bd4384309f471255d09a589c941f1730,1,Chathuri Wimalasena,2014-10-30 15:11:18-04:00,['a728bf2127dfacab50718b4188b7bcc0aa742a2d'],1992,10529,12521,3992088,16,0.511321664,0.610085113,0.975429581,6805
306464c376fb14465bbf2566e81eea422dfb906b,0,Chathuri Wimalasena,2014-10-30 15:12:32-04:00,['a3cef493bd4384309f471255d09a589c941f1730'],0,1927,1927,3994015,1,0.293557423,0.542296919,1,6806
1e992d9ca9cdae4816f8caabb1fc8c5038051fe7,0,shamrath,2014-10-30 15:57:33-04:00,['a15be7ca5056249c6a623c8177f51393349b9942'],43,85,128,3994143,2,1,1,1,6806
add6b58a0632125e596ae3e4033bf573dc3b245d,0,shamrath,2014-10-30 16:34:35-04:00,['1e992d9ca9cdae4816f8caabb1fc8c5038051fe7'],263,264,527,3994670,7,0,1,1,6806
0db9cad01273e0dc40be20042643c190044697ce,0,Chathuri Wimalasena,2014-10-30 16:58:16-04:00,['306464c376fb14465bbf2566e81eea422dfb906b'],1,1,2,3994672,1,0,0,0,6806
14bd9416af4ced1702086a43f82dacc35b4b8a46,0,Chathuri Wimalasena,2014-10-30 17:06:06-04:00,['add6b58a0632125e596ae3e4033bf573dc3b245d'],5,43,48,3994720,3,1,1,1,6806
f29dfbe709c322703225e7f14f1bb1ffd1129a02,0,shamrath,2014-10-31 12:25:31-04:00,['14bd9416af4ced1702086a43f82dacc35b4b8a46'],156,213,369,3995089,10,0.107142857,0.75,1,6806
04f09e7d424ee94d514c6423cd5f524eb7d53181,0,Chathuri Wimalasena,2014-10-31 14:40:50-04:00,['f29dfbe709c322703225e7f14f1bb1ffd1129a02'],400,306,706,3995795,6,0.453125,0,0.5,6806
ad2b1d3a97ec38cb98c970fa815b4863c9e8e898,0,shamrath,2014-10-31 17:41:22-04:00,['f29dfbe709c322703225e7f14f1bb1ffd1129a02'],71,143,214,3996009,7,1,1,0,6806
bb4fe1226ae1a170f59e3992116bcea70f19c3f6,0,shamrath,2014-10-31 17:41:42-04:00,"['ad2b1d3a97ec38cb98c970fa815b4863c9e8e898', '04f09e7d424ee94d514c6423cd5f524eb7d53181']",400,306,706,3996715,6,,,,6806
2dd94e633c1b2ceb17211f28aed9b044d9f7353a,0,shamrath,2014-11-04 12:32:09-05:00,['bb4fe1226ae1a170f59e3992116bcea70f19c3f6'],1001,869,1870,3998585,14,0.924882629,0.643192488,0.197183099,6806
08fff2ce283af84f51e63f9443a982cc9c94852a,1,Chathuri Wimalasena,2014-11-04 13:07:25-05:00,['0db9cad01273e0dc40be20042643c190044697ce'],37,26,63,3998648,5,0,0,0,6806
9cf6d0d8bd661e72c28e988c6f00737fbf221493,1,Chathuri Wimalasena,2014-11-04 13:40:26-05:00,['08fff2ce283af84f51e63f9443a982cc9c94852a'],10232,12379,22611,4021259,10,0.39527845,0.509079903,0.950968523,6806
f415e99364d064f2f10a4f354efc2099abee61c7,0,raminder,2014-11-04 14:07:49-05:00,['306464c376fb14465bbf2566e81eea422dfb906b'],1,1,2,4021261,1,,,,6806
3fbf952f049ece58457ba6ecdb351e7f1dba84a9,1,Chathuri Wimalasena,2014-11-04 14:21:09-05:00,['9cf6d0d8bd661e72c28e988c6f00737fbf221493'],1,6,7,4021268,1,0,0,1,6806
ede66edf03b21fa0071bbb222f5febc5bfc4d57a,1,Chathuri Wimalasena,2014-11-04 16:16:26-05:00,['3fbf952f049ece58457ba6ecdb351e7f1dba84a9'],16880,32308,49188,4070456,10,0.41921696,0.53111643,0.950076936,6806
91f5de5ce3fd100daf2f53a27ea5e23da209d97d,1,Chathuri Wimalasena,2014-11-04 16:28:01-05:00,['ede66edf03b21fa0071bbb222f5febc5bfc4d57a'],2,55,57,4070513,4,0.408163265,0.408163265,1,6806
83ecde91a83778771bf9aac84f503f7b44f71844,0,shamrath,2014-11-04 17:51:53-05:00,['2dd94e633c1b2ceb17211f28aed9b044d9f7353a'],454,472,926,4071439,12,0.906432749,0.023391813,0,6806
e9ee22b97d3c3d2a9f409ec1f8b99957792d6d68,0,Chathuri Wimalasena,2014-11-05 10:14:50-05:00,['83ecde91a83778771bf9aac84f503f7b44f71844'],195,232,427,4071866,3,1,0.019230769,0,6806
8abe8dca55f49eeac0ed1416b4565a767922b7a0,0,Chathuri Wimalasena,2014-11-05 11:16:14-05:00,['91f5de5ce3fd100daf2f53a27ea5e23da209d97d'],334,160,494,4072360,8,1,1,1,6806
a1e0ec813969000d755e47ee77c2be5fbb401f2b,0,Chathuri Wimalasena,2014-11-05 11:16:14-05:00,['8abe8dca55f49eeac0ed1416b4565a767922b7a0'],51,148,199,4072559,6,0.181818182,0.03030303,0.515151515,6806
96a673f0a51fa8944d5700f61fef089e477f99d8,0,Chathuri Wimalasena,2014-11-05 11:16:14-05:00,['a1e0ec813969000d755e47ee77c2be5fbb401f2b'],204,511,715,4073274,11,0.209459459,0,1,6807
73e21be4cf423dc35fb5f1a3363f989a40e067e7,0,Chathuri Wimalasena,2014-11-05 11:16:15-05:00,['96a673f0a51fa8944d5700f61fef089e477f99d8'],43,85,128,4073402,2,1,1,1,6807
e28919c984b0b6a0f7f1203b66afb865a79b4e2b,0,Chathuri Wimalasena,2014-11-05 11:16:15-05:00,['73e21be4cf423dc35fb5f1a3363f989a40e067e7'],263,264,527,4073929,7,0,1,1,6807
51361579602458f56e9b70250c76397305941696,1,Chathuri Wimalasena,2014-11-05 11:16:15-05:00,['e28919c984b0b6a0f7f1203b66afb865a79b4e2b'],5,43,48,4073977,3,1,1,1,6807
eb626fa754d75bcb6fc328507d9ff8c3bceb4bcf,1,Chathuri Wimalasena,2014-11-05 11:23:05-05:00,['51361579602458f56e9b70250c76397305941696'],156,213,369,4074346,10,0.107142857,0.75,1,6807
3f953e026ab6a5341fe762f6a98fc6807d67ca29,1,Chathuri Wimalasena,2014-11-05 11:23:05-05:00,['eb626fa754d75bcb6fc328507d9ff8c3bceb4bcf'],400,306,706,4075052,6,0.453125,0,0.5,6807
5a28f745193e0cbab43dac26e018cc31ded1d26d,0,Chathuri Wimalasena,2014-11-05 11:23:05-05:00,['3f953e026ab6a5341fe762f6a98fc6807d67ca29'],71,143,214,4075266,7,1,1,0,6807
d94e8c955763243f7b36b5151fd0a27aff90e0f6,0,Chathuri Wimalasena,2014-11-05 11:53:12-05:00,['5a28f745193e0cbab43dac26e018cc31ded1d26d'],1039,909,1948,4077214,14,0.921568627,0.62745098,0.205882353,6807
3e584f87d359c07bb2e4429884d8efa820135671,0,Chathuri Wimalasena,2014-11-05 13:10:24-05:00,['d94e8c955763243f7b36b5151fd0a27aff90e0f6'],448,468,916,4078130,12,0.905325444,0.01183432,0,6807
d856d246e2651c5034bc6c125a14551a01bdf40c,0,Chathuri Wimalasena,2014-11-05 13:10:24-05:00,['3e584f87d359c07bb2e4429884d8efa820135671'],195,232,427,4078557,3,1,0.019230769,0,6807
fa666b30ce5c3408b43cb5616c99d4d3d17a3b51,0,Chathuri Wimalasena,2014-11-05 13:19:50-05:00,['d856d246e2651c5034bc6c125a14551a01bdf40c'],9,0,9,4078566,2,1,1,0,6807
7b8d9844f72c81e2d16fb961a60876e9dbeea82d,0,Chathuri Wimalasena,2014-11-05 13:27:45-05:00,"['fa666b30ce5c3408b43cb5616c99d4d3d17a3b51', 'e9ee22b97d3c3d2a9f409ec1f8b99957792d6d68']",0,3,3,4078569,1,,,,6807
755273e1ad2a91e4aa64b41d1a52c25fff78fc5f,0,Chathuri Wimalasena,2014-11-05 13:29:04-05:00,['7b8d9844f72c81e2d16fb961a60876e9dbeea82d'],3,0,3,4078572,1,,,,6807
ce1354e96d1f3d2eedc851ca87e00207ca9f56aa,0,Chathuri Wimalasena,2014-11-05 14:39:05-05:00,['755273e1ad2a91e4aa64b41d1a52c25fff78fc5f'],10,10,20,4078592,5,,,,6807
3eea1a3095f735f7db3b37e65f92b653f0f28f03,0,shamrath,2014-11-05 15:05:37-05:00,['ce1354e96d1f3d2eedc851ca87e00207ca9f56aa'],7,8,15,4078607,2,1,1,0,6807
a133fa8c341cc29e88890a7093a40b795301fab3,1,Raminder,2014-11-05 15:56:41-05:00,['f415e99364d064f2f10a4f354efc2099abee61c7'],8772,13969,22741,4101348,69,0.54077359,0.487558512,0.018723824,6839
44c72f4d45374daa9e189f28356d964305616704,0,raminder,2014-11-05 16:05:00-05:00,"['a133fa8c341cc29e88890a7093a40b795301fab3', '91f5de5ce3fd100daf2f53a27ea5e23da209d97d']",26050,43672,69722,4171070,20,,,,6839
d8176e813b6cf7bb0fe5ec118f502781c4615ff9,0,shamrath,2014-11-06 11:31:39-05:00,['3eea1a3095f735f7db3b37e65f92b653f0f28f03'],17,82,99,4171169,5,0.333333333,0.333333333,1,6839
38bc592927b2fbee8c36ec9dbed800235fdd0c11,1,Chathuri Wimalasena,2014-11-06 11:48:36-05:00,['d8176e813b6cf7bb0fe5ec118f502781c4615ff9'],4,15,19,4171188,1,0,0,1,6839
9e6f748cfb8eed99229ff169fc1ac37f5b818e6d,0,raminder,2014-11-06 11:53:44-05:00,['44c72f4d45374daa9e189f28356d964305616704'],8419,123,8542,4179730,10,0.464685256,0.366004341,0.023209217,6839
95354eab81fdfe4f2d17c5c7f8f7a2deaf9a2b21,0,shamrath,2014-11-06 15:04:21-05:00,['38bc592927b2fbee8c36ec9dbed800235fdd0c11'],35,33,68,4179798,2,1,1,0,6839
f7c25ca51f261786318a7ea96af29b16bb62bdc1,0,raminder,2014-11-06 15:29:35-05:00,['9e6f748cfb8eed99229ff169fc1ac37f5b818e6d'],4,9,13,4179811,2,0.75,0.75,1,6839
198de990384ca3b3974222f22847d2a431fdd686,0,shamrath,2014-11-06 15:47:57-05:00,['95354eab81fdfe4f2d17c5c7f8f7a2deaf9a2b21'],809,699,1508,4181319,21,0.695238095,1,0,6840
d7f35e18d1735e6709b859a1d692f16d144aaedd,0,shamrath,2014-11-06 15:52:45-05:00,['198de990384ca3b3974222f22847d2a431fdd686'],269,0,269,4181588,1,0.817610063,0,0,6840
0b95d3b0d15ef479d489bba430721b82d15a8c00,0,shamrath,2014-11-06 15:59:21-05:00,['d7f35e18d1735e6709b859a1d692f16d144aaedd'],790,0,790,4182378,2,0.615234375,0.580078125,0,6840
f9fdf53e7400d98f0985c8d66b492c97ab07b5bc,1,Chathuri Wimalasena,2014-11-06 16:46:52-05:00,['0b95d3b0d15ef479d489bba430721b82d15a8c00'],120,135,255,4182633,4,1,0,0,6840
428b24075b7ac82109fbd5ab20df314b549da96e,0,shamrath,2014-11-06 16:57:51-05:00,['0b95d3b0d15ef479d489bba430721b82d15a8c00'],6,24,30,4182663,5,0,0,1,6840
088e80f035372fd25f4f07ea6f06b2ec230cce28,0,shamrath,2014-11-06 17:00:06-05:00,"['428b24075b7ac82109fbd5ab20df314b549da96e', 'f9fdf53e7400d98f0985c8d66b492c97ab07b5bc']",120,135,255,4182918,4,,,,6840
b52499eb72b438718f32d1b6653c40d4de8ced9f,0,shamrath,2014-11-06 17:39:59-05:00,['088e80f035372fd25f4f07ea6f06b2ec230cce28'],807,831,1638,4184556,12,1,1,0,6840
a3351b7000384a1a28f969fa5d0473d238c1cbcc,0,shamrath,2014-11-06 19:03:13-05:00,"['b52499eb72b438718f32d1b6653c40d4de8ced9f', 'f7c25ca51f261786318a7ea96af29b16bb62bdc1']",17182,14088,31270,4215826,74,,,,6840
82127c7b3c0afd32fdec372b60a2ca747aa13b9e,0,shamrath,2014-11-06 19:10:52-05:00,['a3351b7000384a1a28f969fa5d0473d238c1cbcc'],10,12,22,4215848,1,,,,6840
4b27ce8a0b8a5979fb4ce82f9573b00b3f35ea82,0,shamrath,2014-11-06 19:35:11-05:00,['82127c7b3c0afd32fdec372b60a2ca747aa13b9e'],100,140,240,4216088,5,,,,6840
f09c742b8f4bb6cb91c61b852e82e414250a5bd7,0,shamrath,2014-11-06 19:40:55-05:00,['4b27ce8a0b8a5979fb4ce82f9573b00b3f35ea82'],39,36,75,4216163,2,,,,6840
c383cf3c44287d2e3e20055eaf69ef0c6e153a01,0,lahiru,2014-11-07 10:21:40-05:00,['f7c25ca51f261786318a7ea96af29b16bb62bdc1'],3,5,8,4216171,2,0,0,1,6840
e54132907b81eb0daf479ea0986f7ff7a9be0e58,0,Chathuri Wimalasena,2014-11-07 10:58:02-05:00,['f09c742b8f4bb6cb91c61b852e82e414250a5bd7'],17,3,20,4216191,1,1,1,0,6840
86c2a9df9195aea59a07525f954064cfbfad3ea4,0,lginnaliadmin,2014-11-07 11:06:58-05:00,['c383cf3c44287d2e3e20055eaf69ef0c6e153a01'],17,13,30,4216221,2,1,1,0,6840
b1226d5d6794754471cefcd809758eb985686b17,0,raminder,2014-11-07 12:05:55-05:00,['c383cf3c44287d2e3e20055eaf69ef0c6e153a01'],4,2,6,4216227,2,,,,6840
f712ec1ee472852e23ca13f0643d346cd24a4f42,0,lahiru,2014-11-07 12:07:38-05:00,['86c2a9df9195aea59a07525f954064cfbfad3ea4'],80,68,148,4216375,20,0,1,0,6840
8cbb2d1fc4187f47e24f2451d9f6bbe300e33fc9,0,lahiru,2014-11-07 12:25:44-05:00,"['f712ec1ee472852e23ca13f0643d346cd24a4f42', 'b1226d5d6794754471cefcd809758eb985686b17']",4,2,6,4216381,2,,,,6840
91721d47ddea6578f9535b24d7c0027d88252697,0,raminder,2014-11-07 13:54:44-05:00,['b1226d5d6794754471cefcd809758eb985686b17'],22,9,31,4216412,5,0.545454545,1,0,6840
ffcaea354e9c3d3ff7fccbcf69130fd0699715c3,0,raminder,2014-11-07 13:55:37-05:00,"['91721d47ddea6578f9535b24d7c0027d88252697', '8cbb2d1fc4187f47e24f2451d9f6bbe300e33fc9']",97,81,178,4216590,22,,,,6840
62f003631e1493dfaacff2357c96e90088d5187d,0,Chathuri Wimalasena,2014-11-07 13:55:55-05:00,['e54132907b81eb0daf479ea0986f7ff7a9be0e58'],9,54,63,4216653,2,0,0,1,6840
4286c8c8569a907d532468fb6220cee0c0ad3a64,0,raminder,2014-11-07 14:50:03-05:00,['ffcaea354e9c3d3ff7fccbcf69130fd0699715c3'],5,1,6,4216659,1,1,1,0,6840
225b6746f40d66d6335b590038bf273cb5ed5c7b,0,Chathuri Wimalasena,2014-11-07 14:53:09-05:00,['62f003631e1493dfaacff2357c96e90088d5187d'],0,17,17,4216676,2,0.5,0.5,1,6840
0b867da49363dbba47dceaff646d086f09de6c1c,0,Chathuri Wimalasena,2014-11-07 15:30:31-05:00,['225b6746f40d66d6335b590038bf273cb5ed5c7b'],8,8,16,4216692,2,,,,6840
97b384b0665579bf893e80703704788be6b8e9b7,0,Ginnaliya Gamathige,2014-11-10 18:46:34-05:00,['4286c8c8569a907d532468fb6220cee0c0ad3a64'],1,1,2,4216694,1,,,,6840
febd0c40d6445d364d42fb13884075906e44507a,0,msmemon,2014-11-11 16:12:48+01:00,['47e82148945907939bbb82ecde4d05c7b9ebe6d1'],69,148,217,4216911,9,0.928571429,1,1,6840
5413e6718fd1e3fefc42858ccde98c1558414a87,0,msmemon,2014-11-11 16:19:47+01:00,"['febd0c40d6445d364d42fb13884075906e44507a', '97b384b0665579bf893e80703704788be6b8e9b7']",32076,65970,98046,4314957,161,,,,6840
af73c44468149b23053da8dc3247e78894fd751d,0,Ginnaliya Gamathige,2014-11-11 10:50:02-05:00,['97b384b0665579bf893e80703704788be6b8e9b7'],36,36,72,4315029,2,1,1,0,6840
f7de359dcae3694912248e50a1a2fd5e30fc613e,0,Ginnaliya Gamathige,2014-11-11 10:50:46-05:00,"['af73c44468149b23053da8dc3247e78894fd751d', '5413e6718fd1e3fefc42858ccde98c1558414a87']",205,293,498,4315527,11,,,,6840
36938926632e490d0a64e14e13277f74fd41c4df,0,Chathuri Wimalasena,2014-11-11 11:14:09-05:00,"['4286c8c8569a907d532468fb6220cee0c0ad3a64', '0b867da49363dbba47dceaff646d086f09de6c1c']",5488,4807,10295,4325822,105,,,,6840
65ad58606fdd4d4a8a1aa5c11a0bc7bdc1f6ac9c,0,Chathuri Wimalasena,2014-11-11 11:31:18-05:00,"['36938926632e490d0a64e14e13277f74fd41c4df', 'f7de359dcae3694912248e50a1a2fd5e30fc613e']",231,525,756,4326578,13,,,,6840
c36ab24191a5e1d549a745c7456a056e889bd156,0,Chathuri Wimalasena,2014-11-11 14:08:48-05:00,['65ad58606fdd4d4a8a1aa5c11a0bc7bdc1f6ac9c'],6,4,10,4326588,2,1,1,0,6840
831dbdce4a9f4874fe0198d72013f6251adbbb47,1,Chathuri Wimalasena,2014-11-11 17:08:56-05:00,['c36ab24191a5e1d549a745c7456a056e889bd156'],2,6,8,4326596,1,1,1,1,6840
ce62a61fc8d12f71c57102ab95bd13fc772a381d,0,shamrath,2014-11-11 18:55:25-05:00,['c36ab24191a5e1d549a745c7456a056e889bd156'],16,11,27,4326623,3,1,0,0,6840
dfa2f22e282bac82ec03d2ac76bfc87edcbf99d1,0,shamrath,2014-11-11 18:55:44-05:00,"['ce62a61fc8d12f71c57102ab95bd13fc772a381d', '831dbdce4a9f4874fe0198d72013f6251adbbb47']",2,6,8,4326631,1,,,,6840
d3d04cd1778e9d8235ed4aa57398f7c22676a6df,0,Chathuri Wimalasena,2014-11-12 16:52:27-05:00,['dfa2f22e282bac82ec03d2ac76bfc87edcbf99d1'],94,167,261,4326892,11,0.608695652,0,0.913043478,6840
afb1cde05cfaef856123de6c7535b330a73b11c8,0,Chathuri Wimalasena,2014-11-13 11:44:21-05:00,['d3d04cd1778e9d8235ed4aa57398f7c22676a6df'],51,76,127,4327019,6,0.181818182,0,0.931818182,6840
e1af2643b16e5d9161eab66038601487ceb4a671,1,Suresh Marru,2014-11-13 12:28:08-05:00,['afb1cde05cfaef856123de6c7535b330a73b11c8'],9743,11680,21423,4348442,18,0.387074357,0.455177206,0.949965254,6840
a40f49c900580abd52bb7c760d5f31d39dd08125,0,Chathuri Wimalasena,2014-11-13 14:15:43-05:00,['e1af2643b16e5d9161eab66038601487ceb4a671'],10,15,25,4348467,3,0,0,1,6840
30798f8a91ee667347da3a2892a4fa28fd1fcc0f,0,Chathuri Wimalasena,2014-11-13 14:36:14-05:00,['a40f49c900580abd52bb7c760d5f31d39dd08125'],2,3,5,4348472,2,1,0,0,6840
c87156880c485c186cc940e1eef12885d812566d,1,Chathuri Wimalasena,2014-11-13 14:42:44-05:00,['30798f8a91ee667347da3a2892a4fa28fd1fcc0f'],1,1,2,4348474,1,,,,6840
7a352c462a2e2bbc3515fe40b7e7a5cd3183a234,0,shamrath,2014-11-13 15:59:13-05:00,['c87156880c485c186cc940e1eef12885d812566d'],3,4,7,4348481,1,1,1,1,6840
a0afbd8b51cd756d838b4b93323a7506d970beb4,0,Chathuri Wimalasena,2014-11-13 17:00:18-05:00,['7a352c462a2e2bbc3515fe40b7e7a5cd3183a234'],364,195,559,4349040,25,0.607843137,0.725490196,0.333333333,6840
405d31d89694369c3fbf5acbe6d3fc95ff921d60,0,chathuri,2014-11-13 23:01:21-05:00,['a0afbd8b51cd756d838b4b93323a7506d970beb4'],2999,2986,5985,4355025,9,0.843356643,0.165034965,0.062937063,6840
f88204404aa7fc65e793ad98478b6648feda0c12,0,Chathuri Wimalasena,2014-11-14 12:02:26-05:00,['405d31d89694369c3fbf5acbe6d3fc95ff921d60'],59,63,122,4355147,4,1,1,0,6840
a02c575b52f4c9e3f18228344d5ef8c98e03ee68,0,shamrath,2014-11-14 13:19:02-05:00,['405d31d89694369c3fbf5acbe6d3fc95ff921d60'],1,1,2,4355149,1,,,,6840
c8bf7f10e42246a15089ec835a1d9c662612d149,0,shamrath,2014-11-14 13:19:34-05:00,"['a02c575b52f4c9e3f18228344d5ef8c98e03ee68', 'f88204404aa7fc65e793ad98478b6648feda0c12']",59,63,122,4355271,4,,,,6840
2330ad894e1a08473b668eef5eb0893d3c160178,0,Chathuri Wimalasena,2014-11-14 15:15:10-05:00,['c8bf7f10e42246a15089ec835a1d9c662612d149'],4,4,8,4355279,2,1,1,0,6840
3eacfb884f61457b3b64b44cfeae9d79abc54065,0,shamrath,2014-11-14 15:24:25-05:00,['c8bf7f10e42246a15089ec835a1d9c662612d149'],38,543,581,4355860,1,0,0,1,6840
d3aff435ef9b832313f7accba02b0f8d5b313bb5,0,shamrath,2014-11-14 15:24:37-05:00,"['3eacfb884f61457b3b64b44cfeae9d79abc54065', '2330ad894e1a08473b668eef5eb0893d3c160178']",4,4,8,4355868,2,,,,6840
c4f3c66208759fd7884c66c86ea39517c5e8398e,0,raminder,2014-11-14 16:17:32-05:00,['c8bf7f10e42246a15089ec835a1d9c662612d149'],197,6138,6335,4362203,23,0.066666667,0.377777778,1,6859
aee6aad8efa0344349557a1f13b95f2e8a83c747,0,shamrath,2014-11-14 17:02:06-05:00,['d3aff435ef9b832313f7accba02b0f8d5b313bb5'],4,4,8,4362211,1,,,,6859
6d7890d4cf93764046f2aaf8c0fa9b2b5439acbd,1,Chathuri Wimalasena,2014-11-14 17:03:54-05:00,['aee6aad8efa0344349557a1f13b95f2e8a83c747'],49,112,161,4362372,8,0.152542373,0.677966102,1,6859
778f3da4eefd8c2cbae3af0e39bff449864a2023,0,shamrath,2014-11-14 17:07:34-05:00,['aee6aad8efa0344349557a1f13b95f2e8a83c747'],832,40,872,4363244,15,,,,6859
f8475797a5b3295bfe6d82caf4a3dee09a4cc598,0,shamrath,2014-11-14 17:07:49-05:00,"['778f3da4eefd8c2cbae3af0e39bff449864a2023', '6d7890d4cf93764046f2aaf8c0fa9b2b5439acbd']",49,112,161,4363405,8,,,,6859
f348ef4c59c7f6a8c0fa347bde5b203ae17f7dde,0,raminder,2014-11-14 19:30:57-05:00,"['c4f3c66208759fd7884c66c86ea39517c5e8398e', 'f8475797a5b3295bfe6d82caf4a3dee09a4cc598']",927,703,1630,4365035,27,,,,6859
a838b664820ea2d8fe86390a41b30340319035fb,0,msmemon,2014-11-17 12:17:36+01:00,['5413e6718fd1e3fefc42858ccde98c1558414a87'],28,30,58,4365093,3,0,0,1,6859
5c139f2ce72652e45cfef6b0cbbb1d96c3f2b313,0,shamrath,2014-11-17 12:56:14-05:00,['f348ef4c59c7f6a8c0fa347bde5b203ae17f7dde'],5,22,27,4365120,3,0.272727273,0.272727273,1,6859
b4a34fac1b3a9a589dcd18652e2a28a56e6aad03,0,raminder,2014-11-17 14:16:53-05:00,['5c139f2ce72652e45cfef6b0cbbb1d96c3f2b313'],4,1,5,4365125,1,,,,6859
be21587b652b8b1a46851824076fe44e7ac8f522,0,raminder,2014-11-17 15:36:48-05:00,['b4a34fac1b3a9a589dcd18652e2a28a56e6aad03'],743,360,1103,4366228,10,,,,6865
eec20007bda6f0e8b07e8d597caf95c51753b027,0,raminder,2014-11-17 16:51:32-05:00,['be21587b652b8b1a46851824076fe44e7ac8f522'],194,12,206,4366434,6,,,,6865
791001f670b94504fe975643b17d6ea6337c145b,1,Chathuri Wimalasena,2014-11-18 14:24:52-05:00,['eec20007bda6f0e8b07e8d597caf95c51753b027'],12,39,51,4366485,5,0,0,1,6865
e853fa2fa50536e8ce28ec6dea9b445e89451fe7,0,Chathuri Wimalasena,2014-11-18 17:13:40-05:00,['791001f670b94504fe975643b17d6ea6337c145b'],0,3,3,4366488,1,0,0,0,6865
e2e9d2c4789a39063161c2692555002cd5431e75,0,Chathuri Wimalasena,2014-11-19 15:00:35-05:00,['e853fa2fa50536e8ce28ec6dea9b445e89451fe7'],6,29,35,4366523,4,0,0,1,6865
ab23ac9203a2e103a27e3dce23a64330015fc202,0,Chathuri Wimalasena,2014-11-20 11:51:49-05:00,['e2e9d2c4789a39063161c2692555002cd5431e75'],4,22,26,4366549,3,,,,6865
dc1898dfe05465fdd1102b1f1c382540dd229f26,0,msmemon,2014-11-24 15:44:43+01:00,"['a838b664820ea2d8fe86390a41b30340319035fb', 'f348ef4c59c7f6a8c0fa347bde5b203ae17f7dde']",19603,26737,46340,4412889,175,,,,6865
afc05ea3d257dc6821588a56c789fda97c47aa4f,0,msmemon,2014-11-24 15:44:55+01:00,"['dc1898dfe05465fdd1102b1f1c382540dd229f26', 'ab23ac9203a2e103a27e3dce23a64330015fc202']",963,483,1446,4414335,30,,,,6865
897d765c8bf702dd66d77f6fb37517b522f826c0,0,msmemon,2014-11-24 16:17:01+01:00,['afc05ea3d257dc6821588a56c789fda97c47aa4f'],208,1,209,4414544,1,0.23655914,0.010752688,0,6865
af136501fa82c9e1fbe953113ff5db7e8d79735e,0,shamrath,2014-11-25 01:52:22-05:00,['ab23ac9203a2e103a27e3dce23a64330015fc202'],0,335,335,4414879,8,0.283333333,1,1,6871
195f8d74cfe6cbd02ee90287f1687d39290c1d1b,0,shamrath,2014-11-25 11:49:53-05:00,"['af136501fa82c9e1fbe953113ff5db7e8d79735e', '897d765c8bf702dd66d77f6fb37517b522f826c0']",227,53,280,4415159,4,,,,6871
cf18c7dba3bc25dd73e59263338bc5ecf790d433,0,shamrath,2014-11-25 12:22:07-05:00,['195f8d74cfe6cbd02ee90287f1687d39290c1d1b'],36,5,41,4415200,2,1,0.772727273,0,6871
12cdde05cb7fabdf2f0b720b22ac482178a23200,0,shamrath,2014-11-25 13:01:23-05:00,['cf18c7dba3bc25dd73e59263338bc5ecf790d433'],30,30,60,4415260,2,,,,6871
4a79ee6ce978077f5084ba11f98a92ba397068a2,0,shamrath,2014-11-25 14:22:27-05:00,['12cdde05cb7fabdf2f0b720b22ac482178a23200'],1,15,16,4415276,2,1,1,1,6871
b305777397b0b75fa78ef8c5ba712528d5afbbad,0,shamrath,2014-11-25 18:20:26-05:00,['4a79ee6ce978077f5084ba11f98a92ba397068a2'],148,121,269,4415545,3,1,1,1,6871
7857e9a1ecaaf75bfbfba5f6b2263783b9f39c04,0,shamrath,2014-11-26 01:11:56-05:00,['b305777397b0b75fa78ef8c5ba712528d5afbbad'],6,10,16,4415561,1,,,,6871
7f4faeb21b24f4514cd37cc9f6ec59737fb8f688,0,shamrath,2014-12-01 01:48:57-05:00,['7857e9a1ecaaf75bfbfba5f6b2263783b9f39c04'],11,7,18,4415579,3,,,,6871
d831b8f7c7da0a71bb2a313df0ee0a532fff933d,0,Chathuri Wimalasena,2014-12-01 16:59:27-05:00,['7f4faeb21b24f4514cd37cc9f6ec59737fb8f688'],1,11,12,4415591,1,,,,6871
6f8973685dad8dd671f508578798a6ef47f52394,0,raminder,2014-12-02 12:38:49-05:00,['d831b8f7c7da0a71bb2a313df0ee0a532fff933d'],24,20,44,4415635,2,1,1,1,6871
469790490d20d95d24ca057aeea4f815f450d2c9,0,shamrath,2014-12-02 19:53:56-05:00,['6f8973685dad8dd671f508578798a6ef47f52394'],45,45,90,4415725,1,1,0.764705882,0,6871
28a235e87c5820ab2d5e7e9849be5f041823b35d,0,msmemon,2014-12-03 13:24:55+01:00,['7f4faeb21b24f4514cd37cc9f6ec59737fb8f688'],546,230,776,4416501,8,1,0.675257732,0.025773196,6871
576c87d2241f1036fdd267503381f59de11c43b3,0,msmemon,2014-12-03 13:25:17+01:00,"['28a235e87c5820ab2d5e7e9849be5f041823b35d', '6f8973685dad8dd671f508578798a6ef47f52394']",25,31,56,4416557,3,,,,6871
ca2f23b2a9ca7ce1600b3e6a7effb63d261f3a91,0,shamrath,2014-12-03 18:18:22-05:00,['469790490d20d95d24ca057aeea4f815f450d2c9'],213,414,627,4417184,28,0.4921875,0.765625,0.96875,6871
a61b37f17cb1d9ee9c98029fb0ac7a8836cd993d,0,shamrath,2014-12-04 22:31:29-05:00,['ca2f23b2a9ca7ce1600b3e6a7effb63d261f3a91'],168,536,704,4417888,47,0.31316726,0.501779359,0.971530249,6871
5d56aa7191503820994310704f46ac29a2f20d3d,0,shamrath,2014-12-04 22:46:20-05:00,['6f8973685dad8dd671f508578798a6ef47f52394'],46,45,91,4417979,1,1,0.764705882,0,6871
b6d9a5e4d8d26b97de1d2c707233b3e7172f300f,0,shamrath,2014-12-05 01:56:15-05:00,['5d56aa7191503820994310704f46ac29a2f20d3d'],4,5,9,4417988,1,1,1,1,6871
f4a32fd04e1cf2dbc24b59303cba9fcdb6855a9d,0,msmemon,2014-12-05 17:23:45+01:00,['576c87d2241f1036fdd267503381f59de11c43b3'],292,85,377,4418365,13,0.690265487,0.424778761,0.955752212,6871
09668d33905b4ec0f111cc0dfe40f64567471ddc,0,shamrath,2014-12-08 00:15:28-05:00,['a61b37f17cb1d9ee9c98029fb0ac7a8836cd993d'],9,7,16,4418381,2,1,1,0,6871
0c6301afa71815d2feb9b8184f7fc1efd13684d2,0,shamrath,2014-12-08 12:48:02-05:00,"['b6d9a5e4d8d26b97de1d2c707233b3e7172f300f', '09668d33905b4ec0f111cc0dfe40f64567471ddc']",365,932,1297,4419678,55,,,,6871
d35226d8830fb84e87fcda9e307fc14af9bfa239,1,Chathuri Wimalasena,2014-12-08 16:28:10-05:00,['0c6301afa71815d2feb9b8184f7fc1efd13684d2'],97,1903,2000,4421678,42,0.325745683,0.367346939,1,6871
6644942bfd1a3b2214a0497bc7ddaaf6d839fe1d,0,msmemon,2014-12-10 13:31:14+01:00,['f4a32fd04e1cf2dbc24b59303cba9fcdb6855a9d'],8,123,131,4421809,3,0.063291139,0.379746835,1,6871
5b118f8c41580d79dfb5707814cac1c628fa2b07,0,msmemon,2014-12-10 13:41:18+01:00,"['6644942bfd1a3b2214a0497bc7ddaaf6d839fe1d', 'd35226d8830fb84e87fcda9e307fc14af9bfa239']",486,2860,3346,4425155,68,,,,6871
5a1b225fd4cb0e40953f63e5a0d100a55160d9c3,0,Chathuri Wimalasena,2014-12-10 14:24:57-05:00,['5b118f8c41580d79dfb5707814cac1c628fa2b07'],2860,486,3346,4428501,68,0.656344869,0.575591985,0.007285974,6871
63a561c388655c2542e468eb627166dd5b255ec8,1,shamrath,2014-12-11 14:15:25-05:00,['5a1b225fd4cb0e40953f63e5a0d100a55160d9c3'],486,2860,3346,4431847,68,0.343655131,0.424408015,0.992714026,6871
bfaac64d88bd259e75e3ae5797e7d27758aab4e5,0,shamrath,2014-12-11 14:24:25-05:00,['63a561c388655c2542e468eb627166dd5b255ec8'],0,186,186,4432033,3,1,1,1,6874
db45699774f8a7afdf85ec3bfc1980c0c0b27975,0,shamrath,2014-12-11 22:47:59-05:00,['bfaac64d88bd259e75e3ae5797e7d27758aab4e5'],301,519,820,4432853,46,1,1,1,6877
d314cdb4fefdc32229e9469afb5e44491e6248ca,0,Chathuri Wimalasena,2014-12-12 11:04:32-05:00,['b6d9a5e4d8d26b97de1d2c707233b3e7172f300f'],181,184,365,4433218,8,,,,6877
158617d23a11f00c0f0a33bbf97070118e73e39e,0,Chathuri Wimalasena,2014-12-12 11:18:50-05:00,['d314cdb4fefdc32229e9469afb5e44491e6248ca'],55,55,110,4433328,1,,,,6877
45432caf8ea6f1cfc3be360a6cecf498280ca06f,0,Chathuri Wimalasena,2014-12-12 13:33:07-05:00,['158617d23a11f00c0f0a33bbf97070118e73e39e'],9,597,606,4433934,31,,,,6877
c2ce72586669abe05921e6ca1214738b497e7b36,0,Chathuri Wimalasena,2014-12-12 13:48:18-05:00,['45432caf8ea6f1cfc3be360a6cecf498280ca06f'],1,134,135,4434069,7,,,,6877
201a05e20b839dd323e3e258e61f12adaa63e9c9,0,shamrath,2014-12-15 15:44:41-05:00,['db45699774f8a7afdf85ec3bfc1980c0c0b27975'],93,19,112,4434181,2,1,0,0,6877
d6ee9532760dd248f90620c970f039108a742440,0,msmemon,2014-12-16 14:59:35+01:00,['201a05e20b839dd323e3e258e61f12adaa63e9c9'],618,668,1286,4435467,3,,,,6877
11c9f539b27ee622cfa2894195ef42f5bd023376,0,Chathuri Wimalasena,2014-12-16 11:40:51-05:00,['c2ce72586669abe05921e6ca1214738b497e7b36'],92,81,173,4435640,68,,,,6877
326c9f464bba24e2bf7199fcdcef5814c095021e,0,Chathuri Wimalasena,2014-12-16 11:41:01-05:00,['11c9f539b27ee622cfa2894195ef42f5bd023376'],69,69,138,4435778,68,,,,6877
e2cc8a4897213a683c5ead237a78e78c2c7ad83f,0,shamrath,2014-12-22 15:13:08-05:00,['201a05e20b839dd323e3e258e61f12adaa63e9c9'],5,131,136,4435914,2,0.021052632,0.810526316,1,6877
a9136101c48d5d7e6c87209945473bf7726469c7,0,shamrath,2014-12-22 15:14:17-05:00,"['e2cc8a4897213a683c5ead237a78e78c2c7ad83f', 'd6ee9532760dd248f90620c970f039108a742440']",618,668,1286,4437200,3,,,,6877
842004ee48df281bf068e024d8118677bf639bdb,1,Chathuri Wimalasena,2014-12-22 16:58:08-05:00,['a9136101c48d5d7e6c87209945473bf7726469c7'],323,814,1137,4438337,35,0.283618582,0.193154034,0.93398533,6877
cf7290a283318ddfe6abf3490d2e5a6bd07286b9,1,Chathuri Wimalasena,2014-12-22 17:26:49-05:00,['842004ee48df281bf068e024d8118677bf639bdb'],28,80,108,4438445,11,0.90625,0.90625,1,6877
9fbb426be64d4577d67b79963385285e61f94470,0,shamrath,2014-12-22 17:46:56-05:00,['cf7290a283318ddfe6abf3490d2e5a6bd07286b9'],14,31,45,4438490,5,0,0.25,1,6877
42699970224a452a96499d8f9c59988129c32064,0,shamrath,2014-12-22 17:50:10-05:00,['9fbb426be64d4577d67b79963385285e61f94470'],1,0,1,4438491,1,1,0,0,6877
04054a7b80855a2ff42309614f0832548b5ed206,0,shamrath,2014-12-23 14:19:25-05:00,['42699970224a452a96499d8f9c59988129c32064'],16,158,174,4438665,9,0.034090909,0.875,1,6877
557aa6889c81eac6f9624e1fc852c84e66010cfc,1,Chathuri Wimalasena,2014-12-23 16:29:34-05:00,['cf7290a283318ddfe6abf3490d2e5a6bd07286b9'],0,120,120,4438785,2,0,0,1,6877
c29d4040bd7c78513dcb1747cd4f200bd4800812,0,shamrath,2014-12-23 16:34:24-05:00,"['04054a7b80855a2ff42309614f0832548b5ed206', '557aa6889c81eac6f9624e1fc852c84e66010cfc']",0,120,120,4438905,2,,,,6877
61d0c7369a68261a1018d5e6523674b23d5cd28a,0,shamrath,2014-12-24 10:29:30-05:00,['c29d4040bd7c78513dcb1747cd4f200bd4800812'],15,29,44,4438949,2,0,0.181818182,1,6877
99fdd58af85dd5421dcd5002692ee3bd341012a0,1,Chathuri Wimalasena,2014-12-24 15:16:51-05:00,['61d0c7369a68261a1018d5e6523674b23d5cd28a'],432,980,1412,4440361,30,0.182186235,0.214574899,1,6877
7328287105b5348b2268de6ddbb9f6d62949970d,0,shamrath,2014-12-24 17:11:31-05:00,['99fdd58af85dd5421dcd5002692ee3bd341012a0'],43,134,177,4440538,10,0.203703704,0.777777778,0.925925926,6877
4dda3f3670032676b812b728a4428a0fee4f3e25,0,Chathuri Wimalasena,2014-12-29 10:32:35-05:00,['326c9f464bba24e2bf7199fcdcef5814c095021e'],80,91,171,4440709,68,,,,6877
c6953df57f4cb558ee2b43824740b6b63f176473,0,Chathuri Wimalasena,2014-12-29 11:43:41-05:00,['4dda3f3670032676b812b728a4428a0fee4f3e25'],11,12,23,4440732,3,1,,0,6877
7e8b48b07f20756ebbe164d5386581360c462152,0,Chathuri Wimalasena,2014-12-29 11:49:30-05:00,['c6953df57f4cb558ee2b43824740b6b63f176473'],100,111,211,4440943,1,,,,6877
1817176a4d8114e4295b1cf3c55b18141c68d75d,0,Chathuri Wimalasena,2014-12-29 12:32:22-05:00,['7e8b48b07f20756ebbe164d5386581360c462152'],92,81,173,4441116,68,,,,6877
429d23f598734802db213b42451390e3485ad2ca,0,Chathuri Wimalasena,2014-12-29 12:32:30-05:00,['1817176a4d8114e4295b1cf3c55b18141c68d75d'],69,69,138,4441254,68,,,,6877
98c9a34eaac4d9c15b1dd7df5050bb0538b7631e,1,Chathuri Wimalasena,2015-01-06 15:24:18-05:00,['7328287105b5348b2268de6ddbb9f6d62949970d'],610,695,1305,4442559,106,0,1,0,6877
8ff835fdde359c5edf8e34f426f76ff6f50c1d26,0,Chathuri Wimalasena,2015-01-08 14:38:17-05:00,['98c9a34eaac4d9c15b1dd7df5050bb0538b7631e'],24,86,110,4442669,5,0,0,0.835820896,6877
46be4553388502f81d0604f642673a34bf54cd95,1,Chathuri Wimalasena,2015-01-08 21:22:00-05:00,['8ff835fdde359c5edf8e34f426f76ff6f50c1d26'],3,7,10,4442679,3,0,0,1,6877
e54313c5e64dbd8eb0ebb0f1217f788cf1c81cd2,0,Chathuri Wimalasena,2015-01-08 22:02:22-05:00,"['46be4553388502f81d0604f642673a34bf54cd95', '429d23f598734802db213b42451390e3485ad2ca']",1014,1663,2677,4445356,117,,,,6877
97ad96b27c8eddb9a10e20d192b20374857db3e4,0,Chathuri Wimalasena,2015-01-12 10:11:48-05:00,['e54313c5e64dbd8eb0ebb0f1217f788cf1c81cd2'],12,115,127,4445483,4,0.068181818,0.068181818,1,6877
f8b6adb7b4d0dc03ba0c9dc817092c46dc9b6545,1,Chathuri Wimalasena,2015-01-12 16:40:08-05:00,['97ad96b27c8eddb9a10e20d192b20374857db3e4'],1434,1042,2476,4447959,53,0.940860215,1,0.043010753,6877
dc22b7bebd72624de14d7b003a7af1607a15b763,1,Chathuri Wimalasena,2015-01-13 13:36:31-05:00,['f8b6adb7b4d0dc03ba0c9dc817092c46dc9b6545'],156,675,831,4448790,31,0.315270936,0.39408867,1,6877
7a3f11b15231d224edeb32c612d5a49bdb449693,0,Chathuri Wimalasena,2015-01-13 14:29:14-05:00,['dc22b7bebd72624de14d7b003a7af1607a15b763'],1,9,10,4448800,3,0,0,1,6877
8561d4f5e575f4d4b10295ea114d0d7fc5d32e13,0,Chathuri Wimalasena,2015-01-13 16:21:58-05:00,['7a3f11b15231d224edeb32c612d5a49bdb449693'],2,10,12,4448812,2,0,0,1,6877
e96d4464a6c647bc720808cb3687a2594feb4bf9,0,Chathuri Wimalasena,2015-01-14 10:45:51-05:00,['8561d4f5e575f4d4b10295ea114d0d7fc5d32e13'],1,1,2,4448814,1,1,1,0,6877
0a85dfe02d7cdd22ce643cdbd6da32d7c3812e31,0,Chathuri Wimalasena,2015-01-14 13:07:02-05:00,['e96d4464a6c647bc720808cb3687a2594feb4bf9'],4,4,8,4448822,1,1,1,1,6877
dba25a4078d9c9524523248615d885772f2f7b20,1,Chathuri Wimalasena,2015-01-15 11:41:06-05:00,['0a85dfe02d7cdd22ce643cdbd6da32d7c3812e31'],14,14,28,4448850,1,,,,6877
e8eef3beecde5ebcfa37abeb53730373813dc886,0,Chathuri Wimalasena,2015-01-15 22:32:58-05:00,['dba25a4078d9c9524523248615d885772f2f7b20'],5,5,10,4448860,3,,,,6877
3c48771648dfb104f3874db99092503e180c1b74,0,raminder,2015-01-15 22:41:19-05:00,['e8eef3beecde5ebcfa37abeb53730373813dc886'],57,326,383,4449243,5,0.038461538,0.038461538,1,6880
47ea033684c4bf53ce9c23f7cfd58d8a1c2f2cc7,0,Chathuri Wimalasena,2015-01-16 10:51:33-05:00,['3c48771648dfb104f3874db99092503e180c1b74'],5,16,21,4449264,2,0,0,0.8,6880
ab59a1574f7e760345443fe600a0137fe833c093,0,raminder,2015-01-16 14:56:18-05:00,['47ea033684c4bf53ce9c23f7cfd58d8a1c2f2cc7'],1,4,5,4449269,1,0,0,1,6880
12bf4c5d83e241f9beb928528e6d5ddc29b792fa,0,raminder,2015-01-16 14:59:38-05:00,['ab59a1574f7e760345443fe600a0137fe833c093'],0,11,11,4449280,1,,,,6880
ea6de3712aeeacc5e8b1d701d12a1f885a8f5b16,1,Chathuri Wimalasena,2015-01-20 16:01:25-05:00,['12bf4c5d83e241f9beb928528e6d5ddc29b792fa'],12008,13994,26002,4475282,10,0.376336898,0.454545455,0.951871658,6880
32fff944499a31a73ced4f74e297a2639e975401,0,Chathuri Wimalasena,2015-01-21 13:46:25-05:00,['ea6de3712aeeacc5e8b1d701d12a1f885a8f5b16'],14032,1,14033,4489315,64,0.488517745,0.39844915,0.322397853,6880
714c2048da87e70544ebdeabab739f8158b134ce,0,Sachith Withana,2015-01-22 19:58:20+05:18,['32fff944499a31a73ced4f74e297a2639e975401'],21,1719,1740,4491055,13,0.486611265,0.603878116,0.981532779,6887
2654424bd1470e11cccc03eb5c027e98561581e5,0,Sachith Withana,2015-01-22 20:12:58+05:18,['714c2048da87e70544ebdeabab739f8158b134ce'],1,14032,14033,4505088,64,0.511482255,0.60155085,0.677602147,6949
6e5e336fdc321dc6a38b50528c4aeb12477bcd08,0,Chathuri Wimalasena,2015-01-22 10:02:16-05:00,['2654424bd1470e11cccc03eb5c027e98561581e5'],14032,1,14033,4519121,64,0.488517745,0.39844915,0.322397853,6949
18f338c5c025ce124be57556cbbcfc333722bbaf,0,Chathuri Wimalasena,2015-01-22 10:02:50-05:00,['6e5e336fdc321dc6a38b50528c4aeb12477bcd08'],1719,21,1740,4520861,13,0.513388735,0.396121884,0.018467221,6949
b81daafbe1dbbe3523e515f137b2ad2fdfa8e684,0,raminder,2015-01-22 16:38:06-05:00,['18f338c5c025ce124be57556cbbcfc333722bbaf'],3,3,6,4520867,2,,,,6949
0b70b6936886a2353b14ef7acd69ffcae0a24fd0,0,raminder,2015-01-23 12:09:44-05:00,['b81daafbe1dbbe3523e515f137b2ad2fdfa8e684'],27,104,131,4520998,8,0,0.245614035,0.578947368,6949
cab15715707215f8812b7bcac98ba71b06688529,1,Chathuri Wimalasena,2015-01-27 10:26:43-05:00,['0b70b6936886a2353b14ef7acd69ffcae0a24fd0'],25022,1416,26438,4547436,214,0.57008245,0.276796231,0.114840989,6949
42f77edb854d4c3c79191ee13112dcc562a93593,0,Chathuri Wimalasena,2015-01-27 14:27:07-05:00,['cab15715707215f8812b7bcac98ba71b06688529'],8584,0,8584,4556020,62,0.363571429,0.262857143,0.306428571,6949
3ad52055362aac1693a1629bc18131527c668061,1,Chathuri Wimalasena,2015-01-29 15:36:26-05:00,['42f77edb854d4c3c79191ee13112dcc562a93593'],15,19,34,4556054,3,1,0,0,6949
d7e2abba6e7572da057e869d033229720f3e76f4,1,shamrath,2015-01-29 20:42:49-05:00,['18f338c5c025ce124be57556cbbcfc333722bbaf'],0,319,319,4556373,12,1,1,1,6960
f339c2eae9c9545af27f1a28aac6c382fecf1908,0,Chathuri Wimalasena,2015-02-02 10:50:42-05:00,['3ad52055362aac1693a1629bc18131527c668061'],3,31,34,4556407,4,0.7,0,1,6960
fb661cfc8d3b82cb950bb26cfb70bfe74a08227e,1,Chathuri Wimalasena,2015-02-02 17:17:12-05:00,['f339c2eae9c9545af27f1a28aac6c382fecf1908'],0,9654,9654,4566061,10,0.624492346,0.73289597,0.990471728,6970
e32c1a949ca470a63050da7a3059695d687070ae,0,Chathuri Wimalasena,2015-02-03 14:37:29-05:00,['fb661cfc8d3b82cb950bb26cfb70bfe74a08227e'],108,280,388,4566449,10,1,1,1,6972
0b8dcd3697e1bde3b2cd5674f14a578e46dc27b4,0,raminder,2015-02-03 16:39:45-05:00,['fb661cfc8d3b82cb950bb26cfb70bfe74a08227e'],2,2,4,4566453,1,,,,6972
92888e5f1a3b11840c711db70018f941e00db185,0,raminder,2015-02-03 16:40:30-05:00,"['0b8dcd3697e1bde3b2cd5674f14a578e46dc27b4', 'e32c1a949ca470a63050da7a3059695d687070ae']",108,280,388,4566841,10,,,,6972
7a6fbdb25530028c0f9c04e02c556ce4e65394d5,1,Chathuri Wimalasena,2015-02-04 12:16:59-05:00,['92888e5f1a3b11840c711db70018f941e00db185'],641,1870,2511,4569352,24,0.300312826,0.277372263,1,6974
1ec53801d6a3ed040b44689fbf7a308fd7a0da0b,0,Chathuri Wimalasena,2015-02-04 12:17:52-05:00,['7a6fbdb25530028c0f9c04e02c556ce4e65394d5'],7,13,20,4569372,1,,,,6974
fc2da553298f18af1fe63df1551d6def1a0048b9,1,Chathuri Wimalasena,2015-02-04 13:35:12-05:00,['1ec53801d6a3ed040b44689fbf7a308fd7a0da0b'],1,1,2,4569374,1,,,,6974
c916087a9c48b983b8183fec0bde7f2da9608c7c,0,raminder,2015-02-04 16:29:32-05:00,['1ec53801d6a3ed040b44689fbf7a308fd7a0da0b'],75,149,224,4569598,14,0.14516129,0.403225806,0.983870968,6974
4a86387c205cbbd4cf66e46bc26948db690ca367,0,raminder,2015-02-04 16:29:54-05:00,"['c916087a9c48b983b8183fec0bde7f2da9608c7c', 'fc2da553298f18af1fe63df1551d6def1a0048b9']",1,1,2,4569600,1,,,,6974
991babd9d9244eec8eddc1a509e62419f1341411,0,Chathuri Wimalasena,2015-02-04 17:01:02-05:00,['4a86387c205cbbd4cf66e46bc26948db690ca367'],0,10,10,4569610,1,0,0,1,6974
b1c682431c607744ace76529e92d5252896290c7,0,Chathuri Wimalasena,2015-02-05 11:07:46-05:00,['991babd9d9244eec8eddc1a509e62419f1341411'],0,1,1,4569611,1,0,0,1,6974
d448fd50041261dba8e8736866b0dc7f1e8d0553,0,Chathuri Wimalasena,2015-02-05 11:30:00-05:00,['b1c682431c607744ace76529e92d5252896290c7'],0,1,1,4569612,1,0,0,1,6974
f568594a1771b07ea8304e04f0c22efd11c1c0bd,0,Chathuri Wimalasena,2015-02-05 11:38:13-05:00,['d448fd50041261dba8e8736866b0dc7f1e8d0553'],1,1,2,4569614,1,,,,6974
7f8988096e1f4b60ebee3c43afd469e170952f2d,1,Chathuri Wimalasena,2015-02-05 15:53:02-05:00,['f568594a1771b07ea8304e04f0c22efd11c1c0bd'],69,1261,1330,4570944,5,0.101251422,0.459613197,1,6976
c6fe0decd079bdfe078da620b29fc2b280c1701f,1,Chathuri Wimalasena,2015-02-06 15:57:14-05:00,['7f8988096e1f4b60ebee3c43afd469e170952f2d'],289,672,961,4571905,8,0,0.547692308,0.904615385,6976
d05cbdca02d13e63a437c956e040dc1e4dbece0a,0,shamrath,2015-02-09 11:03:46-05:00,"['d7e2abba6e7572da057e869d033229720f3e76f4', 'c6fe0decd079bdfe078da620b29fc2b280c1701f']",34482,15123,49605,4621510,352,,,,6976
f70d074b7853295c756d91b1fe5e580dde51caf8,0,Chathuri Wimalasena,2015-02-09 12:33:27-05:00,['c6fe0decd079bdfe078da620b29fc2b280c1701f'],45,72,117,4621627,6,0.928571429,0,1,6976
09876ee646d88e3ba252580cd272236066912d9c,0,Chathuri Wimalasena,2015-02-09 12:33:59-05:00,['f70d074b7853295c756d91b1fe5e580dde51caf8'],1,1,2,4621629,1,,,,6976
30aefc46bedcc06516d992a1b3da196f3bf21289,0,msmemon,2015-02-10 16:22:15+01:00,['09876ee646d88e3ba252580cd272236066912d9c'],30,80,110,4621739,1,,,,6976
88d27d9574f9b077d334eabde147a0787b186899,0,Lahiru Gunathilake,2015-02-10 14:04:13-05:00,['30aefc46bedcc06516d992a1b3da196f3bf21289'],32,2008,2040,4623779,23,0.416988417,0.554440154,0.944401544,6980
4ec9dc309a618897c3b3dddbbc6a9842c89139f8,1,Chathuri Wimalasena,2015-02-10 14:23:34-05:00,['09876ee646d88e3ba252580cd272236066912d9c'],14,184,198,4623977,4,0.054054054,0.540540541,1,6981
d262e9f4e26f77b74f0d1f8f4708a0b581497edf,0,Chathuri Wimalasena,2015-02-10 14:23:52-05:00,"['4ec9dc309a618897c3b3dddbbc6a9842c89139f8', '30aefc46bedcc06516d992a1b3da196f3bf21289']",30,80,110,4624087,1,,,,6981
e68039748fcff30e608cdcfeebc83d18963bfa92,1,Chathuri Wimalasena,2015-02-10 15:27:30-05:00,['d262e9f4e26f77b74f0d1f8f4708a0b581497edf'],3,13,16,4624103,2,0,0.142857143,1,6981
b338f4acb1b6aab86cd9ca1bc64f953c111fc7a8,1,shamrath,2015-02-11 14:45:16-05:00,['d05cbdca02d13e63a437c956e040dc1e4dbece0a'],146,1135,1281,4625384,23,0.287234043,0.505319149,1,6995
5bd8b86d41de816bf6ba7a50571b80817d4d8b81,0,shamrath,2015-02-11 14:45:46-05:00,['b338f4acb1b6aab86cd9ca1bc64f953c111fc7a8'],3,1,4,4625388,1,,,,6995
c90662febdcc2de7d7fd29de4ae2b64e9a31e1b5,0,shamrath,2015-02-11 14:52:37-05:00,['5bd8b86d41de816bf6ba7a50571b80817d4d8b81'],8,8,16,4625404,8,,,,6995
0149c1afd477ab1d86d19374bcb9824520d3a3bc,0,Lahiru Gunathilake,2015-02-11 15:48:40-05:00,['88d27d9574f9b077d334eabde147a0787b186899'],42,361,403,4625807,13,0.330188679,0.523584906,1,6996
b6bf782db30b0e7555f78852da3efcfdbfd530e4,0,Lahiru Gunathilake,2015-02-12 11:36:02-05:00,['0149c1afd477ab1d86d19374bcb9824520d3a3bc'],17,23,40,4625847,5,0,0,0,6996
042209406ecacb00d88c610dd8717aa12e7aa33c,0,Chathuri Wimalasena,2015-02-12 14:50:00-05:00,['e68039748fcff30e608cdcfeebc83d18963bfa92'],4,339,343,4626190,5,0,0,1,6999
e3ce93e1f4b78d01125bc06a894533424723d9a6,0,shamrath,2015-02-13 14:56:24-05:00,['c90662febdcc2de7d7fd29de4ae2b64e9a31e1b5'],260,536,796,4626986,20,0.845559846,0.833976834,1,7004
9445b7a10596c509cbe7950a470add94b3deb32a,0,shamrath,2015-02-16 11:19:18-05:00,['e3ce93e1f4b78d01125bc06a894533424723d9a6'],52,664,716,4627702,13,0.507042254,1,1,7006
155c3c75326945f80e123701cac8af62aa0d1502,0,Chathuri Wimalasena,2015-02-16 16:45:39-05:00,['042209406ecacb00d88c610dd8717aa12e7aa33c'],80,30,110,4627812,1,,,,7006
263522a29d601d547d05ee835709a8ae4e16cd40,0,shamrath,2015-02-16 21:52:33-05:00,['9445b7a10596c509cbe7950a470add94b3deb32a'],4,25,29,4627841,2,0.214285714,0.785714286,1,7006
9fcf22671b1423ca15d8953c51a4e12bdaf00fe0,0,shamrath,2015-02-16 22:11:08-05:00,['263522a29d601d547d05ee835709a8ae4e16cd40'],39,35,74,4627915,6,0.692307692,0.923076923,1,7006
a486b67d9187294bae14dd15d4d5b90a84484c73,0,Lahiru Gunathilake,2015-02-16 22:38:41-05:00,['b6bf782db30b0e7555f78852da3efcfdbfd530e4'],71,547,618,4628533,16,0.33220339,0.355932203,0.681355932,7008
b622683bc8272cf9f1f88d40df1a2e19b10e2ac1,0,Chathuri Wimalasena,2015-02-17 14:58:08-05:00,['155c3c75326945f80e123701cac8af62aa0d1502'],47,148,195,4628728,6,0.823529412,1,1,7010
d9ae024b90d6a66c5cef4d0b7db344057af8364c,0,Chathuri Wimalasena,2015-02-17 15:04:13-05:00,['b622683bc8272cf9f1f88d40df1a2e19b10e2ac1'],1,0,1,4628729,1,,,,7010
60788efec3a808274a19e9687a669cabad84e89b,0,Lahiru Gunathilake,2015-02-17 22:09:15-05:00,['a486b67d9187294bae14dd15d4d5b90a84484c73'],209,43,252,4628981,6,0.125,0.589285714,0.285714286,7010
840e627b4e24baef8dbf62df8da1042380cb8af1,0,Lahiru Gunathilake,2015-02-17 23:58:04-05:00,['60788efec3a808274a19e9687a669cabad84e89b'],115,102,217,4629198,6,0.6,0,0.1,7010
308291f5296dc8d1325856a5aa1aba21eb7d2143,0,shamrath,2015-02-18 07:53:20-05:00,['9fcf22671b1423ca15d8953c51a4e12bdaf00fe0'],77,246,323,4629521,21,0,0,1,7010
0bc98a30df024ac3ff3f194c3079503779d32fc5,0,shamrath,2015-02-18 08:36:07-05:00,['308291f5296dc8d1325856a5aa1aba21eb7d2143'],21,35,56,4629577,4,1,1,1,7010
0ae7e833a80abec8b9507082ebc834ea30d5afad,0,shamrath,2015-02-18 08:37:30-05:00,"['0bc98a30df024ac3ff3f194c3079503779d32fc5', 'd9ae024b90d6a66c5cef4d0b7db344057af8364c']",112,754,866,4630443,19,,,,7010
1a5daae1a2c87a0cf66b2df820e1460224dc998c,0,shamrath,2015-02-18 15:51:42-05:00,['0ae7e833a80abec8b9507082ebc834ea30d5afad'],8,8,16,4630459,5,,,,7010
20d6817c80148483a6e76a443a7b151d333f31ac,0,shamrath,2015-02-18 17:11:41-05:00,['1a5daae1a2c87a0cf66b2df820e1460224dc998c'],4,4,8,4630467,4,,,,7010
33d2e27a4d329f95ce12ba621817ef9e2b956fb4,1,Chathuri Wimalasena,2015-02-19 15:10:38-05:00,['d9ae024b90d6a66c5cef4d0b7db344057af8364c'],2570,11571,14141,4644608,26,0.393983433,0.528847551,0.940706293,7013
27f6f1b12c83448b702064df5f90fb4103ec36c4,0,shamrath,2015-02-20 20:29:18-05:00,['20d6817c80148483a6e76a443a7b151d333f31ac'],53,179,232,4644840,4,0.247191011,0.426966292,0.943820225,7013
55319c96d2c7ace7ab7b458dbd4fd259649d2e8e,0,shamrath,2015-02-22 16:55:55-05:00,['27f6f1b12c83448b702064df5f90fb4103ec36c4'],28,169,197,4645037,6,0.37962963,0.703703704,1,7013
8835097ed697583601bde6039801a95dbdd33422,0,shamrath,2015-02-23 14:14:26-05:00,['55319c96d2c7ace7ab7b458dbd4fd259649d2e8e'],60,70,130,4645167,6,0.666666667,0.833333333,0.166666667,7013
6bfb9563a049b943c2ab2287f468a38f8eaf9b78,0,shamrath,2015-02-23 16:51:21-05:00,['8835097ed697583601bde6039801a95dbdd33422'],76,76,152,4645319,26,,,,7013
41ea9467865dc60cecb2304a97ba9acd85ba2aac,0,shamrath,2015-02-24 09:56:42-05:00,['6bfb9563a049b943c2ab2287f468a38f8eaf9b78'],11,20,31,4645350,2,1,1,1,7013
249b4401f0bfc821482dfbcb1d02eaf6832b9da1,0,shamrath,2015-02-24 10:37:29-05:00,"['41ea9467865dc60cecb2304a97ba9acd85ba2aac', '840e627b4e24baef8dbf62df8da1042380cb8af1']",97,2695,2792,4648142,36,,,,7013
32f10d183bb53106426f4879b0cd97d138031f96,0,Chathuri Wimalasena,2015-02-24 10:52:56-05:00,['33d2e27a4d329f95ce12ba621817ef9e2b956fb4'],3,2,5,4648147,1,1,1,0,7013
ffbb1b9f6776cf90a3eb9e7d418bd5bed76a0ef4,0,Lahiru Gunathilake,2015-02-24 10:57:46-05:00,"['840e627b4e24baef8dbf62df8da1042380cb8af1', '33d2e27a4d329f95ce12ba621817ef9e2b956fb4']",2689,12261,14950,4663097,36,,,,7013
97ff3b7d12ce1e6ac42e8a3d22c2bfc1de9b30a1,0,shamrath,2015-02-24 11:20:07-05:00,['249b4401f0bfc821482dfbcb1d02eaf6832b9da1'],5,5,10,4663107,2,,,,7013
350441038b7eb6c6f8ce704fee5c47100da07ce4,1,Chathuri Wimalasena,2015-02-24 14:43:48-05:00,['32f10d183bb53106426f4879b0cd97d138031f96'],8,16,24,4663131,2,0,1,1,7013
9a6eaaae2abc2d5e687bbda5a393f1dd519d54f1,0,raminder,2015-02-24 22:28:53-05:00,['350441038b7eb6c6f8ce704fee5c47100da07ce4'],7113,7221,14334,4677465,62,0.667037862,0.481625835,0.318485523,7013
1231c014bebd1d23c2bdd340b7d721abe279d45a,0,Lahiru Gunathilake,2015-02-25 00:59:09-05:00,['ffbb1b9f6776cf90a3eb9e7d418bd5bed76a0ef4'],79,151,230,4677695,13,0.515151515,0.53030303,0.863636364,7013
93ed077e87c3e29cd58301ead917fcf7e2025853,0,Lahiru Gunathilake,2015-02-25 01:09:40-05:00,"['1231c014bebd1d23c2bdd340b7d721abe279d45a', '9a6eaaae2abc2d5e687bbda5a393f1dd519d54f1']",7118,7232,14350,4692045,65,,,,7013
c6c93543856a02e7bf8e58227b67dbcb902550eb,0,Lahiru Gunathilake,2015-02-25 12:31:20-05:00,['9a6eaaae2abc2d5e687bbda5a393f1dd519d54f1'],32,561,593,4692638,19,0.438356164,0.593607306,0.812785388,7017
d25441a017f2e443165a22c9c5966a6d9e6aad9e,0,shamrath,2015-02-25 17:12:18-05:00,['97ff3b7d12ce1e6ac42e8a3d22c2bfc1de9b30a1'],240,1260,1500,4694138,18,0.539936102,0.749201278,0.980830671,7020
67ca5b1992f2d0274f20aeacec55c2c6fd96588a,0,msmemon,2015-02-26 11:16:47+01:00,['c6c93543856a02e7bf8e58227b67dbcb902550eb'],617,602,1219,4695357,3,,,,7020
8b2a6b0625cef632cb75a7b8e04fb27582652112,0,shamrath,2015-02-27 14:46:13-05:00,['d25441a017f2e443165a22c9c5966a6d9e6aad9e'],15,85,100,4695457,6,1,1,0.741935484,7021
2e2868f732ff24b8ccf3d7594f804c990f66b851,1,Chathuri Wimalasena,2015-02-27 15:08:58-05:00,['67ca5b1992f2d0274f20aeacec55c2c6fd96588a'],1618,251,1869,4697326,38,0.307692308,0.278846154,0.019230769,7022
a216a736ad56f6e88edae9994686bf28a5d85fcc,0,smarru,2015-03-01 12:29:58-05:00,['2e2868f732ff24b8ccf3d7594f804c990f66b851'],34,49,83,4697409,5,0,0,1,7022
ed6d1af7e2dc7e12f0face37af9934cbe486fe83,0,Suresh Marru,2015-03-02 11:10:50-05:00,['a216a736ad56f6e88edae9994686bf28a5d85fcc'],1,1,2,4697411,1,,,,7022
658e5e9e66147830adb848ca9a9f4700e10a5583,1,Chathuri Wimalasena,2015-03-02 15:27:37-05:00,['ed6d1af7e2dc7e12f0face37af9934cbe486fe83'],4781,16714,21495,4718906,40,0.410925845,0.543111014,0.950526547,7022
ad44956fc29a6e7328e93fc182d9c35fb7b8775b,0,shamrath,2015-03-02 16:03:03-05:00,['8b2a6b0625cef632cb75a7b8e04fb27582652112'],14,36,50,4718956,6,1,1,1,7022
366ada03275079931d7c898cbbfe66c3409729d1,0,shamrath,2015-03-02 16:05:26-05:00,['ad44956fc29a6e7328e93fc182d9c35fb7b8775b'],0,16,16,4718972,1,,,,7022
25cf3c97b194533e5c83cb38b302a57ae216c4dd,0,Chathuri Wimalasena,2015-03-03 10:00:06-05:00,['658e5e9e66147830adb848ca9a9f4700e10a5583'],2552,4804,7356,4726328,7,0.389145497,0.419168591,0.954965358,7022
3df0250ed0c46dff4daf013292f8178eec8634ed,0,Suresh Marru,2015-03-03 12:29:17-05:00,['25cf3c97b194533e5c83cb38b302a57ae216c4dd'],16,9,25,4726353,2,,,,7022
f9f63a02573a6d53b4203a33ff485a50c2844037,0,Suresh Marru,2015-03-03 12:31:35-05:00,['3df0250ed0c46dff4daf013292f8178eec8634ed'],0,37,37,4726390,1,,,,7022
33b403fc793d0e5d373a86b48982bde09dfe6b76,1,Suresh Marru,2015-03-03 12:34:49-05:00,['f9f63a02573a6d53b4203a33ff485a50c2844037'],1076,3687,4763,4731153,9,0.28056872,0.392417062,0.911374408,7022
050ea840f700060b49802b7ae702c95838dde4e0,1,Suresh Marru,2015-03-03 13:23:05-05:00,['33b403fc793d0e5d373a86b48982bde09dfe6b76'],1567,5269,6836,4737989,2,0.500183083,0.600146466,0.976565361,7022
672d13e2bbdaa08f9cbd903f3a4b0ddfb6563a53,1,Chathuri Wimalasena,2015-03-03 14:37:09-05:00,['050ea840f700060b49802b7ae702c95838dde4e0'],305,405,710,4738699,14,0.548387097,0.85483871,1,7022
c66cc84da3da2bea1932e507dcc33531ce00f393,0,Suresh Marru,2015-03-03 15:55:09-05:00,['050ea840f700060b49802b7ae702c95838dde4e0'],8,20,28,4738727,3,,,,7022
0f2c6ff1a223f352e9a19cdebdd5f0933a0f20d8,0,Suresh Marru,2015-03-03 16:47:08-05:00,['c66cc84da3da2bea1932e507dcc33531ce00f393'],32,56,88,4738815,1,,,,7022
c073c6a5d9d6d6719bd6e0574aec826b879f4469,0,Suresh Marru,2015-03-03 16:47:20-05:00,"['0f2c6ff1a223f352e9a19cdebdd5f0933a0f20d8', '672d13e2bbdaa08f9cbd903f3a4b0ddfb6563a53']",305,405,710,4739525,14,,,,7022
8be598817f097a75463f1de3c0f89e52006a6280,1,Suresh Marru,2015-03-03 16:47:37-05:00,['c073c6a5d9d6d6719bd6e0574aec826b879f4469'],749,3823,4572,4744097,5,0.208988764,0.256554307,0.786891386,7022
b1f0b00d3340bc935f025817a13a786798c3a94e,0,Suresh Marru,2015-03-03 17:36:21-05:00,['8be598817f097a75463f1de3c0f89e52006a6280'],196,205,401,4744498,19,,,0,7022
7c5f1c85a250d66332eecbdf77ee64c581cb554a,1,Chathuri Wimalasena,2015-03-04 13:36:32-05:00,['b1f0b00d3340bc935f025817a13a786798c3a94e'],87,195,282,4744780,22,0,0,0.467391304,7022
71db390f49bd4a129ee08e6ae20e87edce0c7115,0,shamrath,2015-03-04 14:15:25-05:00,['366ada03275079931d7c898cbbfe66c3409729d1'],64,1,65,4744845,2,0,0,0,7022
917adad5bbec9500a0524eeb7a3ce3763c89d961,0,shamrath,2015-03-04 14:21:08-05:00,['71db390f49bd4a129ee08e6ae20e87edce0c7115'],82,111,193,4745038,10,0.404761905,0,1,7022
c69d322b23e2d7b066191934dc832f2c9e20ec36,1,Chathuri Wimalasena,2015-03-04 16:49:19-05:00,['7c5f1c85a250d66332eecbdf77ee64c581cb554a'],17,55,72,4745110,6,0.689655172,0.689655172,0.827586207,7022
38e7309ffb6d0f151b46a78f975007c2359f36a5,1,Chathuri Wimalasena,2015-03-05 11:23:49-05:00,['c69d322b23e2d7b066191934dc832f2c9e20ec36'],3,55,58,4745168,15,0.459459459,0.459459459,0.945945946,7022
a18b747a54df31fd74709a4386638544edc4863b,0,Chathuri Wimalasena,2015-03-05 11:35:16-05:00,['38e7309ffb6d0f151b46a78f975007c2359f36a5'],44,41,85,4745253,1,1,1,0,7022
66de3728edcfbd787c7204460bf66e59b4930705,0,Suresh Marru,2015-03-05 13:56:09-05:00,['a18b747a54df31fd74709a4386638544edc4863b'],2512,0,2512,4747765,23,0.726708075,0.198757764,0.283229814,7022
58c58cf209fbfdd6873aaf718ff6927f07f764e2,1,Suresh Marru,2015-03-05 14:36:17-05:00,['66de3728edcfbd787c7204460bf66e59b4930705'],16,10846,10862,4758627,94,0.543327093,0.691762503,0.987697245,7031
b25e0a5db9d137731a2bd0f9a7c2ed1368e6f0e7,0,Suresh Marru,2015-03-05 23:29:26-05:00,['58c58cf209fbfdd6873aaf718ff6927f07f764e2'],10928,150,11078,4769705,13,0.456672907,0.308237497,0.012302755,7031
9d960f76b0f35a2f704d2af04a5af19d9cfd2ed4,1,Chathuri Wimalasena,2015-03-06 10:10:57-05:00,['b25e0a5db9d137731a2bd0f9a7c2ed1368e6f0e7'],21,72,93,4769798,10,0.023809524,0.428571429,0.976190476,7031
7c10349962bdce8c06f6905f226da488017c4930,0,Chathuri Wimalasena,2015-03-06 10:23:07-05:00,['9d960f76b0f35a2f704d2af04a5af19d9cfd2ed4'],27,174,201,4769999,5,0.221374046,0.251908397,1,7031
ac574c942c91a76bd0d9fccfc9350dfcd29f9cb0,0,Chathuri Wimalasena,2015-03-06 10:43:09-05:00,['7c10349962bdce8c06f6905f226da488017c4930'],2,27,29,4770028,8,0.8,0.933333333,1,7031
e9468ca5b68083527cb918c2ce195ec0d4f2a8a1,0,Chathuri Wimalasena,2015-03-06 12:26:14-05:00,['ac574c942c91a76bd0d9fccfc9350dfcd29f9cb0'],0,98,98,4770126,2,0,0,1,7032
52f1e758ee7c8a0ac757d45a8b67f7d6e9ab4c70,0,Suresh Marru,2015-03-06 14:15:26-05:00,['e9468ca5b68083527cb918c2ce195ec0d4f2a8a1'],0,0,0,4770126,1,,,,7032
9385c4eb0ad9df573e62657bacecc552fdeb97bb,0,Chathuri Wimalasena,2015-03-06 14:20:18-05:00,['e9468ca5b68083527cb918c2ce195ec0d4f2a8a1'],11,11,22,4770148,8,,,,7032
8c84eeedca003783f167437edfbd4a812e27d70f,0,Suresh Marru,2015-03-06 14:22:44-05:00,['52f1e758ee7c8a0ac757d45a8b67f7d6e9ab4c70'],0,5,5,4770153,1,,,,7032
9d80cf2981915d908dfc1d37dd9b97fe8501d1c5,0,Suresh Marru,2015-03-06 14:23:18-05:00,"['8c84eeedca003783f167437edfbd4a812e27d70f', '9385c4eb0ad9df573e62657bacecc552fdeb97bb']",11,11,22,4770175,8,,,,7032
44d89ee486c0ecafa94ba2254ef226a9de0b7dd0,0,shamrath,2015-03-06 15:14:00-05:00,['917adad5bbec9500a0524eeb7a3ce3763c89d961'],1,0,1,4770176,1,1,0,0,7032
774b092d31e41919b39ca3ce9f1edd5af1c30669,0,shamrath,2015-03-06 16:18:44-05:00,['44d89ee486c0ecafa94ba2254ef226a9de0b7dd0'],181,259,440,4770616,3,1,0.5625,0.9375,7032
5ff650f4c61a9ee7bfcf6f15ea984d74d545ec32,0,Lahiru Gunathilake,2015-03-07 00:37:06-05:00,['e9468ca5b68083527cb918c2ce195ec0d4f2a8a1'],62,500,562,4771178,20,0.520661157,0.429752066,1,7033
565b5a3f4ec2a5e34334c2a63ee428a7ca3d0085,0,Lahiru Gunathilake,2015-03-07 00:37:31-05:00,"['5ff650f4c61a9ee7bfcf6f15ea984d74d545ec32', '9d80cf2981915d908dfc1d37dd9b97fe8501d1c5']",11,16,27,4771205,10,,,,7033
04cecb4d4c2d52883ca03cd5791c1031b7d2bd6c,0,Lahiru Gunathilake,2015-03-07 01:18:03-05:00,['565b5a3f4ec2a5e34334c2a63ee428a7ca3d0085'],12,21,33,4771238,3,0,1,1,7033
fd557d829f282bdb1ec084cf1e7b19b57a270932,0,Chathuri Wimalasena,2015-03-09 12:34:51-04:00,['04cecb4d4c2d52883ca03cd5791c1031b7d2bd6c'],3,49,52,4771290,3,0,0.261904762,0.80952381,7033
fcbda21f3fbbbc75afa01f4b590afe873c192de2,0,Lahiru Gunathilake,2015-03-09 17:03:33-04:00,['04cecb4d4c2d52883ca03cd5791c1031b7d2bd6c'],63,112,175,4771465,10,0,1,1,7033
34b06cc9999d747cd21eee356049f5dbc47dc45e,0,Lahiru Gunathilake,2015-03-09 17:03:46-04:00,"['fcbda21f3fbbbc75afa01f4b590afe873c192de2', 'fd557d829f282bdb1ec084cf1e7b19b57a270932']",3,49,52,4771517,3,,,,7033
ad8e482674b7c3523eed16b99b5d448dfb83f63c,0,shamrath,2015-03-09 20:44:35-04:00,['774b092d31e41919b39ca3ce9f1edd5af1c30669'],0,7,7,4771524,1,0,0,1,7033
8d3b1374a9ab65f3e9dcceb8cfb4e32391c1c39f,0,msmemon,2015-03-10 16:49:25+01:00,['34b06cc9999d747cd21eee356049f5dbc47dc45e'],1,22,23,4771547,1,,,,7033
7883eb971f8c468698a15bd7c7317c14530efaa7,0,msmemon,2015-03-10 16:52:24+01:00,['8d3b1374a9ab65f3e9dcceb8cfb4e32391c1c39f'],97,441,538,4772085,5,0.088122605,0,0.992337165,7033
7ef880044a2916adabe4f33d47e6349367a3a84c,1,msmemon,2015-03-10 17:20:17+01:00,['7883eb971f8c468698a15bd7c7317c14530efaa7'],13,50,63,4772148,8,0.46875,0.5,1,7033
56efa8e5e7b1bdbc69a8238968ca305c2d8f5ad0,1,Chathuri Wimalasena,2015-03-10 13:30:28-04:00,['7ef880044a2916adabe4f33d47e6349367a3a84c'],1998,4246,6244,4778392,9,0.377058824,0.437058824,0.953529412,7034
4000b82c0dbbbae8fe54c396114ea84da5c09dde,0,Chathuri Wimalasena,2015-03-10 15:18:04-04:00,['56efa8e5e7b1bdbc69a8238968ca305c2d8f5ad0'],2,5,7,4778399,2,0,0,1,7034
b746118e5cc06ac5698c9504f6a4b1c29bc802ca,0,raminder,2015-03-10 23:28:07-04:00,['4000b82c0dbbbae8fe54c396114ea84da5c09dde'],15,143,158,4778557,1,0.010752688,1,1,7034
10c5abfdb478c57ba77e0dacdc1b02bec5ff8ed6,0,raminder,2015-03-10 23:28:34-04:00,['b746118e5cc06ac5698c9504f6a4b1c29bc802ca'],423,146,569,4779126,1,1,1,0,7034
c2bacf2d724cc4c0a58c3956f8b1fd3d54577d29,0,Lahiru Gunathilake,2015-03-11 16:20:17-04:00,['34b06cc9999d747cd21eee356049f5dbc47dc45e'],24,87,111,4779237,5,0,0.222222222,1,7034
13b480d84cdfcaf110536688309834122db8917e,0,Lahiru Gunathilake,2015-03-11 16:21:50-04:00,"['c2bacf2d724cc4c0a58c3956f8b1fd3d54577d29', '10c5abfdb478c57ba77e0dacdc1b02bec5ff8ed6']",2523,5039,7562,4786799,24,,,,7034
674db3c3e7e5adb252102ea18581d4d0523d5d62,0,Chathuri Wimalasena,2015-03-11 17:22:49-04:00,['4000b82c0dbbbae8fe54c396114ea84da5c09dde'],3,22,25,4786824,3,0.461538462,0.461538462,0.769230769,7034
f31637e8c10559ca070a49036e69776b43cb2333,0,Chathuri Wimalasena,2015-03-11 18:07:12-04:00,"['674db3c3e7e5adb252102ea18581d4d0523d5d62', '13b480d84cdfcaf110536688309834122db8917e']",445,371,816,4787640,5,,,,7034
6da7a74e34f8fa02d3a1f693917996b0ca16b34e,0,Chathuri Wimalasena,2015-03-11 22:33:28-04:00,['f31637e8c10559ca070a49036e69776b43cb2333'],2,2,4,4787644,1,,,,7034
a2181e44af8fc3e19fa0069898f8053e253adb2b,0,Chathuri Wimalasena,2015-03-12 15:46:34-04:00,['6da7a74e34f8fa02d3a1f693917996b0ca16b34e'],3,10,13,4787657,2,1,1,0.428571429,7034
757e8a3abb66905b62016c0e0b5caa420c7d7bfb,0,raminder,2015-03-13 13:08:13-04:00,['a2181e44af8fc3e19fa0069898f8053e253adb2b'],0,1,1,4787658,1,0,1,0,7034
990d72a1f007accea95d49a756cc5e10b20d924c,0,Chathuri Wimalasena,2015-03-13 14:35:57-04:00,['757e8a3abb66905b62016c0e0b5caa420c7d7bfb'],1,8,9,4787667,2,0.285714286,0.285714286,0.714285714,7034
970045939852e228bd7059eac8c7df30acad0c0e,0,shamrath,2015-03-13 14:40:32-04:00,['ad8e482674b7c3523eed16b99b5d448dfb83f63c'],2,16,18,4787685,2,0,0,1,7034
48192d98f48f381d039decb3712512336610e533,0,shamrath,2015-03-13 14:42:06-04:00,['970045939852e228bd7059eac8c7df30acad0c0e'],2,2,4,4787689,1,,,,7034
73858d152a23e1e044d6c1ee74f3f9bb056baf06,0,Chathuri Wimalasena,2015-03-13 15:12:07-04:00,['990d72a1f007accea95d49a756cc5e10b20d924c'],1,10,11,4787700,1,1,1,1,7034
a4fb48915283c93af7d4a19076a6d81fec597f64,0,msmemon,2015-03-15 16:29:27+01:00,['73858d152a23e1e044d6c1ee74f3f9bb056baf06'],507,403,910,4788610,19,1,1,0.064516129,7034
5d7a034155f0acb48c15f1420c3ab452523f40ad,0,raminder,2015-03-16 14:22:50-04:00,['a4fb48915283c93af7d4a19076a6d81fec597f64'],7,16,23,4788633,2,0,0,0,7034
be1c6a0d07f1c0e4c21f7c082335703e1d940b3b,0,raminder,2015-03-16 14:38:26-04:00,['5d7a034155f0acb48c15f1420c3ab452523f40ad'],2,1,3,4788636,1,1,1,1,7034
5749f124e15a3704c4815f9e00e5fad90481a76d,0,raminder,2015-03-16 14:46:50-04:00,['be1c6a0d07f1c0e4c21f7c082335703e1d940b3b'],1,1,2,4788638,1,,,,7034
d09957ba1b8c4b19c59349defccc9382a483619c,0,raminder,2015-03-17 10:40:46-04:00,['5749f124e15a3704c4815f9e00e5fad90481a76d'],32,33,65,4788703,3,,,,7034
f708304446dae8aa02244a9baa05cba13242a166,1,Chathuri Wimalasena,2015-03-17 11:26:42-04:00,['d09957ba1b8c4b19c59349defccc9382a483619c'],1,5,6,4788709,2,1,0,1,7034
7d57c09865be7da0dff3ec506e5b6bd00cbf9268,0,raminder,2015-03-17 12:41:28-04:00,['f708304446dae8aa02244a9baa05cba13242a166'],5,3,8,4788717,1,1,1,1,7034
73f371d81fd3a3ceecf6d015ac98b17dffc1eec9,1,Chathuri Wimalasena,2015-03-19 10:03:28-04:00,['7d57c09865be7da0dff3ec506e5b6bd00cbf9268'],2,61,63,4788780,9,0.65,0.65,1,7034
48be39fea6f1df43d0097364a937428198fcc9af,0,Lahiru Gunathilake,2015-03-19 11:02:15-04:00,"['93ed077e87c3e29cd58301ead917fcf7e2025853', '73f371d81fd3a3ceecf6d015ac98b17dffc1eec9']",17342,41428,58770,4847550,300,,,,7034
0db33d2e515603f94a8fc4abd34b1b91f6a1faa4,0,shamrath,2015-03-19 15:11:10-04:00,"['48192d98f48f381d039decb3712512336610e533', '73f371d81fd3a3ceecf6d015ac98b17dffc1eec9']",39826,73048,112874,4960424,361,,,,7034
c05d5e6c8df0a243fa240074f650b0d7800cfe69,0,Chathuri Wimalasena,2015-03-19 15:34:05-04:00,['73f371d81fd3a3ceecf6d015ac98b17dffc1eec9'],11,32,43,4960467,1,0,0,1,7034
29a0e4b61ea68044a0c4ce97a8ca62e8b8d1231a,0,shamrath,2015-03-19 15:35:19-04:00,"['0db33d2e515603f94a8fc4abd34b1b91f6a1faa4', 'c05d5e6c8df0a243fa240074f650b0d7800cfe69']",11,32,43,4960510,1,,,,7034
d3f67fd85197078e4cd13f70ff184fa38f53ea58,0,shamrath,2015-03-19 15:59:03-04:00,['29a0e4b61ea68044a0c4ce97a8ca62e8b8d1231a'],45,36,81,4960591,8,0.333333333,0.333333333,1,7034
cb6c4ccf267c165e64d6858584b2300eaaa37df4,0,Lahiru Gunathilake,2015-03-19 16:08:29-04:00,['48be39fea6f1df43d0097364a937428198fcc9af'],330,369,699,4961290,18,1,1,1,7034
2b45c6d95f083fc5a3964c9e64e2daea55e25b86,0,shamrath,2015-03-19 17:03:44-04:00,['d3f67fd85197078e4cd13f70ff184fa38f53ea58'],23,26,49,4961339,3,0,0,1,7034
be6aecdaf1bdec6c0bbea9beb5d006a1f1d175db,0,shamrath,2015-03-20 12:58:08-04:00,['2b45c6d95f083fc5a3964c9e64e2daea55e25b86'],14,11,25,4961364,1,1,1,0,7034
5310bb4b570bd0b09208e710f121e88418261c5f,0,Lahiru Gunathilake,2015-03-20 16:14:07-04:00,['cb6c4ccf267c165e64d6858584b2300eaaa37df4'],78,61,139,4961503,3,1,1,1,7034
3eb91630f9846f22ad84baad97fa6e1521b77ab9,0,Lahiru Gunathilake,2015-03-23 15:14:15-04:00,"['c05d5e6c8df0a243fa240074f650b0d7800cfe69', '5310bb4b570bd0b09208e710f121e88418261c5f']",370,3053,3423,4964926,46,,,,7034
aa27ce109a6b62dab19739051b40fbecc15a4389,0,Lahiru Gunathilake,2015-03-23 15:38:20-04:00,['3eb91630f9846f22ad84baad97fa6e1521b77ab9'],4,4,8,4964934,2,,,,7034
c090519ae2198c1d2624760c8200fb5ebf36b6be,1,Suresh Marru,2015-03-24 05:05:22-04:00,['aa27ce109a6b62dab19739051b40fbecc15a4389'],83,173,256,4965190,1,,,,7034
97c7a736236bd8275e2ea5c1fc9877ece2e4a550,1,Suresh Marru,2015-03-24 05:19:03-04:00,['c090519ae2198c1d2624760c8200fb5ebf36b6be'],5,39503,39508,5004698,53,0.306120145,0.348652514,0.854185486,7075
4ff23f4644cf74775b215842b35e4f1f2b3bd5d7,0,Suresh Marru,2015-03-24 05:36:13-04:00,['97c7a736236bd8275e2ea5c1fc9877ece2e4a550'],0,2509,2509,5007207,5,,,,7080
b27dc195ad07917b3a516b480dd809862ec540cc,0,Suresh Marru,2015-03-24 07:38:21-04:00,['4ff23f4644cf74775b215842b35e4f1f2b3bd5d7'],0,5659,5659,5012866,26,0.608116883,0.694480519,0.692857143,7106
7d787b829217f4fda26fb5265a0afbaaad86c833,0,shamrath,2015-03-25 11:22:10-04:00,['be6aecdaf1bdec6c0bbea9beb5d006a1f1d175db'],20,30,50,5012916,1,1,1,1,7106
5e5630d32ccf267260ada711a5b0d3b65bd6b081,0,shamrath,2015-03-25 11:35:01-04:00,['7d787b829217f4fda26fb5265a0afbaaad86c833'],7,9,16,5012932,1,0,0,1,7106
80d9df511f2656c2d53c251804c24c974781c0b2,0,msmemon,2015-03-25 18:01:23+01:00,['b27dc195ad07917b3a516b480dd809862ec540cc'],14,176,190,5013122,6,0.037735849,0.566037736,0.509433962,7106
1014cd9830ae8a4d5ac1df836d357e8964db79ce,0,shamrath,2015-03-25 13:25:13-04:00,"['b27dc195ad07917b3a516b480dd809862ec540cc', '5e5630d32ccf267260ada711a5b0d3b65bd6b081']",144,4018,4162,5017284,58,,,,7106
509f2037eaa7a682548c777df284d9a292cf8e04,0,shamrath,2015-03-25 16:25:01-04:00,['5e5630d32ccf267260ada711a5b0d3b65bd6b081'],100,712,812,5018096,40,,,,7108
4031e502df7d812cee88df68dcd3b8c1cb6714d5,0,shamrath,2015-03-25 16:25:36-04:00,"['1014cd9830ae8a4d5ac1df836d357e8964db79ce', '80d9df511f2656c2d53c251804c24c974781c0b2']",14,176,190,5018286,6,,,,7108
220e041937dd35da5f440fc6c43c546ded01e923,0,shamrath,2015-03-25 16:25:48-04:00,"['4031e502df7d812cee88df68dcd3b8c1cb6714d5', '509f2037eaa7a682548c777df284d9a292cf8e04']",100,712,812,5019098,40,,,,7108
a6c483cdb07da24f5c9875c2a321c516b9723d78,0,shamrath,2015-03-26 13:05:12-04:00,['220e041937dd35da5f440fc6c43c546ded01e923'],3,5,8,5019106,2,0,0,1,7108
f25af64c0cd7f1e84d4233ff717083c9e99df36e,0,Chathuri Wimalasena,2015-03-26 16:57:21-04:00,['a6c483cdb07da24f5c9875c2a321c516b9723d78'],11,441,452,5019558,13,1,1,1,7117
a8cf35fc7acc8809f2a8aa0183327cfca3345aff,0,Lahiru Gunathilake,2015-03-27 11:31:53-04:00,['f25af64c0cd7f1e84d4233ff717083c9e99df36e'],1,8,9,5019567,4,1,1,1,7117
f5a2eac628291bd218c872eeb6798149441d6a9d,0,Chathuri Wimalasena,2015-03-27 15:50:46-04:00,['a8cf35fc7acc8809f2a8aa0183327cfca3345aff'],6,352,358,5019925,8,0.342105263,0.468421053,0.773684211,7119
e0df621b6f4af5147824d4c5d61d155b134828ff,0,msmemon,2015-03-30 12:16:20+02:00,['f5a2eac628291bd218c872eeb6798149441d6a9d'],22,588,610,5020535,8,0.351282051,0.482051282,0.782051282,7120
dbe9c8cb9c34374963de92f10f23ac35923d2e5c,0,raminder,2015-03-30 09:43:39-04:00,['e0df621b6f4af5147824d4c5d61d155b134828ff'],2,3,5,5020540,2,,,,7120
17b8740c2a613c17fc12d5bd869fb1e07dd3b573,1,shamrath,2015-03-30 12:39:19-04:00,['dbe9c8cb9c34374963de92f10f23ac35923d2e5c'],49,120,169,5020709,10,0.232142857,0.642857143,1,7120
aff5d9288dfccd6b5d7dd8e22dd1f7d6e1c67b48,0,Chathuri Wimalasena,2015-03-30 13:56:16-04:00,['17b8740c2a613c17fc12d5bd869fb1e07dd3b573'],25,469,494,5021203,4,0.168253968,0.663492063,0.711111111,7120
d798cab5209a093d1f08eac591626d10ace13e14,0,Lahiru Gunathilake,2015-03-31 10:22:40-04:00,['a8cf35fc7acc8809f2a8aa0183327cfca3345aff'],0,2,2,5021205,1,0,0,1,7120
d89236975ad8e48bed81acccf545a4f2fb301845,0,Lahiru Gunathilake,2015-03-31 10:22:50-04:00,"['d798cab5209a093d1f08eac591626d10ace13e14', 'aff5d9288dfccd6b5d7dd8e22dd1f7d6e1c67b48']",80,1508,1588,5022793,29,,,,7120
7812dcaf004d510e532e448a6053e8976ddc7154,0,Chathuri Wimalasena,2015-03-31 15:24:31-04:00,['d89236975ad8e48bed81acccf545a4f2fb301845'],3,353,356,5023149,6,0.126530612,0.191836735,0.951020408,7121
1f9ac846aa0c3bf3f3ec41b3c818780baf280207,0,Chathuri Wimalasena,2015-03-31 16:37:28-04:00,['7812dcaf004d510e532e448a6053e8976ddc7154'],25,206,231,5023380,9,1,1,1,7124
26cf7edd45dac3909f5caf27ca6f93e9369bb8d4,1,Chathuri Wimalasena,2015-03-31 17:16:06-04:00,['1f9ac846aa0c3bf3f3ec41b3c818780baf280207'],2,2,4,5023384,1,,,,7124
9a0024a574029bb10fbcf0146c783e772aa3ebbb,0,Lahiru Gunathilake,2015-04-01 10:25:02-04:00,['d89236975ad8e48bed81acccf545a4f2fb301845'],0,1,1,5023385,1,0,1,1,7124
ac9dc30f53e2b64ce7abb0d0cf724770d51d10d6,0,Lahiru Gunathilake,2015-04-01 10:25:14-04:00,"['9a0024a574029bb10fbcf0146c783e772aa3ebbb', '26cf7edd45dac3909f5caf27ca6f93e9369bb8d4']",28,559,587,5023972,12,,,,7124
764a23933225075b7a36146d284e9d238d3d280a,0,Lahiru Gunathilake,2015-04-01 12:38:32-04:00,['ac9dc30f53e2b64ce7abb0d0cf724770d51d10d6'],66,118,184,5024156,10,0.818181818,0.772727273,1,7124
a51a7ca2265bcc2e56de8868bd0291d4437e941a,0,Lahiru Gunathilake,2015-04-02 11:02:44-04:00,['764a23933225075b7a36146d284e9d238d3d280a'],34,81,115,5024271,10,0.5,0.5,0.75,7124
732da594f0fc7fefbf1c0c53946db4cf035ef7db,0,raminder,2015-04-02 15:34:16-04:00,['764a23933225075b7a36146d284e9d238d3d280a'],1,1,2,5024273,1,,,,7124
fb6e3b6e97ea5a4958015d55af698811ab8be8cb,0,shamrath,2015-04-03 11:22:55-04:00,['17b8740c2a613c17fc12d5bd869fb1e07dd3b573'],0,291,291,5024564,4,0.166666667,1,0.722222222,7128
b368cb08866ac82b90d714350bb41a222875e01c,0,shamrath,2015-04-03 11:25:06-04:00,"['fb6e3b6e97ea5a4958015d55af698811ab8be8cb', '732da594f0fc7fefbf1c0c53946db4cf035ef7db']",108,1138,1246,5025810,26,,,,7128
8feb5d0da418943ae62fa070c47805da49fe9702,0,Lahiru Gunathilake,2015-04-03 12:51:32-04:00,['a51a7ca2265bcc2e56de8868bd0291d4437e941a'],8,15,23,5025833,4,0,1,0.142857143,7128
4d478d80c49b5647544cc0df3875de8409037c3d,0,Lahiru Gunathilake,2015-04-03 12:53:06-04:00,"['8feb5d0da418943ae62fa070c47805da49fe9702', '732da594f0fc7fefbf1c0c53946db4cf035ef7db']",1,1,2,5025835,1,,,,7128
d61d33ee47e6a687cc754101630828ccd899992e,0,Chathuri Wimalasena,2015-04-03 16:36:21-04:00,['4d478d80c49b5647544cc0df3875de8409037c3d'],108,192,300,5026135,7,0,0.122222222,1,7128
9a34ebc1059207f4195abb88f27ef73cb13fe3c8,0,shamrath,2015-04-05 10:31:19-04:00,['b368cb08866ac82b90d714350bb41a222875e01c'],118,362,480,5026615,11,0.86440678,0.686440678,1,7130
28043f51af7d8ce85f79d10c07ef156ed9d34d03,0,Suresh Marru,2015-04-05 23:36:23-04:00,['d61d33ee47e6a687cc754101630828ccd899992e'],288,15,303,5026918,17,,,,7130
7515c461de76249aec7e6f8ad37553ef5358b913,0,Suresh Marru,2015-04-06 00:10:30-04:00,['28043f51af7d8ce85f79d10c07ef156ed9d34d03'],270,13,283,5027201,9,,,,7130
cd6f1d9801fd66c9c877e96b5d5764540983c295,0,shamrath,2015-04-06 17:47:34-04:00,['9a34ebc1059207f4195abb88f27ef73cb13fe3c8'],46,97,143,5027344,7,0.166666667,0.875,1,7130
526aa7782eb78b6e88bfa84f0165689cf605ebde,1,Chathuri Wimalasena,2015-04-06 22:39:48-04:00,['d61d33ee47e6a687cc754101630828ccd899992e'],115,140,255,5027599,7,0.526315789,0.526315789,0.947368421,7130
97bd7a77aff6fb4f8ca56671be8fd3bb0becaa0a,0,Chathuri Wimalasena,2015-04-06 22:40:16-04:00,"['526aa7782eb78b6e88bfa84f0165689cf605ebde', '7515c461de76249aec7e6f8ad37553ef5358b913']",558,28,586,5028185,17,,,,7130
b110ff2502677f98fe889b05c4107431056e46ef,0,shamrath,2015-04-07 12:17:55-04:00,['cd6f1d9801fd66c9c877e96b5d5764540983c295'],0,33,33,5028218,3,1,1,1,7131
9f1fa2d35ebe35652a40db9d04c5e96e77b5eb1c,0,shamrath,2015-04-07 12:34:54-04:00,['b110ff2502677f98fe889b05c4107431056e46ef'],31,88,119,5028337,7,0.0625,0.458333333,1,7131
05bb24d9eb46bbe0327312dcadcdf5731caba12f,0,Chathuri Wimalasena,2015-04-07 14:12:18-04:00,['97bd7a77aff6fb4f8ca56671be8fd3bb0becaa0a'],118,184,302,5028639,7,0.088235294,0.617647059,0.941176471,7131
16700506e7d183808ac8365adb35e660b772fe93,0,Chathuri Wimalasena,2015-04-07 15:10:03-04:00,['05bb24d9eb46bbe0327312dcadcdf5731caba12f'],28,80,108,5028747,4,0,0,1,7132
226539552a86fbf8e4500a869fbca43f010fbf42,0,Chathuri Wimalasena,2015-04-07 15:48:53-04:00,['16700506e7d183808ac8365adb35e660b772fe93'],6,8,14,5028761,1,0,0,1,7132
95fae20b18f562c2d0bed46e58924516c3eccd67,0,shamrath,2015-04-07 22:31:55-04:00,"['9f1fa2d35ebe35652a40db9d04c5e96e77b5eb1c', '226539552a86fbf8e4500a869fbca43f010fbf42']",892,645,1537,5030298,43,,,,7132
6a55b19d6122903d7fb036fc58858ad21acf8bca,0,Chathuri Wimalasena,2015-04-08 10:19:22-04:00,['226539552a86fbf8e4500a869fbca43f010fbf42'],68,39,107,5030405,11,0.75,0.5,0,7132
1d862a478bc89423ed555d37aafd4b6ffe4c0005,0,Chathuri Wimalasena,2015-04-08 10:46:29-04:00,['6a55b19d6122903d7fb036fc58858ad21acf8bca'],4,4,8,5030413,1,,,,7132
6ffc3ee70114f704e6ec7adcdd05c471d98517f0,0,shamrath,2015-04-08 11:24:32-04:00,['95fae20b18f562c2d0bed46e58924516c3eccd67'],166,236,402,5030815,76,0,1,1,7134
5e77e4b5fddb88d538431c90c61e2c9427047939,0,shamrath,2015-04-08 11:25:56-04:00,"['6ffc3ee70114f704e6ec7adcdd05c471d98517f0', '1d862a478bc89423ed555d37aafd4b6ffe4c0005']",72,43,115,5030930,12,,,,7134
bf0fddb05a6fb8f61bb542e9852d252d55af55ae,0,shamrath,2015-04-08 13:35:28-04:00,['5e77e4b5fddb88d538431c90c61e2c9427047939'],30,47,77,5031007,2,0,0,0,7134
66ac6b9287f7971f5e01901c8ada37ed669cb587,0,shamrath,2015-04-08 17:06:37-04:00,['bf0fddb05a6fb8f61bb542e9852d252d55af55ae'],138,1816,1954,5032961,10,0.329331046,0.308747856,0.97941681,7136
fdb3fc918c771c1a7735891af2cd0e760039e7ad,0,Chathuri Wimalasena,2015-04-08 21:57:01-04:00,['bf0fddb05a6fb8f61bb542e9852d252d55af55ae'],130,275,405,5033366,10,0.370967742,0.693548387,1,7137
50672a799c7d9c47f23e075f055f090a15c5a013,0,shamrath,2015-04-09 16:14:17-04:00,['bf0fddb05a6fb8f61bb542e9852d252d55af55ae'],9,18,27,5033393,1,1,0,1,7137
fc20882025dd1830b85c626522fd64da03080f20,0,shamrath,2015-04-09 16:15:33-04:00,"['50672a799c7d9c47f23e075f055f090a15c5a013', 'fdb3fc918c771c1a7735891af2cd0e760039e7ad']",130,275,405,5033798,10,,,,7137
042e25c761d4356df12ff1d65382a9a814026044,0,shamrath,2015-04-09 19:45:40-04:00,"['66ac6b9287f7971f5e01901c8ada37ed669cb587', 'fc20882025dd1830b85c626522fd64da03080f20']",139,293,432,5034230,11,,,,7137
93d4421b7e5c0d32fc62ceae3d0d0c88cdaf7838,0,shamrath,2015-04-10 11:50:20-04:00,['042e25c761d4356df12ff1d65382a9a814026044'],186,279,465,5034695,11,0.666666667,0.666666667,0.925925926,7138
f987a736401cdafc237bcc016ee0a4b1f6aedebc,0,shamrath,2015-04-13 11:22:35-04:00,['93d4421b7e5c0d32fc62ceae3d0d0c88cdaf7838'],2,4,6,5034701,2,0,0,0.5,7138
3cdea29b319942b5561d658bfd550ba537212f47,1,shamrath,2015-04-13 11:30:19-04:00,['f987a736401cdafc237bcc016ee0a4b1f6aedebc'],3,103,106,5034807,5,0.857142857,0.904761905,1,7138
f1d300eed52fc8bef586cde568e875ed1b7a5ddb,1,Chathuri Wimalasena,2015-04-13 14:09:52-04:00,['3cdea29b319942b5561d658bfd550ba537212f47'],81,448,529,5035336,14,0.044609665,0.550185874,1,7139
e89ba3da05147f54943c9ad67c2b5967098dbf33,0,Chathuri Wimalasena,2015-04-13 14:41:52-04:00,['f1d300eed52fc8bef586cde568e875ed1b7a5ddb'],0,111,111,5035447,1,1,1,1,7140
97d31b4dadd8dc0c1effa3e42b59cfa1fa81c14c,1,Chathuri Wimalasena,2015-04-13 15:05:28-04:00,['e89ba3da05147f54943c9ad67c2b5967098dbf33'],47,240,287,5035734,14,0,0,0.839160839,7142
71a94a06eb30fcd8bfe587a97094b49cbb3b8c99,0,Chathuri Wimalasena,2015-04-13 15:35:44-04:00,['97d31b4dadd8dc0c1effa3e42b59cfa1fa81c14c'],13,114,127,5035861,2,0,0.188235294,0.917647059,7142
11c01c6af52ad3a84ef406c0bff7df3f35aef997,0,shamrath,2015-04-13 16:49:10-04:00,['71a94a06eb30fcd8bfe587a97094b49cbb3b8c99'],0,1,1,5035862,1,0,0,1,7142
4f95a790825fab6ebb6749fe0e731734c520f338,0,shamrath,2015-04-13 17:05:32-04:00,['11c01c6af52ad3a84ef406c0bff7df3f35aef997'],113,31,144,5036006,7,0,0,0,7142
c5c83ea5399b99e7eb72c23579c0cf2aa95c1be1,0,raminder,2015-04-13 17:07:56-04:00,['71a94a06eb30fcd8bfe587a97094b49cbb3b8c99'],14,26,40,5036046,9,0,0,0,7142
a4daa528a647e528d3e7db6a7975c76806d26178,0,raminder,2015-04-13 17:08:49-04:00,"['c5c83ea5399b99e7eb72c23579c0cf2aa95c1be1', '4f95a790825fab6ebb6749fe0e731734c520f338']",113,32,145,5036191,8,,,,7142
2dbd798d1eceeaf9157a4540836ffc87ef85de39,0,Lahiru Gunathilake,2015-04-13 17:15:39-04:00,['93d4421b7e5c0d32fc62ceae3d0d0c88cdaf7838'],1,2,3,5036194,1,1,1,0,7142
2b935a4a76b82b58bafe357b13d84739ada7121a,0,Lahiru Gunathilake,2015-04-13 17:15:48-04:00,"['2dbd798d1eceeaf9157a4540836ffc87ef85de39', 'a4daa528a647e528d3e7db6a7975c76806d26178']",197,1002,1199,5037393,46,,,,7142
a773a285890e9a37afbf39afb9acd1b3169df0ef,0,Chathuri Wimalasena,2015-04-13 22:11:45-04:00,['2b935a4a76b82b58bafe357b13d84739ada7121a'],2,2,4,5037397,2,,,,7142
7f89109fe22680f14901139ce4056458b2665ff2,0,Lahiru Gunathilake,2015-04-14 00:20:33-04:00,['a773a285890e9a37afbf39afb9acd1b3169df0ef'],34,82,116,5037513,4,1,0.184210526,1,7142
be901aa87b79d781f54e32b459d39a2d952706fc,0,Lahiru Gunathilake,2015-04-14 00:45:53-04:00,['7f89109fe22680f14901139ce4056458b2665ff2'],2,3,5,5037518,1,1,1,1,7142
ea889993dc1cbfb4a7d89aee6a524cbb21d4cee3,0,Chathuri Wimalasena,2015-04-14 11:55:57-04:00,['be901aa87b79d781f54e32b459d39a2d952706fc'],6,15,21,5037539,1,0,0,1,7142
0f97741eb1b6faf2afd18076b84e0ce534e91e31,0,Chathuri Wimalasena,2015-04-14 15:57:38-04:00,['ea889993dc1cbfb4a7d89aee6a524cbb21d4cee3'],8,316,324,5037863,6,0.162962963,0.218518519,0.948148148,7142
395c9d3246bb42e289fdf2b79f7ba5150380448e,0,Chathuri Wimalasena,2015-04-14 16:49:44-04:00,['0f97741eb1b6faf2afd18076b84e0ce534e91e31'],14,115,129,5037992,2,0.458823529,0.058823529,0.529411765,7142
c92fbd39dfe35adcebe5b25a804b1d70b0023635,0,Lahiru Gunathilake,2015-04-15 08:58:04-04:00,['be901aa87b79d781f54e32b459d39a2d952706fc'],2,10,12,5038004,3,0,1,0.285714286,7142
5e7d3ef05e3810915a5417914d238d630ff95922,0,Lahiru Gunathilake,2015-04-15 08:58:30-04:00,"['c92fbd39dfe35adcebe5b25a804b1d70b0023635', '395c9d3246bb42e289fdf2b79f7ba5150380448e']",28,446,474,5038478,9,,,,7142
73c8337aa84a8ed6a630c0bed2080a319a6bbc69,0,raminder,2015-04-15 09:58:43-04:00,['395c9d3246bb42e289fdf2b79f7ba5150380448e'],33,33,66,5038544,5,0.954545455,1,0,7142
98f218642b53d49223bb2ccce740902839053cdb,0,Lahiru Gunathilake,2015-04-15 10:00:40-04:00,"['5e7d3ef05e3810915a5417914d238d630ff95922', '73c8337aa84a8ed6a630c0bed2080a319a6bbc69']",33,33,66,5038610,5,,,,7142
ae15740d87dd8d128eb2f54fdcf1f9a73e2e3037,0,Lahiru Gunathilake,2015-04-15 10:37:24-04:00,['98f218642b53d49223bb2ccce740902839053cdb'],14,14,28,5038638,4,0,0,1,7142
90aa63955ac6cfb3718fc9702ccea6b65ae20314,0,shamrath,2015-04-15 11:39:20-04:00,['ea889993dc1cbfb4a7d89aee6a524cbb21d4cee3'],19,25,44,5038682,3,1,0,1,7142
2dde0d3aa69bd48168dac624e358cab966311e5c,0,shamrath,2015-04-15 11:39:56-04:00,"['90aa63955ac6cfb3718fc9702ccea6b65ae20314', 'ae15740d87dd8d128eb2f54fdcf1f9a73e2e3037']",64,481,545,5039227,16,,,,7142
1742c4929662c2e26e3d04383b073023b5dae06d,0,raminder,2015-04-15 12:42:59-04:00,['73c8337aa84a8ed6a630c0bed2080a319a6bbc69'],3,5,8,5039235,1,0,1,0,7142
8a7913fad430e52f11461ed6e9a1795f1d072546,0,raminder,2015-04-15 12:43:12-04:00,"['1742c4929662c2e26e3d04383b073023b5dae06d', '2dde0d3aa69bd48168dac624e358cab966311e5c']",28,42,70,5039305,7,,,,7142
2710f99ab2dde8caba40f64c358a713cc96969e2,0,Suresh Marru,2015-04-15 13:29:53-05:00,['8a7913fad430e52f11461ed6e9a1795f1d072546'],1,1,2,5039307,1,,,,7142
4e3fde8f7f30f10a93c19a7fcdd7ae394bdd2888,0,Chathuri Wimalasena,2015-04-15 15:11:40-04:00,['2710f99ab2dde8caba40f64c358a713cc96969e2'],135,496,631,5039938,34,0.945945946,1,0.831081081,7143
e01f24f7eba3b802df2ce878f49247364daea79a,0,shamrath,2015-04-15 17:45:25-04:00,['2710f99ab2dde8caba40f64c358a713cc96969e2'],38,25,63,5040001,2,0.861111111,0,0,7143
49e5201d0d18700321df7efcb0ede7acb260bcac,0,shamrath,2015-04-15 18:43:50-04:00,['e01f24f7eba3b802df2ce878f49247364daea79a'],5,9,14,5040015,1,0,1,1,7143
06e4f1d249af5fc486cfaeb76d32e98c370cf755,0,shamrath,2015-04-15 18:45:13-04:00,['49e5201d0d18700321df7efcb0ede7acb260bcac'],1,1,2,5040017,1,,,,7143
49deda55540739922f822b5a7afb5ea8dfc3c74b,0,Chathuri Wimalasena,2015-04-16 15:51:40-04:00,['4e3fde8f7f30f10a93c19a7fcdd7ae394bdd2888'],60,291,351,5040368,18,0,0.154362416,0.10738255,7143
395c7901c1be05de09e7325783dd0454f051dc10,0,Chathuri Wimalasena,2015-04-16 16:41:46-04:00,['49deda55540739922f822b5a7afb5ea8dfc3c74b'],35,36,71,5040439,2,0,0,1,7143
bd275a9a1865202ee9ecb5d076dc27bda5836d50,0,shamrath,2015-04-16 17:07:49-04:00,"['06e4f1d249af5fc486cfaeb76d32e98c370cf755', '395c7901c1be05de09e7325783dd0454f051dc10']",145,738,883,5041322,34,,,,7143
c8a17de16bfaada4dc955af0026769caa41232ee,0,Chathuri Wimalasena,2015-04-17 11:18:42-04:00,['bd275a9a1865202ee9ecb5d076dc27bda5836d50'],1,43,44,5041366,1,0,0,1,7143
cf82465a0d813ed9cb188e689eb99a999ea37f6a,0,Chathuri Wimalasena,2015-04-17 11:52:43-04:00,['c8a17de16bfaada4dc955af0026769caa41232ee'],12,15,27,5041393,4,1,1,0,7143
cc0a8f9f0b1fad0be872b636ad1195ac46ec5d44,0,shamrath,2015-04-17 17:32:16-04:00,['bd275a9a1865202ee9ecb5d076dc27bda5836d50'],10,21,31,5041424,3,0,0,1,7143
5be53c7306f1c1c8368e3da18ad8c0a320a93d68,0,shamrath,2015-04-17 17:32:22-04:00,"['cc0a8f9f0b1fad0be872b636ad1195ac46ec5d44', 'cf82465a0d813ed9cb188e689eb99a999ea37f6a']",13,58,71,5041495,5,,,,7143
5747ec014899878416372cca41cc196a842ca10a,0,shamrath,2015-04-17 17:36:38-04:00,['5be53c7306f1c1c8368e3da18ad8c0a320a93d68'],2,0,2,5041497,2,,,,7143
76d4e3eebe4dc5a272bd7d3f56be50d0630c44c6,0,Chathuri Wimalasena,2015-04-20 14:07:57-04:00,['5747ec014899878416372cca41cc196a842ca10a'],2,3,5,5041502,2,,,,7143
190217ba76d0f41dae8f532cc1d2df394ee78434,1,Chathuri Wimalasena,2015-04-20 15:03:56-04:00,['76d4e3eebe4dc5a272bd7d3f56be50d0630c44c6'],1,1,2,5041504,1,,,,7143
cff0bf2b3dfc46a2522efde69a8eea5f39d2ad56,1,shamrath,2015-04-20 15:14:19-04:00,['190217ba76d0f41dae8f532cc1d2df394ee78434'],2,4,6,5041510,2,,,,7143
cd9f58121a94bc4495b32e7a1c74f991f69c98a0,0,shamrath,2015-04-20 17:59:50-04:00,['cff0bf2b3dfc46a2522efde69a8eea5f39d2ad56'],33,219,252,5041762,20,0.051612903,0.361290323,0.980645161,7143
a5b7c59ced51634adddafce784996413c9c0e97d,1,shamrath,2015-04-20 18:48:47-04:00,['cd9f58121a94bc4495b32e7a1c74f991f69c98a0'],60,75,135,5041897,1,0,0,1,7143
37e0f4a6d11ffbe3e099dfae0a3cd77d63ac1b2c,0,shamrath,2015-04-21 09:33:23-04:00,['a5b7c59ced51634adddafce784996413c9c0e97d'],0,2,2,5041899,2,,,,7143
4a043bec675ddba4d4cbd36053d6ccde7dd2a4fb,0,Lahiru Gunathilake,2015-04-22 14:39:09-04:00,['cff0bf2b3dfc46a2522efde69a8eea5f39d2ad56'],79,33,112,5042011,9,1,1,0,7143
0f8269da3961adfa2b85823a86b6a184192fb357,0,Chathuri Wimalasena,2015-04-22 16:06:03-04:00,['4a043bec675ddba4d4cbd36053d6ccde7dd2a4fb'],58,203,261,5042272,9,0,0.496062992,0.566929134,7143
9cadde8ef901faa567a2e22e1ed3a44450d4d58b,1,Chathuri Wimalasena,2015-04-22 16:38:36-04:00,['0f8269da3961adfa2b85823a86b6a184192fb357'],176,578,754,5043026,17,0.248466258,0.31595092,0.993865031,7143
35e0af8bf8d53d28391ace67aeafc18873895b63,1,shamrath,2015-04-22 16:40:24-04:00,['37e0f4a6d11ffbe3e099dfae0a3cd77d63ac1b2c'],2485,229,2714,5045740,29,0.714105793,0.625314861,0.014483627,7143
bbb43ffb4ae8fef5041cb8fe9076b4244482c499,0,shamrath,2015-04-22 16:42:21-04:00,"['35e0af8bf8d53d28391ace67aeafc18873895b63', '9cadde8ef901faa567a2e22e1ed3a44450d4d58b']",313,814,1127,5046867,35,,,,7143
6409f076481c182fbcf22058f1a71b196599395b,0,Lahiru Gunathilake,2015-04-22 17:19:33-04:00,['4a043bec675ddba4d4cbd36053d6ccde7dd2a4fb'],54,134,188,5047055,5,0,0,0.923076923,7143
ab070e1797105e6755f623b6bd349949007039f9,0,Lahiru Gunathilake,2015-04-22 17:20:20-04:00,"['6409f076481c182fbcf22058f1a71b196599395b', 'bbb43ffb4ae8fef5041cb8fe9076b4244482c499']",2584,1087,3671,5050726,53,,,,7143
5b192c906c0394e84b63c8a5955c863c72af130b,0,Lahiru Gunathilake,2015-04-23 09:32:40-04:00,['ab070e1797105e6755f623b6bd349949007039f9'],4,0,4,5050730,1,,,,7143
d89f3f6bd0fb9ce6c34f574a6c42c2d07dfff3c0,0,Lahiru Gunathilake,2015-04-23 11:54:14-04:00,['5b192c906c0394e84b63c8a5955c863c72af130b'],160,17,177,5050907,4,0.901515152,0.901515152,0,7143
4f89c67256938ee523eb92b57897581e8460d12b,0,Chathuri Wimalasena,2015-04-23 14:50:49-04:00,['d89f3f6bd0fb9ce6c34f574a6c42c2d07dfff3c0'],183,210,393,5051300,8,0.105263158,0.473684211,0.894736842,7143
f76a4a045d44ae4afb551bd5a68e99baacd8b2a7,0,Chathuri Wimalasena,2015-04-23 16:55:21-04:00,['4f89c67256938ee523eb92b57897581e8460d12b'],24,273,297,5051597,6,0,0.255102041,1,7143
52a6fda3b4e649a2d880cb69b88d71561721796a,0,shamrath,2015-04-23 23:00:15-04:00,['f76a4a045d44ae4afb551bd5a68e99baacd8b2a7'],28,49,77,5051674,3,0.555555556,0.555555556,1,7143
775122015443118d05cb46c1fb9ae5a90f591089,0,shamrath,2015-04-23 23:24:18-04:00,['52a6fda3b4e649a2d880cb69b88d71561721796a'],4,4,8,5051682,1,,,,7143
c22f21db404c8e0f2d5d9ee4fbe84b6334465efb,0,shamrath,2015-04-24 00:19:23-04:00,['775122015443118d05cb46c1fb9ae5a90f591089'],7,19,26,5051708,1,0.909090909,1,1,7143
be018e4569f35d2cac575d5ca38ccaa55151acf2,0,shamrath,2015-04-24 00:35:27-04:00,['c22f21db404c8e0f2d5d9ee4fbe84b6334465efb'],0,1,1,5051709,1,1,1,1,7143
73da33a373bd3f98b9c1052ca1bd2854099c06bd,0,shamrath,2015-04-24 12:10:18-04:00,['be018e4569f35d2cac575d5ca38ccaa55151acf2'],4,5,9,5051718,1,1,0,1,7143
bf0f8efc8ea9ae898e3c8b48c90b41fea3507f59,0,Chathuri Wimalasena,2015-04-24 12:44:24-04:00,['73da33a373bd3f98b9c1052ca1bd2854099c06bd'],79,93,172,5051890,6,1,1,1,7143
92442cc648dfefbc8285866f939b0b9e2a3b6c0b,0,Lahiru Gunathilake,2015-04-24 13:39:46-04:00,['73da33a373bd3f98b9c1052ca1bd2854099c06bd'],29,22,51,5051941,1,1,1,0,7143
02aa95bd084b8c8a5a4c915922c19ef110e3acf1,0,Lahiru Gunathilake,2015-04-24 13:39:55-04:00,"['92442cc648dfefbc8285866f939b0b9e2a3b6c0b', 'bf0f8efc8ea9ae898e3c8b48c90b41fea3507f59']",79,93,172,5052113,6,,,,7143
ccdf5c40f889bc50ed15b22db1629ba374fe876b,0,shamrath,2015-04-24 13:58:17-04:00,['73da33a373bd3f98b9c1052ca1bd2854099c06bd'],8,29,37,5052150,5,0.733333333,0.8,1,7143
a665aa56a1b8843ee43eff12e6feb7bcdab10378,0,shamrath,2015-04-24 13:58:40-04:00,"['ccdf5c40f889bc50ed15b22db1629ba374fe876b', '02aa95bd084b8c8a5a4c915922c19ef110e3acf1']",108,115,223,5052373,7,,,,7143
264bbeb09624aa8f41b4f32959ceb08e775b889e,0,Lahiru Gunathilake,2015-04-24 14:51:20-04:00,['a665aa56a1b8843ee43eff12e6feb7bcdab10378'],60,41,101,5052474,10,1,0.363636364,1,7143
c1c85bb11129cba10cf2740eb15718989ec3bf47,0,shamrath,2015-04-24 16:26:27-04:00,['a665aa56a1b8843ee43eff12e6feb7bcdab10378'],0,2,2,5052476,1,0,0,1,7143
96f04f4d225ee1eb4e88ec6714933083ff80d94d,0,shamrath,2015-04-24 16:27:37-04:00,"['c1c85bb11129cba10cf2740eb15718989ec3bf47', '264bbeb09624aa8f41b4f32959ceb08e775b889e']",60,41,101,5052577,10,,,,7143
4f505cd575458883b738ebdd0e729900e9856422,0,shamrath,2015-04-24 16:37:02-04:00,['96f04f4d225ee1eb4e88ec6714933083ff80d94d'],0,6,6,5052583,1,0,0,1,7143
a6d876e9c5a9695ecdedbf096055aad43f780f49,0,shamrath,2015-04-24 18:14:54-04:00,['4f505cd575458883b738ebdd0e729900e9856422'],4,9,13,5052596,1,0,0,1,7143
672244e0d3fd1d9105e67e28b493929aad964528,0,Lahiru Gunathilake,2015-04-24 19:43:14-04:00,['264bbeb09624aa8f41b4f32959ceb08e775b889e'],43,79,122,5052718,9,0,0,0.935483871,7143
b419e5b7aea2f394025764bf36e45894e2e0024c,0,Lahiru Gunathilake,2015-04-24 19:43:22-04:00,"['672244e0d3fd1d9105e67e28b493929aad964528', 'a6d876e9c5a9695ecdedbf096055aad43f780f49']",4,17,21,5052739,1,,,,7143
b47e4a9330e6e48bafa49442861388bbb7a40243,0,Lahiru Gunathilake,2015-04-24 20:09:55-04:00,['b419e5b7aea2f394025764bf36e45894e2e0024c'],5,49,54,5052793,2,0,0,1,7143
e8b31a325c91daa9104b1f70268e44fbcf2fd11a,0,Lahiru Gunathilake,2015-04-25 11:19:15-04:00,['b47e4a9330e6e48bafa49442861388bbb7a40243'],5,18,23,5052816,2,0,0,0,7143
d08415a53dd6c7766acc4491a3076b752f2eb0e3,0,Lahiru Gunathilake,2015-04-25 18:03:10-04:00,['e8b31a325c91daa9104b1f70268e44fbcf2fd11a'],2,6,8,5052824,1,0,0,0,7143
8baaa0c6146ff46738bea845918de80a6bdf1d34,0,Lahiru Gunathilake,2015-04-25 19:59:46-04:00,['d08415a53dd6c7766acc4491a3076b752f2eb0e3'],16,18,34,5052858,2,0,0,0,7143
851aa62740489c495200419659d9bf908ab089b5,0,Lahiru Gunathilake,2015-04-25 20:01:15-04:00,['8baaa0c6146ff46738bea845918de80a6bdf1d34'],1,1,2,5052860,1,,,,7143
cb600a17e76d2d11e64079b3ef7ae1b3ce30c90a,1,Supun Nakandala,2015-04-26 07:24:04+05:18,['cf82465a0d813ed9cb188e689eb99a999ea37f6a'],22,547,569,5053429,10,0.101694915,0.838983051,0.033898305,7146
be997dda997032751609bb60639319b16698f92f,0,Supun Nakandala,2015-04-26 07:24:24+05:18,"['cb600a17e76d2d11e64079b3ef7ae1b3ce30c90a', '851aa62740489c495200419659d9bf908ab089b5']",3219,2053,5272,5058701,89,,,,7146
7e3478e58f74de54869e2c3d83243e3350761995,0,Supun Nakandala,2015-04-26 08:11:28+05:18,['be997dda997032751609bb60639319b16698f92f'],8,0,8,5058709,1,,,,7146
2f319c143194dfabbe76378b1ad41f0f85ac4dd3,0,Lahiru Gunathilake,2015-04-26 01:15:09-04:00,['851aa62740489c495200419659d9bf908ab089b5'],10,53,63,5058772,7,0,0.025641026,0.948717949,7146
cc40cf33a049a5fb626aaff89baf406a5c7356fb,0,shamrath,2015-04-26 13:30:17-04:00,['7e3478e58f74de54869e2c3d83243e3350761995'],27,28,55,5058827,4,,,,7146
e7e23bf3045d07c7a46f5e1279cf2a00f14c2240,0,shamrath,2015-04-27 10:31:26-04:00,['cc40cf33a049a5fb626aaff89baf406a5c7356fb'],1,1,2,5058829,1,,,,7146
4117cbc682cea81a1979f7753eac67e1a3d4b072,1,Chathuri Wimalasena,2015-04-27 10:39:12-04:00,['e7e23bf3045d07c7a46f5e1279cf2a00f14c2240'],2,13,15,5058844,4,1,1,1,7146
9f6e30e41d2f4366d4e8cd6f253cc88661a513d2,1,Supun Nakandala,2015-04-27 20:24:08+05:18,['cc40cf33a049a5fb626aaff89baf406a5c7356fb'],121,569,690,5059534,8,0.083333333,0.245614035,0,7146
0a3d857b746d27a7a8cccf4f26923b163fcb9965,1,Supun Nakandala,2015-04-27 20:34:56+05:18,['9f6e30e41d2f4366d4e8cd6f253cc88661a513d2'],12494,43430,55924,5115458,13,0.328909256,0.388612684,0.900739268,7147
c6ee5ce892a560432dbe800debebeeeb58dbb0ba,0,Supun Nakandala,2015-04-27 20:45:47+05:18,['0a3d857b746d27a7a8cccf4f26923b163fcb9965'],0,783,783,5116241,2,,,,7149
7bf5fc19bc7e406eac3604e83495b464c1862cde,0,Supun Nakandala,2015-04-27 20:45:53+05:18,"['c6ee5ce892a560432dbe800debebeeeb58dbb0ba', '4117cbc682cea81a1979f7753eac67e1a3d4b072']",3,14,17,5116258,5,,,,7149
0b572c28208f0d185cafb9f15fd617752f2517d9,0,Supun Nakandala,2015-04-27 22:41:51+05:18,['7bf5fc19bc7e406eac3604e83495b464c1862cde'],4,4,8,5116266,1,,,,7149
f0a2fdee0dd40d85ca1d244af617a0c9e54eb583,0,shamrath,2015-04-27 14:01:50-04:00,['e7e23bf3045d07c7a46f5e1279cf2a00f14c2240'],14,3,17,5116283,2,,,,7149
316c7888840b0902cf623f62ad7ddc10194e2d26,0,shamrath,2015-04-27 14:02:04-04:00,"['f0a2fdee0dd40d85ca1d244af617a0c9e54eb583', '4117cbc682cea81a1979f7753eac67e1a3d4b072']",2,13,15,5116298,4,,,,7149
19d8e495493085e337372c2ad3b22dc96a397c01,0,Chathuri Wimalasena,2015-04-27 14:15:56-04:00,['316c7888840b0902cf623f62ad7ddc10194e2d26'],1,1,2,5116300,1,,,,7149
ab2efea082fdbbdd05697386b7b5351ba47f7488,0,shamrath,2015-04-27 15:08:39-04:00,['19d8e495493085e337372c2ad3b22dc96a397c01'],0,79,79,5116379,2,0.903225806,0.935483871,1,7150
6bf56d393f7385e532998101c01f23e4b186a0ff,0,Supun Nakandala,2015-04-28 00:31:48+05:18,"['0b572c28208f0d185cafb9f15fd617752f2517d9', 'ab2efea082fdbbdd05697386b7b5351ba47f7488']",15,83,98,5116477,5,,,,7150
8ad2e036de4c9bc3ff15c61f6e23b325d082122c,0,shamrath,2015-04-27 15:29:44-04:00,['ab2efea082fdbbdd05697386b7b5351ba47f7488'],3,5,8,5116485,1,0,0,1,7150
ee139aeaf1e84d4aa7aacf71003c448598ac2f0e,0,shamrath,2015-04-27 16:10:45-04:00,['8ad2e036de4c9bc3ff15c61f6e23b325d082122c'],25,57,82,5116567,2,0,0,1,7150
71c83a19829366dea6e635a3e96957244f6d2ad8,0,shamrath,2015-04-27 16:43:47-04:00,['ee139aeaf1e84d4aa7aacf71003c448598ac2f0e'],1,5,6,5116573,1,0,0,1,7150
1fba5f95c369744b63f9e3fbbae4b3669b088b0e,0,shamrath,2015-04-27 16:53:10-04:00,['71c83a19829366dea6e635a3e96957244f6d2ad8'],1,3,4,5116577,1,0,0,1,7150
2527fe8a0b889a9d348a612f753495c45343f1b6,0,Chathuri Wimalasena,2015-04-28 15:26:18-04:00,['1fba5f95c369744b63f9e3fbbae4b3669b088b0e'],3,13,16,5116593,2,0.3,0.3,1,7150
e8a6a6e3ade44effbd9438cb6526e8d0cf28b420,0,raminder,2015-04-28 15:29:33-04:00,['1fba5f95c369744b63f9e3fbbae4b3669b088b0e'],0,3,3,5116596,1,0,0,1,7150
135607c74f29fb280b911a43c6fbf031debf5f1e,0,raminder,2015-04-28 15:30:14-04:00,"['e8a6a6e3ade44effbd9438cb6526e8d0cf28b420', '2527fe8a0b889a9d348a612f753495c45343f1b6']",3,13,16,5116612,2,,,,7150
6e94c35c0e9e01321aff2b0ce64eca74f3dc249a,0,Supun Nakandala,2015-04-29 15:43:31+05:18,['6bf56d393f7385e532998101c01f23e4b186a0ff'],785,4,789,5117401,3,0,0,1,7150
464e95554c709e08f8ba6188fcffaf4bfdc29ec6,0,Supun Nakandala,2015-04-29 15:46:16+05:18,"['6e94c35c0e9e01321aff2b0ce64eca74f3dc249a', '135607c74f29fb280b911a43c6fbf031debf5f1e']",32,85,117,5117518,5,,,,7150
e5f16f2f52ce128e5c889b5fc05f361b4fb291bb,0,shamrath,2015-04-29 10:25:42-04:00,['135607c74f29fb280b911a43c6fbf031debf5f1e'],0,1,1,5117519,1,0,0,1,7150
bcc5f583e22db7823b30b982b79fe50e80798c8a,0,Lahiru Gunathilake,2015-04-29 10:51:28-04:00,"['2f319c143194dfabbe76378b1ad41f0f85ac4dd3', 'e5f16f2f52ce128e5c889b5fc05f361b4fb291bb']",98,729,827,5118346,24,,,,7150
b90498f1559012c0587de3c9125d756e56bbef3c,0,Lahiru Gunathilake,2015-04-29 11:37:29-04:00,['bcc5f583e22db7823b30b982b79fe50e80798c8a'],75,93,168,5118514,8,0.933333333,0.866666667,0.733333333,7150
478b39726a1e6386e3b669f56f6c7af7929a98e3,0,Supun Nakandala,2015-04-29 21:26:26+05:18,"['464e95554c709e08f8ba6188fcffaf4bfdc29ec6', 'b90498f1559012c0587de3c9125d756e56bbef3c']",88,130,218,5118732,10,,,,7150
8ef27824c71ecbb467f767d964bf7fc330c67272,0,Lahiru Gunathilake,2015-04-29 12:24:34-04:00,['b90498f1559012c0587de3c9125d756e56bbef3c'],75,80,155,5118887,3,0,0.2,1,7150
fc1cffb221290d876adfc2ec6d666bbff01e7166,0,Lahiru Gunathilake,2015-04-29 12:43:31-04:00,['8ef27824c71ecbb467f767d964bf7fc330c67272'],3,4,7,5118894,2,0,0,1,7150
1e040e42bc5c62d76e77ecd2babf0f0353ba0231,0,Lahiru Gunathilake,2015-04-29 14:01:00-04:00,['fc1cffb221290d876adfc2ec6d666bbff01e7166'],37,34,71,5118965,3,1,1,0.823529412,7150
6c06aaac6608855d108b53606d5c2388af04af79,0,Lahiru Gunathilake,2015-04-29 14:40:31-04:00,['1e040e42bc5c62d76e77ecd2babf0f0353ba0231'],12,24,36,5119001,3,0,0,1,7150
2f06d2768fa1c3b12e4ea12f2beb549c83c5b139,0,Suresh Marru,2015-04-30 09:59:59-04:00,['bcc5f583e22db7823b30b982b79fe50e80798c8a'],0,336,336,5119337,5,,,,7155
7c1c632b83fc52659267a1e0772f263df836d492,0,Suresh Marru,2015-04-30 10:00:13-04:00,"['2f06d2768fa1c3b12e4ea12f2beb549c83c5b139', '6c06aaac6608855d108b53606d5c2388af04af79']",130,163,293,5119630,10,,,,7155
5d940d347f7f16164cef4a0f6456ec9845016574,0,Supun Nakandala,2015-04-30 21:05:33+05:18,"['478b39726a1e6386e3b669f56f6c7af7929a98e3', '7c1c632b83fc52659267a1e0772f263df836d492']",100,451,551,5120181,9,,,,7155
8a0dd498d414bf26b522e0e27491b6f7a3fe3a30,0,Eroma Abeysinghe,2015-04-30 12:25:35-04:00,['7c1c632b83fc52659267a1e0772f263df836d492'],3,3,6,5120187,1,,,,7155
20bf020d5bc0c488bbcf7331cd8c9677c7596391,0,Eroma Abeysinghe,2015-04-30 12:26:53-04:00,['8a0dd498d414bf26b522e0e27491b6f7a3fe3a30'],7,0,7,5120194,1,,,,7155
5cc8b43d0ab0cfa977c777f425174c3f1bcf9c95,0,Supun Nakandala,2015-04-30 22:19:45+05:18,"['5d940d347f7f16164cef4a0f6456ec9845016574', '20bf020d5bc0c488bbcf7331cd8c9677c7596391']",10,3,13,5120207,2,,,,7155
1e2f784a711d1e0af8d0d91c3586269ccc2dcf7b,1,Suresh Marru,2015-05-02 15:02:02-04:00,['5cc8b43d0ab0cfa977c777f425174c3f1bcf9c95'],21,35,56,5120263,6,0,0,1,7155
742edee5cd03038a0cf838c79102818b3b880517,0,raminder,2015-05-07 10:00:27-04:00,['1e2f784a711d1e0af8d0d91c3586269ccc2dcf7b'],3,3,6,5120269,1,,0,,7155
70239916903505c8ec195108eed708f804d720b7,0,shamrath,2015-05-08 11:54:58-04:00,['742edee5cd03038a0cf838c79102818b3b880517'],6749,11,6760,5127029,48,0.740684411,0.599619772,0.211406844,7155
34a8401081853f9ed67772c88bfddd31be661723,0,Suresh Marru,2015-05-10 10:51:40-04:00,['70239916903505c8ec195108eed708f804d720b7'],2,22,24,5127053,2,,,,7156
4819dbb2c4f05f8ec4790bcbda641556e19944d1,0,shamrath,2015-05-10 11:10:41-04:00,['70239916903505c8ec195108eed708f804d720b7'],44,65,109,5127162,1,0.6,0.6,1,7156
a3487e770a29be9060ee72298fa91f9b0a71e4be,0,shamrath,2015-05-10 15:07:37-04:00,['4819dbb2c4f05f8ec4790bcbda641556e19944d1'],347,208,555,5127717,37,0.702702703,1,0,7156
fd6e0a0be55ca20e811a8b6ccd4288d8ce330eae,0,shamrath,2015-05-10 16:15:30-04:00,['a3487e770a29be9060ee72298fa91f9b0a71e4be'],9,1,10,5127727,1,1,1,0,7156
4de74c6017ad2b6c3554a4956a4fd9db216ad2d3,0,shamrath,2015-05-10 16:39:57-04:00,['fd6e0a0be55ca20e811a8b6ccd4288d8ce330eae'],2,2,4,5127731,1,,,,7156
e4be39e812058d3dfb50aed87bdefee5d081b74d,0,shamrath,2015-05-10 16:40:03-04:00,"['4de74c6017ad2b6c3554a4956a4fd9db216ad2d3', '34a8401081853f9ed67772c88bfddd31be661723']",2,22,24,5127755,2,,,,7156
7b8e933a40c3dcafedcd13291d9abb1135177404,0,Chathuri Wimalasena,2015-05-11 10:23:47-04:00,['e4be39e812058d3dfb50aed87bdefee5d081b74d'],13,18,31,5127786,8,1,1,1,7156
43c313f9a1234154e7093a5b63cbf8e6bf0efe49,0,Chathuri Wimalasena,2015-05-11 10:57:12-04:00,['7b8e933a40c3dcafedcd13291d9abb1135177404'],62,248,310,5128096,10,0.253164557,0.32278481,0.974683544,7156
06bf62b9de57621d994e51b594855a602403f560,0,Supun Nakandala,2015-05-11 22:50:41+05:18,['43c313f9a1234154e7093a5b63cbf8e6bf0efe49'],0,12,12,5128108,1,,,,7156
b643ea58fe537d369e12f34feb66c9c88034bd7b,0,Chathuri Wimalasena,2015-05-11 14:22:42-04:00,['06bf62b9de57621d994e51b594855a602403f560'],5,13,18,5128126,2,0,0,1,7156
e9a451dc07fa7756e05c551579a1dff0828cbb15,0,Chathuri Wimalasena,2015-05-11 14:33:41-04:00,['b643ea58fe537d369e12f34feb66c9c88034bd7b'],2,3,5,5128131,2,0,0,1,7156
4a978d4f1347aa683189f7ea5e814d125daaecb1,0,Chathuri Wimalasena,2015-05-11 15:52:17-04:00,['e9a451dc07fa7756e05c551579a1dff0828cbb15'],56,39,95,5128226,2,0,0,1,7156
badaa732ff527a0a4012fe824cb53db83954d24b,0,shamrath,2015-05-11 16:34:15-04:00,['4a978d4f1347aa683189f7ea5e814d125daaecb1'],5,163,168,5128394,13,0.277777778,0.916666667,1,7156
cdf97990540316fde2e434ca490a5c492aa6d4f3,0,Suresh Marru,2015-05-11 21:00:10-04:00,['badaa732ff527a0a4012fe824cb53db83954d24b'],12,10,22,5128416,1,1,1,0,7156
d2afa76fb0eedce88c9eff7d3c107aa114cfd0e6,0,shamrath,2015-05-12 11:38:15-04:00,['badaa732ff527a0a4012fe824cb53db83954d24b'],2,3,5,5128421,1,0,0,1,7156
9a8a14b9f8ec5a1e7e447b71bc4aebec9c8dba47,0,shamrath,2015-05-12 11:45:40-04:00,"['d2afa76fb0eedce88c9eff7d3c107aa114cfd0e6', 'cdf97990540316fde2e434ca490a5c492aa6d4f3']",3,0,3,5128424,1,,,,7156
113b75fc682d7f9ab1ae8ef186d6c551f18ca293,0,Chathuri Wimalasena,2015-05-12 12:16:00-04:00,['9a8a14b9f8ec5a1e7e447b71bc4aebec9c8dba47'],13,17,30,5128454,1,0,0,1,7156
258e06e1ccb38b41e318efecf26395c3c7206fb9,0,shamrath,2015-05-12 13:59:30-04:00,['113b75fc682d7f9ab1ae8ef186d6c551f18ca293'],103,143,246,5128700,7,0.590909091,0.454545455,1,7156
09db4ec38eb1707b851787e0a1144f8250e6c0c5,0,shamrath,2015-05-12 14:42:35-04:00,['258e06e1ccb38b41e318efecf26395c3c7206fb9'],31,2,33,5128733,2,1,1,0,7156
e0ce541139fa7a8418bc9f5b548795b8b9f8a5b4,0,Chathuri Wimalasena,2015-05-12 15:08:51-04:00,['09db4ec38eb1707b851787e0a1144f8250e6c0c5'],4,742,746,5129479,7,0.554644809,0.699453552,1,7160
747d766ff4918cec2e5a16afbc7acb54303c55cd,0,Chathuri Wimalasena,2015-05-12 15:13:41-04:00,['e0ce541139fa7a8418bc9f5b548795b8b9f8a5b4'],43,142,185,5129664,4,0.416666667,0.416666667,1,7161
6f8fa3e9093f0845eb38ac7ba57eda8b1ad12791,0,Chathuri Wimalasena,2015-05-12 15:22:34-04:00,['747d766ff4918cec2e5a16afbc7acb54303c55cd'],94,34,128,5129792,5,0,0,0,7161
1b84883f194f3a5f9b228d63d3e46b9d8f936909,0,Chathuri Wimalasena,2015-05-12 15:30:53-04:00,['6f8fa3e9093f0845eb38ac7ba57eda8b1ad12791'],1,1,2,5129794,1,,,,7161
a893d86b5a1e9c9bd37ce89c35938a682a406562,0,Suresh Marru,2015-05-12 16:57:20-04:00,['1b84883f194f3a5f9b228d63d3e46b9d8f936909'],6,3821,3827,5133621,22,,,,7181
d076fa8bc928d8161a3483cc883108fd8e79f071,0,raminder,2015-05-12 17:09:13-04:00,['1b84883f194f3a5f9b228d63d3e46b9d8f936909'],47,68,115,5133736,5,0.769230769,0.769230769,1,7181
483e9274db29454b3719b2cccbfab2eb02966fbf,0,Chathuri Wimalasena,2015-05-12 17:10:09-04:00,['1b84883f194f3a5f9b228d63d3e46b9d8f936909'],2,14,16,5133752,1,0,1,1,7181
febe2f925a67e8c8ac3ed63e202340a3c3f889a4,0,Suresh Marru,2015-05-12 17:12:19-04:00,['a893d86b5a1e9c9bd37ce89c35938a682a406562'],3195,0,3195,5136947,29,0.663356504,0.444885799,0.459781529,7181
4f4c79963fe6db6521dfb1dc3dfe0bd447a73e44,0,Chathuri Wimalasena,2015-05-12 17:12:53-04:00,"['483e9274db29454b3719b2cccbfab2eb02966fbf', 'febe2f925a67e8c8ac3ed63e202340a3c3f889a4']",3186,3806,6992,5143939,50,,,,7181
d21087291855c68c692ca53601baa28629f1e7c0,0,shamrath,2015-05-12 19:27:04-04:00,['1b84883f194f3a5f9b228d63d3e46b9d8f936909'],429,73,502,5144441,7,0.916363636,1,0.785454545,7181
34cd927c30e169ea8a8808eefc173d21e1fe53b5,0,shamrath,2015-05-12 19:27:10-04:00,"['d21087291855c68c692ca53601baa28629f1e7c0', '4f4c79963fe6db6521dfb1dc3dfe0bd447a73e44']",3188,3820,7008,5151449,51,,,,7181
382b6c0e6bf64d968bf0f39f3c5776dbc73c51d8,0,Suresh Marru,2015-05-12 21:19:28-04:00,['34cd927c30e169ea8a8808eefc173d21e1fe53b5'],5087,5,5092,5156541,32,0.690205011,0.50284738,0.132118451,7181
624dd4149dd0fc8b4369eff4d4750d0cc9f20411,0,Suresh Marru,2015-05-12 21:34:31-04:00,['382b6c0e6bf64d968bf0f39f3c5776dbc73c51d8'],1273,0,1273,5157814,11,0.452777778,0.4,0.375,7181
ea93cc1ef73b017fc4db4911b921baa7f41d11a6,0,raminder,2015-05-12 22:42:30-04:00,"['d076fa8bc928d8161a3483cc883108fd8e79f071', '624dd4149dd0fc8b4369eff4d4750d0cc9f20411']",9977,3898,13875,5171689,98,,,,7181
ec9b6fe42114f2cd7b0a411c40bb844217b169e9,0,Chathuri Wimalasena,2015-05-13 11:05:20-04:00,['ea93cc1ef73b017fc4db4911b921baa7f41d11a6'],97,85,182,5171871,2,1,1,1,7181
0f5ec6f91c8faac16902b05358c773b377341332,0,shamrath,2015-05-13 11:06:47-04:00,['ea93cc1ef73b017fc4db4911b921baa7f41d11a6'],715,23,738,5172609,4,0,0,1,7181
7d391f11a7d660a508febdd76566a486fceb8ff1,0,shamrath,2015-05-13 11:07:12-04:00,"['0f5ec6f91c8faac16902b05358c773b377341332', 'ec9b6fe42114f2cd7b0a411c40bb844217b169e9']",97,85,182,5172791,2,,,,7181
246d55b86e07e615f0900c0ea3e4a53c0ab737fc,0,shamrath,2015-05-13 11:11:40-04:00,['7d391f11a7d660a508febdd76566a486fceb8ff1'],1,1,2,5172793,1,,,,7181
4a38f819abae1de0c4d08d1a908d712e97bdbe5a,0,shamrath,2015-05-13 11:25:36-04:00,['246d55b86e07e615f0900c0ea3e4a53c0ab737fc'],4,2,6,5172799,2,1,0.133333333,0,7181
b96366fec08ea12ee336a4b10ac91bd8e990a3e8,0,shamrath,2015-05-13 11:42:29-04:00,['4a38f819abae1de0c4d08d1a908d712e97bdbe5a'],0,8,8,5172807,1,0,1,0,7181
a6a80d5ac827976f0c637c8adf9447b98795c7c7,0,shamrath,2015-05-13 12:03:21-04:00,['b96366fec08ea12ee336a4b10ac91bd8e990a3e8'],2,7,9,5172816,2,0,1,1,7181
aa7af1bc34ed7fec7b66a9ab5d5806815ad4a9f0,0,shamrath,2015-05-13 14:34:34-04:00,['a6a80d5ac827976f0c637c8adf9447b98795c7c7'],23,0,23,5172839,1,1,1,0,7181
16b58b8c824786db23ba851e6043a09c0ebb8f08,0,shamrath,2015-05-13 14:44:34-04:00,['aa7af1bc34ed7fec7b66a9ab5d5806815ad4a9f0'],0,2,2,5172841,1,0,0,1,7181
2fe26fb6ec643ec694cab016c67f1d76ca6605bf,0,Chathuri Wimalasena,2015-05-13 15:11:38-04:00,['16b58b8c824786db23ba851e6043a09c0ebb8f08'],6,1,7,5172848,2,1,1,0,7181
563c62488c6cc735080613d771096878d71f3f21,1,shamrath,2015-05-13 15:40:29-04:00,['16b58b8c824786db23ba851e6043a09c0ebb8f08'],6,49,55,5172903,1,0,0.025641026,1,7181
4737235654d2eae5672b26ea99302de3da4fc57d,0,shamrath,2015-05-13 15:40:45-04:00,"['563c62488c6cc735080613d771096878d71f3f21', '2fe26fb6ec643ec694cab016c67f1d76ca6605bf']",6,1,7,5172910,2,,,,7181
6117c2963f7e569ee536f8ad7d39ca14fe234a9b,0,Chathuri Wimalasena,2015-05-13 15:42:35-04:00,['4737235654d2eae5672b26ea99302de3da4fc57d'],741,15,756,5173666,6,0.442307692,0.296703297,0,7181
43e15cb46b9a5d9dbf19e61c3323f9d3918b0103,0,shamrath,2015-05-13 15:43:35-04:00,['4737235654d2eae5672b26ea99302de3da4fc57d'],1,0,1,5173667,1,,,,7181
4b048e14910a819431d89045048a38829fd839a8,0,shamrath,2015-05-13 15:44:10-04:00,"['43e15cb46b9a5d9dbf19e61c3323f9d3918b0103', '6117c2963f7e569ee536f8ad7d39ca14fe234a9b']",741,15,756,5174423,6,,,,7181
c38b3b69885eb74a2cabec7079178b59697d56b4,0,Suresh Marru,2015-05-13 15:51:04-04:00,['16b58b8c824786db23ba851e6043a09c0ebb8f08'],208,113,321,5174744,6,,,,7182
449eb75766ca02e0445731c9a76d639c9f204bc3,0,Suresh Marru,2015-05-13 15:51:16-04:00,"['c38b3b69885eb74a2cabec7079178b59697d56b4', '4b048e14910a819431d89045048a38829fd839a8']",753,64,817,5175561,9,,,,7182
c29aa94cd498c5f384b12f3dc655df80f0bc77e6,0,shamrath,2015-05-13 15:57:33-04:00,['4b048e14910a819431d89045048a38829fd839a8'],12,27,39,5175600,2,0,0,1,7182
420a51ad6a6a53ac9d0492d537325947c195490f,0,shamrath,2015-05-13 15:57:43-04:00,"['c29aa94cd498c5f384b12f3dc655df80f0bc77e6', '449eb75766ca02e0445731c9a76d639c9f204bc3']",208,113,321,5175921,6,,,,7182
2bf83dd03cb1f312a8c1de114aedcd0801337901,0,shamrath,2015-05-13 16:24:00-04:00,['420a51ad6a6a53ac9d0492d537325947c195490f'],47,8,55,5175976,1,1,1,1,7182
6fb6644a41819dd59dbc01718dd83e72305ddd74,0,raminder,2015-05-13 16:39:40-04:00,['ea93cc1ef73b017fc4db4911b921baa7f41d11a6'],11,31,42,5176018,2,0,0,0.933333333,7182
fea3325f77abf822b0d4c74682c9be9d512e3ed0,0,raminder,2015-05-13 16:39:52-04:00,"['6fb6644a41819dd59dbc01718dd83e72305ddd74', '2bf83dd03cb1f312a8c1de114aedcd0801337901']",1862,340,2202,5178220,25,,,,7182
0140ce72cb8f56f8c0cc6049071682d52aecf06a,0,Chathuri Wimalasena,2015-05-13 16:48:11-04:00,['fea3325f77abf822b0d4c74682c9be9d512e3ed0'],1,2,3,5178223,1,0,0,1,7182
01414757c10f16f765a4c96ec486bb7585e9892a,0,Chathuri Wimalasena,2015-05-13 16:55:02-04:00,['0140ce72cb8f56f8c0cc6049071682d52aecf06a'],2,0,2,5178225,1,1,1,0,7182
8c85778739b3ac0cefe36709494720bd5542e6fd,0,shamrath,2015-05-13 17:31:59-04:00,['2bf83dd03cb1f312a8c1de114aedcd0801337901'],6,1,7,5178232,1,1,0,0,7182
e6d66d000095205b3405454a91b96f76844a4078,0,shamrath,2015-05-13 17:32:14-04:00,"['8c85778739b3ac0cefe36709494720bd5542e6fd', '01414757c10f16f765a4c96ec486bb7585e9892a']",14,33,47,5178279,3,,,,7182
6b7a84ce2f3d4d5277cfbd1a12ee4e219fa6e31f,0,shamrath,2015-05-14 11:14:17-04:00,['e6d66d000095205b3405454a91b96f76844a4078'],7,18,25,5178304,1,0.375,0.375,1,7182
5ee2559b4047c0537f6f4b1344c4ec485719defd,0,Chathuri Wimalasena,2015-05-14 11:34:48-04:00,['6b7a84ce2f3d4d5277cfbd1a12ee4e219fa6e31f'],1,1,2,5178306,1,,,,7182
cc19eed947797706f151d4bce222ca9cb195b14d,0,shamrath,2015-05-14 12:34:43-04:00,['5ee2559b4047c0537f6f4b1344c4ec485719defd'],38,8,46,5178352,2,1,1,0,7182
acf30c0131aa8f7ed3d5801fa558ab0d7a2342c5,0,shamrath,2015-05-14 14:18:59-04:00,['cc19eed947797706f151d4bce222ca9cb195b14d'],27,31,58,5178410,8,0,1,0,7182
86a79b669c51bb1d464d860256057d793de38fca,0,shamrath,2015-05-14 15:23:45-04:00,['acf30c0131aa8f7ed3d5801fa558ab0d7a2342c5'],3,121,124,5178534,5,1,1,0.813559322,7183
41cb87a9f64d29f7089437d4cf2ed1b332a1c5cf,0,shamrath,2015-05-14 15:44:10-04:00,['86a79b669c51bb1d464d860256057d793de38fca'],2,2,4,5178538,2,,,,7183
ae129dd218b2d7ea6d0fc4f0342bb90ee364a432,0,shamrath,2015-05-14 16:41:37-04:00,['41cb87a9f64d29f7089437d4cf2ed1b332a1c5cf'],0,10,10,5178548,3,0.444444444,0,1,7183
7d4da19587bef2b90dbebe7889d4f9099fc5ff45,0,shamrath,2015-05-14 18:08:42-04:00,['ae129dd218b2d7ea6d0fc4f0342bb90ee364a432'],4,4,8,5178556,3,,,,7183
55a9346a6e4bdd5ed0f8b743d6db0a1b9f8ce98d,0,shamrath,2015-05-14 19:40:34-04:00,['7d4da19587bef2b90dbebe7889d4f9099fc5ff45'],2,14,16,5178572,1,1,1,1,7183
769b905e13ff8301f0334cd280839f8500e08edf,0,shamrath,2015-05-15 11:26:10-04:00,['55a9346a6e4bdd5ed0f8b743d6db0a1b9f8ce98d'],3,4,7,5178579,2,,,,7183
d8054829b448ad2a754f9cbae6437d185bfdfbec,0,Chathuri Wimalasena,2015-05-15 11:52:42-04:00,['769b905e13ff8301f0334cd280839f8500e08edf'],1,23,24,5178603,2,0,0,1,7183
8ae827d91401d68c767114b809fd6a6aaa4135e6,0,Supun Nakandala,2015-05-16 11:37:26+05:18,['d8054829b448ad2a754f9cbae6437d185bfdfbec'],1,3,4,5178607,1,0,1,1,7183
0a3ab51f86eb6f87f58720f6573d1115ba34a016,0,shamrath,2015-05-18 11:03:42-04:00,['8ae827d91401d68c767114b809fd6a6aaa4135e6'],5,13,18,5178625,2,0,0.625,1,7183
c4b8fb21a564cd39676fead8046fdd4087d4a49f,0,shamrath,2015-05-18 11:44:38-04:00,['0a3ab51f86eb6f87f58720f6573d1115ba34a016'],17,3,20,5178645,1,1,1,0,7183
18748564fbf920cb37e860be9e5718bb089e164a,0,shamrath,2015-05-18 15:50:14-04:00,['c4b8fb21a564cd39676fead8046fdd4087d4a49f'],3,8,11,5178656,1,0,1,1,7183
c11b6628c4ea871256501c5e93d17cd1391d9910,0,shamrath,2015-05-18 16:58:28-04:00,['18748564fbf920cb37e860be9e5718bb089e164a'],16,7,23,5178679,1,1,0,0,7183
ad41af738402a0a6f0b8f7eae9758da3b1a81284,0,Chathuri Wimalasena,2015-05-19 09:57:47-04:00,['c11b6628c4ea871256501c5e93d17cd1391d9910'],5,19,24,5178703,3,0.230769231,0.230769231,1,7183
7229a4abd03ba06325d6245a962ff5b754a95df7,0,Chathuri Wimalasena,2015-05-19 14:23:13-04:00,['ad41af738402a0a6f0b8f7eae9758da3b1a81284'],8,16,24,5178727,3,0,0,1,7183
973bf93a9076f883cc7a0eb9bc506e568f8b48ac,1,Chathuri Wimalasena,2015-05-19 16:25:26-04:00,['7229a4abd03ba06325d6245a962ff5b754a95df7'],275,167,442,5179169,13,0,0,0,7183
419cd6a3c4603060d40424da660079729c7e9a81,0,Chathuri Wimalasena,2015-05-19 16:44:35-04:00,['973bf93a9076f883cc7a0eb9bc506e568f8b48ac'],1,0,1,5179170,1,1,1,0,7183
a8a0fcea2d1a3a4cbff27c8e0b663ae07b59eb15,0,shamrath,2015-05-19 18:55:54-04:00,['419cd6a3c4603060d40424da660079729c7e9a81'],34,80,114,5179284,4,0.235294118,0.62745098,0.039215686,7183
7c5418074a35cfbccdb4753169b6d3992c5d7fc1,0,shamrath,2015-05-20 10:33:52-04:00,['a8a0fcea2d1a3a4cbff27c8e0b663ae07b59eb15'],1,0,1,5179285,1,1,1,0,7183
1066f008f3462a3bc764a00a26632ed67772ae31,0,shamrath,2015-05-20 10:40:19-04:00,['7c5418074a35cfbccdb4753169b6d3992c5d7fc1'],1,10,11,5179296,1,0,0,1,7183
9f8e68b42a1efc3e7589c3d7994693cb9035aa1f,0,Chathuri Wimalasena,2015-05-20 11:13:58-04:00,['1066f008f3462a3bc764a00a26632ed67772ae31'],3,1,4,5179300,1,1,1,0,7183
0af085f4a6e900a2a3772a09c7fa39ceae022613,0,Chathuri Wimalasena,2015-05-20 15:09:47-04:00,['9f8e68b42a1efc3e7589c3d7994693cb9035aa1f'],0,17,17,5179317,3,0.538461538,0.538461538,1,7183
5c3c9bdb5ebabc2d0aca737f4bcba454e435afd7,0,Hasini Gunasinghe,2015-05-21 17:40:05+05:18,['8ae827d91401d68c767114b809fd6a6aaa4135e6'],4,205,209,5179526,6,0.46875,1,1,7186
d4ccc87118b3d0710bd4752eb39998e7fcf067d6,0,Chathuri Wimalasena,2015-05-21 12:14:48-04:00,['0af085f4a6e900a2a3772a09c7fa39ceae022613'],3,8,11,5179537,5,,,,7186
111d9b59957fcc4f71fbce8961d9c0eefb316cb8,0,shamrath,2015-05-21 16:14:55-04:00,['d4ccc87118b3d0710bd4752eb39998e7fcf067d6'],4,4,8,5179545,1,1,1,0,7186
a74790a20269f888a5a48e50b5ed64a55cb5ecdd,0,Chathuri Wimalasena,2015-05-21 16:31:55-04:00,['111d9b59957fcc4f71fbce8961d9c0eefb316cb8'],0,18,18,5179563,5,0,0.5,1,7186
83feaecee113239f028baa9c829fe4b60cf70682,0,shamrath,2015-05-22 11:29:06-04:00,['a74790a20269f888a5a48e50b5ed64a55cb5ecdd'],29,57,86,5179649,9,0.818181818,0.681818182,1,7186
db9918f890dec7a45d73dfb908604cbbbe954803,0,Chathuri Wimalasena,2015-05-22 11:35:45-04:00,['83feaecee113239f028baa9c829fe4b60cf70682'],10,37,47,5179696,2,0.904761905,1,0.666666667,7186
c6ac2b1767a5abbe30863c3e56895a87fa1a374d,0,Chathuri Wimalasena,2015-05-22 11:47:34-04:00,['db9918f890dec7a45d73dfb908604cbbbe954803'],2,1,3,5179699,1,1,1,0,7186
72110910a98e68f5b93b94cd0a19e91790206a27,0,shamrath,2015-05-22 17:16:01-04:00,['c6ac2b1767a5abbe30863c3e56895a87fa1a374d'],16,45,61,5179760,1,0.84,0.24,1,7186
86994f641a1ad2f86161882e1c9b88dd41a8e91a,0,shamrath,2015-05-22 17:18:39-04:00,['72110910a98e68f5b93b94cd0a19e91790206a27'],1,1,2,5179762,1,,,,7186
14a1621a8218d49e8b1fc775d62c1fe63e4b3983,0,Hasini Gunasinghe,2015-05-23 13:12:54+05:18,['5c3c9bdb5ebabc2d0aca737f4bcba454e435afd7'],0,864,864,5180626,8,0.425968109,0.785876993,0.920273349,7194
addb4be944acedce8efb089a1e85f86672aaa1c0,0,Hasini Gunasinghe,2015-05-23 21:26:32+05:18,['14a1621a8218d49e8b1fc775d62c1fe63e4b3983'],60,683,743,5181369,23,0.204724409,0.170603675,0.724409449,7197
b62a56aa29c15e070b1efcc7e4f7e05d5309fc45,0,Hasini Gunasinghe,2015-05-25 08:31:10+05:18,['addb4be944acedce8efb089a1e85f86672aaa1c0'],1,10,11,5181380,1,0,0,1,7197
a23a9cc01587d3326a3119a8b201fcd6c7d33f1d,0,Suresh Marru,2015-05-25 23:43:54-04:00,['86994f641a1ad2f86161882e1c9b88dd41a8e91a'],58,1,59,5181439,23,0.58,0.16,0,7197
9f3d55bdd766e6e147fa1372d9598c6d21578145,0,Shameera Rathanyaka,2015-05-26 14:35:37-04:00,['a23a9cc01587d3326a3119a8b201fcd6c7d33f1d'],21,32,53,5181492,4,0.111111111,0.555555556,0,7197
c538ebfeb59b43673c22cdf8b19fcf2ae96e66e8,0,Chathuri Wimalasena,2015-05-26 15:49:50-04:00,['9f3d55bdd766e6e147fa1372d9598c6d21578145'],4,5,9,5181501,1,1,1,0,7197
94a20abca9839120b6e96898aacfc9fa9b16a223,0,Chathuri Wimalasena,2015-05-27 09:40:53-04:00,['c538ebfeb59b43673c22cdf8b19fcf2ae96e66e8'],34,14,48,5181549,2,0.4,0.5,0,7197
a26c1e783dba00372c465d39ce075a6d85137087,0,Chathuri Wimalasena,2015-05-27 14:16:13-04:00,['94a20abca9839120b6e96898aacfc9fa9b16a223'],7,13,20,5181569,5,1,1,1,7197
4e9aa00a48801fe142a0588a69bf7118cca90dfa,0,Shameera Rathanyaka,2015-05-27 14:25:40-04:00,['a26c1e783dba00372c465d39ce075a6d85137087'],1,1,2,5181571,1,,,,7197
9318831bf8cb705ae434a32e9ecf368db912e2e2,0,Shameera Rathanyaka,2015-05-27 14:44:31-04:00,['4e9aa00a48801fe142a0588a69bf7118cca90dfa'],1,1,2,5181573,1,,,,7197
1ec0920285e967e05e715331c429f2f056ebb9b6,0,Chathuri Wimalasena,2015-05-27 14:50:21-04:00,['9318831bf8cb705ae434a32e9ecf368db912e2e2'],1,1,2,5181575,1,,,,7197
e6c774b2ba277e45e954f205634e1494fda1cef2,0,Chathuri Wimalasena,2015-05-27 15:34:26-04:00,['1ec0920285e967e05e715331c429f2f056ebb9b6'],23,60,83,5181658,1,0,0,1,7197
c6081e75bf3ce6a462a3460e628fe7f8d847b53c,0,Shameera Rathanyaka,2015-05-27 16:18:06-04:00,['9318831bf8cb705ae434a32e9ecf368db912e2e2'],0,3,3,5181661,1,1,1,1,7197
5002df55a77f1949f12f30dea5c4d1117f2648a5,0,Shameera Rathanyaka,2015-05-27 16:18:16-04:00,"['c6081e75bf3ce6a462a3460e628fe7f8d847b53c', 'e6c774b2ba277e45e954f205634e1494fda1cef2']",24,61,85,5181746,2,,,,7197
915ed04d54c61e083ef0f2b7dccb7083ef3fee9e,0,Shameera Rathanyaka,2015-05-27 16:48:49-04:00,['5002df55a77f1949f12f30dea5c4d1117f2648a5'],190,3,193,5181939,4,0.855769231,0.971153846,0,7197
4a06178022c0cd1a215c47e3c65a7b6ffd342bbb,0,Shameera Rathanyaka,2015-05-28 11:26:36-04:00,['915ed04d54c61e083ef0f2b7dccb7083ef3fee9e'],971,509,1480,5183419,19,0.849275362,0.672463768,0.182608696,7197
957fd5fc535f1f8b5a48cc3a888c2da174e4e5d8,0,Shameera Rathanyaka,2015-05-28 20:26:09-04:00,['4a06178022c0cd1a215c47e3c65a7b6ffd342bbb'],232,206,438,5183857,17,0.776785714,0.633928571,0.214285714,7197
7ebe11887f08751bc013fcdf58e74291b47183ef,0,Suresh Marru,2015-05-29 12:41:16-04:00,['4a06178022c0cd1a215c47e3c65a7b6ffd342bbb'],97,81,178,5184035,69,,,,7197
6a5ed6e96366cac6297afa6861218b69dca6afb8,0,Shameera Rathanyaka,2015-05-29 13:42:58-04:00,"['957fd5fc535f1f8b5a48cc3a888c2da174e4e5d8', '7ebe11887f08751bc013fcdf58e74291b47183ef']",97,81,178,5184213,69,,,,7197
154f0088543dc601e4948b19d6681bdcfe47be9b,1,Supun Nakandala,2015-05-30 01:42:02+05:18,['6a5ed6e96366cac6297afa6861218b69dca6afb8'],299,29,328,5184541,2,0.860927152,0.622516556,0.860927152,7197
9f9c2e0020aea228627173337b6ea2e849a4fe5f,0,Supun Nakandala,2015-05-30 02:11:41+05:18,['154f0088543dc601e4948b19d6681bdcfe47be9b'],9,10,19,5184560,2,0,1,1,7197
14fe107ce1fbe8cdf69e289a5fad00bc80b9316f,0,sahitya pavurala,2015-05-29 22:02:42-04:00,['6a5ed6e96366cac6297afa6861218b69dca6afb8'],2,3,5,5184565,1,,,,7197
a1ba91510e61dc4d04b1d1c8c2d29af00134787d,0,Shameera Rathanyaka,2015-05-30 11:41:57-04:00,['14fe107ce1fbe8cdf69e289a5fad00bc80b9316f'],32,24,56,5184621,2,1,0,0,7197
cd5ad247c60f9795d6ba32693ea6a35ef383f524,1,Supun Nakandala,2015-05-31 12:15:00+05:18,['9f9c2e0020aea228627173337b6ea2e849a4fe5f'],65,438,503,5185124,9,0.797101449,0.903381643,1,7199
0d32c22ba2c3c284f313be125efcdd85008e01fd,0,Supun Nakandala,2015-05-31 12:19:02+05:18,"['cd5ad247c60f9795d6ba32693ea6a35ef383f524', 'a1ba91510e61dc4d04b1d1c8c2d29af00134787d']",34,27,61,5185185,3,,,,7199
5b1ee03c620a004b13e473b1fb33dd73a01d18f7,1,Supun Nakandala,2015-05-31 14:24:09+05:18,['0d32c22ba2c3c284f313be125efcdd85008e01fd'],233,68,301,5185486,6,0,0,0,7199
7e67ca09e8d87c44163b8fc39f1deacfed9eb374,1,Supun Nakandala,2015-05-31 14:42:28+05:18,['5b1ee03c620a004b13e473b1fb33dd73a01d18f7'],7809,11034,18843,5204329,9,0.316218419,0.394865526,0.89405053,7199
7bc175fe3ca3e727d2930d6894d4ea0216c680ff,0,Supun Nakandala,2015-06-01 02:39:15+05:18,['7e67ca09e8d87c44163b8fc39f1deacfed9eb374'],835,657,1492,5205821,21,0.552631579,1,0,7199
8c420de55aa7254742f94a197509b6444455b665,0,Supun Nakandala,2015-06-01 03:18:37+05:18,['7bc175fe3ca3e727d2930d6894d4ea0216c680ff'],1,1,2,5205823,1,,,,7199
482176c64353a2ff0a05bf593fbd50a6bc51f412,0,Supun Nakandala,2015-06-01 04:13:07+05:18,['8c420de55aa7254742f94a197509b6444455b665'],0,74,74,5205897,1,0.25,0.25,1,7200
b67b53216651ed33d98f869e545bd3dbdde1f7a9,1,Supun Nakandala,2015-06-01 04:14:05+05:18,['482176c64353a2ff0a05bf593fbd50a6bc51f412'],2,2,4,5205901,1,,,,7200
4476dfc1e91df23461ade3a7e3e70d7633bce51c,1,Chathuri Wimalasena,2015-06-01 22:07:00-04:00,['b67b53216651ed33d98f869e545bd3dbdde1f7a9'],1005,1399,2404,5208305,64,1,1,1,7200
ebed3784806c7bfdbd37ea47466c7b6099504e30,0,Supun Nakandala,2015-06-02 14:00:03+05:18,['b67b53216651ed33d98f869e545bd3dbdde1f7a9'],1,0,1,5208306,1,1,1,0,7200
0c1ff519a03da0ae2125469eaedcd11009a8e6b4,0,Hasini Gunasinghe,2015-06-02 14:11:26+05:18,"['b67b53216651ed33d98f869e545bd3dbdde1f7a9', 'b62a56aa29c15e070b1efcc7e4f7e05d5309fc45']",35,1733,1768,5210074,34,,,,7200
85f613f8a2ed810a5fdf91514e3f9b6af19d1b4f,0,Hasini Gunasinghe,2015-06-02 14:35:30+05:18,"['4476dfc1e91df23461ade3a7e3e70d7633bce51c', '0c1ff519a03da0ae2125469eaedcd11009a8e6b4']",34,1732,1766,5211840,34,,,,7200
c8a70e9b40ff088df5b048d443979571aa775f2f,0,Supun Nakandala,2015-06-02 14:56:51+05:18,"['ebed3784806c7bfdbd37ea47466c7b6099504e30', '4476dfc1e91df23461ade3a7e3e70d7633bce51c']",1005,1399,2404,5214244,64,,,,7200
7e11e95c5b0105878df600907f66c8fb5d4ba59f,0,Hasini Gunasinghe,2015-06-02 16:51:48+05:18,"['c8a70e9b40ff088df5b048d443979571aa775f2f', '85f613f8a2ed810a5fdf91514e3f9b6af19d1b4f']",34,1732,1766,5216010,34,,,,7200
1149810ca460437831272bbeccab3688f5d0ec40,0,Hasini Gunasinghe,2015-06-02 17:10:15+05:18,['7e11e95c5b0105878df600907f66c8fb5d4ba59f'],27,0,27,5216037,1,,,,7200
512fa7e791fc88fe4ceb91e7e45cf2980f57c110,0,Supun Nakandala,2015-06-02 20:25:37+05:18,['1149810ca460437831272bbeccab3688f5d0ec40'],0,10,10,5216047,1,,,,7200
6a6657abd4b8b11985b820d20840ca2ea246f4b9,0,raminder,2015-06-02 14:02:12-04:00,['512fa7e791fc88fe4ceb91e7e45cf2980f57c110'],14,10,24,5216071,1,0,0,0,7200
f515c35790d46c073968ab9ab04ea81f6a2f73f5,0,Supun Nakandala,2015-06-03 01:30:39+05:18,['512fa7e791fc88fe4ceb91e7e45cf2980f57c110'],8,6,14,5216085,1,1,1,1,7200
7ab87e5319312e93b6308384dd54f6a352639065,0,Supun Nakandala,2015-06-03 01:31:44+05:18,['f515c35790d46c073968ab9ab04ea81f6a2f73f5'],31,202,233,5216318,10,0.304054054,0,0.959459459,7200
22bcbb40ccdd7b11cb31fd28050ea772c057a46a,0,Chathuri Wimalasena,2015-06-02 16:40:44-04:00,['6a6657abd4b8b11985b820d20840ca2ea246f4b9'],670,415,1085,5217403,145,,,,7201
22a76f8af745ccceedc371ac91dc354673c77b31,0,Supun Nakandala,2015-06-03 02:06:43+05:18,"['7ab87e5319312e93b6308384dd54f6a352639065', '22bcbb40ccdd7b11cb31fd28050ea772c057a46a']",684,425,1109,5218512,146,,,,7201
7c7bdaebf2eb82c3afce480fb75828a7e3d1dc16,0,Chathuri Wimalasena,2015-06-02 16:56:43-04:00,['22bcbb40ccdd7b11cb31fd28050ea772c057a46a'],6,8,14,5218526,1,1,1,1,7201
7c95cf757f3df3fa94767e25c8499d9f469d318c,0,Chathuri Wimalasena,2015-06-02 16:57:03-04:00,"['7c7bdaebf2eb82c3afce480fb75828a7e3d1dc16', '22a76f8af745ccceedc371ac91dc354673c77b31']",39,208,247,5218773,11,,,,7201
7463558e351f1a8d0756da659a29ca0002c1aacd,0,Shameera Rathanyaka,2015-06-02 21:06:54-04:00,['512fa7e791fc88fe4ceb91e7e45cf2980f57c110'],0,0,0,5218773,20,,,,7201
8d160a7af2e510afa8d7258d80d93f777b77a9a8,1,Shameera Rathanyaka,2015-06-03 00:29:49-04:00,['7463558e351f1a8d0756da659a29ca0002c1aacd'],8,8,16,5218789,20,,,,7201
82773c73b7fa2c5f74918575d976235daa7c4660,0,Shameera Rathanyaka,2015-06-03 00:46:02-04:00,['8d160a7af2e510afa8d7258d80d93f777b77a9a8'],18,18,36,5218825,29,,,,7201
7b809747658c5b5e5703540395884c580e8d1f8f,0,Shameera Rathanyaka,2015-06-03 14:14:00-04:00,['82773c73b7fa2c5f74918575d976235daa7c4660'],3717,6855,10572,5229397,295,0.387031408,0.508611955,0.791962175,7251
4d9ed53e3327166578acbe186d810e85f2638907,0,raminder,2015-06-03 16:59:20-04:00,['7c95cf757f3df3fa94767e25c8499d9f469d318c'],2,2,4,5229401,1,,,,7251
19afc7e0d90502f592f1c73aafbf17ae3f4648a1,0,Shameera Rathanyaka,2015-06-03 17:24:47-04:00,['7b809747658c5b5e5703540395884c580e8d1f8f'],358,9622,9980,5239381,104,0.970023221,0.969601013,0.971078742,7275
7814b55f393ec7c2260fd3e2389ae3de5f0675fe,0,Chathuri Wimalasena,2015-06-03 21:34:23-04:00,['4d9ed53e3327166578acbe186d810e85f2638907'],0,0,0,5239381,20,,,,7275
b58a02da302bf4e47cd6ab15ec76cfd355e5b922,0,Chathuri Wimalasena,2015-06-03 21:34:23-04:00,['7814b55f393ec7c2260fd3e2389ae3de5f0675fe'],8,8,16,5239397,20,,,,7275
061ea1072426ee539757ebe67104f0dcf1b6ea22,0,Chathuri Wimalasena,2015-06-03 21:34:24-04:00,['b58a02da302bf4e47cd6ab15ec76cfd355e5b922'],18,18,36,5239433,29,,,,7275
8c4ea1f0f53027c79eb4d54d08cbca2cea737ac1,0,Suresh Marru,2015-06-03 22:00:38-04:00,['19afc7e0d90502f592f1c73aafbf17ae3f4648a1'],27552,0,27552,5266985,106,0.933333333,0.622222222,0,7275
30f9d70adbd9ee7dd6f7d3eccbfca4baf19b09fa,0,Suresh Marru,2015-06-03 23:26:31-04:00,['8c4ea1f0f53027c79eb4d54d08cbca2cea737ac1'],82,0,82,5267067,1,,,,7275
33286af4e64d67cf96381084b92fbfb4978ed6d3,0,Chathuri Wimalasena,2015-06-04 09:52:30-04:00,['061ea1072426ee539757ebe67104f0dcf1b6ea22'],460,9663,10123,5277190,103,0.970023221,0.969601013,0.971078742,7299
de035284833cb0227aabb9dcb99edfc19b7f1c9a,0,Chathuri Wimalasena,2015-06-04 09:56:18-04:00,"['33286af4e64d67cf96381084b92fbfb4978ed6d3', '30f9d70adbd9ee7dd6f7d3eccbfca4baf19b09fa']",30957,8819,39776,5316966,402,,,,7299
29cd57fdf1d5a707e398cc2db11c55f37c7b30e8,0,Shameera Rathanyaka,2015-06-04 11:45:37-04:00,['30f9d70adbd9ee7dd6f7d3eccbfca4baf19b09fa'],3282,415,3697,5320663,10,0.283018868,0.130997305,0.032884097,7299
8e451b3145d9c3df975b7395665b1c7d98690aa6,1,Suresh Marru,2015-06-04 15:05:40-04:00,['29cd57fdf1d5a707e398cc2db11c55f37c7b30e8'],0,4714,4714,5325377,24,,,,7322
6eaaff4feae3a46d574ec59f04499e28c62c5c85,0,Suresh Marru,2015-06-04 15:06:51-04:00,['8e451b3145d9c3df975b7395665b1c7d98690aa6'],0,0,0,5325377,22,,,,7322
08e3a872330845b2391e413c0851558db2e246cd,0,Shameera Rathanyaka,2015-06-04 15:45:02-04:00,['6eaaff4feae3a46d574ec59f04499e28c62c5c85'],72,62,134,5325511,19,,,,7322
b4ede9cbec6089b32d0dc856cc57aea27616197b,0,Shameera Rathanyaka,2015-06-04 16:14:48-04:00,"['4d9ed53e3327166578acbe186d810e85f2638907', '08e3a872330845b2391e413c0851558db2e246cd']",29660,17069,46729,5372240,466,,,,7322
e34df6a686911e41587f4a872f570bd2cdb710ab,0,Chathuri Wimalasena,2015-06-04 16:23:36-04:00,"['de035284833cb0227aabb9dcb99edfc19b7f1c9a', '08e3a872330845b2391e413c0851558db2e246cd']",3319,5167,8486,5380726,50,,,,7322
ec8c6202a1f3e8f7f61ac8ae4dee3019a058169a,1,Chathuri Wimalasena,2015-06-04 16:33:08-04:00,['e34df6a686911e41587f4a872f570bd2cdb710ab'],1502,35569,37071,5417797,430,0.294561404,0.434429825,0.957105263,7454
2835d09ef16e218d7c2224bbebe2a13dd440d23d,0,Shameera Rathanyaka,2015-06-04 16:36:38-04:00,"['b4ede9cbec6089b32d0dc856cc57aea27616197b', 'ec8c6202a1f3e8f7f61ac8ae4dee3019a058169a']",1504,37865,39369,5457166,450,,,,7454
13c2e79e416d95cc04a8b0fabd8bac5df862cd87,0,Shameera Rathanyaka,2015-06-05 01:26:34-04:00,['2835d09ef16e218d7c2224bbebe2a13dd440d23d'],11338,0,11338,5468504,73,0.606405268,0.485184077,0.238551332,7454
5a648a60fb8d6f736406fea001cc73c4d500b060,1,Chathuri Wimalasena,2015-06-05 11:00:54-04:00,['ec8c6202a1f3e8f7f61ac8ae4dee3019a058169a'],35522,70,35592,5504096,191,0.70572231,0.565868001,0.042917325,7454
093643ac3e090faafb1620ed71fcbe47d548fd1a,0,Chathuri Wimalasena,2015-06-05 11:02:41-04:00,"['13c2e79e416d95cc04a8b0fabd8bac5df862cd87', '5a648a60fb8d6f736406fea001cc73c4d500b060']",35522,70,35592,5539688,191,,,,7454
4045c09473e11758e79aa2f02392181868017d94,1,Chathuri Wimalasena,2015-06-05 12:25:40-04:00,['093643ac3e090faafb1620ed71fcbe47d548fd1a'],2985,2237,5222,5544910,120,0,1,1,7454
2f3da0104f4c3d468b4a251a43249c39bce18c29,0,Shameera Rathanyaka,2015-06-05 12:30:59-04:00,['4045c09473e11758e79aa2f02392181868017d94'],103,93,196,5545106,55,,,,7454
bad2c1c0a60fa605defaa4c9e45665d2f91a722a,0,Shameera Rathanyaka,2015-06-05 14:53:35-04:00,['2f3da0104f4c3d468b4a251a43249c39bce18c29'],229,229,458,5545564,29,,,,7454
8ebff8604cba101ba72d93c9d83ade66e60441c9,1,Chathuri Wimalasena,2015-06-05 15:08:07-04:00,['bad2c1c0a60fa605defaa4c9e45665d2f91a722a'],1070,296,1366,5546930,70,1,1,0.8125,7455
b393df565a9ebb77d349f128e904dbdb69ed4f05,0,Chathuri Wimalasena,2015-06-05 15:15:00-04:00,['8ebff8604cba101ba72d93c9d83ade66e60441c9'],29,2,31,5546961,2,,,,7455
de8487878e90d5d16a89428c144a25f2b5c34a17,0,Shameera Rathanyaka,2015-06-05 15:20:38-04:00,['b393df565a9ebb77d349f128e904dbdb69ed4f05'],1373,5,1378,5548339,14,,,,7455
f8379196dfb119e184f78e8abfcfac71a4b7a447,0,Chathuri Wimalasena,2015-06-05 15:33:25-04:00,['b393df565a9ebb77d349f128e904dbdb69ed4f05'],19,10,29,5548368,6,,,,7455
1ba83f11f8bd0d5bda7bc1c6807e045774122a26,0,Chathuri Wimalasena,2015-06-05 15:33:35-04:00,"['f8379196dfb119e184f78e8abfcfac71a4b7a447', 'de8487878e90d5d16a89428c144a25f2b5c34a17']",1373,5,1378,5549746,14,,,,7455
144bb8f6d4ab1b7af305877c77ac8d6054473ae8,0,Shameera Rathanyaka,2015-06-08 11:42:43-04:00,['1ba83f11f8bd0d5bda7bc1c6807e045774122a26'],18,41,59,5549805,6,0,0,1,7455
63f6a53f6943e9c0bb101debebba8b97126a4744,1,Chathuri Wimalasena,2015-06-09 10:02:19-04:00,['144bb8f6d4ab1b7af305877c77ac8d6054473ae8'],61,1568,1629,5551434,15,0.156779661,0.391949153,1,7459
80a1dd315ad93ab23e07514b10b3b0cec7543db2,1,Chathuri Wimalasena,2015-06-09 11:13:18-04:00,['63f6a53f6943e9c0bb101debebba8b97126a4744'],7,7,14,5551448,6,0,1,1,7459
c75d4068519dde12d79978323220fa59e29e5c9f,1,Chathuri Wimalasena,2015-06-09 12:08:19-04:00,['80a1dd315ad93ab23e07514b10b3b0cec7543db2'],3,3,6,5551454,2,,,,7459
6c1eebe31cdf0e935604503a3c001512ad9bb0d9,1,Chathuri Wimalasena,2015-06-09 12:44:59-04:00,['c75d4068519dde12d79978323220fa59e29e5c9f'],6,7,13,5551467,37,,,,7459
ca297e36ad220881d99afef09a2c123beb00c7d5,0,Chathuri Wimalasena,2015-06-09 13:19:10-04:00,['6c1eebe31cdf0e935604503a3c001512ad9bb0d9'],0,44,44,5551511,1,,,,7460
3224e72a19c0b0ff1baddf37f9359dcf15e1a0a8,0,Suresh Marru,2015-06-09 17:39:14-04:00,['ca297e36ad220881d99afef09a2c123beb00c7d5'],5,0,5,5551516,1,,,,7460
2c6620f03f5d5ba9d7255f65156adffbe687ff18,1,Supun Nakandala,2015-06-10 22:11:17+05:18,['3224e72a19c0b0ff1baddf37f9359dcf15e1a0a8'],7548,10515,18063,5569579,10,0.375565611,0.440723982,0.932579186,7462
f742ebde120b1b8f5d5d9ab8eadf4073320754d7,0,Suresh Marru,2015-06-11 08:40:59-04:00,['2c6620f03f5d5ba9d7255f65156adffbe687ff18'],2128,2123,4251,5573830,21,,,,7462
314fa631867357c8d83a6dee343625a98037b824,0,Supun Nakandala,2015-06-11 20:13:58+05:18,['2c6620f03f5d5ba9d7255f65156adffbe687ff18'],5,1,6,5573836,1,,,,7462
6b1f4bd8fb74abf1cfdb3e63c351db050a3f5e03,0,Supun Nakandala,2015-06-11 20:14:48+05:18,"['314fa631867357c8d83a6dee343625a98037b824', 'f742ebde120b1b8f5d5d9ab8eadf4073320754d7']",2128,2123,4251,5578087,21,,,,7462
068c18b970fc8cd181610eae5dab75d9a51bf5d6,1,Suresh Marru,2015-06-11 12:48:14-04:00,['f742ebde120b1b8f5d5d9ab8eadf4073320754d7'],656,656,1312,5579399,19,,,,7463
a5cb91f0ff0d21717eac34407ae1c97ca78e7d87,1,Suresh Marru,2015-06-11 13:12:03-04:00,['068c18b970fc8cd181610eae5dab75d9a51bf5d6'],8146,31615,39761,5619160,139,0.194635686,0.24010327,0.977481354,7463
8d16d0ec5da700f1b576fbcc582e584978d43e60,1,Shameera Rathanyaka,2015-06-11 17:34:31-04:00,['a5cb91f0ff0d21717eac34407ae1c97ca78e7d87'],388,127,515,5619675,131,,,,7463
5a6b647032f487916a43e97ad8a73f59ddc8ca01,0,Shameera Rathanyaka,2015-06-11 21:07:11-04:00,['8d16d0ec5da700f1b576fbcc582e584978d43e60'],146,49,195,5619870,16,0,0,0,7464
95007241eb7e93075df7e4b1f1110334da39deab,0,Suresh Marru,2015-06-12 08:56:55-04:00,['5a6b647032f487916a43e97ad8a73f59ddc8ca01'],0,377,377,5620247,6,,,,7470
8a6b891d3289f46769f8b1cc1d8775d09a9f93bd,0,Suresh Marru,2015-06-12 09:54:55-04:00,['95007241eb7e93075df7e4b1f1110334da39deab'],6,7,13,5620260,1,,,,7470
8535ff1d24a228c793075b92cfdc7f08d6ab7bdb,0,Shameera Rathanyaka,2015-06-12 12:05:18-04:00,['95007241eb7e93075df7e4b1f1110334da39deab'],455,572,1027,5621287,43,1,1,0.517241379,7474
ce04fb92897c0a2535fcb4746e8ff327e946c19e,0,Supun Nakandala,2015-06-12 22:06:44+05:18,"['6b1f4bd8fb74abf1cfdb3e63c351db050a3f5e03', '8a6b891d3289f46769f8b1cc1d8775d09a9f93bd']",9336,32825,42161,5663448,296,,,,7474
2654de094e76a937643b2ea3ca9fff5efa88c50e,0,Shameera Rathanyaka,2015-06-12 14:40:34-04:00,['8535ff1d24a228c793075b92cfdc7f08d6ab7bdb'],1145,205,1350,5664798,13,0,0,0.51048951,7475
be5c037ec5f4d2c7058f13f9343745909dbe2b48,0,Shameera Rathanyaka,2015-06-12 14:40:39-04:00,"['2654de094e76a937643b2ea3ca9fff5efa88c50e', '8a6b891d3289f46769f8b1cc1d8775d09a9f93bd']",6,7,13,5664811,1,,,,7475
debeae018fde8dab0c1617a1d1a912090f0ccbec,0,Shameera Rathanyaka,2015-06-12 15:34:40-04:00,['be5c037ec5f4d2c7058f13f9343745909dbe2b48'],41,1,42,5664853,1,,,,7475
e76851d04f11c2863fb8ef227e2d3304790f938a,1,Shameera Rathanyaka,2015-06-12 17:36:14-04:00,['debeae018fde8dab0c1617a1d1a912090f0ccbec'],523,706,1229,5666082,18,,,,7482
fd26c2b3a3ed9134d78016d5089e3e09e3e3f2c6,0,Shameera Rathanyaka,2015-06-12 18:24:29-04:00,['e76851d04f11c2863fb8ef227e2d3304790f938a'],23,65,88,5666170,3,,,,7483
c4048835073b8d406620e6f95654dffacf8d2ce7,0,Shameera Rathanyaka,2015-06-12 18:42:23-04:00,['fd26c2b3a3ed9134d78016d5089e3e09e3e3f2c6'],3,2,5,5666175,2,,,,7483
51fa27b80779a7a96c61deb08528017134b9224f,1,Shameera Rathanyaka,2015-06-12 19:15:58-04:00,['c4048835073b8d406620e6f95654dffacf8d2ce7'],19678,8927,28605,5694780,103,0.610122578,0.55357849,0.005140372,7487
78732920e6ce559cc03e4fca626d682e2c8e48b7,0,Shameera Rathanyaka,2015-06-12 20:39:42-04:00,['51fa27b80779a7a96c61deb08528017134b9224f'],23,39,62,5694842,4,0.905940594,0.98019802,0.262376238,7487
8a0e6ce4439abece41e30522d635aafc7afaa10c,0,Supun Nakandala,2015-06-13 14:49:39+05:18,"['ce04fb92897c0a2535fcb4746e8ff327e946c19e', '78732920e6ce559cc03e4fca626d682e2c8e48b7']",21735,10361,32096,5726938,168,,,,7487
102fb044e5e6d4c318e69cfebdf033ad4c902da1,0,Shameera Rathanyaka,2015-06-13 19:23:17-04:00,['78732920e6ce559cc03e4fca626d682e2c8e48b7'],30,529,559,5727497,12,0.538011696,0.538011696,1,7494
c8bb9915c3b5d9f47c9b067536fcc65bf93b4d83,0,Shameera Rathanyaka,2015-06-15 10:44:48-04:00,['102fb044e5e6d4c318e69cfebdf033ad4c902da1'],101,461,562,5728059,64,0.2,0.212903226,1,7494
a90734a7c221f55ec627da907ad4be34c1b23eb3,0,Shameera Rathanyaka,2015-06-15 10:45:45-04:00,['c8bb9915c3b5d9f47c9b067536fcc65bf93b4d83'],1,1,2,5728061,1,,,,7494
62ad1c2c086f83997d95a1eebefbd4750f190762,0,Shameera Rathanyaka,2015-06-15 10:46:54-04:00,['a90734a7c221f55ec627da907ad4be34c1b23eb3'],1,4,5,5728066,1,,,,7494
59d2f2507647ec3cbd0f4a89f2fefc1efd33d077,0,Shameera Rathanyaka,2015-06-15 12:02:52-04:00,['62ad1c2c086f83997d95a1eebefbd4750f190762'],2,118,120,5728186,6,1,1,1,7495
0924a6e49ac01b585901398d0832a2f4febb5858,0,Shameera Rathanyaka,2015-06-15 13:35:41-04:00,['59d2f2507647ec3cbd0f4a89f2fefc1efd33d077'],5,128,133,5728319,6,1,1,0.926829268,7497
b00f20f257fc7f5d1063ddf2c3b7b8f4fa5e23f4,1,Chathuri Wimalasena,2015-06-15 14:34:06-04:00,['0924a6e49ac01b585901398d0832a2f4febb5858'],509,400,909,5729228,100,0.444444444,0.555555556,0.323232323,7497
5264b390efa2e1e50dc0e53a485e4287df0c8afa,1,Chathuri Wimalasena,2015-06-15 15:36:51-04:00,['b00f20f257fc7f5d1063ddf2c3b7b8f4fa5e23f4'],814,913,1727,5730955,13,0.519607843,0.100490196,0.166666667,7497
869df7ecd7a6f354236c656c90929e93e1c27bfe,1,Chathuri Wimalasena,2015-06-15 16:07:09-04:00,['5264b390efa2e1e50dc0e53a485e4287df0c8afa'],916,896,1812,5732767,3,1,0.612612613,0.09009009,7497
e6622078b2607cbfa7a6b3274ac470ce8d6fbd9a,0,Shameera Rathanyaka,2015-06-16 11:20:55-04:00,['869df7ecd7a6f354236c656c90929e93e1c27bfe'],408,1245,1653,5734420,21,0.408866995,0.583743842,0.354679803,7503
cb4b40ccb8f4bfb563d2b51d578ead64ecd65ba6,0,Shameera Rathanyaka,2015-06-16 14:30:00-04:00,['e6622078b2607cbfa7a6b3274ac470ce8d6fbd9a'],65,164,229,5734649,4,0.471544715,0.512195122,0.967479675,7503
92264537680af694a590462142d3aa371cffde24,0,Shameera Rathanyaka,2015-06-16 14:53:42-04:00,['cb4b40ccb8f4bfb563d2b51d578ead64ecd65ba6'],2231,8,2239,5736888,33,0.421580928,0.234629862,0.109159348,7503
d9b2df0336199e7641e1af5da5e0d2b4908bf4ac,0,Shameera Rathanyaka,2015-06-16 15:37:32-04:00,['92264537680af694a590462142d3aa371cffde24'],7557,124,7681,5744569,68,0.709067688,0.604086845,0.175989783,7503
a2b6bdfd99ebc27724b5cc97fd589055f6785d89,1,Chathuri Wimalasena,2015-06-16 16:02:58-04:00,['d9b2df0336199e7641e1af5da5e0d2b4908bf4ac'],323,713,1036,5745605,3,0.511904762,0,1,7504
754bc5c4e90dded69fe14233e5bad5dac5e7dbca,0,Shameera Rathanyaka,2015-06-16 16:05:47-04:00,['d9b2df0336199e7641e1af5da5e0d2b4908bf4ac'],73,41,114,5745719,6,0.045454545,0.045454545,0,7504
d05c0a1669fa704e13d299b9c0f879a3370a8d1e,0,Shameera Rathanyaka,2015-06-16 16:06:06-04:00,"['754bc5c4e90dded69fe14233e5bad5dac5e7dbca', 'a2b6bdfd99ebc27724b5cc97fd589055f6785d89']",323,713,1036,5746755,3,,,,7504
2bb805a02fdb4f39fe05d133963822b21648e359,1,Chathuri Wimalasena,2015-06-16 17:06:12-04:00,['d05c0a1669fa704e13d299b9c0f879a3370a8d1e'],240,319,559,5747314,4,0,0,1,7504
e2235afa9f520ef14e3a44c57c07b962a56e022c,0,Shameera Rathanyaka,2015-06-16 17:12:18-04:00,['d05c0a1669fa704e13d299b9c0f879a3370a8d1e'],352,154,506,5747820,8,0.587719298,0.614035088,0.421052632,7506
f6d34cc64fe034d7d6a01d8c3f71aa303b638a49,0,Shameera Rathanyaka,2015-06-16 17:12:34-04:00,"['e2235afa9f520ef14e3a44c57c07b962a56e022c', '2bb805a02fdb4f39fe05d133963822b21648e359']",239,319,558,5748378,3,,,,7506
f715697318e4127f1e158bfb33fe4dc1d00e3b94,0,Supun Nakandala,2015-06-17 19:00:57+05:18,"['8a0e6ce4439abece41e30522d635aafc7afaa10c', 'f6d34cc64fe034d7d6a01d8c3f71aa303b638a49']",13119,5710,18829,5767207,283,,,,7506
709eab9840bbdb22d3577155023d75a40fbb9c80,0,Supun Nakandala,2015-06-17 19:17:45+05:18,['f715697318e4127f1e158bfb33fe4dc1d00e3b94'],1,2,3,5767210,1,,,,7506
5d10a05d9115cfd2cb5cac51f88c58c476366a29,0,Shameera Rathanyaka,2015-06-17 10:45:42-04:00,['f6d34cc64fe034d7d6a01d8c3f71aa303b638a49'],1157,58,1215,5768425,4,0.784987277,0.669211196,0.278625954,7506
ae41a3a4debcc5fa872098bb48add888e92a6f8d,0,Shameera Rathanyaka,2015-06-17 12:00:33-04:00,['5d10a05d9115cfd2cb5cac51f88c58c476366a29'],11,9,20,5768445,2,0,0,0,7506
367ddca6b6dca807e1dfffea903b574ebf195c60,0,Shameera Rathanyaka,2015-06-17 15:03:59-04:00,['ae41a3a4debcc5fa872098bb48add888e92a6f8d'],0,62,62,5768507,2,1,1,1,7508
749ad9330369d0d0699331ce6e4c9a42df73ed21,0,Chathuri Wimalasena,2015-06-17 15:51:07-04:00,['367ddca6b6dca807e1dfffea903b574ebf195c60'],10,22,32,5768539,2,0.545454545,0.545454545,1,7508
ac3be7ae4f057876641fcf90725566b02bb1e312,0,Shameera Rathanyaka,2015-06-17 17:22:32-04:00,['749ad9330369d0d0699331ce6e4c9a42df73ed21'],97,72,169,5768708,3,0.226415094,0.20754717,0.301886792,7508
2d9ea1f4a1394bffb2f90f847c3d25ca32946e57,1,Chathuri Wimalasena,2015-06-18 11:24:41-04:00,['ac3be7ae4f057876641fcf90725566b02bb1e312'],45,116,161,5768869,5,0.341772152,0.556962025,0.784810127,7508
cc4286b211519963d1d4b7ba78095888ed913b78,1,Shameera Rathanyaka,2015-06-18 11:49:52-04:00,['ac3be7ae4f057876641fcf90725566b02bb1e312'],264,1904,2168,5771037,91,0.630484988,0.80369515,1,7511
a6c7a1f71fddf4d7f4462ed9172ecca20b6356e8,0,Shameera Rathanyaka,2015-06-18 12:00:40-04:00,"['cc4286b211519963d1d4b7ba78095888ed913b78', '2d9ea1f4a1394bffb2f90f847c3d25ca32946e57']",45,112,157,5771194,5,,,,7511
a1cffdb706c1c777fc91542331451435d6e249ed,1,Chathuri Wimalasena,2015-06-18 16:03:44-04:00,['a6c7a1f71fddf4d7f4462ed9172ecca20b6356e8'],30,257,287,5771481,7,0.284313725,0.284313725,1,7513
f366c38419ec63c19fa952abd3ea2cc4ebed8d2e,1,Supun Nakandala,2015-06-19 02:06:11+05:18,['709eab9840bbdb22d3577155023d75a40fbb9c80'],9849,6472,16321,5787802,93,0.568933824,0.400735294,0.052389706,7539
c3b4b0654bd5105449fe0a80d0cabca4e77fbf72,0,Supun Nakandala,2015-06-19 02:07:36+05:18,"['f366c38419ec63c19fa952abd3ea2cc4ebed8d2e', 'a1cffdb706c1c777fc91542331451435d6e249ed']",1702,2584,4286,5792088,108,,,,7539
a5039dc0c0afe65282846fd7bc2fcb590943bb56,1,Supun Nakandala,2015-06-19 17:46:03+05:18,['c3b4b0654bd5105449fe0a80d0cabca4e77fbf72'],579,360,939,5793027,2,,,,7539
3a00366696d4c7d85bf51eab204fe6c3728f5a5d,1,Supun Nakandala,2015-06-20 16:45:03+05:18,['a5039dc0c0afe65282846fd7bc2fcb590943bb56'],602,1317,1919,5794946,43,1,0.930612245,1,7549
066030bc53f00d3378655f0cda50ec5bfbf6c924,1,Supun Nakandala,2015-06-20 18:06:00+05:18,['3a00366696d4c7d85bf51eab204fe6c3728f5a5d'],124,373,497,5795443,23,0.457264957,0.457264957,1,7549
21de9e0521282428a1ed672248da6fecac7770b7,1,Supun Nakandala,2015-06-20 18:27:33+05:18,['066030bc53f00d3378655f0cda50ec5bfbf6c924'],591,128,719,5796162,10,0.857142857,0,0,7550
cb5d3aef069d7116f65a26e906bad3f567242615,1,Supun Nakandala,2015-06-21 02:19:16+05:18,['21de9e0521282428a1ed672248da6fecac7770b7'],2924,2724,5648,5801810,54,0.821888412,0.613197425,0.059012876,7550
7ca8104a11013e24a83ccc976980cd40394916b4,1,Supun Nakandala,2015-06-21 18:07:36+05:18,['cb5d3aef069d7116f65a26e906bad3f567242615'],418,497,915,5802725,3,0,0.686075949,0.979746835,7550
1968ff434e77e602efbde315b87718e3cd1fbd1d,1,Supun Nakandala,2015-06-21 21:14:06+05:18,['7ca8104a11013e24a83ccc976980cd40394916b4'],270,362,632,5803357,3,0.006289308,0.289308176,0.84591195,7550
bce94ae9379f937f1418500e22c50dd8540f8737,1,Supun Nakandala,2015-06-21 22:57:16+05:18,['1968ff434e77e602efbde315b87718e3cd1fbd1d'],979,346,1325,5804682,5,0.072368421,0.065789474,0.710526316,7550
fb30f5df438f7acff649b550955a2600df9c84f7,0,Supun Nakandala,2015-06-21 22:59:52+05:18,['bce94ae9379f937f1418500e22c50dd8540f8737'],24,105,129,5804811,3,0.076923077,0.076923077,0,7551
bf7db06539c8ca0ba10fd540a881af4e35396cc5,1,Supun Nakandala,2015-06-22 13:14:24+05:18,['fb30f5df438f7acff649b550955a2600df9c84f7'],52,53,105,5804916,2,0,0,1,7551
11a208bd17b1c1680dd7108b91cea4dc4cee3375,1,Supun Nakandala,2015-06-22 13:20:12+05:18,['bf7db06539c8ca0ba10fd540a881af4e35396cc5'],43,57,100,5805016,2,1,1,1,7551
99808c54d607e6ba1c530da03afffe08aec5904e,1,Supun Nakandala,2015-06-22 13:33:36+05:18,['11a208bd17b1c1680dd7108b91cea4dc4cee3375'],1132,68,1200,5806216,2,0,0,0.03030303,7551
f9032d4dd4ee32f9676e0474283ebce730a6e37c,0,Supun Nakandala,2015-06-22 13:40:33+05:18,['99808c54d607e6ba1c530da03afffe08aec5904e'],16,1,17,5806233,3,1,1,0,7551
8d6ba82da21eb9a83abfa8c3ae171fad518ff1f3,1,Supun Nakandala,2015-06-22 18:31:47+05:18,['f9032d4dd4ee32f9676e0474283ebce730a6e37c'],131,111,242,5806475,1,0,0,0,7551
65afe6f1c2da1c9e1cb084bbe0572cc9f3521b9b,1,Supun Nakandala,2015-06-22 18:38:46+05:18,['8d6ba82da21eb9a83abfa8c3ae171fad518ff1f3'],2,3,5,5806480,3,1,1,1,7551
0a90a404c6e813810c12d3f5303d9d8d257bb4d4,1,Supun Nakandala,2015-06-22 19:00:00+05:18,['65afe6f1c2da1c9e1cb084bbe0572cc9f3521b9b'],12,95,107,5806587,10,0.413793103,1,1,7552
c6cfa329000572b76335e0a23762f12d32cbb006,1,Supun Nakandala,2015-06-22 20:30:52+05:18,['0a90a404c6e813810c12d3f5303d9d8d257bb4d4'],9,12,21,5806608,6,,,,7552
4ee4b1a1ec726499d012b89ad76c4ffca3164e84,0,Chathuri Wimalasena,2015-06-22 11:35:56-04:00,['0a90a404c6e813810c12d3f5303d9d8d257bb4d4'],15,16,31,5806639,3,,,,7552
993f29a559bf45bb0f4c6a68493f93ba6d1178df,1,Supun Nakandala,2015-06-22 21:17:17+05:18,['c6cfa329000572b76335e0a23762f12d32cbb006'],370,688,1058,5807697,13,0.260586319,0.276872964,0.986970684,7552
56d132d2bccc2b79119cb2d827fa26c92299519c,0,Supun Nakandala,2015-06-22 21:18:00+05:18,"['993f29a559bf45bb0f4c6a68493f93ba6d1178df', '4ee4b1a1ec726499d012b89ad76c4ffca3164e84']",15,16,31,5807728,3,,,,7552
9ee0df7c1a2f7deac5cd6438a749034cdc4b9f51,1,Supun Nakandala,2015-06-22 21:24:32+05:18,['56d132d2bccc2b79119cb2d827fa26c92299519c'],4,6,10,5807738,1,0,0,1,7552
aec8f411d00666a00934c5a62edba7465deb3645,0,Chathuri Wimalasena,2015-06-23 12:03:56-04:00,['9ee0df7c1a2f7deac5cd6438a749034cdc4b9f51'],4608,3829,8437,5816175,92,1,1,0.115165336,7555
0dfd5a443152cf97417063842f61dbd38d270c26,0,Supun Nakandala,2015-06-23 22:09:19+05:18,['9ee0df7c1a2f7deac5cd6438a749034cdc4b9f51'],20,23,43,5816218,1,,,,7555
ed63a40af60cd2d918bc23df18c05a6862b97398,1,Supun Nakandala,2015-06-23 23:03:36+05:18,['0dfd5a443152cf97417063842f61dbd38d270c26'],4236,1593,5829,5822047,86,0.70052961,0.701492537,0.05151661,7555
9f2c08608419bb076ff82a05fbb43b91232b5911,0,Chathuri Wimalasena,2015-06-23 14:13:28-04:00,['aec8f411d00666a00934c5a62edba7465deb3645'],65,172,237,5822284,2,0.186813187,0.197802198,1,7555
e5d861e70187a645d3b9041df9206e97752b4e43,0,Chathuri Wimalasena,2015-06-23 16:49:14-04:00,['9f2c08608419bb076ff82a05fbb43b91232b5911'],607,860,1467,5823751,12,0,0,1,7555
ec1ba5a2bb9e2ef68d17034756bd5a0131b36402,1,Supun Nakandala,2015-06-24 02:18:50+05:18,['ed63a40af60cd2d918bc23df18c05a6862b97398'],15,1279,1294,5825045,19,0.489208633,0.638848921,0.974100719,7561
726370bdee8f67a54f2017c8f8feecabd8ff37ad,0,Shameera Rathanyaka,2015-06-23 17:31:30-04:00,['9f2c08608419bb076ff82a05fbb43b91232b5911'],116,224,340,5825385,10,0.146067416,0.573033708,0.752808989,7561
013e8c0905659ecb5170c29b81e698f1b999c1d7,0,Shameera Rathanyaka,2015-06-23 17:31:35-04:00,"['726370bdee8f67a54f2017c8f8feecabd8ff37ad', 'e5d861e70187a645d3b9041df9206e97752b4e43']",607,860,1467,5826852,12,,,,7561
144c1d8ecf467d7b8b8f4360e49a47f701911fb1,0,Supun Nakandala,2015-06-24 02:53:36+05:18,"['ec1ba5a2bb9e2ef68d17034756bd5a0131b36402', 'e5d861e70187a645d3b9041df9206e97752b4e43']",607,2435,3042,5829894,17,,,,7561
a2dce4f8c1a1cdc5f8a32bd8dd56a5dad0a35fcd,0,Supun Nakandala,2015-06-24 02:53:52+05:18,"['144c1d8ecf467d7b8b8f4360e49a47f701911fb1', '013e8c0905659ecb5170c29b81e698f1b999c1d7']",116,224,340,5830234,10,,,,7561
df3fbe6aa3d8f477bab3275e620d77bfb924bae0,1,Chathuri Wimalasena,2015-06-24 10:14:54-04:00,['a2dce4f8c1a1cdc5f8a32bd8dd56a5dad0a35fcd'],3468,3649,7117,5837351,24,0.778115502,0.696555218,0.022289767,7562
ab3223339fe39a15df9ab54387bc3830ec20114f,0,Chathuri Wimalasena,2015-06-24 11:19:01-04:00,['df3fbe6aa3d8f477bab3275e620d77bfb924bae0'],473,449,922,5838273,43,0.892857143,0.87012987,0.123376623,7562
67a467d338745b800f2894f7adb33ce234b1385c,0,Shameera Rathanyaka,2015-06-24 11:45:20-04:00,['ab3223339fe39a15df9ab54387bc3830ec20114f'],0,1,1,5838274,1,,,,7562
996c79d41a782aace00eb1f294567f2add6887b4,0,Shameera Rathanyaka,2015-06-24 12:03:53-04:00,['67a467d338745b800f2894f7adb33ce234b1385c'],31,11,42,5838316,3,,,,7562
4b899ba84d9d26c0547b52aae60263a1ea3b886d,0,Shameera Rathanyaka,2015-06-24 12:04:41-04:00,['996c79d41a782aace00eb1f294567f2add6887b4'],54,58,112,5838428,1,1,1,1,7562
79d01354bb2a7dec281c8db0a131256490e9014d,0,Shameera Rathanyaka,2015-06-24 12:18:50-04:00,['4b899ba84d9d26c0547b52aae60263a1ea3b886d'],78,102,180,5838608,73,0,0,1,7562
adab9dda6961787a889e7f4e5622241a85ff683f,0,Shameera Rathanyaka,2015-06-24 12:25:39-04:00,['79d01354bb2a7dec281c8db0a131256490e9014d'],40,40,80,5838688,3,,,,7562
a393b735e4a03bf3b663c31c7429a7ea19f2b708,0,Shameera Rathanyaka,2015-06-24 12:58:07-04:00,['adab9dda6961787a889e7f4e5622241a85ff683f'],2,51,53,5838741,2,0,0,1,7562
636a733bffd536f96b31bfd8be4917426d4d3eeb,1,Chathuri Wimalasena,2015-06-24 17:01:50-04:00,['a393b735e4a03bf3b663c31c7429a7ea19f2b708'],491,1008,1499,5840240,14,0.334500876,0.432574431,1,7562
aa2fab54be0eae061769c4aca751ae50594bbc38,1,Supun Nakandala,2015-06-25 20:36:37+05:18,['a2dce4f8c1a1cdc5f8a32bd8dd56a5dad0a35fcd'],29,171,200,5840440,16,0.506849315,0.712328767,1,7563
f200d50be55bd435e367494482d67881f4f19f51,0,Supun Nakandala,2015-06-25 20:43:13+05:18,"['aa2fab54be0eae061769c4aca751ae50594bbc38', '636a733bffd536f96b31bfd8be4917426d4d3eeb']",4389,5121,9510,5849950,151,,,,7563
ed5a17203772152344a9de1540b39329b2b995e2,0,Chathuri Wimalasena,2015-06-25 13:31:40-04:00,['f200d50be55bd435e367494482d67881f4f19f51'],1656,1368,3024,5852974,93,0.9375,0.270833333,0.125,7564
dce0271e57815950d8e643e2eaa8d1e378f8eec2,1,Supun Nakandala,2015-06-26 01:57:16+05:18,['ed5a17203772152344a9de1540b39329b2b995e2'],0,158,158,5853132,8,0.47,0.73,1,7564
6caf4787132b8c2108773d629a8d8f5f1334e85a,1,Supun Nakandala,2015-06-26 03:01:35+05:18,['dce0271e57815950d8e643e2eaa8d1e378f8eec2'],81,164,245,5853377,7,0,1,1,7564
455b435018fca0daf73c7df6becf449a428129a8,0,Shameera Rathanyaka,2015-06-25 19:07:26-04:00,['a393b735e4a03bf3b663c31c7429a7ea19f2b708'],131,147,278,5853655,72,0.466666667,0.466666667,1,7564
7f4f1826c46b79267e27b3b57f941656863ac1f6,1,Shameera Rathanyaka,2015-06-26 00:20:08-04:00,['455b435018fca0daf73c7df6becf449a428129a8'],32,81,113,5853768,13,0.518518519,0,1,7564
2c94277151a25e4000d929684f3de0c3e33cd34c,0,Shameera Rathanyaka,2015-06-26 00:27:13-04:00,"['7f4f1826c46b79267e27b3b57f941656863ac1f6', '6caf4787132b8c2108773d629a8d8f5f1334e85a']",2149,2761,4910,5858678,54,,,,7564
525e9e4b92d52a3d149ce4fa2ffb315b7fe4854e,0,Shameera Rathanyaka,2015-06-26 12:07:01-04:00,['2c94277151a25e4000d929684f3de0c3e33cd34c'],10,10,20,5858698,1,,,,7564
20db90fc293dc56eb36c808d77a8f31bdbf7fff4,0,Chathuri Wimalasena,2015-06-26 12:43:42-04:00,['525e9e4b92d52a3d149ce4fa2ffb315b7fe4854e'],53,0,53,5858751,2,0,0,0,7564
80589baad371bd9b3456bd6da7e30cecc1cd74a0,0,Chathuri Wimalasena,2015-06-26 15:02:22-04:00,['20db90fc293dc56eb36c808d77a8f31bdbf7fff4'],289,11,300,5859051,8,0,0,0,7564
f1d49fb584422861d54248c100f8a5108dce69f4,1,Chathuri Wimalasena,2015-07-02 14:09:14-04:00,['80589baad371bd9b3456bd6da7e30cecc1cd74a0'],16,15,31,5859082,2,,,,7564
aecf79475f247daaf37b847ec0a958267c9cb39c,0,Chathuri Wimalasena,2015-07-02 14:28:49-04:00,['f1d49fb584422861d54248c100f8a5108dce69f4'],9,3,12,5859094,2,0,0,0,7564
48e23d9c94b896d1a5bbfefa51b77d702c203cb0,0,Shameera Rathanyaka,2015-07-02 16:17:17-04:00,['525e9e4b92d52a3d149ce4fa2ffb315b7fe4854e'],9,7,16,5859110,1,1,0,0,7564
953feec6bbbfcb2556ab207e1dbf93293e297b20,0,Shameera Rathanyaka,2015-07-02 16:17:31-04:00,"['48e23d9c94b896d1a5bbfefa51b77d702c203cb0', 'aecf79475f247daaf37b847ec0a958267c9cb39c']",367,29,396,5859506,13,,,,7564
2dee81be62b625503afff881b1c11e4612379f45,1,Supun Nakandala,2015-07-03 17:06:57+05:18,['953feec6bbbfcb2556ab207e1dbf93293e297b20'],48,65,113,5859619,12,,,,7564
cc792369ecd4c7b3d1a572127ed470dbaed5fe81,0,Chathuri Wimalasena,2015-07-06 10:51:14-04:00,['2dee81be62b625503afff881b1c11e4612379f45'],95,103,198,5859817,79,0.2,0.8,0.6,7564
624b5c675d0d8ec68706c15f9a7e393e998aa1d1,0,Shameera Rathanyaka,2015-07-06 11:02:48-04:00,['2dee81be62b625503afff881b1c11e4612379f45'],155,185,340,5860157,75,0.086956522,0.173913043,0.913043478,7564
1d27a9c75e1637bca8b2a1495450e66877b35c8f,0,Shameera Rathanyaka,2015-07-06 11:10:28-04:00,"['624b5c675d0d8ec68706c15f9a7e393e998aa1d1', 'cc792369ecd4c7b3d1a572127ed470dbaed5fe81']",13,11,24,5860181,7,,,,7564
82e60f39cdffd691a4a4afb7752ba870a0034a6d,1,Chathuri Wimalasena,2015-07-06 11:20:32-04:00,['cc792369ecd4c7b3d1a572127ed470dbaed5fe81'],157,163,320,5860501,20,1,1,1,7564
343ea0aa316ce19966c1181b0d81c049ad90d944,0,Chathuri Wimalasena,2015-07-06 11:20:51-04:00,"['82e60f39cdffd691a4a4afb7752ba870a0034a6d', '1d27a9c75e1637bca8b2a1495450e66877b35c8f']",84,104,188,5860689,5,,,,7564
debde7aa46aa58db0563810d4d9befa4da55bd48,0,Shameera Rathanyaka,2015-07-06 11:23:47-04:00,['1d27a9c75e1637bca8b2a1495450e66877b35c8f'],15,24,39,5860728,3,0,1,1,7564
db94c558d5aaaf5722cd588f9c058f9f6f54e787,0,Shameera Rathanyaka,2015-07-06 11:23:53-04:00,"['debde7aa46aa58db0563810d4d9befa4da55bd48', '343ea0aa316ce19966c1181b0d81c049ad90d944']",157,163,320,5861048,20,,,,7564
d4ec47ecd86404b30eabaa0e181c4d13a7493cd8,0,Chathuri Wimalasena,2015-07-06 11:38:32-04:00,['db94c558d5aaaf5722cd588f9c058f9f6f54e787'],1,1,2,5861050,1,,,,7564
b5b522ba4fd07456863538dda35d4e7ce5bf50a2,1,Chathuri Wimalasena,2015-07-06 13:05:32-04:00,['d4ec47ecd86404b30eabaa0e181c4d13a7493cd8'],11,37,48,5861098,4,0,1,1,7564
1bc3ce8b7010395648d27227a5d1a0756e85c434,1,Chathuri Wimalasena,2015-07-06 16:10:46-04:00,['b5b522ba4fd07456863538dda35d4e7ce5bf50a2'],19,32,51,5861149,5,0,0.7,1,7564
51befd7ccce9828ba72563080b9c27d2176a3405,0,Shameera Rathanyaka,2015-07-06 16:44:53-04:00,['1bc3ce8b7010395648d27227a5d1a0756e85c434'],1,1,2,5861151,1,,,,7564
25a38953744659d01bec37b69ff4ccead34fb97d,0,Shameera Rathanyaka,2015-07-07 15:18:11-04:00,['51befd7ccce9828ba72563080b9c27d2176a3405'],16,17,33,5861184,6,0.333333333,0,1,7564
23466997d451f2e862a8cc5fa3db055e5b2128af,0,Shameera Rathanyaka,2015-07-07 15:38:59-04:00,['25a38953744659d01bec37b69ff4ccead34fb97d'],2,13,15,5861199,1,0.888888889,0.888888889,1,7564
e105f941369624ca3da6936d60303084deb9c67d,0,Shameera Rathanyaka,2015-07-07 15:50:47-04:00,['23466997d451f2e862a8cc5fa3db055e5b2128af'],1,1,2,5861201,1,,,,7564
ab0bf86c59da550873b7fc18f990042f221e3f35,1,hasinitg,2015-07-08 18:31:27+05:18,['e105f941369624ca3da6936d60303084deb9c67d'],233,548,781,5861982,25,0.126760563,0,1,7568
d88488a9a60d4e42d043c3e09690e47d7ca540f1,0,Shameera Rathanyaka,2015-07-08 12:09:29-04:00,['ab0bf86c59da550873b7fc18f990042f221e3f35'],19,62,81,5862063,4,0.862068966,1,1,7568
b7cee3e0b82f3539c9f70051b8162bbb5713e142,0,Shameera Rathanyaka,2015-07-08 12:24:22-04:00,['d88488a9a60d4e42d043c3e09690e47d7ca540f1'],129,80,209,5862272,3,,,,7569
e060b47e8ec25771b338646c0df0c36d38565246,0,Shameera Rathanyaka,2015-07-08 13:47:06-04:00,['b7cee3e0b82f3539c9f70051b8162bbb5713e142'],4,5,9,5862281,1,1,1,1,7569
c4c03f3fb917e2833a1f8c54287c019d278ecc39,0,Shameera Rathanyaka,2015-07-08 14:01:51-04:00,['e060b47e8ec25771b338646c0df0c36d38565246'],26,31,57,5862338,1,0,0,1,7569
eaf941ae4112da96a5a15ed2dfa076de4002ea2d,0,Shameera Rathanyaka,2015-07-08 16:29:44-04:00,['c4c03f3fb917e2833a1f8c54287c019d278ecc39'],65,144,209,5862547,5,0.1,0.64,1,7569
c857f82476253128b498a0e310ed8e6553be826a,1,Shameera Rathanyaka,2015-07-09 15:38:22-04:00,['eaf941ae4112da96a5a15ed2dfa076de4002ea2d'],21,18,39,5862586,1,1,0,0,7569
8225ab5563c5203eb6028074c64bc4e358d0d7b1,0,Shameera Rathanyaka,2015-07-09 15:39:20-04:00,['c857f82476253128b498a0e310ed8e6553be826a'],50,252,302,5862888,14,0.52027027,0.743243243,0.993243243,7569
1f09dc278ea3c4d98081c047ef0e4a223d36aac7,1,Shameera Rathanyaka,2015-07-09 17:02:56-04:00,['8225ab5563c5203eb6028074c64bc4e358d0d7b1'],2,2,4,5862892,2,,,,7569
96480424db6b5ecb95e635a2d03fa9361be096de,0,Shameera Rathanyaka,2015-07-09 17:06:06-04:00,['1f09dc278ea3c4d98081c047ef0e4a223d36aac7'],72,92,164,5863056,3,0.684210526,1,0.631578947,7569
5413826005c7d28e302633d1ceaa67b5d359ff1f,0,Chathuri Wimalasena,2015-07-10 10:54:44-04:00,['96480424db6b5ecb95e635a2d03fa9361be096de'],1,5,6,5863062,1,0.25,1,0.75,7569
aa86a7e6ebd90952116698cb1455feece24ade73,1,Shameera Rathanyaka,2015-07-10 11:57:29-04:00,['5413826005c7d28e302633d1ceaa67b5d359ff1f'],76,78,154,5863216,9,0.4,0.1,0,7569
e0aa71735a1de1f7f9e6d42910b860e3146fa694,0,Shameera Rathanyaka,2015-07-10 16:14:31-04:00,['aa86a7e6ebd90952116698cb1455feece24ade73'],9,12,21,5863237,1,0,1,0.666666667,7569
01d46f4fc0321de66b2eb6524399820508a0a4f4,1,Shameera Rathanyaka,2015-07-10 16:15:27-04:00,['e0aa71735a1de1f7f9e6d42910b860e3146fa694'],22,10,32,5863269,3,0,0,0,7569
551c378755130f6888aa577c0d42c74d04168bbb,0,Shameera Rathanyaka,2015-07-10 16:16:30-04:00,['01d46f4fc0321de66b2eb6524399820508a0a4f4'],7,8,15,5863284,1,,,,7569
abc42f690b5b833fff4b36c590bbe8a4ec26a213,1,Shameera Rathanyaka,2015-07-10 16:17:02-04:00,['551c378755130f6888aa577c0d42c74d04168bbb'],0,4,4,5863288,1,0,0,1,7569
cce7be71e9fe6b9902ccd000744f416c479c1cf6,0,Shameera Rathanyaka,2015-07-14 10:49:12-04:00,['abc42f690b5b833fff4b36c590bbe8a4ec26a213'],4,4,8,5863296,4,,,,7569
706edf8465ced1280e0940f5b73fa027958cd369,0,Shameera Rathanyaka,2015-07-14 10:51:57-04:00,['cce7be71e9fe6b9902ccd000744f416c479c1cf6'],29,84,113,5863409,5,0,0.25,0.65,7570
4c7dcc0a6c18ce6d4d78d885243176a41fb72cfa,1,Shameera Rathanyaka,2015-07-14 10:54:13-04:00,['706edf8465ced1280e0940f5b73fa027958cd369'],24,85,109,5863518,4,0,1,0.916666667,7570
4568832b31db5977e2674e05bad37f447fdf0e3b,0,Chathuri Wimalasena,2015-07-14 11:19:54-04:00,['4c7dcc0a6c18ce6d4d78d885243176a41fb72cfa'],647,97,744,5864262,85,,,,7570
dc5244905d8585c4f750e78b04d8dce5670a968f,1,hasinitg,2015-07-14 23:42:32+05:18,['4568832b31db5977e2674e05bad37f447fdf0e3b'],265,30460,30725,5894987,143,0.312975152,0.350834226,0.981478647,7683
e0941f4ba3df1711f7acc29af16365d1e8f490ae,0,hasinitg,2015-07-15 10:28:16+05:18,['dc5244905d8585c4f750e78b04d8dce5670a968f'],387,1974,2361,5897348,81,0.105185185,0,0.876296296,7683
e290cfe17a5c4f6f0422f1830067637cb81b0494,1,Shameera Rathanyaka,2015-07-15 18:01:23-04:00,['4568832b31db5977e2674e05bad37f447fdf0e3b'],200,414,614,5897962,12,0.640776699,0.54368932,0.786407767,7684
b7e914ee3c4c90b77676bd2c217bec3b3183dc76,1,Shameera Rathanyaka,2015-07-16 15:57:12-04:00,['e290cfe17a5c4f6f0422f1830067637cb81b0494'],239,413,652,5898614,16,0.517857143,0.803571429,1,7684
4fae741d6e8c98e8f7978850c9cbd5f21418a355,1,hasinitg,2015-07-17 01:33:36+05:18,['e0941f4ba3df1711f7acc29af16365d1e8f490ae'],1802,1117,2919,5901533,83,0.945355191,1,0,7687
b515beeb1844b45867e573cfe9d064e42f918e30,0,hasinitg,2015-07-17 01:45:03+05:18,"['b7e914ee3c4c90b77676bd2c217bec3b3183dc76', '4fae741d6e8c98e8f7978850c9cbd5f21418a355']",759,31856,32615,5934148,218,,,,7687
283e700d3088e0425c509895704ff76ac80c93fe,1,hasinitg,2015-07-17 19:30:19+05:18,['b515beeb1844b45867e573cfe9d064e42f918e30'],439,840,1279,5935427,2,0,0.68,0,7687
4579e1e17aebf09ad375f8bc54f067ccf9f5da6a,1,John Weachock,2015-07-17 15:05:53-04:00,['b7e914ee3c4c90b77676bd2c217bec3b3183dc76'],1,5,6,5935433,1,,,,7687
57164c7a9135b71be79befb0abe0747dcc75dcd6,0,Shameera Rathanyaka,2015-07-18 15:35:24-04:00,['b7e914ee3c4c90b77676bd2c217bec3b3183dc76'],10679,5003,15682,5951115,20,0.657480315,0.453937008,0,7696
7be309d7ffbbcb012573ecb8a44ebb7db077950f,1,hasinitg,2015-07-19 20:58:43+05:18,['283e700d3088e0425c509895704ff76ac80c93fe'],8740,50561,59301,6010416,16,0.026435403,0,0.854187,7696
43fd3d7ff8d8f61bb6a84a68b5bf8e83ff836f2b,0,hasinitg,2015-07-19 21:02:36+05:18,"['57164c7a9135b71be79befb0abe0747dcc75dcd6', '7be309d7ffbbcb012573ecb8a44ebb7db077950f']",9962,78319,88281,6098697,207,,,,7696
7211c2f7083ff81c79ca0d933b4c8ca18049daa5,1,Shameera Rathanyaka,2015-07-20 23:06:51-04:00,['57164c7a9135b71be79befb0abe0747dcc75dcd6'],1,1,2,6098699,1,,,,7696
796fc3da40b4027e49b2d892f199b6e29c990896,0,Suresh Marru,2015-07-21 00:41:09-04:00,"['43fd3d7ff8d8f61bb6a84a68b5bf8e83ff836f2b', '7211c2f7083ff81c79ca0d933b4c8ca18049daa5']",1,1,2,6098701,1,,,,7696
075e390c00a78d08f171cc14ca005ba441e68431,0,Suresh Marru,2015-07-21 00:44:15-04:00,"['4579e1e17aebf09ad375f8bc54f067ccf9f5da6a', '796fc3da40b4027e49b2d892f199b6e29c990896']",20642,83323,103965,6202666,228,,,,7696
1f7b55d2cb7b6eab569d398d519cecf0467920ef,0,hasinitg,2015-07-24 20:59:17+05:18,['075e390c00a78d08f171cc14ca005ba441e68431'],24,25,49,6202715,1,,,,7696
44fb3b18c6b861f67b3518df9c4f0e6a9075c960,0,Supun Nakandala,2015-07-29 23:29:54+05:18,['075e390c00a78d08f171cc14ca005ba441e68431'],4,8,12,6202727,1,,,,7696
67839c0f59613c4512835240eef449196bcf0c5f,0,Supun Nakandala,2015-07-29 23:30:27+05:18,['44fb3b18c6b861f67b3518df9c4f0e6a9075c960'],221,1109,1330,6204057,75,0.123015873,0.201058201,0.986772487,7696
6ec2a39e51999d1a1f2e6f9288926aa362d32851,0,hasinitg,2015-07-30 16:45:18+05:18,['67839c0f59613c4512835240eef449196bcf0c5f'],0,44,44,6204101,1,1,1,1,7697
7ef83689624cf135234976b4abb2d3fd7b43499b,0,hasinitg,2015-07-31 17:01:46+05:18,['6ec2a39e51999d1a1f2e6f9288926aa362d32851'],7,15,22,6204123,3,1,1,1,7697
86eac5d929eeb9dbbeb09be02e46054f69083c3c,0,Shameera Rathanyaka,2015-07-31 13:20:10-04:00,['67839c0f59613c4512835240eef449196bcf0c5f'],2,319,321,6204444,3,0.362162162,0.518918919,0.918918919,7698
b103e6fbd61c8b18bafa292b3af4fce2db25f37e,0,Shameera Rathanyaka,2015-07-31 13:35:27-04:00,['86eac5d929eeb9dbbeb09be02e46054f69083c3c'],12,23,35,6204479,1,,,,7698
9c02f24d99c139b7dcc38b6fcddd17dd935c8e73,0,hasinitg,2015-08-01 01:07:34+05:18,['7ef83689624cf135234976b4abb2d3fd7b43499b'],54,211,265,6204744,8,0.837837838,0.486486486,0.702702703,7700
7ae9cc387de6929c1a5198fa5aeac5a7f072e727,0,Shameera Rathanyaka,2015-07-31 19:41:04-04:00,['b103e6fbd61c8b18bafa292b3af4fce2db25f37e'],4,4,8,6204752,2,,,,7700
673fbf3b40dda4391a33e7a639d3e13e312c865c,0,Shameera Rathanyaka,2015-07-31 20:04:12-04:00,['7ae9cc387de6929c1a5198fa5aeac5a7f072e727'],1,2,3,6204755,1,1,1,1,7700
1ef5bc33d6959472a10ee184e121bfd0d703d44e,0,Shameera Rathanyaka,2015-07-31 21:10:48-04:00,['673fbf3b40dda4391a33e7a639d3e13e312c865c'],4,4,8,6204763,1,,,,7700
d3ac7ceb611b3ed853e828c8492927020aacc72a,0,hasinitg,2015-08-01 15:49:13+05:18,['9c02f24d99c139b7dcc38b6fcddd17dd935c8e73'],21,79,100,6204863,6,0,0.714285714,1,7700
4226a2db00aec8ba0abb84e722bcb9767f0c96fa,0,hasinitg,2015-08-01 20:44:51+05:18,['d3ac7ceb611b3ed853e828c8492927020aacc72a'],10,43,53,6204916,3,0,0.913043478,1,7700
2e815ecdc367c2fbe8fba299051109bdaced1210,0,Supun Nakandala,2015-08-01 22:41:05+05:18,"['1ef5bc33d6959472a10ee184e121bfd0d703d44e', '1f7b55d2cb7b6eab569d398d519cecf0467920ef']",24,25,49,6204965,1,,,,7700
c3174f2028f7292e402ac686dbdc3065c426a69a,0,Supun Nakandala,2015-08-01 22:46:02+05:18,['2e815ecdc367c2fbe8fba299051109bdaced1210'],105,0,105,6205070,1,,,,7700
64a49b9ed26ecc9c81d555f518fcfb48480ec117,1,Supun Nakandala,2015-08-02 00:49:32+05:18,['c3174f2028f7292e402ac686dbdc3065c426a69a'],223,417,640,6205710,85,0.193877551,0.096938776,0.801020408,7700
50e04f135b201c5f14c7a8bb909e63ff76475e76,1,Supun Nakandala,2015-08-02 01:33:06+05:18,['64a49b9ed26ecc9c81d555f518fcfb48480ec117'],857,11,868,6206578,8,0,1,1,7700
053bb9f223b60e4cedcb5cca49e61811dda758d7,1,Supun Nakandala,2015-08-02 23:29:18+05:18,['50e04f135b201c5f14c7a8bb909e63ff76475e76'],4,2,6,6206584,2,,,,7700
bd97f809ccf457ff3aa284016970ea85396a6430,1,Supun Nakandala,2015-08-03 00:23:28+05:18,['053bb9f223b60e4cedcb5cca49e61811dda758d7'],0,1,1,6206585,1,0,1,1,7700
dc61c676067c8a08b8ddccf314fda3e9435089c0,1,Supun Nakandala,2015-08-03 01:48:10+05:18,['bd97f809ccf457ff3aa284016970ea85396a6430'],39549,11247,50796,6257381,84,0.652322571,0.59019196,0.087774142,7700
eb4a737c5150ae7313d4038808ddce8d1564abd1,1,Supun Nakandala,2015-08-03 01:54:37+05:18,['dc61c676067c8a08b8ddccf314fda3e9435089c0'],166,731,897,6258278,9,0.048523207,0.103375527,0.691983122,7700
f903d601405a2ba8182d864437fd4a2c97a4b74a,0,Shameera Rathanyaka,2015-08-03 15:38:36-04:00,['eb4a737c5150ae7313d4038808ddce8d1564abd1'],51,354,405,6258683,11,0.305936073,0.356164384,0.97716895,7701
a68eb18235b9f41069ad7801b4103fe8a6444b3b,1,Shameera Rathanyaka,2015-08-03 20:33:52-04:00,['f903d601405a2ba8182d864437fd4a2c97a4b74a'],5,17,22,6258705,3,0,0,1,7701
0fbb6a84d8818a5259759f8ba8a6d3048ac3ca0a,1,Shameera Rathanyaka,2015-08-04 16:40:11-04:00,['a68eb18235b9f41069ad7801b4103fe8a6444b3b'],131,80,211,6258916,6,0.136363636,0,1,7701
51332d3d6116bb9155be4e288a8b181121f8c608,0,Shameera Rathanyaka,2015-08-04 16:44:33-04:00,['0fbb6a84d8818a5259759f8ba8a6d3048ac3ca0a'],1,0,1,6258917,1,,,,7701
c3652607aff77da6dc4dd6ab039ada78aa836c79,0,hasinitg,2015-08-05 13:52:41+05:18,['4226a2db00aec8ba0abb84e722bcb9767f0c96fa'],3,113,116,6259033,2,0,0,1,7701
59f4acda5c600cb7c11a645fba1bacb4bad27e16,0,hasinitg,2015-08-08 01:09:08+05:18,['c3652607aff77da6dc4dd6ab039ada78aa836c79'],5,219,224,6259257,10,0.234782609,0.234782609,0.895652174,7702
4f6e8c5e61915e92384059919d24abb9e837a6ff,0,Shameera Rathanyaka,2015-08-15 13:58:57-04:00,['51332d3d6116bb9155be4e288a8b181121f8c608'],4,4,8,6259265,1,,,,7702
27774766f502f2e62c288c5bce0f8980926a7741,0,hasinitg,2015-08-16 09:39:56-04:00,['59f4acda5c600cb7c11a645fba1bacb4bad27e16'],211,260,471,6259736,15,1,0,1,7704
f080ac263c6cd1c1df98dcfbd5f3366f0734fb44,1,hasinitg,2015-08-16 23:44:51-04:00,['27774766f502f2e62c288c5bce0f8980926a7741'],3,523,526,6260262,9,0.558375635,1,0.893401015,7710
36922c9fcf4b1af517e18389e1657007d06b7a0e,0,hasinitg,2015-08-16 23:56:54-04:00,"['4f6e8c5e61915e92384059919d24abb9e837a6ff', 'f080ac263c6cd1c1df98dcfbd5f3366f0734fb44']",118,1314,1432,6261694,26,,,,7710
92243599278db75e56f19da2b4d03d7f029ce17f,1,Shameera Rathanyaka,2015-08-18 11:35:46-04:00,['4f6e8c5e61915e92384059919d24abb9e837a6ff'],64,333,397,6262091,14,0.421428571,0.442857143,0.935714286,7713
decad8c49ea6c1f0f94da1fa904762da24c8336b,0,Shameera Rathanyaka,2015-08-20 10:20:41-04:00,['92243599278db75e56f19da2b4d03d7f029ce17f'],154,322,476,6262567,76,0.167832168,0.160839161,0.979020979,7713
bf56b43e1e6472be5ea99158ca4e429a7062311e,0,Shameera Rathanyaka,2015-08-20 10:20:55-04:00,"['decad8c49ea6c1f0f94da1fa904762da24c8336b', '36922c9fcf4b1af517e18389e1657007d06b7a0e']",118,1314,1432,6263999,26,,,,7713
b98f65997304eded6ee59f82dd236efc6b2fe091,1,Shameera Rathanyaka,2015-08-21 11:34:45-04:00,['bf56b43e1e6472be5ea99158ca4e429a7062311e'],182,262,444,6264443,18,1,0.533333333,0.883333333,7713
1de22283bce653c76f111125af429869fc05b60f,1,Shameera Rathanyaka,2015-08-24 17:30:11-04:00,['b98f65997304eded6ee59f82dd236efc6b2fe091'],153,183,336,6264779,6,1,1,0.648648649,7713
e4f149a387a22de642f9a3ade0957605f171a487,0,Chathuri Wimalasena,2015-08-25 10:53:21-04:00,['1de22283bce653c76f111125af429869fc05b60f'],2,40,42,6264821,2,,,,7713
c8b7bb1a0a2c141e035b0996d3a0fd1958ed2d3d,0,Chathuri Wimalasena,2015-08-25 14:06:58-04:00,['e4f149a387a22de642f9a3ade0957605f171a487'],90,122,212,6265033,2,0.347826087,0.347826087,1,7713
4ba83ccdb8e08c7dbfe672384661915e23331ff4,1,Chathuri Wimalasena,2015-08-25 14:38:48-04:00,['c8b7bb1a0a2c141e035b0996d3a0fd1958ed2d3d'],185,1796,1981,6267014,90,0.473275862,0.656034483,0.914655172,7714
3d3999a05e4150e4c55f9a373526325c2e08dc30,1,Chathuri Wimalasena,2015-08-26 14:21:32-04:00,['4ba83ccdb8e08c7dbfe672384661915e23331ff4'],911,883,1794,6268808,15,0.806788512,0.057441253,0.075718016,7714
fdcf2c96adc44cd67c6dc8f106f50ba3cc40b828,0,Shameera Rathanyaka,2015-08-26 14:39:00-04:00,['3d3999a05e4150e4c55f9a373526325c2e08dc30'],20,18,38,6268846,6,0,0,0,7714
1fbef2110d1028481d66103fe4e5d76fd4062a03,0,Shameera Rathanyaka,2015-08-26 16:15:44-04:00,['fdcf2c96adc44cd67c6dc8f106f50ba3cc40b828'],5,13,18,6268864,1,0,0,1,7714
64b7842f006d229598944abd7fc8f28b28e1133d,1,Chathuri Wimalasena,2015-08-26 16:27:34-04:00,['1fbef2110d1028481d66103fe4e5d76fd4062a03'],19,3,22,6268886,3,0,0,1,7714
9534a8104238ef07de5ac812911d41eb92c08de4,1,Chathuri Wimalasena,2015-08-27 11:44:14-04:00,['64b7842f006d229598944abd7fc8f28b28e1133d'],146,498,644,6269530,88,0.353932584,0.353932584,0.921348315,7718
869a625046b74606070a140ac447fa3dfabbb4e1,0,Chathuri Wimalasena,2015-08-27 13:43:18-04:00,['9534a8104238ef07de5ac812911d41eb92c08de4'],3,5,8,6269538,2,0,0,1,7718
2b1c87fd12d3f329afe0552d22059a8994de70cd,1,Shameera Rathanyaka,2015-08-27 21:16:52-04:00,['869a625046b74606070a140ac447fa3dfabbb4e1'],3,34,37,6269575,4,0,0,1,7719
4d70d3ce7c2789e9e0e38861993fb03d4a10de15,0,Chathuri Wimalasena,2015-08-28 14:03:13-04:00,['2b1c87fd12d3f329afe0552d22059a8994de70cd'],8,9,17,6269592,2,1,0,0,7719
1f065a3a41cde5b3828bf310146add8067b3afbe,1,Supun Nakandala,2015-08-30 17:58:48+05:18,['4d70d3ce7c2789e9e0e38861993fb03d4a10de15'],6,35,41,6269633,3,0,0,1,7719
22d9b8293e7bd26490bfbe86c26708e56f605ee9,1,Supun Nakandala,2015-08-30 19:16:11+05:18,['1f065a3a41cde5b3828bf310146add8067b3afbe'],2,50,52,6269685,2,0.705882353,1,0.705882353,7719
555b0adbfc9035d291eeb7d559a86038746724b8,1,Supun Nakandala,2015-08-30 19:34:09+05:18,['22d9b8293e7bd26490bfbe86c26708e56f605ee9'],0,14,14,6269699,1,0,0,1,7719
dded7acff1326a4cc7624f14f9e436cc95ac98c6,0,Suresh Marru,2015-08-31 10:09:12-04:00,['555b0adbfc9035d291eeb7d559a86038746724b8'],12,37,49,6269748,3,0.214285714,0.214285714,1,7719
99abcafa3c08fae65a9b9c7e7aa1a4487c4b40dc,0,Shameera Rathanyaka,2015-08-31 11:56:25-04:00,['555b0adbfc9035d291eeb7d559a86038746724b8'],2,3,5,6269753,1,,,,7719
d8761f07b089a3b8020871c2613f40a08a28c531,0,Shameera Rathanyaka,2015-08-31 11:56:45-04:00,"['99abcafa3c08fae65a9b9c7e7aa1a4487c4b40dc', 'dded7acff1326a4cc7624f14f9e436cc95ac98c6']",12,37,49,6269802,3,,,,7719
284ce4237933d531bbf36e5d0e00790421751297,1,Supun Nakandala,2015-08-31 22:51:54+05:18,['555b0adbfc9035d291eeb7d559a86038746724b8'],6644,9836,16480,6286282,79,0.315586088,0.349935595,0.90124517,7719
114fa739232b695aa51425735ab2acc27c24634e,0,Supun Nakandala,2015-08-31 22:52:19+05:18,"['284ce4237933d531bbf36e5d0e00790421751297', 'd8761f07b089a3b8020871c2613f40a08a28c531']",14,40,54,6286336,4,,,,7719
1be29cb1f46025101fd4c1e2c2f3e384561116e8,0,Chathuri Wimalasena,2015-08-31 15:58:26-04:00,['114fa739232b695aa51425735ab2acc27c24634e'],11,8,19,6286355,2,1,1,1,7719
c7fb7282eeb916064f31f4d6852702f91d1e4a45,1,Shameera Rathanyaka,2015-08-31 18:07:44-04:00,['d8761f07b089a3b8020871c2613f40a08a28c531'],6,15,21,6286376,7,,,,7719
55aa6dfa0b58ff7cb1ec9c54e8b6ba551f2ec0b9,0,Shameera Rathanyaka,2015-08-31 18:07:52-04:00,"['c7fb7282eeb916064f31f4d6852702f91d1e4a45', '1be29cb1f46025101fd4c1e2c2f3e384561116e8']",6655,9844,16499,6302875,81,,,,7719
6938f907f6d994a84f0ed6cd02291ed828211ca9,0,Chathuri Wimalasena,2015-09-02 16:17:32-04:00,['55aa6dfa0b58ff7cb1ec9c54e8b6ba551f2ec0b9'],24,50,74,6302949,3,0,0,1,7719
6623967781bb7e50a86bf37051a544396c4583eb,1,Shameera Rathanyaka,2015-09-02 17:22:46-04:00,['6938f907f6d994a84f0ed6cd02291ed828211ca9'],24,140,164,6303113,7,0.337209302,0.441860465,1,7719
c292fe651f9dabb317ca059de4e3825f2bb1ae95,0,Supun Nakandala,2015-09-03 15:04:17+05:18,['55aa6dfa0b58ff7cb1ec9c54e8b6ba551f2ec0b9'],72,71,143,6303256,71,,,,7719
75c4cf4ba1a0b1c736f010cb4ab214d631e6ad44,0,Supun Nakandala,2015-09-03 15:04:38+05:18,"['c292fe651f9dabb317ca059de4e3825f2bb1ae95', '6623967781bb7e50a86bf37051a544396c4583eb']",48,190,238,6303494,9,,,,7719
d11dda1acc3ca89efdeb1cef064625d327de4126,0,Supun Nakandala,2015-09-03 15:21:06+05:18,['75c4cf4ba1a0b1c736f010cb4ab214d631e6ad44'],257,44,301,6303795,7,0.414201183,0.319526627,0.00591716,7719
0fec5942c8188ac30c79029e06b6ea0d85f6fb8f,0,Supun Nakandala,2015-09-03 15:25:46+05:18,['d11dda1acc3ca89efdeb1cef064625d327de4126'],26,14,40,6303835,2,,,,7719
3580a962da756a4469935dafc15330645a966b13,0,Supun Nakandala,2015-09-03 15:26:15+05:18,['0fec5942c8188ac30c79029e06b6ea0d85f6fb8f'],7,7,14,6303849,1,,,,7719
1ea272ac0aa176df62b1078ea4fa0544c0b4ae78,0,Supun Nakandala,2015-09-03 15:32:24+05:18,['3580a962da756a4469935dafc15330645a966b13'],5,3,8,6303857,3,,,,7719
42cd60de8953a5469dc2fdc15abe503dd609d29f,0,Chathuri Wimalasena,2015-09-03 15:07:29-04:00,['1ea272ac0aa176df62b1078ea4fa0544c0b4ae78'],3,126,129,6303986,4,0.133333333,0.152380952,0.219047619,7719
420a031a1bb1b9e08b6bff3201a89f3a09fdc8c9,0,Chathuri Wimalasena,2015-09-03 15:44:28-04:00,['42cd60de8953a5469dc2fdc15abe503dd609d29f'],1,1,2,6303988,1,,,,7719
e0483f37fc301d459212736d9b57adc3169666ba,0,Shameera Rathanyaka,2015-09-03 19:57:17-04:00,['6623967781bb7e50a86bf37051a544396c4583eb'],161,122,283,6304271,7,0.78125,0.96875,0.625,7720
be9af52e246ba5f91fba83d4b95bc21600a490d0,0,Shameera Rathanyaka,2015-09-03 19:57:26-04:00,"['e0483f37fc301d459212736d9b57adc3169666ba', '420a031a1bb1b9e08b6bff3201a89f3a09fdc8c9']",371,266,637,6304908,89,,,,7720
a8eff3e1e1b9bfe1a04c6c7e1c6df10c0de3e96a,0,Shameera Rathanyaka,2015-09-04 10:58:07-04:00,['be9af52e246ba5f91fba83d4b95bc21600a490d0'],32,0,32,6304940,1,,,,7720
2640e89a29f0aaa7346a937729823e081824c74a,0,Shameera Rathanyaka,2015-09-04 10:59:25-04:00,['a8eff3e1e1b9bfe1a04c6c7e1c6df10c0de3e96a'],0,24,24,6304964,1,,,,7721
3a2d694d582ffc6a2b30a067c4f800cdc35af068,0,Suresh Marru,2015-09-04 11:02:05-04:00,['be9af52e246ba5f91fba83d4b95bc21600a490d0'],32,0,32,6304996,1,,,,7721
47f161b354f8e670391d30c10d5534e44040dfc3,0,Suresh Marru,2015-09-04 11:08:06-04:00,"['3a2d694d582ffc6a2b30a067c4f800cdc35af068', '2640e89a29f0aaa7346a937729823e081824c74a']",0,24,24,6305020,1,,,,7721
26ef3e43a3aaa29d2abd3b59db93b86910099b23,0,Shameera Rathanyaka,2015-09-04 11:09:20-04:00,['2640e89a29f0aaa7346a937729823e081824c74a'],0,9,9,6305029,1,,,,7721
640e1e3e5f60aa8754afea64289916cd810d01af,0,Shameera Rathanyaka,2015-09-04 11:47:02-04:00,['26ef3e43a3aaa29d2abd3b59db93b86910099b23'],142,16,158,6305187,3,0.344262295,0,0,7721
c46e21dce928bc92e7bdcc7ad2f596475e65a09e,0,Chathuri Wimalasena,2015-09-04 14:59:32-04:00,['640e1e3e5f60aa8754afea64289916cd810d01af'],88,688,776,6305963,83,0.124497992,0.309236948,0.993975904,7721
60e657d45940cc47a4f09a27e291057031808962,0,Shameera Rathanyaka,2015-09-04 15:21:49-04:00,['c46e21dce928bc92e7bdcc7ad2f596475e65a09e'],8,116,124,6306087,7,0.75,0.769230769,1,7722
39a0365d84ca3c50a1712acea66f9b5bf27b5409,1,Chathuri Wimalasena,2015-09-04 15:54:00-04:00,['60e657d45940cc47a4f09a27e291057031808962'],37,51,88,6306175,15,1,1,0,7722
12a4800cfc2f7f90306b5f36f3bed4c6a3996e49,0,Shameera Rathanyaka,2015-09-04 16:28:38-04:00,['60e657d45940cc47a4f09a27e291057031808962'],1,1,2,6306177,1,,,,7722
2c4044cd63fa42c61a6f04d87b54ba26e3c40959,0,Shameera Rathanyaka,2015-09-04 16:29:07-04:00,"['12a4800cfc2f7f90306b5f36f3bed4c6a3996e49', '39a0365d84ca3c50a1712acea66f9b5bf27b5409']",37,51,88,6306265,15,,,,7722
9e5356049ed710316c0a2a2aa59f7066f8770055,0,Shameera Rathanyaka,2015-09-04 16:57:09-04:00,['2c4044cd63fa42c61a6f04d87b54ba26e3c40959'],1,1,2,6306267,1,0,0,0,7722
dad1204a779f185a533d7f6e9f6eb4d82c60ee19,0,Supun Nakandala,2015-09-05 12:12:21+05:18,['1ea272ac0aa176df62b1078ea4fa0544c0b4ae78'],3,126,129,6306396,4,0.133333333,0.152380952,0.219047619,7722
4ba16d63cb774f04f3f0a1afb32708c1afd42215,1,Supun Nakandala,2015-09-05 12:12:21+05:18,['dad1204a779f185a533d7f6e9f6eb4d82c60ee19'],1,1,2,6306398,1,,,,7722
e1356b73aaab299552e5992fddce932e9505304b,0,Supun Nakandala,2015-09-05 12:12:21+05:18,['4ba16d63cb774f04f3f0a1afb32708c1afd42215'],161,122,283,6306681,7,0.78125,0.96875,0.625,7723
99c07d718bf89c8e9eca7deffdaa65c66a5b0c8c,0,Supun Nakandala,2015-09-05 12:12:22+05:18,['e1356b73aaab299552e5992fddce932e9505304b'],2,4,6,6306687,1,,,,7723
8ba681793f8aba8babe5a631015556733897b4a0,0,Supun Nakandala,2015-09-05 12:12:22+05:18,['99c07d718bf89c8e9eca7deffdaa65c66a5b0c8c'],32,0,32,6306719,1,,,,7723
43628adbb1a3af227fedc57a7c30be481f9b43a0,0,Supun Nakandala,2015-09-05 12:12:22+05:18,['8ba681793f8aba8babe5a631015556733897b4a0'],0,24,24,6306743,1,,,,7724
1675d74673b0e09324521af46d6dd0f5dacbaa6f,0,Supun Nakandala,2015-09-05 12:12:22+05:18,['43628adbb1a3af227fedc57a7c30be481f9b43a0'],0,9,9,6306752,1,,,,7724
0cb9f312476023fd17f628d232e385dfb5123e96,0,Supun Nakandala,2015-09-05 12:12:22+05:18,['1675d74673b0e09324521af46d6dd0f5dacbaa6f'],142,16,158,6306910,3,0.344262295,0,0,7724
88afef16dd053874eed02e7df0e3cc37276c4935,1,Supun Nakandala,2015-09-05 12:12:23+05:18,['0cb9f312476023fd17f628d232e385dfb5123e96'],88,688,776,6307686,83,0.124497992,0.309236948,0.993975904,7724
840ae1add331a23663687efce23a782e679e986d,1,Supun Nakandala,2015-09-05 12:12:24+05:18,['88afef16dd053874eed02e7df0e3cc37276c4935'],8,116,124,6307810,7,0.75,0.769230769,1,7725
4e57f5b9e0304aa5c4091380999e2ea2c5837f44,1,Supun Nakandala,2015-09-05 12:12:24+05:18,['840ae1add331a23663687efce23a782e679e986d'],37,51,88,6307898,15,1,1,0,7725
21c1cdb1675025d77637d6526f40a551a6d07f70,0,Supun Nakandala,2015-09-05 12:12:24+05:18,['4e57f5b9e0304aa5c4091380999e2ea2c5837f44'],1,1,2,6307900,1,,,,7725
87b72f9879eacf66c98330965b6e620961e39838,0,Supun Nakandala,2015-09-05 12:12:24+05:18,['21c1cdb1675025d77637d6526f40a551a6d07f70'],1,1,2,6307902,1,0,0,0,7725
c139ecefb4a047931c4edb38ce8cd7a3a08a04a2,0,Supun Nakandala,2015-09-05 12:16:59+05:18,['87b72f9879eacf66c98330965b6e620961e39838'],51,265,316,6308218,15,0.585798817,0.680473373,0.99408284,7725
bea823b43ebd7e039832db8343240b6d7e5234ad,0,Supun Nakandala,2015-09-05 12:22:05+05:18,"['c139ecefb4a047931c4edb38ce8cd7a3a08a04a2', '9e5356049ed710316c0a2a2aa59f7066f8770055']",0,0,0,6308218,0,,,,7725
02f697fa86253018da17d913bd0c51c94780018a,0,Supun Nakandala,2015-09-05 12:31:44+05:18,['bea823b43ebd7e039832db8343240b6d7e5234ad'],0,0,0,6308218,1,,,,7725
28b845715ac6a554d3aaae122d5a0ddebe1b55fb,1,Supun Nakandala,2015-09-05 15:19:50+05:18,['02f697fa86253018da17d913bd0c51c94780018a'],0,1,1,6308219,1,0,1,0,7725
bb478568c2895701d74d39a89a5e74e6519dfa2d,0,Suresh Marru,2015-09-05 09:06:17-04:00,"['47f161b354f8e670391d30c10d5534e44040dfc3', '28b845715ac6a554d3aaae122d5a0ddebe1b55fb']",328,1150,1478,6309697,122,,,,7725
940f117575a64ff8c5732cd95e7b6692ceed5a8c,1,Suresh Marru,2015-09-05 11:37:13-04:00,['28b845715ac6a554d3aaae122d5a0ddebe1b55fb'],287,277,564,6310261,85,,,,7725
342065e74db48f26567516c18fad3d5f73b4fdf3,1,Suresh Marru,2015-09-05 12:10:12-04:00,['940f117575a64ff8c5732cd95e7b6692ceed5a8c'],0,1,1,6310262,1,,,,7725
5b1259ce161d9b487b9031b61893c1fcef0ee018,1,Suresh Marru,2015-09-05 12:33:01-04:00,['342065e74db48f26567516c18fad3d5f73b4fdf3'],22,22,44,6310306,5,,,,7725
07e93bec9ecc3d8a41419640f494dbf75c38bf67,0,Suresh Marru,2015-09-08 08:53:09-04:00,['5b1259ce161d9b487b9031b61893c1fcef0ee018'],58,0,58,6310364,2,,,,7725
3f890f9681cbaf65bee9e6fab2328dc62f769084,0,Suresh Marru,2015-09-08 09:23:34-04:00,['07e93bec9ecc3d8a41419640f494dbf75c38bf67'],20,15,35,6310399,1,0,0,1,7725
26f1039b6dbc202d00cf8f07709889a7e3962950,1,Chathuri Wimalasena,2015-09-08 14:34:05-04:00,['3f890f9681cbaf65bee9e6fab2328dc62f769084'],7,72,79,6310478,3,0.561403509,0.666666667,1,7725
b9015cd0eea58520f69237e5ed597a61d4774904,0,Suresh Marru,2015-09-08 14:45:36-04:00,['26f1039b6dbc202d00cf8f07709889a7e3962950'],25,15,40,6310518,1,0,0,1,7725
4e558e11edc752104b419bac8d2232d08f2b97cf,1,Chathuri Wimalasena,2015-09-08 15:41:37-04:00,['b9015cd0eea58520f69237e5ed597a61d4774904'],6,12,18,6310536,2,0,0,1,7725
bd94e0df031f007eea390d638c0b445294001364,1,Chathuri Wimalasena,2015-09-08 15:54:41-04:00,['4e558e11edc752104b419bac8d2232d08f2b97cf'],4,13,17,6310553,1,0,0,1,7725
d6315966e4c7e3804b55c4d8aa7807bb11fa2fed,0,Chathuri Wimalasena,2015-09-08 16:03:49-04:00,['bd94e0df031f007eea390d638c0b445294001364'],0,3,3,6310556,1,1,1,1,7725
b86393ee414ad7b6a781d0173a474138873e2de6,1,Chathuri Wimalasena,2015-09-08 16:25:36-04:00,['d6315966e4c7e3804b55c4d8aa7807bb11fa2fed'],3,17,20,6310576,3,0,0.857142857,1,7725
4fa124229e4361c819cba71dae163017155b702a,1,Chathuri Wimalasena,2015-09-08 16:55:41-04:00,['b86393ee414ad7b6a781d0173a474138873e2de6'],17,27,44,6310620,4,0,0,0,7725
ddc76d60065bf27fe1224471be18ff2ba1738fc7,0,Suresh Marru,2015-09-08 19:35:29-04:00,['4fa124229e4361c819cba71dae163017155b702a'],2511,2,2513,6313133,27,0.825892857,0.404017857,0.147321429,7725
ab71e6ccf378924e708d61247fef4ab0be6581d9,0,Shameera Rathanyaka,2015-09-09 15:21:19-04:00,['9e5356049ed710316c0a2a2aa59f7066f8770055'],2,4,6,6313139,1,0,0,1,7725
b0c793f060017362ec356a5bcd776f1d7edb368b,0,Shameera Rathanyaka,2015-09-09 15:21:31-04:00,"['ab71e6ccf378924e708d61247fef4ab0be6581d9', 'ddc76d60065bf27fe1224471be18ff2ba1738fc7']",3006,739,3745,6316884,137,,,,7725
95cc3c4abbc497f7a1e9431b003f9cb35c803324,0,Shameera Rathanyaka,2015-09-09 15:29:22-04:00,['b0c793f060017362ec356a5bcd776f1d7edb368b'],3,7,10,6316894,1,0,0,1,7725
84c1ae554b9d2de34ddff705b08b6f5a15f4580a,0,Shameera Rathanyaka,2015-09-09 15:43:05-04:00,['95cc3c4abbc497f7a1e9431b003f9cb35c803324'],12,11,23,6316917,4,,,0,7725
369b35363abae1078fa7733204aa7f55d0e2d1de,0,Shameera Rathanyaka,2015-09-09 16:07:54-04:00,['84c1ae554b9d2de34ddff705b08b6f5a15f4580a'],3,3,6,6316923,1,,,,7725
dec07e4b5a4c2c273bf9a5366d04613c11eeee58,1,Chathuri Wimalasena,2015-09-09 16:26:00-04:00,['369b35363abae1078fa7733204aa7f55d0e2d1de'],17,38,55,6316978,1,0,0,1,7725
8ea1f0a59a503935becec505b79dd4cd2010befb,1,Chathuri Wimalasena,2015-09-09 16:47:54-04:00,['dec07e4b5a4c2c273bf9a5366d04613c11eeee58'],0,3,3,6316981,1,1,1,1,7725
7ad88f70f55790d0227446e08301634bc4e9dd73,1,Shameera Rathanyaka,2015-09-10 16:55:14-04:00,['369b35363abae1078fa7733204aa7f55d0e2d1de'],36,44,80,6317061,5,1,1,1,7725
7c498d064f4608c890d1124a1ba13d2651624aea,0,Shameera Rathanyaka,2015-09-10 16:55:21-04:00,"['7ad88f70f55790d0227446e08301634bc4e9dd73', '8ea1f0a59a503935becec505b79dd4cd2010befb']",17,41,58,6317119,2,,,,7725
d44ef59e96c2b54cfa164913c078927e944b06c1,0,Shameera Rathanyaka,2015-09-11 10:31:11-04:00,['7c498d064f4608c890d1124a1ba13d2651624aea'],170,184,354,6317473,81,0,0,1,7725
d2b176ca147f8d8b9730e52df2b69eb8394d24d3,0,Chathuri Wimalasena,2015-09-14 11:42:41-04:00,['d44ef59e96c2b54cfa164913c078927e944b06c1'],11,32,43,6317516,1,0,0,0,7725
828e503d35994122f48447c5a1e1d0105f91bfe0,0,Shameera Rathanyaka,2015-09-14 14:22:37-04:00,['d2b176ca147f8d8b9730e52df2b69eb8394d24d3'],20,19,39,6317555,1,1,1,0,7725
5256d973445fe5e07990553ff2ad37f88c24cff6,0,Shameera Rathanyaka,2015-09-14 15:11:11-04:00,['828e503d35994122f48447c5a1e1d0105f91bfe0'],1,1,2,6317557,1,,,,7725
5568da30e4b8b63f35878ebaad1128acc526d4bf,0,Shameera Rathanyaka,2015-09-14 15:17:28-04:00,['5256d973445fe5e07990553ff2ad37f88c24cff6'],6,1,7,6317564,1,1,1,0,7725
0d837373fc771e6764a48ef153a200a43a1cfdfd,0,Shameera Rathanyaka,2015-09-14 15:50:22-04:00,['5568da30e4b8b63f35878ebaad1128acc526d4bf'],1,1,2,6317566,1,1,1,1,7725
b2f86f60a0e2bc7c04e75eab606d6cfc69bd9d11,0,Chathuri Wimalasena,2015-09-14 16:25:12-04:00,['0d837373fc771e6764a48ef153a200a43a1cfdfd'],0,1,1,6317567,1,0,0,0,7725
b1fd3a06be15a0143237b42c428f89ba0a268dd1,0,Chathuri Wimalasena,2015-09-15 14:07:25-04:00,['b2f86f60a0e2bc7c04e75eab606d6cfc69bd9d11'],4,11,15,6317582,1,1,1,1,7725
a65c01e2be52a707e8d98ca426685b42a9929a25,0,Chathuri Wimalasena,2015-09-15 14:39:32-04:00,['b1fd3a06be15a0143237b42c428f89ba0a268dd1'],1,11,12,6317594,1,0,0,1,7725
c87eb4270bfb89953da252985e27d9037241a108,0,Chathuri Wimalasena,2015-09-16 14:27:44-04:00,['a65c01e2be52a707e8d98ca426685b42a9929a25'],6,27,33,6317627,4,0.625,0.625,1,7725
c86e5508e60a229f73c6e35ba5ea3bbcf9804493,0,Shameera Rathanyaka,2015-09-16 14:49:05-04:00,['c87eb4270bfb89953da252985e27d9037241a108'],1,18,19,6317646,2,0.428571429,0.428571429,1,7725
3d0dd11defc3f069b48e712c76ba5edfafb4005e,1,Chathuri Wimalasena,2015-09-16 15:20:26-04:00,['c86e5508e60a229f73c6e35ba5ea3bbcf9804493'],4,27,31,6317677,2,0,0.826086957,1,7725
719d1a7eb7307bbb38f5829d0bc6d7acafc19513,0,Chathuri Wimalasena,2015-09-16 15:40:32-04:00,['3d0dd11defc3f069b48e712c76ba5edfafb4005e'],0,3,3,6317680,1,0,0.333333333,1,7725
270ff23782dae07ddb9e417de0d1e33653ebf155,0,Shameera Rathanyaka,2015-09-16 15:41:07-04:00,['3d0dd11defc3f069b48e712c76ba5edfafb4005e'],14,40,54,6317734,1,0,0,1,7725
e2132b680e2a670c21d153a9f960809ed9d87633,0,Shameera Rathanyaka,2015-09-16 15:41:12-04:00,"['270ff23782dae07ddb9e417de0d1e33653ebf155', '719d1a7eb7307bbb38f5829d0bc6d7acafc19513']",0,3,3,6317737,1,,,,7725
303630d32893bef5477312cd0eb554fea1be9746,1,Chathuri Wimalasena,2015-09-17 11:28:16-04:00,['e2132b680e2a670c21d153a9f960809ed9d87633'],5,9,14,6317751,3,0.714285714,0.714285714,1,7725
ea0fb52294ee3e3375f33fb16fc290dcb5d33e90,0,Chathuri Wimalasena,2015-09-17 14:31:49-04:00,['303630d32893bef5477312cd0eb554fea1be9746'],15,26,41,6317792,16,,,,7725
af8a84c49b768ee93a8ad20aade8625c1ef6e999,0,Shameera Rathanyaka,2015-09-18 10:15:40-04:00,['e2132b680e2a670c21d153a9f960809ed9d87633'],44,52,96,6317888,1,0,0,1,7725
8139a8d8ddf24024e20015bb4efebf3501299802,0,Shameera Rathanyaka,2015-09-18 10:18:33-04:00,"['af8a84c49b768ee93a8ad20aade8625c1ef6e999', 'ea0fb52294ee3e3375f33fb16fc290dcb5d33e90']",20,34,54,6317942,18,,,,7725
ad95ca466eac15527e2031d1eb43fa7db5725311,0,Shameera Rathanyaka,2015-09-18 10:40:49-04:00,['8139a8d8ddf24024e20015bb4efebf3501299802'],12,30,42,6317984,1,0,0,1,7725
1302c309bf11db251a0b1b696420ecdb97bc2260,0,Shameera Rathanyaka,2015-09-18 11:11:40-04:00,['ad95ca466eac15527e2031d1eb43fa7db5725311'],2,2,4,6317988,2,,,,7725
8b5b8869acd3ba18b69b0d934eea5a32219f778d,0,Chathuri Wimalasena,2015-09-18 15:15:32-04:00,['1302c309bf11db251a0b1b696420ecdb97bc2260'],127,142,269,6318257,6,0.222222222,0.444444444,0.888888889,7725
9ce24a559e181034b0aca5f038d5cc886b8aed08,0,Chathuri Wimalasena,2015-09-18 16:03:47-04:00,['8b5b8869acd3ba18b69b0d934eea5a32219f778d'],157,178,335,6318592,7,0,1,1,7725
44e5ed14adbe756fcdcd7a541656dd968a61f642,0,Shameera Rathanyaka,2015-09-18 16:21:06-04:00,['1302c309bf11db251a0b1b696420ecdb97bc2260'],26,111,137,6318729,6,0.038961039,0.233766234,1,7725
ba8538ddfb0419fe30df0129371231684d478bde,0,Shameera Rathanyaka,2015-09-18 16:21:23-04:00,"['44e5ed14adbe756fcdcd7a541656dd968a61f642', '9ce24a559e181034b0aca5f038d5cc886b8aed08']",284,320,604,6319333,13,,,,7725
d6b735b56459153e06df263182d4deafb238aab0,0,Chathuri Wimalasena,2015-09-21 16:28:41-04:00,['ba8538ddfb0419fe30df0129371231684d478bde'],53,31,84,6319417,6,0,1,1,7725
28ccb9f1b0478187df197ea2e82f274b013c0123,0,Shameera Rathanyaka,2015-09-21 16:55:06-04:00,['d6b735b56459153e06df263182d4deafb238aab0'],0,2,2,6319419,1,1,1,1,7725
d59c3d712b42926225a9e84557e32d5ce2c55b82,0,Shameera Rathanyaka,2015-09-21 17:20:09-04:00,['28ccb9f1b0478187df197ea2e82f274b013c0123'],2,14,16,6319435,1,0.666666667,0.666666667,1,7725
7d000276f0cf8da562d9a6a140ae17f46d12cf49,0,Shameera Rathanyaka,2015-09-23 11:11:57-04:00,['d59c3d712b42926225a9e84557e32d5ce2c55b82'],3,46,49,6319484,7,0.965517241,0.965517241,1,7725
dbb1a0fd2f7570351e0b8df90a9244404c22093a,0,Shameera Rathanyaka,2015-09-23 12:31:04-04:00,['7d000276f0cf8da562d9a6a140ae17f46d12cf49'],2,2,4,6319488,1,,,,7725
40a4daebb4dddbc7238e09d55aac16f4ecda6876,0,Shameera Rathanyaka,2015-09-23 13:58:58-04:00,['dbb1a0fd2f7570351e0b8df90a9244404c22093a'],14,38,52,6319540,9,0.2,1,1,7725
690a0194f4a5728bace275ef44a18ed9eb327901,0,Shameera Rathanyaka,2015-09-23 14:15:31-04:00,['40a4daebb4dddbc7238e09d55aac16f4ecda6876'],1,6,7,6319547,1,0,1,1,7725
8191574762cbe9d1446dd0e2c3fd412378993db9,0,Shameera Rathanyaka,2015-09-23 16:55:56-04:00,['690a0194f4a5728bace275ef44a18ed9eb327901'],6,18,24,6319571,2,0,0,1,7725
d8cbbb1392c7482caad2c1ee3ee794b1480a8d86,1,Chathuri Wimalasena,2015-09-24 11:57:22-04:00,['8191574762cbe9d1446dd0e2c3fd412378993db9'],50,106,156,6319727,29,0,0,0.945945946,7725
9b1d836d8c43cc05fbd6108e3eae3c2e6424af60,0,Suresh Marru,2015-09-25 10:43:28-04:00,"['bb478568c2895701d74d39a89a5e74e6519dfa2d', 'd8cbbb1392c7482caad2c1ee3ee794b1480a8d86']",3658,1641,5299,6325026,191,,,,7725
40ffc3b34c496cc0dbc2c647394d1ce6c85cf143,0,Chathuri Wimalasena,2015-09-25 10:46:08-04:00,['d8cbbb1392c7482caad2c1ee3ee794b1480a8d86'],0,23,23,6325049,23,0,1,1,7725
c119db50381f1bc16c94d2f74c53faa1b3983357,1,Chathuri Wimalasena,2015-09-25 11:18:18-04:00,['40ffc3b34c496cc0dbc2c647394d1ce6c85cf143'],61,8,69,6325118,18,1,0,0,7725
50fabc39948016542041eb2c039c1bb0c74dbc69,0,Suresh Marru,2015-09-25 15:07:46-04:00,['9b1d836d8c43cc05fbd6108e3eae3c2e6424af60'],4,28,32,6325150,2,,,,7725
07da736bc9130b77609e812a1b5aeac37f5a942b,0,Suresh Marru,2015-09-25 15:09:06-04:00,"['50fabc39948016542041eb2c039c1bb0c74dbc69', 'c119db50381f1bc16c94d2f74c53faa1b3983357']",61,31,92,6325242,41,,,,7725
d84783da02f25e9a8f99178eecf6a626c28a5595,1,Chathuri Wimalasena,2015-09-28 13:58:08-04:00,['07da736bc9130b77609e812a1b5aeac37f5a942b'],21859,38638,60497,6385739,102,0.311552658,0.3488573,0.913924448,7728
7cecac8edb823a77e8e731d9f5ff93dc020d6caf,1,Shameera Rathnayaka Yodage,2015-09-28 18:01:39-04:00,['07da736bc9130b77609e812a1b5aeac37f5a942b'],2,3,5,6385744,1,0,0,1,7728
a2823bc6e35bd29090364b352706cc4f26403325,0,Shameera Rathnayaka Yodage,2015-09-28 18:03:24-04:00,"['7cecac8edb823a77e8e731d9f5ff93dc020d6caf', 'd84783da02f25e9a8f99178eecf6a626c28a5595']",21859,38638,60497,6446241,102,,,,7728
32163812274374ec6c649afc8119594b831761ab,0,Chathuri Wimalasena,2015-09-29 10:54:31-04:00,['d84783da02f25e9a8f99178eecf6a626c28a5595'],70,163,233,6446474,18,0,0,1,7728
d86234106e6845342b81c1edbfcddeb4a661dd20,0,Chathuri Wimalasena,2015-09-29 10:54:42-04:00,"['32163812274374ec6c649afc8119594b831761ab', 'a2823bc6e35bd29090364b352706cc4f26403325']",2,3,5,6446479,1,,,,7728
b3acdc463de8a58021e7f0d5397cddc6079bb583,0,Chathuri Wimalasena,2015-09-29 10:58:56-04:00,['d86234106e6845342b81c1edbfcddeb4a661dd20'],0,728,728,6447207,1,0.370808679,0.406311637,1,7729
83d1dfd4860675dcf2d349dcf3b2053831dbeffc,0,Shameera Rathnayaka Yodage,2015-09-30 10:50:45-04:00,['a2823bc6e35bd29090364b352706cc4f26403325'],0,4,4,6447211,1,0,0,1,7729
8f5997e9e408e73c061f79d088a1611d5d34ebe9,1,Shameera Rathnayaka,2015-09-30 11:02:35-04:00,['83d1dfd4860675dcf2d349dcf3b2053831dbeffc'],70,163,233,6447444,18,0,0,1,7729
232bcb202eb293117d89f6d947b64e3b997764db,0,Shameera Rathnayaka,2015-09-30 11:02:35-04:00,['8f5997e9e408e73c061f79d088a1611d5d34ebe9'],0,728,728,6448172,1,0.370808679,0.406311637,1,7730
43c0ac50ac8da63fac35b928fe1d7d9d43e3b7b1,0,Shameera Rathnayaka,2015-09-30 11:03:03-04:00,"['232bcb202eb293117d89f6d947b64e3b997764db', 'b3acdc463de8a58021e7f0d5397cddc6079bb583']",0,0,0,6448172,0,,,,7730
5b4cfc9e7108d17db1f0b34c5d0ee9da52faf3f2,1,Chathuri Wimalasena,2015-09-30 11:09:54-04:00,['43c0ac50ac8da63fac35b928fe1d7d9d43e3b7b1'],3,5,8,6448180,2,0,0,0,7730
e3ec7fef909e49242f1e3fd6fcf83d9063764a69,1,Shameera Rathnayaka,2015-09-30 15:19:52-04:00,['5b4cfc9e7108d17db1f0b34c5d0ee9da52faf3f2'],1,5,6,6448186,1,0,1,1,7730
a0dc590f7ae8e3c0a23bb96e6b21cda3b16577d7,1,Chathuri Wimalasena,2015-09-30 16:03:02-04:00,['e3ec7fef909e49242f1e3fd6fcf83d9063764a69'],1,3,4,6448190,2,0,0,1,7730
4cf30ee36e7a28bde2119d53434de023cdc8f07b,0,Chathuri Wimalasena,2015-09-30 16:04:22-04:00,['a0dc590f7ae8e3c0a23bb96e6b21cda3b16577d7'],2,1,3,6448193,1,,,,7730
25b85226c8ff9af24efe3f813cc93f8534b60024,0,Shameera Rathnayaka,2015-10-02 11:31:40-04:00,['4cf30ee36e7a28bde2119d53434de023cdc8f07b'],1,1,2,6448195,1,,,,7730
bb43bfdd5d2e7927de9614320002d6fc27492c57,1,Chathuri Wimalasena,2015-10-02 11:33:10-04:00,['4cf30ee36e7a28bde2119d53434de023cdc8f07b'],260,485,745,6448940,49,0,0.023746702,0.992084433,7730
dea83926c22a59d628497c6a5635edf287d25c37,0,Chathuri Wimalasena,2015-10-02 11:33:37-04:00,"['bb43bfdd5d2e7927de9614320002d6fc27492c57', '25b85226c8ff9af24efe3f813cc93f8534b60024']",1,1,2,6448942,1,,,,7730
c6869bce121646f45445768cc9a6867a3363a72f,0,Shameera Rathnayaka,2015-10-02 11:46:15-04:00,['dea83926c22a59d628497c6a5635edf287d25c37'],1,1,2,6448944,1,,,,7730
a045061285bbfd26fd71ac1cb3109b4e86771a6f,1,Shameera Rathnayaka,2015-10-02 14:41:16-04:00,['c6869bce121646f45445768cc9a6867a3363a72f'],2,33,35,6448979,2,0.266666667,0.8,1,7730
0665ee421e1c348059684182b0c47486a2b050f4,1,Shameera Rathnayaka,2015-10-02 16:24:21-04:00,['a045061285bbfd26fd71ac1cb3109b4e86771a6f'],8,12,20,6448999,4,0.5,0,1,7730
9fcd441f1df055fbe363ef9a172fd01003f45ddc,0,Shameera Rathnayaka,2015-10-05 15:33:19-04:00,['0665ee421e1c348059684182b0c47486a2b050f4'],3,37,40,6449039,3,0.647058824,0.647058824,0.647058824,7730
4d07c015ba4d874cb3f979f56463e0fd09fac947,0,Shameera Rathnayaka,2015-10-05 15:37:31-04:00,['9fcd441f1df055fbe363ef9a172fd01003f45ddc'],229,0,229,6449268,3,0,0,0,7730
808ff55bd1cd79b667077166bbaa9ab0314934f0,0,Shameera Rathnayaka,2015-10-05 16:37:58-04:00,['4d07c015ba4d874cb3f979f56463e0fd09fac947'],131,173,304,6449572,4,0,0.733333333,1,7730
7275b3d50e795bef508224b5b7b6bcf280684d48,1,Chathuri Wimalasena,2015-10-06 15:57:26-04:00,['808ff55bd1cd79b667077166bbaa9ab0314934f0'],142,365,507,6450079,90,0.234285714,0.348571429,0.994285714,7730
ae208754b7fda0e8b6b54e8772d8d61af6830709,0,Chathuri Wimalasena,2015-10-06 16:29:14-04:00,['7275b3d50e795bef508224b5b7b6bcf280684d48'],3,7,10,6450089,1,1,1,1,7730
625cbfd4b7aad54b007a471d8975be8ed845bf56,0,Shameera Rathnayaka,2015-10-06 19:16:10-04:00,['808ff55bd1cd79b667077166bbaa9ab0314934f0'],6,7,13,6450102,2,1,0,0,7730
bd6571428be75fd905ab30e294f418055ffd49af,0,Shameera Rathnayaka,2015-10-06 19:17:04-04:00,"['625cbfd4b7aad54b007a471d8975be8ed845bf56', 'ae208754b7fda0e8b6b54e8772d8d61af6830709']",145,372,517,6450619,91,,,,7730
638d7f767c7648c581f2196bf045b32fa576520c,0,Shameera Rathnayaka,2015-10-07 11:51:05-04:00,['bd6571428be75fd905ab30e294f418055ffd49af'],142,211,353,6450972,5,0,0.148148148,0,7730
1b6dffe9ff2c92e835fc8f56903ed33dff2aa0f1,0,Shameera Rathnayaka,2015-10-07 13:33:00-04:00,['638d7f767c7648c581f2196bf045b32fa576520c'],48,39,87,6451059,1,,,,7730
302a58e6e1675cbc92af5e732c9a0e28b930c13f,1,scnakandala,2015-10-08 06:11:27-04:00,['ae208754b7fda0e8b6b54e8772d8d61af6830709'],0,3,3,6451062,1,0.333333333,1,1,7730
51ed550725013cd8a27dd9533fac1a96f6baaf80,0,scnakandala,2015-10-08 06:11:49-04:00,"['302a58e6e1675cbc92af5e732c9a0e28b930c13f', '1b6dffe9ff2c92e835fc8f56903ed33dff2aa0f1']",147,208,355,6451417,6,,,,7730
ec75efb0ed21ecf8dc33c1db7300450a13bbd43e,0,Chathuri Wimalasena,2015-10-08 13:49:03-04:00,['51ed550725013cd8a27dd9533fac1a96f6baaf80'],1,7,8,6451425,1,1,1,1,7730
e66c52bc6ad88aa3fe9a80067311a179522ee03a,1,Chathuri Wimalasena,2015-10-08 15:25:25-04:00,['ec75efb0ed21ecf8dc33c1db7300450a13bbd43e'],881,519,1400,6452825,89,1,1,0,7730
c5585979d4fb257a6fabc994fbdd9956b5921905,1,Chathuri Wimalasena,2015-10-08 16:38:51-04:00,['e66c52bc6ad88aa3fe9a80067311a179522ee03a'],223,251,474,6453299,17,0.736842105,0.736842105,0.947368421,7730
07adb3b1233521101d92e31590b6bc066ad6a019,0,Chathuri Wimalasena,2015-10-08 16:43:02-04:00,['c5585979d4fb257a6fabc994fbdd9956b5921905'],1,8,9,6453308,1,0,0,1,7730
6b06c4ed3346f7830d80a1d2d97e353460697df6,0,Shameera Rathnayaka,2015-10-12 11:59:07-04:00,['07adb3b1233521101d92e31590b6bc066ad6a019'],0,9,9,6453317,1,,,,7730
629306941731a0e2c1b19b8a05103dc6f36963aa,1,Chathuri Wimalasena,2015-10-12 12:10:04-04:00,['6b06c4ed3346f7830d80a1d2d97e353460697df6'],90,1699,1789,6455106,82,0.50466497,0.679389313,0.985581001,7730
cb21871fe24275cf729abe3c852ce3bd4862a4e4,0,Chathuri Wimalasena,2015-10-12 13:52:49-04:00,['629306941731a0e2c1b19b8a05103dc6f36963aa'],0,523,523,6455629,1,0.566455696,0.740506329,1,7731
af295229a8a27fa3718b84ed552dcc702a62d4c2,0,Shameera Rathnayaka,2015-10-12 16:55:32-04:00,['cb21871fe24275cf729abe3c852ce3bd4862a4e4'],80,1072,1152,6456781,9,0.526315789,0.716468591,0.981324278,7733
930a222fed86365863210283b2cfb6cd8ca1cb06,0,Shameera Rathnayaka,2015-10-12 17:17:35-04:00,['af295229a8a27fa3718b84ed552dcc702a62d4c2'],83,780,863,6457644,8,0.686774942,0.828306265,1,7734
4db5d4f4b9168a3d512e7275c144c0a895c39a37,1,scnakandala,2015-10-13 12:07:30-04:00,['07adb3b1233521101d92e31590b6bc066ad6a019'],4574,7351,11925,6469569,79,0.343320236,0.404715128,0.93762279,7734
c5778f4526f2cf5f115a7493e495dc82fde0ea89,0,Chathuri Wimalasena,2015-10-13 13:58:34-04:00,['4db5d4f4b9168a3d512e7275c144c0a895c39a37'],8,38,46,6469615,7,0,0,1,7734
14b7bcf98a2d9f7df19af7f5525d4598f3d1911f,1,Chathuri Wimalasena,2015-10-13 16:28:54-04:00,['af295229a8a27fa3718b84ed552dcc702a62d4c2'],249,838,1087,6470702,15,0.21888412,0.259656652,0.553648069,7734
24b83d8f9f72e22f15ff57edf2f05955ca79ff51,0,Chathuri Wimalasena,2015-10-13 16:29:05-04:00,"['14b7bcf98a2d9f7df19af7f5525d4598f3d1911f', '930a222fed86365863210283b2cfb6cd8ca1cb06']",83,780,863,6471565,8,,,,7734
10d593c95260b1d3c2b4a578652be4e0dd4a7f95,1,Shameera Rathnayaka,2015-10-15 17:51:38-04:00,['24b83d8f9f72e22f15ff57edf2f05955ca79ff51'],917,684,1601,6473166,8,1,0.321428571,0.25,7734
41b37009b46f4e6c7e2e5a8d687cf99d192b39a9,0,Shameera Rathnayaka,2015-10-15 18:00:51-04:00,['10d593c95260b1d3c2b4a578652be4e0dd4a7f95'],98,282,380,6473546,80,0,0.054054054,0.97972973,7734
9a99ad4257dccb389a809d2a0cacdcba97c12824,1,Chathuri Wimalasena,2015-10-19 10:51:33-04:00,['41b37009b46f4e6c7e2e5a8d687cf99d192b39a9'],2,4,6,6473552,2,,,,7734
f532a9d161c56f01cda584603ebab704ee1231da,0,Shameera Rathnayaka,2015-10-19 11:36:03-04:00,['9a99ad4257dccb389a809d2a0cacdcba97c12824'],82,264,346,6473898,79,0.06,0.02,0.993333333,7734
e7cbd9f81c5c5a0eef6b3c2e6b784d7e3a13f07c,1,Shameera Rathnayaka,2015-10-19 11:36:52-04:00,['f532a9d161c56f01cda584603ebab704ee1231da'],33,76,109,6474007,2,0.22,0.74,0,7734
9e3d84be8d39ac739a6a35b768589d4fc7207ae3,0,Shameera Rathnayaka,2015-10-19 11:55:35-04:00,['e7cbd9f81c5c5a0eef6b3c2e6b784d7e3a13f07c'],4,17,21,6474028,3,0,0,1,7734
ae19d7c2ef69f1e3e2a5130b44324394a6c40756,0,Shameera Rathnayaka,2015-10-19 12:07:42-04:00,['9e3d84be8d39ac739a6a35b768589d4fc7207ae3'],2,3,5,6474033,1,,,,7734
4293dc438adc768c6861a6d7946acd0bec32b513,1,scnakandala,2015-10-19 17:36:18-04:00,['c5778f4526f2cf5f115a7493e495dc82fde0ea89'],1,1,2,6474035,1,,,,7734
533faee235ea8946dd18ebde6f395c426b499f36,1,scnakandala,2015-10-19 18:27:52-04:00,['4293dc438adc768c6861a6d7946acd0bec32b513'],138,313,451,6474486,78,0.226666667,0.233333333,0.993333333,7734
72366a9b5f80c0130c7178a2768e45f0d28ed5d5,0,scnakandala,2015-10-20 14:42:38-04:00,['533faee235ea8946dd18ebde6f395c426b499f36'],3,3,6,6474492,3,,,,7734
496eff4ab56fd5bedc4323ca8350b1bc0099de87,0,Chathuri Wimalasena,2015-10-20 14:49:06-04:00,['ae19d7c2ef69f1e3e2a5130b44324394a6c40756'],4817,7375,12192,6486684,79,0.365487674,0.432475884,0.942658092,7734
84bf6215e2b8b06ab353836ed03e713a678016b0,0,Chathuri Wimalasena,2015-10-20 14:49:06-04:00,['496eff4ab56fd5bedc4323ca8350b1bc0099de87'],8,38,46,6486730,7,0,0,1,7734
c3dd6f0204bc2e5168527bb33c5f3bd1ae720203,0,Chathuri Wimalasena,2015-10-20 14:49:06-04:00,['84bf6215e2b8b06ab353836ed03e713a678016b0'],1,1,2,6486732,1,,,,7734
83c7e0d6cb7cb090feff9d0181de281260bd2fc3,0,Chathuri Wimalasena,2015-10-20 14:49:06-04:00,['c3dd6f0204bc2e5168527bb33c5f3bd1ae720203'],138,313,451,6487183,78,0.226666667,0.233333333,0.993333333,7734
bfa0afbe5faefda7134a55ab4623b04462a953d4,1,scnakandala,2015-10-20 14:51:19-04:00,['72366a9b5f80c0130c7178a2768e45f0d28ed5d5'],3,3,6,6487189,3,,,,7734
9057115c4cfd5a045068f37660e09197d2c735db,0,Chathuri Wimalasena,2015-10-20 14:52:34-04:00,['83c7e0d6cb7cb090feff9d0181de281260bd2fc3'],6991,4644,11635,6498824,75,0.604824813,0.525560023,0.019529006,7734
3398ec17b34f3244c64d47bb47f7e6c6f754d358,0,Chathuri Wimalasena,2015-10-20 14:54:04-04:00,['9057115c4cfd5a045068f37660e09197d2c735db'],4615,6382,10997,6509821,74,0.351976137,0.407158837,0.963460104,7734
4d9973e2e2723ac21cbf5beca63fa6df99dea2d1,0,Chathuri Wimalasena,2015-10-20 15:02:20-04:00,['3398ec17b34f3244c64d47bb47f7e6c6f754d358'],56,855,911,6510732,4,0.40877193,0.521052632,0.99122807,7734
05da53014edf68666ccb32599127aa94d573e818,1,Chathuri Wimalasena,2015-10-20 16:12:58-04:00,['4d9973e2e2723ac21cbf5beca63fa6df99dea2d1'],2,145,147,6510879,2,0.313559322,0.593220339,0.296610169,7734
a1d999cf3f969fe179549ae5011a55ee6e8d27eb,0,scnakandala,2015-10-20 17:03:32-04:00,['bfa0afbe5faefda7134a55ab4623b04462a953d4'],6,6,12,6510891,3,,,,7734
a2cd71e6b28b578d230724da2f2d5c74038e644b,0,scnakandala,2015-10-21 10:23:00-04:00,['a1d999cf3f969fe179549ae5011a55ee6e8d27eb'],1,1,2,6510893,1,,,,7734
69c268acefd3451c05028f9c7b458ba77ead68ff,0,Chathuri Wimalasena,2015-10-21 11:48:07-04:00,['05da53014edf68666ccb32599127aa94d573e818'],0,1,1,6510894,1,0,0,1,7734
d071d8ed30feec05a8fb870486a32b68161b99ec,0,Chathuri Wimalasena,2015-10-21 12:04:45-04:00,['69c268acefd3451c05028f9c7b458ba77ead68ff'],1,1,2,6510896,1,,,,7734
80ac14c356ea135a741261a08a85dfc8843bcc78,0,Chathuri Wimalasena,2015-10-21 14:04:06-04:00,['d071d8ed30feec05a8fb870486a32b68161b99ec'],9,28,37,6510933,3,0.666666667,0,0.444444444,7734
88a611d24800bd5b0d5769cb3dde703e717addd5,1,Chathuri Wimalasena,2015-10-21 14:22:28-04:00,['80ac14c356ea135a741261a08a85dfc8843bcc78'],5,9,14,6510947,1,0,0,0.8,7734
f4c6424565bd5926b2ab0a8efc4351a58212a431,0,Chathuri Wimalasena,2015-10-21 15:06:19-04:00,['88a611d24800bd5b0d5769cb3dde703e717addd5'],11,3,14,6510961,2,1,1,0.714285714,7734
83592fb5a4aff44df66dc3d4c44438d1aac853af,0,Chathuri Wimalasena,2015-10-21 16:10:47-04:00,['f4c6424565bd5926b2ab0a8efc4351a58212a431'],98,460,558,6511519,83,0.178125,0,0.990625,7734
53e3d4c4e9bdf38055b757e34fc447903e588f5a,1,Chathuri Wimalasena,2015-10-22 10:49:04-04:00,['83592fb5a4aff44df66dc3d4c44438d1aac853af'],8,12,20,6511539,4,,,,7734
138c9949ca4fd5ed45045750707b54c7ba9bb14a,1,Chathuri Wimalasena,2015-10-22 11:57:12-04:00,['53e3d4c4e9bdf38055b757e34fc447903e588f5a'],16,57,73,6511612,2,0.2,0.444444444,0.377777778,7734
30a918440a615747c58e8f7f89092e0ee5feb6e6,1,scnakandala,2015-10-22 12:58:00-04:00,['a2cd71e6b28b578d230724da2f2d5c74038e644b'],78,144,222,6511834,12,1,1,1,7734
4cd7738d71af11341f9f81a59a7760bb3bc280d2,0,scnakandala,2015-10-22 12:59:07-04:00,['30a918440a615747c58e8f7f89092e0ee5feb6e6'],26,26,52,6511886,1,,,,7734
6c43cc12142f9cef3d23275bde4e78c0071bffe1,1,scnakandala,2015-10-22 13:34:10-04:00,['4cd7738d71af11341f9f81a59a7760bb3bc280d2'],4,4,8,6511894,4,,,,7734
1f9a39ce0d7061743deb1d065816de25073b0596,1,scnakandala,2015-10-22 23:14:56-04:00,['6c43cc12142f9cef3d23275bde4e78c0071bffe1'],407,1037,1444,6513338,84,0.298474946,0.374727669,0.991285403,7734
426b0152832138b67e8a4c2e6487304ca3c22ff0,0,scnakandala,2015-10-22 23:17:15-04:00,['1f9a39ce0d7061743deb1d065816de25073b0596'],0,522,522,6513860,1,0.576802508,0.742946708,1,7735
72fb57bc280690885974547ec0c9e1fd4102601c,1,Shameera Rathnayaka,2015-10-23 11:04:00-04:00,['138c9949ca4fd5ed45045750707b54c7ba9bb14a'],27,101,128,6513988,5,0.050847458,1,1,7735
b57a5015d047ac032636772cbb8f7dd9184035cd,1,Shameera Rathnayaka,2015-10-23 14:22:46-04:00,['72fb57bc280690885974547ec0c9e1fd4102601c'],35,67,102,6514090,6,0.074074074,0.851851852,1,7735
44ac0a22da886d04f0cf5e510cabd77f71dd6fe0,0,scnakandala,2015-10-23 16:57:16-04:00,['426b0152832138b67e8a4c2e6487304ca3c22ff0'],81,95,176,6514266,81,0,0,0.5,7735
5748db779b0603243a57a181d0123ef8d7023d81,1,scnakandala,2015-10-23 17:47:31-04:00,['44ac0a22da886d04f0cf5e510cabd77f71dd6fe0'],1,3,4,6514270,1,0,0,0,7735
4db026e5e026c199c0a9b1431dd6fa6d26f26762,0,Chathuri Wimalasena,2015-10-26 13:20:30-04:00,['5748db779b0603243a57a181d0123ef8d7023d81'],2,3,5,6514275,1,0,0,1,7735
d96f35ac23d9a8148fd9be949f34612fee2c89ed,1,Chathuri Wimalasena,2015-10-26 14:30:20-04:00,['4db026e5e026c199c0a9b1431dd6fa6d26f26762'],26,47,73,6514348,6,0.318181818,0.454545455,0.681818182,7735
3de33acf281173a88748697522fb7a01a8e0de20,0,Chathuri Wimalasena,2015-10-27 07:53:07-04:00,['d96f35ac23d9a8148fd9be949f34612fee2c89ed'],3,9,12,6514360,1,,,,7735
ed4637cc20cb26e8ffe928f0ef627334e6dbfd55,0,Chathuri Wimalasena,2015-10-27 10:46:43-04:00,['3de33acf281173a88748697522fb7a01a8e0de20'],1,5,6,6514366,1,0,0,1,7735
e61cb8bbc8627d0b47ec59aea798b24663464260,0,Chathuri Wimalasena,2015-10-27 12:11:31-04:00,['ed4637cc20cb26e8ffe928f0ef627334e6dbfd55'],0,8,8,6514374,1,0,0,1,7735
b442e0c351a4e48f9c7c2733f0a88947a24c6272,1,Chathuri Wimalasena,2015-10-30 14:09:29-04:00,['b57a5015d047ac032636772cbb8f7dd9184035cd'],54,171,225,6514599,16,0.097087379,0.281553398,1,7735
b001b184aa2e5b4a00ef046417f6131b3fc35d6d,1,Chathuri Wimalasena,2015-10-30 15:05:19-04:00,['b442e0c351a4e48f9c7c2733f0a88947a24c6272'],23,9,32,6514631,7,0.5,0.5,0,7735
6fc864eb9a30c2ca15333d1fc90c2d364f6bf58e,1,Chathuri Wimalasena,2015-10-30 15:47:49-04:00,['b001b184aa2e5b4a00ef046417f6131b3fc35d6d'],18,5,23,6514654,4,0,0,0,7735
2d6ee02a5ae8e4769b33138d1ecfd5597c84fc94,0,Chathuri Wimalasena,2015-11-02 11:57:41-05:00,['6fc864eb9a30c2ca15333d1fc90c2d364f6bf58e'],96,100,196,6514850,2,0,0,0.333333333,7735
d139f697d7a8812722a989df76199f93b813ea26,1,Shameera Rathnayaka,2015-11-02 15:32:11-05:00,['6fc864eb9a30c2ca15333d1fc90c2d364f6bf58e'],4,10,14,6514864,1,0,1,0,7735
85885d9cbfb0c94b53d8be62bf1c8ea637291a18,0,Shameera Rathnayaka,2015-11-02 15:32:22-05:00,"['d139f697d7a8812722a989df76199f93b813ea26', '2d6ee02a5ae8e4769b33138d1ecfd5597c84fc94']",96,100,196,6515060,2,,,,7735
ef332fcba9850286d7b6e742018f8ce82165150a,0,Chathuri Wimalasena,2015-11-03 14:46:47-05:00,"['e61cb8bbc8627d0b47ec59aea798b24663464260', '85885d9cbfb0c94b53d8be62bf1c8ea637291a18']",1524,6905,8429,6523489,128,,,,7735
be08320dda089405ed83de6e7bed3d1ea0a16b52,0,Shameera Rathnayaka,2015-11-04 12:46:55-05:00,['ef332fcba9850286d7b6e742018f8ce82165150a'],1,1,2,6523491,1,,,,7735
98f077ed5a9f007b834b6efd98b84f5aea750d4d,0,Shameera Rathnayaka,2015-11-04 14:50:35-05:00,['be08320dda089405ed83de6e7bed3d1ea0a16b52'],45,42,87,6523578,6,1,1,1,7735
5eb3c26ad7f30fec0c899e507099379dbfe2be85,1,Shameera Rathnayaka,2015-11-04 15:35:56-05:00,['98f077ed5a9f007b834b6efd98b84f5aea750d4d'],42,45,87,6523665,6,0,0,0,7735
8ce513c28610d2c60dfc01dc45233330b94f8acf,0,Chathuri Wimalasena,2015-11-04 16:45:50-05:00,['5eb3c26ad7f30fec0c899e507099379dbfe2be85'],135,332,467,6524132,90,0.27388535,0.178343949,0.987261146,7735
b4e3c33fda71c663f0db8c65452b49efd46befff,1,Chathuri Wimalasena,2015-11-06 10:47:11-05:00,['8ce513c28610d2c60dfc01dc45233330b94f8acf'],172,418,590,6524722,110,0.207253886,0.404145078,0.994818653,7735
687d812617a0fb236a7c44a2a894d71c641e51d6,1,Shameera Rathnayaka,2015-11-06 17:25:22-05:00,['5eb3c26ad7f30fec0c899e507099379dbfe2be85'],26,39,65,6524787,2,0,0.8,0.133333333,7735
85fb6b69443c4be9736c9a3af641341c5f957db8,0,Shameera Rathnayaka,2015-11-06 17:25:44-05:00,"['687d812617a0fb236a7c44a2a894d71c641e51d6', 'b4e3c33fda71c663f0db8c65452b49efd46befff']",232,675,907,6525694,120,,,,7735
140d9bd503c713833ec18d248c02a3faf74b5102,0,Shameera Rathnayaka,2015-11-06 17:50:51-05:00,['85fb6b69443c4be9736c9a3af641341c5f957db8'],40,45,85,6525779,2,0,0,1,7735
08cdad2645ffcea9b499a23afe408d9c2bd2896f,0,Shameera Rathnayaka,2015-11-09 10:59:30-05:00,['140d9bd503c713833ec18d248c02a3faf74b5102'],2640,0,2640,6528419,12,,,,7735
c62f74a5ecaa9866f7337a3c25009dcf8ee52f35,1,Shameera Rathnayaka,2015-11-09 13:14:06-05:00,['08cdad2645ffcea9b499a23afe408d9c2bd2896f'],25,257,282,6528701,6,1,1,0.839160839,7737
dc1be3126409992f6de94d76e0fc4834540e9e9c,0,Shameera Rathnayaka,2015-11-09 15:25:52-05:00,['c62f74a5ecaa9866f7337a3c25009dcf8ee52f35'],438,442,880,6529581,10,0,1,1,7738
f0705314af0b43209366320403547a0f703d0868,0,Shameera Rathnayaka,2015-11-09 15:37:59-05:00,['dc1be3126409992f6de94d76e0fc4834540e9e9c'],1,1,2,6529583,1,,,,7738
eb425a591bc93a76d06d29b950f5f4c4f8fd76a2,0,Shameera Rathnayaka,2015-11-09 16:00:37-05:00,['f0705314af0b43209366320403547a0f703d0868'],1,6,7,6529590,1,0,0,1,7738
2df93cca379515528ed1a69968497ecfc2b8bf6b,0,Shameera Rathnayaka,2015-11-09 17:19:32-05:00,['eb425a591bc93a76d06d29b950f5f4c4f8fd76a2'],81,93,174,6529764,81,0,0,1,7738
b00b8b23f683a59d30b7307ff4f88c2d9646b280,0,Shameera Rathnayaka,2015-11-09 17:21:12-05:00,['2df93cca379515528ed1a69968497ecfc2b8bf6b'],1,2,3,6529767,1,0,0,1,7738
dd32d065ea8d9bfedf80cdf48db1a2704dbcafb2,0,Chathuri Wimalasena,2015-11-10 14:57:04-05:00,['b00b8b23f683a59d30b7307ff4f88c2d9646b280'],0,313,313,6530080,2,0.351851852,0.456790123,0.87654321,7740
832b14680730bc64c346a739a6491ffc6f4c13b5,1,Shameera Rathnayaka,2015-11-11 11:26:48-05:00,['dd32d065ea8d9bfedf80cdf48db1a2704dbcafb2'],25,54,79,6530159,10,0.24,0.96,0.96,7740
091fcdca8237ced2ba8cca3e54c79d9469963e53,0,smarru,2015-11-11 11:34:26-05:00,['dd32d065ea8d9bfedf80cdf48db1a2704dbcafb2'],0,168,168,6530327,1,,,,7741
5b9a48d57812ce3a3d9321c2e6104773c084969f,0,smarru,2015-11-11 11:35:25-05:00,"['091fcdca8237ced2ba8cca3e54c79d9469963e53', '832b14680730bc64c346a739a6491ffc6f4c13b5']",25,54,79,6530406,10,,,,7741
37e94a0780b9bbcfe80325d3cadd0d0099f68867,1,Chathuri Wimalasena,2015-11-11 11:37:37-05:00,['dd32d065ea8d9bfedf80cdf48db1a2704dbcafb2'],3,42,45,6530451,2,0.454545455,0,1,7741
539fba49f17103bb11372236c629229e566a5730,0,Chathuri Wimalasena,2015-11-11 11:37:42-05:00,"['37e94a0780b9bbcfe80325d3cadd0d0099f68867', '5b9a48d57812ce3a3d9321c2e6104773c084969f']",25,222,247,6530698,11,,,,7741
c96f66b528daa97cdeb06b03fa7143fd6b039be1,0,smarru,2015-11-11 11:46:12-05:00,['5b9a48d57812ce3a3d9321c2e6104773c084969f'],118,3,121,6530819,2,,,,7741
cbb4c743dbb34488608ad9c06891428b9f0a0940,0,Chathuri Wimalasena,2015-11-11 11:50:38-05:00,"['539fba49f17103bb11372236c629229e566a5730', 'c96f66b528daa97cdeb06b03fa7143fd6b039be1']",118,3,121,6530940,2,,,,7741
5277ec48d43c2abf41ac0a906436c5051cf0f8d9,0,Chathuri Wimalasena,2015-11-11 12:09:27-05:00,['cbb4c743dbb34488608ad9c06891428b9f0a0940'],330,133,463,6531403,89,0.72611465,0.821656051,0.012738854,7741
a9520e0cf4b6ab82f6b88ee58aa8cb344864c09b,0,Chathuri Wimalasena,2015-11-11 15:35:03-05:00,['5277ec48d43c2abf41ac0a906436c5051cf0f8d9'],6,18,24,6531427,6,0,0,1,7741
7b1888fdcf6746d70972e3981d79b53607bf9219,0,Shameera Rathnayaka,2015-11-11 15:53:07-05:00,['a9520e0cf4b6ab82f6b88ee58aa8cb344864c09b'],6,28,34,6531461,1,0,0,1,7741
69ecb680123cea1f86c4b562ef7aff9c978e14e4,1,Shameera Rathnayaka,2015-11-11 16:41:23-05:00,['7b1888fdcf6746d70972e3981d79b53607bf9219'],34,40,74,6531535,1,0,0,1,7741
30d230c44e11aa7f4c3649dc1e5bcb82695a9846,0,Shameera Rathnayaka,2015-11-11 16:51:59-05:00,['69ecb680123cea1f86c4b562ef7aff9c978e14e4'],1,0,1,6531536,1,1,1,0,7741
6aaea39d12aec2ffc8d969ebaa5eccd90aaa7f2f,0,Shameera Rathnayaka,2015-11-11 17:01:37-05:00,['30d230c44e11aa7f4c3649dc1e5bcb82695a9846'],1,1,2,6531538,1,,,,7741
b27fb333b63ec168a4625a8fad822d943ffd508a,0,Chathuri Wimalasena,2015-11-12 10:29:58-05:00,['6aaea39d12aec2ffc8d969ebaa5eccd90aaa7f2f'],0,900,900,6532438,1,0.312401884,0.335949765,1,7742
47b0700624537684e0a0b80fbb28b6403db9b0b2,1,Chathuri Wimalasena,2015-11-12 10:32:07-05:00,['b27fb333b63ec168a4625a8fad822d943ffd508a'],78,412,490,6532928,81,1,1,1,7745
f1014d58b4b5822023a0afad72951941955f1d72,0,smarru,2015-11-12 11:07:13-05:00,['6aaea39d12aec2ffc8d969ebaa5eccd90aaa7f2f'],0,2,2,6532930,1,,,,7745
f6d96515f7fc523418979c44a20c44a70433537c,0,smarru,2015-11-12 13:05:33-05:00,"['f1014d58b4b5822023a0afad72951941955f1d72', '47b0700624537684e0a0b80fbb28b6403db9b0b2']",77,1311,1388,6534318,81,,,,7745
0a0f5ba6b26e08792d19f2c8df5418e9b1ae99b9,0,smarru,2015-11-12 13:08:30-05:00,['f6d96515f7fc523418979c44a20c44a70433537c'],0,252,252,6534570,2,0.388157895,0.388157895,1,7747
e2799d45df13ebe8a75be56c3c6732665954e4ad,0,smarru,2015-11-12 14:55:40-05:00,['0a0f5ba6b26e08792d19f2c8df5418e9b1ae99b9'],14322,28846,43168,6577738,17,0.345718901,0.389907821,0.930057968,7754
96687a6b7c4837e87fe8761eaf953b3d5e477afa,0,smarru,2015-11-12 16:38:02-05:00,['e2799d45df13ebe8a75be56c3c6732665954e4ad'],0,66,66,6577804,1,1,1,0.8,7754
a6de5390478194a63da242ef6bca0e9b0f4f9a76,1,smarru,2015-11-13 00:13:57-05:00,['96687a6b7c4837e87fe8761eaf953b3d5e477afa'],5,888,893,6578697,10,0.423001949,0.586744639,0.980506823,7758
ee330724ff94bc6d2e197729637c5535af8081e7,0,scnakandala,2015-11-16 11:38:27-05:00,['dd32d065ea8d9bfedf80cdf48db1a2704dbcafb2'],5235,9008,14243,6592940,95,0.29615815,0.327489743,0.942931742,7758
4f7af6a9a93774626fbf9b3b8d003022cadbf766,0,scnakandala,2015-11-17 15:08:22-05:00,['a6de5390478194a63da242ef6bca0e9b0f4f9a76'],406,1030,1436,6594376,17,0.324,0.388,0.944,7758
ef5756d719c2440c2bcbe5c181673d3245498de1,0,scnakandala,2015-11-17 15:46:14-05:00,['4f7af6a9a93774626fbf9b3b8d003022cadbf766'],1,1,2,6594378,1,,,,7758
c116140c8f225e331286ee24f5abf9ed5a9a60bd,0,scnakandala,2015-11-17 15:50:27-05:00,['ef5756d719c2440c2bcbe5c181673d3245498de1'],4773,7922,12695,6607073,78,0.29329494,0.321266968,0.942821884,7758
13b50f7a50ee55439ad7cef5b73978a448b68d3f,1,Chathuri Wimalasena,2015-11-17 19:57:45-05:00,['c116140c8f225e331286ee24f5abf9ed5a9a60bd'],2159,2520,4679,6611752,36,0.220640569,0.220640569,1,7760
e25f6fbb47ae39b5007263c6861dcc9023087282,1,Chathuri Wimalasena,2015-11-19 10:48:02-05:00,['13b50f7a50ee55439ad7cef5b73978a448b68d3f'],0,2,2,6611754,1,,,,7760
77841a4eac53a5e7c7c2308fddf3ceae73566d7d,1,Chathuri Wimalasena,2015-11-19 16:15:07-05:00,['e25f6fbb47ae39b5007263c6861dcc9023087282'],1,1,2,6611756,1,,,,7760
4c0978b61d3ebdb9f6540d7f2c4268de61bf6473,1,Chathuri Wimalasena,2015-11-23 10:58:05-05:00,['77841a4eac53a5e7c7c2308fddf3ceae73566d7d'],867,1780,2647,6614403,98,0.121405751,0.079872204,0.907348243,7761
ca89eaee465933f73cbf010751068a6fa276aef8,1,Chathuri Wimalasena,2015-11-23 14:21:52-05:00,['4c0978b61d3ebdb9f6540d7f2c4268de61bf6473'],4098,4754,8852,6623255,97,0.235109718,0.304075235,0.993730408,7771
9943dbff2857be3f4f4ae2ce5acbf343ce864b1d,0,Shameera Rathnayaka,2015-11-23 14:52:29-05:00,['6aaea39d12aec2ffc8d969ebaa5eccd90aaa7f2f'],5,15,20,6623275,1,0,0,1,7771
9e4dccffc79655c44d66cd82166c3b04bed13ff7,0,Shameera Rathnayaka,2015-11-23 14:53:21-05:00,"['9943dbff2857be3f4f4ae2ce5acbf343ce864b1d', 'ca89eaee465933f73cbf010751068a6fa276aef8']",19918,42584,62502,6685777,183,,,,7771
bb5be4b5edf91eaf7d54c4564e9615e3bd5021b9,0,Shameera Rathnayaka,2015-11-23 15:03:49-05:00,['9e4dccffc79655c44d66cd82166c3b04bed13ff7'],14,24,38,6685815,1,0,0,1,7771
0de9433c035e0fbf715f66e3fd60b34f9e7774ea,1,Chathuri Wimalasena,2015-11-24 10:43:07-05:00,['bb5be4b5edf91eaf7d54c4564e9615e3bd5021b9'],1,34,35,6685850,10,0.571428571,0.80952381,1,7771
5e636cb88d26cd3a081c788d9043cffd79f72443,0,Chathuri Wimalasena,2015-11-24 12:16:48-05:00,['0de9433c035e0fbf715f66e3fd60b34f9e7774ea'],1,25,26,6685876,2,0,0,0.529411765,7771
42f071cabfcf9ab95b5d6b9322dbb87b05c35aeb,0,Chathuri Wimalasena,2015-11-24 15:32:47-05:00,['5e636cb88d26cd3a081c788d9043cffd79f72443'],38,44,82,6685958,7,0,0,1,7771
c135fbf8c68101d5941ef9bd8cfd8a80db106835,0,Chathuri Wimalasena,2015-11-25 14:56:36-05:00,['ee330724ff94bc6d2e197729637c5535af8081e7'],301,133,434,6686392,81,0.789855072,0.898550725,0.007246377,7771
497178dea0deb5b9e8911c6bb869da4b32facdd1,1,Shameera Rathnayaka,2015-11-25 15:05:19-05:00,['bb5be4b5edf91eaf7d54c4564e9615e3bd5021b9'],50,95,145,6686537,6,0.47826087,1,1,7771
a6b1785a3ca3998e766a64e3bfb1301f7ba2a7c2,0,Shameera Rathnayaka,2015-11-25 15:05:30-05:00,"['497178dea0deb5b9e8911c6bb869da4b32facdd1', '42f071cabfcf9ab95b5d6b9322dbb87b05c35aeb']",40,103,143,6686680,19,,,,7771
766433652a3c968917b3200e8fd248e9e6a65280,0,Chathuri Wimalasena,2015-11-25 15:11:24-05:00,['c135fbf8c68101d5941ef9bd8cfd8a80db106835'],27,0,27,6686707,6,0.263157895,0.263157895,0.052631579,7771
3d16cbccec4cfedf7bbef6ebca3d3bba107e3855,0,Shameera Rathnayaka,2015-11-30 16:33:29-05:00,['a6b1785a3ca3998e766a64e3bfb1301f7ba2a7c2'],25,44,69,6686776,4,0,0.733333333,1,7771
086fbba6c137b37c03396e9f52b9632ff9ee0857,0,Shameera Rathnayaka,2015-11-30 16:45:20-05:00,['3d16cbccec4cfedf7bbef6ebca3d3bba107e3855'],3,3,6,6686782,2,1,1,1,7771
fbc558ddc4ecce57833fdaff9062f264a631e2ad,0,Chathuri Wimalasena,2015-12-01 15:52:14-05:00,['766433652a3c968917b3200e8fd248e9e6a65280'],3,9,12,6686794,1,0,0,1,7771
9bfdc52ad04336fab79930a1b5be5ddb06310524,1,scnakandala,2015-12-03 01:53:29-05:00,['086fbba6c137b37c03396e9f52b9632ff9ee0857'],106,6517,6623,6693417,122,0.308626673,0.390183441,0.988349033,7805
6242acac3a489c3ddfd03b2dd265c9b71f0f893c,1,scnakandala,2015-12-03 12:48:58-05:00,['9bfdc52ad04336fab79930a1b5be5ddb06310524'],545,779,1324,6694741,94,1,1,0.732394366,7806
0d9a61264c41a106716e493c99be3da79d42c224,1,Chathuri Wimalasena,2015-12-03 14:26:27-05:00,['9bfdc52ad04336fab79930a1b5be5ddb06310524'],185,4974,5159,6699900,124,0.456584961,0.546323224,0.789779809,7830
9bf53d2c1879bf01e5732b486a58f6627949457e,1,scnakandala,2015-12-04 01:46:28-05:00,['6242acac3a489c3ddfd03b2dd265c9b71f0f893c'],414,1411,1825,6701725,43,0.227184466,0.380582524,0.450485437,7841
5870ed4ff055dba7a41b89b073bb5b9c3abbc6ce,0,scnakandala,2015-12-04 01:49:53-05:00,"['9bf53d2c1879bf01e5732b486a58f6627949457e', '0d9a61264c41a106716e493c99be3da79d42c224']",107,4896,5003,6706728,47,,,,7841
bd1cc2f51a917149dca2f0589828a65b67888731,0,scnakandala,2015-12-04 02:21:36-05:00,['5870ed4ff055dba7a41b89b073bb5b9c3abbc6ce'],7,8,15,6706743,1,0,0,0,7841
242a40331bf321feccd559f0f1e6a0bc339625e7,0,scnakandala,2015-12-04 14:44:08-05:00,['bd1cc2f51a917149dca2f0589828a65b67888731'],2,332,334,6707077,3,0.200854701,0.448717949,1,7842
fc277b0a21f2daf7eae057ea9fd877c591c429db,0,Shameera Rathnayaka,2015-12-04 15:59:55-05:00,"['fbc558ddc4ecce57833fdaff9062f264a631e2ad', '242a40331bf321feccd559f0f1e6a0bc339625e7']",17554,49514,67068,6774145,299,,,,7842
62aee2081fb9db8d28f5d0af9b30c91f7c5b5c76,1,Chathuri Wimalasena,2015-12-07 16:30:37-05:00,['fc277b0a21f2daf7eae057ea9fd877c591c429db'],98,211,309,6774454,19,0.944444444,0.444444444,0,7843
777af1920801c76946b793b0b970730be2bcffd6,1,scnakandala,2015-12-07 17:00:19-05:00,['62aee2081fb9db8d28f5d0af9b30c91f7c5b5c76'],31,29,60,6774514,11,0,0,0.5,7843
cea3e002a432b42b3dba340898c957e5d5d1be1b,0,Chathuri Wimalasena,2015-12-08 12:17:06-05:00,['777af1920801c76946b793b0b970730be2bcffd6'],4,27,31,6774545,2,,,,7843
451a7dbde7d86049f6698531c36ce8af371630fa,0,Chathuri Wimalasena,2015-12-08 12:25:12-05:00,['cea3e002a432b42b3dba340898c957e5d5d1be1b'],2,2,4,6774549,2,,,,7843
f3ef897526c2e45222b7e95fa549635dcd265df8,0,Chathuri Wimalasena,2015-12-08 12:29:54-05:00,['451a7dbde7d86049f6698531c36ce8af371630fa'],2,2,4,6774553,2,,,,7843
4dd4482fc742310a1fa52482d5c0e40d21e28f12,0,Chathuri Wimalasena,2015-12-08 12:33:11-05:00,['f3ef897526c2e45222b7e95fa549635dcd265df8'],4,4,8,6774561,2,,,,7843
e14734617fdaca2142641ae47be3ec669ed7c9a1,0,Chathuri Wimalasena,2015-12-08 14:22:07-05:00,['4dd4482fc742310a1fa52482d5c0e40d21e28f12'],0,1,1,6774562,1,0,0,1,7843
c46d5dcbe4802fe7a6a16c690103617901725e2e,0,scnakandala,2015-12-08 16:19:54-05:00,['777af1920801c76946b793b0b970730be2bcffd6'],1,11,12,6774574,1,0,1,1,7843
17d1b4f99f51e530b21feb14d9b47b4fddf5b6eb,0,scnakandala,2015-12-08 16:21:46-05:00,"['c46d5dcbe4802fe7a6a16c690103617901725e2e', 'e14734617fdaca2142641ae47be3ec669ed7c9a1']",6,30,36,6774610,4,,,,7843
6a9a12542fab7f5c2b87fda5841e4e582a83740d,1,smarru,2015-12-08 23:53:26-05:00,['dd32d065ea8d9bfedf80cdf48db1a2704dbcafb2'],22540,43208,65748,6840358,87,0.332290167,0.385178694,0.937034487,7843
72dee689b08625817b2f518abbaff0f3232a7e4e,0,smarru,2015-12-09 00:03:39-05:00,"['6a9a12542fab7f5c2b87fda5841e4e582a83740d', '17d1b4f99f51e530b21feb14d9b47b4fddf5b6eb']",4747,23439,28186,6868544,244,,,,7843
e52b5b6c58c4904f2086a535d1d72fdcaacc0c2a,0,smarru,2015-12-09 00:07:17-05:00,['72dee689b08625817b2f518abbaff0f3232a7e4e'],9,9,18,6868562,9,,,,7843
e32f941b4ec64c021f14f0c03039396e64dc1fcc,0,smarru,2015-12-09 01:04:51-05:00,['e52b5b6c58c4904f2086a535d1d72fdcaacc0c2a'],0,2,2,6868564,1,,,,7843
e8adfe18ede3081e60eb1afb107a67c01eaf3776,1,Chathuri Wimalasena,2015-12-09 11:46:23-05:00,['e32f941b4ec64c021f14f0c03039396e64dc1fcc'],24,50,74,6868638,6,0,0,1,7843
52ccf87e5cb79aee338bad62ea8f47506b66e4f8,1,Chathuri Wimalasena,2015-12-10 10:51:21-05:00,['e8adfe18ede3081e60eb1afb107a67c01eaf3776'],196,591,787,6869425,4,0.286486486,0.427027027,0.92972973,7844
c1989e76c363e7e418c9a48dfc9e2cd1059e998c,0,Chathuri Wimalasena,2015-12-10 16:04:49-05:00,['52ccf87e5cb79aee338bad62ea8f47506b66e4f8'],8,0,8,6869433,1,0,0,0,7844
61201b148b0ebe3e67f38ab961828906ab3a7923,1,Chathuri Wimalasena,2015-12-10 16:29:08-05:00,['c1989e76c363e7e418c9a48dfc9e2cd1059e998c'],2122,5868,7990,6877423,96,0.414537603,0.559193955,0.918675783,7844
ed3d892c0b43b7abba36b36edf74200a8c9137a0,1,scnakandala,2015-12-10 19:16:58-05:00,['52ccf87e5cb79aee338bad62ea8f47506b66e4f8'],2162,1945,4107,6881530,108,0.28358209,0.210613599,1,7846
61fa8b555de894bf724302e2494d1eb478353c6c,0,scnakandala,2015-12-10 19:17:11-05:00,"['ed3d892c0b43b7abba36b36edf74200a8c9137a0', '61201b148b0ebe3e67f38ab961828906ab3a7923']",2052,5790,7842,6889372,20,,,,7846
7f777502186269bd9ea0717b732a4ec100416793,1,scnakandala,2015-12-11 00:17:40-05:00,['61fa8b555de894bf724302e2494d1eb478353c6c'],29378,39853,69231,6958603,88,0.370607029,0.44600639,0.932268371,7846
74973e9b641b461f6458601cdb2135eabcca93a4,0,smarru,2015-12-11 14:04:47-05:00,['7f777502186269bd9ea0717b732a4ec100416793'],1,1,2,6958605,1,,,,7846
87df389f7b9fda295a57328996a49168681088c5,0,smarru,2015-12-11 14:06:57-05:00,['74973e9b641b461f6458601cdb2135eabcca93a4'],0,130,130,6958735,2,1,1,1,7848
a933ba906de8951aa2079fba66e7ab821f977a0e,1,Chathuri Wimalasena,2015-12-11 14:14:24-05:00,['87df389f7b9fda295a57328996a49168681088c5'],0,5,5,6958740,1,1,1,1,7848
080f7ae90773be1c8b112da35ba64b2c9a46bc77,0,scnakandala,2015-12-11 14:28:38-05:00,['7f777502186269bd9ea0717b732a4ec100416793'],0,130,130,6958870,2,1,1,1,7850
a30e5eaa3dcd5d88d395b1d09c866c09f844ad23,0,scnakandala,2015-12-11 14:28:42-05:00,"['080f7ae90773be1c8b112da35ba64b2c9a46bc77', 'a933ba906de8951aa2079fba66e7ab821f977a0e']",1,6,7,6958877,2,,,,7850
55a1053a5ccf97af3e99cdead06d7be05d83af33,0,scnakandala,2015-12-11 14:36:49-05:00,['a30e5eaa3dcd5d88d395b1d09c866c09f844ad23'],2,1,3,6958880,1,0,0,0,7850
305bc04419d8376695dcfe000ad4f2814303e1e9,1,scnakandala,2015-12-11 21:41:39-05:00,['55a1053a5ccf97af3e99cdead06d7be05d83af33'],4,12,16,6958896,2,0,0.25,1,7850
d3a5a5ea608d5193aa9f8826de40c74804ad4242,1,scnakandala,2015-12-14 11:05:06-05:00,['305bc04419d8376695dcfe000ad4f2814303e1e9'],348,1797,2145,6961041,126,0.266025641,0.326923077,0.998931624,7855
94f9af2ddbb2a83cdaee3c74e84280bec2501474,1,Chathuri Wimalasena,2015-12-14 11:11:41-05:00,['d3a5a5ea608d5193aa9f8826de40c74804ad4242'],13,199,212,6961253,5,0.591304348,0.591304348,1,7856
32274f5a88dbf146c0987111d38f2f8cd4da1508,0,scnakandala,2015-12-14 11:17:46-05:00,['d3a5a5ea608d5193aa9f8826de40c74804ad4242'],1,1,2,6961255,1,,,,7856
7a0c97a9b51d92cd80dc709b14d95e4d0e2a14bb,0,scnakandala,2015-12-14 11:18:01-05:00,['32274f5a88dbf146c0987111d38f2f8cd4da1508'],0,40,40,6961295,1,0,0,1,7856
a5ae2f29a341c988efe74192797f0a478e6c1287,0,scnakandala,2015-12-14 11:18:01-05:00,['7a0c97a9b51d92cd80dc709b14d95e4d0e2a14bb'],1,0,1,6961296,1,1,1,0,7856
f28ea2a0c7d8f8f6e0bf186db6fa83b29a855ac0,1,scnakandala,2015-12-14 11:18:01-05:00,['a5ae2f29a341c988efe74192797f0a478e6c1287'],1,1,2,6961298,1,,,,7856
fda09ef998ff578d194de3a481f577e32d13ece3,0,scnakandala,2015-12-14 11:18:47-05:00,['f28ea2a0c7d8f8f6e0bf186db6fa83b29a855ac0'],0,175,175,6961473,2,1,1,1,7858
3912e28b045d36d052095cc008da420698ae6069,0,scnakandala,2015-12-14 11:19:14-05:00,['fda09ef998ff578d194de3a481f577e32d13ece3'],0,1,1,6961474,1,,,,7858
7412c9adc166c9e2d145a70cbd21128497311716,0,scnakandala,2015-12-14 11:23:21-05:00,['3912e28b045d36d052095cc008da420698ae6069'],176,0,176,6961650,3,0,0,0,7858
6c78a0c082cad3fbd3a509af7bf15d673965699d,0,scnakandala,2015-12-14 11:23:24-05:00,"['7412c9adc166c9e2d145a70cbd21128497311716', '94f9af2ddbb2a83cdaee3c74e84280bec2501474']",13,199,212,6961862,5,,,,7858
9709417eb9f92c0a7711875d0442a2ae640fff5a,0,scnakandala,2015-12-14 11:31:26-05:00,['6c78a0c082cad3fbd3a509af7bf15d673965699d'],39,0,39,6961901,1,1,1,0,7858
b8a0335477db74e845b2e7babc649ec6a583f609,0,scnakandala,2015-12-14 11:47:56-05:00,['9709417eb9f92c0a7711875d0442a2ae640fff5a'],5,0,5,6961906,1,,,,7858
727749871502545a45336a88ad30bcc773377cc7,1,Chathuri Wimalasena,2015-12-14 12:27:00-05:00,['b8a0335477db74e845b2e7babc649ec6a583f609'],3,28,31,6961937,6,0.9375,0.9375,1,7858
156976b180a622e75179f3bbe1758e1c6cfa3eae,0,Shameera Rathnayaka,2015-12-14 12:29:57-05:00,['b8a0335477db74e845b2e7babc649ec6a583f609'],4,14,18,6961955,2,0,0,1,7858
150aa8014190cd5a05dcf53716978dbd5a2058f8,0,Shameera Rathnayaka,2015-12-14 12:30:15-05:00,"['156976b180a622e75179f3bbe1758e1c6cfa3eae', '727749871502545a45336a88ad30bcc773377cc7']",3,28,31,6961986,6,,,,7858
bd457c2d5b474aead5a81add3bfa26f0f65db30b,0,Shameera Rathnayaka,2015-12-14 14:06:50-05:00,['150aa8014190cd5a05dcf53716978dbd5a2058f8'],6,12,18,6962004,1,0,0.833333333,1,7858
8f820e5a5ee9b86be04e137040824d6d0e7da62c,1,Chathuri Wimalasena,2015-12-14 14:24:00-05:00,['bd457c2d5b474aead5a81add3bfa26f0f65db30b'],2,2,4,6962008,1,,,,7858
f1c4c9707d5984e1ae409f8178b62bc06c393e14,0,Shameera Rathnayaka,2015-12-14 15:49:21-05:00,['bd457c2d5b474aead5a81add3bfa26f0f65db30b'],135,99,234,6962242,7,0.734693878,1,0,7858
c09cc861c6963d2f3963d28fd7e8f53efecc7037,0,Shameera Rathnayaka,2015-12-14 15:49:32-05:00,"['f1c4c9707d5984e1ae409f8178b62bc06c393e14', '8f820e5a5ee9b86be04e137040824d6d0e7da62c']",2,2,4,6962246,1,,,,7858
89d879e49aa7c58e388a7a35007e689490cf5cb3,0,Shameera Rathnayaka,2015-12-14 16:53:42-05:00,['c09cc861c6963d2f3963d28fd7e8f53efecc7037'],2,2,4,6962250,1,,,,7858
0a2b24c0a2bb3e4c1dfbedee98270a52646d62ba,0,Shameera Rathnayaka,2015-12-14 17:00:40-05:00,['89d879e49aa7c58e388a7a35007e689490cf5cb3'],2,2,4,6962254,1,,,,7858
9ef67cdf3f7e4af1e80bdaf7bee1e3a61df6dcb8,0,Shameera Rathnayaka,2015-12-14 17:15:05-05:00,['0a2b24c0a2bb3e4c1dfbedee98270a52646d62ba'],1,5,6,6962260,1,0,0,0,7858
6c5e9954ab0a6ee3448500ccfd1a6181990aa87e,1,smarru,2015-12-14 23:44:05-05:00,['9ef67cdf3f7e4af1e80bdaf7bee1e3a61df6dcb8'],490,327,817,6963077,49,,,,7860
0dc7e845235d71553b44233bb072ae2d0bd27bd2,1,scnakandala,2015-12-15 11:40:36-05:00,['6c5e9954ab0a6ee3448500ccfd1a6181990aa87e'],1,1,2,6963079,1,,,,7860
098c2306b2a62ae72e0d38b7d66fd2e15ab6808f,1,scnakandala,2015-12-15 13:30:39-05:00,['0dc7e845235d71553b44233bb072ae2d0bd27bd2'],558,616,1174,6964253,110,,,,7862
60295a5fc3312952b428c08f2fa049fe19ae3ad7,0,Eroma Abeysinghe,2015-12-15 15:28:46-05:00,['098c2306b2a62ae72e0d38b7d66fd2e15ab6808f'],0,11,11,6964264,1,,,,7862
7de199dbe4a56417f9d6ca12cdf3454e09ee964c,0,Eroma Abeysinghe,2015-12-15 15:42:49-05:00,['60295a5fc3312952b428c08f2fa049fe19ae3ad7'],0,10,10,6964274,1,,,,7862
501f30bff7738dd712f2b5f4d328ac384f9c51d7,0,Eroma Abeysinghe,2015-12-15 15:51:38-05:00,['7de199dbe4a56417f9d6ca12cdf3454e09ee964c'],3,3,6,6964280,1,,,,7862
ee1d26ca7b6a3090287eacb283cd64622059adac,0,Eroma Abeysinghe,2015-12-15 16:00:26-05:00,['501f30bff7738dd712f2b5f4d328ac384f9c51d7'],6,7,13,6964293,1,,,,7862
8eb545e534905772c7bf632b188d66248ddf9033,0,Eroma Abeysinghe,2015-12-15 16:09:03-05:00,['ee1d26ca7b6a3090287eacb283cd64622059adac'],7,34,41,6964334,1,,,,7862
50cdfceefbe052cb31916616b03c2ea8e5088858,0,Eroma Abeysinghe,2015-12-15 16:13:07-05:00,['8eb545e534905772c7bf632b188d66248ddf9033'],5,5,10,6964344,1,,,,7862
a059fbba7922e99c5f84a4175aea4cb13e77dd6e,0,Eroma Abeysinghe,2015-12-15 16:47:47-05:00,['50cdfceefbe052cb31916616b03c2ea8e5088858'],0,39,39,6964383,1,,,,7862
ae5dab464230131201b7c4a100f5e2d8a6c9c31c,1,scnakandala,2015-12-15 21:08:00-05:00,['098c2306b2a62ae72e0d38b7d66fd2e15ab6808f'],787,2373,3160,6967543,40,0.098387097,0.249193548,0.987096774,7862
77a7e77e92090b5d949e24d77e7a788637265a5d,0,scnakandala,2015-12-15 21:08:25-05:00,['ae5dab464230131201b7c4a100f5e2d8a6c9c31c'],0,76,76,6967619,3,1,1,1,7863
1f0337851990253fca055e1c1d8be7cd1a93b7ff,0,scnakandala,2015-12-15 21:08:33-05:00,['77a7e77e92090b5d949e24d77e7a788637265a5d'],62,154,216,6967835,2,0,0,0,7864
b9baeeb8828ebbd846c344adf9630d1ba9274899,0,scnakandala,2015-12-15 21:08:46-05:00,['1f0337851990253fca055e1c1d8be7cd1a93b7ff'],0,11,11,6967846,1,0,0,1,7864
2d355144660d67ce9253276bef62c3a10353f707,0,scnakandala,2015-12-15 21:09:14-05:00,['b9baeeb8828ebbd846c344adf9630d1ba9274899'],20,126,146,6967992,6,,,,7869
13667e77e68f92c79f260bc200d3443e0713e4ca,0,scnakandala,2015-12-15 21:09:35-05:00,['2d355144660d67ce9253276bef62c3a10353f707'],4,109,113,6968105,6,1,1,1,7869
5d80c91d29620f610217c9d1e6fc7b64fb60381c,0,scnakandala,2015-12-15 21:11:16-05:00,['13667e77e68f92c79f260bc200d3443e0713e4ca'],0,66943,66943,7035048,102,0.375616647,0.43190264,0.993893296,7971
d3d5c97ab7ddeedb042299b266af1ef4966148f8,0,scnakandala,2015-12-15 21:11:38-05:00,['5d80c91d29620f610217c9d1e6fc7b64fb60381c'],1974,3102,5076,7040124,9,0.663316583,0.590093324,0,7973
387a8f6f7511d04a4541dad7ee7daf49c0951fb2,0,scnakandala,2015-12-15 21:11:40-05:00,['d3d5c97ab7ddeedb042299b266af1ef4966148f8'],76,804,880,7041004,2,0.370808679,0.406311637,1,7974
15d8293ce3d72943d0b855798610e56cfbb87f71,0,scnakandala,2015-12-15 21:11:40-05:00,['387a8f6f7511d04a4541dad7ee7daf49c0951fb2'],17,1206,1223,7042227,8,0.265931373,0.525735294,1,7979
e02286bec59eb24b3e8b1d3f1bbcb84c3eef127f,0,smarru,2015-12-15 22:03:18-05:00,['a059fbba7922e99c5f84a4175aea4cb13e77dd6e'],1,1,2,7042229,1,,,,7979
81b54855d7cbd3386984780e0b0e27f6a9a4ffe0,1,scnakandala,2015-12-15 22:49:33-05:00,['15d8293ce3d72943d0b855798610e56cfbb87f71'],3095,1065,4160,7046389,13,0.206015038,0.233082707,1,7981
20f19e87ffc910d0b7436aebee99de7f522d8b98,0,scnakandala,2015-12-15 22:50:20-05:00,"['81b54855d7cbd3386984780e0b0e27f6a9a4ffe0', 'e02286bec59eb24b3e8b1d3f1bbcb84c3eef127f']",9,97,106,7046495,2,,,,7981
a513dcdeb8ff260ff18afa0a5ac244e44af8eba3,1,smarru,2015-12-15 23:55:51-05:00,['20f19e87ffc910d0b7436aebee99de7f522d8b98'],5957,20296,26253,7072748,269,0.149606299,0.054593176,0.761079865,7981
7ea88a2b91cebb313a6484fdf24674ce79bc552d,0,Eroma Abeysinghe,2015-12-16 09:24:00-05:00,['a059fbba7922e99c5f84a4175aea4cb13e77dd6e'],0,27,27,7072775,1,,,,7981
9462bd184566977462fd701450844ed389be06f6,0,Eroma Abeysinghe,2015-12-16 09:36:04-05:00,"['7ea88a2b91cebb313a6484fdf24674ce79bc552d', 'a513dcdeb8ff260ff18afa0a5ac244e44af8eba3']",6703,90976,97679,7170454,422,,,,7981
4c8d396745b1ed13c3fe7ff17f16aff012cd9ac4,0,Eroma Abeysinghe,2015-12-16 09:42:35-05:00,['9462bd184566977462fd701450844ed389be06f6'],1,14,15,7170469,1,,,,7981
d8987244b58c030c468d55158a76e9bf52f41250,0,Eroma Abeysinghe,2015-12-16 09:44:34-05:00,['4c8d396745b1ed13c3fe7ff17f16aff012cd9ac4'],0,12,12,7170481,1,,,,7981
648a0cb9931e616b9f8616e3879cae3fdfe8d81b,0,Eroma Abeysinghe,2015-12-16 09:51:52-05:00,['d8987244b58c030c468d55158a76e9bf52f41250'],37,64,101,7170582,1,,,,7981
3aa2e09a87c230abb2e6066540706189a6b347fa,0,Eroma Abeysinghe,2015-12-16 10:23:36-05:00,['648a0cb9931e616b9f8616e3879cae3fdfe8d81b'],2,55,57,7170639,1,,,,7981
389268fad4b1a2d93082981421b21fe3efe0da87,0,Eroma Abeysinghe,2015-12-16 11:10:24-05:00,['3aa2e09a87c230abb2e6066540706189a6b347fa'],32,164,196,7170835,1,,,,7981
efa66f9baca32c3e3b95c3e8688140b59b6522e1,0,Eroma Abeysinghe,2015-12-16 11:18:50-05:00,['389268fad4b1a2d93082981421b21fe3efe0da87'],8,32,40,7170875,1,,,,7981
80d202785f05f76fee6fa6461c38cfd759444740,0,smarru,2015-12-16 11:34:09-05:00,['efa66f9baca32c3e3b95c3e8688140b59b6522e1'],1240,4,1244,7172119,11,0.684297521,0.426446281,0,7981
5d0bee58d24cf77dbd9238eef235bf6e250fdfc4,0,scnakandala,2015-12-16 14:27:06-05:00,['80d202785f05f76fee6fa6461c38cfd759444740'],3,3,6,7172125,1,,,,7981
36da4ee4dac92bba6104d9bc9d89e22e1e837d96,1,scnakandala,2015-12-16 15:14:17-05:00,['5d0bee58d24cf77dbd9238eef235bf6e250fdfc4'],1644,2648,4292,7176417,93,0.872294372,0.718614719,0.006493506,7981
6572a821436871df07d5747949c16c14fce69444,1,scnakandala,2015-12-16 18:21:39-05:00,['36da4ee4dac92bba6104d9bc9d89e22e1e837d96'],18195,22154,40349,7216766,24,0.264241592,0.31297186,0.781743308,7986
1837eea8cd2a0c2114b45ee463f0d56540a3f88d,1,scnakandala,2015-12-16 22:30:40-05:00,['6572a821436871df07d5747949c16c14fce69444'],28,114,142,7216908,6,0,0,1,7987
fd62b238e14bb769c887121731f4f39b0777527e,0,scnakandala,2015-12-16 22:42:54-05:00,['1837eea8cd2a0c2114b45ee463f0d56540a3f88d'],6,6,12,7216920,2,,,,7987
3d5bf9eeacdc2dacf0b9425e555eade954c18314,0,scnakandala,2015-12-16 22:45:30-05:00,['fd62b238e14bb769c887121731f4f39b0777527e'],9,4,13,7216933,2,1,1,0,7987
ee8a15e4d7fad3c73fb23f70fc1c8ecf49f37c89,1,scnakandala,2015-12-16 23:34:17-05:00,['3d5bf9eeacdc2dacf0b9425e555eade954c18314'],9,14,23,7216956,3,0,0,1,7987
74201879bd02ebf40c0f6874da42bc3df8a79817,0,scnakandala,2015-12-17 00:11:36-05:00,['ee8a15e4d7fad3c73fb23f70fc1c8ecf49f37c89'],1,1,2,7216958,1,,,,7987
52f18ba682f3255fa67c13e75e7c53375425779e,0,smarru,2015-12-17 00:48:25-05:00,['74201879bd02ebf40c0f6874da42bc3df8a79817'],19821,5965,25786,7242744,269,0.85109076,0.945722582,0.239669421,7987
f4aafbfe32386dfc2360afc9ffffe7a681cf1f38,0,smarru,2015-12-17 00:54:43-05:00,['52f18ba682f3255fa67c13e75e7c53375425779e'],1,1,2,7242746,1,,,,7987
b490671ec110d8e82591c2531b2d863eadb29f87,1,scnakandala,2015-12-17 10:45:28-05:00,['f4aafbfe32386dfc2360afc9ffffe7a681cf1f38'],71770,19823,91593,7334339,368,0.531289269,0.412666499,0,7987
679771b4e240cb71d481db3546a56dd417e6a6c2,0,scnakandala,2015-12-17 11:28:28-05:00,['b490671ec110d8e82591c2531b2d863eadb29f87'],407,48,455,7334794,12,0.829787234,0,0,7987
3f0d74a5b35b0e7492e8290486b35b73d6a7381c,1,scnakandala,2015-12-17 11:34:10-05:00,['679771b4e240cb71d481db3546a56dd417e6a6c2'],7,5,12,7334806,3,0,1,1,7987
75109b640a502e7e804aaef897044ce72f25c617,0,Chathuri Wimalasena,2015-12-17 12:22:30-05:00,['3f0d74a5b35b0e7492e8290486b35b73d6a7381c'],0,4,4,7334810,1,0,0,0,7987
798bbf044e270c2a9cca4c09414200db1e1b821c,0,scnakandala,2015-12-17 12:51:00-05:00,['3f0d74a5b35b0e7492e8290486b35b73d6a7381c'],4,8,12,7334822,2,,,,7987
de9fe01c342601894472a6430606de02266fdcc3,0,scnakandala,2015-12-17 12:52:17-05:00,"['798bbf044e270c2a9cca4c09414200db1e1b821c', '75109b640a502e7e804aaef897044ce72f25c617']",0,4,4,7334826,1,,,,7987
e3a183e8a2210052d9eb28ea35eaa138cf96e4ce,0,scnakandala,2015-12-17 13:22:52-05:00,['de9fe01c342601894472a6430606de02266fdcc3'],11,20,31,7334857,2,0,0.166666667,0.166666667,7987
d8cb96589790b59909035f3cdf8890a69ce76c7f,0,scnakandala,2015-12-17 13:44:42-05:00,['e3a183e8a2210052d9eb28ea35eaa138cf96e4ce'],4,5,9,7334866,1,,,,7987
55f8e2509ef96598bac19a6f9619aabaeb79d61e,0,scnakandala,2015-12-17 13:51:30-05:00,['d8cb96589790b59909035f3cdf8890a69ce76c7f'],2,2,4,7334870,2,,0,0,7987
5c6899a49761dd34ce1c3c9bf2f2550f34f99412,0,scnakandala,2015-12-17 14:04:30-05:00,['55f8e2509ef96598bac19a6f9619aabaeb79d61e'],0,6,6,7334876,1,0,0,0,7987
392260101b18f8f5546bc88baa3c6ee060a2305e,0,scnakandala,2015-12-17 17:36:25-05:00,['5c6899a49761dd34ce1c3c9bf2f2550f34f99412'],14,15,29,7334905,3,0,0,0,7987
27383f115b4e0cbed0230f3a75c95b0e238e8a34,0,scnakandala,2015-12-17 17:41:43-05:00,['392260101b18f8f5546bc88baa3c6ee060a2305e'],2,2,4,7334909,1,0,1,1,7987
f3fa0aaa6ce4828321479e185d309ba3b2b4ba4e,0,scnakandala,2015-12-17 17:43:06-05:00,['27383f115b4e0cbed0230f3a75c95b0e238e8a34'],0,2,2,7334911,1,0,1,1,7987
9ba3f030113862cea7cd241507a2de3738b46ec5,1,Chathuri Wimalasena,2015-12-18 10:02:13-05:00,['f3fa0aaa6ce4828321479e185d309ba3b2b4ba4e'],4,10,14,7334925,1,0,1,0.625,7987
ff2b729694ae12d111b06a22564faaa526a99d51,0,scnakandala,2015-12-18 10:25:12-05:00,['f3fa0aaa6ce4828321479e185d309ba3b2b4ba4e'],5,51,56,7334981,2,0.421052632,0.421052632,0,7987
60f479ec42e9a9f369c19077a89ba597108f91bc,1,scnakandala,2015-12-18 10:44:53-05:00,['ff2b729694ae12d111b06a22564faaa526a99d51'],18658,21971,40629,7375610,89,0.292007797,0.300584795,0.895516569,7987
b161ec4ee5ae44460c4e72b9c038f728f72ceeac,1,Chathuri Wimalasena,2015-12-18 14:02:27-05:00,['9ba3f030113862cea7cd241507a2de3738b46ec5'],0,10,10,7375620,2,0,0,1,7987
da42a964d84581bcf05e962c95a0c0d763fc2db3,1,Chathuri Wimalasena,2015-12-18 16:12:41-05:00,['b161ec4ee5ae44460c4e72b9c038f728f72ceeac'],33,12,45,7375665,2,1,1,0,7987
6e7ce92b0d61d6adb4833ef9888027c0f6ae50fa,0,scnakandala,2015-12-20 19:53:28-05:00,"['60f479ec42e9a9f369c19077a89ba597108f91bc', 'da42a964d84581bcf05e962c95a0c0d763fc2db3']",37,32,69,7375734,5,,,,7987
95596496c2651fe0607b861443e397006e39a10f,1,scnakandala,2015-12-21 00:48:55-05:00,['6e7ce92b0d61d6adb4833ef9888027c0f6ae50fa'],54,784,838,7376572,18,0.394789579,0.46492986,1,7988
ea0cf5b3100599a7a89d2468cb9a1bb6001a8b81,0,scnakandala,2015-12-21 10:34:19-05:00,['95596496c2651fe0607b861443e397006e39a10f'],5397,11655,17052,7393624,7,0.387339531,0.454404604,0.922753431,7988
a4b13a3f7165358168f2f680dd0c36384fa12234,0,Chathuri Wimalasena,2015-12-21 11:08:09-05:00,['ea0cf5b3100599a7a89d2468cb9a1bb6001a8b81'],2,2,4,7393628,1,,,,7988
3a8e117d5ecf87fadac836407cea780e3fc0e72c,1,scnakandala,2015-12-21 11:26:28-05:00,['ea0cf5b3100599a7a89d2468cb9a1bb6001a8b81'],11729,5471,17200,7410828,82,0.612660469,0.545595396,0.077246569,7988
8afbcbf3bb15f54046955cc50cf739c2acac3233,0,scnakandala,2015-12-21 11:26:49-05:00,"['3a8e117d5ecf87fadac836407cea780e3fc0e72c', 'a4b13a3f7165358168f2f680dd0c36384fa12234']",2,2,4,7410832,1,,,,7988
47949d3eb370dd40ce34885bd2f943165c03b485,0,Chathuri Wimalasena,2015-12-21 11:59:41-05:00,['8afbcbf3bb15f54046955cc50cf739c2acac3233'],1,2,3,7410835,1,0,1,0,7988
18a4c31b4904448fef63a7e0ea578ddeb9df217f,1,Shameera Rathnayaka,2015-12-21 12:31:14-05:00,['47949d3eb370dd40ce34885bd2f943165c03b485'],17,27,44,7410879,3,0,1,1,7988
f460dba422ba47c5a1b7abac37e631f70badb9c5,1,scnakandala,2015-12-21 14:05:11-05:00,['8afbcbf3bb15f54046955cc50cf739c2acac3233'],7865,15896,23761,7434640,22,0.398756047,0.482722875,0.943503801,7993
b76af43528708c26c7f8412e02dcdb26450d956c,0,scnakandala,2015-12-21 14:05:32-05:00,"['f460dba422ba47c5a1b7abac37e631f70badb9c5', '18a4c31b4904448fef63a7e0ea578ddeb9df217f']",18,29,47,7434687,4,,,,7993
3d8343247336314a6f108bf7996531d36207147a,0,scnakandala,2015-12-21 14:13:18-05:00,['b76af43528708c26c7f8412e02dcdb26450d956c'],61,406,467,7435154,12,0.089655172,0,0.993103448,7993
b7f7fd3b1ac37d266be396dd5167fb5a602063b5,1,scnakandala,2015-12-21 14:48:18-05:00,['3d8343247336314a6f108bf7996531d36207147a'],15593,7880,23473,7458627,15,0.606390449,0.549157303,0.057759831,7993
47ae5b30a95857b625c07d5daa0825b43f1a2fcb,0,scnakandala,2015-12-22 11:37:28-05:00,['b7f7fd3b1ac37d266be396dd5167fb5a602063b5'],1,1,2,7458629,1,,,,7993
5afc8cf54018e285f31ca1d1f0e0ddde44641ad3,0,scnakandala,2015-12-22 13:59:23-05:00,['47ae5b30a95857b625c07d5daa0825b43f1a2fcb'],120,120,240,7458869,81,1,1,0,7993
4a84e86afceb17fc46e9563bd98f948ae73d9e76,1,Chathuri Wimalasena,2015-12-22 14:33:57-05:00,['5afc8cf54018e285f31ca1d1f0e0ddde44641ad3'],4,7,11,7458880,4,,0,,7993
c62f64ae4c9733f913bb1ec6539888cd2666873c,0,Shameera Rathnayaka,2015-12-22 16:30:49-05:00,['18a4c31b4904448fef63a7e0ea578ddeb9df217f'],0,1,1,7458881,1,0,0,1,7993
2d8e3503a2f914299873a2c45052735f6cab0b84,0,Shameera Rathnayaka,2015-12-22 16:30:59-05:00,"['c62f64ae4c9733f913bb1ec6539888cd2666873c', '4a84e86afceb17fc46e9563bd98f948ae73d9e76']",83,749,832,7459713,96,,,,7993
6d0991553008b8f00e5d96e09f1af3710ee12a0b,1,Chathuri Wimalasena,2015-12-23 11:30:33-05:00,['2d8e3503a2f914299873a2c45052735f6cab0b84'],3,9,12,7459725,3,0,0,1,7993
c0ebe04de3cb5369897a2b6c0a7f885c40e611db,1,Chathuri Wimalasena,2016-01-04 14:16:22-05:00,['6d0991553008b8f00e5d96e09f1af3710ee12a0b'],13,13,26,7459751,2,,,,7993
7121dd7dc7b0e6f63f195dde8e51d54a51ff9049,0,Chathuri Wimalasena,2016-01-04 14:35:11-05:00,['c0ebe04de3cb5369897a2b6c0a7f885c40e611db'],1,23,24,7459775,1,0,0.409090909,0.227272727,7993
d2d72e52b2f4475ec179abce180710527de3d7f7,1,scnakandala,2016-01-04 14:36:03-05:00,['6d0991553008b8f00e5d96e09f1af3710ee12a0b'],1,1,2,7459777,1,,,,7993
7523c1e91cdb4300a6904912b97ed185f4dc8353,1,Shameera Rathnayaka,2016-01-04 14:38:20-05:00,['6d0991553008b8f00e5d96e09f1af3710ee12a0b'],15,39,54,7459831,2,0,0,1,7993
6751a37b569afaebad45f280594e8df2d3decb08,1,scnakandala,2016-01-04 14:38:37-05:00,['d2d72e52b2f4475ec179abce180710527de3d7f7'],20,22,42,7459873,7,0,1,1,7993
6efba7c7489e26ec5cf7abc5b6d038400ade702e,0,scnakandala,2016-01-04 14:39:40-05:00,['6751a37b569afaebad45f280594e8df2d3decb08'],0,76,76,7459949,1,1,1,1,7994
f715026910e3ce1bbf419ecf834a2e3c81678c20,0,scnakandala,2016-01-04 14:43:26-05:00,['6efba7c7489e26ec5cf7abc5b6d038400ade702e'],0,0,0,7459949,0,,,,7994
f9b0d2ed61f80b26fd78fddc138188ebc118c939,0,Chathuri Wimalasena,2016-01-04 14:44:53-05:00,"['7121dd7dc7b0e6f63f195dde8e51d54a51ff9049', '7523c1e91cdb4300a6904912b97ed185f4dc8353']",15,39,54,7460003,2,,,,7994
4286bf783eea7e9515b5109f444b7dec1cb23c4b,0,scnakandala,2016-01-04 14:46:34-05:00,"['f715026910e3ce1bbf419ecf834a2e3c81678c20', '7523c1e91cdb4300a6904912b97ed185f4dc8353']",15,39,54,7460057,2,,,,7994
ebf67dac45203c00fbf5d10a4d18b24c0d9cf018,0,Chathuri Wimalasena,2016-01-04 14:48:32-05:00,['f9b0d2ed61f80b26fd78fddc138188ebc118c939'],0,1,1,7460058,1,0,1,1,7994
276267074933bfe0752f35183a191eb22f2f35d9,0,Chathuri Wimalasena,2016-01-04 14:48:59-05:00,"['ebf67dac45203c00fbf5d10a4d18b24c0d9cf018', '4286bf783eea7e9515b5109f444b7dec1cb23c4b']",21,99,120,7460178,9,,,,7994
4409f99681d2a8bfd5ec71d8c48f2fb4d9f6856c,1,Shameera Rathnayaka,2016-01-04 16:00:35-05:00,['7523c1e91cdb4300a6904912b97ed185f4dc8353'],6,9,15,7460193,1,0,0,1,7994
bedf91c1a01166fd5b04c0d99c9a0043026b85cd,0,Shameera Rathnayaka,2016-01-04 16:01:39-05:00,"['4409f99681d2a8bfd5ec71d8c48f2fb4d9f6856c', '276267074933bfe0752f35183a191eb22f2f35d9']",35,136,171,7460364,10,,,,7994
fde02b84c440acd535dfc0a5ccdcad7e46f3352b,1,scnakandala,2016-01-04 17:10:07-05:00,['4286bf783eea7e9515b5109f444b7dec1cb23c4b'],96,3,99,7460463,4,0.272727273,0.272727273,0,7994
88515820221414173461a7b7ae3207afe3a9a621,0,scnakandala,2016-01-04 17:10:24-05:00,"['fde02b84c440acd535dfc0a5ccdcad7e46f3352b', 'bedf91c1a01166fd5b04c0d99c9a0043026b85cd']",20,46,66,7460529,4,,,,7994
1d9eaf8e4c554e4e45db70ff0dc6d72364b12c03,0,Chathuri Wimalasena,2016-01-05 10:30:08-05:00,['88515820221414173461a7b7ae3207afe3a9a621'],14,53,67,7460596,2,0,0.875,0.7,7994
5e4eb57a0ae53daab4ea6e0170a79f2a1b00ca59,1,Chathuri Wimalasena,2016-01-05 10:51:11-05:00,['1d9eaf8e4c554e4e45db70ff0dc6d72364b12c03'],2,2,4,7460600,1,,,,7994
94629e1691dc262a97abf703bd442ce85743223c,1,Chathuri Wimalasena,2016-01-05 10:57:02-05:00,['5e4eb57a0ae53daab4ea6e0170a79f2a1b00ca59'],4,4,8,7460608,1,,,,7994
fc3f979a45f6347b3d6e5494cd44212cca021f22,0,Chathuri Wimalasena,2016-01-05 10:58:32-05:00,['94629e1691dc262a97abf703bd442ce85743223c'],1,1,2,7460610,1,,,,7994
4dc65887241821b23643a930cdd222238cda277c,0,Chathuri Wimalasena,2016-01-05 15:20:53-05:00,['fc3f979a45f6347b3d6e5494cd44212cca021f22'],46,120,166,7460776,1,0,0.972972973,0.472972973,7994
bd7754101a2ffe638caf9be0b24d936713e829a9,1,scnakandala,2016-01-06 11:34:29-05:00,['88515820221414173461a7b7ae3207afe3a9a621'],85,285,370,7461146,90,0.28313253,0.319277108,0.993975904,7994
531cbdfbcdc07893f69f0bea8cec9011fdf3a7b7,0,scnakandala,2016-01-06 11:34:39-05:00,"['bd7754101a2ffe638caf9be0b24d936713e829a9', '4dc65887241821b23643a930cdd222238cda277c']",66,179,245,7461391,2,,,,7994
2fe5278f52522c907908d22cc005f411701b9920,1,scnakandala,2016-01-06 13:10:29-05:00,['531cbdfbcdc07893f69f0bea8cec9011fdf3a7b7'],10,222,232,7461623,14,0.201149425,0.235632184,0.994252874,7994
5ce750d53bc4e8def467b9024c491a463e62203d,1,Shameera Rathnayaka,2016-01-06 14:15:35-05:00,['fc3f979a45f6347b3d6e5494cd44212cca021f22'],41,38,79,7461702,3,1,1,0.571428571,7994
98fc3f58280d126f2c6fd1d03477f8b9a9332838,0,Shameera Rathnayaka,2016-01-06 14:15:50-05:00,"['5ce750d53bc4e8def467b9024c491a463e62203d', '2fe5278f52522c907908d22cc005f411701b9920']",141,627,768,7462470,100,,,,7994
c22a73dc5f6d65956019bb46f2dbbabe660618c2,1,scnakandala,2016-01-06 22:52:51-05:00,['2fe5278f52522c907908d22cc005f411701b9920'],0,1,1,7462471,1,0,1,1,7994
d959615ed5e3e357acb54c27b9647175b3584c27,0,scnakandala,2016-01-06 22:53:00-05:00,"['c22a73dc5f6d65956019bb46f2dbbabe660618c2', '98fc3f58280d126f2c6fd1d03477f8b9a9332838']",41,38,79,7462550,3,,,,7994
51ba07196a8da56c963651fe0e32b95174d296ba,0,scnakandala,2016-01-07 00:30:09-05:00,['d959615ed5e3e357acb54c27b9647175b3584c27'],1,15,16,7462566,1,0,0,0,7994
0b75afd8aa781fcef4ed723449a302526e9c8742,0,scnakandala,2016-01-07 10:27:23-05:00,['51ba07196a8da56c963651fe0e32b95174d296ba'],14,1,15,7462581,1,1,1,1,7994
6d338d07f039bcc30de2d9324a8a37f268ea3b2b,1,Shameera Rathnayaka,2016-01-07 18:32:18-05:00,['0b75afd8aa781fcef4ed723449a302526e9c8742'],18,131,149,7462730,4,0.244897959,0.142857143,0.479591837,7994
545e7534483d271baf999df52e8cdf2b5a12ec45,0,Chathuri Wimalasena,2016-01-08 10:27:15-05:00,['6d338d07f039bcc30de2d9324a8a37f268ea3b2b'],7,21,28,7462758,1,0.222222222,0.444444444,1,7994
4792eac6e173c9ec81bab4f510ebb45da341a3ad,1,Shameera Rathnayaka,2016-01-08 13:36:44-05:00,['545e7534483d271baf999df52e8cdf2b5a12ec45'],26,56,82,7462840,3,0.142857143,0.142857143,0.821428571,7994
843940fa0bdde4e5cca397e8acdf38125c92ee16,1,Shameera Rathnayaka,2016-01-08 16:03:26-05:00,['4792eac6e173c9ec81bab4f510ebb45da341a3ad'],48,123,171,7463011,9,0.31372549,0.68627451,1,7994
c4861b09aecd315436a4d5d10d72e6fdbb18ea4d,1,Chathuri Wimalasena,2016-01-08 22:29:31-05:00,['843940fa0bdde4e5cca397e8acdf38125c92ee16'],0,11,11,7463022,1,0,0,0,7994
cae7925b5d63e0abde7cb11b43edd5debf1701fd,0,Shameera Rathnayaka,2016-01-11 11:07:14-05:00,['c4861b09aecd315436a4d5d10d72e6fdbb18ea4d'],4,4,8,7463030,1,,,,7994
494857a374d12fc2ad9b73e91d85e6519be43cb3,0,Chathuri Wimalasena,2016-01-11 13:48:00-05:00,['cae7925b5d63e0abde7cb11b43edd5debf1701fd'],2,2,4,7463034,1,0,0,0,7994
da4ba5b54778fbea4f250e9ab21330ea4e1856d1,0,Chathuri Wimalasena,2016-01-11 15:18:14-05:00,['494857a374d12fc2ad9b73e91d85e6519be43cb3'],2,2,4,7463038,1,1,1,0,7994
e43b6d9188d4e9b9e13eaece1b8a89f44b30910e,0,Chathuri Wimalasena,2016-01-11 15:57:48-05:00,['da4ba5b54778fbea4f250e9ab21330ea4e1856d1'],7,12,19,7463057,2,0,0,0.25,7994
7c935e75d9c6e69665ff3229d62f03a8c6b49d8d,1,Chathuri Wimalasena,2016-01-13 10:52:00-05:00,['e43b6d9188d4e9b9e13eaece1b8a89f44b30910e'],9,9,18,7463075,2,,,,7994
066473649714e5b22b1964267d0cc06f4c9d3f53,1,Shameera Rathnayaka,2016-01-13 11:02:40-05:00,['7c935e75d9c6e69665ff3229d62f03a8c6b49d8d'],0,4,4,7463079,1,0,1,1,7994
1a30d7f088ff0f31fcab2219fef1f0c9d03a62c0,1,Chathuri Wimalasena,2016-01-13 14:26:07-05:00,['066473649714e5b22b1964267d0cc06f4c9d3f53'],1,4,5,7463084,1,0,0,1,7994
113490efb513365157b512ae35367c3eb08b4306,1,Chathuri Wimalasena,2016-01-15 15:49:21-05:00,['1a30d7f088ff0f31fcab2219fef1f0c9d03a62c0'],4793,7949,12742,7475826,86,0.290242898,0.340469329,0.888019761,7994
0c51c7aa1154161f223a310e6052123ad8b2ed93,0,Chathuri Wimalasena,2016-01-19 10:56:29-05:00,['113490efb513365157b512ae35367c3eb08b4306'],9,24,33,7475859,1,0,0,0,7994
f1e16793be29e68f4fca64c8ada84e0a0fe6a9b6,1,Chathuri Wimalasena,2016-01-19 12:33:25-05:00,['0c51c7aa1154161f223a310e6052123ad8b2ed93'],381,2295,2676,7478535,43,0,0,1,7994
cda9014f87c4aa71d5dff2cd035593c5ee120bae,0,Eroma Abeysinghe,2016-01-19 15:14:37-05:00,['f1e16793be29e68f4fca64c8ada84e0a0fe6a9b6'],0,5,5,7478540,1,,,,7994
70358dff34c253cf73020c389080f03fc4927a98,0,Eroma Abeysinghe,2016-01-19 15:41:04-05:00,['cda9014f87c4aa71d5dff2cd035593c5ee120bae'],3,83,86,7478626,1,,,,7994
101c8d4a3754501b9b1a728b7a4f2267883b06bc,0,Eroma Abeysinghe,2016-01-19 16:43:47-05:00,['70358dff34c253cf73020c389080f03fc4927a98'],34,64,98,7478724,1,,,,7994
20fe7b44a1353b9b5ee060bcf0820b1265951e13,0,Chathuri Wimalasena,2016-01-19 16:43:57-05:00,['70358dff34c253cf73020c389080f03fc4927a98'],18,22,40,7478764,2,0,1,0,7994
8e421f42c34013a9ad4020f8f1f8441470458b16,0,Eroma Abeysinghe,2016-01-19 16:44:13-05:00,"['101c8d4a3754501b9b1a728b7a4f2267883b06bc', '20fe7b44a1353b9b5ee060bcf0820b1265951e13']",18,22,40,7478804,2,,,,7994
ea3380045d73c22ed757e9928d633a3cb2345de0,0,Eroma Abeysinghe,2016-01-20 00:53:32-05:00,['8e421f42c34013a9ad4020f8f1f8441470458b16'],36,64,100,7478904,1,,,,7994
9ce83af821814636653f1b98b7002147e7d16c12,0,Eroma Abeysinghe,2016-01-20 10:38:49-05:00,['ea3380045d73c22ed757e9928d633a3cb2345de0'],156,236,392,7479296,1,,,,7994
d527fc5a50665802569676d65df63c4372c9c3b2,0,Chathuri Wimalasena,2016-01-20 12:05:47-05:00,['9ce83af821814636653f1b98b7002147e7d16c12'],1,7,8,7479304,2,0,0,0,7994
d79055a693f3d0a417b4ac611c02cedec95985e7,0,Chathuri Wimalasena,2016-01-20 13:32:32-05:00,['d527fc5a50665802569676d65df63c4372c9c3b2'],1,1,2,7479306,1,,,,7994
462843a47c276806a57bd197400f0664eef13dcd,0,Chathuri Wimalasena,2016-01-20 14:44:27-05:00,['d79055a693f3d0a417b4ac611c02cedec95985e7'],18,11,29,7479335,7,,,,7994
e2b2951271f42011ce2ae8af232a15de9e53c3dd,0,Chathuri Wimalasena,2016-01-25 15:09:07-05:00,['462843a47c276806a57bd197400f0664eef13dcd'],1,3,4,7479339,1,1,1,1,7994
fa4c1876244fead06addc49cd75d256594925089,0,Chathuri Wimalasena,2016-01-26 12:15:07-05:00,['e2b2951271f42011ce2ae8af232a15de9e53c3dd'],1,1,2,7479341,1,,,,7994
819c5e286eda098b7c47bd30391fbd477665ba31,0,Chathuri Wimalasena,2016-01-27 15:26:00-05:00,['fa4c1876244fead06addc49cd75d256594925089'],1,1,2,7479343,1,,,,7994
b5d568d7dc0ab393d66300610f2c6f9c9ce2ae69,0,Chathuri Wimalasena,2016-01-28 11:59:42-05:00,['819c5e286eda098b7c47bd30391fbd477665ba31'],11,12,23,7479366,1,,,,7994
b65079a75e8a67d4c48832bcd7a168a0aa3b7d99,0,Shameera Rathnayaka,2016-02-01 12:01:48-05:00,['b5d568d7dc0ab393d66300610f2c6f9c9ce2ae69'],78,82,160,7479526,4,1,1,,7995
1ec4efbfa7bba2e1f606f1fce58729dfc3079d26,0,Shameera Rathnayaka,2016-02-01 12:02:26-05:00,['b65079a75e8a67d4c48832bcd7a168a0aa3b7d99'],2,56,58,7479584,1,,,,7995
97f4ba9259170ec7f61971e57351f06c9b6c3564,0,Shameera Rathnayaka,2016-02-01 12:30:11-05:00,['1ec4efbfa7bba2e1f606f1fce58729dfc3079d26'],76,4753,4829,7484413,84,0.374100719,0.41757898,0.996872068,8003
09be4d92b579830e8f14d96b11c53b3acd8ae928,0,Shameera Rathnayaka,2016-02-01 12:48:04-05:00,['97f4ba9259170ec7f61971e57351f06c9b6c3564'],46,4,50,7484463,2,0,0,0,8003
494e0d735a7531894f04f9d01b3602357a05c7c6,0,Shameera Rathnayaka,2016-02-01 12:49:30-05:00,['09be4d92b579830e8f14d96b11c53b3acd8ae928'],14,226,240,7484703,1,0,0,1,8003
9859af32bfd71aa95ec0e5e170d4937398899ecd,0,Shameera Rathnayaka,2016-02-01 13:17:05-05:00,['494e0d735a7531894f04f9d01b3602357a05c7c6'],88,270,358,7485061,12,0.153846154,0.05982906,1,8003
c45172319fa3162bee57d20d028cbb431efd9d00,1,Chathuri Wimalasena,2016-02-01 14:09:05-05:00,['494e0d735a7531894f04f9d01b3602357a05c7c6'],0,234,234,7485295,2,,,,8005
72a6f6a5aa22ee5c70b5088fbd1daa40370daffc,1,Chathuri Wimalasena,2016-02-01 15:10:29-05:00,['c45172319fa3162bee57d20d028cbb431efd9d00'],0,1352,1352,7486647,16,1,1,1,8019
225f462badbc1bf18c8585f9f1eddd36bb0f8e09,0,Shameera Rathnayaka,2016-02-01 16:48:00-05:00,['9859af32bfd71aa95ec0e5e170d4937398899ecd'],475,298,773,7487420,17,0.809160305,0.282442748,0,8021
ad0116126d12b6b2afdd43c60f3190884a56d9d2,0,Shameera Rathnayaka,2016-02-01 16:48:26-05:00,"['225f462badbc1bf18c8585f9f1eddd36bb0f8e09', '72a6f6a5aa22ee5c70b5088fbd1daa40370daffc']",0,1586,1586,7489006,16,,,,8021
2a2782a60ab40f93677063c2c31cdf28c77ba487,1,Chathuri Wimalasena,2016-02-03 12:10:50-05:00,['ad0116126d12b6b2afdd43c60f3190884a56d9d2'],1157,3199,4356,7493362,36,0.107142857,0.126984127,1,8034
14a566a47ce68d27684e1b891d1b39db2beba6ea,1,Chathuri Wimalasena,2016-02-03 15:42:49-05:00,['2a2782a60ab40f93677063c2c31cdf28c77ba487'],22,22,44,7493406,7,,,,8034
d1bb38275f8caa2204ecbe1611b0fbe9c6e322b5,1,Shameera Rathnayaka,2016-02-03 16:42:21-05:00,['14a566a47ce68d27684e1b891d1b39db2beba6ea'],140,123,263,7493669,10,0,0,0.302325581,8035
d2501c332826cebf3b972cbc499b10e1743f53ff,0,Chathuri Wimalasena,2016-02-04 13:41:18-05:00,['d1bb38275f8caa2204ecbe1611b0fbe9c6e322b5'],10,200,210,7493879,8,0.352941176,0.546218487,1,8036
fb75a2f7ea8beb53bd91e6bfee6b488e77869b3b,1,Chathuri Wimalasena,2016-02-05 11:35:31-05:00,['d2501c332826cebf3b972cbc499b10e1743f53ff'],11,26,37,7493916,5,0,1,1,8036
e21fae79eeb6c7aae6f482db3e20e5745ccac6ed,0,Chathuri Wimalasena,2016-02-05 14:40:04-05:00,['fb75a2f7ea8beb53bd91e6bfee6b488e77869b3b'],40,39,79,7493995,8,0,0,1,8036
ce7955813f79812a58bc6395914f3a978b0ae1e9,0,Shameera Rathnayaka,2016-02-05 16:29:41-05:00,['e21fae79eeb6c7aae6f482db3e20e5745ccac6ed'],240,105,345,7494340,8,0.584615385,0.446153846,0.030769231,8036
d8df3d00c2cb701608866c39d61c02220f135378,1,scnakandala,2016-02-08 10:22:41-05:00,['ce7955813f79812a58bc6395914f3a978b0ae1e9'],3,3,6,7494346,1,,,,8036
b4ca1eb5a361b3040e4115dae2235cb4816c8ff1,0,Shameera Rathnayaka,2016-02-08 11:15:58-05:00,['d8df3d00c2cb701608866c39d61c02220f135378'],139,98,237,7494583,7,1,1,0,8036
4c790770685a77b1b43c7dadbea55396e983c465,1,Chathuri Wimalasena,2016-02-08 11:45:01-05:00,['b4ca1eb5a361b3040e4115dae2235cb4816c8ff1'],2296,6116,8412,7502995,99,0.322764743,0.381103361,0.979074192,8036
2bab21895ba24263f563bc6b24937548abd24acb,0,Chathuri Wimalasena,2016-02-08 12:30:16-05:00,['4c790770685a77b1b43c7dadbea55396e983c465'],21,22,43,7503038,1,,,,8036
54bb7192567f48c4d0a3b7b6c73b07ddb3d36a2a,0,Chathuri Wimalasena,2016-02-08 13:29:27-05:00,['4c790770685a77b1b43c7dadbea55396e983c465'],5,6,11,7503049,1,,,,8036
11ea5014aaf16eadb02614aaa75cc2a18191d3e8,0,Shameera Rathnayaka,2016-02-08 17:18:20-05:00,['54bb7192567f48c4d0a3b7b6c73b07ddb3d36a2a'],45,710,755,7503804,10,0.380165289,0.489669421,0.993801653,8037
b96cb162e474dd7e068e1dc9b00e8371d5f7a18b,0,Chathuri Wimalasena,2016-02-09 10:58:04-05:00,['11ea5014aaf16eadb02614aaa75cc2a18191d3e8'],2,35,37,7503841,5,0.428571429,0.714285714,1,8037
caca2fe6de64b919b0eedca1be18e083bbaa8823,0,Chathuri Wimalasena,2016-02-09 11:08:18-05:00,"['2bab21895ba24263f563bc6b24937548abd24acb', 'b96cb162e474dd7e068e1dc9b00e8371d5f7a18b']",48,745,793,7504634,16,,,,8037
45157184c5b01e1c9b53f75546dbe9ad2585ff52,0,Chathuri Wimalasena,2016-02-10 14:08:44-05:00,['b96cb162e474dd7e068e1dc9b00e8371d5f7a18b'],2,18,20,7504654,1,0,0,1,8037
685b3c20849238c604d81e5265b3b473b2b82784,0,Chathuri Wimalasena,2016-02-10 14:09:36-05:00,"['caca2fe6de64b919b0eedca1be18e083bbaa8823', '45157184c5b01e1c9b53f75546dbe9ad2585ff52']",2,18,20,7504674,1,,,,8037
64a387537fe6234b595cb4c94f6332021ca0825b,1,Chathuri Wimalasena,2016-02-12 11:23:54-05:00,['45157184c5b01e1c9b53f75546dbe9ad2585ff52'],301,524,825,7505499,94,0.105263158,0.18128655,0.888888889,8037
d3cf5bc611724fc4f0b9037cc3ec850744c6b712,1,Chathuri Wimalasena,2016-02-12 11:46:32-05:00,['64a387537fe6234b595cb4c94f6332021ca0825b'],2,2,4,7505503,1,,,,8037
38c2c36e717b7d60e9dbafd6f6bc235f8f52bf9d,0,Shameera Rathnayaka,2016-02-12 16:51:16-05:00,['11ea5014aaf16eadb02614aaa75cc2a18191d3e8'],39,410,449,7505952,9,0.778761062,0.694690265,1,8037
24587f9f88172c276f354c7fb2d92f1017d180a3,0,Shameera Rathnayaka,2016-02-12 16:51:29-05:00,"['38c2c36e717b7d60e9dbafd6f6bc235f8f52bf9d', 'd3cf5bc611724fc4f0b9037cc3ec850744c6b712']",305,577,882,7506834,100,,,,8037
614f8bbf5c22290d7a57f4cc11403285e3bac0b9,0,Chathuri Wimalasena,2016-02-15 14:53:01-05:00,['24587f9f88172c276f354c7fb2d92f1017d180a3'],1,2,3,7506837,1,,,,8037
7a345e547487b0cf78eb1805f25bb053ad49a840,0,scnakandala,2016-02-16 16:25:34-05:00,['d8df3d00c2cb701608866c39d61c02220f135378'],16,12,28,7506865,1,,,,8037
2c2d63d04deba0e4828bb08c6a176f2af44c87b7,0,scnakandala,2016-02-16 16:26:02-05:00,"['7a345e547487b0cf78eb1805f25bb053ad49a840', '614f8bbf5c22290d7a57f4cc11403285e3bac0b9']",2684,7773,10457,7517322,131,,,,8037
fa6b4d8e2d2ed000c2fa3bc64045b5b7c8dcc71c,0,Chathuri Wimalasena,2016-02-18 10:48:07-05:00,['2c2d63d04deba0e4828bb08c6a176f2af44c87b7'],1,1,2,7517324,1,,,,8037
ace07827dec6bd3202de277274613197571c0f50,0,Chathuri Wimalasena,2016-02-18 10:49:10-05:00,"['685b3c20849238c604d81e5265b3b473b2b82784', 'fa6b4d8e2d2ed000c2fa3bc64045b5b7c8dcc71c']",360,951,1311,7518635,107,,,,8037
3a9a18af022f519d2be82e8d0e83020c48919664,0,Chathuri Wimalasena,2016-02-19 14:20:40-05:00,['fa6b4d8e2d2ed000c2fa3bc64045b5b7c8dcc71c'],1,1,2,7518637,1,1,1,0,8037
c72a90ed41ce6c8a0f1a02cd43e8afc341f92ad2,0,Shameera Rathnayaka,2016-02-22 11:24:23-05:00,['3a9a18af022f519d2be82e8d0e83020c48919664'],41,74,115,7518752,6,0,0.142857143,1,8037
dad110bcd4a3d0469aacbabffdc76c7408666beb,0,smarru,2016-02-23 14:59:15-05:00,['c72a90ed41ce6c8a0f1a02cd43e8afc341f92ad2'],102,785,887,7519639,93,0.063380282,0.193661972,0.992957746,8037
472108397cdd2ca9719acaa6369d0b7a5f7a9f8a,0,smarru,2016-02-23 15:12:55-05:00,['ace07827dec6bd3202de277274613197571c0f50'],102,785,887,7520526,93,0.063380282,0.193661972,0.992957746,8037
6718650be82472ac6085cf1c093460b38aecbbf3,0,smarru,2016-02-23 15:27:50-05:00,['472108397cdd2ca9719acaa6369d0b7a5f7a9f8a'],186,186,372,7520898,12,,,,8037
03cd77a484d72497626bfc759b2328109d0f16e3,0,smarru,2016-02-23 15:28:45-05:00,['dad110bcd4a3d0469aacbabffdc76c7408666beb'],186,186,372,7521270,12,,,,8037
3ac76fefce6d1fa54f9e647f072263992a0c2580,1,Chathuri Wimalasena,2016-02-24 10:22:13-05:00,['03cd77a484d72497626bfc759b2328109d0f16e3'],0,106,106,7521376,9,0.575757576,0.848484848,0.984848485,8037
e303bb5f1931de285d1b5aa89c049f38069a5815,0,Chathuri Wimalasena,2016-02-24 10:33:25-05:00,['3ac76fefce6d1fa54f9e647f072263992a0c2580'],75,44,119,7521495,4,0.133333333,0.133333333,0,8037
f22acb82622d81f30118b0ba3adb922f88149f03,0,Chathuri Wimalasena,2016-02-24 11:36:49-05:00,['e303bb5f1931de285d1b5aa89c049f38069a5815'],61,179,240,7521735,6,0.424242424,0.585858586,1,8038
48e2593ec724cea9861ce27ff47c3aced2a56349,1,smarru,2016-02-24 12:02:16-05:00,['e303bb5f1931de285d1b5aa89c049f38069a5815'],301,300,601,7522336,97,1,1,1,8038
b09ce0cf9a4c59e1a17d21b9deeec76d6e0a7112,0,smarru,2016-02-24 12:02:42-05:00,"['48e2593ec724cea9861ce27ff47c3aced2a56349', 'f22acb82622d81f30118b0ba3adb922f88149f03']",61,179,240,7522576,6,,,,8038
8e23fadcf0c8235b337b1d060a9cf319b6b47c40,1,Chathuri Wimalasena,2016-02-24 14:39:38-05:00,['b09ce0cf9a4c59e1a17d21b9deeec76d6e0a7112'],10,28,38,7522614,3,0,0,1,8038
55f190ca10cedef2f01ba94cc7476b8293e74917,0,Chathuri Wimalasena,2016-02-24 14:56:57-05:00,['8e23fadcf0c8235b337b1d060a9cf319b6b47c40'],0,2,2,7522616,1,0,0,1,8038
e6d6827114ce2497df512e26d99346e3f013ff49,0,Chathuri Wimalasena,2016-02-24 15:10:48-05:00,"['6718650be82472ac6085cf1c093460b38aecbbf3', '55f190ca10cedef2f01ba94cc7476b8293e74917']",391,702,1093,7523709,116,,,,8038
91ef607cfc1f27323e36722ef24b940212abb89a,0,Chathuri Wimalasena,2016-02-24 15:46:14-05:00,['55f190ca10cedef2f01ba94cc7476b8293e74917'],5,5,10,7523719,1,,,,8038
d9a1075599030001cd3b9df6b06840dc2b6c9eae,1,Chathuri Wimalasena,2016-02-25 16:54:37-05:00,['91ef607cfc1f27323e36722ef24b940212abb89a'],1,2,3,7523722,1,0,0,1,8038
4363669c1fa170d175e185ad3576c23f382c2db7,0,smarru,2016-02-26 10:27:04-05:00,['91ef607cfc1f27323e36722ef24b940212abb89a'],782,1412,2194,7525916,103,0.19112628,0.006825939,0.996587031,8048
55d2fe92c9e760c8619259dbf588b1d32fb6ba15,0,smarru,2016-02-26 10:27:24-05:00,"['4363669c1fa170d175e185ad3576c23f382c2db7', 'd9a1075599030001cd3b9df6b06840dc2b6c9eae']",1,2,3,7525919,1,,,,8048
4772b99e344aa3055c409992de8158ae356f863e,0,smarru,2016-02-26 12:44:36-05:00,['55d2fe92c9e760c8619259dbf588b1d32fb6ba15'],114,114,228,7526147,6,,,,8048
b537f358de8c303af81ade7b0f42d7e58d3e61b3,1,smarru,2016-02-26 15:14:25-05:00,['4772b99e344aa3055c409992de8158ae356f863e'],121,296,417,7526564,8,0.194444444,0.236111111,0.993055556,8048
f0c730cda531633e9c126bde248b3a9843edfe90,1,smarru,2016-02-26 16:23:57-05:00,['b537f358de8c303af81ade7b0f42d7e58d3e61b3'],0,26,26,7526590,5,0.705882353,0.764705882,1,8048
d66d16980be161817dd9c24048a99bc50183605c,1,Chathuri Wimalasena,2016-02-26 16:38:47-05:00,['f0c730cda531633e9c126bde248b3a9843edfe90'],91,580,671,7527261,12,0.229050279,0.134078212,1,8051
833de75a3e27621bc151f6cc6bae39b47e101c7a,1,Chathuri Wimalasena,2016-02-26 17:00:25-05:00,['d66d16980be161817dd9c24048a99bc50183605c'],30,14,44,7527305,9,1,1,0,8051
851117fa0a89fa8d7ef111f244b56aa98040b950,1,Chathuri Wimalasena,2016-03-01 16:35:04-05:00,['833de75a3e27621bc151f6cc6bae39b47e101c7a'],0,1,1,7527306,1,,,,8051
630c75116925e86a49b5e78f0e962c6ea567ead0,0,smarru,2016-03-03 13:14:47-05:00,"['e6d6827114ce2497df512e26d99346e3f013ff49', '851117fa0a89fa8d7ef111f244b56aa98040b950']",941,2247,3188,7530494,137,,,,8051
e2379f595e7463e1b40f31a0c01520c7ce211088,0,Shameera Rathnayaka,2016-03-04 15:04:19-05:00,['851117fa0a89fa8d7ef111f244b56aa98040b950'],1,2,3,7530497,1,,,,8051
44bd69cb314567599c0d5458dbec2f68c9433f5c,0,Shameera Rathnayaka,2016-03-04 15:06:20-05:00,['e2379f595e7463e1b40f31a0c01520c7ce211088'],90,255,345,7530842,87,0.198529412,0.25,0.992647059,8051
97ea70c8b5dacc6d1a1ba7c5e7404a79bab5da25,0,Shameera Rathnayaka,2016-03-04 15:30:42-05:00,['44bd69cb314567599c0d5458dbec2f68c9433f5c'],0,27,27,7530869,7,0.705882353,0.764705882,1,8051
5f29e9f96f6c9cdca530fae5ea1b9218311f5bf4,0,Shameera Rathnayaka,2016-03-04 16:17:01-05:00,['97ea70c8b5dacc6d1a1ba7c5e7404a79bab5da25'],9,199,208,7531077,11,0.254901961,0.307189542,0.993464052,8051
75fb3b3cdd597654832df16cb5f75a6f35db1a9e,1,Shameera Rathnayaka,2016-03-04 21:30:40-05:00,['5f29e9f96f6c9cdca530fae5ea1b9218311f5bf4'],48,132,180,7531257,12,1,1,0,8052
7fbc6241f6ccf76c4829ed2ca745913d95a680ff,1,Suresh Marru,2016-03-07 13:25:13-05:00,['75fb3b3cdd597654832df16cb5f75a6f35db1a9e'],12,211,223,7531480,13,0.309677419,0.232258065,0.993548387,8052
4e80197d71a92da3451c42fe8e166786315f5456,1,Shameera Rathnayaka,2016-03-07 16:24:33-05:00,['75fb3b3cdd597654832df16cb5f75a6f35db1a9e'],31,216,247,7531727,4,0,0.276923077,0.515384615,8052
0888365cafa19858c677af1de11434c1b9e29be5,0,Shameera Rathnayaka,2016-03-07 16:24:43-05:00,"['4e80197d71a92da3451c42fe8e166786315f5456', '7fbc6241f6ccf76c4829ed2ca745913d95a680ff']",12,211,223,7531950,13,,,,8052
cf4f3f596e755e71d030a063d4dafa7c5a050835,1,scnakandala,2016-03-10 12:40:54-05:00,['75fb3b3cdd597654832df16cb5f75a6f35db1a9e'],1,5,6,7531956,1,0,1,1,8052
a1df4ad71e2f79f22c25f11bce25cf8f48390dc6,0,scnakandala,2016-03-10 12:40:58-05:00,"['cf4f3f596e755e71d030a063d4dafa7c5a050835', '0888365cafa19858c677af1de11434c1b9e29be5']",43,427,470,7532426,17,,,,8052
471ae44aec7c05a4eea3df2ce63093e1e6ce6c65,1,Suresh Marru,2016-03-11 01:48:30-05:00,['a1df4ad71e2f79f22c25f11bce25cf8f48390dc6'],84,3136,3220,7535646,91,0.307760141,0.361552028,0.89021164,8052
6c4b50f38371e48132dd606e010386c2b477e9de,0,Suresh Marru,2016-03-11 01:55:45-05:00,"['471ae44aec7c05a4eea3df2ce63093e1e6ce6c65', 'ace07827dec6bd3202de277274613197571c0f50']",18,17,35,7535681,1,,,,8052
39483e4866b95d8e4e4b827a09f994291d91b8b6,0,Suresh Marru,2016-03-11 01:56:58-05:00,"['6c4b50f38371e48132dd606e010386c2b477e9de', '630c75116925e86a49b5e78f0e962c6ea567ead0']",3,69,72,7535753,4,,,,8052
bb3331f3d2d6f6c3dcfdfd75db5d7c5560d3b2b1,0,Shameera Rathnayaka,2016-03-11 11:24:16-05:00,['39483e4866b95d8e4e4b827a09f994291d91b8b6'],2,5,7,7535760,1,0,0,1,8052
59655604842a7753c313ca12fe618d78791a4630,1,Shameera Rathnayaka,2016-03-11 12:40:08-05:00,['bb3331f3d2d6f6c3dcfdfd75db5d7c5560d3b2b1'],478,34,512,7536272,28,0.740223464,0.684357542,0.008379888,8052
f7ea977d2aaa5511b36b2552de1f4a0613b4ccbf,1,Shameera Rathnayaka,2016-03-11 13:25:59-05:00,['59655604842a7753c313ca12fe618d78791a4630'],0,1,1,7536273,1,1,1,1,8052
4a04fab74f2e3006c2cc36f1d88f243159dd3641,0,Shameera Rathnayaka,2016-03-11 15:43:07-05:00,['f7ea977d2aaa5511b36b2552de1f4a0613b4ccbf'],9,11,20,7536293,2,0,0,1,8052
4968ee8c30566af8d17657537de51eb3d050a35e,0,Shameera Rathnayaka,2016-03-11 16:00:08-05:00,['4a04fab74f2e3006c2cc36f1d88f243159dd3641'],2,2,4,7536297,1,,,,8052
fcace748763397649c46b7adbd423afa16989e54,0,Suresh Marru,2016-03-14 09:23:00-04:00,['4968ee8c30566af8d17657537de51eb3d050a35e'],73,20,93,7536390,11,,,,8052
82d489925f86976cb31706c338c529cbd5ba4460,0,Suresh Marru,2016-03-14 09:31:07-04:00,['4968ee8c30566af8d17657537de51eb3d050a35e'],73,20,93,7536483,11,,,,8052
6ebc2b39ba1702310828c41ee7104e6b9a2ab281,0,Suresh Marru,2016-03-14 09:31:34-04:00,"['82d489925f86976cb31706c338c529cbd5ba4460', 'fcace748763397649c46b7adbd423afa16989e54']",0,0,0,7536483,0,,,,8052
c36aa15d8c40bf647e5d851084d5c9b3ffd8aca0,0,Shameera Rathnayaka,2016-03-14 11:57:55-04:00,['4968ee8c30566af8d17657537de51eb3d050a35e'],1,2,3,7536486,1,0,0,1,8052
887ea094f6c7ba6f46e573d75ed85f56f1c50807,0,Shameera Rathnayaka,2016-03-14 11:58:10-04:00,"['c36aa15d8c40bf647e5d851084d5c9b3ffd8aca0', '6ebc2b39ba1702310828c41ee7104e6b9a2ab281']",73,20,93,7536579,11,,,,8052
a9a331a85093118ea1a112883bf6bfa1ab649ade,0,Shameera Rathnayaka,2016-03-14 16:21:26-04:00,['887ea094f6c7ba6f46e573d75ed85f56f1c50807'],1,1,2,7536581,1,,,,8052
63d742bdc438ebc948586e64437657282b7230a3,0,Suresh Marru,2016-03-15 20:36:23-04:00,['a9a331a85093118ea1a112883bf6bfa1ab649ade'],6,5,11,7536592,1,1,1,0,8052
49e962d8f9fe7ebfe7777d629409430835cf9a65,0,Shameera Rathnayaka,2016-03-17 16:33:39-04:00,['63d742bdc438ebc948586e64437657282b7230a3'],0,44,44,7536636,3,,,,8054
c11667b716ebef85c2153cd3f3113f30d91d4b22,0,Shameera Rathnayaka,2016-03-18 11:23:36-04:00,['49e962d8f9fe7ebfe7777d629409430835cf9a65'],2,3,5,7536641,1,0,0,1,8054
03ca7c91bf3a42ede4c71217633c69cf812b9dd8,0,Shameera Rathnayaka,2016-03-18 14:00:45-04:00,['c11667b716ebef85c2153cd3f3113f30d91d4b22'],57,78,135,7536776,3,0.727272727,1,0,8055
10274c11d81068cce76342372d782b7e8cdfef66,1,Shameera Rathnayaka,2016-03-19 17:07:11-04:00,['03ca7c91bf3a42ede4c71217633c69cf812b9dd8'],26,90,116,7536892,2,0,0.775510204,1,8055
6d692ee342501d96e4ea89ec6cbe59f98fdb0558,0,Shameera Rathnayaka,2016-03-21 11:13:40-04:00,['10274c11d81068cce76342372d782b7e8cdfef66'],2,21,23,7536915,2,0.230769231,0.461538462,0.769230769,8055
47409bad84d7e4996c5e03dd45a2931fae6ae8fb,0,Shameera Rathnayaka,2016-03-21 14:05:55-04:00,['6d692ee342501d96e4ea89ec6cbe59f98fdb0558'],20,60,80,7536995,2,0.085714286,0.657142857,1,8055
8496ae6c195edde0b1358aba182ca640a25c831a,0,Shameera Rathnayaka,2016-03-21 14:18:59-04:00,['47409bad84d7e4996c5e03dd45a2931fae6ae8fb'],43,25,68,7537063,2,1,1,0.3125,8055
6d320248f7a0c12b651e55aa520503ca08a04d2f,1,Shameera Rathnayaka,2016-03-21 15:45:38-04:00,['8496ae6c195edde0b1358aba182ca640a25c831a'],26,34,60,7537123,1,0,0.166666667,0,8055
a963d3f0cbbd47a2775154ee1881aebd24a60b15,1,scnakandala,2016-03-22 12:36:31-04:00,['6d320248f7a0c12b651e55aa520503ca08a04d2f'],55519,38421,93940,7631063,139,0.654372019,0.595786963,0.11772655,8063
03afa2da5e9ae12d8c9ecbf0e4584c7b42ea64da,1,scnakandala,2016-03-22 13:50:39-04:00,['a963d3f0cbbd47a2775154ee1881aebd24a60b15'],1322,1526,2848,7633911,24,0.230263158,0.263157895,0.993421053,8063
ec6e9d0ae56a552e5716f581ee81d5a17d02b191,0,scnakandala,2016-03-22 14:15:45-04:00,['03afa2da5e9ae12d8c9ecbf0e4584c7b42ea64da'],2,2,4,7633915,1,,,,8063
d54afbdffdb6eb39c94d566b8a7216bcd3892d25,0,scnakandala,2016-03-22 14:57:34-04:00,['ec6e9d0ae56a552e5716f581ee81d5a17d02b191'],1,1,2,7633917,1,,,,8063
cf6304c6e59671793a8d36c24aa249a3d19fe3e5,0,Suresh Marru,2016-03-22 16:10:39-04:00,['8496ae6c195edde0b1358aba182ca640a25c831a'],110,113,223,7634140,1,,,,8063
6c5645d3aad93e9b5185b950984c9fb5f9c278d2,1,scnakandala,2016-03-22 16:46:12-04:00,['d54afbdffdb6eb39c94d566b8a7216bcd3892d25'],28978,37389,66367,7700507,18,0.34430619,0.368089463,0.926445109,8064
7e7e3a969b6421a4cc968aa266337641923865e9,0,Shameera Rathnayaka,2016-03-23 11:00:17-04:00,"['cf6304c6e59671793a8d36c24aa249a3d19fe3e5', '6d320248f7a0c12b651e55aa520503ca08a04d2f']",26,34,60,7700567,1,,,,8064
244215968409100ebccef0425c505ac7f6e52fc1,0,Shameera Rathnayaka,2016-03-23 11:26:28-04:00,['6c5645d3aad93e9b5185b950984c9fb5f9c278d2'],5,4,9,7700576,1,0,0,0,8064
faabd9713a4d7b9ead35ff44103e9afd71998911,0,scnakandala,2016-03-23 14:08:53-04:00,['6c5645d3aad93e9b5185b950984c9fb5f9c278d2'],14,1,15,7700591,2,,,,8064
37487421cf150718b810e2aed2b42c72f1293526,0,scnakandala,2016-03-23 14:37:44-04:00,['faabd9713a4d7b9ead35ff44103e9afd71998911'],17,30,47,7700638,2,0,0,1,8064
a23cc639e0ee34bc78e64706328feccc482c30f5,0,scnakandala,2016-03-23 14:45:42-04:00,['37487421cf150718b810e2aed2b42c72f1293526'],1,2,3,7700641,1,,,,8064
5e9bf914c251ac5cd36f8718417bbe4d7ba4f1fe,1,scnakandala,2016-03-23 15:56:05-04:00,['a23cc639e0ee34bc78e64706328feccc482c30f5'],5,62,67,7700708,3,0,0.803921569,1,8064
8574272bd33550bab9ed210505636c995330f2b9,0,scnakandala,2016-03-23 16:07:33-04:00,['5e9bf914c251ac5cd36f8718417bbe4d7ba4f1fe'],1,1,2,7700710,1,,,,8064
199c3010786164b9f4e617c935ee50fdb5008a90,0,scnakandala,2016-03-23 17:20:27-04:00,['8574272bd33550bab9ed210505636c995330f2b9'],2,2,4,7700714,1,,,,8064
f30e73fd10668d2ae4735702eda0021f0490abf0,1,Shameera Rathnayaka,2016-03-23 18:05:46-04:00,['244215968409100ebccef0425c505ac7f6e52fc1'],19,35,54,7700768,4,0,0.375,0.5,8064
6c483bc4cf9f7a7c7301449a02dd50e499baccd5,0,Shameera Rathnayaka,2016-03-23 18:05:55-04:00,"['f30e73fd10668d2ae4735702eda0021f0490abf0', '199c3010786164b9f4e617c935ee50fdb5008a90']",38,96,134,7700902,6,,,,8064
464c5b4a70cf01fbb32bf56cbc3678134c560db0,0,scnakandala,2016-03-23 18:08:23-04:00,['199c3010786164b9f4e617c935ee50fdb5008a90'],2,3,5,7700907,3,0,0,1,8064
844a9abb53334943c0500219f3b4e586e814789e,0,scnakandala,2016-03-23 18:08:28-04:00,"['464c5b4a70cf01fbb32bf56cbc3678134c560db0', '6c483bc4cf9f7a7c7301449a02dd50e499baccd5']",24,39,63,7700970,5,,,,8064
a2ff4325377c71125f21aef8e044b7baead1d856,0,scnakandala,2016-03-23 18:14:15-04:00,['844a9abb53334943c0500219f3b4e586e814789e'],1,1,2,7700972,1,,,,8064
04f6f5934607cd2a0925f478fc4121c4adf0b306,1,scnakandala,2016-03-24 11:25:15-04:00,['a2ff4325377c71125f21aef8e044b7baead1d856'],596,628,1224,7702196,127,0.16,0.28,1,8064
cf8dc28e7b551b37f4794a9452a1cc95f21d5c1b,1,scnakandala,2016-03-24 11:30:47-04:00,['04f6f5934607cd2a0925f478fc4121c4adf0b306'],3,3,6,7702202,5,,,,8064
b2740e74dee0634662c06895943d7447da9fbda8,0,scnakandala,2016-03-24 11:47:45-04:00,['cf8dc28e7b551b37f4794a9452a1cc95f21d5c1b'],0,1,1,7702203,1,0,0,1,8064
18cd83c37845b8f66ace551eebebfa2fcad0b523,1,scnakandala,2016-03-24 14:02:58-04:00,['b2740e74dee0634662c06895943d7447da9fbda8'],51,1497,1548,7703751,14,0.318882466,0.335260116,0.95761079,8068
02cbb8dc0640e64aae3a4a161cbe79255a81cd13,1,scnakandala,2016-03-24 14:41:15-04:00,['18cd83c37845b8f66ace551eebebfa2fcad0b523'],24699,30154,54853,7758604,19,0.356157755,0.390515364,0.923300266,8068
3357169c67f64a0347aa64a834c792a4f634ed12,0,scnakandala,2016-03-24 14:41:29-04:00,['02cbb8dc0640e64aae3a4a161cbe79255a81cd13'],1,1,2,7758606,1,,,,8068
24531956710134f2fa65b4fe0d661f1489b5158e,1,scnakandala,2016-03-24 15:35:24-04:00,['3357169c67f64a0347aa64a834c792a4f634ed12'],18,466,484,7759090,20,0.184573003,0.341597796,0.994490358,8068
8e4212ea0e9aa574329cc128b36b49743b6dcc73,1,scnakandala,2016-03-25 13:06:13-04:00,['24531956710134f2fa65b4fe0d661f1489b5158e'],493,268,761,7759851,98,0.961748634,0.765027322,0,8068
fd9b64feb2d745430ce1cca3df4069c1c6802e2b,0,scnakandala,2016-03-25 13:10:51-04:00,['8e4212ea0e9aa574329cc128b36b49743b6dcc73'],1,0,1,7759852,1,1,0,0,8068
ef4329c51c9d81c41c42c5dd77eb5ca34ef40675,1,Shameera Rathnayaka,2016-03-25 14:11:07-04:00,['6c483bc4cf9f7a7c7301449a02dd50e499baccd5'],54,64,118,7759970,2,0,0.857142857,0.857142857,8068
253dee8cd8771966b4ae9d8b323e1d9207f61414,0,Shameera Rathnayaka,2016-03-25 14:11:17-04:00,"['ef4329c51c9d81c41c42c5dd77eb5ca34ef40675', 'fd9b64feb2d745430ce1cca3df4069c1c6802e2b']",26294,33451,59745,7819715,153,,,,8068
5d36493a8855635f9045cfa6c18b58755b6c640e,1,scnakandala,2016-03-25 14:19:07-04:00,['fd9b64feb2d745430ce1cca3df4069c1c6802e2b'],9,208,217,7819932,14,0.24691358,0.283950617,0.987654321,8068
6f39725a1fe14b6280bf4c5068a3115b00171c36,0,scnakandala,2016-03-25 14:19:26-04:00,"['5d36493a8855635f9045cfa6c18b58755b6c640e', '253dee8cd8771966b4ae9d8b323e1d9207f61414']",54,64,118,7820050,2,,,,8068
03c071590f4a1f39bec8f1fbcd8c212a413364f9,1,scnakandala,2016-03-25 15:23:57-04:00,['6f39725a1fe14b6280bf4c5068a3115b00171c36'],1,1,2,7820052,1,,,,8068
1eda8c985171452f82208910921280a47e48d1d3,1,scnakandala,2016-03-25 15:41:58-04:00,['03c071590f4a1f39bec8f1fbcd8c212a413364f9'],0,1,1,7820053,1,0,1,1,8068
5f484b984fb2454033daefe782d7f5a0b2103faf,0,scnakandala,2016-03-25 16:00:47-04:00,['1eda8c985171452f82208910921280a47e48d1d3'],2,2,4,7820057,1,,,,8068
ab262c7061ab395df3c61ecf2e455e041b64b689,0,Shameera Rathnayaka,2016-03-25 17:21:56-04:00,"['7e7e3a969b6421a4cc968aa266337641923865e9', '5f484b984fb2454033daefe782d7f5a0b2103faf']",28591,27548,56139,7876196,200,,,,8068
7bde79be3430afba12b2fc653a15b05afa568356,1,Shameera Rathnayaka,2016-03-25 18:33:07-04:00,['5f484b984fb2454033daefe782d7f5a0b2103faf'],17,134,151,7876347,2,0.074074074,0.074074074,1,8068
eeb101679bc78eb902c11bcc4632db5e96264cc4,0,Shameera Rathnayaka,2016-03-25 18:33:22-04:00,"['ab262c7061ab395df3c61ecf2e455e041b64b689', '7bde79be3430afba12b2fc653a15b05afa568356']",17,134,151,7876498,2,,,,8068
e8b7773e57491097872b302e7ee7111c1be5db63,0,Shameera Rathnayaka,2016-03-25 20:09:36-04:00,['7bde79be3430afba12b2fc653a15b05afa568356'],4,3,7,7876505,2,,,,8068
3dce244cb5995cb191f5d9d580a1fbaca1acd6af,0,Shameera Rathnayaka,2016-03-28 11:23:58-04:00,"['eeb101679bc78eb902c11bcc4632db5e96264cc4', 'e8b7773e57491097872b302e7ee7111c1be5db63']",4,3,7,7876512,2,,,,8068
5444ba3edc02895ed1e08e97c4c6192729b81a8e,0,Shameera Rathnayaka,2016-03-28 18:04:45-04:00,['e8b7773e57491097872b302e7ee7111c1be5db63'],4,8,12,7876524,2,0,0,1,8068
f0198a43a62e2ff1ab403e76d3e7699a9ca1ef48,0,Shameera Rathnayaka,2016-03-28 18:05:06-04:00,"['3dce244cb5995cb191f5d9d580a1fbaca1acd6af', '5444ba3edc02895ed1e08e97c4c6192729b81a8e']",4,8,12,7876536,2,,,,8068
518868a55dd10df8d602f9aaf828997a739ae738,0,scnakandala,2016-03-30 13:29:39-04:00,['3dce244cb5995cb191f5d9d580a1fbaca1acd6af'],10,0,10,7876546,1,,,,8068
777e6f130bfee70fda6dab810042a81fe7974e12,0,scnakandala,2016-03-30 13:30:34-04:00,['5f484b984fb2454033daefe782d7f5a0b2103faf'],10,0,10,7876556,1,,,,8068
16ff3fd7a0c3f311fa4735fe6f3826adca8383eb,0,scnakandala,2016-03-30 13:30:45-04:00,"['777e6f130bfee70fda6dab810042a81fe7974e12', '5444ba3edc02895ed1e08e97c4c6192729b81a8e']",21,141,162,7876718,3,,,,8068
6c301e64a3cda54160a10a4c2f044bd8789d06f2,0,Shameera Rathnayaka,2016-03-30 16:59:40-04:00,['16ff3fd7a0c3f311fa4735fe6f3826adca8383eb'],0,48,48,7876766,3,1,1,1,8070
e0b674c5f102ab820ef99d016e92d8f37f06c435,0,Shameera Rathnayaka,2016-03-30 17:01:17-04:00,"['f0198a43a62e2ff1ab403e76d3e7699a9ca1ef48', '6c301e64a3cda54160a10a4c2f044bd8789d06f2']",10,48,58,7876824,4,,,,8070
27e93a0f2b5032dcc57438d5f726752b64d8a24a,0,Suresh Marru,2016-03-30 17:52:07-04:00,['6c301e64a3cda54160a10a4c2f044bd8789d06f2'],91,610,701,7877525,88,0.118568233,0.18344519,0.993288591,8070
e5ae01e020897c5f0e044895d624e9f95c4ef987,1,Suresh Marru,2016-03-31 17:24:05-04:00,['27e93a0f2b5032dcc57438d5f726752b64d8a24a'],23,201,224,7877749,12,0.333333333,0.952380952,0.857142857,8070
9b52485f7261c2241eeeee9e2b740ae95244f4aa,1,Suresh Marru,2016-04-01 05:30:40-04:00,['e5ae01e020897c5f0e044895d624e9f95c4ef987'],9,49,58,7877807,5,0.081081081,0.513513514,0.567567568,8070
7c30f789c59eaeb8b8a60615419f7964b722b695,1,Shameera Rathnayaka,2016-04-01 11:57:42-04:00,['6c301e64a3cda54160a10a4c2f044bd8789d06f2'],6,15,21,7877828,2,0,0.666666667,1,8070
cfee70c32593407e330c44a8bb633cfa1dde4703,0,Shameera Rathnayaka,2016-04-01 11:58:00-04:00,"['7c30f789c59eaeb8b8a60615419f7964b722b695', '9b52485f7261c2241eeeee9e2b740ae95244f4aa']",119,856,975,7878803,101,,,,8070
6b4960809334c745b76d6af16787c035e9e3f096,1,Shameera Rathnayaka,2016-04-01 16:20:03-04:00,['cfee70c32593407e330c44a8bb633cfa1dde4703'],0,1,1,7878804,1,0,0,1,8070
f5e0f227e50212a1f239f24f28e2616e420e41d5,0,Suresh Marru,2016-04-01 17:27:38-04:00,['6b4960809334c745b76d6af16787c035e9e3f096'],4,4,8,7878812,2,,,,8070
2536b339a88be99022171a3378ea2faafc48f3ee,0,Suresh Marru,2016-04-01 17:55:14-04:00,['f5e0f227e50212a1f239f24f28e2616e420e41d5'],1,3,4,7878816,1,,,,8070
662728b4a3e74b24bd0a6437d7759c4235754dff,0,Shameera Rathnayaka,2016-04-05 16:29:00-04:00,['2536b339a88be99022171a3378ea2faafc48f3ee'],1,1,2,7878818,1,,,,8070
fa2c064e5b603d4d9dad9d5757f70f384c2c9433,0,scnakandala,2016-04-11 14:50:11-04:00,['662728b4a3e74b24bd0a6437d7759c4235754dff'],277,3,280,7879098,2,,,,8070
232d346ac3bafa93672e14601c2f2468802999ab,0,Suresh Marru,2016-04-15 15:29:57-04:00,['fa2c064e5b603d4d9dad9d5757f70f384c2c9433'],110,113,223,7879321,1,,,,8070
975edba02f87e52fa036cf6f6d21231888e44ced,1,Suresh Marru,2016-04-15 15:29:57-04:00,['232d346ac3bafa93672e14601c2f2468802999ab'],0,668,668,7879989,10,0.417582418,1,0.758241758,8080
b5bdad1a6c92c909701dad87d42cd18c529b3e86,0,Suresh Marru,2016-04-15 15:38:41-04:00,['e0b674c5f102ab820ef99d016e92d8f37f06c435'],0,0,0,7879989,0,,,,8080
cf575fe0a09eb7f5a39ff6e79b2f87b2b1e6feb1,0,Shameera Rathnayaka,2016-04-15 15:55:56-04:00,['975edba02f87e52fa036cf6f6d21231888e44ced'],3,15,18,7880007,2,,,,8080
d522a27aca499976b7789645515964388f67089f,0,Shameera Rathnayaka,2016-04-15 16:33:50-04:00,['cf575fe0a09eb7f5a39ff6e79b2f87b2b1e6feb1'],1,1,2,7880009,1,,,,8080
8b9f5c89cbff522c8f913532cd7ad8ff5abaf412,0,Mangirish Wagle,2016-04-16 00:24:34-04:00,['cf575fe0a09eb7f5a39ff6e79b2f87b2b1e6feb1'],20,187,207,7880216,8,0.1,0.65,0.8,8081
e1b200575c60de2d53def3838cf3d4c03552521b,0,Mangirish Wagle,2016-04-16 00:28:56-04:00,"['cf575fe0a09eb7f5a39ff6e79b2f87b2b1e6feb1', 'd522a27aca499976b7789645515964388f67089f']",1,1,2,7880218,1,,,,8081
4a1e79f46f55f10d60b904b2a1db4f1f3e053898,0,Mangirish Wagle,2016-04-16 00:29:48-04:00,"['8b9f5c89cbff522c8f913532cd7ad8ff5abaf412', 'e1b200575c60de2d53def3838cf3d4c03552521b']",1,1,2,7880220,1,,,,8081
ebae1a77b4e153716ca2c288a473c3b737895980,0,Gourav Shenoy,2016-04-22 04:23:40-04:00,['4a1e79f46f55f10d60b904b2a1db4f1f3e053898'],587,957,1544,7881764,7,0.274611399,0.544041451,0.860103627,8081
77a511829a42171658bc095a165f5137bf35ae89,0,Shameera Rathnayaka,2016-04-22 14:14:44-04:00,['4a1e79f46f55f10d60b904b2a1db4f1f3e053898'],13,42,55,7881819,3,0,0,0.481481481,8081
7781ff8fe15868d1e1ecc86703aaff03f09c60f2,0,Shameera Rathnayaka,2016-04-22 14:56:37-04:00,['77a511829a42171658bc095a165f5137bf35ae89'],0,2,2,7881821,1,0,0.5,0.5,8081
47290ad1545187e0ab6b970575896d2ff76fb2cd,1,scnakandala,2016-04-22 15:14:12-04:00,['4a1e79f46f55f10d60b904b2a1db4f1f3e053898'],6919,22178,29097,7910918,111,0.345806564,0.407883313,0.916218093,8084
d905749f8780178e4711e7894a62d5488236c24e,0,scnakandala,2016-04-22 15:14:21-04:00,"['47290ad1545187e0ab6b970575896d2ff76fb2cd', '7781ff8fe15868d1e1ecc86703aaff03f09c60f2']",13,44,57,7910975,3,,,,8084
22ae026168cf2fa5a0530e625a6aaf80eb63d692,0,scnakandala,2016-04-22 15:22:20-04:00,['d905749f8780178e4711e7894a62d5488236c24e'],0,920,920,7911895,1,0.292609351,0.351432881,0.984917044,8085
38c64239e436b619c39416864dca15caea9a854d,0,Shameera Rathnayaka,2016-04-22 15:27:45-04:00,['7781ff8fe15868d1e1ecc86703aaff03f09c60f2'],9,22,31,7911926,1,0,0,1,8085
2a30f80e613a5ff9fbf9d3e28e1b62f892feeb2c,0,Shameera Rathnayaka,2016-04-22 15:28:01-04:00,"['38c64239e436b619c39416864dca15caea9a854d', '22ae026168cf2fa5a0530e625a6aaf80eb63d692']",6919,23098,30017,7941943,112,,,,8085
bd239d5933a92a825819bb0adaf9896bb8e9e9db,0,Gourav Shenoy,2016-04-22 15:28:16-04:00,"['ebae1a77b4e153716ca2c288a473c3b737895980', '22ae026168cf2fa5a0530e625a6aaf80eb63d692']",6932,23142,30074,7972017,115,,,,8085
45adf30d98a36f376df29903d92f60d2e15d6be3,0,Gourav Shenoy,2016-04-22 15:29:14-04:00,"['bd239d5933a92a825819bb0adaf9896bb8e9e9db', '2a30f80e613a5ff9fbf9d3e28e1b62f892feeb2c']",9,22,31,7972048,1,,,,8085
de05f6b45c2b60d9e8254d90a9b43df87afd59df,0,Gourav Shenoy,2016-04-22 15:33:47-04:00,['45adf30d98a36f376df29903d92f60d2e15d6be3'],47,47,94,7972142,6,,,,8085
26fd7c328da3a5a2344ac7d251fb2f972c62dbd4,0,Shameera Rathnayaka,2016-04-22 15:39:01-04:00,['2a30f80e613a5ff9fbf9d3e28e1b62f892feeb2c'],3,3,6,7972148,1,0,1,1,8085
fad21741d1f7c4df2b0d7ee9c7be637a15bd4d8e,0,Shameera Rathnayaka,2016-04-22 21:57:54-04:00,"['b5bdad1a6c92c909701dad87d42cd18c529b3e86', '26fd7c328da3a5a2344ac7d251fb2f972c62dbd4']",7264,24809,32073,8004221,144,,,,8085
84913b59677ffde19e80d07820b0a205007898d4,0,Mangirish Wagle,2016-04-23 12:41:29-04:00,"['4a1e79f46f55f10d60b904b2a1db4f1f3e053898', '26fd7c328da3a5a2344ac7d251fb2f972c62dbd4']",6944,23167,30111,8034332,116,,,,8085
916a825c31b1dda73fe577ab4d5ef4051b5f9aa7,1,scnakandala,2016-04-26 15:17:14-04:00,['22ae026168cf2fa5a0530e625a6aaf80eb63d692'],2,2,4,8034336,2,,,,8085
d721666ed386928e4ba52252c4dfdb5e3dfc570c,0,scnakandala,2016-04-26 15:18:05-04:00,"['916a825c31b1dda73fe577ab4d5ef4051b5f9aa7', '26fd7c328da3a5a2344ac7d251fb2f972c62dbd4']",12,25,37,8034373,2,,,,8085
79a9f1db7cba563d38060117772bce06effd512d,0,Suresh Marru,2016-04-27 15:21:38-04:00,"['d721666ed386928e4ba52252c4dfdb5e3dfc570c', 'de05f6b45c2b60d9e8254d90a9b43df87afd59df']",587,957,1544,8035917,7,,,,8085
60bfc4db9881d97706878fe54d66d4aa4444dea4,0,Suresh Marru,2016-04-27 15:24:17-04:00,['79a9f1db7cba563d38060117772bce06effd512d'],0,1,1,8035918,1,,,,8086
c65d05080f58cf1abb77c9fdf95bc03dc41942d9,0,Suresh Marru,2016-04-28 10:30:29-04:00,['60bfc4db9881d97706878fe54d66d4aa4444dea4'],1,2,3,8035921,1,,,,8086
81e4a397d2dc754bf67ef72bc3497e38324c16c2,1,scnakandala,2016-04-29 15:09:34-04:00,['c65d05080f58cf1abb77c9fdf95bc03dc41942d9'],0,2,2,8035923,1,0,0,0.5,8086
ab0541aeb0d9d09a4d70954f5d1299a6fa028bcc,1,scnakandala,2016-04-29 15:32:50-04:00,['81e4a397d2dc754bf67ef72bc3497e38324c16c2'],290,817,1107,8037030,98,0.252906977,0.110465116,0.994186047,8087
72b594a64c7df89f3d37486575c2e096f07fb87c,1,scnakandala,2016-04-29 15:56:10-04:00,['ab0541aeb0d9d09a4d70954f5d1299a6fa028bcc'],0,4,4,8037034,1,0,0,1,8087
7747df1be07b72993478dc74c80a084fcf28f661,1,scnakandala,2016-04-29 16:05:09-04:00,['72b594a64c7df89f3d37486575c2e096f07fb87c'],57,251,308,8037342,9,0,0,0.969879518,8087
8dafd8f8eec8122e8972d0738f8005d5f9b5cd1f,0,scnakandala,2016-04-29 16:07:01-04:00,['7747df1be07b72993478dc74c80a084fcf28f661'],2,2,4,8037346,2,,,,8087
ffd1954af3f12021b25544e88debb4d7d9336750,1,scnakandala,2016-04-29 16:11:36-04:00,['8dafd8f8eec8122e8972d0738f8005d5f9b5cd1f'],55,249,304,8037650,8,0,0,0.963855422,8087
f5cf05756577142c8a111e1bdd09fccf0b5e02f2,1,scnakandala,2016-04-29 16:13:46-04:00,['ffd1954af3f12021b25544e88debb4d7d9336750'],1,1,2,8037652,1,,,,8087
59726d7615ac121ce951a8484c375ea23940d6b0,1,scnakandala,2016-04-29 16:28:20-04:00,['f5cf05756577142c8a111e1bdd09fccf0b5e02f2'],3,2,5,8037657,1,1,1,1,8087
e93e071a7ae093b0ac1299578d3dfec3c996ec99,1,scnakandala,2016-05-01 13:37:34-04:00,['59726d7615ac121ce951a8484c375ea23940d6b0'],124,534,658,8038315,97,0.22611465,0.191082803,0.987261146,8087
63825ce32a4e129c663b6d23b3b15fbbede683a1,1,scnakandala,2016-05-01 13:40:17-04:00,['e93e071a7ae093b0ac1299578d3dfec3c996ec99'],111,111,222,8038537,1,,,,8087
3bb7f493dc9ab3b71177c1e1ac9b14c25e406519,1,scnakandala,2016-05-01 14:28:36-04:00,['63825ce32a4e129c663b6d23b3b15fbbede683a1'],9971,20911,30882,8069419,21,0.377319081,0.493426711,0.915100135,8087
421a441470e96dd08d8bd31ce4a7b3b2dab454c7,0,scnakandala,2016-05-01 20:43:13-04:00,['3bb7f493dc9ab3b71177c1e1ac9b14c25e406519'],673,1,674,8070093,11,0.770114943,0.687356322,0,8087
c7400a915da830c5736ae1acd9e423e1cc23c72d,1,scnakandala,2016-05-01 21:26:58-04:00,['421a441470e96dd08d8bd31ce4a7b3b2dab454c7'],261,542,803,8070896,12,0.169491525,0,0.949152542,8087
1b6ee7e1da71fb173287f9e915a93565632939cc,0,scnakandala,2016-05-02 00:00:49-04:00,['c7400a915da830c5736ae1acd9e423e1cc23c72d'],110,279,389,8071285,93,0.146853147,0,0.993006993,8087
5f59387a87b407a7c69912507cebd8f3c3cdca2d,0,scnakandala,2016-05-02 13:05:33-04:00,['1b6ee7e1da71fb173287f9e915a93565632939cc'],68,300,368,8071653,10,0.150259067,0.222797927,0.989637306,8087
3418fda517036442769ec14385d0dd4e79e273cd,0,scnakandala,2016-05-02 13:40:04-04:00,['5f59387a87b407a7c69912507cebd8f3c3cdca2d'],0,8,8,8071661,1,0,1,1,8087
0c9e4be024b7fe587f8b31a0c4399a2f65a82b15,0,scnakandala,2016-05-02 13:51:22-04:00,['3418fda517036442769ec14385d0dd4e79e273cd'],8,0,8,8071669,1,1,0,0,8087
944ccc891afdb8bda027e33eabf2cd535b134d47,0,scnakandala,2016-05-02 14:12:14-04:00,['0c9e4be024b7fe587f8b31a0c4399a2f65a82b15'],0,13,13,8071682,1,0,0,1,8087
12f5b014d681353b4a6a67133426dc936090c762,0,scnakandala,2016-05-02 14:30:47-04:00,['944ccc891afdb8bda027e33eabf2cd535b134d47'],32,7,39,8071721,2,1,1,0,8087
9f44797cad885b728cacf1cec2f059728f241909,0,scnakandala,2016-05-02 15:09:27-04:00,['12f5b014d681353b4a6a67133426dc936090c762'],14,20,34,8071755,1,0,0,1,8087
e3cdfd18a85521d48b88c2f5a8a6e3625e0783e1,0,scnakandala,2016-05-02 15:40:53-04:00,['9f44797cad885b728cacf1cec2f059728f241909'],7,21,28,8071783,3,0,0,1,8087
00b1630fb6f9d28ac467b0f00056c7bbd8b1869d,0,scnakandala,2016-05-02 16:17:17-04:00,['e3cdfd18a85521d48b88c2f5a8a6e3625e0783e1'],1,1,2,8071785,1,,,,8087
e1013926ad3e8ff261029a10ee7584333c9ac54a,1,scnakandala,2016-05-02 16:57:00-04:00,['00b1630fb6f9d28ac467b0f00056c7bbd8b1869d'],9711,6915,16626,8088411,9,0.6243309,0.5756691,0.076885645,8087
d1a6e5566141c4cdd1635be3a9237c9b065e9c1b,0,scnakandala,2016-05-02 16:58:28-04:00,['e1013926ad3e8ff261029a10ee7584333c9ac54a'],1,2,3,8088414,1,,,,8087
cd243d3bb6b141e072c831d02180bb3873fc9dce,1,scnakandala,2016-05-02 18:06:53-04:00,['d1a6e5566141c4cdd1635be3a9237c9b065e9c1b'],89,117,206,8088620,1,,,,8087
58401a6c6027b082ec7c64e207de592afb24246c,0,scnakandala,2016-05-02 18:52:04-04:00,['cd243d3bb6b141e072c831d02180bb3873fc9dce'],272,89,361,8088981,8,0.909677419,0.761290323,0.006451613,8087
988293e6cc1f400351b499fafe47063557047321,0,scnakandala,2016-05-02 19:01:52-04:00,['58401a6c6027b082ec7c64e207de592afb24246c'],182,93,275,8089256,4,0.802631579,1,0,8087
67b43ced088a478f1659b5de7c95cc84eda8c514,0,scnakandala,2016-05-02 19:15:07-04:00,['988293e6cc1f400351b499fafe47063557047321'],74,12,86,8089342,5,0.857142857,1,0.020408163,8087
220cbbd3ed92e1e5211ffb9e6cf7036669a968f6,0,scnakandala,2016-05-02 19:24:37-04:00,['67b43ced088a478f1659b5de7c95cc84eda8c514'],5,5,10,8089352,1,,,,8087
40c6f4027d4fa85a9f47f848322050fa8b8d251d,0,Suresh Marru,2016-05-05 12:35:48-04:00,['220cbbd3ed92e1e5211ffb9e6cf7036669a968f6'],0,1,1,8089353,1,,,,8087
4845de489c539ca388e8b7d5746fd309209170aa,0,Suresh Marru,2016-05-13 11:05:46-07:00,['fad21741d1f7c4df2b0d7ee9c7be637a15bd4d8e'],0,13,13,8089366,1,,,,8088
e16794762c0db579e8b1cf2aac26dceeebc9f818,0,Suresh Marru,2016-05-13 11:12:11-07:00,['40c6f4027d4fa85a9f47f848322050fa8b8d251d'],0,14,14,8089380,1,,,,8089
0f962e737bf763f73f8a8674b8d981b25e6688ab,0,Suresh Marru,2016-05-16 15:47:01-04:00,['4845de489c539ca388e8b7d5746fd309209170aa'],1,0,1,8089381,1,,,,8089
a6b27cea22cfb88133071608265ba04570f5f294,0,scnakandala,2016-05-16 17:22:12-04:00,['220cbbd3ed92e1e5211ffb9e6cf7036669a968f6'],0,4,4,8089385,4,0,1,1,8089
2c7da5eca1eecaa849b4653ed73f5844f2abda5f,0,scnakandala,2016-05-16 17:22:21-04:00,"['a6b27cea22cfb88133071608265ba04570f5f294', 'e16794762c0db579e8b1cf2aac26dceeebc9f818']",0,15,15,8089400,2,,,,8089
800b96f54e1410c8713bb2a9c6687101dab200c5,0,scnakandala,2016-05-22 21:28:41-04:00,['2c7da5eca1eecaa849b4653ed73f5844f2abda5f'],0,1,1,8089401,1,0,0,0,8089
4708005efe8013c280b6d91dfc511d805b8317fe,0,Mangirish Wagle,2016-05-24 17:19:03-05:00,"['84913b59677ffde19e80d07820b0a205007898d4', '2c7da5eca1eecaa849b4653ed73f5844f2abda5f']",5625,15203,20828,8110229,162,,,,8089
a69c789e205eff1f27020de8c1fb3185be39af21,0,Mangirish Wagle,2016-05-25 22:59:06-05:00,['4708005efe8013c280b6d91dfc511d805b8317fe'],5,79,84,8110313,2,0.357142857,0,1,8090
3eca754202c7cff3a5b079af86b8b75752f3369f,0,Suresh Marru,2016-06-10 15:24:20-04:00,['2c7da5eca1eecaa849b4653ed73f5844f2abda5f'],0,91,91,8110404,1,,,,8091
24ced80054f084a78d86fff36672c834e144d3e9,0,Jeff Kinnison,2016-06-10 16:46:02-04:00,['2c7da5eca1eecaa849b4653ed73f5844f2abda5f'],0,2337,2337,8112741,31,0.963963964,0.941441441,0.790540541,8122
486d7330b691f5c15e23449c787b5d921d4c1106,0,Suresh Marru,2016-06-12 16:58:41-04:00,['3eca754202c7cff3a5b079af86b8b75752f3369f'],18,10,28,8112769,4,,,,8122
f70a688d95e1fb10b749bdc23f59a3ae9c02d09f,0,Suresh Marru,2016-06-12 17:03:48-04:00,"['a69c789e205eff1f27020de8c1fb3185be39af21', '486d7330b691f5c15e23449c787b5d921d4c1106']",18,101,119,8112888,4,,,,8122
375b5314e823103c0fbe5a484168c96daf791c8f,0,Suresh Marru,2016-06-12 17:06:50-04:00,['f70a688d95e1fb10b749bdc23f59a3ae9c02d09f'],0,2337,2337,8115225,31,0.963963964,0.941441441,0.790540541,8153
0da02d27a054b3f631e58d0dfc3642c05c38dbf0,0,Suresh Marru,2016-06-12 17:09:56-04:00,['375b5314e823103c0fbe5a484168c96daf791c8f'],0,1976,1976,8117201,116,1,1,1,8269
4ed7cf4d2e0811f8de497e780f1b36d17194cb37,0,Suresh Marru,2016-06-12 17:13:47-04:00,['0da02d27a054b3f631e58d0dfc3642c05c38dbf0'],998,0,998,8118199,60,,,,8269
ba2e3b64c308ac012ae31270563b3b434d539559,0,Suresh Marru,2016-06-12 17:19:33-04:00,['4ed7cf4d2e0811f8de497e780f1b36d17194cb37'],0,0,0,8118199,0,,,,8269
ca49a0cdbe5694e3224f86208bf290837c8c0b04,0,Suresh Marru,2016-06-12 17:19:42-04:00,['ba2e3b64c308ac012ae31270563b3b434d539559'],0,0,0,8118199,0,,,,8269
5f5145d08e0e8f6902febe1534c9145791e1d35f,0,Suresh Marru,2016-06-12 17:20:02-04:00,['4ed7cf4d2e0811f8de497e780f1b36d17194cb37'],0,0,0,8118199,0,,,,8269
b0bcba1cd9219ec99c81c00da7393d14fc05e398,0,Suresh Marru,2016-06-12 17:20:05-04:00,['5f5145d08e0e8f6902febe1534c9145791e1d35f'],0,0,0,8118199,0,,,,8269
d244ac7b67eb287ae167a78f9f10813afabd6297,0,Suresh Marru,2016-06-12 17:25:49-04:00,"['ca49a0cdbe5694e3224f86208bf290837c8c0b04', 'b0bcba1cd9219ec99c81c00da7393d14fc05e398']",0,0,0,8118199,0,,,,8269
df0df1007a364050432629a69ce8db0e3061c8c6,0,Suresh Marru,2016-06-12 18:48:23-04:00,['d244ac7b67eb287ae167a78f9f10813afabd6297'],27,119,146,8118345,1,,,,8269
19c514ca4e861a9329fa9b2b395be6b4ea95a711,0,scnakandala,2016-06-13 10:37:55-04:00,"['800b96f54e1410c8713bb2a9c6687101dab200c5', 'df0df1007a364050432629a69ce8db0e3061c8c6']",23,3587,3610,8121955,93,,,,8269
21fcc27b59055cc464a26ac19f08963d390aeec9,0,scnakandala,2016-06-13 15:00:17-04:00,['19c514ca4e861a9329fa9b2b395be6b4ea95a711'],99,1153,1252,8123207,105,0.577160494,0.719135802,0.836419753,8283
43bef68af6e6bc05b654a097111e288bf4928417,0,scnakandala,2016-06-13 15:01:38-04:00,['21fcc27b59055cc464a26ac19f08963d390aeec9'],0,2,2,8123209,1,1,1,1,8283
f23fbd5be61d84e30162b1b90cd60ae07f2fbb24,0,scnakandala,2016-06-13 15:08:48-04:00,['43bef68af6e6bc05b654a097111e288bf4928417'],14,57,71,8123280,3,1,1,1,8284
75a87bb6162b95dcdadcf9e5842cd7ff1b8087f7,0,scnakandala,2016-06-20 00:38:40-04:00,['f23fbd5be61d84e30162b1b90cd60ae07f2fbb24'],0,7481,7481,8130761,16,0.240070783,0.26720409,0.990562328,8300
120d06af6ac9a6915e1fe99cfcc6ea991cb3e75e,0,Shameera Rathnayaka,2016-06-20 10:33:32-04:00,['f23fbd5be61d84e30162b1b90cd60ae07f2fbb24'],84,7565,7649,8138410,100,0.240070783,0.26720409,0.990562328,8316
a79e69028869dc8353d474aa65a6ba5ff3926b0b,0,Shameera Rathnayaka,2016-06-20 15:15:39-04:00,['120d06af6ac9a6915e1fe99cfcc6ea991cb3e75e'],0,583,583,8138993,10,0.831325301,1,0.779116466,8325
361357e8d816d68c0ae707620ee73cfe9eb58c8e,0,scnakandala,2016-06-20 16:23:17-04:00,['75a87bb6162b95dcdadcf9e5842cd7ff1b8087f7'],0,188,188,8139181,2,,,,8327
36afbe6478f9918981a284dfa910fa41be9a021b,0,scnakandala,2016-06-20 16:23:38-04:00,"['361357e8d816d68c0ae707620ee73cfe9eb58c8e', 'a79e69028869dc8353d474aa65a6ba5ff3926b0b']",84,667,751,8139932,94,,,,8327
c3ca681449bbf5ff4b3b937a2ca48284373f4395,0,scnakandala,2016-06-20 16:25:06-04:00,"['36afbe6478f9918981a284dfa910fa41be9a021b', '0f962e737bf763f73f8a8674b8d981b25e6688ab']",1,0,1,8139933,1,,,,8327
a13ec8adb7afb6600f3e941cab5ed59a896bec6d,0,Shameera Rathnayaka,2016-06-21 11:19:09-04:00,['c3ca681449bbf5ff4b3b937a2ca48284373f4395'],33,136,169,8140102,8,1,1,1,8328
c8edcbf04b2f714e99f163d29de3c1550206904c,0,scnakandala,2016-06-21 11:58:27-04:00,['c3ca681449bbf5ff4b3b937a2ca48284373f4395'],1,1,2,8140104,1,,,,8328
464012b247242924403a8ac5208a677e9296ce39,0,scnakandala,2016-06-21 15:24:07-04:00,['c8edcbf04b2f714e99f163d29de3c1550206904c'],18,13,31,8140135,1,,,,8328
79c59566b61edbcaf5428339219e8aa06c9a198c,0,scnakandala,2016-06-21 15:24:16-04:00,"['464012b247242924403a8ac5208a677e9296ce39', 'a13ec8adb7afb6600f3e941cab5ed59a896bec6d']",33,136,169,8140304,8,,,,8328
1ba2e7de88acb5ab735755a825f44ea98e7c4be1,0,scnakandala,2016-06-24 13:52:17-04:00,['79c59566b61edbcaf5428339219e8aa06c9a198c'],1,1,2,8140306,1,,,,8328
1ee72fbca6a7ecacfa318c95bf075a91511206c5,1,scnakandala,2016-06-25 00:29:05-04:00,['1ba2e7de88acb5ab735755a825f44ea98e7c4be1'],132,313,445,8140751,94,0,0.322147651,0.926174497,8328
8d937dba8056352a9d0bdf52a3d185078730ffec,0,scnakandala,2016-06-25 00:34:36-04:00,['1ee72fbca6a7ecacfa318c95bf075a91511206c5'],4,3,7,8140758,1,1,1,1,8328
e0050ddec9de6d7a13da6d007da8448fba955381,1,scnakandala,2016-06-27 13:16:21-04:00,['8d937dba8056352a9d0bdf52a3d185078730ffec'],1173,13,1186,8141944,7,0.857142857,0.857142857,1,8328
9dd7c14a94736e379cc46acb7e10dd22a8c8dfad,1,scnakandala,2016-06-27 13:29:54-04:00,['e0050ddec9de6d7a13da6d007da8448fba955381'],3426,6442,9868,8151812,99,0.346792284,0.368775236,0.928667564,8328
69e71fbd04752e60e9dcbe6e2a2bbc78cac15ca1,0,scnakandala,2016-06-27 15:25:51-04:00,['9dd7c14a94736e379cc46acb7e10dd22a8c8dfad'],97,0,97,8151909,1,0,0,0.694444444,8328
10b7b128515eb5e7cf27f4686815e7365d2fca21,1,scnakandala,2016-06-27 15:41:13-04:00,['69e71fbd04752e60e9dcbe6e2a2bbc78cac15ca1'],0,160,160,8152069,4,0,0,0,8328
c9ddaeb3de586a71d026a81e24eb1c7fe801b40d,1,scnakandala,2016-06-27 15:49:57-04:00,['10b7b128515eb5e7cf27f4686815e7365d2fca21'],28992,9647,38639,8190708,9,0.739848251,0.68406632,0.110369538,8328
08e9b45fc2e2ae37ff105bf18c96f823264b13e5,1,scnakandala,2016-06-27 16:06:26-04:00,['c9ddaeb3de586a71d026a81e24eb1c7fe801b40d'],10153,6551,16704,8207412,14,0.744186047,0.69066076,0.108896272,8328
cded43e86b4cb97abc0a0236a52fa3bc5ff0b001,0,scnakandala,2016-06-27 16:09:12-04:00,['08e9b45fc2e2ae37ff105bf18c96f823264b13e5'],0,62,62,8207474,1,1,1,1,8329
d23d5728877f3e948417063f807ba4054bf6bc07,0,scnakandala,2016-06-27 16:12:02-04:00,['cded43e86b4cb97abc0a0236a52fa3bc5ff0b001'],7,0,7,8207481,1,0,0,0,8329
49dfd423fa32b08fb1ea73f6b11dad677b746966,0,scnakandala,2016-06-27 16:14:39-04:00,['d23d5728877f3e948417063f807ba4054bf6bc07'],42,1,43,8207524,1,1,0,0,8329
b450b85a4780b62c14904f24f87a5bac0e0cd316,0,scnakandala,2016-06-27 16:17:45-04:00,['49dfd423fa32b08fb1ea73f6b11dad677b746966'],151,0,151,8207675,2,0,0,1,8329
b34d8a450c37028d61bd446c1d7e1884695a3a3c,0,scnakandala,2016-06-27 16:21:28-04:00,['b450b85a4780b62c14904f24f87a5bac0e0cd316'],14,2,16,8207691,1,,,,8329
4e53f23ae2eb30ab0c1f080c69cdc97836f94ad1,1,scnakandala,2016-06-27 17:54:42-04:00,['b34d8a450c37028d61bd446c1d7e1884695a3a3c'],8,25,33,8207724,3,0,0,0,8329
233e6142915ddc5973e8a15dd56d9d4a628c4cd7,1,scnakandala,2016-06-27 18:05:38-04:00,['4e53f23ae2eb30ab0c1f080c69cdc97836f94ad1'],1,1,2,8207726,1,,,,8329
35d07069104fff15ff6ff0aaf1d41217b3ee86c6,0,scnakandala,2016-06-27 18:13:06-04:00,['233e6142915ddc5973e8a15dd56d9d4a628c4cd7'],1,1,2,8207728,1,,,,8329
ad6b5257ac315e98adfd7df44f7e99d79654dafd,0,scnakandala,2016-06-27 18:26:29-04:00,['35d07069104fff15ff6ff0aaf1d41217b3ee86c6'],2,7,9,8207737,1,0,0,0,8329
7a636a4e581a7752bb1b4764c37b1af727cfd6e2,0,scnakandala,2016-06-27 18:32:00-04:00,['ad6b5257ac315e98adfd7df44f7e99d79654dafd'],1,1,2,8207739,1,,,,8329
aedabdb322fab68cd9432fcf3475eccaba02d52d,1,scnakandala,2016-06-27 18:58:43-04:00,['7a636a4e581a7752bb1b4764c37b1af727cfd6e2'],11,28,39,8207778,3,0,0,0,8329
b673bcd34c3b529824ff15fb9f121c3087df81fa,1,Shameera Rathnayaka,2016-06-28 16:32:37-04:00,['aedabdb322fab68cd9432fcf3475eccaba02d52d'],0,169,169,8207947,2,,,,8331
8e390839587a31fd8adc40ea3e67f73d68459f2b,0,Shameera Rathnayaka,2016-06-28 16:32:37-04:00,['b673bcd34c3b529824ff15fb9f121c3087df81fa'],2,7,9,8207956,1,,,,8331
11558d6a56c6e86981c9e32939352de8e83f2894,0,Shameera Rathnayaka,2016-06-28 16:32:37-04:00,['8e390839587a31fd8adc40ea3e67f73d68459f2b'],43,45,88,8208044,5,0.909090909,0.909090909,1,8331
31f431523c331b0bccd54309409b3a8dd19d6b06,0,Shameera Rathnayaka,2016-06-28 16:32:37-04:00,['11558d6a56c6e86981c9e32939352de8e83f2894'],14,35,49,8208093,2,0,0.8,1,8331
5757f1243260dcaf683a852217137b03bd7897bc,0,Shameera Rathnayaka,2016-06-28 16:32:37-04:00,['31f431523c331b0bccd54309409b3a8dd19d6b06'],23,36,59,8208152,3,0,1,1,8331
94a9fca6ff7e9eed140d9c8e28df4da736dbf1dc,0,Shameera Rathnayaka,2016-06-28 16:57:45-04:00,['5757f1243260dcaf683a852217137b03bd7897bc'],581,1,582,8208734,6,,,,8331
56450315aef0d51df8107eba750886aa43bedf25,0,Shameera Rathnayaka,2016-07-05 11:29:09-04:00,['94a9fca6ff7e9eed140d9c8e28df4da736dbf1dc'],228,240,468,8209202,96,0,0,1,8331
b9b43b6bf21155ad4098e346cedb78848f6032ef,0,Shameera Rathnayaka,2016-07-05 12:19:14-04:00,['56450315aef0d51df8107eba750886aa43bedf25'],3,29,32,8209234,4,0,0.416666667,1,8331
c382ae2ab059240d48938664794498d78999056b,0,scnakandala,2016-07-05 16:56:28-04:00,['b9b43b6bf21155ad4098e346cedb78848f6032ef'],4,7,11,8209245,1,0,1,1,8331
d20f77e4b5d3545fe01facbb9b2a3b0f9f6ce16c,0,scnakandala,2016-07-05 18:50:29-04:00,['c382ae2ab059240d48938664794498d78999056b'],5,35,40,8209285,1,0,0,1,8331
73fee6be73c9265e637475e6c4443b895fe9556c,1,Shameera Rathnayaka,2016-07-06 14:32:05-04:00,['d20f77e4b5d3545fe01facbb9b2a3b0f9f6ce16c'],5,5,10,8209295,3,,1,,8331
0b40482a915e848dabce421ef5518f31249950a1,1,scnakandala,2016-07-06 14:49:05-04:00,['d20f77e4b5d3545fe01facbb9b2a3b0f9f6ce16c'],94,285,379,8209674,96,0.207792208,0.305194805,0.993506494,8331
7addfd91640c46194ec2b2181275bcc80c1c05d6,0,scnakandala,2016-07-06 14:49:14-04:00,"['0b40482a915e848dabce421ef5518f31249950a1', '73fee6be73c9265e637475e6c4443b895fe9556c']",5,5,10,8209684,3,,,,8331
0bc5513ecf5fe671b733b56ef6c3344c416ab244,1,scnakandala,2016-07-06 16:31:24-04:00,['7addfd91640c46194ec2b2181275bcc80c1c05d6'],1,1,2,8209686,1,,,,8331
70f85795304e8ce719ffac50d41b5b31cf9fc800,1,scnakandala,2016-07-07 11:42:48-04:00,['0bc5513ecf5fe671b733b56ef6c3344c416ab244'],28671,39605,68276,8277962,109,0.270132639,0.305779252,0.88654666,8331
89e0fdc80740223c44e676a5de4ac36d6cddebcb,1,scnakandala,2016-07-07 11:43:40-04:00,['70f85795304e8ce719ffac50d41b5b31cf9fc800'],0,11014,11014,8288976,53,0.307122507,0.427350427,0.51965812,8384
461f7ec485521834278d10e01325b976d24f55c6,0,Suresh Marru,2016-07-07 12:04:24-04:00,['0bc5513ecf5fe671b733b56ef6c3344c416ab244'],16,15,31,8289007,1,,,,8384
c3ea76ed8ee74e1bf3059ddee0fbcb9185c29290,0,scnakandala,2016-07-07 12:55:23-04:00,['89e0fdc80740223c44e676a5de4ac36d6cddebcb'],6,14,20,8289027,1,0,0,0,8384
5d1f9e706848639301e7f9cbac95ed88c7435a58,0,scnakandala,2016-07-07 15:46:55-04:00,['c3ea76ed8ee74e1bf3059ddee0fbcb9185c29290'],1,6,7,8289034,1,1,1,1,8384
59449b28eae9ab112386e2d30b3b18891870d34c,0,scnakandala,2016-07-07 16:23:49-04:00,['5d1f9e706848639301e7f9cbac95ed88c7435a58'],1,1,2,8289036,1,,,,8384
2c1dc547567f6028ba81d290e6977749536283c9,0,scnakandala,2016-07-07 16:33:13-04:00,['59449b28eae9ab112386e2d30b3b18891870d34c'],2,2,4,8289040,1,,,,8384
9f57e42204938ac32ffbdf9aa5153118a1441eaf,0,scnakandala,2016-07-07 16:48:17-04:00,['2c1dc547567f6028ba81d290e6977749536283c9'],1,1,2,8289042,1,,,,8384
639813231a297be0ac50a94050a9ae6341c7de3d,0,scnakandala,2016-07-08 00:02:54-04:00,['9f57e42204938ac32ffbdf9aa5153118a1441eaf'],5,890,895,8289937,4,,,,8386
2d398cf3573f6001e972d54fbb90d377ecd9ad01,0,Shameera Rathnayaka,2016-07-08 15:29:08-04:00,['461f7ec485521834278d10e01325b976d24f55c6'],2,7,9,8289946,1,,,,8386
7cd9457e9293a56cc2384a0f722a7b642086c86b,0,scnakandala,2016-07-08 17:19:01-04:00,"['518868a55dd10df8d602f9aaf828997a739ae738', '2d398cf3573f6001e972d54fbb90d377ecd9ad01']",27290,46416,73706,8363652,380,,,,8386
4260622609004be83f77245ece7c6c64de240b19,0,scnakandala,2016-07-08 18:53:39-04:00,['2d398cf3573f6001e972d54fbb90d377ecd9ad01'],195,8,203,8363855,6,1,1,1,8386
d2f964b8d4ef93acac617d1531a4d63cc1fd1869,0,scnakandala,2016-07-08 18:54:09-04:00,"['7cd9457e9293a56cc2384a0f722a7b642086c86b', '4260622609004be83f77245ece7c6c64de240b19']",195,8,203,8364058,6,,,,8386
35466d476e2db5b50286e934c556bcf3bcbb6929,1,scnakandala,2016-07-08 18:55:39-04:00,['639813231a297be0ac50a94050a9ae6341c7de3d'],92,94,186,8364244,1,,,,8386
52dc070d7acc3d0d5cb8d80416884bacb5f0d04d,0,Vivek Sachdeva,2016-07-10 13:55:22-07:00,['35466d476e2db5b50286e934c556bcf3bcbb6929'],197,393,590,8364834,5,0,0.32278481,0.278481013,8386
9ced67388e553a59420bfd4c637520b67b923d48,0,Suresh Marru,2016-07-11 09:44:42-04:00,['4260622609004be83f77245ece7c6c64de240b19'],3,16,19,8364853,1,,,,8386
f85d41ae4bd96db022fff9aa0e59c2a7c4caf589,0,scnakandala,2016-07-11 12:27:50-04:00,['9ced67388e553a59420bfd4c637520b67b923d48'],1,111,112,8364965,3,0.882352941,0.882352941,1,8386
6148dabfbb3e4d1c794988b23018596b06a3e361,1,scnakandala,2016-07-11 12:38:21-04:00,['52dc070d7acc3d0d5cb8d80416884bacb5f0d04d'],2,2,4,8364969,1,,,,8386
034de76cf6a41bc44aa5ce0aeb92b3890bf455c8,0,scnakandala,2016-07-11 13:19:35-04:00,['f85d41ae4bd96db022fff9aa0e59c2a7c4caf589'],530,1290,1820,8366789,97,0.149425287,0.054187192,0.993431856,8386
7c6a11d3ab871c2687d08695fbf1421ad5fcabde,0,scnakandala,2016-07-11 15:38:40-04:00,['6148dabfbb3e4d1c794988b23018596b06a3e361'],2,6,8,8366797,1,0.5,1,1,8386
c772db0eb3494d806e8c1d126f7193d37fe3cc6e,0,Shameera Rathnayaka,2016-07-11 18:34:19-04:00,['d2f964b8d4ef93acac617d1531a4d63cc1fd1869'],37,38,75,8366872,2,1,0,0,8386
1ec186e4ba28e306b97d0fb3b129bbadad0ff6a2,0,Shameera Rathnayaka,2016-07-11 18:45:52-04:00,['c772db0eb3494d806e8c1d126f7193d37fe3cc6e'],0,294,294,8367166,1,,,,8386
171ee0c26354f1cea131a2bbed81557283090da1,1,scnakandala,2016-07-11 18:48:47-04:00,['7c6a11d3ab871c2687d08695fbf1421ad5fcabde'],37729,52952,90681,8457847,102,0.326688434,0.365698574,0.919144183,8386
2cf282d5c554e38b068063201a4301a10d2ee2b6,0,Shameera Rathnayaka,2016-07-11 18:57:42-04:00,['1ec186e4ba28e306b97d0fb3b129bbadad0ff6a2'],39,39,78,8457925,1,,,,8386
eaf20ccf26819132d17aed02aed8601383298d54,0,scnakandala,2016-07-12 11:49:42-04:00,['171ee0c26354f1cea131a2bbed81557283090da1'],3,68,71,8457996,4,0.14893617,1,0.574468085,8386
2e7ecb3f95d0cd33635b11493bbf64d54e99d71e,1,scnakandala,2016-07-12 12:01:09-04:00,['eaf20ccf26819132d17aed02aed8601383298d54'],0,933,933,8458929,2,0.305263158,0.282706767,1,8388
714fcae8c1ef55308b98117b39604d7b7f329646,0,Shameera Rathnayaka,2016-07-12 13:46:51-04:00,['2cf282d5c554e38b068063201a4301a10d2ee2b6'],1,1,2,8458931,1,,,,8388
d3e14997b6f5aa9f7d1bc4b110c802c7830e26c9,0,Shameera Rathnayaka,2016-07-12 13:48:19-04:00,['714fcae8c1ef55308b98117b39604d7b7f329646'],3,16,19,8458950,1,,,,8388
07c725ae26c01f0fb68296ac4f5df93a8d209c6a,1,Shameera Rathnayaka,2016-07-12 13:48:19-04:00,['d3e14997b6f5aa9f7d1bc4b110c802c7830e26c9'],1,111,112,8459062,3,0.882352941,0.882352941,1,8388
fd5d8369b4a1491c3668b603d79f07e0a6d5ee77,1,Shameera Rathnayaka,2016-07-12 13:48:19-04:00,['07c725ae26c01f0fb68296ac4f5df93a8d209c6a'],530,1290,1820,8460882,97,0.149425287,0.054187192,0.993431856,8388
2a3b3489dcc493049035fab587ac50a0a4d04ae8,0,Shameera Rathnayaka,2016-07-12 13:48:45-04:00,"['fd5d8369b4a1491c3668b603d79f07e0a6d5ee77', '034de76cf6a41bc44aa5ce0aeb92b3890bf455c8']",0,0,0,8460882,0,,,,8388
3b09770a8dfef3a3f7f0c5d4f775d7678a3b233e,0,Shameera Rathnayaka,2016-07-12 15:05:01-04:00,['2a3b3489dcc493049035fab587ac50a0a4d04ae8'],86,154,240,8461122,87,1,1,1,8389
1148ffc078a4dafbb5f3e38d355f9faa07320594,0,Shameera Rathnayaka,2016-07-12 16:39:56-04:00,['3b09770a8dfef3a3f7f0c5d4f775d7678a3b233e'],1,2,3,8461125,1,,,,8389
d12f590e807c84310e879b9c3241a748ba7a553f,0,scnakandala,2016-07-12 19:24:57-04:00,['2e7ecb3f95d0cd33635b11493bbf64d54e99d71e'],0,7,7,8461132,2,0.8,0.8,0.8,8389
5f9dacea192c250ab18551423974b43f394c3659,0,scnakandala,2016-07-12 19:25:48-04:00,['d12f590e807c84310e879b9c3241a748ba7a553f'],5,0,5,8461137,1,0,0,0,8389
77e661b63fa1d5f6179423d29b49d96c7770137f,1,Suresh Marru,2016-07-13 00:18:04-04:00,['1148ffc078a4dafbb5f3e38d355f9faa07320594'],94,959,1053,8462190,91,0.093959732,0.228187919,0.993288591,8389
1fdcf2a4147ef1dcc23f505157bc1acd94329528,0,Shameera Rathnayaka,2016-07-13 00:33:00-04:00,['1148ffc078a4dafbb5f3e38d355f9faa07320594'],173,947,1120,8463310,97,,,,8390
bafcebf73378f799491ad5bc0ea32d3815cf7804,0,Shameera Rathnayaka,2016-07-13 00:33:14-04:00,"['1fdcf2a4147ef1dcc23f505157bc1acd94329528', '77e661b63fa1d5f6179423d29b49d96c7770137f']",94,959,1053,8464363,91,,,,8390
2c6d1d5e08cf6272f59ae279f0acb568cd522349,1,scnakandala,2016-07-13 01:05:10-04:00,['bafcebf73378f799491ad5bc0ea32d3815cf7804'],0,119,119,8464482,4,0.564705882,0.882352941,1,8390
620d9fb6aecadff92c95aa27a28517d62d5a7684,0,scnakandala,2016-07-13 01:31:48-04:00,"['5f9dacea192c250ab18551423974b43f394c3659', '2c6d1d5e08cf6272f59ae279f0acb568cd522349']",453,2180,2633,8467115,117,,,,8390
d6a8208ce6bbd37b71aa40b2ce1d3fd97c2c8ae4,0,scnakandala,2016-07-13 01:37:28-04:00,['620d9fb6aecadff92c95aa27a28517d62d5a7684'],324,1556,1880,8468995,89,0.115121951,0.138536585,1,8390
d0018464e7eaffa8e6b1ce18dc683a19a7e92517,1,scnakandala,2016-07-13 12:00:51-04:00,['d6a8208ce6bbd37b71aa40b2ce1d3fd97c2c8ae4'],128,107,235,8469230,2,1,1,1,8390
ddda60c7085a58264017b074ce65c7d6ce426055,1,scnakandala,2016-07-13 13:26:38-04:00,['2c6d1d5e08cf6272f59ae279f0acb568cd522349'],4,12,16,8469246,2,0,1,1,8390
69631afc8e30a07aef3a900ec474c8c77c19e354,0,scnakandala,2016-07-13 13:27:17-04:00,"['d0018464e7eaffa8e6b1ce18dc683a19a7e92517', 'ddda60c7085a58264017b074ce65c7d6ce426055']",4,12,16,8469262,2,,,,8390
d9d0aa5209da2846f43813ac3b09d985b8a1ae1c,0,Shameera Rathnayaka,2016-07-13 14:33:48-04:00,['ddda60c7085a58264017b074ce65c7d6ce426055'],0,1,1,8469263,1,,,,8390
53e143ae2929e4ec475aac96aa36082c1b64a7be,0,Shameera Rathnayaka,2016-07-13 14:56:08-04:00,['d9d0aa5209da2846f43813ac3b09d985b8a1ae1c'],70,58,128,8469391,48,,,,8390
18154337ea1f74f066021ce6c80f51b636d3a22a,0,Shameera Rathnayaka,2016-07-13 14:56:42-04:00,['53e143ae2929e4ec475aac96aa36082c1b64a7be'],50,50,100,8469491,48,,,,8390
1e355bb88030ee3abdbe78fc06138c496788a36c,1,scnakandala,2016-07-14 01:15:08-04:00,['ddda60c7085a58264017b074ce65c7d6ce426055'],0,2,2,8469493,1,0,1,1,8390
1bf88d5028f044a32308c6b5d320c242191e4649,0,scnakandala,2016-07-14 01:15:21-04:00,"['1e355bb88030ee3abdbe78fc06138c496788a36c', 'd9d0aa5209da2846f43813ac3b09d985b8a1ae1c']",0,1,1,8469494,1,,,,8390
639e8910e3770153f8dc4521b9d2e4fc3c12e420,0,scnakandala,2016-07-14 01:16:20-04:00,"['69631afc8e30a07aef3a900ec474c8c77c19e354', '1bf88d5028f044a32308c6b5d320c242191e4649']",0,3,3,8469497,2,,,,8390
168739652eedfb4e5c637f253701a6ad56be1dfb,1,scnakandala,2016-07-14 01:39:18-04:00,['1bf88d5028f044a32308c6b5d320c242191e4649'],0,1,1,8469498,1,0,0,1,8390
21dee28f5001566cb77bf6c8fd3b0d344bfbb794,0,scnakandala,2016-07-14 01:40:04-04:00,"['639e8910e3770153f8dc4521b9d2e4fc3c12e420', '168739652eedfb4e5c637f253701a6ad56be1dfb']",0,1,1,8469499,1,,,,8390
936a4990f2e660925852437c99b3a4aba4dba237,1,scnakandala,2016-07-14 02:46:52-04:00,['21dee28f5001566cb77bf6c8fd3b0d344bfbb794'],0,1,1,8469500,1,0,0,1,8390
612999804e9003f3a234cdedf6de725f51316adc,1,scnakandala,2016-07-14 02:48:18-04:00,['168739652eedfb4e5c637f253701a6ad56be1dfb'],0,1,1,8469501,1,0,0,1,8390
14bd6d9ab65e337971b82f92671dbf20c7c83899,1,scnakandala,2016-07-14 02:56:42-04:00,['612999804e9003f3a234cdedf6de725f51316adc'],143,337,480,8469981,94,0,0,0.963855422,8390
4e92050b2a5a3031a0606dbfe4a6baea9d5eee8b,0,scnakandala,2016-07-14 02:58:37-04:00,"['936a4990f2e660925852437c99b3a4aba4dba237', '14bd6d9ab65e337971b82f92671dbf20c7c83899']",120,274,394,8470375,93,,,,8390
ab43d4f5ed021f625b428aedf586a771b2457633,0,scnakandala,2016-07-14 03:01:21-04:00,['4e92050b2a5a3031a0606dbfe4a6baea9d5eee8b'],24,65,89,8470464,3,0.088235294,0,0.970588235,8390
1871ba11d3c16a307c418fe8679c8034ce937cd3,1,scnakandala,2016-07-14 17:48:01-04:00,['ab43d4f5ed021f625b428aedf586a771b2457633'],1,11,12,8470476,1,0,0,0,8390
defc75b478327255469a10bcbf1e1c7781699f82,0,scnakandala,2016-07-15 09:21:00-04:00,['1871ba11d3c16a307c418fe8679c8034ce937cd3'],1,8,9,8470485,1,0,0,0,8390
971947c16435b269b927129a73d3edcb4f4703a1,0,scnakandala,2016-07-15 10:37:48-04:00,['defc75b478327255469a10bcbf1e1c7781699f82'],0,11,11,8470496,1,0,0,0,8390
c811b57efff9e411cd413215d6ba19ab19f89303,0,Shameera Rathnayaka,2016-07-15 14:28:05-04:00,['18154337ea1f74f066021ce6c80f51b636d3a22a'],0,2,2,8470498,1,0,1,1,8390
b7768cc0fd0c527524566d97f95d545dd979e994,0,Shameera Rathnayaka,2016-07-15 14:28:05-04:00,['c811b57efff9e411cd413215d6ba19ab19f89303'],0,1,1,8470499,1,0,0,1,8390
7ced64949d26bfab47ce42effc5de414c319074d,0,Shameera Rathnayaka,2016-07-15 14:28:05-04:00,['b7768cc0fd0c527524566d97f95d545dd979e994'],0,1,1,8470500,1,0,0,1,8390
5e145547829feb5d97d389693a02bfedad71166f,0,Shameera Rathnayaka,2016-07-15 14:28:05-04:00,['7ced64949d26bfab47ce42effc5de414c319074d'],143,337,480,8470980,94,0,0,0.963855422,8390
537098e683503a47dbf7f3beaaaabc88b565d3bd,0,Shameera Rathnayaka,2016-07-15 14:28:21-04:00,"['5e145547829feb5d97d389693a02bfedad71166f', '14bd6d9ab65e337971b82f92671dbf20c7c83899']",0,0,0,8470980,0,,,,8390
501d3d8f8ab83453fe12d457517796afa98a5de1,0,Shameera Rathnayaka,2016-07-15 14:58:19-04:00,['537098e683503a47dbf7f3beaaaabc88b565d3bd'],0,2,2,8470982,1,0,1,1,8390
3d5af1950f181804dee250b041b28366de465500,0,scnakandala,2016-07-16 11:51:19-04:00,['971947c16435b269b927129a73d3edcb4f4703a1'],17,10,27,8471009,1,1,0,1,8390
67e1f7bd16e0bcf1147947e13823fc51dbb64d07,0,scnakandala,2016-07-20 13:29:49-04:00,['501d3d8f8ab83453fe12d457517796afa98a5de1'],1,4,5,8471014,1,0,0,1,8390
b0bccc18bb8dc0c06cf3186916a085d09f27e1f3,0,scnakandala,2016-07-27 12:41:40-04:00,['14bd6d9ab65e337971b82f92671dbf20c7c83899'],0,4,4,8471018,1,0,1,1,8390
9ce2541327e675d41fd8259a9158b6eb327900eb,0,scnakandala,2016-07-27 12:46:10-04:00,"['b0bccc18bb8dc0c06cf3186916a085d09f27e1f3', '501d3d8f8ab83453fe12d457517796afa98a5de1']",69,59,128,8471146,49,,,,8390
e43a5a52c205d53b3b9e21e5a962c0d52a45ae6f,0,scnakandala,2016-07-27 13:01:51-04:00,['9ce2541327e675d41fd8259a9158b6eb327900eb'],1,1,2,8471148,1,,,,8390
c1c3035d56b052d8fb99704c1af798ee4b079ab8,0,scnakandala,2016-07-27 15:21:36-04:00,['e43a5a52c205d53b3b9e21e5a962c0d52a45ae6f'],27,22,49,8471197,1,1,0,0,8390
f28a47e871ba4e5b3fc3d4ed09abea1a26e3c738,0,Shameera,2016-07-28 12:05:48-04:00,[],0,203,203,8471400,2,,,,8392
83e98ae383c01f72d1b0ca097f75bcf52cf15f1b,1,Shameera Rathnayaka,2016-07-28 12:12:54-04:00,['f28a47e871ba4e5b3fc3d4ed09abea1a26e3c738'],0,1297,1297,8472697,29,,,,8421
76e613a867c568036942cfa3dba633f803a7f095,0,Shameera Rathnayaka,2016-07-28 12:30:42-04:00,['83e98ae383c01f72d1b0ca097f75bcf52cf15f1b'],0,17,17,8472714,1,,,,8421
bbe01a76f70268ef6b8988c3b9f56179940b4321,0,Shameera Rathnayaka,2016-07-28 12:31:47-04:00,['76e613a867c568036942cfa3dba633f803a7f095'],6,6,12,8472726,1,,,,8421
fdafdcb5e603abb2e71a24d094483c0ab9ca723a,0,Shameera Rathnayaka,2016-07-28 12:43:43-04:00,['bbe01a76f70268ef6b8988c3b9f56179940b4321'],11,15,26,8472752,1,,,,8421
5f7bce68e19bec727d203c1e5f1fc961f12c86db,0,Shameera Rathnayaka,2016-07-28 12:48:53-04:00,['bbe01a76f70268ef6b8988c3b9f56179940b4321'],11,15,26,8472778,1,,,,8421
f50e7adc75331ba7fa8093aa06347f1c6f03edc8,0,Shameera Rathnayaka,2016-07-28 12:49:29-04:00,"['5f7bce68e19bec727d203c1e5f1fc961f12c86db', 'fdafdcb5e603abb2e71a24d094483c0ab9ca723a']",0,4,4,8472782,1,,,,8421
c73f0b0ae6f0b46fed433976f9be0a8f19868971,0,scnakandala,2016-07-28 13:38:58-04:00,"['c1c3035d56b052d8fb99704c1af798ee4b079ab8', '3d5af1950f181804dee250b041b28366de465500']",40245,79654,119899,8592681,89,,,,8421
5025f4f42f62d422d5c13abe0ad2be65d4f151d3,0,scnakandala,2016-07-28 13:44:41-04:00,['c73f0b0ae6f0b46fed433976f9be0a8f19868971'],1,1,2,8592683,1,,,,8421
29e666a5fd4d505398b6b570711c619813d0d2e2,0,scnakandala,2016-07-28 16:31:13-04:00,['5025f4f42f62d422d5c13abe0ad2be65d4f151d3'],22,23,45,8592728,1,0,1,1,8421
c5b37ac515fbeb400358e0f31ff147eae0fca0bb,1,Shameera Rathnayaka,2016-07-29 01:15:03-04:00,['f50e7adc75331ba7fa8093aa06347f1c6f03edc8'],1,342,343,8593071,5,,,,8424
cf8be0d640cba67469cdcffab4b53d19025243cc,0,Shameera Rathnayaka,2016-07-29 01:20:05-04:00,['c5b37ac515fbeb400358e0f31ff147eae0fca0bb'],0,5,5,8593076,2,,,,8425
b311aa0ded9d4d4610691393bd23fab9b63cf1f5,0,scnakandala,2016-07-29 12:48:23-04:00,['29e666a5fd4d505398b6b570711c619813d0d2e2'],0,4,4,8593080,1,0,1,1,8425
22a68ccb3456972e2137d4c2c94bc7b1e736533e,0,Shameera Rathnayaka,2016-08-01 14:32:07-04:00,['cf8be0d640cba67469cdcffab4b53d19025243cc'],5,5,10,8593090,5,,,,8425
1fb43694649a5d0ad12a78fd13deb748e5bbeaaa,0,Shameera Rathnayaka,2016-08-01 14:32:38-04:00,['22a68ccb3456972e2137d4c2c94bc7b1e736533e'],4,4,8,8593098,1,,,,8425
414c0e9c7ff89d12550ca373e4b06a5eb2938f49,0,Shameera Rathnayaka,2016-08-01 20:35:21-04:00,['1fb43694649a5d0ad12a78fd13deb748e5bbeaaa'],8,98,106,8593204,8,,,,8430
433ae48bb6b38d850f64d3ce6392acd6c4fd8d64,0,Shameera Rathnayaka,2016-08-01 23:19:33-04:00,['414c0e9c7ff89d12550ca373e4b06a5eb2938f49'],20,14,34,8593238,4,,,,8430
3e9935f2a93c353dd9c682432ebd0255ff87a24a,1,scnakandala,2016-08-03 10:37:21-04:00,['b311aa0ded9d4d4610691393bd23fab9b63cf1f5'],101,321,422,8593660,97,0.065088757,0.201183432,0.99408284,8430
79bdeb12336faed97308fb34a9e6a65b213361a3,1,scnakandala,2016-08-03 10:39:14-04:00,['3e9935f2a93c353dd9c682432ebd0255ff87a24a'],0,2,2,8593662,1,0,1,1,8430
2d959e0a96f9b7b266ece3eb4e50601941d96ee1,0,Shameera Rathnayaka,2016-08-05 15:47:22-04:00,"['79bdeb12336faed97308fb34a9e6a65b213361a3', '67e1f7bd16e0bcf1147947e13823fc51dbb64d07']",1,4,5,8593667,1,,,,8430
3aca4e95f571294a94171276c20acb3e4c10af50,0,Shameera Rathnayaka,2016-08-05 15:58:06-04:00,['67e1f7bd16e0bcf1147947e13823fc51dbb64d07'],0,26,26,8593693,1,,,,8430
b08d0e6edf1beb024deddec914328d9c9e885230,0,Shameera Rathnayaka,2016-08-05 16:16:52-04:00,['3aca4e95f571294a94171276c20acb3e4c10af50'],88,88,176,8593869,88,,,,8430
a3f8d888153044a7c455b79f4c515274afd81d4d,0,Shameera Rathnayaka,2016-08-05 16:36:37-04:00,['b08d0e6edf1beb024deddec914328d9c9e885230'],2,28,30,8593899,4,,,,8430
7850458fae107e014e4db5255699fb56c48b9186,0,Shameera Rathnayaka,2016-08-05 16:44:15-04:00,"['2d959e0a96f9b7b266ece3eb4e50601941d96ee1', 'a3f8d888153044a7c455b79f4c515274afd81d4d']",90,142,232,8594131,93,,,,8430
c1df0551dae25214cf9fc12637cfb39cf177215e,0,Shameera Rathnayaka,2016-08-05 16:47:27-04:00,['a3f8d888153044a7c455b79f4c515274afd81d4d'],8,181,189,8594320,6,0.127516779,0.228187919,0.993288591,8430
f831fedf0a71aae27ffc6fc581f37b16e28fd303,1,Shameera Rathnayaka,2016-08-05 17:52:10-04:00,['c1df0551dae25214cf9fc12637cfb39cf177215e'],110,898,1008,8595328,20,0.276923077,0.427350427,0.994871795,8430
9bc25f9a117370dabbea4f4300f6d133feddf062,0,Shameera Rathnayaka,2016-08-05 18:49:44-04:00,['f831fedf0a71aae27ffc6fc581f37b16e28fd303'],4,16,20,8595348,1,1,1,1,8430
ab6c1de672fa9f20283d90cb5ed075393d9da462,0,Shameera Rathnayaka,2016-08-05 18:50:30-04:00,"['7850458fae107e014e4db5255699fb56c48b9186', '9bc25f9a117370dabbea4f4300f6d133feddf062']",23,996,1019,8596367,20,,,,8430
a4716a7b3bdf07645370117edc0b9484d3308dab,1,Shameera Rathnayaka,2016-08-05 19:41:44-04:00,['9bc25f9a117370dabbea4f4300f6d133feddf062'],0,113,113,8596480,7,0.666666667,0.777777778,1,8430
f88859bf3de8b3b9924dcd7d3db12931d586b268,0,Shameera Rathnayaka,2016-08-05 19:42:15-04:00,"['ab6c1de672fa9f20283d90cb5ed075393d9da462', 'a4716a7b3bdf07645370117edc0b9484d3308dab']",0,113,113,8596593,7,,,,8430
2d9fd253b6e348a4cfb83e64b235f6adabfe4fa6,1,scnakandala,2016-08-08 14:14:09-04:00,['f88859bf3de8b3b9924dcd7d3db12931d586b268'],1,143221,143222,8739815,23,0.598467035,0.798363209,0.97997781,8449
4e9c4f049ea778588255fa1f35e36e76be3bafe0,0,scnakandala,2016-08-08 14:36:33-04:00,['2d9fd253b6e348a4cfb83e64b235f6adabfe4fa6'],11,23,34,8739849,2,0,0,1,8449
7666d32c80094628bb46c7bd1947ce402dd33fee,1,scnakandala,2016-08-08 15:38:34-04:00,['4e9c4f049ea778588255fa1f35e36e76be3bafe0'],15,19,34,8739883,6,,,,8449
610a8d2e39c815a4256901e80db185f3b81d087f,1,scnakandala,2016-08-08 17:33:28-04:00,['7666d32c80094628bb46c7bd1947ce402dd33fee'],8,404,412,8740295,11,0.239520958,0.299401198,0.994011976,8449
388d90a8356186d91ba2de85aab0a0708e1e60ee,0,scnakandala,2016-08-09 13:09:11-04:00,['610a8d2e39c815a4256901e80db185f3b81d087f'],1,1,2,8740297,1,,,,8449
876a1405c7998cd713c3360283c184640c672404,1,Shameera Rathnayaka,2016-08-09 13:57:29-04:00,['a4716a7b3bdf07645370117edc0b9484d3308dab'],2,7,9,8740306,1,0,1,1,8449
7ce90c54edf34742a6b39871fc6099610365ab4a,0,Shameera Rathnayaka,2016-08-09 13:58:22-04:00,"['f88859bf3de8b3b9924dcd7d3db12931d586b268', '876a1405c7998cd713c3360283c184640c672404']",2,7,9,8740315,1,,,,8449
0e14f97fdd8ad0ad2b96df25856e8ebacab94ad1,0,Shameera Rathnayaka,2016-08-09 13:58:53-04:00,"['7ce90c54edf34742a6b39871fc6099610365ab4a', '388d90a8356186d91ba2de85aab0a0708e1e60ee']",21,143653,143674,8883989,36,,,,8449
c01d7a1472674beb80229f00116b642f85334e6b,1,scnakandala,2016-08-09 17:24:13-04:00,['388d90a8356186d91ba2de85aab0a0708e1e60ee'],2376,3404,5780,8889769,17,1,0.820487805,1,8450
25ffe3434241ef76adc08ee95c4e9ff253f60573,0,scnakandala,2016-08-09 17:24:34-04:00,"['c01d7a1472674beb80229f00116b642f85334e6b', '0e14f97fdd8ad0ad2b96df25856e8ebacab94ad1']",2,7,9,8889778,1,,,,8450
8df73c9eb8bc99f1d63de284ee864de08aef4e8f,0,scnakandala,2016-08-09 17:34:30-04:00,['25ffe3434241ef76adc08ee95c4e9ff253f60573'],2,2,4,8889782,1,,,,8450
4157065ccf512bd5f6a3ba3367ca1f4a9e122887,0,scnakandala,2016-08-09 17:50:40-04:00,['8df73c9eb8bc99f1d63de284ee864de08aef4e8f'],1,11,12,8889794,2,,,,8450
a6670f884c8c4d2aaa5a1dff37fbe3f4ab447285,0,Shameera Rathnayaka,2016-08-09 18:17:33-04:00,['0e14f97fdd8ad0ad2b96df25856e8ebacab94ad1'],0,1046,1046,8890840,8,0.506775068,0.712737127,0.512195122,8458
e247b00d0b4d65a684f5e5551549c329241492d7,0,Shameera Rathnayaka,2016-08-09 18:19:09-04:00,['a6670f884c8c4d2aaa5a1dff37fbe3f4ab447285'],1148,785,1933,8892773,19,0.728538283,0.709976798,0.006960557,8458
20b3d251a2ab6d0c97e4460b5743de8a9655db04,0,Shameera Rathnayaka,2016-08-09 18:19:22-04:00,"['4157065ccf512bd5f6a3ba3367ca1f4a9e122887', 'e247b00d0b4d65a684f5e5551549c329241492d7']",1091,1774,2865,8895638,25,,,,8458
e759b55050da5c6a1f2d601cbd6b8272127894e8,1,Shameera Rathnayaka,2016-08-10 12:38:00-04:00,['876a1405c7998cd713c3360283c184640c672404'],118,143,261,8895899,1,0.695652174,0.217391304,1,8458
2df4bb2e95bffd4286aa5ad795bf5f6aba86bcf6,0,Shameera Rathnayaka,2016-08-10 12:39:05-04:00,"['20b3d251a2ab6d0c97e4460b5743de8a9655db04', 'e759b55050da5c6a1f2d601cbd6b8272127894e8']",118,143,261,8896160,1,,,,8458
5521ea6afabea32a97522ab204ef02167dfad039,1,scnakandala,2016-08-10 12:54:25-04:00,['4157065ccf512bd5f6a3ba3367ca1f4a9e122887'],8,208,216,8896376,11,0.24691358,0.320987654,0.99382716,8458
6f1883bf82eee983cc4135063da55ad7f0f0f178,0,scnakandala,2016-08-10 12:54:31-04:00,"['5521ea6afabea32a97522ab204ef02167dfad039', '2df4bb2e95bffd4286aa5ad795bf5f6aba86bcf6']",1209,1917,3126,8899502,26,,,,8458
3a70c590506edd7a2f19edd73e123d979d3f01c8,1,scnakandala,2016-08-10 14:33:13-04:00,['6f1883bf82eee983cc4135063da55ad7f0f0f178'],1,19,20,8899522,2,0,0,0,8458
e4cc54d923d406542ed5d007aa1fb48a8094d29f,0,Shameera Rathnayaka,2016-08-10 15:18:53-04:00,['2df4bb2e95bffd4286aa5ad795bf5f6aba86bcf6'],454,662,1116,8900638,18,0.263157895,0.308270677,0.037593985,8460
12d9efb90763b7b3cb20c6733804ea0a712186dd,0,Shameera Rathnayaka,2016-08-10 15:19:30-04:00,"['e4cc54d923d406542ed5d007aa1fb48a8094d29f', '3a70c590506edd7a2f19edd73e123d979d3f01c8']",9,227,236,8900874,13,,,,8460
65c2a9672e8d539fcc62b6d0156007d41decc0a0,0,Shameera Rathnayaka,2016-08-10 15:41:39-04:00,['e4cc54d923d406542ed5d007aa1fb48a8094d29f'],85,76,161,8901035,5,0.842105263,0,0,8460
98cbb40733422c365309b83fff16df0df08b6548,0,Shameera Rathnayaka,2016-08-10 15:42:05-04:00,['e4cc54d923d406542ed5d007aa1fb48a8094d29f'],87,79,166,8901201,6,0.842105263,0,0,8460
474ae23d51ca783df8082bb49ae151f07dad3ee3,0,Shameera Rathnayaka,2016-08-10 15:42:58-04:00,"['98cbb40733422c365309b83fff16df0df08b6548', '65c2a9672e8d539fcc62b6d0156007d41decc0a0']",0,0,0,8901201,0,,,,8460
63696ffa1c6ede30ca99b0b8da20e18d70e7c9ca,0,Shameera Rathnayaka,2016-08-10 15:43:32-04:00,"['12d9efb90763b7b3cb20c6733804ea0a712186dd', '474ae23d51ca783df8082bb49ae151f07dad3ee3']",87,79,166,8901367,6,,,,8460
4e3dc9a9e90e6043173a98d6f546b25ff7f2896a,0,Shameera Rathnayaka,2016-08-10 18:38:23-04:00,['63696ffa1c6ede30ca99b0b8da20e18d70e7c9ca'],173,1153,1326,8902693,12,0.544701987,0.612582781,0.925496689,8461
1eb3b4155808dd1bfe2f08002cf49a7018e549af,0,scnakandala,2016-08-11 12:44:39-04:00,['3a70c590506edd7a2f19edd73e123d979d3f01c8'],2923,26,2949,8905642,18,0.680108992,0.452861035,0.042506812,8461
b9b2480c5d68dc77d94aecca305e21604865962a,0,scnakandala,2016-08-11 12:44:54-04:00,"['1eb3b4155808dd1bfe2f08002cf49a7018e549af', '63696ffa1c6ede30ca99b0b8da20e18d70e7c9ca']",541,741,1282,8906924,23,,,,8461
54f5c34d4eed40acd643a0388926c3c3b62be526,0,Shameera Rathnayaka,2016-08-11 14:42:48-04:00,['4e3dc9a9e90e6043173a98d6f546b25ff7f2896a'],3,36,39,8906963,2,0,1,1,8461
01716e5360417926a32cf1e4e1aef441c4b939d7,0,Shameera Rathnayaka,2016-08-11 15:06:52-04:00,"['54f5c34d4eed40acd643a0388926c3c3b62be526', 'b9b2480c5d68dc77d94aecca305e21604865962a']",2928,26,2954,8909917,18,,,,8461
79aa48650ec211b29ba2dcebe429b64a2a6f7eb5,1,Shameera Rathnayaka,2016-08-12 10:52:52-04:00,['01716e5360417926a32cf1e4e1aef441c4b939d7'],1,3,4,8909921,1,0,1,1,8461
fe87f9c908f5df1968627e1b61dd24573ce663e7,0,scnakandala,2016-08-12 11:49:31-04:00,['b9b2480c5d68dc77d94aecca305e21604865962a'],0,3,3,8909924,1,0,0,0,8461
7eacf845270d162bb9e1c8608e646297a1c470f1,0,scnakandala,2016-08-12 11:49:52-04:00,"['fe87f9c908f5df1968627e1b61dd24573ce663e7', '79aa48650ec211b29ba2dcebe429b64a2a6f7eb5']",176,1186,1362,8911286,15,,,,8461
d19f8c5c9369af25e291c78807e7e2c539350ce2,0,scnakandala,2016-08-12 12:01:29-04:00,['7eacf845270d162bb9e1c8608e646297a1c470f1'],14,5,19,8911305,1,1,1,1,8461
a94e0efb517f87113fe086d59e16dcdd9053a9b8,0,Shameera Rathnayaka,2016-08-12 16:32:52-04:00,['e759b55050da5c6a1f2d601cbd6b8272127894e8'],11,11,22,8911327,11,,,,8461
abcdd33bd60856ebe04157f6fc996d85df1f0fd0,0,Shameera Rathnayaka,2016-08-12 16:33:15-04:00,"['79aa48650ec211b29ba2dcebe429b64a2a6f7eb5', 'a94e0efb517f87113fe086d59e16dcdd9053a9b8']",11,11,22,8911349,11,,,,8461
1ecff7642340b49278172412c44ac49750d36e05,0,Shameera Rathnayaka,2016-08-12 16:33:31-04:00,"['abcdd33bd60856ebe04157f6fc996d85df1f0fd0', 'd19f8c5c9369af25e291c78807e7e2c539350ce2']",11,5,16,8911365,1,,,,8461
db9e3b76ee2694cdffeff7f56fa6ef4b3b375119,0,Shameera Rathnayaka,2016-08-12 16:34:04-04:00,['1ecff7642340b49278172412c44ac49750d36e05'],100,134,234,8911599,3,1,1,0,8463
f4aeee53487d72a1229f24218dfe5f785de09c45,0,Shameera Rathnayaka,2016-08-15 12:55:03-04:00,['1ecff7642340b49278172412c44ac49750d36e05'],3,3,6,8911605,2,,,,8463
3fcde5295b75e58ff39f3442ed060d969443594c,0,Shameera Rathnayaka,2016-08-15 13:12:34-04:00,['f4aeee53487d72a1229f24218dfe5f785de09c45'],0,2,2,8911607,1,1,1,1,8463
99d3f4bcdd486f0b6eb8f607c2e517f3e1450753,0,scnakandala,2016-08-15 15:22:17-04:00,"['3fcde5295b75e58ff39f3442ed060d969443594c', 'db9e3b76ee2694cdffeff7f56fa6ef4b3b375119']",100,134,234,8911841,3,,,,8463
9f979b50b972db48b0d80bcdbbe3dd932c9a0bc4,0,Shameera Rathnayaka,2016-08-15 15:45:12-04:00,['3fcde5295b75e58ff39f3442ed060d969443594c'],11,16,27,8911868,6,0.166666667,0.166666667,0.333333333,8463
cfe62c3e829820d744da4f41e9036c87eccd18dd,0,Shameera Rathnayaka,2016-08-15 15:45:20-04:00,"['9f979b50b972db48b0d80bcdbbe3dd932c9a0bc4', '99d3f4bcdd486f0b6eb8f607c2e517f3e1450753']",100,134,234,8912102,3,,,,8463
c6a82a029635a1239ca0563e9019399f90ca714a,1,scnakandala,2016-08-15 16:14:16-04:00,['cfe62c3e829820d744da4f41e9036c87eccd18dd'],134,100,234,8912336,3,0,0,1,8463
3f29cfdbd71de18777557713dce58007a3cbc2f5,0,Shameera Rathnayaka,2016-08-15 16:39:49-04:00,['cfe62c3e829820d744da4f41e9036c87eccd18dd'],6,6,12,8912348,3,1,0.5,0.5,8463
b168933a9443e29af21b4c3d280892ab5c71758c,0,Shameera Rathnayaka,2016-08-15 16:39:56-04:00,"['3f29cfdbd71de18777557713dce58007a3cbc2f5', 'c6a82a029635a1239ca0563e9019399f90ca714a']",134,100,234,8912582,3,,,,8463
18ea6c24f9c42bc3e32c0853ac63d36243cbfe4c,0,Shameera Rathnayaka,2016-08-16 14:21:16-04:00,"['3f29cfdbd71de18777557713dce58007a3cbc2f5', 'c6a82a029635a1239ca0563e9019399f90ca714a']",140,113,253,8912835,5,,,,8463
bc3733487526c1914c28679f6210901f73024a49,0,Shameera Rathnayaka,2016-08-16 14:21:30-04:00,"['18ea6c24f9c42bc3e32c0853ac63d36243cbfe4c', 'b168933a9443e29af21b4c3d280892ab5c71758c']",0,0,0,8912835,0,,,,8463
309a9ff83945b59930d9b37cff52e4fb6e405b5c,0,Shameera Rathnayaka,2016-08-16 15:37:14-04:00,['bc3733487526c1914c28679f6210901f73024a49'],14,48,62,8912897,2,0.838709677,0.903225806,0.903225806,8463
b284167d29172e28cff71575d82731a124ce4c4d,0,Shameera Rathnayaka,2016-08-16 16:25:29-04:00,['309a9ff83945b59930d9b37cff52e4fb6e405b5c'],4,3,7,8912904,1,1,1,1,8463
67102da4443e92d99d5750c1fa204e87fe6e8a30,1,scnakandala,2016-08-16 21:14:08-04:00,['c6a82a029635a1239ca0563e9019399f90ca714a'],2,1,3,8912907,1,1,0,0,8463
93ec75b61ddaa5585700fed81a6e173b2850817d,0,Shameera Rathnayaka,2016-08-16 22:19:12-04:00,['433ae48bb6b38d850f64d3ce6392acd6c4fd8d64'],34,837,871,8913778,9,,,,8467
ab13cf62878e03fefd7d23ca66079571e5d40403,0,Shameera Rathnayaka,2016-08-16 22:22:01-04:00,['93ec75b61ddaa5585700fed81a6e173b2850817d'],0,8,8,8913786,2,,,,8468
779cc376ef7c25a60586214cd7bb06056fdaaf79,0,scnakandala,2016-08-17 11:14:20-04:00,"['67102da4443e92d99d5750c1fa204e87fe6e8a30', 'b284167d29172e28cff71575d82731a124ce4c4d']",30,70,100,8913886,7,,,,8468
c18b06cb47333205f393e911b151560b74312922,0,Shameera Rathnayaka,2016-08-17 17:36:38-04:00,['ab13cf62878e03fefd7d23ca66079571e5d40403'],68,61,129,8914015,9,,,,8469
86a3919970469f2ada367b8d12e0726716723693,0,Shameera Rathnayaka,2016-08-18 00:11:38-04:00,['c18b06cb47333205f393e911b151560b74312922'],80,67,147,8914162,8,,,,8470
6e0715b48039e16b1864c1eb7ad69fd3e4867a20,0,Shameera Rathnayaka,2016-08-18 01:13:26-04:00,['86a3919970469f2ada367b8d12e0726716723693'],5,25,30,8914192,6,,,,8470
d0c6957cfb0fe298e740a5c564d7dcf2aef769ce,1,scnakandala,2016-08-18 11:53:35-04:00,['779cc376ef7c25a60586214cd7bb06056fdaaf79'],15,251,266,8914458,14,0.239520958,0.28742515,0.994011976,8470
0b29a5ccd3b6d709a328565006a76cb6886c26f0,1,Shameera Rathnayaka,2016-08-18 16:05:50-04:00,['b284167d29172e28cff71575d82731a124ce4c4d'],0,3,3,8914461,1,,,,8470
442771830e316a096204b02142a34793d8ee02c0,0,Shameera Rathnayaka,2016-08-18 16:05:58-04:00,"['0b29a5ccd3b6d709a328565006a76cb6886c26f0', 'd0c6957cfb0fe298e740a5c564d7dcf2aef769ce']",17,252,269,8914730,14,,,,8470
7b14e0fa95e22db5ad20a2f93273195339d628ed,0,Jeff Kinnison,2016-08-19 17:25:53-04:00,['24ced80054f084a78d86fff36672c834e144d3e9'],0,750,750,8915480,3,0.796680498,1,0.618257261,8473
ef310d3ca9820a3aefabd59a6c5e6d0b52ecde37,0,Shameera Rathnayaka,2016-08-22 14:45:53-04:00,['442771830e316a096204b02142a34793d8ee02c0'],0,10,10,8915490,1,,,,8473
2b6f220a06f7ca255471648d4a0ce480d789787c,1,Shameera Rathnayaka,2016-08-22 16:12:22-04:00,['6e0715b48039e16b1864c1eb7ad69fd3e4867a20'],251,325,576,8916066,24,,,,8475
ff2e1ae1311852798ad2706a4de85f490e774ec0,0,Shameera Rathnayaka,2016-08-22 18:53:36-04:00,['2b6f220a06f7ca255471648d4a0ce480d789787c'],29,419,448,8916514,5,,,,8477
ff18106ab2559d053392c6b3e8a2c6e3172f9ad4,0,scnakandala,2016-08-22 23:36:46-04:00,"['ef310d3ca9820a3aefabd59a6c5e6d0b52ecde37', '7b14e0fa95e22db5ad20a2f93273195339d628ed']",0,750,750,8917264,3,,,,8477
05ea66e11e8098af51fc95151be596d96b8ccb8c,0,Lahiru Ginnaliya Gamathige,2016-08-23 10:20:07-07:00,['a94e0efb517f87113fe086d59e16dcdd9053a9b8'],2,97,99,8917363,1,,,,8477
43d17aedad1ab722fa5cb2f5a7060358fd7df52a,0,Lahiru Ginnaliya Gamathige,2016-08-23 10:37:31-07:00,['ff18106ab2559d053392c6b3e8a2c6e3172f9ad4'],2,95,97,8917460,1,,,,8477
1dab79b6452280929412599eca3281c0f9fab28c,0,Shameera Rathnayaka,2016-08-24 12:39:04-04:00,['ef310d3ca9820a3aefabd59a6c5e6d0b52ecde37'],8,51,59,8917519,3,1,1,1,8478
35367512ba2156583c4ff527c4aa2dcf432adc61,0,Shameera Rathnayaka,2016-08-24 12:40:04-04:00,"['1dab79b6452280929412599eca3281c0f9fab28c', '43d17aedad1ab722fa5cb2f5a7060358fd7df52a']",2,845,847,8918366,4,,,,8478
415e9b701599b44999ca35306a53052012e44e63,1,scnakandala,2016-08-25 15:28:32-04:00,['35367512ba2156583c4ff527c4aa2dcf432adc61'],636,685,1321,8919687,17,0.239583333,0.239583333,1,8478
bfff64c58c58b62116f64d7c81b6fbc4d23d7d52,0,scnakandala,2016-08-26 02:06:02-04:00,['415e9b701599b44999ca35306a53052012e44e63'],3,5,8,8919695,3,,,,8478
ad06b474c15bf5ab1738e6e259dc04b9720856a2,0,scnakandala,2016-08-26 12:11:21-04:00,['bfff64c58c58b62116f64d7c81b6fbc4d23d7d52'],0,2683,2683,8922378,27,0.931865828,1,0.983228512,8505
c450f400b7d992ddf977d68d93c66a538c54fd01,0,scnakandala,2016-08-26 12:13:09-04:00,['ad06b474c15bf5ab1738e6e259dc04b9720856a2'],0,1,1,8922379,1,,,,8505
a3950c99ac6cef67c864f023fbd4f4a40291c6e8,1,Lahiru Ginnaliya Gamathige,2016-08-27 11:02:07-07:00,['c450f400b7d992ddf977d68d93c66a538c54fd01'],97,4,101,8922480,21,,,,8505
21c3e784989ac71129934f096f8c63e5267a8754,1,scnakandala,2016-08-27 15:42:41-04:00,['c450f400b7d992ddf977d68d93c66a538c54fd01'],89,173,262,8922742,2,0.197674419,0.244186047,0.976744186,8505
cc009e3c6d49b98d1abbbe3dd8aceebc403a9592,0,scnakandala,2016-08-27 15:46:02-04:00,"['21c3e784989ac71129934f096f8c63e5267a8754', 'a3950c99ac6cef67c864f023fbd4f4a40291c6e8']",97,4,101,8922843,21,,,,8505
3ce49b9a6530bbe0f1c2249668473b67b1bb29ae,0,scnakandala,2016-08-29 10:12:34-04:00,['cc009e3c6d49b98d1abbbe3dd8aceebc403a9592'],239,797,1036,8923879,22,0.588235294,0.634453782,0.995798319,8511
171c0425f81dd9b6d113c51cd2daa9ccf7ca8cf0,1,scnakandala,2016-08-29 13:41:11-04:00,['3ce49b9a6530bbe0f1c2249668473b67b1bb29ae'],534,2106,2640,8926519,35,0.829619921,0.753604194,1,8521
eee49d36c2ea2e9ab379c2ebfb2bd51a0ab647e6,0,scnakandala,2016-08-29 15:13:53-04:00,['171c0425f81dd9b6d113c51cd2daa9ccf7ca8cf0'],81,982,1063,8927582,30,0.982300885,0.911504425,1,8529
b46fd511789f4f58a6e2a89f0e608240c844baad,1,scnakandala,2016-08-29 16:06:08-04:00,['eee49d36c2ea2e9ab379c2ebfb2bd51a0ab647e6'],598,864,1462,8929044,35,0.405737705,0.446721311,1,8529
dc6012eb10f1f7de1e56523dcfcee91d97f41a69,0,Shameera,2016-08-29 16:25:14-04:00,[],0,203,203,8929247,2,,,,8531
7429aa65b0eff708debde76aadd65a04c179c157,0,Shameera Rathnayaka,2016-08-30 15:30:27-04:00,['dc6012eb10f1f7de1e56523dcfcee91d97f41a69'],0,241,241,8929488,11,,,,8542
8868abc4f17b6085c7f183f8919a38e20c83bffb,0,Shameera Rathnayaka,2016-08-30 15:31:41-04:00,['7429aa65b0eff708debde76aadd65a04c179c157'],0,1,1,8929489,1,,,,8543
2b3dec80736c0542346c70a6d6ab122d9f6448d5,1,Shameera Rathnayaka,2016-08-31 10:12:01-04:00,['cc009e3c6d49b98d1abbbe3dd8aceebc403a9592'],4,14,18,8929507,1,0,0,1,8543
570832d1c8c76147defe510e09e1a2be83f7103b,0,scnakandala,2016-08-31 15:13:53-04:00,"['2b3dec80736c0542346c70a6d6ab122d9f6448d5', 'b46fd511789f4f58a6e2a89f0e608240c844baad']",1331,4628,5959,8935466,91,,,,8543
6b9b4413d8b246044299dc3200ec6dfb46ea6512,0,scnakandala,2016-08-31 15:46:29-04:00,['570832d1c8c76147defe510e09e1a2be83f7103b'],1,1,2,8935468,1,,,,8543
ea4c2f67ccd08395f2829ee372bb53858a0a14dd,0,Shameera Rathnayaka,2016-08-31 15:58:12-04:00,['2b3dec80736c0542346c70a6d6ab122d9f6448d5'],1,10,11,8935479,2,0.625,0.625,1,8543
729a15fa96a056381ce382aeed9c9e459e5511df,0,Shameera Rathnayaka,2016-08-31 15:58:19-04:00,"['ea4c2f67ccd08395f2829ee372bb53858a0a14dd', '6b9b4413d8b246044299dc3200ec6dfb46ea6512']",1330,4627,5957,8941436,90,,,,8543
5c9cec85947467bdab493134b76baa937b2c6edb,0,Shameera Rathnayaka,2016-09-01 13:34:56-04:00,['ff2e1ae1311852798ad2706a4de85f490e774ec0'],2,3,5,8941441,1,,,,8543
ae5461264baa2e7e0f6bfc6c83e18fa55238c8ad,1,scnakandala,2016-09-07 15:00:13-04:00,['729a15fa96a056381ce382aeed9c9e459e5511df'],460,253,713,8942154,6,0.903225806,0,0,8544
12383ccc6022f76ae465869fcf28bfcc1b27e787,0,scnakandala,2016-09-07 15:15:09-04:00,['ae5461264baa2e7e0f6bfc6c83e18fa55238c8ad'],5415,0,5415,8947569,50,0.058361942,0.063756744,0.007846984,8544
a0c9be8e2221b58ba995d81ef83abcab3414d407,0,scnakandala,2016-09-07 15:50:03-04:00,['12383ccc6022f76ae465869fcf28bfcc1b27e787'],3,3,6,8947575,1,,,,8544
9c02fe056abad5e0e737afd44e4d6c108189b119,0,Shameera Rathnayaka,2016-09-09 16:15:24-04:00,['a0c9be8e2221b58ba995d81ef83abcab3414d407'],28,75,103,8947678,5,1,1,1,8545
03db1dfe3dfaf2aca18547b58cdaa82d3f3acf6c,0,Shameera Rathnayaka,2016-09-10 19:15:35-04:00,['8868abc4f17b6085c7f183f8919a38e20c83bffb'],153,334,487,8948165,23,,,,8556
223ea3a8d18511b6dbe7cbdf5fc3957f7d9b9df2,0,Shameera Rathnayaka,2016-09-10 19:58:37-04:00,['03db1dfe3dfaf2aca18547b58cdaa82d3f3acf6c'],2,2,4,8948169,1,,,,8556
1ae8263079fc45fbff6be88706675ed239c973f3,0,Shameera Rathnayaka,2016-09-11 01:23:50-04:00,['223ea3a8d18511b6dbe7cbdf5fc3957f7d9b9df2'],43,201,244,8948413,13,,,,8561
d5a9c8aadd699dbf0679e933a08382c6c0e51daf,0,Shameera Rathnayaka,2016-09-11 02:30:36-04:00,['1ae8263079fc45fbff6be88706675ed239c973f3'],17,81,98,8948511,3,,,,8561
21545bea2b338dcc8491cb15aee85787fdb38e92,0,Shameera Rathnayaka,2016-09-12 12:29:29-04:00,['d5a9c8aadd699dbf0679e933a08382c6c0e51daf'],0,1,1,8948512,1,,,,8561
9e6f2b1913932baec2d678100446c2557b4e10e3,0,Shameera Rathnayaka,2016-09-12 13:20:28-04:00,['5c9cec85947467bdab493134b76baa937b2c6edb'],10,373,383,8948895,7,,,,8564
fec0b3795604d451b2815bcd2c41fa601fd813c3,0,Shameera Rathnayaka,2016-09-12 13:24:37-04:00,['9e6f2b1913932baec2d678100446c2557b4e10e3'],24,15,39,8948934,3,,,,8564
2289aed1d9c9b12c2ee9d5019f3001a5b281d9fa,1,Shameera Rathnayaka,2016-09-12 15:34:23-04:00,['05ea66e11e8098af51fc95151be596d96b8ccb8c'],4,23,27,8948961,2,0.625,0.625,0.625,8564
5dbf84cc1a710b17b401f182ac2c4b904544d2c5,1,Shameera Rathnayaka,2016-09-12 16:14:19-04:00,['2289aed1d9c9b12c2ee9d5019f3001a5b281d9fa'],0,19,19,8948980,1,0.8125,0.8125,0,8564
96e31a99f8f9b0b9b7be3826bc4e8d417c2e1c42,1,Shameera Rathnayaka,2016-09-12 16:38:46-04:00,['5dbf84cc1a710b17b401f182ac2c4b904544d2c5'],0,1,1,8948981,1,1,1,0,8564
875fc27d49ebfcd342f442dd75ca885b40b0a7ec,0,Shameera Rathnayaka,2016-09-12 16:49:10-04:00,"['9c02fe056abad5e0e737afd44e4d6c108189b119', '96e31a99f8f9b0b9b7be3826bc4e8d417c2e1c42']",4,43,47,8949028,2,,,,8564
475f687529e5547ef9ae3c13850536edea863012,0,Shameera Rathnayaka,2016-09-13 13:36:03-04:00,['fec0b3795604d451b2815bcd2c41fa601fd813c3'],6,14,20,8949048,3,,,,8564
2ab5a7236b771ef045b29ffd9131fca37260cfb5,1,Shameera Rathnayaka,2016-09-14 13:10:43-04:00,['475f687529e5547ef9ae3c13850536edea863012'],31,63,94,8949142,8,,,,8564
06ef33f94328c2c7d59f52bc01756a688ea25744,1,scnakandala,2016-09-15 14:40:42-04:00,['875fc27d49ebfcd342f442dd75ca885b40b0a7ec'],15,581,596,8949738,16,0.871657754,1,1,8572
2d9827c5e68097d758753ad38939e6f6e1451145,0,scnakandala,2016-09-15 14:50:29-04:00,['06ef33f94328c2c7d59f52bc01756a688ea25744'],1,1,2,8949740,1,,,,8572
4d908fbe9bb67d50d05443a1d3c02524bd39253f,0,scnakandala,2016-09-15 14:53:47-04:00,['2d9827c5e68097d758753ad38939e6f6e1451145'],1,1,2,8949742,1,,,,8572
a5156a9207f65c21d069b21fe7147eabc4f2dea1,1,scnakandala,2016-09-16 10:45:06-04:00,['4d908fbe9bb67d50d05443a1d3c02524bd39253f'],570,1113,1683,8951425,17,0.289256198,0.580578512,0.878099174,8576
72f35c19c66b038dab4bc20f6365a80b857692cd,1,Shameera Rathnayaka,2016-09-19 14:35:24-04:00,['2ab5a7236b771ef045b29ffd9131fca37260cfb5'],14,38,52,8951477,7,,,,8576
f3b8e021cbaba7e218a70dbf7b9d1a59e9b11047,0,scnakandala,2016-09-21 17:12:00-04:00,['a5156a9207f65c21d069b21fe7147eabc4f2dea1'],0,2,2,8951479,1,0,1,1,8576
c084683579ee27290db8a9b67051ea11726e2335,0,scnakandala,2016-09-21 22:07:20-04:00,['f3b8e021cbaba7e218a70dbf7b9d1a59e9b11047'],2,6,8,8951487,1,0,1,0,8576
264f616ffecd585d92e650685b504101208e79dc,1,scnakandala,2016-09-22 12:32:49-04:00,['c084683579ee27290db8a9b67051ea11726e2335'],0,2,2,8951489,1,0,1,0,8576
83a0bf8795730d712449653af1f484d9cf152d3f,0,scnakandala,2016-09-22 12:54:39-04:00,['264f616ffecd585d92e650685b504101208e79dc'],0,4,4,8951493,1,0,0,1,8576
43b3757d6c1b759a47603189e0ac0ad97339fd8b,1,scnakandala,2016-09-22 13:20:55-04:00,['83a0bf8795730d712449653af1f484d9cf152d3f'],7,2,9,8951502,3,1,0.333333333,0.333333333,8576
f513f5693582a0cddb062264c1d91e8a7bdc48b9,0,Shameera Rathnayaka,2016-09-23 12:07:42-04:00,['72f35c19c66b038dab4bc20f6365a80b857692cd'],9,16,25,8951527,6,,,,8576
7071ef173edaa0d4cbddcf8e2246a4d5f0c620cf,0,Shameera Rathnayaka,2016-09-23 21:49:08-04:00,"['43b3757d6c1b759a47603189e0ac0ad97339fd8b', '21545bea2b338dcc8491cb15aee85787fdb38e92']",0,646,646,8952173,21,,,,8576
514567c8baeb61846c198a7b111f988bab037284,0,Shameera Rathnayaka,2016-09-23 21:58:00-04:00,"['7071ef173edaa0d4cbddcf8e2246a4d5f0c620cf', 'f513f5693582a0cddb062264c1d91e8a7bdc48b9']",0,3451,3451,8955624,47,,,,8576
b7a79203d79046339377cbe5820a3a6bc380fb6c,0,scnakandala,2016-09-27 14:21:27-04:00,['514567c8baeb61846c198a7b111f988bab037284'],8,8,16,8955640,1,,,,8576
59142dd7d878f2cced3647ba89b24879f578f005,0,scnakandala,2016-09-27 15:08:14-04:00,['b7a79203d79046339377cbe5820a3a6bc380fb6c'],1,1,2,8955642,1,,,,8576
7f983b8868aa0b7f726a9d6c130f48e5649f7464,0,Gourav Shenoy,2016-09-30 14:14:35-04:00,['59142dd7d878f2cced3647ba89b24879f578f005'],12,102,114,8955756,5,,,,8579
8eea17fb9c8c073784795dfc56618ec556a12ad1,1,Lahiru Ginnaliya Gamathige,2016-10-01 09:11:11-07:00,['7f983b8868aa0b7f726a9d6c130f48e5649f7464'],103,861,964,8956720,30,0.699115044,0.85840708,0.908554572,8587
e317d77fadc304daae16507cf6443054324e39b4,0,Lahiru Ginnaliya Gamathige,2016-10-01 21:22:17-07:00,['8eea17fb9c8c073784795dfc56618ec556a12ad1'],2,2,4,8956724,1,,,,8587
81c6ea841e265dc8f7f159e4bbe0d1457db2b213,1,Anuj Bhandar,2016-10-02 20:57:28-04:00,['e317d77fadc304daae16507cf6443054324e39b4'],26320,69649,95969,9052693,31,0.430622163,0.5,0.957062472,8601
67a9f643ddf5d8a8dddfe19b8cf001f64265a0a3,0,Lahiru Ginnaliya Gamathige,2016-10-03 06:58:44-07:00,['e317d77fadc304daae16507cf6443054324e39b4'],0,1,1,9052694,1,0,1,1,8601
c3064689d04a1e7f348d48ae733c04b8c3756480,1,Shameera Rathnayaka,2016-10-03 17:24:28-04:00,['67a9f643ddf5d8a8dddfe19b8cf001f64265a0a3'],10115,477,10592,9063286,51,0.040600346,0.050028863,0.002501443,8608
1917d3b2a92d051de65b5d5de958cb2a16b57dd7,0,Shameera Rathnayaka,2016-10-03 17:35:46-04:00,['c3064689d04a1e7f348d48ae733c04b8c3756480'],560,0,560,9063846,8,,,,8608
33c025188d2181ae9227054ab5911e13adb3f302,1,scnakandala,2016-10-04 02:00:42-04:00,['1917d3b2a92d051de65b5d5de958cb2a16b57dd7'],20831,23275,44106,9107952,24,0.342397336,0.382352941,0.936736959,8608
d5f825cd1b53eaf45d4530bfce3f3d60507ca05b,0,scnakandala,2016-10-04 12:04:56-04:00,['33c025188d2181ae9227054ab5911e13adb3f302'],3,3,6,9107958,1,,,,8608
1f48ce3f67dcec3e66f6b61e5714294798f45cc4,1,Lahiru Ginnaliya Gamathige,2016-10-04 09:13:19-07:00,['d5f825cd1b53eaf45d4530bfce3f3d60507ca05b'],0,31,31,9107989,1,,,,8609
879f0a77cea32b725303d0ddbbe74eea42cac0d4,0,Marcus Christie,2016-10-04 13:10:58-04:00,['1f48ce3f67dcec3e66f6b61e5714294798f45cc4'],2,2,4,9107993,1,,,,8609
8f91bdee95c0b27825fe9f59d72a48dad1168149,1,Ajinkya Dhamnaskar,2016-10-04 14:58:44-04:00,['1f48ce3f67dcec3e66f6b61e5714294798f45cc4'],139,223,362,9108355,20,0,0,0.619047619,8609
04045c4ff218efe34bfda76b77b1751a28c74de5,1,Shameera Rathnayaka,2016-10-04 16:14:19-04:00,['1f48ce3f67dcec3e66f6b61e5714294798f45cc4'],0,8,8,9108363,1,0,1,1,8609
9b66d6792d0e063018db9cb58deb293eaef04c66,0,Shameera Rathnayaka,2016-10-04 16:55:33-04:00,['04045c4ff218efe34bfda76b77b1751a28c74de5'],3,21,24,9108387,2,0.25,0.25,1,8609
c139d656c521af0129950af9458cf320f330e4cb,0,Shameera Rathnayaka,2016-10-05 15:15:00-04:00,['96e31a99f8f9b0b9b7be3826bc4e8d417c2e1c42'],1,1,2,9108389,1,,,,8609
a899b52cc518bf4a49e5bd2f9517d8aa87c8f820,0,Shameera Rathnayaka,2016-10-05 15:16:30-04:00,"['9b66d6792d0e063018db9cb58deb293eaef04c66', 'c139d656c521af0129950af9458cf320f330e4cb']",1,1,2,9108391,1,,,,8609
9f0445f817acd8f35bf7fdcbfbd05b934d300ef6,0,scnakandala,2016-10-05 16:56:24-04:00,"['a899b52cc518bf4a49e5bd2f9517d8aa87c8f820', '879f0a77cea32b725303d0ddbbe74eea42cac0d4']",2,2,4,9108395,1,,,,8609
8469effce22ffe3a54255d3920ee33b9d9035c06,1,Anuj Bhandar,2016-10-07 11:48:58-04:00,['81c6ea841e265dc8f7f159e4bbe0d1457db2b213'],42392,69095,111487,9219882,45,0.275199346,0.346094868,0.869351871,8614
fa5a1e0fc6fe2140f822525e313bc57566024294,1,Anuj Bhandar,2016-10-07 12:36:40-04:00,"['8469effce22ffe3a54255d3920ee33b9d9035c06', '9f0445f817acd8f35bf7fdcbfbd05b934d300ef6']",33779,26225,60004,9279886,164,,,,8614
50cf71e44431e1dce3653df25790443d4a77ec0f,1,Anuj Bhandar,2016-10-07 16:29:10-04:00,['fa5a1e0fc6fe2140f822525e313bc57566024294'],121,104,225,9280111,94,,,,8614
82e57526cdd975381c30f2f4853b2a91101833d7,1,scnakandala,2016-10-09 01:45:41-04:00,['50cf71e44431e1dce3653df25790443d4a77ec0f'],42538,92243,134781,9414892,122,0.35130802,0.45918221,0.824776131,8670
2c81c1ed5364eba8a431a98f9f596acee37c4c1f,0,scnakandala,2016-10-10 01:17:16-04:00,['82e57526cdd975381c30f2f4853b2a91101833d7'],92,138,230,9415122,9,1,0,0,8670
a8b15d86cb637ef120d88c47369e3230767893ac,1,scnakandala,2016-10-10 01:40:40-04:00,['2c81c1ed5364eba8a431a98f9f596acee37c4c1f'],55,57,112,9415234,2,0,1,1,8670
a4ed488c9df36da876b898cbc94a77709856fb78,0,scnakandala,2016-10-10 11:33:09-04:00,['a8b15d86cb637ef120d88c47369e3230767893ac'],1,49,50,9415284,2,0,1,1,8670
eb0cd635ea9e065d622abb30ff30b54a9f60910b,0,Anuj Bhandar,2016-10-10 12:58:25-04:00,['a4ed488c9df36da876b898cbc94a77709856fb78'],1064,5249,6313,9421597,5,0.503494176,0.679201331,0.988352745,8671
cab0b77979c0691d4fa55e6b87f9f8623ba3c41c,0,scnakandala,2016-10-10 14:53:47-04:00,['a4ed488c9df36da876b898cbc94a77709856fb78'],11,0,11,9421608,1,1,1,0,8671
3170fefdf371e6db6cd4099570ff294909eec10e,0,Anuj Bhandar,2016-10-10 15:35:32-04:00,['eb0cd635ea9e065d622abb30ff30b54a9f60910b'],32,127,159,9421767,3,1,1,0.484848485,8672
2c463cae92a53a5eec509e26363320309c717f37,0,scnakandala,2016-10-10 15:57:36-04:00,['cab0b77979c0691d4fa55e6b87f9f8623ba3c41c'],1,10,11,9421778,1,0,1,0,8672
a4ba60c92248f441a8f7737a856bf3150e54f077,0,scnakandala,2016-10-10 16:21:27-04:00,['2c463cae92a53a5eec509e26363320309c717f37'],1,1,2,9421780,1,,,,8672
efed2956fb93443575da73db0128ba1b3a18416d,0,Anuj Bhandar,2016-10-10 16:34:58-04:00,['3170fefdf371e6db6cd4099570ff294909eec10e'],3232,1110,4342,9426122,3,0.370923913,0.177309783,0.019021739,8672
218870c9da84ff5ce6cc8a7bfa6dfaa34a025553,0,Anuj Bhandar,2016-10-10 18:27:52-04:00,['efed2956fb93443575da73db0128ba1b3a18416d'],46,1083,1129,9427251,2,0.586842105,0.793421053,0.990789474,8672
fcc44af33b34afa230a190e92a9b3f80123dadd9,0,Anuj Bhandar,2016-10-10 18:30:04-04:00,['218870c9da84ff5ce6cc8a7bfa6dfaa34a025553'],5,23,28,9427279,3,0.5,0.916666667,0.75,8672
b6548366daab592e260acbd3fb77001986866678,0,Anuj Bhandar,2016-10-10 18:33:41-04:00,['fcc44af33b34afa230a190e92a9b3f80123dadd9'],5679,7968,13647,9440926,11,0.38817794,0.462522852,0.984156002,8674
81d8dee38a2272b76791fb15c3206f34afa9517e,1,scnakandala,2016-10-11 12:00:49-04:00,['a4ba60c92248f441a8f7737a856bf3150e54f077'],4,4,8,9440934,1,,,,8674
5aa40b8a611f3f6778bdb1a72d6757f9d243465b,1,Anuj Bhandar,2016-10-12 11:30:42-04:00,['81d8dee38a2272b76791fb15c3206f34afa9517e'],1064,5249,6313,9447247,5,0.503494176,0.679201331,0.988352745,8675
157efab54df3578189c53ddec6e63d5eacff768c,0,Anuj Bhandar,2016-10-12 11:30:42-04:00,['5aa40b8a611f3f6778bdb1a72d6757f9d243465b'],32,127,159,9447406,3,1,1,0.484848485,8676
077fd2c81d7b443f040e1ff0fb8af24b9c9b5f8a,1,Anuj Bhandar,2016-10-12 11:30:42-04:00,['157efab54df3578189c53ddec6e63d5eacff768c'],3232,1110,4342,9451748,3,0.370923913,0.177309783,0.019021739,8676
c4fb53222205543b85f2b9926ef6c0c98ecfb02e,1,Anuj Bhandar,2016-10-12 11:30:42-04:00,['077fd2c81d7b443f040e1ff0fb8af24b9c9b5f8a'],46,1083,1129,9452877,2,0.586842105,0.793421053,0.990789474,8676
6632b1a8f70b15d6278c27fb0124d5c267af1fb4,1,Anuj Bhandar,2016-10-12 11:30:42-04:00,['c4fb53222205543b85f2b9926ef6c0c98ecfb02e'],5,23,28,9452905,3,0.5,0.916666667,0.75,8676
c31cfa60cd5263f80bb78ef865a44f4adb53a9f0,1,Anuj Bhandar,2016-10-12 11:30:42-04:00,['6632b1a8f70b15d6278c27fb0124d5c267af1fb4'],5679,7968,13647,9466552,11,0.38817794,0.462522852,0.984156002,8678
cc7496024032fc8d0f8e8b4bba3b932cb11d674f,0,Anuj Bhandar,2016-10-12 11:32:57-04:00,['c31cfa60cd5263f80bb78ef865a44f4adb53a9f0'],1,2,3,9466555,1,0,1,1,8678
d8c17d98fd280516aa55dfa11930789ec81589a9,0,Anuj Bhandar,2016-10-12 11:36:09-04:00,"['cc7496024032fc8d0f8e8b4bba3b932cb11d674f', 'b6548366daab592e260acbd3fb77001986866678']",0,0,0,9466555,0,,,,8678
7c6c562533efbb5a42ab136b9a7a61a5d8d9b9e5,0,scnakandala,2016-10-12 11:46:50-04:00,['81d8dee38a2272b76791fb15c3206f34afa9517e'],57,55,112,9466667,2,1,1,1,8678
ac769369bb3b5c42d28ee0bc96b3fbfe251f8474,1,Anuj Bhandar,2016-10-12 12:53:56-04:00,['d8c17d98fd280516aa55dfa11930789ec81589a9'],142,1231,1373,9468040,9,0.516998828,0.728018757,0.983587339,8678
8e59d800f4bf6984d1c84d9f940161a0ba218638,1,Anuj Bhandar,2016-10-12 13:08:58-04:00,['ac769369bb3b5c42d28ee0bc96b3fbfe251f8474'],3491,5033,8524,9476564,3,0.417832168,0.476398601,0.933566434,8678
1b91dd1ce35f2ed37ad93b9762fe227aa72ae913,1,Ajinkya Dhamnaskar,2016-10-12 13:47:00-04:00,['8f91bdee95c0b27825fe9f59d72a48dad1168149'],4,9,13,9476577,2,1,1,0,8679
6250ff1dcd72f54bca5333d3c71729b12578f740,0,Shameera Rathnayaka,2016-10-12 15:37:33-04:00,"['7c6c562533efbb5a42ab136b9a7a61a5d8d9b9e5', '1b91dd1ce35f2ed37ad93b9762fe227aa72ae913']",139,228,367,9476944,21,,,,8679
c9e26ec359c79d3d321e67060aac994941523e2f,1,Anuj Bhandar,2016-10-12 16:36:46-04:00,['8e59d800f4bf6984d1c84d9f940161a0ba218638'],1,25,26,9476970,3,,,,8679
bff76559ecdb0a49250404aab4c57a5e41630d1c,0,scnakandala,2016-10-12 16:42:45-04:00,['6250ff1dcd72f54bca5333d3c71729b12578f740'],863,1626,2489,9479459,23,0.393478261,0.423913043,0.969565217,8681
7cb338d6aaf983e91a4213cde0ee6aa05715e872,0,scnakandala,2016-10-13 13:51:03-04:00,['bff76559ecdb0a49250404aab4c57a5e41630d1c'],48,410,458,9479917,16,0.178807947,0.228476821,1,8681
a8e033358a6a315aa959fc51715b7d1bbfb2db01,0,Shameera Rathnayaka,2016-10-13 14:25:14-04:00,"['7cb338d6aaf983e91a4213cde0ee6aa05715e872', 'c9e26ec359c79d3d321e67060aac994941523e2f']",4273,12431,16704,9496621,21,,,,8681
e36c145d0fa794d0a56be117f321c30fbce1189a,0,scnakandala,2016-10-13 16:30:40-04:00,['a8e033358a6a315aa959fc51715b7d1bbfb2db01'],15,325,340,9496961,42,,,,8685
9101a5192a2199314b219dd67e34769902dfce44,1,scnakandala,2016-10-13 16:58:03-04:00,['e36c145d0fa794d0a56be117f321c30fbce1189a'],43,190,233,9497194,20,0.482352941,0.482352941,1,8685
1764699364e5a07f3d9fe129a6af4e7505c68e10,0,scnakandala,2016-10-13 17:35:49-04:00,['9101a5192a2199314b219dd67e34769902dfce44'],12,12,24,9497218,2,,,,8685
fe76d11e33006bd7429981734ba56f2fdaca8957,0,scnakandala,2016-10-13 17:56:05-04:00,['1764699364e5a07f3d9fe129a6af4e7505c68e10'],1,1,2,9497220,1,,,,8685
6efb535b0a4df26f3fc2453e3180a429075fc5a4,0,scnakandala,2016-10-13 18:01:37-04:00,['fe76d11e33006bd7429981734ba56f2fdaca8957'],1,0,1,9497221,1,,,,8685
eb62af94250c690c933b2f8d15fe620de23aa36f,0,scnakandala,2016-10-13 19:03:38-04:00,['6efb535b0a4df26f3fc2453e3180a429075fc5a4'],12,103,115,9497336,4,0.608695652,1,1,8686
4bb7c6deec45966f00a4e9676b10d945bcdd8075,0,scnakandala,2016-10-14 11:40:52-04:00,['eb62af94250c690c933b2f8d15fe620de23aa36f'],130,594,724,9498060,8,0.126373626,0,0.934065934,8686
d521922ffe45ee224da8390b08700d1aee3a47e2,0,scnakandala,2016-10-14 13:38:37-04:00,['4bb7c6deec45966f00a4e9676b10d945bcdd8075'],12,685,697,9498757,16,,,,8690
dd319ce94ffb7db6729c724b0dbe3523bea0b338,1,Anuj Bhandar,2016-10-14 15:38:42-04:00,['eb62af94250c690c933b2f8d15fe620de23aa36f'],22,34,56,9498813,4,0,0,1,8690
ff48f8c898b7160da6e646e55681bf6a92637549,1,Anuj Bhandar,2016-10-14 16:04:26-04:00,['dd319ce94ffb7db6729c724b0dbe3523bea0b338'],1,5,6,9498819,2,0,0,1,8690
e159a03165f38287551f708f44a832db7f9af630,0,Anuj Bhandar,2016-10-14 16:04:54-04:00,"['ff48f8c898b7160da6e646e55681bf6a92637549', 'd521922ffe45ee224da8390b08700d1aee3a47e2']",142,1279,1421,9500240,21,,,,8690
87564d2be2c0a118213443e2938df511cef356f9,1,scnakandala,2016-10-14 17:26:41-04:00,['d521922ffe45ee224da8390b08700d1aee3a47e2'],4824,7065,11889,9512129,32,0.461335677,0.625659051,0.964850615,8690
6718761f77e943aa65ee6545af2106a44d45d51c,0,scnakandala,2016-10-14 18:20:47-04:00,['87564d2be2c0a118213443e2938df511cef356f9'],29,29,58,9512187,13,,,,8690
61a0fc95416a658fae5164165e67bd896dc228fb,1,scnakandala,2016-10-14 20:03:16-04:00,['6718761f77e943aa65ee6545af2106a44d45d51c'],154,515,669,9512856,10,0,1,1,8693
b6e07d7ba9e0e8d0612f5233e7dbe212d762d608,1,scnakandala,2016-10-16 18:23:19-04:00,['61a0fc95416a658fae5164165e67bd896dc228fb'],900,3591,4491,9517347,44,0.17935046,0.153659719,0.845370819,8698
e04785a4ce733627bf2c702b18099773cd050f08,0,scnakandala,2016-10-17 12:40:40-04:00,['b6e07d7ba9e0e8d0612f5233e7dbe212d762d608'],11,61,72,9517419,12,1,1,1,8699
8bc2dcc4eb3a45c09fa32903c38bd97e349b4599,1,Shameera Rathnayaka,2016-10-17 17:15:41-04:00,['e04785a4ce733627bf2c702b18099773cd050f08'],31,69,100,9517519,8,1,1,1,8699
b85d3dbc5383085afc5b4ada9144c80dd620fbe2,0,Shameera Rathnayaka,2016-10-17 17:19:51-04:00,['8bc2dcc4eb3a45c09fa32903c38bd97e349b4599'],8,10,18,9517537,2,,,,8699
273d074ace42f554ca727dd044ee342c917cac29,1,scnakandala,2016-10-17 18:41:41-04:00,['b85d3dbc5383085afc5b4ada9144c80dd620fbe2'],443,1029,1472,9519009,26,0.151515152,0.675324675,0.991341991,8699
07097ce3919c82a8ef1b466c0581f58f73692094,0,scnakandala,2016-10-18 12:08:49-04:00,['273d074ace42f554ca727dd044ee342c917cac29'],21,86,107,9519116,3,0,1,1,8699
6be0702deae02cfa62d5349b911616a70786ceed,1,scnakandala,2016-10-18 12:44:46-04:00,['07097ce3919c82a8ef1b466c0581f58f73692094'],3,10,13,9519129,2,0,0,0,8699
a6860dc491d23f59bdd489026853147f55596ed2,1,scnakandala,2016-10-18 14:59:28-04:00,['6be0702deae02cfa62d5349b911616a70786ceed'],26,45,71,9519200,5,0.6,0.6,0,8699
2ac72d9e95c0e8d6081b21252044e62c865736e2,0,scnakandala,2016-10-18 15:16:21-04:00,['a6860dc491d23f59bdd489026853147f55596ed2'],382,608,990,9520190,1,0.186666667,0.804444444,0.555555556,8699
a6e7e4ebefe2795ae173a3503e2ebb6fd791338e,0,scnakandala,2016-10-18 15:24:49-04:00,['2ac72d9e95c0e8d6081b21252044e62c865736e2'],0,1,1,9520191,1,0,1,1,8699
43231ee2292cc4de2e612fcccc3926b06c70037f,0,scnakandala,2016-10-18 15:37:43-04:00,['a6e7e4ebefe2795ae173a3503e2ebb6fd791338e'],5,5,10,9520201,2,,,,8699
b96926b645cd3485b99c3b7c799616ae3e8510b3,0,scnakandala,2016-10-18 15:38:17-04:00,['43231ee2292cc4de2e612fcccc3926b06c70037f'],2,2,4,9520205,1,,,,8699
1fcf8c2e8f23c442ec6c178fb3db742966403b13,0,scnakandala,2016-10-18 16:08:24-04:00,['b96926b645cd3485b99c3b7c799616ae3e8510b3'],6,9,15,9520220,2,,,,8700
afb9c6cacf3584da8ee49efae2300e9dffcbda72,0,scnakandala,2016-10-18 16:20:02-04:00,['1fcf8c2e8f23c442ec6c178fb3db742966403b13'],33,23,56,9520276,5,0,0,0.5,8700
2dda44ba3a8eaac388f5bebb9b972e45f169c11e,0,scnakandala,2016-10-19 11:07:46-04:00,['afb9c6cacf3584da8ee49efae2300e9dffcbda72'],9,9,18,9520294,1,,,,8700
2f6340623c0b7a457063268bbe820906c4f90b49,0,scnakandala,2016-10-19 14:39:03-04:00,['2dda44ba3a8eaac388f5bebb9b972e45f169c11e'],1,6,7,9520301,2,,,,8700
adf1e62a408eeae66b99195de676199630d6a885,0,scnakandala,2016-10-19 17:09:28-04:00,['2f6340623c0b7a457063268bbe820906c4f90b49'],15,37,52,9520353,3,0,0,0,8700
61d7b6863dd6e84254dfbbd47241dc7dd60034cc,0,scnakandala,2016-10-19 17:11:12-04:00,['adf1e62a408eeae66b99195de676199630d6a885'],2,2,4,9520357,1,,,,8700
08e306e01085e7c3b6003e1f771922683cd4c0f1,0,scnakandala,2016-10-19 17:48:32-04:00,['61d7b6863dd6e84254dfbbd47241dc7dd60034cc'],0,1,1,9520358,1,,,,8700
c2bf43b61db2ee15f50ffaeab5746a6186cc05dd,0,Suresh Marru,2016-10-20 09:01:30-04:00,"['e159a03165f38287551f708f44a832db7f9af630', '08e306e01085e7c3b6003e1f771922683cd4c0f1']",5011,11319,16330,9536688,72,,,,8700
fdb519155a4710a74e002cc0471433b14eb949ac,0,Marcus Christie,2016-10-20 09:58:36-04:00,['c2bf43b61db2ee15f50ffaeab5746a6186cc05dd'],0,2,2,9536690,1,,,,8700
76c9eaf908d3bafc32a588cf82b81e2c207ebd54,0,scnakandala,2016-10-21 12:22:54-04:00,['fdb519155a4710a74e002cc0471433b14eb949ac'],9,8,17,9536707,4,,1,1,8700
ccc708b1bf99594500ec14c83707d13fa9245f9b,1,Marcus Christie,2016-10-21 16:33:19-04:00,['76c9eaf908d3bafc32a588cf82b81e2c207ebd54'],7,132,139,9536846,5,0.252631579,0.252631579,1,8700
7dd85164103ea492351e25695b4c9b48a9840703,0,GitHub,2016-10-23 13:01:27-04:00,"['59142dd7d878f2cced3647ba89b24879f578f005', '76c9eaf908d3bafc32a588cf82b81e2c207ebd54']",78572,209059,287631,9824477,318,,,,8700
48ea4a0f7be09235011960612c64756ef55e52b7,0,Anuj Bhandar,2016-10-24 20:20:05-04:00,['76c9eaf908d3bafc32a588cf82b81e2c207ebd54'],19,298,317,9824794,6,0.11827957,0.591397849,0.940860215,8701
8422d23752dbf490c7c0a2f54fa13d6c2d617381,1,Anuj Bhandar,2016-10-25 00:46:48-04:00,['76c9eaf908d3bafc32a588cf82b81e2c207ebd54'],4,23,27,9824821,3,0,0,1,8701
1d710c9d85b2fd846ea8eaf81abc8dff62f69f6e,0,Suresh Marru,2016-10-26 09:52:35-04:00,"['8422d23752dbf490c7c0a2f54fa13d6c2d617381', 'ccc708b1bf99594500ec14c83707d13fa9245f9b']",7,132,139,9824960,5,,,,8701
9890991475a6e5a129503d41e7e0be3a9715be3e,0,Suresh Marru,2016-10-26 10:22:04-04:00,"['48ea4a0f7be09235011960612c64756ef55e52b7', '1d710c9d85b2fd846ea8eaf81abc8dff62f69f6e']",11,155,166,9825126,6,,,,8701
08c2766d448f085f43464ec49a81ddfa3bee8295,0,Suresh Marru,2016-10-26 10:27:55-04:00,['c139d656c521af0129950af9458cf320f330e4cb'],0,0,0,9825126,0,,,,8701
00734058dec4309689802503a101adfe7a9bf2dc,0,Suresh Marru,2016-10-26 10:29:54-04:00,['08c2766d448f085f43464ec49a81ddfa3bee8295'],0,0,0,9825126,0,,,,8701
e45e07eee4f2f74dd922749a7b1a5cf71bbf1574,0,Suresh Marru,2016-10-26 10:38:11-04:00,['00734058dec4309689802503a101adfe7a9bf2dc'],0,0,0,9825126,0,,,,8701
3aecdd20d7e718b84edfcc1079e00e84a46a4cfa,0,Suresh Marru,2016-10-26 10:39:42-04:00,['e45e07eee4f2f74dd922749a7b1a5cf71bbf1574'],0,0,0,9825126,0,,,,8701
87a5521016566d68f1a858e37098b4bb4dba357c,0,Suresh Marru,2016-10-26 10:41:09-04:00,['3aecdd20d7e718b84edfcc1079e00e84a46a4cfa'],0,0,0,9825126,0,,,,8701
908569b3feb91f18660a29a4bb02f88acfde1981,0,Suresh Marru,2016-10-26 10:44:26-04:00,['87a5521016566d68f1a858e37098b4bb4dba357c'],0,0,0,9825126,0,,,,8701
ab247b65c71e4d9f17100df52f273dd45a87386c,0,Suresh Marru,2016-10-26 11:28:24-04:00,['9890991475a6e5a129503d41e7e0be3a9715be3e'],0,338,338,9825464,2,0.603603604,0.603603604,0.945945946,8703
bfc193a89e1fca8c29591821f212dd36dd7f0f4c,0,Suresh Marru,2016-10-26 11:29:56-04:00,['ab247b65c71e4d9f17100df52f273dd45a87386c'],0,0,0,9825464,0,,,,8703
2baa6d6c17fa0392137848c1a11e032ea77dc371,0,Suresh Marru,2016-10-26 11:30:12-04:00,['bfc193a89e1fca8c29591821f212dd36dd7f0f4c'],0,0,0,9825464,0,,,,8703
6368b161f34fb2d8ad7daf3014c13b5e4618b2b5,0,Suresh Marru,2016-10-26 11:31:39-04:00,['908569b3feb91f18660a29a4bb02f88acfde1981'],0,0,0,9825464,0,,,,8703
fc0aeace41599fd530710bdfc0a576e225bc2221,0,Suresh Marru,2016-10-26 11:55:42-04:00,['2baa6d6c17fa0392137848c1a11e032ea77dc371'],0,0,0,9825464,0,,,,8703
20902ba13521c901f942b07d66e8473c5846cb94,0,Suresh Marru,2016-10-26 11:57:45-04:00,['fc0aeace41599fd530710bdfc0a576e225bc2221'],0,0,0,9825464,0,,,,8703
0300c5233fa7a84d8157f84801ad25aab8f4ffb5,1,Anuj Bhandar,2016-10-26 12:38:09-04:00,['20902ba13521c901f942b07d66e8473c5846cb94'],4073,5664,9737,9835201,3,0.412914189,0.510620221,0.937128292,8703
b4fd4ff8cf85681ca8bfb4dc37f512cd10eb018d,0,Shameera Rathnayaka,2016-10-26 16:33:40-04:00,['0300c5233fa7a84d8157f84801ad25aab8f4ffb5'],49,141,190,9835391,9,1,1,0.53125,8705
c50470c137e1883a3c222514bf1be3c84fffca85,0,Shameera Rathnayaka,2016-10-27 11:33:34-04:00,['b4fd4ff8cf85681ca8bfb4dc37f512cd10eb018d'],178,178,356,9835747,11,0,0,0,8705
0f781b2e0e1db19d2c0c84031c3f4b746fd27033,0,Shameera Rathnayaka,2016-10-27 17:30:41-04:00,['c50470c137e1883a3c222514bf1be3c84fffca85'],0,96749,96749,9932496,1277,0.582832577,0.722623538,0.9879339,9982
cdbe5c592a2372a9b8eafbf202fb22f6ee1e7871,0,Shameera Rathnayaka,2016-10-27 17:30:41-04:00,['0f781b2e0e1db19d2c0c84031c3f4b746fd27033'],0,49,49,9932545,1,,,,9983
c2e43fac147642f78cf43016003c1347cb1f0dda,0,Shameera Rathnayaka,2016-10-27 17:30:41-04:00,['cdbe5c592a2372a9b8eafbf202fb22f6ee1e7871'],1238,0,1238,9933783,1161,,,,9983
c9303486b343007160ecf8902ebd1375c3557196,0,Shameera Rathnayaka,2016-10-28 11:00:13-04:00,['c2e43fac147642f78cf43016003c1347cb1f0dda'],47,2584,2631,9936414,142,,,,9984
4012db244f9fd57f2f6f15d60ffb27e02bcb6faa,0,Shameera Rathnayaka,2016-10-28 11:08:54-04:00,['c9303486b343007160ecf8902ebd1375c3557196'],0,0,0,9936414,0,,,,9984
325d1630cd7b51f7434b0891bece5855d3f8a670,1,Shameera Rathnayaka,2016-10-28 12:35:19-04:00,['4012db244f9fd57f2f6f15d60ffb27e02bcb6faa'],3138,10719,13857,9950271,30,0.259459459,0.319099099,0.906486486,9997
b66fa88fff988159e72617d34a97e1bd0e665600,0,GitHub,2016-10-28 12:46:17-04:00,"['7dd85164103ea492351e25695b4c9b48a9840703', '325d1630cd7b51f7434b0891bece5855d3f8a670']",7464,115586,123050,10073321,204,,,,9997
b7bebec439cbdd1e63f3b0437a4f2b9ee3995c44,0,Gourav Shenoy,2016-10-31 16:32:34-04:00,['b66fa88fff988159e72617d34a97e1bd0e665600'],6,50,56,10073377,1,0.178571429,1,1,9997
21b1923da2184d6df71a855caf9aea80ce33b300,1,Shameera Rathnayaka,2016-10-31 19:36:17-04:00,['325d1630cd7b51f7434b0891bece5855d3f8a670'],15,543,558,10073935,12,0.29218107,0.62962963,0.641975309,10000
58db74346b1dd9d3e921b8e8ce98ef4c067854d6,0,Shameera Rathnayaka,2016-10-31 19:40:25-04:00,"['21b1923da2184d6df71a855caf9aea80ce33b300', 'b7bebec439cbdd1e63f3b0437a4f2b9ee3995c44']",6,50,56,10073991,1,,,,10000
6d51651ca45920277ab327e676a080103d3fd9fd,1,Shameera Rathnayaka,2016-10-31 20:10:15-04:00,['58db74346b1dd9d3e921b8e8ce98ef4c067854d6'],10,33,43,10074034,3,0,0.25,0.9,10000
ba9d60d3e532987d4a25cdfb84e441271f7281d7,0,Shameera Rathnayaka,2016-11-01 12:23:34-04:00,['6d51651ca45920277ab327e676a080103d3fd9fd'],2,1,3,10074037,1,,,,10000
5904cb13b93810e5b657a3a431a34639bd16f272,1,scnakandala,2016-11-01 15:13:18-04:00,['ba9d60d3e532987d4a25cdfb84e441271f7281d7'],46,1581,1627,10075664,21,0.183413078,0.310207337,0.993620415,10000
f396cb8bf3642e3ec792a1a74a69b3bf385dc088,0,scnakandala,2016-11-01 15:58:22-04:00,['5904cb13b93810e5b657a3a431a34639bd16f272'],1,1,2,10075666,1,,,,10000
512d35ecf0c125549dfbec2651e5da07e5816d0d,1,Shameera Rathnayaka,2016-11-01 17:40:05-04:00,['ba9d60d3e532987d4a25cdfb84e441271f7281d7'],0,1,1,10075667,1,,,,10000
e3da0914426c11a3e4d0cf7621a83147e32d1add,0,Shameera Rathnayaka,2016-11-01 17:40:35-04:00,"['512d35ecf0c125549dfbec2651e5da07e5816d0d', 'f396cb8bf3642e3ec792a1a74a69b3bf385dc088']",47,1582,1629,10077296,22,,,,10000
9d2497c3a46c14d998acd4e28bb273b1f29c2338,1,Shameera Rathnayaka,2016-11-01 17:54:46-04:00,['e3da0914426c11a3e4d0cf7621a83147e32d1add'],0,19,19,10077315,1,0.611111111,0.611111111,1,10000
30aa6f6271d942f99786638040c57666919bd190,1,Shameera Rathnayaka,2016-11-01 18:09:27-04:00,['9d2497c3a46c14d998acd4e28bb273b1f29c2338'],3,4,7,10077322,2,1,1,1,10000
11ff4d8e9ea83d654ebfa917703bf69f1b6d4651,0,Shameera Rathnayaka,2016-11-01 20:12:25-04:00,['30aa6f6271d942f99786638040c57666919bd190'],1,5,6,10077328,1,1,1,0,10000
b3d4c7a1ac2330dc1653194129d0f1e5e35d554b,0,Shameera Rathnayaka,2016-11-01 20:23:14-04:00,['11ff4d8e9ea83d654ebfa917703bf69f1b6d4651'],32,10,42,10077370,3,1,1,1,10000
c72417e3d89daee51538bf78c041cb58bc889491,0,Shameera Rathnayaka,2016-11-01 20:47:08-04:00,['b3d4c7a1ac2330dc1653194129d0f1e5e35d554b'],26,34,60,10077430,1,0,0,1,10000
6d32613860201b83f0555c37b1acc2d14f0e9819,1,Shameera Rathnayaka,2016-11-01 21:31:07-04:00,['c72417e3d89daee51538bf78c041cb58bc889491'],99,114,213,10077643,4,,,,10000
873d684f6c7eb4bc49c68e06134db08de8e2512b,0,Shameera Rathnayaka,2016-11-01 21:50:48-04:00,['6d32613860201b83f0555c37b1acc2d14f0e9819'],3,3,6,10077649,2,,,,10000
dc3d530065556b706aea451c0d9747c0eed07a24,0,Shameera Rathnayaka,2016-11-01 22:08:21-04:00,['873d684f6c7eb4bc49c68e06134db08de8e2512b'],1,1,2,10077651,1,,,,10000
64f823b3a892efbad85099ca619c63325b1e5ff5,1,Shameera Rathnayaka,2016-11-01 22:15:12-04:00,['dc3d530065556b706aea451c0d9747c0eed07a24'],0,1,1,10077652,1,0,1,1,10000
e66337028857c627576cc7260eae49e769e8c047,0,Shameera Rathnayaka,2016-11-01 22:30:52-04:00,['64f823b3a892efbad85099ca619c63325b1e5ff5'],2,7,9,10077661,1,0,1,1,10000
c64d0f020635decc170b61d3cf7fb20cfbbb7d44,0,Shameera Rathnayaka,2016-11-01 22:48:12-04:00,['e66337028857c627576cc7260eae49e769e8c047'],1,3,4,10077665,1,0,0,1,10000
30f187ad5dcc5e021e9f0471a394f52afa3ae36f,0,Shameera Rathnayaka,2016-11-01 23:03:02-04:00,['c64d0f020635decc170b61d3cf7fb20cfbbb7d44'],6,10,16,10077681,1,0,0,0,10000
4a92da4956fb097904996f59c37fabdb40a6c375,1,Shameera Rathnayaka,2016-11-01 23:20:49-04:00,['30f187ad5dcc5e021e9f0471a394f52afa3ae36f'],19,4,23,10077704,2,1,1,1,10000
bf5d8c79645adf161d9121bb84ffcb4acd86f382,0,Shameera Rathnayaka,2016-11-01 23:30:00-04:00,['4a92da4956fb097904996f59c37fabdb40a6c375'],5,3,8,10077712,2,1,0.5,0.5,10000
db027a53eeebc16235f4db40f8d0f28d01a5177f,0,scnakandala,2016-11-02 12:18:01-04:00,['4a92da4956fb097904996f59c37fabdb40a6c375'],9,12,21,10077733,1,,,,10000
c6e96ca2d3d4e0c329fd83f745589eff5c7ceac9,0,GitHub,2016-11-02 14:57:19-04:00,"['b7bebec439cbdd1e63f3b0437a4f2b9ee3995c44', 'bf5d8c79645adf161d9121bb84ffcb4acd86f382']",206,2312,2518,10080251,42,,,,10000
dbcfd77be3abd26f97a185f65649cd3ea1ac46c0,1,Shameera Rathnayaka,2016-11-02 17:24:27-04:00,['4a92da4956fb097904996f59c37fabdb40a6c375'],178,178,356,10080607,11,1,1,1,10000
a45294e461cca0ea5b79fccdd75e969a201052e7,0,Shameera Rathnayaka,2016-11-02 17:29:28-04:00,['dbcfd77be3abd26f97a185f65649cd3ea1ac46c0'],141,49,190,10080797,9,0,0,0.46875,10000
fe6ebe9c0ad075ac13e2a932b494dba13a1de0a1,0,Shameera Rathnayaka,2016-11-02 17:29:55-04:00,"['a45294e461cca0ea5b79fccdd75e969a201052e7', 'db027a53eeebc16235f4db40f8d0f28d01a5177f']",9,12,21,10080818,1,,,,10000
01f804433e0745aca8c5e9f8fd48fb3efd33b25e,1,Gourav Shenoy,2016-11-02 17:50:48-04:00,['c6e96ca2d3d4e0c329fd83f745589eff5c7ceac9'],98,203,301,10081119,12,1,1,1,10000
6d5c632d2e64af17688faa596743a7d5b1acbb04,0,Shameera Rathnayaka,2016-11-02 18:10:22-04:00,"['fe6ebe9c0ad075ac13e2a932b494dba13a1de0a1', '01f804433e0745aca8c5e9f8fd48fb3efd33b25e']",103,206,309,10081428,13,,,,10000
ea5fc9bae5117a23f86afa0d9a27667d594fd647,0,Shameera Rathnayaka,2016-11-02 18:31:32-04:00,['6d5c632d2e64af17688faa596743a7d5b1acbb04'],5,5,10,10081438,1,1,0,0,10000
4cafd7a5cf51b069537e7bbe745de56c396d7406,0,Shameera Rathnayaka,2016-11-02 19:07:14-04:00,['ea5fc9bae5117a23f86afa0d9a27667d594fd647'],3,4,7,10081445,1,1,0,0,10000
926a01a11f44acfbbab33d4a460771d0b85b057f,0,scnakandala,2016-11-03 11:49:11-04:00,['db027a53eeebc16235f4db40f8d0f28d01a5177f'],1,2,3,10081448,1,,,,10000
7937d1c394a36fcc9f4aede158b63ab05fd01b32,0,scnakandala,2016-11-03 12:02:39-04:00,"['926a01a11f44acfbbab33d4a460771d0b85b057f', '4cafd7a5cf51b069537e7bbe745de56c396d7406']",389,401,790,10082238,26,,,,10000
593331b985531e515bd2736b4e986d2786d08a32,0,GitHub,2016-11-03 12:28:48-04:00,"['01f804433e0745aca8c5e9f8fd48fb3efd33b25e', '7937d1c394a36fcc9f4aede158b63ab05fd01b32']",300,213,513,10082751,17,,,,10000
d7d058b112327e88733fc7dc2e06ea084db58b25,1,scnakandala,2016-11-03 12:34:34-04:00,['7937d1c394a36fcc9f4aede158b63ab05fd01b32'],7,198,205,10082956,13,0.297468354,0.32278481,0.993670886,10000
946143a74c6737ed4adcdbb545148aff7dcab241,0,Gourav Shenoy,2016-11-03 14:12:08-04:00,['593331b985531e515bd2736b4e986d2786d08a32'],59,176,235,10083191,2,0,0,1,10000
1ab0102dff06b55ff2c3b633050667c076bc3364,0,Shameera Rathnayaka,2016-11-03 14:37:51-04:00,['946143a74c6737ed4adcdbb545148aff7dcab241'],7,7,14,10083205,2,0,0,1,10000
0717ae34a3b6760b7ce36bfa8191b27d708e2f52,0,Shameera Rathnayaka,2016-11-03 14:38:38-04:00,"['d7d058b112327e88733fc7dc2e06ea084db58b25', '1ab0102dff06b55ff2c3b633050667c076bc3364']",62,179,241,10083446,3,,,,10000
a36adaf96f492c0dd5038236772df7d19b7e2668,1,Marcus Christie,2016-11-04 10:30:55-04:00,['4cafd7a5cf51b069537e7bbe745de56c396d7406'],29,331,360,10083806,5,0.145669291,0.082677165,0.940944882,10000
02021d3f05ccf6819687215613cdf0a7a6c34d88,0,scnakandala,2016-11-04 11:04:33-04:00,['d7d058b112327e88733fc7dc2e06ea084db58b25'],885,0,885,10084691,2,,,,10000
56384a1a028acf50e3111234d0ab5f15c8aadf70,1,scnakandala,2016-11-04 11:04:38-04:00,['02021d3f05ccf6819687215613cdf0a7a6c34d88'],0,1297,1297,10085988,29,,,,10029
e275b7bc55980ee5360a547288eaa7f50664c7dd,1,Marcus Christie,2016-11-04 11:05:42-04:00,['a36adaf96f492c0dd5038236772df7d19b7e2668'],3,10,13,10086001,1,0,0,0,10029
2768cf15997887dbf81f9d546f9bc1c2487131ee,0,scnakandala,2016-11-04 11:17:52-04:00,"['56384a1a028acf50e3111234d0ab5f15c8aadf70', '0717ae34a3b6760b7ce36bfa8191b27d708e2f52']",62,179,241,10086242,3,,,,10029
cdce06d96577500987de931a05dda35db3d14a48,0,scnakandala,2016-11-04 11:19:13-04:00,"['2768cf15997887dbf81f9d546f9bc1c2487131ee', 'e275b7bc55980ee5360a547288eaa7f50664c7dd']",31,340,371,10086613,5,,,,10029
a82e34ec016dd85caebad0192f46ff9bee7bd925,0,scnakandala,2016-11-04 11:35:49-04:00,['cdce06d96577500987de931a05dda35db3d14a48'],1698,651,2349,10088962,85,0,0,0,10029
2b13da9fe12d7f3585ea8a94aca3ad2713d0d9a4,0,Shameera Rathnayaka,2016-11-07 12:11:38-05:00,['a82e34ec016dd85caebad0192f46ff9bee7bd925'],25,24,49,10089011,5,,,,10029
9f3810efcc9da8557bf745f6a5986b5abf1373ce,1,Shameera Rathnayaka,2016-11-07 13:13:43-05:00,['2b13da9fe12d7f3585ea8a94aca3ad2713d0d9a4'],353,732,1085,10090096,19,0.123636364,0.269090909,0.981818182,10030
fe7bc1fcaef59bb5df73700f175ce45c99e8d6ac,0,Shameera Rathnayaka,2016-11-07 14:58:17-05:00,['9f3810efcc9da8557bf745f6a5986b5abf1373ce'],0,1,1,10090097,1,,,,10030
aefd913a843f1bc764aa8da49f496a06dea27c77,0,Shameera Rathnayaka,2016-11-07 15:20:39-05:00,['fe7bc1fcaef59bb5df73700f175ce45c99e8d6ac'],3,4,7,10090104,1,,,,10030
4d9c56e9a9f1431a493ca11e82eae21c82d1ebdf,0,Shameera Rathnayaka,2016-11-07 15:35:45-05:00,['aefd913a843f1bc764aa8da49f496a06dea27c77'],2,4,6,10090110,2,,,,10030
9ee4022f59b5420c945cd80cff96f31d89d63d31,1,Shameera Rathnayaka,2016-11-08 12:31:23-05:00,['4d9c56e9a9f1431a493ca11e82eae21c82d1ebdf'],8,174,182,10090292,6,0.198529412,0.25,0.992647059,10030
b5d7796386a4e3019e56088a7f6bf512256f717e,1,scnakandala,2016-11-08 12:48:41-05:00,['4d9c56e9a9f1431a493ca11e82eae21c82d1ebdf'],0,401,401,10090693,6,0.487951807,0.487951807,0.909638554,10035
db8beb69e68507452612a632cea6e9557fee21f4,0,scnakandala,2016-11-08 12:59:53-05:00,"['9ee4022f59b5420c945cd80cff96f31d89d63d31', 'b5d7796386a4e3019e56088a7f6bf512256f717e']",0,401,401,10091094,6,,,,10035
914799c13c228342908cb542f2d0ed109ad918d2,1,scnakandala,2016-11-08 13:32:19-05:00,['b5d7796386a4e3019e56088a7f6bf512256f717e'],23157,28769,51926,10143020,70,0.480010121,0.57034413,0.965840081,10041
2ea1e88eb8610026fbfffc0a203cee14c6f82355,0,scnakandala,2016-11-08 13:33:45-05:00,"['db8beb69e68507452612a632cea6e9557fee21f4', '914799c13c228342908cb542f2d0ed109ad918d2']",23157,28769,51926,10194946,70,,,,10041
b8977a7ecbfbbc9c3243b0fb74d764b771ccba34,0,scnakandala,2016-11-08 13:47:28-05:00,['2ea1e88eb8610026fbfffc0a203cee14c6f82355'],0,891,891,10195837,1,0.333333333,0.40952381,0.968253968,10042
3660cd8ff9f025b84ff9404792c4aca7f2b0a136,1,Shameera Rathnayaka,2016-11-08 15:26:30-05:00,['b8977a7ecbfbbc9c3243b0fb74d764b771ccba34'],147,257,404,10196241,13,0.679487179,0.692307692,0.987179487,10042
b2bded2c00de11678895e97e7125dc9a2dfeb915,1,Shameera Rathnayaka,2016-11-09 15:20:20-05:00,['3660cd8ff9f025b84ff9404792c4aca7f2b0a136'],88,168,256,10196497,16,0.5,0.482758621,1,10043
c0665f1aaa804736a6a839ba5438387557a873e9,0,Shameera Rathnayaka,2016-11-09 15:20:53-05:00,['b2bded2c00de11678895e97e7125dc9a2dfeb915'],25,24,49,10196546,5,,,,10043
e4a6b18d44d915554194259b3b976a52caaf527a,0,Shameera Rathnayaka,2016-11-09 15:43:50-05:00,['c0665f1aaa804736a6a839ba5438387557a873e9'],1,1,2,10196548,1,,,,10043
2e7fb05b4ce039a4da5e7768ed6f79b3f92e5e5f,1,Shameera Rathnayaka,2016-11-09 16:01:32-05:00,['e4a6b18d44d915554194259b3b976a52caaf527a'],3,12,15,10196563,1,0,1,1,10043
3fa3c3f638dcdcf2c34e45c63ba52443f53be640,1,scnakandala,2016-11-10 12:12:21-05:00,['2e7fb05b4ce039a4da5e7768ed6f79b3f92e5e5f'],11,14,25,10196588,1,0,0,1,10043
0fda5a8fc0e113a8eb13685ba1d419c2c1a16934,1,Marcus Christie,2016-11-10 12:36:38-05:00,['2e7fb05b4ce039a4da5e7768ed6f79b3f92e5e5f'],6722,8815,15537,10212125,5,0.335902376,0.419396275,0.980732177,10043
6a73db2fd29595e62354cb394b755de3cc79ca4b,0,scnakandala,2016-11-10 12:49:04-05:00,['3fa3c3f638dcdcf2c34e45c63ba52443f53be640'],1,11,12,10212137,1,0,1,1,10043
c62df28df01110e738bcdfc72c387e6d3096c8a0,0,scnakandala,2016-11-10 13:06:25-05:00,['6a73db2fd29595e62354cb394b755de3cc79ca4b'],14,4,18,10212155,1,1,0,0,10043
073e45698b8545782a1d647e0664b639fa64e53b,0,scnakandala,2016-11-10 13:11:37-05:00,['c62df28df01110e738bcdfc72c387e6d3096c8a0'],10,10,20,10212175,2,,,,10043
32e0b8b1bdf26b3ee31bdd6cc8f09416a24b12d0,0,scnakandala,2016-11-10 13:21:44-05:00,['073e45698b8545782a1d647e0664b639fa64e53b'],6,12,18,10212193,2,1,1,0,10043
53afafa82c48b7d7485daf392cdabb945b2bec8f,0,scnakandala,2016-11-10 13:49:34-05:00,['32e0b8b1bdf26b3ee31bdd6cc8f09416a24b12d0'],1,1,2,10212195,1,,,,10043
93431b19c5b0b5c650a0bc265126272a5cdefa5c,0,scnakandala,2016-11-10 14:23:06-05:00,['53afafa82c48b7d7485daf392cdabb945b2bec8f'],0,1,1,10212196,1,0,1,0,10043
5f3b778ef55a9d59bc5cc4dab23dd496e89dd65c,1,Marcus Christie,2016-11-10 14:47:45-05:00,['0fda5a8fc0e113a8eb13685ba1d419c2c1a16934'],2434,4954,7388,10219584,5,0.31138976,0.355799373,0.946185998,10043
400e24d6331251dea15fa9516d7facb0303a79ff,0,scnakandala,2016-11-10 15:08:27-05:00,"['93431b19c5b0b5c650a0bc265126272a5cdefa5c', '5f3b778ef55a9d59bc5cc4dab23dd496e89dd65c']",2162,6775,8937,10228521,5,,,,10043
177a2484dfffaf5f46d92d4bdc6755fcc1ce07d0,0,scnakandala,2016-11-11 12:24:05-05:00,['400e24d6331251dea15fa9516d7facb0303a79ff'],989,3470,4459,10232980,15,0.2002442,0.231379731,0.801587302,10043
c456337f23c6833779d454789ee698e0e87b2b24,0,scnakandala,2016-11-11 12:34:27-05:00,['177a2484dfffaf5f46d92d4bdc6755fcc1ce07d0'],0,6,6,10232986,1,0,0,0,10043
4139ae997854f38b17b6872395705be841d6a3e9,0,Shameera Rathnayaka,2016-11-11 16:11:03-05:00,['c456337f23c6833779d454789ee698e0e87b2b24'],2,7,9,10232995,1,0,0,1,10043
f66043474e4cc14b37f8b20d0e16246967c70a96,0,Shameera Rathnayaka,2016-11-11 16:36:08-05:00,['4139ae997854f38b17b6872395705be841d6a3e9'],1,5,6,10233001,1,0,0,1,10043
6e5d1c6eee8cc6772ca4381da2ec5d2a8ac58a7d,1,Shameera Rathnayaka,2016-11-11 19:40:12-05:00,['f66043474e4cc14b37f8b20d0e16246967c70a96'],127,250,377,10233378,2,0.045454545,0.1,0.281818182,10043
3d983269940acd39631bcac591c6f5a7587e38da,0,Shameera Rathnayaka,2016-11-12 00:52:57-05:00,['6e5d1c6eee8cc6772ca4381da2ec5d2a8ac58a7d'],2,2,4,10233382,2,,,,10043
bff26b618a0fbd6ae128900663fff006db47bd94,0,scnakandala,2016-11-12 01:35:40-05:00,['3d983269940acd39631bcac591c6f5a7587e38da'],0,1,1,10233383,1,0,0,1,10043
8035df9613b5e8ad4c1839bce88767748079a98f,0,Anuj Bhandar,2016-11-17 11:30:39-05:00,['bff26b618a0fbd6ae128900663fff006db47bd94'],1,2,3,10233386,1,0,0,1,10043
d41f46b945da360ddd3955170cf827924b3f945b,0,scnakandala,2016-11-18 15:37:40-05:00,['8035df9613b5e8ad4c1839bce88767748079a98f'],17,9,26,10233412,1,0,0,1,10043
98465df455206a3ba1eec8d74d299294b14bf62b,0,scnakandala,2016-11-18 16:13:28-05:00,['d41f46b945da360ddd3955170cf827924b3f945b'],6,0,6,10233418,1,1,1,0,10043
ea5d3251ebc4534f5287ded8dd58bde877c12239,0,scnakandala,2016-11-21 16:14:05-05:00,['98465df455206a3ba1eec8d74d299294b14bf62b'],1,1,2,10233420,1,,,,10043
51a2bfe7771e6d0ec3cf2c1a4a374a60be7d858e,0,scnakandala,2016-11-21 17:04:49-05:00,['ea5d3251ebc4534f5287ded8dd58bde877c12239'],93,75,168,10233588,2,0,0,0,10043
55fe7bad6a27fb3a780fa1d731a93770aef83d16,0,scnakandala,2016-11-22 12:50:00-05:00,['51a2bfe7771e6d0ec3cf2c1a4a374a60be7d858e'],7,9,16,10233604,1,0,1,1,10043
3582fefa6df74877a21072460d0f950451333915,0,Shameera Rathnayaka,2016-11-22 16:27:45-05:00,['55fe7bad6a27fb3a780fa1d731a93770aef83d16'],16,20,36,10233640,1,1,1,1,10043
a1dba1dc202baafc9096ae7934528db28745affa,1,scnakandala,2016-11-23 10:48:21-05:00,['3582fefa6df74877a21072460d0f950451333915'],90,149,239,10233879,2,0,0,1,10043
26e832d6caac59c33fed3914d0a13f41a0489e4f,1,scnakandala,2016-11-23 14:27:32-05:00,['a1dba1dc202baafc9096ae7934528db28745affa'],0,1,1,10233880,1,0,0,1,10043
2e05c239eb46ff2e21fe62fbe94466b225c57a7b,1,Marcus Christie,2016-11-29 09:30:00-05:00,['a1dba1dc202baafc9096ae7934528db28745affa'],2022,635,2657,10236537,25,0.560756076,0.410441044,0.073807381,10045
d678f4fc1e7417461d20b8b1425d8b689233e67a,0,scnakandala,2016-11-29 14:08:48-05:00,"['26e832d6caac59c33fed3914d0a13f41a0489e4f', '2e05c239eb46ff2e21fe62fbe94466b225c57a7b']",2022,635,2657,10239194,25,,,,10045
98378b53e4e1da69e61f8149e51093eab94013a0,1,Anuj Bhandar,2016-12-01 17:48:24-05:00,['d678f4fc1e7417461d20b8b1425d8b689233e67a'],6,70,76,10239270,2,1,1,1,10046
f3c60d0b9f9e56cb29ffacb0e59b840303e54a08,1,Anuj Bhandar,2016-12-01 17:49:32-05:00,['98378b53e4e1da69e61f8149e51093eab94013a0'],8,6,14,10239284,3,1,1,0,10046
1bb80426d1acaa6d65aa49951fbb5fd1bc6a1703,1,Anuj Bhandar,2016-12-01 17:51:14-05:00,['f3c60d0b9f9e56cb29ffacb0e59b840303e54a08'],0,33,33,10239317,1,0,0,1,10046
84f756d41b490198f3f8c420ebf3c51146a34a0a,1,Anuj Bhandar,2016-12-01 21:28:39-05:00,['1bb80426d1acaa6d65aa49951fbb5fd1bc6a1703'],2,14,16,10239333,1,1,1,1,10046
9f83606b5f8bb0f88aba6b4b50d02df97352a689,0,scnakandala,2016-12-05 14:53:35-05:00,['84f756d41b490198f3f8c420ebf3c51146a34a0a'],1,1,2,10239335,1,1,0,0,10046
087fdbdab3482752f6a01081679332bcc2ddaf4c,0,scnakandala,2016-12-05 15:50:54-05:00,['9f83606b5f8bb0f88aba6b4b50d02df97352a689'],3,9,12,10239347,1,0,0,1,10046
5ba819bbb425967de1c07b7eb89b945f5428fd47,0,scnakandala,2016-12-05 16:24:46-05:00,['087fdbdab3482752f6a01081679332bcc2ddaf4c'],1,1,2,10239349,1,,,,10046
0cc6ae66fbccbedc3a0fca44a449f26808aa6c96,0,Shameera Rathnayaka,2016-12-06 16:52:33-05:00,['5ba819bbb425967de1c07b7eb89b945f5428fd47'],11,11,22,10239371,1,,,,10046
e429faafa7af94b6f00369e83462750a0179330b,0,scnakandala,2016-12-06 17:23:01-05:00,['6368b161f34fb2d8ad7daf3014c13b5e4618b2b5'],1,1,2,10239373,1,,,,10046
4d5b61ce96796e3835c6f20fb8359a209a953929,1,scnakandala,2016-12-07 13:51:42-05:00,['0cc6ae66fbccbedc3a0fca44a449f26808aa6c96'],1,9,10,10239383,1,0,0,1,10046
122fb8da06408b1f203006e88a97e923be4fbc2a,1,Anuj Bhandar,2016-12-12 04:18:06-05:00,['4d5b61ce96796e3835c6f20fb8359a209a953929'],1250,502,1752,10241135,19,0.567669173,0.501879699,0,10047
c1b696badd3ccfa686cdb21ab2da0012ec7dd354,1,Anuj Bhandar,2016-12-12 11:58:57-05:00,['122fb8da06408b1f203006e88a97e923be4fbc2a'],890,1682,2572,10243707,11,0.221223022,0.091726619,0.692446043,10048
465f766e3555f7287e4593ea67cd50b4312d0bbd,1,Marcus Christie,2016-12-12 14:06:53-05:00,['84f756d41b490198f3f8c420ebf3c51146a34a0a'],47,822,869,10244576,10,0.016768293,0.079268293,0.928353659,10048
d9a69ae546736ce3265b6b5cedeeb6a2361293d8,1,Anuj Bhandar,2016-12-12 15:00:27-05:00,['4d5b61ce96796e3835c6f20fb8359a209a953929'],962,9957,10919,10255495,45,0.629872312,0.830477151,0.985215054,10073
49afd997f2f30ccabb83a30059f0e4483553a640,1,Anuj Bhandar,2016-12-12 15:51:57-05:00,['d9a69ae546736ce3265b6b5cedeeb6a2361293d8'],0,586,586,10256081,7,0.52195122,0.72195122,0.868292683,10079
7b7bb532cbf940e6d028c44cef0758a7a9c56e29,1,Marcus Christie,2016-12-13 10:54:05-05:00,['465f766e3555f7287e4593ea67cd50b4312d0bbd'],2,10,12,10256093,1,0,0,0,10079
a94a7ca9da12ccb698cf1dfc9716bccd35472437,0,Shameera Rathnayaka,2016-12-13 11:10:58-05:00,"['49afd997f2f30ccabb83a30059f0e4483553a640', 'c1b696badd3ccfa686cdb21ab2da0012ec7dd354']",2056,2100,4156,10260249,25,,,,10079
a6c8c27576072c59d1f643122fd36dd833a26479,0,Marcus Christie,2016-12-13 11:11:02-05:00,['7b7bb532cbf940e6d028c44cef0758a7a9c56e29'],3,45,48,10260297,5,,,,10079
9eede35bad7c6865bcdb3b125c79e97c2c982e98,0,Shameera Rathnayaka,2016-12-13 12:10:23-05:00,['a94a7ca9da12ccb698cf1dfc9716bccd35472437'],2,6,8,10260305,1,,,,10079
9865e7e2404c8ce4d3554f563b8cb987e8211325,1,Marcus Christie,2016-12-13 12:21:40-05:00,['a94a7ca9da12ccb698cf1dfc9716bccd35472437'],71,168,239,10260544,3,0.098591549,0,0.61971831,10079
6867673ff75fc0d486d870e66a0e00c92a1c4f1b,0,scnakandala,2016-12-13 14:52:44-05:00,"['9eede35bad7c6865bcdb3b125c79e97c2c982e98', '9865e7e2404c8ce4d3554f563b8cb987e8211325']",71,168,239,10260783,3,,,,10079
a42ccd7286e2499c033c06688be5aac11f353cea,0,scnakandala,2016-12-13 14:55:15-05:00,"['6867673ff75fc0d486d870e66a0e00c92a1c4f1b', 'a6c8c27576072c59d1f643122fd36dd833a26479']",47,872,919,10261702,10,,,,10079
8fceeb7c9609c682dcf6ed174f43e37d6bc74786,0,Shameera Rathnayaka,2016-12-14 11:46:32-05:00,['a42ccd7286e2499c033c06688be5aac11f353cea'],1,1,2,10261704,1,,,,10079
1802a04d7560e54506414467ef7fae77b3c62463,0,scnakandala,2016-12-14 14:55:41-05:00,['8fceeb7c9609c682dcf6ed174f43e37d6bc74786'],1,1,2,10261706,1,,,,10079
ecf26dfcabafe519ffa0358413f388a6ac9eadb3,0,Anuj Bhandar,2016-12-14 15:25:23-05:00,['49afd997f2f30ccabb83a30059f0e4483553a640'],4,193,197,10261903,3,1,1,1,10081
a9187f2d29de3458f87d140f7a4b4d4f00401473,0,Anuj Bhandar,2016-12-14 15:27:59-05:00,['1802a04d7560e54506414467ef7fae77b3c62463'],4,193,197,10262100,3,1,1,1,10083
93a4a66f448c29bbc1813be4e1567e2b70a4fd4b,0,Anuj Bhandar,2016-12-14 15:34:01-05:00,['a9187f2d29de3458f87d140f7a4b4d4f00401473'],4,4,8,10262108,1,,,,10083
c0779c077240dd63a0167eea73ef301cf80b6ba7,0,scnakandala,2016-12-15 12:58:28-05:00,['93a4a66f448c29bbc1813be4e1567e2b70a4fd4b'],1,1,2,10262110,1,,,,10083
1ad40e3f5c4f38a66f14f9e6b4be8e05879441d3,0,Anuj Bhandar,2016-12-15 13:02:44-05:00,['c0779c077240dd63a0167eea73ef301cf80b6ba7'],0,5,5,10262115,1,,,,10083
a65a2bd6caf8fafeae70d2f52aa8c9adbec8f3d8,0,Anuj Bhandar,2016-12-15 13:05:40-05:00,['1ad40e3f5c4f38a66f14f9e6b4be8e05879441d3'],5,5,10,10262125,1,,,,10083
e65ebc13c576ffaabc14b7e404412e02fa138deb,0,Anuj Bhandar,2016-12-15 13:08:23-05:00,"['a65a2bd6caf8fafeae70d2f52aa8c9adbec8f3d8', 'ecf26dfcabafe519ffa0358413f388a6ac9eadb3']",0,0,0,10262125,0,,,,10083
dc65b9c51d511728a3de03480e4f6fc03b17592b,0,scnakandala,2016-12-15 15:05:26-05:00,['e65ebc13c576ffaabc14b7e404412e02fa138deb'],18,22,40,10262165,1,0,0,0,10083
53b52dcf1dd1049280c6155ae16ddbccb41e04d2,1,Marcus Christie,2016-12-16 13:34:30-05:00,['e429faafa7af94b6f00369e83462750a0179330b'],1,1,2,10262167,1,,,,10083
b33d72be7a0b0adbf1c827a64afbcc5c4d732c84,1,scnakandala,2016-12-16 16:02:18-05:00,['dc65b9c51d511728a3de03480e4f6fc03b17592b'],10,3,13,10262180,3,1,1,1,10083
2cb5ebc3c628e69cd1801020bd17aa5be034774f,1,scnakandala,2016-12-16 17:02:26-05:00,['b33d72be7a0b0adbf1c827a64afbcc5c4d732c84'],28,34,62,10262242,6,1,0,0,10083
ce359dc0f086dcc5719b2ec42237e7f1d505b135,0,Ajinkya Dhamnaskar,2016-12-18 13:44:43-05:00,['2cb5ebc3c628e69cd1801020bd17aa5be034774f'],909,1403,2312,10264554,19,1,1,0.623076923,10092
b46aa6e483d4e5e93e3d521b40ffa9ca103c35a9,0,Ajinkya Dhamnaskar,2016-12-18 13:46:52-05:00,['ce359dc0f086dcc5719b2ec42237e7f1d505b135'],0,71,71,10264625,1,,,,10093
cd2abca6996573ee6696a9bec4a2e3d3a64e41e5,0,Ajinkya Dhamnaskar,2016-12-18 13:48:11-05:00,['b46aa6e483d4e5e93e3d521b40ffa9ca103c35a9'],60,7,67,10264692,1,,,,10093
6c4ac5a128b8ea2dced763862f77188e0793754a,0,Ajinkya Dhamnaskar,2016-12-18 13:49:05-05:00,['cd2abca6996573ee6696a9bec4a2e3d3a64e41e5'],149,0,149,10264841,3,,,,10093
c072479683dc11bb5ac28a278a4e5a2d175eeaee,0,Ajinkya Dhamnaskar,2016-12-18 13:50:02-05:00,['6c4ac5a128b8ea2dced763862f77188e0793754a'],146,490,636,10265477,1,1,0.274725275,0,10093
4d43fc48aef971c5122940f30332d1cf30bc135e,0,Ajinkya Dhamnaskar,2016-12-18 13:51:28-05:00,['c072479683dc11bb5ac28a278a4e5a2d175eeaee'],46,133,179,10265656,2,,,,10093
1e310f3ad6c85bfbdec0dca8a4e0761b08e6b847,0,Ajinkya Dhamnaskar,2016-12-18 13:52:24-05:00,['4d43fc48aef971c5122940f30332d1cf30bc135e'],14,16,30,10265686,2,,,,10093
3f1b73bcaea1df1af76bb2f5b70d82d6f7c0d0f5,0,Ajinkya Dhamnaskar,2016-12-18 13:53:00-05:00,['1e310f3ad6c85bfbdec0dca8a4e0761b08e6b847'],41,18,59,10265745,1,,,,10093
445e1495006563bb9710f35a134e406b1bd9ee95,1,Shameera Rathnayaka,2016-12-19 12:00:01-05:00,['2cb5ebc3c628e69cd1801020bd17aa5be034774f'],343,504,847,10266592,29,0.607142857,0.714285714,0.883928571,10093
8fb9010e18903ac91b5db57a1cd6d95795628b57,0,scnakandala,2016-12-19 16:32:48-05:00,['445e1495006563bb9710f35a134e406b1bd9ee95'],188,1620,1808,10268400,5,0.10513245,0,0.917218543,10093
f40972db8a9beba5a5fee39fcb9502804f38b5bf,0,Shameera Rathnayaka,2016-12-23 13:27:45-05:00,['8fb9010e18903ac91b5db57a1cd6d95795628b57'],1,1,2,10268402,1,,,,10093
5c6b70b61fb834295ed8358335e6f790caa09ced,0,scnakandala,2016-12-23 15:32:11-05:00,['f40972db8a9beba5a5fee39fcb9502804f38b5bf'],2,3,5,10268407,1,0,0,1,10093
7e141b09867d96a3e60b8924de54a701589440f0,0,Shameera Rathnayaka,2016-12-23 17:24:24-05:00,['5c6b70b61fb834295ed8358335e6f790caa09ced'],3,3,6,10268413,2,,,,10093
6a63e1860091cd2f40960f9b8294a5594ad88a3c,0,Shameera Rathnayaka,2016-12-27 11:14:43-05:00,['7e141b09867d96a3e60b8924de54a701589440f0'],5,11,16,10268429,1,1,1,1,10093
fc8f4a500deb524e3911f56101f7f6eacb868405,0,Shameera Rathnayaka,2016-12-27 12:00:09-05:00,['6a63e1860091cd2f40960f9b8294a5594ad88a3c'],5,9,14,10268443,4,0,0,1,10093
b17134db29bc1ea5081bb2c13ff91a7a585e47f0,0,Marcus Christie,2016-12-27 12:16:39-05:00,['fc8f4a500deb524e3911f56101f7f6eacb868405'],0,11,11,10268454,1,,,,10093
3ceba9dc9deb34641544573074451e0c7bf77766,1,Shameera Rathnayaka,2016-12-27 17:00:23-05:00,['b17134db29bc1ea5081bb2c13ff91a7a585e47f0'],8,40,48,10268502,1,0,0.75,0.25,10093
4cf37a695c8a8db423bcbc6f0657d751b9962324,0,Marcus Christie,2016-12-28 10:58:31-05:00,"['3ceba9dc9deb34641544573074451e0c7bf77766', '53b52dcf1dd1049280c6155ae16ddbccb41e04d2']",1,1,2,10268504,1,,,,10093
5cb06c945fe0afebb2c8cbf19d99b7b4e37d4750,0,Shameera Rathnayaka,2016-12-28 14:18:39-05:00,['4cf37a695c8a8db423bcbc6f0657d751b9962324'],9,19,28,10268532,3,0.166666667,1,0,10093
a33d2d88f810f06b750629a1832ed89867a6da79,0,Shameera Rathnayaka,2016-12-28 23:47:14-05:00,['5cb06c945fe0afebb2c8cbf19d99b7b4e37d4750'],24,68,92,10268624,9,0.117647059,0.117647059,1,10093
48469af8f2b3847d87a171bbf6c6ce58c3f0e071,0,Shameera Rathnayaka,2016-12-29 14:19:59-05:00,['a33d2d88f810f06b750629a1832ed89867a6da79'],1,1,2,10268626,1,,,,10093
6fcd3941b5aa357429173a219567bf7fdf4f87de,0,Marcus Christie,2016-12-30 15:17:18-05:00,"['e429faafa7af94b6f00369e83462750a0179330b', '53b52dcf1dd1049280c6155ae16ddbccb41e04d2']",1,1,2,10268628,1,,,,10093
c50e3ecdeaad702f98a7df4fa3795bb211dbfe83,0,Shameera Rathnayaka,2016-12-30 15:48:42-05:00,['48469af8f2b3847d87a171bbf6c6ce58c3f0e071'],4,6,10,10268638,5,,,,10093
644bf89629ac61ab35917bafa737ecbcbe547463,0,Shameera Rathnayaka,2016-12-30 15:50:38-05:00,['c50e3ecdeaad702f98a7df4fa3795bb211dbfe83'],26,54,80,10268718,5,0.833333333,0,1,10093
1480cd3b498fe90bc3f5fac7a35c24cee31110b6,0,Shameera Rathnayaka,2016-12-30 16:38:24-05:00,['644bf89629ac61ab35917bafa737ecbcbe547463'],40,42,82,10268800,1,0,0,1,10093
9fc238dec83505e0ab2417679dfd1b93446a7871,1,Shameera Rathnayaka,2016-12-30 17:19:12-05:00,['1480cd3b498fe90bc3f5fac7a35c24cee31110b6'],3,7,10,10268810,2,1,1,1,10093
c4f1141c5c1c1dc26e774bf6b4f9998f5e8ff4bb,1,Shameera Rathnayaka,2017-01-03 15:07:16-05:00,['9fc238dec83505e0ab2417679dfd1b93446a7871'],14,30,44,10268854,1,1,0.125,1,10093
f97ec69e3e10146ca3937fb6a4297111438b29c9,0,jecoulte,2017-01-13 15:10:44-05:00,"['6fcd3941b5aa357429173a219567bf7fdf4f87de', 'c4f1141c5c1c1dc26e774bf6b4f9998f5e8ff4bb']",99384,556585,655969,10924823,860,,,,10093
387d5c6e300feb59c331dc22bdb612a46a70b98c,1,scnakandala,2017-01-17 23:29:18+05:18,['c4f1141c5c1c1dc26e774bf6b4f9998f5e8ff4bb'],2,2,4,10924827,1,,,,10093
485e71072bea0ee7b8a4ca949f87f0f17aad2dd5,0,Suresh Marru,2017-01-17 15:43:32-05:00,['387d5c6e300feb59c331dc22bdb612a46a70b98c'],2,3,5,10924832,1,,,,10093
0108cb28c5cf704eadcb6be124dfcb8d99963dbc,0,Suresh Marru,2017-01-20 05:24:03-05:00,['485e71072bea0ee7b8a4ca949f87f0f17aad2dd5'],1,1,2,10924834,1,,,,10093
22efc10b9553f741efca3c53761eea34b892cf67,1,Suresh Marru,2017-01-20 05:28:24-05:00,['0108cb28c5cf704eadcb6be124dfcb8d99963dbc'],4256,4206,8462,10933296,126,0.112676056,0.521126761,0.455399061,10101
aae071177ded5ab58d7ed4dbd95dae75f8169772,0,Suresh Marru,2017-01-20 05:34:52-05:00,['22efc10b9553f741efca3c53761eea34b892cf67'],97,97,194,10933490,97,,,,10101
306599f8399b5d02822f96bd8137b91165617c9e,0,Marcus Christie,2017-01-23 12:12:20-05:00,['aae071177ded5ab58d7ed4dbd95dae75f8169772'],1297,0,1297,10934787,29,,,,10101
e0fbde2b9068b86541500b9e1fd9b12f6a8bb0d9,1,Marcus Christie,2017-01-23 12:12:20-05:00,['306599f8399b5d02822f96bd8137b91165617c9e'],0,202,202,10934989,12,,,,10111
8f6f2183c42b1ce1432b93b4ade892f1f122fb2d,0,Anuj Bhandar,2017-01-24 18:45:59-05:00,['e0fbde2b9068b86541500b9e1fd9b12f6a8bb0d9'],287,409,696,10935685,11,0,0,0,10112
aa98eee4f34949a4a8fe09361fe59d6e93e22e36,1,Anuj Bhandar,2017-01-24 18:57:11-05:00,['8f6f2183c42b1ce1432b93b4ade892f1f122fb2d'],1,1,2,10935687,1,,,,10112
baaed53a372e7ab51eaed83b997dd604a29baf46,1,Anuj Bhandar,2017-01-24 19:00:16-05:00,['aa98eee4f34949a4a8fe09361fe59d6e93e22e36'],0,11,11,10935698,1,,,,10112
c6ba43bf685b953f575760894fb89910e2c22d14,0,Anuj Bhandar,2017-01-24 19:05:59-05:00,['baaed53a372e7ab51eaed83b997dd604a29baf46'],1,1,2,10935700,1,0,0,1,10112
69a5855fbafbfc2c8bb43ec2dcda359d45540fac,0,jecoulte,2017-01-25 10:41:39-05:00,"['f97ec69e3e10146ca3937fb6a4297111438b29c9', 'e0fbde2b9068b86541500b9e1fd9b12f6a8bb0d9']",5461,4317,9778,10945478,73,,,,10112
39e22204d13177c02ba360914c2feae7dec51480,0,Anuj Bhandar,2017-01-25 15:00:50-05:00,['c6ba43bf685b953f575760894fb89910e2c22d14'],670,695,1365,10946843,10,1,1,0.785714286,10114
7aa0e2fba44ee50089555daaa1c8362024788a64,1,Anuj Bhandar,2017-01-25 15:10:30-05:00,['39e22204d13177c02ba360914c2feae7dec51480'],0,43,43,10946886,1,1,1,1,10115
b642ce9dad2aeb66890e35d72a8959ab4d6c01f0,1,Anuj Bhandar,2017-01-25 15:34:26-05:00,['7aa0e2fba44ee50089555daaa1c8362024788a64'],7,8,15,10946901,2,,,,10115
42b84f980962b2caf9bf924effef277015ec96fe,0,jecoulte,2017-01-27 10:07:18-05:00,['69a5855fbafbfc2c8bb43ec2dcda359d45540fac'],1,6,7,10946908,1,,,,10115
025faa611fb3075cf9e2bb1ae9d1c033ac31dc29,0,jecoulte,2017-01-27 10:08:59-05:00,['42b84f980962b2caf9bf924effef277015ec96fe'],0,35,35,10946943,1,,,,10116
899781d16740f256ad9bbf285288f466f5875be8,0,jecoulte,2017-01-27 10:10:08-05:00,['025faa611fb3075cf9e2bb1ae9d1c033ac31dc29'],0,33,33,10946976,1,,,,10117
6512efc7ff9625d35cb6a3d6aefc36c08dda3a63,0,jecoulte,2017-01-27 10:11:25-05:00,['899781d16740f256ad9bbf285288f466f5875be8'],1,9,10,10946986,1,,,,10117
09c8f51d2a91f7125111853c881c3a2ec9b17c2d,0,jecoulte,2017-01-27 10:13:31-05:00,['6512efc7ff9625d35cb6a3d6aefc36c08dda3a63'],2,2,4,10946990,1,,,,10117
8193c7f0d6466e7a06d559938867090215d63cf8,0,jecoulte,2017-01-27 11:35:47-05:00,['09c8f51d2a91f7125111853c881c3a2ec9b17c2d'],28,1,29,10947019,1,,,,10117
125abd2999d945724e655140ba944561c6bd9d62,0,jecoulte,2017-01-27 11:37:17-05:00,['8193c7f0d6466e7a06d559938867090215d63cf8'],2,1,3,10947022,1,,,,10117
bb96168ee4ca0962ebc7d4e1e090f524863845c2,0,jecoulte,2017-01-27 11:39:53-05:00,['125abd2999d945724e655140ba944561c6bd9d62'],4,4,8,10947030,1,,,,10117
193f3b5a143c069d4c9f1af655a7094d28ed7150,0,jecoulte,2017-01-27 11:43:15-05:00,['bb96168ee4ca0962ebc7d4e1e090f524863845c2'],17,9,26,10947056,1,,,,10117
f31e6a3a2c78bdc4ad157f505ff8f9d7d6246c3e,0,jecoulte,2017-01-27 11:46:19-05:00,['193f3b5a143c069d4c9f1af655a7094d28ed7150'],2,5,7,10947063,1,,,,10117
58542a4c064db1e12898d003b6adb50975712299,0,jecoulte,2017-01-27 11:47:12-05:00,['f31e6a3a2c78bdc4ad157f505ff8f9d7d6246c3e'],5,15,20,10947083,1,,,,10117
214a068ed698e089e37f5b2007950ca464cb2f07,0,jecoulte,2017-01-27 11:50:59-05:00,['58542a4c064db1e12898d003b6adb50975712299'],0,222,222,10947305,1,,,,10118
ffdb236645c242f1ae4e14bf81dee006620c36c0,0,jecoulte,2017-01-27 11:51:56-05:00,['214a068ed698e089e37f5b2007950ca464cb2f07'],2,2,4,10947309,1,,,,10118
dfdad9bd6374f11248e171b0ceae7cb8c712af4e,0,jecoulte,2017-01-27 11:52:36-05:00,['ffdb236645c242f1ae4e14bf81dee006620c36c0'],1,2,3,10947312,1,,,,10118
0ca9853842193e4a82530b3d993819ebf628d005,0,jecoulte,2017-01-27 11:57:32-05:00,['dfdad9bd6374f11248e171b0ceae7cb8c712af4e'],0,3,3,10947315,1,,,,10118
fa3fb2e68c192594747a00c2a0b4e5a6951b4e11,0,jecoulte,2017-01-27 11:58:00-05:00,['0ca9853842193e4a82530b3d993819ebf628d005'],0,6,6,10947321,1,,,,10118
989cfa3ba620bd63fb18284a53e7f6575a057624,0,jecoulte,2017-01-27 11:58:29-05:00,['fa3fb2e68c192594747a00c2a0b4e5a6951b4e11'],9,0,9,10947330,2,,,,10118
ee8207e694422838616b893ac5b34f01052bfa8b,0,jecoulte,2017-01-27 12:03:25-05:00,['989cfa3ba620bd63fb18284a53e7f6575a057624'],0,1,1,10947331,1,,,,10118
e2b2f8621dfe61bbdf4c65eda902ed49ea8abf26,0,scnakandala,2017-01-27 14:40:24-05:00,['e0fbde2b9068b86541500b9e1fd9b12f6a8bb0d9'],0,4,4,10947335,1,,,,10118
8e08042f9f236a0b6bce897ae2518b38beb15875,0,scnakandala,2017-01-27 15:41:07-05:00,"['e2b2f8621dfe61bbdf4c65eda902ed49ea8abf26', '3f1b73bcaea1df1af76bb2f5b70d82d6f7c0d0f5']",1365,2138,3503,10950838,30,,,,10118
0bde5a6a95166d11b50eba95de00bbfb89aa0394,0,scnakandala,2017-01-30 09:53:14-05:00,['8e08042f9f236a0b6bce897ae2518b38beb15875'],13,9,22,10950860,2,,,,10118
8e87d98114cd2b4c91103f086753647c628ac171,1,scnakandala,2017-01-30 11:33:58-05:00,['0bde5a6a95166d11b50eba95de00bbfb89aa0394'],9,13,22,10950882,1,0,0,1,10118
6fe8556f18d30b647584bce10ea51720eafca4bb,1,scnakandala,2017-01-30 14:12:07-05:00,['8e87d98114cd2b4c91103f086753647c628ac171'],1,3,4,10950886,1,1,1,1,10118
3dd731e085f07635e57d7c851be5527d46094255,0,Suresh Marru,2017-01-31 11:44:18-05:00,['6fe8556f18d30b647584bce10ea51720eafca4bb'],5,0,5,10950891,1,,,,10118
59c812ba165f57ca1c9f28aed9ed25189dbab70d,0,scnakandala,2017-02-01 15:54:46-05:00,['3dd731e085f07635e57d7c851be5527d46094255'],72,162,234,10951125,8,0.48,0.84,0.52,10119
75527b42ee3004e547d15931a0b2c8c532666844,0,Anuj Bhandar,2017-02-01 17:12:51-05:00,['59c812ba165f57ca1c9f28aed9ed25189dbab70d'],287,409,696,10951821,11,0,0,0,10120
234486710d8a03e8a1346f31cca27accfd2fc0e5,1,Anuj Bhandar,2017-02-01 17:12:51-05:00,['75527b42ee3004e547d15931a0b2c8c532666844'],1,1,2,10951823,1,,,,10120
3e62c282b490d1d78b75269703fcbc01e77b4b25,0,Anuj Bhandar,2017-02-01 17:12:51-05:00,['234486710d8a03e8a1346f31cca27accfd2fc0e5'],0,11,11,10951834,1,,,,10120
890b87317216a35a97c5ebe7e6ae02ad7f3bd7cf,1,Anuj Bhandar,2017-02-01 17:12:51-05:00,['3e62c282b490d1d78b75269703fcbc01e77b4b25'],1,1,2,10951836,1,0,0,1,10120
8df74920c95d3e1e826de45faae513b31fe1d223,0,Anuj Bhandar,2017-02-01 17:12:52-05:00,['890b87317216a35a97c5ebe7e6ae02ad7f3bd7cf'],670,695,1365,10953201,10,1,1,0.785714286,10122
32c11f95753f5250b4a41a6292f87029edda58a9,1,Anuj Bhandar,2017-02-01 17:12:52-05:00,['8df74920c95d3e1e826de45faae513b31fe1d223'],0,43,43,10953244,1,1,1,1,10123
5df3f813019215755b020b02ba0f821b1f448d1e,1,Anuj Bhandar,2017-02-01 17:12:52-05:00,['32c11f95753f5250b4a41a6292f87029edda58a9'],7,8,15,10953259,2,,,,10123
05e97d6e6c750c3bf5f5435dd4768b4e733f620a,0,Anuj Bhandar,2017-02-01 17:12:52-05:00,['5df3f813019215755b020b02ba0f821b1f448d1e'],6,4,10,10953269,23,,,,10123
4beadefdccae4f5640562917a7589bf1384285f6,0,Marcus Christie,2017-02-02 14:42:58-05:00,['59c812ba165f57ca1c9f28aed9ed25189dbab70d'],8,2,10,10953279,5,,,,10123
7a662756d69539a59eadd11847362abfd829db59,0,Marcus Christie,2017-02-02 14:59:52-05:00,['4beadefdccae4f5640562917a7589bf1384285f6'],0,33,33,10953312,5,,,,10127
80dbaba6f152a6527928ec038e6f8523db04a14a,0,Marcus Christie,2017-02-02 16:22:42-05:00,"['7a662756d69539a59eadd11847362abfd829db59', 'b642ce9dad2aeb66890e35d72a8959ab4d6c01f0']",867,1069,1936,10955248,18,,,,10127
eb2c383620ec37c52f19735d6389c8a85a5daa68,0,Marcus Christie,2017-02-03 11:24:17-05:00,['80dbaba6f152a6527928ec038e6f8523db04a14a'],10,5,15,10955263,2,,,,10127
f71ef2139fd625685de0ee1e2c86fad69628d315,1,scnakandala,2017-02-06 11:28:38-05:00,['eb2c383620ec37c52f19735d6389c8a85a5daa68'],0,9,9,10955272,1,0,1,1,10127
a54f78133d494b6f309963f2b39c7fd09c081118,0,scnakandala,2017-02-06 12:53:05-05:00,['f71ef2139fd625685de0ee1e2c86fad69628d315'],12,65,77,10955349,7,0,0.25,0.333333333,10127
8eca75cb1f517a7c3007e72050e292b7bb7a0ded,0,scnakandala,2017-02-06 12:59:26-05:00,['a54f78133d494b6f309963f2b39c7fd09c081118'],1,2,3,10955352,1,,,,10127
c4d32f4205cfffc7b75c1e1d3385900a6401af76,0,Anuj Bhandar,2017-02-06 15:59:30-05:00,['05e97d6e6c750c3bf5f5435dd4768b4e733f620a'],854,278,1132,10956484,17,0.204379562,0,0,10128
593f2cfd52f59f945d4f6cafe23f8cda864733bd,0,Anuj Bhandar,2017-02-06 17:02:57-05:00,['c4d32f4205cfffc7b75c1e1d3385900a6401af76'],23,27,50,10956534,15,1,1,0,10128
52ae8349b941d699bfb1e74f743452510a880a75,1,scnakandala,2017-02-07 14:15:50-05:00,['8eca75cb1f517a7c3007e72050e292b7bb7a0ded'],1,1,2,10956536,1,,,,10128
b5ae4dc96e64a61059e57bd6e104d9b1bec76b98,1,Ajinkya Dhamnaskar,2017-02-07 14:52:56-05:00,['52ae8349b941d699bfb1e74f743452510a880a75'],1,5,6,10956542,1,0,0,1,10128
b49aea33b454252175e77b246ce1224a2895b7fa,0,jecoulte,2017-02-08 13:15:04-05:00,['ee8207e694422838616b893ac5b34f01052bfa8b'],1,4,5,10956547,1,,,,10128
d43efb5c19d8196a8e29323c4bc77015dd3e89d8,0,jecoulte,2017-02-08 13:16:16-05:00,['b49aea33b454252175e77b246ce1224a2895b7fa'],0,61,61,10956608,3,,,,10129
5f65b0796c32f014270fadc1c34cf5b5f474b600,0,jecoulte,2017-02-08 13:44:49-05:00,['d43efb5c19d8196a8e29323c4bc77015dd3e89d8'],7,12,19,10956627,2,,,,10129
56acd6b2bb650cfd9021c6ad9d5bb4322b5159aa,0,scnakandala,2017-02-08 16:03:23-05:00,['b5ae4dc96e64a61059e57bd6e104d9b1bec76b98'],0,3,3,10956630,1,0,0,1,10129
56263b46990988e131897480fb7b790b28f0ca91,0,jecoulte,2017-02-09 08:45:57-05:00,['5f65b0796c32f014270fadc1c34cf5b5f474b600'],1,1,2,10956632,1,,,,10129
d7764ad78dd070f26de1ce6fa80aa51250e371bf,0,jecoulte,2017-02-09 08:46:16-05:00,['56263b46990988e131897480fb7b790b28f0ca91'],11,1,12,10956644,1,,,,10129
6f498a40678832330646b74544d4e2b5601ce398,0,Marcus Christie,2017-02-10 11:55:45-05:00,['593f2cfd52f59f945d4f6cafe23f8cda864733bd'],0,4,4,10956648,1,,,,10129
2c5854b1f0eb25b15383e85b6334a0f2e6bb4f0f,0,scnakandala,2017-02-10 14:42:11-05:00,['56acd6b2bb650cfd9021c6ad9d5bb4322b5159aa'],25,24,49,10956697,1,0,0,0,10129
5ba6a6da5783db888c148755393fc0ad589d6cca,0,scnakandala,2017-02-10 14:44:52-05:00,['6fcd3941b5aa357429173a219567bf7fdf4f87de'],17,20,37,10956734,1,1,1,1,10129
ef56b7a52d0d7fdec97a564aa6411c62ad0a0b00,0,scnakandala,2017-02-14 14:04:09-05:00,['2c5854b1f0eb25b15383e85b6334a0f2e6bb4f0f'],1,4,5,10956739,1,1,1,1,10129
8d2581aff4e72e3cf2d353eb1b295038a5d6391b,0,scnakandala,2017-02-14 14:04:57-05:00,['5ba6a6da5783db888c148755393fc0ad589d6cca'],1,4,5,10956744,1,1,1,1,10129
0926abf096b576f385d25544de1fc969224e6333,0,scnakandala,2017-02-14 16:40:27-05:00,['ef56b7a52d0d7fdec97a564aa6411c62ad0a0b00'],74,97,171,10956915,2,1,0,0,10129
cfb0610fba8a4219814ed283904cebd1a2b01b6d,0,Marcus Christie,2017-02-14 16:56:19-05:00,['0926abf096b576f385d25544de1fc969224e6333'],10,30,40,10956955,2,0,0,1,10129
a7d5310073afac8ef7ef36060add3dafd16f8501,0,scnakandala,2017-02-15 10:28:03-05:00,['0926abf096b576f385d25544de1fc969224e6333'],9,1,10,10956965,1,0,0,0,10129
3072a7369cc9bbf4472b0fdf844b9eb1c6965cac,0,scnakandala,2017-02-15 10:28:57-05:00,"['a7d5310073afac8ef7ef36060add3dafd16f8501', 'cfb0610fba8a4219814ed283904cebd1a2b01b6d']",10,30,40,10957005,2,,,,10129
3f1914c24d31bf68b8e8d9e8e40617c9cca629af,0,Marcus Christie,2017-02-15 12:35:43-05:00,['6f498a40678832330646b74544d4e2b5601ce398'],2,3,5,10957010,1,,,,10129
c8326ae6243f2bb31d4cd41e5dd5e89fe808c470,1,scnakandala,2017-02-15 14:25:24-05:00,['3072a7369cc9bbf4472b0fdf844b9eb1c6965cac'],232,168,400,10957410,12,0,1,0,10129
f68f55a1abf9e6cad1e3a4d909f5c050a46d5ce5,0,Marcus Christie,2017-02-15 14:40:59-05:00,['3f1914c24d31bf68b8e8d9e8e40617c9cca629af'],1,8,9,10957419,1,,,,10129
84fcd360da6e6d8c9ecb5f52de133e81734abfdb,1,scnakandala,2017-02-15 15:28:51-05:00,['c8326ae6243f2bb31d4cd41e5dd5e89fe808c470'],29,258,287,10957706,23,0.098958333,0.411458333,0.994791667,10129
a7b7fe6b6c80d4e12c4f5a4d664917b0c2d82fe2,0,scnakandala,2017-02-15 15:51:13-05:00,['84fcd360da6e6d8c9ecb5f52de133e81734abfdb'],0,7,7,10957713,5,,,,10129
4120d75f36eb692cd92c6fed054715b5c9c7c334,0,Marcus Christie,2017-02-17 13:10:26-05:00,['f68f55a1abf9e6cad1e3a4d909f5c050a46d5ce5'],1,46,47,10957760,2,,,,10129
54e0f39eb5ae508f532be673057da6088e768e91,0,Marcus Christie,2017-02-17 13:12:41-05:00,['4120d75f36eb692cd92c6fed054715b5c9c7c334'],29035,42367,71402,11029162,2,0.370320599,0.420906124,0.96179689,10129
de26509047837989ceddd505fe13a96837493928,0,Marcus Christie,2017-02-17 13:14:56-05:00,['54e0f39eb5ae508f532be673057da6088e768e91'],6,148,154,11029316,7,1,1,0.489361702,10129
a700073d6fddd9407cb3ed49ab31c5e9465291b4,1,scnakandala,2017-02-17 14:06:28-05:00,['a7b7fe6b6c80d4e12c4f5a4d664917b0c2d82fe2'],429,1241,1670,11030986,2,0,0.931880109,0.519073569,10130
589392ef0d4868d1c32970e31ca7fe0515990048,0,Marcus Christie,2017-02-17 16:29:20-05:00,['de26509047837989ceddd505fe13a96837493928'],2,2,4,11030990,2,,,,10130
d4dad6dc843ae69710f08dfa9a50b54b22894242,0,Suresh Marru,2017-02-20 12:00:14-05:00,['a700073d6fddd9407cb3ed49ab31c5e9465291b4'],0,1,1,11030991,1,,,,10130
2f3847b202006c67e857c0e6e58078498fb3acc8,0,scnakandala,2017-02-22 14:17:22-05:00,['a700073d6fddd9407cb3ed49ab31c5e9465291b4'],2,0,2,11030993,1,1,1,0,10130
527e63527463b8839ba62e957ee48143d0da1d00,0,scnakandala,2017-02-22 14:17:51-05:00,"['2f3847b202006c67e857c0e6e58078498fb3acc8', 'd4dad6dc843ae69710f08dfa9a50b54b22894242']",0,1,1,11030994,1,,,,10130
9526e99b2aed47f4ab354ad3f8a1822db4f94627,0,scnakandala,2017-02-22 14:27:56-05:00,['8d2581aff4e72e3cf2d353eb1b295038a5d6391b'],1,1,2,11030996,1,,,,10130
0bc5f2e9b4d63fb02f5519d26a8cd84443ef70d3,0,Marcus Christie,2017-02-22 17:03:34-05:00,['589392ef0d4868d1c32970e31ca7fe0515990048'],4,4,8,11031004,1,,,,10130
f07a1ddd663a7261b009423a4988308f7ae2a11c,0,scnakandala,2017-02-22 17:36:31-05:00,['527e63527463b8839ba62e957ee48143d0da1d00'],2,0,2,11031006,1,1,0,0,10130
6931cd3c6ddf39280b4bb7db393502334f3fb8d2,0,scnakandala,2017-02-23 14:16:22-05:00,['f07a1ddd663a7261b009423a4988308f7ae2a11c'],132,185,317,11031323,20,0.02,0.08,0.96,10130
deda93758c3d3018d98f1dbbd2256afcc6c60550,0,scnakandala,2017-02-23 16:13:00-05:00,['6931cd3c6ddf39280b4bb7db393502334f3fb8d2'],4,6,10,11031333,2,0.5,0.5,0.5,10130
af4a04ec6f7e920cd4d244f8fbbefdf81aeeb27c,0,scnakandala,2017-02-23 21:01:38-05:00,['deda93758c3d3018d98f1dbbd2256afcc6c60550'],4,620,624,11031957,2,0,1,1,10131
1378dbdb0b7eafd96228ee7929bb77c4406c0096,0,scnakandala,2017-02-24 15:06:59-05:00,['af4a04ec6f7e920cd4d244f8fbbefdf81aeeb27c'],1,1,2,11031959,1,,,,10131
6c367b92d589dd79926d47f534c232b6161d85b0,0,scnakandala,2017-02-24 15:25:15-05:00,['1378dbdb0b7eafd96228ee7929bb77c4406c0096'],6,9,15,11031974,1,0,0,0,10131
52fb440274fbc121b28e0af8de91d2037345a532,0,Marcus Christie,2017-02-28 11:55:41-05:00,['0bc5f2e9b4d63fb02f5519d26a8cd84443ef70d3'],7,18,25,11031999,2,0,1,1,10131
bfe1066a4bc83eccf5ac731aba930665180e9b36,0,Marcus Christie,2017-02-28 12:18:04-05:00,['52fb440274fbc121b28e0af8de91d2037345a532'],2,16,18,11032017,1,,,,10131
eed4f7de04ca47e5eb07e1f294331acaa51ff086,0,GitHub,2017-02-28 12:36:17-05:00,"['593f2cfd52f59f945d4f6cafe23f8cda864733bd', 'bfe1066a4bc83eccf5ac731aba930665180e9b36']",29053,42609,71662,11103679,18,,,,10131
e9f14e2d97c798c495364df2c897d2ea06345646,0,Suresh Marru,2017-02-28 12:54:11-05:00,['6c367b92d589dd79926d47f534c232b6161d85b0'],3,0,3,11103682,1,,,,10131
01943baf04a15b10f800497e0de111276602d7ab,0,Anuj Bhandar,2017-02-28 12:55:34-05:00,['e9f14e2d97c798c495364df2c897d2ea06345646'],6,4,10,11103692,23,,,,10131
9085dfe5f87d5a3bb8321e1d6adf7e6226cb9264,0,Anuj Bhandar,2017-02-28 12:55:35-05:00,['01943baf04a15b10f800497e0de111276602d7ab'],854,278,1132,11104824,17,0.204379562,0,0,10132
e0f63bcb936e496d0630de19637673b0a5a31862,0,Anuj Bhandar,2017-02-28 12:55:35-05:00,['9085dfe5f87d5a3bb8321e1d6adf7e6226cb9264'],23,27,50,11104874,15,1,1,0,10132
71dcaac1b728bbf305e3e10de9d90399f68f9f51,0,Anuj Bhandar,2017-02-28 12:55:35-05:00,['e0f63bcb936e496d0630de19637673b0a5a31862'],0,4,4,11104878,1,,,,10132
bd1ada588c5cfed3bd3c9e9c740e243c7c38ec1e,0,Anuj Bhandar,2017-02-28 12:55:35-05:00,['71dcaac1b728bbf305e3e10de9d90399f68f9f51'],2,3,5,11104883,1,,,,10132
53193fb4d2f81feb79805805afeaba7cb24b40a6,0,Anuj Bhandar,2017-02-28 12:55:35-05:00,['bd1ada588c5cfed3bd3c9e9c740e243c7c38ec1e'],1,8,9,11104892,1,,,,10132
ebba4c9f54b3a36688fbdc99d8692e31f6b28922,1,Anuj Bhandar,2017-02-28 12:55:35-05:00,['53193fb4d2f81feb79805805afeaba7cb24b40a6'],1,46,47,11104939,2,,,,10132
9dd4fdb3fd0190f27e4d13a510f90965789632ed,1,Anuj Bhandar,2017-02-28 12:55:47-05:00,['ebba4c9f54b3a36688fbdc99d8692e31f6b28922'],29035,42367,71402,11176341,2,0.370320599,0.420906124,0.96179689,10132
bce873c8c6f0d91b489518a89f26d48443e815bc,1,Anuj Bhandar,2017-02-28 13:07:17-05:00,['9dd4fdb3fd0190f27e4d13a510f90965789632ed'],6,182,188,11176529,7,1,1,0.603305785,10132
e34206394de573f718a7fb3e8b0b4ebdc8938dbc,0,Anuj Bhandar,2017-02-28 13:07:18-05:00,['bce873c8c6f0d91b489518a89f26d48443e815bc'],2,2,4,11176533,2,,,,10132
08fd8c4081ae8b0cdf8798e8c6d88555c596274f,0,Anuj Bhandar,2017-02-28 13:07:18-05:00,['e34206394de573f718a7fb3e8b0b4ebdc8938dbc'],4,4,8,11176541,1,,,,10132
ee8d5eede9fafd9353be8f36635449efa391800f,1,Anuj Bhandar,2017-02-28 13:07:18-05:00,['08fd8c4081ae8b0cdf8798e8c6d88555c596274f'],7,18,25,11176566,2,0,1,1,10132
a43d1a9c8d8dca9ab29d079192ca9e4befed4f79,0,Anuj Bhandar,2017-02-28 13:07:18-05:00,['ee8d5eede9fafd9353be8f36635449efa391800f'],2,16,18,11176584,1,,,,10132
b81bad3a8ec1a82133b9e72fb249c2cf8c9e6856,0,Anuj Bhandar,2017-02-28 13:17:33-05:00,"['a43d1a9c8d8dca9ab29d079192ca9e4befed4f79', 'eed4f7de04ca47e5eb07e1f294331acaa51ff086']",1,1,2,11176586,1,,,,10132
d1ae2642a586fed4f8b20c669668218f42f636d5,0,Marcus Christie,2017-03-01 15:47:52-05:00,"['e9f14e2d97c798c495364df2c897d2ea06345646', 'b81bad3a8ec1a82133b9e72fb249c2cf8c9e6856']",29955,42971,72926,11249512,41,,,,10132
326891fcfc80a6acdc4be1ac40a6e6f0d8e44409,0,Ajinkya Dhamnaskar,2017-03-01 16:15:53-05:00,['e9f14e2d97c798c495364df2c897d2ea06345646'],0,125,125,11249637,5,1,1,1,10137
2436e7ad338e8705645644433d0a10224d3610d0,0,Ajinkya Dhamnaskar,2017-03-01 16:19:45-05:00,['326891fcfc80a6acdc4be1ac40a6e6f0d8e44409'],1,1,2,11249639,1,,,,10137
0d354226f2c24e05dd192c12980e0e554c29f199,0,Ajinkya Dhamnaskar,2017-03-01 16:30:17-05:00,['2436e7ad338e8705645644433d0a10224d3610d0'],0,5,5,11249644,1,,,,10138
e34722a98b7634d71e80ccab170bd43197395d12,0,scnakandala,2017-03-02 14:05:48-05:00,['6c367b92d589dd79926d47f534c232b6161d85b0'],0,65,65,11249709,3,0,1,1,10141
3c453aeac578f309b03ce37c91bab5518bce08b5,0,scnakandala,2017-03-02 14:20:57-05:00,['e34722a98b7634d71e80ccab170bd43197395d12'],0,72,72,11249781,1,1,1,1,10142
530ee96af958ab2bc01a4d103aee31e2d06af705,0,GitHub,2017-03-03 11:08:57-05:00,"['0d354226f2c24e05dd192c12980e0e554c29f199', 'd1ae2642a586fed4f8b20c669668218f42f636d5']",29955,42971,72926,11322707,41,,,,10142
af39d44b2d0bef340399e45f8c7e27dd7b1a6bc1,0,scnakandala,2017-03-04 20:58:41-05:00,['3c453aeac578f309b03ce37c91bab5518bce08b5'],29,96,125,11322832,4,0.25,0.25,1,10142
2d0796f84c1db30892f47f49b2f9d3131500f00a,0,scnakandala,2017-03-04 21:26:47-05:00,['af39d44b2d0bef340399e45f8c7e27dd7b1a6bc1'],12,20,32,11322864,8,0,0,1,10142
79757785499572f885dc9b96f3f16637a751fd08,0,scnakandala,2017-03-04 21:45:42-05:00,['2d0796f84c1db30892f47f49b2f9d3131500f00a'],0,60,60,11322924,2,1,1,0.8,10143
efc2b693ef02c9c12740738cd36c9d2d7963bde6,0,Gourav Shenoy,2017-03-04 22:18:44-05:00,['d1ae2642a586fed4f8b20c669668218f42f636d5'],0,48,48,11322972,3,,,,10145
594e85115da53187d2bdc3157b062c37a22476a9,1,Gourav Shenoy,2017-03-05 17:12:47-05:00,['efc2b693ef02c9c12740738cd36c9d2d7963bde6'],2,8316,8318,11331290,10,0.608554413,0.809781628,0.980869879,10153
ef9f85051b10930e055afa2db082059d404128e3,0,Gourav Shenoy,2017-03-05 17:20:30-05:00,['594e85115da53187d2bdc3157b062c37a22476a9'],0,29,29,11331319,4,1,1,1,10153
b9bbb78689f15e2e792e242f5374d438d2201fe5,0,Gourav Shenoy,2017-03-05 17:24:12-05:00,['ef9f85051b10930e055afa2db082059d404128e3'],0,2,2,11331321,1,0,0,1,10153
fcc06e0ff3502de42a2010b420a9d90f43eafb14,1,Gourav Shenoy,2017-03-05 17:45:13-05:00,['b9bbb78689f15e2e792e242f5374d438d2201fe5'],0,1328,1328,11332649,17,0.901763224,1,0.921914358,10168
f8927815a44ff1d58dbff1168b9c91d6930eed29,0,Ajinkya Dhamnaskar,2017-03-05 18:13:16-05:00,"['0d354226f2c24e05dd192c12980e0e554c29f199', 'd1ae2642a586fed4f8b20c669668218f42f636d5']",29955,42971,72926,11405575,41,,,,10168
cbe1c280ca50c75af7bfe0146a15472aa073eba4,0,Gourav Shenoy,2017-03-05 18:16:01-05:00,['fcc06e0ff3502de42a2010b420a9d90f43eafb14'],1,389,390,11405965,7,0.762886598,0.762886598,0.932989691,10172
5af1accd75b1fa6fd9968c5839ce723d3552da6e,1,Gourav Shenoy,2017-03-05 18:33:13-05:00,['cbe1c280ca50c75af7bfe0146a15472aa073eba4'],6,11,17,11405982,2,,,,10172
56fefc9845ab926f225edb7c787c1a676eefadb3,0,scnakandala,2017-03-06 13:05:45-05:00,['79757785499572f885dc9b96f3f16637a751fd08'],2,9,11,11405993,1,0,0,1,10172
a749a7c8d5fd010deb138ea009ce2bbed2d965d7,0,scnakandala,2017-03-06 13:38:38-05:00,['56fefc9845ab926f225edb7c787c1a676eefadb3'],2,2,4,11405997,1,,,,10172
2c3052252f26f8548cae77e5f6c978b16cffbaf7,0,scnakandala,2017-03-06 14:10:58-05:00,['a749a7c8d5fd010deb138ea009ce2bbed2d965d7'],1,1,2,11405999,1,,,,10172
fc07b995cfdbeed9ad9726c4b8c8a8bae20807b0,0,scnakandala,2017-03-06 14:22:56-05:00,['2c3052252f26f8548cae77e5f6c978b16cffbaf7'],4,4,8,11406007,1,,,,10172
ce58c98c4b860bf682ca456c94eb7a2eb370eae7,0,Gourav Shenoy,2017-03-06 17:42:10-05:00,['5af1accd75b1fa6fd9968c5839ce723d3552da6e'],2,7422,7424,11413431,8,0.64456869,0.847444089,0.988618211,10177
598261960369714a8499cc04262453b61c1b8941,0,Gourav Shenoy,2017-03-06 17:50:35-05:00,['ce58c98c4b860bf682ca456c94eb7a2eb370eae7'],0,61,61,11413492,1,1,1,1,10178
4e58ef78b9193ee5a3bfa9df9e0632987470e736,1,Gourav Shenoy,2017-03-07 13:12:50-05:00,['598261960369714a8499cc04262453b61c1b8941'],0,1057,1057,11414549,14,0.451263538,0.528880866,1,10188
732abdeec5696d7923e0f3e0f7a8831a1db5d500,0,Gourav Shenoy,2017-03-07 14:11:05-05:00,['4e58ef78b9193ee5a3bfa9df9e0632987470e736'],5,40,45,11414594,2,1,1,1,10188
362c7d480b5d6e54729b554018bf4499636f17ce,0,Ajinkya Dhamnaskar,2017-03-07 14:40:38-05:00,"['f8927815a44ff1d58dbff1168b9c91d6930eed29', '5af1accd75b1fa6fd9968c5839ce723d3552da6e']",6,10120,10126,11424720,36,,,,10188
7177cac6b247a525ee2a56bbe461e521134aba50,0,Ajinkya Dhamnaskar,2017-03-07 15:14:23-05:00,['fc07b995cfdbeed9ad9726c4b8c8a8bae20807b0'],1,12,13,11424733,1,0,0,0.142857143,10188
bf2d92d986abe9237bf7e19916910391360357dd,0,Gourav Shenoy,2017-03-07 15:27:41-05:00,['732abdeec5696d7923e0f3e0f7a8831a1db5d500'],6,560,566,11425299,4,0.76,0.9,1,10191
f9e4b0dfda8da03356d295661fc30d6b2732170d,0,Gourav Shenoy,2017-03-07 16:51:25-05:00,['bf2d92d986abe9237bf7e19916910391360357dd'],619,405,1024,11426323,9,0.771929825,1,0,10192
1a619c98e2fff342a119928963895e90f9a797b3,0,Gourav Shenoy,2017-03-07 16:56:07-05:00,['f9e4b0dfda8da03356d295661fc30d6b2732170d'],24,21,45,11426368,14,,,,10192
f113d160cafdf81ec4a13ed48d6c13c776cc9fcd,0,Gourav Shenoy,2017-03-07 16:58:35-05:00,['1a619c98e2fff342a119928963895e90f9a797b3'],0,5,5,11426373,1,0,0,1,10192
b774862b66f6649429ad6d4155a2921108588bc9,0,scnakandala,2017-03-07 17:14:46-05:00,['79757785499572f885dc9b96f3f16637a751fd08'],2,9,11,11426384,1,0,0,1,10192
231e0eba64ec2e7c5d59dc5afac0d8ae1f953c89,0,scnakandala,2017-03-07 17:14:59-05:00,['b774862b66f6649429ad6d4155a2921108588bc9'],2,2,4,11426388,1,,,,10192
889fd074eff282817797b9d7786ccb5fc6f411f1,0,scnakandala,2017-03-07 17:15:08-05:00,['231e0eba64ec2e7c5d59dc5afac0d8ae1f953c89'],1,1,2,11426390,1,,,,10192
bf23eaec9af9a3b613831fb2bcf6b337a3b74ec9,0,scnakandala,2017-03-07 17:15:28-05:00,['889fd074eff282817797b9d7786ccb5fc6f411f1'],4,4,8,11426398,1,,,,10192
1306097cf632035a4c5ed1b22bd3b5d43499e6a6,0,scnakandala,2017-03-07 17:15:52-05:00,['bf23eaec9af9a3b613831fb2bcf6b337a3b74ec9'],1,12,13,11426411,1,0,0,0.142857143,10192
536cca166851be8d15a2edd1e909fb4f546b9940,0,scnakandala,2017-03-07 17:16:04-05:00,['1306097cf632035a4c5ed1b22bd3b5d43499e6a6'],6589,13136,19725,11446136,7,0.589464519,0.799521114,0.983239007,10192
7da786f6af7a90f9dc00f2faee58f8be7fd49d63,0,scnakandala,2017-03-07 17:16:24-05:00,['536cca166851be8d15a2edd1e909fb4f546b9940'],1,1,2,11446138,1,,,,10192
741531f0b78059af173032a09bfe58377ab507e6,0,scnakandala,2017-03-07 18:16:49-05:00,['f113d160cafdf81ec4a13ed48d6c13c776cc9fcd'],17,202,219,11446357,12,0.190140845,0.528169014,0.788732394,10192
2071c7c25cdf16e3a28540b8c2edd859f3a21596,0,Marcus Christie,2017-03-08 10:13:43-05:00,"['7da786f6af7a90f9dc00f2faee58f8be7fd49d63', 'd7764ad78dd070f26de1ce6fa80aa51250e371bf']",68,409,477,11446834,10,,,,10192
4b54ff605b46cdfc83f989dfde533a0fb2168821,0,Marcus Christie,2017-03-08 10:15:15-05:00,['2071c7c25cdf16e3a28540b8c2edd859f3a21596'],3,194,197,11447031,14,,,,10198
60a3223898e1afafb2332cb401e7a0da1de1e6bc,0,Marcus Christie,2017-03-08 10:15:15-05:00,['4b54ff605b46cdfc83f989dfde533a0fb2168821'],0,1,1,11447032,1,,,,10198
852a4fe4359c6dbc9468610332cf02a2aba7ce50,0,Marcus Christie,2017-03-08 10:27:19-05:00,['60a3223898e1afafb2332cb401e7a0da1de1e6bc'],1,1,2,11447034,1,,,,10198
2a41071dda3916c8dbfd5269164fa6b02df7b0f8,1,Marcus Christie,2017-03-08 12:11:07-05:00,['852a4fe4359c6dbc9468610332cf02a2aba7ce50'],0,69,69,11447103,6,,,,10201
3e0a8c44751771d1be37cf0f48e665c49bb96e07,0,Gourav Shenoy,2017-03-08 12:41:21-05:00,['f113d160cafdf81ec4a13ed48d6c13c776cc9fcd'],3,0,3,11447106,1,,,,10201
c7deb6730d64a05fd4c661ed2e644f62ed01f60b,1,Gourav Shenoy,2017-03-08 16:10:08-05:00,['3e0a8c44751771d1be37cf0f48e665c49bb96e07'],6,66,72,11447178,2,0.193548387,1,1,10201
fd38523b09ca2fc398f56c571641f7ec8a3f787d,1,Gourav Shenoy,2017-03-08 16:10:48-05:00,['c7deb6730d64a05fd4c661ed2e644f62ed01f60b'],0,1175,1175,11448353,13,0.918410042,1,0.956066946,10213
5b35224995f1cdc1eaf36ca3c75fb26fea3fbaff,0,Gourav Shenoy,2017-03-08 16:25:16-05:00,['fd38523b09ca2fc398f56c571641f7ec8a3f787d'],886,86,972,11449325,14,0.047337278,0,0.062130178,10213
45bacd67fba7e9d728a8bd05a870745bf6677fed,0,Gourav Shenoy,2017-03-08 17:00:39-05:00,['5b35224995f1cdc1eaf36ca3c75fb26fea3fbaff'],100,29,129,11449454,6,,,,10213
2eb3ee7c68065c2dc5931091a5d280cb0ec74523,1,Gourav Shenoy,2017-03-08 17:48:15-05:00,['45bacd67fba7e9d728a8bd05a870745bf6677fed'],20,7246,7266,11456720,9,0.657247408,0.858914413,0.989835332,10216
8e83408a9d35d018b7047be55619630d1858d821,1,Gourav Shenoy,2017-03-08 18:00:49-05:00,['2eb3ee7c68065c2dc5931091a5d280cb0ec74523'],7400,153,7553,11464273,14,0.355788624,0.154094393,0.011496571,10217
648d8ca74a12d56a63c1ab136104873ec25a6df8,0,Gourav Shenoy,2017-03-08 18:07:36-05:00,['8e83408a9d35d018b7047be55619630d1858d821'],1286,42,1328,11465601,13,0.406779661,0.168079096,0,10217
fe0ed74e9d9f6d30bfa34189fef0e86eaa042972,1,Gourav Shenoy,2017-03-08 18:27:04-05:00,['648d8ca74a12d56a63c1ab136104873ec25a6df8'],29,23,52,11465653,5,0,0,0,10217
fa0c57b3df19436ae75b5e0ecf1f0f3d9e9f8c74,0,scnakandala,2017-03-08 18:45:30-05:00,"['741531f0b78059af173032a09bfe58377ab507e6', 'fe0ed74e9d9f6d30bfa34189fef0e86eaa042972']",1912,1002,2914,11468567,43,,,,10217
f9eb7bc70da5179ed8ab586064d5ca94932982ef,0,Marcus Christie,2017-03-09 12:09:00-05:00,['2a41071dda3916c8dbfd5269164fa6b02df7b0f8'],4,4,8,11468575,1,,,,10217
99013354dba66273b378e396ef8942b8dddbe03e,0,Ajinkya Dhamnaskar,2017-03-14 14:12:22-04:00,"['362c7d480b5d6e54729b554018bf4499636f17ce', 'fa0c57b3df19436ae75b5e0ecf1f0f3d9e9f8c74']",138,8328,8466,11477041,46,,,,10217
e0110cbb5a52ceb0a9b9b1a3452d91052840d577,0,Marcus Christie,2017-03-14 17:29:36-04:00,['f9eb7bc70da5179ed8ab586064d5ca94932982ef'],581,106,687,11477728,9,,,,10222
ebc158ddf56adadae67eec252fe089b0406f109d,0,Marcus Christie,2017-03-14 17:29:36-04:00,['e0110cbb5a52ceb0a9b9b1a3452d91052840d577'],5,6,11,11477739,5,,,,10222
c6608d8fe4045dc3cd0543d82f354e64313b367a,0,scnakandala,2017-03-16 14:17:11-04:00,['ebc158ddf56adadae67eec252fe089b0406f109d'],24,195,219,11477958,11,0.285714286,0.344537815,0.890756303,10222
505e30cad2525584646bf8e00654f122e60673fa,0,scnakandala,2017-03-16 14:37:46-04:00,['c6608d8fe4045dc3cd0543d82f354e64313b367a'],1,1,2,11477960,1,,,,10222
fc720d464bd95194db237cb7d6955308c027335c,0,Marcus Christie,2017-03-16 14:42:14-04:00,['505e30cad2525584646bf8e00654f122e60673fa'],0,0,0,11477960,1,,,,10222
7beb6a4da010617baaee9cad251eac0ba6e10247,0,scnakandala,2017-03-16 14:47:13-04:00,['505e30cad2525584646bf8e00654f122e60673fa'],1,1,2,11477962,1,,,,10222
ae139ff29ef1d7757e046bba10f69153a8889544,0,scnakandala,2017-03-16 14:49:47-04:00,"['7beb6a4da010617baaee9cad251eac0ba6e10247', 'fc720d464bd95194db237cb7d6955308c027335c']",0,0,0,11477962,1,,,,10222
520ad04f75fbb07afccba3fef515c8307eaba921,0,scnakandala,2017-03-16 15:25:20-04:00,['ae139ff29ef1d7757e046bba10f69153a8889544'],2,8,10,11477972,2,0,1,1,10222
866178a41f75df25bb788eb2a8a19cecb9889944,0,scnakandala,2017-03-16 15:26:40-04:00,['520ad04f75fbb07afccba3fef515c8307eaba921'],1,1,2,11477974,1,,,,10222
5d1b345952ed217732ba271097f850751c333c40,0,scnakandala,2017-03-16 15:31:33-04:00,['866178a41f75df25bb788eb2a8a19cecb9889944'],4,4,8,11477982,3,,,,10222
a135c82e93a67f9945b6173689974a54b8f03e97,0,scnakandala,2017-03-16 15:47:25-04:00,['5d1b345952ed217732ba271097f850751c333c40'],125,118,243,11478225,3,,,,10222
0c8c2ae00d031c36135fb61302b0d30c2310d5e1,0,scnakandala,2017-03-16 15:49:52-04:00,['a135c82e93a67f9945b6173689974a54b8f03e97'],8,3,11,11478236,2,1,0,0,10222
58c3d52b443e1cf9d5bf517ef8ccfdff6f25be57,1,Marcus Christie,2017-03-16 17:03:13-04:00,['0c8c2ae00d031c36135fb61302b0d30c2310d5e1'],14,24,38,11478274,1,0,1,1,10222
eb7cbc5c0786f4bd5a235c6a91d227b2b637ce47,1,Anuj Bhandar,2017-03-17 17:48:51-04:00,['58c3d52b443e1cf9d5bf517ef8ccfdff6f25be57'],0,145,145,11478419,6,,,,10228
7cf48b3bb12b1ad1860b2396ea5fc15dd4d3a6c7,1,Anuj Bhandar,2017-03-17 17:48:51-04:00,['eb7cbc5c0786f4bd5a235c6a91d227b2b637ce47'],33,36,69,11478488,4,,,,10228
ed6cbf656dc1745e42463ef1af0ea053c8a86eae,0,Marcus Christie,2017-03-20 09:35:50-04:00,['58c3d52b443e1cf9d5bf517ef8ccfdff6f25be57'],35,2,37,11478525,3,,,,10228
28b488dbf42722194421555cf3998386aeca4321,0,Marcus Christie,2017-03-20 09:37:20-04:00,"['ed6cbf656dc1745e42463ef1af0ea053c8a86eae', '7cf48b3bb12b1ad1860b2396ea5fc15dd4d3a6c7']",0,148,148,11478673,6,,,,10228
3d308ab23a2218e0328cc35a34f53f25b02d21f0,0,Marcus Christie,2017-03-20 09:47:52-04:00,['28b488dbf42722194421555cf3998386aeca4321'],0,7,7,11478680,1,,,,10229
2eb8f211743d376572da4af8ef775061cc4ae3f8,0,Marcus Christie,2017-03-20 10:19:32-04:00,['3d308ab23a2218e0328cc35a34f53f25b02d21f0'],0,342,342,11479022,10,,,,10239
7126b1fbbbd713f0814b39afc3e6912929f6850d,1,Marcus Christie,2017-03-20 16:12:09-04:00,['2eb8f211743d376572da4af8ef775061cc4ae3f8'],19,11,30,11479052,3,,,,10239
8ac8e9ecdb4078314b4c866d9ab98413a85d94ec,0,Marcus Christie,2017-03-20 17:06:01-04:00,['7126b1fbbbd713f0814b39afc3e6912929f6850d'],2,1,3,11479055,1,,,,10239
7e1d36953ae5f756ded7158460a278f0211d90ce,0,scnakandala,2017-03-20 23:31:39-04:00,['0c8c2ae00d031c36135fb61302b0d30c2310d5e1'],17,63,80,11479135,7,0,0.466666667,0.6,10239
45edb67374b6e9d3265d26ee9536670d3d4e52bf,0,scnakandala,2017-03-20 23:32:58-04:00,"['7e1d36953ae5f756ded7158460a278f0211d90ce', '8ac8e9ecdb4078314b4c866d9ab98413a85d94ec']",59,524,583,11479718,23,,,,10239
5d094c46dc93d17b9d0f66ab2d327144636a5905,0,GitHub,2017-03-21 11:29:23-04:00,"['530ee96af958ab2bc01a4d103aee31e2d06af705', 'fa0c57b3df19436ae75b5e0ecf1f0f3d9e9f8c74']",23,18327,18350,11498068,58,,,,10239
058cf708665deaf782a9d8aff45907722a0421c0,0,Marcus Christie,2017-03-21 12:17:09-04:00,['45edb67374b6e9d3265d26ee9536670d3d4e52bf'],7,6,13,11498081,5,,,,10239
7915c3d54b854de4d63d70eb23801c061e7c7f99,0,Gourav Shenoy,2017-03-21 16:08:08-04:00,['5d094c46dc93d17b9d0f66ab2d327144636a5905'],10,113,123,11498204,4,1,1,0.4375,10240
8d0a13efd38a269cc592120cac4797ade3459e22,0,Ajinkya Dhamnaskar,2017-03-21 16:17:21-04:00,"['99013354dba66273b378e396ef8942b8dddbe03e', '7915c3d54b854de4d63d70eb23801c061e7c7f99']",10,113,123,11498327,4,,,,10240
07ebc2e484a182a1b5f511eae4fb409a0074c184,0,Gourav Shenoy,2017-03-21 16:19:48-04:00,['7915c3d54b854de4d63d70eb23801c061e7c7f99'],0,41,41,11498368,1,1,1,0.923076923,10240
b4660f6b4c532c10e30d0bb64a8af48fa80df43e,0,Gourav Shenoy,2017-03-21 16:21:41-04:00,['07ebc2e484a182a1b5f511eae4fb409a0074c184'],1,1,2,11498370,1,,,,10240
513f284d458003ad86744ba8bc823a21ace3cd47,0,Ajinkya Dhamnaskar,2017-03-22 12:17:12-04:00,"['8d0a13efd38a269cc592120cac4797ade3459e22', 'b4660f6b4c532c10e30d0bb64a8af48fa80df43e']",1,42,43,11498413,1,,,,10240
c9ae218a6274c7c96c20f176c30738c1f0933960,0,Gourav Shenoy,2017-03-22 13:10:39-04:00,['b4660f6b4c532c10e30d0bb64a8af48fa80df43e'],25,673,698,11499111,5,0.60058309,0.760932945,1,10243
38dc8974edb9e5dd19aa6a9a9b04e02ffd3547a5,0,scnakandala,2017-03-22 14:56:23-04:00,['45edb67374b6e9d3265d26ee9536670d3d4e52bf'],10,19,29,11499140,1,0,0,1,10243
3a0b06132abe10504dd692d51a09aadabf601dfb,0,scnakandala,2017-03-22 14:56:54-04:00,"['38dc8974edb9e5dd19aa6a9a9b04e02ffd3547a5', '058cf708665deaf782a9d8aff45907722a0421c0']",7,6,13,11499153,5,,,,10243
d0b29a5c8537e5e661e8a347e6f9b4cbbf17f6db,0,Ajinkya Dhamnaskar,2017-03-23 12:06:41-04:00,['513f284d458003ad86744ba8bc823a21ace3cd47'],12,31,43,11499196,3,1,1,1,10244
d850df57b66553812587b0848a15e8e31495c022,0,Ajinkya Dhamnaskar,2017-03-23 12:20:29-04:00,"['d0b29a5c8537e5e661e8a347e6f9b4cbbf17f6db', 'c9ae218a6274c7c96c20f176c30738c1f0933960']",25,673,698,11499894,5,,,,10244
86d697b708de4519df875c0a9b4f58bb8d13202f,0,Gourav Shenoy,2017-03-23 12:59:26-04:00,['d850df57b66553812587b0848a15e8e31495c022'],29,1942,1971,11501865,7,0.685234306,0.790450928,0.991158267,10249
641e936446a2110173ca39cbed3fe2f589308eb4,0,Gourav Shenoy,2017-03-23 13:17:01-04:00,['86d697b708de4519df875c0a9b4f58bb8d13202f'],2,29,31,11501896,1,1,1,1,10249
fd7f481df4590cf00655ef0d046e748df64f116c,0,Gourav Shenoy,2017-03-23 13:57:06-04:00,['641e936446a2110173ca39cbed3fe2f589308eb4'],22,0,22,11501918,1,0,0,0,10249
11cb924f64c4dd080b2e78e9b08f7fea5670f80a,0,Gourav Shenoy,2017-03-23 13:58:11-04:00,['fd7f481df4590cf00655ef0d046e748df64f116c'],8,18,26,11501944,1,1,1,0.333333333,10249
6ec15de311d48742adb1cf6b657e8fdf824a87de,0,Gourav Shenoy,2017-03-23 14:21:46-04:00,['11cb924f64c4dd080b2e78e9b08f7fea5670f80a'],8,12,20,11501964,2,0,0,0,10249
2e537fc1855debf0794f64d616c4b39f34d1105a,0,Gourav Shenoy,2017-03-23 14:55:13-04:00,['6ec15de311d48742adb1cf6b657e8fdf824a87de'],0,64,64,11502028,7,,,,10249
495c407bb449d2a03ab872d6ea94a6f45cbb02dd,0,Gourav Shenoy,2017-03-23 14:56:20-04:00,['2e537fc1855debf0794f64d616c4b39f34d1105a'],0,56,56,11502084,2,,,,10251
9ee27207f420a5976152b60bc490e3033e911ecb,0,Gourav Shenoy,2017-03-23 15:10:17-04:00,['495c407bb449d2a03ab872d6ea94a6f45cbb02dd'],5,5,10,11502094,1,,,,10251
f4edced90812ea8310b60449efdcb9973848bad1,0,scnakandala,2017-03-23 15:23:18-04:00,['3a0b06132abe10504dd692d51a09aadabf601dfb'],2,3,5,11502099,1,0,0,1,10251
118c7bccee8ee414a5c458421960abbe59b16816,0,scnakandala,2017-03-23 15:59:42-04:00,['f4edced90812ea8310b60449efdcb9973848bad1'],8,15,23,11502122,1,0,1,0,10251
668b54daa644fa7f8c38fca5e0e4cbf34586340d,0,scnakandala,2017-03-23 16:52:49-04:00,['118c7bccee8ee414a5c458421960abbe59b16816'],6,0,6,11502128,1,1,0,1,10251
bfc3a84c745eefce1e89290e7319210b549de3b2,0,scnakandala,2017-03-23 16:58:05-04:00,['668b54daa644fa7f8c38fca5e0e4cbf34586340d'],19,17,36,11502164,4,,,,10251
9d419449707279aa186a094379ce2d8122801dbd,0,scnakandala,2017-03-23 17:00:32-04:00,['bfc3a84c745eefce1e89290e7319210b549de3b2'],6,6,12,11502176,4,,,,10251
4fc49834ebbee9d53e00680e20aa9db355913703,0,Ajinkya Dhamnaskar,2017-03-23 23:28:47-04:00,['9ee27207f420a5976152b60bc490e3033e911ecb'],45,259,304,11502480,10,0.545454545,0.97979798,0.777777778,10255
44abf36705724cad722ed1ef9253eeecf41a42cd,0,scnakandala,2017-03-24 11:11:43-04:00,['9d419449707279aa186a094379ce2d8122801dbd'],0,6,6,11502486,1,0,1,0,10255
41cc92057c603fb21fc3f1c719d525fbbc7ab281,0,Marcus Christie,2017-03-25 20:29:48-04:00,['44abf36705724cad722ed1ef9253eeecf41a42cd'],34,7,41,11502527,2,0.592592593,0,0,10255
5a1c86425335a017dbc84c4569865ca7d40d0ddb,0,Gourav Shenoy,2017-03-27 13:10:20-04:00,['4fc49834ebbee9d53e00680e20aa9db355913703'],7,135,142,11502669,7,1,1,1,10259
4066b6ccca98bce862bd8d726eb5d8d72e890196,1,Marcus Christie,2017-03-27 13:36:27-04:00,['41cc92057c603fb21fc3f1c719d525fbbc7ab281'],1,1,2,11502671,1,,,,10259
f2d09953d2bb36a13cb1053015f5de0cc8bc9bf9,0,Gourav Shenoy,2017-03-27 13:48:00-04:00,['5a1c86425335a017dbc84c4569865ca7d40d0ddb'],17,72,89,11502760,3,0.578947368,1,1,10260
5a92edae0b5b0eded0421d63fe9681a03c668ebc,0,Marcus Christie,2017-03-27 13:49:43-04:00,['4066b6ccca98bce862bd8d726eb5d8d72e890196'],1,1,2,11502762,1,,,,10260
8c6f18c59465e8dcde0200c79ac20f6320191814,0,Marcus Christie,2017-03-27 15:14:58-04:00,['5a92edae0b5b0eded0421d63fe9681a03c668ebc'],1,1,2,11502764,1,,,,10260
9b4c9682b13aeb437db51382bba8621622046fe2,0,Marcus Christie,2017-03-27 15:15:42-04:00,['8c6f18c59465e8dcde0200c79ac20f6320191814'],34,0,34,11502798,1,1,1,0,10260
8ff29121cc5e68fd0ca0ff749597cf7c3792b1f3,1,Gourav Shenoy,2017-03-28 01:31:36-04:00,['f2d09953d2bb36a13cb1053015f5de0cc8bc9bf9'],40,42,82,11502880,7,1,1,1,10260
053df2f03db57a8edbe136908ef697e7cc691b81,1,Marcus Christie,2017-03-28 10:19:40-04:00,['9b4c9682b13aeb437db51382bba8621622046fe2'],9,1,10,11502890,1,1,0,0,10260
e87cf35b07d05d40756ae9fc91f8967b81c5282d,0,Gourav Shenoy,2017-03-28 12:04:05-04:00,['8ff29121cc5e68fd0ca0ff749597cf7c3792b1f3'],135,227,362,11503252,4,0.15942029,0.463768116,0.956521739,10260
ed4452a267d5d4773ee98aa8e1818da88d395ca4,0,Gourav Shenoy,2017-03-28 12:18:25-04:00,['e87cf35b07d05d40756ae9fc91f8967b81c5282d'],4,17,21,11503273,2,1,1,1,10260
3dfa9446b94ef8ab0c87dabca2804b1ae4ecf107,1,Gourav Shenoy,2017-03-28 12:19:33-04:00,['ed4452a267d5d4773ee98aa8e1818da88d395ca4'],37,28,65,11503338,2,0,0,0,10260
59116567f0026ac12334c79627f5ec50e4d1247a,0,Gourav Shenoy,2017-03-28 12:44:50-04:00,['3dfa9446b94ef8ab0c87dabca2804b1ae4ecf107'],67,272,339,11503677,3,0.266055046,0,0.908256881,10261
6bc536f5915f8f95bd956fa50e9d3fb36a026892,1,scnakandala,2017-03-28 14:02:26-04:00,['053df2f03db57a8edbe136908ef697e7cc691b81'],3,7,10,11503687,1,0,0,1,10261
f737e8fee232c624fb6019c85173f56f54988cc3,0,Ajinkya Dhamnaskar,2017-03-28 14:14:29-04:00,['59116567f0026ac12334c79627f5ec50e4d1247a'],22,0,22,11503709,1,0,0,0,10261
070ff151c3ff5c113998f1fc98943fedb4ddbe4c,0,Ajinkya Dhamnaskar,2017-03-28 14:15:11-04:00,['f737e8fee232c624fb6019c85173f56f54988cc3'],0,12,12,11503721,1,1,1,1,10261
973bcfdce37bdda70a6e03f90c99c2347a547971,0,Ajinkya Dhamnaskar,2017-03-28 14:16:24-04:00,['070ff151c3ff5c113998f1fc98943fedb4ddbe4c'],10,35,45,11503766,3,0.666666667,0.866666667,1,10261
eeecac9b928f9265b681dac1ae34f8b2bf23623c,0,Ajinkya Dhamnaskar,2017-03-28 14:30:28-04:00,['973bcfdce37bdda70a6e03f90c99c2347a547971'],2,2,4,11503770,1,,,,10261
aa0da780aedf210751c032eb980642422e87b603,0,Ajinkya Dhamnaskar,2017-03-28 14:34:39-04:00,['eeecac9b928f9265b681dac1ae34f8b2bf23623c'],0,12,12,11503782,1,1,1,1,10261
e33946de19853b09f6773e15cd3e8d5624bfa614,0,Ajinkya Dhamnaskar,2017-03-28 14:37:23-04:00,['aa0da780aedf210751c032eb980642422e87b603'],15,0,15,11503797,1,,,,10261
5cc3e36af5023e7fc13e90d00deb1196a7cfaa66,0,Ajinkya Dhamnaskar,2017-03-28 16:01:59-04:00,['e33946de19853b09f6773e15cd3e8d5624bfa614'],0,5,5,11503802,1,,,,10261
ba8cfc70382b17bb7b87ea3446bc91c355410cce,0,Ajinkya Dhamnaskar,2017-03-28 16:03:02-04:00,['5cc3e36af5023e7fc13e90d00deb1196a7cfaa66'],15,20,35,11503837,2,,,,10262
e1e4c3f90be3d24f2e58d269f5265f4e4bc87b65,0,Ajinkya Dhamnaskar,2017-03-28 16:05:06-04:00,['ba8cfc70382b17bb7b87ea3446bc91c355410cce'],0,106,106,11503943,3,1,1,1,10265
52a2e268832734edf4010ebe253f50aa77f0a48e,0,Ajinkya Dhamnaskar,2017-03-28 16:05:54-04:00,['e1e4c3f90be3d24f2e58d269f5265f4e4bc87b65'],0,5,5,11503948,1,0,0,1,10265
de27617f24618b3e351ea466e82beac4be12788b,0,Ajinkya Dhamnaskar,2017-03-28 16:07:04-04:00,['52a2e268832734edf4010ebe253f50aa77f0a48e'],0,3,3,11503951,1,1,1,1,10265
0b5c98fcad6300407928b584ec55af5a1440a36e,0,Ajinkya Dhamnaskar,2017-03-28 16:21:45-04:00,['de27617f24618b3e351ea466e82beac4be12788b'],1,2,3,11503954,1,,,,10265
5faedb480f90b8b8d14e6ffe84aa7b3781ff4ee2,1,Gourav Shenoy,2017-03-28 16:24:12-04:00,['0b5c98fcad6300407928b584ec55af5a1440a36e'],5,110,115,11504069,6,0,0.885714286,0.485714286,10266
6c06eeebbf5a431516a1f71682f8dbd84617190c,0,Ajinkya Dhamnaskar,2017-03-29 11:54:04-04:00,['5faedb480f90b8b8d14e6ffe84aa7b3781ff4ee2'],9,34,43,11504112,2,0,1,1,10266
3745340be012be91d80048ead03cdf6bbd8a4db2,0,Ajinkya Dhamnaskar,2017-03-29 11:55:43-04:00,['6c06eeebbf5a431516a1f71682f8dbd84617190c'],18,20,38,11504150,3,1,1,1,10266
98ebc2c35b7e48ea1d63c25a42cf3c530c607144,1,Marcus Christie,2017-03-29 11:58:46-04:00,['6bc536f5915f8f95bd956fa50e9d3fb36a026892'],21,73,94,11504244,9,0.783783784,0.486486486,0.621621622,10266
2febbe60ece0d7a94d0303a54621c5e125da9775,0,Ajinkya Dhamnaskar,2017-03-29 12:01:27-04:00,['3745340be012be91d80048ead03cdf6bbd8a4db2'],2,8,10,11504254,2,,,,10266
5faa249aaf75f8ce451fe4d36a66161264e22250,0,Ajinkya Dhamnaskar,2017-03-29 12:51:31-04:00,['2febbe60ece0d7a94d0303a54621c5e125da9775'],8,10,18,11504272,2,1,1,1,10266
bd3d404f00b852f012869201153fa1655ec54c29,0,Ajinkya Dhamnaskar,2017-03-29 12:52:39-04:00,['5faa249aaf75f8ce451fe4d36a66161264e22250'],11,8,19,11504291,4,0,0,0.666666667,10266
b65c3d56eb57546136dfb6ffc40c03d977fc2795,1,Gourav Shenoy,2017-03-29 12:55:39-04:00,['bd3d404f00b852f012869201153fa1655ec54c29'],13,52,65,11504356,3,0,1,1,10266
01094fa25cc623fa1870ce4cfefce03e1b461c3b,0,Gourav Shenoy,2017-03-29 12:58:01-04:00,['b65c3d56eb57546136dfb6ffc40c03d977fc2795'],3,3,6,11504362,2,0,1,1,10266
b45bac667e89f246d85a0b1b76ce00e8d327ea55,1,Marcus Christie,2017-03-29 13:00:57-04:00,['98ebc2c35b7e48ea1d63c25a42cf3c530c607144'],2,8,10,11504372,2,,,,10266
d82e3355835fd095de7348797ae4031f0c866217,0,Gourav Shenoy,2017-03-29 13:17:10-04:00,['01094fa25cc623fa1870ce4cfefce03e1b461c3b'],1,0,1,11504373,1,,,,10266
79325446e460b0c87d9ae0fa8e29521f27bb151c,1,Gourav Shenoy,2017-03-29 13:17:45-04:00,['d82e3355835fd095de7348797ae4031f0c866217'],7,30,37,11504410,6,1,1,1,10266
ddf063c5c99835b36576683c0c76a88df01b7718,0,Ajinkya Dhamnaskar,2017-03-29 14:28:38-04:00,['79325446e460b0c87d9ae0fa8e29521f27bb151c'],7,71,78,11504488,2,0,0,1,10266
8a0f27596412052e44916429ff2ca9f66abfb302,0,Ajinkya Dhamnaskar,2017-03-29 14:30:57-04:00,['ddf063c5c99835b36576683c0c76a88df01b7718'],1,3,4,11504492,1,,,,10266
0524706b76f2e036fd05056c13139bb1ddf5cb99,0,Ajinkya Dhamnaskar,2017-03-29 14:39:37-04:00,['8a0f27596412052e44916429ff2ca9f66abfb302'],3,31,34,11504526,2,1,1,1,10267
5a2f965cad6fb35deed9eb82990ad6f21a45110b,0,Ajinkya Dhamnaskar,2017-03-29 14:40:32-04:00,['0524706b76f2e036fd05056c13139bb1ddf5cb99'],2,22,24,11504550,2,0.8,0.8,1,10267
5f9bb1e963b1f696056cac45b7f7a363145f61d9,0,Gourav Shenoy,2017-03-29 14:45:33-04:00,['5a2f965cad6fb35deed9eb82990ad6f21a45110b'],6,8,14,11504564,4,0,1,1,10267
23a6ed27a4e972ff28e70f3a90d78155caf478fa,0,Ajinkya Dhamnaskar,2017-03-29 14:57:30-04:00,['5a2f965cad6fb35deed9eb82990ad6f21a45110b'],0,58,58,11504622,1,1,1,1,10268
2b8aef344777a3942cfb4d7ec3be72df0742a0b0,0,Ajinkya Dhamnaskar,2017-03-29 14:57:50-04:00,"['23a6ed27a4e972ff28e70f3a90d78155caf478fa', '5f9bb1e963b1f696056cac45b7f7a363145f61d9']",6,8,14,11504636,4,,,,10268
f7bbec32d44e0eea98f0f581624b4e35ce49c689,0,Ajinkya Dhamnaskar,2017-03-29 15:01:34-04:00,['2b8aef344777a3942cfb4d7ec3be72df0742a0b0'],9,9,18,11504654,3,,,,10268
fa7d765df03a3c87f2dd833ee56021466b8c194e,1,Gourav Shenoy,2017-03-29 15:11:48-04:00,['5f9bb1e963b1f696056cac45b7f7a363145f61d9'],11,29,40,11504694,6,0.428571429,1,0.857142857,10268
d67e6085f01ee2fdf570f00eb900d9a28902664a,0,Gourav Shenoy,2017-03-29 15:11:56-04:00,"['fa7d765df03a3c87f2dd833ee56021466b8c194e', 'f7bbec32d44e0eea98f0f581624b4e35ce49c689']",8,66,74,11504768,3,,,,10268
b3aefe5bd19f445d473bcd6ea3d12fd1463b3019,0,Ajinkya Dhamnaskar,2017-03-29 15:21:10-04:00,['d67e6085f01ee2fdf570f00eb900d9a28902664a'],2,2,4,11504772,1,,,,10268
8c0bccce447376ce85396c4233f7f256060b7353,0,Gourav Shenoy,2017-03-29 15:31:48-04:00,['d67e6085f01ee2fdf570f00eb900d9a28902664a'],3,13,16,11504788,1,0,0,1,10268
8cca4b6cd701919ab0328efad23ef3e446b0027c,0,Gourav Shenoy,2017-03-29 15:31:56-04:00,"['8c0bccce447376ce85396c4233f7f256060b7353', 'b3aefe5bd19f445d473bcd6ea3d12fd1463b3019']",2,2,4,11504792,1,,,,10268
027a0020b333508a2ea1bafa0781fe9082ba5eca,0,Ajinkya Dhamnaskar,2017-03-29 15:34:38-04:00,['8cca4b6cd701919ab0328efad23ef3e446b0027c'],4,7,11,11504803,2,0,0,1,10268
0974ebb6050f962314542d468e077ddcf171250b,0,Gourav Shenoy,2017-03-29 15:46:05-04:00,['027a0020b333508a2ea1bafa0781fe9082ba5eca'],10,11,21,11504824,1,1,1,0,10268
9169309e2c7456b7361118748820d565e5666c5f,0,Ajinkya Dhamnaskar,2017-03-30 00:12:05-04:00,['0974ebb6050f962314542d468e077ddcf171250b'],3,1,4,11504828,2,1,1,0,10268
e8e47f769122d3253d011492d567988da049609a,0,Ajinkya Dhamnaskar,2017-03-30 12:06:17-04:00,['9169309e2c7456b7361118748820d565e5666c5f'],3,7,10,11504838,2,0,1,1,10268
cc62d47aa6f8c5609281f471ec2f9996d0fd2d37,0,Ajinkya Dhamnaskar,2017-03-30 12:38:56-04:00,['e8e47f769122d3253d011492d567988da049609a'],7,14,21,11504859,3,0,0,1,10268
a5e907c88271dd5c0020fb39e7aa80fb23b74e10,0,Gourav Shenoy,2017-03-30 12:59:52-04:00,['cc62d47aa6f8c5609281f471ec2f9996d0fd2d37'],0,180,180,11505039,9,,,,10268
582e25fa214fbcfe1a6f5be8a71a89a9f49fd274,0,Ajinkya Dhamnaskar,2017-03-30 13:15:50-04:00,['a5e907c88271dd5c0020fb39e7aa80fb23b74e10'],2,10,12,11505051,2,1,1,1,10268
c8a2b8e3719feb3aafdcbbe093364f7c4946d3ac,1,Gourav Shenoy,2017-03-30 14:17:11-04:00,['a5e907c88271dd5c0020fb39e7aa80fb23b74e10'],1,274,275,11505326,6,0.36036036,0.36036036,1,10270
833baa97aa50f590838304390e8fb2bff6610c2f,0,Gourav Shenoy,2017-03-30 14:17:20-04:00,"['c8a2b8e3719feb3aafdcbbe093364f7c4946d3ac', '582e25fa214fbcfe1a6f5be8a71a89a9f49fd274']",2,10,12,11505338,2,,,,10270
8d30ebeeb6292a205acf56d1a9da2f7c407c6240,0,Gourav Shenoy,2017-03-30 14:28:49-04:00,['833baa97aa50f590838304390e8fb2bff6610c2f'],9,22,31,11505369,3,0.833333333,0.833333333,1,10270
28f133dd29a949110aa715ab613e64ee66553bf6,0,Gourav Shenoy,2017-03-30 14:46:48-04:00,['8d30ebeeb6292a205acf56d1a9da2f7c407c6240'],5,5,10,11505379,4,,,,10270
f1e1fc28a305a14f0e7e28a7707308dd37dd05bd,0,Gourav Shenoy,2017-03-30 14:47:50-04:00,['28f133dd29a949110aa715ab613e64ee66553bf6'],1,1,2,11505381,1,,,,10270
3d8c343f176937098ddd5c2b5f92d716df140587,1,Gourav Shenoy,2017-03-30 15:08:35-04:00,['f1e1fc28a305a14f0e7e28a7707308dd37dd05bd'],1,33,34,11505415,1,0,1,1,10270
610d456f76be927b978ceaa28e5df5b0aa37ba92,1,Gourav Shenoy,2017-03-30 15:25:51-04:00,['3d8c343f176937098ddd5c2b5f92d716df140587'],22,148,170,11505585,7,0,0.336538462,0.932692308,10270
8de4e2332368f4700e988f58a67518a21f2a9487,1,Gourav Shenoy,2017-03-31 01:39:08-04:00,['610d456f76be927b978ceaa28e5df5b0aa37ba92'],1608,2620,4228,11509813,5,0.644257703,0.861344538,0.988795518,10270
f8e7f132b458f3850dd4497c5b33a89867a15a66,0,Gourav Shenoy,2017-03-31 01:40:23-04:00,['8de4e2332368f4700e988f58a67518a21f2a9487'],1,1,2,11509815,1,,,,10270
2ec0e8f155f7417cd206132dd9045a1cb509a821,0,Gourav Shenoy,2017-03-31 01:41:46-04:00,['f8e7f132b458f3850dd4497c5b33a89867a15a66'],2,60,62,11509877,3,0.37037037,1,1,10271
570bc5d1b4c48483f61b0ff6cbc143f8b4c2b77d,1,Marcus Christie,2017-03-31 09:29:47-04:00,['b45bac667e89f246d85a0b1b76ce00e8d327ea55'],16,126,142,11510019,8,,,,10275
de5692c52901b059cf302a26c14cfc691fcad47c,0,Marcus Christie,2017-03-31 10:05:06-04:00,['570bc5d1b4c48483f61b0ff6cbc143f8b4c2b77d'],2,1,3,11510022,1,,,,10275
d581d4eb176a2357dd2b1a60fb2a0f9bc42f16d6,1,Gourav Shenoy,2017-03-31 13:50:02-04:00,['2ec0e8f155f7417cd206132dd9045a1cb509a821'],1,2,3,11510025,1,0,0,1,10275
06ec5552e23e05909225fabce469e31dcd8d4325,0,Gourav Shenoy,2017-03-31 14:18:58-04:00,['d581d4eb176a2357dd2b1a60fb2a0f9bc42f16d6'],7,10,17,11510042,2,1,1,1,10275
be2c9401ed3d62ac5d552fa438fa6dc7af1f519b,0,Gourav Shenoy,2017-04-02 20:25:09-04:00,['06ec5552e23e05909225fabce469e31dcd8d4325'],2,2,4,11510046,1,,,,10275
5100c07dbb4a40fd87337d3dc68380f851efe2b3,0,Suresh Marru,2017-04-03 05:50:05-04:00,"['de5692c52901b059cf302a26c14cfc691fcad47c', '9526e99b2aed47f4ab354ad3f8a1822db4f94627']",1,0,1,11510047,1,,,,10275
2ff3d63225ed264daeed6689c80b693b3b8d61f5,0,Ajinkya Dhamnaskar,2017-04-03 12:02:34-04:00,['be2c9401ed3d62ac5d552fa438fa6dc7af1f519b'],6,14,20,11510067,1,0,0,1,10275
394efe6a53d0c8d6b9e62491fd3afbea4bf370db,0,Ajinkya Dhamnaskar,2017-04-03 12:33:09-04:00,['2ff3d63225ed264daeed6689c80b693b3b8d61f5'],0,11,11,11510078,1,0,0,1,10275
b5b512542b730dd63ff27743b5a6f1423b8255b3,1,Ajinkya Dhamnaskar,2017-04-03 13:18:15-04:00,['394efe6a53d0c8d6b9e62491fd3afbea4bf370db'],1,2,3,11510081,1,1,1,1,10275
4efff281a2ee5213c64bc9eae492d450b4eae285,0,Ajinkya Dhamnaskar,2017-04-03 13:19:39-04:00,['b5b512542b730dd63ff27743b5a6f1423b8255b3'],0,55,55,11510136,1,0,0,1,10275
4ec282320f267729c9c8b7138667c092d8f98035,1,scnakandala,2017-04-03 13:48:59-04:00,['6bc536f5915f8f95bd956fa50e9d3fb36a026892'],0,302,302,11510438,5,0.331606218,0.777202073,0.89119171,10276
f0d833113d7a211d2d7344b30406a657515d5989,0,scnakandala,2017-04-03 13:49:53-04:00,['4ec282320f267729c9c8b7138667c092d8f98035'],5,0,5,11510443,1,0,0,0,10276
048a11babe3a078898eb723c6d3bd19a98a91af5,0,scnakandala,2017-04-03 13:50:15-04:00,"['f0d833113d7a211d2d7344b30406a657515d5989', '5100c07dbb4a40fd87337d3dc68380f851efe2b3']",42,208,250,11510693,19,,,,10276
c48a8ff490f80a3279f4df0577ee32c70ea05441,1,Gourav Shenoy,2017-04-03 14:12:17-04:00,['be2c9401ed3d62ac5d552fa438fa6dc7af1f519b'],5,38,43,11510736,2,0.833333333,0.833333333,1,10276
c231e53b572848fad6a4dccc68fa9219cae599f2,0,Gourav Shenoy,2017-04-03 14:12:24-04:00,"['c48a8ff490f80a3279f4df0577ee32c70ea05441', '4efff281a2ee5213c64bc9eae492d450b4eae285']",7,82,89,11510825,3,,,,10276
030468d3ad30b9fd1d11a9ff47b33c3fd93d43cb,0,Gourav Shenoy,2017-04-03 14:12:57-04:00,['c231e53b572848fad6a4dccc68fa9219cae599f2'],0,20,20,11510845,2,,,,10277
c14db5955e3fb9d8e190d02f48c15adf87e0d376,1,Gourav Shenoy,2017-04-03 16:08:59-04:00,['030468d3ad30b9fd1d11a9ff47b33c3fd93d43cb'],7,22,29,11510874,1,1,1,1,10277
5808332f3a3e3051a9e91451690d3e4ac5558f3b,0,Ajinkya Dhamnaskar,2017-04-03 16:10:08-04:00,['c14db5955e3fb9d8e190d02f48c15adf87e0d376'],12,14,26,11510900,1,1,1,0,10277
45ecfa357009aea47d47c4fa5ec1b6dcde031200,0,Gourav Shenoy,2017-04-03 16:15:52-04:00,['5808332f3a3e3051a9e91451690d3e4ac5558f3b'],4,4,8,11510908,1,,,,10277
d1792cc0d0c41c810b6778ec98977aa7c86d2a45,0,Ajinkya Dhamnaskar,2017-04-03 16:20:48-04:00,['45ecfa357009aea47d47c4fa5ec1b6dcde031200'],42,63,105,11511013,1,0,0,1,10277
a90e9bb156aad87eb7fa36906dc923b22cdf5238,1,Marcus Christie,2017-04-03 16:50:40-04:00,['5100c07dbb4a40fd87337d3dc68380f851efe2b3'],2,366,368,11511381,9,,,,10284
bacc2bf9e44c2625ede0e4163b48472e6138c099,0,Gourav Shenoy,2017-04-03 17:03:26-04:00,['d1792cc0d0c41c810b6778ec98977aa7c86d2a45'],2,2,4,11511385,1,,,,10284
0e9c08f17c7c590fef8fc39db9fe9a8a9860b673,0,Gourav Shenoy,2017-04-03 17:15:16-04:00,['bacc2bf9e44c2625ede0e4163b48472e6138c099'],3,3,6,11511391,2,,,,10284
6e5530c1465825aef82132bf0ab3e32183178560,0,Gourav Shenoy,2017-04-03 22:24:26-04:00,['0e9c08f17c7c590fef8fc39db9fe9a8a9860b673'],0,1683,1683,11513074,20,0.407692308,0.68,0.930769231,10302
7958a0f8b02345c5c4eaf69ce8eaa8fbddd05e6f,0,Suresh Marru,2017-04-04 07:27:49-04:00,['5100c07dbb4a40fd87337d3dc68380f851efe2b3'],7,11,18,11513092,1,,,,10302
71d67f1c753930f6018b0b8449f9c7b0568bc7db,0,Suresh Marru,2017-04-04 07:28:03-04:00,"['7958a0f8b02345c5c4eaf69ce8eaa8fbddd05e6f', 'a90e9bb156aad87eb7fa36906dc923b22cdf5238']",2,366,368,11513460,9,,,,10302
d82842ddcf8ae3a57e74db6fb48e872da8df0a27,0,Suresh Marru,2017-04-04 08:00:25-04:00,['71d67f1c753930f6018b0b8449f9c7b0568bc7db'],5804,10543,16347,11529807,1628,0.243243243,0.141891892,0.641891892,10302
83ea630684431b88ef6ba2e952140316f3dce56c,0,Suresh Marru,2017-04-04 08:18:27-04:00,['d82842ddcf8ae3a57e74db6fb48e872da8df0a27'],0,2,2,11529809,1,,,,10302
defbad3986acd769a3356bbf4448407a8f61aaa1,0,Marcus Christie,2017-04-04 09:41:47-04:00,['83ea630684431b88ef6ba2e952140316f3dce56c'],1,56,57,11529866,2,,,,10303
e440a966e08dd5a0301c6cb4c3d941c5acffbd0b,0,Marcus Christie,2017-04-04 10:30:36-04:00,['defbad3986acd769a3356bbf4448407a8f61aaa1'],0,1,1,11529867,1,,,,10303
2e90368a1a7d68d225b4059a0294ebaec11c211f,0,Suresh Marru,2017-04-04 11:35:25-04:00,['e440a966e08dd5a0301c6cb4c3d941c5acffbd0b'],161,4,165,11530032,10,0.756756757,0.858108108,0.358108108,10303
9e1958f457a461ecc033921c7631684b72016214,0,Suresh Marru,2017-04-04 12:39:08-04:00,['2e90368a1a7d68d225b4059a0294ebaec11c211f'],0,3,3,11530035,3,,,,10303
382e3cb482e78dd319bc1474b999c4de8b64801c,0,Marcus Christie,2017-04-04 14:13:09-04:00,['9e1958f457a461ecc033921c7631684b72016214'],2,1,3,11530038,1,,,,10303
30ab06f3efb945d5cf9d71fef026494b40a2fe47,0,scnakandala,2017-04-04 14:37:14-04:00,['048a11babe3a078898eb723c6d3bd19a98a91af5'],11,17,28,11530066,2,0,1,1,10303
41b61cfc3095cb2de4e308b6c036bbe720596743,0,Gourav Shenoy,2017-04-04 14:48:58-04:00,['6e5530c1465825aef82132bf0ab3e32183178560'],0,413,413,11530479,1,0.813852814,0.943722944,1,10304
66afcef6bc24f6a43b5d4e2f6f4c08492e80054d,0,Gourav Shenoy,2017-04-04 14:49:24-04:00,['41b61cfc3095cb2de4e308b6c036bbe720596743'],0,9,9,11530488,1,,,,10304
33388b42ef625bb6d1e178c38b36dd307cd8b8bb,0,Gourav Shenoy,2017-04-04 15:09:39-04:00,['66afcef6bc24f6a43b5d4e2f6f4c08492e80054d'],56,69,125,11530613,2,0,0.5,1,10304
2c16c71b7b9fbda59a06fb48dad48162a21dfd52,0,Gourav Shenoy,2017-04-04 15:21:28-04:00,['33388b42ef625bb6d1e178c38b36dd307cd8b8bb'],0,12,12,11530625,1,0,0,1,10304
7ba98fa399de6370d87537386bcfa7bbdaf183c6,0,Gourav Shenoy,2017-04-04 15:33:40-04:00,['2c16c71b7b9fbda59a06fb48dad48162a21dfd52'],13,17,30,11530655,2,0,1,1,10304
eff24f1f289d89e31a1d8675531a39dcc620a9ca,0,Gourav Shenoy,2017-04-04 15:37:59-04:00,['7ba98fa399de6370d87537386bcfa7bbdaf183c6'],1,1,2,11530657,1,,,,10304
de241d6cc524901554c500eefcd143909629d51b,0,Ajinkya Dhamnaskar,2017-04-04 15:44:54-04:00,['eff24f1f289d89e31a1d8675531a39dcc620a9ca'],7,11,18,11530675,1,,,,10304
9a3f1954c4ab29e547bc485ad59772703265a282,0,Ajinkya Dhamnaskar,2017-04-04 15:46:27-04:00,['de241d6cc524901554c500eefcd143909629d51b'],117,154,271,11530946,1,0,0,1,10304
f17d5f59ae113ad3b8be1c3900b3d0f3af9441a8,0,Gourav Shenoy,2017-04-04 16:28:00-04:00,['eff24f1f289d89e31a1d8675531a39dcc620a9ca'],91,662,753,11531699,7,0.098039216,0,0.901960784,10304
0869c47762850526a339fa1cb384256735cfdc7a,0,Gourav Shenoy,2017-04-04 16:28:10-04:00,"['f17d5f59ae113ad3b8be1c3900b3d0f3af9441a8', '9a3f1954c4ab29e547bc485ad59772703265a282']",124,165,289,11531988,2,,,,10304
a26520d5116781efe0c54c6ed3974d4b2f3e99e2,0,Gourav Shenoy,2017-04-04 16:33:06-04:00,['0869c47762850526a339fa1cb384256735cfdc7a'],21,257,278,11532266,4,0.097560976,0,0.902439024,10304
63206c9814113202c255666039b107d575941557,0,Ajinkya Dhamnaskar,2017-04-04 16:34:01-04:00,['a26520d5116781efe0c54c6ed3974d4b2f3e99e2'],4,4,8,11532274,1,,,,10304
e46bc75d972f2c7fe34e44427c18fd824a4a07f0,0,Gourav Shenoy,2017-04-04 16:34:21-04:00,['a26520d5116781efe0c54c6ed3974d4b2f3e99e2'],1,1,2,11532276,1,,,,10304
057e4e1a18b162fb60590a7696edf8983e4e0beb,0,Gourav Shenoy,2017-04-04 16:34:32-04:00,"['e46bc75d972f2c7fe34e44427c18fd824a4a07f0', '63206c9814113202c255666039b107d575941557']",4,4,8,11532284,1,,,,10304
5f2160d15d812feab3dbbf4291f30e49107145b8,0,Ajinkya Dhamnaskar,2017-04-04 16:40:29-04:00,['057e4e1a18b162fb60590a7696edf8983e4e0beb'],0,5,5,11532289,1,,,,10304
749a84d9b31383fb839ad71617b5d31425e65006,0,Marcus Christie,2017-04-04 16:41:17-04:00,['382e3cb482e78dd319bc1474b999c4de8b64801c'],9,29,38,11532327,5,,,,10304
ebd55e9296a6f39d1c415065325c84671972b626,0,Gourav Shenoy,2017-04-04 16:56:40-04:00,['5f2160d15d812feab3dbbf4291f30e49107145b8'],1,0,1,11532328,1,1,1,0,10304
ca9f938238fbbc79fc5ced5576fc580c49443f8f,0,Marcus Christie,2017-04-04 17:04:36-04:00,['749a84d9b31383fb839ad71617b5d31425e65006'],4,124,128,11532456,8,,,,10307
dc55333a6b4338de133fc2b4c45cfda8434f61d8,0,Marcus Christie,2017-04-05 09:36:38-04:00,['ca9f938238fbbc79fc5ced5576fc580c49443f8f'],0,1,1,11532457,1,,,,10307
2e6437a7e0f682cda8cfa10855ffabe8c957972c,0,Marcus Christie,2017-04-05 10:11:46-04:00,['dc55333a6b4338de133fc2b4c45cfda8434f61d8'],9,22,31,11532488,8,,,,10307
cda1172e515bdae731cbd35f2222280173d9308f,0,Marcus Christie,2017-04-05 10:46:13-04:00,['2e6437a7e0f682cda8cfa10855ffabe8c957972c'],2,10,12,11532500,3,,,,10307
aa0358c12acd5f08be0e02ad394ccaa045b9e7de,1,Gourav Shenoy,2017-04-05 11:53:25-04:00,['ebd55e9296a6f39d1c415065325c84671972b626'],1183,4407,5590,11538090,4,0.163272727,0.098545455,0.892,10307
e597eb5179e044384f6650af41aee8a60ce2d9ad,1,Gourav Shenoy,2017-04-05 11:56:45-04:00,['aa0358c12acd5f08be0e02ad394ccaa045b9e7de'],17,44,61,11538151,2,,,0,10307
e572553c2d507e72add87d244fce637c6c4bfad2,0,Gourav Shenoy,2017-04-05 11:57:44-04:00,['e597eb5179e044384f6650af41aee8a60ce2d9ad'],0,5,5,11538156,1,,,,10307
52dd9bb2637fc11e28242fd1d04552e7f2f55765,0,Gourav Shenoy,2017-04-05 12:02:11-04:00,['e572553c2d507e72add87d244fce637c6c4bfad2'],9,13,22,11538178,2,,,,10307
5bbecff37269ae5d0bb93f4602c89a5c86c465e3,1,Gourav Shenoy,2017-04-05 12:05:18-04:00,['52dd9bb2637fc11e28242fd1d04552e7f2f55765'],7,7,14,11538192,1,,,,10307
db000411a5abb3ec1eb91ffcc7f1265a182b9787,0,GitHub,2017-04-05 12:23:34-04:00,"['af39d44b2d0bef340399e45f8c7e27dd7b1a6bc1', '30ab06f3efb945d5cf9d71fef026494b40a2fe47']",7233,15088,22321,11560513,108,,,,10307
b156320b3d22c1f6fb9f6303e740796d437612a2,0,GitHub,2017-04-05 12:24:47-04:00,"['d1ae2642a586fed4f8b20c669668218f42f636d5', 'fa0c57b3df19436ae75b5e0ecf1f0f3d9e9f8c74']",23,18327,18350,11578863,58,,,,10307
5946869fde286fd5444ed289cf1f01e1b418eedc,0,Gourav Shenoy,2017-04-05 12:56:43-04:00,"['b156320b3d22c1f6fb9f6303e740796d437612a2', 'db000411a5abb3ec1eb91ffcc7f1265a182b9787']",7377,15264,22641,11601504,111,,,,10307
ecdacd4a185bc89d2c662afc4745581c5fc13183,0,Gourav Shenoy,2017-04-05 13:32:15-04:00,"['5946869fde286fd5444ed289cf1f01e1b418eedc', '5bbecff37269ae5d0bb93f4602c89a5c86c465e3']",3146,15490,18636,11620140,105,,,,10307
f682cac635a62df2f947983fb1e0a3952339fdb8,0,Gourav Shenoy,2017-04-05 13:52:26-04:00,['ecdacd4a185bc89d2c662afc4745581c5fc13183'],1,1,2,11620142,1,,,,10307
65c71cf04eac7d97b87b7f6ecc2c0d6374d83f82,0,Gourav Shenoy,2017-04-05 14:08:42-04:00,['f682cac635a62df2f947983fb1e0a3952339fdb8'],6,0,6,11620148,1,1,0,0,10307
837e24958b750f85f3dce01ddde937a0bd450568,0,Anuj Bhandar,2017-04-05 14:53:52-04:00,['5100c07dbb4a40fd87337d3dc68380f851efe2b3'],0,690,690,11620838,8,,,,10313
4eb4bc37bf56d42c51b571827fa02beb804c0373,0,scnakandala,2017-04-05 15:10:07-04:00,['65c71cf04eac7d97b87b7f6ecc2c0d6374d83f82'],3,1,4,11620842,2,,,,10313
67eed40b9a56db71d45f18b23384da0ea14e9199,0,Marcus Christie,2017-04-05 16:05:58-04:00,['cda1172e515bdae731cbd35f2222280173d9308f'],6,138,144,11620986,7,,,,10317
22e979857078313c3dfdb53da52241a1e491a9a5,0,Marcus Christie,2017-04-05 16:55:54-04:00,['67eed40b9a56db71d45f18b23384da0ea14e9199'],10,95,105,11621091,5,,,,10319
7f8272db47f123f1e03f6e871cfd06a37325ed20,0,Marcus Christie,2017-04-06 17:06:26-04:00,['22e979857078313c3dfdb53da52241a1e491a9a5'],4,456,460,11621551,16,,,,10331
1bf6e77e992f0cc25616bdedebf3314136054d3a,0,Marcus Christie,2017-04-07 13:30:08-04:00,['7f8272db47f123f1e03f6e871cfd06a37325ed20'],6,523,529,11622080,16,,,,10345
6c38ebb3e4989fcd65f227569753a3819beedb30,0,Marcus Christie,2017-04-10 11:45:57-04:00,['4eb4bc37bf56d42c51b571827fa02beb804c0373'],3,3,6,11622086,1,0,0,1,10345
fc9b8f23cdb1d618862d90360f4e0401a91fe891,0,Gourav Shenoy,2017-04-10 14:02:46-04:00,['1bf6e77e992f0cc25616bdedebf3314136054d3a'],0,11,11,11622097,1,,,,10345
ab6d02dc423b165705b8ec23388c43c1fcdadcce,0,Ajinkya Dhamnaskar,2017-04-11 13:00:11-04:00,['fc9b8f23cdb1d618862d90360f4e0401a91fe891'],0,11,11,11622108,1,,,,10345
9578e5c3d32d01eb1c455c248275696a6856f430,0,Marcus Christie,2017-04-11 17:17:25-04:00,['ab6d02dc423b165705b8ec23388c43c1fcdadcce'],82,23,105,11622213,19,,,,10345
dca8e1431a80c20178c2ea2b1a33cea26eeaa27c,1,Marcus Christie,2017-04-11 17:17:25-04:00,['9578e5c3d32d01eb1c455c248275696a6856f430'],72,48,120,11622333,3,,,,10345
3a963d7364aa24d84f7c4a17acc13bfc54951c00,0,Anuj Bhandar,2017-04-13 13:50:55-04:00,['837e24958b750f85f3dce01ddde937a0bd450568'],29,762,791,11623124,14,,,,10351
dc24945af0f8c91d3fa68fc1886bf60f4f5a583b,0,Marcus Christie,2017-04-15 14:57:21-04:00,['dca8e1431a80c20178c2ea2b1a33cea26eeaa27c'],22,53,75,11623199,2,,,,10351
dd5e9c1c332bfb5266b79c9cac2cf51f94ce6564,0,Marcus Christie,2017-04-18 14:30:50-04:00,['dc24945af0f8c91d3fa68fc1886bf60f4f5a583b'],1,1,2,11623201,1,,,,10351
82e39d8f954fea56f2fe2f7a987959f2cadc21be,0,Marcus Christie,2017-04-19 11:53:02-04:00,['dd5e9c1c332bfb5266b79c9cac2cf51f94ce6564'],2,2,4,11623205,2,,,,10351
8be77fd37de62753df984a05d3591f4584b7f6d6,0,Marcus Christie,2017-04-19 13:56:16-04:00,['82e39d8f954fea56f2fe2f7a987959f2cadc21be'],0,1,1,11623206,1,,,,10351
2afa065f964a430b9c626e1da7b1d5a0ff8cf5d0,1,scnakandala,2017-04-20 14:01:17-04:00,['6c38ebb3e4989fcd65f227569753a3819beedb30'],0,49,49,11623255,3,0,0.052631579,0.052631579,10351
803d5ea891c4871281f592192684990e6a264778,1,scnakandala,2017-04-20 14:21:45-04:00,['2afa065f964a430b9c626e1da7b1d5a0ff8cf5d0'],253,1721,1974,11625229,5,0.478139535,0.601860465,0.946046512,10351
64fb9df0f81b730e6dbb70ee5a21740a02699261,1,Marcus Christie,2017-04-21 11:46:24-04:00,['8be77fd37de62753df984a05d3591f4584b7f6d6'],1,16,17,11625246,1,,,,10351
eadbdba5be540557efd67645d109eded756054d0,0,Marcus Christie,2017-04-21 12:10:42-04:00,['64fb9df0f81b730e6dbb70ee5a21740a02699261'],0,1,1,11625247,1,1,1,1,10351
2923dd2769aa0e24a99299ab98476905d6d4505e,0,scnakandala,2017-04-21 21:38:55-04:00,['803d5ea891c4871281f592192684990e6a264778'],2,26,28,11625275,7,1,1,1,10351
e3009f5f3e010a0859625328a321dc56301afac4,0,scnakandala,2017-04-21 22:05:58-04:00,['eadbdba5be540557efd67645d109eded756054d0'],2,26,28,11625303,7,1,1,1,10351
65bb9867213615891957906c414a4a4f08c26c64,0,Anuj Bhandar,2017-04-23 23:29:58-04:00,['2923dd2769aa0e24a99299ab98476905d6d4505e'],0,3049,3049,11628352,10,0.592649311,0.735579377,0.977539561,10358
d365175655fd332620fb127dcad03dec2a641d14,0,Marcus Christie,2017-04-24 15:40:28-04:00,['2923dd2769aa0e24a99299ab98476905d6d4505e'],12,14,26,11628378,7,,,,10358
f4c5d67666f20b7a3f5090bca5666ad79b55b2dc,0,Marcus Christie,2017-04-24 15:40:40-04:00,"['d365175655fd332620fb127dcad03dec2a641d14', '3a963d7364aa24d84f7c4a17acc13bfc54951c00']",1,1424,1425,11629803,16,,,,10358
05d39e522a35baa2b3b760fd058ca355c572101c,0,Suresh Marru,2017-04-25 13:00:15-04:00,['e3009f5f3e010a0859625328a321dc56301afac4'],1,4,5,11629808,2,,,,10358
e74625d166b76629223502c8167460aeb4983fa6,0,Suresh Marru,2017-04-25 13:07:42-04:00,['05d39e522a35baa2b3b760fd058ca355c572101c'],4,4,8,11629816,1,,,,10358
af6ca9a78f9a39f2e3506ebf5673daedacc1700d,1,Marcus Christie,2017-04-25 14:52:58-04:00,['e74625d166b76629223502c8167460aeb4983fa6'],2,150,152,11629968,7,,,,10361
00efec7ec967a6a7b0e89fa7fec5d58c91e2e72e,0,Marcus Christie,2017-04-25 14:52:58-04:00,['af6ca9a78f9a39f2e3506ebf5673daedacc1700d'],27,14,41,11630009,3,,,,10361
2cf1e9a6984c1a728d643ac3d656f21bfb3ed7cd,0,Marcus Christie,2017-04-25 14:52:58-04:00,['00efec7ec967a6a7b0e89fa7fec5d58c91e2e72e'],2,2,4,11630013,1,,,,10361
950309c9f2a81371a5b2d9e64f9917dd4e02d317,0,Marcus Christie,2017-04-25 14:52:58-04:00,['2cf1e9a6984c1a728d643ac3d656f21bfb3ed7cd'],0,6,6,11630019,2,,,,10361
17941979ff345e01eb8fac8d0399aed43863847e,0,Marcus Christie,2017-04-25 14:52:58-04:00,['950309c9f2a81371a5b2d9e64f9917dd4e02d317'],31,16,47,11630066,16,,,,10361
cad84183ef2b0dfd15e570aaa7f29922ae4ea270,1,Marcus Christie,2017-04-25 14:52:58-04:00,['17941979ff345e01eb8fac8d0399aed43863847e'],1,5,6,11630072,2,,,,10361
156588192a0d9cf1f40c26801d08ce0456f98148,0,Marcus Christie,2017-04-25 16:02:18-04:00,['cad84183ef2b0dfd15e570aaa7f29922ae4ea270'],3,7,10,11630082,1,,,,10361
2fb19efccf804f4710cedcb1dad891e3cc9c4170,1,scnakandala,2017-04-25 17:20:39-04:00,['156588192a0d9cf1f40c26801d08ce0456f98148'],0,4,4,11630086,1,0,0,0,10361
f8e55d34576d5d7c6afbd0848daf05841defb361,0,Marcus Christie,2017-04-26 10:31:45-04:00,['2fb19efccf804f4710cedcb1dad891e3cc9c4170'],4,120,124,11630210,7,,,,10364
57cb2aef858c2216114a5733c8a241d912ef5969,0,Marcus Christie,2017-04-26 13:39:07-04:00,['f8e55d34576d5d7c6afbd0848daf05841defb361'],0,1,1,11630211,1,,,,10364
c99687f993992c402cb722acc2237b02245509b5,0,Marcus Christie,2017-04-26 14:16:40-04:00,['57cb2aef858c2216114a5733c8a241d912ef5969'],2,82,84,11630295,3,,,,10366
6791f289e0c02956bcfc41913da332b570a7d673,0,Marcus Christie,2017-04-26 14:53:26-04:00,['c99687f993992c402cb722acc2237b02245509b5'],1,5,6,11630301,4,,,,10366
056ae0a97f8c02d6e89294e77142ba2f79a2c4b8,0,Suresh Marru,2017-04-27 09:23:36-04:00,['6791f289e0c02956bcfc41913da332b570a7d673'],4,4,8,11630309,2,,,,10366
b37882a4372c2fc18493737264a105162bf673b6,0,Marcus Christie,2017-04-27 11:15:22-04:00,['f4c5d67666f20b7a3f5090bca5666ad79b55b2dc'],15,16,31,11630340,1,,,,10366
b6312d9aa5a164490f744545414f8e05c2093680,0,Suresh Marru,2017-04-27 13:05:15-04:00,['056ae0a97f8c02d6e89294e77142ba2f79a2c4b8'],1,5,6,11630346,1,,,,10366
4d497987ad58aa5fad2ed0346be7224520bc097d,0,Anuj Bhandar,2017-04-27 13:56:40-04:00,['65bb9867213615891957906c414a4a4f08c26c64'],3,453,456,11630802,10,0.103053435,0.801526718,0.839694656,10369
e0fbdeb0ea80005ae03c5527ffa28b582b4105e5,0,Anuj Bhandar,2017-04-27 14:03:26-04:00,['4d497987ad58aa5fad2ed0346be7224520bc097d'],22,2440,2462,11633264,2,0.522354273,0.707413696,0.971703452,10369
28ab7a4f46bdefdd0a556aa13c0518e841533850,0,Anuj Bhandar,2017-04-27 14:49:09-04:00,['e0fbdeb0ea80005ae03c5527ffa28b582b4105e5'],10,50,60,11633324,3,1,1,0,10369
43c6736bd07b9420f0d9bc4c5d7f0da389ac0ace,1,scnakandala,2017-04-27 14:51:54-04:00,['2fb19efccf804f4710cedcb1dad891e3cc9c4170'],2,3,5,11633329,1,,,,10369
be5ef40fdbe1a144bf89a68b934e11ff573dba83,0,scnakandala,2017-04-27 14:52:01-04:00,['43c6736bd07b9420f0d9bc4c5d7f0da389ac0ace'],1,1,2,11633331,1,0,0,1,10369
e48a02eaf8e81f209ae7291c3e01d30fd445e5b1,0,scnakandala,2017-04-27 14:52:38-04:00,"['be5ef40fdbe1a144bf89a68b934e11ff573dba83', 'b6312d9aa5a164490f744545414f8e05c2093680']",12,217,229,11633560,13,,,,10369
4407f82c3ad320b24a31f3bf611208ce22b140dd,0,Marcus Christie,2017-04-27 14:56:40-04:00,['e48a02eaf8e81f209ae7291c3e01d30fd445e5b1'],1,1,2,11633562,1,1,1,0,10369
94f8748df85ccfc9d46a383d0a25c994d55f4b88,1,Anuj Bhandar,2017-04-27 15:22:54-04:00,['b37882a4372c2fc18493737264a105162bf673b6'],0,3049,3049,11636611,10,0.592649311,0.735579377,0.977539561,10376
1a977c06cfefcf545edb550d0dd05dd872ce0453,1,Anuj Bhandar,2017-04-27 15:22:54-04:00,['94f8748df85ccfc9d46a383d0a25c994d55f4b88'],3,453,456,11637067,10,0.103053435,0.801526718,0.839694656,10379
2190091134ed776296da82204d085ac61539b103,1,Anuj Bhandar,2017-04-27 15:22:54-04:00,['1a977c06cfefcf545edb550d0dd05dd872ce0453'],22,2440,2462,11639529,2,0.522354273,0.707413696,0.971703452,10379
ea0f1fad4aa60ccaae49efe74e3a812e719b200b,1,Anuj Bhandar,2017-04-27 15:22:54-04:00,['2190091134ed776296da82204d085ac61539b103'],10,50,60,11639589,3,1,1,0,10379
e478ba68fd8190ab4cd7e1b2acd5a7d06864da9f,1,Anuj Bhandar,2017-04-27 15:22:54-04:00,['ea0f1fad4aa60ccaae49efe74e3a812e719b200b'],49,522,571,11640160,4,0.140540541,0,0.794594595,10379
63a797b7b1857ac81d0271b953a10da9b2729f1c,0,Anuj Bhandar,2017-04-27 15:28:14-04:00,"['e478ba68fd8190ab4cd7e1b2acd5a7d06864da9f', '28ab7a4f46bdefdd0a556aa13c0518e841533850']",2,1,3,11640163,2,,,,10379
a9073175fca796df2a22e07ca1a89e7b20ea7391,0,Suresh Marru,2017-04-27 17:04:43-04:00,['4407f82c3ad320b24a31f3bf611208ce22b140dd'],1,1,2,11640165,1,,,,10379
10d7c029ae0bfcda0a2f78b2bd0e015fb59b9721,0,Marcus Christie,2017-04-28 10:57:03-04:00,['a9073175fca796df2a22e07ca1a89e7b20ea7391'],0,11,11,11640176,2,,,,10380
7a779933e7e6b89d722f11ef5c80026210e63dd1,0,Marcus Christie,2017-04-28 11:20:49-04:00,"['b37882a4372c2fc18493737264a105162bf673b6', '10d7c029ae0bfcda0a2f78b2bd0e015fb59b9721']",5992,12712,18704,11658880,1679,,,,10380
b6fb0b98d146951df5caa975b6d641a0b90fa7ef,0,Marcus Christie,2017-04-28 11:35:45-04:00,['10d7c029ae0bfcda0a2f78b2bd0e015fb59b9721'],1,4,5,11658885,2,,,,10380
beb3b43e1d33794e0d62c61ae9259505cf4a2733,0,Marcus Christie,2017-04-29 19:10:26-04:00,['b6fb0b98d146951df5caa975b6d641a0b90fa7ef'],0,1,1,11658886,1,,,,10380
8327c29f036ebcc93bc3f3616756c67bb36b7341,0,Anuj Bhandar,2017-05-01 15:29:27-04:00,['7a779933e7e6b89d722f11ef5c80026210e63dd1'],12,318,330,11659216,11,0.413580247,0.413580247,0.932098765,10386
ec35622d02a970a31dfe47c4b13312665143167d,0,Anuj Bhandar,2017-05-01 15:31:37-04:00,['8327c29f036ebcc93bc3f3616756c67bb36b7341'],212,76,288,11659504,9,0,1,0,10386
161680df9675a92ae7e3fbfc616187801beb4f46,0,Anuj Bhandar,2017-05-01 15:31:37-04:00,['ec35622d02a970a31dfe47c4b13312665143167d'],0,129,129,11659633,1,,,,10387
7d97f7340539968057196082395d14f5c616a24c,0,Anuj Bhandar,2017-05-01 15:31:37-04:00,['161680df9675a92ae7e3fbfc616187801beb4f46'],192,0,192,11659825,1,0.791666667,0.791666667,0,10387
a97bb13b5bd773376a871d4bab292863f3eea51b,0,Marcus Christie,2017-05-01 18:42:19-04:00,['beb3b43e1d33794e0d62c61ae9259505cf4a2733'],1,1,2,11659827,1,,,,10387
686d8e30a76ad06b96ab9232933a6579126398ad,1,Anuj Bhandar,2017-05-01 20:35:56-04:00,['63a797b7b1857ac81d0271b953a10da9b2729f1c'],19,3186,3205,11663032,7,0.424697539,0.562369629,0.917396746,10387
96bdea2d043ab19a9b1d4f3762a4ca3086f9e1c0,0,Anuj Bhandar,2017-05-01 20:45:48-04:00,['686d8e30a76ad06b96ab9232933a6579126398ad'],0,12,12,11663044,1,0,1,1,10387
24f8b7f0f23a098babac6b1017c8b9bce67f71f2,0,Marcus Christie,2017-05-02 09:24:26-04:00,['a97bb13b5bd773376a871d4bab292863f3eea51b'],2,5,7,11663051,3,,,,10387
45e8f654a4bab789e272dda86d62f1969c11e227,0,Marcus Christie,2017-05-02 09:39:21-04:00,['24f8b7f0f23a098babac6b1017c8b9bce67f71f2'],1,143,144,11663195,8,,,,10391
269d2aeb7923d9edb4f6666bf80a1cc49c398d21,0,Marcus Christie,2017-05-02 12:02:04-04:00,['7d97f7340539968057196082395d14f5c616a24c'],4,9,13,11663208,1,0,1,1,10391
64b55702d4db791af3b1ffa0db5ad4932d6f2932,0,Marcus Christie,2017-05-02 12:30:55-04:00,['45e8f654a4bab789e272dda86d62f1969c11e227'],1,1,2,11663210,1,,,,10391
66c20986824a49a918cc64e7b79738e29faf1eba,0,Anuj Bhandar,2017-05-02 12:47:14-04:00,"['269d2aeb7923d9edb4f6666bf80a1cc49c398d21', '96bdea2d043ab19a9b1d4f3762a4ca3086f9e1c0']",1,9609,9610,11672820,17,,,,10391
538135f3a3ee0639accd62055a6ecfb38bfc1eb5,0,Marcus Christie,2017-05-02 12:57:42-04:00,['66c20986824a49a918cc64e7b79738e29faf1eba'],1,1,2,11672822,1,,,,10391
28709245bb933dac13570c95cac276cd873d71ee,0,scnakandala,2017-05-02 13:44:56-04:00,['538135f3a3ee0639accd62055a6ecfb38bfc1eb5'],9929,1,9930,11682752,28,0.367433513,0.179148311,0.024473813,10391
f52352760c01dd1c58e3e5298c14002b2b52dfa7,0,scnakandala,2017-05-02 13:53:59-04:00,['28709245bb933dac13570c95cac276cd873d71ee'],1593,17,1610,11684362,21,0.592307692,0.32,0.069230769,10391
7699ea0818291497542a3b8abb1ed5cd0057201d,0,Marcus Christie,2017-05-02 14:04:08-04:00,['54e640cd16c71cfbe86076f8706f055397c4b5c1'],1,4,5,11684367,2,,,,10391
703c853777c135bccdce03f2fd0e22807b9b3346,1,Marcus Christie,2017-05-02 14:04:08-04:00,['7699ea0818291497542a3b8abb1ed5cd0057201d'],30,29,59,11684426,7,,,,10391
f46b19e0a85a18ca9980441761e70c3507719d3f,1,Marcus Christie,2017-05-02 14:04:08-04:00,['703c853777c135bccdce03f2fd0e22807b9b3346'],2,2,4,11684430,2,,,,10391
d81d3ad23bc134774916698cda95878752ac58cf,1,Marcus Christie,2017-05-02 14:04:08-04:00,['f46b19e0a85a18ca9980441761e70c3507719d3f'],15,12,27,11684457,3,,,,10391
81a5f2bcfe2ef4bd6d97a30524a74f17d9b253d2,0,Marcus Christie,2017-05-02 14:04:08-04:00,['d81d3ad23bc134774916698cda95878752ac58cf'],12,289,301,11684758,6,,,,10392
54e640cd16c71cfbe86076f8706f055397c4b5c1,0,scnakandala,2017-05-02 14:04:10-04:00,['f52352760c01dd1c58e3e5298c14002b2b52dfa7'],2,1,3,11684761,1,,,,10392
57dc7672e43cb433ba0cae1d1db7519441c20a07,1,Marcus Christie,2017-05-02 15:55:39-04:00,['81a5f2bcfe2ef4bd6d97a30524a74f17d9b253d2'],2,31,33,11684794,5,,,,10392
ddb95c1222247e5dbeebd1dff1335cd5228b9b96,0,Gourav Shenoy,2017-05-02 15:58:25-04:00,['81a5f2bcfe2ef4bd6d97a30524a74f17d9b253d2'],13975,28413,42388,11727182,197,0.252614718,0.292754169,0.901912749,10411
9fab6277660e6e6a889e734f487449a757237825,0,Gourav Shenoy,2017-05-02 15:58:37-04:00,"['ddb95c1222247e5dbeebd1dff1335cd5228b9b96', '57dc7672e43cb433ba0cae1d1db7519441c20a07']",2,31,33,11727215,5,,,,10411
d37c9d2ff004bf51caee598d3513d0c936839089,1,Gourav Shenoy,2017-05-02 16:00:55-04:00,['9fab6277660e6e6a889e734f487449a757237825'],4,4,8,11727223,1,0,1,0,10411
3dae7048eff00f6f92ad988e52a7f12f29d2c357,0,scnakandala,2017-05-02 16:30:37-04:00,['54e640cd16c71cfbe86076f8706f055397c4b5c1'],0,1,1,11727224,1,,,,10411
93e18115751e3ca1c6bd04fa6f0e12a20012471e,0,scnakandala,2017-05-02 16:30:45-04:00,"['3dae7048eff00f6f92ad988e52a7f12f29d2c357', 'd37c9d2ff004bf51caee598d3513d0c936839089']",14038,28781,42819,11770043,214,,,,10411
b5984b0962b3248f028dd7a72821f3ce60d576c2,0,Marcus Christie,2017-05-02 16:33:01-04:00,['93e18115751e3ca1c6bd04fa6f0e12a20012471e'],8,3,11,11770054,2,,,,10411
e6eb0c973bdfdb86762382130941ead5407ff60e,0,scnakandala,2017-05-02 16:43:40-04:00,['93e18115751e3ca1c6bd04fa6f0e12a20012471e'],44,17,61,11770115,3,0,0,0,10411
4b0a9ecb9ccf34757602dd2d7c7f1156ec4aeac7,0,scnakandala,2017-05-02 16:43:47-04:00,"['e6eb0c973bdfdb86762382130941ead5407ff60e', 'b5984b0962b3248f028dd7a72821f3ce60d576c2']",8,3,11,11770126,2,,,,10411
5303a357fe3bb7ac6e9559d8842fea88203d96fe,1,Marcus Christie,2017-05-02 17:16:44-04:00,['4b0a9ecb9ccf34757602dd2d7c7f1156ec4aeac7'],4,4,8,11770134,1,,,,10411
a61aab4236bffe15d0a2e740407173f47bb57638,0,Marcus Christie,2017-05-03 11:53:06-04:00,['64b55702d4db791af3b1ffa0db5ad4932d6f2932'],3,2,5,11770139,1,,,,10411
868fc55811bea98c849b682fd687c062f71e3dc5,0,Marcus Christie,2017-05-03 11:56:38-04:00,['a61aab4236bffe15d0a2e740407173f47bb57638'],113,0,113,11770252,4,,,,10411
0fcce5651aab0ab845bd5af2608895e9c915f1f0,0,scnakandala,2017-05-03 16:04:16-04:00,['5303a357fe3bb7ac6e9559d8842fea88203d96fe'],10,87,97,11770349,5,0.75,0.75,0.25,10411
04abb1e45a0d902dd73394404fdb980817a4da9d,0,scnakandala,2017-05-03 16:57:37-04:00,['0fcce5651aab0ab845bd5af2608895e9c915f1f0'],11,17,28,11770377,1,0,0,1,10411
7027f44b08f2589747bc62141ea1bad2084c5e1c,0,scnakandala,2017-05-03 17:05:03-04:00,['04abb1e45a0d902dd73394404fdb980817a4da9d'],1,2,3,11770380,1,0,0,1,10411
1108b57c961ad2ffd684ed4bef6a8e7f84bf7088,0,scnakandala,2017-05-03 17:19:16-04:00,['868fc55811bea98c849b682fd687c062f71e3dc5'],10,87,97,11770477,5,0.75,0.75,0.25,10411
010b133a251c637297305d12462cac8b8e229087,0,scnakandala,2017-05-03 17:19:25-04:00,['1108b57c961ad2ffd684ed4bef6a8e7f84bf7088'],11,17,28,11770505,1,0,0,1,10411
a76825caf5d89b836e2f9e049f295fd45766d6e5,0,scnakandala,2017-05-03 17:19:34-04:00,['010b133a251c637297305d12462cac8b8e229087'],1,2,3,11770508,1,0,0,1,10411
3a82e021965edb5461d48d6e3d619dee86d9d9bd,0,Marcus Christie,2017-05-03 17:20:38-04:00,['a76825caf5d89b836e2f9e049f295fd45766d6e5'],0,216,216,11770724,1,,,,10412
2265cbe6f891de6153d879b924957ed42f708ef6,0,Marcus Christie,2017-05-04 10:22:53-04:00,['3a82e021965edb5461d48d6e3d619dee86d9d9bd'],1,18,19,11770743,5,,,,10412
0710b1c258f66c8937f652acf15763a9824ed4ce,0,Marcus Christie,2017-05-04 13:57:16-04:00,['7027f44b08f2589747bc62141ea1bad2084c5e1c'],2,9,11,11770754,3,,,,10412
3f404315179fb61591123d6f133f4db5d157a876,1,Marcus Christie,2017-05-04 14:43:26-04:00,['0710b1c258f66c8937f652acf15763a9824ed4ce'],0,2,2,11770756,1,,,,10412
d0f3f5c912e4ae78cf342f07d27401e9a060ee69,0,Marcus Christie,2017-05-04 16:46:10-04:00,['3f404315179fb61591123d6f133f4db5d157a876'],0,13,13,11770769,1,,,,10412
f5a4e9dd574b2dafa6a070951f6f6cd5f3fa1b20,1,Gourav Shenoy,2017-05-08 13:58:26-04:00,['d0f3f5c912e4ae78cf342f07d27401e9a060ee69'],3324,306,3630,11774399,16,0.551648352,0.502417582,0.055824176,10412
317bece97ae162e797eda1b3ce3d63535ae6a5a8,0,Marcus Christie,2017-05-09 10:39:32-04:00,['2265cbe6f891de6153d879b924957ed42f708ef6'],0,23,23,11774422,3,,,,10413
b1ed4caacbfe5b24fab48b778553e2e8fc5cd734,1,Gourav Shenoy,2017-05-09 12:26:30-04:00,['f5a4e9dd574b2dafa6a070951f6f6cd5f3fa1b20'],13,57,70,11774492,6,0.851851852,1,1,10413
31a67053d4f83fc9ff10e3d64c12f6da63ffd1aa,0,Marcus Christie,2017-05-09 12:29:28-04:00,['45e8f654a4bab789e272dda86d62f1969c11e227'],1,1,2,11774494,1,,,,10413
44f9493e696b85033f1b4455be1d699e97e7abfc,0,Marcus Christie,2017-05-09 12:30:52-04:00,"['b1ed4caacbfe5b24fab48b778553e2e8fc5cd734', '31a67053d4f83fc9ff10e3d64c12f6da63ffd1aa']",5,151,156,11774650,12,,,,10413
9ef08205c1f030b9252177c2076b310a16f1764c,0,Marcus Christie,2017-05-09 12:39:59-04:00,['31a67053d4f83fc9ff10e3d64c12f6da63ffd1aa'],2,6,8,11774658,2,1,1,1,10413
7b48f15144022a9dba850d1e9ad77ff098efe8f3,0,Marcus Christie,2017-05-09 13:10:14-04:00,['9ef08205c1f030b9252177c2076b310a16f1764c'],0,6,6,11774664,1,0,0,1,10413
a1c3e83eb63774d2d33c3ff84dabda44ebc8935e,0,Marcus Christie,2017-05-09 13:11:07-04:00,"['44f9493e696b85033f1b4455be1d699e97e7abfc', '7b48f15144022a9dba850d1e9ad77ff098efe8f3']",2,12,14,11774678,3,,,,10413
8310de563407a285da5c309585c30fe07416671d,0,Marcus Christie,2017-05-09 13:30:38-04:00,"['317bece97ae162e797eda1b3ce3d63535ae6a5a8', '7b48f15144022a9dba850d1e9ad77ff098efe8f3']",3,13,16,11774694,3,,,,10413
5f8d5c6acd9d9bfc5c2d3e241ad684a230020796,0,Marcus Christie,2017-05-11 10:51:19-04:00,['a1c3e83eb63774d2d33c3ff84dabda44ebc8935e'],21,21,42,11774736,3,,,,10413
e1a9ab48529d998b09b310ad15427efa2587df8f,0,Marcus Christie,2017-05-11 10:55:03-04:00,['5f8d5c6acd9d9bfc5c2d3e241ad684a230020796'],3,3,6,11774742,3,,,,10413
e65d9d7362b9d3c54b22c5839ede2f18ec0f15de,0,Suresh Marru,2017-05-11 12:48:44-04:00,['8310de563407a285da5c309585c30fe07416671d'],0,74,74,11774816,3,,,,10415
940e0baed816df7ede6f736915bf2937599d6534,0,Gourav Shenoy,2017-05-11 13:55:53-04:00,['e1a9ab48529d998b09b310ad15427efa2587df8f'],6,9,15,11774831,1,0,1,1,10415
58ea1bfe780d7aaf34cabf886ca298d5e9b1c8ee,1,Marcus Christie,2017-05-12 16:40:37-04:00,['940e0baed816df7ede6f736915bf2937599d6534'],178,178,356,11775187,6,1,0.363636364,0,10415
56bc4bee230fb3ba84d26d8965190c5ecfe1c66f,1,scnakandala,2017-05-15 01:31:44-04:00,['58ea1bfe780d7aaf34cabf886ca298d5e9b1c8ee'],1742,1169,2911,11778098,29,0.873096447,0.779187817,0.461928934,10415
e988672bce256cdc650f90d0f8000f0b154fda98,1,scnakandala,2017-05-15 10:49:45-04:00,['56bc4bee230fb3ba84d26d8965190c5ecfe1c66f'],0,16,16,11778114,3,0,0.5625,1,10415
9f57e1f3d03d14423d142ee64c0815b6721d2e4e,0,Ajinkya Dhamnaskar,2017-05-17 13:59:04-04:00,"['7177cac6b247a525ee2a56bbe461e521134aba50', 'e988672bce256cdc650f90d0f8000f0b154fda98']",57054,127652,184706,11962820,1747,,,,10415
aa68a44a5c7f25cb554ade1e8a79bba28c155511,0,Ajinkya Dhamnaskar,2017-05-17 14:12:27-04:00,['9f57e1f3d03d14423d142ee64c0815b6721d2e4e'],5,0,5,11962825,1,,,,10415
1cfda99ec345694c0115bdbed9432f7b47778015,0,Ajinkya Dhamnaskar,2017-05-17 14:13:17-04:00,['aa68a44a5c7f25cb554ade1e8a79bba28c155511'],5,0,5,11962830,1,,,,10415
78a3cafce78a0810b9c282419f420426e5cb18ff,0,Ajinkya Dhamnaskar,2017-05-17 14:13:59-04:00,['1cfda99ec345694c0115bdbed9432f7b47778015'],1,1,2,11962832,1,,,,10415
846220595f111a9edd83076648e728be6e460fb4,0,Ajinkya Dhamnaskar,2017-05-17 14:14:23-04:00,['78a3cafce78a0810b9c282419f420426e5cb18ff'],10,9,19,11962851,2,,,,10415
706e01d8d6039f2e8c98771dffbf092d44c6a8b7,0,Ajinkya Dhamnaskar,2017-05-17 14:55:52-04:00,['846220595f111a9edd83076648e728be6e460fb4'],1,0,1,11962852,1,,,,10415
11f12dfc2e490f49f03d4f642bf1b3c17cd830c0,1,scnakandala,2017-05-22 11:30:29-04:00,['e988672bce256cdc650f90d0f8000f0b154fda98'],114,505,619,11963471,13,0,0.316770186,0.99378882,10415
d71c2aa8f3091c385241419f8254486a968923d4,0,scnakandala,2017-05-22 12:17:50-04:00,"['11f12dfc2e490f49f03d4f642bf1b3c17cd830c0', '706e01d8d6039f2e8c98771dffbf092d44c6a8b7']",22,10,32,11963503,5,,,,10415
f19cc0cd9adf587d67c4245cf27dd1535c6d5332,1,Marcus Christie,2017-05-22 15:28:28-04:00,['d71c2aa8f3091c385241419f8254486a968923d4'],1,14,15,11963518,1,1,1,1,10415
f6f2adc5aaf93cec7f64850be0dcc4aecc6c4aeb,0,Marcus Christie,2017-05-22 16:05:16-04:00,['e65d9d7362b9d3c54b22c5839ede2f18ec0f15de'],3,5,8,11963526,1,,,,10415
701f36a7a138753ae944a63a2f11b8f89825a3c9,0,Marcus Christie,2017-05-22 16:08:48-04:00,"['f19cc0cd9adf587d67c4245cf27dd1535c6d5332', 'f6f2adc5aaf93cec7f64850be0dcc4aecc6c4aeb']",79,297,376,11963902,16,,,,10415
cb27490d668460afbbbef2953077e9121867f997,1,scnakandala,2017-05-23 15:45:48-04:00,['701f36a7a138753ae944a63a2f11b8f89825a3c9'],2343,2985,5328,11969230,27,0.547505938,0.763657957,0.983372922,10415
0a6afd12e8f5a6f2be9e9e6e8b85bb7efc51eff4,0,scnakandala,2017-05-23 15:53:37-04:00,['cb27490d668460afbbbef2953077e9121867f997'],0,398,398,11969628,1,0.814655172,0.943965517,1,10416
0eda7d202c68bc64caa876a888b92e035d9ebcef,1,Marcus Christie,2017-05-23 16:57:50-04:00,['0a6afd12e8f5a6f2be9e9e6e8b85bb7efc51eff4'],22,56,78,11969706,2,0.136363636,1,0.454545455,10416
ff0ccae998a3a289df76afe31220cde126ba1795,0,Marcus Christie,2017-05-24 11:33:48-04:00,['0eda7d202c68bc64caa876a888b92e035d9ebcef'],60,12,72,11969778,2,,,,10416
df6cfd7d2f68d6b1d6416a9665b49426b2d51710,0,Marcus Christie,2017-05-24 12:29:14-04:00,['ff0ccae998a3a289df76afe31220cde126ba1795'],0,4,4,11969782,1,0,1,0,10416
84c2fdc01e9969c59f8ad1caafc0750698261543,0,Marcus Christie,2017-05-25 09:21:25-04:00,['df6cfd7d2f68d6b1d6416a9665b49426b2d51710'],1,8,9,11969791,3,,,,10416
fa7468a6cf9790c18153a39aab55919921aa7564,0,scnakandala,2017-05-31 11:36:34-04:00,['84c2fdc01e9969c59f8ad1caafc0750698261543'],0,107,107,11969898,1,0.301886792,0.622641509,1,10417
1fab963d940ab286fd6efa59dc12b4e0207fd529,0,scnakandala,2017-05-31 11:49:30-04:00,['fa7468a6cf9790c18153a39aab55919921aa7564'],16,28,44,11969942,6,0,0,1,10417
a9c4ba18cbf7dc688e064f18363069789f988e85,0,scnakandala,2017-05-31 12:10:55-04:00,['1fab963d940ab286fd6efa59dc12b4e0207fd529'],11,11,22,11969964,6,,,,10417
d8132b784f20fa7440615e45161f6cd00888190e,0,scnakandala,2017-05-31 12:37:11-04:00,['a9c4ba18cbf7dc688e064f18363069789f988e85'],108,4,112,11970076,3,0.692307692,0.384615385,0,10417
64ea7eebd7bded036937d1f932d365152ab6ee62,0,scnakandala,2017-05-31 12:39:49-04:00,['d8132b784f20fa7440615e45161f6cd00888190e'],27,16,43,11970119,5,1,1,0,10417
c076a56bb9b06e72489244d58fa39bf35c9b3201,0,Marcus Christie,2017-05-31 15:56:50-04:00,['64ea7eebd7bded036937d1f932d365152ab6ee62'],14,36,50,11970169,3,0,1,0,10417
020ecaeb6a2ebbcd8557a7d952ec2efdd8523410,0,Marcus Christie,2017-05-31 17:16:56-04:00,['c076a56bb9b06e72489244d58fa39bf35c9b3201'],0,107,107,11970276,2,0.698113208,1,1,10418
bd526ade0ac87f9b3673cebd1e029761ee018a57,0,Marcus Christie,2017-06-01 16:13:10-04:00,['020ecaeb6a2ebbcd8557a7d952ec2efdd8523410'],12,119,131,11970407,3,0.564102564,0.961538462,0.705128205,10418
71579928ccb4844e66151358a4281833e7289fa1,0,Marcus Christie,2017-06-02 17:59:59-04:00,['bd526ade0ac87f9b3673cebd1e029761ee018a57'],9,86,95,11970502,3,0,1,1,10420
1c320eb2d17aa912476937aca5dac288b2b1e74c,0,Marcus Christie,2017-06-05 10:34:16-04:00,['71579928ccb4844e66151358a4281833e7289fa1'],3,17,20,11970522,2,0,1,1,10420
eeea42eeed1c260bbe0ef74ab8277868eeb3abb9,0,Marcus Christie,2017-06-05 10:45:10-04:00,['1c320eb2d17aa912476937aca5dac288b2b1e74c'],3,20,23,11970545,3,0.428571429,0.5,0.928571429,10420
504f83930770b3319dd184208a6ded5197087f2c,0,Gourav Shenoy,2017-06-06 11:00:13-04:00,['eeea42eeed1c260bbe0ef74ab8277868eeb3abb9'],0,16,16,11970561,1,1,1,1,10420
c26f289595ffca771d93e2014f7572f3a6e01ebc,0,Marcus Christie,2017-06-06 13:46:39-04:00,['504f83930770b3319dd184208a6ded5197087f2c'],9,14,23,11970584,3,0,1,0,10420
aa15344371da93d8076cfd2cee8bc8b4c6db831a,0,Gourav Shenoy,2017-06-06 14:35:32-04:00,['504f83930770b3319dd184208a6ded5197087f2c'],1,17,18,11970602,1,0.928571429,1,1,10420
59ca27bca0ae84dfebd072ec8abc02a5de210b71,0,Gourav Shenoy,2017-06-06 14:35:37-04:00,"['aa15344371da93d8076cfd2cee8bc8b4c6db831a', 'c26f289595ffca771d93e2014f7572f3a6e01ebc']",9,14,23,11970625,3,,,,10420
98ec4bfa32e51af7b50b6252b8f7b5001f94d03b,0,Sneha Tilak,2017-06-06 16:05:54-04:00,['59ca27bca0ae84dfebd072ec8abc02a5de210b71'],4,19,23,11970648,1,0.857142857,1,1,10420
9a314106764d3cf8bb43367e5312c464f9f5154e,0,scnakandala,2017-06-07 13:49:43-04:00,['59ca27bca0ae84dfebd072ec8abc02a5de210b71'],104,105,209,11970857,1,,,,10420
83102ed625c5a7a754100a98e653e6f572353270,1,Marcus Christie,2017-06-07 14:51:59-04:00,['9a314106764d3cf8bb43367e5312c464f9f5154e'],154,113,267,11971124,8,0,0,0,10420
ff3fc16ddc760c69f60fb4bbf1cc63cdda10c688,0,Marcus Christie,2017-06-07 14:51:59-04:00,['83102ed625c5a7a754100a98e653e6f572353270'],1,1,2,11971126,1,,,,10420
8341d4976e4673ed2df38cfb1d997e5a2798c63c,1,Marcus Christie,2017-06-07 14:54:40-04:00,['ff3fc16ddc760c69f60fb4bbf1cc63cdda10c688'],25,13,38,11971164,2,,,,10420
de45cba140cba1bc2af3f230afaa1d82e943e4dc,0,Marcus Christie,2017-06-07 16:10:49-04:00,['ff3fc16ddc760c69f60fb4bbf1cc63cdda10c688'],1,31,32,11971196,2,0,0,1,10420
ffbf3292f311f3e0f4aecfcd89daa426c621d895,0,Marcus Christie,2017-06-07 16:32:40-04:00,['de45cba140cba1bc2af3f230afaa1d82e943e4dc'],20,20,40,11971236,2,,,,10420
0a59ba00228e9f5b77823585e21a5e342aab6512,0,Marcus Christie,2017-06-07 17:17:41-04:00,['8341d4976e4673ed2df38cfb1d997e5a2798c63c'],55,99,154,11971390,2,,,,10420
f52024fe86751a7a8ff3d19d503744ed98f4522b,0,Marcus Christie,2017-06-08 12:27:22-04:00,['ffbf3292f311f3e0f4aecfcd89daa426c621d895'],0,1,1,11971391,1,0,0,1,10420
da720e3a61eb18fbe46487373a58ced75e14b7ee,0,Marcus Christie,2017-06-09 10:12:07-04:00,['f52024fe86751a7a8ff3d19d503744ed98f4522b'],1,6,7,11971398,1,0,0,1,10420
29718e088ba9013c09b0623d3e6000823f176e7f,1,Sneha Tilak,2017-06-09 14:44:10-04:00,['98ec4bfa32e51af7b50b6252b8f7b5001f94d03b'],487,2007,2494,11973892,7,0.482158399,0.589208007,0.939077459,10420
b3e07540f665e4d419c246076cf504dc4f1f348e,1,Sneha Tilak,2017-06-09 15:17:07-04:00,['29718e088ba9013c09b0623d3e6000823f176e7f'],4,8,12,11973904,3,0,1,1,10420
f089bb1a9cae11ba0a1f22c4866b65b279ebdec9,0,Marcus Christie,2017-06-11 14:09:37-04:00,['da720e3a61eb18fbe46487373a58ced75e14b7ee'],41,51,92,11973996,5,,,,10420
c0c585f5103b64409c00d1150e375a299bbac157,1,Marcus Christie,2017-06-11 15:49:34-04:00,['f089bb1a9cae11ba0a1f22c4866b65b279ebdec9'],13,6588,6601,11980597,13,0.263443781,0.46804273,0.959985515,10430
3eb804ba597888f4fc7edd94da6a2d1603d1b0ad,1,Marcus Christie,2017-06-11 16:08:46-04:00,['c0c585f5103b64409c00d1150e375a299bbac157'],2,2,4,11980601,1,0,1,1,10430
b3338ceb511f4a3d225dd69eadf89c45a61a3071,0,Marcus Christie,2017-06-12 10:44:20-04:00,"['3eb804ba597888f4fc7edd94da6a2d1603d1b0ad', '0a59ba00228e9f5b77823585e21a5e342aab6512']",69,101,170,11980771,2,,,,10430
b1c390cb42c4f02a7a45231627e0d646fa7c23d5,1,Marcus Christie,2017-06-12 12:24:09-04:00,['b3338ceb511f4a3d225dd69eadf89c45a61a3071'],7,1236,1243,11982014,7,0.550561798,0.811235955,0.943820225,10430
7f3a93928875e85b8ab5fc965661b85223014bf6,0,Marcus Christie,2017-06-12 12:32:57-04:00,['b1c390cb42c4f02a7a45231627e0d646fa7c23d5'],2,2,4,11982018,1,,,,10430
b45fac7a97988286f1ce7e4b65663ff833c46202,0,Gourav Shenoy,2017-06-12 14:52:14-04:00,"['b3e07540f665e4d419c246076cf504dc4f1f348e', '7f3a93928875e85b8ab5fc965661b85223014bf6']",393,8235,8628,11990646,36,,,,10430
da4a57069c14f2d579bc4db89ba6e26858dc473d,0,Marcus Christie,2017-06-12 15:38:34-04:00,['f6f2adc5aaf93cec7f64850be0dcc4aecc6c4aeb'],5,5,10,11990656,1,,,,10430
4e7d7cc646b67c5c2a51877e5e4a61182f30efec,0,Marcus Christie,2017-06-12 16:04:59-04:00,['b45fac7a97988286f1ce7e4b65663ff833c46202'],9,27,36,11990692,2,1,1,1,10430
883c3f4b0f108f0ff180395a08591163a5c5415c,0,Suresh Marru,2017-06-12 16:15:49-04:00,['da4a57069c14f2d579bc4db89ba6e26858dc473d'],4,4,8,11990700,1,,,,10430
e061361650cecee38046560e5566860e9fab0f9b,1,Marcus Christie,2017-06-12 16:43:12-04:00,['4e7d7cc646b67c5c2a51877e5e4a61182f30efec'],39716,28805,68521,12059221,8,0.619560076,0.571428571,0.039498581,10430
7ff713008d69fc62f521128f2a3f8169d513f416,1,Marcus Christie,2017-06-13 09:39:36-04:00,['f6f2adc5aaf93cec7f64850be0dcc4aecc6c4aeb'],2,2,4,12059225,2,,,,10430
047521f3a8f54dac9edf6bdc66f89f1d75003400,0,Marcus Christie,2017-06-14 11:39:14-04:00,['7ff713008d69fc62f521128f2a3f8169d513f416'],62,63,125,12059350,10,,,,10430
251070bb3ce1eca6f5efd51a87462f49daddb3c8,0,scnakandala,2017-06-15 11:00:07-04:00,['e061361650cecee38046560e5566860e9fab0f9b'],1,0,1,12059351,1,,,,10430
1279779099fb0a158ef37c3df494f2a1c2abbff0,1,Marcus Christie,2017-06-15 12:18:14-04:00,['251070bb3ce1eca6f5efd51a87462f49daddb3c8'],23,760,783,12060134,20,,,,10446
93fa1f71da9a2438768c7db7f75a934a52577274,0,Marcus Christie,2017-06-15 12:19:42-04:00,"['1279779099fb0a158ef37c3df494f2a1c2abbff0', '047521f3a8f54dac9edf6bdc66f89f1d75003400']",64,66,130,12060264,12,,,,10446
2b7a9a344e9c29173a532e6e8cfb9afcb65d27ef,0,Marcus Christie,2017-06-15 12:19:55-04:00,['93fa1f71da9a2438768c7db7f75a934a52577274'],6,6,12,12060276,2,,,,10446
35c7cdf674470879e957cb7a098de9d2da943f84,0,Marcus Christie,2017-06-15 12:19:55-04:00,['2b7a9a344e9c29173a532e6e8cfb9afcb65d27ef'],0,3,3,12060279,1,0,1,1,10446
2075f41e1f1a7e3b7ff887f12901e6e1706e100b,1,Marcus Christie,2017-06-15 12:19:56-04:00,['35c7cdf674470879e957cb7a098de9d2da943f84'],38,230,268,12060547,7,,,,10448
0429d37206c4cb67377680a044799b730254b8ca,1,Marcus Christie,2017-06-15 15:42:17-04:00,['2075f41e1f1a7e3b7ff887f12901e6e1706e100b'],1,6,7,12060554,3,,,,10448
225b09c1ffa570cf9d8f7f895cbd4e2059c14976,0,Marcus Christie,2017-06-16 09:34:06-04:00,['0429d37206c4cb67377680a044799b730254b8ca'],1,9,10,12060564,2,0.75,1,1,10448
9a27385743bac0a16cd63011095e6c6384c05863,0,Marcus Christie,2017-06-16 09:38:07-04:00,['225b09c1ffa570cf9d8f7f895cbd4e2059c14976'],2,2,4,12060568,1,,,,10448
8b803d7ee7e4c4d4905d1c4bb9214957039f11ca,0,Marcus Christie,2017-06-16 09:44:59-04:00,['9a27385743bac0a16cd63011095e6c6384c05863'],1,1,2,12060570,1,,,,10448
3b80b596b7bf1114e7314c03206598f9207c4496,0,Marcus Christie,2017-06-16 10:01:48-04:00,['8b803d7ee7e4c4d4905d1c4bb9214957039f11ca'],3,16,19,12060589,4,0,0.5,1,10448
649d57951a0990d8a5c59b7c6a0eafb71780f15d,0,Marcus Christie,2017-06-16 10:22:11-04:00,['3b80b596b7bf1114e7314c03206598f9207c4496'],125,270,395,12060984,1,,,,10448
ae2e0e617f6581cb64a7c9abaeb8dc4e675b5a9d,0,Marcus Christie,2017-06-16 10:42:50-04:00,['649d57951a0990d8a5c59b7c6a0eafb71780f15d'],9,5,14,12060998,6,,,,10448
3ed7880517499b29856efdb25d6d0e63b11a2494,0,Marcus Christie,2017-06-16 10:53:04-04:00,['ae2e0e617f6581cb64a7c9abaeb8dc4e675b5a9d'],1,7,8,12061006,1,0,1,1,10448
555eb6bccb18767bc464a34d67edfd3a8ce33318,1,Marcus Christie,2017-06-16 11:24:41-04:00,['3ed7880517499b29856efdb25d6d0e63b11a2494'],7,51,58,12061064,2,0.103448276,0.793103448,0.310344828,10448
34242484bd9c0caf0129753bfd0ebe8d63e4ec22,1,Marcus Christie,2017-06-16 16:53:44-04:00,['555eb6bccb18767bc464a34d67edfd3a8ce33318'],130,60,190,12061254,8,,,,10448
b24d60f34676145cfc55f22b88c6659e88fea768,0,Marcus Christie,2017-06-19 09:15:47-04:00,['34242484bd9c0caf0129753bfd0ebe8d63e4ec22'],0,8,8,12061262,3,,,,10448
13ed71f14c5d681c9e3badcbda14774259ba0c6b,0,Marcus Christie,2017-06-20 14:40:59-04:00,['b24d60f34676145cfc55f22b88c6659e88fea768'],1,1,2,12061264,1,,,,10448
14bb4321a24db50ba937e40b0ab5665495a16b88,1,Marcus Christie,2017-06-21 14:43:32-04:00,['13ed71f14c5d681c9e3badcbda14774259ba0c6b'],938,634,1572,12062836,13,0.857142857,1,0.239285714,10448
78f089582f33bdf3fb7e5ccfb739d6e46428a491,1,Marcus Christie,2017-06-21 16:44:14-04:00,['14bb4321a24db50ba937e40b0ab5665495a16b88'],232,3525,3757,12066593,7,0.441553243,0.626100881,0.924339472,10448
f0f6b3404866ac6d2056ba74dd6cc9591796d443,0,scnakandala,2017-06-23 13:18:47-04:00,['78f089582f33bdf3fb7e5ccfb739d6e46428a491'],6,10,16,12066609,1,1,1,0,10448
a445590b880ddd3c0671d959f28131406b37e205,0,Marcus Christie,2017-06-23 17:42:16-04:00,"['f0f6b3404866ac6d2056ba74dd6cc9591796d443', '883c3f4b0f108f0ff180395a08591163a5c5415c']",9,9,18,12066627,2,,,,10448
280068981af49e1f4d54f87d2e1f9dd7f06b9d8d,0,Marcus Christie,2017-06-24 13:58:39-04:00,['a445590b880ddd3c0671d959f28131406b37e205'],6,30,36,12066663,4,,,,10448
24b869ae0abffcaf39d34e4b47879fa0d4d5714d,0,Marcus Christie,2017-06-24 14:17:14-04:00,['280068981af49e1f4d54f87d2e1f9dd7f06b9d8d'],0,4,4,12066667,2,,,,10448
a9d277167d6470706b388727679f02bfe1ba265a,1,Marcus Christie,2017-06-26 11:22:41-04:00,['24b869ae0abffcaf39d34e4b47879fa0d4d5714d'],20,1676,1696,12068363,6,0.4664,0.6416,0.9592,10448
cd230e275fe69b0ff936324ef658f6eedc796a49,1,scnakandala,2017-06-26 13:11:10-04:00,['a9d277167d6470706b388727679f02bfe1ba265a'],75,29,104,12068467,5,0.916666667,0.916666667,1,10448
0479066b2c6206c5a24a95c1e59447bc4cfe1fe8,0,Marcus Christie,2017-06-26 15:01:57-04:00,['cd230e275fe69b0ff936324ef658f6eedc796a49'],4,10,14,12068481,2,0,0,0,10448
e9b42768b1b64138ba5883772f1d6dd37303a11b,0,Marcus Christie,2017-06-26 16:38:37-04:00,"['883c3f4b0f108f0ff180395a08591163a5c5415c', '047521f3a8f54dac9edf6bdc66f89f1d75003400']",64,65,129,12068610,12,,,,10448
ec62e687774e0a238fc0fab50de123ead935f398,0,Marcus Christie,2017-06-27 10:45:52-04:00,['e9b42768b1b64138ba5883772f1d6dd37303a11b'],0,1,1,12068611,1,,,,10448
11e80b05a5af41e2458f07e7534f78bad1d75462,0,scnakandala,2017-06-27 14:02:39-04:00,['ec62e687774e0a238fc0fab50de123ead935f398'],1,0,1,12068612,1,,,,10448
d8c4f4584793ae0744903b53d47882285f35000a,0,Marcus Christie,2017-06-28 09:41:39-04:00,['11e80b05a5af41e2458f07e7534f78bad1d75462'],0,1,1,12068613,1,,,,10448
2b92f65863a0244f3107f0111a26b58a152f6fac,1,Marcus Christie,2017-06-28 11:24:08-04:00,['0479066b2c6206c5a24a95c1e59447bc4cfe1fe8'],4,108,112,12068725,9,,,,10456
cb4565d9835ed38cb3108ce78d61d38cd1464bcf,1,Marcus Christie,2017-06-28 13:00:13-04:00,['2b92f65863a0244f3107f0111a26b58a152f6fac'],15,44,59,12068784,7,0.684210526,0.789473684,0.052631579,10456
9792d279c1d06f78a6530d5d9dba21b7a79d0d80,0,Marcus Christie,2017-06-29 10:39:00-04:00,['cb4565d9835ed38cb3108ce78d61d38cd1464bcf'],1,1,2,12068786,1,,,,10456
de6fcb19c509f37ff50590606fe08325266e583f,0,Marcus Christie,2017-06-29 10:39:31-04:00,['9792d279c1d06f78a6530d5d9dba21b7a79d0d80'],0,1,1,12068787,1,0,0,1,10456
ec20fe50a3067212eb57fd6eba3fe60666b1a579,0,Marcus Christie,2017-06-30 10:54:11-04:00,['de6fcb19c509f37ff50590606fe08325266e583f'],0,84,84,12068871,3,,,,10458
b8449f566b9335953296588255d9e28c2601fec8,0,Marcus Christie,2017-06-30 11:30:54-04:00,['ec20fe50a3067212eb57fd6eba3fe60666b1a579'],4,8,12,12068883,1,0,0,1,10458
67e8b52552b1cbe9c831ecc325f87b2701cffc0c,1,Marcus Christie,2017-06-30 11:45:44-04:00,['b8449f566b9335953296588255d9e28c2601fec8'],2,3,5,12068888,1,0,1,1,10458
32e47dec62e5cc8a5efe48b4f5260780ba301606,1,Gourav Shenoy,2017-06-30 12:08:00-04:00,['b45fac7a97988286f1ce7e4b65663ff833c46202'],0,2,2,12068890,1,0,1,1,10458
0d93a45403c5028e79528a5747057f92f781b628,0,Gourav Shenoy,2017-06-30 12:08:10-04:00,"['32e47dec62e5cc8a5efe48b4f5260780ba301606', '67e8b52552b1cbe9c831ecc325f87b2701cffc0c']",41248,36303,77551,12146441,85,,,,10458
f1f3712c870559effc5212ad46d5f596cb79f0da,1,Gourav Shenoy,2017-06-30 12:19:00-04:00,['0d93a45403c5028e79528a5747057f92f781b628'],1,3,4,12146445,1,0,1,1,10458
aadaa258220a322a5ce35ab5bd381428c27529f7,0,scnakandala,2017-06-30 12:22:41-04:00,['67e8b52552b1cbe9c831ecc325f87b2701cffc0c'],25,49,74,12146519,6,0,0.052631579,0.736842105,10458
51005a11cb5b0682e7e403bb1b4cb503fa68df50,0,scnakandala,2017-06-30 12:24:58-04:00,"['aadaa258220a322a5ce35ab5bd381428c27529f7', 'f1f3712c870559effc5212ad46d5f596cb79f0da']",0,4,4,12146523,1,,,,10458
0f643e4a40f3371c7da5e80af4b8b2f83bd2e43d,1,Marcus Christie,2017-06-30 12:29:51-04:00,['51005a11cb5b0682e7e403bb1b4cb503fa68df50'],1,1,2,12146525,1,,,,10458
30a01324399873d820adf11f8d441dca28fd80ad,1,Marcus Christie,2017-06-30 12:39:12-04:00,['0f643e4a40f3371c7da5e80af4b8b2f83bd2e43d'],1,2,3,12146528,1,0,1,1,10458
fa8924435bc857079e78421f845623bc9204a845,1,Marcus Christie,2017-06-30 12:59:12-04:00,['30a01324399873d820adf11f8d441dca28fd80ad'],2,10,12,12146540,1,0,1,1,10458
2e667f25bfc64b6b642e3217796747da7c02ea33,0,scnakandala,2017-06-30 13:21:20-04:00,['51005a11cb5b0682e7e403bb1b4cb503fa68df50'],7,25,32,12146572,2,0,0,1,10458
867135d4137e61cd201bc02f91c5308a5aa66fa5,0,scnakandala,2017-06-30 13:22:05-04:00,"['2e667f25bfc64b6b642e3217796747da7c02ea33', 'fa8924435bc857079e78421f845623bc9204a845']",2,11,13,12146585,1,,,,10458
94508b62b1b070cf62b7758d187b03d016a2c8fe,0,scnakandala,2017-06-30 13:35:24-04:00,['867135d4137e61cd201bc02f91c5308a5aa66fa5'],4,7,11,12146596,1,0,1,0,10458
2a00dd2677fd5c0b26f33c3cb4527949e40a777b,1,Marcus Christie,2017-06-30 14:24:21-04:00,['94508b62b1b070cf62b7758d187b03d016a2c8fe'],2,5,7,12146603,1,0,1,1,10458
a860fd9c5c7ad69015999a6758b1cb9461a756b2,0,scnakandala,2017-06-30 16:38:11-04:00,['94508b62b1b070cf62b7758d187b03d016a2c8fe'],4,13,17,12146620,1,0,0,0,10458
66d98bcfcb88e7d868adeda527db6bb4bee04171,0,scnakandala,2017-06-30 16:38:16-04:00,['a860fd9c5c7ad69015999a6758b1cb9461a756b2'],0,43,43,12146663,1,1,1,1,10459
324a9f77e87c7b8b949cf8dec892a7a59d49c96a,0,scnakandala,2017-06-30 16:38:56-04:00,"['66d98bcfcb88e7d868adeda527db6bb4bee04171', '2a00dd2677fd5c0b26f33c3cb4527949e40a777b']",2,5,7,12146670,1,,,,10459
4691113d749a6cc960e1b3537c4fc497f2038498,0,Marcus Christie,2017-07-03 10:32:41-04:00,['324a9f77e87c7b8b949cf8dec892a7a59d49c96a'],92,96,188,12146858,8,,,,10459
c48982d75652690e50139fdb8aeff281191fb995,0,Marcus Christie,2017-07-03 11:56:33-04:00,['4691113d749a6cc960e1b3537c4fc497f2038498'],1,19,20,12146878,2,1,1,1,10459
48995ea35f1ba308a39ee356199502cc09ed3539,0,Marcus Christie,2017-07-03 14:10:27-04:00,['c48982d75652690e50139fdb8aeff281191fb995'],68,371,439,12147317,21,,,,10460
042ecf7020cbf2989197b221c2ff529334e82a0d,0,Marcus Christie,2017-07-03 14:10:27-04:00,['48995ea35f1ba308a39ee356199502cc09ed3539'],80,0,80,12147397,3,,,,10460
601a65d9151148bef6a66c24c43851e647a3054c,0,Marcus Christie,2017-07-03 14:20:07-04:00,['042ecf7020cbf2989197b221c2ff529334e82a0d'],6,9,15,12147412,1,,,,10460
1ecce70b0b9bf011c42b2958b69c2746f1b4b8db,0,Marcus Christie,2017-07-03 16:31:24-04:00,['601a65d9151148bef6a66c24c43851e647a3054c'],127,272,399,12147811,3,,,,10460
fc09a353c19b6baffa0ee81a685a4504866106e4,0,Marcus Christie,2017-07-04 19:58:36-04:00,['1ecce70b0b9bf011c42b2958b69c2746f1b4b8db'],51,50,101,12147912,3,,,,10460
70fd7b1b2f40b9f7a185f0c3ef9b66c5e7a113a3,0,Marcus Christie,2017-07-04 21:02:10-04:00,['fc09a353c19b6baffa0ee81a685a4504866106e4'],28,36,64,12147976,4,,,,10460
037a8d16eaea4c36d7b8c55a359fa205d62dde54,0,Marcus Christie,2017-07-05 09:10:36-04:00,['70fd7b1b2f40b9f7a185f0c3ef9b66c5e7a113a3'],0,1,1,12147977,1,,,,10460
6c2d7c5ac717629767b8d1b69d705dd21a1bae49,0,scnakandala,2017-07-05 09:27:57-04:00,['324a9f77e87c7b8b949cf8dec892a7a59d49c96a'],7,10,17,12147994,2,1,1,0,10460
d95546500510ea670cba4376c5b7ee23875c6c9d,0,scnakandala,2017-07-05 09:28:53-04:00,"['6c2d7c5ac717629767b8d1b69d705dd21a1bae49', 'c48982d75652690e50139fdb8aeff281191fb995']",93,115,208,12148202,9,,,,10460
165538f9a94594ff5098ad208fc95bced2c88771,0,Marcus Christie,2017-07-05 11:11:25-04:00,['d95546500510ea670cba4376c5b7ee23875c6c9d'],0,1,1,12148203,1,0,0,1,10460
5ab0dc96facf69576b168c629146973b5de8a18e,1,scnakandala,2017-07-05 11:23:33-04:00,['d95546500510ea670cba4376c5b7ee23875c6c9d'],49,45,94,12148297,7,1,1,1,10460
47f57e7b8834cc5e8ff59f8e4bd889dff63c2c1d,0,scnakandala,2017-07-05 11:24:08-04:00,"['5ab0dc96facf69576b168c629146973b5de8a18e', '165538f9a94594ff5098ad208fc95bced2c88771']",0,1,1,12148298,1,,,,10460
295d50e0741bcb5523cfb086b93010e2cdeb71ba,0,Marcus Christie,2017-07-05 14:21:13-04:00,['037a8d16eaea4c36d7b8c55a359fa205d62dde54'],2,2,4,12148302,2,,,,10460
160f70e585098a079c2e6b8168a86ec01cc8ecea,1,Marcus Christie,2017-07-05 14:28:18-04:00,['47f57e7b8834cc5e8ff59f8e4bd889dff63c2c1d'],1,1,2,12148304,1,,,,10460
b7e06dac2ea35f833ddac1da9c4bdfe65286ef8b,1,Marcus Christie,2017-07-05 14:40:40-04:00,['160f70e585098a079c2e6b8168a86ec01cc8ecea'],1,2,3,12148307,1,,,,10460
4e4a63907a34cdc2e984e8adeb07992244b863b2,1,Marcus Christie,2017-07-05 14:46:24-04:00,['b7e06dac2ea35f833ddac1da9c4bdfe65286ef8b'],1,1,2,12148309,1,,,,10460
774b4c968f711a4748b056cf7ee5bfbdc078c1ae,1,Marcus Christie,2017-07-05 14:53:25-04:00,['4e4a63907a34cdc2e984e8adeb07992244b863b2'],1,2,3,12148312,1,,,,10460
9ba8954aa2389fca4e7a1b980b8300f2439e0c73,0,Marcus Christie,2017-07-06 10:27:07-04:00,['295d50e0741bcb5523cfb086b93010e2cdeb71ba'],1,2,3,12148315,1,,,,10460
8e059507516bf13f4649467f41d900e498a73cc9,0,Marcus Christie,2017-07-06 12:29:14-04:00,['9ba8954aa2389fca4e7a1b980b8300f2439e0c73'],285,283,568,12148883,17,,,,10460
d3bc3b6e2613c2395a949817e6a4d5df51ce8da1,1,Gourav Shenoy,2017-07-06 14:01:01-04:00,['f1f3712c870559effc5212ad46d5f596cb79f0da'],0,4,4,12148887,1,0,1,1,10460
a0c6b891fd1af6b8ee61f55ab1a7d44743533853,0,Gourav Shenoy,2017-07-06 14:01:08-04:00,"['d3bc3b6e2613c2395a949817e6a4d5df51ce8da1', '774b4c968f711a4748b056cf7ee5bfbdc078c1ae']",164,297,461,12149348,19,,,,10460
ee6e3da8871d3a80c123e79b40f338e52fcb220e,0,Marcus Christie,2017-07-06 14:04:41-04:00,['8e059507516bf13f4649467f41d900e498a73cc9'],2,2,4,12149352,2,,,,10460
f169bb1068b0763468203cda5043104be960f3b3,0,Marcus Christie,2017-07-06 18:12:08-04:00,['ee6e3da8871d3a80c123e79b40f338e52fcb220e'],44,45,89,12149441,17,,,,10460
217fa0feb9a77e7776338fd3b369458717608a4c,0,Marcus Christie,2017-07-07 09:14:17-04:00,['f169bb1068b0763468203cda5043104be960f3b3'],2,2,4,12149445,2,,,,10460
cd34c55f46e995cb91fb16867f73cac91fe4efc5,0,Marcus Christie,2017-07-07 10:25:34-04:00,['217fa0feb9a77e7776338fd3b369458717608a4c'],2,261,263,12149708,4,,,,10461
b062491b093f07109cd89b6dbaeb751cdc9a27db,0,scnakandala,2017-07-07 12:08:00-04:00,['d8c4f4584793ae0744903b53d47882285f35000a'],6,12,18,12149726,2,0,0,1,10461
7af20472a36cceb1a8d8696e3caad8d0ef2973f2,0,scnakandala,2017-07-07 12:09:52-04:00,['a0c6b891fd1af6b8ee61f55ab1a7d44743533853'],3,5,8,12149734,1,0,0,1,10461
d49fcd72e06c4ff26eacd4fd578042254093f7c3,0,scnakandala,2017-07-07 12:38:14-04:00,['7af20472a36cceb1a8d8696e3caad8d0ef2973f2'],3,3,6,12149740,1,1,1,0,10461
983225c6040a5dde1e3c8c9b560f3a9ca1084424,0,scnakandala,2017-07-07 12:42:28-04:00,['b062491b093f07109cd89b6dbaeb751cdc9a27db'],3,3,6,12149746,1,1,1,0,10461
704ba661233136c338a5fc4e141a982e3fe0e795,0,scnakandala,2017-07-07 15:20:13-04:00,['d49fcd72e06c4ff26eacd4fd578042254093f7c3'],1,1,2,12149748,1,,,,10461
b5a597e0cadef34e63d52d18158196fbc5dd007b,0,Marcus Christie,2017-07-07 17:37:48-04:00,['704ba661233136c338a5fc4e141a982e3fe0e795'],1,1,2,12149750,1,,,,10461
6c46dfe8dc6a339425608a75ef313e38ef1b0f25,0,Marcus Christie,2017-07-07 22:56:23-04:00,"['b5a597e0cadef34e63d52d18158196fbc5dd007b', 'cd34c55f46e995cb91fb16867f73cac91fe4efc5']",560,1198,1758,12151508,46,,,,10461
a8e99e87267506d188c0d090ed6bf06e6bdc1445,0,Marcus Christie,2017-07-07 22:59:06-04:00,['6c46dfe8dc6a339425608a75ef313e38ef1b0f25'],0,4,4,12151512,1,,,,10461
45bbc256e4bc480e44b1901ce1a959074e621447,1,Marcus Christie,2017-07-08 22:27:32-05:00,['a8e99e87267506d188c0d090ed6bf06e6bdc1445'],3,6,9,12151521,1,0,0,0,10461
226cd3fb734c9bdbd8fcb616fd0636c9be409697,1,Marcus Christie,2017-07-08 23:28:51-05:00,['45bbc256e4bc480e44b1901ce1a959074e621447'],0,4,4,12151525,1,0,0,0,10461
86713eecadd740de8c28a14923f77763b00fc9a5,1,Marcus Christie,2017-07-09 00:08:52-05:00,['226cd3fb734c9bdbd8fcb616fd0636c9be409697'],1,3,4,12151529,1,0,0,0,10461
5d4d1057c70406ac03cb09aef706cd7020315eed,0,Marcus Christie,2017-07-09 01:04:38-05:00,['86713eecadd740de8c28a14923f77763b00fc9a5'],6,14,20,12151549,1,0,0,0,10461
5baf04d3f3911edd56dc8928ec00d4a2d9cd7233,0,Suresh Marru,2017-07-10 14:32:43-05:00,['5d4d1057c70406ac03cb09aef706cd7020315eed'],2,2,4,12151553,1,,,,10461
101a687a154690946deed18a74c0f7cb013dd416,0,Suresh Marru,2017-07-11 10:40:10-05:00,['5baf04d3f3911edd56dc8928ec00d4a2d9cd7233'],24,203,227,12151780,7,,,,10465
d03c724029a0fd9203b4ee2404c38cc87f55baf4,0,Suresh Marru,2017-07-11 12:04:10-05:00,['101a687a154690946deed18a74c0f7cb013dd416'],27,51,78,12151858,9,,,,10465
e72ddf0b3b2060356618c10113d4356219708317,0,Marcus Christie,2017-07-11 12:28:02-05:00,['d03c724029a0fd9203b4ee2404c38cc87f55baf4'],4,92,96,12151954,8,0.525,0.95,1,10465
33a601fe84d297b11171a1157a2561a451ad9d84,0,Marcus Christie,2017-07-11 16:46:32-05:00,['e72ddf0b3b2060356618c10113d4356219708317'],5,10,15,12151969,2,0,0,1,10465
14633418a45d80a793fa05d6c381b4ae7e386adc,0,Marcus Christie,2017-07-11 18:02:44-05:00,['33a601fe84d297b11171a1157a2561a451ad9d84'],1,6,7,12151976,1,0,0,1,10465
aff5156c2a83214c58819c7db42a3ee7d804f086,0,Marcus Christie,2017-07-11 19:00:38-05:00,['14633418a45d80a793fa05d6c381b4ae7e386adc'],1,0,1,12151977,1,1,0,0,10465
2aab0ea4f70f6dabdc151f00d7e9790b0585b389,0,Marcus Christie,2017-07-11 20:53:11-05:00,['aff5156c2a83214c58819c7db42a3ee7d804f086'],1,1,2,12151979,1,,,,10465
03d69180366d88fd59f87df0e1d12c27083f001e,0,Marcus Christie,2017-07-11 21:28:13-05:00,['2aab0ea4f70f6dabdc151f00d7e9790b0585b389'],2,2,4,12151983,2,,,,10465
c8ee09c3324686722702b9831194e3fe517b606d,1,Marcus Christie,2017-07-12 12:43:36-05:00,['03d69180366d88fd59f87df0e1d12c27083f001e'],12,40,52,12152035,1,0,0,0,10465
1492fdcab47a4e8634ff0f2c7b17969e71905dd7,0,Marcus Christie,2017-07-12 14:04:09-05:00,['c8ee09c3324686722702b9831194e3fe517b606d'],1,1,2,12152037,1,,,,10465
75edff6f68a511f78fa97fffc598fecee93e6052,0,Suresh Marru,2017-07-12 15:29:47-05:00,['d03c724029a0fd9203b4ee2404c38cc87f55baf4'],0,79,79,12152116,2,,,,10467
632b76a34aa1cdfebcb77e792e35fe75028a8add,0,Suresh Marru,2017-07-12 15:32:47-05:00,"['75edff6f68a511f78fa97fffc598fecee93e6052', '1492fdcab47a4e8634ff0f2c7b17969e71905dd7']",25,150,175,12152291,15,,,,10467
f43c761792b44562070258aa536c0d9859a56822,0,Suresh Marru,2017-07-12 15:33:15-05:00,['632b76a34aa1cdfebcb77e792e35fe75028a8add'],2,2,4,12152295,1,,,,10467
461fdbbf62ed82be0496654aad70a011ab2f2783,0,Marcus Christie,2017-07-12 16:27:25-05:00,['f43c761792b44562070258aa536c0d9859a56822'],1,2,3,12152298,2,,,,10467
89e7e7f0d47999ac7c4e7e73476fd7b8a06e5ca1,1,Marcus Christie,2017-07-13 12:14:06-05:00,['461fdbbf62ed82be0496654aad70a011ab2f2783'],58,94,152,12152450,6,0.081081081,1,0.675675676,10467
fa868f5476e6bb520ba697ee035c2c18e8764a66,0,Suresh Marru,2017-07-13 14:50:54-05:00,['f43c761792b44562070258aa536c0d9859a56822'],0,158,158,12152608,4,,,,10471
8df51dad7706e2fdbf36c8a14599ca97be9a8675,0,Suresh Marru,2017-07-13 14:52:28-05:00,"['fa868f5476e6bb520ba697ee035c2c18e8764a66', '89e7e7f0d47999ac7c4e7e73476fd7b8a06e5ca1']",59,96,155,12152763,8,,,,10471
a0a66dc53a79d98906159b87ec13454c7759de10,0,Marcus Christie,2017-07-13 18:13:20-05:00,['8df51dad7706e2fdbf36c8a14599ca97be9a8675'],2,4,6,12152769,3,,,,10471
fe6e9a25763db27c5cc5f780848a0c6993df7627,0,scnakandala,2017-07-18 13:43:23-04:00,['704ba661233136c338a5fc4e141a982e3fe0e795'],0,2,2,12152771,1,0,0,0,10471
edd1dbbc3f6b1e37b4a4e1bdc9d3322ee949c172,0,scnakandala,2017-07-18 13:43:42-04:00,"['fe6e9a25763db27c5cc5f780848a0c6993df7627', 'a0a66dc53a79d98906159b87ec13454c7759de10']",623,1886,2509,12155280,75,,,,10471
7307b317a04faf0f375c8eb64b3d0514bd1ba8ff,0,scnakandala,2017-07-18 13:44:09-04:00,['edd1dbbc3f6b1e37b4a4e1bdc9d3322ee949c172'],1,1,2,12155282,1,,,,10471
f386e38fc200f515cf48c62ace4207494d94e615,0,scnakandala,2017-07-18 14:56:37-04:00,['7307b317a04faf0f375c8eb64b3d0514bd1ba8ff'],4,3,7,12155289,2,,,,10471
e7e77716260ad745c8b82c08f4bb490feb6c0b2f,1,scnakandala,2017-07-21 15:35:29-04:00,['f386e38fc200f515cf48c62ace4207494d94e615'],18395,11739,30134,12185423,18,0.808126858,0.802180377,0.180773043,10471
1f35ede16b01b52908b397d76d751a1262711692,0,Suresh Marru,2017-07-27 05:22:56+05:18,['e7e77716260ad745c8b82c08f4bb490feb6c0b2f'],10,10,20,12185443,2,,,,10471
d49f25271cdbcfc3f8d8c311d6f9c10ea9c346fc,0,Eroma Abeysinghe,2017-07-27 16:56:48-04:00,['1f35ede16b01b52908b397d76d751a1262711692'],0,114,114,12185557,3,,,,10474
36edde69802c4f439afa5917dd0086f2ca0cff41,0,Marcus Christie,2017-07-27 17:13:17-04:00,['d49f25271cdbcfc3f8d8c311d6f9c10ea9c346fc'],23,23,46,12185603,23,,,,10474
6d6973d87a8442015e63ca6bc5d2b641a1eec010,0,scnakandala,2017-08-02 14:04:14-04:00,['d49f25271cdbcfc3f8d8c311d6f9c10ea9c346fc'],1,34264,34265,12219868,18,0.350722097,0.495675037,0.909918835,10489
ad013e07a4fbf548c39b06abaa967adc39442de2,1,scnakandala,2017-08-02 15:48:17-04:00,['6d6973d87a8442015e63ca6bc5d2b641a1eec010'],23,1397,1420,12221288,12,0.368809273,0.417281349,1,10495
21a750580e9e59f8c66cb6bae13de9f3ffde4e1b,0,Marcus Christie,2017-08-03 11:59:32-04:00,"['983225c6040a5dde1e3c8c9b560f3a9ca1084424', '36edde69802c4f439afa5917dd0086f2ca0cff41']",12970,70241,83211,12304499,559,,,,10495
0f03a85aeb8dc7a9ae80673a12fe440eb0c65bb7,0,Marcus Christie,2017-08-03 13:04:00-04:00,['ad013e07a4fbf548c39b06abaa967adc39442de2'],23,23,46,12304545,23,,,,10495
fe2bc6e01f603059914c00607967653e65f25341,0,Marcus Christie,2017-08-04 16:58:42-04:00,['0f03a85aeb8dc7a9ae80673a12fe440eb0c65bb7'],0,3,3,12304548,2,,,,10495
a0d83fe09e4d5509d9c02913de0bd418c88ead5b,0,Marcus Christie,2017-08-07 10:38:18-04:00,['fe2bc6e01f603059914c00607967653e65f25341'],0,1,1,12304549,1,,,,10495
67f6fad3b77f16b4e3ffbdfa0bc5fd52b32c4452,0,Eroma Abeysinghe,2017-08-07 11:54:26-04:00,['21a750580e9e59f8c66cb6bae13de9f3ffde4e1b'],1,1,2,12304551,1,,,,10495
0d9d15280eaf4a8d7945f2f438035ce87403425a,0,scnakandala,2017-08-07 13:05:37-04:00,['a0d83fe09e4d5509d9c02913de0bd418c88ead5b'],0,2,2,12304553,1,,,,10495
92efa1b86fd135f4bfbdbb6b500f46490654e890,1,scnakandala,2017-08-07 15:17:58-04:00,['0d9d15280eaf4a8d7945f2f438035ce87403425a'],7,25,32,12304585,2,0,1,1,10495
c171c67a47d7dfca8ab4363783b463e6d7a95934,0,scnakandala,2017-08-07 15:30:17-04:00,['92efa1b86fd135f4bfbdbb6b500f46490654e890'],0,1,1,12304586,1,0,0,1,10495
84e8eef50d8c51f4926bb02518d1d5ce0142956f,0,scnakandala,2017-08-08 12:10:23-04:00,['c171c67a47d7dfca8ab4363783b463e6d7a95934'],0,4,4,12304590,1,0,0,1,10495
8e7756608773fb734db2895e522f1f078eefc534,1,Marcus Christie,2017-08-08 13:45:27-04:00,['84e8eef50d8c51f4926bb02518d1d5ce0142956f'],163612,156366,319978,12624568,305,1,0,0.987341772,10495
b279904467f3005b42791beffd3ccbd0ec718cc0,0,Marcus Christie,2017-08-08 14:24:03-04:00,['21a750580e9e59f8c66cb6bae13de9f3ffde4e1b'],0,3,3,12624571,1,0,1,1,10495
a7573b2fb2a323ef2608d5c9c5f7c9e7d87fdac0,0,Marcus Christie,2017-08-08 14:25:05-04:00,"['84e8eef50d8c51f4926bb02518d1d5ce0142956f', 'b279904467f3005b42791beffd3ccbd0ec718cc0']",0,5,5,12624576,2,,,,10495
ccd251830eca38e2d1fba0d0640fca77a6ca3dd0,0,Marcus Christie,2017-08-09 11:20:25-04:00,['67f6fad3b77f16b4e3ffbdfa0bc5fd52b32c4452'],21,27,48,12624624,2,,,,10495
b182ca18a6f5e81caf97bb5e18efd863f17bdf55,0,scnakandala,2017-08-09 17:23:19-04:00,['a7573b2fb2a323ef2608d5c9c5f7c9e7d87fdac0'],1,8,9,12624633,2,1,1,1,10495
efa619b78020e0a66140b3636f7c3f6d1c5706a3,0,scnakandala,2017-08-10 14:16:42-04:00,['b182ca18a6f5e81caf97bb5e18efd863f17bdf55'],2,1,3,12624636,1,,,,10495
1a5cf4ebb6957cd21046003de2af0b58b604520a,0,scnakandala,2017-08-11 12:27:22-04:00,['efa619b78020e0a66140b3636f7c3f6d1c5706a3'],0,1,1,12624637,1,0,0,0,10495
2f471d104dcd7a03ee5f46d758e51fee06825077,0,Eroma Abeysinghe,2017-08-14 15:54:52-04:00,['ccd251830eca38e2d1fba0d0640fca77a6ca3dd0'],0,89,89,12624726,2,,,,10497
862c25be80db341369c40781ea8d3f531eb76bfd,0,Eroma Abeysinghe,2017-08-14 16:41:52-04:00,['2f471d104dcd7a03ee5f46d758e51fee06825077'],0,61,61,12624787,1,,,,10498
5ad4734521c5e6ab8fb5eae8dd4b770bee553dff,0,Eroma Abeysinghe,2017-08-14 16:42:54-04:00,['862c25be80db341369c40781ea8d3f531eb76bfd'],0,18,18,12624805,1,,,,10499
8f57d7c3fe3584c543fe8a9dbbf3af2a817ee7ee,0,Eroma Abeysinghe,2017-08-14 16:52:19-04:00,['5ad4734521c5e6ab8fb5eae8dd4b770bee553dff'],1,1,2,12624807,1,,,,10499
4b1c4372eee4dd4877a19d2d144b9e44b8f02133,0,Eroma Abeysinghe,2017-08-15 14:32:07-04:00,['8f57d7c3fe3584c543fe8a9dbbf3af2a817ee7ee'],1,64,65,12624872,2,,,,10500
d53789056fe011f224b154812d20478aa09be3a8,0,Eroma Abeysinghe,2017-08-15 14:32:24-04:00,['4b1c4372eee4dd4877a19d2d144b9e44b8f02133'],0,18,18,12624890,1,,,,10501
6488090f90eab30e37c4ca39cc0fa24025aeaffb,0,Marcus Christie,2017-08-16 11:33:36-04:00,['d53789056fe011f224b154812d20478aa09be3a8'],0,4,4,12624894,1,,,,10501
c3262a09315ef23172e1083a6a3c39a69ebe2a56,0,scnakandala,2017-08-17 17:19:39-04:00,['1a5cf4ebb6957cd21046003de2af0b58b604520a'],10,27,37,12624931,3,0,0.071428571,1,10501
bb3d4786c5e5c50f8be433c8efb7860a45b8f7a7,0,scnakandala,2017-08-18 10:31:16-04:00,['c3262a09315ef23172e1083a6a3c39a69ebe2a56'],0,11,11,12624942,1,0,0,1,10501
34e1c0e9413dfa49c610d2e3e5b86829e992131e,0,scnakandala,2017-08-18 12:11:28-04:00,['bb3d4786c5e5c50f8be433c8efb7860a45b8f7a7'],1,1,2,12624944,1,,,,10501
251203792214af5ad0f3831a4b9a547cdc19cca3,0,Eroma Abeysinghe,2017-08-22 12:35:20-04:00,['d53789056fe011f224b154812d20478aa09be3a8'],1,1,2,12624946,1,,,,10501
fd8f207b7c4aed90256388eda0a9ad9fe63c1f2a,0,Eroma Abeysinghe,2017-08-22 12:37:46-04:00,['251203792214af5ad0f3831a4b9a547cdc19cca3'],1,1,2,12624948,1,,,,10501
0822efc0136333bccf474a89648926be28aef880,0,Eroma Abeysinghe,2017-08-22 13:20:58-04:00,['fd8f207b7c4aed90256388eda0a9ad9fe63c1f2a'],1,1,2,12624950,1,,,,10501
4f1122d2c2a17bb5e392a0f8550d8b9559b9d39c,0,Eroma Abeysinghe,2017-08-22 13:21:23-04:00,"['0822efc0136333bccf474a89648926be28aef880', '6488090f90eab30e37c4ca39cc0fa24025aeaffb']",0,4,4,12624954,1,,,,10501
b0beb3063898429d07a6e856bbe4abdb793e93fe,0,Eroma Abeysinghe,2017-08-23 10:41:32-04:00,['4f1122d2c2a17bb5e392a0f8550d8b9559b9d39c'],0,61,61,12625015,1,,,,10502
ba7dcd30f63a908d685439d7cb4d88ecaea9e18d,0,Eroma Abeysinghe,2017-08-23 10:41:55-04:00,['b0beb3063898429d07a6e856bbe4abdb793e93fe'],0,18,18,12625033,1,,,,10503
e74f7812b0e4d3be3c2de84a2be0c0ce48a7bdeb,0,Eroma Abeysinghe,2017-08-23 10:42:23-04:00,['ba7dcd30f63a908d685439d7cb4d88ecaea9e18d'],0,1,1,12625034,1,,,,10503
8f358c44628d65ecbb3616935228b77af6ea0868,0,Marcus Christie,2017-08-24 16:37:46-04:00,['e74f7812b0e4d3be3c2de84a2be0c0ce48a7bdeb'],1,9,10,12625044,2,,,,10503
ce376aac544c924c73c92acd42a01b845195ebf3,0,Marcus Christie,2017-08-28 15:15:38-04:00,['8f358c44628d65ecbb3616935228b77af6ea0868'],1257,158,1415,12626459,30,,,,10505
f2e5f0d3a20a7edc74519fa0f7feadf894f2a21c,0,Marcus Christie,2017-08-28 15:28:36-04:00,"['34e1c0e9413dfa49c610d2e3e5b86829e992131e', 'ce376aac544c924c73c92acd42a01b845195ebf3']",1281,529,1810,12628269,44,,,,10505
16d59201378409b8bba32c991009f8e063922e90,0,Eroma Abeysinghe,2017-09-05 12:44:50-04:00,['ce376aac544c924c73c92acd42a01b845195ebf3'],1,1,2,12628271,1,,,,10505
5d49548b819371ea97733ff7dd8ef0a22dafe619,0,Eroma Abeysinghe,2017-09-05 12:46:15-04:00,['16d59201378409b8bba32c991009f8e063922e90'],1,1,2,12628273,1,,,,10505
d31d1cc175e2dde80fb480053c9b020588eb3d22,0,Eroma Abeysinghe,2017-09-05 12:47:09-04:00,['5d49548b819371ea97733ff7dd8ef0a22dafe619'],1,1,2,12628275,1,,,,10505
0ad3fdde5628cde1a53bdff80963d18ae5a91ccf,0,Eroma Abeysinghe,2017-09-05 12:47:34-04:00,['d31d1cc175e2dde80fb480053c9b020588eb3d22'],1,1,2,12628277,1,,,,10505
19f120c924f9372d8727502a9d93feabb827e35b,0,Eroma Abeysinghe,2017-09-05 12:48:27-04:00,['0ad3fdde5628cde1a53bdff80963d18ae5a91ccf'],1,1,2,12628279,1,,,,10505
68599743842efe703f772573121e42b0056ce3c6,0,Eroma Abeysinghe,2017-09-05 12:49:03-04:00,['19f120c924f9372d8727502a9d93feabb827e35b'],1,1,2,12628281,1,,,,10505
8041bf8f078d00310e62cbbbde5c9928586ed3a9,0,Eroma Abeysinghe,2017-09-05 12:49:28-04:00,['68599743842efe703f772573121e42b0056ce3c6'],1,1,2,12628283,1,,,,10505
8d38de8f871e6389d37a366a9bd2eac03a366c4d,0,Eroma Abeysinghe,2017-09-05 12:49:48-04:00,['8041bf8f078d00310e62cbbbde5c9928586ed3a9'],1,1,2,12628285,1,,,,10505
1005e87facac051ff118a28b3a383847ef22be04,0,Eroma Abeysinghe,2017-09-05 12:50:42-04:00,['8d38de8f871e6389d37a366a9bd2eac03a366c4d'],1,1,2,12628287,1,,,,10505
aaf4749b86dbadd93ffa221b395f4416e08d8d8c,0,Eroma Abeysinghe,2017-09-05 16:36:04-04:00,['1005e87facac051ff118a28b3a383847ef22be04'],1,1,2,12628289,1,,,,10505
666bcdf6ec450a66c4e9a7033b98595a0d51ac8d,0,Marcus Christie,2017-09-05 16:39:46-04:00,"['f2e5f0d3a20a7edc74519fa0f7feadf894f2a21c', '8e7756608773fb734db2895e522f1f078eefc534']",163612,156366,319978,12948267,305,,,,10505
817b637819c0af73edcd5a16bf4fc0360272a1fa,0,Marcus Christie,2017-09-06 11:51:07-04:00,['aaf4749b86dbadd93ffa221b395f4416e08d8d8c'],4,4,8,12948275,1,,,,10505
73cf9e117ed138518305ec3a8fcdc111383915d7,0,Marcus Christie,2017-09-07 11:23:51-04:00,['817b637819c0af73edcd5a16bf4fc0360272a1fa'],0,4,4,12948279,1,,,,10505
6c0786f5e147b3b0376134cf04b9012823213c23,0,Marcus Christie,2017-09-11 12:04:53-04:00,['73cf9e117ed138518305ec3a8fcdc111383915d7'],1,1,2,12948281,1,,,,10505
e0b64ebf826416dee88f83f6dae88733e3812861,0,Marcus Christie,2017-09-12 11:48:13-04:00,['6c0786f5e147b3b0376134cf04b9012823213c23'],1,1,2,12948283,1,,,,10505
52d923807d672c54923a25b4b138b2efd21e8bc2,0,Marcus Christie,2017-09-19 12:39:57-04:00,['6488090f90eab30e37c4ca39cc0fa24025aeaffb'],20,81,101,12948384,10,0,0,0,10505
1c39e2ea715f736d25d874c36a519ee0ed250162,1,Marcus Christie,2017-09-19 15:07:40-04:00,['6488090f90eab30e37c4ca39cc0fa24025aeaffb'],1,448,449,12948833,11,1,1,0.875,10513
77baac438f9a59629a9fc21a904dc7397245a029,1,Marcus Christie,2017-09-19 15:07:40-04:00,['1c39e2ea715f736d25d874c36a519ee0ed250162'],34,399,433,12949266,14,0.572463768,0.833333333,0.898550725,10519
2a90139402c9c82350138adc4dc3bc59d56cee93,1,Marcus Christie,2017-09-19 15:07:56-04:00,['77baac438f9a59629a9fc21a904dc7397245a029'],16280,19411,35691,12984957,5,0.403822185,0.429580391,0.979642709,10519
3d161b8161975be658259739047e36df3bd6ef38,1,Marcus Christie,2017-09-19 15:07:56-04:00,['2a90139402c9c82350138adc4dc3bc59d56cee93'],25,162,187,12985144,2,0.134146341,0.597560976,0.365853659,10520
8c748c66b5f4c40847432b6abe5b1ca535188be9,1,Marcus Christie,2017-09-19 15:07:56-04:00,['3d161b8161975be658259739047e36df3bd6ef38'],6,84,90,12985234,2,0,0,0,10520
0d1e90f612831337588867f2589819eefcadde0a,1,Marcus Christie,2017-09-19 15:07:56-04:00,['8c748c66b5f4c40847432b6abe5b1ca535188be9'],11,30,41,12985275,1,0,0,0,10520
8f2f135374c96f92ffb7eb1775bdfdecb144fb20,1,Marcus Christie,2017-09-19 15:07:56-04:00,['0d1e90f612831337588867f2589819eefcadde0a'],7,122,129,12985404,6,0.285714286,1,0.214285714,10520
722aabd4c4fcde001ace20416ea16027a1299224,1,Marcus Christie,2017-09-19 15:07:56-04:00,['8f2f135374c96f92ffb7eb1775bdfdecb144fb20'],748,5345,6093,12991497,4,0.418716257,0.458608278,0.960407918,10523
ac2823a604abca6e0db6314dd7658c1325bb94c3,1,Marcus Christie,2017-09-19 15:07:56-04:00,['722aabd4c4fcde001ace20416ea16027a1299224'],25,300,325,12991822,13,0.694915254,0.762711864,0.898305085,10526
469a7e791db59ca277685f47a422e8805d3c4042,1,Marcus Christie,2017-09-19 15:07:57-04:00,['ac2823a604abca6e0db6314dd7658c1325bb94c3'],445,415,860,12992682,2,1,1,0,10526
643d35b3884d1014a47c3a1b50fc6580d0dabeb1,1,Marcus Christie,2017-09-19 15:07:57-04:00,['469a7e791db59ca277685f47a422e8805d3c4042'],68,107,175,12992857,12,0,0.976744186,0.976744186,10526
3184c23874cf15aef991859bbb87b9d1e0892f9d,1,Marcus Christie,2017-09-19 15:08:05-04:00,['643d35b3884d1014a47c3a1b50fc6580d0dabeb1'],22832,22774,45606,13038463,5,0,0,0,10526
31f3906b6123bb1ce57cd9030f05f15d343cd9f9,0,Marcus Christie,2017-09-19 15:08:05-04:00,['3184c23874cf15aef991859bbb87b9d1e0892f9d'],2,4,6,13038469,1,,,,10526
71d33eafe2fadda66ecd33aeb2a8415f7f67bcb1,1,Marcus Christie,2017-09-19 15:08:05-04:00,['31f3906b6123bb1ce57cd9030f05f15d343cd9f9'],4,34,38,13038507,9,0.666666667,0.722222222,1,10526
fab19005af44bec99634aa5d9233948803428d16,0,Marcus Christie,2017-09-19 15:08:05-04:00,['71d33eafe2fadda66ecd33aeb2a8415f7f67bcb1'],4,133,137,13038644,2,0.222222222,0.231481481,1,10526
1c2ab2724fdb0e6d104130d0c4a8fc4c6df96312,0,Marcus Christie,2017-09-19 15:08:05-04:00,['fab19005af44bec99634aa5d9233948803428d16'],8,136,144,13038788,4,0.151515152,1,1,10526
743711290ee07336005ee7a4d023cdce5325a6f6,1,Marcus Christie,2017-09-19 15:08:05-04:00,['1c2ab2724fdb0e6d104130d0c4a8fc4c6df96312'],142,153,295,13039083,4,1,,,10526
66689a8b817f534d80e1ed0f2594509f53190e95,1,Marcus Christie,2017-09-20 15:04:53-04:00,['743711290ee07336005ee7a4d023cdce5325a6f6'],35,175,210,13039293,7,0.373333333,0.133333333,0.373333333,10528
2425187bb505fbc21580d52dc2192043bb18551a,0,Marcus Christie,2017-09-20 15:05:18-04:00,['66689a8b817f534d80e1ed0f2594509f53190e95'],0,64,64,13039357,2,,,,10528
42059ecccc02eaf6493cda480a6edbaad0d09961,1,Marcus Christie,2017-09-20 16:29:26-04:00,['2425187bb505fbc21580d52dc2192043bb18551a'],1,11,12,13039369,1,0,0,1,10528
8f68bc1a9fdef0f980c7ae47ef671366fdb4373b,0,Marcus Christie,2017-09-20 16:42:37-04:00,['42059ecccc02eaf6493cda480a6edbaad0d09961'],6,13,19,13039388,1,1,1,0,10528
596eb5ba21bec45cdd5eb92a7b09f0249eddcceb,0,Marcus Christie,2017-09-25 09:42:24-04:00,['8f68bc1a9fdef0f980c7ae47ef671366fdb4373b'],0,9,9,13039397,1,1,1,1,10528
20fc3fdbbd7928c63c0ee6abf1382d9970bbef67,1,Marcus Christie,2017-09-25 09:57:28-04:00,['596eb5ba21bec45cdd5eb92a7b09f0249eddcceb'],2,110,112,13039509,10,0.631578947,0.736842105,0.894736842,10528
e5dcade08f7a91bf7bd135647358202475f37620,0,Marcus Christie,2017-09-25 09:57:28-04:00,['20fc3fdbbd7928c63c0ee6abf1382d9970bbef67'],4,148,152,13039661,3,0.238095238,0.238095238,1,10528
29fedaf52435c5ab97b524298bfa52a476fd80ce,0,Marcus Christie,2017-09-25 10:33:24-04:00,['e5dcade08f7a91bf7bd135647358202475f37620'],1,1,2,13039663,1,,,,10528
ba4982c1fe90b841b250f085a5b536c21c4f3201,0,Marcus Christie,2017-09-25 10:38:28-04:00,['29fedaf52435c5ab97b524298bfa52a476fd80ce'],1,3,4,13039667,1,,,,10528
50d7bb6a5b90966eb6cb78c1a5d95f7647345e1b,0,Marcus Christie,2017-09-25 16:17:54-04:00,['ba4982c1fe90b841b250f085a5b536c21c4f3201'],18,44,62,13039729,4,0.5,0.5,0.75,10528
ebdf8977f90d82572186a8944b9b7cdddac5db6a,1,Marcus Christie,2017-09-26 15:08:05-04:00,"['666bcdf6ec450a66c4e9a7033b98595a0d51ac8d', '50d7bb6a5b90966eb6cb78c1a5d95f7647345e1b']",16727,26586,43313,13083042,47,,,,10528
db2a6826851e5b7cafeeb60185ed1204c0bb9281,0,Suresh Marru,2017-09-26 16:28:54-04:00,['ebdf8977f90d82572186a8944b9b7cdddac5db6a'],0,27,27,13083069,1,,,,10529
de6faa346057a5f4461a59e4b79773ad0f210c8c,1,Marcus Christie,2017-09-28 10:42:30-04:00,['50d7bb6a5b90966eb6cb78c1a5d95f7647345e1b'],2,5,7,13083076,1,,,,10529
430001c28415fe60376f2975f9ef4a6b0d4e6619,0,Marcus Christie,2017-09-28 10:44:08-04:00,"['db2a6826851e5b7cafeeb60185ed1204c0bb9281', 'de6faa346057a5f4461a59e4b79773ad0f210c8c']",2,5,7,13083083,1,,,,10529
a27a82964094111b4e93bf5a9ed90ebfc76b61f7,0,Marcus Christie,2017-09-28 17:16:47-04:00,"['430001c28415fe60376f2975f9ef4a6b0d4e6619', '52d923807d672c54923a25b4b138b2efd21e8bc2']",20,81,101,13083184,10,,,,10529
124558d7d6fcb93338c1ebc24d2ead484ca04967,0,Marcus Christie,2017-10-06 15:47:40-04:00,['e0b64ebf826416dee88f83f6dae88733e3812861'],0,6,6,13083190,1,,,,10529
95cb20401744373e9c398d8fdd39b56032fcc2df,0,Marcus Christie,2017-10-06 17:30:38-04:00,"['a27a82964094111b4e93bf5a9ed90ebfc76b61f7', '124558d7d6fcb93338c1ebc24d2ead484ca04967']",16,26,42,13083232,13,,,,10529
5c12e94674acfc827f84b860072b087f9dccf084,0,Marcus Christie,2017-10-06 17:39:41-04:00,['124558d7d6fcb93338c1ebc24d2ead484ca04967'],0,6,6,13083238,1,,,,10529
784d3dede6f616b15307f012c5d4193300fbd45e,0,Eroma Abeysinghe,2017-10-10 12:13:54-04:00,['e0b64ebf826416dee88f83f6dae88733e3812861'],0,83,83,13083321,2,,,,10531
b8aaabc694bbea95fbd6647a95a9c1f9cda769f7,0,Marcus Christie,2017-10-10 15:57:31-04:00,"['784d3dede6f616b15307f012c5d4193300fbd45e', 'b279904467f3005b42791beffd3ccbd0ec718cc0', '52d923807d672c54923a25b4b138b2efd21e8bc2']",20,84,104,13083425,10,,,,10531
8223d51c20bb4d8a2058791b0f403f390e9c5288,0,Marcus Christie,2017-10-10 15:59:32-04:00,['b8aaabc694bbea95fbd6647a95a9c1f9cda769f7'],0,293,293,13083718,2,,,,10532
1a6606fd4c540389fb28b7ce1733d1d6e32bc720,0,Marcus Christie,2017-10-11 12:21:55-04:00,['95cb20401744373e9c398d8fdd39b56032fcc2df'],1,2,3,13083721,1,0,1,0,10532
72cfc64415467e9fb24696a51c67bf0d780cf093,0,Eroma Abeysinghe,2017-10-11 12:28:51-04:00,['784d3dede6f616b15307f012c5d4193300fbd45e'],0,1,1,13083722,1,,,,10532
4a2b9562743a0df4385e709a2e41d30cfbab1fb0,0,Eroma Abeysinghe,2017-10-11 12:29:30-04:00,['72cfc64415467e9fb24696a51c67bf0d780cf093'],26,26,52,13083774,2,,,,10532
7b0cc0b29ba1bb15de7e9f112f87a8b67840c15f,0,Marcus Christie,2017-10-11 16:34:17-04:00,['8223d51c20bb4d8a2058791b0f403f390e9c5288'],1,1,2,13083776,1,,,,10532
5f04191cb7078ee8dc6ff4e848553cc79357152c,0,Marcus Christie,2017-10-11 16:34:46-04:00,"['1a6606fd4c540389fb28b7ce1733d1d6e32bc720', '7b0cc0b29ba1bb15de7e9f112f87a8b67840c15f']",1,377,378,13084154,5,,,,10532
970dc68e659daf8d633e7aaeb6dceaac063d6725,0,Marcus Christie,2017-10-11 17:12:52-04:00,['7b0cc0b29ba1bb15de7e9f112f87a8b67840c15f'],1,1,2,13084156,1,,,,10532
5bf7fce661ff6e250828bc8668f7d347004cf1e3,0,Marcus Christie,2017-10-11 17:14:09-04:00,"['5f04191cb7078ee8dc6ff4e848553cc79357152c', '970dc68e659daf8d633e7aaeb6dceaac063d6725']",1,1,2,13084158,1,,,,10532
857b99b6ca57b7a00d69dcb4da9fdd81b4f7b4bf,0,Eroma Abeysinghe,2017-10-12 11:49:11-04:00,"['4a2b9562743a0df4385e709a2e41d30cfbab1fb0', '970dc68e659daf8d633e7aaeb6dceaac063d6725']",22,379,401,13084559,14,,,,10532
8c8ad8bd2bc3094e0768832f582e1744f6c04b7f,0,Eroma Abeysinghe,2017-10-12 12:13:42-04:00,['857b99b6ca57b7a00d69dcb4da9fdd81b4f7b4bf'],17,17,34,13084593,1,,,,10532
15a8d3650ba28e8714d3a57c1086669aeef1626b,0,Eroma Abeysinghe,2017-10-12 14:39:09-04:00,['8c8ad8bd2bc3094e0768832f582e1744f6c04b7f'],0,83,83,13084676,2,,,,10534
e016b850a3f8adf576e19367d69b5754eb1ccbc9,0,Eroma Abeysinghe,2017-10-12 14:40:06-04:00,['15a8d3650ba28e8714d3a57c1086669aeef1626b'],0,1,1,13084677,1,,,,10534
7ca21453e5b839a87cf9244eb4c1fae568ca45ac,0,Eroma Abeysinghe,2017-10-12 16:28:15-04:00,['e016b850a3f8adf576e19367d69b5754eb1ccbc9'],1,1,2,13084679,1,,,,10534
f392b8dd0777091059efcc9b198240c994a50202,0,Eroma Abeysinghe,2017-10-16 11:37:48-04:00,['7ca21453e5b839a87cf9244eb4c1fae568ca45ac'],1,1,2,13084681,1,,,,10534
6aa119516a624a99c084e66983f4a157add4b3c5,0,Eroma Abeysinghe,2017-10-16 13:54:15-04:00,['f392b8dd0777091059efcc9b198240c994a50202'],4,4,8,13084689,1,,,,10534
eb44aacfafe6bfef102c83624408b69e1e8f3478,0,Eroma Abeysinghe,2017-10-16 14:26:26-04:00,['6aa119516a624a99c084e66983f4a157add4b3c5'],4,4,8,13084697,1,,,,10534
e1bd58f5a1fee988750c9ecca5ee58535f123cf5,0,Sachin Kariyattin,2017-10-21 17:03:37-04:00,['5bf7fce661ff6e250828bc8668f7d347004cf1e3'],356,8240,8596,13093293,5,0.397949057,0.469732054,0.983625538,10535
4988f92bed8b4568f040b554c729cd934214257d,0,Sachin Kariyattin,2017-10-21 17:09:04-04:00,['e1bd58f5a1fee988750c9ecca5ee58535f123cf5'],2,2,4,13093297,1,,,,10535
f26ea4c3edbcab73288875fd29695d42cddcf909,1,Sachin Kariyattin,2017-10-22 02:42:20-04:00,['4988f92bed8b4568f040b554c729cd934214257d'],0,388,388,13093685,5,0.857142857,1,1,10536
8679ab5d579632327dd7a52909b66d053d062615,0,Sachin Kariyattin,2017-10-22 15:40:58-04:00,['f26ea4c3edbcab73288875fd29695d42cddcf909'],5176,357,5533,13099218,3,0.469543147,0.355047941,0.027918782,10536
ac23b72041f297d6843682430bca127d5911d4e2,0,Sachin Kariyattin,2017-10-22 15:49:17-04:00,['8679ab5d579632327dd7a52909b66d053d062615'],32,3,35,13099253,2,0,0,0,10536
a68ff57ded1eb26a9b30def94762194c7a377361,0,dimuthu.upeksha2@gmail.com,2017-10-23 11:22:46+05:18,['eb44aacfafe6bfef102c83624408b69e1e8f3478'],0,2710,2710,13101963,47,0.917209302,1,0.985116279,10583
4d51329baae3cc1f6aa3c0fbfe8c33af0f2d2458,0,Sachin Kariyattin,2017-10-23 20:06:10-04:00,['ac23b72041f297d6843682430bca127d5911d4e2'],391,1128,1519,13103482,2,0,0,1,10583
8579f2ac34a4c081331e0d00eb9c2eadad3b81ac,1,Marcus Christie,2017-10-23 21:13:53-04:00,['eb44aacfafe6bfef102c83624408b69e1e8f3478'],6,15,21,13103503,1,0,0.285714286,0.714285714,10583
23a1bf7d1eabf0da53912769db80cb6c5f60bc79,0,Marcus Christie,2017-10-23 21:15:38-04:00,"['5bf7fce661ff6e250828bc8668f7d347004cf1e3', '8579f2ac34a4c081331e0d00eb9c2eadad3b81ac']",30,124,154,13103657,7,,,,10583
c3644ef92cbb14dd4bd281407ae3f9a381c6137e,0,dimuthu.upeksha2@gmail.com,2017-10-24 07:28:45+05:18,['a68ff57ded1eb26a9b30def94762194c7a377361'],65,803,868,13104525,31,0.808108108,1,0.97027027,10595
44553b963c0dfbb02ffac9dd8c3ec1a44edbc4e1,0,Marcus Christie,2017-10-25 15:53:53-04:00,['eb44aacfafe6bfef102c83624408b69e1e8f3478'],8,8,16,13104541,6,,,,10595
96840a737d382ee9c148cced9b779ea3c9433967,0,Marcus Christie,2017-10-25 15:54:24-04:00,"['23a1bf7d1eabf0da53912769db80cb6c5f60bc79', '44553b963c0dfbb02ffac9dd8c3ec1a44edbc4e1']",8,8,16,13104557,6,,,,10595
9935b6bdb2b8f7133437cd494f9599d4a154b44d,1,Marcus Christie,2017-10-25 16:06:20-04:00,['8579f2ac34a4c081331e0d00eb9c2eadad3b81ac'],4,4,8,13104565,1,0,1,0.5,10595
be028240c276b93a45ed11360b2181581f57c19a,0,Marcus Christie,2017-10-25 16:07:55-04:00,"['96840a737d382ee9c148cced9b779ea3c9433967', '9935b6bdb2b8f7133437cd494f9599d4a154b44d']",4,4,8,13104573,1,,,,10595
98afe91a6033ac741aa84064ecfe109a3d1c2b76,0,dimuthu.upeksha2@gmail.com,2017-10-26 16:46:33+05:18,['c3644ef92cbb14dd4bd281407ae3f9a381c6137e'],96,1031,1127,13105700,51,0.498489426,0.746223565,0.6918429,10613
90f67fff376c0603be5ae64442d1ad899b8dcb64,0,Suresh Marru,2017-10-26 15:14:13-04:00,['44553b963c0dfbb02ffac9dd8c3ec1a44edbc4e1'],3,1,4,13105704,1,,,,10613
c4a3a054c7f9d6bed492d95a84404ae5b1a046b0,0,dimuthu.upeksha2@gmail.com,2017-10-27 08:42:22+05:18,['98afe91a6033ac741aa84064ecfe109a3d1c2b76'],33,2151,2184,13107888,60,0.805147059,0.965073529,0.972426471,10653
e96bced36aad77da5573948ced313bec86fe8b91,0,dimuthu.upeksha2@gmail.com,2017-10-27 08:44:03+05:18,['c4a3a054c7f9d6bed492d95a84404ae5b1a046b0'],0,656,656,13108544,17,0.741721854,1,0.960264901,10670
f800a634c93000edb2fd7e009297f2b3cc4ccf18,0,dimuthu.upeksha2@gmail.com,2017-10-27 18:09:37+05:18,['e96bced36aad77da5573948ced313bec86fe8b91'],25,118,143,13108687,15,1,1,1,10670
04f88bc42993c6548249b939b27df638ca5762ee,0,dimuthu.upeksha2@gmail.com,2017-10-27 18:26:26+05:18,['f800a634c93000edb2fd7e009297f2b3cc4ccf18'],5,30,35,13108722,10,1,1,0,10670
14a62f9b65403cd6e340ef24c83ded9189a0af0a,0,dimuthu.upeksha2@gmail.com,2017-10-27 19:33:05+05:18,['04f88bc42993c6548249b939b27df638ca5762ee'],1,375,376,13109098,11,1,1,0.830985915,10679
56bb2fa2da49e0a6b60a7d0659a971d764df56e2,0,dimuthu.upeksha2@gmail.com,2017-10-27 23:34:10+05:18,['14a62f9b65403cd6e340ef24c83ded9189a0af0a'],69,458,527,13109625,22,0.204081633,0.62755102,0.806122449,10684
fa3a242c9d6006c9e33fa6060a3dea9bacea3ab5,0,dimuthu.upeksha2@gmail.com,2017-10-28 07:36:22+05:18,['56bb2fa2da49e0a6b60a7d0659a971d764df56e2'],294,377,671,13110296,148,,,,10703
426806712dc3f210add4eaee3e20dc76a2a98990,0,dimuthu.upeksha2@gmail.com,2017-10-28 12:30:29+05:18,['fa3a242c9d6006c9e33fa6060a3dea9bacea3ab5'],0,3,3,13110299,1,,,,10703
da921e99221db3ea71a0c17eaafa166c976c5894,0,dimuthu.upeksha2@gmail.com,2017-10-28 12:31:25+05:18,['426806712dc3f210add4eaee3e20dc76a2a98990'],0,263,263,13110562,12,,,,10715
549ae48ecd6bc7d85d2778373d831e27d3a79dac,0,dimuthu.upeksha2@gmail.com,2017-10-28 13:41:38+05:18,['da921e99221db3ea71a0c17eaafa166c976c5894'],6,174,180,13110742,7,0.882352941,0.882352941,0.870588235,10717
4e27cb5cd4ba85c80aa652df2758503cf60e3e0b,0,dimuthu.upeksha2@gmail.com,2017-10-29 16:59:57+05:18,['549ae48ecd6bc7d85d2778373d831e27d3a79dac'],1,191,192,13110934,14,0.984375,1,1,10717
e1e09b8c29bbfe36215a1219cb065810810e751c,0,dimuthu.upeksha2@gmail.com,2017-10-29 17:02:28+05:18,['4e27cb5cd4ba85c80aa652df2758503cf60e3e0b'],0,11376,11376,13122310,62,0.836923077,1,0.606153846,10779
2d18e158af5302f92d6a721f62ef7bc09c5025bd,0,dimuthu.upeksha2@gmail.com,2017-10-29 21:47:26+05:18,['e1e09b8c29bbfe36215a1219cb065810810e751c'],17,500,517,13122827,15,1,1,0.906040268,10781
e1d73b560a31167484e42d43eca644494c32e56b,0,dimuthu.upeksha2@gmail.com,2017-10-30 00:48:25+05:18,['2d18e158af5302f92d6a721f62ef7bc09c5025bd'],33,391,424,13123251,18,0.925619835,1,1,10786
95fb8d477d3718662a947a2f6fec2c8243b75479,0,dimuthu.upeksha2@gmail.com,2017-10-30 02:03:22+05:18,['e1d73b560a31167484e42d43eca644494c32e56b'],28,198,226,13123477,14,0.904761905,1,1,10789
4f19f5cf8eacdcd65aa795226bf0a2dc714b22ac,0,dimuthu.upeksha2@gmail.com,2017-10-30 02:38:37+05:18,['95fb8d477d3718662a947a2f6fec2c8243b75479'],2,64,66,13123543,8,1,1,1,10791
9b8c097963f0e3138e6b8b23948d862158c84e32,0,dimuthu.upeksha2@gmail.com,2017-10-30 11:45:42+05:18,['4f19f5cf8eacdcd65aa795226bf0a2dc714b22ac'],96,278,374,13123917,12,0.097902098,0,0.804195804,10791
cb4438f002fa79d0ac61bcc3b6b8271155ec541c,0,dimuthu.upeksha2@gmail.com,2017-10-30 16:02:33+05:18,['9b8c097963f0e3138e6b8b23948d862158c84e32'],47,609,656,13124573,17,0.381578947,0.381578947,0.490131579,10797
421fd4a096e7d4cc118a373f8a3418ffae3038ed,0,dimuthu.upeksha2@gmail.com,2017-10-30 20:05:23+05:18,['cb4438f002fa79d0ac61bcc3b6b8271155ec541c'],0,2,2,13124575,1,,,,10798
7b16ba63606d9e90b07b264b882b0d3a2989d2a4,0,dimuthu.upeksha2@gmail.com,2017-10-30 20:05:48+05:18,['421fd4a096e7d4cc118a373f8a3418ffae3038ed'],0,5,5,13124580,1,,,,10798
67de113276e7c639602c7f1befe408146bb799cc,0,dimuthu.upeksha2@gmail.com,2017-10-30 20:06:28+05:18,['7b16ba63606d9e90b07b264b882b0d3a2989d2a4'],14,8,22,13124602,3,0,0,0,10798
6b8c79d77f2a291dbb9f893f2000de1e2de5e207,0,Eroma Abeysinghe,2017-10-30 12:02:09-04:00,['44553b963c0dfbb02ffac9dd8c3ec1a44edbc4e1'],0,84,84,13124686,2,,,,10800
737c290ff704dbfd487abaf1b9ec80b936ef1247,0,Eroma Abeysinghe,2017-10-30 12:41:26-04:00,"['6b8c79d77f2a291dbb9f893f2000de1e2de5e207', '90f67fff376c0603be5ae64442d1ad899b8dcb64']",3,1,4,13124690,1,,,,10800
2a3302c49810077012cb0d8345168469e1716f0c,0,Eroma Abeysinghe,2017-10-30 12:42:05-04:00,['737c290ff704dbfd487abaf1b9ec80b936ef1247'],1,1,2,13124692,1,,,,10800
70076aaead5fbd589eb9b03dbd2ac28e2d6ad855,0,dimuthu.upeksha2@gmail.com,2017-10-31 20:34:14+05:18,['67de113276e7c639602c7f1befe408146bb799cc'],119,71,190,13124882,12,,,,10800
35ef6520c8ae3e0c8fab8e34bb14600269393c8e,0,dimuthu.upeksha2@gmail.com,2017-10-31 20:56:22+05:18,['70076aaead5fbd589eb9b03dbd2ac28e2d6ad855'],0,2627,2627,13127509,137,,,,10800
3077522f98b47d5e3259e83090fcbec31e492b95,0,dimuthu.upeksha2@gmail.com,2017-10-31 21:08:36+05:18,['35ef6520c8ae3e0c8fab8e34bb14600269393c8e'],39,8,47,13127556,3,,,,10802
88acdf1220b4e3aa9b8ad09fcb251964034abb21,0,GitHub,2017-10-31 12:03:32-04:00,"['2a3302c49810077012cb0d8345168469e1716f0c', '3077522f98b47d5e3259e83090fcbec31e492b95']",0,24487,24487,13152043,246,,,,10802
b7159b06f96cc9fc7f54011b3f30a1c107b4936b,0,GitHub,2017-10-31 16:36:33-04:00,['88acdf1220b4e3aa9b8ad09fcb251964034abb21'],24487,0,24487,13176530,246,0.238583639,0.135775336,0.134310134,10802
f1fc62db42cb3e1c9f09149a07a846fbf22da55c,0,GitHub,2017-10-31 16:37:06-04:00,"['88acdf1220b4e3aa9b8ad09fcb251964034abb21', 'b7159b06f96cc9fc7f54011b3f30a1c107b4936b']",24487,0,24487,13201017,246,,,,10802
5e7e5c564f616f49c60f30825b7b37292e5c3617,0,Marcus Christie,2017-11-01 17:51:28-04:00,['de6faa346057a5f4461a59e4b79773ad0f210c8c'],2,4,6,13201023,1,0,0,1,10802
6885a268572627671f5e93fe698bd93ab60492c7,0,Marcus Christie,2017-11-01 17:52:04-04:00,"['be028240c276b93a45ed11360b2181581f57c19a', '5e7e5c564f616f49c60f30825b7b37292e5c3617']",2,4,6,13201029,1,,,,10802
cb0b5ef8136a69496550783391e849b7919fbb1f,0,Marcus Christie,2017-11-03 13:47:44-04:00,['6885a268572627671f5e93fe698bd93ab60492c7'],1,1,2,13201031,1,,,,10802
b73cf69fededb98cf7d17cf5ed86f19fa97d7f39,0,GitHub,2017-11-03 20:36:18-04:00,"['cb0b5ef8136a69496550783391e849b7919fbb1f', '4d51329baae3cc1f6aa3c0fbfe8c33af0f2d2458']",396,4557,4953,13205984,10,,,,10802
2269b50482c27088ae444f2bb02126ac17d9369a,0,Sachin Kariyattin,2017-11-06 02:05:47-05:00,['b73cf69fededb98cf7d17cf5ed86f19fa97d7f39'],0,4,4,13205988,1,,,,10803
3451a63dd21c96978226bc30754e94196a4519c3,1,Marcus Christie,2017-11-06 15:41:54-05:00,['b73cf69fededb98cf7d17cf5ed86f19fa97d7f39'],8689,5136,13825,13219813,153,0.749284254,0.753783231,0.02208589,10807
084227b60fce7f51d2e76e40632a81eb94a47873,0,Sachin Kariyattin,2017-11-06 22:36:58-05:00,['2269b50482c27088ae444f2bb02126ac17d9369a'],0,86,86,13219899,1,,,,10807
249111f78f581612070ba010fe6e03b6b9fa399d,0,Marcus Christie,2017-11-08 16:07:35-05:00,['f1fc62db42cb3e1c9f09149a07a846fbf22da55c'],1,1,2,13219901,1,,,,10807
eec7b76743ef0947709ef135ae2456bff24f7c3e,0,Marcus Christie,2017-11-08 16:24:06-05:00,"['249111f78f581612070ba010fe6e03b6b9fa399d', '5c12e94674acfc827f84b860072b087f9dccf084']",0,12,12,13219913,2,,,,10807
0ba2ddb180aec633a7234bc96f25112bff39975f,0,Marcus Christie,2017-11-09 15:34:18-05:00,['eec7b76743ef0947709ef135ae2456bff24f7c3e'],0,1,1,13219914,1,,,,10807
b74c1c5f83dc8cb9bfde3c542ac07137eb2af3f1,0,Marcus Christie,2017-11-09 17:08:40-05:00,['eec7b76743ef0947709ef135ae2456bff24f7c3e'],2,4,6,13219920,1,,,,10807
c663745ee8d872bbfea2e39cd5b5237cd4f28045,0,Sachin Kariyattin,2017-11-13 21:34:56-05:00,['3451a63dd21c96978226bc30754e94196a4519c3'],0,1,1,13219921,1,,,,10808
2c55c4b7d7f9496292a46aa3c24c33bbb80ff3d2,1,Sachin Kariyattin,2017-11-16 22:10:46-05:00,['c663745ee8d872bbfea2e39cd5b5237cd4f28045'],1423,9139,10562,13230483,10,0.539556677,0.623175347,0.962335556,10810
07d4d8e1ac9a0b56abcc8542884dcf888622ce16,0,Sachin Kariyattin,2017-11-16 22:38:53-05:00,['2c55c4b7d7f9496292a46aa3c24c33bbb80ff3d2'],275,0,275,13230758,1,0,0,0,10810
c04861f1906fea9d4c3c694f8e623abf21283224,0,Sachin Kariyattin,2017-11-18 17:17:38-05:00,['07d4d8e1ac9a0b56abcc8542884dcf888622ce16'],0,313,313,13231071,8,1,0.80952381,1,10816
6dfa6f266857ee35d4382c5d3a863dfa346abcb8,0,Sachin Kariyattin,2017-11-18 17:24:10-05:00,['c04861f1906fea9d4c3c694f8e623abf21283224'],13,13,26,13231097,1,,,,10816
8cc934f95a681d740911efffdc90c3047589ec5d,0,Sachin Kariyattin,2017-11-18 20:55:34-05:00,['6dfa6f266857ee35d4382c5d3a863dfa346abcb8'],4,67,71,13231168,1,0.050847458,1,0,10816
03dbe9ce8b57c8a3db10d074c49b2cdae6ee8821,0,Sachin Kariyattin,2017-11-19 00:10:56-05:00,['8cc934f95a681d740911efffdc90c3047589ec5d'],1,1,2,13231170,1,,,,10816
342cc269241cf41e53a3f72c45b870db8094046f,1,Sachin Kariyattin,2017-11-19 00:13:44-05:00,['03dbe9ce8b57c8a3db10d074c49b2cdae6ee8821'],215,150,365,13231535,5,0.759259259,1,0,10816
35cd0f5d7bb894d5db3c3052e4a16d0f262c2dbc,0,Sachin Kariyattin,2017-11-19 00:16:49-05:00,['342cc269241cf41e53a3f72c45b870db8094046f'],1,0,1,13231536,1,,,,10816
2f84474a2a9cfd8900cc484a5b38ae40c3036ec3,0,Sachin Kariyattin,2017-11-19 02:06:34-05:00,['35cd0f5d7bb894d5db3c3052e4a16d0f262c2dbc'],1,1,2,13231538,1,,,,10816
bc8d76f628eaf938dc26b3396fc7d38b86ae7ea5,1,Sachin Kariyattin,2017-11-28 01:55:18-05:00,['2f84474a2a9cfd8900cc484a5b38ae40c3036ec3'],155,155,310,13231848,17,,,,10818
027af88e888a15c3066dcadbeac4181f21a83f3c,0,GitHub,2017-11-28 16:11:52-05:00,"['3451a63dd21c96978226bc30754e94196a4519c3', 'bc8d76f628eaf938dc26b3396fc7d38b86ae7ea5']",1700,9452,11152,13243000,19,,,,10818
3e21d491539eff85e25365c4e7f014569258d07c,0,GitHub,2017-11-28 16:12:42-05:00,"['027af88e888a15c3066dcadbeac4181f21a83f3c', '084227b60fce7f51d2e76e40632a81eb94a47873']",0,90,90,13243090,1,,,,10818
2a7f51d29012a465de044bf56e6d199dad336f9f,0,Suresh Marru,2017-11-30 20:15:51-05:00,['3e21d491539eff85e25365c4e7f014569258d07c'],772,7,779,13243869,11,0.534274194,0.485887097,0.028225806,10818
4b24b979d132e33a6595567b885cdc0a8f1212cf,0,Sneha Tilak,2017-12-01 15:28:16-05:00,['be028240c276b93a45ed11360b2181581f57c19a'],433,661,1094,13244963,6,0.020833333,0.421875,0.963541667,10818
9eb062c510ea1227390d012c26e0c1ccf5f092c2,0,Sneha Tilak,2017-12-01 15:31:01-05:00,"['4b24b979d132e33a6595567b885cdc0a8f1212cf', '2a7f51d29012a465de044bf56e6d199dad336f9f']",10788,18475,29263,13274226,178,,,,10818
3908471f947e96d8eed1445cf0b48a8ba38235d4,0,Suresh Marru,2017-12-01 15:38:12-05:00,['0ba2ddb180aec633a7234bc96f25112bff39975f'],1,1,2,13274228,1,,,,10818
8aa2c45ae21c5ddabfe251ee9d270beff4b13c8b,0,Marcus Christie,2017-12-01 15:41:16-05:00,['3908471f947e96d8eed1445cf0b48a8ba38235d4'],0,34,34,13274262,1,,,,10819
3778d1a3977508018b667da4a20f48dd3b645c7c,0,Sneha Tilak,2017-12-01 16:36:44-05:00,['9eb062c510ea1227390d012c26e0c1ccf5f092c2'],1,2,3,13274265,1,,,,10819
9f2d3878d62dd27becd1efb83c0deef3fd2a2115,0,Sneha Tilak,2017-12-04 15:27:59-05:00,['3778d1a3977508018b667da4a20f48dd3b645c7c'],468,644,1112,13275377,4,0.025806452,0.490322581,0.903225806,10819
04ee2f2bd99d9463ec49d7786d30f883c3144527,0,Sneha Tilak,2017-12-04 15:44:41-05:00,['9f2d3878d62dd27becd1efb83c0deef3fd2a2115'],1,1,2,13275379,1,,,,10819
84ddb3a94f7d08e75faa386562eaa13c6dce4ad5,0,Marcus Christie,2017-12-06 16:06:21-05:00,['2a7f51d29012a465de044bf56e6d199dad336f9f'],1,1,2,13275381,1,,,,10819
ccb09a94028fccad59fa99db76fdeeb1baa135a8,0,Marcus Christie,2017-12-06 16:12:09-05:00,['84ddb3a94f7d08e75faa386562eaa13c6dce4ad5'],4,9,13,13275394,6,,,,10819
f96894c8a6de174d3e2c4d360e974389e6057fd8,0,Sneha Tilak,2017-12-06 18:07:36-05:00,['04ee2f2bd99d9463ec49d7786d30f883c3144527'],8,15,23,13275417,4,0,1,0,10819
bae2f2fbc59199f691f8b9544ec4d14fe2625c6e,0,Marcus Christie,2017-12-07 09:15:01-05:00,['ccb09a94028fccad59fa99db76fdeeb1baa135a8'],0,8,8,13275425,5,,,,10819
27ea5d50ae806d82abe2b07755729c949283c908,0,Marcus Christie,2017-12-07 12:40:41-05:00,['8aa2c45ae21c5ddabfe251ee9d270beff4b13c8b'],1,3,4,13275429,3,,,,10819
b64b828ae5b538c884ebd662d5bc62c25042e169,1,Sneha Tilak,2017-12-07 13:20:09-05:00,['f96894c8a6de174d3e2c4d360e974389e6057fd8'],6,27,33,13275462,6,0,0,1,10819
fc363c93bbbe462fbda1607b130159693ade4c2f,1,Sneha Tilak,2017-12-07 14:15:36-05:00,['b64b828ae5b538c884ebd662d5bc62c25042e169'],1,3,4,13275466,1,0,1,1,10819
8c90a50c049eafe0acac063ab8de90ea3d2c0ca8,0,Sneha Tilak,2017-12-07 14:42:41-05:00,"['fc363c93bbbe462fbda1607b130159693ade4c2f', 'bae2f2fbc59199f691f8b9544ec4d14fe2625c6e']",5,18,23,13275489,7,,,,10819
d802360aa10ea15c8e7bcd365f7ee4fe5c8ca0f9,0,Eroma Abeysinghe,2017-12-07 15:03:24-05:00,['8aa2c45ae21c5ddabfe251ee9d270beff4b13c8b'],0,4,4,13275493,1,,,,10819
27cde9d986b65f588324f308dccf65cae68257fc,0,Marcus Christie,2017-12-08 15:33:27-05:00,['bae2f2fbc59199f691f8b9544ec4d14fe2625c6e'],2,2,4,13275497,2,,,,10819
0e35b485cc0d355fa45d06697b9aa80888a587e5,0,Suresh Marru,2017-12-09 13:42:39-05:00,['d802360aa10ea15c8e7bcd365f7ee4fe5c8ca0f9'],37,31,68,13275565,2,,,,10819
236455fdc2cd611e46e76eefa4716c74cbbbf444,0,Suresh Marru,2017-12-09 13:56:45-05:00,['0e35b485cc0d355fa45d06697b9aa80888a587e5'],39,46,85,13275650,2,,,,10819
bc5d4c87f35984d1d43145938d5b2c44b319c505,0,Suresh Marru,2017-12-11 14:56:01-05:00,['27cde9d986b65f588324f308dccf65cae68257fc'],0,2,2,13275652,1,,,,10819
206abb82e8257a30d2428027a96f04c5d96ecd32,1,Suresh Marru,2017-12-11 14:56:01-05:00,['bc5d4c87f35984d1d43145938d5b2c44b319c505'],0,13998,13998,13289650,6,0.508058252,0.589902913,0.959805825,10824
8810c0461d3eea513192deff7043b6b097ef5259,1,Suresh Marru,2017-12-11 14:56:01-05:00,['206abb82e8257a30d2428027a96f04c5d96ecd32'],4,251,255,13289905,5,0.615384615,0.98816568,0.532544379,10825
5f65d4c08a9796389019c884b68d1a42c9bc0b49,1,Suresh Marru,2017-12-11 14:56:01-05:00,['8810c0461d3eea513192deff7043b6b097ef5259'],625,105,730,13290635,3,1,1,0.045454545,10825
ab467ac8fd4bb36239de16ab7baf5220de09e62f,0,Suresh Marru,2017-12-11 14:56:01-05:00,['5f65d4c08a9796389019c884b68d1a42c9bc0b49'],3,179,182,13290817,3,1,1,0.888888889,10826
ea0eb0d79a4d13eb02d687c86381466a3aae39d9,0,Suresh Marru,2017-12-11 14:56:01-05:00,['ab467ac8fd4bb36239de16ab7baf5220de09e62f'],1,1,2,13290819,1,,,,10826
fa2afd84a411474a0ffcaf743d9479ffbe233e70,1,Suresh Marru,2017-12-11 14:56:01-05:00,['ea0eb0d79a4d13eb02d687c86381466a3aae39d9'],31127,23621,54748,13345567,4,0.584942085,0.535275535,0.031590032,10826
e759204aa54cf92f1d585b8938ab087540ca1f71,0,Suresh Marru,2017-12-11 14:56:01-05:00,['fa2afd84a411474a0ffcaf743d9479ffbe233e70'],1,0,1,13345568,1,,,,10826
5e36ed399a57a1f94c784e1268736a4523c84472,0,Suresh Marru,2017-12-11 14:56:01-05:00,['e759204aa54cf92f1d585b8938ab087540ca1f71'],1,0,1,13345569,1,,,,10826
a7f24b623f73f1cd217b830249c3590ac6715d55,0,Suresh Marru,2017-12-11 14:56:01-05:00,['5e36ed399a57a1f94c784e1268736a4523c84472'],0,3,3,13345572,1,,,,10826
f51745f19215fafaa81cec95990459c629629dfd,0,Suresh Marru,2017-12-11 14:56:01-05:00,['a7f24b623f73f1cd217b830249c3590ac6715d55'],201,23,224,13345796,2,0,0,0.108695652,10826
0fb711cb3ee1b6c85ad9d04ba75d37dcbd584014,1,Suresh Marru,2017-12-11 14:56:01-05:00,['f51745f19215fafaa81cec95990459c629629dfd'],1,32,33,13345829,2,0,1,1,10826
4ec92a79afbbcf4ed0c92be69c33379065d60ae4,0,Suresh Marru,2017-12-11 14:56:01-05:00,['0fb711cb3ee1b6c85ad9d04ba75d37dcbd584014'],0,56,56,13345885,2,1,1,1,10827
6cee9a24ee020d77097d1ca9b5569ab21905d020,0,Marcus Christie,2017-12-11 16:09:40-05:00,"['236455fdc2cd611e46e76eefa4716c74cbbbf444', '27ea5d50ae806d82abe2b07755729c949283c908']",1,3,4,13345889,3,,,,10827
edf17835bf8778ddbd3c49c02a719efa03e358f3,0,Marcus Christie,2017-12-11 16:10:07-05:00,"['4ec92a79afbbcf4ed0c92be69c33379065d60ae4', '27ea5d50ae806d82abe2b07755729c949283c908']",7,132,139,13346028,12,,,,10827
b5d2d37f959aa253f23353c25b02fa8bc09e8571,0,Marcus Christie,2017-12-12 16:45:14-05:00,['6cee9a24ee020d77097d1ca9b5569ab21905d020'],3,2,5,13346033,1,0,0,1,10827
dedbfc9e24075b55ac04cea49054e7794da54d46,0,Marcus Christie,2017-12-13 15:02:33-05:00,['b5d2d37f959aa253f23353c25b02fa8bc09e8571'],0,2,2,13346035,1,0,1,0,10827
7a9164fde6bf7434b5c957a6201a0123ead1ebd1,0,Marcus Christie,2017-12-13 15:13:42-05:00,['dedbfc9e24075b55ac04cea49054e7794da54d46'],1,6,7,13346042,1,0,1,1,10827
41d371bd7b4ee949b8d62db8791c2beab5e49ede,0,Marcus Christie,2017-12-13 15:17:06-05:00,"['edf17835bf8778ddbd3c49c02a719efa03e358f3', '7a9164fde6bf7434b5c957a6201a0123ead1ebd1']",80,91,171,13346213,7,,,,10827
a9978324633969bf821611cd1792cd97f469d9ff,0,Sneha Tilak,2017-12-13 19:24:51-05:00,"['8c90a50c049eafe0acac063ab8de90ea3d2c0ca8', '41d371bd7b4ee949b8d62db8791c2beab5e49ede']",31167,37610,68777,13414990,36,,,,10827
4153e2813fe8e2bfd161ebf70e4821206e68907b,0,Marcus Christie,2017-12-15 10:59:51-05:00,['41d371bd7b4ee949b8d62db8791c2beab5e49ede'],0,291,291,13415281,1,0.100917431,1,1,10828
d9505f3bdff99436578bac43d849032f84c0716c,0,Marcus Christie,2017-12-15 11:00:06-05:00,['4153e2813fe8e2bfd161ebf70e4821206e68907b'],0,1202,1202,13416483,14,1,1,1,10842
e6869352e168a8f7133b24acc866fcefb51e39fc,0,Marcus Christie,2017-12-15 11:00:36-05:00,['d9505f3bdff99436578bac43d849032f84c0716c'],0,122,122,13416605,6,1,1,1,10848
9edef9b8fd2d828472065856bb8e643f1904cd7d,0,Marcus Christie,2017-12-15 11:00:45-05:00,['e6869352e168a8f7133b24acc866fcefb51e39fc'],1,94,95,13416700,1,0.044444444,1,1,10848
4e0c9d0068e4ed5e8a1b85999086a98d19cb6a67,1,Marcus Christie,2017-12-15 11:00:55-05:00,['9edef9b8fd2d828472065856bb8e643f1904cd7d'],0,3917,3917,13420617,61,1,1,1,10909
3f2e05676e9205799afd2a8b80165fbd2e4add4d,1,Marcus Christie,2017-12-15 11:02:39-05:00,['4e0c9d0068e4ed5e8a1b85999086a98d19cb6a67'],558,879,1437,13422054,66,0.540540541,1,0.891891892,10912
c825fb0700f73af061903795f1ed1b4e313b80a1,1,Marcus Christie,2017-12-15 11:03:25-05:00,['3f2e05676e9205799afd2a8b80165fbd2e4add4d'],5,761,766,13422820,10,0.785276074,0.708588957,1,10921
5f5d035834cdaa568fead16ca3981b03214b9c5e,0,Marcus Christie,2017-12-15 11:03:45-05:00,['c825fb0700f73af061903795f1ed1b4e313b80a1'],7,0,7,13422827,1,,,,10921
6ded2896eb60592ae799ca0a23f872ff90756834,1,Marcus Christie,2017-12-15 11:03:53-05:00,['5f5d035834cdaa568fead16ca3981b03214b9c5e'],340,2321,2661,13425488,93,1,1,1,10923
71f642276e31582f91f8d712deba7ef539ba4ddf,0,Marcus Christie,2017-12-15 11:08:28-05:00,['6ded2896eb60592ae799ca0a23f872ff90756834'],0,299,299,13425787,2,0.298969072,0.432989691,1,10925
108dcd4538c46be323ad64cbb8011bf21c0b5744,0,Marcus Christie,2017-12-15 11:09:59-05:00,['71f642276e31582f91f8d712deba7ef539ba4ddf'],3,14,17,13425804,1,,,,10925
7e34167f4ea564607367a4f3aa70889954f644b8,0,Marcus Christie,2017-12-15 11:11:00-05:00,['108dcd4538c46be323ad64cbb8011bf21c0b5744'],0,7823,7823,13433627,5,0.624372093,0.827348837,0.986418605,10930
43f5817f3bceee953b1443535290586417bef930,0,Marcus Christie,2017-12-15 11:11:46-05:00,['7e34167f4ea564607367a4f3aa70889954f644b8'],253,0,253,13433880,2,0.701030928,0.567010309,0,10930
9599a91052e0a61f884c990a318bb86454f5b334,1,Marcus Christie,2017-12-15 11:13:28-05:00,['43f5817f3bceee953b1443535290586417bef930'],20,590,610,13434490,27,0.759562842,0.759562842,0.907103825,10949
e3c7d91653272532bd7b4738f63325d8d71c3ad9,0,Marcus Christie,2017-12-15 11:14:48-05:00,['9599a91052e0a61f884c990a318bb86454f5b334'],0,0,0,13434490,0,,,,10949
26f9d3dcdc7999e73aaff0bfa2589c1d0c7c5528,1,Marcus Christie,2017-12-15 11:18:05-05:00,['e3c7d91653272532bd7b4738f63325d8d71c3ad9'],265,438,703,13435193,4,0.096385542,0.240963855,0.740963855,10949
9cf12bda89e84d76a904766f2b58b95970e38dc9,1,Marcus Christie,2017-12-15 11:19:13-05:00,['26f9d3dcdc7999e73aaff0bfa2589c1d0c7c5528'],593,710,1303,13436496,8,0.828571429,0,0,10950
89af670fc3a4d0487dd1f1a58fb705b1e0052b3b,1,Marcus Christie,2017-12-15 11:19:31-05:00,['9cf12bda89e84d76a904766f2b58b95970e38dc9'],635,5627,6262,13442758,48,0.870615034,0.940774487,0.998177677,10993
6aefb7e46416a480a9046409d858b780f53ca528,0,Marcus Christie,2017-12-15 11:19:52-05:00,['89af670fc3a4d0487dd1f1a58fb705b1e0052b3b'],29,2,31,13442789,3,0,0,0,10993
78826ec657a0f8f283a74848e3c4021270bef11e,0,Marcus Christie,2017-12-15 11:40:19-05:00,['6aefb7e46416a480a9046409d858b780f53ca528'],8554,20,8574,13451363,28,0.389475537,0.193241816,0.01935938,10993
87d323cfbedad731e64bc22ecbdab5e75ad93eb6,0,Marcus Christie,2017-12-21 10:18:42-05:00,['b5d2d37f959aa253f23353c25b02fa8bc09e8571'],1,1,2,13451365,1,,,,10993
d70f9af377c33fb78bc448aef1ec386f1fc16884,0,Marcus Christie,2017-12-21 10:25:05-05:00,['87d323cfbedad731e64bc22ecbdab5e75ad93eb6'],1,6,7,13451372,1,,,,10993
c43640f30d33c4d19acf1ef46a746a663297d611,0,Eroma Abeysinghe,2017-12-21 10:53:19-05:00,['b5d2d37f959aa253f23353c25b02fa8bc09e8571'],0,83,83,13451455,2,,,,10995
274da25fcdbccbae7e7c9561392fba863bd69b29,0,Eroma Abeysinghe,2017-12-21 10:54:43-05:00,"['c43640f30d33c4d19acf1ef46a746a663297d611', 'd70f9af377c33fb78bc448aef1ec386f1fc16884']",2,7,9,13451464,2,,,,10995
807e1e7a9ffa2fbec6d604b2fd52c2459ce20ea1,0,Eroma Abeysinghe,2017-12-21 10:55:43-05:00,['274da25fcdbccbae7e7c9561392fba863bd69b29'],0,1,1,13451465,1,,,,10995
acf3a494d1bc8981ae743b849c11511c8a90656e,0,Eroma Abeysinghe,2017-12-21 11:09:05-05:00,['807e1e7a9ffa2fbec6d604b2fd52c2459ce20ea1'],1,1,2,13451467,1,,,,10995
1d69f66641b4e105f6d7fd64b5d02a715c37b290,0,Eroma Abeysinghe,2017-12-21 13:44:20-05:00,['acf3a494d1bc8981ae743b849c11511c8a90656e'],0,1,1,13451468,1,,,,10995
625732dfe2a0f24b7cb8f2d5d345c93cd69f828c,0,Eroma Abeysinghe,2017-12-21 14:35:53-05:00,['1d69f66641b4e105f6d7fd64b5d02a715c37b290'],0,1,1,13451469,1,,,,10995
e9d64b8e15004712587dff5a55b40747e89785f1,0,Eroma Abeysinghe,2017-12-21 14:50:12-05:00,['625732dfe2a0f24b7cb8f2d5d345c93cd69f828c'],0,1,1,13451470,1,,,,10995
8632150f66b590bce6ca81231b11c3a986343570,0,Suresh Marru,2017-12-21 21:14:54-05:00,['41d371bd7b4ee949b8d62db8791c2beab5e49ede'],1,1,2,13451472,1,,,,10995
a73ba7b13828bfa7edd2a4d19aa8ba233a93084b,0,Suresh Marru,2017-12-21 21:16:08-05:00,['e9d64b8e15004712587dff5a55b40747e89785f1'],1,1,2,13451474,1,,,,10995
a4acd74c14eb06a85d06e278c5fc1985aecbc352,1,Suresh Marru,2017-12-22 13:35:55-05:00,['78826ec657a0f8f283a74848e3c4021270bef11e'],7,87,94,13451568,4,1,1,1,10996
034b41a8ff5255c113b7096c1f38dfdbafbfb3b9,1,Suresh Marru,2017-12-22 13:35:55-05:00,['a4acd74c14eb06a85d06e278c5fc1985aecbc352'],28,140,168,13451736,10,0.696969697,0.696969697,1,10999
667cf6a78f3a1ca8869c5cd19d34f47df4bfb8f8,1,Suresh Marru,2017-12-22 13:35:55-05:00,['034b41a8ff5255c113b7096c1f38dfdbafbfb3b9'],64,59,123,13451859,3,1,0.105263158,0.210526316,10999
17c25b44b5cd3fe87fb31158b1daf326d0879be5,1,Suresh Marru,2017-12-22 13:35:55-05:00,['667cf6a78f3a1ca8869c5cd19d34f47df4bfb8f8'],40,1787,1827,13453686,14,0.311688312,0.651948052,0.963636364,11005
c974220c9bcc368558c94f4d1777a4bb205cab21,0,Suresh Marru,2017-12-22 13:35:55-05:00,['17c25b44b5cd3fe87fb31158b1daf326d0879be5'],5,0,5,13453691,1,0,0,0,11005
502650a16567196853dcc1dfc67db2f37419d3d9,1,Suresh Marru,2017-12-22 13:35:55-05:00,['c974220c9bcc368558c94f4d1777a4bb205cab21'],2,38,40,13453731,3,1,1,1,11005
e2d1c5b22e47dabdd5b4b2f04a601bba8a04f3a0,1,Sachin Kariyattin,2017-12-29 13:07:17-05:00,['502650a16567196853dcc1dfc67db2f37419d3d9'],122,890,1012,13454743,22,0.738241309,1,0.993865031,11008
353a60a62ef20ff577e78056797bf0aea77156a4,0,Sachin Kariyattin,2017-12-29 13:09:27-05:00,['e2d1c5b22e47dabdd5b4b2f04a601bba8a04f3a0'],14,91,105,13454848,5,1,1,1,11009
1ba6ca4cf5ef93adfa19cc16fab7a8e84cd5cf6a,1,Sachin Kariyattin,2017-12-29 14:53:02-05:00,['353a60a62ef20ff577e78056797bf0aea77156a4'],14,82,96,13454944,4,0.721311475,1,0.770491803,11009
dea1c5e52d73348738b2ec70666658770f5470cc,1,Sachin Kariyattin,2017-12-30 01:35:45-05:00,['1ba6ca4cf5ef93adfa19cc16fab7a8e84cd5cf6a'],22,279,301,13455245,6,0.180851064,0.14893617,1,11010
2fa1bfef3d1a28137bbe38cb302293f3536e49a8,0,Sachin Kariyattin,2017-12-30 17:55:05-05:00,['dea1c5e52d73348738b2ec70666658770f5470cc'],23,152,175,13455420,9,0.985074627,1,0.985074627,11014
15cc7feeac94d54253c1c151f136d53730ee4e5e,0,Eroma Abeysinghe,2018-01-04 09:38:08-05:00,['a73ba7b13828bfa7edd2a4d19aa8ba233a93084b'],0,75,75,13455495,1,,,,11015
104418900ee168f981553d684d40a9c471fc18ca,0,Eroma Abeysinghe,2018-01-04 14:34:31-05:00,['15cc7feeac94d54253c1c151f136d53730ee4e5e'],9,6,15,13455510,1,,,,11015
bcdd11923c2a71bebbd722cf3b7a9c25b3ea9dc0,0,Marcus Christie,2018-01-04 15:51:34-05:00,"['104418900ee168f981553d684d40a9c471fc18ca', '7a9164fde6bf7434b5c957a6201a0123ead1ebd1']",1,8,9,13455519,1,,,,11015
44dd8f16c7a08256a2e601a57c9107f2bef41340,0,Eroma Abeysinghe,2018-01-09 10:46:17-05:00,['bcdd11923c2a71bebbd722cf3b7a9c25b3ea9dc0'],0,21,21,13455540,1,,,,11016
bd4c6d8a8434512f00dc7401c1c44c046bb62484,0,Eroma Abeysinghe,2018-01-09 10:47:03-05:00,['44dd8f16c7a08256a2e601a57c9107f2bef41340'],13,13,26,13455566,1,,,,11016
5aec2a82d8d0bdb4d86face05c7163f4617aabbd,0,Eroma Abeysinghe,2018-01-09 15:47:23-05:00,['bd4c6d8a8434512f00dc7401c1c44c046bb62484'],0,1,1,13455567,1,,,,11016
80da3476f1ed5f6f0ba136a7d702345950addd43,0,Eroma Abeysinghe,2018-01-09 15:59:54-05:00,['5aec2a82d8d0bdb4d86face05c7163f4617aabbd'],0,1,1,13455568,1,,,,11016
08f09bc0855708b3d836531ea055597a31798a9c,0,Eroma Abeysinghe,2018-01-09 16:21:40-05:00,['80da3476f1ed5f6f0ba136a7d702345950addd43'],0,1,1,13455569,1,,,,11016
5a33b09fb975fdcd05a521b0a28799b98ae77caf,0,Eroma Abeysinghe,2018-01-09 16:27:59-05:00,['08f09bc0855708b3d836531ea055597a31798a9c'],0,1,1,13455570,1,,,,11016
ac7330b14257745d3c7a62135dbc8b2c7f1b700b,0,Eroma Abeysinghe,2018-01-09 16:33:07-05:00,['5a33b09fb975fdcd05a521b0a28799b98ae77caf'],0,1,1,13455571,1,,,,11016
e101d4349b7678a563f6a02a3b76b880ca79137b,0,Eroma Abeysinghe,2018-01-09 16:36:54-05:00,['ac7330b14257745d3c7a62135dbc8b2c7f1b700b'],0,1,1,13455572,1,,,,11016
c13c0c236c5a67fba794815ba12b2a7c60532c4a,0,Marcus Christie,2018-01-10 13:40:47-05:00,['8632150f66b590bce6ca81231b11c3a986343570'],1,1,2,13455574,1,,,,11016
ea518c0bcb035aea6f443e39e99f67de07b0bcad,1,Sachin Kariyattin,2018-01-15 01:33:51-05:00,['2fa1bfef3d1a28137bbe38cb302293f3536e49a8'],555,288,843,13456417,20,0.289256198,0.429752066,0.024793388,11016
6c536e3d270ce27bb9297e8d7a32bc8ad9fa633f,1,Sachin Kariyattin,2018-01-15 02:41:36-05:00,['ea518c0bcb035aea6f443e39e99f67de07b0bcad'],99,60,159,13456576,2,0.4,0,0.225,11016
1e3a51806026749821324b2a919ad659da7fa41c,1,Sachin Kariyattin,2018-01-16 02:33:59-05:00,['6c536e3d270ce27bb9297e8d7a32bc8ad9fa633f'],130,526,656,13457232,16,0.733009709,0.888349515,0.970873786,11018
6c1478c906fd0f1b209b5b0d2eb2317a68ed549d,0,dimuthu.upeksha2@gmail.com,2018-01-17 11:30:10-05:00,['8632150f66b590bce6ca81231b11c3a986343570'],2,33,35,13457267,2,0,0,1,11018
dc6ea56eb5435ec3f03d6a8226a44497e7290616,0,dimuthu.upeksha2@gmail.com,2018-01-17 14:29:51-05:00,['6c1478c906fd0f1b209b5b0d2eb2317a68ed549d'],8,9,17,13457284,1,1,1,0,11018
61b96843f40f42477556020c283f79b86262724d,0,dimuthu.upeksha2@gmail.com,2018-01-17 15:34:29-05:00,['dc6ea56eb5435ec3f03d6a8226a44497e7290616'],5,12,17,13457301,1,0,0,1,11018
766cbd82cdb9362944778957f6f095a474605c42,0,Marcus Christie,2018-01-18 11:30:37-05:00,['c13c0c236c5a67fba794815ba12b2a7c60532c4a'],0,10,10,13457311,9,,,,11018
0d77ff5e0a54af23c33b86096c8d0dd789d1e930,0,Marcus Christie,2018-01-18 11:31:42-05:00,['766cbd82cdb9362944778957f6f095a474605c42'],6028,15974,22002,13479313,48,0.315805243,0.547865169,0.768988764,11060
f13c17fe41bfdd1a4c8e35a88ab16f534190b523,0,Marcus Christie,2018-01-18 14:21:28-05:00,['e101d4349b7678a563f6a02a3b76b880ca79137b'],2,33,35,13479348,2,0,0,1,11060
02379098159a81612ed8cf4f73a5cef1e3eae9f9,0,Marcus Christie,2018-01-18 14:21:28-05:00,['f13c17fe41bfdd1a4c8e35a88ab16f534190b523'],8,9,17,13479365,1,1,1,0,11060
53888e12f9177d99b17194581f04b3f691305cc8,0,Marcus Christie,2018-01-18 14:21:28-05:00,['02379098159a81612ed8cf4f73a5cef1e3eae9f9'],5,12,17,13479382,1,0,0,1,11060
0f25c2f1dcb3f58a31cfad631d19bfbef714a349,0,Marcus Christie,2018-01-18 14:21:54-05:00,"['0d77ff5e0a54af23c33b86096c8d0dd789d1e930', '53888e12f9177d99b17194581f04b3f691305cc8']",12,242,254,13479636,19,,,,11060
298fadfebb58a38fbe9791a88fc13a4edaf2d389,0,Eroma Abeysinghe,2018-01-18 14:54:28-05:00,['53888e12f9177d99b17194581f04b3f691305cc8'],0,1,1,13479637,1,,,,11060
4a3ba811b645ee9313448c34f47c23517e4b56a5,0,Eroma Abeysinghe,2018-01-18 15:35:49-05:00,['298fadfebb58a38fbe9791a88fc13a4edaf2d389'],0,1,1,13479638,1,,,,11060
28d91cbb916ab1b7500b4914cfbf9945d16f5058,0,Sneha Tilak,2018-01-22 12:46:13-05:00,"['a9978324633969bf821611cd1792cd97f469d9ff', '0f25c2f1dcb3f58a31cfad631d19bfbef714a349']",6042,16228,22270,13501908,78,,,,11060
a24cf52f8dc50bd27ab417f880a118371fc9bda8,0,Marcus Christie,2018-01-22 13:03:50-05:00,['5e7e5c564f616f49c60f30825b7b37292e5c3617'],1,4,5,13501913,1,,,,11060
964aaab26547fb8979913d5be95875256e5248fe,0,Marcus Christie,2018-01-22 13:05:01-05:00,"['0f25c2f1dcb3f58a31cfad631d19bfbef714a349', 'a24cf52f8dc50bd27ab417f880a118371fc9bda8']",1,4,5,13501918,1,,,,11060
f4814b8c6fb070b3964acb2a1a13d1acbbc22c97,1,Sachin Kariyattin,2018-01-22 17:12:19-05:00,['964aaab26547fb8979913d5be95875256e5248fe'],1,18,19,13501937,1,0,1,1,11060
bc22d0da25fe151ed3f63b5427f7eb5ff6e40a50,0,Marcus Christie,2018-01-23 17:22:43-05:00,['964aaab26547fb8979913d5be95875256e5248fe'],0,1,1,13501938,1,0,1,1,11060
6f4ae172524119da280dacf290c04e27060aa5f2,0,Marcus Christie,2018-01-23 17:38:00-05:00,['bc22d0da25fe151ed3f63b5427f7eb5ff6e40a50'],3,5,8,13501946,1,0,1,1,11060
3ecbd3a4fe911053014bd3d066fec09dc83ecfd9,0,GitHub,2018-01-24 15:04:42-05:00,"['6f4ae172524119da280dacf290c04e27060aa5f2', 'f4814b8c6fb070b3964acb2a1a13d1acbbc22c97']",1,18,19,13501965,1,,,,11060
649bb6600375f70996ec2820a0dec5c61c258556,1,Sachin Kariyattin,2018-01-25 01:49:04-05:00,['3ecbd3a4fe911053014bd3d066fec09dc83ecfd9'],246,313,559,13502524,12,1,0.88,0.96,11060
aaffede901e4f15d3c2756a11134d314d3e130cd,0,Sneha Tilak,2018-01-26 13:20:11-05:00,"['28d91cbb916ab1b7500b4914cfbf9945d16f5058', '3ecbd3a4fe911053014bd3d066fec09dc83ecfd9']",4,27,31,13502555,2,,,,11060
bd8408c3cfdae8b0cd55ba6e8556fcc7dbf3d6ea,0,Sachin Kariyattin,2018-01-26 14:25:09-05:00,['1e3a51806026749821324b2a919ad659da7fa41c'],1,1,2,13502557,1,,,,11060
179ad8066da28999b63c32e50bd0a4088e0fc427,0,Gourav Shenoy,2018-01-26 16:14:30-05:00,['6f4ae172524119da280dacf290c04e27060aa5f2'],15,18,33,13502590,2,,,,11060
aff441a2f4f6a1579f4972f58854663de207ec6c,0,Gourav Shenoy,2018-01-26 16:14:41-05:00,"['179ad8066da28999b63c32e50bd0a4088e0fc427', '3ecbd3a4fe911053014bd3d066fec09dc83ecfd9']",1,18,19,13502609,1,,,,11060
4f4cbd6a17d62ce32ac151150a3c283725d050f0,1,Sachin Kariyattin,2018-01-27 21:52:15-05:00,['649bb6600375f70996ec2820a0dec5c61c258556'],26637,44228,70865,13573474,20,0.665981776,1,0.976683938,11060
0e58134737be984ed062c80bce4844892eab8f70,1,Sachin Kariyattin,2018-01-28 19:41:36-05:00,['4f4cbd6a17d62ce32ac151150a3c283725d050f0'],24673,27099,51772,13625246,30,0.525245679,0,0.997966791,11060
feff039c637da6f491cf074d5ebb234f28cb0e4d,0,Sachin Kariyattin,2018-01-28 19:42:48-05:00,"['0e58134737be984ed062c80bce4844892eab8f70', 'aff441a2f4f6a1579f4972f58854663de207ec6c']",15,18,33,13625279,2,,,,11060
211691d46e965f2c37054435a97c1ce47282b707,0,Marcus Christie,2018-01-29 08:53:28-05:00,"['aff441a2f4f6a1579f4972f58854663de207ec6c', 'b74c1c5f83dc8cb9bfde3c542ac07137eb2af3f1']",2,4,6,13625285,1,,,,11060
1692d9b2d37f188677187b5bf4a60b349ecd91fc,0,Marcus Christie,2018-01-29 08:55:10-05:00,"['4a3ba811b645ee9313448c34f47c23517e4b56a5', 'b74c1c5f83dc8cb9bfde3c542ac07137eb2af3f1']",2,4,6,13625291,1,,,,11060
e4b0b2cfe93b17169efa9cdb1754172f7dd77c5e,0,GitHub,2018-01-29 11:28:56-05:00,"['502650a16567196853dcc1dfc67db2f37419d3d9', 'bd8408c3cfdae8b0cd55ba6e8556fcc7dbf3d6ea']",706,2095,2801,13628092,48,,,,11060
43415f300a9a8cbce704637dd844168bf069ed8c,0,Sneha Tilak,2018-01-29 12:04:05-05:00,"['aaffede901e4f15d3c2756a11134d314d3e130cd', '211691d46e965f2c37054435a97c1ce47282b707']",17,22,39,13628131,3,,,,11060
6a600d04ca1bc90999776f2770b37677bbe5194d,0,dimuthu,2018-01-29 13:47:24-05:00,['a73ba7b13828bfa7edd2a4d19aa8ba233a93084b'],4,10,14,13628145,1,1,1,1,11060
49c5b5b49db802bf3d53e1d37c56714f753204ab,0,dimuthu,2018-01-29 14:35:41-05:00,['6a600d04ca1bc90999776f2770b37677bbe5194d'],3,3,6,13628151,1,,,,11060
a44fa60e5d1cf853b1b7a13a7b3ca779fdf6bd2b,0,GitHub,2018-01-29 15:44:49-05:00,"['1692d9b2d37f188677187b5bf4a60b349ecd91fc', '49c5b5b49db802bf3d53e1d37c56714f753204ab']",7,13,20,13628171,1,,,,11060
631f2ec919e11dc2d392b9d223a80bc1982750be,0,Sneha Tilak,2018-01-30 12:43:24-05:00,['e4b0b2cfe93b17169efa9cdb1754172f7dd77c5e'],32,135,167,13628338,21,1,1,1,11060
4dd82aea21cc3d4f9c94a6ecf6fdb76d14aa0811,1,Sneha Tilak,2018-01-30 15:26:50-05:00,['43415f300a9a8cbce704637dd844168bf069ed8c'],2823,8069,10892,13639230,6,0.47960251,0.577405858,0.981694561,11060
ba8ad4eaa1603e8f0865613a1cc31d4d2b67c085,0,Sneha Tilak,2018-01-30 15:32:15-05:00,['4dd82aea21cc3d4f9c94a6ecf6fdb76d14aa0811'],2,28,30,13639260,2,,,,11060
f5aaf3305418c72856f6927556ae78be6398963d,1,Sachin Kariyattin,2018-01-30 19:06:37-05:00,['feff039c637da6f491cf074d5ebb234f28cb0e4d'],209,204,413,13639673,28,1,1,0,11060
ccfecab1b50c39efe5ccada158c2fb479d7f6262,0,Sachin Kariyattin,2018-01-30 19:30:24-05:00,"['f5aaf3305418c72856f6927556ae78be6398963d', '211691d46e965f2c37054435a97c1ce47282b707']",2,4,6,13639679,1,,,,11060
2e933a76b129b1b87852504c263aac5376d89405,1,Marcus Christie,2018-01-31 13:23:42-05:00,['211691d46e965f2c37054435a97c1ce47282b707'],206,1402,1608,13641287,5,0.583710407,0.678733032,0.980769231,11060
3aee8241b96e7a9df46e8334655ac66bcd449366,0,GitHub,2018-01-31 13:53:42-05:00,"['211691d46e965f2c37054435a97c1ce47282b707', 'ccfecab1b50c39efe5ccada158c2fb479d7f6262']",14667,34746,49413,13690700,42,,,,11060
a0491486c681bae59a93ea259c10cfcca3a9f4ea,0,Marcus Christie,2018-02-01 09:53:48-05:00,['3aee8241b96e7a9df46e8334655ac66bcd449366'],0,1,1,13690701,1,0,1,1,11060
a123fc0d16627421d451dc4a466e0a75aa8940bf,1,Marcus Christie,2018-02-01 10:30:30-05:00,['a0491486c681bae59a93ea259c10cfcca3a9f4ea'],6,6,12,13690713,1,,,,11060
4c807911877542c08a5774a9bccb9da51f8162e8,1,Marcus Christie,2018-02-01 12:19:27-05:00,['a123fc0d16627421d451dc4a466e0a75aa8940bf'],436,303,739,13691452,9,1,0.243243243,1,11060
14ae2027f50ba0b30b112f181b32f2192f98f86c,0,Marcus Christie,2018-02-01 12:48:53-05:00,['4c807911877542c08a5774a9bccb9da51f8162e8'],3,3,6,13691458,1,,,,11060
73d52c9ee4c98eddb878a8975b734b9cfc6d1079,0,Marcus Christie,2018-02-02 09:39:43-05:00,['14ae2027f50ba0b30b112f181b32f2192f98f86c'],2,1,3,13691461,2,,,,11060
5091d6fb6b488e82ca0428d37e05db9e7d38ffd5,1,Marcus Christie,2018-02-02 13:13:18-05:00,['73d52c9ee4c98eddb878a8975b734b9cfc6d1079'],810,969,1779,13693240,17,0,0,0,11060
b26717b820cf6315d0438891866c93b8100d6641,0,Marcus Christie,2018-02-02 13:35:04-05:00,['5091d6fb6b488e82ca0428d37e05db9e7d38ffd5'],2020,2783,4803,13698043,5,0.588535032,0.740127389,0.979617834,11060
4679a8060a1b22ea62aefa020c714c151b024051,0,Marcus Christie,2018-02-02 16:43:49-05:00,['2e933a76b129b1b87852504c263aac5376d89405'],0,712,712,13698755,7,,,,11067
0e2918aff74858e6380b17dbb59ce12121c9484d,0,Marcus Christie,2018-02-02 17:33:38-05:00,['b26717b820cf6315d0438891866c93b8100d6641'],4,2,6,13698761,1,0,0,1,11067
8daae07d0dfd7184814bb45b8b210cc440ed2381,1,Sneha Tilak,2018-02-03 16:20:01-05:00,['631f2ec919e11dc2d392b9d223a80bc1982750be'],188,1436,1624,13700385,23,0.419525066,0.457783641,1,11071
715bcaeae35e7f47df9f04e7aa71eb113dfaf3c1,0,Marcus Christie,2018-02-04 09:54:22-05:00,['0e2918aff74858e6380b17dbb59ce12121c9484d'],1,1,2,13700387,1,,,,11071
665bed88e8bfc3b40a91905b8cdc99af9efbd9c9,0,Marcus Christie,2018-02-04 10:44:52-05:00,['715bcaeae35e7f47df9f04e7aa71eb113dfaf3c1'],44,10,54,13700441,6,,,,11071
7477deb46d806bbf31398bc3a6a8cb976b60570e,0,Marcus Christie,2018-02-04 10:45:20-05:00,['665bed88e8bfc3b40a91905b8cdc99af9efbd9c9'],0,3,3,13700444,1,,,,11071
1f39ac6d3e7a043c2eb40ab725ac5eb34753ae35,0,Marcus Christie,2018-02-04 10:53:42-05:00,['7477deb46d806bbf31398bc3a6a8cb976b60570e'],1,0,1,13700445,1,,,,11071
210cf4347df9aac9d0419e50c6c23be31f23c2b5,0,Eroma Abeysinghe,2018-02-06 13:18:37-05:00,['a44fa60e5d1cf853b1b7a13a7b3ca779fdf6bd2b'],0,1,1,13700446,1,,,,11071
50cd75f210de93171ba79094642a61b116e7a0e6,0,Sneha Tilak,2018-02-06 17:46:00-05:00,['4679a8060a1b22ea62aefa020c714c151b024051'],1,78,79,13700525,3,0,1,1,11072
a09ed5e5be6140bdf07e6e585eb5b7802b64f0b5,0,Eroma Abeysinghe,2018-02-09 11:50:30-05:00,['210cf4347df9aac9d0419e50c6c23be31f23c2b5'],0,1,1,13700526,1,,,,11072
e271719abd7054ab9947fa6e888d856a0ed7e781,0,Marcus Christie,2018-02-09 15:28:38-05:00,['1f39ac6d3e7a043c2eb40ab725ac5eb34753ae35'],19,251,270,13700796,2,0.304093567,0.549707602,0.83625731,11072
5e793c559d660fa7503a9d9004ea660fb1e8f2aa,0,Marcus Christie,2018-02-09 15:31:46-05:00,['a09ed5e5be6140bdf07e6e585eb5b7802b64f0b5'],0,1,1,13700797,1,,,,11072
9991e44be2d5328a1ecc3475693c3b82fbe8cd7a,0,Marcus Christie,2018-02-09 15:58:00-05:00,['5e793c559d660fa7503a9d9004ea660fb1e8f2aa'],0,7,7,13700804,2,,,,11073
e67ed305058f39fec16080dbd6dfeb89defda6dc,0,Marcus Christie,2018-02-09 15:59:16-05:00,"['e271719abd7054ab9947fa6e888d856a0ed7e781', '9991e44be2d5328a1ecc3475693c3b82fbe8cd7a']",7,25,32,13700836,5,,,,11073
c571592952446d27c8fb5667a86262bd60377111,1,Sachin Kariyattin,2018-02-10 16:15:04-05:00,['bd8408c3cfdae8b0cd55ba6e8556fcc7dbf3d6ea'],1,6656,6657,13707493,21,0.349690634,0.37337316,0.978664391,11089
9954bbb79a33d0a4f8353fa96207dc88dfb3c2d9,1,Sachin Kariyattin,2018-02-10 18:21:24-05:00,['c571592952446d27c8fb5667a86262bd60377111'],248,255,503,13707996,15,1,0.983870968,0.403225806,11092
8913c632ea76f6fbfa87ca28b11a75cf438b73f8,1,Sachin Kariyattin,2018-02-12 17:00:09-05:00,['9954bbb79a33d0a4f8353fa96207dc88dfb3c2d9'],266,971,1237,13709233,22,0.311023622,0.437007874,0.921259843,11093
880af05f93ede2ed0505c48f3858b5940e1cac1e,1,Sachin Kariyattin,2018-02-13 02:00:55-05:00,['8913c632ea76f6fbfa87ca28b11a75cf438b73f8'],2460,18826,21286,13730519,6,0.55096258,0.67655638,0.963413618,11093
75963c3776ef03d6451722e126d8734f358a7cf3,0,Marcus Christie,2018-02-13 11:05:47-05:00,['4679a8060a1b22ea62aefa020c714c151b024051'],3,92,95,13730614,3,,,,11095
42f4553360274b3c07239d96933d4a3003db3e49,0,Marcus Christie,2018-02-13 11:26:48-05:00,['75963c3776ef03d6451722e126d8734f358a7cf3'],0,2,2,13730616,1,,,,11095
8d4a65e10875b00ea52b1541ccd1447cbe676109,0,dimuthu,2018-02-13 12:02:17-05:00,['a73ba7b13828bfa7edd2a4d19aa8ba233a93084b'],29,333,362,13730978,24,0,0,1,11098
731862957db942003695559dc26a74a47c8bfe50,1,Sachin Kariyattin,2018-02-13 13:19:04-05:00,['880af05f93ede2ed0505c48f3858b5940e1cac1e'],28369,51151,79520,13810498,3,0.398286693,0.421302113,0.950371216,11098
bf0cc5ee00da606c984274d7109e743301bc443a,0,Sachin Kariyattin,2018-02-13 13:19:17-05:00,"['731862957db942003695559dc26a74a47c8bfe50', 'e4b0b2cfe93b17169efa9cdb1754172f7dd77c5e']",0,0,0,13810498,0,,,,11098
bf6ef8bcc4b95f219932c13ed32ca1653d1d805c,1,dimuthu,2018-02-13 15:55:29-05:00,['8d4a65e10875b00ea52b1541ccd1447cbe676109'],30,44,74,13810572,8,0,0,1,11098
4da2c5f4298630c51a9a96c65fcdfaea7ea11907,0,dimuthu,2018-02-13 18:54:38-05:00,['bf6ef8bcc4b95f219932c13ed32ca1653d1d805c'],12,29,41,13810613,7,,,,11098
7c0716e18d38da91c4e806c52fc2136598cf600a,1,Sachin Kariyattin,2018-02-15 16:27:58-05:00,['bf0cc5ee00da606c984274d7109e743301bc443a'],5437,521,5958,13816571,24,0.840753425,0.955234834,0.195205479,11098
fd4729b8164f83f15a45a8fded4ead765e13ac74,1,Sachin Kariyattin,2018-02-15 16:31:38-05:00,['7c0716e18d38da91c4e806c52fc2136598cf600a'],20,16,36,13816607,1,,,,11098
9411399b5ca875459d65094b582b3c5601b56fdc,0,Sneha Tilak,2018-02-15 17:07:29-05:00,['ba8ad4eaa1603e8f0865613a1cc31d4d2b67c085'],17,19,36,13816643,2,0,0,1,11098
8581a9e150d534c1fdf88be37eccb137d75214e7,1,Sachin Kariyattin,2018-02-15 21:16:40-05:00,['fd4729b8164f83f15a45a8fded4ead765e13ac74'],180,813,993,13817636,8,0.386516854,0.435955056,0.993258427,11099
47980a4e23c1929fb12f4003fc107b7cdf55779a,0,GitHub,2018-02-16 09:54:49-05:00,"['e4b0b2cfe93b17169efa9cdb1754172f7dd77c5e', '8581a9e150d534c1fdf88be37eccb137d75214e7']",31158,73386,104544,13922180,33,,,,11099
86a290836a9c6a92a82bc7fa7a6d3bbe17f949a6,0,Marcus Christie,2018-02-16 09:55:53-05:00,['e67ed305058f39fec16080dbd6dfeb89defda6dc'],85,0,85,13922265,3,,,,11099
75ff81755b52c2263c63c26e238d0debed1c1964,0,Marcus Christie,2018-02-16 09:56:25-05:00,"['42f4553360274b3c07239d96933d4a3003db3e49', '47980a4e23c1929fb12f4003fc107b7cdf55779a']",31354,90783,122137,14044402,189,,,,11099
919337453d72eaab5814091e6f56d9aea4406ad3,1,Marcus Christie,2018-02-16 10:03:11-05:00,"['75ff81755b52c2263c63c26e238d0debed1c1964', '86a290836a9c6a92a82bc7fa7a6d3bbe17f949a6']",16048,37047,53095,14097497,62,,,,11099
4c4e817e788080a91be107fdb8b4782f5fc8b7a2,0,Marcus Christie,2018-02-16 11:17:09-05:00,['919337453d72eaab5814091e6f56d9aea4406ad3'],31,40,71,14097568,3,0,1,0.666666667,11099
4f429ef0185dd5d91436b4a241c9483ae3d6c0ba,0,dimuthu,2018-02-16 13:57:10-05:00,['4da2c5f4298630c51a9a96c65fcdfaea7ea11907'],2,2,4,14097572,1,,,,11099
5f1e81f880cbd8e495f9fafbe80aa0daf80374d9,0,dimuthu,2018-02-19 13:45:00-05:00,['4f429ef0185dd5d91436b4a241c9483ae3d6c0ba'],2,2,4,14097576,2,,,,11099
3a2e1befce1476e8dda6847abbfbd1e73468f21f,0,dimuthu,2018-02-19 13:45:40-05:00,['5f1e81f880cbd8e495f9fafbe80aa0daf80374d9'],2,2,4,14097580,1,,,,11099
d6fa1cf95bf06265a10c0ecfd8bab10ec6187e7a,0,dimuthu,2018-02-19 13:46:15-05:00,['3a2e1befce1476e8dda6847abbfbd1e73468f21f'],1,1,2,14097582,1,,,,11099
7eae3f9f36ab0411c9bf62f2cdfd21e8d53804f0,1,dimuthu,2018-02-19 13:48:41-05:00,['d6fa1cf95bf06265a10c0ecfd8bab10ec6187e7a'],34,55,89,14097671,2,0,0.058823529,1,11099
8cbbda80724ebcafd1157e5397462bdabc52c1ee,0,Sneha Tilak,2018-02-19 13:52:06-05:00,['9411399b5ca875459d65094b582b3c5601b56fdc'],0,7,7,14097678,1,0,0,1,11099
9f06e0fa4f4a8b3f53a67043197739d2da1dc18e,0,dimuthu,2018-02-19 13:56:45-05:00,['7eae3f9f36ab0411c9bf62f2cdfd21e8d53804f0'],8,1,9,14097687,1,,,,11099
5fe2c6ffaea494af81c1317843c1d8b2588f75d7,0,Sneha Tilak,2018-02-19 14:11:03-05:00,['50cd75f210de93171ba79094642a61b116e7a0e6'],3,7,10,14097697,2,0,1,1,11099
6eaa6932315cf48b5bd2bd6e08ac2f05d075a01e,0,Sneha Tilak,2018-02-19 14:12:57-05:00,"['5fe2c6ffaea494af81c1317843c1d8b2588f75d7', '4c4e817e788080a91be107fdb8b4782f5fc8b7a2']",66236,146764,213000,14310697,252,,,,11099
b88bed0f7c20fbc08d49fca148a795d364cb815b,0,Sneha Tilak,2018-02-19 14:18:38-05:00,"['8daae07d0dfd7184814bb45b8b210cc440ed2381', '47980a4e23c1929fb12f4003fc107b7cdf55779a']",31158,73386,104544,14415241,33,,,,11099
1f5066aec84b42b2bccf59ee8c57be14bba67f0e,0,dimuthu,2018-02-19 14:42:21-05:00,['9f06e0fa4f4a8b3f53a67043197739d2da1dc18e'],2,2,4,14415245,2,,,,11099
882722cd0dd4285ea82f46de1e893a812a138e56,0,Marcus Christie,2018-02-19 15:25:54-05:00,"['a09ed5e5be6140bdf07e6e585eb5b7802b64f0b5', '1f5066aec84b42b2bccf59ee8c57be14bba67f0e']",43,392,435,14415680,27,,,,11099
37b06e241cf361b36f6081386ac4eb9dacc7a56f,0,Marcus Christie,2018-02-19 15:29:14-05:00,"['86a290836a9c6a92a82bc7fa7a6d3bbe17f949a6', '882722cd0dd4285ea82f46de1e893a812a138e56']",44,392,436,14416116,27,,,,11099
a5444550bd96ead54b9fcaa0c058b78e7ccf270b,0,Marcus Christie,2018-02-19 16:10:49-05:00,['882722cd0dd4285ea82f46de1e893a812a138e56'],1,1,2,14416118,1,,,,11099
49ff096b2c8601e397e71de21e3b8fc06515e85d,0,Marcus Christie,2018-02-19 16:11:19-05:00,['a5444550bd96ead54b9fcaa0c058b78e7ccf270b'],11,0,11,14416129,2,,,,11099
04724f08b06109ff923b9e4efd29c2ba2d410133,0,Marcus Christie,2018-02-19 16:14:14-05:00,"['37b06e241cf361b36f6081386ac4eb9dacc7a56f', '49ff096b2c8601e397e71de21e3b8fc06515e85d']",12,1,13,14416142,3,,,,11099
25b5a0c88df2706bde00514d0939c3b736e46879,1,Sneha Tilak,2018-02-19 16:21:21-05:00,"['8cbbda80724ebcafd1157e5397462bdabc52c1ee', '4c4e817e788080a91be107fdb8b4782f5fc8b7a2']",64100,146547,210647,14626789,264,,,,11099
3c3345d1160a7d9b1295b14daf3de1c4c213913d,0,Marcus Christie,2018-02-19 17:09:19-05:00,['49ff096b2c8601e397e71de21e3b8fc06515e85d'],4,7,11,14626800,6,,,,11099
cce75c89ab14be0974043cc05c047194e76406c7,0,Marcus Christie,2018-02-19 17:09:34-05:00,"['04724f08b06109ff923b9e4efd29c2ba2d410133', '3c3345d1160a7d9b1295b14daf3de1c4c213913d']",4,7,11,14626811,6,,,,11099
3be90c6bc3af105688ef65f0ba156ed91b205cfe,0,Marcus Christie,2018-02-20 10:27:54-05:00,['3c3345d1160a7d9b1295b14daf3de1c4c213913d'],2,2,4,14626815,1,,,,11099
2ec390286fbcff103ff6ad16c58ca3011de1dc8b,0,Marcus Christie,2018-02-20 10:29:58-05:00,"['a09ed5e5be6140bdf07e6e585eb5b7802b64f0b5', '3be90c6bc3af105688ef65f0ba156ed91b205cfe']",47,388,435,14627250,31,,,,11099
7b67c1a8b7971a720b3ca931e9c4baf70e429d50,0,GitHub,2018-02-20 11:53:38-05:00,"['4c4e817e788080a91be107fdb8b4782f5fc8b7a2', '25b5a0c88df2706bde00514d0939c3b736e46879']",2692,8419,11111,14638361,17,,,,11099
b1fa867cb2ce5034b263a585f2bb502a19f9fb15,1,Marcus Christie,2018-02-20 12:16:52-05:00,['7b67c1a8b7971a720b3ca931e9c4baf70e429d50'],185,220,405,14638766,6,1,1,1,11099
a6beeb552933e8ebf0d657d85bfd6792577d1888,1,Marcus Christie,2018-02-20 13:20:53-05:00,['b1fa867cb2ce5034b263a585f2bb502a19f9fb15'],10,137,147,14638913,4,0.213114754,0.836065574,1,11100
264c8d4cdd16e2cdbda5f55002f123a08e4eba42,0,Sneha Tilak,2018-02-20 13:26:01-05:00,"['6eaa6932315cf48b5bd2bd6e08ac2f05d075a01e', 'a6beeb552933e8ebf0d657d85bfd6792577d1888']",2703,8592,11295,14650208,18,,,,11100
a782fd713b6bb5a6df2ab33ac60027f7aa901049,1,Marcus Christie,2018-02-20 16:30:32-05:00,['a6beeb552933e8ebf0d657d85bfd6792577d1888'],61,370,431,14650639,7,0.378947368,0,0.368421053,11100
fc9fb2e357ca49d0ac39a944fa7656531111d485,0,Sachin Kariyattin,2018-02-20 23:35:30-05:00,['a6beeb552933e8ebf0d657d85bfd6792577d1888'],268,3055,3323,14653962,4,0.458689459,0.610636277,0.924976258,11100
dce7caa5cef66e87cc80bdf0b362a7c4cb1cea48,0,dimuthu,2018-02-21 12:24:52-05:00,['a6beeb552933e8ebf0d657d85bfd6792577d1888'],10,29,39,14654001,1,0,0,1,11100
c9a1b064bb71dd936bb7f480bf4d7703ba7ad9a0,1,dimuthu,2018-02-21 13:31:29-05:00,['8632150f66b590bce6ca81231b11c3a986343570'],0,5575,5575,14659576,69,0.540069686,0.720867209,0.821525358,11168
484e2d8813bbf269b2acbdc593bfcb2eb8372fee,0,Sachin Kariyattin,2018-02-21 13:37:36-05:00,['fc9fb2e357ca49d0ac39a944fa7656531111d485'],0,2,2,14659578,2,0,1,1,11168
1da4d8ee4f9483172174093cc73125df3286f4c5,1,Marcus Christie,2018-02-21 14:26:31-05:00,['47980a4e23c1929fb12f4003fc107b7cdf55779a'],6,10,16,14659594,2,,,,11168
cda2c82d28f0bc5009005da129148412b45884a9,0,Marcus Christie,2018-02-21 14:27:02-05:00,"['a782fd713b6bb5a6df2ab33ac60027f7aa901049', '1da4d8ee4f9483172174093cc73125df3286f4c5']",6,10,16,14659610,2,,,,11168
f9dfb7747b07e630a196f44f5781fc5930ec2d69,0,Sachin Kariyattin,2018-02-21 16:41:13-05:00,['1da4d8ee4f9483172174093cc73125df3286f4c5'],3,5,8,14659618,2,0,0,1,11168
53e684e65863dd20669d14eaf7f589c610101ff6,0,GitHub,2018-02-21 16:48:43-05:00,"['1da4d8ee4f9483172174093cc73125df3286f4c5', 'f9dfb7747b07e630a196f44f5781fc5930ec2d69']",3,5,8,14659626,2,,,,11168
9c7fa9930d42149df3722d3bbd86295e77f929b2,0,Marcus Christie,2018-02-21 16:49:05-05:00,"['cda2c82d28f0bc5009005da129148412b45884a9', '53e684e65863dd20669d14eaf7f589c610101ff6']",3,5,8,14659634,2,,,,11168
1f2edf897a26f0916bc4a670cc76c02e3af0cc4f,0,Sachin Kariyattin,2018-02-21 18:50:34-05:00,['f9dfb7747b07e630a196f44f5781fc5930ec2d69'],0,1,1,14659635,1,,,,11168
e93a09decbcd541fa9ea3851493d59678add9b84,1,Marcus Christie,2018-02-22 09:20:19-05:00,['9c7fa9930d42149df3722d3bbd86295e77f929b2'],1,3,4,14659639,1,0,0,1,11168
ef94a5afd073359b0d75b72f51b254670953b7e2,0,dimuthu,2018-02-22 09:37:36-05:00,['c9a1b064bb71dd936bb7f480bf4d7703ba7ad9a0'],221,1275,1496,14661135,12,0.627371274,0.711382114,0.966124661,11170
93c0ffd04b058e33c015181999008847c8ae5537,0,GitHub,2018-02-22 09:42:31-05:00,"['e93a09decbcd541fa9ea3851493d59678add9b84', '484e2d8813bbf269b2acbdc593bfcb2eb8372fee']",268,3057,3325,14664460,6,,,,11170
c8bc672fc5b467c8f67f069a7395a545bf353a04,1,Marcus Christie,2018-02-22 10:09:33-05:00,['93c0ffd04b058e33c015181999008847c8ae5537'],1,1,2,14664462,1,,,,11170
7fe25f18b1aa97a2b8ff1674b98afec05ca09ab0,0,Marcus Christie,2018-02-22 10:31:18-05:00,['c8bc672fc5b467c8f67f069a7395a545bf353a04'],4,9,13,14664475,1,1,1,0,11170
5144f67d7a8e297427c47bc9cffa184219aab8de,0,dimuthu,2018-02-22 11:51:09-05:00,"['61b96843f40f42477556020c283f79b86262724d', 'cce75c89ab14be0974043cc05c047194e76406c7']",21848,53362,75210,14739685,165,,,,11170
97f03cc04c90fb4ef7c2450260e970a22a69761a,0,Marcus Christie,2018-02-22 11:56:08-05:00,['7fe25f18b1aa97a2b8ff1674b98afec05ca09ab0'],8,9,17,14739702,1,1,0,1,11170
508b89575d7bfe95a991dbdfd64d8b7b89fb1e70,0,dimuthu,2018-02-22 11:58:29-05:00,['5144f67d7a8e297427c47bc9cffa184219aab8de'],35,54,89,14739791,1,0,0,1,11170
b6c2e134bd768881351e7218209ef1b697556dd2,0,GitHub,2018-02-22 12:01:33-05:00,"['cce75c89ab14be0974043cc05c047194e76406c7', '508b89575d7bfe95a991dbdfd64d8b7b89fb1e70']",35,54,89,14739880,1,,,,11170
5a3575baa4590bc888c046f39708854870f88ecf,0,Marcus Christie,2018-02-22 12:21:15-05:00,['53e684e65863dd20669d14eaf7f589c610101ff6'],1,1,2,14739882,1,,,,11170
6a45f36ea8e3eb4bdc6364ae1a41243e40533007,0,Marcus Christie,2018-02-22 12:21:54-05:00,"['97f03cc04c90fb4ef7c2450260e970a22a69761a', '5a3575baa4590bc888c046f39708854870f88ecf']",1,1,2,14739884,1,,,,11170
978fafb2684b62f13c96a856e9118f3fa7752238,0,Sneha Tilak,2018-02-22 13:42:55-05:00,['264c8d4cdd16e2cdbda5f55002f123a08e4eba42'],0,15,15,14739899,2,0,1,1,11170
630348c2416b4b93d0042c41a932ed5cffcd5ebd,0,Sneha Tilak,2018-02-22 13:56:42-05:00,"['978fafb2684b62f13c96a856e9118f3fa7752238', '6a45f36ea8e3eb4bdc6364ae1a41243e40533007']",353,3465,3818,14743717,21,,,,11170
799ab29b4b3eded8dfc3faeb07c487847e8dc660,0,Sneha Tilak,2018-02-22 13:57:33-05:00,"['b88bed0f7c20fbc08d49fca148a795d364cb815b', '5a3575baa4590bc888c046f39708854870f88ecf']",10,16,26,14743743,5,,,,11170
74a9b796f726eee2b7428adeb2aefac8007858ad,0,Marcus Christie,2018-02-22 16:03:47-05:00,['5a3575baa4590bc888c046f39708854870f88ecf'],10,10,20,14743763,1,,,,11170
9755a1b9bb1cf3a93fe5762fce729b835964d683,0,Marcus Christie,2018-02-22 16:04:10-05:00,"['6a45f36ea8e3eb4bdc6364ae1a41243e40533007', '74a9b796f726eee2b7428adeb2aefac8007858ad']",10,10,20,14743783,1,,,,11170
c78f8df700f58054f2c8f6f549a3d3918b0f3203,0,dimuthu,2018-02-22 16:19:29-05:00,['dce7caa5cef66e87cc80bdf0b362a7c4cb1cea48'],2,19,21,14743804,1,0.166666667,0.166666667,0.833333333,11170
a967aeead69c51ce6c611715389d6cde5d831916,0,GitHub,2018-02-22 16:27:42-05:00,"['9755a1b9bb1cf3a93fe5762fce729b835964d683', 'c78f8df700f58054f2c8f6f549a3d3918b0f3203']",12,48,60,14743864,2,,,,11170
e100d6d7c36a35fac405182555379f1abc084c2b,1,Marcus Christie,2018-02-22 16:51:44-05:00,['a967aeead69c51ce6c611715389d6cde5d831916'],6927,12880,19807,14763671,10,0.2522014,0.248814631,0.779634229,11173
cb2918ba69dfc80d74c6017539e38a991597ae28,0,Sneha Tilak,2018-02-22 19:09:39-05:00,['799ab29b4b3eded8dfc3faeb07c487847e8dc660'],484,164,648,14764319,7,1,1,0,11176
433800846fcaa9d254fe598af0958fec9431cc75,0,dimuthu,2018-02-23 01:16:12-05:00,['b6c2e134bd768881351e7218209ef1b697556dd2'],1,1,2,14764321,1,,,,11176
85c222b7c7f7d20aba1597f1a0ca813bbca27aaa,0,GitHub,2018-02-23 01:19:06-05:00,"['b6c2e134bd768881351e7218209ef1b697556dd2', '433800846fcaa9d254fe598af0958fec9431cc75']",1,1,2,14764323,1,,,,11176
b99f51636f691c0016aad3198d007395c0fe3016,0,Marcus Christie,2018-02-23 01:19:54-05:00,['e100d6d7c36a35fac405182555379f1abc084c2b'],30,37,67,14764390,1,1,1,1,11176
b0b32f7318cd75adb9bca6f5dc51564528a4aa61,0,Marcus Christie,2018-02-23 01:22:19-05:00,"['b99f51636f691c0016aad3198d007395c0fe3016', '85c222b7c7f7d20aba1597f1a0ca813bbca27aaa']",77,417,494,14764884,33,,,,11176
02aaa54f01e94be23b32d09cddcb78f2f8d07cde,0,Sneha Tilak,2018-02-23 01:59:47-05:00,['cb2918ba69dfc80d74c6017539e38a991597ae28'],1,3,4,14764888,1,1,1,1,11176
c9a27c3bac9fc2e72e709073bbc56cc5bdd6c1b2,0,Marcus Christie,2018-02-23 02:55:51-05:00,['b0b32f7318cd75adb9bca6f5dc51564528a4aa61'],14,14,28,14764916,1,,,,11176
3bb568819b80ce8d83794eeab2d2d6c881a2775c,0,Marcus Christie,2018-02-23 03:05:13-05:00,['c9a27c3bac9fc2e72e709073bbc56cc5bdd6c1b2'],4,4,8,14764924,1,,,,11176
e8a299eb507c0f2f817072641f6ef6c3fefdfa66,1,Marcus Christie,2018-02-23 03:50:16-05:00,['3bb568819b80ce8d83794eeab2d2d6c881a2775c'],8,55,63,14764987,4,0,0.795454545,1,11176
b199bc2090ff9bc8b9c5827adeedcbfbfe181cc0,0,dimuthu,2018-02-26 01:11:29-05:00,['ef94a5afd073359b0d75b72f51b254670953b7e2'],183,242,425,14765412,16,0,0,1,11176
712480159c71b151fcfded27e9d03e60d505f7a4,0,Marcus Christie,2018-02-26 12:57:46-05:00,['85c222b7c7f7d20aba1597f1a0ca813bbca27aaa'],28,22,50,14765462,12,1,1,0,11176
4c8902d93ae62068962ca09ba0ee81bd1b31b1aa,1,Sneha Tilak,2018-02-26 17:15:43-05:00,['630348c2416b4b93d0042c41a932ed5cffcd5ebd'],621,828,1449,14766911,9,0.321052632,0.047368421,0.710526316,11176
da26401aa2c05745cd3406901ba595eadd0f705f,0,Sneha Tilak,2018-02-26 17:16:20-05:00,"['4c8902d93ae62068962ca09ba0ee81bd1b31b1aa', 'e8a299eb507c0f2f817072641f6ef6c3fefdfa66']",7079,13462,20541,14787452,50,,,,11176
5534a5ab5eab613b587618a96d0558d4047994f5,0,Sneha Tilak,2018-02-26 17:18:43-05:00,"['02aaa54f01e94be23b32d09cddcb78f2f8d07cde', '74a9b796f726eee2b7428adeb2aefac8007858ad']",10,10,20,14787472,1,,,,11176
2c87d35adf824b692476db08b55d75eede5c4840,0,Sneha Tilak,2018-02-26 17:23:42-05:00,['da26401aa2c05745cd3406901ba595eadd0f705f'],1,1,2,14787474,1,,,,11176
72e2149039b99f5e5ae3bf4ae0c1e439140f58a1,1,Sachin Kariyattin,2018-02-27 01:17:04-05:00,['e8a299eb507c0f2f817072641f6ef6c3fefdfa66'],100,408,508,14787982,15,0.193548387,0.188940092,1,11178
871b1d591366cc0100b48a5ae7a934310bf8d3ec,0,Sachin Kariyattin,2018-02-27 02:14:19-05:00,['72e2149039b99f5e5ae3bf4ae0c1e439140f58a1'],19,13,32,14788014,2,0,0,1,11178
cb54e4df2eb5ae453290a5d29cd3c0a8033c993d,0,dimuthu,2018-02-27 11:04:32-05:00,['b199bc2090ff9bc8b9c5827adeedcbfbfe181cc0'],45,75,120,14788134,4,0,0,1,11178
a3dcf67731043bf9f92016c97e92000c1944ec18,1,Sneha Tilak,2018-02-27 15:24:07-05:00,['2c87d35adf824b692476db08b55d75eede5c4840'],624,787,1411,14789545,11,0.292517007,0.047619048,0.43537415,11178
bc327369dc97cb9aac1d1b8f8b3f0117270256fa,0,Sneha Tilak,2018-02-27 16:31:03-05:00,['a3dcf67731043bf9f92016c97e92000c1944ec18'],3,10,13,14789558,1,0,0,0,11178
f24581389e7e71baff48ba08fef0ecf05739a81d,1,Sneha Tilak,2018-02-27 17:44:45-05:00,['bc327369dc97cb9aac1d1b8f8b3f0117270256fa'],2,5,7,14789565,2,0,1,1,11178
c76f9ac28f23722dd72f73e92b8e7fd8349ac205,0,Sneha Tilak,2018-02-27 17:56:59-05:00,['f24581389e7e71baff48ba08fef0ecf05739a81d'],0,10,10,14789575,1,,,,11178
1b6af5d5b53e99ca200c4105e4cf1e1c282437fd,0,Sachin Kariyattin,2018-02-27 18:05:23-05:00,['871b1d591366cc0100b48a5ae7a934310bf8d3ec'],42,69,111,14789686,1,0,1,1,11178
fb0944c50d638940b360297b0f96f18075ad949f,1,Sneha Tilak,2018-02-27 18:46:44-05:00,['c76f9ac28f23722dd72f73e92b8e7fd8349ac205'],1,3,4,14789690,1,0,0,1,11178
855bb6700f1e6bea4cbf38a562d47ebd84ebe050,0,Sachin Kariyattin,2018-02-28 14:40:59-05:00,['1b6af5d5b53e99ca200c4105e4cf1e1c282437fd'],6,6,12,14789702,1,,,,11178
001a6f5192911b2b6e071a83aec09201f05ac1b5,1,Sachin Kariyattin,2018-02-28 17:24:31-05:00,['855bb6700f1e6bea4cbf38a562d47ebd84ebe050'],14,244,258,14789960,9,0.359375,0.078125,0.921875,11178
2e5563c2421c1fe6d875e7ae681968e1e5768c9a,0,Sneha Tilak,2018-02-28 20:30:18-05:00,['fb0944c50d638940b360297b0f96f18075ad949f'],46,130,176,14790136,6,0,0.814285714,1,11178
e6bed20ecf26cc5ea67c1aa1316a722b0839fe60,0,Sneha Tilak,2018-02-28 20:48:45-05:00,['2e5563c2421c1fe6d875e7ae681968e1e5768c9a'],5,0,5,14790141,1,,,,11178
7350b253564a91e4a6ebcd8df3673c69f3d1ba92,1,dimuthu,2018-03-01 12:27:31-05:00,['cb54e4df2eb5ae453290a5d29cd3c0a8033c993d'],30,673,703,14790844,18,0.223587224,0.314496314,0.825552826,11183
5783ef9c12fac630ad1087268d08e00ce03de685,0,GitHub,2018-03-01 13:08:19-05:00,"['e8a299eb507c0f2f817072641f6ef6c3fefdfa66', '855bb6700f1e6bea4cbf38a562d47ebd84ebe050']",101,430,531,14791375,14,,,,11183
b731c30edf34fe20bd98158c8a14f374e1d58a25,0,Sachin Kariyattin,2018-03-01 13:55:48-05:00,"['001a6f5192911b2b6e071a83aec09201f05ac1b5', '5783ef9c12fac630ad1087268d08e00ce03de685']",0,0,0,14791375,0,,,,11183
fe0199b7dce9d4be713ab75cbe8c5f96b58bd6e8,1,Sachin Kariyattin,2018-03-01 14:03:24-05:00,['b731c30edf34fe20bd98158c8a14f374e1d58a25'],1,2,3,14791378,2,,,,11183
584cda3a84db64017aa1a1ea63e5c502faeea1b1,0,Sneha Tilak,2018-03-01 14:21:46-05:00,"['e6bed20ecf26cc5ea67c1aa1316a722b0839fe60', '5783ef9c12fac630ad1087268d08e00ce03de685']",101,430,531,14791909,14,,,,11183
563f6250c97100155a9ca00a9058e45a60fadb3c,0,Marcus Christie,2018-03-01 15:10:08-05:00,"['5783ef9c12fac630ad1087268d08e00ce03de685', '712480159c71b151fcfded27e9d03e60d505f7a4']",28,22,50,14791959,12,,,,11183
7ac86f67b25e358023b08ca7ffcfaba52ba6539c,0,Sneha Tilak,2018-03-01 15:13:04-05:00,"['5534a5ab5eab613b587618a96d0558d4047994f5', '563f6250c97100155a9ca00a9058e45a60fadb3c']",21846,70768,92614,14884573,217,,,,11183
9dc2f64eb8af956fc262a4a72ea546b040f02bdc,0,Sneha Tilak,2018-03-01 15:37:32-05:00,['7ac86f67b25e358023b08ca7ffcfaba52ba6539c'],0,8,8,14884581,1,1,1,1,11183
26872262b983143f78697d5a1de46d7d60a5f4d4,0,Sneha Tilak,2018-03-01 16:36:45-05:00,['9dc2f64eb8af956fc262a4a72ea546b040f02bdc'],2,23,25,14884606,2,1,1,1,11183
573dbab1a29f1bf2f1fdb8c9cacdb7ad42b105ad,0,dimuthu,2018-03-02 13:16:49-05:00,['7350b253564a91e4a6ebcd8df3673c69f3d1ba92'],15,92,107,14884713,10,0.05,0.033333333,1,11183
4e1c1b0f1156f6453b81b7a58a30a196545e2489,0,dimuthu,2018-03-02 16:58:42-05:00,['573dbab1a29f1bf2f1fdb8c9cacdb7ad42b105ad'],0,1316,1316,14886029,14,0.455128205,0.596153846,1,11196
42ff5f4e2fbdbb1421f686b702a5eb76918bb4d3,0,dimuthu,2018-03-04 13:21:55-05:00,['4e1c1b0f1156f6453b81b7a58a30a196545e2489'],9,460,469,14886498,12,0.506976744,0.586046512,0.879069767,11200
ca455645a09da0c8184a741c7ee5cb3853338d70,0,dimuthu,2018-03-04 20:48:23-05:00,['42ff5f4e2fbdbb1421f686b702a5eb76918bb4d3'],37,102,139,14886637,5,0.159090909,0.931818182,0.886363636,11200
1c3a5d4eca7a3fd455adea1ce56437ec21499bd7,0,dimuthu,2018-03-05 08:46:53-05:00,['ca455645a09da0c8184a741c7ee5cb3853338d70'],79,266,345,14886982,13,0.288590604,0.919463087,0.724832215,11201
f51f1f16ff687768f7cfade2b92e66b84bd105d8,1,dimuthu,2018-03-05 23:08:52-05:00,['1c3a5d4eca7a3fd455adea1ce56437ec21499bd7'],28,33,61,14887043,1,0,1,1,11201
71075e0d6bfcf00047fe271188eff3cf46a8982b,0,dimuthu,2018-03-05 23:09:33-05:00,['f51f1f16ff687768f7cfade2b92e66b84bd105d8'],43,84,127,14887170,11,0.766666667,0.9,0.866666667,11201
782b0e81242604961dba675fc02386698cce48b9,0,dimuthu,2018-03-05 23:18:03-05:00,['71075e0d6bfcf00047fe271188eff3cf46a8982b'],72,62,134,14887304,31,,,,11201
39a011e18b317b4529a363af69bc302c5a273c11,0,dimuthu,2018-03-06 13:14:49-05:00,['2ec390286fbcff103ff6ad16c58ca3011de1dc8b'],1,13,14,14887318,1,,,,11201
cf8a98ab9542b162b7c0ad4b82df83c30d8cd7c3,0,Sneha Tilak,2018-03-06 18:36:10-05:00,['26872262b983143f78697d5a1de46d7d60a5f4d4'],34,213,247,14887565,7,0.047244094,0.937007874,1,11202
44a1f643e8ab51263d1970c4752da7185702cccc,0,Sneha Tilak,2018-03-06 22:06:28-05:00,['cf8a98ab9542b162b7c0ad4b82df83c30d8cd7c3'],103,224,327,14887892,8,0.030769231,1,1,11203
aaf65563dfa48c9fdf236ef29a3e0743613e1de9,0,Sneha Tilak,2018-03-06 22:36:33-05:00,['44a1f643e8ab51263d1970c4752da7185702cccc'],200,200,400,14888292,4,1,0,0,11203
a4b16f2e55d8e318da3c31352fe0e59340af4586,0,Sneha Tilak,2018-03-06 22:47:02-05:00,['aaf65563dfa48c9fdf236ef29a3e0743613e1de9'],23,5,28,14888320,1,0.5,0.166666667,0,11203
5f89fb8bf61bdabc15e4b4f8e10b16fe4ac47399,0,Sneha Tilak,2018-03-07 10:40:57-05:00,['a4b16f2e55d8e318da3c31352fe0e59340af4586'],1,5,6,14888326,2,0,1,1,11203
35847f99a0765c70c1882d964e1626bebeb49afa,0,GitHub,2018-03-07 12:50:16-05:00,['39a011e18b317b4529a363af69bc302c5a273c11'],0,11,11,14888337,1,,,,11203
e864db36b93cc0b55bb4255d699ca851f711005c,0,dimuthu,2018-03-07 13:42:32-05:00,['782b0e81242604961dba675fc02386698cce48b9'],89,1460,1549,14889886,26,0,0,0.909090909,11219
a726a987afed70e0662c4f689c1e4a56a2837967,0,dimuthu,2018-03-07 14:02:48-05:00,['e864db36b93cc0b55bb4255d699ca851f711005c'],0,0,0,14889886,41,,,,11219
005341372d92414a0e5589ec039cd209d32de030,0,dimuthu,2018-03-07 14:09:58-05:00,['a726a987afed70e0662c4f689c1e4a56a2837967'],3,3,6,14889892,3,,,,11219
71b294ed957cdddf6a08bf32f690c8204fedf3af,0,dimuthu,2018-03-07 16:09:50-05:00,['005341372d92414a0e5589ec039cd209d32de030'],472,314,786,14890678,16,1,0.537313433,0.567164179,11219
0164795986172459be287c930eaa6192336b5c52,0,dimuthu,2018-03-07 16:22:18-05:00,['71b294ed957cdddf6a08bf32f690c8204fedf3af'],56,1279,1335,14892013,80,0,0,0,11219
5d985b6d939a6aac9c58f51f260729c7294a7d8e,0,Sneha Tilak,2018-03-07 23:37:09-05:00,['5f89fb8bf61bdabc15e4b4f8e10b16fe4ac47399'],13,55,68,14892081,4,0,0,0,11219
8c1ff2e8218d9355ad78dab6f7b529cd35664b35,0,Sneha Tilak,2018-03-07 23:41:54-05:00,['5d985b6d939a6aac9c58f51f260729c7294a7d8e'],13,615,628,14892709,34,,,,11219
21d059c2c280a4b3a9a019f11d8b6900d42fbe4d,0,Sneha Tilak,2018-03-07 23:47:50-05:00,['8c1ff2e8218d9355ad78dab6f7b529cd35664b35'],4,4,8,14892717,4,,,,11219
4e63595f87736b0ffcdceb0fa93b5e5c89bd1e6f,0,dimuthu,2018-03-08 11:11:17-05:00,['0164795986172459be287c930eaa6192336b5c52'],0,4,4,14892721,1,,,,11219
59f4e5871e63e5e9bc7794462541aa758fdd35a8,0,Sachin Kariyattin,2018-03-08 23:05:39+05:18,['35847f99a0765c70c1882d964e1626bebeb49afa'],0,11,11,14892732,1,,,,11219
24aa025a548df30f66402d52d12d06f3732ed630,0,GitHub,2018-03-08 14:14:12-05:00,"['563f6250c97100155a9ca00a9058e45a60fadb3c', '584cda3a84db64017aa1a1ea63e5c502faeea1b1']",659,1226,1885,14894617,18,,,,11219
c56bfdfd8095d4b3678ffd8edd4edf750063f10c,0,Sneha Tilak,2018-03-08 15:55:19-05:00,['21d059c2c280a4b3a9a019f11d8b6900d42fbe4d'],8,28,36,14894653,2,0,1,1,11219
bc0016f65dfb0146c92bbd76cc25cb93650748ea,1,dimuthu,2018-03-08 17:11:29-05:00,['4e63595f87736b0ffcdceb0fa93b5e5c89bd1e6f'],14,79,93,14894746,4,0.235294118,0.294117647,0.941176471,11219
7bc9d5018675cc9ebd74cb264b00e3325d5ed82c,0,Sneha Tilak,2018-03-08 19:23:25-05:00,"['c56bfdfd8095d4b3678ffd8edd4edf750063f10c', '24aa025a548df30f66402d52d12d06f3732ed630']",664,1236,1900,14896646,22,,,,11219
acfd49b56f6408241fe5b50bcaf34f71db794c2b,0,Sneha Tilak,2018-03-08 20:01:58-05:00,['7bc9d5018675cc9ebd74cb264b00e3325d5ed82c'],12,38,50,14896696,4,0.111111111,1,1,11219
a05fd1d33ad81b2d3a5c5452573e52ba042f47c2,0,Sneha Tilak,2018-03-08 20:16:23-05:00,['acfd49b56f6408241fe5b50bcaf34f71db794c2b'],7,6,13,14896709,5,,,,11219
f00eb1c1e7e5807a8e2406c8e217dc721931af4c,0,Sneha Tilak,2018-03-08 20:19:16-05:00,['a05fd1d33ad81b2d3a5c5452573e52ba042f47c2'],3,2,5,14896714,1,1,0,0,11219
19b8afc740aaa988734b9a199af7a4dcfd908881,0,Sneha Tilak,2018-03-09 16:37:48-05:00,['f00eb1c1e7e5807a8e2406c8e217dc721931af4c'],0,3,3,14896717,1,,,,11219
48a308c6f40ad13df68f8bfb162c6a681a237b4c,0,GitHub,2018-03-09 18:24:56-05:00,"['24aa025a548df30f66402d52d12d06f3732ed630', 'fe0199b7dce9d4be713ab75cbe8c5f96b58bd6e8']",14,245,259,14896976,10,,,,11219
dea3e958ecba2e94da7d6b1da4e2390a6ddf8422,1,Sachin Kariyattin,2018-03-11 02:34:49+05:18,['fe0199b7dce9d4be713ab75cbe8c5f96b58bd6e8'],52,389,441,14897417,6,0,0.686206897,0.903448276,11219
1c75cf02c877ee90d119152d0eff720195baf3ae,0,Sachin Kariyattin,2018-03-11 02:35:07+05:18,"['dea3e958ecba2e94da7d6b1da4e2390a6ddf8422', '48a308c6f40ad13df68f8bfb162c6a681a237b4c']",687,1248,1935,14899352,30,,,,11219
b6d3d148a5f5f8a4e1f84718e657a1b5e632e671,0,Sachin Kariyattin,2018-03-11 02:55:29+05:18,['1c75cf02c877ee90d119152d0eff720195baf3ae'],1,1,2,14899354,1,,,,11219
97c6d5cc818442ad95ddd728899bc2e20f90f9a0,0,Sachin Kariyattin,2018-03-11 14:06:54+05:18,['48a308c6f40ad13df68f8bfb162c6a681a237b4c'],2,11,13,14899367,1,0,1,0.545454545,11219
7e3ce48a1d08b26a5557751d8f28be9fdad8f878,0,Sachin Kariyattin,2018-03-11 14:08:17+05:18,"['b6d3d148a5f5f8a4e1f84718e657a1b5e632e671', '97c6d5cc818442ad95ddd728899bc2e20f90f9a0']",2,11,13,14899380,1,,,,11219
ab8435b2574e555736059ef0e81800293e4a02bb,0,dimuthu,2018-03-12 10:06:38-04:00,['bc0016f65dfb0146c92bbd76cc25cb93650748ea'],99,29,128,14899508,6,,,,11219
07e898432fe9e9252609d438f9429a8e12662392,0,dimuthu,2018-03-12 11:03:28-04:00,"['ab8435b2574e555736059ef0e81800293e4a02bb', '712480159c71b151fcfded27e9d03e60d505f7a4']",21867,53426,75293,14974801,164,,,,11219
a03b8e538badec33acecf52b09597d9fffefa5be,0,dimuthu,2018-03-12 11:12:45-04:00,"['712480159c71b151fcfded27e9d03e60d505f7a4', '07e898432fe9e9252609d438f9429a8e12662392']",29,11950,11979,14986780,108,,,,11219
07fbfe15b790373b4bbfe0a85452c9a6d5ef26f0,0,Sachin Kariyattin,2018-03-13 21:28:06+05:18,['1f2edf897a26f0916bc4a670cc76c02e3af0cc4f'],64,940,1004,14987784,14,0.231124807,0.252696456,1,11221
1b968ebb0b3dd4c8692d5416393138e9d70a55ec,0,Sachin Kariyattin,2018-03-13 21:28:22+05:18,"['07fbfe15b790373b4bbfe0a85452c9a6d5ef26f0', '24aa025a548df30f66402d52d12d06f3732ed630']",21866,71355,93221,15081005,220,,,,11221
901ed05ae7362607693e3c3119b1589cc136b0e2,0,Sachin Kariyattin,2018-03-13 23:07:24+05:18,['1b968ebb0b3dd4c8692d5416393138e9d70a55ec'],13,12,25,15081030,2,0,0,0,11221
97e452170a2461a1699a8b29d95d8407b6b0a80d,0,Sachin Kariyattin,2018-03-13 23:10:40+05:18,['901ed05ae7362607693e3c3119b1589cc136b0e2'],0,19,19,15081049,1,,,,11221
b15077f0d0dda1371223d86ac19891ddec8c8fb0,0,Sachin Kariyattin,2018-03-13 23:25:32+05:18,['97e452170a2461a1699a8b29d95d8407b6b0a80d'],1,0,1,15081050,1,,,,11221
749051217240d14c21c3fd292c081961966e8a14,0,Sneha Tilak,2018-03-13 18:36:22-04:00,['19b8afc740aaa988734b9a199af7a4dcfd908881'],12,0,12,15081062,2,0,0,0,11221
47ca36f70af8d078a33f1b2e180fdfb7e7da6c5c,0,Sneha Tilak,2018-03-13 18:07:21-07:00,['563f6250c97100155a9ca00a9058e45a60fadb3c'],0,734,734,15081796,6,1,1,1,11227
358a3f8cb8b72d6b7d5d7416cb7642286d967119,0,Eroma Abeysinghe,2018-03-14 02:44:17-04:00,['a09ed5e5be6140bdf07e6e585eb5b7802b64f0b5'],0,82,82,15081878,2,,,,11229
2c5f4c5fcbe3bc08786c807cc38d1ad13c8f4714,0,Marcus Christie,2018-03-14 09:54:57-04:00,['59f4e5871e63e5e9bc7794462541aa758fdd35a8'],1,0,1,15081879,1,,,,11229
880e208a4f6c61a31d21c984f947fc385087c597,0,Marcus Christie,2018-03-14 09:55:29-04:00,"['a03b8e538badec33acecf52b09597d9fffefa5be', '2c5f4c5fcbe3bc08786c807cc38d1ad13c8f4714']",4,37,41,15081920,3,,,,11229
710f7b7b8c37dec425e416f081bd0ec06bf7511a,0,Sneha Tilak,2018-03-14 14:30:36-07:00,['47ca36f70af8d078a33f1b2e180fdfb7e7da6c5c'],9,357,366,15082286,6,0.857142857,1,0.706349206,11232
d54ec428940e6ad8d22a3102d0df711da3c57548,0,Sneha Tilak,2018-03-14 15:07:25-07:00,['710f7b7b8c37dec425e416f081bd0ec06bf7511a'],2,1,3,15082289,1,,,,11232
f9d9c7ce254178ac071f39338e22231d29121d1b,0,Sneha Tilak,2018-03-14 15:14:40-07:00,['d54ec428940e6ad8d22a3102d0df711da3c57548'],0,3,3,15082292,1,,,,11232
dce8a86adfedfa9ea25d59c11dab37219a978782,0,Sneha Tilak,2018-03-14 15:15:20-07:00,['f9d9c7ce254178ac071f39338e22231d29121d1b'],0,97,97,15082389,1,0.236363636,1,1,11233
e1ccbf8169e461c602d7748f38845a550e27f507,0,dimuthu,2018-03-15 13:21:18-04:00,['2c5f4c5fcbe3bc08786c807cc38d1ad13c8f4714'],104,182,286,15082675,4,0,0,0,11233
e9dd9a47573d564d862f0668f6f2e76cda48864a,0,Marcus Christie,2018-03-15 14:32:01-04:00,['2c5f4c5fcbe3bc08786c807cc38d1ad13c8f4714'],1,1,2,15082677,1,,,,11233
fb59d8d87b1b4505921a1ddec75347b08b0eac65,0,Eroma Abeysinghe,2018-03-15 16:28:50-04:00,['358a3f8cb8b72d6b7d5d7416cb7642286d967119'],0,738,738,15083415,18,,,,11251
afe33c8d035292fa59bced09f6592f867bbf7866,0,Eroma Abeysinghe,2018-03-15 16:29:31-04:00,"['fb59d8d87b1b4505921a1ddec75347b08b0eac65', 'e9dd9a47573d564d862f0668f6f2e76cda48864a']",49,423,472,15083887,32,,,,11251
367a68af4a6da5cdf2659673161b0a21d4f6bf01,0,dimuthu,2018-03-16 17:35:53-04:00,['e1ccbf8169e461c602d7748f38845a550e27f507'],25,80,105,15083992,1,0,0,0,11251
a0aabcf31f59846cb8a3973b3e9694e06a22ec75,0,Sneha Tilak,2018-03-19 10:52:35-07:00,['dce8a86adfedfa9ea25d59c11dab37219a978782'],54,24,78,15084070,1,1,0.290322581,0.612903226,11251
ce6478e6622c1cddf8e629ae2782c52f18076ae5,1,dimuthu,2018-03-19 16:32:37-04:00,['880e208a4f6c61a31d21c984f947fc385087c597'],49,225,274,15084344,8,0.054347826,0.043478261,1,11252
1cb80a02a32a5a6f6ec0becb73483b962ef682b1,0,dimuthu,2018-03-21 10:54:28-04:00,['ce6478e6622c1cddf8e629ae2782c52f18076ae5'],4,6,10,15084354,5,,0,,11252
3cd7bf8b2924b1f6a7fcd575c77ecece4cb78b01,0,Sneha Tilak,2018-03-22 16:03:58-04:00,['24aa025a548df30f66402d52d12d06f3732ed630'],279,381,660,15085014,10,1,1,1,11254
a812582e7a75ae3ed3dcadbda92f4a735dd5fa5d,0,Sneha Tilak,2018-03-22 16:09:24-04:00,['97c6d5cc818442ad95ddd728899bc2e20f90f9a0'],32,135,167,15085181,21,1,1,1,11254
03fc65dcf5c394f4b340d8b6ea095dffe388d1f8,1,Sneha Tilak,2018-03-22 16:13:18-04:00,['a812582e7a75ae3ed3dcadbda92f4a735dd5fa5d'],188,1436,1624,15086805,23,0.419525066,0.457783641,1,11258
32b58e3f456f3e6c31320af1a4545a6cd6f697fa,0,Sneha Tilak,2018-03-22 16:13:18-04:00,['03fc65dcf5c394f4b340d8b6ea095dffe388d1f8'],484,164,648,15087453,7,1,1,0,11261
305b8167a521b0ded83940ab31f91e4ad1b0d33f,0,Sneha Tilak,2018-03-22 16:13:18-04:00,['32b58e3f456f3e6c31320af1a4545a6cd6f697fa'],1,3,4,15087457,1,1,1,1,11261
ceb32e9a6191cbdcc3ec44fd2ae174109b0ade97,0,Sneha Tilak,2018-03-22 16:13:18-04:00,['305b8167a521b0ded83940ab31f91e4ad1b0d33f'],0,8,8,15087465,1,1,1,1,11261
1396102984a65c9d64d88086c2b2124e9cdceb56,0,Sneha Tilak,2018-03-22 16:13:18-04:00,['ceb32e9a6191cbdcc3ec44fd2ae174109b0ade97'],2,23,25,15087490,2,1,1,1,11261
4819cc8c5e8e77d9d2afe5222bea57d546e9e63a,1,Sneha Tilak,2018-03-22 16:13:18-04:00,['1396102984a65c9d64d88086c2b2124e9cdceb56'],34,213,247,15087737,7,0.047244094,0.937007874,1,11262
05fd715d80fc1585e57f0c0c8fcf66c771771f97,1,Sneha Tilak,2018-03-22 16:13:18-04:00,['4819cc8c5e8e77d9d2afe5222bea57d546e9e63a'],103,224,327,15088064,8,0.030769231,1,1,11263
cda1a7a5a888f06f033fc771a47e14fd68f97efd,0,Sneha Tilak,2018-03-22 16:13:18-04:00,['05fd715d80fc1585e57f0c0c8fcf66c771771f97'],200,200,400,15088464,4,1,0,0,11263
2777056ea714c1e04412cf8e982606dd58eca65f,0,Sneha Tilak,2018-03-22 16:15:03-04:00,['cda1a7a5a888f06f033fc771a47e14fd68f97efd'],23,5,28,15088492,1,0.5,0.166666667,0.111111111,11263
e7503a3cdfbcf1e8d541bc21f6816ddbc0604093,0,Sneha Tilak,2018-03-22 16:15:03-04:00,['2777056ea714c1e04412cf8e982606dd58eca65f'],1,5,6,15088498,2,0,1,1,11263
343f13f57c46046158b04e2ddb89d714d7cefeb4,0,Sneha Tilak,2018-03-22 16:15:03-04:00,['e7503a3cdfbcf1e8d541bc21f6816ddbc0604093'],13,55,68,15088566,4,0,0,0,11263
ad0466c7745874ac298ec58b670d912962886d0d,0,Sneha Tilak,2018-03-22 16:15:03-04:00,['343f13f57c46046158b04e2ddb89d714d7cefeb4'],13,615,628,15089194,34,,,,11263
a4f63fcffd39b1edeca1fcc88b45d4da3009e734,0,Sneha Tilak,2018-03-22 16:15:03-04:00,['ad0466c7745874ac298ec58b670d912962886d0d'],4,4,8,15089202,4,,,,11263
cb39b7d74b46d930dded4181be7fdd7bad93c6f0,0,Sneha Tilak,2018-03-22 16:15:03-04:00,['a4f63fcffd39b1edeca1fcc88b45d4da3009e734'],8,28,36,15089238,2,0,1,1,11263
37e2164774faf1277355c0b84f7e64ed9158f22d,0,Sneha Tilak,2018-03-22 16:16:01-04:00,['cb39b7d74b46d930dded4181be7fdd7bad93c6f0'],13,40,53,15089291,4,0.111111111,1,1,11263
63cebd9bbebf260f94bcfb22d713e060f263de00,0,Sneha Tilak,2018-03-22 16:17:28-04:00,['37e2164774faf1277355c0b84f7e64ed9158f22d'],8,8,16,15089307,5,1,1,0,11263
c7a5be154b51f7844c45d33e2d29baee32baaf13,0,Sneha Tilak,2018-03-22 16:17:28-04:00,['63cebd9bbebf260f94bcfb22d713e060f263de00'],3,2,5,15089312,1,1,0,0,11263
902178100d5abec09c6f811220f3fb80e5b7af5b,0,Sneha Tilak,2018-03-22 16:17:28-04:00,['c7a5be154b51f7844c45d33e2d29baee32baaf13'],0,3,3,15089315,1,,,,11263
adfbc2bdb7771700de62f006c286499c9d5124b4,0,Sneha Tilak,2018-03-22 16:17:28-04:00,['902178100d5abec09c6f811220f3fb80e5b7af5b'],12,0,12,15089327,2,0,0,0,11263
acddc8b7c49e63a42dc6e5468cec82b4560de118,0,Sneha Tilak,2018-03-22 16:24:21-04:00,"['adfbc2bdb7771700de62f006c286499c9d5124b4', '749051217240d14c21c3fd292c081961966e8a14']",4,9,13,15089340,4,,,,11263
1eb01cd0f1f93f89c2feb2c10fa292099123b2ea,0,Sneha Tilak,2018-03-22 16:47:42-04:00,['97c6d5cc818442ad95ddd728899bc2e20f90f9a0'],0,734,734,15090074,6,1,1,1,11269
0dd45dca7fd35e3dee119216e5ebc55a519e69a8,0,Sneha Tilak,2018-03-22 16:47:42-04:00,['1eb01cd0f1f93f89c2feb2c10fa292099123b2ea'],9,357,366,15090440,6,0.857142857,1,0.706349206,11272
602ddd6dd1074d74d09cf39e14ed96f1f2f85d13,0,Sneha Tilak,2018-03-22 16:47:42-04:00,['0dd45dca7fd35e3dee119216e5ebc55a519e69a8'],2,1,3,15090443,1,,,,11272
9187ac6ce4b508adcdb07d88c889e5f159707eb4,1,Sneha Tilak,2018-03-22 16:47:42-04:00,['602ddd6dd1074d74d09cf39e14ed96f1f2f85d13'],0,3,3,15090446,1,,,,11272
bb7e8b1a2e0e100954514e277009cf93733bc72e,0,Sneha Tilak,2018-03-22 16:47:42-04:00,['9187ac6ce4b508adcdb07d88c889e5f159707eb4'],0,97,97,15090543,1,0.236363636,1,1,11273
8cd0e5a0759f34a13e9190a3cbb0cdf25f83fe1b,1,Sneha Tilak,2018-03-22 16:47:42-04:00,['bb7e8b1a2e0e100954514e277009cf93733bc72e'],54,24,78,15090621,1,1,0.290322581,0.612903226,11273
4f40d75c07e6c7bacccf179c8184d421c7a2dbc3,1,Sneha Tilak,2018-03-22 16:48:43-04:00,['97c6d5cc818442ad95ddd728899bc2e20f90f9a0'],279,381,660,15091281,10,1,1,1,11275
9d7c805506f98f205cec0ff3b09c581893032018,0,Sneha Tilak,2018-03-22 16:54:50-04:00,"['4f40d75c07e6c7bacccf179c8184d421c7a2dbc3', '3cd7bf8b2924b1f6a7fcd575c77ecece4cb78b01']",0,0,0,15091281,0,,,,11275
5a7eafa0dd12999464ae7a434e1437bd3f5527b6,0,Sneha Tilak,2018-03-22 16:55:55-04:00,"['8cd0e5a0759f34a13e9190a3cbb0cdf25f83fe1b', 'a0aabcf31f59846cb8a3973b3e9694e06a22ec75']",0,0,0,15091281,0,,,,11275
150d310923eabfbfd68f1e63b81b7331c94364d7,1,Sneha Tilak,2018-03-23 13:30:48-04:00,['acddc8b7c49e63a42dc6e5468cec82b4560de118'],80,167,247,15091528,3,0.472727273,0.818181818,0.963636364,11275
722695fb61a9b929c3964052b4d7c29cbafe43df,0,Sneha Tilak,2018-03-23 13:53:24-04:00,['5a7eafa0dd12999464ae7a434e1437bd3f5527b6'],9,39,48,15091576,1,0.8,1,0.5,11275
1e090ffda8521b299cdbf512be061888171cf83a,0,dimuthu,2018-03-23 15:10:17-04:00,['1cb80a02a32a5a6f6ec0becb73483b962ef682b1'],59,347,406,15091982,13,0.367149758,0.603864734,0.787439614,11277
a826a983facb5951a5f48fd5e26c8c53cb6c8b13,0,Sneha Tilak,2018-03-23 16:46:10-04:00,['150d310923eabfbfd68f1e63b81b7331c94364d7'],24,26,50,15092032,1,,,,11277
9292821d004de823222e0edebd8b485160ab2667,0,Sneha Tilak,2018-03-23 16:48:23-04:00,['722695fb61a9b929c3964052b4d7c29cbafe43df'],23,24,47,15092079,1,,,,11277
251fed8e2fa8cbb93f686de19a535f7e9681ff51,0,Sneha Tilak,2018-03-23 18:46:36-04:00,['9292821d004de823222e0edebd8b485160ab2667'],73,29,102,15092181,7,0,0,0.714285714,11277
701c8f68d097aa5144a7280ff835c089080e52b7,0,Sneha Tilak,2018-03-23 18:49:55-04:00,['a826a983facb5951a5f48fd5e26c8c53cb6c8b13'],30,0,30,15092211,6,,,,11277
2ce7e3b815d053a53a8117b80e0fe28696191d5f,0,Sneha Tilak,2018-03-24 12:23:18-04:00,['9d7c805506f98f205cec0ff3b09c581893032018'],21,6,27,15092238,5,,,,11277
9dc731ed1c35c46621bbcce6072fdfe8ab8fe710,0,Sneha Tilak,2018-03-24 18:00:17-04:00,['2ce7e3b815d053a53a8117b80e0fe28696191d5f'],135,5,140,15092378,2,0.825,0,0,11277
3dd82638ebae02f48f6bb1451b6cffaea63b12eb,1,Sneha Tilak,2018-03-24 18:03:03-04:00,['9dc731ed1c35c46621bbcce6072fdfe8ab8fe710'],4,573,577,15092955,9,0.709543568,0.89626556,0.904564315,11283
b9cf983103dc968e3d18c7c7bf2126a6a2162dd5,0,Sneha Tilak,2018-03-24 18:20:26-04:00,['701c8f68d097aa5144a7280ff835c089080e52b7'],39,3,42,15092997,4,0,0,0,11283
5f182f0704c08f72e51204bccc037a51d87c267b,0,dimuthu,2018-03-24 22:41:46-04:00,['1e090ffda8521b299cdbf512be061888171cf83a'],21,215,236,15093233,6,0.216216216,0.171171171,0.900900901,11284
72bece3017c345e88dd23b1765c078bb04745114,0,dimuthu,2018-03-26 11:50:38-04:00,['5f182f0704c08f72e51204bccc037a51d87c267b'],210,840,1050,15094283,29,0.683060109,0.775956284,0.972677596,11296
797027c59ffb12bfd568761f6e767dac24f298d3,0,dimuthu,2018-03-26 12:06:10-04:00,['72bece3017c345e88dd23b1765c078bb04745114'],157,1,158,15094441,4,0,0,0,11296
7b2050668d4fceace02e9e50215e0f4599f80b0a,0,dimuthu,2018-03-26 12:06:50-04:00,['797027c59ffb12bfd568761f6e767dac24f298d3'],2,5,7,15094448,1,1,1,1,11296
b0987c550b27841e56ffc06122d1ac5bef444ea9,0,Marcus Christie,2018-03-26 16:50:27-04:00,"['afe33c8d035292fa59bced09f6592f867bbf7866', 'a24cf52f8dc50bd27ab417f880a118371fc9bda8']",16849,26782,43631,15138079,48,,,,11296
9d83c913bbea36045ad5ee846e38bc6bb187abac,0,Marcus Christie,2018-03-26 16:58:04-04:00,['b0987c550b27841e56ffc06122d1ac5bef444ea9'],0,3,3,15138082,1,,,,11296
91f4fef39c34652401e2ff3c2e34842ac6b352a7,0,dimuthu,2018-03-26 17:13:20-04:00,['7b2050668d4fceace02e9e50215e0f4599f80b0a'],9,16,25,15138107,1,0,1,1,11296
f25b2a8b86a1ad80b61a68d27762ffd80555fb4c,0,dimuthu,2018-03-26 17:15:36-04:00,['91f4fef39c34652401e2ff3c2e34842ac6b352a7'],45,1184,1229,15139336,20,,,,11310
403656fc9e6cbffaf535edcf9538fbc65e8b3733,0,dimuthu,2018-03-27 02:34:49-04:00,['f25b2a8b86a1ad80b61a68d27762ffd80555fb4c'],772,1394,2166,15141502,45,1,1,1,11328
865d7a444bd3d5abe3c6e8e46dda7fb62b44c944,0,dimuthu,2018-03-27 14:40:50-04:00,['403656fc9e6cbffaf535edcf9538fbc65e8b3733'],178,75,253,15141755,28,1,0,0,11328
fa7b1ea5b28012e95dd08d6d3547281fcb979c8c,1,Sneha Tilak,2018-03-27 17:23:29-04:00,['3dd82638ebae02f48f6bb1451b6cffaea63b12eb'],53,142,195,15141950,7,1,1,1,11329
42176a7f8ef0284b5cf6c8f310bf07d0ea368b0c,1,dimuthu,2018-03-27 23:06:19-04:00,['865d7a444bd3d5abe3c6e8e46dda7fb62b44c944'],182,299,481,15142431,24,,,,11334
7d4c71168d4b119856b1ceba657c398414f17410,0,Marcus Christie,2018-03-28 14:23:05-04:00,['9d83c913bbea36045ad5ee846e38bc6bb187abac'],2,0,2,15142433,1,,,,11334
dc8834785073daa04233e891be7120979a765a21,1,Sneha Tilak,2018-03-28 14:30:45-04:00,['fa7b1ea5b28012e95dd08d6d3547281fcb979c8c'],9,102,111,15142544,2,0,1,1,11334
36bab3b03fa1686fd523d8279105283e0e86a981,0,Sneha Tilak,2018-03-28 14:31:35-04:00,['dc8834785073daa04233e891be7120979a765a21'],14,10,24,15142568,1,0,0,0.166666667,11334
d7e919324422a03a037e532a9ca67caf634f3720,0,GitHub,2018-03-28 17:13:25-04:00,"['97c6d5cc818442ad95ddd728899bc2e20f90f9a0', '251fed8e2fa8cbb93f686de19a535f7e9681ff51']",63,1201,1264,15143832,15,,,,11334
a5f3a51955fe6b898317ef4a0f0a1c8b0b4ff7c6,1,Sneha Tilak,2018-03-28 17:55:14-04:00,['36bab3b03fa1686fd523d8279105283e0e86a981'],63,435,498,15144330,14,0.121338912,0.447698745,1,11337
82cd01a83e71dd26e3dd44b435ced63f7fe815db,0,Sneha Tilak,2018-03-28 18:05:51-04:00,"['a5f3a51955fe6b898317ef4a0f0a1c8b0b4ff7c6', 'd7e919324422a03a037e532a9ca67caf634f3720']",63,1202,1265,15145595,15,,,,11337
22389a5eb099961550a60fce2c7ca496514e3c79,0,Sneha Tilak,2018-03-28 18:10:47-04:00,"['b9cf983103dc968e3d18c7c7bf2126a6a2162dd5', 'd7e919324422a03a037e532a9ca67caf634f3720']",63,1201,1264,15146859,15,,,,11337
f4d4e221a9353966dfd8d4cb413b1d6848459462,0,tilaks26,2018-03-29 14:13:58-04:00,['22389a5eb099961550a60fce2c7ca496514e3c79'],2,0,2,15146861,2,,,,11337
863ca432154837f56b53da143189177ea365ebc3,0,tilaks26,2018-03-29 14:32:17-04:00,['82cd01a83e71dd26e3dd44b435ced63f7fe815db'],10,10,20,15146881,1,,,,11337
49d1f393bd9fa9ed811cc86db3aa7afe6553917e,0,tilaks26,2018-03-29 14:34:26-04:00,['f4d4e221a9353966dfd8d4cb413b1d6848459462'],21,21,42,15146923,1,,,,11337
11efe8a64baf365dc96f4193f57977a7a76e635d,0,GitHub,2018-03-30 11:11:16-04:00,"['d7e919324422a03a037e532a9ca67caf634f3720', '49d1f393bd9fa9ed811cc86db3aa7afe6553917e']",548,2603,3151,15150074,77,,,,11337
bf8f6f326fa3567e2bcaedbd7cdfd6481b71b5f2,0,tilaks26,2018-03-30 12:24:57-04:00,"['863ca432154837f56b53da143189177ea365ebc3', '11efe8a64baf365dc96f4193f57977a7a76e635d']",506,2560,3066,15153140,76,,,,11337
68b8c7ed902960634f439aef1e276f18650950d7,1,tilaks26,2018-03-30 12:27:49-04:00,['bf8f6f326fa3567e2bcaedbd7cdfd6481b71b5f2'],1,1,2,15153142,1,,,,11337
05860649eb8cecd5be2023c4f21587f7a59e94bb,1,tilaks26,2018-03-30 12:29:14-04:00,['68b8c7ed902960634f439aef1e276f18650950d7'],0,76,76,15153218,1,,,,11338
4893e914ca2f9be24dfc1b1d77dfecdb1fe4c848,0,GitHub,2018-03-30 13:06:19-04:00,"['11efe8a64baf365dc96f4193f57977a7a76e635d', '05860649eb8cecd5be2023c4f21587f7a59e94bb']",420,1572,1992,15155210,27,,,,11338
30d7f24f3371d797cb857cccd79f7c545ae3502f,0,tilaks26,2018-04-01 01:51:11-04:00,['4893e914ca2f9be24dfc1b1d77dfecdb1fe4c848'],0,9,9,15155219,3,1,1,1,11338
b589bee63a133846bf788530b9ee5eb8c3c3f497,0,tilaks26,2018-04-01 02:02:21-04:00,['30d7f24f3371d797cb857cccd79f7c545ae3502f'],152,0,152,15155371,29,,,,11338
a6ea043b7f0111bc6d29e8deac3eeb84f12677fc,0,tilaks26,2018-04-01 02:03:14-04:00,['b589bee63a133846bf788530b9ee5eb8c3c3f497'],6,0,6,15155377,3,,,,11338
9e6963c31dfc1ed62adb661158bf2ab8818c2cc4,0,tilaks26,2018-04-01 02:41:51-04:00,['a6ea043b7f0111bc6d29e8deac3eeb84f12677fc'],238,259,497,15155874,14,1,1,1,11338
df058b5a8419ad7c39dd579460a13a40ebe33948,0,dimuthu,2018-04-01 13:32:39-04:00,['42176a7f8ef0284b5cf6c8f310bf07d0ea368b0c'],0,53,53,15155927,2,,,,11338
98885d70866e8f61aacca0e2971fad1b3b0195bd,1,tilaks26,2018-04-01 21:19:48-04:00,['9e6963c31dfc1ed62adb661158bf2ab8818c2cc4'],176,355,531,15156458,11,0.579881657,0.840236686,0.917159763,11340
10a01abad15e516ad99cf32500662941530f730a,0,tilaks26,2018-04-01 21:20:18-04:00,['98885d70866e8f61aacca0e2971fad1b3b0195bd'],0,13,13,15156471,2,,,,11340
84d5ca0c94a9857d42cfcc6b62ac09085ebb836f,0,tilaks26,2018-04-01 21:23:38-04:00,['10a01abad15e516ad99cf32500662941530f730a'],8,7,15,15156486,7,,,,11340
4de156862a35957225dad8df9d3a563ecfce681e,1,tilaks26,2018-04-01 22:13:13-04:00,['84d5ca0c94a9857d42cfcc6b62ac09085ebb836f'],0,264,264,15156750,4,,,,11344
f5552ee2ae7337adb4062dd4379c758facf98e7a,1,tilaks26,2018-04-01 22:14:06-04:00,['4de156862a35957225dad8df9d3a563ecfce681e'],91,183,274,15157024,10,1,1,1,11344
a1619dbb1fa235b89a0c73e8f2c07d29dc23fe09,1,tilaks26,2018-04-01 22:34:44-04:00,['f5552ee2ae7337adb4062dd4379c758facf98e7a'],185,370,555,15157579,9,0.206008584,0.446351931,1,11344
cbcc08c23160f7b12d62265e94d4fc9c25b3606e,1,tilaks26,2018-04-02 00:26:56-04:00,['a1619dbb1fa235b89a0c73e8f2c07d29dc23fe09'],13,58,71,15157650,4,0,1,1,11344
5642246d88352dfa63917c9e4cffd72c023c2205,0,tilaks26,2018-04-02 00:34:54-04:00,['cbcc08c23160f7b12d62265e94d4fc9c25b3606e'],21,9,30,15157680,1,0.166666667,0,0,11344
d365755caf7068f24c75b4b47bc9bd6247785313,0,Marcus Christie,2018-04-02 09:21:36-04:00,['7d4c71168d4b119856b1ceba657c398414f17410'],0,2,2,15157682,1,,,,11344
ccf7e01c69737d9ceb8ca4f8376d80d2a64ec00e,0,dimuthu,2018-04-02 11:01:29-04:00,['df058b5a8419ad7c39dd579460a13a40ebe33948'],120,262,382,15158064,16,,,,11348
17b40340698f05a742e7c4cb340a268a238d0fac,1,tilaks26,2018-04-02 12:51:04-04:00,['5642246d88352dfa63917c9e4cffd72c023c2205'],44,59,103,15158167,4,0,0,0,11348
ac53d8a0410fca041cbee14dbf49e94a09abc0dc,0,dimuthu,2018-04-03 15:47:41-04:00,['ccf7e01c69737d9ceb8ca4f8376d80d2a64ec00e'],4,4,8,15158175,4,,,,11348
1a97414fbf0e4cabd8af45a7219edf8ec4f18a10,0,dimuthu,2018-04-03 15:49:19-04:00,['ac53d8a0410fca041cbee14dbf49e94a09abc0dc'],27,50,77,15158252,2,0.5,0.75,0.75,11348
8f7dc3dc8889bd21cb00911d323a66721a960c81,0,dimuthu,2018-04-03 15:53:24-04:00,['1a97414fbf0e4cabd8af45a7219edf8ec4f18a10'],59,98,157,15158409,7,0.111111111,0.185185185,0.814814815,11348
bf3943a37fc182e7ad884c9683e8563f4bc29d5b,0,dimuthu,2018-04-03 15:54:05-04:00,['8f7dc3dc8889bd21cb00911d323a66721a960c81'],20,36,56,15158465,1,1,1,1,11348
55747caf5f11ebfb2507d96e83f61a9938ceb857,0,dimuthu,2018-04-03 16:14:11-04:00,['bf3943a37fc182e7ad884c9683e8563f4bc29d5b'],0,16,16,15158481,2,0,0,0,11348
a6971801e7babb1b121f56cb44f62f4c35781407,0,dimuthu,2018-04-03 16:39:42-04:00,['55747caf5f11ebfb2507d96e83f61a9938ceb857'],64,45,109,15158590,1,1,1,1,11348
0646f2dc548ed91efe88b848d9617dbcbcf56630,0,GitHub,2018-04-04 10:04:29-04:00,"['4893e914ca2f9be24dfc1b1d77dfecdb1fe4c848', '17b40340698f05a742e7c4cb340a268a238d0fac']",869,1521,2390,15160980,83,,,,11348
04d4640ced1072b0199af9d69f6e992997070d40,0,dimuthu,2018-04-04 13:56:54-04:00,['367a68af4a6da5cdf2659673161b0a21d4f6bf01'],1,1,2,15160982,1,,,,11348
33bf5bd17acd490c2e10c2fd0abd5c0f0dfef824,0,dimuthu,2018-04-04 14:01:12-04:00,['433800846fcaa9d254fe598af0958fec9431cc75'],15,16,31,15161013,1,0,1,1,11348
c86a4ea911f2350a09ecf6dab65730d3e5c882a1,0,dimuthu,2018-04-04 14:10:39-04:00,['a6971801e7babb1b121f56cb44f62f4c35781407'],6,16,22,15161035,1,1,1,1,11348
b10c672b387cc24ced9ece32e203d94c1f4471c1,0,dimuthu,2018-04-04 14:11:21-04:00,['c86a4ea911f2350a09ecf6dab65730d3e5c882a1'],1,2,3,15161038,1,,,,11348
2dc41b7f2dc376add40d44df7edb17b06263a2e4,1,dimuthu,2018-04-05 00:12:39-04:00,['b10c672b387cc24ced9ece32e203d94c1f4471c1'],646,412,1058,15162096,21,0,0.8,0.9,11349
d042fd3c5d1f003bb64efd2d6c7fb3fd4496ed7b,0,dimuthu,2018-04-05 00:35:20-04:00,['2dc41b7f2dc376add40d44df7edb17b06263a2e4'],184,23,207,15162303,2,0,0,0.133333333,11349
03e0ec733052c33e84403f3555f2a6a32106ef51,1,dimuthu,2018-04-05 14:23:11-04:00,['d042fd3c5d1f003bb64efd2d6c7fb3fd4496ed7b'],0,176,176,15162479,1,1,1,0.888888889,11350
721146745ecbafc93fcbaa2a5143dc825e09480e,0,dimuthu,2018-04-05 14:25:57-04:00,['03e0ec733052c33e84403f3555f2a6a32106ef51'],1,3,4,15162483,1,0,0,1,11350
bac92d05aec1066ab621c2168c52305bcfbc1987,0,dimuthu,2018-04-05 14:26:50-04:00,['721146745ecbafc93fcbaa2a5143dc825e09480e'],2,2,4,15162487,1,,,,11350
721a55abf5b7dff1260f4fd23395003b5460f5e0,0,dimuthu,2018-04-05 14:28:04-04:00,['bac92d05aec1066ab621c2168c52305bcfbc1987'],5,33,38,15162525,3,0,0.37037037,0.62962963,11350
623a87d5b3953e1e5b7b74faf4710d677e4f816b,0,dimuthu,2018-04-05 14:56:59-04:00,['721a55abf5b7dff1260f4fd23395003b5460f5e0'],1,2,3,15162528,1,,,,11350
66750afae72be1cfe6d9574c3229dbed2f4858fe,0,dimuthu,2018-04-05 15:42:40-04:00,['623a87d5b3953e1e5b7b74faf4710d677e4f816b'],5,4,9,15162537,1,1,1,0,11350
9d8482693151b5cf0e8fd91e73662bc18997316d,0,dimuthu,2018-04-05 16:02:04-04:00,['66750afae72be1cfe6d9574c3229dbed2f4858fe'],0,63,63,15162600,3,0.056603774,0.056603774,1,11350
e45108a00b3542907fc5494a2a4ef288a1fa9e3b,0,dimuthu,2018-04-05 16:02:50-04:00,['9d8482693151b5cf0e8fd91e73662bc18997316d'],0,12,12,15162612,1,0,0,0,11350
7bb426a243135e97cda181850fa6b48f1d5e059d,0,dimuthu,2018-04-05 21:37:48-04:00,['e45108a00b3542907fc5494a2a4ef288a1fa9e3b'],1,6,7,15162619,1,0,0,1,11350
06f8435f875bde0bac09ac0e64584f3e0617138d,0,dimuthu,2018-04-05 21:38:45-04:00,['7bb426a243135e97cda181850fa6b48f1d5e059d'],2,2,4,15162623,1,,,,11350
2839c44d75a9d5ebe0262905a9c4ca6d88504b28,0,dimuthu,2018-04-05 23:53:16-04:00,['06f8435f875bde0bac09ac0e64584f3e0617138d'],329,17,346,15162969,4,,,,11350
0f0712382a9ce124a90939c247d2f352510e350b,0,dimuthu,2018-04-06 11:05:58-04:00,['2839c44d75a9d5ebe0262905a9c4ca6d88504b28'],2,2,4,15162973,1,,,,11350
5997dd81d0c20ceba27288d915aee44bf1d3e565,1,Marcus Christie,2018-04-06 16:35:20-04:00,['0646f2dc548ed91efe88b848d9617dbcbcf56630'],17,68,85,15163058,2,,,,11350
dfbc1f8b2788339a09ec2e983bd3ee1a6062625e,1,Marcus Christie,2018-04-06 16:57:51-04:00,['5997dd81d0c20ceba27288d915aee44bf1d3e565'],3,4,7,15163065,2,,,,11350
957dc95375b572dc4306833f1f21ce40f99dfc48,0,dimuthu,2018-04-07 18:33:15-04:00,['2c5f4c5fcbe3bc08786c807cc38d1ad13c8f4714'],15,25,40,15163105,1,0.285714286,0.285714286,0.714285714,11350
176d1b74b58c10b63a81be8737a9cc664085dbe2,1,tilaks26,2018-04-08 01:10:37-04:00,['0646f2dc548ed91efe88b848d9617dbcbcf56630'],1365,2865,4230,15167335,49,1,1,1,11360
c26d7e49306d7222cdb300ceff733ba0cb14f6e5,1,tilaks26,2018-04-08 02:08:29-04:00,['176d1b74b58c10b63a81be8737a9cc664085dbe2'],0,484,484,15167819,3,0.278481013,0.591772152,0.955696203,11362
24bfe90ff3eb6d94119c6f55c732d79a4a253d56,0,tilaks26,2018-04-08 02:11:16-04:00,['c26d7e49306d7222cdb300ceff733ba0cb14f6e5'],165,8,173,15167992,2,0,0,0,11362
dd2a5d8b01e82e6ee0c9d88a910de84a9d6de6f9,1,tilaks26,2018-04-08 17:11:11-04:00,['24bfe90ff3eb6d94119c6f55c732d79a4a253d56'],75,966,1041,15169033,25,0.904282116,0.957178841,0.858942065,11380
bbe37812d8c7985520b6c1b71deabc22d9bf2255,0,tilaks26,2018-04-08 17:14:05-04:00,"['dd2a5d8b01e82e6ee0c9d88a910de84a9d6de6f9', 'dfbc1f8b2788339a09ec2e983bd3ee1a6062625e']",21,73,94,15169127,4,,,,11380
01e0e70605ea9937304458651335166e52c51d60,0,dimuthu,2018-04-09 10:48:41-04:00,['0f0712382a9ce124a90939c247d2f352510e350b'],1,1,2,15169129,1,,,,11380
8adb34e298fa7a8b473be4d63720e7b49dc83f2c,0,dimuthu,2018-04-09 12:08:47-04:00,['01e0e70605ea9937304458651335166e52c51d60'],16,11,27,15169156,3,,,,11380
4cfca6546f4358739ceb3c9a345cf9ead2dd0233,0,dimuthu,2018-04-09 12:38:02-04:00,['8adb34e298fa7a8b473be4d63720e7b49dc83f2c'],10,19,29,15169185,7,1,1,0,11380
1ce6d3f55d30a845b1f642b5a7a5ba0b92408e98,0,dimuthu,2018-04-09 14:13:06-04:00,['4cfca6546f4358739ceb3c9a345cf9ead2dd0233'],38,41,79,15169264,2,0,,1,11380
99babaa44082ffcaeec535627c37556ff6e99be1,1,Marcus Christie,2018-04-09 17:10:22-04:00,['dfbc1f8b2788339a09ec2e983bd3ee1a6062625e'],9,105,114,15169378,5,0,0.081081081,1,11381
2f4e3448575ef5e432e59cb285b47b43f6bb1197,1,tilaks26,2018-04-09 17:12:06-04:00,['bbe37812d8c7985520b6c1b71deabc22d9bf2255'],260,557,817,15170195,16,0.523415978,0.721763085,0.961432507,11382
f912d39d37e85d0ac9b3a5c4a027714d17e208f2,0,dimuthu,2018-04-09 19:20:51-04:00,['1ce6d3f55d30a845b1f642b5a7a5ba0b92408e98'],38,116,154,15170349,6,0.132075472,0.20754717,0.622641509,11382
3d2f314d188421bfb2a0788751ca69249aa5e1e8,0,Sachin Kariyattin,2018-04-10 00:19:41-04:00,"['7e3ce48a1d08b26a5557751d8f28be9fdad8f878', '99babaa44082ffcaeec535627c37556ff6e99be1']",1710,6817,8527,15178876,148,,,,11382
ee81a666718d2ea43e791683ff1033f033181b1f,1,Sachin Kariyattin,2018-04-10 13:56:35-04:00,['3d2f314d188421bfb2a0788751ca69249aa5e1e8'],102,257,359,15179235,8,0.061538462,0.392307692,0.946153846,11382
1b950bdb5b96f046e4fbaac6e7024b158dd86e7a,0,dimuthu,2018-04-10 14:09:49-04:00,['f912d39d37e85d0ac9b3a5c4a027714d17e208f2'],137,214,351,15179586,5,0.290322581,0.322580645,0,11383
98b7d16065f946f32ccfb886ff8190c6a545c434,0,dimuthu,2018-04-10 15:05:31-04:00,['1b950bdb5b96f046e4fbaac6e7024b158dd86e7a'],1,4,5,15179591,1,1,1,1,11383
e26b66c4b5fe0912c9992ef1baefa2f364469377,0,dimuthu,2018-04-10 15:13:40-04:00,['98b7d16065f946f32ccfb886ff8190c6a545c434'],29,34,63,15179654,3,0,0,0,11383
529ac9d92a5554d858fe5ceefb6483902ac7bb22,1,tilaks26,2018-04-10 19:41:23-04:00,['2f4e3448575ef5e432e59cb285b47b43f6bb1197'],51,424,475,15180129,8,0.245192308,0.653846154,0.548076923,11384
9f01566e29743c22045a0dc04a95faf295368b12,0,tilaks26,2018-04-10 19:43:07-04:00,"['529ac9d92a5554d858fe5ceefb6483902ac7bb22', '99babaa44082ffcaeec535627c37556ff6e99be1']",9,105,114,15180243,5,,,,11384
7d696e0f67df7773ec4db32dcb28583e66eb3882,0,GitHub,2018-04-11 14:20:27-04:00,"['99babaa44082ffcaeec535627c37556ff6e99be1', 'ee81a666718d2ea43e791683ff1033f033181b1f']",156,610,766,15181009,8,,,,11384
5fa0cec518bfd376b0c81433b8af51f8b614979c,0,dimuthu,2018-04-11 14:31:41-04:00,['e26b66c4b5fe0912c9992ef1baefa2f364469377'],1,1,2,15181011,1,0,1,1,11384
c2fa529c076c1faf6920d5ab27a45bee6a1d4d18,0,Sachin Kariyattin,2018-04-11 21:05:00-04:00,['b15077f0d0dda1371223d86ac19891ddec8c8fb0'],12,71,83,15181094,7,1,1,1,11386
04cf03ef834d3c91886ce490d0e1c9b68a87a514,0,Sachin Kariyattin,2018-04-12 01:31:58-04:00,['c2fa529c076c1faf6920d5ab27a45bee6a1d4d18'],223,236,459,15181553,12,0,0.714285714,1,11386
6482253ef9e92d004ea323e168be23be422abd4c,0,Sachin Kariyattin,2018-04-12 01:42:33-04:00,['04cf03ef834d3c91886ce490d0e1c9b68a87a514'],3,3,6,15181559,2,,,,11386
e52034785268b329433a84f189b336d5051b6fd9,0,GitHub,2018-04-12 14:31:52-04:00,"['24aa025a548df30f66402d52d12d06f3732ed630', '6482253ef9e92d004ea323e168be23be422abd4c']",66,1032,1098,15182657,17,,,,11386
355d8d7daa8227143a133308e6ff6fc77e7d5521,0,Marcus Christie,2018-04-12 14:45:46-04:00,"['7d696e0f67df7773ec4db32dcb28583e66eb3882', 'e52034785268b329433a84f189b336d5051b6fd9']",57,1008,1065,15183722,16,,,,11386
f36ea615804a3fead60154ceba0e38d43efe8b75,0,Marcus Christie,2018-04-12 15:01:55-04:00,['355d8d7daa8227143a133308e6ff6fc77e7d5521'],2,6,8,15183730,1,,,,11386
1aa3c52684102a6fcffd22eb62161859ea1934ad,1,Marcus Christie,2018-04-12 16:30:00-04:00,['f36ea615804a3fead60154ceba0e38d43efe8b75'],2,47,49,15183779,4,0.307692308,1,0.730769231,11386
a080ae5f361af5ed7c8d0bc0c99960d23074763b,1,Marcus Christie,2018-04-12 16:44:31-04:00,['1aa3c52684102a6fcffd22eb62161859ea1934ad'],0,1,1,15183780,1,0,1,1,11386
099d116f82c3e1142d7fa8ef2c40a724af563134,0,Sachin Kariyattin,2018-04-12 16:54:24-04:00,['7d696e0f67df7773ec4db32dcb28583e66eb3882'],71,3,74,15183854,4,0,0,0,11386
e8e10faaa7fd236d68b75350ffdcb5a595233831,0,Sachin Kariyattin,2018-04-12 16:56:15-04:00,"['099d116f82c3e1142d7fa8ef2c40a724af563134', 'a080ae5f361af5ed7c8d0bc0c99960d23074763b']",59,1060,1119,15184973,20,,,,11386
abf5ee26e150ef31a4aa433f518a112872c73220,0,GitHub,2018-04-12 17:12:43-04:00,"['a080ae5f361af5ed7c8d0bc0c99960d23074763b', 'e8e10faaa7fd236d68b75350ffdcb5a595233831']",71,3,74,15185047,4,,,,11386
7e8b6925ff9148d9d0b4a4f3a06a559aca92e70c,1,Marcus Christie,2018-04-13 09:48:35-04:00,['abf5ee26e150ef31a4aa433f518a112872c73220'],0,2,2,15185049,2,0,0,1,11386
f2b5d2b3d2cc62c376125eaca82b8678f8dbffd4,0,Eroma Abeysinghe,2018-04-13 10:13:20-04:00,['d365755caf7068f24c75b4b47bc9bd6247785313'],1,1,2,15185051,1,,,,11386
d9000604bcc4a45d85664eb802e2d028a1960e79,0,Marcus Christie,2018-04-13 10:32:06-04:00,['f2b5d2b3d2cc62c376125eaca82b8678f8dbffd4'],1,1,2,15185053,1,,,,11386
4836bdf62ba2d6710b5998671519dc09e1bff312,0,dimuthu,2018-04-13 10:33:34-04:00,['5fa0cec518bfd376b0c81433b8af51f8b614979c'],2,8,10,15185063,1,0,0,1,11386
c516b73a150ef0d1026e4d2ee0dca24e50474207,0,Eroma Abeysinghe,2018-04-13 10:49:34-04:00,['d9000604bcc4a45d85664eb802e2d028a1960e79'],1,1,2,15185065,1,,,,11386
ea1691fe2de3eaf75e7a4901630d8d7ec65c4da4,0,Marcus Christie,2018-04-13 11:22:55-04:00,['c516b73a150ef0d1026e4d2ee0dca24e50474207'],1,1,2,15185067,1,,,,11386
a2acaac097dfd24c85c1acbb4f041a4ee65a7d95,0,dimuthu,2018-04-13 13:49:47-04:00,['4836bdf62ba2d6710b5998671519dc09e1bff312'],140,1070,1210,15186277,17,0.628571429,0.81978022,0.843956044,11394
c27b477c01ebaeafe48196f2c24df0890e394cb3,0,tilaks26,2018-04-13 11:34:03-07:00,"['9f01566e29743c22045a0dc04a95faf295368b12', '7e8b6925ff9148d9d0b4a4f3a06a559aca92e70c']",286,1675,1961,15188238,29,,,,11394
d447052d8eb9cc140b150d9872045497abd96b3b,0,dimuthu,2018-04-13 15:03:25-04:00,['a2acaac097dfd24c85c1acbb4f041a4ee65a7d95'],200,193,393,15188631,7,0,1,0,11396
2d2f5ee816fd33f99185b5e7fca6b6c281c8b6fc,0,dimuthu,2018-04-13 15:45:55-04:00,['d447052d8eb9cc140b150d9872045497abd96b3b'],21,1,22,15188653,3,,,,11396
9b9a2c059f989524bddf24604897526d0155916c,1,Marcus Christie,2018-04-13 16:20:30-04:00,['b10c672b387cc24ced9ece32e203d94c1f4471c1'],0,717,717,15189370,7,,,,11403
f07015938bbcb29d7194bf4b208a4b1313cbb98b,0,Marcus Christie,2018-04-13 16:20:39-04:00,['9b9a2c059f989524bddf24604897526d0155916c'],1,7,8,15189378,1,,,,11403
fe28ca9f42a2aa0b6ea102d69bfffb8c54c5cdbe,0,Marcus Christie,2018-04-13 17:00:31-04:00,['f07015938bbcb29d7194bf4b208a4b1313cbb98b'],11,30,41,15189419,2,,,,11404
0ff8b18b5ef2dae9db447e0013e8fe3d8c6367c9,0,GitHub,2018-04-14 11:40:15-04:00,"['ea1691fe2de3eaf75e7a4901630d8d7ec65c4da4', '957dc95375b572dc4306833f1f21ce40f99dfc48']",15,25,40,15189459,1,,,,11404
42bd72f6768b6e308f06b820075554545af40557,0,GitHub,2018-04-14 11:41:40-04:00,"['2d2f5ee816fd33f99185b5e7fca6b6c281c8b6fc', '33bf5bd17acd490c2e10c2fd0abd5c0f0dfef824']",15,16,31,15189490,1,,,,11404
c0e3978bf26b4c3838f317ae061228e6dee6fa4f,0,dimuthu,2018-04-16 10:21:56-04:00,['433800846fcaa9d254fe598af0958fec9431cc75'],6,8,14,15189504,1,0,1,0,11404
9092156b7b5a74e322cf82dcdd771b1314f37267,1,tilaks26,2018-04-16 11:48:36-07:00,['c27b477c01ebaeafe48196f2c24df0890e394cb3'],0,232,232,15189736,5,1,1,1,11409
3cdb2e3d3a88bd9f0e21a0e3b59ab782f34342cf,0,Marcus Christie,2018-04-16 16:49:08-04:00,['0ff8b18b5ef2dae9db447e0013e8fe3d8c6367c9'],92,0,92,15189828,3,,,,11409
bf2bbf49298822c9703d0bde3bc8cba8feb49ef9,1,tilaks26,2018-04-17 02:07:14-07:00,['9092156b7b5a74e322cf82dcdd771b1314f37267'],9,48,57,15189885,3,0.896551724,0.896551724,0.896551724,11409
5d176dd2e90d4cafac189130f3df1c36c8a393c3,1,tilaks26,2018-04-17 11:42:27-07:00,['bf2bbf49298822c9703d0bde3bc8cba8feb49ef9'],17,72,89,15189974,3,0,0.942857143,0.942857143,11409
db713897e7926e2e9b85a8f8711a5e8ff1182809,0,Eroma Abeysinghe,2018-04-18 12:36:03-04:00,['ea1691fe2de3eaf75e7a4901630d8d7ec65c4da4'],0,1,1,15189975,1,,,,11409
c3031842bb32b31b000e7938be35b1068e7c80ac,0,Eroma Abeysinghe,2018-04-18 12:36:39-04:00,"['db713897e7926e2e9b85a8f8711a5e8ff1182809', '3cdb2e3d3a88bd9f0e21a0e3b59ab782f34342cf']",107,25,132,15190107,4,,,,11409
68999eb25dfe0a0bebb793451acc130c5027e229,0,Marcus Christie,2018-04-18 14:59:38-04:00,['fe28ca9f42a2aa0b6ea102d69bfffb8c54c5cdbe'],0,107,107,15190214,3,,,,11412
8c7ba3136b06abc7601e5ebd351ff0a8ce02a5de,0,yasgun,2018-04-19 01:03:18+05:18,['42bd72f6768b6e308f06b820075554545af40557'],26,72,98,15190312,3,0.257142857,0.257142857,0.914285714,11412
cc699a4193a3f86750ce8af6b8cf7ea3d9329bda,0,Marcus Christie,2018-04-18 17:26:46-04:00,['68999eb25dfe0a0bebb793451acc130c5027e229'],15,12,27,15190339,5,,,,11412
3df3bc59278728bfc09d2b42c17db5b4620f4b3d,0,Eroma Abeysinghe,2018-04-19 10:29:36-04:00,['c3031842bb32b31b000e7938be35b1068e7c80ac'],3,3,6,15190345,1,,,,11412
ed59794a6e3c5e3155811c728ddc5bdfd27b9bb3,0,Eroma Abeysinghe,2018-04-19 16:32:31-04:00,['3df3bc59278728bfc09d2b42c17db5b4620f4b3d'],1,1,2,15190347,1,,,,11412
e9baeeca4049938a38eec486dd55a7e4fc827f04,0,lahiru-j,2018-04-22 17:06:57+05:18,['42bd72f6768b6e308f06b820075554545af40557'],0,304,304,15190651,6,,,,11417
ce87faf34b399843fbfd6bfe9d0de0c830c3fe30,1,tilaks26,2018-04-23 00:30:05-07:00,['5d176dd2e90d4cafac189130f3df1c36c8a393c3'],571,1435,2006,15192657,30,0.274725275,0.826373626,0.978021978,11422
c94aa67e48d5661d7f6dc816ee94459034380308,0,tilaks26,2018-04-23 00:45:48-07:00,['ce87faf34b399843fbfd6bfe9d0de0c830c3fe30'],0,12,12,15192669,5,0,1,1,11422
d89b1b6fdd2b45c066fce336454f075e3adb805c,1,tilaks26,2018-04-23 01:23:09-07:00,['c94aa67e48d5661d7f6dc816ee94459034380308'],168,40,208,15192877,8,0,0,0,11422
2995f9996920df97669925c93277070225c172be,1,tilaks26,2018-04-23 01:54:28-07:00,['d89b1b6fdd2b45c066fce336454f075e3adb805c'],0,79,79,15192956,1,0.019607843,1,1,11422
f2fd1c226c00a094839f9bc29f562b27b89da40b,0,Eroma Abeysinghe,2018-04-23 08:40:25-04:00,['ed59794a6e3c5e3155811c728ddc5bdfd27b9bb3'],0,83,83,15193039,2,,,,11424
d15cad4e5c924c3e80a4d2fcfffcb377b4d4e9e2,0,Marcus Christie,2018-04-23 09:38:52-04:00,['f2fd1c226c00a094839f9bc29f562b27b89da40b'],9,9,18,15193057,1,,,,11424
173b9d66e1d683b9838e182a8523d04ac020e3c2,0,Eroma Abeysinghe,2018-04-23 12:30:47-04:00,['d15cad4e5c924c3e80a4d2fcfffcb377b4d4e9e2'],1,1,2,15193059,1,,,,11424
dc035b13323d5c974f18e7ce2e9edecd3d210b94,1,lahiru-j,2018-04-23 22:57:36+05:18,['e9baeeca4049938a38eec486dd55a7e4fc827f04'],0,1223,1223,15194282,20,,,,11443
0f66b458fc05e1d635c9cdf7f13b7bbb91cae13f,0,GitHub,2018-04-23 16:16:35-04:00,"['42bd72f6768b6e308f06b820075554545af40557', 'dc035b13323d5c974f18e7ce2e9edecd3d210b94']",0,1527,1527,15195809,25,,,,11443
58678923e9754ea8839dfdcce113b831c09a66c7,0,dimuthu,2018-04-23 16:19:08-04:00,"['cc699a4193a3f86750ce8af6b8cf7ea3d9329bda', '42bd72f6768b6e308f06b820075554545af40557']",1513,2172,3685,15199494,55,,,,11443
021ff948dd59ad133ffad421cb2de91b7cead3e5,0,dimuthu,2018-04-23 16:29:12-04:00,"['58678923e9754ea8839dfdcce113b831c09a66c7', '0f66b458fc05e1d635c9cdf7f13b7bbb91cae13f']",1,1498,1499,15200993,25,,,,11443
9999156cbf7b8ce52e3dde8457e01b86488e6a81,0,dimuthu,2018-04-24 12:12:19-04:00,['021ff948dd59ad133ffad421cb2de91b7cead3e5'],500,8,508,15201501,2,,,,11443
1d5b3f2b286eb8304f5f9e3bc34ca3020243dfdf,0,Eroma Abeysinghe,2018-04-24 16:10:55-04:00,['173b9d66e1d683b9838e182a8523d04ac020e3c2'],1,1,2,15201503,1,,,,11443
3f842042a723214b63af48855ae453238bd4912f,0,Eroma Abeysinghe,2018-04-24 16:48:13-04:00,['1d5b3f2b286eb8304f5f9e3bc34ca3020243dfdf'],1,1,2,15201505,1,,,,11443
15e8958b3d5743559569f500ea707f5fc4e71cb5,0,yasgun,2018-04-26 00:33:45+05:18,"['8c7ba3136b06abc7601e5ebd351ff0a8ce02a5de', '0f66b458fc05e1d635c9cdf7f13b7bbb91cae13f']",0,1527,1527,15203032,25,,,,11443
aea2b55231eedd228474a2437b1eb7953ee833c6,0,dimuthu,2018-04-25 17:18:18-04:00,['9999156cbf7b8ce52e3dde8457e01b86488e6a81'],7,13,20,15203052,1,0.571428571,1,0.428571429,11443
796ecbb745b359390f82642529edbc82a09342ea,0,dimuthu,2018-04-25 20:43:04-04:00,['aea2b55231eedd228474a2437b1eb7953ee833c6'],1,2,3,15203055,1,,,,11443
ad72e82096cfc5cb4028c825d7cb6a2bf3e83532,0,dimuthu,2018-04-25 21:08:46-04:00,['796ecbb745b359390f82642529edbc82a09342ea'],316,161,477,15203532,28,,,,11445
b86eea704ab84aa8b4b06a637fd5cf963aff617a,1,tilaks26,2018-04-26 00:51:18-04:00,['2995f9996920df97669925c93277070225c172be'],118,794,912,15204444,20,0.054104478,0,0.955223881,11446
aa23561231e056e763edeb61353c15d096da3909,1,tilaks26,2018-04-26 02:10:45-04:00,['b86eea704ab84aa8b4b06a637fd5cf963aff617a'],209,108,317,15204761,1,1,1,0.283018868,11446
0f2a1e5543fcf3e8658649dc3b501639c398560e,0,yasgun,2018-04-26 16:15:01+05:18,"['15e8958b3d5743559569f500ea707f5fc4e71cb5', 'ad72e82096cfc5cb4028c825d7cb6a2bf3e83532']",847,1023,1870,15206631,44,,,,11446
5f58b1b65ee71c13ef24a092d1a39c7c186cb76e,0,dimuthu,2018-04-26 14:55:56-04:00,['ad72e82096cfc5cb4028c825d7cb6a2bf3e83532'],2,2,4,15206635,1,,,,11446
c8573c1d5cf0a2fecd4c3a59bde5a58698afa345,0,Eroma Abeysinghe,2018-04-26 15:32:11-04:00,['3f842042a723214b63af48855ae453238bd4912f'],6,6,12,15206647,1,,,,11446
f79c7f792d2961055a8353c6da4077a5f9456e62,0,Eroma Abeysinghe,2018-04-26 15:47:32-04:00,['c8573c1d5cf0a2fecd4c3a59bde5a58698afa345'],0,1,1,15206648,1,,,,11446
3a8dc0dcc5d301a64353adbecff8fd73b4880631,0,tilaks26,2018-04-27 13:27:50-04:00,['aa23561231e056e763edeb61353c15d096da3909'],196,0,196,15206844,2,,,,11446
cca45cd25fe4741e785eae9cb226c29af6059453,1,Marcus Christie,2018-04-27 15:17:08-04:00,['7e8b6925ff9148d9d0b4a4f3a06a559aca92e70c'],3,46,49,15206893,4,,,,11448
6b5363a14204e617b839cc98b35cb3175fc376c3,0,tilaks26,2018-04-27 16:43:20-04:00,"['3a8dc0dcc5d301a64353adbecff8fd73b4880631', 'cca45cd25fe4741e785eae9cb226c29af6059453']",2,46,48,15206941,4,,,,11448
3fe6d225a64775f45ff57458431cfae8fb7f49ad,1,tilaks26,2018-04-27 17:26:07-04:00,['6b5363a14204e617b839cc98b35cb3175fc376c3'],49,29,78,15207019,13,0,0,0,11448
d132bf234d60e6b9c4a8fee201fc398ee21b87ef,0,yasgun,2018-05-01 22:57:24+05:18,['0f2a1e5543fcf3e8658649dc3b501639c398560e'],31,44,75,15207094,3,1,1,0.846153846,11448
638b3f9fa9f0ec44c5e7164be8d623a1c9ecac3a,1,tilaks26,2018-05-01 17:26:35-04:00,['3fe6d225a64775f45ff57458431cfae8fb7f49ad'],630,365,995,15208089,29,0,0,0,11450
2669ea088f9e14112757bdc9c29f73c03f3bd7a7,1,tilaks26,2018-05-02 09:38:36-04:00,['638b3f9fa9f0ec44c5e7164be8d623a1c9ecac3a'],231,987,1218,15209307,23,0.426900585,0.994152047,1,11457
baf6974c61230ff5807cacf55b59632ff9205a1d,0,dimuthu,2018-05-02 10:04:45-04:00,['f79c7f792d2961055a8353c6da4077a5f9456e62'],0,3,3,15209310,1,,,,11457
a6e57823a4fe0b14dc1ec48cfa4a733cda1bd275,0,dimuthu,2018-05-02 10:04:46-04:00,['baf6974c61230ff5807cacf55b59632ff9205a1d'],1,4,5,15209315,1,0,0,0,11457
e67ffd8d43f9fc824cefefb4d891d413971fbc95,0,GitHub,2018-05-02 11:03:54-04:00,"['ad72e82096cfc5cb4028c825d7cb6a2bf3e83532', 'd132bf234d60e6b9c4a8fee201fc398ee21b87ef']",26,85,111,15209426,3,,,,11457
7a182e16b37c71a220682a21fae8f4bcf9bddef4,0,dimuthu,2018-05-02 13:29:29-04:00,['5f58b1b65ee71c13ef24a092d1a39c7c186cb76e'],0,38,38,15209464,2,0,0.96,0.04,11457
6836a2c3e45c50c280947d9c46d57ada3b70c1fc,1,Marcus Christie,2018-05-02 15:05:16-04:00,['cca45cd25fe4741e785eae9cb226c29af6059453'],51,269,320,15209784,13,0.016949153,0,0.943502825,11457
af876506c7cd124fe1f5d3d4ce4dcd3c05a6c853,0,Marcus Christie,2018-05-02 17:23:24-04:00,['a6e57823a4fe0b14dc1ec48cfa4a733cda1bd275'],0,5,5,15209789,1,,,,11457
7c12e1b56178f53499c754d3c1e94ac451e40900,1,tilaks26,2018-05-02 19:31:31-04:00,['2669ea088f9e14112757bdc9c29f73c03f3bd7a7'],224,891,1115,15210904,16,0.395604396,0.994505495,1,11465
75aff2de877a9e52b5d3d7525fae5c41446b199c,1,tilaks26,2018-05-02 20:16:46-04:00,['7c12e1b56178f53499c754d3c1e94ac451e40900'],125,357,482,15211386,7,0.326530612,0.989795918,1,11469
34b9f6ded98605763de0b46862cb2df1d0972e73,1,tilaks26,2018-05-03 00:21:43-04:00,['75aff2de877a9e52b5d3d7525fae5c41446b199c'],64,257,321,15211707,5,0.144736842,0.710526316,1,11471
366ca6433526b5cbf75bba84d1e4462e0ead5b23,0,tilaks26,2018-05-03 00:34:21-04:00,"['34b9f6ded98605763de0b46862cb2df1d0972e73', '6836a2c3e45c50c280947d9c46d57ada3b70c1fc']",51,269,320,15212027,13,,,,11471
3dd7c7235ff867b489ace807ecf91b0b57efa6fd,0,Eroma Abeysinghe,2018-05-03 05:55:44-04:00,['af876506c7cd124fe1f5d3d4ce4dcd3c05a6c853'],1,1,2,15212029,1,,,,11471
b66e01b1e3961a12da5a096f8a4284583cda97c8,0,dimuthu,2018-05-03 11:17:48-04:00,['6836a2c3e45c50c280947d9c46d57ada3b70c1fc'],0,40,40,15212069,1,,,,11471
ca0f1f0e54010b7c7f389416ec7cb07df75a0cb1,0,Marcus Christie,2018-05-04 10:47:38-04:00,['b66e01b1e3961a12da5a096f8a4284583cda97c8'],8,17,25,15212094,1,,,,11471
743bbb1140c10e5302d84ea8a6df4b23dfe9e9bd,0,Marcus Christie,2018-05-04 10:52:56-04:00,['ca0f1f0e54010b7c7f389416ec7cb07df75a0cb1'],17,8,25,15212119,1,,,,11471
f0a6e8422add33825976601d49c6ceffcc71ad27,1,Marcus Christie,2018-05-04 16:05:47-04:00,['743bbb1140c10e5302d84ea8a6df4b23dfe9e9bd'],31,84,115,15212234,9,0.357142857,0,1,11471
eaf8d1c7a89f87f4ccdde8fc6e1f713bb702afdb,0,Marcus Christie,2018-05-04 16:28:02-04:00,['f0a6e8422add33825976601d49c6ceffcc71ad27'],16,28,44,15212278,6,1,1,1,11471
d8a510cc0f11b5065740ebda00af6f6e949cca6b,1,Marcus Christie,2018-05-04 17:10:30-04:00,['eaf8d1c7a89f87f4ccdde8fc6e1f713bb702afdb'],1,10,11,15212289,1,,,,11471
e38fb065d3edccb365bc400e6f9db007eb7c54e5,0,lahiru-j,2018-05-05 22:46:01+05:18,['e67ffd8d43f9fc824cefefb4d891d413971fbc95'],0,152,152,15212441,6,,,,11476
0237a7c1592561226936e6989f55117cc92ce0be,1,Sachin Kariyattin,2018-05-06 19:26:27-04:00,['d8a510cc0f11b5065740ebda00af6f6e949cca6b'],159,394,553,15212994,11,0.240223464,0.38547486,0.977653631,11476
4a12fdc0437da8cde96124949abd60b3b7f8b837,0,tilaks26,2018-05-06 21:35:41-04:00,"['366ca6433526b5cbf75bba84d1e4462e0ead5b23', 'd8a510cc0f11b5065740ebda00af6f6e949cca6b']",46,160,206,15213200,13,,,,11476
bc5971d803f57e25914b68442f491e185a854d87,0,tilaks26,2018-05-06 21:36:16-04:00,['4a12fdc0437da8cde96124949abd60b3b7f8b837'],0,19,19,15213219,1,,,,11476
15c39876ef72851beab7dcfa28eb79a441c897f2,1,dimuthu,2018-05-07 12:38:38-04:00,['7a182e16b37c71a220682a21fae8f4bcf9bddef4'],2,6,8,15213227,2,0,1,0,11476
a3f1f475059a2200474f0dd949c6da9a2c731810,0,GitHub,2018-05-07 13:55:07-04:00,"['e67ffd8d43f9fc824cefefb4d891d413971fbc95', 'e38fb065d3edccb365bc400e6f9db007eb7c54e5']",0,152,152,15213379,6,,,,11476
0bcf435a388ea0fcd9aaf644fb26953e67aa9e23,0,dimuthu,2018-05-08 14:56:40-04:00,['15c39876ef72851beab7dcfa28eb79a441c897f2'],3,10,13,15213392,1,0,1,1,11476
0441cb7fefdedf211db7884debd915cfecbc64d7,0,Marcus Christie,2018-05-09 10:01:19-04:00,['d8a510cc0f11b5065740ebda00af6f6e949cca6b'],1,60,61,15213453,2,0.340425532,1,0.191489362,11476
da4503d6cc12b2b38edd3ef4d47314f224a390da,0,dimuthu,2018-05-09 16:49:04-04:00,['0bcf435a388ea0fcd9aaf644fb26953e67aa9e23'],1,1,2,15213455,1,,,,11476
0f9a5192a52655b6c39a17a2591e4aa787f3a9e5,0,rkunalan,2018-05-10 12:03:49-04:00,['3dd7c7235ff867b489ace807ecf91b0b57efa6fd'],1,1,2,15213457,1,,,,11476
4f1bced37cd0cec44acefb4257066289eebde912,1,Marcus Christie,2018-05-10 12:23:03-04:00,['0441cb7fefdedf211db7884debd915cfecbc64d7'],42,221,263,15213720,7,0.209677419,0.5,0.709677419,11479
6ef6c03f135399c4c7586b9ebb09a1c9c202b62c,0,Marcus Christie,2018-05-10 12:30:08-04:00,['da4503d6cc12b2b38edd3ef4d47314f224a390da'],0,1,1,15213721,1,,,,11480
5cf113dcad9f25e37604e1b7b67e43228f26e5a8,0,Marcus Christie,2018-05-10 12:30:08-04:00,['6ef6c03f135399c4c7586b9ebb09a1c9c202b62c'],1,257,258,15213979,8,,,,11486
20cb5ce36b081ccdbee2600c9b861c91a0a448de,0,dimuthu,2018-05-14 13:49:56-04:00,['5cf113dcad9f25e37604e1b7b67e43228f26e5a8'],2,2,4,15213983,1,,,,11486
49f6f1a5721f09bfba346fd85aea6d721087db7a,0,Marcus Christie,2018-05-15 10:43:05-04:00,['3dd7c7235ff867b489ace807ecf91b0b57efa6fd'],1,1,2,15213985,1,,,,11486
a0fc98b494ee75b6a0aa0a45f8c5849d6c316a49,0,Marcus Christie,2018-05-15 15:14:22-04:00,['49f6f1a5721f09bfba346fd85aea6d721087db7a'],5,20,25,15214010,3,,,,11486
a1dbae899412e570fd306f6ca7aeceb451230199,0,Marcus Christie,2018-05-16 13:58:21-04:00,['4f1bced37cd0cec44acefb4257066289eebde912'],1,1,2,15214012,1,,,,11486
4eb343c65932118a92006fe7755291b5f4240af2,1,Marcus Christie,2018-05-17 11:01:30-04:00,['a1dbae899412e570fd306f6ca7aeceb451230199'],2530,7388,9918,15223930,10,0.636879857,0.774058577,0.988045427,11491
d7d77112d89dfac2ece64ec1f999f300228fe21f,1,Marcus Christie,2018-05-17 11:39:47-04:00,['4eb343c65932118a92006fe7755291b5f4240af2'],57,87,144,15224074,1,0,1,0,11491
b7e7d3a4e77d7e1a31e2a69499a6bac045d71ed4,0,Marcus Christie,2018-05-17 12:34:28-04:00,"['d7d77112d89dfac2ece64ec1f999f300228fe21f', 'a3f1f475059a2200474f0dd949c6da9a2c731810']",121,17838,17959,15242033,215,,,,11491
378cc7ba0b46909c1527f3a68ed2be6b1b481f83,1,Marcus Christie,2018-05-17 12:51:33-04:00,['b7e7d3a4e77d7e1a31e2a69499a6bac045d71ed4'],1,1,2,15242035,1,,,,11491
e91c302a7183cbdac291f1e815017ec2c75ea0d5,0,dimuthu,2018-05-18 12:44:24-04:00,['20cb5ce36b081ccdbee2600c9b861c91a0a448de'],0,1,1,15242036,1,0,0,1,11491
9703d13c9c6369488c480af43a5bb23dbd179512,0,dimuthu,2018-05-18 13:44:02-04:00,['e91c302a7183cbdac291f1e815017ec2c75ea0d5'],1,27,28,15242064,1,,,,11491
cccdbf3b7bbb9d5e5218bc6788ae984fc73f012d,0,dimuthu,2018-05-18 14:10:32-04:00,['9703d13c9c6369488c480af43a5bb23dbd179512'],2,3,5,15242069,1,0,1,0,11491
e8530a1d356576643fff86ea27802757427dca24,0,Marcus Christie,2018-05-18 14:19:25-04:00,['a0fc98b494ee75b6a0aa0a45f8c5849d6c316a49'],124,59,183,15242252,15,,,,11491
6d8082e3ad2991a74f657fea049fd5f982b1d8ef,0,dimuthu,2018-05-18 15:00:23-04:00,['cccdbf3b7bbb9d5e5218bc6788ae984fc73f012d'],1,8,9,15242261,1,0,0,1,11491
88c8615d9b08da7daeb204a98dc8fa0097d312a8,1,Marcus Christie,2018-05-21 10:33:01-04:00,['378cc7ba0b46909c1527f3a68ed2be6b1b481f83'],351,3880,4231,15246492,3,0.331992687,0.390493601,0.919195612,11491
d279ebc865b73e21158c9c98ebc148c4b8c2b207,0,Marcus Christie,2018-05-21 11:36:49-04:00,['88c8615d9b08da7daeb204a98dc8fa0097d312a8'],0,2,2,15246494,1,,,,11491
d5fd41511eadd25dabf85f7a2e7214d135abd8d8,1,Marcus Christie,2018-05-21 16:51:43-04:00,['d279ebc865b73e21158c9c98ebc148c4b8c2b207'],30040,32408,62448,15308942,8,0.366061294,0.376844495,0.901248581,11494
803773c6f9220067aa3243236be06f5abbfea51d,0,Marcus Christie,2018-05-21 16:53:30-04:00,['d5fd41511eadd25dabf85f7a2e7214d135abd8d8'],1,29,30,15308972,2,0,1,1,11494
9e5de00a40a9f34e11c74e808c1f764554836551,0,Marcus Christie,2018-05-23 16:42:39-04:00,['803773c6f9220067aa3243236be06f5abbfea51d'],1,1,2,15308974,1,,,,11494
692d57144a867ff71b259c9c52998b0c1bab73c1,1,Marcus Christie,2018-05-23 16:48:24-04:00,['9e5de00a40a9f34e11c74e808c1f764554836551'],12,315,327,15309301,5,0.522580645,0.987096774,0.832258065,11496
341d3d9031d5fd7320191c4034cf95bf69a8c964,0,dimuthu,2018-05-24 14:10:39-04:00,['6d8082e3ad2991a74f657fea049fd5f982b1d8ef'],1,27,28,15309329,1,,,,11496
61dc4214e4417fa7c9f9793cdd82ab1c5b6375d5,0,GitHub,2018-05-24 16:25:15-04:00,"['e8530a1d356576643fff86ea27802757427dca24', '0f9a5192a52655b6c39a17a2591e4aa787f3a9e5']",1,1,2,15309331,1,,,,11496
edba8d3af8f6e301fb16ea53d7e2e3d56661a626,0,Eroma Abeysinghe,2018-05-24 16:53:25-04:00,['61dc4214e4417fa7c9f9793cdd82ab1c5b6375d5'],1,1,2,15309333,1,,,,11496
433210bab0448c4dec937c2e5d310892dcf2efe5,0,Eroma Abeysinghe,2018-05-25 10:13:44-04:00,['edba8d3af8f6e301fb16ea53d7e2e3d56661a626'],1,1,2,15309335,1,,,,11496
0c96efb103d63e718f023add35ce307458a67988,0,Marcus Christie,2018-05-29 13:36:12-04:00,['692d57144a867ff71b259c9c52998b0c1bab73c1'],8,372,380,15309715,3,0.776041667,0.984375,0.65625,11497
d198a31472ec1b188b7d608fd60f7a5d9d3d355f,0,Marcus Christie,2018-06-04 08:17:04-04:00,"['0c96efb103d63e718f023add35ce307458a67988', 'bc5971d803f57e25914b68442f491e185a854d87']",2231,8733,10964,15320679,101,,,,11497
2d7227a63e1c52fbce709ae948ede5f0c9ca6237,0,Marcus Christie,2018-06-04 08:17:41-04:00,"['0c96efb103d63e718f023add35ce307458a67988', 'd198a31472ec1b188b7d608fd60f7a5d9d3d355f']",2231,8733,10964,15331643,101,,,,11497
95969875f02b7e650eb326b17e6447b0ea61a298,0,Marcus Christie,2018-06-04 09:45:36-04:00,['2d7227a63e1c52fbce709ae948ede5f0c9ca6237'],0,4,4,15331647,2,0,1,1,11497
39d81aa6d0abe1f7bc882ed830fa4abdd1f0f34f,0,GitHub,2018-06-04 10:56:47-04:00,"['a3f1f475059a2200474f0dd949c6da9a2c731810', 'c0e3978bf26b4c3838f317ae061228e6dee6fa4f']",6,8,14,15331661,1,,,,11497
f5aeb4b086046ccd6d193eac897886cb63873c8e,0,dimuthu,2018-06-04 10:59:58-04:00,"['341d3d9031d5fd7320191c4034cf95bf69a8c964', '39d81aa6d0abe1f7bc882ed830fa4abdd1f0f34f']",32,245,277,15331938,10,,,,11497
3fd4d4d6a1abe128b90c26c21d134b36732b9c6e,0,Marcus Christie,2018-06-04 11:02:36-04:00,['95969875f02b7e650eb326b17e6447b0ea61a298'],141,236,377,15332315,43,0,1,1,11497
0070559439ce5e25575827d8a3751bdc02c398d8,0,Marcus Christie,2018-06-04 12:01:29-04:00,['3fd4d4d6a1abe128b90c26c21d134b36732b9c6e'],21,98,119,15332434,1,0.323529412,0.838235294,0.75,11497
79a314ef801910b2a02c1c3a060cf5ecff33b4a9,1,Marcus Christie,2018-06-04 14:12:08-04:00,['0070559439ce5e25575827d8a3751bdc02c398d8'],521,559,1080,15333514,10,0.052631579,0.052631579,0.894736842,11497
5b069764b40d2d305018a5ba8ca99336ca5fd3d1,0,Marcus Christie,2018-06-04 14:12:50-04:00,['79a314ef801910b2a02c1c3a060cf5ecff33b4a9'],45,0,45,15333559,4,1,1,0.292682927,11497
0174bac0b958855070f69c5c2cf53d14ab395c19,0,Marcus Christie,2018-06-04 14:35:50-04:00,['5b069764b40d2d305018a5ba8ca99336ca5fd3d1'],38,5,43,15333602,3,1,0,0,11497
359434fe648d63b7677bf62c7868d6d4c1f31f6f,0,Eroma Abeysinghe,2018-06-04 16:33:56-04:00,['433210bab0448c4dec937c2e5d310892dcf2efe5'],2,2,4,15333606,1,,,,11497
e55f3cff0553ffe77a093bf192282a243d353c5c,0,Marcus Christie,2018-06-04 19:05:53-04:00,['0174bac0b958855070f69c5c2cf53d14ab395c19'],16,15,31,15333637,2,,,,11497
931b425d7d9dc543c5168e8f4173d4769b12fd0f,1,Marcus Christie,2018-06-05 09:51:19-04:00,['e55f3cff0553ffe77a093bf192282a243d353c5c'],12,14,26,15333663,4,0,1,1,11497
a75bac688f57855616cf8298ebcf54a4fc7f3255,0,Marcus Christie,2018-06-05 10:07:49-04:00,['931b425d7d9dc543c5168e8f4173d4769b12fd0f'],3,3,6,15333669,2,,,,11497
21533f6444bf1f1c5221df646c12e9cff15339ee,0,Marcus Christie,2018-06-05 10:44:51-04:00,['a75bac688f57855616cf8298ebcf54a4fc7f3255'],0,17,17,15333686,1,0,0,1,11497
10d4d7fe66273617bc46fff9bb134447b7c7eda4,0,Marcus Christie,2018-06-05 11:39:42-04:00,['21533f6444bf1f1c5221df646c12e9cff15339ee'],0,34,34,15333720,2,0,0,0,11497
790d446cae4cb1a630d2a49374ae0e693eac9c68,1,Marcus Christie,2018-06-05 11:41:23-04:00,['10d4d7fe66273617bc46fff9bb134447b7c7eda4'],33366,42407,75773,15409493,13,0.328147788,0.436193486,0.959285367,11497
21fc75ec27051d83feb006a3a1c61e0c01b849bb,0,Marcus Christie,2018-06-05 12:56:48-04:00,['790d446cae4cb1a630d2a49374ae0e693eac9c68'],1,11,12,15409505,2,1,1,0,11497
10753c592e09cea51691ef23b28ad66403910da8,1,Marcus Christie,2018-06-05 17:00:18-04:00,['21fc75ec27051d83feb006a3a1c61e0c01b849bb'],1,5,6,15409511,4,0,1,1,11497
87b6b2f080fdd12502ece92d11a01e4c20294747,0,dimuthu,2018-06-06 09:01:49-04:00,['f5aeb4b086046ccd6d193eac897886cb63873c8e'],1,3,4,15409515,1,0,1,1,11497
d5c2bdf4d380991fbd6eba584cd99dc65357356e,0,dimuthu,2018-06-06 09:33:54-04:00,['87b6b2f080fdd12502ece92d11a01e4c20294747'],2,2,4,15409519,1,,,,11497
8dacd905dd5e4f3827bc9012442dde150bc7fd01,1,Marcus Christie,2018-06-06 09:38:12-04:00,['10753c592e09cea51691ef23b28ad66403910da8'],44,63,107,15409626,1,1,1,0,11497
f5bd24a7fd4ee29f3b4b2510387f1a175e6d0bc7,0,Marcus Christie,2018-06-06 10:37:06-04:00,['8dacd905dd5e4f3827bc9012442dde150bc7fd01'],16,49,65,15409691,3,0,0,1,11497
d2811fbd0356688a14509ce640e7a4e981374884,0,Marcus Christie,2018-06-06 11:47:50-04:00,['f5bd24a7fd4ee29f3b4b2510387f1a175e6d0bc7'],4,72,76,15409767,5,0.441176471,1,0.558823529,11497
f56bbe36f8f895e645c10b3ab1e00235756dbdf3,1,Marcus Christie,2018-06-06 11:52:53-04:00,['d2811fbd0356688a14509ce640e7a4e981374884'],20226,29946,50172,15459939,14,0.328227571,0.458746299,0.949800489,11503
64b567846647526d3309234f4d6cce2b83239f28,0,Marcus Christie,2018-06-06 12:07:40-04:00,['f56bbe36f8f895e645c10b3ab1e00235756dbdf3'],11,1,12,15459951,2,1,0,0,11503
7d0458147dd34b2999828e58f892b681e99eb851,0,Marcus Christie,2018-06-06 12:16:34-04:00,['64b567846647526d3309234f4d6cce2b83239f28'],1,1,2,15459953,1,,,,11503
10749a7e580411e4ca87c73536c1173aa5291d4c,0,dimuthu,2018-06-06 13:43:17-04:00,['d5c2bdf4d380991fbd6eba584cd99dc65357356e'],2,2,4,15459957,2,,,,11503
2919c7af8328a159eeb5aef0d7dddb0211088d27,0,Marcus Christie,2018-06-06 14:01:48-04:00,['7d0458147dd34b2999828e58f892b681e99eb851'],2,14,16,15459973,1,0,1,0,11503
2dbbfd50b9073931c07a78743d8f1529944fa043,0,Eroma Abeysinghe,2018-06-06 14:51:42-04:00,['359434fe648d63b7677bf62c7868d6d4c1f31f6f'],0,83,83,15460056,2,,,,11505
35e1c126287b2c906b5e7daaddae2724a8d64c7a,0,Eroma Abeysinghe,2018-06-06 14:52:56-04:00,['2dbbfd50b9073931c07a78743d8f1529944fa043'],1,1,2,15460058,1,,,,11505
f91e93c454d3b3ec69577773295ab10c1fb2dfb3,0,Marcus Christie,2018-06-07 11:12:59-04:00,['2919c7af8328a159eeb5aef0d7dddb0211088d27'],24,15,39,15460097,2,1,0.666666667,0.333333333,11505
ba0fb1adfd63b4a0183217171d5488dc274bd53e,1,Marcus Christie,2018-06-07 13:03:52-04:00,['f91e93c454d3b3ec69577773295ab10c1fb2dfb3'],6,3,9,15460106,2,1,1,0,11505
908471f24974b409f198f6adec1d4b6e4d3673d4,0,Marcus Christie,2018-06-07 15:13:43-04:00,['ba0fb1adfd63b4a0183217171d5488dc274bd53e'],1,57,58,15460164,3,0,1,1,11505
1b81890edd93a375d54fca4b5d450a9c4c879b8e,0,Marcus Christie,2018-06-08 09:48:42-04:00,['908471f24974b409f198f6adec1d4b6e4d3673d4'],1,1,2,15460166,1,,,,11505
28cb205d9471fe8152abcf2dbf729e97b367be70,1,Marcus Christie,2018-06-08 16:47:37-04:00,['1b81890edd93a375d54fca4b5d450a9c4c879b8e'],10,33,43,15460209,3,0.333333333,0.583333333,1,11505
a79b48465d9edc844fada683d2eb777e4eb0cf7d,0,Marcus Christie,2018-06-08 17:09:03-04:00,['35e1c126287b2c906b5e7daaddae2724a8d64c7a'],0,48,48,15460257,4,0.413793103,1,0.413793103,11505
32a58cf879aa7582409b912c153a4faefb4bb87e,0,Marcus Christie,2018-06-08 17:09:20-04:00,['a79b48465d9edc844fada683d2eb777e4eb0cf7d'],0,1490,1490,15461747,2,0.459507042,0.655809859,0.977992958,11505
5ba95f9ed8ac28e21017a792e97ece1943fc3146,0,Marcus Christie,2018-06-08 17:15:41-04:00,"['28cb205d9471fe8152abcf2dbf729e97b367be70', '32a58cf879aa7582409b912c153a4faefb4bb87e']",214,2618,2832,15464579,61,,,,11505
3f4b69ff2f39be4783600a146a02b101d19b2d81,1,Marcus Christie,2018-06-11 09:57:15-04:00,['5ba95f9ed8ac28e21017a792e97ece1943fc3146'],3,11,14,15464593,3,0.25,1,1,11505
1d32f811cfea590639cf40577bdf9d858b195b13,0,yasgun,2018-06-11 20:04:24+05:18,['39d81aa6d0abe1f7bc882ed830fa4abdd1f0f34f'],64,47,111,15464704,2,0.625,0,0,11505
c2c86a3e1305f18c1fcc73cefb567ee102705d0f,1,Marcus Christie,2018-06-11 11:22:22-04:00,['3f4b69ff2f39be4783600a146a02b101d19b2d81'],21,16,37,15464741,5,0,0,0,11505
0d3e2872619530107a5d3942ed5298b41a0214c1,1,Marcus Christie,2018-06-11 11:53:55-04:00,['c2c86a3e1305f18c1fcc73cefb567ee102705d0f'],5,20,25,15464766,3,0,0.5,1,11505
ff0c734c6c41a59beb8f354826e2bd7bd9b08ab9,1,Marcus Christie,2018-06-11 12:36:24-04:00,['0d3e2872619530107a5d3942ed5298b41a0214c1'],75,121,196,15464962,10,0,0,1,11505
d14aea5840a18d2dadf02b971fb5ec1b23d0f4c8,0,Marcus Christie,2018-06-11 16:12:51-04:00,['ff0c734c6c41a59beb8f354826e2bd7bd9b08ab9'],0,17,17,15464979,2,0,1,1,11505
2c489dc72ed88f6b223ca2615c5510f637a01553,1,Marcus Christie,2018-06-12 12:03:46-04:00,['d14aea5840a18d2dadf02b971fb5ec1b23d0f4c8'],475,83,558,15465537,7,0.254826255,0.092664093,0.281853282,11505
31120306ca5fd3f396156e78e3d624142187662f,1,Marcus Christie,2018-06-12 12:05:21-04:00,['2c489dc72ed88f6b223ca2615c5510f637a01553'],13,44,57,15465594,3,0.833333333,1,1,11505
78a6fa9557c3443500ae2f68f041fe099c9a0c3b,0,yasgun,2018-06-13 01:33:31+05:18,['1d32f811cfea590639cf40577bdf9d858b195b13'],0,136,136,15465730,1,0.689655172,1,0.637931034,11506
cbf08276f69c10643f9c568e014933db6414d6ce,0,Eroma Abeysinghe,2018-06-13 10:15:56-04:00,['35e1c126287b2c906b5e7daaddae2724a8d64c7a'],0,1,1,15465731,1,,,,11506
f3a316f79f826a0ec36576075364a88fc96bacdd,0,yasgun,2018-06-13 21:39:07+05:18,['78a6fa9557c3443500ae2f68f041fe099c9a0c3b'],51,57,108,15465839,1,0.875,1,0.125,11506
10f1c7f7bc82cafca738973e8f9587a7403af9c0,0,Marcus Christie,2018-06-13 16:19:49-04:00,['31120306ca5fd3f396156e78e3d624142187662f'],0,31,31,15465870,2,0,1,1,11506
1c5e648797a7ea6aa28eea7a1050ff5cdb55ac0b,1,Marcus Christie,2018-06-14 10:05:57-04:00,['10f1c7f7bc82cafca738973e8f9587a7403af9c0'],50,26,76,15465946,9,,,,11506
3a7f7f1e81212ac631f129526cdeafcbc2610af0,0,yasgun,2018-06-14 19:28:40+05:18,['f3a316f79f826a0ec36576075364a88fc96bacdd'],13,75,88,15466034,1,1,1,0,11506
b2395fefa4d01e2aba0fffdb5219a107ad7157cf,0,yasgun,2018-06-14 19:59:16+05:18,['3a7f7f1e81212ac631f129526cdeafcbc2610af0'],0,1,1,15466035,1,0,0,1,11506
5b2aa800a1e9e47a713dc07e89eff7130291a118,1,Marcus Christie,2018-06-15 09:31:48-04:00,['1c5e648797a7ea6aa28eea7a1050ff5cdb55ac0b'],5,20,25,15466060,4,,,,11506
46de1e4096d0fd8cb8ae58e608c65a595b4386d3,0,Marcus Christie,2018-06-15 10:04:34-04:00,['5b2aa800a1e9e47a713dc07e89eff7130291a118'],66,66,132,15466192,2,,,,11506
4f334fa864bab290f21938df5b36d413ed06eed6,0,Marcus Christie,2018-06-15 10:35:23-04:00,['46de1e4096d0fd8cb8ae58e608c65a595b4386d3'],9,31,40,15466232,3,0,1,1,11506
d26886658a39d86360ed9407afa84f271edbafa7,0,Marcus Christie,2018-06-18 11:33:26-04:00,['4f334fa864bab290f21938df5b36d413ed06eed6'],18,57,75,15466307,2,0,0,0.078947368,11506
8863fb9cf06efb9ec49a2b3fcfc306edf32ec758,1,dimuthu,2018-06-18 11:53:07-04:00,['d26886658a39d86360ed9407afa84f271edbafa7'],839,3284,4123,15470430,31,0.318987342,0.937974684,0.727848101,11513
19a0373b933286bf4ce404af2a5f3701db7ec896,0,Marcus Christie,2018-06-18 14:42:02-04:00,['8863fb9cf06efb9ec49a2b3fcfc306edf32ec758'],1,3,4,15470434,1,0,0,0,11513
b7b80546ccec7f858f59b25ef1691312a71ddf9f,0,Marcus Christie,2018-06-18 14:42:03-04:00,['19a0373b933286bf4ce404af2a5f3701db7ec896'],8,3,11,15470445,2,0,0,0,11513
cba802c3dc2d7d7bbbc52e220b6abbf830f78164,0,Marcus Christie,2018-06-18 15:07:31-04:00,['b7b80546ccec7f858f59b25ef1691312a71ddf9f'],3,0,3,15470448,1,,,,11513
5c350069266835958d72dcf2e77adbbfe0d3acac,0,Marcus Christie,2018-06-18 15:14:24-04:00,['cba802c3dc2d7d7bbbc52e220b6abbf830f78164'],1,1,2,15470450,1,,,,11513
aae3c6e92e2dc62f44efa76f411bc923e0a62cdf,1,Marcus Christie,2018-06-18 15:38:40-04:00,['5c350069266835958d72dcf2e77adbbfe0d3acac'],1,2,3,15470453,2,,,,11513
e390b5a5a80f46dd7456f58c4d6b2097b101e02c,0,Marcus Christie,2018-06-18 16:50:16-04:00,['aae3c6e92e2dc62f44efa76f411bc923e0a62cdf'],1,1,2,15470455,1,,,,11513
6e26230453d75eb54e9e633a170ae3ea6ba6fe0f,0,Marcus Christie,2018-06-18 17:15:01-04:00,['e390b5a5a80f46dd7456f58c4d6b2097b101e02c'],1,1,2,15470457,1,,,,11513
65ddb61b637463906c108b79ed818735e31f723c,0,Marcus Christie,2018-06-19 09:25:11-04:00,['6e26230453d75eb54e9e633a170ae3ea6ba6fe0f'],2,33,35,15470492,2,0.923076923,1,0.076923077,11513
bb94eb5f54e8accc4aa1f1d153499cbb4afacc49,0,Marcus Christie,2018-06-19 10:12:34-04:00,['65ddb61b637463906c108b79ed818735e31f723c'],43,69,112,15470604,3,0,1,0.315789474,11513
5122cab0e2117eab09006a1f94389dfd8828e426,0,Marcus Christie,2018-06-19 10:32:17-04:00,['bb94eb5f54e8accc4aa1f1d153499cbb4afacc49'],0,4,4,15470608,4,,,,11513
830588cb4d4156b879afa58891333bb06d0563fb,1,Karan Kotabagi,2018-06-19 11:29:51-04:00,['5122cab0e2117eab09006a1f94389dfd8828e426'],461,195,656,15471264,20,0,0,0,11513
a493b408a8d29fef268a6cc48c050d49ebc591a1,0,GitHub,2018-06-19 12:04:31-04:00,"['5122cab0e2117eab09006a1f94389dfd8828e426', '830588cb4d4156b879afa58891333bb06d0563fb']",461,195,656,15471920,20,,,,11513
d4e0007c65d4f2ede65b53ff79a1a7c276c0a67c,1,Marcus Christie,2018-06-19 12:50:08-04:00,['a493b408a8d29fef268a6cc48c050d49ebc591a1'],0,38,38,15471958,2,0,1,0,11513
12790935052cfc2ea1bd0c90bc0cb4785e83ef52,1,Marcus Christie,2018-06-19 12:50:09-04:00,['d4e0007c65d4f2ede65b53ff79a1a7c276c0a67c'],2067,4343,6410,15478368,5,0.35631518,0.380069525,0.909617613,11513
c40d8f1ba5848d2ae8a85adf4008999a5a43b1f2,0,Eroma Abeysinghe,2018-06-20 09:44:56-04:00,['cbf08276f69c10643f9c568e014933db6414d6ce'],0,1,1,15478369,1,,,,11513
1e1b084a1cb464f3c2c80c81a2e47714401ecc79,0,Marcus Christie,2018-06-20 11:48:10-04:00,['12790935052cfc2ea1bd0c90bc0cb4785e83ef52'],19,18,37,15478406,2,,,,11513
047c6bffaaa5ecd9671a926e1a555ab806407060,1,Marcus Christie,2018-06-20 11:49:01-04:00,['1e1b084a1cb464f3c2c80c81a2e47714401ecc79'],943,126,1069,15479475,3,0.95709571,1,0.059405941,11513
befba326cbad0363fbd9da5910c5f69cf06bff9b,0,yasgun,2018-06-20 22:12:27+05:18,['b2395fefa4d01e2aba0fffdb5219a107ad7157cf'],18,16,34,15479509,2,0,0,,11513
f04ac5f27b88098d5df081c7b49302403225ed81,0,GitHub,2018-06-20 15:35:32-04:00,"['39d81aa6d0abe1f7bc882ed830fa4abdd1f0f34f', 'befba326cbad0363fbd9da5910c5f69cf06bff9b']",73,259,332,15479841,3,,,,11513
abf24ff7d6039d0aa91f7b873c5c7f021b20f50a,0,dimuthu,2018-06-21 12:05:16-04:00,['10749a7e580411e4ca87c73536c1173aa5291d4c'],0,673,673,15480514,14,,,,11527
9c4f74e710e134fa8a74e67d4eb9838e7a4b86f5,0,dimuthu,2018-06-21 17:08:09-04:00,"['04d4640ced1072b0199af9d69f6e992997070d40', 'c40d8f1ba5848d2ae8a85adf4008999a5a43b1f2']",17023,27830,44853,15525367,101,,,,11527
21c3a59a562614f1c4af16ec05e4583d6c8f427d,0,dimuthu,2018-06-21 23:12:14-04:00,['9c4f74e710e134fa8a74e67d4eb9838e7a4b86f5'],13,88,101,15525468,6,0.367346939,0.959183673,0.959183673,11527
f2be22156d029b4c9c411780d6959baae5bc9610,0,Marcus Christie,2018-06-25 15:03:41-04:00,['047c6bffaaa5ecd9671a926e1a555ab806407060'],1,478,479,15525947,5,0.035928144,0.946107784,1,11528
eb07965fbe9028e21c40bb0ed0f331603762c781,0,Marcus Christie,2018-06-25 16:57:22-04:00,"['c40d8f1ba5848d2ae8a85adf4008999a5a43b1f2', '32a58cf879aa7582409b912c153a4faefb4bb87e']",0,1538,1538,15527485,6,,,,11528
356049e5691817559d78d664a3d37c34475faf4e,0,dimuthu,2018-06-26 14:38:57-04:00,"['21c3a59a562614f1c4af16ec05e4583d6c8f427d', 'eb07965fbe9028e21c40bb0ed0f331603762c781']",0,1538,1538,15529023,6,,,,11528
aa897d80898f774f7edfb6f205446b5a86c310c2,0,dimuthu,2018-06-27 17:13:41-04:00,['abf24ff7d6039d0aa91f7b873c5c7f021b20f50a'],4,6,10,15529033,1,0,0,1,11528
a645e5120bbdc4c1fef8466b362cdf9e47a4d549,0,dimuthu,2018-06-27 17:14:24-04:00,['aa897d80898f774f7edfb6f205446b5a86c310c2'],82,96,178,15529211,1,0,0,1,11528
826ccb8eca3b470f75d893af23788da6870bb561,0,Marcus Christie,2018-07-05 11:14:41-04:00,['f2be22156d029b4c9c411780d6959baae5bc9610'],4,12,16,15529227,1,0,0,0,11528
99d500ad5a91c3ea5bb150c89fb5d506ab7c127f,0,dimuthu,2018-07-10 12:42:06-04:00,['a645e5120bbdc4c1fef8466b362cdf9e47a4d549'],3,28,31,15529258,4,1,1,0.555555556,11528
6df7cbc00017236466ae367618b6377296928b6e,0,dimuthu,2018-07-10 13:06:04-04:00,['99d500ad5a91c3ea5bb150c89fb5d506ab7c127f'],1,2,3,15529261,1,0,0,1,11528
321b79e88b528ec5a399f8a8e55147bce74225ab,0,dimuthu,2018-07-10 14:42:10-04:00,['6df7cbc00017236466ae367618b6377296928b6e'],5,16,21,15529282,1,0.875,0.875,0.375,11528
04610525e308c190976e440068d68bfdabe7eaf9,0,dimuthu,2018-07-10 15:50:25-04:00,['321b79e88b528ec5a399f8a8e55147bce74225ab'],7,41,48,15529330,1,0.428571429,1,0.607142857,11528
5d667d437b7d58383e8a95d0cfd47cbf3b367bb0,0,dimuthu,2018-07-10 15:56:40-04:00,['04610525e308c190976e440068d68bfdabe7eaf9'],1,10,11,15529341,1,0,1,1,11528
2de372ee367223fb8417563ffa10477c44c17228,0,dimuthu,2018-07-10 16:11:57-04:00,['5d667d437b7d58383e8a95d0cfd47cbf3b367bb0'],1,1,2,15529343,1,,,,11528
bb68c49e7e088f2a61a74e219032dd0776c613b7,0,dimuthu,2018-07-10 16:35:00-04:00,['2de372ee367223fb8417563ffa10477c44c17228'],2,2,4,15529347,1,,,,11528
93bfe76c9278119995df7a4449e2d978349859b6,0,dimuthu,2018-07-11 09:51:49-04:00,['bb68c49e7e088f2a61a74e219032dd0776c613b7'],2,2,4,15529351,1,,,,11528
3764bba64b264fbb1c80bc54c2be4382fce11aa0,0,Eroma Abeysinghe,2018-07-12 11:43:31-04:00,['eb07965fbe9028e21c40bb0ed0f331603762c781'],0,83,83,15529434,2,,,,11530
05cdb25bb305506595dc6122c5bb97daec8372f6,0,Eroma Abeysinghe,2018-07-12 12:22:49-04:00,['3764bba64b264fbb1c80bc54c2be4382fce11aa0'],1,1,2,15529436,1,,,,11530
1aab9bb923350640d09fc1f5d528744064d8b13b,0,Marcus Christie,2018-07-16 11:17:49-04:00,['826ccb8eca3b470f75d893af23788da6870bb561'],2,180,182,15529618,7,0.136986301,1,0,11530
228f0fea59f828aa2b986f910daf7dec83a92309,1,Marcus Christie,2018-07-16 11:20:34-04:00,['1aab9bb923350640d09fc1f5d528744064d8b13b'],9204,12600,21804,15551422,4,0.408841941,0.466353678,0.942097027,11530
ed3e4c8293beaf6ded7de72b034a429a04b540f4,1,Marcus Christie,2018-07-16 12:09:28-04:00,['228f0fea59f828aa2b986f910daf7dec83a92309'],0,5,5,15551427,1,1,1,0,11530
e3c45d1bad447db52561e7a0eb9d24cca4bea9fb,0,Marcus Christie,2018-07-16 18:44:09-04:00,['ed3e4c8293beaf6ded7de72b034a429a04b540f4'],5,7,12,15551439,2,,,1,11530
f9d666c4761995fd067fa0e527288af6003f841e,1,Marcus Christie,2018-07-16 18:44:56-04:00,['e3c45d1bad447db52561e7a0eb9d24cca4bea9fb'],166,22,188,15551627,3,0.693069307,1,0.257425743,11530
637709f80f1a023e64ae8e190d95dac52a4e45d6,0,Marcus Christie,2018-07-17 10:02:24-04:00,['f9d666c4761995fd067fa0e527288af6003f841e'],7,16,23,15551650,2,0,1,1,11530
7a0cce137e2a216dd33ec9a9f0560855bd706f37,0,Marcus Christie,2018-07-17 10:33:03-04:00,['637709f80f1a023e64ae8e190d95dac52a4e45d6'],1,7,8,15551658,1,,,,11530
aeb78acc9161bde3e1f17cada96accd97d65732e,0,dimuthu,2018-07-17 13:07:43-04:00,['356049e5691817559d78d664a3d37c34475faf4e'],1,11,12,15551670,1,0,0,1,11530
ea75438a4d6a367bdbd7eedd1b753b0de0dcb4e8,0,Eroma Abeysinghe,2018-07-17 13:27:44-04:00,['05cdb25bb305506595dc6122c5bb97daec8372f6'],1,1,2,15551672,1,,,,11530
024428811e18ab559605aa8291a67087fadc667c,0,Eroma Abeysinghe,2018-07-17 13:52:45-04:00,['ea75438a4d6a367bdbd7eedd1b753b0de0dcb4e8'],1,1,2,15551674,1,,,,11530
f8f78c06f12a04652ff478ae11b77728ea1b5aa5,0,GitHub,2018-07-17 16:49:25-04:00,"['0237a7c1592561226936e6989f55117cc92ce0be', '7a0cce137e2a216dd33ec9a9f0560855bd706f37']",45715,110681,156396,15708070,520,,,,11530
96c54e24e0ec8c4872d9f1e4fe8d7414e2af4d2e,0,GitHub,2018-07-17 16:51:08-04:00,"['7a0cce137e2a216dd33ec9a9f0560855bd706f37', 'f8f78c06f12a04652ff478ae11b77728ea1b5aa5']",13,248,261,15708331,8,,,,11530
4144f81dd79ae7249221bdca2b7bb54c5af025bf,1,Marcus Christie,2018-07-17 17:24:38-04:00,['96c54e24e0ec8c4872d9f1e4fe8d7414e2af4d2e'],7,7,14,15708345,2,,,,11530
2bbfd8cdee0a8411c674fed10f91afcd9c0649b8,0,dimuthu,2018-07-19 10:03:25-04:00,"['93bfe76c9278119995df7a4449e2d978349859b6', 'f04ac5f27b88098d5df081c7b49302403225ed81']",73,259,332,15708677,3,,,,11530
8fcc7a917700eb6f0afd76c61a252a3041e2e6e5,0,Marcus Christie,2018-07-19 12:41:25-04:00,"['f04ac5f27b88098d5df081c7b49302403225ed81', '4144f81dd79ae7249221bdca2b7bb54c5af025bf']",96332,228313,324645,16033322,487,,,,11530
1ca7c57ad1615551b03ebbe2eef629720b9ce050,0,Marcus Christie,2018-07-19 14:15:44-04:00,['8fcc7a917700eb6f0afd76c61a252a3041e2e6e5'],18,18,36,16033358,1,1,0,1,11530
1adf1bd5ad9727dd0f4739088d7a0c048cf7115c,0,Marcus Christie,2018-07-19 14:19:02-04:00,['1ca7c57ad1615551b03ebbe2eef629720b9ce050'],2,1,3,16033361,1,,,,11530
f463f1de86e3bebb102aae9f37781d6343d687b8,0,Marcus Christie,2018-07-19 14:32:44-04:00,['1adf1bd5ad9727dd0f4739088d7a0c048cf7115c'],1,5,6,16033367,1,0,0,1,11530
0c4e24612cb94796f62119534008dde92d337d29,0,Marcus Christie,2018-07-19 14:44:06-04:00,['f463f1de86e3bebb102aae9f37781d6343d687b8'],0,11,11,16033378,1,0,0,1,11530
15ab2eaa34a5757ffa9228e7015631a5a0cdc127,0,Marcus Christie,2018-07-19 14:51:53-04:00,['0c4e24612cb94796f62119534008dde92d337d29'],2,7,9,16033387,1,0,0,1,11530
3cf1da46da16aae50e164a005465d2ddbba26b56,0,Marcus Christie,2018-07-19 15:00:06-04:00,['15ab2eaa34a5757ffa9228e7015631a5a0cdc127'],0,1,1,16033388,1,0,0,1,11530
fa161fd3cb8d8cc0697367c07c93c9d9513e94d7,0,dimuthu,2018-07-19 15:25:28-04:00,['aeb78acc9161bde3e1f17cada96accd97d65732e'],1,1,2,16033390,1,,,,11530
2b491664ffd6b5dc7f63a834b26f39ec591ffd84,0,Marcus Christie,2018-07-19 15:33:09-04:00,['3cf1da46da16aae50e164a005465d2ddbba26b56'],0,5,5,16033395,1,0,1,1,11530
ca4d613ddb114f5502f03eaf6736104d7b4f415e,0,Marcus Christie,2018-07-20 14:08:46-04:00,['2b491664ffd6b5dc7f63a834b26f39ec591ffd84'],472,0,472,16033867,3,0.975757576,0.054545455,0,11530
2002fe624e81dbf0a001f43c077fea79c4be000c,0,Marcus Christie,2018-07-21 20:02:27-04:00,['ca4d613ddb114f5502f03eaf6736104d7b4f415e'],4,19,23,16033890,4,0.875,1,1,11530
d679f53d2dd5ca709a13dcc601e1d5e76892ce7a,0,Marcus Christie,2018-07-22 12:20:29-04:00,['024428811e18ab559605aa8291a67087fadc667c'],0,8,8,16033898,3,,,,11530
d8a7f582873942e5c2c318bf2bb96f298a3bb911,0,Marcus Christie,2018-07-22 12:21:27-04:00,"['2002fe624e81dbf0a001f43c077fea79c4be000c', 'd679f53d2dd5ca709a13dcc601e1d5e76892ce7a']",1,94,95,16033993,7,,,,11530
a3520c9aafcce769f6fa1c6e69de969545c1cde5,0,Marcus Christie,2018-07-22 12:46:34-04:00,['d679f53d2dd5ca709a13dcc601e1d5e76892ce7a'],0,3,3,16033996,1,,,,11530
c06a1ba83e96a49c1ef0a6829b29280490be1568,0,Marcus Christie,2018-07-22 12:47:19-04:00,"['d8a7f582873942e5c2c318bf2bb96f298a3bb911', 'a3520c9aafcce769f6fa1c6e69de969545c1cde5']",0,3,3,16033999,1,,,,11530
f4269d61d25660e482707b0d62431f100074ad26,0,Marcus Christie,2018-07-22 13:33:40-04:00,['c06a1ba83e96a49c1ef0a6829b29280490be1568'],8,16,24,16034023,2,1,1,0,11530
90dfbb61ac0ec0a80c23ceda0c6637ea42a316f6,0,Marcus Christie,2018-07-22 13:40:34-04:00,['a3520c9aafcce769f6fa1c6e69de969545c1cde5'],0,3,3,16034026,1,,,,11530
937d7253fcc6ff079c4e7481cb9982d5f2f83146,0,Marcus Christie,2018-07-22 13:50:14-04:00,['f4269d61d25660e482707b0d62431f100074ad26'],1,5,6,16034032,1,0,1,1,11530
239f69fada04d6f05f5191916c564e92d1c4672f,0,yasgun,2018-07-24 18:34:33+05:18,['937d7253fcc6ff079c4e7481cb9982d5f2f83146'],0,10542,10542,16044574,21,0.303184547,0.328765335,0.994518403,11550
285611943d6d3ff3166c1f854547b6516f40082b,1,yasgun,2018-07-24 18:34:35+05:18,['239f69fada04d6f05f5191916c564e92d1c4672f'],1143,3612,4755,16049329,36,0.751243781,0.659701493,0.99800995,11569
b42aa8ac6e05047f29d29f89e9c046ceb5953cbe,1,yasgun,2018-07-24 18:34:35+05:18,['285611943d6d3ff3166c1f854547b6516f40082b'],414,2051,2465,16051794,31,0.447204969,0.500621118,0.997515528,11576
9dd562d76a09ee022cc1d1777b65befc2ac538a0,0,Marcus Christie,2018-07-24 09:45:56-04:00,['90dfbb61ac0ec0a80c23ceda0c6637ea42a316f6'],7,3,10,16051804,1,,,,11576
b74017225e4af9d618e0776e241897bbcf6e2a26,1,yasgun,2018-07-24 19:12:16+05:18,['b42aa8ac6e05047f29d29f89e9c046ceb5953cbe'],106,737,843,16052647,16,0.637837838,0.935135135,1,11579
2d39bb1a940cdc91173e4be462ea1f10925d526b,0,Marcus Christie,2018-07-24 13:51:58-04:00,['937d7253fcc6ff079c4e7481cb9982d5f2f83146'],0,83,83,16052730,2,,,,11581
7055d80a8179dca952b1bd1b884f98099322fd93,0,Eroma Abeysinghe,2018-07-26 06:09:30-04:00,['9dd562d76a09ee022cc1d1777b65befc2ac538a0'],0,83,83,16052813,2,,,,11583
d730bbb8af425397ea7abe9779c486ab8049e1af,0,Eroma Abeysinghe,2018-07-26 06:30:16-04:00,['7055d80a8179dca952b1bd1b884f98099322fd93'],1,1,2,16052815,1,,,,11583
20753c80f42c8891dd96d3ebdfa9e508db15bf24,0,Eroma Abeysinghe,2018-07-26 06:38:45-04:00,['d730bbb8af425397ea7abe9779c486ab8049e1af'],1,3,4,16052819,1,,,,11583
22d1db2cfd83156f2fa868fcd072c7ad34a002ce,0,Eroma Abeysinghe,2018-07-26 10:46:31-04:00,['20753c80f42c8891dd96d3ebdfa9e508db15bf24'],4,4,8,16052827,1,,,,11583
0cd309b5cc183f3c1df31da73ec10f8f77866068,0,Eroma Abeysinghe,2018-07-26 13:32:08-04:00,['22d1db2cfd83156f2fa868fcd072c7ad34a002ce'],4,4,8,16052835,1,,,,11583
723cf790d41201e2a9fcbf62108334e52e66ffbb,0,yasgun,2018-07-28 00:43:33+05:18,['b74017225e4af9d618e0776e241897bbcf6e2a26'],6,7,13,16052848,1,0,0,1,11583
b220c3609eece9880561bb3ef5474fe32550c76c,0,yasgun,2018-07-28 00:54:27+05:18,"['723cf790d41201e2a9fcbf62108334e52e66ffbb', '2d39bb1a940cdc91173e4be462ea1f10925d526b']",0,83,83,16052931,2,,,,11583
dd81c47cc9eda3454a95272555867e8076973489,0,GitHub,2018-07-31 10:05:52-04:00,"['2d39bb1a940cdc91173e4be462ea1f10925d526b', 'b220c3609eece9880561bb3ef5474fe32550c76c']",1056,16336,17392,16070323,65,,,,11583
bcf97ce32d6d1066b9bc884dfa1275b76e110541,1,Marcus Christie,2018-08-01 12:02:09-04:00,['dd81c47cc9eda3454a95272555867e8076973489'],1,2,3,16070326,1,,,,11583
658550e35fd3dc08b8d4b79a42f45322e9868cfe,0,dimuthu,2018-08-01 15:58:23-04:00,"['bcf97ce32d6d1066b9bc884dfa1275b76e110541', '2bbfd8cdee0a8411c674fed10f91afcd9c0649b8']",115,1253,1368,16071694,41,,,,11583
6118d045b43f6d630770e2e41b096302af53d05e,0,dimuthu,2018-08-02 09:40:01-04:00,['658550e35fd3dc08b8d4b79a42f45322e9868cfe'],5,989,994,16072688,19,0.607317073,0.892682927,0.870731707,11595
096488938f62766098fc0dd0da0cc6b08a5edb54,1,Marcus Christie,2018-08-03 11:17:01-04:00,['6118d045b43f6d630770e2e41b096302af53d05e'],1,984,985,16073673,17,,,,11611
9500630370fbf2e5929ce684c9622f323bae3c44,1,Marcus Christie,2018-08-03 11:57:56-04:00,['096488938f62766098fc0dd0da0cc6b08a5edb54'],2,57,59,16073732,4,,,,11613
558069bd9568bca4591dd4e4f588ec5a02f7ea69,1,Marcus Christie,2018-08-03 13:36:11-04:00,['9500630370fbf2e5929ce684c9622f323bae3c44'],4,4,8,16073740,2,,,,11613
825218d752e85b9b9d5756ab7da632a4f9abefce,0,Marcus Christie,2018-08-03 16:04:31-04:00,['558069bd9568bca4591dd4e4f588ec5a02f7ea69'],19,1,20,16073760,2,0,0,0,11613
c378737e28b982700fabdc6cc49f3f3eeac26e9e,0,Marcus Christie,2018-08-03 16:05:08-04:00,['825218d752e85b9b9d5756ab7da632a4f9abefce'],27,11,38,16073798,1,0.434782609,1,0,11613
76728d40d7924b789147cc865ff9aaa1c30abce9,0,Marcus Christie,2018-08-13 12:41:30-04:00,['c378737e28b982700fabdc6cc49f3f3eeac26e9e'],9,9,18,16073816,1,,,,11613
aa19979a7cca0627a65ced20fb54fea7ff80d470,0,Marcus Christie,2018-08-13 16:55:07-04:00,['76728d40d7924b789147cc865ff9aaa1c30abce9'],5,0,5,16073821,1,1,1,0,11613
f5a051d5be1a61fdb7de1df23044b3805c129a66,0,Eroma Abeysinghe,2018-08-14 23:58:13-04:00,['0cd309b5cc183f3c1df31da73ec10f8f77866068'],0,83,83,16073904,2,,,,11615
ad4221d79fef6d2da6c52491ac92030ccc17bb7d,0,Marcus Christie,2018-08-16 13:28:00-04:00,['f5a051d5be1a61fdb7de1df23044b3805c129a66'],0,5,5,16073909,2,,,,11615
c905ef59739bb9ad765457ca9baa04e6d09f882e,0,dimuthu,2018-08-23 21:51:16-04:00,['2bbfd8cdee0a8411c674fed10f91afcd9c0649b8'],40,94,134,16074043,7,0.565217391,0,0.565217391,11615
6c6cfdc01c58bd475f2ec488ae01822a3f3262f0,0,dimuthu,2018-08-23 22:34:45-04:00,['c905ef59739bb9ad765457ca9baa04e6d09f882e'],3,2,5,16074048,1,,,,11615
b4c3baba2672e5001b012a2fdb0a63457b1386dc,0,dimuthu,2018-08-23 23:12:19-04:00,['6c6cfdc01c58bd475f2ec488ae01822a3f3262f0'],0,1,1,16074049,1,,,,11615
c1b12e58cf0ccc941273725a91d102e8b5bae797,0,dimuthu,2018-08-24 11:29:15-04:00,['b4c3baba2672e5001b012a2fdb0a63457b1386dc'],1,1,2,16074051,1,,,,11615
a508aa29018c17cd228efeea88f7679f81abffdf,0,dimuthu,2018-08-27 16:50:12-04:00,['aa19979a7cca0627a65ced20fb54fea7ff80d470'],0,124,124,16074175,3,1,0.868852459,1,11617
ec1f07f8d8e767982ada0251ac9e389982d438b5,0,Marcus Christie,2018-08-28 17:31:27-04:00,['a508aa29018c17cd228efeea88f7679f81abffdf'],6,6,12,16074187,2,,,,11617
b377c7dff620d1286f976ccf3f15ea203dd07702,0,dimuthu,2018-08-29 01:28:24-04:00,['ec1f07f8d8e767982ada0251ac9e389982d438b5'],1117,1631,2748,16076935,14,0.095137421,0.126849894,0.917547569,11617
ec66759c4d519beae62391fd2efbfa596acd8e3c,0,dimuthu,2018-08-29 09:54:05-04:00,['b377c7dff620d1286f976ccf3f15ea203dd07702'],0,868,868,16077803,2,0.356666667,0.368333333,1,11619
71dffabc9c6221c258af8202c57481268c18c6f6,0,Marcus Christie,2018-08-30 09:31:21-04:00,['ad4221d79fef6d2da6c52491ac92030ccc17bb7d'],1,1,2,16077805,1,,,,11619
36f795c14e20f428d1d6cf93e9da37e3fbe0f98c,0,Marcus Christie,2018-09-04 17:35:30-04:00,['ec66759c4d519beae62391fd2efbfa596acd8e3c'],2,63,65,16077870,2,0,1,1,11619
b64f33b9455ed868f21f53dec911224495b115ea,0,lahiru-j,2018-09-05 18:54:59+05:18,['c1b12e58cf0ccc941273725a91d102e8b5bae797'],0,534,534,16078404,3,0.498054475,0.657587549,0.964980545,11622
1447321b22b5ec09d872fe4cc4f2241697068e40,0,lahiru-j,2018-09-05 18:55:56+05:18,['b64f33b9455ed868f21f53dec911224495b115ea'],0,467,467,16078871,5,0.906735751,1,0.901554404,11627
e0486d4f4267bf7d56452f6157ede12514d8999b,0,lahiru-j,2018-09-05 18:56:27+05:18,['1447321b22b5ec09d872fe4cc4f2241697068e40'],2,203,205,16079076,4,0.420454545,0.420454545,1,11629
4ff6b34954d07acedaecd5f7b0a9cc7425580f6a,0,lahiru-j,2018-09-05 18:57:10+05:18,['e0486d4f4267bf7d56452f6157ede12514d8999b'],0,418,418,16079494,7,,,,11635
9b40364929b85d414857d22b42c23c558d27d59a,0,lahiru-j,2018-09-05 18:57:42+05:18,['4ff6b34954d07acedaecd5f7b0a9cc7425580f6a'],86,179,265,16079759,8,0,0,1,11635
8a4eb0a1fc1de4b15078b57f328e300a7c6ca779,0,lahiru-j,2018-09-05 18:58:10+05:18,['9b40364929b85d414857d22b42c23c558d27d59a'],10,23,33,16079792,1,1,0.75,1,11635
2af909048a2860b41293183646dbef606f1e8a1a,0,GitHub,2018-09-06 21:09:36-04:00,"['c1b12e58cf0ccc941273725a91d102e8b5bae797', '8a4eb0a1fc1de4b15078b57f328e300a7c6ca779']",2,1728,1730,16081522,19,,,,11635
a43556eec57484167f1bbe1aed62343cfcc6026f,1,Marcus Christie,2018-09-07 12:25:39-04:00,['36f795c14e20f428d1d6cf93e9da37e3fbe0f98c'],1,2,3,16081525,1,0,1,1,11635
6c95c1b7cd778cb0ede5494ec3c81632c3a48ee2,0,Marcus Christie,2018-09-11 11:54:48-04:00,['a43556eec57484167f1bbe1aed62343cfcc6026f'],8,230,238,16081763,7,1,0.857142857,0.923076923,11638
1e78a00d6c799bdeed3c89cf41e45e285509b00a,0,Marcus Christie,2018-09-11 12:20:47-04:00,['6c95c1b7cd778cb0ede5494ec3c81632c3a48ee2'],6,6,12,16081775,1,,,,11638
8c513fb8c8d1c0b986f27fae6ec7e1c6e18dfa4e,0,Marcus Christie,2018-09-12 11:01:13-04:00,['1e78a00d6c799bdeed3c89cf41e45e285509b00a'],1,25,26,16081801,7,,,,11638
5d18d51dcc1e8c2842a425ac4a6c4f07ad526908,0,Marcus Christie,2018-09-12 11:36:29-04:00,['8c513fb8c8d1c0b986f27fae6ec7e1c6e18dfa4e'],13,71,84,16081885,4,0.263157895,0.131578947,1,11638
7d57a5eecc646dc699f08c2c7c5fbefc499eb06a,0,Marcus Christie,2018-09-12 16:51:23-04:00,['71dffabc9c6221c258af8202c57481268c18c6f6'],1,1,2,16081887,1,,,,11638
42be237cd0f43ffe2981fe7bf7c13bdef106c55a,0,Marcus Christie,2018-09-12 16:52:49-04:00,"['5d18d51dcc1e8c2842a425ac4a6c4f07ad526908', '7d57a5eecc646dc699f08c2c7c5fbefc499eb06a']",14,186,200,16082087,11,,,,11638
3e77e160986d53f0d5d8db1bd62102a937b478ef,0,Dimuthu Wannipurage,2018-09-14 14:04:24-04:00,"['42be237cd0f43ffe2981fe7bf7c13bdef106c55a', '2af909048a2860b41293183646dbef606f1e8a1a']",43,1823,1866,16083953,27,,,,11638
c377ff28f27934cfb85fef088fdad863324cd660,1,Dimuthu Wannipurage,2018-09-14 16:18:34-04:00,['3e77e160986d53f0d5d8db1bd62102a937b478ef'],137,175,312,16084265,3,0.194444444,0,1,11638
e1f9f8e26c1aa67bf8741932a86b17446277ceda,0,Marcus Christie,2018-09-14 18:34:07-04:00,['c377ff28f27934cfb85fef088fdad863324cd660'],1,1,2,16084267,1,,,,11638
0ba004e71e87e9c2801b479fc5674d3082a7e8d8,0,Marcus Christie,2018-09-17 10:23:19-04:00,['e1f9f8e26c1aa67bf8741932a86b17446277ceda'],5,5,10,16084277,1,,,,11638
a66e06dcec1be521f45b926309dec88b2bc45988,0,Marcus Christie,2018-09-17 12:50:17-04:00,['0ba004e71e87e9c2801b479fc5674d3082a7e8d8'],1,1,2,16084279,1,,,,11638
100f761cd0248de47279cee9eb25ddb1e1354e47,0,Marcus Christie,2018-09-18 17:07:59-04:00,['a66e06dcec1be521f45b926309dec88b2bc45988'],1,2,3,16084282,1,0,0,1,11638
9d04c6a4b28852a0240e0c5ea51745fcc9b203b7,1,Marcus Christie,2018-09-19 10:40:39-04:00,['5d18d51dcc1e8c2842a425ac4a6c4f07ad526908'],1,92,93,16084375,5,0,0.076923077,1,11638
4658347a21fcea3d4b93d4400444308727f88225,0,Marcus Christie,2018-09-19 13:45:53-04:00,['9d04c6a4b28852a0240e0c5ea51745fcc9b203b7'],0,5,5,16084380,1,0,0,1,11638
d8d4df200e1bec1e197deb10cfcd5b06590435cd,1,Marcus Christie,2018-09-20 16:31:30-04:00,['4658347a21fcea3d4b93d4400444308727f88225'],15851,6920,22771,16107151,16,0.579320755,0.498264151,0.040301887,11638
a145535b7c9e1b00006025c3cad0ffcf24f47503,0,Marcus Christie,2018-09-24 12:21:01-04:00,['d8d4df200e1bec1e197deb10cfcd5b06590435cd'],3,1,4,16107155,1,1,1,0,11638
f69def5697d3c5064679c24030527d80c5c37174,1,Marcus Christie,2018-09-24 12:35:45-04:00,['a145535b7c9e1b00006025c3cad0ffcf24f47503'],3754,6861,10615,16117770,5,0.410353535,0.48989899,0.927609428,11638
0afc1d941008ed76ed5aee982293d9425ce1d135,1,Marcus Christie,2018-09-24 12:55:03-04:00,['f69def5697d3c5064679c24030527d80c5c37174'],7057,4330,11387,16129157,10,0.74270428,0.701848249,0.108463035,11638
eb9b63e2738fa97ee4a38b7e81738965f62b9728,0,Marcus Christie,2018-09-24 12:55:21-04:00,"['100f761cd0248de47279cee9eb25ddb1e1354e47', '0afc1d941008ed76ed5aee982293d9425ce1d135']",16934,8477,25411,16154568,30,,,,11638
6e58da8570f9fc594c86c36a365484ad7c4af974,0,Marcus Christie,2018-09-24 13:04:55-04:00,['eb9b63e2738fa97ee4a38b7e81738965f62b9728'],3,1,4,16154572,1,,,,11638
0a8b27bfe7d37420ebff2ca075401ed5049d4fba,0,Dimuthu Wannipurage,2018-09-24 14:43:22-04:00,['6e58da8570f9fc594c86c36a365484ad7c4af974'],5,5,10,16154582,1,,,,11638
ece59df10d79de95677de36aa7fb289091476385,0,Dimuthu Wannipurage,2018-09-24 14:43:58-04:00,['0a8b27bfe7d37420ebff2ca075401ed5049d4fba'],1,1,2,16154584,1,,,,11638
f8761624cb610576e6241fae7e8cf1d84d8dce00,0,Dimuthu Wannipurage,2018-09-24 14:46:09-04:00,['ece59df10d79de95677de36aa7fb289091476385'],3,3,6,16154590,1,,,,11638
65933efe757cbf7d83e589ce5ceff0c0a05b4a04,0,Dimuthu Wannipurage,2018-09-24 14:47:24-04:00,['f8761624cb610576e6241fae7e8cf1d84d8dce00'],24,60,84,16154674,5,,,,11638
e0554fe34425d8746eec1dfc9a7ef98943554915,0,Dimuthu Wannipurage,2018-09-24 14:49:37-04:00,['2af909048a2860b41293183646dbef606f1e8a1a'],3,3,6,16154680,1,,,,11638
25a63e5658392d0212088b8bc98e1b20f7d3295a,0,Dimuthu Wannipurage,2018-09-24 14:54:37-04:00,['e0554fe34425d8746eec1dfc9a7ef98943554915'],2,2,4,16154684,1,1,1,1,11638
e59e62751362e2d4da1ef082464fc3ae77f815ee,1,Marcus Christie,2018-09-25 11:08:11-04:00,['65933efe757cbf7d83e589ce5ceff0c0a05b4a04'],17,263,280,16154964,4,0,0,0.98,11638
46fde1411397e6a01a8fef7cd9ce58e7b4fdf822,0,Dimuthu Wannipurage,2018-09-26 12:39:07-04:00,['25a63e5658392d0212088b8bc98e1b20f7d3295a'],3,3,6,16154970,2,,,,11638
6bf1caf932e15cc0d57d659929aa00b4b66e5d16,0,Marcus Christie,2018-09-26 19:22:21-04:00,['e59e62751362e2d4da1ef082464fc3ae77f815ee'],20,7,27,16154997,2,,,,11638
f590d0a59d6e297aef6145e2e02f23c569b75ef9,0,Marcus Christie,2018-09-26 19:23:21-04:00,['6bf1caf932e15cc0d57d659929aa00b4b66e5d16'],725,106,831,16155828,7,0.752173913,1,0.37826087,11638
f8dcbf7df1d04bcbf54ebac23ce363b76ce41a64,0,Marcus Christie,2018-09-26 19:38:46-04:00,['f590d0a59d6e297aef6145e2e02f23c569b75ef9'],12,39,51,16155879,2,0.25,1,1,11638
e080f013c8c37d24f90e7a3ab239b1dd18e01d3d,0,Marcus Christie,2018-09-27 16:29:56-04:00,['f8dcbf7df1d04bcbf54ebac23ce363b76ce41a64'],2,5,7,16155886,1,0,1,1,11638
6844273f673c4149abeb38880e44100f935f7a7b,0,Dimuthu Wannipurage,2018-09-28 10:17:26-04:00,['46fde1411397e6a01a8fef7cd9ce58e7b4fdf822'],1,1,2,16155888,1,,,,11638
dcb34e857a4f772da9a8a7ce661b5a8089d52ad0,0,Dimuthu Wannipurage,2018-09-28 10:38:23-04:00,['6844273f673c4149abeb38880e44100f935f7a7b'],0,1,1,16155889,1,,,,11638
e2aedc555369248e14f4d409f972bb00b9a1df6d,0,Dimuthu Wannipurage,2018-09-28 15:16:28-04:00,['dcb34e857a4f772da9a8a7ce661b5a8089d52ad0'],1,1,2,16155891,1,,,,11638
9ab9644e17831b1334216da350b02b526b56fe34,1,Marcus Christie,2018-10-01 11:04:36-04:00,['e080f013c8c37d24f90e7a3ab239b1dd18e01d3d'],6,150,156,16156047,9,0.09009009,0.243243243,0.963963964,11638
f9b5434ac3dd8ee21d7dfa57b34f76ea02508717,0,Marcus Christie,2018-10-01 11:09:18-04:00,['9ab9644e17831b1334216da350b02b526b56fe34'],0,2,2,16156049,1,0,1,1,11638
3106345bdf2895fb62f91beac7bd1acf4fddd962,0,Marcus Christie,2018-10-01 12:44:59-04:00,['f9b5434ac3dd8ee21d7dfa57b34f76ea02508717'],8,27,35,16156084,1,0.157894737,0,1,11638
3f1cb95e27d9a56249ff67ab1e95cf28adf2ccdc,0,Marcus Christie,2018-10-01 13:00:41-04:00,['3106345bdf2895fb62f91beac7bd1acf4fddd962'],1,1,2,16156086,1,,,,11638
896a62c5c9b93ce38b8440a33dc9e063480ecf5f,1,Marcus Christie,2018-10-01 14:48:19-04:00,['3f1cb95e27d9a56249ff67ab1e95cf28adf2ccdc'],0,58,58,16156144,3,,,,11640
bd04f0efddb2f3be298885fe96d0bcc005dab112,0,Marcus Christie,2018-10-02 09:53:53-04:00,['896a62c5c9b93ce38b8440a33dc9e063480ecf5f'],21,18,39,16156183,1,1,1,0,11640
18d0e4e10f27a4b189eab0a234fb02dd0edff439,0,Marcus Christie,2018-10-02 12:36:59-04:00,['71dffabc9c6221c258af8202c57481268c18c6f6'],43,142,185,16156368,4,0.816901408,1,0.577464789,11640
f0565c1caa69963022b5cb29bda9e4a507e54c2f,0,Marcus Christie,2018-10-02 12:59:22-04:00,['18d0e4e10f27a4b189eab0a234fb02dd0edff439'],8,56,64,16156432,3,0.424242424,1,0.606060606,11640
d79987698fcda3bb7d61fc8111e9b9b0c291742b,0,Marcus Christie,2018-10-02 14:21:52-04:00,['f0565c1caa69963022b5cb29bda9e4a507e54c2f'],17491,19757,37248,16193680,3,0.351945854,0.414551607,0.956570784,11641
70cfbcfc92ac402f842cee5f9e6c648d3dbd15e2,0,Marcus Christie,2018-10-02 14:30:25-04:00,"['bd04f0efddb2f3be298885fe96d0bcc005dab112', 'd79987698fcda3bb7d61fc8111e9b9b0c291742b']",18025,20094,38119,16231799,9,,,,11641
1cced3b261040fd823cdc628d6aa4c40c64dd9f2,0,Eroma Abeysinghe,2018-10-02 15:10:14-04:00,['7d57a5eecc646dc699f08c2c7c5fbefc499eb06a'],0,1,1,16231800,1,,,,11641
b4a57f7626a1e46263b05301f85a92aae8a52b06,0,Dimuthu Wannipurage,2018-10-03 02:45:28-04:00,['e2aedc555369248e14f4d409f972bb00b9a1df6d'],43,129,172,16231972,4,0.106060606,0.924242424,0.924242424,11641
521b36a31cd83e87325285c7286f710defe877c8,0,Dimuthu Wannipurage,2018-10-03 02:46:22-04:00,['b4a57f7626a1e46263b05301f85a92aae8a52b06'],2,106,108,16232080,2,0,0.571428571,1,11642
591f997fa54aa1bedd6fea205fa52fce90f681d6,0,Dimuthu Wannipurage,2018-10-03 03:04:50-04:00,['521b36a31cd83e87325285c7286f710defe877c8'],0,4,4,16232084,2,0.25,0.5,0.75,11642
3c1717d105a0ecad53832ad1787081c71b409eff,0,Dimuthu Wannipurage,2018-10-03 03:08:20-04:00,['591f997fa54aa1bedd6fea205fa52fce90f681d6'],0,1,1,16232085,1,,,,11642
f6f16ec11d51c70d80c6a739d164f74e0a6e0f50,0,Dimuthu Wannipurage,2018-10-03 03:22:32-04:00,['3c1717d105a0ecad53832ad1787081c71b409eff'],1,1,2,16232087,1,,,,11642
dd79ce2eb427388f8e3c8357c959ccd31012df2d,0,Dimuthu Wannipurage,2018-10-03 10:02:09-04:00,['f6f16ec11d51c70d80c6a739d164f74e0a6e0f50'],8,33,41,16232128,5,1,1,1,11642
3bd208b2443597f25b4266b10227ef0693b99e9a,1,Marcus Christie,2018-10-03 10:28:14-04:00,['70cfbcfc92ac402f842cee5f9e6c648d3dbd15e2'],117,39,156,16232284,3,0.2,1,0.028571429,11642
6227c3784c0b2774d4857fb5def4c395ed0038b7,0,Dimuthu Wannipurage,2018-10-03 10:28:49-04:00,['dd79ce2eb427388f8e3c8357c959ccd31012df2d'],2,2,4,16232288,1,,,,11642
ee072f0ee0f2d14af8ce3078e830cc3c5bfc3ed8,0,lahiru-j,2018-10-03 21:03:59+05:18,['3bd208b2443597f25b4266b10227ef0693b99e9a'],849,658,1507,16233795,15,0,0.132352941,0.220588235,11646
16e14b78eb32a7734f1f5ad32805bd563d9eef81,0,GitHub,2018-10-03 12:03:15-04:00,"['3bd208b2443597f25b4266b10227ef0693b99e9a', 'ee072f0ee0f2d14af8ce3078e830cc3c5bfc3ed8']",849,658,1507,16235302,15,,,,11646
0ab3c5648d06d1b26f38bebdcb6f20b995202e13,0,Marcus Christie,2018-10-03 17:17:07-04:00,['16e14b78eb32a7734f1f5ad32805bd563d9eef81'],5,2,7,16235309,1,1,0,0,11646
0573b92bd826d75d633182e90dcda83c73b3c6a1,0,Marcus Christie,2018-10-04 09:54:28-04:00,['0ab3c5648d06d1b26f38bebdcb6f20b995202e13'],6,4,10,16235319,1,1,1,0,11646
422d866c5e990bf00095b79a12acc3c7abba1ccb,0,Dimuthu Wannipurage,2018-10-04 12:53:16-04:00,['6227c3784c0b2774d4857fb5def4c395ed0038b7'],0,1,1,16235320,1,0,0,0,11646
d7ad156689715507c22fae802eb01483e5398d48,0,Dimuthu Wannipurage,2018-10-04 12:55:27-04:00,['422d866c5e990bf00095b79a12acc3c7abba1ccb'],1,1,2,16235322,1,,,,11646
eeb77972b5bbe5146dad462f14eb61dd62e205b5,0,Dimuthu Wannipurage,2018-10-04 13:29:59-04:00,['0573b92bd826d75d633182e90dcda83c73b3c6a1'],20,1,21,16235343,2,0.357142857,0.357142857,0,11646
353e64bc91ed7a5eef559d7af04b8f8724bdd64e,0,Dimuthu Wannipurage,2018-10-04 13:46:53-04:00,['d7ad156689715507c22fae802eb01483e5398d48'],8,5,13,16235356,3,0,0,0,11646
eff684f4ea518b86392ce92f88801a5cd1c07781,1,Marcus Christie,2018-10-05 09:36:16-04:00,['eeb77972b5bbe5146dad462f14eb61dd62e205b5'],3,8,11,16235367,2,,,,11646
fdd9ebabb7ca40b2a77ffac0d98d3c3320a2d935,0,Marcus Christie,2018-10-05 09:59:53-04:00,['eff684f4ea518b86392ce92f88801a5cd1c07781'],0,1,1,16235368,1,,,,11646
3acc33a98eb1a40d3d5c34a628a99fb2384b5dbc,0,Eroma Abeysinghe,2018-10-05 10:13:43-04:00,['fdd9ebabb7ca40b2a77ffac0d98d3c3320a2d935'],4,4,8,16235376,1,,,,11646
ac2b8e144111df4402e8bc70896126d608067816,0,Eroma Abeysinghe,2018-10-05 12:00:05-04:00,['1cced3b261040fd823cdc628d6aa4c40c64dd9f2'],0,3,3,16235379,1,,,,11646
40ffcb8e91c4425adb2ca7d2c5f39c1bcfd958f1,0,Marcus Christie,2018-10-05 13:09:00-04:00,['3acc33a98eb1a40d3d5c34a628a99fb2384b5dbc'],0,1,1,16235380,1,,,,11646
6fad6caf0dbadc4aa4243ccd57794b0e9b51a3e4,0,Marcus Christie,2018-10-09 14:59:23-04:00,"['ac2b8e144111df4402e8bc70896126d608067816', 'd79987698fcda3bb7d61fc8111e9b9b0c291742b']",17542,19955,37497,16272877,10,,,,11646
ffd2b6c19d4e8bef884e2ce0ac3cb1ccefc5bc21,0,Eroma Abeysinghe,2018-10-10 09:58:38-04:00,['ac2b8e144111df4402e8bc70896126d608067816'],0,84,84,16272961,2,,,,11648
ad3f5eb3c2c4c13bca95c97957956d40642c77c3,0,Eroma Abeysinghe,2018-10-10 10:17:42-04:00,"['ffd2b6c19d4e8bef884e2ce0ac3cb1ccefc5bc21', '6fad6caf0dbadc4aa4243ccd57794b0e9b51a3e4']",17542,19955,37497,16310458,10,,,,11648
30bcd6c48ad948454d60e72c4b3c7eb660bcba90,0,Eroma Abeysinghe,2018-10-10 10:23:00-04:00,['ad3f5eb3c2c4c13bca95c97957956d40642c77c3'],1,1,2,16310460,1,,,,11648
7f62cd5b637a51ad25e6a2034cc74acfdf460c57,0,Eroma Abeysinghe,2018-10-10 10:44:34-04:00,['30bcd6c48ad948454d60e72c4b3c7eb660bcba90'],1,1,2,16310462,1,,,,11648
b059e091ba1dfcfa075deba0573ca5c7ac39040e,1,Eroma Abeysinghe,2018-10-10 14:26:58-04:00,['40ffcb8e91c4425adb2ca7d2c5f39c1bcfd958f1'],0,46,46,16310508,1,,,,11649
5dfd715e0008d98f19bcc5e4a1da0afe66155335,0,Eroma Abeysinghe,2018-10-10 14:27:38-04:00,['b059e091ba1dfcfa075deba0573ca5c7ac39040e'],0,13,13,16310521,2,,,,11650
0d47a945edb0ba6f7cd7644578f893d2d598b840,0,Marcus Christie,2018-10-11 09:38:38-04:00,['5dfd715e0008d98f19bcc5e4a1da0afe66155335'],0,5,5,16310526,1,,,,11650
a5100ebe41dc250270122ac7744f357c5d13e094,0,Marcus Christie,2018-10-11 09:43:23-04:00,['0d47a945edb0ba6f7cd7644578f893d2d598b840'],0,1737,1737,16312263,5,0.453551913,0.55971897,0.903981265,11650
cae799595d8f4acdd344f68cb201d1e019f0beb6,1,Marcus Christie,2018-10-11 11:35:33-04:00,['a5100ebe41dc250270122ac7744f357c5d13e094'],0,68,68,16312331,3,0.58,1,0.32,11650
50fc4862a08695e0376c721aa9188b646e38b974,0,Eroma Abeysinghe,2018-10-11 15:00:47-04:00,['7f62cd5b637a51ad25e6a2034cc74acfdf460c57'],4,4,8,16312339,1,,,,11650
31fe888de92fdfdc9051f46cc1c3c61e0691ef6d,0,Eroma Abeysinghe,2018-10-12 09:23:32-04:00,['cae799595d8f4acdd344f68cb201d1e019f0beb6'],1,1,2,16312341,1,,,,11650
71a0e3421c98f4ee9f17fcf2a776d405a24dadb8,0,Marcus Christie,2018-10-12 17:48:54-04:00,['31fe888de92fdfdc9051f46cc1c3c61e0691ef6d'],1,6,7,16312348,3,,,,11650
8bfc54f9e28d2fd39da44f2a0f2c7eb57dda926b,0,Eroma Abeysinghe,2018-10-18 11:10:55-04:00,['50fc4862a08695e0376c721aa9188b646e38b974'],0,1,1,16312349,1,,,,11650
73942aaf1397db80a24804a727b434ab7c731d95,0,Dimuthu Wannipurage,2018-10-18 11:42:54-04:00,['353e64bc91ed7a5eef559d7af04b8f8724bdd64e'],38,7,45,16312394,1,0.48,0.48,0.32,11650
656b3bf2744f83e40457cf25ec5e85ada44b8a89,0,Dimuthu Wannipurage,2018-10-18 11:45:56-04:00,['73942aaf1397db80a24804a727b434ab7c731d95'],34,35,69,16312463,1,,,,11650
5c818236427daac4a8d90e8de952df0115dc6480,0,Dimuthu Wannipurage,2018-10-18 12:43:45-04:00,['656b3bf2744f83e40457cf25ec5e85ada44b8a89'],2,2,4,16312467,1,,,,11650
0ad3b1ba6e84f9e28392a6778a96f9643abc30de,0,Dimuthu Wannipurage,2018-10-18 13:20:43-04:00,['5c818236427daac4a8d90e8de952df0115dc6480'],0,10,10,16312477,1,1,1,1,11650
91b44b13f0b6a9457c1a9ddc9a5733632f4e7cab,0,Eroma Abeysinghe,2018-10-19 13:12:08-04:00,['8bfc54f9e28d2fd39da44f2a0f2c7eb57dda926b'],3,6,9,16312486,1,,,,11650
1665986725ed9f65da04c9d6b827a5f42ec01836,0,Eroma Abeysinghe,2018-10-19 20:31:21-04:00,['91b44b13f0b6a9457c1a9ddc9a5733632f4e7cab'],0,83,83,16312569,2,,,,11652
873bd55bdf7348eaa6c3ca30110b8c6c4b208cb7,0,Eroma Abeysinghe,2018-10-19 20:41:12-04:00,['1665986725ed9f65da04c9d6b827a5f42ec01836'],4,4,8,16312577,1,,,,11652
85e37cc286af096805390d1af29f2533fbd5d4b0,0,Eroma Abeysinghe,2018-10-22 08:58:46-04:00,['873bd55bdf7348eaa6c3ca30110b8c6c4b208cb7'],4,4,8,16312585,1,,,,11652
a30ec331dfa5f6e7a4df2bd0d8138f962f08daad,0,Eroma Abeysinghe,2018-10-22 10:07:30-04:00,['85e37cc286af096805390d1af29f2533fbd5d4b0'],1,6,7,16312592,1,,,,11652
44c3b62a3902a184b9f0c2df576f94edcb702245,0,Eroma Abeysinghe,2018-10-23 14:21:45-04:00,['a30ec331dfa5f6e7a4df2bd0d8138f962f08daad'],0,116,116,16312708,3,,,,11655
c6226bea232a605c7bdedadc29f5c8aba95d7575,0,Dimuthu Wannipurage,2018-10-23 15:20:20-04:00,['71a0e3421c98f4ee9f17fcf2a776d405a24dadb8'],5142,14642,19784,16332492,31,0.532838212,0.678607835,0.971166448,11671
f22e9c67b200edfe4876591ef5799bb5aedca3e0,0,Eroma Abeysinghe,2018-10-24 11:00:06-04:00,['44c3b62a3902a184b9f0c2df576f94edcb702245'],4,4,8,16332500,1,,,,11671
f31a2aa9489dea561c7bc8a75ab2b18b411790e7,0,Eroma Abeysinghe,2018-10-24 13:17:12-04:00,['c6226bea232a605c7bdedadc29f5c8aba95d7575'],4,4,8,16332508,1,,,,11671
4448f980055453ad79d5ab6e6717f0339535324d,0,Eroma Abeysinghe,2018-10-24 14:14:45-04:00,['f31a2aa9489dea561c7bc8a75ab2b18b411790e7'],2,2,4,16332512,1,,,,11671
13defc0367f833a4480987689fc8aebe6de33cb2,1,Eroma Abeysinghe,2018-10-24 15:37:40-04:00,['4448f980055453ad79d5ab6e6717f0339535324d'],0,58,58,16332570,2,,,,11673
307ca98dfe789c2e617fb12ab56f890bab8430bd,0,Eroma Abeysinghe,2018-10-24 15:38:22-04:00,['13defc0367f833a4480987689fc8aebe6de33cb2'],0,1,1,16332571,1,,,,11673
3a7282b0b84a25d884a0d7a8474f3e78b2491c41,1,Marcus Christie,2018-10-25 12:27:15-04:00,['307ca98dfe789c2e617fb12ab56f890bab8430bd'],62,167,229,16332800,9,0.444444444,1,0.555555556,11673
66a56cd49dfe4f95111b9d9f3e52adb245b59330,0,Marcus Christie,2018-10-25 12:27:15-04:00,['3a7282b0b84a25d884a0d7a8474f3e78b2491c41'],1,1,2,16332802,1,,,,11673
254c8abe2b7400fc841f232dd94f89ece3ad6642,1,Marcus Christie,2018-10-25 14:36:47-04:00,['66a56cd49dfe4f95111b9d9f3e52adb245b59330'],8,11,19,16332821,2,0,1,1,11673
ce56a35d8af50554cf435f269cf07712cf303fa5,0,Marcus Christie,2018-10-26 16:42:47-04:00,['254c8abe2b7400fc841f232dd94f89ece3ad6642'],25,2526,2551,16335372,5,0.514457174,0.64811784,0.956355701,11673
7ef48ba0fb5977ec90600bce811d2050bcee21d6,0,Eroma Abeysinghe,2018-10-29 13:59:36-04:00,['307ca98dfe789c2e617fb12ab56f890bab8430bd'],1,1,2,16335374,1,,,,11673
52da8ac14fb90fae7b213fd827bc14df9e9ff054,0,Eroma Abeysinghe,2018-10-29 14:02:07-04:00,"['7ef48ba0fb5977ec90600bce811d2050bcee21d6', 'ce56a35d8af50554cf435f269cf07712cf303fa5']",96,2705,2801,16338175,13,,,,11673
c759412cb45743697066f55061202ba49104f5ec,0,Eroma Abeysinghe,2018-10-29 14:18:45-04:00,['52da8ac14fb90fae7b213fd827bc14df9e9ff054'],4,4,8,16338183,1,,,,11673
3cba34f343327ee611aa93f475d73591ddcedc7c,0,Dimuthu Wannipurage,2018-10-29 15:32:03-04:00,['c759412cb45743697066f55061202ba49104f5ec'],5,10,15,16338198,2,0,0,1,11673
3c6b3dd4d359cde18036e8df3621a54be214385f,0,Dimuthu Wannipurage,2018-10-29 15:33:22-04:00,['3cba34f343327ee611aa93f475d73591ddcedc7c'],2,30,32,16338230,2,1,1,1,11673
e1d65eb53930e4250fb9d754fde65d5596440f88,0,Dimuthu Wannipurage,2018-10-29 15:34:36-04:00,['3c6b3dd4d359cde18036e8df3621a54be214385f'],55,140,195,16338425,4,0.55,0.9,0.35,11673
f40f462d54de32593b522ab6a09c1b3e59f15085,0,Eroma Abeysinghe,2018-10-29 15:50:03-04:00,['c759412cb45743697066f55061202ba49104f5ec'],2,2,4,16338429,1,,,,11673
657d6e4120bf0dbd882850f8cb9225e517f7ed04,0,Dimuthu Wannipurage,2018-10-29 22:59:24-04:00,['e1d65eb53930e4250fb9d754fde65d5596440f88'],147,940,1087,16339516,8,0.163608563,0,0.948012232,11673
fb375317c55099b3759355084887b57e25cd8f4a,1,Dimuthu Wannipurage,2018-10-29 22:59:55-04:00,['657d6e4120bf0dbd882850f8cb9225e517f7ed04'],0,643,643,16340159,7,1,1,1,11680
1d7087770f4246e2928922977bad890310afc49d,0,Dimuthu Wannipurage,2018-10-29 23:02:00-04:00,['fb375317c55099b3759355084887b57e25cd8f4a'],2,2,4,16340163,1,,,,11680
31770421ebe8f1fe9d2ca67d42eb9096d48577a9,1,Dimuthu Wannipurage,2018-10-30 00:22:46-04:00,['1d7087770f4246e2928922977bad890310afc49d'],0,192,192,16340355,3,1,1,1,11680
5e8b0d9581d09025798240b8d6c06a3fc8b81fa0,0,Dimuthu Wannipurage,2018-10-30 01:25:05-04:00,['31770421ebe8f1fe9d2ca67d42eb9096d48577a9'],85,164,249,16340604,10,1,1,1,11687
e908d3cb5dd829938dacc480b07e14336c42ac2d,0,Dimuthu Wannipurage,2018-10-30 01:39:34-04:00,['5e8b0d9581d09025798240b8d6c06a3fc8b81fa0'],60,76,136,16340740,3,0.333333333,0.333333333,1,11687
34d7b0ff3d084ab4829367349c55191784a69cf6,0,Dimuthu Wannipurage,2018-10-30 01:50:03-04:00,['e908d3cb5dd829938dacc480b07e14336c42ac2d'],6,12,18,16340758,6,,,,11687
351c64c9e138ef2be1bb5af3c930657e858f31a2,1,Dimuthu Wannipurage,2018-10-30 02:03:06-04:00,['34d7b0ff3d084ab4829367349c55191784a69cf6'],0,7,7,16340765,1,,,,11687
c40bdd1470b46018d1283188cba32fe70d024e78,0,Dimuthu Wannipurage,2018-10-30 02:50:11-04:00,['351c64c9e138ef2be1bb5af3c930657e858f31a2'],63,32,95,16340860,1,1,0,0,11687
61004834e0e14859c02ab381852326ab1ce92cec,1,Dimuthu Wannipurage,2018-10-30 02:51:25-04:00,['c40bdd1470b46018d1283188cba32fe70d024e78'],2,2,4,16340864,2,,,,11687
71518b8a4e76c2d073b4496881966be7ca408383,0,Dimuthu Wannipurage,2018-10-30 12:41:29-04:00,['61004834e0e14859c02ab381852326ab1ce92cec'],3,27,30,16340894,1,0,1,0,11687
b4ab27e1ce71538cd561e1c56f677c79fff2d5f1,0,Eroma Abeysinghe,2018-10-30 16:32:16-04:00,"['f40f462d54de32593b522ab6a09c1b3e59f15085', '71518b8a4e76c2d073b4496881966be7ca408383']",353,2200,2553,16343447,34,,,,11687
88edfa4e09a22695af131c4772b5b97a74e3fced,1,Dimuthu Wannipurage,2018-10-30 23:05:22-04:00,['71518b8a4e76c2d073b4496881966be7ca408383'],885,2176,3061,16346508,32,0.111917098,0.170984456,0.977202073,11690
87ccc4abc1ad63861e54a9aecd3e08886b4d7627,0,Dimuthu Wannipurage,2018-10-31 00:19:32-04:00,['88edfa4e09a22695af131c4772b5b97a74e3fced'],1,1,2,16346510,1,,,,11690
3ba041d121baa83bbce3729e195e00452faeed59,0,Dimuthu Wannipurage,2018-10-31 01:42:55-04:00,['87ccc4abc1ad63861e54a9aecd3e08886b4d7627'],6,6,12,16346522,2,,,,11690
514cf87f5c1c96b515ee2f0c07cc91831eb1eafe,0,Eroma Abeysinghe,2018-10-31 10:20:57-04:00,"['b4ab27e1ce71538cd561e1c56f677c79fff2d5f1', '3ba041d121baa83bbce3729e195e00452faeed59']",892,2183,3075,16349597,32,,,,11690
9f7fc2519b8ff99040161d13aad9804961e1c3fd,1,Eroma Abeysinghe,2018-10-31 11:05:42-04:00,['514cf87f5c1c96b515ee2f0c07cc91831eb1eafe'],0,58,58,16349655,2,,,,11692
a7ef8dc3584e8b2946b3e0164e5dd9d27db934a5,0,Eroma Abeysinghe,2018-10-31 11:06:54-04:00,['9f7fc2519b8ff99040161d13aad9804961e1c3fd'],0,1,1,16349656,1,,,,11692
1a516b50f4434682eaae5740156f262b753ee8d5,1,Marcus Christie,2018-10-31 16:00:23-04:00,['a7ef8dc3584e8b2946b3e0164e5dd9d27db934a5'],60,144,204,16349860,13,,,,11692
3e879e4325fba582186acd8133552ea6f8542cb6,0,Dimuthu Wannipurage,2018-10-31 16:48:06-04:00,['0ad3b1ba6e84f9e28392a6778a96f9643abc30de'],1,3,4,16349864,1,0,0,1,11692
ceb4cdb04fa2a0ed1f090fad0d344df655e9f3c2,0,Marcus Christie,2018-11-01 15:23:39-04:00,['1a516b50f4434682eaae5740156f262b753ee8d5'],7,90,97,16349961,3,1,1,1,11693
e642e7f1e42072bbe63dbd3e357acc8af2a8fa74,0,Dimuthu Wannipurage,2018-11-01 22:34:17-04:00,['3e879e4325fba582186acd8133552ea6f8542cb6'],6,3,9,16349970,1,0,0,0,11693
bb7d3ca0770a1a0301d975e30e7eb37f9834b7c4,0,Dimuthu Wannipurage,2018-11-01 22:36:21-04:00,['e642e7f1e42072bbe63dbd3e357acc8af2a8fa74'],1,2,3,16349973,1,1,0,0,11693
23631de8140ef0d74c95cfaf5eeb4228e800a037,0,Dimuthu Wannipurage,2018-11-01 22:55:50-04:00,['bb7d3ca0770a1a0301d975e30e7eb37f9834b7c4'],3,3,6,16349979,1,1,1,0,11693
3f68a88febe5c7997d2c2627fd720fbdda278494,0,Dimuthu Wannipurage,2018-11-01 23:24:45-04:00,['23631de8140ef0d74c95cfaf5eeb4228e800a037'],2,1,3,16349982,1,1,1,0,11693
12fbb593ed85763b3aa8d05de75f4185a9f72d21,0,Marcus Christie,2018-11-02 11:51:27-04:00,['ceb4cdb04fa2a0ed1f090fad0d344df655e9f3c2'],5,2,7,16349989,2,0,0,0,11693
9cb5742efe2ce567cf775156c138137c809d3c86,1,Marcus Christie,2018-11-02 16:52:46-04:00,['12fbb593ed85763b3aa8d05de75f4185a9f72d21'],3,26,29,16350018,1,0.526315789,0.526315789,1,11693
4d955fb22ec834d4d2cd48f524ce859332c01b00,0,lahiru-j,2018-11-04 08:00:42+05:18,['9cb5742efe2ce567cf775156c138137c809d3c86'],3,11,14,16350032,1,,,,11693
8c6d4d321be8b56865801f5e1c91568e301937d3,0,Dimuthu Wannipurage,2018-11-05 13:49:38-05:00,['9cb5742efe2ce567cf775156c138137c809d3c86'],2,14,16,16350048,2,0.2,1,0.2,11693
ae7e230608ebd0e3250fa7c6296f620a7983f5dd,0,Marcus Christie,2018-11-05 13:52:47-05:00,['8c6d4d321be8b56865801f5e1c91568e301937d3'],0,481,481,16350529,2,0.293447293,0.495726496,0.749287749,11693
a62bb05bb6c0b87351e189473a98e07d59fd6f63,0,Dimuthu Wannipurage,2018-11-05 14:19:43-05:00,['ae7e230608ebd0e3250fa7c6296f620a7983f5dd'],1,1,2,16350531,1,1,1,1,11693
186e764c1f811e9494af3a4d29fff5547f729bd4,0,Eroma Abeysinghe,2018-11-05 15:16:09-05:00,['f22e9c67b200edfe4876591ef5799bb5aedca3e0'],0,83,83,16350614,2,,,,11695
a27eec484fa17f4ba688bebf80fc00ac3d8e246e,0,Eroma Abeysinghe,2018-11-05 15:30:10-05:00,['186e764c1f811e9494af3a4d29fff5547f729bd4'],1,1,2,16350616,1,,,,11695
8a0861eeb60f0415a508de6de2b6d2f99622767f,0,Eroma Abeysinghe,2018-11-05 16:15:42-05:00,['a27eec484fa17f4ba688bebf80fc00ac3d8e246e'],4,4,8,16350624,1,,,,11695
3e8a66629973fe3f6bffafa2afa72bfcbfb7abe0,0,Eroma Abeysinghe,2018-11-05 17:03:18-05:00,['8a0861eeb60f0415a508de6de2b6d2f99622767f'],1,1,2,16350626,1,,,,11695
07f21f4f27da37ce02d11f2920a4a7cf8595a121,0,Eroma Abeysinghe,2018-11-05 21:50:33-05:00,['3e8a66629973fe3f6bffafa2afa72bfcbfb7abe0'],4,4,8,16350634,1,,,,11695
caf34aa04d1ec14fb03d3243f7830741f359697d,0,Eroma Abeysinghe,2018-11-05 21:51:33-05:00,['07f21f4f27da37ce02d11f2920a4a7cf8595a121'],0,2,2,16350636,1,,,,11695
f4b61a7614c51f0eb0c7cc0406e1746327bc64c7,1,Marcus Christie,2018-11-06 11:46:26-05:00,['a62bb05bb6c0b87351e189473a98e07d59fd6f63'],164,121,285,16350921,18,0,0,0,11695
cc4437e48f205d03a15df0490e4fe13bb366f57e,0,Marcus Christie,2018-11-06 11:46:26-05:00,['f4b61a7614c51f0eb0c7cc0406e1746327bc64c7'],14,15,29,16350950,7,0,1,1,11695
2c01b94181be962f62bfca11c44a375745b00b45,1,Marcus Christie,2018-11-06 11:46:27-05:00,['cc4437e48f205d03a15df0490e4fe13bb366f57e'],1610,207,1817,16352767,15,,,,11695
423a7365e58143f8d666e5dc85d7e67f510b055f,0,Marcus Christie,2018-11-06 12:34:09-05:00,['2c01b94181be962f62bfca11c44a375745b00b45'],1,84,85,16352852,3,,,,11696
eac72f9a565c8263d19eec55176a26330073ca90,0,Eroma Abeysinghe,2018-11-06 14:49:41-05:00,['423a7365e58143f8d666e5dc85d7e67f510b055f'],4,4,8,16352860,1,,,,11696
7bd2ced62230b2ba6d4d05a6df279a93e28e8c9a,1,Marcus Christie,2018-11-06 15:56:57-05:00,['eac72f9a565c8263d19eec55176a26330073ca90'],60,296,356,16353216,9,0.670454545,1,1,11698
39b2f83a3858023cb939a89d6ccebde74a927954,0,Marcus Christie,2018-11-06 15:56:58-05:00,['7bd2ced62230b2ba6d4d05a6df279a93e28e8c9a'],11,14,25,16353241,1,,,,11698
1d29f870edf806e671834e0f885d01167a9cb22e,0,Marcus Christie,2018-11-06 17:09:03-05:00,['39b2f83a3858023cb939a89d6ccebde74a927954'],63,75,138,16353379,2,0,0,0,11698
5b2681a3ae6b0491697ff96dad644e5ca1eb8457,0,Marcus Christie,2018-11-06 17:16:58-05:00,['1d29f870edf806e671834e0f885d01167a9cb22e'],6,5,11,16353390,1,,,,11698
4337511eb6e9fca8502aa8758eef5437c10500c1,0,Marcus Christie,2018-11-06 17:18:44-05:00,['5b2681a3ae6b0491697ff96dad644e5ca1eb8457'],0,2,2,16353392,1,,,,11698
82706a1c07eb06198d795cf5422cfa3cebfad67d,1,Dimuthu Wannipurage,2018-11-06 17:55:14-05:00,['4337511eb6e9fca8502aa8758eef5437c10500c1'],65,74,139,16353531,6,1,1,1,11698
eccf3bdc65f0b9407cd3eda2f8b376b42a9e9aff,0,Dimuthu Wannipurage,2018-11-06 18:12:03-05:00,['82706a1c07eb06198d795cf5422cfa3cebfad67d'],50,99,149,16353680,2,0.078947368,0,0.236842105,11698
00ff6e75f31fd86544ce4cfaa9764f4a451783b6,0,Dimuthu Wannipurage,2018-11-06 21:56:48-05:00,['eccf3bdc65f0b9407cd3eda2f8b376b42a9e9aff'],2,24,26,16353706,4,1,1,1,11698
e494aff4f559ff1d80bfe00d05ec98db53c59ea7,1,Marcus Christie,2018-11-07 10:14:35-05:00,['00ff6e75f31fd86544ce4cfaa9764f4a451783b6'],18,198,216,16353922,4,0.127388535,0.222929936,0.993630573,11698
36270a3ca43ed62a878dc378c44869a455bf4ed0,0,Eroma Abeysinghe,2018-11-07 14:05:15-05:00,['e494aff4f559ff1d80bfe00d05ec98db53c59ea7'],2,2,4,16353926,1,,,,11698
2d84196b073e4f17ff1e5375215efb9f12aa3f90,0,GitHub,2018-11-08 01:17:10-05:00,"['caf34aa04d1ec14fb03d3243f7830741f359697d', 'fa161fd3cb8d8cc0697367c07c93c9d9513e94d7']",95,315,410,16354336,9,,,,11698
36f9dfd7ad6571e7e92ed99791f7715ef8c93f19,1,yasgun,2018-11-08 21:03:30+05:18,['36270a3ca43ed62a878dc378c44869a455bf4ed0'],27568,8464,36032,16390368,29,0.512267135,0.427486819,0.024885764,11699
9dd591342abb0b11bc25630e92ffff5c1e06c2e7,0,yasgun,2018-11-08 21:03:30+05:18,['36f9dfd7ad6571e7e92ed99791f7715ef8c93f19'],521,193,714,16391082,4,0.774647887,0.774647887,0,11699
1d96bba7aea613459e5c6cb698c83bdcdd5cbbeb,0,yasgun,2018-11-08 21:03:30+05:18,['9dd591342abb0b11bc25630e92ffff5c1e06c2e7'],745,186,931,16392013,11,0.69895288,0.62565445,0.02617801,11699
97c2aa6a063c1d094731411232f0932acc8395e2,0,yasgun,2018-11-08 21:03:32+05:18,['1d96bba7aea613459e5c6cb698c83bdcdd5cbbeb'],1808,1808,3616,16395629,2,0,0,,11699
9c66169183ac24dd6536996ea68cee47846a0e51,0,Dimuthu Wannipurage,2018-11-08 11:34:54-05:00,['36270a3ca43ed62a878dc378c44869a455bf4ed0'],31,34,65,16395694,3,1,0,0,11699
56f10b9b70976391b8a3cb1d303c09e3975f63c1,0,GitHub,2018-11-08 14:44:21-05:00,"['9c66169183ac24dd6536996ea68cee47846a0e51', '97c2aa6a063c1d094731411232f0932acc8395e2']",44354,24363,68717,16464411,33,,,,11699
5aec2fe7632a97dc83d35f5ed3f98d9fa2d7c777,0,GitHub,2018-11-08 20:37:15-05:00,"['56f10b9b70976391b8a3cb1d303c09e3975f63c1', '4d955fb22ec834d4d2cd48f524ce859332c01b00']",3,11,14,16464425,1,,,,11699
b2c00c92320f5302751e83eca6a0e6d1b9a790f6,0,Dimuthu Wannipurage,2018-11-09 09:51:19-05:00,['5aec2fe7632a97dc83d35f5ed3f98d9fa2d7c777'],10,93,103,16464528,7,0.80952381,0.80952381,1,11700
86d3502f63697aeecdf38ae2a475c1c813ef162b,0,Dimuthu Wannipurage,2018-11-09 09:52:33-05:00,['b2c00c92320f5302751e83eca6a0e6d1b9a790f6'],17,19,36,16464564,3,,,,11700
05559e1c2de805a4d4621f2036169a7e933e3ecc,0,Dimuthu Wannipurage,2018-11-09 10:09:44-05:00,['86d3502f63697aeecdf38ae2a475c1c813ef162b'],3,133,136,16464700,6,,,,11702
f9db782b4bd808bb19daa6785ac377c3aaef032c,0,Dimuthu Wannipurage,2018-11-09 10:31:25-05:00,['3f68a88febe5c7997d2c2627fd720fbdda278494'],1,1,2,16464702,1,1,1,0,11702
51a5c3e38e36d2014f9f35e11a0eb7b83121548e,0,Dimuthu Wannipurage,2018-11-09 16:11:30-05:00,['05559e1c2de805a4d4621f2036169a7e933e3ecc'],2,2,4,16464706,2,,,,11702
a14e4733d38c5e1085f8927137c388d704026127,0,Dimuthu Wannipurage,2018-11-09 17:09:31-05:00,['f9db782b4bd808bb19daa6785ac377c3aaef032c'],30,31,61,16464767,1,,,,11702
f3100aa85c220c42c18a74d8022490d1fa5550ae,0,Dimuthu Wannipurage,2018-11-10 00:09:23-05:00,['a14e4733d38c5e1085f8927137c388d704026127'],79,84,163,16464930,1,0,0,1,11702
eb919bcbaeb6c8b2e3def01309382b2dcba3e03b,0,Dimuthu Wannipurage,2018-11-10 00:35:59-05:00,['f3100aa85c220c42c18a74d8022490d1fa5550ae'],4,4,8,16464938,1,1,0,0,11702
274c73ffcc226daabfbe213a27b8f10ad53dac0b,0,Dimuthu Wannipurage,2018-11-11 01:01:38-05:00,['eb919bcbaeb6c8b2e3def01309382b2dcba3e03b'],2,4,6,16464944,1,0,1,1,11702
2dd7049e0a73478918b72bd9fe3a279bf46c25d8,1,Marcus Christie,2018-11-12 08:58:29-05:00,['51a5c3e38e36d2014f9f35e11a0eb7b83121548e'],30,41,71,16465015,6,,,,11702
079bbbca457b7d9c49e54a75235943d5d1d0459d,0,Marcus Christie,2018-11-12 09:34:04-05:00,['2dd7049e0a73478918b72bd9fe3a279bf46c25d8'],2,2,4,16465019,1,,,,11702
026a36185359500d4e25daa12325d42db3934017,0,Dimuthu Wannipurage,2018-11-12 16:30:11-05:00,['079bbbca457b7d9c49e54a75235943d5d1d0459d'],32791,39378,72169,16537188,13,0.446876244,0.493633108,0.994627935,11702
15a605e49e6bd83f9e6e46dad2a5ef03f4d8b24b,0,Dimuthu Wannipurage,2018-11-13 12:46:47-05:00,['274c73ffcc226daabfbe213a27b8f10ad53dac0b'],0,3,3,16537191,1,0,1,0,11702
5aecd2fa0fb9dfc2f5925ec8b8ce6e09c1dc43f4,0,Dimuthu Wannipurage,2018-11-16 11:27:19-05:00,['15a605e49e6bd83f9e6e46dad2a5ef03f4d8b24b'],0,1,1,16537192,1,,,,11702
fa75599de3659324a3b778e3e5b5d87e94cbfff7,0,Dimuthu Wannipurage,2018-11-16 12:08:31-05:00,['5aecd2fa0fb9dfc2f5925ec8b8ce6e09c1dc43f4'],9727,9430,19157,16556349,5,1,1,0.664335664,11702
8b10120be4ce1d0720f214dc5e849d1dc862c595,0,Dimuthu Wannipurage,2018-11-16 12:18:47-05:00,['fa75599de3659324a3b778e3e5b5d87e94cbfff7'],31,41,72,16556421,7,1,0,0,11702
4f166fa6073dbc76ba9a6ea605de8f73b990cfd7,0,Dimuthu Wannipurage,2018-11-16 14:46:03-05:00,['8b10120be4ce1d0720f214dc5e849d1dc862c595'],0,20,20,16556441,1,0,1,0.2,11702
59e7ba74fbf445a104a35ddc99f5d1e5ca732e11,0,Dimuthu Wannipurage,2018-11-16 15:22:02-05:00,['026a36185359500d4e25daa12325d42db3934017'],19,25,44,16556485,3,1,1,1,11702
f03e017d202ddbca5eb8e2c0d010742036015b9a,0,DGRamya,2018-11-18 01:05:28-05:00,['59e7ba74fbf445a104a35ddc99f5d1e5ca732e11'],1,4,5,16556490,1,0,0,0,11702
a337eefc9496ce9fb31cbc6608bbdb25c433b709,0,Dimuthu Wannipurage,2018-11-18 12:23:07-05:00,['4f166fa6073dbc76ba9a6ea605de8f73b990cfd7'],3,3,6,16556496,3,,,,11702
1532e5e8de52e3042de2c6ed5c93b6717b4bc487,0,Dimuthu Wannipurage,2018-11-18 12:23:59-05:00,['a337eefc9496ce9fb31cbc6608bbdb25c433b709'],3,3,6,16556502,3,,,,11702
616ff1858d9fad0d2c8c92bd2e7aaa0ea46c6a50,0,Dimuthu Wannipurage,2018-11-18 21:12:36-05:00,['1532e5e8de52e3042de2c6ed5c93b6717b4bc487'],23,23,46,16556548,5,,,,11702
e3b77ae2b072c68996ac02abe90d5e33523414d8,0,Dimuthu Wannipurage,2018-11-19 01:59:05-05:00,['616ff1858d9fad0d2c8c92bd2e7aaa0ea46c6a50'],3,499,502,16557050,16,0.388888889,1,1,11715
2f94413188479b0621133141ef54d062d821926c,0,Dimuthu Wannipurage,2018-11-19 02:37:21-05:00,['e3b77ae2b072c68996ac02abe90d5e33523414d8'],50,66,116,16557166,5,0.03030303,1,1,11715
76e2ebaff14f2ba3ac7916ea24c34030c50de471,0,Dimuthu Wannipurage,2018-11-19 12:59:30-05:00,['2d84196b073e4f17ff1e5375215efb9f12aa3f90'],1,1,2,16557168,1,,,,11715
cb3168bd68ae5a623d25a2d926f08d8d6e7ce676,0,Dimuthu Wannipurage,2018-11-19 15:15:23-05:00,['2f94413188479b0621133141ef54d062d821926c'],5,22,27,16557195,6,1,1,1,11715
0758b75be73c7d689fcd2e3d6ac048c6f4e78592,0,Dimuthu Wannipurage,2018-11-19 15:19:06-05:00,['cb3168bd68ae5a623d25a2d926f08d8d6e7ce676'],67,680,747,16557942,17,,,,11726
ae2548725912ed55d9cffbdf4352af3b7b6f54c8,0,Dimuthu Wannipurage,2018-11-19 15:34:35-05:00,['0758b75be73c7d689fcd2e3d6ac048c6f4e78592'],4,4,8,16557950,4,,,,11726
1252b1dc0ae309387a5b18dfd1c8009754781cd2,0,Marcus Christie,2018-11-19 15:38:50-05:00,['59e7ba74fbf445a104a35ddc99f5d1e5ca732e11'],2,2,4,16557954,1,,,,11726
10c3cfc9f0080708e997f011752aa57e895ab3c5,0,Marcus Christie,2018-11-19 15:43:20-05:00,['1252b1dc0ae309387a5b18dfd1c8009754781cd2'],1,13,14,16557968,3,,,,11726
709a791623f5629cfe63c9a7017450f2324dc300,0,Marcus Christie,2018-11-19 16:18:42-05:00,['10c3cfc9f0080708e997f011752aa57e895ab3c5'],9,26,35,16558003,1,0.6,0.6,0,11726
7bc9208ad590227f49cdef6b764a597c455bac76,0,Dimuthu Wannipurage,2018-11-19 17:31:45-05:00,['ae2548725912ed55d9cffbdf4352af3b7b6f54c8'],0,5,5,16558008,1,,,,11726
2d9ae114290404309cbc55b843a5a45f7e189adf,0,Dimuthu Wannipurage,2018-11-19 17:53:55-05:00,['7bc9208ad590227f49cdef6b764a597c455bac76'],22,24,46,16558054,8,1,1,1,11726
b2b080c793f98deedfda9cb1093969f8660373c0,0,Dimuthu Wannipurage,2018-11-20 03:15:26-05:00,['2d9ae114290404309cbc55b843a5a45f7e189adf'],4,22,26,16558080,2,0,1,0.875,11726
d341aefb30510698c9b16ee7c55969f823b64dc6,0,Dimuthu Wannipurage,2018-11-20 03:24:06-05:00,['b2b080c793f98deedfda9cb1093969f8660373c0'],1,1,2,16558082,1,,,,11726
a781ee26a1a68741d99623d1cd6db4be351e2e17,0,Marcus Christie,2018-11-20 10:01:01-05:00,['709a791623f5629cfe63c9a7017450f2324dc300'],2,11,13,16558095,2,0,1,1,11726
8ec3f54b8e3a7c6a36303fe0f5449e644208d447,0,Dimuthu Wannipurage,2018-11-20 10:34:35-05:00,['d341aefb30510698c9b16ee7c55969f823b64dc6'],7,8,15,16558110,3,1,0,0,11726
174cafce69718640c8865eaa955fb2c30936b254,0,Marcus Christie,2018-11-20 11:49:55-05:00,['a781ee26a1a68741d99623d1cd6db4be351e2e17'],1,2,3,16558113,1,,,,11726
3589953b13a9b73aeeb2c70da198a4ab010ef585,0,Marcus Christie,2018-11-20 11:50:45-05:00,['174cafce69718640c8865eaa955fb2c30936b254'],1,1,2,16558115,1,,,,11726
380f36e26c58fa73629a5ba8a7aeaff6602ac8cb,0,Marcus Christie,2018-11-20 19:30:57-05:00,['3589953b13a9b73aeeb2c70da198a4ab010ef585'],8,25,33,16558148,2,,,,11726
1226e82d9865eb437adddb25f9a05ba1ded17f17,0,DGRamya,2018-11-20 21:36:17-05:00,['f03e017d202ddbca5eb8e2c0d010742036015b9a'],1,1,2,16558150,1,,,,11726
130c9606bc1f0e00fbf4d533960ef268ee8edae5,1,Marcus Christie,2018-11-21 11:19:43-05:00,['380f36e26c58fa73629a5ba8a7aeaff6602ac8cb'],21,1600,1621,16559771,13,0.531083481,0.68383659,0.964476021,11727
215ae182d27480287050a511569ed522cc5d8616,1,Marcus Christie,2018-11-21 14:19:09-05:00,['130c9606bc1f0e00fbf4d533960ef268ee8edae5'],2,5,7,16559778,3,,,,11727
d809b0386a2f30b2aaf766dc2d0cb5d66af84948,0,GitHub,2018-11-21 14:25:34-05:00,"['215ae182d27480287050a511569ed522cc5d8616', '1226e82d9865eb437adddb25f9a05ba1ded17f17']",1,4,5,16559783,1,,,,11727
f57cc7e57aa8f940dac4599e80dbec1715219ad5,0,Dimuthu Wannipurage,2018-11-25 13:51:10+05:18,['8ec3f54b8e3a7c6a36303fe0f5449e644208d447'],17,94,111,16559894,7,0.645833333,0.979166667,0.9375,11729
e6fe2053313cf767283b15b1f5f07e382814ec61,0,Dimuthu Wannipurage,2018-11-25 15:00:13+05:18,['f57cc7e57aa8f940dac4599e80dbec1715219ad5'],0,10,10,16559904,1,,,,11729
96cb11b2b787ad8ea175103f540464c6e191420a,0,Dimuthu Wannipurage,2018-11-25 15:24:20+05:18,['e6fe2053313cf767283b15b1f5f07e382814ec61'],0,1,1,16559905,1,,,,11729
b7b08422d2bacbcfdf2dd9256a780e279481427c,0,Dimuthu Wannipurage,2018-11-25 16:31:09+05:18,['96cb11b2b787ad8ea175103f540464c6e191420a'],3,24,27,16559932,4,0,0.125,1,11729
e105c7cb8a155ac0aa6b4f9e96b9916b09b7d7c8,0,Dimuthu Wannipurage,2018-11-26 08:52:18+05:18,['b7b08422d2bacbcfdf2dd9256a780e279481427c'],4,8,12,16559944,3,1,0,0,11729
11929a9e7069032f2a412494ba3d0f6e24246244,0,Eroma Abeysinghe,2018-11-26 16:12:49-05:00,['76e2ebaff14f2ba3ac7916ea24c34030c50de471'],0,84,84,16560028,2,,,,11731
d18ae10510e60c8e6c43b70cf38173f35b041cb2,0,Eroma Abeysinghe,2018-11-26 16:19:09-05:00,['11929a9e7069032f2a412494ba3d0f6e24246244'],19,18,37,16560065,2,,,,11731
161b21f5b422d6b76d4baf58d38e0d883e78d6e0,0,Eroma Abeysinghe,2018-11-26 16:58:31-05:00,['d18ae10510e60c8e6c43b70cf38173f35b041cb2'],5,5,10,16560075,1,,,,11731
6b779a97422c044c6ac2493dd46b7282c3fac836,0,Eroma Abeysinghe,2018-11-27 08:33:24-05:00,['161b21f5b422d6b76d4baf58d38e0d883e78d6e0'],4,4,8,16560083,1,,,,11731
8b9a7fff4d8efcd3bf515018eaa7293251471a72,0,Eroma Abeysinghe,2018-11-28 13:15:15-05:00,['6b779a97422c044c6ac2493dd46b7282c3fac836'],0,1,1,16560084,1,,,,11731
b1738809aee44fda16f43791f7d3868d14404a70,0,Eroma Abeysinghe,2018-11-28 13:28:33-05:00,['8b9a7fff4d8efcd3bf515018eaa7293251471a72'],1,5,6,16560090,1,,,,11731
2154128c971b50fedc11e12ec566beaf369e7bbc,0,Dimuthu Wannipurage,2018-11-30 15:24:56+05:18,['e105c7cb8a155ac0aa6b4f9e96b9916b09b7d7c8'],1,0,1,16560091,1,1,0,0,11731
c1376d45d8a2960ecf4f0a5d6831a96d7deee71b,0,Dimuthu Wannipurage,2018-11-30 16:21:05+05:18,"['d809b0386a2f30b2aaf766dc2d0cb5d66af84948', '2154128c971b50fedc11e12ec566beaf369e7bbc']",327,1854,2181,16562272,77,,,,11731
f0e4f404d38b790ccef01c159c09a9c7b613f111,0,Dimuthu Wannipurage,2018-11-30 16:37:55+05:18,['c1376d45d8a2960ecf4f0a5d6831a96d7deee71b'],6724,10882,17606,16579878,8,0.338526064,0.41312163,1,11733
d7fa9434a7f88a312413b52e37333de31e7643d3,1,Eroma Abeysinghe,2018-12-03 11:47:56-05:00,['f0e4f404d38b790ccef01c159c09a9c7b613f111'],0,54,54,16579932,1,,,,11734
623757380ba99b12405eb13caaa212653a195f5a,0,Eroma Abeysinghe,2018-12-03 12:37:31-05:00,['d7fa9434a7f88a312413b52e37333de31e7643d3'],0,1,1,16579933,1,,,,11734
29b408e94415241f1a5c15bec5892658eb560e80,0,Eroma Abeysinghe,2018-12-03 12:38:29-05:00,['623757380ba99b12405eb13caaa212653a195f5a'],0,15,15,16579948,1,,,,11735
d9fbac3fc27fe45e56ef443dff351ccfa13c17a0,0,Eroma Abeysinghe,2018-12-03 14:21:30-05:00,['29b408e94415241f1a5c15bec5892658eb560e80'],4,4,8,16579956,1,,,,11735
2b6937fd92511ec6e52215048bf0339e7ce0f71d,0,Eroma Abeysinghe,2018-12-03 16:27:43-05:00,['d9fbac3fc27fe45e56ef443dff351ccfa13c17a0'],2,2,4,16579960,1,,,,11735
d172f91977fcc031470059eae52a146e7dbf05b6,0,Dimuthu Wannipurage,2018-12-06 07:46:10+05:18,['2154128c971b50fedc11e12ec566beaf369e7bbc'],228782,37,228819,16808779,1113,0.454640142,0.30123756,0.053592902,11735
ec22e480c42d015a605b4b89ad5557fd59f30940,0,Dimuthu Wannipurage,2018-12-09 23:34:44+05:18,['d172f91977fcc031470059eae52a146e7dbf05b6'],4,40,44,16808823,5,1,1,1,11736
ea882daaac7f8a798a3fd6241ab80901f0a5bde0,0,Dimuthu Wannipurage,2018-12-10 07:42:06+05:18,['ec22e480c42d015a605b4b89ad5557fd59f30940'],0,0,0,16808823,6,,,,11736
0fbe1b1274c29338b992eb228836d18df71c4b52,0,Dimuthu Wannipurage,2018-12-10 11:06:36+05:18,['ec22e480c42d015a605b4b89ad5557fd59f30940'],8,34,42,16808865,2,,,,11736
4f490eb37794a0285c6c674737203b296efe51b9,0,Dimuthu Wannipurage,2018-12-10 11:10:10+05:18,"['0fbe1b1274c29338b992eb228836d18df71c4b52', 'ea882daaac7f8a798a3fd6241ab80901f0a5bde0']",0,0,0,16808865,6,,,,11736
a51defadd31d3d66f1454cad45d9c63b05b3c8b2,1,Marcus Christie,2018-12-10 14:46:54-05:00,['2b6937fd92511ec6e52215048bf0339e7ce0f71d'],3,6,9,16808874,4,,,,11736
9b6a7e8f4825afd8b55aca8fce9d9f22486ae737,0,Marcus Christie,2018-12-13 08:54:33-05:00,['a51defadd31d3d66f1454cad45d9c63b05b3c8b2'],4,105,109,16808983,3,0,1,1,11736
78a22163a39a9985d34fa635754ebf9064ee8305,0,Dimuthu Wannipurage,2018-12-19 01:13:26+05:18,['4f490eb37794a0285c6c674737203b296efe51b9'],0,604,604,16809587,10,0.719298246,1,0.941520468,11744
711c2d77ccdac6ad4a5a861bb178ec3c0a274fe0,0,Dimuthu Wannipurage,2018-12-19 01:42:56+05:18,['78a22163a39a9985d34fa635754ebf9064ee8305'],5,23,28,16809615,1,0,0,1,11744
a6ef239695f87c8d9ebf97ff6977b335e6e9820a,0,Dimuthu Wannipurage,2018-12-19 01:56:00+05:18,['711c2d77ccdac6ad4a5a861bb178ec3c0a274fe0'],1,12,13,16809628,1,1,1,1,11744
25975e2e84b88796af593afae1bcdf0e74db9f93,0,Marcus Christie,2018-12-19 15:20:04-05:00,['9b6a7e8f4825afd8b55aca8fce9d9f22486ae737'],0,2,2,16809630,1,,,,11744
b82714626017773aef293db1bbd0f44763c0e869,0,Marcus Christie,2018-12-20 08:51:10-05:00,['a6ef239695f87c8d9ebf97ff6977b335e6e9820a'],0,8,8,16809638,3,,,,11744
abd1979dcc01f68f1f29c4ae894e9939d2decc8f,0,Marcus Christie,2018-12-20 08:51:10-05:00,['b82714626017773aef293db1bbd0f44763c0e869'],0,3,3,16809641,1,,,,11744
241e5a3f238524eadde2cc49f344108452a9f87d,0,Marcus Christie,2018-12-20 08:59:30-05:00,['b1738809aee44fda16f43791f7d3868d14404a70'],0,2,2,16809643,1,,,,11744
0bf84951f01fce32abd7d3173fbe922314dbddb8,0,Marcus Christie,2018-12-21 12:36:43-05:00,['abd1979dcc01f68f1f29c4ae894e9939d2decc8f'],1,3,4,16809647,1,,,,11744
e889b3a05aaee8627c68810185d2fe63d0099e7e,0,Marcus Christie,2018-12-21 12:40:49-05:00,['25975e2e84b88796af593afae1bcdf0e74db9f93'],1,3,4,16809651,1,,,,11744
e0a1d165aa289a6372c0a92f59ad94539ad9c8ba,0,Marcus Christie,2018-12-28 11:37:48-05:00,['e889b3a05aaee8627c68810185d2fe63d0099e7e'],0,1,1,16809652,1,0,0,1,11744
89ae6eef1fcb927534aab61016b4e87e1df22a48,0,Dimuthu Wannipurage,2018-12-28 15:00:17-05:00,"['a6ef239695f87c8d9ebf97ff6977b335e6e9820a', '241e5a3f238524eadde2cc49f344108452a9f87d']",40454,55121,95575,16905227,93,,,,11744
f0e1eb4a66f724fb13ca26ff52030280fe56b448,0,Dimuthu Wannipurage,2018-12-29 22:02:07-05:00,"['89ae6eef1fcb927534aab61016b4e87e1df22a48', '0bf84951f01fce32abd7d3173fbe922314dbddb8']",1,3,4,16905231,1,,,,11744
cb87e25988b53440a2a9c754af57e02a4c7738d9,0,Dimuthu Wannipurage,2018-12-29 22:56:32-05:00,['f0e1eb4a66f724fb13ca26ff52030280fe56b448'],54058,48598,102656,17007887,17,0.985443466,0.529113067,0,11747
091382da617cf8275a02f59da7319d6c5e5f9a60,0,Dimuthu Wannipurage,2019-01-02 12:07:38-05:00,['cb87e25988b53440a2a9c754af57e02a4c7738d9'],21,21,42,17007929,5,,,,11747
c9829c4728ebe7fa37a8e837add0ebf5672d0119,0,Marcus Christie,2019-01-03 12:43:31-05:00,['e0a1d165aa289a6372c0a92f59ad94539ad9c8ba'],1,1,2,17007931,1,,,,11747
d65899c1f7b8e1b5a02d175b27beb9bb7ac8fcff,0,Marcus Christie,2019-01-04 10:23:00-05:00,['c9829c4728ebe7fa37a8e837add0ebf5672d0119'],0,27,27,17007958,2,,,,11748
56f6728d91fbb5eb9ab6ac5688309cd071a50d90,0,Marcus Christie,2019-01-04 10:30:41-05:00,['d65899c1f7b8e1b5a02d175b27beb9bb7ac8fcff'],1,1,2,17007960,1,,,,11748
701aebce283da9eb8ee558030d04d16f33d78901,0,Dimuthu Wannipurage,2019-01-04 13:08:35-05:00,['56f6728d91fbb5eb9ab6ac5688309cd071a50d90'],2,1,3,17007963,1,1,0,0,11748
f3abbdc9698e9c001f2b8411e202e0d4fda97f50,0,Dimuthu Wannipurage,2019-01-07 12:15:59-05:00,['701aebce283da9eb8ee558030d04d16f33d78901'],0,11,11,17007974,1,0,0,1,11748
11cb76df6bad4e22c34aa5d9b6bcc1094eb391d8,0,Marcus Christie,2019-01-07 12:27:04-05:00,['f3abbdc9698e9c001f2b8411e202e0d4fda97f50'],3,13,16,17007990,1,,,,11748
48d27edf2b69c5aff5192aa42ac7855eae41659d,1,Dimuthu Wannipurage,2019-01-08 16:23:40-05:00,['11cb76df6bad4e22c34aa5d9b6bcc1094eb391d8'],1439,15424,16863,17024853,22,0.420683201,0.488628919,0.933083762,11748
e732224e79c6d04d4a2c4506a13ee1598de94bbb,0,Dimuthu Wannipurage,2019-01-08 16:25:25-05:00,['48d27edf2b69c5aff5192aa42ac7855eae41659d'],0,946,946,17025799,3,0.232394366,0.164788732,0.936619718,11751
382ca0cfb8647dbefddf28de30661e0e56d8b47d,0,Dimuthu Wannipurage,2019-01-08 16:37:31-05:00,['e732224e79c6d04d4a2c4506a13ee1598de94bbb'],4,5,9,17025808,2,0,0,1,11751
11e846363cdb4822692f82bac71ccc2441e541da,0,Dimuthu Wannipurage,2019-01-08 16:59:34-05:00,['382ca0cfb8647dbefddf28de30661e0e56d8b47d'],2,2,4,17025812,1,,,,11751
b24f1cebe0eec2fd77430b4e714cb0abdbddb2a5,1,Marcus Christie,2019-01-10 10:46:08-05:00,['11e846363cdb4822692f82bac71ccc2441e541da'],4,6,10,17025822,2,,,,11751
9a7d82176a22f7eec7b838652d91bf2b4fa3d313,0,Marcus Christie,2019-01-10 10:53:00-05:00,['b24f1cebe0eec2fd77430b4e714cb0abdbddb2a5'],3,0,3,17025825,1,,,,11751
e61bcbb9d3f4786fb6d9005408483152f31ce815,0,Dimuthu Wannipurage,2019-01-10 11:40:02-05:00,['091382da617cf8275a02f59da7319d6c5e5f9a60'],11,43,54,17025879,2,0.238095238,1,0.571428571,11751
9d6d37dd0f4f0f97f317a357ab602afef04b9cb6,0,Marcus Christie,2019-01-11 16:21:05-05:00,['9a7d82176a22f7eec7b838652d91bf2b4fa3d313'],945,2198,3143,17029022,25,0.867177522,1,0.970625798,11751
f28f86170003308bcd4089332e886a3a3246bc9e,0,Marcus Christie,2019-01-11 17:08:44-05:00,['9d6d37dd0f4f0f97f317a357ab602afef04b9cb6'],11,11,22,17029044,9,,,,11751
bec5809160d0ad2e5dcc49c0d27b54d25f560b90,0,Dimuthu Wannipurage,2019-01-15 14:23:19-05:00,['f28f86170003308bcd4089332e886a3a3246bc9e'],2,36,38,17029082,2,0,1,1,11751
b4949f9d90e62560512faf7e4ff65494f62de072,0,Dimuthu Wannipurage,2019-01-16 09:49:48-05:00,['bec5809160d0ad2e5dcc49c0d27b54d25f560b90'],0,3,3,17029085,1,0,0,1,11751
0cc43ea2c3ff2191ca08b6c5bba7659e792539c1,0,Dimuthu Wannipurage,2019-01-16 10:17:56-05:00,['b4949f9d90e62560512faf7e4ff65494f62de072'],1,1,2,17029087,1,,,,11751
94e219fc176cbfb0d78fa1a15914521e51ad5a62,0,Dimuthu Wannipurage,2019-01-16 10:18:32-05:00,['0cc43ea2c3ff2191ca08b6c5bba7659e792539c1'],1,8,9,17029096,1,,,,11751
448ed3c494cf4486627af6a63ca99ea46f31f530,0,Dimuthu Wannipurage,2019-01-16 12:13:46-05:00,['94e219fc176cbfb0d78fa1a15914521e51ad5a62'],9,12,21,17029117,1,1,1,1,11751
1c6f86700479b7e5038386d1807087296ed77934,0,Dimuthu Wannipurage,2019-01-16 12:14:26-05:00,['448ed3c494cf4486627af6a63ca99ea46f31f530'],2,6,8,17029125,1,0,1,1,11751
afcb7c2e54ea2ff158bbbc21038b1decf3532d0f,0,Dimuthu Wannipurage,2019-01-16 12:15:37-05:00,['1c6f86700479b7e5038386d1807087296ed77934'],2,2,4,17029129,2,,,,11751
44b8f2970867aadf25bf22b7903db1f872b58180,0,Dimuthu Wannipurage,2019-01-17 13:32:54-05:00,['afcb7c2e54ea2ff158bbbc21038b1decf3532d0f'],4,6,10,17029139,1,,,,11751
5bfee48591a0fcb16412285bcea60699e9ea0317,1,Dimuthu Wannipurage,2019-01-18 14:23:35-05:00,['e61bcbb9d3f4786fb6d9005408483152f31ce815'],5050,6138,11188,17040327,20,0.459770115,0.62962963,1,11751
3f67957ac8cfa63ec4abe0ccddb2aebd51b292b1,0,Marcus Christie,2019-01-18 14:46:28-05:00,['5bfee48591a0fcb16412285bcea60699e9ea0317'],0,58,58,17040385,2,,,,11752
2878568f7f605ec1509b458fdedcce1f08fe76f3,0,Dimuthu Wannipurage,2019-01-18 14:59:38-05:00,['3f67957ac8cfa63ec4abe0ccddb2aebd51b292b1'],0,9,9,17040394,3,,,,11752
4f34b19139245ff8ed4c3187f6fe3d4a5eae8a16,0,Dimuthu Wannipurage,2019-01-18 15:46:36-05:00,['2878568f7f605ec1509b458fdedcce1f08fe76f3'],2,3,5,17040399,1,1,1,1,11752
cedbd981c378451f91b1de1aeb3736c9da106d3b,0,Dimuthu Wannipurage,2019-01-18 16:16:49-05:00,['4f34b19139245ff8ed4c3187f6fe3d4a5eae8a16'],0,1,1,17040400,1,0,0,1,11752
6353b294b88590733d24ac997eb289bd5a80bde4,0,Marcus Christie,2019-01-22 18:52:51-05:00,['241e5a3f238524eadde2cc49f344108452a9f87d'],2,7,9,17040409,1,0,1,1,11752
d55d7066f9002d8ca19e3b72efe353a12daa5caf,1,Marcus Christie,2019-01-23 09:24:08-05:00,['44b8f2970867aadf25bf22b7903db1f872b58180'],2,7,9,17040418,1,0,1,1,11752
2757880bcdc92e0ebb4b9ee3ca43c038e7f015b1,1,Marcus Christie,2019-01-23 10:23:42-05:00,['d55d7066f9002d8ca19e3b72efe353a12daa5caf'],11,11,22,17040440,6,,,,11752
5c1ed49c4e4c384e62f69ab4151ad59e335df053,0,Dimuthu Wannipurage,2019-01-23 14:33:44-05:00,['cedbd981c378451f91b1de1aeb3736c9da106d3b'],5118,8138,13256,17053696,21,0.614360437,0.710889206,0.992391821,11756
08748352c25a80a022ade4fc6eb3c6d59878cfe4,0,Dimuthu Wannipurage,2019-01-23 14:55:33-05:00,['5c1ed49c4e4c384e62f69ab4151ad59e335df053'],0,1,1,17053697,1,,,,11756
2a6929e57d707dd6851d1ee515335834caa48603,0,Dimuthu Wannipurage,2019-01-23 15:29:55-05:00,['08748352c25a80a022ade4fc6eb3c6d59878cfe4'],69,230,299,17053996,3,0.205673759,0.212765957,1,11756
b18f8b69b4fe061f729f1f82f645f2e88fe98226,0,Dimuthu Wannipurage,2019-01-23 15:38:11-05:00,['2a6929e57d707dd6851d1ee515335834caa48603'],33,30,63,17054059,5,1,1,0,11756
a570a5790198156a9a32b89787ad1e69c43cf333,0,Dimuthu Wannipurage,2019-01-23 16:49:41-05:00,['b18f8b69b4fe061f729f1f82f645f2e88fe98226'],2,2,4,17054063,1,,,,11756
06c20dce2a96c26a9f70e1d7fa86f39c04283e77,0,Dimuthu Wannipurage,2019-01-23 16:50:01-05:00,['a570a5790198156a9a32b89787ad1e69c43cf333'],2,2,4,17054067,1,,,,11756
a995878369cc31fd674676b4bf2374c1e2882906,0,Dimuthu Wannipurage,2019-01-23 17:42:54-05:00,['06c20dce2a96c26a9f70e1d7fa86f39c04283e77'],5,0,5,17054072,2,,,,11756
7897c0a2eb8e9d26dad094ad93475bfbc34cbc6c,0,Dimuthu Wannipurage,2019-01-23 17:43:26-05:00,['a995878369cc31fd674676b4bf2374c1e2882906'],7,268,275,17054347,10,0.222222222,0.343434343,1,11756
721dae23022c66233048f56b9cf0a7c1d0507793,0,Dimuthu Wannipurage,2019-01-23 18:49:23-05:00,['7897c0a2eb8e9d26dad094ad93475bfbc34cbc6c'],0,8,8,17054355,1,0,0.75,0,11756
f55bb83596c6d87151118ca20c66746f779590b3,0,Dimuthu Wannipurage,2019-01-23 21:11:03-05:00,['721dae23022c66233048f56b9cf0a7c1d0507793'],24,0,24,17054379,2,0,0,0,11756
358d2426e7e87906f53d6cfa7f38583959e89521,0,Dimuthu Wannipurage,2019-01-23 21:11:35-05:00,['f55bb83596c6d87151118ca20c66746f779590b3'],1,2,3,17054382,2,0,0,1,11756
ef15e2fd5d60c04c0936cfcf58ae26d03406793f,0,Dimuthu Wannipurage,2019-01-24 15:02:36-05:00,['2757880bcdc92e0ebb4b9ee3ca43c038e7f015b1'],0,6,6,17054388,1,,,,11756
f798bdb246fac5725a3a015bc7a3d54162a26970,0,Dimuthu Wannipurage,2019-01-24 15:03:20-05:00,['ef15e2fd5d60c04c0936cfcf58ae26d03406793f'],0,8,8,17054396,1,0,1,0,11756
63df813aac627e515b885152f9c72624d4d46660,0,Dimuthu Wannipurage,2019-01-24 16:21:11-05:00,['f798bdb246fac5725a3a015bc7a3d54162a26970'],1,2,3,17054399,1,0,1,0,11756
bac48350bb1a22f684e11740d17a5ed66f37c8aa,0,Marcus Christie,2019-01-25 15:52:51-05:00,['358d2426e7e87906f53d6cfa7f38583959e89521'],6,12,18,17054417,3,,,,11756
b764b8fb86ea006b511046f17cc38e346287127c,0,Dimuthu Wannipurage,2019-01-29 16:22:30-05:00,['bac48350bb1a22f684e11740d17a5ed66f37c8aa'],17,17,34,17054451,1,,,,11756
88d45a8b839910fb45c29d7beef4bd034e586e68,0,Dimuthu Wannipurage,2019-01-30 12:58:34-05:00,['b764b8fb86ea006b511046f17cc38e346287127c'],1,1,2,17054453,1,,,,11756
512fa67a34d6feb429188a7e4a7662a91f182c9c,0,Dimuthu Wannipurage,2019-01-30 13:05:54-05:00,['63df813aac627e515b885152f9c72624d4d46660'],1,1,2,17054455,1,,,,11756
5c9beda4f3d81e37f12a9b5dd1a72b8f829381f1,0,Eroma Abeysinghe,2019-01-31 12:44:56-05:00,['63df813aac627e515b885152f9c72624d4d46660'],1,1,2,17054457,1,,,,11756
083932e8b97d2570154e3c352730b145420b0bee,0,Eroma Abeysinghe,2019-01-31 14:36:58-05:00,['5c9beda4f3d81e37f12a9b5dd1a72b8f829381f1'],1,1,2,17054459,1,,,,11756
f74e475f88b4ef6f35f3a9fefa577a4210aa034f,0,Eroma Abeysinghe,2019-01-31 14:37:27-05:00,"['083932e8b97d2570154e3c352730b145420b0bee', '512fa67a34d6feb429188a7e4a7662a91f182c9c']",1,1,2,17054461,1,,,,11756
ac30f48b3de87d8c0b597af8c13778b07788f629,0,Eroma Abeysinghe,2019-01-31 14:38:40-05:00,['f74e475f88b4ef6f35f3a9fefa577a4210aa034f'],4,4,8,17054469,1,,,,11756
d5b8e58cc736e800e334aa828880dba4dfcf1f54,0,Eroma Abeysinghe,2019-01-31 16:00:50-05:00,['6353b294b88590733d24ac997eb289bd5a80bde4'],5,5,10,17054479,1,,,,11756
3c783ac8fed11ddc9cb07e82ed1c6289304ca715,0,Dimuthu Wannipurage,2019-01-31 16:31:51-05:00,['a6ef239695f87c8d9ebf97ff6977b335e6e9820a'],1,5,6,17054485,1,1,1,1,11756
3709aaaef543c1c46d5951b8a7c02156e15b02a7,0,Dimuthu Wannipurage,2019-01-31 16:36:05-05:00,['3c783ac8fed11ddc9cb07e82ed1c6289304ca715'],30,55,85,17054570,2,0,1,0,11756
921f1be13104a7dd7fc5751bb240b1bb44514467,0,Dimuthu Wannipurage,2019-01-31 17:06:25-05:00,"['88d45a8b839910fb45c29d7beef4bd034e586e68', '3709aaaef543c1c46d5951b8a7c02156e15b02a7']",31,60,91,17054661,3,,,,11756
5ac9117f97fffaa67d674913994ea4282677bc38,0,Suresh Marru,2019-02-02 11:00:42-05:00,['d5b8e58cc736e800e334aa828880dba4dfcf1f54'],0,1,1,17054662,1,,,,11756
8ce886b98377fba998b43f1f155b60b730c6a0b2,1,Marcus Christie,2019-02-04 11:15:51-05:00,['ac30f48b3de87d8c0b597af8c13778b07788f629'],1370,578,1948,17056610,31,0.634353741,0.421768707,0.091836735,11765
d200a8d87d4f29a8221c6bcb16381cc75ad47083,0,Marcus Christie,2019-02-04 11:15:51-05:00,['8ce886b98377fba998b43f1f155b60b730c6a0b2'],39,2,41,17056651,5,0,0,0,11765
76a03579e1256fcdedfa5d17edd735e7766f9e92,1,Marcus Christie,2019-02-04 11:15:51-05:00,['d200a8d87d4f29a8221c6bcb16381cc75ad47083'],78,79,157,17056808,3,,,,11765
c490b843185cb4614219f3e2b83229a332500517,0,Marcus Christie,2019-02-04 11:15:51-05:00,['76a03579e1256fcdedfa5d17edd735e7766f9e92'],1067,120,1187,17057995,10,0.606260297,0.334431631,0.097199341,11767
db5b32159c9eb785aa53e3ca9afb5519edc0eb45,1,Marcus Christie,2019-02-04 11:15:51-05:00,['c490b843185cb4614219f3e2b83229a332500517'],1344,149,1493,17059488,12,0.681087763,0.406674907,0.072929543,11769
40a2fba8c71ca83c21220e9ef5dda3fb3bdadf29,0,Marcus Christie,2019-02-04 11:15:51-05:00,['db5b32159c9eb785aa53e3ca9afb5519edc0eb45'],1,1,2,17059490,1,,,,11769
55cb6a1f8c68fe20783fbcc8b65c590411a3382c,0,Marcus Christie,2019-02-04 11:15:51-05:00,['40a2fba8c71ca83c21220e9ef5dda3fb3bdadf29'],1,1,2,17059492,1,,,,11769
42b1fccda9570d0fe0762411cab64215c967da88,0,Marcus Christie,2019-02-04 11:15:51-05:00,['55cb6a1f8c68fe20783fbcc8b65c590411a3382c'],27,271,298,17059790,7,0,0,1,11772
cbed9302d3bf8ce30610bddad8b6535b7c5ee748,0,Marcus Christie,2019-02-04 11:15:51-05:00,['42b1fccda9570d0fe0762411cab64215c967da88'],1,1,2,17059792,1,,,,11772
0c5f4943128ebe851b06e7312f075968b528c734,0,Marcus Christie,2019-02-04 11:15:52-05:00,['cbed9302d3bf8ce30610bddad8b6535b7c5ee748'],306,0,306,17060098,1,0.821656051,0.566878981,0,11772
5144ca769ed81f43b06d636a6d1363c0b8030deb,1,Marcus Christie,2019-02-04 11:15:52-05:00,['0c5f4943128ebe851b06e7312f075968b528c734'],1426,591,2017,17062115,40,0.773286467,0.532513181,0.014059754,11775
ca5e20ea44c652899fb11180bef35d7edbef415e,0,Marcus Christie,2019-02-04 11:15:52-05:00,['5144ca769ed81f43b06d636a6d1363c0b8030deb'],1,1,2,17062117,1,,,,11775
61bc8fd43a06184e9e5509836ecdabc0fe69a242,0,Marcus Christie,2019-02-04 11:15:52-05:00,['ca5e20ea44c652899fb11180bef35d7edbef415e'],990,0,990,17063107,5,0.716639209,0.505766063,0,11775
156b7c59562b4623a60db24a403856ad6841b9a0,1,Marcus Christie,2019-02-04 11:15:52-05:00,['61bc8fd43a06184e9e5509836ecdabc0fe69a242'],100,200,300,17063407,9,,,,11775
966886d50ad68b870acea0798969f1e702a16998,1,Marcus Christie,2019-02-04 11:15:52-05:00,['156b7c59562b4623a60db24a403856ad6841b9a0'],416,198,614,17064021,11,0,0,0,11776
6878eb85ee614c6bfd273ebb10476b0405720b96,1,Marcus Christie,2019-02-04 11:15:52-05:00,['966886d50ad68b870acea0798969f1e702a16998'],7,25,32,17064053,3,,,,11776
6e3542c493b78c3642df78b71c5def61c7ab109b,0,Marcus Christie,2019-02-04 11:15:52-05:00,['6878eb85ee614c6bfd273ebb10476b0405720b96'],0,31,31,17064084,1,,,,11777
a75a4f0a5761e45eeb06570914bc099111a37b8b,1,Marcus Christie,2019-02-04 11:15:52-05:00,['6e3542c493b78c3642df78b71c5def61c7ab109b'],2,6,8,17064092,1,,,,11777
0db131209d2d892ac0148dbd93a831015c9372e5,0,Marcus Christie,2019-02-04 11:15:52-05:00,['a75a4f0a5761e45eeb06570914bc099111a37b8b'],2,1,3,17064095,1,,,,11777
7a4ebeed960e04328dc1ee2f2b6a2ac0f06e1509,1,Marcus Christie,2019-02-04 11:15:52-05:00,['0db131209d2d892ac0148dbd93a831015c9372e5'],329,288,617,17064712,21,1,0,0,11780
4649b2a355266ddc0626e2bc79000fa0a9ea947a,0,Marcus Christie,2019-02-04 11:47:24-05:00,['7a4ebeed960e04328dc1ee2f2b6a2ac0f06e1509'],2,2,4,17064716,2,,,,11780
4cde408578b0c5196ef56b1950e0654d5122655f,0,Marcus Christie,2019-02-04 12:53:31-05:00,['4649b2a355266ddc0626e2bc79000fa0a9ea947a'],1,1,2,17064718,1,,,,11780
cc6c23e67b5a17124d9191fc8fbbb347405b6c4e,1,Marcus Christie,2019-02-05 13:47:59-05:00,['4cde408578b0c5196ef56b1950e0654d5122655f'],26,119,145,17064863,8,,,,11780
94d4b8c984064bcc0a80d0cd39e96071a1e6b7d8,1,Marcus Christie,2019-02-05 13:56:29-05:00,['cc6c23e67b5a17124d9191fc8fbbb347405b6c4e'],2,2,4,17064867,2,,,,11780
4e3bf1b909a1e738699bc77ae013ed096c6cc21c,0,Eroma Abeysinghe,2019-02-06 00:59:29-05:00,['5ac9117f97fffaa67d674913994ea4282677bc38'],0,66,66,17064933,1,,,,11781
719f8ff096d65242165100b8eb94c281f7dbb1df,0,Eroma Abeysinghe,2019-02-06 01:13:08-05:00,['4e3bf1b909a1e738699bc77ae013ed096c6cc21c'],2,2,4,17064937,1,,,,11781
a5c836f16b0d5c3f1f1e3694e6e506c1b0ff0bef,0,Eroma Abeysinghe,2019-02-06 01:16:56-05:00,['719f8ff096d65242165100b8eb94c281f7dbb1df'],1,1,2,17064939,1,,,,11781
057812f0ee2f8c373654f315ecc1fc13d49097d2,0,Eroma Abeysinghe,2019-02-06 01:17:35-05:00,['a5c836f16b0d5c3f1f1e3694e6e506c1b0ff0bef'],0,18,18,17064957,1,,,,11782
fdb37e7eaeccc7bd20f7e0b992707cc3a2d81940,0,Eroma Abeysinghe,2019-02-06 01:24:21-05:00,['057812f0ee2f8c373654f315ecc1fc13d49097d2'],1,1,2,17064959,1,,,,11782
63053572c1833900acec1f54650bd693a50f717d,0,Eroma Abeysinghe,2019-02-06 01:55:52-05:00,['fdb37e7eaeccc7bd20f7e0b992707cc3a2d81940'],0,66,66,17065025,1,,,,11783
e67566a1b3b73bdfd56be0aeedffb0db93ed7579,0,Eroma Abeysinghe,2019-02-06 01:57:40-05:00,['63053572c1833900acec1f54650bd693a50f717d'],0,18,18,17065043,1,,,,11784
99afa3382619cbcb34374399a51ab6266e2462d8,0,Eroma Abeysinghe,2019-02-06 02:07:46-05:00,['e67566a1b3b73bdfd56be0aeedffb0db93ed7579'],1,1,2,17065045,1,,,,11784
7efc129c6da48331830882d1e40179f8c267cf52,0,Eroma Abeysinghe,2019-02-06 02:17:17-05:00,['99afa3382619cbcb34374399a51ab6266e2462d8'],1,1,2,17065047,1,,,,11784
221b7254ef50713bb077492d239fe8a9186e852e,0,Marcus Christie,2019-02-06 12:57:58-05:00,['94d4b8c984064bcc0a80d0cd39e96071a1e6b7d8'],0,17,17,17065064,2,,,,11784
818ec02232612e1feb94c4e67239c86038245a9c,0,Marcus Christie,2019-02-06 13:16:56-05:00,['221b7254ef50713bb077492d239fe8a9186e852e'],63,152,215,17065279,7,0.2,0,0.933333333,11784
e388d059061727e35d91f9cd7621be723c635569,0,Eroma Abeysinghe,2019-02-07 03:25:34-05:00,['7efc129c6da48331830882d1e40179f8c267cf52'],2,2,4,17065283,1,,,,11784
bc0f99f6511438c68b1dfe72c1d401737d718744,1,Marcus Christie,2019-02-07 09:09:58-05:00,['818ec02232612e1feb94c4e67239c86038245a9c'],1,52,53,17065336,3,1,1,1,11784
8eee22dee2bfcee496840790269302c51a979ad8,0,Marcus Christie,2019-02-07 09:23:12-05:00,['bc0f99f6511438c68b1dfe72c1d401737d718744'],1,10,11,17065347,1,0,1,1,11784
05db6bcd44e70067e154243401c16b3a1f96ac2d,0,Marcus Christie,2019-02-07 10:33:58-05:00,['8eee22dee2bfcee496840790269302c51a979ad8'],62836,1261,64097,17129444,589,0.647702407,0.567540161,0.037786198,11784
b3ee3e4b3e6acf0b36474803bc0cf83b76624ecd,0,Marcus Christie,2019-02-13 16:40:53-05:00,['05db6bcd44e70067e154243401c16b3a1f96ac2d'],0,2,2,17129446,1,,,,11784
912349e769f1acce9e53cc7afbb7185487d1efda,0,Marcus Christie,2019-02-18 12:20:50-05:00,['b3ee3e4b3e6acf0b36474803bc0cf83b76624ecd'],3,3,6,17129452,1,,,,11784
99439ed729c0f95355f1e0fc88bc5f2162261e14,0,Marcus Christie,2019-02-18 15:39:09-05:00,['912349e769f1acce9e53cc7afbb7185487d1efda'],4,1,5,17129457,1,1,1,0,11784
cccea8e0d473ad8d03fd8503b6ee497c1e9133ba,0,Marcus Christie,2019-02-21 10:23:11-05:00,['99439ed729c0f95355f1e0fc88bc5f2162261e14'],14,14,28,17129485,2,,,,11784
7d0a63ef32291a3fc529a9ee7ada8f9bc0d21649,0,Marcus Christie,2019-02-21 10:32:51-05:00,['cccea8e0d473ad8d03fd8503b6ee497c1e9133ba'],0,6,6,17129491,1,,,,11784
a6fdf6d89e14d3c419a436672e4f31e3754c422a,0,Marcus Christie,2019-02-21 12:08:24-05:00,['7d0a63ef32291a3fc529a9ee7ada8f9bc0d21649'],0,10,10,17129501,1,0,0,0.5,11784
58ff73f7db76e31d0bf84a16df0e9253145b2f63,1,Dimuthu Wannipurage,2019-02-22 10:40:51-05:00,['a6fdf6d89e14d3c419a436672e4f31e3754c422a'],13,7805,7818,17137319,42,0,0.298507463,0.835820896,11819
41d64bb2ba3d95f5dc089480f334d90fc4c05cea,0,Dimuthu Wannipurage,2019-02-22 10:46:07-05:00,['58ff73f7db76e31d0bf84a16df0e9253145b2f63'],0,160423,160423,17297742,383,0.33100575,0.455597448,0.936732325,12202
0dd5234718df2832a26bc2d5d4792ef2b7a3c978,0,Dimuthu Wannipurage,2019-02-22 12:36:55-05:00,['41d64bb2ba3d95f5dc089480f334d90fc4c05cea'],0,59,59,17297801,1,,,,12203
a50f2b09abc3e2dc226879d02bc59d74d719ea21,0,Dimuthu Wannipurage,2019-02-22 13:09:51-05:00,['0dd5234718df2832a26bc2d5d4792ef2b7a3c978'],9,15,24,17297825,1,,,,12203
9161ccdef7baaeba88066133aaf758b927ccc079,0,Eroma Abeysinghe,2019-02-22 15:34:44-05:00,['e388d059061727e35d91f9cd7621be723c635569'],0,3,3,17297828,1,,,,12203
f82b7b95647880ae0a8c8d86fdd5e098dac1ed79,0,Dimuthu Wannipurage,2019-02-25 15:18:42-05:00,['a50f2b09abc3e2dc226879d02bc59d74d719ea21'],1,4,5,17297833,2,,,,12203
4d222ac1fd50ba29c79ff686a8d8322484367653,1,Dimuthu Wannipurage,2019-02-25 16:51:07-05:00,['f82b7b95647880ae0a8c8d86fdd5e098dac1ed79'],90,226,316,17298149,11,0.441176471,1,1,12206
bfd9d93c53d6c4fa38c7589289f3baa6aed6d6e5,0,Dimuthu Wannipurage,2019-02-25 17:51:58-05:00,['4d222ac1fd50ba29c79ff686a8d8322484367653'],10226,39392,49618,17347767,38,0.305301872,0.482003389,0.967973883,12216
317c700a03c735b2e493883c8592a9d2c1e2e78c,0,Dimuthu Wannipurage,2019-02-25 17:57:39-05:00,['bfd9d93c53d6c4fa38c7589289f3baa6aed6d6e5'],1,1,2,17347769,1,,,,12216
5347dbef6c737e25b4a82c5dfd1fc34cb6d4e04b,0,Dimuthu Wannipurage,2019-02-25 18:01:31-05:00,['317c700a03c735b2e493883c8592a9d2c1e2e78c'],22,20,42,17347811,1,,,,12216
30238388b2f6736a51f3215005666d420cccf829,0,Eroma Abeysinghe,2019-02-27 12:44:13-05:00,['9161ccdef7baaeba88066133aaf758b927ccc079'],4,4,8,17347819,1,,,,12216
b838d9cadafe91f9583f091c795a96ca3770f263,0,Marcus Christie,2019-02-27 16:34:00-05:00,['30238388b2f6736a51f3215005666d420cccf829'],7,7,14,17347833,2,,,,12216
ea6c33201166caa34579ffcdb91171833e84dd0a,0,Marcus Christie,2019-02-27 16:34:58-05:00,['88d45a8b839910fb45c29d7beef4bd034e586e68'],7,7,14,17347847,2,,,,12216
0f23bf6a2c6ce92b0382dc23ae82d0cd0413684d,0,Marcus Christie,2019-02-27 16:35:44-05:00,['5347dbef6c737e25b4a82c5dfd1fc34cb6d4e04b'],7,7,14,17347861,2,,,,12216
958a42f168e0f4bc2210099e304b6aad2a9dfb1d,0,Eroma Abeysinghe,2019-02-28 12:34:47-05:00,['b838d9cadafe91f9583f091c795a96ca3770f263'],4,4,8,17347869,1,,,,12216
6d74dc13621c459cd25ad8545dd6263985e4697a,0,Marcus Christie,2019-02-28 16:43:05-05:00,['0f23bf6a2c6ce92b0382dc23ae82d0cd0413684d'],0,2,2,17347871,1,,,,12216
79763ff6103b51dbbe598765178afc84c41f2465,0,Dimuthu Wannipurage,2019-03-01 14:24:41-05:00,"['921f1be13104a7dd7fc5751bb240b1bb44514467', 'ea6c33201166caa34579ffcdb91171833e84dd0a']",7,7,14,17347885,2,,,,12216
c7ca8a658ea37aa94e1f750cfc285ced21a1ea32,0,Dimuthu Wannipurage,2019-03-01 14:27:13-05:00,['79763ff6103b51dbbe598765178afc84c41f2465'],7,32,39,17347924,1,0.476190476,0.476190476,0.666666667,12216
c9f579607f888ba6614c5096c51ac0f23a87674b,0,Dimuthu Wannipurage,2019-03-01 15:04:00-05:00,['c7ca8a658ea37aa94e1f750cfc285ced21a1ea32'],1,2,3,17347927,1,,,,12216
0f0a52afadcb9bc33439cfb6be4ceb062a01ebfa,0,Dimuthu Wannipurage,2019-03-01 15:49:52-05:00,['c9f579607f888ba6614c5096c51ac0f23a87674b'],6,31,37,17347964,4,0.35,0,0,12216
039f9a2cdb7f4c7bfad0aa846fe160d478e59644,0,Dimuthu Wannipurage,2019-03-01 16:53:29-05:00,['0f0a52afadcb9bc33439cfb6be4ceb062a01ebfa'],6,22,28,17347992,1,0,0,1,12216
f72105761efb82e7ffc1637a5003dccf2aa40a73,0,Eroma Abeysinghe,2019-03-04 16:31:10-05:00,['958a42f168e0f4bc2210099e304b6aad2a9dfb1d'],2,2,4,17347996,1,,,,12216
da1b279c5a09f8cf02a57b79304c0f9d5f0394a5,0,Marcus Christie,2019-03-05 18:53:51-05:00,['6d74dc13621c459cd25ad8545dd6263985e4697a'],803,0,803,17348799,9,,,,12216
ff05f3abc19825f11681ca18cbeedc9a3e7734ef,0,Dimuthu Wannipurage,2019-03-06 15:21:47-05:00,['039f9a2cdb7f4c7bfad0aa846fe160d478e59644'],0,1,1,17348800,1,,,,12216
4b1a9e252861b4dc76ffb3999d935acbe7ab322d,0,Dimuthu Wannipurage,2019-03-08 12:09:44-05:00,['f72105761efb82e7ffc1637a5003dccf2aa40a73'],0,1,1,17348801,1,,,,12216
453ea2b40c560ff2f7255e0c78d875b0bc6b8a25,0,Dimuthu Wannipurage,2019-03-11 12:53:44-04:00,['da1b279c5a09f8cf02a57b79304c0f9d5f0394a5'],2,32,34,17348835,2,,,,12217
65e80bb597c0468fbee68e5aeabb2226f5192c2c,0,Dimuthu Wannipurage,2019-03-11 12:55:37-04:00,['453ea2b40c560ff2f7255e0c78d875b0bc6b8a25'],0,1,1,17348836,1,,,,12218
f2d8a835d61773348e8b10917fc1d66dba071fc5,0,Dimuthu Wannipurage,2019-03-11 12:56:50-04:00,['65e80bb597c0468fbee68e5aeabb2226f5192c2c'],4,2441,2445,17351281,5,,,,12220
57292c85329e7a949c787e6a9d44714456f716cb,0,Dimuthu Wannipurage,2019-03-11 12:57:35-04:00,['f2d8a835d61773348e8b10917fc1d66dba071fc5'],0,6,6,17351287,1,,,,12220
918bcef876debd6aaeed44867fc29ac0e7246dcf,0,Dimuthu Wannipurage,2019-03-11 12:58:14-04:00,['57292c85329e7a949c787e6a9d44714456f716cb'],4,79,83,17351370,4,0.7,1,1,12222
0d8ef6fa8c25125f9b1dd2b3015d7df496ad7f17,0,Dimuthu Wannipurage,2019-03-11 12:59:10-04:00,['918bcef876debd6aaeed44867fc29ac0e7246dcf'],15,19,34,17351404,2,0,1,1,12222
77b5f880ad44c979c1e0790ddde9865443e71db4,0,Dimuthu Wannipurage,2019-03-11 15:17:49-04:00,['0d8ef6fa8c25125f9b1dd2b3015d7df496ad7f17'],14,10,24,17351428,2,,,,12222
22f216a145be2d3aa7d8382b8ed3634b035f96f8,0,Dimuthu Wannipurage,2019-03-11 15:18:23-04:00,['77b5f880ad44c979c1e0790ddde9865443e71db4'],7,3590,3597,17355025,2,,,,12223
859ce37fb827fcd2145aff2f145dd49af59e64a4,0,Dimuthu Wannipurage,2019-03-11 15:36:36-04:00,['22f216a145be2d3aa7d8382b8ed3634b035f96f8'],6,58,64,17355089,2,0,1,1,12223
6066396cf948916e4b85425e0f00a8f517f8a5e4,0,Dimuthu Wannipurage,2019-03-11 15:43:06-04:00,['859ce37fb827fcd2145aff2f145dd49af59e64a4'],17,34,51,17355140,1,,,,12223
81b860abfb36e6d460b694cc2607b4a58b0bc674,0,Dimuthu Wannipurage,2019-03-11 15:49:17-04:00,['6066396cf948916e4b85425e0f00a8f517f8a5e4'],1,7,8,17355148,1,,,,12223
60d4b3dd29ec315ddcbb65895d932d3df11a89cb,0,Dimuthu Wannipurage,2019-03-12 21:43:20-04:00,['81b860abfb36e6d460b694cc2607b4a58b0bc674'],1,2,3,17355151,1,,,,12223
8f9ea47b6b78eff266deeebfeb51954704240ae3,0,Dimuthu Wannipurage,2019-03-12 21:44:17-04:00,['60d4b3dd29ec315ddcbb65895d932d3df11a89cb'],1,1,2,17355153,1,,,,12223
5aafb08bd6f2b253c5b06a71eef160a266e45854,0,Dimuthu Wannipurage,2019-03-12 21:45:56-04:00,['8f9ea47b6b78eff266deeebfeb51954704240ae3'],11,58,69,17355222,5,0.083333333,0,0.083333333,12223
77b7812899b484c2ca4925dc0df79d0c2402ab66,0,Dimuthu Wannipurage,2019-03-12 22:44:41-04:00,['5aafb08bd6f2b253c5b06a71eef160a266e45854'],1,0,1,17355223,1,,,,12223
e90b51e0506bf70c4715f6d9d2333f7519ca3103,0,Dimuthu Wannipurage,2019-03-12 22:46:39-04:00,['77b7812899b484c2ca4925dc0df79d0c2402ab66'],0,309,309,17355532,1,1,1,1,12224
7d2da37dd7c7331da73e8a5c9e284f4e0e1e9bc8,0,Dimuthu Wannipurage,2019-03-12 22:52:01-04:00,['e90b51e0506bf70c4715f6d9d2333f7519ca3103'],1,1,2,17355534,1,,,,12224
9a4c1bc9b343826d6dc6c75af5cb0f74e7e77480,0,Dimuthu Wannipurage,2019-03-12 23:01:10-04:00,['7d2da37dd7c7331da73e8a5c9e284f4e0e1e9bc8'],0,6,6,17355540,1,,,,12224
349c83754bcabf5261b3e82ac7a5fa0db1f5f50d,0,Dimuthu Wannipurage,2019-03-14 00:23:42-04:00,['9a4c1bc9b343826d6dc6c75af5cb0f74e7e77480'],1,1,2,17355542,1,,,,12224
b8dd3247dc0e5c693bf3a07778719da1873dd837,0,Sai Rohith Achanta,2019-03-15 12:18:20-04:00,['349c83754bcabf5261b3e82ac7a5fa0db1f5f50d'],2,2,4,17355546,1,,,,12224
a205f2569ec061039fe9737406a29e9b0aff3c80,0,GitHub,2019-03-15 12:22:00-04:00,"['349c83754bcabf5261b3e82ac7a5fa0db1f5f50d', 'b8dd3247dc0e5c693bf3a07778719da1873dd837']",2,2,4,17355550,1,,,,12224
5f989cbddaa7f02ea2cdf6b956f28a71af2c15f9,0,Marcus Christie,2019-03-15 12:43:46-04:00,['a205f2569ec061039fe9737406a29e9b0aff3c80'],2,12,14,17355564,3,,,,12224
88ca00b78d553d595ec229238114389a13288532,0,Marcus Christie,2019-03-15 15:52:34-04:00,['4b1a9e252861b4dc76ffb3999d935acbe7ab322d'],1,3,4,17355568,2,0,0,1,12224
0ba8531e4107a075bcb29816ba3501265c7cdb1e,0,Keerthi4308,2019-03-15 16:16:00-04:00,['5f989cbddaa7f02ea2cdf6b956f28a71af2c15f9'],1,4,5,17355573,1,,,,12224
fec770d1f39e5ed8c517757b9ad22113ed448563,0,GitHub,2019-03-15 17:06:10-04:00,"['5f989cbddaa7f02ea2cdf6b956f28a71af2c15f9', '0ba8531e4107a075bcb29816ba3501265c7cdb1e']",1,4,5,17355578,1,,,,12224
1a0dd49755e0c7f3cd3fa3d7ea44f294faa1b4ca,0,Dimuthu Wannipurage,2019-03-17 10:12:22-04:00,['88ca00b78d553d595ec229238114389a13288532'],1,1,2,17355580,1,,,,12224
431cb1b4f17bbedef633dd6b5b14cb625bad86c7,0,Marcus Christie,2019-03-19 14:31:13-04:00,['fec770d1f39e5ed8c517757b9ad22113ed448563'],0,78,78,17355658,2,,,,12225
167d31a6bccebd89ac8ba9efedf2d777724fe25b,0,Marcus Christie,2019-03-20 15:46:23-04:00,['431cb1b4f17bbedef633dd6b5b14cb625bad86c7'],6,40,46,17355704,3,0,1,1,12225
8eb16e203df1d429e5f2c5c6762dfbb8e40760aa,0,Suresh Marru,2019-03-20 21:55:34-04:00,['1a0dd49755e0c7f3cd3fa3d7ea44f294faa1b4ca'],2311,3831,6142,17361846,299,,,,12225
ef644775bf3322dd0e81db8ad64f90ccf8a36fca,0,Suresh Marru,2019-03-20 22:01:10-04:00,['8eb16e203df1d429e5f2c5c6762dfbb8e40760aa'],2,231,233,17362079,1,,,,12225
68711b9cb68d156adc16ab929eb14055c570089f,0,Suresh Marru,2019-03-20 22:41:41-04:00,['ef644775bf3322dd0e81db8ad64f90ccf8a36fca'],2,3,5,17362084,3,,,,12225
38e0b2a57f885b00c66be08204cf1af83c926958,0,Suresh Marru,2019-03-20 23:17:54-04:00,['68711b9cb68d156adc16ab929eb14055c570089f'],4,186,190,17362274,3,,,,12225
e3edeec77904f48845a50d974a318c7639f83d41,0,Suresh Marru,2019-03-21 00:11:57-04:00,['38e0b2a57f885b00c66be08204cf1af83c926958'],80,30,110,17362384,27,,,,12225
305cccab1d8eab8aff28e0fa06ebe9f01ffdde2e,0,Suresh Marru,2019-03-21 00:24:51-04:00,['e3edeec77904f48845a50d974a318c7639f83d41'],77,77,154,17362538,69,,,,12225
bcbfb67ab59bff3bcdc08e04dbef0ae4bb2e688e,0,Suresh Marru,2019-03-21 00:25:09-04:00,['305cccab1d8eab8aff28e0fa06ebe9f01ffdde2e'],77,77,154,17362692,69,,,,12225
391843a00eefa7b6213e845f2f044b4e042894d5,0,Dimuthu Wannipurage,2019-03-21 01:36:16-04:00,['bcbfb67ab59bff3bcdc08e04dbef0ae4bb2e688e'],4,4,8,17362700,1,,,,12225
9ada1f59c5225afacb6e0fc16499c5201f70b29c,0,Suresh Marru,2019-03-21 09:24:28-04:00,['ff05f3abc19825f11681ca18cbeedc9a3e7734ef'],227,149,376,17363076,73,,,,12225
823cab0c6047492c5fd07f553e85311e6b518367,0,Suresh Marru,2019-03-21 09:29:19-04:00,['167d31a6bccebd89ac8ba9efedf2d777724fe25b'],270,182,452,17363528,88,,,,12225
dcbb73f518a237121677bc1ae89031c34e20bb4c,0,Marcus Christie,2019-03-21 10:52:56-04:00,['823cab0c6047492c5fd07f553e85311e6b518367'],4,19,23,17363551,5,,,,12225
bda5e765729d48f0ebf304b0d1294adbe2186697,0,Dimuthu Wannipurage,2019-03-21 11:30:47-04:00,['9ada1f59c5225afacb6e0fc16499c5201f70b29c'],18,16,34,17363585,2,1,0,0.75,12225
dbcf6cbbef0f062c18ddcbbbf243698d3f33131f,0,Marcus Christie,2019-03-21 16:23:13-04:00,['dcbb73f518a237121677bc1ae89031c34e20bb4c'],3,3,6,17363591,2,,,,12225
8f9c109c18a28255fc47323a600e0cd534826b0f,0,Marcus Christie,2019-03-22 16:03:51-04:00,['dbcf6cbbef0f062c18ddcbbbf243698d3f33131f'],0,2,2,17363593,1,,,,12225
45fbef6caf731f6b4bbf8d5322cabbb5d411dec5,0,Marcus Christie,2019-03-25 10:52:30-04:00,['8f9c109c18a28255fc47323a600e0cd534826b0f'],5,9,14,17363607,2,,,,12225
eea0f0af437bb274020791a7b48c37566c34de73,0,Eroma Abeysinghe,2019-03-25 17:18:27-04:00,['391843a00eefa7b6213e845f2f044b4e042894d5'],0,66,66,17363673,1,,,,12226
b7b52e2196caf71c796c422f8d8c40b401e9e49a,0,Eroma Abeysinghe,2019-03-25 17:22:31-04:00,['eea0f0af437bb274020791a7b48c37566c34de73'],0,18,18,17363691,1,,,,12227
73eee994c4ab77d6ff9ff65f4e8a51a98b3e3439,0,Eroma Abeysinghe,2019-03-26 15:51:57-04:00,['b7b52e2196caf71c796c422f8d8c40b401e9e49a'],1,1,2,17363693,1,,,,12227
871bfbd05c0cbd048e5bdd87a21d3996328288b9,0,Suresh Marru,2019-03-26 22:19:54-04:00,['38e0b2a57f885b00c66be08204cf1af83c926958'],4,4,8,17363701,1,,,,12227
5df04325ba43249407656d882af0daad148786e5,0,Suresh Marru,2019-03-26 22:20:10-04:00,"['871bfbd05c0cbd048e5bdd87a21d3996328288b9', '73eee994c4ab77d6ff9ff65f4e8a51a98b3e3439']",160,194,354,17364055,72,,,,12227
b46c081dc7b9593fdb7b0f62581e6b073c1832ca,0,Eroma Abeysinghe,2019-03-28 11:51:02-04:00,['5df04325ba43249407656d882af0daad148786e5'],2,2,4,17364059,1,,,,12227
05a422ade51e1816306babc1df721fdb951bcde5,0,Dimuthu Wannipurage,2019-03-28 18:41:27-04:00,['bda5e765729d48f0ebf304b0d1294adbe2186697'],11,57,68,17364127,4,0,0,0,12227
f2415ff23c018c979b17978c9214feb85dc535d5,0,Dimuthu Wannipurage,2019-03-28 18:48:32-04:00,['05a422ade51e1816306babc1df721fdb951bcde5'],3664,0,3664,17367791,147,0.361111111,0.361111111,0,12227
bf07d2aed10a5259df434a999b00b9116161111e,0,Dimuthu Wannipurage,2019-03-28 19:12:03-04:00,['f2415ff23c018c979b17978c9214feb85dc535d5'],0,117,117,17367908,4,0.731343284,1,0.402985075,12228
d56dda49463b4c9c2f4f3b954b180d4bc1238e88,0,Dimuthu Wannipurage,2019-03-28 19:17:03-04:00,['bf07d2aed10a5259df434a999b00b9116161111e'],0,922,922,17368830,13,0.662790698,1,0.962209302,12240
db65570d5884cb6a6fc481288f1916cbed671738,0,Dimuthu Wannipurage,2019-03-29 14:08:19-04:00,['d56dda49463b4c9c2f4f3b954b180d4bc1238e88'],2,2,4,17368834,1,,,,12240
3b5092048074143287a6aaae8a388a08982093ec,0,Dimuthu Wannipurage,2019-03-29 14:09:01-04:00,['db65570d5884cb6a6fc481288f1916cbed671738'],6,39,45,17368879,2,,,,12240
9b5e3eb6bc0f39c9cfab5a642fba295fcaa5fbb6,0,Dimuthu Wannipurage,2019-03-30 02:19:49-04:00,['3b5092048074143287a6aaae8a388a08982093ec'],5,18,23,17368902,2,0,0,1,12240
fbabb5a32057bea892733eb921fb138a02cc55b2,0,Dimuthu Wannipurage,2019-03-30 10:29:57-04:00,['9b5e3eb6bc0f39c9cfab5a642fba295fcaa5fbb6'],21,117,138,17369040,4,0,0.444444444,0.833333333,12241
91f02d63f1dd391c69134a0677d4d6b3694d95bf,0,Eroma Abeysinghe,2019-04-01 02:22:46-04:00,['b46c081dc7b9593fdb7b0f62581e6b073c1832ca'],0,84,84,17369124,2,,,,12243
f9cc11c3997a9b2993f949167f88cd26e0f50014,0,Eroma Abeysinghe,2019-04-01 02:29:23-04:00,['91f02d63f1dd391c69134a0677d4d6b3694d95bf'],1,6,7,17369131,1,,,,12243
d00fb8b27995b0e1bbc8e9ef7f236a3c13aded12,0,Eroma Abeysinghe,2019-04-01 02:33:39-04:00,['f9cc11c3997a9b2993f949167f88cd26e0f50014'],5,5,10,17369141,1,,,,12243
348a383d795eecf0890ddca200e582e08d3926e3,0,Eroma Abeysinghe,2019-04-01 12:22:56-04:00,['d00fb8b27995b0e1bbc8e9ef7f236a3c13aded12'],4,4,8,17369149,1,,,,12243
79445964e906f17ef918e04cd9a14c6f23994f9c,0,Eroma Abeysinghe,2019-04-01 12:33:45-04:00,['348a383d795eecf0890ddca200e582e08d3926e3'],4,4,8,17369157,1,,,,12243
64fea0acccaf72525c7e92c06288e5fe0fe6e31e,1,Eroma Abeysinghe,2019-04-01 13:58:52-04:00,['45fbef6caf731f6b4bbf8d5322cabbb5d411dec5'],0,54,54,17369211,1,,,,12244
3c6ac02ba2e5eaedd457469b1a366d15d82cdf06,0,Eroma Abeysinghe,2019-04-01 16:23:57-04:00,['64fea0acccaf72525c7e92c06288e5fe0fe6e31e'],0,15,15,17369226,1,,,,12245
1c159d27d1005459ea4c4a93bbf544277f63ebac,0,Eroma Abeysinghe,2019-04-01 16:34:05-04:00,['3c6ac02ba2e5eaedd457469b1a366d15d82cdf06'],0,1,1,17369227,1,,,,12245
68c34b2ec18a9a5a318169de28841c41b62790e0,0,Eroma Abeysinghe,2019-04-01 16:36:51-04:00,['79445964e906f17ef918e04cd9a14c6f23994f9c'],4,4,8,17369235,1,,,,12245
113221fd3616c9390be6c987b23066db71db20f6,0,Marcus Christie,2019-04-01 17:14:27-04:00,['1c159d27d1005459ea4c4a93bbf544277f63ebac'],1,2,3,17369238,1,,,,12245
09530cc65461ddb581892578239c0394ac695bff,0,Dimuthu Wannipurage,2019-04-02 11:27:31-04:00,['fbabb5a32057bea892733eb921fb138a02cc55b2'],77,49,126,17369364,4,0.96875,0.90625,0,12245
9c00bdb806af6923ed98add9d0542c41e79cb706,0,Eroma Abeysinghe,2019-04-02 13:10:40-04:00,['68c34b2ec18a9a5a318169de28841c41b62790e0'],0,3,3,17369367,1,,,,12245
2e0df07434816525cc8e0a6348e022eb12f12e36,0,Dimuthu Wannipurage,2019-04-02 13:56:31-04:00,['09530cc65461ddb581892578239c0394ac695bff'],13,31,44,17369411,2,0,0,1,12245
3b19c83d44e06e11a0de03d7f389806a55777fe9,0,Dimuthu Wannipurage,2019-04-02 15:59:37-04:00,['2e0df07434816525cc8e0a6348e022eb12f12e36'],1,1,2,17369413,1,,,,12245
17a0e3091958251fdc65023a3a1210fbd3c29d6f,0,Dimuthu Wannipurage,2019-04-02 22:28:03-04:00,['3b19c83d44e06e11a0de03d7f389806a55777fe9'],1,1,2,17369415,1,,,,12245
4b8ef3719e355aceb73af2c9b068fe84beb9407b,0,Dimuthu Wannipurage,2019-04-03 01:20:51-04:00,['17a0e3091958251fdc65023a3a1210fbd3c29d6f'],0,2,2,17369417,1,0,1,0,12245
27eb5129e76dd8d0be7992a8c6b099314d1f5b7e,0,Dimuthu Wannipurage,2019-04-03 02:13:10-04:00,['4b8ef3719e355aceb73af2c9b068fe84beb9407b'],1,1,2,17369419,1,,,,12245
770695d7282b0c788316d0705e86b36e635652c5,1,Marcus Christie,2019-04-03 15:03:33-04:00,['113221fd3616c9390be6c987b23066db71db20f6'],24,159,183,17369602,4,0.540983607,0.573770492,0.62295082,12246
6134da4f912da0720a16b2608c4745ef05fa2eea,1,Marcus Christie,2019-04-03 15:33:15-04:00,['770695d7282b0c788316d0705e86b36e635652c5'],9,15,24,17369626,3,1,1,1,12246
1690e3f55e590639354f4824e8201e30068cb617,0,Marcus Christie,2019-04-03 15:47:50-04:00,['6134da4f912da0720a16b2608c4745ef05fa2eea'],1,3,4,17369630,1,0,0,1,12246
8cf2b821ed1ee46215ee4137e642d9ba2056bd72,0,Marcus Christie,2019-04-03 16:11:23-04:00,['1690e3f55e590639354f4824e8201e30068cb617'],123,14,137,17369767,4,0.75,0.107142857,0.482142857,12246
09184dbfebd1d6e85f4af60c0a441740a2b488f6,0,Dimuthu Wannipurage,2019-04-04 19:37:04-04:00,['27eb5129e76dd8d0be7992a8c6b099314d1f5b7e'],14,47,61,17369828,1,0,0,1,12246
658385197c476d41b3982683636349db0924701e,0,Eroma Abeysinghe,2019-04-05 10:15:28-04:00,['9c00bdb806af6923ed98add9d0542c41e79cb706'],1,1,2,17369830,1,,,,12246
58c75850112ec2d3aec05b19ffe43e533ff2c3d8,0,Marcus Christie,2019-04-05 11:59:16-04:00,['8cf2b821ed1ee46215ee4137e642d9ba2056bd72'],3,2,5,17369835,1,,,,12246
e2b5b840bc39c880dae3c95324a9100938b26084,0,Eroma Abeysinghe,2019-04-05 12:38:26-04:00,['1c159d27d1005459ea4c4a93bbf544277f63ebac'],2,2,4,17369839,1,,,,12246
287d459f1182a8a4a6e8acd8a5b3e1dce872e9b0,0,Eroma Abeysinghe,2019-04-05 12:39:22-04:00,"['e2b5b840bc39c880dae3c95324a9100938b26084', '58c75850112ec2d3aec05b19ffe43e533ff2c3d8']",92,126,218,17370057,9,,,,12246
bdaddd24bc06871693f492fee234a6afb2a9dd1c,1,Eroma Abeysinghe,2019-04-05 12:41:19-04:00,['287d459f1182a8a4a6e8acd8a5b3e1dce872e9b0'],1,1,2,17370059,1,,,,12246
ab8417e5fada953354dc7d94696be6044a51484c,0,Eroma Abeysinghe,2019-04-05 12:42:15-04:00,['bdaddd24bc06871693f492fee234a6afb2a9dd1c'],1,1,2,17370061,1,,,,12246
2edfb83bcd579e44da65f6bd3e69611f74d10699,0,Dimuthu Wannipurage,2019-04-05 14:15:04-04:00,['09184dbfebd1d6e85f4af60c0a441740a2b488f6'],12,58,70,17370131,9,0.296296296,1,1,12246
05694e389e8601b87be61d5bf22abe9d68abcaf6,0,Dimuthu Wannipurage,2019-04-05 15:32:09-04:00,['2edfb83bcd579e44da65f6bd3e69611f74d10699'],1,1,2,17370133,1,,,,12246
ef495d131b78ac0b9afe7254e19168de311330d0,1,Marcus Christie,2019-04-05 17:08:34-04:00,['ab8417e5fada953354dc7d94696be6044a51484c'],0,11,11,17370144,4,,,,12246
d91f2d85db9e8425a49a44ff4a9ab87ebcabcc31,1,Marcus Christie,2019-04-05 17:08:35-04:00,['ef495d131b78ac0b9afe7254e19168de311330d0'],11,15,26,17370170,2,0,1,1,12246
76a55405d9b622a0e3ffd8cc8d550b6c72069868,0,Dimuthu Wannipurage,2019-04-06 13:21:17-04:00,['05694e389e8601b87be61d5bf22abe9d68abcaf6'],63,8,71,17370241,3,1,0.150684932,0.082191781,12246
60d1e453c8cd2804840608394183bec212ac4f53,0,Dimuthu Wannipurage,2019-04-06 14:44:21-04:00,['76a55405d9b622a0e3ffd8cc8d550b6c72069868'],1,1,2,17370243,1,,,,12246
1ec7d99f41ba52aee00ccf2dd9c3a69184ef69df,0,Dimuthu Wannipurage,2019-04-06 14:51:02-04:00,['60d1e453c8cd2804840608394183bec212ac4f53'],1,1,2,17370245,1,,,,12246
c61b2d7c07f40d33ef5f87a9b03d5bc325f1d484,0,Marcus Christie,2019-04-09 18:38:18-04:00,['d91f2d85db9e8425a49a44ff4a9ab87ebcabcc31'],1,9,10,17370255,3,,,,12246
fbe83f30b668a07cf494d5c4bdb2c9ec8ca4febb,0,Marcus Christie,2019-04-10 09:56:10-04:00,['c61b2d7c07f40d33ef5f87a9b03d5bc325f1d484'],0,6,6,17370261,1,,,,12246
842b767cf3926cc725c95d06094339c5901b2a7b,0,Marcus Christie,2019-04-10 10:39:16-04:00,['fbe83f30b668a07cf494d5c4bdb2c9ec8ca4febb'],4,9,13,17370274,2,,,,12246
6019b23fcf3a8aaee582c5f0e85ef058093064d2,0,Marcus Christie,2019-04-10 16:21:49-04:00,['842b767cf3926cc725c95d06094339c5901b2a7b'],5,6,11,17370285,3,0,1,1,12246
00e3e3615e7058c0442fe8c49241ec7291f7bd6b,0,Marcus Christie,2019-04-12 15:24:44-04:00,['6019b23fcf3a8aaee582c5f0e85ef058093064d2'],2,2,4,17370289,1,,,,12246
c1377a57f036f201f89f99c2bb1cc88426e040f7,0,Marcus Christie,2019-04-12 15:25:45-04:00,['00e3e3615e7058c0442fe8c49241ec7291f7bd6b'],3,3,6,17370295,1,,,,12246
191c7cbb33cc61a47777ce11c637f83c15fca50d,0,Eroma Abeysinghe,2019-04-12 15:51:56-04:00,['658385197c476d41b3982683636349db0924701e'],2,2,4,17370299,1,,,,12246
00758576a78215f3b51e3764b96ab7c14ef13966,0,Eroma Abeysinghe,2019-04-12 15:57:13-04:00,['191c7cbb33cc61a47777ce11c637f83c15fca50d'],4,4,8,17370307,1,,,,12246
c1fd82bc09f9be2847d8601786854d036672fa80,0,Marcus Christie,2019-04-12 16:25:37-04:00,['c1377a57f036f201f89f99c2bb1cc88426e040f7'],23,35,58,17370365,3,,,,12246
2829932f779eeed09f542098f8792ba8fe3c602a,0,Marcus Christie,2019-04-15 12:49:04-04:00,['c1fd82bc09f9be2847d8601786854d036672fa80'],2,9,11,17370376,3,0,0,1,12246
567a04d63e3ad07dcfd15cae61d9e6834d4eed16,0,Marcus Christie,2019-04-15 12:49:40-04:00,['2829932f779eeed09f542098f8792ba8fe3c602a'],0,18,18,17370394,3,0,0.533333333,0.533333333,12246
e1a88de724511b6820a474ab11b9f43c368af22c,0,Dimuthu Wannipurage,2019-04-15 16:16:47-04:00,['1ec7d99f41ba52aee00ccf2dd9c3a69184ef69df'],1,9,10,17370404,2,,,,12246
ceeff058e84a768c6eebb0bf7459d6d757036adf,0,Dimuthu Wannipurage,2019-04-15 16:17:33-04:00,['e1a88de724511b6820a474ab11b9f43c368af22c'],2,7,9,17370413,1,0,0,1,12246
ae059f7654df779ca844f209cefd3b033c26648e,0,Dimuthu Wannipurage,2019-04-18 13:44:51-04:00,"['ceeff058e84a768c6eebb0bf7459d6d757036adf', '00758576a78215f3b51e3764b96ab7c14ef13966']",2330,4585,6915,17377328,317,,,,12246
3c77048d762f20c19f47a798bbf93c270a29a460,0,Eroma Abeysinghe,2019-04-19 12:38:15-04:00,['00758576a78215f3b51e3764b96ab7c14ef13966'],2,2,4,17377332,1,,,,12246
5a3e8a7bd87b6a327531994996cfc486586887b8,0,bd2019us,2019-04-20 11:50:41-05:00,['6019b23fcf3a8aaee582c5f0e85ef058093064d2'],4,3,7,17377339,2,1,0,1,12246
412254d1cb72612136854a1dfbe53363968ace6e,0,bd2019us,2019-04-25 10:51:28-05:00,['5a3e8a7bd87b6a327531994996cfc486586887b8'],14,14,28,17377367,8,,,,12246
828d331d253609db4c0833e323e57020b189169a,0,GitHub,2019-04-25 12:43:11-04:00,"['567a04d63e3ad07dcfd15cae61d9e6834d4eed16', '412254d1cb72612136854a1dfbe53363968ace6e']",18,17,35,17377402,9,,,,12246
cd14c6efc2217136f6f09caf92b566ec5bb6bfde,0,Dimuthu Wannipurage,2019-04-29 11:11:10-04:00,"['3c77048d762f20c19f47a798bbf93c270a29a460', 'ae059f7654df779ca844f209cefd3b033c26648e']",419459,292513,711972,18089374,2085,,,,12246
c5ada8ce5354cb7ec6095efa363c5646b3588d56,0,Dimuthu Wannipurage,2019-04-29 12:56:48-04:00,['cd14c6efc2217136f6f09caf92b566ec5bb6bfde'],2,2,4,18089378,1,,,,12246
196d4b41ab86857a867ff888bb325a3e68cb70a0,0,Dimuthu Wannipurage,2019-04-29 13:32:32-04:00,['c5ada8ce5354cb7ec6095efa363c5646b3588d56'],0,21,21,18089399,1,0,0,1,12246
f628452e313932dd5cc6cac3122304ca4d61aa44,0,Dimuthu Wannipurage,2019-04-29 13:35:56-04:00,['196d4b41ab86857a867ff888bb325a3e68cb70a0'],1,1,2,18089401,1,,,,12246
73ec5caff9efa90461b01add6474cd86e075dc9b,0,Dimuthu Wannipurage,2019-04-30 08:55:09-04:00,['f628452e313932dd5cc6cac3122304ca4d61aa44'],1,1,2,18089403,10,,,,12246
a89811f009376d10f7634e418dbf427f7668f96c,0,Dimuthu Wannipurage,2019-04-30 08:58:13-04:00,['73ec5caff9efa90461b01add6474cd86e075dc9b'],2425,6,2431,18091834,19,0.813813814,0.627627628,0.175675676,12246
0251884d11a18ea691792a5df03849fed214861f,0,Dimuthu Wannipurage,2019-04-30 09:25:04-04:00,['a89811f009376d10f7634e418dbf427f7668f96c'],656,0,656,18092490,6,,,,12246
62c01825a2ad570b6ab910ed24d8d71deba48643,0,Dimuthu Wannipurage,2019-04-30 14:19:30-04:00,['0251884d11a18ea691792a5df03849fed214861f'],932,969,1901,18094391,79,,,,12251
69e1f794bfe094b4fdef7c3487fadb78acb15468,0,Dimuthu Wannipurage,2019-04-30 14:26:51-04:00,['62c01825a2ad570b6ab910ed24d8d71deba48643'],1171,0,1171,18095562,10,0.642411642,0.230769231,0.27027027,12251
6a247f431c022facd8386cae1672dcd6c6a2b8e3,0,Dimuthu Wannipurage,2019-04-30 14:37:22-04:00,['69e1f794bfe094b4fdef7c3487fadb78acb15468'],16,0,16,18095578,1,,,,12251
565f512b0603e9cf58dcd62e9801514398d4fc35,0,Dimuthu Wannipurage,2019-04-30 15:16:09-04:00,['6a247f431c022facd8386cae1672dcd6c6a2b8e3'],6,6,12,18095590,1,,,,12251
c15418f19c6273a2379d4b12678fe26009b27b92,0,Dimuthu Wannipurage,2019-04-30 15:27:49-04:00,['565f512b0603e9cf58dcd62e9801514398d4fc35'],25,25,50,18095640,1,,,,12251
1b2e96ab76ddff2ce0648aaf345375bd814797c6,0,Dimuthu Wannipurage,2019-04-30 15:40:04-04:00,['c15418f19c6273a2379d4b12678fe26009b27b92'],143,10,153,18095793,7,,,,12251
2d1bdb5ef8676476cb0f3dfeee8c71fea91d567b,0,GitHub,2019-05-01 01:27:46-04:00,['1b2e96ab76ddff2ce0648aaf345375bd814797c6'],0,3,3,18095796,1,,,,12251
693495ed635db3d74f34863f4c930765b14caf23,0,GitHub,2019-05-01 01:28:54-04:00,['2d1bdb5ef8676476cb0f3dfeee8c71fea91d567b'],0,0,0,18095796,1,,,,12251
82c57c7d637be78a16ab4f954a54ce70d56e2f12,0,Dimuthu Wannipurage,2019-05-01 14:29:35-04:00,['693495ed635db3d74f34863f4c930765b14caf23'],9511,5920,15431,18111227,208,0.470374849,0.380088674,0.012091898,12256
55b3dd6b9f958871288be7db482a885b41c09503,0,Dimuthu Wannipurage,2019-05-01 14:59:00-04:00,['82c57c7d637be78a16ab4f954a54ce70d56e2f12'],2413,66,2479,18113706,17,0.4,0.331677019,0.021118012,12256
6e890978803063fe000797f0d53186ca6eb33279,0,Eroma Abeysinghe,2019-05-02 12:34:13-04:00,['55b3dd6b9f958871288be7db482a885b41c09503'],4,4,8,18113714,1,,,,12256
feea5203dfb4fdd70caa994794b9bbb15b2ccd8d,0,Dimuthu Wannipurage,2019-05-02 13:53:57-04:00,['6e890978803063fe000797f0d53186ca6eb33279'],760,663,1423,18115137,31,0,0,0,12257
26d3f1a668adf9d069a46f434d461cea4eb23490,1,Dimuthu Wannipurage,2019-05-02 13:55:48-04:00,['feea5203dfb4fdd70caa994794b9bbb15b2ccd8d'],8,23,31,18115168,2,0,1,1,12257
5a4088d2ad0e1abf67eaf34ce37a61411a2e1283,0,Dimuthu Wannipurage,2019-05-02 14:50:27-04:00,['26d3f1a668adf9d069a46f434d461cea4eb23490'],207,207,414,18115582,7,,,,12257
6c24083d5eb144f9e61aa98d638a54faa10cecd9,0,Dimuthu Wannipurage,2019-05-02 15:36:37-04:00,['5a4088d2ad0e1abf67eaf34ce37a61411a2e1283'],0,7,7,18115589,7,,,,12257
52b57c43642b51073af85a0927e349077e18248d,0,Dimuthu Wannipurage,2019-05-02 16:13:14-04:00,['6c24083d5eb144f9e61aa98d638a54faa10cecd9'],5,5,10,18115599,5,,,,12257
b933d963904e2dc3d56b5db6640b8d4cf4cea3dc,0,Dimuthu Wannipurage,2019-05-02 16:32:13-04:00,['52b57c43642b51073af85a0927e349077e18248d'],4,15,19,18115618,1,0,1,0.727272727,12257
a6045664bb2d4260aea7f6919ed7b32b5116131a,0,Dimuthu Wannipurage,2019-05-02 16:33:56-04:00,['b933d963904e2dc3d56b5db6640b8d4cf4cea3dc'],2,2,4,18115622,1,0,1,1,12257
e5efd8bee371ee87a267530fae642187fe26a853,0,Eroma Abeysinghe,2019-05-02 16:47:23-04:00,['a6045664bb2d4260aea7f6919ed7b32b5116131a'],2,2,4,18115626,1,,,,12257
88b8047b2dca73fea3b01bfc01f642537f15f1cc,0,Dimuthu Wannipurage,2019-05-03 11:37:56-04:00,['e5efd8bee371ee87a267530fae642187fe26a853'],13,25,38,18115664,1,0,0,0,12257
3f84f165e4e6818ca4950c0eb402674a6eb543af,0,Marcus Christie,2019-05-03 11:53:58-04:00,['88b8047b2dca73fea3b01bfc01f642537f15f1cc'],52,116,168,18115832,7,,,,12260
8183162556fcfb1ce81257d60f989d4cbbadd911,0,Dimuthu Wannipurage,2019-05-03 12:31:03-04:00,['3f84f165e4e6818ca4950c0eb402674a6eb543af'],0,176,176,18116008,8,,,,12260
d3dfda6cce89a6433b18b4080bd6d1a0d605183b,0,Marcus Christie,2019-05-03 16:47:03-04:00,['8183162556fcfb1ce81257d60f989d4cbbadd911'],17,1047,1064,18117072,15,,,,12274
acb1740c56dc9bf41fc3d001c74734dd350eeaf6,0,Dimuthu Wannipurage,2019-05-03 23:41:59-04:00,['d3dfda6cce89a6433b18b4080bd6d1a0d605183b'],53,45,98,18117170,4,,,,12274
89862771c2b7d2ad6723e290fca4e760e928de9c,0,Dimuthu Wannipurage,2019-05-06 12:27:39-04:00,['acb1740c56dc9bf41fc3d001c74734dd350eeaf6'],1,1,2,18117172,1,,,,12274
08b45863393d1184935d18a83a8596af5d5c3b05,0,Marcus Christie,2019-05-06 16:53:02-04:00,['828d331d253609db4c0833e323e57020b189169a'],12,115,127,18117299,4,0.254237288,0.728813559,1,12275
4b37a174d184e9c8759a79792377ecc35ef7b7c3,0,Eroma Abeysinghe,2019-05-07 12:39:41-04:00,['89862771c2b7d2ad6723e290fca4e760e928de9c'],1,1,2,18117301,1,,,,12275
581ea395060535f2084931423370c8afdff70c93,0,Marcus Christie,2019-05-07 13:12:04-04:00,['08b45863393d1184935d18a83a8596af5d5c3b05'],1,1,2,18117303,1,,,,12275
e6ad21ff3c765ec904fb97f737a4ccb6f43beaf5,0,Marcus Christie,2019-05-07 16:43:53-04:00,['4b37a174d184e9c8759a79792377ecc35ef7b7c3'],0,1,1,18117304,1,,,,12275
660d5dd73a516301ff99a45aea7538ade0b36778,0,Marcus Christie,2019-05-08 09:36:44-04:00,['581ea395060535f2084931423370c8afdff70c93'],0,7,7,18117311,1,0,0,0,12275
44d176ad8e5b9745401d1aef788d384eadb73bc6,0,Marcus Christie,2019-05-08 12:28:04-04:00,['660d5dd73a516301ff99a45aea7538ade0b36778'],7,13,20,18117331,1,0,0,0,12275
5e16505667a2209e93949e0f8a41a84c69d31fa8,1,Marcus Christie,2019-05-09 09:45:53-04:00,['44d176ad8e5b9745401d1aef788d384eadb73bc6'],22668,29609,52277,18169608,16,0.43587271,0.485824494,0.913596914,12275
1a308370fccec5f042e94b09b6086d7a5c310045,0,Marcus Christie,2019-05-09 11:34:38-04:00,['5e16505667a2209e93949e0f8a41a84c69d31fa8'],1,3,4,18169612,2,0,1,1,12275
fb22ba7eb11d97ed8b05b748db16f7ed4ff3c2fc,1,Eroma Abeysinghe,2019-05-10 12:44:49-04:00,['1a308370fccec5f042e94b09b6086d7a5c310045'],0,54,54,18169666,1,,,,12276
a5ebfda27ff0a187f94ee785fd25bb5cbf45f4c7,0,Eroma Abeysinghe,2019-05-10 12:48:06-04:00,['fb22ba7eb11d97ed8b05b748db16f7ed4ff3c2fc'],0,15,15,18169681,1,,,,12277
d3170c74c8da15728849474b53fab298ae04a5bd,0,Eroma Abeysinghe,2019-05-10 12:49:12-04:00,['a5ebfda27ff0a187f94ee785fd25bb5cbf45f4c7'],0,1,1,18169682,1,,,,12277
b6ff4477390ef97b719eb3f03e0967841c1c511e,0,Eroma Abeysinghe,2019-05-10 14:52:04-04:00,['d3170c74c8da15728849474b53fab298ae04a5bd'],4,4,8,18169690,1,,,,12277
7e1d84cf4271321fa7a5c8cfe8e7778398e21054,0,Marcus Christie,2019-05-13 09:50:13-04:00,['b6ff4477390ef97b719eb3f03e0967841c1c511e'],1,21,22,18169712,2,1,1,1,12277
c788ac0237a7e0ff9f3065a03f1c7f126149c442,0,Eroma Abeysinghe,2019-05-13 12:11:31-04:00,['7e1d84cf4271321fa7a5c8cfe8e7778398e21054'],2,2,4,18169716,1,,,,12277
5317fcc2acdf2f69164918c1a84ee1f22c6867e5,0,Eroma Abeysinghe,2019-05-16 15:59:08-04:00,['e6ad21ff3c765ec904fb97f737a4ccb6f43beaf5'],0,3,3,18169719,1,,,,12277
6e8d5d31d16e92e20d36f8ec302a213ac3d040b2,0,Shivam Rastogi,2019-05-21 14:46:27-04:00,['c788ac0237a7e0ff9f3065a03f1c7f126149c442'],5,16,21,18169740,2,,,,12277
c413e1a54f93f9f1a1c0d411ab1b0ee1f0512f87,0,GitHub,2019-05-21 15:18:05-04:00,"['c788ac0237a7e0ff9f3065a03f1c7f126149c442', '6e8d5d31d16e92e20d36f8ec302a213ac3d040b2']",5,16,21,18169761,2,,,,12277
879b1f68313bfa265e6d922af6e43ca74fa42ea3,0,Shivam Rastogi,2019-05-21 19:51:02-04:00,['6e8d5d31d16e92e20d36f8ec302a213ac3d040b2'],1,1,2,18169763,1,,,,12277
855584603413eb1e69e91978451bad7ab902ed5c,0,GitHub,2019-05-21 22:23:12-04:00,"['c413e1a54f93f9f1a1c0d411ab1b0ee1f0512f87', '879b1f68313bfa265e6d922af6e43ca74fa42ea3']",1,1,2,18169765,1,,,,12277
bdea66097756a85250a74055797e6ee34839df4f,0,Shivam Rastogi,2019-05-24 16:34:47-04:00,['879b1f68313bfa265e6d922af6e43ca74fa42ea3'],1,28,29,18169794,6,0,0,0.142857143,12277
36538aae6b8eab0c700e5bce03f85e6c70f22b1e,0,Shivam Rastogi,2019-05-24 19:37:20-04:00,['bdea66097756a85250a74055797e6ee34839df4f'],40,174,214,18170008,5,0.28,0.28,0.9,12277
afb4b1c7a47ba6e3fbfc0d88c542fff911d95d19,0,Shivam Rastogi,2019-05-26 14:37:59-04:00,['bdea66097756a85250a74055797e6ee34839df4f'],40,174,214,18170222,5,0.28,0.28,0.9,12277
880a5068e62ba99b52d32d0b759bd8ba9b216104,0,Shivam Rastogi,2019-05-26 14:39:11-04:00,"['afb4b1c7a47ba6e3fbfc0d88c542fff911d95d19', '36538aae6b8eab0c700e5bce03f85e6c70f22b1e']",0,0,0,18170222,0,,,,12277
db54643e0cb9a6be30625f5c3dd4129293767593,0,Dimuthu Wannipurage,2019-05-26 22:48:39-04:00,['5317fcc2acdf2f69164918c1a84ee1f22c6867e5'],1,4,5,18170227,1,0,1,1,12277
c9e0509c974cf907ba2f77d56568eb142a1a4900,0,Marcus Christie,2019-05-28 10:42:19-04:00,['855584603413eb1e69e91978451bad7ab902ed5c'],138,1654,1792,18172019,5,0.494283201,0.569920844,0.925241865,12277
ddf94882aae1c546939b7ce39a95e7698696ad3d,0,Shivam Rastogi,2019-05-28 10:55:19-04:00,['880a5068e62ba99b52d32d0b759bd8ba9b216104'],44,30,74,18172093,4,1,1,0.1,12277
cb857a2482e1a483bb75a3dde46fc51aa7986f99,0,Marcus Christie,2019-05-28 16:50:52-04:00,['c9e0509c974cf907ba2f77d56568eb142a1a4900'],1,1,2,18172095,1,,,,12277
d51e9895b868789c7ad4a1d827e5e921553fe043,0,Shivam Rastogi,2019-05-30 11:01:24-04:00,['ddf94882aae1c546939b7ce39a95e7698696ad3d'],1,1,2,18172097,1,,,,12277
927bb1de84793895b5c9f780ed4c0605853926e1,0,Aarushi,2019-05-30 14:49:07-04:00,['855584603413eb1e69e91978451bad7ab902ed5c'],2,2,4,18172101,2,,,,12277
74ab3d4641b9aa12cfda08aa7158203dbeae3c22,0,Eroma Abeysinghe,2019-05-31 10:28:02-04:00,['db54643e0cb9a6be30625f5c3dd4129293767593'],0,113,113,18172214,3,,,,12280
082ce823c3e70bba2a0e8df5ef969ed9493c9c7c,0,Eroma Abeysinghe,2019-05-31 10:39:50-04:00,['74ab3d4641b9aa12cfda08aa7158203dbeae3c22'],46,41,87,18172301,2,,,,12280
449da41bee5edb930a060320fa767e7509e6d3e4,0,Eroma Abeysinghe,2019-05-31 11:03:46-04:00,['082ce823c3e70bba2a0e8df5ef969ed9493c9c7c'],7,7,14,18172315,1,,,,12280
7b69ce41353642a7edd612f0ae255945f46ba2fc,0,Eroma Abeysinghe,2019-05-31 11:16:24-04:00,['449da41bee5edb930a060320fa767e7509e6d3e4'],0,0,0,18172315,3,,,,12280
fdb2800aff3988b508f9d4a526be0d825002745b,0,Marcus Christie,2019-05-31 12:30:51-04:00,['7b69ce41353642a7edd612f0ae255945f46ba2fc'],0,8,8,18172323,1,,,,12280
c7cea7cfc8e3b85a836839d17e71cc8bdb05f03f,0,Eroma Abeysinghe,2019-05-31 13:25:49-04:00,['fdb2800aff3988b508f9d4a526be0d825002745b'],5,5,10,18172333,1,,,,12280
f1ac254f6ecda4c6d2d68c639e4836ddc329fa21,0,Eroma Abeysinghe,2019-05-31 14:44:24-04:00,['c7cea7cfc8e3b85a836839d17e71cc8bdb05f03f'],1,1,2,18172335,1,,,,12280
99bfa251cec6123b959693e931ac14beaf065481,0,Eroma Abeysinghe,2019-05-31 15:02:17-04:00,['f1ac254f6ecda4c6d2d68c639e4836ddc329fa21'],1,1,2,18172337,1,,,,12280
66475a5238d99669806555c00195655758ab1d08,0,Eroma Abeysinghe,2019-05-31 15:23:32-04:00,['99bfa251cec6123b959693e931ac14beaf065481'],1,1,2,18172339,1,,,,12280
9bbb9f3bce4ab8e96cca409bed561d77edc634a9,0,Eroma Abeysinghe,2019-06-01 01:20:18-04:00,['66475a5238d99669806555c00195655758ab1d08'],2,3,5,18172344,1,,,,12280
edeb5243d2acc328f24a55d50a365c35fabe2e77,0,Dimuthu Wannipurage,2019-06-02 10:40:16-04:00,['9bbb9f3bce4ab8e96cca409bed561d77edc634a9'],5,46,51,18172395,1,,,,12280
de97222f7578e564c75a0b2707a21a6bd46dbbec,0,Suresh Marru,2019-06-02 11:14:48-04:00,['edeb5243d2acc328f24a55d50a365c35fabe2e77'],21,3169,3190,18175585,72,,,,12349
28348fd6fca5ef53badaf16ce5d89cf01090c5d3,0,Suresh Marru,2019-06-02 11:51:50-04:00,['de97222f7578e564c75a0b2707a21a6bd46dbbec'],107,64,171,18175756,8,,,,12350
b1221487e29c0db2c75f859e92e55a9c87d9ab40,0,Marcus Christie,2019-06-02 12:09:47-04:00,['28348fd6fca5ef53badaf16ce5d89cf01090c5d3'],36,1,37,18175793,37,,,,12350
c6f75b173e3374786c55a6ffefbbbbf017252c2b,0,Marcus Christie,2019-06-02 12:14:56-04:00,['b1221487e29c0db2c75f859e92e55a9c87d9ab40'],1,1,2,18175795,1,,,,12350
c2b14bddd8cc31be5241d63f1fec52f9f7e43418,0,Marcus Christie,2019-06-02 12:19:03-04:00,['c6f75b173e3374786c55a6ffefbbbbf017252c2b'],1,1,2,18175797,1,,,,12350
db9945cfe9eca6a8431eea4a1e50ffacc973f15d,0,Dimuthu Wannipurage,2019-06-02 12:22:57-04:00,['c2b14bddd8cc31be5241d63f1fec52f9f7e43418'],3,3,6,18175803,1,,,,12350
d52effcfccda596da9ad8978b81088b879b7f823,0,Dimuthu Wannipurage,2019-06-02 12:23:19-04:00,['db9945cfe9eca6a8431eea4a1e50ffacc973f15d'],2,2,4,18175807,1,,,,12350
63692955d6dfbf6385bd429f6d203bf07cd2a8aa,0,Marcus Christie,2019-06-02 13:29:37-04:00,['d52effcfccda596da9ad8978b81088b879b7f823'],7,10,17,18175824,2,,,,12350
ba0f3e5eb49e068533fdd8c9ce1aecb9115c7096,0,Dimuthu Wannipurage,2019-06-02 14:04:51-04:00,['63692955d6dfbf6385bd429f6d203bf07cd2a8aa'],0,11,11,18175835,2,0.857142857,0.857142857,1,12350
1e79caca9c5791046d8befc0101174e1c76870d4,0,Dimuthu Wannipurage,2019-06-02 14:07:56-04:00,['ba0f3e5eb49e068533fdd8c9ce1aecb9115c7096'],36,35,71,18175906,2,,,,12350
8b765356c6f59318cec1dffe66e16d4a4ec85240,0,Marcus Christie,2019-06-02 14:40:51-04:00,['1e79caca9c5791046d8befc0101174e1c76870d4'],1,1,2,18175908,1,,,,12350
a73327325ac4b6cf4ff88e7ef1c33c2fc9999776,0,Marcus Christie,2019-06-02 16:15:35-04:00,['8b765356c6f59318cec1dffe66e16d4a4ec85240'],12,18,30,18175938,2,,,,12350
ac87e338fb3b53b507ac8666c35bab8bc4a468e8,0,Suresh Marru,2019-06-02 17:01:50-04:00,['a73327325ac4b6cf4ff88e7ef1c33c2fc9999776'],3,3,6,18175944,1,,,,12350
edd4246e4ebef13df643c1dc21af0c442d62ab0f,0,Dimuthu Wannipurage,2019-06-02 17:06:08-04:00,['ac87e338fb3b53b507ac8666c35bab8bc4a468e8'],0,16,16,18175960,1,0,0,0,12350
4fe013c389a8dc1ff77ab8eb2dc07f657a865a14,0,Dimuthu Wannipurage,2019-06-02 18:25:55-04:00,['edd4246e4ebef13df643c1dc21af0c442d62ab0f'],11,23,34,18175994,2,0,0,1,12350
d4a209d042dd36fe9f86a706e783c3c3ee8a6ec8,0,Dimuthu Wannipurage,2019-06-02 20:25:22-04:00,['4fe013c389a8dc1ff77ab8eb2dc07f657a865a14'],7,6,13,18176007,1,1,1,0,12350
34f2e831b2e90f3024d188dad91124fbec033886,0,Dimuthu Wannipurage,2019-06-02 22:06:03-04:00,['d4a209d042dd36fe9f86a706e783c3c3ee8a6ec8'],0,114,114,18176121,3,0.029850746,0.029850746,0.880597015,12351
bce1bb51832e9dbab2cab6c66d7f2f397466c083,0,Suresh Marru,2019-06-02 22:57:17-04:00,['34f2e831b2e90f3024d188dad91124fbec033886'],5,5,10,18176131,1,,,,12351
6a437beead734879c49cfb91231091ac321a4c22,0,Suresh Marru,2019-06-02 23:04:18-04:00,['bce1bb51832e9dbab2cab6c66d7f2f397466c083'],1,1,2,18176133,1,,,,12351
2d5d3d5ccee68bdd0233b6835a23dac06cba54d8,0,Suresh Marru,2019-06-02 23:24:48-04:00,['6a437beead734879c49cfb91231091ac321a4c22'],13,12,25,18176158,3,,,,12351
c45222f979bf063214ce881ae835ebf69be9c5a9,0,Dimuthu Wannipurage,2019-06-03 00:48:14-04:00,['2d5d3d5ccee68bdd0233b6835a23dac06cba54d8'],1,6,7,18176165,1,0,0,1,12351
5013f656297a44088b4c577a2db108ce79d8882f,0,Dimuthu Wannipurage,2019-06-03 01:12:35-04:00,['c45222f979bf063214ce881ae835ebf69be9c5a9'],0,4,4,18176169,1,0,0,0,12351
89c82f2512eff036b64158d673b76e9ef2538274,0,Marcus Christie,2019-06-03 08:48:52-04:00,['cb857a2482e1a483bb75a3dde46fc51aa7986f99'],1,1,2,18176171,1,,,,12351
d7dd5a8b1d81d1e086d32e7598822e365170a98a,0,Suresh Marru,2019-06-03 09:22:48-04:00,['5013f656297a44088b4c577a2db108ce79d8882f'],12,12,24,18176195,4,,,,12351
c91e5dc94b729cdef7ddb3329856bec87114fbc9,0,Dimuthu Wannipurage,2019-06-03 10:54:41-04:00,['d7dd5a8b1d81d1e086d32e7598822e365170a98a'],2,5,7,18176202,2,0,0,0.666666667,12351
f8529a92d854f9b14bd25e65e6b6789a8512af48,0,Dimuthu Wannipurage,2019-06-03 12:35:58-04:00,['c91e5dc94b729cdef7ddb3329856bec87114fbc9'],51,64,115,18176317,1,0,1,0,12351
f3ec14118bc78671387f404d8de0b3bb06cd290b,0,Marcus Christie,2019-06-03 12:39:19-04:00,['89c82f2512eff036b64158d673b76e9ef2538274'],1,3,4,18176321,1,0,1,1,12351
4ec7a7c6defe1f627e48b130f9ce2b562989eefc,0,Dimuthu Wannipurage,2019-06-03 14:42:27-04:00,['f8529a92d854f9b14bd25e65e6b6789a8512af48'],0,3,3,18176324,1,0.666666667,0.666666667,1,12351
d9228e1540d767df77a3600246b7a6c0fbb86a6b,0,Dimuthu Wannipurage,2019-06-03 15:26:43-04:00,['4ec7a7c6defe1f627e48b130f9ce2b562989eefc'],10,10,20,18176344,2,,,,12351
79eede4a50c23d2a630420d0ff0cdeb91c439ad8,0,GitHub,2019-06-04 15:46:03-04:00,"['f3ec14118bc78671387f404d8de0b3bb06cd290b', 'd51e9895b868789c7ad4a1d827e5e921553fe043']",41,188,229,18176573,12,,,,12351
649f7c2bfc4c923ab83572ad2c200fa1faafd34e,0,GitHub,2019-06-04 16:08:35-04:00,"['879b1f68313bfa265e6d922af6e43ca74fa42ea3', '79eede4a50c23d2a630420d0ff0cdeb91c439ad8']",182,1847,2029,18178602,18,,,,12351
85e3096c79d41772a807cd21c566c2826c55ca3e,0,Marcus Christie,2019-06-05 14:35:01-04:00,['d9228e1540d767df77a3600246b7a6c0fbb86a6b'],1,1,2,18178604,1,,,,12351
d0cf5f25e3cedd67fb9f28dc5f3a3985be00561b,0,Aarushi,2019-06-05 15:07:06-04:00,['927bb1de84793895b5c9f780ed4c0605853926e1'],12,1,13,18178617,2,1,0,0,12351
a630b7337b2a667b80fbcab6dbc9db9058821f09,0,GitHub,2019-06-05 17:17:56-04:00,"['79eede4a50c23d2a630420d0ff0cdeb91c439ad8', 'd0cf5f25e3cedd67fb9f28dc5f3a3985be00561b']",12,1,13,18178630,2,,,,12351
ca7e3d54eb9563da76b018184bfb9e1009dbd9e9,0,Dimuthu Wannipurage,2019-06-05 19:04:30-04:00,['85e3096c79d41772a807cd21c566c2826c55ca3e'],0,2,2,18178632,1,0,1,0,12351
1ab8b73acc69043536239cb0b909859f6fe0eb6a,0,Dimuthu Wannipurage,2019-06-05 19:04:58-04:00,['ca7e3d54eb9563da76b018184bfb9e1009dbd9e9'],1,3,4,18178636,2,,,,12351
8c31d035068a711e18e0e0b619f017296948a810,0,Marcus Christie,2019-06-06 14:16:08-04:00,['1ab8b73acc69043536239cb0b909859f6fe0eb6a'],5630,104,5734,18184370,150,,,,12351
67ba55886a85f144565298f1857b92ee0768fef2,1,Eroma Abeysinghe,2019-06-06 16:54:53-04:00,['a630b7337b2a667b80fbcab6dbc9db9058821f09'],0,69,69,18184439,2,,,,12353
10dde8a1a0a7a18b3653faa08a2001a85e087cca,0,Eroma Abeysinghe,2019-06-07 00:47:40-04:00,['67ba55886a85f144565298f1857b92ee0768fef2'],11,11,22,18184461,1,,,,12353
78c760db09fc90a3480fc2dee11dfda626cb5f7f,0,Eroma Abeysinghe,2019-06-07 00:51:52-04:00,['10dde8a1a0a7a18b3653faa08a2001a85e087cca'],14,14,28,18184489,1,,,,12353
aaca2ace1f0a7bc9e39ebc1210a93d0e31798f1c,0,Eroma Abeysinghe,2019-06-07 00:53:07-04:00,['78c760db09fc90a3480fc2dee11dfda626cb5f7f'],0,1,1,18184490,1,,,,12353
f86fb8943ee1df778e024290b00dc36613161e48,0,Eroma Abeysinghe,2019-06-07 03:38:09-04:00,['aaca2ace1f0a7bc9e39ebc1210a93d0e31798f1c'],2,2,4,18184494,1,,,,12353
bee0ee998707a1b2fe1e3aac2182f22e0941d755,0,Marcus Christie,2019-06-07 09:26:24-04:00,['f86fb8943ee1df778e024290b00dc36613161e48'],11,2,13,18184507,11,,,,12353
caaf77d30cbaed199529276983685bde41a0e7b5,0,Marcus Christie,2019-06-07 09:30:06-04:00,['bee0ee998707a1b2fe1e3aac2182f22e0941d755'],9,1,10,18184517,10,,,,12353
cc35ce9b49c94c921e0c6c4d95ac75b41a6515f0,0,Dimuthu Wannipurage,2019-06-07 10:06:01-04:00,['8c31d035068a711e18e0e0b619f017296948a810'],1,7,8,18184525,3,,,,12353
b49e9c819a5abbd6e686a480dbc9c176b95e190e,1,Marcus Christie,2019-06-07 14:25:03-04:00,"['caaf77d30cbaed199529276983685bde41a0e7b5', '8c31d035068a711e18e0e0b619f017296948a810']",260245,28218,288463,18472988,1770,,,,12353
6fd748508536d5444f8ba59998e59527b6592a51,0,Marcus Christie,2019-06-07 17:03:48-04:00,['b49e9c819a5abbd6e686a480dbc9c176b95e190e'],1,1,2,18472990,1,,,,12353
8bdbdfcb3c9521fd6a5f90ba9e95f8d2647fe9b2,1,Marcus Christie,2019-06-10 14:45:53-04:00,['6fd748508536d5444f8ba59998e59527b6592a51'],8,196,204,18473194,14,0.304964539,0.319148936,0.992907801,12353
cf7d67137e2b1d1d44593fdfdc2c0504d76518ee,0,Marcus Christie,2019-06-10 14:58:09-04:00,['8bdbdfcb3c9521fd6a5f90ba9e95f8d2647fe9b2'],3,3,6,18473200,1,,,,12353
bf3c1a8809c287d35cdb3569188a10478793d2d5,0,Marcus Christie,2019-06-10 15:55:17-04:00,['cf7d67137e2b1d1d44593fdfdc2c0504d76518ee'],589,490,1079,18474279,20,0,0,0,12353
6c41f4fbaa349d05aba4e249c2ca5d8ef3250407,0,Marcus Christie,2019-06-11 08:59:32-04:00,['bf3c1a8809c287d35cdb3569188a10478793d2d5'],94,100,194,18474473,5,0.666666667,0.666666667,0.333333333,12353
726c3b171407fc524efb9bca6335f179f303bae3,0,Marcus Christie,2019-06-11 09:48:26-04:00,['6c41f4fbaa349d05aba4e249c2ca5d8ef3250407'],107,107,214,18474687,2,,,,12353
bc733d9447c53fa95ac8dc006237e26cb1fa01bf,0,Marcus Christie,2019-06-11 11:33:04-04:00,['726c3b171407fc524efb9bca6335f179f303bae3'],1,1,2,18474689,1,,,,12353
ef395df0de4ad1b2a1cdff63e005a7fa14894539,0,Marcus Christie,2019-06-11 12:10:38-04:00,['bc733d9447c53fa95ac8dc006237e26cb1fa01bf'],1,1,2,18474691,1,,,,12353
e1e6bf872903c5226e579ee9a993f2d2c712a363,0,Marcus Christie,2019-06-11 17:08:44-04:00,['ef395df0de4ad1b2a1cdff63e005a7fa14894539'],5,10,15,18474706,2,1,0,0,12353
417f68a7cdec3f25dcf32cc0ced6c1b7d692606d,0,Marcus Christie,2019-06-12 09:34:02-04:00,['e1e6bf872903c5226e579ee9a993f2d2c712a363'],3,0,3,18474709,1,,,,12353
dd51fc64bfef30cbd8bfebf4759c9ae4b4156e35,0,Marcus Christie,2019-06-12 10:19:39-04:00,['417f68a7cdec3f25dcf32cc0ced6c1b7d692606d'],3,3,6,18474715,1,1,0,0,12353
6234f4b225cdefab381e4f1bcdac2a603676e1f8,0,Marcus Christie,2019-06-12 16:37:29-04:00,['dd51fc64bfef30cbd8bfebf4759c9ae4b4156e35'],0,1,1,18474716,1,,,,12353
3fa3caab8b09c4d32f9af23847847d8f18f2cd26,0,Marcus Christie,2019-06-12 16:45:42-04:00,['6234f4b225cdefab381e4f1bcdac2a603676e1f8'],2,0,2,18474718,1,,,,12353
04fc4182aab37c7eaad7f118dd82eed4ecb17807,0,Dimuthu Wannipurage,2019-06-13 11:51:04-04:00,['3fa3caab8b09c4d32f9af23847847d8f18f2cd26'],1,1,2,18474720,1,,,,12353
455adefc58472e93beffad5b2efcc360a2f2654a,0,Dimuthu Wannipurage,2019-06-13 11:51:42-04:00,['04fc4182aab37c7eaad7f118dd82eed4ecb17807'],0,191,191,18474911,3,,,,12354
e2b653d3ee1e0afb1d78c743bbd24f49dc5f01ca,0,Dimuthu Wannipurage,2019-06-13 16:21:49-04:00,['455adefc58472e93beffad5b2efcc360a2f2654a'],0,5,5,18474916,1,,,,12354
3280ee597a60b0009c147f0446547de8473ac383,0,Dimuthu Wannipurage,2019-06-13 16:22:36-04:00,['e2b653d3ee1e0afb1d78c743bbd24f49dc5f01ca'],0,1,1,18474917,1,,,,12354
e1de154549afa9baf57294c001c2c8bc53bdde4f,0,Dimuthu Wannipurage,2019-06-13 16:25:27-04:00,['3280ee597a60b0009c147f0446547de8473ac383'],68,107,175,18475092,5,0.916666667,1,1,12355
57a3c60fabc77e8ffdf3efaf6a28c430869f9da8,0,Eroma Abeysinghe,2019-06-13 16:39:48-04:00,['85e3096c79d41772a807cd21c566c2826c55ca3e'],1,2,3,18475095,1,,,,12355
ae6a4e2c2432a20f8c83a148c8d8e6486dbd8af2,0,Eroma Abeysinghe,2019-06-13 16:42:38-04:00,"['57a3c60fabc77e8ffdf3efaf6a28c430869f9da8', 'cc35ce9b49c94c921e0c6c4d95ac75b41a6515f0']",5632,116,5748,18480843,155,,,,12355
669032b5fa725f7a17ac147f00bade495ecf9ce5,0,Eroma Abeysinghe,2019-06-13 16:43:41-04:00,['ae6a4e2c2432a20f8c83a148c8d8e6486dbd8af2'],1,1,2,18480845,1,,,,12355
6c574ac7235b6c84df591319eeb9a656426b5d0e,0,Eroma Abeysinghe,2019-06-13 16:44:54-04:00,['669032b5fa725f7a17ac147f00bade495ecf9ce5'],1,1,2,18480847,1,,,,12355
eae9e329b68d165ad62f9b25af36f47f677e9789,0,Eroma Abeysinghe,2019-06-13 16:51:44-04:00,['6c574ac7235b6c84df591319eeb9a656426b5d0e'],4,4,8,18480855,1,,,,12355
a5f5b217dce64b2d203e8582fd35c3ec69b03ee8,0,Marcus Christie,2019-06-17 11:11:53-04:00,['e1de154549afa9baf57294c001c2c8bc53bdde4f'],32,34,66,18480921,2,,,,12355
69205a1eaf946a53bb4a021a09d4207d959535cf,0,Marcus Christie,2019-06-17 11:16:12-04:00,['a5f5b217dce64b2d203e8582fd35c3ec69b03ee8'],16,1512,1528,18482449,7,0.487202925,0.638939671,0.911334552,12355
4116b4755cc3b7dc6bb9f6cc3eb047201d81d6a7,0,Marcus Christie,2019-06-17 11:17:33-04:00,['69205a1eaf946a53bb4a021a09d4207d959535cf'],226,240,466,18482915,15,,,,12355
4e986b5d5a5f2233eab2181a2b1ef1483946a294,0,Marcus Christie,2019-06-17 12:08:16-04:00,['4116b4755cc3b7dc6bb9f6cc3eb047201d81d6a7'],998,1197,2195,18485110,6,0.220238095,0.148809524,0.80952381,12355
92a2d1913f8664a5e274774c4e4eaef23d440bca,0,Marcus Christie,2019-06-17 15:58:10-04:00,['4e986b5d5a5f2233eab2181a2b1ef1483946a294'],1,8,9,18485119,3,,,,12355
1a3b1928c883a546fe176a5846c775f6f38276cd,1,Aarushi,2019-06-19 10:28:55-04:00,['e1de154549afa9baf57294c001c2c8bc53bdde4f'],10,76,86,18485205,4,0.032786885,0,0.344262295,12355
20d32a30c655768f5661877b0dea895c4ff157a2,0,Aarushi,2019-06-19 12:24:50-04:00,['1a3b1928c883a546fe176a5846c775f6f38276cd'],2,2,4,18485209,1,,,,12355
6299ac39e9f05072d440d8b29890be6004028508,1,Dimuthu Wannipurage,2019-06-19 16:30:39-04:00,['92a2d1913f8664a5e274774c4e4eaef23d440bca'],1,84,85,18485294,6,0.511627907,0.88372093,1,12355
ee4255bd7226fd24a04ed4edee80e5620009fa82,0,Dimuthu Wannipurage,2019-06-19 22:46:06-04:00,['6299ac39e9f05072d440d8b29890be6004028508'],0,1,1,18485295,1,1,1,1,12355
ca6a54f5f8c503368c25d95d1405529f3de8869d,0,Dimuthu Wannipurage,2019-06-20 13:59:41-04:00,['eae9e329b68d165ad62f9b25af36f47f677e9789'],7,193,200,18485495,9,0.556521739,0.956521739,0.756521739,12355
aa19cb3a2a06425b6072b447c4b1666ba7428b35,0,Eroma Abeysinghe,2019-06-21 10:46:16-04:00,['ca6a54f5f8c503368c25d95d1405529f3de8869d'],0,3,3,18485498,1,,,,12355
bf14d82f642b549d6c5087934ad2a0e4d6a77970,1,GitHub,2019-06-23 23:08:00-04:00,['20d32a30c655768f5661877b0dea895c4ff157a2'],1,1,2,18485500,1,,,,12355
82bbd1a95e733d0184ffc7150345db4ecf3a442c,0,Aarushi,2019-06-24 10:19:58-04:00,['20d32a30c655768f5661877b0dea895c4ff157a2'],1,1,2,18485502,1,,,,12355
846e2928ae31a29387695785a2a2af0b4a71a5ae,0,Aarushi,2019-06-24 10:20:22-04:00,"['82bbd1a95e733d0184ffc7150345db4ecf3a442c', 'bf14d82f642b549d6c5087934ad2a0e4d6a77970']",1,1,2,18485504,1,,,,12355
95df57711e033f52b38541083f802b45b1b4650b,0,Aarushi,2019-06-24 15:55:45-04:00,['846e2928ae31a29387695785a2a2af0b4a71a5ae'],0,1,1,18485505,1,0,0,0,12355
9903c9ef5f8e2005c2845a254e5cdc5b42aad030,0,Marcus Christie,2019-06-25 09:48:37-04:00,['ee4255bd7226fd24a04ed4edee80e5620009fa82'],15,15,30,18485535,7,,,,12355
dece907c14813c9f07b5bc913727998385349aba,0,Marcus Christie,2019-06-25 10:58:05-04:00,['9903c9ef5f8e2005c2845a254e5cdc5b42aad030'],1,8,9,18485544,3,,,,12355
52343660c3d725df751a1fba236c1f9717ca3702,0,Marcus Christie,2019-06-25 11:04:34-04:00,['dece907c14813c9f07b5bc913727998385349aba'],0,2,2,18485546,1,,,,12355
9f41548a2624c8870edf2ddb12accb7b3404ca4e,0,Shivam Rastogi,2019-06-25 12:34:00-04:00,"['52343660c3d725df751a1fba236c1f9717ca3702', '649f7c2bfc4c923ab83572ad2c200fa1faafd34e']",0,0,0,18485546,0,,,,12355
59b38b97774fb693ed1660a97b6d88af31698b7e,0,Shivam Rastogi,2019-06-25 12:47:24-04:00,['9f41548a2624c8870edf2ddb12accb7b3404ca4e'],32186,58181,90367,18575913,135,0.230690454,0.268528001,0.89252412,12375
24361724396b5cce238660fb92d70ba6ccf21c5e,0,Shivam Rastogi,2019-06-25 12:47:24-04:00,['59b38b97774fb693ed1660a97b6d88af31698b7e'],1,1,2,18575915,1,,,,12375
802381ed94f3261d38e64834788938c0157d9dcd,0,Shivam Rastogi,2019-06-25 12:47:25-04:00,['24361724396b5cce238660fb92d70ba6ccf21c5e'],1,75,76,18575991,3,0.102040816,0.428571429,1,12375
580a69304e5a5d323ba325f44d3ddac9928c867c,0,Shivam Rastogi,2019-06-25 12:47:25-04:00,['802381ed94f3261d38e64834788938c0157d9dcd'],0,0,0,18575991,1,,,,12375
987dc603a4d42ebdec0dd49562549fd8a21e9d75,0,Shivam Rastogi,2019-06-25 12:53:08-04:00,['580a69304e5a5d323ba325f44d3ddac9928c867c'],4,4,8,18575999,3,,,,12375
e53174c7216c89f3892449e3208e047d67d0dcd1,0,Shivam Rastogi,2019-06-25 13:08:45-04:00,['987dc603a4d42ebdec0dd49562549fd8a21e9d75'],989,1874,2863,18578862,21,0.312896406,0.756871036,1,12382
ae91f793b547bc90044e0347a13d70e880ad1754,0,GitHub,2019-06-25 14:33:31-04:00,"['52343660c3d725df751a1fba236c1f9717ca3702', 'e53174c7216c89f3892449e3208e047d67d0dcd1']",25817,52771,78588,18657450,149,,,,12382
5775302114677394b8a27d7da09e99569c475df0,0,Marcus Christie,2019-06-25 17:04:35-04:00,['ae91f793b547bc90044e0347a13d70e880ad1754'],1,1,2,18657452,1,,,,12382
3ff1492af38ef627efa7a32485ade6054ddf0f1b,0,Dimuthu Wannipurage,2019-06-26 09:35:08-04:00,['aa19cb3a2a06425b6072b447c4b1666ba7428b35'],0,24,24,18657476,2,0.9375,0.9375,0.9375,12382
a59afe31e2822284046313bb781789a44b6330ce,0,Dimuthu Wannipurage,2019-06-26 10:57:13-04:00,"['3ff1492af38ef627efa7a32485ade6054ddf0f1b', '5775302114677394b8a27d7da09e99569c475df0']",198704,538117,736821,19394297,1537,,,,12382
f86351435b07eef8a74dd4ec0457b3379780f033,0,Marcus Christie,2019-06-26 11:42:53-04:00,['a59afe31e2822284046313bb781789a44b6330ce'],0,169,169,19394466,1,,,,12382
9366175e93d758cbe4fc1864dba64ee1bcb75c7b,0,Marcus Christie,2019-06-26 11:53:15-04:00,['f86351435b07eef8a74dd4ec0457b3379780f033'],73,73,146,19394612,1,,,,12382
f915139137e4f1ee2edb48ada39470b3ad02287b,0,Marcus Christie,2019-06-26 14:07:40-04:00,['9366175e93d758cbe4fc1864dba64ee1bcb75c7b'],0,7,7,19394619,1,,,,12382
6b4f64f40bb9991cc6f6b1fb7f257950b862ae32,0,Marcus Christie,2019-06-26 14:12:10-04:00,['f915139137e4f1ee2edb48ada39470b3ad02287b'],2,2,4,19394623,1,,,,12382
b769e6da03f572d987925b20ec3577d141207f59,0,Marcus Christie,2019-06-26 14:32:32-04:00,['6b4f64f40bb9991cc6f6b1fb7f257950b862ae32'],16,21,37,19394660,2,,,,12382
a5d8242fc372a2577eef649d34f3cc44df7a5608,0,Marcus Christie,2019-06-26 14:35:44-04:00,['b769e6da03f572d987925b20ec3577d141207f59'],2,2,4,19394664,1,,,,12382
f75afb6ee8a533f992f1702ed76c387ba7fb8c4c,0,Marcus Christie,2019-06-26 14:41:45-04:00,['a5d8242fc372a2577eef649d34f3cc44df7a5608'],3,4,7,19394671,1,,,,12382
b8fbfb79d317ce4e0cbe65dd1bf8857539a3993a,0,Marcus Christie,2019-06-26 14:51:26-04:00,['f75afb6ee8a533f992f1702ed76c387ba7fb8c4c'],14,16,30,19394701,2,,,,12382
57b7f4d0af33b4876430de801f9eec09627c5bad,0,Marcus Christie,2019-06-26 14:58:22-04:00,['b8fbfb79d317ce4e0cbe65dd1bf8857539a3993a'],1,2,3,19394704,1,,,,12382
ea77eee0359fb9873b9f1e5861e11897dac08031,0,Dimuthu Wannipurage,2019-06-26 16:00:01-04:00,['57b7f4d0af33b4876430de801f9eec09627c5bad'],0,1,1,19394705,1,,,,12382
4a291c7a91910d83953e2fe60ff83a4086b7dec0,0,Marcus Christie,2019-06-26 16:31:23-04:00,['ea77eee0359fb9873b9f1e5861e11897dac08031'],7,3,10,19394715,1,1,0,1,12382
41274878383756fed383ac008f090c475d640185,0,Marcus Christie,2019-06-26 16:34:16-04:00,['4a291c7a91910d83953e2fe60ff83a4086b7dec0'],4,3,7,19394722,1,1,1,0,12382
82deb9f9d047745059a38740f91f3c3424e3078e,0,GitHub,2019-06-27 17:09:03-04:00,"['5775302114677394b8a27d7da09e99569c475df0', '95df57711e033f52b38541083f802b45b1b4650b']",11,78,89,19394811,5,,,,12382
bb2f1503e8f5595e8aba9017315d33450ee760f2,0,Marcus Christie,2019-06-27 17:43:16-04:00,['41274878383756fed383ac008f090c475d640185'],3,13,16,19394827,1,1,1,1,12382
3ba4e62009db816eb35a78f2e9b86a76a2e6af50,0,Marcus Christie,2019-06-28 12:08:31-04:00,['bb2f1503e8f5595e8aba9017315d33450ee760f2'],3,12,15,19394842,1,1,1,0,12382
459c57da2666a150d6e5633040c846b8f136ee08,1,Marcus Christie,2019-06-29 16:13:53-04:00,['82deb9f9d047745059a38740f91f3c3424e3078e'],1,66,67,19394909,7,,,,12383
011392c716934af95dd54f136b1e0f40596b0d20,0,Marcus Christie,2019-06-29 16:13:53-04:00,['459c57da2666a150d6e5633040c846b8f136ee08'],1,2,3,19394912,1,,,,12383
21fd56dff1eda910e9a238a00ca705de2d75dfdd,0,Marcus Christie,2019-06-29 16:13:53-04:00,['011392c716934af95dd54f136b1e0f40596b0d20'],0,3,3,19394915,1,,,,12383
184ff08a5227a5fd7d77a6447c7f6a8e67d6f739,0,Marcus Christie,2019-06-30 13:22:06-04:00,['21fd56dff1eda910e9a238a00ca705de2d75dfdd'],12,19,31,19394946,3,,,,12383
de0f823107ea1fff98300c8b11b7962ffae713ca,0,Marcus Christie,2019-06-30 13:23:54-04:00,"['3ba4e62009db816eb35a78f2e9b86a76a2e6af50', '184ff08a5227a5fd7d77a6447c7f6a8e67d6f739']",22,165,187,19395133,15,,,,12383
9c166b217b31be7a1c93121c425973a72f10251f,0,Marcus Christie,2019-06-30 13:24:59-04:00,['de0f823107ea1fff98300c8b11b7962ffae713ca'],1,4,5,19395138,4,,,,12383
a410c47cb61e40f6ca165800668e33790d211518,1,Marcus Christie,2019-06-30 17:39:07-04:00,['184ff08a5227a5fd7d77a6447c7f6a8e67d6f739'],1,1,2,19395140,1,,,,12383
9b0025b8c5cfc7ddf3c30701e16495695f58f584,0,Marcus Christie,2019-06-30 17:39:59-04:00,['9c166b217b31be7a1c93121c425973a72f10251f'],3,234,237,19395377,10,,,,12390
fe2a76c2aedeb93fa3f705d24afb92084ad46529,0,Marcus Christie,2019-06-30 17:40:20-04:00,"['9b0025b8c5cfc7ddf3c30701e16495695f58f584', 'a410c47cb61e40f6ca165800668e33790d211518']",1,1,2,19395379,1,,,,12390
3948a6a9195c3a8c43e31e98c92b6bc9b27b3361,0,Dimuthu Wannipurage,2019-07-01 10:24:58-04:00,['fe2a76c2aedeb93fa3f705d24afb92084ad46529'],0,2,2,19395381,2,,,,12390
57d3f907e4a90ed3570eb92f19c9da9b465541b0,0,Dimuthu Wannipurage,2019-07-02 12:12:04-04:00,['3ff1492af38ef627efa7a32485ade6054ddf0f1b'],0,9,9,19395390,3,,,,12390
492a9f2afbe7dfb8762827b61f03541faef82f57,0,Dimuthu Wannipurage,2019-07-02 12:27:19-04:00,['57d3f907e4a90ed3570eb92f19c9da9b465541b0'],0,3,3,19395393,3,,,,12390
8b214e64d35b3d7599eaad699c05e50c7d5abe02,0,Dimuthu Wannipurage,2019-07-02 12:59:21-04:00,['492a9f2afbe7dfb8762827b61f03541faef82f57'],4,5,9,19395402,2,1,1,0,12390
c78105f2dc34a35085549f525538190eef14b04e,0,Marcus Christie,2019-07-08 16:26:44-04:00,['3948a6a9195c3a8c43e31e98c92b6bc9b27b3361'],14,14,28,19395430,1,,,,12390
925abb6a5356d9e7b4fa2cab86c4e6b2d70d4dec,0,Marcus Christie,2019-07-10 09:00:21-04:00,['c78105f2dc34a35085549f525538190eef14b04e'],0,0,0,19395430,6,,,,12390
d33a2bb575914e70796ef1de6cd1034892a4aba8,0,Marcus Christie,2019-07-10 09:02:15-04:00,['925abb6a5356d9e7b4fa2cab86c4e6b2d70d4dec'],0,126,126,19395556,6,,,,12396
b64e87e993ea692ed8d1102b98a0237dde620cb8,0,Marcus Christie,2019-07-10 15:21:07-04:00,['925abb6a5356d9e7b4fa2cab86c4e6b2d70d4dec'],4,4,8,19395564,1,,,,12396
c357d0d98d9c3a717ba212cf1890a490d8264a39,0,Marcus Christie,2019-07-10 15:28:50-04:00,"['d33a2bb575914e70796ef1de6cd1034892a4aba8', 'b64e87e993ea692ed8d1102b98a0237dde620cb8']",4,4,8,19395572,1,,,,12396
59da61521890cba656503099744906a21637beec,1,Marcus Christie,2019-07-10 15:48:46-04:00,['b64e87e993ea692ed8d1102b98a0237dde620cb8'],1,2,3,19395575,1,0,1,0,12396
eca17b443cc255deb4c10ac0461bf8cb2b8fbc0e,0,Marcus Christie,2019-07-10 15:49:06-04:00,['59da61521890cba656503099744906a21637beec'],1,4,5,19395580,1,0,0,0,12396
d048990ffc21040697582059943ce768debc1c1d,0,Marcus Christie,2019-07-10 15:50:15-04:00,"['c357d0d98d9c3a717ba212cf1890a490d8264a39', 'eca17b443cc255deb4c10ac0461bf8cb2b8fbc0e']",2,6,8,19395588,2,,,,12396
46efbc87e033a1307a11dddc3f7f28e16b4aeedd,0,Dimuthu Wannipurage,2019-07-11 10:50:36-04:00,['eca17b443cc255deb4c10ac0461bf8cb2b8fbc0e'],0,5,5,19395593,1,0,0,1,12396
91c5258f6e869f738ed425be6dbc3c5b2b5b0088,0,Eroma Abeysinghe,2019-07-11 12:56:33-04:00,['d048990ffc21040697582059943ce768debc1c1d'],0,52,52,19395645,1,,,,12397
48de312e465607296e1e763a1c435e5c4531c1c1,0,Eroma Abeysinghe,2019-07-11 14:04:38-04:00,['91c5258f6e869f738ed425be6dbc3c5b2b5b0088'],0,1,1,19395646,1,,,,12397
21c7a6dfe116a046a5c140b6aafdb7fd048896aa,0,Eroma Abeysinghe,2019-07-11 14:04:59-04:00,['48de312e465607296e1e763a1c435e5c4531c1c1'],0,15,15,19395661,1,,,,12398
b8f9ca9975b2c50030ec21577555a3ffccd4bc27,0,Eroma Abeysinghe,2019-07-11 14:12:35-04:00,['21c7a6dfe116a046a5c140b6aafdb7fd048896aa'],1,1,2,19395663,1,,,,12398
66628a0e3ecdd218f7bfdb4a447b9545652c1783,0,Eroma Abeysinghe,2019-07-11 14:18:40-04:00,['b8f9ca9975b2c50030ec21577555a3ffccd4bc27'],0,1,1,19395664,1,,,,12398
4830be082c4ba79840eceba7a7f27024ed2acea9,0,Marcus Christie,2019-07-11 15:33:18-04:00,['66628a0e3ecdd218f7bfdb4a447b9545652c1783'],1,11,12,19395676,12,,,,12398
ea2d593887bffb57dc39ac9dd3c16624a776e732,0,Marcus Christie,2019-07-11 17:05:27-04:00,['46efbc87e033a1307a11dddc3f7f28e16b4aeedd'],11,36,47,19395723,4,0,1,1,12398
89d43eb0275697204500feaae08488bc98944723,0,Marcus Christie,2019-07-11 17:05:54-04:00,"['4830be082c4ba79840eceba7a7f27024ed2acea9', 'ea2d593887bffb57dc39ac9dd3c16624a776e732']",11,41,52,19395775,5,,,,12398
99e241dfd3f059dd1089048150698a7acf194b13,0,Dimuthu Wannipurage,2019-07-12 10:06:53-04:00,['ea2d593887bffb57dc39ac9dd3c16624a776e732'],4,4,8,19395783,1,1,1,0,12398
4680bd9d86c4f4a4bcd724507351bb9b79f421fa,0,Marcus Christie,2019-07-12 10:20:59-04:00,['99e241dfd3f059dd1089048150698a7acf194b13'],0,16,16,19395799,3,,,,12398
87cc12db1a930ead53223d636ebfc3e5e57663da,0,Aarushi,2019-07-12 17:19:53-04:00,['e1de154549afa9baf57294c001c2c8bc53bdde4f'],0,1,1,19395800,1,0,1,1,12398
91b8fa28a40ed4c58e52ed87d5a330f46210ba59,0,GitHub,2019-07-15 10:25:30-04:00,"['89d43eb0275697204500feaae08488bc98944723', '87cc12db1a930ead53223d636ebfc3e5e57663da']",0,1,1,19395801,1,,,,12398
b86623aabc1be07020eb48386125b7996dcef174,0,Aarushi,2019-07-15 11:15:16-04:00,['87cc12db1a930ead53223d636ebfc3e5e57663da'],1,21,22,19395823,1,,,,12398
fee5e16f358681c11860696bf0d9cfbd59a4f2d8,0,GitHub,2019-07-15 16:24:59-04:00,"['91b8fa28a40ed4c58e52ed87d5a330f46210ba59', 'b86623aabc1be07020eb48386125b7996dcef174']",1,21,22,19395845,1,,,,12398
11a5ecc73c7dd62020f48eae4c5f71f860c71dae,0,Marcus Christie,2019-07-15 17:15:17-04:00,['fee5e16f358681c11860696bf0d9cfbd59a4f2d8'],0,6,6,19395851,3,,,,12398
114ecd9b56ed3bd2f28f5bb82fb3c4d8bc7a0356,0,Marcus Christie,2019-07-16 17:20:48-04:00,['4680bd9d86c4f4a4bcd724507351bb9b79f421fa'],3,8,11,19395862,2,,,,12398
c3df4c32b999b44b9c0e9c3ea677477349428c14,0,Marcus Christie,2019-07-16 17:22:16-04:00,['114ecd9b56ed3bd2f28f5bb82fb3c4d8bc7a0356'],0,3,3,19395865,1,,,,12398
c03c802c9c3743cb366178c64cb63bc2c72d0f17,0,Marcus Christie,2019-07-16 17:24:40-04:00,['8b214e64d35b3d7599eaad699c05e50c7d5abe02'],3,3,6,19395871,1,,,,12398
9be2b9debc889e1d8d548e30afac72c45ab66167,0,Marcus Christie,2019-07-19 09:01:22-04:00,"['11a5ecc73c7dd62020f48eae4c5f71f860c71dae', 'c3df4c32b999b44b9c0e9c3ea677477349428c14']",7,31,38,19395909,7,,,,12398
1ba6a52591f88e84d081451131041a16a00b2e13,0,Marcus Christie,2019-07-19 09:20:19-04:00,['9be2b9debc889e1d8d548e30afac72c45ab66167'],0,2,2,19395911,2,,,,12398
ffd07bdf4b39cf9d6637e19bcfcce0c2bb09f156,0,Marcus Christie,2019-07-19 09:40:16-04:00,['1ba6a52591f88e84d081451131041a16a00b2e13'],1,1,2,19395913,1,,,,12398
2ace6638a6a6f5a5e846e9d1d2aa551f3c00800b,0,Dimuthu Wannipurage,2019-07-20 01:11:57-04:00,['ffd07bdf4b39cf9d6637e19bcfcce0c2bb09f156'],1,2,3,19395916,1,0,0,0,12398
212d7c9dcf5a04c841683813b30e1c643c019a17,0,Eroma Abeysinghe,2019-07-21 13:45:59-04:00,['2ace6638a6a6f5a5e846e9d1d2aa551f3c00800b'],1,1,2,19395918,1,,,,12398
2e9e7e0b4b8e0bd49a7032967236a680b226e82f,0,Eroma Abeysinghe,2019-07-21 14:26:13-04:00,['212d7c9dcf5a04c841683813b30e1c643c019a17'],0,61,61,19395979,2,,,,12400
95d70d354262da09998cd96eed6e188c0940a1f5,0,Eroma Abeysinghe,2019-07-21 14:34:56-04:00,['2e9e7e0b4b8e0bd49a7032967236a680b226e82f'],8,8,16,19395995,1,,,,12400
ae646e1a10eba1448a13379798cab0a11258e67b,0,Eroma Abeysinghe,2019-07-22 01:12:15-04:00,['95d70d354262da09998cd96eed6e188c0940a1f5'],14,14,28,19396023,1,,,,12400
461503d3929997c3956b00015167b6ce8720b011,0,Eroma Abeysinghe,2019-07-22 01:17:12-04:00,['ae646e1a10eba1448a13379798cab0a11258e67b'],2,3,5,19396028,1,,,,12400
adb8e155305e4740b9fecb93ffd43f1d3f246c0b,0,Eroma Abeysinghe,2019-07-22 01:23:51-04:00,['461503d3929997c3956b00015167b6ce8720b011'],3,3,6,19396034,1,,,,12400
3aeedeb057419f66673ddfb356d77f87bf1545f1,0,Eroma Abeysinghe,2019-07-22 01:38:49-04:00,['adb8e155305e4740b9fecb93ffd43f1d3f246c0b'],0,1,1,19396035,1,,,,12400
7ad2971731bc875230ac27b495f5f77aa2cbf0b7,0,Eroma Abeysinghe,2019-07-22 01:59:34-04:00,['3aeedeb057419f66673ddfb356d77f87bf1545f1'],1,1,2,19396037,1,,,,12400
39ac6d17d6b36d0702d78e563e80f4e908552bc7,0,Marcus Christie,2019-07-22 11:13:29-04:00,['7ad2971731bc875230ac27b495f5f77aa2cbf0b7'],2,4,6,19396043,5,,,,12400
73e583c1a2c3e351b9eaa6e00f2f4d1e1076907e,0,Marcus Christie,2019-07-23 12:47:27-04:00,['39ac6d17d6b36d0702d78e563e80f4e908552bc7'],0,1,1,19396044,1,,,,12400
623bd05696de09ab2b5c113e90902b8c4ed49a1c,0,Marcus Christie,2019-07-23 13:11:41-04:00,['73e583c1a2c3e351b9eaa6e00f2f4d1e1076907e'],3,27,30,19396074,1,0,1,0,12400
88a8c521ba2f1bfd638b5dbc6f864db4d3bfbc35,1,Dimuthu Wannipurage,2019-07-24 00:00:35-04:00,['623bd05696de09ab2b5c113e90902b8c4ed49a1c'],1299,3672,4971,19401045,25,0.592198582,0.744680851,0.983451537,12402
8373b821556dfb4b4f27abcc8020c98d4b236db5,0,Eroma Abeysinghe,2019-07-24 02:38:42-04:00,['88a8c521ba2f1bfd638b5dbc6f864db4d3bfbc35'],2,2,4,19401049,1,,,,12402
eb80c48f88ef9a4e9a0d300f8cb552ef938f328f,0,Eroma Abeysinghe,2019-07-24 02:40:50-04:00,['8373b821556dfb4b4f27abcc8020c98d4b236db5'],1,1,2,19401051,1,,,,12402
85db70accdbc39c37d408a919578ab0243010c4d,0,Dimuthu Wannipurage,2019-07-24 02:49:51-04:00,['eb80c48f88ef9a4e9a0d300f8cb552ef938f328f'],0,43,43,19401094,1,,,,12402
fdd1de3d2c60024e947078839f905171033d01c0,0,Dimuthu Wannipurage,2019-07-24 11:55:06-04:00,['85db70accdbc39c37d408a919578ab0243010c4d'],3,3,6,19401100,1,,,,12402
3b6e124aa9170db923b52f63926770db22bbe881,0,Dimuthu Wannipurage,2019-07-24 12:17:30-04:00,['fdd1de3d2c60024e947078839f905171033d01c0'],1,1,2,19401102,1,,,,12402
8d9e701ed3b7eec0bc42b8c5ba7a82cd5e554511,0,Dimuthu Wannipurage,2019-07-24 12:27:45-04:00,['3b6e124aa9170db923b52f63926770db22bbe881'],1,2,3,19401105,1,0,0,1,12402
1cd1a3b0d900ed01fbe695815071f0fb4a78de87,0,Dimuthu Wannipurage,2019-07-24 13:56:10-04:00,['8d9e701ed3b7eec0bc42b8c5ba7a82cd5e554511'],4,13,17,19401122,2,0,0,0,12402
18eb5f63b3069753449a57a3290a95535f590a20,0,Dimuthu Wannipurage,2019-07-24 14:05:41-04:00,['1cd1a3b0d900ed01fbe695815071f0fb4a78de87'],1,1,2,19401124,1,1,1,1,12402
dfb16125a4af1dcd2d1f616f48975632cc7b3654,0,Dimuthu Wannipurage,2019-07-24 14:26:30-04:00,['18eb5f63b3069753449a57a3290a95535f590a20'],1,1,2,19401126,1,,,,12402
23f6099a5b58988f0ccecb94f0719c4f21eaecd8,0,Marcus Christie,2019-07-25 13:44:14-04:00,['dfb16125a4af1dcd2d1f616f48975632cc7b3654'],0,1,1,19401127,1,,,,12402
4cc94389ad3ff9681620e899fc99adfab8773343,0,Dimuthu Wannipurage,2019-07-25 16:15:27-04:00,['23f6099a5b58988f0ccecb94f0719c4f21eaecd8'],24,42,66,19401193,1,0,0,1,12402
1162b5561824bec0b7f7132cba525f6c05e19394,0,Dimuthu Wannipurage,2019-07-26 03:47:49-04:00,['4cc94389ad3ff9681620e899fc99adfab8773343'],1,7,8,19401201,2,1,1,1,12402
e92590cef353daf3e790d2a554349771d1312f58,0,Dimuthu Wannipurage,2019-07-26 11:10:08-04:00,['1162b5561824bec0b7f7132cba525f6c05e19394'],4,37,41,19401242,1,0,0,0.8125,12402
ab932814e4092c45fdb2daff8ad4e25b35e26763,1,Dimuthu Wannipurage,2019-07-26 11:10:32-04:00,['e92590cef353daf3e790d2a554349771d1312f58'],0,1,1,19401243,1,,,,12402
521d2dc9a6fcc8eb65832345ae18f3ac99eac1fa,0,Dimuthu Wannipurage,2019-07-26 11:11:44-04:00,['ab932814e4092c45fdb2daff8ad4e25b35e26763'],0,1,1,19401244,1,,,,12402
8b189d2db10a7a03f39f0f7fb894447a9a6a5bfb,0,Marcus Christie,2019-07-26 11:49:53-04:00,['521d2dc9a6fcc8eb65832345ae18f3ac99eac1fa'],1,8,9,19401253,2,,,,12402
0e58b6e87f23658a9502623cc315eb284645186c,0,Marcus Christie,2019-07-29 10:19:13-05:00,['8b189d2db10a7a03f39f0f7fb894447a9a6a5bfb'],2,3,5,19401258,2,,,,12402
5571489ab54c5f0510ba649afc38753628dbe735,0,Marcus Christie,2019-07-29 10:22:18-05:00,['0e58b6e87f23658a9502623cc315eb284645186c'],2,2,4,19401262,1,,,,12402
37a18bc76882cff890880aadb3c13e6bb6054762,0,Marcus Christie,2019-08-06 11:44:33-04:00,['5571489ab54c5f0510ba649afc38753628dbe735'],4,12,16,19401278,2,0.166666667,1,1,12402
5405be0ae767b616abd22edab768ec158a634651,0,Marcus Christie,2019-08-07 09:20:48-04:00,['37a18bc76882cff890880aadb3c13e6bb6054762'],0,61,61,19401339,3,,,,12404
3800ea2e1f0dc3dae6b6322aa16638fc74e69378,0,Marcus Christie,2019-08-07 15:29:04-04:00,['5405be0ae767b616abd22edab768ec158a634651'],17,5,22,19401361,3,0.142857143,0,0,12404
e66939d09586e3f5f5fc25a4011541f8359f1b98,0,Eroma Abeysinghe,2019-08-08 12:08:58-04:00,['c03c802c9c3743cb366178c64cb63bc2c72d0f17'],4,4,8,19401369,1,,,,12404
2cfd5efee635a94c385339c3507521dd19c701df,0,Marcus Christie,2019-08-09 10:45:33-04:00,['3800ea2e1f0dc3dae6b6322aa16638fc74e69378'],1,1,2,19401371,1,,,,12404
13c1f20adf069bd7000946fc49a6f17353bda776,0,Marcus Christie,2019-08-09 11:28:57-04:00,['2cfd5efee635a94c385339c3507521dd19c701df'],0,3,3,19401374,1,,,,12404
6e7a77ab106bd1df94ff8aed364b63caa9f5935c,1,Marcus Christie,2019-08-12 16:56:19-04:00,['13c1f20adf069bd7000946fc49a6f17353bda776'],0,48,48,19401422,4,,,,12405
679a4b9a05742b613512e737797a5b2fa6f4268d,0,Marcus Christie,2019-08-14 16:30:29-04:00,['6e7a77ab106bd1df94ff8aed364b63caa9f5935c'],0,3,3,19401425,1,,,,12405
84dae43365b76bb582959c13c1789103b1a8fd29,0,Eroma Abeysinghe,2019-08-22 01:47:08-04:00,['e66939d09586e3f5f5fc25a4011541f8359f1b98'],1,1,2,19401427,1,,,,12405
6c410b0a2dc7ba24692935e07e7f280ec58742ca,0,Eroma Abeysinghe,2019-08-22 02:10:32-04:00,['84dae43365b76bb582959c13c1789103b1a8fd29'],1,1,2,19401429,1,,,,12405
a4f8b39953ff4dd7d6aa5e74aa54668d28a9b41d,0,Marcus Christie,2019-08-26 18:42:05-04:00,['679a4b9a05742b613512e737797a5b2fa6f4268d'],0,8,8,19401437,3,,,,12405
3bfbc118dd643871490078350250af1c10b915b3,0,Suresh Marru,2019-09-05 08:28:23-04:00,['6c410b0a2dc7ba24692935e07e7f280ec58742ca'],0,11,11,19401448,1,,,,12406
ddf51e454b0537fd8dafb2cc4605837a4a52196e,0,Dimuthu Wannipurage,2019-09-07 13:20:36-04:00,['a4f8b39953ff4dd7d6aa5e74aa54668d28a9b41d'],127,677,804,19402252,15,0.439189189,0.685810811,0.462837838,12411
dd6bdc02f08f48657388e2d6edbf1d0872fd2847,0,Eroma Abeysinghe,2019-09-12 10:41:22-04:00,['ddf51e454b0537fd8dafb2cc4605837a4a52196e'],0,64,64,19402316,2,,,,12413
4bc05c07ac30e16cc1f7e33e397fa974de2377c3,0,Eroma Abeysinghe,2019-09-12 10:42:47-04:00,['dd6bdc02f08f48657388e2d6edbf1d0872fd2847'],0,1,1,19402317,1,,,,12413
ba9dea7fa0e6fdf3550a34a5181831b70af8d501,0,Eroma Abeysinghe,2019-09-12 10:44:16-04:00,['4bc05c07ac30e16cc1f7e33e397fa974de2377c3'],14,14,28,19402345,1,,,,12413
be506d3fc39a74ffb2b4a2604041532ec0214cb1,0,Eroma Abeysinghe,2019-09-12 10:50:34-04:00,['ba9dea7fa0e6fdf3550a34a5181831b70af8d501'],3,3,6,19402351,1,,,,12413
b99d30ca99edcd8d97e2ae448289b9580f282c34,0,Eroma Abeysinghe,2019-09-12 12:34:57-04:00,['be506d3fc39a74ffb2b4a2604041532ec0214cb1'],4,4,8,19402359,1,,,,12413
1b6789c4f0a19a5a8199a398258241425ac61c93,0,Eroma Abeysinghe,2019-09-12 13:19:39-04:00,['b99d30ca99edcd8d97e2ae448289b9580f282c34'],1,1,2,19402361,1,,,,12413
6624228664eae2e2050b9a2eeebf92abd332e29e,0,Eroma Abeysinghe,2019-09-12 13:44:32-04:00,['1b6789c4f0a19a5a8199a398258241425ac61c93'],0,2,2,19402363,1,,,,12413
4c6948040507fc169cf07abc42fc8552f053e8cd,0,Marcus Christie,2019-09-12 13:55:37-04:00,['6624228664eae2e2050b9a2eeebf92abd332e29e'],0,3,3,19402366,2,,,,12413
8faef3bb9ff8c53907b14ea17b2dbcc867c83a32,0,Dimuthu Wannipurage,2019-09-16 00:19:03-04:00,['4c6948040507fc169cf07abc42fc8552f053e8cd'],7,26,33,19402399,4,0,0.615384615,0.230769231,12413
f0809fb3348fd5d2433c2e53f31e02edc32c4dac,1,Dimuthu Wannipurage,2019-09-16 00:44:26-04:00,['3bfbc118dd643871490078350250af1c10b915b3'],127,708,835,19403234,18,0.381877023,0.682847896,0.453074434,12418
3823a07a7ca311e5213835084c0dbf1790ac4d90,0,Dimuthu Wannipurage,2019-09-16 00:49:09-04:00,['f0809fb3348fd5d2433c2e53f31e02edc32c4dac'],2,2,4,19403238,2,,,,12418
19de9cf21f74e3e060caa989bdd50b436d1f411c,0,Dimuthu Wannipurage,2019-09-16 16:03:00-04:00,['3823a07a7ca311e5213835084c0dbf1790ac4d90'],38,49,87,19403325,1,0,0,1,12418
03a0fe3d39fb8beda1ccc0f4f61ede3fe12510e8,0,Marcus Christie,2019-09-17 10:08:35-04:00,['8faef3bb9ff8c53907b14ea17b2dbcc867c83a32'],1,4,5,19403330,1,,,,12418
80157e5674983537c56db41e6dbcf9e0af140a1b,1,Marcus Christie,2019-09-17 12:39:20-04:00,['03a0fe3d39fb8beda1ccc0f4f61ede3fe12510e8'],27,65,92,19403422,2,0.483870968,0.483870968,1,12418
64b24c45b5434ebedbd0a5a438f6778bdda2e9c8,0,Eroma Abeysinghe,2019-09-17 13:31:03-04:00,['80157e5674983537c56db41e6dbcf9e0af140a1b'],0,2,2,19403424,1,,,,12418
aac966fe4f35a5d2783e697f128eb299a0c21dc6,0,Marcus Christie,2019-09-17 15:01:47-04:00,['64b24c45b5434ebedbd0a5a438f6778bdda2e9c8'],3,3,6,19403430,1,,,,12418
d38061ad27740064b6bd41483c2d0e2a2bcd75d2,0,Marcus Christie,2019-09-17 16:54:26-04:00,['aac966fe4f35a5d2783e697f128eb299a0c21dc6'],0,5,5,19403435,1,,,,12418
aab692e0e4c100912240a2e7f273b90aa4b4bc5d,0,Eroma Abeysinghe,2019-09-18 04:57:05-04:00,['d38061ad27740064b6bd41483c2d0e2a2bcd75d2'],0,49,49,19403484,1,,,,12419
a755da4741cb1259ad8e031c87d4f0d47d483cd8,0,Eroma Abeysinghe,2019-09-18 05:18:36-04:00,['aab692e0e4c100912240a2e7f273b90aa4b4bc5d'],0,15,15,19403499,1,,,,12420
ae996ce493dc17aa6e3ae206138f0443416b7dfe,0,Eroma Abeysinghe,2019-09-18 05:23:24-04:00,['a755da4741cb1259ad8e031c87d4f0d47d483cd8'],0,1,1,19403500,1,,,,12420
716a43b23de9ae567ce93d3fde5c165e8231eeb2,0,Eroma Abeysinghe,2019-09-18 06:26:16-04:00,['ae996ce493dc17aa6e3ae206138f0443416b7dfe'],1,1,2,19403502,1,,,,12420
081b3c454b10e21cced8e58152b8f48c259ac7e2,0,Eroma Abeysinghe,2019-09-18 10:35:27-04:00,['716a43b23de9ae567ce93d3fde5c165e8231eeb2'],3,3,6,19403508,1,,,,12420
707549972adcf84aa36810fa2e78ddfd6b7eb60d,0,Marcus Christie,2019-09-18 14:59:13-04:00,['081b3c454b10e21cced8e58152b8f48c259ac7e2'],2,2,4,19403512,1,,,,12420
1b2fd78283b024de16e4619b08cdd29f1479e4ae,0,Marcus Christie,2019-09-20 14:23:59-04:00,['707549972adcf84aa36810fa2e78ddfd6b7eb60d'],0,2,2,19403514,1,,,,12420
ee0972e6ce09fb5a6ff9fb1bf6af717e5a284e36,0,Marcus Christie,2019-09-21 12:35:44-07:00,['1b2fd78283b024de16e4619b08cdd29f1479e4ae'],1,0,1,19403515,1,,,,12420
6d4a98a5f34e9855d6264e79df21d20565b773f7,0,Dimuthu Wannipurage,2019-09-23 09:36:20-04:00,['ee0972e6ce09fb5a6ff9fb1bf6af717e5a284e36'],1,6,7,19403522,1,,,,12420
fa463378028017e6d08d1204d4b000346b226965,0,Dimuthu Wannipurage,2019-09-23 09:37:55-04:00,['6d4a98a5f34e9855d6264e79df21d20565b773f7'],5,0,5,19403527,1,,,,12420
b9c9be39ae11089f3d3ecf1cb927cc5a71a6a93d,0,Eroma Abeysinghe,2019-09-23 20:16:26-04:00,['19de9cf21f74e3e060caa989bdd50b436d1f411c'],0,1,1,19403528,1,,,,12420
04b3c3c45b947083dcb2006fac01953dae78d247,0,Eroma Abeysinghe,2019-09-23 21:00:19-04:00,['fa463378028017e6d08d1204d4b000346b226965'],6,6,12,19403540,1,,,,12420
2b7752d678af378092d7ed32554503e3ed31ee4d,0,Eroma Abeysinghe,2019-09-23 21:10:21-04:00,['04b3c3c45b947083dcb2006fac01953dae78d247'],1,1,2,19403542,1,,,,12420
007e251bb2dea831f8acf1075e38afd9c3e1eafc,0,Marcus Christie,2019-09-23 20:40:06-07:00,['b9c9be39ae11089f3d3ecf1cb927cc5a71a6a93d'],4,2,6,19403548,1,,,,12420
2ef9f8f7154d05eaa8c36bd286f8b8bc43c1adba,0,Eroma Abeysinghe,2019-09-25 17:00:10-04:00,['2b7752d678af378092d7ed32554503e3ed31ee4d'],0,49,49,19403597,1,,,,12421
b1bb5868c686a4cc90ee3e2df2a881b3878e14b8,0,Eroma Abeysinghe,2019-09-25 17:00:29-04:00,['2ef9f8f7154d05eaa8c36bd286f8b8bc43c1adba'],0,15,15,19403612,1,,,,12422
6491e244889035271b75b585ac90cb222ac547c5,0,Eroma Abeysinghe,2019-09-25 19:05:09-04:00,['b1bb5868c686a4cc90ee3e2df2a881b3878e14b8'],8,8,16,19403628,1,,,,12422
1cce00f5457d36a21ccc0d9763f7758191c6a524,0,Eroma Abeysinghe,2019-09-25 19:06:17-04:00,['6491e244889035271b75b585ac90cb222ac547c5'],14,14,28,19403656,1,,,,12422
9e04fac85ae65c09330269038c983557dd4e5930,0,Eroma Abeysinghe,2019-09-25 19:07:34-04:00,['1cce00f5457d36a21ccc0d9763f7758191c6a524'],0,1,1,19403657,1,,,,12422
bebae89124ecf8b2c7ac8ba9c2cd5b3ffd0bcced,0,Eroma Abeysinghe,2019-09-25 19:12:45-04:00,['9e04fac85ae65c09330269038c983557dd4e5930'],0,9,9,19403666,1,,,,12422
814af4a3b2763ea0d86813bf59348f6ecc0032c0,0,Eroma Abeysinghe,2019-09-25 19:13:55-04:00,['bebae89124ecf8b2c7ac8ba9c2cd5b3ffd0bcced'],0,82,82,19403748,1,,,,12423
56ee906d694b6b0b24ea2b6321128a8ee24cb5d3,0,Marcus Christie,2019-09-25 21:06:48-07:00,['814af4a3b2763ea0d86813bf59348f6ecc0032c0'],4,7,11,19403759,1,,,,12423
4cce1169933af79318887e648e6812bd12c23fe9,0,Marcus Christie,2019-09-30 13:10:10-04:00,['007e251bb2dea831f8acf1075e38afd9c3e1eafc'],1,1,2,19403761,1,,,,12423
bb15f3b080fd8a2670d1b71ffd30f33281a0d012,0,Dimuthu Wannipurage,2019-10-01 16:31:03-04:00,"['007e251bb2dea831f8acf1075e38afd9c3e1eafc', 'fa463378028017e6d08d1204d4b000346b226965']",198954,542109,741063,20144824,1599,,,,12423
eb39d24eee19de930ea4ab0cbf20055c7678ff8c,0,Marcus Christie,2019-10-02 10:38:14-04:00,['56ee906d694b6b0b24ea2b6321128a8ee24cb5d3'],1,5,6,20144830,3,,,,12423
88ebfc3f50caad50d0ef059b26b1e3b718d5c770,0,Marcus Christie,2019-10-02 10:50:59-04:00,['eb39d24eee19de930ea4ab0cbf20055c7678ff8c'],1,1,2,20144832,1,,,,12423
73f34cb8d8eb4e93a94f443db081d9d647bac04c,0,Marcus Christie,2019-10-02 11:05:58-04:00,['88ebfc3f50caad50d0ef059b26b1e3b718d5c770'],7,7,14,20144846,2,,,,12423
42a07873dd3517e3ca4a420a187ded0a4d59375e,0,Eroma Abeysinghe,2019-10-03 08:41:28-04:00,['4cce1169933af79318887e648e6812bd12c23fe9'],0,65,65,20144911,1,,,,12424
0e507371eb4679a162c5bb5535e8f70bf9f50240,0,Eroma Abeysinghe,2019-10-03 08:43:17-04:00,['42a07873dd3517e3ca4a420a187ded0a4d59375e'],3,3,6,20144917,1,,,,12424
18245f8ee54009dad3bcca258338228e799eed28,0,Eroma Abeysinghe,2019-10-03 09:09:27-04:00,['0e507371eb4679a162c5bb5535e8f70bf9f50240'],0,18,18,20144935,1,,,,12425
ce05252156caa00ff2fc4f05d52af644bbdd812e,0,Eroma Abeysinghe,2019-10-03 09:34:59-04:00,['18245f8ee54009dad3bcca258338228e799eed28'],1,1,2,20144937,1,,,,12425
9e924c788d09bb8f67f7af6dea9f2eafcd81d6c6,0,Eroma Abeysinghe,2019-10-03 10:36:09-04:00,['ce05252156caa00ff2fc4f05d52af644bbdd812e'],0,1,1,20144938,1,,,,12425
5850d6bf5aed936cf03535bab982dffc7c22c2cf,0,Marcus Christie,2019-10-07 12:55:08-04:00,['73f34cb8d8eb4e93a94f443db081d9d647bac04c'],5,0,5,20144943,1,,,,12425
3c3e7e9bbc87d295c99aa78865693cc42ef66a32,0,Marcus Christie,2019-10-07 14:03:23-04:00,['5850d6bf5aed936cf03535bab982dffc7c22c2cf'],2,1,3,20144946,2,,,,12425
fd1b73efc125e98d33bbf89427698d3cbe22b5ac,0,Marcus Christie,2019-10-08 11:24:57-04:00,['3c3e7e9bbc87d295c99aa78865693cc42ef66a32'],0,1,1,20144947,1,,,,12425
abbb9eea29f1ab4ac11af1ed3f09f6054b2ed91d,0,Marcus Christie,2019-10-11 13:17:32-04:00,['3c3e7e9bbc87d295c99aa78865693cc42ef66a32'],14,14,28,20144975,1,,,,12425
2190e8253b503de65a08791a920c2164e7448e71,0,Eroma Abeysinghe,2019-10-15 19:06:50-04:00,['9e924c788d09bb8f67f7af6dea9f2eafcd81d6c6'],4,4,8,20144983,1,,,,12425
f2d6e09e68bbd38ad5b82421254460b2da9021c7,0,Eroma Abeysinghe,2019-10-15 21:54:29-04:00,['fd1b73efc125e98d33bbf89427698d3cbe22b5ac'],0,54,54,20145037,1,,,,12426
e516d1191290072bd81fd134b148dfedf653c8bd,0,Eroma Abeysinghe,2019-10-16 00:27:00-04:00,['f2d6e09e68bbd38ad5b82421254460b2da9021c7'],0,15,15,20145052,1,,,,12427
d94ac0f6ff5da4d01d7b869ff76986c31b0d0302,0,Eroma Abeysinghe,2019-10-16 00:32:20-04:00,['e516d1191290072bd81fd134b148dfedf653c8bd'],1,1,2,20145054,1,,,,12427
24538c7624418473a27e1cbfd29456ac5f4a9fa3,0,Eroma Abeysinghe,2019-10-16 00:33:19-04:00,['d94ac0f6ff5da4d01d7b869ff76986c31b0d0302'],0,1,1,20145055,1,,,,12427
55d9a9b8a833ff615ce6df47556c5553b6718370,0,Eroma Abeysinghe,2019-10-16 10:55:03-04:00,['24538c7624418473a27e1cbfd29456ac5f4a9fa3'],0,0,0,20145055,2,,,,12427
da0973b3647a2b310435f87e925bf90fb2b04b29,0,Eroma Abeysinghe,2019-10-16 10:57:08-04:00,['55d9a9b8a833ff615ce6df47556c5553b6718370'],1,1,2,20145057,1,,,,12427
89ddf10df576b243902e6d89322322674e4b0d15,0,Marcus Christie,2019-10-16 15:01:42-04:00,['abbb9eea29f1ab4ac11af1ed3f09f6054b2ed91d'],0,1,1,20145058,1,,,,12427
cf29ed27b1951c61042a29ab767a445a9b605ee6,1,Marcus Christie,2019-10-16 15:44:08-04:00,['89ddf10df576b243902e6d89322322674e4b0d15'],18,47,65,20145123,2,,,,12427
502acac7dd0ddeb2a7e1e47840d25271322b66b0,1,Marcus Christie,2019-10-16 15:44:08-04:00,['cf29ed27b1951c61042a29ab767a445a9b605ee6'],7,16,23,20145146,1,,,,12427
95664d279aa4dd4f4b4a0e5019172c6042a04dd1,1,Marcus Christie,2019-10-16 15:44:08-04:00,['502acac7dd0ddeb2a7e1e47840d25271322b66b0'],4,3,7,20145153,1,,,,12427
6401c810f13175ab925b4b5bad40d1ac95da78ea,0,Marcus Christie,2019-10-16 15:44:08-04:00,['95664d279aa4dd4f4b4a0e5019172c6042a04dd1'],1,15,16,20145169,1,,,,12427
ea710c20802065e4ac79cb2a85672177b7d1d302,0,Marcus Christie,2019-10-16 15:44:09-04:00,['6401c810f13175ab925b4b5bad40d1ac95da78ea'],2,1,3,20145172,2,,,,12427
0cbc83355dda6287f9c5988b0c160310e0ec2cf3,0,Marcus Christie,2019-10-16 15:44:09-04:00,['ea710c20802065e4ac79cb2a85672177b7d1d302'],4,11,15,20145187,2,,,,12427
b0e15a581326ede8ffb6e23279ea8a3e4706eb31,1,Marcus Christie,2019-10-16 15:44:09-04:00,['0cbc83355dda6287f9c5988b0c160310e0ec2cf3'],0,1,1,20145188,1,,,,12427
9ef216d77437e69780d5678ff561f9801ac58ae0,0,Marcus Christie,2019-10-16 15:44:50-04:00,"['da0973b3647a2b310435f87e925bf90fb2b04b29', 'b0e15a581326ede8ffb6e23279ea8a3e4706eb31']",36,95,131,20145319,7,,,,12427
fa948f22e644f9a862db149586fc66ebd706e422,0,Marcus Christie,2019-10-17 16:51:21-04:00,['9ef216d77437e69780d5678ff561f9801ac58ae0'],0,3,3,20145322,1,,,,12427
8c731c7e0fee6293cfef1f3f451214de049002ab,0,Eroma Abeysinghe,2019-10-18 02:05:39-04:00,['b0e15a581326ede8ffb6e23279ea8a3e4706eb31'],1,1,2,20145324,1,,,,12427
415f4419294c29872508d93c38c05ab938bbe927,0,Marcus Christie,2019-10-18 12:01:33-04:00,['8c731c7e0fee6293cfef1f3f451214de049002ab'],2,4,6,20145330,2,,,,12427
5c5aee02041ac39778489e7c276772332b694a88,0,Marcus Christie,2019-10-18 12:01:44-04:00,"['fa948f22e644f9a862db149586fc66ebd706e422', '415f4419294c29872508d93c38c05ab938bbe927']",3,5,8,20145338,3,,,,12427
1737f8f1112575868ba36f28c54cb274f38b16c0,0,Marcus Christie,2019-10-21 15:28:29-04:00,['415f4419294c29872508d93c38c05ab938bbe927'],425,481,906,20146244,23,0,0,1,12427
4caefaf82bf952353f87f87de242c67ee036f17b,0,Marcus Christie,2019-10-21 21:06:03-04:00,['1737f8f1112575868ba36f28c54cb274f38b16c0'],0,3,3,20146247,1,0,0,1,12427
ed86689b4427e1af6cee07b4138b9b2323bd0ab4,0,Aarushi,2019-10-21 23:21:45-04:00,['415f4419294c29872508d93c38c05ab938bbe927'],3,88,91,20146338,1,0.671641791,0.925373134,0.343283582,12427
45718db8f7f742342c44bc17bd6fc66380efb9c9,0,Aarushi,2019-10-22 14:04:16-04:00,['ed86689b4427e1af6cee07b4138b9b2323bd0ab4'],4,4,8,20146346,1,,,,12427
45672dbf12998e195b149be8fb8a18a5cddbf9a9,0,GitHub,2019-10-22 14:12:19-04:00,"['2190e8253b503de65a08791a920c2164e7448e71', '4caefaf82bf952353f87f87de242c67ee036f17b']",198949,542386,741335,20887681,1596,,,,12427
c94f3beee135559fe63e3b5c6378c6494f8c67c1,0,GitHub,2019-10-22 14:13:11-04:00,"['4caefaf82bf952353f87f87de242c67ee036f17b', '45672dbf12998e195b149be8fb8a18a5cddbf9a9']",53,171,224,20887905,13,,,,12427
9c1e3649382fb20dda6ed0ea5388181aafce26c4,0,Dimuthu Wannipurage,2019-10-22 14:30:01-04:00,"['bb15f3b080fd8a2670d1b71ffd30f33281a0d012', '45672dbf12998e195b149be8fb8a18a5cddbf9a9']",486,852,1338,20889243,46,,,,12427
b90f17c05b73554515cff825b0471ab485a51f17,0,isururanawaka,2019-10-22 17:05:03-04:00,['5c5aee02041ac39778489e7c276772332b694a88'],1,17,18,20889261,4,,,,12427
478482248de093448e11fa1545c2b1ad6c39c84b,0,GitHub,2019-10-22 20:25:42-04:00,"['5c5aee02041ac39778489e7c276772332b694a88', 'b90f17c05b73554515cff825b0471ab485a51f17']",1,17,18,20889279,4,,,,12427
0e11ed44e5ccdf062f00297a2c72bb0def3af015,0,Marcus Christie,2019-10-22 20:37:18-04:00,"['478482248de093448e11fa1545c2b1ad6c39c84b', 'c94f3beee135559fe63e3b5c6378c6494f8c67c1']",478,655,1133,20890412,37,,,,12427
5b97b0aae9ff4c2d6ab4dc1deb2db4e43ecee67b,0,Aarushi,2019-10-22 21:38:08-04:00,['45718db8f7f742342c44bc17bd6fc66380efb9c9'],21,32,53,20890465,1,0.090909091,1,0,12427
8df13133612529cc9f32a409a372af26e768924a,0,Aarushi,2019-10-22 21:42:37-04:00,['5b97b0aae9ff4c2d6ab4dc1deb2db4e43ecee67b'],2,0,2,20890467,1,,,,12427
29967aa6abfeaa2bfd94b6847002de1781bd2a49,0,isururanawaka,2019-10-23 13:04:03-04:00,['b90f17c05b73554515cff825b0471ab485a51f17'],8,21,29,20890496,5,,,,12427
7a42459250eb49f07c976cdce9fffeb0b71ab36e,0,isururanawaka,2019-10-23 13:06:40-04:00,['29967aa6abfeaa2bfd94b6847002de1781bd2a49'],6,0,6,20890502,2,,,,12427
5ed835b6f30c965c403db0c108f590eec1fef98d,0,isururanawaka,2019-10-23 14:02:55-04:00,['7a42459250eb49f07c976cdce9fffeb0b71ab36e'],6,22,28,20890530,2,,,,12427
f0f8dc6904eec5158cba562d492197ad69f5187e,0,isururanawaka,2019-10-23 15:19:53-04:00,['5ed835b6f30c965c403db0c108f590eec1fef98d'],4,3,7,20890537,2,,,,12427
0c4259622203597b63fdc6263f8543a97639ddbf,1,Eroma Abeysinghe,2019-10-24 05:08:22-04:00,['9c1e3649382fb20dda6ed0ea5388181aafce26c4'],0,65,65,20890602,2,,,,12429
dbc1040d733ea97f33b4a830c4dd343bb256f4d5,1,Eroma Abeysinghe,2019-10-24 05:12:21-04:00,['0c4259622203597b63fdc6263f8543a97639ddbf'],0,64,64,20890666,2,,,,12431
3c364829338e95a68ea739513239c3f4f9098078,1,Eroma Abeysinghe,2019-10-24 05:14:41-04:00,['dbc1040d733ea97f33b4a830c4dd343bb256f4d5'],0,160,160,20890826,3,,,,12434
8f41a09882148cd8f91da968ba10851b46ce2e16,1,Eroma Abeysinghe,2019-10-24 05:16:10-04:00,['3c364829338e95a68ea739513239c3f4f9098078'],0,62,62,20890888,2,,,,12436
e2c8114d708455f98dd138ca8871954d80b51ef1,1,Marcus Christie,2019-10-24 10:40:51-04:00,['8f41a09882148cd8f91da968ba10851b46ce2e16'],0,41,41,20890929,1,,,,12437
30f4780609c427910235bc8d963b7bf74c28d3a1,0,isururanawaka,2019-10-24 14:36:55-04:00,['f0f8dc6904eec5158cba562d492197ad69f5187e'],66,140,206,20891135,16,1,0,0,12437
86ca6288f2bf0a4f34132e8f07e573e5394d60e0,0,GitHub,2019-10-24 15:13:07-04:00,"['0e11ed44e5ccdf062f00297a2c72bb0def3af015', '30f4780609c427910235bc8d963b7bf74c28d3a1']",78,174,252,20891387,21,,,,12437
3a0c81bd17eaafa81e9bee5af91e0732f4305bb7,0,GitHub,2019-10-24 17:30:43-04:00,"['c94f3beee135559fe63e3b5c6378c6494f8c67c1', '8df13133612529cc9f32a409a372af26e768924a']",3,97,100,20891487,1,,,,12437
c6a6ae93201f563c2e677697dbdbdaa9f6a0261a,1,Marcus Christie,2019-10-25 11:25:53-04:00,['3a0c81bd17eaafa81e9bee5af91e0732f4305bb7'],70,324,394,20891881,21,0.31147541,1,0.852459016,12438
f674a986a0bff146f814e39f079b25b24dd9b7bb,0,Marcus Christie,2019-10-26 18:39:31-04:00,['c6a6ae93201f563c2e677697dbdbdaa9f6a0261a'],1,2,3,20891884,1,0,0,1,12438
1e66dfe72c64465a844db8767cbbe677c6ffdf2a,0,Marcus Christie,2019-10-28 10:11:08-04:00,['f674a986a0bff146f814e39f079b25b24dd9b7bb'],0,5,5,20891889,1,,,,12439
7dcfc50bf61ca301f54e7cb6e3fe09ccf9a31266,0,Marcus Christie,2019-10-28 10:11:47-04:00,"['86ca6288f2bf0a4f34132e8f07e573e5394d60e0', '1e66dfe72c64465a844db8767cbbe677c6ffdf2a']",74,428,502,20892391,24,,,,12439
bbb43a6bd60867a9086398f9aa4c075a8fea1cd8,0,Marcus Christie,2019-10-28 11:54:16-04:00,['1e66dfe72c64465a844db8767cbbe677c6ffdf2a'],0,20,20,20892411,4,,,,12439
43453fd6b4d1e8715eeeb3a75f7b88fc7f8a11ce,0,Dimuthu Wannipurage,2019-10-28 17:17:08-04:00,['bbb43a6bd60867a9086398f9aa4c075a8fea1cd8'],1,21,22,20892433,11,,,,12439
f5780fc86a167f710b3895866e5e7f18d103cfee,0,Marcus Christie,2019-10-29 09:04:17-04:00,['7dcfc50bf61ca301f54e7cb6e3fe09ccf9a31266'],1,1,2,20892435,1,,,,12439
fdf50797fa52d69024d4c9c0471b1abd91218e37,0,Marcus Christie,2019-10-30 10:31:07-04:00,['43453fd6b4d1e8715eeeb3a75f7b88fc7f8a11ce'],0,5,5,20892440,2,,,,12439
f007d5515c6775c762d42658128742b1700768d6,0,Marcus Christie,2019-10-30 11:08:01-04:00,['fdf50797fa52d69024d4c9c0471b1abd91218e37'],2,2,4,20892444,1,,,,12439
59b4afde6bfbea35f890017d756ead90c6d1a69b,0,Marcus Christie,2019-10-30 11:08:29-04:00,['f007d5515c6775c762d42658128742b1700768d6'],0,1,1,20892445,1,0,0,1,12439
cca4dce67c6478481aa441007be6d16254a3c20b,0,Marcus Christie,2019-10-30 11:45:37-04:00,['59b4afde6bfbea35f890017d756ead90c6d1a69b'],2,3,5,20892450,1,,,,12439
fdb503b5836291a9c00b7f414a915e706cc9b2be,0,Marcus Christie,2019-10-30 14:22:44-04:00,['cca4dce67c6478481aa441007be6d16254a3c20b'],0,6,6,20892456,1,,,,12439
dc4a55e632302d075e4fa7d37f3127526627d08a,0,Marcus Christie,2019-10-30 15:20:15-04:00,['fdb503b5836291a9c00b7f414a915e706cc9b2be'],1,8,9,20892465,2,,,,12439
5f9542dcea9bc482e31e179cbf075bcedde673cb,0,Marcus Christie,2019-10-30 17:06:56-04:00,['dc4a55e632302d075e4fa7d37f3127526627d08a'],1,1,2,20892467,1,,,,12439
0af0fbe7914e5b1a8b6ad473d63519aca789f4a8,0,Marcus Christie,2019-10-31 11:25:13-04:00,"['e2c8114d708455f98dd138ca8871954d80b51ef1', '5f9542dcea9bc482e31e179cbf075bcedde673cb']",78,492,570,20893037,42,,,,12439
405f9c99949bee8892291ae67368f8e920f4624d,0,Marcus Christie,2019-10-31 11:42:21-04:00,['0af0fbe7914e5b1a8b6ad473d63519aca789f4a8'],1,1,2,20893039,1,,,,12439
7b194789ed4c7adc32dbb19db16580a3ee8fdf42,0,Marcus Christie,2019-10-31 15:58:09-04:00,['405f9c99949bee8892291ae67368f8e920f4624d'],41,44,85,20893124,1,,,,12439
1cdea6cc928e72fc2ad7dc7d881b046e387fc077,0,Marcus Christie,2019-10-31 16:14:43-04:00,['7b194789ed4c7adc32dbb19db16580a3ee8fdf42'],7,18,25,20893149,1,0,0,0,12439
bb1e5a883a1e4a9aaf8509bd1eae872dc8844dfa,0,Dimuthu Wannipurage,2019-10-31 16:56:56-04:00,['1cdea6cc928e72fc2ad7dc7d881b046e387fc077'],18,122,140,20893289,5,0,1,0.58,12440
deaa9a29b67e9f659ab9579ce557f75f25161b3c,0,Marcus Christie,2019-10-31 17:42:58-04:00,['bb1e5a883a1e4a9aaf8509bd1eae872dc8844dfa'],0,10,10,20893299,1,,,,12440
c9975b29404ef7a9a0fc04000e6e5bd2edfd21a0,0,Marcus Christie,2019-11-01 09:29:09-04:00,['deaa9a29b67e9f659ab9579ce557f75f25161b3c'],8,16,24,20893323,3,0.25,0.25,0.125,12440
01eda63e650f419e7948cbcadfb6009dd31a4817,0,Marcus Christie,2019-11-01 11:37:57-04:00,['c9975b29404ef7a9a0fc04000e6e5bd2edfd21a0'],12,4,16,20893339,5,,,,12440
9bfc94dfaaae88e58d9fc9df32ebedac39520d70,0,Dimuthu Wannipurage,2019-11-01 15:10:00-04:00,['01eda63e650f419e7948cbcadfb6009dd31a4817'],39,53,92,20893431,1,0.214285714,0.214285714,1,12440
b6cf15e94c6b3f4a171f6999a4e51beced9d5da8,0,Dimuthu Wannipurage,2019-11-01 15:15:00-04:00,['9bfc94dfaaae88e58d9fc9df32ebedac39520d70'],7,7,14,20893445,1,,,,12440
bd01d9faf35f927a2982c8192a1bafc2fdb6a338,0,Dimuthu Wannipurage,2019-11-01 15:16:03-04:00,['b6cf15e94c6b3f4a171f6999a4e51beced9d5da8'],4,6,10,20893455,1,,,,12440
7ceaad21ff9eab5294faff49b7717f81574b12d2,0,Marcus Christie,2019-11-02 16:14:04-04:00,['bd01d9faf35f927a2982c8192a1bafc2fdb6a338'],1,1,2,20893457,1,,,,12440
4e10b0043b36cef5f137c68d305bc51631306d0e,0,Eroma Abeysinghe,2019-11-03 02:03:46-05:00,['7ceaad21ff9eab5294faff49b7717f81574b12d2'],0,49,49,20893506,1,,,,12441
e0a2f980ad0a557523efec0d62250b778650a7df,1,Eroma Abeysinghe,2019-11-03 02:10:36-05:00,['4e10b0043b36cef5f137c68d305bc51631306d0e'],0,15,15,20893521,1,,,,12442
76157e25524d59d92476eea6b0fcbc664c8bdfe7,1,Eroma Abeysinghe,2019-11-03 02:23:33-05:00,['e0a2f980ad0a557523efec0d62250b778650a7df'],0,64,64,20893585,2,,,,12444
1ba63921e8793a288aba8f69ba09208dc6bae63d,0,Eroma Abeysinghe,2019-11-03 02:55:02-05:00,['76157e25524d59d92476eea6b0fcbc664c8bdfe7'],1,1,2,20893587,1,,,,12444
5f4937f41c82e4cbc4daff752c2457ef74634b14,0,Eroma Abeysinghe,2019-11-03 02:56:48-05:00,['1ba63921e8793a288aba8f69ba09208dc6bae63d'],5,5,10,20893597,1,,,,12444
12594fd9008772b3b09c8d8142e9179671598cdd,0,Eroma Abeysinghe,2019-11-03 03:06:03-05:00,['5f4937f41c82e4cbc4daff752c2457ef74634b14'],4,4,8,20893605,1,,,,12444
76b1af88b29e37af469a493b4151c030d3459096,0,Eroma Abeysinghe,2019-11-03 03:07:17-05:00,['12594fd9008772b3b09c8d8142e9179671598cdd'],1,1,2,20893607,1,,,,12444
f4d91dddf164a86f5929107f609860782fa244a4,0,Eroma Abeysinghe,2019-11-03 03:11:44-05:00,['76b1af88b29e37af469a493b4151c030d3459096'],4,4,8,20893615,1,,,,12444
6cb475fdcf56c552edb3930c0ae07b5b8ca333dd,0,Eroma Abeysinghe,2019-11-03 03:17:56-05:00,['f4d91dddf164a86f5929107f609860782fa244a4'],0,64,64,20893679,2,,,,12446
c69f77216a1ec30eedbbf257b1a8ef84a3d24d18,0,Eroma Abeysinghe,2019-11-03 03:18:41-05:00,['6cb475fdcf56c552edb3930c0ae07b5b8ca333dd'],0,2,2,20893681,1,,,,12446
a01e8bc4ad2a1153f9cfea77099d6aa30d63016b,0,Eroma Abeysinghe,2019-11-03 03:27:38-05:00,['c69f77216a1ec30eedbbf257b1a8ef84a3d24d18'],0,50,50,20893731,1,,,,12447
135c80e5c255507fd04b5d9a61a73d75cb023eb0,1,Eroma Abeysinghe,2019-11-03 03:27:50-05:00,['a01e8bc4ad2a1153f9cfea77099d6aa30d63016b'],0,15,15,20893746,1,,,,12448
096c823843aae0481a3ff6c257bb2fa297733562,1,Eroma Abeysinghe,2019-11-03 04:09:45-05:00,['135c80e5c255507fd04b5d9a61a73d75cb023eb0'],0,64,64,20893810,2,,,,12450
999f84f4e77c5096ceb7addf10a1c9c322da3770,0,Eroma Abeysinghe,2019-11-03 04:11:48-05:00,['096c823843aae0481a3ff6c257bb2fa297733562'],4,4,8,20893818,1,,,,12450
b96efe461983c1b0aac739037efc468e21c4cc95,0,Eroma Abeysinghe,2019-11-03 04:12:38-05:00,['999f84f4e77c5096ceb7addf10a1c9c322da3770'],1,1,2,20893820,1,,,,12450
cb5a042f98717d13901ce537d6d5f99184148f31,1,Eroma Abeysinghe,2019-11-03 04:26:42-05:00,['b96efe461983c1b0aac739037efc468e21c4cc95'],0,65,65,20893885,2,,,,12452
b2e758a8b0e56f32c2f51dd471ee127c55b04ec6,0,Eroma Abeysinghe,2019-11-03 04:34:43-05:00,['cb5a042f98717d13901ce537d6d5f99184148f31'],0,12,12,20893897,1,,,,12452
866bc75946275974cc0962974b38ee0d393d1673,1,Eroma Abeysinghe,2019-11-03 04:40:58-05:00,['b2e758a8b0e56f32c2f51dd471ee127c55b04ec6'],0,65,65,20893962,2,,,,12454
e9c1699c6b5f4873ae676a2824335ce979382882,0,Eroma Abeysinghe,2019-11-03 05:00:30-05:00,['866bc75946275974cc0962974b38ee0d393d1673'],1,1,2,20893964,1,,,,12454
b4d14f07d6236090d9c7db4d2e4c9b8922da7361,0,Eroma Abeysinghe,2019-11-03 05:05:58-05:00,['e9c1699c6b5f4873ae676a2824335ce979382882'],0,53,53,20894017,1,,,,12455
3d19c5189b2df21aee1d5ecb3dfd633727f21060,1,Eroma Abeysinghe,2019-11-03 05:07:29-05:00,['b4d14f07d6236090d9c7db4d2e4c9b8922da7361'],0,15,15,20894032,1,,,,12456
1867418e6b14bac95b7c790669198a9d367b35dd,0,Eroma Abeysinghe,2019-11-03 05:13:10-05:00,['3d19c5189b2df21aee1d5ecb3dfd633727f21060'],0,49,49,20894081,1,,,,12457
ae53c6b6b7e7a64c3b6b00cb8207f8c1759e592b,1,Eroma Abeysinghe,2019-11-03 05:14:23-05:00,['1867418e6b14bac95b7c790669198a9d367b35dd'],0,15,15,20894096,1,,,,12458
50abaf5061dcc58e544ea27afc4867230e658845,0,Eroma Abeysinghe,2019-11-03 05:19:20-05:00,['ae53c6b6b7e7a64c3b6b00cb8207f8c1759e592b'],0,49,49,20894145,1,,,,12459
f6d0c1ca255290e0aae5c68c52816c0ae20bce40,1,Eroma Abeysinghe,2019-11-03 05:20:42-05:00,['50abaf5061dcc58e544ea27afc4867230e658845'],0,15,15,20894160,1,,,,12460
e61d334050a20211d7d1574ca748e748712b6b85,0,Eroma Abeysinghe,2019-11-03 05:25:23-05:00,['f6d0c1ca255290e0aae5c68c52816c0ae20bce40'],0,2,2,20894162,1,,,,12460
00e26da1785b84a5ccb7896df23e52c9e898e8dd,0,Eroma Abeysinghe,2019-11-03 05:26:03-05:00,['e61d334050a20211d7d1574ca748e748712b6b85'],0,1,1,20894163,1,,,,12460
60bc601cacfec95f1e87d347c74194006515a95d,0,Eroma Abeysinghe,2019-11-03 05:27:13-05:00,['00e26da1785b84a5ccb7896df23e52c9e898e8dd'],0,3,3,20894166,1,,,,12460
12e9033270bf0aaf08bf0d08a517d72cb4df2f49,0,Eroma Abeysinghe,2019-11-03 05:31:55-05:00,['60bc601cacfec95f1e87d347c74194006515a95d'],0,1,1,20894167,1,,,,12460
619445a49040005adf050b7cd735ac9c70653d82,0,Eroma Abeysinghe,2019-11-03 05:35:59-05:00,['12e9033270bf0aaf08bf0d08a517d72cb4df2f49'],0,49,49,20894216,1,,,,12461
eb06386f0eb711b2b79058ccc1a9fa01609ba8e9,1,Eroma Abeysinghe,2019-11-03 05:36:52-05:00,['619445a49040005adf050b7cd735ac9c70653d82'],0,15,15,20894231,1,,,,12462
bf77ccff44c3831ed60ad3a71691587d1fbb5bbe,0,Eroma Abeysinghe,2019-11-03 05:51:47-05:00,['eb06386f0eb711b2b79058ccc1a9fa01609ba8e9'],1,1,2,20894233,1,,,,12462
b57c7eb9747e63669eb7892aca26792a0cb24fcf,0,Eroma Abeysinghe,2019-11-03 06:00:21-05:00,['bf77ccff44c3831ed60ad3a71691587d1fbb5bbe'],1,1,2,20894235,1,,,,12462
4ea1aed4f19d18dcfca0756e8d8bee3191aa4aac,1,Eroma Abeysinghe,2019-11-03 06:02:28-05:00,['b57c7eb9747e63669eb7892aca26792a0cb24fcf'],0,64,64,20894299,2,,,,12464
01ae41514e636d6161dd8be5c251e5c9293eb445,1,Eroma Abeysinghe,2019-11-03 06:10:20-05:00,['4ea1aed4f19d18dcfca0756e8d8bee3191aa4aac'],0,64,64,20894363,2,,,,12466
5272e0cb2237fa5378aecec0202b6889327d6f96,0,Eroma Abeysinghe,2019-11-03 06:15:37-05:00,['01ae41514e636d6161dd8be5c251e5c9293eb445'],0,49,49,20894412,1,,,,12467
373470445c20a249adf1494d931d93e8ad331e3d,1,Eroma Abeysinghe,2019-11-03 06:16:34-05:00,['5272e0cb2237fa5378aecec0202b6889327d6f96'],0,15,15,20894427,1,,,,12468
2fdd13429e10cd91d570d9decee1e9e74c8a903c,1,Eroma Abeysinghe,2019-11-03 06:23:17-05:00,['373470445c20a249adf1494d931d93e8ad331e3d'],0,64,64,20894491,2,,,,12470
2602903d0861faad1ab78246b99be65802547d3b,0,Eroma Abeysinghe,2019-11-03 06:27:52-05:00,['2fdd13429e10cd91d570d9decee1e9e74c8a903c'],0,49,49,20894540,1,,,,12471
8e802b4d19e54dc066bbff464a035d45d54afdd2,1,Eroma Abeysinghe,2019-11-03 06:30:15-05:00,['2602903d0861faad1ab78246b99be65802547d3b'],0,15,15,20894555,1,,,,12472
7db06cc0a774b1eee4bbafc3b56113ff901bb8da,1,Eroma Abeysinghe,2019-11-03 06:35:42-05:00,['8e802b4d19e54dc066bbff464a035d45d54afdd2'],0,64,64,20894619,2,,,,12474
6090d489e5efda22616303661287eb58df96fe35,0,Eroma Abeysinghe,2019-11-03 06:51:08-05:00,['7db06cc0a774b1eee4bbafc3b56113ff901bb8da'],0,49,49,20894668,1,,,,12475
2b9f739772b44c5b09f976336e91bcd6b58cc0ba,1,Eroma Abeysinghe,2019-11-03 06:51:57-05:00,['6090d489e5efda22616303661287eb58df96fe35'],0,15,15,20894683,1,,,,12476
d5ef65639eeae22495059c0822584dfbe28e1c28,0,Eroma Abeysinghe,2019-11-03 06:55:48-05:00,['2b9f739772b44c5b09f976336e91bcd6b58cc0ba'],0,49,49,20894732,1,,,,12477
a970510e30a9e7abde70c06f2ef4f04e810aeee6,1,Eroma Abeysinghe,2019-11-03 06:57:12-05:00,['d5ef65639eeae22495059c0822584dfbe28e1c28'],0,15,15,20894747,1,,,,12478
31797c149580b0b88ea014c11418184c5583cfc6,1,Eroma Abeysinghe,2019-11-03 07:05:02-05:00,['a970510e30a9e7abde70c06f2ef4f04e810aeee6'],0,64,64,20894811,2,,,,12480
4cd3a4ec78ffb5c0b5cacde75dbb2eafe38c652d,0,Eroma Abeysinghe,2019-11-03 07:10:44-05:00,['31797c149580b0b88ea014c11418184c5583cfc6'],0,49,49,20894860,1,,,,12481
a8445944470073d0e44aa7796763a9fe56b4bf3d,1,Eroma Abeysinghe,2019-11-03 07:11:37-05:00,['4cd3a4ec78ffb5c0b5cacde75dbb2eafe38c652d'],0,15,15,20894875,1,,,,12482
3ff60cab266145f018f40755246c2d253380add6,0,Eroma Abeysinghe,2019-11-03 07:16:53-05:00,['a8445944470073d0e44aa7796763a9fe56b4bf3d'],0,64,64,20894939,2,,,,12484
33cbb21b98197c2c46b7746f439ce8fa90ae0475,0,Eroma Abeysinghe,2019-11-03 07:22:25-05:00,['3ff60cab266145f018f40755246c2d253380add6'],0,51,51,20894990,1,,,,12485
18d2356f38d8c39b56db3fbdccca5b356e2495f1,0,Eroma Abeysinghe,2019-11-03 07:23:40-05:00,['33cbb21b98197c2c46b7746f439ce8fa90ae0475'],0,15,15,20895005,1,,,,12486
a28131cb6525d35c06191cbd7a8853d3cfe82f45,0,Eroma Abeysinghe,2019-11-03 07:31:59-05:00,['18d2356f38d8c39b56db3fbdccca5b356e2495f1'],0,51,51,20895056,1,,,,12487
cec78b00970da68594bfd8af20b46caf87fa3808,1,Eroma Abeysinghe,2019-11-03 07:33:27-05:00,['a28131cb6525d35c06191cbd7a8853d3cfe82f45'],14,29,43,20895099,2,,,,12488
6f7c7f71e84609c969f14b50b3be761ae7cc5034,0,Eroma Abeysinghe,2019-11-03 07:41:50-05:00,['cec78b00970da68594bfd8af20b46caf87fa3808'],0,49,49,20895148,1,,,,12489
3a14bf96170dc3e8768505338b03bab3c6273b48,1,Eroma Abeysinghe,2019-11-03 07:42:37-05:00,['6f7c7f71e84609c969f14b50b3be761ae7cc5034'],0,15,15,20895163,1,,,,12490
9afa3b6caf048ffcff96da1f61d5b3f3cb966eba,0,Eroma Abeysinghe,2019-11-03 07:49:13-05:00,['3a14bf96170dc3e8768505338b03bab3c6273b48'],0,49,49,20895212,1,,,,12491
a6bcd5497a9cc094b4d59b506c9bc372dbc842b9,1,Eroma Abeysinghe,2019-11-03 07:50:13-05:00,['9afa3b6caf048ffcff96da1f61d5b3f3cb966eba'],0,15,15,20895227,1,,,,12492
c9e6f9b73ec21fad897d0b15df84c093c0c8be90,0,Eroma Abeysinghe,2019-11-03 07:53:41-05:00,['a6bcd5497a9cc094b4d59b506c9bc372dbc842b9'],3,4,7,20895234,1,,,,12492
8ce1d60f6f739723ef8669f1cea4171e1b441cf6,0,Eroma Abeysinghe,2019-11-03 08:00:31-05:00,['c9e6f9b73ec21fad897d0b15df84c093c0c8be90'],0,48,48,20895282,1,,,,12493
bd933b291328e4f6d6948ce7d2eaa20d5dad8809,1,Eroma Abeysinghe,2019-11-03 08:01:27-05:00,['8ce1d60f6f739723ef8669f1cea4171e1b441cf6'],0,15,15,20895297,1,,,,12494
ba22c39fe3220e6762d85bb178346e2d35e06e93,0,Eroma Abeysinghe,2019-11-03 08:09:33-05:00,['bd933b291328e4f6d6948ce7d2eaa20d5dad8809'],0,48,48,20895345,1,,,,12495
06d8257e8d214524d5f95127818c9e24b9cc2f54,1,Eroma Abeysinghe,2019-11-03 08:11:17-05:00,['ba22c39fe3220e6762d85bb178346e2d35e06e93'],0,15,15,20895360,1,,,,12496
084e54c396203ba4d677db3e83ed1a8cc630b805,0,Marcus Christie,2019-11-03 10:00:23-05:00,['06d8257e8d214524d5f95127818c9e24b9cc2f54'],9,13,22,20895382,2,,,,12496
c310860ad7e013277c9ea25c259fc19d94abd69c,0,Marcus Christie,2019-11-03 12:11:43-05:00,['084e54c396203ba4d677db3e83ed1a8cc630b805'],103,186,289,20895671,41,,,,12498
3a00939c15de90d52cb7a6e06d472642f9422bc8,0,Marcus Christie,2019-11-03 12:27:37-05:00,['c310860ad7e013277c9ea25c259fc19d94abd69c'],0,7,7,20895678,7,,,,12498
8011fd9180f5e84786995c9d03065635fa5c8790,0,Marcus Christie,2019-11-03 13:21:16-05:00,['3a00939c15de90d52cb7a6e06d472642f9422bc8'],6,8,14,20895692,6,,,,12498
9858de52a56ddc62c2c0fb8754117b776d41a07f,0,Marcus Christie,2019-11-03 17:23:35-05:00,['8011fd9180f5e84786995c9d03065635fa5c8790'],1,4,5,20895697,2,,,,12498
f0d94cde460147b2fbbd1ad1d047ea20d49a7d4b,0,Marcus Christie,2019-11-03 17:24:11-05:00,['9858de52a56ddc62c2c0fb8754117b776d41a07f'],1,3,4,20895701,1,,,,12498
fd3d04e20142840e6da21bd87f1efa5e1d68be95,0,Marcus Christie,2019-11-03 18:29:53-05:00,['f0d94cde460147b2fbbd1ad1d047ea20d49a7d4b'],24,9,33,20895734,5,,,,12498
449b75813188fdb31f0aa2866ca45b9200e51b17,0,Marcus Christie,2019-11-03 18:30:50-05:00,['fd3d04e20142840e6da21bd87f1efa5e1d68be95'],23,4,27,20895761,4,,,,12498
6cc2a867a4d67341f66d57653c8be1216e302144,0,Marcus Christie,2019-11-03 21:03:56-05:00,['449b75813188fdb31f0aa2866ca45b9200e51b17'],1,20,21,20895782,1,,,,12498
9aa2b2c2331b467a8cb5409298e6544311b25c63,0,Marcus Christie,2019-11-03 23:11:36-05:00,['6cc2a867a4d67341f66d57653c8be1216e302144'],11,11,22,20895804,7,,,,12498
772df3ce5cd32b6a8879a61005ab61d950e90be3,0,Marcus Christie,2019-11-04 00:46:23-05:00,['9aa2b2c2331b467a8cb5409298e6544311b25c63'],0,1,1,20895805,1,,,,12498
1dd965ca2f17f7cb0d23730c0aec8430b2ea458e,0,Marcus Christie,2019-11-04 07:57:53-05:00,['772df3ce5cd32b6a8879a61005ab61d950e90be3'],1,1,2,20895807,1,,,,12498
240a55b5544d69b97fd61968783f93ac1e426342,0,Marcus Christie,2019-11-04 08:13:04-05:00,['f5780fc86a167f710b3895866e5e7f18d103cfee'],4,4,8,20895815,1,,,,12498
48178276141f7df3fea90c1466a6b196ba2d4bf8,0,Dimuthu Wannipurage,2019-11-04 11:29:51-05:00,['1dd965ca2f17f7cb0d23730c0aec8430b2ea458e'],8,4,12,20895827,1,0,0,0,12498
54dad18b051a2deff62e97491f8c1182b670f8f0,0,Marcus Christie,2019-11-04 12:06:28-05:00,['48178276141f7df3fea90c1466a6b196ba2d4bf8'],4,4,8,20895835,1,,,,12498
69cd2e645d10f6149d5b8b22a28674c22d81ef81,0,Marcus Christie,2019-11-04 12:47:30-05:00,['54dad18b051a2deff62e97491f8c1182b670f8f0'],1,1,2,20895837,1,,,,12498
c5e8afd05357aad86097afee21668f4e1559ac17,0,Dimuthu Wannipurage,2019-11-04 14:53:49-05:00,['69cd2e645d10f6149d5b8b22a28674c22d81ef81'],0,1,1,20895838,1,,,,12498
bee51dbe02e83656037f2183cd5c52f4cba59fd6,0,Dimuthu Wannipurage,2019-11-04 15:07:18-05:00,['c5e8afd05357aad86097afee21668f4e1559ac17'],0,3,3,20895841,1,0,0,1,12498
19f5fdeae719c248cb68f346ae00bb75be44f9c8,1,Marcus Christie,2019-11-05 09:51:15-05:00,['bee51dbe02e83656037f2183cd5c52f4cba59fd6'],0,2,2,20895843,1,,,,12498
ab4e01c12c7b8c998fd9224dfc69f640c2f010a3,0,Eroma Abeysinghe,2019-11-05 10:24:19-05:00,['bee51dbe02e83656037f2183cd5c52f4cba59fd6'],1,1,2,20895845,1,,,,12498
85ca2b28d373d2c9f3bb82f74fe222b41cb7726e,0,Marcus Christie,2019-11-05 10:35:31-05:00,"['19f5fdeae719c248cb68f346ae00bb75be44f9c8', 'ab4e01c12c7b8c998fd9224dfc69f640c2f010a3']",1,1,2,20895847,1,,,,12498
e5d6c663bd983b3e7071ba54c53e72426b3d4738,0,Marcus Christie,2019-11-05 10:43:59-05:00,['85ca2b28d373d2c9f3bb82f74fe222b41cb7726e'],1,1,2,20895849,1,,,,12498
3ef4916c38f1449737a6c4b922bbd963d0476e9c,0,Marcus Christie,2019-11-05 12:00:05-05:00,['e5d6c663bd983b3e7071ba54c53e72426b3d4738'],1,1,2,20895851,1,,,,12498
37cdb64091e662cdcf8dd1c73383761cba8d62f8,0,Marcus Christie,2019-11-05 14:29:11-05:00,['3ef4916c38f1449737a6c4b922bbd963d0476e9c'],1,1,2,20895853,1,,,,12498
3523a3251724dfe799fbe03bdf2c18cb23083069,0,Marcus Christie,2019-11-05 16:26:50-05:00,['37cdb64091e662cdcf8dd1c73383761cba8d62f8'],0,0,0,20895853,4,,,,12498
03221e616b206dc55403bf3c14f381a077580618,0,Marcus Christie,2019-11-05 17:57:28-05:00,['3523a3251724dfe799fbe03bdf2c18cb23083069'],2,2,4,20895857,5,,,,12498
2c540417a04f441a18d18be758ada79440059f10,0,Marcus Christie,2019-11-05 18:03:56-05:00,['03221e616b206dc55403bf3c14f381a077580618'],0,2,2,20895859,1,,,,12498
f6911d76e3b7e72ba4b25c7440bd1caea8247d95,0,Marcus Christie,2019-11-05 18:20:45-05:00,['2c540417a04f441a18d18be758ada79440059f10'],6,3,9,20895868,3,,,,12498
46ca6e996e1b3fc6d062256cbfaf713756ee10f5,0,Isuru Ranawaka,2019-11-06 22:05:22-05:00,['f6911d76e3b7e72ba4b25c7440bd1caea8247d95'],2,11,13,20895881,2,,,,12498
76c6ee4e3dc28341e790b800526e1ff601b2edae,0,Marcus Christie,2019-11-07 08:58:54-05:00,['f6911d76e3b7e72ba4b25c7440bd1caea8247d95'],2,2,4,20895885,1,,,,12498
58cf23c20246d5b80220a00a3070cec43f3f2e55,0,Marcus Christie,2019-11-08 15:06:35-05:00,['76c6ee4e3dc28341e790b800526e1ff601b2edae'],0,1,1,20895886,1,0,0,0,12498
f88117bdf426f394e538d1bdf2b6f30b52a3b4bc,0,Marcus Christie,2019-11-08 17:02:51-05:00,['58cf23c20246d5b80220a00a3070cec43f3f2e55'],8,112,120,20896006,6,0.607142857,1,1,12499
f025f12142d0bab96adfa2ed0c19dfb5ca71defc,0,Marcus Christie,2019-11-11 15:47:00-05:00,['f88117bdf426f394e538d1bdf2b6f30b52a3b4bc'],4,4,8,20896014,4,,,,12499
adb440898e5debae4110a5b20ba296c02fa9e0f9,0,Marcus Christie,2019-11-12 18:16:22-05:00,"['240a55b5544d69b97fd61968783f93ac1e426342', 'f025f12142d0bab96adfa2ed0c19dfb5ca71defc']",245,2857,3102,20899116,129,,,,12499
cd54debe60a7afc295f7acf9c114ef845a0ffe18,0,Eroma Abeysinghe,2019-11-13 15:46:51-05:00,['f025f12142d0bab96adfa2ed0c19dfb5ca71defc'],0,55,55,20899171,1,,,,12500
1ecbef9b421bffe448980b4545f770abcce73864,0,Eroma Abeysinghe,2019-11-13 15:50:27-05:00,['cd54debe60a7afc295f7acf9c114ef845a0ffe18'],13,13,26,20899197,1,,,,12500
07740da45de1c4cd6abf7e890f54cdad91087361,0,Eroma Abeysinghe,2019-11-13 15:52:29-05:00,['1ecbef9b421bffe448980b4545f770abcce73864'],0,3,3,20899200,1,,,,12500
000ac9ba78c2f3e90275f857c66239a1d0ff95e9,0,Eroma Abeysinghe,2019-11-13 16:07:49-05:00,['07740da45de1c4cd6abf7e890f54cdad91087361'],3,3,6,20899206,1,,,,12500
672f23da1c69a58d26f1eab6f0250e139071d21a,0,Eroma Abeysinghe,2019-11-13 16:12:00-05:00,['000ac9ba78c2f3e90275f857c66239a1d0ff95e9'],4,4,8,20899214,1,,,,12500
1ba1ef209af8f4c61cdff42d7f296095595bea0f,1,Eroma Abeysinghe,2019-11-13 16:14:06-05:00,['672f23da1c69a58d26f1eab6f0250e139071d21a'],0,15,15,20899229,1,,,,12501
10a843d20a7028f0b39d0069155c2ceb57eafff1,0,Eroma Abeysinghe,2019-11-13 16:38:37-05:00,['1ba1ef209af8f4c61cdff42d7f296095595bea0f'],2,4,6,20899235,1,,,,12501
058c090be0bb8fdd617781c0e5ec39c283d30758,0,Eroma Abeysinghe,2019-11-14 00:45:45-05:00,['10a843d20a7028f0b39d0069155c2ceb57eafff1'],0,1,1,20899236,1,,,,12501
c33ed3530bc77067eb73ca237f2d4727c0e5c200,0,Marcus Christie,2019-11-14 09:00:00-05:00,['058c090be0bb8fdd617781c0e5ec39c283d30758'],1,3,4,20899240,2,,,,12501
050f4b811929137645e5ed938edb89cf6e40b3dd,0,Marcus Christie,2019-11-14 09:36:54-05:00,['c33ed3530bc77067eb73ca237f2d4727c0e5c200'],6,13,19,20899259,1,,,,12501
91a575e96dd2f95bcdc9f193650d66977547bc1d,0,Marcus Christie,2019-11-14 09:56:30-05:00,['050f4b811929137645e5ed938edb89cf6e40b3dd'],3,0,3,20899262,1,,,,12501
74020d86c146d250c41cabaa2831bd762e67243c,0,Eroma Abeysinghe,2019-11-14 12:08:52-05:00,['91a575e96dd2f95bcdc9f193650d66977547bc1d'],1,1,2,20899264,1,,,,12501
0383e92de383f71edbebdc190ac268d9e25a3a1e,0,Eroma Abeysinghe,2019-11-14 13:29:02-05:00,['74020d86c146d250c41cabaa2831bd762e67243c'],4,4,8,20899272,1,,,,12501
8326c082b9886a32431cb17b2af4f47a2f4b4357,0,Eroma Abeysinghe,2019-11-14 16:13:33-05:00,['0383e92de383f71edbebdc190ac268d9e25a3a1e'],4,4,8,20899280,1,,,,12501
18139510fb5be8b241b250c1461556203a54f979,0,Eroma Abeysinghe,2019-11-14 16:20:01-05:00,['8326c082b9886a32431cb17b2af4f47a2f4b4357'],1,1,2,20899282,1,,,,12501
b07d1d03df3fc68097ba49a41baf0559b688fc95,0,Marcus Christie,2019-11-15 14:52:42-05:00,['18139510fb5be8b241b250c1461556203a54f979'],9,206,215,20899497,17,0.28030303,0.318181818,0.984848485,12503
a67592603a4c23319d6ac861cbad5b31d86907db,0,Marcus Christie,2019-11-15 14:54:09-05:00,"['adb440898e5debae4110a5b20ba296c02fa9e0f9', 'b07d1d03df3fc68097ba49a41baf0559b688fc95']",15,294,309,20899806,22,,,,12503
e34f3df875a041ed0a76ae159bc1291f20043523,0,Dimuthu Wannipurage,2019-11-15 16:00:06-05:00,['18139510fb5be8b241b250c1461556203a54f979'],1,1,2,20899808,1,,,,12503
6e216453be11f2d659d8948997b58c51f4bf6d76,0,Marcus Christie,2019-11-18 15:48:45-05:00,['e34f3df875a041ed0a76ae159bc1291f20043523'],0,12,12,20899820,1,,,,12503
e1e0156f6d5d8a6e831fbcc9758994ee8fdc0b4f,0,Eroma Abeysinghe,2019-11-19 17:25:39-05:00,['6e216453be11f2d659d8948997b58c51f4bf6d76'],4,5,9,20899829,1,,,,12503
fd56623e303e579d7974b721ecd7f931498ad502,0,Marcus Christie,2019-11-20 13:05:10-05:00,['a67592603a4c23319d6ac861cbad5b31d86907db'],36,31,67,20899896,5,,,,12504
cf0bb4ba7e840f0346ee4530a7c34528403e316f,0,Marcus Christie,2019-11-20 13:15:41-05:00,['b07d1d03df3fc68097ba49a41baf0559b688fc95'],0,1,1,20899897,1,,,,12504
717616a927ae9816ee01fb7c1f3c90c30fda46b6,0,Marcus Christie,2019-11-20 13:15:53-05:00,"['fd56623e303e579d7974b721ecd7f931498ad502', 'cf0bb4ba7e840f0346ee4530a7c34528403e316f']",0,1,1,20899898,1,,,,12504
500cebd6a5682abbce08e93b9cd839ebc51e14e7,0,Marcus Christie,2019-11-20 13:16:32-05:00,['e1e0156f6d5d8a6e831fbcc9758994ee8fdc0b4f'],0,2,2,20899900,1,,,,12504
c4467de60a609928d77215d404e99015727f9428,0,Marcus Christie,2019-11-20 16:32:35-05:00,['717616a927ae9816ee01fb7c1f3c90c30fda46b6'],0,5,5,20899905,3,,,,12504
4da014f8056ba824675db8a07d3e997192cfaef8,0,Eroma Abeysinghe,2019-11-21 08:20:40-05:00,['500cebd6a5682abbce08e93b9cd839ebc51e14e7'],0,50,50,20899955,1,,,,12505
03f5c88fe626f95783c916831ce54d59598f2274,1,Eroma Abeysinghe,2019-11-21 08:25:31-05:00,['4da014f8056ba824675db8a07d3e997192cfaef8'],0,15,15,20899970,1,,,,12506
6d83679ec5d35250c3469ca5f1c73182ee23348e,0,Eroma Abeysinghe,2019-11-21 08:26:13-05:00,['03f5c88fe626f95783c916831ce54d59598f2274'],0,1,1,20899971,1,,,,12506
945e3fe3ddd61f3092abcf8d088d53c0cff28447,0,Marcus Christie,2019-11-21 10:20:10-05:00,['c4467de60a609928d77215d404e99015727f9428'],11,18,29,20900000,2,0,1,1,12506
8ecf589eaeef743239eefd51b26fbc9d76cb5f84,0,Eroma Abeysinghe,2019-11-21 11:44:02-05:00,['6d83679ec5d35250c3469ca5f1c73182ee23348e'],1,1,2,20900002,1,,,,12506
e4260c1571a9819e21dc1c076e8c2df92446b1f8,0,Eroma Abeysinghe,2019-11-21 14:11:01-05:00,['945e3fe3ddd61f3092abcf8d088d53c0cff28447'],4,4,8,20900010,1,,,,12506
6d356e7b41d1a6df16f1d180597f1d5a03f16fe1,0,Eroma Abeysinghe,2019-11-21 15:46:57-05:00,['e4260c1571a9819e21dc1c076e8c2df92446b1f8'],1,1,2,20900012,1,,,,12506
e17324657487fff7cff3ba7128ac561e7365b3a9,0,Marcus Christie,2019-11-25 12:16:36-05:00,['8ecf589eaeef743239eefd51b26fbc9d76cb5f84'],0,1,1,20900013,1,0,0,1,12506
bd591c4aa891781d12f0a014f2a848516ed268ac,1,Marcus Christie,2019-11-25 16:32:41-05:00,['e17324657487fff7cff3ba7128ac561e7365b3a9'],11,26,37,20900050,1,,,,12506
3409bcf3dd27e1e65c81963cd9e7e531a8f4b924,0,Isuru Ranawaka,2019-11-29 11:42:30-05:00,"['46ca6e996e1b3fc6d062256cbfaf713756ee10f5', '6d356e7b41d1a6df16f1d180597f1d5a03f16fe1']",160,738,898,20900948,71,,,,12506
8d723334d08a2a201042e5bfdd899c5b748ee304,0,Marcus Christie,2019-12-02 13:08:16-05:00,['bd591c4aa891781d12f0a014f2a848516ed268ac'],2,14,16,20900964,2,,,,12506
03b09dd5f0aa8391fb7780845deb8b099fd4ec5a,0,Marcus Christie,2019-12-02 15:07:43-05:00,['8d723334d08a2a201042e5bfdd899c5b748ee304'],0,2,2,20900966,1,,,,12506
997462e906816ea873ceaea40c1e5351c5cd0a06,0,Marcus Christie,2019-12-02 15:08:11-05:00,['03b09dd5f0aa8391fb7780845deb8b099fd4ec5a'],7,7,14,20900980,1,,,,12506
dc219b3f6f9a54b170985bbc82c896b732356af2,0,Marcus Christie,2019-12-02 15:09:04-05:00,['6d356e7b41d1a6df16f1d180597f1d5a03f16fe1'],2,2,4,20900984,2,,,,12506
e38be012ebb12cd6fed9b6472280e6c63153dece,0,Marcus Christie,2019-12-02 15:23:41-05:00,"['dc219b3f6f9a54b170985bbc82c896b732356af2', '997462e906816ea873ceaea40c1e5351c5cd0a06']",17,128,145,20901129,9,,,,12506
5202ce21c7fcb536b48e7f11e4a793ae823287fe,0,Marcus Christie,2019-12-02 16:25:32-05:00,['e17324657487fff7cff3ba7128ac561e7365b3a9'],2,5,7,20901136,3,,,,12506
3a0a89851081df27c391feb5b4f540319e249178,0,Marcus Christie,2019-12-02 16:38:06-05:00,"['5202ce21c7fcb536b48e7f11e4a793ae823287fe', '997462e906816ea873ceaea40c1e5351c5cd0a06']",12,41,53,20901189,3,,,,12506
fdfc572422e0171d35350db3938716b5e95377a3,0,Dimuthu Wannipurage,2019-12-05 13:57:36-05:00,['e38be012ebb12cd6fed9b6472280e6c63153dece'],5,6,11,20901200,6,,,,12506
e6292fdd73fb744be0ad9a88e9972a7a06b89eef,0,Marcus Christie,2019-12-05 14:55:00-05:00,['3a0a89851081df27c391feb5b4f540319e249178'],0,3,3,20901203,1,,,,12506
7cf3726ef8d5c71a53e2d45d05a5ae069d9c728c,0,Marcus Christie,2019-12-05 14:57:47-05:00,['fdfc572422e0171d35350db3938716b5e95377a3'],0,1,1,20901204,1,,,,12506
3cb9347a10ad266613d80910aa16a06b3d28ebcc,0,Dimuthu Wannipurage,2019-12-05 15:04:00-05:00,['cf0bb4ba7e840f0346ee4530a7c34528403e316f'],1,4,5,20901209,1,0,1,0,12506
d3a5318850c73092e4546cfcbba22753ee7c1077,0,Dimuthu Wannipurage,2019-12-05 15:07:03-05:00,"['7cf3726ef8d5c71a53e2d45d05a5ae069d9c728c', '3cb9347a10ad266613d80910aa16a06b3d28ebcc']",1,4,5,20901214,1,,,,12506
0859211fd8bfb8e2168e95d711fd27d83133c939,0,Dimuthu Wannipurage,2019-12-06 15:23:19-05:00,['d3a5318850c73092e4546cfcbba22753ee7c1077'],32,87,119,20901333,4,,,,12506
d08780b44af28543e9b46cf9140f14b021c17298,0,Dimuthu Wannipurage,2019-12-06 15:27:02-05:00,['e6292fdd73fb744be0ad9a88e9972a7a06b89eef'],4,17,21,20901354,2,1,1,1,12506
52379203a1ca1a5491d79d5086e9152e8f6df2cd,0,Dimuthu Wannipurage,2019-12-06 15:27:49-05:00,"['0859211fd8bfb8e2168e95d711fd27d83133c939', 'd08780b44af28543e9b46cf9140f14b021c17298']",6,25,31,20901385,6,,,,12506
5fb5629dfaaf503e1875737c58f703e5cdfad255,0,Dimuthu Wannipurage,2019-12-06 15:47:28-05:00,['52379203a1ca1a5491d79d5086e9152e8f6df2cd'],9,9,18,20901403,9,,,,12506
7b1a2b3525f93a7057325b9df1e7251282e5294f,0,Dimuthu Wannipurage,2019-12-06 16:39:55-05:00,['5fb5629dfaaf503e1875737c58f703e5cdfad255'],5,3,8,20901411,4,,,,12506
ceefe75232f438e7f82b42cde82ea465cf875411,0,Isuru Ranawaka,2019-12-08 20:44:03-05:00,['3409bcf3dd27e1e65c81963cd9e7e531a8f4b924'],8994,583,9577,20910988,213,0.400324149,0.314100486,0.298865478,12515
5209ef37648cac1259b700ff529b65479baad6ba,0,Marcus Christie,2019-12-10 12:57:33-05:00,['3cb9347a10ad266613d80910aa16a06b3d28ebcc'],4,8,12,20911000,1,0,0,1,12515
58669d85929feed4ec394e2549fcb660cd8b8d7f,0,Marcus Christie,2019-12-10 12:58:18-05:00,"['7b1a2b3525f93a7057325b9df1e7251282e5294f', '5209ef37648cac1259b700ff529b65479baad6ba']",4,8,12,20911012,1,,,,12515
33b606a3cd3c5ae514f010235f4df89868a8b39a,0,Isuru Ranawaka,2019-12-11 17:34:15-05:00,['ceefe75232f438e7f82b42cde82ea465cf875411'],225,9585,9810,20920822,20,0.200741198,1,0.118797612,12531
ec6b1faa5db6b0d09caef7c512a2d56e0bc27e6d,0,Isuru Ranawaka,2019-12-11 21:25:01-05:00,['33b606a3cd3c5ae514f010235f4df89868a8b39a'],0,45,45,20920867,1,,,,12531
5fd87545b94994e86324c3cf0fb0c604eab2fb73,0,Isuru Ranawaka,2019-12-11 23:26:26-05:00,['ec6b1faa5db6b0d09caef7c512a2d56e0bc27e6d'],23,339,362,20921229,1,,,,12531
f4b113205ee3a58f8610a34eda404c4c1030b9dc,0,Isuru Ranawaka,2019-12-12 09:35:36-05:00,['5fd87545b94994e86324c3cf0fb0c604eab2fb73'],1,17,18,20921247,4,,,,12531
7a03c56bad498160e01306b88a5f991f7a466b43,0,Isuru Ranawaka,2019-12-12 11:38:55-05:00,['f4b113205ee3a58f8610a34eda404c4c1030b9dc'],31,31,62,20921309,1,,,,12531
8bf1331febf74b6cd9d48b0cf9f4bf83c7faf644,0,Isuru Ranawaka,2019-12-12 11:54:09-05:00,['7a03c56bad498160e01306b88a5f991f7a466b43'],1,9,10,20921319,1,1,1,1,12531
5281ee78856845c4f1a124581392c7729f05e147,0,Isuru Ranawaka,2019-12-12 12:02:59-05:00,['8bf1331febf74b6cd9d48b0cf9f4bf83c7faf644'],4,30,34,20921353,1,,,,12531
a4b362ba56f7325eb7b32c39b69aab159c40c206,0,Isuru Ranawaka,2019-12-12 12:04:45-05:00,['5281ee78856845c4f1a124581392c7729f05e147'],1,1,2,20921355,1,,,,12531
6f9ddb7f5ce7355beb9a776af36b453c08fd6074,0,Isuru Ranawaka,2019-12-12 12:05:58-05:00,['a4b362ba56f7325eb7b32c39b69aab159c40c206'],2,2,4,20921359,1,,,,12531
83da9890f810cfdc9951c27d53bd0a57da3d047f,0,Isuru Ranawaka,2019-12-12 12:07:26-05:00,['6f9ddb7f5ce7355beb9a776af36b453c08fd6074'],2,1,3,20921362,1,,,,12531
f756a8dbabec05649631aed303c7e1a1cc45a189,0,Isuru Ranawaka,2019-12-15 14:01:43-05:00,['83da9890f810cfdc9951c27d53bd0a57da3d047f'],1,0,1,20921363,1,,,,12531
2f9e72daa0f65c2b7c23c8396bbf2ffe487e88c0,0,Marcus Christie,2019-12-17 10:25:37-05:00,['e6292fdd73fb744be0ad9a88e9972a7a06b89eef'],39,186,225,20921588,7,,,,12535
f437d23fda2a79d7db7a2af43f4df30ea0fd4557,0,Marcus Christie,2019-12-17 11:38:18-05:00,['2f9e72daa0f65c2b7c23c8396bbf2ffe487e88c0'],2,172,174,20921762,5,,,,12538
37372c703492ea8c9cd0d6ef47f95a3e9126d5bb,0,Dimuthu Wannipurage,2019-12-31 12:06:16-05:00,['58669d85929feed4ec394e2549fcb660cd8b8d7f'],20,8,28,20921790,2,,,,12538
1d209de5afa8149ef098054afe0a9d514dcf1cf0,0,Dimuthu Wannipurage,2019-12-31 16:44:20-05:00,['37372c703492ea8c9cd0d6ef47f95a3e9126d5bb'],0,7,7,20921797,1,,,,12538
51777de2277dd1b562e34b97fcf1692b52320a2f,0,Dimuthu Wannipurage,2019-12-31 16:45:07-05:00,['1d209de5afa8149ef098054afe0a9d514dcf1cf0'],2,2,4,20921801,2,,,,12538
82139606a0ad46cdd740da5e92bc30196565b027,0,Dimuthu Wannipurage,2020-01-03 13:02:11-05:00,['e6292fdd73fb744be0ad9a88e9972a7a06b89eef'],54,284,338,20922139,7,0,0.971098266,0.774566474,12539
025f2c6cc1b7e7d6ef01d9c1bc64ce215f88c611,0,Dimuthu Wannipurage,2020-01-03 13:03:08-05:00,"['f437d23fda2a79d7db7a2af43f4df30ea0fd4557', '82139606a0ad46cdd740da5e92bc30196565b027']",54,284,338,20922477,7,,,,12539
63f5d6c4ab41cb88acd71a5b9b7ba8213395bc79,0,Dimuthu Wannipurage,2020-01-03 13:06:26-05:00,"['51777de2277dd1b562e34b97fcf1692b52320a2f', '82139606a0ad46cdd740da5e92bc30196565b027']",52,269,321,20922798,7,,,,12539
3cdfc19a8c1f75c67fadb4c7801559ea6915b23f,0,Dimuthu Wannipurage,2020-01-03 14:36:41-05:00,['025f2c6cc1b7e7d6ef01d9c1bc64ce215f88c611'],3,9,12,20922810,2,0,0,1,12539
087aa75f0c30b3c34c7a7d64d48847d913714dcd,0,Dimuthu Wannipurage,2020-01-03 14:37:31-05:00,"['63f5d6c4ab41cb88acd71a5b9b7ba8213395bc79', '3cdfc19a8c1f75c67fadb4c7801559ea6915b23f']",44,367,411,20923221,14,,,,12539
cef36c19a2371a97e3e80c3b927098a3f742d436,0,Marcus Christie,2020-01-03 16:16:10-05:00,['025f2c6cc1b7e7d6ef01d9c1bc64ce215f88c611'],6,20,26,20923247,1,0,1,0,12539
43d7aa32c38dfed13c49b31346223a2884efce52,0,Marcus Christie,2020-01-03 16:16:54-05:00,"['087aa75f0c30b3c34c7a7d64d48847d913714dcd', 'cef36c19a2371a97e3e80c3b927098a3f742d436']",6,20,26,20923273,1,,,,12539
566166da0a0ad59a3186f57e05b0562df2d4d6c8,0,Marcus Christie,2020-01-06 09:29:29-05:00,['025f2c6cc1b7e7d6ef01d9c1bc64ce215f88c611'],0,2,2,20923275,1,,,,12539
0f7b264d65d5062d2e642133c3d12b0af59fdaa1,0,Marcus Christie,2020-01-06 13:25:06-05:00,['cef36c19a2371a97e3e80c3b927098a3f742d436'],0,8,8,20923283,8,,,,12539
87d4cac2a46237fac4ccd330c8e063e00d809d75,0,Marcus Christie,2020-01-06 13:25:52-05:00,"['43d7aa32c38dfed13c49b31346223a2884efce52', '0f7b264d65d5062d2e642133c3d12b0af59fdaa1']",0,8,8,20923291,8,,,,12539
8f09ec2afbc71ee529bf718862f7169fc2b71dc8,0,Dimuthu Wannipurage,2020-01-06 16:10:05-05:00,['82139606a0ad46cdd740da5e92bc30196565b027'],8,10,18,20923309,1,0,1,1,12539
b31abc10ec5913b7cc7a3a39b1574f954cab9aae,0,Dimuthu Wannipurage,2020-01-06 16:11:04-05:00,"['087aa75f0c30b3c34c7a7d64d48847d913714dcd', '8f09ec2afbc71ee529bf718862f7169fc2b71dc8']",8,10,18,20923327,1,,,,12539
eb607086a50ff5410423db7dea3c7bc9ebf5726d,0,Dimuthu Wannipurage,2020-01-06 16:12:05-05:00,"['b31abc10ec5913b7cc7a3a39b1574f954cab9aae', '87d4cac2a46237fac4ccd330c8e063e00d809d75']",6,28,34,20923361,9,,,,12539
d332a5a778247f4b55972fb6918e63bbb8a42e5d,0,Dimuthu Wannipurage,2020-01-06 16:53:53-05:00,['3cdfc19a8c1f75c67fadb4c7801559ea6915b23f'],2,1,3,20923364,1,1,1,0,12539
ccc0648acd53a465bc186cf0edc4d33a00a42041,0,Dimuthu Wannipurage,2020-01-06 16:54:18-05:00,"['eb607086a50ff5410423db7dea3c7bc9ebf5726d', 'd332a5a778247f4b55972fb6918e63bbb8a42e5d']",2,1,3,20923367,1,,,,12539
57262f77ea8b553110a65d9d59338a139c4b30b9,0,Eroma Abeysinghe,2020-01-07 09:29:52-05:00,['566166da0a0ad59a3186f57e05b0562df2d4d6c8'],5,5,10,20923377,1,,,,12539
f2a5f3147bdd04238346f518a4bdbcaeecbbed60,0,Eroma Abeysinghe,2020-01-07 09:30:47-05:00,['57262f77ea8b553110a65d9d59338a139c4b30b9'],1,1,2,20923379,1,,,,12539
38f06446f02c66cd835522e611ca08edb0bdff5c,0,Marcus Christie,2020-01-07 11:22:59-05:00,['f2a5f3147bdd04238346f518a4bdbcaeecbbed60'],1,1,2,20923381,1,,,,12539
8f653a6d53861efddb70f4a950d54e6729beeeab,0,Marcus Christie,2020-01-07 12:39:03-05:00,['38f06446f02c66cd835522e611ca08edb0bdff5c'],0,2,2,20923383,1,0,1,0,12539
98efce7587cbc5680175e5697c7d359cb2c09771,1,Marcus Christie,2020-01-08 16:36:30-05:00,['38f06446f02c66cd835522e611ca08edb0bdff5c'],0,28,28,20923411,2,0.454545455,1,0.909090909,12539
66daa39aa837e8a782385b186404949b66eda9cd,0,Marcus Christie,2020-01-08 16:37:06-05:00,"['ccc0648acd53a465bc186cf0edc4d33a00a42041', '98efce7587cbc5680175e5697c7d359cb2c09771']",5,35,40,20923451,5,,,,12539
8f3b3c595cec5374a6f5d314648a4a49a0b40779,0,Dimuthu Wannipurage,2020-01-09 10:56:00-05:00,"['025f2c6cc1b7e7d6ef01d9c1bc64ce215f88c611', '8f09ec2afbc71ee529bf718862f7169fc2b71dc8']",8,10,18,20923469,1,,,,12539
84a2453d19bc65986f1e76825227052860131ba5,0,Dimuthu Wannipurage,2020-01-09 10:56:20-05:00,"['8f3b3c595cec5374a6f5d314648a4a49a0b40779', 'd332a5a778247f4b55972fb6918e63bbb8a42e5d']",3,8,11,20923480,2,,,,12539
44e2b875717b95060687c0ea3342a6ae94560bb2,0,Dimuthu Wannipurage,2020-01-09 10:57:46-05:00,"['84a2453d19bc65986f1e76825227052860131ba5', '38f06446f02c66cd835522e611ca08edb0bdff5c']",5,7,12,20923492,3,,,,12539
e61712e4c8dc66ea702e48e34f7cb34f839ac488,0,Marcus Christie,2020-01-10 10:39:20-05:00,"['66daa39aa837e8a782385b186404949b66eda9cd', '8f653a6d53861efddb70f4a950d54e6729beeeab']",0,2,2,20923494,1,,,,12539
10635f30b3e2cfc56cee03ab85039776ad3837fb,0,Marcus Christie,2020-01-10 10:41:02-05:00,"['44e2b875717b95060687c0ea3342a6ae94560bb2', '98efce7587cbc5680175e5697c7d359cb2c09771']",0,28,28,20923522,2,,,,12539
33e2d304a40ecae17645853eaa8436d069c36065,0,Marcus Christie,2020-01-10 10:41:12-05:00,"['10635f30b3e2cfc56cee03ab85039776ad3837fb', '8f653a6d53861efddb70f4a950d54e6729beeeab']",0,2,2,20923524,1,,,,12539
bc8ef64eaab6c24e01a9c657db1f7ecf030fbc59,0,Marcus Christie,2020-01-10 10:46:37-05:00,['33e2d304a40ecae17645853eaa8436d069c36065'],1,1,2,20923526,1,,,,12539
c51a5b5b3d91404747595a5e333190622f830232,0,Marcus Christie,2020-01-10 12:52:03-05:00,['98efce7587cbc5680175e5697c7d359cb2c09771'],2,76,78,20923604,16,0,1,0.914893617,12539
cbcbdee38b183ca0df0a2deaf6ddf0e09a47d521,0,Marcus Christie,2020-01-10 12:53:10-05:00,"['e61712e4c8dc66ea702e48e34f7cb34f839ac488', 'c51a5b5b3d91404747595a5e333190622f830232']",2,76,78,20923682,16,,,,12539
2eea2170cb49fe4cec820c56421b91a3eb9e6023,0,Marcus Christie,2020-01-10 14:59:40-05:00,['d332a5a778247f4b55972fb6918e63bbb8a42e5d'],0,19,19,20923701,1,,,,12539
4b2880941abb78b47a53bec106c66d4326268d79,0,Marcus Christie,2020-01-10 15:00:43-05:00,"['cbcbdee38b183ca0df0a2deaf6ddf0e09a47d521', '2eea2170cb49fe4cec820c56421b91a3eb9e6023']",0,19,19,20923720,1,,,,12539
77cb3dd27bef5fc23ac9fa012436d2f0eccc15e1,0,Marcus Christie,2020-01-10 15:04:34-05:00,"['bc8ef64eaab6c24e01a9c657db1f7ecf030fbc59', 'c51a5b5b3d91404747595a5e333190622f830232']",3,77,80,20923800,16,,,,12539
330c29d256ac894b2d1306a1aa92c2de00679bfc,0,Eroma Abeysinghe,2020-01-13 07:48:42-05:00,['77cb3dd27bef5fc23ac9fa012436d2f0eccc15e1'],0,50,50,20923850,1,,,,12540
31ff82e288aff3acb699c646aea4ecd261a61f80,0,Marcus Christie,2020-01-13 16:12:52-05:00,['330c29d256ac894b2d1306a1aa92c2de00679bfc'],2,1,3,20923853,1,,,,12540
55d26131442bf631bb66cc702b1c9f6b50fe2070,0,Eroma Abeysinghe,2020-01-14 01:56:43-05:00,['31ff82e288aff3acb699c646aea4ecd261a61f80'],0,15,15,20923868,1,,,,12541
6130975480efefbf28ebadcd520a8fe630faae25,0,Eroma Abeysinghe,2020-01-14 02:02:59-05:00,['55d26131442bf631bb66cc702b1c9f6b50fe2070'],14,14,28,20923896,1,,,,12541
3dd37b9f3c2b68c3ec96f0506827eb645f1b30d8,0,Eroma Abeysinghe,2020-01-14 02:03:38-05:00,['6130975480efefbf28ebadcd520a8fe630faae25'],0,1,1,20923897,1,,,,12541
9a94dfcfd9cf6a8176caff003673f0bd692a1a95,0,Eroma Abeysinghe,2020-01-14 03:37:31-05:00,['3dd37b9f3c2b68c3ec96f0506827eb645f1b30d8'],3,3,6,20923903,1,,,,12541
bb891f7527a18c161fab5822c5cfd47ea41255e6,0,Marcus Christie,2020-01-14 09:03:11-05:00,['9a94dfcfd9cf6a8176caff003673f0bd692a1a95'],0,2,2,20923905,1,,,,12541
739c1d84e4add988bced8e69c336e61f183ed57d,0,Marcus Christie,2020-01-14 09:07:04-05:00,['bb891f7527a18c161fab5822c5cfd47ea41255e6'],1,1,2,20923907,1,,,,12541
bb63befd93a169a8b2c994dec4955000267a61f6,1,Marcus Christie,2020-01-14 15:21:04-05:00,['739c1d84e4add988bced8e69c336e61f183ed57d'],0,39,39,20923946,1,,,,12541
fcf2b3c9b47e698a6737d27c51db88de76169e6c,0,Marcus Christie,2020-01-14 15:39:44-05:00,['bb63befd93a169a8b2c994dec4955000267a61f6'],2,2,4,20923950,1,,,,12541
e9e25f4eff83b1e2978aa76ff57384f27316d9cd,1,Marcus Christie,2020-01-14 17:15:33-05:00,['fcf2b3c9b47e698a6737d27c51db88de76169e6c'],2,4,6,20923956,1,,,,12541
cea84c382508a6f1f561f7dd07fcc6f2c56afc6f,0,Marcus Christie,2020-01-15 15:37:31-05:00,['739c1d84e4add988bced8e69c336e61f183ed57d'],0,1,1,20923957,1,,,,12541
2aa1e53c5a171b9be40c9abf8332c6463eb65c49,0,Marcus Christie,2020-01-15 15:38:40-05:00,['cea84c382508a6f1f561f7dd07fcc6f2c56afc6f'],173,12,185,20924142,5,,,,12541
6ff811eef053c6f83a34241051012581b4822be6,0,Marcus Christie,2020-01-15 16:16:20-05:00,['e9e25f4eff83b1e2978aa76ff57384f27316d9cd'],8,14,22,20924164,2,,,,12541
89ed4058e00b2484b28f44a767075a0df76c71ca,0,Marcus Christie,2020-01-15 16:16:28-05:00,"['4b2880941abb78b47a53bec106c66d4326268d79', '6ff811eef053c6f83a34241051012581b4822be6']",5,119,124,20924288,7,,,,12541
e120dba685f499b2ebea65f33c21bd4fda637629,0,Marcus Christie,2020-01-16 11:14:04-05:00,['2aa1e53c5a171b9be40c9abf8332c6463eb65c49'],1,1,2,20924290,1,,,,12541
f9acba99c073507847b46fb12ba00385479a97ee,0,Marcus Christie,2020-01-16 15:19:52-05:00,['e120dba685f499b2ebea65f33c21bd4fda637629'],1,1,2,20924292,1,,,,12541
6d6a6b05f2a5c84e3bb47c851fd76cb25c60dccd,0,Eroma Abeysinghe,2020-01-21 12:25:43-05:00,['f9acba99c073507847b46fb12ba00385479a97ee'],4,4,8,20924300,1,,,,12541
7d307e4648d031daa7b87b9476963879362b685b,0,Eroma Abeysinghe,2020-01-21 13:31:21-05:00,['6d6a6b05f2a5c84e3bb47c851fd76cb25c60dccd'],4,4,8,20924308,1,,,,12541
3b69297284e2f3f3223bebf69bae3a366fa27c53,1,Marcus Christie,2020-01-21 14:17:34-05:00,['6ff811eef053c6f83a34241051012581b4822be6'],21,67,88,20924396,3,,,,12542
7445c19853e944214bea9298bc9ebd1c14ccbd39,0,Marcus Christie,2020-01-21 14:17:45-05:00,"['89ed4058e00b2484b28f44a767075a0df76c71ca', '3b69297284e2f3f3223bebf69bae3a366fa27c53']",21,67,88,20924484,3,,,,12542
e57c704516fd155ae82d682ffe838cacf235b5fd,0,Eroma Abeysinghe,2020-01-21 16:43:27-05:00,['7445c19853e944214bea9298bc9ebd1c14ccbd39'],0,68,68,20924552,2,,,,12544
1cdc8eb8b17c62dd887351d34ddf0c28722d5c13,0,Eroma Abeysinghe,2020-01-21 16:44:51-05:00,['e57c704516fd155ae82d682ffe838cacf235b5fd'],13,13,26,20924578,1,,,,12544
74e5be88cc007a6a794b6122eb7e0d74dfcda6fd,0,Eroma Abeysinghe,2020-01-21 16:51:04-05:00,['1cdc8eb8b17c62dd887351d34ddf0c28722d5c13'],14,14,28,20924606,1,,,,12544
a55e3f1b7546a2403cdbff5ef48b0cdbf2903b03,0,Eroma Abeysinghe,2020-01-21 16:52:31-05:00,['74e5be88cc007a6a794b6122eb7e0d74dfcda6fd'],0,3,3,20924609,1,,,,12544
762d0e296b31b83d5537c62863f9db253de858d3,0,Eroma Abeysinghe,2020-01-21 16:53:14-05:00,['a55e3f1b7546a2403cdbff5ef48b0cdbf2903b03'],2,2,4,20924613,1,,,,12544
1442e842b2bf821022efe8937f198510abc91b86,0,Eroma Abeysinghe,2020-01-21 17:00:30-05:00,['762d0e296b31b83d5537c62863f9db253de858d3'],0,1,1,20924614,1,,,,12544
46df96f76480cc847f124decbdcaab7248ebd663,0,Eroma Abeysinghe,2020-01-24 14:52:42-05:00,['7d307e4648d031daa7b87b9476963879362b685b'],0,65,65,20924679,2,,,,12546
67aad5b7b49b5569f20210c849ae3f0bf466b045,0,Eroma Abeysinghe,2020-01-24 14:53:08-05:00,['46df96f76480cc847f124decbdcaab7248ebd663'],1,1,2,20924681,1,,,,12546
6f143c4274421f3bbc3448b8d595571d2f13f337,1,Eroma Abeysinghe,2020-01-24 15:02:45-05:00,['67aad5b7b49b5569f20210c849ae3f0bf466b045'],14,14,28,20924709,1,,,,12546
3aa3dcac1536645ef4823fbadf909a329f4643f7,0,Eroma Abeysinghe,2020-01-24 15:22:07-05:00,['6f143c4274421f3bbc3448b8d595571d2f13f337'],0,1,1,20924710,1,,,,12546
59972bee1c25a61e6dfdb0c4b11f2737f8e403df,0,Marcus Christie,2020-01-24 15:53:52-05:00,['1442e842b2bf821022efe8937f198510abc91b86'],1,4,5,20924715,1,,,,12546
d8aacab1252bc903d48d018c5d3f5ade025dc376,0,Marcus Christie,2020-01-24 16:18:52-05:00,['f9acba99c073507847b46fb12ba00385479a97ee'],0,3,3,20924718,3,,,,12546
1082e09a36843ca482fcc7bf6f63a8626f28cf4e,0,Marcus Christie,2020-01-24 16:19:01-05:00,"['59972bee1c25a61e6dfdb0c4b11f2737f8e403df', 'd8aacab1252bc903d48d018c5d3f5ade025dc376']",175,18,193,20924911,10,,,,12546
e6a927c46dd9bbef07b2977bf6a9a4d0f3fee4c9,0,Marcus Christie,2020-01-24 16:29:55-05:00,['1082e09a36843ca482fcc7bf6f63a8626f28cf4e'],0,3,3,20924914,2,,,,12546
93ab557916708998329c9062f47da49f2019dfa1,0,Eroma Abeysinghe,2020-01-24 16:44:21-05:00,['3aa3dcac1536645ef4823fbadf909a329f4643f7'],3,3,6,20924920,1,,,,12546
f6178d0a1754e9a2e5ef24fa2ad4520595067113,0,Marcus Christie,2020-01-24 17:01:31-05:00,['93ab557916708998329c9062f47da49f2019dfa1'],1,1,2,20924922,1,,,,12546
a2dad122d946b56c48e642f64b1881ceb0be8660,0,Eroma Abeysinghe,2020-01-24 17:09:57-05:00,['93ab557916708998329c9062f47da49f2019dfa1'],1,1,2,20924924,1,,,,12546
10aaaf75cee09eddfacea5d90d7798919f0cde58,0,Eroma Abeysinghe,2020-01-24 17:10:18-05:00,['a2dad122d946b56c48e642f64b1881ceb0be8660'],1,1,2,20924926,1,,,,12546
a78af84d7f1411e2ddb235f8cb144ee867d5ed85,0,Eroma Abeysinghe,2020-01-24 17:10:46-05:00,['10aaaf75cee09eddfacea5d90d7798919f0cde58'],1,1,2,20924928,1,,,,12546
863f2bed267de720e61fc077085cc5967c6eb7d6,0,Eroma Abeysinghe,2020-01-24 17:11:02-05:00,"['a78af84d7f1411e2ddb235f8cb144ee867d5ed85', 'f6178d0a1754e9a2e5ef24fa2ad4520595067113']",1,1,2,20924930,1,,,,12546
d520224412d779e4a66c4dc66ebc263adcf561d7,0,Marcus Christie,2020-01-24 17:16:38-05:00,['e6a927c46dd9bbef07b2977bf6a9a4d0f3fee4c9'],2,2,4,20924934,1,,,,12546
df631a3b98b6945f57e9234baa385e609feba5c5,0,Dimuthu Wannipurage,2020-01-27 12:23:03-05:00,['f6178d0a1754e9a2e5ef24fa2ad4520595067113'],2,4,6,20924940,1,0,0,1,12546
eef825a04bd8757c276a725a0a323624ff0d7c41,0,Eroma Abeysinghe,2020-01-27 12:46:38-05:00,"['863f2bed267de720e61fc077085cc5967c6eb7d6', 'df631a3b98b6945f57e9234baa385e609feba5c5']",2,4,6,20924946,1,,,,12546
1f47bf070efb36fb2464c66430c67b38a36e46f9,0,Eroma Abeysinghe,2020-01-27 20:18:04-05:00,['d520224412d779e4a66c4dc66ebc263adcf561d7'],4,4,8,20924954,1,,,,12546
77b4f242e5f06845d1ae2a0182dc872759142fb8,0,Marcus Christie,2020-01-28 12:36:33-05:00,['df631a3b98b6945f57e9234baa385e609feba5c5'],0,61,61,20925015,2,,,,12547
7f606b4fc58dcb72bf3be5be4772a7cd57c1ea54,0,Marcus Christie,2020-01-28 12:36:39-05:00,"['1f47bf070efb36fb2464c66430c67b38a36e46f9', '77b4f242e5f06845d1ae2a0182dc872759142fb8']",11,140,151,20925166,9,,,,12547
43f10d3c3403b9178fd34b340288831af98b610c,0,Marcus Christie,2020-01-28 14:50:15-05:00,['7f606b4fc58dcb72bf3be5be4772a7cd57c1ea54'],0,2,2,20925168,1,,,,12547
424a4cf58f36f144a9cfc8e3e846e26a9fce33a5,0,Eroma Abeysinghe,2020-01-28 15:05:55-05:00,['43f10d3c3403b9178fd34b340288831af98b610c'],3,3,6,20925174,1,,,,12547
55ae6c02b759c2cb8cf490458339103470f5a7d0,0,Eroma Abeysinghe,2020-01-28 15:05:56-05:00,['424a4cf58f36f144a9cfc8e3e846e26a9fce33a5'],3,3,6,20925180,1,,,,12547
e6630c81e8dab4b36d25f383b3a5c34baf8bd8e3,0,Eroma Abeysinghe,2020-01-28 15:05:56-05:00,['55ae6c02b759c2cb8cf490458339103470f5a7d0'],3,3,6,20925186,1,,,,12547
ad5ce3b7e65167c4b3b76ffe13b5f189bf7e6a46,0,Eroma Abeysinghe,2020-01-28 15:05:56-05:00,['e6630c81e8dab4b36d25f383b3a5c34baf8bd8e3'],1,3,4,20925190,1,,,,12547
3a17b0f79e8bc1270e86bca017016b33b93d8bcb,0,Eroma Abeysinghe,2020-01-28 17:13:04-05:00,"['eef825a04bd8757c276a725a0a323624ff0d7c41', '77b4f242e5f06845d1ae2a0182dc872759142fb8']",0,61,61,20925251,2,,,,12547
8dac096a97d2a034403bae6251d45f2f1b0b29a2,0,Eroma Abeysinghe,2020-01-28 17:13:46-05:00,['3a17b0f79e8bc1270e86bca017016b33b93d8bcb'],4,4,8,20925259,1,,,,12547
a039d05dbbeb69eadcfab1eb593aa9784ba48f07,0,Dimuthu Wannipurage,2020-01-29 09:51:32-05:00,['8dac096a97d2a034403bae6251d45f2f1b0b29a2'],0,9,9,20925268,3,1,1,1,12547
594f7b7c7d77fa7f80bc9dcc6ea5b7e814e4ac19,0,Marcus Christie,2020-01-29 15:12:32-05:00,['a039d05dbbeb69eadcfab1eb593aa9784ba48f07'],0,89,89,20925357,2,,,,12548
205301dd1e4a9063b28636d69d62d7224218dbf9,0,Eroma Abeysinghe,2020-01-29 23:05:33-05:00,['594f7b7c7d77fa7f80bc9dcc6ea5b7e814e4ac19'],0,50,50,20925407,1,,,,12549
a01fae3c99a6494e08dfcef5f8cd0529b8736a03,1,Eroma Abeysinghe,2020-01-29 23:12:55-05:00,['205301dd1e4a9063b28636d69d62d7224218dbf9'],0,15,15,20925422,1,,,,12550
7c6024b4a636ac9057d6618aa2fac81166083b03,0,Eroma Abeysinghe,2020-01-29 23:15:00-05:00,['a01fae3c99a6494e08dfcef5f8cd0529b8736a03'],1,1,2,20925424,1,,,,12550
de1f1b809a9040d9bdcc46a91bbb0d2ee451c660,0,Eroma Abeysinghe,2020-01-29 23:16:45-05:00,['7c6024b4a636ac9057d6618aa2fac81166083b03'],0,1,1,20925425,1,,,,12550
4bd6725ad0139ee2c0169c1165ef76955b5705c9,0,Eroma Abeysinghe,2020-01-29 23:44:02-05:00,['de1f1b809a9040d9bdcc46a91bbb0d2ee451c660'],1,1,2,20925427,1,,,,12550
81259e71b1730dddfb011eb3f697f13dbcb58a4c,0,Eroma Abeysinghe,2020-01-30 00:38:23-05:00,['4bd6725ad0139ee2c0169c1165ef76955b5705c9'],1,1,2,20925429,1,,,,12550
1815459678dd6135350169db3844a4bb8847378b,0,Eroma Abeysinghe,2020-01-30 08:39:36-05:00,['81259e71b1730dddfb011eb3f697f13dbcb58a4c'],3,3,6,20925435,1,,,,12550
07af7da9cec09fee1545cc330e1e98b4850dcc92,0,Eroma Abeysinghe,2020-01-30 08:53:19-05:00,['1815459678dd6135350169db3844a4bb8847378b'],1,1,2,20925437,1,,,,12550
334e72cb51793ff61b0fcf001dc10974bbbc23e5,0,Marcus Christie,2020-01-30 13:10:12-05:00,['07af7da9cec09fee1545cc330e1e98b4850dcc92'],0,2,2,20925439,1,,,,12550
a2718ab52039ca3bb0122a12ca14e82fca4ae55a,0,Marcus Christie,2020-01-30 15:36:21-05:00,['334e72cb51793ff61b0fcf001dc10974bbbc23e5'],2,5,7,20925446,1,,,,12550
73ca271c35e9472054ded26ca2b68df7a5e407ca,0,Marcus Christie,2020-01-30 15:36:29-05:00,"['ad5ce3b7e65167c4b3b76ffe13b5f189bf7e6a46', 'a2718ab52039ca3bb0122a12ca14e82fca4ae55a']",6,175,181,20925627,11,,,,12550
fcb5ecb67955a3a1301e074e8643e131f51bda72,0,Isuru Ranawaka,2020-01-30 17:02:11-05:00,['f756a8dbabec05649631aed303c7e1a1cc45a189'],59,114126,114185,21039812,195,0.268578664,0.348907882,0.752567268,12729
ca9671ddbe058d2bc7473985f2542561377c7d1a,0,Marcus Christie,2020-01-31 16:07:28-05:00,['73ca271c35e9472054ded26ca2b68df7a5e407ca'],1,13,14,21039826,5,,,,12729
5bb160fe205827b116cda59cc24653e8f9174048,0,Marcus Christie,2020-01-31 16:21:36-05:00,['ca9671ddbe058d2bc7473985f2542561377c7d1a'],2,3,5,21039831,2,,,,12729
2ed6874d5d10f9cda6ea89b87abecc35bc906942,0,Isuru Ranawaka,2020-01-31 16:25:33-05:00,['fcb5ecb67955a3a1301e074e8643e131f51bda72'],0,199,199,21040030,2,,,,12731
7d5e0a71e559b5262ef8158743418173651b5f82,0,Marcus Christie,2020-02-04 10:37:05-05:00,['a2718ab52039ca3bb0122a12ca14e82fca4ae55a'],4,4,8,21040038,1,,,,12731
63367e6acb87ceed2c467bd3dddfde2b9d472aa2,0,GitHub,2020-02-04 14:57:58-05:00,"['2ed6874d5d10f9cda6ea89b87abecc35bc906942', '5bb160fe205827b116cda59cc24653e8f9174048']",226,1498,1724,21041762,114,,,,12731
cf3368b34c1fa2f09b629d21c1e6f0e65c7e80de,0,Eroma Abeysinghe,2020-02-05 10:31:26-05:00,['7d5e0a71e559b5262ef8158743418173651b5f82'],0,2,2,21041764,1,,,,12731
2b79774604faaeb33ce325686c3a8b9adcdca889,0,Eroma Abeysinghe,2020-02-05 11:00:53-05:00,['cf3368b34c1fa2f09b629d21c1e6f0e65c7e80de'],0,50,50,21041814,1,,,,12732
a98ffa4b20e529351bade1ffe48558e893f8388e,0,Eroma Abeysinghe,2020-02-05 11:08:55-05:00,['2b79774604faaeb33ce325686c3a8b9adcdca889'],0,1,1,21041815,1,,,,12732
44148a13c1eb7968bcecb5b7d18b24d0b9687c22,1,Eroma Abeysinghe,2020-02-05 11:09:11-05:00,['a98ffa4b20e529351bade1ffe48558e893f8388e'],0,15,15,21041830,1,,,,12733
c1f1928de9692a48c00c522dae6e9486c1b5ab09,0,Eroma Abeysinghe,2020-02-05 11:48:05-05:00,['44148a13c1eb7968bcecb5b7d18b24d0b9687c22'],4,4,8,21041838,1,,,,12733
38153cacb039d33bb26a3cbe9c4423a28e7c8c75,0,Eroma Abeysinghe,2020-02-05 11:50:58-05:00,['c1f1928de9692a48c00c522dae6e9486c1b5ab09'],1,1,2,21041840,1,,,,12733
074d8d63c1728678ec9ec68e583406036ea36b61,0,GitHub,2020-02-06 09:36:17-05:00,"['5bb160fe205827b116cda59cc24653e8f9174048', '63367e6acb87ceed2c467bd3dddfde2b9d472aa2']",8998,124632,133630,21175470,413,,,,12733
363a075e3681bdd28173c2a56d8bca0c2f9d8f51,0,Marcus Christie,2020-02-06 09:53:25-05:00,['074d8d63c1728678ec9ec68e583406036ea36b61'],1,1,2,21175472,1,,,,12733
4e2bbd7eb75c7a4fe6e84ba3f7065c258d471535,0,Marcus Christie,2020-02-06 10:13:15-05:00,['363a075e3681bdd28173c2a56d8bca0c2f9d8f51'],1,1,2,21175474,1,,,,12733
74aa58d435523bfb0595e6b750fc45f844af4465,0,Marcus Christie,2020-02-10 09:51:06-05:00,['38153cacb039d33bb26a3cbe9c4423a28e7c8c75'],1,1,2,21175476,1,,,,12733
5ea7267b2ae02e3600344a59d836bca7dd92e7ef,0,eroma2014,2020-02-10 10:19:48-05:00,['38153cacb039d33bb26a3cbe9c4423a28e7c8c75'],0,2,2,21175478,1,,,,12733
4030ab29a46a6e4a3d7de7ff127ff23fb89461e1,0,Marcus Christie,2020-02-10 10:24:03-05:00,"['74aa58d435523bfb0595e6b750fc45f844af4465', '5ea7267b2ae02e3600344a59d836bca7dd92e7ef']",0,2,2,21175480,1,,,,12733
895bba92136668760e0300375341de62f4c5a1a9,0,Marcus Christie,2020-02-10 14:33:49-05:00,"['4030ab29a46a6e4a3d7de7ff127ff23fb89461e1', '3b69297284e2f3f3223bebf69bae3a366fa27c53']",3,96,99,21175579,4,,,,12733
dee5cc924e431cd1979893d9850f3be5e57aed1a,0,Isuru Ranawaka,2020-02-13 15:19:17-05:00,['2ed6874d5d10f9cda6ea89b87abecc35bc906942'],62,605,667,21176246,27,1,1,0.353658537,12742
52445a2f49094c2dce8878b4743cec79aadc85d5,0,Isuru Ranawaka,2020-02-13 15:20:13-05:00,"['dee5cc924e431cd1979893d9850f3be5e57aed1a', '63367e6acb87ceed2c467bd3dddfde2b9d472aa2']",226,1498,1724,21177970,114,,,,12742
2e003385c0407a7b5cd661f8047dcbdd7957b9ee,0,GitHub,2020-02-13 15:22:40-05:00,"['4e2bbd7eb75c7a4fe6e84ba3f7065c258d471535', '52445a2f49094c2dce8878b4743cec79aadc85d5']",62,605,667,21178637,27,,,,12742
1ec128abd532412fbda357aee26681a7d58358c4,0,Marcus Christie,2020-02-18 15:41:35-05:00,['895bba92136668760e0300375341de62f4c5a1a9'],3,10,13,21178650,3,,,,12742
49930683ce2ec4bf6e4ae2e574ac2a6ff773f276,0,Marcus Christie,2020-02-18 16:01:46-05:00,['1ec128abd532412fbda357aee26681a7d58358c4'],0,2,2,21178652,1,,,,12742
531a743067118f6f75e0a64d313be68f9c565ba7,0,eroma2014,2020-02-19 09:02:18-05:00,['49930683ce2ec4bf6e4ae2e574ac2a6ff773f276'],1,1,2,21178654,1,,,,12742
050a304df1ab705dce4aa7a2e7b61e8f118e2446,0,Marcus Christie,2020-02-19 10:31:58-05:00,['531a743067118f6f75e0a64d313be68f9c565ba7'],2,0,2,21178656,1,,,,12742
3ea326faf318390b4f7475af420ace0ff96d8a24,0,Marcus Christie,2020-02-19 12:59:01-05:00,['050a304df1ab705dce4aa7a2e7b61e8f118e2446'],0,11,11,21178667,1,,,,12742
253a96b60b82df7cdceb35a265eaa90b7988eb22,0,Marcus Christie,2020-02-19 12:59:11-05:00,"['2e003385c0407a7b5cd661f8047dcbdd7957b9ee', '3ea326faf318390b4f7475af420ace0ff96d8a24']",11,99,110,21178777,12,,,,12742
38fe735aa2fe9e312c90cfa15b5b136c413b583e,0,Marcus Christie,2020-02-20 12:05:21-05:00,['3ea326faf318390b4f7475af420ace0ff96d8a24'],2,2,4,21178781,1,,,,12742
08ddca63eef15dfcc6006705b7e079c085dd44bc,0,Marcus Christie,2020-02-20 17:45:18-05:00,['38fe735aa2fe9e312c90cfa15b5b136c413b583e'],1,1,2,21178783,1,,,,12742
eba6ca3f28b70ecaa7bff40155d2cb581c6218ac,0,Dimuthu Wannipurage,2020-02-21 01:25:57-05:00,['08ddca63eef15dfcc6006705b7e079c085dd44bc'],10,5,15,21178798,1,1,1,0,12742
9f1173db463e56a417c87b3ed7f07ab7a34d35d5,0,eroma2014,2020-02-24 08:30:30-05:00,['eba6ca3f28b70ecaa7bff40155d2cb581c6218ac'],0,50,50,21178848,1,,,,12743
9d9f8f3980dbb400a84116a797f3a2b401ad2abe,1,eroma2014,2020-02-24 08:35:02-05:00,['9f1173db463e56a417c87b3ed7f07ab7a34d35d5'],0,15,15,21178863,1,,,,12744
7bdb75e93fbd568aa628814af78f889878934f1b,0,eroma2014,2020-02-24 08:35:53-05:00,['9d9f8f3980dbb400a84116a797f3a2b401ad2abe'],0,1,1,21178864,1,,,,12744
151a1232c3b78205240eb1341263c1d458e18c1a,0,eroma2014,2020-02-24 10:38:29-05:00,['7bdb75e93fbd568aa628814af78f889878934f1b'],4,4,8,21178872,1,,,,12744
64c9e5ca3b3e4fc9d607c70f0fcb2655484c1313,0,eroma2014,2020-02-24 12:35:06-05:00,['253a96b60b82df7cdceb35a265eaa90b7988eb22'],0,55,55,21178927,1,,,,12745
fc6c93d0d89b45b43f197ca0340a36b09f589ab0,0,eroma2014,2020-02-24 15:35:35-05:00,['64c9e5ca3b3e4fc9d607c70f0fcb2655484c1313'],0,15,15,21178942,1,,,,12746
74bdf1c093d87edfdee70b259bb881634d4cfc69,0,eroma2014,2020-02-24 15:36:59-05:00,['fc6c93d0d89b45b43f197ca0340a36b09f589ab0'],0,1,1,21178943,1,,,,12746
e8b7e3b4be3c642a0b0a04888a99164631bcb553,0,Marcus Christie,2020-02-25 12:04:56-05:00,['151a1232c3b78205240eb1341263c1d458e18c1a'],1,1,2,21178945,1,,,,12746
6e92079b053902d34befc1ee1d04425ad737af9f,0,Marcus Christie,2020-02-25 12:05:19-05:00,"['74bdf1c093d87edfdee70b259bb881634d4cfc69', 'e8b7e3b4be3c642a0b0a04888a99164631bcb553']",13,74,87,21179032,6,,,,12746
2add5d38667e5d4b7aad25dc2fff1c2b2ded0f11,0,Isuru Ranawaka,2020-02-25 22:01:48-05:00,['52445a2f49094c2dce8878b4743cec79aadc85d5'],12,6504,6516,21185548,35,0.428506582,0.58284158,0.76758965,12767
ead3c4df2daaace7b440c41a9b73fcded105dd73,0,Isuru Ranawaka,2020-02-25 22:02:48-05:00,['2add5d38667e5d4b7aad25dc2fff1c2b2ded0f11'],13,23,36,21185584,2,,,,12767
e9a25d2000dceb2d65dfdceda3f53898646a34e1,0,GitHub,2020-02-25 22:07:53-05:00,"['6e92079b053902d34befc1ee1d04425ad737af9f', 'ead3c4df2daaace7b440c41a9b73fcded105dd73']",24,6526,6550,21192134,36,,,,12767
96d251bd9744ff1065557b21bfadaee8ac851a7d,0,Marcus Christie,2020-02-26 10:29:39-05:00,['e8b7e3b4be3c642a0b0a04888a99164631bcb553'],1,1,2,21192136,1,,,,12767
20827880702161160d023c5372a9831ef985d2f4,0,Marcus Christie,2020-02-26 10:30:03-05:00,"['e9a25d2000dceb2d65dfdceda3f53898646a34e1', '96d251bd9744ff1065557b21bfadaee8ac851a7d']",1,1,2,21192138,1,,,,12767
cbd1bfe36db817da0b5894f386f453044ef9a5f6,0,Marcus Christie,2020-02-26 10:30:46-05:00,['20827880702161160d023c5372a9831ef985d2f4'],3,0,3,21192141,1,,,,12767
42533b7da62d255f158bb5dda8b2fbe86e6a15e0,0,eroma2014,2020-02-26 12:49:32-05:00,['e9a25d2000dceb2d65dfdceda3f53898646a34e1'],0,1,1,21192142,1,,,,12767
686036bc30ca03efb760219a380fa2c2ae9aa6ca,0,eroma2014,2020-02-26 12:49:54-05:00,"['42533b7da62d255f158bb5dda8b2fbe86e6a15e0', 'cbd1bfe36db817da0b5894f386f453044ef9a5f6']",4,1,5,21192147,2,,,,12767
098c7af594b2558d2c209c5e22583ac5e01425e1,0,Marcus Christie,2020-02-27 09:41:01-05:00,['686036bc30ca03efb760219a380fa2c2ae9aa6ca'],4,6,10,21192157,1,,,,12767
de2cc48a1e3cf2a372b025e6680dc5f7524ed542,0,Marcus Christie,2020-02-27 10:00:01-05:00,['098c7af594b2558d2c209c5e22583ac5e01425e1'],0,13,13,21192170,1,,,,12767
33fc6fce25e6dd739439ead460912a9b10c43b8f,0,eroma2014,2020-03-02 09:23:01-05:00,['96d251bd9744ff1065557b21bfadaee8ac851a7d'],1,1,2,21192172,1,,,,12767
cc9da4a473ac10a285a8cdcc3568ab7c6febd657,0,Dimuthu Wannipurage,2020-03-03 12:03:15-05:00,['33fc6fce25e6dd739439ead460912a9b10c43b8f'],80,132,212,21192384,6,0,0,1,12767
e7d33f427cfa4593ca890eeb9e6a967d4e829d0a,0,Dimuthu Wannipurage,2020-03-03 12:05:30-05:00,"['de2cc48a1e3cf2a372b025e6680dc5f7524ed542', 'cc9da4a473ac10a285a8cdcc3568ab7c6febd657']",81,133,214,21192598,7,,,,12767
23ce8d8507a4d438ebf3fbce1fb6697e3f2821ad,0,Dimuthu Wannipurage,2020-03-03 12:59:23-05:00,['cc9da4a473ac10a285a8cdcc3568ab7c6febd657'],73,73,146,21192744,2,,,,12767
61246f78836167ea9d83292db16c75e01054d105,0,Dimuthu Wannipurage,2020-03-03 12:59:44-05:00,"['e7d33f427cfa4593ca890eeb9e6a967d4e829d0a', '23ce8d8507a4d438ebf3fbce1fb6697e3f2821ad']",73,73,146,21192890,2,,,,12767
39463591b07fa9fe747cbfe925df117e90c4760b,0,Dimuthu Wannipurage,2020-03-03 15:44:53-05:00,['23ce8d8507a4d438ebf3fbce1fb6697e3f2821ad'],18,30,48,21192938,2,0,0,1,12767
dfce1d758104cbe710a36e2b2235b95717493c31,0,Dimuthu Wannipurage,2020-03-03 15:46:45-05:00,"['61246f78836167ea9d83292db16c75e01054d105', '39463591b07fa9fe747cbfe925df117e90c4760b']",18,30,48,21192986,2,,,,12767
6736394d855731c21d2bb64f53308ac18fa8f28a,0,Marcus Christie,2020-03-04 16:48:37-05:00,['dfce1d758104cbe710a36e2b2235b95717493c31'],1,1,2,21192988,1,,,,12767
6a3a13840ef5d3e38b7ba9870a796c13880c0433,0,Marcus Christie,2020-03-05 10:13:17-05:00,['33fc6fce25e6dd739439ead460912a9b10c43b8f'],0,19,19,21193007,11,,,,12767
3dcb0b8e94b0677e7442216578820066ab1aff93,0,Marcus Christie,2020-03-05 10:13:26-05:00,"['6736394d855731c21d2bb64f53308ac18fa8f28a', '6a3a13840ef5d3e38b7ba9870a796c13880c0433']",0,19,19,21193026,11,,,,12767
c84d5f4e7889710125a97fb1a70632c4b3137df3,0,Marcus Christie,2020-03-10 18:18:35-04:00,['6a3a13840ef5d3e38b7ba9870a796c13880c0433'],3,47,50,21193076,3,,,,12767
a5e3b2648f5702365dbee1985b812da81de050ba,0,Marcus Christie,2020-03-10 18:19:35-04:00,"['3dcb0b8e94b0677e7442216578820066ab1aff93', 'c84d5f4e7889710125a97fb1a70632c4b3137df3']",3,44,47,21193123,3,,,,12767
c2309574a5c8d8cafc746c0dc186f3c77bdcd1e9,0,Isuru Ranawaka,2020-03-12 14:27:19-04:00,['ead3c4df2daaace7b440c41a9b73fcded105dd73'],23,281,304,21193427,11,0.836363636,1,0.545454545,12772
c39544262fef3f19b374938f3df679feaaabac40,0,GitHub,2020-03-12 14:36:02-04:00,"['a5e3b2648f5702365dbee1985b812da81de050ba', 'c2309574a5c8d8cafc746c0dc186f3c77bdcd1e9']",23,281,304,21193731,11,,,,12772
a42ec4d3f8f9aed5d76f793250d13ad02767a2df,0,Isuru Ranawaka,2020-03-12 20:36:51-04:00,['c2309574a5c8d8cafc746c0dc186f3c77bdcd1e9'],1,0,1,21193732,1,,,,12772
632d7434e855b448bffa3c6be66f31bcb73dd13e,0,Isuru Ranawaka,2020-03-12 20:38:35-04:00,['a42ec4d3f8f9aed5d76f793250d13ad02767a2df'],1,0,1,21193733,1,0,0,1,12772
cd0f271a6117673ba9aa6324fbcc4d4137cbad4c,0,GitHub,2020-03-12 20:39:43-04:00,"['c39544262fef3f19b374938f3df679feaaabac40', '632d7434e855b448bffa3c6be66f31bcb73dd13e']",2,0,2,21193735,2,,,,12772
a1040e72261ce451206ee4daec1ecee7339ee8ac,0,eroma2014,2020-03-16 10:29:07-04:00,['c84d5f4e7889710125a97fb1a70632c4b3137df3'],3,3,6,21193741,1,,,,12772
c858046d1cd051ff9582fc61132e6fbebe0f3c7d,0,eroma2014,2020-03-16 10:57:10-04:00,['a1040e72261ce451206ee4daec1ecee7339ee8ac'],1,1,2,21193743,1,,,,12772
af5cc079cbc2223d709f8b474d452cb7becacfde,0,Marcus Christie,2020-03-25 15:44:54-04:00,['96d251bd9744ff1065557b21bfadaee8ac851a7d'],141,1798,1939,21195682,23,0.311345646,0.509234828,0.978891821,12776
d698f9b57efa7aad900bca7deb1a6fad648d7202,0,Marcus Christie,2020-03-25 15:45:06-04:00,['af5cc079cbc2223d709f8b474d452cb7becacfde'],0,175,175,21195857,4,0.666666667,0.724637681,1,12778
3fb981b8e945fc7bae16f3d5071c807ebca8e93c,0,Marcus Christie,2020-03-25 15:45:06-04:00,['d698f9b57efa7aad900bca7deb1a6fad648d7202'],1,1,2,21195859,1,,,,12778
b801135da78a5001ee467c8587d4df58baf4ce8f,0,Marcus Christie,2020-03-25 15:45:59-04:00,"['cd0f271a6117673ba9aa6324fbcc4d4137cbad4c', '3fb981b8e945fc7bae16f3d5071c807ebca8e93c']",140,1955,2095,21197954,25,,,,12778
cbbda127aeb659456c57864cdc73e0c2f1eee983,0,Isuru Ranawaka,2020-03-26 13:31:01-04:00,['632d7434e855b448bffa3c6be66f31bcb73dd13e'],179,425,604,21198558,9,0.692307692,1,0,12780
e83b6d0310e0000f32fb8fd6bfd0b1a8bc257796,0,GitHub,2020-03-26 13:32:05-04:00,"['b801135da78a5001ee467c8587d4df58baf4ce8f', 'cbbda127aeb659456c57864cdc73e0c2f1eee983']",179,425,604,21199162,9,,,,12780
dcca0fd102f5bee0b355761f207ca2d29aa693b5,0,Marcus Christie,2020-03-27 09:11:04-04:00,['c858046d1cd051ff9582fc61132e6fbebe0f3c7d'],1,14,15,21199177,5,,,,12780
5bef547c106391031f8d038f7883df017536e922,0,Marcus Christie,2020-03-27 09:14:01-04:00,['dcca0fd102f5bee0b355761f207ca2d29aa693b5'],2,2,4,21199181,2,,,,12780
c480b7c8660b9573bc35f1a2e12da68cb196a995,0,Dimuthu Wannipurage,2020-03-27 11:05:23-04:00,['5bef547c106391031f8d038f7883df017536e922'],0,0,0,21199181,2,,,,12780
1222b7bfdd2dff6e3ef26df492121199aaa7f96e,0,Marcus Christie,2020-03-27 16:08:27-04:00,['c480b7c8660b9573bc35f1a2e12da68cb196a995'],1,1,2,21199183,1,,,,12780
b5ccb3921b5b22cf985460469ed2b210a763d4f8,0,Marcus Christie,2020-03-27 16:09:49-04:00,['1222b7bfdd2dff6e3ef26df492121199aaa7f96e'],2,2,4,21199187,1,,,,12780
a83a8118295bdbbe00d2cb15dd475aa060453934,0,Marcus Christie,2020-03-27 16:10:49-04:00,['b5ccb3921b5b22cf985460469ed2b210a763d4f8'],1,1,2,21199189,1,,,,12780
95ea1d0c984b1e67a45f9124e5232f56542784bc,0,Dimuthu Wannipurage,2020-03-27 17:02:45-04:00,['e83b6d0310e0000f32fb8fd6bfd0b1a8bc257796'],0,1,1,21199190,1,,,,12780
d7e26da42174eed413a504c74500d19ebe73a6d3,0,Marcus Christie,2020-03-27 18:04:19-04:00,['95ea1d0c984b1e67a45f9124e5232f56542784bc'],4,3,7,21199197,1,,,,12780
fa403195b71bddc2bb6e429917e7733e6c34bcba,0,Marcus Christie,2020-03-31 12:01:11-04:00,['d7e26da42174eed413a504c74500d19ebe73a6d3'],2,2,4,21199201,1,,,,12780
790082f1fd7eb8aa588b5542a957cc09767dcc79,0,Marcus Christie,2020-03-31 12:04:34-04:00,['fa403195b71bddc2bb6e429917e7733e6c34bcba'],1,15,16,21199217,1,0.1,0.1,0.9,12780
ec9562cd11cc6c5bbf345cc6e601941afa5b33bf,0,Marcus Christie,2020-04-01 11:28:10-04:00,['a83a8118295bdbbe00d2cb15dd475aa060453934'],24,64,88,21199305,4,1,1,1,12780
b1396d7c90823b077cc2c6b32b84e5bad10b7278,0,Marcus Christie,2020-04-01 11:30:06-04:00,"['790082f1fd7eb8aa588b5542a957cc09767dcc79', 'ec9562cd11cc6c5bbf345cc6e601941afa5b33bf']",34,74,108,21199413,12,,,,12780
56f07261dbe7a4a628f6d9503d9e965662596032,0,Suresh Marru,2020-04-06 21:18:17-04:00,['b1396d7c90823b077cc2c6b32b84e5bad10b7278'],3,3,6,21199419,1,,,,12780
760fce3f79b0efd7347f607bc3b48648630c8b50,0,Marcus Christie,2020-04-07 10:21:42-04:00,['a83a8118295bdbbe00d2cb15dd475aa060453934'],35,39,74,21199493,4,1,0.083333333,1,12780
2c5a867bb64b9a242277b4baeef7ca4acc09804e,0,Marcus Christie,2020-04-07 10:23:43-04:00,"['56f07261dbe7a4a628f6d9503d9e965662596032', '760fce3f79b0efd7347f607bc3b48648630c8b50']",35,39,74,21199567,4,,,,12780
78ebb03272bf63cc3b6ea496bed0635d7ac2e1fc,0,Marcus Christie,2020-04-07 10:40:31-04:00,['760fce3f79b0efd7347f607bc3b48648630c8b50'],1,1,2,21199569,1,,,,12780
14d6f6597623368448261e74718d141c6cf5cc1a,0,Marcus Christie,2020-04-07 10:41:02-04:00,"['2c5a867bb64b9a242277b4baeef7ca4acc09804e', '78ebb03272bf63cc3b6ea496bed0635d7ac2e1fc']",1,1,2,21199571,1,,,,12780
38ebee8b9e257fd7c4434d88769e472fb11799d7,0,Marcus Christie,2020-04-07 11:07:24-04:00,['78ebb03272bf63cc3b6ea496bed0635d7ac2e1fc'],25,29,54,21199625,2,0,0,1,12780
f8d09e98eb4425b76249d9c9662f1757c98c82ff,0,Marcus Christie,2020-04-07 11:07:44-04:00,"['14d6f6597623368448261e74718d141c6cf5cc1a', '38ebee8b9e257fd7c4434d88769e472fb11799d7']",25,29,54,21199679,2,,,,12780
4bae56ccfdff95360e6dfc84a6d9d25d988d046e,0,eroma2014,2020-04-07 14:16:28-04:00,['a83a8118295bdbbe00d2cb15dd475aa060453934'],0,2,2,21199681,1,,,,12780
ef82e19b92479a901e48a3e32763ba091f049394,0,Marcus Christie,2020-04-07 20:03:40-04:00,"['4bae56ccfdff95360e6dfc84a6d9d25d988d046e', '38ebee8b9e257fd7c4434d88769e472fb11799d7']",60,68,128,21199809,6,,,,12780
74def4cf6773418201ea26086b8d0b6dfdb0fdf8,0,Marcus Christie,2020-04-07 20:08:35-04:00,['ec9562cd11cc6c5bbf345cc6e601941afa5b33bf'],21,21,42,21199851,4,,,,12780
0ed17d6a4f0e1dee5d1b84f933d77e2382378be0,0,Marcus Christie,2020-04-07 20:08:43-04:00,"['ef82e19b92479a901e48a3e32763ba091f049394', '74def4cf6773418201ea26086b8d0b6dfdb0fdf8']",24,64,88,21199939,4,,,,12780
fb6c5d97f9fd5ead9217ebd64adb48a48ba0ac2a,0,Marcus Christie,2020-04-07 20:33:39-04:00,['0ed17d6a4f0e1dee5d1b84f933d77e2382378be0'],0,0,0,21199939,2,,,,12780
fc52011ddc97f579229dbc8308a96bc028365814,0,Marcus Christie,2020-04-07 20:38:39-04:00,['38ebee8b9e257fd7c4434d88769e472fb11799d7'],1,1,2,21199941,1,,,,12780
04d6dc770360d2c06a2e096834e252b3b50f9005,0,Marcus Christie,2020-04-07 20:40:24-04:00,"['fb6c5d97f9fd5ead9217ebd64adb48a48ba0ac2a', 'fc52011ddc97f579229dbc8308a96bc028365814']",1,1,2,21199943,1,,,,12780
917fe22b4598a3682a414e2ebcda3ff720c47ab6,0,Dimuthu Wannipurage,2020-04-10 01:31:12-04:00,['f8d09e98eb4425b76249d9c9662f1757c98c82ff'],0,41,41,21199984,3,,,,12780
38e4facd94f5f0091a5ee6fe14565aeffb6faba0,0,Marcus Christie,2020-04-10 12:48:46-04:00,['04d6dc770360d2c06a2e096834e252b3b50f9005'],0,4,4,21199988,4,,,,12780
7d0329f28772906d9c074d1c24b8e686e89e9d11,0,Marcus Christie,2020-04-13 17:03:58-04:00,['917fe22b4598a3682a414e2ebcda3ff720c47ab6'],127,127,254,21200242,74,,,,12780
1bce4bf5b3ab1d057dbe8253599b77fc09f68568,0,Marcus Christie,2020-04-15 18:43:49-04:00,['38e4facd94f5f0091a5ee6fe14565aeffb6faba0'],1,0,1,21200243,1,,,,12780
7e7ed8a13c6649b3e70b9881854b1349bfcfd3df,0,Marcus Christie,2020-04-16 17:18:00-04:00,['1bce4bf5b3ab1d057dbe8253599b77fc09f68568'],4,4,8,21200251,1,,,,12780
6f3509156e91ae2a389cb2143493dd27eac4d2b8,0,Marcus Christie,2020-04-17 11:01:40-04:00,['3fb981b8e945fc7bae16f3d5071c807ebca8e93c'],42,140,182,21200433,2,0.783783784,1,0.945945946,12780
c16b9be37d6058e2b2c0fedb09d0ca4ebb1e0914,0,Isuru Ranawaka,2020-04-17 21:06:26-04:00,['cbbda127aeb659456c57864cdc73e0c2f1eee983'],292,5,297,21200730,6,0.380952381,0,1,12780
9f50f980808392e45eac27ec8e256cdcba9b65a9,0,Isuru Ranawaka,2020-04-17 21:08:43-04:00,"['c16b9be37d6058e2b2c0fedb09d0ca4ebb1e0914', '7d0329f28772906d9c074d1c24b8e686e89e9d11']",487,2762,3249,21203979,161,,,,12780
72bfb6159fda52221adbb8c66959af3ded7e369e,0,GitHub,2020-04-17 21:10:24-04:00,"['7d0329f28772906d9c074d1c24b8e686e89e9d11', '9f50f980808392e45eac27ec8e256cdcba9b65a9']",292,5,297,21204276,6,,,,12780
a88c9562e2a8213c37784b26ee25116bbfa3b793,0,Dimuthu Wannipurage,2020-04-21 19:53:19-04:00,['7e7ed8a13c6649b3e70b9881854b1349bfcfd3df'],1,4,5,21204281,2,0,0,1,12780
9bebfa092d4497129422635a4a7ad4362129a1c2,0,Dimuthu Wannipurage,2020-04-21 19:54:12-04:00,['a88c9562e2a8213c37784b26ee25116bbfa3b793'],8,28,36,21204317,1,0,0,1,12780
678be056fa912b779269921b6e8406531292698c,0,Dimuthu Wannipurage,2020-04-21 23:17:58-04:00,['9bebfa092d4497129422635a4a7ad4362129a1c2'],2,7,9,21204326,2,0,0,1,12780
8a6820d66b677fb66dc81c71b61dbffc723aaaaa,0,Marcus Christie,2020-04-22 10:00:11-04:00,"['678be056fa912b779269921b6e8406531292698c', '2eea2170cb49fe4cec820c56421b91a3eb9e6023']",0,19,19,21204345,1,,,,12780
6e51d46747b1fd63145065afebb0f9faa49f40f8,0,Marcus Christie,2020-04-22 11:55:29-04:00,"['8a6820d66b677fb66dc81c71b61dbffc723aaaaa', '0f7b264d65d5062d2e642133c3d12b0af59fdaa1']",6,28,34,21204379,9,,,,12780
e78ff86e7ff3a180ba9edf725352b013d24f77e3,0,Marcus Christie,2020-04-22 20:27:17-04:00,"['6e51d46747b1fd63145065afebb0f9faa49f40f8', '5209ef37648cac1259b700ff529b65479baad6ba']",14,219,233,21204612,19,,,,12780
56b3f0ab77b7b68e3ebb4179a66eb4189b8d66fb,0,Marcus Christie,2020-04-22 20:30:52-04:00,"['e78ff86e7ff3a180ba9edf725352b013d24f77e3', '6f3509156e91ae2a389cb2143493dd27eac4d2b8']",143,2054,2197,21206809,25,,,,12780
d0c5843529449ec34593710aebd403e4964e7f03,0,Marcus Christie,2020-04-22 20:59:35-04:00,['56b3f0ab77b7b68e3ebb4179a66eb4189b8d66fb'],0,1,1,21206810,1,,,,12780
efb78bcea80ddff2c6b3db5db57420dbec63ebc4,0,eroma2014,2020-04-23 02:52:53-04:00,['d0c5843529449ec34593710aebd403e4964e7f03'],0,50,50,21206860,1,,,,12781
3b7e26bf350c264cb54bde79f4c9a0ef45d8da8a,1,eroma2014,2020-04-23 03:03:47-04:00,['efb78bcea80ddff2c6b3db5db57420dbec63ebc4'],0,15,15,21206875,1,,,,12782
925bbf65c76ad00f22356934c3afe937c2c56c06,0,eroma2014,2020-04-23 03:04:16-04:00,['3b7e26bf350c264cb54bde79f4c9a0ef45d8da8a'],0,1,1,21206876,1,,,,12782
0026d18a8d68c08b2ba4a69d9694b4292360a6f6,0,eroma2014,2020-04-23 03:53:48-04:00,['925bbf65c76ad00f22356934c3afe937c2c56c06'],1,1,2,21206878,1,,,,12782
dbc611594e1cc6a2220995e1af2c58b180528acc,0,eroma2014,2020-04-23 04:09:33-04:00,['0026d18a8d68c08b2ba4a69d9694b4292360a6f6'],0,50,50,21206928,1,,,,12783
669d788d3bae837212bb669672a6b82f5b04123b,1,eroma2014,2020-04-23 04:15:52-04:00,['dbc611594e1cc6a2220995e1af2c58b180528acc'],0,15,15,21206943,1,,,,12784
c367c9bf3c33df5d24058a1453e273559331d5f9,0,eroma2014,2020-04-23 04:18:08-04:00,['669d788d3bae837212bb669672a6b82f5b04123b'],0,1,1,21206944,1,,,,12784
8476a13647da21ad45ebb48dd9404d97375af734,0,eroma2014,2020-04-23 04:53:15-04:00,['c367c9bf3c33df5d24058a1453e273559331d5f9'],1,1,2,21206946,1,,,,12784
4e104866cdfab2135b488a7e1c4f7cae00533c31,0,eroma2014,2020-04-23 04:53:35-04:00,['8476a13647da21ad45ebb48dd9404d97375af734'],1,1,2,21206948,1,,,,12784
11998ee56560adb7e96aea8c8fcd10af5b38412b,0,eroma2014,2020-04-23 09:24:27-04:00,['4e104866cdfab2135b488a7e1c4f7cae00533c31'],3,3,6,21206954,1,,,,12784
f68c46c3b2c4a8369ea29a4fbc359fe44fd3610a,0,eroma2014,2020-04-23 15:31:43-04:00,['11998ee56560adb7e96aea8c8fcd10af5b38412b'],1,1,2,21206956,1,,,,12784
af250b256870447ac76e4d185530cd35da768d99,0,eroma2014,2020-04-24 09:36:35-04:00,['f68c46c3b2c4a8369ea29a4fbc359fe44fd3610a'],3,3,6,21206962,1,,,,12784
efd6bd25fc480c644590e23dfb29f80a1ed66cdc,0,Marcus Christie,2020-04-27 17:52:55-04:00,['6f3509156e91ae2a389cb2143493dd27eac4d2b8'],9,9,18,21206980,2,,,,12784
bb8609673b8e2e21d2ec638613c4f319da1fb4e1,0,Marcus Christie,2020-04-27 17:55:01-04:00,"['af250b256870447ac76e4d185530cd35da768d99', 'efd6bd25fc480c644590e23dfb29f80a1ed66cdc']",8,9,17,21206997,2,,,,12784
96994d3c6ecff90a9e32fce429b277fa2e7a878f,0,Marcus Christie,2020-04-27 17:56:18-04:00,['bb8609673b8e2e21d2ec638613c4f319da1fb4e1'],19,19,38,21207035,2,,,,12784
5544db6bc910de24d01ce2a390c75ad6c277856e,0,Marcus Christie,2020-04-27 17:58:04-04:00,"['72bfb6159fda52221adbb8c66959af3ded7e369e', '96994d3c6ecff90a9e32fce429b277fa2e7a878f']",109,370,479,21207514,26,,,,12784
abb901273ff642a7a089139593bc78ba2e8ddfe9,0,Marcus Christie,2020-04-27 18:03:58-04:00,['5544db6bc910de24d01ce2a390c75ad6c277856e'],23,23,46,21207560,1,1,1,1,12784
9825a1554d045a45d27ae0b745c76e342b5f551e,0,eroma2014,2020-04-29 12:35:07-04:00,['96994d3c6ecff90a9e32fce429b277fa2e7a878f'],4,4,8,21207568,1,,,,12784
eee6ae60c9ac72a2a09bfd3ff3f442958be623f8,0,Suresh Marru,2020-05-05 19:25:45-04:00,['abb901273ff642a7a089139593bc78ba2e8ddfe9'],26,1,27,21207595,1,,,,12784
d2eb9b73c3c2653dff471529c0a8490812de7dde,0,Suresh Marru,2020-05-05 22:10:20-04:00,['eee6ae60c9ac72a2a09bfd3ff3f442958be623f8'],4,14,18,21207613,3,,,,12784
ad6cdeca4db4b8fb6ca729b9564cacdff04fe00a,0,Isuru Ranawaka,2020-05-06 12:24:06-04:00,['9f50f980808392e45eac27ec8e256cdcba9b65a9'],2,76,78,21207691,4,1,1,0.228571429,12785
b2d61a0a7ab68885dc82a8149244c40208b14bc6,0,Isuru Ranawaka,2020-05-06 12:35:29-04:00,['ad6cdeca4db4b8fb6ca729b9564cacdff04fe00a'],7,19,26,21207717,1,,,,12785
aea921a32043756ce66427556a9af60e5dc488f5,0,GitHub,2020-05-06 12:37:21-04:00,"['d2eb9b73c3c2653dff471529c0a8490812de7dde', 'b2d61a0a7ab68885dc82a8149244c40208b14bc6']",9,95,104,21207821,4,,,,12785
8fc657428bdb8261b28506e403e1fae53c61e2d4,0,Marcus Christie,2020-05-11 10:13:29-04:00,['aea921a32043756ce66427556a9af60e5dc488f5'],405,68,473,21208294,4,0.827464789,0.799295775,0.01056338,12785
e10b84c8ee75fc46463d0ca2fd83dae88372957a,0,Marcus Christie,2020-05-11 10:14:39-04:00,['8fc657428bdb8261b28506e403e1fae53c61e2d4'],44,10,54,21208348,6,0.181818182,0.181818182,0,12785
211ba2b7b7cc6a88cab9c2030c4c2f16d81f65d0,0,Marcus Christie,2020-05-13 09:02:13-04:00,['9825a1554d045a45d27ae0b745c76e342b5f551e'],0,4,4,21208352,1,,,,12785
7ef3f58ca14b3c313ce7feed8c8258f4278020ff,0,eroma2014,2020-05-14 16:30:53-04:00,['211ba2b7b7cc6a88cab9c2030c4c2f16d81f65d0'],0,1,1,21208353,1,,,,12785
18f4cf0fa61988932ca553802008b65b61723fb4,0,Marcus Christie,2020-05-14 17:06:50-04:00,['7ef3f58ca14b3c313ce7feed8c8258f4278020ff'],1,11,12,21208365,3,,,,12785
a69a19362bc047b435efac3c940f5cc426c73b8e,0,Isuru Ranawaka,2020-05-18 21:36:20-04:00,['e10b84c8ee75fc46463d0ca2fd83dae88372957a'],2,2,4,21208369,1,,,,12785
1e7f475f97de719de1d1f1692d5b589ae7d0e342,0,Isuru Ranawaka,2020-05-18 21:37:53-04:00,['a69a19362bc047b435efac3c940f5cc426c73b8e'],2,2,4,21208373,1,,,,12785
26f9fd2c3c777ecc651425f7cd2e42bdfb35449a,0,GitHub,2020-05-18 21:47:38-04:00,"['e10b84c8ee75fc46463d0ca2fd83dae88372957a', '1e7f475f97de719de1d1f1692d5b589ae7d0e342']",2,2,4,21208377,1,,,,12785
81ce63715ae8c75157cd954cee914482270d34b5,0,Dimuthu Wannipurage,2020-05-19 00:22:52-04:00,['18f4cf0fa61988932ca553802008b65b61723fb4'],1,1,2,21208379,1,,,,12785
f3e174a80583e9279445cf06f07a0ee3f8e8d103,0,eroma2014,2020-05-19 14:58:46-04:00,['81ce63715ae8c75157cd954cee914482270d34b5'],1,1,2,21208381,1,,,,12785
d0bd675fd76319115a40b05e147ffef0a70464ea,0,eroma2014,2020-05-21 10:21:22-04:00,['f3e174a80583e9279445cf06f07a0ee3f8e8d103'],0,50,50,21208431,1,,,,12786
934efddd008529808fbdcf8141c508e1f4a645f8,0,eroma2014,2020-05-21 10:21:50-04:00,['d0bd675fd76319115a40b05e147ffef0a70464ea'],0,15,15,21208446,1,,,,12787
1c1a8976c1467acf3d28f856b78b4b7acb376252,1,eroma2014,2020-05-21 10:43:58-04:00,['934efddd008529808fbdcf8141c508e1f4a645f8'],14,14,28,21208474,1,,,,12787
0fc42c7d3406c7f52146faa9344efaeb2cd4e786,0,eroma2014,2020-05-21 10:47:24-04:00,['1c1a8976c1467acf3d28f856b78b4b7acb376252'],0,1,1,21208475,1,,,,12787
4034c6a5bed3d327ff2738468681164ee3a961eb,0,Marcus Christie,2020-05-21 10:53:07-04:00,['26f9fd2c3c777ecc651425f7cd2e42bdfb35449a'],1,228,229,21208704,5,0.467532468,0.714285714,0.844155844,12790
7c6d6065a7a9171c2b3e18f96680985597a7eb1a,0,eroma2014,2020-05-21 11:21:44-04:00,['0fc42c7d3406c7f52146faa9344efaeb2cd4e786'],1,1,2,21208706,1,,,,12790
aa00afdc0c9c60002d20ebbf5becc4b93d7ceaf0,0,eroma2014,2020-05-21 11:28:05-04:00,['7c6d6065a7a9171c2b3e18f96680985597a7eb1a'],3,3,6,21208712,1,,,,12790
1265b74502c43906d6f386382c3cac61a5039d06,0,Isuru Ranawaka,2020-05-25 09:56:04-04:00,['b2d61a0a7ab68885dc82a8149244c40208b14bc6'],3,6,9,21208721,1,0,1,0,12790
4fa2a9ad64b31a145690d48ab425f691de4d2998,0,GitHub,2020-05-25 09:56:55-04:00,"['4034c6a5bed3d327ff2738468681164ee3a961eb', '1265b74502c43906d6f386382c3cac61a5039d06']",3,6,9,21208730,1,,,,12790
7784f4b683327843cf8aa4d3009d97446bae2d61,0,Isuru Ranawaka,2020-05-25 11:35:47-04:00,['4fa2a9ad64b31a145690d48ab425f691de4d2998'],1,1,2,21208732,1,,,,12790
59a1ea90fab8b64c0dd2b649881f33661ac29487,0,Feng Li,2020-06-02 15:49:50-04:00,['4fa2a9ad64b31a145690d48ab425f691de4d2998'],3,5,8,21208740,2,,,,12790
3cdb661ac5ce0e633f96042e8518d10dbb06e57c,0,Feng Li,2020-06-02 15:51:40-04:00,['59a1ea90fab8b64c0dd2b649881f33661ac29487'],3,1,4,21208744,1,1,0,1,12790
dac4edfb89e96c337f537a5c92611dcc153abf9a,0,eroma2014,2020-06-03 10:38:02-04:00,['aa00afdc0c9c60002d20ebbf5becc4b93d7ceaf0'],4,4,8,21208752,1,,,,12790
f9f3b08dcec818fc54bcb3c594c5cac38842f3f4,0,Marcus Christie,2020-06-03 11:09:44-04:00,['af250b256870447ac76e4d185530cd35da768d99'],39,395,434,21209186,10,0.156626506,0.626506024,0.746987952,12795
eaf1f00114fb58ca2d82f8c35676fa4528d68496,0,Marcus Christie,2020-06-04 11:40:51-04:00,['4fa2a9ad64b31a145690d48ab425f691de4d2998'],1,5,6,21209192,1,,,,12795
57866eb73b7e697e9d4a1846b0b8e6f3ca6f73fc,0,Feng Li,2020-06-05 14:05:05-04:00,['3cdb661ac5ce0e633f96042e8518d10dbb06e57c'],20,25,45,21209237,2,0,0,1,12795
64b419063921c45ac1ddf30f594da53ea84687e0,0,GitHub,2020-06-05 15:38:12-04:00,"['eaf1f00114fb58ca2d82f8c35676fa4528d68496', '57866eb73b7e697e9d4a1846b0b8e6f3ca6f73fc']",24,29,53,21209290,3,,,,12795
57b03734441c2f0ff62f123187e045a43d337686,0,Isuru Ranawaka,2020-06-05 15:42:58-04:00,['64b419063921c45ac1ddf30f594da53ea84687e0'],6,3,9,21209299,2,0.5,0,1,12795
7387adf99da2b5283f5489b185d7021262fa0832,0,GitHub,2020-06-05 15:44:12-04:00,"['64b419063921c45ac1ddf30f594da53ea84687e0', '57b03734441c2f0ff62f123187e045a43d337686']",6,3,9,21209308,2,,,,12795
50ef0d720390613903aaf0ec3e468df1f549e1a8,0,Marcus Christie,2020-06-09 09:51:17-04:00,['f9f3b08dcec818fc54bcb3c594c5cac38842f3f4'],21,8,29,21209337,2,,,,12795
a090e3eb00327798f72f1e16fa9e67cc84cb6ed6,0,Marcus Christie,2020-06-09 10:56:03-04:00,['50ef0d720390613903aaf0ec3e468df1f549e1a8'],11,16,27,21209364,6,,,,12795
e58c6c23a0f03fc8ebe0cc409999305de4291738,0,Marcus Christie,2020-06-10 17:52:49-04:00,['7387adf99da2b5283f5489b185d7021262fa0832'],1,1,2,21209366,1,,,,12795
4e2f39e4df4da9aa787669680ddc909440d74374,0,Marcus Christie,2020-06-11 11:08:57-04:00,['e58c6c23a0f03fc8ebe0cc409999305de4291738'],0,0,0,21209366,1,,,,12795
b53e2db0f04c29517eb31f0c6a7aca6b69bd74ff,0,eroma2014,2020-06-12 13:52:34-04:00,['4e2f39e4df4da9aa787669680ddc909440d74374'],4,5,9,21209375,1,,,,12795
bff2ee2bba90cbfe97f9d3b4eda3f8924a04f5fa,0,Marcus Christie,2020-06-15 10:49:56-04:00,['a090e3eb00327798f72f1e16fa9e67cc84cb6ed6'],156,15,171,21209546,6,0.415384615,0,0,12795
18caaf5e55f9084e62b5cf18e8f85d3d946cee39,0,Marcus Christie,2020-06-15 11:13:02-04:00,['b53e2db0f04c29517eb31f0c6a7aca6b69bd74ff'],1,1,2,21209548,1,,,,12795
47c23ea8d1caf560d9abc52af4680ba33f9bdd61,0,Marcus Christie,2020-06-16 17:04:47-04:00,['dac4edfb89e96c337f537a5c92611dcc153abf9a'],0,0,0,21209548,2,,,,12795
cfe585e0132a0ee373bd6b5ab498d3ad1e1ce074,0,Marcus Christie,2020-06-17 11:18:08-04:00,['bff2ee2bba90cbfe97f9d3b4eda3f8924a04f5fa'],30,0,30,21209578,1,,,,12795
5aeea3337561e3289e70dd55bd8832fd3bd77cb4,0,Marcus Christie,2020-06-18 16:56:41-04:00,['dac4edfb89e96c337f537a5c92611dcc153abf9a'],108,157,265,21209843,12,,,,12798
538d3f477be199fd16789c094aea5524d17db5cb,0,Marcus Christie,2020-06-18 16:58:31-04:00,"['18caaf5e55f9084e62b5cf18e8f85d3d946cee39', '5aeea3337561e3289e70dd55bd8832fd3bd77cb4']",115,245,360,21210203,23,,,,12798
00a1f0f522932f906ed39157a5416eb34a51a06e,0,Marcus Christie,2020-06-18 16:59:46-04:00,"['47c23ea8d1caf560d9abc52af4680ba33f9bdd61', '5aeea3337561e3289e70dd55bd8832fd3bd77cb4']",108,157,265,21210468,12,,,,12798
2b33fda08b2d93348e1e86c8e17f20b386302446,0,Marcus Christie,2020-06-18 18:08:14-04:00,['538d3f477be199fd16789c094aea5524d17db5cb'],3,5,8,21210476,3,,,,12798
8f40b24e0851af07d85fd2ae2d9c18cc5e6cba41,0,Marcus Christie,2020-06-19 10:39:32-04:00,['cfe585e0132a0ee373bd6b5ab498d3ad1e1ce074'],13,123,136,21210612,4,0,0,1,12798
9ec4b13c87d026b8b2071458211fd5551dcb5f65,0,Marcus Christie,2020-06-19 18:02:46-04:00,['00a1f0f522932f906ed39157a5416eb34a51a06e'],2,0,2,21210614,1,,,,12798
cf3898d4859a143a6b4dde5679580af43520b89f,0,Marcus Christie,2020-06-20 14:44:39-04:00,['9ec4b13c87d026b8b2071458211fd5551dcb5f65'],1,4,5,21210619,2,,,,12798
3cd556d5c2e72e3e3a236aea3755bf3cf655d7b7,0,eroma2014,2020-06-22 11:55:05-04:00,['2b33fda08b2d93348e1e86c8e17f20b386302446'],0,1,1,21210620,1,,,,12798
0707aec165d8e9e6b693131fc5a49ca3fd14c2cf,0,eroma2014,2020-06-22 13:40:01-04:00,['3cd556d5c2e72e3e3a236aea3755bf3cf655d7b7'],0,57,57,21210677,1,,,,12799
ee4bfaee2e2b8c068ade370611474d49547d4eca,0,eroma2014,2020-06-22 13:57:42-04:00,['0707aec165d8e9e6b693131fc5a49ca3fd14c2cf'],0,15,15,21210692,1,,,,12800
1c3561628c35f97902496720b94e9a438026c078,0,eroma2014,2020-06-22 14:49:03-04:00,['ee4bfaee2e2b8c068ade370611474d49547d4eca'],14,14,28,21210720,1,,,,12800
6f19a327ee3fb6af7eca2dafff29224db8554bfc,0,eroma2014,2020-06-22 14:51:33-04:00,['1c3561628c35f97902496720b94e9a438026c078'],0,1,1,21210721,1,,,,12800
6cda1ef9210124e5e187b078b9681724a629df61,0,Marcus Christie,2020-06-23 10:00:16-04:00,['8f40b24e0851af07d85fd2ae2d9c18cc5e6cba41'],3,19,22,21210743,1,,,,12800
f51fc4e4cd2a9d3316b47e806296c0e1b6c76833,0,Marcus Christie,2020-06-23 11:16:31-04:00,['6cda1ef9210124e5e187b078b9681724a629df61'],0,3,3,21210746,1,,,,12800
aeb72dd30366cecf9524b93f5ba5220126421fe6,0,Marcus Christie,2020-06-23 15:03:30-04:00,['cf3898d4859a143a6b4dde5679580af43520b89f'],1,1,2,21210748,1,,,,12800
57842ba2e74fa00e29946ca84be28a1254155621,0,Marcus Christie,2020-06-25 17:04:46-04:00,['f51fc4e4cd2a9d3316b47e806296c0e1b6c76833'],6,20,26,21210774,1,,,,12800
4e8579072875bf3933939efc57613cd6be27c8fe,0,Marcus Christie,2020-06-25 17:09:39-04:00,"['6f19a327ee3fb6af7eca2dafff29224db8554bfc', '57842ba2e74fa00e29946ca84be28a1254155621']",223,542,765,21211539,18,,,,12800
3441f8df97c823c19d2983eaca468a35cc07ec3b,0,Marcus Christie,2020-06-25 17:21:16-04:00,['57842ba2e74fa00e29946ca84be28a1254155621'],3599,0,3599,21215138,16,,,,12800
80316586e8ede9e389928dcd6b49cc5fed9aab12,0,Marcus Christie,2020-06-25 17:23:24-04:00,"['4e8579072875bf3933939efc57613cd6be27c8fe', '3441f8df97c823c19d2983eaca468a35cc07ec3b']",3599,0,3599,21218737,16,,,,12800
e96d8dba9b1f7759112e7d96bd8b1b95168b7d26,0,Marcus Christie,2020-06-25 17:24:56-04:00,['3441f8df97c823c19d2983eaca468a35cc07ec3b'],1,0,1,21218738,1,,,,12800
63f90c0a6527373eb16458a8150266804c874fcb,0,Marcus Christie,2020-06-25 17:25:11-04:00,"['80316586e8ede9e389928dcd6b49cc5fed9aab12', 'e96d8dba9b1f7759112e7d96bd8b1b95168b7d26']",1,0,1,21218739,1,,,,12800
1b146a30eec815bf5856a71d7d525610eac4afd9,0,eroma2014,2020-06-25 18:45:03-04:00,['aeb72dd30366cecf9524b93f5ba5220126421fe6'],0,1,1,21218740,1,,,,12800
01fc93c3070af7f9b3db28c013dd4b52ac178d2f,0,eroma2014,2020-06-25 18:45:29-04:00,['1b146a30eec815bf5856a71d7d525610eac4afd9'],1,1,2,21218742,1,,,,12800
819a336b4ca1fd4ad2567d3a15b5892ce03bb994,0,eroma2014,2020-06-25 18:47:48-04:00,['01fc93c3070af7f9b3db28c013dd4b52ac178d2f'],3,3,6,21218748,1,,,,12800
9116fe589e9f6718415c4bb0765dc6eb3761cce1,0,Marcus Christie,2020-06-26 09:15:34-04:00,['63f90c0a6527373eb16458a8150266804c874fcb'],0,19,19,21218767,1,,,,12800
17af75f735ed68daa3ffa64768e0a4c6ce24440a,0,Marcus Christie,2020-06-26 09:23:42-04:00,['e96d8dba9b1f7759112e7d96bd8b1b95168b7d26'],1,0,1,21218768,1,,,,12800
855c4c723cc4f072e7e5d61b8e59706a4a65556c,0,Marcus Christie,2020-06-26 09:27:08-04:00,"['9116fe589e9f6718415c4bb0765dc6eb3761cce1', '17af75f735ed68daa3ffa64768e0a4c6ce24440a']",1,0,1,21218769,1,,,,12800
a5f76f05d4c4f66c2f32980dd23cd7226457afb1,0,GitHub,2020-06-29 13:42:34-04:00,['819a336b4ca1fd4ad2567d3a15b5892ce03bb994'],0,1,1,21218770,1,,,,12800
d45c557b13cc0e6c2f1e109e771e36856d7a091f,0,eroma2014,2020-06-30 13:57:12-04:00,['a5f76f05d4c4f66c2f32980dd23cd7226457afb1'],0,2,2,21218772,1,,,,12800
19d56ddb28b839c50a7f356aa771adc8f473601c,0,eroma2014,2020-06-30 14:26:28-04:00,['d45c557b13cc0e6c2f1e109e771e36856d7a091f'],2,2,4,21218776,1,,,,12800
c4c80ef9b8626fbe175752da780aa5fdec2c6cd6,0,Marcus Christie,2020-07-01 16:38:34-04:00,['19d56ddb28b839c50a7f356aa771adc8f473601c'],2,6,8,21218784,2,,,,12800
41156d1d858e88a051aab9e0ce7c17b67602a47b,0,eroma2014,2020-07-09 15:44:08-04:00,['c4c80ef9b8626fbe175752da780aa5fdec2c6cd6'],0,65,65,21218849,2,,,,12802
2a079eb3a2c044c74c67dd172c64eaac0cd1edcf,1,eroma2014,2020-07-09 16:05:17-04:00,['41156d1d858e88a051aab9e0ce7c17b67602a47b'],14,14,28,21218877,1,,,,12802
387522a950e57f4572b9291c7a0fa3026a05d276,0,eroma2014,2020-07-09 16:07:37-04:00,['2a079eb3a2c044c74c67dd172c64eaac0cd1edcf'],0,3,3,21218880,1,,,,12802
1595d584c9f38a88d7f437d4f8199d4d6cda940b,0,eroma2014,2020-07-09 16:48:56-04:00,['387522a950e57f4572b9291c7a0fa3026a05d276'],4,4,8,21218888,1,,,,12802
7ef08eb3a83c1bdc0c2a53a3124261242c7037a4,0,eroma2014,2020-07-09 17:13:45-04:00,['1595d584c9f38a88d7f437d4f8199d4d6cda940b'],1,1,2,21218890,1,,,,12802
0e47fc8ce095d65f1b195d61ffa6ee25f0e67aff,0,eroma2014,2020-07-09 17:46:32-04:00,['7ef08eb3a83c1bdc0c2a53a3124261242c7037a4'],4,4,8,21218898,1,,,,12802
71e01dd315098ac0a49d9b0aeb17cef90072f1f3,0,eroma2014,2020-07-09 18:57:50-04:00,['0e47fc8ce095d65f1b195d61ffa6ee25f0e67aff'],1,2,3,21218901,1,,,,12802
5f559f486e868374debc3259d9f6ca914f4b5935,0,Marcus Christie,2020-07-13 10:15:03-04:00,"['71e01dd315098ac0a49d9b0aeb17cef90072f1f3', '17af75f735ed68daa3ffa64768e0a4c6ce24440a']",3820,539,4359,21223260,35,,,,12802
0e82f0253d4be3ffec9662b87625d5dc0d3899ae,0,eroma2014,2020-07-14 04:06:38-04:00,['5f559f486e868374debc3259d9f6ca914f4b5935'],1,1,2,21223262,1,,,,12802
8dfa8904b18326125acc63fd1897ecfbd4a84482,0,Isuru Ranawaka,2020-07-15 20:59:19-04:00,"['7784f4b683327843cf8aa4d3009d97446bae2d61', '855c4c723cc4f072e7e5d61b8e59706a4a65556c']",3969,919,4888,21228150,69,,,,12802
fb56a416b6a1e006d8b0591cb3c0254850a71114,0,Isuru Ranawaka,2020-07-15 21:32:13-04:00,['8dfa8904b18326125acc63fd1897ecfbd4a84482'],3,2,5,21228155,3,0.5,0,0.5,12802
4d43aca9b908d86abd672f7a6767585533b02cbe,0,GitHub,2020-07-15 21:34:21-04:00,"['855c4c723cc4f072e7e5d61b8e59706a4a65556c', 'fb56a416b6a1e006d8b0591cb3c0254850a71114']",3,2,5,21228160,3,,,,12802
aa6d82595e797c57decc59db130df17b0f475cd9,0,Isuru Ranawaka,2020-07-16 22:43:45-04:00,['fb56a416b6a1e006d8b0591cb3c0254850a71114'],1,1,2,21228162,1,,,,12802
7e8eae9071c2a6e6c51556833198d225534d928c,0,GitHub,2020-07-16 22:44:29-04:00,"['4d43aca9b908d86abd672f7a6767585533b02cbe', 'aa6d82595e797c57decc59db130df17b0f475cd9']",1,1,2,21228164,1,,,,12802
0ca6229859dd866230b72c2f28d80a50c3bcf93f,0,eroma2014,2020-07-20 13:35:46-04:00,['0e82f0253d4be3ffec9662b87625d5dc0d3899ae'],1,1,2,21228166,1,,,,12802
c8ec1a1b5d0ba46c1774230ecc71ee6f09d91ef6,0,eroma2014,2020-07-21 18:37:02-04:00,['0ca6229859dd866230b72c2f28d80a50c3bcf93f'],2,2,4,21228170,1,,,,12802
cfe3f13d5fd4be2cd300267b4124f9bfe2360081,0,eroma2014,2020-07-29 15:24:42-04:00,['c8ec1a1b5d0ba46c1774230ecc71ee6f09d91ef6'],1,1,2,21228172,1,,,,12802
5b0e9ed08fe37ec69032de3ca1c8cbfe17ae05e0,0,eroma2014,2020-07-30 11:45:37-04:00,['7e8eae9071c2a6e6c51556833198d225534d928c'],0,5,5,21228177,1,,,,12802
4758d3e721a2c31a96c7079b7d3b2ceeae2d318b,0,Dimuthu Wannipurage,2020-07-31 04:21:51-04:00,['5b0e9ed08fe37ec69032de3ca1c8cbfe17ae05e0'],5295,9728,15023,21243200,15,0.701575837,0.830597505,0.990807617,12805
57823d6e391cd0f7641e064f7b752137612bda70,0,Dimuthu Wannipurage,2020-08-01 13:54:47-04:00,['4758d3e721a2c31a96c7079b7d3b2ceeae2d318b'],235,745,980,21244180,13,0.136246787,0.223650386,0.920308483,12806
e3a4718c73ba4dfbca358b59dcc30bac138dd120,0,Dimuthu Wannipurage,2020-08-04 10:24:49-04:00,['cfe3f13d5fd4be2cd300267b4124f9bfe2360081'],1,1,2,21244182,1,,,,12806
6d9739931776f62d5ddb6b6821c2a2d29a48a1ff,0,Marcus Christie,2020-08-05 10:11:05-04:00,['e3a4718c73ba4dfbca358b59dcc30bac138dd120'],132,70,202,21244384,1,,,,12806
bea7fb473ab25a9953dd27ae18b9d7ac2eec45f5,0,Marcus Christie,2020-08-05 18:21:27-04:00,['6d9739931776f62d5ddb6b6821c2a2d29a48a1ff'],1,1,2,21244386,1,,,,12806
0c5715368cf560ad67c4a2ded1050c89b581ecc9,0,Marcus Christie,2020-08-05 18:27:56-04:00,['bea7fb473ab25a9953dd27ae18b9d7ac2eec45f5'],0,8,8,21244394,1,,,,12806
1fcb466cad7be1ad2bc09fec7e3b39f49c1411b5,0,Marcus Christie,2020-08-06 14:10:01-04:00,['57823d6e391cd0f7641e064f7b752137612bda70'],117332,3,117335,21361729,192,0.726478155,0.644307117,0.247165561,12806
5d02f8b6ae8a37fd52bdfdae1ba0faf85b5806dd,0,Marcus Christie,2020-08-10 12:29:29-04:00,['1fcb466cad7be1ad2bc09fec7e3b39f49c1411b5'],296,98,394,21362123,39,,,,12807
011f6f7fdb7e1b8a7fa556b72139516a0bec9eec,0,Marcus Christie,2020-08-10 20:30:26-04:00,['1fcb466cad7be1ad2bc09fec7e3b39f49c1411b5'],9,9,18,21362141,1,,,,12807
5a7d80193317cd73b4d33f3f3f2745f1a252c32c,0,Marcus Christie,2020-08-11 16:57:39-04:00,['011f6f7fdb7e1b8a7fa556b72139516a0bec9eec'],0,2,2,21362143,2,,,,12807
7a9b27aac395883afcf9f5bf08a3eb4c6ff577a5,0,GitHub,2020-08-14 11:04:25-04:00,"['e3a4718c73ba4dfbca358b59dcc30bac138dd120', '0c5715368cf560ad67c4a2ded1050c89b581ecc9']",132,78,210,21362353,1,,,,12807
a0ceb4dd5870a283e286436dc69338fbff73071e,0,Marcus Christie,2020-08-14 15:06:44-04:00,['5a7d80193317cd73b4d33f3f3f2745f1a252c32c'],0,4,4,21362357,1,,,,12807
e98ed19b6866f9e2f8d630c71b81bd404e141962,0,Marcus Christie,2020-08-27 16:18:07-04:00,['a0ceb4dd5870a283e286436dc69338fbff73071e'],0,3,3,21362360,1,,,,12807
06aa0641f1f86a39e7224e84766f9374482e7c8c,0,Marcus Christie,2020-08-31 16:51:34-04:00,['e98ed19b6866f9e2f8d630c71b81bd404e141962'],2,7,9,21362369,1,0,1,1,12807
31b17d172eba5588c943a231cd1b60f3eed802e6,0,Marcus Christie,2020-09-01 15:50:58-04:00,['06aa0641f1f86a39e7224e84766f9374482e7c8c'],3,3,6,21362375,1,,,,12807
5c444d265e03d1e2b2ddcee0d82e9259bd53dac9,0,eroma2014,2020-09-02 03:18:07-04:00,['7a9b27aac395883afcf9f5bf08a3eb4c6ff577a5'],0,51,51,21362426,1,,,,12808
7134a587040e2832323a9cffd5ad8c3ce2bb99e9,1,eroma2014,2020-09-02 03:25:44-04:00,['5c444d265e03d1e2b2ddcee0d82e9259bd53dac9'],0,15,15,21362441,1,,,,12809
bb8b780e32654b872f6a39b0304b1d66f5db3908,0,eroma2014,2020-09-02 03:26:51-04:00,['7134a587040e2832323a9cffd5ad8c3ce2bb99e9'],0,1,1,21362442,1,,,,12809
a5be1549fda86413b7d336b2d7b103a050ed621e,0,eroma2014,2020-09-02 04:37:43-04:00,['bb8b780e32654b872f6a39b0304b1d66f5db3908'],1,1,2,21362444,1,,,,12809
cb81aade7acf27cfd0c72f0b364067920aa27def,0,eroma2014,2020-09-02 15:59:38-04:00,['a5be1549fda86413b7d336b2d7b103a050ed621e'],3,3,6,21362450,1,,,,12809
194f4c2bdad98117e77ae36971fc0ae4fc53fce2,0,Dimuthu Wannipurage,2020-09-02 17:48:49-04:00,['31b17d172eba5588c943a231cd1b60f3eed802e6'],1,2,3,21362453,1,0,0,1,12809
7912ba9842de8855a451a0cd90192b81ea634a87,0,Dimuthu Wannipurage,2020-09-03 01:08:12-04:00,"['194f4c2bdad98117e77ae36971fc0ae4fc53fce2', 'cb81aade7acf27cfd0c72f0b364067920aa27def']",146,238,384,21362837,18,,,,12809
f28bc9cc2b9deb530027b2c710dde5ad0d37317d,0,Marcus Christie,2020-09-03 18:30:25-04:00,['7912ba9842de8855a451a0cd90192b81ea634a87'],18,11,29,21362866,4,,,,12809
5c3dc80628d2174fb206ca6c0463172dc26a2fd6,0,Dimuthu Wannipurage,2020-09-05 03:52:38-04:00,['7912ba9842de8855a451a0cd90192b81ea634a87'],0,7,7,21362873,1,,,,12809
fb4d3d509eaca05c88a03d0db0e2967ced67c4e9,0,Dimuthu Wannipurage,2020-09-05 04:58:30-04:00,['cb81aade7acf27cfd0c72f0b364067920aa27def'],126,126,252,21363125,75,,,,12809
30add7b7daca5edf3ecf68c778bdadd494414850,0,Dimuthu Wannipurage,2020-09-05 11:43:25-04:00,"['fb4d3d509eaca05c88a03d0db0e2967ced67c4e9', '5c3dc80628d2174fb206ca6c0463172dc26a2fd6']",15076,26168,41244,21404369,435,,,,12809
b27abd2339123eb03e9882d12e6d412126cf9cc4,0,Dimuthu Wannipurage,2020-09-05 12:04:16-04:00,['30add7b7daca5edf3ecf68c778bdadd494414850'],2,2,4,21404373,1,,,,12809
675fc5605b2fe26a1109573d1cf5ffc78390eaa5,0,Dimuthu Wannipurage,2020-09-05 14:15:49-04:00,['b27abd2339123eb03e9882d12e6d412126cf9cc4'],2,2,4,21404377,2,,,,12809
d21c31d48e362ff9d76b670d024e787c20e90c66,0,Marcus Christie,2020-09-09 15:27:13-04:00,['675fc5605b2fe26a1109573d1cf5ffc78390eaa5'],0,0,0,21404377,6,,,,12809
cb6d3aec88da92f66425e21d3fd78699e27465bf,0,Marcus Christie,2020-09-09 15:35:11-04:00,['d21c31d48e362ff9d76b670d024e787c20e90c66'],2,2,4,21404381,1,,,,12809
ceaac72ba5638625b703bbaec197287968f73691,0,Marcus Christie,2020-09-09 15:36:04-04:00,['cb6d3aec88da92f66425e21d3fd78699e27465bf'],0,126,126,21404507,6,,,,12815
b4933b26560f7e7dc77f87d28d4452dac8a0ec8a,0,Marcus Christie,2020-09-09 17:48:59-04:00,['cb6d3aec88da92f66425e21d3fd78699e27465bf'],8,18,26,21404533,9,,,,12815
9be338e44c4f70b748bd79438502a8c8046e54a6,0,Marcus Christie,2020-09-09 17:49:48-04:00,['b4933b26560f7e7dc77f87d28d4452dac8a0ec8a'],1,1,2,21404535,1,,,,12815
106e0102d9f017393e6e06dd6e01f8cb88567616,0,Marcus Christie,2020-09-09 17:53:52-04:00,['9be338e44c4f70b748bd79438502a8c8046e54a6'],3,3,6,21404541,1,,,,12815
a7614b1bad2ecdc2c7735b59a658a409e3f35530,0,Marcus Christie,2020-09-09 17:54:00-04:00,"['ceaac72ba5638625b703bbaec197287968f73691', '106e0102d9f017393e6e06dd6e01f8cb88567616']",9,19,28,21404569,10,,,,12815
e175e2a44b2457f55ff0e25aad01bd1b6b157500,0,Dimuthu Wannipurage,2020-09-09 18:07:29-04:00,['cb6d3aec88da92f66425e21d3fd78699e27465bf'],3,4,7,21404576,3,,,,12815
0872164fbd48d567ff1caccfc748122c28992f11,0,Dimuthu Wannipurage,2020-09-09 18:10:14-04:00,['a7614b1bad2ecdc2c7735b59a658a409e3f35530'],1,2,3,21404579,2,,,,12815
56ba01927122919741b6c1c0f5022a5affb9c349,0,eroma2014,2020-09-10 14:25:06-04:00,['e175e2a44b2457f55ff0e25aad01bd1b6b157500'],1,1,2,21404581,1,,,,12815
e66582157de92c39265d300eadeba111e6a186bd,0,Marcus Christie,2020-09-10 15:40:25-04:00,['56ba01927122919741b6c1c0f5022a5affb9c349'],2,2,4,21404585,1,,,,12815
fc9fdb0d593842eb6cd6401ff8923017cb3ec4f9,0,eroma2014,2020-09-14 15:25:55-04:00,['e66582157de92c39265d300eadeba111e6a186bd'],0,1,1,21404586,1,,,,12815
5258ddcae0eb1c433a03fe0bebc988f55cbb0410,0,eroma2014,2020-09-14 15:56:10-04:00,['fc9fdb0d593842eb6cd6401ff8923017cb3ec4f9'],0,2,2,21404588,1,,,,12815
3ccd5131eef287c4e5c664662253088fc3999158,0,eroma2014,2020-09-14 16:11:20-04:00,['5258ddcae0eb1c433a03fe0bebc988f55cbb0410'],0,1,1,21404589,1,,,,12815
5536d047be5829f7cfa97f967f0ad5e0c7b34c5a,0,eroma2014,2020-09-15 01:42:38-04:00,['3ccd5131eef287c4e5c664662253088fc3999158'],0,2,2,21404591,1,,,,12815
1d6f0e12b5c0096cbcb1a5724ec1a2035d216dd3,0,eroma2014,2020-09-15 01:48:45-04:00,['5536d047be5829f7cfa97f967f0ad5e0c7b34c5a'],0,1,1,21404592,1,,,,12815
e0e02b25e6815180081fe00df53dad727f9beee7,0,eroma2014,2020-09-15 02:04:51-04:00,['1d6f0e12b5c0096cbcb1a5724ec1a2035d216dd3'],0,1,1,21404593,1,,,,12815
0d0992a73dab8d10fc1fa57a2120dbbcbb6b43c1,0,eroma2014,2020-09-15 02:15:17-04:00,['e0e02b25e6815180081fe00df53dad727f9beee7'],0,1,1,21404594,1,,,,12815
549ed5134fbc188dafb15633eb99a6c880ad8e2f,0,eroma2014,2020-09-15 02:18:52-04:00,['0d0992a73dab8d10fc1fa57a2120dbbcbb6b43c1'],0,1,1,21404595,1,,,,12815
b9276a4911aabe66cb3001308564113be89fabf1,0,eroma2014,2020-09-15 02:27:27-04:00,['549ed5134fbc188dafb15633eb99a6c880ad8e2f'],0,1,1,21404596,1,,,,12815
386b6ad995bf225e1d342b9f41b12f8dceb20880,0,eroma2014,2020-09-15 02:37:09-04:00,['b9276a4911aabe66cb3001308564113be89fabf1'],0,3,3,21404599,2,,,,12815
dfe7dde24e933cd9df7c201c2d6837f4f24ca5b9,0,Dimuthu Wannipurage,2020-09-16 21:44:39-04:00,['386b6ad995bf225e1d342b9f41b12f8dceb20880'],0,2,2,21404601,1,0,0,0,12815
7925b9f7f94e4437c3edd2c9bff0347f71e77209,0,Marcus Christie,2020-09-17 16:35:12-04:00,['dfe7dde24e933cd9df7c201c2d6837f4f24ca5b9'],1,1,2,21404603,1,,,,12815
5b70d6ea3f4542c50f62862a46776f36b524adc4,0,Marcus Christie,2020-09-17 18:37:59-04:00,['f28bc9cc2b9deb530027b2c710dde5ad0d37317d'],3,8,11,21404614,3,,,,12815
d65c9f1521f37fb6b40a5dd8bbb3a156dcff2ebe,0,Marcus Christie,2020-09-18 09:24:57-04:00,['0872164fbd48d567ff1caccfc748122c28992f11'],1,1,2,21404616,1,,,,12815
29e0ac9bae4303bc413b7844670c2359b93f3feb,0,GitHub,2020-09-18 09:45:06-04:00,"['7925b9f7f94e4437c3edd2c9bff0347f71e77209', '5b70d6ea3f4542c50f62862a46776f36b524adc4']",19,17,36,21404652,6,,,,12815
32318dc0f3b454246ab2932df9db36a2d57aa21d,1,Marcus Christie,2020-09-18 13:56:53-04:00,['29e0ac9bae4303bc413b7844670c2359b93f3feb'],1,69,70,21404722,3,,,,12817
b40a9349746a8c97b734bd2e2199f0b79ed22b5c,0,Marcus Christie,2020-09-18 13:57:04-04:00,['32318dc0f3b454246ab2932df9db36a2d57aa21d'],94,269,363,21405085,10,,,,12820
05b734d34bfd2c06af989451ee7a2113730d1134,0,Marcus Christie,2020-09-18 13:57:04-04:00,['b40a9349746a8c97b734bd2e2199f0b79ed22b5c'],30,58,88,21405173,6,,,,12821
aef45ae0154bd27efa1fb355a85e181baecf6230,0,Marcus Christie,2020-09-18 13:57:04-04:00,['05b734d34bfd2c06af989451ee7a2113730d1134'],2,5,7,21405180,2,,,,12821
0476158b68b4a26fcccdf4c2533433cfc99d972f,0,Marcus Christie,2020-09-18 13:57:04-04:00,['aef45ae0154bd27efa1fb355a85e181baecf6230'],0,6,6,21405186,1,,,,12821
5aa09d0dad852589e875b5a112e9a2c507a27560,0,Marcus Christie,2020-09-18 13:57:04-04:00,['0476158b68b4a26fcccdf4c2533433cfc99d972f'],0,3,3,21405189,2,,,,12821
7724d22070ba4787ba1865d7f69af1c857fc5d25,0,Marcus Christie,2020-09-18 13:57:46-04:00,['5aa09d0dad852589e875b5a112e9a2c507a27560'],11,31,42,21405231,3,,,,12821
24bd94c7325ea48e65e7dfa1fd5f9a384e4ba86c,0,Marcus Christie,2020-09-18 13:57:48-04:00,['7724d22070ba4787ba1865d7f69af1c857fc5d25'],2,1,3,21405234,1,,,,12821
181834ec0648edc8d47c359c7ecec95fb40ead36,1,Marcus Christie,2020-09-18 13:57:48-04:00,['24bd94c7325ea48e65e7dfa1fd5f9a384e4ba86c'],18,31,49,21405283,3,,,,12821
15ec606a7c5e29fd13d088aeab1bf2c4373082ad,0,Marcus Christie,2020-09-18 14:42:04-04:00,"['d65c9f1521f37fb6b40a5dd8bbb3a156dcff2ebe', '181834ec0648edc8d47c359c7ecec95fb40ead36']",175,505,680,21405963,42,,,,12821
43c74df1f498f639ffc86c5cf7abab03876c0740,0,Marcus Christie,2020-09-18 14:59:24-04:00,['15ec606a7c5e29fd13d088aeab1bf2c4373082ad'],78,78,156,21406119,75,,,,12821
7be63284e0ae52c35b7b30ebbd49c0b81a9993bb,0,GitHub,2020-09-18 17:30:35-04:00,"['43c74df1f498f639ffc86c5cf7abab03876c0740', '5d02f8b6ae8a37fd52bdfdae1ba0faf85b5806dd']",296,98,394,21406513,39,,,,12821
34e8bedcbe84f080071a05378350081482313453,1,Marcus Christie,2020-09-24 12:23:02-04:00,['181834ec0648edc8d47c359c7ecec95fb40ead36'],6,47,53,21406566,2,0.368421053,0.368421053,0.631578947,12821
ac35813a3ed448550632160c1ab31ab299e5e7e3,0,Marcus Christie,2020-09-24 12:23:10-04:00,"['7be63284e0ae52c35b7b30ebbd49c0b81a9993bb', '34e8bedcbe84f080071a05378350081482313453']",6,47,53,21406619,2,,,,12821
6abd10f2415281dc6e6887f55b82cb76e10e9c8d,0,Marcus Christie,2020-09-24 13:06:47-04:00,['34e8bedcbe84f080071a05378350081482313453'],1,1,2,21406621,1,,,,12821
d43619402defffeaa03b0949fc3d59ce58c91fc8,0,Marcus Christie,2020-09-24 13:07:02-04:00,"['ac35813a3ed448550632160c1ab31ab299e5e7e3', '6abd10f2415281dc6e6887f55b82cb76e10e9c8d']",1,1,2,21406623,1,,,,12821
bbcaf8d194c0409f14b968a4a22e55850257e1ae,0,eroma2014,2020-10-02 00:14:23-04:00,['181834ec0648edc8d47c359c7ecec95fb40ead36'],0,52,52,21406675,1,,,,12822
f5487d5d46098164272d2d50588340de92647695,1,eroma2014,2020-10-02 00:17:17-04:00,['bbcaf8d194c0409f14b968a4a22e55850257e1ae'],0,15,15,21406690,1,,,,12823
920296641583ca514adc6f483d21c9e802f98581,0,Marcus Christie,2020-10-04 18:13:22-04:00,['181834ec0648edc8d47c359c7ecec95fb40ead36'],0,4,4,21406694,2,,,,12823
3c5cb01ec4b14a1de8a6b3c2ab863943f5223d13,0,Marcus Christie,2020-10-04 18:13:36-04:00,"['d43619402defffeaa03b0949fc3d59ce58c91fc8', '920296641583ca514adc6f483d21c9e802f98581']",0,4,4,21406698,2,,,,12823
e21b5e14768ef2bcd00d39febb67c5c55416289d,0,Marcus Christie,2020-10-05 11:37:26-04:00,"['f5487d5d46098164272d2d50588340de92647695', '920296641583ca514adc6f483d21c9e802f98581']",0,4,4,21406702,2,,,,12823
e16269b06e7c3243af9219e09031fb61baf8a917,0,eroma2014,2020-10-05 12:53:04-04:00,['f5487d5d46098164272d2d50588340de92647695'],0,2,2,21406704,1,,,,12823
618168c2e619baa61c355967ca309e4057ebc6fd,0,eroma2014,2020-10-05 14:59:31-04:00,"['e16269b06e7c3243af9219e09031fb61baf8a917', 'e21b5e14768ef2bcd00d39febb67c5c55416289d']",0,4,4,21406708,2,,,,12823
a8055d324b9156de43831f639f91fae257ed9462,0,eroma2014,2020-10-06 13:10:37-04:00,['618168c2e619baa61c355967ca309e4057ebc6fd'],1,1,2,21406710,1,,,,12823
6cbb671631807c6145cab89acc84488a7970cc6b,0,eroma2014,2020-10-08 10:41:24-04:00,['a8055d324b9156de43831f639f91fae257ed9462'],0,1,1,21406711,1,,,,12823
57553f761896fd72b6a998f12b04b26bf62cf128,0,eroma2014,2020-10-08 11:30:41-04:00,['6cbb671631807c6145cab89acc84488a7970cc6b'],4,4,8,21406719,1,,,,12823
a30620542a2e866f3834016e30a492eda3bc24d9,0,Marcus Christie,2020-10-08 12:13:01-04:00,['3c5cb01ec4b14a1de8a6b3c2ab863943f5223d13'],0,11,11,21406730,1,,,,12823
8958e3d001b7900e25d5872ca71cf9a2f9e7f0ef,0,Marcus Christie,2020-10-09 14:17:56-04:00,['a30620542a2e866f3834016e30a492eda3bc24d9'],1,1,2,21406732,1,,,,12823
a31babb27080cef0c7a47ec0082d592d1c058e23,0,Dimuthu Wannipurage,2020-10-13 18:23:33-04:00,['8958e3d001b7900e25d5872ca71cf9a2f9e7f0ef'],2,7,9,21406741,2,1,1,1,12823
aa43fa902bc08438a950f3d3aeaaf1cc055e4f30,0,DImuthuUpe,2020-10-14 03:08:01-04:00,['a31babb27080cef0c7a47ec0082d592d1c058e23'],0,0,0,21406741,1,,,,12824
687c4ab716d79931c127e20de2d4ac01523d8ed2,0,DImuthuUpe,2020-10-14 03:08:28-04:00,['aa43fa902bc08438a950f3d3aeaaf1cc055e4f30'],1,1,2,21406743,1,,,,12824
b11d81182f915491187dcf9f3ede5beeb5ea94a2,0,DImuthuUpe,2020-10-14 04:22:22-04:00,['687c4ab716d79931c127e20de2d4ac01523d8ed2'],0,0,0,21406743,1,,,,12825
9e30529d7545a1df0b9d94c2783d7d11c32d301d,0,DImuthuUpe,2020-10-14 05:17:28-04:00,['b11d81182f915491187dcf9f3ede5beeb5ea94a2'],0,0,0,21406743,1,,,,12826
f581b61d44eb9a848b866456acd63f29e2bbfc8e,0,DImuthuUpe,2020-10-14 05:17:56-04:00,['9e30529d7545a1df0b9d94c2783d7d11c32d301d'],1,1,2,21406745,1,,,,12826
3794421f01fdb4ef5c0199fdfc6cfc15c25d2e7a,0,DImuthuUpe,2020-10-14 05:18:28-04:00,['f581b61d44eb9a848b866456acd63f29e2bbfc8e'],0,11,11,21406756,1,,,,12826
f9b9e203fc268db468977680ab511f88a3eadc99,0,DImuthuUpe,2020-10-14 05:19:22-04:00,['3794421f01fdb4ef5c0199fdfc6cfc15c25d2e7a'],1,7,8,21406764,1,,,,12826
0fad16881e4d1189933447fae01491a13c6188d7,0,Marcus Christie,2020-10-29 11:10:56-04:00,['57553f761896fd72b6a998f12b04b26bf62cf128'],1,1,2,21406766,1,,,,12826
81c3e5cc2fa20af08dd82395e63085c77fbe704d,0,Dimuthu Wannipurage,2020-10-30 11:58:10-04:00,['f9b9e203fc268db468977680ab511f88a3eadc99'],4,4,8,21406774,416,,,,12827
1a437d532df8364e3e7c96b241145ac777ca9203,0,Dimuthu Wannipurage,2020-10-30 12:03:03-04:00,['81c3e5cc2fa20af08dd82395e63085c77fbe704d'],1,1,2,21406776,1,,,,12827
3acf29313b46689c979b7444828774992aea3eb1,0,Dimuthu Wannipurage,2020-10-30 12:07:03-04:00,['1a437d532df8364e3e7c96b241145ac777ca9203'],0,1,1,21406777,270,,,,12827
4ca774bbd36bd8d8f882b993a4a438283e9ca775,0,Dimuthu Wannipurage,2020-11-02 14:47:25-05:00,['3acf29313b46689c979b7444828774992aea3eb1'],5,9,14,21406791,1,0,1,1,12827
7d6073b9227c2cd1949e1e41f4371f2ca755e8d3,0,Dimuthu Wannipurage,2020-11-02 14:47:53-05:00,['4ca774bbd36bd8d8f882b993a4a438283e9ca775'],0,15,15,21406806,1,0,1,1,12827
5642cc2103b2dc73a2e13632f08fe27372efa656,0,Dimuthu Wannipurage,2020-11-06 01:21:52-05:00,['7d6073b9227c2cd1949e1e41f4371f2ca755e8d3'],3,1734,1737,21408543,20,,,,12841
fae9e6145e415a298161ead7697081faf7033425,0,Dimuthu Wannipurage,2020-11-06 01:38:29-05:00,['5642cc2103b2dc73a2e13632f08fe27372efa656'],1,2,3,21408546,1,,,,12841
b89b91a772d2657f65eb41478a0b8d0fc8d31ca2,0,eroma2014,2020-11-11 11:25:36-05:00,['0fad16881e4d1189933447fae01491a13c6188d7'],1,1,2,21408548,1,,,,12841
ebc73f5f170669e4ca23168a008868f62423caaa,0,eroma2014,2020-11-11 12:56:18-05:00,['b89b91a772d2657f65eb41478a0b8d0fc8d31ca2'],1,1,2,21408550,1,,,,12841
c992d0211f0ab72c622159bc6cc0080039590c24,0,Dimuthu Wannipurage,2020-11-12 13:50:25-05:00,['ebc73f5f170669e4ca23168a008868f62423caaa'],0,1,1,21408551,1,,,,12841
a514a55824cdaeb0fc92252c4c29daef03d00841,0,Marcus Christie,2020-11-12 17:12:23-05:00,['fae9e6145e415a298161ead7697081faf7033425'],0,4,4,21408555,1,,,,12841
2473cd4b4a3a7cb2f25908c891a48c4e817f08c8,0,eroma2014,2020-11-18 01:53:27-05:00,['c992d0211f0ab72c622159bc6cc0080039590c24'],5,5,10,21408565,1,,,,12841
cd09d9cba7beaf917c2754668b6fee8fc11350b9,0,Marcus Christie,2020-11-19 20:36:21-05:00,['2473cd4b4a3a7cb2f25908c891a48c4e817f08c8'],0,1,1,21408566,1,,,,12841
cce58999ba6ecf40c48e1b5ec16a2c9ecad2a16d,0,Dimuthu Wannipurage,2020-11-19 23:11:15-05:00,['cd09d9cba7beaf917c2754668b6fee8fc11350b9'],24,125,149,21408715,8,,,,12841
9b3ada7a2470fe7fdda1b15492f96f6c76526ac5,1,Dimuthu Wannipurage,2020-11-19 23:21:38-05:00,['cce58999ba6ecf40c48e1b5ec16a2c9ecad2a16d'],1,73,74,21408789,3,,,,12841
8d53c146318baa375ce62fcabe5419372eb2ab65,0,Dimuthu Wannipurage,2020-11-21 01:55:59-05:00,['9b3ada7a2470fe7fdda1b15492f96f6c76526ac5'],0,1,1,21408790,1,,,,12841
8337e851b2c9e9d8c9d2fe23749b1bfdc405bfd6,0,Dimuthu Wannipurage,2020-11-21 01:57:42-05:00,['9b3ada7a2470fe7fdda1b15492f96f6c76526ac5'],8,19,27,21408817,6,,,,12841
75723e7041c9b515706831db5be4beead93893a6,0,GitHub,2020-11-21 01:59:35-05:00,"['8d53c146318baa375ce62fcabe5419372eb2ab65', '8337e851b2c9e9d8c9d2fe23749b1bfdc405bfd6']",8,19,27,21408844,6,,,,12841
79efb906036de33e168c97aa9740171c131df336,0,Dimuthu Wannipurage,2020-11-27 17:12:18-05:00,['75723e7041c9b515706831db5be4beead93893a6'],1,4,5,21408849,1,0,1,1,12841
8f16a987af5225720b8a6227318244dcb7f5ace7,0,Dimuthu Wannipurage,2020-11-27 17:43:51-05:00,['79efb906036de33e168c97aa9740171c131df336'],12,6,18,21408867,1,1,0,0,12841
541af76b80a0d36da748abcc63209365961bce71,0,GitHub,2020-12-03 01:12:20-05:00,"['75723e7041c9b515706831db5be4beead93893a6', '8f16a987af5225720b8a6227318244dcb7f5ace7']",11,8,19,21408886,1,,,,12841
1920f28288c1ef789c3859b42ba319aa0b462466,0,Dimuthu Wannipurage,2020-12-03 01:29:16-05:00,['541af76b80a0d36da748abcc63209365961bce71'],2,2,4,21408890,1,1,0,0,12841
31a9f22c932b58e7331a7f9bc8f48c541f8ae992,0,Dimuthu Wannipurage,2020-12-07 14:43:47-05:00,['8f16a987af5225720b8a6227318244dcb7f5ace7'],1,1,2,21408892,1,,,,12841
704ac38d63cd37f937451289024e9db13899c01d,0,GitHub,2020-12-07 14:44:59-05:00,"['1920f28288c1ef789c3859b42ba319aa0b462466', '31a9f22c932b58e7331a7f9bc8f48c541f8ae992']",1,1,2,21408894,1,,,,12841
f74bd2020cba18b44edf6c925fadaf3f980e6107,0,Dimuthu Wannipurage,2020-12-07 17:13:58-05:00,['1920f28288c1ef789c3859b42ba319aa0b462466'],1026,494,1520,21410414,57,1,0,0,12845
74a71455a5ed8803462d10b83d4ee7067ab7f71b,0,Dimuthu Wannipurage,2020-12-07 17:16:12-05:00,"['a514a55824cdaeb0fc92252c4c29daef03d00841', 'f74bd2020cba18b44edf6c925fadaf3f980e6107']",1069,791,1860,21412274,77,,,,12845
ae78abcce520199599c52cbcc751fa9c79935bfc,0,Dimuthu Wannipurage,2020-12-07 17:19:17-05:00,['74a71455a5ed8803462d10b83d4ee7067ab7f71b'],1,1,2,21412276,1,,,,12845
540dead3f2058a02ed3f7adceb359a52f00d2d19,0,Dimuthu Wannipurage,2020-12-08 04:58:50-05:00,['f74bd2020cba18b44edf6c925fadaf3f980e6107'],0,14,14,21412290,7,,,,12845
57ef075eb7a4e1ab33dedd5da7a74a221f2478d6,0,Dimuthu Wannipurage,2020-12-08 04:59:19-05:00,"['ae78abcce520199599c52cbcc751fa9c79935bfc', '540dead3f2058a02ed3f7adceb359a52f00d2d19']",0,14,14,21412304,7,,,,12845
a3ca40f7bf116fd626771aaea5ff0c47f790bef8,0,Dimuthu Wannipurage,2020-12-08 13:25:04-05:00,['540dead3f2058a02ed3f7adceb359a52f00d2d19'],2,6,8,21412312,1,1,1,1,12845
b161235b060fe77fb65a4bacbc0a3f12f03ce9da,0,Dimuthu Wannipurage,2020-12-08 13:25:35-05:00,"['57ef075eb7a4e1ab33dedd5da7a74a221f2478d6', 'a3ca40f7bf116fd626771aaea5ff0c47f790bef8']",2,6,8,21412320,1,,,,12845
9ef272abd4543417a0973ae5abbe302eb226f61e,1,Dimuthu Wannipurage,2020-12-08 13:48:20-05:00,['a3ca40f7bf116fd626771aaea5ff0c47f790bef8'],10,12,22,21412342,3,,,,12845
de6b31742ef40b5eaff314b6de28f0b9893f26ec,0,Dimuthu Wannipurage,2020-12-08 13:48:38-05:00,"['b161235b060fe77fb65a4bacbc0a3f12f03ce9da', '9ef272abd4543417a0973ae5abbe302eb226f61e']",10,12,22,21412364,3,,,,12845
a8d5eb92c336bc6f935d7b5d7f0bf645b082a4f9,1,Dimuthu Wannipurage,2020-12-08 14:57:32-05:00,['9ef272abd4543417a0973ae5abbe302eb226f61e'],0,57,57,21412421,8,0.588235294,1,1,12845
9939e072a1c2449446d2152ae8a108193f6c26ae,0,Dimuthu Wannipurage,2020-12-08 14:57:53-05:00,"['de6b31742ef40b5eaff314b6de28f0b9893f26ec', 'a8d5eb92c336bc6f935d7b5d7f0bf645b082a4f9']",0,57,57,21412478,8,,,,12845
890dc20bd6cca509b228be562ad12e1c4866cc11,0,Dimuthu Wannipurage,2020-12-08 17:30:13-05:00,"['704ac38d63cd37f937451289024e9db13899c01d', 'a8d5eb92c336bc6f935d7b5d7f0bf645b082a4f9']",1028,573,1601,21414079,62,,,,12845
12897e6a39d6460b0dc9c435699d9bacd8aa2a4b,0,Marcus Christie,2020-12-09 17:40:45-05:00,['890dc20bd6cca509b228be562ad12e1c4866cc11'],1,1,2,21414081,1,,,,12845
5e8fdc42b4f569a981b24e8af90eb8f6bde5e8f4,0,eroma2014,2020-12-10 01:56:56-05:00,['12897e6a39d6460b0dc9c435699d9bacd8aa2a4b'],0,60,60,21414141,1,,,,12846
c0a9e6727f15f03b8212d20358dc0d1d4e1c9871,1,eroma2014,2020-12-10 02:45:46-05:00,['5e8fdc42b4f569a981b24e8af90eb8f6bde5e8f4'],0,15,15,21414156,1,,,,12847
229d8a054458e4617ae8ca6f0b138b255f539aa3,0,eroma2014,2020-12-10 02:48:52-05:00,['c0a9e6727f15f03b8212d20358dc0d1d4e1c9871'],0,1,1,21414157,1,,,,12847
c4475c0ba3ea1c48a48410bf02bc411f976a2b5a,0,eroma2014,2020-12-10 03:29:53-05:00,['229d8a054458e4617ae8ca6f0b138b255f539aa3'],1,1,2,21414159,1,,,,12847
056fce850122f59e4706a5e46be31dc8cf733ef8,0,eroma2014,2020-12-10 03:31:50-05:00,['c4475c0ba3ea1c48a48410bf02bc411f976a2b5a'],1,1,2,21414161,1,,,,12847
0e0db916f8a386629e444f35ea4302422d02c67b,0,eroma2014,2020-12-11 16:14:53-05:00,['056fce850122f59e4706a5e46be31dc8cf733ef8'],4,4,8,21414169,1,,,,12847
80c45cb18aed47f55bee6694211db8fe8b219f46,0,eroma2014,2020-12-11 17:03:59-05:00,['0e0db916f8a386629e444f35ea4302422d02c67b'],0,75,75,21414244,2,,,,12849
a094ea28dc488375858d04d464df811f8d1a1965,0,eroma2014,2020-12-13 13:33:00-05:00,['80c45cb18aed47f55bee6694211db8fe8b219f46'],12,5,17,21414261,1,,,,12849
99712874144b5fb483f5aefa13f7f6828dd452ec,0,eroma2014,2020-12-13 13:37:09-05:00,['a094ea28dc488375858d04d464df811f8d1a1965'],12,12,24,21414285,1,,,,12849
9013f7a0317add1d826dbd33f300f1d028cfe9b3,1,eroma2014,2020-12-14 09:37:02-05:00,['99712874144b5fb483f5aefa13f7f6828dd452ec'],14,14,28,21414313,1,,,,12849
76d0cbdd7456ea2fb2253310ded95a0841f23b95,0,eroma2014,2020-12-14 09:42:54-05:00,['9013f7a0317add1d826dbd33f300f1d028cfe9b3'],0,1,1,21414314,1,,,,12849
66ba191770d06ca1b3e4b3ac4ad3d6cbc036f7e9,0,eroma2014,2020-12-14 11:03:06-05:00,['76d0cbdd7456ea2fb2253310ded95a0841f23b95'],5,5,10,21414324,1,,,,12849
c5a45a55d016e669053ebe69f7057891e66e8f6c,0,eroma2014,2020-12-15 01:13:43-05:00,['66ba191770d06ca1b3e4b3ac4ad3d6cbc036f7e9'],0,1,1,21414325,1,,,,12849
789991c56d9a333d52f382814a2de350864640e4,0,eroma2014,2020-12-16 13:39:41-05:00,['c5a45a55d016e669053ebe69f7057891e66e8f6c'],1,1,2,21414327,1,,,,12849
213efb65b84bbfd9e9e96a2724032c43c0ab1a8d,0,Marcus Christie,2020-12-16 17:08:24-05:00,['789991c56d9a333d52f382814a2de350864640e4'],0,1,1,21414328,1,,,,12849
8a293adf1a8b1369bef803a224e88c88371dbc57,0,eroma2014,2020-12-18 13:44:21-05:00,['213efb65b84bbfd9e9e96a2724032c43c0ab1a8d'],4,4,8,21414336,1,,,,12849
c1a8d98d96c2ec7aca22b3f0a09fcfdd6fb7e674,0,Dimuthu Wannipurage,2020-12-23 17:36:23-05:00,['19de9cf21f74e3e060caa989bdd50b436d1f411c'],4,26,30,21414366,1,,,,12849
da70969e7a5abffab0e2bd9420a5da265cb231bb,0,Dimuthu Wannipurage,2020-12-23 19:24:04-05:00,['c1a8d98d96c2ec7aca22b3f0a09fcfdd6fb7e674'],4,4,8,21414374,1,,,,12849
d19a697baaebecb7d8298f8fcb25751644846a49,0,Marcus Christie,2021-01-04 11:57:49-05:00,['8a293adf1a8b1369bef803a224e88c88371dbc57'],30,50,80,21414454,12,0.777777778,0.777777778,1,12849
d7b9f2b531424e87b26c87490f089b52fd30c5e7,0,Marcus Christie,2021-01-04 11:58:38-05:00,"['9939e072a1c2449446d2152ae8a108193f6c26ae', 'd19a697baaebecb7d8298f8fcb25751644846a49']",33,200,233,21414687,21,,,,12849
5760d1ba71ca753c2326112bca3c1ec1a8ea6b79,0,Dimuthu Wannipurage,2021-01-12 22:32:38-05:00,['d19a697baaebecb7d8298f8fcb25751644846a49'],2,1,3,21414690,2,,,,12849
6591afaaf6a594ceb9723738543224fd1d14bcfb,0,Marcus Christie,2021-01-14 19:03:53-05:00,['5760d1ba71ca753c2326112bca3c1ec1a8ea6b79'],0,23,23,21414713,4,,,,12849
59f74f2258339cb92d2e7d74558988692de63810,0,Marcus Christie,2021-01-15 16:40:15-05:00,['6591afaaf6a594ceb9723738543224fd1d14bcfb'],7,25,32,21414745,3,0,1,1,12849
ba8e0eaa4ecc933d204bd5709b002617b5c69bb9,0,Marcus Christie,2021-01-15 16:40:33-05:00,"['d7b9f2b531424e87b26c87490f089b52fd30c5e7', '59f74f2258339cb92d2e7d74558988692de63810']",9,49,58,21414803,9,,,,12849
a8fc69bfee49f49507f1d926e9baa2db51cb290b,0,Marcus Christie,2021-01-18 07:56:04-05:00,"['6591afaaf6a594ceb9723738543224fd1d14bcfb', '6abd10f2415281dc6e6887f55b82cb76e10e9c8d']",6,47,53,21414856,2,,,,12849
3e209add01983edb6dbaa475a8466e39cbac3ae1,0,Marcus Christie,2021-01-18 09:28:11-05:00,['a8fc69bfee49f49507f1d926e9baa2db51cb290b'],0,1,1,21414857,1,,,,12849
187563146e63f8448e6eaab22534e2386de97bcf,0,eroma2014,2021-01-21 05:33:06-05:00,['3e209add01983edb6dbaa475a8466e39cbac3ae1'],1,137,138,21414995,5,,,,12853
5abbf62516a637c4e79dd9a85b58c1a587c2e1c9,1,eroma2014,2021-01-21 10:12:04-05:00,['187563146e63f8448e6eaab22534e2386de97bcf'],14,29,43,21415038,3,,,,12854
75a478a9c58293fecd41f3a59475f0c7bd0ca08f,0,eroma2014,2021-01-21 10:16:28-05:00,['5abbf62516a637c4e79dd9a85b58c1a587c2e1c9'],0,2,2,21415040,1,,,,12854
e4d32c119ee3d8541fc1f466a714068e3bcace57,0,eroma2014,2021-01-21 10:40:29-05:00,['75a478a9c58293fecd41f3a59475f0c7bd0ca08f'],5,5,10,21415050,1,,,,12854
e6dc2231566c9d206cb70eb566cbbf65c60350ee,0,eroma2014,2021-01-21 10:44:59-05:00,['e4d32c119ee3d8541fc1f466a714068e3bcace57'],5,5,10,21415060,1,,,,12854
6663206a81ddb1794e5ba09b09c0ca001a99c9b8,0,Marcus Christie,2021-01-22 16:51:16-05:00,['e6dc2231566c9d206cb70eb566cbbf65c60350ee'],0,10,10,21415070,1,,,,12854
e9bafb7c9ab8c7e7e54a8542cdff8c592a1aa4f9,0,eroma2014,2021-01-29 14:59:19-05:00,['6663206a81ddb1794e5ba09b09c0ca001a99c9b8'],1,1,2,21415072,1,,,,12854
c156d06c82e9cb357484c99e9dec3504d6958479,0,eroma2014,2021-01-29 15:16:29-05:00,['e9bafb7c9ab8c7e7e54a8542cdff8c592a1aa4f9'],0,53,53,21415125,1,,,,12855
5b5aa3190de7bd75200d5b673ab3ad77c37c3241,1,eroma2014,2021-01-29 15:21:12-05:00,['c156d06c82e9cb357484c99e9dec3504d6958479'],0,15,15,21415140,1,,,,12856
470698029e1682c6fea00be41037425454309337,0,eroma2014,2021-01-29 15:39:17-05:00,['5b5aa3190de7bd75200d5b673ab3ad77c37c3241'],0,1,1,21415141,1,,,,12856
9a6177d8e473d3e165ab470a33d30020dda0bb51,0,eroma2014,2021-01-29 16:07:59-05:00,['470698029e1682c6fea00be41037425454309337'],5,5,10,21415151,1,,,,12856
4369bf079c0084faca8e8e8aa6816030b1d5452e,0,eroma2014,2021-01-29 16:22:31-05:00,['9a6177d8e473d3e165ab470a33d30020dda0bb51'],1,1,2,21415153,1,,,,12856
2725c4257aa1536926dea523cc376ed2eb46a421,0,eroma2014,2021-02-01 13:44:14-05:00,['9939e072a1c2449446d2152ae8a108193f6c26ae'],1,3,4,21415157,1,,,,12856
2a4ca69878f988bdcde8bb710104b22c3fdbd169,0,eroma2014,2021-02-01 13:44:43-05:00,"['2725c4257aa1536926dea523cc376ed2eb46a421', 'ba8e0eaa4ecc933d204bd5709b002617b5c69bb9']",42,249,291,21415448,29,,,,12856
a252e9c322cfc2dacb34eca6cabe7eebb3de8633,0,eroma2014,2021-02-01 13:45:20-05:00,['2a4ca69878f988bdcde8bb710104b22c3fdbd169'],1,1,2,21415450,1,,,,12856
461da06fe90bd21b60feb5aff6f184d6e3472147,0,Marcus Christie,2021-02-22 18:56:39-05:00,['4369bf079c0084faca8e8e8aa6816030b1d5452e'],20,239,259,21415709,19,,,,12861
6d18965c858370ac0348096415d2beae3e1f8564,0,Marcus Christie,2021-02-22 19:01:49-05:00,"['a252e9c322cfc2dacb34eca6cabe7eebb3de8633', '461da06fe90bd21b60feb5aff6f184d6e3472147']",22,474,496,21416205,31,,,,12861
9dd14eb34c95b5ff056108ade81e5cf61d276e55,0,Marcus Christie,2021-02-23 13:16:31-05:00,['461da06fe90bd21b60feb5aff6f184d6e3472147'],0,4,4,21416209,2,,,,12861
71815bdd1f28cb45efa9cb21b4baaac33417f97b,0,Marcus Christie,2021-02-23 13:18:19-05:00,['9dd14eb34c95b5ff056108ade81e5cf61d276e55'],0,1,1,21416210,1,,,,12861
67fc7b8c07014357901ef8e86966398230d676aa,0,Marcus Christie,2021-02-23 13:18:29-05:00,"['6d18965c858370ac0348096415d2beae3e1f8564', '71815bdd1f28cb45efa9cb21b4baaac33417f97b']",0,5,5,21416215,3,,,,12861
b270c68cbb7722c4559b3e16a40475fe7706e13b,0,eroma2014,2021-02-25 10:30:32-05:00,['4369bf079c0084faca8e8e8aa6816030b1d5452e'],0,1,1,21416216,1,,,,12861
eb21b49e1edd73491b3b47d975413df69452b777,0,eroma2014,2021-03-11 13:32:46-05:00,['b270c68cbb7722c4559b3e16a40475fe7706e13b'],0,54,54,21416270,1,,,,12862
040fb20cdb7cf90978cd2016ad4c1042e4dcdd30,1,eroma2014,2021-03-11 13:34:44-05:00,['eb21b49e1edd73491b3b47d975413df69452b777'],0,15,15,21416285,1,,,,12863
f671a668dab09d8811913348ecab4a6e243c91aa,0,eroma2014,2021-03-11 13:54:21-05:00,['040fb20cdb7cf90978cd2016ad4c1042e4dcdd30'],0,1,1,21416286,1,,,,12863
37ed413af2a9a8f84d1079f0a2173b28f8ae980e,0,eroma2014,2021-03-11 15:14:13-05:00,['f671a668dab09d8811913348ecab4a6e243c91aa'],1,1,2,21416288,1,,,,12863
4cb05f2db32e1bca8508cc524016fb89fc55c106,0,eroma2014,2021-03-12 08:00:12-05:00,['37ed413af2a9a8f84d1079f0a2173b28f8ae980e'],0,54,54,21416342,1,,,,12864
88f962e578f74bb3531123ae2b7d639ac72907b3,0,eroma2014,2021-03-12 08:01:59-05:00,['4cb05f2db32e1bca8508cc524016fb89fc55c106'],0,1,1,21416343,1,,,,12864
c795c1fdb6bdb25f25426304884486a24a0424d5,1,eroma2014,2021-03-12 08:04:20-05:00,['88f962e578f74bb3531123ae2b7d639ac72907b3'],0,15,15,21416358,1,,,,12865
262bd7dcb71062d4c22c46e6dc80bc240fc1570c,0,eroma2014,2021-03-12 08:47:41-05:00,['c795c1fdb6bdb25f25426304884486a24a0424d5'],4,4,8,21416366,1,,,,12865
91912f2f6101fda24737f8c4f55caf929f594447,0,eroma2014,2021-03-12 14:08:43-05:00,['262bd7dcb71062d4c22c46e6dc80bc240fc1570c'],4,4,8,21416374,1,,,,12865
b241e8ab70878dfd32e2c18fad5c7c0e5f7acf8d,0,Marcus Christie,2021-03-18 17:13:32-04:00,['91912f2f6101fda24737f8c4f55caf929f594447'],64,0,64,21416438,3,,,,12865
110c18138b38abd5ff88e8bb1c9698db6fd8592c,0,Marcus Christie,2021-03-22 19:24:26-04:00,['b241e8ab70878dfd32e2c18fad5c7c0e5f7acf8d'],1,0,1,21416439,1,,,,12865
18cec903938cc3d24ecb4c287070c2deb7da4f72,0,Marcus Christie,2021-03-22 19:24:48-04:00,"['67fc7b8c07014357901ef8e86966398230d676aa', '110c18138b38abd5ff88e8bb1c9698db6fd8592c']",65,141,206,21416645,9,,,,12865
0f57c46948b774cb36aed0c2f0ad1183b9a54685,0,Marcus Christie,2021-03-24 14:41:53-04:00,['110c18138b38abd5ff88e8bb1c9698db6fd8592c'],15,0,15,21416660,1,,,,12865
b47edb2ac6bb1664d49dba0cade354bed0c503a9,0,Marcus Christie,2021-03-24 17:09:29-04:00,"['0f57c46948b774cb36aed0c2f0ad1183b9a54685', '59f74f2258339cb92d2e7d74558988692de63810']",7,25,32,21416692,3,,,,12865
802d5bf5bd668c0b930968519cef8dcbbed5e061,0,Marcus Christie,2021-03-24 17:10:38-04:00,"['b47edb2ac6bb1664d49dba0cade354bed0c503a9', '106e0102d9f017393e6e06dd6e01f8cb88567616']",9,19,28,21416720,10,,,,12865
19c817d335d48de1820284c0b907ef5eb7c5d105,0,Marcus Christie,2021-03-25 08:18:48-04:00,['802d5bf5bd668c0b930968519cef8dcbbed5e061'],1,8,9,21416729,2,,,,12865
d6ad14d1c5ee34ea2cfb4a25379c1209d351a4da,0,Suresh Marru,2021-03-25 09:10:44-04:00,['19c817d335d48de1820284c0b907ef5eb7c5d105'],0,0,0,21416729,1,,,,12866
d0cac328eda705d7361a4dd6d20bfbd21071f85e,0,Marcus Christie,2021-03-25 09:34:36-04:00,['d6ad14d1c5ee34ea2cfb4a25379c1209d351a4da'],1,1,2,21416731,1,,,,12866
d89bf14f001126c8eea064d3b2952ea0fc192df9,0,Marcus Christie,2021-03-30 17:54:31-04:00,['802d5bf5bd668c0b930968519cef8dcbbed5e061'],0,45,45,21416776,3,,,,12867
f0636c5a87cad3f2a331574006a726d0e23cdea2,0,Marcus Christie,2021-03-30 17:54:50-04:00,"['18cec903938cc3d24ecb4c287070c2deb7da4f72', 'd89bf14f001126c8eea064d3b2952ea0fc192df9']",15,45,60,21416836,4,,,,12867
fdea18f1753b585aca949667738f206fb8fb9faa,0,eroma2014,2021-03-31 13:15:14-04:00,['d0cac328eda705d7361a4dd6d20bfbd21071f85e'],0,54,54,21416890,1,,,,12868
4f0679949f8b518457d26f1a058acf2ef5fa72c1,1,eroma2014,2021-03-31 15:40:28-04:00,['fdea18f1753b585aca949667738f206fb8fb9faa'],0,15,15,21416905,1,,,,12869
caea036973c17b8e8c932ebfc12a1523d3b65b65,0,eroma2014,2021-04-01 01:57:21-04:00,['4f0679949f8b518457d26f1a058acf2ef5fa72c1'],0,1,1,21416906,1,,,,12869
31707f7f79a670a9561b1b29f83a4b7adfede568,0,eroma2014,2021-04-01 14:47:22-04:00,['caea036973c17b8e8c932ebfc12a1523d3b65b65'],5,5,10,21416916,1,,,,12869
a4bc9e7f6af6d4e5911fae4beb2657ce912b226b,0,eroma2014,2021-04-05 12:42:12-04:00,['31707f7f79a670a9561b1b29f83a4b7adfede568'],1,1,2,21416918,1,,,,12869
fac5ff6c5f20b243c397cf56d7ab6084925436d7,0,Marcus Christie,2021-04-06 18:20:32-04:00,['a4bc9e7f6af6d4e5911fae4beb2657ce912b226b'],0,4,4,21416922,1,,,,12869
ccfeb356541985561df62be6906e6a1058424844,0,eroma2014,2021-04-07 10:36:11-04:00,['a4bc9e7f6af6d4e5911fae4beb2657ce912b226b'],1,1,2,21416924,1,,,,12869
d592ea0f917f680521e3f6c15cc7eed2766af77f,0,eroma2014,2021-04-07 10:36:27-04:00,"['ccfeb356541985561df62be6906e6a1058424844', 'fac5ff6c5f20b243c397cf56d7ab6084925436d7']",0,4,4,21416928,1,,,,12869
18f19beac293c953b7f0955130738c80ed2d4d4e,0,eroma2014,2021-04-07 10:39:41-04:00,['d592ea0f917f680521e3f6c15cc7eed2766af77f'],1,1,2,21416930,1,,,,12869
aa30d23606e4ccba9f86c4bf056b254fd38ac0bc,0,Feng Li,2021-04-07 21:11:23-04:00,['18cec903938cc3d24ecb4c287070c2deb7da4f72'],1,1,2,21416932,1,,,,12869
9afe03d21542e7cc1c7c1d525b75f6cbf82a5b08,0,Marcus Christie,2021-04-13 11:51:03-04:00,['18f19beac293c953b7f0955130738c80ed2d4d4e'],0,2,2,21416934,2,,,,12869
daa822e141511ba7702397d05d96052d7ddfda5a,0,Marcus Christie,2021-04-13 11:52:25-04:00,"['f0636c5a87cad3f2a331574006a726d0e23cdea2', '9afe03d21542e7cc1c7c1d525b75f6cbf82a5b08']",5,88,93,21417027,12,,,,12869
e663dc6f884d9fd5c612002a33f4a7c70c00d061,0,Marcus Christie,2021-04-13 17:16:34-04:00,"['9afe03d21542e7cc1c7c1d525b75f6cbf82a5b08', 'd89bf14f001126c8eea064d3b2952ea0fc192df9']",0,45,45,21417072,3,,,,12869
57f62ae244560e5cc0b5b8f5c7fbb80372bdd330,0,Marcus Christie,2021-04-13 17:24:47-04:00,['daa822e141511ba7702397d05d96052d7ddfda5a'],1,1,2,21417074,1,,,,12869
5d3598d7444c6f4dc15596219f101276d90dfd90,0,Marcus Christie,2021-04-16 12:10:39-04:00,['e663dc6f884d9fd5c612002a33f4a7c70c00d061'],2,5,7,21417081,1,,,,12869
c32fd5158475a86754428c609995946c7aceb976,0,Marcus Christie,2021-04-16 12:11:26-04:00,"['57f62ae244560e5cc0b5b8f5c7fbb80372bdd330', '5d3598d7444c6f4dc15596219f101276d90dfd90']",2,5,7,21417088,1,,,,12869
a933b5b9481b99bf85f1aec5f4bd6a7307a097e4,0,Marcus Christie,2021-04-16 14:01:29-04:00,['5d3598d7444c6f4dc15596219f101276d90dfd90'],0,103,103,21417191,2,,,,12870
5d99d5cc42a7888b255006c0ccfb1b1983c816ef,0,Marcus Christie,2021-04-16 14:01:40-04:00,"['c32fd5158475a86754428c609995946c7aceb976', 'a933b5b9481b99bf85f1aec5f4bd6a7307a097e4']",0,103,103,21417294,2,,,,12870
02f6dda5ecba1da38a8f917a178ff53aff2010ac,0,eroma2014,2021-04-23 09:17:14-04:00,['5d3598d7444c6f4dc15596219f101276d90dfd90'],1,1,2,21417296,1,,,,12870
c8f0074dbd27d0c56ce77c58821ccdaffae2ee1d,0,eroma2014,2021-04-26 11:35:49-04:00,['5d99d5cc42a7888b255006c0ccfb1b1983c816ef'],0,63,63,21417359,2,,,,12871
aeb0ca5062f715a9ff99a2afa8901c77c4894e3d,0,Marcus Christie,2021-04-28 16:26:50-04:00,['02f6dda5ecba1da38a8f917a178ff53aff2010ac'],0,3,3,21417362,1,,,,12871
cef4ed87720ddb383bd6e59a0016daab260fe46c,0,eroma2014,2021-04-29 13:16:17-04:00,['c8f0074dbd27d0c56ce77c58821ccdaffae2ee1d'],0,15,15,21417377,1,,,,12872
5913fffca32f96e62c35ec01a99a228d2cf0773e,0,Marcus Christie,2021-05-03 16:39:48-04:00,['aeb0ca5062f715a9ff99a2afa8901c77c4894e3d'],0,3,3,21417380,1,,,,12872
21770f03822b0c2384fa51dc5200e10c2387a0a2,0,Marcus Christie,2021-05-11 17:15:43-04:00,['cef4ed87720ddb383bd6e59a0016daab260fe46c'],1,2,3,21417383,1,0,1,1,12872
8c2d736bc4f06aaff3a4eb78964094747a40e488,0,Marcus Christie,2021-05-19 14:59:05-04:00,['a933b5b9481b99bf85f1aec5f4bd6a7307a097e4'],0,3,3,21417386,1,,,,12872
9fa604c9a9fd70970042104b335a3e0cb1e89f68,0,Marcus Christie,2021-05-20 17:55:34-04:00,['8c2d736bc4f06aaff3a4eb78964094747a40e488'],13,553,566,21417952,8,,,,12877
ee49f05f49464b86d39b6c0deb427d1e8d535a07,0,Marcus Christie,2021-05-20 17:56:30-04:00,"['21770f03822b0c2384fa51dc5200e10c2387a0a2', '9fa604c9a9fd70970042104b335a3e0cb1e89f68']",13,556,569,21418521,9,,,,12877
ab3c9972665547ed4d69be859625dad3b726171b,0,Dimuthu Wannipurage,2021-05-21 12:34:28-04:00,['02f6dda5ecba1da38a8f917a178ff53aff2010ac'],1,3,4,21418525,1,1,1,1,12877
c62abdbd24a6f6bf6ad1d551e658fb5257df28a3,0,GitHub,2021-05-21 12:55:39-04:00,"['5913fffca32f96e62c35ec01a99a228d2cf0773e', 'ab3c9972665547ed4d69be859625dad3b726171b']",1,3,4,21418529,1,,,,12877
ffaa64ca529e07c4ee6231da6521f08e5b3e5fd4,0,Marcus Christie,2021-05-27 17:11:23-04:00,['9fa604c9a9fd70970042104b335a3e0cb1e89f68'],8,7,15,21418544,3,,,,12877
371d7f5f6a85037f4fc3cbab44ac4ef30e962a4c,0,Marcus Christie,2021-05-27 17:11:44-04:00,"['ee49f05f49464b86d39b6c0deb427d1e8d535a07', 'ffaa64ca529e07c4ee6231da6521f08e5b3e5fd4']",8,7,15,21418559,3,,,,12877
c326b23f29c11fe9a4df067d6f52117cdd176fc1,0,Marcus Christie,2021-05-27 17:25:38-04:00,['371d7f5f6a85037f4fc3cbab44ac4ef30e962a4c'],1,0,1,21418560,1,,,,12877
460f4a75cbb56ac500e9ae94a90a9aa78777657f,0,Marcus Christie,2021-05-28 09:51:31-04:00,['c62abdbd24a6f6bf6ad1d551e658fb5257df28a3'],66,0,66,21418626,3,,,,12877
f9bb3a193a85860ec66cf48a60797b630bd2abe8,0,Marcus Christie,2021-05-28 15:54:31-04:00,['ffaa64ca529e07c4ee6231da6521f08e5b3e5fd4'],0,1,1,21418627,1,,,,12877
ba5a0863ca989b8d3742648b756b9f9c51d3f7d2,0,Marcus Christie,2021-05-28 15:54:45-04:00,"['c326b23f29c11fe9a4df067d6f52117cdd176fc1', 'f9bb3a193a85860ec66cf48a60797b630bd2abe8']",0,1,1,21418628,1,,,,12877
046cd4646c55b6263a182d98ac0e7cdd0d82ea1a,0,Marcus Christie,2021-05-28 16:03:08-04:00,"['460f4a75cbb56ac500e9ae94a90a9aa78777657f', 'f9bb3a193a85860ec66cf48a60797b630bd2abe8']",17,663,680,21419308,11,,,,12877
85b002bf01c06b056c4f4c539303d67314353c05,0,Marcus Christie,2021-06-02 18:06:50-04:00,['046cd4646c55b6263a182d98ac0e7cdd0d82ea1a'],0,1,1,21419309,1,,,,12877
2385d2ec9c3b960cb57e2f85ea4b44a1cfc57daa,0,Marcus Christie,2021-06-07 11:24:23-04:00,['85b002bf01c06b056c4f4c539303d67314353c05'],0,3,3,21419312,1,,,,12877
8b3f88958ec0c31cb991ea76fefd6cfc32b2d119,0,Marcus Christie,2021-06-09 17:00:15-04:00,['2385d2ec9c3b960cb57e2f85ea4b44a1cfc57daa'],0,1,1,21419313,1,,,,12877
e5de21a429667fd6a89a8abb80962670ab434459,0,Marcus Christie,2021-06-09 17:00:22-04:00,"['ba5a0863ca989b8d3742648b756b9f9c51d3f7d2', '8b3f88958ec0c31cb991ea76fefd6cfc32b2d119']",68,15,83,21419396,9,,,,12877
885ec28ad7942016baa2ef72abbbc3c364c15f9a,0,Marcus Christie,2021-06-10 15:52:42-04:00,['2385d2ec9c3b960cb57e2f85ea4b44a1cfc57daa'],0,3,3,21419399,1,,,,12877
2172f74aa0231e13544e16bd4fb692568587fc8e,0,Marcus Christie,2021-06-11 14:34:20-04:00,['885ec28ad7942016baa2ef72abbbc3c364c15f9a'],1,0,1,21419400,1,,,,12877
bfe29572f8726d28d924a3631ca8ece4e898a1ab,0,Marcus Christie,2021-06-11 16:31:53-04:00,['2172f74aa0231e13544e16bd4fb692568587fc8e'],1,1295,1296,21420696,3,,,,12878
aa7915e69846ac0ba0ef6e1108bf501c04e7e83a,0,Marcus Christie,2021-06-11 16:45:25-04:00,"['e5de21a429667fd6a89a8abb80962670ab434459', 'bfe29572f8726d28d924a3631ca8ece4e898a1ab']",2,1298,1300,21421996,5,,,,12878
b66261fe70b34e9434a466208d84dc000b45e0c2,0,Marcus Christie,2021-06-14 13:47:05-04:00,['2172f74aa0231e13544e16bd4fb692568587fc8e'],4,4,8,21422004,1,,,,12878
ff12b5cef74cb556d5618aef45b7b09c21345d64,0,Marcus Christie,2021-06-15 13:54:50-04:00,"['aa7915e69846ac0ba0ef6e1108bf501c04e7e83a', 'b66261fe70b34e9434a466208d84dc000b45e0c2']",4,4,8,21422012,1,,,,12878
a8e0fd5d77ef198c5948715dd12ffaa619c74f94,0,Marcus Christie,2021-06-17 11:20:44-04:00,['2172f74aa0231e13544e16bd4fb692568587fc8e'],0,3,3,21422015,1,,,,12878
e4a6f13c3ec68c7a2ee174e5095b2dd7d5bd02d3,0,Marcus Christie,2021-06-17 12:48:12-04:00,['a8e0fd5d77ef198c5948715dd12ffaa619c74f94'],1,1,2,21422017,1,,,,12878
ace6d9cb19133e27841ceb9a5d4264880c6a86af,0,Marcus Christie,2021-06-23 09:03:14-04:00,['ff12b5cef74cb556d5618aef45b7b09c21345d64'],2,2,4,21422021,1,,,,12878
38a5136c296a2c887f7bd131be0b6bbfba1cf071,0,Marcus Christie,2021-06-23 11:53:01-04:00,['e4a6f13c3ec68c7a2ee174e5095b2dd7d5bd02d3'],32,88,120,21422141,1,0.302325581,0.720930233,0.325581395,12878
813f7c3bf77f228ae26439c79311bbef7a9fc07e,0,Marcus Christie,2021-06-23 11:53:01-04:00,['38a5136c296a2c887f7bd131be0b6bbfba1cf071'],49,508,557,21422698,8,0.256559767,0.247813411,0.664723032,12878
e1703419beb0961c1fd2900f3ee06b4e777ef71a,0,Marcus Christie,2021-06-23 11:53:02-04:00,['813f7c3bf77f228ae26439c79311bbef7a9fc07e'],5,9,14,21422712,2,,,,12878
06e4dad62c0eec2e2ca3afef7c3c386e89577d6e,0,Marcus Christie,2021-06-23 11:53:29-04:00,"['ace6d9cb19133e27841ceb9a5d4264880c6a86af', 'e1703419beb0961c1fd2900f3ee06b4e777ef71a']",78,600,678,21423390,10,,,,12878
b9e44ea589cc60409da8a259f3fb2d265c41fb5a,0,Marcus Christie,2021-06-23 12:13:28-04:00,['e1703419beb0961c1fd2900f3ee06b4e777ef71a'],1,1,2,21423392,1,,,,12878
6f932caee3ebe026495197f7fb17dbfb562666c5,0,Marcus Christie,2021-06-23 12:13:42-04:00,"['06e4dad62c0eec2e2ca3afef7c3c386e89577d6e', 'b9e44ea589cc60409da8a259f3fb2d265c41fb5a']",1,1,2,21423394,1,,,,12878
bea9611f40efb9236dbf5a44f673f6cf4c63dee2,0,Marcus Christie,2021-06-23 13:06:36-04:00,['b9e44ea589cc60409da8a259f3fb2d265c41fb5a'],10,142,152,21423546,3,0.269662921,0.269662921,0.91011236,12878
30e675f69408f54f20f82e2955ca9579ea4c3e2a,0,Marcus Christie,2021-06-23 15:44:41-04:00,['bea9611f40efb9236dbf5a44f673f6cf4c63dee2'],0,3,3,21423549,1,,,,12878
041a3e124df2095cf1911785e99e0bef9b90aca5,0,Marcus Christie,2021-06-23 16:25:16-04:00,"['6f932caee3ebe026495197f7fb17dbfb562666c5', '30e675f69408f54f20f82e2955ca9579ea4c3e2a']",10,145,155,21423704,4,,,,12878
7669775a0132665d62c5643f2ebc84d65ee1f2cc,0,Marcus Christie,2021-06-23 17:17:50-04:00,['041a3e124df2095cf1911785e99e0bef9b90aca5'],142,10,152,21423856,3,0.730337079,0.730337079,0.08988764,12878
a9b5ded0c7337073eccda529117c898e373002d1,0,Marcus Christie,2021-06-29 17:08:55-04:00,['e4a6f13c3ec68c7a2ee174e5095b2dd7d5bd02d3'],3,2,5,21423861,1,,,,12878
453194f18e13fa88fd05ba8c32370ab94e643eda,0,Marcus Christie,2021-06-29 17:36:51-04:00,['e4a6f13c3ec68c7a2ee174e5095b2dd7d5bd02d3'],1,15,16,21423877,1,,,,12878
297c834b981ebb161d89d6e549fd730cee58b78e,0,Marcus Christie,2021-06-29 17:37:09-04:00,"['7669775a0132665d62c5643f2ebc84d65ee1f2cc', '453194f18e13fa88fd05ba8c32370ab94e643eda']",1,15,16,21423893,1,,,,12878
ef4d0a5a0dfa083a3b98be572fd9d9aaa4147373,0,Marcus Christie,2021-06-30 16:11:02-04:00,['a9b5ded0c7337073eccda529117c898e373002d1'],1,15,16,21423909,1,,,,12878
91cf0d100e53db4027f2ca4529463c104c301d82,0,Marcus Christie,2021-07-01 15:53:43-04:00,['297c834b981ebb161d89d6e549fd730cee58b78e'],0,5,5,21423914,1,,,,12878
a0de241225cf0b1d7e66482cccd4adc53978ae5b,0,Marcus Christie,2021-07-06 16:09:05-04:00,['e4a6f13c3ec68c7a2ee174e5095b2dd7d5bd02d3'],0,12,12,21423926,4,,,,12878
ebdd083580a01e4e876713f9ec76e719c463b636,0,Marcus Christie,2021-07-06 16:09:14-04:00,"['ef4d0a5a0dfa083a3b98be572fd9d9aaa4147373', 'a0de241225cf0b1d7e66482cccd4adc53978ae5b']",0,12,12,21423938,4,,,,12878
9977e93e1b789b42a5a2640273639453e94eb032,0,eroma2014,2021-07-08 07:44:52-04:00,['ebdd083580a01e4e876713f9ec76e719c463b636'],6,6,12,21423950,1,,,,12878
a3c36da244d956f147eac88882cb343e08c7473a,0,Marcus Christie,2021-07-13 17:31:51-04:00,"['9977e93e1b789b42a5a2640273639453e94eb032', '8b3f88958ec0c31cb991ea76fefd6cfc32b2d119']",0,1,1,21423951,1,,,,12878
2dee29ea7bb986dd65ea4375914e7ceca1797400,0,Marcus Christie,2021-07-26 13:44:41-04:00,['a3c36da244d956f147eac88882cb343e08c7473a'],0,1,1,21423952,1,0,1,1,12878
25464e4665f0de37df7ce45b16aeea28d2efa8b0,0,Marcus Christie,2021-07-26 13:46:42-04:00,"['91cf0d100e53db4027f2ca4529463c104c301d82', '2dee29ea7bb986dd65ea4375914e7ceca1797400']",9,21,30,21423982,7,,,,12878
f8ed00e398c34a95fa8b81301881b62eec54afcc,0,Marcus Christie,2021-07-27 15:04:47-04:00,['2dee29ea7bb986dd65ea4375914e7ceca1797400'],0,14,14,21423996,6,,,,12878
0d42f70088f17d091c2efb2a237973e6e6226f34,0,Marcus Christie,2021-07-27 15:04:57-04:00,"['25464e4665f0de37df7ce45b16aeea28d2efa8b0', 'f8ed00e398c34a95fa8b81301881b62eec54afcc']",0,14,14,21424010,6,,,,12878
247d63f6079cdf6827d5b0f589a7d622c15540ce,0,Marcus Christie,2021-07-27 16:40:26-04:00,['30e675f69408f54f20f82e2955ca9579ea4c3e2a'],1,1,2,21424012,1,,,,12878
df4a8a711fd87d758c6562bdb920a605e4f0b279,0,Marcus Christie,2021-08-02 10:37:02-04:00,['a3c36da244d956f147eac88882cb343e08c7473a'],2,2,4,21424016,2,,,,12878
a22db2c47e8aaa55f32bdada99ca36c107f24618,0,Marcus Christie,2021-08-03 15:38:03-04:00,['df4a8a711fd87d758c6562bdb920a605e4f0b279'],1,2,3,21424019,1,,,,12878
5fd75865c13835b4900d58f267eac57ce5228ba6,0,Marcus Christie,2021-08-04 12:25:42-04:00,['0d42f70088f17d091c2efb2a237973e6e6226f34'],0,2,2,21424021,1,,,,12878
333d7f3bc61dec3963f9127d4c6bd6eb1b37def4,0,Marcus Christie,2021-08-04 12:44:33-04:00,['5fd75865c13835b4900d58f267eac57ce5228ba6'],0,2,2,21424023,1,,,,12878
4eb447622c6b395c43270b17a658e78b952f7728,0,Marcus Christie,2021-08-04 13:56:38-04:00,['a22db2c47e8aaa55f32bdada99ca36c107f24618'],3,11,14,21424037,1,,,,12878
35bbf10eea2272808b18d8fb417ff7cf64042a92,0,Marcus Christie,2021-08-04 16:10:23-04:00,"['333d7f3bc61dec3963f9127d4c6bd6eb1b37def4', '4eb447622c6b395c43270b17a658e78b952f7728']",6,15,21,21424058,4,,,,12878
404b05432f4b3b0ee8827250f7c353eafd84e813,0,eroma2014,2021-08-06 03:26:07-04:00,['4eb447622c6b395c43270b17a658e78b952f7728'],0,53,53,21424111,1,,,,12879
c76154c6ed7ad9cdfcb50491fbfbe528755d4d6f,0,eroma2014,2021-08-06 03:30:57-04:00,['404b05432f4b3b0ee8827250f7c353eafd84e813'],0,1,1,21424112,1,,,,12879
edacc61ed4771a21a7835754f920c1992908a788,1,eroma2014,2021-08-06 03:31:11-04:00,['c76154c6ed7ad9cdfcb50491fbfbe528755d4d6f'],0,15,15,21424127,1,,,,12880
ad3ce1c2f34db9ae84bd6cb444330ea5aef5041d,0,eroma2014,2021-08-06 09:58:41-04:00,['edacc61ed4771a21a7835754f920c1992908a788'],4,4,8,21424135,1,,,,12880
107f91ee40fb11f31e10872f2a83e2f2cd2d9ea4,0,Marcus Christie,2021-08-06 11:51:58-04:00,['ad3ce1c2f34db9ae84bd6cb444330ea5aef5041d'],1,0,1,21424136,1,1,0,0,12880
8878d9c79d7b7ace92077cb41b3787974cdaf4ff,0,Marcus Christie,2021-08-06 11:52:07-04:00,"['35bbf10eea2272808b18d8fb417ff7cf64042a92', '107f91ee40fb11f31e10872f2a83e2f2cd2d9ea4']",1,69,70,21424206,4,,,,12880
ef0b2f99f1765ea4551e5dbc03b03525d6947c8a,0,Marcus Christie,2021-08-16 15:04:26-04:00,"['ad3ce1c2f34db9ae84bd6cb444330ea5aef5041d', '247d63f6079cdf6827d5b0f589a7d622c15540ce']",88,742,830,21425036,13,,,,12880
b8004747428f969eda9345cab84ad73d70e068fd,0,Marcus Christie,2021-08-18 10:06:40-04:00,['ef0b2f99f1765ea4551e5dbc03b03525d6947c8a'],39,224,263,21425299,4,0.093333333,0.213333333,0.3,12880
af0b722f8556cd25f047fecc749cd83d205f1fac,0,Marcus Christie,2021-08-18 10:07:13-04:00,"['8878d9c79d7b7ace92077cb41b3787974cdaf4ff', 'b8004747428f969eda9345cab84ad73d70e068fd']",40,225,265,21425564,5,,,,12880
de930b7ea1cc8dadae491bcfd65383773b15c40b,0,Marcus Christie,2021-08-18 11:13:16-04:00,['b8004747428f969eda9345cab84ad73d70e068fd'],1,16,17,21425581,2,0,1,0.8,12880
5b69f2b17c5d0603a134e6236a24e18cbdc09295,0,Marcus Christie,2021-08-18 11:13:49-04:00,"['af0b722f8556cd25f047fecc749cd83d205f1fac', 'de930b7ea1cc8dadae491bcfd65383773b15c40b']",1,16,17,21425598,2,,,,12880
7f2e2255ceab4f24db198c824dd86944f739699e,0,Marcus Christie,2021-08-23 16:34:36-04:00,['ad3ce1c2f34db9ae84bd6cb444330ea5aef5041d'],0,1,1,21425599,1,,,,12880
19b6f9ec78496af092239b44a142c731bc0d4804,1,Marcus Christie,2021-08-25 11:36:21-04:00,['7f2e2255ceab4f24db198c824dd86944f739699e'],0,5,5,21425604,1,,,,12880
f2433a9cb651ad734ab0eaba515d7d64bcc23ff9,0,Marcus Christie,2021-08-30 17:12:36-04:00,['5b69f2b17c5d0603a134e6236a24e18cbdc09295'],0,4,4,21425608,1,,,,12880
b064dcaf3482befa8394ab70534714c24304e8d0,0,Marcus Christie,2021-08-31 17:06:14-04:00,['19b6f9ec78496af092239b44a142c731bc0d4804'],3,6,9,21425617,2,0,0,0.666666667,12880
f1f17c082489e96c03c0213ea943bfa1190ebbfd,0,Marcus Christie,2021-08-31 17:06:37-04:00,"['f2433a9cb651ad734ab0eaba515d7d64bcc23ff9', 'b064dcaf3482befa8394ab70534714c24304e8d0']",3,12,15,21425632,4,,,,12880
23e272d66a018fb0b0e558d83a30f3cfbb0e599b,0,Marcus Christie,2021-08-31 17:25:00-04:00,"['19b6f9ec78496af092239b44a142c731bc0d4804', 'b66261fe70b34e9434a466208d84dc000b45e0c2']",4,4,8,21425640,1,,,,12880
ba00d1e188e29c70683e3b1c9e64a04c6eaf98b4,0,Marcus Christie,2021-08-31 17:25:09-04:00,"['23e272d66a018fb0b0e558d83a30f3cfbb0e599b', 'de930b7ea1cc8dadae491bcfd65383773b15c40b']",121,975,1096,21426736,14,,,,12880
ecd0b55eca8b724fc1f6fab1631fc6c760c42582,0,Marcus Christie,2021-08-31 17:25:36-04:00,"['ba00d1e188e29c70683e3b1c9e64a04c6eaf98b4', '107f91ee40fb11f31e10872f2a83e2f2cd2d9ea4']",1,0,1,21426737,1,,,,12880
8c07b4d472319d7849ab6f46c301f26682299859,0,Marcus Christie,2021-08-31 17:25:45-04:00,"['ecd0b55eca8b724fc1f6fab1631fc6c760c42582', 'b064dcaf3482befa8394ab70534714c24304e8d0']",3,6,9,21426746,2,,,,12880
97dfd4180226852f897a16d2bd76cec3053e65ac,0,Marcus Christie,2021-09-01 09:57:49-04:00,['8c07b4d472319d7849ab6f46c301f26682299859'],5,0,5,21426751,1,,,,12880
d63ab43a1cb1cc5867b0a4be673d1ef0edba3224,0,Marcus Christie,2021-09-01 09:58:29-04:00,"['f1f17c082489e96c03c0213ea943bfa1190ebbfd', '97dfd4180226852f897a16d2bd76cec3053e65ac']",5,0,5,21426756,1,,,,12880
f33fef9e74f31b68a87232017028ba3831a33167,0,Marcus Christie,2021-09-14 09:26:32-04:00,"['97dfd4180226852f897a16d2bd76cec3053e65ac', 'bfe29572f8726d28d924a3631ca8ece4e898a1ab']",1,1295,1296,21428052,3,,,,12880
e0a961cf5058debf230cdd6b55412ffbf2b842eb,0,Marcus Christie,2021-09-15 18:08:04-04:00,['f33fef9e74f31b68a87232017028ba3831a33167'],2,2,4,21428056,1,,,,12880
e48e3a3b83c87724eaf41d0a216c38c34f8b91b2,0,Marcus Christie,2021-09-24 12:08:01-04:00,['e0a961cf5058debf230cdd6b55412ffbf2b842eb'],2,2,4,21428060,1,,,,12880
99901ed55e60d9d9cdb793647664ab02f021aa2f,0,Marcus Christie,2021-09-24 16:55:10-04:00,['d63ab43a1cb1cc5867b0a4be673d1ef0edba3224'],0,4,4,21428064,1,,,,12880
063ff910966f582bece3b2062d50f64cbfe8fd82,0,Marcus Christie,2021-09-27 17:01:13-04:00,['e48e3a3b83c87724eaf41d0a216c38c34f8b91b2'],1,1,2,21428066,1,,,,12880
9621eb585e146f30593c8298bc4fb74d3e774629,0,eroma2014,2021-09-28 10:16:18-04:00,['063ff910966f582bece3b2062d50f64cbfe8fd82'],1,2,3,21428069,1,,,,12880
ad1e6b97a0a393c89d39e3a30153a8f12ca0f518,0,eroma2014,2021-09-28 10:42:37-04:00,['9621eb585e146f30593c8298bc4fb74d3e774629'],3,3,6,21428075,1,,,,12880
26e585d8500ac07dd954502d734c4ceeaa8e0791,0,Marcus Christie,2021-09-28 14:35:16-04:00,['ad1e6b97a0a393c89d39e3a30153a8f12ca0f518'],1,2,3,21428078,1,,,,12880
c97759dd870864f25b838f5424b9e2761642e87c,0,Marcus Christie,2021-09-28 14:55:41-04:00,['26e585d8500ac07dd954502d734c4ceeaa8e0791'],0,4,4,21428082,1,,,,12880
34658614bd00544d3b7d92017768b00525244235,0,Marcus Christie,2021-10-05 17:30:34-04:00,['c97759dd870864f25b838f5424b9e2761642e87c'],1,1,2,21428084,1,,,,12880
a087a0bbefed65ad971b7a84f7dff2c14107111c,0,Marcus Christie,2021-10-06 13:37:24-04:00,['f33fef9e74f31b68a87232017028ba3831a33167'],4,4,8,21428092,1,,,,12880
5a932a29911f123a3e5e3529af4951809861d93e,0,Marcus Christie,2021-10-06 13:39:18-04:00,"['99901ed55e60d9d9cdb793647664ab02f021aa2f', 'a087a0bbefed65ad971b7a84f7dff2c14107111c']",4,4,8,21428100,1,,,,12880
fe684b4ecdd113a93d4e66b3bffc6abbde4cfc94,0,Marcus Christie,2021-10-07 16:49:40-04:00,['34658614bd00544d3b7d92017768b00525244235'],0,3,3,21428103,1,,,,12880
049ef091689a6fbafd92086d2b10fecb4ba8d602,0,eroma2014,2021-10-08 13:29:19-04:00,['fe684b4ecdd113a93d4e66b3bffc6abbde4cfc94'],0,1,1,21428104,1,,,,12880
6a43acf4086fd40d6f9482211029fc628145a9dd,0,eroma2014,2021-10-08 14:03:57-04:00,['049ef091689a6fbafd92086d2b10fecb4ba8d602'],1,1,2,21428106,1,,,,12880
e6db55ab86f6e49a0ee9e070ed8663c7bf36393e,0,eroma2014,2021-10-13 15:40:45-04:00,['6a43acf4086fd40d6f9482211029fc628145a9dd'],0,53,53,21428159,1,,,,12881
7b1433a74e29f244ae3b8b62c31a81dd03aab6d6,1,eroma2014,2021-10-13 15:42:23-04:00,['e6db55ab86f6e49a0ee9e070ed8663c7bf36393e'],0,15,15,21428174,1,,,,12882
4afcb70a1682be89a18526b1b27ee25bee026346,0,eroma2014,2021-10-13 15:43:00-04:00,['7b1433a74e29f244ae3b8b62c31a81dd03aab6d6'],0,1,1,21428175,1,,,,12882
220153de4a295cf71319e55a286ef8746135d024,0,eroma2014,2021-10-15 11:13:00-04:00,['4afcb70a1682be89a18526b1b27ee25bee026346'],6,6,12,21428187,1,,,,12882
13cacfeeafe4dcb824976e741b7b9530e51009fb,0,eroma2014,2021-10-15 13:12:25-04:00,['220153de4a295cf71319e55a286ef8746135d024'],2,2,4,21428191,1,,,,12882
bd256279db788bd482d4927c9b2a7b9031c1c7c8,0,eroma2014,2021-10-21 13:47:11-04:00,['13cacfeeafe4dcb824976e741b7b9530e51009fb'],2,2,4,21428195,1,,,,12882
050a29f8474b769004d00db3c01825d481da4824,0,Marcus Christie,2021-10-21 16:27:52-04:00,['bd256279db788bd482d4927c9b2a7b9031c1c7c8'],2,27,29,21428224,3,,,,12882
4e9e0bba360eaae83195510a222d10201c43fd4f,0,Marcus Christie,2021-10-21 17:31:01-04:00,['050a29f8474b769004d00db3c01825d481da4824'],2,2,4,21428228,1,,,,12882
90ee40b172c91ff9e60b748353f9eeb57f4d64c7,0,Marcus Christie,2021-10-29 09:58:27-04:00,['5a932a29911f123a3e5e3529af4951809861d93e'],1,1,2,21428230,1,,,,12882
960d6ead771c4c9b46cf472ee7545b40ffaaddf2,0,Marcus Christie,2021-11-05 14:57:25-04:00,['4e9e0bba360eaae83195510a222d10201c43fd4f'],0,3,3,21428233,1,,,,12882
8afb6c8b98b73e64678d00bd7d137411a2e68655,0,Marcus Christie,2021-11-08 09:14:45-05:00,"['960d6ead771c4c9b46cf472ee7545b40ffaaddf2', 'a087a0bbefed65ad971b7a84f7dff2c14107111c']",4,4,8,21428241,1,,,,12882
b2a67b4a12827d872b74c32defbb2b869bf94feb,0,eroma2014,2021-11-09 15:13:13-05:00,['8afb6c8b98b73e64678d00bd7d137411a2e68655'],0,53,53,21428294,1,,,,12883
f80abdf5d5831713121a79943b9be81819737e0d,1,eroma2014,2021-11-09 16:11:46-05:00,['b2a67b4a12827d872b74c32defbb2b869bf94feb'],0,16,16,21428310,2,,,,12884
db893d4ccfffc04348b0b7fcef17bc851934188b,0,eroma2014,2021-11-09 16:47:54-05:00,['f80abdf5d5831713121a79943b9be81819737e0d'],4,4,8,21428318,1,,,,12884
f931c943e157879d0932008400d6f54e8643efea,0,Marcus Christie,2021-11-30 17:23:04-05:00,['db893d4ccfffc04348b0b7fcef17bc851934188b'],3,4,7,21428325,1,,,,12884
14f2b71bec0615f2eda610ffcc52a90e70a1733f,0,Marcus Christie,2021-11-30 17:23:20-05:00,"['90ee40b172c91ff9e60b748353f9eeb57f4d64c7', 'f931c943e157879d0932008400d6f54e8643efea']",11,188,199,21428524,12,,,,12884
38f744b8017c2e3d023d883ec0522faba53c5950,0,eroma2014,2021-12-02 12:56:44-05:00,['14f2b71bec0615f2eda610ffcc52a90e70a1733f'],0,54,54,21428578,1,,,,12885
705151da871e90668ecc1a1efa75fe97e72b3540,0,Marcus Christie,2021-12-02 18:44:01-05:00,['f931c943e157879d0932008400d6f54e8643efea'],0,1,1,21428579,1,,,,12885
8fbfbd85d88cf4886ce62b6bea7d923953fedc4f,0,eroma2014,2021-12-02 23:05:04-05:00,['38f744b8017c2e3d023d883ec0522faba53c5950'],0,15,15,21428594,1,,,,12886
5f88a162ec1980abaa74061618608e13977af387,0,eroma2014,2021-12-02 23:05:52-05:00,['8fbfbd85d88cf4886ce62b6bea7d923953fedc4f'],0,1,1,21428595,1,,,,12886
d1512cf5371a14cb8d4018de25f9117a3d1724e6,0,Marcus Christie,2021-12-03 08:53:52-05:00,"['5f88a162ec1980abaa74061618608e13977af387', '705151da871e90668ecc1a1efa75fe97e72b3540']",0,1,1,21428596,1,,,,12886
23fb256b6d2a794c10a3ec4134109dda79dbfcf0,0,eroma2014,2021-12-03 09:38:23-05:00,['5f88a162ec1980abaa74061618608e13977af387'],3,3,6,21428602,1,,,,12886
0a573a0ff94eea0f26ccac6c653ad2925b4e52ad,0,eroma2014,2021-12-03 09:38:52-05:00,"['23fb256b6d2a794c10a3ec4134109dda79dbfcf0', 'd1512cf5371a14cb8d4018de25f9117a3d1724e6']",0,1,1,21428603,1,,,,12886
521b75ab6eaf1e224a9a71b893bcf61533176dba,0,Marcus Christie,2021-12-10 16:49:06-05:00,['f8ed00e398c34a95fa8b81301881b62eec54afcc'],0,10,10,21428613,5,,,,12886
d787ff3b9c550ad6c4ed5c6cad02433346f480da,0,Marcus Christie,2021-12-14 12:23:25-05:00,['0a573a0ff94eea0f26ccac6c653ad2925b4e52ad'],70,0,70,21428683,3,,,,12886
8682af773e58e7be29bf556e8e289ed5394a884c,0,Marcus Christie,2021-12-15 15:37:53-05:00,['705151da871e90668ecc1a1efa75fe97e72b3540'],3355,5629,8984,21437667,6,0.428995841,0.461081402,0.960784314,12887
cef65af8277a8ab3a9087a4083f16f2d977ac639,0,Dimuthu Wannipurage,2021-12-15 16:14:22-05:00,['8682af773e58e7be29bf556e8e289ed5394a884c'],6,29,35,21437702,3,0,0,0,12887
5ef1a8a730e0e0f5fcc78be4ade0eff400152b8c,0,Marcus Christie,2021-12-15 16:54:03-05:00,['cef65af8277a8ab3a9087a4083f16f2d977ac639'],2,175,177,21437879,3,0.353333333,0.48,0.473333333,12887
7de8965407776695f341536803af17636220c7c4,0,Marcus Christie,2021-12-15 18:04:12-05:00,['705151da871e90668ecc1a1efa75fe97e72b3540'],1,1,2,21437881,1,,,,12887
252f47fe5220712c00034fc1a73c5e82b477878e,0,Marcus Christie,2021-12-15 18:04:25-05:00,"['d787ff3b9c550ad6c4ed5c6cad02433346f480da', '7de8965407776695f341536803af17636220c7c4']",1,1,2,21437883,1,,,,12887
299d66334ba87fb4b9c366a685f96e8eb254538c,1,Dimuthu Wannipurage,2021-12-16 20:56:39-05:00,['705151da871e90668ecc1a1efa75fe97e72b3540'],2476,1296,3772,21441655,113,0.414519906,0.128805621,0.114754098,12909
8ec6073c27c721beb0d253e77ea74397f728ff12,0,Dimuthu Wannipurage,2021-12-16 20:57:43-05:00,"['252f47fe5220712c00034fc1a73c5e82b477878e', '299d66334ba87fb4b9c366a685f96e8eb254538c']",2476,1296,3772,21445427,113,,,,12909
9860070afa84623db074726fe9cbbd0e33260fc9,0,Dimuthu Wannipurage,2021-12-17 00:26:57-05:00,['299d66334ba87fb4b9c366a685f96e8eb254538c'],1,7,8,21445435,2,0,1,1,12909
ac24d9c7852706d430fab0db11df8368bd058bdb,0,Dimuthu Wannipurage,2021-12-17 00:27:43-05:00,"['8ec6073c27c721beb0d253e77ea74397f728ff12', '9860070afa84623db074726fe9cbbd0e33260fc9']",1,7,8,21445443,2,,,,12909
a656a3f318a7ed124b55569711b739f4309e19ec,0,GitHub,2021-12-17 15:19:32-05:00,"['705151da871e90668ecc1a1efa75fe97e72b3540', '9860070afa84623db074726fe9cbbd0e33260fc9']",2475,1301,3776,21449219,113,,,,12909
634b157df917241bd02f9917fb20b725f7ae2e1e,0,Dimuthu Wannipurage,2021-12-30 14:35:16-05:00,"['ac24d9c7852706d430fab0db11df8368bd058bdb', '5ef1a8a730e0e0f5fcc78be4ade0eff400152b8c']",3361,5831,9192,21458411,11,,,,12909
4c1cfb35b5a59bb07c34d48ab304dc91894ee370,0,Dimuthu Wannipurage,2021-12-30 21:54:59-05:00,['634b157df917241bd02f9917fb20b725f7ae2e1e'],2,11,13,21458424,2,0,1,0,12909
88cb8a965bd8a311d01c9d3ca2364a13f85f7450,0,Dimuthu Wannipurage,2021-12-31 01:53:42-05:00,['5ef1a8a730e0e0f5fcc78be4ade0eff400152b8c'],8,25,33,21458457,1,0,1,0,12909
9768729b6a45a9fbd65a3af563ad3e9a611a6496,0,Dimuthu Wannipurage,2021-12-31 01:54:58-05:00,"['4c1cfb35b5a59bb07c34d48ab304dc91894ee370', '88cb8a965bd8a311d01c9d3ca2364a13f85f7450']",9,21,30,21458487,1,,,,12909
41b67acb2ae05bf29d5d625caa515d2efb153674,0,Dimuthu Wannipurage,2022-01-01 18:49:11-05:00,['88cb8a965bd8a311d01c9d3ca2364a13f85f7450'],177,195,372,21458859,5,1,1,1,12909
97a939e47f79eab00375cfa25774a57b7ff4ba51,0,Dimuthu Wannipurage,2022-01-01 18:52:49-05:00,"['9768729b6a45a9fbd65a3af563ad3e9a611a6496', '41b67acb2ae05bf29d5d625caa515d2efb153674']",177,194,371,21459230,5,,,,12909
75393b3b7c60dd1e8658ba6301313ab0518a27a7,0,Dimuthu Wannipurage,2022-01-02 19:01:04-05:00,['41b67acb2ae05bf29d5d625caa515d2efb153674'],40,268,308,21459538,9,0,0,0.6,12909
bc26c4d1a6effba55d60e45e43974167eadaf92d,0,Dimuthu Wannipurage,2022-01-02 19:03:20-05:00,"['97a939e47f79eab00375cfa25774a57b7ff4ba51', '75393b3b7c60dd1e8658ba6301313ab0518a27a7']",40,268,308,21459846,9,,,,12909
feb31ac2fb650feef321d92a9a48c4f142c154f1,0,Dimuthu Wannipurage,2022-01-02 21:02:07-05:00,['75393b3b7c60dd1e8658ba6301313ab0518a27a7'],47,94,141,21459987,5,0.411764706,0.470588235,1,12909
098690cfad51511320899c667b0b126611af043c,0,Dimuthu Wannipurage,2022-01-02 21:02:47-05:00,"['bc26c4d1a6effba55d60e45e43974167eadaf92d', 'feb31ac2fb650feef321d92a9a48c4f142c154f1']",47,94,141,21460128,5,,,,12909
e66474b0ffc826c4336bc20c29590fcf82e4302f,0,Dimuthu Wannipurage,2022-01-02 22:53:12-05:00,['feb31ac2fb650feef321d92a9a48c4f142c154f1'],0,6,6,21460134,2,,,,12909
4a1cf0d71a48cec605b251a7b6b4bb239300af1d,0,Marcus Christie,2022-01-04 16:03:32-05:00,['e66474b0ffc826c4336bc20c29590fcf82e4302f'],225,15,240,21460374,4,1,1,0.034883721,12909
d469bf2257d179a8393f7ba6ca9060aa5d5b3fd3,0,Marcus Christie,2022-01-04 16:08:15-05:00,['4a1cf0d71a48cec605b251a7b6b4bb239300af1d'],24,31,55,21460429,3,0,0,0,12909
ea8e538435ab8973b81cd9b22813b15e515b26b1,0,Dimuthu Wannipurage,2022-01-04 18:49:03-05:00,['a656a3f318a7ed124b55569711b739f4309e19ec'],0,1,1,21460430,1,0,0,1,12909
acce953c5500fb6759e443cdf1bf33b2d88250dd,0,Dimuthu Wannipurage,2022-01-04 19:46:23-05:00,['ea8e538435ab8973b81cd9b22813b15e515b26b1'],7,13,20,21460450,1,0,0,1,12909
e4e97e37b89f66d0fffdc27769fc91516f895e96,0,Dimuthu Wannipurage,2022-01-04 20:19:44-05:00,"['098690cfad51511320899c667b0b126611af043c', 'd469bf2257d179a8393f7ba6ca9060aa5d5b3fd3']",245,48,293,21460743,7,,,,12909
936c21ed26b61c30c6d09cdb8060beda76994c5b,0,Dimuthu Wannipurage,2022-01-05 02:16:10-05:00,['acce953c5500fb6759e443cdf1bf33b2d88250dd'],1,4,5,21460748,1,0,0,1,12909
44ad2071fd3d7ed798d5ebb799a239185a11bf22,0,Dimuthu Wannipurage,2022-01-05 11:45:50-05:00,['936c21ed26b61c30c6d09cdb8060beda76994c5b'],4,26,30,21460778,1,,,,12909
e351f81d51ad5062411ce615319c5232b34a702d,0,Dimuthu Wannipurage,2022-01-05 11:45:50-05:00,['44ad2071fd3d7ed798d5ebb799a239185a11bf22'],4,4,8,21460786,1,,,,12909
0271293fcce5b1ee581b262181373a9a57a0554e,0,eroma2014,2022-01-05 15:57:17-05:00,['e351f81d51ad5062411ce615319c5232b34a702d'],1,1,2,21460788,1,,,,12909
f8cf01dd0e53b3a34bc774fcd34dc47f2dc216d0,0,Marcus Christie,2022-01-07 12:24:24-05:00,['d469bf2257d179a8393f7ba6ca9060aa5d5b3fd3'],4,80,84,21460872,1,0,0,0,12909
c33e0416d45f0f9f8fd8cd2b09bc8290c2298770,0,Marcus Christie,2022-01-07 12:25:18-05:00,['f8cf01dd0e53b3a34bc774fcd34dc47f2dc216d0'],40,53,93,21460965,1,0,0,0,12909
1dea824a07c4e6a1af6accb45542d6fbf977297f,0,Marcus Christie,2022-01-07 17:27:51-05:00,['c33e0416d45f0f9f8fd8cd2b09bc8290c2298770'],2810,4639,7449,21468414,3,0.346982759,0.38433908,0.927442529,12909
7a191a7f84969a96ac83ef7d4e765795a6b96c37,0,Marcus Christie,2022-01-13 09:48:45-05:00,"['e4e97e37b89f66d0fffdc27769fc91516f895e96', '1dea824a07c4e6a1af6accb45542d6fbf977297f']",2837,4751,7588,21476002,4,,,,12909
a37ae49ef4959c731dd220830711bd790c7e1635,0,Dimuthu Wannipurage,2022-01-13 20:45:20-05:00,['e4e97e37b89f66d0fffdc27769fc91516f895e96'],8,539,547,21476549,14,0.536585366,0.62195122,0.780487805,12913
77fe9095a311120c793e26d57996178a789dacc3,0,Dimuthu Wannipurage,2022-01-13 22:49:04-05:00,['da70969e7a5abffab0e2bd9420a5da265cb231bb'],29,43,72,21476621,1,0,0,0.166666667,12913
4b26599fb71c28217f95c554fe058cb01c7db54d,0,Dimuthu Wannipurage,2022-01-13 23:06:29-05:00,['77fe9095a311120c793e26d57996178a789dacc3'],7,5,12,21476633,1,1,1,1,12913
139d5e4ea84e24bfeddf388ac628e72b27aa4771,0,Dimuthu Wannipurage,2022-01-14 13:53:53-05:00,['1dea824a07c4e6a1af6accb45542d6fbf977297f'],2,36,38,21476671,1,0,0,1,12913
181a8c342d9c7ff4786e4033062a4e54c6c58b77,0,Dimuthu Wannipurage,2022-01-14 13:56:29-05:00,"['e4e97e37b89f66d0fffdc27769fc91516f895e96', '139d5e4ea84e24bfeddf388ac628e72b27aa4771']",2839,4787,7626,21484297,5,,,,12913
3ed6a1263befbc90b0ab8918c69eaa4825d71b50,0,Dimuthu Wannipurage,2022-01-14 13:59:07-05:00,"['181a8c342d9c7ff4786e4033062a4e54c6c58b77', '7a191a7f84969a96ac83ef7d4e765795a6b96c37']",0,0,0,21484297,0,,,,12913
887e1fce400230594acc31c052a43fec48d9b414,0,Dimuthu Wannipurage,2022-01-16 16:29:51-05:00,['3ed6a1263befbc90b0ab8918c69eaa4825d71b50'],8,539,547,21484844,14,0.536585366,0.62195122,0.780487805,12917
de3fa662e4cf18617388d2791a276aa2d796efb8,0,Marcus Christie,2022-01-18 08:55:21-05:00,"['0271293fcce5b1ee581b262181373a9a57a0554e', '521b75ab6eaf1e224a9a71b893bcf61533176dba']",0,25,25,21484869,12,,,,12917
027694a364a7e72761bc1c6f5f98f6329871cb1f,0,Marcus Christie,2022-01-18 09:05:07-05:00,"['de3fa662e4cf18617388d2791a276aa2d796efb8', '7de8965407776695f341536803af17636220c7c4']",1,1,2,21484871,1,,,,12917
7d9f8443fe84317b48c765ce359dce872e819a60,0,Marcus Christie,2022-01-26 14:48:12-05:00,['139d5e4ea84e24bfeddf388ac628e72b27aa4771'],2,3,5,21484876,1,,,,12917
b393b53850eedd3cc196d32c7718175ffd7fcbc0,0,Marcus Christie,2022-01-26 14:48:41-05:00,"['887e1fce400230594acc31c052a43fec48d9b414', '7d9f8443fe84317b48c765ce359dce872e819a60']",2,3,5,21484881,1,,,,12917
07950cc01a17772d57f4ddd2f95ef56c75b9fa2b,0,Marcus Christie,2022-01-26 16:29:36-05:00,['027694a364a7e72761bc1c6f5f98f6329871cb1f'],0,1,1,21484882,1,,,,12917
dd4a90293f584e25e30467931b770ebc6af04668,0,Marcus Christie,2022-01-26 16:29:44-05:00,"['b393b53850eedd3cc196d32c7718175ffd7fcbc0', '07950cc01a17772d57f4ddd2f95ef56c75b9fa2b']",13,56,69,21484951,9,,,,12917
48c75e914702a8fffbc02b7317c4dc110fe68283,0,Dimuthu Wannipurage,2022-02-03 12:55:28-05:00,"['07950cc01a17772d57f4ddd2f95ef56c75b9fa2b', '4b26599fb71c28217f95c554fe058cb01c7db54d']",30,42,72,21485023,1,,,,12917
0f346c59209b8edf862d13c3313d9d701f661a36,0,Marcus Christie,2022-02-04 14:58:33-05:00,['dd4a90293f584e25e30467931b770ebc6af04668'],1,1,2,21485025,1,,,,12917
dc032bd5ba08fe72546376045ea8478305edb3a2,0,Marcus Christie,2022-02-10 10:00:43-05:00,['7d9f8443fe84317b48c765ce359dce872e819a60'],2,9,11,21485036,1,0,0,1,12917
04a480c6a189a4fee88049bc4da6759bb4c58dfb,0,Marcus Christie,2022-02-10 11:13:34-05:00,['dc032bd5ba08fe72546376045ea8478305edb3a2'],5,58,63,21485099,3,0.083333333,0.520833333,0.875,12917
5139eb26b1f6e82abc6554c7c47a8c18cdbbbbad,0,Marcus Christie,2022-02-10 11:59:32-05:00,"['0f346c59209b8edf862d13c3313d9d701f661a36', '04a480c6a189a4fee88049bc4da6759bb4c58dfb']",7,67,74,21485173,4,,,,12917
d716ad992aa88b26117633e7b9569fd63336dc1b,0,Marcus Christie,2022-02-10 13:57:12-05:00,['04a480c6a189a4fee88049bc4da6759bb4c58dfb'],50,3,53,21485226,1,1,1,0.5,12917
d406823f2bdc35bea6ce7919eae1b2f0496c39e3,0,Marcus Christie,2022-02-16 09:29:32-05:00,['d716ad992aa88b26117633e7b9569fd63336dc1b'],2,2,4,21485230,1,,,,12917
10156e600db671cf3b611af147ac124b7b4feb6b,0,Marcus Christie,2022-02-16 17:33:15-05:00,['d406823f2bdc35bea6ce7919eae1b2f0496c39e3'],4,12,16,21485246,1,0,0,0,12917
f2a94f513a46838542d0119bcc8283705a9e0b46,0,Marcus Christie,2022-02-16 17:45:18-05:00,"['5139eb26b1f6e82abc6554c7c47a8c18cdbbbbad', '10156e600db671cf3b611af147ac124b7b4feb6b']",56,17,73,21485319,1,,,,12917
8dd08145ca7d1dec100691f3bda6e04054bfcb23,0,Marcus Christie,2022-02-16 19:21:53-05:00,['f2a94f513a46838542d0119bcc8283705a9e0b46'],543,1453,1996,21487315,6,0.226209048,0.229329173,0.801872075,12917
720d072c709809ac8ae4927f932e50456df9e0a4,0,GitHub,2022-02-21 12:32:25-05:00,['48c75e914702a8fffbc02b7317c4dc110fe68283'],0,1,1,21487316,1,,,,12917
0afc1b70ebaf847feae9c178d8cea89f51a781fa,0,Marcus Christie,2022-02-28 17:22:00-05:00,['720d072c709809ac8ae4927f932e50456df9e0a4'],1,6,7,21487323,1,,,,12917
ad70ca781d8b8e9fe160b179e51f57b80f1a4d8f,0,Marcus Christie,2022-02-28 17:22:36-05:00,"['8dd08145ca7d1dec100691f3bda6e04054bfcb23', '0afc1b70ebaf847feae9c178d8cea89f51a781fa']",31,49,80,21487403,3,,,,12917
b3d51aa1f992407cbbb1b6b8167e42e9090bfbac,0,Marcus Christie,2022-03-03 15:32:17-05:00,['0afc1b70ebaf847feae9c178d8cea89f51a781fa'],2,2,4,21487407,1,,,,12917
52bff1d9906e4108c85ef8dbe686fb52c1ee9187,0,Marcus Christie,2022-03-07 17:38:51-05:00,['b3d51aa1f992407cbbb1b6b8167e42e9090bfbac'],0,4,4,21487411,1,,,,12917
f9fd8bef91c63b486709555658fefbdc10277fb7,0,GitHub,2022-03-11 14:56:07-05:00,['52bff1d9906e4108c85ef8dbe686fb52c1ee9187'],0,1,1,21487412,1,,,,12917
e278f82d4181bca403a0aa47d35eece34b1bc5cb,0,Marcus Christie,2022-03-11 18:02:51-05:00,['f9fd8bef91c63b486709555658fefbdc10277fb7'],2,22,24,21487436,2,,,,12917
75ba6c2c2dd4993a7a57cabede0ed42f25220011,0,Marcus Christie,2022-03-11 18:03:03-05:00,"['ad70ca781d8b8e9fe160b179e51f57b80f1a4d8f', 'e278f82d4181bca403a0aa47d35eece34b1bc5cb']",4,29,33,21487469,5,,,,12917
b89f62b017203aa7057a1b57ea1ad3d03002449c,0,GitHub,2022-03-21 09:35:43-04:00,"['e278f82d4181bca403a0aa47d35eece34b1bc5cb', '10156e600db671cf3b611af147ac124b7b4feb6b']",3523,8080,11603,21499072,20,,,,12917
34d6536eef303a9c0666fed7cb1e5d58a7c3ef49,0,Marcus Christie,2022-03-21 09:42:26-04:00,['b89f62b017203aa7057a1b57ea1ad3d03002449c'],6,6,12,21499084,5,,,,12917
1f230a374066f1ebcff4a155decabb514059210e,0,Marcus Christie,2022-03-21 09:48:00-04:00,"['75ba6c2c2dd4993a7a57cabede0ed42f25220011', '34d6536eef303a9c0666fed7cb1e5d58a7c3ef49']",6,6,12,21499096,5,,,,12917
32e128ed62720d01e40862732d79de10b6e86373,0,Dimuthu Wannipurage,2022-04-04 09:41:20-04:00,['34d6536eef303a9c0666fed7cb1e5d58a7c3ef49'],4,4,8,21499104,2,,,,12917
bb732dfaf8d66fbf85ff7585982b60d0120c6252,0,Dimuthu Wannipurage,2022-04-04 09:46:19-04:00,"['32e128ed62720d01e40862732d79de10b6e86373', 'a37ae49ef4959c731dd220830711bd790c7e1635']",593,3030,3623,21502727,606,,,,12917
4eaa9af99ca99b402e5b4dea8d06da8c01082877,0,Dimuthu Wannipurage,2022-04-04 09:53:45-04:00,['bb732dfaf8d66fbf85ff7585982b60d0120c6252'],6,6,12,21502739,2,,,,12917
d3e29bcf035dfcb41ed27285be654e1a57cdbb64,0,GitHub,2022-04-04 13:23:00-04:00,['4eaa9af99ca99b402e5b4dea8d06da8c01082877'],0,5,5,21502744,1,,,,12917
08a15d11238a8a0444f12d7247eba54732f259a9,0,Suresh Marru,2022-04-05 08:55:10-04:00,['d3e29bcf035dfcb41ed27285be654e1a57cdbb64'],2,3,5,21502749,3,,,,12917
97a205cbc295600148eff29496eaa0fde167a671,0,Suresh Marru,2022-04-05 08:55:10-04:00,['08a15d11238a8a0444f12d7247eba54732f259a9'],7,8,15,21502764,2,,,,12917
f412aeb290dda5be31e950dd3a0d8561280dd357,0,Suresh Marru,2022-04-05 08:56:29-04:00,['97a205cbc295600148eff29496eaa0fde167a671'],2,2,4,21502768,1,,,,12917
e12c2497d55fbb5be6705336f240141dccfdb220,0,Suresh Marru,2022-04-05 10:03:46-04:00,['f412aeb290dda5be31e950dd3a0d8561280dd357'],13,0,13,21502781,2,,,,12917
4d9fd40c240ba6a2d4d62d8a566a83660b8efe48,0,Marcus Christie,2022-04-06 17:04:54-04:00,['e12c2497d55fbb5be6705336f240141dccfdb220'],0,1,1,21502782,1,,,,12917
c827dda0025725db387f75a2d1f4c4e9c523f32a,0,Marcus Christie,2022-04-06 17:36:07-04:00,['4d9fd40c240ba6a2d4d62d8a566a83660b8efe48'],2,6,8,21502790,1,,,,12917
268eefae5224c79447da00b81d605feb1cb9b7dc,0,Marcus Christie,2022-04-13 14:31:51-04:00,['c827dda0025725db387f75a2d1f4c4e9c523f32a'],1,1,2,21502792,1,,,,12917
d3b6d1d17ea596b87100ecb766b56c95d01b75f9,0,Marcus Christie,2022-04-15 13:15:04-04:00,['1f230a374066f1ebcff4a155decabb514059210e'],0,4,4,21502796,1,,,,12917
d5b4b5106ff1cae3bde59efcbd8f952f54d475fe,0,Marcus Christie,2022-04-15 13:44:36-04:00,['268eefae5224c79447da00b81d605feb1cb9b7dc'],0,3,3,21502799,1,,,,12917
0f873efd2e790a97fcda94c71020cbc0fe1bb824,0,eroma2014,2022-04-25 15:14:11-04:00,['d5b4b5106ff1cae3bde59efcbd8f952f54d475fe'],1,1,2,21502801,1,,,,12917
d3850be30f58c82fddd08c28a13a0a78c4e4153f,0,Marcus Christie,2022-05-11 17:32:50-04:00,['0f873efd2e790a97fcda94c71020cbc0fe1bb824'],1,2,3,21502804,1,,,,12917
480e0e3e8e148c9d16aa9a668366766e34bd5bd8,0,Marcus Christie,2022-05-11 17:33:57-04:00,['d3b6d1d17ea596b87100ecb766b56c95d01b75f9'],1,2,3,21502807,1,,,,12917
b308844e03eac612f50c567e38d80aebf6ad98a9,0,Isuru Ranawaka,2022-05-12 10:00:47-04:00,['57b03734441c2f0ff62f123187e045a43d337686'],69,97,166,21502973,4,,,,12917
f6cb3fc1a948887aa696ce204df97c9387665457,0,Isuru Ranawaka,2022-05-12 10:02:34-04:00,"['b308844e03eac612f50c567e38d80aebf6ad98a9', '480e0e3e8e148c9d16aa9a668366766e34bd5bd8']",133799,29157,162956,21665929,1113,,,,12917
3ffe25098b9c9dee402133b8fccb6cde6bb5ca9f,0,GitHub,2022-05-12 11:30:57-04:00,"['480e0e3e8e148c9d16aa9a668366766e34bd5bd8', 'f6cb3fc1a948887aa696ce204df97c9387665457']",69,97,166,21666095,4,,,,12917
145a4c8437058cafc63e8a4915aeebfb237aa6f1,0,eroma2014,2022-05-12 15:42:39-04:00,['d3850be30f58c82fddd08c28a13a0a78c4e4153f'],0,2,2,21666097,1,,,,12917
13a8bcd3240f70f4844ad04a5c98c9a69d4818c7,0,Feng Li,2022-05-23 11:16:27-04:00,"['3ffe25098b9c9dee402133b8fccb6cde6bb5ca9f', 'aa30d23606e4ccba9f86c4bf056b254fd38ac0bc']",1,1,2,21666099,1,,,,12917
586da2006fa733755f031b00c51e5edff9263619,0,Feng Li,2022-05-23 14:26:50-04:00,['13a8bcd3240f70f4844ad04a5c98c9a69d4818c7'],4,5,9,21666108,2,,,,12917
fe009e7112a6328e3523e51a20e59a59719eeaab,0,Marcus Christie,2022-05-23 16:06:31-04:00,['145a4c8437058cafc63e8a4915aeebfb237aa6f1'],0,17,17,21666125,2,,,,12917
4d130b3374e42d0a0ba380232acadb38a37771c4,0,Marcus Christie,2022-05-23 16:08:25-04:00,"['3ffe25098b9c9dee402133b8fccb6cde6bb5ca9f', 'fe009e7112a6328e3523e51a20e59a59719eeaab']",38,60,98,21666223,16,,,,12917
7f5fc29bf6517ba90a725afd40f36f00a950d9b7,0,eroma2014,2022-05-26 12:48:56-04:00,['4d130b3374e42d0a0ba380232acadb38a37771c4'],1,4,5,21666228,1,,,,12917
020902ae031e69bbfbd1d7b476893c7b710ea662,0,Marcus Christie,2022-05-26 16:16:27-04:00,['145a4c8437058cafc63e8a4915aeebfb237aa6f1'],0,4,4,21666232,1,,,,12917
757c1a961f25d7ffa79fa235c311c0d82da8bb99,0,Marcus Christie,2022-06-06 09:50:15-04:00,"['020902ae031e69bbfbd1d7b476893c7b710ea662', 'fe009e7112a6328e3523e51a20e59a59719eeaab']",0,17,17,21666249,2,,,,12917
db817edbb59e8fb7d0d1d0aea0a00e327cff9bc7,0,Dimuthu Wannipurage,2022-06-09 14:33:41-04:00,['7f5fc29bf6517ba90a725afd40f36f00a950d9b7'],0,4,4,21666253,1,,,,12917
8ed824376df086991c6d2291c53e9c93ba12d279,0,Dimuthu Wannipurage,2022-06-09 14:33:41-04:00,['db817edbb59e8fb7d0d1d0aea0a00e327cff9bc7'],0,9,9,21666262,4,,,,12917
977d86cd95b20256f7798a9807fe4912fd7a63eb,0,Marcus Christie,2022-06-13 15:00:45-04:00,['757c1a961f25d7ffa79fa235c311c0d82da8bb99'],1,2,3,21666265,1,,,,12917
0af936c9d3b636333b3470f8779473d62280dd1f,0,Marcus Christie,2022-06-13 15:00:54-04:00,"['8ed824376df086991c6d2291c53e9c93ba12d279', '977d86cd95b20256f7798a9807fe4912fd7a63eb']",1,2,3,21666268,1,,,,12917
cf6d8b24c1980403fb74a9dacb5ba80aed91000d,0,Marcus Christie,2022-06-16 17:37:33-04:00,['977d86cd95b20256f7798a9807fe4912fd7a63eb'],0,5,5,21666273,1,,,,12917
9f8c2f9652210155c2417d2420b30aca9da78d57,0,Marcus Christie,2022-06-17 10:03:22-04:00,['cf6d8b24c1980403fb74a9dacb5ba80aed91000d'],0,3,3,21666276,1,,,,12917
fbdbff47ba91067d3dda711f78972252246b1c36,0,Dimuthu Wannipurage,2022-06-17 14:05:57-04:00,['9f8c2f9652210155c2417d2420b30aca9da78d57'],5,23,28,21666304,2,0.642857143,0.785714286,0.857142857,12917
8df7f78a4af07f63cabbe7662fc5d919d6a702cf,0,Dimuthu Wannipurage,2022-06-17 14:07:58-04:00,['fbdbff47ba91067d3dda711f78972252246b1c36'],23,5,28,21666332,2,0.357142857,0.214285714,0.142857143,12917
1a005071079e76063f02b4686ae2d7b7ead06c13,0,Dimuthu Wannipurage,2022-06-17 14:09:31-04:00,['0af936c9d3b636333b3470f8779473d62280dd1f'],5,23,28,21666360,2,0.642857143,0.785714286,0.857142857,12917
8616c5a7439ddccbe6079c58ae590548e17a33a0,0,Dimuthu Wannipurage,2022-06-26 12:19:32-04:00,['1a005071079e76063f02b4686ae2d7b7ead06c13'],3,3,6,21666366,1,,,,12917
5fe936fdb51e2516819a2f1b8f9fdae6b794e0f2,0,Dimuthu Wannipurage,2022-06-26 12:19:32-04:00,['8616c5a7439ddccbe6079c58ae590548e17a33a0'],1,1,2,21666368,1,,,,12917
bbcf79945bd61e868ff02824d48dea222e9f8eea,0,Marcus Christie,2022-06-27 18:12:51-04:00,['8df7f78a4af07f63cabbe7662fc5d919d6a702cf'],774,610,1384,21667752,56,,,,12917
752ea1f9ee8dbfb3d33c5c0e13b3fdcbfad3996d,0,Dimuthu Wannipurage,2022-06-28 12:57:00-04:00,['5fe936fdb51e2516819a2f1b8f9fdae6b794e0f2'],0,1932,1932,21669684,43,,,,12960
dc54dd8925e72770bf1181c4645c71face684a16,0,eroma2014,2022-06-29 14:50:12-04:00,['bbcf79945bd61e868ff02824d48dea222e9f8eea'],2,2,4,21669688,1,,,,12960
f8b1bed6ace0054e2d925662c3d1254a6b16c96c,0,eroma2014,2022-06-29 15:00:16-04:00,['dc54dd8925e72770bf1181c4645c71face684a16'],1,1,2,21669690,1,,,,12960
bd039503216f36ffa448d8ce891c8f58218468c2,0,Marcus Christie,2022-06-30 16:33:58-04:00,['f8b1bed6ace0054e2d925662c3d1254a6b16c96c'],11,18,29,21669719,8,,,,12960
da6231272a182936715002b78dee8f069f789f54,0,Marcus Christie,2022-06-30 16:49:41-04:00,['752ea1f9ee8dbfb3d33c5c0e13b3fdcbfad3996d'],7,11,18,21669737,4,,,,12960
5b85985f854d3c057b9d557fd99df2ff162a1535,0,Marcus Christie,2022-06-30 17:00:19-04:00,['f8b1bed6ace0054e2d925662c3d1254a6b16c96c'],0,10,10,21669747,1,,,,12961
c8e51dcd0cd230cff2539e96b4c905224187e854,0,Marcus Christie,2022-06-30 17:31:36-04:00,['752ea1f9ee8dbfb3d33c5c0e13b3fdcbfad3996d'],2,1,3,21669750,1,,,,12961
8eb16bd1561582f36d592ffd1e9c7500efb6bef6,0,eroma2014,2022-07-06 07:13:49-04:00,['5b85985f854d3c057b9d557fd99df2ff162a1535'],0,53,53,21669803,1,,,,12962
1027c561abe8a5bfb913bdd84bd7fe0bbb7ef512,0,eroma2014,2022-07-06 07:30:48-04:00,['8eb16bd1561582f36d592ffd1e9c7500efb6bef6'],0,12,12,21669815,1,,,,12963
9397c4a8c691b4d2a428b3ce8b9edcf2dd1ee174,0,eroma2014,2022-07-06 07:31:28-04:00,['1027c561abe8a5bfb913bdd84bd7fe0bbb7ef512'],0,1,1,21669816,1,,,,12963
bc6de335fc963906dbf5eabd2ab0e967d51d1e94,0,eroma2014,2022-07-06 09:39:13-04:00,['9397c4a8c691b4d2a428b3ce8b9edcf2dd1ee174'],0,66,66,21669882,3,,,,12965
3abd4cd67f9d3abfd988e12059f346b5e1f17f97,0,eroma2014,2022-07-06 10:00:03-04:00,['bc6de335fc963906dbf5eabd2ab0e967d51d1e94'],1,1,2,21669884,1,,,,12965
147d5de7d07751a2d0f5c19295c0704bcc25fd1c,0,eroma2014,2022-07-06 10:28:01-04:00,['3abd4cd67f9d3abfd988e12059f346b5e1f17f97'],5,5,10,21669894,1,,,,12965
c90bdc67371c671916d39250659792901b903428,0,Marcus Christie,2022-07-06 11:08:37-04:00,['dc54dd8925e72770bf1181c4645c71face684a16'],2,3,5,21669899,1,,,,12965
ed1e86aa16ad812f7698b77f47b20dcedb0291bd,0,Marcus Christie,2022-07-06 11:09:17-04:00,['c90bdc67371c671916d39250659792901b903428'],14,38,52,21669951,3,,,,12965
45f8dac6d16673deda5fdc1f1717f60bebda8e09,0,Marcus Christie,2022-07-06 11:34:57-04:00,['ed1e86aa16ad812f7698b77f47b20dcedb0291bd'],36,49,85,21670036,2,,,,12966
bb1366355e11903e9b18f1a4316c371b358c4af4,0,Marcus Christie,2022-07-06 11:35:31-04:00,['45f8dac6d16673deda5fdc1f1717f60bebda8e09'],2,23,25,21670061,4,,,,12966
5cddfe352d4628172bfefbec46f15b6880b0ecde,0,Marcus Christie,2022-07-06 11:44:20-04:00,['da6231272a182936715002b78dee8f069f789f54'],3,24,27,21670088,2,,,,12966
65134efef90e48c677e6c37d26bbf8560224e7d5,0,Marcus Christie,2022-07-06 11:49:29-04:00,['bb1366355e11903e9b18f1a4316c371b358c4af4'],32,292,324,21670412,10,,,,12972
7ac5d08b51655be44a6090909bf31036aa0334dd,0,Marcus Christie,2022-07-06 12:06:21-04:00,['5cddfe352d4628172bfefbec46f15b6880b0ecde'],34,27,61,21670473,6,,,,12972
562fd93dec206ec440c0f4d6b156c83980231bae,0,eroma2014,2022-07-06 15:41:11-04:00,['147d5de7d07751a2d0f5c19295c0704bcc25fd1c'],6,6,12,21670485,1,,,,12972
9b8e7522ffe653d46e78c3d2c18be08463ec008e,0,Dimuthu Wannipurage,2022-07-07 12:08:46-04:00,['c8e51dcd0cd230cff2539e96b4c905224187e854'],21,147,168,21670653,6,,,,12973
73761df3777a8b7bed609dceea68ea6141cdca9d,0,Dimuthu Wannipurage,2022-07-09 03:55:35-04:00,['9b8e7522ffe653d46e78c3d2c18be08463ec008e'],1,6,7,21670660,2,,,,12973
0a9cbeefa208d5e164e93087230ce8292864d4ed,0,Isuru Ranawaka,2022-07-25 22:10:23-04:00,['73761df3777a8b7bed609dceea68ea6141cdca9d'],2,72,74,21670734,8,,,,12973
c07353066fbc61a908e821d2024cae581371ee51,0,Isuru Ranawaka,2022-07-26 10:45:27-04:00,['0a9cbeefa208d5e164e93087230ce8292864d4ed'],4,8,12,21670746,5,,,,12973
dcba17a72dbee390b60a4c83088455594a1ccc58,0,GitHub,2022-07-27 09:20:09-04:00,"['73761df3777a8b7bed609dceea68ea6141cdca9d', 'c07353066fbc61a908e821d2024cae581371ee51']",4,78,82,21670828,8,,,,12973
834c381b1b48c25d6acdbdc0500a07a534eaa841,0,Marcus Christie,2022-07-27 09:33:52-04:00,"['dcba17a72dbee390b60a4c83088455594a1ccc58', '65134efef90e48c677e6c37d26bbf8560224e7d5']",858,1021,1879,21672707,75,,,,12973
c02b3a56749d7f0d970dbb98ea1c419271da155e,0,Marcus Christie,2022-07-27 09:34:55-04:00,"['834c381b1b48c25d6acdbdc0500a07a534eaa841', '7ac5d08b51655be44a6090909bf31036aa0334dd']",42,60,102,21672809,9,,,,12973
8ab4ae1b8606a0c80beddad10c69168f04221807,0,Marcus Christie,2022-07-27 10:58:19-04:00,['c02b3a56749d7f0d970dbb98ea1c419271da155e'],2,0,2,21672811,1,,,,12973
c0dc2e073415f5c234f1e81295f7c62325d9d3db,0,Marcus Christie,2022-07-27 10:58:47-04:00,['8ab4ae1b8606a0c80beddad10c69168f04221807'],29,29,58,21672869,2,,,,12973
58835358cea76e34c45081ead13160e19ffa9338,0,Marcus Christie,2022-07-27 10:59:05-04:00,['c0dc2e073415f5c234f1e81295f7c62325d9d3db'],0,1,1,21672870,1,,,,12973
0ca0d9925378251edbccf571e9d826c87cd8032c,0,Marcus Christie,2022-07-27 16:35:06-04:00,['58835358cea76e34c45081ead13160e19ffa9338'],322,196,518,21673388,34,,,,12974
2f8ea5cb145a524a0e32e1f6b6017e41fe5b5b94,0,Marcus Christie,2022-07-28 11:11:58-04:00,['0ca0d9925378251edbccf571e9d826c87cd8032c'],18,18,36,21673424,1,,,,12974
ba7f8874b0b6c0c49d252d3823bcbf3e7d22f98b,0,Marcus Christie,2022-07-28 11:52:28-04:00,['2f8ea5cb145a524a0e32e1f6b6017e41fe5b5b94'],4,7,11,21673435,3,,,,12974
7f2ff24064daec8e330c2feff749f798f8670006,0,Dimuthu Wannipurage,2022-07-28 12:55:03-04:00,['ba7f8874b0b6c0c49d252d3823bcbf3e7d22f98b'],1,1,2,21673437,1,,,,12974
474c32e0bc1bf7b859dabb7f66ea6975cce5894d,0,Dimuthu Wannipurage,2022-07-28 13:13:00-04:00,['7f2ff24064daec8e330c2feff749f798f8670006'],3,3,6,21673443,2,,,,12974
281cfc33b0cc25d8df0e9bde0024f6a6699b3865,0,Dimuthu Wannipurage,2022-07-28 13:15:26-04:00,['474c32e0bc1bf7b859dabb7f66ea6975cce5894d'],1,1,2,21673445,1,,,,12974
b4daebd25aa281ef973f1a12cadb87120d32f92b,0,Dimuthu Wannipurage,2022-07-28 13:34:34-04:00,['281cfc33b0cc25d8df0e9bde0024f6a6699b3865'],0,10,10,21673455,3,,,,12974
a2fc565bc2204e8eb8dc169389cd88a3f0cf6d82,0,Marcus Christie,2022-07-28 14:51:29-04:00,['b4daebd25aa281ef973f1a12cadb87120d32f92b'],36,25,61,21673516,7,,,,12974
6521fc1fb75ea2562bb42224e021df7e6ad1bb66,0,Marcus Christie,2022-07-28 17:31:10-04:00,['a2fc565bc2204e8eb8dc169389cd88a3f0cf6d82'],2,21,23,21673539,2,,,,12974
02c9f3312aa44251c122c0f07317c71aebb2999d,0,Marcus Christie,2022-07-28 17:34:48-04:00,['6521fc1fb75ea2562bb42224e021df7e6ad1bb66'],0,1,1,21673540,1,,,,12974
45882f7ebe16d36a695bf187f78f999b6da26d17,0,Marcus Christie,2022-07-28 17:48:36-04:00,['02c9f3312aa44251c122c0f07317c71aebb2999d'],2,2,4,21673544,2,,,,12974
3a8f3436cb95176f4e4b8139d78811cac6286a4d,0,Marcus Christie,2022-07-29 12:08:22-04:00,['45882f7ebe16d36a695bf187f78f999b6da26d17'],9,17,26,21673570,2,,,,12974
caff5027a9838e58558c5f3d725641371d7bfa5a,0,Marcus Christie,2022-07-29 12:21:12-04:00,['3a8f3436cb95176f4e4b8139d78811cac6286a4d'],1,1,2,21673572,1,,,,12974
2a66a2a1c803f2047261f1359b35a559e346f656,0,Marcus Christie,2022-07-29 14:10:18-04:00,"['562fd93dec206ec440c0f4d6b156c83980231bae', 'caff5027a9838e58558c5f3d725641371d7bfa5a']",722,4071,4793,21678365,95,,,,12974
31ce2c589c73429e6b366e002ebccbaa21f066d0,0,Marcus Christie,2022-07-29 14:10:36-04:00,"['2a66a2a1c803f2047261f1359b35a559e346f656', 'bd039503216f36ffa448d8ce891c8f58218468c2']",11,18,29,21678394,8,,,,12974
ad6611f4bbeb83058507203392e1c365cd7f1344,0,Marcus Christie,2022-07-29 15:20:52-04:00,['31ce2c589c73429e6b366e002ebccbaa21f066d0'],6,13,19,21678413,2,,,,12974
fc85a2f91ae85c17821de24a60f0e5e4a8944098,0,Marcus Christie,2022-07-29 15:24:42-04:00,['ad6611f4bbeb83058507203392e1c365cd7f1344'],2,17,19,21678432,1,,,,12974
eec05021bc517989d622b0f5b868b269fcdfb96b,0,Marcus Christie,2022-07-29 16:44:14-04:00,['caff5027a9838e58558c5f3d725641371d7bfa5a'],2,2,4,21678436,1,,,,12974
