sha,is_bug,committer_name,commit_time,parents,all_del,all_add,all_change_lines,all_lines,files_change_nums,dmm_unit_size,dmm_unit_complexity,dmm_unit_interfacing,file_nums
c61d22075fcf00e3265c7a954818fb2b0275baff,0,Owen O'Malley,2011-08-30 22:00:51+00:00,[],0,0,0,0,0,,,,0
e1f1b6480da6a1a230bfe7500fe4fe37d7748224,0,Owen O'Malley,2011-09-05 14:40:58+00:00,['c61d22075fcf00e3265c7a954818fb2b0275baff'],0,0,0,0,0,,,,0
89e282fb559225ff144328bf2295f94185c048e9,1,Owen O'Malley,2011-09-22 16:13:55+00:00,['e1f1b6480da6a1a230bfe7500fe4fe37d7748224'],0,16386,16386,16386,193,0.722832723,0.802808303,0.867216117,193
7c647cc4faec817ac3ca23326792ee0d0dadec71,1,Eric Yang,2011-09-22 23:01:12+00:00,['89e282fb559225ff144328bf2295f94185c048e9'],106,317,423,16809,13,0.6875,1,1,196
5bbaa8bc283c7c64f07f86c15b445958adaba8e4,0,Owen O'Malley,2011-09-22 23:19:24+00:00,['7c647cc4faec817ac3ca23326792ee0d0dadec71'],1,214,215,17024,4,,,,199
c8df5a65768b54ecb7b853757fc776fd4d1f0657,1,Suhas,2011-09-22 23:36:00+00:00,['5bbaa8bc283c7c64f07f86c15b445958adaba8e4'],24,40,64,17088,6,0.75,0.75,1,199
24b7f49cebfb6d1692761de374cf7011d9459753,1,Suhas,2011-09-23 01:21:10+00:00,['c8df5a65768b54ecb7b853757fc776fd4d1f0657'],54,37,91,17179,9,0,0,0,199
2ea901733c1a483a4cbda8f8e457a46e0fb198f4,0,Eric Yang,2011-09-23 01:54:09+00:00,['24b7f49cebfb6d1692761de374cf7011d9459753'],8,7,15,17194,4,0,0,0,199
70acdb7536ffbcecf01b85fecef18d5b813ec346,0,Owen O'Malley,2011-09-23 13:13:10+00:00,['2ea901733c1a483a4cbda8f8e457a46e0fb198f4'],95,97,192,17386,4,,,,199
5d87aa09941f5e45c38227fdea7fc5e7b5ef2b32,0,Owen O'Malley,2011-09-23 17:41:32+00:00,['70acdb7536ffbcecf01b85fecef18d5b813ec346'],1477,1852,3329,20715,105,,,,202
9683b784e507922ae4165b0e0b0e15772883a9ce,0,Owen O'Malley,2011-09-23 19:01:04+00:00,['5d87aa09941f5e45c38227fdea7fc5e7b5ef2b32'],1529,1529,3058,23773,29,,,,202
f8416d3499d9218607499f0567e3ccabe95db933,0,Owen O'Malley,2011-09-23 20:21:24+00:00,['9683b784e507922ae4165b0e0b0e15772883a9ce'],0,0,0,23773,0,,,,202
ac11baa6006b937dc3ab8a82daaa77d746dc8674,1,Devaraj Das,2011-09-23 20:47:41+00:00,['f8416d3499d9218607499f0567e3ccabe95db933'],8,99,107,23880,6,0.263157895,1,1,203
9b68d298b93329564d0f87fe96624827360771ef,0,Devaraj Das,2011-09-23 20:49:03+00:00,['ac11baa6006b937dc3ab8a82daaa77d746dc8674'],0,2,2,23882,1,,,,203
8a879e70cac55f2a067056ac69a4f5b2f5519232,1,Eric Yang,2011-09-24 02:26:57+00:00,['9b68d298b93329564d0f87fe96624827360771ef'],169,926,1095,24977,9,0.2,1,1,207
1b00f2734408b54afe504f8d9382fc233265648e,0,Eric Yang,2011-09-24 21:03:35+00:00,['8a879e70cac55f2a067056ac69a4f5b2f5519232'],0,3,3,24980,1,,,,207
ebdda675a19a3cb20a21f1d74094d4d385ee837a,1,Suhas,2011-09-26 19:13:23+00:00,['1b00f2734408b54afe504f8d9382fc233265648e'],214,258,472,25452,4,0,0,1,207
659e779f291d00b27a25cbefdcd982960e0b8d42,1,Suhas,2011-09-26 19:14:11+00:00,['ebdda675a19a3cb20a21f1d74094d4d385ee837a'],21,23,44,25496,1,1,1,1,207
398d6fc791c241bc9aee3a6dafcc5a21b165adeb,0,Eric Yang,2011-09-26 22:43:54+00:00,['659e779f291d00b27a25cbefdcd982960e0b8d42'],1,1,2,25498,1,,,,207
de6723ca1494f16ca3876d79195a98ec0f510ac5,1,Owen O'Malley,2011-09-27 01:18:53+00:00,['398d6fc791c241bc9aee3a6dafcc5a21b165adeb'],12,434,446,25944,10,,,,212
e09aa9158f24234145487467c665b3640ebda823,1,Suhas,2011-09-27 07:36:41+00:00,['de6723ca1494f16ca3876d79195a98ec0f510ac5'],644,563,1207,27151,8,0.848484848,0.333333333,1,212
99e4ac8dd99459393a9110d60711235321c609c8,0,Owen O'Malley,2011-09-27 20:06:44+00:00,['e09aa9158f24234145487467c665b3640ebda823'],18,24,42,27193,2,,,,212
e693db393fa02773c104f4a2057d840d8b0c2aa0,1,Eric Yang,2011-09-27 21:08:16+00:00,['99e4ac8dd99459393a9110d60711235321c609c8'],173,698,871,28064,17,0.648026316,0.9375,0.796052632,220
8014a99c98984d0fea5c44d0ad9b295fda7eec43,0,Eric Yang,2011-09-27 21:52:40+00:00,['e693db393fa02773c104f4a2057d840d8b0c2aa0'],8,11,19,28083,2,0,0.333333333,1,220
bdda84b7d470730e89788cf35dfa029a76b8f3d1,1,Devaraj Das,2011-09-28 00:17:19+00:00,['8014a99c98984d0fea5c44d0ad9b295fda7eec43'],41,185,226,28309,10,0.984848485,1,1,222
b60859a84c9c220209176b5ed20812e777226591,1,Suhas,2011-09-28 07:17:41+00:00,['bdda84b7d470730e89788cf35dfa029a76b8f3d1'],516,738,1254,29563,13,0.657342657,0.874125874,1,224
52cc5807c3aed381edccb10089f5bbd5f6dbeaad,0,Eric Yang,2011-09-29 00:05:25+00:00,['b60859a84c9c220209176b5ed20812e777226591'],1,17,18,29581,2,0.857142857,1,1,224
76c58aad2526871f3d62d46406a72441d7e81271,0,Eric Yang,2011-09-29 00:49:12+00:00,['52cc5807c3aed381edccb10089f5bbd5f6dbeaad'],1,6,7,29588,2,1,1,1,224
4318032dae2cb7ba00f7e3e70d15d18752b48053,1,Suhas,2011-09-29 01:18:02+00:00,['76c58aad2526871f3d62d46406a72441d7e81271'],501,300,801,30389,14,0,1,1,225
72b5ee3e828ac821ce0172db886837044acf26d4,0,Eric Yang,2011-09-29 01:32:14+00:00,['4318032dae2cb7ba00f7e3e70d15d18752b48053'],8,43,51,30440,4,0.791666667,1,0.791666667,225
993c1962ccc56b0f8f9ca0b9a676eda6ece867d7,0,Owen O'Malley,2011-09-29 02:43:58+00:00,['72b5ee3e828ac821ce0172db886837044acf26d4'],146,197,343,30783,4,,,,225
1025c4fdad0b3eba88bb53180e7324468d13e108,1,Eric Yang,2011-09-29 17:14:41+00:00,['993c1962ccc56b0f8f9ca0b9a676eda6ece867d7'],1,60,61,30844,2,0.185185185,0.888888889,0.888888889,226
6313d0c2dafcf3153e89f293e72d4e92b487ce5a,1,Devaraj Das,2011-09-29 17:29:21+00:00,['1025c4fdad0b3eba88bb53180e7324468d13e108'],43,131,174,31018,12,0.527272727,0,1,226
1e1c4900bfaba125eed1a75c3354962435ea24c2,1,Suhas,2011-09-29 19:16:23+00:00,['6313d0c2dafcf3153e89f293e72d4e92b487ce5a'],64,169,233,31251,6,0.170454545,0.875,1,226
48c62126900585f6cb31b9f3469a22859430a0c4,1,Suhas,2011-09-30 00:39:29+00:00,['1e1c4900bfaba125eed1a75c3354962435ea24c2'],72,174,246,31497,6,0.175438596,0.49122807,0.526315789,226
d049bd3b8d46ed4f5b743990e32f3b3f6619d21d,1,Suhas,2011-09-30 00:51:01+00:00,['48c62126900585f6cb31b9f3469a22859430a0c4'],5,15,20,31517,2,0.6,0.6,0,226
f2dc15e3303a9d53cf53ceccf20137852dbfac1e,1,Eric Yang,2011-09-30 01:10:43+00:00,['d049bd3b8d46ed4f5b743990e32f3b3f6619d21d'],50,140,190,31707,13,0.227272727,1,0.954545455,227
45450ba18b0c8b975b9b4486cf5f0d860ac7f82c,1,Suhas,2011-09-30 07:29:31+00:00,['f2dc15e3303a9d53cf53ceccf20137852dbfac1e'],101,68,169,31876,9,0,0,0,227
45f31785d12c2ca2a44a59a6468b0fa69e1810d1,1,Devaraj Das,2011-09-30 17:02:59+00:00,['45450ba18b0c8b975b9b4486cf5f0d860ac7f82c'],87,112,199,32075,5,1,0,1,227
1a8a12e328759b430d51e60352074c0518bddec1,0,Devaraj Das,2011-09-30 17:08:05+00:00,['45f31785d12c2ca2a44a59a6468b0fa69e1810d1'],1,1,2,32077,1,,,,227
ef1f89c47ab2bb8ae40f9d62e4e99cdc87bc8a62,1,Suhas,2011-09-30 18:49:11+00:00,['1a8a12e328759b430d51e60352074c0518bddec1'],22,150,172,32249,6,0.064935065,0.727272727,1,227
967631391d359e0a891ec6b412d4ba77a69a71e5,1,Owen O'Malley,2011-09-30 22:29:54+00:00,['ef1f89c47ab2bb8ae40f9d62e4e99cdc87bc8a62'],28,44,72,32321,6,,,,227
899e87c6fcfa8aa5b19650c1600d20589e5d53ce,0,Eric Yang,2011-10-01 01:42:25+00:00,['967631391d359e0a891ec6b412d4ba77a69a71e5'],333,432,765,33086,15,0.162790698,1,1,231
8448ab4e2003345aa95dfaeea7448ad747520a97,1,Suhas,2011-10-01 06:37:41+00:00,['899e87c6fcfa8aa5b19650c1600d20589e5d53ce'],22,189,211,33297,8,0.067226891,0.56302521,1,231
ae6058012b652ee2d62cbc203a8534f30df4a369,0,Owen O'Malley,2011-10-01 15:47:08+00:00,['8448ab4e2003345aa95dfaeea7448ad747520a97'],10,15,25,33322,4,,,,231
33afc92c75c4ae7956824bbaa080200212ca75d6,1,Suhas,2011-10-02 23:38:06+00:00,['ae6058012b652ee2d62cbc203a8534f30df4a369'],73,92,165,33487,16,0,1,1,231
b5ab88c75766bbc3d88621c1f49a41df652d3b21,1,Owen O'Malley,2011-10-03 16:12:22+00:00,['33afc92c75c4ae7956824bbaa080200212ca75d6'],25,51,76,33563,8,1,1,1,231
866c8206f28c8c7f7f1249c3833f7010b229fa5f,1,Suhas,2011-10-03 21:51:36+00:00,['b5ab88c75766bbc3d88621c1f49a41df652d3b21'],614,69,683,34246,9,0.65470852,0.219730942,0,231
ebc5c0e9e44e9fae1ffe7cabc231cedc7edc6153,1,Suhas,2011-10-03 21:56:51+00:00,['866c8206f28c8c7f7f1249c3833f7010b229fa5f'],6,8,14,34260,2,0,1,1,231
d2a0c7fa33efc0baf2c2514b525da61a57668038,1,Devaraj Das,2011-10-04 17:40:19+00:00,['ebc5c0e9e44e9fae1ffe7cabc231cedc7edc6153'],96,203,299,34559,10,1,1,0.741935484,231
26f384c9e4303589eb46bcc68c8c95410369982c,1,Devaraj Das,2011-10-04 19:04:15+00:00,['d2a0c7fa33efc0baf2c2514b525da61a57668038'],36,58,94,34653,3,1,1,1,231
d35bf129c3fa84a84282c3116de640dee3982abc,1,Devaraj Das,2011-10-04 23:06:10+00:00,['26f384c9e4303589eb46bcc68c8c95410369982c'],35,29,64,34717,4,0,0,0,231
dbcde4ac818a1be649f8bc2a23768b7e29a8a65b,1,Suhas,2011-10-05 02:08:04+00:00,['d35bf129c3fa84a84282c3116de640dee3982abc'],0,344,344,35061,3,,,,232
de6f687a2f4c73179bb6a53a31ab494def65f66a,1,Devaraj Das,2011-10-05 07:10:36+00:00,['dbcde4ac818a1be649f8bc2a23768b7e29a8a65b'],54,101,155,35216,5,0.961538462,0.961538462,1,232
98b9b505bf3c85f2652c19a2bea4d75161bf1ba8,1,Devaraj Das,2011-10-06 06:08:19+00:00,['de6f687a2f4c73179bb6a53a31ab494def65f66a'],112,129,241,35457,14,0,1,1,232
22174a76efd6c444f54b2303a336d56dd17b921a,0,Devaraj Das,2011-10-06 18:00:29+00:00,['98b9b505bf3c85f2652c19a2bea4d75161bf1ba8'],4,6,10,35467,3,,,,232
2792a42a4caf14c2059293f4d910aacf63ef9672,1,Devaraj Das,2011-10-06 20:08:18+00:00,['22174a76efd6c444f54b2303a336d56dd17b921a'],5,15,20,35487,2,1,1,0,232
466c9a8025e80f05e2ca595ef23023d20c8639a8,1,Devaraj Das,2011-10-06 20:22:59+00:00,['2792a42a4caf14c2059293f4d910aacf63ef9672'],3,12,15,35502,2,0.714285714,0.714285714,0.285714286,232
870dafbe5ece2154a5a0beaad45948dfcbb33ce5,1,Suhas,2011-10-06 21:29:32+00:00,['466c9a8025e80f05e2ca595ef23023d20c8639a8'],41,65,106,35608,7,0,1,1,232
06f78edeb92703f5ad7b4defcf25def42394a4cd,1,Eric Yang,2011-10-06 21:31:00+00:00,['870dafbe5ece2154a5a0beaad45948dfcbb33ce5'],1,29,30,35638,1,0,0.785714286,1,232
aad4e05cfb980a7a669e3614e7b91b51efede679,1,Eric Yang,2011-10-06 21:36:28+00:00,['06f78edeb92703f5ad7b4defcf25def42394a4cd'],0,14,14,35652,1,,,,233
fe903f63215b46e5aabfa3d453496b0b0dce5c00,1,Eric Yang,2011-10-07 01:54:10+00:00,['aad4e05cfb980a7a669e3614e7b91b51efede679'],11,93,104,35756,6,0.731707317,1,1,233
0160a2c8d3a77738769973dde5ec7233ec109564,1,Eric Yang,2011-10-07 19:49:52+00:00,['fe903f63215b46e5aabfa3d453496b0b0dce5c00'],29,64,93,35849,4,0.12,1,1,233
f6e6f69eceebea740d6aa95ce391a59914ef1d3a,1,Eric Yang,2011-10-07 20:50:21+00:00,['0160a2c8d3a77738769973dde5ec7233ec109564'],4,31,35,35884,2,0,0,1,233
95e20694def418e172a073dcc5279bd74e9ea408,1,Suhas,2011-10-07 22:53:25+00:00,['f6e6f69eceebea740d6aa95ce391a59914ef1d3a'],229,812,1041,36925,14,0.203791469,0.639810427,1,243
b406b60fbacbf1fdda7175fed8a8ceacc3ac9f78,1,Suhas,2011-10-07 23:27:37+00:00,['95e20694def418e172a073dcc5279bd74e9ea408'],32,20,52,36977,3,0,0,1,243
fe5af16fa7ad0551cebdd87e29962d4b921aa864,1,Suhas,2011-10-08 21:30:34+00:00,['b406b60fbacbf1fdda7175fed8a8ceacc3ac9f78'],69,133,202,37179,9,0.303030303,0.303030303,1,243
ba8d9fb4f9109a02157c45233f848308b1989658,1,Suhas,2011-10-08 21:38:14+00:00,['fe5af16fa7ad0551cebdd87e29962d4b921aa864'],8,10,18,37197,9,,,,243
2808545a2602b463844b83beac6b83bc0aa607e4,1,Suhas,2011-10-08 23:19:25+00:00,['ba8d9fb4f9109a02157c45233f848308b1989658'],18,11,29,37226,2,,,,243
83d57bf6a1645555da6b6d2bcd68f4c2080e4f3d,0,Owen O'Malley,2011-10-10 06:41:35+00:00,['2808545a2602b463844b83beac6b83bc0aa607e4'],113,194,307,37533,1,,,,243
c1987ed5f9593624d8d224623793e58d355718ad,1,Owen O'Malley,2011-10-10 07:25:42+00:00,['83d57bf6a1645555da6b6d2bcd68f4c2080e4f3d'],285,251,536,38069,16,1,0,0,243
a9bc0be0c06f9b32f34bcca0f6ef8731744a99d0,1,Owen O'Malley,2011-10-10 15:47:58+00:00,['c1987ed5f9593624d8d224623793e58d355718ad'],246,118,364,38433,5,1,1,1,244
0e6fa6dda071952f4d6350026a1220b4cc3f45d1,1,Devaraj Das,2011-10-10 21:51:03+00:00,['a9bc0be0c06f9b32f34bcca0f6ef8731744a99d0'],86,206,292,38725,6,0.0625,0.078125,0.234375,245
434d56491b834c33f17cfb66d82548e58a70180e,1,Suhas,2011-10-10 23:39:55+00:00,['0e6fa6dda071952f4d6350026a1220b4cc3f45d1'],33,126,159,38884,9,1,1,1,245
8ac818ad88c95661085feff1b276d99f339aeea8,1,Eric Yang,2011-10-10 23:59:13+00:00,['434d56491b834c33f17cfb66d82548e58a70180e'],143,115,258,39142,9,0,0,0,245
b5fdfc031879319e2c705c5c6d1d8ef4efc328f1,1,Eric Yang,2011-10-11 01:49:25+00:00,['8ac818ad88c95661085feff1b276d99f339aeea8'],4,133,137,39279,4,0.815384615,1,0.861538462,246
9f217483b44249e1b119d544545f7777cb95cf7b,0,Devaraj Das,2011-10-11 04:08:07+00:00,['b5fdfc031879319e2c705c5c6d1d8ef4efc328f1'],16,15,31,39310,1,1,1,0,246
9fb6417b545196187462598accd7bbfb2a05b9d4,1,Suhas,2011-10-11 07:21:10+00:00,['9f217483b44249e1b119d544545f7777cb95cf7b'],92,148,240,39550,5,0.269230769,0.115384615,1,246
af2029c69e5261344871b26fd77bc60027e45985,1,Eric Yang,2011-10-11 17:09:15+00:00,['9fb6417b545196187462598accd7bbfb2a05b9d4'],167,193,360,39910,22,0.7,1,0.266666667,246
06a53a0633d11b2b56b8d9d12a29c63bb4317a07,0,Eric Yang,2011-10-11 17:12:58+00:00,['af2029c69e5261344871b26fd77bc60027e45985'],21,22,43,39953,3,0,0,0,246
3fc0d4e0ff8f67b597bbd7bdf3dd946f2ebc9a78,1,Eric Yang,2011-10-11 18:39:19+00:00,['06a53a0633d11b2b56b8d9d12a29c63bb4317a07'],30,75,105,40058,4,0,0.186046512,1,246
ddc926a82e72e32fd130aca5a9923d50e599f258,1,Suhas,2011-10-11 19:23:05+00:00,['3fc0d4e0ff8f67b597bbd7bdf3dd946f2ebc9a78'],31,54,85,40143,2,0,0,1,246
4cf6e2c8a73cdfb3a3d8e3776ad5e7526bc95bdd,1,Suhas,2011-10-11 19:57:08+00:00,['ddc926a82e72e32fd130aca5a9923d50e599f258'],29,43,72,40215,2,1,0,0,246
0609cb997d51ddd4ed3ff2b512a3e1946fc11315,1,Devaraj Das,2011-10-11 23:09:37+00:00,['4cf6e2c8a73cdfb3a3d8e3776ad5e7526bc95bdd'],22,132,154,40369,6,0.577777778,0.977777778,0.6,246
b9f6526b41b3ad4d1d70ce1fe1678d333e7a1301,0,Eric Yang,2011-10-11 23:20:56+00:00,['0609cb997d51ddd4ed3ff2b512a3e1946fc11315'],29,23,52,40421,4,1,0,0,246
dc1ad02be478195bbf3f6785bec9d83e5cc7d280,1,Eric Yang,2011-10-11 23:23:21+00:00,['b9f6526b41b3ad4d1d70ce1fe1678d333e7a1301'],89,61,150,40571,8,0.441176471,0.117647059,0.441176471,246
5cbc89cf7fbbf6be5e3d4943fa1fa55d22b1a20a,1,Devaraj Das,2011-10-12 01:00:44+00:00,['dc1ad02be478195bbf3f6785bec9d83e5cc7d280'],20,7,27,40598,3,0.416666667,0.416666667,0.166666667,246
b1c2fc6341c5094a890d3586d0b46437737220cd,1,Suhas,2011-10-12 01:34:41+00:00,['5cbc89cf7fbbf6be5e3d4943fa1fa55d22b1a20a'],25,120,145,40743,5,0.354166667,0.75,0.895833333,246
55d0daf4d87e97b78439f56598a7172856b5d18a,1,Eric Yang,2011-10-12 02:06:02+00:00,['b1c2fc6341c5094a890d3586d0b46437737220cd'],8,52,60,40803,3,0,0,0.111111111,246
bec2e672743891632d5957b7f2f8b15529b38671,0,Devaraj Das,2011-10-12 05:51:34+00:00,['55d0daf4d87e97b78439f56598a7172856b5d18a'],29,70,99,40902,2,0.516129032,0.516129032,0.516129032,246
30b685b01c10ee4eb9877eb9b07c6c45a4392a25,1,Suhas,2011-10-12 06:48:13+00:00,['bec2e672743891632d5957b7f2f8b15529b38671'],12,414,426,41328,6,0.349344978,0.668122271,0.995633188,246
acfb0f62c3d3f988e48593d7c6deaae5bf47108d,0,Suhas,2011-10-12 06:48:43+00:00,['30b685b01c10ee4eb9877eb9b07c6c45a4392a25'],0,136,136,41464,1,0.459016393,1,1,247
5de1786f1d476c9dabe4d9adab3a30a1aec5ea76,0,Devaraj Das,2011-10-12 06:58:06+00:00,['acfb0f62c3d3f988e48593d7c6deaae5bf47108d'],67,32,99,41563,1,0.551724138,0,0,247
d1435b837ba4a465b5925510e8b643c94915b571,1,Owen O'Malley,2011-10-12 18:04:58+00:00,['5de1786f1d476c9dabe4d9adab3a30a1aec5ea76'],361,506,867,42430,15,0.492307692,0.630769231,0.984615385,251
d3399a4107e0510dc09674b274d8a79469ae873a,0,Owen O'Malley,2011-10-12 18:10:44+00:00,['d1435b837ba4a465b5925510e8b643c94915b571'],150,0,150,42580,1,0,0,0,251
0ee9b855d68a5a015b659f6e5fd059d6a7da3f50,0,Devaraj Das,2011-10-12 19:56:41+00:00,['d3399a4107e0510dc09674b274d8a79469ae873a'],22,35,57,42637,1,1,1,0.5,251
64326b182f9ed3a81d013c168a9cefb6806d7259,1,Eric Yang,2011-10-12 22:45:50+00:00,['0ee9b855d68a5a015b659f6e5fd059d6a7da3f50'],11,66,77,42714,4,0.555555556,0.822222222,1,251
0935d27a5183dac5a2b60b114a2d0add324414b6,1,Devaraj Das,2011-10-13 04:29:07+00:00,['64326b182f9ed3a81d013c168a9cefb6806d7259'],31,71,102,42816,2,0.477272727,0.477272727,0.363636364,251
78ae97060a5d55607ea5eafdd145b2322d4b26d7,1,Suhas,2011-10-13 06:47:28+00:00,['0935d27a5183dac5a2b60b114a2d0add324414b6'],20,99,119,42935,8,0.461538462,1,1,251
c9a1e6a50450098267ce4508f747761170ae0f28,1,Suhas,2011-10-13 06:48:00+00:00,['78ae97060a5d55607ea5eafdd145b2322d4b26d7'],0,538,538,43473,4,0.553488372,0.827906977,1,255
232e4e6906405d66cea5fa245819af14e087b6e2,1,Suhas,2011-10-13 07:40:10+00:00,['c9a1e6a50450098267ce4508f747761170ae0f28'],5,148,153,43626,4,0.602739726,1,1,255
43d3ccf6ebe95cb585a4291e14a66d7bcb2e6216,1,Eric Yang,2011-10-13 20:31:39+00:00,['232e4e6906405d66cea5fa245819af14e087b6e2'],60,123,183,43809,6,1,1,1,257
a9ded07cd2a1c9091203d424a299080e6d6748a7,1,Suhas,2011-10-13 21:06:28+00:00,['43d3ccf6ebe95cb585a4291e14a66d7bcb2e6216'],19,24,43,43852,6,0,0,0,257
6d9b9face26e04de0168c85c536ede93d635b20c,0,Devaraj Das,2011-10-14 00:55:24+00:00,['a9ded07cd2a1c9091203d424a299080e6d6748a7'],7,49,56,43908,2,0,0,0.2,257
e419ef96ff73dda9edf0b804c4e9ca910d917a86,0,Devaraj Das,2011-10-14 01:35:37+00:00,['6d9b9face26e04de0168c85c536ede93d635b20c'],7,6,13,43921,1,,,,257
3cdfc99c50f217eff3e08ead24b49716562190c0,1,Eric Yang,2011-10-14 02:25:24+00:00,['e419ef96ff73dda9edf0b804c4e9ca910d917a86'],87,573,660,44581,17,,,,264
3eb28c674f7abc43dde77cb2a38c8ed6f13149eb,0,Eric Yang,2011-10-14 02:31:40+00:00,['3cdfc99c50f217eff3e08ead24b49716562190c0'],3,3,6,44587,1,,,,264
66592e45b4709eb6248a9b7228e98d03cbb63153,0,Devaraj Das,2011-10-14 02:42:07+00:00,['3eb28c674f7abc43dde77cb2a38c8ed6f13149eb'],1,1,2,44589,1,,,,264
4f91d1671b9333c18680cef49c2952c347c2f980,1,Suhas,2011-10-14 05:21:26+00:00,['66592e45b4709eb6248a9b7228e98d03cbb63153'],16,107,123,44712,9,0.441860465,0.976744186,0,264
f8ecca9b2425191f6dfb0a8a1d11a799fb38d4f2,1,Suhas,2011-10-14 06:50:14+00:00,['4f91d1671b9333c18680cef49c2952c347c2f980'],12,197,209,44921,7,0.395348837,0.651162791,1,265
bb14d41b2a69e9f72e090c2efedbea9982510c06,0,Eric Yang,2011-10-14 16:17:48+00:00,['f8ecca9b2425191f6dfb0a8a1d11a799fb38d4f2'],3,9,12,44933,3,0,0,1,265
d8f1a0d4238d05e01cad9a21d371eb083b3f8973,1,Eric Yang,2011-10-14 18:00:10+00:00,['bb14d41b2a69e9f72e090c2efedbea9982510c06'],61,88,149,45082,5,1,0.25,0.35,266
cb296c0f2eca7ec612d8ff73c723ffb2c35a3321,0,Eric Yang,2011-10-14 18:00:31+00:00,['d8f1a0d4238d05e01cad9a21d371eb083b3f8973'],0,2,2,45084,1,,,,266
7675f9cc259c1b6600836e16ae0f5f60cdf51004,1,Suhas,2011-10-14 22:31:41+00:00,['cb296c0f2eca7ec612d8ff73c723ffb2c35a3321'],7,16,23,45107,4,1,1,0.8,266
576a3914bab75a01e02846e64630e39f16b636b5,0,Suhas,2011-10-14 23:11:51+00:00,['7675f9cc259c1b6600836e16ae0f5f60cdf51004'],4,8,12,45119,1,1,1,1,266
d67600e682845393a54a658378dc0f68246ad7b3,1,Suhas,2011-10-14 23:58:05+00:00,['576a3914bab75a01e02846e64630e39f16b636b5'],41,75,116,45235,3,0,1,0,266
f6a3cf73963655a00f8a75174240115f74affa60,1,Devaraj Das,2011-10-16 23:11:13+00:00,['d67600e682845393a54a658378dc0f68246ad7b3'],193,205,398,45633,9,1,0,0,266
8b439e2be1a584e7391fa144af6461677b30050a,1,Suhas,2011-10-17 19:24:55+00:00,['f6a3cf73963655a00f8a75174240115f74affa60'],17,429,446,46079,7,0.471204188,1,0.691099476,267
4625a972bc84bb47acf885c83cba4a6468c1b273,1,Suhas,2011-10-17 21:53:02+00:00,['8b439e2be1a584e7391fa144af6461677b30050a'],4,178,182,46261,8,0.355263158,1,1,268
14b9b30a4a770ffcce08800257914d7d4e4f8332,1,Suhas,2011-10-18 00:28:19+00:00,['4625a972bc84bb47acf885c83cba4a6468c1b273'],9,72,81,46342,2,0,0,0.12,268
c73f38e19334cab5c841b911a69ab0669fd12d97,1,Eric Yang,2011-10-18 02:04:29+00:00,['14b9b30a4a770ffcce08800257914d7d4e4f8332'],1,20,21,46363,2,,,,268
97be1f9373baaec3b5402e105f2c45cd021a6ae4,0,Owen O'Malley,2011-10-18 20:25:34+00:00,['c73f38e19334cab5c841b911a69ab0669fd12d97'],5,10,15,46378,2,,,,268
ee56cf2711d351802ae3b5d754adf62063845e66,0,Eric Yang,2011-10-18 21:28:28+00:00,['97be1f9373baaec3b5402e105f2c45cd021a6ae4'],23,22,45,46423,7,,,,268
898dd6d627b4b8ea48f487c8e31f8d421d28032b,0,Eric Yang,2011-10-18 21:30:41+00:00,['ee56cf2711d351802ae3b5d754adf62063845e66'],13,167,180,46603,2,0,1,1,268
1462da5f863270f3e78ae5d795d56bdb72a6a4e3,0,Eric Yang,2011-10-18 21:31:48+00:00,['898dd6d627b4b8ea48f487c8e31f8d421d28032b'],2,3,5,46608,2,,,,268
642b8768739118b9ee2af2e797a9f1f52b785191,1,Eric Yang,2011-10-18 21:52:58+00:00,['1462da5f863270f3e78ae5d795d56bdb72a6a4e3'],12,265,277,46885,11,0.685714286,1,1,274
cfc85bbe941cade25853b5bc2306d789ad3d57e5,0,Eric Yang,2011-10-19 00:04:38+00:00,['642b8768739118b9ee2af2e797a9f1f52b785191'],5,168,173,47058,6,1,1,0.641304348,276
8c49cd6afb2467e9d5f1d2a752495bd36729e532,1,Eric Yang,2011-10-19 00:35:13+00:00,['cfc85bbe941cade25853b5bc2306d789ad3d57e5'],2,2,4,47062,1,,,,276
b6ecc64764872ed26464ff683bb0d21018eba424,0,Eric Yang,2011-10-19 01:12:33+00:00,['8c49cd6afb2467e9d5f1d2a752495bd36729e532'],6,3,9,47071,3,0,0,1,276
d6033cd6c4aaaf1d202c227fb718d79f5b1c0afe,1,Devaraj Das,2011-10-19 14:19:19+00:00,['b6ecc64764872ed26464ff683bb0d21018eba424'],211,283,494,47565,14,1,1,1,276
de85eae896606391b02e5094d8b2a333070c6c67,1,Suhas,2011-10-19 20:09:18+00:00,['d6033cd6c4aaaf1d202c227fb718d79f5b1c0afe'],30,62,92,47657,4,0.5,1,1,276
9efb93dc8011a147e713dac9337c90537c730dfd,1,Suhas,2011-10-19 21:33:25+00:00,['de85eae896606391b02e5094d8b2a333070c6c67'],1,5,6,47663,2,,,,276
c77565e0a3dd34092ad0a71cf999faccd4ee1202,1,Devaraj Das,2011-10-19 23:09:11+00:00,['9efb93dc8011a147e713dac9337c90537c730dfd'],83,96,179,47842,2,0.6,0.6,1,276
1d61129b161a514a714d4843eaacb611f53c409a,1,Suhas,2011-10-20 01:33:48+00:00,['c77565e0a3dd34092ad0a71cf999faccd4ee1202'],5,20,25,47867,4,0,0,1,276
3ea91720ba5829f867216b82a0d6977e81228900,1,Suhas,2011-10-20 05:47:45+00:00,['1d61129b161a514a714d4843eaacb611f53c409a'],92,305,397,48264,9,0.525,0.991666667,0.95,276
9e9609bdedccd1ecbf01d1a0e8c7b565b34a06d1,1,Suhas,2011-10-20 18:42:17+00:00,['3ea91720ba5829f867216b82a0d6977e81228900'],64,393,457,48721,12,0.384615385,0.579881657,1,276
ac57063579204a0fecd1c08e45b80b857a8e5cd0,1,Owen O'Malley,2011-10-21 17:22:25+00:00,['9e9609bdedccd1ecbf01d1a0e8c7b565b34a06d1'],204,281,485,49206,10,1,0,1,280
bd5fa64a882ff035f5e0699e2f1a1924603f7d42,1,Eric Yang,2011-10-21 18:18:28+00:00,['ac57063579204a0fecd1c08e45b80b857a8e5cd0'],2,8,10,49216,2,0,0,1,280
d02997a06ac84a1a0238eb7bcec073e964a49ace,1,Eric Yang,2011-10-21 21:40:26+00:00,['bd5fa64a882ff035f5e0699e2f1a1924603f7d42'],2,50,52,49268,2,0.545454545,0.515151515,1,280
35366c13fe938d5ed79c3e67ad58934b9769a920,0,Eric Yang,2011-10-21 21:40:47+00:00,['d02997a06ac84a1a0238eb7bcec073e964a49ace'],0,2,2,49270,1,,,,280
b3f5080ecb242608501fb6b2d89d310c4553c228,0,Eric Yang,2011-10-21 21:48:36+00:00,['35366c13fe938d5ed79c3e67ad58934b9769a920'],13,16,29,49299,2,1,1,0,280
33cf13a671a8cbd6663ae526f93936e62b711edd,0,Eric Yang,2011-10-21 22:31:13+00:00,['b3f5080ecb242608501fb6b2d89d310c4553c228'],5,16,21,49320,2,1,1,1,280
b5203d80981548c011a099cd0836c2dcbbfd3160,0,Eric Yang,2011-10-21 22:32:04+00:00,['33cf13a671a8cbd6663ae526f93936e62b711edd'],3,3,6,49326,1,,,,280
bef5cc7c62f55a4f07b74c98aeb69ea603933970,1,Suhas,2011-10-24 19:53:26+00:00,['b5203d80981548c011a099cd0836c2dcbbfd3160'],39,307,346,49672,6,,,,280
1335e7e66686eccf1676ddc4520a298a93fa62f1,1,Suhas,2011-10-24 20:02:04+00:00,['bef5cc7c62f55a4f07b74c98aeb69ea603933970'],63,75,138,49810,1,,,,280
cac6378fa6c8b96701c2af3d601b54a9c5d7d6e3,1,Eric Yang,2011-10-25 00:48:12+00:00,['1335e7e66686eccf1676ddc4520a298a93fa62f1'],75,509,584,50394,23,1,1,0.75862069,281
117797104854792f7b1f5d5c6140724116a879fe,0,Eric Yang,2011-10-25 01:48:23+00:00,['cac6378fa6c8b96701c2af3d601b54a9c5d7d6e3'],2,15,17,50411,4,,,,281
1015b8c8e9e42c24b1fb750f356de15de800201b,1,Devaraj Das,2011-10-25 03:03:32+00:00,['117797104854792f7b1f5d5c6140724116a879fe'],78,331,409,50820,3,0.27,0.555,0.34,281
7f0336380f9c1061834b41c671917e53a18332e0,0,Devaraj Das,2011-10-25 03:05:10+00:00,['1015b8c8e9e42c24b1fb750f356de15de800201b'],1,1,2,50822,1,,,,281
88407e5006e6164b80a273b0bb71b9611f6a0cc0,1,Suhas,2011-10-25 20:27:05+00:00,['7f0336380f9c1061834b41c671917e53a18332e0'],121,89,210,51032,11,0,0.315789474,0,281
f8b1c919d3938f436503733c02ac49670d45cd29,0,Devaraj Das,2011-10-25 20:46:12+00:00,['88407e5006e6164b80a273b0bb71b9611f6a0cc0'],56,49,105,51137,4,1,1,0,281
fe896af4a7e20bf16a07788ce2b8f6a635f7b2cf,0,Suhas,2011-10-25 21:24:55+00:00,['f8b1c919d3938f436503733c02ac49670d45cd29'],275,4,279,51416,3,,,,281
fcab15a3698c06cfd137d7ec63f29a434f72dd43,0,Eric Yang,2011-10-25 21:38:00+00:00,['fe896af4a7e20bf16a07788ce2b8f6a635f7b2cf'],2,2,4,51420,1,,,,281
8e7b6fee8851d9e7fb805cab78e41a2bd2cfb15e,0,Eric Yang,2011-10-25 23:37:02+00:00,['fcab15a3698c06cfd137d7ec63f29a434f72dd43'],2,9,11,51431,2,0,1,1,281
148b32244843a07639c9dcaaf3f9d6f3a5e9f03f,1,Devaraj Das,2011-10-26 01:57:10+00:00,['8e7b6fee8851d9e7fb805cab78e41a2bd2cfb15e'],19,42,61,51492,6,0,0.882352941,0,281
6e7bf601f3df5ac2d81db8465516e04baa2c98dc,1,Eric Yang,2011-10-26 18:22:04+00:00,['148b32244843a07639c9dcaaf3f9d6f3a5e9f03f'],38,41,79,51571,17,,,,281
2a09ba9d03d62cf123643940529256980320570a,0,Devaraj Das,2011-10-26 19:02:41+00:00,['6e7bf601f3df5ac2d81db8465516e04baa2c98dc'],10,12,22,51593,2,,,,281
3b83022106df8d0e752e5d4287c77d595b9ba987,1,Suhas,2011-10-26 19:08:11+00:00,['2a09ba9d03d62cf123643940529256980320570a'],45,53,98,51691,5,0,1,0,281
847ec939d165cf65d536860219d8dd8300edaacb,1,Suhas,2011-10-26 19:58:58+00:00,['3b83022106df8d0e752e5d4287c77d595b9ba987'],262,233,495,52186,5,0.3125,0.3125,0.1875,281
06ea1dacc5ad2f61d3b66940be46bfc06a5e32f2,0,Devaraj Das,2011-10-26 21:01:02+00:00,['847ec939d165cf65d536860219d8dd8300edaacb'],7,9,16,52202,4,,,,281
f7ab1d0d73d17b49bafd197dd998fc5d8a9fb9db,1,Suhas,2011-10-26 22:51:30+00:00,['06ea1dacc5ad2f61d3b66940be46bfc06a5e32f2'],162,164,326,52528,17,,,,281
1c479527639a8a6c3406b0afad5c1f4d8512953b,1,Suhas,2011-10-26 23:06:37+00:00,['f7ab1d0d73d17b49bafd197dd998fc5d8a9fb9db'],98,98,196,52724,9,,,,281
61d13b0fc2cf3a5abb806719560adc9b19c9cf1e,0,Owen O'Malley,2011-10-26 23:12:25+00:00,['1c479527639a8a6c3406b0afad5c1f4d8512953b'],115,180,295,53019,2,,,,281
9af85e89a6f7dfc22d44d2661c91d97a4eb8a500,1,Suhas,2011-10-26 23:18:20+00:00,['61d13b0fc2cf3a5abb806719560adc9b19c9cf1e'],72,72,144,53163,10,,,,281
b2d6b584f7dc9b409ff04c83b209ef38f98d17cc,1,Suhas,2011-10-26 23:34:33+00:00,['9af85e89a6f7dfc22d44d2661c91d97a4eb8a500'],95,95,190,53353,12,,,,281
87230f99163b929d8075ce6dd1de7576c5e55fef,0,Suhas,2011-10-26 23:43:44+00:00,['b2d6b584f7dc9b409ff04c83b209ef38f98d17cc'],13,13,26,53379,7,,,,281
b351f8e00e84c953be900a7b0f0de69f316d117b,0,Eric Yang,2011-10-26 23:46:09+00:00,['87230f99163b929d8075ce6dd1de7576c5e55fef'],141,97,238,53617,3,,,,281
2bbe14219cf6db91d3c0fb2bf37ebd2cc47a722a,1,Eric Yang,2011-10-27 02:26:56+00:00,['b351f8e00e84c953be900a7b0f0de69f316d117b'],4,30,34,53651,4,,,,282
5421edcea17f52d914e1e285cc5ab5116c650b1d,1,Eric Yang,2011-10-27 06:37:14+00:00,['2bbe14219cf6db91d3c0fb2bf37ebd2cc47a722a'],29,100,129,53780,5,1,1,1,282
2c5a8044f2d3cf94e41247b9b74e2bd88d1ae882,0,Eric Yang,2011-10-27 06:45:52+00:00,['5421edcea17f52d914e1e285cc5ab5116c650b1d'],1,1,2,53782,1,,,,282
eb0f756dac66406fef28bc2b180a27ff37eeb5ef,1,Suhas,2011-10-27 06:58:54+00:00,['2c5a8044f2d3cf94e41247b9b74e2bd88d1ae882'],26,162,188,53970,5,1,1,1,283
718ae90cf7590b3dab9f850e44026b999a6008a7,0,Owen O'Malley,2011-10-27 17:47:36+00:00,['eb0f756dac66406fef28bc2b180a27ff37eeb5ef'],252,63,315,54285,6,0,0,0,284
1b087340a7de12718f47a1f99ab970d2b42bad08,1,Suhas,2011-10-27 18:24:10+00:00,['718ae90cf7590b3dab9f850e44026b999a6008a7'],9,15,24,54309,4,,,,284
7d5747ec8affb298ab473a890ad7a4f00a981f69,1,Suhas,2011-10-27 19:31:49+00:00,['1b087340a7de12718f47a1f99ab970d2b42bad08'],477,384,861,55170,6,,,,284
b7ed71badc54c102f517c9af9e08fd7369bbce14,1,Devaraj Das,2011-10-27 22:18:46+00:00,['7d5747ec8affb298ab473a890ad7a4f00a981f69'],3,9,12,55182,2,0,0,1,284
33574a865cb4c5a68a7e8d0ed59073999b4c1deb,0,Owen O'Malley,2011-10-27 23:11:37+00:00,['b7ed71badc54c102f517c9af9e08fd7369bbce14'],37,34,71,55253,2,,,,284
e504fb54d82146dede24e95a2dabc8477e3e3543,0,Owen O'Malley,2011-10-27 23:49:26+00:00,['33574a865cb4c5a68a7e8d0ed59073999b4c1deb'],33,44,77,55330,2,,,,284
7f8f881fa27a0e973d349b204d2b88badc85ce57,1,Suhas,2011-10-28 00:02:00+00:00,['e504fb54d82146dede24e95a2dabc8477e3e3543'],23,31,54,55384,1,1,1,1,284
5ae3696c3746c8f0668104f68dbd3625300c11e3,0,Devaraj Das,2011-10-28 00:26:46+00:00,['7f8f881fa27a0e973d349b204d2b88badc85ce57'],18,20,38,55422,2,,,,284
9daeb3a6f5897427ee897f2e1bbe33852d5cbd83,0,Eric Yang,2011-10-28 17:56:44+00:00,['5ae3696c3746c8f0668104f68dbd3625300c11e3'],1,3,4,55426,2,,,,284
f7dbf15fa2317297f21eeb4492f249157e631f82,0,Owen O'Malley,2011-10-28 18:16:44+00:00,['9daeb3a6f5897427ee897f2e1bbe33852d5cbd83'],34,129,163,55589,4,,,,285
228fbb8c262aa789c5e7aa2fc622ce2c0a7f01d6,1,Owen O'Malley,2011-10-28 20:22:09+00:00,['f7dbf15fa2317297f21eeb4492f249157e631f82'],98,204,302,55891,20,0,0,0,285
3c41f89722616a2c79f55ecfa7dac9f855f0bfaa,0,Owen O'Malley,2011-10-29 00:02:01+00:00,['228fbb8c262aa789c5e7aa2fc622ce2c0a7f01d6'],23,64,87,55978,1,,,,285
af3cb35229d53803231e395df0df989a0cb9ebb9,0,Devaraj Das,2011-10-29 21:15:30+00:00,['3c41f89722616a2c79f55ecfa7dac9f855f0bfaa'],100,154,254,56232,12,0,0.461538462,0.461538462,285
f8777a857b6a3a321a50839fabaeba060a23a514,0,Suhas,2011-10-30 02:16:13+00:00,['af3cb35229d53803231e395df0df989a0cb9ebb9'],4,2,6,56238,1,,,,285
4857994cfb6fe8c6d588dfa62f50e1d7743079c0,0,Devaraj Das,2011-10-31 06:44:56+00:00,['f8777a857b6a3a321a50839fabaeba060a23a514'],15,48,63,56301,4,0,0.857142857,0.142857143,285
a76afdc89cda0e7c8e63447d9d3233d9ccbb71fc,0,Owen O'Malley,2011-10-31 18:17:43+00:00,['4857994cfb6fe8c6d588dfa62f50e1d7743079c0'],26,153,179,56480,7,0,0,0,285
18ee8bf6334c45230b6ae5f33c3b2d435af65b97,0,Eric Yang,2011-10-31 18:50:35+00:00,['a76afdc89cda0e7c8e63447d9d3233d9ccbb71fc'],1,8,9,56489,2,0,1,1,285
bb26e6a58d7c1e80c30706af328aeaa13690ae77,0,Devaraj Das,2011-10-31 21:17:42+00:00,['18ee8bf6334c45230b6ae5f33c3b2d435af65b97'],3,18,21,56510,2,0.818181818,1,0.545454545,285
6b75e089008016314030f30c7e9742e47564d82e,1,Eric Yang,2011-10-31 23:15:06+00:00,['bb26e6a58d7c1e80c30706af328aeaa13690ae77'],13,38,51,56561,5,0,0.869565217,0.47826087,285
040b8fc4764a2372a7baeb29c589c7fdfa7338a7,0,Owen O'Malley,2011-11-01 04:56:42+00:00,['6b75e089008016314030f30c7e9742e47564d82e'],5,10,15,56576,1,,,,285
d23750be798c4cca46951074b016071beec07fa5,1,Suhas,2011-11-01 23:22:27+00:00,['040b8fc4764a2372a7baeb29c589c7fdfa7338a7'],20,20,40,56616,2,,,,285
240dbd8c6613c6fe30d2d9e93dad10952ed5a5ca,1,Eric Yang,2011-11-02 06:52:51+00:00,['d23750be798c4cca46951074b016071beec07fa5'],67,90,157,56773,7,,,,285
7765efbee28d1918e43b0a84acd4c00f349c6424,0,Devaraj Das,2011-11-02 06:55:33+00:00,['240dbd8c6613c6fe30d2d9e93dad10952ed5a5ca'],20,32,52,56825,3,1,0.714285714,0.571428571,285
d6639d4fd6eb8b96e789effe4aabc57b367b12cd,1,Eric Yang,2011-11-02 07:11:14+00:00,['7765efbee28d1918e43b0a84acd4c00f349c6424'],6,11,17,56842,2,1,1,1,285
1bacc3831ee93632759bf066db6aada6fa83090a,0,Eric Yang,2011-11-02 16:19:07+00:00,['d6639d4fd6eb8b96e789effe4aabc57b367b12cd'],1,1,2,56844,1,,,,285
c5f9c77d5f4e8439bdf5fc60a84325afcebf8dcd,1,Suhas,2011-11-03 07:48:30+00:00,['1bacc3831ee93632759bf066db6aada6fa83090a'],367,863,1230,58074,15,0.671428571,0.892857143,0.896428571,288
37a67049c861eb4ed08219093392f62d42e22bd1,1,Suhas,2011-11-03 18:44:32+00:00,['c5f9c77d5f4e8439bdf5fc60a84325afcebf8dcd'],16,56,72,58146,3,0,0,1,288
373b81077a9218a169dd7dd1ef8ab8b9520abed6,1,Suhas,2011-11-03 20:19:25+00:00,['37a67049c861eb4ed08219093392f62d42e22bd1'],25,37,62,58208,3,1,1,1,288
dc87b7efc2ad3d28776d2bb24b2cfb7f888e205a,0,Suhas,2011-11-03 20:21:06+00:00,['373b81077a9218a169dd7dd1ef8ab8b9520abed6'],8,0,8,58216,1,,,,288
9e20ad2f0d6fb27c4d6db15adf27db9bf2afb1ce,0,Devaraj Das,2011-11-04 07:03:11+00:00,['dc87b7efc2ad3d28776d2bb24b2cfb7f888e205a'],6,8,14,58230,2,1,1,1,288
d1d7f01d0f5806b80ddd7fe0cd88bddb7e9c3455,0,Devaraj Das,2011-11-04 07:03:36+00:00,['9e20ad2f0d6fb27c4d6db15adf27db9bf2afb1ce'],0,2,2,58232,1,,,,288
3ec258a1e77a8324349d9cfba5b76ce277c0c6c3,0,Eric Yang,2011-11-10 17:21:53+00:00,['d1d7f01d0f5806b80ddd7fe0cd88bddb7e9c3455'],9,11,20,58252,2,,,,288
b3d43254010f6096a568209bed3b201af3e7ae20,0,Eric Yang,2011-11-10 17:42:48+00:00,['3ec258a1e77a8324349d9cfba5b76ce277c0c6c3'],3,9,12,58264,4,1,1,1,288
4b00a7ed3a95665f90f8fb12b2a531eb0e4defa5,1,Eric Yang,2011-11-10 21:00:36+00:00,['b3d43254010f6096a568209bed3b201af3e7ae20'],105,104,209,58473,13,,,,288
98edec90e9340f888e86efec0508116e7a401680,0,Eric Yang,2011-11-10 21:05:16+00:00,['4b00a7ed3a95665f90f8fb12b2a531eb0e4defa5'],5,5,10,58483,3,,,,288
2f5e2bc33c851f4aaaa229ad78ab43fc0ecfab85,0,Eric Yang,2011-11-15 16:49:13+00:00,['98edec90e9340f888e86efec0508116e7a401680'],1,3,4,58487,2,,,,288
9849cf8f8d0b4d959e36aacd4eb2082b5feb8102,0,Owen O'Malley,2011-11-15 17:18:15+00:00,['2f5e2bc33c851f4aaaa229ad78ab43fc0ecfab85'],44,114,158,58645,2,,,,288
fad5f16acbe32550d1a9f40fd2f776da78b55a77,0,Eric Yang,2011-11-20 19:42:07+00:00,['9849cf8f8d0b4d959e36aacd4eb2082b5feb8102'],1,3,4,58649,2,,,,288
60f294a022131b766f8b5ef0cf621cf8adfa3c8b,0,Owen O'Malley,2011-11-22 06:56:40+00:00,['fad5f16acbe32550d1a9f40fd2f776da78b55a77'],4,30,34,58683,2,,,,288
61630bb19c87a9216892e23de4e49b471c8e6b61,0,Devaraj Das,2011-11-22 22:07:25+00:00,['60f294a022131b766f8b5ef0cf621cf8adfa3c8b'],152,15,167,58850,5,0.465116279,0,0.418604651,288
5c4cee0f5ec3aba52db82f36f34723196b921025,1,Suhas,2011-11-23 06:20:33+00:00,['61630bb19c87a9216892e23de4e49b471c8e6b61'],78,64,142,58992,2,0,0,0,288
bd640a417f3b01995adaf923879fa62df46560f8,1,Suhas,2011-11-23 08:30:46+00:00,['5c4cee0f5ec3aba52db82f36f34723196b921025'],2,67,69,59061,2,0.064516129,0.064516129,0.903225806,288
9eebb9837c0db2ae940bccf62086bbeaf1c9016c,1,Suhas,2011-11-27 00:31:25+00:00,['bd640a417f3b01995adaf923879fa62df46560f8'],311,538,849,59910,10,0,0.192307692,1,289
471a9d6e2a88d449a15cb6b6699626cc0a832eba,1,Suhas,2011-11-28 00:08:50+00:00,['9eebb9837c0db2ae940bccf62086bbeaf1c9016c'],11,34,45,59955,6,0,0,1,289
c74f4d5e29a0440aa0bd89013ce44ecb0828762e,1,Devaraj Das,2011-11-28 06:47:24+00:00,['471a9d6e2a88d449a15cb6b6699626cc0a832eba'],478,141,619,60574,7,0.659259259,0.37037037,0.544444444,289
3137148c079325b595cc557f74c0ba84deda9c9b,1,Suhas,2011-11-28 21:56:05+00:00,['c74f4d5e29a0440aa0bd89013ce44ecb0828762e'],109,60,169,60743,4,1,0,0,289
96fe365debdf9498860eb3fbbe09a24928d0d268,1,Devaraj Das,2011-11-28 23:03:06+00:00,['3137148c079325b595cc557f74c0ba84deda9c9b'],7,8,15,60758,3,0,0,0,289
285c638d1faa8aba356a2f4d249caa88ed64a16c,1,Suhas,2011-11-29 02:04:35+00:00,['96fe365debdf9498860eb3fbbe09a24928d0d268'],47,60,107,60865,3,0,0,1,289
bda3df3974ac0efaa7c84b461e46bfb681e0a866,1,Devaraj Das,2011-11-30 04:22:15+00:00,['285c638d1faa8aba356a2f4d249caa88ed64a16c'],17,64,81,60946,5,0.076923077,0.615384615,0.435897436,289
efa884b5b04c57aa8fed4d079d544558d84a75a7,1,Suhas,2011-11-30 07:24:55+00:00,['bda3df3974ac0efaa7c84b461e46bfb681e0a866'],38,41,79,61025,1,,,,289
f1b68132b1411bca21e6114a2f4b5151aaeab1f9,1,Owen O'Malley,2011-12-01 23:46:49+00:00,['efa884b5b04c57aa8fed4d079d544558d84a75a7'],11,14,25,61050,2,0,1,0,289
d8394f1d4d37d4c5f52c6c4f9529ed0fb5d889e6,0,Devaraj Das,2011-12-02 00:46:19+00:00,['f1b68132b1411bca21e6114a2f4b5151aaeab1f9'],34,49,83,61133,12,0,1,0.75,289
c9c20ac7deb3728d2d6f3c5f3beca20c4d516621,0,Devaraj Das,2011-12-02 01:09:39+00:00,['d8394f1d4d37d4c5f52c6c4f9529ed0fb5d889e6'],0,85,85,61218,1,1,1,1,290
5aa7c7279b8e9d8863b925e11aa4599b80868209,1,Owen O'Malley,2011-12-06 16:19:14+00:00,['c9c20ac7deb3728d2d6f3c5f3beca20c4d516621'],435,1497,1932,63150,34,0.567970205,0.782122905,0.819366853,299
02b64e4c7ced7ffa413b93fbfd85b4ad6c93d381,1,Suhas,2011-12-06 19:27:43+00:00,['5aa7c7279b8e9d8863b925e11aa4599b80868209'],114,114,228,63378,1,,,,299
5006337816cd0cb9a71f7bf3c7fa96e55aeefc08,1,Suhas,2011-12-06 21:18:13+00:00,['02b64e4c7ced7ffa413b93fbfd85b4ad6c93d381'],16,16,32,63410,1,,,,299
f7e96e639f35b925600c219b85c5a0701669a417,0,Suhas,2011-12-06 21:32:04+00:00,['5006337816cd0cb9a71f7bf3c7fa96e55aeefc08'],5,0,5,63415,1,,,,299
e7a622afce1979dadaaea0d3f431bed120abbbb2,0,Owen O'Malley,2011-12-06 22:01:04+00:00,['f7e96e639f35b925600c219b85c5a0701669a417'],3,0,3,63418,2,0,0,0,299
a8e85ff21b7f543cd2375b6c6b32f5fb1f8fdae7,1,Suhas,2011-12-07 05:11:07+00:00,['e7a622afce1979dadaaea0d3f431bed120abbbb2'],80,80,160,63578,1,,,,299
fef1b18ddbf59cbe5844bc4b5fd396b61e16a3a0,1,Suhas,2011-12-07 05:25:43+00:00,['a8e85ff21b7f543cd2375b6c6b32f5fb1f8fdae7'],10,10,20,63598,1,,,,299
5739079064d1fabc1831b73864b0ecdbc28d8202,0,Suhas,2011-12-07 05:28:02+00:00,['fef1b18ddbf59cbe5844bc4b5fd396b61e16a3a0'],1,1,2,63600,1,,,,299
328c5a28c509ec26f2c3272f2ac183c02525a0f8,0,Suhas,2011-12-07 05:46:58+00:00,['5739079064d1fabc1831b73864b0ecdbc28d8202'],87,0,87,63687,1,,,,299
86673b10762925c11b575f541bc9338517cf646d,0,Suhas,2011-12-07 21:08:35+00:00,['328c5a28c509ec26f2c3272f2ac183c02525a0f8'],0,75,75,63762,1,,,,299
7863fcf0f1a6b6a7d7e0b5aaef81c8b2442c4480,1,Suhas,2011-12-08 00:01:11+00:00,['86673b10762925c11b575f541bc9338517cf646d'],28,111,139,63901,2,0.163934426,0.540983607,0.967213115,299
85634d4e5b6453ea7dfaaa9176639cf46100d6f2,0,Owen O'Malley,2011-12-09 00:13:21+00:00,['7863fcf0f1a6b6a7d7e0b5aaef81c8b2442c4480'],5,1,6,63907,2,0,0,1,299
ddfca55cc2a25d5c63f68ac6b86772163588b3f1,1,Devaraj Das,2011-12-09 09:13:06+00:00,['85634d4e5b6453ea7dfaaa9176639cf46100d6f2'],176,829,1005,64912,20,0.546632124,0.950777202,1,301
24ec25cb3d8524144809412d0ce7a0b99eed4700,0,Owen O'Malley,2011-12-09 17:14:43+00:00,['ddfca55cc2a25d5c63f68ac6b86772163588b3f1'],12,36,48,64960,3,0,0,0,301
742cc3d3761964b7afef220116481665b62666a0,1,Devaraj Das,2011-12-09 22:31:56+00:00,['24ec25cb3d8524144809412d0ce7a0b99eed4700'],182,742,924,65884,17,0.907949791,1,0.778242678,305
6509d3fc0141f6aac228736ec4fbb6931b983c7b,0,Devaraj Das,2011-12-09 22:34:38+00:00,['742cc3d3761964b7afef220116481665b62666a0'],1,1,2,65886,1,,,,305
a0f2a8ed38a36f4f2c87c3663c297026d7c4945d,0,Devaraj Das,2011-12-10 07:06:29+00:00,['6509d3fc0141f6aac228736ec4fbb6931b983c7b'],0,1,1,65887,1,1,1,1,305
bc1b395f5d545307676e37b04ea0113a9e67f792,0,Owen O'Malley,2011-12-11 15:16:22+00:00,['a0f2a8ed38a36f4f2c87c3663c297026d7c4945d'],1,3,4,65891,2,,,,305
798c7e3ec5f94b4868d4067d0374df3b4f9bf0f4,1,Devaraj Das,2011-12-11 19:20:13+00:00,['bc1b395f5d545307676e37b04ea0113a9e67f792'],173,419,592,66483,21,0.945945946,1,1,311
9dddf48d6e4705d139d1cf74ec984fc5d9b87148,0,Devaraj Das,2011-12-12 05:53:03+00:00,['798c7e3ec5f94b4868d4067d0374df3b4f9bf0f4'],4,4,8,66491,5,,,,311
ec13d649820060b4e1171c90abb787d20c32640c,1,Owen O'Malley,2011-12-12 08:21:17+00:00,['9dddf48d6e4705d139d1cf74ec984fc5d9b87148'],452,1986,2438,68929,18,0.232323232,0.909090909,0.97979798,318
68b8cdf42995ea92279d951547148143fcc4eecf,0,Owen O'Malley,2011-12-12 17:21:56+00:00,['ec13d649820060b4e1171c90abb787d20c32640c'],530,62,592,69521,6,1,1,1,318
8c4d9c4e25ff56fce9be454b703dd3c2a0836493,0,Suhas,2011-12-12 17:28:51+00:00,['68b8cdf42995ea92279d951547148143fcc4eecf'],2,4,6,69527,2,,,,318
a48e07f0550e4ff8c25bbba351dd9e3325f7917c,0,Owen O'Malley,2011-12-12 18:39:29+00:00,['84ce1b38c898b26109c6c5a5beb87c8028b1f94d'],257,7,264,69829,2,,,,318
806244f90845838be38fbae9937c8926c1374e39,0,Owen O'Malley,2011-12-12 18:49:22+00:00,['a48e07f0550e4ff8c25bbba351dd9e3325f7917c'],15,0,15,69844,1,0,0,0,318
78836231b79a42008a361ac42b1843b116954692,1,Owen O'Malley,2011-12-13 01:03:18+00:00,['806244f90845838be38fbae9937c8926c1374e39'],625,151,776,70620,4,1,1,1,318
6ef963e87d688a45be9462433fc2e3dc365bb41d,1,Owen O'Malley,2011-12-13 01:03:55+00:00,['78836231b79a42008a361ac42b1843b116954692'],0,29,29,70649,1,,,,319
47402b8f76e5a1d9517522677bcbe51ae78127dc,1,Devaraj Das,2011-12-13 19:00:58+00:00,['6ef963e87d688a45be9462433fc2e3dc365bb41d'],61,154,215,70864,11,0.16,0.826666667,0.04,319
661a91d54e0abe3c66f03968e5561b0fb9462ccc,0,Devaraj Das,2011-12-13 19:45:15+00:00,['47402b8f76e5a1d9517522677bcbe51ae78127dc'],6,0,6,70870,1,0,0,0,319
42ece5096ff25f45a0382866c046b5309cfdb237,0,Devaraj Das,2011-12-13 22:49:13+00:00,['661a91d54e0abe3c66f03968e5561b0fb9462ccc'],8,12,20,70890,2,0,1,1,319
83122448290c2fcf23eabd20ecf9576e7a226ae2,1,Owen O'Malley,2011-12-13 23:06:51+00:00,['42ece5096ff25f45a0382866c046b5309cfdb237'],64,109,173,71063,6,,,,320
ae4860031ade04714b09d5cf8116682b5ef2d2de,0,Devaraj Das,2011-12-14 00:16:23+00:00,['83122448290c2fcf23eabd20ecf9576e7a226ae2'],3,4,7,71070,3,0,1,1,320
57d504760d1c1ef95a6cd3aff55b35a50f934b87,0,Suhas,2011-12-14 00:34:24+00:00,['ae4860031ade04714b09d5cf8116682b5ef2d2de'],106,36,142,71212,13,0.375,0,1,320
03b678ac0a8f8c2416e5ede800ac169993cc1be5,0,Devaraj Das,2011-12-14 01:57:51+00:00,['57d504760d1c1ef95a6cd3aff55b35a50f934b87'],8,10,18,71230,5,0.5,0,0,320
3bc9e0cdbc30c0a212c60baf304567e866e6dfdc,1,Suhas,2011-12-14 02:50:11+00:00,['03b678ac0a8f8c2416e5ede800ac169993cc1be5'],0,333,333,71563,10,,,,329
f6a3ce26655778fa93cca15a063d6a1683a3be08,1,Suhas,2011-12-14 07:02:26+00:00,['3bc9e0cdbc30c0a212c60baf304567e866e6dfdc'],5,11,16,71579,2,,,,329
61075de18a9bdd6850d0c6f890cc6bbe47613dc5,0,Suhas,2011-12-14 07:05:06+00:00,['f6a3ce26655778fa93cca15a063d6a1683a3be08'],2,2,4,71583,1,,,,329
03947c98a0b41f42e69d8037e23248bdd70d60b9,0,Eric Yang,2011-12-14 07:21:28+00:00,['61075de18a9bdd6850d0c6f890cc6bbe47613dc5'],1,6,7,71590,2,1,1,1,329
4a27bfd2e8b01534e9730b7da449fe89f0d015f1,1,Devaraj Das,2011-12-14 07:38:52+00:00,['03947c98a0b41f42e69d8037e23248bdd70d60b9'],0,1,1,71591,1,0,1,1,329
3064529c17b2d8bed8f2b37393931844591946b6,0,Devaraj Das,2011-12-14 23:58:08+00:00,['4a27bfd2e8b01534e9730b7da449fe89f0d015f1'],13,12,25,71616,3,1,0,0,329
36042258d8e1e13d119e5174613c92dea99bcece,1,Devaraj Das,2011-12-15 00:00:28+00:00,['3064529c17b2d8bed8f2b37393931844591946b6'],12,13,25,71641,3,0,1,1,329
ae04b7ea3e063078fcccefebe7504939bdac6a30,0,Devaraj Das,2011-12-15 00:01:49+00:00,['36042258d8e1e13d119e5174613c92dea99bcece'],3,3,6,71647,1,1,0,0,329
ccc6e83f464cb8aa9168e2824924f13413bbbfed,0,Devaraj Das,2011-12-15 00:04:15+00:00,['ae04b7ea3e063078fcccefebe7504939bdac6a30'],10,9,19,71666,2,1,0,0,329
c748a86e773c4d6f8a99cc91240859d03a0889bf,0,Devaraj Das,2011-12-15 00:15:55+00:00,['ccc6e83f464cb8aa9168e2824924f13413bbbfed'],1,0,1,71667,1,1,0,0,329
6b41afa89a844a026179e5311d8e7b17db4e5fa6,0,Suhas,2011-12-16 00:29:54+00:00,['c748a86e773c4d6f8a99cc91240859d03a0889bf'],24,33,57,71724,4,1,1,1,329
4a3310438db089ac351d14871e58a111eb977545,0,Owen O'Malley,2011-12-17 00:15:18+00:00,['6b41afa89a844a026179e5311d8e7b17db4e5fa6'],28,20,48,71772,5,,,,329
0489b64f788784e47c85138feac46739e9d5e5c0,0,Owen O'Malley,2011-12-17 00:16:47+00:00,['4a3310438db089ac351d14871e58a111eb977545'],0,47,47,71819,1,,,,330
2591530de6fc5d97239bb78b870fe5f53a623dac,0,Owen O'Malley,2011-12-17 00:18:40+00:00,['0489b64f788784e47c85138feac46739e9d5e5c0'],47,0,47,71866,1,,,,330
808b59728dca18d311c121e45d1bb152ba891792,0,Devaraj Das,2011-12-17 01:29:26+00:00,['2591530de6fc5d97239bb78b870fe5f53a623dac'],24,13,37,71903,1,,,,330
9c5788b46745cca3ee1eab9958e98700ca27c9ec,0,Devaraj Das,2011-12-17 01:54:43+00:00,['808b59728dca18d311c121e45d1bb152ba891792'],11,18,29,71932,4,0.5,1,0,330
87a5056c97c27ef357c5e398ccc8cc785b4e8876,0,Devaraj Das,2011-12-18 04:54:32+00:00,['9c5788b46745cca3ee1eab9958e98700ca27c9ec'],5,30,35,71967,3,0,0.045454545,1,330
14c8080f8ad9670c82dd19e7ce5c98aa1bd00244,1,Suhas,2011-12-19 00:16:38+00:00,['87a5056c97c27ef357c5e398ccc8cc785b4e8876'],16,71,87,72054,2,,,,330
040ba7328ad0677d3652584d196dc2539159b9d4,0,Devaraj Das,2011-12-19 00:47:36+00:00,['14c8080f8ad9670c82dd19e7ce5c98aa1bd00244'],96,366,462,72516,12,0.830188679,1,0.820754717,334
52ac19ab90e41bcdafd327cf8fd7da38a6ce00a8,1,Suhas,2011-12-20 18:43:24+00:00,['040ba7328ad0677d3652584d196dc2539159b9d4'],1,14,15,72531,2,,,,334
1a91355802e6c85a157e00f58e8dab9814a286dd,0,Suhas,2011-12-20 19:04:44+00:00,['52ac19ab90e41bcdafd327cf8fd7da38a6ce00a8'],1,3,4,72535,2,,,,334
636912274905f316cb73e39192c033931877ce0e,1,Devaraj Das,2011-12-20 22:51:56+00:00,['1a91355802e6c85a157e00f58e8dab9814a286dd'],25,57,82,72617,3,0.739130435,0,0.739130435,334
48b676ed2383b67ccede6f55f078d41f87684e17,0,Devaraj Das,2011-12-21 00:43:07+00:00,['636912274905f316cb73e39192c033931877ce0e'],2,5,7,72624,2,0,1,1,334
d86b52bed8894a6384a04d6bc981e524c1df49f8,0,Devaraj Das,2011-12-21 01:20:37+00:00,['48b676ed2383b67ccede6f55f078d41f87684e17'],0,4,4,72628,1,1,1,0.5,334
c31187c4e89a3573eb1b8f73d7ea595e034cfed9,0,Devaraj Das,2011-12-21 01:21:42+00:00,['d86b52bed8894a6384a04d6bc981e524c1df49f8'],0,2,2,72630,1,,,,334
ed16f76180b9e0d5470e941896614b291f8553fc,1,Suhas,2011-12-21 02:46:52+00:00,['c31187c4e89a3573eb1b8f73d7ea595e034cfed9'],30,28,58,72688,9,0,,,334
c8a1171cfa10e271adad5732bf7d6b058273777e,1,Suhas,2011-12-21 18:33:23+00:00,['ed16f76180b9e0d5470e941896614b291f8553fc'],0,3,3,72691,1,1,1,1,334
554c119bf79d84eac7ef402d9123e4e900c7e9a3,0,Suhas,2011-12-21 22:58:58+00:00,['c8a1171cfa10e271adad5732bf7d6b058273777e'],17,60,77,72768,3,1,1,1,334
d2fb284f3952790bb55ff3cab1a1d23bfe59ff82,0,Suhas,2011-12-21 23:12:58+00:00,['554c119bf79d84eac7ef402d9123e4e900c7e9a3'],0,10,10,72778,1,1,1,1,334
2d5ca4079452b056a6c48a90b0860736c3770549,0,Suhas,2011-12-22 00:36:40+00:00,['d2fb284f3952790bb55ff3cab1a1d23bfe59ff82'],0,12,12,72790,1,0,0,1,334
e1eeeab3716c2d59c5857b1c0625cc1fbbe1df8a,1,Devaraj Das,2011-12-22 02:22:06+00:00,['2d5ca4079452b056a6c48a90b0860736c3770549'],13,115,128,72918,5,0.026315789,0.381578947,1,334
a83292d141cc2f1e1a2b3bb6f0ed5cd6e29a9cdb,0,Suhas,2011-12-22 02:29:28+00:00,['e1eeeab3716c2d59c5857b1c0625cc1fbbe1df8a'],6,4,10,72928,2,1,1,1,334
42944ec04bf819f62a97de4e77285bd4b00b0b58,0,Devaraj Das,2011-12-22 05:39:12+00:00,['a83292d141cc2f1e1a2b3bb6f0ed5cd6e29a9cdb'],2,6,8,72936,1,0,1,1,334
077449984fb7f2b55c5c3c2dd3060814ca378796,0,Suhas,2011-12-23 02:35:54+00:00,['42944ec04bf819f62a97de4e77285bd4b00b0b58'],25,150,175,73111,9,1,1,1,335
ba45bf89455333cdf6cdd4cbef1fd8a5db47f718,0,Eric Yang,2011-12-23 06:39:18+00:00,['077449984fb7f2b55c5c3c2dd3060814ca378796'],1,5,6,73117,3,,,,335
ef33728c18bb21b84662383397de3d647964c17a,1,Devaraj Das,2011-12-25 18:14:11+00:00,['ba45bf89455333cdf6cdd4cbef1fd8a5db47f718'],18,295,313,73430,8,0.485714286,0.502857143,1,335
926307473bff1d6fa32fa41f14a37b084a93403c,0,Devaraj Das,2011-12-26 08:49:50+00:00,['ef33728c18bb21b84662383397de3d647964c17a'],24,10,34,73464,4,0.916666667,0.916666667,0.25,335
59ca0d93dadd0b413668001a7f67367c1f635b7f,0,Devaraj Das,2011-12-26 09:00:04+00:00,['926307473bff1d6fa32fa41f14a37b084a93403c'],0,4,4,73468,1,1,0,1,335
71e2fde25eabc4e076a732dcb47a7222baf5380d,0,Devaraj Das,2011-12-27 19:37:22+00:00,['59ca0d93dadd0b413668001a7f67367c1f635b7f'],0,1,1,73469,1,1,0,1,335
b5712e8297ec7616f9f84b239621f9899e9adb7d,1,Devaraj Das,2011-12-27 19:51:10+00:00,['71e2fde25eabc4e076a732dcb47a7222baf5380d'],0,40,40,73509,2,,,,336
ef73016c7002e6185746c06029941e15c5bc49f0,0,Devaraj Das,2011-12-27 22:01:50+00:00,['b5712e8297ec7616f9f84b239621f9899e9adb7d'],1,2,3,73512,1,1,1,1,336
57118e509a411777bf41373734fdafd03f8fc5f1,1,Suhas,2011-12-28 22:46:40+00:00,['ef73016c7002e6185746c06029941e15c5bc49f0'],105,689,794,74306,11,0.717647059,0.188235294,0.988235294,338
ded8e046de8652a2c2261f3ea5927ea2178f5c38,1,Suhas,2011-12-28 23:20:15+00:00,['57118e509a411777bf41373734fdafd03f8fc5f1'],16,16,32,74338,1,,,,338
6764c8ec06322a589892f63fa5db7a40b95c25aa,0,Suhas,2011-12-28 23:42:07+00:00,['ded8e046de8652a2c2261f3ea5927ea2178f5c38'],0,11,11,74349,2,0,1,1,338
860e39505d1b8f462c2b172a6d085112d1e46fc2,0,Suhas,2011-12-30 03:42:51+00:00,['6764c8ec06322a589892f63fa5db7a40b95c25aa'],50,69,119,74468,5,0,0,1,339
ff8b8f689ab21828191485e6787280e1a62356a2,0,Suhas,2011-12-30 03:59:34+00:00,['860e39505d1b8f462c2b172a6d085112d1e46fc2'],10,19,29,74497,1,0,0,1,339
47c4b0b07c916c485598eb92cf21863e39e204ec,0,Devaraj Das,2011-12-31 17:06:27+00:00,['ff8b8f689ab21828191485e6787280e1a62356a2'],41,185,226,74723,6,0.491071429,0.892857143,1,339
def50e6eab38bf6cc1f9403dbb47f93723f78764,0,Devaraj Das,2011-12-31 18:40:57+00:00,['47c4b0b07c916c485598eb92cf21863e39e204ec'],0,1,1,74724,1,0,1,0,339
8daee776cae144ab3441f243393b157f88d89cb9,0,Devaraj Das,2011-12-31 19:16:04+00:00,['def50e6eab38bf6cc1f9403dbb47f93723f78764'],3,5,8,74732,1,0,0,1,339
0efe0ff7835f854c67bfa4cb5f3bcbd18730602d,0,Suhas,2012-01-03 23:39:48+00:00,['8daee776cae144ab3441f243393b157f88d89cb9'],38,2,40,74772,2,,,,339
f014d3b6dbaf4c7cc7c73c6f07d2301f7da1f507,0,Suhas,2012-01-04 01:43:23+00:00,['0efe0ff7835f854c67bfa4cb5f3bcbd18730602d'],7,39,46,74818,5,0,1,0.933333333,339
94d23deafb4314a089f538f096faf15867f7d023,0,Devaraj Das,2012-01-04 02:34:56+00:00,['f014d3b6dbaf4c7cc7c73c6f07d2301f7da1f507'],3,13,16,74834,1,0,0,1,339
c89e8e1be1fd6ae2688bb028cd1d2393f61a2fa3,0,Devaraj Das,2012-01-05 06:38:11+00:00,['94d23deafb4314a089f538f096faf15867f7d023'],22,28,50,74884,4,0,0,1,339
0c25fd1f54781967c1927761530738fbb9d5f326,0,Suhas,2012-01-05 19:03:58+00:00,['c89e8e1be1fd6ae2688bb028cd1d2393f61a2fa3'],1,1,2,74886,1,0,0,0,339
d401135745dbe7625746fc7deafb2ecc2f6b18aa,0,Suhas,2012-01-05 19:53:24+00:00,['0c25fd1f54781967c1927761530738fbb9d5f326'],0,11,11,74897,2,0,0,1,339
a61cce648bad7ef97ce5c8bd61dd0be13a321f72,0,Suhas,2012-01-06 01:03:42+00:00,['d401135745dbe7625746fc7deafb2ecc2f6b18aa'],53,95,148,75045,9,0,0.428571429,0.828571429,339
f6e531a1a0a8b942556c2d736be6d08bd365fb69,1,Suhas,2012-05-08 20:34:08+00:00,[],0,507565,507565,582610,2189,0.401839989,0.599250748,0.857017003,2528
f83723dd8318199183a5bfb79d1b634a24bc0a28,1,Suhas,2012-05-08 20:57:47+00:00,['f6e531a1a0a8b942556c2d736be6d08bd365fb69'],1,1,2,582612,1,,,,2528
e7a051c86eb99273b097854f6d0ef54e7d5d0722,0,Owen O'Malley,2012-05-08 23:02:52+00:00,['f83723dd8318199183a5bfb79d1b634a24bc0a28'],0,0,0,582612,0,,,,2528
35946d3e2a793c81bef87e804c90b0a4a1d775f2,0,Suhas,2012-05-09 00:17:28+00:00,['e7a051c86eb99273b097854f6d0ef54e7d5d0722'],3,10,13,582625,2,0,0,0,2529
1b823401111c87add42fa2dd9be9b09c40f103b7,0,Suhas,2012-05-09 00:24:34+00:00,['35946d3e2a793c81bef87e804c90b0a4a1d775f2'],1,5,6,582631,2,0,1,1,2529
675fd6276b975bf2bac61d238c9d6a652de691dc,1,Suhas,2012-05-09 00:27:27+00:00,['1b823401111c87add42fa2dd9be9b09c40f103b7'],10,58,68,582699,3,0.166666667,1,1,2529
206e7fbded35c53602a2fcdb93d85c6d3b6997ad,1,Suhas,2012-05-09 05:24:47+00:00,['675fd6276b975bf2bac61d238c9d6a652de691dc'],0,9,9,582708,3,1,1,1,2529
d04b038c43332e4b44809fdadf0ced1672d49bad,1,Suhas,2012-05-09 05:30:02+00:00,['206e7fbded35c53602a2fcdb93d85c6d3b6997ad'],1,5,6,582714,2,1,1,0,2529
a86f6dc8e8a43d92c8053ec7055f99658140993a,1,Suhas,2012-05-09 05:34:26+00:00,['d04b038c43332e4b44809fdadf0ced1672d49bad'],1,3,4,582718,2,,,,2529
2d8fbcef9888592172fea12ebdd758129c4d10cd,1,Suhas,2012-05-09 05:58:35+00:00,['a86f6dc8e8a43d92c8053ec7055f99658140993a'],5,19,24,582742,3,,,,2529
88df1608c76c921fac530ed17e315c53e7e4e0cd,0,Suhas,2012-05-09 06:02:28+00:00,['2d8fbcef9888592172fea12ebdd758129c4d10cd'],1,13,14,582756,2,,,,2529
76818790c2fcae43332d005bb503371a11b18b5e,1,Suhas,2012-05-09 22:16:59+00:00,['88df1608c76c921fac530ed17e315c53e7e4e0cd'],0,6,6,582762,2,0.333333333,1,1,2529
e684d29d89521717d9525dba046fab0fa5bc86dd,0,Suhas,2012-05-09 22:19:48+00:00,['76818790c2fcae43332d005bb503371a11b18b5e'],1,2,3,582765,2,1,0,0,2529
b0fcd514540dd5816837a89d7afa6796ee26847b,1,Suhas,2012-05-09 22:31:53+00:00,['e684d29d89521717d9525dba046fab0fa5bc86dd'],19,71,90,582855,4,,,,2529
a58be3bf06d0d5d9f8aef8336f824bc15b395077,0,Suhas,2012-05-09 22:41:00+00:00,['b0fcd514540dd5816837a89d7afa6796ee26847b'],0,20,20,582875,1,,,,2530
3b54b194a1e64b34b55c5393fc47e5f54c63e10c,0,Suhas,2012-05-09 22:43:56+00:00,['a58be3bf06d0d5d9f8aef8336f824bc15b395077'],63,73,136,583011,4,1,1,1,2530
1abb56dab61880082e740794c1a24d7eef6461db,1,Suhas,2012-05-09 22:46:24+00:00,['3b54b194a1e64b34b55c5393fc47e5f54c63e10c'],2,8,10,583021,2,,,,2530
d877bfe61275c737796fceb906d906e205fde398,0,Owen O'Malley,2012-05-11 14:29:10+00:00,['1abb56dab61880082e740794c1a24d7eef6461db'],15,17,32,583053,1,,,,2530
b954f762a843485d787b6c28c15158d6ed74c54f,1,Owen O'Malley,2012-05-11 14:35:13+00:00,['d877bfe61275c737796fceb906d906e205fde398'],2,4,6,583059,2,,,,2530
f2e7dbca366b77c3098623f2bf8708786cc6201e,1,Owen O'Malley,2012-05-11 14:40:05+00:00,['b954f762a843485d787b6c28c15158d6ed74c54f'],22,69,91,583150,3,0,0,0,2530
bf41a0e5e436575a7ec454be201ec11972497076,1,Owen O'Malley,2012-05-11 14:43:29+00:00,['f2e7dbca366b77c3098623f2bf8708786cc6201e'],7,4,11,583161,3,1,0,0,2530
e06d20485976ab0526d0cfbba11e0be0259528af,0,Owen O'Malley,2012-05-11 14:56:34+00:00,['bf41a0e5e436575a7ec454be201ec11972497076'],0,3,3,583164,2,,,,2530
de7b88d895b354722249ac251e344554ee1706ca,0,Owen O'Malley,2012-05-11 14:58:45+00:00,['e06d20485976ab0526d0cfbba11e0be0259528af'],1,37,38,583202,3,1,1,1,2530
4195d076adcb5aa2271934e307b72b9782e6c538,1,Owen O'Malley,2012-05-11 15:41:53+00:00,['de7b88d895b354722249ac251e344554ee1706ca'],3,7,10,583212,2,1,1,1,2530
4812b342ccdbf9a9de88fc3011cf6409771b7459,0,Owen O'Malley,2012-05-11 15:42:22+00:00,['4195d076adcb5aa2271934e307b72b9782e6c538'],1,1,2,583214,1,,,,2530
e6fa6fcf13bc6220295b167a593ea733673670a3,1,Owen O'Malley,2012-05-11 15:47:29+00:00,['4812b342ccdbf9a9de88fc3011cf6409771b7459'],6,8,14,583228,5,,,,2530
4149d3b64b2779d1e01c0d98635a852fb62af40b,0,Owen O'Malley,2012-05-11 15:55:15+00:00,['e6fa6fcf13bc6220295b167a593ea733673670a3'],1,3,4,583232,2,1,1,0,2530
7752492660dc92e0e18f02410c95ffabda7ab2be,1,Owen O'Malley,2012-05-11 15:58:36+00:00,['4149d3b64b2779d1e01c0d98635a852fb62af40b'],2,27,29,583261,5,,,,2530
2cae166ec2f01930227991e4cf6000ed83fac451,1,Owen O'Malley,2012-05-11 16:01:01+00:00,['7752492660dc92e0e18f02410c95ffabda7ab2be'],40,21,61,583322,9,0.833333333,0.833333333,0.888888889,2530
9c01dff0c3a29ca0122270950816bc34df9401a7,1,Owen O'Malley,2012-05-11 16:02:46+00:00,['2cae166ec2f01930227991e4cf6000ed83fac451'],1,3,4,583326,2,,,,2530
f3affe1ee16721c37f99e1717f9eb771f7a31358,0,Owen O'Malley,2012-05-11 16:05:40+00:00,['9c01dff0c3a29ca0122270950816bc34df9401a7'],2,7,9,583335,3,0.5,0,0,2530
e9d11d47ff36f2710c41ee8ceefaf2e6534f83cd,1,Owen O'Malley,2012-05-11 16:11:38+00:00,['f3affe1ee16721c37f99e1717f9eb771f7a31358'],1,7,8,583343,2,0,0,1,2530
23d95e882c8f9b1424c76aa15116b70fffe69178,1,Suhas,2012-05-15 00:53:27+00:00,['e9d11d47ff36f2710c41ee8ceefaf2e6534f83cd'],4,10,14,583357,5,0,0,1,2530
9c316520087e5f4db30bd71f075f338175f5aab4,0,Suhas,2012-05-15 01:06:38+00:00,['23d95e882c8f9b1424c76aa15116b70fffe69178'],9,27,36,583393,3,,,,2530
97a9d88caec1c89b3edeaf47638d79ef9cc88ff3,1,Suhas,2012-05-15 01:10:46+00:00,['9c316520087e5f4db30bd71f075f338175f5aab4'],42,44,86,583479,3,,,,2530
74a92b433d933db3eab75c8a6d09cdad49ca8720,1,Suhas,2012-05-15 02:17:26+00:00,['97a9d88caec1c89b3edeaf47638d79ef9cc88ff3'],8,4,12,583491,2,,,,2530
2c55a0433beb1008dc662421d52cdf401a4d4305,1,Suhas,2012-05-15 02:19:47+00:00,['74a92b433d933db3eab75c8a6d09cdad49ca8720'],2,4,6,583497,2,,,,2530
09be642e47a5ece9dd47a5381f9d263d856d2964,0,Suhas,2012-05-15 02:22:40+00:00,['2c55a0433beb1008dc662421d52cdf401a4d4305'],3,5,8,583505,2,,,,2530
a56ba00c9e205ea2d5b7392344cbe684691640c2,1,Suhas,2012-05-15 02:26:24+00:00,['09be642e47a5ece9dd47a5381f9d263d856d2964'],3,17,20,583525,3,,,,2530
85a0304d3a81203084e935f2498f2bcfca892114,1,Suhas,2012-05-15 02:29:58+00:00,['a56ba00c9e205ea2d5b7392344cbe684691640c2'],4,6,10,583535,3,,,,2530
1340d255790285cf860adfb8195e12c70daf4bc4,0,Suhas,2012-05-15 02:34:10+00:00,['85a0304d3a81203084e935f2498f2bcfca892114'],1,2,3,583538,2,,,,2530
d315747dcbc651e3422bd1fac135552620bf208e,1,Suhas,2012-05-15 02:37:17+00:00,['1340d255790285cf860adfb8195e12c70daf4bc4'],17,33,50,583588,4,,,,2530
5a52482de2654a4437b48c2a1a0525ad601d7ec6,1,Suhas,2012-05-15 02:40:45+00:00,['d315747dcbc651e3422bd1fac135552620bf208e'],43,62,105,583693,9,,,,2530
fff3ab491f2991040ac5a4d36d459f58fa5b0aee,1,Suhas,2012-05-15 02:44:48+00:00,['5a52482de2654a4437b48c2a1a0525ad601d7ec6'],4,21,25,583718,3,0,0,1,2530
fb8cfbcffb8f11dd97ee8d99ef08bb0b50eb3175,1,Suhas,2012-05-15 03:01:43+00:00,['fff3ab491f2991040ac5a4d36d459f58fa5b0aee'],17,51,68,583786,11,1,1,1,2530
cd25d308e64982dd2a33426745b51f48ae9694ed,1,Suhas,2012-05-15 03:04:39+00:00,['fb8cfbcffb8f11dd97ee8d99ef08bb0b50eb3175'],2,4,6,583792,2,,,,2530
61ea099ffd2add733105a19ae83a769e361d9e96,0,Suhas,2012-05-15 03:08:46+00:00,['cd25d308e64982dd2a33426745b51f48ae9694ed'],1,1,2,583794,1,1,1,0,2530
4a669573b9282499aa6de95d775557a72c945f00,1,Suhas,2012-05-15 03:11:21+00:00,['61ea099ffd2add733105a19ae83a769e361d9e96'],9,13,22,583816,4,,,,2530
e02c2a06397b8cfade57326a74ffb7610cd27d8b,1,Suhas,2012-05-15 03:14:52+00:00,['4a669573b9282499aa6de95d775557a72c945f00'],1,3,4,583820,2,,,,2530
3e1cf496915dbd3b6252d3332a6e0a4101c922dd,0,Owen O'Malley,2012-05-15 15:42:16+00:00,['e02c2a06397b8cfade57326a74ffb7610cd27d8b'],13,22,35,583855,1,,,,2530
12366a13fcc55b82933b5a137a23c44ff3e80a0b,1,Jitendra Nath Pandey,2012-05-16 06:35:41+00:00,['3e1cf496915dbd3b6252d3332a6e0a4101c922dd'],135,96,231,584086,2,0.333333333,0,0,2530
14c4d31fb1c404eed807f133f845340b768636b3,0,Jitendra Nath Pandey,2012-05-16 07:12:20+00:00,['12366a13fcc55b82933b5a137a23c44ff3e80a0b'],0,2,2,584088,1,,,,2530
ac9cc4fd8ca12b2fefc7f857e6f6ccaad69295d6,0,Suhas,2012-05-16 21:08:01+00:00,['14c4d31fb1c404eed807f133f845340b768636b3'],137,137,274,584362,1,,,,2530
5ada2d6f74ea32476d5984ef1344b45b6a133180,0,Suhas,2012-05-16 21:26:47+00:00,['ac9cc4fd8ca12b2fefc7f857e6f6ccaad69295d6'],137,137,274,584636,1,,,,2530
794457835a4544a2489f19e3f3d4279397e58e07,1,Suhas,2012-05-16 21:52:30+00:00,['5ada2d6f74ea32476d5984ef1344b45b6a133180'],177,229,406,585042,4,0,0,1,2530
c751b3149d8e2007023890c52fb398f3629da0c8,0,Jitendra Nath Pandey,2012-05-17 02:22:00+00:00,['794457835a4544a2489f19e3f3d4279397e58e07'],0,16,16,585058,2,0.272727273,1,1,2530
7d32f0d26857765527192618d6d5ef9219e05b47,0,Jitendra Nath Pandey,2012-05-17 02:28:39+00:00,['c751b3149d8e2007023890c52fb398f3629da0c8'],16,0,16,585074,2,0.727272727,0,0,2530
93d9201ce9129a839041fdf52796b854af375508,0,Jitendra Nath Pandey,2012-05-17 02:30:17+00:00,['7d32f0d26857765527192618d6d5ef9219e05b47'],1,5,6,585080,2,,,,2530
43167e0433b7a7b696ecb15403b7014abcab8e85,1,Jitendra Nath Pandey,2012-05-17 02:34:05+00:00,['93d9201ce9129a839041fdf52796b854af375508'],5,7,12,585092,6,,,,2530
9979c20d872514d4e6ed430891ae07c940c6bd0c,0,Jitendra Nath Pandey,2012-05-17 02:37:54+00:00,['43167e0433b7a7b696ecb15403b7014abcab8e85'],24,3,27,585119,4,,,,2530
380f36b83987c01429a30421c14c6fee01605b82,1,Jitendra Nath Pandey,2012-05-17 02:43:13+00:00,['9979c20d872514d4e6ed430891ae07c940c6bd0c'],114,49,163,585282,7,,,,2532
ece37a8be240812a08b1ad7ff65b707454b373bb,0,Jitendra Nath Pandey,2012-05-17 02:45:34+00:00,['380f36b83987c01429a30421c14c6fee01605b82'],0,7,7,585289,3,,,,2532
214445873f969f619b206b503832d85ddad6742e,0,Jitendra Nath Pandey,2012-05-17 02:51:51+00:00,['ece37a8be240812a08b1ad7ff65b707454b373bb'],0,3,3,585292,2,,,,2532
5c168090bf4c39581760de606e005105571a5eda,1,Jitendra Nath Pandey,2012-05-17 02:54:27+00:00,['214445873f969f619b206b503832d85ddad6742e'],0,4,4,585296,3,,,,2532
74226dd5795b3ca3403fd0c870de0c41823f1575,0,Jitendra Nath Pandey,2012-05-17 02:57:18+00:00,['5c168090bf4c39581760de606e005105571a5eda'],1,3,4,585300,2,,,,2532
4eb9ce648ebbea641bae1a4d224ca8a1cecbddbe,1,Jitendra Nath Pandey,2012-05-17 03:01:21+00:00,['74226dd5795b3ca3403fd0c870de0c41823f1575'],22,45,67,585367,6,0,0.941176471,0.941176471,2532
acd23d1aed3b3d4a4de187157755d782b34f784b,0,Owen O'Malley,2012-05-17 15:40:50+00:00,['4eb9ce648ebbea641bae1a4d224ca8a1cecbddbe'],10,14,24,585391,1,,,,2532
add092999ed8448b728d6d63cbf4c848967ea348,1,Ramya Sunil,2012-05-17 15:50:26+00:00,['acd23d1aed3b3d4a4de187157755d782b34f784b'],242,5254,5496,590887,20,0.991071429,0.7875,0.869642857,2536
daab831afad5079be88e236f9884cd2cca0a3ea3,0,Ramya Sunil,2012-05-17 16:01:33+00:00,['add092999ed8448b728d6d63cbf4c848967ea348'],0,3,3,590890,16,,,,2536
9544e8be4f8625e07dfb5488a33b5a6028feab39,1,Ramya Sunil,2012-05-17 16:47:51+00:00,['daab831afad5079be88e236f9884cd2cca0a3ea3'],0,5,5,590895,2,1,1,1,2536
61b001c26ef16ffac03c7748cb7ba7fb46d02a78,1,Ramya Sunil,2012-05-17 16:54:41+00:00,['9544e8be4f8625e07dfb5488a33b5a6028feab39'],37,9,46,590941,6,,,,2536
44ebd793a575218b1d2104aa0c9acc5a3d52bc5e,1,Ramya Sunil,2012-05-17 16:58:16+00:00,['61b001c26ef16ffac03c7748cb7ba7fb46d02a78'],2,5,7,590948,3,,,,2536
656905fe511ec438f41662de4c89626202bf13b2,0,Ramya Sunil,2012-05-17 17:07:55+00:00,['44ebd793a575218b1d2104aa0c9acc5a3d52bc5e'],0,0,0,590948,2,,,,2538
a93985fc4a3a72753787c8680196216dcd09e73e,0,Ramya Sunil,2012-05-17 17:10:51+00:00,['656905fe511ec438f41662de4c89626202bf13b2'],0,8,8,590956,2,1,1,1,2538
563388fad4a31b722fb3f8ebf8fd226908c0b415,1,Ramya Sunil,2012-05-17 17:13:17+00:00,['a93985fc4a3a72753787c8680196216dcd09e73e'],1,17,18,590974,2,1,1,1,2538
576f0e1e7a4c3e84dbec02a54af9ba7360a7cc3b,0,Ramya Sunil,2012-05-17 17:22:02+00:00,['563388fad4a31b722fb3f8ebf8fd226908c0b415'],3,3,6,590980,2,0,1,1,2538
9da6c8371131966dc23ee2b73e1015ce9f16f1ee,1,Ramya Sunil,2012-05-17 17:24:41+00:00,['576f0e1e7a4c3e84dbec02a54af9ba7360a7cc3b'],14,8,22,591002,4,,,,2538
ddea474efe5b5132a3505715d6147487191921e7,1,Ramya Sunil,2012-05-17 17:27:05+00:00,['9da6c8371131966dc23ee2b73e1015ce9f16f1ee'],1,62,63,591065,3,1,1,1,2539
e807fa1eddeecc5f3ee37a25c0c09b45db118edb,0,Ramya Sunil,2012-05-17 17:35:36+00:00,['ddea474efe5b5132a3505715d6147487191921e7'],0,125,125,591190,2,1,1,0.117647059,2540
328dd9cd0dd904363db31cce709bbfdb74445f94,1,Ramya Sunil,2012-05-17 17:36:35+00:00,['e807fa1eddeecc5f3ee37a25c0c09b45db118edb'],22,79,101,591291,5,0,0,1,2540
f8e37bb55534da1de219d8cfb6fd1ec76e0aab46,1,Ramya Sunil,2012-05-17 17:39:09+00:00,['328dd9cd0dd904363db31cce709bbfdb74445f94'],80,288,368,591659,26,,,,2540
053e7138255efeb925f2b623dd61009905986570,0,Ramya Sunil,2012-05-17 17:41:17+00:00,['f8e37bb55534da1de219d8cfb6fd1ec76e0aab46'],1,5,6,591665,2,,,,2540
ca04361f7c4fd43fb673c894ad660b57f621d259,1,Ramya Sunil,2012-05-17 17:44:22+00:00,['053e7138255efeb925f2b623dd61009905986570'],0,4,4,591669,3,,,,2540
1362a071af04e088d72bcd456e9a9b7a5dd3b8d6,1,Ramya Sunil,2012-05-17 17:46:40+00:00,['ca04361f7c4fd43fb673c894ad660b57f621d259'],3,15,18,591687,4,0,1,0.25,2540
88bebffc608449e2b70693463d1ff407e7e9880f,1,Ramya Sunil,2012-05-17 17:47:58+00:00,['1362a071af04e088d72bcd456e9a9b7a5dd3b8d6'],41,1913,1954,593641,10,,,,2546
a477a62bedee3fe0583ed4635feb004351d3e232,0,Ramya Sunil,2012-05-17 17:48:52+00:00,['88bebffc608449e2b70693463d1ff407e7e9880f'],0,1,1,593642,1,,,,2546
b764efbedf64823646b621f7dfadd092f7c455df,1,Ramya Sunil,2012-05-17 17:51:33+00:00,['a477a62bedee3fe0583ed4635feb004351d3e232'],18,41,59,593701,7,0,0.5,0.5,2546
ed129e3c2fe4ce416ffc88393619b7a54fb0ad74,1,Ramya Sunil,2012-05-17 18:05:37+00:00,['b764efbedf64823646b621f7dfadd092f7c455df'],24,27,51,593752,7,0,1,1,2546
4d7eb0150cd02f51fecb5cc2ea3aa7fb483a632d,1,Ramya Sunil,2012-05-17 18:08:04+00:00,['ed129e3c2fe4ce416ffc88393619b7a54fb0ad74'],1,16,17,593769,2,0,0,1,2546
25380645615142b2627ee1a4dd9962e512480e2c,1,Ramya Sunil,2012-05-17 18:09:52+00:00,['4d7eb0150cd02f51fecb5cc2ea3aa7fb483a632d'],2,9,11,593780,3,,,,2546
7daa0b2ac7ee44d0efb1daf25ba6f7f29eed82b6,1,Ramya Sunil,2012-05-17 18:12:05+00:00,['25380645615142b2627ee1a4dd9962e512480e2c'],3,10,13,593793,2,0,0,1,2546
9a076d5d386f5f8864716d1aa5f2a77c193b8eaf,0,Ramya Sunil,2012-05-17 18:13:51+00:00,['7daa0b2ac7ee44d0efb1daf25ba6f7f29eed82b6'],4,13,17,593810,3,,,,2546
154dd5a3cb3157cfedccfb7647d3f773390d5b7f,1,Ramya Sunil,2012-05-17 18:15:31+00:00,['9a076d5d386f5f8864716d1aa5f2a77c193b8eaf'],0,18,18,593828,4,,,,2546
182f5c6403e507c087444287bc5d6cf0469e6a78,1,Ramya Sunil,2012-05-17 18:19:27+00:00,['154dd5a3cb3157cfedccfb7647d3f773390d5b7f'],1,45,46,593874,3,0,0,1,2546
f28ffe056da756f74bef035dea564804c60f0e8a,0,Ramya Sunil,2012-05-17 18:28:07+00:00,['182f5c6403e507c087444287bc5d6cf0469e6a78'],2353,2,2355,596229,24,0.47008547,0.232478632,0.117948718,2546
58150659490b9f90d06b25cefa03a24388b7f8db,1,Ramya Sunil,2012-05-17 18:57:41+00:00,['f28ffe056da756f74bef035dea564804c60f0e8a'],12,15,27,596256,15,,,,2549
ee003476f36250cf0cfb294a1a481c0fb566dac6,1,Ramya Sunil,2012-05-17 19:55:50+00:00,['58150659490b9f90d06b25cefa03a24388b7f8db'],27,63,90,596346,10,1,1,1,2549
a9daa72a9e62ac93d5c9a36ebe783181eb405705,1,Ramya Sunil,2012-05-17 20:11:02+00:00,['ee003476f36250cf0cfb294a1a481c0fb566dac6'],35,54,89,596435,3,,,,2549
05495ed893b608113065877fc97776167124fdb6,1,Ramya Sunil,2012-05-17 20:13:40+00:00,['a9daa72a9e62ac93d5c9a36ebe783181eb405705'],36,44,80,596515,16,,,,2549
e8bd699f222519c517e498f15ccdc1b88181eb5d,1,Ramya Sunil,2012-05-17 22:03:19+00:00,['05495ed893b608113065877fc97776167124fdb6'],59,452,511,597026,12,0.528089888,0.528089888,0.97752809,2550
9eff2fda2add9b5fe0fa09840766c75594415a95,0,Hitesh Shah,2012-05-18 05:24:50+00:00,['e8bd699f222519c517e498f15ccdc1b88181eb5d'],34,4,38,597064,4,,,,2550
97d82440404de10ed0f1afc0154204c8c9274b7d,0,Hitesh Shah,2012-05-18 05:41:53+00:00,['9eff2fda2add9b5fe0fa09840766c75594415a95'],1,7,8,597072,2,,,,2550
16b63c09525d98d75e1b1159352dba47927b97de,1,Hitesh Shah,2012-05-18 05:52:07+00:00,['97d82440404de10ed0f1afc0154204c8c9274b7d'],0,60,60,597132,3,0.2,0.2,1,2551
572071ecd991e4b940cf83de1bfac7efabcd8504,1,Hitesh Shah,2012-05-18 05:58:36+00:00,['16b63c09525d98d75e1b1159352dba47927b97de'],1,653,654,597786,10,0.488789238,0.730941704,0.995515695,2556
45230232f3afb97c4b511b061c832cd24bb6ce5f,1,Hitesh Shah,2012-05-18 06:05:28+00:00,['572071ecd991e4b940cf83de1bfac7efabcd8504'],108,18,126,597912,7,1,1,1,2557
77cc8c893c34dcd1b9910d446948f96689e25d51,0,Hitesh Shah,2012-05-18 06:07:51+00:00,['45230232f3afb97c4b511b061c832cd24bb6ce5f'],1,5,6,597918,2,,,,2557
05433755f611c1068788a04d43734826cab424dd,1,Hitesh Shah,2012-05-18 06:09:49+00:00,['77cc8c893c34dcd1b9910d446948f96689e25d51'],1,3,4,597922,3,,,,2557
6c678c994f19c7fdc796e3ae034d961341c0c149,1,Hitesh Shah,2012-05-18 06:14:52+00:00,['05433755f611c1068788a04d43734826cab424dd'],2,7,9,597931,2,0,0,1,2557
fc3059e9ca39ad9e90f4ac9554de27f365d381e3,1,Hitesh Shah,2012-05-18 06:18:18+00:00,['6c678c994f19c7fdc796e3ae034d961341c0c149'],0,41,41,597972,5,,,,2557
080cc89585db10f8ab8bb16328106880fb13a395,1,Hitesh Shah,2012-05-18 06:21:52+00:00,['fc3059e9ca39ad9e90f4ac9554de27f365d381e3'],17,19,36,598008,4,,,,2557
451be6421e92fea36374e93728dcf6959ddc1957,1,Hitesh Shah,2012-05-18 06:25:56+00:00,['080cc89585db10f8ab8bb16328106880fb13a395'],2,7,9,598017,4,0.5,0.5,1,2557
4cfd09b6c0ae67f1f6315242244354350863d7a4,1,Owen O'Malley,2012-05-18 16:01:42+00:00,['451be6421e92fea36374e93728dcf6959ddc1957'],23,31,54,598071,1,,,,2557
39977a0ea808e13bfd4834d1ca4c6b6f9a87e5b1,0,Devaraj Das,2012-05-23 22:47:26+00:00,['4cfd09b6c0ae67f1f6315242244354350863d7a4'],1,2,3,598074,1,,,,2557
5c89be9b4e92070600ce3fbaccb82dd14a451366,1,Devaraj Das,2012-05-23 22:47:43+00:00,['39977a0ea808e13bfd4834d1ca4c6b6f9a87e5b1'],1,1,2,598076,1,,,,2557
7272472c30a4c613ef7258bb1c69c5ec816aee99,1,Suhas,2012-05-26 19:10:07+00:00,['5c89be9b4e92070600ce3fbaccb82dd14a451366'],3,5,8,598084,2,,,,2557
3f660ffdeedb53df0a84f5470aea018cede5ba93,1,Suhas,2012-05-26 19:16:02+00:00,['7272472c30a4c613ef7258bb1c69c5ec816aee99'],0,14,14,598098,2,0.272727273,1,1,2557
cba6a3e2f6f7f50ce46dfed89d09cd44129072e8,0,Suhas,2012-05-26 19:20:30+00:00,['3f660ffdeedb53df0a84f5470aea018cede5ba93'],0,12,12,598110,2,0,0,1,2557
fee71071881b3e93bb88d1de9b7a1e04f1b6c123,0,Suhas,2012-05-26 19:26:53+00:00,['cba6a3e2f6f7f50ce46dfed89d09cd44129072e8'],1,3,4,598114,2,,,,2557
d28d53bc76fd5893df700a53563b44b1db25f6e6,1,Suhas,2012-05-27 02:19:31+00:00,['fee71071881b3e93bb88d1de9b7a1e04f1b6c123'],7,26,33,598147,2,0,0,1,2557
81c66aded1f0565d1f495bcbcbbfdb384e5f41c3,1,Jitendra Nath Pandey,2012-05-27 07:26:00+00:00,['d28d53bc76fd5893df700a53563b44b1db25f6e6'],91,27,118,598265,5,0,0,0,2557
894917bfe46a36f86f03baf537ee2e4f09079026,0,Jitendra Nath Pandey,2012-05-27 07:27:33+00:00,['81c66aded1f0565d1f495bcbcbbfdb384e5f41c3'],0,2,2,598267,1,,,,2557
e190178c5e7aa355d5933d72caeddca101d198e2,0,Jitendra Nath Pandey,2012-05-27 07:29:27+00:00,['894917bfe46a36f86f03baf537ee2e4f09079026'],3,3,6,598273,2,,,,2557
348cb50633d8764eee624d011d51c7fcd9f85aaa,0,Jitendra Nath Pandey,2012-05-27 07:32:01+00:00,['e190178c5e7aa355d5933d72caeddca101d198e2'],20,4,24,598297,8,,,,2557
d5a9be8c150510cf589084526dc4d2f46634d27d,0,Jitendra Nath Pandey,2012-05-27 07:34:23+00:00,['348cb50633d8764eee624d011d51c7fcd9f85aaa'],6,6,12,598309,5,,,,2557
b4950bfc80ed1352e70133fbfb03d8016339307f,1,Jitendra Nath Pandey,2012-05-29 19:51:38+00:00,['d5a9be8c150510cf589084526dc4d2f46634d27d'],183852,3688579,3872431,4470740,4025,0.5173094,0.865748869,0.960341231,5398
b3277efd17d95118c7c05d5c789211df9fe79572,1,Jitendra Nath Pandey,2012-05-29 20:29:16+00:00,['b4950bfc80ed1352e70133fbfb03d8016339307f'],9,11,20,4470760,3,,,,5398
3e8aec6f67b17836af673d8834358e82557ecae0,1,Jitendra Nath Pandey,2012-05-29 20:38:17+00:00,['b3277efd17d95118c7c05d5c789211df9fe79572'],14,16,30,4470790,2,,,,5398
1517b7c00899d9190f1d31e847a3ec156737e0df,1,Jitendra Nath Pandey,2012-05-29 20:44:41+00:00,['3e8aec6f67b17836af673d8834358e82557ecae0'],16,22,38,4470828,3,,,,5398
d6a122d2c96d6a65fd48dd6c3eeb4906a6e2f224,0,Jitendra Nath Pandey,2012-05-29 20:46:30+00:00,['1517b7c00899d9190f1d31e847a3ec156737e0df'],12,50,62,4470890,3,1,1,1,5398
bfcf39c87a78fac352f2ae5c3f0b595378491f05,1,Suhas,2012-05-30 19:13:29+00:00,['d6a122d2c96d6a65fd48dd6c3eeb4906a6e2f224'],169,172,341,4471231,5,,,,5398
86273b434d6bdea39bf69caa80652417fa00e538,1,Suhas,2012-05-30 20:31:23+00:00,['bfcf39c87a78fac352f2ae5c3f0b595378491f05'],136,161,297,4471528,3,0,0,1,5398
8813684762d55209c85171f265c036fe929c8830,1,Suhas,2012-05-30 20:58:44+00:00,['86273b434d6bdea39bf69caa80652417fa00e538'],13,31,44,4471572,3,0,0,1,5398
84c705699d80961269b2d85ca5be704014411722,1,Vikram Dixit K,2012-06-01 22:46:52+00:00,['8813684762d55209c85171f265c036fe929c8830'],35,74,109,4471681,8,1,1,0,5399
c940bf4dc93f85ccac2e8d14aeee3a3e2e2f5dfe,0,Vikram Dixit K,2012-06-01 22:54:01+00:00,['84c705699d80961269b2d85ca5be704014411722'],0,8,8,4471689,2,0,1,0,5399
fc6391bdd51184e14996559fda2aedc456f664ba,1,Vikram Dixit K,2012-06-01 22:58:01+00:00,['c940bf4dc93f85ccac2e8d14aeee3a3e2e2f5dfe'],1,9,10,4471699,2,,,,5399
da276ab8b60afda2ad3759aea51a86a4f1c329b2,0,Vikram Dixit K,2012-06-01 23:00:53+00:00,['fc6391bdd51184e14996559fda2aedc456f664ba'],8,10,18,4471717,2,,,,5399
14a83a0ee69329c9f360938a20648cc561fe254a,1,Vikram Dixit K,2012-06-01 23:02:43+00:00,['da276ab8b60afda2ad3759aea51a86a4f1c329b2'],0,38,38,4471755,2,,,,5400
f962001b46645eaf01ccb1b4090306e28558053f,1,Vikram Dixit K,2012-06-01 23:05:11+00:00,['14a83a0ee69329c9f360938a20648cc561fe254a'],7,9,16,4471771,2,,,,5400
dd66e8a501be539387f4102ced3cfc2b8d8892da,1,Vikram Dixit K,2012-06-02 00:10:37+00:00,['f962001b46645eaf01ccb1b4090306e28558053f'],106,106,212,4471983,14,0,0,1,5400
2db16b7cbbf1f6cb5e9b7587b34090c28ee25d1d,1,Vikram Dixit K,2012-06-02 00:19:20+00:00,['dd66e8a501be539387f4102ced3cfc2b8d8892da'],135,315,450,4472433,4,0.671755725,1,0.79389313,5400
689e18e4a88135b486f237a44e54bacb16f9d76f,1,Vikram Dixit K,2012-06-02 00:25:12+00:00,['2db16b7cbbf1f6cb5e9b7587b34090c28ee25d1d'],1,3,4,4472437,2,,,,5400
756ebf142d6685c6b14ac8d9a2aa84ccb0c87f97,1,Vikram Dixit K,2012-06-02 00:27:53+00:00,['689e18e4a88135b486f237a44e54bacb16f9d76f'],11,20,31,4472468,6,,,,5400
a845f72a7f2f3b7af63ae888885a8084029ca11b,1,Vikram Dixit K,2012-06-02 00:30:30+00:00,['756ebf142d6685c6b14ac8d9a2aa84ccb0c87f97'],13,81,94,4472562,8,0,0,0,5401
8f9e0141ab95b043448f41991a5217ced62b4ecc,0,Vikram Dixit K,2012-06-02 00:32:59+00:00,['a845f72a7f2f3b7af63ae888885a8084029ca11b'],4,10,14,4472576,2,,,,5401
f473b72cdae7e59330a3bfe866dd07c2c6e82b4d,1,Vikram Dixit K,2012-06-02 00:35:16+00:00,['8f9e0141ab95b043448f41991a5217ced62b4ecc'],0,8,8,4472584,2,,,,5402
1b8f614acc0bda7daa02bcfa1ca2fdada0244793,0,Vikram Dixit K,2012-06-02 00:38:22+00:00,['f473b72cdae7e59330a3bfe866dd07c2c6e82b4d'],10,12,22,4472606,2,,,,5402
6f562057013e9970e4998ec27706396a221c17ec,1,Vikram Dixit K,2012-06-02 00:41:30+00:00,['1b8f614acc0bda7daa02bcfa1ca2fdada0244793'],5,7,12,4472618,4,,,,5402
0a2a809c8181efa155a9d41401d1037e9eed0079,1,Vikram Dixit K,2012-06-02 00:43:08+00:00,['6f562057013e9970e4998ec27706396a221c17ec'],148,159,307,4472925,2,0,0,1,5402
c17876866386fa978294efa29051c4e7fd6854ff,0,Vikram Dixit K,2012-06-05 21:09:34+00:00,['0a2a809c8181efa155a9d41401d1037e9eed0079'],3,4,7,4472932,2,,,,5402
e6ad58b4c2362d72458466d133f8f4b408609edd,1,Vikram Dixit K,2012-06-05 21:11:51+00:00,['c17876866386fa978294efa29051c4e7fd6854ff'],30,125,155,4473087,3,,,,5402
8f05c100863b16dc9a15a36d4ee2c7ad9afff340,0,Vikram Dixit K,2012-06-05 21:13:15+00:00,['e6ad58b4c2362d72458466d133f8f4b408609edd'],2,4,6,4473093,2,,,,5402
fd9e3530a4bc4b19571c33b81099a0c2add3c499,1,Vikram Dixit K,2012-06-05 21:18:52+00:00,['8f05c100863b16dc9a15a36d4ee2c7ad9afff340'],112,159,271,4473364,5,,,,5402
216844686a8441e44786119d576d29272d2543f6,1,Vikram Dixit K,2012-06-05 21:21:29+00:00,['fd9e3530a4bc4b19571c33b81099a0c2add3c499'],0,7,7,4473371,5,,,,5402
933e49fda74d4c5ea68cda01bcf1b3bd926ea40f,1,Vikram Dixit K,2012-06-05 21:23:50+00:00,['216844686a8441e44786119d576d29272d2543f6'],22,91,113,4473484,4,1,1,1,5402
bd045738d190f31310f4644bb7c6126c7a489056,1,Vikram Dixit K,2012-06-05 21:25:45+00:00,['933e49fda74d4c5ea68cda01bcf1b3bd926ea40f'],3,5,8,4473492,2,,,,5402
c4d740664fd271cf4913abf9863d4b4602c850d5,0,Vikram Dixit K,2012-06-05 21:28:29+00:00,['bd045738d190f31310f4644bb7c6126c7a489056'],13,17,30,4473522,2,,,,5402
2e2c67f1783387f3bb4836fc54dcc7dd41f12990,1,Vikram Dixit K,2012-06-05 21:30:46+00:00,['c4d740664fd271cf4913abf9863d4b4602c850d5'],10,114,124,4473646,5,0.4,1,1,5404
cfba11f580f64decdcc2ead6efc18b4c05e3e621,1,Vikram Dixit K,2012-06-05 21:32:45+00:00,['2e2c67f1783387f3bb4836fc54dcc7dd41f12990'],44,240,284,4473930,15,1,1,0.705882353,5405
f790ffaf898c84b405d54de38986d9ac627f83d7,0,Vikram Dixit K,2012-06-05 21:35:00+00:00,['cfba11f580f64decdcc2ead6efc18b4c05e3e621'],8,35,43,4473973,3,,,,5405
0fb207a45b980a2024e2a4eb8b27c415936221c0,1,Vikram Dixit K,2012-06-05 21:36:43+00:00,['f790ffaf898c84b405d54de38986d9ac627f83d7'],4,23,27,4474000,2,0,1,1,5405
a95906ab9f7f5af3f0f3f202dab456bcdf04e4e5,1,Vikram Dixit K,2012-06-05 21:44:00+00:00,['0fb207a45b980a2024e2a4eb8b27c415936221c0'],1,3,4,4474004,2,,,,5405
ad06c7105e6d1784402025b67b74c2b23a3befd0,1,Vikram Dixit K,2012-06-05 21:46:14+00:00,['a95906ab9f7f5af3f0f3f202dab456bcdf04e4e5'],0,5,5,4474009,2,,,,5405
57a4eefead050920eee76ded5d22cfb34c53852a,1,Vikram Dixit K,2012-06-05 21:50:31+00:00,['ad06c7105e6d1784402025b67b74c2b23a3befd0'],20,40,60,4474069,4,0,0,0.307692308,5405
cb467e0a32867d2e76bea98d0d94a3904e11274a,0,Vikram Dixit K,2012-06-05 22:32:50+00:00,['57a4eefead050920eee76ded5d22cfb34c53852a'],1,10,11,4474080,2,,,,5405
4667f04a54976c972025e63ecf07a145665f6794,1,Vikram Dixit K,2012-06-05 22:34:15+00:00,['cb467e0a32867d2e76bea98d0d94a3904e11274a'],7,11,18,4474098,2,1,1,0,5405
1ac501fbcd0dfd2d095e95aae4924e452a94861d,1,Vikram Dixit K,2012-06-05 22:35:51+00:00,['4667f04a54976c972025e63ecf07a145665f6794'],457,220,677,4474775,7,0.702702703,0.198198198,0.36036036,5405
f6f7190df2534e310519c57f9b6cd7f58b32eb5e,1,Vikram Dixit K,2012-06-05 22:41:31+00:00,['1ac501fbcd0dfd2d095e95aae4924e452a94861d'],204,125,329,4475104,5,0,0,1,5405
9782ac44c71e2e167975f29f2ec687706db63150,1,Vikram Dixit K,2012-06-05 22:48:27+00:00,['f6f7190df2534e310519c57f9b6cd7f58b32eb5e'],85,162,247,4475351,2,0.346153846,0.346153846,1,5405
246852ff4a5fba32d3e95902ebdc8975685346bc,0,Vikram Dixit K,2012-06-05 22:50:01+00:00,['9782ac44c71e2e167975f29f2ec687706db63150'],15,8,23,4475374,2,1,1,0,5405
baf3ad8a7d24eb312fc3ef78e6ffed06658c124d,1,Vikram Dixit K,2012-06-05 22:51:59+00:00,['246852ff4a5fba32d3e95902ebdc8975685346bc'],10,8,18,4475392,4,0,0,0,5405
8ad575f7ce3ddf37c94f716362537b72b0449bf6,0,Vikram Dixit K,2012-06-05 22:53:55+00:00,['baf3ad8a7d24eb312fc3ef78e6ffed06658c124d'],63,80,143,4475535,7,1,1,1,5405
cf104cfeb8bb148df891f1b968692bd9b8846e8d,1,Vikram Dixit K,2012-06-05 23:08:28+00:00,['8ad575f7ce3ddf37c94f716362537b72b0449bf6'],0,58,58,4475593,3,,,,5406
e269d7ca38a14533ce5a5ec9c42ed828852f7afc,0,Vikram Dixit K,2012-06-05 23:10:32+00:00,['cf104cfeb8bb148df891f1b968692bd9b8846e8d'],46,48,94,4475687,2,1,1,0,5406
d147db2e1f7376511a49e91934f5473944c29a33,1,Vikram Dixit K,2012-06-05 23:20:23+00:00,['e269d7ca38a14533ce5a5ec9c42ed828852f7afc'],34,122,156,4475843,5,0.055555556,0.041666667,0.041666667,5407
e8b699620f1cb71b80643563926f5571aa98112a,0,Vikram Dixit K,2012-06-05 23:22:53+00:00,['d147db2e1f7376511a49e91934f5473944c29a33'],1,12,13,4475856,2,,,,5407
64169da98320484e98f1ab6b2f2fdc354503a881,0,Vikram Dixit K,2012-06-05 23:37:43+00:00,['e8b699620f1cb71b80643563926f5571aa98112a'],1,4,5,4475861,2,0,0,0,5407
aae08df1db1d0de16735d9404356e8d1ce8c7ef6,1,Vikram Dixit K,2012-06-05 23:39:44+00:00,['64169da98320484e98f1ab6b2f2fdc354503a881'],2,5,7,4475868,3,,,,5407
1b39c31d75a04639b911e91a9fcc635ed1422efd,1,Vikram Dixit K,2012-06-05 23:45:34+00:00,['aae08df1db1d0de16735d9404356e8d1ce8c7ef6'],20,40,60,4475928,4,1,1,1,5407
3ab4d87555b94718eb0b33fd3e19d3e062f40b67,1,Vikram Dixit K,2012-06-06 18:11:20+00:00,['1b39c31d75a04639b911e91a9fcc635ed1422efd'],3,13,16,4475944,2,0,1,1,5407
7537f7d6c1b8eaa55ab479e2cb8133c1acb3e48a,0,Vikram Dixit K,2012-06-06 18:13:52+00:00,['3ab4d87555b94718eb0b33fd3e19d3e062f40b67'],1,2,3,4475947,2,,,,5407
7548dfb0efb77b1b5673bfcd63a2c53e2938841b,1,Vikram Dixit K,2012-06-06 18:23:26+00:00,['7537f7d6c1b8eaa55ab479e2cb8133c1acb3e48a'],17,70,87,4476034,3,1,1,1,5407
740b4814b546d0a033b7e942b5baf0e90f37bd8b,1,Vikram Dixit K,2012-06-06 18:25:02+00:00,['7548dfb0efb77b1b5673bfcd63a2c53e2938841b'],65,137,202,4476236,3,0.833333333,0.833333333,1,5407
809698f8383a07ecf84db7a8861e6862f51dcec7,1,Vikram Dixit K,2012-06-06 18:26:45+00:00,['740b4814b546d0a033b7e942b5baf0e90f37bd8b'],56,90,146,4476382,6,1,1,1,5407
0811c06930c8da76544ffc14c42924a6c5bfbb35,1,Vikram Dixit K,2012-06-06 18:28:18+00:00,['809698f8383a07ecf84db7a8861e6862f51dcec7'],17,21,38,4476420,3,0,0.35483871,1,5407
e7fff184fd8026c94c78c1b837b28dd247d2ca46,0,Vikram Dixit K,2012-06-06 20:40:14+00:00,['0811c06930c8da76544ffc14c42924a6c5bfbb35'],0,4,4,4476424,2,,,,5407
599ef759a5c9ffcb87ffc63202a9f7bc8ac85092,1,Vikram Dixit K,2012-06-06 20:50:48+00:00,['e7fff184fd8026c94c78c1b837b28dd247d2ca46'],0,124,124,4476548,6,1,1,0.25,5409
0e452665df1ff88dca7c6171be61df0482665fcc,0,Vikram Dixit K,2012-06-06 20:53:39+00:00,['599ef759a5c9ffcb87ffc63202a9f7bc8ac85092'],6,3,9,4476557,2,,,,5409
bf8c836c68a1a4ca00923c4f59acef902e8e36d5,0,Vikram Dixit K,2012-06-06 20:55:10+00:00,['0e452665df1ff88dca7c6171be61df0482665fcc'],0,3,3,4476560,2,,,,5409
b2f3f9d828dcc130d36d89b9ad0898d4746bfca6,1,Vikram Dixit K,2012-06-06 20:58:40+00:00,['bf8c836c68a1a4ca00923c4f59acef902e8e36d5'],63,151,214,4476774,2,,,,5409
9912bc1bcf4440084078e6bacd6daeb82cc4645e,1,Vikram Dixit K,2012-06-06 21:00:08+00:00,['b2f3f9d828dcc130d36d89b9ad0898d4746bfca6'],8,4,12,4476786,4,0,0,0,5409
5c27d234e624879333a4f0fe589ed9a0739c3d70,1,Vikram Dixit K,2012-06-06 21:01:41+00:00,['9912bc1bcf4440084078e6bacd6daeb82cc4645e'],69,95,164,4476950,2,0.25,0.25,1,5409
6d6d1791362131b7001725b770dd9e306f19d59e,1,Vikram Dixit K,2012-06-06 21:03:11+00:00,['5c27d234e624879333a4f0fe589ed9a0739c3d70'],4,6,10,4476960,2,,,,5409
72e650b0508169be45ba430d2a198e40f11150c0,1,Vikram Dixit K,2012-06-06 21:04:36+00:00,['6d6d1791362131b7001725b770dd9e306f19d59e'],65,194,259,4477219,8,1,0,0,5409
468d4fe0c9e395758ea9126f44b5d94461c92c25,1,Vikram Dixit K,2012-06-06 21:05:56+00:00,['72e650b0508169be45ba430d2a198e40f11150c0'],1,3,4,4477223,2,,,,5409
b2630fc539b53d5ef1d03c8a06424b72d34cbf09,0,Vikram Dixit K,2012-06-06 21:07:22+00:00,['468d4fe0c9e395758ea9126f44b5d94461c92c25'],0,3,3,4477226,2,,,,5409
9d7d07ed7f4c0ff9cf889c6ddd8f00d71b8ddd40,0,Vikram Dixit K,2012-06-06 21:09:57+00:00,['b2630fc539b53d5ef1d03c8a06424b72d34cbf09'],4,16,20,4477246,2,0.333333333,1,1,5409
96cb1ed508c5d1c540c6790d5e73ff2c898e6ee4,1,Vikram Dixit K,2012-06-06 21:20:03+00:00,['9d7d07ed7f4c0ff9cf889c6ddd8f00d71b8ddd40'],60,74,134,4477380,5,1,1,0,5409
e90dd0fc7c1fcd5212fb35c6203fc556533368f5,0,Vikram Dixit K,2012-06-06 21:21:30+00:00,['96cb1ed508c5d1c540c6790d5e73ff2c898e6ee4'],1,3,4,4477384,2,0,0,1,5409
bc987844a0ea923c4160d6a44ac7827ea9d5f783,1,Vikram Dixit K,2012-06-06 21:22:58+00:00,['e90dd0fc7c1fcd5212fb35c6203fc556533368f5'],0,30,30,4477414,2,,,,5410
4004578274f5dde15eb1d9ecff7a0d9e74328a90,0,Vikram Dixit K,2012-06-06 21:27:28+00:00,['bc987844a0ea923c4160d6a44ac7827ea9d5f783'],0,3,3,4477417,2,,,,5410
24155c31c1e04b9f6132f2f580ecd83762660268,1,Vikram Dixit K,2012-06-06 21:29:01+00:00,['4004578274f5dde15eb1d9ecff7a0d9e74328a90'],36,27,63,4477480,3,1,0.111111111,0,5410
6eb2a767560a13c32903196c9040c6ef89938c55,1,Vikram Dixit K,2012-06-06 21:30:20+00:00,['24155c31c1e04b9f6132f2f580ecd83762660268'],8,85,93,4477573,4,0.578947368,1,0.776315789,5410
024a34cf6df0c9bf2541bd65927c48006bd6f824,1,Vikram Dixit K,2012-06-06 21:32:31+00:00,['6eb2a767560a13c32903196c9040c6ef89938c55'],6,54,60,4477633,5,,,,5411
fc290a2858b8a7e84a32e561327de5124ea877eb,1,Vikram Dixit K,2012-06-06 21:33:51+00:00,['024a34cf6df0c9bf2541bd65927c48006bd6f824'],48,43,91,4477724,3,0,0,0,5411
43de58ad51d334619710a2265b476e391841232a,0,Vikram Dixit K,2012-06-06 21:48:24+00:00,['fc290a2858b8a7e84a32e561327de5124ea877eb'],1,2,3,4477727,2,0.5,0,0,5411
5a426603155578277d0bbde6e86b4d9d1dfd6ac8,1,Vikram Dixit K,2012-06-06 21:50:08+00:00,['43de58ad51d334619710a2265b476e391841232a'],1,3,4,4477731,2,1,1,1,5411
0affd18db89bb631ad86b5a54b754f7328467c0e,0,Vikram Dixit K,2012-06-06 21:51:36+00:00,['5a426603155578277d0bbde6e86b4d9d1dfd6ac8'],1,40,41,4477772,4,1,1,0.888888889,5411
539c3c5e9e1220998d254760c695e1b4a579d3d2,1,Vikram Dixit K,2012-06-06 21:53:07+00:00,['0affd18db89bb631ad86b5a54b754f7328467c0e'],58,82,140,4477912,3,1,1,1,5411
153ec0756c892be3908e042e456f688717011e88,1,Vikram Dixit K,2012-06-06 21:56:58+00:00,['539c3c5e9e1220998d254760c695e1b4a579d3d2'],10,47,57,4477969,6,0.941176471,1,1,5411
7e2c68f022d8091cfa4c155ee049061f029bf263,0,Vikram Dixit K,2012-06-06 21:58:27+00:00,['153ec0756c892be3908e042e456f688717011e88'],14,22,36,4478005,2,0,0,1,5411
9416596cc5ff975150768d42338968b864c5bac6,1,Vikram Dixit K,2012-06-06 21:59:45+00:00,['7e2c68f022d8091cfa4c155ee049061f029bf263'],4,20,24,4478029,2,1,0,0.1,5411
dd248633503614dbbf8e3c60d8a07b20ae3b8d11,0,Vikram Dixit K,2012-06-06 22:01:07+00:00,['9416596cc5ff975150768d42338968b864c5bac6'],0,6,6,4478035,2,1,1,1,5411
443297d3d6b3423e3f3ad2a91f299b1fc7f7fea7,1,Vikram Dixit K,2012-06-06 22:02:38+00:00,['dd248633503614dbbf8e3c60d8a07b20ae3b8d11'],25,57,82,4478117,5,0,0,0.545454545,5411
e9b901b9fe263b3685def666441d232e83a06a5d,1,Vikram Dixit K,2012-06-06 22:05:45+00:00,['443297d3d6b3423e3f3ad2a91f299b1fc7f7fea7'],26,80,106,4478223,7,,,,5412
97edcb5a1cdfa5ce27c4266b548c74b1947b1f5e,1,Vikram Dixit K,2012-06-06 22:09:47+00:00,['e9b901b9fe263b3685def666441d232e83a06a5d'],10,40,50,4478273,5,1,0,0,5413
1a33733c729ce69dac32865da80ab9e070ded323,0,Vikram Dixit K,2012-06-06 22:11:14+00:00,['97edcb5a1cdfa5ce27c4266b548c74b1947b1f5e'],2,16,18,4478291,2,0.277777778,0.277777778,0.277777778,5413
375fd1148e38a912350cc6f07e3712def672e601,1,Vikram Dixit K,2012-06-06 22:12:55+00:00,['1a33733c729ce69dac32865da80ab9e070ded323'],1,21,22,4478313,2,1,1,1,5413
85b3b9a97fd8d4060d64f71c31483ad76b40c0ec,0,Vikram Dixit K,2012-06-06 22:14:08+00:00,['375fd1148e38a912350cc6f07e3712def672e601'],1,3,4,4478317,2,,,,5413
c34f8d38932320439610ee6563683ccea0d04c2a,1,Vikram Dixit K,2012-06-06 22:15:22+00:00,['85b3b9a97fd8d4060d64f71c31483ad76b40c0ec'],1,7,8,4478325,2,,,,5413
9861311baec577edbfabb4f1b0fc9a495e2e2f35,1,Vikram Dixit K,2012-06-06 22:21:57+00:00,['c34f8d38932320439610ee6563683ccea0d04c2a'],9,11,20,4478345,2,,,,5413
65dce52efbc977bafa54907862f31aa1f2aa78e7,0,Vikram Dixit K,2012-06-06 22:23:42+00:00,['9861311baec577edbfabb4f1b0fc9a495e2e2f35'],0,4,4,4478349,2,,,,5413
80c1dcf032f3b51401e7424c20db37c704a77990,1,Vikram Dixit K,2012-06-06 22:26:24+00:00,['65dce52efbc977bafa54907862f31aa1f2aa78e7'],35,24,59,4478408,6,1,,,5413
e0a60bb5abca5c019ce25b75cb574f0182775b9d,1,Vikram Dixit K,2012-06-06 22:27:48+00:00,['80c1dcf032f3b51401e7424c20db37c704a77990'],52,74,126,4478534,7,0.269230769,0,0.269230769,5413
25adecdfada80e1e35997447078760dada3cabc0,1,Vikram Dixit K,2012-06-06 22:29:11+00:00,['e0a60bb5abca5c019ce25b75cb574f0182775b9d'],21,46,67,4478601,6,1,0,0,5413
3f3fdf4d341eee4fe48b6b609b82d00819a73479,1,Vikram Dixit K,2012-06-06 22:30:22+00:00,['25adecdfada80e1e35997447078760dada3cabc0'],24,129,153,4478754,5,0.094594595,0.635135135,0.297297297,5413
56c77dfa135b921f1230e3cb3d86ed287c4a4c57,0,Vikram Dixit K,2012-06-06 22:42:12+00:00,['3f3fdf4d341eee4fe48b6b609b82d00819a73479'],9,11,20,4478774,2,1,1,1,5413
2cdaae99d2bf815f630c1445b4a00aee2234cf30,1,Vikram Dixit K,2012-06-06 22:43:25+00:00,['56c77dfa135b921f1230e3cb3d86ed287c4a4c57'],48,195,243,4479017,8,1,1,1,5413
4071962cf0529f0a275c06be79894f8a56ca4c2f,1,Vikram Dixit K,2012-06-06 22:45:45+00:00,['2cdaae99d2bf815f630c1445b4a00aee2234cf30'],127,26,153,4479170,5,0.905405405,0.364864865,0.702702703,5413
ec886b00956b8459cc9c17ee597bae0dd9879551,0,Vikram Dixit K,2012-06-06 22:47:00+00:00,['4071962cf0529f0a275c06be79894f8a56ca4c2f'],2,4,6,4479176,2,,,,5413
a78e1fe5542c88b2359361f22a204c1730d53775,0,Vikram Dixit K,2012-06-06 22:51:03+00:00,['ec886b00956b8459cc9c17ee597bae0dd9879551'],2,4,6,4479182,3,,,,5413
4d5703a0060162803a6cfc8036f7e712f85e3034,0,Vikram Dixit K,2012-06-06 22:52:35+00:00,['a78e1fe5542c88b2359361f22a204c1730d53775'],1,3,4,4479186,2,,,,5413
68edf7e2cf0f5875179a34997dea2e5a496ba450,1,Vikram Dixit K,2012-06-06 22:54:12+00:00,['4d5703a0060162803a6cfc8036f7e712f85e3034'],34,126,160,4479346,5,1,1,1,5413
9f1ecff305e8146243b376ec8ca2e1a6ae5ed353,1,Vikram Dixit K,2012-06-06 23:13:43+00:00,['68edf7e2cf0f5875179a34997dea2e5a496ba450'],4,10,14,4479360,2,1,1,1,5413
0069f90ee14fddb40fd8b0520102906fbde0f238,1,Vikram Dixit K,2012-06-06 23:15:33+00:00,['9f1ecff305e8146243b376ec8ca2e1a6ae5ed353'],11,19,30,4479390,2,1,1,1,5413
2564d76012afe6dc087ac72d5fcce93e3fbd34ee,1,Vikram Dixit K,2012-06-06 23:17:17+00:00,['0069f90ee14fddb40fd8b0520102906fbde0f238'],2,12,14,4479404,4,0,0,0.428571429,5413
7c818ba0d9bec5407a6bbb1f00c5dda261b0a208,1,Vikram Dixit K,2012-06-06 23:18:47+00:00,['2564d76012afe6dc087ac72d5fcce93e3fbd34ee'],7,33,40,4479444,3,0,0,1,5413
28ec82482d3d531e9d6fc88776ac5a01ccb32b91,0,Vikram Dixit K,2012-06-06 23:20:39+00:00,['7c818ba0d9bec5407a6bbb1f00c5dda261b0a208'],2,7,9,4479453,2,,,,5413
db964d9017d382eea99dc666563b9f3a0cc4c978,0,Vikram Dixit K,2012-06-06 23:22:24+00:00,['28ec82482d3d531e9d6fc88776ac5a01ccb32b91'],1,5,6,4479459,2,,,,5413
b6d0fdd28c496b45bf7ff228c7b774805017ea86,1,Vikram Dixit K,2012-06-06 23:24:36+00:00,['db964d9017d382eea99dc666563b9f3a0cc4c978'],12,14,26,4479485,4,,,,5413
4a747a430d466e017071a32a76f67420e8efc797,0,Vikram Dixit K,2012-06-06 23:26:09+00:00,['b6d0fdd28c496b45bf7ff228c7b774805017ea86'],7,11,18,4479503,3,,,,5413
b5d416e24cc8d555905b678f826a7716811bac8d,1,Vikram Dixit K,2012-06-07 00:28:25+00:00,['4a747a430d466e017071a32a76f67420e8efc797'],0,25,25,4479528,2,1,1,1,5413
04710ca7e20cb898c8fc2fdb8cc8a3a2786b04db,1,Vikram Dixit K,2012-06-07 00:32:45+00:00,['b5d416e24cc8d555905b678f826a7716811bac8d'],14,51,65,4479593,5,,,,5413
f3eb0c1331043855a80a971eb4b92e4cf69f90b6,0,Vikram Dixit K,2012-06-07 00:34:42+00:00,['04710ca7e20cb898c8fc2fdb8cc8a3a2786b04db'],0,16,16,4479609,2,,,,5413
177314c12249f2cf2a64ca04567250a261682195,1,Vikram Dixit K,2012-06-07 00:35:54+00:00,['f3eb0c1331043855a80a971eb4b92e4cf69f90b6'],2,4,6,4479615,2,,,,5413
dd1ceae7c59a622074b617ce9c4835b9de3f161b,1,Vikram Dixit K,2012-06-07 00:37:17+00:00,['177314c12249f2cf2a64ca04567250a261682195'],50,17,67,4479682,4,0.95,0,0,5413
c446f968ccb25793b132bf97ea2525035b3fddf3,0,Vikram Dixit K,2012-06-07 00:38:19+00:00,['dd1ceae7c59a622074b617ce9c4835b9de3f161b'],1,7,8,4479690,2,,,,5413
259387208803bd6e9dbc155ba12c7f7ed3dfd96e,0,Vikram Dixit K,2012-06-07 00:39:27+00:00,['c446f968ccb25793b132bf97ea2525035b3fddf3'],1,21,22,4479712,3,1,1,1,5413
0ac0b24d0d3e82a354fa405d9ec3d5f9b39b497f,1,Vikram Dixit K,2012-06-07 00:40:33+00:00,['259387208803bd6e9dbc155ba12c7f7ed3dfd96e'],21,10,31,4479743,2,,,,5413
0ecca49cecb424802859f2c86282c6bf38c5587b,1,Vikram Dixit K,2012-06-07 00:43:00+00:00,['0ac0b24d0d3e82a354fa405d9ec3d5f9b39b497f'],0,133,133,4479876,2,,,,5414
26038ee47ab730752610ac7f873059ccfc04fd3a,0,Vikram Dixit K,2012-06-07 00:44:06+00:00,['0ecca49cecb424802859f2c86282c6bf38c5587b'],2,4,6,4479882,2,,,,5414
aa0272ae8a1d954fb3ee7ea89046d99df2687ce6,0,Vikram Dixit K,2012-06-07 00:45:08+00:00,['26038ee47ab730752610ac7f873059ccfc04fd3a'],27,50,77,4479959,2,0.857142857,0.857142857,1,5414
70bc99fb5ee35ff53c30d1e8b7fc913eca011b4f,1,Vikram Dixit K,2012-06-07 00:46:30+00:00,['aa0272ae8a1d954fb3ee7ea89046d99df2687ce6'],30,51,81,4480040,5,,,,5414
e4a8a7747a70892d301bf6f70445b9d197389ec7,1,Vikram Dixit K,2012-06-07 00:47:42+00:00,['70bc99fb5ee35ff53c30d1e8b7fc913eca011b4f'],1,3,4,4480044,2,,,,5414
5ce9e6022b2b28f26421f940c07e51eb1bc70416,1,Vikram Dixit K,2012-06-07 00:48:59+00:00,['e4a8a7747a70892d301bf6f70445b9d197389ec7'],4,5,9,4480053,2,,,,5414
3a9731ff992f56f7d30a281880273e2cba66a7b8,1,Vikram Dixit K,2012-06-07 00:50:57+00:00,['5ce9e6022b2b28f26421f940c07e51eb1bc70416'],10,33,43,4480096,4,,,,5414
e7ab63e42d59a3597e94c62e2a9c72d19227c638,0,Vikram Dixit K,2012-06-07 00:52:23+00:00,['3a9731ff992f56f7d30a281880273e2cba66a7b8'],1,3,4,4480100,2,,,,5414
e201473997e9691ef4fb68d9d873a28538e5112d,0,Vikram Dixit K,2012-06-07 00:53:37+00:00,['e7ab63e42d59a3597e94c62e2a9c72d19227c638'],5,17,22,4480122,4,,,,5414
44dc6f130312cb0bf35573e2233bc6596933216e,0,Vikram Dixit K,2012-06-07 00:54:53+00:00,['e201473997e9691ef4fb68d9d873a28538e5112d'],14,71,85,4480207,6,0,0.19047619,0.80952381,5414
b1b63ea54ac6f00f847b2b8b93867e37af8e82c8,1,Vikram Dixit K,2012-06-07 00:56:00+00:00,['44dc6f130312cb0bf35573e2233bc6596933216e'],3,5,8,4480215,3,,,,5414
e41fbcb3e8a1fe57fc4c27dfaee87e338388089b,0,Vikram Dixit K,2012-06-07 00:57:05+00:00,['b1b63ea54ac6f00f847b2b8b93867e37af8e82c8'],3,3,6,4480221,3,,,,5414
6f962eea4a6dd04f099887f8739eb2275a740f21,1,Vikram Dixit K,2012-06-07 00:58:07+00:00,['e41fbcb3e8a1fe57fc4c27dfaee87e338388089b'],2,4,6,4480227,2,,,,5414
ea310871d87dec4d80eb458f92392216f2e98d11,1,Vikram Dixit K,2012-06-07 00:59:19+00:00,['6f962eea4a6dd04f099887f8739eb2275a740f21'],4,22,26,4480253,4,1,1,1,5414
b058682953c6234d441e25b861ad5bd378875158,1,Vikram Dixit K,2012-06-07 01:00:39+00:00,['ea310871d87dec4d80eb458f92392216f2e98d11'],62,150,212,4480465,6,1,0,0,5416
02cababc8e7d18e50afc1651e30ee8aeb94f1f29,1,Vikram Dixit K,2012-06-07 01:01:56+00:00,['b058682953c6234d441e25b861ad5bd378875158'],3,55,58,4480523,4,,,,5417
22e28e641446eb7c69dbcc9ba27718b4e33d8647,1,Vikram Dixit K,2012-06-07 01:03:09+00:00,['02cababc8e7d18e50afc1651e30ee8aeb94f1f29'],7,27,34,4480557,2,0,1,0,5417
270b3c4e78662ba5a26707ddf3f2ade363826404,1,Vikram Dixit K,2012-06-07 01:04:27+00:00,['22e28e641446eb7c69dbcc9ba27718b4e33d8647'],217,132,349,4480906,12,1,0,0,5417
f0b2269f93ca9575e2cf604674398ceb8a429ab0,1,Vikram Dixit K,2012-06-07 01:05:51+00:00,['270b3c4e78662ba5a26707ddf3f2ade363826404'],1,5,6,4480912,2,,,,5417
eee6cb96253f794ee2d535d73ed80b12d35c2b23,0,Vikram Dixit K,2012-06-07 01:07:16+00:00,['f0b2269f93ca9575e2cf604674398ceb8a429ab0'],8,8,16,4480928,2,0,0,0,5417
bf210611f637919c3cee1177b3d8d154902fd16b,0,Vikram Dixit K,2012-06-07 01:08:33+00:00,['eee6cb96253f794ee2d535d73ed80b12d35c2b23'],11,2,13,4480941,4,,,,5417
12034420471ed0e31adcc98817daae0aa709d91a,1,Vikram Dixit K,2012-06-07 01:10:06+00:00,['bf210611f637919c3cee1177b3d8d154902fd16b'],2,14,16,4480957,2,,,,5417
470af7247004d448b3e45e81f8d9ebbd5e46b60e,0,Vikram Dixit K,2012-06-07 01:11:31+00:00,['12034420471ed0e31adcc98817daae0aa709d91a'],9,8,17,4480974,2,,,,5417
976e1bf32624f14140fae9e3e90c24687c90e2c9,1,Vikram Dixit K,2012-06-07 01:13:48+00:00,['470af7247004d448b3e45e81f8d9ebbd5e46b60e'],26,19,45,4481019,8,,,,5417
feb7cb2c1474b5db3e5ae23e5e15de32f1756604,1,Vikram Dixit K,2012-06-07 01:15:25+00:00,['976e1bf32624f14140fae9e3e90c24687c90e2c9'],472,587,1059,4482078,16,0,0,1,5417
70412842a959117e160d62b409075071ce3795b3,0,Vikram Dixit K,2012-06-07 01:16:37+00:00,['feb7cb2c1474b5db3e5ae23e5e15de32f1756604'],1,7,8,4482086,2,,,,5417
79e9421fe252518f900f7e153fff027a8669d2a6,1,Vikram Dixit K,2012-06-07 01:22:13+00:00,['70412842a959117e160d62b409075071ce3795b3'],4,6,10,4482096,2,,,,5417
a23791ed962f4f245d23d8e83d602c720a81c0a9,1,Vikram Dixit K,2012-06-07 01:23:51+00:00,['79e9421fe252518f900f7e153fff027a8669d2a6'],3,5,8,4482104,2,,,,5417
73fb735b967fd99f680d2aea52d03fff446a201b,0,Vikram Dixit K,2012-06-07 01:25:12+00:00,['a23791ed962f4f245d23d8e83d602c720a81c0a9'],2,13,15,4482119,3,1,1,1,5417
eab5d5b820bb6a10607c916c79770b99aac59563,1,Vikram Dixit K,2012-06-07 01:26:21+00:00,['73fb735b967fd99f680d2aea52d03fff446a201b'],2,4,6,4482125,2,,,,5417
ce0760c2339c0b80b39cd355a8416acc1af20e5f,0,Vikram Dixit K,2012-06-07 01:27:28+00:00,['eab5d5b820bb6a10607c916c79770b99aac59563'],78,36,114,4482239,2,0.473684211,0,0,5417
84a5b1cef078314ca054a4e0747a7f9c3564892b,0,Vikram Dixit K,2012-06-07 01:28:44+00:00,['ce0760c2339c0b80b39cd355a8416acc1af20e5f'],16,16,32,4482271,2,,,,5417
4b37685e04240d052095af2b985a6b5fbfd948f2,0,Vikram Dixit K,2012-06-07 01:30:04+00:00,['84a5b1cef078314ca054a4e0747a7f9c3564892b'],37,43,80,4482351,4,,,,5417
cb29f117b48ec00c2e6ad1c12259dfb02d1061fe,0,Vikram Dixit K,2012-06-07 01:31:16+00:00,['4b37685e04240d052095af2b985a6b5fbfd948f2'],2,27,29,4482380,4,,,,5417
396e1f5ff84a6ac1d26a2a60d918abfbbc1bfd1b,0,Vikram Dixit K,2012-06-07 01:33:42+00:00,['cb29f117b48ec00c2e6ad1c12259dfb02d1061fe'],2,6,8,4482388,2,,,,5417
6f70fd69cb0536e9a179245fff3c3b72f5472d83,1,Vikram Dixit K,2012-06-07 01:34:55+00:00,['396e1f5ff84a6ac1d26a2a60d918abfbbc1bfd1b'],5,24,29,4482417,6,0.909090909,0.818181818,1,5417
44061a820e051f6b6baef71c617298d687893401,1,Vikram Dixit K,2012-06-07 01:36:27+00:00,['6f70fd69cb0536e9a179245fff3c3b72f5472d83'],50,44,94,4482511,22,0.863636364,1,1,5417
bbff40ca12b39f2397dcea562a1b5240056bbf91,1,Vikram Dixit K,2012-06-07 01:37:40+00:00,['44061a820e051f6b6baef71c617298d687893401'],644,199,843,4483354,8,0.387096774,1,1,5417
a79996fa04acfc1c3b036e7b8f19ffea1fe65312,0,Vikram Dixit K,2012-06-07 01:38:42+00:00,['bbff40ca12b39f2397dcea562a1b5240056bbf91'],1,3,4,4483358,2,,,,5417
1c7237e4329867671c88f5e8282a172a12834a9d,1,Vikram Dixit K,2012-06-07 01:41:52+00:00,['a79996fa04acfc1c3b036e7b8f19ffea1fe65312'],315,283,598,4483956,16,1,1,0,5418
8008f7e722fb80d964500d7399f7574358d14f4b,0,Vikram Dixit K,2012-06-07 01:43:59+00:00,['1c7237e4329867671c88f5e8282a172a12834a9d'],4,13,17,4483973,5,,,,5418
e3c1910d6511508625b6f5cac9eb05ac5f4b7775,0,Vikram Dixit K,2012-06-07 01:45:04+00:00,['8008f7e722fb80d964500d7399f7574358d14f4b'],2,9,11,4483984,3,0,1,1,5418
b23546444ebc5051fdefffefd3eac12fec48ff93,1,Vikram Dixit K,2012-06-07 01:46:15+00:00,['e3c1910d6511508625b6f5cac9eb05ac5f4b7775'],1,18,19,4484003,2,0.769230769,0.769230769,0.230769231,5418
1fd516b8a9d8c1e5894f919f478f555397039dc7,1,Vikram Dixit K,2012-06-07 01:47:14+00:00,['b23546444ebc5051fdefffefd3eac12fec48ff93'],6,35,41,4484044,3,1,1,1,5418
3ad0124e40b7b1a55adf9a88101743c3ab363a46,1,Vikram Dixit K,2012-06-07 01:48:52+00:00,['1fd516b8a9d8c1e5894f919f478f555397039dc7'],250,399,649,4484693,13,0.976744186,1,1,5422
f9111aa41a26dfb66aaa7338987d70484069ebc9,1,Vikram Dixit K,2012-06-07 01:50:00+00:00,['3ad0124e40b7b1a55adf9a88101743c3ab363a46'],1,3,4,4484697,2,,,,5422
c4184760c81e75230bc59f5b560d2b27f640c3b8,1,Vikram Dixit K,2012-06-07 01:51:16+00:00,['f9111aa41a26dfb66aaa7338987d70484069ebc9'],7,10,17,4484714,2,,,,5422
18c83064a13f5aa9628071b64fc0ac0833c8e0fd,0,Vikram Dixit K,2012-06-07 01:52:18+00:00,['c4184760c81e75230bc59f5b560d2b27f640c3b8'],2,4,6,4484720,2,,,,5422
50a79a6676b4885d2a283023099c20a767fcb825,1,Vikram Dixit K,2012-06-07 01:53:28+00:00,['18c83064a13f5aa9628071b64fc0ac0833c8e0fd'],19,130,149,4484869,3,0.941176471,0.294117647,1,5422
078b156a6e5e66e65db44679caa2fe0e8d7ad173,1,Vikram Dixit K,2012-06-07 01:54:50+00:00,['50a79a6676b4885d2a283023099c20a767fcb825'],28,35,63,4484932,11,,,,5422
7ae4460871fe1713dd37fd5c1b52e18ed6f2254e,0,Vikram Dixit K,2012-06-07 01:56:38+00:00,['078b156a6e5e66e65db44679caa2fe0e8d7ad173'],88,83,171,4485103,8,,,,5422
d4e1bdaf6156665c1d3b136626bc0ab24f0aae32,0,Vikram Dixit K,2012-06-07 02:00:55+00:00,['7ae4460871fe1713dd37fd5c1b52e18ed6f2254e'],2,2,4,4485107,2,,,,5422
7c0807b8eff48aa10339013998f2cd58dda9c48d,1,Vikram Dixit K,2012-06-07 02:02:26+00:00,['d4e1bdaf6156665c1d3b136626bc0ab24f0aae32'],0,114,114,4485221,2,0.621621622,1,1,5423
b5d0005db716b0e91440d4d4372b143e035f9163,0,Vikram Dixit K,2012-06-07 02:03:51+00:00,['7c0807b8eff48aa10339013998f2cd58dda9c48d'],1,3,4,4485225,2,,,,5423
3532798f47a673819262527dc6bd6f531b2f3619,0,Vikram Dixit K,2012-06-07 02:04:59+00:00,['b5d0005db716b0e91440d4d4372b143e035f9163'],1,4,5,4485230,2,0,0,1,5423
9f88889ecc478c015cf6f6b665b39ecf94cabc6f,1,Vikram Dixit K,2012-06-07 02:07:07+00:00,['3532798f47a673819262527dc6bd6f531b2f3619'],0,158,158,4485388,2,,,,5424
c5b4e81a0e6d262585fba1306fc92eed1fa11577,0,Vikram Dixit K,2012-06-07 02:08:19+00:00,['9f88889ecc478c015cf6f6b665b39ecf94cabc6f'],44,53,97,4485485,4,0,,,5424
f071c203b5f757c65fb0254b19b8fe352e254f1a,1,Vikram Dixit K,2012-06-07 02:15:40+00:00,['c5b4e81a0e6d262585fba1306fc92eed1fa11577'],66,56,122,4485607,13,,,,5424
e4994a73f34859efe1e5541c20e464389fa94b40,1,Vikram Dixit K,2012-06-07 02:16:45+00:00,['f071c203b5f757c65fb0254b19b8fe352e254f1a'],62,48,110,4485717,5,0,0,0.833333333,5424
5c4f339cfa2f065b13b9737a4fddcfc7b79f2c14,0,Vikram Dixit K,2012-06-07 02:17:44+00:00,['e4994a73f34859efe1e5541c20e464389fa94b40'],2,4,6,4485723,2,,,,5424
d134198bd56ec88e0b23df783cb15373160dc1ce,0,Vikram Dixit K,2012-06-07 02:19:36+00:00,['5c4f339cfa2f065b13b9737a4fddcfc7b79f2c14'],3,17,20,4485743,2,,,,5424
7bbfbbb4b577bc1905e2d09975614640f62e6277,1,Vikram Dixit K,2012-06-07 02:20:44+00:00,['d134198bd56ec88e0b23df783cb15373160dc1ce'],2,10,12,4485755,2,1,1,1,5424
e0e5a59e72173836f75b6f7749fcae51874e9533,0,Vikram Dixit K,2012-06-07 02:21:57+00:00,['7bbfbbb4b577bc1905e2d09975614640f62e6277'],1,3,4,4485759,2,,,,5424
27e71af6ef40beed3a61236be2cdbe13138022b4,0,Vikram Dixit K,2012-06-07 02:23:04+00:00,['e0e5a59e72173836f75b6f7749fcae51874e9533'],8,11,19,4485778,2,0,0,1,5424
7d4179d52af433c77cc8b1367fd951cef02d18ec,0,Vikram Dixit K,2012-06-07 02:24:04+00:00,['27e71af6ef40beed3a61236be2cdbe13138022b4'],0,10,10,4485788,2,1,1,1,5424
e97a3c0d4cbf666ff066a94435380e26fb54a4ba,0,Vikram Dixit K,2012-06-07 02:25:07+00:00,['7d4179d52af433c77cc8b1367fd951cef02d18ec'],0,9,9,4485797,2,,,,5424
de2015f400a166014376c6ec0742b88ec2de7539,1,Vikram Dixit K,2012-06-07 02:26:31+00:00,['e97a3c0d4cbf666ff066a94435380e26fb54a4ba'],245,254,499,4486296,6,0.857142857,1,1,5424
dc6328a46112953068655c13b83f6493c729d3db,0,Vikram Dixit K,2012-06-07 02:27:42+00:00,['de2015f400a166014376c6ec0742b88ec2de7539'],6,8,14,4486310,2,,,,5424
2f8d00cdc2c23d68e57ba889e7dbf6b17765c8c5,1,Vikram Dixit K,2012-06-07 02:29:06+00:00,['dc6328a46112953068655c13b83f6493c729d3db'],242,239,481,4486791,4,1,0.5,0.5,5424
85075f943f61b71097456e93758be4a6776b1dbc,1,Vikram Dixit K,2012-06-07 02:31:44+00:00,['2f8d00cdc2c23d68e57ba889e7dbf6b17765c8c5'],4,14,18,4486809,3,0,0,0,5424
5f3d27e66e39f4c4cda5331971ac917a1e7c8f5d,0,Vikram Dixit K,2012-06-07 02:32:41+00:00,['85075f943f61b71097456e93758be4a6776b1dbc'],1,3,4,4486813,2,,,,5424
1da991cc0cce6daf3bf15bd978b6a68f20466147,0,Vikram Dixit K,2012-06-07 02:33:55+00:00,['5f3d27e66e39f4c4cda5331971ac917a1e7c8f5d'],0,3,3,4486816,2,,,,5424
efe375a8d0a9bf8f5c6039b30f86b26835f551d9,0,Vikram Dixit K,2012-06-07 02:35:05+00:00,['1da991cc0cce6daf3bf15bd978b6a68f20466147'],4,6,10,4486826,2,,,,5424
cfd05c737aa9fdf1fb467206cf427e76e936daf0,0,Vikram Dixit K,2012-06-07 02:37:14+00:00,['efe375a8d0a9bf8f5c6039b30f86b26835f551d9'],82,125,207,4487033,30,1,1,0,5428
8f49fc25b722203eab7a7a707ff55cb82fb758bb,1,Vikram Dixit K,2012-06-07 02:38:28+00:00,['cfd05c737aa9fdf1fb467206cf427e76e936daf0'],46,43,89,4487122,8,1,1,0,5428
27ce3e8d486a62a6ea5f51c8526a333d014c2620,1,Vikram Dixit K,2012-06-07 02:39:38+00:00,['8f49fc25b722203eab7a7a707ff55cb82fb758bb'],7,9,16,4487138,2,,,,5428
ca10ce86ca028281e9003b835349089064315c3c,1,Vikram Dixit K,2012-06-07 02:40:57+00:00,['27ce3e8d486a62a6ea5f51c8526a333d014c2620'],15,24,39,4487177,3,,,,5428
6e1cbfaf9fdfee13c88ccc4b624eee1fa042c476,1,Vikram Dixit K,2012-06-07 02:42:13+00:00,['ca10ce86ca028281e9003b835349089064315c3c'],4,6,10,4487187,3,,,,5428
38cfc1ca55a240ced9513f8b9ad477a4ed91de97,1,Vikram Dixit K,2012-06-07 02:43:38+00:00,['6e1cbfaf9fdfee13c88ccc4b624eee1fa042c476'],17,667,684,4487871,5,1,0.851720047,0.870699881,5430
5eb384248f3339e94b9f786debf215a6073af719,0,Vikram Dixit K,2012-06-07 02:47:53+00:00,['38cfc1ca55a240ced9513f8b9ad477a4ed91de97'],0,2,2,4487873,2,,,,5431
ba042b04e388eaeaa408060eb8648942d9b7e162,0,Vikram Dixit K,2012-06-07 03:19:52+00:00,['5eb384248f3339e94b9f786debf215a6073af719'],7,11,18,4487891,2,0,1,0,5431
76aaefb833fa582458c09cd97bd17b0a398eeeae,1,Vikram Dixit K,2012-06-07 03:23:23+00:00,['ba042b04e388eaeaa408060eb8648942d9b7e162'],7,30,37,4487928,6,,,,5431
c0abbf8f2a1f15f76acc39e9624c8b3295573f2f,1,Vikram Dixit K,2012-06-07 03:24:32+00:00,['76aaefb833fa582458c09cd97bd17b0a398eeeae'],3,6,9,4487937,3,,,,5431
4ce83f09a4948fa534eb798398f278256efec920,1,Vikram Dixit K,2012-06-07 03:25:32+00:00,['c0abbf8f2a1f15f76acc39e9624c8b3295573f2f'],50,82,132,4488069,6,,,,5431
5a67a1c6e95dff34ad29f5641b05974585ec851e,1,Vikram Dixit K,2012-06-07 03:27:27+00:00,['4ce83f09a4948fa534eb798398f278256efec920'],97,71,168,4488237,8,0.657142857,0.685714286,0,5431
7e82be350674fd454ceffd4d4bd626e4b0eb535b,1,Vikram Dixit K,2012-06-07 03:29:18+00:00,['5a67a1c6e95dff34ad29f5641b05974585ec851e'],233,310,543,4488780,9,0.066666667,0,0,5434
58aa2654dcd4c2e8ce7f1075e907c5daf3526aaf,0,Vikram Dixit K,2012-06-07 03:30:40+00:00,['7e82be350674fd454ceffd4d4bd626e4b0eb535b'],0,9,9,4488789,2,,,,5434
a837888443562af463b2989ed4b6bfb5ff1823f6,1,Vikram Dixit K,2012-06-07 03:31:51+00:00,['58aa2654dcd4c2e8ce7f1075e907c5daf3526aaf'],3,5,8,4488797,2,,,,5434
0a1273ad3e07bd6c0cbbd8baa3aff1a9e8a5c601,1,Vikram Dixit K,2012-06-07 03:35:52+00:00,['a837888443562af463b2989ed4b6bfb5ff1823f6'],5,7,12,4488809,5,,,,5434
83684d4b69850e809d09c6ad062cf96afc3f9726,1,Vikram Dixit K,2012-06-07 03:37:05+00:00,['0a1273ad3e07bd6c0cbbd8baa3aff1a9e8a5c601'],1,3,4,4488813,2,,,,5434
f0cd8d7304e3dd5dcee9ae7f5581818a165c254f,1,Vikram Dixit K,2012-06-07 03:40:37+00:00,['83684d4b69850e809d09c6ad062cf96afc3f9726'],24,27,51,4488864,5,,,,5434
6b96adcbd25eebc48086533d82ef82b4441a12fc,0,Vikram Dixit K,2012-06-07 03:43:16+00:00,['f0cd8d7304e3dd5dcee9ae7f5581818a165c254f'],2,4,6,4488870,3,,,,5434
c9f3f19a25da2589b9ea4e105114d33a7fe1b3ff,0,Vikram Dixit K,2012-06-07 03:44:36+00:00,['6b96adcbd25eebc48086533d82ef82b4441a12fc'],3,5,8,4488878,2,,,,5434
c7fdfd43d30e9f2b4993e56b10e0d93a2e44f87b,1,Vikram Dixit K,2012-06-07 03:46:14+00:00,['c9f3f19a25da2589b9ea4e105114d33a7fe1b3ff'],9,23,32,4488910,7,,,,5434
8c61650b79d9d97c1b3dca6ef46753f1e95e895a,0,Vikram Dixit K,2012-06-07 03:48:16+00:00,['c7fdfd43d30e9f2b4993e56b10e0d93a2e44f87b'],1,5,6,4488916,2,,,,5434
9fff917731abfce00b4b510cb79c35c8fed736d0,1,Vikram Dixit K,2012-06-07 03:49:25+00:00,['8c61650b79d9d97c1b3dca6ef46753f1e95e895a'],7,9,16,4488932,4,,,,5434
d1a778b4af4e8c425c3efa6db4924798e28b7c82,0,Vikram Dixit K,2012-06-07 03:50:38+00:00,['9fff917731abfce00b4b510cb79c35c8fed736d0'],1,3,4,4488936,2,,,,5434
b1886ff1a4b81c0043e5b3a532f0013dfb4820e5,0,Vikram Dixit K,2012-06-07 03:52:05+00:00,['d1a778b4af4e8c425c3efa6db4924798e28b7c82'],0,5,5,4488941,2,,,,5434
8e2065c3d588e417612400a672341b649fb34e0c,1,Vikram Dixit K,2012-06-07 03:53:38+00:00,['b1886ff1a4b81c0043e5b3a532f0013dfb4820e5'],63,9,72,4489013,5,,,,5434
bbe7721924b60ed019a17a36ac6cd16808725d32,0,Vikram Dixit K,2012-06-07 03:54:45+00:00,['8e2065c3d588e417612400a672341b649fb34e0c'],2,4,6,4489019,3,,,,5434
99acd817407e9b8ee86efc389eb5fb20e5a5a394,0,Vikram Dixit K,2012-06-07 03:56:12+00:00,['bbe7721924b60ed019a17a36ac6cd16808725d32'],0,22,22,4489041,2,1,1,1,5434
ba736eb6dc2afba4792a43b24487139d875cff2c,0,Vikram Dixit K,2012-06-07 03:57:09+00:00,['99acd817407e9b8ee86efc389eb5fb20e5a5a394'],5,2,7,4489048,2,,,,5434
da8f7902987be0b87ac3ffc3bdee2d324743066c,0,Vikram Dixit K,2012-06-07 03:58:46+00:00,['ba736eb6dc2afba4792a43b24487139d875cff2c'],2,4,6,4489054,2,,,,5434
e4d581b2928ad6687f48a973c56a8c6aef443bc5,0,Vikram Dixit K,2012-06-07 04:00:45+00:00,['da8f7902987be0b87ac3ffc3bdee2d324743066c'],1,3,4,4489058,2,,,,5434
1c4ce2639c684ccdf8828145c34ece3281887847,1,Hitesh Shah,2012-06-07 23:26:41+00:00,['e4d581b2928ad6687f48a973c56a8c6aef443bc5'],4868,43,4911,4493969,84,0.114842176,0.087306917,0.040967092,5434
d386328829beff71b8e21f24d0769f084d8034db,1,Varun Kapoor,2012-06-08 23:12:24+00:00,['1c4ce2639c684ccdf8828145c34ece3281887847'],4,156,160,4494129,3,,,,5435
20820afb2780c8ce68cc77f2a5db7ebb98166adc,0,Varun Kapoor,2012-06-09 01:03:41+00:00,['d386328829beff71b8e21f24d0769f084d8034db'],1,3,4,4494133,2,,,,5435
87357fd7c572208409c3d7fa65d09883d14101be,0,Vikram Dixit K,2012-06-09 01:43:23+00:00,['20820afb2780c8ce68cc77f2a5db7ebb98166adc'],18,20,38,4494171,4,,,,5435
8ac9f6190a26f367037041b77c2de4f259dcb74c,1,Varun Kapoor,2012-06-09 02:02:35+00:00,['87357fd7c572208409c3d7fa65d09883d14101be'],30,98,128,4494299,2,,,,5435
534d52a6acf6a393c402c64544d32e2d8b0dd2ef,0,Varun Kapoor,2012-06-09 02:10:07+00:00,['8ac9f6190a26f367037041b77c2de4f259dcb74c'],2,4,6,4494305,3,,,,5435
5508553a43721089e2ccddb54fe36c16c9ac5f44,0,Owen O'Malley,2012-06-11 17:33:39+00:00,['534d52a6acf6a393c402c64544d32e2d8b0dd2ef'],283,422,705,4495010,1,,,,5435
0906c695f08910a19d8027d422de223bc07016a7,0,Vikram Dixit K,2012-06-12 03:02:05+00:00,"['a61cce648bad7ef97ce5c8bd61dd0be13a321f72', '5508553a43721089e2ccddb54fe36c16c9ac5f44']",32738,4018148,4050886,8545896,4697,,,,5435
864947c0f27b4dd169f0a4e1f166d8c4008b291f,1,Vikram Dixit K,2012-06-12 03:43:51+00:00,['0906c695f08910a19d8027d422de223bc07016a7'],2,5,7,8545903,2,,,,5435
1886d5307a2b31069ca09931ea4f31056eea7b00,1,Hitesh Shah,2012-06-15 19:15:00+00:00,['864947c0f27b4dd169f0a4e1f166d8c4008b291f'],0,7,7,8545910,2,,,,5435
fdf2e22b31b29ca1714bb75442c6eb7f75add469,1,Hitesh Shah,2012-06-16 00:20:33+00:00,['1886d5307a2b31069ca09931ea4f31056eea7b00'],0,642,642,8546552,6,,,,5440
cac282e09914a1bc86e6067817708a186fad5f6a,0,Yusaku Sako,2012-06-17 01:01:18+00:00,['fdf2e22b31b29ca1714bb75442c6eb7f75add469'],15,25,40,8546592,3,,,,5440
1c3d9ba7ff0012b6e85bd606eafa12eb4129ab78,1,Yusaku Sako,2012-06-17 01:13:31+00:00,['cac282e09914a1bc86e6067817708a186fad5f6a'],39,60,99,8546691,2,0,0,0,5440
db6683248835a829c7e4afeca2ccc0ba68a5f587,0,Yusaku Sako,2012-06-17 01:17:51+00:00,['1c3d9ba7ff0012b6e85bd606eafa12eb4129ab78'],3,5,8,8546699,1,0,0,0,5440
970f461797587508606eadec54d6e07374526509,0,Yusaku Sako,2012-06-17 01:20:26+00:00,['db6683248835a829c7e4afeca2ccc0ba68a5f587'],3,4,7,8546706,2,,,,5440
0e5c8ed5abdf42a8f43e5f8b2f3021463d6fa55b,1,Yusaku Sako,2012-06-17 01:23:04+00:00,['970f461797587508606eadec54d6e07374526509'],5,7,12,8546718,3,,,,5440
527451ae0e1a5846f0deb248e935361a2c1b4704,0,Yusaku Sako,2012-06-17 01:29:12+00:00,['0e5c8ed5abdf42a8f43e5f8b2f3021463d6fa55b'],5,7,12,8546730,2,,,,5440
beb74b56aa248b838570acd9046ce26f106224ca,0,Yusaku Sako,2012-06-17 01:29:49+00:00,['527451ae0e1a5846f0deb248e935361a2c1b4704'],0,46,46,8546776,1,0.242424242,0.242424242,1,5441
be3e24451d4973e00db220a43698f4aabf231392,0,Yusaku Sako,2012-06-17 01:32:39+00:00,['beb74b56aa248b838570acd9046ce26f106224ca'],0,0,0,8546776,6,,,,5447
20b85fde19900a017ae62fd40ef989c330d93bbf,0,Yusaku Sako,2012-06-17 01:38:53+00:00,['be3e24451d4973e00db220a43698f4aabf231392'],2,2,4,8546780,1,,,,5447
4847bc274153c5b6be7bdb739e74087319be97fd,1,Yusaku Sako,2012-06-18 00:35:12+00:00,['20b85fde19900a017ae62fd40ef989c330d93bbf'],2,16,18,8546798,1,,,,5447
098989eccae1f68069cb36db78eec9eaeb71329a,1,Yusaku Sako,2012-06-18 01:01:19+00:00,['4847bc274153c5b6be7bdb739e74087319be97fd'],0,1,1,8546799,1,,,,5447
0509411d852b0cc6b83a19e2fa4b19227b28f29f,0,Yusaku Sako,2012-06-18 02:40:43+00:00,['098989eccae1f68069cb36db78eec9eaeb71329a'],0,1,1,8546800,1,,,,5447
21f2682606af22b2682f06252b83fd057bf55f3d,1,Yusaku Sako,2012-06-20 21:23:21+00:00,['0509411d852b0cc6b83a19e2fa4b19227b28f29f'],13,6,19,8546819,3,,,,5447
523ebcb257546d8d229f1baa2224e07fe54f07d1,1,Yusaku Sako,2012-06-21 00:45:14+00:00,['21f2682606af22b2682f06252b83fd057bf55f3d'],3848650,15,3848665,12395484,3442,0.547072479,0.294420866,0.106060606,5447
2cf95c27989f7379d7744dfbbf34247ce757f317,1,Yusaku Sako,2012-06-21 01:54:40+00:00,['523ebcb257546d8d229f1baa2224e07fe54f07d1'],1591,1372,2963,12398447,21,,,,5449
3525f0c25e1db139d301e0abba476b76e3e5ff03,0,Yusaku Sako,2012-06-21 20:43:14+00:00,['2cf95c27989f7379d7744dfbbf34247ce757f317'],1,24,25,12398472,2,,,,5450
64aa91b39140182c683b18c0886f862140f4f4f8,0,Hitesh Shah,2012-06-22 20:34:51+00:00,['3525f0c25e1db139d301e0abba476b76e3e5ff03'],1,3,4,12398476,2,,,,5450
ff7f6e9a411a35ce8a773e0ffb324030890200bf,1,Yusaku Sako,2012-06-23 00:20:18+00:00,['64aa91b39140182c683b18c0886f862140f4f4f8'],160,326,486,12398962,11,0,0.906976744,1,5450
f1bd46e5da52913d50e817ed95a24b7261f73ea9,0,Yusaku Sako,2012-06-25 21:05:04+00:00,['ff7f6e9a411a35ce8a773e0ffb324030890200bf'],1,4,5,12398967,2,,,,5450
72d9022253eb312e2692775e5e77f0d72ee1e111,1,Suhas,2012-06-26 01:09:01+00:00,['f1bd46e5da52913d50e817ed95a24b7261f73ea9'],14,37,51,12399018,6,,,,5450
471022197098f31d41babee52d270d5fbcc89e5c,1,Yusaku Sako,2012-06-26 01:46:22+00:00,['72d9022253eb312e2692775e5e77f0d72ee1e111'],4,171,175,12399193,5,,,,5450
427f102bc0623720096784ed15be6de185388263,0,Yusaku Sako,2012-06-26 18:37:16+00:00,['471022197098f31d41babee52d270d5fbcc89e5c'],0,7,7,12399200,2,0,1,1,5450
4711d26c25f550cc2e5dc45235f3da6ba0c9123a,0,Hitesh Shah,2012-06-26 22:20:28+00:00,['427f102bc0623720096784ed15be6de185388263'],1,3,4,12399204,2,,,,5450
67119f8e90aa95a6a56827677fbb8a1eee808cc0,0,Hitesh Shah,2012-06-26 22:23:45+00:00,['4711d26c25f550cc2e5dc45235f3da6ba0c9123a'],1,6,7,12399211,2,,,,5450
ca56976bdaf30af7a57d34fc8e66e1df2b1ecd3d,0,Hitesh Shah,2012-06-26 22:26:09+00:00,['67119f8e90aa95a6a56827677fbb8a1eee808cc0'],7,56,63,12399274,2,,,,5450
982404b52da6f7bf10044b707360ead47000cf51,0,Hitesh Shah,2012-06-26 22:28:00+00:00,['ca56976bdaf30af7a57d34fc8e66e1df2b1ecd3d'],0,36,36,12399310,3,,,,5450
02fed8d662efec1abe64e2c91e6df3a49393e1e6,0,Hitesh Shah,2012-06-26 22:31:44+00:00,['982404b52da6f7bf10044b707360ead47000cf51'],2,14,16,12399326,2,,,,5450
a4d35dd71bf26d3128a6155043f29e4f781567c5,0,Mahadev Konar,2012-06-27 01:24:52+00:00,['02fed8d662efec1abe64e2c91e6df3a49393e1e6'],4,4,8,12399334,1,,,,5450
1ae5c6dc8fdfd8968ad0854e869f8ab2802a8d08,1,Yusaku Sako,2012-06-27 23:01:50+00:00,['a4d35dd71bf26d3128a6155043f29e4f781567c5'],14,28,42,12399376,3,,,,5450
80731ec2a67175156165bb6c98df941455bae24d,0,Hitesh Shah,2012-06-28 00:27:10+00:00,['1ae5c6dc8fdfd8968ad0854e869f8ab2802a8d08'],0,12,12,12399388,3,1,1,1,5450
53060ecc80e7a82368bb36a5dfb40044885656a4,0,Hitesh Shah,2012-06-29 18:26:00+00:00,['80731ec2a67175156165bb6c98df941455bae24d'],7,10,17,12399405,4,,,,5450
3acc2cbcd67e83f9c78f3e3a6892f3626838780e,0,Hitesh Shah,2012-06-29 18:35:08+00:00,['53060ecc80e7a82368bb36a5dfb40044885656a4'],21,24,45,12399450,3,,,,5450
d1e09230b4f869d63f16f40efb60254aa3ccb604,0,Hitesh Shah,2012-06-29 18:56:00+00:00,['3acc2cbcd67e83f9c78f3e3a6892f3626838780e'],0,5,5,12399455,2,1,1,1,5450
92c68daa9b985e0bcacd2f7ecffd58f622a70621,0,Vikram Dixit K,2012-07-02 16:45:55+00:00,['d1e09230b4f869d63f16f40efb60254aa3ccb604'],37215,44561,81776,12481231,351,,,,5450
7530cca4abc478d70316f1ec18fec56daad726aa,0,Vikram Dixit K,2012-07-02 17:11:57+00:00,['92c68daa9b985e0bcacd2f7ecffd58f622a70621'],15,23,38,12481269,6,,,,5450
378c44fadc0288cc59367fd84078876e67435232,0,Vikram Dixit K,2012-07-02 17:17:39+00:00,['7530cca4abc478d70316f1ec18fec56daad726aa'],0,0,0,12481269,0,,,,5450
478293206750f29e5b3890e05a33634893002da3,0,Vikram Dixit K,2012-07-02 17:31:48+00:00,['378c44fadc0288cc59367fd84078876e67435232'],5,7,12,12481281,5,,,,5450
50761a7b72a6139d1df4ff12101b9a3a3b7fafc7,0,Vinod Kumar Vavilapalli,2012-07-03 01:49:16+00:00,"['478293206750f29e5b3890e05a33634893002da3', 'd1e09230b4f869d63f16f40efb60254aa3ccb604']",44591,37235,81826,12563107,360,,,,5450
fc42a8e7dbe2a7bdcb7b5ecebe6a2c1a89e3fcb6,1,Vikram Dixit K,2012-07-03 02:08:26+00:00,['50761a7b72a6139d1df4ff12101b9a3a3b7fafc7'],21,6192,6213,12569320,303,,,,5450
7a9db56ec77751163b080703775f7dbe32755683,0,Vikram Dixit K,2012-07-03 02:14:55+00:00,['fc42a8e7dbe2a7bdcb7b5ecebe6a2c1a89e3fcb6'],105,18,123,12569443,6,,,,5451
0987865cada16319371938b8d1c15d1ff9e1f6ae,0,Vinod Kumar Vavilapalli,2012-07-03 02:19:20+00:00,"['7530cca4abc478d70316f1ec18fec56daad726aa', '7a9db56ec77751163b080703775f7dbe32755683']",44604,43334,87938,12657381,652,,,,5451
ef9612df93912f03462ec8d3b22c4563db8c6fc5,1,Vikram Dixit K,2012-07-03 03:00:07+00:00,['0987865cada16319371938b8d1c15d1ff9e1f6ae'],0,492,492,12657873,4,,,,5455
9d1d25afd9f3cfb07d0aba6b06f9b8756162a0c7,1,Yusaku Sako,2012-07-03 19:18:37+00:00,['ef9612df93912f03462ec8d3b22c4563db8c6fc5'],15,24,39,12657912,6,,,,5455
29182c918dfb4bb628366180d43c4a1a15e6bb5f,0,Vikram Dixit K,2012-07-03 20:25:50+00:00,['9d1d25afd9f3cfb07d0aba6b06f9b8756162a0c7'],11,769,780,12658692,41,,,,5455
6a0685c6a68fc47e093d00e48455400c4e4d85ea,1,Vikram Dixit K,2012-07-03 21:03:32+00:00,['29182c918dfb4bb628366180d43c4a1a15e6bb5f'],2,10,12,12658704,2,,,,5455
d8b28741768d03c54cd7b44d58ff13d73c8b7d6c,0,Yusaku Sako,2012-07-03 21:13:48+00:00,['6a0685c6a68fc47e093d00e48455400c4e4d85ea'],137,117,254,12658958,23,,,,5455
8397a0026d9caf9228b5cdcfc050427c381e1d23,0,Vikram Dixit K,2012-07-03 21:56:13+00:00,['d8b28741768d03c54cd7b44d58ff13d73c8b7d6c'],0,8,8,12658966,2,,,,5455
2a59a6db2f487a5e08af269d7dd4dc91c5384bbd,1,Yusaku Sako,2012-07-04 00:20:02+00:00,['8397a0026d9caf9228b5cdcfc050427c381e1d23'],6,20,26,12658992,11,,,,5455
22235bbeda81b4c525d103506c23904a74d238f4,0,Yusaku Sako,2012-07-04 03:13:26+00:00,['2a59a6db2f487a5e08af269d7dd4dc91c5384bbd'],114,48,162,12659154,2,,,,5455
af9c98adce269045b77e8ba81911bed89784a12c,0,Yusaku Sako,2012-07-04 04:20:01+00:00,['22235bbeda81b4c525d103506c23904a74d238f4'],76,84,160,12659314,3,0,0,1,5455
5333dc267848a6422e8ca24f21d063e0ceb67382,1,Vinod Kumar Vavilapalli,2012-07-04 19:56:40+00:00,['af9c98adce269045b77e8ba81911bed89784a12c'],0,2,2,12659316,6,,,,5455
514df0167cd4020d4d8d5c84e976e65794bd8979,0,Vikram Dixit K,2012-07-04 19:59:25+00:00,['5333dc267848a6422e8ca24f21d063e0ceb67382'],2,3,5,12659321,2,,,,5455
7ab2433aed2bfe5ebbcdea3f6c5d3e760d940a55,0,Vinod Kumar Vavilapalli,2012-07-04 20:07:00+00:00,['514df0167cd4020d4d8d5c84e976e65794bd8979'],1,4,5,12659326,8,,,,5455
52245ea705607c1fbc304edbab58c5ed60674105,0,Mahadev Konar,2012-07-05 06:12:57+00:00,['7ab2433aed2bfe5ebbcdea3f6c5d3e760d940a55'],19,9,28,12659354,14,,,,5455
3c159ed01c1d68ef55fc59554ce0fbecd264dc18,0,Yusaku Sako,2012-07-05 17:58:28+00:00,['52245ea705607c1fbc304edbab58c5ed60674105'],892,578,1470,12660824,7,0.293706294,0,0,5455
ca2e5e5accd9ecfb17d7d3d27b4ad04e87fc6085,0,Yusaku Sako,2012-07-05 18:42:33+00:00,['3c159ed01c1d68ef55fc59554ce0fbecd264dc18'],4,3,7,12660831,2,,,,5455
6d7b4fe5c36f48df4a7d0e7cca0c44e5a3c46bc9,0,Hitesh Shah,2012-07-05 18:45:29+00:00,['ca2e5e5accd9ecfb17d7d3d27b4ad04e87fc6085'],11,23,34,12660865,5,0,0.666666667,1,5455
e5ba4356fb46a419bcf94fdc1580c9d179ab6e16,0,Hitesh Shah,2012-07-05 22:10:00+00:00,['6d7b4fe5c36f48df4a7d0e7cca0c44e5a3c46bc9'],2,18,20,12660885,3,,,,5455
17e010dc01226cafd51fdde0cde16e35a5303767,1,Yusaku Sako,2012-07-06 04:46:36+00:00,['e5ba4356fb46a419bcf94fdc1580c9d179ab6e16'],862,1324,2186,12663071,45,0.805860806,0.917582418,0.963369963,5463
a6fe13cec247a39fc67e492b68b9a8129e7c8dea,1,Yusaku Sako,2012-07-06 21:03:24+00:00,['17e010dc01226cafd51fdde0cde16e35a5303767'],81,12,93,12663164,2,1,1,0,5463
d3e09a44a6334131d45a4d1433bfba5bfdbd5bc5,0,Yusaku Sako,2012-07-06 21:20:42+00:00,['a6fe13cec247a39fc67e492b68b9a8129e7c8dea'],5,8,13,12663177,3,,,,5463
9e656189a36895664fe2a778aac9199448341647,0,Hitesh Shah,2012-07-06 21:21:26+00:00,['d3e09a44a6334131d45a4d1433bfba5bfdbd5bc5'],3,6,9,12663186,4,,,,5463
b0251a61a6361781932a04b5f7f66b476fb0c3cb,1,Mahadev Konar,2012-07-06 23:56:21+00:00,['9e656189a36895664fe2a778aac9199448341647'],75,325,400,12663586,8,0.05,1,1,5466
fef20a96f03ff323983181ea7d1a17955eaa6725,1,Yusaku Sako,2012-07-07 18:47:32+00:00,['b0251a61a6361781932a04b5f7f66b476fb0c3cb'],61,190,251,12663837,12,0.634920635,1,1,5467
bcb61cfe1963480b8654e1a4f4e7cf2e6fd2bcc9,0,Yusaku Sako,2012-07-07 19:38:38+00:00,['fef20a96f03ff323983181ea7d1a17955eaa6725'],14,3,17,12663854,2,,,,5467
1fbada057b95f7242db6197b2bcbb295f407c078,1,Yusaku Sako,2012-07-09 19:26:11+00:00,['bcb61cfe1963480b8654e1a4f4e7cf2e6fd2bcc9'],121,256,377,12664231,5,1,1,1,5467
2bcd0bcd29e92872192746612f9f3eeb0acf439c,0,Vikram Dixit K,2012-07-10 01:52:34+00:00,['1fbada057b95f7242db6197b2bcbb295f407c078'],0,2,2,12664233,1,,,,5467
844e3b812ba37315a766a1b15f336f629570e2a7,0,Vinod Kumar Vavilapalli,2012-07-10 01:56:32+00:00,['2bcd0bcd29e92872192746612f9f3eeb0acf439c'],0,5,5,12664238,2,,,,5467
a3f439077f91643c7b357c8eed7a819400e1068e,0,Vikram Dixit K,2012-07-10 02:20:21+00:00,['844e3b812ba37315a766a1b15f336f629570e2a7'],0,14,14,12664252,2,,,,5467
b3d9b50a7443f62948a88ed16a0365c2a8f15347,0,Vinod Kumar Vavilapalli,2012-07-10 02:21:38+00:00,['a3f439077f91643c7b357c8eed7a819400e1068e'],20,32,52,12664304,1,,,,5467
ea50845055387d473f681046184fc8032b17a217,1,Yusaku Sako,2012-07-10 20:02:25+00:00,['b3d9b50a7443f62948a88ed16a0365c2a8f15347'],409,426,835,12665139,24,0.266666667,1,0.755555556,5467
7f7f7997218e2c524117c8f52e11b290db98ae27,1,Yusaku Sako,2012-07-11 02:40:52+00:00,['ea50845055387d473f681046184fc8032b17a217'],19,65,84,12665223,5,0.074074074,0.333333333,1,5467
0c5c23d17aa79236a2fee31b53ebe4b2bb3979bd,0,Mahadev Konar,2012-07-11 06:22:46+00:00,['7f7f7997218e2c524117c8f52e11b290db98ae27'],10,79,89,12665312,2,0.318181818,0.318181818,1,5467
7d81eccbe051307e0b64f72f4c8d0af096d0c3af,1,Yusaku Sako,2012-07-11 17:14:48+00:00,['0c5c23d17aa79236a2fee31b53ebe4b2bb3979bd'],14,634,648,12665960,9,0.592814371,1,1,5471
c909710980466dea3003214b5d64ee742511ce6a,0,Hitesh Shah,2012-07-11 18:43:13+00:00,['7d81eccbe051307e0b64f72f4c8d0af096d0c3af'],1,4,5,12665965,2,0,0,0,5471
2df62d477d104a01e5d8bfd2aa2fbc6bf91954e2,1,Hitesh Shah,2012-07-11 22:17:37+00:00,['c909710980466dea3003214b5d64ee742511ce6a'],25,59,84,12666049,7,,,,5471
afac1fa4e0211e28d8e86254e133151f14d133dc,0,Yusaku Sako,2012-07-11 23:47:22+00:00,['2df62d477d104a01e5d8bfd2aa2fbc6bf91954e2'],6,22,28,12666077,2,0,1,1,5471
8e8be57f669f86ee3d9c2a69cb8740220e199b9d,1,Hitesh Shah,2012-07-12 00:01:14+00:00,['afac1fa4e0211e28d8e86254e133151f14d133dc'],1,3,4,12666081,2,,,,5471
2d13c90c58c468bacc49733c7cc7b80a9ee6258e,0,Hitesh Shah,2012-07-12 00:20:39+00:00,['8e8be57f669f86ee3d9c2a69cb8740220e199b9d'],1,4,5,12666086,2,,,,5471
3cba294de404afd9187f16f4b9afa06eccca19c4,0,Yusaku Sako,2012-07-12 01:11:15+00:00,['2d13c90c58c468bacc49733c7cc7b80a9ee6258e'],14,57,71,12666157,6,1,1,1,5471
8dcfa29533b39d606e373493760415a795d25f8f,0,Yusaku Sako,2012-07-12 18:23:18+00:00,['3cba294de404afd9187f16f4b9afa06eccca19c4'],10,12,22,12666179,2,,,,5471
1d68d43e9271fbe2d3df870e5f4ceabe5e326cab,0,Mahadev Konar,2012-07-12 20:40:23+00:00,['8dcfa29533b39d606e373493760415a795d25f8f'],3,39,42,12666221,4,,,,5471
c5774212fa1fdc46215cc059166ffbedd63acd8c,0,Hitesh Shah,2012-07-12 21:23:46+00:00,['1d68d43e9271fbe2d3df870e5f4ceabe5e326cab'],5,5,10,12666231,2,,,,5471
9950c6d73e31a6d5b7e9ea146ea110ce037c5edd,0,Yusaku Sako,2012-07-12 23:41:07+00:00,['c5774212fa1fdc46215cc059166ffbedd63acd8c'],54,130,184,12666415,10,0.428571429,0.892857143,1,5472
97dfaf4aaa787b8a67e556da4c33625741535bb5,0,Yusaku Sako,2012-07-13 17:25:45+00:00,['9950c6d73e31a6d5b7e9ea146ea110ce037c5edd'],0,10,10,12666425,3,0,0,1,5472
cf3a82fa0fa23707159540829fb43065d6b23944,1,Yusaku Sako,2012-07-14 02:09:24+00:00,['97dfaf4aaa787b8a67e556da4c33625741535bb5'],26,325,351,12666776,11,0.289617486,0.355191257,0.950819672,5472
25a72b004aaeb13886d5d6ba2118a59ba842e273,0,Yusaku Sako,2012-07-16 16:59:44+00:00,['cf3a82fa0fa23707159540829fb43065d6b23944'],6,109,115,12666891,2,1,1,1,5472
f4484b56dfef336236ea0147ac4aa1aa539bff0b,0,Yusaku Sako,2012-07-16 20:12:51+00:00,['25a72b004aaeb13886d5d6ba2118a59ba842e273'],127,132,259,12667150,2,0,0,1,5472
ec00127b69b937e834309af905ac1c39e1b1a223,0,Hitesh Shah,2012-07-16 23:47:48+00:00,['f4484b56dfef336236ea0147ac4aa1aa539bff0b'],49,21,70,12667220,8,0.75,0.75,1,5472
e4f29afb847c201dffc353ae79bd1e627f56f634,1,Yusaku Sako,2012-07-17 00:56:52+00:00,['ec00127b69b937e834309af905ac1c39e1b1a223'],12,63,75,12667295,4,1,1,1,5472
9070da9196d5c73483d42c1d64e5dd5896197e76,0,Yusaku Sako,2012-07-17 03:04:56+00:00,['e4f29afb847c201dffc353ae79bd1e627f56f634'],14,29,43,12667338,7,1,1,1,5472
5f6f04fc25ce6e3991d1839fcf5400b430e95b53,0,Varun Kapoor,2012-07-17 03:07:53+00:00,['9070da9196d5c73483d42c1d64e5dd5896197e76'],0,171,171,12667509,2,1,1,1,5473
bb3716d836ffd42c5b32ea64118ad5b319cb0f40,0,Varun Kapoor,2012-07-17 18:57:57+00:00,['5f6f04fc25ce6e3991d1839fcf5400b430e95b53'],0,3,3,12667512,1,,,,5473
d182e933e81edcec8930a489c3410aeb888f88f2,1,Jitendra Nath Pandey,2012-07-17 20:16:37+00:00,['bb3716d836ffd42c5b32ea64118ad5b319cb0f40'],122,1886,2008,12669520,67,0.492260062,0.46130031,0.938080495,5488
4ebc9106a85cd49fac12e427a617895a9139164b,0,Jitendra Nath Pandey,2012-07-17 21:48:10+00:00,['d182e933e81edcec8930a489c3410aeb888f88f2'],0,2,2,12669522,2,,,,5489
3688c6cf8be078ada9b09ff5a7978f22cb892958,0,Suhas,2012-07-17 22:13:23+00:00,['4ebc9106a85cd49fac12e427a617895a9139164b'],1,10,11,12669533,2,,,,5489
3daf0169ede1eb77ffc05174dffceb4fa4d71947,0,Jitendra Nath Pandey,2012-07-17 22:34:06+00:00,['3688c6cf8be078ada9b09ff5a7978f22cb892958'],2,0,2,12669535,2,,,,5489
e9f971bc18f9e3b4343de8bbaed0f000d1036918,0,Jitendra Nath Pandey,2012-07-18 20:34:05+00:00,['3daf0169ede1eb77ffc05174dffceb4fa4d71947'],68,6,74,12669609,5,,0,,5489
f7b6797e3cd9c509e7f14406cc32bc4bb7db7758,0,Yusaku Sako,2012-07-18 21:08:37+00:00,['e9f971bc18f9e3b4343de8bbaed0f000d1036918'],517,556,1073,12670682,19,,,,5489
8d1c1c1d9405c0d51c6076f3aa9f85c2c027ed1b,0,Hitesh Shah,2012-07-18 22:02:15+00:00,['f7b6797e3cd9c509e7f14406cc32bc4bb7db7758'],8,3,11,12670693,2,,,,5489
bd1aabcda7e2bf227deee7851516f2f51ee5582e,1,Jitendra Nath Pandey,2012-07-19 00:07:39+00:00,['8d1c1c1d9405c0d51c6076f3aa9f85c2c027ed1b'],1,42,43,12670736,5,1,1,1,5489
cbde01bae4fd76b856838e1de32426964e048fcf,0,Yusaku Sako,2012-07-19 02:01:56+00:00,['bd1aabcda7e2bf227deee7851516f2f51ee5582e'],21,21,42,12670778,12,0,1,1,5489
e87d66dd20129f1d3e9ff80eba4cdf943fe6421b,0,Yusaku Sako,2012-07-19 02:46:24+00:00,['cbde01bae4fd76b856838e1de32426964e048fcf'],37,40,77,12670855,6,1,0,0,5489
9c8f1093ccc2c3e2291f5146f04bca735be3077c,1,Yusaku Sako,2012-07-19 06:18:15+00:00,['e87d66dd20129f1d3e9ff80eba4cdf943fe6421b'],2,8,10,12670865,4,1,1,1,5489
1551d6783f9ebcde7ccd6473a7f97a580c2e35fb,0,Yusaku Sako,2012-07-19 07:03:52+00:00,['9c8f1093ccc2c3e2291f5146f04bca735be3077c'],7,3,10,12670875,2,,,,5489
e2ea83cd6283554997babc64ae07f7b88554d094,0,Hitesh Shah,2012-07-19 17:54:29+00:00,['1551d6783f9ebcde7ccd6473a7f97a580c2e35fb'],1,4,5,12670880,2,,,,5489
8cdd3c5a0bbafd20a97729a495967a3ef07c9e12,0,Hitesh Shah,2012-07-19 18:11:24+00:00,['e2ea83cd6283554997babc64ae07f7b88554d094'],5,12,17,12670897,2,,,,5489
ee98cb2e7b01dbae31268e4fdc4565f79ba396dd,0,Yusaku Sako,2012-07-19 18:30:22+00:00,['8cdd3c5a0bbafd20a97729a495967a3ef07c9e12'],5,9,14,12670911,2,0,1,0,5489
2694413ece88032b87bc1d555cadf6c3f169aab9,1,Jitendra Nath Pandey,2012-07-20 04:24:13+00:00,['ee98cb2e7b01dbae31268e4fdc4565f79ba396dd'],34,28,62,12670973,8,,,,5489
9f59c811838bd6a9f36e77b0b80986a21504490f,0,Jitendra Nath Pandey,2012-07-23 21:40:12+00:00,['2694413ece88032b87bc1d555cadf6c3f169aab9'],79,137,216,12671189,10,1,1,1,5489
ac4c1d89a096e939afbd59399b0b5d7702bd53e4,0,Yusaku Sako,2012-07-30 02:06:23+00:00,['9f59c811838bd6a9f36e77b0b80986a21504490f'],10,12,22,12671211,5,,,,5489
1976bc6bf5b6a7623f1dac8089a833ea6bfac08e,0,Mahadev Konar,2012-08-13 03:15:04+00:00,['ac4c1d89a096e939afbd59399b0b5d7702bd53e4'],3,4,7,12671218,4,,,,5489
50417576bcb1cfaaae85c212a0f444c855e29d16,0,Jitendra Nath Pandey,2012-08-14 23:20:25+00:00,['1976bc6bf5b6a7623f1dac8089a833ea6bfac08e'],0,0,0,12671218,0,,,,5489
72c970336df900cdb41cd27ae80d239636492061,0,Jitendra Nath Pandey,2012-08-16 08:18:00+00:00,['1976bc6bf5b6a7623f1dac8089a833ea6bfac08e'],2,9,11,12671229,2,0,0,1,5489
e21a3eb258c6ea80c72a303f33931744b58038d4,0,Hitesh Shah,2012-08-16 19:00:36+00:00,['72c970336df900cdb41cd27ae80d239636492061'],0,21,21,12671250,2,,,,5489
5631cdabcac794ed8db6741a7ad60976c358f402,0,Hitesh Shah,2012-08-16 21:54:44+00:00,['e21a3eb258c6ea80c72a303f33931744b58038d4'],10,20,30,12671280,4,,,,5489
6de2e35b0c73e8ae0885cfd7e63834bdf24a84a5,1,Hitesh Shah,2012-08-18 01:38:09+00:00,['5631cdabcac794ed8db6741a7ad60976c358f402'],2,43,45,12671325,4,,,,5490
0512d3aa31a639b49c2c55b15f60ab9053685e14,1,Yusaku Sako,2012-08-21 20:55:08+00:00,['6de2e35b0c73e8ae0885cfd7e63834bdf24a84a5'],0,42,42,12671367,3,0.058823529,1,1,5490
0122db7fbe416b2eb159e66b85467cdef5c0dc8f,0,Jitendra Nath Pandey,2012-08-21 21:40:52+00:00,['0512d3aa31a639b49c2c55b15f60ab9053685e14'],0,7,7,12671374,2,,,,5490
8fb5cced36412457431e60976fedd7b4cf01eee6,0,Hitesh Shah,2012-08-22 22:13:18+00:00,['0122db7fbe416b2eb159e66b85467cdef5c0dc8f'],2,6,8,12671382,2,,,,5490
b802241f41d0b090c83951fdb19f3727c881cb6e,1,Jitendra Nath Pandey,2012-08-22 23:21:16+00:00,['50417576bcb1cfaaae85c212a0f444c855e29d16'],0,501,501,12671883,8,0.484848485,1,1,5498
8b1ecf1f687cb8664df3d5e36500b04d9243edb7,0,Hitesh Shah,2012-08-22 23:53:30+00:00,['b802241f41d0b090c83951fdb19f3727c881cb6e'],182250,0,182250,12854133,1023,0.617381614,0.418853553,0.135315512,5498
06f2a0792d20de8f1d23cde46e390c44b5f6ac3d,0,Hitesh Shah,2012-08-23 22:53:54+00:00,['8fb5cced36412457431e60976fedd7b4cf01eee6'],0,16,16,12854149,2,0,0,1,5498
5d7dfedfd062bf9775625c4e78cfc4d88217a9e6,1,Yusaku Sako,2012-08-23 23:42:30+00:00,['06f2a0792d20de8f1d23cde46e390c44b5f6ac3d'],16,22,38,12854187,2,0,0,1,5498
5125dfe4d9af779087ab993c5f4c8a0fb6489ee5,0,Hitesh Shah,2012-08-23 23:50:19+00:00,['8b1ecf1f687cb8664df3d5e36500b04d9243edb7'],52,25,77,12854264,3,,,,5498
7c2a5b673c400a41fdd8a96b9f51f77ebdf9dd1f,1,Hitesh Shah,2012-08-24 17:28:11+00:00,['5125dfe4d9af779087ab993c5f4c8a0fb6489ee5'],0,204,204,12854468,2,,,,5500
0d373d07a9db239d2fef37d84b7fd928ec13f613,0,Jitendra Nath Pandey,2012-08-24 20:58:20+00:00,['5d7dfedfd062bf9775625c4e78cfc4d88217a9e6'],2,4,6,12854474,2,,,,5500
3f0edea47e71f0746cf959b48418c8a10d323dde,0,Jitendra Nath Pandey,2012-08-24 21:07:42+00:00,['0d373d07a9db239d2fef37d84b7fd928ec13f613'],4,6,10,12854484,3,,,,5500
43544ff3f69272c6f29464aedbb1838406a3c68d,0,Jitendra Nath Pandey,2012-08-24 21:39:39+00:00,['3f0edea47e71f0746cf959b48418c8a10d323dde'],1,3,4,12854488,2,,,,5500
aeeb3a0da1e6f9b822b0678f02e057e9d107a933,1,Yusaku Sako,2012-08-25 02:39:44+00:00,['43544ff3f69272c6f29464aedbb1838406a3c68d'],88,64,152,12854640,3,,,,5500
c46f9fa07a64b45459a4bcab4557f2fb940d8415,0,Yusaku Sako,2012-08-27 16:49:04+00:00,['aeeb3a0da1e6f9b822b0678f02e057e9d107a933'],2,23,25,12854665,2,0,0,1,5500
87fbfc5db7a0b55e33c083f460f8468029a9f479,0,Yusaku Sako,2012-08-27 19:02:14+00:00,['c46f9fa07a64b45459a4bcab4557f2fb940d8415'],2,5,7,12854672,2,,,,5500
f20c25ec6191ea3c7216eb9145ed4395e2ba4bc6,0,Mahadev Konar,2012-08-29 00:24:31+00:00,['87fbfc5db7a0b55e33c083f460f8468029a9f479'],6,9,15,12854687,3,,,,5500
0c96cc32d9441b785181a65ab0eaad8686750b7e,0,Jitendra Nath Pandey,2012-08-29 00:35:21+00:00,['7c2a5b673c400a41fdd8a96b9f51f77ebdf9dd1f'],0,4,4,12854691,1,,,,5501
4cf83b9a7d42699a3b47d6f578299013fa6ab75f,1,Jitendra Nath Pandey,2012-08-29 08:49:31+00:00,['0c96cc32d9441b785181a65ab0eaad8686750b7e'],165,1856,2021,12856712,41,0.94516129,1,0.767741935,5538
4994ad236333afd4e6356a3e367381925eae4228,0,Hitesh Shah,2012-08-30 18:14:16+00:00,['4cf83b9a7d42699a3b47d6f578299013fa6ab75f'],0,2,2,12856714,1,,,,5538
67a2025232c599eb9111b25168565807e1c1c1e8,0,Yusaku Sako,2012-08-30 22:25:21+00:00,['f20c25ec6191ea3c7216eb9145ed4395e2ba4bc6'],18,21,39,12856753,8,,,,5538
5611afd22d85ddab52afaca9f8ba2e6cae4924c6,0,Mahadev Konar,2012-08-31 21:25:08+00:00,['4994ad236333afd4e6356a3e367381925eae4228'],0,67,67,12856820,1,,,,5538
e654c60844caca7c1b627ce0584f0452c4e9500a,0,Jitendra Nath Pandey,2012-09-01 06:46:52+00:00,['5611afd22d85ddab52afaca9f8ba2e6cae4924c6'],0,257,257,12857077,7,1,1,0.130434783,5544
d7b3ccddfb90022d624b24578c12cfb192cbe88a,1,Hitesh Shah,2012-09-04 17:57:06+00:00,['e654c60844caca7c1b627ce0584f0452c4e9500a'],597,655,1252,12858329,38,0,0,0,5557
c104d29e1526ee22dab4ad4fe255d1cc1cf0c5de,1,Jitendra Nath Pandey,2012-09-04 21:26:47+00:00,['d7b3ccddfb90022d624b24578c12cfb192cbe88a'],7,124,131,12858460,6,1,1,0,5561
42118f0e8e56f41f4450c754d4066a58011dd778,0,Hitesh Shah,2012-09-04 22:02:37+00:00,['c104d29e1526ee22dab4ad4fe255d1cc1cf0c5de'],489,536,1025,12859485,43,1,1,1,5569
92aa6d537a1d2e73580634b2f693411dcab81360,1,Yusaku Sako,2012-09-05 02:39:09+00:00,['42118f0e8e56f41f4450c754d4066a58011dd778'],0,39218,39218,12898703,60,0.631107817,0.774901648,0.8422373,5628
6a3917ef4bacf204a9149e52fcd84c3a3003768e,0,Mahadev Konar,2012-09-05 05:07:30+00:00,['92aa6d537a1d2e73580634b2f693411dcab81360'],43,513,556,12899259,10,0.58490566,1,1,5633
de1e2167054d0aa84524cad975785714ff5d6a74,0,Mahadev Konar,2012-09-05 05:22:24+00:00,['6a3917ef4bacf204a9149e52fcd84c3a3003768e'],513,43,556,12899815,10,0.41509434,0,0,5633
2e2a012ae6ef509c2e9de50859702e9a57c4e61f,1,Mahadev Konar,2012-09-05 05:26:12+00:00,['de1e2167054d0aa84524cad975785714ff5d6a74'],26,359,385,12900200,9,0.58490566,1,1,5638
4b510f22737b0e1e650b0cd888a654fd9917dc68,0,Yusaku Sako,2012-09-05 06:24:48+00:00,['67a2025232c599eb9111b25168565807e1c1c1e8'],0,4,4,12900204,2,,,,5638
073c43ab2501a9ff3494c73ce49f17e0a2372356,0,Hitesh Shah,2012-09-05 17:27:29+00:00,['2e2a012ae6ef509c2e9de50859702e9a57c4e61f'],0,75,75,12900279,3,,,,5640
0d08e61db8bc902b8f99ff4c526379b3a968144d,1,Mahadev Konar,2012-09-06 07:42:18+00:00,['073c43ab2501a9ff3494c73ce49f17e0a2372356'],23,2261,2284,12902563,30,0.31871345,0.625730994,0.807992203,5665
bb8f9726b2712a4eb56ea0e7e2570a2f089753a2,1,Mahadev Konar,2012-09-06 07:50:53+00:00,['0d08e61db8bc902b8f99ff4c526379b3a968144d'],0,34,34,12902597,1,,,,5666
53fc74b27397be7251fc84a53bf20096e9b3eb3b,1,Jitendra Nath Pandey,2012-09-07 08:11:46+00:00,['bb8f9726b2712a4eb56ea0e7e2570a2f089753a2'],8,381,389,12902986,16,1,1,0.971428571,5678
0c5f8d21dc935bad434fd54f918b47e828f5a397,1,Hitesh Shah,2012-09-07 15:11:12+00:00,['53fc74b27397be7251fc84a53bf20096e9b3eb3b'],419,1495,1914,12904900,46,0.799426934,1,0.962750716,5689
e3c43f41dbaab68b0784c594d5452000444787dd,0,Hitesh Shah,2012-09-07 17:36:18+00:00,['4b510f22737b0e1e650b0cd888a654fd9917dc68'],9,72,81,12904981,3,0,0.47826087,0.782608696,5689
c50a084999214cb5549086e6b96b93583481a270,1,Hitesh Shah,2012-09-07 21:53:49+00:00,['0c5f8d21dc935bad434fd54f918b47e828f5a397'],11,257,268,12905249,7,0.248366013,1,0.941176471,5690
e3e237a088626235d518087a25069115ea905bd4,1,Hitesh Shah,2012-09-08 00:03:34+00:00,['c50a084999214cb5549086e6b96b93583481a270'],18,116,134,12905383,10,0.632653061,1,0.87755102,5690
39b327df9e82c72f984e3eff7158f98e646aed65,1,Mahadev Konar,2012-09-09 06:42:00+00:00,['e3e237a088626235d518087a25069115ea905bd4'],13,91,104,12905487,3,0.26984127,1,1,5690
0c74d8120ad5469cb67ba243c81acaa552afe3be,1,Mahadev Konar,2012-09-10 05:26:34+00:00,['39b327df9e82c72f984e3eff7158f98e646aed65'],6,552,558,12906045,10,0.945736434,1,1,5696
aeb482b35d98368a83dac7b47e7d789e71325cae,1,Jitendra Nath Pandey,2012-09-10 20:49:40+00:00,['0c74d8120ad5469cb67ba243c81acaa552afe3be'],1,129,130,12906175,6,1,1,1,5699
8d9a423e44630fb73ce70857069db7dc26eefbb1,0,Hitesh Shah,2012-09-10 20:51:10+00:00,['aeb482b35d98368a83dac7b47e7d789e71325cae'],264,602,866,12907041,49,0.821989529,1,1,5705
fdfc5b1af1bae0b665ebde475dc2a3d625734c06,1,Mahadev Konar,2012-09-11 02:32:14+00:00,['8d9a423e44630fb73ce70857069db7dc26eefbb1'],363,507,870,12907911,26,1,1,1,5707
2aa804d35228466d682a1b406f7df5e9c8c5eed7,1,Yusaku Sako,2012-09-11 03:25:58+00:00,['fdfc5b1af1bae0b665ebde475dc2a3d625734c06'],1086,2645,3731,12911642,18,0.736986301,0.789041096,0.994520548,5707
083730abf851fa1bc625d82d948249594ea50870,1,Yusaku Sako,2012-09-11 04:45:38+00:00,['2aa804d35228466d682a1b406f7df5e9c8c5eed7'],42,390,432,12912074,20,1,1,1,5712
8ecbba906799677772a814e85e8bf0e3620cbdc4,0,Yusaku Sako,2012-09-11 05:06:22+00:00,['083730abf851fa1bc625d82d948249594ea50870'],5,7,12,12912086,4,,,,5712
c2e1cdf80275862320edb006fb69cb1d2c826593,1,Mahadev Konar,2012-09-11 06:48:20+00:00,['8ecbba906799677772a814e85e8bf0e3620cbdc4'],141,320,461,12912547,11,0.13559322,1,1,5713
1c8b4722119a1981ff72d3d9796b41b14b0d4de6,1,Yusaku Sako,2012-09-11 09:05:53+00:00,['c2e1cdf80275862320edb006fb69cb1d2c826593'],75,1128,1203,12913750,6,,,,5714
59f4eca26e93d67cb38e71ce4d6d63cb3c0146ee,1,Yusaku Sako,2012-09-11 16:27:36+00:00,['1c8b4722119a1981ff72d3d9796b41b14b0d4de6'],22,58,80,12913830,13,,,,5714
9e490a515e58de27432c1c12ed97890c5d416a96,0,Mahadev Konar,2012-09-11 20:33:50+00:00,['59f4eca26e93d67cb38e71ce4d6d63cb3c0146ee'],131,3,134,12913964,2,0,0,0,5714
706e122e1c1095308bb06e05e3986344fbe32705,0,Hitesh Shah,2012-09-11 21:35:23+00:00,['9e490a515e58de27432c1c12ed97890c5d416a96'],43,75,118,12914082,8,1,1,1,5714
6dd57d2bd5155c0929a79bfb5a81575e431dd415,0,Hitesh Shah,2012-09-11 21:36:31+00:00,['706e122e1c1095308bb06e05e3986344fbe32705'],0,125,125,12914207,1,0.824175824,1,0.637362637,5715
0333bbe196c65f91a7baaa9b67e9a700ceada0b2,1,Yusaku Sako,2012-09-12 06:12:22+00:00,['6dd57d2bd5155c0929a79bfb5a81575e431dd415'],121,311,432,12914639,7,0.241758242,1,1,5716
5195019cd385d33dd83576a8457e38a651cc2d26,0,Hitesh Shah,2012-09-12 22:17:28+00:00,['0333bbe196c65f91a7baaa9b67e9a700ceada0b2'],183,480,663,12915302,24,0.551724138,1,0.75862069,5718
897e5fd8b82d23cbb08304337fca34fac774c012,1,Hitesh Shah,2012-09-12 22:22:10+00:00,['5195019cd385d33dd83576a8457e38a651cc2d26'],0,4292,4292,12919594,45,0.916079812,0.800469484,0.986502347,5760
044f32e6274bd2e915c9aba9b3637792b52ea994,0,Yusaku Sako,2012-09-12 22:42:28+00:00,['897e5fd8b82d23cbb08304337fca34fac774c012'],346,542,888,12920482,13,0.602941176,1,1,5763
be60c7ca2f99111dbe076aec54a335ed28976960,1,Mahadev Konar,2012-09-12 23:50:59+00:00,['044f32e6274bd2e915c9aba9b3637792b52ea994'],122,375,497,12920979,26,1,1,1,5765
b07fc30275fd37bca9c552f31637b2c8d68532c5,1,Mahadev Konar,2012-09-14 01:36:50+00:00,['be60c7ca2f99111dbe076aec54a335ed28976960'],9,153,162,12921141,7,1,1,1,5767
bf83b98f8c45fa51a3cd3cc8e8787396e354a0c8,1,Jitendra Nath Pandey,2012-09-14 06:24:50+00:00,['b07fc30275fd37bca9c552f31637b2c8d68532c5'],19,345,364,12921505,6,0.672727273,0.75,0.936363636,5767
5edd07b75d0d8cbfa71404508868ea35c0a17fc1,1,Mahadev Konar,2012-09-14 07:04:05+00:00,['bf83b98f8c45fa51a3cd3cc8e8787396e354a0c8'],2,334,336,12921841,7,1,1,1,5772
6d10fec9e8229adcca07529611b4cd2d0db7615a,1,Yusaku Sako,2012-09-14 22:43:24+00:00,['5edd07b75d0d8cbfa71404508868ea35c0a17fc1'],42,1199,1241,12923082,29,1,1,1,5793
33169c13a03cdd1a1b1150fd68f8cfd81eb4ca45,1,Yusaku Sako,2012-09-14 22:57:36+00:00,['6d10fec9e8229adcca07529611b4cd2d0db7615a'],49,361,410,12923492,13,1,0,1,5796
d4552f3dea5a19cc9370e39bf36ddeb62759e99b,0,Hitesh Shah,2012-09-15 00:00:27+00:00,['33169c13a03cdd1a1b1150fd68f8cfd81eb4ca45'],46,871,917,12924409,19,0.417582418,0.923076923,0.57967033,5806
9a525ef0227c763fdfdb8822a9796be5c5e80355,1,Hitesh Shah,2012-09-15 00:28:42+00:00,['d4552f3dea5a19cc9370e39bf36ddeb62759e99b'],1186,1188,2374,12926783,33,,,,5808
ed71f92e79a757de23d1132e6afe58e897500482,0,Yusaku Sako,2012-09-15 00:47:38+00:00,['9a525ef0227c763fdfdb8822a9796be5c5e80355'],202,357,559,12927342,12,0.701030928,1,1,5808
95bda662d536c4891efc3050cda65bf018ff1c2e,1,Yusaku Sako,2012-09-16 01:20:48+00:00,['ed71f92e79a757de23d1132e6afe58e897500482'],218,329,547,12927889,22,1,1,1,5810
47d1386ffb4c2b96f8d6b37607f5dae7cab268cb,1,Mahadev Konar,2012-09-16 07:08:06+00:00,['95bda662d536c4891efc3050cda65bf018ff1c2e'],37,380,417,12928306,10,1,1,0.9375,5813
1db9c532650ec78e0ce80ffaf499e5d6e01c723e,1,Yusaku Sako,2012-09-16 20:07:54+00:00,['47d1386ffb4c2b96f8d6b37607f5dae7cab268cb'],8,120,128,12928434,17,1,0,0,5819
25ddd74893410b8daed5a8d53b1a693d1be05b97,1,Yusaku Sako,2012-09-16 20:11:21+00:00,['1db9c532650ec78e0ce80ffaf499e5d6e01c723e'],2,742,744,12929178,3,,,,5820
eb461c57ccfd12b2cd054f44cf5f3cfb43493b79,1,Yusaku Sako,2012-09-17 17:17:16+00:00,['25ddd74893410b8daed5a8d53b1a693d1be05b97'],15,68,83,12929261,6,1,1,1,5820
efc43657a8f880edfc1377beebe3e6f08c859bc8,0,Yusaku Sako,2012-09-17 17:26:09+00:00,['eb461c57ccfd12b2cd054f44cf5f3cfb43493b79'],0,108,108,12929369,6,,,,5820
b89aa88d76a144efd16b51a7ae3727b3854d7d48,0,Hitesh Shah,2012-09-17 22:23:04+00:00,['efc43657a8f880edfc1377beebe3e6f08c859bc8'],12,626,638,12930007,13,0.645283019,1,0.777358491,5827
5d1e4cda7fa854522cffbd2ad8d41bbecd2bd04f,1,Yusaku Sako,2012-09-17 22:46:44+00:00,['b89aa88d76a144efd16b51a7ae3727b3854d7d48'],335,655,990,12930997,8,0.045454545,0.045454545,1,5827
2b9352823062b5fbc03977b027fcad2826cc5b37,1,Yusaku Sako,2012-09-17 23:05:42+00:00,['5d1e4cda7fa854522cffbd2ad8d41bbecd2bd04f'],0,180,180,12931177,2,0.888235294,1,1,5829
25493ef89004809202f01b504dd2a9b0d5530536,1,Yusaku Sako,2012-09-17 23:10:57+00:00,['2b9352823062b5fbc03977b027fcad2826cc5b37'],209,539,748,12931925,17,0.806629834,1,1,5834
0e7d852128ea1b735d8491ec91a6141eabcf4854,1,Jitendra Nath Pandey,2012-09-18 02:27:11+00:00,['25493ef89004809202f01b504dd2a9b0d5530536'],29,163,192,12932117,9,0.444444444,0.655555556,0.866666667,5834
427b0a192501a55b94b7a502aa3243f05e72667d,1,Jitendra Nath Pandey,2012-09-18 02:31:02+00:00,['0e7d852128ea1b735d8491ec91a6141eabcf4854'],0,125,125,12932242,1,0,1,1,5835
f61fa33f2d6390f9c27cf8e36a319e95cad9c928,1,Mahadev Konar,2012-09-18 08:24:05+00:00,['427b0a192501a55b94b7a502aa3243f05e72667d'],3,6,9,12932251,2,,,,5835
e8a6f4108d130677887aaa2c6bc61014df60842e,0,Hitesh Shah,2012-09-18 17:35:00+00:00,['f61fa33f2d6390f9c27cf8e36a319e95cad9c928'],23,178,201,12932452,24,0.544444444,0.8,1,5836
e8a8521ba8a154edcb70877362b275f5338ce01d,0,Hitesh Shah,2012-09-18 17:46:59+00:00,['e8a6f4108d130677887aaa2c6bc61014df60842e'],0,20,20,12932472,2,,,,5836
8820ada54467d8ca83e9865a10a3f929251a2d24,0,Hitesh Shah,2012-09-18 19:09:10+00:00,['e8a8521ba8a154edcb70877362b275f5338ce01d'],5,7,12,12932484,5,,,,5836
4f1aa39ea226400291176a2ab374bdae69f1a514,1,Yusaku Sako,2012-09-19 04:52:19+00:00,['8820ada54467d8ca83e9865a10a3f929251a2d24'],429,918,1347,12933831,28,0.989071038,0.989071038,1,5844
561c1649ad579869687bf19dbaca2e9c923d6dc9,1,Mahadev Konar,2012-09-19 06:06:09+00:00,['4f1aa39ea226400291176a2ab374bdae69f1a514'],45,404,449,12934280,8,0.218446602,0.553398058,0.970873786,5846
a30758b5cccd9cbed331796171f2b36cf4ba18cc,1,Mahadev Konar,2012-09-20 00:27:02+00:00,['561c1649ad579869687bf19dbaca2e9c923d6dc9'],76,4587,4663,12938943,60,0.605590062,0.872670807,0.98447205,5898
34e735d9f4fe3229ab7c552e020648241e6e6447,1,Mahadev Konar,2012-09-20 00:48:08+00:00,['a30758b5cccd9cbed331796171f2b36cf4ba18cc'],77,99,176,12939119,17,,,,5898
b3ccc7834c23163083ed625c4dc5b2a23eb765bd,0,Mahadev Konar,2012-09-20 01:07:26+00:00,['34e735d9f4fe3229ab7c552e020648241e6e6447'],0,7,7,12939126,2,,,,5898
a9c32798c88185db48b83a019b0d0155c5587ee2,1,Yusaku Sako,2012-09-20 05:04:59+00:00,['b3ccc7834c23163083ed625c4dc5b2a23eb765bd'],31,541,572,12939698,17,0.749077491,1,1,5903
6c995c099fecbc72476fbe631a2dce8b96d15e5e,1,Yusaku Sako,2012-09-21 02:59:55+00:00,['a9c32798c88185db48b83a019b0d0155c5587ee2'],248,470,718,12940416,17,0.578947368,0.915789474,1,5906
8386243721f62021580e136be20d576e2e51ed64,1,Mahadev Konar,2012-09-23 18:01:49+00:00,['6c995c099fecbc72476fbe631a2dce8b96d15e5e'],0,10003,10003,12950419,116,0.659306961,0.937749157,0.879484821,6020
ead69b65c9b9530250353651c8dbdd7ed08b1d7e,0,Yusaku Sako,2012-09-24 05:23:36+00:00,['e3c43f41dbaab68b0784c594d5452000444787dd'],35,237,272,12950691,6,,,,6021
d938f9a5c68e653ab00a8a41d9faf82b995e391f,0,Yusaku Sako,2012-09-24 19:55:15+00:00,['ead69b65c9b9530250353651c8dbdd7ed08b1d7e'],0,68,68,12950759,3,,,,6022
ff0b146a47b5391cacbc80b8a35ec78fa33586bb,1,Mahadev Konar,2012-09-25 09:41:01+00:00,['8386243721f62021580e136be20d576e2e51ed64'],0,359,359,12951118,4,0.891719745,1,0.78343949,6025
1463b2231b28da70a7b7a8d1486f769cec631c47,1,Yusaku Sako,2012-09-26 20:59:33+00:00,['ff0b146a47b5391cacbc80b8a35ec78fa33586bb'],7,696,703,12951821,9,0.738831615,0.855670103,0.962199313,6027
8f367128dadcb6b84bddbef74ffae20f2ff1f03c,1,Yusaku Sako,2012-09-26 21:09:47+00:00,['1463b2231b28da70a7b7a8d1486f769cec631c47'],74,1423,1497,12953318,18,0.684085511,0.966745843,1,6033
1aea3a7a77a1e8fc17de9b870052b071152a18f5,1,Yusaku Sako,2012-09-26 22:32:47+00:00,['8f367128dadcb6b84bddbef74ffae20f2ff1f03c'],288,3900,4188,12957506,91,0.899882214,0.884570082,0.987043581,6099
d5e552df33db9c6883ffd0db5d390b326e652c57,1,Mahadev Konar,2012-09-27 04:42:23+00:00,['1aea3a7a77a1e8fc17de9b870052b071152a18f5'],185,1855,2040,12959546,42,0.725677831,0.972886762,0.883572568,6117
ae9d61a7527eb4224bc7a7c3a16b8b58810bbce7,1,Yusaku Sako,2012-09-27 04:59:28+00:00,['d5e552df33db9c6883ffd0db5d390b326e652c57'],208,250,458,12960004,9,,,,6117
96f197ad1ee2c3d418f2428931e8af130f932707,0,Hitesh Shah,2012-09-27 20:26:56+00:00,['ae9d61a7527eb4224bc7a7c3a16b8b58810bbce7'],81,131,212,12960216,8,0.393939394,1,1,6117
bf2f1fac8363d151865fb545ea1c77f17de2c188,1,Jitendra Nath Pandey,2012-09-27 22:35:00+00:00,['96f197ad1ee2c3d418f2428931e8af130f932707'],153,1113,1266,12961482,31,0.794212219,0.993569132,0.91318328,6128
a5fc1a4095ea1c4de7720c33d6a52c3c6ca61567,1,Mahadev Konar,2012-09-28 05:55:11+00:00,['bf2f1fac8363d151865fb545ea1c77f17de2c188'],4,22,26,12961508,3,1,1,1,6128
ebdf6110c288efdb38840ba2ad2f935972ba9b21,1,Mahadev Konar,2012-09-29 01:30:22+00:00,['a5fc1a4095ea1c4de7720c33d6a52c3c6ca61567'],307,15339,15646,12977154,231,0.779456193,0.83081571,0.921450151,6355
1cfa14b322b0a7f2492f46fa1a8613506b02191f,0,Mahadev Konar,2012-09-29 02:09:59+00:00,['ebdf6110c288efdb38840ba2ad2f935972ba9b21'],0,247,247,12977401,3,,,,6357
1a2052f0cbd72dd1f8da562b14739610d492eb61,1,Jitendra Nath Pandey,2012-10-01 18:16:28+00:00,['1cfa14b322b0a7f2492f46fa1a8613506b02191f'],76,178,254,12977655,18,0.14893617,0,1,6357
e516813a695f5a0641f74f877f0ed5178a06cacc,1,Hitesh Shah,2012-10-01 18:22:52+00:00,['1a2052f0cbd72dd1f8da562b14739610d492eb61'],292,1256,1548,12979203,22,0.540816327,0.977040816,0.844387755,6362
6cd090344849557de6409f033a1b7262675f4bdd,1,Hitesh Shah,2012-10-01 18:35:19+00:00,['e516813a695f5a0641f74f877f0ed5178a06cacc'],474,783,1257,12980460,66,0.19047619,0.619047619,0.674603175,6364
a8461c0fc40e4b0ac8a53c23e60bec1febce7dcc,1,Jitendra Nath Pandey,2012-10-01 19:04:48+00:00,['6cd090344849557de6409f033a1b7262675f4bdd'],126,227,353,12980813,21,0.336734694,0.826530612,0.918367347,6365
7e59ad9b94625df91ff2b8d2e864887284e08262,1,Jitendra Nath Pandey,2012-10-01 22:35:40+00:00,['a8461c0fc40e4b0ac8a53c23e60bec1febce7dcc'],3,33,36,12980849,3,0,1,1,6365
4a2969dd2633200b0957b8da4088a20b7c618d68,1,Mahadev Konar,2012-10-02 05:22:49+00:00,['7e59ad9b94625df91ff2b8d2e864887284e08262'],3,323,326,12981175,13,0.698795181,1,1,6371
b13b9211a6120814e34463a1cfcd61ccec9d6ad5,1,Mahadev Konar,2012-10-02 05:35:12+00:00,['4a2969dd2633200b0957b8da4088a20b7c618d68'],80,154,234,12981409,9,0,0.951219512,0.926829268,6371
a992578aafee3d83bf107824ba9f5bce7fb63f0d,1,Jitendra Nath Pandey,2012-10-02 07:36:17+00:00,['b13b9211a6120814e34463a1cfcd61ccec9d6ad5'],12,200,212,12981621,10,0.802083333,1,0.833333333,6373
61678ba4432c4d883d88efe477dea6df49793713,0,Mahadev Konar,2012-10-02 23:34:43+00:00,['a992578aafee3d83bf107824ba9f5bce7fb63f0d'],15,30,45,12981666,5,0.125,1,0.875,6373
bf04fcdb638587469b96043c57b3e4bdaac7a709,1,Jitendra Nath Pandey,2012-10-02 23:36:26+00:00,['61678ba4432c4d883d88efe477dea6df49793713'],2,26,28,12981694,3,0,1,1,6373
5f95df9db07d0c9732279a343ffc1a893fc4d717,0,Hitesh Shah,2012-10-02 23:42:00+00:00,['bf04fcdb638587469b96043c57b3e4bdaac7a709'],98,423,521,12982215,16,0,0,0.869565217,6380
997940a4b56ed3e4f61121e28679049bf85ad476,1,Jitendra Nath Pandey,2012-10-03 00:05:28+00:00,['5f95df9db07d0c9732279a343ffc1a893fc4d717'],4,24,28,12982243,4,0.545454545,1,1,6380
1f3f79b1d7463d66c40e2afbe8ac5579a71e1729,1,Mahadev Konar,2012-10-03 04:22:19+00:00,['997940a4b56ed3e4f61121e28679049bf85ad476'],30,27,57,12982300,4,,,,6380
7f288ee08d1c64efc8831edc8b946242ae823b08,0,Yusaku Sako,2012-10-03 04:33:32+00:00,['1f3f79b1d7463d66c40e2afbe8ac5579a71e1729'],203,500,703,12983003,27,1,1,1,6380
6e39983374b663eb2acca73a1fa934311614788a,0,Yusaku Sako,2012-10-03 04:41:43+00:00,['7f288ee08d1c64efc8831edc8b946242ae823b08'],500,203,703,12983706,27,0,0,0,6380
6710ef87ac33ac12b68dca73c9ef297ce38633e4,1,Yusaku Sako,2012-10-03 04:45:03+00:00,['6e39983374b663eb2acca73a1fa934311614788a'],8,111,119,12983825,4,1,1,1,6380
bcf60d4fe88dd6c42fdc8806d3beb7c506fbd92c,1,Mahadev Konar,2012-10-03 06:42:13+00:00,['6710ef87ac33ac12b68dca73c9ef297ce38633e4'],94,111,205,12984030,6,,,,6380
3281b489035fdc17946303c323a1aae25d81c638,1,Hitesh Shah,2012-10-03 20:44:18+00:00,['bcf60d4fe88dd6c42fdc8806d3beb7c506fbd92c'],317,1957,2274,12986304,40,0.921542553,0.940159574,0.792553191,6385
ce738a923ccffe1a4677eb6b2dd4fe4e568beede,0,Hitesh Shah,2012-10-03 20:58:02+00:00,['3281b489035fdc17946303c323a1aae25d81c638'],1,3,4,12986308,2,,,,6385
3b73adaa12ff9787cf868140a14c83c12a7d9066,1,Hitesh Shah,2012-10-03 22:40:31+00:00,['ce738a923ccffe1a4677eb6b2dd4fe4e568beede'],31,379,410,12986718,8,1,1,0.788888889,6387
ff66974b8912a037662212052cbd05b96c11f6e3,0,Yusaku Sako,2012-10-03 23:17:04+00:00,['3b73adaa12ff9787cf868140a14c83c12a7d9066'],295,659,954,12987672,21,0.898360656,0.904918033,1,6387
dfb7f03927aee48e81597a1dad0b270067c68563,1,Mahadev Konar,2012-10-03 23:18:31+00:00,['ff66974b8912a037662212052cbd05b96c11f6e3'],4,18,22,12987694,4,0.333333333,0.333333333,1,6387
90375352ea2de2f290127523a5ae554df3327791,1,Jitendra Nath Pandey,2012-10-03 23:19:42+00:00,['dfb7f03927aee48e81597a1dad0b270067c68563'],23,169,192,12987886,12,0.420560748,0.962616822,0.728971963,6387
8c63c5a7d4cb5556a8996e4c0460bf1d790b50fb,1,Yusaku Sako,2012-10-03 23:48:57+00:00,['90375352ea2de2f290127523a5ae554df3327791'],827,1982,2809,12990695,70,0.940438871,1,1,6396
f748b4ee90b50793d617945966e8b294395e592c,1,Yusaku Sako,2012-10-04 00:01:26+00:00,['8c63c5a7d4cb5556a8996e4c0460bf1d790b50fb'],651,962,1613,12992308,30,0.80141844,0.932624113,1,6398
69dd21254e051a1cdf8dcbb8fd3b909a31fd8926,1,Hitesh Shah,2012-10-04 00:10:39+00:00,['f748b4ee90b50793d617945966e8b294395e592c'],294,262,556,12992864,51,0.634615385,0,1,6399
be3cbbf1fab8bf1db169a39b25ff7460b8b132a9,0,Yusaku Sako,2012-10-04 00:12:18+00:00,['69dd21254e051a1cdf8dcbb8fd3b909a31fd8926'],330,332,662,12993526,7,,,,6399
67ba63dfdba5457beaa1d0580dd3501a08648c42,0,Hitesh Shah,2012-10-04 00:42:06+00:00,['be3cbbf1fab8bf1db169a39b25ff7460b8b132a9'],34,156,190,12993716,5,1,1,1,6401
3fdc7ce5d2ac39fe0cd9ceadba4f8234ca5159cb,1,Hitesh Shah,2012-10-04 04:44:13+00:00,['67ba63dfdba5457beaa1d0580dd3501a08648c42'],477,337,814,12994530,14,1,0.327868852,0.131147541,6401
d85333c5100db35a1740d20e574d0091b9b39a61,1,Yusaku Sako,2012-10-06 05:05:05+00:00,['3fdc7ce5d2ac39fe0cd9ceadba4f8234ca5159cb'],201,566,767,12995297,41,0.894736842,0.906882591,1,6403
6024d89143f4ef68065cf1d4040aa06722246206,1,Yusaku Sako,2012-10-06 05:11:32+00:00,['d85333c5100db35a1740d20e574d0091b9b39a61'],54,68,122,12995419,10,,,,6403
cfe53d470e3ac7bd6170bee36e5a1b6159e5c204,0,Yusaku Sako,2012-10-06 05:36:12+00:00,['6024d89143f4ef68065cf1d4040aa06722246206'],2,8,10,12995429,5,,,,6403
0179792b0c265d6b0d074792e6a04846a090ae74,1,Mahadev Konar,2012-10-08 01:37:59+00:00,['cfe53d470e3ac7bd6170bee36e5a1b6159e5c204'],3787,16144,19931,13015360,243,0.509714036,0.768609474,0.866841301,6501
5f1f7f6dc78f1e65a351c80e4a09e57b24d3ceb0,0,Mahadev Konar,2012-10-08 01:50:57+00:00,['0179792b0c265d6b0d074792e6a04846a090ae74'],8319,0,8319,13023679,90,0.341570347,0.082502989,0.163411718,6501
264db1fb32c886d559eb146d007d6b0552487ce8,0,Mahadev Konar,2012-10-08 02:16:47+00:00,['d938f9a5c68e653ab00a8a41d9faf82b995e391f'],9,15,24,13023703,4,,,,6501
d7472c12466b8ec281e9475cb0062d57effc67de,1,Hitesh Shah,2012-10-08 03:20:52+00:00,['5f1f7f6dc78f1e65a351c80e4a09e57b24d3ceb0'],36,324,360,13024063,9,0,0.793577982,0.78440367,6501
87764a4e4d92c7f281fe909263dab393bf209c8c,1,Mahadev Konar,2012-10-08 20:11:04+00:00,['d7472c12466b8ec281e9475cb0062d57effc67de'],50,77,127,13024190,7,1,1,1,6501
2dcce0e26872211df566c6d310fdc30110ada2ec,1,Hitesh Shah,2012-10-09 00:04:44+00:00,['87764a4e4d92c7f281fe909263dab393bf209c8c'],158,203,361,13024551,15,0,0,1,6502
3f58067e403de5684d8975b486972e53ff130327,1,Hitesh Shah,2012-10-09 00:38:29+00:00,['2dcce0e26872211df566c6d310fdc30110ada2ec'],10,97,107,13024658,5,0,1,0.391304348,6502
5b4ff7542c6d75680999a7b5b41276e4e9c3ae72,1,Mahadev Konar,2012-10-09 00:55:06+00:00,['3f58067e403de5684d8975b486972e53ff130327'],155,1684,1839,13026497,49,0.455855856,1,0.89009009,6517
62b3e82f0f38879d9a7801adf399f6195839da48,1,Mahadev Konar,2012-10-09 00:57:48+00:00,['5b4ff7542c6d75680999a7b5b41276e4e9c3ae72'],0,4,4,13026501,2,0,1,1,6517
a0fdd3603012d2a46fcf216e64932afc51279866,1,Mahadev Konar,2012-10-09 01:13:06+00:00,['62b3e82f0f38879d9a7801adf399f6195839da48'],98,223,321,13026822,5,1,1,1,6520
d18d9bacc83a004abf339acb671ebbc05ff6a770,1,Hitesh Shah,2012-10-09 04:47:45+00:00,['a0fdd3603012d2a46fcf216e64932afc51279866'],3,144,147,13026969,15,0.145299145,0.435897436,1,6520
908cf3346993aa7d665ed07ad165dffece08172f,1,Mahadev Konar,2012-10-09 05:06:15+00:00,['d18d9bacc83a004abf339acb671ebbc05ff6a770'],31,91,122,13027091,8,0.666666667,1,1,6522
416190a44e294d85f0b62cfe97d0c88fcfb8fdca,1,Mahadev Konar,2012-10-09 05:21:04+00:00,['908cf3346993aa7d665ed07ad165dffece08172f'],373,926,1299,13028390,38,0.243589744,0.939102564,0.951923077,6523
605e3d31221a702c027c5ddf6f5b0128b89a0a81,1,Jitendra Nath Pandey,2012-10-09 07:00:02+00:00,['416190a44e294d85f0b62cfe97d0c88fcfb8fdca'],3,51,54,13028444,4,0.243243243,0.243243243,1,6523
e58e12180a10171dd1f6a9439e064a8756b451c1,0,Jitendra Nath Pandey,2012-10-09 08:08:12+00:00,['605e3d31221a702c027c5ddf6f5b0128b89a0a81'],0,2,2,13028446,1,,,,6523
052abb79b5def58a552350d5d9043ec02de98ffc,1,Mahadev Konar,2012-10-09 17:01:58+00:00,['e58e12180a10171dd1f6a9439e064a8756b451c1'],402,317,719,13029165,107,,,,6523
5f69c485173e10a199a4a8f0681229bb3bc616a3,1,Hitesh Shah,2012-10-09 20:46:13+00:00,['052abb79b5def58a552350d5d9043ec02de98ffc'],51,57,108,13029273,2,1,1,0,6523
847fc6ac1e315a82a9d08aa79d2eed92d3a46ccc,1,Hitesh Shah,2012-10-09 21:38:56+00:00,['5f69c485173e10a199a4a8f0681229bb3bc616a3'],47,1046,1093,13030366,14,0.534246575,1,0.671232877,6531
173cacfeb98d6fb652d8c9561f4f17d51760d8ef,1,Hitesh Shah,2012-10-09 21:40:39+00:00,['847fc6ac1e315a82a9d08aa79d2eed92d3a46ccc'],20,42,62,13030428,6,1,1,0.888888889,6531
6ff2ced7136fecf1ed6b617323485f88187ee8a7,0,Hitesh Shah,2012-10-09 22:39:54+00:00,['173cacfeb98d6fb652d8c9561f4f17d51760d8ef'],4,17,21,13030449,5,0.444444444,1,1,6531
e6513878d725d9da29f5bfbd2b9e2c58a6163bb8,0,Hitesh Shah,2012-10-10 00:06:46+00:00,['6ff2ced7136fecf1ed6b617323485f88187ee8a7'],7,17,24,13030473,2,0,1,1,6531
74c4d2eb0104d4e5c9a97898c6f1d5a64180be28,0,Hitesh Shah,2012-10-10 02:27:20+00:00,['e6513878d725d9da29f5bfbd2b9e2c58a6163bb8'],2,24,26,13030499,5,0,1,1,6531
ba13ae9582c0e7758189756ea88067e7c867e090,1,Hitesh Shah,2012-10-10 02:44:34+00:00,['74c4d2eb0104d4e5c9a97898c6f1d5a64180be28'],17,26,43,13030542,4,0,0,1,6531
86b9c8be5963e9c22798470f11935c94b46e510c,0,Mahadev Konar,2012-10-10 05:45:28+00:00,['ba13ae9582c0e7758189756ea88067e7c867e090'],34,136,170,13030712,5,1,1,1,6532
fd8cd68cea76e2b96844844de13dc932fd4e2dce,1,Mahadev Konar,2012-10-10 05:57:44+00:00,['86b9c8be5963e9c22798470f11935c94b46e510c'],10,40,50,13030762,7,1,1,1,6532
01101f9ee7da5a6da1b046793847b936dcb9a512,0,Mahadev Konar,2012-10-10 06:03:37+00:00,['fd8cd68cea76e2b96844844de13dc932fd4e2dce'],5,19,24,13030786,7,1,1,1,6532
947a9d5acc9e22aa1b9613bfdc5cdab74a3e78e0,1,Mahadev Konar,2012-10-10 06:34:22+00:00,['01101f9ee7da5a6da1b046793847b936dcb9a512'],145,261,406,13031192,18,1,1,0.066666667,6536
96cf16f195c35aa6617e74e9c2893c53bea1a8b5,1,Mahadev Konar,2012-10-10 07:56:23+00:00,['947a9d5acc9e22aa1b9613bfdc5cdab74a3e78e0'],24,35,59,13031251,5,0.5,0,1,6536
44ec9f9affb8a2f225b9a4d0590eeb491dd3f154,1,Yusaku Sako,2012-10-10 22:54:17+00:00,['96cf16f195c35aa6617e74e9c2893c53bea1a8b5'],298,724,1022,13032273,29,0.992481203,1,1,6537
18819c9086716d0ed1622adbfe12f7642f341a22,1,Yusaku Sako,2012-10-10 22:57:53+00:00,['44ec9f9affb8a2f225b9a4d0590eeb491dd3f154'],32,52,84,13032357,4,1,0.857142857,1,6537
699286192417c282decfde93bf12e031b4b16a34,1,Mahadev Konar,2012-10-11 05:33:58+00:00,['18819c9086716d0ed1622adbfe12f7642f341a22'],330,1163,1493,13033850,20,0.706036745,0.855643045,0.965879265,6545
6ae2e822018a3a3843583cb718fb5b0aafe070c3,0,Mahadev Konar,2012-10-11 05:53:01+00:00,['699286192417c282decfde93bf12e031b4b16a34'],157,0,157,13034007,5,0,0,0,6545
27d96c9c8c6cf2fd76795c39b23c7c19e424801c,1,Hitesh Shah,2012-10-11 22:12:13+00:00,['6ae2e822018a3a3843583cb718fb5b0aafe070c3'],48,308,356,13034363,14,0.246478873,0.971830986,0.992957746,6547
5bfc4a8b9bdc1e10fefd30bc54baa3e5b619f705,1,Jitendra Nath Pandey,2012-10-12 02:03:57+00:00,['27d96c9c8c6cf2fd76795c39b23c7c19e424801c'],391,493,884,13035247,15,0.340909091,0.568181818,0.454545455,6547
c91932926a91d1b251ff6c711d3197419cfbc638,1,Yusaku Sako,2012-10-13 07:49:28+00:00,['5bfc4a8b9bdc1e10fefd30bc54baa3e5b619f705'],1,106,107,13035354,5,0.833333333,1,1,6548
15cf212b050eea940e02e5b2a778ee871e9682a5,1,Yusaku Sako,2012-10-13 17:14:13+00:00,['c91932926a91d1b251ff6c711d3197419cfbc638'],30,81,111,13035465,3,1,1,0,6549
06ba5ba3c51f1b2a037dcdfbca3b14a5b8f2a85e,1,Yusaku Sako,2012-10-13 21:03:18+00:00,['15cf212b050eea940e02e5b2a778ee871e9682a5'],202,8920,9122,13044587,60,0.744054817,0.780330512,0.887948408,6584
92c38ca4327a313f44d5c1a1cda87128e39307f4,1,Yusaku Sako,2012-10-14 02:37:39+00:00,['06ba5ba3c51f1b2a037dcdfbca3b14a5b8f2a85e'],346,234,580,13045167,9,0.504587156,0,0,6584
f6aa563324a85e8c7c0932b4b72a6ae70769a5da,0,Yusaku Sako,2012-10-14 02:49:12+00:00,['92c38ca4327a313f44d5c1a1cda87128e39307f4'],33,4,37,13045204,3,,,,6584
82fc5f95ada0ec4f60911c0c58481415bca7a69b,1,Yusaku Sako,2012-10-14 05:28:03+00:00,['f6aa563324a85e8c7c0932b4b72a6ae70769a5da'],19,54,73,13045277,4,,,,6584
2cefb1bdd723f0591affa2ec261b4e7e12fc5b5e,0,Jitendra Nath Pandey,2012-10-14 20:15:10+00:00,['82fc5f95ada0ec4f60911c0c58481415bca7a69b'],8,11,19,13045296,4,1,0,0,6584
a3d2cc3f8f5b3cc1e077cdaf38bed922cbb940db,1,Jitendra Nath Pandey,2012-10-16 00:09:49+00:00,['2cefb1bdd723f0591affa2ec261b4e7e12fc5b5e'],40,710,750,13046046,16,0.477386935,0.748743719,0.959798995,6588
0f888a1e080d1acbc75edb123995c4af63f2f4f4,1,Mahadev Konar,2012-10-16 02:13:18+00:00,['a3d2cc3f8f5b3cc1e077cdaf38bed922cbb940db'],36,71,107,13046153,5,0,1,1,6588
b8a44cbe2c3c94a98ee41764aea85bd840d7a07b,1,Mahadev Konar,2012-10-16 02:20:41+00:00,['0f888a1e080d1acbc75edb123995c4af63f2f4f4'],415,1816,2231,13048384,31,0.802631579,1,1,6590
6d894db77e0f1c796c9ea0a6be84d3728fa5a19b,1,Mahadev Konar,2012-10-16 02:29:19+00:00,['b8a44cbe2c3c94a98ee41764aea85bd840d7a07b'],141,37,178,13048562,5,1,0,0,6590
b41d25189fd21aa1a12ff398d75e7273f5b40d61,1,Mahadev Konar,2012-10-16 06:13:44+00:00,['6d894db77e0f1c796c9ea0a6be84d3728fa5a19b'],298,583,881,13049443,20,0.31986532,0.855218855,0.929292929,6592
070f452dba866acf03ec9a6009a6fa474730e51f,1,Mahadev Konar,2012-10-16 06:23:28+00:00,['b41d25189fd21aa1a12ff398d75e7273f5b40d61'],248,250,498,13049941,5,,,,6592
1e4001f4739302f429442f6d8ca5662c581fff16,1,Mahadev Konar,2012-10-16 06:38:23+00:00,['070f452dba866acf03ec9a6009a6fa474730e51f'],1887,2923,4810,13054751,89,0.279863481,0.998293515,0.784982935,6602
207718cd571b3c6f8c7a61436b062d6a7131f2db,1,Mahadev Konar,2012-10-16 06:43:23+00:00,['1e4001f4739302f429442f6d8ca5662c581fff16'],16,175,191,13054942,4,0.060606061,1,1,6602
85f9c355f9502640974b8b7fe9c342678265989f,0,Mahadev Konar,2012-10-16 07:01:35+00:00,['207718cd571b3c6f8c7a61436b062d6a7131f2db'],200,191,391,13055333,3,,,,6602
f0ea8b7c52676b4941be0bf173f0205aff88f309,1,Mahadev Konar,2012-10-16 16:55:05+00:00,['85f9c355f9502640974b8b7fe9c342678265989f'],412,252,664,13055997,39,0,0.103448276,0.011494253,6602
b4d6b0209bdfce1f3a9dbd2de5180aa0ff45fb9f,1,Hitesh Shah,2012-10-17 00:50:53+00:00,['f0ea8b7c52676b4941be0bf173f0205aff88f309'],820,1785,2605,13058602,23,0.120226308,0.497878359,0.827439887,6603
8f6091221699692bcc27420c0369968ff838ab8c,0,Mahadev Konar,2012-10-17 02:51:05+00:00,['b4d6b0209bdfce1f3a9dbd2de5180aa0ff45fb9f'],37,185,222,13058824,3,0,1,1,6604
4c405925c4435d24cd1075f8d813c5239d29335b,1,Jitendra Nath Pandey,2012-10-17 08:25:46+00:00,['8f6091221699692bcc27420c0369968ff838ab8c'],8,31,39,13058863,5,1,1,1,6604
49d1ae727ce66715c370c581ca6d617c0810b663,1,Hitesh Shah,2012-10-17 21:02:09+00:00,['4c405925c4435d24cd1075f8d813c5239d29335b'],372,223,595,13059458,15,0,0,0.125,6604
5bb33314ade76dc04f95b25f39fc644afd41b22a,0,Yusaku Sako,2012-10-18 00:10:44+00:00,['49d1ae727ce66715c370c581ca6d617c0810b663'],3,4,7,13059465,2,0,0,0,6604
6cad6e7439b4cda08654df4f0460a054c95a0577,1,Yusaku Sako,2012-10-18 00:17:19+00:00,['5bb33314ade76dc04f95b25f39fc644afd41b22a'],26,2558,2584,13062049,34,0.873770492,0.906557377,0.971311475,6622
fa64bd526ac74152c886d3ba80dd5d370e665c65,1,Yusaku Sako,2012-10-18 00:26:50+00:00,['6cad6e7439b4cda08654df4f0460a054c95a0577'],44,73,117,13062166,7,0.238095238,1,1,6623
748d2cfd6d39795ab8b8f7a8722e753afb42e171,1,Yusaku Sako,2012-10-18 00:32:42+00:00,['fa64bd526ac74152c886d3ba80dd5d370e665c65'],158,179,337,13062503,15,0.9375,0.9375,0,6623
ec3c47fdd4ee67991d27cfb46e04a0018c24e984,1,Yusaku Sako,2012-10-18 00:39:02+00:00,['748d2cfd6d39795ab8b8f7a8722e753afb42e171'],190,1493,1683,13064186,35,0.748175182,0.919708029,1,6638
8f8b578661095f086b2ebfc1abe9e4ee33438cbe,1,Yusaku Sako,2012-10-18 00:59:57+00:00,['ec3c47fdd4ee67991d27cfb46e04a0018c24e984'],868,1273,2141,13066327,13,0.944444444,0.841269841,0.96031746,6640
701df6769bbc15e2e62f4028394e47768d2119c7,1,Yusaku Sako,2012-10-18 01:03:38+00:00,['8f8b578661095f086b2ebfc1abe9e4ee33438cbe'],87,1981,2068,13068395,23,0.364948454,0.465979381,0.960824742,6648
8d810fbb534b37e5acbba84d85d0964b13caddaa,1,Yusaku Sako,2012-10-18 01:15:47+00:00,['701df6769bbc15e2e62f4028394e47768d2119c7'],799,15501,16300,13084695,11,0.458965999,0.562272939,0.902654867,6649
41c2ca48643d4cec68a8ee723c274e874a18f8fb,1,Yusaku Sako,2012-10-18 01:18:54+00:00,['8d810fbb534b37e5acbba84d85d0964b13caddaa'],330,643,973,13085668,9,0.863636364,0.863636364,1,6649
9c4e212672f82ca366592d412bd691c0182b5669,1,Hitesh Shah,2012-10-18 22:41:08+00:00,['41c2ca48643d4cec68a8ee723c274e874a18f8fb'],104,459,563,13086231,13,0.063291139,0.392405063,1,6649
7ae7f580a2e22f993c557e65936f45088ce5a328,1,Yusaku Sako,2012-10-20 17:12:55+00:00,['9c4e212672f82ca366592d412bd691c0182b5669'],774,3304,4078,13090309,39,0.475129918,0.587230883,0.817371938,6657
5a6d0aa7d97a8263896d21466f3ba04e1285c078,1,Yusaku Sako,2012-10-20 17:17:07+00:00,['7ae7f580a2e22f993c557e65936f45088ce5a328'],12,3590,3602,13093911,24,0.65430996,0.839213935,0.990620813,6675
83fb0a2bb00d317bf7f2ef25539f2890bc7b83e3,1,Yusaku Sako,2012-10-20 17:29:51+00:00,['5a6d0aa7d97a8263896d21466f3ba04e1285c078'],580,727,1307,13095218,9,0.804878049,0.926829268,1,6675
c1d9fcf67ee498fc588812040102492be4e4e23a,1,Mahadev Konar,2012-10-22 07:31:23+00:00,['83fb0a2bb00d317bf7f2ef25539f2890bc7b83e3'],260,274,534,13095752,5,0,0,0,6675
e64ee087ba1a226e16172185477b4071d786001f,1,Mahadev Konar,2012-10-22 07:44:06+00:00,['c1d9fcf67ee498fc588812040102492be4e4e23a'],925,2849,3774,13099526,31,0.762108262,0.754985755,0.991452991,6693
f66d3f488b0a6df1cf74962e3ff41856c9c51593,1,Mahadev Konar,2012-10-22 07:53:13+00:00,['e64ee087ba1a226e16172185477b4071d786001f'],76,933,1009,13100535,25,0.580985915,0.661971831,0.894366197,6698
66236896786a64eb7bb47859317a9107f98ed4e8,1,Mahadev Konar,2012-10-22 08:09:14+00:00,['f66d3f488b0a6df1cf74962e3ff41856c9c51593'],645,1635,2280,13102815,54,0.432735426,0.910313901,0.784753363,6708
734566422ff7578022e50577370c72b48a9b9731,1,Jitendra Nath Pandey,2012-10-22 20:57:18+00:00,['66236896786a64eb7bb47859317a9107f98ed4e8'],27,60,87,13102902,4,0.555555556,0.888888889,1,6708
d6ce83acfd91a3adba828ce7655833369a50d823,1,Hitesh Shah,2012-10-22 21:19:10+00:00,['734566422ff7578022e50577370c72b48a9b9731'],229,2399,2628,13105530,42,0.037274316,0.659289458,0.998252766,6708
743b73f97d82bb41500ab9a883b7fed7c12c0144,1,Jitendra Nath Pandey,2012-10-23 00:18:28+00:00,['d6ce83acfd91a3adba828ce7655833369a50d823'],0,37,37,13105567,4,1,1,1,6708
4d7abcdd682012d51a1ea657d3c87a8613ba6419,0,Jitendra Nath Pandey,2012-10-23 00:19:21+00:00,['743b73f97d82bb41500ab9a883b7fed7c12c0144'],0,62,62,13105629,1,1,1,1,6709
4235a3db92b61c6d82491e2bffaf6207c5f203ae,1,Mahadev Konar,2012-10-24 06:05:32+00:00,['4d7abcdd682012d51a1ea657d3c87a8613ba6419'],230,766,996,13106625,25,0.263736264,0.769230769,0.677655678,6712
030ef999f141152ef567bb930ad57ae55e128399,1,Mahadev Konar,2012-10-24 06:14:24+00:00,['4235a3db92b61c6d82491e2bffaf6207c5f203ae'],549,2315,2864,13109489,27,0.115789474,0.205263158,0.615789474,6716
32b1a0cb24b102ad3b38fdde80f216616615d251,1,Mahadev Konar,2012-10-24 06:24:20+00:00,['030ef999f141152ef567bb930ad57ae55e128399'],207,1118,1325,13110814,26,0.591792657,0.779697624,0.950323974,6722
76849482eef70ae3180deee2707d6cdfd1789414,1,Mahadev Konar,2012-10-24 06:37:23+00:00,['32b1a0cb24b102ad3b38fdde80f216616615d251'],205,643,848,13111662,41,0.192411924,0.596205962,0.726287263,6723
f3bdc22a38842c818b4cedebdf8d06ffb6503170,1,Mahadev Konar,2012-10-24 06:46:38+00:00,['76849482eef70ae3180deee2707d6cdfd1789414'],89,86,175,13111837,9,0.545454545,1,0.818181818,6723
12c5c6559a43f71288b52eac81fa733d3b31e40c,0,Mahadev Konar,2012-10-24 06:59:07+00:00,['f3bdc22a38842c818b4cedebdf8d06ffb6503170'],0,12,12,13111849,1,1,1,1,6723
1ed554e97229d5ac7745fd3843764619bb8e7130,1,Jitendra Nath Pandey,2012-10-25 00:29:05+00:00,['12c5c6559a43f71288b52eac81fa733d3b31e40c'],7,156,163,13112012,7,0,0.717171717,0.525252525,6723
6c3c0c3a1aaab6f5a05f414315c732ddf29dfc30,1,Hitesh Shah,2012-10-25 00:32:39+00:00,['1ed554e97229d5ac7745fd3843764619bb8e7130'],78,140,218,13112230,6,0.081967213,0.081967213,1,6723
077dccc60e2f0b5610b365a9044bd0cac65559c5,1,Hitesh Shah,2012-10-25 00:34:31+00:00,['6c3c0c3a1aaab6f5a05f414315c732ddf29dfc30'],68,544,612,13112842,12,0.367123288,0.550684932,0.978082192,6723
43470a61ee234382d64d6c6ef7d0b764c7675a7d,1,Hitesh Shah,2012-10-25 00:49:43+00:00,['077dccc60e2f0b5610b365a9044bd0cac65559c5'],7,8,15,13112857,2,1,0,1,6723
06a632d43584ef3ff30e7930adcac43555277657,1,Yusaku Sako,2012-10-25 19:08:17+00:00,['43470a61ee234382d64d6c6ef7d0b764c7675a7d'],93,252,345,13113202,17,0.984126984,1,1,6723
e74c7cf1216844e9688e56bf7454787a8e9a590f,1,Yusaku Sako,2012-10-25 19:17:36+00:00,['06a632d43584ef3ff30e7930adcac43555277657'],14903,21997,36900,13150102,59,0,0,0,6765
9e07443e45739f58fcee38b6fadd59241aa62027,1,Yusaku Sako,2012-10-25 19:22:07+00:00,['e74c7cf1216844e9688e56bf7454787a8e9a590f'],67,193,260,13150362,12,1,0.765957447,1,6766
17a6f58fb8682278be94735962cafa6c982e7fe9,0,Yusaku Sako,2012-10-25 19:28:44+00:00,['9e07443e45739f58fcee38b6fadd59241aa62027'],33,40,73,13150435,2,1,1,1,6766
48c2ebc43e115225f882b8c333caaff68d1c5569,1,Yusaku Sako,2012-10-25 19:35:14+00:00,['17a6f58fb8682278be94735962cafa6c982e7fe9'],616,441,1057,13151492,38,0,0,0.113636364,6771
1ace5cdfc29b7e83438aa6ce6cbcf4a7ddaaef4b,1,Yusaku Sako,2012-10-25 19:44:07+00:00,['48c2ebc43e115225f882b8c333caaff68d1c5569'],1988,3229,5217,13156709,27,0,0,0,6786
56b9f59510381b584549eb3abf9235a9c0f29cd6,1,Yusaku Sako,2012-10-25 19:47:29+00:00,['1ace5cdfc29b7e83438aa6ce6cbcf4a7ddaaef4b'],201,559,760,13157469,8,0.8,0.8,1,6786
d14e24eb982679767c62844ee80179ac6566b10d,0,Yusaku Sako,2012-10-25 19:50:33+00:00,['56b9f59510381b584549eb3abf9235a9c0f29cd6'],1,3,4,13157473,2,,,,6786
91a7d1eeae1ed1eef2817a8f3b688aa75ac5aa17,1,Yusaku Sako,2012-10-25 20:02:35+00:00,['d14e24eb982679767c62844ee80179ac6566b10d'],3273,4749,8022,13165495,63,0.746945899,0.87609075,1,6801
af23fe3511de4f4b3fdbe8de1e9bab2e5da701b4,1,Yusaku Sako,2012-10-25 23:14:05+00:00,['91a7d1eeae1ed1eef2817a8f3b688aa75ac5aa17'],57,691,748,13166243,24,0,0.050583658,1,6813
bb88f13beb7e655adb00a547477ca88c0826f1f2,1,Yusaku Sako,2012-10-26 06:04:09+00:00,['af23fe3511de4f4b3fdbe8de1e9bab2e5da701b4'],2,754,756,13166999,21,0,0.025889968,1,6829
d16295362deed1ed12026ee2c090a08451260e88,1,Hitesh Shah,2012-10-28 01:30:48+00:00,['bb88f13beb7e655adb00a547477ca88c0826f1f2'],10,88,98,13167097,3,0,0,1,6829
2f93cd8aecf9798af139a9eaa57b880b89605b9e,1,Yusaku Sako,2012-10-29 01:11:09+00:00,['d16295362deed1ed12026ee2c090a08451260e88'],30,30,60,13167157,14,,,,6829
655681b2d4068c495e75e70b0dfe46a6ca74b967,1,Yusaku Sako,2012-10-29 01:15:14+00:00,['2f93cd8aecf9798af139a9eaa57b880b89605b9e'],97,127,224,13167381,4,1,1,1,6829
2beaf704a1f732e4c3f073c2ebb206c955586096,1,Yusaku Sako,2012-10-29 01:18:02+00:00,['655681b2d4068c495e75e70b0dfe46a6ca74b967'],2,530,532,13167913,16,0.009661836,0,1,6841
0ee0fb6760a0ee8c0fa155fcb4c2dd4fc4e4a78b,1,Yusaku Sako,2012-10-29 01:24:10+00:00,['2beaf704a1f732e4c3f073c2ebb206c955586096'],1947,761,2708,13170621,47,0.307814992,0.121212121,0.01754386,6842
ba2495b0b3f159b9a303f8e7ba6fc5f200754328,1,Yusaku Sako,2012-11-07 04:00:21+00:00,['0ee0fb6760a0ee8c0fa155fcb4c2dd4fc4e4a78b'],2731,4734,7465,13178086,105,0.433839479,0.431670282,0.815618221,6870
9c6e8bc39c79e6dc86fc26696287216db670597c,1,Yusaku Sako,2012-11-07 04:06:08+00:00,['ba2495b0b3f159b9a303f8e7ba6fc5f200754328'],89,2008,2097,13180183,15,0.343065693,0.46350365,0.795620438,6872
7490918022bdc91c03c29b307491286785c63df1,1,Yusaku Sako,2012-11-07 04:10:52+00:00,['9c6e8bc39c79e6dc86fc26696287216db670597c'],135,207,342,13180525,10,0.555555556,0.530864198,1,6873
677a6773bff44793beff835ea095af14a763ef64,1,Yusaku Sako,2012-11-07 04:15:01+00:00,['7490918022bdc91c03c29b307491286785c63df1'],20,453,473,13180998,18,1,1,1,6883
b9b7401dd0322a9d35d4fc1239fe97fd38778bad,1,Yusaku Sako,2012-11-07 04:18:45+00:00,['677a6773bff44793beff835ea095af14a763ef64'],15,29,44,13181042,5,1,1,1,6883
6fb8f3d8cabd6457a9e59606b45ec45f00f594fa,1,Yusaku Sako,2012-11-07 04:27:13+00:00,['b9b7401dd0322a9d35d4fc1239fe97fd38778bad'],858,614,1472,13182514,28,1,1,0.958333333,6883
b8959b8b7ec7619bdb227feb42d123935b37210a,1,Yusaku Sako,2012-11-07 04:30:28+00:00,['6fb8f3d8cabd6457a9e59606b45ec45f00f594fa'],69,763,832,13183346,18,0.057142857,0.132142857,0.921428571,6895
e326e13c323f206fab6b887e227d71d46ff0358f,1,Yusaku Sako,2012-11-07 04:35:45+00:00,['b8959b8b7ec7619bdb227feb42d123935b37210a'],24,37,61,13183407,6,1,1,1,6895
543e9851d9c3512bcff2c06a5ef79e0b3fa59d8d,0,Yusaku Sako,2012-11-07 04:38:56+00:00,['e326e13c323f206fab6b887e227d71d46ff0358f'],39,35,74,13183481,9,0,0.166666667,0,6895
f305fb30e52567b2002e736fb27ee6ed81e2575e,1,Yusaku Sako,2012-11-07 04:41:23+00:00,['543e9851d9c3512bcff2c06a5ef79e0b3fa59d8d'],17,21,38,13183519,6,1,1,1,6895
a12bb10131ca66e48e524500092695ecdcc86fea,1,Mahadev Konar,2012-11-07 08:13:12+00:00,['f305fb30e52567b2002e736fb27ee6ed81e2575e'],2913,19531,22444,13205963,300,0.389458955,0.60051306,0.862873134,6989
c2264fedc1ca9ed27ba56513823fc52fea400230,1,Mahadev Konar,2012-11-07 08:19:54+00:00,['a12bb10131ca66e48e524500092695ecdcc86fea'],1207,22830,24037,13230000,35,0.616977226,0.6873706,0.743271222,7000
29ded1af8304ab51f46cf2f7cb0edb6a44226a3a,1,Mahadev Konar,2012-11-07 08:27:36+00:00,['c2264fedc1ca9ed27ba56513823fc52fea400230'],362,700,1062,13231062,50,0,0.72,0.765714286,7001
e3b14497c51c125be53542ed112360b6ae6aed74,1,Mahadev Konar,2012-11-07 08:32:11+00:00,['29ded1af8304ab51f46cf2f7cb0edb6a44226a3a'],1367,2212,3579,13234641,41,0.09939759,0.840361446,1,7013
36d646ee25536c2584f7e5e94fdaf8637b7066d3,1,Mahadev Konar,2012-11-07 08:49:58+00:00,['e3b14497c51c125be53542ed112360b6ae6aed74'],2457,12787,15244,13249885,126,0.375815167,0.947643004,0.940749022,7106
573ef74745f43692bdf07712032b1cfc1c61f219,1,Yusaku Sako,2012-11-08 02:40:49+00:00,['36d646ee25536c2584f7e5e94fdaf8637b7066d3'],247,387,634,13250519,14,0.046511628,1,1,7106
e12ffac1e8d56b71985c78e55b43064deccfc410,1,Yusaku Sako,2012-11-08 02:46:20+00:00,['573ef74745f43692bdf07712032b1cfc1c61f219'],23,46,69,13250588,3,0.35,0,1,7106
81204b28219e5c109c1de448b98d4dddf340c171,1,Yusaku Sako,2012-11-08 02:49:01+00:00,['e12ffac1e8d56b71985c78e55b43064deccfc410'],2,5,7,13250595,2,,,,7106
ea861a49258ae51218e0d3bc559f365cf2866c26,1,Yusaku Sako,2012-11-08 02:53:32+00:00,['81204b28219e5c109c1de448b98d4dddf340c171'],50,416,466,13251061,14,0.494736842,1,1,7106
3122e9d47d356024eb601734fed3b087f3ac6706,1,Yusaku Sako,2012-12-09 11:53:15+00:00,['ea861a49258ae51218e0d3bc559f365cf2866c26'],2016,3870,5886,13256947,84,0.459407832,0.76313276,0.936962751,7122
24ae0762118093f3406e10d9436a5b7c1fd8c4c0,1,Yusaku Sako,2012-12-09 11:57:37+00:00,['3122e9d47d356024eb601734fed3b087f3ac6706'],188,374,562,13257509,31,0.796296296,1,0.796296296,7122
744a1c9ab22a18aec6c85bd5fb09fac8f591b3d9,1,Yusaku Sako,2012-12-09 12:05:10+00:00,['24ae0762118093f3406e10d9436a5b7c1fd8c4c0'],478,684,1162,13258671,36,1,0.964912281,0.859649123,7126
4c8b6cddda7b4672b45b32772efacc10c34f56a5,1,Yusaku Sako,2012-12-09 12:06:57+00:00,['744a1c9ab22a18aec6c85bd5fb09fac8f591b3d9'],55,54,109,13258780,28,,,,7126
fb75fa8eaa80528e6f069a76f5849491bc73b302,1,Yusaku Sako,2012-12-09 12:09:34+00:00,['4c8b6cddda7b4672b45b32772efacc10c34f56a5'],106,228,334,13259114,10,0.375,0.375,1,7127
476db5916ec671dbac18fd39918af530b0e19943,1,Yusaku Sako,2012-12-09 12:11:49+00:00,['fb75fa8eaa80528e6f069a76f5849491bc73b302'],15,11,26,13259140,3,1,1,1,7127
c6281e51187ffbc5fad61f5920a7c21bc52d07a0,1,Yusaku Sako,2012-12-09 12:13:51+00:00,['476db5916ec671dbac18fd39918af530b0e19943'],13,23,36,13259176,3,0.833333333,1,1,7127
a02355f314676567e8e354ac629410d4ec5b6a5d,1,Yusaku Sako,2012-12-09 12:21:22+00:00,['c6281e51187ffbc5fad61f5920a7c21bc52d07a0'],808,860,1668,13260844,37,0,0.388888889,0.925925926,7133
7a1bcf778cdeae0ed8de69d07216f3a1a1b4f0ad,0,Yusaku Sako,2012-12-09 12:22:47+00:00,['a02355f314676567e8e354ac629410d4ec5b6a5d'],1,1,2,13260846,1,,,,7133
8d93e7866e691b78018b1c884e0457e6c564669b,0,Yusaku Sako,2012-12-09 12:27:11+00:00,['7a1bcf778cdeae0ed8de69d07216f3a1a1b4f0ad'],258,230,488,13261334,15,1,1,1,7135
d9bae744eb217fae96e7df35bc201923ebc5748a,1,Yusaku Sako,2012-12-09 12:29:35+00:00,['8d93e7866e691b78018b1c884e0457e6c564669b'],24,135,159,13261493,11,1,1,1,7135
78939c196ec4ecefc6b9bdea2ec5dbad7b1cd0a2,1,Yusaku Sako,2012-12-09 12:37:57+00:00,['d9bae744eb217fae96e7df35bc201923ebc5748a'],826,1317,2143,13263636,120,1,0.76344086,0.946236559,7136
9c9b862231651981928286808669e2ee51673a84,1,Yusaku Sako,2012-12-09 12:43:31+00:00,['78939c196ec4ecefc6b9bdea2ec5dbad7b1cd0a2'],519,3626,4145,13267781,19,0.990950226,1,0.918552036,7142
2d91266ab926b76048779b200f47139b87cb8e3f,1,Yusaku Sako,2012-12-09 12:48:31+00:00,['9c9b862231651981928286808669e2ee51673a84'],84,660,744,13268525,10,0.474226804,0.701030928,1,7143
0602ad27ea15c364f5980dc967d8d9c076b34d6b,1,Yusaku Sako,2012-12-09 12:54:34+00:00,['2d91266ab926b76048779b200f47139b87cb8e3f'],471,592,1063,13269588,20,0.032432432,0.016216216,0,7143
70be340448eafae5005fd3e96df0df3cbd52e226,1,Yusaku Sako,2012-12-09 12:57:55+00:00,['0602ad27ea15c364f5980dc967d8d9c076b34d6b'],16,36,52,13269640,4,1,1,0,7143
fe001feab987d52d5b66276343879c819bb5cbde,1,Yusaku Sako,2012-12-09 13:03:01+00:00,['70be340448eafae5005fd3e96df0df3cbd52e226'],258,2002,2260,13271900,28,0,1,1,7148
e62cdf99baa6aabd376e59f6f7af977ee02dfaa1,1,Yusaku Sako,2012-12-09 13:05:18+00:00,['fe001feab987d52d5b66276343879c819bb5cbde'],102,310,412,13272312,10,0.52173913,0.739130435,1,7149
2e87803c3dc9134ab4723b0241a39a226ca3fa0e,1,Yusaku Sako,2012-12-09 13:08:21+00:00,['e62cdf99baa6aabd376e59f6f7af977ee02dfaa1'],29,176,205,13272517,16,0.891891892,1,0.891891892,7151
bec99af9cc9707b68feec45825c81c35bb14aef2,1,Yusaku Sako,2012-12-09 13:11:13+00:00,['2e87803c3dc9134ab4723b0241a39a226ca3fa0e'],129,297,426,13272943,9,0.441860465,0.395348837,1,7152
b7255ac61868f15ba7b658f8e38d2372057e55ac,1,Yusaku Sako,2012-12-09 13:14:22+00:00,['bec99af9cc9707b68feec45825c81c35bb14aef2'],23,45,68,13273011,3,0,0,1,7152
98f77e2a5770d6a3b7e29add893c0c982348eafe,1,Yusaku Sako,2012-12-09 13:17:38+00:00,['b7255ac61868f15ba7b658f8e38d2372057e55ac'],55,170,225,13273236,9,0,0,1,7152
33ec01f1701f3095a96e2cdc875fc2efb6bd8b9b,1,Yusaku Sako,2012-12-09 13:22:27+00:00,['98f77e2a5770d6a3b7e29add893c0c982348eafe'],1175,1989,3164,13276400,67,0.464285714,0,0.25,7152
76a8cc191fa9f5130382c7960f11090a134fcd2d,1,Yusaku Sako,2012-12-09 13:25:59+00:00,['33ec01f1701f3095a96e2cdc875fc2efb6bd8b9b'],17,252,269,13276669,17,0.184782609,0.206521739,1,7156
aa675fde9eb214d8f70b6e0bcb6a518e0a789065,0,Yusaku Sako,2012-12-09 13:27:36+00:00,['76a8cc191fa9f5130382c7960f11090a134fcd2d'],66,124,190,13276859,8,0.965517241,1,0.793103448,7156
465917e291b5a4133741bd6b1db9aa12a3af06a0,1,Yusaku Sako,2012-12-09 13:29:52+00:00,['aa675fde9eb214d8f70b6e0bcb6a518e0a789065'],18,30,48,13276907,9,0,0,1,7156
6e0b836d9eba9502454f0f3cb6271c236cd6cf3e,1,Yusaku Sako,2012-12-09 13:32:45+00:00,['465917e291b5a4133741bd6b1db9aa12a3af06a0'],43,160,203,13277110,12,0.673076923,1,1,7159
6b5925ee37bf169ca98590a4aa628c4ea6c510ea,1,Yusaku Sako,2012-12-09 13:35:15+00:00,['6e0b836d9eba9502454f0f3cb6271c236cd6cf3e'],486,1011,1497,13278607,10,0.55,1,1,7160
8bf497655267cf5120e7a5989aae7be2111c4d4a,0,Yusaku Sako,2012-12-09 13:37:36+00:00,['6b5925ee37bf169ca98590a4aa628c4ea6c510ea'],124,66,190,13278797,8,0.034482759,0,0.206896552,7160
9628208297029988e2d04f8e2597ba8f3013393e,1,Yusaku Sako,2012-12-09 13:40:13+00:00,['8bf497655267cf5120e7a5989aae7be2111c4d4a'],161,1249,1410,13280207,17,0.528301887,0.245283019,1,7161
536a305dce59b876b4c728e01bf785f7cd2e1948,1,Yusaku Sako,2012-12-09 13:43:07+00:00,['9628208297029988e2d04f8e2597ba8f3013393e'],284,22712,22996,13303203,47,0.698924731,0.913978495,1,7177
0135ae98f75ef2f7550c2477f1fbb750332cdfe6,0,Yusaku Sako,2012-12-09 13:45:47+00:00,['536a305dce59b876b4c728e01bf785f7cd2e1948'],12,19,31,13303234,4,1,1,1,7177
8bf288100803f3363221491485c99b7812dfe175,1,Yusaku Sako,2012-12-09 13:50:03+00:00,['0135ae98f75ef2f7550c2477f1fbb750332cdfe6'],2809,3990,6799,13310033,96,0.935897436,0.923076923,1,7180
d1ad27f934055d87b2481e36fb65a08755081ee2,1,Yusaku Sako,2012-12-09 13:52:32+00:00,['8bf288100803f3363221491485c99b7812dfe175'],136,1535,1671,13311704,25,0.626262626,0.888888889,1,7185
46eb1a01782ee64c2d7cb7f1a1fe54f04ba1df50,0,Yusaku Sako,2012-12-09 13:57:36+00:00,['d1ad27f934055d87b2481e36fb65a08755081ee2'],8,22,30,13311734,4,1,1,1,7185
00ba841494a44f60b1888377fa8fc8972eb1ce2b,1,Yusaku Sako,2012-12-09 14:00:34+00:00,['46eb1a01782ee64c2d7cb7f1a1fe54f04ba1df50'],18362,4257,22619,13334353,47,0.654366544,0.842558426,0.916359164,7187
5ef37e1708ecad97d3576303a03d0ca613a437b0,1,Yusaku Sako,2012-12-09 14:03:08+00:00,['00ba841494a44f60b1888377fa8fc8972eb1ce2b'],38,71,109,13334462,6,0.3,0.9,1,7187
68ebef6cf05fc2ce1afb0b021484a3dbedfbcb84,1,Yusaku Sako,2012-12-09 14:05:05+00:00,['5ef37e1708ecad97d3576303a03d0ca613a437b0'],300,661,961,13335423,31,0.815789474,0.903508772,0.894736842,7190
41dfe5d74f5c5d5bbda94ae7e9652c6e3020bbdf,0,Yusaku Sako,2012-12-09 14:07:52+00:00,['68ebef6cf05fc2ce1afb0b021484a3dbedfbcb84'],15,18,33,13335456,2,,,,7190
0769fc6f9f2cf39c30c0e7e597d7a01b85b70f28,1,Yusaku Sako,2012-12-09 14:11:19+00:00,['41dfe5d74f5c5d5bbda94ae7e9652c6e3020bbdf'],342,753,1095,13336551,56,0.9609375,0.9921875,0.9609375,7191
4f89d2e064924c11477cbefe72adf815ae88a135,1,Yusaku Sako,2012-12-09 14:14:17+00:00,['0769fc6f9f2cf39c30c0e7e597d7a01b85b70f28'],3,75,78,13336629,8,0.163265306,0.571428571,1,7191
fec2e11885cabf716945c91239e881f7e0aafc59,0,Yusaku Sako,2012-12-09 14:15:29+00:00,['4f89d2e064924c11477cbefe72adf815ae88a135'],5,6,11,13336640,1,1,1,1,7191
435a7ca63d3995523e9bc9fa9761279b32cf7019,1,Yusaku Sako,2012-12-09 14:18:52+00:00,['fec2e11885cabf716945c91239e881f7e0aafc59'],20,153,173,13336813,8,0.779069767,0.988372093,1,7191
0eabc1a3c69955d8cf324d4a8d2460da63d74db8,1,Yusaku Sako,2012-12-09 14:21:37+00:00,['435a7ca63d3995523e9bc9fa9761279b32cf7019'],2826,3370,6196,13343009,60,0.34939759,0.763855422,0.930120482,7194
59100605114056bb819e6e568af24dd20b4a350d,1,Yusaku Sako,2012-12-09 14:23:41+00:00,['0eabc1a3c69955d8cf324d4a8d2460da63d74db8'],40,63,103,13343112,5,0.181818182,0.181818182,1,7194
d9376e87ca32940e03ea57ddb74c0dcd1b613d0c,1,Yusaku Sako,2012-12-09 14:25:12+00:00,['59100605114056bb819e6e568af24dd20b4a350d'],335,503,838,13343950,15,0.792079208,0.376237624,0.851485149,7194
762191fe315b95f9c7a6626ad5c1ab425e156649,1,Yusaku Sako,2012-12-09 14:28:13+00:00,['d9376e87ca32940e03ea57ddb74c0dcd1b613d0c'],3,16,19,13343969,4,0,0,1,7194
18f6dd5c550d39e8658f8bf16a3edf2e98a2a2d8,0,Yusaku Sako,2012-12-09 14:30:27+00:00,['762191fe315b95f9c7a6626ad5c1ab425e156649'],23,52,75,13344044,8,0.333333333,0,1,7196
b885ee6ce8140e712ac865b502e8148722b88d37,0,Yusaku Sako,2012-12-09 14:32:16+00:00,['18f6dd5c550d39e8658f8bf16a3edf2e98a2a2d8'],1,34,35,13344079,2,1,0,0,7196
49e6352f0dc6bdb1dfd2c4caf157b4f8b0ba57f7,0,Yusaku Sako,2012-12-09 14:34:42+00:00,['b885ee6ce8140e712ac865b502e8148722b88d37'],42,53,95,13344174,2,0,1,1,7196
155742a74e5b265d0f35810d93bfc671d7bd58ce,0,Yusaku Sako,2012-12-09 14:35:43+00:00,['49e6352f0dc6bdb1dfd2c4caf157b4f8b0ba57f7'],4,4,8,13344182,4,,,,7196
6497697a1d6f0ba2b9fd58330c7f48b2dd95e306,1,Yusaku Sako,2012-12-09 14:37:51+00:00,['155742a74e5b265d0f35810d93bfc671d7bd58ce'],21,26,47,13344229,13,1,1,1,7196
ec1abe07667f65636846fc42e5e1bd91d552acb2,1,Yusaku Sako,2012-12-09 14:40:20+00:00,['6497697a1d6f0ba2b9fd58330c7f48b2dd95e306'],508,800,1308,13345537,29,1,1,0,7197
7ab2fbf4fbb083bc41b24bf361a2b0dae3eaad79,1,Yusaku Sako,2012-12-09 14:42:31+00:00,['ec1abe07667f65636846fc42e5e1bd91d552acb2'],10,199,209,13345746,10,0.603448276,0.732758621,1,7198
5ed4c1c13bc61b69ab0b6733e065d55e81db1504,1,Yusaku Sako,2012-12-09 14:45:11+00:00,['7ab2fbf4fbb083bc41b24bf361a2b0dae3eaad79'],8,11,19,13345765,4,,,,7198
c357ac4960385fd55240887a6b9b8c0f76d35672,1,Yusaku Sako,2012-12-09 14:47:44+00:00,['5ed4c1c13bc61b69ab0b6733e065d55e81db1504'],568,583,1151,13346916,53,0,0,0.5,7200
856f382c42a6dc8efcce1b2524d74b93c3d53869,1,Yusaku Sako,2012-12-09 14:51:22+00:00,['c357ac4960385fd55240887a6b9b8c0f76d35672'],44,792,836,13347752,23,0.746666667,0.968888889,0.773333333,7211
0ea9f9b7780a6896530235343c6894c14424944e,1,Yusaku Sako,2012-12-09 14:53:08+00:00,['856f382c42a6dc8efcce1b2524d74b93c3d53869'],549,3294,3843,13351595,23,1,1,1,7213
67cc2e29819521cedc833e169359e39dc42b8637,1,Yusaku Sako,2012-12-09 14:55:26+00:00,['0ea9f9b7780a6896530235343c6894c14424944e'],90,159,249,13351844,13,0.842105263,0.368421053,1,7213
26429c08a436ed8561e0e770bd9109352dcfbc29,1,Yusaku Sako,2012-12-09 14:56:58+00:00,['67cc2e29819521cedc833e169359e39dc42b8637'],115,338,453,13352297,29,0.936842105,0.694736842,1,7213
7c45596821f21f774bc3962a167ee4606062d79e,1,Yusaku Sako,2012-12-09 14:58:46+00:00,['26429c08a436ed8561e0e770bd9109352dcfbc29'],70,778,848,13353145,7,1,1,1,7213
b721857ca3dc4fe66dee0238ea87e8f5ea537cdb,0,Yusaku Sako,2012-12-09 15:00:41+00:00,['7c45596821f21f774bc3962a167ee4606062d79e'],5,15,20,13353165,4,,,,7213
19a5aeee7f6ea90fe16efb7c8e9671e80710fc2e,1,Yusaku Sako,2012-12-09 15:02:17+00:00,['b721857ca3dc4fe66dee0238ea87e8f5ea537cdb'],150,117,267,13353432,7,0,0,0,7213
115489a10f16bd41b6f19491709b45ecde42365b,1,Yusaku Sako,2012-12-09 15:05:19+00:00,['19a5aeee7f6ea90fe16efb7c8e9671e80710fc2e'],173,377,550,13353982,13,0.776315789,0.664473684,1,7213
28a9ae32d340739fc230ea020de3f153d8e59131,1,Yusaku Sako,2012-12-09 15:10:57+00:00,['115489a10f16bd41b6f19491709b45ecde42365b'],941,5989,6930,13360912,93,1,1,0.9625,7226
2f2ad380560a41f8241605ffc15a262795e76f57,1,Yusaku Sako,2012-12-09 15:13:09+00:00,['28a9ae32d340739fc230ea020de3f153d8e59131'],13,21,34,13360946,4,0,1,1,7226
ee1801a10bdf1a74de65b377a5b18efbd89a0df0,1,Yusaku Sako,2012-12-09 15:14:23+00:00,['2f2ad380560a41f8241605ffc15a262795e76f57'],44,64,108,13361054,3,1,1,1,7226
650f165c987d3b1f59dd3f926ed08a15e3a50aa8,0,Yusaku Sako,2012-12-09 15:15:50+00:00,['ee1801a10bdf1a74de65b377a5b18efbd89a0df0'],2,5,7,13361061,3,,,,7226
2327f56fb2651f737cea89f9ce7eed78703b956c,1,Yusaku Sako,2012-12-09 15:18:23+00:00,['650f165c987d3b1f59dd3f926ed08a15e3a50aa8'],460,2983,3443,13364504,33,0.463157895,0.263157895,1,7233
750bc81fc796b8b8bc348ea75336966f656de083,1,Yusaku Sako,2012-12-09 15:20:25+00:00,['2327f56fb2651f737cea89f9ce7eed78703b956c'],57,85,142,13364646,7,1,1,1,7233
9b15091e8f0ebae95f513fc27a4bf075bd052eda,1,Yusaku Sako,2012-12-09 15:23:01+00:00,['750bc81fc796b8b8bc348ea75336966f656de083'],786,1799,2585,13367231,64,0.499145299,0.629059829,1,7234
3afc913756dfe80f6dd75bc9d6da9d4b9ec2704e,0,Jitendra Nath Pandey,2012-12-12 21:25:25+00:00,"['264db1fb32c886d559eb146d007d6b0552487ce8', '9b15091e8f0ebae95f513fc27a4bf075bd052eda']",150981,245929,396910,13764141,2164,,,,7234
b87dc45ed36daeb9823df1a1849cc8b67fbd6a86,1,Mahadev Konar,2012-12-13 02:03:13+00:00,['3afc913756dfe80f6dd75bc9d6da9d4b9ec2704e'],27376,402154,429530,14193671,2575,0.626192107,0.731331318,0.901942445,9373
675d6aeb5435c502640f47854af0e04b8428d697,0,Mahadev Konar,2012-12-13 02:39:54+00:00,['b87dc45ed36daeb9823df1a1849cc8b67fbd6a86'],633,0,633,14194304,1,,,,9373
d5d479767556b28bef2541b87bb4afa3bfa84f93,0,Yusaku Sako,2012-12-14 01:36:53+00:00,['675d6aeb5435c502640f47854af0e04b8428d697'],358188,0,358188,14552492,1989,0.364210514,0.265912696,0.096269223,9373
aa9d4ab063cb0c53bed5d769a7d195887cf312c6,0,Yusaku Sako,2012-12-14 02:28:34+00:00,['d5d479767556b28bef2541b87bb4afa3bfa84f93'],0,122,122,14552614,1,,,,9373
d3864eb75d26071c035a5a78d72a2bec432de11d,0,Yusaku Sako,2012-12-14 04:19:14+00:00,['aa9d4ab063cb0c53bed5d769a7d195887cf312c6'],3,195,198,14552812,1,,,,9373
0d5733556fd5798dd1e01f742b0e226d803d818f,0,Yusaku Sako,2012-12-14 04:59:19+00:00,['d3864eb75d26071c035a5a78d72a2bec432de11d'],0,3,3,14552815,1,,,,9373
35a0042c3add1582bbacdbab82658da012976dc1,1,Yusaku Sako,2012-12-14 07:17:42+00:00,['0d5733556fd5798dd1e01f742b0e226d803d818f'],0,1000,1000,14553815,8,,,,9381
207ca55b658e96f5210c8177eff1f9144d59c481,1,Yusaku Sako,2013-01-10 19:52:05+00:00,['35a0042c3add1582bbacdbab82658da012976dc1'],1611,23647,25258,14579073,91,0.460093897,0.840375587,0.981220657,9391
46a5083e4daa40236101aaafe0c461dad66de7e5,1,Yusaku Sako,2013-01-10 19:55:32+00:00,['207ca55b658e96f5210c8177eff1f9144d59c481'],11,53,64,14579137,7,0.285714286,1,1,9391
4309db897f71c675089c30e63a83ba396dd810d8,1,Yusaku Sako,2013-01-10 19:58:18+00:00,['46a5083e4daa40236101aaafe0c461dad66de7e5'],2,22,24,14579161,3,0,1,1,9391
7ef0f4abc9c723bbf3043f174f2dab6b274ebdb5,0,Yusaku Sako,2013-01-10 20:00:02+00:00,['4309db897f71c675089c30e63a83ba396dd810d8'],3,15,18,14579179,4,1,1,1,9391
519dd02fe481dbb167a1b910fd522a1a4bb2ff10,1,Yusaku Sako,2013-01-10 20:02:27+00:00,['7ef0f4abc9c723bbf3043f174f2dab6b274ebdb5'],18,11,29,14579208,6,0,0,0,9391
0a386386a838dec7f98fdcfe25d8788e1059e9e4,0,Yusaku Sako,2013-01-10 20:08:11+00:00,['519dd02fe481dbb167a1b910fd522a1a4bb2ff10'],3,6,9,14579217,3,,,,9391
a4631cf7bcd80fec1fa8ea97c0daffe916e045e2,1,Yusaku Sako,2013-01-10 20:11:39+00:00,['0a386386a838dec7f98fdcfe25d8788e1059e9e4'],213,2872,3085,14582302,30,0.846153846,0.956043956,1,9392
06156c5e57d990c3cbfbd3c38a329add26f2f6b4,0,Yusaku Sako,2013-01-10 20:13:40+00:00,['a4631cf7bcd80fec1fa8ea97c0daffe916e045e2'],4,4,8,14582310,2,0.333333333,0.888888889,1,9392
faa7d8d3ec177d45e24387fd71e52b7d6c2d7a8b,1,Yusaku Sako,2013-01-10 20:24:29+00:00,['06156c5e57d990c3cbfbd3c38a329add26f2f6b4'],3,40,43,14582353,5,0,0,1,9393
b2f7f5fad6e405fcd5f3363e16b060dfc8fd7c5e,1,Yusaku Sako,2013-01-10 20:26:48+00:00,['faa7d8d3ec177d45e24387fd71e52b7d6c2d7a8b'],3,17,20,14582373,3,1,1,0,9393
d4ef1be1512e5270068cfb107278acf4fa165e14,1,Yusaku Sako,2013-01-10 20:32:11+00:00,['b2f7f5fad6e405fcd5f3363e16b060dfc8fd7c5e'],164,135,299,14582672,15,0,0,0,9393
6fb948026ea73aba0a9e261e104877e962fdf16a,1,Yusaku Sako,2013-01-10 20:33:58+00:00,['d4ef1be1512e5270068cfb107278acf4fa165e14'],10,10,20,14582692,3,1,1,0,9393
9c007275bb29a643889808f0c14899d52a665023,0,Yusaku Sako,2013-01-10 20:36:14+00:00,['6fb948026ea73aba0a9e261e104877e962fdf16a'],4,6,10,14582702,2,,,,9393
709f87e0b8aa8eb26de17a52a640e876ce9da180,1,Yusaku Sako,2013-01-10 20:41:29+00:00,['9c007275bb29a643889808f0c14899d52a665023'],2,12,14,14582716,2,0,0,1,9393
f8117d2348b3bef35d2b6c8738d8986c7b3641dc,1,Yusaku Sako,2013-01-10 20:44:51+00:00,['709f87e0b8aa8eb26de17a52a640e876ce9da180'],4,30,34,14582750,3,0,0,1,9393
180ed4b8cb5ce0a9b1299fea7bf1527cb2a3ab67,1,Yusaku Sako,2013-01-10 20:55:12+00:00,['f8117d2348b3bef35d2b6c8738d8986c7b3641dc'],362,9372,9734,14592484,28,0.42364532,0,0,9393
7246140021c8f1c8c9f0280ed57d444bf60b0bf8,0,Yusaku Sako,2013-01-10 21:11:21+00:00,['180ed4b8cb5ce0a9b1299fea7bf1527cb2a3ab67'],7,17,24,14592508,7,0.375,0.375,1,9393
a38f982d320166a07b0828e6151b35830e8ae692,1,Yusaku Sako,2013-01-10 21:13:57+00:00,['7246140021c8f1c8c9f0280ed57d444bf60b0bf8'],83,281,364,14592872,9,0.393063584,1,1,9394
e954fd0dbda86a1ac2fab99c752d792c6dc715a4,1,Yusaku Sako,2013-01-10 21:15:58+00:00,['a38f982d320166a07b0828e6151b35830e8ae692'],61,75,136,14593008,10,0,0,1,9394
0eddcbd936b29a31c48b618d543784505eba34ec,1,Yusaku Sako,2013-01-10 21:19:22+00:00,['e954fd0dbda86a1ac2fab99c752d792c6dc715a4'],299,236,535,14593543,4,0.112244898,0.908163265,0.918367347,9394
a17b15911209ab39755af815500e677cf868d11e,1,Yusaku Sako,2013-01-10 21:21:54+00:00,['0eddcbd936b29a31c48b618d543784505eba34ec'],49,88,137,14593680,16,1,0.318181818,1,9394
ad55ce1fd805a6ffca05de40161bc44014b61859,1,Yusaku Sako,2013-01-10 21:24:00+00:00,['a17b15911209ab39755af815500e677cf868d11e'],127,33,160,14593840,5,0,0,0.783333333,9394
1f1fcf77d44a09157537d5848e64c949426a4b8c,0,Yusaku Sako,2013-01-10 21:25:32+00:00,['ad55ce1fd805a6ffca05de40161bc44014b61859'],2,5,7,14593847,3,,,,9394
7e00fc381d0f093c9f59ab3c160f1d8f14d2e752,1,Yusaku Sako,2013-01-10 21:31:03+00:00,['1f1fcf77d44a09157537d5848e64c949426a4b8c'],66,140,206,14594053,6,0,0,1,9394
c4df025ddabf2879180006fa0848813d40bd609c,0,Yusaku Sako,2013-01-10 21:32:32+00:00,['7e00fc381d0f093c9f59ab3c160f1d8f14d2e752'],8,19,27,14594080,1,0,0,0,9394
31fef9aa44cca9dd1519b03a5855eaa7b2bb9a52,1,Yusaku Sako,2013-01-10 21:47:42+00:00,['c4df025ddabf2879180006fa0848813d40bd609c'],131,868,999,14595079,36,1,1,1,9398
3d7a6941e06c3b40c1488504f638ff3a2a43655f,1,Yusaku Sako,2013-01-10 21:57:34+00:00,['31fef9aa44cca9dd1519b03a5855eaa7b2bb9a52'],23,58,81,14595160,2,0.3125,0,0.21875,9398
69b6169cf99eecffa72eb96aa56190955f91d1f0,1,Yusaku Sako,2013-01-11 00:38:17+00:00,['3d7a6941e06c3b40c1488504f638ff3a2a43655f'],17,178,195,14595355,9,0.54,1,0.9,9399
7d8f95bdc8f162b2ea88e1e0493a653f728ccca8,1,Yusaku Sako,2013-01-11 00:41:57+00:00,['69b6169cf99eecffa72eb96aa56190955f91d1f0'],56,155,211,14595566,3,0.614035088,1,0.973684211,9399
593ed9519f018d6cd76831ca0a86ea934976f91b,1,Yusaku Sako,2013-01-11 00:45:16+00:00,['7d8f95bdc8f162b2ea88e1e0493a653f728ccca8'],15,52,67,14595633,3,0.371428571,0.428571429,1,9399
fe763097f47b7beb662a9d78bbb04b61cc2f0bc4,1,Yusaku Sako,2013-01-11 00:49:54+00:00,['593ed9519f018d6cd76831ca0a86ea934976f91b'],27,38,65,14595698,3,0,1,1,9399
3881acfc107d6be4d367ad5259f5e8bb0c585e76,1,Yusaku Sako,2013-01-11 00:51:26+00:00,['fe763097f47b7beb662a9d78bbb04b61cc2f0bc4'],20,43,63,14595761,4,1,1,1,9399
bab1f46b260f4242c4cd077757ae10ba35e83e81,1,Yusaku Sako,2013-01-11 00:56:37+00:00,['3881acfc107d6be4d367ad5259f5e8bb0c585e76'],1,7,8,14595769,2,1,1,1,9399
aec69090d337471e01a890db198dc1296f2167d5,1,Yusaku Sako,2013-01-11 01:04:01+00:00,['bab1f46b260f4242c4cd077757ae10ba35e83e81'],0,27,27,14595796,2,0,0,1,9399
6f0f66a81b931eacd620d39efe2756f0c425fc97,1,Yusaku Sako,2013-01-11 01:06:33+00:00,['aec69090d337471e01a890db198dc1296f2167d5'],125,190,315,14596111,26,1,1,0.482758621,9399
a0e6e2a8874b54d79d0ce98bb674bbf6a0bed637,1,Yusaku Sako,2013-01-11 01:07:52+00:00,['6f0f66a81b931eacd620d39efe2756f0c425fc97'],116,147,263,14596374,4,0,1,0.307692308,9399
64e7b7b55881ce67f0aae029c998a5ed193af444,0,Yusaku Sako,2013-01-11 01:17:06+00:00,['a0e6e2a8874b54d79d0ce98bb674bbf6a0bed637'],7,10,17,14596391,4,0,0,0,9399
1e8c9308b5ff99777682028e4db19b1e2117ee1a,0,Yusaku Sako,2013-01-11 01:20:57+00:00,['64e7b7b55881ce67f0aae029c998a5ed193af444'],116,165,281,14596672,14,0,0,0.981818182,9399
cf18eca796a16b8c31a7e3f5b7d8118f2dd17bbc,1,Yusaku Sako,2013-01-11 01:29:03+00:00,['1e8c9308b5ff99777682028e4db19b1e2117ee1a'],102,162,264,14596936,3,0,0,0.727272727,9399
fd71cd58f29ac15e8ede88b4360b51e48690f908,1,Yusaku Sako,2013-01-11 01:31:41+00:00,['cf18eca796a16b8c31a7e3f5b7d8118f2dd17bbc'],162,129,291,14597227,9,1,1,0.022222222,9399
ed8c183a106e0613ea6c6ea2fa44ce2c49159e42,1,Yusaku Sako,2013-01-11 01:33:41+00:00,['fd71cd58f29ac15e8ede88b4360b51e48690f908'],84,193,277,14597504,7,0,0,1,9399
01eb8d93cc4bc8b97fea3cad24650894fdd8a959,1,Yusaku Sako,2013-01-11 01:35:18+00:00,['ed8c183a106e0613ea6c6ea2fa44ce2c49159e42'],6,44,50,14597554,6,0,0.5,1,9399
5c2df3df33d8ed5dd3045e67650bc8593657a0f1,1,Yusaku Sako,2013-01-11 01:40:12+00:00,['01eb8d93cc4bc8b97fea3cad24650894fdd8a959'],0,11,11,14597565,2,0,1,1,9399
5e3da1fd9190a6ffe540135dfa021dc7c0acf176,1,Yusaku Sako,2013-01-11 01:46:06+00:00,['5c2df3df33d8ed5dd3045e67650bc8593657a0f1'],7,36,43,14597608,4,0.416666667,1,1,9399
908b27f3b28a83979130e24741374146419a45d3,0,Yusaku Sako,2013-01-11 01:49:53+00:00,['5e3da1fd9190a6ffe540135dfa021dc7c0acf176'],0,12,12,14597620,2,1,1,1,9399
bd9b7ff1ad7bc66c618dcf6e892e083e0c6dfdd9,1,Yusaku Sako,2013-01-11 01:52:18+00:00,['908b27f3b28a83979130e24741374146419a45d3'],93,97,190,14597810,4,1,1,1,9399
69b7eb284f9df1fee59e8ca359b1f5cf8a741075,1,Yusaku Sako,2013-01-11 01:54:58+00:00,['bd9b7ff1ad7bc66c618dcf6e892e083e0c6dfdd9'],80,242,322,14598132,30,0.336283186,0.539823009,1,9400
84fa1d22bddc622c6210e45e0bd587d3fe9636b5,1,Yusaku Sako,2013-01-11 01:57:12+00:00,['69b7eb284f9df1fee59e8ca359b1f5cf8a741075'],9,34,43,14598175,3,0.19047619,0.19047619,1,9400
0087462d87c589242e120c6a3220c2f35ee9d50a,1,Yusaku Sako,2013-01-11 02:13:25+00:00,['84fa1d22bddc622c6210e45e0bd587d3fe9636b5'],45,114,159,14598334,20,0.830188679,0.490566038,1,9400
c81ed11739b3c2ed3ce3b909bf039f24bf50cfd3,0,Yusaku Sako,2013-01-11 02:15:49+00:00,['0087462d87c589242e120c6a3220c2f35ee9d50a'],6,10,16,14598350,2,1,1,1,9400
f846bfa1de52a57d8ec9e9d46e9d511af6c18033,1,Yusaku Sako,2013-01-11 02:17:49+00:00,['c81ed11739b3c2ed3ce3b909bf039f24bf50cfd3'],3,16,19,14598369,2,1,1,1,9400
80f29f4f457ebfb3e45b92040252ebdc6eaabb5f,1,Yusaku Sako,2013-01-11 02:19:13+00:00,['f846bfa1de52a57d8ec9e9d46e9d511af6c18033'],1,4,5,14598374,2,,,,9400
8a40d303c3a1c786fa7ba6d9cc09cebfd7b765a1,1,Yusaku Sako,2013-01-11 02:20:43+00:00,['80f29f4f457ebfb3e45b92040252ebdc6eaabb5f'],2,11,13,14598387,4,,,,9400
6baec0855368375f973c0c9b9877cc1c76b06a96,1,Yusaku Sako,2013-01-11 02:22:20+00:00,['8a40d303c3a1c786fa7ba6d9cc09cebfd7b765a1'],10,29,39,14598426,4,1,0,1,9400
516a387916a84581b6f3271b41b2608dd02b1a07,1,Yusaku Sako,2013-01-11 02:24:18+00:00,['6baec0855368375f973c0c9b9877cc1c76b06a96'],1,14,15,14598441,5,0,0.666666667,1,9400
1c413ff67f45a36365b54dce6ca45f90c47afbcc,1,Yusaku Sako,2013-01-11 02:25:18+00:00,['516a387916a84581b6f3271b41b2608dd02b1a07'],119,150,269,14598710,5,0.857142857,0,1,9400
1103bc9392b8fec1db13684235c1f13ff513441f,1,Yusaku Sako,2013-01-11 02:27:18+00:00,['1c413ff67f45a36365b54dce6ca45f90c47afbcc'],17,25,42,14598752,5,0.8,1,0.8,9400
95b1e8f0129db9080ce0c4eacfc43504547c90d7,1,Yusaku Sako,2013-01-11 02:29:09+00:00,['1103bc9392b8fec1db13684235c1f13ff513441f'],2,5,7,14598759,2,,,,9400
7c1820fb10592d8c66b9705a558ace339e8a58b3,1,Yusaku Sako,2013-01-11 02:30:30+00:00,['95b1e8f0129db9080ce0c4eacfc43504547c90d7'],534,51,585,14599344,15,0,0,0,9400
0e3debd27995019f01ccb6042249df0ebe1b37b1,1,Yusaku Sako,2013-01-11 02:31:46+00:00,['7c1820fb10592d8c66b9705a558ace339e8a58b3'],1,12,13,14599357,2,0,0,1,9400
01cc279e0fb647a7e07f9c95801e8bb8e110ac6d,0,Yusaku Sako,2013-01-11 02:33:53+00:00,['0e3debd27995019f01ccb6042249df0ebe1b37b1'],32,34,66,14599423,33,,,,9400
5ed5c4d87e2d10c468791824a6caa449270bee37,1,Yusaku Sako,2013-01-11 02:35:21+00:00,['01cc279e0fb647a7e07f9c95801e8bb8e110ac6d'],12,25,37,14599460,3,0,0.142857143,1,9400
6eed7569a34f12be9486be23dcb25377f6ad2584,0,Yusaku Sako,2013-01-11 02:36:51+00:00,['5ed5c4d87e2d10c468791824a6caa449270bee37'],1,9,10,14599470,3,1,1,1,9400
44efbaf96c49d61642facd0e7e89584a50e501b0,1,Yusaku Sako,2013-01-11 02:41:48+00:00,['6eed7569a34f12be9486be23dcb25377f6ad2584'],905,276,1181,14600651,55,0,0,0,9400
fc9afae4dd28119458765ba5622ae1a8f5a074c6,0,Yusaku Sako,2013-01-11 02:44:39+00:00,['44efbaf96c49d61642facd0e7e89584a50e501b0'],1,4,5,14600656,2,,,,9400
772c737ed75bc2239b264cc3fc8d528fe9d80115,1,Yusaku Sako,2013-01-11 02:46:24+00:00,['fc9afae4dd28119458765ba5622ae1a8f5a074c6'],3,23,26,14600682,6,0,0,1,9400
4dabb5a46dbd5db78a594303c6f610d1b392040d,0,Yusaku Sako,2013-01-11 02:52:17+00:00,['772c737ed75bc2239b264cc3fc8d528fe9d80115'],0,22,22,14600704,2,0,0,1,9400
ed5742336e8f5408406842e7c4334cf80d767424,1,Yusaku Sako,2013-01-11 02:55:53+00:00,['4dabb5a46dbd5db78a594303c6f610d1b392040d'],0,15,15,14600719,2,,,,9400
764392d54ace24a99d207c36427a3aa2b422004e,1,Yusaku Sako,2013-01-11 02:59:13+00:00,['ed5742336e8f5408406842e7c4334cf80d767424'],31,73,104,14600823,10,1,1,1,9400
f50acfccda05388fccddf6dd9f0b4d46da6d5f02,1,Yusaku Sako,2013-01-11 03:01:35+00:00,['764392d54ace24a99d207c36427a3aa2b422004e'],2,5,7,14600830,2,,,,9400
bb45951281054e6e3643251733182dffc26a03ca,1,Mahadev Konar,2013-01-11 03:02:37+00:00,['f50acfccda05388fccddf6dd9f0b4d46da6d5f02'],2885,7977,10862,14611692,195,0.550070522,0.705688764,0.933239304,9426
884353a8e5976260930567e6d6081d5ee2fe299b,1,Yusaku Sako,2013-01-11 03:08:21+00:00,['bb45951281054e6e3643251733182dffc26a03ca'],1,6,7,14611699,2,0,0,1,9426
544df2c96b9a69a51a1ad03dccca091453ded67b,1,Yusaku Sako,2013-01-11 03:10:51+00:00,['884353a8e5976260930567e6d6081d5ee2fe299b'],1,5,6,14611705,2,,,,9426
7bc11647641046c93f83f76ab567144a7ac9589c,1,Yusaku Sako,2013-01-11 03:14:13+00:00,['544df2c96b9a69a51a1ad03dccca091453ded67b'],52,46,98,14611803,10,1,1,0,9426
a2d00e4b9e947aa4f44d2ddebd4e5ae25abbdbcf,0,Yusaku Sako,2013-01-11 03:16:16+00:00,['7bc11647641046c93f83f76ab567144a7ac9589c'],1,3,4,14611807,2,0.5,1,1,9426
350ea2e27ec6bd2bb8b64b2ff8effe4aab77729c,0,Yusaku Sako,2013-01-11 03:16:49+00:00,['a2d00e4b9e947aa4f44d2ddebd4e5ae25abbdbcf'],0,2,2,14611809,1,,,,9426
655a9dd884742b29711bfc5437bf50e3bca09b07,1,Yusaku Sako,2013-01-11 03:19:14+00:00,['350ea2e27ec6bd2bb8b64b2ff8effe4aab77729c'],3,30,33,14611842,3,0.454545455,0.454545455,1,9426
8c208422ba5f96791bc3b4b663b48f822c2c63cf,0,Yusaku Sako,2013-01-11 03:19:53+00:00,['655a9dd884742b29711bfc5437bf50e3bca09b07'],0,3,3,14611845,1,,,,9426
29a817aa5f7bbf42ef77b953e60944a40bcd170e,0,Yusaku Sako,2013-01-11 03:21:35+00:00,['8c208422ba5f96791bc3b4b663b48f822c2c63cf'],1,5,6,14611851,2,,,,9426
a219509ebc6e6a2c863f40eca828e55651fcb8a5,1,Yusaku Sako,2013-01-11 03:30:44+00:00,['29a817aa5f7bbf42ef77b953e60944a40bcd170e'],518,248,766,14612617,33,0.263636364,0.095454545,0,9427
553f6eea3be5070f6ab8d449ff659c183dfbafd9,0,Yusaku Sako,2013-01-11 03:34:21+00:00,['a219509ebc6e6a2c863f40eca828e55651fcb8a5'],2,7,9,14612626,2,,,,9427
428ae0297b05138a91ede3d789a25ffa7c795390,1,Mahadev Konar,2013-01-11 05:20:30+00:00,['553f6eea3be5070f6ab8d449ff659c183dfbafd9'],189,549,738,14613364,14,0.442687747,0.770750988,0.256916996,9427
3d03e790e9668af4a92761b368deefb1ba246eb7,1,Mahadev Konar,2013-01-11 21:02:52+00:00,['428ae0297b05138a91ede3d789a25ffa7c795390'],134,496,630,14613994,35,0.691056911,0.902439024,0.967479675,9429
ff096b56b547df4a43f57045d1e501ba4976adb3,1,Mahadev Konar,2013-01-11 21:35:03+00:00,['3d03e790e9668af4a92761b368deefb1ba246eb7'],578,3294,3872,14617866,112,0.706214689,0.830508475,0.961864407,9458
4db5c63a06c7aeb8b06644deabc37e6f880f58bc,1,Mahadev Konar,2013-01-12 00:06:03+00:00,['ff096b56b547df4a43f57045d1e501ba4976adb3'],0,1,1,14617867,1,,,,9458
8c1bebcbe8134ef4f461322fae19a7e65a590d44,1,Yusaku Sako,2013-01-15 00:37:35+00:00,['4db5c63a06c7aeb8b06644deabc37e6f880f58bc'],1,4,5,14617872,2,,,,9458
df2bb11af0886bd192c001234910db127dc10c98,0,Srimanth,2013-01-15 01:57:17+00:00,['8c1bebcbe8134ef4f461322fae19a7e65a590d44'],1,1,2,14617874,1,,,,9458
1a45514b53a491bd26a85b6d50d5351256dc3eb8,0,Yusaku Sako,2013-01-15 02:38:54+00:00,['df2bb11af0886bd192c001234910db127dc10c98'],12,52,64,14617938,4,,,,9458
a90f0521be752215e82ef68028352cbc78b80471,1,Mahadev Konar,2013-01-15 18:10:03+00:00,['1a45514b53a491bd26a85b6d50d5351256dc3eb8'],40,416,456,14618394,20,0.607734807,0.900552486,0.834254144,9460
e71ba8c660654e3670ce2053a6316831473b089f,0,Yusaku Sako,2013-01-15 20:44:53+00:00,['a90f0521be752215e82ef68028352cbc78b80471'],17,21,38,14618432,2,,,,9460
34c090c456ecd5c7de7f6e61e4bbdd49ca32d9c9,0,Yusaku Sako,2013-01-15 20:46:40+00:00,['e71ba8c660654e3670ce2053a6316831473b089f'],30,14,44,14618476,3,,,,9460
02fc10357ca44334bd3af9fa433def177a225e9d,0,Yusaku Sako,2013-01-15 20:47:53+00:00,['34c090c456ecd5c7de7f6e61e4bbdd49ca32d9c9'],1,7,8,14618484,3,,,,9460
7ed62a144960cc09fd77d750f3899c0c488f4705,0,Yusaku Sako,2013-01-15 20:49:58+00:00,['02fc10357ca44334bd3af9fa433def177a225e9d'],0,11,11,14618495,2,0.375,1,1,9460
fc1353f8b24c07437ab0b5fb20fbab966cb5c902,1,Yusaku Sako,2013-01-15 20:53:10+00:00,['7ed62a144960cc09fd77d750f3899c0c488f4705'],25,20,45,14618540,14,0,0,0,9460
b605ad3cacdc3ad44408d3a26ff3a96820f69196,0,Yusaku Sako,2013-01-15 20:55:10+00:00,['fc1353f8b24c07437ab0b5fb20fbab966cb5c902'],0,2,2,14618542,1,,,,9460
46d8def90723283be31d1fcf40f21c069933f927,0,Yusaku Sako,2013-01-15 20:56:30+00:00,['b605ad3cacdc3ad44408d3a26ff3a96820f69196'],1,5,6,14618548,2,,,,9460
99bcb4c73c51bdc5881304cb7d3549b04107c4dd,1,Yusaku Sako,2013-01-15 20:58:09+00:00,['46d8def90723283be31d1fcf40f21c069933f927'],1,8,9,14618557,3,1,1,1,9460
1f5f1b6c67da0155348130d7f2f16f168579ee25,0,Yusaku Sako,2013-01-15 21:31:17+00:00,['99bcb4c73c51bdc5881304cb7d3549b04107c4dd'],1,4,5,14618562,2,,,,9460
70d18e971eae5049c924db9ef0efc6fd6fec353c,1,Yusaku Sako,2013-01-15 21:32:17+00:00,['1f5f1b6c67da0155348130d7f2f16f168579ee25'],1,3,4,14618566,2,,,,9460
8a9c996099d8b1fc0b609f81285764168c53c798,1,Yusaku Sako,2013-01-15 21:33:39+00:00,['70d18e971eae5049c924db9ef0efc6fd6fec353c'],125,104,229,14618795,4,0.913043478,0,0,9460
0cd4566d4eefc85721f32dfa1cd6fe6687f3fd98,1,Yusaku Sako,2013-01-15 21:34:47+00:00,['8a9c996099d8b1fc0b609f81285764168c53c798'],1153,833,1986,14620781,34,1,1,0,9460
c6b1bc99fcdc348560ad5768834f4e8f54540e18,1,Yusaku Sako,2013-01-17 00:29:01+00:00,['0cd4566d4eefc85721f32dfa1cd6fe6687f3fd98'],1,5,6,14620787,2,,,,9460
a596f07ca938d5766b4290625d11e68dd8d84303,0,Yusaku Sako,2013-01-17 01:09:08+00:00,['c6b1bc99fcdc348560ad5768834f4e8f54540e18'],2,4,6,14620793,2,,,,9460
cf5abee82d3861d77a3ca27a11f51d38b57d43a8,1,Yusaku Sako,2013-01-17 01:28:24+00:00,['a596f07ca938d5766b4290625d11e68dd8d84303'],2,5,7,14620800,3,,,,9460
905207918f1c05d303ee56a951998f08b1f7cf8a,1,Mahadev Konar,2013-01-18 23:05:09+00:00,['cf5abee82d3861d77a3ca27a11f51d38b57d43a8'],2883,33,2916,14623716,45,0.621118012,0.285714286,0.078674948,9460
2d68dc5ee771161b2731566e57766ba2c4e74e35,1,Mahadev Konar,2013-01-18 23:37:20+00:00,['905207918f1c05d303ee56a951998f08b1f7cf8a'],34,71,105,14623821,11,0.631578947,0,0.631578947,9460
03585c842fb29540c65c5e9990af011b996ea502,1,Mahadev Konar,2013-01-18 23:54:49+00:00,['2d68dc5ee771161b2731566e57766ba2c4e74e35'],824,934,1758,14625579,11,0.173333333,0.173333333,0.706666667,9461
0a93b79c6135d2d20de2e7d9f3f9486fa7231f1f,0,Yusaku Sako,2013-01-19 00:44:01+00:00,['03585c842fb29540c65c5e9990af011b996ea502'],1,4,5,14625584,2,,,,9461
a48bb341090369230105c2b719ce7503d34af84a,1,Yusaku Sako,2013-01-19 01:01:24+00:00,['0a93b79c6135d2d20de2e7d9f3f9486fa7231f1f'],14,10,24,14625608,2,1,1,0,9461
46f19b470f8870268caf9bbb23789b715d0c86a8,1,Yusaku Sako,2013-01-19 01:05:09+00:00,['a48bb341090369230105c2b719ce7503d34af84a'],10,40,50,14625658,4,1,1,0,9461
3739e59a707392b4dce89721c93279477b7495e6,1,Yusaku Sako,2013-01-19 01:11:14+00:00,['46f19b470f8870268caf9bbb23789b715d0c86a8'],300,362,662,14626320,7,1,1,1,9463
aa4a8f60c2fd5fbb71d33690cd9e7dc8e53b4bb3,0,Yusaku Sako,2013-01-19 01:13:53+00:00,['3739e59a707392b4dce89721c93279477b7495e6'],1,3,4,14626324,2,,,,9463
dfe69dde25e86829c3643604a0d9f855f7ce3bdf,0,Yusaku Sako,2013-01-19 01:17:49+00:00,['aa4a8f60c2fd5fbb71d33690cd9e7dc8e53b4bb3'],0,5,5,14626329,2,,,,9463
c77f11e4dc6b27a444cba4fbfc53179b7c41230a,0,Yusaku Sako,2013-01-19 01:20:07+00:00,['dfe69dde25e86829c3643604a0d9f855f7ce3bdf'],17,37,54,14626383,3,,,,9464
f1de13765425240c73ce4f6813da06694a97132f,0,Yusaku Sako,2013-01-19 01:22:27+00:00,['c77f11e4dc6b27a444cba4fbfc53179b7c41230a'],0,29,29,14626412,2,0.583333333,1,1,9464
5b6855f60cfdd085801e5d7a5a5d4f225a7c7fa5,1,Yusaku Sako,2013-01-19 01:24:31+00:00,['f1de13765425240c73ce4f6813da06694a97132f'],29,5,34,14626446,3,1,0,0,9464
12c233570671872c313d4792fb65484aabaa74cb,0,Yusaku Sako,2013-01-19 01:26:47+00:00,['5b6855f60cfdd085801e5d7a5a5d4f225a7c7fa5'],1,5,6,14626452,2,0,1,1,9464
6c4c4e5fa0254a59ce725cec0a6a95f7b23332df,1,Yusaku Sako,2013-01-19 01:29:31+00:00,['12c233570671872c313d4792fb65484aabaa74cb'],13,72,85,14626537,5,1,1,1,9464
bea7c5feecdcf5c95d43383637431a7d856ea102,1,Yusaku Sako,2013-01-19 01:33:07+00:00,['6c4c4e5fa0254a59ce725cec0a6a95f7b23332df'],7,47,54,14626591,5,0.928571429,0.535714286,1,9464
980a0c388827d3f9c48f033cc221ec2cafd57e78,0,Yusaku Sako,2013-01-19 01:36:20+00:00,['bea7c5feecdcf5c95d43383637431a7d856ea102'],26,6,32,14626623,5,0,0,0,9464
a49331e19a852b1c7452282a19ac3924e4e5a44f,1,Yusaku Sako,2013-01-19 01:40:30+00:00,['980a0c388827d3f9c48f033cc221ec2cafd57e78'],0,22,22,14626645,4,0.947368421,0.947368421,1,9464
f4a38fdedadc43362bea41432568cbf8cbb01883,1,Yusaku Sako,2013-01-19 01:43:02+00:00,['a49331e19a852b1c7452282a19ac3924e4e5a44f'],610,148,758,14627403,2,0.476190476,1,1,9464
1efc30be0f10ab5960bea1318cb5a52451ccd69c,1,Yusaku Sako,2013-01-19 01:47:16+00:00,['f4a38fdedadc43362bea41432568cbf8cbb01883'],52,91,143,14627546,16,1,1,1,9464
61f4af34dde35d8592204db363411e738e52c472,1,Yusaku Sako,2013-01-19 01:49:23+00:00,['1efc30be0f10ab5960bea1318cb5a52451ccd69c'],1,4,5,14627551,2,,,,9464
6d29fa0a9f92352306f19882e047d91e92a821ff,1,Yusaku Sako,2013-01-19 01:52:41+00:00,['61f4af34dde35d8592204db363411e738e52c472'],79,45,124,14627675,2,0,0.151515152,0,9464
f4fc600bd3646503ed683c2536b14b40b03dcd81,1,Yusaku Sako,2013-01-19 01:55:53+00:00,['6d29fa0a9f92352306f19882e047d91e92a821ff'],62,75,137,14627812,8,0.75,0.625,1,9464
c4bbe33e4218d3293463270a4945884e16bf9e1c,1,Mahadev Konar,2013-01-19 01:57:20+00:00,['f4fc600bd3646503ed683c2536b14b40b03dcd81'],1483,10353,11836,14639648,70,0.608405135,0.888517672,0.786354844,9494
9138b3f7822fa2706cd69ccc59eb60673fb04a94,1,Yusaku Sako,2013-01-19 02:08:56+00:00,['c4bbe33e4218d3293463270a4945884e16bf9e1c'],2,14,16,14639664,4,,,,9494
11a2da67dfcfba2c45ee1d9f02b9df7b786753b8,0,Yusaku Sako,2013-01-19 02:10:14+00:00,['9138b3f7822fa2706cd69ccc59eb60673fb04a94'],0,3,3,14639667,1,,,,9494
3db4989f960cc06837ffa2a42e986215fcda14b0,1,Mahadev Konar,2013-01-19 02:10:33+00:00,['11a2da67dfcfba2c45ee1d9f02b9df7b786753b8'],1178,5243,6421,14646088,13,0,1,1,9495
2fddf0f8ebc4aba24057864167f40bdc777aa07b,1,Mahadev Konar,2013-01-19 02:33:01+00:00,['3db4989f960cc06837ffa2a42e986215fcda14b0'],43,5929,5972,14652060,14,0.5,0.416666667,0,9506
ac43888bd787489fe61b2da0281c37965464b89b,1,Yusaku Sako,2013-01-19 02:47:45+00:00,['2fddf0f8ebc4aba24057864167f40bdc777aa07b'],9,168,177,14652237,5,1,1,1,9508
d28e46f37b5bc8db3622898f4862a60aab402214,0,Mahadev Konar,2013-01-19 02:54:28+00:00,['ac43888bd787489fe61b2da0281c37965464b89b'],0,0,0,14652237,2,,,,9508
38e1603ed076162f5236862956c0c7fa2e7237bf,0,Mahadev Konar,2013-01-19 03:00:08+00:00,['d28e46f37b5bc8db3622898f4862a60aab402214'],0,1,1,14652238,1,,,,9509
12b908523c5091229571641d95ceabfe7e8a5d79,0,Mahadev Konar,2013-01-21 18:09:02+00:00,['38e1603ed076162f5236862956c0c7fa2e7237bf'],1,3,4,14652242,2,,,,9509
18b019898c4c5d91b0038b15b8f8b5bea0aa2be6,1,Mahadev Konar,2013-01-21 18:20:17+00:00,['12b908523c5091229571641d95ceabfe7e8a5d79'],91,284,375,14652617,10,0.846938776,0.744897959,1,9509
40c1c44be39f74e74d7bdb10db42ebdca5a62299,1,Mahadev Konar,2013-01-21 19:12:05+00:00,['18b019898c4c5d91b0038b15b8f8b5bea0aa2be6'],11,294,305,14652922,3,0,0.081196581,1,9509
2b0b8d0457b0cc1b16097a20dd17cdbadba51e71,1,Mahadev Konar,2013-01-22 18:42:54+00:00,['40c1c44be39f74e74d7bdb10db42ebdca5a62299'],5,50,55,14652977,3,0.266666667,1,1,9509
9ce06975f09a92c6a0bf5b7a06bf940496a43a52,0,Mahadev Konar,2013-01-22 20:05:54+00:00,['2b0b8d0457b0cc1b16097a20dd17cdbadba51e71'],3,4,7,14652984,2,,,,9509
b42f7303fccf1f638273b265ad871780f40b8f2e,1,Yusaku Sako,2013-01-22 21:13:20+00:00,['9ce06975f09a92c6a0bf5b7a06bf940496a43a52'],14,14,28,14653012,5,0,0,1,9509
ee8ba19b4253ae505347a93439c4d769aa06530b,1,Yusaku Sako,2013-01-22 21:16:36+00:00,['b42f7303fccf1f638273b265ad871780f40b8f2e'],3,69,72,14653084,6,0.322580645,1,1,9509
ed9ca874f3e754381d306e53e5e2ffc371f5069c,1,Yusaku Sako,2013-01-22 21:47:15+00:00,['ee8ba19b4253ae505347a93439c4d769aa06530b'],2,7,9,14653093,3,,,,9509
bf8f5c5067a80d598cbdca27372edc7d0e314c30,1,Yusaku Sako,2013-01-22 21:50:01+00:00,['ed9ca874f3e754381d306e53e5e2ffc371f5069c'],5,13,18,14653111,4,1,1,1,9509
5c9b6d449f6ae12d582cb0e7bbdae3eaecd27b31,1,Yusaku Sako,2013-01-22 21:51:21+00:00,['bf8f5c5067a80d598cbdca27372edc7d0e314c30'],4,25,29,14653140,5,1,1,1,9509
8d00101aba76ac8531cc455b8291fab0bc950284,0,Yusaku Sako,2013-01-22 21:52:52+00:00,['5c9b6d449f6ae12d582cb0e7bbdae3eaecd27b31'],0,6,6,14653146,2,1,1,1,9509
0aaa57126ad731615aadecb760a815442bbefc42,1,Yusaku Sako,2013-01-22 21:54:09+00:00,['8d00101aba76ac8531cc455b8291fab0bc950284'],278,25,303,14653449,8,0.610091743,0.146788991,0.160550459,9509
c65dc87939a957bf8b985d78f6531bfb7c493571,0,Yusaku Sako,2013-01-22 21:56:11+00:00,['0aaa57126ad731615aadecb760a815442bbefc42'],2,7,9,14653458,2,0,0,1,9509
7158f13edc46585acdd41316ac607e1ef3336e32,1,Yusaku Sako,2013-01-22 22:05:18+00:00,['c65dc87939a957bf8b985d78f6531bfb7c493571'],24228,1860,26088,14679546,3,,,,9509
368c37e7552b547e2c34fd4c871ceb7d34015cac,1,Mahadev Konar,2013-01-23 21:05:54+00:00,['7158f13edc46585acdd41316ac607e1ef3336e32'],51,139,190,14679736,14,0.081081081,0.216216216,0.918918919,9509
9cc8651a51c7944c67d684be494e585c24bc8457,1,Mahadev Konar,2013-01-23 21:10:41+00:00,['368c37e7552b547e2c34fd4c871ceb7d34015cac'],49,311,360,14680096,22,0.56424581,1,1,9509
d30ae2b87e0af35abeb7a9e7bc502e9c936512bc,1,Yusaku Sako,2013-01-23 21:44:12+00:00,['9cc8651a51c7944c67d684be494e585c24bc8457'],38,83,121,14680217,5,1,0,0,9510
c84f72d9af8e6e4235acfbeefaa680664b016ca4,0,Yusaku Sako,2013-01-23 22:01:06+00:00,['d30ae2b87e0af35abeb7a9e7bc502e9c936512bc'],4,3,7,14680224,3,1,1,0,9510
8abee8ac5cd22fb4eeae7da09765b287b55bdaf5,1,Mahadev Konar,2013-01-24 01:41:02+00:00,['c84f72d9af8e6e4235acfbeefaa680664b016ca4'],26,118,144,14680368,12,1,0.781818182,1,9510
23b56f3661f08abd1019784aec7ec31c8e4214c8,1,John Speidel,2013-01-24 05:14:25+00:00,['8abee8ac5cd22fb4eeae7da09765b287b55bdaf5'],2,299,301,14680669,5,0.623931624,0.837606838,0.572649573,9512
361652af66df5e0e11f5bed63aca37cd33d7aafe,1,Yusaku Sako,2013-01-25 02:11:00+00:00,['23b56f3661f08abd1019784aec7ec31c8e4214c8'],440,30,470,14681139,4,0,0,0,9512
d61660c794b749ff46fbaf0016ae6a43e6313569,0,Yusaku Sako,2013-01-25 02:44:00+00:00,['361652af66df5e0e11f5bed63aca37cd33d7aafe'],1,2,3,14681142,2,,,,9512
c1abb5a0e8d92c6b76404808767d0727a73bfe4c,1,Yusaku Sako,2013-01-25 02:46:25+00:00,['d61660c794b749ff46fbaf0016ae6a43e6313569'],1,8,9,14681151,4,,,,9512
433211a1cca3ea26352017593be46fa03dba7a9a,1,Yusaku Sako,2013-01-25 02:48:33+00:00,['c1abb5a0e8d92c6b76404808767d0727a73bfe4c'],2,3,5,14681156,2,,,,9512
cc9ae66fdf97e43188a9fa6185918c83b90f3c72,1,Mahadev Konar,2013-01-25 04:08:28+00:00,['433211a1cca3ea26352017593be46fa03dba7a9a'],60,190,250,14681406,10,0,0.936842105,0.957894737,9512
87ed8a93bb825d424c61320218e3fbac83cf84cd,1,Yusaku Sako,2013-01-25 04:46:54+00:00,['cc9ae66fdf97e43188a9fa6185918c83b90f3c72'],953,946,1899,14683305,19,0,0,0,9512
6622212140b4edf9a1e63902f7d6291ef0b4aefb,1,Yusaku Sako,2013-01-25 04:49:57+00:00,['87ed8a93bb825d424c61320218e3fbac83cf84cd'],2,988,990,14684295,8,0.720720721,1,1,9514
5f0e3d93a7b990cc32932654142133e54d60de4d,1,Mahadev Konar,2013-01-25 23:13:03+00:00,['6622212140b4edf9a1e63902f7d6291ef0b4aefb'],4,222,226,14684521,4,,,,9515
4b916e7aec45259f9f054be626c834257ed22225,1,Mahadev Konar,2013-01-25 23:20:45+00:00,['5f0e3d93a7b990cc32932654142133e54d60de4d'],33,130,163,14684684,8,1,1,1,9517
57644e90f2b8958540b7bf53469f3733f7b75736,0,Mahadev Konar,2013-01-25 23:43:00+00:00,['4b916e7aec45259f9f054be626c834257ed22225'],3,6,9,14684693,2,,,,9517
5518292a77a9ed6ddc0f2c09d6a0abcabdab76c9,0,Mahadev Konar,2013-01-26 00:57:09+00:00,['57644e90f2b8958540b7bf53469f3733f7b75736'],2,6,8,14684701,3,,,,9517
c3101c7aa9db49b4cf3ccd3948e70d6877cfbad8,1,Mahadev Konar,2013-01-26 01:23:44+00:00,['5518292a77a9ed6ddc0f2c09d6a0abcabdab76c9'],2,66,68,14684769,5,0.8,0.8,1,9517
9d3d9c0d85f7f4847dc75001f3243331c29fa576,1,Mahadev Konar,2013-01-26 01:32:15+00:00,['c3101c7aa9db49b4cf3ccd3948e70d6877cfbad8'],0,21,21,14684790,1,,,,9518
8c08636792dfc1b13fa2bc0c76df2417aa53d064,1,Mahadev Konar,2013-01-26 02:48:55+00:00,['9d3d9c0d85f7f4847dc75001f3243331c29fa576'],2,5,7,14684797,2,,,,9518
fab67dee8df9414ea670c55319ebf0416cf139c1,1,Mahadev Konar,2013-01-26 04:47:04+00:00,['8c08636792dfc1b13fa2bc0c76df2417aa53d064'],1,313,314,14685111,6,,,,9521
fc7928338fd69bee3352ebce55089514d99e6a02,1,Yusaku Sako,2013-01-26 05:25:08+00:00,['fab67dee8df9414ea670c55319ebf0416cf139c1'],55,32,87,14685198,6,0,0,0,9521
894c1f8d4f100b1d71c10c19c72d1917d145428a,0,Yusaku Sako,2013-01-26 05:27:02+00:00,['fc7928338fd69bee3352ebce55089514d99e6a02'],1,6,7,14685205,3,0,1,1,9521
05a4ff31ada2cf3cdc275f41c186a141f76588a6,1,Yusaku Sako,2013-01-26 05:28:24+00:00,['894c1f8d4f100b1d71c10c19c72d1917d145428a'],12,59,71,14685276,3,0,0,1,9521
40c564ad53603595f96f7c70927431a9cf0fa5ba,0,Yusaku Sako,2013-01-26 05:30:31+00:00,['05a4ff31ada2cf3cdc275f41c186a141f76588a6'],4,52,56,14685332,2,0,0,1,9521
d6a47c9761e6b67907af8733f5e50d97b2b8c03b,1,Srimanth,2013-01-28 20:36:54+00:00,['40c564ad53603595f96f7c70927431a9cf0fa5ba'],60,135,195,14685527,7,0.98,1,0.96,9521
29870ecca6801cb1034b01aa24363df89f5f1f5e,1,Srimanth,2013-01-28 23:09:01+00:00,['d6a47c9761e6b67907af8733f5e50d97b2b8c03b'],0,5,5,14685532,3,,,,9521
7ff86e012943631d96983ea3f813607fc3148517,0,Srimanth,2013-01-28 23:35:41+00:00,['29870ecca6801cb1034b01aa24363df89f5f1f5e'],9,225,234,14685766,9,,,,9521
74d660b0891ccb52ebc35704e586fdc3e3e7cff8,1,Srimanth,2013-01-28 23:43:35+00:00,['7ff86e012943631d96983ea3f813607fc3148517'],4,18,22,14685788,4,1,1,0,9521
9cc85082ee792efefad870321a150dcc2d5a5f35,0,Srimanth,2013-01-28 23:58:37+00:00,['74d660b0891ccb52ebc35704e586fdc3e3e7cff8'],26,18,44,14685832,3,,,,9521
7df660d85d3b3416aeef40ec2faaebc114811c3d,1,Srimanth,2013-01-29 00:01:54+00:00,['9cc85082ee792efefad870321a150dcc2d5a5f35'],1,4,5,14685837,2,,,,9521
74b94057aad482710c5fda4ea74c2dc0b18f19e3,0,Srimanth,2013-01-29 00:06:11+00:00,['7df660d85d3b3416aeef40ec2faaebc114811c3d'],20,76,96,14685933,2,0.555555556,0,0,9521
fa6d081099f6a92bc07bd4dc59b47aba00d099b1,0,Mahadev Konar,2013-01-29 01:21:11+00:00,['74b94057aad482710c5fda4ea74c2dc0b18f19e3'],1,3,4,14685937,2,,,,9521
bb8e3d8845bf47d48b4ff5059754986d7aa0def8,1,Srimanth,2013-01-29 01:28:42+00:00,['fa6d081099f6a92bc07bd4dc59b47aba00d099b1'],0,4,4,14685941,2,0,1,1,9521
30d31d84659f7265f1bc27b02df5a0def021c655,1,Mahadev Konar,2013-01-29 17:41:41+00:00,['bb8e3d8845bf47d48b4ff5059754986d7aa0def8'],8,11,19,14685960,2,,,,9521
ce71a9dcb577fcc0836e2394008dd59def456a9d,1,Mahadev Konar,2013-01-29 17:52:36+00:00,['30d31d84659f7265f1bc27b02df5a0def021c655'],5,13,18,14685978,2,,,,9521
476bdf8ff218b25212679a912bbc9928ff20bad1,1,Tom Beerbower,2013-01-29 18:15:16+00:00,['ce71a9dcb577fcc0836e2394008dd59def456a9d'],1073,1333,2406,14688384,49,0.407407407,0,1,9525
0030250767bfc21d5347fdb8daea37dc19a20711,1,Mahadev Konar,2013-01-29 18:17:02+00:00,['476bdf8ff218b25212679a912bbc9928ff20bad1'],196,285,481,14688865,2,0,1,1,9526
30b292bfdaa3dd881555c9326a4351279600a6e6,1,John Speidel,2013-01-29 19:19:10+00:00,['0030250767bfc21d5347fdb8daea37dc19a20711'],115,2937,3052,14691917,45,0.781485468,1,0.951560818,9554
a26f2914e6b11de77bc651272b45c50340947bc3,1,Tom Beerbower,2013-01-29 23:11:46+00:00,['30b292bfdaa3dd881555c9326a4351279600a6e6'],2,338,340,14692257,13,0.688073394,1,1,9559
4b7a095aa7a4b80d881456da3a4ea7c6e556f79e,1,Yusaku Sako,2013-01-30 00:40:42+00:00,['a26f2914e6b11de77bc651272b45c50340947bc3'],21,38,59,14692316,8,0,1,1,9559
3cbf161a12569558239f332f0a9f35fa4de346ec,1,Yusaku Sako,2013-01-30 00:43:52+00:00,['4b7a095aa7a4b80d881456da3a4ea7c6e556f79e'],13294,209,13503,14705819,12,0,0,0,9563
e82adac63692629562be417200ff7da0de06ca10,0,Yusaku Sako,2013-01-30 00:45:53+00:00,['3cbf161a12569558239f332f0a9f35fa4de346ec'],4,4,8,14705827,2,,,,9563
15bc7c7942d8d9337e0a46bab33b452b7e0632aa,1,Yusaku Sako,2013-01-30 00:48:37+00:00,['e82adac63692629562be417200ff7da0de06ca10'],1,27,28,14705855,2,1,1,1,9563
d6c91996bc81113be5fb1d8dd1c94ae17bb07a19,0,Yusaku Sako,2013-01-30 00:52:50+00:00,['15bc7c7942d8d9337e0a46bab33b452b7e0632aa'],634,301,935,14706790,4,0,0,0,9563
2b0316444565a49b6cd1851e751e45e2afd79236,1,Yusaku Sako,2013-01-30 01:40:26+00:00,['d6c91996bc81113be5fb1d8dd1c94ae17bb07a19'],50,45,95,14706885,6,0,0,0,9563
607f001945baff9460f575e44ae313f49e7afa7e,1,Yusaku Sako,2013-01-30 01:43:08+00:00,['2b0316444565a49b6cd1851e751e45e2afd79236'],2,5,7,14706892,3,,,,9563
3ac262bf3b8fae8729baac2819cf2219d2577ceb,0,Yusaku Sako,2013-01-30 01:48:02+00:00,['607f001945baff9460f575e44ae313f49e7afa7e'],2,5,7,14706899,2,,,,9563
5f229b7e530dd6103b9ca4abc2514bc5bc78664a,1,Yusaku Sako,2013-01-30 01:51:18+00:00,['3ac262bf3b8fae8729baac2819cf2219d2577ceb'],101,60,161,14707060,6,0.85,0,0,9563
14e84f71e6f700a72f2df2797884212d2c385771,1,Mahadev Konar,2013-01-30 09:04:19+00:00,['5f229b7e530dd6103b9ca4abc2514bc5bc78664a'],16,142,158,14707218,4,0.096774194,0.591397849,1,9563
be67b1b594c802e6c3519fff93fd329bd4c7176d,1,Tom Beerbower,2013-01-30 12:07:45+00:00,['14e84f71e6f700a72f2df2797884212d2c385771'],32,56,88,14707306,7,0,0,0,9563
625d482a5c4132f6d60c3188669d2ba96a7e9ded,1,Tom Beerbower,2013-01-30 12:26:19+00:00,['be67b1b594c802e6c3519fff93fd329bd4c7176d'],11,32,43,14707349,5,0.9,0.9,1,9563
fda26d78ffa6a51cd741ef331a73e265b89f6fb9,1,Yusaku Sako,2013-01-30 23:58:04+00:00,['625d482a5c4132f6d60c3188669d2ba96a7e9ded'],10,14,24,14707373,2,0,1,0,9563
c99b8ac9f0d9872e96b06591c5291da5e1f53d72,0,Yusaku Sako,2013-01-31 00:13:41+00:00,['fda26d78ffa6a51cd741ef331a73e265b89f6fb9'],2,8,10,14707383,2,1,1,1,9563
f64f43c1f84ce966e9cc91132259e91717d34658,1,Yusaku Sako,2013-01-31 00:19:09+00:00,['c99b8ac9f0d9872e96b06591c5291da5e1f53d72'],7,15,22,14707405,4,0,0,0,9563
151a81276debc2cd96836f2393c2b2c1356f674e,1,Tom Beerbower,2013-01-31 00:23:54+00:00,['f64f43c1f84ce966e9cc91132259e91717d34658'],42,576,618,14708023,17,0.698324022,0.983240223,0.709497207,9565
fcb07f3a98824716295197cd3b60bc13ddd71d3f,1,Yusaku Sako,2013-01-31 00:26:13+00:00,['151a81276debc2cd96836f2393c2b2c1356f674e'],365,394,759,14708782,8,0,0,0,9565
8c4dd7bf7ff82dff7856d52db845be55650aacdb,1,Yusaku Sako,2013-01-31 00:28:30+00:00,['fcb07f3a98824716295197cd3b60bc13ddd71d3f'],9,47,56,14708838,5,1,1,1,9565
a47308a2f6ccef0fd471591e2709cc70c66bd334,1,Yusaku Sako,2013-01-31 00:31:44+00:00,['8c4dd7bf7ff82dff7856d52db845be55650aacdb'],62,35,97,14708935,6,0.709677419,0,0,9565
bc7006594af79eec81a48e2440ce920b0e17085b,1,Yusaku Sako,2013-01-31 00:35:32+00:00,['a47308a2f6ccef0fd471591e2709cc70c66bd334'],1,5,6,14708941,2,,,,9565
31e2be022bd7e82b2219a2d6b3062b07ad16ad38,1,Yusaku Sako,2013-01-31 00:37:46+00:00,['bc7006594af79eec81a48e2440ce920b0e17085b'],2,9,11,14708952,5,1,1,1,9565
62cb2ea1d5c5ae41d4631a3a8dada708437cbbdc,0,Yusaku Sako,2013-01-31 00:47:02+00:00,['31e2be022bd7e82b2219a2d6b3062b07ad16ad38'],5,47,52,14709004,4,1,1,1,9565
7a268a3ada0b55fadb92edd71cac5f257feb03ed,0,Yusaku Sako,2013-01-31 00:50:34+00:00,['62cb2ea1d5c5ae41d4631a3a8dada708437cbbdc'],1,3,4,14709008,2,,,,9565
a3a9b4b77c26d2bf1da7811351ea811876e80554,1,Yusaku Sako,2013-01-31 00:53:24+00:00,['7a268a3ada0b55fadb92edd71cac5f257feb03ed'],20,46,66,14709074,6,1,1,1,9565
f3fac65e45c79936c8840c301cd2a33d85a4297b,1,Yusaku Sako,2013-01-31 00:55:31+00:00,['a3a9b4b77c26d2bf1da7811351ea811876e80554'],16,36,52,14709126,4,1,1,1,9565
cfa2701399c5dfa03f73fce78c652a0bee2113bd,0,Yusaku Sako,2013-01-31 00:59:04+00:00,['f3fac65e45c79936c8840c301cd2a33d85a4297b'],18,20,38,14709164,2,0,0,0,9565
7ea25f1865a2019de8f65e3a249cb264d40fb643,1,Mahadev Konar,2013-01-31 01:07:57+00:00,['cfa2701399c5dfa03f73fce78c652a0bee2113bd'],3,33,36,14709200,7,0,1,1,9565
8f8b30274dde26ac06678d409232b6144d2a5a51,1,Yusaku Sako,2013-01-31 01:58:54+00:00,['7ea25f1865a2019de8f65e3a249cb264d40fb643'],1,15,16,14709216,2,1,1,1,9565
d00a6e0eb25207accb8bc88a4b894ac07ef4b457,1,Yusaku Sako,2013-01-31 02:01:31+00:00,['8f8b30274dde26ac06678d409232b6144d2a5a51'],0,11,11,14709227,2,1,1,1,9565
dc069c9a0728b3f762c374b41f4d93760858e92d,1,Yusaku Sako,2013-01-31 02:07:09+00:00,['d00a6e0eb25207accb8bc88a4b894ac07ef4b457'],1066,385,1451,14710678,5,1,0,0,9565
dc64f58529d9ecab5c56e488434df474b23ecdb2,1,Srimanth,2013-01-31 21:38:27+00:00,['dc069c9a0728b3f762c374b41f4d93760858e92d'],5,12,17,14710695,2,,,,9565
91201a25683e46795ee02184a76779cf4c69bd6e,1,Srimanth,2013-01-31 21:53:30+00:00,['dc64f58529d9ecab5c56e488434df474b23ecdb2'],0,8,8,14710703,2,1,1,1,9565
0bf6d7ff4940da4ccbe65814fc26898857ed86dc,0,Srimanth,2013-01-31 22:00:08+00:00,['91201a25683e46795ee02184a76779cf4c69bd6e'],1,2,3,14710706,2,,,,9565
9048709c0908d6f78bd5044f0b13b9c6e0f77bb0,1,Srimanth,2013-01-31 22:06:46+00:00,['0bf6d7ff4940da4ccbe65814fc26898857ed86dc'],18,27,45,14710751,4,1,1,1,9565
d94b27e3f8c079ff2660964b5ffcfcf9d14971a5,1,John Speidel,2013-01-31 22:33:31+00:00,['9048709c0908d6f78bd5044f0b13b9c6e0f77bb0'],40,404,444,14711195,16,0.840425532,0.978723404,1,9567
7b76f23fb7f37bb99459ddaf282f04111caea785,0,John Speidel,2013-01-31 23:09:44+00:00,['d94b27e3f8c079ff2660964b5ffcfcf9d14971a5'],14,20,34,14711229,2,,,,9567
77813035caa8ad95e017209a5e9738409127814d,0,John Speidel,2013-01-31 23:37:24+00:00,['7b76f23fb7f37bb99459ddaf282f04111caea785'],4,23,27,14711256,3,1,1,0,9567
ec2b9ff8b24461071dd10f0b6d25027a847d299d,1,Mahadev Konar,2013-02-01 07:38:03+00:00,['77813035caa8ad95e017209a5e9738409127814d'],5,20,25,14711281,3,0.285714286,0.571428571,0.857142857,9567
0808d3ce2bf404761f6db44f32d9ecb9d271f879,0,John Speidel,2013-02-01 17:07:15+00:00,['ec2b9ff8b24461071dd10f0b6d25027a847d299d'],0,659,659,14711940,11,1,1,1,9578
7170887107944909d737528b42ac8696a29e7c1d,1,Tom Beerbower,2013-02-01 20:07:43+00:00,['0808d3ce2bf404761f6db44f32d9ecb9d271f879'],56,342,398,14712338,9,0,0,0.813084112,9580
19a5159ce722a5e116ea7c5a6ac701a2e56e8e1e,1,Yusaku Sako,2013-02-02 02:18:37+00:00,['7170887107944909d737528b42ac8696a29e7c1d'],1,3,4,14712342,2,,,,9580
b17b783649df05959458424dbf040e5d04b910a5,0,Yusaku Sako,2013-02-02 02:21:58+00:00,['19a5159ce722a5e116ea7c5a6ac701a2e56e8e1e'],6,28,34,14712376,4,0.5,0,1,9580
2abeec6a4b9bcfc1f5992fd95023fe9aa8da3e05,1,Yusaku Sako,2013-02-02 02:23:36+00:00,['b17b783649df05959458424dbf040e5d04b910a5'],14,4,18,14712394,2,0,0,0,9580
97db2183bbe4ed4948f35774e36a45177631074f,1,Yusaku Sako,2013-02-02 02:27:27+00:00,['2abeec6a4b9bcfc1f5992fd95023fe9aa8da3e05'],60,133,193,14712587,41,1,0,0,9580
15d6769d882c1e6e3f5f3680d1fd97769bf31ece,1,Yusaku Sako,2013-02-02 02:28:28+00:00,['97db2183bbe4ed4948f35774e36a45177631074f'],57,16,73,14712660,2,1,1,0,9580
e330fe0ac8f8b080ec4e23870052e534fc113c54,1,Yusaku Sako,2013-02-02 02:32:05+00:00,['15d6769d882c1e6e3f5f3680d1fd97769bf31ece'],1,4,5,14712665,2,,,,9580
cfd440f564895968a7a681da94627e4864116c87,1,Yusaku Sako,2013-02-04 18:44:07+00:00,['e330fe0ac8f8b080ec4e23870052e534fc113c54'],5,15,20,14712685,6,0,0,1,9580
ce698bdf9b5c2128675744223cd798388ab0455b,1,Yusaku Sako,2013-02-04 18:45:41+00:00,['cfd440f564895968a7a681da94627e4864116c87'],5,18,23,14712708,2,0,1,1,9580
51dbc7f9f148a48072a57eebc2bc9b7894b6c7e8,0,Yusaku Sako,2013-02-04 18:46:55+00:00,['ce698bdf9b5c2128675744223cd798388ab0455b'],1,7,8,14712716,2,,,,9580
21ef37e7dd064a064cb6a6172f726ba565e7a492,0,Jaimin Jetly,2013-02-05 02:49:07+00:00,['51dbc7f9f148a48072a57eebc2bc9b7894b6c7e8'],0,12,12,14712728,2,0.5,0.5,1,9580
0ad5c0ee07dd581121a02ee17e66ba1a22d21a8a,0,Yusaku Sako,2013-02-06 00:15:18+00:00,['21ef37e7dd064a064cb6a6172f726ba565e7a492'],8,12,20,14712748,2,,,,9580
b1c401d3231acdb122b0c2d8ef1136b4f9ee7550,0,Yusaku Sako,2013-02-06 00:16:45+00:00,['0ad5c0ee07dd581121a02ee17e66ba1a22d21a8a'],1,3,4,14712752,2,,,,9580
ee4ee08e613f2570723596d3a0a7048d5bf41a7c,1,Yusaku Sako,2013-02-06 00:54:18+00:00,['b1c401d3231acdb122b0c2d8ef1136b4f9ee7550'],12,80,92,14712844,8,1,1,1,9581
3542c842178b7f05a06f5d9f673027ae1d05ca8f,1,Yusaku Sako,2013-02-06 00:55:50+00:00,['ee4ee08e613f2570723596d3a0a7048d5bf41a7c'],95,193,288,14713132,29,1,1,1,9581
a383457097951a78642f46f92352561c3cc1fb42,0,Yusaku Sako,2013-02-06 02:14:49+00:00,['3542c842178b7f05a06f5d9f673027ae1d05ca8f'],1,20,21,14713153,2,0,0,1,9581
566e79c977a30155c95139c8be8a37f627366e49,1,Yusaku Sako,2013-02-06 04:50:58+00:00,['a383457097951a78642f46f92352561c3cc1fb42'],1,4,5,14713158,2,,,,9581
ea5f703822aad11629a03d0734d0270ed49630b8,1,Jaimin Jetly,2013-02-06 22:09:41+00:00,['566e79c977a30155c95139c8be8a37f627366e49'],1,18,19,14713177,2,1,1,1,9581
a91c8166a5e55e8f070238f432d79a4bf002610b,1,Jaimin Jetly,2013-02-06 22:14:53+00:00,['ea5f703822aad11629a03d0734d0270ed49630b8'],43,46,89,14713266,17,,,,9581
a199c843cff8d1febeba8630be1e0d20ffa97af0,0,Jaimin Jetly,2013-02-06 22:25:11+00:00,['a91c8166a5e55e8f070238f432d79a4bf002610b'],1,4,5,14713271,3,,,,9581
492342f66b9935c0b9661e1d36e6f286959920c3,0,Jaimin Jetly,2013-02-06 22:29:03+00:00,['a199c843cff8d1febeba8630be1e0d20ffa97af0'],0,40,40,14713311,2,0,1,1,9581
1565e61740601ea5f143bf80e557e3486c6d6f41,1,Jaimin Jetly,2013-02-06 22:39:08+00:00,['492342f66b9935c0b9661e1d36e6f286959920c3'],8,11,19,14713330,5,,,,9581
51fcaa1f8f310607540640981b8b33dcc0bc1b01,0,Jaimin Jetly,2013-02-06 22:55:35+00:00,['1565e61740601ea5f143bf80e557e3486c6d6f41'],1,4,5,14713335,2,,,,9581
adbea8b6ef716326b5c891027e9e52f6468d6467,1,Mahadev Konar,2013-02-07 07:04:11+00:00,['51fcaa1f8f310607540640981b8b33dcc0bc1b01'],14,14,28,14713363,10,,,,9581
094bb832aa8658c80dac808cf771bc8ed29623d4,1,Mahadev Konar,2013-02-07 07:46:45+00:00,['adbea8b6ef716326b5c891027e9e52f6468d6467'],127,105,232,14713595,9,1,0,0,9581
62a35ec6343d9c636b59c82d942cd8401b2767fb,1,Mahadev Konar,2013-02-07 07:59:32+00:00,['094bb832aa8658c80dac808cf771bc8ed29623d4'],24,426,450,14714045,7,0.378723404,0.787234043,0.565957447,9582
977ded81116abd05ff84363987cd9de3d3aee29e,1,Jaimin Jetly,2013-02-07 21:00:41+00:00,['62a35ec6343d9c636b59c82d942cd8401b2767fb'],8,19,27,14714072,4,1,1,1,9582
35e1349c2070f657e237120fe0a143d4eb45177e,0,Jaimin Jetly,2013-02-07 21:05:03+00:00,['977ded81116abd05ff84363987cd9de3d3aee29e'],3,8,11,14714083,2,,,,9582
3c623614a83c2c248eb3b37fa3d04dd5cc7c279e,1,Jaimin Jetly,2013-02-07 21:10:22+00:00,['35e1349c2070f657e237120fe0a143d4eb45177e'],1,4,5,14714088,3,,,,9582
3575011b160e5f86a9adab01a42d51b223427612,0,Jaimin Jetly,2013-02-07 21:14:03+00:00,['3c623614a83c2c248eb3b37fa3d04dd5cc7c279e'],3,5,8,14714096,2,,,,9582
f505c3b2b624eec7aed60f18aa54e8add0bd77ba,1,Jaimin Jetly,2013-02-07 21:21:57+00:00,['3575011b160e5f86a9adab01a42d51b223427612'],55,78,133,14714229,7,,,,9582
7253953deba51f0cfb095db868b2e29fa61e54ab,1,Jaimin Jetly,2013-02-07 21:25:18+00:00,['f505c3b2b624eec7aed60f18aa54e8add0bd77ba'],101,251,352,14714581,8,0.731343284,0.313432836,0.895522388,9582
b138b8d2eec1219e3e728a8793c1d9e9b7941dc4,1,Jaimin Jetly,2013-02-07 21:38:14+00:00,['7253953deba51f0cfb095db868b2e29fa61e54ab'],0,5,5,14714586,2,1,1,1,9582
f19200235e5b5407ae78c0b612fca52ba80c907a,1,Jaimin Jetly,2013-02-07 21:41:44+00:00,['b138b8d2eec1219e3e728a8793c1d9e9b7941dc4'],22,30,52,14714638,12,,,,9582
483db54cdbadc9f5a83693ee0670716138cd0551,0,Jaimin Jetly,2013-02-07 22:02:12+00:00,['f19200235e5b5407ae78c0b612fca52ba80c907a'],0,5,5,14714643,2,,,,9582
17a7caa61da71a5b898997ab206681e2d724c90d,0,Mahadev Konar,2013-02-11 03:04:55+00:00,['483db54cdbadc9f5a83693ee0670716138cd0551'],1,5,6,14714649,3,,,,9582
c1a433d0df16e3f8fe94f0c7dd5008d47d64b5cd,1,Jaimin Jetly,2013-02-11 19:21:08+00:00,['17a7caa61da71a5b898997ab206681e2d724c90d'],2,4,6,14714655,2,,,,9582
c603ba9b93c6c3fbe32d39c5483d050fe429f105,1,Jaimin Jetly,2013-02-11 19:28:55+00:00,['c1a433d0df16e3f8fe94f0c7dd5008d47d64b5cd'],8,18,26,14714681,4,1,1,1,9582
0348c1f23c0db8b6c33e3a935c00ccd87708244f,1,Jaimin Jetly,2013-02-11 19:31:48+00:00,['c603ba9b93c6c3fbe32d39c5483d050fe429f105'],2,47,49,14714730,6,1,1,1,9582
8cb14dc004d43336111bb920c3ec235508bcfc11,1,Jaimin Jetly,2013-02-11 19:34:48+00:00,['0348c1f23c0db8b6c33e3a935c00ccd87708244f'],45,82,127,14714857,15,1,1,1,9582
f5ddc34631a0720b36b8a30d9e2882d43436a71e,0,Yusaku Sako,2013-02-13 00:49:16+00:00,['8cb14dc004d43336111bb920c3ec235508bcfc11'],1,4,5,14714862,2,,,,9582
bf1f46c9a8445afb52bad38d846d739474aae5e0,0,Yusaku Sako,2013-02-13 01:28:26+00:00,['f5ddc34631a0720b36b8a30d9e2882d43436a71e'],3,5,8,14714870,2,,,,9582
84f9df39cfb06a82725857e49c1f128cb792704d,0,Yusaku Sako,2013-02-13 09:09:33+00:00,['bf1f46c9a8445afb52bad38d846d739474aae5e0'],11,23,34,14714904,4,,,,9582
8874b3728dee612bd93b15965d52710a5ccf0184,1,Tom Beerbower,2013-02-13 15:50:13+00:00,['84f9df39cfb06a82725857e49c1f128cb792704d'],451,2592,3043,14717947,12,0.16007533,0.943502825,0.951035782,9590
a849261be513be9a4e86bc9640a8e48526200b9a,1,Yusaku Sako,2013-02-14 03:07:22+00:00,['8874b3728dee612bd93b15965d52710a5ccf0184'],322,275,597,14718544,37,0.023364486,0,0,9590
a71f64eca1f15ee3308541970b39d48092cd1221,0,Yusaku Sako,2013-02-14 03:14:23+00:00,['a849261be513be9a4e86bc9640a8e48526200b9a'],11760,0,11760,14730304,2,0.776106195,0.664159292,0.20199115,9590
bb71a6ecacc8abe8243a8e5aaafd669563259616,0,Yusaku Sako,2013-02-14 21:10:55+00:00,['a71f64eca1f15ee3308541970b39d48092cd1221'],1,3,4,14730308,2,,,,9590
3db3e5b75f8ebd2d2a6faaada60f1d2e3bfba1b2,1,Yusaku Sako,2013-02-14 22:00:35+00:00,['bb71a6ecacc8abe8243a8e5aaafd669563259616'],25,233,258,14730566,7,1,0.745762712,1,9591
1ee059701559dfdc161da259c3f773959d5055fa,1,John Speidel,2013-02-14 22:16:53+00:00,['3db3e5b75f8ebd2d2a6faaada60f1d2e3bfba1b2'],304,629,933,14731499,12,,,,9591
c96ca0da69bb58938d6208f5d889e06a109d2ded,1,Mahadev Konar,2013-02-14 23:02:18+00:00,['1ee059701559dfdc161da259c3f773959d5055fa'],48,482,530,14732029,9,0,0.275,1,9593
1eae6f9112bd3d57ce38e3dd369fd4f4ca9888e3,0,Mahadev Konar,2013-02-14 23:07:40+00:00,['c96ca0da69bb58938d6208f5d889e06a109d2ded'],195,0,195,14732224,1,,,,9593
6aa436dfff8d16447ccb8a43ec5883ba3f80873f,1,Mahadev Konar,2013-02-14 23:17:19+00:00,['1eae6f9112bd3d57ce38e3dd369fd4f4ca9888e3'],1,4,5,14732229,2,0,0,1,9593
6c1433c431d53d021edb987250dab95e07d09486,1,Mahadev Konar,2013-02-15 01:30:45+00:00,['6aa436dfff8d16447ccb8a43ec5883ba3f80873f'],115,68,183,14732412,3,1,0.070588235,0,9593
bb33f7d6d95deeca40b756fffa6f51df9e50ce1f,0,Yusaku Sako,2013-02-15 22:46:06+00:00,['6c1433c431d53d021edb987250dab95e07d09486'],2,4,6,14732418,2,,,,9593
50a89c5d515b5e51e0fe63a5a2497ae0daa14008,1,Mahadev Konar,2013-02-15 22:52:08+00:00,['bb33f7d6d95deeca40b756fffa6f51df9e50ce1f'],138,56,194,14732612,11,0,0,0,9593
3e7d807c3bf574865df07b6f414450e2a2cb1d93,1,Mahadev Konar,2013-02-15 22:55:21+00:00,['50a89c5d515b5e51e0fe63a5a2497ae0daa14008'],421,632,1053,14733665,4,0,0.945054945,0.972527473,9593
5d7efcde7029d9646129c7ef11feb13c38c2ac88,0,Mahadev Konar,2013-02-15 22:57:58+00:00,['3e7d807c3bf574865df07b6f414450e2a2cb1d93'],0,2,2,14733667,1,,,,9593
cba57fc5312f8cec8aa416064c61e55686ad017a,1,Mahadev Konar,2013-02-15 22:59:54+00:00,['5d7efcde7029d9646129c7ef11feb13c38c2ac88'],0,6144,6144,14739811,52,,,,9645
524dda393512834874602a5eaa017419e4ecb573,1,Jaimin Jetly,2013-02-16 03:22:35+00:00,['cba57fc5312f8cec8aa416064c61e55686ad017a'],4,29,33,14739844,3,,,,9645
a4e7d8bc258f8ef539ee48b3e56901a615018c47,1,Tom Beerbower,2013-02-19 16:09:32+00:00,['524dda393512834874602a5eaa017419e4ecb573'],158,4990,5148,14744992,4,0,1,1,9645
2cbea03d95e1733db1ef18ebb1806537a406d8f3,1,Jaimin Jetly,2013-02-19 19:52:23+00:00,['a4e7d8bc258f8ef539ee48b3e56901a615018c47'],16,23,39,14745031,2,0,0,1,9645
d8e8268ca554678f75e5899da97e375166e8621d,1,Tom Beerbower,2013-02-19 20:59:07+00:00,['2cbea03d95e1733db1ef18ebb1806537a406d8f3'],46,119,165,14745196,3,0.139534884,0.953488372,0.906976744,9645
e0c007f6c4846b01579a6a88b06638e3859a56db,1,John Speidel,2013-02-19 22:53:07+00:00,['d8e8268ca554678f75e5899da97e375166e8621d'],2,37,39,14745235,3,0,1,1,9645
505dc8b474e136d6c1d0433f75308b86dc719439,1,Mahadev Konar,2013-02-20 00:54:01+00:00,['e0c007f6c4846b01579a6a88b06638e3859a56db'],7,105,112,14745347,5,0.44,0.44,1,9646
8f3502bcc84b734276ae5529df9430928dff5be1,0,Mahadev Konar,2013-02-20 01:07:27+00:00,['505dc8b474e136d6c1d0433f75308b86dc719439'],1,6,7,14745354,4,,,,9646
3ed2b515906b158201995b7478a0fe8d71b66030,1,Jaimin Jetly,2013-02-20 02:04:53+00:00,['8f3502bcc84b734276ae5529df9430928dff5be1'],23,234,257,14745611,3,0,0,1,9646
c14eaaf8b6e0d3e2f83c024ed0fd932890348bd8,1,Yusaku Sako,2013-02-20 21:49:01+00:00,['3ed2b515906b158201995b7478a0fe8d71b66030'],0,9,9,14745620,2,,,,9646
d0e4ebcdc2c386cae95506d9c2b158eef6679574,0,Yusaku Sako,2013-02-20 21:54:54+00:00,['c14eaaf8b6e0d3e2f83c024ed0fd932890348bd8'],1,4,5,14745625,2,,,,9646
79a57e7ef66c7bae4db958d32732075e381db53b,1,Yusaku Sako,2013-02-20 21:57:04+00:00,['d0e4ebcdc2c386cae95506d9c2b158eef6679574'],2,14,16,14745641,2,0,1,0,9646
ae6df00240ff4864d2707b2a63656ee6a7b3a4dc,1,Yusaku Sako,2013-02-20 22:02:56+00:00,['79a57e7ef66c7bae4db958d32732075e381db53b'],12,28,40,14745681,4,1,1,1,9646
6c38993fdb3b67a0d582d1d93b1bc2ce4348b26b,1,Yusaku Sako,2013-02-20 22:23:56+00:00,['ae6df00240ff4864d2707b2a63656ee6a7b3a4dc'],98,101,199,14745880,44,0,0,0,9646
2d9c6d71932dca03ab0b43601bb916f013608ad4,1,Yusaku Sako,2013-02-20 22:26:11+00:00,['6c38993fdb3b67a0d582d1d93b1bc2ce4348b26b'],5,13,18,14745898,6,1,1,1,9646
9d6eea7ec53ef59d2a034a0af042a2fa4cd8dfbb,1,Yusaku Sako,2013-02-20 22:29:09+00:00,['2d9c6d71932dca03ab0b43601bb916f013608ad4'],26,50,76,14745974,3,,,,9647
c249c25efe7bb4313a4c4e405e7df7a5b4eb36e1,1,Yusaku Sako,2013-02-20 22:34:52+00:00,['9d6eea7ec53ef59d2a034a0af042a2fa4cd8dfbb'],105,284,389,14746363,7,0.042553191,0.886524823,0.531914894,9647
400a37ab0b6636a5476461e731f43c085a5b8cfc,1,Yusaku Sako,2013-02-20 22:41:18+00:00,['c249c25efe7bb4313a4c4e405e7df7a5b4eb36e1'],5,241,246,14746609,12,0.705882353,1,0.911764706,9650
b89240907deb7bf4a08ed03b16009dc731694431,1,Yusaku Sako,2013-02-20 22:44:30+00:00,['400a37ab0b6636a5476461e731f43c085a5b8cfc'],170,171,341,14746950,9,0,0,0,9653
b61f3d68b55c6c86e9c9f4cd1282eed1748cfacb,1,Yusaku Sako,2013-02-20 22:51:22+00:00,['b89240907deb7bf4a08ed03b16009dc731694431'],1,4,5,14746955,2,,,,9653
75e33e872766d557ae5b44116fbbf399faae1da4,1,Yusaku Sako,2013-02-20 23:08:53+00:00,['b61f3d68b55c6c86e9c9f4cd1282eed1748cfacb'],153,153,306,14747261,26,0.890625,0.5078125,0,9653
1d7ff27fbb12b61c4e4f100eb79636a4b5bdacb1,1,Tom Beerbower,2013-02-21 19:25:50+00:00,['75e33e872766d557ae5b44116fbbf399faae1da4'],1,51,52,14747313,4,0,1,1,9653
c4f6c7e3c67df511be971e09859c059ef1359039,1,Mahadev Konar,2013-02-22 05:43:27+00:00,['1d7ff27fbb12b61c4e4f100eb79636a4b5bdacb1'],24,117,141,14747454,6,0,0,1,9653
2d1e9cfae9612f8f2bc8f7bcdbc065f840facc77,1,Mahadev Konar,2013-02-22 05:54:19+00:00,['c4f6c7e3c67df511be971e09859c059ef1359039'],13,30,43,14747497,13,,,,9653
2c05a7edae1f304fc5fba8558f132e4d7e0d73af,1,Mahadev Konar,2013-02-22 06:04:35+00:00,['2d1e9cfae9612f8f2bc8f7bcdbc065f840facc77'],15,124,139,14747636,4,0,0.375,1,9653
112517d675a6198bde4d532e0d63e2167bf05e46,1,Mahadev Konar,2013-02-22 06:15:28+00:00,['2c05a7edae1f304fc5fba8558f132e4d7e0d73af'],4,19,23,14747659,2,,,,9653
cd135589151712411c45c8881421f859bf46e0c6,1,Mahadev Konar,2013-02-22 06:39:10+00:00,['112517d675a6198bde4d532e0d63e2167bf05e46'],2,5,7,14747666,3,,,,9653
60abcbcf7f74c28fd874a59232dbf6a829f90c77,1,Mahadev Konar,2013-02-22 06:55:05+00:00,['cd135589151712411c45c8881421f859bf46e0c6'],9,12,21,14747687,6,,,,9653
47e3c62c928d7365987ce4654e73a8d98f133e33,0,Mahadev Konar,2013-02-22 07:18:45+00:00,['60abcbcf7f74c28fd874a59232dbf6a829f90c77'],1,4,5,14747692,2,,,,9653
779a0997e67d0b650ff91deef4d6c5c04d91198d,1,Yusaku Sako,2013-02-22 07:55:59+00:00,['47e3c62c928d7365987ce4654e73a8d98f133e33'],346,215,561,14748253,9,0,0,0,9653
c46578fea5a7b6b40f58142c21b0a6272e189590,1,Yusaku Sako,2013-02-22 07:58:43+00:00,['779a0997e67d0b650ff91deef4d6c5c04d91198d'],2,4,6,14748259,3,,,,9653
aa645e2a21f59046a66c51c45fc8d88e7c48aadc,0,Yusaku Sako,2013-02-22 08:00:42+00:00,['c46578fea5a7b6b40f58142c21b0a6272e189590'],1,4,5,14748264,2,,,,9653
60466790d634730e0c92eeaf9ef19f26d666222f,1,Yusaku Sako,2013-02-22 08:02:48+00:00,['aa645e2a21f59046a66c51c45fc8d88e7c48aadc'],1,3,4,14748268,2,,,,9653
92cc346d2d4ea617c2f4eac6d941cde701427f69,1,Yusaku Sako,2013-02-22 08:04:48+00:00,['60466790d634730e0c92eeaf9ef19f26d666222f'],219,1737,1956,14750224,12,1,0,0.15,9653
6d35b529d872ed1062a0bdb2b1c643efdca0812f,1,Yusaku Sako,2013-02-22 08:05:50+00:00,['92cc346d2d4ea617c2f4eac6d941cde701427f69'],0,379,379,14750603,7,1,1,0.928571429,9660
bbf5b6b8d6f0b03b806544a28b62d9db4e454134,1,Yusaku Sako,2013-02-22 08:07:20+00:00,['6d35b529d872ed1062a0bdb2b1c643efdca0812f'],161,145,306,14750909,9,0.84,0,0,9660
17d0b2622f5ec51154a2207846a686f6f219ffe2,1,Yusaku Sako,2013-02-22 08:09:15+00:00,['bbf5b6b8d6f0b03b806544a28b62d9db4e454134'],25,63,88,14750997,4,1,1,1,9660
a1a27a30485dd0e4828cf11e8f713be6cb7f57bd,1,Yusaku Sako,2013-02-22 08:11:16+00:00,['17d0b2622f5ec51154a2207846a686f6f219ffe2'],160,293,453,14751450,5,0.904761905,1,0.952380952,9661
875839f7a798eff5a52d8b18685f0b147213a692,1,Yusaku Sako,2013-02-22 08:12:39+00:00,['a1a27a30485dd0e4828cf11e8f713be6cb7f57bd'],1,7,8,14751458,2,1,1,1,9661
aa3af0ef970fb2000f22d732acbd5adad63cdd85,1,Yusaku Sako,2013-02-22 08:14:05+00:00,['875839f7a798eff5a52d8b18685f0b147213a692'],2,5,7,14751465,3,,,,9661
053aca65b5a08e0fc55e0dbcd2a051b1c8238a50,0,John Speidel,2013-02-22 18:45:02+00:00,['aa3af0ef970fb2000f22d732acbd5adad63cdd85'],13,101,114,14751579,4,1,1,0.98245614,9661
12b0c478109789b74aec8473497b1e84acafe9b0,1,Yusaku Sako,2013-02-22 21:34:23+00:00,['053aca65b5a08e0fc55e0dbcd2a051b1c8238a50'],24,145,169,14751748,5,1,1,1,9661
c5faec7ab42f61ee3f612911c9833da55998e3be,1,Yusaku Sako,2013-02-22 21:37:02+00:00,['12b0c478109789b74aec8473497b1e84acafe9b0'],55,256,311,14752059,15,0.96,0.96,1,9664
40ace6619a9208cd63113e6619c546c5d12a1ed8,1,Yusaku Sako,2013-02-22 21:39:46+00:00,['c5faec7ab42f61ee3f612911c9833da55998e3be'],17,484,501,14752560,19,0.898734177,0.905063291,1,9671
072eaae7e8f16fe17424224d3d357b092a6a0b66,1,Yusaku Sako,2013-02-22 21:41:13+00:00,['40ace6619a9208cd63113e6619c546c5d12a1ed8'],3,48,51,14752611,7,1,1,1,9671
6844d41e7d5f128417872a297fffe95f36bc3879,0,Yusaku Sako,2013-02-22 21:43:06+00:00,['072eaae7e8f16fe17424224d3d357b092a6a0b66'],15,26,41,14752652,3,0,1,1,9671
7fe21924195fe14e22e1dbffcf857528864970e3,0,Mahadev Konar,2013-02-25 03:20:58+00:00,['6844d41e7d5f128417872a297fffe95f36bc3879'],1,5,6,14752658,2,1,1,1,9671
c7d7badfb09bbbc5977dcd203a0e73eedb71595c,0,Tom Beerbower,2013-02-25 17:32:39+00:00,['7fe21924195fe14e22e1dbffcf857528864970e3'],3,106,109,14752767,11,1,1,1,9671
292390d81ea9a8d4ece0771d61b9bc5d79a29284,1,Mahadev Konar,2013-02-25 18:50:35+00:00,['c7d7badfb09bbbc5977dcd203a0e73eedb71595c'],136,433,569,14753336,17,0.289308176,0.893081761,0.93081761,9671
b0067a4aa5ded5df9979fd90d0462f7025e1ff60,1,Jaimin Jetly,2013-02-25 22:34:00+00:00,['292390d81ea9a8d4ece0771d61b9bc5d79a29284'],374,3573,3947,14757283,40,0.93401487,0.949814126,0.942379182,9695
7014a032de15748e5becb9750b4d6ce13c9c55d4,1,Mahadev Konar,2013-02-25 22:36:00+00:00,['b0067a4aa5ded5df9979fd90d0462f7025e1ff60'],1,4,5,14757288,2,,,,9695
96e2710b54cd89cd72ca521c681845a655b6a9b3,1,Jaimin Jetly,2013-02-25 23:08:12+00:00,['7014a032de15748e5becb9750b4d6ce13c9c55d4'],20,67,87,14757375,5,0.4375,1,0.84375,9695
9303c20ac0438394869d516a4b7dc408ed4314a2,1,Mahadev Konar,2013-02-25 23:43:32+00:00,['96e2710b54cd89cd72ca521c681845a655b6a9b3'],7,14,21,14757396,5,0,0,0,9695
43cb6704968666f32efb76f320a8a250668c91a6,1,Mahadev Konar,2013-02-26 00:04:42+00:00,['9303c20ac0438394869d516a4b7dc408ed4314a2'],11,16,27,14757423,2,,,,9695
38b78ef0890147753b25f84bc72ca9edeb0db170,1,Mahadev Konar,2013-02-26 01:42:29+00:00,['43cb6704968666f32efb76f320a8a250668c91a6'],1,3,4,14757427,2,,,,9695
46d7c0f61b9db79d141d5a4eb8a5312ca86f6b5f,0,Jaimin Jetly,2013-02-26 02:00:06+00:00,['38b78ef0890147753b25f84bc72ca9edeb0db170'],31,6,37,14757464,3,1,1,0,9695
3b05576ae4fbc5585f2473a5b256c42b5b89e0ad,0,Mahadev Konar,2013-02-26 03:06:53+00:00,['46d7c0f61b9db79d141d5a4eb8a5312ca86f6b5f'],2,5,7,14757471,2,,,,9695
e0f0f4e96227f0a0cd8924ba120fb083c3c75b05,1,Tom Beerbower,2013-02-26 18:28:52+00:00,['3b05576ae4fbc5585f2473a5b256c42b5b89e0ad'],25,68,93,14757564,7,0.181818182,1,0.772727273,9695
b219c06380d1d09c9c2f324c8ef1fdb8d0e4e0f9,1,Yusaku Sako,2013-02-26 22:46:54+00:00,['e0f0f4e96227f0a0cd8924ba120fb083c3c75b05'],1,4,5,14757569,2,,,,9695
3ed7d78272dd11bae4b99ee14ae7cb26381578d1,1,Yusaku Sako,2013-02-26 22:48:35+00:00,['b219c06380d1d09c9c2f324c8ef1fdb8d0e4e0f9'],1,7,8,14757577,2,0,1,1,9695
b1e5a1b0556a1b89295d5fea83d092c66d69cf29,0,Yusaku Sako,2013-02-26 22:50:18+00:00,['3ed7d78272dd11bae4b99ee14ae7cb26381578d1'],2,4,6,14757583,3,,,,9695
b5f5fdcdc384e53c32af7e3dc4e8ddd56fe14438,1,Yusaku Sako,2013-02-26 23:23:51+00:00,['b1e5a1b0556a1b89295d5fea83d092c66d69cf29'],25,135,160,14757743,7,1,1,1,9695
37f746a0a00c1452c5f026345c8ff81eaa2f2cfa,1,Jaimin Jetly,2013-02-27 00:03:05+00:00,['b5f5fdcdc384e53c32af7e3dc4e8ddd56fe14438'],107,367,474,14758217,9,0.948717949,1,1,9697
590cc663325d7c75e3ef8720abacd0147e3ed9bc,1,Tom Beerbower,2013-02-27 16:40:34+00:00,['37f746a0a00c1452c5f026345c8ff81eaa2f2cfa'],101,578,679,14758896,24,0.492682927,0.585365854,1,9699
af8015c4c5e32ab96bfc52927a9fae3af1b219a9,1,Srimanth,2013-02-27 19:54:36+00:00,['590cc663325d7c75e3ef8720abacd0147e3ed9bc'],133,926,1059,14759955,16,0.713855422,0.731927711,1,9704
1d44649afee6c8fd142535539f79d81a2e19ef03,1,Yusaku Sako,2013-02-27 20:10:01+00:00,['af8015c4c5e32ab96bfc52927a9fae3af1b219a9'],22,64,86,14760041,4,1,1,1,9704
21fb8ee0c29a5573bd0e4af306d3a3c81c11a527,1,Yusaku Sako,2013-02-27 20:37:38+00:00,['1d44649afee6c8fd142535539f79d81a2e19ef03'],128,145,273,14760314,6,0.69047619,0,0,9705
87f1d6d0ad9b8f65b2ed840ec2d8930c3142936b,1,Yusaku Sako,2013-02-27 20:41:46+00:00,['21fb8ee0c29a5573bd0e4af306d3a3c81c11a527'],0,3,3,14760317,1,0,1,1,9705
14be8428501346c936402124794be98e556fe7a0,1,Mahadev Konar,2013-02-27 20:48:10+00:00,['87f1d6d0ad9b8f65b2ed840ec2d8930c3142936b'],2,15,17,14760334,2,,,,9705
d0c8c7c1df69e036f017ef88effcf2c444a79d6d,1,Tom Beerbower,2013-02-28 16:50:06+00:00,['14be8428501346c936402124794be98e556fe7a0'],1,25,26,14760360,3,0,0.625,0.625,9705
7fc54e328e8472b4fa7bf6953aff442777dc98a3,1,Yusaku Sako,2013-02-28 20:51:00+00:00,['d0c8c7c1df69e036f017ef88effcf2c444a79d6d'],0,33,33,14760393,2,1,1,1,9705
bed3af1c7fc268df225128a6ef00270049e612fb,0,Yusaku Sako,2013-02-28 20:52:57+00:00,['7fc54e328e8472b4fa7bf6953aff442777dc98a3'],0,16,16,14760409,2,1,1,1,9705
b13bdc0e61b9783219f3a3429eee361455206029,1,Yusaku Sako,2013-02-28 20:59:45+00:00,['bed3af1c7fc268df225128a6ef00270049e612fb'],62,43,105,14760514,9,0,0,0,9705
77710995b5f99c68683e0ff4843ae03be70950e5,0,Mahadev Konar,2013-02-28 21:22:38+00:00,['b13bdc0e61b9783219f3a3429eee361455206029'],0,3,3,14760517,1,,,,9705
a410a001c91a1b2e0d85329750dc44540a57d2ed,1,Yusaku Sako,2013-02-28 21:44:31+00:00,['77710995b5f99c68683e0ff4843ae03be70950e5'],0,37,37,14760554,1,,,,9706
867f4e99601e74fe35b58f11cb8697ed20fb056c,0,Jaimin Jetly,2013-02-28 21:48:36+00:00,['a410a001c91a1b2e0d85329750dc44540a57d2ed'],1,4,5,14760559,2,,,,9706
a63ecf30f3fc506001c63625eebecf424e095a2e,1,Jaimin Jetly,2013-03-01 01:11:18+00:00,['867f4e99601e74fe35b58f11cb8697ed20fb056c'],1,4,5,14760564,2,,,,9706
b8caaf8c44fde9ee47c7704328876979e88e1f76,0,Tom Beerbower,2013-03-01 02:53:31+00:00,['a63ecf30f3fc506001c63625eebecf424e095a2e'],8,110,118,14760682,9,0.180327869,1,1,9706
a59689dc942bb7a135ac5461faf6fa25fec90391,1,Mahadev Konar,2013-03-01 07:02:47+00:00,['b8caaf8c44fde9ee47c7704328876979e88e1f76'],8,29,37,14760719,3,0,0,0.666666667,9706
9891977144839c8e4268c16d6e2e3772b6fc1140,1,Yusaku Sako,2013-03-01 22:13:07+00:00,['a59689dc942bb7a135ac5461faf6fa25fec90391'],16,1842,1858,14762577,18,0.670792079,0.826732673,0.995049505,9714
e0a9a13816b6746b37afae5f8f0c8db51bdfedc1,1,Yusaku Sako,2013-03-01 22:23:37+00:00,['9891977144839c8e4268c16d6e2e3772b6fc1140'],9,358,367,14762944,14,1,1,1,9720
4600218b68102f09d1e8911fa7d84ee5bb97a1d4,1,Yusaku Sako,2013-03-01 22:32:36+00:00,['e0a9a13816b6746b37afae5f8f0c8db51bdfedc1'],25,40,65,14763009,3,,,,9720
9b9b6902283d5138d671366778e1928fcebf391e,0,Yusaku Sako,2013-03-01 22:34:04+00:00,['4600218b68102f09d1e8911fa7d84ee5bb97a1d4'],42,68,110,14763119,8,0,0,0,9720
04541f0e0fc3597fa7843b7150f6433f239efd81,1,Siddharth Wagle,2013-03-01 22:36:22+00:00,['9b9b6902283d5138d671366778e1928fcebf391e'],44,804,848,14763967,12,0.272331155,0.773420479,0.335511983,9726
21e00a225f9aebd95eed17f52345a0c00ff235ba,1,Yusaku Sako,2013-03-01 22:39:13+00:00,['04541f0e0fc3597fa7843b7150f6433f239efd81'],68,42,110,14764077,8,1,1,1,9726
6120e2dc1d44aff9c1ae0e478bba762424fa3993,1,Yusaku Sako,2013-03-01 22:39:52+00:00,['21e00a225f9aebd95eed17f52345a0c00ff235ba'],2,21,23,14764100,2,,,,9726
6ce45f710e69532b65414d6fe130d975cf8c8a64,1,Siddharth Wagle,2013-03-01 23:08:02+00:00,['6120e2dc1d44aff9c1ae0e478bba762424fa3993'],66,1064,1130,14765230,21,0.133903134,0.699430199,0.807692308,9729
8aae66033c13b1a610433b025bfdc05786946b83,1,Siddharth Wagle,2013-03-01 23:39:53+00:00,['6ce45f710e69532b65414d6fe130d975cf8c8a64'],3,160,163,14765393,3,0,0,0.992125984,9729
60f3e6e4c8fd246070c959bebf15d5d9e358e49a,1,Siddharth Wagle,2013-03-02 00:29:27+00:00,['8aae66033c13b1a610433b025bfdc05786946b83'],89,234,323,14765716,14,1,0.9,0.175,9731
a2e0a3fd4a2fb7e74c42a1c2d95cfe4b08f5f868,0,Siddharth Wagle,2013-03-02 01:05:16+00:00,['60f3e6e4c8fd246070c959bebf15d5d9e358e49a'],3,5,8,14765724,2,,,,9731
a590882345e651fdd8b70358f4241ea60e0ca53c,1,Mahadev Konar,2013-03-04 03:44:01+00:00,['a2e0a3fd4a2fb7e74c42a1c2d95cfe4b08f5f868'],3,27,30,14765754,4,,,,9732
30199b0d3b8bfe08c9839e766bc3483e174eed79,1,Mahadev Konar,2013-03-04 04:50:49+00:00,['a590882345e651fdd8b70358f4241ea60e0ca53c'],47,147,194,14765948,10,0.145833333,0.104166667,0.4375,9733
8d742cf6544c3ce542a284075d16bc7e773c51d6,1,Jaimin Jetly,2013-03-04 18:19:10+00:00,['30199b0d3b8bfe08c9839e766bc3483e174eed79'],214,323,537,14766485,15,0.196969697,0.712121212,0.939393939,9733
8a58721d871fe26f45c3944205a5258eccb8c7ff,1,Siddharth Wagle,2013-03-04 19:16:28+00:00,['8d742cf6544c3ce542a284075d16bc7e773c51d6'],81,4209,4290,14770775,53,0.682847896,0.957389428,0.802588997,9766
40d8888c261c8d6674cd61610d35b96bea0e6992,1,Siddharth Wagle,2013-03-04 22:48:40+00:00,['8a58721d871fe26f45c3944205a5258eccb8c7ff'],30,129,159,14770934,15,,,,9767
e9d3a41518b1ab7315ffa02b66019074d1fd1857,1,Nate Cole,2013-03-05 16:52:48+00:00,['40d8888c261c8d6674cd61610d35b96bea0e6992'],35,918,953,14771887,23,0.684210526,0.936288089,0.844875346,9773
9120b394d5f36806b1f1aeeecd84a281010311b8,1,Siddharth Wagle,2013-03-06 01:27:01+00:00,['e9d3a41518b1ab7315ffa02b66019074d1fd1857'],9,113,122,14772009,8,0.266666667,0.311111111,1,9774
5b0321a2bba131d4004724b8d4955a528dbd47d1,1,Siddharth Wagle,2013-03-06 06:01:25+00:00,['9120b394d5f36806b1f1aeeecd84a281010311b8'],3,3407,3410,14775419,31,0,1,1,9802
480d83a9e8b52a3bc9e4c6c5fb23937471d86130,1,Nate Cole,2013-03-06 18:45:41+00:00,['5b0321a2bba131d4004724b8d4955a528dbd47d1'],48,251,299,14775718,12,0.208333333,0.775,1,9802
dfbd22be55b60594da7cac6daf37979a04791f0d,1,Siddharth Wagle,2013-03-06 18:47:55+00:00,['480d83a9e8b52a3bc9e4c6c5fb23937471d86130'],1,135,136,14775854,7,0.875,0.875,1,9804
4f8357fdf5bb1ead4c1af5e206187d9f16511f2f,1,Siddharth Wagle,2013-03-06 18:55:44+00:00,['dfbd22be55b60594da7cac6daf37979a04791f0d'],9,27,36,14775890,3,1,1,1,9804
f00f883002854c13575019668eebaa49d86bb7ed,1,Siddharth Wagle,2013-03-06 19:06:13+00:00,['4f8357fdf5bb1ead4c1af5e206187d9f16511f2f'],98,392,490,14776380,11,0.090517241,0.969827586,0.487068966,9804
bd97066367c3531bd30a9308d597f7153d1fbd8f,0,Siddharth Wagle,2013-03-06 19:25:09+00:00,['f00f883002854c13575019668eebaa49d86bb7ed'],9,61,70,14776450,3,0,1,1,9804
72334f9d48ef7bf7a1fb28636b19e992bf8d38c8,1,Siddharth Wagle,2013-03-06 19:44:34+00:00,['bd97066367c3531bd30a9308d597f7153d1fbd8f'],3,5,8,14776458,4,1,1,,9804
e9db441699d38ca7dc26feefe7280e1c05fa981b,1,Siddharth Wagle,2013-03-06 20:53:35+00:00,['72334f9d48ef7bf7a1fb28636b19e992bf8d38c8'],1,7,8,14776466,3,,,,9804
82665571f512bf971684e8b2cf4775de763b0478,1,Nate Cole,2013-03-06 21:08:39+00:00,['e9db441699d38ca7dc26feefe7280e1c05fa981b'],9,11,20,14776486,6,,,,9804
ba542242cee27e85e7b09ae3f9f9121471a327d8,1,Siddharth Wagle,2013-03-07 06:35:21+00:00,['82665571f512bf971684e8b2cf4775de763b0478'],21,82,103,14776589,5,0.333333333,0.861111111,1,9805
43f296e7b5b4fbda444ea3df24a728516d78efff,0,Jaimin Jetly,2013-03-07 18:31:53+00:00,['ba542242cee27e85e7b09ae3f9f9121471a327d8'],1,4,5,14776594,2,,0,,9805
f501ec774b21691cf110106f57d817d6b13c9eee,1,Jaimin Jetly,2013-03-07 19:27:42+00:00,['43f296e7b5b4fbda444ea3df24a728516d78efff'],4,5,9,14776603,3,,,,9805
fc0bebea7cd4509c340292d89891499f5d0c8185,1,Tom Beerbower,2013-03-07 21:32:32+00:00,['f501ec774b21691cf110106f57d817d6b13c9eee'],52,253,305,14776908,6,0,1,1,9805
f10bfdd4bf723873ac7d27d01b216b4873142475,1,Siddharth Wagle,2013-03-07 22:32:21+00:00,['fc0bebea7cd4509c340292d89891499f5d0c8185'],1,9,10,14776918,1,0,1,1,9805
f613759cc564adedc303471be9a10c7d73cf46b7,1,Yusaku Sako,2013-03-07 22:43:52+00:00,['f10bfdd4bf723873ac7d27d01b216b4873142475'],15,32,47,14776965,4,0,0,1,9805
4f7994c2f73ad141a4b528f908c701aa4e85faf4,1,Yusaku Sako,2013-03-07 22:47:03+00:00,['f613759cc564adedc303471be9a10c7d73cf46b7'],2,5,7,14776972,2,,,,9805
ee9c5b37a5812c68494dcf9ecde4d095d50205b8,1,Yusaku Sako,2013-03-07 22:48:43+00:00,['4f7994c2f73ad141a4b528f908c701aa4e85faf4'],0,7,7,14776979,2,,,,9805
e26a0d95c8de7b21537363a22a14b1cd525639b1,1,Yusaku Sako,2013-03-07 23:15:17+00:00,['ee9c5b37a5812c68494dcf9ecde4d095d50205b8'],421,525,946,14777925,11,1,1,1,9805
86a02e3cad496efcc6c8c18a7919bc722a866bb6,1,Yusaku Sako,2013-03-07 23:17:33+00:00,['e26a0d95c8de7b21537363a22a14b1cd525639b1'],53,73,126,14778051,6,1,1,1,9805
03ada6d417e2a79e56baad592b5d89ed6d71e8e4,1,Yusaku Sako,2013-03-07 23:32:49+00:00,['86a02e3cad496efcc6c8c18a7919bc722a866bb6'],119,186,305,14778356,9,0.227272727,0,1,9805
3c110114d928effd888d16366983848793af5d13,1,Yusaku Sako,2013-03-07 23:35:05+00:00,['03ada6d417e2a79e56baad592b5d89ed6d71e8e4'],240,213,453,14778809,12,0.677419355,0.806451613,1,9805
cc4ac398b75aac0999df39e8a69b1ac38c4b581f,1,Yusaku Sako,2013-03-07 23:53:05+00:00,['3c110114d928effd888d16366983848793af5d13'],2,579,581,14779390,7,0.494949495,0.703703704,1,9807
96190e3e97bcd826981213f3236c5c081cb11f02,1,Yusaku Sako,2013-03-08 00:03:11+00:00,['cc4ac398b75aac0999df39e8a69b1ac38c4b581f'],21,25,46,14779436,2,,,,9807
b98f8c271bd2b8e3fe8fd7b77a405f1aa670ffce,0,Yusaku Sako,2013-03-08 00:04:35+00:00,['96190e3e97bcd826981213f3236c5c081cb11f02'],0,4,4,14779440,2,,,,9807
663ec9d669aa2e3fae9ed8be1fd22bf452296e8f,1,Yusaku Sako,2013-03-08 00:07:45+00:00,['b98f8c271bd2b8e3fe8fd7b77a405f1aa670ffce'],3,16,19,14779459,1,1,1,1,9807
d47770de7a63469e768e6545d3d1b859a4ca0741,1,Siddharth Wagle,2013-03-08 00:17:51+00:00,['663ec9d669aa2e3fae9ed8be1fd22bf452296e8f'],103,188,291,14779750,5,0,1,1,9807
f0856989c8ad8a2647febf34db49f05f3d7fab3b,1,Yusaku Sako,2013-03-08 00:20:18+00:00,['d47770de7a63469e768e6545d3d1b859a4ca0741'],1,5,6,14779756,2,1,1,1,9807
90829a21baf1f42bc822629778cdcc1eac7c0485,1,Yusaku Sako,2013-03-08 00:30:36+00:00,['f0856989c8ad8a2647febf34db49f05f3d7fab3b'],475,370,845,14780601,10,0,0.630630631,0,9807
7707ec5ce08faab427ba25078f62c07d10745a98,1,Siddharth Wagle,2013-03-08 18:29:46+00:00,['90829a21baf1f42bc822629778cdcc1eac7c0485'],12,29,41,14780642,8,,,,9807
d1b0c3db00fc6205cb8d090922c7ddeeef467f78,1,Nate Cole,2013-03-08 20:14:34+00:00,['7707ec5ce08faab427ba25078f62c07d10745a98'],14,67,81,14780723,4,0.95,1,1,9807
7bc55da8e0ca1d82743d3563e00fac6f6a6c3b23,1,Nate Cole,2013-03-08 20:39:20+00:00,['d1b0c3db00fc6205cb8d090922c7ddeeef467f78'],63,97,160,14780883,2,0,0,0,9807
12be9a1a12958a3e890592a87f8b5a131b4c8a58,1,Siddharth Wagle,2013-03-08 21:14:19+00:00,['7bc55da8e0ca1d82743d3563e00fac6f6a6c3b23'],11,115,126,14781009,6,0,1,1,9810
3b53d908e6609a901280ed6c6a890ea076f6c7d5,1,Yusaku Sako,2013-03-09 02:03:51+00:00,['12be9a1a12958a3e890592a87f8b5a131b4c8a58'],4501,1538,6039,14787048,30,0.658959538,0.479287091,0.193641618,9818
5a4b8e5c09418c2c8386d4748258a125e1bc6f1f,1,Siddharth Wagle,2013-03-09 20:02:43+00:00,['3b53d908e6609a901280ed6c6a890ea076f6c7d5'],9,25,34,14787082,3,0.25,0,0.25,9818
0e5a4c4f89cac37fa52c5a6be9cbc31492ad0138,1,Mahadev Konar,2013-03-11 06:24:52+00:00,['5a4b8e5c09418c2c8386d4748258a125e1bc6f1f'],15,467,482,14787564,14,0.37398374,0.524390244,0.983739837,9820
5357f3923946ab1940cb4eb047c8ca19a4ea75c7,1,John Speidel,2013-03-11 19:26:49+00:00,['0e5a4c4f89cac37fa52c5a6be9cbc31492ad0138'],2259,2919,5178,14792742,50,0,0.008298755,1,9829
8c1b6ee5a6950024b639b1de9ae85366a1061833,0,Yusaku Sako,2013-03-12 06:18:09+00:00,['5357f3923946ab1940cb4eb047c8ca19a4ea75c7'],16,35,51,14792793,5,,,,9829
56fc66187d8fbe4008e7c5fe5c6120f3f78f88d5,1,John Speidel,2013-03-12 16:44:29+00:00,['8c1b6ee5a6950024b639b1de9ae85366a1061833'],113,200,313,14793106,7,0,0,1,9829
9ceaf73ce74b2d6aee5ebd83f6c9138e7ba4cdaf,1,Siddharth Wagle,2013-03-12 16:56:01+00:00,['56fc66187d8fbe4008e7c5fe5c6120f3f78f88d5'],1,5,6,14793112,2,,,,9829
1a615f3fb88e106baff7dd7e543a78a33d391fa3,1,Mahadev Konar,2013-03-12 17:39:35+00:00,['9ceaf73ce74b2d6aee5ebd83f6c9138e7ba4cdaf'],6,64,70,14793182,5,0,0.875,0.1875,9829
b3ed978fa8863e7d3cd66ef907915df478f7cba8,0,Siddharth Wagle,2013-03-12 17:40:35+00:00,['1a615f3fb88e106baff7dd7e543a78a33d391fa3'],0,7,7,14793189,2,,,,9829
6273761f7a18f46e36322f05bd5a8e97b1298d6a,1,Nate Cole,2013-03-12 19:37:51+00:00,['b3ed978fa8863e7d3cd66ef907915df478f7cba8'],14,16,30,14793219,3,,,,9829
b4e53d0f31fda3cd44c678c2d7f7b1776c0e7fae,1,Nate Cole,2013-03-13 21:36:16+00:00,['6273761f7a18f46e36322f05bd5a8e97b1298d6a'],72,90,162,14793381,3,0,0.2,0.2,9829
6285936bc8e394c9278cd11765bd7755a521ceeb,1,Siddharth Wagle,2013-03-13 21:55:51+00:00,['b4e53d0f31fda3cd44c678c2d7f7b1776c0e7fae'],2,17,19,14793400,3,,,,9829
98362842b0a44e6dec74ce4a3d5decd0b09d84a6,0,Yusaku Sako,2013-03-13 23:11:33+00:00,['6285936bc8e394c9278cd11765bd7755a521ceeb'],12,14,26,14793426,6,,,,9829
44c1e82ef1d9e326960bf683aceb1849e9ee4033,1,Siddharth Wagle,2013-03-13 23:14:28+00:00,['98362842b0a44e6dec74ce4a3d5decd0b09d84a6'],10,28,38,14793464,7,,,,9829
335047d0db578c9706a6cd53bf5b16d170ddba35,1,Yusaku Sako,2013-03-13 23:15:26+00:00,['44c1e82ef1d9e326960bf683aceb1849e9ee4033'],616,136,752,14794216,15,0.125,0,0,9829
485c844f1fd0f4655e7ab53509ffd2b2c6c7b1c9,1,Yusaku Sako,2013-03-13 23:30:55+00:00,['335047d0db578c9706a6cd53bf5b16d170ddba35'],4,714,718,14794934,13,0.388059701,0.701492537,1,9838
906d3c40118b9184d8774fb74ee8d852412f1fd4,1,Yusaku Sako,2013-03-13 23:40:30+00:00,['485c844f1fd0f4655e7ab53509ffd2b2c6c7b1c9'],68,101,169,14795103,7,1,1,1,9838
79d1681095ce0ae71294dec8f8f1c7a7c759a6e4,1,Yusaku Sako,2013-03-13 23:46:46+00:00,['906d3c40118b9184d8774fb74ee8d852412f1fd4'],64,468,532,14795635,14,1,1,1,9844
952905f60fec9744a7a0d6a23b7c7e1651275ae5,1,Yusaku Sako,2013-03-13 23:50:03+00:00,['79d1681095ce0ae71294dec8f8f1c7a7c759a6e4'],71,454,525,14796160,11,0.223880597,0.611940299,1,9847
5e1a663cd842fc1ad6db5cf932645a355d450c9c,1,Yusaku Sako,2013-03-13 23:55:15+00:00,['952905f60fec9744a7a0d6a23b7c7e1651275ae5'],18,89,107,14796267,5,0.107142857,1,1,9847
e1e44666eb05c5b108469290eff08c57c5e6706d,1,Yusaku Sako,2013-03-13 23:57:19+00:00,['5e1a663cd842fc1ad6db5cf932645a355d450c9c'],4,82,86,14796353,2,,,,9847
c4bbbe38fd0c3af38bd13808cc88e857345317f2,1,Yusaku Sako,2013-03-14 00:04:22+00:00,['e1e44666eb05c5b108469290eff08c57c5e6706d'],2,30,32,14796385,2,,,,9847
d6c1a8f32f74b6a6e1946efca5a440f1a0909aca,1,Siddharth Wagle,2013-03-14 00:19:47+00:00,['c4bbbe38fd0c3af38bd13808cc88e857345317f2'],40,901,941,14797326,13,,,,9853
573ea662b0e0d42e4bb899ce88c446b151b4d91d,1,Yusaku Sako,2013-03-14 00:27:03+00:00,['d6c1a8f32f74b6a6e1946efca5a440f1a0909aca'],1,970,971,14798297,11,0.630114566,0.782324059,0.972176759,9856
c2e15d0ca0ba436284a1dfaa2d8a4a5d337a7220,1,Jaimin Jetly,2013-03-14 00:33:10+00:00,['573ea662b0e0d42e4bb899ce88c446b151b4d91d'],35,154,189,14798486,6,0.409090909,0.636363636,1,9856
d907f1ee96aef2ba7aa9648eb2c9ae6ff136b355,1,Jaimin Jetly,2013-03-14 00:51:00+00:00,['c2e15d0ca0ba436284a1dfaa2d8a4a5d337a7220'],18,302,320,14798806,13,1,1,1,9863
7364fae1bf21c4457928bf4d8865d55b8102b677,0,Mahadev Konar,2013-03-14 05:32:30+00:00,['d907f1ee96aef2ba7aa9648eb2c9ae6ff136b355'],7,7,14,14798820,2,,,,9863
f1dff00e99725119669472ace5ca78a315bb1a18,0,Mahadev Konar,2013-03-14 05:33:45+00:00,['7364fae1bf21c4457928bf4d8865d55b8102b677'],1,1,2,14798822,1,,,,9863
65f2880a0bd872ce0a76247548a17da0617deb12,0,Yusaku Sako,2013-03-14 07:39:01+00:00,['f1dff00e99725119669472ace5ca78a315bb1a18'],61,53,114,14798936,2,,,,9863
b2fae8cb54d2e4929437d941e831dcb584c5f645,1,Siddharth Wagle,2013-03-14 16:44:19+00:00,['65f2880a0bd872ce0a76247548a17da0617deb12'],87,503,590,14799526,18,0.344262295,0.778688525,0.696721311,9866
e046f95e1592afb8a33f4f905fbc09152f714b4e,1,Siddharth Wagle,2013-03-14 16:53:33+00:00,['b2fae8cb54d2e4929437d941e831dcb584c5f645'],10,27,37,14799563,3,0,0.8,0.8,9866
5919203ba698a2b454ad538c761cd7a05e770b9b,1,Siddharth Wagle,2013-03-14 17:31:50+00:00,['e046f95e1592afb8a33f4f905fbc09152f714b4e'],41,519,560,14800123,9,0.054590571,0.82382134,0.841191067,9866
d775dcf38d6fa258c45763e1ee409e49bf8349a7,0,Siddharth Wagle,2013-03-14 17:54:07+00:00,['5919203ba698a2b454ad538c761cd7a05e770b9b'],1,3,4,14800127,2,,,,9866
d7e7b8df184041859ccc81c33cb585083e26b8f7,1,Jaimin Jetly,2013-03-14 18:24:29+00:00,['d775dcf38d6fa258c45763e1ee409e49bf8349a7'],2,5,7,14800134,2,,,,9866
ad21db4022f9f68601391e72638cb0213adc6793,1,Mahadev Konar,2013-03-14 21:19:00+00:00,['d7e7b8df184041859ccc81c33cb585083e26b8f7'],125,600,725,14800859,11,0.12890625,0.10546875,0.953125,9868
0d7d7a81114cef99008f79fdfc82b5b7bb5e9919,1,Tom Beerbower,2013-03-14 22:45:06+00:00,['ad21db4022f9f68601391e72638cb0213adc6793'],15,35,50,14800909,4,0,1,1,9868
e37878aaf45bebe57dac44c636a441b26076f64c,0,Siddharth Wagle,2013-03-15 18:14:35+00:00,['0d7d7a81114cef99008f79fdfc82b5b7bb5e9919'],0,4,4,14800913,2,,,,9868
9ea1663172c2b7364286c829480a939e0366bb6a,1,Nate Cole,2013-03-15 21:09:32+00:00,['e37878aaf45bebe57dac44c636a441b26076f64c'],21,31,52,14800965,8,0,0.857142857,0.571428571,9868
d22a96985922c91233a0e77864948486119c3676,1,Siddharth Wagle,2013-03-15 22:30:49+00:00,['9ea1663172c2b7364286c829480a939e0366bb6a'],2,12,14,14800979,2,,,,9868
5c6470a484a97f6eaba242b1fc515609e59b0997,0,Yusaku Sako,2013-03-16 00:15:53+00:00,['d22a96985922c91233a0e77864948486119c3676'],1,37,38,14801017,1,,,,9868
5fc6ba4959a7c924f2a5df4831aa6c2720cb4ce4,1,Siddharth Wagle,2013-03-16 03:39:02+00:00,['5c6470a484a97f6eaba242b1fc515609e59b0997'],127,1216,1343,14802360,50,0.300395257,0.897233202,0.743083004,9898
38924d9e066a728e8de86a3e9195eac286cf251a,1,Nate Cole,2013-03-18 14:06:19+00:00,['5fc6ba4959a7c924f2a5df4831aa6c2720cb4ce4'],46,435,481,14802841,18,0.043478261,0.789855072,0.963768116,9898
fb8eca687995c0991183258720171d5f6d5ac486,1,Nate Cole,2013-03-18 20:07:43+00:00,['38924d9e066a728e8de86a3e9195eac286cf251a'],24,68,92,14802933,3,0,1,1,9898
0569d9865bc87f96ec41b3b74250da1cec67dcc1,1,Siddharth Wagle,2013-03-19 00:27:39+00:00,['fb8eca687995c0991183258720171d5f6d5ac486'],50,255,305,14803238,9,,,,9901
74937dd55694a8e154a52d25d0d25e10a9377c31,1,Tom Beerbower,2013-03-19 15:56:11+00:00,['0569d9865bc87f96ec41b3b74250da1cec67dcc1'],371,3285,3656,14806894,55,0.499531396,0.919400187,0.873477038,9927
d9beaa09d7c86297d59eeb474885f06faabff997,1,Siddharth Wagle,2013-03-19 17:22:31+00:00,['74937dd55694a8e154a52d25d0d25e10a9377c31'],8,225,233,14807127,4,0.222857143,0.742857143,0.851428571,9927
49a15c150982a2f5c3a5bce38cbe8cfedf7b9281,0,Tom Beerbower,2013-03-19 19:53:31+00:00,['d9beaa09d7c86297d59eeb474885f06faabff997'],0,556,556,14807683,4,1,0.565217391,0.826086957,9931
a39a15f7b7d9254c4ed2d42fc4c39f97699991f2,1,John Speidel,2013-03-19 20:20:27+00:00,['49a15c150982a2f5c3a5bce38cbe8cfedf7b9281'],1040,1360,2400,14810083,71,0.1,0.905,0.93,9932
019947decbae1ba941b026d1758b8bd8df37116a,1,Siddharth Wagle,2013-03-19 20:32:43+00:00,['a39a15f7b7d9254c4ed2d42fc4c39f97699991f2'],2,5,7,14810090,2,,,,9932
8f30bc0aef9747cf6f08a7969a5ad43222fd5135,0,Siddharth Wagle,2013-03-20 00:41:55+00:00,['019947decbae1ba941b026d1758b8bd8df37116a'],11,13,24,14810114,2,,,,9932
1857c259fb6df22d8c5c46d6b6bcfa0384ceb268,0,Siddharth Wagle,2013-03-20 00:52:40+00:00,['8f30bc0aef9747cf6f08a7969a5ad43222fd5135'],8,25,33,14810147,3,,,,9932
56eae5817428a85bcb2e19cbd45faeb003152514,1,Jaimin Jetly,2013-03-20 01:02:10+00:00,['1857c259fb6df22d8c5c46d6b6bcfa0384ceb268'],43,54,97,14810244,8,1,0,0,9932
f4ec7e33e4bda47949ab61d47a97747262af5068,0,Yusaku Sako,2013-03-20 06:35:37+00:00,['56eae5817428a85bcb2e19cbd45faeb003152514'],25,23,48,14810292,4,,,,9932
063306a82c94fb1a78cb86750d1ca8d63599c53c,1,Jaimin Jetly,2013-03-21 16:53:46+00:00,['f4ec7e33e4bda47949ab61d47a97747262af5068'],328,190,518,14810810,7,0,0,0.142857143,9932
83943c3ef2b962da9d0070f3240a82b3dbe74271,1,Nate Cole,2013-03-21 19:09:00+00:00,['063306a82c94fb1a78cb86750d1ca8d63599c53c'],3,7,10,14810820,2,0,0,0,9932
20e4498aec50e6631867bb5ebec79893a021f746,0,Yusaku Sako,2013-03-22 04:40:10+00:00,['83943c3ef2b962da9d0070f3240a82b3dbe74271'],2,3,5,14810825,3,,,,9932
8782442de66f30f260d8be74d1be118c6cdd28c5,0,Tom Beerbower,2013-03-22 19:18:57+00:00,['20e4498aec50e6631867bb5ebec79893a021f746'],149,768,917,14811742,17,0.457792208,0.451298701,0.931818182,9933
9948a0ac5385e2cbf484f8675e67185be24b6cb9,1,Siddharth Wagle,2013-03-22 20:34:57+00:00,['8782442de66f30f260d8be74d1be118c6cdd28c5'],15,63,78,14811820,6,0,0.047619048,0.047619048,9933
22a242fa4d96c09fee770ee948a556833532c391,1,Siddharth Wagle,2013-03-22 20:42:13+00:00,['9948a0ac5385e2cbf484f8675e67185be24b6cb9'],92,213,305,14812125,15,0.388059701,0.507462687,0,9933
f75189b60f274e669a3d2b5335d82e59b59f081b,1,Siddharth Wagle,2013-03-22 20:48:34+00:00,['22a242fa4d96c09fee770ee948a556833532c391'],12,94,106,14812231,11,0.805555556,0.916666667,0.972222222,9933
46bcf0424edd9f0658f3d5a05b9b513bbc3fdb76,0,Siddharth Wagle,2013-03-22 20:53:26+00:00,['f75189b60f274e669a3d2b5335d82e59b59f081b'],6,10,16,14812247,2,,,,9933
12ea5e4a1a12606a5612576d2be19e5bdd789f2b,1,Yusaku Sako,2013-03-23 04:28:01+00:00,['46bcf0424edd9f0658f3d5a05b9b513bbc3fdb76'],75,113,188,14812435,7,0.565217391,0,1,9933
917d5092aa7e1419dfa5d2939e88a540f85ad2b6,1,Yusaku Sako,2013-03-23 04:29:58+00:00,['12ea5e4a1a12606a5612576d2be19e5bdd789f2b'],5,31,36,14812471,4,1,1,1,9933
fc5193e768f08faaf5593ca9a5342c6b346abf98,1,Yusaku Sako,2013-03-23 04:38:02+00:00,['917d5092aa7e1419dfa5d2939e88a540f85ad2b6'],40,688,728,14813199,16,0.726315789,0.642105263,0.926315789,9936
989cffef89b5ff92beedff1da673542429045673,1,Yusaku Sako,2013-03-23 04:40:33+00:00,['fc5193e768f08faaf5593ca9a5342c6b346abf98'],45,520,565,14813764,6,0.735426009,1,0.932735426,9936
2b3a6ed172d83fb3632f22c940ebef6266be0690,1,Yusaku Sako,2013-03-23 04:43:01+00:00,['989cffef89b5ff92beedff1da673542429045673'],1,3,4,14813768,2,,,,9936
0ee06905f9c1230426a2bd2b84d3215054c62c80,1,Yusaku Sako,2013-03-23 04:47:11+00:00,['2b3a6ed172d83fb3632f22c940ebef6266be0690'],10,33,43,14813811,3,1,1,1,9936
8d8219a3dfb91fa2aaf41ce01d1ea65f41a31719,1,Yusaku Sako,2013-03-23 04:50:35+00:00,['0ee06905f9c1230426a2bd2b84d3215054c62c80'],25,164,189,14814000,7,0.614583333,0.791666667,1,9936
1e177bf87a791c617e1082335fb0f917261b3080,1,Siddharth Wagle,2013-03-25 17:34:34+00:00,['8d8219a3dfb91fa2aaf41ce01d1ea65f41a31719'],4,13,17,14814017,3,,,,9936
a3c06d7304f6cbeaf596fd2459569ebab1bbd11c,1,Jaimin Jetly,2013-03-25 21:09:55+00:00,['1e177bf87a791c617e1082335fb0f917261b3080'],21,23,44,14814061,2,1,1,1,9936
9da486cd60c142b541049dbe6fd19d4fcf799ae0,1,Jaimin Jetly,2013-03-25 22:04:47+00:00,['a3c06d7304f6cbeaf596fd2459569ebab1bbd11c'],6,23,29,14814090,4,1,1,1,9936
9923793177556c401b13d56f0bdf95cb611c4a00,1,Siddharth Wagle,2013-03-26 01:21:11+00:00,['9da486cd60c142b541049dbe6fd19d4fcf799ae0'],24,115,139,14814229,4,0,0,1,9937
bac34df81838d818be5341d779a9017583c1f1cb,1,Siddharth Wagle,2013-03-26 01:32:24+00:00,['9923793177556c401b13d56f0bdf95cb611c4a00'],3,92,95,14814324,13,,,,9942
478f9e0f041b8631d84a1c5093a25095b19e3cc5,1,Siddharth Wagle,2013-03-26 01:35:02+00:00,['bac34df81838d818be5341d779a9017583c1f1cb'],30,150,180,14814504,18,,,,9943
858375d7640d827ba24685aa46dedc50d167b635,1,Nate Cole,2013-03-26 18:01:30+00:00,['478f9e0f041b8631d84a1c5093a25095b19e3cc5'],7,63,70,14814574,3,0,0.448275862,1,9943
1f3db51d7f07c77466938118a7a612eb20e5b8b2,1,Siddharth Wagle,2013-03-26 20:29:43+00:00,['858375d7640d827ba24685aa46dedc50d167b635'],35,40,75,14814649,4,,,,9943
01891a909bb01e0f45780d4c4d97c001c5241ec9,0,Siddharth Wagle,2013-03-26 20:38:43+00:00,['1f3db51d7f07c77466938118a7a612eb20e5b8b2'],0,10,10,14814659,3,0,0.166666667,1,9943
b3a2afee9e1832ff2a74757153b0b9ece9b18308,1,Sumit Mohanty,2013-03-26 21:11:02+00:00,['01891a909bb01e0f45780d4c4d97c001c5241ec9'],0,66,66,14814725,7,0,0,1,9944
790c31164cccb9f5ad9982a1dee3552d47acbe04,1,Sumit Mohanty,2013-03-26 21:29:42+00:00,['b3a2afee9e1832ff2a74757153b0b9ece9b18308'],1,8,9,14814734,2,0,1,1,9944
cecc97a7f039f28726b55aca2482800b4cd32a60,1,Sumit Mohanty,2013-03-27 01:25:04+00:00,['790c31164cccb9f5ad9982a1dee3552d47acbe04'],27,326,353,14815087,15,1,0.865853659,0.658536585,9948
4b43261cb32dd73479e81a7d48f4adb24890b2c2,1,Sumit Mohanty,2013-03-27 16:52:31+00:00,['cecc97a7f039f28726b55aca2482800b4cd32a60'],37,45,82,14815169,7,0,0,1,9948
67f4b84375e4cee4d552e076cc23ad8a4a613838,1,Siddharth Wagle,2013-03-27 22:45:53+00:00,['4b43261cb32dd73479e81a7d48f4adb24890b2c2'],30,61,91,14815260,11,0.2,0.24,0.96,9948
58a0dcbb5e6b9f4afd2f73d68a732ee857631dc3,0,Siddharth Wagle,2013-03-27 22:47:05+00:00,['67f4b84375e4cee4d552e076cc23ad8a4a613838'],0,3,3,14815263,1,,,,9948
8266f981dad538c56106a88237a2d116f6b8c842,0,Jaimin Jetly,2013-03-28 00:20:54+00:00,['58a0dcbb5e6b9f4afd2f73d68a732ee857631dc3'],4,4,8,14815271,2,,,,9948
6c149aa8c57525af0400b466211165843eb0bb5e,1,Jaimin Jetly,2013-03-28 00:32:52+00:00,['8266f981dad538c56106a88237a2d116f6b8c842'],2,4,6,14815277,2,,,,9948
0f52f8bf2bd46c47fb221755de40fea3a7b6c209,1,Sumit Mohanty,2013-03-28 05:09:19+00:00,['6c149aa8c57525af0400b466211165843eb0bb5e'],363,413,776,14816053,41,0,0,1,9965
3598b4651c8e70c64f8be3f1704ae212e115a03a,1,Jaimin Jetly,2013-03-28 15:58:49+00:00,['0f52f8bf2bd46c47fb221755de40fea3a7b6c209'],1,6,7,14816060,3,,,,9965
e4827126710d09d5c0773aecf49816eac364dc8d,1,Nate Cole,2013-03-28 19:48:35+00:00,['3598b4651c8e70c64f8be3f1704ae212e115a03a'],26,330,356,14816416,17,0.385135135,0.898648649,0.952702703,9967
6227a3fd326bcadba167621b835112769b79877b,1,Siddharth Wagle,2013-03-29 01:11:07+00:00,['e4827126710d09d5c0773aecf49816eac364dc8d'],13,16,29,14816445,5,,,,9967
ea921ee493d86a650443636e3cb6315ff382798b,1,Sumit Mohanty,2013-03-29 17:00:34+00:00,['6227a3fd326bcadba167621b835112769b79877b'],1,12,13,14816458,2,,,,9967
4a75c484cf7eaabb28128fc3447854a04f30bba9,1,Sumit Mohanty,2013-03-29 17:03:35+00:00,['ea921ee493d86a650443636e3cb6315ff382798b'],22,401,423,14816881,9,0.218905473,0.587064677,0.940298507,9968
1795acfb2772b618c2a57445b6618e5d76656543,1,Sumit Mohanty,2013-03-29 17:08:02+00:00,['4a75c484cf7eaabb28128fc3447854a04f30bba9'],7,17,24,14816905,3,,,,9968
c016a025109c938cefcdc432dd01da77e9d27fbc,1,Sumit Mohanty,2013-03-29 17:19:48+00:00,['1795acfb2772b618c2a57445b6618e5d76656543'],37,46,83,14816988,5,0,1,1,9968
7415f55c31debbbc87ec3669c748189e8814bded,1,Sumit Mohanty,2013-03-29 17:34:45+00:00,['c016a025109c938cefcdc432dd01da77e9d27fbc'],48,303,351,14817339,19,,,,9968
ed271deff5b4c5be4075ea87f792a118a755de1c,0,Sumit Mohanty,2013-03-29 17:38:47+00:00,['7415f55c31debbbc87ec3669c748189e8814bded'],0,3,3,14817342,3,,,,9968
b4740b343d8dd14afcc13d4e173613132b72c1c1,0,Srimanth,2013-03-29 18:07:22+00:00,['ed271deff5b4c5be4075ea87f792a118a755de1c'],2,4,6,14817348,2,,,,9968
a32d1c012e4b336c83e3496fd72f222dbf7a0c96,1,Siddharth Wagle,2013-03-29 18:27:24+00:00,['b4740b343d8dd14afcc13d4e173613132b72c1c1'],3,5,8,14817356,3,,,,9968
81cabf88d0cca3e239639c1a31f57f2140ea9b45,1,Siddharth Wagle,2013-03-29 18:29:50+00:00,['a32d1c012e4b336c83e3496fd72f222dbf7a0c96'],14,170,184,14817540,8,0,0,1,9968
6ddb4dba49a971843908f193916c7bc38660822a,1,Siddharth Wagle,2013-03-29 18:59:12+00:00,['81cabf88d0cca3e239639c1a31f57f2140ea9b45'],14,51,65,14817605,5,,,,9968
5e495c75d20c1ece1ad4b36f624fdbaddca93fd5,1,Sumit Mohanty,2013-03-31 06:06:08+00:00,['6ddb4dba49a971843908f193916c7bc38660822a'],42,291,333,14817938,24,0.239130435,0.557971014,1,9970
c52dbfc7512c1857004fe36e3bba1eb633b3e7aa,0,Yusaku Sako,2013-04-01 17:13:03+00:00,['5e495c75d20c1ece1ad4b36f624fdbaddca93fd5'],0,1,1,14817939,1,,,,9970
b335cd4c8cf0a0bc108ab19139c4da378ea10df2,1,Sumit Mohanty,2013-04-01 17:50:42+00:00,['c52dbfc7512c1857004fe36e3bba1eb633b3e7aa'],36,38,74,14818013,54,,,,9970
28ef6579b5a52057b65810992b0fceda20a67278,1,Sumit Mohanty,2013-04-01 18:00:39+00:00,['b335cd4c8cf0a0bc108ab19139c4da378ea10df2'],802,874,1676,14819689,7,0.030927835,0.443298969,0.587628866,9970
91e0fcc30cda8fe9b5e8559cd769ae58e4fcd36e,1,Sumit Mohanty,2013-04-01 18:14:04+00:00,['28ef6579b5a52057b65810992b0fceda20a67278'],0,4,4,14819693,2,,,,9970
b5fa1f35aa0b5cb9a8dc1597d866c4a099d0130e,0,Siddharth Wagle,2013-04-01 21:25:13+00:00,['91e0fcc30cda8fe9b5e8559cd769ae58e4fcd36e'],0,8,8,14819701,2,,,,9970
84b06faab25a20ae3d6005dc9a2dcea167ae8abf,1,Jaimin Jetly,2013-04-01 22:23:20+00:00,['b5fa1f35aa0b5cb9a8dc1597d866c4a099d0130e'],49,52,101,14819802,10,0,0.857142857,1,9970
70246536590002b0ed40c48bf6532689fd9081b7,0,Jaimin Jetly,2013-04-01 23:47:18+00:00,['84b06faab25a20ae3d6005dc9a2dcea167ae8abf'],0,4,4,14819806,2,0,1,1,9970
e5d7e08e42baea2ad15784400c6f9e7ebb5f1608,0,Jaimin Jetly,2013-04-02 00:12:42+00:00,['70246536590002b0ed40c48bf6532689fd9081b7'],1,3,4,14819810,2,,,,9970
a411f6b89b82b7170a36a0535112a47705cd0f9f,1,Tom Beerbower,2013-04-02 16:56:38+00:00,['e5d7e08e42baea2ad15784400c6f9e7ebb5f1608'],39,112,151,14819961,3,0,1,1,9970
1a8e06c2326966e6108101c31cf8b330fd8f24f4,0,Siddharth Wagle,2013-04-02 17:26:33+00:00,['a411f6b89b82b7170a36a0535112a47705cd0f9f'],78,89,167,14820128,6,,,,9971
233d0ee7e140d172dd4da4c8ff78bcfd57ff3905,0,Sumit Mohanty,2013-04-02 17:29:24+00:00,['1a8e06c2326966e6108101c31cf8b330fd8f24f4'],3,5,8,14820136,2,,,,9971
8598e0fce05f896c9304110fbc4e1ff1a4669fc7,0,Jaimin Jetly,2013-04-02 18:08:23+00:00,['233d0ee7e140d172dd4da4c8ff78bcfd57ff3905'],2,5,7,14820143,3,,,,9971
9541fd394d77acbdfb85f030340c12ebd5dd0e8d,0,Jaimin Jetly,2013-04-03 18:41:52+00:00,['8598e0fce05f896c9304110fbc4e1ff1a4669fc7'],2,5,7,14820150,3,,,,9971
8550a671c7a70a40374ed3c38c6e5f8db5293fcf,1,Sumit Mohanty,2013-04-03 22:35:41+00:00,['9541fd394d77acbdfb85f030340c12ebd5dd0e8d'],904,1765,2669,14822819,55,0.290640394,0.738916256,0.729064039,9975
666f5a83d74b8337cee24f505f5a0e7c05472d37,0,Sumit Mohanty,2013-04-03 22:37:38+00:00,['8550a671c7a70a40374ed3c38c6e5f8db5293fcf'],2,4,6,14822825,2,,,,9975
c363ee9a8b751e7825748eaf9e35f09a39c3fd35,1,Siddharth Wagle,2013-04-03 23:16:42+00:00,['666f5a83d74b8337cee24f505f5a0e7c05472d37'],44,354,398,14823223,3,0,0.7109375,0.7109375,9975
5387c210a76828f6519272a3b8d289dc8d850c28,1,Jaimin Jetly,2013-04-04 00:17:27+00:00,['c363ee9a8b751e7825748eaf9e35f09a39c3fd35'],10,20,30,14823253,4,1,1,1,9975
9d72065493db7f2137b9001d2fd4669cc7c73132,1,Sumit Mohanty,2013-04-04 16:49:24+00:00,['5387c210a76828f6519272a3b8d289dc8d850c28'],14,133,147,14823400,9,,,,9979
415a0ae6345901117e246c728c972a494b10a340,1,Sumit Mohanty,2013-04-04 16:56:59+00:00,['9d72065493db7f2137b9001d2fd4669cc7c73132'],55,70,125,14823525,5,1,1,0.625,9979
13368fd192060195ea7c77d6fba3fc2ec16bf8da,1,Sumit Mohanty,2013-04-04 17:08:19+00:00,['415a0ae6345901117e246c728c972a494b10a340'],0,3,3,14823528,2,,,,9979
89c0756712a94e453ce68e256e7743f20f8810a5,1,Tom Beerbower,2013-04-04 17:46:29+00:00,['13368fd192060195ea7c77d6fba3fc2ec16bf8da'],6,15,21,14823549,4,0,1,1,9979
28abc8397c5c6c062d6e87a5fac1858f6a90c1fb,0,Siddharth Wagle,2013-04-04 18:11:12+00:00,['89c0756712a94e453ce68e256e7743f20f8810a5'],1,3,4,14823553,2,,,,9979
70eb24044e4347902199ee0c629b546fb16d9817,1,Siddharth Wagle,2013-04-04 18:12:55+00:00,['28abc8397c5c6c062d6e87a5fac1858f6a90c1fb'],1,4,5,14823558,2,1,1,1,9979
61fab35135c9841cb47467b198eaf2592a446edf,1,Siddharth Wagle,2013-04-04 18:27:22+00:00,['70eb24044e4347902199ee0c629b546fb16d9817'],6,25,31,14823589,5,1,1,1,9979
dba3fee783d1475212195060eaeff3943ed020c0,1,Siddharth Wagle,2013-04-04 20:00:11+00:00,['61fab35135c9841cb47467b198eaf2592a446edf'],10,36,46,14823635,6,0,0.7,1,9979
3ee9956386f55c45ab333618569e254a13350dbd,1,Mahadev Konar,2013-04-05 01:54:13+00:00,['dba3fee783d1475212195060eaeff3943ed020c0'],2,621,623,14824258,11,1,1,1,9986
5db3355dd9289fd9a66dc227b9cf5089f5ebe0e3,0,Billie Rinaldi,2013-04-05 14:34:30+00:00,['3ee9956386f55c45ab333618569e254a13350dbd'],4,3058,3062,14827320,28,0.455917395,0.876092137,0.720413026,10007
fc1b81bc32f4010c26496502377467ec311a6803,0,Yusaku Sako,2013-04-05 16:55:04+00:00,['5db3355dd9289fd9a66dc227b9cf5089f5ebe0e3'],0,12,12,14827332,1,,,,10007
8230f8700f0e36d5b8426d949dde186f7981d4d7,1,Jaimin Jetly,2013-04-05 17:55:56+00:00,['fc1b81bc32f4010c26496502377467ec311a6803'],44,140,184,14827516,6,0,0,1,10007
3f726dc057cf9f4f28fd8102c63e1467317f6010,1,Siddharth Wagle,2013-04-05 18:34:30+00:00,['8230f8700f0e36d5b8426d949dde186f7981d4d7'],6,17,23,14827539,4,,,,10007
3647442840f8a638a377bf05826dbe03f187d7f4,0,Mahadev Konar,2013-04-05 19:00:50+00:00,['3f726dc057cf9f4f28fd8102c63e1467317f6010'],0,21,21,14827560,2,,,,10008
f3b04e413482616ae2b61f9dbe2b1b597e3c297a,0,Mahadev Konar,2013-04-05 19:48:16+00:00,['3647442840f8a638a377bf05826dbe03f187d7f4'],1,1,2,14827562,1,,,,10008
8a18cd17f10de43ef89d0fda71ebad3ecee7e48c,1,Siddharth Wagle,2013-04-05 21:48:40+00:00,['f3b04e413482616ae2b61f9dbe2b1b597e3c297a'],3,30,33,14827595,4,,,,10008
73075b5487b20a2a62dc60349c60fb10826fbb7b,1,Sumit Mohanty,2013-04-05 23:03:15+00:00,['8a18cd17f10de43ef89d0fda71ebad3ecee7e48c'],14,34,48,14827643,3,,,,10008
7c2790b5dde28e8971c931d67fdabb12770a5f8a,0,Siddharth Wagle,2013-04-05 23:46:08+00:00,['73075b5487b20a2a62dc60349c60fb10826fbb7b'],2,4,6,14827649,2,,,,10008
4caaa6bca1150acb2c3f60da0decd2fccf1d133e,1,Yusaku Sako,2013-04-06 01:55:42+00:00,['7c2790b5dde28e8971c931d67fdabb12770a5f8a'],3860,20248,24108,14851757,232,0.557362765,0.613999419,0.956142899,10117
8f2ce06b61d16c63dd8341bacf86bf1a7a72781a,1,Sumit Mohanty,2013-04-08 16:53:32+00:00,['4caaa6bca1150acb2c3f60da0decd2fccf1d133e'],108,384,492,14852249,14,0.123287671,0.787671233,0.767123288,10119
7374436e034cce4bb8f86454ec8846b564c682c4,1,Sumit Mohanty,2013-04-08 16:56:32+00:00,['8f2ce06b61d16c63dd8341bacf86bf1a7a72781a'],121,70,191,14852440,8,0.863636364,1,0.136363636,10119
3329c44045ecded15d0f9236bf4b632e0e78431b,0,Siddharth Wagle,2013-04-08 17:06:57+00:00,['7374436e034cce4bb8f86454ec8846b564c682c4'],2,4,6,14852446,2,,,,10119
13cb06dc83d363675eb997e55243bb5a200684a4,1,Jaimin Jetly,2013-04-08 19:09:29+00:00,['3329c44045ecded15d0f9236bf4b632e0e78431b'],87,102,189,14852635,8,1,1,1,10119
c78b4dae4c7c1a718263507434407a91484c3efb,1,Jaimin Jetly,2013-04-08 20:30:54+00:00,['13cb06dc83d363675eb997e55243bb5a200684a4'],71,7,78,14852713,3,0.23880597,0,0,10119
4442554385fd909d6c7752d81979b3b4e64e5dfc,1,Srimanth,2013-04-08 23:31:57+00:00,['c78b4dae4c7c1a718263507434407a91484c3efb'],22,2659,2681,14855394,7,0.326732673,0.326732673,0.574257426,10120
89ea6e0977f192a381c58056caa02112e9c281b1,1,Jaimin Jetly,2013-04-09 00:17:22+00:00,['4442554385fd909d6c7752d81979b3b4e64e5dfc'],40,44,84,14855478,3,0,0,1,10120
3f397cdc769be9962155456a021982d9254cd7f6,1,Srimanth,2013-04-09 00:21:50+00:00,['89ea6e0977f192a381c58056caa02112e9c281b1'],1,7,8,14855486,3,,,,10120
c54950323689a85d8723e978b74e2b8e88482948,1,Tom Beerbower,2013-04-09 14:57:05+00:00,['3f397cdc769be9962155456a021982d9254cd7f6'],65,158,223,14855709,6,0,0.470588235,0.882352941,10120
5f5832eb4c5d14406b5882723896a106a29aaa16,1,Tom Beerbower,2013-04-09 15:16:42+00:00,['c54950323689a85d8723e978b74e2b8e88482948'],5,11,16,14855725,4,0,1,0.5,10120
9e830adfbe5f8e1a733b6fd08ea60e9512cf40ee,0,Jaimin Jetly,2013-04-09 19:05:36+00:00,['5f5832eb4c5d14406b5882723896a106a29aaa16'],0,1,1,14855726,1,1,1,1,10120
245b5d988bd5f3dbbc677c9b69a1c3425929308c,1,Sumit Mohanty,2013-04-09 20:15:12+00:00,['9e830adfbe5f8e1a733b6fd08ea60e9512cf40ee'],0,225,225,14855951,3,0,1,1,10120
00d302869df8b50c6dbd031cf8985eab162f847c,1,Sumit Mohanty,2013-04-09 20:25:34+00:00,['245b5d988bd5f3dbbc677c9b69a1c3425929308c'],3,22,25,14855976,5,0.3,0.6,0.6,10120
ff96a4c758d819d379b5bd8c2424df777e6dae69,1,Srimanth,2013-04-09 20:37:39+00:00,['00d302869df8b50c6dbd031cf8985eab162f847c'],27,180,207,14856183,8,0.681318681,0.681318681,1,10120
dc62caac72f357f73ff6c1b46e86f044664ad51e,1,Srimanth,2013-04-09 20:56:26+00:00,['ff96a4c758d819d379b5bd8c2424df777e6dae69'],7,8,15,14856198,5,1,1,0,10120
a497b426d47a246d0740ebf3c21be5aa999fcc34,1,Srimanth,2013-04-09 21:02:20+00:00,['dc62caac72f357f73ff6c1b46e86f044664ad51e'],0,6,6,14856204,2,,,,10120
a4517a34840efc31f37ac68afe7fac6710778413,1,Srimanth,2013-04-09 21:59:21+00:00,['a497b426d47a246d0740ebf3c21be5aa999fcc34'],303,116,419,14856623,11,0.090909091,0,0.113636364,10122
7cc40a245c296a6ef2b0d0b9aa857fd2ea4afda1,1,Srimanth,2013-04-09 22:13:33+00:00,['a4517a34840efc31f37ac68afe7fac6710778413'],24,28,52,14856675,5,0,0,0,10122
d379779d40f44ed6d9203fa4cf226f7d8fbe705a,1,Srimanth,2013-04-09 22:24:54+00:00,['7cc40a245c296a6ef2b0d0b9aa857fd2ea4afda1'],1,4,5,14856680,2,,,,10122
6b8a497007990e79d16fa52574f55577d75b1cda,1,Srimanth,2013-04-09 22:39:26+00:00,['d379779d40f44ed6d9203fa4cf226f7d8fbe705a'],1,3,4,14856684,2,,,,10122
581a8e4a59727410d2ebd3adab1412f169cef943,1,Srimanth,2013-04-09 22:54:17+00:00,['6b8a497007990e79d16fa52574f55577d75b1cda'],27,42,69,14856753,4,0,0,1,10122
dc23dd2aae434269c5d385f60784dd25c1dba912,1,Srimanth,2013-04-09 22:58:22+00:00,['581a8e4a59727410d2ebd3adab1412f169cef943'],20,65,85,14856838,4,0.941176471,1,1,10122
d63d57e3fce9c20d857433f5e2b2471a6067b4de,1,Srimanth,2013-04-09 23:32:04+00:00,['dc23dd2aae434269c5d385f60784dd25c1dba912'],66,65,131,14856969,3,0,0,0.333333333,10122
8b674ee07a65cf686038752157540eede91e862f,1,Srimanth,2013-04-09 23:49:08+00:00,['d63d57e3fce9c20d857433f5e2b2471a6067b4de'],5274,2874,8148,14865117,19,0,1,0.8,10122
b1b15007d8450c8306591cce4fa942301713a032,1,Sumit Mohanty,2013-04-09 23:56:33+00:00,['8b674ee07a65cf686038752157540eede91e862f'],5,12,17,14865134,6,0,0,0,10122
e9998bee05988e748340bfa4e16a2e1076c3ad73,1,Tom Beerbower,2013-04-10 13:19:09+00:00,['b1b15007d8450c8306591cce4fa942301713a032'],12,1067,1079,14866213,7,0.173913043,1,1,10124
712c0b359d1d818dcfd83d90d42801c2818ab3b9,0,Yusaku Sako,2013-04-10 16:59:06+00:00,['e9998bee05988e748340bfa4e16a2e1076c3ad73'],2,3,5,14866218,2,,,,10124
c1769273df7c6ee3d85304197474b82b26d5c642,1,Siddharth Wagle,2013-04-10 23:04:32+00:00,['712c0b359d1d818dcfd83d90d42801c2818ab3b9'],12,117,129,14866347,10,0.554054054,1,0.972972973,10124
d2cfe191589462b189990978d7352c4c127022ed,1,Siddharth Wagle,2013-04-10 23:06:05+00:00,['c1769273df7c6ee3d85304197474b82b26d5c642'],0,7,7,14866354,2,0,0.2,0.8,10124
e84cb80c05e814288ed90aff62e87f9524345357,1,Siddharth Wagle,2013-04-10 23:22:20+00:00,['d2cfe191589462b189990978d7352c4c127022ed'],0,49,49,14866403,1,0,1,1,10124
c49f57dc8814c929884fca8a95a70ab65b95e5c0,1,Siddharth Wagle,2013-04-10 23:48:05+00:00,['e84cb80c05e814288ed90aff62e87f9524345357'],2,3,5,14866408,2,,,,10124
e20342d68644bda6f128054c33017be8e6c27240,0,Jaimin Jetly,2013-04-11 01:33:37+00:00,['c49f57dc8814c929884fca8a95a70ab65b95e5c0'],1,4,5,14866413,2,,,,10124
63a327e877f21f1b8671284947a48fa54afedd9b,1,Nate Cole,2013-04-11 13:41:34+00:00,['e20342d68644bda6f128054c33017be8e6c27240'],0,7,7,14866420,2,,,,10124
c9b4dca3db6080bceb3fe23d51fdada01cc442eb,1,Yusaku Sako,2013-04-11 18:03:56+00:00,['63a327e877f21f1b8671284947a48fa54afedd9b'],7,15,22,14866442,2,0,1,1,10124
f7a423576f772744dc544f1795285ba1fb2407f1,1,Yusaku Sako,2013-04-11 18:06:54+00:00,['c9b4dca3db6080bceb3fe23d51fdada01cc442eb'],1,3,4,14866446,2,,,,10124
cd5a862819b6d1fc49a2246f8c4aa315cbadd162,1,Yusaku Sako,2013-04-11 18:09:14+00:00,['f7a423576f772744dc544f1795285ba1fb2407f1'],31,90,121,14866567,5,0.862068966,0.862068966,1,10124
1b841698b86f18bee9fd1dabe5e268779cd99d71,1,Yusaku Sako,2013-04-11 18:11:04+00:00,['cd5a862819b6d1fc49a2246f8c4aa315cbadd162'],442,456,898,14867465,5,1,1,1,10124
b2ce0fd89986808891f61b972606bb2cdfc22656,1,Yusaku Sako,2013-04-11 18:12:53+00:00,['1b841698b86f18bee9fd1dabe5e268779cd99d71'],2,8,10,14867475,3,0.5,0.5,1,10124
f525b88a84181b0cd6798dd07a867afac62c86c6,1,Yusaku Sako,2013-04-11 18:14:20+00:00,['b2ce0fd89986808891f61b972606bb2cdfc22656'],9,17,26,14867501,3,1,1,0,10124
9cbbcb758c680a9741ec7e1b48c082651e8579bb,0,Yusaku Sako,2013-04-11 18:18:12+00:00,['f525b88a84181b0cd6798dd07a867afac62c86c6'],3,5,8,14867509,2,,,,10124
344f066487bea5fbdcb3f77f2361c09997c02a87,0,Yusaku Sako,2013-04-11 18:19:42+00:00,['9cbbcb758c680a9741ec7e1b48c082651e8579bb'],2,5,7,14867516,3,,,,10124
e56744fbb98472d5bb9cae765cae6494e0378ecb,0,Srimanth,2013-04-11 19:43:43+00:00,['344f066487bea5fbdcb3f77f2361c09997c02a87'],0,4,4,14867520,2,,,,10124
3a8b91cecfeb1e70a9f9476078bf2f8f9e10c98c,0,Srimanth,2013-04-11 20:57:29+00:00,['e56744fbb98472d5bb9cae765cae6494e0378ecb'],3,32,35,14867555,6,1,0.428571429,1,10124
178da669f80624180b2f25a856b413c2d39353ea,1,Srimanth,2013-04-11 21:01:25+00:00,['3a8b91cecfeb1e70a9f9476078bf2f8f9e10c98c'],53,68,121,14867676,4,1,0,1,10124
1e0cf650d74ee859c73a6c92dd708ec767aed05f,1,Srimanth,2013-04-11 21:05:32+00:00,['178da669f80624180b2f25a856b413c2d39353ea'],1132,1488,2620,14870296,51,0.316455696,0.905063291,0.882911392,10124
485ca56d2733aa1c95100a2cd1b66dbe27bdce25,0,Srimanth,2013-04-11 21:08:00+00:00,['1e0cf650d74ee859c73a6c92dd708ec767aed05f'],9,18,27,14870323,6,0,0,0,10124
ca2e394398df90b7b1c2569cac6be2661303014e,1,Srimanth,2013-04-11 21:10:12+00:00,['485ca56d2733aa1c95100a2cd1b66dbe27bdce25'],47,142,189,14870512,3,0.225,1,0.15,10124
c169058c426418b3ab77fb65645702b8f252347c,1,Sumit Mohanty,2013-04-11 22:22:06+00:00,['ca2e394398df90b7b1c2569cac6be2661303014e'],10,3928,3938,14874450,46,,,,10159
4ab244b52e9e7d4fc6b1e23aa937bbcfb4aa6f3b,1,Siddharth Wagle,2013-04-11 22:31:29+00:00,['c169058c426418b3ab77fb65645702b8f252347c'],11,42,53,14874503,3,0.125,1,0,10159
7d855fa3639dea523871717eed0d57448b1e14e6,1,Sumit Mohanty,2013-04-11 22:54:50+00:00,['4ab244b52e9e7d4fc6b1e23aa937bbcfb4aa6f3b'],0,142,142,14874645,3,0.08,0.08,0.91,10159
7bda36bcc547d21d524bd119d3161bcda80d2599,1,Jaimin Jetly,2013-04-11 23:01:07+00:00,['7d855fa3639dea523871717eed0d57448b1e14e6'],159,225,384,14875029,12,1,1,1,10159
a32f1465b3359f017b67dc7fc0a6f0206a8cc331,1,Mahadev Konar,2013-04-11 23:28:06+00:00,['7bda36bcc547d21d524bd119d3161bcda80d2599'],12,1141,1153,14876182,13,0,0,1,10165
50a1e5a64185dc20d68eff0ffad157d6555d188e,0,Mahadev Konar,2013-04-11 23:30:10+00:00,['a32f1465b3359f017b67dc7fc0a6f0206a8cc331'],405,0,405,14876587,1,,,,10165
246242b6615347e700b7f3baef6199cd92b917d6,1,Srimanth,2013-04-12 00:24:07+00:00,['50a1e5a64185dc20d68eff0ffad157d6555d188e'],7,35,42,14876629,4,0.5,0.5,1,10165
56b684f72b467120ff92dec5c97620a3f23ebc16,0,Jaimin Jetly,2013-04-12 00:57:31+00:00,['246242b6615347e700b7f3baef6199cd92b917d6'],3,4,7,14876636,4,,,,10165
34b7929db75bd2ceabf2d6a8438e60a25190cf1d,1,Tom Beerbower,2013-04-12 16:46:58+00:00,['56b684f72b467120ff92dec5c97620a3f23ebc16'],135,62,197,14876833,7,0.925925926,0,0.740740741,10165
0a3c718e144a68c40739770e0c155262e0764a19,1,Jaimin Jetly,2013-04-12 17:18:22+00:00,['34b7929db75bd2ceabf2d6a8438e60a25190cf1d'],0,19,19,14876852,4,0,0,1,10165
9718cb2a8f50aa2ee7881105147061b6d380a78a,0,Jaimin Jetly,2013-04-12 17:54:05+00:00,['0a3c718e144a68c40739770e0c155262e0764a19'],3,6,9,14876861,3,,,,10165
8abf7a4368f8e64f38ec3366b6cc870ab7f4059d,0,Siddharth Wagle,2013-04-12 18:43:20+00:00,['9718cb2a8f50aa2ee7881105147061b6d380a78a'],2,57,59,14876920,8,,,,10166
18d9fee53a22f68a7227916ae7fd0e0c039a983d,1,Nate Cole,2013-04-12 18:45:29+00:00,['8abf7a4368f8e64f38ec3366b6cc870ab7f4059d'],0,234,234,14877154,3,,,,10167
5bf4da071cc0ab3336c706e167e897d97d702878,1,Jaimin Jetly,2013-04-12 21:26:32+00:00,['18d9fee53a22f68a7227916ae7fd0e0c039a983d'],8,11,19,14877173,9,,,,10167
7a78c918a02f184263844d63ff97cfd1c64de539,1,Jaimin Jetly,2013-04-12 21:50:34+00:00,['5bf4da071cc0ab3336c706e167e897d97d702878'],5,11,16,14877189,5,0,0,1,10167
88c72afc9cd03b7184899db83427ecc095f96923,1,Jaimin Jetly,2013-04-12 22:38:36+00:00,['7a78c918a02f184263844d63ff97cfd1c64de539'],2,7,9,14877198,2,1,1,1,10167
80c838420c6db17f6ebde2379b3b2336f54f666b,1,Srimanth,2013-04-13 00:18:49+00:00,['88c72afc9cd03b7184899db83427ecc095f96923'],1,11,12,14877210,3,0.5,0,0.666666667,10167
1e882c739e280dce2f36fb3539bcdc22b4e83291,1,Siddharth Wagle,2013-04-13 00:41:02+00:00,['80c838420c6db17f6ebde2379b3b2336f54f666b'],64,176,240,14877450,10,0,0.863013699,0,10167
eac4d558313ed34b1752bdf056f3ffa6ec70184b,1,Siddharth Wagle,2013-04-13 00:46:21+00:00,['1e882c739e280dce2f36fb3539bcdc22b4e83291'],41,442,483,14877933,6,0.232484076,0.926751592,0.945859873,10167
7a0bce006862126c873a9cf0e5eb5ce1dc7a94a2,1,Siddharth Wagle,2013-04-13 00:49:59+00:00,['eac4d558313ed34b1752bdf056f3ffa6ec70184b'],17,204,221,14878154,7,,,,10168
f7a420bc1b1f2f4dedb17ede1fb2994099b488fa,0,Siddharth Wagle,2013-04-13 00:52:54+00:00,['7a0bce006862126c873a9cf0e5eb5ce1dc7a94a2'],0,16,16,14878170,3,,,,10168
09205679017c226adafe4144eb468d22b0c5ed71,0,Sumit Mohanty,2013-04-13 04:26:43+00:00,['f7a420bc1b1f2f4dedb17ede1fb2994099b488fa'],17,16,33,14878203,7,,,,10168
7a917c6471b8dd952bcf70be68e2600881a3a61b,1,Sumit Mohanty,2013-04-13 04:31:57+00:00,['09205679017c226adafe4144eb468d22b0c5ed71'],56,269,325,14878528,3,0.557251908,0.946564885,1,10168
5ba7a68387cd6b84442aaa379fffbc471e0c4705,1,Sumit Mohanty,2013-04-13 04:34:44+00:00,['7a917c6471b8dd952bcf70be68e2600881a3a61b'],2,5,7,14878535,3,,,,10168
36e179e4e6cc114621e6177de1d5faa860805d43,1,Sumit Mohanty,2013-04-13 04:39:34+00:00,['5ba7a68387cd6b84442aaa379fffbc471e0c4705'],6,78,84,14878619,4,0,1,1,10168
61ad106b0e5a1306e5772e660cdd29e718c053f8,0,Mahadev Konar,2013-04-15 06:23:02+00:00,['36e179e4e6cc114621e6177de1d5faa860805d43'],1,10,11,14878630,2,,,,10168
0b797ab10f209f92a7a0b749ea43a91074a2ed07,0,Mahadev Konar,2013-04-15 06:26:23+00:00,['61ad106b0e5a1306e5772e660cdd29e718c053f8'],0,4,4,14878634,2,,,,10168
58dabba136a3b8598e807b0d539c4cf60edd2202,1,Mahadev Konar,2013-04-15 07:23:10+00:00,['0b797ab10f209f92a7a0b749ea43a91074a2ed07'],0,1408,1408,14880042,17,0.600502513,0.650753769,0.56281407,10184
4b51d9a61177258483f88c6a531b10d340657683,0,Sumit Mohanty,2013-04-15 17:17:11+00:00,['58dabba136a3b8598e807b0d539c4cf60edd2202'],7,37,44,14880086,3,0,0,1,10184
4b386d755b2fd3c34fa8acf77a73584ccec67743,0,Sumit Mohanty,2013-04-15 17:18:33+00:00,['4b51d9a61177258483f88c6a531b10d340657683'],1,3,4,14880090,2,,,,10184
6a50ecb027017b082cc1641edfa2165553550f70,1,Sumit Mohanty,2013-04-15 17:20:25+00:00,['4b386d755b2fd3c34fa8acf77a73584ccec67743'],1,75,76,14880166,4,,,,10185
64d7b50d1c1948a891263bb88ddbf5db0bd0cb17,1,Siddharth Wagle,2013-04-15 17:58:50+00:00,['6a50ecb027017b082cc1641edfa2165553550f70'],38,320,358,14880524,10,0.173228346,1,0.354330709,10186
8d93a4c346f9579d68150536e6f4e6141286b917,1,Jaimin Jetly,2013-04-15 20:23:35+00:00,['64d7b50d1c1948a891263bb88ddbf5db0bd0cb17'],303,758,1061,14881585,3,,,,10186
b173415a51d1d65428cbd092abbfd904e47f2c52,0,Jaimin Jetly,2013-04-15 22:12:33+00:00,['8d93a4c346f9579d68150536e6f4e6141286b917'],0,16,16,14881601,2,,,,10187
3e6b6d80f14a795e7cee196d93272086996df6a1,0,Siddharth Wagle,2013-04-15 22:14:17+00:00,['b173415a51d1d65428cbd092abbfd904e47f2c52'],0,5,5,14881606,2,,,,10187
2584cd00580209c23ade8e0cb9b517fdddbdb491,0,Jaimin Jetly,2013-04-15 22:21:44+00:00,['3e6b6d80f14a795e7cee196d93272086996df6a1'],2,4,6,14881612,2,,,,10187
bdf330542542c8e60089a7b5ed09301df13af577,1,Jaimin Jetly,2013-04-15 22:25:13+00:00,['2584cd00580209c23ade8e0cb9b517fdddbdb491'],5,7,12,14881624,2,,,,10187
0171dea7473affa82cf8439d6c9eb630bc0e51f1,1,Jaimin Jetly,2013-04-15 22:36:44+00:00,['bdf330542542c8e60089a7b5ed09301df13af577'],44,94,138,14881762,10,0.866666667,0.866666667,1,10187
835a068842ad1a12adfe0a84844e5efb413ae693,1,Jaimin Jetly,2013-04-15 22:41:00+00:00,['0171dea7473affa82cf8439d6c9eb630bc0e51f1'],2,5,7,14881769,2,,,,10187
61cd9b37d08f465d97df7e05fd01b48ed33dad0f,1,Jaimin Jetly,2013-04-15 23:05:41+00:00,['835a068842ad1a12adfe0a84844e5efb413ae693'],2,16,18,14881787,2,0.25,0,1,10187
d4ec0f7756b2f7d6330bf9aec537c1a0915ef1dc,1,Jaimin Jetly,2013-04-15 23:10:36+00:00,['61cd9b37d08f465d97df7e05fd01b48ed33dad0f'],10,26,36,14881823,4,,,,10188
7f8a9fc561641597cd167d9210772d429e8e03fb,1,Jaimin Jetly,2013-04-15 23:15:33+00:00,['d4ec0f7756b2f7d6330bf9aec537c1a0915ef1dc'],5,15,20,14881843,4,,,,10188
58d1aa58a162c243d3f61a040ad77442490d1e76,1,Jaimin Jetly,2013-04-15 23:20:22+00:00,['7f8a9fc561641597cd167d9210772d429e8e03fb'],10,34,44,14881887,8,1,1,1,10188
f323dd1bc9c5872815bff0d21de51aff929a25c9,1,Jaimin Jetly,2013-04-15 23:32:03+00:00,['58d1aa58a162c243d3f61a040ad77442490d1e76'],516,56,572,14882459,7,0.93877551,0.959183673,0,10188
9d893201c7e19e7a04d569720d08133efdf368f5,1,Jaimin Jetly,2013-04-16 00:25:10+00:00,['f323dd1bc9c5872815bff0d21de51aff929a25c9'],2,5,7,14882466,3,,,,10188
474a9d1f656b3a75a3b08a2d02098a359c1209ca,1,Srimanth,2013-04-16 00:38:29+00:00,['9d893201c7e19e7a04d569720d08133efdf368f5'],50,89,139,14882605,7,1,1,1,10188
37c6762e1b7027c175da20a87308f01b595fe54d,0,Yusaku Sako,2013-04-16 01:40:37+00:00,['474a9d1f656b3a75a3b08a2d02098a359c1209ca'],24,11,35,14882640,4,,,,10188
1f0d9c38d8bb8407e87852c6db4751bdc326afb7,1,Yusaku Sako,2013-04-16 02:45:25+00:00,['37c6762e1b7027c175da20a87308f01b595fe54d'],286,904,1190,14883830,16,0.344537815,0.87394958,0.966386555,10189
a6bec1ee66d269aab3b9c2eba1c886619d024c6a,1,Siddharth Wagle,2013-04-16 05:09:16+00:00,['1f0d9c38d8bb8407e87852c6db4751bdc326afb7'],101,163,264,14884094,3,0,1,0.888888889,10189
b5ff7321114af372dddfe55c171fd116da5cccbd,0,Yusaku Sako,2013-04-16 20:00:15+00:00,['a6bec1ee66d269aab3b9c2eba1c886619d024c6a'],1,4,5,14884099,2,,,,10189
b8d77c647044ca2a108bd841484900ef29ea0c2d,1,Siddharth Wagle,2013-04-16 21:07:09+00:00,['b5ff7321114af372dddfe55c171fd116da5cccbd'],1,6,7,14884106,2,,,,10189
f2280e358c69132c4449a0f0e6a021883fb61e9c,1,Siddharth Wagle,2013-04-16 22:34:27+00:00,['b8d77c647044ca2a108bd841484900ef29ea0c2d'],1,15,16,14884122,2,,,,10189
c1c40146679780bf3432d300ae2b0c062117a1d1,0,Siddharth Wagle,2013-04-16 22:35:03+00:00,['f2280e358c69132c4449a0f0e6a021883fb61e9c'],0,132,132,14884254,1,,,,10190
143268eb65a437d61e478ed99c66a9379e8234f6,1,Srimanth,2013-04-17 02:15:18+00:00,['c1c40146679780bf3432d300ae2b0c062117a1d1'],1,4,5,14884259,2,,,,10190
d03cf6863d32cfe36bdab48de656429eda5d6b16,0,Sumit Mohanty,2013-04-17 18:48:22+00:00,['143268eb65a437d61e478ed99c66a9379e8234f6'],1,21,22,14884281,2,,,,10190
b64a4a8a0fb4ffeb8b2bc18f95f66fb7a0315446,1,Sumit Mohanty,2013-04-17 18:57:55+00:00,['d03cf6863d32cfe36bdab48de656429eda5d6b16'],136,479,615,14884896,8,0.211538462,0.798076923,0,10191
858a80f3e74499d205a6ca9e1df27d3ced6bb71d,1,Yusaku Sako,2013-04-18 01:37:08+00:00,['b64a4a8a0fb4ffeb8b2bc18f95f66fb7a0315446'],4,9,13,14884909,4,,,,10191
ec9bf2bd3af986511ca9ff63f2d2bcc51944619d,1,Yusaku Sako,2013-04-18 01:39:47+00:00,['858a80f3e74499d205a6ca9e1df27d3ced6bb71d'],1,16,17,14884926,3,1,1,1,10191
86516018c4ca664026504599a359e69211ff6e78,1,Yusaku Sako,2013-04-18 01:42:54+00:00,['ec9bf2bd3af986511ca9ff63f2d2bcc51944619d'],14,47,61,14884987,4,0.058823529,1,1,10191
5e76038a89b4166accd863a6ff62bac26f3eb978,0,Yusaku Sako,2013-04-18 01:44:01+00:00,['86516018c4ca664026504599a359e69211ff6e78'],1,3,4,14884991,2,,,,10191
88573cbd4a649f4b501bf69857f6ba16d42805b8,1,Yusaku Sako,2013-04-18 01:46:02+00:00,['5e76038a89b4166accd863a6ff62bac26f3eb978'],16,47,63,14885054,3,0.96,1,1,10191
77d872fa434cb9d31cb24567d947e6caf8475006,1,Yusaku Sako,2013-04-18 04:42:28+00:00,['88573cbd4a649f4b501bf69857f6ba16d42805b8'],10,14,24,14885078,5,1,1,1,10191
a628e2c7b03d3dd99a220cb37607b1f235f15bf9,1,Yusaku Sako,2013-04-18 04:43:48+00:00,['77d872fa434cb9d31cb24567d947e6caf8475006'],2,19,21,14885099,4,0,1,1,10191
c4b4be501d86a70117cf13cce7194843fcb4c853,1,Yusaku Sako,2013-04-18 04:46:27+00:00,['a628e2c7b03d3dd99a220cb37607b1f235f15bf9'],3,5,8,14885107,2,0,0,0,10191
63358d0807673e3fcaa8c63545e7c60cee146e59,0,Yusaku Sako,2013-04-18 04:47:50+00:00,['c4b4be501d86a70117cf13cce7194843fcb4c853'],4,7,11,14885118,2,,,0,10191
2839d91d48ba1229da915691970a205bed45850f,1,Yusaku Sako,2013-04-18 04:49:29+00:00,['63358d0807673e3fcaa8c63545e7c60cee146e59'],1,5,6,14885124,3,,,,10191
8cda9eed467b35bc0cc3c3d797e9b09580714ef0,1,Yusaku Sako,2013-04-18 04:50:46+00:00,['2839d91d48ba1229da915691970a205bed45850f'],4,11,15,14885139,3,0,0,1,10191
b047a179320c51c8dd10b36050b4e273e7470711,1,Yusaku Sako,2013-04-18 04:52:13+00:00,['8cda9eed467b35bc0cc3c3d797e9b09580714ef0'],1,5,6,14885145,2,,,,10191
482979b0f9579466c7eb3d1cdc3b21aa971db922,1,Yusaku Sako,2013-04-18 04:53:41+00:00,['b047a179320c51c8dd10b36050b4e273e7470711'],12,15,27,14885172,4,,,,10191
243173a338f0dbd805ca75daeaa93b9c276810a5,1,Yusaku Sako,2013-04-18 04:54:43+00:00,['482979b0f9579466c7eb3d1cdc3b21aa971db922'],19,25,44,14885216,2,0,0,1,10191
cb27f464737f5e6550a8f40fb517283eebf52636,0,Yusaku Sako,2013-04-18 04:57:44+00:00,['243173a338f0dbd805ca75daeaa93b9c276810a5'],2,6,8,14885224,3,,,,10191
c4585b001d4922ea614ef9d71a565576017c3489,1,Yusaku Sako,2013-04-18 06:13:16+00:00,['cb27f464737f5e6550a8f40fb517283eebf52636'],0,8,8,14885232,2,,,,10191
21db3a128def2f36a634dc922f96073e06d1d07d,1,Yusaku Sako,2013-04-18 06:13:36+00:00,['c4585b001d4922ea614ef9d71a565576017c3489'],0,10,10,14885242,1,,,,10192
d2493765fe38ef4efeba89d73e6f4d6a7d22e778,1,Nate Cole,2013-04-18 14:46:55+00:00,['21db3a128def2f36a634dc922f96073e06d1d07d'],0,12,12,14885254,2,,,,10192
dc1039911a2d348ffd20baa1cd583c68c236eccb,1,Sumit Mohanty,2013-04-18 17:10:57+00:00,['d2493765fe38ef4efeba89d73e6f4d6a7d22e778'],20,183,203,14885457,7,0.434782609,0.782608696,0.84057971,10193
9638cfa0d04b4a5828c431f257460565e78f383a,1,Sumit Mohanty,2013-04-18 17:21:25+00:00,['dc1039911a2d348ffd20baa1cd583c68c236eccb'],51,122,173,14885630,9,1,1,0.653846154,10194
5970236c6d28fb9f046e34b0e84854529d907ac1,1,Sumit Mohanty,2013-04-18 17:25:29+00:00,['9638cfa0d04b4a5828c431f257460565e78f383a'],1,5,6,14885636,2,,,,10194
a1f4bb42d88e7163914caf95a688b626d6e61151,1,Sumit Mohanty,2013-04-18 17:28:21+00:00,['5970236c6d28fb9f046e34b0e84854529d907ac1'],0,8,8,14885644,2,0,1,1,10194
4073f0a2aa964405d724fd6dafcbdd5176e8bae6,1,Siddharth Wagle,2013-04-18 17:49:30+00:00,['a1f4bb42d88e7163914caf95a688b626d6e61151'],19,29,48,14885692,3,1,1,1,10194
c593c8bcb06a389960c70e20b7779327afec5bbf,1,Siddharth Wagle,2013-04-18 18:32:21+00:00,['4073f0a2aa964405d724fd6dafcbdd5176e8bae6'],0,4250,4250,14889942,37,,,,10230
a608f2ff61aef4e7bf1d54726dbda84d3f0e42de,1,Siddharth Wagle,2013-04-18 20:21:25+00:00,['c593c8bcb06a389960c70e20b7779327afec5bbf'],5,34,39,14889981,5,0,0.888888889,1,10230
8414fea10e18fb4caab014485b687b5ae1b98cd7,1,Siddharth Wagle,2013-04-18 20:24:42+00:00,['a608f2ff61aef4e7bf1d54726dbda84d3f0e42de'],243,643,886,14890867,16,,,,10236
e652f76da9d9eef53f1ff9a0a669570849d5ad4f,1,Siddharth Wagle,2013-04-18 22:02:19+00:00,['8414fea10e18fb4caab014485b687b5ae1b98cd7'],18,30,48,14890915,3,,,,10236
162e54950e49fee89c591911b58ce3fd6cc40624,1,Siddharth Wagle,2013-04-18 22:23:31+00:00,['e652f76da9d9eef53f1ff9a0a669570849d5ad4f'],9,12,21,14890936,10,,,,10236
de01e2b86aa69d1ff2174f34ddc51502a4e893de,1,Nate Cole,2013-04-18 22:37:55+00:00,['162e54950e49fee89c591911b58ce3fd6cc40624'],8,35,43,14890979,3,1,1,0.222222222,10236
2c43520b086fd798c0aafcf5abfa3d1c79ff4220,1,Yusaku Sako,2013-04-18 23:37:06+00:00,['de01e2b86aa69d1ff2174f34ddc51502a4e893de'],7,24,31,14891010,5,1,1,1,10236
a0248b78aced20b766b1c94fd4cc8a7da10fae40,1,Yusaku Sako,2013-04-18 23:38:43+00:00,['2c43520b086fd798c0aafcf5abfa3d1c79ff4220'],7,6,13,14891023,2,1,1,0,10236
1a98388f30b17638404a17a8a493075f1dad516b,1,Yusaku Sako,2013-04-18 23:39:55+00:00,['a0248b78aced20b766b1c94fd4cc8a7da10fae40'],5,173,178,14891201,6,0.564102564,0.965811966,1,10238
2a462634c19b59bf80ecf9b8309fad6c1e48482f,1,Yusaku Sako,2013-04-18 23:41:01+00:00,['1a98388f30b17638404a17a8a493075f1dad516b'],7,10,17,14891218,3,1,1,1,10238
b161772dfe7c70523efd25bd77f9c750dedbabf5,0,Yusaku Sako,2013-04-18 23:42:23+00:00,['2a462634c19b59bf80ecf9b8309fad6c1e48482f'],1,4,5,14891223,2,,,,10238
355c52d93de90142bd52455bb3fabea91c055e65,1,Yusaku Sako,2013-04-18 23:44:01+00:00,['b161772dfe7c70523efd25bd77f9c750dedbabf5'],28,34,62,14891285,4,0,1,1,10238
aeaaeba0c565203d33c2713df2cef7308eaa41b8,0,Yusaku Sako,2013-04-18 23:45:23+00:00,['355c52d93de90142bd52455bb3fabea91c055e65'],2,5,7,14891292,2,,,,10238
9586b4569f98a45c8452b40230057db55a09025d,0,Yusaku Sako,2013-04-18 23:46:23+00:00,['aeaaeba0c565203d33c2713df2cef7308eaa41b8'],0,5,5,14891297,2,,,,10238
04e73cc4bf81ecb6f5b7809a14522d268b1d89cb,1,Sumit Mohanty,2013-04-19 16:21:56+00:00,['9586b4569f98a45c8452b40230057db55a09025d'],982,53,1035,14892332,35,0.612068966,0.364942529,0.255747126,10238
17fdf940c96e8ccc490e6fa249e7393a594344fc,0,Sumit Mohanty,2013-04-19 16:25:04+00:00,['04e73cc4bf81ecb6f5b7809a14522d268b1d89cb'],5,4,9,14892341,2,0,0,0,10238
6fff26c6e93670b55d918fae60198445aa4150e1,0,Siddharth Wagle,2013-04-19 23:07:59+00:00,['17fdf940c96e8ccc490e6fa249e7393a594344fc'],1,4,5,14892346,2,,,,10238
925d019592e659aa948c2c7ddb49d315d0c487f5,1,Siddharth Wagle,2013-04-19 23:09:52+00:00,['6fff26c6e93670b55d918fae60198445aa4150e1'],116,139,255,14892601,11,,,,10238
06527319f15335218ce07aecfc8062ac562c8788,1,Nate Cole,2013-04-22 13:44:54+00:00,['925d019592e659aa948c2c7ddb49d315d0c487f5'],13,167,180,14892781,5,0,0,0.990654206,10238
6fd93679a6ec213d934971927f0a81e628951c74,1,Nate Cole,2013-04-22 20:27:22+00:00,['06527319f15335218ce07aecfc8062ac562c8788'],4,110,114,14892895,3,0,0.871794872,0.871794872,10238
464aba0be8546ae044b630f5d0d0be52aa078b8d,0,Tom Beerbower,2013-04-23 19:26:39+00:00,['6fd93679a6ec213d934971927f0a81e628951c74'],31,25,56,14892951,2,1,0.111111111,0,10238
6057521d72853314ada2e93217239664701872ed,1,Sumit Mohanty,2013-04-23 21:21:11+00:00,['464aba0be8546ae044b630f5d0d0be52aa078b8d'],3,37,40,14892991,7,0,1,0.130434783,10238
a3c2536bcce79d5e9172e97f26c31a508be166fc,0,Sumit Mohanty,2013-04-23 22:46:52+00:00,['6057521d72853314ada2e93217239664701872ed'],9,17,26,14893017,3,0,0.428571429,1,10238
50185d90b582d64fc56cd773aeed0c183f5c138d,1,Sumit Mohanty,2013-04-23 22:55:46+00:00,['a3c2536bcce79d5e9172e97f26c31a508be166fc'],3,6,9,14893026,2,,,,10238
35519853d2b4b9a7f476ebc8b9cbd81624c7d327,1,Sumit Mohanty,2013-04-23 23:01:03+00:00,['50185d90b582d64fc56cd773aeed0c183f5c138d'],16,94,110,14893136,3,0,1,0.590163934,10238
391497388caf75893e59771310988d78738d910d,1,Sumit Mohanty,2013-04-23 23:08:39+00:00,['35519853d2b4b9a7f476ebc8b9cbd81624c7d327'],14,15,29,14893165,3,,,,10238
61e6091dc2423f3a1cb0eaee1586e7c3a942781c,1,Yusaku Sako,2013-04-23 23:10:21+00:00,['391497388caf75893e59771310988d78738d910d'],9,6,15,14893180,2,0,0,0,10238
63315c84a1c26b4373382ddb6ae652f1a0119f30,1,Yusaku Sako,2013-04-23 23:11:24+00:00,['61e6091dc2423f3a1cb0eaee1586e7c3a942781c'],109,105,214,14893394,2,,,,10238
484a0e9b1eca9ceb4d2c859bbdc28969623a5893,1,Yusaku Sako,2013-04-23 23:12:18+00:00,['63315c84a1c26b4373382ddb6ae652f1a0119f30'],1,4,5,14893399,2,,,,10238
7d7be39e2ee2ec8718ee11ee3efbc7538407b15e,1,Yusaku Sako,2013-04-23 23:13:43+00:00,['484a0e9b1eca9ceb4d2c859bbdc28969623a5893'],1,4,5,14893404,2,,,,10238
f3017536e4d0bec52b779a0f4add5488b11d7b44,0,Yusaku Sako,2013-04-23 23:14:35+00:00,['7d7be39e2ee2ec8718ee11ee3efbc7538407b15e'],1,4,5,14893409,2,,,,10238
9969332fb376b7dbe0efe4df937606992670ff57,0,Yusaku Sako,2013-04-23 23:15:47+00:00,['f3017536e4d0bec52b779a0f4add5488b11d7b44'],26,3,29,14893438,7,0,0,0,10238
8ed3fda69311932647848c221b36e0d2aec0cc16,1,Yusaku Sako,2013-04-23 23:16:53+00:00,['9969332fb376b7dbe0efe4df937606992670ff57'],1,4,5,14893443,2,,,,10238
93d13e68d8a521130bb06652311846deac87d245,1,Yusaku Sako,2013-04-23 23:17:42+00:00,['8ed3fda69311932647848c221b36e0d2aec0cc16'],12,12,24,14893467,4,,,,10238
20c909ab707683df96f04c96bc24c9453af586be,1,Yusaku Sako,2013-04-23 23:19:03+00:00,['93d13e68d8a521130bb06652311846deac87d245'],44,61,105,14893572,3,0,0,0,10238
99f49ae9aebab65190818de87f8e55e1294a30d7,1,Nate Cole,2013-04-24 15:42:49+00:00,['20c909ab707683df96f04c96bc24c9453af586be'],229,259,488,14894060,12,,,,10238
14f34bd20d67bd5b69f10bf3836fe2368b2d56f3,0,Nate Cole,2013-04-24 16:35:43+00:00,['99f49ae9aebab65190818de87f8e55e1294a30d7'],0,11,11,14894071,3,0.166666667,0.833333333,1,10238
42cb50e2f534d6b3ef6e12bc849f57ade33c7d4c,1,Sumit Mohanty,2013-04-24 17:19:14+00:00,['14f34bd20d67bd5b69f10bf3836fe2368b2d56f3'],7,34,41,14894112,8,0,0.428571429,0.357142857,10238
54707c4965b0da9e2acd07e4675af07611b9a884,1,Siddharth Wagle,2013-04-24 18:04:39+00:00,['42cb50e2f534d6b3ef6e12bc849f57ade33c7d4c'],8,101,109,14894221,4,0,0.61038961,0.922077922,10238
4dd506e0f90b898c2a54434e685b737fcccf4d8d,0,Sumit Mohanty,2013-04-24 21:25:06+00:00,['54707c4965b0da9e2acd07e4675af07611b9a884'],24,2,26,14894247,3,,,,10238
9736dcbbcef0c04173e31d26bca85ccd4aa160f0,1,Siddharth Wagle,2013-04-24 22:11:50+00:00,['4dd506e0f90b898c2a54434e685b737fcccf4d8d'],13,109,122,14894369,4,0,1,1,10238
c21f2c304f4d7fdb2e11c0930dd3d117e2ecaf22,1,Tom Beerbower,2013-04-24 23:19:46+00:00,['9736dcbbcef0c04173e31d26bca85ccd4aa160f0'],36,115,151,14894520,6,0,0.847826087,0.782608696,10238
0863e1b20d8f0315b53c95bc330b7603b4bdce07,1,Yusaku Sako,2013-04-24 23:29:51+00:00,['c21f2c304f4d7fdb2e11c0930dd3d117e2ecaf22'],1,4,5,14894525,2,,,,10238
2965debae2166dec797e6e4b9f9eb48685ae237d,1,Yusaku Sako,2013-04-24 23:31:36+00:00,['0863e1b20d8f0315b53c95bc330b7603b4bdce07'],7,46,53,14894578,4,1,0,0,10238
76e99bad6f0a93daba822e1f860ca211ab186a38,0,Yusaku Sako,2013-04-24 23:33:03+00:00,['2965debae2166dec797e6e4b9f9eb48685ae237d'],3,6,9,14894587,2,,,,10238
b0072f4cb8f52f3b0d72a0508896f13677631293,1,Yusaku Sako,2013-04-24 23:41:07+00:00,['76e99bad6f0a93daba822e1f860ca211ab186a38'],37,21,58,14894645,4,1,0,0,10238
7adcd39a81cbe12091fe1f289615c1fdaf75ed99,1,Yusaku Sako,2013-04-24 23:41:55+00:00,['b0072f4cb8f52f3b0d72a0508896f13677631293'],25,37,62,14894707,5,0,0.727272727,0.272727273,10238
a548101632ebb1d7d1abcb68bcab97c49bdac169,1,Yusaku Sako,2013-04-24 23:43:02+00:00,['7adcd39a81cbe12091fe1f289615c1fdaf75ed99'],69,26,95,14894802,5,0.615384615,0,0,10238
88542d99c599ffd756ae6cfbb2b591bb9482b466,0,Yusaku Sako,2013-04-24 23:43:49+00:00,['a548101632ebb1d7d1abcb68bcab97c49bdac169'],10,12,22,14894824,2,,,,10238
2f62c15c6a24a15fc090d4e6aed5c74a602be857,1,Siddharth Wagle,2013-04-25 20:00:07+00:00,['88542d99c599ffd756ae6cfbb2b591bb9482b466'],1,12,13,14894837,4,0.666666667,0.666666667,1,10238
c6944bc5461f7c84e0a9f82ce17b316c7f4a952e,1,Nate Cole,2013-04-25 21:27:12+00:00,['2f62c15c6a24a15fc090d4e6aed5c74a602be857'],57,41,98,14894935,3,1,1,0,10238
2fb690c85df187ccbd744db2bb025d078e2770cf,1,Nate Cole,2013-04-25 21:30:56+00:00,['c6944bc5461f7c84e0a9f82ce17b316c7f4a952e'],4,11,15,14894950,3,,,,10238
73dc42159feaf21820b67c4c5303c174ffe0c2e5,1,Sumit Mohanty,2013-04-26 17:39:39+00:00,['2fb690c85df187ccbd744db2bb025d078e2770cf'],3,24,27,14894977,2,,,,10238
27b11a994ec266b5d557b1a22717fa91d9567d02,1,Nate Cole,2013-04-26 20:59:05+00:00,['73dc42159feaf21820b67c4c5303c174ffe0c2e5'],12,58,70,14895047,3,0,0.333333333,1,10238
220e370772404ffe6b69fa8ee97ea90611b7ec51,0,Siddharth Wagle,2013-04-26 22:37:08+00:00,['27b11a994ec266b5d557b1a22717fa91d9567d02'],3,31,34,14895081,4,,,,10238
1ee263832bac014e955c3e0bed665da521e3f9f4,1,Sumit Mohanty,2013-04-27 00:18:30+00:00,['220e370772404ffe6b69fa8ee97ea90611b7ec51'],7,139,146,14895227,3,0.110091743,0.110091743,1,10238
ee66381e1fcf588519cab03fbdf938d09588414f,1,Yusaku Sako,2013-04-27 03:02:18+00:00,['1ee263832bac014e955c3e0bed665da521e3f9f4'],26,36,62,14895289,4,0,0,0,10238
a6df407f75046f7392d9a0c10a076a1961033aaa,1,Yusaku Sako,2013-04-27 03:02:44+00:00,['ee66381e1fcf588519cab03fbdf938d09588414f'],1,1,2,14895291,1,1,1,1,10238
b4bd7be4469608c6a6a259f5d44280ad17d06868,1,Yusaku Sako,2013-04-27 03:03:58+00:00,['a6df407f75046f7392d9a0c10a076a1961033aaa'],31,50,81,14895372,6,0.666666667,0.666666667,0,10238
b1eb5be76b533cb0a7596fd9dfe9ee0b1baab0d3,1,Yusaku Sako,2013-04-27 03:04:58+00:00,['b4bd7be4469608c6a6a259f5d44280ad17d06868'],1,23,24,14895396,3,1,1,1,10238
ca95fbdafb89fe743872d78bd5589fc198484667,1,Yusaku Sako,2013-04-27 03:17:53+00:00,['b1eb5be76b533cb0a7596fd9dfe9ee0b1baab0d3'],6,26,32,14895428,7,0.222222222,0,1,10238
97068bc445a929bea4f5af036970a22b385f0917,0,Yusaku Sako,2013-04-27 03:18:38+00:00,['ca95fbdafb89fe743872d78bd5589fc198484667'],7,19,26,14895454,3,,,,10238
b1a1f85d299877a3fb74827544d97882300531d2,1,Yusaku Sako,2013-04-27 03:19:47+00:00,['97068bc445a929bea4f5af036970a22b385f0917'],17,24,41,14895495,3,1,1,1,10238
22d6bf8392c4086af8632670b33fa951563f7c49,1,Yusaku Sako,2013-04-27 03:20:53+00:00,['b1a1f85d299877a3fb74827544d97882300531d2'],9,7,16,14895511,2,,,,10238
6fd6a936763f6af4eb6b9cd4b30dec6d02e52ea7,1,Sumit Mohanty,2013-04-27 16:20:02+00:00,['22d6bf8392c4086af8632670b33fa951563f7c49'],12,12,24,14895535,3,0.666666667,0.666666667,0,10238
0a81ee1b5ca9b17c037b3a20df324b1d170e51e9,1,Tom Beerbower,2013-04-29 15:25:39+00:00,['6fd6a936763f6af4eb6b9cd4b30dec6d02e52ea7'],310,425,735,14896270,15,,,,10251
cbce36e49f59b4b6a25e725b5aa7ea2893b71d75,1,Siddharth Wagle,2013-04-29 18:49:36+00:00,['0a81ee1b5ca9b17c037b3a20df324b1d170e51e9'],13,62,75,14896345,5,0.083333333,0,0.916666667,10251
8a1627e7f952f99e77eefc183d47246abbda0c4f,1,Siddharth Wagle,2013-04-29 20:38:22+00:00,['cbce36e49f59b4b6a25e725b5aa7ea2893b71d75'],0,13,13,14896358,2,,,,10251
d70f2ed48e91a397b60ab48431c0e77f55ed6667,1,Siddharth Wagle,2013-04-29 21:52:18+00:00,['8a1627e7f952f99e77eefc183d47246abbda0c4f'],1,78,79,14896437,2,0,0,1,10251
7cb29e1dded26ec2a33d590b5c5c9af52c73e6e8,0,Siddharth Wagle,2013-04-30 00:30:27+00:00,['d70f2ed48e91a397b60ab48431c0e77f55ed6667'],2,49,51,14896488,4,,,,10252
c1ede3dbd7f712e94fdf6b04591084796c4c7e46,1,Siddharth Wagle,2013-04-30 00:36:13+00:00,['7cb29e1dded26ec2a33d590b5c5c9af52c73e6e8'],9,84,93,14896581,8,,,,10253
226821c4e5479f203fc8a31bea714a9d30fdc18b,1,Siddharth Wagle,2013-04-30 00:40:29+00:00,['c1ede3dbd7f712e94fdf6b04591084796c4c7e46'],861,204,1065,14897646,18,0,1,1,10254
e09005b072e3508869ae03544febd1fe8b7bf38f,0,Siddharth Wagle,2013-04-30 00:45:38+00:00,['226821c4e5479f203fc8a31bea714a9d30fdc18b'],1,45,46,14897692,4,,,,10255
bbd8fe2a6762a97c48c70a83408d979b390a95f6,1,Siddharth Wagle,2013-04-30 00:49:44+00:00,['e09005b072e3508869ae03544febd1fe8b7bf38f'],0,126,126,14897818,4,0.419354839,1,1,10257
babd00f078156a0af72cadd044494987e88cc981,0,Siddharth Wagle,2013-04-30 00:51:51+00:00,['bbd8fe2a6762a97c48c70a83408d979b390a95f6'],13,27,40,14897858,3,,,,10257
9d2e873b091cb35bc9731db8d3f57bb859cb2ea2,1,Sumit Mohanty,2013-04-30 18:00:51+00:00,['babd00f078156a0af72cadd044494987e88cc981'],4,15,19,14897877,2,,,,10257
950e02d272019d76b9d66f2be3d8f4bbf3a3e808,0,Siddharth Wagle,2013-04-30 18:02:10+00:00,['9d2e873b091cb35bc9731db8d3f57bb859cb2ea2'],0,60,60,14897937,2,,,,10257
607cc2c82528ae01a36f7276ba6db470521a0bcf,1,Siddharth Wagle,2013-04-30 18:29:58+00:00,['950e02d272019d76b9d66f2be3d8f4bbf3a3e808'],19,16,35,14897972,3,,,,10257
f7e9a72cffc474cde87351a6e8d2aabe8824bcf9,0,Siddharth Wagle,2013-04-30 19:58:06+00:00,['607cc2c82528ae01a36f7276ba6db470521a0bcf'],1,28,29,14898001,3,0,1,1,10257
38eff2c087bb4739ecb6a1843901aebd5e49957f,0,Yusaku Sako,2013-05-01 17:41:33+00:00,['f7e9a72cffc474cde87351a6e8d2aabe8824bcf9'],1,4,5,14898006,2,,,,10257
4ea57553dc980d6b2527065d9f3325149be105b3,0,Yusaku Sako,2013-05-01 17:48:29+00:00,['38eff2c087bb4739ecb6a1843901aebd5e49957f'],0,7,7,14898013,2,,,,10257
93391f57944ec5838c1e6f970cc963c3db2a7a72,0,Yusaku Sako,2013-05-01 17:49:58+00:00,['4ea57553dc980d6b2527065d9f3325149be105b3'],1,3,4,14898017,3,,,,10258
386911dbaf50f25e7744f03827074eb223840fe8,1,Sumit Mohanty,2013-05-01 18:34:33+00:00,['93391f57944ec5838c1e6f970cc963c3db2a7a72'],6,9,15,14898032,7,,,,10258
c18e5de41e83678486b9c4262b2b8df426256dde,1,Sumit Mohanty,2013-05-01 18:53:51+00:00,['386911dbaf50f25e7744f03827074eb223840fe8'],8,16,24,14898056,8,,,,10258
1c5bed578f2e7040c5c50652a13d7bf3eace19b0,1,Yusaku Sako,2013-05-01 21:10:48+00:00,['c18e5de41e83678486b9c4262b2b8df426256dde'],2,3,5,14898061,2,,,,10258
772ced0a2672bc49e7afd910d6dc19e966f6e485,1,Yusaku Sako,2013-05-01 21:11:48+00:00,['1c5bed578f2e7040c5c50652a13d7bf3eace19b0'],3,7,10,14898071,3,,,,10258
0c17d5dd4d549a9387d9920e9cf38583ac5c2a73,1,Yusaku Sako,2013-05-01 21:13:39+00:00,['772ced0a2672bc49e7afd910d6dc19e966f6e485'],7,16,23,14898094,4,1,1,1,10258
1d4f6f0f5699a0e8ec9fedd644bdec44ee5f0635,1,Yusaku Sako,2013-05-01 21:15:35+00:00,['0c17d5dd4d549a9387d9920e9cf38583ac5c2a73'],38,180,218,14898312,6,1,1,0.885964912,10259
7a51b551ae71857f3cdb1a15540968c79aaedfde,1,Yusaku Sako,2013-05-01 21:17:56+00:00,['1d4f6f0f5699a0e8ec9fedd644bdec44ee5f0635'],23,76,99,14898411,6,1,1,1,10259
7bd69ee1943409db794e20fcdfbe108e645b0abc,1,Yusaku Sako,2013-05-01 21:24:40+00:00,['7a51b551ae71857f3cdb1a15540968c79aaedfde'],1,4,5,14898416,2,,,,10259
9b267c3503c5539a7ff7e2877cfe0141c72c1689,0,Yusaku Sako,2013-05-01 21:26:41+00:00,['7bd69ee1943409db794e20fcdfbe108e645b0abc'],12,14,26,14898442,6,,,,10259
b5e17cee65c198a667cee8a4e5b902adefac8209,1,Yusaku Sako,2013-05-01 21:27:44+00:00,['9b267c3503c5539a7ff7e2877cfe0141c72c1689'],3,5,8,14898450,2,,,,10259
05ecdc727cbe02100dd4841971787e2581b4ed0b,0,Yusaku Sako,2013-05-01 21:31:57+00:00,['b5e17cee65c198a667cee8a4e5b902adefac8209'],3,7,10,14898460,2,0,0,0,10259
3efcc5323b817b8fad128904c88c386699234de1,1,Srimanth,2013-05-01 21:55:48+00:00,['05ecdc727cbe02100dd4841971787e2581b4ed0b'],11,94,105,14898565,5,0.518518519,1,0.962962963,10259
0f439334045187bde5dde697cd9bf0ef582f53f7,1,Yusaku Sako,2013-05-01 22:08:55+00:00,['3efcc5323b817b8fad128904c88c386699234de1'],1717,1836,3553,14902118,9,0.375,0,1,10260
76d9ffeaab70c09fbd1857dc68921950cbc3421c,0,Sumit Mohanty,2013-05-01 23:58:12+00:00,['0f439334045187bde5dde697cd9bf0ef582f53f7'],25,2,27,14902145,4,,,,10260
ed9ffa45790c9bc729a5d4546b672175c4b014ff,1,Siddharth Wagle,2013-05-02 18:09:55+00:00,['76d9ffeaab70c09fbd1857dc68921950cbc3421c'],1,24,25,14902170,4,,,,10260
ec385434caab0398932f745c608d47f4fd65c433,1,Nate Cole,2013-05-02 20:25:40+00:00,['ed9ffa45790c9bc729a5d4546b672175c4b014ff'],245,10,255,14902425,12,1,0.309090909,0.018181818,10260
c5c5c5afb1640b7e9ea6f33dae29c08ce9417e31,1,Siddharth Wagle,2013-05-02 20:35:33+00:00,['ec385434caab0398932f745c608d47f4fd65c433'],1,4,5,14902430,2,,,,10260
e9508526b15b7e1adc9d333601aba46e9217ce9f,0,Yusaku Sako,2013-05-02 23:20:28+00:00,['c5c5c5afb1640b7e9ea6f33dae29c08ce9417e31'],2,5,7,14902437,2,,,,10260
fec0e3df8aa70b8ae192fe94026fa5b98913e9af,1,Yusaku Sako,2013-05-02 23:22:11+00:00,['e9508526b15b7e1adc9d333601aba46e9217ce9f'],120,169,289,14902726,8,1,1,0.956521739,10260
b903af518e01d733cad1b1d206a922883529c3f1,1,Siddharth Wagle,2013-05-03 20:34:40+00:00,['fec0e3df8aa70b8ae192fe94026fa5b98913e9af'],31,3228,3259,14905985,37,0,1,0.897058824,10286
6c8f4d5cc98d8006f0565585107e96572be336d8,1,Siddharth Wagle,2013-05-03 21:45:56+00:00,['b903af518e01d733cad1b1d206a922883529c3f1'],3,46,49,14906034,3,,,,10287
250e981c8a4dba15ef619aad1aa2d8c5bcb9d958,1,Sumit Mohanty,2013-05-03 22:41:58+00:00,['6c8f4d5cc98d8006f0565585107e96572be336d8'],28,16,44,14906078,4,,,,10287
6517322717e294fc3a07a8a9fb71f5d751def6a0,1,Sumit Mohanty,2013-05-03 23:40:26+00:00,['250e981c8a4dba15ef619aad1aa2d8c5bcb9d958'],3,10,13,14906091,5,,,,10287
6845939cf5f84a45fa629b18b81d2031959cfae4,0,Jaimin Jetly,2013-05-03 23:48:53+00:00,['6517322717e294fc3a07a8a9fb71f5d751def6a0'],404,137,541,14906632,2,,,,10287
807c79d728020cf4a0f1aad400c05921ac4eb94d,1,Jaimin Jetly,2013-05-04 00:24:08+00:00,['6845939cf5f84a45fa629b18b81d2031959cfae4'],1,3,4,14906636,2,,,,10287
b06b53d09f059f47b3a6871d3411f08299e55618,0,Jaimin Jetly,2013-05-06 17:33:49+00:00,['807c79d728020cf4a0f1aad400c05921ac4eb94d'],2,5,7,14906643,2,,,,10287
65f429487dc3c57f04f0ee1c3434f7fc3aff133d,1,Yusaku Sako,2013-05-06 17:55:12+00:00,['b06b53d09f059f47b3a6871d3411f08299e55618'],5,8,13,14906656,6,,,,10287
61d1045d6bf313d79d1da4f18b71fd6381b4f882,1,Yusaku Sako,2013-05-06 17:57:02+00:00,['65f429487dc3c57f04f0ee1c3434f7fc3aff133d'],47,110,157,14906813,6,0,1,0,10288
da54f347171b23f6088123b22d3cf7e1ff0e6e08,1,Siddharth Wagle,2013-05-06 22:18:29+00:00,['61d1045d6bf313d79d1da4f18b71fd6381b4f882'],3,33,36,14906849,3,,,,10288
c1385cd039a16f39eb52117056217da91c92d157,1,Siddharth Wagle,2013-05-06 23:35:22+00:00,['da54f347171b23f6088123b22d3cf7e1ff0e6e08'],4,4,8,14906857,2,,,,10288
028629508e21ced0a3cfcbe10b08e7ad5ecb1f9a,1,Jaimin Jetly,2013-05-06 23:50:44+00:00,['c1385cd039a16f39eb52117056217da91c92d157'],7,9,16,14906873,4,0,0,0,10288
bce0fbe0bea7e27709c2f3d1d869428ec07c3cc9,1,Sumit Mohanty,2013-05-07 05:35:05+00:00,['028629508e21ced0a3cfcbe10b08e7ad5ecb1f9a'],18,44,62,14906935,4,1,1,0.052631579,10288
484803e9f701b144514954bf9a0c0223452f3ba3,0,Nate Cole,2013-05-07 17:33:55+00:00,['bce0fbe0bea7e27709c2f3d1d869428ec07c3cc9'],12,15,27,14906962,2,,,,10288
12e6a2cefd4ddbb737fde910dc0f21489126f887,0,Siddharth Wagle,2013-05-07 18:04:50+00:00,['484803e9f701b144514954bf9a0c0223452f3ba3'],1,3,4,14906966,2,,,,10288
e23877fb77dc6219058171ad7bfff79720d9e141,1,Siddharth Wagle,2013-05-07 18:08:33+00:00,['12e6a2cefd4ddbb737fde910dc0f21489126f887'],46,146,192,14907158,3,0,0.965909091,1,10288
bbf0ab69a0dd364372f83a88befbcdaf981e63cf,1,Sumit Mohanty,2013-05-07 18:09:31+00:00,['e23877fb77dc6219058171ad7bfff79720d9e141'],2,139,141,14907299,4,0,0.796116505,1,10288
01630d5e82b75360f9f538383d4c520c5c7c36b9,1,Jaimin Jetly,2013-05-07 18:12:26+00:00,['bbf0ab69a0dd364372f83a88befbcdaf981e63cf'],5,7,12,14907311,3,,,,10288
797d2c9b33b0cc7daf3bbe386d95f377e2ddd164,0,Siddharth Wagle,2013-05-07 20:58:38+00:00,['01630d5e82b75360f9f538383d4c520c5c7c36b9'],6,2,8,14907319,3,,,,10288
aa934afb2a96f60b9ce0d06645d921cfbfaaff37,1,Siddharth Wagle,2013-05-08 00:39:58+00:00,['797d2c9b33b0cc7daf3bbe386d95f377e2ddd164'],4,80,84,14907403,7,,,,10290
0cc6f6057a28e3ff603f7fc9313cca315de1ea3e,1,Siddharth Wagle,2013-05-08 00:43:24+00:00,['aa934afb2a96f60b9ce0d06645d921cfbfaaff37'],23,86,109,14907512,6,,,,10292
86518c9056622b3a05721a5a91554ce426ca274e,1,Tom Beerbower,2013-05-08 17:21:55+00:00,['0cc6f6057a28e3ff603f7fc9313cca315de1ea3e'],3,306,309,14907821,5,,,,10293
9c82eb7a1ea7b64974b8f3857df1382816155a81,1,Siddharth Wagle,2013-05-08 17:26:05+00:00,['86518c9056622b3a05721a5a91554ce426ca274e'],23,49,72,14907893,8,0,0,0.058823529,10293
6acebf3454e92a397047de9940c518b9f09fa505,0,Tom Beerbower,2013-05-08 17:30:02+00:00,['9c82eb7a1ea7b64974b8f3857df1382816155a81'],1,1,2,14907895,1,,,,10293
3081dfe9b2edb5ef6ecdc43f00fcc322355d2c0d,0,Siddharth Wagle,2013-05-08 22:29:28+00:00,['6acebf3454e92a397047de9940c518b9f09fa505'],2,5,7,14907902,2,,,,10293
79a7f97a432498521e0cef9c9a6e33655a8b385c,0,Yusaku Sako,2013-05-09 23:01:07+00:00,['3081dfe9b2edb5ef6ecdc43f00fcc322355d2c0d'],33,16,49,14907951,3,1,1,0,10293
7e3d999103290546ac8467e7cd67fe31be791984,1,Yusaku Sako,2013-05-09 23:02:36+00:00,['79a7f97a432498521e0cef9c9a6e33655a8b385c'],70,46,116,14908067,3,0,0.25,1,10293
fa78ce19de288235bdeedde747c9f901719c28b9,0,Yusaku Sako,2013-05-09 23:04:01+00:00,['7e3d999103290546ac8467e7cd67fe31be791984'],1,9,10,14908077,3,1,1,1,10293
a4b6545a505f8ec93c76d33ca5117fdc8683f119,1,Yusaku Sako,2013-05-09 23:06:10+00:00,['fa78ce19de288235bdeedde747c9f901719c28b9'],4,31,35,14908112,4,1,1,1,10293
5cd97eedeba47fb22cf1dff30f330fc65bbe4bb9,1,Siddharth Wagle,2013-05-10 18:35:46+00:00,['a4b6545a505f8ec93c76d33ca5117fdc8683f119'],5,8,13,14908125,3,,,,10293
9d560aad826435416855393ce67c01cab9d5edfe,0,Yusaku Sako,2013-05-10 18:50:52+00:00,['5cd97eedeba47fb22cf1dff30f330fc65bbe4bb9'],2,895,897,14909022,3,0,0,1,10294
2905116f90b8426f6c066f1cff4cfa7029ab23e9,1,Yusaku Sako,2013-05-10 18:51:59+00:00,['9d560aad826435416855393ce67c01cab9d5edfe'],7,9,16,14909038,3,,,,10294
8258110761654b096042de2aab06a265626a2df8,1,Yusaku Sako,2013-05-10 20:38:16+00:00,['2905116f90b8426f6c066f1cff4cfa7029ab23e9'],0,129,129,14909167,9,,,,10294
394b8741e6caa52e6ead575cfd9703b3a0cebda0,1,Sumit Mohanty,2013-05-10 21:03:46+00:00,['8258110761654b096042de2aab06a265626a2df8'],2,5,7,14909174,2,,,,10294
a5c83a096e0a3ed1c876a137a971f049c121a934,1,Siddharth Wagle,2013-05-10 21:07:23+00:00,['394b8741e6caa52e6ead575cfd9703b3a0cebda0'],14,192,206,14909380,5,0.466666667,0.761904762,1,10295
e5d1fddb3102bd3a700903abbbe6b048b8879e84,1,Siddharth Wagle,2013-05-10 21:10:39+00:00,['a5c83a096e0a3ed1c876a137a971f049c121a934'],3,251,254,14909634,15,,,,10295
973d72e92ed4a7c522907729ce59148e86ee6125,1,Jaimin Jetly,2013-05-10 21:25:50+00:00,['e5d1fddb3102bd3a700903abbbe6b048b8879e84'],60,89,149,14909783,3,1,1,1,10295
be9e9eae6c12ceb6129051b30db4402d4341fddd,0,Yusaku Sako,2013-05-10 21:30:43+00:00,['973d72e92ed4a7c522907729ce59148e86ee6125'],0,4,4,14909787,2,,,,10295
6e8b0e4b6ad3ccf1da16d32edb7214172cc64869,0,Yusaku Sako,2013-05-10 22:38:11+00:00,['be9e9eae6c12ceb6129051b30db4402d4341fddd'],0,61,61,14909848,2,,,,10295
565d38682ea8b4d145cbe0cb0bb4e14695654db3,1,Mahadev Konar,2013-05-11 00:21:24+00:00,['6e8b0e4b6ad3ccf1da16d32edb7214172cc64869'],0,15,15,14909863,3,,,,10295
5caf897c458d5c342f1b3c402bdea3277272e314,0,Yusaku Sako,2013-05-11 01:23:47+00:00,['565d38682ea8b4d145cbe0cb0bb4e14695654db3'],1,3,4,14909867,2,,,,10295
8cae5481a36272b80b4b3e237f06e482fb92e9a9,1,Siddharth Wagle,2013-05-13 17:52:02+00:00,['5caf897c458d5c342f1b3c402bdea3277272e314'],7,9,16,14909883,8,,,,10295
69d0bfcddda6a801734c417ae7a7c7803aed0d91,1,Siddharth Wagle,2013-05-13 18:10:58+00:00,['8cae5481a36272b80b4b3e237f06e482fb92e9a9'],2,132,134,14910017,3,,,,10295
54f664f972af435fdb1152bb33b8371f1ae91ec9,1,Sumit Mohanty,2013-05-13 22:01:58+00:00,['69d0bfcddda6a801734c417ae7a7c7803aed0d91'],9,14,23,14910040,4,0,1,1,10295
10dcf7a296eac5caef039063200ad0c66115690e,1,Yusaku Sako,2013-05-14 00:41:10+00:00,['54f664f972af435fdb1152bb33b8371f1ae91ec9'],15,20,35,14910075,4,0,1,1,10295
7dd90e8fb47824aa38f7d878b8296790f5839733,1,Yusaku Sako,2013-05-14 01:11:48+00:00,['10dcf7a296eac5caef039063200ad0c66115690e'],27,64,91,14910166,9,1,1,1,10295
0458578dae0486ffb39b48328c79a7fc99b79d46,1,Yusaku Sako,2013-05-14 01:12:59+00:00,['7dd90e8fb47824aa38f7d878b8296790f5839733'],4,6,10,14910176,4,,,,10295
a7245a2ce8c41cf675a6bd23a2d5044070e066b8,1,Jaimin Jetly,2013-05-14 01:34:36+00:00,['0458578dae0486ffb39b48328c79a7fc99b79d46'],1,7,8,14910184,3,1,1,1,10295
6917d80a0d21155e2a573a3cf76afbdaf485372c,1,Tom Beerbower,2013-05-14 15:55:56+00:00,['a7245a2ce8c41cf675a6bd23a2d5044070e066b8'],120,124,244,14910428,19,,,,10295
9e08295bd75121fe7e470c26a8bacfe3cfbee838,1,Siddharth Wagle,2013-05-14 16:49:36+00:00,['6917d80a0d21155e2a573a3cf76afbdaf485372c'],23,12,35,14910463,3,1,1,1,10295
70ccfdebc93c90184caa2a427afa2039ca4aaa0f,1,Tom Beerbower,2013-05-14 17:50:42+00:00,['9e08295bd75121fe7e470c26a8bacfe3cfbee838'],91,1079,1170,14911633,25,,,,10295
d98ca81527ccb1b20ecfa45b8883bdbd06f3ca49,1,Sumit Mohanty,2013-05-14 18:02:25+00:00,['70ccfdebc93c90184caa2a427afa2039ca4aaa0f'],1,5,6,14911639,2,0,0,1,10295
14f519fbb8c844619761c149885a7377d87a68a4,1,Nate Cole,2013-05-14 18:23:58+00:00,['d98ca81527ccb1b20ecfa45b8883bdbd06f3ca49'],6,177,183,14911822,3,0,0.992424242,0.992424242,10295
f0db62906992e06d3761fc525a161871fdcd2879,1,Siddharth Wagle,2013-05-14 20:21:34+00:00,['14f519fbb8c844619761c149885a7377d87a68a4'],0,55,55,14911877,3,,,,10295
e23df89c917e13cffad7cf4acd4e627e257b63f6,1,Siddharth Wagle,2013-05-14 20:52:15+00:00,['f0db62906992e06d3761fc525a161871fdcd2879'],4,17,21,14911898,2,,,,10295
d27bb94242898673f68393f684c4ddb385bd8b3b,1,Siddharth Wagle,2013-05-14 20:56:41+00:00,['e23df89c917e13cffad7cf4acd4e627e257b63f6'],8,167,175,14912073,8,,,,10295
230c9d914b3620f6e69d2883c0d2768d5e4ae4d9,1,Jaimin Jetly,2013-05-14 22:11:48+00:00,['d27bb94242898673f68393f684c4ddb385bd8b3b'],2,5,7,14912080,3,,,,10295
f3faa3744b3aa2521ef911fa392b118a1a47228a,1,Sumit Mohanty,2013-05-14 22:47:40+00:00,['230c9d914b3620f6e69d2883c0d2768d5e4ae4d9'],2,11,13,14912093,2,,,,10295
5813b4adbd6aa3e32e53d05d543e8c5e9d6e6ef1,0,Mahadev Konar,2013-05-14 22:59:15+00:00,['f3faa3744b3aa2521ef911fa392b118a1a47228a'],6,10,16,14912109,2,,,,10295
565cd54ed11bd4ec92c2408fea9e83a39e7da847,1,Siddharth Wagle,2013-05-15 18:31:16+00:00,['5813b4adbd6aa3e32e53d05d543e8c5e9d6e6ef1'],7,49,56,14912165,6,,,,10296
1b1478da61190d908ae76088ba97d25396f7e0de,1,Yusaku Sako,2013-05-15 19:02:40+00:00,['565cd54ed11bd4ec92c2408fea9e83a39e7da847'],1,3,4,14912169,2,,,,10296
b0c90cdcba9a17b6a0c5c3a0f2bca32881db4368,0,Jaimin Jetly,2013-05-15 20:33:53+00:00,['1b1478da61190d908ae76088ba97d25396f7e0de'],1,3,4,14912173,2,,,,10296
273b9c1e34d16590bb8adeaa8e38cac061e25ac3,1,Siddharth Wagle,2013-05-16 17:00:26+00:00,['b0c90cdcba9a17b6a0c5c3a0f2bca32881db4368'],10,12,22,14912195,4,,,,10296
9b02e1f7caafab796e1c60201af9f6be58679f42,1,Siddharth Wagle,2013-05-16 17:04:45+00:00,['273b9c1e34d16590bb8adeaa8e38cac061e25ac3'],117,243,360,14912555,13,0.763888889,1,0.75,10296
39a995daf662eaddab7f235ddf9a7e4dd8b58549,1,Siddharth Wagle,2013-05-16 17:05:24+00:00,['9b02e1f7caafab796e1c60201af9f6be58679f42'],0,552,552,14913107,2,0.413043478,1,0.307971014,10298
a719a58a4b5fc9603a0cc915813e56637648e874,1,Siddharth Wagle,2013-05-16 17:12:21+00:00,['39a995daf662eaddab7f235ddf9a7e4dd8b58549'],92,123,215,14913322,9,0.1875,0.5625,0.9375,10298
4e487509602abb2534a887b9cba5f59b15912541,0,Sumit Mohanty,2013-05-16 17:15:11+00:00,['a719a58a4b5fc9603a0cc915813e56637648e874'],2,6,8,14913330,2,,,,10298
2caa1afec1d1cddd06803be9f3f3f57493b08b45,1,Sumit Mohanty,2013-05-16 17:16:03+00:00,['4e487509602abb2534a887b9cba5f59b15912541'],6,10,16,14913346,3,,,,10298
6f8ae9c9bc55298663ec559af603c0c942148965,0,Siddharth Wagle,2013-05-16 17:17:51+00:00,['2caa1afec1d1cddd06803be9f3f3f57493b08b45'],4,6,10,14913356,3,,,,10298
5527ea02d75a64f003cdf2bc6eecebd366d45f05,1,Sumit Mohanty,2013-05-16 17:26:07+00:00,['6f8ae9c9bc55298663ec559af603c0c942148965'],0,47,47,14913403,2,,,,10299
a16442600db0662f2566a7915fcaf288cec00b05,1,Sumit Mohanty,2013-05-16 17:38:11+00:00,['5527ea02d75a64f003cdf2bc6eecebd366d45f05'],1,5,6,14913409,3,,,,10299
5e27977c27b314fdb519505a7a0e47e0b6d7918e,1,Siddharth Wagle,2013-05-16 19:50:27+00:00,['a16442600db0662f2566a7915fcaf288cec00b05'],0,21,21,14913430,3,,,,10299
7380b4a9be5cac41f6f24fd83d68739393c39db9,0,Yusaku Sako,2013-05-16 20:46:27+00:00,['5e27977c27b314fdb519505a7a0e47e0b6d7918e'],17,20,37,14913467,2,,,,10299
36ccced35ab6f9b7a542f518f93acc982ad1ee1e,0,Mahadev Konar,2013-05-16 23:00:03+00:00,['7380b4a9be5cac41f6f24fd83d68739393c39db9'],0,3,3,14913470,1,,,,10299
e6d07071e7090fc300ff403870d4d43750e6921a,0,Mahadev Konar,2013-05-16 23:00:28+00:00,['36ccced35ab6f9b7a542f518f93acc982ad1ee1e'],1,1,2,14913472,1,,,,10299
b9038f7c3faefe05f2be36472abecf91b6441be8,0,Yusaku Sako,2013-05-17 00:27:09+00:00,['e6d07071e7090fc300ff403870d4d43750e6921a'],7,9,16,14913488,3,0,0,0,10299
e6585d4f5369f6fc45729476b16702d297577c18,0,Yusaku Sako,2013-05-17 00:27:57+00:00,['b9038f7c3faefe05f2be36472abecf91b6441be8'],18,3,21,14913509,4,1,0,0,10299
daeb0823b33659e826a8b873387168562d3426d5,1,Yusaku Sako,2013-05-17 00:28:51+00:00,['e6585d4f5369f6fc45729476b16702d297577c18'],3,6,9,14913518,4,,,,10299
c49f676be76f844d1487457f3b443af1c7f82433,0,Yusaku Sako,2013-05-17 00:30:00+00:00,['daeb0823b33659e826a8b873387168562d3426d5'],6,12,18,14913536,3,0,0,0,10299
813c016b98f447f98ba08b84d9ae8d20d1623803,1,Yusaku Sako,2013-05-17 00:31:07+00:00,['c49f676be76f844d1487457f3b443af1c7f82433'],6,78,84,14913620,4,1,0.621621622,0.378378378,10300
e4d2fd65fe7bda9c23cc069e2cbf4d39b1179c26,1,Yusaku Sako,2013-05-17 00:32:04+00:00,['813c016b98f447f98ba08b84d9ae8d20d1623803'],2,5,7,14913627,2,,,,10300
f544275b0855ccc8f505bf65ccbb704d4d332fb1,0,Jaimin Jetly,2013-05-17 18:20:03+00:00,['e4d2fd65fe7bda9c23cc069e2cbf4d39b1179c26'],1,4,5,14913632,2,,,,10300
a622ecb3b1ff4f1ab4254eca7d7d86dd95780d34,1,Tom Beerbower,2013-05-17 20:03:08+00:00,['f544275b0855ccc8f505bf65ccbb704d4d332fb1'],92,269,361,14913993,4,0.23880597,0.686567164,0.71641791,10300
4e5234ba5d128a1de7dc4787f2650fc621f37b12,1,Jaimin Jetly,2013-05-18 00:16:11+00:00,['a622ecb3b1ff4f1ab4254eca7d7d86dd95780d34'],2,4,6,14913999,2,,,,10300
126146f8c680868fe0b68d639852746351a6ae8f,1,Jaimin Jetly,2013-05-18 00:22:54+00:00,['4e5234ba5d128a1de7dc4787f2650fc621f37b12'],2,6,8,14914007,3,,,,10300
82f69585a0f3d0023450ccf084426794901e9641,1,Nate Cole,2013-05-20 16:50:04+00:00,['126146f8c680868fe0b68d639852746351a6ae8f'],59,245,304,14914311,23,0.325581395,0.38372093,0.941860465,10300
68e7a7fe3a20d4cb04691910e3badf81c61d9965,0,Sumit Mohanty,2013-05-20 17:13:02+00:00,['82f69585a0f3d0023450ccf084426794901e9641'],0,7,7,14914318,2,,,,10300
a3d93dca780be48ab85447845279fbb7d9d2c488,1,Jaimin Jetly,2013-05-20 17:44:28+00:00,['68e7a7fe3a20d4cb04691910e3badf81c61d9965'],39,15,54,14914372,6,0.846153846,0.269230769,0,10300
d6fe9125464866cd9baf539b0a9f5e1b57d8be80,1,Srimanth,2013-05-20 17:50:59+00:00,['a3d93dca780be48ab85447845279fbb7d9d2c488'],0,25,25,14914397,3,,,,10301
814854ce9b5790b113844fbca4735fe10c14b31e,1,Sumit Mohanty,2013-05-20 23:15:20+00:00,['d6fe9125464866cd9baf539b0a9f5e1b57d8be80'],0,21,21,14914418,5,,,,10301
842b513211280746506987941234b417dacd4e61,1,Sumit Mohanty,2013-05-21 01:14:51+00:00,['814854ce9b5790b113844fbca4735fe10c14b31e'],5,16,21,14914439,3,,,,10301
acc1839bd9b0749a91a9b6443c4ac2e355fd69e8,0,Sumit Mohanty,2013-05-21 04:33:31+00:00,['842b513211280746506987941234b417dacd4e61'],4,14,18,14914457,4,0.5,0.833333333,1,10301
3b7aea28ac22ce66902858d44644c4eabf1c00e1,1,Srimanth,2013-05-21 17:58:11+00:00,['acc1839bd9b0749a91a9b6443c4ac2e355fd69e8'],0,24,24,14914481,2,,,,10302
997755f211b7417cd92a544cabdfa95aee71b0fc,1,Jaimin Jetly,2013-05-21 22:55:43+00:00,['3b7aea28ac22ce66902858d44644c4eabf1c00e1'],5,8,13,14914494,2,,,,10302
ad92710d5c3bad03efb76f5d4a9bbe94481d1bfe,0,Mahadev Konar,2013-05-22 01:35:57+00:00,['997755f211b7417cd92a544cabdfa95aee71b0fc'],4891,3,4894,14919388,22,,,,10302
7ac987b0ce1922f98cb8b007639e69b5db5eedc1,1,Sumit Mohanty,2013-05-22 02:15:00+00:00,['ad92710d5c3bad03efb76f5d4a9bbe94481d1bfe'],11,90,101,14919489,4,,,,10304
d24ac9307364e764a33a3b98ee377f1c8b8350ae,1,Sumit Mohanty,2013-05-22 06:09:38+00:00,['7ac987b0ce1922f98cb8b007639e69b5db5eedc1'],1,294,295,14919784,5,0.476821192,1,0.966887417,10305
eb6c15ae47bf8200c463d7dfce46950a10bb1bf4,1,Sumit Mohanty,2013-05-22 06:11:40+00:00,['d24ac9307364e764a33a3b98ee377f1c8b8350ae'],18,54,72,14919856,7,0.84375,0.9375,0.8125,10305
a5d80f661215bfc3e3944bdd4fcc3ad28d7847c5,0,Sumit Mohanty,2013-05-22 06:12:45+00:00,['eb6c15ae47bf8200c463d7dfce46950a10bb1bf4'],1,3,4,14919860,2,,,,10305
d4f8fac25efb84c0d10a4f12c1ca8d1cbe80f59f,0,Yusaku Sako,2013-05-22 21:39:22+00:00,['a5d80f661215bfc3e3944bdd4fcc3ad28d7847c5'],1,3,4,14919864,2,0,0,0,10305
f126a5c12cbbf35d6dfa4ff2543f27d821e8c52e,1,Yusaku Sako,2013-05-22 21:43:28+00:00,['d4f8fac25efb84c0d10a4f12c1ca8d1cbe80f59f'],110,346,456,14920320,17,0.981818182,0.981818182,1,10307
579e7d1e7a0962269a207ca7ec6970560ce83003,1,Yusaku Sako,2013-05-22 21:43:47+00:00,['f126a5c12cbbf35d6dfa4ff2543f27d821e8c52e'],0,90,90,14920410,2,1,1,1,10309
8c908db3091ff1217184db2c8ff4792b6716e9ed,1,Yusaku Sako,2013-05-22 21:44:55+00:00,['579e7d1e7a0962269a207ca7ec6970560ce83003'],11,328,339,14920749,16,0.601190476,0.738095238,1,10309
08db0d9a297e1f213235e243caa1c93be5addc0b,0,Yusaku Sako,2013-05-22 21:46:13+00:00,['8c908db3091ff1217184db2c8ff4792b6716e9ed'],1,4,5,14920754,2,,,,10309
029e1d2736a8749e1cf80920bbf2b49d235e892f,1,Yusaku Sako,2013-05-22 21:47:31+00:00,['08db0d9a297e1f213235e243caa1c93be5addc0b'],31,172,203,14920957,5,0.321428571,1,1,10312
65e5a01a2b21ddc154bc4e68640bf451863a8c02,1,Yusaku Sako,2013-05-22 21:57:45+00:00,['029e1d2736a8749e1cf80920bbf2b49d235e892f'],24,55,79,14921036,4,1,1,1,10312
2a0e706fc2c4a5912ea136fd8e8fe84f938e03e5,1,Yusaku Sako,2013-05-22 21:59:23+00:00,['65e5a01a2b21ddc154bc4e68640bf451863a8c02'],48,88,136,14921172,9,0.613636364,1,1,10313
e2eae4ba31de05cc15849a4f80ece6729615d187,1,Yusaku Sako,2013-05-22 22:00:32+00:00,['2a0e706fc2c4a5912ea136fd8e8fe84f938e03e5'],5,8,13,14921185,3,,,,10313
b3a7c4fbae947ae5b74275351e15f2a5934ef4d2,1,Yusaku Sako,2013-05-22 22:03:17+00:00,['e2eae4ba31de05cc15849a4f80ece6729615d187'],2,4,6,14921191,2,,,,10313
8d2938bebc9aaa545ff37bb8f69395846fa82a58,1,Nate Cole,2013-05-22 22:25:32+00:00,['b3a7c4fbae947ae5b74275351e15f2a5934ef4d2'],3,3,6,14921197,7,,,,10313
24607b52241f6e1332c8a8566212b400e7de6918,1,Srimanth,2013-05-22 22:26:52+00:00,['8d2938bebc9aaa545ff37bb8f69395846fa82a58'],891,8120,9011,14930208,53,1,1,1,10343
45d74009b2b0c701df5e265e9a5e0b8ae7688ad8,1,Srimanth,2013-05-22 22:36:17+00:00,['24607b52241f6e1332c8a8566212b400e7de6918'],9,23,32,14930240,7,1,1,1,10343
8976ef093a0ff1e7c809bbcaeb0d459589a3e4dd,1,Srimanth,2013-05-22 22:42:55+00:00,['45d74009b2b0c701df5e265e9a5e0b8ae7688ad8'],0,11,11,14930251,2,1,1,1,10343
7221bafe1bfdb9d88162e24ec29b8f97c98e9c67,1,Sumit Mohanty,2013-05-23 00:25:34+00:00,['8976ef093a0ff1e7c809bbcaeb0d459589a3e4dd'],78,40,118,14930369,3,,,,10343
af3af9d4e7294e21536729a890c1cd34e6185734,1,Sumit Mohanty,2013-05-23 00:29:09+00:00,['7221bafe1bfdb9d88162e24ec29b8f97c98e9c67'],3,19,22,14930391,6,0.6,0.8,1,10343
64d78f81574f0f40cd4771e66f6c513cc0de42ac,1,Srimanth,2013-05-23 02:26:47+00:00,['af3af9d4e7294e21536729a890c1cd34e6185734'],125,251,376,14930767,21,0.333333333,0.444444444,1,10346
41cb3576ae12c6487097824343a2a1750b16ebeb,1,Nate Cole,2013-05-23 18:10:33+00:00,['64d78f81574f0f40cd4771e66f6c513cc0de42ac'],25,36,61,14930828,3,,,,10346
eb0ab156cdafcbed5d971161e723a0d97cba3655,0,Nate Cole,2013-05-23 18:55:13+00:00,['41cb3576ae12c6487097824343a2a1750b16ebeb'],16,3,19,14930847,2,0,0,0,10346
f7d3565aface85288eb9358a0b1cce6f82bbbbbc,1,Srimanth,2013-05-23 23:46:29+00:00,['eb0ab156cdafcbed5d971161e723a0d97cba3655'],191,2407,2598,14933445,11,0.4,0.4,1,10347
13e3daeb6840ebe0b61f809126209984b47b8306,1,Srimanth,2013-05-23 23:51:04+00:00,['f7d3565aface85288eb9358a0b1cce6f82bbbbbc'],14,23,37,14933482,13,0,0,1,10347
c445bca63c1b48e0e47d55501c18dcb476c368db,1,Srimanth,2013-05-24 01:20:04+00:00,['13e3daeb6840ebe0b61f809126209984b47b8306'],125,131,256,14933738,4,0.928571429,1,0,10347
f2f9fe0e5aed89e16284790fa5180b71f5a0cb2c,0,Srimanth,2013-05-24 01:22:24+00:00,['c445bca63c1b48e0e47d55501c18dcb476c368db'],3,30,33,14933771,3,1,1,1,10347
e557d56f250734264c1905b0f253b5543c1de2a3,1,Tom Beerbower,2013-05-28 15:17:19+00:00,['f2f9fe0e5aed89e16284790fa5180b71f5a0cb2c'],34,366,400,14934171,2,,,,10347
e910c599b2dc9b565f1dac5a154dcb85c4152dd2,1,Jaimin Jetly,2013-05-28 20:07:17+00:00,['e557d56f250734264c1905b0f253b5543c1de2a3'],5,10,15,14934186,2,,,,10347
16a035d113d9194e36b86a635bf567c60aa4ad7c,1,Jaimin Jetly,2013-05-28 20:55:16+00:00,['e910c599b2dc9b565f1dac5a154dcb85c4152dd2'],39,45,84,14934270,7,,,,10347
2b204bc5f8d7399ecac520ca1289c5d50d7efdac,1,Sumit Mohanty,2013-05-28 23:53:31+00:00,['16a035d113d9194e36b86a635bf567c60aa4ad7c'],5,1087,1092,14935362,11,,,,10347
04c2e7ac1377de28b322adae6e47eaedf66fabf5,1,Yusaku Sako,2013-05-29 01:52:26+00:00,['2b204bc5f8d7399ecac520ca1289c5d50d7efdac'],2,6,8,14935370,3,,,,10347
016bff80edffd176e425eb4dc919d68039d1e5e3,1,Yusaku Sako,2013-05-29 01:56:27+00:00,['04c2e7ac1377de28b322adae6e47eaedf66fabf5'],17,27,44,14935414,2,0.75,0.75,1,10347
e7d2462de0ad474392932973069a828e692e6c7f,1,Yusaku Sako,2013-05-29 01:57:37+00:00,['016bff80edffd176e425eb4dc919d68039d1e5e3'],10,20,30,14935444,4,1,1,1,10347
9583ad00780bc6d05119d2c4e487d19139a6108b,1,Yusaku Sako,2013-05-29 01:58:38+00:00,['e7d2462de0ad474392932973069a828e692e6c7f'],3,6,9,14935453,2,,,,10347
51324a4939b3efc785f23c4c0be4510309e393be,1,Yusaku Sako,2013-05-29 01:59:51+00:00,['9583ad00780bc6d05119d2c4e487d19139a6108b'],275,239,514,14935967,6,0.66539924,1,1,10347
f0c88566fcbae0e71d002e749d32263166aa22ff,1,Yusaku Sako,2013-05-29 02:01:12+00:00,['51324a4939b3efc785f23c4c0be4510309e393be'],83,392,475,14936442,6,0.186619718,0.996478873,1,10349
7c0e6106eae68963b0bb5c19a77c6208ec9d59a9,1,Yusaku Sako,2013-05-29 02:02:34+00:00,['f0c88566fcbae0e71d002e749d32263166aa22ff'],6,9,15,14936457,3,1,,,10349
8c9d81e424c5eacfe394db1739d9ecd3d5b0480a,1,Yusaku Sako,2013-05-29 02:04:09+00:00,['7c0e6106eae68963b0bb5c19a77c6208ec9d59a9'],2,8,10,14936467,3,1,1,1,10349
ea3918f1523482b342eb7a1e4eeb59da909044ae,1,Yusaku Sako,2013-05-29 02:06:36+00:00,['8c9d81e424c5eacfe394db1739d9ecd3d5b0480a'],141,820,961,14937428,5,1,1,1,10350
3740bcb53da403779957561b5e3feb5554aea0d3,1,Yusaku Sako,2013-05-29 02:08:24+00:00,['ea3918f1523482b342eb7a1e4eeb59da909044ae'],214,32,246,14937674,16,0.845070423,0.338028169,0,10350
eb3403bc84dd37d139ddef879ab49c5e00260648,1,Yusaku Sako,2013-05-29 02:15:57+00:00,['3740bcb53da403779957561b5e3feb5554aea0d3'],1,68,69,14937743,4,,,,10350
3ce33809035fa490a386244d1e51395d11cee608,1,Sumit Mohanty,2013-05-29 14:17:10+00:00,['eb3403bc84dd37d139ddef879ab49c5e00260648'],7,6,13,14937756,2,,,,10350
bd520ce8a25e50a31d00484840ddf4ec0c4cd57c,1,Sumit Mohanty,2013-05-29 16:38:52+00:00,['3ce33809035fa490a386244d1e51395d11cee608'],213,245,458,14938214,8,1,1,0.471698113,10352
e0d7dc61e335cafb43a52f419f9d1abebbd6cd7e,0,Sumit Mohanty,2013-05-29 16:40:42+00:00,['bd520ce8a25e50a31d00484840ddf4ec0c4cd57c'],19,20,39,14938253,5,1,0,0,10352
08c6fda7c63fafc2c5e0140b7701d424cb6a20d9,1,Jaimin Jetly,2013-05-29 17:11:57+00:00,['e0d7dc61e335cafb43a52f419f9d1abebbd6cd7e'],0,10,10,14938263,3,,,,10352
e88529d6e6279ca74251120e5dc223414da3b9aa,1,Siddharth Wagle,2013-05-29 19:54:45+00:00,['08c6fda7c63fafc2c5e0140b7701d424cb6a20d9'],1,4,5,14938268,2,,,,10352
29db6d7e79f8433c7fda4a33b11c08c76937c637,1,Siddharth Wagle,2013-05-29 19:58:02+00:00,['e88529d6e6279ca74251120e5dc223414da3b9aa'],15,58,73,14938341,3,,,,10352
1bba2f9b386bce8f0a4ce27f17d74f2d017ac530,1,Siddharth Wagle,2013-05-29 19:59:21+00:00,['29db6d7e79f8433c7fda4a33b11c08c76937c637'],20,24,44,14938385,9,,,,10352
3678223e9a241d056fff9d6934de39ded0cd1afa,1,Siddharth Wagle,2013-05-29 20:03:08+00:00,['1bba2f9b386bce8f0a4ce27f17d74f2d017ac530'],0,5,5,14938390,2,,,,10352
300653667a80b6c57d351b6e401895ffcf330777,1,Sumit Mohanty,2013-05-29 22:39:24+00:00,['3678223e9a241d056fff9d6934de39ded0cd1afa'],13,22,35,14938425,6,0.5,0.5,0.5,10352
3a422c516f19501fb0853aa6f3b28ec001461d1b,0,Yusaku Sako,2013-05-30 01:48:38+00:00,['300653667a80b6c57d351b6e401895ffcf330777'],9,66,75,14938500,3,,,,10352
0f4be5efe00ebb3a3adf1162e6083797f35c14cb,0,Mahadev Konar,2013-05-30 07:15:06+00:00,['3a422c516f19501fb0853aa6f3b28ec001461d1b'],0,4,4,14938504,2,,,,10352
dd9e55d7a0e789f3573b6505223dfc9e00e840f1,1,Sumit Mohanty,2013-05-30 16:49:21+00:00,['0f4be5efe00ebb3a3adf1162e6083797f35c14cb'],10,13,23,14938527,3,,,,10352
9db6ce0c3e694e154ac495c51b78ea07ebb7c41b,1,Sumit Mohanty,2013-05-30 16:51:01+00:00,['dd9e55d7a0e789f3573b6505223dfc9e00e840f1'],3,5,8,14938535,3,,,,10352
f3e2e0c68d1761ff01f6a56198dbe6af3d16aee6,1,Sumit Mohanty,2013-05-30 20:47:46+00:00,['9db6ce0c3e694e154ac495c51b78ea07ebb7c41b'],18,144,162,14938697,14,,,,10352
1d2e972f9d08aee69b9caec694f945decd6e2568,1,Jaimin Jetly,2013-05-30 21:01:14+00:00,['f3e2e0c68d1761ff01f6a56198dbe6af3d16aee6'],29,45,74,14938771,5,,,,10352
d692803972a0ab4a9c7ebaf8eda72189e105a308,1,Sumit Mohanty,2013-05-30 21:10:25+00:00,['1d2e972f9d08aee69b9caec694f945decd6e2568'],0,16,16,14938787,3,0,1,1,10352
10b76e77deb08e0ac82bdecea0211e5d240b43a5,0,Jaimin Jetly,2013-05-30 21:47:54+00:00,['d692803972a0ab4a9c7ebaf8eda72189e105a308'],15,4,19,14938806,4,,,,10352
fe0e2c563fae61b5f5e12bd2d45b4fd504b6f275,1,Yusaku Sako,2013-05-30 22:03:58+00:00,['10b76e77deb08e0ac82bdecea0211e5d240b43a5'],928,2946,3874,14942680,71,0.479007634,0.879770992,0.980916031,10361
a6281b4f9c5f1dde906f723dcce29af45f67ed43,1,Mahadev Konar,2013-05-31 06:38:46+00:00,['fe0e2c563fae61b5f5e12bd2d45b4fd504b6f275'],1,53,54,14942734,2,0.827586207,0.827586207,0.172413793,10361
dfd4a78be591ef21ee49301502c86650860cad89,1,Mahadev Konar,2013-05-31 15:03:50+00:00,['a6281b4f9c5f1dde906f723dcce29af45f67ed43'],0,120,120,14942854,2,0.191780822,0.123287671,0.808219178,10361
e7c26f5c16df3c6163d825a042c7054cf46ff9f2,1,Yusaku Sako,2013-06-01 04:49:41+00:00,['dfd4a78be591ef21ee49301502c86650860cad89'],46,188,234,14943088,5,0,0.9,1,10361
6fe66a1e2d6a48b2ffe5fa61ddc6f1c492d424c2,1,Tom Beerbower,2013-06-03 18:12:35+00:00,['e7c26f5c16df3c6163d825a042c7054cf46ff9f2'],0,2822,2822,14945910,1,,,,10362
b3c451cf6380576af311c1e29acc44f6122111cc,1,Tom Beerbower,2013-06-03 18:13:30+00:00,['6fe66a1e2d6a48b2ffe5fa61ddc6f1c492d424c2'],59,436,495,14946405,2,,,,10362
c38a32265d3ff66fe166efc6910979805a42d8b7,1,Tom Beerbower,2013-06-03 18:28:04+00:00,['b3c451cf6380576af311c1e29acc44f6122111cc'],1039,1049,2088,14948493,12,1,0,1,10362
b5b7517ef846998a15a3f6d3475d58359d381263,0,Tom Beerbower,2013-06-03 18:43:17+00:00,['c38a32265d3ff66fe166efc6910979805a42d8b7'],1,1,2,14948495,1,,,,10362
88cacbefed6125d62570963b0c7fa51c089cc82c,0,Yusaku Sako,2013-06-03 19:09:01+00:00,['b5b7517ef846998a15a3f6d3475d58359d381263'],0,1,1,14948496,1,1,1,1,10362
cde740ffeee25bc15df179eb440374e886bfba29,1,Yusaku Sako,2013-06-03 19:10:40+00:00,['88cacbefed6125d62570963b0c7fa51c089cc82c'],1,16,17,14948513,2,0.4375,0.4375,1,10362
571a9bc251842b73ccfc67b131763a1f05b0f544,1,Yusaku Sako,2013-06-03 19:12:11+00:00,['cde740ffeee25bc15df179eb440374e886bfba29'],4,42,46,14948559,4,1,1,1,10362
abf054c783e7ee2504358d0f687997728b3692d8,1,Jaimin Jetly,2013-06-03 22:27:04+00:00,['571a9bc251842b73ccfc67b131763a1f05b0f544'],76,72,148,14948707,6,,,,10362
b0efe88977ed01cdf1ce030a4f6b06c6860ea2a4,1,Siddharth Wagle,2013-06-03 22:45:30+00:00,['abf054c783e7ee2504358d0f687997728b3692d8'],22,148,170,14948877,3,0,0.259615385,1,10362
f5036a26e8a3413854014012be4c85a606e3bf83,0,Jaimin Jetly,2013-06-04 02:04:36+00:00,['b0efe88977ed01cdf1ce030a4f6b06c6860ea2a4'],1,3,4,14948881,2,0,0,1,10362
66c4d6e488c8b1f881c00e5acb2086b0b856250c,1,Yusaku Sako,2013-06-04 02:41:31+00:00,['f5036a26e8a3413854014012be4c85a606e3bf83'],2,2,4,14948885,1,,,,10362
352df84fdb2c3a6b8b5a372233da8761ce206515,1,Mahadev Konar,2013-06-04 05:14:01+00:00,['66c4d6e488c8b1f881c00e5acb2086b0b856250c'],13,443,456,14949341,11,1,1,0.987654321,10367
5e739bea8e2f903d899f0f872ab591614087890f,1,Tom Beerbower,2013-06-04 09:55:32+00:00,['352df84fdb2c3a6b8b5a372233da8761ce206515'],1049,1039,2088,14951429,12,0,1,0,10369
1be2fdb2a6a9c706e20ce32ff452de5933853994,1,Yusaku Sako,2013-06-04 16:48:43+00:00,['5e739bea8e2f903d899f0f872ab591614087890f'],0,14,14,14951443,2,1,1,1,10369
99358047e0f440d61b2db6c96632554e1fb1d08f,1,Yusaku Sako,2013-06-04 17:40:56+00:00,['1be2fdb2a6a9c706e20ce32ff452de5933853994'],6,6,12,14951455,4,,,,10369
67279d73edd9b0fbeef382b25911086530a63eab,1,Yusaku Sako,2013-06-04 18:02:09+00:00,['99358047e0f440d61b2db6c96632554e1fb1d08f'],0,3,3,14951458,1,0,0,1,10369
ff5e276e3751d916aa13768ac2ce61fab1619e64,0,Yusaku Sako,2013-06-04 18:20:52+00:00,['67279d73edd9b0fbeef382b25911086530a63eab'],3,3,6,14951464,2,,,,10369
5e81c4850935e493a17a06951bcd61483e38a809,1,Sumit Mohanty,2013-06-04 18:33:30+00:00,['ff5e276e3751d916aa13768ac2ce61fab1619e64'],1298,2021,3319,14954783,7,0,0.914473684,0.981907895,10369
c5dece3b2962a4a4d9c2fa35969587ee80ad83a8,1,Jaimin Jetly,2013-06-04 18:58:57+00:00,['5e81c4850935e493a17a06951bcd61483e38a809'],2,7,9,14954792,2,1,1,1,10369
612351bf16f73a6a11ee0480b803d7a4938390e9,0,Sumit Mohanty,2013-06-04 19:58:05+00:00,['c5dece3b2962a4a4d9c2fa35969587ee80ad83a8'],0,4,4,14954796,1,,,,10369
50ae4fd88738495904e7b1de028a51a58dd0c85c,0,Jaimin Jetly,2013-06-04 20:19:22+00:00,['612351bf16f73a6a11ee0480b803d7a4938390e9'],321,1,322,14955118,4,,,,10369
fee893fe3623b594da05542f364207ce7bae171f,1,Jaimin Jetly,2013-06-04 21:22:39+00:00,['50ae4fd88738495904e7b1de028a51a58dd0c85c'],15,36,51,14955169,7,0.9,0.9,0.95,10369
09d3156b0a4b76b7ba5f9021ae3a45803abe5619,1,Yusaku Sako,2013-06-05 00:39:45+00:00,['fee893fe3623b594da05542f364207ce7bae171f'],0,2,2,14955171,1,,,,10369
65bf3370f3228cbd364f2d9d5ca36b81ba53180f,1,Sumit Mohanty,2013-06-05 01:24:27+00:00,['09d3156b0a4b76b7ba5f9021ae3a45803abe5619'],18,82,100,14955271,3,0,0.551724138,0.5,10369
29431281008eea203a8af2fa647f09609f737ae2,1,Mahadev Konar,2013-06-05 16:54:15+00:00,['65bf3370f3228cbd364f2d9d5ca36b81ba53180f'],1,37,38,14955309,2,,,,10370
f0c0227c054bef110a8890e5705382b228b73711,1,Yusaku Sako,2013-06-05 17:03:15+00:00,['29431281008eea203a8af2fa647f09609f737ae2'],1,4,5,14955314,1,0,1,1,10370
893dc97e2a1d5f901356f3056081ab65dba030b7,0,Yusaku Sako,2013-06-05 17:08:47+00:00,['f0c0227c054bef110a8890e5705382b228b73711'],5,0,5,14955319,1,1,0,0,10370
7e97ca670e8d6a54ff07a59bb9ba00b27b9403e5,1,Sumit Mohanty,2013-06-05 17:12:05+00:00,['893dc97e2a1d5f901356f3056081ab65dba030b7'],13,108,121,14955440,3,0,1,1,10371
67fc1c3c98a4bce73d802f43c5b354acbf555da6,1,Yusaku Sako,2013-06-05 17:30:51+00:00,['7e97ca670e8d6a54ff07a59bb9ba00b27b9403e5'],2,6,8,14955448,1,1,1,1,10371
29a1323603dec6a56c6d15c819ff0ea6ecdb2658,1,Yusaku Sako,2013-06-05 23:27:41+00:00,['67fc1c3c98a4bce73d802f43c5b354acbf555da6'],18,5972,5990,14961438,31,0.7,0.844444444,0.833333333,10383
aac34c3b16946db9ead803c8fa5922a995caf1c4,0,Yusaku Sako,2013-06-06 05:40:40+00:00,['29a1323603dec6a56c6d15c819ff0ea6ecdb2658'],5,6,11,14961449,4,,,,10383
1491139ff5a94b5229833a9542b96f1567d49f64,1,Mahadev Konar,2013-06-06 06:07:43+00:00,['aac34c3b16946db9ead803c8fa5922a995caf1c4'],3,71,74,14961523,5,,,,10385
6c537a81ee9930cb3741a8cdd10081b5c8ead4ce,1,Mahadev Konar,2013-06-06 17:34:20+00:00,['1491139ff5a94b5229833a9542b96f1567d49f64'],44,70,114,14961637,9,,,,10385
9fedbb265521759d7d4d30c7940ab8b4ce257ec1,1,Yusaku Sako,2013-06-06 20:13:47+00:00,['6c537a81ee9930cb3741a8cdd10081b5c8ead4ce'],4,13,17,14961654,4,0,1,0,10385
1bdf6213dea47ea6888593ae0dd0dd39a830357b,1,Mahadev Konar,2013-06-07 10:34:34+00:00,['9fedbb265521759d7d4d30c7940ab8b4ce257ec1'],26,44,70,14961724,3,0,0,0.7,10385
3cc3b1ab605d5d2efd95c27e33435965a7e4f2d3,0,Mahadev Konar,2013-06-07 10:35:11+00:00,['1bdf6213dea47ea6888593ae0dd0dd39a830357b'],0,91,91,14961815,1,1,1,1,10386
7024558d24f9b13db1d216b59ac8f3f2be1b356b,0,Mahadev Konar,2013-06-07 18:12:17+00:00,['3cc3b1ab605d5d2efd95c27e33435965a7e4f2d3'],2,4,6,14961821,1,,,,10386
c29a6828e9d45771034c59be6748986ea1ec08e4,0,Yusaku Sako,2013-06-07 18:14:52+00:00,['7024558d24f9b13db1d216b59ac8f3f2be1b356b'],2,2,4,14961825,1,,,,10386
6ff3dd07383b9c03f4306db4645cc1db56d5f3e0,1,Yusaku Sako,2013-06-07 18:17:19+00:00,['c29a6828e9d45771034c59be6748986ea1ec08e4'],2,14,16,14961841,2,1,1,1,10386
9181df6237830c21199d15a3f13c2179a45c5a31,1,Yusaku Sako,2013-06-07 18:20:53+00:00,['6ff3dd07383b9c03f4306db4645cc1db56d5f3e0'],33,36,69,14961910,3,0,0,0,10386
2857e042bb3080e875974b46fb7454689ffe345a,1,Yusaku Sako,2013-06-07 18:23:51+00:00,['9181df6237830c21199d15a3f13c2179a45c5a31'],2,2,4,14961914,1,,,,10386
69b416d37a964efe1acf245903e45ff08ea9d7c0,1,Yusaku Sako,2013-06-07 18:30:30+00:00,['2857e042bb3080e875974b46fb7454689ffe345a'],15,54,69,14961983,4,0.444444444,1,1,10386
f38cea4b71220d04cc81c054df87c1079369c388,1,Sumit Mohanty,2013-06-07 18:38:12+00:00,['69b416d37a964efe1acf245903e45ff08ea9d7c0'],34,197,231,14962214,8,0.987012987,0.948051948,0.701298701,10387
6626f2a37f0b3ac4943c2ceabf21a65639971671,0,Yusaku Sako,2013-06-07 18:52:29+00:00,['f38cea4b71220d04cc81c054df87c1079369c388'],1,1,2,14962216,1,,,,10387
5bded734a34dcf512923781b9ac2197e7179cc0a,1,Sumit Mohanty,2013-06-07 20:49:50+00:00,['6626f2a37f0b3ac4943c2ceabf21a65639971671'],8,12,20,14962236,2,1,1,1,10387
2637482643e211d401ce648b7c85674552720ff1,1,Jaimin Jetly,2013-06-07 21:36:40+00:00,['5bded734a34dcf512923781b9ac2197e7179cc0a'],120,196,316,14962552,11,0.169811321,0.830188679,0.981132075,10387
76879c8a63519aa757176bc79d3a9a9946c30ff3,1,Jaimin Jetly,2013-06-07 23:17:11+00:00,['2637482643e211d401ce648b7c85674552720ff1'],1,1,2,14962554,1,,,,10387
3f9e1c34ba15189a68eacb6c4247f4dc5f27de5d,1,Mahadev Konar,2013-06-08 20:29:06+00:00,['76879c8a63519aa757176bc79d3a9a9946c30ff3'],419,791,1210,14963764,11,0.408602151,0,1,10391
2148283707daaf8d2834b1ab1c2464946a78f80f,1,Mahadev Konar,2013-06-09 16:06:28+00:00,['3f9e1c34ba15189a68eacb6c4247f4dc5f27de5d'],6,82,88,14963852,2,0.413043478,0.826086957,0.326086957,10391
239a1176c12de794d934d38a3f3947139677200e,1,Sumit Mohanty,2013-06-09 20:46:26+00:00,['2148283707daaf8d2834b1ab1c2464946a78f80f'],15,62,77,14963929,2,0.419354839,0.096774194,0.709677419,10391
97e3d542d424586dae42040047634eb975d8770d,1,Sumit Mohanty,2013-06-09 21:50:55+00:00,['239a1176c12de794d934d38a3f3947139677200e'],3,57,60,14963989,2,0.441176471,0.970588235,0.970588235,10391
7ffcf5a666edab82fe9d58a4982eba9c441a02b2,1,Siddharth Wagle,2013-06-09 22:07:10+00:00,['97e3d542d424586dae42040047634eb975d8770d'],5,74,79,14964068,5,0.375,0,0.375,10391
aa9a84806c942b7f5017eff0efd96ee59b45568a,1,Yusaku Sako,2013-06-10 02:35:05+00:00,['7ffcf5a666edab82fe9d58a4982eba9c441a02b2'],66,48,114,14964182,10,0,0,0,10391
30c3618b9d675c191bfb34bf8c5fb27d135e7234,0,Yusaku Sako,2013-06-10 02:38:02+00:00,['aa9a84806c942b7f5017eff0efd96ee59b45568a'],112,39,151,14964333,4,1,0,0,10391
c1d1fa0adcc94e037286355d711173b9b9f4699f,1,Mahadev Konar,2013-06-10 05:46:39+00:00,['30c3618b9d675c191bfb34bf8c5fb27d135e7234'],39,77,116,14964449,2,0.166666667,0.833333333,0.9,10391
32eead980448369cb9c4e3b54834569569827208,1,Tom Beerbower,2013-06-10 14:54:38+00:00,['c1d1fa0adcc94e037286355d711173b9b9f4699f'],28,167,195,14964644,6,0.183908046,0.850574713,0.977011494,10391
ce3f257288a0d56b8a9fe132183b629c8be20e03,0,Siddharth Wagle,2013-06-10 17:46:40+00:00,['32eead980448369cb9c4e3b54834569569827208'],3,11,14,14964658,1,0,1,1,10391
54c27e6a4a135bb7719e0897672cb4def5d530cf,1,Mahadev Konar,2013-06-10 18:20:12+00:00,['ce3f257288a0d56b8a9fe132183b629c8be20e03'],16,19,35,14964693,1,0,1,1,10391
cd7aae3d9fbfcc4e47aef4cb5ff83e0b3ad5359a,1,Yusaku Sako,2013-06-11 00:21:32+00:00,['54c27e6a4a135bb7719e0897672cb4def5d530cf'],271,4292,4563,14969256,39,0.600243754,0.761121268,0.987202925,10416
d10fd3e7d715cbcf30fea71d4c7cfcd8e4bb9a9d,1,Yusaku Sako,2013-06-11 01:27:52+00:00,['cd7aae3d9fbfcc4e47aef4cb5ff83e0b3ad5359a'],0,1,1,14969257,1,1,1,1,10416
720145a3988820a976c68a2e7f3bc93579b34575,1,Yusaku Sako,2013-06-11 02:56:44+00:00,['d10fd3e7d715cbcf30fea71d4c7cfcd8e4bb9a9d'],58,158,216,14969473,6,0,1,1,10416
486674643c873ee7deb4e3b25ae22def2682c66a,1,Jaimin Jetly,2013-06-11 18:52:12+00:00,['720145a3988820a976c68a2e7f3bc93579b34575'],7,50,57,14969530,6,1,0,1,10416
842a421c3e5b88581f35b57983bbd32689aa9036,1,Jaimin Jetly,2013-06-11 21:29:25+00:00,['486674643c873ee7deb4e3b25ae22def2682c66a'],34,70,104,14969634,5,1,1,1,10416
14fd56787793fa8a9f6d8d5b2b94382b86707e00,1,Yusaku Sako,2013-06-11 21:35:02+00:00,['842a421c3e5b88581f35b57983bbd32689aa9036'],398,1105,1503,14971137,33,0.157320872,0.998442368,1,10422
7f8b02481815e39a00c1d4f107f4b2bd4a439787,0,Tom Beerbower,2013-06-11 21:51:52+00:00,['14fd56787793fa8a9f6d8d5b2b94382b86707e00'],45,112,157,14971294,6,0.215384615,0.892307692,1,10422
1665538e8fc06ca5ac6db12379af6f4e3ebadea8,0,Tom Beerbower,2013-06-12 01:07:49+00:00,['7f8b02481815e39a00c1d4f107f4b2bd4a439787'],16,4,20,14971314,1,,,,10422
03c11d4eb56e382b8dd53cc3479db219d31ad49d,1,Sumit Mohanty,2013-06-12 01:19:53+00:00,['1665538e8fc06ca5ac6db12379af6f4e3ebadea8'],18,106,124,14971438,2,0.537037037,0.537037037,0.685185185,10422
ca3a6232dc3ee91104e59306b4dff57dbbbe5401,0,Sumit Mohanty,2013-06-12 17:39:26+00:00,['03c11d4eb56e382b8dd53cc3479db219d31ad49d'],4,5,9,14971447,1,,,,10422
860c1716b9861eea45913af0452918c026492179,0,Nate Cole,2013-06-12 19:24:07+00:00,['ca3a6232dc3ee91104e59306b4dff57dbbbe5401'],0,1,1,14971448,1,,,,10422
baae6af6678342b3996890ab05efaaa6215564ea,1,Siddharth Wagle,2013-06-12 21:04:44+00:00,['860c1716b9861eea45913af0452918c026492179'],4,30,34,14971482,2,0,0,1,10422
06a4ab09f05bb9581a0b63a8eed81a808ed2c6a8,1,Yusaku Sako,2013-06-12 22:46:36+00:00,['baae6af6678342b3996890ab05efaaa6215564ea'],236,354,590,14972072,10,0,0,1,10424
68140080ef5da0d4f1100a34e1f12c0388ba9d72,1,Mahadev Konar,2013-06-13 00:00:45+00:00,['06a4ab09f05bb9581a0b63a8eed81a808ed2c6a8'],119,189,308,14972380,2,0.75,0,0,10424
3341319a6792e4c64881107b77886e0d61498f89,1,Mahadev Konar,2013-06-13 00:10:27+00:00,['68140080ef5da0d4f1100a34e1f12c0388ba9d72'],4,10,14,14972394,1,0,1,0,10424
5dba5e919254acf1f75d7c91710668cd8f2b3e4b,1,Yusaku Sako,2013-06-13 00:43:33+00:00,['3341319a6792e4c64881107b77886e0d61498f89'],8,8,16,14972410,2,,,,10424
15fe72ac6380b685b970a0137838e5baace26205,1,Jaimin Jetly,2013-06-13 00:48:09+00:00,['5dba5e919254acf1f75d7c91710668cd8f2b3e4b'],5,13,18,14972428,2,0.666666667,1,1,10424
07fa714832ea947e8c5b74a375f2b0e579a27149,1,Mahadev Konar,2013-06-13 00:59:48+00:00,['15fe72ac6380b685b970a0137838e5baace26205'],0,3,3,14972431,1,,,,10424
9bf66dd892409c2f8d251443f25d25252fc508cf,1,Mahadev Konar,2013-06-13 01:00:00+00:00,['07fa714832ea947e8c5b74a375f2b0e579a27149'],0,44,44,14972475,1,,,,10425
79a23ca7abc0aad8799b715e8eb462753a0414a9,1,Yusaku Sako,2013-06-13 01:26:35+00:00,['9bf66dd892409c2f8d251443f25d25252fc508cf'],3,3,6,14972481,1,0,0,0,10425
2292519042ac41cbec6cdd5967b4b9980d78c3bb,1,Mahadev Konar,2013-06-13 03:37:35+00:00,['79a23ca7abc0aad8799b715e8eb462753a0414a9'],5,23,28,14972509,2,0,1,0.818181818,10425
968c9a9840ab02890621d36ce2176b751d5a7396,1,Yusaku Sako,2013-06-13 17:14:10+00:00,['2292519042ac41cbec6cdd5967b4b9980d78c3bb'],22,80,102,14972611,6,0.698113208,1,1,10425
70c7852b7bf56eb97ef7adaf2f422c7ade0e19fd,1,Yusaku Sako,2013-06-13 17:17:23+00:00,['968c9a9840ab02890621d36ce2176b751d5a7396'],7,30,37,14972648,4,1,1,1,10425
b90a20866ed9841097a33abd8486db256fdb4d39,1,Mahadev Konar,2013-06-13 18:52:44+00:00,['70c7852b7bf56eb97ef7adaf2f422c7ade0e19fd'],1470,2028,3498,14976146,7,0.356796117,0.468446602,0.339805825,10425
5e79481e9d7e55aa523f9850453931ffb44f681b,1,Siddharth Wagle,2013-06-14 00:37:22+00:00,['b90a20866ed9841097a33abd8486db256fdb4d39'],3274,1742,5016,14981162,19,0.344308561,0.587958608,0.8579492,10435
8382f541dc7b9d644924200b1da789f81e8d4aa7,0,Siddharth Wagle,2013-06-14 00:47:36+00:00,['5e79481e9d7e55aa523f9850453931ffb44f681b'],137,108,245,14981407,2,0.72972973,1,0,10435
9520464a0ed0c2dc7391448bd031bbaaac011a19,1,Siddharth Wagle,2013-06-14 00:52:29+00:00,['8382f541dc7b9d644924200b1da789f81e8d4aa7'],5,47,52,14981459,2,0,0,0.615384615,10435
f3271759d3f8de23388296f9292e5945f7d04818,0,Siddharth Wagle,2013-06-14 00:54:36+00:00,['9520464a0ed0c2dc7391448bd031bbaaac011a19'],7,43,50,14981509,4,1,1,1,10436
01fda0811dac6b204e4a30bd2c11a4774b3ca509,0,Siddharth Wagle,2013-06-14 00:57:07+00:00,['f3271759d3f8de23388296f9292e5945f7d04818'],0,4,4,14981513,1,0,1,1,10436
a6db0cb505cb9dd5b224cd7ebd9b3ad67f6b3c03,0,Yusaku Sako,2013-06-14 01:25:45+00:00,['01fda0811dac6b204e4a30bd2c11a4774b3ca509'],1,1,2,14981515,1,1,1,1,10436
166836fb77d17ea62f904af068ccdf18c5c59cce,1,Jaimin Jetly,2013-06-14 01:27:08+00:00,['a6db0cb505cb9dd5b224cd7ebd9b3ad67f6b3c03'],96,88,184,14981699,8,0.210526316,1,1,10436
1d2b11f037153079222f900f44c79e53258ea2db,1,Siddharth Wagle,2013-06-14 01:48:35+00:00,['166836fb77d17ea62f904af068ccdf18c5c59cce'],3,14,17,14981716,2,0.727272727,1,0.727272727,10436
c8f612ab655b6340a40f9f398cd385a9cd7495f3,1,Nate Cole,2013-06-14 01:52:46+00:00,['1d2b11f037153079222f900f44c79e53258ea2db'],1,4,5,14981721,2,,,,10436
7e3f6278f62c27c165eb8c90b4c2a54b0796c5f9,1,Siddharth Wagle,2013-06-14 17:23:26+00:00,['c8f612ab655b6340a40f9f398cd385a9cd7495f3'],9,9,18,14981739,1,,,,10436
ef546ca73e69c3c8b08bd4d5afde60adf1063f3f,0,Siddharth Wagle,2013-06-14 17:24:08+00:00,['7e3f6278f62c27c165eb8c90b4c2a54b0796c5f9'],11,1,12,14981751,1,1,1,0,10436
d0096223b9be30c2d763b78641a1318e345a8df3,1,Siddharth Wagle,2013-06-14 17:33:52+00:00,['ef546ca73e69c3c8b08bd4d5afde60adf1063f3f'],6,45,51,14981802,2,0.419354839,1,0.387096774,10436
17ee15da23286032c2dd0e614cda4095860a2db8,1,Siddharth Wagle,2013-06-14 17:36:17+00:00,['d0096223b9be30c2d763b78641a1318e345a8df3'],2,2,4,14981806,1,,,,10436
a06fa23e5ac882d22b019fd005f61ccfed1c9287,0,Siddharth Wagle,2013-06-14 17:38:17+00:00,['17ee15da23286032c2dd0e614cda4095860a2db8'],0,1,1,14981807,1,,,,10436
f31ccf5ef8141762c2ef386662a77097b67cda33,1,Siddharth Wagle,2013-06-14 17:44:03+00:00,['a06fa23e5ac882d22b019fd005f61ccfed1c9287'],26,108,134,14981941,6,0.327272727,0.836363636,0.509090909,10436
7ca693fddb971b640ce8f8bb3ff4045549482899,1,Jaimin Jetly,2013-06-14 17:48:49+00:00,['f31ccf5ef8141762c2ef386662a77097b67cda33'],15,18,33,14981974,1,1,1,1,10436
725e2b61ac3b96b8ba30298b9381661dfca729be,1,Siddharth Wagle,2013-06-14 17:49:31+00:00,['7ca693fddb971b640ce8f8bb3ff4045549482899'],31,182,213,14982187,9,0.533333333,0.980952381,0.79047619,10436
4e47819e3be89d3468a0afb48d9efcf849554b8a,1,Yusaku Sako,2013-06-14 17:50:32+00:00,['725e2b61ac3b96b8ba30298b9381661dfca729be'],57,72,129,14982316,1,1,1,1,10436
787da8f09da79cc4a5b5c75bc9979f06a775c64f,1,Siddharth Wagle,2013-06-14 17:51:12+00:00,['4e47819e3be89d3468a0afb48d9efcf849554b8a'],3,40,43,14982359,3,0.4,1,0.44,10436
c97fc05f77f6380da40a40fae80fe06422646ebc,1,Yusaku Sako,2013-06-14 17:52:37+00:00,['787da8f09da79cc4a5b5c75bc9979f06a775c64f'],291,41,332,14982691,13,0.242990654,0.14953271,0,10436
b35d4d881d4dd2437f1e5254ccf4a1d7bec905da,1,Yusaku Sako,2013-06-14 18:03:34+00:00,['c97fc05f77f6380da40a40fae80fe06422646ebc'],399,646,1045,14983736,37,0.58041958,0.734265734,0.692307692,10445
290743a70fce31270284a84c1ccfdc57f95fc328,1,Siddharth Wagle,2013-06-14 19:12:41+00:00,['b35d4d881d4dd2437f1e5254ccf4a1d7bec905da'],14,14,28,14983764,1,0,0,,10445
f4e29aa4e1f233e3f2508114341c358200bb662f,1,Siddharth Wagle,2013-06-15 00:28:27+00:00,['290743a70fce31270284a84c1ccfdc57f95fc328'],15,392,407,14984171,2,0.111570248,0.855371901,0.033057851,10445
e4f576df19494b40071011438a364e3f6a33730d,0,Tom Beerbower,2013-06-15 00:43:32+00:00,['f4e29aa4e1f233e3f2508114341c358200bb662f'],36,479904,479940,15464111,6,0.209302326,0.8,0.772093023,10446
2a149112bb15091c8d5877160f098adf7639d5fc,1,Tom Beerbower,2013-06-15 01:18:34+00:00,['e4f576df19494b40071011438a364e3f6a33730d'],479904,36,479940,15944051,6,0.790697674,0.2,0.227906977,10446
3b8d2464ce62a847018bda627b5edb162931c571,1,Jaimin Jetly,2013-06-17 07:29:35+00:00,['2a149112bb15091c8d5877160f098adf7639d5fc'],58,88,146,15944197,6,0.377777778,0.4,1,10446
1f906f70200a255aecde4e2b96cbec0d277cbb27,0,Jaimin Jetly,2013-06-17 07:31:49+00:00,['3b8d2464ce62a847018bda627b5edb162931c571'],2,2,4,15944201,2,,,,10446
461eecba8d78eb0d6a0dcb506722c9b650ee464d,1,Yusaku Sako,2013-06-17 18:55:40+00:00,['1f906f70200a255aecde4e2b96cbec0d277cbb27'],95,222,317,15944518,11,0.727272727,0.818181818,1,10446
fd702592787f820888566a5e39ebdaecf9e748f8,1,Tom Beerbower,2013-06-17 19:46:34+00:00,['461eecba8d78eb0d6a0dcb506722c9b650ee464d'],1058,994,2052,15946570,12,1,0.1875,0,10446
1b623274c3790265aa755ca57d0be1ec9ef114cf,1,Yusaku Sako,2013-06-17 21:20:43+00:00,['fd702592787f820888566a5e39ebdaecf9e748f8'],4,20,24,15946594,2,0,1,1,10446
6f1661b45c927daad2ee83a3d5b77cf2ea8fb903,1,Jaimin Jetly,2013-06-17 21:35:20+00:00,['1b623274c3790265aa755ca57d0be1ec9ef114cf'],7,3,10,15946604,2,1,1,1,10446
df0de09dafecdc1ad895709bba23daed3c621004,0,Jaimin Jetly,2013-06-18 00:03:55+00:00,['6f1661b45c927daad2ee83a3d5b77cf2ea8fb903'],6,20,26,15946630,8,,,,10446
4dd6f8853f86faf2344801cf06e87fd5505b79b2,1,Mahadev Konar,2013-06-18 03:40:42+00:00,['df0de09dafecdc1ad895709bba23daed3c621004'],1,1,2,15946632,1,,,,10446
02d659fc7425603f00ddcbc0114fe78f72f1a3d8,1,Mahadev Konar,2013-06-18 05:48:58+00:00,['4dd6f8853f86faf2344801cf06e87fd5505b79b2'],0,2,2,15946634,1,,,,10446
f4f27333b8efec7f160607174cfe02bcd7dd1404,1,Nate Cole,2013-06-18 20:04:04+00:00,['02d659fc7425603f00ddcbc0114fe78f72f1a3d8'],58,497,555,15947189,8,0.110204082,0.6,0.636734694,10447
07de9178a549244814baca54443176092ef1f08a,1,Siddharth Wagle,2013-06-18 20:58:54+00:00,['f4f27333b8efec7f160607174cfe02bcd7dd1404'],28,370,398,15947587,6,0.196153846,0.746153846,0.453846154,10447
8c54e9d9186be19ee856edd86f17c47d3cabba2f,1,Siddharth Wagle,2013-06-18 21:00:42+00:00,['07de9178a549244814baca54443176092ef1f08a'],91,228,319,15947906,7,0,0.2625,0.7625,10447
be1d871d1de0a28b10fdcb1440456db7eb84e690,0,Siddharth Wagle,2013-06-18 21:02:02+00:00,['8c54e9d9186be19ee856edd86f17c47d3cabba2f'],0,15,15,15947921,1,0,0,1,10447
e79a794d155d58a83e4da3b3c769d54542ccf73b,1,Yusaku Sako,2013-06-18 23:43:38+00:00,['be1d871d1de0a28b10fdcb1440456db7eb84e690'],2,21,23,15947944,2,,,,10447
437e75cde988c67112df82344bbeffdd606fe4b1,1,Yusaku Sako,2013-06-18 23:48:05+00:00,['e79a794d155d58a83e4da3b3c769d54542ccf73b'],137,340,477,15948421,6,1,1,1,10448
65504cfdf48b9cc8c8a766fa94f346e6c96f2aa8,0,Yusaku Sako,2013-06-18 23:50:13+00:00,['437e75cde988c67112df82344bbeffdd606fe4b1'],1,1,2,15948423,1,,,,10448
6ea2d179b92565bcdb7f164d5e3652d93e28dd84,0,Yusaku Sako,2013-06-18 23:52:35+00:00,['65504cfdf48b9cc8c8a766fa94f346e6c96f2aa8'],1,1,2,15948425,1,,,,10448
74b33bd0f105a5933b1df6b1c1ea6ad387cbf459,0,Yusaku Sako,2013-06-18 23:56:21+00:00,['6ea2d179b92565bcdb7f164d5e3652d93e28dd84'],13,12,25,15948450,1,,,,10448
3d3ae0dc84fdab975d513ed91b50fa9dcfb8af57,0,Yusaku Sako,2013-06-18 23:59:54+00:00,['74b33bd0f105a5933b1df6b1c1ea6ad387cbf459'],1,2,3,15948453,2,1,1,1,10448
2c71028e3beea1282a11b78d1fa7695ff9c8cf18,0,Yusaku Sako,2013-06-19 00:02:42+00:00,['3d3ae0dc84fdab975d513ed91b50fa9dcfb8af57'],9,9,18,15948471,5,,,,10448
7d3753affefbc8a20f4bec32627cca153c2d2432,1,Yusaku Sako,2013-06-19 00:04:37+00:00,['2c71028e3beea1282a11b78d1fa7695ff9c8cf18'],39,59,98,15948569,5,0,1,1,10448
a7f61bfecd9b174c75f1d936dbc226a10d0d465b,0,Sumit Mohanty,2013-06-19 00:53:49+00:00,['7d3753affefbc8a20f4bec32627cca153c2d2432'],15,43,58,15948627,1,0,1,1,10448
909aa7e2c6f2c16934f83df5ce0c252a76a035f4,1,Siddharth Wagle,2013-06-19 03:01:19+00:00,['a7f61bfecd9b174c75f1d936dbc226a10d0d465b'],32,88,120,15948747,8,0.045454545,0,1,10448
547df2dd02224dbc70480617c7d662f526e70712,1,Siddharth Wagle,2013-06-19 03:02:00+00:00,['909aa7e2c6f2c16934f83df5ce0c252a76a035f4'],0,140,140,15948887,1,0.25,1,1,10449
2ffbfc33373d80a3d1202780e6006dfab14841c3,1,Yusaku Sako,2013-06-19 03:17:15+00:00,['547df2dd02224dbc70480617c7d662f526e70712'],13,43,56,15948943,3,0.333333333,1,1,10449
8ec328ce991f0de668321e438603da05d2ef12d3,1,Yusaku Sako,2013-06-19 04:17:46+00:00,['2ffbfc33373d80a3d1202780e6006dfab14841c3'],1,1,2,15948945,1,,,,10449
227ea5408da9b8787e034a517ea63257aa6ff747,1,Siddharth Wagle,2013-06-19 04:47:24+00:00,['8ec328ce991f0de668321e438603da05d2ef12d3'],0,1,1,15948946,1,,,,10449
3db55e593ea6e3e8eb26dc00866bfb40c02a09df,0,Siddharth Wagle,2013-06-19 05:48:24+00:00,['227ea5408da9b8787e034a517ea63257aa6ff747'],1,0,1,15948947,1,1,0,0,10449
a14a95011307876ed4315aade3094a5a409821d1,1,Tom Beerbower,2013-06-19 09:44:23+00:00,['3db55e593ea6e3e8eb26dc00866bfb40c02a09df'],994,1058,2052,15950999,12,0,0.8125,1,10451
d4e928b61bdd6ced47893ec1658efc63a55b1009,1,Jaimin Jetly,2013-06-19 18:03:45+00:00,['a14a95011307876ed4315aade3094a5a409821d1'],0,2,2,15951001,1,0,0,1,10451
8f79c64f9105b4de048b28ae931894453eb6d80e,0,Siddharth Wagle,2013-06-19 21:28:38+00:00,['d4e928b61bdd6ced47893ec1658efc63a55b1009'],1,1,2,15951003,1,,,,10451
4f1b67918955623126d4fc78ea3b3570bdbab25c,0,Srimanth,2013-06-19 22:35:57+00:00,['8f79c64f9105b4de048b28ae931894453eb6d80e'],11,2,13,15951016,1,0,0.75,0,10451
3e619d3ff96a4d16a9e80af172bd8d54e5b0ba43,1,Siddharth Wagle,2013-06-19 23:20:33+00:00,['4f1b67918955623126d4fc78ea3b3570bdbab25c'],1,1,2,15951018,1,,,,10451
325b13608f5a0c2db10181da3a2ffe05c0f461c4,1,Yusaku Sako,2013-06-20 00:49:05+00:00,['3e619d3ff96a4d16a9e80af172bd8d54e5b0ba43'],5,7,12,15951030,1,,,,10451
fc4790c73db33e6f066c14f31ac77db2ad48812f,1,Siddharth Wagle,2013-06-20 01:02:32+00:00,['325b13608f5a0c2db10181da3a2ffe05c0f461c4'],33,107,140,15951170,2,0,1,0.065217391,10451
bd1aa86a143bd8c2e9b5bf248381cf0ff2659688,1,Tom Beerbower,2013-06-20 18:09:29+00:00,['fc4790c73db33e6f066c14f31ac77db2ad48812f'],84,536380,536464,16487634,65,0.406862745,0.470588235,0.926470588,10483
ed1289e4f473bd281f5a4ee019fcd2486cd7d3ba,0,Sumit Mohanty,2013-06-20 19:51:50+00:00,['bd1aa86a143bd8c2e9b5bf248381cf0ff2659688'],18,140,158,16487792,2,0.18627451,0.009803922,0.490196078,10483
8916dd54931c04f866730dcaa89336f6da11d920,1,Sumit Mohanty,2013-06-20 20:47:09+00:00,['ed1289e4f473bd281f5a4ee019fcd2486cd7d3ba'],140,18,158,16487950,2,0.81372549,0.990196078,0.509803922,10483
e9fd10e3bd8cf3efe4db95683dbd73de0519b8de,0,Sumit Mohanty,2013-06-20 20:52:04+00:00,['8916dd54931c04f866730dcaa89336f6da11d920'],0,52,52,16488002,4,,,,10484
e8c5bf94a63c65e74646f6f6de960caee383a06d,1,Sumit Mohanty,2013-06-20 20:54:44+00:00,['e9fd10e3bd8cf3efe4db95683dbd73de0519b8de'],9,18,27,16488029,2,0,0,1,10484
e215a9ee453e05e71e872c11a6efd52822ad25a9,0,Sumit Mohanty,2013-06-20 20:56:35+00:00,['e8c5bf94a63c65e74646f6f6de960caee383a06d'],2,2,4,16488033,1,,,,10484
401d0bb400bef31993fec554425db61f8a234f06,1,Sumit Mohanty,2013-06-20 20:59:09+00:00,['e215a9ee453e05e71e872c11a6efd52822ad25a9'],9,304,313,16488346,2,0,0.68877551,0.505102041,10484
db47b2d00a36c90e79d9d1866da30f0082b1779d,1,Sumit Mohanty,2013-06-20 21:30:08+00:00,['401d0bb400bef31993fec554425db61f8a234f06'],18,148,166,16488512,2,0.196261682,0.056074766,0.46728972,10484
e0ce9f31818e6ca4e1f60a1ca77b8cc3aa152c83,1,Yusaku Sako,2013-06-20 22:53:44+00:00,['db47b2d00a36c90e79d9d1866da30f0082b1779d'],9,17,26,16488538,9,1,1,1,10484
6aa3319fd7d20d4f35b1bcaa166c7792bcee7c06,1,Yusaku Sako,2013-06-20 22:56:50+00:00,['e0ce9f31818e6ca4e1f60a1ca77b8cc3aa152c83'],1,1,2,16488540,1,,,,10484
26e883fd709baf2c8043d11216da2f8d349091dd,1,Yusaku Sako,2013-06-20 22:59:35+00:00,['6aa3319fd7d20d4f35b1bcaa166c7792bcee7c06'],0,2,2,16488542,1,,,,10484
c3c41562671694c2444bb398e63f97f7c96cd44e,0,Yusaku Sako,2013-06-20 23:07:39+00:00,['26e883fd709baf2c8043d11216da2f8d349091dd'],2,2,4,16488546,1,,,,10484
1abc317b029ca6f6dc6a61c1c99529182c789dbf,0,Yusaku Sako,2013-06-20 23:09:01+00:00,['c3c41562671694c2444bb398e63f97f7c96cd44e'],2,7,9,16488555,2,1,1,1,10484
f91741598d4754edc8534a964042c222c1a7bfeb,1,Yusaku Sako,2013-06-20 23:09:46+00:00,['1abc317b029ca6f6dc6a61c1c99529182c789dbf'],0,338,338,16488893,4,0.459349593,1,1,10488
736266c67e2c9d2a0656814a44c60e22f6989da2,1,Srimanth,2013-06-20 23:47:19+00:00,['f91741598d4754edc8534a964042c222c1a7bfeb'],2,9,11,16488904,1,1,1,1,10488
561006e2432e12f7227f10ba0f26fe5245016af6,1,Nate Cole,2013-06-21 13:52:45+00:00,['736266c67e2c9d2a0656814a44c60e22f6989da2'],3,45,48,16488952,3,0,0,0.964285714,10488
4e063f58c238731cf1c6edb323d12cf06a31d0dd,1,Jaimin Jetly,2013-06-21 17:49:02+00:00,['561006e2432e12f7227f10ba0f26fe5245016af6'],6,10,16,16488968,2,,,,10488
6bfe2bb78cc19d42f78684173c08e305b52315e9,1,Jaimin Jetly,2013-06-21 17:59:14+00:00,['4e063f58c238731cf1c6edb323d12cf06a31d0dd'],12,117,129,16489097,8,0.680555556,0.611111111,1,10488
e042472713e07c50fea0af542bf2533288e4eb01,0,Sumit Mohanty,2013-06-21 22:20:30+00:00,['6bfe2bb78cc19d42f78684173c08e305b52315e9'],1,20,21,16489118,2,1,0,0,10488
b49b75314bc105f77ef29d4459a94d9b61b98719,1,Sumit Mohanty,2013-06-21 22:23:18+00:00,['e042472713e07c50fea0af542bf2533288e4eb01'],27,119,146,16489264,2,0,0.651515152,0.090909091,10488
00d618d5668a3654648bcd9e7dbe022aa8f82d25,1,Sumit Mohanty,2013-06-21 22:33:43+00:00,['b49b75314bc105f77ef29d4459a94d9b61b98719'],65,198,263,16489527,2,0.011627907,0.953488372,0.220930233,10488
e6213df1c30a13f3356f21d64da1eeab2d355ef1,1,Srimanth,2013-06-21 22:41:06+00:00,['00d618d5668a3654648bcd9e7dbe022aa8f82d25'],0,160,160,16489687,1,,,,10489
9d1fa02ef202818de0b92a0b730015be2d4d95dc,1,Siddharth Wagle,2013-06-21 23:18:58+00:00,['e6213df1c30a13f3356f21d64da1eeab2d355ef1'],99,146,245,16489932,3,0.037037037,0,0.851851852,10489
5113a33d9ab5ffb650e3b3a955ba54c6d7976f41,1,Yusaku Sako,2013-06-21 23:55:31+00:00,['9d1fa02ef202818de0b92a0b730015be2d4d95dc'],6,7,13,16489945,2,,,,10489
7ac80e482c1a1ac6c333c720606df2b98327da85,1,Yusaku Sako,2013-06-21 23:59:26+00:00,['5113a33d9ab5ffb650e3b3a955ba54c6d7976f41'],1189,32,1221,16491166,28,0,0,0,10489
a1d35b48b0bd65f9e681427216c996f11f9b4379,1,Jaimin Jetly,2013-06-22 00:28:11+00:00,['7ac80e482c1a1ac6c333c720606df2b98327da85'],2,2,4,16491170,1,,,,10489
46c6b299aa70b152a1a8c8f2f5a0669444a8db7f,1,Jaimin Jetly,2013-06-22 00:38:22+00:00,['a1d35b48b0bd65f9e681427216c996f11f9b4379'],61,63,124,16491294,8,1,0,,10489
3c717e665397a4127bbb1ad6c7045e935049bf6b,0,Jaimin Jetly,2013-06-22 01:06:41+00:00,['46c6b299aa70b152a1a8c8f2f5a0669444a8db7f'],7,11,18,16491312,2,,,,10489
f1c399cf502211ad04611b805d212dcdb827c8eb,1,Yusaku Sako,2013-06-22 01:23:16+00:00,['3c717e665397a4127bbb1ad6c7045e935049bf6b'],50,205,255,16491567,8,0.337209302,0.104651163,1,10489
50f84846a60defb958bb8803f113a40d077c4c11,0,Sumit Mohanty,2013-06-22 01:39:23+00:00,['f1c399cf502211ad04611b805d212dcdb827c8eb'],1,1,2,16491569,1,,,,10489
3ec47dc9cf1bb4b43006e4c4f6ca234d9906cd04,1,Mahadev Konar,2013-06-22 23:56:41+00:00,['50f84846a60defb958bb8803f113a40d077c4c11'],21,51,72,16491641,2,1,1,0.85,10489
77befe9371bd5d464b69573516f160fd542d026a,1,Mahadev Konar,2013-06-24 04:59:02+00:00,['3ec47dc9cf1bb4b43006e4c4f6ca234d9906cd04'],1,44,45,16491686,2,0,0.28125,1,10489
5963247395f2abd437beb0314b4347a03c2f125f,1,Siddharth Wagle,2013-06-24 17:13:20+00:00,['77befe9371bd5d464b69573516f160fd542d026a'],4,8,12,16491698,1,0,1,0,10489
b617ceef5b96d86c83d15d1613cbbd8e7d0cd2f4,1,Yusaku Sako,2013-06-24 20:00:41+00:00,['5963247395f2abd437beb0314b4347a03c2f125f'],167,265,432,16492130,8,0.775862069,0.775862069,1,10489
0630916b8a157becf4241c4cf1ef653723aadbc5,0,Yusaku Sako,2013-06-24 20:11:33+00:00,['b617ceef5b96d86c83d15d1613cbbd8e7d0cd2f4'],14,15,29,16492159,4,,,,10489
558ae80f740b395d218683ee7147151a3290a230,1,Yusaku Sako,2013-06-26 02:34:51+00:00,['0630916b8a157becf4241c4cf1ef653723aadbc5'],0,14,14,16492173,1,,,,10489
67ebae8243fd26537912e21875330f69bc165fae,1,Yusaku Sako,2013-06-26 02:40:44+00:00,['558ae80f740b395d218683ee7147151a3290a230'],11,31,42,16492215,4,0,0,1,10489
5a60d9322b7df01e520a1dad55cc111dfdc00177,0,Yusaku Sako,2013-06-26 02:42:20+00:00,['67ebae8243fd26537912e21875330f69bc165fae'],0,8,8,16492223,1,1,1,1,10489
c7c75bec4f52b399df3f1617f4cea96b0b872ca2,1,Yusaku Sako,2013-06-26 02:45:08+00:00,['5a60d9322b7df01e520a1dad55cc111dfdc00177'],1,2,3,16492226,1,1,1,1,10489
5b28abbef6e6eac39bc7f05cb3b9463b84a9c2dc,1,Siddharth Wagle,2013-06-26 05:14:39+00:00,['c7c75bec4f52b399df3f1617f4cea96b0b872ca2'],9,16,25,16492251,2,0,0.285714286,0.714285714,10489
dadd0c92261ab60fd357bff35e9505d3ac610408,1,Siddharth Wagle,2013-06-26 05:16:20+00:00,['5b28abbef6e6eac39bc7f05cb3b9463b84a9c2dc'],32,26,58,16492309,3,1,0.666666667,0.333333333,10489
50513297217fe1352b01b00cefa82c5fffba13e5,1,Mahadev Konar,2013-06-26 19:03:33+00:00,['dadd0c92261ab60fd357bff35e9505d3ac610408'],18,71,89,16492398,6,0.352941176,1,1,10489
36800ada6a664cbc1697864c2345c0039332bd85,0,Mahadev Konar,2013-06-26 19:07:29+00:00,['50513297217fe1352b01b00cefa82c5fffba13e5'],2,6,8,16492406,2,,,,10489
df25ce8ca2e223b9e7f3dab4debbf41f21db8890,1,Mahadev Konar,2013-06-26 19:32:19+00:00,['36800ada6a664cbc1697864c2345c0039332bd85'],5,67,72,16492478,2,0.108108108,0.783783784,0.324324324,10489
ee28a00ad1158690cbbf398b62da7df2ffcdb4f6,1,Mahadev Konar,2013-06-26 19:46:38+00:00,['df25ce8ca2e223b9e7f3dab4debbf41f21db8890'],3,3,6,16492484,1,,,,10489
3838ade4caba74dbcacc42bdc8830774629dafa9,1,Yusaku Sako,2013-06-26 21:19:10+00:00,['ee28a00ad1158690cbbf398b62da7df2ffcdb4f6'],20,386,406,16492890,7,0.638513514,0.797297297,0.952702703,10490
ec1a7eb6a6cae83d5f301bfec43e634181de3ece,1,Mahadev Konar,2013-06-26 21:21:03+00:00,['3838ade4caba74dbcacc42bdc8830774629dafa9'],1,1,2,16492892,1,,,,10490
7794f67b963f5883cf1026adf37be3201a3a87a3,1,Yusaku Sako,2013-06-26 21:27:23+00:00,['ec1a7eb6a6cae83d5f301bfec43e634181de3ece'],1,1,2,16492894,1,,,,10490
ea2a9fb8e7d1a1dd632c87747a639df81d2c85eb,1,Yusaku Sako,2013-06-26 21:32:33+00:00,['7794f67b963f5883cf1026adf37be3201a3a87a3'],22,55,77,16492971,3,0.965517241,1,0.965517241,10490
363a45a9e19226f8e35984191ac5361182499a41,1,Yusaku Sako,2013-06-26 21:40:09+00:00,['ea2a9fb8e7d1a1dd632c87747a639df81d2c85eb'],1,1,2,16492973,1,,,,10490
3a977e23d89bcbc0a0a73c63b412110707427f97,0,Siddharth Wagle,2013-06-27 04:21:24+00:00,['363a45a9e19226f8e35984191ac5361182499a41'],1,5,6,16492979,1,0,1,1,10490
72d6438196c3c5a0ec84df5636faa5a08c9db732,1,Jaimin Jetly,2013-06-27 09:11:39+00:00,['3a977e23d89bcbc0a0a73c63b412110707427f97'],69,154,223,16493202,2,0.285714286,1,1,10490
c0fc10eab2d863a401fa11f3527da09dcceb1980,1,Yusaku Sako,2013-06-27 12:30:39+00:00,['72d6438196c3c5a0ec84df5636faa5a08c9db732'],0,266,266,16493468,3,0.824675325,1,1,10493
d2d4bb109571e0cd3541bedcf588c14c7f31bf38,1,Yusaku Sako,2013-06-27 13:01:02+00:00,['c0fc10eab2d863a401fa11f3527da09dcceb1980'],15,44,59,16493527,4,0.263157895,0.263157895,1,10493
d9cb901c157b635cfe1dd86f3ad871fa71845169,1,Mahadev Konar,2013-06-27 14:38:15+00:00,['d2d4bb109571e0cd3541bedcf588c14c7f31bf38'],19,11,30,16493557,2,1,1,0,10493
0d99aeb38f167e922c5a2db58ba70b57e7081cca,1,Nate Cole,2013-06-27 17:20:48+00:00,['d9cb901c157b635cfe1dd86f3ad871fa71845169'],2,7,9,16493566,1,0,0,1,10493
28ebbafbc422be37d07fcf4b13fce96bab1797d4,1,Mahadev Konar,2013-06-27 17:53:26+00:00,['0d99aeb38f167e922c5a2db58ba70b57e7081cca'],11,20,31,16493597,3,0,1,0,10493
eb5f09c8b637835e7b836b5a08ba469df7078d16,1,Mahadev Konar,2013-06-27 18:16:06+00:00,['28ebbafbc422be37d07fcf4b13fce96bab1797d4'],20,83,103,16493700,2,0.219512195,1,0.414634146,10493
195da71985e1ec002c86e488334c9d20a9658e40,1,Jaimin Jetly,2013-06-27 19:10:24+00:00,['eb5f09c8b637835e7b836b5a08ba469df7078d16'],21,2,23,16493723,4,,,,10493
09ec93ea84c398ad23f3640649df3195d510113e,1,Nate Cole,2013-06-27 21:12:35+00:00,['195da71985e1ec002c86e488334c9d20a9658e40'],22,89,111,16493834,9,0.388888889,0.555555556,0.722222222,10493
ae46ee6510c95be226b01e22f8a876d3b8d9bba4,1,Nate Cole,2013-06-27 21:14:31+00:00,['09ec93ea84c398ad23f3640649df3195d510113e'],4,25,29,16493863,1,,,,10493
8443bc66d9fcfb6773492708c7792d2861a09309,1,Jaimin Jetly,2013-06-27 21:43:22+00:00,['ae46ee6510c95be226b01e22f8a876d3b8d9bba4'],32,38,70,16493933,3,,,,10493
b756b5df161016a159e2ffb141571aa5161b9e88,0,Yusaku Sako,2013-06-27 22:49:34+00:00,['8443bc66d9fcfb6773492708c7792d2861a09309'],1,1,2,16493935,1,,,,10493
13c8c5bb5092f4355729415b678f322b46638047,0,Siddharth Wagle,2013-06-28 03:13:41+00:00,['b756b5df161016a159e2ffb141571aa5161b9e88'],13,19,32,16493967,2,,,,10493
e196c58012f93eafc51fa52a7b765403dec8d108,1,Jaimin Jetly,2013-06-28 03:16:42+00:00,['13c8c5bb5092f4355729415b678f322b46638047'],5,2,7,16493974,3,1,1,0,10493
fcb7e0b7499d2df6200653ca582a9837a5a8222f,1,Srimanth,2013-06-28 05:11:28+00:00,['e196c58012f93eafc51fa52a7b765403dec8d108'],2,114,116,16494090,4,0.871794872,0.487179487,1,10493
368800f09968276df5623b7c87eaa48d98ee3495,1,Siddharth Wagle,2013-06-28 07:33:14+00:00,['fcb7e0b7499d2df6200653ca582a9837a5a8222f'],6,18,24,16494114,2,,,,10493
9d488bb5a613fd30c513c5f9c98c6b51afe6aa91,0,Siddharth Wagle,2013-06-28 09:22:23+00:00,['368800f09968276df5623b7c87eaa48d98ee3495'],1,2,3,16494117,1,,,,10493
dda50cba78ca71810cbf19394bab63e16f215076,0,Siddharth Wagle,2013-06-29 01:00:17+00:00,['9d488bb5a613fd30c513c5f9c98c6b51afe6aa91'],1,12,13,16494130,1,0,0,1,10493
cb1c9204f97ec935b9e0bd68030a010985799300,1,Siddharth Wagle,2013-06-30 01:19:16+00:00,['dda50cba78ca71810cbf19394bab63e16f215076'],5,10,15,16494145,3,,,,10493
2b671a163da30ae9693726c0d6e5ce1b9f880ae2,1,Mahadev Konar,2013-06-30 17:12:36+00:00,['cb1c9204f97ec935b9e0bd68030a010985799300'],4,3,7,16494152,1,1,1,0,10493
d4a2b2b9eb0864dd26327c896547868f16a56f6e,0,Sumit Mohanty,2013-07-01 17:38:58+00:00,['2b671a163da30ae9693726c0d6e5ce1b9f880ae2'],2,46,48,16494200,2,1,1,1,10494
e6d55f1cbab726bd88f6941b7ee3f9b28a73cfba,1,Yusaku Sako,2013-07-01 17:58:16+00:00,['d4a2b2b9eb0864dd26327c896547868f16a56f6e'],0,1,1,16494201,1,1,1,1,10494
9a17465077fec25e960879bfb200a707dce3a0f4,1,Yusaku Sako,2013-07-01 18:03:26+00:00,['e6d55f1cbab726bd88f6941b7ee3f9b28a73cfba'],0,4,4,16494205,1,0,0,1,10494
fdf349a6f4fb6554932d2dbbf748f40ba339fa76,1,Siddharth Wagle,2013-07-01 21:22:44+00:00,['9a17465077fec25e960879bfb200a707dce3a0f4'],25,48,73,16494278,2,0,1,0.5,10494
385bd1b8acf215c613e6fd2a9f03495b6a2e70ab,1,Yusaku Sako,2013-07-01 22:44:03+00:00,['fdf349a6f4fb6554932d2dbbf748f40ba339fa76'],17,54,71,16494349,6,,,,10494
2147c13be3c471c2d373d688896272633d9aeb20,0,Siddharth Wagle,2013-07-01 23:07:23+00:00,['385bd1b8acf215c613e6fd2a9f03495b6a2e70ab'],1,1,2,16494351,1,,,,10494
26d853e1210b466f44373c6221ca6cc439ec98af,1,Jaimin Jetly,2013-07-01 23:38:42+00:00,['2147c13be3c471c2d373d688896272633d9aeb20'],0,25,25,16494376,2,0,0,1,10494
15b3c65c907936adbe4e839f31644189f58dcedb,1,Tom Beerbower,2013-07-02 00:14:37+00:00,['26d853e1210b466f44373c6221ca6cc439ec98af'],23,121,144,16494520,6,0,0,1,10494
28270d262c34563ec91e4b2f574308b416a50ed7,0,Yusaku Sako,2013-07-02 00:39:26+00:00,['15b3c65c907936adbe4e839f31644189f58dcedb'],1,1,2,16494522,1,,,,10494
9a5e18dfb0b490c3ea7d121278305e48540b21f1,1,Yusaku Sako,2013-07-02 01:11:28+00:00,['28270d262c34563ec91e4b2f574308b416a50ed7'],55,40,95,16494617,12,1,0,0,10494
e20bc930bb5bce8156ece28ca0fb63b4c47fbaa7,1,Jaimin Jetly,2013-07-02 01:50:01+00:00,['9a5e18dfb0b490c3ea7d121278305e48540b21f1'],11,37,48,16494665,4,0.9,0.9,1,10494
8edfb8e26b9f216517eba8d8579b3f06d9ec39a3,1,Sumit Mohanty,2013-07-02 02:28:00+00:00,['e20bc930bb5bce8156ece28ca0fb63b4c47fbaa7'],18,18,36,16494701,3,,,,10494
f6ee76b0a8dd7e595fdd9988754950c59cdf0291,1,Sumit Mohanty,2013-07-02 06:19:44+00:00,['8edfb8e26b9f216517eba8d8579b3f06d9ec39a3'],213,1586,1799,16496500,18,0.415819209,0.816949153,0.592090395,10498
92f9b0c21d6f77e6959557a52765cdecf6525048,1,Sumit Mohanty,2013-07-02 06:32:29+00:00,['f6ee76b0a8dd7e595fdd9988754950c59cdf0291'],52,9,61,16496561,2,,,,10498
bf2915c9e18aec124caa3ba6a8ba8eed68bb91fa,1,Jaimin Jetly,2013-07-02 07:18:18+00:00,['92f9b0c21d6f77e6959557a52765cdecf6525048'],1,1,2,16496563,1,,,,10498
9d862ebff775fadfe99d8ef4a07b5d9f73682e4c,1,Srimanth,2013-07-02 09:56:28+00:00,['bf2915c9e18aec124caa3ba6a8ba8eed68bb91fa'],250,298,548,16497111,5,0,0.444444444,1,10498
499add6929538cfd59ca1f86db6e6b57c20a5561,1,Mahadev Konar,2013-07-02 15:25:53+00:00,['9d862ebff775fadfe99d8ef4a07b5d9f73682e4c'],87,150,237,16497348,2,0.035087719,0.578947368,0.456140351,10498
e6243e34026bfbf0bd30a8f837dc59849ee4b03f,1,Mahadev Konar,2013-07-02 17:10:50+00:00,['499add6929538cfd59ca1f86db6e6b57c20a5561'],108,436,544,16497892,4,0.259541985,0.984732824,0.324427481,10498
2db1b45b07e480eeb8c66edcd11b5268c6ba501b,1,Srimanth,2013-07-02 17:32:07+00:00,['e6243e34026bfbf0bd30a8f837dc59849ee4b03f'],32,51,83,16497975,3,0,0,1,10498
63fdd28e13264456843f6825425ad86ad3b96c1c,1,Jaimin Jetly,2013-07-02 18:15:47+00:00,['2db1b45b07e480eeb8c66edcd11b5268c6ba501b'],8,11,19,16497994,2,1,1,1,10498
435acee5b108ecca1608cadba0496944d13e2fc3,1,Nate Cole,2013-07-02 18:38:12+00:00,['63fdd28e13264456843f6825425ad86ad3b96c1c'],1,1,2,16497996,1,,,,10498
33fdaf0b3b1953bf0ec621462aa94c563fbd1d2c,1,Jaimin Jetly,2013-07-02 18:54:22+00:00,['435acee5b108ecca1608cadba0496944d13e2fc3'],0,25,25,16498021,3,0,0,1,10498
aabe29bcf817c7d3f306f5cc617e0132637831c0,1,Mahadev Konar,2013-07-02 21:00:08+00:00,['33fdaf0b3b1953bf0ec621462aa94c563fbd1d2c'],3,6,9,16498030,1,,,,10498
91ff4039580142f73289e966837c8dfef516b52f,0,Mahadev Konar,2013-07-02 21:10:16+00:00,['aabe29bcf817c7d3f306f5cc617e0132637831c0'],2,2,4,16498034,1,,,,10498
4667ca45f28995ff288a8bbb7e58a0e5749b6b27,1,Srimanth,2013-07-02 22:00:00+00:00,['91ff4039580142f73289e966837c8dfef516b52f'],63,1304,1367,16499401,11,0.772727273,0.781818182,1,10499
8d0d34dbb6e13212f750b4a5ad9eee90e2b9e4bf,1,Nate Cole,2013-07-02 23:19:03+00:00,['4667ca45f28995ff288a8bbb7e58a0e5749b6b27'],242,163,405,16499806,8,1,1,0.769230769,10499
6360d16862fb64e560094cf9897438af1574c8f5,1,Srimanth,2013-07-03 00:26:56+00:00,['8d0d34dbb6e13212f750b4a5ad9eee90e2b9e4bf'],56,311,367,16500173,8,0.427807487,1,1,10501
b8a6707b6a51513f0f187a2ad5127a0968a557f9,1,Srimanth,2013-07-03 01:34:03+00:00,['6360d16862fb64e560094cf9897438af1574c8f5'],0,152,152,16500325,3,0.5,0.5,0.725,10501
799f458bb48f7dd665005bd1e1d0a8bb997e2843,1,Sumit Mohanty,2013-07-03 16:46:33+00:00,['b8a6707b6a51513f0f187a2ad5127a0968a557f9'],6,48,54,16500379,2,0.043478261,0.913043478,0.956521739,10501
5eba9cb1a59fb2b37871895d57ac2c031fab5119,1,Sumit Mohanty,2013-07-03 16:54:25+00:00,['799f458bb48f7dd665005bd1e1d0a8bb997e2843'],0,9,9,16500388,1,,,,10501
93479c9d25ebe59de23b8a316591d8dd39389445,1,Sumit Mohanty,2013-07-03 17:21:29+00:00,['5eba9cb1a59fb2b37871895d57ac2c031fab5119'],13,91,104,16500492,4,0.25,0.35,0.5,10501
116e7b7e6a8362d7a0d5cbfb6e55ea1201bbd0b5,0,Sumit Mohanty,2013-07-03 17:23:21+00:00,['93479c9d25ebe59de23b8a316591d8dd39389445'],1,1,2,16500494,1,,,,10501
e47649271e6aa4ce5780303a7e12167ee2574fbc,1,Sumit Mohanty,2013-07-03 17:25:39+00:00,['116e7b7e6a8362d7a0d5cbfb6e55ea1201bbd0b5'],52,362,414,16500908,5,0.482926829,1,0.434146341,10501
b26a4e78d2a8c12f0f72d5afb7b68f49942c430f,0,Sumit Mohanty,2013-07-03 17:27:48+00:00,['e47649271e6aa4ce5780303a7e12167ee2574fbc'],1,5,6,16500914,1,,,,10501
bfef736af1187bf97d58f1a96ae7fd1b572d68cb,0,Siddharth Wagle,2013-07-03 19:38:01+00:00,['b26a4e78d2a8c12f0f72d5afb7b68f49942c430f'],0,13,13,16500927,1,,,,10501
28242c07f5e81ff9b081554a915da1eccad6cfc5,1,Sumit Mohanty,2013-07-03 20:33:35+00:00,['bfef736af1187bf97d58f1a96ae7fd1b572d68cb'],7,787,794,16501721,4,0.299806576,0.603481625,0.649903288,10503
3678c54ad2ababaa33a884335cb89ded022bfdd3,0,Jaimin Jetly,2013-07-03 21:02:31+00:00,['28242c07f5e81ff9b081554a915da1eccad6cfc5'],1,3,4,16501725,1,1,1,1,10503
0363abbb0c58ab0cd845fe5d5bf27b32e2b51f4d,1,Srimanth,2013-07-03 21:59:49+00:00,['3678c54ad2ababaa33a884335cb89ded022bfdd3'],13,245,258,16501983,3,0.230769231,0.230769231,1,10504
59d19e5c5112fa43ca668f120e99eaa1c1b20fe5,1,Jaimin Jetly,2013-07-03 23:15:54+00:00,['0363abbb0c58ab0cd845fe5d5bf27b32e2b51f4d'],106,191,297,16502280,7,0.927710843,0.927710843,0.698795181,10504
e818f34fa6eddfd22f112e3ead5a8ebd17d5c0b2,0,Jaimin Jetly,2013-07-03 23:30:59+00:00,['59d19e5c5112fa43ca668f120e99eaa1c1b20fe5'],0,1,1,16502281,1,,,,10504
6550e1c409be3454bfd3a2557ad7c9569186a4f0,1,Siddharth Wagle,2013-07-04 01:45:02+00:00,['e818f34fa6eddfd22f112e3ead5a8ebd17d5c0b2'],301,379,680,16502961,4,0.661016949,0.423728814,1,10504
82e938ff9022fed1df509beed4e673b068e79b89,0,Jaimin Jetly,2013-07-04 03:53:40+00:00,['6550e1c409be3454bfd3a2557ad7c9569186a4f0'],3,8,11,16502972,2,1,1,1,10504
a1abc3f4fffda8e2a46226905c5941cc0d4e370a,0,Yusaku Sako,2013-07-04 04:35:57+00:00,['82e938ff9022fed1df509beed4e673b068e79b89'],0,5,5,16502977,1,0,0,1,10504
4588dc4fbb7b87b518620a16f1cb034c0c20fdc3,1,Yusaku Sako,2013-07-04 04:39:46+00:00,['a1abc3f4fffda8e2a46226905c5941cc0d4e370a'],2,9,11,16502988,1,1,1,1,10504
98fb5ab9a6e947011cd2d465fcdd6260e216c37a,1,Yusaku Sako,2013-07-04 04:42:23+00:00,['4588dc4fbb7b87b518620a16f1cb034c0c20fdc3'],195,275,470,16503458,17,1,1,1,10505
cf7bf4dacfa30642ebab7752a85cfd040e854691,0,Yusaku Sako,2013-07-04 16:35:24+00:00,['98fb5ab9a6e947011cd2d465fcdd6260e216c37a'],0,1,1,16503459,1,,,,10505
01404348d8639039b1170f9904004cb77dc6fa08,1,Yusaku Sako,2013-07-04 16:40:53+00:00,['cf7bf4dacfa30642ebab7752a85cfd040e854691'],953,976,1929,16505388,17,0.301204819,0.409638554,0.144578313,10508
d43d7ad1fac0f4bf1d91e5de1d90291436d8e7e8,0,Mahadev Konar,2013-07-04 17:23:39+00:00,['01404348d8639039b1170f9904004cb77dc6fa08'],5,5,10,16505398,3,,,,10508
69800bc1d81a24573c88abb3ff283ed33ccbbcdc,0,Yusaku Sako,2013-07-04 17:48:30+00:00,['d43d7ad1fac0f4bf1d91e5de1d90291436d8e7e8'],8,8,16,16505414,1,,,,10508
e79f57665bde373a1cc8e463ae7bb4a8dfc77d88,0,Yusaku Sako,2013-07-04 17:56:09+00:00,['69800bc1d81a24573c88abb3ff283ed33ccbbcdc'],2,16,18,16505432,2,1,1,1,10508
ca77f76df0a628be3f218dab7fe58e79555fabd1,0,Yusaku Sako,2013-07-04 18:37:00+00:00,['e79f57665bde373a1cc8e463ae7bb4a8dfc77d88'],0,1,1,16505433,1,,,,10508
3d3c6824fb0cac2c1e48ab5b7bfce7010fbb5900,1,Mahadev Konar,2013-07-04 20:37:52+00:00,['ca77f76df0a628be3f218dab7fe58e79555fabd1'],1,42,43,16505476,2,0,0.852941176,1,10508
b67825fc0ba8c88d4ae52c2bbb4e0a9da158f387,1,Siddharth Wagle,2013-07-04 22:22:19+00:00,['3d3c6824fb0cac2c1e48ab5b7bfce7010fbb5900'],28,77,105,16505581,2,0.972222222,1,1,10508
b79210efb7bcfe4d8cb66659bfd83b59dff8999c,1,Mahadev Konar,2013-07-05 00:06:25+00:00,['b67825fc0ba8c88d4ae52c2bbb4e0a9da158f387'],35,50,85,16505666,2,0,0.529411765,1,10508
8afbe766ea6d04a822a9d06933826773a1b869d1,0,Mahadev Konar,2013-07-05 00:08:34+00:00,['b79210efb7bcfe4d8cb66659bfd83b59dff8999c'],240,0,240,16505906,7,,,,10508
374d164abfb97dbcd46294d7c326b814149faf34,1,Tom Beerbower,2013-07-05 00:48:09+00:00,['8afbe766ea6d04a822a9d06933826773a1b869d1'],16,833,849,16506755,17,0.319526627,0.686390533,0.801775148,10514
5d7ef4610a2e7f3d06d45deb21744d055774538d,1,Srimanth,2013-07-05 16:27:04+00:00,['374d164abfb97dbcd46294d7c326b814149faf34'],97,128,225,16506980,5,1,1,1,10514
8438e60c9a39bddd18747fda28d647d2c9ee8ca2,1,Srimanth,2013-07-05 16:31:55+00:00,['5d7ef4610a2e7f3d06d45deb21744d055774538d'],1,36,37,16507017,3,1,1,1,10514
758ed44896a6036d339c3858eef92d4af1de7d6a,1,Srimanth,2013-07-05 16:51:17+00:00,['8438e60c9a39bddd18747fda28d647d2c9ee8ca2'],0,2,2,16507019,1,1,1,1,10514
64c4ab4a142103594e9a597ca60662fa4ce7386e,1,Mahadev Konar,2013-07-05 17:57:24+00:00,['758ed44896a6036d339c3858eef92d4af1de7d6a'],11,305,316,16507335,3,0.223880597,0.582089552,0.860696517,10514
a7e66758073635a26aba8023ecac229a7e66dcb9,1,Yusaku Sako,2013-07-05 18:19:32+00:00,['64c4ab4a142103594e9a597ca60662fa4ce7386e'],2,15,17,16507352,2,1,1,0.4,10514
c2ad5e40e0f9d35e77a0c5c3fcaef90a8cef9af7,1,Yusaku Sako,2013-07-05 18:47:21+00:00,['a7e66758073635a26aba8023ecac229a7e66dcb9'],2,4,6,16507358,1,,,,10514
1e8cc190a0cc1b19cbe4f47cb5f7a6eb6981b75f,1,Yusaku Sako,2013-07-05 19:04:49+00:00,['c2ad5e40e0f9d35e77a0c5c3fcaef90a8cef9af7'],119,64,183,16507541,3,0.254545455,0,0,10514
97c4a74de273febc74fdc81dbe4f70a789625e97,1,Mahadev Konar,2013-07-05 19:15:22+00:00,['1e8cc190a0cc1b19cbe4f47cb5f7a6eb6981b75f'],66,47,113,16507654,2,1,1,0,10514
31edd6df2a27b3450560895ab20efef5068b6298,1,Yusaku Sako,2013-07-05 21:27:07+00:00,['97c4a74de273febc74fdc81dbe4f70a789625e97'],2,2,4,16507658,2,,,,10514
bce75e609f131cef727615cde4c60f5a9d91ab5b,1,Mahadev Konar,2013-07-07 15:39:21-07:00,['31edd6df2a27b3450560895ab20efef5068b6298'],4,104,108,16507766,2,0.168831169,0.441558442,0.727272727,10514
12575e787359a47d7b7104441dc521c1e3eb1995,1,Siddharth Wagle,2013-07-08 10:07:00-07:00,['bce75e609f131cef727615cde4c60f5a9d91ab5b'],1,3,4,16507770,2,,,,10514
daff70daa626453ebf8e3e0cda72787f8a7882e0,0,Sumit Mohanty,2013-07-08 10:19:34-07:00,['12575e787359a47d7b7104441dc521c1e3eb1995'],3,4,7,16507777,1,,,,10514
22c4f24f8be536743288bce6b829d87731668e2f,0,Sumit Mohanty,2013-07-08 10:24:18-07:00,['daff70daa626453ebf8e3e0cda72787f8a7882e0'],1,1,2,16507779,1,,,,10514
be7f13762c95e7a547afb8662a41ace7ea3f983d,1,Srimanth Gunturi,2013-07-08 11:14:22-07:00,['22c4f24f8be536743288bce6b829d87731668e2f'],1,1,2,16507781,1,,,,10514
e09b47c0b8f514c067b93b56112789f04532aed5,1,Srimanth Gunturi,2013-07-08 11:23:39-07:00,['be7f13762c95e7a547afb8662a41ace7ea3f983d'],62,51,113,16507894,4,1,1,1,10514
a39283a55344644961e4bdb6b437f9bb84a8ea75,1,Yusaku Sako,2013-07-08 12:34:44-07:00,['e09b47c0b8f514c067b93b56112789f04532aed5'],1,1,2,16507896,1,,,,10514
51d9f1bd8b1fe17d8a86a9cfd531755c7f2c52af,0,Yusaku Sako,2013-07-08 12:50:35-07:00,['a39283a55344644961e4bdb6b437f9bb84a8ea75'],1,1,2,16507898,1,,,,10514
548dd3f88d7c948d5e83fdfeb9bcda040c2d84f7,1,Sumit Mohanty,2013-07-08 16:01:23-07:00,['51d9f1bd8b1fe17d8a86a9cfd531755c7f2c52af'],0,9232,9232,16517130,82,,,,10596
ba7aa91bd1248393b6749f62be25202f18af077f,1,Yusaku Sako,2013-07-08 18:16:11-07:00,['548dd3f88d7c948d5e83fdfeb9bcda040c2d84f7'],1,13,14,16517144,1,,,,10596
c77a03cdb6f3714d8e311c1d49e03eb38b6fc124,1,Siddharth Wagle,2013-07-08 18:26:00-07:00,['ba7aa91bd1248393b6749f62be25202f18af077f'],8,69,77,16517221,4,,,,10597
38c13315af05c0c2b37bf5d0108d41e913361d61,1,Jaimin Jetly,2013-07-08 18:30:02-07:00,['c77a03cdb6f3714d8e311c1d49e03eb38b6fc124'],67,98,165,16517386,7,1,0.375,0.625,10597
2383e9c828ef543b180cb50a4a6afb52253f60ad,0,Yusaku Sako,2013-07-08 20:27:46-07:00,['38c13315af05c0c2b37bf5d0108d41e913361d61'],1,0,1,16517387,1,,,,10597
8d285d917df3f1643dcc1ca7aa6a508742536cf9,1,Yusaku Sako,2013-07-08 21:25:25-07:00,['2383e9c828ef543b180cb50a4a6afb52253f60ad'],1,2,3,16517390,2,,,,10597
9bb65d34ec9f0dcc34d142602310b58b8f3af287,0,Siddharth Wagle,2013-07-08 22:34:41-07:00,['8d285d917df3f1643dcc1ca7aa6a508742536cf9'],4,29,33,16517423,2,,,,10598
8250e980890193349f12aa371f5bcd734ba6ec21,0,Sumit Mohanty,2013-07-09 09:32:02-07:00,['9bb65d34ec9f0dcc34d142602310b58b8f3af287'],4,4,8,16517431,1,,,,10598
5555ff381a18577d2c6b3c94ccc431d03debe563,0,Yusaku Sako,2013-07-09 10:52:22-07:00,['8250e980890193349f12aa371f5bcd734ba6ec21'],1,1,2,16517433,1,,,,10598
6aa52df61c22983a1d73131baf9ddc6323798cbb,1,Yusaku Sako,2013-07-09 10:55:39-07:00,['5555ff381a18577d2c6b3c94ccc431d03debe563'],3,192,195,16517628,3,0.398876404,0.398876404,0.904494382,10599
71b0044bf795173578ad00364454b56466591831,1,Yusaku Sako,2013-07-09 11:14:27-07:00,['6aa52df61c22983a1d73131baf9ddc6323798cbb'],61,29,90,16517718,7,,,,10599
4fdeab528f9e1cfbaa19700b19c3709123109eb9,1,Yusaku Sako,2013-07-09 12:02:43-07:00,['71b0044bf795173578ad00364454b56466591831'],0,6,6,16517724,1,,,,10599
676567f8f01eda2fa33a7c992defe453bc8b122e,1,Jaimin Jetly,2013-07-09 13:40:40-07:00,['4fdeab528f9e1cfbaa19700b19c3709123109eb9'],117,371,488,16518212,15,0,0.553191489,1,10599
93cdf494b4f5be33fb9ed38e4e3b3a0ae60c1bba,0,Jaimin Jetly,2013-07-09 13:44:38-07:00,['676567f8f01eda2fa33a7c992defe453bc8b122e'],2,2,4,16518216,1,,,,10599
2635925186d917b23da4701510e8986d5334aa80,1,Yusaku Sako,2013-07-09 14:57:16-07:00,['93cdf494b4f5be33fb9ed38e4e3b3a0ae60c1bba'],55,47,102,16518318,3,1,1,0,10599
6a0da9632c99f99b1b4d594ebc0dfafe7d448e43,1,Yusaku Sako,2013-07-09 15:09:59-07:00,['2635925186d917b23da4701510e8986d5334aa80'],74,95,169,16518487,6,0,0,0,10599
8e211a4219c16f56d5312878df5dc7cd33354337,0,Yusaku Sako,2013-07-09 16:16:05-07:00,['6a0da9632c99f99b1b4d594ebc0dfafe7d448e43'],1,3,4,16518491,1,,,,10599
0724670a292ff85744be1cb06ab11ece37c056eb,0,Siddharth Wagle,2013-07-09 16:44:43-07:00,['8e211a4219c16f56d5312878df5dc7cd33354337'],4,0,4,16518495,1,,,,10599
ec3d6d5d77ebe958d804f3f4bb7c364c264a7288,1,Sumit Mohanty,2013-07-09 17:47:00-07:00,['0724670a292ff85744be1cb06ab11ece37c056eb'],16,110,126,16518621,2,0.721311475,0.754098361,0.819672131,10599
f18c274dddbcdc6948cc71378e20addc49325986,0,Yusaku Sako,2013-07-09 18:51:30-07:00,['ec3d6d5d77ebe958d804f3f4bb7c364c264a7288'],1,17,18,16518639,2,,,,10599
635ff2af1772579d8c1cf365f1e46471e385ce48,0,Sumit Mohanty,2013-07-10 10:49:59-07:00,['f18c274dddbcdc6948cc71378e20addc49325986'],9,21,30,16518669,2,0,0.1,1,10599
e2d42ea2714084c7c13518bf3856d4b3d1b2e104,1,Sumit Mohanty,2013-07-10 10:57:14-07:00,['635ff2af1772579d8c1cf365f1e46471e385ce48'],35,71,106,16518775,4,0.272727273,0.636363636,1,10599
37793fcbc5fcf0dfd723194143acf5cb06fe1341,1,Yusaku Sako,2013-07-10 11:15:50-07:00,['e2d42ea2714084c7c13518bf3856d4b3d1b2e104'],8,8,16,16518791,5,,,,10599
582bfbcd26f3c80b8a2bfd4e376f8a690aab8bbc,1,Yusaku Sako,2013-07-10 11:18:05-07:00,['37793fcbc5fcf0dfd723194143acf5cb06fe1341'],7,7,14,16518805,2,,,,10599
73f1ee079d2ddf8c0b249f768cf5b24c055bd228,1,Yusaku Sako,2013-07-10 11:19:48-07:00,['582bfbcd26f3c80b8a2bfd4e376f8a690aab8bbc'],0,6,6,16518811,1,,,,10599
2234d389a82cb5ba7a3e327537854ed1b9aa6a50,0,Yusaku Sako,2013-07-10 11:33:37-07:00,['73f1ee079d2ddf8c0b249f768cf5b24c055bd228'],5,5,10,16518821,1,,,,10599
ed10eed47180f892c44ddbf2bf7fb0095886a0a3,1,Yusaku Sako,2013-07-10 11:36:35-07:00,['2234d389a82cb5ba7a3e327537854ed1b9aa6a50'],1,1,2,16518823,1,,,,10599
1f160326277fcc168ffb23fbfbf7156b5260f529,1,Jaimin Jetly,2013-07-10 12:56:52-07:00,['ed10eed47180f892c44ddbf2bf7fb0095886a0a3'],10,10,20,16518843,1,,,,10599
6928cf3ba6096e0f2f18c3a88ffd80c2d21d8a83,0,Sumit Mohanty,2013-07-10 14:24:08-07:00,['1f160326277fcc168ffb23fbfbf7156b5260f529'],6,42,48,16518891,6,,,,10600
5bf2ec58783eecce746346db4b3043bba5f094f0,1,Mahadev Konar,2013-07-10 15:03:13-07:00,['6928cf3ba6096e0f2f18c3a88ffd80c2d21d8a83'],37,407,444,16519335,9,0.201058201,0.46031746,1,10601
63ce1d475a67ff7602688b356b7c4d97e52e5c18,1,Mahadev Konar,2013-07-10 17:21:19-07:00,['5bf2ec58783eecce746346db4b3043bba5f094f0'],3,3,6,16519341,1,,,,10601
94d849a1e41927f2828b2ed031d40b53787f71c6,0,Mahadev Konar,2013-07-10 18:49:20-07:00,['63ce1d475a67ff7602688b356b7c4d97e52e5c18'],18,18,36,16519377,1,,,,10601
0cd867fc5ba8a2381ad836d0a4e0f43a9f33f68b,1,Mahadev Konar,2013-07-10 22:21:34-07:00,['94d849a1e41927f2828b2ed031d40b53787f71c6'],6,21,27,16519404,3,0,0.111111111,0.888888889,10601
5b3a39c24f0e8f7fc55d164584df90517ec68b4e,1,Mahadev Konar,2013-07-10 22:58:34-07:00,['0cd867fc5ba8a2381ad836d0a4e0f43a9f33f68b'],21,27,48,16519452,2,0,0,1,10601
94ee80d7b4bb5fa0a88bd37d9975b9cd8d55c2ee,1,Srimanth Gunturi,2013-07-11 10:31:37-07:00,['5b3a39c24f0e8f7fc55d164584df90517ec68b4e'],7,22,29,16519481,2,0.3125,0.3125,1,10601
06c840fa675db183a0616fb4fb808a7293c1e13a,1,Yusaku Sako,2013-07-11 11:29:26-07:00,['94ee80d7b4bb5fa0a88bd37d9975b9cd8d55c2ee'],1,6,7,16519488,1,1,1,1,10601
20b3d2dade2b65fca89cea98f042a5e4468d9851,1,Yusaku Sako,2013-07-11 11:31:21-07:00,['06c840fa675db183a0616fb4fb808a7293c1e13a'],3,7,10,16519498,2,1,1,1,10601
6573ac0d5a7829205746853bd063dad97461b29c,0,Yusaku Sako,2013-07-11 11:46:48-07:00,['20b3d2dade2b65fca89cea98f042a5e4468d9851'],1,2,3,16519501,1,0,1,1,10601
66a7a7f66b03859f97d6cb29b9f23dadb74b7849,1,Jaimin Jetly,2013-07-11 13:45:07-07:00,['6573ac0d5a7829205746853bd063dad97461b29c'],58,101,159,16519660,4,0.256410256,0.666666667,1,10601
3adb81663555db0707181987dd6e322dca28600b,1,Yusaku Sako,2013-07-11 15:05:14-07:00,['66a7a7f66b03859f97d6cb29b9f23dadb74b7849'],65,110,175,16519835,5,1,1,1,10601
e020b7440a43648e629c36ae8d60eeb402de0541,1,Sumit Mohanty,2013-07-11 16:06:27-07:00,['3adb81663555db0707181987dd6e322dca28600b'],100,215,315,16520150,2,0.235294118,0.752941176,0.729411765,10601
1d0830b88e8d272c68b17f5014470b7116a663ba,0,Sumit Mohanty,2013-07-11 16:16:14-07:00,['e020b7440a43648e629c36ae8d60eeb402de0541'],9215,0,9215,16529365,82,,,,10601
779c629ab692d5e1fbb8328842bb60436813e56e,0,Jaimin Jetly,2013-07-11 16:27:48-07:00,['1d0830b88e8d272c68b17f5014470b7116a663ba'],4,4,8,16529373,1,,,,10601
9cd2ce2b887789cb2dab1eea3f4c7c01713e8bcf,0,Srimanth Gunturi,2013-07-11 17:19:42-07:00,['779c629ab692d5e1fbb8328842bb60436813e56e'],0,5,5,16529378,1,1,1,1,10601
0e2c341c1fdddbf6177896389cea783094129127,1,Sumit Mohanty,2013-07-11 20:43:39-07:00,['9cd2ce2b887789cb2dab1eea3f4c7c01713e8bcf'],22,23,45,16529423,1,,,,10601
dfd4b1ac46ed848daee92e29de02b5ec49cb3f44,1,Sumit Mohanty,2013-07-11 20:45:34-07:00,['0e2c341c1fdddbf6177896389cea783094129127'],7,8,15,16529438,3,0,1,0,10601
d28067bd3dc8288f3153a3602321793301279dcd,1,Sumit Mohanty,2013-07-11 20:48:01-07:00,['dfd4b1ac46ed848daee92e29de02b5ec49cb3f44'],15,151,166,16529604,8,0.164705882,0.647058824,0.905882353,10601
98cb712470a7f92844deebeac62c53da08328969,0,Sumit Mohanty,2013-07-11 21:28:45-07:00,['d28067bd3dc8288f3153a3602321793301279dcd'],1,1,2,16529606,1,,,,10601
2b013ac35ca4937847e5546fd82f590d498aefbe,1,Yusaku Sako,2013-07-12 06:44:27-07:00,['98cb712470a7f92844deebeac62c53da08328969'],3,5,8,16529614,2,1,1,1,10601
4d1dc1e85a476790ecfbe2044f5e5b87a0b0d1a9,0,Yusaku Sako,2013-07-12 10:39:09-07:00,['2b013ac35ca4937847e5546fd82f590d498aefbe'],0,9,9,16529623,2,1,1,1,10601
6e28d760f013646d223d6ed05ac08efaea915d53,1,Nate Cole,2013-07-12 14:28:47-04:00,['4d1dc1e85a476790ecfbe2044f5e5b87a0b0d1a9'],0,105,105,16529728,3,0.795454545,0.795454545,1,10602
ca76062c2a6d75500bdf7caf59f7759d12b44097,0,Siddharth Wagle,2013-07-12 13:04:22-07:00,['6e28d760f013646d223d6ed05ac08efaea915d53'],3,7,10,16529738,1,0,0,1,10602
82a104ee6f0a89cff4a44503dbac7e6a9d42fc73,1,Siddharth Wagle,2013-07-12 13:44:14-07:00,['ca76062c2a6d75500bdf7caf59f7759d12b44097'],11,27,38,16529776,1,0.384615385,1,0.384615385,10602
fca0b5c6e412f1df7c9b7dbf5bba05e8425774f6,1,Srimanth Gunturi,2013-07-12 15:20:55-07:00,['82a104ee6f0a89cff4a44503dbac7e6a9d42fc73'],147,241,388,16530164,2,1,1,0,10602
e0435fafe1031ac337ab17033c2075c0c3037d10,1,Srimanth Gunturi,2013-07-12 15:40:11-07:00,['fca0b5c6e412f1df7c9b7dbf5bba05e8425774f6'],1,3,4,16530168,1,1,1,1,10602
2e11b88d11d50d192d3dfae04bafb2a22c6aee0f,1,tbeerbower,2013-07-15 10:19:04-04:00,['e0435fafe1031ac337ab17033c2075c0c3037d10'],64,158,222,16530390,7,0.447761194,0.791044776,0.865671642,10602
c97f62fb186f0d55025343f32a03bea282218e58,0,Jaimin Jetly,2013-07-15 11:08:30-07:00,['2e11b88d11d50d192d3dfae04bafb2a22c6aee0f'],0,66,66,16530456,1,1,1,0.464285714,10603
a701b4d5ac170c447e9e4e68b834572cbaadf170,0,tbeerbower,2013-07-15 15:57:31-04:00,['c97f62fb186f0d55025343f32a03bea282218e58'],1,55,56,16530512,1,,,,10603
b26c489fc464599d312f32b3977f7428a21d3db0,0,tbeerbower,2013-07-15 15:57:31-04:00,['a701b4d5ac170c447e9e4e68b834572cbaadf170'],0,375,375,16530887,5,,,,10607
f8444ad99478aec4a196c4377741d2f15b0fb396,1,Sumit Mohanty,2013-07-15 13:43:23-07:00,['b26c489fc464599d312f32b3977f7428a21d3db0'],64,101,165,16531052,7,,,,10607
fbed96d8e1f19ff46688a529ae360fc53d657b39,1,Nate Cole,2013-07-15 17:19:06-04:00,['f8444ad99478aec4a196c4377741d2f15b0fb396'],22,342,364,16531416,11,0.075757576,0.257575758,1,10607
acc79e49192f9a4c9bfd75dac68e709a196a7d7a,1,Jaimin Jetly,2013-07-15 15:44:08-07:00,['fbed96d8e1f19ff46688a529ae360fc53d657b39'],6,29,35,16531451,2,1,1,1,10607
b7954ab5467073d25c00f9f1c24848bff2956325,0,Yusaku Sako,2013-07-15 16:31:37-07:00,['acc79e49192f9a4c9bfd75dac68e709a196a7d7a'],0,1,1,16531452,1,1,1,1,10607
b27fa4bdedb7679dbedd63e32b86a052fa671c65,0,Siddharth Wagle,2013-07-16 10:46:37-07:00,['b7954ab5467073d25c00f9f1c24848bff2956325'],1,1,2,16531454,1,,,,10607
8fa171913549813fe84ed0af93278234e5c659e1,1,Srimanth Gunturi,2013-07-16 11:38:54-07:00,['b27fa4bdedb7679dbedd63e32b86a052fa671c65'],4,9,13,16531467,2,0,1,1,10607
2707ef0368c16b08fc74b69432f20d42b6fc7b15,1,Jaimin Jetly,2013-07-16 12:41:27-07:00,['8fa171913549813fe84ed0af93278234e5c659e1'],2,1,3,16531470,1,,,,10607
e17554c998da191d713b9ce8a07ae0a1111d366e,1,Sumit Mohanty,2013-07-16 13:26:30-07:00,['2707ef0368c16b08fc74b69432f20d42b6fc7b15'],30,238,268,16531738,2,0,0.159090909,0.903409091,10607
7ba1d09a00faf8613475acdfe6e9b6e409d18363,1,Sumit Mohanty,2013-07-16 14:54:09-07:00,['e17554c998da191d713b9ce8a07ae0a1111d366e'],3,80,83,16531821,5,0,0.054545455,1,10607
39efc0be41cba94e34bc6c00c4cfd45f27842d72,0,Sumit Mohanty,2013-07-16 17:15:12-07:00,['7ba1d09a00faf8613475acdfe6e9b6e409d18363'],9,4,13,16531834,1,1,1,1,10607
a658a77e927058084ade92177d1ca1fbec526290,1,Siddharth Wagle,2013-07-16 17:28:23-07:00,['39efc0be41cba94e34bc6c00c4cfd45f27842d72'],9,17,26,16531860,2,,,,10607
35523fca93182cf73f93d1d179a86e9415a61df6,0,Siddharth Wagle,2013-07-16 17:30:50-07:00,['a658a77e927058084ade92177d1ca1fbec526290'],2,3,5,16531865,1,,,,10607
607d7d4a24a09fdcadb8b9917842657a346781e2,1,Srimanth Gunturi,2013-07-16 18:12:18-07:00,['35523fca93182cf73f93d1d179a86e9415a61df6'],1,5,6,16531871,1,1,1,1,10607
896165e49cc226ad1d0aea6f718d19801bab72fd,1,Srimanth Gunturi,2013-07-16 19:55:46-07:00,['607d7d4a24a09fdcadb8b9917842657a346781e2'],5,6,11,16531882,1,,,,10607
2275602111d90f972df63a3d8c74a46aa0e6d65f,1,Sumit Mohanty,2013-07-17 09:53:06-07:00,['896165e49cc226ad1d0aea6f718d19801bab72fd'],14,62,76,16531958,5,0.351351351,1,0.918918919,10607
07effbf665120b19ef52d9a98c580f9d3fa25341,0,Siddharth Wagle,2013-07-17 10:19:16-07:00,['2275602111d90f972df63a3d8c74a46aa0e6d65f'],2,4,6,16531964,1,0,0,0,10607
5e3e1e005a72c419d2f37b3797c94978b8c57d74,1,Siddharth Wagle,2013-07-17 10:19:16-07:00,['07effbf665120b19ef52d9a98c580f9d3fa25341'],1,33,34,16531998,1,0,1,1,10607
0ce260116f9d0c2877da1d5fdd3907da30cfa5f3,0,Yusaku Sako,2013-07-17 10:28:33-07:00,['5e3e1e005a72c419d2f37b3797c94978b8c57d74'],1,1,2,16532000,1,,,,10607
b5674c5bbdf7f852a3b01758bb1d0f80140cf1b4,1,Yusaku Sako,2013-07-17 10:46:15-07:00,['0ce260116f9d0c2877da1d5fdd3907da30cfa5f3'],145,211,356,16532356,3,0.482142857,0.5,0.964285714,10607
318a7983f8749b6016500650728b9969e1be4388,1,Yusaku Sako,2013-07-17 10:48:09-07:00,['b5674c5bbdf7f852a3b01758bb1d0f80140cf1b4'],1,1,2,16532358,1,,,,10607
7f00dbc2ce7ee36e6e9086583884b3d4c50842d7,0,Yusaku Sako,2013-07-17 11:20:54-07:00,['318a7983f8749b6016500650728b9969e1be4388'],1,5,6,16532364,2,,,,10607
6a7855c830bc6bda8c9468015332ddd3ef53a64b,1,Yusaku Sako,2013-07-17 11:24:39-07:00,['7f00dbc2ce7ee36e6e9086583884b3d4c50842d7'],9,37,46,16532410,3,0.04,0,1,10607
aa97384e4e65d668a4d513ac818f023385a8b66e,1,Yusaku Sako,2013-07-17 11:28:15-07:00,['6a7855c830bc6bda8c9468015332ddd3ef53a64b'],31,126,157,16532567,3,0.788235294,1,1,10608
ca230b6b053dc54525a4cd745805ec592f507888,1,Yusaku Sako,2013-07-17 11:41:19-07:00,['aa97384e4e65d668a4d513ac818f023385a8b66e'],63,167,230,16532797,3,0.367088608,1,1,10608
4b2fa7be8cb191505392b889361b29457f53b784,1,Yusaku Sako,2013-07-17 14:38:11-07:00,['ca230b6b053dc54525a4cd745805ec592f507888'],3,15,18,16532815,3,,,,10608
5e96716754a9406648e9d9796a316077f234aa96,1,Yusaku Sako,2013-07-17 14:49:03-07:00,['4b2fa7be8cb191505392b889361b29457f53b784'],15,12,27,16532842,1,,,,10608
552f007f9ce91e49f28a1c2081d89c130f391ba6,1,Yusaku Sako,2013-07-17 15:59:04-07:00,['5e96716754a9406648e9d9796a316077f234aa96'],12,12,24,16532866,2,,,,10608
e55a661431066a4eedee7b599faa0ab91808f15b,1,Mahadev Konar,2013-07-17 16:15:43-07:00,['552f007f9ce91e49f28a1c2081d89c130f391ba6'],131,9084,9215,16542081,78,0,0.989795918,0.996598639,10678
34f907c1a1306ab6d2e60aa0f26a8b7d8a37a538,1,Yusaku Sako,2013-07-17 16:21:54-07:00,['e55a661431066a4eedee7b599faa0ab91808f15b'],12,13,25,16542106,2,1,1,1,10678
793ead0198475eafaf1c0db656c5cc16a9691e35,1,Siddharth Wagle,2013-07-17 16:27:48-07:00,['34f907c1a1306ab6d2e60aa0f26a8b7d8a37a538'],21,75,96,16542202,2,0,0.815789474,0.184210526,10678
f79e2f5cde7d5e4235bc63816634edd6486054fb,1,Sumit Mohanty,2013-07-17 17:05:27-07:00,['793ead0198475eafaf1c0db656c5cc16a9691e35'],47,3,50,16542252,2,0.685714286,0,0.371428571,10678
d5810bd615ed989db1184710ef5bad8eccd34dcc,1,Sumit Mohanty,2013-07-17 23:43:13-07:00,['f79e2f5cde7d5e4235bc63816634edd6486054fb'],2,72,74,16542326,2,0,1,0,10678
0ef3c9363ed494df35607f1f018f5964fd789487,1,Yusaku Sako,2013-07-18 10:06:04-07:00,['d5810bd615ed989db1184710ef5bad8eccd34dcc'],1,10,11,16542337,2,,,,10678
2f16174c3bb406d1592a350cf2fdfe63bb86974d,0,Yusaku Sako,2013-07-18 10:27:23-07:00,['0ef3c9363ed494df35607f1f018f5964fd789487'],2,2,4,16542341,1,,,,10678
5b2e8f4cab00d0ad37c5f6f03378fa0e0e95b846,0,Jaimin Jetly,2013-07-18 10:31:03-07:00,['2f16174c3bb406d1592a350cf2fdfe63bb86974d'],2,2,4,16542345,1,,,,10678
c17a99285420a4b8d88c3878351fc286f0afd2ec,1,Nate Cole,2013-07-18 15:19:15-04:00,['5b2e8f4cab00d0ad37c5f6f03378fa0e0e95b846'],0,82,82,16542427,2,0,0.931818182,0.068181818,10678
fd17b1b5c1f6fb63b76615fb0bd883b0e469cd64,1,Sumit Mohanty,2013-07-18 13:40:08-07:00,['c17a99285420a4b8d88c3878351fc286f0afd2ec'],2,28,30,16542457,1,,,,10678
74cef41a4bbae8234a160d8c8e405bb3abeea17a,1,Sumit Mohanty,2013-07-18 14:17:48-07:00,['fd17b1b5c1f6fb63b76615fb0bd883b0e469cd64'],0,9215,9215,16551672,82,,,,10760
f60aebdab7e542a4ac3c395150d124c29dec335c,1,Jaimin Jetly,2013-07-18 18:03:09-07:00,['74cef41a4bbae8234a160d8c8e405bb3abeea17a'],73,151,224,16551896,4,0.4,1,1,10760
a1322cecdd78ded1a1a0e2c6a29ee49a4b4d1bb3,0,Sumit Mohanty,2013-07-18 18:18:39-07:00,['f60aebdab7e542a4ac3c395150d124c29dec335c'],11,13,24,16551920,5,,,,10760
a718fc45dbf958c7be7158fe498d4ff76dd5feae,1,Nate Cole,2013-07-19 08:24:09-04:00,['a1322cecdd78ded1a1a0e2c6a29ee49a4b4d1bb3'],1698,38854,40552,16592472,224,0.327079425,0.522826767,0.736085053,10837
7a94a8388dbd3c384a069583575b0dede4aee574,0,Yusaku Sako,2013-07-19 11:58:07-07:00,['a718fc45dbf958c7be7158fe498d4ff76dd5feae'],0,392,392,16592864,2,0.122615804,1,1,10838
0f6a98c7a32d0c89d543f8bfe9922dd4f0f1a9ed,1,Jaimin Jetly,2013-07-19 13:29:08-07:00,['7a94a8388dbd3c384a069583575b0dede4aee574'],9,26,35,16592899,2,1,1,1,10838
dfc5509d6b6ffac27ac177d3432c4f15dab02ff5,0,Jaimin Jetly,2013-07-19 16:42:56-07:00,['0f6a98c7a32d0c89d543f8bfe9922dd4f0f1a9ed'],0,1,1,16592900,1,1,1,1,10838
4f8c9cc74401abdadcdffa5da91655458be5a5a5,0,Jaimin Jetly,2013-07-19 18:23:05-07:00,['dfc5509d6b6ffac27ac177d3432c4f15dab02ff5'],2,2,4,16592904,1,,,,10838
72c99be0671c2a7a855b9f9bc7749e17e43f013d,0,Sumit Mohanty,2013-07-22 10:34:45-07:00,['4f8c9cc74401abdadcdffa5da91655458be5a5a5'],2,2,4,16592908,1,,,,10838
256c309176915dc2289ff8a6f2b6134c91d0f6a9,1,Srimanth Gunturi,2013-07-22 10:38:15-07:00,['72c99be0671c2a7a855b9f9bc7749e17e43f013d'],89,140,229,16593137,7,0.769230769,1,0.980769231,10838
7b2d01a2f966afeba4360e6bb3efdd1a0ac6794f,1,Siddharth Wagle,2013-07-22 10:50:29-07:00,['256c309176915dc2289ff8a6f2b6134c91d0f6a9'],2,18,20,16593157,1,,,,10838
6db49576754873af03c568b75c985ea6f1d8327c,1,Srimanth Gunturi,2013-07-22 13:28:22-07:00,['7b2d01a2f966afeba4360e6bb3efdd1a0ac6794f'],1,4,5,16593162,2,,,,10838
64930cea449110ab69833757efd7f23973e05ee3,0,Jaimin Jetly,2013-07-23 11:56:23-07:00,['6db49576754873af03c568b75c985ea6f1d8327c'],0,1,1,16593163,1,0,0,1,10838
477838dcfdcb36669d0ffcfeb759eb8241a81c67,1,Srimanth Gunturi,2013-07-23 12:35:13-07:00,['64930cea449110ab69833757efd7f23973e05ee3'],1,1,2,16593165,1,,,,10838
209a9e97a9241576c42f28794b112532dd110cc9,0,Srimanth Gunturi,2013-07-23 12:38:12-07:00,['477838dcfdcb36669d0ffcfeb759eb8241a81c67'],0,11,11,16593176,1,,,,10838
fa0fc4ad13d28395847f0877745e797d706c1baf,1,Srimanth Gunturi,2013-07-23 12:42:20-07:00,['209a9e97a9241576c42f28794b112532dd110cc9'],0,31,31,16593207,1,,,,10838
e163b0e5dd5d1109a69c06febc40752db5074d26,1,tbeerbower,2013-07-23 16:10:48-04:00,['fa0fc4ad13d28395847f0877745e797d706c1baf'],63,651,714,16593921,18,0.72815534,0.857605178,0.686084142,10840
6e2fa0343ae507e7f776da39c321ab18024957c9,0,tbeerbower,2013-07-23 16:10:48-04:00,['e163b0e5dd5d1109a69c06febc40752db5074d26'],25,57,82,16594003,3,0,0.8,0.28,10840
0368796c51589a83b1620db35f3f796fb5c04dfd,0,Srimanth Gunturi,2013-07-23 13:17:19-07:00,['fa0fc4ad13d28395847f0877745e797d706c1baf'],3,1,4,16594007,1,1,1,0,10840
aa31e2ccb5bd6ef63b01a3fc7acc561dd4a430a5,0,tbeerbower,2013-07-23 16:20:23-04:00,"['6e2fa0343ae507e7f776da39c321ab18024957c9', '0368796c51589a83b1620db35f3f796fb5c04dfd']",3,1,4,16594011,1,,,,10840
6b3bb003b9cfb96bd0dab3221cddb90238ddffba,0,Srimanth Gunturi,2013-07-23 13:22:54-07:00,['aa31e2ccb5bd6ef63b01a3fc7acc561dd4a430a5'],1,1,2,16594013,1,0,1,0,10840
2b116b39f40208b9381a684b08fb837d87636380,1,Srimanth Gunturi,2013-07-23 13:27:08-07:00,['6b3bb003b9cfb96bd0dab3221cddb90238ddffba'],1,90,91,16594104,3,0.158730159,1,1,10841
37d60ec80d5a03e749ca737b091daa809f945700,1,Yusaku Sako,2013-07-23 13:43:48-07:00,['2b116b39f40208b9381a684b08fb837d87636380'],5,4,9,16594113,1,1,1,0,10841
633880b7947195d6ea8cc2db93955734faa99691,1,Yusaku Sako,2013-07-23 13:48:07-07:00,['37d60ec80d5a03e749ca737b091daa809f945700'],26,30,56,16594169,2,,,,10841
960e23825afcc0d0c03ed8f8e936c87bc3ca25fd,1,Yusaku Sako,2013-07-23 13:49:46-07:00,['633880b7947195d6ea8cc2db93955734faa99691'],1,6,7,16594176,2,1,1,1,10841
d7b27a7c4bdd423f8d0d7530e71c31ef31d15a7f,0,Yusaku Sako,2013-07-23 13:57:37-07:00,['960e23825afcc0d0c03ed8f8e936c87bc3ca25fd'],36,91,127,16594303,2,0.473684211,0.473684211,1,10841
2810d1fde41a97dc6c42add7d2fca72a3ebef7b9,1,Yusaku Sako,2013-07-23 13:59:43-07:00,['d7b27a7c4bdd423f8d0d7530e71c31ef31d15a7f'],19,161,180,16594483,7,0.82,1,1,10843
a5502753be384f629d39e6acab5e6d6e135e8875,1,Yusaku Sako,2013-07-23 14:01:01-07:00,['2810d1fde41a97dc6c42add7d2fca72a3ebef7b9'],223,10,233,16594716,10,0.408163265,0,0,10843
042551b8ae2786c27ac30018e33a12954b87b922,0,Yusaku Sako,2013-07-23 14:02:14-07:00,['a5502753be384f629d39e6acab5e6d6e135e8875'],1,1,2,16594718,1,,,,10843
a631f7956cfa4ede062e2b61af1ba3e31544fdb0,1,Yusaku Sako,2013-07-23 14:03:55-07:00,['042551b8ae2786c27ac30018e33a12954b87b922'],303,149,452,16595170,4,0,0,1,10843
fcdf75151579af2b428d23b9c092ddf34f37dbda,1,Yusaku Sako,2013-07-23 14:06:00-07:00,['a631f7956cfa4ede062e2b61af1ba3e31544fdb0'],27,20,47,16595217,5,1,1,0.25,10843
90fee3624950d3a4406a4e3a89197a74b052f7f6,1,Yusaku Sako,2013-07-23 18:18:50-07:00,['fcdf75151579af2b428d23b9c092ddf34f37dbda'],1,8,9,16595226,1,1,1,1,10843
5d88e7a001eb15f7b691a8bb80f93360ee6138ba,1,Srimanth Gunturi,2013-07-24 10:05:14-07:00,['90fee3624950d3a4406a4e3a89197a74b052f7f6'],22,223,245,16595471,6,0.671755725,0.786259542,0.977099237,10843
bbef800599786ccdcc737b725a9e6b596270f93f,0,Yusaku Sako,2013-07-24 11:07:33-07:00,['5d88e7a001eb15f7b691a8bb80f93360ee6138ba'],36,12,48,16595519,4,,,,10843
66ad274e7700ccd8f6c05e873da9ffe0ca4cde3e,1,Sumit Mohanty,2013-07-24 17:15:31-07:00,['bbef800599786ccdcc737b725a9e6b596270f93f'],77,79,156,16595675,7,0.2,0,0,10843
188a6c4158a439720c59bd8c2f3b9f095e8c7bd4,1,Sumit Mohanty,2013-07-24 19:37:24-07:00,['66ad274e7700ccd8f6c05e873da9ffe0ca4cde3e'],5,25,30,16595705,2,1,1,1,10843
c7f0212d45bb59a265c0aeeeb22bafa568f7baa6,1,Sumit Mohanty,2013-07-24 19:38:41-07:00,['188a6c4158a439720c59bd8c2f3b9f095e8c7bd4'],2,18,20,16595725,3,1,1,1,10843
0221dba563e03a42c2765a48a2349dedad04546a,1,Sumit Mohanty,2013-07-24 19:46:48-07:00,['c7f0212d45bb59a265c0aeeeb22bafa568f7baa6'],2,205,207,16595932,6,0.734693878,0.887755102,0.683673469,10845
b2cecadc057b6d866c6416339ff576d12616f6e8,1,Sumit Mohanty,2013-07-24 19:50:19-07:00,['0221dba563e03a42c2765a48a2349dedad04546a'],1082,1040,2122,16598054,2,1,0,0.438356164,10845
d3c95073bfb61014f5f9838e0b8a018a340276c1,0,Sumit Mohanty,2013-07-24 21:39:24-07:00,['b2cecadc057b6d866c6416339ff576d12616f6e8'],45,67,112,16598166,3,,,,10845
2dca5a4218c64b84e6050dd606d03d99ae5b5a13,1,Jaimin Jetly,2013-07-25 11:23:47-07:00,['d3c95073bfb61014f5f9838e0b8a018a340276c1'],14,18,32,16598198,16,,,,10845
c5d7c0fbcb072cfcbde58c61ca38727e1fd88b70,1,Yusaku Sako,2013-07-25 12:20:14-07:00,['2dca5a4218c64b84e6050dd606d03d99ae5b5a13'],56,71,127,16598325,6,0,0,0,10845
7d02e73758a7d83caa5ca3290262a6c75b7bf1cf,1,Yusaku Sako,2013-07-25 12:23:13-07:00,['c5d7c0fbcb072cfcbde58c61ca38727e1fd88b70'],35,37,72,16598397,2,1,1,1,10845
cde1636748b64223481efacf9b97f7e595629805,1,Yusaku Sako,2013-07-25 12:25:26-07:00,['7d02e73758a7d83caa5ca3290262a6c75b7bf1cf'],3,5,8,16598405,2,1,1,1,10845
a2dd81eb0a063708ac323a6b9398ac7ce99975fd,1,Yusaku Sako,2013-07-25 12:28:37-07:00,['cde1636748b64223481efacf9b97f7e595629805'],4,6,10,16598415,2,,,,10845
fb69284e6908dfc881e64c975b8b60ceb3b2b935,1,Siddharth Wagle,2013-07-25 14:31:01-07:00,['a2dd81eb0a063708ac323a6b9398ac7ce99975fd'],0,4516,4516,16602931,43,,,,10888
23ea7ee55bb8d6b952a71d4fbdda6a42771c8784,1,Siddharth Wagle,2013-07-25 15:00:02-07:00,['fb69284e6908dfc881e64c975b8b60ceb3b2b935'],1,79,80,16603011,2,0,1,1,10888
3c2b4e74592aaf6b29dfeea2dc5c20cd0d136fb8,1,Sumit Mohanty,2013-07-25 15:04:50-07:00,['23ea7ee55bb8d6b952a71d4fbdda6a42771c8784'],3,14,17,16603028,1,,,,10888
8666a165efa3f4d9df7043974b933739d6791a1f,1,Sumit Mohanty,2013-07-25 15:08:37-07:00,['3c2b4e74592aaf6b29dfeea2dc5c20cd0d136fb8'],3,31,34,16603062,2,1,1,0,10888
ba1b3bbec09c48583107a0100e143ac379025df7,1,Sumit Mohanty,2013-07-25 15:11:20-07:00,['8666a165efa3f4d9df7043974b933739d6791a1f'],18,104,122,16603184,3,0.212765957,1,1,10888
c77941197b4f937f49d09a491741e5aac1aabfa6,1,Sumit Mohanty,2013-07-25 15:52:12-07:00,['ba1b3bbec09c48583107a0100e143ac379025df7'],95,116,211,16603395,25,,,,10888
c48c649f27b1a59354742cf2e4135a9ea80c981d,1,Sumit Mohanty,2013-07-25 15:57:44-07:00,['c77941197b4f937f49d09a491741e5aac1aabfa6'],4,26,30,16603425,2,0.866666667,0.866666667,0.866666667,10888
8be5c1689b4bc85bb4eb55c389a1ca86801c5801,0,Yusaku Sako,2013-07-25 16:21:07-07:00,['c48c649f27b1a59354742cf2e4135a9ea80c981d'],5,1,6,16603431,2,,,,10888
23915a29ec1942e6a7ae27ff3ecc7a26164b6211,1,Sumit Mohanty,2013-07-25 22:41:58-07:00,['8be5c1689b4bc85bb4eb55c389a1ca86801c5801'],18,17,35,16603466,4,,,,10888
e365c8a6853e6512a29b101276cab2e749409b60,0,Srimanth Gunturi,2013-07-26 10:46:29-07:00,['23915a29ec1942e6a7ae27ff3ecc7a26164b6211'],2,2,4,16603470,2,,,,10888
9ab6227eb342c8215baae9998feaded9ecbea922,0,Srimanth Gunturi,2013-07-26 13:10:36-07:00,['e365c8a6853e6512a29b101276cab2e749409b60'],25,0,25,16603495,1,,,,10888
978f4cd86a62f5b70b4af6bf9ab9e761928e2055,0,tbeerbower,2013-07-26 16:27:34-04:00,['9ab6227eb342c8215baae9998feaded9ecbea922'],1,56,57,16603552,3,1,1,1,10889
a13f2324e1c9989f89d25741c6ef0e42c470d59f,1,Sumit Mohanty,2013-07-26 13:58:33-07:00,['978f4cd86a62f5b70b4af6bf9ab9e761928e2055'],10,19,29,16603581,4,0,0,0.285714286,10889
6814ab7e4b28db7818ba7b8b55f2853376e6b8ca,1,Srimanth Gunturi,2013-07-26 14:10:23-07:00,['a13f2324e1c9989f89d25741c6ef0e42c470d59f'],0,25,25,16603606,1,,,,10889
7b2f40ed79a70a91dcb98828d62f134df847648a,1,Siddharth Wagle,2013-07-26 14:40:29-07:00,['6814ab7e4b28db7818ba7b8b55f2853376e6b8ca'],3,3,6,16603612,1,,,,10889
e871c72f6f68b82a7576e8f78d803a2e07b45978,1,Jaimin Jetly,2013-07-26 17:51:48-07:00,['7b2f40ed79a70a91dcb98828d62f134df847648a'],1,1,2,16603614,1,,,,10889
0b7be0d3a0491ee585ba6e59bbb30668384ae310,1,Yusaku Sako,2013-07-28 13:59:17-07:00,['e871c72f6f68b82a7576e8f78d803a2e07b45978'],6,10,16,16603630,1,1,1,1,10889
ae25391f89f1f95eaede4c3ae38d8e7723fe18ea,1,Mahadev Konar,2013-07-28 19:07:37-07:00,['0b7be0d3a0491ee585ba6e59bbb30668384ae310'],81,313,394,16604024,11,0.43258427,0.505617978,0.657303371,10889
bf71649cae561573569a0c45cabad81306d6ba8e,1,Mahadev Konar,2013-07-28 20:16:20-07:00,['ae25391f89f1f95eaede4c3ae38d8e7723fe18ea'],17,639,656,16604680,16,,,,10895
8e73a2697b7cfbd3a60f6af1a1969ce09aa74b21,1,Srimanth Gunturi,2013-07-29 10:25:23-07:00,['bf71649cae561573569a0c45cabad81306d6ba8e'],4,95,99,16604779,2,,,,10895
96480991e0fae8f0b097e827df975839b78e9d04,1,Srimanth Gunturi,2013-07-29 12:10:05-07:00,['8e73a2697b7cfbd3a60f6af1a1969ce09aa74b21'],34,18,52,16604831,3,1,1,1,10895
4fad13ca77df347e0df5f2084c3c3cc536e24e57,1,Yusaku Sako,2013-07-29 13:21:47-07:00,['96480991e0fae8f0b097e827df975839b78e9d04'],54,53,107,16604938,6,1,1,1,10895
31820900a992b65cfad06935f455480113b29bd6,0,Yusaku Sako,2013-07-29 13:27:44-07:00,['4fad13ca77df347e0df5f2084c3c3cc536e24e57'],11,9,20,16604958,1,,,,10895
b5d5576f6c2ac91364a23b15dd4c0fec4b6e9508,1,Yusaku Sako,2013-07-29 13:30:30-07:00,['31820900a992b65cfad06935f455480113b29bd6'],0,107,107,16605065,2,1,1,1,10896
bbb767f76547b9f97bfc88f761c31917129ede97,1,Yusaku Sako,2013-07-29 14:18:24-07:00,['b5d5576f6c2ac91364a23b15dd4c0fec4b6e9508'],8,9,17,16605082,2,,,,10896
ce5fba55ab804062c6841e50727b1d2fd84a416e,1,Mahadev Konar,2013-07-29 15:44:44-07:00,['bbb767f76547b9f97bfc88f761c31917129ede97'],13,2,15,16605097,1,,,,10896
8cfc7068040117f17d97f56eb1addd706b5a2273,1,Siddharth Wagle,2013-07-29 17:02:52-07:00,['ce5fba55ab804062c6841e50727b1d2fd84a416e'],0,8,8,16605105,1,,,,10896
e7ca070bcf38da55b1302f87d4da3a4e3d485ef6,0,Siddharth Wagle,2013-07-29 17:05:44-07:00,['8cfc7068040117f17d97f56eb1addd706b5a2273'],0,8,8,16605113,1,,,,10896
44246c522e19874c59d44d689169b585774c71e1,1,tbeerbower,2013-07-30 12:05:33-04:00,['e7ca070bcf38da55b1302f87d4da3a4e3d485ef6'],136,679,815,16605928,8,0.144781145,0.824915825,0.757575758,10896
1f59fffa1b83a2440fbf651fe3ff56002e8b10d0,0,Mahadev Konar,2013-07-30 10:20:06-07:00,['44246c522e19874c59d44d689169b585774c71e1'],0,13,13,16605941,1,,,,10896
edbd458c7981ebe14abe6cc5ac832d8da85ea0e2,1,Jaimin Jetly,2013-07-30 10:52:36-07:00,['1f59fffa1b83a2440fbf651fe3ff56002e8b10d0'],0,1,1,16605942,1,,,,10896
d100c9b44c264f1b181cfecdc17be24501a97fce,1,Yusaku Sako,2013-07-30 11:23:48-07:00,['edbd458c7981ebe14abe6cc5ac832d8da85ea0e2'],2,2,4,16605946,2,,,,10896
b452db7de358aed2328ca5059efab9d88e93b877,1,Yusaku Sako,2013-07-30 11:56:51-07:00,['d100c9b44c264f1b181cfecdc17be24501a97fce'],18,51,69,16606015,4,0.529411765,1,1,10896
574dfad4d35430b9c18ea54f78103f32f489456a,0,Nate Cole,2013-07-30 15:57:16-04:00,['b452db7de358aed2328ca5059efab9d88e93b877'],4,20,24,16606039,1,,,,10896
157ad266ae41bf9172b0a8c23954d88a1bc3c5a7,1,Yusaku Sako,2013-07-30 13:25:09-07:00,['574dfad4d35430b9c18ea54f78103f32f489456a'],12,17,29,16606068,4,1,1,1,10896
799ff9165295372af7d916179f567d0386053634,1,Yusaku Sako,2013-07-30 13:31:32-07:00,['157ad266ae41bf9172b0a8c23954d88a1bc3c5a7'],2,697,699,16606767,26,0.992063492,1,1,10915
3c092f84ada8edf80d8cdccb4d7c141b6751e92e,1,Yusaku Sako,2013-07-30 13:32:57-07:00,['799ff9165295372af7d916179f567d0386053634'],6,101,107,16606874,5,1,1,1,10915
a3492ae027cc53a913bf0867b29a057ecac6bc3c,1,Sumit Mohanty,2013-07-30 14:24:46-07:00,['3c092f84ada8edf80d8cdccb4d7c141b6751e92e'],2,3,5,16606879,2,0,0,0,10915
49dfd03c48115bb55d1db9cfb5dfff81572ec0cb,0,Sumit Mohanty,2013-07-30 14:24:46-07:00,['a3492ae027cc53a913bf0867b29a057ecac6bc3c'],2,2,4,16606883,1,,,,10915
354d2568d4c94f81e147604152529b7f364ff790,1,Sumit Mohanty,2013-07-30 14:44:24-07:00,['49dfd03c48115bb55d1db9cfb5dfff81572ec0cb'],4,7,11,16606894,2,1,1,0,10915
26229f0e97d8c2a99a5192243088236d66d8bfd3,1,Yusaku Sako,2013-07-30 14:56:48-07:00,['354d2568d4c94f81e147604152529b7f364ff790'],23,34,57,16606951,3,0,1,1,10915
aa231d4e805459b3bb2f9a63622e3299400397f5,1,Yusaku Sako,2013-07-30 15:02:13-07:00,['26229f0e97d8c2a99a5192243088236d66d8bfd3'],16,14,30,16606981,2,1,1,1,10915
89e3d9f603588d305f80fde5a4a881f35bbad033,0,Yusaku Sako,2013-07-30 15:16:45-07:00,['aa231d4e805459b3bb2f9a63622e3299400397f5'],1,61,62,16607043,1,,,,10915
7b3559da62fe06e7a02ba9e4c4e9370439f344ea,1,Yusaku Sako,2013-07-30 16:26:41-07:00,['89e3d9f603588d305f80fde5a4a881f35bbad033'],2,2,4,16607047,2,,,,10915
f319832a8d25b64694a7318a5f6c2a208a1946ad,0,Siddharth Wagle,2013-07-30 18:15:25-07:00,['7b3559da62fe06e7a02ba9e4c4e9370439f344ea'],25,44,69,16607116,4,,,,10915
75eda7a68b25f6ee40d4465219ece09c4c69b7d4,0,Mahadev Konar,2013-07-30 22:28:13-07:00,['f319832a8d25b64694a7318a5f6c2a208a1946ad'],60,0,60,16607176,2,,,,10915
14ff542d1b48223246e8c0bf79dfed6d8f2efc52,1,Jaimin Jetly,2013-07-31 10:46:04-07:00,['75eda7a68b25f6ee40d4465219ece09c4c69b7d4'],16,3833,3849,16611025,21,0.591549296,0.352112676,1,10919
37eb38256ae2ec856b92555d0d38fff1b6011ad9,1,Oleg Nechiporenko,2013-07-31 20:48:50+03:00,['14ff542d1b48223246e8c0bf79dfed6d8f2efc52'],23,27,50,16611075,5,0.777777778,0.777777778,1,10919
7c8e240e6a2fb857bf2c9f3e12aba01a0eb8e4b3,0,Yusaku Sako,2013-07-31 11:22:53-07:00,['37eb38256ae2ec856b92555d0d38fff1b6011ad9'],2,7,9,16611084,2,0.6,0.6,1,10919
242a0227e8ba5ec86ffa2a7fb5a5607d5a368221,0,Yusaku Sako,2013-07-31 11:22:53-07:00,['7c8e240e6a2fb857bf2c9f3e12aba01a0eb8e4b3'],1,2,3,16611087,1,1,0,1,10919
2b09e326180c9292a0327938bd1ff1aa73ab0f4c,0,Yusaku Sako,2013-07-31 11:29:28-07:00,['242a0227e8ba5ec86ffa2a7fb5a5607d5a368221'],3,6,9,16611096,1,1,1,1,10919
a17127340aac86b2e9cd63362ffd17066364b99e,0,Yusaku Sako,2013-07-31 11:30:49-07:00,['2b09e326180c9292a0327938bd1ff1aa73ab0f4c'],6,3,9,16611105,1,0,0,0,10919
7d2baddfffeb1a2a60ce777f7740951eb80f9cc7,1,Yusaku Sako,2013-07-31 11:33:42-07:00,['a17127340aac86b2e9cd63362ffd17066364b99e'],30,512,542,16611647,13,0.522968198,0.727915194,0.961130742,10922
964e5cf42e0f683c7a72b0da1793e1361e3b952f,0,Yusaku Sako,2013-07-31 11:35:46-07:00,['7d2baddfffeb1a2a60ce777f7740951eb80f9cc7'],1,1,2,16611649,1,,,,10922
fb0527ffcaea608bdb5df6e894c693d0a3cc8a66,1,Sumit Mohanty,2013-07-31 12:47:07-07:00,['964e5cf42e0f683c7a72b0da1793e1361e3b952f'],8,23,31,16611680,2,0,0.714285714,0.285714286,10922
a1a72c62a8b20c7ad44ebd93ed27d03b134af774,0,Sumit Mohanty,2013-07-31 12:53:34-07:00,['fb0527ffcaea608bdb5df6e894c693d0a3cc8a66'],0,2,2,16611682,1,,,,10922
db1df4582b0024df9ad62c3ea1208fa889407668,1,Sumit Mohanty,2013-07-31 12:57:27-07:00,['a1a72c62a8b20c7ad44ebd93ed27d03b134af774'],0,153,153,16611835,4,0.216216216,1,1,10922
7162d936f9297de552d7399fb02a95f2c5eeb3e1,0,Sumit Mohanty,2013-07-31 13:06:10-07:00,['db1df4582b0024df9ad62c3ea1208fa889407668'],49,55,104,16611939,8,,,,10922
817b6ffbde0a80fb569c733f63a9db50c5c86bf7,0,Srimanth Gunturi,2013-07-31 17:38:12-07:00,['7162d936f9297de552d7399fb02a95f2c5eeb3e1'],2,2,4,16611943,1,,,,10922
f81bbc8378d9d31655837a9c66208ee16e2e1e5c,0,Yusaku Sako,2013-07-31 19:15:05-07:00,['817b6ffbde0a80fb569c733f63a9db50c5c86bf7'],1,1,2,16611945,1,,,,10922
14d3b23307ae880e4cbb5b6c102ff1d670b5ba8c,1,Yusaku Sako,2013-07-31 20:12:52-07:00,['f81bbc8378d9d31655837a9c66208ee16e2e1e5c'],4,4,8,16611953,1,,,,10922
55b634d719bdb101da2c92b84cae76d9ff9b2096,0,tbeerbower,2013-08-01 10:03:44-04:00,['14d3b23307ae880e4cbb5b6c102ff1d670b5ba8c'],0,240,240,16612193,1,,,,10922
d8af64c754ea68f68df436b59c6608f7c8f8d2e0,0,Yusaku Sako,2013-08-01 10:23:11-07:00,['55b634d719bdb101da2c92b84cae76d9ff9b2096'],7,314,321,16612514,8,1,1,1,10922
6909d11086559ac40cb93b31e0a05d41e27ccf95,0,Yusaku Sako,2013-08-01 10:24:54-07:00,['d8af64c754ea68f68df436b59c6608f7c8f8d2e0'],4,49,53,16612567,4,1,1,1,10922
36f483fa1c096801f71eaaed3e5c1a8417ed662c,0,Yusaku Sako,2013-08-01 10:39:03-07:00,['6909d11086559ac40cb93b31e0a05d41e27ccf95'],49,4,53,16612620,4,0,0,0,10922
5072b037534492de4e825ca042ca82e017fcacd3,0,Yusaku Sako,2013-08-01 10:39:12-07:00,['36f483fa1c096801f71eaaed3e5c1a8417ed662c'],314,7,321,16612941,8,0,0,0,10922
691cf4764f93c63f58459353a3f13b744f7b91ef,1,Yusaku Sako,2013-08-01 10:40:19-07:00,['5072b037534492de4e825ca042ca82e017fcacd3'],7,314,321,16613262,8,1,1,1,10922
7cf3f1d2e8311507617ce5effbf7e931a7b82555,1,Yusaku Sako,2013-08-01 10:41:05-07:00,['691cf4764f93c63f58459353a3f13b744f7b91ef'],4,49,53,16613315,4,1,1,1,10922
064c7d9de58b358124c9c6e6dd91f6686dcccd7d,0,Yusaku Sako,2013-08-01 11:10:52-07:00,['7cf3f1d2e8311507617ce5effbf7e931a7b82555'],2,1,3,16613318,1,0,0,0,10922
0b5ddc39325510d2f50af7c0244cec23591068c4,0,Yusaku Sako,2013-08-01 14:08:24-07:00,['064c7d9de58b358124c9c6e6dd91f6686dcccd7d'],1,1,2,16613320,1,,,,10922
e67c8112687f5c282a47072a5ee6b6716eee3fc3,1,Sumit Mohanty,2013-08-01 16:34:34-07:00,['0b5ddc39325510d2f50af7c0244cec23591068c4'],32,32,64,16613384,82,,,,10922
b56ab107de96f40e6a128df0b879c73366157d3d,1,Oleg Nechiporenko,2013-08-02 14:34:38+03:00,['e67c8112687f5c282a47072a5ee6b6716eee3fc3'],31,33,64,16613448,5,0,1,1,10922
92cceb87caaa8ed59a47295a6d03b16d6c739551,0,Oleg Nechiporenko,2013-08-02 19:22:38+03:00,['b56ab107de96f40e6a128df0b879c73366157d3d'],5,312,317,16613765,8,0,0,1,10926
3728dedd626e68719270a8e6d1a676a11e4d8ff8,0,Srimanth Gunturi,2013-08-02 09:48:34-07:00,['92cceb87caaa8ed59a47295a6d03b16d6c739551'],1,139,140,16613905,6,1,0.85915493,1,10927
ebdab0068c22d9e98c7b2fc80a67802a7c22743e,0,Yusaku Sako,2013-08-02 10:51:25-07:00,['3728dedd626e68719270a8e6d1a676a11e4d8ff8'],312,5,317,16614222,8,1,1,0,10927
439046a1a68b45f122b5fe88276aab04ce24f711,1,Yusaku Sako,2013-08-02 10:52:45-07:00,['ebdab0068c22d9e98c7b2fc80a67802a7c22743e'],5,312,317,16614539,8,0,0,1,10931
57b4784421d031ba725ad45e2e577e2961f499f1,1,Yusaku Sako,2013-08-02 11:00:58-07:00,['439046a1a68b45f122b5fe88276aab04ce24f711'],139,1,140,16614679,6,0,0.14084507,0,10931
09c2ddae7a28fbd1e2606c2d3f11e4dd10713bac,1,Srimanth Gunturi,2013-08-02 11:46:09-07:00,['57b4784421d031ba725ad45e2e577e2961f499f1'],1912,2004,3916,16618595,7,1,0.85915493,1,10932
7fd290dd50030ad363a8f304505e52b57444e7c7,1,Nate Cole,2013-08-02 14:46:40-04:00,['09c2ddae7a28fbd1e2606c2d3f11e4dd10713bac'],3,110,113,16618708,2,0,1,1,10932
ff6ff6d0c1a2d54421fc4281ea342414384666f4,1,Srimanth Gunturi,2013-08-02 13:21:29-07:00,['7fd290dd50030ad363a8f304505e52b57444e7c7'],12,15,27,16618735,3,,,,10932
6ea5458bd95d606b3b6082985fdd891317205258,1,Yusaku Sako,2013-08-02 14:40:46-07:00,['ff6ff6d0c1a2d54421fc4281ea342414384666f4'],16,434,450,16619185,12,0.847058824,0.917647059,1,10933
31157a88b18eb5d3477e7baac09a70b48ead7bb1,1,Srimanth Gunturi,2013-08-02 17:47:59-07:00,['6ea5458bd95d606b3b6082985fdd891317205258'],81,117,198,16619383,15,0,0,0,10934
91ce30a1b9435be2e853c113dba9c961425691d0,1,Jaimin Jetly,2013-08-05 10:03:56-07:00,['31157a88b18eb5d3477e7baac09a70b48ead7bb1'],38,1190,1228,16620611,15,0.315068493,0,1,10937
662f92524cd7c66ed3decf84648ab325f20f2243,0,Yusaku Sako,2013-08-05 11:31:58-07:00,['91ce30a1b9435be2e853c113dba9c961425691d0'],2,1,3,16620614,1,0,0,0,10937
b9ac106280c692e750e2720bfb0896480f390d4e,0,Yusaku Sako,2013-08-05 11:47:09-07:00,['662f92524cd7c66ed3decf84648ab325f20f2243'],0,6,6,16620620,1,1,1,1,10937
651d870c93d453db274c0861cb8255a2c59e90f8,1,Yusaku Sako,2013-08-05 12:01:52-07:00,['b9ac106280c692e750e2720bfb0896480f390d4e'],29,33,62,16620682,1,0,0,1,10937
e7590a8aa345bbc9d246eb8603f2b1e325836542,1,Srimanth Gunturi,2013-08-05 14:50:03-07:00,['651d870c93d453db274c0861cb8255a2c59e90f8'],53,130,183,16620865,9,1,1,1,10937
e883524cba19175f89c1fc6b425c574e689a1932,1,Yusaku Sako,2013-08-05 17:21:27-07:00,['e7590a8aa345bbc9d246eb8603f2b1e325836542'],9,124,133,16620998,6,0.975609756,0.975609756,0.731707317,10938
80a8850cacd62871568605f02bc44b05094cc8bb,1,Alex,2013-08-06 15:16:07+03:00,['e883524cba19175f89c1fc6b425c574e689a1932'],10,203,213,16621211,13,1,1,1,10940
a303eafa1944ac8bfc8048ca38531706b385cdde,1,Oleg Nechiporenko,2013-08-06 17:02:56+03:00,['80a8850cacd62871568605f02bc44b05094cc8bb'],0,9,9,16621220,1,0.909090909,1,1,10940
8dcabe83b22dc20c26a5ce6c81446e2e0149dba4,1,Jaimin Jetly,2013-08-06 11:07:16-07:00,['a303eafa1944ac8bfc8048ca38531706b385cdde'],9,9,18,16621238,2,,,,10940
76a83d5a886e534bbbb709cbe04999e582aa31f3,1,Siddharth Wagle,2013-08-06 12:18:45-07:00,['8dcabe83b22dc20c26a5ce6c81446e2e0149dba4'],1,4,5,16621243,1,0.666666667,0.666666667,0.666666667,10940
4ac483eb94bc4bd360bc6bb2f68c4087dda72f27,1,Jaimin Jetly,2013-08-06 12:31:17-07:00,['76a83d5a886e534bbbb709cbe04999e582aa31f3'],30,83,113,16621356,10,,,,10941
1dcce733cb46205d38d0cde484c4b5a02dc18a59,1,Nate Cole,2013-08-06 16:30:52-04:00,['4ac483eb94bc4bd360bc6bb2f68c4087dda72f27'],32,32,64,16621420,73,,,,10941
915f74b292fd51ec06f6bc20cdb81210540bdf42,1,Yusaku Sako,2013-08-06 13:57:47-07:00,['1dcce733cb46205d38d0cde484c4b5a02dc18a59'],11,24,35,16621455,2,0,0,1,10941
93887864704475d35ac574c344c2904a87a964ea,1,Yusaku Sako,2013-08-06 13:59:46-07:00,['915f74b292fd51ec06f6bc20cdb81210540bdf42'],143,246,389,16621844,15,1,0.363636364,1,10944
13ca404d3609b10bbfefb79317b95b1dba2dc493,1,Yusaku Sako,2013-08-06 14:01:25-07:00,['93887864704475d35ac574c344c2904a87a964ea'],21,153,174,16622018,13,0.896551724,0.965517241,0.896551724,10947
746d98f72226537df0cb60290f5aeb44f70d4b08,1,Yusaku Sako,2013-08-06 14:03:34-07:00,['13ca404d3609b10bbfefb79317b95b1dba2dc493'],7,5,12,16622030,2,0,0,0,10947
378d0dddfd3b64910391fb66fb8d759245768916,0,Yusaku Sako,2013-08-06 14:04:45-07:00,['746d98f72226537df0cb60290f5aeb44f70d4b08'],0,7,7,16622037,1,0,0.428571429,1,10947
4aa12f4a7cdc7533791fffecea0fbfcc3c54d190,1,Yusaku Sako,2013-08-06 15:06:57-07:00,['378d0dddfd3b64910391fb66fb8d759245768916'],6,26,32,16622069,1,0,1,1,10947
1d871813ee480fc4c0e44f9bb3273b192d6452fb,0,Jaimin Jetly,2013-08-06 15:20:51-07:00,['4aa12f4a7cdc7533791fffecea0fbfcc3c54d190'],5,5,10,16622079,3,,,,10947
bdc0d78da3382b09981508e97916d16e253c1fff,1,Yusaku Sako,2013-08-06 16:37:48-07:00,['1d871813ee480fc4c0e44f9bb3273b192d6452fb'],1,24,25,16622104,1,,,,10947
49f3bdced5cb43f78ea5e3f5356df123e071338b,0,Jaimin Jetly,2013-08-06 18:27:16-07:00,['bdc0d78da3382b09981508e97916d16e253c1fff'],4,4,8,16622112,4,,,,10947
3df9a127bf068ad53ee9fc0ea261dd2093200375,1,Sumit Mohanty,2013-08-06 18:30:05-07:00,['49f3bdced5cb43f78ea5e3f5356df123e071338b'],29,29,58,16622170,29,,,,10947
842125aa99e5eec2ea4305d2c95ab5124b371e8f,0,Yusaku Sako,2013-08-07 05:37:21-07:00,['3df9a127bf068ad53ee9fc0ea261dd2093200375'],0,12,12,16622182,1,,,,10947
3bc7d8336ce8afd0a6bdd7bf0d2d4141fac70990,1,Yusaku Sako,2013-08-07 09:52:34-07:00,['842125aa99e5eec2ea4305d2c95ab5124b371e8f'],2,188,190,16622372,6,0.34351145,1,1,10949
be216e19fc7e693426229d9c5b84de8e7dab4750,0,Yusaku Sako,2013-08-07 11:11:25-07:00,['3bc7d8336ce8afd0a6bdd7bf0d2d4141fac70990'],1,1,2,16622374,1,,,,10949
c3591ec0bc5e58c1dc6c24bd563a19c4938b0844,1,Yusaku Sako,2013-08-07 11:13:14-07:00,['be216e19fc7e693426229d9c5b84de8e7dab4750'],94,255,349,16622723,19,0.433333333,0.933333333,1,10954
afc574e8b4ebfaec65a83c5ff81d0e98a362bc92,1,Yusaku Sako,2013-08-07 11:16:26-07:00,['c3591ec0bc5e58c1dc6c24bd563a19c4938b0844'],1,2,3,16622726,2,0,1,1,10954
5f3a94efa1da9dec26bc9424907bb1372a8f3d1e,1,Yusaku Sako,2013-08-07 11:18:52-07:00,['afc574e8b4ebfaec65a83c5ff81d0e98a362bc92'],0,5,5,16622731,1,,,,10954
9791a1d4009e5e058770d61133c72635fa47eaed,1,Mahadev Konar,2013-08-07 11:30:47-07:00,['5f3a94efa1da9dec26bc9424907bb1372a8f3d1e'],0,1433,1433,16624164,1,,,,10955
1d21a41c8bd24af10d90a3ebb1c49aa6675cbb7a,1,Sumit Mohanty,2013-08-07 16:22:45-07:00,['9791a1d4009e5e058770d61133c72635fa47eaed'],5,2,7,16624171,1,0,0,0,10955
02d1d81d009931f07cc7aac092ea1555ec2cc60c,0,Mahadev Konar,2013-08-08 00:11:59-07:00,['1d21a41c8bd24af10d90a3ebb1c49aa6675cbb7a'],0,5,5,16624176,1,,,,10955
493c8ddc42fb32900058709783861fd47672c38a,0,atkach,2013-08-08 13:22:32+03:00,['02d1d81d009931f07cc7aac092ea1555ec2cc60c'],18,14,32,16624208,3,0.333333333,0,0,10955
d75875cf129781907e726dcc6d6a50c04a01536b,1,Oleksandr Diachenko,2013-08-08 16:15:21+03:00,['493c8ddc42fb32900058709783861fd47672c38a'],2,6,8,16624216,1,,,,10955
e81d705b778e7d172de89e6cd1d0d2a37b10bda8,1,Yusaku Sako,2013-08-08 11:25:34-07:00,['d75875cf129781907e726dcc6d6a50c04a01536b'],1495,2504,3999,16628215,60,0.541176471,1,1,10978
84ea23232b0b12548284e9e7ec0b046328493a6c,1,Yusaku Sako,2013-08-08 11:29:05-07:00,['e81d705b778e7d172de89e6cd1d0d2a37b10bda8'],9,7,16,16628231,3,,,,10978
0bc3050f4640c011a3543c0e6ad8c7e579757127,0,Siddharth Wagle,2013-08-08 14:32:44-07:00,['84ea23232b0b12548284e9e7ec0b046328493a6c'],13,14,27,16628258,11,,,,10978
758df470ecf9d12b27379d345cdff0678d54ae71,1,Siddharth Wagle,2013-08-08 14:46:37-07:00,['0bc3050f4640c011a3543c0e6ad8c7e579757127'],2,4,6,16628264,1,0,1,0,10978
73ba823aeb9876de21b59330ac2cb1dd32d5a5c5,1,Yusaku Sako,2013-08-08 18:10:56-07:00,['758df470ecf9d12b27379d345cdff0678d54ae71'],19,143,162,16628426,12,0.96,0.96,1,10981
1000552c10f24623b8aee5e938a290cf07ccaa3d,1,Yusaku Sako,2013-08-08 18:12:45-07:00,['73ba823aeb9876de21b59330ac2cb1dd32d5a5c5'],3,146,149,16628575,11,0.980392157,0.980392157,1,10984
65662172fbf3fb67caaf992f71128054273a66b1,0,atkach,2013-08-09 13:03:36+03:00,['1000552c10f24623b8aee5e938a290cf07ccaa3d'],0,5,5,16628580,2,1,1,1,10984
28a4ae836bcb0098867e29835476d18480c4d906,1,Nate Cole,2013-08-09 07:51:16-04:00,['65662172fbf3fb67caaf992f71128054273a66b1'],168,214,382,16628962,20,0,0,1,10984
03e5152cedc21002733bc78b4aaef5cac5f8dc2b,0,Nate Cole,2013-08-09 07:53:13-04:00,['28a4ae836bcb0098867e29835476d18480c4d906'],1,1,2,16628964,1,,,,10984
f9f3e51a95b536d16f00a84a56eeb5a7e92b3294,1,Nate Cole,2013-08-09 07:54:32-04:00,['03e5152cedc21002733bc78b4aaef5cac5f8dc2b'],8,3,11,16628975,1,,,,10984
67ed85b9e5104f5c4ee1135e7450a08ce16d4d07,0,Yusaku Sako,2013-08-09 10:37:08-07:00,['f9f3e51a95b536d16f00a84a56eeb5a7e92b3294'],16,26,42,16629017,1,1,1,1,10984
e7ac8688d0a1378abaeee5bf2270cd1e3b971c6c,0,Yusaku Sako,2013-08-09 10:38:58-07:00,['67ed85b9e5104f5c4ee1135e7450a08ce16d4d07'],12,9,21,16629038,3,1,1,1,10984
436394607ef5fe283ca822827c70ad152e33724e,1,Yusaku Sako,2013-08-09 10:41:17-07:00,['e7ac8688d0a1378abaeee5bf2270cd1e3b971c6c'],3,5,8,16629046,2,0,0,1,10984
d2a20742f85925ca9fac573f7771deaa33d0c0fe,1,Yusaku Sako,2013-08-09 10:44:20-07:00,['436394607ef5fe283ca822827c70ad152e33724e'],9,11,20,16629066,2,0.5,0.5,1,10984
26fcd451a319f46c8046e75f2b34c8c1d1e65c64,1,Nate Cole,2013-08-09 14:06:58-04:00,['d2a20742f85925ca9fac573f7771deaa33d0c0fe'],6,16,22,16629088,1,,,,10984
cdb67e8ff9dadba958992a5904887abf28ca028f,1,Mahadev Konar,2013-08-09 12:34:47-07:00,['26fcd451a319f46c8046e75f2b34c8c1d1e65c64'],0,5,5,16629093,1,,,,10984
2328e72545e43c5b7f8574e5c03066379d8cb6a1,1,Mahadev Konar,2013-08-09 12:40:53-07:00,['cdb67e8ff9dadba958992a5904887abf28ca028f'],35,84,119,16629212,7,,,,10984
f4cc4c887b39050d11a0b472a3df84e7d7a16124,1,Mahadev Konar,2013-08-09 12:59:10-07:00,['2328e72545e43c5b7f8574e5c03066379d8cb6a1'],81,1,82,16629294,2,,,,10984
4be888c577e71cef7ada6f68548bff436ac10d50,1,Siddharth Wagle,2013-08-09 14:46:31-07:00,['f4cc4c887b39050d11a0b472a3df84e7d7a16124'],0,121,121,16629415,5,,,,10986
57281c7224686c77717de9bfebc3d7b387caed67,1,Siddharth Wagle,2013-08-09 14:56:10-07:00,['4be888c577e71cef7ada6f68548bff436ac10d50'],3,13,16,16629431,1,0.444444444,0,0.444444444,10986
e970869466916f6e737ffb1269bfa32667a12fc3,0,tbeerbower,2013-08-09 18:23:19-04:00,['57281c7224686c77717de9bfebc3d7b387caed67'],5,4,9,16629440,1,1,1,1,10986
eae96d751a9dff788096c879c0eba7e5750f6ceb,0,Jaimin Jetly,2013-08-09 16:16:56-07:00,['e970869466916f6e737ffb1269bfa32667a12fc3'],1,1,2,16629442,1,,,,10986
38eea56545ae44ac56944bef796cebee1c58f120,1,Sumit Mohanty,2013-08-09 17:17:32-07:00,['eae96d751a9dff788096c879c0eba7e5750f6ceb'],5,10,15,16629457,3,0,1,0,10986
053882789f04bee76d44640f25525e1beb242b60,0,Siddharth Wagle,2013-08-09 19:56:21-07:00,['38eea56545ae44ac56944bef796cebee1c58f120'],3,4,7,16629464,1,,,,10986
d5a04c73074914b78217263ae1910ddbd3a5db0f,0,Sumit Mohanty,2013-08-09 23:35:07-07:00,['053882789f04bee76d44640f25525e1beb242b60'],10,10,20,16629484,4,,,,10986
779879f8744c199412536f587ce611267b220100,1,Siddharth Wagle,2013-08-11 12:03:38-07:00,['d5a04c73074914b78217263ae1910ddbd3a5db0f'],7,16,23,16629507,2,,,,10986
20755818f021fef6cab88718f5b266a3125801da,1,atkach,2013-08-12 13:32:04+03:00,['779879f8744c199412536f587ce611267b220100'],1,3,4,16629511,1,1,1,1,10986
cd30718c6af7d10a83d69ef0d86587f649db224e,1,atkach,2013-08-12 16:03:40+03:00,['20755818f021fef6cab88718f5b266a3125801da'],19,23,42,16629553,2,1,1,1,10986
4dceca42c504ca26078e57d724096f5b5f4ea33d,1,Oleksandr Diachenko,2013-08-12 18:10:28+03:00,['cd30718c6af7d10a83d69ef0d86587f649db224e'],12,16,28,16629581,1,,,,10986
f547305d2acb0cae04a1a3a858097cd9eb9aea6c,1,Oleksandr Diachenko,2013-08-12 19:43:00+03:00,['4dceca42c504ca26078e57d724096f5b5f4ea33d'],2,9,11,16629592,1,,,,10986
dd35a6d54413a35bac26cd0503483b371a66e9be,1,Oleksandr Diachenko,2013-08-12 20:07:37+03:00,['f547305d2acb0cae04a1a3a858097cd9eb9aea6c'],6,15,21,16629613,2,,,,10986
df0821dfa019166bd49258abf6d4e4c3c19cc295,1,Sumit Mohanty,2013-08-12 10:57:35-07:00,['dd35a6d54413a35bac26cd0503483b371a66e9be'],12,12,24,16629637,12,,,,10986
da8d55e0b5bb90ceaad8ac7af13d3e7824b6d85e,0,Sumit Mohanty,2013-08-12 11:10:13-07:00,['df0821dfa019166bd49258abf6d4e4c3c19cc295'],1,3,4,16629641,1,0,1,1,10986
7c3bab94dc189df03eabc2ef14cda11c5738c48b,0,Sumit Mohanty,2013-08-12 14:26:19-07:00,['da8d55e0b5bb90ceaad8ac7af13d3e7824b6d85e'],3,8,11,16629652,2,,,,10986
f1dc8beb76d922c653f2012dee241658c7a7b0b2,0,Siddharth Wagle,2013-08-12 18:03:58-07:00,['7c3bab94dc189df03eabc2ef14cda11c5738c48b'],3,3,6,16629658,3,,,,10986
fa220fd31bcd51c8aa2e17161858ad224cc323d4,1,Srimanth Gunturi,2013-08-12 18:14:50-07:00,['f1dc8beb76d922c653f2012dee241658c7a7b0b2'],10,9,19,16629677,5,0,0,,10986
be99d85a7b140706b27dc13215757073a4b043bb,1,Mahadev Konar,2013-08-12 22:52:49-07:00,['fa220fd31bcd51c8aa2e17161858ad224cc323d4'],20,149,169,16629846,7,,,,10988
80db337cfe45d9961c466229168590f6084a7750,1,atkach,2013-08-13 18:03:24+03:00,['be99d85a7b140706b27dc13215757073a4b043bb'],1,1,2,16629848,1,,,,10988
13d732392078c804a3125d926bb2882dc2cbf07a,1,Oleksandr Diachenko,2013-08-13 19:31:53+03:00,['80db337cfe45d9961c466229168590f6084a7750'],87,43,130,16629978,6,,,,10988
c0925b9959f98d259bd8d25aa91070a3ce5c86f8,0,Siddharth Wagle,2013-08-13 10:28:43-07:00,['13d732392078c804a3125d926bb2882dc2cbf07a'],1,1,2,16629980,1,,,,10988
72311b797289ca591537650dcea40ac40f513b20,1,Oleksandr Diachenko,2013-08-13 22:44:40+03:00,['c0925b9959f98d259bd8d25aa91070a3ce5c86f8'],16,115,131,16630111,5,0,1,0.296296296,10990
90395eee096fd9c9bedd783e2a3f08fa35e49971,1,Siddharth Wagle,2013-08-13 14:16:49-07:00,['72311b797289ca591537650dcea40ac40f513b20'],7,9,16,16630127,2,,,,10990
cb4f8f4ebc04b49f313ec93e63d90d5dfd627d72,1,Yusaku Sako,2013-08-13 15:43:50-07:00,['90395eee096fd9c9bedd783e2a3f08fa35e49971'],7,10,17,16630144,2,0,1,0,10990
177f5558817b4d85c90202ef8140524e45c15de4,0,Yusaku Sako,2013-08-13 15:46:46-07:00,['cb4f8f4ebc04b49f313ec93e63d90d5dfd627d72'],0,4,4,16630148,1,,,,10990
d1c13d53c5d8b22965d383a67dd8fd265d79aa83,0,Yusaku Sako,2013-08-13 15:49:16-07:00,['177f5558817b4d85c90202ef8140524e45c15de4'],40,40,80,16630228,12,,,,10990
69331db5c2d53f89e43799f2364308d68203b8eb,0,Yusaku Sako,2013-08-13 15:51:26-07:00,['d1c13d53c5d8b22965d383a67dd8fd265d79aa83'],4,2,6,16630234,2,,,,10990
d1299d1fe66948966fcbca69dcb49d38e083e6de,1,Yusaku Sako,2013-08-13 15:53:16-07:00,['69331db5c2d53f89e43799f2364308d68203b8eb'],15,96,111,16630345,10,1,1,1,10990
bb0c427b9abf3d71839f582843f8e65eb907445c,1,Yusaku Sako,2013-08-13 15:55:58-07:00,['d1299d1fe66948966fcbca69dcb49d38e083e6de'],9,175,184,16630529,5,0.550458716,1,1,10990
c84d3e286379ff32d40c9d319a24036d22a69190,1,Yusaku Sako,2013-08-13 18:12:13-07:00,['bb0c427b9abf3d71839f582843f8e65eb907445c'],2,2,4,16630533,1,,,,10990
4959c35667b1b7c54f96b6dd3984d3c9e7b0ef3e,1,atkach,2013-08-14 14:56:34+03:00,['c84d3e286379ff32d40c9d319a24036d22a69190'],2,2,4,16630537,1,,,,10990
c244d4fc477921903ab73488aefd5cbf00fac647,1,atkach,2013-08-14 15:29:11+03:00,['4959c35667b1b7c54f96b6dd3984d3c9e7b0ef3e'],146,289,435,16630972,2,,,,10990
8871874f087b96cad2dcd6003779969ded2603a7,1,Lisnichenko Dmitro,2013-08-14 18:43:14+03:00,['c244d4fc477921903ab73488aefd5cbf00fac647'],30,140,170,16631142,11,,,,10991
06d53ed972639d415704764a6ab86fd89d040950,1,Nate Cole,2013-08-14 13:08:54-04:00,['8871874f087b96cad2dcd6003779969ded2603a7'],352,4,356,16631498,8,,,,10991
63d10763b637361d2548af963b159fdd0367570f,1,Sumit Mohanty,2013-08-14 10:44:28-07:00,['06d53ed972639d415704764a6ab86fd89d040950'],12,52,64,16631562,2,,,,10991
8950f9112e7fa431f946aa3ce4ffc682e2585125,0,Yusaku Sako,2013-08-14 11:47:12-07:00,['63d10763b637361d2548af963b159fdd0367570f'],16,16,32,16631594,5,,,,10991
8b5583fee770c47546d9d2ae843e394f3cba5592,1,Yusaku Sako,2013-08-14 11:53:58-07:00,['8950f9112e7fa431f946aa3ce4ffc682e2585125'],3,17,20,16631614,1,0,1,0.923076923,10991
1d93addee9e89df2a70ea40060274faa74206d16,1,Yusaku Sako,2013-08-14 11:55:16-07:00,['8b5583fee770c47546d9d2ae843e394f3cba5592'],11,72,83,16631697,4,0.277777778,0.75,1,10991
ad24d766d2ec0804ab555a4dd63c27ea8ed01406,1,Lisnichenko Dmitro,2013-08-14 22:22:57+03:00,['1d93addee9e89df2a70ea40060274faa74206d16'],4,50,54,16631751,2,0.516129032,1,0,10991
684cff3813ac7808f29e6b34bd0f5184bd1d2de2,0,Sumit Mohanty,2013-08-14 13:53:26-07:00,['ad24d766d2ec0804ab555a4dd63c27ea8ed01406'],9,9,18,16631769,1,,,,10991
9ea2792f3857a4ff9be407d7a1b7b3786c79782f,1,Sumit Mohanty,2013-08-14 13:53:34-07:00,['684cff3813ac7808f29e6b34bd0f5184bd1d2de2'],37,9,46,16631815,2,,,,10991
fbc1ad0e7601acdcbda05af7d8b7c2b2a285752a,0,Yusaku Sako,2013-08-14 16:02:53-07:00,['9ea2792f3857a4ff9be407d7a1b7b3786c79782f'],1,1,2,16631817,1,,,,10991
ae2237849ccd973591fe163073a310d79310d286,1,Siddharth Wagle,2013-08-14 16:57:45-07:00,['fbc1ad0e7601acdcbda05af7d8b7c2b2a285752a'],53,267,320,16632137,2,,,,10991
eacb81660e5cd97b8328fde506aab500735c3b17,1,Mahadev Konar,2013-08-14 17:40:37-07:00,['ae2237849ccd973591fe163073a310d79310d286'],35,15,50,16632187,1,,,,10991
8a11fdd868021121aae4d817d9bf3925469c65eb,1,Jaimin Jetly,2013-08-14 17:47:47-07:00,['eacb81660e5cd97b8328fde506aab500735c3b17'],25,56,81,16632268,10,0.333333333,0.333333333,1,10991
e65468a6c09b7dc1133ff973443cef8f956a962b,1,Siddharth Wagle,2013-08-14 18:53:27-07:00,['8a11fdd868021121aae4d817d9bf3925469c65eb'],4,18,22,16632290,2,0,0,1,10991
9c3940bd071106c8d97d353b3599b09dcd584e31,1,Yusaku Sako,2013-08-14 19:20:47-07:00,['e65468a6c09b7dc1133ff973443cef8f956a962b'],2,49,51,16632341,3,0,1,1,10991
32399749c9394cef0088328583f192c6e548165c,1,Sumit Mohanty,2013-08-14 22:50:58-07:00,['9c3940bd071106c8d97d353b3599b09dcd584e31'],81,130,211,16632552,4,,,,10991
7c50e3413664be1c71f34d66039dbd0e9eeb442c,0,atkach,2013-08-15 12:55:35+03:00,['32399749c9394cef0088328583f192c6e548165c'],13,13,26,16632578,1,,,,10991
57228eb9f43b833123f82c2b48f8c40c0081130d,1,atkach,2013-08-15 14:19:04+03:00,['7c50e3413664be1c71f34d66039dbd0e9eeb442c'],128,129,257,16632835,2,,,,10991
08001043a0bbff089e512fdafae98b9cc633b9d0,0,atkach,2013-08-15 18:03:19+03:00,['57228eb9f43b833123f82c2b48f8c40c0081130d'],1,6,7,16632842,1,0,0,1,10991
83c4991ec867ce816a3f68b9d1be4fe18a6e2f8b,1,Nate Cole,2013-08-15 11:33:06-04:00,['08001043a0bbff089e512fdafae98b9cc633b9d0'],1,15828,15829,16648671,5,0,1,1,10992
e5286e04b0a0365020026bb4bfe1976b1965e2a0,1,Oleksandr Diachenko,2013-08-15 19:26:07+03:00,['83c4991ec867ce816a3f68b9d1be4fe18a6e2f8b'],1,7,8,16648679,2,,,,10992
aa5933a5a1cafaf4573f157f695078ca30535c5e,1,Yusaku Sako,2013-08-15 10:34:46-07:00,['e5286e04b0a0365020026bb4bfe1976b1965e2a0'],9,21,30,16648709,1,1,1,1,10992
6141422e0837e6bf6c59bf2be008ea05851674b2,0,Srimanth Gunturi,2013-08-15 12:27:12-07:00,['aa5933a5a1cafaf4573f157f695078ca30535c5e'],13,19,32,16648741,3,0,0,1,10992
d95ecac9225c3b18142344623a6574120d9fc802,1,Sumit Mohanty,2013-08-15 12:45:53-07:00,['6141422e0837e6bf6c59bf2be008ea05851674b2'],2,2,4,16648745,1,,,,10992
54c3788726eb86369452983f9140094fdda3cb14,0,Sumit Mohanty,2013-08-15 12:48:58-07:00,['d95ecac9225c3b18142344623a6574120d9fc802'],85,1,86,16648831,4,0.481481481,0.111111111,0.37037037,10992
d44c1c2ba90d8d8366a08d59e798d101c96ed9c7,1,Srimanth Gunturi,2013-08-15 15:07:29-07:00,['54c3788726eb86369452983f9140094fdda3cb14'],11,18,29,16648860,3,1,0,1,10992
a2b675c6ada585a830ad928f6aefe426acb9dc03,1,Yusaku Sako,2013-08-15 15:22:02-07:00,['d44c1c2ba90d8d8366a08d59e798d101c96ed9c7'],68,68,136,16648996,9,,,,10992
12cf60b688a7ac8e2e95876e08d696cfd9891fcc,1,Sumit Mohanty,2013-08-15 15:28:40-07:00,['a2b675c6ada585a830ad928f6aefe426acb9dc03'],0,60,60,16649056,2,,,,10994
be0c09bedbc447caa104e8a744875a507f72ff45,1,Siddharth Wagle,2013-08-15 15:44:10-07:00,['12cf60b688a7ac8e2e95876e08d696cfd9891fcc'],0,17,17,16649073,2,,,,10994
6f644ea591d2da97c51fc045ac9c2b7530d77a36,1,Mahadev Konar,2013-08-15 16:56:09-07:00,['be0c09bedbc447caa104e8a744875a507f72ff45'],5,10,15,16649088,3,,,,10994
d2bd5dc52e7704a5a63f30d16b6e2a7d93dc4435,0,Sumit Mohanty,2013-08-15 17:07:25-07:00,['6f644ea591d2da97c51fc045ac9c2b7530d77a36'],2,6,8,16649096,1,0,1,0,10994
1851aa3ddf7e3fef57b7b6a7cf6b73f0453c1db1,0,Srimanth Gunturi,2013-08-15 21:29:04-07:00,['d2bd5dc52e7704a5a63f30d16b6e2a7d93dc4435'],4,2,6,16649102,2,,,,10994
34c85a689acf604a330be3a3d34b7b0c0e96c032,1,tbeerbower,2013-08-16 03:51:25-04:00,['1851aa3ddf7e3fef57b7b6a7cf6b73f0453c1db1'],8,106,114,16649216,3,0.389830508,0.711864407,1,10994
bcebaddbd9d900f34afbc31be2a991da7c714b07,0,Oleksandr Diachenko,2013-08-16 15:53:43+03:00,['34c85a689acf604a330be3a3d34b7b0c0e96c032'],0,11,11,16649227,1,,,,10994
83683f6077fbfde735d5ae37636cb5cb221997c7,1,Oleksandr Diachenko,2013-08-16 18:43:11+03:00,['bcebaddbd9d900f34afbc31be2a991da7c714b07'],22368,2641,25009,16674236,2,,,,10994
b51f04229eed6b247a030f7e2bf1a4488bca8d9d,1,Yusaku Sako,2013-08-16 10:16:33-07:00,['83683f6077fbfde735d5ae37636cb5cb221997c7'],8,21,29,16674265,6,1,1,1,10994
86e28b07ecbf6e97333a4f99bc640e492f71326a,1,Yusaku Sako,2013-08-16 10:36:22-07:00,['b51f04229eed6b247a030f7e2bf1a4488bca8d9d'],14,15,29,16674294,1,,,,10994
cf593abc2e94153f4b3be7613f6e486b3ae6db37,0,Yusaku Sako,2013-08-16 10:52:54-07:00,['86e28b07ecbf6e97333a4f99bc640e492f71326a'],1,1,2,16674296,1,,,,10994
788eedb090fe43b88dfabff0881ad42b59411025,1,Yusaku Sako,2013-08-16 10:54:54-07:00,['cf593abc2e94153f4b3be7613f6e486b3ae6db37'],106,105,211,16674507,2,,,,10994
01594a8b16037784a9a8775d5a65e6a663b1a7e0,0,Nate Cole,2013-08-16 14:13:42-04:00,['788eedb090fe43b88dfabff0881ad42b59411025'],30,0,30,16674537,4,,,,10994
024a009e753a9ec23807d297d62be121a88beb6c,1,Srimanth Gunturi,2013-08-16 12:21:08-07:00,['01594a8b16037784a9a8775d5a65e6a663b1a7e0'],2,6,8,16674545,2,,,,10994
2ebffb16523b875e1af87040176a77bda0de30ba,1,Yusaku Sako,2013-08-16 13:33:23-07:00,['024a009e753a9ec23807d297d62be121a88beb6c'],17,147,164,16674709,9,0.591397849,0.795698925,1,10994
8bf8f9e96e7ce5cee8a67217c945e4ed87b740c7,0,Sumit Mohanty,2013-08-16 13:56:22-07:00,['2ebffb16523b875e1af87040176a77bda0de30ba'],96,135,231,16674940,1,,,,10994
1b47ef01fa7c08d51ad8af67035ba672f8547dbd,1,Sumit Mohanty,2013-08-16 14:09:23-07:00,['8bf8f9e96e7ce5cee8a67217c945e4ed87b740c7'],135,96,231,16675171,1,,,,10994
202e2571245eb36d2d5f1c7f39352e634a7dea14,1,Siddharth Wagle,2013-08-16 14:11:28-07:00,['1b47ef01fa7c08d51ad8af67035ba672f8547dbd'],289,493,782,16675953,3,,,,10994
4b6df8424ad0f318d8b5ac5173db25fc5c161fe3,0,Siddharth Wagle,2013-08-16 14:14:52-07:00,['202e2571245eb36d2d5f1c7f39352e634a7dea14'],1,1,2,16675955,1,,,,10994
22ff085f16689cebf020a1374d1c46d973c6fc4d,0,Srimanth Gunturi,2013-08-16 15:16:34-07:00,['4b6df8424ad0f318d8b5ac5173db25fc5c161fe3'],2,16,18,16675973,2,1,1,1,10994
ad26dc34f55a82319383831f5b9fd19a88fa111f,1,Mahadev Konar,2013-08-16 18:04:38-07:00,['22ff085f16689cebf020a1374d1c46d973c6fc4d'],4,5,9,16675982,3,,,,10994
bfd1fb5c5938ba74df251a9166a97fb074540f89,1,Yusaku Sako,2013-08-17 00:24:05-07:00,['ad26dc34f55a82319383831f5b9fd19a88fa111f'],2,2,4,16675986,2,,,,10994
f092e2a1cb93ff56163eaea65b3bb545098f3aed,0,Yusaku Sako,2013-08-17 12:50:41-07:00,['bfd1fb5c5938ba74df251a9166a97fb074540f89'],2,6,8,16675994,1,0.5,0.5,1,10994
2a9cb5daaaecb9e52c941ab8d419b89af9c64f17,0,Siddharth Wagle,2013-08-17 19:22:05-07:00,['f092e2a1cb93ff56163eaea65b3bb545098f3aed'],8,8,16,16676010,2,,,,10994
ba87bc0cc39237c2cbf8d18baaeb1eac9daeb1ec,0,Mahadev Konar,2013-08-17 19:59:27-07:00,['2a9cb5daaaecb9e52c941ab8d419b89af9c64f17'],12,12,24,16676034,2,,,,10994
9a85a69bca4c67e541f505149da96c73befd9220,0,Sumit Mohanty,2013-08-18 10:30:41-07:00,['ba87bc0cc39237c2cbf8d18baaeb1eac9daeb1ec'],1,1,2,16676036,1,,,,10994
a42aa297e48ee72b415971a8a5727641c82f9e99,0,Siddharth Wagle,2013-08-18 10:41:51-07:00,['9a85a69bca4c67e541f505149da96c73befd9220'],2,2,4,16676040,1,,,,10994
624302b2b09453d59c2a41283ffc9d87ec1933ae,1,Mahadev Konar,2013-08-18 12:34:39-07:00,['a42aa297e48ee72b415971a8a5727641c82f9e99'],1,1,2,16676042,1,,,,10994
9bdfa5411a4066603270a0ddcdedaeac7b84f6f1,1,Mahadev Konar,2013-08-18 17:25:01-07:00,['624302b2b09453d59c2a41283ffc9d87ec1933ae'],16,16,32,16676074,2,,,,10994
18ab3420722167d91e3a973a059bbd04578ef16c,0,atkach,2013-08-19 15:00:11+03:00,['9bdfa5411a4066603270a0ddcdedaeac7b84f6f1'],6,7,13,16676087,1,1,1,1,10994
8a7a639c6920c4e016920eacca9b3f604af4e5ce,0,Sumit Mohanty,2013-08-19 08:36:14-07:00,['18ab3420722167d91e3a973a059bbd04578ef16c'],1,4,5,16676092,1,,,,10994
ed800deb2e9dfcaf705aa4b8bdd3bdce7c8fabce,1,Sumit Mohanty,2013-08-19 11:43:18-07:00,['8a7a639c6920c4e016920eacca9b3f604af4e5ce'],1,17,18,16676110,1,,,,10994
951fc09e7a559e0c6ff57ecd46144e228742ffd9,0,Yusaku Sako,2013-08-19 12:05:33-07:00,['ed800deb2e9dfcaf705aa4b8bdd3bdce7c8fabce'],4,6,10,16676120,1,1,1,1,10994
88a60d222ff14f45150528e003e1a78dc5b0fdb1,0,Yusaku Sako,2013-08-19 12:08:07-07:00,['951fc09e7a559e0c6ff57ecd46144e228742ffd9'],25,25,50,16676170,3,,,,10994
fb20eab51a3f064baddc44f89ea42b16ef38f1da,1,Yusaku Sako,2013-08-19 12:12:22-07:00,['88a60d222ff14f45150528e003e1a78dc5b0fdb1'],3,7,10,16676180,2,0,1,1,10994
a6295682347bbc84c556f60f77b0937a36b268f2,1,Yusaku Sako,2013-08-19 12:15:06-07:00,['fb20eab51a3f064baddc44f89ea42b16ef38f1da'],1,47,48,16676228,3,1,1,1,10994
a4230368b0217a61694c21bc11d2c91d2818600b,0,Yusaku Sako,2013-08-19 13:08:13-07:00,['a6295682347bbc84c556f60f77b0937a36b268f2'],0,3,3,16676231,1,,,,10994
61a0e73b7751f11e3a1f457d4cd7fa67a221a30b,0,Siddharth Wagle,2013-08-19 14:13:15-07:00,['a4230368b0217a61694c21bc11d2c91d2818600b'],0,5,5,16676236,1,,,,10994
2191bd06e1cf84ee6bbd12314a994f35dae31770,0,Yusaku Sako,2013-08-19 14:30:47-07:00,['61a0e73b7751f11e3a1f457d4cd7fa67a221a30b'],1,1,2,16676238,1,,,,10994
c94855f714d3b32f08170d7c88563014e996b4f8,0,Yusaku Sako,2013-08-19 15:10:52-07:00,['2191bd06e1cf84ee6bbd12314a994f35dae31770'],0,16,16,16676254,2,1,1,1,10994
1824b6a88856beace4b12ff68924505cf265d00c,0,Yusaku Sako,2013-08-19 15:32:51-07:00,['c94855f714d3b32f08170d7c88563014e996b4f8'],2,2,4,16676258,2,,,,10994
d9ff52e2b3e3b1f69a91a49f4d210dce289c363a,0,Yusaku Sako,2013-08-19 15:38:05-07:00,['1824b6a88856beace4b12ff68924505cf265d00c'],57,10,67,16676325,8,1,0.153846154,0,10994
0aefc3760704782fe79b0e33a29dcfda35352ac9,1,Lisnichenko Dmitro,2013-08-20 15:31:36+03:00,['d9ff52e2b3e3b1f69a91a49f4d210dce289c363a'],0,5,5,16676330,1,,,,10994
0c2fa10f887637a85e43f45a31774a48004a2cc8,0,tbeerbower,2013-08-20 11:58:02-04:00,['0aefc3760704782fe79b0e33a29dcfda35352ac9'],1,1,2,16676332,1,,,,10994
211ad201758b59b2f5bb06a5da640bdede1e4aad,1,Yusaku Sako,2013-08-20 13:15:30-07:00,['0c2fa10f887637a85e43f45a31774a48004a2cc8'],1,1,2,16676334,1,,,,10994
6d37377ccc65a3efd2f8de0022bf56db5e853920,1,Yusaku Sako,2013-08-20 13:17:22-07:00,['211ad201758b59b2f5bb06a5da640bdede1e4aad'],8,12,20,16676354,5,,,,10994
0eee1ff3d216de5a04edc2f840a401adcd383ed4,1,Yusaku Sako,2013-08-20 13:20:38-07:00,['6d37377ccc65a3efd2f8de0022bf56db5e853920'],12,27,39,16676393,4,1,1,1,10994
649e166395c2ccaed545069397167ffdcda8a69a,0,Yusaku Sako,2013-08-20 13:29:08-07:00,['0eee1ff3d216de5a04edc2f840a401adcd383ed4'],96,0,96,16676489,2,,,,10994
cbad978dbf38135f2159facd8c04bec1580f6a17,0,Yusaku Sako,2013-08-20 23:49:23-07:00,['649e166395c2ccaed545069397167ffdcda8a69a'],1,4,5,16676494,1,0.75,0.75,1,10994
b009c49b51981240af68c409f0d4b301bfcbfa5a,1,atkach,2013-08-21 14:35:37+03:00,['cbad978dbf38135f2159facd8c04bec1580f6a17'],115,42,157,16676651,4,0.051724138,0.051724138,0,10994
a811db6d4aabddacfbde2c0507137001cc06b49a,1,atkach,2013-08-21 14:47:47+03:00,['b009c49b51981240af68c409f0d4b301bfcbfa5a'],13,213,226,16676877,6,0.789473684,1,0.927631579,10994
3a97a6e999c51f7843819463a12c8b3ff542fcb1,1,Lisnichenko Dmitro,2013-08-21 16:03:38+03:00,['a811db6d4aabddacfbde2c0507137001cc06b49a'],16,22,38,16676915,14,,,,10994
8ea2afde09aa9470d258b9f8dcdb7f9c39adaf90,0,Sumit Mohanty,2013-08-21 10:05:12-07:00,['3a97a6e999c51f7843819463a12c8b3ff542fcb1'],67,0,67,16676982,3,,,,10994
301fba80dbc06c60d3d106ae1d0ab32a553c5c4a,0,Yusaku Sako,2013-08-21 10:54:45-07:00,['8ea2afde09aa9470d258b9f8dcdb7f9c39adaf90'],1,1,2,16676984,1,,,,10994
c309d22722fff0979de995cba093153b91fa6d66,1,Yusaku Sako,2013-08-21 10:56:13-07:00,['301fba80dbc06c60d3d106ae1d0ab32a553c5c4a'],14,20,34,16677018,2,1,1,1,10994
7eddd1c5b55614b0d6915af4c7f4bf93758b340a,1,Yusaku Sako,2013-08-21 11:05:06-07:00,['c309d22722fff0979de995cba093153b91fa6d66'],0,57,57,16677075,4,1,1,1,10994
81cd63d9e66a428289a8eaf3f89061421e752d39,0,Yusaku Sako,2013-08-21 11:08:48-07:00,['7eddd1c5b55614b0d6915af4c7f4bf93758b340a'],0,7,7,16677082,1,0,0,1,10994
67fd6fb7c489b44b83f8552f61e35b28aab5cbc5,1,Siddharth Wagle,2013-08-21 11:39:13-07:00,['81cd63d9e66a428289a8eaf3f89061421e752d39'],27,103,130,16677212,5,,,,10995
88cd415ca5ae69fa13213ab866129caf6b0dbd54,0,Siddharth Wagle,2013-08-21 13:31:53-07:00,['67fd6fb7c489b44b83f8552f61e35b28aab5cbc5'],7,30,37,16677249,1,0,0,1,10995
d26ad0f422b739c3b45b421aea8a004213efbaae,1,Sumit Mohanty,2013-08-21 14:06:17-07:00,['88cd415ca5ae69fa13213ab866129caf6b0dbd54'],122,3,125,16677374,7,1,1,0,10995
30365506a9eba096bbcdb06e12fae72b1a02176e,0,Mahadev Konar,2013-08-21 15:43:43-07:00,['d26ad0f422b739c3b45b421aea8a004213efbaae'],9,10,19,16677393,2,,,,10995
d649f57e213509a50697bf5b1f3f1e75c68f62e4,1,Mahadev Konar,2013-08-21 22:48:56-07:00,['30365506a9eba096bbcdb06e12fae72b1a02176e'],0,2,2,16677395,2,,,,10995
d8afa86728ed0f8e91067b6ff969bcad0440d1a4,1,Mahadev Konar,2013-08-21 22:51:50-07:00,['d649f57e213509a50697bf5b1f3f1e75c68f62e4'],1,10,11,16677406,2,0,1,0,10995
3aa7ef1916275e97f776c05221dfc3bbc95b05d7,1,Mahadev Konar,2013-08-21 23:34:18-07:00,['d8afa86728ed0f8e91067b6ff969bcad0440d1a4'],0,16,16,16677422,2,,,,10995
cfa2f7f304c932f9d6e2383231976acc4dccf406,0,atkach,2013-08-22 12:56:43+03:00,['3aa7ef1916275e97f776c05221dfc3bbc95b05d7'],109,184,293,16677715,7,1,1,1,10997
8d46a38b57f57970e8c8a62e91058d8171850167,1,Lisnichenko Dmitro,2013-08-22 17:58:33+03:00,['cfa2f7f304c932f9d6e2383231976acc4dccf406'],4,35,39,16677754,2,0,0.904761905,0.095238095,10997
758bbc1ac6196eb24c21ed34485e96e414a260ae,1,Lisnichenko Dmitro,2013-08-22 18:00:12+03:00,['8d46a38b57f57970e8c8a62e91058d8171850167'],5,15,20,16677774,5,0.333333333,1,0,10997
20a73bf9ddeb6c26500a5d81dda959539a1c768a,1,Yusaku Sako,2013-08-22 10:20:25-07:00,['758bbc1ac6196eb24c21ed34485e96e414a260ae'],18,79,97,16677871,9,0.939393939,0.96969697,1,10997
ee89427137f8493bfd194efac8e99b70fbc88d39,0,Yusaku Sako,2013-08-22 10:21:25-07:00,['20a73bf9ddeb6c26500a5d81dda959539a1c768a'],0,9,9,16677880,1,1,1,1,10997
93f607e535f500114f70850a97a6314532cd52cd,0,Yusaku Sako,2013-08-22 10:25:12-07:00,['ee89427137f8493bfd194efac8e99b70fbc88d39'],20,55,75,16677955,5,,,,10997
7677554d812866fa6f90c2a80925d7d622722cfb,0,Yusaku Sako,2013-08-22 10:26:58-07:00,['93f607e535f500114f70850a97a6314532cd52cd'],55,20,75,16678030,5,,,,10997
60e1efd0d96c7a477757c0df86e7ad70e03fefcd,1,Yusaku Sako,2013-08-22 10:27:34-07:00,['7677554d812866fa6f90c2a80925d7d622722cfb'],20,55,75,16678105,5,,,,10997
a194cb0c22eee02a37233eae0ac736b71144753e,1,Siddharth Wagle,2013-08-22 11:05:34-07:00,['60e1efd0d96c7a477757c0df86e7ad70e03fefcd'],20,353,373,16678478,5,0.214285714,0.228571429,0.992857143,11000
f9310d6294a998eb270f3c20ebcfc171d8f682fe,1,Sumit Mohanty,2013-08-22 14:38:40-07:00,['a194cb0c22eee02a37233eae0ac736b71144753e'],12,12,24,16678502,2,,,,11000
48046ae478f6e4688d8037242820612796ec9f72,1,Siddharth Wagle,2013-08-22 15:06:36-07:00,['f9310d6294a998eb270f3c20ebcfc171d8f682fe'],0,3,3,16678505,1,,,,11000
4b6ae77bb668167741bcfa87daf19423fbb827e5,0,Siddharth Wagle,2013-08-22 15:06:36-07:00,['48046ae478f6e4688d8037242820612796ec9f72'],3,1,4,16678509,1,1,1,0,11000
43198bf607ba4f86b75bcf4ba01b0eaf4b850ed9,1,Srimanth Gunturi,2013-08-22 15:14:44-07:00,['4b6ae77bb668167741bcfa87daf19423fbb827e5'],184,109,293,16678802,7,0,0,0,11000
012354b7515df9cde15096f0e82a34f9719902a2,0,Jaimin Jetly,2013-08-22 15:34:06-07:00,['43198bf607ba4f86b75bcf4ba01b0eaf4b850ed9'],2,2,4,16678806,1,,,,11000
b4186eb2baf33fab6d82ae0525c9032e46110661,0,Sumit Mohanty,2013-08-22 16:21:19-07:00,['012354b7515df9cde15096f0e82a34f9719902a2'],1,11,12,16678818,1,,,,11000
81bc7d830c71c7e4b8be2d341916cc99754d0c23,1,Siddharth Wagle,2013-08-22 18:02:27-07:00,['b4186eb2baf33fab6d82ae0525c9032e46110661'],6,13,19,16678837,4,,,,11000
23754e344ab034fc53a3f72d40f65acc5a4b37c5,1,Mahadev Konar,2013-08-22 23:35:52-07:00,['81bc7d830c71c7e4b8be2d341916cc99754d0c23'],67,467,534,16679371,20,0.839622642,0.981132075,0.471698113,11008
82adc3442e680a35c3eac45f31b4ad60632797af,1,atkach,2013-08-23 14:56:31+03:00,['23754e344ab034fc53a3f72d40f65acc5a4b37c5'],13,63,76,16679447,7,1,1,1,11010
5cd2cde22ba43dd1fa5c8f9eeea9949b163334c1,1,Lisnichenko Dmitro,2013-08-23 20:54:00+03:00,['82adc3442e680a35c3eac45f31b4ad60632797af'],0,63,63,16679510,5,,,,11010
43a04e4cae6f39514c3e57bed2c77b4028cbff01,1,Oleksandr Diachenko,2013-08-23 21:07:41+03:00,['5cd2cde22ba43dd1fa5c8f9eeea9949b163334c1'],1,1,2,16679512,1,,,,11010
de61875d14814dde4d07d204df030393058ab780,1,Yusaku Sako,2013-08-23 11:08:13-07:00,['43a04e4cae6f39514c3e57bed2c77b4028cbff01'],0,2,2,16679514,1,0,0,1,11010
74eab8d6f2a4a0e3500117b480f15f5fabcc6439,1,Yusaku Sako,2013-08-23 11:09:37-07:00,['de61875d14814dde4d07d204df030393058ab780'],25,53,78,16679592,8,0.666666667,1,1,11010
fc0da06dd92f898c3d7932075a9302c7cd74b40e,1,Lisnichenko Dmitro,2013-08-23 22:25:04+03:00,['74eab8d6f2a4a0e3500117b480f15f5fabcc6439'],1,1,2,16679594,1,,,,11010
8d822cb69d37d4ad88f125475346d9f661001742,0,Siddharth Wagle,2013-08-23 13:47:45-07:00,['fc0da06dd92f898c3d7932075a9302c7cd74b40e'],8,11,19,16679613,3,,,,11010
01b1b682e2ea7b61df00caa3e2b248fa9a9feec8,1,Siddharth Wagle,2013-08-23 13:58:47-07:00,['8d822cb69d37d4ad88f125475346d9f661001742'],3,71,74,16679687,2,0.111111111,0.666666667,0.444444444,11010
650803abf5b2717448df77dfe51e9758362ad0d7,0,Siddharth Wagle,2013-08-23 14:12:18-07:00,['01b1b682e2ea7b61df00caa3e2b248fa9a9feec8'],12,12,24,16679711,2,,,,11010
f011256e2ecd6ebea8aa6159c2ef084f91de5e8c,1,Jaimin Jetly,2013-08-23 14:35:39-07:00,['650803abf5b2717448df77dfe51e9758362ad0d7'],8,12,20,16679731,1,1,1,1,11010
2a3fa82636ff1c5871dc7838208a9ff89ae899c4,1,Yusaku Sako,2013-08-23 14:36:11-07:00,['f011256e2ecd6ebea8aa6159c2ef084f91de5e8c'],17,72,89,16679820,8,0.085106383,0.446808511,1,11010
1f90b35c3cba6af5cbd800a5fcf1db670f3836fa,1,Yusaku Sako,2013-08-23 14:38:00-07:00,['2a3fa82636ff1c5871dc7838208a9ff89ae899c4'],0,1,1,16679821,1,1,0,0,11010
d8f71bbe2f7f9a6789c24107b10d2dbeef4e4217,1,Siddharth Wagle,2013-08-23 14:53:16-07:00,['1f90b35c3cba6af5cbd800a5fcf1db670f3836fa'],154,215,369,16680190,11,0.385964912,0.929824561,0.719298246,11010
62c381115e6097cc53e10a6083edd3fcce5870c7,1,Yusaku Sako,2013-08-23 14:58:55-07:00,['d8f71bbe2f7f9a6789c24107b10d2dbeef4e4217'],4,146,150,16680340,5,0,1,1,11010
90f1aa4a541e8997627a3d1123b495c16e0c960d,1,Yusaku Sako,2013-08-23 15:03:00-07:00,['62c381115e6097cc53e10a6083edd3fcce5870c7'],4,3,7,16680347,2,,,,11010
4f4524474c1470845750fd5d0df89449aa4fe225,1,Yusaku Sako,2013-08-23 15:06:03-07:00,['90f1aa4a541e8997627a3d1123b495c16e0c960d'],112,889,1001,16681348,18,0.066914498,1,0.983271375,11019
c9e842438c60c8bf9e846802bce3c684166c6adc,1,Jaimin Jetly,2013-08-23 15:16:56-07:00,['4f4524474c1470845750fd5d0df89449aa4fe225'],12,12,24,16681372,2,,,,11019
b0ade11f8e1bb85cc3d75a67444bd99542ebc8f9,1,Mahadev Konar,2013-08-25 19:12:23-07:00,['c9e842438c60c8bf9e846802bce3c684166c6adc'],3,236,239,16681611,4,0.452054795,1,1,11022
56539558518062107eaaee6f26e9d545f064f937,1,Mahadev Konar,2013-08-26 10:17:02-07:00,['b0ade11f8e1bb85cc3d75a67444bd99542ebc8f9'],2,2,4,16681615,2,,,,11022
fa123b5863a3cd9045c1aebdeeec538f7f089385,1,Jaimin Jetly,2013-08-26 11:02:20-07:00,['56539558518062107eaaee6f26e9d545f064f937'],0,26,26,16681641,2,,,,11022
e616cca8a78a99c10e0f79ebf95884b6e7bf9041,1,Siddharth Wagle,2013-08-26 13:01:04-07:00,['fa123b5863a3cd9045c1aebdeeec538f7f089385'],4,2,6,16681647,1,1,1,0,11022
a97b09a16aedc01940c84b789abc108e030d0657,0,Sumit Mohanty,2013-08-26 14:23:08-07:00,['e616cca8a78a99c10e0f79ebf95884b6e7bf9041'],0,2,2,16681649,1,,,,11022
2f782bd7c71758a786363198ec8b40b2d49de693,0,Mahadev Konar,2013-08-26 15:11:34-07:00,['a97b09a16aedc01940c84b789abc108e030d0657'],14,13,27,16681676,2,,,,11022
f06bcd91dc75127222e412a003a2dd9181d76dff,1,Siddharth Wagle,2013-08-26 16:06:51-07:00,['2f782bd7c71758a786363198ec8b40b2d49de693'],5,10,15,16681691,1,,,,11022
75d364ec304105f96653e7e44069fbb3d088eeaa,0,Jaimin Jetly,2013-08-26 16:20:44-07:00,['f06bcd91dc75127222e412a003a2dd9181d76dff'],1,1,2,16681693,1,,,,11022
08484a0a999daae06bdee653f6f895e32ae44a5a,1,Mahadev Konar,2013-08-26 17:29:48-07:00,['75d364ec304105f96653e7e44069fbb3d088eeaa'],13,14,27,16681720,2,,,,11022
e980f7e5ae16a651f6da2e4cad87bf708cbdfeb0,1,Jaimin Jetly,2013-08-26 18:26:21-07:00,['08484a0a999daae06bdee653f6f895e32ae44a5a'],2,28,30,16681750,5,0,0,1,11022
abe2aa24749f68adc3f27d9cf79db8717a65804b,0,Jaimin Jetly,2013-08-26 19:55:20-07:00,['e980f7e5ae16a651f6da2e4cad87bf708cbdfeb0'],26,9,35,16681785,2,,,,11022
a706dd95ab62e2656744b124b8e015bc4fda288e,1,Srimanth Gunturi,2013-08-26 23:12:56-07:00,['abe2aa24749f68adc3f27d9cf79db8717a65804b'],18,75,93,16681878,5,1,1,1,11022
ca47b36dfa3cf64c88f916d15041c7aa1c435640,1,atkach,2013-08-27 12:43:41+03:00,['a706dd95ab62e2656744b124b8e015bc4fda288e'],2,14,16,16681894,3,1,1,0.75,11022
1220239dc2b90078a3b060b5315499f8dc7be9fe,0,atkach,2013-08-27 17:28:33+03:00,['ca47b36dfa3cf64c88f916d15041c7aa1c435640'],0,11,11,16681905,1,1,1,1,11022
6f5b24fbd7a0ee60bc59f396b20ac661ac0ecc3d,0,Yusaku Sako,2013-08-27 17:43:12+03:00,['1220239dc2b90078a3b060b5315499f8dc7be9fe'],1,1,2,16681907,1,,,,11022
88d69cb56c4299049fae975fd071281fee225afd,1,Oleksandr Diachenko,2013-08-27 18:06:21+03:00,['6f5b24fbd7a0ee60bc59f396b20ac661ac0ecc3d'],6,26,32,16681939,5,0.066666667,0.8,0.333333333,11022
3bc5effcfaa139b353d04632af6aea7d12e35c35,0,Jaimin Jetly,2013-08-27 11:07:40-07:00,['88d69cb56c4299049fae975fd071281fee225afd'],0,25,25,16681964,2,1,1,1,11022
f94f394038f86c4f6b94963588f6a9fcd2eb113e,0,Mahadev Konar,2013-08-27 11:49:23-07:00,['3bc5effcfaa139b353d04632af6aea7d12e35c35'],5,6,11,16681975,1,0,0,,11022
5ba1e21603451411741e741499a391ccc527a914,1,Jaimin Jetly,2013-08-27 12:52:40-07:00,['f94f394038f86c4f6b94963588f6a9fcd2eb113e'],2,3,5,16681980,1,0,0,1,11022
e4a4cb05a0c0a2cb08b8e5f8c9080922c3858684,0,Siddharth Wagle,2013-08-27 14:07:42-07:00,['5ba1e21603451411741e741499a391ccc527a914'],17,14,31,16682011,2,,,,11022
2070cbc3f9e369e71b2bee95019d0730e26264f7,0,Jaimin Jetly,2013-08-27 14:43:24-07:00,['e4a4cb05a0c0a2cb08b8e5f8c9080922c3858684'],1,1,2,16682013,1,,,,11022
0f8ec4c8a5dd003dcbf3ee39ef29a324e27947aa,1,Yusaku Sako,2013-08-28 15:48:17+03:00,['2070cbc3f9e369e71b2bee95019d0730e26264f7'],2,2,4,16682017,2,,,,11022
017528d8c54b808e6cd56d89aa3fd9efd5086cc1,0,Yusaku Sako,2013-08-28 15:52:27+03:00,['0f8ec4c8a5dd003dcbf3ee39ef29a324e27947aa'],1,1,2,16682019,1,,,,11022
08bcffd94ba71a6551f8628e17eec90723787c2b,1,Yusaku Sako,2013-08-28 15:59:54+03:00,['017528d8c54b808e6cd56d89aa3fd9efd5086cc1'],3,61,64,16682083,3,1,1,1,11022
7d968d39295cba0475adc6b414f9373388f1784a,1,Yusaku Sako,2013-08-28 16:03:04+03:00,['08bcffd94ba71a6551f8628e17eec90723787c2b'],4,61,65,16682148,5,1,1,1,11022
6028540dfbe54e9b113cac3b0f91325901a037a9,1,Jaimin Jetly,2013-08-28 11:52:40-07:00,['7d968d39295cba0475adc6b414f9373388f1784a'],11,167,178,16682326,6,0,1,0,11022
4c2e398e0b2123048c7f8c3af9b49e82aec1562c,1,Sumit Mohanty,2013-08-28 15:01:02-07:00,['6028540dfbe54e9b113cac3b0f91325901a037a9'],35,89,124,16682450,6,0.459459459,1,0.810810811,11022
c8e2dec2fafb1215a5fa9cccc3a1060ade49cd22,1,atkach,2013-08-29 15:24:06+03:00,['4c2e398e0b2123048c7f8c3af9b49e82aec1562c'],2,8,10,16682460,2,1,1,1,11022
214e13211aff9f478b1cf49bd1e103b3c8ad679e,1,atkach,2013-08-29 16:09:18+03:00,['c8e2dec2fafb1215a5fa9cccc3a1060ade49cd22'],4,3,7,16682467,1,,,,11022
31b5fdf4f0e8f64a23f1f260066bc88279830041,1,Oleksandr Diachenko,2013-08-29 18:27:05+03:00,['214e13211aff9f478b1cf49bd1e103b3c8ad679e'],6,3935,3941,16686408,40,0,0,1,11059
43283406cb228970e7da0d2a67155ab5afe4415b,0,Yusaku Sako,2013-08-29 18:30:32+03:00,['31b5fdf4f0e8f64a23f1f260066bc88279830041'],4,12,16,16686424,5,1,1,1,11059
462c6432d42f9bb13bd847c5a01663e6c5205683,1,Yusaku Sako,2013-08-29 18:36:47+03:00,['43283406cb228970e7da0d2a67155ab5afe4415b'],1,1,2,16686426,1,,,,11059
c25d5ad3a198faaf63e473376e621806d14a6c2f,0,Yusaku Sako,2013-08-29 18:43:17+03:00,['462c6432d42f9bb13bd847c5a01663e6c5205683'],12,4,16,16686442,5,0,0,0,11059
713f6ca9f5b29a1dc851b6400dda8ac3925176bc,1,Yusaku Sako,2013-08-29 18:44:33+03:00,['c25d5ad3a198faaf63e473376e621806d14a6c2f'],3,9,12,16686454,4,,,,11059
adff075757991e5ec253213a1351244e5b230ecf,1,Yusaku Sako,2013-08-29 18:47:12+03:00,['713f6ca9f5b29a1dc851b6400dda8ac3925176bc'],1,3,4,16686458,1,1,1,1,11059
ca36faba841da0a0b9b73aa0e38a65e164c4d8b7,0,Jaimin Jetly,2013-08-29 10:16:41-07:00,['adff075757991e5ec253213a1351244e5b230ecf'],2,2,4,16686462,1,,,,11059
bcf447056083f25746c3f5c6a2481ea1d702cb74,0,Sumit Mohanty,2013-08-29 15:18:44-07:00,['ca36faba841da0a0b9b73aa0e38a65e164c4d8b7'],13,13,26,16686488,2,,,,11059
8f5b66286be8bf350e9a507edb9e525985499f9c,1,Oleksandr Diachenko,2013-08-30 14:56:47+03:00,['bcf447056083f25746c3f5c6a2481ea1d702cb74'],4,2110,2114,16688602,31,0.443800695,0.820393975,0.884125145,11079
44cc11dfb38b5dd3ce770fcd3a632c26ae37a596,1,Billie Rinaldi,2013-08-30 13:34:01-07:00,['8f5b66286be8bf350e9a507edb9e525985499f9c'],18,34,52,16688654,3,0.428571429,1,1,11079
203b5f9fdb8a418ced7e9ee2f8f86b8755bcfed1,1,Jaimin Jetly,2013-08-30 14:34:37-07:00,['44cc11dfb38b5dd3ce770fcd3a632c26ae37a596'],30,13,43,16688697,6,,,,11079
f8eea043f26b215fc7927339cc3ff91705bf6c12,1,Jaimin Jetly,2013-08-30 16:32:27-07:00,['203b5f9fdb8a418ced7e9ee2f8f86b8755bcfed1'],3,12,15,16688712,2,0.545454545,0.545454545,1,11079
bbb4553b34f97b85b66269ce7d081daf65c1cfa6,1,atkach,2013-09-02 13:46:30+03:00,['f8eea043f26b215fc7927339cc3ff91705bf6c12'],1,6,7,16688719,1,1,1,1,11079
2a8ea2bd61d3dfb5b445ecacd3708cdce29a71f5,1,atkach,2013-09-02 14:06:48+03:00,['bbb4553b34f97b85b66269ce7d081daf65c1cfa6'],1,1,2,16688721,1,,,,11079
dd33e55e50e1779cc8a272015c9252ea5224e1df,0,Oleksandr Diachenko,2013-09-02 15:45:14+03:00,['2a8ea2bd61d3dfb5b445ecacd3708cdce29a71f5'],2,34,36,16688757,2,,,,11080
5317b35d0f1e9efef316ff3cb1b4a7fcac8ad279,0,Oleksandr Diachenko,2013-09-02 17:25:55+03:00,['dd33e55e50e1779cc8a272015c9252ea5224e1df'],3,27,30,16688787,4,0.25,1,0.5,11080
9c0da685fb7e7391bf0b636858cdf2719c11e83b,0,Lisnichenko Dmitro,2013-09-02 23:21:13+03:00,['5317b35d0f1e9efef316ff3cb1b4a7fcac8ad279'],2,97,99,16688886,9,,,,11083
e1c40dcc2940bd15390f70b1e11ab1a29676b254,1,Lisnichenko Dmitro,2013-09-03 17:02:15+03:00,['9c0da685fb7e7391bf0b636858cdf2719c11e83b'],2,4,6,16688892,1,0,0,1,11083
3d8ecddd525a9c49ef5ad2f2e370e1069a466e66,0,Oleksandr Diachenko,2013-09-03 17:09:09+03:00,['e1c40dcc2940bd15390f70b1e11ab1a29676b254'],64,852,916,16689808,2,,,,11083
26041800e4fca766b5999ecf33fc922dacc4203f,1,Oleksandr Diachenko,2013-09-03 17:33:44+03:00,['3d8ecddd525a9c49ef5ad2f2e370e1069a466e66'],23,129,152,16689960,9,0.131147541,0.786885246,0.885245902,11083
df278233fc7d93ae67d23519dadf66d6100deefa,1,atkach,2013-09-03 17:36:43+03:00,['26041800e4fca766b5999ecf33fc922dacc4203f'],8,44,52,16690012,3,1,1,0.952380952,11083
db277f731e34bbe3b0295317303f3b098ce5b18b,1,Sumit Mohanty,2013-09-03 09:01:00-07:00,['df278233fc7d93ae67d23519dadf66d6100deefa'],12,12,24,16690036,2,,,,11083
9e30642cb2f40c3e5534744a51df954ff50da48b,0,Lisnichenko Dmitro,2013-09-03 19:28:45+03:00,['db277f731e34bbe3b0295317303f3b098ce5b18b'],0,15,15,16690051,1,,,,11083
8bf3d0b56cf66c3ef2e9d61efad942f7cebb405e,1,Lisnichenko Dmitro,2013-09-03 19:34:06+03:00,['9e30642cb2f40c3e5534744a51df954ff50da48b'],7,226,233,16690284,18,0.591397849,0.946236559,0.88172043,11085
c764f2b8c6fb6c1f6339d3a60b49d0dd75f3f971,0,Oleg Nechiporenko,2013-09-03 19:51:53+03:00,['8bf3d0b56cf66c3ef2e9d61efad942f7cebb405e'],1,1,2,16690286,1,,,,11085
b942f7bf542432d0acfb9b76b45ede14aa24f8e9,1,Oleg Nechiporenko,2013-09-03 19:51:53+03:00,['c764f2b8c6fb6c1f6339d3a60b49d0dd75f3f971'],4,4,8,16690294,2,,,,11085
0a7c5d7a787fd5b6568f09aca3f698305602ddfa,0,Oleg Nechiporenko,2013-09-03 19:51:54+03:00,['b942f7bf542432d0acfb9b76b45ede14aa24f8e9'],20,20,40,16690334,5,,,,11085
21b02ef5c760457d0a7e4eddaea930ceae553324,1,atkach,2013-09-03 19:57:39+03:00,['0a7c5d7a787fd5b6568f09aca3f698305602ddfa'],17,48,65,16690399,2,0.484848485,1,1,11085
f0c0cd24eae11e0815c4a15ffbd5d71413aaf8b7,1,atkach,2013-09-03 20:02:16+03:00,['21b02ef5c760457d0a7e4eddaea930ceae553324'],17,24,41,16690440,4,1,1,1,11085
9af3e3f8d86582f99c706a35ddc52e53dd88a931,0,Yusaku Sako,2013-09-03 14:04:36-07:00,['f0c0cd24eae11e0815c4a15ffbd5d71413aaf8b7'],9,3,12,16690452,1,1,1,1,11085
558d5fb646eabc160798b52205eae1f55f937822,1,Yusaku Sako,2013-09-03 14:24:41-07:00,['9af3e3f8d86582f99c706a35ddc52e53dd88a931'],1,1,2,16690454,1,,,,11085
553bf73d1767d70f392e99fc68cb5187ad706bf6,1,Jaimin Jetly,2013-09-03 18:04:11-07:00,['558d5fb646eabc160798b52205eae1f55f937822'],13,18,31,16690485,2,,,,11085
bf55a2e12175e2e52f3eeab09f87c4218d24ffff,0,Yusaku Sako,2013-09-03 18:16:25-07:00,['553bf73d1767d70f392e99fc68cb5187ad706bf6'],0,24,24,16690509,1,,,,11085
b4c9c9775ae1490718585c4c9c8fd8319910c00c,1,Jaimin Jetly,2013-09-03 18:50:51-07:00,['bf55a2e12175e2e52f3eeab09f87c4218d24ffff'],3,9,12,16690521,2,1,1,1,11085
1b6281f2fe2414117ec065a0c1d4308628f08231,0,Oleg Nechiporenko,2013-09-04 13:02:06+03:00,['b4c9c9775ae1490718585c4c9c8fd8319910c00c'],2,3,5,16690526,2,,,,11085
dea1f811a03fed5d5c873bd409777cfed7ddbbdb,0,atkach,2013-09-04 13:16:32+03:00,['1b6281f2fe2414117ec065a0c1d4308628f08231'],8,8,16,16690542,2,,,,11085
bd97893f7684871fc7a38c489605b623f27cca48,0,Oleksandr Diachenko,2013-09-04 16:11:14+03:00,['dea1f811a03fed5d5c873bd409777cfed7ddbbdb'],0,12,12,16690554,2,,,,11085
dc22f4f465f641d22d81ae699d8f187f06b2f56b,0,Oleksandr Diachenko,2013-09-04 16:14:55+03:00,['bd97893f7684871fc7a38c489605b623f27cca48'],0,1,1,16690555,1,,,,11085
631ae2b5b683e75fa5b388bc977bf6d13715d6fa,1,atkach,2013-09-04 17:24:09+03:00,['dc22f4f465f641d22d81ae699d8f187f06b2f56b'],2,2,4,16690559,1,,,,11085
ddfbda054fd2c7cf063c2a1ef8189e880c091a4a,1,Oleksandr Diachenko,2013-09-04 18:19:01+03:00,['631ae2b5b683e75fa5b388bc977bf6d13715d6fa'],1,100,101,16690660,4,,,,11086
9a5060c0c63e1649093ebe883d789def7f55313a,1,Oleksandr Diachenko,2013-09-04 18:55:21+03:00,['ddfbda054fd2c7cf063c2a1ef8189e880c091a4a'],3,34,37,16690697,2,0.272727273,1,0.181818182,11086
c34ab731ed59ba66f8592a5944e13c892a8e9d11,1,atkach,2013-09-04 19:31:23+03:00,['9a5060c0c63e1649093ebe883d789def7f55313a'],15,17,32,16690729,2,,,,11086
a5141de3c3309417faae385ed0c25c54321ddf5d,1,Yusaku Sako,2013-09-04 09:48:36-07:00,['c34ab731ed59ba66f8592a5944e13c892a8e9d11'],24,25,49,16690778,1,,,,11086
613aee60b88b4fa5aeaeae15c434653b050ca714,1,Sumit Mohanty,2013-09-04 10:07:43-07:00,['a5141de3c3309417faae385ed0c25c54321ddf5d'],0,753,753,16691531,2,0.352769679,0.370262391,0.755102041,11088
96751430b7c5110076a8026bfdb7c1f203d68321,0,Yusaku Sako,2013-09-04 10:09:07-07:00,['613aee60b88b4fa5aeaeae15c434653b050ca714'],15,24,39,16691570,2,1,1,1,11088
2ded3d1afae92a84b160e7d06ebcede98324b410,0,Siddharth Wagle,2013-09-04 10:25:44-07:00,['96751430b7c5110076a8026bfdb7c1f203d68321'],1,1,2,16691572,1,,,,11088
6fc9f12ef03e087646afe593e618ed06753e5005,1,Sumit Mohanty,2013-09-04 13:52:41-07:00,['2ded3d1afae92a84b160e7d06ebcede98324b410'],9,50,59,16691631,2,0.666666667,0.121212121,0.090909091,11088
2adbf8310386b9f212b50ff80b687967554e66b6,1,Yusaku Sako,2013-09-04 15:37:52-07:00,['6fc9f12ef03e087646afe593e618ed06753e5005'],15,15,30,16691661,4,,,,11088
73d4939911c6dc73474a61bd155b7110d60be869,1,Siddharth Wagle,2013-09-04 15:55:35-07:00,['2adbf8310386b9f212b50ff80b687967554e66b6'],23,123,146,16691807,2,0.263157895,0.565789474,1,11088
422c5f89096dc0cab30b95b012d1616e3302b9e4,1,Alex Antonenko,2013-09-05 03:23:01+03:00,['73d4939911c6dc73474a61bd155b7110d60be869'],2,41,43,16691850,5,0,1,1,11088
e6be9e275acbe01fbac24ff32d43e1138eefbd45,1,Yusaku Sako,2013-09-04 17:50:20-07:00,['422c5f89096dc0cab30b95b012d1616e3302b9e4'],1,1,2,16691852,1,,,,11088
7ac4b6cb43425f4942f8273d3dcfe77fbbb3cb51,1,Srimanth Gunturi,2013-09-04 17:50:27-07:00,['e6be9e275acbe01fbac24ff32d43e1138eefbd45'],24,55,79,16691931,3,,,,11088
75b0c440036a48e8706008014e37606089cbfaea,1,Alex Antonenko,2013-09-05 09:44:04+03:00,['7ac4b6cb43425f4942f8273d3dcfe77fbbb3cb51'],0,69,69,16692000,4,1,1,1,11089
ee4997c52b1845346bccd07c8f45c26d226bc9da,1,Lisnichenko Dmitro,2013-09-05 14:49:34+03:00,['75b0c440036a48e8706008014e37606089cbfaea'],2,32,34,16692034,2,0,1,0.043478261,11089
c25e5c224ed12a02e3583fc67e762263f4ac1047,0,Lisnichenko Dmitro,2013-09-05 15:04:16+03:00,['ee4997c52b1845346bccd07c8f45c26d226bc9da'],1,15,16,16692050,2,,,,11089
f8e59976d7ab96e1407b40795ebf2b6295169f71,1,Oleg Nechiporenko,2013-09-05 17:13:48+03:00,['c25e5c224ed12a02e3583fc67e762263f4ac1047'],4,4,8,16692058,4,,,,11089
9496abdd25f5c93afd9d866d4f1626d6c547d2c2,0,Lisnichenko Dmitro,2013-09-05 18:29:35+03:00,['f8e59976d7ab96e1407b40795ebf2b6295169f71'],6,10,16,16692074,3,1,1,0.5,11089
def7e8cf9e26c89b12c2391ad60ccb063b65f3d9,1,Lisnichenko Dmitro,2013-09-05 19:46:11+03:00,['9496abdd25f5c93afd9d866d4f1626d6c547d2c2'],7,144,151,16692225,6,0.141304348,0.75,0.945652174,11089
013a75a98f5d073f0faf54408163faeafe2800f4,1,Lisnichenko Dmitro,2013-09-05 20:18:31+03:00,['def7e8cf9e26c89b12c2391ad60ccb063b65f3d9'],604,4090,4694,16696919,11,0,0.991452991,1,11091
8420c8773654a6521e718229763fc806d50c56be,0,Lisnichenko Dmitro,2013-09-05 20:31:50+03:00,['013a75a98f5d073f0faf54408163faeafe2800f4'],15,1,16,16696935,2,,,,11091
a8ba15f48e5a142d0e7d7b6501deec461548e00d,0,Yusaku Sako,2013-09-05 11:08:31-07:00,['8420c8773654a6521e718229763fc806d50c56be'],16,18,34,16696969,1,0,0,1,11091
7a8c397df2744f45bc2fbd357e9d7144a3eed656,0,Mahadev Konar,2013-09-05 11:20:30-07:00,['a8ba15f48e5a142d0e7d7b6501deec461548e00d'],3,1,4,16696973,1,,,,11091
f26e64c9ed494a107ce3ce15bb82ce26d52a0d3f,0,Jaimin Jetly,2013-09-05 11:20:51-07:00,['7a8c397df2744f45bc2fbd357e9d7144a3eed656'],1,11,12,16696985,1,,,,11091
c05f22cda8bac07a88c4ac9f959ad7670dc8f834,1,Oleksandr Diachenko,2013-09-05 21:32:08+03:00,['f26e64c9ed494a107ce3ce15bb82ce26d52a0d3f'],10,172,182,16697167,4,0.064220183,0.834862385,0.394495413,11091
a841617628a93939ec216366b47fcf4eadf0086e,0,Lisnichenko Dmitro,2013-09-05 22:40:52+03:00,['c05f22cda8bac07a88c4ac9f959ad7670dc8f834'],2,141,143,16697310,3,0,0.3125,1,11091
bb280dfdc8a79832d5196498c412b020e4b2e15f,0,Oleksandr Diachenko,2013-09-05 23:57:28+03:00,['a841617628a93939ec216366b47fcf4eadf0086e'],4,42,46,16697356,4,0.238095238,1,1,11091
52e689237c34698061c885b43a3e4c3d286999e1,1,Yusaku Sako,2013-09-05 13:59:45-07:00,['bb280dfdc8a79832d5196498c412b020e4b2e15f'],0,47,47,16697403,1,0.3,0.325,1,11091
ceb2fc41299cf172b898a02a2581d55a1109ffe3,1,Siddharth Wagle,2013-09-05 14:25:42-07:00,['52e689237c34698061c885b43a3e4c3d286999e1'],4,23,27,16697430,3,1,1,1,11091
45a53ede17c6a1f451bbf0a795a5cac6dec04298,1,Siddharth Wagle,2013-09-05 15:51:22-07:00,['ceb2fc41299cf172b898a02a2581d55a1109ffe3'],1,3,4,16697434,1,0,0,0,11091
6fd7a32815fc7bc87277b6836ebf97c4896657f3,1,Sumit Mohanty,2013-09-05 16:53:39-07:00,['45a53ede17c6a1f451bbf0a795a5cac6dec04298'],7,110,117,16697551,4,0.13253012,0.855421687,1,11091
e3198304fc829bd326964019dd8206af67933138,1,Mahadev Konar,2013-09-05 18:45:12-07:00,['6fd7a32815fc7bc87277b6836ebf97c4896657f3'],1,1,2,16697553,1,,,,11091
22e209e862568346749dabff50d515e3e594fe4d,1,Yusaku Sako,2013-09-05 18:55:21-07:00,['e3198304fc829bd326964019dd8206af67933138'],46,67,113,16697666,8,,,,11091
e6a05f4141ae4eb960b0b72b42d1c4ba0f10d6f8,0,Oleg Nechiporenko,2013-09-06 12:04:49+03:00,['22e209e862568346749dabff50d515e3e594fe4d'],3,5,8,16697674,1,1,1,0,11091
747bd1e310ce480098dfabd20a20577f3ec5c7cd,1,Alex Antonenko,2013-09-06 12:48:47+03:00,['e6a05f4141ae4eb960b0b72b42d1c4ba0f10d6f8'],2,4,6,16697680,1,0.5,1,1,11091
38bcb75a6af89c9f7ad073042c2137277658c5cc,0,atkach,2013-09-06 14:18:15+03:00,['747bd1e310ce480098dfabd20a20577f3ec5c7cd'],5,242,247,16697927,8,1,1,1,11093
bdd36f5c6e80e749e90efa880e1c19755ccce1e1,1,Oleg Nechiporenko,2013-09-06 15:37:20+03:00,['38bcb75a6af89c9f7ad073042c2137277658c5cc'],1,1,2,16697929,1,,,,11093
e4a263877730dfc7d0792fedb27649cdf4d4b5a5,0,Yusaku Sako,2013-09-06 11:04:44-07:00,['bdd36f5c6e80e749e90efa880e1c19755ccce1e1'],3,3,6,16697935,1,,,,11093
bd6779848e069d580ab7570c13f9873a4889f1c6,0,Yusaku Sako,2013-09-06 11:08:20-07:00,['e4a263877730dfc7d0792fedb27649cdf4d4b5a5'],5,5,10,16697945,1,,,,11093
c8a6cbd38b52d50f280726949b5396e3ff182f69,1,Yusaku Sako,2013-09-06 11:13:10-07:00,['bd6779848e069d580ab7570c13f9873a4889f1c6'],0,1,1,16697946,1,,,,11093
8682a95e45f37b9fe4dadf5c03b8e38df3700cda,0,Srimanth Gunturi,2013-09-06 11:18:33-07:00,['c8a6cbd38b52d50f280726949b5396e3ff182f69'],19,56,75,16698021,4,1,1,1,11093
8ba6957253de840a08fb31c2d1ef7708bbaeae20,1,Yusaku Sako,2013-09-06 11:25:29-07:00,['8682a95e45f37b9fe4dadf5c03b8e38df3700cda'],31,50,81,16698102,2,1,0.235294118,1,11093
2fd989f11f115d1d11f4201ade00ff3f63628367,1,Yusaku Sako,2013-09-06 11:27:48-07:00,['8ba6957253de840a08fb31c2d1ef7708bbaeae20'],1,1,2,16698104,1,,,,11093
a69e026f49a6c88d29128e894a421908d2623716,1,Nate Cole,2013-09-06 15:00:51-04:00,['2fd989f11f115d1d11f4201ade00ff3f63628367'],0,38,38,16698142,1,,,,11093
e032673e6b2ebbbb93eddc503381abedafb76407,1,Jaimin Jetly,2013-09-06 12:29:50-07:00,['a69e026f49a6c88d29128e894a421908d2623716'],12,73,85,16698227,3,0.916666667,1,0.75,11093
66ce099f5889651f84621c1d303da9f6cccd287f,1,Yusaku Sako,2013-09-06 13:54:01-07:00,['e032673e6b2ebbbb93eddc503381abedafb76407'],4,4,8,16698235,2,,,,11093
e0e7514518683272c3c40198324851f617b413e4,1,Srimanth Gunturi,2013-09-06 14:18:58-07:00,['66ce099f5889651f84621c1d303da9f6cccd287f'],182,129,311,16698546,9,1,1,0,11093
3e88cb6faa196525f38d20d5019de6c9974cbb0d,1,Siddharth Wagle,2013-09-06 15:06:34-07:00,['e0e7514518683272c3c40198324851f617b413e4'],39,267,306,16698852,32,0.569230769,0.784615385,1,11094
207047375ca0596a2b1929749f3b2d0fc6d34f86,1,Siddharth Wagle,2013-09-06 15:08:15-07:00,['3e88cb6faa196525f38d20d5019de6c9974cbb0d'],29,151,180,16699032,14,0.147540984,0.295081967,0.918032787,11094
3e318f904180e51d4f8d4b16abbbc4ff12e56b04,1,Yusaku Sako,2013-09-06 15:37:07-07:00,['207047375ca0596a2b1929749f3b2d0fc6d34f86'],16,63,79,16699111,4,,,,11094
205bd5695ac850fb98640f27d156cfb668e1a105,0,Jaimin Jetly,2013-09-06 17:20:19-07:00,['3e318f904180e51d4f8d4b16abbbc4ff12e56b04'],14,4,18,16699129,3,,,,11094
670cd8f1b38c7ceaa7c9481062267db54aa14c1f,1,Yusaku Sako,2013-09-06 17:38:43-07:00,['205bd5695ac850fb98640f27d156cfb668e1a105'],1,1,2,16699131,1,,,,11094
36ff824e5dbc2ec46800026f5229e783b671029f,1,Yusaku Sako,2013-09-06 17:44:38-07:00,['670cd8f1b38c7ceaa7c9481062267db54aa14c1f'],12,2,14,16699145,1,0.6,0.6,0,11094
b19122629d9c35d81efe5ac16b37eebf19e7c5a1,1,Siddharth Wagle,2013-09-06 17:58:53-07:00,['36ff824e5dbc2ec46800026f5229e783b671029f'],4,63,67,16699212,4,0,0.769230769,0.769230769,11094
8098df95b87554dedbac164c21c3f0fedcf6bff7,1,Alex Antonenko,2013-09-07 17:32:23+03:00,['b19122629d9c35d81efe5ac16b37eebf19e7c5a1'],10,74,84,16699296,5,0.461538462,1,1,11094
5700280279b8c8b87b82c798b8959d09839e87dd,1,atkach,2013-09-09 14:04:44+03:00,['8098df95b87554dedbac164c21c3f0fedcf6bff7'],4,72,76,16699372,5,1,1,1,11094
0634c2c0444a11295e0bbec53d559b543c44f753,1,Alex Antonenko,2013-09-09 14:58:09+03:00,['5700280279b8c8b87b82c798b8959d09839e87dd'],1,2,3,16699375,1,1,1,1,11094
2406165f7ca7caaf6c9a034dac3a4a7f0ccb34ef,0,Lisnichenko Dmitro,2013-09-09 15:59:55+03:00,['0634c2c0444a11295e0bbec53d559b543c44f753'],0,2,2,16699377,1,,,,11094
f79b9ff3cbf414b9609aa085c8980f4df3620daf,0,Sumit Mohanty,2013-09-09 10:20:26-07:00,['2406165f7ca7caaf6c9a034dac3a4a7f0ccb34ef'],0,8,8,16699385,1,,,,11094
13a488d6fe0c21d719d8297aed77fe0eafc920c8,0,Mahadev Konar,2013-09-09 10:21:26-07:00,['f79b9ff3cbf414b9609aa085c8980f4df3620daf'],0,0,0,16699385,1,,,,11094
ff72393920d6e42ad625b297f57a0b7fb26dacbc,1,Mahadev Konar,2013-09-09 10:28:50-07:00,['13a488d6fe0c21d719d8297aed77fe0eafc920c8'],2,82,84,16699469,2,0,0.878787879,1,11094
c35d8ae4fb8c036ef33c0552223ea0d7256a7a1a,0,Srimanth Gunturi,2013-09-09 18:00:20-07:00,['ff72393920d6e42ad625b297f57a0b7fb26dacbc'],5,9,14,16699483,4,1,1,1,11094
188b7dbd8a570a24595d4d690c28fe7b53d16cc6,1,Sumit Mohanty,2013-09-09 18:28:32-07:00,['c35d8ae4fb8c036ef33c0552223ea0d7256a7a1a'],12,14,26,16699509,3,0.75,0.75,0,11094
f0f76f280a9d1edc8a53864d5c0e831a20438da6,1,Sumit Mohanty,2013-09-09 18:54:59-07:00,['188b7dbd8a570a24595d4d690c28fe7b53d16cc6'],0,1,1,16699510,1,0,1,0,11094
e49551d1b68f9067e05a444c2ec4e3f92fac76af,1,Oleg Nechiporenko,2013-09-10 13:30:00+03:00,['f0f76f280a9d1edc8a53864d5c0e831a20438da6'],0,1,1,16699511,1,1,0,1,11094
f8e39c72c9c923be95317e6acf874660b055a927,1,Alex Antonenko,2013-09-10 17:31:58+03:00,['e49551d1b68f9067e05a444c2ec4e3f92fac76af'],11,247,258,16699769,8,0.631284916,1,0.899441341,11094
23ceb77134f34ab63dff9ac8b8ff2f70b6433afa,0,Oleksandr Diachenko,2013-09-10 18:20:56+03:00,['f8e39c72c9c923be95317e6acf874660b055a927'],1,3,4,16699773,1,,,,11094
0204583f060ff31df6fea4cc90e78def31538f17,0,Lisnichenko Dmitro,2013-09-10 19:01:35+03:00,['23ceb77134f34ab63dff9ac8b8ff2f70b6433afa'],6,11,17,16699790,1,,,,11094
045c8b96a0fb0cd5c02570ac9e856544ec73953b,0,Lisnichenko Dmitro,2013-09-10 19:11:38+03:00,['0204583f060ff31df6fea4cc90e78def31538f17'],1,2,3,16699793,1,,,,11094
9bb87a35cb9ac9e8d2045c69d347f10f5c4b1284,1,Alex Antonenko,2013-09-10 19:44:32+03:00,['045c8b96a0fb0cd5c02570ac9e856544ec73953b'],28,36,64,16699857,1,1,1,1,11094
32c3887ebdeb1d7b75d6ebd99007d4b5894755ca,1,Oleg Nechiporenko,2013-09-10 19:48:55+03:00,['9bb87a35cb9ac9e8d2045c69d347f10f5c4b1284'],3,10,13,16699870,1,1,1,1,11094
6782de914aef04e8085f75188c52da5a72906b41,1,Alex Antonenko,2013-09-10 19:51:41+03:00,['32c3887ebdeb1d7b75d6ebd99007d4b5894755ca'],3,6,9,16699879,1,1,1,1,11094
3e962ea58651ea9b134576646ac565a7c25cace0,1,Yusaku Sako,2013-09-10 10:09:36-07:00,['6782de914aef04e8085f75188c52da5a72906b41'],2,14,16,16699895,2,0,0,1,11094
a4a26da76c9373260464cbf90968a14cacf7a9d5,1,Yusaku Sako,2013-09-10 10:12:21-07:00,['3e962ea58651ea9b134576646ac565a7c25cace0'],3,5,8,16699903,1,0,0,1,11094
dd5b2aa46ad2e6c39e2bd03f2e4994c33f34f246,1,Mahadev Konar,2013-09-10 11:10:36-07:00,['a4a26da76c9373260464cbf90968a14cacf7a9d5'],341,5243,5584,16705487,45,0.378531073,0.824858757,0.70433145,11110
873d9a9a6197c87080409a425621fa4e4829547e,0,Siddharth Wagle,2013-09-10 11:29:04-07:00,['dd5b2aa46ad2e6c39e2bd03f2e4994c33f34f246'],583,0,583,16706070,1,,,,11110
9660e52e05e57f86461eabc827a2357117ba77ed,0,Nate Cole,2013-09-10 14:44:11-04:00,['873d9a9a6197c87080409a425621fa4e4829547e'],3,1,4,16706074,1,1,0,0,11110
b105d51bd3630e22fd5c9c2235d0072282cd0572,0,Siddharth Wagle,2013-09-10 15:00:15-07:00,['9660e52e05e57f86461eabc827a2357117ba77ed'],6,6,12,16706086,2,,,,11110
01659c22427cfe389678092f011984edeb3562de,1,Jaimin Jetly,2013-09-10 15:17:25-07:00,['b105d51bd3630e22fd5c9c2235d0072282cd0572'],44,19,63,16706149,9,0.375,0.375,1,11110
7a058ce61992ae333916cab10327fb745f46be84,0,tbeerbower,2013-09-10 19:32:41-04:00,['01659c22427cfe389678092f011984edeb3562de'],14,14,28,16706177,1,,,,11110
57c53df7c105ec966407d1deca8a5f308de23030,0,Oleksandr Diachenko,2013-09-11 02:42:39+03:00,['7a058ce61992ae333916cab10327fb745f46be84'],4,8,12,16706189,1,,,,11110
73f5c2ce122e5b2082ad3e0d5406837d3404b888,0,Sumit Mohanty,2013-09-10 18:06:45-07:00,['57c53df7c105ec966407d1deca8a5f308de23030'],1,0,1,16706190,1,1,0,0,11110
4c2d5bfef054eef49ada1bf06b958297387083a6,1,Sumit Mohanty,2013-09-10 18:08:17-07:00,['73f5c2ce122e5b2082ad3e0d5406837d3404b888'],29,454,483,16706673,2,0.146067416,0.820224719,0.109550562,11110
52164b180dda31523e025b279bf906301ec5a64c,1,atkach,2013-09-11 15:04:10+03:00,['4c2d5bfef054eef49ada1bf06b958297387083a6'],141,123,264,16706937,3,0.25,0,0,11110
d43f37e52102d561b2958da9ea5e37946bc92a8b,1,Oleksandr Diachenko,2013-09-11 15:47:24+03:00,['52164b180dda31523e025b279bf906301ec5a64c'],5,187,192,16707129,6,0.234693878,0.918367347,1,11110
55add73bd3a637e804c82212aec61e83e90ad2b4,1,Oleksandr Diachenko,2013-09-11 16:18:04+03:00,['d43f37e52102d561b2958da9ea5e37946bc92a8b'],2,2,4,16707133,2,,,,11110
098f5f2d9c11d2554c394d538836ac31ba4229ef,0,Oleksandr Diachenko,2013-09-11 18:37:59+03:00,['55add73bd3a637e804c82212aec61e83e90ad2b4'],41,44,85,16707218,1,,,,11110
9b240c97a77f00f78a4c97744c853ab2f2a21923,1,Alex Antonenko,2013-09-11 19:42:52+03:00,['55add73bd3a637e804c82212aec61e83e90ad2b4'],2,8,10,16707228,5,1,1,1,11110
8d3f646611d933407a199b0c4dca9f2e21c6411a,0,Alex Antonenko,2013-09-11 19:47:25+03:00,"['9b240c97a77f00f78a4c97744c853ab2f2a21923', '098f5f2d9c11d2554c394d538836ac31ba4229ef']",41,44,85,16707313,1,,,,11110
6106dff05bc4637d6fc7f0ca6b7d3815da0f3d3e,1,Jaimin Jetly,2013-09-11 10:11:03-07:00,['8d3f646611d933407a199b0c4dca9f2e21c6411a'],2,23,25,16707338,2,1,1,1,11110
66d717a03ab49a6e7b7211b1d60876718f8350a8,0,Yusaku Sako,2013-09-11 11:01:44-07:00,['6106dff05bc4637d6fc7f0ca6b7d3815da0f3d3e'],18,19,37,16707375,4,,,,11110
59076a55fe2e149a4a7018e42d400b56265ae98f,1,Sumit Mohanty,2013-09-11 11:32:29-07:00,['66d717a03ab49a6e7b7211b1d60876718f8350a8'],90,94,184,16707559,2,1,0,1,11110
2518fe1286f5b7e61a54f542f02c3cfdfa5bd607,1,Mahadev Konar,2013-09-11 14:35:59-07:00,['59076a55fe2e149a4a7018e42d400b56265ae98f'],8,4,12,16707571,1,,,,11110
4ddff3e505cd44da9bab3a248408bfeeace0edfb,1,Siddharth Wagle,2013-09-11 15:28:13-07:00,['2518fe1286f5b7e61a54f542f02c3cfdfa5bd607'],2,2,4,16707575,1,,,,11110
752542b0f7c733c69fdd081213abcc72d1ec7b9d,1,Mahadev Konar,2013-09-11 15:49:50-07:00,['4ddff3e505cd44da9bab3a248408bfeeace0edfb'],0,7844,7844,16715419,74,,,,11184
842c4ba57812267e9153b10305101165dfc714f2,0,Mahadev Konar,2013-09-11 18:34:51-07:00,['752542b0f7c733c69fdd081213abcc72d1ec7b9d'],1,1,2,16715421,1,,,,11184
bd920a598152e8238d6fb9b6a91ab16468f621cd,0,Jaimin Jetly,2013-09-11 18:41:09-07:00,['842c4ba57812267e9153b10305101165dfc714f2'],8,13,21,16715442,2,,,,11184
5da35605b072a83ca99a9cd8adb10b5daca6066a,1,Mahadev Konar,2013-09-11 18:43:12-07:00,['bd920a598152e8238d6fb9b6a91ab16468f621cd'],0,28,28,16715470,2,,,,11184
60be849a322cdd47a10b7a4d6d8d7177ace2bf75,1,Dilli Dorai Arumugam,2013-09-11 18:56:02-07:00,['5da35605b072a83ca99a9cd8adb10b5daca6066a'],13,115,128,16715598,6,0.31372549,0.843137255,0.843137255,11184
acfbf348a771eabbca6e78189b3be8abcef87ded,1,Sumit Mohanty,2013-09-11 20:23:50-07:00,['60be849a322cdd47a10b7a4d6d8d7177ace2bf75'],23,5,28,16715626,3,0,1,0,11184
76daacf0f7de1734cb63c2b0a06bd7c70f7412ae,1,Sumit Mohanty,2013-09-11 23:14:35-07:00,['acfbf348a771eabbca6e78189b3be8abcef87ded'],83,118,201,16715827,5,0,0,0,11184
a0993a734c6fc30d0f582f7df2956da40b04ea16,1,atkach,2013-09-12 12:28:40+03:00,['76daacf0f7de1734cb63c2b0a06bd7c70f7412ae'],2,9,11,16715838,1,1,1,1,11184
dd35bed89c64e5137e7bfde29d213b70543c92c7,0,atkach,2013-09-12 13:54:40+03:00,['a0993a734c6fc30d0f582f7df2956da40b04ea16'],52,60,112,16715950,2,1,1,1,11184
a50d9904e89cd34c691adc0a98383563e391b158,1,Oleg Nechiporenko,2013-09-12 14:26:40+03:00,['dd35bed89c64e5137e7bfde29d213b70543c92c7'],89,176,265,16716215,5,0.137254902,0.470588235,1,11184
62cd376777c67d548c52faca07153c353b471284,1,Lisnichenko Dmitro,2013-09-12 16:55:02+03:00,['a50d9904e89cd34c691adc0a98383563e391b158'],6,11,17,16716232,2,0,0.25,1,11184
b4cb39a08455cf8d4b4c15543ae1996d41f1f1ce,0,Oleg Nechiporenko,2013-09-12 16:58:32+03:00,['62cd376777c67d548c52faca07153c353b471284'],5,2,7,16716239,1,1,1,0,11184
3f688723b716d5b3f52922ce913c6db05d559dae,1,Oleg Nechiporenko,2013-09-12 16:58:33+03:00,['b4cb39a08455cf8d4b4c15543ae1996d41f1f1ce'],0,1,1,16716240,1,1,1,1,11184
69a97d479ac972a65b34f7f9bae68578a1b25853,1,Oleksandr Diachenko,2013-09-12 16:59:49+03:00,['3f688723b716d5b3f52922ce913c6db05d559dae'],3,9,12,16716252,1,0,1,1,11184
5f9b4e834dd3c493038989171541c157f153ba7c,1,Lisnichenko Dmitro,2013-09-12 17:42:29+03:00,['69a97d479ac972a65b34f7f9bae68578a1b25853'],71,12,83,16716335,7,,,,11184
2a85a64b5838e86a0890f4dc244ef81ed7476698,1,Alex Antonenko,2013-09-12 18:57:45+03:00,['5f9b4e834dd3c493038989171541c157f153ba7c'],0,8,8,16716343,2,0.4,1,1,11184
bf8b16576cf3268e8619211fe45d8c573ff67797,1,Alex Antonenko,2013-09-12 19:07:07+03:00,['2a85a64b5838e86a0890f4dc244ef81ed7476698'],2,2,4,16716347,1,,,,11184
abb8020e29e83f82114ba2f7d6582d3aab6d4ca4,0,Alex Antonenko,2013-09-12 19:16:52+03:00,['bf8b16576cf3268e8619211fe45d8c573ff67797'],0,11,11,16716358,1,1,1,1,11184
f5b58134337fceae8c7cfc85cea446a97b28ed34,1,Nate Cole,2013-09-12 15:29:54-04:00,['abb8020e29e83f82114ba2f7d6582d3aab6d4ca4'],8,134,142,16716500,3,0.05,0.775,1,11184
2aaf8bc1412004cde19f41c63687a91b273001f9,0,Nate Cole,2013-09-12 15:38:35-04:00,['f5b58134337fceae8c7cfc85cea446a97b28ed34'],2,2,4,16716504,1,,,,11184
043604e606ca63025da5d2913646a3eaae5056b5,1,Oleksandr Diachenko,2013-09-12 22:50:18+03:00,['2aaf8bc1412004cde19f41c63687a91b273001f9'],7,99,106,16716610,5,1,1,0.275862069,11185
fbf7afc1b6e0cdeb1a31c5cf6691f91501532ff1,0,Yusaku Sako,2013-09-12 12:50:48-07:00,['043604e606ca63025da5d2913646a3eaae5056b5'],0,1,1,16716611,1,,,,11185
7a26b7ef894294851a8babf1c539a70df952bdc4,1,Yusaku Sako,2013-09-12 12:53:08-07:00,['fbf7afc1b6e0cdeb1a31c5cf6691f91501532ff1'],19,123,142,16716753,6,0.277777778,0.277777778,1,11185
16088a760e1569d91037481e947f52fdf689f68d,1,Yusaku Sako,2013-09-12 12:54:26-07:00,['7a26b7ef894294851a8babf1c539a70df952bdc4'],23,42,65,16716818,2,0.125,1,1,11185
8dd0f4f51b00d970b783c0addc746a0db6180fd8,0,Siddharth Wagle,2013-09-12 12:56:32-07:00,['16088a760e1569d91037481e947f52fdf689f68d'],0,5,5,16716823,1,,,,11185
4a0b21b54d5e7fa9e4040d88d12feebbdf896176,1,Yusaku Sako,2013-09-12 12:59:42-07:00,['8dd0f4f51b00d970b783c0addc746a0db6180fd8'],34,159,193,16717016,3,0.402597403,0.779220779,1,11185
0b010afb0fda18e64f2f4e582f9b0f7548c0752b,1,Yusaku Sako,2013-09-12 13:58:00-07:00,['4a0b21b54d5e7fa9e4040d88d12feebbdf896176'],38,83,121,16717137,1,0.490196078,0.509803922,1,11185
aacb46fbdd4de5fd30ddbbf55eeb5d03823e7ea3,1,Jaimin Jetly,2013-09-12 14:31:03-07:00,['0b010afb0fda18e64f2f4e582f9b0f7548c0752b'],48,69,117,16717254,3,1,1,1,11185
d6ad2991ce8b8aaeb98d8d8fbdcbff1ad98ebb71,1,Yusaku Sako,2013-09-12 15:25:06-07:00,['aacb46fbdd4de5fd30ddbbf55eeb5d03823e7ea3'],8,45,53,16717307,6,0.666666667,0.666666667,1,11185
fb7e4a2127736e7978010f91c1075ad86dc1b160,1,Sumit Mohanty,2013-09-12 15:48:02-07:00,['d6ad2991ce8b8aaeb98d8d8fbdcbff1ad98ebb71'],4,4,8,16717315,3,,,,11185
43cbbdeb8013e41fde76df8ab7b5babccb10def1,1,Siddharth Wagle,2013-09-12 16:01:45-07:00,['fb7e4a2127736e7978010f91c1075ad86dc1b160'],9,12,21,16717336,2,0,1,1,11185
3cf02594eb1f8e955a94bbe4749bbbc6940bbd60,1,Sumit Mohanty,2013-09-12 16:04:36-07:00,['43cbbdeb8013e41fde76df8ab7b5babccb10def1'],5,2,7,16717343,1,1,0,1,11185
2df4a6e09da1144bc1fd2650b4e823aaca07847c,1,Sumit Mohanty,2013-09-12 16:09:02-07:00,['3cf02594eb1f8e955a94bbe4749bbbc6940bbd60'],511,494,1005,16718348,1,0,0.833333333,0.166666667,11185
becdc592448f0935a445b0776b66990191caef4b,0,Yusaku Sako,2013-09-12 18:10:11-07:00,['2df4a6e09da1144bc1fd2650b4e823aaca07847c'],2,2,4,16718352,1,,,,11185
344aa6417a40b842c498253c1569e2cc17e13400,0,Yusaku Sako,2013-09-12 18:10:11-07:00,['becdc592448f0935a445b0776b66990191caef4b'],3,6,9,16718361,3,1,1,1,11185
78867493c9d9a15e260f49d5c339df9014e76c2d,0,Mahadev Konar,2013-09-12 18:31:28-07:00,['344aa6417a40b842c498253c1569e2cc17e13400'],5,0,5,16718366,1,1,0.666666667,0,11185
72dc18d7eae1ac5140ccf9bcdd2de0095267fcc3,1,Sumit Mohanty,2013-09-12 18:40:33-07:00,['78867493c9d9a15e260f49d5c339df9014e76c2d'],2,26,28,16718394,2,0.6875,0.6875,0.3125,11185
41c4f21ec1fd323416efd1a6a87191a3d819c64d,1,atkach,2013-09-13 13:04:58+03:00,['72dc18d7eae1ac5140ccf9bcdd2de0095267fcc3'],10,17,27,16718421,4,1,1,1,11185
9fcc05aefa87853926f3a5a22eba563474d69fef,1,Lisnichenko Dmitro,2013-09-13 14:56:23+03:00,['41c4f21ec1fd323416efd1a6a87191a3d819c64d'],0,67,67,16718488,3,,,,11187
6f7e5c582ddd4d433772b52c82112d334181572f,1,Mahadev Konar,2013-09-13 08:57:12-07:00,['9fcc05aefa87853926f3a5a22eba563474d69fef'],70,77,147,16718635,8,1,1,0.823529412,11187
3356ffbd99bc5eec5971b1b3e86b0a5e1221e68d,1,Mahadev Konar,2013-09-13 09:12:15-07:00,['6f7e5c582ddd4d433772b52c82112d334181572f'],0,5,5,16718640,1,0,0.333333333,1,11187
aef337b5635abacb94a6bf6fa87fa475e05faa4f,0,Alex Antonenko,2013-09-13 20:09:04+03:00,['3356ffbd99bc5eec5971b1b3e86b0a5e1221e68d'],1,1,2,16718642,1,,,,11187
f0fcead3e8c872a83fa5066c006814fe977542bd,1,Lisnichenko Dmitro,2013-09-13 20:22:33+03:00,['aef337b5635abacb94a6bf6fa87fa475e05faa4f'],6,65,71,16718713,4,,,,11187
1ea82541bda549894e27027357e339711785de10,1,Alex Antonenko,2013-09-13 20:52:31+03:00,['f0fcead3e8c872a83fa5066c006814fe977542bd'],1,5,6,16718719,3,,,,11187
7a32144ed504f1824df346f95333fb6a84f74a29,0,Siddharth Wagle,2013-09-13 11:01:38-07:00,['1ea82541bda549894e27027357e339711785de10'],2,10,12,16718731,2,,,,11187
2675d8c226cb375a9bb235b1cd37318eed6ae2be,1,Yusaku Sako,2013-09-13 11:28:47-07:00,['7a32144ed504f1824df346f95333fb6a84f74a29'],4,57,61,16718792,4,0.159090909,0.159090909,1,11187
249861fb8946aaeafe6899c477f82c2452810623,1,Jaimin Jetly,2013-09-13 11:34:36-07:00,['2675d8c226cb375a9bb235b1cd37318eed6ae2be'],0,64,64,16718856,8,,,,11187
b01e9def83953b366ce1fa360ddf7f72a90d7974,0,Srimanth Gunturi,2013-09-13 12:45:30-07:00,['249861fb8946aaeafe6899c477f82c2452810623'],1,1,2,16718858,1,,,,11187
248e54d34820cbf48686a703ecdc62ba2ef64164,1,Oleksandr Diachenko,2013-09-13 23:05:20+03:00,['b01e9def83953b366ce1fa360ddf7f72a90d7974'],6,4,10,16718868,2,,,,11187
1cee6377ab76a9b4948f2779bfd69a2ce3403ba3,1,Mahadev Konar,2013-09-13 13:56:59-07:00,['248e54d34820cbf48686a703ecdc62ba2ef64164'],2,2,4,16718872,2,,,,11187
7d396bb6a680277c025babf53008ec5f176e2b73,1,Yusaku Sako,2013-09-13 14:48:55-07:00,['1cee6377ab76a9b4948f2779bfd69a2ce3403ba3'],2,3,5,16718877,2,0,1,1,11187
c6033d3538af7d7c3ad2cf094d0ff210e71329eb,1,Yusaku Sako,2013-09-13 14:54:36-07:00,['7d396bb6a680277c025babf53008ec5f176e2b73'],6,10,16,16718893,3,1,1,1,11187
99d9d038d174297949bd7f23e34ebc74f7dc9342,1,Yusaku Sako,2013-09-13 15:16:44-07:00,['c6033d3538af7d7c3ad2cf094d0ff210e71329eb'],0,21,21,16718914,1,0.941176471,0.941176471,1,11187
534f78953da1c625be8cf7f2acf5f0346ed99a84,0,Mahadev Konar,2013-09-13 15:23:37-07:00,['99d9d038d174297949bd7f23e34ebc74f7dc9342'],10,2,12,16718926,2,,,,11187
735628b72e614dbcbc1a5fec514b81882143b5b2,1,Yusaku Sako,2013-09-13 15:28:43-07:00,['534f78953da1c625be8cf7f2acf5f0346ed99a84'],1,13,14,16718940,2,0,0,1,11187
e17c529897a9b512e5e14e26d395cda195d58f1b,1,Yusaku Sako,2013-09-13 15:54:34-07:00,['735628b72e614dbcbc1a5fec514b81882143b5b2'],13,22,35,16718975,2,1,1,1,11187
a6b4a81be3564b2b96486683244b913ed1ee73b8,1,Yusaku Sako,2013-09-13 15:57:27-07:00,['e17c529897a9b512e5e14e26d395cda195d58f1b'],2,14,16,16718991,2,1,1,1,11187
90b4fa9bf6b9d91781388e2cbc953681d41df5de,1,Mahadev Konar,2013-09-13 16:08:07-07:00,['a6b4a81be3564b2b96486683244b913ed1ee73b8'],19,150,169,16719160,2,0,0.023255814,0.476744186,11187
cc98f98ae2e496d797485a505200ef7ca1827b99,0,Mahadev Konar,2013-09-13 16:39:55-07:00,['90b4fa9bf6b9d91781388e2cbc953681d41df5de'],8,8,16,16719176,1,,,,11187
f88f7135fb3f4e0c27f3266c6b64ec3e0ae3dd58,1,Sumit Mohanty,2013-09-14 21:38:32-07:00,['cc98f98ae2e496d797485a505200ef7ca1827b99'],22,43,65,16719241,5,0,0,0.35,11187
430456471fb115bc7acbc613a8b16c0e0e21f943,0,Yusaku Sako,2013-09-16 00:59:32-07:00,['f88f7135fb3f4e0c27f3266c6b64ec3e0ae3dd58'],1,1,2,16719243,1,,,,11187
79af31fcb157e6bf001413b09adce4f83ad39215,1,Oleg Nechiporenko,2013-09-16 12:16:33+03:00,['430456471fb115bc7acbc613a8b16c0e0e21f943'],9,15,24,16719267,1,1,1,1,11187
9b0eddc7443ac954f8690ca4651bb606e21f5bc4,1,Oleg Nechiporenko,2013-09-16 12:16:33+03:00,['79af31fcb157e6bf001413b09adce4f83ad39215'],2,2,4,16719271,1,,,,11187
7af440286c66bac0867d03b6194d10a440a6cf09,1,Oleg Nechiporenko,2013-09-16 12:51:31+03:00,['9b0eddc7443ac954f8690ca4651bb606e21f5bc4'],1,22,23,16719294,1,,,,11187
41c2d3ec8f0950d5958db8c9e0aa280308b00b0e,1,atkach,2013-09-16 14:48:23+03:00,['7af440286c66bac0867d03b6194d10a440a6cf09'],67,98,165,16719459,3,0,0,1,11187
0dfd27ea025f851be0ec4286b6c1803342d55913,1,Oleg Nechiporenko,2013-09-16 15:21:27+03:00,['41c2d3ec8f0950d5958db8c9e0aa280308b00b0e'],1,22,23,16719482,1,1,1,1,11187
59998d8cb08c48d0878e02dcf6385c1ef2911d5b,1,Lisnichenko Dmitro,2013-09-16 16:07:42+03:00,['0dfd27ea025f851be0ec4286b6c1803342d55913'],0,1,1,16719483,1,,,,11187
81b64b48b0c3baef99b50c55811c31bfd3dcff07,1,atkach,2013-09-16 17:50:49+03:00,['59998d8cb08c48d0878e02dcf6385c1ef2911d5b'],2,2,4,16719487,1,0.4,0,0,11187
e55a1ecf27307b107d903481fe3d510f8788569d,0,Mahadev Konar,2013-09-16 08:33:21-07:00,['81b64b48b0c3baef99b50c55811c31bfd3dcff07'],36,145,181,16719668,7,1,1,0.739130435,11187
d98cfd9ca0ddd24f1e293bf0d3e877118a171765,0,Mahadev Konar,2013-09-16 08:37:58-07:00,['e55a1ecf27307b107d903481fe3d510f8788569d'],81,129,210,16719878,10,1,1,0.315789474,11187
9ef4a41378f9b80caa8321479706ad8a7a50d517,0,Oleksandr Diachenko,2013-09-16 18:55:24+03:00,['d98cfd9ca0ddd24f1e293bf0d3e877118a171765'],0,6,6,16719884,2,,,,11187
9f1833461c0632789f3a9871510f4f47221a4f41,0,Alex Antonenko,2013-09-16 19:05:20+03:00,['9ef4a41378f9b80caa8321479706ad8a7a50d517'],2,4,6,16719890,3,,,,11187
a703223297c8502e451c80f8bb5f1cb9862efb8c,0,Alex Antonenko,2013-09-16 19:07:40+03:00,['9f1833461c0632789f3a9871510f4f47221a4f41'],13,43,56,16719946,5,1,1,1,11187
99983453b24b4d3435c82f4b63969a148fd4678f,0,Oleksandr Diachenko,2013-09-16 19:14:20+03:00,['a703223297c8502e451c80f8bb5f1cb9862efb8c'],6,22,28,16719974,2,,,,11187
fce0467e9617a628ef1e1ffc997c299d477e3b3d,0,Yusaku Sako,2013-09-16 10:58:32-07:00,['99983453b24b4d3435c82f4b63969a148fd4678f'],7,3,10,16719984,1,1,0,0,11187
481b8ed37be3de6a1f1ae29d12fbba8706777a32,1,Yusaku Sako,2013-09-16 13:02:18-07:00,['fce0467e9617a628ef1e1ffc997c299d477e3b3d'],3,3,6,16719990,2,0.6,1,1,11187
0a292cc862875196ea4f256b0def4cd98b8fefc9,0,Sumit Mohanty,2013-09-16 13:28:58-07:00,['481b8ed37be3de6a1f1ae29d12fbba8706777a32'],2,2,4,16719994,1,,,,11187
257d92f2880bc2a30f2e91c941fcc2094ee0817b,0,Alex Antonenko,2013-09-16 23:30:26+03:00,['0a292cc862875196ea4f256b0def4cd98b8fefc9'],0,16,16,16720010,3,1,1,1,11187
59b24e5123f9d0cf3e8817a0e553f2e6645e8f6d,1,Lisnichenko Dmitro,2013-09-16 23:51:39+03:00,['257d92f2880bc2a30f2e91c941fcc2094ee0817b'],12,99,111,16720121,2,0,0.710144928,1,11187
aa8de8964814515780671f4966ee4855c56ef1e8,1,Srimanth Gunturi,2013-09-16 16:13:30-07:00,['59b24e5123f9d0cf3e8817a0e553f2e6645e8f6d'],122,525,647,16720768,9,0.379204893,0.639143731,0.957186544,11187
72438ae293b0b77672029200230e088645d9352f,0,Sumit Mohanty,2013-09-16 16:46:18-07:00,['aa8de8964814515780671f4966ee4855c56ef1e8'],2,6,8,16720776,2,1,1,1,11187
032055dcb908358e82963a29856e89533551936b,1,Sumit Mohanty,2013-09-16 19:52:09-07:00,['72438ae293b0b77672029200230e088645d9352f'],49,115,164,16720940,4,0.222222222,0.73015873,0.873015873,11187
b157e601ce2055626f46dea6b9eaec02d514bbdc,0,Alex Antonenko,2013-09-17 13:05:35+03:00,['032055dcb908358e82963a29856e89533551936b'],1,1,2,16720942,1,,,,11187
2a04b7a428a5b34f73698a3f7ad410464e118c2c,1,atkach,2013-09-17 13:16:31+03:00,['b157e601ce2055626f46dea6b9eaec02d514bbdc'],1,3,4,16720946,1,0,0,1,11187
22b35866ede3f0f261e7eefc14f807fd0797138c,1,Oleg Nechiporenko,2013-09-17 14:06:13+03:00,['2a04b7a428a5b34f73698a3f7ad410464e118c2c'],4,6,10,16720956,2,1,1,1,11187
048ce92712402f780a4ff4f92fe14094cbbdbd48,1,Siddharth Wagle,2013-09-17 10:16:10-07:00,['22b35866ede3f0f261e7eefc14f807fd0797138c'],42,134,176,16721132,3,0.434210526,0.723684211,0.605263158,11187
3633b1e0a3c0978955c64c2ce5c8fb0c810f1e46,1,Yusaku Sako,2013-09-17 10:19:56-07:00,['048ce92712402f780a4ff4f92fe14094cbbdbd48'],6,6,12,16721144,3,1,1,,11187
288ae2a55655b3857fe0601c8b3ba2d8efe92152,1,Srimanth Gunturi,2013-09-17 10:27:35-07:00,['3633b1e0a3c0978955c64c2ce5c8fb0c810f1e46'],0,128,128,16721272,4,1,1,1,11189
8167eff34210cf5a6aa8c38b81d2e627f840a13b,1,Siddharth Wagle,2013-09-17 10:48:13-07:00,['288ae2a55655b3857fe0601c8b3ba2d8efe92152'],1,2,3,16721275,1,0,0,1,11189
fc43264d621bd60d8a31fe6a76e277d0b1df2876,1,Jaimin Jetly,2013-09-17 11:25:23-07:00,['8167eff34210cf5a6aa8c38b81d2e627f840a13b'],49,49,98,16721373,3,,,,11189
6dcb9f860b09a026601a41556dc4a2e35835a57f,0,Siddharth Wagle,2013-09-17 12:40:54-07:00,['fc43264d621bd60d8a31fe6a76e277d0b1df2876'],1,4,5,16721378,1,0,0,1,11189
7417461245c32093516491be93e8a8fa33271feb,1,Mahadev Konar,2013-09-17 13:08:04-07:00,['6dcb9f860b09a026601a41556dc4a2e35835a57f'],129,81,210,16721588,10,0,0,0.684210526,11189
85fcfb1aeb2c6ce9cea30f6e2be25fb7858bcd18,1,Mahadev Konar,2013-09-17 13:14:14-07:00,['7417461245c32093516491be93e8a8fa33271feb'],55,121,176,16721764,6,1,1,0.857142857,11189
b62c675bef47624087c8ddeb53fff9b5325ae261,0,Mahadev Konar,2013-09-17 14:13:21-07:00,['85fcfb1aeb2c6ce9cea30f6e2be25fb7858bcd18'],0,4,4,16721768,1,,,,11190
e059591f7ed174f05e1ef17a90409264dbe4ad6d,1,Srimanth Gunturi,2013-09-17 15:44:59-07:00,['b62c675bef47624087c8ddeb53fff9b5325ae261'],11,44,55,16721823,3,0,0,1,11190
e92df28ecb135e6536da4406509650592eaeb0e4,1,Jaimin Jetly,2013-09-17 17:45:33-07:00,['e059591f7ed174f05e1ef17a90409264dbe4ad6d'],7,9,16,16721839,1,0,1,1,11190
062480094dd2f2f59fb59e3b10ccf1c194f69b35,1,Lisnichenko Dmitro,2013-09-18 15:11:49+03:00,['e92df28ecb135e6536da4406509650592eaeb0e4'],4,19,23,16721862,2,0,0.777777778,0.222222222,11190
82d4a5438afc8ed8cda46dbfa09d819efe703106,1,Lisnichenko Dmitro,2013-09-18 15:17:43+03:00,['062480094dd2f2f59fb59e3b10ccf1c194f69b35'],87,10,97,16721959,4,,,,11190
f061d4517c364902c1c530b02a10e90a02949c8f,0,Oleg Nechiporenko,2013-09-18 17:58:28+03:00,['82d4a5438afc8ed8cda46dbfa09d819efe703106'],4,4,8,16721967,1,,,,11190
0d447291714b39316a2d8e250c03765d73b9eb39,1,Oleg Nechiporenko,2013-09-18 17:58:29+03:00,['f061d4517c364902c1c530b02a10e90a02949c8f'],1,4,5,16721972,1,,,,11190
e8223b378af00eabe92a42ee05ed7003ded5f29f,1,Yusaku Sako,2013-09-18 12:38:27-07:00,['0d447291714b39316a2d8e250c03765d73b9eb39'],1,1,2,16721974,1,,,,11190
91ead9e80dfd0c7d7034fa40c5b133706fede467,1,Mahadev Konar,2013-09-18 13:00:00-07:00,['e8223b378af00eabe92a42ee05ed7003ded5f29f'],22,84,106,16722080,3,1,1,1,11191
935224014dd04375b83278f4fee923c925c41b2f,0,Mahadev Konar,2013-09-18 13:06:16-07:00,['91ead9e80dfd0c7d7034fa40c5b133706fede467'],4,21,25,16722105,3,0,0.9,0.4,11191
ff9c50aaba8c0f86afab70367eccce153d152629,0,Alex Antonenko,2013-09-18 23:19:38+03:00,['935224014dd04375b83278f4fee923c925c41b2f'],6,55,61,16722166,2,0,1,1,11191
c8bfc42880ad6477cbed71b90905100153eb3b9a,0,Yusaku Sako,2013-09-18 15:23:05-07:00,['ff9c50aaba8c0f86afab70367eccce153d152629'],0,3,3,16722169,1,,,,11191
028d36126969e3387d62caffb29ec492b7c1bc0b,1,Yusaku Sako,2013-09-18 16:08:55-07:00,['c8bfc42880ad6477cbed71b90905100153eb3b9a'],22,22,44,16722213,4,,,,11191
074d8395ea8f727fa54b58700ef5cab6382d0af9,0,Yusaku Sako,2013-09-18 16:13:21-07:00,['028d36126969e3387d62caffb29ec492b7c1bc0b'],6,17,23,16722236,2,1,1,0,11191
64ff4978b92592d43465310d92e46150efb1c523,0,Yusaku Sako,2013-09-18 16:40:08-07:00,['074d8395ea8f727fa54b58700ef5cab6382d0af9'],1,2,3,16722239,1,1,1,1,11191
327db479f695f8c8f58bee1d51dd31c69176f93c,0,Yusaku Sako,2013-09-18 17:10:39-07:00,['64ff4978b92592d43465310d92e46150efb1c523'],15,17,32,16722271,1,,,,11191
317333e576d656222772f83122a1f216d0ca87c1,1,Srimanth Gunturi,2013-09-18 17:18:36-07:00,['327db479f695f8c8f58bee1d51dd31c69176f93c'],6,9,15,16722286,1,1,1,1,11191
ffe3e5a32798e84b4d7d49b9825e90d1378fc287,0,Srimanth Gunturi,2013-09-18 17:42:20-07:00,['317333e576d656222772f83122a1f216d0ca87c1'],1,5,6,16722292,1,1,1,1,11191
f0fe1dcabc314c403bc9511c4e5d2d1900d197bd,1,Aleksandr Kovalenko,2013-09-19 13:29:21+03:00,['ffe3e5a32798e84b4d7d49b9825e90d1378fc287'],1233,1046,2279,16724571,16,0.285714286,0.285714286,0,11191
ff184861cf8b1f898348726bce9d28e664dfb4ae,1,atkach,2013-09-19 16:42:45+03:00,['f0fe1dcabc314c403bc9511c4e5d2d1900d197bd'],64,62,126,16724697,2,0,1,0,11191
3b6aaf7febec73e2c6d2019b8cff69765cf42cbf,0,Alex Antonenko,2013-09-19 18:13:09+03:00,['ff184861cf8b1f898348726bce9d28e664dfb4ae'],2,4,6,16724703,2,1,1,1,11191
7a29bb6e82adb2a1fc986ddf94698886098549a6,1,Oleg Nechiporenko,2013-09-19 18:52:00+03:00,['3b6aaf7febec73e2c6d2019b8cff69765cf42cbf'],82,185,267,16724970,2,0.371212121,1,1,11191
3a99cb13ba537d6272ec93b9f661f9c2726073d7,1,Alex Antonenko,2013-09-19 19:53:00+03:00,['7a29bb6e82adb2a1fc986ddf94698886098549a6'],5,30,35,16725005,1,0.12,1,1,11191
0b7bf81c3fc30fe9056b020f670c9e368ed3b218,1,Srimanth Gunturi,2013-09-19 11:17:44-07:00,['3a99cb13ba537d6272ec93b9f661f9c2726073d7'],5,5,10,16725015,2,1,1,0,11191
632ebf74facd89138d178e3d8a7f3eb96c91d8ce,0,Oleksandr Diachenko,2013-09-19 21:48:45+03:00,['0b7bf81c3fc30fe9056b020f670c9e368ed3b218'],0,1,1,16725016,1,,,,11191
787cd36f4eed1930616061a38c91da16fe85c14c,0,Jaimin Jetly,2013-09-19 13:24:22-07:00,['632ebf74facd89138d178e3d8a7f3eb96c91d8ce'],39,13,52,16725068,3,1,1,0,11191
19430a07ffe6c0b40ee745c8998006d187b441fe,0,Sumit Mohanty,2013-09-19 13:25:23-07:00,['787cd36f4eed1930616061a38c91da16fe85c14c'],1,1,2,16725070,1,,,,11191
be59140447a21a898cdf9caf2923c1fbaf861fde,0,Yusaku Sako,2013-09-19 13:34:51-07:00,['19430a07ffe6c0b40ee745c8998006d187b441fe'],3,2,5,16725075,2,0,0,0,11191
ab10b73e8c32420477d7cbd24ef69b54065ef65d,0,Mahadev Konar,2013-09-19 14:36:00-07:00,['be59140447a21a898cdf9caf2923c1fbaf861fde'],2,8,10,16725085,3,,,,11191
7d6dc48b33d69e56da21df0b284a109e41a38119,1,Mahadev Konar,2013-09-19 15:55:14-07:00,['ab10b73e8c32420477d7cbd24ef69b54065ef65d'],0,1,1,16725086,1,,,,11191
c4d8733cba6dc7080771669ab0bd74411367c1d8,0,Lisnichenko Dmitro,2013-09-20 14:18:17+03:00,['7d6dc48b33d69e56da21df0b284a109e41a38119'],1,10,11,16725097,1,,,,11191
dd3fc740a256333cf1ae190bdfe4f9e8536aa6bd,1,Oleksandr Diachenko,2013-09-20 15:48:10+03:00,['c4d8733cba6dc7080771669ab0bd74411367c1d8'],60,72,132,16725229,4,,,,11191
c54753b7d074e4cf11782526942f3bff3f1465f7,1,Oleg Nechiporenko,2013-09-20 16:03:41+03:00,['dd3fc740a256333cf1ae190bdfe4f9e8536aa6bd'],0,22,22,16725251,3,1,1,1,11191
9eb563bb5d6099d3098026453dfa357d14226220,1,Nate Cole,2013-09-20 11:01:26-04:00,['c54753b7d074e4cf11782526942f3bff3f1465f7'],1,25,26,16725277,2,0.1,1,1,11191
2951f1bc17ba72160e18700d6108e4f37670367f,0,Oleksandr Diachenko,2013-09-20 18:11:45+03:00,['9eb563bb5d6099d3098026453dfa357d14226220'],22,23,45,16725322,13,,,,11191
f8d9c458be5d62e06fd47658f7e79121fb623bee,0,Lisnichenko Dmitro,2013-09-20 18:36:02+03:00,['2951f1bc17ba72160e18700d6108e4f37670367f'],2,8,10,16725332,2,0,0.333333333,0.666666667,11191
7e23327743673264e7238c2d28e42f379c88b993,0,Oleksandr Diachenko,2013-09-20 19:10:34+03:00,['f8d9c458be5d62e06fd47658f7e79121fb623bee'],1,0,1,16725333,1,,,,11191
dcbdd9be10d88e135e22801deb9e1a598292028a,1,Oleksandr Diachenko,2013-09-20 19:17:45+03:00,['7e23327743673264e7238c2d28e42f379c88b993'],22,6,28,16725361,2,,,,11191
2f078e9265d63a47174853500af3cff30fd28d98,1,Oleg Nechiporenko,2013-09-20 19:34:53+03:00,['dcbdd9be10d88e135e22801deb9e1a598292028a'],1,1,2,16725363,1,,,,11191
fd45f823480bdf5738456738d8403f6a6e75078d,1,Yusaku Sako,2013-09-20 10:58:28-07:00,['2f078e9265d63a47174853500af3cff30fd28d98'],5,8,13,16725376,2,,,,11191
e555a7543bf556eb87cec743c78719524e9ec3c9,1,Yusaku Sako,2013-09-20 15:27:16-07:00,['fd45f823480bdf5738456738d8403f6a6e75078d'],5,5,10,16725386,5,,,,11191
c0822d817eee6eee6d7f9d25a051b39cfe47bc76,1,Mahadev Konar,2013-09-20 16:02:45-07:00,['e555a7543bf556eb87cec743c78719524e9ec3c9'],3,47,50,16725436,5,,,,11191
dd2a1f8d1d741d22449c41ac365fdd804879607a,0,Yusaku Sako,2013-09-20 16:36:56-07:00,['c0822d817eee6eee6d7f9d25a051b39cfe47bc76'],17,6,23,16725459,2,0,0,1,11191
ab58f79d2f8dc91fd6794a92f242839f0e5300cd,0,Yusaku Sako,2013-09-20 16:37:11-07:00,['dd2a1f8d1d741d22449c41ac365fdd804879607a'],12,0,12,16725471,1,1,1,0,11191
377ae1c0c3febf25d8d7382c515669535a29395d,1,Jaimin Jetly,2013-09-20 17:25:43-07:00,['ab58f79d2f8dc91fd6794a92f242839f0e5300cd'],200,212,412,16725883,7,0.8,0.8,0.7,11191
c622ff7bed01505111f5bf687a423cb814e3c08c,1,atkach,2013-09-23 14:15:11+03:00,['377ae1c0c3febf25d8d7382c515669535a29395d'],0,1,1,16725884,1,1,1,1,11191
c01be3962345fef611c9561c35a1999ac6a0b374,0,Lisnichenko Dmitro,2013-09-23 16:57:31+03:00,['c622ff7bed01505111f5bf687a423cb814e3c08c'],1,1,2,16725886,1,,,,11191
8f4ab529c573304ab5ee8feefbc8d067bcc990bf,1,Lisnichenko Dmitro,2013-09-23 18:14:51+03:00,['c01be3962345fef611c9561c35a1999ac6a0b374'],1067,1751,2818,16728704,26,1,1,0,11199
8bb6cdc2aef9ecb2180813d6468c08e91d897846,1,Oleg Nechiporenko,2013-09-23 18:28:55+03:00,['8f4ab529c573304ab5ee8feefbc8d067bcc990bf'],166,201,367,16729071,5,1,,,11199
1f7de9e3034202e691f8dcd5b001625530ad3159,1,Oleg Nechiporenko,2013-09-23 18:28:55+03:00,['8bb6cdc2aef9ecb2180813d6468c08e91d897846'],2,5,7,16729078,1,1,1,1,11199
9b2d8c487e48e04863c5be6615fbda7bd213c8f4,1,Alex Antonenko,2013-09-23 19:16:46+03:00,['1f7de9e3034202e691f8dcd5b001625530ad3159'],29,40,69,16729147,5,0.857142857,0,1,11199
f28f7e141a169f2cb569409ff70b22fb967bc581,1,Aleksandr Kovalenko,2013-09-23 20:55:30+03:00,['9b2d8c487e48e04863c5be6615fbda7bd213c8f4'],1011,203,1214,16730361,10,0.300330033,0.191419142,0.028052805,11199
cebf5df4c8c8ef7e67213cb3df6147018c6508b2,0,Mahadev Konar,2013-09-23 11:04:42-07:00,['f28f7e141a169f2cb569409ff70b22fb967bc581'],1,1,2,16730363,1,,,,11199
980918e0e925f28494e33419e98117eef9a7d5e2,1,Siddharth Wagle,2013-09-23 11:28:15-07:00,['cebf5df4c8c8ef7e67213cb3df6147018c6508b2'],278,951,1229,16731592,16,0.160120846,0.277945619,0.996978852,11205
12864a1f3ba9e3ca2b12be3b09065324f60a4fd8,0,Alex Antonenko,2013-09-23 21:52:52+03:00,['980918e0e925f28494e33419e98117eef9a7d5e2'],5,0,5,16731597,1,,,,11205
7e970e9e6afd4ac2a0faf99643ace99dc0e520cb,1,Yusaku Sako,2013-09-23 15:55:18-07:00,['12864a1f3ba9e3ca2b12be3b09065324f60a4fd8'],3,3,6,16731603,2,,,,11205
5f0b165e56f9ce3e26ba35a3dee1b6e9bf91b7d4,0,Yusaku Sako,2013-09-23 17:21:01-07:00,['7e970e9e6afd4ac2a0faf99643ace99dc0e520cb'],6,1,7,16731610,1,1,1,0,11205
c66df38e8ab0657e2288a37b0d496c3c01c9ac8f,1,Yusaku Sako,2013-09-23 17:24:54-07:00,['5f0b165e56f9ce3e26ba35a3dee1b6e9bf91b7d4'],0,3,3,16731613,2,0,1,1,11205
3c344371f224e978cb5c075b7904dc5eee76db09,1,Jaimin Jetly,2013-09-23 17:32:48-07:00,['c66df38e8ab0657e2288a37b0d496c3c01c9ac8f'],41,43,84,16731697,8,1,0,,11205
7181bc69a89b9b802a8342d9a7fc24e96dd8f526,0,Siddharth Wagle,2013-09-23 17:45:08-07:00,['3c344371f224e978cb5c075b7904dc5eee76db09'],1,12,13,16731710,1,,,,11205
df408fbff81d2a4ebdd718938b873b9e036296e1,1,Siddharth Wagle,2013-09-23 18:04:16-07:00,['7181bc69a89b9b802a8342d9a7fc24e96dd8f526'],1,2,3,16731713,1,,,,11205
985bb7b3369cad348e1058d826fffe1acce4cdbf,1,Oleg Nechiporenko,2013-09-24 14:07:23+03:00,['df408fbff81d2a4ebdd718938b873b9e036296e1'],3,16,19,16731732,4,0.857142857,0,1,11205
ba20129492e32c51823181f48d28eac2509ccd8d,0,atkach,2013-09-24 14:25:20+03:00,['985bb7b3369cad348e1058d826fffe1acce4cdbf'],1,1,2,16731734,1,,,,11205
e222d3ee827558c3be7cf8032e7622f360813676,1,aBabiichuk,2013-09-24 14:26:56+03:00,['ba20129492e32c51823181f48d28eac2509ccd8d'],4,41,45,16731779,1,1,1,1,11205
580d0aa39865c1be5ba7f96514b65d763cad5fe7,1,aBabiichuk,2013-09-24 14:26:57+03:00,['e222d3ee827558c3be7cf8032e7622f360813676'],1,4,5,16731784,1,1,1,1,11205
533d15cd73112f9bd413288c90360ae0488ecb2e,1,aBabiichuk,2013-09-24 14:26:57+03:00,['580d0aa39865c1be5ba7f96514b65d763cad5fe7'],7,12,19,16731803,1,1,1,1,11205
420f16be96ddb9ec85efb7cbaf5a1bf390e02794,1,aBabiichuk,2013-09-24 14:26:57+03:00,['533d15cd73112f9bd413288c90360ae0488ecb2e'],20,35,55,16731858,6,0,0,0,11205
efa87786addeaf45866523bdb2b0d16f9408ebcc,0,aBabiichuk,2013-09-24 14:26:58+03:00,['420f16be96ddb9ec85efb7cbaf5a1bf390e02794'],32,0,32,16731890,4,1,1,0,11205
7f9d0582fde7bc2c42f2b808c6aeed18460e49c9,1,aBabiichuk,2013-09-24 14:26:59+03:00,['efa87786addeaf45866523bdb2b0d16f9408ebcc'],20,14,34,16731924,3,0,0,0,11205
93f29c2e075945669e9c69d758f99f1f1c7bae93,1,aBabiichuk,2013-09-24 14:26:59+03:00,['7f9d0582fde7bc2c42f2b808c6aeed18460e49c9'],6,6,12,16731936,1,,,,11205
3a8bd15873df5ab706f04f5e96cf2f2021af0b0c,1,aBabiichuk,2013-09-24 14:27:00+03:00,['93f29c2e075945669e9c69d758f99f1f1c7bae93'],0,1,1,16731937,1,1,1,1,11205
d321f7edbccebd335f9ca562ffe8aa343b00d7a3,1,aBabiichuk,2013-09-24 15:01:36+03:00,['3a8bd15873df5ab706f04f5e96cf2f2021af0b0c'],1,1,2,16731939,1,,,,11205
add5928168163b9f2e62477980f2822968b57222,1,aBabiichuk,2013-09-24 17:14:15+03:00,['d321f7edbccebd335f9ca562ffe8aa343b00d7a3'],73,50,123,16732062,8,0,1,0,11205
38a780791831907732669592d4c1fc76a7a9df74,1,Nate Cole,2013-09-24 11:02:35-04:00,['add5928168163b9f2e62477980f2822968b57222'],320,2245,2565,16734627,21,1,1,0,11220
47e3d7ac26dc6a7573cfc056412fb7480c8cd04b,0,Mahadev Konar,2013-09-24 10:26:55-07:00,['38a780791831907732669592d4c1fc76a7a9df74'],2,2,4,16734631,1,,,,11220
a879a831080b6ce21bc56bec4beb013d7c34ce2f,1,Oleksandr Diachenko,2013-09-24 20:28:49+03:00,['47e3d7ac26dc6a7573cfc056412fb7480c8cd04b'],6,24,30,16734661,2,,,,11220
719ff2af63daf6ad20874561ef808050229eb86c,1,Oleksandr Diachenko,2013-09-24 20:40:25+03:00,['a879a831080b6ce21bc56bec4beb013d7c34ce2f'],38,32,70,16734731,2,1,0,1,11220
e18d93cbf667555f131999e29a6b65ea8a7c47ef,1,atkach,2013-09-24 21:03:19+03:00,['719ff2af63daf6ad20874561ef808050229eb86c'],1,10,11,16734742,1,0,0,1,11220
2d26653be8270d1e090bf9b7e8fda522414339b2,1,Lisnichenko Dmitro,2013-09-24 22:27:02+03:00,['e18d93cbf667555f131999e29a6b65ea8a7c47ef'],5,5,10,16734752,1,,,,11220
8f10bc752659beef713fcd91c0a6547cdbba860e,0,Yusaku Sako,2013-09-24 16:02:08-07:00,['2d26653be8270d1e090bf9b7e8fda522414339b2'],73,0,73,16734825,2,,,,11220
0d73469c77b14d75035169f572e81d0602bbc31b,1,Yusaku Sako,2013-09-24 18:23:02-07:00,['8f10bc752659beef713fcd91c0a6547cdbba860e'],6,5,11,16734836,2,,,,11220
b202f8e672a9c8678a6dbc1332d4f4a2ab79a48e,1,Mahadev Konar,2013-09-24 18:28:00-07:00,['0d73469c77b14d75035169f572e81d0602bbc31b'],3,25,28,16734864,2,,,,11220
107df843d945b61bb4d4b208e276fcc2fe02f397,1,Sumit Mohanty,2013-09-24 18:28:41-07:00,['b202f8e672a9c8678a6dbc1332d4f4a2ab79a48e'],5,8,13,16734877,2,1,1,1,11220
8167851a0d0c600cac6273da53486d5797b9058b,0,Yusaku Sako,2013-09-24 18:57:03-07:00,['107df843d945b61bb4d4b208e276fcc2fe02f397'],0,5,5,16734882,1,0.6,0.6,1,11220
11c577a9218007881d603ee4fe94be97160120a4,0,Oleg Nechiporenko,2013-09-25 12:57:30+03:00,['8167851a0d0c600cac6273da53486d5797b9058b'],1,1,2,16734884,1,,,,11220
43674bae3ce6268ed9bcc26fe33f4d607f521953,1,Oleg Nechiporenko,2013-09-25 12:58:01+03:00,['11c577a9218007881d603ee4fe94be97160120a4'],26,56,82,16734966,4,0,0,1,11220
6075303ce2ea99f68758c6ef6c49a611f5c4ffad,1,atkach,2013-09-25 13:19:17+03:00,['43674bae3ce6268ed9bcc26fe33f4d607f521953'],5,18,23,16734989,4,1,1,1,11220
1f4ab2a7e063843425485d797c4a4dd657793197,1,atkach,2013-09-25 13:50:57+03:00,['6075303ce2ea99f68758c6ef6c49a611f5c4ffad'],153,188,341,16735330,5,0,1,1,11220
ae0f9f58e9fb9a606d4d5391bcf02dbbe727aae7,0,aBabiichuk,2013-09-25 19:34:22+03:00,['1f4ab2a7e063843425485d797c4a4dd657793197'],3,6,9,16735339,1,0,0,1,11220
81e8423255da8c5eace8df9ac0b3d5cab50b1e79,1,Alex Antonenko,2013-09-25 19:55:36+03:00,['ae0f9f58e9fb9a606d4d5391bcf02dbbe727aae7'],19,15,34,16735373,4,0,0,0,11220
bf7972bcc7f6cf0fef300f840191c1d4b07ecc6e,1,Oleksandr Diachenko,2013-09-25 20:04:53+03:00,['81e8423255da8c5eace8df9ac0b3d5cab50b1e79'],6,43,49,16735422,2,0,0.172413793,0.413793103,11220
61b8e9ea1c2d7e1831397fd84a3e512f02afab34,0,Mahadev Konar,2013-09-25 10:21:13-07:00,['bf7972bcc7f6cf0fef300f840191c1d4b07ecc6e'],1,1,2,16735424,1,,,,11220
a9da5b0c228334fb0a420acd9d5ebfbab27fb896,0,aBabiichuk,2013-09-25 20:30:40+03:00,['61b8e9ea1c2d7e1831397fd84a3e512f02afab34'],2,6,8,16735432,2,,,,11220
bd0b800efb8af2e4e5ff5b1faac43998b4c48088,0,Sumit Mohanty,2013-09-25 11:09:27-07:00,['a9da5b0c228334fb0a420acd9d5ebfbab27fb896'],9,11,20,16735452,3,,,,11220
8e37c8773ea7f5224004e35cebc7b2ca7c794fc4,1,Jaimin Jetly,2013-09-25 11:18:20-07:00,['bd0b800efb8af2e4e5ff5b1faac43998b4c48088'],1,2,3,16735455,1,,,,11220
a9a4fe4575e839837e3ced2adaf47fb8e3e661de,1,Sumit Mohanty,2013-09-25 11:29:39-07:00,['8e37c8773ea7f5224004e35cebc7b2ca7c794fc4'],37,115,152,16735607,4,,,,11221
20433a3d0fa8370b0d569306c3eb9871cb6aed84,0,Siddharth Wagle,2013-09-25 12:30:20-07:00,['a9a4fe4575e839837e3ced2adaf47fb8e3e661de'],0,12,12,16735619,1,,,,11221
397f3d627e2ea2dc82f72f9e9f66727cce7968cd,0,Yusaku Sako,2013-09-25 13:01:08-07:00,['20433a3d0fa8370b0d569306c3eb9871cb6aed84'],6,7,13,16735632,2,0,0,0,11221
fed74613d77dbc63fdb48224deb2e15f7e25efe2,1,Lisnichenko Dmitro,2013-09-25 23:27:25+03:00,['397f3d627e2ea2dc82f72f9e9f66727cce7968cd'],2,2,4,16735636,1,,,,11221
a8864ba5361c573d9c95a0f1a391b957eb09b0f5,0,Yusaku Sako,2013-09-25 13:52:57-07:00,['fed74613d77dbc63fdb48224deb2e15f7e25efe2'],1,2,3,16735639,1,,,,11221
a0386357b7cd1a2b932c7331f336228e298ee42a,1,Mahadev Konar,2013-09-25 20:59:07-07:00,['a8864ba5361c573d9c95a0f1a391b957eb09b0f5'],2887,1122,4009,16739648,17,0.894736842,0.894736842,1,11229
e29fcae536d827683923b0cc400a5735e22f5cae,1,Oleksandr Diachenko,2013-09-26 15:23:10+03:00,['a0386357b7cd1a2b932c7331f336228e298ee42a'],83,354,437,16740085,4,0.06779661,1,0.937853107,11229
6df878b7d6b0d45ed3b14ffae8e456bea79554b5,0,atkach,2013-09-26 19:43:35+03:00,['e29fcae536d827683923b0cc400a5735e22f5cae'],3,3,6,16740091,1,,,,11229
d0735e9cb9b3f57617112a554cce355ecd71cbc5,1,Dmitry Sen,2013-09-26 20:08:36+03:00,['6df878b7d6b0d45ed3b14ffae8e456bea79554b5'],2,4,6,16740097,1,0,0,0,11229
0e01a8abc11efdab5c42151868f0b7c0dacf9012,1,Jaimin Jetly,2013-09-26 12:13:09-07:00,['d0735e9cb9b3f57617112a554cce355ecd71cbc5'],24,39,63,16740160,1,0.95,0.95,1,11229
e26590bc7a4b2022d4ef0f25350ff0db94489bca,0,Siddharth Wagle,2013-09-26 13:30:37-07:00,['0e01a8abc11efdab5c42151868f0b7c0dacf9012'],0,1,1,16740161,1,,,,11229
91e36bfc78982748dc00d534d86c3373d3e8bcc8,1,Jaimin Jetly,2013-09-26 15:12:07-07:00,['e26590bc7a4b2022d4ef0f25350ff0db94489bca'],126,114,240,16740401,11,,,,11229
022db8567ae7d31323fa55cd2bd5fad13a8eeb30,1,Jaimin Jetly,2013-09-26 15:51:17-07:00,['91e36bfc78982748dc00d534d86c3373d3e8bcc8'],2,2,4,16740405,2,,,,11229
c900dcaf872919481db0cd1f877a2cf863748fb8,1,Siddharth Wagle,2013-09-26 18:09:12-07:00,['022db8567ae7d31323fa55cd2bd5fad13a8eeb30'],5,119,124,16740529,5,0.028571429,1,0.485714286,11231
0960fac65d735aadaafeca42fad93b439f3f5402,0,Oleg Nechiporenko,2013-09-27 14:10:42+03:00,['c900dcaf872919481db0cd1f877a2cf863748fb8'],15,1,16,16740545,1,1,0,0,11231
8eab479b5366d792bf276ebee1c96d3a52995894,0,atkach,2013-09-27 14:34:25+03:00,['0960fac65d735aadaafeca42fad93b439f3f5402'],1,2,3,16740548,1,,,,11231
6fb5ae4f7f6c0ea417cf6e21ffaa28c1d8a0b50a,0,atkach,2013-09-27 16:04:18+03:00,['8eab479b5366d792bf276ebee1c96d3a52995894'],1,1,2,16740550,1,,,,11231
df7c622fdd7f40d07873a3ec19e533d74c2d73a8,1,Oleksandr Diachenko,2013-09-27 20:28:16+03:00,['6fb5ae4f7f6c0ea417cf6e21ffaa28c1d8a0b50a'],13,13,26,16740576,2,1,1,1,11231
a7b9d375d009cc6409d399b829abfe713a93501b,1,Sumit Mohanty,2013-09-27 10:58:34-07:00,['df7c622fdd7f40d07873a3ec19e533d74c2d73a8'],130,186,316,16740892,3,0,0.85106383,0.765957447,11231
ff24af8acbb4ddd21d82c9d31aadb96fcc9df096,0,Jaimin Jetly,2013-09-27 11:18:43-07:00,['a7b9d375d009cc6409d399b829abfe713a93501b'],1,1,2,16740894,1,,,,11231
bc087fd03bc0ae08f3461c02006a5f026a91c1d9,0,Oleksandr Diachenko,2013-09-27 21:26:30+03:00,['ff24af8acbb4ddd21d82c9d31aadb96fcc9df096'],13,0,13,16740907,1,,,,11231
a51edd52898ef57ee8024559a43779a47a5901df,1,Alex Antonenko,2013-09-27 21:43:17+03:00,['bc087fd03bc0ae08f3461c02006a5f026a91c1d9'],0,22,22,16740929,5,0,0.85,1,11231
437a0410fbf0bd5ae93c8ad58c46809e6fca3847,0,Jaimin Jetly,2013-09-27 14:06:39-07:00,['a51edd52898ef57ee8024559a43779a47a5901df'],1,0,1,16740930,1,1,1,0,11231
19bb1b71057157efac9aed5fd2aeb05576568246,0,Oleg Nechiporenko,2013-09-28 00:08:20+03:00,['437a0410fbf0bd5ae93c8ad58c46809e6fca3847'],4,4,8,16740938,1,,,,11231
597dbf3c1921461ede746ef4876b150859fa3191,0,Sumit Mohanty,2013-09-27 14:21:31-07:00,['19bb1b71057157efac9aed5fd2aeb05576568246'],1,1,2,16740940,1,,,,11231
84336625523e8b5aaa3bbe272461d14d87b0a96f,1,Yusaku Sako,2013-09-27 16:19:18-07:00,['597dbf3c1921461ede746ef4876b150859fa3191'],1,1,2,16740942,1,,,,11231
e32b034a25b09d5876fe8720d33428e3bce707b8,1,Jaimin Jetly,2013-09-27 16:30:41-07:00,['84336625523e8b5aaa3bbe272461d14d87b0a96f'],7,32,39,16740981,6,,,,11231
22802015ed7d61b2315f8e262484e193b2ab8cf5,0,Mahadev Konar,2013-09-27 17:13:33-07:00,['e32b034a25b09d5876fe8720d33428e3bce707b8'],0,3,3,16740984,1,,,,11231
07d50cda1e6690600c437459147a798bd11704b6,1,Mahadev Konar,2013-09-27 17:44:52-07:00,['22802015ed7d61b2315f8e262484e193b2ab8cf5'],0,16,16,16741000,2,,,,11231
5c98fb5284f35f927d093b38413a879337e7ea3e,0,Mahadev Konar,2013-09-27 18:06:51-07:00,['07d50cda1e6690600c437459147a798bd11704b6'],52,0,52,16741052,4,,,,11231
4cfadcfcac0f1abb98e2ba70812441d625ab7cb8,0,Yusaku Sako,2013-09-27 19:10:42-07:00,['5c98fb5284f35f927d093b38413a879337e7ea3e'],0,38,38,16741090,1,0,0,1,11231
3b93763f2c232895d824eeda1710c0daf4ac9287,1,Yusaku Sako,2013-09-27 19:15:12-07:00,['4cfadcfcac0f1abb98e2ba70812441d625ab7cb8'],47,41,88,16741178,2,0.875,0.875,0,11231
5a2b0f2057091c0add3e8f0c7affade03108bf17,1,Yusaku Sako,2013-09-27 19:17:44-07:00,['3b93763f2c232895d824eeda1710c0daf4ac9287'],1,6,7,16741185,1,,,,11231
a35bc83779afa2766cfcda5077d160bef3d58d39,0,Yusaku Sako,2013-09-28 17:43:53-07:00,['5a2b0f2057091c0add3e8f0c7affade03108bf17'],2,4,6,16741191,2,,,,11231
dda3546318199a3e1e67248d43ad8de66e4a1f49,1,Jaimin Jetly,2013-09-29 19:13:01-07:00,['a35bc83779afa2766cfcda5077d160bef3d58d39'],1,1,2,16741193,1,,,,11231
62011714fec8b34a8431e0a731778f7de31debff,1,Nate Cole,2013-09-30 08:36:12-04:00,['dda3546318199a3e1e67248d43ad8de66e4a1f49'],131,217,348,16741541,10,1,1,1,11231
45af4330cb53d17fdde53d8ef0f70f69744a0ffb,1,atkach,2013-09-30 18:03:02+03:00,['62011714fec8b34a8431e0a731778f7de31debff'],42,60,102,16741643,2,1,1,0.25,11231
3d4e43bdee5715df81b4c2ccba93f01316b9e9dd,1,aBabiichuk,2013-09-30 18:29:34+03:00,['45af4330cb53d17fdde53d8ef0f70f69744a0ffb'],0,3,3,16741646,1,0,0,1,11231
15642cd7994adf3da4bc49ab11188ae2001c3d07,0,aBabiichuk,2013-09-30 19:41:31+03:00,['3d4e43bdee5715df81b4c2ccba93f01316b9e9dd'],0,7,7,16741653,1,0,0,1,11231
51eed5b81451a945ffe7c971bb8319896ffec658,1,Sumit Mohanty,2013-09-30 10:03:27-07:00,['15642cd7994adf3da4bc49ab11188ae2001c3d07'],4,4,8,16741661,4,,,,11231
37869477367f76a1f0346edfd36201b5fa9cccdb,1,Aleksandr Kovalenko,2013-09-30 20:06:48+03:00,['51eed5b81451a945ffe7c971bb8319896ffec658'],51,515,566,16742227,18,0.744186047,0.88372093,1,11237
53597260b5c5264bec099cf2bcdd691bd3ffb422,0,Aleksandr Kovalenko,2013-09-30 20:09:29+03:00,['37869477367f76a1f0346edfd36201b5fa9cccdb'],2,15,17,16742244,3,,,,11237
7d7717a49659376783ebbfbee4c5e74e43a5fb1b,0,Jaimin Jetly,2013-09-30 10:20:05-07:00,['53597260b5c5264bec099cf2bcdd691bd3ffb422'],1,2,3,16742247,2,0,1,1,11237
ee6d6410b4b7f7b31f160bfafca87c2217108c20,1,Srimanth Gunturi,2013-09-30 11:08:50-07:00,['7d7717a49659376783ebbfbee4c5e74e43a5fb1b'],7,29,36,16742283,1,0,0,1,11237
7f6ece7bd197acf406b5daa3031250147a123f7f,1,Srimanth Gunturi,2013-09-30 14:21:33-07:00,['ee6d6410b4b7f7b31f160bfafca87c2217108c20'],12,20,32,16742315,3,1,1,1,11237
4cfd9f7a90b44846bbd587e1ee7bb3a50c9089f2,0,Srimanth Gunturi,2013-09-30 16:08:38-07:00,['7f6ece7bd197acf406b5daa3031250147a123f7f'],8,12,20,16742335,2,1,1,1,11237
9d45df2f7286061cbeddb0a754dab72c53e705b9,1,Jaimin Jetly,2013-09-30 19:04:53-07:00,['4cfd9f7a90b44846bbd587e1ee7bb3a50c9089f2'],6,6,12,16742347,5,,,,11237
62b1902eb2362d9672c7e25fe94bb81c90487311,0,atkach,2013-10-01 12:11:41+03:00,['9d45df2f7286061cbeddb0a754dab72c53e705b9'],3,9,12,16742359,1,0,0,1,11237
66236fe786cf25248b8b1d3e0396aa262bfa3cb2,1,Sumit Mohanty,2013-10-01 02:13:30-07:00,['62b1902eb2362d9672c7e25fe94bb81c90487311'],106,404,510,16742869,2,0.23255814,0.790697674,0.674418605,11237
c9b5b00ad002792da2144ddc3f875cc7a10230cf,1,Oleg Nechiporenko,2013-10-01 14:36:33+03:00,['66236fe786cf25248b8b1d3e0396aa262bfa3cb2'],3,1,4,16742873,1,1,1,0,11237
75b6707759914b44f418662aaca98051c840c1bf,0,Oleg Nechiporenko,2013-10-01 14:36:34+03:00,['c9b5b00ad002792da2144ddc3f875cc7a10230cf'],1,11,12,16742885,2,,,,11237
a07468767c626af6416f840d394c3cea0db08c3a,1,aBabiichuk,2013-10-01 15:31:59+03:00,['75b6707759914b44f418662aaca98051c840c1bf'],2,8,10,16742895,2,,,,11237
f01523b6a790ceb8332bac397d08cfacf58fbb74,1,Aleksandr Kovalenko,2013-10-01 17:22:19+03:00,['a07468767c626af6416f840d394c3cea0db08c3a'],29,22,51,16742946,4,1,1,1,11237
5cb4361a4c8ad14ad2b369c5680a350547975036,0,Oleksandr Diachenko,2013-10-01 18:13:16+03:00,['f01523b6a790ceb8332bac397d08cfacf58fbb74'],2,2,4,16742950,2,,,,11237
2569326522645412a62aedb555d4e30019749a27,0,Siddharth Wagle,2013-10-01 10:10:16-07:00,['5cb4361a4c8ad14ad2b369c5680a350547975036'],7,30,37,16742987,2,,,,11237
8053bbdc0c7e1e9dec21156e26468d99b9046b44,0,Myroslav Papirkovskyy,2013-10-01 20:21:40+03:00,['2569326522645412a62aedb555d4e30019749a27'],3,5,8,16742995,1,0,0,0.5,11237
c11eea1752ebbd150972bf2a6c37d5e0943ea583,0,Siddharth Wagle,2013-10-01 11:15:17-07:00,['8053bbdc0c7e1e9dec21156e26468d99b9046b44'],1,1,2,16742997,1,,,,11237
eca0b5ead835af3d77dc6d1397f982c2dc2302c4,1,Srimanth Gunturi,2013-10-01 12:59:56-07:00,['c11eea1752ebbd150972bf2a6c37d5e0943ea583'],6,38,44,16743041,1,,,,11237
a090dff7a115f92cfd9b226a11ddd6b22aed3e93,0,Mahadev Konar,2013-10-01 15:27:12-07:00,['eca0b5ead835af3d77dc6d1397f982c2dc2302c4'],2,2,4,16743045,1,,,,11237
9c7b5773629129757eecb35070de3beb4ccaef51,0,Mahadev Konar,2013-10-01 16:14:50-07:00,['a090dff7a115f92cfd9b226a11ddd6b22aed3e93'],33,53,86,16743131,2,1,1,0.5,11237
4a9ccf0c052476f185965353010ff25f0ce5f181,1,Srimanth Gunturi,2013-10-01 17:03:49-07:00,['9c7b5773629129757eecb35070de3beb4ccaef51'],21,72,93,16743224,1,,,,11237
6de666e53610a9909b10f0d0b2d8b9b098329118,1,Oleksandr Diachenko,2013-10-02 17:17:40+03:00,['4a9ccf0c052476f185965353010ff25f0ce5f181'],37,209,246,16743470,9,1,1,1,11237
acfbca340e14c10a7b506f6a53ed0e161a89d40e,1,Alex Antonenko,2013-10-02 17:42:14+03:00,['6de666e53610a9909b10f0d0b2d8b9b098329118'],9,52,61,16743531,4,0.047619048,0,1,11237
e0d72ad9314ec22e98e17a2fa723de6d0a518a00,1,Oleksandr Diachenko,2013-10-02 18:02:23+03:00,['acfbca340e14c10a7b506f6a53ed0e161a89d40e'],7,289,296,16743827,2,0.092307692,0.907692308,0.907692308,11238
2e6e7d1505cf93ae2b93b1395111a3232b4ab80f,0,Aleksandr Kovalenko,2013-10-02 18:47:54+03:00,['e0d72ad9314ec22e98e17a2fa723de6d0a518a00'],15,24,39,16743866,3,1,1,1,11238
65fbee708e591164e0949f1d23128916cbcfa953,0,Dmitry Sen,2013-10-02 19:21:43+03:00,['2e6e7d1505cf93ae2b93b1395111a3232b4ab80f'],1,1,2,16743868,1,,,,11238
f7ab06dfa8ddfe138b7ba462ccc62223a2b2186b,1,Nate Cole,2013-10-02 13:59:24-04:00,['65fbee708e591164e0949f1d23128916cbcfa953'],5,165,170,16744038,6,0.145833333,0.177083333,1,11238
a270e733593dd72903583d7ed6230796b0a03257,0,Alex Antonenko,2013-10-02 22:35:41+03:00,['f7ab06dfa8ddfe138b7ba462ccc62223a2b2186b'],1,1,2,16744040,1,,,,11238
88cabba76f03be2271c6a0cd699c80b0f6b184d9,0,Mahadev Konar,2013-10-02 13:14:54-07:00,['a270e733593dd72903583d7ed6230796b0a03257'],0,1,1,16744041,1,,,,11238
0328b7c05ead74e73c3b16a99bf1d1cddeb7b12d,1,Jaimin Jetly,2013-10-02 13:14:46-07:00,['88cabba76f03be2271c6a0cd699c80b0f6b184d9'],3,5,8,16744049,1,0,1,1,11238
501f58020469580d5c60c0971fbe94b9cccfad32,1,Yusaku Sako,2013-10-02 14:50:54-07:00,['0328b7c05ead74e73c3b16a99bf1d1cddeb7b12d'],21,1,22,16744071,3,,,,11238
f5a8f99ed522e2f03b980cca7d864f75c04103c7,0,Siddharth Wagle,2013-10-02 16:03:59-07:00,['501f58020469580d5c60c0971fbe94b9cccfad32'],1,1,2,16744073,1,,,,11238
83d03436af22ac68321c1d5077d18e2400d09ddd,0,Yusaku Sako,2013-10-02 16:22:14-07:00,['f5a8f99ed522e2f03b980cca7d864f75c04103c7'],9,3,12,16744085,1,1,1,0,11238
1b300393d8ea0d28dcc30b59c56d2dfb65b7ff43,0,Mahadev Konar,2013-10-02 17:14:22-07:00,['83d03436af22ac68321c1d5077d18e2400d09ddd'],2,2,4,16744089,1,,,,11238
ca04149302c42916b2e2c150f9dd0b8b36db9aa2,1,Jaimin Jetly,2013-10-02 18:11:46-07:00,['1b300393d8ea0d28dcc30b59c56d2dfb65b7ff43'],30,26,56,16744145,8,,,,11238
4343a0b8428df299afb815cb5ec7ce5114f56885,1,Yusaku Sako,2013-10-02 20:29:18-07:00,['ca04149302c42916b2e2c150f9dd0b8b36db9aa2'],82,17,99,16744244,7,,,,11238
dd330b8b73b930389260634906415b7365cb3380,1,Yusaku Sako,2013-10-02 20:36:20-07:00,['4343a0b8428df299afb815cb5ec7ce5114f56885'],5,6,11,16744255,1,1,1,1,11238
7e538964cda7103f62b95aef6f869c4372e4d1ae,1,Oleg Nechiporenko,2013-10-03 13:40:04+03:00,['dd330b8b73b930389260634906415b7365cb3380'],9,14,23,16744278,4,0.5,1,1,11238
0ddb963ea9312e26eba2b45ca1732441a4b6eae7,1,Alex Antonenko,2013-10-03 14:25:40+03:00,['7e538964cda7103f62b95aef6f869c4372e4d1ae'],0,12,12,16744290,1,0,0,0,11238
acd08ba9b05ba023e0f0965dc36841eeb7f87afb,1,Oleg Nechiporenko,2013-10-03 15:44:02+03:00,['0ddb963ea9312e26eba2b45ca1732441a4b6eae7'],2,2,4,16744294,1,,,,11238
948a41fc597b41d27c0e02fb75f12f5c7960c1e9,0,Aleksandr Kovalenko,2013-10-03 18:12:34+03:00,['acd08ba9b05ba023e0f0965dc36841eeb7f87afb'],11,25,36,16744330,4,0,1,1,11238
62dfae5f4cf719ffa1f501e5ea3401ddf2585ce3,1,aBabiichuk,2013-10-03 18:24:19+03:00,['948a41fc597b41d27c0e02fb75f12f5c7960c1e9'],9,85,94,16744424,4,0.098039216,1,0.862745098,11239
cbe4b253b17962ae9b3d884d22e0b0de20abd9aa,1,Sumit Mohanty,2013-10-03 12:34:54-07:00,['62dfae5f4cf719ffa1f501e5ea3401ddf2585ce3'],9,23,32,16744456,2,,,,11239
fb62623e89b6d47335956c0108649054791573ae,1,Yusaku Sako,2013-10-03 12:45:12-07:00,['cbe4b253b17962ae9b3d884d22e0b0de20abd9aa'],19,37,56,16744512,2,,,,11239
639b728d4a18ba47be0d180f414cd47bc6b1c040,1,Yusaku Sako,2013-10-03 13:19:56-07:00,['fb62623e89b6d47335956c0108649054791573ae'],6,6,12,16744524,2,,,,11239
6b8311d3e17d8ec0bb4ef39a688e1c48fa3d0527,1,Srimanth Gunturi,2013-10-03 13:55:10-07:00,['639b728d4a18ba47be0d180f414cd47bc6b1c040'],33,32,65,16744589,1,0,0,0,11239
d61413d9d50dc51a79a0d99f2e9e89798c0b2cdc,1,Yusaku Sako,2013-10-03 14:51:32-07:00,['6b8311d3e17d8ec0bb4ef39a688e1c48fa3d0527'],9,14,23,16744612,3,,,,11239
202f182243f2134488e46bb8e4eafa33cbec0932,1,Yusaku Sako,2013-10-03 15:53:42-07:00,['d61413d9d50dc51a79a0d99f2e9e89798c0b2cdc'],0,6,6,16744618,1,,,,11239
4eaec1e2e79b541d612b9d20e117dc33d9fc4240,0,Siddharth Wagle,2013-10-03 15:57:52-07:00,['202f182243f2134488e46bb8e4eafa33cbec0932'],30,34,64,16744682,4,,,,11239
54871024758d120f6591ffb1fea213109aa8a241,0,Yusaku Sako,2013-10-03 17:19:20-07:00,['4eaec1e2e79b541d612b9d20e117dc33d9fc4240'],1,5,6,16744688,1,0,0,1,11239
d58802e974b8663524c6b7d31ff89949c60ec236,1,Siddharth Wagle,2013-10-03 17:28:38-07:00,['54871024758d120f6591ffb1fea213109aa8a241'],11,28,39,16744727,4,0,1,0,11239
48fef3beb56b1826903768f4eeb714f24e827fa5,0,Mahadev Konar,2013-10-03 17:37:46-07:00,['d58802e974b8663524c6b7d31ff89949c60ec236'],5,5,10,16744737,3,,,,11239
cedc67afb2e1415082708e473be0924cbdfa72c4,0,Mahadev Konar,2013-10-03 21:58:41-07:00,['48fef3beb56b1826903768f4eeb714f24e827fa5'],3,24,27,16744764,1,1,1,1,11239
0c42fd8538048b45ed7318c1102ac9b3485cd3f0,0,Mahadev Konar,2013-10-03 22:17:48-07:00,['cedc67afb2e1415082708e473be0924cbdfa72c4'],0,4,4,16744768,1,1,1,0,11239
2d946404b9a0f58f2438a2f549aa577b125d7d92,1,Mahadev Konar,2013-10-03 22:28:57-07:00,['0c42fd8538048b45ed7318c1102ac9b3485cd3f0'],5,4,9,16744777,2,0,0,1,11239
edd114db25fd2b3ed983305ece250943d30606d6,0,aBabiichuk,2013-10-04 17:28:29+03:00,['2d946404b9a0f58f2438a2f549aa577b125d7d92'],1,3,4,16744781,1,1,1,1,11239
446f86b2101b121fbe0cd6fcadc4fe24c641c04e,1,aBabiichuk,2013-10-04 20:21:14+03:00,['edd114db25fd2b3ed983305ece250943d30606d6'],0,3,3,16744784,1,0,0,1,11239
230a06e992a5137490b5998b58ddd851f083e11c,0,Yusaku Sako,2013-10-04 10:26:51-07:00,['446f86b2101b121fbe0cd6fcadc4fe24c641c04e'],2,1,3,16744787,1,,,,11239
f4b62b546a1a9bfb19a84c51fdc419764ee188f7,0,Siddharth Wagle,2013-10-04 11:41:01-07:00,['230a06e992a5137490b5998b58ddd851f083e11c'],3,6,9,16744796,1,0,1,1,11239
2b0048b8ed48d81bd0f9318020707933b46d8abf,0,Yusaku Sako,2013-10-04 14:24:00-07:00,['f4b62b546a1a9bfb19a84c51fdc419764ee188f7'],2,7,9,16744805,4,,,,11239
2339fa99c270fcadf104d75e149fb00093e4af94,1,Siddharth Wagle,2013-10-04 14:52:32-07:00,['2b0048b8ed48d81bd0f9318020707933b46d8abf'],51,51,102,16744907,4,,,,11239
41d6de75df76323b00c5b94ddcf174a0dcde0de6,1,Mahadev Konar,2013-10-04 15:38:37-07:00,['2339fa99c270fcadf104d75e149fb00093e4af94'],25,24,49,16744956,3,1,0.25,0.75,11239
03e5500121c0d7fc32a93f663d75abc46e745872,1,Sumit Mohanty,2013-10-04 16:28:22-07:00,['41d6de75df76323b00c5b94ddcf174a0dcde0de6'],22,115,137,16745093,2,0,0.777777778,0.111111111,11239
06ee3b3fccf70b018ae69deff071ab985f287429,1,Jaimin Jetly,2013-10-04 17:14:53-07:00,['03e5500121c0d7fc32a93f663d75abc46e745872'],68,34,102,16745195,8,,,,11239
9823d5786589907280301aeb30a77244e1ef173f,0,Siddharth Wagle,2013-10-04 19:08:46-07:00,['06ee3b3fccf70b018ae69deff071ab985f287429'],13,18,31,16745226,2,0,1,0,11239
530232af0dcbccdda8eb5870b6d8d73d2676b1c1,1,Sumit Mohanty,2013-10-05 01:34:49-07:00,['9823d5786589907280301aeb30a77244e1ef173f'],26,40,66,16745292,2,,,,11239
6a15aadeb54cacd11c2354eaf0a7025b681f0ce2,0,Mahadev Konar,2013-10-05 18:57:58-07:00,['530232af0dcbccdda8eb5870b6d8d73d2676b1c1'],2,2,4,16745296,2,,,,11239
3ba75617b11cc00acdc9f7d0ec05b55a011d2354,1,Mahadev Konar,2013-10-06 12:42:19-07:00,['6a15aadeb54cacd11c2354eaf0a7025b681f0ce2'],0,16,16,16745312,2,,,,11239
0a80b3f25e054d875b8c57a64c8eaa27b9d727d3,1,Yusaku Sako,2013-10-06 17:41:52-07:00,['3ba75617b11cc00acdc9f7d0ec05b55a011d2354'],115,12,127,16745439,3,,,,11239
94a17ec4a6fff6c3390784e03b8612bfd543bd56,1,atkach,2013-10-07 13:02:15+03:00,['0a80b3f25e054d875b8c57a64c8eaa27b9d727d3'],3,9,12,16745451,1,0,0,1,11239
ce5f62eddc3400d64ca3fbeb796747a03fdb18db,1,Oleg Nechiporenko,2013-10-07 13:49:34+03:00,['94a17ec4a6fff6c3390784e03b8612bfd543bd56'],3,24,27,16745478,2,0.956521739,1,1,11239
d436c3a1bdf8bfba9f96dac623dfbc16751d27ea,0,aBabiichuk,2013-10-07 19:01:46+03:00,['ce5f62eddc3400d64ca3fbeb796747a03fdb18db'],0,8,8,16745486,2,0,0,1,11239
335029f652cc20bbc5b285eab108c4af785ac3b8,0,Alex Antonenko,2013-10-07 19:10:35+03:00,['d436c3a1bdf8bfba9f96dac623dfbc16751d27ea'],7,17,24,16745510,2,1,1,1,11239
bc6503b862fb364aa4b580cd75c9ae5b59ea0201,1,Oleksandr Diachenko,2013-10-07 23:32:58+03:00,['335029f652cc20bbc5b285eab108c4af785ac3b8'],0,10,10,16745520,1,,,,11239
7e89b1116e23dd17d91f1f7b417c7361074cce68,0,Mahadev Konar,2013-10-07 18:53:50-07:00,['bc6503b862fb364aa4b580cd75c9ae5b59ea0201'],1,12,13,16745533,1,1,1,1,11239
d74b4279dd8b715be6cf75f2b8d153c67f074a34,1,Mahadev Konar,2013-10-07 18:57:14-07:00,['7e89b1116e23dd17d91f1f7b417c7361074cce68'],2,2,4,16745537,1,,,,11239
618a6619a6fdb8b731b414aedb825d3e159c85b4,0,Yusaku Sako,2013-10-08 01:24:12-07:00,['d74b4279dd8b715be6cf75f2b8d153c67f074a34'],14,1,15,16745552,2,,,,11239
8281195b6910cc2dddbab69600ef0af833ec88a9,0,atkach,2013-10-08 12:27:45+03:00,['618a6619a6fdb8b731b414aedb825d3e159c85b4'],1,1,2,16745554,1,,,,11239
55c7e46e3db0284786de74ac0965dc7948a80d76,1,Oleg Nechiporenko,2013-10-08 13:29:59+03:00,['8281195b6910cc2dddbab69600ef0af833ec88a9'],1,1,2,16745556,1,,,,11239
b0c07e197839c35c1fc7178e19e30207c361c2f3,1,Jaimin Jetly,2013-10-08 17:43:56-07:00,['55c7e46e3db0284786de74ac0965dc7948a80d76'],6,24,30,16745586,1,1,1,1,11239
96d67e3738c02a5a679e7fac51217a21c61a9d67,0,Jaimin Jetly,2013-10-08 17:49:15-07:00,['b0c07e197839c35c1fc7178e19e30207c361c2f3'],2,14,16,16745602,1,0.75,0.75,1,11239
ef1e1f98d5d406de8dff6b3ac62fe02d5c72e0b6,0,Siddharth Wagle,2013-10-08 18:22:05-07:00,['96d67e3738c02a5a679e7fac51217a21c61a9d67'],1,3,4,16745606,2,,,,11239
0c3b3d893682711283425c0a6c139af88a3b6c83,0,Sumit Mohanty,2013-10-08 23:21:44-07:00,['ef1e1f98d5d406de8dff6b3ac62fe02d5c72e0b6'],1,11,12,16745618,2,,,,11239
78e3d4142d0a0e604b38526cb3e06c73d43a2b7c,0,atkach,2013-10-09 15:40:39+03:00,['0c3b3d893682711283425c0a6c139af88a3b6c83'],14,17,31,16745649,1,0,0,1,11239
489a193dd2f54215f8b6f9dc9890032ca746b301,1,Lisnichenko Dmitro,2013-10-09 21:10:30+03:00,['78e3d4142d0a0e604b38526cb3e06c73d43a2b7c'],980,86,1066,16746715,10,0.743925234,0.297196262,0.751401869,11239
c0e318b207bd36cbee232b6aa11964e7dc89c896,0,Jaimin Jetly,2013-10-09 20:47:28-07:00,['489a193dd2f54215f8b6f9dc9890032ca746b301'],22,47,69,16746784,3,1,1,1,11239
a0dd6770e2e7594ce8e191e8035f147988b8e59a,1,Aleksandr Kovalenko,2013-10-10 15:48:09+03:00,['c0e318b207bd36cbee232b6aa11964e7dc89c896'],140,287,427,16747211,31,0.963636364,0.981818182,1,11241
8d72c0b9e5c9bfad4ec7643a9eeafb82b08fec99,0,aBabiichuk,2013-10-10 16:31:14+03:00,['a0dd6770e2e7594ce8e191e8035f147988b8e59a'],1,1,2,16747213,1,,,,11241
124e06d72d793ce31e5d5f7805b0c54522ac4806,1,atkach,2013-10-10 16:57:44+03:00,['8d72c0b9e5c9bfad4ec7643a9eeafb82b08fec99'],79,137,216,16747429,9,0.96,1,1,11242
883d33eb9b0f911b0b24d48acdb675dea55da8df,0,Nate Cole,2013-10-10 10:46:35-04:00,['124e06d72d793ce31e5d5f7805b0c54522ac4806'],13,14,27,16747456,3,0,0,1,11242
f9d8b55f76bc036baa254dbf9911858715872f1f,1,Alex Antonenko,2013-10-10 19:12:37+03:00,['883d33eb9b0f911b0b24d48acdb675dea55da8df'],1,69,70,16747526,2,0.108695652,0.956521739,1,11242
3571423f61b298ec6d2289adc62e14f6e04f01ab,0,Oleksandr Diachenko,2013-10-10 19:27:07+03:00,['f9d8b55f76bc036baa254dbf9911858715872f1f'],2,16,18,16747544,2,0,1,0,11242
82e92080c49c3f9c54ea527e38900b1e6abf71d8,0,Oleksandr Diachenko,2013-10-10 19:32:51+03:00,['3571423f61b298ec6d2289adc62e14f6e04f01ab'],1,27,28,16747572,2,0,0,0.4,11242
8f450ffd75d4c1968477b8ebfadfd7f62a58b177,0,Oleksandr Diachenko,2013-10-10 19:36:45+03:00,['82e92080c49c3f9c54ea527e38900b1e6abf71d8'],2,2,4,16747576,1,,,,11242
29012b4aaaf1545f842d8d8b6c26c7e97f4f27b6,1,Nate Cole,2013-10-10 17:02:32-04:00,['8f450ffd75d4c1968477b8ebfadfd7f62a58b177'],14,13,27,16747603,3,1,1,0,11242
bc56c034e7eb45cb8817b43a44464ab02724281a,1,Yusaku Sako,2013-10-10 14:10:41-07:00,['29012b4aaaf1545f842d8d8b6c26c7e97f4f27b6'],1126,237,1363,16748966,23,0.753875969,0.779069767,0.579457364,11242
7b52868fdcb6e41648593f396e2d69823407eb41,0,Yusaku Sako,2013-10-10 14:10:44-07:00,['bc56c034e7eb45cb8817b43a44464ab02724281a'],3,3,6,16748972,1,,,,11242
674f227f0653b51bb578c4e30c67aea99ff4eb7c,1,Yusaku Sako,2013-10-10 14:41:01-07:00,['7b52868fdcb6e41648593f396e2d69823407eb41'],340,43,383,16749355,11,0.364705882,0.011764706,0.011764706,11242
d7514dcfcf42e341bfc4ebc220f228af6c9d4a14,0,Jaimin Jetly,2013-10-10 17:35:28-07:00,['674f227f0653b51bb578c4e30c67aea99ff4eb7c'],21,0,21,16749376,1,,,,11242
1a219f0a7d5f8ea2ca4bc76215b49fe2a595c9bc,1,Jaimin Jetly,2013-10-10 17:41:41-07:00,['d7514dcfcf42e341bfc4ebc220f228af6c9d4a14'],4,26,30,16749406,2,0,0,0.235294118,11242
1a109fb29cecb9538f888edf6d7e7ef7017dc502,0,Sumit Mohanty,2013-10-10 18:27:42-07:00,['1a219f0a7d5f8ea2ca4bc76215b49fe2a595c9bc'],27,1,28,16749434,2,1,1,0.6,11242
06fd82a659b613de87eee016827a5c7e3376d415,1,Yusaku Sako,2013-10-10 19:31:22-07:00,['1a109fb29cecb9538f888edf6d7e7ef7017dc502'],0,5,5,16749439,1,,,,11242
82d26cbe05cf02bec5235c794130798d904df26d,1,Yusaku Sako,2013-10-10 19:41:27-07:00,['06fd82a659b613de87eee016827a5c7e3376d415'],131,264,395,16749834,9,1,1,0.714285714,11242
36cdefe007ea50ff55ec21ffbb9e49925bc1bb48,0,Yusaku Sako,2013-10-10 19:45:13-07:00,['82d26cbe05cf02bec5235c794130798d904df26d'],8,8,16,16749850,1,,,,11242
82823e6e20ed1d50545e0072e11f5cc32a6b1dc6,0,Aleksandr Kovalenko,2013-10-11 17:31:33+03:00,['36cdefe007ea50ff55ec21ffbb9e49925bc1bb48'],2,7,9,16749859,1,,,,11242
b3ca22261ea571aabd703934eb9d924d3decffc3,1,Oleg Nechiporenko,2013-10-11 18:18:43+03:00,['82823e6e20ed1d50545e0072e11f5cc32a6b1dc6'],240,1168,1408,16751267,5,0.481481481,1,1,11243
e964d3fd3309b219604b10c01a47c64cfeb96056,1,aBabiichuk,2013-10-11 18:51:46+03:00,['b3ca22261ea571aabd703934eb9d924d3decffc3'],0,10,10,16751277,1,,,,11243
4dd856eaa5efb324f7d5796dfea37b56fc3807ee,1,Myroslav Papirkovskyy,2013-10-11 19:54:10+03:00,['e964d3fd3309b219604b10c01a47c64cfeb96056'],10,20,30,16751307,2,1,1,1,11243
f1d232fb88af5577160805dacd12d503ab41d514,1,Oleksandr Diachenko,2013-10-11 20:37:40+03:00,['4dd856eaa5efb324f7d5796dfea37b56fc3807ee'],239,307,546,16751853,14,1,0,0,11245
4410fcce1883347b9853bf9e3cd321488157d4f8,1,Siddharth Wagle,2013-10-11 10:48:26-07:00,['f1d232fb88af5577160805dacd12d503ab41d514'],1,76,77,16751930,2,0,0.783333333,0,11245
f8b247be70e146c8a43706742f649b6020a58d59,1,Jaimin Jetly,2013-10-13 22:57:31-07:00,['4410fcce1883347b9853bf9e3cd321488157d4f8'],0,76,76,16752006,1,0.952380952,0.952380952,1,11245
b8c835b553b02549b2e8d4eb65a7f9488f24b479,1,Oleg Nechiporenko,2013-10-14 13:56:25+03:00,['f8b247be70e146c8a43706742f649b6020a58d59'],1,7,8,16752014,2,0,1,1,11245
5366b1d70b6da812a3a1ab3f2781268704b779a1,1,Oleg Nechiporenko,2013-10-14 16:02:01+03:00,['b8c835b553b02549b2e8d4eb65a7f9488f24b479'],2,10,12,16752026,1,,,,11245
150f949aaab21428c9770ee376b1285460f0c894,1,Aleksandr Kovalenko,2013-10-14 17:49:40+03:00,['5366b1d70b6da812a3a1ab3f2781268704b779a1'],91,89,180,16752206,4,0.36,1,1,11245
fc1ea2b60a9af4a0ed8b0b575df65127269fc5ca,1,Oleg Nechiporenko,2013-10-14 18:00:01+03:00,['150f949aaab21428c9770ee376b1285460f0c894'],0,12,12,16752218,1,1,1,1,11245
1cea3394ed7a5430c345991ca84294174906a151,0,Lisnichenko Dmitro,2013-10-14 18:54:28+03:00,['fc1ea2b60a9af4a0ed8b0b575df65127269fc5ca'],2,6,8,16752226,1,,,,11245
84f491ca19017411b4baeba186138302cbeeb5fe,1,Aleksandr Kovalenko,2013-10-14 19:12:41+03:00,['1cea3394ed7a5430c345991ca84294174906a151'],4,4,8,16752234,2,,,,11245
9dbf00eed8aca6caf56cc4a16747dd07acfdadff,0,Sumit Mohanty,2013-10-14 19:24:24-07:00,['84f491ca19017411b4baeba186138302cbeeb5fe'],1,5,6,16752240,1,,,,11245
d26023841a5c2022169af0809ca9166dafe2d007,1,atkach,2013-10-15 15:18:29+03:00,['9dbf00eed8aca6caf56cc4a16747dd07acfdadff'],10,37,47,16752287,6,1,1,1,11245
d67d1fe8fd838032946339f48b5972de639788b6,1,atkach,2013-10-15 16:40:15+03:00,['d26023841a5c2022169af0809ca9166dafe2d007'],2,2,4,16752291,2,,,,11245
70b6e8a6e386009014fa5d731f1219eed6c2a021,0,Aleksandr Kovalenko,2013-10-15 17:43:30+03:00,['d67d1fe8fd838032946339f48b5972de639788b6'],1,1,2,16752293,1,,,,11245
05793888d7faf27262bcc05f8821f405ca10cce0,0,Aleksandr Kovalenko,2013-10-15 18:19:39+03:00,['70b6e8a6e386009014fa5d731f1219eed6c2a021'],4,5,9,16752302,1,,,,11245
24dbefe242509d2ee7fe570bb0d40f682119a99a,1,Aleksandr Kovalenko,2013-10-15 18:26:14+03:00,['05793888d7faf27262bcc05f8821f405ca10cce0'],0,2,2,16752304,1,1,1,1,11245
37bd63fc519f26eb214ff25b7abda8126e1bfc58,1,Aleksandr Kovalenko,2013-10-16 18:48:53+03:00,['24dbefe242509d2ee7fe570bb0d40f682119a99a'],11,66,77,16752381,5,0.724137931,1,1,11245
65ba892aef90bf6f7c60b78af24a9d0ff83327d8,1,Alex Antonenko,2013-10-16 19:26:36+03:00,['37bd63fc519f26eb214ff25b7abda8126e1bfc58'],73,808,881,16753262,25,0.905579399,1,1,11258
ecf65d2319014c181d6de183d2d6dd205a0942c6,1,Oleg Nechiporenko,2013-10-16 20:00:55+03:00,['65ba892aef90bf6f7c60b78af24a9d0ff83327d8'],17,44,61,16753323,4,0.909090909,0.909090909,1,11258
8f2b1fe4c6fc673bbaea604d3c1f072276842598,1,Oleg Nechiporenko,2013-10-16 20:00:56+03:00,['ecf65d2319014c181d6de183d2d6dd205a0942c6'],1,1,2,16753325,1,,,,11258
8d534ee1161a20936d5fd4d0fef045323035f1b2,1,Jaimin Jetly,2013-10-16 18:12:21-07:00,['8f2b1fe4c6fc673bbaea604d3c1f072276842598'],76,105,181,16753506,6,1,1,1,11258
0cdf5a8f9b8bdcb6c8ea54692903dc7d3e06dc28,1,aBabiichuk,2013-10-17 15:05:27+03:00,['8d534ee1161a20936d5fd4d0fef045323035f1b2'],3,11,14,16753520,2,0.625,0,1,11258
9a05963cedb986c1e9ea571642783404ac392f09,0,Oleksandr Diachenko,2013-10-17 15:31:31+03:00,['0cdf5a8f9b8bdcb6c8ea54692903dc7d3e06dc28'],1,23,24,16753544,2,0,0,0.470588235,11258
02ecc4d18939fd0fc76b03bbcf0ebcdbfb7a5a4a,0,Oleksandr Diachenko,2013-10-17 15:39:29+03:00,['9a05963cedb986c1e9ea571642783404ac392f09'],1,105,106,16753650,2,,,,11259
cd0517afb0715fd1fd577a48c0a7fd3096ab2add,1,Oleg Nechiporenko,2013-10-17 17:33:07+03:00,['02ecc4d18939fd0fc76b03bbcf0ebcdbfb7a5a4a'],7,196,203,16753853,6,0.327044025,1,1,11260
d6aca0b4dae8c9ec0b5101eae891ba434921225b,0,Aleksandr Kovalenko,2013-10-17 19:08:47+03:00,['cd0517afb0715fd1fd577a48c0a7fd3096ab2add'],3,12,15,16753868,2,0,1,1,11260
94fd897f67298a2c8b9acca9ef454e08bcccb292,0,Alex Antonenko,2013-10-17 19:33:25+03:00,['d6aca0b4dae8c9ec0b5101eae891ba434921225b'],13,10,23,16753891,3,1,1,1,11260
873b3502bec3344ff8b03a7a1ffd2240f9de13b4,1,Mahadev Konar,2013-10-17 17:26:21-07:00,['94fd897f67298a2c8b9acca9ef454e08bcccb292'],0,41679,41679,16795570,402,0.479055041,0.795908427,0.88894301,11660
aa4b88fed9bfc7ab0fa70c78488e4b40c46aae7c,0,Srimanth Gunturi,2013-10-17 17:43:31-07:00,['873b3502bec3344ff8b03a7a1ffd2240f9de13b4'],1,16,17,16795587,2,0.5,0.5,1,11660
5c767210d83fd8bd07a984f59d43410c98ff73c6,1,atkach,2013-10-18 15:05:26+03:00,['aa4b88fed9bfc7ab0fa70c78488e4b40c46aae7c'],47,319,366,16795953,10,0.437956204,0.518248175,0.97080292,11662
e676819f5e645b57416c4d4ff1e1fe7eed5b9bb3,1,Alex Antonenko,2013-10-18 17:02:22+03:00,['5c767210d83fd8bd07a984f59d43410c98ff73c6'],123,138,261,16796214,9,1,1,1,11662
733f8f910a619c00e9cedde6fb9bfd3ef10621cd,1,aBabiichuk,2013-10-18 18:14:34+03:00,['e676819f5e645b57416c4d4ff1e1fe7eed5b9bb3'],1,2,3,16796217,1,0,0,1,11662
9cda86be30bae92c395cc4fb0e833b5ec08770e6,1,Mahadev Konar,2013-10-18 08:37:03-07:00,['733f8f910a619c00e9cedde6fb9bfd3ef10621cd'],4,1804,1808,16798025,28,0.550946799,0.641118124,0.736699729,11687
e9c19145cefe9dc103f2179f4d219497ea5268a0,1,Mahadev Konar,2013-10-18 08:39:35-07:00,['9cda86be30bae92c395cc4fb0e833b5ec08770e6'],253,22,275,16798300,7,0.74522293,0.636942675,0.337579618,11687
58a3eac93c74c9ef433c4cb8491666d82e5f6fa3,1,Mahadev Konar,2013-10-18 08:41:19-07:00,['e9c19145cefe9dc103f2179f4d219497ea5268a0'],92,30,122,16798422,3,0.711538462,0.326923077,0.288461538,11687
647dc17ca8e90cc1b67dfd49e1622cc100aeabfb,1,Alex Antonenko,2013-10-18 18:40:27+03:00,['58a3eac93c74c9ef433c4cb8491666d82e5f6fa3'],14,44,58,16798480,6,1,1,1,11687
bb2f8aef48a09ab733af9044d8c52f54327ceb9a,1,Mahadev Konar,2013-10-18 09:16:03-07:00,['647dc17ca8e90cc1b67dfd49e1622cc100aeabfb'],0,17,17,16798497,1,1,1,1,11688
b945179bd73080ad2d79437b4966656dfc0d6495,1,Oleg Nechiporenko,2013-10-18 19:21:25+03:00,['bb2f8aef48a09ab733af9044d8c52f54327ceb9a'],2,68,70,16798567,3,0.8,1,0.914285714,11688
c16d009a96b6a06668a5305c0aff6d25800449a1,0,Jaimin Jetly,2013-10-18 16:21:27-07:00,['b945179bd73080ad2d79437b4966656dfc0d6495'],5,7,12,16798579,2,,,,11688
0321de69c618eeea281201e707c316db3495f60a,1,Siddharth Wagle,2013-10-18 17:21:18-07:00,['c16d009a96b6a06668a5305c0aff6d25800449a1'],1,1152,1153,16799732,12,0.811881188,0.805940594,0.893069307,11697
7f27602af59a4f8259f7a74710b2b90b038f73e8,1,Oleg Nechiporenko,2013-10-21 15:42:06+03:00,['0321de69c618eeea281201e707c316db3495f60a'],95,118,213,16799945,3,0,1,1,11697
f700bf0973ab2cbc285bbb6bcd7f569b45f64deb,1,atkach,2013-10-21 15:51:37+03:00,['7f27602af59a4f8259f7a74710b2b90b038f73e8'],0,4,4,16799949,1,1,1,1,11697
a86099d33e7a40055f53264cafe00f4513e169a1,1,Aleksandr Kovalenko,2013-10-21 19:34:46+03:00,['f700bf0973ab2cbc285bbb6bcd7f569b45f64deb'],6,17,23,16799972,4,1,1,1,11697
c0b68039c3eed70d46f1ea0be72d4502b512dd2f,1,Alex Antonenko,2013-10-21 20:47:29+03:00,['a86099d33e7a40055f53264cafe00f4513e169a1'],6,30,36,16800008,5,0.95,0.95,1,11697
139537c77d4ef7dcd661a9e004904453b3d698d5,1,Jaimin Jetly,2013-10-21 11:28:56-07:00,['c0b68039c3eed70d46f1ea0be72d4502b512dd2f'],36,49,85,16800093,4,1,0,0,11697
38569ba592a467d2e716f2906b4f0ec049c855e9,1,Oleg Nechiporenko,2013-10-22 13:26:27+03:00,['139537c77d4ef7dcd661a9e004904453b3d698d5'],1,4,5,16800098,2,1,1,1,11697
b356135d2ff637748c189e7267e0750d04be65a6,0,atkach,2013-10-22 14:44:40+03:00,['38569ba592a467d2e716f2906b4f0ec049c855e9'],4,12,16,16800114,2,1,1,1,11697
1bee56a9b870e7797fbf7449463e6dc43774dcd0,0,Oleksandr Diachenko,2013-10-22 17:40:12+03:00,['b356135d2ff637748c189e7267e0750d04be65a6'],5,47,52,16800166,2,,,,11697
9404fc004546a674ae329811a0a0eab1f379fc91,1,Aleksandr Kovalenko,2013-10-22 18:06:19+03:00,['1bee56a9b870e7797fbf7449463e6dc43774dcd0'],1,9,10,16800176,4,1,1,1,11697
3e1a60aa4be02cf3d9ff4fbf157953051534a09f,1,Oleg Nechiporenko,2013-10-22 18:09:26+03:00,['9404fc004546a674ae329811a0a0eab1f379fc91'],91,142,233,16800409,6,1,1,1,11701
dac8ff8b1429890c77d6dc76cbaba701515dd47e,1,Lisnichenko Dmitro,2013-10-22 18:31:09+03:00,['3e1a60aa4be02cf3d9ff4fbf157953051534a09f'],26,30,56,16800465,2,0,0,0,11701
6001f062c821c6bff28c5abe3f140d16512ece51,1,atkach,2013-10-22 18:41:27+03:00,['dac8ff8b1429890c77d6dc76cbaba701515dd47e'],0,32,32,16800497,2,1,1,0.7,11701
f073329382f379a98364e5b0f28402796cef6575,1,Lisnichenko Dmitro,2013-10-22 18:49:59+03:00,['6001f062c821c6bff28c5abe3f140d16512ece51'],1,21439,21440,16821937,128,0.62407801,0.728091011,0.658707338,11826
98243a9186220eb994c62fd4bf06a781ae798eb5,1,Lisnichenko Dmitro,2013-10-22 18:58:39+03:00,['f073329382f379a98364e5b0f28402796cef6575'],38,12,50,16821987,4,1,0.111111111,0.111111111,11826
08f3991b05c5a54c58aeed2b4a8227dcb9a84a39,1,Lisnichenko Dmitro,2013-10-22 19:06:38+03:00,['98243a9186220eb994c62fd4bf06a781ae798eb5'],34,82,116,16822103,9,0,1,0,11827
bf46889d35caccf52598064c7d96d6e533347b34,1,Lisnichenko Dmitro,2013-10-22 19:13:24+03:00,['08f3991b05c5a54c58aeed2b4a8227dcb9a84a39'],3,7,10,16822113,2,1,1,1,11827
57a9dd04de963ddb883b4300790c5341389bfa36,0,Mahadev Konar,2013-10-22 09:19:56-07:00,['bf46889d35caccf52598064c7d96d6e533347b34'],15,9,24,16822137,2,,,,11827
280c1550768fb6b1849e4de48a88d573d8794a18,1,Lisnichenko Dmitro,2013-10-22 19:21:45+03:00,['57a9dd04de963ddb883b4300790c5341389bfa36'],4,9,13,16822150,2,0,0,1,11827
4c14a716ee80f39dfd5eef18007a5db1ebbd6e4c,1,Lisnichenko Dmitro,2013-10-22 19:23:18+03:00,['280c1550768fb6b1849e4de48a88d573d8794a18'],7,18,25,16822175,3,0,0,1,11827
19c00dbd99f976d4bdeb0594b8e0c1e1b6a4c85c,1,Lisnichenko Dmitro,2013-10-22 19:25:29+03:00,['4c14a716ee80f39dfd5eef18007a5db1ebbd6e4c'],17,16,33,16822208,3,0,0,0,11827
cc8d9fec8b47d47f1a32c435004316278eadd804,1,Lisnichenko Dmitro,2013-10-22 19:27:09+03:00,['19c00dbd99f976d4bdeb0594b8e0c1e1b6a4c85c'],30,22,52,16822260,3,1,1,1,11827
f8cf601c1fac6f2b7571903b3ded8225f71d63a7,1,Lisnichenko Dmitro,2013-10-22 19:28:48+03:00,['cc8d9fec8b47d47f1a32c435004316278eadd804'],2,11,13,16822273,1,0,0,0,11827
1aad6407be494a4c77002906479d9e8a39f60685,1,tbeerbower,2013-10-22 14:49:52-04:00,['f8cf601c1fac6f2b7571903b3ded8225f71d63a7'],2249,2169,4418,16826691,8,1,1,0.869918699,11827
2700d84739367a1cd4eb97aa13cfecdeb3c18af4,1,Siddharth Wagle,2013-10-22 15:03:12-07:00,['1aad6407be494a4c77002906479d9e8a39f60685'],18,18,36,16826727,3,,,,11827
7b66bbf26d3f4e1788e4380b3e9e2522afc069c8,1,Mahadev Konar,2013-10-22 15:33:58-07:00,['2700d84739367a1cd4eb97aa13cfecdeb3c18af4'],1,9195,9196,16835923,83,,,,11909
63d56385483f212b0c0efc1d0ca3bbf125ebbbba,1,Mahadev Konar,2013-10-22 15:34:07-07:00,['7b66bbf26d3f4e1788e4380b3e9e2522afc069c8'],1,1,2,16835925,1,,,,11909
88f513259283798b8746a607354d345e6754890d,1,Jaimin Jetly,2013-10-22 15:56:21-07:00,['63d56385483f212b0c0efc1d0ca3bbf125ebbbba'],3070,2368,5438,16841363,32,1,0.333333333,0,11909
0672abab29adfc2264a9d3ef9e3621959687b187,1,Sumit Mohanty,2013-10-22 15:58:03-07:00,['88f513259283798b8746a607354d345e6754890d'],12,47,59,16841422,2,0.8,0.8,0.2,11909
48ceaa9ecbf1031e743891413c12c4b4e0cdb5a2,1,Jaimin Jetly,2013-10-22 16:33:40-07:00,['0672abab29adfc2264a9d3ef9e3621959687b187'],676,702,1378,16842800,11,,,,11909
bc0bbbf9b8d99af2b6cf6fcb5162b415da06e6ab,1,Siddharth Wagle,2013-10-22 18:16:19-07:00,['48ceaa9ecbf1031e743891413c12c4b4e0cdb5a2'],0,16,16,16842816,1,,,,11909
859ba4b499fecb286b81f14c79ce81a390f90f90,1,Oleksandr Diachenko,2013-10-23 15:10:47+03:00,['bc0bbbf9b8d99af2b6cf6fcb5162b415da06e6ab'],7,121,128,16842944,9,0,1,1,11910
629bd3e5f202b5d45f1440fa2893bb2c2dc40a7b,1,aBabiichuk,2013-10-23 16:30:16+03:00,['859ba4b499fecb286b81f14c79ce81a390f90f90'],20,24,44,16842988,2,0,0,1,11910
8eb0034ca1f8b3a7ed641100f673b8571e78b595,1,Srimanth Gunturi,2013-10-23 14:55:33-07:00,['629bd3e5f202b5d45f1440fa2893bb2c2dc40a7b'],309,2,311,16843299,6,0.70703125,0.70703125,0.23828125,11910
7fd4f92e0c537756ced5c4b3b3e58108fdcd53d9,1,Jaimin Jetly,2013-10-23 18:22:39-07:00,['8eb0034ca1f8b3a7ed641100f673b8571e78b595'],39,57,96,16843395,9,0.888888889,1,1,11910
a67fb7cb3b0afafb4f07ef3db919c6bdac200a70,1,tbeerbower,2013-10-24 10:58:26-04:00,['7fd4f92e0c537756ced5c4b3b3e58108fdcd53d9'],365,574,939,16844334,11,0,0.845679012,0.407407407,11911
98adf59479cd1be9bb62ff09d29abc7696f252ef,1,Lisnichenko Dmitro,2013-10-24 22:37:34+03:00,['a67fb7cb3b0afafb4f07ef3db919c6bdac200a70'],33,433,466,16844800,11,0.397163121,1,0.553191489,11916
e136095b858a3a0ab0fc84e51ce10c0eb524d438,0,Jaimin Jetly,2013-10-24 16:20:14-07:00,['98adf59479cd1be9bb62ff09d29abc7696f252ef'],2,1,3,16844803,2,,,,11916
9b056b12ed7c5842dead050eb6e041175487941f,0,Srimanth Gunturi,2013-10-24 17:27:08-07:00,['e136095b858a3a0ab0fc84e51ce10c0eb524d438'],16,1,17,16844820,2,0.5,0.5,0,11916
49a3cbe9f934e8559997e2044eb9bb27ba6bdf85,1,Oleg Nechiporenko,2013-10-25 13:49:03+03:00,['9b056b12ed7c5842dead050eb6e041175487941f'],133,153,286,16845106,18,0.333333333,1,0.416666667,11916
ec7f70673b05ab1cdea7297a4135f304c3388110,1,Aleksandr Kovalenko,2013-10-25 19:25:50+03:00,['49a3cbe9f934e8559997e2044eb9bb27ba6bdf85'],23,123,146,16845252,7,0.967741935,0.983870968,1,11916
bb62d39bc71648f1e4cf559c0ca4364b76626d33,1,Nate Cole,2013-10-25 13:09:15-04:00,['ec7f70673b05ab1cdea7297a4135f304c3388110'],4,35,39,16845291,2,0,1,1,11916
a1fedaf88a3e8464c89657ce7ab18e676e6ce0f3,0,Lisnichenko Dmitro,2013-10-25 21:00:54+03:00,['bb62d39bc71648f1e4cf559c0ca4364b76626d33'],4,4,8,16845299,2,,,,11916
0b5dfa542e27c6a530e79e9712e125a7bfb0c5b0,1,Jaimin Jetly,2013-10-25 19:56:54-07:00,['a1fedaf88a3e8464c89657ce7ab18e676e6ce0f3'],56,82,138,16845437,4,0.12,0,1,11916
ac94d2779e9e11a21577ed66fb1252a0fa62d5f2,1,aBabiichuk,2013-10-28 14:22:47+02:00,['0b5dfa542e27c6a530e79e9712e125a7bfb0c5b0'],6,47,53,16845490,6,0,0,1,11916
2366731e5f011d9586521cf27eb2c0cf3d7c76b9,0,Oleksandr Diachenko,2013-10-28 16:17:11+02:00,['ac94d2779e9e11a21577ed66fb1252a0fa62d5f2'],14,17,31,16845521,1,,,,11916
6a437469794d744514b69434354b26592fd23bd6,1,Oleksandr Diachenko,2013-10-28 16:45:57+02:00,['2366731e5f011d9586521cf27eb2c0cf3d7c76b9'],1,3,4,16845525,1,,,,11916
6dcda0d511b979608cf528a1a31edf24f8d02981,0,Lisnichenko Dmitro,2013-10-28 17:10:48+02:00,['6a437469794d744514b69434354b26592fd23bd6'],0,1,1,16845526,1,,,,11916
71226d354266ec59ea16d1f9e921a3dd17d81a33,0,Aleksandr Kovalenko,2013-10-28 17:58:49+02:00,['6dcda0d511b979608cf528a1a31edf24f8d02981'],1,6,7,16845533,2,1,1,1,11916
6ed6d64ea79e1e145ad35ae66c9b82e985ddbc59,1,Aleksandr Kovalenko,2013-10-28 18:01:13+02:00,['71226d354266ec59ea16d1f9e921a3dd17d81a33'],4,5,9,16845542,2,,,,11916
399a63b8e43337d088a5b466051fe19ddfd9605c,0,Lisnichenko Dmitro,2013-10-28 19:12:58+02:00,['6ed6d64ea79e1e145ad35ae66c9b82e985ddbc59'],2,2,4,16845546,2,,,,11916
b2d057065123d2e5b25b3c3592d878d1e7db3eb1,1,Mahadev Konar,2013-10-28 10:57:37-07:00,['399a63b8e43337d088a5b466051fe19ddfd9605c'],140,1184,1324,16846870,10,0.888888889,0.533333333,1,11919
38a133e8cd9af35d8de7837278061aeb6d69dc10,1,Jaimin Jetly,2013-10-28 19:15:47-07:00,['b2d057065123d2e5b25b3c3592d878d1e7db3eb1'],19,22,41,16846911,6,0.25,0,0.25,11919
d57d5f7946a9ef56ee34b846c02c8c54db2093a3,1,Dmitry Sen,2013-10-29 16:24:19+02:00,['38a133e8cd9af35d8de7837278061aeb6d69dc10'],67,111,178,16847089,5,0,0.6,1,11919
8b0fc1cb6cc952f4e2a34410a6609b29c4328337,1,tbeerbower,2013-10-29 10:58:08-04:00,['d57d5f7946a9ef56ee34b846c02c8c54db2093a3'],896,1098,1994,16849083,10,0.240310078,0.798449612,0.930232558,11919
c7f1fed4b864e2fd9d5d385c848580df7f9199f3,0,tbeerbower,2013-10-29 10:58:08-04:00,['8b0fc1cb6cc952f4e2a34410a6609b29c4328337'],3,3,6,16849089,2,,,,11919
6f104fb5929f21d01a25a02f13b0f12c3ad099ed,1,Alex Antonenko,2013-10-29 18:05:40+02:00,['c7f1fed4b864e2fd9d5d385c848580df7f9199f3'],3,11,14,16849103,1,0.5,1,1,11919
1f26f6d3d64db09f14a1232c7fb9c4810343dbd2,1,Alex Antonenko,2013-10-29 18:21:42+02:00,['6f104fb5929f21d01a25a02f13b0f12c3ad099ed'],32,37,69,16849172,12,0.3,0.3,0,11919
6115a5720ed206ba54fee233dd5d006c54267fde,1,Nate Cole,2013-10-29 12:24:45-04:00,['1f26f6d3d64db09f14a1232c7fb9c4810343dbd2'],111,673,784,16849956,12,0.261818182,0.745454545,0.778181818,11920
c4a4b5a97d0d0f191730a4061433f9138d2cdf5c,0,Dmitry Sen,2013-10-29 19:20:19+02:00,['6115a5720ed206ba54fee233dd5d006c54267fde'],7,1,8,16849964,2,,,,11920
8647e65c115e3bc9f5ac3aac084e73e6647bc7bd,1,aBabiichuk,2013-10-29 19:34:28+02:00,['c4a4b5a97d0d0f191730a4061433f9138d2cdf5c'],2,3,5,16849969,1,0,0,1,11920
74d6a7f51d05895660eab59219e0eb8e9d127fa7,1,Dmitry Sen,2013-10-29 19:49:12+02:00,['8647e65c115e3bc9f5ac3aac084e73e6647bc7bd'],1,7,8,16849977,2,,,,11920
99e0e02a0af1eb787f7c80e432c53f0d2d928a8c,1,Mahadev Konar,2013-10-29 12:21:10-07:00,['74d6a7f51d05895660eab59219e0eb8e9d127fa7'],12,26,38,16850015,3,0.25,1,0.25,11920
ac5bd63c6320f8095a948b6231d84541407c6ce2,1,Mahadev Konar,2013-10-29 12:40:12-07:00,['99e0e02a0af1eb787f7c80e432c53f0d2d928a8c'],28,38,66,16850081,1,,0,,11920
00484f9c9da0653a4f840643ac2575f792f098e9,1,tbeerbower,2013-10-29 19:21:58-04:00,['ac5bd63c6320f8095a948b6231d84541407c6ce2'],81,200,281,16850362,6,0.338709677,1,1,11921
08165ae6157c917bdcc9e5c3bfddbff566d79389,0,Dmitry Sen,2013-10-30 14:31:56+02:00,['00484f9c9da0653a4f840643ac2575f792f098e9'],1,34,35,16850397,2,1,1,0.411764706,11921
035f2864988cd3d1c0082e62bae372bea7a22bed,1,aBabiichuk,2013-10-30 14:59:36+02:00,['08165ae6157c917bdcc9e5c3bfddbff566d79389'],4,9,13,16850410,2,,,,11921
c275b7312bc3919b246d625b5675e2c56aa43c8d,1,atkach,2013-10-30 15:42:59+02:00,['035f2864988cd3d1c0082e62bae372bea7a22bed'],452,406,858,16851268,7,0.936170213,1,0.553191489,11923
5ca0c22d4552920cf43608165e26951bc814d276,1,Oleksandr Diachenko,2013-10-30 16:04:57+02:00,['c275b7312bc3919b246d625b5675e2c56aa43c8d'],1,4,5,16851273,2,1,1,1,11923
1f835e74a844dc84554058c168670e4b282e7a82,0,tbeerbower,2013-10-30 11:14:31-04:00,['5ca0c22d4552920cf43608165e26951bc814d276'],23,13,36,16851309,2,0,0.571428571,0.571428571,11923
5f24598b50ca44c76e1890758a3ea9c79bdc3204,1,aBabiichuk,2013-10-30 18:19:52+02:00,['1f835e74a844dc84554058c168670e4b282e7a82'],2,3,5,16851314,2,,,,11923
bae037a86f1c43a8af8e03b46a31a158300dcdac,1,Aleksandr Kovalenko,2013-10-30 18:31:43+02:00,['5f24598b50ca44c76e1890758a3ea9c79bdc3204'],3,26,29,16851343,2,0.944444444,1,1,11923
2b6dd0427ae1795e0109dd1a7943261d8dfb6aca,1,Oleg Nechiporenko,2013-10-30 19:13:48+02:00,['bae037a86f1c43a8af8e03b46a31a158300dcdac'],8,173,181,16851524,13,1,1,1,11924
c78fe49d97df99b6e4f2d271c1494efca8c1afa7,1,aBabiichuk,2013-10-30 19:31:34+02:00,['2b6dd0427ae1795e0109dd1a7943261d8dfb6aca'],12,21,33,16851557,2,,,,11924
94c579badbfbc916c83b75f28695825e5bfdb44c,1,Lisnichenko Dmitro,2013-10-30 20:35:42+02:00,['c78fe49d97df99b6e4f2d271c1494efca8c1afa7'],6,159,165,16851722,2,0.008547009,1,0,11924
700f82561375da08a9e6ca7e71d734e08e62c19e,1,Lisnichenko Dmitro,2013-10-30 20:56:15+02:00,['94c579badbfbc916c83b75f28695825e5bfdb44c'],0,5,5,16851727,1,,,,11924
3fef9f457c87815a51c7393959442f23338ed74b,1,Dmitry Sen,2013-10-30 21:02:28+02:00,['700f82561375da08a9e6ca7e71d734e08e62c19e'],2,2,4,16851731,2,,,,11924
49811347712d9e4b9ba915e184399ad95f55da0c,0,Xi Wang,2013-10-30 15:31:37-07:00,['3fef9f457c87815a51c7393959442f23338ed74b'],3,15,18,16851749,3,1,1,1,11924
4fc8133b9d19d9e9aad672363c629f9b05caeee0,1,Xi Wang,2013-10-30 16:13:32-07:00,['49811347712d9e4b9ba915e184399ad95f55da0c'],9,59,68,16851817,4,1,1,1,11924
e10272390444e56b0e4cacfda0bc36f6985e300d,0,Xi Wang,2013-10-30 16:33:42-07:00,['4fc8133b9d19d9e9aad672363c629f9b05caeee0'],11,10,21,16851838,4,,,,11924
0dba52dfc703f44b440945edfd9d2d62f2303735,0,Xi Wang,2013-10-30 16:39:53-07:00,['e10272390444e56b0e4cacfda0bc36f6985e300d'],8,88,96,16851934,5,0.9375,1,1,11924
68f77e6536cb1293b58aefc32300395305795792,0,Xi Wang,2013-10-30 16:56:05-07:00,['0dba52dfc703f44b440945edfd9d2d62f2303735'],16,87,103,16852037,12,0.470588235,1,1,11924
70aa9b085912c30ab59550e3101745038ef075b4,0,Srimanth Gunturi,2013-10-30 18:13:02-07:00,['68f77e6536cb1293b58aefc32300395305795792'],87,16,103,16852140,12,0.529411765,0,0,11924
621079d13d0768518fbd9af349746de93dec87b9,0,Srimanth Gunturi,2013-10-30 18:13:40-07:00,['70aa9b085912c30ab59550e3101745038ef075b4'],88,8,96,16852236,5,0.0625,0,0,11924
ad0d9f0eae1784a927f105587e551b4d76f6c2fb,1,Srimanth Gunturi,2013-10-30 18:14:06-07:00,['621079d13d0768518fbd9af349746de93dec87b9'],10,11,21,16852257,4,,,,11924
a8309ce096107c0ccf6b08825baa2ab7b5686554,1,Jaimin Jetly,2013-10-30 23:18:28-07:00,['ad0d9f0eae1784a927f105587e551b4d76f6c2fb'],7,32,39,16852296,5,0,0,1,11924
8e836f1b82522a5c084c6307cc862f969497026a,1,Aleksandr Kovalenko,2013-10-31 17:48:18+02:00,['a8309ce096107c0ccf6b08825baa2ab7b5686554'],14,4,18,16852314,2,0,0,0,11924
062069479c4a2c6bab447fb4abead4800a66571b,1,Oleksandr Diachenko,2013-10-31 17:52:52+02:00,['8e836f1b82522a5c084c6307cc862f969497026a'],3,3,6,16852320,1,,,,11924
e524a02977733404974cd8c354dd533f9162a26a,1,Aleksandr Kovalenko,2013-10-31 17:57:22+02:00,['062069479c4a2c6bab447fb4abead4800a66571b'],3,14,17,16852337,4,1,1,1,11924
d6277f61937dc37460b260b27cabb33c9d8380fa,0,Aleksandr Kovalenko,2013-10-31 17:57:23+02:00,['e524a02977733404974cd8c354dd533f9162a26a'],4,1,5,16852342,2,0,0,0,11924
58c60c5e13fd8553bca8ad6c9abc4d69cd73e916,0,Lisnichenko Dmitro,2013-10-31 18:04:00+02:00,['d6277f61937dc37460b260b27cabb33c9d8380fa'],2,2,4,16852346,1,,,,11924
0b9e3a87217e72af72c3c3c3f5a8a75ee0cf5a39,1,atkach,2013-10-31 18:10:17+02:00,['58c60c5e13fd8553bca8ad6c9abc4d69cd73e916'],68,82,150,16852496,5,1,1,0,11924
b6f0bc4e5542e3155012aea118dcac3f94c6ac4f,0,Xi Wang,2013-10-31 10:02:30-07:00,['0b9e3a87217e72af72c3c3c3f5a8a75ee0cf5a39'],16,211,227,16852723,14,0.769230769,1,1,11926
02013834577673afa8e81efe913241489b8bda4e,1,Xi Wang,2013-10-31 10:23:29-07:00,['b6f0bc4e5542e3155012aea118dcac3f94c6ac4f'],12,14,26,16852749,4,,,,11926
a1394c581ec7fedc7f862536b0099a69274cab66,1,Xi Wang,2013-10-31 10:36:47-07:00,['02013834577673afa8e81efe913241489b8bda4e'],9,114,123,16852872,6,0.9375,1,1,11927
2b29a425e76feffa3cecd20eb1b8b0888942ce1b,1,Dmitry Sen,2013-10-31 19:47:08+02:00,['a1394c581ec7fedc7f862536b0099a69274cab66'],2,2,4,16852876,1,,,,11927
18b14d784c78e33e299b30b40b95426bc4d06e7a,1,Dmitry Sen,2013-10-31 20:12:07+02:00,['2b29a425e76feffa3cecd20eb1b8b0888942ce1b'],16,190,206,16853082,7,,,,11931
aa2df114bf56f04bf00d1310845cf24c21907e62,0,Xi Wang,2013-10-31 14:48:52-07:00,['18b14d784c78e33e299b30b40b95426bc4d06e7a'],8,8,16,16853098,3,,0,,11931
2a0bf718efd1d5a7a8880374c079aa63a85d48bd,1,Srimanth Gunturi,2013-10-31 14:58:33-07:00,['aa2df114bf56f04bf00d1310845cf24c21907e62'],25,210,235,16853333,8,0.260869565,0.956521739,1,11932
ea86d6904b2f761aa761dd7aee9efa7ca96c5b31,1,Srimanth Gunturi,2013-10-31 15:02:47-07:00,['2a0bf718efd1d5a7a8880374c079aa63a85d48bd'],1,625,626,16853959,6,0.432735426,0.831838565,1,11935
0e6ca79085b19de2306409b23bfc019aa4dd4800,0,Srimanth Gunturi,2013-10-31 15:46:53-07:00,['ea86d6904b2f761aa761dd7aee9efa7ca96c5b31'],210,15,225,16854184,14,0.230769231,0,0,11935
93774ef86674d1688b65e8e35aea12eff3116764,1,Mahadev Konar,2013-10-31 16:28:45-07:00,['0e6ca79085b19de2306409b23bfc019aa4dd4800'],24,24,48,16854232,24,,,,11935
895fd88eca3564ac8417525c143d1c60442310c3,1,Xi Wang,2013-10-31 16:36:35-07:00,['93774ef86674d1688b65e8e35aea12eff3116764'],15,243,258,16854490,15,0.795454545,1,1,11938
c864766af610ea1807e0a46a66f836169ebc940d,0,Mahadev Konar,2013-10-31 18:10:40-07:00,['895fd88eca3564ac8417525c143d1c60442310c3'],1,0,1,16854491,1,,,,11938
87e914c1b3dce97f55791ede7ee7bc80a1823264,1,atkach,2013-11-01 14:20:55+02:00,['c864766af610ea1807e0a46a66f836169ebc940d'],6,127,133,16854624,8,0.977272727,1,1,11940
00ec1d302d04a2a959282a22abf59c8cf858336b,1,aBabiichuk,2013-11-01 15:24:10+02:00,['87e914c1b3dce97f55791ede7ee7bc80a1823264'],20,38,58,16854682,7,1,1,1,11940
b3f7fa6ec1aa44b2ef394da698fb13991a735cd4,1,Aleksandr Kovalenko,2013-11-01 15:51:21+02:00,['00ec1d302d04a2a959282a22abf59c8cf858336b'],4,5,9,16854691,2,1,1,1,11940
9b0af755db8ffe34f06c6fc48c74c3c274ae5789,1,Aleksandr Kovalenko,2013-11-01 16:13:52+02:00,['b3f7fa6ec1aa44b2ef394da698fb13991a735cd4'],2,28,30,16854721,6,1,1,1,11940
71d6fb1bf2caa6a38766fe3b757abcabeab74e8e,0,Lisnichenko Dmitro,2013-11-01 17:00:50+02:00,['9b0af755db8ffe34f06c6fc48c74c3c274ae5789'],2,2,4,16854725,2,,,,11940
85bdf2bed13ffeb9399e83c5c3f6cf625cd156de,1,Lisnichenko Dmitro,2013-11-01 17:05:05+02:00,['71d6fb1bf2caa6a38766fe3b757abcabeab74e8e'],6,27,33,16854758,1,1,1,1,11940
99ac88e1c60a54163df693160539e4d4e62f6d4e,1,Lisnichenko Dmitro,2013-11-01 17:06:41+02:00,['85bdf2bed13ffeb9399e83c5c3f6cf625cd156de'],14,42,56,16854814,3,0.625,0.625,0.8125,11940
a02af69f9b7c77ad7aa9c4fc689ed1ea7d38d02b,1,Lisnichenko Dmitro,2013-11-01 17:08:31+02:00,['99ac88e1c60a54163df693160539e4d4e62f6d4e'],5,17,22,16854836,3,0.4,0.2,1,11940
451222fea021938ff950956eefcd312b8fb39fa0,1,Lisnichenko Dmitro,2013-11-01 17:10:20+02:00,['a02af69f9b7c77ad7aa9c4fc689ed1ea7d38d02b'],5,13,18,16854854,2,0,0,1,11940
cefc54a63c55974cdd568f19387a3f0ff6b44075,1,Lisnichenko Dmitro,2013-11-01 17:12:47+02:00,['451222fea021938ff950956eefcd312b8fb39fa0'],31,156,187,16855041,3,0.705882353,0.705882353,0.75,11940
61d3ee9d6d884130b2f7bb27ce34e97f41274fb1,1,Lisnichenko Dmitro,2013-11-01 17:14:18+02:00,['cefc54a63c55974cdd568f19387a3f0ff6b44075'],24,26,50,16855091,2,0,0,1,11940
84274b4f83d0c8ff0fbfb978ab95a1a7d79b29c7,1,Lisnichenko Dmitro,2013-11-01 17:15:25+02:00,['61d3ee9d6d884130b2f7bb27ce34e97f41274fb1'],110,129,239,16855330,28,0,0,0,11946
267239e4018681c23689ec09b872a67057d23740,1,Lisnichenko Dmitro,2013-11-01 17:17:01+02:00,['84274b4f83d0c8ff0fbfb978ab95a1a7d79b29c7'],59,25,84,16855414,2,0,0,0.291666667,11946
87ef3f4adeaa5134cd3bfacb90587630b2b4600b,1,Lisnichenko Dmitro,2013-11-01 17:18:13+02:00,['267239e4018681c23689ec09b872a67057d23740'],15,17,32,16855446,1,1,1,0,11946
0e7b987bcdfda2bde0fcc5fc174d9a758cba3cc2,1,Lisnichenko Dmitro,2013-11-01 17:19:37+02:00,['87ef3f4adeaa5134cd3bfacb90587630b2b4600b'],71,22,93,16855539,3,1,0.6,0.1,11946
fa817f6446177a49c414480a51c58e76e37f1b33,1,Lisnichenko Dmitro,2013-11-01 17:21:43+02:00,['0e7b987bcdfda2bde0fcc5fc174d9a758cba3cc2'],0,49,49,16855588,4,0,1,1,11948
002060f84dc18cdb03c38924b3fe5287f07c8d96,1,Lisnichenko Dmitro,2013-11-01 17:23:57+02:00,['fa817f6446177a49c414480a51c58e76e37f1b33'],72,65,137,16855725,5,0.666666667,0.333333333,0,11948
732d113587391e7d9c62be8fd950ede177255e38,1,Lisnichenko Dmitro,2013-11-01 17:24:58+02:00,['002060f84dc18cdb03c38924b3fe5287f07c8d96'],3,35,38,16855763,5,1,1,1,11950
220294d552b38555c3497b85b8356198fab7f23a,1,Lisnichenko Dmitro,2013-11-01 17:26:09+02:00,['732d113587391e7d9c62be8fd950ede177255e38'],15,60,75,16855838,7,0,1,0.941176471,11952
12ac556f4476c1b9107d889ede78417060663660,1,Aleksandr Kovalenko,2013-11-01 20:15:13+02:00,['220294d552b38555c3497b85b8356198fab7f23a'],5,29,34,16855872,3,1,1,1,11952
aa8e98f467ec64c3227023b3c3dadd61ca98f355,1,Siddharth Wagle,2013-11-01 11:53:17-07:00,['12ac556f4476c1b9107d889ede78417060663660'],27,2944,2971,16858843,40,0.275193798,0.687338501,0.874677003,11965
506adf75119333ecbde5997b203927275d03cd32,0,Dmitry Sen,2013-11-01 21:12:48+02:00,['aa8e98f467ec64c3227023b3c3dadd61ca98f355'],681,13,694,16859537,38,0.210526316,0,0.263157895,11965
6b9ca4b41812576e39dcae3c2e71c66a1d80c978,1,Siddharth Wagle,2013-11-01 14:07:25-07:00,['506adf75119333ecbde5997b203927275d03cd32'],51,60,111,16859648,9,0,1,1,11965
c6c4e3483d943f1865a5110d91cad9e27f361ba0,1,Nate Cole,2013-11-01 17:13:46-04:00,['6b9ca4b41812576e39dcae3c2e71c66a1d80c978'],749,960,1709,16861357,16,0.619565217,0.236413043,0.002717391,11966
2b6b4a9b0ff184750489f30bf976b74b49deadca,1,Srimanth Gunturi,2013-11-01 14:48:16-07:00,['c6c4e3483d943f1865a5110d91cad9e27f361ba0'],12,16,28,16861385,7,0.2,0.2,1,11966
85b85ddac2bee9077d1ff841984bbd538629736f,0,Sumit Mohanty,2013-11-01 17:37:01-07:00,['2b6b4a9b0ff184750489f30bf976b74b49deadca'],1,1,2,16861387,1,,,,11966
95d63f0ed549469e85cdc4055b534e2179fe0621,0,Srimanth Gunturi,2013-11-01 17:57:06-07:00,['85b85ddac2bee9077d1ff841984bbd538629736f'],6,14,20,16861407,2,1,1,1,11966
c13df4d7dc3d65dfd580fccadb278913f47f843a,1,Jaimin Jetly,2013-11-04 01:21:04-08:00,['95d63f0ed549469e85cdc4055b534e2179fe0621'],92,114,206,16861613,5,1,1,1,11966
69010c8085e56335f593da669362fa39bc9d982b,1,tbeerbower,2013-11-04 05:01:19-05:00,['c13df4d7dc3d65dfd580fccadb278913f47f843a'],784,1401,2185,16863798,10,0.090487239,0.863109049,1,11966
fd9a889e7760e37b5bcb28d301e9a62c299ba0e1,0,Dmitry Sen,2013-11-04 13:24:48+02:00,['69010c8085e56335f593da669362fa39bc9d982b'],3,3,6,16863804,1,,,,11966
9e3d193f19d8968ee46259266c4d631dd87b700f,0,Aleksandr Kovalenko,2013-11-04 18:59:23+02:00,['fd9a889e7760e37b5bcb28d301e9a62c299ba0e1'],2,2,4,16863808,2,,,,11966
8b0e64c5121ee14acdafa624681c9f291a390bb1,1,Sumit Mohanty,2013-11-04 09:46:44-08:00,['9e3d193f19d8968ee46259266c4d631dd87b700f'],675,2724,3399,16867207,42,0.419774501,0.716392021,0.863833478,11978
d2bba601b937f8aede3a08deb4da03c368ea655d,1,Lisnichenko Dmitro,2013-11-04 21:12:10+02:00,['8b0e64c5121ee14acdafa624681c9f291a390bb1'],167,168,335,16867542,4,1,1,1,11978
c288fa43445a797bb7f753208f9d33961c8039fd,1,Aleksandr Kovalenko,2013-11-04 21:46:31+02:00,['d2bba601b937f8aede3a08deb4da03c368ea655d'],5,5,10,16867552,1,,,,11978
23a5105a3b79dc99a7b3adf4232f05aa2e403339,0,Yusaku Sako,2013-11-04 12:12:51-08:00,['c288fa43445a797bb7f753208f9d33961c8039fd'],9,30,39,16867591,4,,,,11978
8a995902a8ebeabc715797be74a76b20b042ba5a,1,Lisnichenko Dmitro,2013-11-04 22:35:29+02:00,['23a5105a3b79dc99a7b3adf4232f05aa2e403339'],16,7,23,16867614,4,0,1,0,11978
fefb83c33b279a70274c22fb515cec84db9f9060,1,Jaimin Jetly,2013-11-04 13:21:31-08:00,['8a995902a8ebeabc715797be74a76b20b042ba5a'],113,27,140,16867754,4,0.905660377,0.433962264,0,11978
0db94b814c50dcb4c7833c6f2b5d28d067315977,1,tbeerbower,2013-11-04 16:34:43-05:00,['fefb83c33b279a70274c22fb515cec84db9f9060'],40,143,183,16867937,2,0,0.930555556,1,11978
bf1789f25f7d168e6bd5d64dbda8c4c8383c5f8c,0,Srimanth Gunturi,2013-11-04 16:26:15-08:00,['0db94b814c50dcb4c7833c6f2b5d28d067315977'],3,3,6,16867943,1,1,1,,11978
7b5e3914a3004fc0c85438baf5599bafb8a6ff66,0,Xi Wang,2013-11-04 16:51:57-08:00,['bf1789f25f7d168e6bd5d64dbda8c4c8383c5f8c'],0,1,1,16867944,1,1,1,1,11978
3ce506e2f373735fbf16dbd79848992a5f04dd30,0,Jaimin Jetly,2013-11-04 18:22:30-08:00,['7b5e3914a3004fc0c85438baf5599bafb8a6ff66'],6,5,11,16867955,3,,,,11978
e10d85756dd55729c20aeda2baa0d6c93c4ca31d,0,Yusaku Sako,2013-11-04 18:50:28-08:00,['3ce506e2f373735fbf16dbd79848992a5f04dd30'],1,1,2,16867957,1,,,,11978
6112685ba00ab7e038d2f3533459a84d0fde8cdb,1,aBabiichuk,2013-11-05 13:40:40+02:00,['e10d85756dd55729c20aeda2baa0d6c93c4ca31d'],2,4,6,16867963,2,,,,11978
ff720cd9340b49d3541b49a9c15afe21f4d13ec9,1,aBabiichuk,2013-11-05 14:24:18+02:00,['6112685ba00ab7e038d2f3533459a84d0fde8cdb'],1,1,2,16867965,1,,,,11978
747f5897ecea6d8b05427c5835d72b9201c98107,1,atkach,2013-11-05 15:15:47+02:00,['ff720cd9340b49d3541b49a9c15afe21f4d13ec9'],73,105,178,16868143,6,0,1,1,11978
5793ae2eb6bbeeb9679690b748faf7768063c3e7,0,Lisnichenko Dmitro,2013-11-05 16:03:37+02:00,['747f5897ecea6d8b05427c5835d72b9201c98107'],9,984,993,16869136,15,0.808139535,0.808139535,1,11989
3664d43ecb8b29b587519644db6e0ceabe83372b,0,atkach,2013-11-05 16:58:07+02:00,['5793ae2eb6bbeeb9679690b748faf7768063c3e7'],3,2,5,16869141,1,0,0,0,11989
d2c74336492f2d3acd7aacf0dfba32239f749f0a,0,Alex Antonenko,2013-11-05 17:11:38+02:00,['3664d43ecb8b29b587519644db6e0ceabe83372b'],1,1,2,16869143,1,,,,11989
ac89d969b9af167d5de101eb29dcd7fbd4d15d01,0,Alex Antonenko,2013-11-05 17:11:39+02:00,['d2c74336492f2d3acd7aacf0dfba32239f749f0a'],0,2,2,16869145,1,0,1,1,11989
9d55ab9375a1a9eb59909aab756fe3972eeedc5f,1,Lisnichenko Dmitro,2013-11-05 21:25:24+02:00,['ac89d969b9af167d5de101eb29dcd7fbd4d15d01'],2,11,13,16869158,2,0,0.5,0,11989
f2c9e1a9a4b2346e8e272566a4f52157081227ea,0,Lisnichenko Dmitro,2013-11-05 23:23:34+02:00,['9d55ab9375a1a9eb59909aab756fe3972eeedc5f'],2,7,9,16869167,2,,,,11989
49f10119a1d9d5133bf3393873380dc7e4d31a35,1,tbeerbower,2013-11-05 18:00:46-05:00,['f2c9e1a9a4b2346e8e272566a4f52157081227ea'],1,624,625,16869792,2,0.02676399,0.652068127,0.652068127,11989
0af2dcba321f1d2c48b2300b0d516eadd16159ac,1,Jaimin Jetly,2013-11-05 15:07:36-08:00,['49f10119a1d9d5133bf3393873380dc7e4d31a35'],6,49,55,16869847,9,0,0,1,11989
5b85301707ed2cbfde0e787605e12663774fe9d7,0,tbeerbower,2013-11-05 19:39:54-05:00,['0af2dcba321f1d2c48b2300b0d516eadd16159ac'],13,18,31,16869878,1,0,1,1,11989
b5d95605291df23c0cc514684c4e05ce0d7e4d79,1,Jaimin Jetly,2013-11-05 16:46:37-08:00,['5b85301707ed2cbfde0e787605e12663774fe9d7'],1,5,6,16869884,2,,,,11989
a4cba0e17a55911ba4acf8cdbe00c0ce9d89faf1,1,Srimanth Gunturi,2013-11-05 18:39:24-08:00,['b5d95605291df23c0cc514684c4e05ce0d7e4d79'],14,338,352,16870236,15,0.627906977,0.627906977,0.92248062,11992
9eb83fd998644b28c083c18ced3569c6c7eefc4b,1,atkach,2013-11-06 14:00:00+02:00,['a4cba0e17a55911ba4acf8cdbe00c0ce9d89faf1'],342,542,884,16871120,6,0.8,1,0,11993
a13cb6247b66e08b553e0ac323703860873ec8a4,1,Aleksandr Kovalenko,2013-11-06 15:40:14+02:00,['9eb83fd998644b28c083c18ced3569c6c7eefc4b'],48,51,99,16871219,2,,,,11993
08d5fcff9bf02c75424d7c02aeb802bbbba4ad26,1,Oleksandr Diachenko,2013-11-06 16:34:10+02:00,['a13cb6247b66e08b553e0ac323703860873ec8a4'],4,27,31,16871250,2,0,1,1,11993
f603882f81142fe84634c8272026623869134deb,0,Dmitry Sen,2013-11-06 18:09:38+02:00,['08d5fcff9bf02c75424d7c02aeb802bbbba4ad26'],1,24,25,16871275,1,0,0,1,11993
5f1637dd2532adae5214b999705c6ef83fa9ea1b,1,Lisnichenko Dmitro,2013-11-06 18:38:01+02:00,['f603882f81142fe84634c8272026623869134deb'],7,2,9,16871284,2,,,,11993
d6176141a9dd0d8ccbdcf4ebb6c678e545c5f21b,1,Dmitry Sen,2013-11-06 19:00:32+02:00,['5f1637dd2532adae5214b999705c6ef83fa9ea1b'],6,6,12,16871296,3,,,,11993
66dd2e84b30eed3fed2845f7d9525939464e809f,1,Srimanth Gunturi,2013-11-06 13:09:17-08:00,['d6176141a9dd0d8ccbdcf4ebb6c678e545c5f21b'],0,6,6,16871302,1,0.5,1,1,11993
9530083bb8795951aacfe7a3c55c3b683795a553,1,Srimanth Gunturi,2013-11-06 15:53:07-08:00,['66dd2e84b30eed3fed2845f7d9525939464e809f'],11,14,25,16871327,2,0.111111111,0.111111111,0,11993
abaca9f8f9de340e76c2794b1754fe2b68abab8f,1,Xi Wang,2013-11-06 16:57:11-08:00,['9530083bb8795951aacfe7a3c55c3b683795a553'],102,295,397,16871724,5,0.454545455,0.52892562,0.900826446,11993
da607636e9e349640a111a33dbaca572676a522b,0,Oleg Nechiporenko,2013-11-07 14:07:42+02:00,['abaca9f8f9de340e76c2794b1754fe2b68abab8f'],1,1,2,16871726,1,,,,11993
ff58adac85fb43aeec9bf7d291ecc6297ee83bc8,0,Aleksandr Kovalenko,2013-11-07 14:27:41+02:00,['da607636e9e349640a111a33dbaca572676a522b'],13,1,14,16871740,4,0,0,0,11993
cfdb9ce59f947dfdf5190b4b3977b47f55a537b6,1,Oleg Nechiporenko,2013-11-07 16:25:22+02:00,['ff58adac85fb43aeec9bf7d291ecc6297ee83bc8'],7,32,39,16871779,1,,,,11993
8944c1db3da6a1eda6f9d7211c8be6cb73cf00d1,0,Lisnichenko Dmitro,2013-11-07 16:43:46+02:00,['cfdb9ce59f947dfdf5190b4b3977b47f55a537b6'],2,6,8,16871787,2,,,,11993
5820bd7c63b2aec52d3fad2cc40cb69be03f6164,1,atkach,2013-11-07 18:01:25+02:00,['8944c1db3da6a1eda6f9d7211c8be6cb73cf00d1'],2308,360,2668,16874455,6,0.90625,1,0,11993
3b78da641f0d863d552afb7ff3c5224c3b2577e7,1,Myroslav Papirkovskyy,2013-11-07 19:07:57+02:00,['5820bd7c63b2aec52d3fad2cc40cb69be03f6164'],183,434,617,16875072,8,0.37254902,0.882352941,0.460784314,11993
698cf785461cd65b94c24c4d34addf134b64cc4c,1,Lisnichenko Dmitro,2013-11-07 20:05:22+02:00,['3b78da641f0d863d552afb7ff3c5224c3b2577e7'],15,47,62,16875134,2,0,0,0.481481481,11993
f3832a9a658806c9a36c32878f5866f05346acef,1,Alex Antonenko,2013-11-07 20:18:34+02:00,['698cf785461cd65b94c24c4d34addf134b64cc4c'],19,11,30,16875164,7,1,0.75,0,11993
8e081737a54784f32f401594cf1f67463fabba0d,1,Lisnichenko Dmitro,2013-11-07 22:46:59+02:00,['f3832a9a658806c9a36c32878f5866f05346acef'],47,15,62,16875226,2,1,1,0.518518519,11993
6292620075cbb27760a06c3b6e733f905da36dd4,1,Siddharth Wagle,2013-11-07 13:16:45-08:00,['8e081737a54784f32f401594cf1f67463fabba0d'],354,1202,1556,16876782,24,0.035971223,0.580935252,1,11995
d58846eab9269fc94528740ab72fa414c3bb976e,1,Lisnichenko Dmitro,2013-11-08 00:01:51+02:00,['6292620075cbb27760a06c3b6e733f905da36dd4'],434,183,617,16877399,8,0.62745098,0.117647059,0.539215686,11995
4f6bacdfd3fecb33f43d8a753b2473553f0f37cc,1,Srimanth Gunturi,2013-11-07 14:31:08-08:00,['d58846eab9269fc94528740ab72fa414c3bb976e'],1,1,2,16877401,1,,,,11995
be01dee8049ec36edcd486388f33cac8b6d1fb11,1,Jaimin Jetly,2013-11-07 14:50:08-08:00,['4f6bacdfd3fecb33f43d8a753b2473553f0f37cc'],972,917,1889,16879290,42,0.046511628,0.046511628,1,11995
4272cafafd47d7b188edcf5e611ac32508331619,0,Siddharth Wagle,2013-11-07 17:34:28-08:00,['be01dee8049ec36edcd486388f33cac8b6d1fb11'],23,74,97,16879387,6,,,,11995
91c9c5a96f465a864f9ae8fe6bd2086d63a0e150,0,Siddharth Wagle,2013-11-07 17:35:48-08:00,['4272cafafd47d7b188edcf5e611ac32508331619'],74,23,97,16879484,6,,,,11995
62a75007f4581e7fec86aa937af019372ee7ca5d,1,Siddharth Wagle,2013-11-07 17:38:08-08:00,['91c9c5a96f465a864f9ae8fe6bd2086d63a0e150'],23,74,97,16879581,6,,,,11995
dace05a7c59210422fb70c701380d19ca4a7eb1b,0,aBabiichuk,2013-11-08 15:16:01+02:00,['62a75007f4581e7fec86aa937af019372ee7ca5d'],1,5,6,16879587,2,1,1,1,11995
0e350e10bd0873cb1bded66be2c3f49210e510c5,0,Oleg Nechiporenko,2013-11-08 16:14:32+02:00,['dace05a7c59210422fb70c701380d19ca4a7eb1b'],441,164,605,16880192,10,0.877483444,0,0,11996
327e4cc91438fd7346d2c8c5d19ee05c564a0819,1,Lisnichenko Dmitro,2013-11-08 16:37:24+02:00,['0e350e10bd0873cb1bded66be2c3f49210e510c5'],18,50,68,16880260,2,0,0,0.481481481,11996
79691bccdcf02c737976ea6581fa532fcc1db19e,1,tbeerbower,2013-11-08 09:48:49-05:00,['327e4cc91438fd7346d2c8c5d19ee05c564a0819'],1,88,89,16880349,2,0,0.393442623,0.852459016,11996
e508fdb4e850db0e25b4304301ee6269affc3140,0,atkach,2013-11-08 17:36:04+02:00,['79691bccdcf02c737976ea6581fa532fcc1db19e'],1,1,2,16880351,1,,,,11996
dd0663dffd3fd8faa52dd59864ad9157f382070c,0,tbeerbower,2013-11-08 11:15:49-05:00,['e508fdb4e850db0e25b4304301ee6269affc3140'],2,2,4,16880355,1,,,,11996
611988983821f78d0db2fad8ce335da80170a971,0,tbeerbower,2013-11-08 11:37:38-05:00,['dd0663dffd3fd8faa52dd59864ad9157f382070c'],1496,778,2274,16882629,6,0.110294118,0,1,11996
8b3af9afe37eecc95c701ab7910e8fd2715927ea,0,Alex Antonenko,2013-11-08 19:49:29+02:00,['611988983821f78d0db2fad8ce335da80170a971'],0,1,1,16882630,1,0,0,1,11996
471403cd51feafa74088360b32f297766ea8d64f,1,Nate Cole,2013-11-08 17:15:04-05:00,['8b3af9afe37eecc95c701ab7910e8fd2715927ea'],3653,632,4285,16886915,63,0.598833819,0.40058309,0.155102041,11996
20702c6bf5dc99206980967b30335ab0061b1770,1,tbeerbower,2013-11-08 17:30:13-05:00,['471403cd51feafa74088360b32f297766ea8d64f'],183,435,618,16887533,8,0.378640777,0.883495146,0.466019417,11996
86fed01eb14df077cd36e641695196ee81275349,1,Siddharth Wagle,2013-11-08 14:39:15-08:00,['20702c6bf5dc99206980967b30335ab0061b1770'],40,188,228,16887761,23,0.316666667,0.733333333,1,11996
9d47f20a12a262d509d323350ab10535a472c8f8,1,Srimanth Gunturi,2013-11-08 14:59:09-08:00,['86fed01eb14df077cd36e641695196ee81275349'],164,441,605,16888366,10,0.122516556,1,1,11996
d23cdc160a2b2414ef7f6833cd29aa1cc56bfe45,0,Siddharth Wagle,2013-11-08 15:01:34-08:00,['9d47f20a12a262d509d323350ab10535a472c8f8'],8,9,17,16888383,3,,,,11996
8fd02c7c4b87b1b10fbf9d2c5024374f0e4cceba,1,Srimanth Gunturi,2013-11-08 17:48:47-08:00,['d23cdc160a2b2414ef7f6833cd29aa1cc56bfe45'],144,190,334,16888717,2,1,1,1,11997
7107d5e26ddd6fb178720ef95f4708589096cdc1,1,atkach,2013-11-11 14:14:57+02:00,['8fd02c7c4b87b1b10fbf9d2c5024374f0e4cceba'],82,76,158,16888875,12,0.909090909,1,1,11997
6e9cd1bd002c8b83309e45dddb7db3bc21354323,1,Oleg Nechiporenko,2013-11-11 15:34:52+02:00,['7107d5e26ddd6fb178720ef95f4708589096cdc1'],2,6,8,16888883,1,,,,11997
4626bf2d507779c5f27ba74c280cb35218cfd68b,0,Lisnichenko Dmitro,2013-11-11 16:10:08+02:00,['6e9cd1bd002c8b83309e45dddb7db3bc21354323'],5,26,31,16888914,4,,,,11997
c24508645083126ac8b59ed1d63c4959c38be3e5,1,Lisnichenko Dmitro,2013-11-11 16:49:25+02:00,['4626bf2d507779c5f27ba74c280cb35218cfd68b'],5,58,63,16888977,5,,,,11998
712134b245d6b3182c326da2cd6bec326fc6d134,0,aBabiichuk,2013-11-11 18:13:57+02:00,['c24508645083126ac8b59ed1d63c4959c38be3e5'],41,31,72,16889049,1,0,0,0,11998
fd38de5643b203f16931cc3afa6a5c9197228fb8,1,aBabiichuk,2013-11-11 19:18:55+02:00,['712134b245d6b3182c326da2cd6bec326fc6d134'],27,65,92,16889141,3,,,,11999
2ad9c330c670defd4968562a4167f8583ca354d4,1,Siddharth Wagle,2013-11-11 10:17:20-08:00,['fd38de5643b203f16931cc3afa6a5c9197228fb8'],2,2,4,16889145,2,,,,11999
61f6219be1d7709df5f8148ae0c089ca60f20cb7,1,Yusaku Sako,2013-11-11 10:54:36-08:00,['2ad9c330c670defd4968562a4167f8583ca354d4'],0,5,5,16889150,1,,,,11999
45ce766ac9e51f1b2a8f75cbd4ef2125479ffb28,1,aBabiichuk,2013-11-11 20:55:39+02:00,['61f6219be1d7709df5f8148ae0c089ca60f20cb7'],8,8,16,16889166,1,,,,11999
ccf874f4aaf16ae75dbcc7eca576aa4b41f187ac,0,aBabiichuk,2013-11-11 21:26:36+02:00,['45ce766ac9e51f1b2a8f75cbd4ef2125479ffb28'],16,0,16,16889182,4,0,0,0,11999
44a6d2f70269780c2074bfc6c5457711bdf0b9ad,1,Lisnichenko Dmitro,2013-11-11 22:52:23+02:00,['ccf874f4aaf16ae75dbcc7eca576aa4b41f187ac'],62,514,576,16889758,13,0.447852761,0.957055215,0.63190184,12005
3ab690f0434a40f763f1988ee2500ceabf300b1d,0,Srimanth Gunturi,2013-11-11 13:33:09-08:00,['44a6d2f70269780c2074bfc6c5457711bdf0b9ad'],4,11,15,16889773,1,,,,12005
b98d660ed3d3ab34f726589aca02fb92423bccff,1,Xi Wang,2013-11-11 13:57:24-08:00,['3ab690f0434a40f763f1988ee2500ceabf300b1d'],5,26,31,16889804,3,1,1,1,12005
695a3bcdafbf39ecaff520a18c21a48d40173868,1,Xi Wang,2013-11-11 13:57:24-08:00,['b98d660ed3d3ab34f726589aca02fb92423bccff'],25,103,128,16889932,4,0.552631579,1,0.921052632,12005
e308a772fcfec29219c9a552668b7bc80d5b2c50,1,Xi Wang,2013-11-11 13:57:24-08:00,['695a3bcdafbf39ecaff520a18c21a48d40173868'],169,123,292,16890224,16,1,1,1,12005
dfde1a2135e5256f4c1839ba5cc30dab558ccbaf,1,Xi Wang,2013-11-11 13:57:24-08:00,['e308a772fcfec29219c9a552668b7bc80d5b2c50'],3,64,67,16890291,4,0,0.333333333,1,12005
52d1873a32f6c005e5061f991fd9052df48b6cb7,0,Xi Wang,2013-11-11 13:57:24-08:00,['dfde1a2135e5256f4c1839ba5cc30dab558ccbaf'],7,9,16,16890307,2,,,,12005
5fe89e76bac17cf6d53fa51d2ea106cfa9fbb54b,0,Xi Wang,2013-11-11 15:41:38-08:00,['52d1873a32f6c005e5061f991fd9052df48b6cb7'],41,64,105,16890412,5,1,1,0,12005
38f6f48d007fc8982ac457294cc03872b9af4837,1,Srimanth Gunturi,2013-11-11 15:45:23-08:00,['5fe89e76bac17cf6d53fa51d2ea106cfa9fbb54b'],20,263,283,16890695,6,1,1,0.905263158,12006
4b84ed171da60533032099fc94f4aa013a82465d,1,Yusaku Sako,2013-11-11 15:53:39-08:00,['38f6f48d007fc8982ac457294cc03872b9af4837'],64,41,105,16890800,5,0,0,1,12006
1765b084246e2a2c3d65016c6f1663ddd9cb0228,0,Xi Wang,2013-11-11 16:27:39-08:00,['4b84ed171da60533032099fc94f4aa013a82465d'],1,1,2,16890802,1,,,,12006
5b4b545073901d414a48e0629ae3ab616e26a927,1,Xi Wang,2013-11-11 16:36:17-08:00,['1765b084246e2a2c3d65016c6f1663ddd9cb0228'],3,4,7,16890809,3,1,0,0,12006
2261a353ed92c1ad4d50dcdbdfa64093f620e4d8,1,Oleg Nechiporenko,2013-11-12 13:12:09+02:00,['5b4b545073901d414a48e0629ae3ab616e26a927'],1,1,2,16890811,1,,,,12006
45f1a86dec545f2ad6dff5bded1d3f34b6484ea9,1,atkach,2013-11-12 16:47:51+02:00,['2261a353ed92c1ad4d50dcdbdfa64093f620e4d8'],22,87,109,16890920,3,0.404255319,0.276595745,1,12006
8780e308f11af08acde72388d1d32924bc4e52f8,1,Oleg Nechiporenko,2013-11-12 16:56:01+02:00,['45f1a86dec545f2ad6dff5bded1d3f34b6484ea9'],455,195,650,16891570,11,0.922807018,0,0,12007
d74bf3d75df99099f094d52cf44390396d840097,1,Lisnichenko Dmitro,2013-11-12 17:30:53+02:00,['8780e308f11af08acde72388d1d32924bc4e52f8'],92,197,289,16891859,18,0,0.392857143,1,12011
8372bbff4dd2f2421e06d87953b7509bcca692e8,1,Lisnichenko Dmitro,2013-11-12 17:30:53+02:00,['d74bf3d75df99099f094d52cf44390396d840097'],141,694,835,16892694,19,0.403314917,1,0.961325967,12026
6f7d033d7ce6446d5e2c8c58128ca8b639fb7019,1,Aleksandr Kovalenko,2013-11-12 20:34:18+02:00,['8372bbff4dd2f2421e06d87953b7509bcca692e8'],125,231,356,16893050,10,1,1,0,12027
a9f5a470a846e598f60d3150c3f539d227df8503,1,Alex Antonenko,2013-11-12 22:01:07+02:00,['6f7d033d7ce6446d5e2c8c58128ca8b639fb7019'],16,185,201,16893251,9,1,1,1,12027
7bfddc9f7226adce9a6d02673a6bc4a58c961c85,0,Srimanth Gunturi,2013-11-12 16:48:58-08:00,['a9f5a470a846e598f60d3150c3f539d227df8503'],10,9,19,16893270,1,0,0,0,12027
f77726510400c11a06f14d6479b70f5aa078b223,0,Srimanth Gunturi,2013-11-12 16:48:58-08:00,['7bfddc9f7226adce9a6d02673a6bc4a58c961c85'],4,4,8,16893278,1,,,,12027
6e93225b5e7a030ab67f6f2654d9fe1a2b8dc1db,0,Srimanth Gunturi,2013-11-12 17:37:02-08:00,['f77726510400c11a06f14d6479b70f5aa078b223'],2,6,8,16893286,1,,,,12027
5d9960243b2d46d6a9562a0120fa84f533af2337,0,atkach,2013-11-13 13:00:27+02:00,['6e93225b5e7a030ab67f6f2654d9fe1a2b8dc1db'],1,1,2,16893288,1,,,,12027
d639a7f061dcbe2ea287b9d32bf8602ad34223f8,1,atkach,2013-11-13 15:43:54+02:00,['5d9960243b2d46d6a9562a0120fa84f533af2337'],62,48,110,16893398,1,0.2,0.2,0,12027
a0d57eb11e9121e1a55635d6042a8aff957a6f23,1,Oleg Nechiporenko,2013-11-13 17:51:22+02:00,['d639a7f061dcbe2ea287b9d32bf8602ad34223f8'],8,32,40,16893438,4,0,0,0,12028
4d910297abc1c726e15315492c3d8d15bfe949a1,1,aBabiichuk,2013-11-13 20:15:43+02:00,['a0d57eb11e9121e1a55635d6042a8aff957a6f23'],6,13,19,16893457,1,1,1,1,12028
eef606b1ea38e58ef4287b2253bc150259fce73d,1,Alex Antonenko,2013-11-13 20:50:24+02:00,['4d910297abc1c726e15315492c3d8d15bfe949a1'],17,20,37,16893494,1,0,1,1,12028
708e59d9b3f26f3d31d2bd4a9b5f2c2bfcd17af3,1,Oleksandr Diachenko,2013-11-13 22:57:42+02:00,['eef606b1ea38e58ef4287b2253bc150259fce73d'],65,147,212,16893706,20,0.722222222,0.833333333,0.722222222,12028
22f5fdfb70916fb5ffe486c6bcb50f36bc0de1b4,1,Sumit Mohanty,2013-11-13 22:30:26-08:00,['708e59d9b3f26f3d31d2bd4a9b5f2c2bfcd17af3'],466,1214,1680,16895386,26,0.296728972,0.780373832,0.404205607,12031
fc427d9f3e2d448a4e8746dd04199ad17390755c,1,tbeerbower,2013-11-14 05:21:19-05:00,['22f5fdfb70916fb5ffe486c6bcb50f36bc0de1b4'],1176,880,2056,16897442,12,0.869565217,0.391304348,0.136645963,12031
ae1517672bd7b69005e0e6728dafbd77a0503854,1,tbeerbower,2013-11-14 05:21:19-05:00,['fc427d9f3e2d448a4e8746dd04199ad17390755c'],5,81,86,16897528,3,0.342857143,1,1,12032
a948d6b77b798567e40e0a939cfb65aa2cc0ea0a,0,atkach,2013-11-14 17:50:10+02:00,['ae1517672bd7b69005e0e6728dafbd77a0503854'],10,10,20,16897548,3,0,1,0,12032
ef55a79c264fdc14c99dca62fa83da9fc050a038,1,Aleksandr Kovalenko,2013-11-14 18:20:32+02:00,['a948d6b77b798567e40e0a939cfb65aa2cc0ea0a'],36,344,380,16897928,11,0.808,1,0.976,12035
f3dd3017e2caa4aba5406338c87cd50e2742018d,0,Aleksandr Kovalenko,2013-11-14 18:31:19+02:00,['ef55a79c264fdc14c99dca62fa83da9fc050a038'],1,3,4,16897932,1,,,,12035
55b61a9d0825f4cf456d12ef7316c43eec25ccf2,1,Oleg Nechiporenko,2013-11-14 19:05:03+02:00,['f3dd3017e2caa4aba5406338c87cd50e2742018d'],0,1,1,16897933,1,1,1,1,12035
e3de66656a3b3b755e86c0198c0462e6ed92d06a,0,atkach,2013-11-14 19:40:24+02:00,['55b61a9d0825f4cf456d12ef7316c43eec25ccf2'],0,3,3,16897936,1,0,1,1,12035
a4bd8e36738eee314a547be6960350bf45c4e04a,1,aBabiichuk,2013-11-14 20:34:11+02:00,['e3de66656a3b3b755e86c0198c0462e6ed92d06a'],2,17,19,16897955,4,0,1,1,12035
2dc3e3e91dcb3ceb44130f8eb6a97915038ff222,1,Myroslav Papirkovskyy,2013-11-14 20:42:24+02:00,['a4bd8e36738eee314a547be6960350bf45c4e04a'],2,15,17,16897972,2,0.428571429,0.428571429,1,12035
fb60f21dac3e98a7925cdac76fc4225118cec5cb,1,Jaimin Jetly,2013-11-14 18:31:07-08:00,['2dc3e3e91dcb3ceb44130f8eb6a97915038ff222'],1282,810,2092,16900064,33,1,0,1,12035
05be921e3eee9f229a7954a75210731eacfa6c34,1,Yusaku Sako,2013-11-14 19:52:57-08:00,['fb60f21dac3e98a7925cdac76fc4225118cec5cb'],810,1282,2092,16902156,33,0,1,0,12035
b8f96a2d620546839090e934b1f4b156fe2072c7,1,Aleksandr Kovalenko,2013-11-15 16:15:04+02:00,['05be921e3eee9f229a7954a75210731eacfa6c34'],73,96,169,16902325,6,0,1,1,12035
b5a3f48bcbe22eeae0f892fa7a820ff74def9886,1,Lisnichenko Dmitro,2013-11-15 17:45:07+02:00,['b8f96a2d620546839090e934b1f4b156fe2072c7'],1,2,3,16902328,1,1,1,1,12035
68eef9663c12d3065d327b107f399c7d30f22b3a,1,atkach,2013-11-15 17:58:51+02:00,['b5a3f48bcbe22eeae0f892fa7a820ff74def9886'],4,62,66,16902394,4,1,1,1,12035
3b433e7ed13d22144efcf19d0f7a3f64915f23ad,1,Aleksandr Kovalenko,2013-11-15 19:45:01+02:00,['68eef9663c12d3065d327b107f399c7d30f22b3a'],35,38,73,16902467,2,1,1,1,12035
16d4306a6a42c2f82fe4c0f3705d55e6e2d18e37,0,Oleg Nechiporenko,2013-11-15 19:58:58+02:00,['3b433e7ed13d22144efcf19d0f7a3f64915f23ad'],38,122,160,16902627,3,0.125,0.125,1,12035
6ccdcc836fb240fb99e0729dd1fdaa0b451dd8fb,0,Lisnichenko Dmitro,2013-11-15 20:44:53+02:00,['16d4306a6a42c2f82fe4c0f3705d55e6e2d18e37'],15,38,53,16902680,4,0,0,1,12035
d3e1eab5b05579abced82015d6767c6745ca33c3,0,Yusaku Sako,2013-11-15 11:12:14-08:00,['6ccdcc836fb240fb99e0729dd1fdaa0b451dd8fb'],27880,0,27880,16930560,249,,,,12035
b6b6aa86c87e5006a3250243a2b9fd16cc2cf719,1,Yusaku Sako,2013-11-15 11:15:35-08:00,['d3e1eab5b05579abced82015d6767c6745ca33c3'],122,38,160,16930720,3,0.875,0.875,0,12035
cd7e9f623e901cf4037d03b9a1728fcd8a199f7a,1,Lisnichenko Dmitro,2013-11-15 21:52:21+02:00,['b6b6aa86c87e5006a3250243a2b9fd16cc2cf719'],38,15,53,16930773,4,1,1,0,12035
8bd015a72c7d9f667166f16ae2757b46d0109171,0,Sumit Mohanty,2013-11-15 14:27:11-08:00,['cd7e9f623e901cf4037d03b9a1728fcd8a199f7a'],5,0,5,16930778,1,,,,12035
05cb1b7d6f1e796b196994609cbac0710c86b224,1,Siddharth Wagle,2013-11-15 15:08:10-08:00,['8bd015a72c7d9f667166f16ae2757b46d0109171'],2,28,30,16930808,2,0.111111111,1,1,12035
8ba18c255fdf3c614940bb952b35154bdbb23772,1,Jaimin Jetly,2013-11-15 15:22:14-08:00,['05cb1b7d6f1e796b196994609cbac0710c86b224'],20,15,35,16930843,5,0,0,1,12035
9649a4dc3cfff14c4aca9cc3705d84eced3fd505,0,Sumit Mohanty,2013-11-15 15:30:29-08:00,['8ba18c255fdf3c614940bb952b35154bdbb23772'],9,0,9,16930852,1,,,,12035
1b1678ee390d53955fa1a2297086e9d17507e076,1,tbeerbower,2013-11-15 22:58:13-05:00,['9649a4dc3cfff14c4aca9cc3705d84eced3fd505'],334,500,834,16931686,28,0,1,1,12035
165f93149b8a4197e66369139cedc7aba76792d2,1,Yusaku Sako,2013-11-16 12:53:38-08:00,['1b1678ee390d53955fa1a2297086e9d17507e076'],51,65,116,16931802,4,,,,12035
88e95a058d805f6c89ba128561bf9303760cff97,0,Yusaku Sako,2013-11-16 12:55:22-08:00,['165f93149b8a4197e66369139cedc7aba76792d2'],0,0,0,16931802,4,,,,12035
6e556012c3a112faf5981dfbfc32236122c6999b,1,Yusaku Sako,2013-11-16 12:56:23-08:00,['88e95a058d805f6c89ba128561bf9303760cff97'],58,18,76,16931878,11,,,,12035
02595a0fd9c2f15adb2dac4946639a96c5acdf95,0,Yusaku Sako,2013-11-16 18:36:25-08:00,['6e556012c3a112faf5981dfbfc32236122c6999b'],2,6,8,16931886,1,0,1,1,12035
a19d053d0a784e4fe9b1f211d2cf76787048b785,0,tbeerbower,2013-11-16 22:33:08-05:00,['02595a0fd9c2f15adb2dac4946639a96c5acdf95'],0,91,91,16931977,1,0,1,1,12036
fcd566217dc8fe79822fb14d3c68b279d3f869f2,1,Sumit Mohanty,2013-11-16 22:48:32-08:00,['a19d053d0a784e4fe9b1f211d2cf76787048b785'],0,4,4,16931981,2,,,,12036
b8f64b4cadec1216daed6066b605161305dde6c0,1,Alex Antonenko,2013-11-17 19:31:36+02:00,['fcd566217dc8fe79822fb14d3c68b279d3f869f2'],30,343,373,16932354,11,0.953846154,0.984615385,1,12039
d9043f014bb34bf81f0c1465162e059d7b80967f,1,Aleksandr Kovalenko,2013-11-18 14:37:24+02:00,['b8f64b4cadec1216daed6066b605161305dde6c0'],19,28,47,16932401,2,0,1,0,12039
f44fb1050c3b8699f47803560b1979a6f007f6a1,1,Alex Antonenko,2013-11-18 14:52:19+02:00,['d9043f014bb34bf81f0c1465162e059d7b80967f'],5,187,192,16932593,6,1,1,1,12040
015130d44166b1e8dbe02369eb69a38abbedd84e,0,Lisnichenko Dmitro,2013-11-18 17:00:33+02:00,['f44fb1050c3b8699f47803560b1979a6f007f6a1'],54,98,152,16932745,6,0.421052632,0.657894737,0.447368421,12040
d44b3124f15f0a1c3229e75f29c80085e5483170,1,Lisnichenko Dmitro,2013-11-18 18:03:47+02:00,['015130d44166b1e8dbe02369eb69a38abbedd84e'],59,54,113,16932858,20,1,0,0.5,12040
76236019879f6fba9115fcaf741de4d2dbdeb3f5,0,Yusaku Sako,2013-11-18 09:57:42-08:00,['d44b3124f15f0a1c3229e75f29c80085e5483170'],2,2,4,16932862,1,,,,12040
c46beb2bf362b417b3ce5d8d542ab0ecd0c5ceb3,1,Yusaku Sako,2013-11-18 09:58:40-08:00,['76236019879f6fba9115fcaf741de4d2dbdeb3f5'],3,3,6,16932868,2,,,,12040
e9a1ba1ee616450053d5515c21fc67d4a705b0af,1,Srimanth Gunturi,2013-11-18 10:05:51-08:00,['c46beb2bf362b417b3ce5d8d542ab0ecd0c5ceb3'],17,205,222,16933090,7,0.819672131,0.819672131,0.901639344,12040
346a50c35cb4755f7205a681f9d1391cbf504711,1,Oleksandr Diachenko,2013-11-18 20:27:32+02:00,['e9a1ba1ee616450053d5515c21fc67d4a705b0af'],2,19,21,16933111,1,0,0,0.625,12040
d01e0e26a4229ac97f8b254b4e9a0c597b7ef956,1,atkach,2013-11-18 20:47:21+02:00,['346a50c35cb4755f7205a681f9d1391cbf504711'],19,79,98,16933209,4,1,1,1,12040
1d1e49ce9dd9ded4dc1040cab91d9331fe0e6848,1,Lisnichenko Dmitro,2013-11-18 22:06:47+02:00,['d01e0e26a4229ac97f8b254b4e9a0c597b7ef956'],26,1008,1034,16934243,42,0.382978723,1,1,12041
62975356ce6fa035b2e2549d9fced7084981517b,1,Mahadev Konar,2013-11-18 16:04:09-08:00,['1d1e49ce9dd9ded4dc1040cab91d9331fe0e6848'],0,4111,4111,16938354,38,,,,12079
41172fef7a4e1e99e7ea4cf101535a3861020e1a,0,Siddharth Wagle,2013-11-18 20:38:22-08:00,['62975356ce6fa035b2e2549d9fced7084981517b'],30,28,58,16938412,1,1,1,0,12079
3f6dc9bae7f85968c0d0cfc9c63ac5257a683c68,0,Mahadev Konar,2013-11-18 22:53:03-08:00,['41172fef7a4e1e99e7ea4cf101535a3861020e1a'],2,8,10,16938422,1,,,,12079
15f3b3786ad1aed61e7af240cb4566d9c47db875,1,aBabiichuk,2013-11-19 14:02:44+02:00,['3f6dc9bae7f85968c0d0cfc9c63ac5257a683c68'],8,8,16,16938438,4,,,,12079
2b5bffb036975eeb4d775916b00e22e6894ec7c8,0,aBabiichuk,2013-11-19 14:07:39+02:00,['15f3b3786ad1aed61e7af240cb4566d9c47db875'],1,1,2,16938440,1,,,,12079
17ab11391e0cf64124d8605afd0972001d8242d2,1,Oleg Nechiporenko,2013-11-19 14:38:39+02:00,['2b5bffb036975eeb4d775916b00e22e6894ec7c8'],39,137,176,16938616,3,0.144927536,0.144927536,1,12079
4ecaa001a7ba6b8eabc2389d53cadf7784e0d193,1,Oleg Nechiporenko,2013-11-19 14:39:11+02:00,['17ab11391e0cf64124d8605afd0972001d8242d2'],47,113,160,16938776,6,1,1,1,12079
b01ba5c51fd19e4101a9104eb5d8d177cdd8afa0,0,atkach,2013-11-19 14:49:54+02:00,['4ecaa001a7ba6b8eabc2389d53cadf7784e0d193'],12,5,17,16938793,1,1,0,0,12079
f6c4620ce9e027d73ac17bc6ede1559bcff7e134,0,atkach,2013-11-19 15:15:04+02:00,['b01ba5c51fd19e4101a9104eb5d8d177cdd8afa0'],1,1,2,16938795,1,,,,12079
e644a08e7d23f92f7b39c3d472d83ba6b4ddb7a0,1,Aleksandr Kovalenko,2013-11-19 16:47:37+02:00,['f6c4620ce9e027d73ac17bc6ede1559bcff7e134'],6,18,24,16938819,4,1,1,1,12079
c7503231e8b8caeafb71e579fab533117410fd72,0,Lisnichenko Dmitro,2013-11-19 17:15:45+02:00,['e644a08e7d23f92f7b39c3d472d83ba6b4ddb7a0'],1,3,4,16938823,1,,,,12079
7948bc4b42fc6b786849dd62b202cd886458af2a,1,Lisnichenko Dmitro,2013-11-19 17:34:14+02:00,['c7503231e8b8caeafb71e579fab533117410fd72'],21,76,97,16938920,4,0.058823529,0,0.911764706,12079
01f8e85bd23cf6b85cb05c79eac6c11861e3aebc,0,atkach,2013-11-19 18:45:28+02:00,['7948bc4b42fc6b786849dd62b202cd886458af2a'],3,3,6,16938926,1,,,,12079
aad5c5aa8abee0a561e15e8d44cab99916e451a4,0,Aleksandr Kovalenko,2013-11-19 18:54:03+02:00,['01f8e85bd23cf6b85cb05c79eac6c11861e3aebc'],2,13,15,16938941,2,1,1,1,12079
b2571e4082ffd36e2b3841963980160da69bed08,1,Alex Antonenko,2013-11-19 20:10:13+02:00,['aad5c5aa8abee0a561e15e8d44cab99916e451a4'],2,18,20,16938961,2,1,1,1,12079
e5c6e113052191a5f677ae9d04997ec0f797234a,1,Lisnichenko Dmitro,2013-11-19 20:16:06+02:00,['b2571e4082ffd36e2b3841963980160da69bed08'],17,352,369,16939330,47,0.228855721,0.985074627,0.104477612,12080
dab89e6950bf9b02072c8452fcb1e7297883aa63,1,Lisnichenko Dmitro,2013-11-19 21:53:40+02:00,['e5c6e113052191a5f677ae9d04997ec0f797234a'],0,138,138,16939468,1,0.538461538,1,0,12081
e311d66c6ed2f7b880d90e445ca67706779e0bd1,0,tbeerbower,2013-11-19 15:06:54-05:00,['dab89e6950bf9b02072c8452fcb1e7297883aa63'],134,144,278,16939746,3,0,0,0,12081
6b9bca7d97be4eaed24094cd8aedbee48bd1f4d4,1,Yusaku Sako,2013-11-19 13:22:14-08:00,['e311d66c6ed2f7b880d90e445ca67706779e0bd1'],13,17,30,16939776,5,,,,12081
89cb9704c4ce68551b2c0a3b38697335e310cb54,0,Yusaku Sako,2013-11-19 13:24:20-08:00,['6b9bca7d97be4eaed24094cd8aedbee48bd1f4d4'],0,1,1,16939777,1,,,,12081
6050e5ea14922fb6572ec2925a59ccb6db31bc64,1,Yusaku Sako,2013-11-19 13:41:19-08:00,['89cb9704c4ce68551b2c0a3b38697335e310cb54'],53,101,154,16939931,3,,,,12081
15d4ebdef0a54380a0eda1715c3557820a516be6,0,Srimanth Gunturi,2013-11-19 14:43:15-08:00,['6050e5ea14922fb6572ec2925a59ccb6db31bc64'],2,7,9,16939940,2,1,1,1,12081
a0af1dbfe97aea154cabcd1a41e32b210e650900,1,Yusaku Sako,2013-11-19 16:01:09-08:00,['15d4ebdef0a54380a0eda1715c3557820a516be6'],123,176,299,16940239,7,1,1,0.714285714,12081
029c91d4dfff667a23163d7c4925d3ca88b1499e,1,Yusaku Sako,2013-11-19 16:03:05-08:00,['a0af1dbfe97aea154cabcd1a41e32b210e650900'],18,18,36,16940275,5,1,1,1,12081
a1058b555c5ee7537f749a447f20a416795f80b5,1,Nate Cole,2013-11-19 20:11:47-05:00,['029c91d4dfff667a23163d7c4925d3ca88b1499e'],28,27074,27102,16967377,18,0.355742297,0.745098039,0.616246499,12090
04b138176d9223d9fbdc73a72fe621fa2d78d68f,1,Yusaku Sako,2013-11-19 18:20:01-08:00,['a1058b555c5ee7537f749a447f20a416795f80b5'],144,134,278,16967655,3,1,1,1,12090
dc4c08dbe6a632e303acad3f711847d6b90f3b1d,1,Aleksandr Kovalenko,2013-11-20 14:06:34+02:00,['04b138176d9223d9fbdc73a72fe621fa2d78d68f'],2,3,5,16967660,1,,,,12090
8c345c3147fe65999392139275160a0320e7faaa,0,Aleksandr Kovalenko,2013-11-20 14:35:01+02:00,['dc4c08dbe6a632e303acad3f711847d6b90f3b1d'],1,2,3,16967663,1,0,0,1,12090
e08e809bab20f3aa6dbcb9bbf55805bd8446e490,0,Oleg Nechiporenko,2013-11-20 16:14:38+02:00,['8c345c3147fe65999392139275160a0320e7faaa'],1,1,2,16967665,2,1,1,1,12090
1e02ae78614ae069611d6d0e0c1ba3197c182406,1,aBabiichuk,2013-11-20 17:00:37+02:00,['e08e809bab20f3aa6dbcb9bbf55805bd8446e490'],13,16,29,16967694,6,,,,12090
a5229c1c404bcfaff5aed9ac081c28b4e72af0c5,1,atkach,2013-11-20 17:40:36+02:00,['1e02ae78614ae069611d6d0e0c1ba3197c182406'],2,52,54,16967748,5,1,1,1,12090
94ec68b774e663680df99ee78fa4428bfd7e7972,1,Aleksandr Kovalenko,2013-11-20 18:07:43+02:00,['a5229c1c404bcfaff5aed9ac081c28b4e72af0c5'],2,1,3,16967751,1,1,1,0,12090
a1bbb6e5b98b3376c2875086df9d1446545dfdb6,0,Yusaku Sako,2013-11-20 08:40:03-08:00,['94ec68b774e663680df99ee78fa4428bfd7e7972'],2,3,5,16967756,1,,,,12090
89a3a2ee909a088dce0425b649ec3e9e0f53775d,1,aBabiichuk,2013-11-20 19:25:46+02:00,['a1bbb6e5b98b3376c2875086df9d1446545dfdb6'],9,31,40,16967796,5,0,0,1,12090
a61a83623c557be466892f26c617cd83e96b0f23,1,aBabiichuk,2013-11-20 19:30:21+02:00,['89a3a2ee909a088dce0425b649ec3e9e0f53775d'],4,12,16,16967812,3,,,,12090
dc52fefb8e2786b28052227838e1fe743a9f28bf,1,Yusaku Sako,2013-11-20 09:59:06-08:00,['a61a83623c557be466892f26c617cd83e96b0f23'],1,1,2,16967814,1,,,,12090
f5244e9f02924c2b506167d282f84a6c41562c08,0,Srimanth Gunturi,2013-11-20 10:58:11-08:00,['dc52fefb8e2786b28052227838e1fe743a9f28bf'],1,5,6,16967820,2,,,,12090
9422aea5c383689ac6b4062629083b14c5143d5d,1,Srimanth Gunturi,2013-11-20 11:05:48-08:00,['f5244e9f02924c2b506167d282f84a6c41562c08'],5,23,28,16967848,3,,,,12090
a1ae35eb556877e53051e02fe2e7f239bbdc2231,1,Srimanth Gunturi,2013-11-20 11:19:25-08:00,['9422aea5c383689ac6b4062629083b14c5143d5d'],8,19,27,16967875,3,1,1,1,12090
47b80c59fe761f2fa7a3e6886708dd4a44d3f485,1,Alex Antonenko,2013-11-20 21:20:49+02:00,['a1ae35eb556877e53051e02fe2e7f239bbdc2231'],0,21,21,16967896,1,1,1,1,12090
46e034e5e07a6607ed5c430b27045eea53810803,1,tbeerbower,2013-11-20 15:01:56-05:00,['47b80c59fe761f2fa7a3e6886708dd4a44d3f485'],148,338,486,16968382,5,0.43442623,0.344262295,0.680327869,12090
fcc0f0585575b77f3d4b5a3a4ab3e50c3d3f5858,0,Yusaku Sako,2013-11-20 17:49:06-08:00,['46e034e5e07a6607ed5c430b27045eea53810803'],14,0,14,16968396,1,1,1,0,12090
3009a1cc62adb16bae5a77a1954051b73f306bf9,1,Nate Cole,2013-11-20 22:39:50-05:00,['fcc0f0585575b77f3d4b5a3a4ab3e50c3d3f5858'],31,43,74,16968470,2,0,0,1,12090
13b0376d3bca78c9673f002310ccb5471e437275,1,atkach,2013-11-21 13:07:42+02:00,['3009a1cc62adb16bae5a77a1954051b73f306bf9'],16,38,54,16968524,1,0.8,0.8,0,12090
01f8dcb5e8795d6c3dc179d9f1a84dccc0026648,1,atkach,2013-11-21 14:16:33+02:00,['13b0376d3bca78c9673f002310ccb5471e437275'],19,26,45,16968569,3,1,1,1,12090
efe97301a7047d96ba547b55f90acd19cdb5e13d,1,atkach,2013-11-21 14:59:30+02:00,['01f8dcb5e8795d6c3dc179d9f1a84dccc0026648'],0,3,3,16968572,1,1,1,1,12090
6a709e238699f6e397d5f761f5bab4f4f28d489d,1,Alex Antonenko,2013-11-21 15:55:31+02:00,['efe97301a7047d96ba547b55f90acd19cdb5e13d'],8,48,56,16968628,4,1,1,1,12090
852b51c4b14a789f7502b0ccfcdb223af6df4cc0,1,aBabiichuk,2013-11-21 16:12:36+02:00,['6a709e238699f6e397d5f761f5bab4f4f28d489d'],65,44,109,16968737,5,0,0,0,12090
3b784aba365d4e952a26b0d231d66a78ab75058a,1,Oleg Nechiporenko,2013-11-21 17:15:22+02:00,['852b51c4b14a789f7502b0ccfcdb223af6df4cc0'],24,68,92,16968829,5,1,1,1,12091
b77bf1c7dc5031950c17e408fa8531c98de6c8d7,1,Alex Antonenko,2013-11-21 18:30:43+02:00,['3b784aba365d4e952a26b0d231d66a78ab75058a'],25,30,55,16968884,5,0,1,1,12091
a108b86f0cf95258e2f9186d7972c49a4e01484f,1,Aleksandr Kovalenko,2013-11-21 19:53:21+02:00,['b77bf1c7dc5031950c17e408fa8531c98de6c8d7'],69,54,123,16969007,5,0.181818182,1,0,12091
0b66c706e27de00c7a45010f5747d4ff391b5730,1,Yusaku Sako,2013-11-21 10:56:53-08:00,['a108b86f0cf95258e2f9186d7972c49a4e01484f'],3,9,12,16969019,1,0.428571429,0.428571429,1,12091
c778c731212eb575d3563bf04a02630c576cad96,1,Srimanth Gunturi,2013-11-21 11:11:30-08:00,['0b66c706e27de00c7a45010f5747d4ff391b5730'],1,6,7,16969026,2,,,,12091
071c9d47111d76080250735ec6fcd81f25ffc229,1,Siddharth Wagle,2013-11-21 12:50:20-08:00,['c778c731212eb575d3563bf04a02630c576cad96'],0,4,4,16969030,1,0,1,0,12091
94dae66098440386c093840bae97692e76771260,0,Siddharth Wagle,2013-11-21 12:58:26-08:00,['071c9d47111d76080250735ec6fcd81f25ffc229'],3,27,30,16969060,3,,,,12091
ceaa02b23a7ae7890a9aa5f4db5ed735a4f029e7,1,Yusaku Sako,2013-11-21 16:28:09-08:00,['94dae66098440386c093840bae97692e76771260'],4,4,8,16969068,1,,,,12091
85206b97a63491b1d4dd229d433a48a5f7561672,1,Yusaku Sako,2013-11-21 16:46:24-08:00,['ceaa02b23a7ae7890a9aa5f4db5ed735a4f029e7'],4,16,20,16969088,2,1,1,1,12091
1bce5da14f90278c9d46c208525610187aa5e330,0,Yusaku Sako,2013-11-21 23:39:31-08:00,['85206b97a63491b1d4dd229d433a48a5f7561672'],27,3,30,16969118,3,,,,12091
70fe2e3f03fdc795d1f7586873496c005d0d2803,0,Aleksandr Kovalenko,2013-11-22 12:42:46+02:00,['1bce5da14f90278c9d46c208525610187aa5e330'],1,2,3,16969121,1,0,0,1,12091
7a6e05ec4925e238e41ede5d1cb71a41adc32ac7,1,Aleksandr Kovalenko,2013-11-22 15:19:31+02:00,['70fe2e3f03fdc795d1f7586873496c005d0d2803'],7,6,13,16969134,3,0,1,1,12091
a4dee94c54209f5714e2a0a1beee6af99317a394,1,Myroslav Papirkovskyy,2013-11-22 15:38:53+02:00,['7a6e05ec4925e238e41ede5d1cb71a41adc32ac7'],1,1,2,16969136,1,,,,12091
4fe3a7172f26b3677920aed8b6eb940f1b19d404,1,Oleg Nechiporenko,2013-11-22 16:15:05+02:00,['a4dee94c54209f5714e2a0a1beee6af99317a394'],1,6,7,16969143,2,,,,12091
c3321560768d5c3417e16096bd4ccf44c7638fd8,1,Oleg Nechiporenko,2013-11-22 16:15:06+02:00,['4fe3a7172f26b3677920aed8b6eb940f1b19d404'],1,13,14,16969157,3,1,1,0,12091
ac38ac2b5cf72d444379fe3d06cf94434eea1137,1,aBabiichuk,2013-11-22 16:27:18+02:00,['c3321560768d5c3417e16096bd4ccf44c7638fd8'],1,13,14,16969171,1,1,1,1,12091
972506f26553d685b3c438affb216d71296dc58e,0,Alex Antonenko,2013-11-22 17:17:46+02:00,['ac38ac2b5cf72d444379fe3d06cf94434eea1137'],5,13,18,16969189,3,1,1,1,12091
c3ebde2d5188a9ce5a6a26fd062ca69866dfe7f5,1,aBabiichuk,2013-11-22 17:51:16+02:00,['972506f26553d685b3c438affb216d71296dc58e'],0,7,7,16969196,1,1,1,1,12091
80b617fd6477624b856245a2c24b7b168a531496,1,Oleksandr Diachenko,2013-11-22 17:56:17+02:00,['c3ebde2d5188a9ce5a6a26fd062ca69866dfe7f5'],35,120,155,16969351,10,0.255319149,0.787234043,0,12091
73a98ce8edd2f0d026a6ae48d2439d947d2f9a21,0,Alex Antonenko,2013-11-22 18:33:48+02:00,['80b617fd6477624b856245a2c24b7b168a531496'],1,3,4,16969355,1,,,,12091
181ea4f3dcf3c033218d5330d441b63e91ef24ee,1,Aleksandr Kovalenko,2013-11-22 19:03:39+02:00,['73a98ce8edd2f0d026a6ae48d2439d947d2f9a21'],58,81,139,16969494,7,1,1,1,12091
87bf327a7d6b767acc93833eca320f2bf36237d9,1,Lisnichenko Dmitro,2013-11-22 22:37:08+02:00,['181ea4f3dcf3c033218d5330d441b63e91ef24ee'],13,42,55,16969549,2,0,0.52173913,0.782608696,12091
37565defb6a417607d7b911a462928e6b771893b,1,Mahadev Konar,2013-11-22 14:55:43-08:00,['87bf327a7d6b767acc93833eca320f2bf36237d9'],34,271,305,16969854,5,,,,12091
f071cc6c0fe10581fd982f015cf868c6ab0a201e,1,Mahadev Konar,2013-11-22 15:02:29-08:00,['37565defb6a417607d7b911a462928e6b771893b'],0,16,16,16969870,2,,,,12091
9f03598041edf7af48a79d5bf9a1aab6a210db72,1,Jaimin Jetly,2013-11-22 15:19:07-08:00,['f071cc6c0fe10581fd982f015cf868c6ab0a201e'],34,16,50,16969920,1,0,0,0,12091
d727c0a159a01c9007013f47e142b4b54ea4cdb6,1,Yusaku Sako,2013-11-22 17:06:18-08:00,['9f03598041edf7af48a79d5bf9a1aab6a210db72'],9,10,19,16969939,1,1,1,1,12091
f595e78f2ac9b14c77f9b0a0213d5315711b6705,0,Srimanth Gunturi,2013-11-22 17:25:40-08:00,['d727c0a159a01c9007013f47e142b4b54ea4cdb6'],2,2,4,16969943,1,,,,12091
bf747346312170834c6beb89a60c8624b47aa288,1,Jaimin Jetly,2013-11-22 18:45:03-08:00,['f595e78f2ac9b14c77f9b0a0213d5315711b6705'],4,8,12,16969955,1,0,0,1,12091
093c8aff8898067a18d414353f818d2baf96f53e,0,Alex Antonenko,2013-11-25 15:30:53+02:00,['bf747346312170834c6beb89a60c8624b47aa288'],6,5,11,16969966,1,,,,12091
c4f264ac530d13696b721a519e14877dd9831600,0,Lisnichenko Dmitro,2013-11-25 17:22:21+02:00,['093c8aff8898067a18d414353f818d2baf96f53e'],25,4,29,16969995,2,0,0,1,12091
d1804acc846b32bee1739e6ae0e0da76714083f7,1,Aleksandr Kovalenko,2013-11-25 17:34:19+02:00,['c4f264ac530d13696b721a519e14877dd9831600'],7,23,30,16970025,3,0.1875,1,1,12091
938810b4fc792f34e7edbc6c8dff1c2276cae604,1,Alex Antonenko,2013-11-25 17:58:16+02:00,['d1804acc846b32bee1739e6ae0e0da76714083f7'],5,20,25,16970050,3,1,1,1,12091
2b2c62b1136544f5599efeb1572d39e9788dc345,1,Aleksandr Kovalenko,2013-11-25 18:23:30+02:00,['938810b4fc792f34e7edbc6c8dff1c2276cae604'],3,3,6,16970056,1,,,,12091
a018cc3bc93851f4e05447ae645370419578eca0,1,Alex Antonenko,2013-11-25 18:58:05+02:00,['2b2c62b1136544f5599efeb1572d39e9788dc345'],23,41,64,16970120,5,,,,12091
b8cc8ea55dfab5d78aaf45c2493fbafd7cbc59ed,0,Lisnichenko Dmitro,2013-11-25 19:19:05+02:00,['a018cc3bc93851f4e05447ae645370419578eca0'],11,44,55,16970175,8,0.72,0.92,1,12091
1daa58e251896e98a6a9e6e9a78ba9396b920b88,1,Lisnichenko Dmitro,2013-11-25 19:27:21+02:00,['b8cc8ea55dfab5d78aaf45c2493fbafd7cbc59ed'],0,202,202,16970377,1,1,1,0,12092
f80da0256d0d3851f222fb50b5dc92ddad5ac356,1,Lisnichenko Dmitro,2013-11-25 19:37:46+02:00,['1daa58e251896e98a6a9e6e9a78ba9396b920b88'],1,344,345,16970722,2,0.882022472,1,0.140449438,12093
5cac5f3083a9b36fb25398ae43cb09a65b6026ea,0,Lisnichenko Dmitro,2013-11-25 19:44:04+02:00,['f80da0256d0d3851f222fb50b5dc92ddad5ac356'],0,20,20,16970742,2,,,,12093
41013792f5dd7471e5b8568090ccdf280cd5d654,1,aBabiichuk,2013-11-25 20:49:03+02:00,['5cac5f3083a9b36fb25398ae43cb09a65b6026ea'],15,55,70,16970812,2,1,1,0.333333333,12093
cbca25d63c887cd8c86c3abb9ec04c046df9bc78,0,Srimanth Gunturi,2013-11-25 10:52:54-08:00,['41013792f5dd7471e5b8568090ccdf280cd5d654'],0,12,12,16970824,2,1,1,1,12093
47d7da54b9885413d4aa3d49b8b61c2978bfbf8a,1,Srimanth Gunturi,2013-11-25 11:02:03-08:00,['cbca25d63c887cd8c86c3abb9ec04c046df9bc78'],3,14,17,16970841,2,1,1,1,12093
b3669eebcd2ad646946dd693bcf3bd522284dffe,0,Srimanth Gunturi,2013-11-25 13:07:44-08:00,['47d7da54b9885413d4aa3d49b8b61c2978bfbf8a'],2,2,4,16970845,1,,,,12093
a14f8824fca067e7b2766f035d9ba61435b85e84,1,Yusaku Sako,2013-11-25 18:11:14-08:00,['b3669eebcd2ad646946dd693bcf3bd522284dffe'],2,4,6,16970851,1,1,1,1,12093
7dd72b5aaef600452a2fc42e5bffd2560bc4b6f5,1,Yusaku Sako,2013-11-25 18:15:27-08:00,['a14f8824fca067e7b2766f035d9ba61435b85e84'],14,15,29,16970880,8,0,0,1,12093
2599fa997d218c473cd99adcbaf60f2d1440e216,1,Yusaku Sako,2013-11-25 18:29:13-08:00,['7dd72b5aaef600452a2fc42e5bffd2560bc4b6f5'],1,2,3,16970883,1,,,,12093
731618c407525f21ef51407697fce9d168f62f06,0,Yusaku Sako,2013-11-25 18:46:51-08:00,['2599fa997d218c473cd99adcbaf60f2d1440e216'],7,13,20,16970903,1,1,1,1,12093
275096202f7cad9862b1ff0ddbc37878ccbfdaa7,1,atkach,2013-11-26 13:20:23+02:00,['731618c407525f21ef51407697fce9d168f62f06'],55,352,407,16971310,15,0.733668342,0.994974874,1,12093
e6e7ec1f9b740f4b6dbbd2b6db30122cb292f087,1,Oleg Nechiporenko,2013-11-26 13:53:42+02:00,['275096202f7cad9862b1ff0ddbc37878ccbfdaa7'],3,263,266,16971576,3,0.371859296,0.889447236,1,12093
1536c7a58282438df8326ae101e2fe643c758d52,1,atkach,2013-11-26 15:30:09+02:00,['e6e7ec1f9b740f4b6dbbd2b6db30122cb292f087'],1,21,22,16971598,2,1,1,1,12093
f0682821b57aa3e2546a469968bcdd2b70a0d019,1,tbeerbower,2013-11-26 09:07:42-05:00,['1536c7a58282438df8326ae101e2fe643c758d52'],2,11,13,16971611,3,0,0,0,12093
d4a0a57a85f8e61c0945e5d047c9642586c9fcd6,1,Aleksandr Kovalenko,2013-11-26 17:24:38+02:00,['f0682821b57aa3e2546a469968bcdd2b70a0d019'],25,55,80,16971691,7,0.863636364,1,1,12093
0c51fe15e9acc269b86e0cff46790c73eb446e94,1,Oleg Nechiporenko,2013-11-26 17:34:19+02:00,['d4a0a57a85f8e61c0945e5d047c9642586c9fcd6'],29,335,364,16972055,8,0.584699454,1,1,12094
029c1df7d12bc573df802ce13ef9991bbc4f1497,1,atkach,2013-11-26 19:52:56+02:00,['0c51fe15e9acc269b86e0cff46790c73eb446e94'],2,45,47,16972102,4,0.918918919,1,1,12094
c941e6d52f9000d52f91b1598c52ce346cbdec8f,0,Alex Antonenko,2013-11-26 19:56:15+02:00,['029c1df7d12bc573df802ce13ef9991bbc4f1497'],0,1,1,16972103,1,,,,12094
158a737f5e8f43ffd6a459aaf66f8b15f80f0a63,1,aBabiichuk,2013-11-26 20:11:31+02:00,['c941e6d52f9000d52f91b1598c52ce346cbdec8f'],2,2,4,16972107,2,,,,12094
1ed9d97e7f8b98c65bbef1f7be98cc599e2c2c11,1,Yusaku Sako,2013-11-26 10:20:24-08:00,['158a737f5e8f43ffd6a459aaf66f8b15f80f0a63'],7,7,14,16972121,2,,,,12094
8d1da2d230bc58955bc8ff39e6bdbcc9b48b08ea,0,Yusaku Sako,2013-11-26 12:23:19-08:00,['1ed9d97e7f8b98c65bbef1f7be98cc599e2c2c11'],1,2,3,16972124,1,,,,12094
cc49fb9e651cb647e20c7187d66b674d81d2c185,1,Lisnichenko Dmitro,2013-11-26 22:55:53+02:00,['8d1da2d230bc58955bc8ff39e6bdbcc9b48b08ea'],709,17219,17928,16990052,89,0.217105263,0.746710526,0.730263158,12153
c662873590e3285c5f12db351e3de9a74c735abc,1,Srimanth Gunturi,2013-11-26 16:28:14-08:00,['cc49fb9e651cb647e20c7187d66b674d81d2c185'],1,1,2,16990054,1,,,,12153
eb5c0b619146f461dbfd5b644f3635eec914224a,1,Siddharth Wagle,2013-11-26 17:30:51-08:00,['c662873590e3285c5f12db351e3de9a74c735abc'],11,18,29,16990083,3,0,0,1,12153
fb92dd560fe3e3b3134614e9d849e9b6e7a0ba5d,1,Srimanth Gunturi,2013-11-26 17:47:16-08:00,['eb5c0b619146f461dbfd5b644f3635eec914224a'],16,48,64,16990147,10,,,,12153
76ac00dbbea71fb67a589fb0cd6c0c1704c4711e,1,Yusaku Sako,2013-11-26 18:49:28-08:00,['fb92dd560fe3e3b3134614e9d849e9b6e7a0ba5d'],4,4,8,16990155,2,,,,12153
ef233e44f21297efdb063d9c347f254a41375665,0,Jaimin Jetly,2013-11-26 18:55:46-08:00,['76ac00dbbea71fb67a589fb0cd6c0c1704c4711e'],13,0,13,16990168,1,,,,12153
1ae9d699c6e904a66037f4294ba566acfa16e588,0,Yusaku Sako,2013-11-26 19:04:00-08:00,['ef233e44f21297efdb063d9c347f254a41375665'],18,14,32,16990200,4,,,,12153
dd535bcf81398132f973faf3a58e71c9aa66e51b,1,tbeerbower,2013-11-27 06:02:36-05:00,['1ae9d699c6e904a66037f4294ba566acfa16e588'],159,325,484,16990684,16,0.22,0.83,1,12153
1b20485fed5dd4803435aa6671da2417ff6568d1,1,Lisnichenko Dmitro,2013-11-27 15:06:58+02:00,['dd535bcf81398132f973faf3a58e71c9aa66e51b'],13,25,38,16990722,1,0,0,1,12153
9302ddb57aaf29c8a6e7fe1d7fd45795ba92306b,1,atkach,2013-11-27 15:19:00+02:00,['1b20485fed5dd4803435aa6671da2417ff6568d1'],8,39,47,16990769,3,0.583333333,1,1,12153
1672eac65c8ec6aa2cbac65b293e373cf7fecd43,1,atkach,2013-11-27 15:39:41+02:00,['9302ddb57aaf29c8a6e7fe1d7fd45795ba92306b'],2,4,6,16990775,2,1,1,1,12153
d8bcb50aba0e36decf27afb2504136d07329c3c9,1,Aleksandr Kovalenko,2013-11-27 16:14:22+02:00,['1672eac65c8ec6aa2cbac65b293e373cf7fecd43'],5,3,8,16990783,2,,,,12153
0eb9fb9ac6cdfeba59a625c1de34159c1851d62c,0,aBabiichuk,2013-11-27 17:17:54+02:00,['d8bcb50aba0e36decf27afb2504136d07329c3c9'],1,1,2,16990785,1,,,,12153
2f06f26c0621c859b04641bca9721e65c1005e47,1,Alex Antonenko,2013-11-27 17:49:13+02:00,['0eb9fb9ac6cdfeba59a625c1de34159c1851d62c'],0,12,12,16990797,1,1,1,1,12153
fe9d517e59d18dcf9d364645ed3b75949a93d1a0,1,aBabiichuk,2013-11-27 17:55:28+02:00,['2f06f26c0621c859b04641bca9721e65c1005e47'],4,12,16,16990813,4,1,1,1,12153
b368344c1f327ba8b1d6834bda514ad1850dae33,1,Aleksandr Kovalenko,2013-11-27 18:08:06+02:00,['fe9d517e59d18dcf9d364645ed3b75949a93d1a0'],18,30,48,16990861,4,1,1,1,12153
599cbe27a22c782917508540ec4667793c441a51,1,Alex Antonenko,2013-11-27 21:05:13+02:00,['b368344c1f327ba8b1d6834bda514ad1850dae33'],12,11,23,16990884,2,0,0,0,12153
4d21a67da77f628229f72ee868667fe301af375a,1,Alex Antonenko,2013-11-27 22:02:55+02:00,['599cbe27a22c782917508540ec4667793c441a51'],1,18,19,16990903,1,1,1,1,12153
3645146205f985f0b6964bb787730ba7f2229615,1,Srimanth Gunturi,2013-11-27 18:07:30-08:00,['4d21a67da77f628229f72ee868667fe301af375a'],5,12,17,16990920,2,1,1,1,12153
3d404d8ef9d227280ad4e3059c47274db85a7e44,1,atkach,2013-11-28 13:47:19+02:00,['3645146205f985f0b6964bb787730ba7f2229615'],1,1,2,16990922,1,,,,12153
33bf2302c7eeb76d251146fe2859c6315ae0d5e9,1,Aleksandr Kovalenko,2013-11-28 14:15:44+02:00,['3d404d8ef9d227280ad4e3059c47274db85a7e44'],8,62,70,16990992,5,0.441860465,0.674418605,0.674418605,12153
a6f6d20adbecf7d54a9023a6ac8cdec14221ae67,1,atkach,2013-11-28 15:24:42+02:00,['33bf2302c7eeb76d251146fe2859c6315ae0d5e9'],68,69,137,16991129,3,0,1,1,12153
89f4ef3d0ebb1064888cf7850874de03f6136992,0,Aleksandr Kovalenko,2013-11-28 16:31:53+02:00,['a6f6d20adbecf7d54a9023a6ac8cdec14221ae67'],11,11,22,16991151,1,,,,12153
e8594a9cb640c2f25a1d61fa22aab157a06eb0ac,1,Oleg Nechiporenko,2013-11-28 17:03:13+02:00,['89f4ef3d0ebb1064888cf7850874de03f6136992'],1,8,9,16991160,3,1,1,1,12153
0afd327c94eba72f790946951fa0003aa1e41cd8,1,Alex Antonenko,2013-11-28 17:34:28+02:00,['e8594a9cb640c2f25a1d61fa22aab157a06eb0ac'],10,22,32,16991192,4,,,,12153
9645845180412dcf22441e418d772b7e8f913634,1,Aleksandr Kovalenko,2013-11-28 17:35:01+02:00,['0afd327c94eba72f790946951fa0003aa1e41cd8'],37,58,95,16991287,3,1,1,1,12153
46df4981cce82b8ee72a92c9a5b4c932cbad8f3a,0,atkach,2013-11-28 17:51:06+02:00,['9645845180412dcf22441e418d772b7e8f913634'],4,7,11,16991298,1,0,0,1,12153
c0f0abd68b944645971c47f5ced10baf0e92cde0,1,aBabiichuk,2013-11-28 18:01:26+02:00,['46df4981cce82b8ee72a92c9a5b4c932cbad8f3a'],5,6,11,16991309,3,0,1,1,12153
4de1063853751bdd3c460014aba46512e373721f,1,Lisnichenko Dmitro,2013-11-28 18:16:38+02:00,['c0f0abd68b944645971c47f5ced10baf0e92cde0'],21,677,698,16992007,16,0.43315508,0.834224599,1,12165
b7d29d1cf5d3369f45c42545081e566be8355f99,1,Aleksandr Kovalenko,2013-11-28 18:48:58+02:00,['4de1063853751bdd3c460014aba46512e373721f'],4,5,9,16992016,2,1,1,1,12165
3b292002c91b248a28e613aba81107294052ef8d,1,Oleg Nechiporenko,2013-11-28 18:55:39+02:00,['b7d29d1cf5d3369f45c42545081e566be8355f99'],28,36,64,16992080,2,1,1,1,12165
fc0aad5d89b8dec04bec2ca015372b96e17f3ff7,1,atkach,2013-11-28 19:45:10+02:00,['3b292002c91b248a28e613aba81107294052ef8d'],21,30,51,16992131,14,1,1,1,12165
050506eb949d26711dab613287ff91cd97b48cf9,1,Lisnichenko Dmitro,2013-11-28 21:47:26+02:00,['fc0aad5d89b8dec04bec2ca015372b96e17f3ff7'],0,4649,4649,16996780,41,,,,12206
82bb2103dba710c18f326ee8a3e3d9d182e81740,1,Aleksandr Kovalenko,2013-11-28 21:50:44+02:00,['050506eb949d26711dab613287ff91cd97b48cf9'],53,30,83,16996863,4,0,0,0,12206
929647d93dd504ce3711d43447767e89b897fd91,1,Lisnichenko Dmitro,2013-11-28 22:29:46+02:00,['82bb2103dba710c18f326ee8a3e3d9d182e81740'],126,44,170,16997033,14,1,0.234693878,0.469387755,12206
60bbb1d53b1f605096aeab0e1842eb949e60f470,1,Alex Antonenko,2013-11-28 23:18:06+02:00,['929647d93dd504ce3711d43447767e89b897fd91'],14,25,39,16997072,2,1,1,1,12206
e86e013eab5f0dc98b78811ea810f5eee4d3bbaa,1,Alex Antonenko,2013-11-28 23:23:42+02:00,['60bbb1d53b1f605096aeab0e1842eb949e60f470'],0,7,7,16997079,1,1,1,1,12206
ee63a0ce2c5fadd6a9b0ece9a8de7e0f5894bb5d,0,Srimanth Gunturi,2013-11-28 21:08:07-08:00,['e86e013eab5f0dc98b78811ea810f5eee4d3bbaa'],2,2,4,16997083,1,,,,12206
35024a0e742f2927304221ce66ff2d6d1d31c4a1,1,Lisnichenko Dmitro,2013-11-29 13:40:13+02:00,['ee63a0ce2c5fadd6a9b0ece9a8de7e0f5894bb5d'],9,20,29,16997112,3,0,0,1,12206
bd53110038271255c6a0c4028c7b5c842e3487b7,0,Oleg Nechiporenko,2013-11-29 15:09:31+02:00,['35024a0e742f2927304221ce66ff2d6d1d31c4a1'],23,17,40,16997152,2,0,0,0,12206
b982dabf5232f658f4a3d46d26d6cce6f3525004,0,atkach,2013-11-29 15:38:20+02:00,['bd53110038271255c6a0c4028c7b5c842e3487b7'],0,1,1,16997153,1,0,0,1,12206
5cc2b12a545618beb96fcc7f1b88a941e0c840a4,0,Yusaku Sako,2013-11-29 06:55:42-08:00,['b982dabf5232f658f4a3d46d26d6cce6f3525004'],5,9,14,16997167,1,1,1,1,12206
e8a60eb465c1ae43ec4dc9686d734453457b6305,0,Alex Antonenko,2013-11-29 17:17:42+02:00,['5cc2b12a545618beb96fcc7f1b88a941e0c840a4'],3,8,11,16997178,1,0.857142857,1,1,12206
95ba3b45225b8b9528d7c57cb8f35b0adaa6039b,1,aBabiichuk,2013-11-29 17:42:01+02:00,['e8a60eb465c1ae43ec4dc9686d734453457b6305'],10,25,35,16997213,6,1,1,1,12206
d2ebacc09e91ebdbf9b2442864214b28af5ffff6,1,Lisnichenko Dmitro,2013-11-29 18:33:27+02:00,['95ba3b45225b8b9528d7c57cb8f35b0adaa6039b'],8,268,276,16997489,7,0.488888889,1,1,12212
e59e85a61f497656630401e1b2b935d2bb51bfed,0,Lisnichenko Dmitro,2013-11-29 19:06:17+02:00,['d2ebacc09e91ebdbf9b2442864214b28af5ffff6'],4,0,4,16997493,1,,,,12212
4059a69ed5ede2aab6fdb27b90df3496497852c0,1,Dmitry Sen,2013-11-29 19:09:46+02:00,['e59e85a61f497656630401e1b2b935d2bb51bfed'],6,128,134,16997627,14,0.392405063,0.607594937,0.873417722,12212
a9f8f3b69aec76c4b04b2fca4d9eb301c490ddb2,1,Yusaku Sako,2013-11-29 22:14:19-08:00,['4059a69ed5ede2aab6fdb27b90df3496497852c0'],22,27,49,16997676,8,0,0,0,12212
cb0b3d928a6c0045697034ef007987d37429babc,1,Yusaku Sako,2013-11-30 15:40:22-08:00,['a9f8f3b69aec76c4b04b2fca4d9eb301c490ddb2'],16,26,42,16997718,1,1,1,1,12212
aad6b98247a3cfe6433731cb3a4bf1080fc46986,1,Aleksandr Kovalenko,2013-12-01 20:53:26+02:00,['cb0b3d928a6c0045697034ef007987d37429babc'],0,1,1,16997719,1,1,1,1,12212
2559a004ec76eca6b39c07bbb6c0dd37597446c8,0,Aleksandr Kovalenko,2013-12-02 13:10:38+02:00,['aad6b98247a3cfe6433731cb3a4bf1080fc46986'],2,1,3,16997722,1,,,,12212
28b95f6fefe1b5952e8b74a0995f15f4e5d88081,1,aBabiichuk,2013-12-02 15:03:19+02:00,['2559a004ec76eca6b39c07bbb6c0dd37597446c8'],2,2,4,16997726,1,,,,12212
44f37423a669c8fe200ffb6b1020b31f78dded3b,0,Oleg Nechiporenko,2013-12-02 16:07:58+02:00,['28b95f6fefe1b5952e8b74a0995f15f4e5d88081'],2,2,4,16997730,2,0,0,0,12212
78b1a7190e6de9e5828615a5e0e97e6d4c105ee8,1,Dmitry Sen,2013-12-02 17:09:10+02:00,['44f37423a669c8fe200ffb6b1020b31f78dded3b'],3,3,6,16997736,1,,,,12212
2e6a9642e37ff131e923a41ec6dd56a2d28930be,1,Aleksandr Kovalenko,2013-12-02 17:59:10+02:00,['78b1a7190e6de9e5828615a5e0e97e6d4c105ee8'],0,1,1,16997737,1,1,1,1,12212
679c6ee23d9df369c70c7b151ee73d3bc2cf9ab9,1,Aleksandr Kovalenko,2013-12-02 18:53:10+02:00,['2e6a9642e37ff131e923a41ec6dd56a2d28930be'],0,6,6,16997743,1,1,1,1,12212
66b1c1d5674b410376f590351246f9371df9cd64,1,Srimanth Gunturi,2013-12-02 12:10:51-08:00,['679c6ee23d9df369c70c7b151ee73d3bc2cf9ab9'],3,3,6,16997749,1,,,,12212
ce40cfc7bdb08e67b0452471b666c065c523b25a,1,Lisnichenko Dmitro,2013-12-02 22:53:55+02:00,['66b1c1d5674b410376f590351246f9371df9cd64'],5,15,20,16997769,2,1,1,0.888888889,12212
b34951074c80be198310044b2e46285677e10557,1,Lisnichenko Dmitro,2013-12-02 23:04:23+02:00,['ce40cfc7bdb08e67b0452471b666c065c523b25a'],14,2603,2617,17000386,31,0.389041096,0.567123288,0.808219178,12241
de56ee61dd36927f96169a0cb157a3752290896c,1,Yusaku Sako,2013-12-02 13:35:06-08:00,['b34951074c80be198310044b2e46285677e10557'],8,10,18,17000404,2,,,,12241
74dfb8e1780008afb7d2cdd2f803ab9671359f9e,0,Siddharth Wagle,2013-12-02 16:28:24-08:00,['de56ee61dd36927f96169a0cb157a3752290896c'],11,13,24,17000428,2,,,,12241
c8b4e1aba624d3f85e7e192280cd7ba207738531,0,Yusaku Sako,2013-12-02 19:54:34-08:00,['74dfb8e1780008afb7d2cdd2f803ab9671359f9e'],19,31,50,17000478,2,,,,12241
70980847acb4266d4fcf58c738bde9411adf7234,0,Yusaku Sako,2013-12-02 19:57:41-08:00,['c8b4e1aba624d3f85e7e192280cd7ba207738531'],1,1,2,17000480,1,,,,12241
305c934f55c22365d8ef68eb0256bce720e32135,1,atkach,2013-12-03 12:20:10+02:00,['70980847acb4266d4fcf58c738bde9411adf7234'],25,10,35,17000515,5,1,1,0,12241
0120a4d47075130a9721766018311c2609ab94be,1,aBabiichuk,2013-12-03 14:37:12+02:00,['305c934f55c22365d8ef68eb0256bce720e32135'],100,99,199,17000714,5,1,1,1,12241
34c6d94b4123662929665f180d1502a22b1e0d06,1,Oleg Nechiporenko,2013-12-03 14:48:29+02:00,['0120a4d47075130a9721766018311c2609ab94be'],0,23,23,17000737,2,0.3,0.6,1,12241
b6b1980a6748d4a1ad070291856decc263be2a02,1,Dmitry Sen,2013-12-03 15:32:52+02:00,['34c6d94b4123662929665f180d1502a22b1e0d06'],4,6,10,17000747,1,,,,12241
8f309f4e8ce1cd49f861ef25846dd55242743d6a,1,Oleg Nechiporenko,2013-12-03 16:03:18+02:00,['b6b1980a6748d4a1ad070291856decc263be2a02'],17,46,63,17000810,1,1,1,0.9,12241
36c56366586727d1540b1ef0afbeb86d639ddffd,1,Lisnichenko Dmitro,2013-12-03 16:05:02+02:00,['8f309f4e8ce1cd49f861ef25846dd55242743d6a'],11,13656,13667,17014477,3,,,,12242
6bf9136f1298312e884fb6a16de938a6c0b63df4,1,Oleg Nechiporenko,2013-12-03 16:27:04+02:00,['36c56366586727d1540b1ef0afbeb86d639ddffd'],3,12,15,17014492,5,1,0,1,12242
7f3860a7fbb61cf56acaa363cfd635c072c83b4d,1,Lisnichenko Dmitro,2013-12-03 16:53:10+02:00,['6bf9136f1298312e884fb6a16de938a6c0b63df4'],0,3,3,17014495,1,,,,12242
32faad52e0ae37946c6f07a8962f5501decc1f67,1,atkach,2013-12-03 17:52:52+02:00,['7f3860a7fbb61cf56acaa363cfd635c072c83b4d'],747,1020,1767,17016262,10,1,1,1,12245
325335b04a8fe5820d35444bdc2a0b97849a8d7b,0,tbeerbower,2013-12-03 11:54:19-05:00,['32faad52e0ae37946c6f07a8962f5501decc1f67'],141,2,143,17016405,2,0.941176471,0.941176471,0.941176471,12245
6c8cba1df31c655b0d2d6972e53155d514823230,1,Lisnichenko Dmitro,2013-12-03 20:14:35+02:00,['325335b04a8fe5820d35444bdc2a0b97849a8d7b'],1,1,2,17016407,1,,,,12245
b245ca7f287afcafd320569c6747eb4b4c98525a,0,Lisnichenko Dmitro,2013-12-03 20:15:52+02:00,['6c8cba1df31c655b0d2d6972e53155d514823230'],1,1,2,17016409,1,,,,12245
2c4f38dc4274474ee98e3bb58e04d8a0957c20c2,1,Nate Cole,2013-12-03 16:03:38-05:00,['b245ca7f287afcafd320569c6747eb4b4c98525a'],1,258,259,17016668,4,0.0625,0.3125,0.35625,12247
4d77357b071a589de2ba8315a816f8b477230690,0,Myroslav Papirkovskyy,2013-12-03 23:08:34+02:00,['2c4f38dc4274474ee98e3bb58e04d8a0957c20c2'],1,1,2,17016670,1,,,,12247
e8d30dd224d0a7f0223020266cc492842fa63854,1,Mahadev Konar,2013-12-03 14:25:22-08:00,['4d77357b071a589de2ba8315a816f8b477230690'],2,2,4,17016674,2,,,,12247
f2969d2dc7ff6032aae4bfcff76901c32c2a9157,0,Yusaku Sako,2013-12-03 16:17:31-08:00,['e8d30dd224d0a7f0223020266cc492842fa63854'],11,25,36,17016710,10,,,,12247
60c1d70a29f59a2a67cc793d9de36a062a751897,0,Yusaku Sako,2013-12-03 16:54:49-08:00,['f2969d2dc7ff6032aae4bfcff76901c32c2a9157'],1,2,3,17016713,2,1,0,0,12247
7c5e2499fee3be218c8ea7fa3891fe89387f3afc,1,Jaimin Jetly,2013-12-03 17:49:38-08:00,['60c1d70a29f59a2a67cc793d9de36a062a751897'],2,3,5,17016718,3,,,,12247
32e003998e3c66d8b7127ff8ce0f9512dc94c433,1,Yusaku Sako,2013-12-03 21:54:46-08:00,['7c5e2499fee3be218c8ea7fa3891fe89387f3afc'],25,11,36,17016754,10,,,,12247
a95e6e7f5b84d9e7cd231765491c0746aa3d5c6b,0,atkach,2013-12-04 12:08:18+02:00,['32e003998e3c66d8b7127ff8ce0f9512dc94c433'],17,21,38,17016792,4,0.5,1,1,12247
ac1a4947137615a37ef8ce97f290d7622c788381,1,Aleksandr Kovalenko,2013-12-04 14:05:32+02:00,['a95e6e7f5b84d9e7cd231765491c0746aa3d5c6b'],24,33,57,17016849,5,0,0,0,12247
5ddbc1e846326c15aa2912db26a3072cbcf7d82a,1,Dmitry Sen,2013-12-04 16:13:39+02:00,['ac1a4947137615a37ef8ce97f290d7622c788381'],19,19,38,17016887,2,,,,12247
a5f113af45473e7f13e6ecd187a3be0ba17b960e,0,Aleksandr Kovalenko,2013-12-04 17:03:15+02:00,['5ddbc1e846326c15aa2912db26a3072cbcf7d82a'],2,3,5,17016892,1,1,1,1,12247
2743782f45941f58dc266a5587565422ea78c80d,1,Aleksandr Kovalenko,2013-12-04 17:22:15+02:00,['a5f113af45473e7f13e6ecd187a3be0ba17b960e'],4,5,9,17016901,2,,,,12247
e3d19b6abdc1a64b9037f4d7fbc265c0fd698237,1,atkach,2013-12-04 17:34:59+02:00,['2743782f45941f58dc266a5587565422ea78c80d'],9,59,68,17016969,5,0.888888889,1,0.777777778,12247
88d3a1a777acad40c8eb38f68fb3414d66182ce2,0,Lisnichenko Dmitro,2013-12-04 17:58:39+02:00,['e3d19b6abdc1a64b9037f4d7fbc265c0fd698237'],76,0,76,17017045,3,0.617021277,0.042553191,0,12247
6d5b66759c7be4f42c79cc7a0e9b3c357fbd0471,1,Alex Antonenko,2013-12-04 19:26:12+02:00,['88d3a1a777acad40c8eb38f68fb3414d66182ce2'],0,17,17,17017062,3,1,1,1,12247
720671a1e86baa6721debff81d01527c19a97f1d,1,Oleg Nechiporenko,2013-12-04 20:17:43+02:00,['6d5b66759c7be4f42c79cc7a0e9b3c357fbd0471'],109,193,302,17017364,4,0,0.697674419,0.837209302,12247
0175008e90a7174f65c775f5fdd4e5543d64f566,1,Lisnichenko Dmitro,2013-12-04 21:12:44+02:00,['720671a1e86baa6721debff81d01527c19a97f1d'],0,213,213,17017577,1,0.78358209,1,0.641791045,12248
516bee70266212bd63dd3c096a00fcf0c670e957,1,Lisnichenko Dmitro,2013-12-04 21:14:38+02:00,['0175008e90a7174f65c775f5fdd4e5543d64f566'],47,1265,1312,17018889,26,0.448028674,0.903225806,1,12272
186798c6d1284def21512a5d65426808d7838bb2,1,Oleksandr Diachenko,2013-12-04 22:33:49+02:00,['516bee70266212bd63dd3c096a00fcf0c670e957'],6,77,83,17018972,2,0,0.976744186,1,12272
0bc52fd96b2d126f659a922f96a5232b05128e67,1,Jaimin Jetly,2013-12-04 12:57:08-08:00,['186798c6d1284def21512a5d65426808d7838bb2'],7,21,28,17019000,8,,,,12272
709976c5a7afb3547569b39f50b3999ec2e64ae8,1,Jaimin Jetly,2013-12-04 14:29:46-08:00,['0bc52fd96b2d126f659a922f96a5232b05128e67'],3,3,6,17019006,3,,,,12272
1a007aecee4fe172c2164a2b910d2cc31aacd79d,0,Mahadev Konar,2013-12-04 15:41:15-08:00,['709976c5a7afb3547569b39f50b3999ec2e64ae8'],0,7,7,17019013,1,0.142857143,0.285714286,0.857142857,12272
d6c1c1c16b5b9a9fda26181ca540a2dabc7491e5,1,Siddharth Wagle,2013-12-04 16:19:18-08:00,['1a007aecee4fe172c2164a2b910d2cc31aacd79d'],0,462,462,17019475,1,0.320945946,0.668918919,0.641891892,12273
649757319e38b3702f4bf637f5696d9fb6b18c1b,1,Siddharth Wagle,2013-12-04 16:37:37-08:00,['d6c1c1c16b5b9a9fda26181ca540a2dabc7491e5'],4,9,13,17019488,1,0,1,0.6,12273
33688dd8843409d7568f8642bff930ad98e49e8f,1,Siddharth Wagle,2013-12-04 16:50:34-08:00,['649757319e38b3702f4bf637f5696d9fb6b18c1b'],0,7,7,17019495,1,0,0,0,12273
3408cfec89364fbaf8750bee00ef809b326c5c5d,1,Yusaku Sako,2013-12-05 06:22:20-08:00,['33688dd8843409d7568f8642bff930ad98e49e8f'],670,367,1037,17020532,6,0.076923077,0.076923077,0.092307692,12274
107aa58083e2eaff8f43f3b5ee7ade4eecb07bd4,0,Oleg Nechiporenko,2013-12-05 17:34:59+02:00,['3408cfec89364fbaf8750bee00ef809b326c5c5d'],6,8,14,17020546,1,1,1,1,12274
e353a1f5d0a4cb53026bdeca746e56cbfd4fdafc,0,tbeerbower,2013-12-05 10:36:53-05:00,['107aa58083e2eaff8f43f3b5ee7ade4eecb07bd4'],4,144,148,17020694,2,0.611111111,0.611111111,1,12275
d3f299825511de0e1b001ed17e0786d71763ed37,0,Lisnichenko Dmitro,2013-12-05 17:55:20+02:00,['e353a1f5d0a4cb53026bdeca746e56cbfd4fdafc'],3,4,7,17020701,1,0,1,1,12275
f6615827285632e9d236e223ad80ea4d1d61edf9,1,Lisnichenko Dmitro,2013-12-05 18:21:50+02:00,['d3f299825511de0e1b001ed17e0786d71763ed37'],12,257,269,17020970,8,0.488888889,1,1,12281
e578087a8a1cc4e609704bf3f6b218d2ecea4a9b,1,Lisnichenko Dmitro,2013-12-05 18:25:40+02:00,['f6615827285632e9d236e223ad80ea4d1d61edf9'],16,2469,2485,17023455,27,0.273615635,0.48534202,0.771986971,12307
e449076dd58beb3b065de2397dbc59e3e81c06b4,1,Lisnichenko Dmitro,2013-12-05 18:51:34+02:00,['e578087a8a1cc4e609704bf3f6b218d2ecea4a9b'],1,1,2,17023457,1,,,,12307
796eab5e5c794c5c192fc93c5fdfbd404a19e20f,1,aBabiichuk,2013-12-05 19:05:51+02:00,['e449076dd58beb3b065de2397dbc59e3e81c06b4'],0,53,53,17023510,4,0.833333333,1,1,12308
bdb4669791cf2d29bdaac4db3d478bb27acd80d0,1,Jaimin Jetly,2013-12-05 10:22:56-08:00,['796eab5e5c794c5c192fc93c5fdfbd404a19e20f'],113,235,348,17023858,9,1,0.984848485,1,12308
3f2d61e1710e12126cfff9fd1cf42c6cf223be5f,1,Lisnichenko Dmitro,2013-12-05 20:32:31+02:00,['bdb4669791cf2d29bdaac4db3d478bb27acd80d0'],1,17,18,17023876,3,0.5,1,1,12308
629cf39a75ecd93103ebed05cd1c60adae0ff95d,0,Lisnichenko Dmitro,2013-12-05 20:36:09+02:00,['3f2d61e1710e12126cfff9fd1cf42c6cf223be5f'],2,7,9,17023885,1,,,,12308
953262cef25da0861902b9997ae29e9abe75bb00,0,Yusaku Sako,2013-12-05 10:57:49-08:00,['629cf39a75ecd93103ebed05cd1c60adae0ff95d'],21,25,46,17023931,1,0.5,0.5,1,12308
7a88b2c6bae0c99e1e2ad598390062af5095608f,1,Yusaku Sako,2013-12-05 11:08:54-08:00,['953262cef25da0861902b9997ae29e9abe75bb00'],3,12,15,17023946,3,1,1,1,12308
bd37807ac941e35e92b1b7909cf94c9f49389a34,0,Yusaku Sako,2013-12-05 11:23:03-08:00,['7a88b2c6bae0c99e1e2ad598390062af5095608f'],2,12,14,17023960,2,1,1,1,12308
e40e12da5a6659667fc751eb6b5f9ba25b0d8e9d,1,Jaimin Jetly,2013-12-05 11:49:30-08:00,['bd37807ac941e35e92b1b7909cf94c9f49389a34'],0,210,210,17024170,1,,,,12309
c9a190453a735c0aaf50e0edea8751d08dbf3649,1,Chad Roberts,2013-12-05 15:11:56-05:00,['e40e12da5a6659667fc751eb6b5f9ba25b0d8e9d'],2,2,4,17024174,1,,,,12309
9b3c8eca735973a2c4bb31f13e9ee9f19d64462f,1,Siddharth Wagle,2013-12-05 13:54:02-08:00,['c9a190453a735c0aaf50e0edea8751d08dbf3649'],17,72,89,17024263,7,0,0.958333333,1,12309
e9837042de776c760df113173ec0079595f2f3ec,0,Jaimin Jetly,2013-12-05 14:21:32-08:00,['9b3c8eca735973a2c4bb31f13e9ee9f19d64462f'],1,1,2,17024265,1,,,,12309
661d4d16a2c9a90f0cb316c57957076f6d7a5e10,1,Siddharth Wagle,2013-12-05 16:38:40-08:00,['e9837042de776c760df113173ec0079595f2f3ec'],3,6,9,17024274,1,0,1,1,12309
b2bbf86485c3fe0781d1db949b9b0bc0c1b5a607,1,Siddharth Wagle,2013-12-05 16:39:45-08:00,['661d4d16a2c9a90f0cb316c57957076f6d7a5e10'],2,2,4,17024278,1,,,,12309
fa54ce2a5c006dd97e3b1a89252a9bfa858a60fa,1,tbeerbower,2013-12-05 19:44:15-05:00,['b2bbf86485c3fe0781d1db949b9b0bc0c1b5a607'],50,172,222,17024500,6,0,1,1,12309
09ed860a7b7f28db96684f67a16a8690a73cb433,1,Siddharth Wagle,2013-12-05 17:56:32-08:00,['fa54ce2a5c006dd97e3b1a89252a9bfa858a60fa'],6,19,25,17024525,1,0,0.444444444,1,12309
81fdc69aa09e4ce5cc8bb3e6e1a5b1a3d08ce807,1,atkach,2013-12-06 12:43:19+02:00,['09ed860a7b7f28db96684f67a16a8690a73cb433'],3,3,6,17024531,1,,,,12309
7199a0b41933e01d0c3ec9399c781684f3cabb67,1,Oleg Nechiporenko,2013-12-06 14:03:35+02:00,['81fdc69aa09e4ce5cc8bb3e6e1a5b1a3d08ce807'],9,3,12,17024543,2,0,0,0,12309
da16636dda11384afba47f72dafdbd8398a05ce8,0,Alex Antonenko,2013-12-06 14:08:09+02:00,['7199a0b41933e01d0c3ec9399c781684f3cabb67'],1,4,5,17024548,1,0,0,1,12309
868a78904634a60cbb9177b5a786ccf0cbecdf48,1,Alex Antonenko,2013-12-06 14:58:29+02:00,['da16636dda11384afba47f72dafdbd8398a05ce8'],0,18,18,17024566,2,0.625,1,1,12309
758c0a2a05dce52ef4cdec79513fe2f733359279,0,atkach,2013-12-06 15:33:55+02:00,['868a78904634a60cbb9177b5a786ccf0cbecdf48'],28,31,59,17024625,1,0.4,1,1,12309
56f7f8744fbcf0a7d1781e08b57538ba984ec119,1,Dmitry Sen,2013-12-06 18:52:23+02:00,['758c0a2a05dce52ef4cdec79513fe2f733359279'],49,248,297,17024922,17,0.075630252,0.848739496,0.495798319,12310
66a5dbe6038e6f3d2a25b195759237d5702ec855,1,Oleg Nechiporenko,2013-12-06 19:08:24+02:00,['56f7f8744fbcf0a7d1781e08b57538ba984ec119'],3,83,86,17025008,3,0.595744681,0.957446809,1,12310
b92082252f17103df89b67ace5ff057d57e8990f,0,Oleg Nechiporenko,2013-12-06 19:33:41+02:00,['66a5dbe6038e6f3d2a25b195759237d5702ec855'],1,0,1,17025009,1,1,0,0,12310
0a94a0f439c31bc15ee3797658fff6e06171fdad,1,Aleksandr Kovalenko,2013-12-06 19:54:40+02:00,['b92082252f17103df89b67ace5ff057d57e8990f'],83,57,140,17025149,9,0,1,0,12310
fc3024c514279f311d6b62d696b9e28227185739,0,Lisnichenko Dmitro,2013-12-06 20:18:31+02:00,['0a94a0f439c31bc15ee3797658fff6e06171fdad'],32,5,37,17025186,1,1,0.958333333,0.333333333,12310
48e2184fe1e5b0f543d41551d50d2f0be41b58fe,1,Lisnichenko Dmitro,2013-12-06 20:19:09+02:00,['fc3024c514279f311d6b62d696b9e28227185739'],42,217,259,17025445,7,1,1,1,12314
9a50f98b54e183741c08ffa32386844016a61059,1,aBabiichuk,2013-12-06 20:22:25+02:00,['48e2184fe1e5b0f543d41551d50d2f0be41b58fe'],1,1,2,17025447,1,,,,12314
764ea58e19daac317ab9d2f1bbb7d3a92fce1aed,0,Chad Roberts,2013-12-06 16:39:50-05:00,['9a50f98b54e183741c08ffa32386844016a61059'],1,5,6,17025453,1,,,,12314
d0f91d5d4c5500eeff9d142936955f8b42119632,1,Nate Cole,2013-12-06 16:42:31-05:00,['764ea58e19daac317ab9d2f1bbb7d3a92fce1aed'],1,13,14,17025467,2,0,0,1,12314
ce5541422863b992b7763a1017f9af57a2571859,1,Siddharth Wagle,2013-12-06 15:10:05-08:00,['d0f91d5d4c5500eeff9d142936955f8b42119632'],39,39,78,17025545,1,,,,12314
5100bb26ba767d145a9d0d9cd603ec44d6d2557f,1,Jaimin Jetly,2013-12-06 17:20:48-08:00,['ce5541422863b992b7763a1017f9af57a2571859'],1676,1007,2683,17028228,27,1,0,1,12314
c69c33c878d7e3ab74cfa8de5f7fba26e1ef6557,1,Jaimin Jetly,2013-12-06 17:25:50-08:00,['5100bb26ba767d145a9d0d9cd603ec44d6d2557f'],8,13,21,17028249,1,0,1,1,12314
bf20cda0a14451d297c2bd8fc3e21c63e14fb9ce,1,Yusaku Sako,2013-12-09 00:07:42-08:00,['c69c33c878d7e3ab74cfa8de5f7fba26e1ef6557'],14,38,52,17028301,8,0.947368421,0.947368421,1,12314
8bd4a9793df35aed112eacd1c2f7c6242c043e7a,0,Aleksandr Kovalenko,2013-12-09 12:57:49+02:00,['bf20cda0a14451d297c2bd8fc3e21c63e14fb9ce'],1,1,2,17028303,1,,,,12314
98081d63ae847922fadb471f0648397893ba6dc5,1,Oleg Nechiporenko,2013-12-09 15:27:56+02:00,['8bd4a9793df35aed112eacd1c2f7c6242c043e7a'],3,2,5,17028308,1,0,0,1,12314
328c10e05d1826a6512781a669a902129717c13c,1,Chad Roberts,2013-12-09 09:40:22-05:00,['98081d63ae847922fadb471f0648397893ba6dc5'],40,108,148,17028456,2,1,1,0.811320755,12314
71fa52975f49262c855a5adcd202a503c0e3bdfa,1,Andrew Onischuk,2013-12-09 08:04:35-08:00,['328c10e05d1826a6512781a669a902129717c13c'],8,364,372,17028828,9,0.546875,1,1,12322
15caddde9bc1559e928fd887cf998f2d2310916d,1,aBabiichuk,2013-12-09 18:08:30+02:00,['71fa52975f49262c855a5adcd202a503c0e3bdfa'],0,1,1,17028829,1,1,1,1,12322
e307e832a814c595a23c948e054dd8b2b84c6e14,1,aBabiichuk,2013-12-09 18:08:30+02:00,['15caddde9bc1559e928fd887cf998f2d2310916d'],2,7,9,17028838,2,,,,12322
fc73c199f52d32321c1e8dcbb1bfb94706ee0a3c,0,Chad Roberts,2013-12-09 11:15:09-05:00,['e307e832a814c595a23c948e054dd8b2b84c6e14'],145,145,290,17029128,145,,,,12322
ca8b0ad845d79907e14c0829fb4648a3371cea7a,1,Andrew Onischuk,2013-12-09 08:16:09-08:00,['fc73c199f52d32321c1e8dcbb1bfb94706ee0a3c'],26,530,556,17029684,11,0.25,1,0.798387097,12330
110fc144a97b946dce004fec3c60a5098501e9fc,0,Chad Roberts,2013-12-09 11:27:31-05:00,['ca8b0ad845d79907e14c0829fb4648a3371cea7a'],269,0,269,17029953,5,0.483870968,0,0,12330
3091cbce31f4439621505127f00d47465bdcc401,1,Aleksandr Kovalenko,2013-12-09 19:45:23+02:00,['110fc144a97b946dce004fec3c60a5098501e9fc'],24,26,50,17030003,2,1,0,0,12330
d3c1a6457c0196e036b8675c74d5f21aacfb0817,1,Alex Antonenko,2013-12-09 19:53:11+02:00,['3091cbce31f4439621505127f00d47465bdcc401'],2,8,10,17030013,2,1,1,1,12330
3b44151aa76392b5d9e8540d0c30662fb708a815,1,atkach,2013-12-09 20:01:15+02:00,['d3c1a6457c0196e036b8675c74d5f21aacfb0817'],230,110,340,17030353,5,1,0.989583333,0,12330
4b39ed873cf2d38b39ee3aad7e66272edaecbe99,0,Mahadev Konar,2013-12-09 12:02:37-08:00,['3b44151aa76392b5d9e8540d0c30662fb708a815'],2,2,4,17030357,1,,,,12330
cc58951c1192e670eec994404f59628c9e425310,1,Mahadev Konar,2013-12-09 14:08:01-08:00,['4b39ed873cf2d38b39ee3aad7e66272edaecbe99'],0,722,722,17031079,2,,,,12331
be6d0ef688527a7c582d24a562818513f187ff93,1,Siddharth Wagle,2013-12-09 17:31:42-08:00,['cc58951c1192e670eec994404f59628c9e425310'],0,12,12,17031091,1,,,,12331
7ce91da37989374b78ed1e3ee0cd3d593a8742df,0,Siddharth Wagle,2013-12-09 17:31:42-08:00,['be6d0ef688527a7c582d24a562818513f187ff93'],2,2,4,17031095,1,,,,12331
630983ab01e327a4a19c2f823f66ec98bbf47d2c,1,Siddharth Wagle,2013-12-09 17:48:47-08:00,['7ce91da37989374b78ed1e3ee0cd3d593a8742df'],4,1659,1663,17032758,12,0.91198044,0.936430318,1,12337
6e9126297a945dc1278ce32701ce8e45ff520023,1,Jaimin Jetly,2013-12-09 18:24:17-08:00,['630983ab01e327a4a19c2f823f66ec98bbf47d2c'],45,8,53,17032811,9,0,0,1,12337
f1a9048414c10f511fb2bdf5874fe7a7c7d6b88d,0,atkach,2013-12-10 12:29:53+02:00,['6e9126297a945dc1278ce32701ce8e45ff520023'],1,1,2,17032813,1,,,,12337
142f51b6443462360f7404a35875ca2dead18d03,1,Aleksandr Kovalenko,2013-12-10 17:22:04+02:00,['f1a9048414c10f511fb2bdf5874fe7a7c7d6b88d'],4,9,13,17032826,3,1,1,1,12337
e9d546108f4c85faa0186994bfaad62ac1856399,1,atkach,2013-12-10 18:16:43+02:00,['142f51b6443462360f7404a35875ca2dead18d03'],13,19,32,17032858,1,0.285714286,0,1,12337
e45779ab3b5272221a9b463564317502b29f8a43,1,aBabiichuk,2013-12-10 18:41:47+02:00,['e9d546108f4c85faa0186994bfaad62ac1856399'],4,15,19,17032877,1,1,1,1,12337
4f822ca93421b99593d4f645c795f0a5688fd2af,1,Oleg Nechiporenko,2013-12-10 20:03:44+02:00,['e45779ab3b5272221a9b463564317502b29f8a43'],40,89,129,17033006,9,1,0,0,12339
e30633c19d171a6cdb356e1fc92099354b8da7cd,1,Oleg Nechiporenko,2013-12-10 20:16:11+02:00,['4f822ca93421b99593d4f645c795f0a5688fd2af'],6,25,31,17033037,2,0,0,0,12340
ce08fc8ae9a218832ad5fd3e3b03c67ed3e558d0,1,Lisnichenko Dmitro,2013-12-10 20:18:29+02:00,['e30633c19d171a6cdb356e1fc92099354b8da7cd'],23,218,241,17033278,11,0.779220779,0.311688312,0.545454545,12342
a939bbd1ed53c86409342b97ed087f8e8f7f998d,1,Andrew Onischuk,2013-12-10 10:19:05-08:00,['ce08fc8ae9a218832ad5fd3e3b03c67ed3e558d0'],49,75,124,17033402,14,0,0.055555556,1,12342
27822b37b50f7e2b58cc0d813e91ee30c40d136f,1,Lisnichenko Dmitro,2013-12-10 21:42:25+02:00,['a939bbd1ed53c86409342b97ed087f8e8f7f998d'],1,1,2,17033404,1,,,,12342
02ef1af6092c3eace6efc5ba6042f91f5fd9eaf8,1,Aleksandr Kovalenko,2013-12-11 14:43:57+02:00,['27822b37b50f7e2b58cc0d813e91ee30c40d136f'],28,22,50,17033454,2,0,0,1,12342
84dc327677d248c2137fa1afa8755cf92f58d0c8,1,Aleksandr Kovalenko,2013-12-11 17:49:58+02:00,['02ef1af6092c3eace6efc5ba6042f91f5fd9eaf8'],1,3,4,17033458,1,1,1,1,12342
d8a915a974638ac01386d9318aefbc5579b53a15,1,Oleg Nechiporenko,2013-12-11 19:43:42+02:00,['84dc327677d248c2137fa1afa8755cf92f58d0c8'],332,500,832,17034290,29,0,0,0,12352
740df281c709b2c7bb86c72d3af710c02660dbfe,1,Lisnichenko Dmitro,2013-12-11 19:51:22+02:00,['d8a915a974638ac01386d9318aefbc5579b53a15'],4,3,7,17034297,3,,,,12352
5074552959329e0a310da13c53e736ec7241f0ec,1,Andrew Onischuk,2013-12-11 11:45:48-08:00,['740df281c709b2c7bb86c72d3af710c02660dbfe'],9,896,905,17035202,18,0.285714286,1,1,12369
8dac3f1a84dd165972fea41f3fbb9df760ff7458,1,atkach,2013-12-12 13:09:36+02:00,['5074552959329e0a310da13c53e736ec7241f0ec'],51,28,79,17035281,3,0.615384615,0.615384615,0,12369
66e1f0d2c47d81cfce055765c755ec8c35bb4134,0,aBabiichuk,2013-12-12 14:17:31+02:00,['8dac3f1a84dd165972fea41f3fbb9df760ff7458'],25,19,44,17035325,1,0,1,0,12369
cf811e2c2f7f94c52ae42d1e29be60e816520b2d,1,aBabiichuk,2013-12-12 14:18:13+02:00,['66e1f0d2c47d81cfce055765c755ec8c35bb4134'],1,1,2,17035327,1,,,,12369
03d190cc90f689ce1eaf0121b10fa4c89e4c0075,1,Aleksandr Kovalenko,2013-12-12 15:05:04+02:00,['cf811e2c2f7f94c52ae42d1e29be60e816520b2d'],0,7,7,17035334,1,1,1,1,12369
70ac9ea7e035d0d443bb49cae327cdc44e2751ae,1,Aleksandr Kovalenko,2013-12-12 15:45:05+02:00,['03d190cc90f689ce1eaf0121b10fa4c89e4c0075'],6,5,11,17035345,2,,,,12369
06c22ff5a995735a1b854b7f8891637135b18a6b,0,Aleksandr Kovalenko,2013-12-12 18:00:08+02:00,['70ac9ea7e035d0d443bb49cae327cdc44e2751ae'],2,6,8,17035353,1,1,1,0,12369
92ea2fdd6589695e8dc72038c5cd5e70f99034dd,1,Oleg Nechiporenko,2013-12-12 18:45:13+02:00,['06c22ff5a995735a1b854b7f8891637135b18a6b'],88,150,238,17035591,8,0,1,1,12369
fbc43ac67b2cd8ed6979c5513d5fe207b49d4c94,0,Aleksandr Kovalenko,2013-12-12 19:47:57+02:00,['92ea2fdd6589695e8dc72038c5cd5e70f99034dd'],2,2,4,17035595,1,,,,12369
06749c8fb1b76920be69b12bb93129d2fc85bd4a,0,Aleksandr Kovalenko,2013-12-12 19:59:08+02:00,['fbc43ac67b2cd8ed6979c5513d5fe207b49d4c94'],2,2,4,17035599,1,,,,12369
336e4b34b463859251b494e4d21dd0250d7944d9,0,Aleksandr Kovalenko,2013-12-12 20:01:30+02:00,['06749c8fb1b76920be69b12bb93129d2fc85bd4a'],2,2,4,17035603,1,,,,12369
99779cc7d1fd06081d79c315edda301a5e679bae,1,Srimanth Gunturi,2013-12-12 10:11:29-08:00,['336e4b34b463859251b494e4d21dd0250d7944d9'],6,11,17,17035620,1,1,1,1,12369
d1cbbdb13c8b8a08b5edbeb2c472308087a86703,0,Yusaku Sako,2013-12-12 10:13:58-08:00,['99779cc7d1fd06081d79c315edda301a5e679bae'],1,4,5,17035625,1,1,1,1,12369
bbd15037143d9e11fd1408a2c7395a9bb9f21150,1,Yusaku Sako,2013-12-12 10:16:55-08:00,['d1cbbdb13c8b8a08b5edbeb2c472308087a86703'],2,6,8,17035633,3,1,1,1,12369
4e41f12f7060605896affd1d30f3335694d4c434,0,Lisnichenko Dmitro,2013-12-12 20:35:00+02:00,['bbd15037143d9e11fd1408a2c7395a9bb9f21150'],1,2,3,17035636,1,,,,12369
83b34888031cc58ca921b0d4a5551fe2edf37f0e,1,Srimanth Gunturi,2013-12-12 10:59:18-08:00,['4e41f12f7060605896affd1d30f3335694d4c434'],9,37,46,17035682,1,0,0,1,12369
e4b099a5a2bba6003f96275bf129e864b3d745ce,0,Yusaku Sako,2013-12-12 11:08:57-08:00,['83b34888031cc58ca921b0d4a5551fe2edf37f0e'],6,54,60,17035742,1,,,,12369
abb68972ef5c7b07685acb5cd5b4cda25ec8c760,1,Sumit Mohanty,2013-12-12 13:23:43-08:00,['e4b099a5a2bba6003f96275bf129e864b3d745ce'],2,17,19,17035761,6,,,,12369
7f92051d019729f36d5ca9371cae4f600024f972,1,Srimanth Gunturi,2013-12-12 17:53:32-08:00,['abb68972ef5c7b07685acb5cd5b4cda25ec8c760'],15,8,23,17035784,3,0,0,0,12369
3a1fc7db946ad70356e8517d0c3f059e85d4a91d,1,Oleg Nechiporenko,2013-12-13 17:51:47+02:00,['7f92051d019729f36d5ca9371cae4f600024f972'],7,21,28,17035812,3,1,1,1,12369
af0679d1ca102f515b323e51c86e8b274c57b927,1,aBabiichuk,2013-12-13 18:18:23+02:00,['3a1fc7db946ad70356e8517d0c3f059e85d4a91d'],1,1,2,17035814,1,,,,12369
65aec6617ed05ea87edf665d38d8c41e504482a1,1,Andrew Onischuk,2013-12-13 08:21:14-08:00,['af0679d1ca102f515b323e51c86e8b274c57b927'],14,4596,4610,17040424,42,0.478632479,0.84045584,0.846153846,12403
34b1cb86a2e81cf882dd459ddb9b0ec4d96b3a35,1,Lisnichenko Dmitro,2013-12-13 19:21:27+02:00,['65aec6617ed05ea87edf665d38d8c41e504482a1'],14,49,63,17040487,4,0.571428571,0.857142857,0.428571429,12404
227bb375280014f1b0aecdaf5a870b396e80f3a3,0,Sumit Mohanty,2013-12-13 09:40:56-08:00,['34b1cb86a2e81cf882dd459ddb9b0ec4d96b3a35'],2,2,4,17040491,1,,,,12404
9b32b676e8c96e4cea137d94dc8ac8b9daafcd9d,1,Andrew Onischuk,2013-12-13 09:53:59-08:00,['227bb375280014f1b0aecdaf5a870b396e80f3a3'],9,10,19,17040510,4,,,,12404
2eeac2986b66c6a05e389fe37c53dd799b36a071,1,aBabiichuk,2013-12-13 19:58:39+02:00,['9b32b676e8c96e4cea137d94dc8ac8b9daafcd9d'],5,8,13,17040523,3,1,1,1,12404
6f179fd037d7249f7bc38438a724b6bc937babd3,1,Yusaku Sako,2013-12-13 11:22:46-08:00,['2eeac2986b66c6a05e389fe37c53dd799b36a071'],2,2,4,17040527,1,,,,12404
5d9f9ed5934bba1d59830db1afc74c62402c9a0c,1,Andrew Onischuk,2013-12-13 12:31:13-08:00,['6f179fd037d7249f7bc38438a724b6bc937babd3'],6,8,14,17040541,3,1,1,1,12404
fd9cd27a1abfbd3e93ea6560fa5a907295c1b0a8,1,Lisnichenko Dmitro,2013-12-13 23:15:11+02:00,['5d9f9ed5934bba1d59830db1afc74c62402c9a0c'],239,820,1059,17041600,70,0.385826772,0.732283465,0.464566929,12414
5629ad98314334c5f2f53498fdf8c747bfcd6ff1,0,atkach,2013-12-16 14:12:07+02:00,['fd9cd27a1abfbd3e93ea6560fa5a907295c1b0a8'],141,96,237,17041837,4,1,1,0,12414
eb80c2b7e681beca82fe9ac034b73fbf21324130,1,Nate Cole,2013-12-16 08:27:43-05:00,['5629ad98314334c5f2f53498fdf8c747bfcd6ff1'],13298,30951,44249,17086086,21,0.795795796,0.339339339,0.291291291,12420
bf536d1a8af6f5ebf448e9030205ec714c781f4a,0,Lisnichenko Dmitro,2013-12-16 15:37:46+02:00,['eb80c2b7e681beca82fe9ac034b73fbf21324130'],74,0,74,17086160,3,,,,12420
a58a0f801a51c7128e3cb2b329277d4aece73faf,1,Andrew Onischuk,2013-12-16 06:25:39-08:00,['bf536d1a8af6f5ebf448e9030205ec714c781f4a'],515,1176,1691,17087851,24,0.254143646,0.867403315,0.892265193,12434
1a34b620d142cbb678e0c0aaf2f0ca552e37658a,0,Andrew Onischuk,2013-12-16 06:50:19-08:00,['a58a0f801a51c7128e3cb2b329277d4aece73faf'],1,1,2,17087853,1,,,,12434
e27f3763325bbff51e07ef43e82f25156695f08a,0,Alex Antonenko,2013-12-16 18:19:25+02:00,['1a34b620d142cbb678e0c0aaf2f0ca552e37658a'],0,1,1,17087854,1,0.5,1,1,12434
c54e6cd333e940adf267e7e90cf517aa3a1188a5,1,Alex Antonenko,2013-12-16 18:48:27+02:00,['e27f3763325bbff51e07ef43e82f25156695f08a'],2,19,21,17087875,4,1,1,1,12434
a46cb311b8e8097ae4eded083467545893ce7579,1,Andrew Onischuk,2013-12-16 08:49:21-08:00,['c54e6cd333e940adf267e7e90cf517aa3a1188a5'],8,4,12,17087887,3,0.333333333,0,0,12434
9c2cbdb076556d561b4dd593c3a4cb8a8723efee,0,Sumit Mohanty,2013-12-16 08:58:16-08:00,['a46cb311b8e8097ae4eded083467545893ce7579'],5,7,12,17087899,2,0,0,1,12434
fb4a4cf7a7d3cce282c3af423987a632909fe03e,0,Oleg Nechiporenko,2013-12-16 19:34:06+02:00,['9c2cbdb076556d561b4dd593c3a4cb8a8723efee'],0,5,5,17087904,1,1,1,1,12434
e5d225a2db6afc6d1b03f03027d3582ffac88850,1,tbeerbower,2013-12-16 12:46:34-05:00,['fb4a4cf7a7d3cce282c3af423987a632909fe03e'],52,1339,1391,17089295,19,0.494208494,0.83011583,0.901544402,12440
2dc955fa61ba2290d5a3395fde90df5c3d6f0963,1,Yusaku Sako,2013-12-16 14:07:09-08:00,['e5d225a2db6afc6d1b03f03027d3582ffac88850'],24,122,146,17089441,3,1,1,0.769230769,12440
97d0d2737d6dc54a4de1e6c7252586b15d0bb1f3,1,Yusaku Sako,2013-12-16 14:12:02-08:00,['2dc955fa61ba2290d5a3395fde90df5c3d6f0963'],2,28,30,17089471,5,0.111111111,1,1,12440
1969062f762541bbb8e6876874a358594e068868,1,Mahadev Konar,2013-12-16 15:40:41-08:00,['97d0d2737d6dc54a4de1e6c7252586b15d0bb1f3'],225,5650,5875,17095346,76,,,,12485
83a48aaa608dc25e4a998780dd28bd0b26085d55,1,Mahadev Konar,2013-12-16 15:50:17-08:00,['1969062f762541bbb8e6876874a358594e068868'],0,1,1,17095347,1,,,,12485
a693c65ef3bf5ee12d542503c7cdcf784ad9a680,1,Mahadev Konar,2013-12-16 17:01:48-08:00,['83a48aaa608dc25e4a998780dd28bd0b26085d55'],1,4927,4928,17100275,43,,,,12526
064ac7c1b39edf5220a4dbc8cf7e832bc5f8af73,0,atkach,2013-12-17 14:53:34+02:00,['a693c65ef3bf5ee12d542503c7cdcf784ad9a680'],3,3,6,17100281,1,,,,12526
f3afbc70128a2f0d0564a54419c6b72328136fe4,1,Dmitry Sen,2013-12-17 15:21:17+02:00,['064ac7c1b39edf5220a4dbc8cf7e832bc5f8af73'],215,459,674,17100955,4,1,1,1,12527
6ced2a18c4dcc29d906e9dcb350650c2732bf8c5,1,Alex Antonenko,2013-12-17 16:29:21+02:00,['f3afbc70128a2f0d0564a54419c6b72328136fe4'],0,22,22,17100977,2,,,,12527
54791d17aec04e9f5bfa01065d0ae8414e552909,1,Oleg Nechiporenko,2013-12-17 17:06:45+02:00,['6ced2a18c4dcc29d906e9dcb350650c2732bf8c5'],30,20,50,17101027,14,0.2,0.2,0,12527
5229fb1beb2057acc5b0b540f7a1680ece46f177,1,aBabiichuk,2013-12-17 18:17:44+02:00,['54791d17aec04e9f5bfa01065d0ae8414e552909'],1,15,16,17101043,3,1,1,0.428571429,12527
185b11ab59374540577c468457e7aa5c0ac7dfc1,1,atkach,2013-12-17 18:49:33+02:00,['5229fb1beb2057acc5b0b540f7a1680ece46f177'],44,48,92,17101135,5,1,1,1,12527
4522c0d1bc40ed55b8d3fe39e6be9cbf39a7955a,1,Andrew Onischuk,2013-12-17 08:53:16-08:00,['185b11ab59374540577c468457e7aa5c0ac7dfc1'],6,56,62,17101197,5,1,1,1,12528
b12c19c3cc6bc285d5b94c2b891478162c32cf6b,1,Alex Antonenko,2013-12-17 20:57:25+02:00,['4522c0d1bc40ed55b8d3fe39e6be9cbf39a7955a'],28,24,52,17101249,3,,,,12528
ac46ed4908b37185016f627d4091f7e6de2990cb,1,Jaimin Jetly,2013-12-17 15:55:59-08:00,['b12c19c3cc6bc285d5b94c2b891478162c32cf6b'],100,278,378,17101627,2,0,0,0.409090909,12528
59d292a2c434e2b48e378872c4d0f4a33ea1dd73,0,Jaimin Jetly,2013-12-17 18:21:53-08:00,['ac46ed4908b37185016f627d4091f7e6de2990cb'],1,1,2,17101629,1,,,,12528
7f726aec97273a2b80780de5b914d69ce01a5b05,1,tbeerbower,2013-12-18 04:59:12-05:00,['59d292a2c434e2b48e378872c4d0f4a33ea1dd73'],18800,9164,27964,17129593,9,0,0,0.263157895,12528
13710eb2f2791f2c820e8ef933f2737554962e1e,0,atkach,2013-12-18 14:46:21+02:00,['7f726aec97273a2b80780de5b914d69ce01a5b05'],0,3,3,17129596,1,1,1,1,12528
4aec796a165c7d94e3354bc4718c0cb3da27ae4d,1,Andrew Onischuk,2013-12-18 05:07:02-08:00,['13710eb2f2791f2c820e8ef933f2737554962e1e'],458,536,994,17130590,11,,,,12528
9379a8851689f617c109d085b9637183cfa35494,1,Dmitry Sen,2013-12-18 15:38:27+02:00,['4aec796a165c7d94e3354bc4718c0cb3da27ae4d'],1,4,5,17130595,1,1,1,0,12528
ed77411d43b3f72f22f72613716fc7071be29c42,1,Andrew Onischuk,2013-12-18 06:17:59-08:00,['9379a8851689f617c109d085b9637183cfa35494'],8,449,457,17131052,11,0.560606061,1,1,12538
2e04d3b0259d59da127d6444e89fbc8d2548d522,0,Andrew Onischuk,2013-12-18 06:24:59-08:00,['ed77411d43b3f72f22f72613716fc7071be29c42'],82,6,88,17131140,4,1,1,1,12538
dcadbc9ef9c5dc295d025949ebd185ec7eac8ad3,1,Dmitry Sen,2013-12-18 17:08:25+02:00,['2e04d3b0259d59da127d6444e89fbc8d2548d522'],4,8,12,17131152,4,0,1,0,12538
5ba4a2470e6c292b348a94d1b362e09c8b57c402,1,Dmitry Sen,2013-12-18 17:12:13+02:00,['dcadbc9ef9c5dc295d025949ebd185ec7eac8ad3'],3,5,8,17131160,1,0,1,0,12538
7ff8e74c517bf35c2dd0f18581dc3e8630dc4a57,1,aBabiichuk,2013-12-18 17:16:06+02:00,['5ba4a2470e6c292b348a94d1b362e09c8b57c402'],5,5,10,17131170,1,,,,12538
11c45419d933ed8d5bf4ab5d7f88656b40e6e319,0,atkach,2013-12-18 17:33:48+02:00,['7ff8e74c517bf35c2dd0f18581dc3e8630dc4a57'],25,2,27,17131197,9,1,0.210526316,0.052631579,12538
7fcaee967c5bc498c53098c37ae6b3668477cf9c,0,Lisnichenko Dmitro,2013-12-18 18:42:56+02:00,['11c45419d933ed8d5bf4ab5d7f88656b40e6e319'],1,13,14,17131211,3,,,,12538
7b837b11f4f9822cc4b6f6faa36c0a53b9e2ee54,1,Aleksandr Kovalenko,2013-12-18 18:47:58+02:00,['7fcaee967c5bc498c53098c37ae6b3668477cf9c'],366,211,577,17131788,5,0,0,0,12538
1c4f148952533910433ab97f94bf2f0083fa901a,1,Nate Cole,2013-12-18 12:17:34-05:00,['7b837b11f4f9822cc4b6f6faa36c0a53b9e2ee54'],0,115,115,17131903,3,0,0,0,12540
3a84e4f93954feb3a028a93476d10d578ebd215d,1,Oleksandr Diachenko,2013-12-18 19:23:58+02:00,['1c4f148952533910433ab97f94bf2f0083fa901a'],185,1149,1334,17133237,15,0.249027237,0.856031128,1,12540
3c1c0a02e971d11557db0e6fafbcb2e9fbcde149,1,Dmitry Sen,2013-12-18 19:29:31+02:00,['3a84e4f93954feb3a028a93476d10d578ebd215d'],6,6,12,17133249,5,,,,12540
7feffb0ce84f4e098be1fdf953ce96c5e3891fb9,1,Andrew Onischuk,2013-12-18 09:36:55-08:00,['3c1c0a02e971d11557db0e6fafbcb2e9fbcde149'],15,15,30,17133279,4,0,0,0,12540
481f640c4379cd2cea5963f6cfcf17d6572b6d51,0,Andrew Onischuk,2013-12-18 10:47:19-08:00,['7feffb0ce84f4e098be1fdf953ce96c5e3891fb9'],2,3,5,17133284,2,1,1,1,12540
2cba1853dce1703d901170d5df1d8c7ab4624c55,1,Alex Antonenko,2013-12-18 21:00:50+02:00,['481f640c4379cd2cea5963f6cfcf17d6572b6d51'],0,3,3,17133287,1,1,1,1,12540
942eb80027d25df844e5ce0cbd6692d5ed5d8544,0,Lisnichenko Dmitro,2013-12-18 21:21:07+02:00,['2cba1853dce1703d901170d5df1d8c7ab4624c55'],2,2,4,17133291,1,,,,12540
55e45ef26421e4a5a00927b101114885771d594b,1,aBabiichuk,2013-12-18 21:33:44+02:00,['942eb80027d25df844e5ce0cbd6692d5ed5d8544'],14,59,73,17133364,2,0.162162162,0.675675676,1,12540
778edc8dc4f12b3364770306279e6b90d9afb49d,1,Jaimin Jetly,2013-12-18 15:54:29-08:00,['55e45ef26421e4a5a00927b101114885771d594b'],71,60,131,17133495,7,0.176470588,0,1,12540
b35f7b8e538f9ce142ce83636d1135bc8acaa8bb,0,atkach,2013-12-19 13:53:06+02:00,['778edc8dc4f12b3364770306279e6b90d9afb49d'],4,12,16,17133511,1,1,1,,12540
d64b06e6ed298c2b3ff298d24d3a894e86f09a84,1,atkach,2013-12-19 14:01:10+02:00,['b35f7b8e538f9ce142ce83636d1135bc8acaa8bb'],3,110,113,17133624,5,1,1,1,12542
69faaf7be843c98c6928884005b27d28948b2038,1,Oleg Nechiporenko,2013-12-19 14:10:42+02:00,['d64b06e6ed298c2b3ff298d24d3a894e86f09a84'],4,5,9,17133633,1,,,,12542
8692e9c9a810885f8bc22e9c7c99faaf5544c556,1,Andrew Onischuk,2013-12-19 04:40:14-08:00,['69faaf7be843c98c6928884005b27d28948b2038'],2,202,204,17133837,13,1,1,1,12542
b1798b8f65e2349023c024cb2be819e42a02e97a,0,aBabiichuk,2013-12-19 15:01:43+02:00,['8692e9c9a810885f8bc22e9c7c99faaf5544c556'],6,7,13,17133850,1,,,,12542
d43c517370db9b509933c5933df43e8d8210a620,0,aBabiichuk,2013-12-19 15:10:58+02:00,['b1798b8f65e2349023c024cb2be819e42a02e97a'],10,7,17,17133867,1,,,,12542
26f1fb95539bdd2c4265936418a9dafd4f8169cb,0,Alex Antonenko,2013-12-19 18:00:49+02:00,['d43c517370db9b509933c5933df43e8d8210a620'],8,0,8,17133875,1,1,0,0,12542
05a0ce2f989bd6fe47275e69b40bb9e6af7f9ecf,1,aBabiichuk,2013-12-19 18:37:36+02:00,['26f1fb95539bdd2c4265936418a9dafd4f8169cb'],1,12,13,17133888,1,1,1,1,12542
87dd9be0dd769e867f31e37ab802e818e8d3058f,0,Lisnichenko Dmitro,2013-12-19 18:42:46+02:00,['05a0ce2f989bd6fe47275e69b40bb9e6af7f9ecf'],2,1,3,17133891,1,,,,12542
0f045cad761f37428cc7c25cf56880f453c6162f,1,Alex Antonenko,2013-12-19 21:31:34+02:00,['87dd9be0dd769e867f31e37ab802e818e8d3058f'],46,96,142,17134033,5,1,1,1,12542
caf8aaf9d6efe460138cba8c4e6b4108b7c4b9bb,0,Alex Antonenko,2013-12-19 21:34:54+02:00,['0f045cad761f37428cc7c25cf56880f453c6162f'],2,0,2,17134035,1,0,0,0,12542
43002933c6e69ba664ce282f00ba79dccd3199c6,1,tbeerbower,2013-12-19 15:16:20-05:00,['caf8aaf9d6efe460138cba8c4e6b4108b7c4b9bb'],2,16,18,17134053,3,0,0,1,12542
4f8dadd30809c7f6fdcdcb53f8e337d5f3f27aa7,1,Yusaku Sako,2013-12-19 15:11:18-08:00,['43002933c6e69ba664ce282f00ba79dccd3199c6'],18,8,26,17134079,9,,,,12542
f963f667e3af947e323bac628d1b781fb9a1226f,1,Siddharth Wagle,2013-12-19 21:33:07-08:00,['4f8dadd30809c7f6fdcdcb53f8e337d5f3f27aa7'],5,66,71,17134150,4,0.386363636,1,1,12542
614d4f741843ea76b505cbd207731ef3ccc3d702,1,atkach,2013-12-20 14:32:06+02:00,['f963f667e3af947e323bac628d1b781fb9a1226f'],27,54,81,17134231,8,0.28,0.28,1,12542
07404fb2defadc21e3ea2093ba5a2b4fa74ecacd,0,atkach,2013-12-20 14:45:38+02:00,['614d4f741843ea76b505cbd207731ef3ccc3d702'],1,1,2,17134233,1,,,,12542
40da324a431ab146c1a0d60e92d73e00c78de7f5,1,Alex Antonenko,2013-12-20 16:46:43+02:00,['07404fb2defadc21e3ea2093ba5a2b4fa74ecacd'],0,5,5,17134238,2,0,0,1,12542
b24a797b055fae016759b99cf1bb29ce6f6ba7cb,1,Oleg Nechiporenko,2013-12-20 16:53:58+02:00,['40da324a431ab146c1a0d60e92d73e00c78de7f5'],1,1,2,17134240,1,,,,12542
21d0830929f3f14c4a031acb717e5bd89a8b1b3d,1,Aleksandr Kovalenko,2013-12-20 17:24:16+02:00,['b24a797b055fae016759b99cf1bb29ce6f6ba7cb'],12,55,67,17134307,4,0.95,1,1,12543
30ae2409898e3401e3945a35bdd5e236308aa681,1,Andrew Onischuk,2013-12-20 07:29:38-08:00,['21d0830929f3f14c4a031acb717e5bd89a8b1b3d'],9,932,941,17135248,19,0.324324324,1,1,12561
b7e2fe7c082610f459444f4f9d5ddca23b7ccdbb,1,Oleg Nechiporenko,2013-12-20 17:40:11+02:00,['30ae2409898e3401e3945a35bdd5e236308aa681'],2,2,4,17135252,1,,,,12561
ba8f51094e4d6cef5ad97f947576cd26bf0d1564,0,aBabiichuk,2013-12-20 17:56:57+02:00,['b7e2fe7c082610f459444f4f9d5ddca23b7ccdbb'],0,3,3,17135255,1,1,1,1,12561
52fa294feef250f9dcdc420d1f3c039d1c15720b,1,aBabiichuk,2013-12-20 17:56:58+02:00,['ba8f51094e4d6cef5ad97f947576cd26bf0d1564'],3,7,10,17135265,1,,,,12561
7ae7a7deccd6367c2d55954cff50ed1b68406cbe,0,Lisnichenko Dmitro,2013-12-20 18:30:29+02:00,['52fa294feef250f9dcdc420d1f3c039d1c15720b'],1,1,2,17135267,1,,,,12561
1aabafb087213450816c00db886258966789d08c,1,aBabiichuk,2013-12-20 18:33:41+02:00,['7ae7a7deccd6367c2d55954cff50ed1b68406cbe'],6,6,12,17135279,1,,,,12561
e805ff8431cad3170e1581fdef926c2ead8f899d,1,aBabiichuk,2013-12-20 20:03:57+02:00,['1aabafb087213450816c00db886258966789d08c'],1,1,2,17135281,1,,,,12561
dd900eb8f8323c865287c7fab0b6c26a294e9d14,1,Alex Antonenko,2013-12-20 20:32:24+02:00,['e805ff8431cad3170e1581fdef926c2ead8f899d'],0,2,2,17135283,1,,,,12561
1366975c5f0aab6502e0658a57efdb5cc1190051,1,Siddharth Wagle,2013-12-20 10:50:01-08:00,['dd900eb8f8323c865287c7fab0b6c26a294e9d14'],0,371,371,17135654,22,,,,12567
26dee15eef4d47d61388052328d859f58c696afc,1,Lisnichenko Dmitro,2013-12-20 20:52:30+02:00,['1366975c5f0aab6502e0658a57efdb5cc1190051'],16,16,32,17135686,2,,,,12567
d60ee2cb16f25d799ade3ceb629ad9edb3643049,1,Dmitry Sen,2013-12-20 21:00:50+02:00,['26dee15eef4d47d61388052328d859f58c696afc'],5,227,232,17135918,12,0.197530864,0.567901235,0.567901235,12567
3d362faed500e149963699eccf20d7ca42af2daa,0,Aleksandr Kovalenko,2013-12-20 21:03:50+02:00,['d60ee2cb16f25d799ade3ceb629ad9edb3643049'],3,13,16,17135934,1,1,1,1,12567
079c3c7f8229c37e2aaa8ead41b90b4661318d73,1,Andrew Onischuk,2013-12-20 11:09:38-08:00,['3d362faed500e149963699eccf20d7ca42af2daa'],186,3063,3249,17139183,38,0.224264706,0.545343137,0.884803922,12599
fbe344c815e858dda8b2f883908a19501fadd839,1,Mahadev Konar,2013-12-20 11:13:18-08:00,['079c3c7f8229c37e2aaa8ead41b90b4661318d73'],28693,17,28710,17167893,48,,,,12599
7e8dfeddf30fc73705a1971816f6094d3fee669d,0,Lisnichenko Dmitro,2013-12-20 22:27:43+02:00,['fbe344c815e858dda8b2f883908a19501fadd839'],11,17,28,17167921,4,,,,12599
c5105ee1f43c87d9df4952f1bd218bcae0b99188,1,Yusaku Sako,2013-12-20 15:19:14-08:00,['7e8dfeddf30fc73705a1971816f6094d3fee669d'],3,34,37,17167958,5,0,1,1,12599
31143fac4f281a60a4ed3e65cd3aae32e454c7cf,1,Yusaku Sako,2013-12-20 15:22:19-08:00,['c5105ee1f43c87d9df4952f1bd218bcae0b99188'],11,78,89,17168047,2,1,1,0.666666667,12599
f14dc5e11284fc34a7599e340173b0f7ffb187c7,1,Sumit Mohanty,2013-12-20 17:02:43-08:00,['31143fac4f281a60a4ed3e65cd3aae32e454c7cf'],1,1,2,17168049,1,,,,12599
4a9e9543766cf1d884f06d53c361ca596d71d04a,0,atkach,2013-12-23 13:24:03+02:00,['f14dc5e11284fc34a7599e340173b0f7ffb187c7'],2,2,4,17168053,2,,,,12599
681694856e9008bbb524fa267e78be7c0bfbebe2,1,Oleg Nechiporenko,2013-12-23 14:21:21+02:00,['4a9e9543766cf1d884f06d53c361ca596d71d04a'],3,3,6,17168059,1,,,,12599
3109a921905033df213a3ec22b49033aac030f1a,1,Alex Antonenko,2013-12-23 18:10:01+02:00,['681694856e9008bbb524fa267e78be7c0bfbebe2'],0,13,13,17168072,1,0,0,1,12599
bc783e894c4d06e0957b788fcc7418df8dc95f13,1,aBabiichuk,2013-12-23 19:06:28+02:00,['3109a921905033df213a3ec22b49033aac030f1a'],8,11,19,17168091,1,,,,12599
31be5e3e9d321133c4ec9f183b0feb32719d77e2,1,Oleg Nechiporenko,2013-12-23 19:13:13+02:00,['bc783e894c4d06e0957b788fcc7418df8dc95f13'],2,4,6,17168097,1,1,1,1,12599
eb021c018991edd96fd1b0a3fcf1a44d5f06dfa0,0,Alex Antonenko,2013-12-23 20:02:01+02:00,['31be5e3e9d321133c4ec9f183b0feb32719d77e2'],1,1,2,17168099,1,,,,12599
ef81b392fd583570a3dc031094d28ca8e2418e8e,1,Lisnichenko Dmitro,2013-12-23 23:16:01+02:00,['eb021c018991edd96fd1b0a3fcf1a44d5f06dfa0'],19,22,41,17168140,243,1,1,1,12599
5dcea3726e53eea4243510da156a9c8f145f51ef,1,Siddharth Wagle,2013-12-23 14:12:55-08:00,['ef81b392fd583570a3dc031094d28ca8e2418e8e'],333,3871,4204,17172344,55,0.373582766,0.866213152,0.925736961,12622
8757aeb96b007de0a458f36242b5e93f2c003c29,1,Yusaku Sako,2013-12-23 14:52:58-08:00,['5dcea3726e53eea4243510da156a9c8f145f51ef'],10,28,38,17172382,3,,,,12622
8860005f923ec7e64b7db1731e8567b221645286,1,Lisnichenko Dmitro,2013-12-24 17:02:52+02:00,['8757aeb96b007de0a458f36242b5e93f2c003c29'],31,69,100,17172482,4,,,,12623
b3659b0f3f7f6d7bf9ab23771d5c01e33297f5bc,1,Oleg Nechiporenko,2013-12-24 17:20:14+02:00,['8860005f923ec7e64b7db1731e8567b221645286'],7,40,47,17172529,3,0.966666667,0.966666667,1,12623
95fb387b9f7f3960f8c7280311ebc32a0023f9e3,1,Andrew Onischuk,2013-12-24 07:46:19-08:00,['b3659b0f3f7f6d7bf9ab23771d5c01e33297f5bc'],8,4634,4642,17177171,35,0.480113636,0.840909091,0.846590909,12656
fe8d9ab2cd288953e4262d3e8d53466fbd51d7f3,1,Andrew Onischuk,2013-12-24 08:10:44-08:00,['95fb387b9f7f3960f8c7280311ebc32a0023f9e3'],17,609,626,17177797,10,0.588652482,1,1,12665
8c2895f9dbe176f64a327a3beacf9da0f3e69f74,1,Oleksandr Diachenko,2013-12-24 18:15:04+02:00,['fe8d9ab2cd288953e4262d3e8d53466fbd51d7f3'],20,244,264,17178061,7,0.128205128,0.666666667,0.993589744,12665
e51ba1e984560ca61b20f5395c9b14505195fd44,1,aBabiichuk,2013-12-24 18:16:03+02:00,['8c2895f9dbe176f64a327a3beacf9da0f3e69f74'],23,43,66,17178127,6,1,0,0,12665
35a196298557bba4ce02ba01ea2e501990ff9643,1,Andrew Onischuk,2013-12-24 08:20:09-08:00,['e51ba1e984560ca61b20f5395c9b14505195fd44'],11,549,560,17178687,11,0.259541985,1,0.809160305,12674
09da7397e1ce07d45d969f2f6b895572f95e65e3,0,Myroslav Papirkovskyy,2013-12-24 19:50:49+02:00,['35a196298557bba4ce02ba01ea2e501990ff9643'],1,1,2,17178689,1,,,,12674
0776b7f77fdf05a5e2f5b4a031cd7c320f7bf7ec,0,Oleg Nechiporenko,2013-12-24 20:18:29+02:00,['09da7397e1ce07d45d969f2f6b895572f95e65e3'],5,7,12,17178701,1,,,,12674
0d30fb95ef4723f7cfe7f924a8cc6705b5237d97,1,Andrew Onischuk,2013-12-24 11:42:33-08:00,['0776b7f77fdf05a5e2f5b4a031cd7c320f7bf7ec'],14,676,690,17179391,12,0.301675978,0.82122905,1,12685
236d94ed2b33015fde5d74cff13ff655c3c2b227,1,Andrew Onischuk,2013-12-24 11:49:05-08:00,['0d30fb95ef4723f7cfe7f924a8cc6705b5237d97'],98,221,319,17179710,8,0.6,1,1,12688
88619ef2778264b8125be926aa4a36c4c92883f4,1,Oleg Nechiporenko,2013-12-25 13:05:07+02:00,['236d94ed2b33015fde5d74cff13ff655c3c2b227'],1,1,2,17179712,1,,,,12688
8108ca459514ce2aea84fb612804c6f1d8b5a950,1,Oleg Nechiporenko,2013-12-25 13:22:24+02:00,['88619ef2778264b8125be926aa4a36c4c92883f4'],2,4,6,17179718,1,1,1,1,12688
d522edb374c5421f9f0ed31f664e76ec5cffbc83,1,atkach,2013-12-25 15:05:24+02:00,['8108ca459514ce2aea84fb612804c6f1d8b5a950'],109,91,200,17179918,3,0.8125,0.96875,0,12688
aafadc5d5072e5daa63daed2fa2934492cc5753c,1,atkach,2013-12-25 15:06:29+02:00,['d522edb374c5421f9f0ed31f664e76ec5cffbc83'],10,15,25,17179943,4,0.75,0.75,1,12688
6f17e44c05f4cdc0462e3c686214251610597cc2,1,Oleg Nechiporenko,2013-12-25 15:24:28+02:00,['aafadc5d5072e5daa63daed2fa2934492cc5753c'],116,37,153,17180096,5,0.114754098,0,0,12688
4790e35e4629087fc551952c8af118d45c26b466,1,atkach,2013-12-25 15:33:14+02:00,['6f17e44c05f4cdc0462e3c686214251610597cc2'],8,8,16,17180112,1,,,,12688
2a48ee546e511ec44dbb0554b43ec9d5ef57237d,1,Andrew Onischuk,2013-12-25 07:48:37-08:00,['4790e35e4629087fc551952c8af118d45c26b466'],29,2829,2858,17182970,36,0.169291339,0.519685039,0.881889764,12720
47d2ff693b2f633c0c19bbff075701d8c00f7f32,0,Oleg Nechiporenko,2013-12-25 17:53:20+02:00,['2a48ee546e511ec44dbb0554b43ec9d5ef57237d'],0,1,1,17182971,1,1,1,1,12720
aefbc614214c39b26fe1dcdfb54ca7817fb99e08,1,Andrew Onischuk,2013-12-25 10:07:58-08:00,['47d2ff693b2f633c0c19bbff075701d8c00f7f32'],17,14654,14671,17197642,23,0.528384279,1,0.969432314,12742
8c277cb554ef80119b0c133ca189e7725d0eeb28,0,Myroslav Papirkovskyy,2013-12-25 20:24:34+02:00,['aefbc614214c39b26fe1dcdfb54ca7817fb99e08'],1,1,2,17197644,1,,,,12742
6f38b1bdb5bff8b1a8fa485ec268a1340d6e727e,0,Vitaly Brodetskyi,2013-12-26 13:47:02+02:00,['8c277cb554ef80119b0c133ca189e7725d0eeb28'],2,6,8,17197652,2,0,0,1,12742
c742935524bc9dafc22fe06fddad7ceb1934ad69,1,aBabiichuk,2013-12-26 14:22:00+02:00,['6f38b1bdb5bff8b1a8fa485ec268a1340d6e727e'],12,11,23,17197675,2,1,0,0,12742
05e8fe3d7def440d2791aeb5e8e8400f0e891f48,1,Oleg Nechiporenko,2013-12-26 14:27:17+02:00,['c742935524bc9dafc22fe06fddad7ceb1934ad69'],2,3,5,17197680,1,1,1,1,12742
91ec1eaba4b93b4bee654587a5ae1d8b9100c6ac,1,atkach,2013-12-26 14:59:37+02:00,['05e8fe3d7def440d2791aeb5e8e8400f0e891f48'],1,1,2,17197682,1,,0,,12742
35196a776aeaf1712773988b07dd81eec537a838,1,Oleksandr Diachenko,2013-12-26 16:41:17+02:00,['91ec1eaba4b93b4bee654587a5ae1d8b9100c6ac'],2,3,5,17197687,1,,,,12742
ef6d3af8d8fee1086f239197afb8f7e81d95c674,1,Mahadev Konar,2013-12-26 12:38:59-08:00,['35196a776aeaf1712773988b07dd81eec537a838'],9,9,18,17197705,9,,,,12742
37d59a55eb348e7ebc831522e75d56678eb7d012,1,Oleg Nechiporenko,2013-12-27 14:44:02+02:00,['ef6d3af8d8fee1086f239197afb8f7e81d95c674'],30,5,35,17197740,3,0,0,1,12742
44f03fb18d212cac319e45207c17d438530a4209,1,atkach,2013-12-27 17:08:24+02:00,['37d59a55eb348e7ebc831522e75d56678eb7d012'],41,72,113,17197853,4,0,1,1,12742
2c65034e8bf4d4d3beac51d150a68ca150972b16,1,aBabiichuk,2013-12-27 17:54:37+02:00,['44f03fb18d212cac319e45207c17d438530a4209'],9,13,22,17197875,2,0,0,1,12742
8bc7ee984eda04801b0e9835ad70906618c86fa7,0,atkach,2013-12-27 17:55:00+02:00,['2c65034e8bf4d4d3beac51d150a68ca150972b16'],4,6,10,17197885,1,,,,12742
84ad92a529878af1ee874d4dc8305e0ed7c6b94e,1,Alex Antonenko,2013-12-27 19:08:51+02:00,['8bc7ee984eda04801b0e9835ad70906618c86fa7'],4,2,6,17197891,2,,,,12742
375172c8eb350d25b73efc62a4637ac65f27d3c0,1,Oleksandr Diachenko,2013-12-27 20:36:02+02:00,['84ad92a529878af1ee874d4dc8305e0ed7c6b94e'],264,404,668,17198559,8,0,1,1,12743
f0be471404f90af602b79d368cc8091560a891b1,1,Dmitry Sen,2013-12-27 22:44:30+02:00,['375172c8eb350d25b73efc62a4637ac65f27d3c0'],22,25,47,17198606,1,1,1,1,12743
33f95a12a31bfd01e5135ab8e4586affb6b815c9,0,Siddharth Wagle,2013-12-27 13:04:08-08:00,['f0be471404f90af602b79d368cc8091560a891b1'],1,1,2,17198608,1,,,,12743
cfb53ad77628d1ef7b32e4146ac6b726b0621bb2,0,Dmitry Sen,2013-12-27 23:32:46+02:00,['33f95a12a31bfd01e5135ab8e4586affb6b815c9'],1,1,2,17198610,1,,,,12743
6295e773d221e07e4cb36bba0575b1375051e648,1,Yusaku Sako,2013-12-27 13:54:31-08:00,['cfb53ad77628d1ef7b32e4146ac6b726b0621bb2'],2,5,7,17198617,3,,,,12743
873e9b34b07c062fdce3e3a5171ff1cc73b60188,1,Yusaku Sako,2013-12-27 14:40:49-08:00,['6295e773d221e07e4cb36bba0575b1375051e648'],1,5,6,17198623,2,,1,,12743
c80d16e7f58f8d8bd1c959ddce75c7bd2ee99c4b,0,Yusaku Sako,2013-12-27 23:18:34-08:00,['873e9b34b07c062fdce3e3a5171ff1cc73b60188'],6,5,11,17198634,7,0,0,0,12743
c1375bcca70b26e06970d00c0f7103b355f56362,0,Nate Cole,2013-12-28 08:32:53-05:00,['c80d16e7f58f8d8bd1c959ddce75c7bd2ee99c4b'],1,1,2,17198636,1,,,,12743
1dc1cf108cd64ecd7b25b2c1c079582d24bf37b2,1,Andrew Onischuk,2013-12-30 04:16:50-08:00,['c1375bcca70b26e06970d00c0f7103b355f56362'],92,1298,1390,17200026,28,0.432989691,0.907216495,1,12767
7326ebe580113048b5fabb1e01684e2883fa2b2a,1,Andrew Onischuk,2013-12-30 04:21:00-08:00,['1dc1cf108cd64ecd7b25b2c1c079582d24bf37b2'],16,14,30,17200056,8,,0,,12767
8848236005fac7eb989624d01b3fcb33d3cb51ef,1,Andrew Onischuk,2013-12-30 04:58:46-08:00,['7326ebe580113048b5fabb1e01684e2883fa2b2a'],17,17,34,17200090,240,,,,12767
3d82c1175341feb2499b7700be2b4017b9dadb4d,1,aBabiichuk,2013-12-30 15:51:07+02:00,['8848236005fac7eb989624d01b3fcb33d3cb51ef'],1,11,12,17200102,2,,,,12767
ba0bff86100542ed3bdd84bf46653d8c2f3bcc30,1,Oleg Nechiporenko,2013-12-30 16:04:46+02:00,['3d82c1175341feb2499b7700be2b4017b9dadb4d'],27,29,56,17200158,3,1,1,1,12767
c868b2e0e1834e0eb530834571d31e766d560164,0,Yusaku Sako,2013-12-30 07:58:51-08:00,['ba0bff86100542ed3bdd84bf46653d8c2f3bcc30'],2,2,4,17200162,1,,,,12767
f3fbc2e9df894b81ec4c9a0f5c9b5279212a16ee,1,atkach,2013-12-30 19:36:37+02:00,['c868b2e0e1834e0eb530834571d31e766d560164'],2,2,4,17200166,1,,,,12767
d1f17bff041d154cef9b87ea5fd32389d9ff1ca1,0,Yusaku Sako,2013-12-30 13:45:50-08:00,['f3fbc2e9df894b81ec4c9a0f5c9b5279212a16ee'],1,1,2,17200168,1,,,,12767
2b21ff7edcc572a236ee605aa923c98c5b49a3eb,1,atkach,2013-12-31 11:05:55+02:00,['d1f17bff041d154cef9b87ea5fd32389d9ff1ca1'],3,3,6,17200174,1,,,,12767
5eeb4241d2ab269669aa5f6b8f4d054545d46428,1,atkach,2013-12-31 14:30:53+02:00,['2b21ff7edcc572a236ee605aa923c98c5b49a3eb'],2,266,268,17200442,6,0.21319797,0.314720812,0.888324873,12767
2ef018b47885554873e03ab02953fa39cf43273d,1,Oleksandr Diachenko,2013-12-31 18:06:16+02:00,['5eeb4241d2ab269669aa5f6b8f4d054545d46428'],183,656,839,17201281,19,0.416666667,0.657407407,0.939814815,12769
7643202353f203f72e43ed06984e3893bfbdf97e,1,Myroslav Papirkovskyy,2013-12-31 18:59:08+02:00,['2ef018b47885554873e03ab02953fa39cf43273d'],41,43,84,17201365,1,1,1,1,12769
10dc7d6addeeb0a243737a0788abb602608916dc,1,aBabiichuk,2014-01-02 15:02:22+02:00,['7643202353f203f72e43ed06984e3893bfbdf97e'],3,34,37,17201402,9,0,0,1,12769
645408d542f4913e21f1c53952fa4a84c40d9f92,1,Andrew Onischuk,2014-01-02 05:51:04-08:00,['10dc7d6addeeb0a243737a0788abb602608916dc'],0,2,2,17201404,2,,,,12769
87686b64a416d4de765af3c0a7adfcba985c23bf,1,Andrew Onischuk,2014-01-02 05:59:16-08:00,['645408d542f4913e21f1c53952fa4a84c40d9f92'],2,1,3,17201407,1,,,,12769
67bc855462edf48bc9ae3b4d9bd52ccc80482a9e,1,atkach,2014-01-02 17:47:15+02:00,['87686b64a416d4de765af3c0a7adfcba985c23bf'],1,28,29,17201436,4,0.086956522,0,1,12769
b4ad188e14dff92670cabea0a2768927118cea78,1,Andrew Onischuk,2014-01-02 09:25:37-08:00,['67bc855462edf48bc9ae3b4d9bd52ccc80482a9e'],0,148,148,17201584,1,1,1,0,12770
e66947e815c599afbee8634eca1a5f0b530ba232,0,atkach,2014-01-02 19:35:49+02:00,['b4ad188e14dff92670cabea0a2768927118cea78'],3,5,8,17201592,1,0,1,1,12770
72d92b88922bf267ac1a60cd6864b1b463c59251,1,Andrew Onischuk,2014-01-02 10:01:02-08:00,['e66947e815c599afbee8634eca1a5f0b530ba232'],226,399,625,17202217,38,0.142857143,0.421768707,0.700680272,12770
afa0d7baf239ee68be69ec3fac8a2628ca2d5a72,1,Andrew Onischuk,2014-01-02 10:01:02-08:00,['72d92b88922bf267ac1a60cd6864b1b463c59251'],21,22,43,17202260,5,0.5,1,1,12770
b15eca4a0e6371f7e548dce4b381d97412df6831,1,Sumit Mohanty,2014-01-02 10:20:01-08:00,['afa0d7baf239ee68be69ec3fac8a2628ca2d5a72'],101,111,212,17202472,6,0.0625,1,1,12770
1e0326ba460ec76c3756aabba5e97372bc17220d,1,Nate Cole,2014-01-02 15:24:56-05:00,['b15eca4a0e6371f7e548dce4b381d97412df6831'],250,803,1053,17203525,20,0.056603774,0.056603774,1,12771
082042e82f998fd39c2b6af30fc6ba282ece99a5,0,Mahadev Konar,2014-01-02 13:14:10-08:00,['1e0326ba460ec76c3756aabba5e97372bc17220d'],1,1,2,17203527,1,,,,12771
a74eb1fc14cecee859cf0239ba662414b14d72d8,1,Siddharth Wagle,2014-01-02 14:13:14-08:00,['082042e82f998fd39c2b6af30fc6ba282ece99a5'],3,2,5,17203532,2,0,0,0,12771
54549b2d737c26cf577d8e27c6c63b2d92cf8958,1,Siddharth Wagle,2014-01-02 15:53:58-08:00,['a74eb1fc14cecee859cf0239ba662414b14d72d8'],52,422,474,17204006,13,0.476470588,0.823529412,1,12773
0872ee698b54afee174465a0bf03bb35157396e4,1,Andrew Onischuk,2014-01-03 01:36:08-08:00,['54549b2d737c26cf577d8e27c6c63b2d92cf8958'],24,12,36,17204042,6,1,1,1,12773
e833a724321054292826269afedf856a8a06edef,1,Aleksandr Kovalenko,2014-01-03 14:52:39+02:00,['0872ee698b54afee174465a0bf03bb35157396e4'],136,166,302,17204344,7,1,1,1,12773
48933cbdf52af8de6fb0dbb680ac5f14a150ef57,1,Oleg Nechiporenko,2014-01-03 15:00:55+02:00,['e833a724321054292826269afedf856a8a06edef'],1,1,2,17204346,1,,,,12773
09f1c98a23edd1a8f215552fe3b9c3e98969c300,1,atkach,2014-01-03 15:06:35+02:00,['48933cbdf52af8de6fb0dbb680ac5f14a150ef57'],3,7,10,17204356,2,0,1,1,12773
bf0aee7f62b404475e9acdb9ff34d4e306135f8b,0,atkach,2014-01-03 16:22:21+02:00,['09f1c98a23edd1a8f215552fe3b9c3e98969c300'],0,6,6,17204362,1,1,1,1,12773
13ac36e28bfec6c40f627001aca421ceca16f627,1,Andrew Onischuk,2014-01-03 07:25:52-08:00,['bf0aee7f62b404475e9acdb9ff34d4e306135f8b'],32,51,83,17204445,7,1,1,1,12773
f8d0acb83b68c0a1bf6d72add7ce18179dd93e33,1,Nate Cole,2014-01-03 10:38:12-05:00,['13ac36e28bfec6c40f627001aca421ceca16f627'],24,8,32,17204477,4,,,,12773
80751f135ab0a5f5ffc04d93ed1ca36d3ac20e47,1,atkach,2014-01-03 18:15:00+02:00,['f8d0acb83b68c0a1bf6d72add7ce18179dd93e33'],16,16,32,17204509,1,1,1,0,12773
0df2b18171763d484c7fea35aff4de2522ded27e,1,Nate Cole,2014-01-03 13:18:13-05:00,['80751f135ab0a5f5ffc04d93ed1ca36d3ac20e47'],36,69,105,17204614,3,0,1,1,12774
5774dd81c62f48130b34b2f3c50e58c599c0d5c1,1,Sumit Mohanty,2014-01-03 11:58:43-08:00,['0df2b18171763d484c7fea35aff4de2522ded27e'],5,121,126,17204740,4,0.11627907,0.895348837,1,12774
35df112e6d8380e786f5e584015279f23c0ad855,0,Mahadev Konar,2014-01-03 14:32:40-08:00,['5774dd81c62f48130b34b2f3c50e58c599c0d5c1'],12,7,19,17204759,3,,,,12774
57a93d64d16c005e16f01a73cb725faabfd99483,1,Sumit Mohanty,2014-01-03 15:13:55-08:00,['35df112e6d8380e786f5e584015279f23c0ad855'],37,55,92,17204851,2,0,0.8,1,12774
470c3436f60527f20948a9b70da66f07d22b06f2,0,Mahadev Konar,2014-01-03 15:22:45-08:00,['57a93d64d16c005e16f01a73cb725faabfd99483'],9,9,18,17204869,1,,,,12774
8056bb3db5c4dc761bf9d2f1efb4e730456e0841,0,Yusaku Sako,2014-01-03 15:49:52-08:00,['470c3436f60527f20948a9b70da66f07d22b06f2'],0,2,2,17204871,1,,,,12774
14e28135e715f3861f7177d4499e8abdb266bae0,1,Yusaku Sako,2014-01-03 16:25:19-08:00,['8056bb3db5c4dc761bf9d2f1efb4e730456e0841'],44,105,149,17205020,3,1,1,1,12774
a440c0a84ce5dfb1c5cd7a14fe0f78c6206cc3ec,1,Oleg Nechiporenko,2014-01-06 15:16:23+02:00,['14e28135e715f3861f7177d4499e8abdb266bae0'],800,2871,3671,17208691,15,0.37037037,1,1,12774
ad3bc8efbc3d93edc1294ce39230e605fd9c338d,1,aBabiichuk,2014-01-06 19:02:37+02:00,['a440c0a84ce5dfb1c5cd7a14fe0f78c6206cc3ec'],35,121,156,17208847,6,0.363636364,0.909090909,1,12774
0b04d90e3e6ca19030b2fdc37333368320fd9055,1,aBabiichuk,2014-01-06 20:00:31+02:00,['ad3bc8efbc3d93edc1294ce39230e605fd9c338d'],2,11,13,17208860,2,,,,12774
8985c71dc624f3ec58f0cca21b8ca83fbbc7e6b2,1,Nate Cole,2014-01-06 13:11:37-05:00,['0b04d90e3e6ca19030b2fdc37333368320fd9055'],13639,4,13643,17222503,3,,,,12774
f6379480dfbb694f8ce5f7e145d7413081e6fe9b,0,Chad Roberts,2014-01-06 13:31:21-05:00,['8985c71dc624f3ec58f0cca21b8ca83fbbc7e6b2'],2,14,16,17222519,2,,,,12774
f661509a40a85a5850623e604762555a3fb0a63d,0,Yusaku Sako,2014-01-06 16:50:03-08:00,['f6379480dfbb694f8ce5f7e145d7413081e6fe9b'],14,2,16,17222535,2,,,,12774
2e9a93faedab008de110a4f69d54f1478de21a9b,1,Yusaku Sako,2014-01-06 17:15:03-08:00,['f661509a40a85a5850623e604762555a3fb0a63d'],4,13,17,17222552,7,1,1,1,12774
9457a5715b5dae980529863358aa12cdbc5a2114,1,Siddharth Wagle,2014-01-06 17:30:15-08:00,['2e9a93faedab008de110a4f69d54f1478de21a9b'],0,51,51,17222603,3,0.25,0.85,1,12775
5da0039823cf108f7fe5361d56ce558477f9619b,1,Siddharth Wagle,2014-01-07 10:17:33-08:00,['9457a5715b5dae980529863358aa12cdbc5a2114'],280,1057,1337,17223940,24,0.097345133,0.559734513,1,12777
1c7e66dadf2630b165c98d92f7c37613ed712775,1,Siddharth Wagle,2014-01-07 10:56:31-08:00,['5da0039823cf108f7fe5361d56ce558477f9619b'],171,170,341,17224281,1,,,,12777
12609b27d87aca2223f702b5a4abd0541003cdcf,1,Siddharth Wagle,2014-01-07 13:17:07-08:00,['1c7e66dadf2630b165c98d92f7c37613ed712775'],1,69,70,17224351,2,1,1,1,12778
d507500e4354dcea7a271f7b30b5ab8285d453b1,0,Siddharth Wagle,2014-01-07 13:18:03-08:00,['12609b27d87aca2223f702b5a4abd0541003cdcf'],1,1,2,17224353,1,,,,12778
a0c5805e299ef22643f4791ac4a019af24cf7ba3,0,Sumit Mohanty,2014-01-07 13:27:53-08:00,['d507500e4354dcea7a271f7b30b5ab8285d453b1'],6,6,12,17224365,2,,,,12778
56b888078431d7f67aecfcd84a5eb7b18dad2e9a,1,Siddharth Wagle,2014-01-07 17:10:09-08:00,['a0c5805e299ef22643f4791ac4a019af24cf7ba3'],0,7,7,17224372,1,,,,12778
5e5d119d0914d070136cf7a8bf6078fad724b61f,1,Andrew Onischuk,2014-01-08 03:45:42-08:00,['56b888078431d7f67aecfcd84a5eb7b18dad2e9a'],0,72,72,17224444,1,1,1,1,12779
fb73489094de066c55222897a1b1e832980663ab,0,Vitaly Brodetskyi,2014-01-08 14:37:45+02:00,['5e5d119d0914d070136cf7a8bf6078fad724b61f'],0,32,32,17224476,1,,,,12780
a30ece3e0b6907d9f30cc46bac33e345879c7381,0,Chad Roberts,2014-01-08 09:29:07-05:00,['fb73489094de066c55222897a1b1e832980663ab'],8,24,32,17224508,2,,,,12780
366a263c4a6d05d086d6c42b133debcf2384e843,0,Chad Roberts,2014-01-08 09:35:30-05:00,['a30ece3e0b6907d9f30cc46bac33e345879c7381'],24,8,32,17224540,2,,,,12780
7a25e8557f62b5f36b7405eb8f3fbca634725b01,0,Aleksandr Kovalenko,2014-01-08 17:21:15+02:00,['366a263c4a6d05d086d6c42b133debcf2384e843'],72,54,126,17224666,5,1,1,1,12780
d025b06e68600852ceb45e7cf11b22ed3f8efd5e,1,Alex Antonenko,2014-01-08 18:14:08+02:00,['7a25e8557f62b5f36b7405eb8f3fbca634725b01'],9,95,104,17224770,10,0.6,0.533333333,1,12780
ead9758cafecb602f8db0c1e5400557f71ac9220,1,John Speidel,2014-01-08 12:17:41-05:00,['d025b06e68600852ceb45e7cf11b22ed3f8efd5e'],0,3,3,17224773,1,,,,12780
2999ec6c192d57cdafd5a7e53432ecdf5f1dc199,1,Andrew Onischuk,2014-01-08 09:26:15-08:00,['ead9758cafecb602f8db0c1e5400557f71ac9220'],0,802,802,17225575,7,0.764705882,1,0.764705882,12787
a45eb1aa21d139c194436b736138607a313da039,1,John Speidel,2014-01-08 16:17:11-05:00,['2999ec6c192d57cdafd5a7e53432ecdf5f1dc199'],0,3,3,17225578,1,,,,12787
06c971ea3c65e1f44851d1e739f085d1927a48e8,1,atkach,2014-01-09 13:07:59+02:00,['a45eb1aa21d139c194436b736138607a313da039'],119,68,187,17225765,12,0.444444444,0.444444444,0,12787
8448978de7457f3f3571da5cb8bf3fadbbbf43a4,1,Vitaly Brodetskyi,2014-01-09 13:11:16+02:00,['06c971ea3c65e1f44851d1e739f085d1927a48e8'],2,2,4,17225769,2,,,,12787
c95c7f75cfb43e7705b785a584067b644e9f374b,1,Oleg Nechiporenko,2014-01-09 14:10:56+02:00,['8448978de7457f3f3571da5cb8bf3fadbbbf43a4'],8,70,78,17225847,9,1,1,1,12788
365e8dcddcb73768426958064e2782be569e1ee6,0,Oleg Nechiporenko,2014-01-09 14:24:23+02:00,['c95c7f75cfb43e7705b785a584067b644e9f374b'],0,0,0,17225847,1,,,,12788
a4011020dbd0b483295d68b50d5439ba445563a3,1,atkach,2014-01-09 14:36:19+02:00,['365e8dcddcb73768426958064e2782be569e1ee6'],4,3,7,17225854,3,0,0,0,12788
58210ab8975a70d10c2b7b2c933c17027ac54213,1,Oleg Nechiporenko,2014-01-09 16:08:28+02:00,['a4011020dbd0b483295d68b50d5439ba445563a3'],68,188,256,17226110,9,0.58490566,0.320754717,1,12788
4e53fa2a35cd1a7b4ed115378a207fa298208954,0,Alex Antonenko,2014-01-09 18:37:33+02:00,['58210ab8975a70d10c2b7b2c933c17027ac54213'],0,4,4,17226114,1,1,1,1,12788
24e58d5c61278da363108c0a0a4a41d009c0da2f,1,Aleksandr Kovalenko,2014-01-09 19:06:36+02:00,['4e53fa2a35cd1a7b4ed115378a207fa298208954'],15,335,350,17226464,14,1,1,1,12791
00ba34dfe886ff45921c1bb30dbef6c24c10604c,0,Siddharth Wagle,2014-01-09 10:16:28-08:00,['24e58d5c61278da363108c0a0a4a41d009c0da2f'],5,4,9,17226473,1,1,1,1,12791
7349a52490ee4f9d9a58cbf936f9a97a378f9cab,0,Alex Antonenko,2014-01-09 22:18:09+02:00,['00ba34dfe886ff45921c1bb30dbef6c24c10604c'],8,80,88,17226561,6,0.529411765,0.970588235,1,12791
95b71281f7fc17c4838903cfa334d83422b9dd4e,1,Siddharth Wagle,2014-01-09 12:38:35-08:00,['7349a52490ee4f9d9a58cbf936f9a97a378f9cab'],30,234,264,17226825,17,0.205673759,0.90070922,0.985815603,12791
e8a03c8dfec0e848bc816852a00e81759d29c712,0,Siddharth Wagle,2014-01-09 13:23:15-08:00,['95b71281f7fc17c4838903cfa334d83422b9dd4e'],0,1,1,17226826,1,0,0,1,12791
35c0cdf659b8de11a5e1fb1501f69a7a9b4ed67e,1,Siddharth Wagle,2014-01-09 16:18:16-08:00,['e8a03c8dfec0e848bc816852a00e81759d29c712'],6,56,62,17226888,3,0,1,1,12791
f2867353600d93079b8ab66216d2b6b1c82187c4,1,Nate Cole,2014-01-09 19:53:06-05:00,['35c0cdf659b8de11a5e1fb1501f69a7a9b4ed67e'],0,1383,1383,17228271,7,0.268096515,0.179624665,0.777479893,12796
e60bf801c50f47c868b76f152a35599acadb14f4,1,Siddharth Wagle,2014-01-09 17:10:50-08:00,['f2867353600d93079b8ab66216d2b6b1c82187c4'],28,26,54,17228325,10,,,,12796
19e31745a4352de38d9f790c739f96a255fa59b2,0,Siddharth Wagle,2014-01-09 17:10:50-08:00,['e60bf801c50f47c868b76f152a35599acadb14f4'],2,2,4,17228329,1,,,,12796
0ad06758fa17927d93068fe413cf17fd7e89e86f,1,atkach,2014-01-10 15:33:18+02:00,['19e31745a4352de38d9f790c739f96a255fa59b2'],39,49,88,17228417,6,0.9,1,1,12796
bbccf12265c515dd41deb59b5a56f29350467384,1,Oleg Nechiporenko,2014-01-10 16:28:11+02:00,['0ad06758fa17927d93068fe413cf17fd7e89e86f'],2,376,378,17228795,8,1,1,1,12799
7b8a705caae019f04a518ffb95224f654d5b822b,1,Andrew Onischuk,2014-01-10 06:34:20-08:00,['bbccf12265c515dd41deb59b5a56f29350467384'],1,122,123,17228918,7,0,0,1,12800
63a08d09ca07dc1ba28ce1d3a22c79787c67253e,1,Andrew Onischuk,2014-01-10 07:40:46-08:00,['7b8a705caae019f04a518ffb95224f654d5b822b'],0,43,43,17228961,4,0.285714286,0.714285714,1,12801
727f082ac9a59c1420059cc42c05e1925fb5fd59,1,Alex Antonenko,2014-01-10 17:55:36+02:00,['63a08d09ca07dc1ba28ce1d3a22c79787c67253e'],13,168,181,17229142,16,0.742857143,0.771428571,1,12802
5550a6452e091289c9a7eeb99ff733d0183ccf9e,0,Alex Antonenko,2014-01-10 20:07:03+02:00,['727f082ac9a59c1420059cc42c05e1925fb5fd59'],37,56,93,17229235,2,1,1,1,12802
dbb345b6ac29a909eebd48896379ac54997d079e,1,Nate Cole,2014-01-10 15:14:06-05:00,['5550a6452e091289c9a7eeb99ff733d0183ccf9e'],1,1,2,17229237,1,,,,12802
3e81b773f72c06c2ce7a6c07ce9ae1a214712f41,0,Srimanth Gunturi,2014-01-10 13:21:16-08:00,['dbb345b6ac29a909eebd48896379ac54997d079e'],1,473,474,17229711,9,0.535211268,0.633802817,0.840375587,12805
7e73eba61ed19ff7002b05eb5ea11abf966fdc7d,0,Srimanth Gunturi,2014-01-10 13:33:32-08:00,['3e81b773f72c06c2ce7a6c07ce9ae1a214712f41'],473,1,474,17230185,9,0.464788732,0.366197183,0.159624413,12805
93338ed9fd80bc996f8251abba4b429d2e0be213,1,Srimanth Gunturi,2014-01-10 13:36:02-08:00,['7e73eba61ed19ff7002b05eb5ea11abf966fdc7d'],1,473,474,17230659,9,0.535211268,0.633802817,0.840375587,12808
46d3fa97d728bf0e475e8ef40a44d6b1a7dd6b4e,1,Vitaly Brodetskyi,2014-01-13 12:43:51+02:00,['93338ed9fd80bc996f8251abba4b429d2e0be213'],0,26,26,17230685,4,,,,12808
4316bf08db99ad8045aa404433df90f40041cb89,0,atkach,2014-01-13 14:32:44+02:00,['46d3fa97d728bf0e475e8ef40a44d6b1a7dd6b4e'],39,44,83,17230768,3,0,1,1,12808
e3722e9b7ee59bc433b83951d297d34f80c73021,1,Andrew Onischuk,2014-01-13 05:32:34-08:00,['4316bf08db99ad8045aa404433df90f40041cb89'],32,59,91,17230859,2,0,0,1,12808
6343a9011665517d5b8c84fd677b033c0151e8fc,0,John Speidel,2014-01-13 10:50:34-05:00,['e3722e9b7ee59bc433b83951d297d34f80c73021'],2,9,11,17230870,1,1,1,1,12808
6c6f00122e5ea3b90876a8cc56ccf83f5ee03275,1,Alex Antonenko,2014-01-13 19:10:30+02:00,['6343a9011665517d5b8c84fd677b033c0151e8fc'],7,226,233,17231103,29,0.53125,0.46875,1,12809
e8c40593cecabb177a7cbad23288bdf8caab23f6,1,Alex Antonenko,2014-01-13 19:48:48+02:00,['6c6f00122e5ea3b90876a8cc56ccf83f5ee03275'],46,53,99,17231202,5,0.108108108,1,1,12809
46d86dc808c9118dcfe31d9b77dcc08c639afdd0,0,Alex Antonenko,2014-01-13 20:02:14+02:00,['e8c40593cecabb177a7cbad23288bdf8caab23f6'],0,1,1,17231203,1,,,,12809
c86976551f4dd1a437bed6e728ae39bbc2040736,1,Myroslav Papirkovskyy,2014-01-13 23:44:11+02:00,['46d86dc808c9118dcfe31d9b77dcc08c639afdd0'],636,2405,3041,17234244,51,0.393650794,0.601058201,0.894179894,12821
5d3677f7485f4d1016a9caaa105e6be42813bce8,1,Sumit Mohanty,2014-01-13 14:08:35-08:00,['c86976551f4dd1a437bed6e728ae39bbc2040736'],1221,13482,14703,17248947,105,0.272569444,0.677951389,0.938368056,12872
73057ba0adc2ff9c29dc737f5857e8ede91a3169,0,Sumit Mohanty,2014-01-13 15:28:46-08:00,['5d3677f7485f4d1016a9caaa105e6be42813bce8'],22,0,22,17248969,1,,,,12872
70dd8ae247b4690255f717b1f75c2d44cf06b56a,1,Mahadev Konar,2014-01-13 15:49:47-08:00,['73057ba0adc2ff9c29dc737f5857e8ede91a3169'],14,26,40,17249009,1,0.461538462,1,1,12872
144755b2bbc72e7268f20b4594a011b624efa89b,1,Siddharth Wagle,2014-01-13 16:08:01-08:00,['70dd8ae247b4690255f717b1f75c2d44cf06b56a'],4,15,19,17249028,3,0,0,1,12872
04fa77eba7ea087a85b54d036ebf502fbea458a9,0,Siddharth Wagle,2014-01-13 17:07:56-08:00,['144755b2bbc72e7268f20b4594a011b624efa89b'],2,1,3,17249031,1,1,0,0,12872
b1d187fb29f27a2013dd13072cc58b70ac0fb88b,1,Vitaly Brodetskyi,2014-01-14 11:40:47+02:00,['04fa77eba7ea087a85b54d036ebf502fbea458a9'],5,5,10,17249041,3,,,,12872
122dc8397cf8d91aae315e64dbda5067825a1139,1,Oleg Nechiporenko,2014-01-14 14:00:19+02:00,['b1d187fb29f27a2013dd13072cc58b70ac0fb88b'],95,250,345,17249386,4,1,1,0,12873
029b055592ea9f348fa4f2edae57cfdd00565db2,1,Oleg Nechiporenko,2014-01-14 17:47:25+02:00,['122dc8397cf8d91aae315e64dbda5067825a1139'],5,19,24,17249410,1,1,1,1,12873
9395e1f8797104c80e9eb68285a6cb3bd5d92c4f,1,aBabiichuk,2014-01-14 19:57:51+02:00,['029b055592ea9f348fa4f2edae57cfdd00565db2'],445,2581,3026,17252436,16,0.5,1,1,12873
ab0c39c07a6153f214dfd486ec6df314877db6ba,1,Srimanth Gunturi,2014-01-14 10:20:21-08:00,['9395e1f8797104c80e9eb68285a6cb3bd5d92c4f'],2,76,78,17252514,5,0.583333333,1,0.95,12873
88ddc9222a4629f0f6f798fdae0305ac48648e2b,1,Aleksandr Kovalenko,2014-01-14 20:25:31+02:00,['ab0c39c07a6153f214dfd486ec6df314877db6ba'],371,453,824,17253338,21,1,1,0,12880
589e92d5c7023d6afecb84943eae14e18f03959f,1,John Speidel,2014-01-14 14:26:37-05:00,['88ddc9222a4629f0f6f798fdae0305ac48648e2b'],277,653,930,17254268,7,0.642276423,1,0.398373984,12882
7e5b5d176315f2e3f634de02448080f196f21f4e,1,Andrew Onischuk,2014-01-14 11:32:30-08:00,['589e92d5c7023d6afecb84943eae14e18f03959f'],28,16,44,17254312,4,1,0,0,12882
625d0df9a3cfb647946bed6b66da75b157d523c4,1,Andrew Onischuk,2014-01-14 11:32:30-08:00,['7e5b5d176315f2e3f634de02448080f196f21f4e'],0,159,159,17254471,7,,,,12882
e192cc3849ecc6b22550883808bdd4f969be0fc9,1,Siddharth Wagle,2014-01-14 12:56:59-08:00,['625d0df9a3cfb647946bed6b66da75b157d523c4'],7,19,26,17254497,6,1,1,1,12882
9886890e31a5fee68993057655dc4bea079e427a,1,Lisnichenko Dmitro,2014-01-14 23:13:30+02:00,['e192cc3849ecc6b22550883808bdd4f969be0fc9'],0,6,6,17254503,2,1,1,1,12882
d8d308e6aa9e7c2d5957d48d6a84860156d16283,1,Lisnichenko Dmitro,2014-01-14 23:16:53+02:00,['9886890e31a5fee68993057655dc4bea079e427a'],25,53,78,17254581,2,0,1,0,12882
391f1242c836e210f982896a1ffe0afcb13e1105,1,atkach,2014-01-15 14:29:02+02:00,['d8d308e6aa9e7c2d5957d48d6a84860156d16283'],323,278,601,17255182,23,0.718309859,0.521126761,0.042253521,12883
ad789bfe0e8f947d34e57225701ff4b115ed3a02,0,Myroslav Papirkovskyy,2014-01-15 16:03:36+02:00,['391f1242c836e210f982896a1ffe0afcb13e1105'],4,14,18,17255200,1,0,1,1,12883
736c5cf151f58c748fd9d1a018827502c47c8c62,1,Alex Antonenko,2014-01-15 16:24:08+02:00,['ad789bfe0e8f947d34e57225701ff4b115ed3a02'],54,57,111,17255311,6,0.333333333,0.333333333,1,12883
4b4351ba4f9dfe7acba3cfc2a82ff8157028575e,0,atkach,2014-01-15 16:27:47+02:00,['736c5cf151f58c748fd9d1a018827502c47c8c62'],693,418,1111,17256422,7,1,1,1,12885
1763922ec6f7bf0d3b96a1d342ce25a8f25489d7,1,Vitaly Brodetskyi,2014-01-15 17:02:46+02:00,['4b4351ba4f9dfe7acba3cfc2a82ff8157028575e'],12,47,59,17256481,2,0,0,0.28125,12885
af56baa0b497869398726ae6b6c78b8707072d95,1,Lisnichenko Dmitro,2014-01-15 17:07:32+02:00,['1763922ec6f7bf0d3b96a1d342ce25a8f25489d7'],55,302,357,17256838,8,0.024390244,0.93902439,0.987804878,12885
a3b53446ef6fab413e62a962fe086b1eeb2cbd22,1,aBabiichuk,2014-01-15 17:38:31+02:00,['af56baa0b497869398726ae6b6c78b8707072d95'],61,448,509,17257347,17,0.738317757,0.953271028,1,12892
e10d9c60d749980d7ff4de29b431c2b8cac2e001,1,Nate Cole,2014-01-15 10:58:35-05:00,['a3b53446ef6fab413e62a962fe086b1eeb2cbd22'],10,1,11,17257358,1,,,,12892
d06dd4d90f475863b381f998d63ee4508a74cd66,1,aBabiichuk,2014-01-15 18:47:40+02:00,['e10d9c60d749980d7ff4de29b431c2b8cac2e001'],0,2,2,17257360,1,1,1,1,12892
15c39f4bca69b9982381acde5798c9288c62d6c9,1,Siddharth Wagle,2014-01-15 10:15:53-08:00,['d06dd4d90f475863b381f998d63ee4508a74cd66'],16,223,239,17257599,6,0.282894737,0.802631579,0.730263158,12892
fa78cd71a3d425eb597894862924913a6809f055,1,Mahadev Konar,2014-01-15 10:56:52-08:00,['15c39f4bca69b9982381acde5798c9288c62d6c9'],7,42,49,17257648,6,1,0,1,12892
db9f0cbc716cde5eeed091cf92f748ec5ead52f6,0,Siddharth Wagle,2014-01-15 11:14:15-08:00,['fa78cd71a3d425eb597894862924913a6809f055'],0,5,5,17257653,1,,,,12892
f4e0f6ca4050a36e3007928c0049672dc5263ac9,1,Srimanth Gunturi,2014-01-15 13:16:37-08:00,['db9f0cbc716cde5eeed091cf92f748ec5ead52f6'],4,604,608,17258261,38,,,,12892
161df3b15ae4daac6841e72e2d408c45800d8874,1,Sumit Mohanty,2014-01-15 13:20:15-08:00,['f4e0f6ca4050a36e3007928c0049672dc5263ac9'],40,95,135,17258396,13,0.608695652,1,1,12893
532d76d996ed14f70d99d7bb2374710983fc133f,0,Yusaku Sako,2014-01-15 14:42:03-08:00,['161df3b15ae4daac6841e72e2d408c45800d8874'],1,1,2,17258398,1,,,,12893
f87b95ed7f3582ea17537536ce2440c645989255,0,Yusaku Sako,2014-01-15 16:57:37-08:00,['532d76d996ed14f70d99d7bb2374710983fc133f'],1,1,2,17258400,1,,,,12893
e7c4533cac2e3d4361a34f7c16ded8c81e378b42,1,Yusaku Sako,2014-01-15 17:20:52-08:00,['f87b95ed7f3582ea17537536ce2440c645989255'],3,3,6,17258406,3,,,,12893
067b1b60ca6d88ff1f99cd3f267334b889119ac9,1,Srimanth Gunturi,2014-01-15 18:13:00-08:00,['e7c4533cac2e3d4361a34f7c16ded8c81e378b42'],202,74,276,17258682,10,0.508196721,0,0,12893
ad77a8afd5d914c9e5801110abc0e524070946a0,1,Sumit Mohanty,2014-01-15 23:23:23-08:00,['067b1b60ca6d88ff1f99cd3f267334b889119ac9'],23,28,51,17258733,6,0,0,1,12893
7a93855069126d4865bc9cccc5ddd9b42d3d68cd,0,aBabiichuk,2014-01-16 12:44:02+02:00,['ad77a8afd5d914c9e5801110abc0e524070946a0'],1,3,4,17258737,1,0,1,1,12893
5f48900bdeee5169acee9ec4bd16752256442360,1,Eugene Chekanskiy,2014-01-16 14:49:02+02:00,['7a93855069126d4865bc9cccc5ddd9b42d3d68cd'],4,14,18,17258755,2,0,1,1,12893
8c0e377195f2c58727011d299a0da2b093508a72,1,atkach,2014-01-16 15:56:53+02:00,['5f48900bdeee5169acee9ec4bd16752256442360'],2597,5455,8052,17266807,19,,,,12893
1c9b15735cb85a5b9044de45575e8d7c3cf23836,1,atkach,2014-01-16 15:56:53+02:00,['8c0e377195f2c58727011d299a0da2b093508a72'],9,97,106,17266913,9,0,0.142857143,1,12893
287c51fa9832169c7446082f46345ad7d31f1589,1,aBabiichuk,2014-01-16 16:40:42+02:00,['1c9b15735cb85a5b9044de45575e8d7c3cf23836'],16,222,238,17267151,2,0,0,1,12893
5b03e2bb85d3495645629cd185449b4d77194350,1,Oleg Nechiporenko,2014-01-16 16:47:49+02:00,['287c51fa9832169c7446082f46345ad7d31f1589'],142,149,291,17267442,3,1,0.886792453,0.509433962,12893
b01a7b7fa1c498290e96af9285cbe945d59001af,1,Aleksandr Kovalenko,2014-01-16 16:53:30+02:00,['5b03e2bb85d3495645629cd185449b4d77194350'],9,29,38,17267480,3,0.818181818,0.818181818,1,12893
c4032cbd28dc3f19d04689beeadfadb7f9867c83,1,Andrew Onischuk,2014-01-16 07:06:34-08:00,['b01a7b7fa1c498290e96af9285cbe945d59001af'],15,28,43,17267523,9,1,1,1,12893
0ecb08e4c0cad254feae4518ee8eb5967de3a7a5,0,Andrew Onischuk,2014-01-16 07:06:34-08:00,['c4032cbd28dc3f19d04689beeadfadb7f9867c83'],9,12,21,17267544,1,0,0,1,12893
b5d3ecb9fbbd78b837a3f6b8d205d9fa147b6717,1,Andrew Onischuk,2014-01-16 07:06:34-08:00,['0ecb08e4c0cad254feae4518ee8eb5967de3a7a5'],12,1,13,17267557,2,,,,12893
76ee5d7c1a9ea78adfa9c10cf63dfa68c24553fc,0,Sumit Mohanty,2014-01-16 08:28:42-08:00,['b5d3ecb9fbbd78b837a3f6b8d205d9fa147b6717'],1,1,2,17267559,1,,,,12893
40e94f00d6e5001cdc5a1d5e86c1e6a4b541fde7,1,Lisnichenko Dmitro,2014-01-16 18:49:16+02:00,['76ee5d7c1a9ea78adfa9c10cf63dfa68c24553fc'],51,126,177,17267736,17,0.098039216,0,0.529411765,12893
a158073c7db49cee635bdcda2a6330ead3fba62b,1,Siddharth Wagle,2014-01-16 10:16:51-08:00,['40e94f00d6e5001cdc5a1d5e86c1e6a4b541fde7'],11,262,273,17268009,10,0.211180124,0.409937888,1,12893
8f087a7d5b2f468768c7882fc932f2fb58fe6aea,0,Siddharth Wagle,2014-01-16 10:16:51-08:00,['a158073c7db49cee635bdcda2a6330ead3fba62b'],2,1,3,17268012,1,1,0,0,12893
ca4147f8973e7c1567d1e2fc4b4741f1280680b0,1,Lisnichenko Dmitro,2014-01-16 23:02:55+02:00,['8f087a7d5b2f468768c7882fc932f2fb58fe6aea'],1,12,13,17268025,2,0,1,1,12893
e056203a263e20f39fa46fc1aaaf2a86a5328072,1,mpapirkovskyy,2014-01-16 23:45:53+02:00,['ca4147f8973e7c1567d1e2fc4b4741f1280680b0'],80,222,302,17268327,17,0.13253012,0.903614458,0.734939759,12893
1fb20653b1329c1ce07741e577dfc9bf7fbf8355,0,mpapirkovskyy,2014-01-17 00:11:06+02:00,['e056203a263e20f39fa46fc1aaaf2a86a5328072'],1,3,4,17268331,1,0,1,1,12893
44f4f91983da4c2dedb0bc03772c2fe816198926,1,Srimanth Gunturi,2014-01-16 14:16:38-08:00,['1fb20653b1329c1ce07741e577dfc9bf7fbf8355'],25,37,62,17268393,4,1,1,1,12893
2e29777a59795aededda156b36088db7fa6f1ea2,1,John Speidel,2014-01-16 17:58:39-05:00,['44f4f91983da4c2dedb0bc03772c2fe816198926'],20,2067,2087,17270480,32,0.239193084,0.406340058,1,12909
8d5c99db8d78bef4e9d09b793cab4b9bcb804ab4,0,Mahadev Konar,2014-01-16 16:31:32-08:00,['2e29777a59795aededda156b36088db7fa6f1ea2'],12,15,27,17270507,1,,,,12909
53f05bebb46aad3e9e4a4cf9ca6cfdd3c1c02976,1,Srimanth Gunturi,2014-01-16 16:40:24-08:00,['8d5c99db8d78bef4e9d09b793cab4b9bcb804ab4'],0,16,16,17270523,3,0,1,1,12909
db379b16e136b429aaf98339ad25c40f71f58570,1,Andrew Onischuk,2014-01-17 02:39:29-08:00,['53f05bebb46aad3e9e4a4cf9ca6cfdd3c1c02976'],7,679,686,17271209,18,0.445652174,0.489130435,1,12921
207f4bc6f0516e3655c5861d9c3915618a15c8d3,1,Andrew Onischuk,2014-01-17 02:49:14-08:00,['db379b16e136b429aaf98339ad25c40f71f58570'],2,1,3,17271212,1,,,,12921
05d9a042f6f9bf18f82fe2f977b72b4906d13aa8,1,Oleg Nechiporenko,2014-01-17 13:56:49+02:00,['207f4bc6f0516e3655c5861d9c3915618a15c8d3'],168,364,532,17271744,5,1,1,1,12922
2e22a2c338db26d68cc768cbfcf6d68ba1fe3cb7,1,Alex Antonenko,2014-01-17 15:09:10+02:00,['05d9a042f6f9bf18f82fe2f977b72b4906d13aa8'],12,12,24,17271768,3,0,0,0,12922
c5072ed1df2f2ea0c5add9fa698b352955dcc925,1,Alex Antonenko,2014-01-17 15:35:06+02:00,['2e22a2c338db26d68cc768cbfcf6d68ba1fe3cb7'],6,89,95,17271863,8,1,1,1,12923
20c0b8b5ba052be01b21cf829e1ef1486ca360af,1,atkach,2014-01-17 16:06:49+02:00,['c5072ed1df2f2ea0c5add9fa698b352955dcc925'],123,68,191,17272054,4,0,1,0.85,12924
186d6a7fc1cc8917c5c5243bf4f613bb473e6a62,1,Alex Antonenko,2014-01-17 18:26:25+02:00,['20c0b8b5ba052be01b21cf829e1ef1486ca360af'],1,1,2,17272056,1,,,,12924
92583535dc8ad24c49f9d7f4c6c9c8b56575c497,1,Mahadev Konar,2014-01-17 11:31:56-08:00,['186d6a7fc1cc8917c5c5243bf4f613bb473e6a62'],21441,1403,22844,17294900,260,0.65449233,0.276113952,0.094959825,12924
ae534ed3089f2650748c9563009007cae13d8e99,1,Mahadev Konar,2014-01-17 15:34:30-08:00,['92583535dc8ad24c49f9d7f4c6c9c8b56575c497'],38,15352,15390,17310290,478,0.34550767,0.723886048,0.905040175,13126
e2c9a64e587b747ef54413c6aea53e4a7e4d6afc,1,Andrew Onischuk,2014-01-20 02:51:28-08:00,['ae534ed3089f2650748c9563009007cae13d8e99'],0,3476,3476,17313766,13,0.328687573,1,0.958188153,13139
9d92a192f29060bad18b0f244c38d5fe3e1d67df,1,atkach,2014-01-20 12:56:34+02:00,['e2c9a64e587b747ef54413c6aea53e4a7e4d6afc'],0,135,135,17313901,4,0.567567568,1,1,13141
4ec6e63d811d824ec07abf9ae8e7d16a90ab29fc,1,atkach,2014-01-20 13:00:15+02:00,['9d92a192f29060bad18b0f244c38d5fe3e1d67df'],4,26,30,17313931,2,1,0,1,13141
78b63993b11613d331b80cc69efc182b28213c32,1,atkach,2014-01-20 14:00:32+02:00,['4ec6e63d811d824ec07abf9ae8e7d16a90ab29fc'],2,8,10,17313941,1,0,0,1,13141
b26bca933b023a1d5a074661072f9671a6de8f78,0,Aleksandr Kovalenko,2014-01-20 14:19:22+02:00,['78b63993b11613d331b80cc69efc182b28213c32'],2257,487,2744,17316685,29,0.420168067,0.130252101,0,13145
e96845faaf447b6f88d40ea4691bca0ae42cb51d,1,atkach,2014-01-20 15:39:11+02:00,['b26bca933b023a1d5a074661072f9671a6de8f78'],4,6,10,17316695,1,1,1,1,13145
c3a1a5923573b035eece63fb748548ccdbc3dd52,1,Andrew Onischuk,2014-01-20 06:59:58-08:00,['e96845faaf447b6f88d40ea4691bca0ae42cb51d'],14,37,51,17316746,8,0.9375,1,0.9375,13145
aae72dfafcc09369a9134306af5e996fff517682,1,Andrew Onischuk,2014-01-20 08:31:40-08:00,['c3a1a5923573b035eece63fb748548ccdbc3dd52'],2,706,708,17317454,6,0.225454545,1,1,13149
6974a6be3b18e8788c82db088b20f3090a8312d2,1,Oleg Nechiporenko,2014-01-20 19:10:30+02:00,['aae72dfafcc09369a9134306af5e996fff517682'],58,320,378,17317832,8,1,1,0.906779661,13150
fd4234651d8db655743c6e302c68536ef43de203,1,Aleksandr Kovalenko,2014-01-20 19:33:19+02:00,['6974a6be3b18e8788c82db088b20f3090a8312d2'],7,66,73,17317905,8,0.114285714,0.085714286,1,13150
52e67f92c024fafee3df7af6679dd294d2a56837,1,Lisnichenko Dmitro,2014-01-20 19:53:38+02:00,['fd4234651d8db655743c6e302c68536ef43de203'],5,23,28,17317933,5,0,0,1,13150
0a3e26518305e54ea4d6c6d552ceced191c399b4,0,Aleksandr Kovalenko,2014-01-20 20:32:27+02:00,['52e67f92c024fafee3df7af6679dd294d2a56837'],2,9,11,17317944,6,1,1,1,13152
60d42bbe15b68fecbf6bf57926fff8f910807e4a,1,Siddharth Wagle,2014-01-20 10:36:26-08:00,['0a3e26518305e54ea4d6c6d552ceced191c399b4'],0,3,3,17317947,2,,,,13152
0edf889df0576ad7d55dc97b89ce53a3de23a320,0,Siddharth Wagle,2014-01-20 10:37:21-08:00,['60d42bbe15b68fecbf6bf57926fff8f910807e4a'],1,1,2,17317949,1,,,,13152
2949ce171da6f280f19cb0d33f56b529a1923e10,1,Srimanth Gunturi,2014-01-20 10:40:00-08:00,['0edf889df0576ad7d55dc97b89ce53a3de23a320'],18,47,65,17318014,3,0,0,0,13152
49bf41a56510f5911a391fc63adc8637853811e7,0,Nate Cole,2014-01-20 17:31:14-05:00,['2949ce171da6f280f19cb0d33f56b529a1923e10'],7,15,22,17318036,2,1,1,1,13152
18c04fa8cada6b9005f0823797e5f0cc8a7be812,0,Srimanth Gunturi,2014-01-20 15:03:46-08:00,['49bf41a56510f5911a391fc63adc8637853811e7'],2,2,4,17318040,2,,,,13152
14bc5451825922b981bbd8239e4da70ba82b1d1a,1,Srimanth Gunturi,2014-01-20 18:22:02-08:00,['18c04fa8cada6b9005f0823797e5f0cc8a7be812'],2,2,4,17318044,2,,,,13152
fcfbf01aa6a0848b66558a9da12fde2e5aa41d27,1,atkach,2014-01-21 13:56:26+02:00,['14bc5451825922b981bbd8239e4da70ba82b1d1a'],4,24,28,17318072,4,1,1,1,13152
5c9311e3c7b7353eb517c282a34ea897eca2263b,0,atkach,2014-01-21 14:35:56+02:00,['fcfbf01aa6a0848b66558a9da12fde2e5aa41d27'],0,2,2,17318074,1,1,1,1,13152
85dd6783be44e52c90d414733923f27b97ebfb22,1,Aleksandr Kovalenko,2014-01-21 15:22:01+02:00,['5c9311e3c7b7353eb517c282a34ea897eca2263b'],2,88,90,17318164,9,0,0.4,1,13152
e1dffdc50fa226992eeaf39c28487ef752238c08,1,Andrew Onischuk,2014-01-21 05:34:37-08:00,['85dd6783be44e52c90d414733923f27b97ebfb22'],0,376,376,17318540,2,0.411764706,1,1,13154
bf2bc70b7054fbc867b9d20b501de59d946e3852,1,Aleksandr Kovalenko,2014-01-21 15:51:21+02:00,['e1dffdc50fa226992eeaf39c28487ef752238c08'],2,56,58,17318598,7,0,0,1,13154
9ae8a0dfedd611bedb5da76565f75b0a51230d73,1,Dmitry Sen,2014-01-21 17:11:46+02:00,['bf2bc70b7054fbc867b9d20b501de59d946e3852'],1,61,62,17318660,2,0,0.916666667,0.083333333,13154
e41b89cbdd6be9935d223f501284f8d0a078909b,0,Artem Baranchuk,2014-01-21 17:24:35+02:00,['9ae8a0dfedd611bedb5da76565f75b0a51230d73'],4,174,178,17318838,2,0.616071429,0.982142857,0.991071429,13154
b84b0732aa09092721a27e9bc701e5926e21a227,0,Artem Baranchuk,2014-01-21 17:24:36+02:00,['e41b89cbdd6be9935d223f501284f8d0a078909b'],21,19,40,17318878,3,1,1,0,13154
4528f4b098ee2701985598388e753bf66d97fe3c,1,Lisnichenko Dmitro,2014-01-21 17:44:06+02:00,['b84b0732aa09092721a27e9bc701e5926e21a227'],95,35,130,17319008,9,1,1,0,13154
6f152614a20a637a2c6778fefbbb01235ee314df,1,atkach,2014-01-21 19:04:45+02:00,['4528f4b098ee2701985598388e753bf66d97fe3c'],513,124,637,17319645,2,0.164037855,0.211356467,0,13154
76e0c5547f1afccb8f53a4a6ebc92540f8cf55cb,1,atkach,2014-01-21 20:07:09+02:00,['6f152614a20a637a2c6778fefbbb01235ee314df'],10,27,37,17319682,4,1,1,1,13154
75a5655a93a40561448e5607ea568875a9b33032,0,Jeff Sposetti,2014-01-21 11:10:57-08:00,['76e0c5547f1afccb8f53a4a6ebc92540f8cf55cb'],7,5,12,17319694,3,,,,13154
6ddd861cd3e585a1bcd66bf09ff15fe1914a625a,0,Srimanth Gunturi,2014-01-21 13:13:40-08:00,['75a5655a93a40561448e5607ea568875a9b33032'],9,11,20,17319714,4,,,,13154
c417961570d98f05709fce07526a4b74cfaf8d64,0,tbeerbower,2014-01-21 16:22:11-05:00,['6ddd861cd3e585a1bcd66bf09ff15fe1914a625a'],60,114,174,17319888,3,1,1,1,13155
4f00cb0bf819ecd70dcf673f57b3d1351e50a795,1,Siddharth Wagle,2014-01-21 17:34:25-08:00,['c417961570d98f05709fce07526a4b74cfaf8d64'],17,22,39,17319927,2,0,1,1,13155
937bcbbbba6f221467212040f6d1dd45bf58a7d7,0,tbeerbower,2014-01-21 20:39:05-05:00,['4f00cb0bf819ecd70dcf673f57b3d1351e50a795'],0,2,2,17319929,1,,,,13155
a2d7c9e57cc8a652e408b1731236c00d8f8275bb,1,tbeerbower,2014-01-21 23:50:55-05:00,['937bcbbbba6f221467212040f6d1dd45bf58a7d7'],128,449,577,17320506,11,0.504273504,0.982905983,1,13156
26fbaef393288000fd666886fd89bcdabf52df77,1,Oleg Nechiporenko,2014-01-22 13:17:18+02:00,['a2d7c9e57cc8a652e408b1731236c00d8f8275bb'],57,339,396,17320902,8,0.880829016,1,1,13156
1b07eaa482e43991e0e9243731a246c4dfb7a277,0,Aleksandr Kovalenko,2014-01-22 18:01:05+02:00,['26fbaef393288000fd666886fd89bcdabf52df77'],28,61,89,17320991,1,,,,13156
c98481ec3c0aea9fdfeb892256e6b9a301bf7cdb,0,Aleksandr Kovalenko,2014-01-22 18:28:14+02:00,['1b07eaa482e43991e0e9243731a246c4dfb7a277'],1,0,1,17320992,1,,,,13156
d48edfaa0f1716b28c843376a4e7b5a6adabcd2e,1,Andrew Onischuk,2014-01-22 08:48:29-08:00,['c98481ec3c0aea9fdfeb892256e6b9a301bf7cdb'],138,136,274,17321266,32,1,1,0,13156
d125f703153ef48ac3122653dec4fdb7db713333,1,Andrew Onischuk,2014-01-22 09:02:00-08:00,['d48edfaa0f1716b28c843376a4e7b5a6adabcd2e'],10,177,187,17321453,2,0.08,0,0.648,13156
46a80f7a8f84c9dfa64c2ac65230ad32c2fe2618,1,Andrew Onischuk,2014-01-22 09:22:44-08:00,['d125f703153ef48ac3122653dec4fdb7db713333'],7,2,9,17321462,1,1,1,0.2,13156
e84f5368cc0560d7798e8e86951ede4e86f5b714,1,Andrew Onischuk,2014-01-22 09:39:36-08:00,['46a80f7a8f84c9dfa64c2ac65230ad32c2fe2618'],15,17,32,17321494,4,0,1,1,13156
241f059cbe91806108473da3ccb07bb5a3685de7,1,Aleksandr Kovalenko,2014-01-22 19:50:54+02:00,['e84f5368cc0560d7798e8e86951ede4e86f5b714'],10,9,19,17321513,5,,,,13156
8e8a9a47fd5d9afb0fcc4bd41b283c409d5bc355,1,Sumit Mohanty,2014-01-22 11:14:09-08:00,['241f059cbe91806108473da3ccb07bb5a3685de7'],1432,804,2236,17323749,36,0.763466042,0.217798595,0.208430913,13164
fd9078d8dcef135a4c02c77dcb2adad51577d6d8,1,Siddharth Wagle,2014-01-22 13:04:29-08:00,['8e8a9a47fd5d9afb0fcc4bd41b283c409d5bc355'],1,432,433,17324182,11,0.637931034,1,1,13171
d2d31a548749c132d1105eee8959f176e85a7e57,0,Siddharth Wagle,2014-01-22 13:20:26-08:00,['fd9078d8dcef135a4c02c77dcb2adad51577d6d8'],1,0,1,17324183,1,,,,13171
7790fbd5b32414656685aa9f89b79310720c582e,1,Yusaku Sako,2014-01-22 14:05:22-08:00,['d2d31a548749c132d1105eee8959f176e85a7e57'],6,5,11,17324194,4,,,,13171
7598e25ac48b34333aca57faad34c489f725988b,1,Oleg Nechiporenko,2014-01-23 12:37:31+02:00,['7790fbd5b32414656685aa9f89b79310720c582e'],43,57,100,17324294,4,1,1,1,13171
99cabb956accd25e198422141034e84ea6cd70d4,1,Oleg Nechiporenko,2014-01-23 13:31:23+02:00,['7598e25ac48b34333aca57faad34c489f725988b'],34,22,56,17324350,3,,,,13171
151df0baabd3ed3d5ffce86fa34ad345849c045d,1,Andrew Onischuk,2014-01-23 04:35:06-08:00,['99cabb956accd25e198422141034e84ea6cd70d4'],3,1572,1575,17325925,11,0.307629204,1,1,13181
2e34a088b62ac2762eb35f21b064bd0a0cf0ea0d,1,Andrew Onischuk,2014-01-23 04:57:30-08:00,['151df0baabd3ed3d5ffce86fa34ad345849c045d'],28,1298,1326,17327251,8,0.112399643,1,1,13186
386330fde96666c33efa7028dee6182538d40a3d,1,Aleksandr Kovalenko,2014-01-23 15:24:51+02:00,['2e34a088b62ac2762eb35f21b064bd0a0cf0ea0d'],15,220,235,17327486,5,0.431818182,0.356060606,1,13187
db264c8c5ec3c903b839fd1a82639b1dfac1610f,1,Lisnichenko Dmitro,2014-01-23 16:55:03+02:00,['386330fde96666c33efa7028dee6182538d40a3d'],4,6,10,17327496,4,1,1,1,13187
49de3a3496979f65684e8d960383e941e0e3eb3e,0,Nate Cole,2014-01-23 10:24:50-05:00,['db264c8c5ec3c903b839fd1a82639b1dfac1610f'],7,9,16,17327512,2,,,,13187
90f00a2a4267a7a94e8c89ade790ca7b71d8199a,1,Myroslav Papirkovskyy,2014-01-23 18:28:01+02:00,['49de3a3496979f65684e8d960383e941e0e3eb3e'],0,172,172,17327684,4,0.444444444,0.981481481,0.740740741,13189
c7d94be5a0294e3be31eabb09bc4a9e0cf2bc373,1,atkach,2014-01-23 18:34:52+02:00,['90f00a2a4267a7a94e8c89ade790ca7b71d8199a'],11,77,88,17327772,2,0.362068966,0.637931034,0.724137931,13189
11de6a5c6f027564466f089c553d06a6d3f28c5d,1,Andrew Onischuk,2014-01-23 09:55:08-08:00,['c7d94be5a0294e3be31eabb09bc4a9e0cf2bc373'],38,49,87,17327859,7,0,0.8,0.2,13189
cd25d7b6b79b0ecd5821226980c47c7fd5ccc8f8,1,Siddharth Wagle,2014-01-23 10:00:07-08:00,['11de6a5c6f027564466f089c553d06a6d3f28c5d'],7,65,72,17327931,3,0,0.725,1,13189
33092de45a23331b39e855fbcd0d6bbca48d6c99,0,Siddharth Wagle,2014-01-23 10:00:07-08:00,['cd25d7b6b79b0ecd5821226980c47c7fd5ccc8f8'],24,13,37,17327968,2,1,0,0,13189
5ff51712a8ef881db7970f0673578d8099df9350,1,Oleg Nechiporenko,2014-01-23 20:02:58+02:00,['33092de45a23331b39e855fbcd0d6bbca48d6c99'],395,317,712,17328680,110,0,0.125,0.015625,13189
7bee7da4d6559aa4dc12d2f28a6e6d20ddf4dd74,1,atkach,2014-01-23 20:07:07+02:00,['5ff51712a8ef881db7970f0673578d8099df9350'],1,5,6,17328686,1,,,,13189
67b7c76fd71e73768ef6def81187041246f07f35,0,tbeerbower,2014-01-23 14:09:21-05:00,['7bee7da4d6559aa4dc12d2f28a6e6d20ddf4dd74'],4,549,553,17329239,3,0,0.88,1,13190
e5d440b4f1eb342e0bcd92b792fdc4240a44395f,1,Srimanth Gunturi,2014-01-23 11:51:03-08:00,['67b7c76fd71e73768ef6def81187041246f07f35'],17,255,272,17329511,9,0.344827586,0.525862069,0.577586207,13190
a0ea66fecae19438267467aed0a2a7a661880bc7,1,Myroslav Papirkovskyy,2014-01-23 22:19:49+02:00,['e5d440b4f1eb342e0bcd92b792fdc4240a44395f'],6,132,138,17329649,4,0,0.952380952,1,13190
375d0836510b7645df91151d2c84d763a21ac098,1,Myroslav Papirkovskyy,2014-01-23 22:19:49+02:00,['a0ea66fecae19438267467aed0a2a7a661880bc7'],5,202,207,17329856,4,,,,13190
5363f84168f0fae24928d52626a7d307d51eaf69,0,Srimanth Gunturi,2014-01-23 12:31:33-08:00,['375d0836510b7645df91151d2c84d763a21ac098'],1,1,2,17329858,1,,,,13190
f792d3d3f6651d918ee5d201f1057f1c2bc65a3a,1,Myroslav Papirkovskyy,2014-01-24 00:55:53+02:00,['5363f84168f0fae24928d52626a7d307d51eaf69'],110,280,390,17330248,11,0.395604396,0.659340659,0.934065934,13190
58ce96dc5afbe09948b4df587d3290e9f2abcd11,1,Sumit Mohanty,2014-01-23 15:02:31-08:00,['f792d3d3f6651d918ee5d201f1057f1c2bc65a3a'],4,4,8,17330256,2,,,,13190
b7f6163a5cf728fb8ed4c750fc10fef799597d7c,0,Srimanth Gunturi,2014-01-23 18:47:05-08:00,['58ce96dc5afbe09948b4df587d3290e9f2abcd11'],3,2,5,17330261,2,0,0,1,13190
33a0ec85a8410a3df6741f0d394104b1a7950d12,1,Andrew Onischuk,2014-01-17 03:53:41-08:00,['b7f6163a5cf728fb8ed4c750fc10fef799597d7c'],83,38,121,17330382,23,0.534482759,0,0.448275862,13190
e42416421cc59a8b6b6e0dd5e5edaacd06956d5b,0,atkach,2014-01-24 16:30:30+02:00,['33a0ec85a8410a3df6741f0d394104b1a7950d12'],10,10,20,17330402,1,,,,13190
ca103852fd8889232ad20d2bc53bfd00f170dfd6,1,Oleg Nechiporenko,2014-01-24 17:31:39+02:00,['e42416421cc59a8b6b6e0dd5e5edaacd06956d5b'],12,10,22,17330424,1,,,,13190
847a91011d4048580cc8b2bfe7b9454832ec64d6,1,Andrew Onischuk,2014-01-24 08:04:47-08:00,['ca103852fd8889232ad20d2bc53bfd00f170dfd6'],5,19,24,17330448,6,,,,13190
55a5cb97c274bb90cb18f45f079189641ff2c2c6,0,tbeerbower,2014-01-24 11:44:07-05:00,['847a91011d4048580cc8b2bfe7b9454832ec64d6'],10,10,20,17330468,7,,,,13190
ff921e62ab45058f740822e6030e857206ceda2e,1,Dmitry Sen,2014-01-24 21:14:23+02:00,['55a5cb97c274bb90cb18f45f079189641ff2c2c6'],769,2735,3504,17333972,65,0,0,1,13208
f31c604e4790c7ec21037abc47ba5d8cb2849766,1,Mahadev Konar,2014-01-24 13:27:26-08:00,['ff921e62ab45058f740822e6030e857206ceda2e'],92,100,192,17334164,1,,,,13208
f14dae7ef02ef2df47dd3da4798c22fd4d58c21b,1,Srimanth Gunturi,2014-01-24 17:59:38-08:00,['f31c604e4790c7ec21037abc47ba5d8cb2849766'],0,242,242,17334406,5,1,1,1,13211
930c8d909cde3c3ec87f09d75d7cc9d31ec9c51b,1,Yusaku Sako,2014-01-24 19:35:59-08:00,['f14dae7ef02ef2df47dd3da4798c22fd4d58c21b'],199,736,935,17335341,5,0.251497006,0.739520958,0.670658683,13211
78559508e6738380e1e71c71d7f42aa725cc53e5,1,Lisnichenko Dmitro,2014-01-27 13:15:21+02:00,['930c8d909cde3c3ec87f09d75d7cc9d31ec9c51b'],3,28,31,17335372,2,0.705882353,0.058823529,0.941176471,13211
12f610d096b991b0c67f161fcb118e4e43b845ba,1,Aleksandr Kovalenko,2014-01-27 15:48:51+02:00,['78559508e6738380e1e71c71d7f42aa725cc53e5'],2,18,20,17335392,2,,,,13211
b8a3d399a4acbdc5d4adb0cbfb42a7795f87b84c,0,aBabiichuk,2014-01-27 17:27:11+02:00,['12f610d096b991b0c67f161fcb118e4e43b845ba'],1,1,2,17335394,1,,,,13211
8015c714a66ce8214e8d3159dd8deba8ca22b2d7,1,Aleksandr Kovalenko,2014-01-27 17:47:51+02:00,['b8a3d399a4acbdc5d4adb0cbfb42a7795f87b84c'],8,9,17,17335411,1,,,,13211
b0add1ce46728f8222bec0955caeb97ef922fca3,1,Lisnichenko Dmitro,2014-01-27 18:26:43+02:00,['8015c714a66ce8214e8d3159dd8deba8ca22b2d7'],1,1,2,17335413,1,,,,13211
34bf12a0d86963ecb2e93b5cf8867b3a271ae72c,1,Vitaly Brodetskyi,2014-01-27 18:39:09+02:00,['b0add1ce46728f8222bec0955caeb97ef922fca3'],18,340,358,17335771,3,0.173913043,0.994565217,0.804347826,13213
a59e3d0b91594f227073ea3cb59a6b34d26c8ee6,0,atkach,2014-01-27 18:53:04+02:00,['34bf12a0d86963ecb2e93b5cf8867b3a271ae72c'],1,1,2,17335773,1,,,,13213
dce0e2041b943fc9eddc00bc5c7c48bb40571759,1,Oleg Nechiporenko,2014-01-27 19:12:22+02:00,['a59e3d0b91594f227073ea3cb59a6b34d26c8ee6'],405,286,691,17336464,9,0.978723404,0.861702128,0.271276596,13213
bc102b3273f3fc5809854f30a67e6844c7b10fdd,1,Lisnichenko Dmitro,2014-01-27 19:58:24+02:00,['dce0e2041b943fc9eddc00bc5c7c48bb40571759'],27,1703,1730,17338194,24,0.126290707,0.993645751,1,13228
95f0159acb8766b3e43ed6a46796c3bf5d1255fd,1,Nate Cole,2014-01-27 13:23:48-05:00,['bc102b3273f3fc5809854f30a67e6844c7b10fdd'],122,916,1038,17339232,34,0.261758691,0.347648262,0.897750511,13229
fb458772988a8109ddc43bb5e44a680b541ee708,0,Myroslav Papirkovskyy,2014-01-27 22:27:54+02:00,['95f0159acb8766b3e43ed6a46796c3bf5d1255fd'],480,7,487,17339719,2,,,,13229
0f95cfcf042be22047550a096b6fb68603664f5f,1,Myroslav Papirkovskyy,2014-01-27 22:28:03+02:00,['fb458772988a8109ddc43bb5e44a680b541ee708'],8,8,16,17339735,2,,,,13229
49eb50fd48610b047a633d66fe48f30c802c4981,1,Sumit Mohanty,2014-01-27 13:31:09-08:00,['0f95cfcf042be22047550a096b6fb68603664f5f'],35,15,50,17339785,6,,,,13229
60c16d770d0fdc9b6fda19310b83978f280e749a,1,Jaimin Jetly,2014-01-27 14:17:04-08:00,['49eb50fd48610b047a633d66fe48f30c802c4981'],46,43,89,17339874,4,1,0,0,13229
21566f28fbd867c0988fdf34ff2a5c184d9aa4f3,1,Siddharth Wagle,2014-01-27 15:23:08-08:00,['60c16d770d0fdc9b6fda19310b83978f280e749a'],16,621,637,17340511,2,,,,13230
a89f85948b062dc8329be0cabfe299598d0e1637,1,Siddharth Wagle,2014-01-27 15:53:41-08:00,['21566f28fbd867c0988fdf34ff2a5c184d9aa4f3'],0,3,3,17340514,1,,,,13230
5be57caff0a33ded07ba409dcc0f9f521f7a142c,1,Sumit Mohanty,2014-01-27 16:34:30-08:00,['a89f85948b062dc8329be0cabfe299598d0e1637'],11,227,238,17340752,13,0.495867769,0.842975207,0.842975207,13232
7b9682f81da8a8f0b23495022bcba5ab6c31d504,1,Jaimin Jetly,2014-01-27 17:45:25-08:00,['5be57caff0a33ded07ba409dcc0f9f521f7a142c'],1,24,25,17340777,1,,,,13232
682ef9984ef1ac246a63c2ab0acded3f6f4c0a0e,1,Yusaku Sako,2014-01-27 19:07:49-08:00,['7b9682f81da8a8f0b23495022bcba5ab6c31d504'],18,20,38,17340815,7,,,,13232
89af4f19005c2a87561e2279fed8745a6f8a9645,1,tbeerbower,2014-01-28 05:06:59-05:00,['682ef9984ef1ac246a63c2ab0acded3f6f4c0a0e'],0,719,719,17341534,15,1,1,1,13245
3d7270b38d20346228b7e6e793a538a2deda6b4f,1,tbeerbower,2014-01-28 05:06:59-05:00,['89af4f19005c2a87561e2279fed8745a6f8a9645'],0,1311,1311,17342845,14,1,1,1,13259
2aad5bbb4aa9e51d2b98de4cfe88cebf2ad64a28,1,Andrew Onischuk,2014-01-17 03:52:24-08:00,['3d7270b38d20346228b7e6e793a538a2deda6b4f'],234,752,986,17343831,15,0.305630027,1,1,13264
371186173be89985c5d2ad4c33fe74c2a4741d88,1,Andrew Onischuk,2014-01-17 03:53:59-08:00,['2aad5bbb4aa9e51d2b98de4cfe88cebf2ad64a28'],1,638,639,17344470,10,0,1,1,13272
665114fad0c12eb404f632915d3a967fa4da1fd8,0,Vitaly Brodetskyi,2014-01-28 14:50:43+02:00,['371186173be89985c5d2ad4c33fe74c2a4741d88'],3,63,66,17344536,3,0,0.454545455,0,13273
5343c5e0c8943713e875d2350bf3d8a3d38b13cf,1,Lisnichenko Dmitro,2014-01-28 18:04:23+02:00,['665114fad0c12eb404f632915d3a967fa4da1fd8'],16,24,40,17344576,1,,,,13273
6e0b01110c89327bdf06251bd6640b4dab9bd8e2,1,atkach,2014-01-28 20:01:43+02:00,['5343c5e0c8943713e875d2350bf3d8a3d38b13cf'],9,483,492,17345068,19,0.615384615,0.653846154,1,13274
3aa12f57d72a43a01b250f8525131a98a469122d,0,Sumit Mohanty,2014-01-28 11:46:58-08:00,['6e0b01110c89327bdf06251bd6640b4dab9bd8e2'],1,1,2,17345070,1,,,,13274
4a008bdc6b46d9bc8e9af95cf0aa857c9e593be0,1,Sumit Mohanty,2014-01-28 14:24:02-08:00,['3aa12f57d72a43a01b250f8525131a98a469122d'],3,9,12,17345082,2,0,0.666666667,0.666666667,13274
9eb89a2fa1ce20259ab373819fe35122c63e581d,1,Yusaku Sako,2014-01-28 19:32:06-08:00,['4a008bdc6b46d9bc8e9af95cf0aa857c9e593be0'],2,2,4,17345086,2,,,,13274
8017fec53a522098a7c63b39a9187636dc3fd533,1,Yusaku Sako,2014-01-28 19:32:06-08:00,['9eb89a2fa1ce20259ab373819fe35122c63e581d'],902,1180,2082,17347168,30,,,,13274
2b0ced0d49a178924ecb07ad4c6984d37dff5827,1,atkach,2014-01-29 12:29:11+02:00,['8017fec53a522098a7c63b39a9187636dc3fd533'],2,3,5,17347173,2,,,,13274
a2579c320a08c0f0eafd5652e5f41952e9a75db5,1,atkach,2014-01-29 12:51:05+02:00,['2b0ced0d49a178924ecb07ad4c6984d37dff5827'],36,424,460,17347633,8,0,0.882352941,1,13275
c6e65f534d930773d17f2d24becf9abf38d28083,0,Andrew Onischuk,2014-01-29 03:22:26-08:00,['a2579c320a08c0f0eafd5652e5f41952e9a75db5'],2,1,3,17347636,1,,,,13275
17da19222b39422a3330ccebf9da727f2c318a27,1,Andrew Onischuk,2014-01-29 05:27:28-08:00,['c6e65f534d930773d17f2d24becf9abf38d28083'],2,27,29,17347665,2,1,0,1,13275
7bf2d37128dfc2264e190e1fa2626fbdb57be727,1,atkach,2014-01-29 15:44:40+02:00,['17da19222b39422a3330ccebf9da727f2c318a27'],47,25,72,17347737,4,0.939393939,0,0.060606061,13275
4a1eaf22db7cf89a14591e5e582c31b94b25ce1e,1,Alex Antonenko,2014-01-29 16:17:32+02:00,['7bf2d37128dfc2264e190e1fa2626fbdb57be727'],17,288,305,17348042,12,1,1,1,13278
7bc9103204cbddfc475f345b935470e4174bcf06,1,aBabiichuk,2014-01-29 17:50:37+02:00,['4a1eaf22db7cf89a14591e5e582c31b94b25ce1e'],70,81,151,17348193,11,0.285714286,0,1,13278
1a54ce4c6103f545d37d5993774f3668c9a75b22,1,Oleg Nechiporenko,2014-01-29 18:13:44+02:00,['7bc9103204cbddfc475f345b935470e4174bcf06'],7,16,23,17348216,4,,,,13278
e77d28fca22e78978583ac65836738334388b25e,1,Artem Baranchuk,2014-01-29 18:20:35+02:00,['1a54ce4c6103f545d37d5993774f3668c9a75b22'],1,1,2,17348218,1,,,,13278
18b0b8bfa4f5c1d7eb0a7af2b7b75da8dacac3c7,1,atkach,2014-01-29 20:13:38+02:00,['e77d28fca22e78978583ac65836738334388b25e'],11,51,62,17348280,7,1,0.833333333,0,13278
fd1da9bd6df28a6c52177b435ff692c770b65ad7,1,Vitaly Brodetskyi,2014-01-29 20:15:10+02:00,['18b0b8bfa4f5c1d7eb0a7af2b7b75da8dacac3c7'],0,2,2,17348282,1,,,,13278
ea420ff9c3a13d50cdabd4a73f5fa7f24398076d,0,atkach,2014-01-29 20:49:43+02:00,['fd1da9bd6df28a6c52177b435ff692c770b65ad7'],1,0,1,17348283,1,1,1,0,13278
a0a10fc5a98e16b8aec4717dc28af32c9f860d0e,1,tbeerbower,2014-01-29 14:38:33-05:00,['ea420ff9c3a13d50cdabd4a73f5fa7f24398076d'],6,3149,3155,17351438,29,0.729941292,0.804305284,0.850293542,13300
625b53c56cf38d6807ea1b24c68ae5a97495995e,0,Sumit Mohanty,2014-01-29 13:36:01-08:00,['a0a10fc5a98e16b8aec4717dc28af32c9f860d0e'],1,1,2,17351440,1,,,,13300
32f1ab98ac5c7dab793fcbfb9341cb0fe94fa7fd,1,Jaimin Jetly,2014-01-29 14:07:39-08:00,['625b53c56cf38d6807ea1b24c68ae5a97495995e'],2,2,4,17351444,1,,,,13300
dd9ec5a9fa99cd190ba2c6634eacd5f1e97a2199,1,Xi Wang,2014-01-29 14:54:16-08:00,['32f1ab98ac5c7dab793fcbfb9341cb0fe94fa7fd'],40,99,139,17351583,5,0,0.292682927,1,13300
3b5e39714516af49786e932ea4985a8b257607c5,1,Srimanth Gunturi,2014-01-29 15:00:21-08:00,['dd9ec5a9fa99cd190ba2c6634eacd5f1e97a2199'],13,1163,1176,17352759,19,0.533898305,0.807909605,0.935028249,13309
3035db82fa7a3b908fa1498c405c51727b1a333b,1,Xi Wang,2014-01-29 18:00:55-08:00,['3b5e39714516af49786e932ea4985a8b257607c5'],36,141,177,17352936,7,0.102564103,1,1,13309
8a415ee1f4314abf63c1e3ac1a83630a9582878d,1,Aleksandr Kovalenko,2014-01-30 13:04:07+02:00,['3035db82fa7a3b908fa1498c405c51727b1a333b'],20,291,311,17353247,15,0.6875,0.8125,1,13309
d0338adf31d51a7b250b6a079254e791fbb23e68,1,Oleg Nechiporenko,2014-01-30 14:26:54+02:00,['8a415ee1f4314abf63c1e3ac1a83630a9582878d'],98,440,538,17353785,13,0.784722222,0.611111111,1,13309
ab014b38406aa51fd5c930b94d6a182668a4ea3d,1,atkach,2014-01-30 14:38:50+02:00,['d0338adf31d51a7b250b6a079254e791fbb23e68'],48,5,53,17353838,2,0.772727273,0,0.318181818,13309
16773c272afa83df396a387fd4ef0c08af0be04d,0,Oleg Nechiporenko,2014-01-30 17:14:35+02:00,['ab014b38406aa51fd5c930b94d6a182668a4ea3d'],18,61,79,17353917,9,0.863636364,1,1,13310
a1995263fd2f68e3869c81f5f24cd731583611e7,1,aBabiichuk,2014-01-30 17:52:40+02:00,['16773c272afa83df396a387fd4ef0c08af0be04d'],6,40,46,17353963,6,0.88,0.16,1,13310
72535217cc044b1a6fe55d67098f00f3737b4a53,1,aBabiichuk,2014-01-30 19:12:14+02:00,['a1995263fd2f68e3869c81f5f24cd731583611e7'],5,58,63,17354026,9,0.90625,0.125,1,13310
2f0d12e4b67f420aa56a268b152b673b96f8ee51,0,Yusaku Sako,2014-01-30 11:14:55-08:00,['72535217cc044b1a6fe55d67098f00f3737b4a53'],61,18,79,17354105,9,0.136363636,0,0,13310
e8d045af20ae823a5c79fc304e88c937a208a004,0,Myroslav Papirkovskyy,2014-01-30 22:03:58+02:00,['2f0d12e4b67f420aa56a268b152b673b96f8ee51'],12,216,228,17354333,2,0.087719298,0.280701754,0.777777778,13310
c4a778da041ee56d01ef2dc88fd7fcfebe2a0680,1,Artem Baranchuk,2014-01-30 22:19:05+02:00,['e8d045af20ae823a5c79fc304e88c937a208a004'],19,149,168,17354501,5,0.028846154,1,0.942307692,13311
af7a9d89238330a0440e83e2b66f0c34f91df4dd,1,Xi Wang,2014-01-30 14:49:35-08:00,['c4a778da041ee56d01ef2dc88fd7fcfebe2a0680'],1,4,5,17354506,2,,,,13311
2585f9b51d7b39798721697a6a46b6ecdb30ce83,0,Xi Wang,2014-01-30 14:50:12-08:00,['af7a9d89238330a0440e83e2b66f0c34f91df4dd'],0,18,18,17354524,1,,,,13311
2fcd093ec58b9e4ec79db6bfb4a23e14360a99e4,1,tbeerbower,2014-01-30 18:42:22-05:00,['2585f9b51d7b39798721697a6a46b6ecdb30ce83'],4,2,6,17354530,2,,,,13311
f006ab20216a79506bd58467f787bceb19ca22d4,1,Mahadev Konar,2014-01-30 15:43:08-08:00,['2fcd093ec58b9e4ec79db6bfb4a23e14360a99e4'],600,24753,25353,17379883,30,,,,13319
0a9cd6496e06af042fa44010833d02152edece68,1,Oleg Nechiporenko,2014-01-31 13:47:05+02:00,['f006ab20216a79506bd58467f787bceb19ca22d4'],17,60,77,17379960,8,0.863636364,1,1,13320
fec3da3a2ef58e30f4239278e326921d406ca585,0,atkach,2014-01-31 16:59:29+02:00,['0a9cd6496e06af042fa44010833d02152edece68'],133,5,138,17380098,4,0,0,0,13320
861f3f39c3cb46508dae9034dd7090a99375b62e,0,Aleksandr Kovalenko,2014-01-31 17:40:01+02:00,['fec3da3a2ef58e30f4239278e326921d406ca585'],305,334,639,17380737,11,1,1,1,13320
b7e9dd9fb18cf7176c00b4d31244b189ea157f03,1,Oleg Nechiporenko,2014-01-31 18:15:47+02:00,['861f3f39c3cb46508dae9034dd7090a99375b62e'],21,232,253,17380990,6,0.276836158,1,1,13321
46608926ec0cdd184cc2c715821995e891380710,1,aBabiichuk,2014-01-31 19:09:00+02:00,['b7e9dd9fb18cf7176c00b4d31244b189ea157f03'],57,61,118,17381108,8,1,1,1,13321
c06aeba3125c525869f45fb349d7050c45930398,0,tbeerbower,2014-01-31 12:38:35-05:00,['46608926ec0cdd184cc2c715821995e891380710'],0,0,0,17381108,48,,,,13369
f2146a41ed26d4be8438112fed52f022fd8e4308,1,tbeerbower,2014-01-31 12:49:59-05:00,['c06aeba3125c525869f45fb349d7050c45930398'],680,298,978,17382086,29,0,0,1,13371
37f11ebda45eeac550ecacb78a25b40cd563825f,1,Lisnichenko Dmitro,2014-01-31 20:46:45+02:00,['f2146a41ed26d4be8438112fed52f022fd8e4308'],1355,8901,10256,17392342,49,0.942028986,0.362318841,0.355072464,13378
43f14b349cf529c7cda1a161f14bd1ea2ad54884,1,Andrew Onischuk,2014-01-31 11:49:08-08:00,['37f11ebda45eeac550ecacb78a25b40cd563825f'],35473,3586,39059,17431401,595,,,,13380
96980028711f7df88c387bd88a8cf7a4d07f8b89,1,Andrew Onischuk,2014-01-31 12:42:28-08:00,['43f14b349cf529c7cda1a161f14bd1ea2ad54884'],18,153,171,17431572,17,0,1,1,13380
5d4959c854f329bb12ec9328e9752626bda10300,1,Srimanth Gunturi,2014-01-31 13:13:02-08:00,['96980028711f7df88c387bd88a8cf7a4d07f8b89'],30,384,414,17431986,13,0.596774194,0.935483871,1,13383
d15577d0c520d0305289bc46b79b051aaf54ebfe,1,Jeff Sposetti,2014-01-31 16:34:25-05:00,['5d4959c854f329bb12ec9328e9752626bda10300'],0,83,83,17432069,6,1,1,1,13384
61ad24e7b6e521f52e9aae150da45bf9659d381b,1,Jaimin Jetly,2014-01-31 15:44:47-08:00,['d15577d0c520d0305289bc46b79b051aaf54ebfe'],6,13,19,17432088,5,0.4,0.4,1,13384
460c0d5f09956ad8ad4a66e5b4a7f9ed6fb8c535,0,atkach,2014-02-03 13:02:44+02:00,['61ad24e7b6e521f52e9aae150da45bf9659d381b'],27,15,42,17432130,1,0.8,0,0,13384
082e9ae044ebf932395dcfb2c9488fa2ce956233,0,Oleg Nechiporenko,2014-02-03 13:19:57+02:00,['460c0d5f09956ad8ad4a66e5b4a7f9ed6fb8c535'],0,2,2,17432132,1,,,,13384
20225db209c43c45e332515b2127dbd0e94452c1,1,Andrew Onischuk,2014-02-03 04:46:54-08:00,['082e9ae044ebf932395dcfb2c9488fa2ce956233'],37,78,115,17432247,12,0,1,1,13384
6372db8bf6e58cceacd1b1c0e7785dcbdac24b19,1,Vitaly Brodetskyi,2014-02-03 15:25:34+02:00,['20225db209c43c45e332515b2127dbd0e94452c1'],26,42,68,17432315,3,0,0.222222222,0.222222222,13384
5f464316237c2a1661602eaa230f197221aae271,1,John Speidel,2014-02-03 09:36:57-05:00,['6372db8bf6e58cceacd1b1c0e7785dcbdac24b19'],11,2141,2152,17434467,30,0.549450549,0.850274725,0.983516484,13400
0224d15d584fe3e5c6c15c60e62f2b615fe64aa5,1,Aleksandr Kovalenko,2014-02-03 18:23:05+02:00,['5f464316237c2a1661602eaa230f197221aae271'],2,3,5,17434472,1,,,,13400
92c040b5baace56f64190142fa790e292d2aaf03,1,Andrew Onischuk,2014-02-03 08:44:00-08:00,['0224d15d584fe3e5c6c15c60e62f2b615fe64aa5'],138,212,350,17434822,31,1,1,0.1875,13401
65d16bd9f5876cdc6aa41da7422491c73f0b893f,1,Andrew Onischuk,2014-02-03 08:44:00-08:00,['92c040b5baace56f64190142fa790e292d2aaf03'],9,85,94,17434916,2,,,,13401
97783f71a61446e6605ef99f180b6a1fff1cd5a4,1,Andrew Onischuk,2014-02-03 08:44:00-08:00,['65d16bd9f5876cdc6aa41da7422491c73f0b893f'],3,8,11,17434927,1,0,1,1,13401
36ebaad2438da9bda295c8a93d1e69fe68e44b9c,0,Andrew Onischuk,2014-02-03 08:44:00-08:00,['97783f71a61446e6605ef99f180b6a1fff1cd5a4'],21,2,23,17434950,6,0,0,0,13401
0de2e012bf8e2d7872d3c9c60bf8eec9b4e4cee7,0,Andrew Onischuk,2014-02-03 08:44:01-08:00,['36ebaad2438da9bda295c8a93d1e69fe68e44b9c'],5,7,12,17434962,2,0,1,1,13401
a127257e718c3a2e3a05b3c23be2e809f3a6b422,1,aBabiichuk,2014-02-03 18:52:21+02:00,['0de2e012bf8e2d7872d3c9c60bf8eec9b4e4cee7'],14,58,72,17435034,10,0.783783784,0.162162162,1,13401
aa25d928faa0251754acf830f3a83c68b0292cc9,1,aBabiichuk,2014-02-03 18:52:21+02:00,['a127257e718c3a2e3a05b3c23be2e809f3a6b422'],37,59,96,17435130,6,1,0.869565217,1,13401
3a2d9e3a96dbc792d4374f8fe10c6a618dfcd830,1,Oleg Nechiporenko,2014-02-03 18:58:25+02:00,['aa25d928faa0251754acf830f3a83c68b0292cc9'],3,6,9,17435139,1,,,,13401
a5c88d05a3f787e55c08f24e8ed3daf487812dd8,1,aBabiichuk,2014-02-03 19:23:34+02:00,['3a2d9e3a96dbc792d4374f8fe10c6a618dfcd830'],1,1,2,17435141,1,,,,13401
337248d1dbd50a1062d4917b58458a4e55fd2bcf,0,Oleg Nechiporenko,2014-02-03 19:42:03+02:00,['a5c88d05a3f787e55c08f24e8ed3daf487812dd8'],1,8,9,17435150,1,1,1,1,13401
0064670d46b7f88861b791e657a9b8b0d44f1981,1,Alex Antonenko,2014-02-03 19:58:36+02:00,['337248d1dbd50a1062d4917b58458a4e55fd2bcf'],120,266,386,17435536,6,0,0.7,1,13401
3289ea060ef4a4249bf5501e95bbe38461e12b9d,1,Lisnichenko Dmitro,2014-02-03 20:13:44+02:00,['0064670d46b7f88861b791e657a9b8b0d44f1981'],2,92,94,17435630,5,0.75,0.75,1,13403
c92863cba6a92cf859901eac5b09429902dca8f1,1,Oleg Nechiporenko,2014-02-03 20:39:35+02:00,['3289ea060ef4a4249bf5501e95bbe38461e12b9d'],14,14,28,17435658,2,,,,13403
cf5c6ad6445909bd23fc94affd4e1df6e7daadc7,1,Nate Cole,2014-02-03 14:10:45-05:00,['c92863cba6a92cf859901eac5b09429902dca8f1'],5,167,172,17435830,3,0.096491228,0.096491228,0.894736842,13403
b31639e7273d882112b15ee4d1f28701d1313302,1,Yusaku Sako,2014-02-03 11:38:20-08:00,['cf5c6ad6445909bd23fc94affd4e1df6e7daadc7'],74,93,167,17435997,1,0,0,1,13403
8fb4683780319704457e758cc2d55c6d247302c3,1,Lisnichenko Dmitro,2014-02-03 22:57:05+02:00,['b31639e7273d882112b15ee4d1f28701d1313302'],10,866,876,17436873,17,0.238095238,0.80952381,1,13410
3349f699ad714c6da3dba75c8c6c5bea1c5a556a,1,Yusaku Sako,2014-02-03 14:32:04-08:00,['8fb4683780319704457e758cc2d55c6d247302c3'],1,1,2,17436875,1,,,,13410
9bf73024d128a768247c97551cf926f511e132e8,1,Jaimin Jetly,2014-02-03 15:46:38-08:00,['3349f699ad714c6da3dba75c8c6c5bea1c5a556a'],5,71,76,17436951,7,,,,13411
6ad7de9d1bee1f41a7db0feef1bbf031a28bb0aa,1,Oleg Nechiporenko,2014-02-04 13:21:44+02:00,['9bf73024d128a768247c97551cf926f511e132e8'],5,18,23,17436974,5,1,1,1,13411
2134e526cbf44e7459d4c61c86cb2f141d9a8416,1,aBabiichuk,2014-02-04 15:12:57+02:00,['6ad7de9d1bee1f41a7db0feef1bbf031a28bb0aa'],116,189,305,17437279,3,,,,13411
a1c5645d91f3f0f6072268dfadf031081253e561,0,Aleksandr Kovalenko,2014-02-04 15:24:52+02:00,['2134e526cbf44e7459d4c61c86cb2f141d9a8416'],14,88,102,17437381,12,0.184210526,0.289473684,1,13411
7057e558e2ce1f5863f68e5cfff0f522099e1400,1,Lisnichenko Dmitro,2014-02-04 16:06:13+02:00,['a1c5645d91f3f0f6072268dfadf031081253e561'],31,5,36,17437417,7,0.666666667,0,0,13411
2d8117e01ec89b0d7524b4cb1bdc96d0412ee0a5,1,Oleg Nechiporenko,2014-02-04 16:42:49+02:00,['7057e558e2ce1f5863f68e5cfff0f522099e1400'],60,192,252,17437669,5,1,1,1,13411
0e58a038efa498afb0891fdf1c965f573dac080b,1,Andrew Onischuk,2014-02-04 06:58:02-08:00,['2d8117e01ec89b0d7524b4cb1bdc96d0412ee0a5'],12,12,24,17437693,5,0,0,1,13411
aaea21f0e67153da34e9bc3f7d31bf5a8d98c46f,0,Andrew Onischuk,2014-02-04 08:29:30-08:00,['0e58a038efa498afb0891fdf1c965f573dac080b'],1,1,2,17437695,1,0,0,0,13411
1d80ca0bc3f7eb82f0f2bbd2625a72ba7b64c1cc,1,Sumit Mohanty,2014-02-04 11:22:44-08:00,['aaea21f0e67153da34e9bc3f7d31bf5a8d98c46f'],15,1648,1663,17439358,13,0.244186047,0.654069767,0.985465116,13415
aeb36c36e4dffa6ea1082b5298ff7b07e17352f1,1,tbeerbower,2014-02-04 12:35:29-08:00,['1d80ca0bc3f7eb82f0f2bbd2625a72ba7b64c1cc'],1,5,6,17439364,1,,,,13415
cb4adf179287f0201bbf1782b3cca155bef86e25,0,tbeerbower,2014-02-04 13:00:14-08:00,['aeb36c36e4dffa6ea1082b5298ff7b07e17352f1'],9,9,18,17439382,3,,,,13415
dcb90c9d2e0f2b6f3a0a0916ca5bf6339e24fbfb,1,tbeerbower,2014-02-04 13:13:17-08:00,['cb4adf179287f0201bbf1782b3cca155bef86e25'],1,2,3,17439385,1,,,,13415
aa7ba4d276a08ecdff0b3f773cc2fc823b531c0e,1,Lisnichenko Dmitro,2014-02-04 23:34:12+02:00,['dcb90c9d2e0f2b6f3a0a0916ca5bf6339e24fbfb'],46,587,633,17440018,11,0.666666667,0.238095238,0,13418
e969f4388af28dc0652dc74154fa9ebc95cf5f2f,0,Yusaku Sako,2014-02-04 13:42:43-08:00,['aa7ba4d276a08ecdff0b3f773cc2fc823b531c0e'],10,22,32,17440050,1,1,1,1,13418
6d9f7e8717e59ad146fdc92c75591813a2c0325c,1,Yusaku Sako,2014-02-04 14:22:32-08:00,['e969f4388af28dc0652dc74154fa9ebc95cf5f2f'],10,19,29,17440079,2,1,1,1,13418
61618f73c6478c0e2a460c3b0a6ae7fcc0d33885,1,tbeerbower,2014-02-04 14:39:56-08:00,['6d9f7e8717e59ad146fdc92c75591813a2c0325c'],44,638,682,17440761,15,0.73015873,0.566137566,0.941798942,13423
76c85a73501e46f3d1a1315301fd2b78f7989de6,0,Siddharth Wagle,2014-02-04 18:33:29-08:00,['61618f73c6478c0e2a460c3b0a6ae7fcc0d33885'],6,62,68,17440829,4,0.5,0,1,13423
60c338b286b5b1b12395cd24a8620241b583ab02,1,Jaimin Jetly,2014-02-04 18:53:05-08:00,['76c85a73501e46f3d1a1315301fd2b78f7989de6'],4,18,22,17440851,2,0.857142857,0.857142857,1,13423
a12ea1ec828b7337ceeea363719a2dc1d0be02ce,1,Dmitry Sen,2014-02-05 11:29:41+02:00,['60c338b286b5b1b12395cd24a8620241b583ab02'],102,647,749,17441600,24,0,1,1,13423
8d5c0b6a887375cfef55542f386d6a5fe97a3618,1,tbeerbower,2014-02-05 04:09:07-08:00,['a12ea1ec828b7337ceeea363719a2dc1d0be02ce'],2,2,4,17441604,1,,,,13423
1dbea4476dff6600ed741af18b55f7a315246d67,0,tbeerbower,2014-02-05 04:35:27-08:00,['8d5c0b6a887375cfef55542f386d6a5fe97a3618'],2,1,3,17441607,2,,,,13423
5bf15d0ab6d8d9f3c2b0f3fa785028592424e50e,1,Andrew Onischuk,2014-02-05 04:36:00-08:00,['1dbea4476dff6600ed741af18b55f7a315246d67'],4,6,10,17441617,4,1,,,13423
8e181741590d75ab371ce9fec9067bca2942623f,1,aBabiichuk,2014-02-05 15:38:27+02:00,['5bf15d0ab6d8d9f3c2b0f3fa785028592424e50e'],15,42,57,17441674,4,1,1,0.117647059,13423
d4330ad2fae3c02009cd6ad4dc49997a4e355a82,1,aBabiichuk,2014-02-05 17:39:30+02:00,['8e181741590d75ab371ce9fec9067bca2942623f'],7,6,13,17441687,1,,,,13423
d4387a0efcf3753e65d42f7c891f804930324511,0,aBabiichuk,2014-02-05 17:41:31+02:00,['d4330ad2fae3c02009cd6ad4dc49997a4e355a82'],1,1,2,17441689,1,,,,13423
d0eeac994758e3fcd1892ea95b6facfc28aa9ee6,1,Andrew Onischuk,2014-02-05 08:11:04-08:00,['d4387a0efcf3753e65d42f7c891f804930324511'],8,35,43,17441732,4,0.727272727,0.727272727,0.090909091,13423
804a8c5ce6595144898434ad025944d3253f7319,1,Aleksandr Kovalenko,2014-02-05 19:45:27+02:00,['d0eeac994758e3fcd1892ea95b6facfc28aa9ee6'],142,122,264,17441996,8,0,0,0,13424
64553564d98b633049938c589808417db944381a,0,Mahadev Konar,2014-02-05 14:10:59-08:00,['804a8c5ce6595144898434ad025944d3253f7319'],1,1,2,17441998,1,,,,13424
e826f78e624a7525bc5df38e0b1d46095074db29,0,Yusaku Sako,2014-02-05 14:37:45-08:00,['64553564d98b633049938c589808417db944381a'],2,4,6,17442004,1,,,,13424
ac8afa72e8c3f3c6d5986c75dd801dd39bc196ba,0,tbeerbower,2014-02-05 16:04:53-08:00,['e826f78e624a7525bc5df38e0b1d46095074db29'],12,60,72,17442076,5,1,1,0,13424
ca558726d02eb5cf3d77f2fe3d2cd5a11639badc,0,Sumit Mohanty,2014-02-05 18:09:31-08:00,['ac8afa72e8c3f3c6d5986c75dd801dd39bc196ba'],19,33,52,17442128,2,0,0.25,1,13424
c42a60e3a1c7fd9e2a9c8f39be31beb966c11fe3,1,Mahadev Konar,2014-02-05 21:20:04-08:00,['ca558726d02eb5cf3d77f2fe3d2cd5a11639badc'],1,1,2,17442130,1,,,,13424
9ec612ca14dcdd4131158bc4ea9b7ba817f45302,1,Oleg Nechiporenko,2014-02-06 13:43:52+02:00,['c42a60e3a1c7fd9e2a9c8f39be31beb966c11fe3'],795,894,1689,17443819,7,1,1,1,13426
a68dd4b1a82c56b9a44c977678deb9b3d618da51,1,Andrew Onischuk,2014-02-06 06:21:21-08:00,['9ec612ca14dcdd4131158bc4ea9b7ba817f45302'],3,5,8,17443827,1,,,,13426
1617c73570652bd27ed68d1d49214d17fa16c1ea,1,Vitaly Brodetskyi,2014-02-06 17:41:59+02:00,['a68dd4b1a82c56b9a44c977678deb9b3d618da51'],17,1446,1463,17445290,16,0.376923077,1,0.753846154,13436
eec3548f10e8bceea9127f8cd641e4d77ed2474a,0,tbeerbower,2014-02-06 08:39:32-08:00,['1617c73570652bd27ed68d1d49214d17fa16c1ea'],2,39,41,17445331,3,1,1,1,13436
369aeb4e5b551f91fb034aba6ce1b59490925e04,1,Nate Cole,2014-02-06 09:24:08-08:00,['eec3548f10e8bceea9127f8cd641e4d77ed2474a'],4,60,64,17445395,4,0,0.071428571,0.619047619,13436
a627a68bb6c447b2acced581896cdb30cac27023,1,Yusaku Sako,2014-02-06 14:15:10-08:00,['369aeb4e5b551f91fb034aba6ce1b59490925e04'],1,1,2,17445397,1,,,,13436
a3844f930bdc439b029e49a31fa3d77ed2cec5fe,1,Yusaku Sako,2014-02-06 14:31:59-08:00,['a627a68bb6c447b2acced581896cdb30cac27023'],1,11,12,17445409,2,1,1,1,13436
db991df50d1a47e68d78e8c949ae4b03f727de14,0,Mahadev Konar,2014-02-06 22:31:31-08:00,['a3844f930bdc439b029e49a31fa3d77ed2cec5fe'],1,1,2,17445411,1,,,,13436
3f2a76b1e02dfc123488e98a240580c695849733,1,Vitaly Brodetskyi,2014-02-07 10:37:09+02:00,['db991df50d1a47e68d78e8c949ae4b03f727de14'],7,22,29,17445440,3,0,0,1,13436
c9202e26c0b1390aa918506e6bb46e7fc1836817,1,Oleg Nechiporenko,2014-02-07 12:58:24+02:00,['3f2a76b1e02dfc123488e98a240580c695849733'],14,54,68,17445508,5,0.964285714,1,1,13436
2e88be437a6db62a48a52f1db8f1ddf044b2b785,1,aBabiichuk,2014-02-07 14:10:50+02:00,['c9202e26c0b1390aa918506e6bb46e7fc1836817'],2,4,6,17445514,2,,,,13436
522b6d2ea8b1c3fc8bf7fcd948ab38bf3856e3aa,1,aBabiichuk,2014-02-07 14:10:50+02:00,['2e88be437a6db62a48a52f1db8f1ddf044b2b785'],3,4,7,17445521,4,,,,13436
61782812576ec9f98aeb40cf9cf61dff2fe44d9a,1,aBabiichuk,2014-02-07 14:49:27+02:00,['522b6d2ea8b1c3fc8bf7fcd948ab38bf3856e3aa'],2,2,4,17445525,2,,,,13436
556102801a008351d9c2e21870d5bd803f181759,0,Andrew Onischuk,2014-01-17 04:20:27-08:00,['61782812576ec9f98aeb40cf9cf61dff2fe44d9a'],6,2,8,17445533,2,1,0,0,13436
e6e6a5ef71858d9746745dbd8cbe3b09992418fe,1,Oleg Nechiporenko,2014-02-07 15:47:56+02:00,['556102801a008351d9c2e21870d5bd803f181759'],199,956,1155,17446688,8,1,1,1,13438
16d0f7bbd0b4ff30ad72880d7d76a697a8ab4d67,1,Andrew Onischuk,2014-02-07 05:55:06-08:00,['e6e6a5ef71858d9746745dbd8cbe3b09992418fe'],2,2,4,17446692,2,,,,13438
c7a9937af54210bd5d6004c329a8d2bf0f66ad2a,1,Dmitry Sen,2014-02-07 20:54:33+02:00,['16d0f7bbd0b4ff30ad72880d7d76a697a8ab4d67'],0,298,298,17446990,4,0,1,1,13442
e3b1b09debac75176dbeb97ca1fc015960d98237,1,Alex Antonenko,2014-02-07 21:49:44+02:00,['c7a9937af54210bd5d6004c329a8d2bf0f66ad2a'],65,39,104,17447094,5,1,0.65,0,13442
dbb625eb344bf5dc8f18759bb1ede2b99a9a4260,0,Jaimin Jetly,2014-02-07 14:29:12-08:00,['e3b1b09debac75176dbeb97ca1fc015960d98237'],1,1,2,17447096,1,,,,13442
f221f7f8da4121e915c076ad785354c7b2758127,1,Yusaku Sako,2014-02-07 14:33:04-08:00,['dbb625eb344bf5dc8f18759bb1ede2b99a9a4260'],0,1,1,17447097,1,,,,13442
25d44e52e4cc199a405f9cd9aecfe57564d4c0a9,1,Yusaku Sako,2014-02-07 14:33:04-08:00,['f221f7f8da4121e915c076ad785354c7b2758127'],2,2,4,17447101,1,,,,13442
a687e1b201a1ec36c2625e3eeca3559644715abd,1,Andrew Onischuk,2014-02-07 15:03:59-08:00,['25d44e52e4cc199a405f9cd9aecfe57564d4c0a9'],23,81,104,17447205,13,0,1,1,13442
6516491ed3ff3a3c7bffb694d4a59c961400dc16,1,Mahadev Konar,2014-02-07 15:53:08-08:00,['a687e1b201a1ec36c2625e3eeca3559644715abd'],3,3,6,17447211,2,,,,13442
9d9e70486fa33bbf2634e97b8e13dd084b01d0cb,1,Alex Antonenko,2014-02-08 03:09:08+02:00,['6516491ed3ff3a3c7bffb694d4a59c961400dc16'],1,151,152,17447363,11,1,1,1,13445
1f6bf6582f536e3bc10641b47ad578c2ff00d8eb,1,Srimanth Gunturi,2014-02-07 17:40:12-08:00,['9d9e70486fa33bbf2634e97b8e13dd084b01d0cb'],99,845,944,17448307,14,0.508905852,0.814249364,0.956743003,13447
9fe84f4756620a224f1c1fe125e3f384b5e887e6,1,Mahadev Konar,2014-02-09 22:18:54-08:00,['1f6bf6582f536e3bc10641b47ad578c2ff00d8eb'],9,26,35,17448342,3,0,1,1,13447
9d07f72a50cf5bcc4068ddb9a5681374b8481f5e,0,Oleg Nechiporenko,2014-02-10 11:48:28+02:00,['9fe84f4756620a224f1c1fe125e3f384b5e887e6'],14,1,15,17448357,2,0,0,0,13447
9b7f183cb04290c04761afdea12e7c8a9880c132,1,Andrew Onischuk,2014-02-10 03:27:50-08:00,['9d07f72a50cf5bcc4068ddb9a5681374b8481f5e'],2,522,524,17448881,4,0.157894737,1,1,13449
8a9d841ee4e1cd3a137e75b05c5490ad2de5e206,1,aBabiichuk,2014-02-10 15:49:05+02:00,['9b7f183cb04290c04761afdea12e7c8a9880c132'],4,4,8,17448889,2,,,,13449
1fd3e2ccbd1731f686db28db18438c87c889645d,1,Vitaly Brodetskyi,2014-02-10 16:58:45+02:00,['8a9d841ee4e1cd3a137e75b05c5490ad2de5e206'],2,4,6,17448895,2,,,,13449
dea337569d8fe85b42ac716771e61d6c011cbddf,0,Nate Cole,2014-02-10 10:09:22-05:00,['1fd3e2ccbd1731f686db28db18438c87c889645d'],1,16,17,17448912,2,0,0,0.9,13449
65e8bc1e25d005296d961fc51796c11f56eaf596,1,Lisnichenko Dmitro,2014-02-10 18:54:39+02:00,['dea337569d8fe85b42ac716771e61d6c011cbddf'],0,761,761,17449673,4,0.088328076,1,1,13453
a7bc7d669352c4a4b5d6b4c31f5791f461e947c2,1,Andrew Onischuk,2014-02-10 09:03:26-08:00,['65e8bc1e25d005296d961fc51796c11f56eaf596'],9,14,23,17449696,6,1,0,1,13453
2e2b7153f4b8f60f901d61a7d2393b800305bc82,0,aBabiichuk,2014-02-10 19:16:41+02:00,['a7bc7d669352c4a4b5d6b4c31f5791f461e947c2'],4,9,13,17449709,2,,,,13453
84fba7b22d0ded0a30c7b4f191b69432abe96acb,1,aBabiichuk,2014-02-10 19:48:47+02:00,['2e2b7153f4b8f60f901d61a7d2393b800305bc82'],39,120,159,17449868,6,0.88,0.88,1,13453
0a79a472ebcaccda560816e4f744b68cc5a801fa,1,Nate Cole,2014-02-10 12:57:31-05:00,['84fba7b22d0ded0a30c7b4f191b69432abe96acb'],66,199,265,17450133,10,0.115942029,0.942028986,1,13454
e20cd88855b8cbf623add2ba41908a76aeaf7c7d,0,Alex Antonenko,2014-02-10 20:12:27+02:00,['0a79a472ebcaccda560816e4f744b68cc5a801fa'],36,168,204,17450337,4,0,0,0,13455
2b4e3956395c5b8232e41372c475aaf672269919,1,Sumit Mohanty,2014-02-10 14:13:44-08:00,['e20cd88855b8cbf623add2ba41908a76aeaf7c7d'],71,337,408,17450745,33,0.37628866,0.819587629,0.773195876,13455
c9ddb9e84e3707ea8ba60427e5b1045fbdf02198,0,Yusaku Sako,2014-02-10 16:02:21-08:00,['2b4e3956395c5b8232e41372c475aaf672269919'],1,1,2,17450747,1,,,,13455
ccb61e86d1dc1e5c4e5f5f532471fc6ec9749189,0,Srimanth Gunturi,2014-02-10 17:44:51-08:00,['c9ddb9e84e3707ea8ba60427e5b1045fbdf02198'],1,12,13,17450760,2,1,1,1,13455
49bcf0fa038c482e7a7509e8ef97c6282918f34d,1,Oleg Nechiporenko,2014-02-11 13:20:17+02:00,['ccb61e86d1dc1e5c4e5f5f532471fc6ec9749189'],5,7,12,17450772,3,1,1,1,13455
d0f3c900f2ca1761d15b26b5e9e699d3a6edea99,1,Oleg Nechiporenko,2014-02-11 13:51:02+02:00,['49bcf0fa038c482e7a7509e8ef97c6282918f34d'],1,24,25,17450797,1,,,,13455
980cdec62c5d8b1aa811b93dc5b491db16efc9d7,0,aBabiichuk,2014-02-11 13:51:43+02:00,['d0f3c900f2ca1761d15b26b5e9e699d3a6edea99'],1,1,2,17450799,1,,,,13455
3990199f97906b56ceca44aef4a0b6020b08e895,1,Oleg Nechiporenko,2014-02-11 14:00:34+02:00,['980cdec62c5d8b1aa811b93dc5b491db16efc9d7'],13,15,28,17450827,1,,,,13455
a9e999bf4b62c841a3b6204891d075df6488cde3,0,aBabiichuk,2014-02-11 14:01:28+02:00,['3990199f97906b56ceca44aef4a0b6020b08e895'],6,0,6,17450833,1,,,,13455
d0aa14b64df2aed57e48acc933e2238921d78002,1,aBabiichuk,2014-02-11 14:11:01+02:00,['a9e999bf4b62c841a3b6204891d075df6488cde3'],1,1,2,17450835,1,,,,13455
6171bda09e2b5584fd840d0129826b338c33209d,0,Oleg Nechiporenko,2014-02-11 14:17:04+02:00,['d0aa14b64df2aed57e48acc933e2238921d78002'],1,1,2,17450837,1,,,,13455
7bb9b47d721feadd1cb3002fcc7623c8db12710f,1,aBabiichuk,2014-02-11 14:25:50+02:00,['6171bda09e2b5584fd840d0129826b338c33209d'],28,114,142,17450979,6,1,1,1,13457
072c625e9292c5f0906f76658551deb6d8eb3f0a,0,Andrew Onischuk,2014-02-11 04:47:37-08:00,['7bb9b47d721feadd1cb3002fcc7623c8db12710f'],2,6,8,17450987,1,0,1,0,13457
6cbdded043b8710609f7989220828d833eb5526c,1,aBabiichuk,2014-02-11 15:36:28+02:00,['072c625e9292c5f0906f76658551deb6d8eb3f0a'],37,38,75,17451062,1,0,0,1,13457
53ef1ce765e3536899439995855fdd341df6036f,1,Andrew Onischuk,2014-02-11 05:58:55-08:00,['6cbdded043b8710609f7989220828d833eb5526c'],14,40,54,17451116,4,0,0.666666667,1,13457
557b132f1fd9d2546040dfc6e53a92a21c567368,1,Andrew Onischuk,2014-02-11 05:58:55-08:00,['53ef1ce765e3536899439995855fdd341df6036f'],16,130,146,17451262,8,0.2,0,1,13459
776a39ebda62d53ac0eea97201685be6b69b229e,0,Aleksandr Kovalenko,2014-02-11 16:29:48+02:00,['557b132f1fd9d2546040dfc6e53a92a21c567368'],724,411,1135,17452397,23,1,0,0.142857143,13462
2ebdc7f15ec465883570374b9659ddc5dbfed9c9,1,aBabiichuk,2014-02-11 17:06:21+02:00,['776a39ebda62d53ac0eea97201685be6b69b229e'],10,11,21,17452418,4,0,0,0,13462
317da3335701b4457e5fd821a393659a127bc549,0,Oleg Nechiporenko,2014-02-11 17:48:36+02:00,['2ebdc7f15ec465883570374b9659ddc5dbfed9c9'],1,1,2,17452420,1,,,,13462
81f5dd2437fca155afab13785c30a43bd3b36d3d,1,Oleg Nechiporenko,2014-02-11 17:49:21+02:00,['317da3335701b4457e5fd821a393659a127bc549'],1,1,2,17452422,1,,,,13462
fa47490b58668ab7e33eba82174e011f16cb6f1b,1,Andrew Onischuk,2014-02-11 08:16:38-08:00,['81f5dd2437fca155afab13785c30a43bd3b36d3d'],249,1833,2082,17454504,57,0.003878976,0.927075252,1,13464
3bfab6fbdd82976333f52eb9e793e2fb1c4954c3,0,Lisnichenko Dmitro,2014-02-11 18:35:28+02:00,['fa47490b58668ab7e33eba82174e011f16cb6f1b'],5,1,6,17454510,1,1,1,0,13464
90b463d2b3004d6de14b77cd761b955b5807e600,1,aBabiichuk,2014-02-11 18:41:23+02:00,['3bfab6fbdd82976333f52eb9e793e2fb1c4954c3'],2,3,5,17454515,1,0,0,1,13464
bad3ad2bb464f5b4fa23b7ead4560349d1826c56,1,aBabiichuk,2014-02-11 18:49:23+02:00,['90b463d2b3004d6de14b77cd761b955b5807e600'],3,4,7,17454522,1,,,,13464
b527a781ccf139e4194f5fb18440b01bee72a28d,0,aBabiichuk,2014-02-11 18:52:11+02:00,['bad3ad2bb464f5b4fa23b7ead4560349d1826c56'],1,1,2,17454524,1,,,,13464
e7cf023b34d93901069a6410b98d6057d9b61e9b,1,Lisnichenko Dmitro,2014-02-11 19:03:01+02:00,['b527a781ccf139e4194f5fb18440b01bee72a28d'],190,1314,1504,17456028,18,0.304556355,1,1,13471
3cfc8308fef22193dfee00d1310dd1910aececc0,0,Andrew Onischuk,2014-02-11 09:19:40-08:00,['e7cf023b34d93901069a6410b98d6057d9b61e9b'],13,31,44,17456072,6,0,1,1,13471
7f834d421d879d142fe5065ea7964722c11a7cfe,1,Andrew Onischuk,2014-01-17 05:27:57-08:00,['3cfc8308fef22193dfee00d1310dd1910aececc0'],4,1934,1938,17458010,7,0,0,1,13472
e66d84f8a8fb82bb31cc6f7b220a422443541dfe,1,Andrew Onischuk,2014-02-11 09:40:13-08:00,['7f834d421d879d142fe5065ea7964722c11a7cfe'],109,35,144,17458154,3,1,0.74137931,0,13472
6497bc91967b0152bee94bfc64e67873bc629d8f,1,Andrew Onischuk,2014-02-11 10:46:58-08:00,['e66d84f8a8fb82bb31cc6f7b220a422443541dfe'],1,1,2,17458156,1,,,,13472
e4ac9eda75646e725fb11f727eeaea26eb0bdd13,0,Siddharth Wagle,2014-02-11 11:03:58-08:00,['6497bc91967b0152bee94bfc64e67873bc629d8f'],1,1,2,17458158,1,,,,13472
91af8962d1c85077328ad29f09720582cdf64908,0,Srimanth Gunturi,2014-02-11 12:51:05-08:00,['e4ac9eda75646e725fb11f727eeaea26eb0bdd13'],4,27,31,17458189,3,1,1,1,13472
19cc7ba62e6f9f45deb0e1bcd0708d0e4f9c117f,1,Siddharth Wagle,2014-02-11 13:29:40-08:00,['91af8962d1c85077328ad29f09720582cdf64908'],36,91,127,17458316,1,,,,13472
636abc2658b4c3455d04bee6e19703edb0e54b74,1,Yusaku Sako,2014-02-11 14:25:14-08:00,['19cc7ba62e6f9f45deb0e1bcd0708d0e4f9c117f'],23,23,46,17458362,3,,,,13472
f303a4657bb766ded93775a54558d2478118abcf,1,Srimanth Gunturi,2014-02-11 14:50:36-08:00,['636abc2658b4c3455d04bee6e19703edb0e54b74'],6,10,16,17458378,3,1,1,1,13472
d4614598ff6689d83ba721747fcf3f4a637dedad,1,Yusaku Sako,2014-02-11 15:10:55-08:00,['f303a4657bb766ded93775a54558d2478118abcf'],2,2,4,17458382,2,,,,13472
0ce7bb06d748bfa170c9c2d5dc0375dba2b88fa9,0,Yusaku Sako,2014-02-11 15:12:52-08:00,['d4614598ff6689d83ba721747fcf3f4a637dedad'],1,1,2,17458384,1,,,,13472
676c1a4d60bd0894e50557766b28967a161c77a6,1,Yusaku Sako,2014-02-11 16:55:43-08:00,['0ce7bb06d748bfa170c9c2d5dc0375dba2b88fa9'],0,1,1,17458385,1,,,,13472
b986691a197dd8bfe2794cd3b02b86753db5fff5,0,Jaimin Jetly,2014-02-11 17:07:27-08:00,['676c1a4d60bd0894e50557766b28967a161c77a6'],0,6,6,17458391,1,0,0,1,13472
d0b03b5f581e929101d2b96cfa62ff8db1f8c5fa,1,Mahadev Konar,2014-02-11 17:53:43-08:00,['b986691a197dd8bfe2794cd3b02b86753db5fff5'],8,11,19,17458410,6,,,,13472
49131366201e701efaa96af3882fe770fb03dd74,1,Siddharth Wagle,2014-02-11 18:48:12-08:00,['d0b03b5f581e929101d2b96cfa62ff8db1f8c5fa'],27,235,262,17458672,3,0.087248322,0.375838926,0.711409396,13472
fbbf7776295749f5c7408bebf870e78e37bc66e6,1,Srimanth Gunturi,2014-02-11 18:51:49-08:00,['49131366201e701efaa96af3882fe770fb03dd74'],0,18,18,17458690,2,,,,13472
16fe1f21dfbf0a53535679dcbe411dfcfce11a33,1,aBabiichuk,2014-02-12 13:53:33+02:00,['fbbf7776295749f5c7408bebf870e78e37bc66e6'],4,15,19,17458709,2,1,1,1,13472
8b90b39bf2645251b9aa27b5b32fcad1947317a1,1,atkach,2014-02-12 14:14:00+02:00,['16fe1f21dfbf0a53535679dcbe411dfcfce11a33'],1,1,2,17458711,1,,,,13472
9d6e78168fe4d3c2e873a9390cd4d61166ed4e8e,1,Vitaly Brodetskyi,2014-02-12 17:17:58+02:00,['8b90b39bf2645251b9aa27b5b32fcad1947317a1'],22,101,123,17458834,3,0,0.9,0.9,13472
40319d893f409c73951fb13331125d37e564e4e3,1,Andrew Onischuk,2014-02-12 07:23:44-08:00,['9d6e78168fe4d3c2e873a9390cd4d61166ed4e8e'],0,219,219,17459053,1,0,1,0,13473
5fd74cbb3e0b072aa2864ff3a96e8d7763ac9b1c,1,Andrew Onischuk,2014-02-12 08:36:00-08:00,['40319d893f409c73951fb13331125d37e564e4e3'],4,59,63,17459116,8,0,1,1,13473
06763f827f0ede656ada691142d49dc4bd57b078,0,Vitaly Brodetskyi,2014-02-12 19:07:18+02:00,['5fd74cbb3e0b072aa2864ff3a96e8d7763ac9b1c'],1,1,2,17459118,1,,,,13473
3e179d2425d996b5e0a917a07fc26b23c6ee90ef,1,Andrew Onischuk,2014-02-12 09:10:21-08:00,['06763f827f0ede656ada691142d49dc4bd57b078'],25,25,50,17459168,25,,,,13473
4a31747024370c8379875288ec8e1b906f634e66,1,Andrew Onischuk,2014-02-12 09:50:31-08:00,['3e179d2425d996b5e0a917a07fc26b23c6ee90ef'],7,29,36,17459204,8,0,1,1,13473
c14a483bd2a93be895af1a0fa3d7d142fdb9d980,0,Alex Antonenko,2014-02-12 19:56:19+02:00,['4a31747024370c8379875288ec8e1b906f634e66'],3,3,6,17459210,2,,,,13473
03e0f066efe5a4e864675d5d22994a6bc4ca585c,1,aBabiichuk,2014-02-12 19:57:01+02:00,['c14a483bd2a93be895af1a0fa3d7d142fdb9d980'],2,2,4,17459214,1,,,,13473
15fc0eca3ac40600e5ec612ba8754ef7658f101c,1,Andrew Onischuk,2014-02-12 10:09:37-08:00,['03e0f066efe5a4e864675d5d22994a6bc4ca585c'],0,138,138,17459352,1,0,1,0,13474
2213e103b07e0951891a0df57d4db78a86cbd49a,0,atkach,2014-02-12 20:14:09+02:00,['15fc0eca3ac40600e5ec612ba8754ef7658f101c'],13,28,41,17459393,10,1,1,1,13474
f64fed6a1ee77c13f8ab4539bdc6d5826d9f4028,1,Jaimin Jetly,2014-02-12 15:03:25-08:00,['2213e103b07e0951891a0df57d4db78a86cbd49a'],345,33,378,17459771,2,,,,13474
99a26c9a50cf019eefddb13d7aec03c6145eb65b,1,Alex Antonenko,2014-02-13 01:07:12+02:00,['f64fed6a1ee77c13f8ab4539bdc6d5826d9f4028'],28,303,331,17460102,7,0.700729927,0.576642336,1,13476
db4271471f19cd56c5d89cd76beeb077054d7752,0,Srimanth Gunturi,2014-02-12 16:38:33-08:00,['99a26c9a50cf019eefddb13d7aec03c6145eb65b'],290,120,410,17460512,8,1,1,1,13476
534a00139134b523d5feed6959601e916d0c90de,1,Siddharth Wagle,2014-02-12 16:51:41-08:00,['db4271471f19cd56c5d89cd76beeb077054d7752'],36,277,313,17460825,9,0.069306931,0.638613861,0.98019802,13476
59a5075d5ec0db431785cfe5a55369162a854c11,0,Siddharth Wagle,2014-02-12 16:53:13-08:00,['534a00139134b523d5feed6959601e916d0c90de'],1,10,11,17460836,1,,,,13476
7f8d215cc8d5a5c558ea9b125dcb5b50aa95b460,1,Nate Cole,2014-02-12 20:11:31-05:00,['59a5075d5ec0db431785cfe5a55369162a854c11'],169,926,1095,17461931,33,0.195783133,0.539156627,0.897590361,13480
abbd1020963fe41a54ca6a89cc38661c035e6231,1,Srimanth Gunturi,2014-02-12 18:36:40-08:00,['7f8d215cc8d5a5c558ea9b125dcb5b50aa95b460'],34,52,86,17462017,4,,,,13480
e11d100e5bd9512570d09e19dd4a1c024c2e9da5,1,Alex Antonenko,2014-02-13 14:03:29+02:00,['abbd1020963fe41a54ca6a89cc38661c035e6231'],59,233,292,17462309,2,0.660377358,1,1,13480
4bbd5ea37651d3fb18add7f997f45b8b6d3329e7,1,atkach,2014-02-13 14:22:01+02:00,['e11d100e5bd9512570d09e19dd4a1c024c2e9da5'],16,17,33,17462342,1,0,0,1,13480
8d1d814de9dbed9060fc7bd1af63df42bbd0ec16,0,Alex Antonenko,2014-02-13 15:15:18+02:00,['4bbd5ea37651d3fb18add7f997f45b8b6d3329e7'],4,4,8,17462350,1,,,,13480
8ea3b178a5d5798af32720080399cff009a7d48c,1,Oleg Nechiporenko,2014-02-13 15:47:24+02:00,['8d1d814de9dbed9060fc7bd1af63df42bbd0ec16'],0,12,12,17462362,1,,,,13480
a6224cfb451207410c1a261583348ed107e55c5d,1,Lisnichenko Dmitro,2014-02-13 15:58:24+02:00,['8ea3b178a5d5798af32720080399cff009a7d48c'],5,25,30,17462392,4,0,1,1,13480
812092497d2ac64cb8e6f3f523d0c5275f994f72,1,aBabiichuk,2014-02-13 15:59:34+02:00,['a6224cfb451207410c1a261583348ed107e55c5d'],22,68,90,17462482,2,,,,13480
957349c3b8b56f96575268bdb79cd952ef26ad84,0,Alex Antonenko,2014-02-13 17:04:19+02:00,['812092497d2ac64cb8e6f3f523d0c5275f994f72'],5,37,42,17462524,4,1,1,1,13480
1d5a462146683636ddf28ee102c75441f37f3389,0,atkach,2014-02-13 17:27:03+02:00,['957349c3b8b56f96575268bdb79cd952ef26ad84'],5,6,11,17462535,4,,,,13480
9537488e766592a424577cff2cbc32aceb1e57a3,0,Alex Antonenko,2014-02-13 17:41:34+02:00,['1d5a462146683636ddf28ee102c75441f37f3389'],2,2,4,17462539,1,,,,13480
d377fe2189be88e5df619f88669f6028cbe32248,0,Oleg Nechiporenko,2014-02-13 18:11:52+02:00,['9537488e766592a424577cff2cbc32aceb1e57a3'],1,3,4,17462543,1,,,,13480
8f4d05be56ba4c2d47b9c57df5a23c81dfaaf603,0,Vitaly Brodetskyi,2014-02-13 18:13:36+02:00,['d377fe2189be88e5df619f88669f6028cbe32248'],21,25,46,17462589,3,1,1,1,13480
9157fe8f6f92447ec671d628bca8d6a78fa27c3b,0,Vitaly Brodetskyi,2014-02-13 18:48:50+02:00,['8f4d05be56ba4c2d47b9c57df5a23c81dfaaf603'],29,31,60,17462649,2,,0,,13480
eb60996af06e567e195e077ed935a168ab38ee3e,0,Lisnichenko Dmitro,2014-02-13 18:54:17+02:00,['9157fe8f6f92447ec671d628bca8d6a78fa27c3b'],2,2,4,17462653,2,,,,13480
d520978e332421789705d35927649e44d2b3290e,0,Oleg Nechiporenko,2014-02-13 19:24:04+02:00,['eb60996af06e567e195e077ed935a168ab38ee3e'],1,1,2,17462655,1,,,,13480
d3ea89dfc575de39f9029e0c9b771109287ef154,0,Andrew Onischuk,2014-02-13 11:41:02-08:00,['d520978e332421789705d35927649e44d2b3290e'],35,83,118,17462773,29,0,0,0,13481
613be7a656e043c7781b380be0a13b0aae24ae3e,0,Siddharth Wagle,2014-02-13 12:48:09-08:00,['d3ea89dfc575de39f9029e0c9b771109287ef154'],40,410,450,17463223,5,,,,13483
38cd87d82cd9e0af8ecb28aeb1d8a8d5eb83652e,0,Siddharth Wagle,2014-02-13 12:48:09-08:00,['613be7a656e043c7781b380be0a13b0aae24ae3e'],3,3,6,17463229,1,,,,13483
fdfe81086b2a46d0977b77b0b94447f7261f1aff,1,Mahadev Konar,2014-02-13 12:54:37-08:00,['38cd87d82cd9e0af8ecb28aeb1d8a8d5eb83652e'],3,55,58,17463287,2,0,0,0.022222222,13483
ab1265376829d9d21a217b5dd5996c2edbfa0400,0,Yusaku Sako,2014-02-13 14:13:29-08:00,['fdfe81086b2a46d0977b77b0b94447f7261f1aff'],0,2,2,17463289,1,1,0,1,13483
e4551a8ce9a8dccf90f3748ebfae5e4cea34c06c,1,Yusaku Sako,2014-02-13 14:17:07-08:00,['ab1265376829d9d21a217b5dd5996c2edbfa0400'],21,63,84,17463373,4,0,0,1,13483
0576626e696bbdcbb11d835bea48080b1d9314ce,1,Nate Cole,2014-02-13 17:48:00-05:00,['e4551a8ce9a8dccf90f3748ebfae5e4cea34c06c'],17,17,34,17463407,1,,,,13483
5ccaaa2e4e0346c8c9369ccdca1490f7825f0861,0,Siddharth Wagle,2014-02-13 15:19:27-08:00,['0576626e696bbdcbb11d835bea48080b1d9314ce'],0,4,4,17463411,1,,,,13483
50a7a50a95974d4f92f67e146748973c83bdee10,0,Sumit Mohanty,2014-02-13 18:14:31-08:00,['5ccaaa2e4e0346c8c9369ccdca1490f7825f0861'],1,2,3,17463414,2,0,0,1,13483
bd48dca60b8dc39eae756ab5818e45641171983e,1,Yusaku Sako,2014-02-13 18:14:55-08:00,['50a7a50a95974d4f92f67e146748973c83bdee10'],44,146,190,17463604,4,0.634920635,0.396825397,1,13483
342b63476ae8e44d145df1e24d35d064c4f820b5,0,Mahadev Konar,2014-02-13 22:50:36-08:00,['bd48dca60b8dc39eae756ab5818e45641171983e'],6,5,11,17463615,1,,,,13483
f41c3b37c68b986b1dd61ce9408ca02fdbad1aaa,1,Oleg Nechiporenko,2014-02-14 12:56:53+02:00,['342b63476ae8e44d145df1e24d35d064c4f820b5'],27,100,127,17463742,7,0.625,0.625,1,13483
ecf4ab543fcca10a1ccb036605e9836612d79355,1,Lisnichenko Dmitro,2014-02-14 13:22:29+02:00,['f41c3b37c68b986b1dd61ce9408ca02fdbad1aaa'],173,246,419,17464161,9,0,0.24137931,1,13483
dbee456ae88d54ac89f5a9e9b9cc454fa9eca262,1,Oleg Nechiporenko,2014-02-14 14:17:00+02:00,['ecf4ab543fcca10a1ccb036605e9836612d79355'],8,21,29,17464190,1,,,,13483
287b3d7b1e268630428b37ec805f355431fc5fbf,1,atkach,2014-02-14 14:31:09+02:00,['dbee456ae88d54ac89f5a9e9b9cc454fa9eca262'],0,21,21,17464211,3,0,0,1,13483
8f01f6eabc892b42012fff211cd08c8df599918e,0,atkach,2014-02-14 15:28:43+02:00,['287b3d7b1e268630428b37ec805f355431fc5fbf'],2,2,4,17464215,1,,,,13483
c3ecfc086d1efa1b50000b3d194c75158ff37645,1,Aleksandr Kovalenko,2014-02-14 16:38:58+02:00,['8f01f6eabc892b42012fff211cd08c8df599918e'],2,35,37,17464252,3,1,1,1,13483
d3ddf51c834fe99a6dd1de721b832c3612b5918c,1,atkach,2014-02-14 17:22:04+02:00,['c3ecfc086d1efa1b50000b3d194c75158ff37645'],4,6,10,17464262,1,1,1,1,13483
c337d7df188bec9f955c7cbd38b0f51410e29fae,1,tbeerbower,2014-02-14 11:03:32-05:00,['d3ddf51c834fe99a6dd1de721b832c3612b5918c'],484,205,689,17464951,16,0.078651685,0.449438202,0.707865169,13483
6a1f1bfd427b6784a4c4fa06b7d240140d27472e,0,Nate Cole,2014-02-14 11:08:41-05:00,['c337d7df188bec9f955c7cbd38b0f51410e29fae'],21,30,51,17465002,7,0,0.5,0.5,13483
ba50ff7042a0c56e0310b9455a13a5f2d4148654,1,Andrew Onischuk,2014-01-17 04:20:10-08:00,['6a1f1bfd427b6784a4c4fa06b7d240140d27472e'],14,15,29,17465031,7,,,,13483
af54f0ff9aac7d054ef7de1514b780a164e178f5,0,tbeerbower,2014-02-14 13:16:55-05:00,['ba50ff7042a0c56e0310b9455a13a5f2d4148654'],13,31,44,17465075,2,1,1,1,13483
bad3a8a2806cd81b2cc48ad37c6992a07c4d78b1,1,Andrew Onischuk,2014-02-14 10:24:53-08:00,['af54f0ff9aac7d054ef7de1514b780a164e178f5'],28,39,67,17465142,13,1,0,0,13483
5d69aaaf2954a501abd4f2e1f7e2fe473c2d0a6f,1,Lisnichenko Dmitro,2014-02-14 20:26:30+02:00,['bad3a8a2806cd81b2cc48ad37c6992a07c4d78b1'],3,136,139,17465281,4,0.271186441,0.898305085,1,13484
cec62b2e487860d5088475722299ef3ab4b37a29,1,Lisnichenko Dmitro,2014-02-14 20:44:14+02:00,['5d69aaaf2954a501abd4f2e1f7e2fe473c2d0a6f'],32,42,74,17465355,4,,,,13484
f60a78f681870d91aff240db7ca72abcef7be595,0,Andrew Onischuk,2014-02-14 10:58:44-08:00,['cec62b2e487860d5088475722299ef3ab4b37a29'],14,14,28,17465383,7,,,,13484
b59b258d243832ace399b0c8e2213ba38474dc79,1,Andrew Onischuk,2014-02-14 11:00:42-08:00,['f60a78f681870d91aff240db7ca72abcef7be595'],14,56,70,17465453,7,0.923076923,0.923076923,1,13484
de4fe5f14350e4bbdd35adfd351ca357fb8ab757,1,Nate Cole,2014-02-14 15:51:04-05:00,['b59b258d243832ace399b0c8e2213ba38474dc79'],57,126,183,17465636,3,0.466666667,0.766666667,0.766666667,13484
cfbc3397c5cbbd4a3865b86061d82c8102e17334,0,Mahadev Konar,2014-02-14 14:42:17-08:00,['de4fe5f14350e4bbdd35adfd351ca357fb8ab757'],0,7,7,17465643,1,,,,13484
03a5ca8ebee70dfce36e1910f98f02c2a2b82af4,1,Xi Wang,2014-02-14 16:17:08-08:00,['cfbc3397c5cbbd4a3865b86061d82c8102e17334'],4,32,36,17465679,5,0.76,0.76,1,13484
9f4df9fd808369459556fa3049bf66d48b837bd6,1,Yusaku Sako,2014-02-14 16:30:30-08:00,['03a5ca8ebee70dfce36e1910f98f02c2a2b82af4'],3,48,51,17465730,4,1,1,1,13484
592db99f483f020ba288f3030d560e7299b9d8cf,1,Jaimin Jetly,2014-02-14 19:15:46-08:00,['9f4df9fd808369459556fa3049bf66d48b837bd6'],13,21,34,17465764,4,0,1,1,13484
58dc91852e3d3a28da610ae9b54cf8e9e7a13321,0,Oleg Nechiporenko,2014-02-17 11:49:26+02:00,['592db99f483f020ba288f3030d560e7299b9d8cf'],0,10,10,17465774,1,,,,13484
a440fea7fb617971ba7652e888e3d0e037729a81,0,Vitaly Brodetskyi,2014-02-17 13:02:46+02:00,['58dc91852e3d3a28da610ae9b54cf8e9e7a13321'],1,3,4,17465778,1,0,1,0,13484
8c09335674cf42e5465f53c3bdc51fc572b498e5,1,Oleg Nechiporenko,2014-02-17 13:49:41+02:00,['a440fea7fb617971ba7652e888e3d0e037729a81'],12,38,50,17465828,2,,,,13484
95796b832f9e740455d202d254daf77a775d328d,0,Oleg Nechiporenko,2014-02-17 13:51:47+02:00,['8c09335674cf42e5465f53c3bdc51fc572b498e5'],0,2,2,17465830,2,,,,13484
cb9a6f3803ef67af3904580a565e31e1e52cb436,1,aBabiichuk,2014-02-17 14:06:22+02:00,['95796b832f9e740455d202d254daf77a775d328d'],1,5,6,17465836,2,1,1,1,13484
5cd82eb233ebf65876e5469677ff304732a7278f,1,aBabiichuk,2014-02-17 14:06:23+02:00,['cb9a6f3803ef67af3904580a565e31e1e52cb436'],15,15,30,17465866,1,,,,13484
ef1e7a232c1c1a5381fae9acea006a31cef110cb,1,Andrew Onischuk,2014-02-17 04:38:24-08:00,['5cd82eb233ebf65876e5469677ff304732a7278f'],23,21,44,17465910,2,,,,13484
1d38f471c77588f01bce1e571660805ef673402b,0,Vitaly Brodetskyi,2014-02-17 14:52:33+02:00,['ef1e7a232c1c1a5381fae9acea006a31cef110cb'],2,3,5,17465915,2,,,,13484
d864d2a048e86c78a646f37369fca6b8f1cc4d6b,1,Alex Antonenko,2014-02-17 15:38:04+02:00,['1d38f471c77588f01bce1e571660805ef673402b'],4,7,11,17465926,1,1,1,1,13484
9d2ecfa919d67adf39b855d5ca9b2527ac2f23d7,1,Alex Antonenko,2014-02-17 16:22:17+02:00,['d864d2a048e86c78a646f37369fca6b8f1cc4d6b'],13,66,79,17466005,7,0.681818182,0.681818182,1,13484
33bf1d44c14b0841841bd1eefa4a0d2967ed901c,1,Aleksandr Kovalenko,2014-02-17 19:14:02+02:00,['9d2ecfa919d67adf39b855d5ca9b2527ac2f23d7'],93,125,218,17466223,6,,,,13484
a5a0203967b1076d579c8237f7e343b5794b715e,1,Andrew Onischuk,2014-02-17 09:18:37-08:00,['33bf1d44c14b0841841bd1eefa4a0d2967ed901c'],12,2493,2505,17468728,15,0.162588792,1,1,13494
1367ceb2300d4778b2dfbef654e864e7138759dd,0,Andrew Onischuk,2014-02-17 09:18:37-08:00,['a5a0203967b1076d579c8237f7e343b5794b715e'],0,82,82,17468810,8,0,1,1,13494
9e69e1eb525991dfebb8bb58cabfec6dd3d1998f,0,Andrew Onischuk,2014-02-17 09:18:37-08:00,['1367ceb2300d4778b2dfbef654e864e7138759dd'],0,58,58,17468868,1,0.28,1,0,13495
88c2472e50ab3a8fc56b542d57e29d66172c5d03,1,Andrew Onischuk,2014-02-17 09:18:38-08:00,['9e69e1eb525991dfebb8bb58cabfec6dd3d1998f'],0,207,207,17469075,1,0.274074074,1,1,13496
a593a644cb502972e5843ba7491c2a54017df0bf,1,Alex Antonenko,2014-02-17 19:19:25+02:00,['88c2472e50ab3a8fc56b542d57e29d66172c5d03'],15,28,43,17469118,6,0.461538462,1,0.769230769,13496
65249796f42e45216ce5463b4d7bb0024a7a5bcd,1,Alex Antonenko,2014-02-17 19:30:04+02:00,['a593a644cb502972e5843ba7491c2a54017df0bf'],0,1,1,17469119,1,1,1,1,13496
746e68fc6ff6d743f0a069901dcb9c90fe0cda48,1,Oleg Nechiporenko,2014-02-18 13:50:05+02:00,['65249796f42e45216ce5463b4d7bb0024a7a5bcd'],562,975,1537,17470656,14,1,1,1,13502
1b213b46a7e8646d65bef3abd14cca1cb32bb934,0,atkach,2014-02-18 15:43:51+02:00,['746e68fc6ff6d743f0a069901dcb9c90fe0cda48'],335,182,517,17471173,6,0.140939597,0,0.382550336,13503
612da80cdd695c655b79d4540aff42df8b59f4f3,1,atkach,2014-02-18 17:29:40+02:00,['1b213b46a7e8646d65bef3abd14cca1cb32bb934'],13,9,22,17471195,3,0,0,0,13503
8f0fe9c339439ad1f035b5f3aef4706f7ec24607,1,Andrew Onischuk,2014-02-18 08:01:38-08:00,['612da80cdd695c655b79d4540aff42df8b59f4f3'],1,1,2,17471197,1,,,,13503
8d9b031e877f8ddc46f2443ce9bc8cb55d0007f1,1,Nate Cole,2014-02-18 11:37:07-05:00,['8f0fe9c339439ad1f035b5f3aef4706f7ec24607'],8,119,127,17471324,5,0,0,0.95,13503
f2c18bcd762a99edeb8ba8d38a6a194acd279fa2,1,Srimanth Gunturi,2014-02-18 09:16:52-08:00,['8d9b031e877f8ddc46f2443ce9bc8cb55d0007f1'],19,135,154,17471478,7,0.178082192,0.671232877,1,13503
02f9c45311ee6f6e7d87fe07b0059ad43a265782,1,Lisnichenko Dmitro,2014-02-18 23:03:50+02:00,['f2c18bcd762a99edeb8ba8d38a6a194acd279fa2'],120,2807,2927,17474405,50,0.298058252,0.859223301,0.605825243,13536
3b9c3311938cac94990b107f7d0fc5f5a7acb9a7,0,Yusaku Sako,2014-02-18 16:17:57-08:00,['02f9c45311ee6f6e7d87fe07b0059ad43a265782'],0,1,1,17474406,1,0,0,1,13536
79eaf12bab0fc93cac440ad3a07f8d2457045aef,0,Yusaku Sako,2014-02-18 16:25:53-08:00,['3b9c3311938cac94990b107f7d0fc5f5a7acb9a7'],8,0,8,17474414,2,,,,13536
5f939c8efcb60ce44781337af18eb48791de0cf1,1,Jaimin Jetly,2014-02-18 17:05:07-08:00,['79eaf12bab0fc93cac440ad3a07f8d2457045aef'],0,4,4,17474418,2,1,1,1,13536
c6e459251e6ee6c17db2facc67c0c516bd0fb730,1,Yusaku Sako,2014-02-18 17:11:59-08:00,['5f939c8efcb60ce44781337af18eb48791de0cf1'],37,95,132,17474550,26,0.58974359,0.58974359,1,13536
4f996e435944fa54cffcb34dd4817893a8b295d4,0,Oleg Nechiporenko,2014-02-19 13:58:30+02:00,['c6e459251e6ee6c17db2facc67c0c516bd0fb730'],74,76,150,17474700,4,,,,13536
38926714346e00bd288abefc0386aa55907f7101,1,Oleg Nechiporenko,2014-02-19 15:23:35+02:00,['4f996e435944fa54cffcb34dd4817893a8b295d4'],16,50,66,17474766,9,1,1,1,13536
81c32ed50ab018a56e3f2c04b06913b3f2928099,1,tbeerbower,2014-02-19 10:11:24-05:00,['38926714346e00bd288abefc0386aa55907f7101'],0,2604,2604,17477370,30,0.55,1,0.940909091,13566
8c27b827ede1999dea1a58a8d2a176b28aa2a2e4,1,Alex Antonenko,2014-02-19 17:59:51+02:00,['81c32ed50ab018a56e3f2c04b06913b3f2928099'],2,6,8,17477378,1,1,1,1,13566
9dca63fd5707efe510fba2007745bd36c918e6bb,0,Oleg Nechiporenko,2014-02-19 18:16:18+02:00,['8c27b827ede1999dea1a58a8d2a176b28aa2a2e4'],2,6,8,17477386,1,1,1,1,13566
9285f6febf77b53069421876cee807f71570e6c6,0,Vitaly Brodetskyi,2014-02-19 19:44:57+02:00,['9dca63fd5707efe510fba2007745bd36c918e6bb'],0,31,31,17477417,1,0,1,1,13566
d46396018701334861b02d7c2815cd78a910d7cf,1,Alex Antonenko,2014-02-19 19:56:21+02:00,['9285f6febf77b53069421876cee807f71570e6c6'],24,32,56,17477473,6,0.428571429,0.571428571,1,13566
e884fe2e645e56edac65f121249b1bdbbc4cbf00,1,Vitaly Brodetskyi,2014-02-19 20:26:14+02:00,['d46396018701334861b02d7c2815cd78a910d7cf'],1,17,18,17477491,3,0,0,1,13566
fd1264e6247e958d9e104e67906dfdc4ed598b10,0,Alex Antonenko,2014-02-19 20:40:03+02:00,['e884fe2e645e56edac65f121249b1bdbbc4cbf00'],0,1,1,17477492,1,0,0,1,13566
0d33d14dc38b4ccbc8eb36af7cb3f2e4569e2cab,1,atkach,2014-02-19 20:42:11+02:00,['fd1264e6247e958d9e104e67906dfdc4ed598b10'],104,109,213,17477705,6,1,1,0.083333333,13566
4b9ef03bf9cfadd841a5e3078d0a52b7eb80f234,1,Yusaku Sako,2014-02-19 11:52:09-08:00,['0d33d14dc38b4ccbc8eb36af7cb3f2e4569e2cab'],1,3,4,17477709,1,,,,13566
0e049a287be503a1e0c8475020d7640162584c1f,1,Srimanth Gunturi,2014-02-19 13:51:16-08:00,['4b9ef03bf9cfadd841a5e3078d0a52b7eb80f234'],5,8,13,17477722,4,0,0,1,13566
38545f8ce2a07d37d6021b1178436de2f68c49e0,0,Mahadev Konar,2014-02-19 14:12:14-08:00,['0e049a287be503a1e0c8475020d7640162584c1f'],1,2,3,17477725,1,,,,13566
c3d539cca398a92308d70d5b898e0ddbc5883c8f,1,Srimanth Gunturi,2014-02-19 18:31:28-08:00,['38545f8ce2a07d37d6021b1178436de2f68c49e0'],29,93,122,17477847,11,0.396551724,0.275862069,1,13566
cf0b566575bc849591f833865a46aa945d7257ac,1,Jaimin Jetly,2014-02-19 19:09:05-08:00,['c3d539cca398a92308d70d5b898e0ddbc5883c8f'],4,7,11,17477858,4,,,,13566
c3751de81e0f1fef94367551f636da8d681ed9e0,1,Mahadev Konar,2014-02-19 19:48:25-08:00,['cf0b566575bc849591f833865a46aa945d7257ac'],1,6,7,17477865,1,,,,13566
b7856cbcf7544dad98881870369fa3de393d76b3,1,Siddharth Wagle,2014-02-19 21:00:38-08:00,['c3751de81e0f1fef94367551f636da8d681ed9e0'],15,77,92,17477957,4,0,0.871794872,1,13566
9199f1c608e16b6d3da03f45cf47eabf01e14e54,0,Siddharth Wagle,2014-02-19 21:41:28-08:00,['b7856cbcf7544dad98881870369fa3de393d76b3'],6,11,17,17477974,2,,,,13566
4471763ebb92a008c9c4b8c3f5adf9186653c4b1,0,Mahadev Konar,2014-02-19 21:52:24-08:00,['9199f1c608e16b6d3da03f45cf47eabf01e14e54'],2,2,4,17477978,2,,,,13566
e2f9af9863f4732aab8a8a0d9e1ce757725b0f75,0,Alex Antonenko,2014-02-20 14:40:14+02:00,['4471763ebb92a008c9c4b8c3f5adf9186653c4b1'],0,6,6,17477984,1,0,0,1,13566
34b1ccbf290dad5790680eb11e2542374d4fa61f,1,atkach,2014-02-20 14:52:48+02:00,['e2f9af9863f4732aab8a8a0d9e1ce757725b0f75'],8,17,25,17478009,4,0,1,1,13566
a864232ed6f707e5b909673bd7af6c21f2f3fa97,1,Andrew Onischuk,2014-02-20 07:53:36-08:00,['34b1ccbf290dad5790680eb11e2542374d4fa61f'],0,131,131,17478140,1,0,1,1,13567
8e538edf8e3d6081e877a6853dc0498466d6d9c1,0,Siddharth Wagle,2014-02-20 10:11:01-08:00,['a864232ed6f707e5b909673bd7af6c21f2f3fa97'],5,1,6,17478146,3,,,,13567
6b89afd4c5256f4764fae016faec5a2b4e625513,0,Nate Cole,2014-02-20 13:42:37-05:00,['8e538edf8e3d6081e877a6853dc0498466d6d9c1'],9,9,18,17478164,4,,,,13567
f72be08ba0581e1d0ad3f9a3d882269c4eb431e9,0,Vitaly Brodetskyi,2014-02-20 20:44:05+02:00,['6b89afd4c5256f4764fae016faec5a2b4e625513'],1,1,2,17478166,1,,,,13567
22fa3e0338c710683a6444f8294ab3c2e8c537fc,1,Siddharth Wagle,2014-02-20 11:03:07-08:00,['f72be08ba0581e1d0ad3f9a3d882269c4eb431e9'],10,203,213,17478379,7,0,0.297101449,0.782608696,13567
e44bbb73c111a492daba4414f12a0a09bd859c1f,0,Siddharth Wagle,2014-02-20 11:03:07-08:00,['22fa3e0338c710683a6444f8294ab3c2e8c537fc'],0,18,18,17478397,1,,,,13567
d4c021d8de499f7deaeea7ab407b65d3a255550e,1,Nate Cole,2014-02-20 14:11:19-05:00,['e44bbb73c111a492daba4414f12a0a09bd859c1f'],33,103,136,17478533,6,0.113636364,0.181818182,0.704545455,13567
c85e308944d130ddb41882fe6c9d5a43b3a91f12,1,Siddharth Wagle,2014-02-20 11:28:57-08:00,['d4c021d8de499f7deaeea7ab407b65d3a255550e'],16,112,128,17478661,9,0.636363636,1,0.636363636,13569
b0b27c3bf84634bda4776d6f3f57be32a8f43454,0,Lisnichenko Dmitro,2014-02-20 21:50:42+02:00,['c85e308944d130ddb41882fe6c9d5a43b3a91f12'],1,1,2,17478663,1,,,,13569
b03fe24a6fe6939768bcd08334584318f40ad941,0,Lisnichenko Dmitro,2014-02-20 21:59:07+02:00,['b0b27c3bf84634bda4776d6f3f57be32a8f43454'],1,1,2,17478665,1,,0,,13569
021b236bb38b050cbb9662699df524fda35e5af8,1,Aleksandr Kovalenko,2014-02-20 22:09:00+02:00,['b03fe24a6fe6939768bcd08334584318f40ad941'],133,367,500,17479165,18,1,1,1,13571
d291fb456da18e2911c46ec282e4ce1a127d4bd1,1,Srimanth Gunturi,2014-02-20 12:30:14-08:00,['021b236bb38b050cbb9662699df524fda35e5af8'],29,15,44,17479209,5,0,1,0,13571
9182ccab00e174435a02f7e625300625a276b78f,1,Lisnichenko Dmitro,2014-02-20 23:35:53+02:00,['d291fb456da18e2911c46ec282e4ce1a127d4bd1'],2,44,46,17479255,6,0,0,1,13571
87b4a3678b72515a008a9e61478e3dd1eeadc4eb,1,Lisnichenko Dmitro,2014-02-20 23:37:44+02:00,['9182ccab00e174435a02f7e625300625a276b78f'],3,349,352,17479607,3,0,1,1,13571
093ee03f14bd17fe9111a39a07bff34dcaca25f6,1,Lisnichenko Dmitro,2014-02-20 23:39:13+02:00,['87b4a3678b72515a008a9e61478e3dd1eeadc4eb'],0,9,9,17479616,3,0.5,0.5,1,13571
4f2d45a61c7b8ecc7d748cc15e129feb9fc28b4c,0,Lisnichenko Dmitro,2014-02-20 23:47:01+02:00,['093ee03f14bd17fe9111a39a07bff34dcaca25f6'],1,1,2,17479618,1,,,,13571
339cfb4cc33cb27651ca21210e7360ff742527ac,1,Andrew Onischuk,2014-02-20 14:31:48-08:00,['4f2d45a61c7b8ecc7d748cc15e129feb9fc28b4c'],0,3,3,17479621,1,,,,13571
5beb18eff05bec591feb702758b1a184079f01e9,1,Siddharth Wagle,2014-02-20 14:39:11-08:00,['339cfb4cc33cb27651ca21210e7360ff742527ac'],194,183,377,17479998,7,1,1,0.5,13571
1ee85af2aca166eaf2af2334d0350e9aacd15202,1,Yusaku Sako,2014-02-20 14:42:35-08:00,['5beb18eff05bec591feb702758b1a184079f01e9'],0,10,10,17480008,1,0.6,0.6,1,13571
f02308fa1773f020988617d7546a13293c2df33c,0,aBabiichuk,2014-02-21 00:45:10+02:00,['1ee85af2aca166eaf2af2334d0350e9aacd15202'],73,300,373,17480381,5,0.634146341,0.743902439,0.890243902,13571
eae58511e5732f235a10250ab6a9640c7fe25173,0,Yusaku Sako,2014-02-20 14:56:19-08:00,['f02308fa1773f020988617d7546a13293c2df33c'],300,73,373,17480754,5,0.365853659,0.256097561,0.109756098,13571
3682c9014267493d68c1ab271ecd9ef48b67dcbe,0,Mahadev Konar,2014-02-20 16:30:10-08:00,['eae58511e5732f235a10250ab6a9640c7fe25173'],1,1,2,17480756,1,,,,13571
d91a9dc82e6c10f6399ef4f3d59f75a9f35a25eb,1,Jaimin Jetly,2014-02-20 16:59:03-08:00,['3682c9014267493d68c1ab271ecd9ef48b67dcbe'],59,21,80,17480836,9,,,,13571
01359ffe649389f2e5db7888b1c8b1d2c2b0cd4a,0,Jaimin Jetly,2014-02-20 17:39:25-08:00,['d91a9dc82e6c10f6399ef4f3d59f75a9f35a25eb'],59,64,123,17480959,5,0,0,0,13571
6fdaec4ee438b5f7422eb494d122863180b79c79,1,Yusaku Sako,2014-02-20 18:18:39-08:00,['01359ffe649389f2e5db7888b1c8b1d2c2b0cd4a'],8,3,11,17480970,2,0,0,0,13571
77e37961ed55cda94c9e37eed3fe01701ba36a9c,1,Yusaku Sako,2014-02-20 18:56:38-08:00,['6fdaec4ee438b5f7422eb494d122863180b79c79'],1,18,19,17480989,4,0.2,0.2,1,13571
44f0f2d9739070e0954f4aa0b3ed63fd3a7efaf7,0,Dmitry Sen,2014-02-21 13:15:52+02:00,['77e37961ed55cda94c9e37eed3fe01701ba36a9c'],10,12,22,17481011,1,0,1,1,13571
9c98af160d8b87068f8b223fa714501caf6701d0,1,atkach,2014-02-21 15:38:59+02:00,['44f0f2d9739070e0954f4aa0b3ed63fd3a7efaf7'],111,37,148,17481159,4,0.354166667,0.020833333,0.125,13571
210dade4bb9698ac9f4b0b25b7abca50260f7778,1,Andrew Onischuk,2014-02-21 05:52:55-08:00,['9c98af160d8b87068f8b223fa714501caf6701d0'],2,187,189,17481348,4,0,1,1,13573
b815bd2e0bb27dcf0b45bd9afe11c07982c5fec3,1,Andrew Onischuk,2014-02-21 05:52:56-08:00,['210dade4bb9698ac9f4b0b25b7abca50260f7778'],182,182,364,17481712,31,,,,13573
2ccf7047b625017cc19ba12be65be49678fc4400,1,Andrew Onischuk,2014-02-21 06:28:01-08:00,['b815bd2e0bb27dcf0b45bd9afe11c07982c5fec3'],1,1,2,17481714,1,,,,13573
0f9a5bf535921e9559cef44fa42db14c2bc3b80f,1,Oleg Nechiporenko,2014-02-21 16:35:22+02:00,['2ccf7047b625017cc19ba12be65be49678fc4400'],3,98,101,17481815,2,1,1,1,13573
267f679b6e379e87cb1e0316e2c2ba70d48c4628,0,aBabiichuk,2014-02-21 16:37:17+02:00,['0f9a5bf535921e9559cef44fa42db14c2bc3b80f'],3,19,22,17481837,4,0.5,0,1,13573
d6d048d4a7ba5ea43cc211c7a8f94d50146591e9,0,Vitaly Brodetskyi,2014-02-21 17:06:25+02:00,['267f679b6e379e87cb1e0316e2c2ba70d48c4628'],14,34,48,17481885,2,,,,13573
54a9df72aee7229e411a4f5a39f7a36abc96ae1b,1,Lisnichenko Dmitro,2014-02-21 17:52:51+02:00,['d6d048d4a7ba5ea43cc211c7a8f94d50146591e9'],14,87,101,17481986,3,0.333333333,1,0.277777778,13573
98ee4c6d60a32006641829f49343f59f9542c56d,0,Alex Antonenko,2014-02-21 18:34:12+02:00,['54a9df72aee7229e411a4f5a39f7a36abc96ae1b'],1,7,8,17481994,1,0,1,1,13573
c02c7bf5086f79e92cc234b949b08d693bedeac4,0,Vitaly Brodetskyi,2014-02-21 20:42:21+02:00,['98ee4c6d60a32006641829f49343f59f9542c56d'],6,6,12,17482006,4,,,,13573
fea7b6222311a48604c5a96d9478c53fbd7ce26f,1,Myroslav Papirkovskyy,2014-02-21 21:03:40+02:00,['c02c7bf5086f79e92cc234b949b08d693bedeac4'],995,3509,4504,17486510,35,0.675451807,0.969879518,0.932981928,13592
822cd75a2a722bf34717f6858bed43bb239d517e,1,Yusaku Sako,2014-02-21 11:58:12-08:00,['fea7b6222311a48604c5a96d9478c53fbd7ce26f'],4,12,16,17486526,1,0,1,1,13592
965bd9df97167555a6cca23d9a41f36f542872c0,1,aBabiichuk,2014-02-21 23:34:39+02:00,['822cd75a2a722bf34717f6858bed43bb239d517e'],75,424,499,17487025,6,0.634146341,0.743902439,0.890243902,13592
944e0f5e2a081d11db4cd4af63f5d544430b8998,0,Mahadev Konar,2014-02-21 14:31:31-08:00,['965bd9df97167555a6cca23d9a41f36f542872c0'],1,4,5,17487030,2,,,,13592
60ea8da46700d4e8994490188979a106f9fde134,0,Mahadev Konar,2014-02-21 15:03:51-08:00,['944e0f5e2a081d11db4cd4af63f5d544430b8998'],2,2,4,17487034,2,,,,13592
dfe1fe043d031b7299106826e854ebd97a112e0a,1,Mahadev Konar,2014-02-21 15:22:15-08:00,['60ea8da46700d4e8994490188979a106f9fde134'],751,604,1355,17488389,52,0.923076923,0.065934066,0,13592
793cad52da74ba5e04f67474263b90d875c5bda2,0,Jaimin Jetly,2014-02-21 19:20:35-08:00,['dfe1fe043d031b7299106826e854ebd97a112e0a'],3,1,4,17488393,1,0,0,0,13592
d79be1109db28284d96fd32582023591e3051cad,1,Jaimin Jetly,2014-02-21 19:33:54-08:00,['793cad52da74ba5e04f67474263b90d875c5bda2'],503,1517,2020,17490413,9,0.560869565,0.747826087,1,13594
3b57c215e95f97077651913af1f28def4843da56,1,Yusaku Sako,2014-02-22 13:07:15-08:00,['d79be1109db28284d96fd32582023591e3051cad'],1,1,2,17490415,1,,,,13594
d0ccc47cc1d6d4516421ab651d20d74b9d83d9d5,1,Jaimin Jetly,2014-02-22 19:32:28-08:00,['3b57c215e95f97077651913af1f28def4843da56'],1,8,9,17490424,1,0,1,1,13594
e5fbaa48ef41245263980eb25104a855643d744e,1,Srimanth Gunturi,2014-02-22 20:46:13-08:00,['d0ccc47cc1d6d4516421ab651d20d74b9d83d9d5'],34,38,72,17490496,11,,,,13594
64de9764fd78cdbfdb42436ff6533285c1d97a0a,1,Srimanth Gunturi,2014-02-23 00:21:26-08:00,['e5fbaa48ef41245263980eb25104a855643d744e'],1,44,45,17490541,3,0,0,1,13594
a2a34fa8a14fb8a1b1c400120f406a399993ebc9,1,Sumit Mohanty,2014-02-23 19:26:47-08:00,['64de9764fd78cdbfdb42436ff6533285c1d97a0a'],14,25,39,17490580,2,0,0.454545455,0.454545455,13594
a83ebae7c115e0219ead99f6c950188c538b293e,1,Andrew Onischuk,2014-02-24 03:44:01-08:00,['a2a34fa8a14fb8a1b1c400120f406a399993ebc9'],7,9,16,17490596,2,1,1,0.666666667,13594
ba2c2a080a483357d461f285918a9a1522994b01,1,atkach,2014-02-24 14:12:57+02:00,['a83ebae7c115e0219ead99f6c950188c538b293e'],1,21,22,17490618,1,1,1,1,13594
2a0b71f0da0149a26410ec2ceca0ee8f65a71c13,1,Oleg Nechiporenko,2014-02-24 14:38:06+02:00,['ba2c2a080a483357d461f285918a9a1522994b01'],18,28,46,17490664,1,,,,13594
ce202e3b185c8d5f4d821e06867970d763477cd8,1,Andrew Onischuk,2014-02-24 05:16:48-08:00,['2a0b71f0da0149a26410ec2ceca0ee8f65a71c13'],1,61,62,17490726,7,0,1,1,13594
44619ac7745b274f0d41fb22045fbfffb97f8ed5,1,Alex Antonenko,2014-02-24 16:12:37+02:00,['ce202e3b185c8d5f4d821e06867970d763477cd8'],9,26,35,17490761,4,1,1,1,13594
a48f1e26edf5360cd2543d85e47eb69328477e85,0,Alex Antonenko,2014-02-24 16:25:42+02:00,['44619ac7745b274f0d41fb22045fbfffb97f8ed5'],2,2,4,17490765,1,,,,13594
8b1cae43f2fbb07830ae7d45aecf82d30fa49937,1,aBabiichuk,2014-02-24 17:46:36+02:00,['a48f1e26edf5360cd2543d85e47eb69328477e85'],2,5,7,17490772,1,1,1,1,13594
297fff3cf78ed720951cc71dc7bf4dda642a5837,0,Aleksandr Kovalenko,2014-02-24 18:25:25+02:00,['8b1cae43f2fbb07830ae7d45aecf82d30fa49937'],64,197,261,17491033,9,1,1,1,13594
84a88e5e4ab0d26ba9fb3236590d82082ac83ead,1,Oleg Nechiporenko,2014-02-24 18:57:35+02:00,['297fff3cf78ed720951cc71dc7bf4dda642a5837'],105,3,108,17491141,2,0,0,0,13594
8ead12ba7f74a6ea3bae5da707c7b06fa8fb5472,1,aBabiichuk,2014-02-24 19:25:31+02:00,['84a88e5e4ab0d26ba9fb3236590d82082ac83ead'],60,112,172,17491313,11,0.904761905,1,1,13594
77de4b96ce5bdffca548ed6a9f09713caac7c050,1,aBabiichuk,2014-02-24 20:07:36+02:00,['8ead12ba7f74a6ea3bae5da707c7b06fa8fb5472'],8,56,64,17491377,4,,,,13596
e1f4f2e8b062f36f1db623423b682dd0019b0f19,1,Nate Cole,2014-02-24 14:02:11-05:00,['77de4b96ce5bdffca548ed6a9f09713caac7c050'],477,496,973,17492350,50,0,1,1,13596
40fca9c833fc27911068afdd39179f7fa14ecd53,1,Yusaku Sako,2014-02-24 11:23:26-08:00,['e1f4f2e8b062f36f1db623423b682dd0019b0f19'],448,287,735,17493085,28,,,,13596
7b8741ba7deefd2d58aec04205351dfa7a10e6f2,1,Mahadev Konar,2014-02-24 13:36:18-08:00,['40fca9c833fc27911068afdd39179f7fa14ecd53'],8,10,18,17493103,1,0,0,1,13596
0d0fe121c98a512a74c8d2e421e758dc5c3d1bec,1,Yusaku Sako,2014-02-24 16:44:23-08:00,['7b8741ba7deefd2d58aec04205351dfa7a10e6f2'],1,6,7,17493110,1,1,1,1,13596
4a0a7d03b0f98a7df8c775efd117f89523256d2e,1,Mahadev Konar,2014-02-24 22:31:09-08:00,['0d0fe121c98a512a74c8d2e421e758dc5c3d1bec'],10,4,14,17493124,3,,,,13596
5be623515893830d7f995b0662ae5a98e1bf40cd,0,Oleg Nechiporenko,2014-02-25 13:08:47+02:00,['4a0a7d03b0f98a7df8c775efd117f89523256d2e'],1,1,2,17493126,1,0,0,0,13596
be70f78c4c3de55b871e52d9a1c43cc19b219541,1,Oleg Nechiporenko,2014-02-25 14:57:23+02:00,['5be623515893830d7f995b0662ae5a98e1bf40cd'],129,139,268,17493394,12,0,0,0.016393443,13598
4737319e01c634ac354a12a6f4dd2d49556e0253,1,atkach,2014-02-25 15:23:18+02:00,['be70f78c4c3de55b871e52d9a1c43cc19b219541'],3,25,28,17493422,4,,,,13599
c04360ddc39b2a2f8094ec71be6380d62a3b327d,0,Oleg Nechiporenko,2014-02-25 16:28:13+02:00,['4737319e01c634ac354a12a6f4dd2d49556e0253'],4,6,10,17493432,1,,,,13599
a9da4498459a8b4e731a83665b8f0bb5f9bc1fd7,0,atkach,2014-02-25 17:46:24+02:00,['c04360ddc39b2a2f8094ec71be6380d62a3b327d'],0,2,2,17493434,1,0,1,1,13599
845355c5f16a5dd64387751b46bd2c2436866db4,1,Oleg Nechiporenko,2014-02-25 18:17:39+02:00,['a9da4498459a8b4e731a83665b8f0bb5f9bc1fd7'],12,12,24,17493458,3,0,0,0,13599
6f0f26a56af765473490687ebaf9808b3dc72a6c,1,aBabiichuk,2014-02-25 18:34:32+02:00,['845355c5f16a5dd64387751b46bd2c2436866db4'],2,17,19,17493477,3,0.888888889,1,1,13599
f18a824c3cbae96dbcdb0fcdd22ed8c4aba0680c,1,Andrew Onischuk,2014-02-25 09:10:48-08:00,['6f0f26a56af765473490687ebaf9808b3dc72a6c'],348,26,374,17493851,23,1,0.504201681,0.478991597,13599
0b155481f1ff84294dc29fc159abd464c62c6a35,1,Lisnichenko Dmitro,2014-02-25 20:05:03+02:00,['f18a824c3cbae96dbcdb0fcdd22ed8c4aba0680c'],40,477,517,17494368,16,0,0.796296296,1,13601
c6987eeef05bce7404635a9a88a4f30b94c134e0,0,Siddharth Wagle,2014-02-25 10:18:15-08:00,['0b155481f1ff84294dc29fc159abd464c62c6a35'],749,1411,2160,17496528,23,0.174641148,0.593301435,0.825358852,13603
668d4c26d2af899c4a84873794ee5d4241a0a975,1,Siddharth Wagle,2014-02-25 11:57:19-08:00,['c6987eeef05bce7404635a9a88a4f30b94c134e0'],1411,749,2160,17498688,23,0.825358852,0.406698565,0.174641148,13603
5041884de7848fc22d4a9a2df53ceb7db9f04e8d,1,Jaimin Jetly,2014-02-25 12:34:18-08:00,['668d4c26d2af899c4a84873794ee5d4241a0a975'],66,234,300,17498988,2,0,0,0.535714286,13604
66478e1126449cf486b388f7e3372be201b64f69,1,Srimanth Gunturi,2014-02-25 13:31:16-08:00,['5041884de7848fc22d4a9a2df53ceb7db9f04e8d'],5,5,10,17498998,5,,,,13604
6d522cb9d62c7f6775c7ec4ae9bd04aff3d5da4e,1,tbeerbower,2014-02-25 17:08:26-05:00,['66478e1126449cf486b388f7e3372be201b64f69'],11,127,138,17499136,2,0,0.698630137,0.698630137,13604
a9bd173545063df979148c6593c55ef8439a40b4,1,Jaimin Jetly,2014-02-25 15:13:58-08:00,['6d522cb9d62c7f6775c7ec4ae9bd04aff3d5da4e'],9,47,56,17499192,4,0.933333333,0.933333333,1,13604
07d38f3689cd2c104512052e1b0cf8a053ab139b,1,Yusaku Sako,2014-02-25 15:52:51-08:00,['a9bd173545063df979148c6593c55ef8439a40b4'],3,3,6,17499198,2,,,,13604
f56d554e49d117445f1f7d262f58c110a38f9272,0,Srimanth Gunturi,2014-02-25 17:54:22-08:00,['07d38f3689cd2c104512052e1b0cf8a053ab139b'],330,811,1141,17500339,5,,,,13604
e92ae94e4bf7fe704e23acadd0766ec58cbed95d,0,Yusaku Sako,2014-02-25 18:18:54-08:00,['f56d554e49d117445f1f7d262f58c110a38f9272'],11,17,28,17500367,1,,,,13604
d5d6109058386dc1619cd4c1ed39cd70f7ba0090,1,Yusaku Sako,2014-02-25 18:21:49-08:00,['e92ae94e4bf7fe704e23acadd0766ec58cbed95d'],50,70,120,17500487,3,,,,13604
adc3fd05af9538a0ed0c655a5b5f854ee0a413f2,1,Jaimin Jetly,2014-02-25 19:10:41-08:00,['d5d6109058386dc1619cd4c1ed39cd70f7ba0090'],19,68,87,17500574,4,0.351351351,1,1,13604
8119a9d3e66f8cdbcd54628d16c12dabfdf7fbd9,1,Jaimin Jetly,2014-02-25 19:49:33-08:00,['adc3fd05af9538a0ed0c655a5b5f854ee0a413f2'],1,1,2,17500576,1,,,,13604
a46484e4b5ff8f72c1dd26b077f5a9412b68074e,1,Jaimin Jetly,2014-02-25 21:14:20-08:00,['8119a9d3e66f8cdbcd54628d16c12dabfdf7fbd9'],37,52,89,17500665,3,,,,13604
c4a2523e0cdc06d847336b2073cb621c67b3acc3,0,Andrew Onischuk,2014-02-26 03:19:49-08:00,['a46484e4b5ff8f72c1dd26b077f5a9412b68074e'],6,6,12,17500677,2,,,,13604
225fb253c66e3573e9e9577cac5069de829ecbe9,1,Alex Antonenko,2014-02-26 14:51:18+02:00,['c4a2523e0cdc06d847336b2073cb621c67b3acc3'],1,4,5,17500682,2,1,1,1,13604
e6ba88fb0a5b47c7b23604e5d6cdcad3324f3fb2,1,Alex Antonenko,2014-02-26 14:58:23+02:00,['225fb253c66e3573e9e9577cac5069de829ecbe9'],3,3,6,17500688,2,,,,13604
884b1e8cec444b2fca293037f33334088d940b96,0,aBabiichuk,2014-02-26 15:07:41+02:00,['e6ba88fb0a5b47c7b23604e5d6cdcad3324f3fb2'],2,33,35,17500723,5,,,,13604
1aeb5aa1cecf7674a8c5229871d09a38c873753b,1,atkach,2014-02-26 15:56:35+02:00,['884b1e8cec444b2fca293037f33334088d940b96'],10,20,30,17500753,5,1,1,1,13604
edd310c8bba071b2319561b5a364996bc6e305da,1,Aleksandr Kovalenko,2014-02-26 16:06:13+02:00,['1aeb5aa1cecf7674a8c5229871d09a38c873753b'],6,34,40,17500793,3,1,1,1,13604
01b4d27f2dab95741030bb78ec8d5fe44f096aa7,1,Lisnichenko Dmitro,2014-02-26 16:42:52+02:00,['edd310c8bba071b2319561b5a364996bc6e305da'],25,87,112,17500905,6,0,0.769230769,1,13604
d8cfceb9d3f69c28021a4714fd352331cc239da5,1,Vitaly Brodetskyi,2014-02-26 17:30:11+02:00,['01b4d27f2dab95741030bb78ec8d5fe44f096aa7'],3,24,27,17500932,3,0.421052632,1,1,13604
682e55d04a5a82f42178855fabaa27c573a8558f,0,Artem Baranchuk,2014-02-26 17:43:39+02:00,['d8cfceb9d3f69c28021a4714fd352331cc239da5'],102,368,470,17501402,7,0.388059701,1,1,13608
43077b30d915f02dc09d49d5c7441b0124714908,1,atkach,2014-02-26 17:56:36+02:00,['682e55d04a5a82f42178855fabaa27c573a8558f'],1,1,2,17501404,1,,,,13608
0a1cf22d12bf388db54286b8a5dc121c83c190e7,0,Andrew Onischuk,2014-02-26 07:59:04-08:00,['43077b30d915f02dc09d49d5c7441b0124714908'],215,14,229,17501633,21,0,0,0,13608
3d15e738233c42c33675c7f8262077b500199591,1,Alex Antonenko,2014-02-26 18:10:01+02:00,['0a1cf22d12bf388db54286b8a5dc121c83c190e7'],0,9,9,17501642,1,,,,13608
f9bc43dde9286b428adaeafedb3163bdbcb4b821,0,Alex Antonenko,2014-02-26 18:22:19+02:00,['3d15e738233c42c33675c7f8262077b500199591'],0,9,9,17501651,1,0,0,1,13608
d77b11dd72271192a9d7f1972dd12a298c29a4f4,0,Aleksandr Kovalenko,2014-02-26 18:48:42+02:00,['f9bc43dde9286b428adaeafedb3163bdbcb4b821'],117,60,177,17501828,3,0,0,0,13608
79ff159d03111752a847548ee124fc706eabb6dd,0,Vitaly Brodetskyi,2014-02-26 19:04:55+02:00,['d77b11dd72271192a9d7f1972dd12a298c29a4f4'],3,3,6,17501834,2,,,,13608
f959b37689b8b32fc4354dfbab194e174a1c399c,1,Dmitry Sen,2014-02-26 20:12:28+02:00,['79ff159d03111752a847548ee124fc706eabb6dd'],1,1001,1002,17502836,4,,,,13609
dc4709ead97f0fcdf623f28b3a84786bbbdd7f1c,1,Mahadev Konar,2014-02-26 10:47:46-08:00,['f959b37689b8b32fc4354dfbab194e174a1c399c'],7,141,148,17502984,10,0,0,1,13609
13affcb86d55f847c55074d9d1016da2bcb6b133,0,Alex Antonenko,2014-02-26 21:16:01+02:00,['dc4709ead97f0fcdf623f28b3a84786bbbdd7f1c'],14,1,15,17502999,1,1,0,0,13609
87ee281089847b8516f02a5988e6a8b09de48af3,0,Mahadev Konar,2014-02-26 12:32:15-08:00,['13affcb86d55f847c55074d9d1016da2bcb6b133'],77,279,356,17503355,6,0.092307692,0.846153846,0.584615385,13609
cc26943bde277b32e267267a67b3f15a03461f76,0,Mahadev Konar,2014-02-26 13:06:00-08:00,['87ee281089847b8516f02a5988e6a8b09de48af3'],0,35,35,17503390,2,,,,13609
fcb38e5a423e01f2c4e6aaf598d3a7b9b140aa85,0,Artem Baranchuk,2014-02-26 23:25:55+02:00,['cc26943bde277b32e267267a67b3f15a03461f76'],0,30,30,17503420,1,,,,13609
b269ba5f49a9fe73465c59df5677faec3376fb89,1,Srimanth Gunturi,2014-02-26 14:01:24-08:00,['fcb38e5a423e01f2c4e6aaf598d3a7b9b140aa85'],368,693,1061,17504481,12,0.328467153,0.47810219,0.897810219,13610
89bf324889ed93e1eaeb0787b3c8c38391ece7fe,0,Srimanth Gunturi,2014-02-26 15:16:33-08:00,['b269ba5f49a9fe73465c59df5677faec3376fb89'],1,14,15,17504496,1,0,1,1,13610
5e29f679df1496affd5b4b327c923302c7842cce,1,Mahadev Konar,2014-02-26 16:19:14-08:00,['89bf324889ed93e1eaeb0787b3c8c38391ece7fe'],3,3,6,17504502,2,,,,13610
1b311dcbf87407884588cc3964e10445af4fa10d,1,Alex Antonenko,2014-02-27 02:37:54+02:00,['5e29f679df1496affd5b4b327c923302c7842cce'],76,87,163,17504665,4,0,1,1,13610
4635717adc5b96da600eb950b54e00a5b1aa4fd5,1,Jaimin Jetly,2014-02-26 17:01:54-08:00,['1b311dcbf87407884588cc3964e10445af4fa10d'],567,347,914,17505579,4,0.304347826,0.217391304,0.434782609,13610
f0a9aaa62f37f8a63f7314a850b1d6ea23fc2000,1,Jaimin Jetly,2014-02-26 17:38:53-08:00,['4635717adc5b96da600eb950b54e00a5b1aa4fd5'],5,4,9,17505588,2,,,,13610
3842cd54841a363a70ed2e9debc77206411d70c2,0,Mahadev Konar,2014-02-26 18:16:18-08:00,['f0a9aaa62f37f8a63f7314a850b1d6ea23fc2000'],0,440,440,17506028,8,,,,13618
81c4a9d97ca42ad4787e6b48db251bd64bd3204c,1,Oleg Nechiporenko,2014-02-27 15:26:41+02:00,['3842cd54841a363a70ed2e9debc77206411d70c2'],211,171,382,17506410,4,0.5,0,0,13618
7646ec2f16bb059e677db70805b39b63fdbf1437,0,Lisnichenko Dmitro,2014-02-27 15:31:04+02:00,['81c4a9d97ca42ad4787e6b48db251bd64bd3204c'],440,0,440,17506850,8,,,,13618
e26ca98c01590f37f588786489d2825e6d18fd9c,1,Lisnichenko Dmitro,2014-02-27 15:31:04+02:00,['7646ec2f16bb059e677db70805b39b63fdbf1437'],279,77,356,17507206,6,0.907692308,0.153846154,0.415384615,13618
b6b9415ae31248990c9f4f50268998cfa5777c75,1,tbeerbower,2014-02-27 09:08:10-05:00,['e26ca98c01590f37f588786489d2825e6d18fd9c'],13,89,102,17507308,3,0.542857143,1,0.857142857,13618
724f75364969aefd621c86c7c91daf8716299ff4,0,Alex Antonenko,2014-02-27 16:33:44+02:00,['b6b9415ae31248990c9f4f50268998cfa5777c75'],1,4,5,17507313,1,0,0,1,13618
30c81a603e262edf6255136e2915b5c3fdfa9970,1,Andrew Onischuk,2014-02-27 06:46:54-08:00,['724f75364969aefd621c86c7c91daf8716299ff4'],0,36,36,17507349,4,0,1,1,13618
9eef77a0e2c1af62c356abac343eaec642bf702f,1,atkach,2014-02-27 17:10:56+02:00,['30c81a603e262edf6255136e2915b5c3fdfa9970'],151,69,220,17507569,4,1,1,1,13618
62aa47bef78d04edd88676f0acc0a7da0d1f2d00,1,Lisnichenko Dmitro,2014-02-27 17:16:21+02:00,['9eef77a0e2c1af62c356abac343eaec642bf702f'],8,10,18,17507587,10,,,,13618
7eb4bc6b9905cc6df6aee2cfce662e7b53fe6d85,1,John Speidel,2014-02-27 10:58:00-05:00,['62aa47bef78d04edd88676f0acc0a7da0d1f2d00'],310,2882,3192,17510779,40,0.302652106,0.957878315,1,13630
1187ea32f0dfb966fb26955afbff5993a7964a61,0,Alex Antonenko,2014-02-27 18:05:13+02:00,['7eb4bc6b9905cc6df6aee2cfce662e7b53fe6d85'],1,6,7,17510786,2,0.2,0.2,1,13630
572d369d87d00e07f0aaa3a88187a826e04b8d8c,1,Dmitry Sen,2014-02-27 19:09:11+02:00,['1187ea32f0dfb966fb26955afbff5993a7964a61'],2356,1320,3676,17514462,20,,,,13630
b911c05e1b532982118fcf32896aad36313dc50e,1,aBabiichuk,2014-02-27 19:46:28+02:00,['572d369d87d00e07f0aaa3a88187a826e04b8d8c'],511,472,983,17515445,9,0.021276596,0.170212766,0.191489362,13630
da413e507e7045012dfe995622456459008e87e1,1,Lisnichenko Dmitro,2014-02-27 19:56:47+02:00,['b911c05e1b532982118fcf32896aad36313dc50e'],79,719,798,17516243,14,0.104477612,0.835820896,0.567164179,13638
a8884594e0312e776e2c5e07e44a4a389eb80fdc,1,Siddharth Wagle,2014-02-27 10:36:21-08:00,['da413e507e7045012dfe995622456459008e87e1'],135,228,363,17516606,9,0,1,1,13641
f5dc33261e672227955080aba3ca32365312a31b,0,Srimanth Gunturi,2014-02-27 11:23:16-08:00,['a8884594e0312e776e2c5e07e44a4a389eb80fdc'],3,24,27,17516633,1,0.631578947,0.631578947,1,13641
0ee9b81f9f6064a9bc982135af6f5d5664a74108,1,Nate Cole,2014-02-27 16:28:58-05:00,['f5dc33261e672227955080aba3ca32365312a31b'],2,184,186,17516819,3,,,,13642
9acbc10014bf2e752598cf3ca94499a30b7b96dd,1,Mahadev Konar,2014-02-27 13:57:59-08:00,['0ee9b81f9f6064a9bc982135af6f5d5664a74108'],28,100,128,17516947,8,0.016666667,0.95,1,13642
895bf7995453e5db051c0efead21356e73a707b3,1,Mahadev Konar,2014-02-27 14:30:58-08:00,['9acbc10014bf2e752598cf3ca94499a30b7b96dd'],12,11,23,17516970,6,,,,13642
156ddc1e1163dd4cbb2e0df257f04e3df2933a78,1,Yusaku Sako,2014-02-27 16:24:04-08:00,['895bf7995453e5db051c0efead21356e73a707b3'],8,6,14,17516984,3,1,1,1,13642
813a124af9a964377ffb87ab11aec12ed4c8ed6d,1,Yusaku Sako,2014-02-27 16:25:40-08:00,['156ddc1e1163dd4cbb2e0df257f04e3df2933a78'],1,13,14,17516998,4,1,1,1,13642
450022aeee367d3bb51910d2be9535da2bc2ac82,0,Jaimin Jetly,2014-02-27 18:10:42-08:00,['813a124af9a964377ffb87ab11aec12ed4c8ed6d'],1,1,2,17517000,1,,,,13642
044a29f9b1dd70969355edfa09c17f814927ec49,1,Siddharth Wagle,2014-02-27 21:38:23-08:00,['450022aeee367d3bb51910d2be9535da2bc2ac82'],3,126,129,17517129,3,0.089108911,0.95049505,0.95049505,13642
595b721b2226eac4ed240ff931441786018eb27a,1,Siddharth Wagle,2014-02-27 22:01:59-08:00,['044a29f9b1dd70969355edfa09c17f814927ec49'],2,1,3,17517132,1,1,1,1,13642
036b140971d87749acef9cb6c4c4d7bc8bba7912,1,Andrew Onischuk,2014-02-28 05:01:25-08:00,['595b721b2226eac4ed240ff931441786018eb27a'],336,1,337,17517469,1,,,,13642
925df0341fc3671391d1f63400e0c8ba5d23adf7,1,Vitaly Brodetskyi,2014-02-28 15:15:30+02:00,['036b140971d87749acef9cb6c4c4d7bc8bba7912'],18,44,62,17517531,2,,,,13642
4860eb4c65d548183f0e86878d149780bd7606e0,1,Myroslav Papirkovskyy,2014-02-28 15:20:58+02:00,['925df0341fc3671391d1f63400e0c8ba5d23adf7'],67,89,156,17517687,2,0,1,1,13642
b97572927705f9aa686f59b43f099673c6224e05,1,Myroslav Papirkovskyy,2014-02-28 15:20:58+02:00,['4860eb4c65d548183f0e86878d149780bd7606e0'],125,299,424,17518111,11,0.933333333,0.5,0.916666667,13643
d2780170127680ad6dbd5712f1bc7785a8252073,1,Vitaly Brodetskyi,2014-02-28 15:46:33+02:00,['b97572927705f9aa686f59b43f099673c6224e05'],0,16,16,17518127,2,,,,13643
0a5c3ff27ee5b3c5cefe5cb11b703d91cc16507e,1,aBabiichuk,2014-02-28 16:11:17+02:00,['d2780170127680ad6dbd5712f1bc7785a8252073'],1,26,27,17518154,4,1,1,1,13643
6627144d4cb1d8a66356c86f1b008706276609bd,0,atkach,2014-02-28 16:17:50+02:00,['0a5c3ff27ee5b3c5cefe5cb11b703d91cc16507e'],1,4,5,17518159,2,1,1,1,13643
cfe3c6a6e2ecb88d5ce5265122a72d730023632e,1,aBabiichuk,2014-02-28 16:48:28+02:00,['6627144d4cb1d8a66356c86f1b008706276609bd'],3,7,10,17518169,4,,,,13643
3c2ec028d817e08ea7685ee7e388392e0437c717,0,Aleksandr Kovalenko,2014-02-28 17:29:28+02:00,['cfe3c6a6e2ecb88d5ce5265122a72d730023632e'],9,17,26,17518195,3,1,1,1,13643
0a7b75f0d24458d80f7a2a321342cb47379ec23a,1,Nate Cole,2014-02-28 10:43:52-05:00,['3c2ec028d817e08ea7685ee7e388392e0437c717'],7,121,128,17518323,3,0,0.605263158,1,13643
748b061a57e991bf377ef852e009908197f04767,1,Andrew Onischuk,2014-02-28 08:35:07-08:00,['0a7b75f0d24458d80f7a2a321342cb47379ec23a'],11,11,22,17518345,6,,,,13643
1a66462b6045ee2eee6625b8fee6d7e848b23204,1,atkach,2014-02-28 18:59:52+02:00,['748b061a57e991bf377ef852e009908197f04767'],2,7,9,17518354,4,0.25,0.25,1,13643
91bdbc3b80c764ed069f2cb9dc461506cc609dfc,1,Andrew Onischuk,2014-02-28 09:09:28-08:00,['1a66462b6045ee2eee6625b8fee6d7e848b23204'],13,13,26,17518380,7,,,,13643
dde5bb330910076db8d46c42efcbc45ee58b7abc,1,Oleg Nechiporenko,2014-02-28 19:14:54+02:00,['91bdbc3b80c764ed069f2cb9dc461506cc609dfc'],252,300,552,17518932,19,,,,13643
541d15b2125212e07dd5a7468fdf58ecee3c97fd,1,Andrew Onischuk,2014-02-28 09:29:40-08:00,['dde5bb330910076db8d46c42efcbc45ee58b7abc'],2,2,4,17518936,1,,,,13643
41046349c5f3814f3812112fa4b6077904d040f2,1,Siddharth Wagle,2014-02-28 10:29:53-08:00,['541d15b2125212e07dd5a7468fdf58ecee3c97fd'],753,1458,2211,17521147,23,0.179138322,0.494331066,0.83446712,13645
acfb1db9c9b42793754f62cba978a98a34ff8367,1,Myroslav Papirkovskyy,2014-02-28 20:37:19+02:00,['41046349c5f3814f3812112fa4b6077904d040f2'],66,66,132,17521279,3,0,0.125,1,13645
25e74f9589d662b7e962cf98de13bb5bda40713f,1,Chad Roberts,2014-02-28 13:43:49-05:00,['acfb1db9c9b42793754f62cba978a98a34ff8367'],9,26,35,17521314,2,,,,13645
778f59e9759cbe5778fd20ebbbb6c51774b721b9,1,Siddharth Wagle,2014-02-28 11:26:19-08:00,['25e74f9589d662b7e962cf98de13bb5bda40713f'],1,5,6,17521320,1,0,0,0,13645
a8be41bf7210c050c10354e633d127e6680d491d,1,Yusaku Sako,2014-02-28 12:13:02-08:00,['778f59e9759cbe5778fd20ebbbb6c51774b721b9'],30,114,144,17521464,3,1,1,1,13645
133d7d55daf58e28667bb15840c088c4193e3596,0,Siddharth Wagle,2014-02-28 12:20:19-08:00,['a8be41bf7210c050c10354e633d127e6680d491d'],1,1,2,17521466,1,,,,13645
1cd926ef91fc7e6ad4bbe7e7d336c15fcef30ed4,1,Siddharth Wagle,2014-02-28 12:49:55-08:00,['133d7d55daf58e28667bb15840c088c4193e3596'],3,4,7,17521473,1,0,1,1,13645
060ae2cdb4c1706caac1cf3495748ba857b7652b,0,Dmitry Sen,2014-02-28 22:57:17+02:00,['1cd926ef91fc7e6ad4bbe7e7d336c15fcef30ed4'],18,0,18,17521491,2,,,,13645
08dc84acb4e29fdd657a9f0d6937005ef8e5ece7,1,Nate Cole,2014-02-28 16:13:55-05:00,['060ae2cdb4c1706caac1cf3495748ba857b7652b'],30,269,299,17521790,5,0.291666667,0.75,0.283333333,13646
37137ac969ac10313ebcbeaf024b446c19c5cca1,1,Jaimin Jetly,2014-02-28 13:14:34-08:00,['08dc84acb4e29fdd657a9f0d6937005ef8e5ece7'],31,15,46,17521836,4,,,,13646
78a0d5acdc920ee0bb912f9899530e12388e41ef,1,Jaimin Jetly,2014-02-28 13:28:23-08:00,['37137ac969ac10313ebcbeaf024b446c19c5cca1'],0,76,76,17521912,2,1,1,1,13647
b79293137ac69791725bdf9e605eec0df1b99a3b,1,Mahadev Konar,2014-02-28 13:31:26-08:00,['78a0d5acdc920ee0bb912f9899530e12388e41ef'],3,4,7,17521919,2,1,1,1,13647
4e0ffac5b3e89aa630897659e9df50b3f95cbe1b,1,Nate Cole,2014-02-28 16:43:34-05:00,['b79293137ac69791725bdf9e605eec0df1b99a3b'],2,8,10,17521929,1,0,0,1,13647
61828bd41a8d6c15a0fff808e69106e4b641c6fd,1,Siddharth Wagle,2014-02-28 14:50:48-08:00,['4e0ffac5b3e89aa630897659e9df50b3f95cbe1b'],1,1,2,17521931,1,,,,13647
a645599a80efb18404298b728a771da60d010512,1,Nate Cole,2014-02-28 18:31:42-05:00,['61828bd41a8d6c15a0fff808e69106e4b641c6fd'],1,43,44,17521975,3,0,1,1,13647
e3761872c81408da4c797d6ace5edbdfe26ea0df,1,Yusaku Sako,2014-02-28 15:40:22-08:00,['a645599a80efb18404298b728a771da60d010512'],17,34,51,17522026,1,,,,13647
f587f7e56408f2d29bde689524436b54c8ca42f6,1,Jaimin Jetly,2014-02-28 15:42:36-08:00,['e3761872c81408da4c797d6ace5edbdfe26ea0df'],1,25,26,17522052,1,,,,13647
4f4379357998efe97cd0ca20f967a43ea7b0d010,0,Yusaku Sako,2014-02-28 16:59:46-08:00,['f587f7e56408f2d29bde689524436b54c8ca42f6'],2,2,4,17522056,1,,,,13647
c5c1da4c737b265bdb197c8b5bc83eaf6de00eab,0,Mahadev Konar,2014-02-28 17:15:19-08:00,['4f4379357998efe97cd0ca20f967a43ea7b0d010'],17,0,17,17522073,1,,,,13647
33c6e227816ff3f6a791c33c8a030bd33e1d10e9,0,Yusaku Sako,2014-02-28 17:55:54-08:00,['c5c1da4c737b265bdb197c8b5bc83eaf6de00eab'],4,4,8,17522081,1,,,,13647
0134fb666cc85286f1d5f555e9341a55698fdcaf,0,Srimanth Gunturi,2014-02-28 18:04:07-08:00,['33c6e227816ff3f6a791c33c8a030bd33e1d10e9'],16,81,97,17522178,5,0.35483871,0.35483871,1,13647
0f23e3d8ce397b2cae61495b84dc596a3d7ef716,1,Yusaku Sako,2014-02-28 19:13:00-08:00,['0134fb666cc85286f1d5f555e9341a55698fdcaf'],18,12,30,17522208,2,0,0,1,13647
173a54efe8a8ce283a497ba8e67ee95a28b4fc9c,1,Mahadev Konar,2014-03-02 10:54:12-08:00,['0f23e3d8ce397b2cae61495b84dc596a3d7ef716'],2,29,31,17522239,2,0,1,1,13647
b0740f535e4dee688468e29fc2b70a5572595d31,1,Mahadev Konar,2014-03-02 17:24:16-08:00,['173a54efe8a8ce283a497ba8e67ee95a28b4fc9c'],0,58,58,17522297,2,0,0.886792453,1,13647
4a3ed67e1c7b7ac6776a7fd2d8d47badc88bfcea,0,Mahadev Konar,2014-03-02 17:52:06-08:00,['b0740f535e4dee688468e29fc2b70a5572595d31'],1,10,11,17522308,2,0,0.375,1,13647
d40b5214df2574d127e078dc840be8b8d4833662,1,Oleg Nechiporenko,2014-03-03 13:51:39+02:00,['4a3ed67e1c7b7ac6776a7fd2d8d47badc88bfcea'],2,2,4,17522312,2,,,,13647
27854b4b0481f7588bc9b974e9c17a0fb42a14dc,1,Oleg Nechiporenko,2014-03-03 13:58:08+02:00,['d40b5214df2574d127e078dc840be8b8d4833662'],26,38,64,17522376,5,0,1,1,13647
1910dd48891236e9263b2dde2d92f22c116c820c,0,Oleg Nechiporenko,2014-03-03 15:43:29+02:00,['27854b4b0481f7588bc9b974e9c17a0fb42a14dc'],7,9,16,17522392,1,,,,13647
c7640d0db54ebccd11edc1d14ce1495f6258eda5,1,aBabiichuk,2014-03-03 16:16:01+02:00,['1910dd48891236e9263b2dde2d92f22c116c820c'],9,128,137,17522529,3,1,1,1,13648
ac56341dce06301de193c3bdac6070aab127e9d7,0,Vitaly Brodetskyi,2014-03-03 16:21:20+02:00,['c7640d0db54ebccd11edc1d14ce1495f6258eda5'],19,11,30,17522559,2,1,1,0.529411765,13648
872d3c76b575eccb99b5e7af9ff3a7f2d328eabe,1,Artem Baranchuk,2014-03-03 17:42:26+02:00,['ac56341dce06301de193c3bdac6070aab127e9d7'],55,32631,32686,17555245,7,0.516666667,1,0.916666667,13651
b1ad9ea73e47167e64380fb8fdf08a3738836d3c,1,Dmitry Sen,2014-03-03 17:49:19+02:00,['872d3c76b575eccb99b5e7af9ff3a7f2d328eabe'],0,4,4,17555249,1,0,0,1,13651
9ed9f129bdc9858efae0cf19c2ec2911398050e8,1,Dmitry Sen,2014-03-03 18:06:38+02:00,['b1ad9ea73e47167e64380fb8fdf08a3738836d3c'],3,197,200,17555449,14,0.048543689,0.941747573,1,13653
a3ddc89a1361923121e30ca620278161fc1cfbec,1,Andrew Onischuk,2014-03-03 08:20:02-08:00,['9ed9f129bdc9858efae0cf19c2ec2911398050e8'],6,6,12,17555461,2,,,,13653
674765b6f1287c162c17cdce71d8a7f846844bad,1,Andrew Onischuk,2014-03-03 08:46:38-08:00,['a3ddc89a1361923121e30ca620278161fc1cfbec'],5,29,34,17555495,4,0,1,1,13654
bc6c65460a9f303e8944d179e3a34a5f5d156619,1,Andrew Onischuk,2014-03-03 09:15:36-08:00,['674765b6f1287c162c17cdce71d8a7f846844bad'],0,18,18,17555513,6,0,1,1,13654
c97c276ae6db90ab4d7938ef2d815234329d61fe,0,Vitaly Brodetskyi,2014-03-03 19:52:45+02:00,['bc6c65460a9f303e8944d179e3a34a5f5d156619'],3,4,7,17555520,2,0,0,0,13654
5aa5d90da173281c7e11873726f7c63bff176a99,1,Alex Antonenko,2014-03-03 20:05:58+02:00,['c97c276ae6db90ab4d7938ef2d815234329d61fe'],9,31,40,17555560,2,1,1,1,13654
0aebe0191ca233ff9fb9b2999b24569796d08425,0,Alex Antonenko,2014-03-03 20:12:36+02:00,['5aa5d90da173281c7e11873726f7c63bff176a99'],4,3,7,17555567,1,,,,13654
67a5eca7449f96b38f9d51e530d94549cffb2ec3,1,Yusaku Sako,2014-03-03 11:03:26-08:00,['0aebe0191ca233ff9fb9b2999b24569796d08425'],7,7,14,17555581,2,,,,13654
9a0e1efa842d13d9626bc37f4b5a243f40732649,1,atkach,2014-03-03 21:08:57+02:00,['67a5eca7449f96b38f9d51e530d94549cffb2ec3'],1,4,5,17555586,1,0,0,1,13654
e3f4bd9fc719ebc4ae7c3d4ed23e68914b45544d,1,atkach,2014-03-03 21:10:48+02:00,['9a0e1efa842d13d9626bc37f4b5a243f40732649'],3,337,340,17555926,15,0.729411765,0.8,1,13661
30ceedab4d1b1f878fe780d092f0a4a2b0b62ff0,0,Srimanth Gunturi,2014-03-03 11:58:43-08:00,['e3f4bd9fc719ebc4ae7c3d4ed23e68914b45544d'],5,5,10,17555936,1,,,,13661
b05ae04bad69467b921e2e9925bf3abe74fe9a0a,1,atkach,2014-03-03 22:15:08+02:00,['30ceedab4d1b1f878fe780d092f0a4a2b0b62ff0'],1,63,64,17556000,4,0.75,0.75,1,13661
0a6b6df9a0f24851d73f282bf73517883115f921,1,Siddharth Wagle,2014-03-03 17:20:33-08:00,['b05ae04bad69467b921e2e9925bf3abe74fe9a0a'],22,26,48,17556048,6,0,0,1,13661
660bf2c53dc439be613a758f853028ab8cb0e244,0,Aleksandr Kovalenko,2014-03-04 13:50:35+02:00,['0a6b6df9a0f24851d73f282bf73517883115f921'],10,2,12,17556060,1,0,0,0,13661
80e519cad2bd1b29ebe8f965cd44ef3ee12dee47,1,Alex Antonenko,2014-03-04 17:29:50+02:00,['660bf2c53dc439be613a758f853028ab8cb0e244'],2,2,4,17556064,2,,,,13661
489d145ca853b89b91e400cae69b21cca658d508,1,atkach,2014-03-04 19:22:06+02:00,['80e519cad2bd1b29ebe8f965cd44ef3ee12dee47'],122,242,364,17556428,3,0.70754717,1,1,13661
da889292b017a4b79098c152791a7196ea48224f,1,Jaimin Jetly,2014-03-04 09:33:31-08:00,['489d145ca853b89b91e400cae69b21cca658d508'],1,13,14,17556442,2,,,,13661
6d532d89b3d5e3cca41339fbcf9270559c3a1e7e,1,Jaimin Jetly,2014-03-04 09:48:50-08:00,['da889292b017a4b79098c152791a7196ea48224f'],202,143,345,17556787,8,,,,13661
6fdec13f3c9fa45e1767837f7fc1fd7658469b9c,0,Vitaly Brodetskyi,2014-03-04 20:36:06+02:00,['6d532d89b3d5e3cca41339fbcf9270559c3a1e7e'],27,11,38,17556825,7,,,,13661
fdab4bd7fbd1879905cb6eafaa74e634610ee088,0,Aleksandr Kovalenko,2014-03-04 20:37:41+02:00,['6fdec13f3c9fa45e1767837f7fc1fd7658469b9c'],11,15,26,17556851,6,,,,13661
a8d2184b5f4b4c550a84639055e08bc05c2899dd,0,Andrew Onischuk,2014-03-04 11:08:18-08:00,['fdab4bd7fbd1879905cb6eafaa74e634610ee088'],3,0,3,17556854,1,,,,13661
20fa2346b8037e1305d90cbb8f3cbacd64bbf619,1,Mahadev Konar,2014-03-04 11:23:31-08:00,['a8d2184b5f4b4c550a84639055e08bc05c2899dd'],5,24,29,17556883,4,0,0,1,13661
01e59101c2a70bc0eca94a5a5b2dfd1e31fa359d,1,Srimanth Gunturi,2014-03-04 11:26:56-08:00,['20fa2346b8037e1305d90cbb8f3cbacd64bbf619'],8,90,98,17556981,8,1,1,1,13663
804cebf10096303ee3fce24cf15c5946c59377b0,1,Andrew Onischuk,2014-03-04 11:28:03-08:00,['01e59101c2a70bc0eca94a5a5b2dfd1e31fa359d'],10,11,21,17557002,7,1,0,0,13663
e1aa2ddae22c53152a9c3faf3680483210668da5,1,Nate Cole,2014-03-04 15:11:11-05:00,['804cebf10096303ee3fce24cf15c5946c59377b0'],4,50,54,17557056,3,0,1,1,13663
db1554766f923daecdb321ea156f6ee5188f6a84,1,Xi Wang,2014-03-04 15:03:28-08:00,['e1aa2ddae22c53152a9c3faf3680483210668da5'],1,48,49,17557105,2,1,1,1,13663
424d429c4dd98c8d559dcc1c290aeda57b2d5cb1,0,Xi Wang,2014-03-04 15:31:14-08:00,['db1554766f923daecdb321ea156f6ee5188f6a84'],23,37,60,17557165,2,1,1,1,13663
6f005988163de88ecbf726df6848c8be724760cc,1,Oleg Nechiporenko,2014-03-05 14:28:06+02:00,['424d429c4dd98c8d559dcc1c290aeda57b2d5cb1'],5,3,8,17557173,1,,,,13663
c9466c7c013f7a445e6d60d99e60598a64f4b6af,1,Oleg Nechiporenko,2014-03-05 14:52:46+02:00,['6f005988163de88ecbf726df6848c8be724760cc'],8,37,45,17557218,4,1,1,1,13663
c6f9ff782631d6b76d7d3e0df09cf1a27e3ea8bc,1,Vitaly Brodetskyi,2014-03-05 14:53:09+02:00,['c9466c7c013f7a445e6d60d99e60598a64f4b6af'],12,37,49,17557267,7,0,0,1,13663
1dddef3bcf9780374aac2776cca3954c20ecddd1,1,atkach,2014-03-05 14:58:53+02:00,['c6f9ff782631d6b76d7d3e0df09cf1a27e3ea8bc'],2,2,4,17557271,1,,,,13663
bcc8aad56c775929398fe5ede0a5bd410163666e,0,Aleksandr Kovalenko,2014-03-05 15:29:36+02:00,['1dddef3bcf9780374aac2776cca3954c20ecddd1'],14,38,52,17557323,3,1,1,1,13663
343ab68aa57a542fe4cfeb156dc48af5b5d298e4,1,Oleg Nechiporenko,2014-03-05 15:55:41+02:00,['bcc8aad56c775929398fe5ede0a5bd410163666e'],70,89,159,17557482,3,0.352941176,1,1,13663
787dd74ff6fea8665c2647783315fc155b28af88,0,Aleksandr Kovalenko,2014-03-05 15:58:01+02:00,['343ab68aa57a542fe4cfeb156dc48af5b5d298e4'],0,2,2,17557484,1,1,1,1,13663
64520d8136606989a8c7d1ac2b1a91f0787714c4,0,Nate Cole,2014-03-05 09:35:10-05:00,['787dd74ff6fea8665c2647783315fc155b28af88'],4,4,8,17557492,2,,,,13663
4de1ab117a979946e0101d6636644595c56b1552,0,Aleksandr Kovalenko,2014-03-05 18:55:19+02:00,['64520d8136606989a8c7d1ac2b1a91f0787714c4'],1,5,6,17557498,3,1,1,1,13663
707775097514e8778a02e0ae926f7a2334b0bb84,1,Andrew Onischuk,2014-03-05 09:12:12-08:00,['4de1ab117a979946e0101d6636644595c56b1552'],24,68,92,17557590,4,1,1,1,13663
da5fca78a2a26b966d0a3a2fd3df3cc37256228a,1,aBabiichuk,2014-03-05 19:29:42+02:00,['707775097514e8778a02e0ae926f7a2334b0bb84'],12,20,32,17557622,2,1,1,1,13663
3c44c313e66001dcf65c71fbfb2e13418690ef06,1,Oleg Nechiporenko,2014-03-05 19:49:30+02:00,['da5fca78a2a26b966d0a3a2fd3df3cc37256228a'],199,244,443,17558065,22,0.359550562,0.011235955,0,13664
99fb2b9b2ffd058bb0dbd27af2e4546c9eb6e17b,0,Alex Antonenko,2014-03-05 19:54:48+02:00,['3c44c313e66001dcf65c71fbfb2e13418690ef06'],82,64,146,17558211,5,0,0,0,13664
4f7a40943de02251d9733b03909a145228efb5cd,1,Vitaly Brodetskyi,2014-03-05 20:33:14+02:00,['99fb2b9b2ffd058bb0dbd27af2e4546c9eb6e17b'],3,12,15,17558226,2,,,,13664
d6c8aad32a65b30e443372942807649760769fc5,1,Lisnichenko Dmitro,2014-03-05 20:38:20+02:00,['4f7a40943de02251d9733b03909a145228efb5cd'],0,8,8,17558234,2,,,,13664
41b194064f28fd55f418ac1c80da992444e9556e,1,Siddharth Wagle,2014-03-05 10:53:57-08:00,['d6c8aad32a65b30e443372942807649760769fc5'],27,53,80,17558314,4,0,0,0.714285714,13664
221c8215adc2be3735ac22bbf195bb5262358757,1,Lisnichenko Dmitro,2014-03-05 21:22:37+02:00,['41b194064f28fd55f418ac1c80da992444e9556e'],3,12,15,17558329,2,0,1,1,13664
aec54e2c2b95ba1aab133a3bc1a5e53898b208c6,1,Mahadev Konar,2014-03-05 11:48:08-08:00,['221c8215adc2be3735ac22bbf195bb5262358757'],12,360,372,17558701,4,0,1,1,13664
d6942380738fd650c2a7056f6e2436eff3f3fed2,1,Srimanth Gunturi,2014-03-05 13:10:55-08:00,['aec54e2c2b95ba1aab133a3bc1a5e53898b208c6'],1,366,367,17559068,7,0.187022901,1,1,13668
5fca4800dbecc7ac0eb22b810378a99b1be285d4,1,Jaimin Jetly,2014-03-05 13:44:58-08:00,['d6942380738fd650c2a7056f6e2436eff3f3fed2'],13,85,98,17559166,5,0.595744681,0.914893617,1,13668
1ff7f5731c5bb385f6fa55de91ff4e03a78737c9,1,Siddharth Wagle,2014-03-05 13:54:34-08:00,['5fca4800dbecc7ac0eb22b810378a99b1be285d4'],27,51,78,17559244,4,0.222222222,0.722222222,0.555555556,13668
7adcb0db14ca2bf28fea2205178bd043070c0133,1,Xi Wang,2014-03-05 16:55:42-08:00,['1ff7f5731c5bb385f6fa55de91ff4e03a78737c9'],0,8,8,17559252,2,1,1,1,13668
6799d16f68e430d9dcf4df128417a812d06f837b,1,Jaimin Jetly,2014-03-05 19:38:28-08:00,['7adcb0db14ca2bf28fea2205178bd043070c0133'],48,73,121,17559373,5,0.6875,0.6875,1,13668
195ee69005071eb38c4858b25e0d3d1b77f57d2f,1,Oleg Nechiporenko,2014-03-06 15:24:52+02:00,['6799d16f68e430d9dcf4df128417a812d06f837b'],5,12,17,17559390,2,1,1,1,13668
9937ad24210377ba7b44f7ac5407c7d50feac3f3,0,aBabiichuk,2014-03-06 15:58:49+02:00,['195ee69005071eb38c4858b25e0d3d1b77f57d2f'],2,4,6,17559396,1,0,0,1,13668
02959df6918bf0c1c7098975a4162af8ddd9924a,1,Oleg Nechiporenko,2014-03-06 17:16:45+02:00,['9937ad24210377ba7b44f7ac5407c7d50feac3f3'],16,328,344,17559740,9,0.591666667,0.841666667,1,13668
c3691338892f2efc10100acc879158e4c7593b38,0,Aleksandr Kovalenko,2014-03-06 19:53:06+02:00,['02959df6918bf0c1c7098975a4162af8ddd9924a'],99,11,110,17559850,5,0.3375,0.3375,0,13668
4746abd73f98dbaf6892b105ae8f39ef443e3167,1,Aleksandr Kovalenko,2014-03-06 19:56:01+02:00,['c3691338892f2efc10100acc879158e4c7593b38'],29,39,68,17559918,6,1,1,1,13668
9af033149ea34416fa429da67aac4aa66514eb49,0,Andrew Onischuk,2014-03-06 10:17:37-08:00,['4746abd73f98dbaf6892b105ae8f39ef443e3167'],47,0,47,17559965,1,,,,13668
6a6082880836ef433f61181559b228d9403c17ec,1,Lisnichenko Dmitro,2014-03-06 20:27:50+02:00,['9af033149ea34416fa429da67aac4aa66514eb49'],67,62,129,17560094,7,,,,13668
000ab94cd6d091aeb27a06f2946b299d3ffce767,0,Andrew Onischuk,2014-03-06 10:56:07-08:00,['6a6082880836ef433f61181559b228d9403c17ec'],2,2,4,17560098,1,,,,13668
aafd07f70fd2bac70b0d4d57de078e9f2f9a8f4e,1,Andrew Onischuk,2014-03-06 11:08:49-08:00,['000ab94cd6d091aeb27a06f2946b299d3ffce767'],1,3,4,17560102,1,,,,13668
40199b3e7c72c2d0d1cbb6a12af8f68f1ada2518,0,Andrew Onischuk,2014-03-06 11:10:31-08:00,['aafd07f70fd2bac70b0d4d57de078e9f2f9a8f4e'],11,825,836,17560938,12,,,,13669
2c61e863d9c67f226a12a0e6a4e8ecd2f706acc4,0,Alex Antonenko,2014-03-06 21:43:58+02:00,['40199b3e7c72c2d0d1cbb6a12af8f68f1ada2518'],3,3,6,17560944,1,,,,13669
374afc385791e02dede8c1b37ba9621049119ffa,0,Lisnichenko Dmitro,2014-03-06 22:11:14+02:00,['2c61e863d9c67f226a12a0e6a4e8ecd2f706acc4'],10,19,29,17560973,1,1,1,1,13669
81c1a416cc8a3f6b6d4f8df3dd29ab24d632f364,1,Xi Wang,2014-03-06 17:26:51-08:00,['374afc385791e02dede8c1b37ba9621049119ffa'],2,3,5,17560978,1,1,1,1,13669
5bf016242257163d9c92beabd292192116d3869d,0,Srimanth Gunturi,2014-03-06 18:43:09-08:00,['81c1a416cc8a3f6b6d4f8df3dd29ab24d632f364'],17,54,71,17561049,3,0.125,0.208333333,0,13669
bbf8c794d2093d1c4b2193f7d8324b35e262b0de,1,Siddharth Wagle,2014-03-06 19:30:05-08:00,['5bf016242257163d9c92beabd292192116d3869d'],1,2,3,17561052,2,1,1,1,13669
e556180c60ffb3025108c56714ed3b2e3b5e33ee,1,atkach,2014-03-07 12:38:18+02:00,['bbf8c794d2093d1c4b2193f7d8324b35e262b0de'],46,123,169,17561221,3,1,1,1,13669
2549e75cb6d1c52972b53e165c97e1f8bf6ddf2a,1,aBabiichuk,2014-03-07 13:13:40+02:00,['e556180c60ffb3025108c56714ed3b2e3b5e33ee'],0,45,45,17561266,2,1,1,1,13670
f3bbe63b3aa068e6f3eb3d319e47700768856a5a,0,aBabiichuk,2014-03-07 13:28:00+02:00,['2549e75cb6d1c52972b53e165c97e1f8bf6ddf2a'],1,1,2,17561268,1,,,,13670
cab195ddb5e1605b1f7ec132c1f03593c8ff36de,1,Artem Baranchuk,2014-03-07 14:36:13+02:00,['f3bbe63b3aa068e6f3eb3d319e47700768856a5a'],127,127,254,17561522,5,,,,13670
7dc110d646db956c839c457ec48486085adb4bdd,0,atkach,2014-03-07 15:21:50+02:00,['cab195ddb5e1605b1f7ec132c1f03593c8ff36de'],3,13,16,17561538,1,0,1,0,13670
5c95b13c98af0d10a1a5a220b603e5e8f63a1340,0,tbeerbower,2014-03-07 10:04:11-05:00,['7dc110d646db956c839c457ec48486085adb4bdd'],18,212,230,17561768,2,0.481012658,0.455696203,1,13670
8da623ed5da454b75b2935ca2f951e2659128c91,1,Andrew Onischuk,2014-03-07 07:33:17-08:00,['5c95b13c98af0d10a1a5a220b603e5e8f63a1340'],0,176,176,17561944,1,0.41,1,0.06,13671
5237cfd0b77d8c416b90f6a379fa7c2bad84e214,1,Andrew Onischuk,2014-03-07 07:41:04-08:00,['8da623ed5da454b75b2935ca2f951e2659128c91'],2,2,4,17561948,2,,,,13671
719fa21840e8b37ba57afa5f7a02a4c310bc08e4,0,Aleksandr Kovalenko,2014-03-07 17:46:16+02:00,['5237cfd0b77d8c416b90f6a379fa7c2bad84e214'],17,58,75,17562023,9,1,1,1,13671
05774df576c00646c0e3364da8f3e4e0f2f9e588,1,Alex Antonenko,2014-03-07 18:00:28+02:00,['719fa21840e8b37ba57afa5f7a02a4c310bc08e4'],1,29,30,17562053,3,1,1,0.461538462,13671
17125a7e6c98f1e639502c771bd5dbcd60a83b8d,1,Oleg Nechiporenko,2014-03-07 18:22:00+02:00,['05774df576c00646c0e3364da8f3e4e0f2f9e588'],471,733,1204,17563257,4,0.378238342,0.388601036,0.077720207,13672
4fc0d3c2a5826a1a41fd64047ba9f8b219ace565,1,Lisnichenko Dmitro,2014-03-07 19:48:30+02:00,['17125a7e6c98f1e639502c771bd5dbcd60a83b8d'],833,71,904,17564161,12,0,0.8,1,13673
87e84c68152653fe4582e85bb21b1605e041a4c9,0,Srimanth Gunturi,2014-03-07 12:09:16-08:00,['4fc0d3c2a5826a1a41fd64047ba9f8b219ace565'],1,13,14,17564175,2,0.6,0.8,1,13673
3f119e345d8bff6d94c3669f5278735252e89b96,0,Srimanth Gunturi,2014-03-07 13:25:44-08:00,['87e84c68152653fe4582e85bb21b1605e041a4c9'],4,4,8,17564183,1,,,,13673
b4eb05c6eafb71b8fc1fdfa1e4e18941e11b6f7a,1,Jaimin Jetly,2014-03-07 17:54:00-08:00,['3f119e345d8bff6d94c3669f5278735252e89b96'],20,60,80,17564263,3,0.512820513,1,1,13673
592e16f3708c6f57d0c26c83d5dfadee2b520401,0,Srimanth Gunturi,2014-03-10 00:48:58-07:00,['b4eb05c6eafb71b8fc1fdfa1e4e18941e11b6f7a'],18,46,64,17564327,9,0.75,0.75,1,13673
8bf325f20cbf89145c149b3f0786d43aeae01305,0,Nate Cole,2014-03-10 16:46:56-04:00,['592e16f3708c6f57d0c26c83d5dfadee2b520401'],524,134,658,17564985,15,0,0,1,13676
9ac86781e46faa4c140ff87ac1872bff01bdd744,1,Yusaku Sako,2014-03-10 14:28:00-07:00,['8bf325f20cbf89145c149b3f0786d43aeae01305'],2,2,4,17564989,1,,,,13676
16703e0737ea50b6fcb86f3a1442be5401e0f0bc,0,Yusaku Sako,2014-03-10 14:52:07-07:00,['9ac86781e46faa4c140ff87ac1872bff01bdd744'],1,2,3,17564992,1,,,,13676
f53763b377a12ae1bb3e0732d5431d90e8d9a3fc,1,Yusaku Sako,2014-03-10 14:53:20-07:00,['16703e0737ea50b6fcb86f3a1442be5401e0f0bc'],0,2,2,17564994,1,,,,13676
1e83c740d2ddec7e8f3225b3cd2674eace26ef9c,1,Siddharth Wagle,2014-03-10 17:09:23-07:00,['f53763b377a12ae1bb3e0732d5431d90e8d9a3fc'],97,214,311,17565305,10,0,0.887850467,0.990654206,13676
df6c70cbe9ffa2c562abf244ca87e300b34eeea1,1,Yusaku Sako,2014-03-10 17:13:07-07:00,['1e83c740d2ddec7e8f3225b3cd2674eace26ef9c'],1,1,2,17565307,1,,,,13676
a02cf3f1f5c7ca19efe82b8147aa039f6afdf10c,1,Mahadev Konar,2014-03-10 19:08:24-07:00,['df6c70cbe9ffa2c562abf244ca87e300b34eeea1'],54,553,607,17565914,87,0,0,1,13692
ca876224eba9c2a556ad2c7efc95348bb586f998,1,Jaimin Jetly,2014-03-10 19:30:32-07:00,['a02cf3f1f5c7ca19efe82b8147aa039f6afdf10c'],386,428,814,17566728,18,1,1,0,13692
f9c05125e8a063e841cfdb688585bb4367500b19,0,Mahadev Konar,2014-03-10 21:37:25-07:00,['ca876224eba9c2a556ad2c7efc95348bb586f998'],1,1,2,17566730,1,,,,13692
e76f9df0b1c69a6bcaedee912b925ffb1c033edd,1,Siddharth Wagle,2014-03-10 23:55:17-07:00,['f9c05125e8a063e841cfdb688585bb4367500b19'],8,8,16,17566746,1,,,,13692
de154ac168df4711efc3271be8ddb3e0d20fa3d4,0,Yusaku Sako,2014-03-11 00:28:21-07:00,['e76f9df0b1c69a6bcaedee912b925ffb1c033edd'],1,1,2,17566748,1,,,,13692
22c6e54e73343ac856a801251117595be2e2f894,0,Siddharth Wagle,2014-03-11 00:43:32-07:00,['de154ac168df4711efc3271be8ddb3e0d20fa3d4'],1,1,2,17566750,1,,,,13692
6a8ae7f1bb4e2d25bbfc34cca3a9b83f5bc6c54e,1,Vitaly Brodetskyi,2014-03-11 11:04:50+02:00,['22c6e54e73343ac856a801251117595be2e2f894'],28,80,108,17566858,4,,,,13692
e1035d145fdaee42ccaadd8ea5475b83da72bead,1,aBabiichuk,2014-03-11 14:28:39+02:00,['6a8ae7f1bb4e2d25bbfc34cca3a9b83f5bc6c54e'],9,9,18,17566876,2,,,,13692
e788c8b816930f6b8108c4323bac03513a25d924,0,aBabiichuk,2014-03-11 15:02:46+02:00,['e1035d145fdaee42ccaadd8ea5475b83da72bead'],5,14,19,17566895,3,,,0,13692
ae5f8519fb056afe103b7017a456049ce02931da,1,Andrew Onischuk,2014-03-11 08:03:06-07:00,['e788c8b816930f6b8108c4323bac03513a25d924'],8,11,19,17566914,2,,,,13692
fa65de900c3016f6528006de416d4d4112992aba,1,Alex Antonenko,2014-03-11 17:23:27+02:00,['ae5f8519fb056afe103b7017a456049ce02931da'],28,102,130,17567044,6,1,1,0.52,13692
7187a2606bb7abb8d2ccba4e1e4f7c46e19af450,0,Aleksandr Kovalenko,2014-03-11 17:31:20+02:00,['fa65de900c3016f6528006de416d4d4112992aba'],6,14,20,17567064,5,1,1,1,13692
1b1dcaf9a4d64b24367a8961513125042c92ddce,0,Aleksandr Kovalenko,2014-03-11 17:31:20+02:00,['7187a2606bb7abb8d2ccba4e1e4f7c46e19af450'],0,17,17,17567081,1,1,1,1,13692
97cff09d2c8cdc3253f9f7bc1c1d24a5cdda21a2,0,Aleksandr Kovalenko,2014-03-11 17:31:21+02:00,['1b1dcaf9a4d64b24367a8961513125042c92ddce'],8,16,24,17567105,4,0.5,0,1,13692
4edcf069a150657b6d1b6e19ead33f79c7a01d35,1,atkach,2014-03-11 17:50:45+02:00,['97cff09d2c8cdc3253f9f7bc1c1d24a5cdda21a2'],11,10,21,17567126,3,0,0,0,13692
bf741836dc86b3c4a84cb03a268c9c1aa26a7e3b,1,Oleg Nechiporenko,2014-03-11 18:12:06+02:00,['4edcf069a150657b6d1b6e19ead33f79c7a01d35'],38,64,102,17567228,7,0,0.944444444,1,13692
a04bd5fb2eafc59a4f6d881f2e022ab9c70913c5,1,aBabiichuk,2014-03-11 18:32:02+02:00,['bf741836dc86b3c4a84cb03a268c9c1aa26a7e3b'],5,31,36,17567264,5,1,1,0.714285714,13692
9b5705a4e9cca318624aad09c6f4e6e10c4afc81,1,Mahadev Konar,2014-03-11 10:02:30-07:00,['a04bd5fb2eafc59a4f6d881f2e022ab9c70913c5'],6,6,12,17567276,4,,,,13692
29ccfa7f9cc566aba5c5c3bb7908744611c44444,0,Alex Antonenko,2014-03-11 19:23:22+02:00,['9b5705a4e9cca318624aad09c6f4e6e10c4afc81'],6,7,13,17567289,2,,,,13692
e37c2b5763f413e4ec1dc9fc12f4de70f8ca7e8a,1,Myroslav Papirkovskyy,2014-03-11 19:38:18+02:00,['29ccfa7f9cc566aba5c5c3bb7908744611c44444'],84,2387,2471,17569760,30,0.321637427,0.076023392,1,13701
2fa99b94f3413bff6a0b9d5c6f4f537c348f9fc2,0,Nate Cole,2014-03-11 13:42:08-04:00,['e37c2b5763f413e4ec1dc9fc12f4de70f8ca7e8a'],0,14,14,17569774,1,0,0,1,13701
0f576396df1abcd9d52fae3bedf38b31e164ac7a,1,Siddharth Wagle,2014-03-11 10:53:05-07:00,['2fa99b94f3413bff6a0b9d5c6f4f537c348f9fc2'],0,241,241,17570015,2,0.236486486,0.560810811,1,13702
19a336954b3a24c2c875582c8ce526f54637e46d,0,Srimanth Gunturi,2014-03-11 10:56:42-07:00,['0f576396df1abcd9d52fae3bedf38b31e164ac7a'],31,143,174,17570189,2,0.333333333,0.888888889,1,13702
ada5de23cbd3be852870ea6410eb21b03e8f2f40,1,Vitaly Brodetskyi,2014-03-11 20:01:30+02:00,['19a336954b3a24c2c875582c8ce526f54637e46d'],16,676,692,17570881,10,0.015444015,1,1,13702
a799ffdbf0c987070ab7287f06a493449eca94b9,0,Myroslav Papirkovskyy,2014-03-11 20:12:32+02:00,['ada5de23cbd3be852870ea6410eb21b03e8f2f40'],1,1,2,17570883,1,,,,13702
4ed70c31eb78dbc48c7afec1bdc18485a0806f34,1,Lisnichenko Dmitro,2014-03-11 20:38:52+02:00,['a799ffdbf0c987070ab7287f06a493449eca94b9'],13,63,76,17570959,2,0,0.970588235,0.970588235,13702
a3728c4cb547d6dc4faa4e2cde46a7edea58bf05,1,Myroslav Papirkovskyy,2014-03-11 22:39:43+02:00,['4ed70c31eb78dbc48c7afec1bdc18485a0806f34'],5,14,19,17570978,4,0.5,0.833333333,1,13702
6cd020086f24eac8c8503247956209c0c03e6b21,0,Jaimin Jetly,2014-03-11 14:45:33-07:00,['a3728c4cb547d6dc4faa4e2cde46a7edea58bf05'],1,3,4,17570982,1,0,1,1,13702
628338922388a6f76b107c995961f1373374a4eb,1,Andrew Onischuk,2014-03-11 14:46:08-07:00,['6cd020086f24eac8c8503247956209c0c03e6b21'],83,72,155,17571137,3,1,0,0,13702
dd84963dffd4a34b7fde9d933eaf1a707450ec90,0,Yusaku Sako,2014-03-11 14:51:02-07:00,['628338922388a6f76b107c995961f1373374a4eb'],1,3,4,17571141,1,,,,13702
9069cb2fec307ff006d9cab6d78030c25c65f70d,0,Jaimin Jetly,2014-03-11 16:31:53-07:00,['dd84963dffd4a34b7fde9d933eaf1a707450ec90'],0,8,8,17571149,1,,,,13702
2efb77958e69f95ee44606f13ec25103b1e9e7c2,1,Xi Wang,2014-03-11 17:24:51-07:00,['9069cb2fec307ff006d9cab6d78030c25c65f70d'],45,113,158,17571307,7,0.257142857,0.2,1,13702
e1d621ce67a9115614144462ff0bbb96b4abfe11,0,Xi Wang,2014-03-11 17:24:51-07:00,['2efb77958e69f95ee44606f13ec25103b1e9e7c2'],4,16,20,17571327,3,1,1,1,13702
dd57e60aff7845e6eaaa82a415ff0ebd68392fd0,0,Jaimin Jetly,2014-03-11 18:57:38-07:00,['e1d621ce67a9115614144462ff0bbb96b4abfe11'],2,2,4,17571331,1,,,,13702
3f5f8878c1e96ecaa8315ad14f3694478ca67206,1,aBabiichuk,2014-03-12 14:22:10+02:00,['dd57e60aff7845e6eaaa82a415ff0ebd68392fd0'],20,30,50,17571381,11,,,,13702
af0e297eec5abcf1741e8146c876a0c43196267d,1,Oleg Nechiporenko,2014-03-12 14:32:54+02:00,['3f5f8878c1e96ecaa8315ad14f3694478ca67206'],111,180,291,17571672,8,1,0.909090909,1,13703
b4307db96da2035c0c74e97819a3e7f9360e1ff5,0,Vitaly Brodetskyi,2014-03-12 16:26:42+02:00,['af0e297eec5abcf1741e8146c876a0c43196267d'],12,14,26,17571698,2,0,0,0,13703
731c1f19ba1b3c0d7346e1220a534b5d2c0e7c89,0,aBabiichuk,2014-03-12 18:11:27+02:00,['b4307db96da2035c0c74e97819a3e7f9360e1ff5'],2,2,4,17571702,1,,,,13703
eeed6fca567659451a9defb28131874fb8fd3ba6,0,Oleg Nechiporenko,2014-03-12 18:28:59+02:00,['731c1f19ba1b3c0d7346e1220a534b5d2c0e7c89'],2,2,4,17571706,1,,,0,13703
611cb6582a28ae2350b5d204b4ce59f9f685035c,0,Aleksandr Kovalenko,2014-03-12 18:45:15+02:00,['eeed6fca567659451a9defb28131874fb8fd3ba6'],131,186,317,17572023,6,0,0,0,13704
655e8018a3cc68eba45b0925427be35eec0ac20c,0,Vitaly Brodetskyi,2014-03-12 19:11:26+02:00,['611cb6582a28ae2350b5d204b4ce59f9f685035c'],7,21,28,17572051,2,0,0.785714286,0.785714286,13704
892c6ad363ac5282af456105baad55c7ae2219c6,0,Oleg Nechiporenko,2014-03-12 20:06:15+02:00,['655e8018a3cc68eba45b0925427be35eec0ac20c'],4,10,14,17572065,2,0.833333333,1,1,13704
db63a74e796485ec7bcdaee71e3b4e57c7f3d46b,1,Aleksandr Kovalenko,2014-03-12 20:36:31+02:00,['892c6ad363ac5282af456105baad55c7ae2219c6'],15,79,94,17572159,3,0.183673469,1,1,13704
96a953f3938dc5882edc85b6281b8478b5ceb9cc,0,Alex Antonenko,2014-03-12 20:46:41+02:00,['db63a74e796485ec7bcdaee71e3b4e57c7f3d46b'],0,4,4,17572163,1,1,1,1,13704
b7f2d16a8cbc83c04e379767bad77840b6e03c2c,1,atkach,2014-03-12 21:09:34+02:00,['96a953f3938dc5882edc85b6281b8478b5ceb9cc'],64,147,211,17572374,8,0.531914894,1,0,13705
af7a889bb051f2bfffe92927125a08922421a61f,1,Xi Wang,2014-03-12 13:38:06-07:00,['b7f2d16a8cbc83c04e379767bad77840b6e03c2c'],11,23,34,17572408,5,0,0,0,13705
15f6fb0a81ec05ccd12c9ed2c41068e157770957,0,Srimanth Gunturi,2014-03-12 15:01:16-07:00,['af7a889bb051f2bfffe92927125a08922421a61f'],254,442,696,17573104,6,0.941176471,0.901960784,0.784313725,13705
9320e9d2aef3256c5afa7c338f8daa2b3524c379,0,Siddharth Wagle,2014-03-12 15:19:40-07:00,['15f6fb0a81ec05ccd12c9ed2c41068e157770957'],2,2,4,17573108,1,,,,13705
ba276b489250a1df0db186ba71e9d30e8df1a47b,0,Jaimin Jetly,2014-03-12 18:18:24-07:00,['9320e9d2aef3256c5afa7c338f8daa2b3524c379'],158,30,188,17573296,7,1,,,13705
81b8e8fe4ae76a5a0d34fbc8ff9a08664b7d2af3,0,Yusaku Sako,2014-03-12 18:37:08-07:00,['ba276b489250a1df0db186ba71e9d30e8df1a47b'],1,3,4,17573300,2,,,,13705
65e60df3195e146d58891f9d86d283f4ed301727,0,Yusaku Sako,2014-03-12 18:38:57-07:00,['81b8e8fe4ae76a5a0d34fbc8ff9a08664b7d2af3'],0,1,1,17573301,1,,,,13705
00f951fd54672f05d0af647a295b0a9a857675e4,1,Alex Antonenko,2014-03-13 04:46:28+02:00,['65e60df3195e146d58891f9d86d283f4ed301727'],17,83,100,17573401,6,1,1,1,13705
244aa3ff0a83e5767d84996be8e20400b0be6f0d,0,Alex Antonenko,2014-03-13 13:29:38+02:00,['00f951fd54672f05d0af647a295b0a9a857675e4'],4,7,11,17573412,3,1,1,1,13705
aad6fdb94d2e08672ac48311493ee8badf5b8685,1,Dmitry Sen,2014-03-13 14:43:42+02:00,['244aa3ff0a83e5767d84996be8e20400b0be6f0d'],44,47,91,17573503,6,0.588235294,0.882352941,1,13705
1bddc0364f804309b5d19f71a3edd6060ec8de72,0,Andrew Onischuk,2014-03-13 05:49:00-07:00,['aad6fdb94d2e08672ac48311493ee8badf5b8685'],1,2,3,17573506,1,,,,13705
6d11d67806d88eaaa457807d7807684962e071ad,1,Oleg Nechiporenko,2014-03-13 14:58:16+02:00,['1bddc0364f804309b5d19f71a3edd6060ec8de72'],135,165,300,17573806,2,0,0,0,13705
4e78cb3410a87469fc1706d39b24cd36e63e4438,1,Lisnichenko Dmitro,2014-03-13 16:00:12+02:00,['6d11d67806d88eaaa457807d7807684962e071ad'],15,67,82,17573888,3,0.828571429,1,0.8,13705
df85df87ef586c2ef97af81d70f19f53501b9626,1,Oleg Nechiporenko,2014-03-13 16:06:27+02:00,['4e78cb3410a87469fc1706d39b24cd36e63e4438'],14,9,23,17573911,2,1,1,1,13705
e40bf7090a209568b5e5d404d3287d7be734a837,1,Nate Cole,2014-03-13 10:25:23-04:00,['df85df87ef586c2ef97af81d70f19f53501b9626'],2,119,121,17574032,4,0,0,0.952380952,13705
0c3b372aecb96502229a4ab843b8c628f5f434c7,1,Oleg Nechiporenko,2014-03-13 17:11:12+02:00,['e40bf7090a209568b5e5d404d3287d7be734a837'],1,33,34,17574066,3,1,1,1,13705
4731a3b21abddef03e30c11597e92114a0b256e5,1,atkach,2014-03-13 17:31:05+02:00,['0c3b372aecb96502229a4ab843b8c628f5f434c7'],51,49,100,17574166,3,1,1,1,13705
9e870b2cc8bd205f82be1a78a94ce5dfb7787620,0,Aleksandr Kovalenko,2014-03-13 19:14:51+02:00,['4731a3b21abddef03e30c11597e92114a0b256e5'],88,160,248,17574414,6,0.933333333,1,1,13705
45de7eff7c4587c72a8982ed0942f08105db7c3a,1,Dmitry Sen,2014-03-13 20:04:28+02:00,['9e870b2cc8bd205f82be1a78a94ce5dfb7787620'],38,119,157,17574571,5,0.309859155,0.802816901,0.549295775,13705
2016fa316d454141c678b3c141f5674a312417ed,1,Myroslav Papirkovskyy,2014-03-13 22:12:45+02:00,['45de7eff7c4587c72a8982ed0942f08105db7c3a'],0,4,4,17574575,1,0,0,1,13705
4bd14a96638fc40703030129e2355c3ad70429a2,0,Siddharth Wagle,2014-03-13 13:50:48-07:00,['2016fa316d454141c678b3c141f5674a312417ed'],1,19,20,17574595,1,0,0,0,13705
82afeb3f10271afe105ce64e225ffd6348f3f06b,0,Siddharth Wagle,2014-03-13 14:55:36-07:00,['4bd14a96638fc40703030129e2355c3ad70429a2'],7,11,18,17574613,1,0,1,0,13705
3060730c878065cea662c9273f1bd08969b0709d,1,Jaimin Jetly,2014-03-13 15:43:28-07:00,['82afeb3f10271afe105ce64e225ffd6348f3f06b'],8,7,15,17574628,6,,,,13705
b612522f94890e7dc5350c98ddb0792065319a6d,1,Mahadev Konar,2014-03-13 16:46:24-07:00,['3060730c878065cea662c9273f1bd08969b0709d'],119,38,157,17574785,5,0.690140845,0.197183099,0.450704225,13705
82c0cfb2fb6e3ff82be4528e2f2b9fbe9e2d688b,0,Yusaku Sako,2014-03-13 17:37:40-07:00,['b612522f94890e7dc5350c98ddb0792065319a6d'],1,2,3,17574788,2,,,,13705
04c67e8ee2daf6db38dad99a81dc89e5586f079c,0,Mahadev Konar,2014-03-13 18:14:48-07:00,['82c0cfb2fb6e3ff82be4528e2f2b9fbe9e2d688b'],69,0,69,17574857,4,,,,13705
148cf0ac9655f235ec3647251fe05c4442dd61c5,0,Srimanth Gunturi,2014-03-13 22:31:57-07:00,['04c67e8ee2daf6db38dad99a81dc89e5586f079c'],118,184,302,17575159,7,0.48,0,1,13705
69dafbc93cfc66247ba37754898d2cbe3d6c1cf9,0,aBabiichuk,2014-03-14 13:55:37+02:00,['148cf0ac9655f235ec3647251fe05c4442dd61c5'],258,3,261,17575420,5,0.489583333,0.291666667,0.041666667,13705
c3fb6ca297b1b4bc5cae1e33c1b3d96a0abda21b,1,atkach,2014-03-14 15:04:54+02:00,['69dafbc93cfc66247ba37754898d2cbe3d6c1cf9'],19,30,49,17575469,6,0,0,,13705
69786453cec5e927b488c4e11ddedf4266bd942f,1,atkach,2014-03-14 17:11:34+02:00,['c3fb6ca297b1b4bc5cae1e33c1b3d96a0abda21b'],67,55,122,17575591,12,0,1,0,13705
917807d0e3d7db20d756f28dc2274e0ee50172f5,1,Alex Antonenko,2014-03-14 17:23:13+02:00,['69786453cec5e927b488c4e11ddedf4266bd942f'],43,58,101,17575692,7,1,1,1,13705
63f263f4d59c0cc9abf60dc6bb9ac894ed9be9c6,1,aBabiichuk,2014-03-14 18:23:23+02:00,['917807d0e3d7db20d756f28dc2274e0ee50172f5'],47,35,82,17575774,3,0.466666667,0,0,13705
ad28c4e4ef65f15fdfef3f7e7e683221e5a63e23,1,Vitaly Brodetskyi,2014-03-14 18:35:31+02:00,['63f263f4d59c0cc9abf60dc6bb9ac894ed9be9c6'],0,11,11,17575785,4,0.5,1,1,13705
9432be8263b85e367efde26d977ea76c59b8755f,0,Oleg Nechiporenko,2014-03-14 18:36:28+02:00,['ad28c4e4ef65f15fdfef3f7e7e683221e5a63e23'],6,11,17,17575802,3,0.333333333,0.333333333,0,13705
642ba0e93fdd25abc7f018283d20119af85551b4,1,Xi Wang,2014-03-14 11:16:29-07:00,['9432be8263b85e367efde26d977ea76c59b8755f'],4,28,32,17575834,6,0,0.769230769,1,13705
08c7610d43178578bd38695ae5135e2e07dcae3d,0,Yusaku Sako,2014-03-14 15:12:29-07:00,['642ba0e93fdd25abc7f018283d20119af85551b4'],2,2,4,17575838,1,,,,13705
4ccf720aa2a8a5b4b09cdc5bb9cb7e33326ea4a5,1,John Speidel,2014-03-14 18:44:05-04:00,['08c7610d43178578bd38695ae5135e2e07dcae3d'],129,2024,2153,17577991,14,0.31724846,0.635523614,0.869609856,13707
3b97791b032a75c3be899b80a6a425983592bbf9,1,Jaimin Jetly,2014-03-14 17:54:17-07:00,['4ccf720aa2a8a5b4b09cdc5bb9cb7e33326ea4a5'],23,100,123,17578114,3,0.46875,1,1,13707
87e16d06a4b5ab2101690cedb7168af5854bb638,0,Yusaku Sako,2014-03-17 01:46:16-07:00,['3b97791b032a75c3be899b80a6a425983592bbf9'],0,1,1,17578115,1,,,,13707
64c673a98831e6fb609d5e259129a44680a1765c,0,Yusaku Sako,2014-03-17 01:49:14-07:00,['87e16d06a4b5ab2101690cedb7168af5854bb638'],0,3,3,17578118,1,,,,13707
6c2447d0ebbd068938ebdbe2ae059952ae7d6dc9,0,aBabiichuk,2014-03-17 14:03:37+02:00,['64c673a98831e6fb609d5e259129a44680a1765c'],1,1,2,17578120,1,,,,13707
aa3b00d9c629301db4cae739ed177ba24a2d9b71,0,atkach,2014-03-17 14:11:53+02:00,['6c2447d0ebbd068938ebdbe2ae059952ae7d6dc9'],1,1,2,17578122,1,,,,13707
d3e0602c49aa3f65453cbec2a523387cd8bca382,1,Aleksandr Kovalenko,2014-03-17 14:45:54+02:00,['aa3b00d9c629301db4cae739ed177ba24a2d9b71'],22,51,73,17578195,5,1,1,1,13707
4a288fbac0cc38d60473c8ba11c26ffba31da664,0,Aleksandr Kovalenko,2014-03-17 15:31:58+02:00,['d3e0602c49aa3f65453cbec2a523387cd8bca382'],8,10,18,17578213,1,1,1,1,13707
0eec9aa3dff2390e7cb303a37ab64343387f541d,0,Alex Antonenko,2014-03-17 15:37:38+02:00,['4a288fbac0cc38d60473c8ba11c26ffba31da664'],1,9,10,17578223,2,1,1,1,13707
eeea51e1ed5a62fe342a225dfc6c124e66256629,1,Oleg Nechiporenko,2014-03-17 15:45:36+02:00,['0eec9aa3dff2390e7cb303a37ab64343387f541d'],122,46,168,17578391,10,0,0.050847458,0,13707
4351f73b96be3216ac39538b6d1e80ed770fd140,0,Alex Antonenko,2014-03-17 15:50:59+02:00,['eeea51e1ed5a62fe342a225dfc6c124e66256629'],4,8,12,17578403,2,1,1,1,13707
c82ea30e92bc67e359a74d8d934aa8ec54ec4449,1,Andrew Onischuk,2014-03-17 08:35:15-07:00,['4351f73b96be3216ac39538b6d1e80ed770fd140'],7,201,208,17578611,3,0.198473282,0.954198473,0.702290076,13707
38690dd4294b2650843f51e3be5669d47fa422ea,1,Lisnichenko Dmitro,2014-03-17 18:56:57+02:00,['c82ea30e92bc67e359a74d8d934aa8ec54ec4449'],9,125,134,17578745,6,0,0.948275862,0.948275862,13707
c1d73a6148ee1969aa45841b8e9aa0534c7acdf6,1,Vitaly Brodetskyi,2014-03-17 19:05:53+02:00,['38690dd4294b2650843f51e3be5669d47fa422ea'],1,6,7,17578752,2,0,1,0.5,13707
bfac23716749bd098b64d10c2e7f07c189913a44,0,atkach,2014-03-17 19:55:51+02:00,['c1d73a6148ee1969aa45841b8e9aa0534c7acdf6'],1,9,10,17578762,4,0,1,1,13709
b960e606eab5c17c41eb0f47cc5fb41f387a10cb,1,Aleksandr Kovalenko,2014-03-17 21:36:03+02:00,['bfac23716749bd098b64d10c2e7f07c189913a44'],12,22,34,17578796,4,1,1,1,13709
37434acae16a5b5036321d9cef426eb08c342cbe,1,Dmitry Sen,2014-03-17 21:49:17+02:00,['b960e606eab5c17c41eb0f47cc5fb41f387a10cb'],37,114,151,17578947,5,0.223880597,0.985074627,0.417910448,13709
e3c7dd2c8b507b287ae91910ce65c8aead1bd80f,1,Lisnichenko Dmitro,2014-03-17 22:35:27+02:00,['37434acae16a5b5036321d9cef426eb08c342cbe'],11,31,42,17578989,2,0,0,1,13709
4e1519095d65d47e6c8cde49b18c41d6d62b93d4,0,Jaimin Jetly,2014-03-17 14:56:43-07:00,['e3c7dd2c8b507b287ae91910ce65c8aead1bd80f'],2,0,2,17578991,2,,,,13709
e8f7aa1e57f34b77e9b6c2af2b70d6392a7fa7d0,0,Siddharth Wagle,2014-03-17 15:28:37-07:00,['4e1519095d65d47e6c8cde49b18c41d6d62b93d4'],0,23,23,17579014,2,,,,13709
c654952bdac0b4806b509680ea80ff6d31fbecfb,0,Mahadev Konar,2014-03-17 15:52:53-07:00,['e8f7aa1e57f34b77e9b6c2af2b70d6392a7fa7d0'],0,8,8,17579022,2,,,,13709
1d2900fcc5722d593d4ba9f0a7b6d881de9080c1,0,Siddharth Wagle,2014-03-17 15:59:54-07:00,['c654952bdac0b4806b509680ea80ff6d31fbecfb'],139,0,139,17579161,1,,,,13709
7dd65f2e25c3ddd93858b3ca7fc8653d3d8fbc12,0,Xi Wang,2014-03-17 16:38:40-07:00,['1d2900fcc5722d593d4ba9f0a7b6d881de9080c1'],19,51,70,17579231,3,0,0,1,13709
d3c6cce7ea72b4e9d7bdc8ee254fb39f29aed058,0,Srimanth Gunturi,2014-03-17 17:08:01-07:00,['7dd65f2e25c3ddd93858b3ca7fc8653d3d8fbc12'],1,40,41,17579272,2,0,0,1,13709
5a61840ba7fd0ab23b2980a9a52e668a5284e6ef,0,Siddharth Wagle,2014-03-17 17:53:12-07:00,['d3c6cce7ea72b4e9d7bdc8ee254fb39f29aed058'],0,139,139,17579411,1,,,,13710
45383d3696a7f03ee4f700be96da983fed8c936d,1,Yusaku Sako,2014-03-17 18:10:43-07:00,['5a61840ba7fd0ab23b2980a9a52e668a5284e6ef'],0,32,32,17579443,3,,,,13711
915c152b1d9ec7ef19a735af34026fdcbac65392,1,Xi Wang,2014-03-17 18:21:53-07:00,['45383d3696a7f03ee4f700be96da983fed8c936d'],19,15,34,17579477,2,,,,13711
31459c7d54660d310396c8a7630da18543c87d9b,1,Siddharth Wagle,2014-03-17 18:58:22-07:00,['915c152b1d9ec7ef19a735af34026fdcbac65392'],15,66,81,17579558,2,0,0,1,13711
a3639e6e4322140700163536bfda31534568518a,0,Oleg Nechiporenko,2014-03-18 13:19:38+02:00,['31459c7d54660d310396c8a7630da18543c87d9b'],5,5,10,17579568,2,,,0,13711
fcd6a94be63975ef4455c8811cbe2bda5bcadb6c,0,Oleg Nechiporenko,2014-03-18 14:50:07+02:00,['a3639e6e4322140700163536bfda31534568518a'],29,23,52,17579620,2,1,1,1,13711
77a7b826669627f1dd447c6c26bd170ac8a317f6,1,Dmitry Sen,2014-03-18 15:52:08+02:00,['fcd6a94be63975ef4455c8811cbe2bda5bcadb6c'],38,42,80,17579700,2,0,0.25,1,13711
a13574471eb8152fbb33ec609eb15e400325dedd,0,Dmitry Sen,2014-03-18 16:19:49+02:00,['77a7b826669627f1dd447c6c26bd170ac8a317f6'],0,1,1,17579701,1,0,1,1,13711
6609364a0837f9114c7e941d4f1a5c40351960bc,0,Alex Antonenko,2014-03-18 16:45:49+02:00,['a13574471eb8152fbb33ec609eb15e400325dedd'],2,8,10,17579711,1,,,,13711
00fe3df41b1f75c063d4a8f84102ec97f4f98559,1,Andrew Onischuk,2014-03-16 10:59:25-07:00,['6609364a0837f9114c7e941d4f1a5c40351960bc'],24,67,91,17579802,6,0.461538462,0.576923077,0.846153846,13711
226ecd7db2a3a8d3d433354054c44db0266c5274,1,Alex Antonenko,2014-03-18 18:01:22+02:00,['00fe3df41b1f75c063d4a8f84102ec97f4f98559'],0,8,8,17579810,2,1,0,1,13711
1531a7edcf75311ad65cecf9bf2694c729813b0b,1,John Speidel,2014-03-18 12:44:34-04:00,['226ecd7db2a3a8d3d433354054c44db0266c5274'],26,614,640,17580450,17,0.421052632,0.813765182,0.821862348,13715
f58c63645316c30f6ec9728ebab6083a307a0898,1,Andrew Onischuk,2014-03-16 12:45:09-07:00,['1531a7edcf75311ad65cecf9bf2694c729813b0b'],1,54,55,17580505,8,0,1,1,13715
cc07fbe75444415c60e92dc19fd2050d1fa862c3,0,Andrew Onischuk,2014-03-16 12:46:01-07:00,['f58c63645316c30f6ec9728ebab6083a307a0898'],1,1,2,17580507,1,,,,13715
0d056b714ec8a8acbd0d1b62cb2e6992685fa9f0,0,atkach,2014-03-18 19:16:03+02:00,['cc07fbe75444415c60e92dc19fd2050d1fa862c3'],12,19,31,17580538,3,1,1,1,13715
75cb22e6eb9c13b3bd1e4b83bf39daedf3992276,0,aBabiichuk,2014-03-18 19:33:34+02:00,['0d056b714ec8a8acbd0d1b62cb2e6992685fa9f0'],4,9,13,17580551,1,1,1,1,13715
6525b7527f34fd370ef5e90b5a6db0bd68e28bdc,1,Myroslav Papirkovskyy,2014-03-18 21:22:16+02:00,['75cb22e6eb9c13b3bd1e4b83bf39daedf3992276'],15,44,59,17580610,2,1,0.941176471,1,13715
f04e4300142f8897bd6aa8171c114f892ba5d947,1,Andrew Onischuk,2014-03-16 12:48:05-07:00,['6525b7527f34fd370ef5e90b5a6db0bd68e28bdc'],5,5,10,17580620,2,,0,1,13715
436d7a06f54e84e96a8ff22b36bf1d5875f750f6,1,Srimanth Gunturi,2014-03-18 15:25:47-07:00,['f04e4300142f8897bd6aa8171c114f892ba5d947'],15,151,166,17580786,3,0.031578947,0.505263158,1,13716
33cd7fff6b2e6ba6b9b551ee7b3e001ea0551168,0,Jaimin Jetly,2014-03-18 16:23:29-07:00,['436d7a06f54e84e96a8ff22b36bf1d5875f750f6'],1,1,2,17580788,1,,,,13716
c825ed21496a7c1a1e4627f7011c8ea05e60e62f,0,Jaimin Jetly,2014-03-18 16:43:17-07:00,['33cd7fff6b2e6ba6b9b551ee7b3e001ea0551168'],2,7,9,17580797,1,1,1,1,13716
8ee1cce1ec0117872fe1fb7b22810e8a0ecbcf89,1,atkach,2014-03-19 12:55:45+02:00,['c825ed21496a7c1a1e4627f7011c8ea05e60e62f'],16,42,58,17580855,3,1,1,1,13716
03c757c63a5bfcc1dfc64d6a3a221d1a4d4e64a8,0,atkach,2014-03-19 14:22:10+02:00,['8ee1cce1ec0117872fe1fb7b22810e8a0ecbcf89'],16,25,41,17580896,2,1,0.6,1,13716
0887d94eb4beb34fd7b2c2cc6b5140813acf0e60,1,Oleg Nechiporenko,2014-03-19 15:31:40+02:00,['03c757c63a5bfcc1dfc64d6a3a221d1a4d4e64a8'],48,76,124,17581020,2,0.454545455,0.454545455,1,13716
b3408e38786cf1c269644ac9a17e2d9ee0862261,1,Andrew Onischuk,2014-03-16 12:48:20-07:00,['0887d94eb4beb34fd7b2c2cc6b5140813acf0e60'],13,31,44,17581064,3,0.583333333,0.583333333,0.583333333,13716
17ead15a7634c46db6e806b47c116f481108fdaa,0,Dmitry Sen,2014-03-19 16:57:50+02:00,['b3408e38786cf1c269644ac9a17e2d9ee0862261'],3,14,17,17581081,2,0,1,1,13716
8449cd1d34929c823a90001e7e8d22590c2052e9,1,Dmitry Sen,2014-03-19 17:23:55+02:00,['17ead15a7634c46db6e806b47c116f481108fdaa'],120,10,130,17581211,10,1,0,0,13716
bb53d0df1656c310e75a829b133110d1fa7e7374,0,Lisnichenko Dmitro,2014-03-19 17:32:01+02:00,['8449cd1d34929c823a90001e7e8d22590c2052e9'],24,233,257,17581468,5,0.03164557,0.101265823,0.943037975,13716
e2a743ba074259e68cd885d589734113dbfb38b7,1,Alex Antonenko,2014-03-19 18:18:10+02:00,['bb53d0df1656c310e75a829b133110d1fa7e7374'],66,125,191,17581659,7,0,1,0,13717
15013b719954c9a12db705196a34bbd9cbd28c51,1,aBabiichuk,2014-03-19 19:06:30+02:00,['e2a743ba074259e68cd885d589734113dbfb38b7'],241,449,690,17582349,9,1,1,1,13718
773ccfe8ffd4777a2adb176fba348726ec335521,1,Andrew Onischuk,2014-03-16 12:48:05-07:00,['15013b719954c9a12db705196a34bbd9cbd28c51'],5,9,14,17582363,4,0,1,0.5,13718
ab66ce06c0b81822695491908d04ff384da15aa6,0,Lisnichenko Dmitro,2014-03-19 19:50:32+02:00,['773ccfe8ffd4777a2adb176fba348726ec335521'],14,1267,1281,17583644,37,,,,13748
bf6cdf5e4405c0d266889d2067d71115218bd66b,1,Lisnichenko Dmitro,2014-03-19 21:44:27+02:00,['ab66ce06c0b81822695491908d04ff384da15aa6'],233,24,257,17583901,5,0.96835443,0.898734177,0.056962025,13748
1524c9bce6d4ce066e45b143c24a82c0b1043176,1,Lisnichenko Dmitro,2014-03-19 22:09:04+02:00,['bf6cdf5e4405c0d266889d2067d71115218bd66b'],0,14,14,17583915,4,1,1,1,13748
33e262e1a8058e0ae9757623c5ec87149d3909bc,1,John Speidel,2014-03-19 16:10:15-04:00,['1524c9bce6d4ce066e45b143c24a82c0b1043176'],0,358,358,17584273,4,,,,13752
ec516c94f711c44dbfe18b3de00d7ba415edb14b,0,Yusaku Sako,2014-03-19 14:00:56-07:00,['33e262e1a8058e0ae9757623c5ec87149d3909bc'],1,1,2,17584275,1,,,,13752
d80ae0bd1f38d992fdef2e7305b80a4353305d09,0,Siddharth Wagle,2014-03-19 14:11:42-07:00,['ec516c94f711c44dbfe18b3de00d7ba415edb14b'],16,76,92,17584367,4,0.239130435,0.369565217,0.913043478,13752
58064a862e08e327c119100c3964aba02e7fe6ac,0,Siddharth Wagle,2014-03-19 14:11:43-07:00,['d80ae0bd1f38d992fdef2e7305b80a4353305d09'],1267,14,1281,17585648,37,,,,13752
fc1ba0b4af5f29a62b7e5e1c563663757a54a0b7,1,Lisnichenko Dmitro,2014-03-19 23:42:13+02:00,['58064a862e08e327c119100c3964aba02e7fe6ac'],14,1267,1281,17586929,37,,,,13782
93e32e31d785eafdb834d72e4f04365e126f005c,0,Lisnichenko Dmitro,2014-03-19 23:49:39+02:00,['fc1ba0b4af5f29a62b7e5e1c563663757a54a0b7'],33,33,66,17586995,1,,,,13782
5b72f0b54cbf0350cfbbad78ae9125174ff9afd2,0,Andrew Onischuk,2014-03-16 12:59:20-07:00,['93e32e31d785eafdb834d72e4f04365e126f005c'],0,3,3,17586998,1,0,1,0,13782
3b1fcf36a6771a989f4b188f7018ea2a574f68df,1,John Speidel,2014-03-19 18:39:16-04:00,['5b72f0b54cbf0350cfbbad78ae9125174ff9afd2'],18,42,60,17587058,4,0.909090909,0.909090909,0.545454545,13782
b3f8c1d0198dfd5ddd90aae0ec55b592f5d56376,1,John Speidel,2014-03-19 19:34:58-04:00,['3b1fcf36a6771a989f4b188f7018ea2a574f68df'],2,2,4,17587062,2,,,,13782
d42a5b3904ff4320e28442b804dcbe32884d4cfc,1,Siddharth Wagle,2014-03-19 17:22:37-07:00,['b3f8c1d0198dfd5ddd90aae0ec55b592f5d56376'],24,15,39,17587101,5,1,0,0,13782
57138c3d3a550b470c7f85396ec80bf3bac378bb,0,Aleksandr Kovalenko,2014-03-20 12:40:10+02:00,['d42a5b3904ff4320e28442b804dcbe32884d4cfc'],93,113,206,17587307,7,0.730769231,0,0,13782
c2cfab3acbf965603d13665c13634f9b6aa21d8a,0,Oleg Nechiporenko,2014-03-20 15:04:33+02:00,['57138c3d3a550b470c7f85396ec80bf3bac378bb'],5,33,38,17587345,2,0,1,1,13782
35b5a57f9c7355c3da51179f8ac8fc3f2f475237,0,Lisnichenko Dmitro,2014-03-20 16:51:36+02:00,['c2cfab3acbf965603d13665c13634f9b6aa21d8a'],10,6,16,17587361,4,,,,13782
b6b56cfeb600cd1be788245843f57ed2c6306072,0,atkach,2014-03-20 17:44:34+02:00,['35b5a57f9c7355c3da51179f8ac8fc3f2f475237'],27,45,72,17587433,7,1,1,0.5,13782
442f73229dedb0bb6969afe3a5ad7a89bf7d5d70,1,aBabiichuk,2014-03-20 17:54:15+02:00,['b6b56cfeb600cd1be788245843f57ed2c6306072'],5,41,46,17587479,3,0.305555556,1,1,13782
187ec69bf5ab0d978559b31d9740f5da21ab1d1f,0,Alex Antonenko,2014-03-20 17:57:27+02:00,['442f73229dedb0bb6969afe3a5ad7a89bf7d5d70'],10,52,62,17587541,3,0.979166667,0.979166667,1,13782
a931fd17baec79bf65b18e9a801a317dca23c176,0,Aleksandr Kovalenko,2014-03-20 18:27:44+02:00,['187ec69bf5ab0d978559b31d9740f5da21ab1d1f'],24,41,65,17587606,2,1,1,1,13782
c60fe07b64a4f3a0272b7b98a0324e82caead494,1,Siddharth Wagle,2014-03-20 09:41:13-07:00,['a931fd17baec79bf65b18e9a801a317dca23c176'],2,15,17,17587623,1,0.636363636,0,1,13782
55b5111afa79d2954b750e62f33a49eaa6ac627a,0,atkach,2014-03-20 18:53:56+02:00,['c60fe07b64a4f3a0272b7b98a0324e82caead494'],4,13,17,17587640,3,0.9,0.9,1,13782
caf2e6f5544c917d10570d45fd8eede560e1378f,1,aBabiichuk,2014-03-20 18:58:13+02:00,['55b5111afa79d2954b750e62f33a49eaa6ac627a'],0,3,3,17587643,1,,,,13782
127ce93e9bcbc00b64092ffd4b015dcbe657ef25,1,Dmitry Sen,2014-03-20 19:23:37+02:00,['caf2e6f5544c917d10570d45fd8eede560e1378f'],8,350,358,17588001,6,0.008849558,0.256637168,1,13783
112c758df1849ab7063982262e1b8c408791ff48,0,Mahadev Konar,2014-03-20 10:29:05-07:00,['127ce93e9bcbc00b64092ffd4b015dcbe657ef25'],30,7,37,17588038,2,,,,13783
b73aca82558159bf104457f6724aa0dc41647791,0,Lisnichenko Dmitro,2014-03-20 21:24:51+02:00,['112c758df1849ab7063982262e1b8c408791ff48'],78,18,96,17588134,2,0.377777778,0,0.444444444,13783
46de892c1a640fb11d95255915923bb386ae6040,0,Alex Antonenko,2014-03-20 21:31:28+02:00,['b73aca82558159bf104457f6724aa0dc41647791'],1,1,2,17588136,1,,,,13783
fe79eab9b67e306ab91b3a9ceceb245e5871b0bc,0,Yusaku Sako,2014-03-20 12:53:16-07:00,['46de892c1a640fb11d95255915923bb386ae6040'],13,4,17,17588153,3,0.1,0.1,0,13783
6cb293b27fdc7c5e861717c43425d585e7fa2cde,0,Yusaku Sako,2014-03-20 12:53:16-07:00,['fe79eab9b67e306ab91b3a9ceceb245e5871b0bc'],45,27,72,17588225,7,0,0,0.5,13783
9035b3f3fc35177fccf7b702780a6fb2f8ba3258,0,Siddharth Wagle,2014-03-20 15:46:21-07:00,['6cb293b27fdc7c5e861717c43425d585e7fa2cde'],0,1,1,17588226,1,0,0,1,13783
2eda4d31b4d5f156d77ba68a76f525e24a709779,0,Srimanth Gunturi,2014-03-20 16:00:43-07:00,['9035b3f3fc35177fccf7b702780a6fb2f8ba3258'],26,92,118,17588344,8,1,0,1,13783
9916f42c6214521df1c7f4f5a93c93d9f7ff3c5d,1,Siddharth Wagle,2014-03-20 17:38:40-07:00,['2eda4d31b4d5f156d77ba68a76f525e24a709779'],2,3,5,17588349,1,1,0,1,13783
6b6ce4330d55dbfe5c4d6369071d758b8f135ab1,1,Yusaku Sako,2014-03-20 19:39:36-07:00,['9916f42c6214521df1c7f4f5a93c93d9f7ff3c5d'],117,220,337,17588686,11,1,1,1,13783
e5696384acceb6705d28b07309c4ec50c108e189,0,Aleksandr Kovalenko,2014-03-21 14:13:59+02:00,['6b6ce4330d55dbfe5c4d6369071d758b8f135ab1'],7,20,27,17588713,5,1,1,1,13783
ccde6bc4ce0a6daf45fee98b3b25bb759cf72aa9,0,atkach,2014-03-21 14:52:49+02:00,['e5696384acceb6705d28b07309c4ec50c108e189'],24,50,74,17588787,8,0.944444444,0.944444444,0.777777778,13783
7c02ccbf30bafbe0d4d1421293457fd61a0963f2,0,Alex Antonenko,2014-03-21 15:12:32+02:00,['ccde6bc4ce0a6daf45fee98b3b25bb759cf72aa9'],3,6,9,17588796,2,1,1,0,13783
eb99f753de0b317792d4ae4b2958843ccc1b0d27,0,Alex Antonenko,2014-03-21 16:06:45+02:00,['7c02ccbf30bafbe0d4d1421293457fd61a0963f2'],23,8,31,17588827,4,1,1,1,13783
bb6844a800393e8aa098eca19af75c1dd801b327,1,Lisnichenko Dmitro,2014-03-21 16:12:57+02:00,['eb99f753de0b317792d4ae4b2958843ccc1b0d27'],24,240,264,17589091,5,0.030120482,0.096385542,0.945783133,13783
336b5a89a0782f5b4883ec5b65dd0fdfa4a6cd7c,0,Alex Antonenko,2014-03-21 17:27:44+02:00,['bb6844a800393e8aa098eca19af75c1dd801b327'],2,14,16,17589107,3,1,1,1,13783
efb8bd9c44d51669c3f83d76ea22ef8ef4634876,1,Artem Baranchuk,2014-03-21 17:55:20+02:00,['336b5a89a0782f5b4883ec5b65dd0fdfa4a6cd7c'],0,2826,2826,17591933,1,,,,13783
18ab92c9c645353644402a4d51f31d28c9fa12ea,0,Artem Baranchuk,2014-03-21 17:55:21+02:00,['efb8bd9c44d51669c3f83d76ea22ef8ef4634876'],8,9,17,17591950,4,0.045454545,1,1,13783
46c6dab45b0f5f6e668199f913d4e8ca134b68a3,1,Artem Baranchuk,2014-03-21 17:55:22+02:00,['18ab92c9c645353644402a4d51f31d28c9fa12ea'],2415,4854,7269,17599219,2,,,,13783
39e2a744772ded1d42d722dcb19ebd05f2c6912e,1,Andrew Onischuk,2014-03-20 05:50:58-07:00,['46c6dab45b0f5f6e668199f913d4e8ca134b68a3'],298,45,343,17599562,12,0.308823529,0.007352941,0,13783
a1ce9d351667d513f5a7cf7d34d80bca5f83566a,0,aBabiichuk,2014-03-21 18:28:54+02:00,['39e2a744772ded1d42d722dcb19ebd05f2c6912e'],37,0,37,17599599,10,1,0.857142857,0,13783
4e31383dcff9a0d24f73c64cc8ba07bf2a932da4,0,Vitaly Brodetskyi,2014-03-21 18:55:51+02:00,['a1ce9d351667d513f5a7cf7d34d80bca5f83566a'],52,0,52,17599651,4,,,,13783
dce87447dcdbb961a0acf6a22406a24b983d28e8,0,Aleksandr Kovalenko,2014-03-21 19:24:44+02:00,['4e31383dcff9a0d24f73c64cc8ba07bf2a932da4'],14,65,79,17599730,11,0,0,1,13783
6c24c657de9d79e15587d03aaf70dbbce718db1b,0,Aleksandr Kovalenko,2014-03-21 19:50:55+02:00,['dce87447dcdbb961a0acf6a22406a24b983d28e8'],25,26,51,17599781,2,,,,13783
02e5e04540efa8177a5c6c1bf1deecd98eeba399,1,Andrew Onischuk,2014-03-21 11:12:39-07:00,['6c24c657de9d79e15587d03aaf70dbbce718db1b'],6,79,85,17599866,4,1,1,0.3,13784
9c16989fbb6c7323e7a8234c47894960d54b81f0,1,Myroslav Papirkovskyy,2014-03-21 21:11:39+02:00,['02e5e04540efa8177a5c6c1bf1deecd98eeba399'],21,30,51,17599917,4,0,0,1,13784
8d58c3262635e1cf115ca77628a865dcaee4d67c,1,Dmitry Sen,2014-03-21 22:20:35+02:00,['9c16989fbb6c7323e7a8234c47894960d54b81f0'],1,1,2,17599919,1,,,,13784
a3410253caaec3527792a71f02bdc5e5cecef29a,1,Lisnichenko Dmitro,2014-03-21 22:36:29+02:00,['8d58c3262635e1cf115ca77628a865dcaee4d67c'],2,29,31,17599950,2,0.823529412,0.823529412,0.823529412,13784
1a26f5b105a8470553ae317fa59723a8298cc6a1,1,Andrew Onischuk,2014-03-21 14:58:23-07:00,['a3410253caaec3527792a71f02bdc5e5cecef29a'],1,23,24,17599974,4,,,,13786
428329bf3d7824f6dadf88c8914395bde002e4ac,0,Andrew Onischuk,2014-03-21 15:00:42-07:00,['1a26f5b105a8470553ae317fa59723a8298cc6a1'],20,0,20,17599994,2,,,,13786
fae3fa56d453aec038890c0fc4d04f4ba69824a3,1,Siddharth Wagle,2014-03-21 15:06:36-07:00,['428329bf3d7824f6dadf88c8914395bde002e4ac'],256,807,1063,17601057,39,0.156862745,0.735294118,0.901960784,13791
a5e372543e3c89b69318e89ba9c3fad4f9695a36,1,Jaimin Jetly,2014-03-21 16:16:22-07:00,['fae3fa56d453aec038890c0fc4d04f4ba69824a3'],50,24,74,17601131,8,0.055555556,0.055555556,0.222222222,13791
d9c2641d7aefa87b5f31e20a9ea1018eed823586,1,Andrew Onischuk,2014-03-24 04:21:40-07:00,['a5e372543e3c89b69318e89ba9c3fad4f9695a36'],183,218,401,17601532,13,0.5,1,0,13793
378b9606c939d47d727ad86330379c5344bdb02a,1,atkach,2014-03-24 14:01:17+02:00,['d9c2641d7aefa87b5f31e20a9ea1018eed823586'],25,51,76,17601608,8,0.944444444,0.944444444,0.777777778,13793
1f8f6de2c964dd23eb9cc26e166fce17814e2ed7,1,Andrew Onischuk,2014-03-24 08:23:09-07:00,['378b9606c939d47d727ad86330379c5344bdb02a'],11,149,160,17601768,5,0.540540541,1,0.324324324,13793
fcccee374cb806a135722aa99356d3a888a137f5,1,Andrew Onischuk,2014-03-24 08:41:03-07:00,['1f8f6de2c964dd23eb9cc26e166fce17814e2ed7'],10,19,29,17601797,2,0.428571429,0.428571429,0.571428571,13793
d94b1d05c316ae66709e6b6189a6d84815f6a505,0,aBabiichuk,2014-03-24 17:47:15+02:00,['fcccee374cb806a135722aa99356d3a888a137f5'],0,1,1,17601798,1,0,0,1,13793
20ca5e57088e9228add876e752b0367edaff080a,1,Lisnichenko Dmitro,2014-03-24 17:49:21+02:00,['d94b1d05c316ae66709e6b6189a6d84815f6a505'],1,9,10,17601808,2,0,1,1,13793
509e02bc07ce2891bfcb473de71ebc1107a0720e,1,Lisnichenko Dmitro,2014-03-24 18:20:24+02:00,['20ca5e57088e9228add876e752b0367edaff080a'],8,8,16,17601824,8,,,,13793
14f369426e1e1a7e537a595eec5f59a25760f970,1,Nate Cole,2014-03-24 12:55:31-04:00,['509e02bc07ce2891bfcb473de71ebc1107a0720e'],24,238,262,17602086,11,0.336956522,0.358695652,0.510869565,13795
2de0789f4ce1c830599f7652ef0cbc191c25fea2,0,Aleksandr Kovalenko,2014-03-24 20:06:31+02:00,['14f369426e1e1a7e537a595eec5f59a25760f970'],17,8,25,17602111,4,,,,13795
dfc023bb2792c5344dd33a0c38370ecaa20d9a96,0,Siddharth Wagle,2014-03-24 11:29:10-07:00,['2de0789f4ce1c830599f7652ef0cbc191c25fea2'],1,1,2,17602113,1,,,,13795
343d41ef5bbb90506ecfc92f6c558f81a021b8e8,1,Jaimin Jetly,2014-03-24 15:49:05-07:00,['dfc023bb2792c5344dd33a0c38370ecaa20d9a96'],9,18,27,17602140,3,0,1,1,13795
79692547ba3f817ff9766535001edf8f20a685e9,0,Vitaly Brodetskyi,2014-03-25 13:41:04+02:00,['343d41ef5bbb90506ecfc92f6c558f81a021b8e8'],0,16,16,17602156,2,0,0,1,13795
360662ed6ccfd4c0d4f30b32cb713b6290b8d993,1,atkach,2014-03-25 13:49:21+02:00,['79692547ba3f817ff9766535001edf8f20a685e9'],3,12,15,17602171,2,1,1,1,13795
ca61dc91a1f10b001f6e337b92828b60c957f895,0,Vitaly Brodetskyi,2014-03-25 14:30:31+02:00,['360662ed6ccfd4c0d4f30b32cb713b6290b8d993'],3,3,6,17602177,1,,,,13795
cf332bb382b752f1ba554e472545046d1458b73b,0,Oleg Nechiporenko,2014-03-25 15:12:32+02:00,['ca61dc91a1f10b001f6e337b92828b60c957f895'],760,1296,2056,17604233,21,1,1,0.352631579,13797
4d0296c673e11c4b976ddb7e28c4701c2d5d18c5,0,Aleksandr Kovalenko,2014-03-25 15:33:38+02:00,['cf332bb382b752f1ba554e472545046d1458b73b'],11,12,23,17604256,1,0,0,1,13797
b51bfea4e7d4852c4272c5f29735925f5c635d0a,0,Andrew Onischuk,2014-03-25 07:54:59-07:00,['4d0296c673e11c4b976ddb7e28c4701c2d5d18c5'],2,5,7,17604263,2,0,0,1,13797
4f226737f99d2caadbd53b27945c14d7a745d43d,1,Alex Antonenko,2014-03-25 17:21:40+02:00,['b51bfea4e7d4852c4272c5f29735925f5c635d0a'],19,87,106,17604369,5,0.536585366,0.951219512,1,13797
6625ae5dd471a1712b10791b326a75978290bea4,1,Alex Antonenko,2014-03-25 17:38:55+02:00,['4f226737f99d2caadbd53b27945c14d7a745d43d'],1,16,17,17604386,1,,,,13797
e3f47c061da47ef805b08df78410885c20d7ae5f,0,Lisnichenko Dmitro,2014-03-25 18:33:22+02:00,['6625ae5dd471a1712b10791b326a75978290bea4'],55,36,91,17604477,2,1,0.314285714,0.514285714,13797
008767f0bee3bac42ec0daeb1ea2c945f9880e9e,1,Nate Cole,2014-03-25 13:14:12-04:00,['e3f47c061da47ef805b08df78410885c20d7ae5f'],84,52,136,17604613,2,0,0.153846154,0,13797
5b0f89462daa45b524b51d53e08c102a6c8c46d9,1,Vitaly Brodetskyi,2014-03-25 19:18:59+02:00,['008767f0bee3bac42ec0daeb1ea2c945f9880e9e'],1,74,75,17604688,1,,,,13797
4bae12388335b99125209bcc8612e3fa36f9b511,1,Vitaly Brodetskyi,2014-03-25 19:27:38+02:00,['5b0f89462daa45b524b51d53e08c102a6c8c46d9'],298,494,792,17605480,4,0.962264151,0.943396226,0.924528302,13799
8d029a62bed250e0d3c31f86c105016521d8469b,1,Andrew Onischuk,2014-03-25 10:41:45-07:00,['4bae12388335b99125209bcc8612e3fa36f9b511'],9,106,115,17605595,4,,,,13800
4490dea55c461a45847314514f9e95ef74b67990,0,Jaimin Jetly,2014-03-25 11:18:11-07:00,['8d029a62bed250e0d3c31f86c105016521d8469b'],0,3,3,17605598,1,,,,13800
322e390b7bd8951819a3e2d46259b53ff8e10ce6,1,Mahadev Konar,2014-03-25 12:44:12-07:00,['4490dea55c461a45847314514f9e95ef74b67990'],15,16,31,17605629,6,,,,13800
a59b635c49d12d45c832a773b95228b64049db48,1,Mahadev Konar,2014-03-25 13:03:40-07:00,['322e390b7bd8951819a3e2d46259b53ff8e10ce6'],38,99,137,17605766,6,0.075,0.075,0.9,13800
4275c3c742ca045febe51210e8855056786526fb,0,Srimanth Gunturi,2014-03-25 13:19:14-07:00,['a59b635c49d12d45c832a773b95228b64049db48'],0,24,24,17605790,2,0,0,0.5,13800
30d52d25886f1e45c245541c57ece2a8523919cb,1,Jaimin Jetly,2014-03-25 14:07:08-07:00,['4275c3c742ca045febe51210e8855056786526fb'],15,137,152,17605942,10,1,1,1,13802
1bdc774351ef15c08c6515948fe36072bd1f67de,0,Jaimin Jetly,2014-03-25 14:52:00-07:00,['30d52d25886f1e45c245541c57ece2a8523919cb'],10,2,12,17605954,1,1,0,0,13802
72f0db1ccdb40f4659ea95adf99534eca9bd3076,1,Srimanth Gunturi,2014-03-25 16:52:06-07:00,['1bdc774351ef15c08c6515948fe36072bd1f67de'],1291,753,2044,17607998,21,0,0,0.640625,13802
7501cfa12480884b515c2bfc0a40960297b73a97,1,Siddharth Wagle,2014-03-25 17:14:05-07:00,['72f0db1ccdb40f4659ea95adf99534eca9bd3076'],3,3,6,17608004,3,,,,13802
1aa731f83d8bd64596f835544534bc51350b6abe,1,Siddharth Wagle,2014-03-25 17:14:28-07:00,['7501cfa12480884b515c2bfc0a40960297b73a97'],27,36,63,17608067,4,0,1,1,13802
194f1a179b2ab5c5528cd952bc9bce787cd2e4c9,1,aBabiichuk,2014-03-26 14:35:08+02:00,['1aa731f83d8bd64596f835544534bc51350b6abe'],1,1,2,17608069,1,,0,,13802
6dcbb87333a4364b3d2a3b776bf22981faf826ad,0,Alex Antonenko,2014-03-26 15:28:55+02:00,['194f1a179b2ab5c5528cd952bc9bce787cd2e4c9'],4,4,8,17608077,1,1,1,0,13802
aa6769c06b60bc0b231cb08e099d86ed8579a6c3,1,Dmitry Sen,2014-03-26 15:56:43+02:00,['6dcbb87333a4364b3d2a3b776bf22981faf826ad'],1,31,32,17608109,3,1,1,1,13802
8e5c6be95e9a3e308f97cff74184fbfbac1afeb5,0,Andrew Onischuk,2014-03-26 07:05:50-07:00,['aa6769c06b60bc0b231cb08e099d86ed8579a6c3'],1,2,3,17608112,2,,,,13802
b5a072f3a724317e0ae8f4afe45c3f1c6053f2a9,1,Andrew Onischuk,2014-03-26 07:05:56-07:00,['8e5c6be95e9a3e308f97cff74184fbfbac1afeb5'],3,40,43,17608155,8,,,,13803
b0fc3ada9ce9ed15370b1f839af06593dee36227,0,Oleg Nechiporenko,2014-03-26 16:12:46+02:00,['b5a072f3a724317e0ae8f4afe45c3f1c6053f2a9'],9,102,111,17608266,2,1,1,0.666666667,13803
c2f3eb723a623d505a2df59a6eddc9ca85f71cb8,0,Andrew Onischuk,2014-03-26 07:12:59-07:00,['b0fc3ada9ce9ed15370b1f839af06593dee36227'],0,117,117,17608383,1,1,1,1,13804
1176ecfa3ab8f73e92529a121950d924518291d8,1,Vitaly Brodetskyi,2014-03-26 17:20:16+02:00,['c2f3eb723a623d505a2df59a6eddc9ca85f71cb8'],4,8,12,17608395,2,,,,13804
24639f05ae17a2ef10d1c7395200e3b8f8fab56b,0,Alex Antonenko,2014-03-26 19:04:15+02:00,['1176ecfa3ab8f73e92529a121950d924518291d8'],2,2,4,17608399,1,,,,13804
3898abd547b163013fe35bc0aa3d213dd2f9e02f,1,Andrew Onischuk,2014-03-26 10:14:58-07:00,['24639f05ae17a2ef10d1c7395200e3b8f8fab56b'],2,3,5,17608404,3,0,0,1,13804
7d5f2039852fd033b42a1214b1ecb4dd67dc6143,1,Mahadev Konar,2014-03-26 10:28:39-07:00,['3898abd547b163013fe35bc0aa3d213dd2f9e02f'],8,8,16,17608420,1,,,,13804
c3fb15c93fa1406ad75246f8609b22b5bb879da2,1,Siddharth Wagle,2014-03-26 10:37:19-07:00,['7d5f2039852fd033b42a1214b1ecb4dd67dc6143'],0,5,5,17608425,1,0,0,1,13804
b4a1179802498cc5e4ae0be17caa114abae29bac,0,Jaimin Jetly,2014-03-26 10:46:57-07:00,['c3fb15c93fa1406ad75246f8609b22b5bb879da2'],1,6,7,17608432,1,,,,13804
0c55fd391191d636a71d9ef462de7c5fb46680d5,0,Andrew Onischuk,2014-03-20 06:14:24-07:00,['b4a1179802498cc5e4ae0be17caa114abae29bac'],1893,0,1893,17610325,2,,,,13804
aebdadbac908b72002ad6eaf079d63e405032e1c,1,John Speidel,2014-03-26 14:32:49-04:00,['0c55fd391191d636a71d9ef462de7c5fb46680d5'],278,311,589,17610914,4,1,1,1,13804
a3d1d673200cc34e60ab9ea7e2a1ac584dd6d037,1,Siddharth Wagle,2014-03-26 15:16:55-07:00,['aebdadbac908b72002ad6eaf079d63e405032e1c'],12,19,31,17610945,2,0.375,0.375,1,13804
74ef96200a8b8ba1bc761d5ad7d561d35721cc4a,1,atkach,2014-03-27 14:08:14+02:00,['a3d1d673200cc34e60ab9ea7e2a1ac584dd6d037'],201,363,564,17611509,8,0.969230769,1,1,13804
786dd627148be2e3e3c89d6d46ec2ab917ba42fd,0,Dmitry Sen,2014-03-27 15:22:41+02:00,['74ef96200a8b8ba1bc761d5ad7d561d35721cc4a'],1,12,13,17611522,1,,,,13804
56b177608bfc4e96e02ce816e59886d2753204b0,1,Oleg Nechiporenko,2014-03-27 16:03:00+02:00,['786dd627148be2e3e3c89d6d46ec2ab917ba42fd'],9,5,14,17611536,1,0,0,0,13804
1eec850c76652921e66c0d3a5c042d1af142f7a5,1,Oleg Nechiporenko,2014-03-27 16:45:41+02:00,['56b177608bfc4e96e02ce816e59886d2753204b0'],7,19,26,17611562,1,1,1,1,13804
4be37e9b0a0c3d002c6fd24298a48c8f9b5bbda9,1,Aleksandr Kovalenko,2014-03-27 17:54:12+02:00,['1eec850c76652921e66c0d3a5c042d1af142f7a5'],21,42,63,17611625,2,0,0.03030303,1,13804
4eec338e30b93195eababfefb92de2163ddf3603,1,aBabiichuk,2014-03-27 17:57:59+02:00,['4be37e9b0a0c3d002c6fd24298a48c8f9b5bbda9'],23,23,46,17611671,23,,,,13804
6d865b76ec93983de1699f77738082837b08c4d9,1,atkach,2014-03-27 17:58:45+02:00,['4eec338e30b93195eababfefb92de2163ddf3603'],38,49,87,17611758,5,0,0,0,13804
5bf62189b8988bacecb9a6b21766d1b245796172,1,Oleg Nechiporenko,2014-03-27 18:09:09+02:00,['6d865b76ec93983de1699f77738082837b08c4d9'],20,8,28,17611786,2,0,0,0,13804
a50851967e95a7274f0364ccefde5cbca816235c,1,aBabiichuk,2014-03-27 18:11:20+02:00,['5bf62189b8988bacecb9a6b21766d1b245796172'],1,1,2,17611788,1,,,,13804
a4b1f2bad7e0131485f04827b4ebf2a438391767,1,Dmitry Sen,2014-03-27 18:27:34+02:00,['a50851967e95a7274f0364ccefde5cbca816235c'],0,12,12,17611800,1,,,,13804
a06bb70f9e0b7dde3da450322671aee3c96deed0,0,Alex Antonenko,2014-03-27 18:29:50+02:00,['a4b1f2bad7e0131485f04827b4ebf2a438391767'],1,1,2,17611802,1,,,,13804
be3e5c6d3f8688f9e329fb7bcc55267a1328ad57,1,Lisnichenko Dmitro,2014-03-27 18:32:44+02:00,['a06bb70f9e0b7dde3da450322671aee3c96deed0'],326,101,427,17612229,19,,,,13804
718567fc453cfa854c4cfb63c3b26d9a16b30d62,1,atkach,2014-03-27 18:48:46+02:00,['be3e5c6d3f8688f9e329fb7bcc55267a1328ad57'],1,8,9,17612238,2,,,,13804
12798c2c3580060e72bec4c47a6d030cbfc979cd,1,Alex Antonenko,2014-03-27 19:07:19+02:00,['718567fc453cfa854c4cfb63c3b26d9a16b30d62'],2,2,4,17612242,1,,,,13804
33871dddb9c1d44bcfa17e63a8350955b2a56335,1,Lisnichenko Dmitro,2014-03-27 19:42:07+02:00,['12798c2c3580060e72bec4c47a6d030cbfc979cd'],346,547,893,17613135,6,1,,,13806
1d1ac322534fec45b5bec615c2a12238ddf64d5a,1,Siddharth Wagle,2014-03-27 11:00:33-07:00,['33871dddb9c1d44bcfa17e63a8350955b2a56335'],52,282,334,17613469,10,0,0.673758865,0.914893617,13806
27e35262b60f66124f1d911e5de5240d86d2d924,0,Vitaly Brodetskyi,2014-03-27 20:19:51+02:00,['1d1ac322534fec45b5bec615c2a12238ddf64d5a'],2,22,24,17613493,2,0,1,1,13806
65106ab5ae7cb141012e321699a4be4f177ab576,0,Jaimin Jetly,2014-03-27 13:29:58-07:00,['27e35262b60f66124f1d911e5de5240d86d2d924'],1,1,2,17613495,1,,,,13806
c06183ba713b8c7c8c4dee858b66f3e633e8646d,1,Siddharth Wagle,2014-03-27 13:58:04-07:00,['65106ab5ae7cb141012e321699a4be4f177ab576'],6,6,12,17613507,1,,,,13806
5ef9adce2186ea676979c5b32f334d13a1e7ed03,1,Andrew Onischuk,2014-03-27 14:24:19-07:00,['c06183ba713b8c7c8c4dee858b66f3e633e8646d'],136,144,280,17613787,5,0,0,1,13807
d5306d309b9b5ccef5695b9469377f39a95941c4,1,Jaimin Jetly,2014-03-27 15:53:34-07:00,['5ef9adce2186ea676979c5b32f334d13a1e7ed03'],12,31,43,17613830,7,1,1,1,13807
f0ca5d1076e20ab1a491b9d654f43036b56dfda3,1,Xi Wang,2014-03-27 16:13:41-07:00,['d5306d309b9b5ccef5695b9469377f39a95941c4'],0,9,9,17613839,1,,,,13807
61f205906ad288fa181490136157da179419d018,1,Andrew Onischuk,2014-03-28 04:59:27-07:00,['f0ca5d1076e20ab1a491b9d654f43036b56dfda3'],3,3,6,17613845,1,,,,13807
e7e67085e168aadd0909d5f65872802508dc7dc2,0,Artem Baranchuk,2014-03-28 14:26:39+02:00,['61f205906ad288fa181490136157da179419d018'],31,116,147,17613992,2,0.484375,0.484375,0.9375,13807
c0fc9e7582a7295b3c3a1a6ee3e8ed150c8076ed,0,Oleg Nechiporenko,2014-03-28 14:49:45+02:00,['e7e67085e168aadd0909d5f65872802508dc7dc2'],0,2,2,17613994,2,0.5,1,1,13807
3a7ad3a6c6c918b1d665c62cd5154b27b1fb0d56,0,Alex Antonenko,2014-03-28 15:33:40+02:00,['c0fc9e7582a7295b3c3a1a6ee3e8ed150c8076ed'],11,25,36,17614030,3,1,1,1,13807
7f60c1c40c85337c51d863453a7e7e6dea416bb2,1,Alex Antonenko,2014-03-28 15:59:57+02:00,['3a7ad3a6c6c918b1d665c62cd5154b27b1fb0d56'],9,226,235,17614265,7,0.63963964,0.576576577,0.720720721,13807
3bc68f875f8e2b06a092a63271873f6c61a3b2a4,1,atkach,2014-03-28 16:46:20+02:00,['7f60c1c40c85337c51d863453a7e7e6dea416bb2'],109,110,219,17614484,5,0,0,0,13807
28b31ba020f70f0e4902e858ff0ac495b3f08b90,0,Aleksandr Kovalenko,2014-03-28 18:28:09+02:00,['3bc68f875f8e2b06a092a63271873f6c61a3b2a4'],4,42,46,17614530,4,1,1,1,13807
bdddb9bb0d2ba5420de644fe7418973e1d0f3d61,1,Vitaly Brodetskyi,2014-03-28 19:22:49+02:00,['28b31ba020f70f0e4902e858ff0ac495b3f08b90'],16,76,92,17614622,4,0,0,1,13807
aec2d18830953b7e05280a6fd45a642045ed44e9,1,Dmitry Sen,2014-03-29 00:23:05+02:00,['bdddb9bb0d2ba5420de644fe7418973e1d0f3d61'],23,252,275,17614897,7,0.246073298,0.937172775,1,13808
e6d490bfbd82b9f292ba746732c6d401b474c048,0,Jaimin Jetly,2014-03-28 15:36:23-07:00,['aec2d18830953b7e05280a6fd45a642045ed44e9'],4,2,6,17614903,2,,,,13808
d47bea19a2b5700ee208c9472be977dc82c9c2fe,1,Siddharth Wagle,2014-03-29 09:47:16-07:00,['e6d490bfbd82b9f292ba746732c6d401b474c048'],1,1,2,17614905,1,,,,13808
34b8056fde12ca182bb9e0d9c1b8ecccf8a93dec,0,Mahadev Konar,2014-03-29 14:20:50-07:00,['d47bea19a2b5700ee208c9472be977dc82c9c2fe'],2,26,28,17614933,2,1,1,1,13808
aaa5d2c32d7bf7799aeaf8c2312fecd7ad160f04,0,Jaimin Jetly,2014-03-29 14:37:34-07:00,['34b8056fde12ca182bb9e0d9c1b8ecccf8a93dec'],1,1,2,17614935,1,,,,13808
7c198ac3c847c876126158afafa5f46aef8e0392,1,tbeerbower,2014-03-30 17:09:12-04:00,['aaa5d2c32d7bf7799aeaf8c2312fecd7ad160f04'],498,2850,3348,17618283,38,0.752447552,0.836363636,0.966433566,13820
532fe097d9d18390ea20506087a513da9a08f3bf,1,Artem Baranchuk,2014-03-31 12:44:19+03:00,['7c198ac3c847c876126158afafa5f46aef8e0392'],18,18,36,17618319,1,,,,13820
ec0769e04f6072b138bd642e8302b80204188e36,1,aBabiichuk,2014-03-31 15:20:47+03:00,['532fe097d9d18390ea20506087a513da9a08f3bf'],5,5,10,17618329,2,,,,13820
8ad29b5aebb2f373fb4dd8299050a0a3a935db91,1,aBabiichuk,2014-03-31 16:01:55+03:00,['ec0769e04f6072b138bd642e8302b80204188e36'],2,2,4,17618333,2,,,,13820
1cb63dc2cb9555ed2470f23d2dc585fed8c7be96,1,John Speidel,2014-03-31 09:48:24-04:00,['8ad29b5aebb2f373fb4dd8299050a0a3a935db91'],46,66,112,17618445,2,1,1,1,13820
45bb146299990fa932d76c6524b3b3ad4a402af0,0,Vitaly Brodetskyi,2014-03-31 17:12:48+03:00,['1cb63dc2cb9555ed2470f23d2dc585fed8c7be96'],1,2,3,17618448,1,,,,13820
b5f48c752b3a7bad5bccb43fe7a36442aa55e2ca,0,Alex Antonenko,2014-03-31 17:37:24+03:00,['45bb146299990fa932d76c6524b3b3ad4a402af0'],0,2,2,17618450,1,1,1,0,13820
1067ae5c44d221fbc6af0c38257be7c4c6a9fe07,0,Alex Antonenko,2014-03-31 17:37:24+03:00,['b5f48c752b3a7bad5bccb43fe7a36442aa55e2ca'],0,1,1,17618451,1,1,1,1,13820
a42d8ca885a765ed72aa749774c6dd137d07dad7,1,aBabiichuk,2014-03-31 17:41:12+03:00,['1067ae5c44d221fbc6af0c38257be7c4c6a9fe07'],7,16,23,17618474,3,1,1,0.428571429,13820
b8f09dae68a2a08ce8d4e48c0fb2407fa4f9165c,0,Vitaly Brodetskyi,2014-03-31 17:45:05+03:00,['a42d8ca885a765ed72aa749774c6dd137d07dad7'],3,3,6,17618480,1,,,,13820
b1563db098b3876ecb7f43f29eff04ee7a40ce00,0,Lisnichenko Dmitro,2014-03-31 17:47:23+03:00,['b8f09dae68a2a08ce8d4e48c0fb2407fa4f9165c'],29,1,30,17618510,4,,,,13820
b8b21604a9624314d66e0def8632bbd1730d2df0,1,Alex Antonenko,2014-03-31 18:05:00+03:00,['b1563db098b3876ecb7f43f29eff04ee7a40ce00'],8,14,22,17618532,1,1,1,1,13820
3dd56eb44265e44620a1743cb16f876fa9680c02,1,atkach,2014-03-31 18:14:06+03:00,['b8b21604a9624314d66e0def8632bbd1730d2df0'],137,85,222,17618754,8,0,0,0,13820
b56019031443e174f0e09ec753259e48b48457b6,1,Andrew Onischuk,2014-03-31 08:23:30-07:00,['3dd56eb44265e44620a1743cb16f876fa9680c02'],1,515,516,17619270,6,0.359050445,1,1,13825
1ffff55939af573e3947e2d5e14fb796565cfd16,1,Lisnichenko Dmitro,2014-03-31 18:34:20+03:00,['b56019031443e174f0e09ec753259e48b48457b6'],0,11,11,17619281,2,,,,13825
ac875fcc5ca17aa40d6c04d1609ca77ea8ec8a85,1,Lisnichenko Dmitro,2014-03-31 19:36:07+03:00,['1ffff55939af573e3947e2d5e14fb796565cfd16'],266,266,532,17619813,1,0,0,0,13825
18d798bfebe0c4948269b76332ab0487ee2cdf99,0,Aleksandr Kovalenko,2014-03-31 19:41:13+03:00,['ac875fcc5ca17aa40d6c04d1609ca77ea8ec8a85'],15,7,22,17619835,3,0.125,1,0,13825
d4fa271d2116632d6a03366d80eb69195fcf24da,0,Aleksandr Kovalenko,2014-03-31 19:41:14+03:00,['18d798bfebe0c4948269b76332ab0487ee2cdf99'],7,18,25,17619860,3,,,,13825
85ecb9a48fb95d0910a4e1a10dedfbd6a0c2518b,0,Dmitry Sen,2014-03-31 22:42:07+03:00,['d4fa271d2116632d6a03366d80eb69195fcf24da'],8,22,30,17619890,5,,,,13825
b6064a7464c8c9ec4150dc8d449880264c77557a,0,Jaimin Jetly,2014-03-31 15:35:19-07:00,['85ecb9a48fb95d0910a4e1a10dedfbd6a0c2518b'],0,18,18,17619908,1,,,,13825
683753e2520f2854fba71e609bf967ff1c98dd6d,1,Aleksandr Kovalenko,2014-04-01 13:47:06+03:00,['b6064a7464c8c9ec4150dc8d449880264c77557a'],1,14,15,17619923,4,0,0,1,13825
18b68f0e83b1b47a720744eb0a1f909e266219ce,0,Oleg Nechiporenko,2014-04-01 16:12:14+03:00,['683753e2520f2854fba71e609bf967ff1c98dd6d'],1,1,2,17619925,1,,,,13825
762ead1b10af1f4aea0de53616341537a106c487,0,Aleksandr Kovalenko,2014-04-01 16:36:51+03:00,['18b68f0e83b1b47a720744eb0a1f909e266219ce'],2,2,4,17619929,1,,,,13825
278a18993380b9911166bb197868679a0d10a4e4,1,atkach,2014-04-01 17:10:36+03:00,['762ead1b10af1f4aea0de53616341537a106c487'],162,171,333,17620262,10,0,1,1,13825
848bda46b982be595a930431de9bdd47a35d3575,0,Lisnichenko Dmitro,2014-04-01 17:16:42+03:00,['278a18993380b9911166bb197868679a0d10a4e4'],2,2,4,17620266,2,,,,13825
0a702395e5a09743b14574247ba42092cdc4dc6f,1,Lisnichenko Dmitro,2014-04-01 17:19:51+03:00,['848bda46b982be595a930431de9bdd47a35d3575'],142,133,275,17620541,9,1,0.214285714,0,13825
0efe870dabb2760ce4acd69fdcd5c05e422dc928,0,atkach,2014-04-01 18:34:52+03:00,['0a702395e5a09743b14574247ba42092cdc4dc6f'],24,31,55,17620596,2,1,1,1,13825
8d2e94af8ee30984828e4cc39f45013a108e0958,1,Lisnichenko Dmitro,2014-04-01 18:49:06+03:00,['0efe870dabb2760ce4acd69fdcd5c05e422dc928'],1721,1992,3713,17624309,15,1,0.071887035,0,13827
90dee51790269b135247b28c94ffba9d4d4414ba,1,Andrew Onischuk,2014-04-01 11:44:07-07:00,['8d2e94af8ee30984828e4cc39f45013a108e0958'],2,154,156,17624465,4,0.347826087,1,1,13829
04ed90db03cc8211482c0c5875ae6e11451fbc77,1,Yusaku Sako,2014-04-01 13:09:00-07:00,['90dee51790269b135247b28c94ffba9d4d4414ba'],2,29,31,17624496,2,,,,13829
945bb7ac12e336763e52225c06b217f473d2f941,1,Xi Wang,2014-04-01 13:41:37-07:00,['04ed90db03cc8211482c0c5875ae6e11451fbc77'],62,160,222,17624718,12,0,0.493506494,1,13829
2511b0923b7735aba44bb66e9aa9d312e48b0983,0,Yusaku Sako,2014-04-01 17:54:17-07:00,['945bb7ac12e336763e52225c06b217f473d2f941'],25,0,25,17624743,1,,,,13829
6abe91268eabd641c162ab83ae9deede737c0e6c,1,Jaimin Jetly,2014-04-01 22:27:57-07:00,['2511b0923b7735aba44bb66e9aa9d312e48b0983'],3,2158,2161,17626904,118,,,,13829
90c64d945a4815afb7dfb9577a66ec1c3190c963,0,Oleg Nechiporenko,2014-04-02 14:54:27+03:00,['6abe91268eabd641c162ab83ae9deede737c0e6c'],0,4,4,17626908,1,1,1,1,13829
25b4eb51c52b96896f19b552fa47b98b3b59404b,1,Oleg Nechiporenko,2014-04-02 15:39:26+03:00,['90c64d945a4815afb7dfb9577a66ec1c3190c963'],4,4,8,17626916,3,,,,13829
7910b44a161dfaf84f109f3373f3bdddccdd0cb7,1,Oleg Nechiporenko,2014-04-02 15:51:17+03:00,['25b4eb51c52b96896f19b552fa47b98b3b59404b'],15,4,19,17626935,2,0.066666667,0,0,13829
53c4050553123d2f54ab6c3730083b29dfc14dbd,1,Artem Baranchuk,2014-04-02 17:01:30+03:00,['7910b44a161dfaf84f109f3373f3bdddccdd0cb7'],115,7113,7228,17634163,130,1,1,1,13921
aae007837e7bbc5d998d4e1f40959dab59710cd1,0,Artem Baranchuk,2014-04-02 17:05:39+03:00,['53c4050553123d2f54ab6c3730083b29dfc14dbd'],3692,3691,7383,17641546,1,,,,13921
8faae789ecefd5cb222ae2f113a926f8566d23b5,1,Alex Antonenko,2014-04-02 17:51:49+03:00,['aae007837e7bbc5d998d4e1f40959dab59710cd1'],12,21,33,17641579,3,0,0,0,13921
86b95b03c9db174f6081f08b7aa2aa3dd95a6267,1,Yusaku Sako,2014-04-02 08:35:34-07:00,['8faae789ecefd5cb222ae2f113a926f8566d23b5'],3,45,48,17641627,2,,,,13921
f4f30dd693d1e8d58c7abc657cbef4580fc6b05c,0,Alex Antonenko,2014-04-02 18:47:53+03:00,['86b95b03c9db174f6081f08b7aa2aa3dd95a6267'],1,2,3,17641630,1,1,1,1,13921
f9db0c6363a0c415df6e62224af58542d4eeb2a1,1,Andrew Onischuk,2014-04-02 08:50:47-07:00,['f4f30dd693d1e8d58c7abc657cbef4580fc6b05c'],3,14,17,17641647,1,0,0,1,13921
71e099d292c56df1840539c71b3d879928095048,1,Andrew Onischuk,2014-04-02 08:52:38-07:00,['f9db0c6363a0c415df6e62224af58542d4eeb2a1'],13,22,35,17641682,5,1,1,0.8,13921
cc048cf0f0d4e6282e31968e87d0ec8b8dedbac1,1,tbeerbower,2014-04-02 12:01:52-04:00,['71e099d292c56df1840539c71b3d879928095048'],7,94,101,17641783,2,0,1,1,13921
08206fb2a073886fded9f0adb5273f4e88eb0767,0,Alex Antonenko,2014-04-02 19:04:58+03:00,['cc048cf0f0d4e6282e31968e87d0ec8b8dedbac1'],0,9,9,17641792,1,1,1,1,13921
a63c55ed94b0252406e0f6d79b8036e98ca7a147,0,Aleksandr Kovalenko,2014-04-02 19:23:04+03:00,['08206fb2a073886fded9f0adb5273f4e88eb0767'],45,83,128,17641920,5,1,1,1,13921
96b738dea48c7fd016e28933a4bad3b774c1c2b6,0,Artem Baranchuk,2014-04-02 20:19:40+03:00,['a63c55ed94b0252406e0f6d79b8036e98ca7a147'],2,2,4,17641924,1,,,,13921
d7605024ea0c1f1343ab8822539da63a2eb7d150,1,Alex Antonenko,2014-04-02 21:21:06+03:00,['96b738dea48c7fd016e28933a4bad3b774c1c2b6'],0,30,30,17641954,1,,,,13921
e849955ac5c127774c0a81a6e72a142f25852717,1,Yusaku Sako,2014-04-02 11:52:41-07:00,['d7605024ea0c1f1343ab8822539da63a2eb7d150'],4,14,18,17641972,2,1,1,1,13921
f0603eb16ed931383d43a95e03042b710aa74ab9,0,Dmitry Sen,2014-04-02 22:36:00+03:00,['e849955ac5c127774c0a81a6e72a142f25852717'],250,0,250,17642222,2,0.702439024,0.058536585,0,13921
c5ab9e7b81ae271144c401dd642dfec35ddfd92c,1,Yusaku Sako,2014-04-02 14:14:45-07:00,['f0603eb16ed931383d43a95e03042b710aa74ab9'],3,3,6,17642228,1,,,,13921
af7e32ed1317ca8317ea5fa92c21fa9903e9dcd5,1,Jaimin Jetly,2014-04-02 15:25:16-07:00,['c5ab9e7b81ae271144c401dd642dfec35ddfd92c'],2,66,68,17642296,8,,,,13921
59278a95f98087a465b040cc4892d123dfd5ccc7,0,Alex Antonenko,2014-04-03 01:56:57+03:00,['af7e32ed1317ca8317ea5fa92c21fa9903e9dcd5'],1,0,1,17642297,1,,,,13921
ddf5ce89e1eabfb933ec1b80f72700884982cbda,1,Yusaku Sako,2014-04-02 16:17:49-07:00,['59278a95f98087a465b040cc4892d123dfd5ccc7'],22,8,30,17642327,5,,,,13921
8b763e174826bc6479973ca3b844aa504d942c8d,0,Mahadev Konar,2014-04-02 16:21:52-07:00,['ddf5ce89e1eabfb933ec1b80f72700884982cbda'],1,8,9,17642336,1,0,1,1,13921
9a322e1e659ec84ef523c56c598b6a3a079a2722,1,tbeerbower,2014-04-02 19:37:38-04:00,['8b763e174826bc6479973ca3b844aa504d942c8d'],24,251,275,17642611,6,0.295918367,1,1,13923
9764cb95bcd9d66be457a82453ca64583a7c5ee0,0,Siddharth Wagle,2014-04-02 17:03:59-07:00,['9a322e1e659ec84ef523c56c598b6a3a079a2722'],87,1,88,17642699,5,0.85,0.7,0,13923
28ae1edd3fe99559ba1b0846a39a70b69f62778c,0,Alex Antonenko,2014-04-03 03:25:25+03:00,['9764cb95bcd9d66be457a82453ca64583a7c5ee0'],7,4,11,17642710,1,0,0,1,13923
2e7cb594f7bedd350a10d3d0ccdd899371d1e509,1,atkach,2014-04-03 13:57:15+03:00,['28ae1edd3fe99559ba1b0846a39a70b69f62778c'],3,471,474,17643184,5,0.767123288,1,1,13924
99dbf3dbcc5e275bf4b822ef96482c1b67190761,1,Siddharth Wagle,2014-04-03 11:20:50-07:00,['2e7cb594f7bedd350a10d3d0ccdd899371d1e509'],17,17,34,17643218,1,1,1,0,13924
bb4a19672e0e74a2126e3edf9f4d9ab9e480b433,1,Nate Cole,2014-04-03 17:05:49-04:00,['99dbf3dbcc5e275bf4b822ef96482c1b67190761'],7,98,105,17643323,6,0.354166667,0.8125,1,13924
979cd9eac08a6e67e500a5d8798a50ba7a3bc27b,1,Mahadev Konar,2014-04-03 14:28:20-07:00,['bb4a19672e0e74a2126e3edf9f4d9ab9e480b433'],0,37,37,17643360,2,,,,13924
c98e67a7d258ba16414c4cf2626c4780300648c7,0,Alex Antonenko,2014-04-04 00:31:36+03:00,['979cd9eac08a6e67e500a5d8798a50ba7a3bc27b'],4,5,9,17643369,1,0,0,1,13924
4ba9f1e814ec4d58e9879df8b3ea125aca425e31,0,Alex Antonenko,2014-04-04 00:40:55+03:00,['c98e67a7d258ba16414c4cf2626c4780300648c7'],4,4,8,17643377,2,,,,13924
e123825d22a9ba160998251b462119c4d9682f85,1,Xi Wang,2014-04-03 14:54:59-07:00,['4ba9f1e814ec4d58e9879df8b3ea125aca425e31'],14,92,106,17643483,9,1,1,1,13924
697a97b3f5fea1703ee57091eb69891303766f72,1,Srimanth Gunturi,2014-04-03 15:48:22-07:00,['e123825d22a9ba160998251b462119c4d9682f85'],8,17,25,17643508,2,,,,13924
233dd0124ac996e1a32095ca366e2970389bfdab,0,Dmitry Sen,2014-04-04 12:55:37+03:00,['697a97b3f5fea1703ee57091eb69891303766f72'],4,7,11,17643519,1,,,,13924
9451ee052b9b0a060432ce76ab30d72afec41790,1,Dmitry Sen,2014-04-04 12:56:37+03:00,['233dd0124ac996e1a32095ca366e2970389bfdab'],151,246,397,17643916,21,0,1,0,13925
14b44ee20a3fb741f7a935409f338f0f31c716bd,0,Aleksandr Kovalenko,2014-04-04 13:09:28+03:00,['9451ee052b9b0a060432ce76ab30d72afec41790'],1,3,4,17643920,1,1,1,1,13925
2ab58cfb59475502dff4d7f097569094fe74236e,1,aBabiichuk,2014-04-04 13:35:48+03:00,['14b44ee20a3fb741f7a935409f338f0f31c716bd'],0,3,3,17643923,1,1,1,1,13925
994631c3b9054830b5a0d69fe54298fd6f7c016b,1,atkach,2014-04-04 16:11:40+03:00,['2ab58cfb59475502dff4d7f097569094fe74236e'],7,696,703,17644626,10,0.566860465,1,1,13930
ae08e109b0edb0c11292b048288e856c1235874e,0,Vitaly Brodetskyi,2014-04-04 17:21:24+03:00,['994631c3b9054830b5a0d69fe54298fd6f7c016b'],343,41,384,17645010,13,1,0.711610487,0,13930
f96d22e0c27d1547f485b5b52998436d44ac8a75,1,Vitaly Brodetskyi,2014-04-04 17:29:19+03:00,['ae08e109b0edb0c11292b048288e856c1235874e'],109,41,150,17645160,6,1,0,0,13930
ff43fe25a0a27f502a02076200303b0a14bb0f17,1,Myroslav Papirkovskyy,2014-04-04 18:10:44+03:00,['f96d22e0c27d1547f485b5b52998436d44ac8a75'],9,45,54,17645214,1,0,0,1,13930
74d037bdc96712db6d9bfe217c79094615a24a83,1,Myroslav Papirkovskyy,2014-04-04 18:10:44+03:00,['ff43fe25a0a27f502a02076200303b0a14bb0f17'],40,78,118,17645332,2,0.928571429,0,0.214285714,13930
c1441e05fe2432cb067b9ea882202d620cba6603,1,Vitaly Brodetskyi,2014-04-04 18:20:33+03:00,['74d037bdc96712db6d9bfe217c79094615a24a83'],41,343,384,17645716,13,0,0.288389513,1,13930
0ebb16dca92c93bf5f6f068eec3b1cf836b3a192,1,aBabiichuk,2014-04-04 18:26:16+03:00,['c1441e05fe2432cb067b9ea882202d620cba6603'],1,91,92,17645808,9,1,1,1,13932
ad873dc39715a5a1c7db1071b32f3fc390171475,1,Lisnichenko Dmitro,2014-04-04 18:40:50+03:00,['0ebb16dca92c93bf5f6f068eec3b1cf836b3a192'],2,2,4,17645812,2,,,,13932
7df81fabff07b8cb516085a9b03c9f3667509fe1,0,Mahadev Konar,2014-04-04 09:11:27-07:00,['ad873dc39715a5a1c7db1071b32f3fc390171475'],0,1,1,17645813,1,,,,13932
34476f2d44ad72752eb89de4ef1511f756eeda29,1,Dmitry Sen,2014-04-04 19:38:46+03:00,['7df81fabff07b8cb516085a9b03c9f3667509fe1'],3,53,56,17645869,2,0,0.972222222,1,13932
82ebd6d5aeae82326d9c6f9ff26aa880ace8ac03,0,Andrew Onischuk,2014-04-04 10:36:52-07:00,['34476f2d44ad72752eb89de4ef1511f756eeda29'],1,1,2,17645871,1,,,,13932
b6c5f57b815b1c0c8810cb5487931d788a8e7534,1,Lisnichenko Dmitro,2014-04-04 20:55:14+03:00,['82ebd6d5aeae82326d9c6f9ff26aa880ace8ac03'],0,9,9,17645880,3,0,0.666666667,1,13932
ad88bd14f9f2dc5d68164e1398faff34af7dd75b,0,Siddharth Wagle,2014-04-04 11:05:58-07:00,['b6c5f57b815b1c0c8810cb5487931d788a8e7534'],9,9,18,17645898,9,,,,13932
78fc98468e53bc99ded9faf0794106fa1da8d31c,1,Lisnichenko Dmitro,2014-04-04 21:17:21+03:00,['ad88bd14f9f2dc5d68164e1398faff34af7dd75b'],2,4,6,17645904,2,,,,13932
82e34855addf8f940a647271e3781c6cd0522172,1,Andrew Onischuk,2014-03-20 06:09:47-07:00,['78fc98468e53bc99ded9faf0794106fa1da8d31c'],14,82,96,17646000,16,0.029411765,1,1,13932
e63a05a85191aa33eb024089518614afccb9d023,1,Dmitry Sen,2014-04-04 22:12:31+03:00,['82e34855addf8f940a647271e3781c6cd0522172'],11,32,43,17646043,5,0,1,1,13932
c21459200eb16efdff5a253d31bc7375791b4042,1,Dmitry Sen,2014-04-04 22:39:42+03:00,['e63a05a85191aa33eb024089518614afccb9d023'],5,16,21,17646064,2,1,1,1,13932
be82b987c8670691ec12baf9426f93a098efc534,0,Alex Antonenko,2014-04-04 22:57:53+03:00,['c21459200eb16efdff5a253d31bc7375791b4042'],5,3,8,17646072,2,0,0,0,13932
14a44ea8ace8ef0e2c9faf55909c333fe0832700,0,Lisnichenko Dmitro,2014-04-04 23:28:49+03:00,['be82b987c8670691ec12baf9426f93a098efc534'],1,15,16,17646088,1,0.1,1,1,13932
1212459212c88757aaf0641581b6e7cce2dbf8c9,0,Srimanth Gunturi,2014-04-04 16:22:37-07:00,['14a44ea8ace8ef0e2c9faf55909c333fe0832700'],2,2,4,17646092,2,,,,13932
5bc56f364296097717544f31727027ccae429c4a,1,Jaimin Jetly,2014-04-04 17:19:31-07:00,['1212459212c88757aaf0641581b6e7cce2dbf8c9'],5,19,24,17646116,2,0.428571429,0.428571429,1,13932
f2078a0571ccad8bed29f3886e5aa57457c3b755,1,Siddharth Wagle,2014-04-04 17:23:37-07:00,['5bc56f364296097717544f31727027ccae429c4a'],7,28,35,17646151,2,0,0.9375,0.9375,13932
c1ec6735640dce734736d1431a2c7b6d054d1408,1,Siddharth Wagle,2014-04-04 17:31:44-07:00,['f2078a0571ccad8bed29f3886e5aa57457c3b755'],10,10,20,17646171,10,,,,13932
e8f2d1e1cc43173082145b3c4ca6bc3e4feb24a2,1,Jaimin Jetly,2014-04-04 18:12:19-07:00,['c1ec6735640dce734736d1431a2c7b6d054d1408'],0,80,80,17646251,1,,,,13932
494d647293c8b49ea652bf11743bed5fbfb76304,1,Yusaku Sako,2014-04-04 18:15:28-07:00,['e8f2d1e1cc43173082145b3c4ca6bc3e4feb24a2'],33,113,146,17646397,5,0,1,1,13932
ea40f027f2c47e150a5dc0e48d72bfeecdf507d6,0,Yusaku Sako,2014-04-05 16:40:12-07:00,['494d647293c8b49ea652bf11743bed5fbfb76304'],15,14,29,17646426,1,0,0,0,13932
929a0ddf95ffe070258162e624a41a4ca13b4850,1,Mahadev Konar,2014-04-06 14:05:09-07:00,['ea40f027f2c47e150a5dc0e48d72bfeecdf507d6'],14,278,292,17646718,17,0,0.163636364,1,13932
e1ac7e2370438737ca7edfca4de5c58a5c79c6d6,1,Dmitry Sen,2014-04-07 00:08:45+03:00,['929a0ddf95ffe070258162e624a41a4ca13b4850'],10,10,20,17646738,6,,,,13932
8ff1e60f186914c042fb721c627d98979e890e84,1,Dmitry Sen,2014-04-07 00:10:30+03:00,['e1ac7e2370438737ca7edfca4de5c58a5c79c6d6'],7,22,29,17646767,5,,,,13932
e2b0e2ae705844ea00397ac77ab31317a7d95e32,1,Oleg Nechiporenko,2014-04-07 16:22:03+03:00,['8ff1e60f186914c042fb721c627d98979e890e84'],98,280,378,17647145,7,0,1,1,13933
9c7dc7785e7a13f2c7bf47f535ad5689cdbf8af7,1,aBabiichuk,2014-04-07 19:01:54+03:00,['e2b0e2ae705844ea00397ac77ab31317a7d95e32'],30,86,116,17647261,8,0.976744186,1,1,13933
7ef2daf6bc310b111a0434673fabb77734a9cb77,1,Vitaly Brodetskyi,2014-04-07 19:38:59+03:00,['9c7dc7785e7a13f2c7bf47f535ad5689cdbf8af7'],16,16,32,17647293,10,,,,13933
90973d3d0689910eb615aa033134ef757fea6acc,1,Aleksandr Kovalenko,2014-04-07 21:05:59+03:00,['7ef2daf6bc310b111a0434673fabb77734a9cb77'],3,40,43,17647336,6,0,0,0,13933
53e0f8da2912622d8d8426da59d89182c2dcfcfc,1,Aleksandr Kovalenko,2014-04-07 21:08:37+03:00,['90973d3d0689910eb615aa033134ef757fea6acc'],2,40,42,17647378,3,0.692307692,0.692307692,1,13933
eab916dd2d6eafe37dcc4f5dd4f987945f3bcf11,1,Siddharth Wagle,2014-04-07 11:28:51-07:00,['53e0f8da2912622d8d8426da59d89182c2dcfcfc'],1,3,4,17647382,1,0,1,0,13933
322d10de9265e1d39b7e86d5fb6f507c8145c51f,1,Dmitry Sen,2014-04-07 22:38:45+03:00,['eab916dd2d6eafe37dcc4f5dd4f987945f3bcf11'],2,15,17,17647399,3,0,1,1,13933
778a3728f3eaf68df964fb09ca4f331179c155ca,1,Myroslav Papirkovskyy,2014-04-07 22:58:57+03:00,['322d10de9265e1d39b7e86d5fb6f507c8145c51f'],16,71,87,17647486,12,0.21875,1,0.90625,13933
fab325cc7e3edf750be674806cb0931c85740d11,0,Nate Cole,2014-04-07 16:16:40-04:00,['778a3728f3eaf68df964fb09ca4f331179c155ca'],6,1,7,17647493,2,,,,13933
fa2de3f617940db76b01432ccc0ad3c1d3c0730e,0,Artem Baranchuk,2014-04-07 23:43:46+03:00,['fab325cc7e3edf750be674806cb0931c85740d11'],1338,1343,2681,17650174,1,,,,13933
4a4543ad51d809906d5f524861f81c140e3a4e09,1,Nate Cole,2014-04-07 17:59:22-04:00,['fa2de3f617940db76b01432ccc0ad3c1d3c0730e'],2,2,4,17650178,1,0,0,1,13933
7d98fc56be0c08baffa6460401f07ca4c3924e4d,0,tbeerbower,2014-04-07 19:13:08-04:00,['4a4543ad51d809906d5f524861f81c140e3a4e09'],13,6,19,17650197,1,,,,13933
fa47bc20c9fe698d178d52434a22f8737753fb60,0,Yusaku Sako,2014-04-07 16:57:18-07:00,['7d98fc56be0c08baffa6460401f07ca4c3924e4d'],1,6,7,17650204,1,1,1,1,13933
b1eabddf9415ce1b11ee2e3e7f60472daaca9a9c,0,Yusaku Sako,2014-04-07 16:57:18-07:00,['fa47bc20c9fe698d178d52434a22f8737753fb60'],3,3,6,17650210,1,,,,13933
72235ffe7ad37ffd80be63e9267b75f673b9aaa6,0,Jaimin Jetly,2014-04-07 17:59:44-07:00,['b1eabddf9415ce1b11ee2e3e7f60472daaca9a9c'],8,0,8,17650218,1,,,,13933
3d97d7d136f9e9b3809eaf3dff3aaf1d476f837e,1,Mahadev Konar,2014-04-07 20:19:35-07:00,['72235ffe7ad37ffd80be63e9267b75f673b9aaa6'],18,41,59,17650277,2,0,1,1,13933
cb2ef7c21c5b57596f0bb90375937d4fc286fb6e,1,aBabiichuk,2014-04-08 16:21:41+03:00,['3d97d7d136f9e9b3809eaf3dff3aaf1d476f837e'],2,33,35,17650312,3,1,1,1,13933
b6ef1f15b3d5f4bc200d3b824ca25947c7099d82,0,Alex Antonenko,2014-04-08 16:48:22+03:00,['cb2ef7c21c5b57596f0bb90375937d4fc286fb6e'],2,7,9,17650321,1,1,1,0.6,13933
de1a98410b60c65922e6221fa6c3a304217cd3f1,1,Oleg Nechiporenko,2014-04-08 16:54:18+03:00,['b6ef1f15b3d5f4bc200d3b824ca25947c7099d82'],514,1129,1643,17651964,16,0.62585034,1,1,13935
06c56b11da7bc83068b4272d8b35a8e7a3316102,0,Alex Antonenko,2014-04-08 17:01:42+03:00,['de1a98410b60c65922e6221fa6c3a304217cd3f1'],1,1,2,17651966,1,,,,13935
26939926dd57743788f5670a459d7c298cfcafce,0,Alex Antonenko,2014-04-08 17:21:31+03:00,['06c56b11da7bc83068b4272d8b35a8e7a3316102'],7,3,10,17651976,2,,,,13935
94e505fc818bb2ce585c7c960af29d36355d2fb7,0,Srimanth Gunturi,2014-04-08 10:22:23-07:00,['26939926dd57743788f5670a459d7c298cfcafce'],1,1,2,17651978,1,,,,13935
c39fcb30fb4646e43283fb6993f6923e3766827d,0,Srimanth Gunturi,2014-04-08 11:05:30-07:00,['94e505fc818bb2ce585c7c960af29d36355d2fb7'],33,46,79,17652057,2,0,0,0,13935
01bd864f1cbe8f497e309469f3ec776419b98269,1,Andrew Onischuk,2014-04-08 12:12:40-07:00,['c39fcb30fb4646e43283fb6993f6923e3766827d'],1144,364,1508,17653565,78,1,0.473684211,0,13935
ebd07ec1b6c038b915144a4792593df07a852b91,0,Yusaku Sako,2014-04-08 16:18:45-07:00,['01bd864f1cbe8f497e309469f3ec776419b98269'],19,37,56,17653621,4,,,,13935
77c8f1ff73c57aa52f5da5d40d586196a169912c,0,Srimanth Gunturi,2014-04-08 18:45:47-07:00,['ebd07ec1b6c038b915144a4792593df07a852b91'],1,1,2,17653623,1,,,,13935
29e61ae9cf0b1c7a75fda592f81e6244274a0d84,1,Jaimin Jetly,2014-04-08 19:44:40-07:00,['77c8f1ff73c57aa52f5da5d40d586196a169912c'],786,1240,2026,17655649,28,1,0.967741935,1,13939
eb6ed77ce6a88ffb5b705428de890f6a17538a8d,1,aBabiichuk,2014-04-09 14:05:55+03:00,['29e61ae9cf0b1c7a75fda592f81e6244274a0d84'],837,420,1257,17656906,30,0.8,0.444444444,0,13944
0b641b8d73a0ad63db7d8d3382d22d1393e9ac1d,1,Andrew Onischuk,2014-04-09 04:11:49-07:00,['eb6ed77ce6a88ffb5b705428de890f6a17538a8d'],3,25,28,17656934,2,0,1,1,13944
88acfa0c93f494a092bbcefc768fa963a495413c,1,Oleg Nechiporenko,2014-04-09 14:40:18+03:00,['0b641b8d73a0ad63db7d8d3382d22d1393e9ac1d'],129,780,909,17657843,12,1,1,1,13945
a60d8608bc45d360115894779a4962b3f75ab22a,1,Andrew Onischuk,2014-04-09 04:43:57-07:00,['88acfa0c93f494a092bbcefc768fa963a495413c'],1,1,2,17657845,1,,,,13945
4b962fabc8b141fa6805aae8fd8865f3dcd3493e,1,atkach,2014-04-09 15:32:30+03:00,['a60d8608bc45d360115894779a4962b3f75ab22a'],47,442,489,17658334,7,0.441935484,1,1,13947
3ed1b415bc06435137147ac6b329042a70813903,0,atkach,2014-04-09 15:49:42+03:00,['4b962fabc8b141fa6805aae8fd8865f3dcd3493e'],1,1,2,17658336,1,,,,13947
3971bd139f243b934df5626d855c9e03918c5338,1,tbeerbower,2014-04-09 09:54:28-04:00,['3ed1b415bc06435137147ac6b329042a70813903'],3,750,753,17659089,16,0.710144928,0.847826087,0.898550725,13958
7d6acbb914e962f833383a8e4a6dfa273f4df792,1,Andrew Onischuk,2014-04-09 07:33:50-07:00,['3971bd139f243b934df5626d855c9e03918c5338'],21,18,39,17659128,1,1,0,0,13958
ef4f7720d2ea09c58c067a00d4f44bdb7fd26136,1,aBabiichuk,2014-04-09 18:11:22+03:00,['7d6acbb914e962f833383a8e4a6dfa273f4df792'],19,3,22,17659150,2,,,,13958
89b64a03f3a73f587c2c2cf2f5f109719de7803b,0,Aleksandr Kovalenko,2014-04-09 18:19:52+03:00,['ef4f7720d2ea09c58c067a00d4f44bdb7fd26136'],21,18,39,17659189,3,0,0,0,13958
386199a713e8fe65438be26405e952d020e28ac8,1,Nate Cole,2014-04-09 11:32:36-04:00,['89b64a03f3a73f587c2c2cf2f5f109719de7803b'],195,679,874,17660063,38,0.350282486,0.463276836,1,13967
343d78c65b792a4793bd1c1679817a3b24b1d628,1,Nate Cole,2014-04-09 12:01:48-04:00,['386199a713e8fe65438be26405e952d020e28ac8'],2,602,604,17660667,4,0,0.333333333,1,13968
81a0305dfd2f92051c83ed200b955eb2dad1ca36,1,Vitaly Brodetskyi,2014-04-09 20:27:04+03:00,['343d78c65b792a4793bd1c1679817a3b24b1d628'],5,10,15,17660682,3,0,0,1,13968
8a79d247efa83df9d0ea90c1a5652b5a9f592d42,1,Alex Antonenko,2014-04-09 20:28:15+03:00,['81a0305dfd2f92051c83ed200b955eb2dad1ca36'],5,196,201,17660883,4,0,1,1,13970
7fd838d1ad4eab6ad61a94e737a691be39678ad4,0,Siddharth Wagle,2014-04-09 11:22:49-07:00,['8a79d247efa83df9d0ea90c1a5652b5a9f592d42'],1,26,27,17660910,2,1,1,0,13970
c1ecb28b75a58bad886c3f34c2ac2b0001fb06c8,0,Srimanth Gunturi,2014-04-09 12:19:07-07:00,['7fd838d1ad4eab6ad61a94e737a691be39678ad4'],1,1,2,17660912,1,,,,13970
1daffd8d8324eeb3652bc7a7a2a602603ffae072,0,Mahadev Konar,2014-04-09 12:56:48-07:00,['c1ecb28b75a58bad886c3f34c2ac2b0001fb06c8'],1,1,2,17660914,1,,,,13970
47626bd65e5ccc5442848497c6f5dda4d547818d,1,Mahadev Konar,2014-04-09 16:13:58-07:00,['1daffd8d8324eeb3652bc7a7a2a602603ffae072'],0,5043,5043,17665957,40,0.304068522,0.897216274,0.847965739,14009
02bea739bcc217980f9cb793b74ca0efd81b6b75,0,Mahadev Konar,2014-04-09 16:20:17-07:00,['47626bd65e5ccc5442848497c6f5dda4d547818d'],10,11,21,17665978,2,0,0,0,14009
59630d6ab25d0c83bb2db3c898639147b2ce9778,0,Mahadev Konar,2014-04-09 16:32:21-07:00,['02bea739bcc217980f9cb793b74ca0efd81b6b75'],1,1,2,17665980,1,,,,14009
8fa25781dbc2aff1314470722ec8b0457a951139,1,Aleksandr Kovalenko,2014-04-10 13:56:22+03:00,['59630d6ab25d0c83bb2db3c898639147b2ce9778'],4,206,210,17666190,4,0.474452555,0.627737226,1,14010
ec156a36741d9eaa59f2b388e49aae5b1a842f3f,0,aBabiichuk,2014-04-10 14:46:53+03:00,['8fa25781dbc2aff1314470722ec8b0457a951139'],3,3,6,17666196,1,,,,14010
156b98e4cd4cc61e909407075650e315f25dfeb8,0,aBabiichuk,2014-04-10 14:47:31+03:00,['ec156a36741d9eaa59f2b388e49aae5b1a842f3f'],1,2,3,17666199,1,1,1,1,14010
526a16bc36d74a56c9818451bcbedddf03567fac,0,Myroslav Papirkovskyy,2014-04-10 16:03:53+03:00,['156b98e4cd4cc61e909407075650e315f25dfeb8'],4,4,8,17666207,3,,,,14010
f71d6b92366854fca0b90d6fdbd2c6bbfeeb4092,1,Oleg Nechiporenko,2014-04-10 16:57:11+03:00,['526a16bc36d74a56c9818451bcbedddf03567fac'],84,7894,7978,17674185,6,0.34971335,0.738411138,0.829320229,14011
cc92b610264bfca23bbdd9730a4972ccb1848b70,1,atkach,2014-04-10 16:59:27+03:00,['f71d6b92366854fca0b90d6fdbd2c6bbfeeb4092'],169,1079,1248,17675433,6,0.345415778,1,1,14011
24cbae554e337d4e30bd3322e64560a0f64fa463,1,Vitaly Brodetskyi,2014-04-10 18:14:59+03:00,['cc92b610264bfca23bbdd9730a4972ccb1848b70'],3,3,6,17675439,1,,,,14011
1c056ac1d134403d1dd2046373689d1672a88ceb,0,Alex Antonenko,2014-04-10 18:45:29+03:00,['24cbae554e337d4e30bd3322e64560a0f64fa463'],1,0,1,17675440,1,0,0,0,14011
f0c0c2ef3ac8ac69a6f13984d9b21ff88262b9ad,0,Lisnichenko Dmitro,2014-04-10 21:05:39+03:00,['1c056ac1d134403d1dd2046373689d1672a88ceb'],5,14,19,17675459,2,0,1,0,14011
60dc78f95dd2dbcc7de4ad69e0b305b63acab076,1,Lisnichenko Dmitro,2014-04-10 21:45:50+03:00,['f0c0c2ef3ac8ac69a6f13984d9b21ff88262b9ad'],13,48,61,17675520,8,,,,14011
e69c9a3c7af48019eb3bfee58cc7090254ab9c16,0,Artem Baranchuk,2014-04-10 22:29:28+03:00,['60dc78f95dd2dbcc7de4ad69e0b305b63acab076'],0,2,2,17675522,2,0,0,1,14011
79165d6850ee3621be49d1e9a76fbb39d2db70d2,0,Jaimin Jetly,2014-04-10 14:36:29-07:00,['e69c9a3c7af48019eb3bfee58cc7090254ab9c16'],79,0,79,17675601,1,,,,14011
12ba97fd3c7552d49130ca7cb405c890980e087a,1,Srimanth Gunturi,2014-04-10 15:40:49-07:00,['79165d6850ee3621be49d1e9a76fbb39d2db70d2'],0,96,96,17675697,4,0.301369863,1,1,14011
f62f57a15ee479b7af554867c4ba29e828de324d,1,Sumit Mohanty,2014-04-10 15:54:18-07:00,['12ba97fd3c7552d49130ca7cb405c890980e087a'],13,106,119,17675816,10,0,1,1,14012
e6e4b5bcbe276f47931af7dbc907dcbd2b605e51,1,Sumit Mohanty,2014-04-10 15:54:30-07:00,['f62f57a15ee479b7af554867c4ba29e828de324d'],2,4,6,17675822,2,0,0,1,14012
571e76213a3a612db60301e3f30c53cf9e423930,0,Jaimin Jetly,2014-04-10 16:54:06-07:00,['e6e4b5bcbe276f47931af7dbc907dcbd2b605e51'],2,2,4,17675826,2,,,,14012
93dbf2ba71837db9323b1636515a581be1e5a06a,1,Yusaku Sako,2014-04-10 17:07:21-07:00,['571e76213a3a612db60301e3f30c53cf9e423930'],0,16,16,17675842,2,,,,14012
2ada153e0675d8511d73244182b908653e5b08f5,0,Srimanth Gunturi,2014-04-10 18:20:56-07:00,['93dbf2ba71837db9323b1636515a581be1e5a06a'],35,142,177,17676019,3,0.083333333,0.6875,0.447916667,14012
b5da14c7d69afee55a8055861349c5ecafa1d3b6,1,Yusaku Sako,2014-04-10 19:31:52-07:00,['2ada153e0675d8511d73244182b908653e5b08f5'],4,9,13,17676032,1,1,1,1,14012
03e04a684a481eede81faa015b13d2a0f7df8546,1,Dmitry Sen,2014-04-11 11:41:09+03:00,['b5da14c7d69afee55a8055861349c5ecafa1d3b6'],197,517,714,17676746,12,0.057803468,0.99132948,1,14013
50ee0ff6aacfaeee971606b1b1be50af722b47ed,1,atkach,2014-04-11 14:05:18+03:00,['03e04a684a481eede81faa015b13d2a0f7df8546'],65,462,527,17677273,6,0.47107438,1,1,14015
8ded461a34f4f5207e16c9a31688c7cca0b6fb19,1,Oleg Nechiporenko,2014-04-11 14:23:37+03:00,['50ee0ff6aacfaeee971606b1b1be50af722b47ed'],6,6,12,17677285,1,0,0,0,14015
6a837985f4a467a709d36dd3a6d61cb6113bb0d6,0,Alex Antonenko,2014-04-11 16:33:51+03:00,['8ded461a34f4f5207e16c9a31688c7cca0b6fb19'],8,3,11,17677296,1,0,0,0,14015
0661a4b398d941d6ad78aac8b871d6cd01882562,1,Alex Antonenko,2014-04-11 16:57:11+03:00,['6a837985f4a467a709d36dd3a6d61cb6113bb0d6'],58,528,586,17677882,12,0.738095238,1,0.989417989,14017
c2c16c4a3dc8f85586260fe089cfddff6b2c2c7c,1,aBabiichuk,2014-04-11 17:20:28+03:00,['0661a4b398d941d6ad78aac8b871d6cd01882562'],1,10,11,17677893,2,,,,14017
0fbdb6cc2b0d0f8722f91fa14fa6ebef250f5e04,1,Oleg Nechiporenko,2014-04-11 18:20:45+03:00,['c2c16c4a3dc8f85586260fe089cfddff6b2c2c7c'],1146,2230,3376,17681269,23,0.95256917,1,0.517786561,14019
857098dbc0821db3a51d9392a40776f87cf8cb12,1,Andrew Onischuk,2014-04-11 07:49:16-07:00,['0fbdb6cc2b0d0f8722f91fa14fa6ebef250f5e04'],5,5,10,17681279,2,,,,14019
f4f83a4398a2b1e0e432bd256df65471b71a49e3,0,Jaimin Jetly,2014-04-11 11:11:51-07:00,['857098dbc0821db3a51d9392a40776f87cf8cb12'],2,2,4,17681283,2,,,,14019
b70f6b3d15510bda34d97843b019c5961341a759,0,Andrew Onischuk,2014-04-11 11:33:59-07:00,['f4f83a4398a2b1e0e432bd256df65471b71a49e3'],5,111,116,17681399,2,0.271604938,0.938271605,0.222222222,14019
35dbad9509c76fbde2932fc4878e3c7e15ceb3c2,1,Siddharth Wagle,2014-04-11 11:48:41-07:00,['b70f6b3d15510bda34d97843b019c5961341a759'],71,54,125,17681524,4,1,0,1,14019
1c3c036cacbccd47eb208431178269ec6c6421d2,1,Jaimin Jetly,2014-04-11 12:00:40-07:00,['35dbad9509c76fbde2932fc4878e3c7e15ceb3c2'],0,1,1,17681525,1,,,,14019
403bdd9e82bf03b5ae83f43b08ef2ad0cef12f91,1,Siddharth Wagle,2014-04-11 14:12:07-07:00,['1c3c036cacbccd47eb208431178269ec6c6421d2'],1,1,2,17681527,1,,,,14019
e46bf8b57c3b4ea746ddc916944e7751bc720e32,0,Srimanth Gunturi,2014-04-11 15:49:39-07:00,['403bdd9e82bf03b5ae83f43b08ef2ad0cef12f91'],1,1,2,17681529,1,,,,14019
c590a1640d2930feb116d16053da7a869164eefe,1,Srimanth Gunturi,2014-04-11 16:39:33-07:00,['e46bf8b57c3b4ea746ddc916944e7751bc720e32'],3,3,6,17681535,1,,,,14019
fcbd817a032a7d353e40eed44e50a96b0a24b32b,1,Siddharth Wagle,2014-04-12 12:26:15-07:00,['c590a1640d2930feb116d16053da7a869164eefe'],5,22,27,17681562,2,0,1,1,14019
f3445cc8f0ae42710f49f1deb99eeb94d47eedae,1,Mahadev Konar,2014-04-12 14:55:59-07:00,['fcbd817a032a7d353e40eed44e50a96b0a24b32b'],13,13,26,17681588,6,,,,14019
0f7f7604894d6f06771e3ae83d567a3701e8fb2a,0,Mahadev Konar,2014-04-12 18:33:01-07:00,['f3445cc8f0ae42710f49f1deb99eeb94d47eedae'],3,3,6,17681594,1,,,,14019
1c9d49458efff1094df9d5e609d6d890a92aaecd,1,Srimanth Gunturi,2014-04-13 00:00:47-07:00,['0f7f7604894d6f06771e3ae83d567a3701e8fb2a'],65,304,369,17681963,6,0.076923077,0.076923077,1,14019
864fae63f2488d8294dc1b6379b632294bf6fe0e,1,Srimanth Gunturi,2014-04-14 00:15:42-07:00,['1c9d49458efff1094df9d5e609d6d890a92aaecd'],3,18,21,17681984,2,1,1,1,14019
f6d0436c68584d0224dc97fb3c7f753b0d1db5bb,0,Oleg Nechiporenko,2014-04-14 13:03:31+03:00,['864fae63f2488d8294dc1b6379b632294bf6fe0e'],8,14,22,17682006,2,0,1,1,14019
c9e181d25f57f5ea56770a080e6d3b09dbda82b1,1,Dmitry Sen,2014-04-14 13:37:32+03:00,['f6d0436c68584d0224dc97fb3c7f753b0d1db5bb'],165,275,440,17682446,6,0.771084337,1,0.253012048,14019
7db13dd368e57cd5bae69015cc1b4fbac70d41c6,1,aBabiichuk,2014-04-14 15:00:32+03:00,['c9e181d25f57f5ea56770a080e6d3b09dbda82b1'],1,39,40,17682486,3,0,0.842105263,1,14019
a7272c3f391f236aad6699afa55fb3eca3b76af5,1,Aleksandr Kovalenko,2014-04-14 18:53:15+03:00,['7db13dd368e57cd5bae69015cc1b4fbac70d41c6'],109,227,336,17682822,26,1,1,1,14019
e124c7d809f6cc7fe43d69c81d74e431ee3f61e6,0,Aleksandr Kovalenko,2014-04-14 20:17:40+03:00,['a7272c3f391f236aad6699afa55fb3eca3b76af5'],0,447,447,17683269,5,0.74433657,1,0.870550162,14023
b740b57b7f7ce68d4863d31ea2aa357aac726e0e,1,Nate Cole,2014-04-14 13:44:10-04:00,['e124c7d809f6cc7fe43d69c81d74e431ee3f61e6'],39,123,162,17683431,11,0.734693878,0,0.714285714,14023
c9b740a7a4558a56e5bee98e8522de5475b2b26c,0,Andrew Onishuk,2014-04-14 22:08:52+03:00,['b740b57b7f7ce68d4863d31ea2aa357aac726e0e'],7,8,15,17683446,4,,,,14023
29e467bbc8a42203f8c4a59e9af491b0949bace2,1,Srimanth Gunturi,2014-04-14 13:02:31-07:00,['c9b740a7a4558a56e5bee98e8522de5475b2b26c'],3,3,6,17683452,2,,,,14023
26199080df967039edd33e0855800b83b0562db4,0,Nate Cole,2014-04-14 18:52:29-04:00,['29e467bbc8a42203f8c4a59e9af491b0949bace2'],1,1,2,17683454,1,,,,14023
5c0e09ca9fd40372d934b3ab80f1a1924016613c,0,Srimanth Gunturi,2014-04-14 17:50:15-07:00,['26199080df967039edd33e0855800b83b0562db4'],2,2,4,17683458,1,,,,14023
a3be8c9600cc8280feab3c75da27122a67dcf243,1,atkach,2014-04-15 12:53:45+03:00,['5c0e09ca9fd40372d934b3ab80f1a1924016613c'],83,564,647,17684105,6,0.693548387,1,0.964516129,14025
0d31527f6e97db445438c3c1cf8308294df59323,1,Dmitry Sen,2014-04-15 15:33:19+03:00,['a3be8c9600cc8280feab3c75da27122a67dcf243'],0,248,248,17684353,2,0.297560976,0.941463415,1,14026
21b1b61fe65104b11ccbdf9b34b4cfd47a59e06b,1,Andrew Onishuk,2014-04-15 15:40:48+03:00,['0d31527f6e97db445438c3c1cf8308294df59323'],29,106,135,17684488,9,0.833333333,1,1,14026
215a351d35be356f648112f74fd89a6aea71de2f,1,Andrew Onishuk,2014-04-15 15:48:04+03:00,['21b1b61fe65104b11ccbdf9b34b4cfd47a59e06b'],29,24,53,17684541,3,1,0,0,14026
998ac1168402b67b25b3c7799761ba05996fea62,1,aBabiichuk,2014-04-15 15:56:43+03:00,['215a351d35be356f648112f74fd89a6aea71de2f'],31,93,124,17684665,10,0,0,0,14027
7e5604788899e25db97db36898f88f1d2333be7e,1,Andrew Onishuk,2014-04-15 16:01:56+03:00,['998ac1168402b67b25b3c7799761ba05996fea62'],2,2,4,17684669,1,,,,14027
5ef841a0e227ad22bce8b9e6a9d075d10cc7fd4f,1,Oleg Nechiporenko,2014-04-15 17:52:49+03:00,['7e5604788899e25db97db36898f88f1d2333be7e'],1005,2978,3983,17688652,21,0.945121951,0.976626016,0.949186992,14033
dd5f864f05564e36fcc5c40b2fad9dd4fa45a51e,1,John Speidel,2014-04-15 12:42:15-04:00,['5ef841a0e227ad22bce8b9e6a9d075d10cc7fd4f'],87,1085,1172,17689824,20,0.643229167,0.841145833,0.880208333,14040
71aa1f24c5cb852a513117956e1f10571e545c91,1,Nate Cole,2014-04-15 16:15:57-04:00,['dd5f864f05564e36fcc5c40b2fad9dd4fa45a51e'],67,832,899,17690723,21,0.250720461,0.893371758,0.887608069,14044
829bb45071f3454a964b7930b6a0a2dcb196b6fa,0,Siddharth Wagle,2014-04-15 16:55:19-07:00,['71aa1f24c5cb852a513117956e1f10571e545c91'],1,38,39,17690762,5,0,1,1,14044
7a251ae7e887b4ec4714d4d0484e12598b4ca32f,0,Dmitry Sen,2014-04-16 13:56:39+03:00,['829bb45071f3454a964b7930b6a0a2dcb196b6fa'],11,86,97,17690859,7,,,,14044
8b3983f1243d898670f01cc6ed735fb8c9bbdb1b,1,atkach,2014-04-16 14:50:44+03:00,['7a251ae7e887b4ec4714d4d0484e12598b4ca32f'],38,8,46,17690905,7,1,1,0,14044
a0f09837aec41f9f18d75ad1bae7dba87ebb9e4e,1,Aleksandr Kovalenko,2014-04-16 15:26:40+03:00,['8b3983f1243d898670f01cc6ed735fb8c9bbdb1b'],0,92,92,17690997,7,1,1,1,14044
461747b9cd25ed7b5e04891abfbb26947248c60f,1,Andrew Onishuk,2014-04-16 17:30:13+03:00,['a0f09837aec41f9f18d75ad1bae7dba87ebb9e4e'],53,45,98,17691095,10,1,1,0,14044
6fa376aeae64737865f4e6125429ade3880eb1e6,1,Alex Antonenko,2014-04-16 18:03:18+03:00,['461747b9cd25ed7b5e04891abfbb26947248c60f'],0,4,4,17691099,1,0,0,1,14044
b00d45e544ac96727da0bc57209826dadd5d581c,1,Andrew Onishuk,2014-04-16 18:21:18+03:00,['6fa376aeae64737865f4e6125429ade3880eb1e6'],720,1435,2155,17693254,67,0,1,1,14050
a21ea8b8a397f0444511254caf79e98b503cd0f3,0,Alex Antonenko,2014-04-16 18:33:51+03:00,['b00d45e544ac96727da0bc57209826dadd5d581c'],1,0,1,17693255,1,,,,14050
8c6e09152279e72361fa7c143cd83137df43ff9a,1,Alex Antonenko,2014-04-16 19:48:16+03:00,['a21ea8b8a397f0444511254caf79e98b503cd0f3'],6,26,32,17693287,3,1,1,1,14050
1df9a16593d52c4d5c020630e9087d1d6678645e,1,atkach,2014-04-16 20:54:51+03:00,['8c6e09152279e72361fa7c143cd83137df43ff9a'],37,7,44,17693331,8,,,,14050
491f1c9f80d3eed54004a846f74f4fd3e24f7cbf,0,Andrew Onishuk,2014-04-16 21:01:49+03:00,['1df9a16593d52c4d5c020630e9087d1d6678645e'],0,0,0,17693331,1,,,,14050
b75ef47ec564d1210af75c424881193771c1c7c6,1,Yusaku Sako,2014-04-16 18:52:40-07:00,['491f1c9f80d3eed54004a846f74f4fd3e24f7cbf'],39,68,107,17693438,1,1,1,1,14050
ce9a6eff413d66b9aab258ad997da4189db3408d,0,Yusaku Sako,2014-04-16 19:06:00-07:00,['b75ef47ec564d1210af75c424881193771c1c7c6'],16,13,29,17693467,4,0,0,0,14050
290ec23b24bcb4d3ebbbcaecfd02f45634065170,0,Oleg Nechiporenko,2014-04-17 13:07:07+03:00,['ce9a6eff413d66b9aab258ad997da4189db3408d'],18,21,39,17693506,3,,,,14050
9935ff8a53b879700f6a8b8de167ea95501f3af6,0,Aleksandr Kovalenko,2014-04-17 15:17:05+03:00,['290ec23b24bcb4d3ebbbcaecfd02f45634065170'],4,59,63,17693569,5,1,1,1,14050
8b385e0751ac0a407cd13cff158b1df6dfae097b,1,Oleg Nechiporenko,2014-04-17 15:24:33+03:00,['9935ff8a53b879700f6a8b8de167ea95501f3af6'],287,1536,1823,17695392,7,0.865313653,1,1,14051
e445a9ce487d2486a556b29b693c6083ffd396f3,1,Lisnichenko Dmitro,2014-04-17 16:37:49+03:00,['8b385e0751ac0a407cd13cff158b1df6dfae097b'],8,205,213,17695605,5,0.04516129,0.890322581,0.896774194,14051
fa78c73d5952187543196794f7481cbfc0a5dcec,1,atkach,2014-04-17 17:17:33+03:00,['e445a9ce487d2486a556b29b693c6083ffd396f3'],193,1510,1703,17697308,9,0.763000853,1,1,14054
5b2e8087b38cc816530f8bd426d52c86fdb65f44,1,Nate Cole,2014-04-17 11:09:23-04:00,['fa78c73d5952187543196794f7481cbfc0a5dcec'],19,138,157,17697465,5,0.222222222,0.694444444,0.458333333,14054
a4028880af617911d25950d9a432eec09c26cee7,1,Aleksandr Kovalenko,2014-04-17 21:25:10+03:00,['5b2e8087b38cc816530f8bd426d52c86fdb65f44'],5,87,92,17697557,3,1,1,1,14054
384ce70c54bb9d592d2be2d4e19b3ac94efe333b,1,Andrew Onishuk,2014-04-17 22:23:06+03:00,['a4028880af617911d25950d9a432eec09c26cee7'],44,49,93,17697650,40,,,,14054
04dc3028390bd0ab09c346c12f731a60a4187e65,0,Andrew Onishuk,2014-04-17 22:34:47+03:00,['384ce70c54bb9d592d2be2d4e19b3ac94efe333b'],7,18,25,17697675,2,0.714285714,1,1,14054
8425bd120d5ddca1e9aa16b12db625650b728dbc,1,Sumit Mohanty,2014-04-17 13:02:29-07:00,['04dc3028390bd0ab09c346c12f731a60a4187e65'],1,338,339,17698014,10,0,1,1,14054
da88fb5fa360b6d156f63e847af8fcfc78a43205,0,Sumit Mohanty,2014-04-17 13:17:07-07:00,['8425bd120d5ddca1e9aa16b12db625650b728dbc'],17,65,82,17698096,2,,,,14054
cbb4955cea41d45d79d3623c6dd92408157fdee4,0,Andrew Onishuk,2014-04-17 23:37:47+03:00,['da88fb5fa360b6d156f63e847af8fcfc78a43205'],1,1,2,17698098,1,,,,14054
c67e883e6c7352e992aed691cb5b796451ef62f0,1,Nate Cole,2014-04-17 16:58:30-04:00,['cbb4955cea41d45d79d3623c6dd92408157fdee4'],18,857,875,17698973,7,0.090163934,0.540983607,0.868852459,14055
68147d53c7a08afc75f79e8f26b5f595ece444f4,1,Aleksandr Kovalenko,2014-04-18 15:31:56+03:00,['c67e883e6c7352e992aed691cb5b796451ef62f0'],49,194,243,17699216,7,0.753846154,1,1,14055
f83d95df736e83c02d5f2d4c97e2493b96b33768,0,Lisnichenko Dmitro,2014-04-18 15:35:10+03:00,['68147d53c7a08afc75f79e8f26b5f595ece444f4'],8,46,54,17699270,2,0,0.296296296,0.814814815,14055
fd73398b19c2e419ad8e9572865a06a380fbe472,1,Alex Antonenko,2014-04-18 15:56:55+03:00,['f83d95df736e83c02d5f2d4c97e2493b96b33768'],62,54,116,17699386,3,0,0,0,14055
8865d248eee1e0e9a53f913f2ec9d2131a786ad7,1,Oleg Nechiporenko,2014-04-18 16:06:18+03:00,['fd73398b19c2e419ad8e9572865a06a380fbe472'],248,524,772,17700158,6,0.79245283,1,1,14056
60c96ae90673fba0b346dad62735e5d0f08644da,1,Alex Antonenko,2014-04-18 18:13:31+03:00,['8865d248eee1e0e9a53f913f2ec9d2131a786ad7'],1,3,4,17700162,1,,,,14056
0a21401f6a096cf86ccc247058dcd175d908bf96,1,Alex Antonenko,2014-04-18 19:06:44+03:00,['60c96ae90673fba0b346dad62735e5d0f08644da'],3,4,7,17700169,2,1,1,1,14056
04690bf92fe383ea2a071ef45137129c5641b705,1,Aleksandr Kovalenko,2014-04-18 19:25:25+03:00,['0a21401f6a096cf86ccc247058dcd175d908bf96'],265,30,295,17700464,5,0.842105263,1,0,14056
d3f45041f70b7fb25f35b84646b3f91714efcc74,1,Siddharth Wagle,2014-04-18 09:42:31-07:00,['04690bf92fe383ea2a071ef45137129c5641b705'],467,168,635,17701099,41,1,0,1,14056
bed392da03dfe93bfc349c99ba972120d0a66adc,1,Siddharth Wagle,2014-04-18 09:42:32-07:00,['d3f45041f70b7fb25f35b84646b3f91714efcc74'],1,1,2,17701101,1,,,,14056
6f1b631862f0e56626ef27fb98c992697b7b55ae,1,Siddharth Wagle,2014-04-18 09:42:32-07:00,['bed392da03dfe93bfc349c99ba972120d0a66adc'],4,5,9,17701110,1,0,0,1,14056
08d499f9ea87adc89ca0ee7509dd8f408b82a1ca,1,Siddharth Wagle,2014-04-18 09:42:32-07:00,['6f1b631862f0e56626ef27fb98c992697b7b55ae'],3,3,6,17701116,2,,,,14056
773541ea06916d63aa2cd2c701b2759c6bd6384f,0,Sumit Mohanty,2014-04-18 10:00:55-07:00,['08d499f9ea87adc89ca0ee7509dd8f408b82a1ca'],2,10,12,17701128,1,0,0,1,14056
a32863d86cab572c3dee7611fc8455e69adedbff,1,Alex Antonenko,2014-04-18 22:26:55+03:00,['773541ea06916d63aa2cd2c701b2759c6bd6384f'],3,3,6,17701134,1,,,,14056
bbde993be9d0f377274d12dbcf15a15dc43c8d55,1,Yusaku Sako,2014-04-18 14:41:47-07:00,['a32863d86cab572c3dee7611fc8455e69adedbff'],719,515,1234,17702368,13,0.780730897,0.528239203,0.019933555,14056
d00330230679c89fab3f345d677394a1ce2ed27d,1,Yusaku Sako,2014-04-18 14:48:28-07:00,['bbde993be9d0f377274d12dbcf15a15dc43c8d55'],0,707,707,17703075,3,0.411363636,0.638636364,0.986363636,14059
9d74026bda5206ec9f249865dde362494b486d0f,0,Yusaku Sako,2014-04-18 14:56:02-07:00,['d00330230679c89fab3f345d677394a1ce2ed27d'],0,0,0,17703075,1,,,,14060
6557b464b41fcc15ffccb6f5bb67540c769e7a27,1,Yusaku Sako,2014-04-18 14:56:50-07:00,['9d74026bda5206ec9f249865dde362494b486d0f'],7,52,59,17703134,1,,,,14060
ac6c15edb1ab07d94fab67dbcf2e44c6c22a9d7b,0,Yusaku Sako,2014-04-18 16:08:30-07:00,['6557b464b41fcc15ffccb6f5bb67540c769e7a27'],1,1,2,17703136,1,,,,14060
0740b4da11a4cff2ab9b93d3197ca9ee8122270f,1,Srimanth Gunturi,2014-04-18 17:04:51-07:00,['ac6c15edb1ab07d94fab67dbcf2e44c6c22a9d7b'],61,29,90,17703226,3,0.045454545,0.045454545,0,14060
0e01b1807d76bd66eb7a30c1baf00cc2e7e63384,1,Oleg Nechiporenko,2014-04-22 14:21:30+03:00,['0740b4da11a4cff2ab9b93d3197ca9ee8122270f'],96,134,230,17703456,4,0.9,1,1,14061
d9443620a64a38bbbfa49c20b12dcca0468c1cab,1,Aleksandr Kovalenko,2014-04-22 14:36:17+03:00,['0e01b1807d76bd66eb7a30c1baf00cc2e7e63384'],1,3,4,17703460,1,,,,14061
662a0af63f9bcaa268df3beb53f90da99f92bd5a,0,Aleksandr Kovalenko,2014-04-22 16:34:58+03:00,['d9443620a64a38bbbfa49c20b12dcca0468c1cab'],18,20,38,17703498,3,1,1,1,14061
f5f40f53446b1da96634223bcd4b3a81c3e25f5c,1,Oleg Nechiporenko,2014-04-22 16:39:38+03:00,['662a0af63f9bcaa268df3beb53f90da99f92bd5a'],29,168,197,17703695,8,0.654761905,0.994047619,1,14061
30fab7861cd96cff411fc07ac4a10db81ed24ee4,1,atkach,2014-04-22 17:13:18+03:00,['f5f40f53446b1da96634223bcd4b3a81c3e25f5c'],226,745,971,17704666,9,0.143626571,0.976660682,1,14062
5dd1ded5de4129e23a765c172f3d2fc320953323,1,Oleg Nechiporenko,2014-04-22 17:34:47+03:00,['30fab7861cd96cff411fc07ac4a10db81ed24ee4'],1,1,2,17704668,1,,,,14062
86da4e6a8d5e3a7700fdff63f106cedb2d96b4df,1,Alex Antonenko,2014-04-22 17:42:53+03:00,['5dd1ded5de4129e23a765c172f3d2fc320953323'],2,5,7,17704675,2,1,1,1,14062
ca6e4de6d66ff9fc92c04424bb4878eebe6dfe1f,0,Alex Antonenko,2014-04-22 17:49:20+03:00,['86da4e6a8d5e3a7700fdff63f106cedb2d96b4df'],0,3,3,17704678,1,1,1,0,14062
833eda8975ce75aaaed4779d44f8fad349d3761a,0,tbeerbower,2014-04-22 12:09:56-04:00,['ca6e4de6d66ff9fc92c04424bb4878eebe6dfe1f'],2,4,6,17704684,3,,,,14062
11a9f1d5b6116668a8914fb1d4cab58c6149e76f,1,Dmitry Sen,2014-04-22 19:13:45+03:00,['833eda8975ce75aaaed4779d44f8fad349d3761a'],33,305,338,17705022,20,0.32885906,0.718120805,0.906040268,14062
61e8d7afa1580b71586f3f2b3c4e6c08761b6c2b,1,Srimanth Gunturi,2014-04-22 09:17:42-07:00,['11a9f1d5b6116668a8914fb1d4cab58c6149e76f'],5,226,231,17705253,9,0.333333333,0.577777778,1,14066
b7ad2c57c39d31f5d0dec9b7becf62b9ee622cfb,1,Aleksandr Kovalenko,2014-04-22 20:08:11+03:00,['61e8d7afa1580b71586f3f2b3c4e6c08761b6c2b'],26,107,133,17705386,7,,,,14066
d35e3cd58db0bb86d5f5f86283058064286f3ad2,1,Xi Wang,2014-04-22 10:34:48-07:00,['b7ad2c57c39d31f5d0dec9b7becf62b9ee622cfb'],21,22,43,17705429,5,,,,14066
9a4cef7890309ddc042163fd31c8e18bd2af77fc,0,Srimanth Gunturi,2014-04-22 12:02:42-07:00,['d35e3cd58db0bb86d5f5f86283058064286f3ad2'],2,19,21,17705450,3,,,,14066
7a5c891e6efea4309764988ddbd1f3c640ed155f,0,Aleksandr Kovalenko,2014-04-23 15:05:07+03:00,['9a4cef7890309ddc042163fd31c8e18bd2af77fc'],16,13,29,17705479,2,1,0,0,14066
3ad84982ea4f0e7be7156f86e75ae7b37f0ee27e,1,Andrew Onishuk,2014-04-23 15:08:55+03:00,['7a5c891e6efea4309764988ddbd1f3c640ed155f'],4,22,26,17705505,3,0,1,1,14066
227b47926322e8e7bef2ae454bd7007cc3ec77e5,0,Artem Baranchuk,2014-04-23 15:23:19+03:00,['3ad84982ea4f0e7be7156f86e75ae7b37f0ee27e'],1,355,356,17705861,6,0.270440252,0.849056604,0.974842767,14068
d396b8f955dc9b83098ac3efa95d04572edc9552,0,Artem Baranchuk,2014-04-23 15:23:20+03:00,['227b47926322e8e7bef2ae454bd7007cc3ec77e5'],18,18,36,17705897,1,,,,14068
f37d4c940a7aa41c5046a9604e7bb545a0afab62,1,Artem Baranchuk,2014-04-23 15:23:20+03:00,['d396b8f955dc9b83098ac3efa95d04572edc9552'],9,17,26,17705923,1,,,,14068
7e7b6709d0fbf7b5c3748ef3e6838c01d52d2520,1,aBabiichuk,2014-04-23 15:24:16+03:00,['f37d4c940a7aa41c5046a9604e7bb545a0afab62'],27,705,732,17706655,2,0.460506706,1,1,14068
443da921b0f8a8e62259e12147c83d2749ab5621,1,atkach,2014-04-23 15:26:12+03:00,['7e7b6709d0fbf7b5c3748ef3e6838c01d52d2520'],4,4,8,17706663,1,0,0,0,14068
841a69d28fb811bd5800f89397f99a630de18622,0,Dmitry Sen,2014-04-23 15:27:44+03:00,['443da921b0f8a8e62259e12147c83d2749ab5621'],0,6,6,17706669,2,,,,14068
11c63bc572db7486e98d52c6dec0046ec2f6d0d9,1,Lisnichenko Dmitro,2014-04-23 15:30:12+03:00,['841a69d28fb811bd5800f89397f99a630de18622'],1,1,2,17706671,1,,,,14068
9d0dea40b0fb25e546c9c1f6caba8ec2d0179add,1,Andrew Onishuk,2014-04-23 15:41:07+03:00,['11c63bc572db7486e98d52c6dec0046ec2f6d0d9'],77,30,107,17706778,6,1,0,0,14068
d9b91a7fc58424f9a9c66918771d404ba84abc62,1,Oleg Nechiporenko,2014-04-23 15:41:37+03:00,['9d0dea40b0fb25e546c9c1f6caba8ec2d0179add'],181,1592,1773,17708551,6,0.692058347,1,1,14069
89cdb711e6cc463733fab1868a9d637f2e226443,1,Aleksandr Kovalenko,2014-04-23 18:56:00+03:00,['d9b91a7fc58424f9a9c66918771d404ba84abc62'],0,1,1,17708552,1,,,,14069
e954e2fad68fd54ea5ca26eaf3110dbfda23cfe8,1,aBabiichuk,2014-04-23 19:53:13+03:00,['89cdb711e6cc463733fab1868a9d637f2e226443'],2,2,4,17708556,2,0.666666667,1,1,14069
cef629f81cf0a917c85c7fff0fc0ed4f9a86c4a9,1,Xi Wang,2014-04-23 10:58:25-07:00,['e954e2fad68fd54ea5ca26eaf3110dbfda23cfe8'],9,8,17,17708573,2,,,,14069
bb21aae27d916899f6b134de294bd014cc7d0ea3,1,Srimanth Gunturi,2014-04-23 12:02:04-07:00,['cef629f81cf0a917c85c7fff0fc0ed4f9a86c4a9'],17,10,27,17708600,1,0,0,0,14069
d0139617cfe188a1f969cbdaaf14787da4321894,1,Siddharth Wagle,2014-04-23 13:35:19-07:00,['bb21aae27d916899f6b134de294bd014cc7d0ea3'],0,880,880,17709480,7,0.151282051,0.238461538,0.364102564,14075
80a499a1f735f2f8069bb675d6f99d63322bf4a9,1,Oleg Nechiporenko,2014-04-24 13:01:06+03:00,['d0139617cfe188a1f969cbdaaf14787da4321894'],1,1,2,17709482,1,,,,14075
e002774b5c4e59c659eef1d729928976973265f5,0,Myroslav Papirkovskyy,2014-04-24 14:51:51+03:00,['80a499a1f735f2f8069bb675d6f99d63322bf4a9'],3,9,12,17709494,2,0,1,1,14075
1a262a0dc8586e449e13557ff4c16ffd63131fbb,1,Myroslav Papirkovskyy,2014-04-24 14:51:51+03:00,['e002774b5c4e59c659eef1d729928976973265f5'],441,530,971,17710465,10,0,0,1,14076
82eae43a545fc02f52b7d69708e275592ae148de,0,Aleksandr Kovalenko,2014-04-24 15:19:21+03:00,['1a262a0dc8586e449e13557ff4c16ffd63131fbb'],7,5,12,17710477,3,1,1,0,14076
3f139ac965b72e6eb6342bf730ca74156c096ed3,1,Andrew Onishuk,2014-04-24 16:30:55+03:00,['82eae43a545fc02f52b7d69708e275592ae148de'],0,241,241,17710718,1,0.223076923,1,0.623076923,14077
0276ecdea1bd76a11300c8a589bf2f7331100c32,1,Andrew Onishuk,2014-04-24 16:33:20+03:00,['3f139ac965b72e6eb6342bf730ca74156c096ed3'],0,241,241,17710959,1,0.223076923,1,0.623076923,14078
643f51ee270d3a556e395c9acce8f5db46c31bf9,1,Andrew Onishuk,2014-04-24 16:35:30+03:00,['0276ecdea1bd76a11300c8a589bf2f7331100c32'],4,60,64,17711023,8,0,1,1,14079
3e05cb551a5c7cfb521f210838694608e1cbf0b0,0,Andrew Onishuk,2014-04-24 16:55:51+03:00,['643f51ee270d3a556e395c9acce8f5db46c31bf9'],241,0,241,17711264,1,0.776923077,0,0.376923077,14079
82bbd3ea6b3be4064ec4df0c394803a6bb710ea6,1,Myroslav Papirkovskyy,2014-04-24 16:58:18+03:00,['3e05cb551a5c7cfb521f210838694608e1cbf0b0'],14,27,41,17711305,13,1,0,0,14079
cb6765fae3d149b4918d60b166dade4f1f1bd178,1,Dmitry Sen,2014-04-24 17:12:32+03:00,['82bbd3ea6b3be4064ec4df0c394803a6bb710ea6'],55,211,266,17711571,11,0,0.404255319,0.638297872,14079
2947c7adaa18061b21dd9e2f813d4650e73e4ecb,0,aBabiichuk,2014-04-24 17:54:15+03:00,['cb6765fae3d149b4918d60b166dade4f1f1bd178'],15,3,18,17711589,2,0,0,0,14079
8835bf993b921ca835f0926bdb4eaff46968825a,1,John Speidel,2014-04-24 11:11:11-04:00,['2947c7adaa18061b21dd9e2f813d4650e73e4ecb'],62,904,966,17712555,20,0.364741641,0.76899696,0.741641337,14082
fee25b4d838478123a3e3da00550cd752550313c,1,Aleksandr Kovalenko,2014-04-24 18:22:49+03:00,['8835bf993b921ca835f0926bdb4eaff46968825a'],6,6,12,17712567,1,,,,14082
6ffef4c7002ca1bd7e8757d722f061c1bc6b1f35,0,Aleksandr Kovalenko,2014-04-24 18:43:00+03:00,['fee25b4d838478123a3e3da00550cd752550313c'],1,4,5,17712572,2,,,,14082
88758cce90d37662612585d900d8a7303b34476c,1,Andrew Onishuk,2014-04-24 20:04:22+03:00,['6ffef4c7002ca1bd7e8757d722f061c1bc6b1f35'],2,2,4,17712576,1,,,,14082
94bbf6404a0519b1c015c1dc7b3d38823a82b72a,1,Myroslav Papirkovskyy,2014-04-24 21:07:07+03:00,['88758cce90d37662612585d900d8a7303b34476c'],32,34,66,17712642,3,1,1,0,14082
16bc5f3ddfaf305d82751880b4ab2abb5da03f03,1,Yusaku Sako,2014-04-24 13:18:57-07:00,['94bbf6404a0519b1c015c1dc7b3d38823a82b72a'],18,18,36,17712678,11,,,,14082
5465578c6d0fc5f6f84db8e40b0f67ed082bb042,0,Xi Wang,2014-04-24 13:28:21-07:00,['16bc5f3ddfaf305d82751880b4ab2abb5da03f03'],1,2,3,17712681,1,,,,14082
6de58738895236b9e5c397baec1d032fd2205e1b,0,Artem Baranchuk,2014-04-25 00:01:35+03:00,['5465578c6d0fc5f6f84db8e40b0f67ed082bb042'],1,1,2,17712683,1,,,,14082
02b2cb8b9fefd79be4ba2c2bdefe14c07eaeda95,0,Artem Baranchuk,2014-04-25 00:01:36+03:00,['6de58738895236b9e5c397baec1d032fd2205e1b'],0,1,1,17712684,1,,,,14082
1830dcf6db99a5ec2f3403037bea9f5f3b184ee1,1,Sumit Mohanty,2014-04-24 15:46:22-07:00,['02b2cb8b9fefd79be4ba2c2bdefe14c07eaeda95'],86,11,97,17712781,7,,,,14082
ed6aaaf73e349b9dadc6a0047d862e82ee3491d0,1,Srimanth Gunturi,2014-04-24 16:36:17-07:00,['1830dcf6db99a5ec2f3403037bea9f5f3b184ee1'],0,13,13,17712794,1,1,1,1,14082
3a806b50e8f452538a561c65e5d8b531169004d0,1,Xi Wang,2014-04-24 16:50:24-07:00,['ed6aaaf73e349b9dadc6a0047d862e82ee3491d0'],139,103,242,17713036,9,1,1,1,14082
b137f0b9ac945dce6fea091c710add207e372f5c,0,Oleg Nechiporenko,2014-04-25 13:11:31+03:00,['3a806b50e8f452538a561c65e5d8b531169004d0'],9,9,18,17713054,1,,,,14082
fb57e05a5a40b012d76cacbd55b257e338b884b9,1,tbeerbower,2014-04-25 08:11:05-04:00,['b137f0b9ac945dce6fea091c710add207e372f5c'],60,2178,2238,17715292,27,0.399108138,0.809364548,0.904124861,14094
7c277169fe158222f1856e931a3a0a030dd0b318,1,Vitaly Brodetskyi,2014-04-25 16:57:30+03:00,['fb57e05a5a40b012d76cacbd55b257e338b884b9'],8,28,36,17715328,3,0.894736842,1,0.789473684,14094
a965487c5c06b507f5c3b4289ba4e8f0d0515996,1,Aleksandr Kovalenko,2014-04-25 17:41:38+03:00,['7c277169fe158222f1856e931a3a0a030dd0b318'],2,9,11,17715339,2,1,1,1,14094
739d35e385df0e6e3d6b27e2b04cc74e0afa5e50,1,Alex Antonenko,2014-04-25 18:46:47+03:00,['a965487c5c06b507f5c3b4289ba4e8f0d0515996'],13,21,34,17715373,5,1,1,1,14094
b96edcf90d7d2e609aa5e2e4eb9024c8c467c000,1,Oleg Nechiporenko,2014-04-25 19:28:30+03:00,['739d35e385df0e6e3d6b27e2b04cc74e0afa5e50'],366,1867,2233,17717606,11,0.824014665,1,1,14096
ad3323ef638e289a7ad6a09f594ee9637f3b117a,1,Dmitry Sen,2014-04-25 20:03:51+03:00,['b96edcf90d7d2e609aa5e2e4eb9024c8c467c000'],42,44,86,17717692,4,0,0,1,14096
f0c31d29a521c2046c9660bc29fc27fac7cafb37,0,Aleksandr Kovalenko,2014-04-25 20:22:31+03:00,['ad3323ef638e289a7ad6a09f594ee9637f3b117a'],8,9,17,17717709,1,0,0,1,14096
bc5d82cad01f484195ddb30bdef60aa684856da4,1,Dmitry Sen,2014-04-25 20:36:20+03:00,['f0c31d29a521c2046c9660bc29fc27fac7cafb37'],34,100,134,17717843,4,0,1,0.017857143,14096
6ee9847342cefeeb372ccd3f53ba855a0e3bd23b,1,tbeerbower,2014-04-25 13:46:19-04:00,['bc5d82cad01f484195ddb30bdef60aa684856da4'],1,7,8,17717851,1,,,,14096
878c9319b2033295dc5eea2fedc2b252d7520c80,0,Artem Baranchuk,2014-04-25 22:59:13+03:00,['6ee9847342cefeeb372ccd3f53ba855a0e3bd23b'],2,1,3,17717854,1,,,,14096
462ade7dd36eaa29c0cffc15e182da74648140b7,1,Siddharth Wagle,2014-04-25 13:03:36-07:00,['878c9319b2033295dc5eea2fedc2b252d7520c80'],15,277,292,17718146,11,,,,14096
45916637ef1a09211c11fb8df38bb043dfa75fc9,0,John Speidel,2014-04-25 18:01:18-04:00,['462ade7dd36eaa29c0cffc15e182da74648140b7'],13,13,26,17718172,1,,,,14096
2a92c51deca541b2ab1ec0dadeb4f0ad396b5a49,1,Nate Cole,2014-04-25 19:25:24-04:00,['45916637ef1a09211c11fb8df38bb043dfa75fc9'],3,430,433,17718605,15,,,,14108
8be34412187afba72cb4f0c8bbe65a936e2b2399,0,Artem Baranchuk,2014-04-27 19:45:39+03:00,['2a92c51deca541b2ab1ec0dadeb4f0ad396b5a49'],0,1,1,17718606,1,0,0,1,14108
16affea25e805322edaf377d144256c53250cd66,0,Artem Baranchuk,2014-04-27 19:47:31+03:00,['8be34412187afba72cb4f0c8bbe65a936e2b2399'],2,27,29,17718635,3,0.85,0,1,14108
e1ca79f6ff53d0d684a5151e42c9757034653be1,1,Andrew Onishuk,2014-04-28 13:03:50+03:00,['16affea25e805322edaf377d144256c53250cd66'],20,113,133,17718768,2,,,,14109
b698c294b15212e91a7c765f47ae656fe31dbaaa,0,Alex Antonenko,2014-04-28 14:05:18+03:00,['e1ca79f6ff53d0d684a5151e42c9757034653be1'],3,3,6,17718774,1,,,,14109
5c49faf56bb0fb28a9aa038e3e97f40c3dc34dcc,1,atkach,2014-04-28 14:23:40+03:00,['b698c294b15212e91a7c765f47ae656fe31dbaaa'],590,2331,2921,17721695,6,0.96742671,1,0.988273616,14111
d9ebe6a82a493d0331733d61820e05744c301f03,1,Andrew Onishuk,2014-04-28 16:06:14+03:00,['5c49faf56bb0fb28a9aa038e3e97f40c3dc34dcc'],4,12,16,17721711,4,0.4,0.4,0.8,14111
287c66a89aa6064568f6e2e13591568e1767a250,1,Andrew Onishuk,2014-04-28 16:06:45+03:00,['d9ebe6a82a493d0331733d61820e05744c301f03'],4,5,9,17721720,2,,,,14111
8471f06b4c63f1535d5b0af3ecf1947cacaee6ee,1,Aleksandr Kovalenko,2014-04-28 19:31:20+03:00,['287c66a89aa6064568f6e2e13591568e1767a250'],23,36,59,17721779,3,,,,14111
0241bf3e1659dd1bc4ba80c88b3e91866f4820e2,0,Alex Antonenko,2014-04-28 20:04:15+03:00,['8471f06b4c63f1535d5b0af3ecf1947cacaee6ee'],4,17,21,17721800,2,0,1,1,14111
5b58d16df31d489db81372831b1b107caa05131c,0,atkach,2014-04-28 20:51:24+03:00,['0241bf3e1659dd1bc4ba80c88b3e91866f4820e2'],1,1,2,17721802,1,,0,,14111
08e726ada80c7bb0fc38ffc022568186a0d21241,0,John Speidel,2014-04-28 14:33:46-04:00,['5b58d16df31d489db81372831b1b107caa05131c'],5,5,10,17721812,4,,,,14111
ccc6acdf94f82bc50f9f8df62e41a05dfc9c9019,1,tbeerbower,2014-04-28 15:09:29-04:00,['08e726ada80c7bb0fc38ffc022568186a0d21241'],63,161,224,17722036,8,0.130434783,0.630434783,1,14111
d78c5b2f831bc82b7f5de7dd1d2900c4e980e1b3,1,tbeerbower,2014-04-28 15:15:45-04:00,['ccc6acdf94f82bc50f9f8df62e41a05dfc9c9019'],56,1840,1896,17723932,11,0.391678623,0.714490674,0.659971306,14118
704e114552e39417e3e3c9b974aa297d31320a7e,1,Lisnichenko Dmitro,2014-04-28 22:31:04+03:00,['d78c5b2f831bc82b7f5de7dd1d2900c4e980e1b3'],6,41,47,17723979,3,0,1,1,14118
eb0b6da827c0d792ba3a44b4ac0ba5b358c76cfe,0,tbeerbower,2014-04-28 16:00:25-04:00,['704e114552e39417e3e3c9b974aa297d31320a7e'],1,0,1,17723980,1,,,,14118
179e5b29b4724fd810a55cbb36126bb866178d73,0,Xi Wang,2014-04-28 15:15:58-07:00,['eb0b6da827c0d792ba3a44b4ac0ba5b358c76cfe'],22,23,45,17724025,4,0,0,0,14118
186db4e0cdc6ec9d4f4ca6176895acda36ef203b,0,Siddharth Wagle,2014-04-28 16:30:02-07:00,['179e5b29b4724fd810a55cbb36126bb866178d73'],5,15,20,17724045,2,0,0,1,14118
a511d28289138a5cdffd27e03d4fb0ea92e1f41c,0,Siddharth Wagle,2014-04-28 20:30:19-07:00,['186db4e0cdc6ec9d4f4ca6176895acda36ef203b'],1,1,2,17724047,1,,,,14118
817a7e34e3ef67d273c5617329913a5276878bf3,1,atkach,2014-04-29 13:40:53+03:00,['a511d28289138a5cdffd27e03d4fb0ea92e1f41c'],13,361,374,17724421,5,0.788778878,1,1,14120
852d8af2f47296b6e036d7ca4590e3d33e80c4cb,1,Oleg Nechiporenko,2014-04-29 15:10:06+03:00,['817a7e34e3ef67d273c5617329913a5276878bf3'],41,332,373,17724794,9,0.751351351,1,1,14123
c4a9dc131ec915ae2edaefb9cd7f032ac9de4b1a,1,Andrew Onishuk,2014-04-29 16:40:32+03:00,['852d8af2f47296b6e036d7ca4590e3d33e80c4cb'],16,59,75,17724869,12,0,0.909090909,1,14123
06b6ca7f505fc22fdc6deeef7299dd12cc3d34e6,1,Oleg Nechiporenko,2014-04-29 17:06:36+03:00,['c4a9dc131ec915ae2edaefb9cd7f032ac9de4b1a'],115,1386,1501,17726370,8,0.77400582,1,1,14124
35f618e366c4fa80b358b32a2c640ea616cb7fd0,0,Aleksandr Kovalenko,2014-04-29 18:02:54+03:00,['06b6ca7f505fc22fdc6deeef7299dd12cc3d34e6'],2,2,4,17726374,1,,,,14124
f3637b5653d86e3f38db4f3bf1f07bda045abeb6,1,Nate Cole,2014-04-29 13:37:18-04:00,['35f618e366c4fa80b358b32a2c640ea616cb7fd0'],0,77,77,17726451,2,1,1,1,14125
8277003296ddc6ea981e89565017021b1e93c76e,1,Siddharth Wagle,2014-04-29 14:33:10-07:00,['f3637b5653d86e3f38db4f3bf1f07bda045abeb6'],2,9,11,17726462,2,0,1,1,14125
7d3eb698d9e966c79121e97a841365e413f4b42b,0,Siddharth Wagle,2014-04-29 14:37:56-07:00,['8277003296ddc6ea981e89565017021b1e93c76e'],4,0,4,17726466,1,1,1,0,14125
11819ace2f2b451bbec3e95e4a28ad7c4ab37489,0,Siddharth Wagle,2014-04-29 15:03:30-07:00,['7d3eb698d9e966c79121e97a841365e413f4b42b'],1,2,3,17726469,1,0,0,1,14125
fa787e559bbf5fd9e3088f8dace7522725cdecc7,0,Srimanth Gunturi,2014-04-29 18:00:01-07:00,['11819ace2f2b451bbec3e95e4a28ad7c4ab37489'],0,6,6,17726475,1,,,,14125
b4d35ac315fc70da74b6299f6dd854f461b0dcaf,1,Vitaly Brodetskyi,2014-04-30 12:16:26+03:00,['fa787e559bbf5fd9e3088f8dace7522725cdecc7'],5,124,129,17726604,5,0.123076923,0.923076923,1,14126
9a245cbc4ebb3cf740930613f8e34dd01976554c,1,Lisnichenko Dmitro,2014-04-30 14:54:43+03:00,['b4d35ac315fc70da74b6299f6dd854f461b0dcaf'],9,67,76,17726680,4,0,0.489361702,0.936170213,14126
8d6756eb83c9233f7b3b8832f62597492607f5f6,0,Aleksandr Kovalenko,2014-04-30 16:02:56+03:00,['9a245cbc4ebb3cf740930613f8e34dd01976554c'],2,2,4,17726684,1,,,,14126
74f3f85a66c031daeff562d24fa819188f959a5f,1,Vitaly Brodetskyi,2014-04-30 16:14:42+03:00,['8d6756eb83c9233f7b3b8832f62597492607f5f6'],1,56,57,17726741,3,1,1,1,14127
8ae56643bc8d3a5f7c7228bf1772b4a965161402,0,tbeerbower,2014-04-30 09:15:58-04:00,['74f3f85a66c031daeff562d24fa819188f959a5f'],7,38,45,17726786,2,1,1,1,14127
4481ac2495c9da2ae50d7f86ff9eebdfae8e9348,1,Nate Cole,2014-04-30 09:32:15-04:00,['8ae56643bc8d3a5f7c7228bf1772b4a965161402'],229,328,557,17727343,32,0,0,0,14129
27544b1480ea8d370372808c9b52ebbe81d7384c,1,John Speidel,2014-04-30 10:39:17-04:00,['4481ac2495c9da2ae50d7f86ff9eebdfae8e9348'],1,242,243,17727586,2,0,1,1,14129
6cd8a8021e4138e0377c9903a9d0d3af182d0e6c,1,aBabiichuk,2014-04-30 17:56:55+03:00,['27544b1480ea8d370372808c9b52ebbe81d7384c'],56,123,179,17727765,7,0,1,0.666666667,14129
68020574d540923c6c59ffabe0747d60d83e6144,1,aBabiichuk,2014-04-30 19:24:02+03:00,['6cd8a8021e4138e0377c9903a9d0d3af182d0e6c'],24,797,821,17728586,4,0.551663748,1,1,14130
2182d60cffbe82880b62c1b115deb8168123490b,1,Nate Cole,2014-04-30 12:36:49-04:00,['68020574d540923c6c59ffabe0747d60d83e6144'],7,34,41,17728627,2,0,0.736842105,1,14130
9ede3dee3a29ac8e4cde21ffda9f939460a39fc1,1,atkach,2014-04-30 19:59:13+03:00,['2182d60cffbe82880b62c1b115deb8168123490b'],70,179,249,17728876,6,1,0.30952381,0.976190476,14130
7140d3c3674c0e2d3ded308c2071eb7a6432945f,0,tbeerbower,2014-04-30 13:39:33-04:00,['9ede3dee3a29ac8e4cde21ffda9f939460a39fc1'],11,17,28,17728904,6,,,,14130
e28a1f506a314ce60c381abba50d846b3927905b,1,Nate Cole,2014-04-30 13:50:25-04:00,['7140d3c3674c0e2d3ded308c2071eb7a6432945f'],26,78,104,17729008,4,0.909090909,0.909090909,1,14130
89c72f3c8621df26d10b9d1e8bf8c01af40c2b1f,0,tbeerbower,2014-04-30 15:07:47-04:00,['e28a1f506a314ce60c381abba50d846b3927905b'],34,26,60,17729068,1,,,,14130
8490bae982a15448486f99b522afefd2d9c68c17,1,tbeerbower,2014-04-30 15:22:15-04:00,['89c72f3c8621df26d10b9d1e8bf8c01af40c2b1f'],14,133,147,17729215,5,0.242424242,0.242424242,1,14130
cf6e1f3a7fbb13cba6524504d18e6093fd183876,0,tbeerbower,2014-04-30 15:29:17-04:00,['8490bae982a15448486f99b522afefd2d9c68c17'],6,19,25,17729240,3,,,,14130
3c799274aea8d73aa50a5d76fde32ee6573beee7,1,Srimanth Gunturi,2014-04-30 12:53:26-07:00,['cf6e1f3a7fbb13cba6524504d18e6093fd183876'],5,22,27,17729267,1,0,0,0,14130
21c3f58d24ece92c42f0054f9e57e76f04927e91,1,tbeerbower,2014-04-30 18:54:53-04:00,['3c799274aea8d73aa50a5d76fde32ee6573beee7'],17,24,41,17729308,1,0,1,1,14130
accb02afd6f6a6e599988c94299aacb208fd0ba1,0,Srimanth Gunturi,2014-04-30 16:08:28-07:00,['21c3f58d24ece92c42f0054f9e57e76f04927e91'],1,7,8,17729316,1,1,1,1,14130
602d6d7bb5f548571e2d2cc291696a6049c2bf30,1,Siddharth Wagle,2014-04-30 17:27:59-07:00,['accb02afd6f6a6e599988c94299aacb208fd0ba1'],40,198,238,17729554,13,0.735294118,0.985294118,0.852941176,14130
84c101fa594e46c33e66561c7301eedccc2a518a,0,Srimanth Gunturi,2014-04-30 17:31:41-07:00,['602d6d7bb5f548571e2d2cc291696a6049c2bf30'],0,3,3,17729557,1,0,0,0,14130
b0d850eb91b50eacdcc715223747df6c961ddaba,1,Jaimin Jetly,2014-05-01 10:28:36-07:00,['84c101fa594e46c33e66561c7301eedccc2a518a'],6,6,12,17729569,1,0,0,0,14130
327f9c3a87e9faad3a6acddbea5863851c3cd799,1,John Speidel,2014-05-01 15:31:26-04:00,['b0d850eb91b50eacdcc715223747df6c961ddaba'],50,512,562,17730131,4,0.093247588,0.678456592,0.897106109,14130
ce220f0812a3ee496df4f267582a9f12b4b887f6,1,Yusaku Sako,2014-05-01 14:51:43-07:00,['327f9c3a87e9faad3a6acddbea5863851c3cd799'],58,141,199,17730330,6,1,1,1,14130
60db51efe596d617fe40779dce9dd610d25e8217,0,Yusaku Sako,2014-05-01 14:58:48-07:00,['ce220f0812a3ee496df4f267582a9f12b4b887f6'],0,1,1,17730331,1,,,,14130
65e8193187cf550071ecaaab228f4470dcb96bef,0,tbeerbower,2014-05-01 18:17:41-04:00,['60db51efe596d617fe40779dce9dd610d25e8217'],1,8,9,17730340,1,1,1,1,14130
bd865da069b17379d937ced11e0b450d0a6f1489,0,Yusaku Sako,2014-05-01 16:30:21-07:00,['65e8193187cf550071ecaaab228f4470dcb96bef'],7,15,22,17730362,4,,,,14130
548419513dda850e69318d00a2eef85fdebdc872,1,Yusaku Sako,2014-05-01 16:30:49-07:00,['bd865da069b17379d937ced11e0b450d0a6f1489'],6,13,19,17730381,2,,,,14130
cd50f5cdf0a0086650b954eeb02b437c12e6fbf9,0,Siddharth Wagle,2014-05-01 17:55:38-07:00,['548419513dda850e69318d00a2eef85fdebdc872'],98,29,127,17730508,2,1,0.526315789,0.333333333,14130
a68b04215a381a2903db99cfa67b3fe9f313e7ad,1,Siddharth Wagle,2014-05-01 17:56:28-07:00,['cd50f5cdf0a0086650b954eeb02b437c12e6fbf9'],10,31,41,17730549,2,0,0,1,14130
0e783763bfe3af125955560552b21103092a7a94,0,Siddharth Wagle,2014-05-01 17:57:11-07:00,['a68b04215a381a2903db99cfa67b3fe9f313e7ad'],1,1,2,17730551,1,,,,14130
ef80c0a97c75787c35b99f3ac1699e86a0e1b888,1,Siddharth Wagle,2014-05-01 17:57:29-07:00,['0e783763bfe3af125955560552b21103092a7a94'],132,147,279,17730830,3,,,,14130
d0081327b51b2e27c138a1562237f73a8d9c70f9,1,Nate Cole,2014-05-01 21:21:24-04:00,['ef80c0a97c75787c35b99f3ac1699e86a0e1b888'],35,130,165,17730995,5,0.175438596,0,0.543859649,14131
75505c635f31222af4763a72cc835f6a412ed5f9,0,Yusaku Sako,2014-05-01 20:47:05-07:00,['d0081327b51b2e27c138a1562237f73a8d9c70f9'],16,13,29,17731024,3,,,,14131
5eb22214397b55a153594faa75705517f55d945c,1,tbeerbower,2014-05-02 12:24:30-04:00,['75505c635f31222af4763a72cc835f6a412ed5f9'],0,10153,10153,17741177,145,0.706195244,0.908322904,0.926157697,14276
ee9d1f1f7405d22a24386c2ba51a4326d72edb0d,0,Xi Wang,2014-05-02 13:43:10-07:00,['5eb22214397b55a153594faa75705517f55d945c'],2,2,4,17741181,1,,,,14276
59e41ba27a84540749321df8d1282c47d5bd3986,0,Xi Wang,2014-05-02 13:43:11-07:00,['ee9d1f1f7405d22a24386c2ba51a4326d72edb0d'],1,1,2,17741183,1,,,,14276
acaef41c0dd992a6c766976ec139563584417894,0,Xi Wang,2014-05-02 13:43:11-07:00,['59e41ba27a84540749321df8d1282c47d5bd3986'],2,0,2,17741185,1,,,,14276
23d222aeb23ece2b6656b08dbbf4ef9710331277,1,Siddharth Wagle,2014-05-02 14:17:13-07:00,['acaef41c0dd992a6c766976ec139563584417894'],12,188,200,17741385,4,0,0.628318584,0.530973451,14276
e9d88ebd5029e39c398be6d53caec0254f739bbd,1,Siddharth Wagle,2014-05-02 15:17:42-07:00,['23d222aeb23ece2b6656b08dbbf4ef9710331277'],2,2,4,17741389,1,,,,14276
bb29f54c62d0db3f85e18e097c07d632ff799ee6,0,Yusaku Sako,2014-05-02 15:21:14-07:00,['e9d88ebd5029e39c398be6d53caec0254f739bbd'],3,7,10,17741399,1,,,,14276
4520a81252d807e91bc6f885a88e818b1ebf9e16,0,Siddharth Wagle,2014-05-02 16:45:19-07:00,['bb29f54c62d0db3f85e18e097c07d632ff799ee6'],1,1,2,17741401,1,,,,14276
3daffeac5b1d62ddcefd37d3c0d60e230bba524b,1,tbeerbower,2014-05-02 19:48:16-04:00,['4520a81252d807e91bc6f885a88e818b1ebf9e16'],3,4639,4642,17746043,55,0.817817014,0.92776886,0.817817014,14330
9116b82f288813a6b3d6866bda6fa18a43ec0e9e,0,Yusaku Sako,2014-05-02 17:31:15-07:00,['3daffeac5b1d62ddcefd37d3c0d60e230bba524b'],3,0,3,17746046,3,,,,14330
c22f056b7477b79f2d566c999620cd3c852fa338,0,Siddharth Wagle,2014-05-03 10:33:19-07:00,['9116b82f288813a6b3d6866bda6fa18a43ec0e9e'],1,1,2,17746048,1,,,,14330
d361930fa243fba010948a6365c31bf407c6fe63,0,Oleg Nechiporenko,2014-05-05 12:51:09+03:00,['c22f056b7477b79f2d566c999620cd3c852fa338'],10,10,20,17746068,1,1,1,1,14330
c2d8a9a856e62837c3ce9d44a74a326e7bd4123a,1,Aleksandr Kovalenko,2014-05-05 19:27:38+03:00,['d361930fa243fba010948a6365c31bf407c6fe63'],6,37,43,17746111,5,0,0.275862069,0.862068966,14330
1dce49a7b1f2b0469ef4fcb8af1fc8f2ff386de0,1,Yusaku Sako,2014-05-05 13:26:53-07:00,['c2d8a9a856e62837c3ce9d44a74a326e7bd4123a'],1,1,2,17746113,1,,,,14330
046c2cf31f3e658c65cb8488527b2e02d40b4a18,1,Jaimin Jetly,2014-05-05 15:00:18-07:00,['1dce49a7b1f2b0469ef4fcb8af1fc8f2ff386de0'],3,3,6,17746119,1,,,,14330
f091c6fb6b03e7504f8533a3ce6e6165954fa026,1,Yusaku Sako,2014-05-05 19:54:56-07:00,['046c2cf31f3e658c65cb8488527b2e02d40b4a18'],13,17,30,17746149,7,,,,14330
9817682785a24d037a2e17aae6efa747f1266ee0,1,atkach,2014-05-06 13:44:58+03:00,['f091c6fb6b03e7504f8533a3ce6e6165954fa026'],87,172,259,17746408,8,0.514285714,1,0.771428571,14331
e9f274d4e03046cc920292fbc27ffa2b23d196e9,0,tbeerbower,2014-05-06 06:59:59-04:00,['9817682785a24d037a2e17aae6efa747f1266ee0'],1,1,2,17746410,1,,,,14331
c867591fa69584c3f39ef0875fc3acba8556d57f,1,Oleg Nechiporenko,2014-05-06 14:36:04+03:00,['e9f274d4e03046cc920292fbc27ffa2b23d196e9'],0,3,3,17746413,2,0,0,1,14331
f475fc0b8c038a5607c81988dcf9bb11f3aa5c8a,1,Oleg Nechiporenko,2014-05-06 15:33:22+03:00,['c867591fa69584c3f39ef0875fc3acba8556d57f'],179,1379,1558,17747971,4,0.693376068,1,1,14331
06e2aeb53762d30a358a0d04f51c086a4080b293,1,atkach,2014-05-06 17:30:21+03:00,['f475fc0b8c038a5607c81988dcf9bb11f3aa5c8a'],61,378,439,17748410,5,0.920833333,1,1,14332
0aaba364c7c23b63b90d06bae894ae5d527e9df4,0,Andrew Onishuk,2014-05-06 19:02:58+03:00,['06e2aeb53762d30a358a0d04f51c086a4080b293'],0,4,4,17748414,1,1,1,1,14332
246d82fbfb7f0781cb3375ecd19db16dbf047866,1,Andrew Onishuk,2014-05-06 19:39:16+03:00,['0aaba364c7c23b63b90d06bae894ae5d527e9df4'],48,198,246,17748660,12,,,,14334
709e33e192adf9708b334f43ecbfb27b867548a8,1,Mahadev Konar,2014-05-06 10:41:48-07:00,['246d82fbfb7f0781cb3375ecd19db16dbf047866'],44,5485,5529,17754189,8,,,,14340
ac29d93936c158abce880335660fcf46f0810841,0,Siddharth Wagle,2014-05-06 11:06:32-07:00,['709e33e192adf9708b334f43ecbfb27b867548a8'],33,212,245,17754434,2,0.138297872,0.734042553,1,14340
32210667d22a51ecc7eebd1976883421155bb65f,0,Siddharth Wagle,2014-05-06 11:35:38-07:00,['ac29d93936c158abce880335660fcf46f0810841'],1,1,2,17754436,1,,,,14340
6d33c324070206a188d456d37b4addb1607521ce,1,tbeerbower,2014-05-06 16:50:46-04:00,['32210667d22a51ecc7eebd1976883421155bb65f'],96,667,763,17755199,26,0.487951807,0.734939759,0.825301205,14344
fea5c201ca4103cb3cee14f06e4ea83277573cce,0,Mahadev Konar,2014-05-06 14:28:02-07:00,['6d33c324070206a188d456d37b4addb1607521ce'],0,1,1,17755200,1,,,,14344
0a94a332b24aed003a2ddbe231daa179eab201b5,0,Mahadev Konar,2014-05-06 18:18:35-07:00,['fea5c201ca4103cb3cee14f06e4ea83277573cce'],22,0,22,17755222,1,,,,14344
32e68f41bf23473d8949e68abf0555acabf7e12b,1,Siddharth Wagle,2014-05-06 21:29:36-07:00,['0a94a332b24aed003a2ddbe231daa179eab201b5'],7,7,14,17755236,6,,,,14344
5c11ca71bd3de74cb4580a7eeb44ac49757a7017,1,Oleg Nechiporenko,2014-05-07 12:22:32+03:00,['32e68f41bf23473d8949e68abf0555acabf7e12b'],6,874,880,17756116,4,0.376456876,1,1,14345
f3e605566cb0fec80ca631c2cffe90fd72573d15,1,Andrew Onishuk,2014-05-07 15:49:34+03:00,['5c11ca71bd3de74cb4580a7eeb44ac49757a7017'],12,26,38,17756154,4,0,1,1,14345
afce48094c3388063ed963556e491aa18b965aae,1,Andrew Onishuk,2014-05-07 15:57:07+03:00,['f3e605566cb0fec80ca631c2cffe90fd72573d15'],12,13,25,17756179,2,1,1,1,14345
35bf069bacb1676f47508d1efd4f5fbeafc532fd,1,Andrew Onishuk,2014-05-07 16:04:39+03:00,['afce48094c3388063ed963556e491aa18b965aae'],0,4,4,17756183,1,,,,14345
e702b31753d3f581f747cbe95c0bc64036d92504,1,Oleg Nechiporenko,2014-05-07 16:06:11+03:00,['35bf069bacb1676f47508d1efd4f5fbeafc532fd'],43,883,926,17757109,7,0.554966887,1,1,14345
00cc0cf501564224489990d9a593caa67b9670c5,1,Lisnichenko Dmitro,2014-05-07 16:41:22+03:00,['e702b31753d3f581f747cbe95c0bc64036d92504'],138,196,334,17757443,6,0.727272727,0.727272727,1,14345
4c2d80a1752e74c94ec87861b9ac5fcf4b922660,0,Andrew Onishuk,2014-05-07 17:40:52+03:00,['00cc0cf501564224489990d9a593caa67b9670c5'],5,8,13,17757456,2,0,1,0,14345
414e628b764f2bb05f50877d3b5292979f800b10,1,Dmitry Sen,2014-05-07 18:00:41+03:00,['4c2d80a1752e74c94ec87861b9ac5fcf4b922660'],3,196,199,17757655,10,0.235955056,0.898876404,1,14346
b946b63f2e75cb796fc3e8b59d22996afcee59bf,1,John Speidel,2014-05-07 11:34:19-04:00,['414e628b764f2bb05f50877d3b5292979f800b10'],52,1096,1148,17758803,9,0.05370844,0.453964194,0.921994885,14346
0e8baccec36f5694ec812f9ea00a7ad6ad8858d3,1,Andrew Onishuk,2014-05-07 18:53:21+03:00,['b946b63f2e75cb796fc3e8b59d22996afcee59bf'],17,47,64,17758867,7,0.8,0.8,1,14346
382f30d6d9e606e67907a7a82c4a49108b76bd01,0,Dmitry Sen,2014-05-07 18:54:57+03:00,['0e8baccec36f5694ec812f9ea00a7ad6ad8858d3'],2,1,3,17758870,2,,,,14346
0ec0a441aee7382cda42069de9e1ff02d8c50b4c,1,Oleg Nechiporenko,2014-05-07 19:25:28+03:00,['382f30d6d9e606e67907a7a82c4a49108b76bd01'],1,15,16,17758886,2,,,,14346
9eb4aaa234375f82428c7d1cf7f69c3ad81ccdb4,1,atkach,2014-05-07 20:32:19+03:00,['0ec0a441aee7382cda42069de9e1ff02d8c50b4c'],188,860,1048,17759934,4,0.881578947,1,0.969924812,14346
6d2743b5eb75701e6951e252d3ee8c29f5492e72,0,Xi Wang,2014-05-07 11:53:44-07:00,['9eb4aaa234375f82428c7d1cf7f69c3ad81ccdb4'],2,2,4,17759938,1,,,,14346
3f929c697eb7b0d25e64de14e32852c8aa77b014,1,Xi Wang,2014-05-07 11:53:44-07:00,['6d2743b5eb75701e6951e252d3ee8c29f5492e72'],3,32,35,17759973,3,1,1,1,14346
f830293bfd64babd2520102c4a61a19d5a46aece,1,Mahadev Konar,2014-05-07 12:39:14-07:00,['3f929c697eb7b0d25e64de14e32852c8aa77b014'],3261,3766,7027,17767000,46,1,1,1,14346
6f609990aaa41aeb719b4e7a60ed61da5336fe42,0,Mahadev Konar,2014-05-07 13:44:27-07:00,['f830293bfd64babd2520102c4a61a19d5a46aece'],136,0,136,17767136,1,,,,14346
4bf30ae4d8217f08a97a404b05eca232256e03d8,1,Siddharth Wagle,2014-05-07 14:13:33-07:00,['6f609990aaa41aeb719b4e7a60ed61da5336fe42'],0,4,4,17767140,4,,,,14346
3755b42af7f562b4e8f25dbab00c88b7466c133e,1,Siddharth Wagle,2014-05-07 15:05:19-07:00,['4bf30ae4d8217f08a97a404b05eca232256e03d8'],3,5,8,17767148,2,0,1,1,14346
b23ebd42cf6ea90841114462be8257fba81ad476,1,John Speidel,2014-05-07 18:10:58-04:00,['3755b42af7f562b4e8f25dbab00c88b7466c133e'],2,531,533,17767681,2,0,0.905,1,14346
f8d06b4c7c6a810c2a4b58065895c6c78f4c2c3b,1,John Speidel,2014-05-07 20:55:10-04:00,['b23ebd42cf6ea90841114462be8257fba81ad476'],8,150,158,17767839,8,0.520833333,1,0.791666667,14348
c991897b4ef010b3b55f71c862acd84b2d0950f6,1,Oleg Nechiporenko,2014-05-08 13:23:19+03:00,['f8d06b4c7c6a810c2a4b58065895c6c78f4c2c3b'],30,341,371,17768210,5,0.57,1,1,14348
586e3e6055020920a388e1709446c0c7ee651cac,1,Andrew Onishuk,2014-05-08 13:31:31+03:00,['c991897b4ef010b3b55f71c862acd84b2d0950f6'],20,84,104,17768314,16,0,0,0,14349
2f41f02d7e40d31de388439a8d02a4d18c34ea71,0,Andrew Onishuk,2014-05-08 14:39:23+03:00,['586e3e6055020920a388e1709446c0c7ee651cac'],1,1,2,17768316,1,,,,14349
e49cf155c1697e77b83b95e1f973b15b7ecae821,1,Andrew Onishuk,2014-05-08 15:34:46+03:00,['2f41f02d7e40d31de388439a8d02a4d18c34ea71'],10,10,20,17768336,4,,,,14349
51b5433f560cacf6b69e0adef0cfd92b8e3a098c,1,Lisnichenko Dmitro,2014-05-08 17:57:49+03:00,['e49cf155c1697e77b83b95e1f973b15b7ecae821'],44,166,210,17768546,2,0,0.223300971,1,14349
848e9519790ed99eed30ce3cf5c11a845471a7d4,1,tbeerbower,2014-05-08 11:00:24-04:00,['51b5433f560cacf6b69e0adef0cfd92b8e3a098c'],54,450,504,17769050,3,0.306220096,0.650717703,0.966507177,14349
e667dc7c9870864ff537374c819b7c1d1dd88e98,1,Lisnichenko Dmitro,2014-05-08 19:04:21+03:00,['848e9519790ed99eed30ce3cf5c11a845471a7d4'],84,1613,1697,17770747,52,0.389830508,0,1,14351
5ed50d5af10cd82f6a49fec30a5d6f7ab93538bd,1,aBabiichuk,2014-05-08 19:41:32+03:00,['e667dc7c9870864ff537374c819b7c1d1dd88e98'],7,101,108,17770855,3,0.723076923,0.723076923,1,14351
2fb2a17ec9265542972dd1e7c91a1b3d967f4583,1,Dmitry Sen,2014-05-08 22:23:39+03:00,['5ed50d5af10cd82f6a49fec30a5d6f7ab93538bd'],0,90,90,17770945,6,,,,14351
5dff4516ae9ab962aaefcdf535e0d41df698e948,1,Lisnichenko Dmitro,2014-05-08 23:02:00+03:00,['2fb2a17ec9265542972dd1e7c91a1b3d967f4583'],163,992,1155,17772100,29,0.494680851,0.946808511,1,14356
b427ffa269c85402b96e4d10e49f2f5635099a57,1,Xi Wang,2014-05-08 13:17:58-07:00,['5dff4516ae9ab962aaefcdf535e0d41df698e948'],9,17,26,17772126,2,1,1,1,14356
9d3e6a243f36176570c66207ddc9665f9470283d,1,Siddharth Wagle,2014-05-08 15:37:09-07:00,['b427ffa269c85402b96e4d10e49f2f5635099a57'],2,2,4,17772130,2,,,,14356
f3fe3d23208591b524ab69e902d27701195d415b,1,Siddharth Wagle,2014-05-08 15:38:28-07:00,['9d3e6a243f36176570c66207ddc9665f9470283d'],0,21,21,17772151,4,0,0,0,14356
adaf32e642ede6568252404879f408a6ebae5f37,1,Nate Cole,2014-05-08 20:08:55-04:00,['f3fe3d23208591b524ab69e902d27701195d415b'],40,131,171,17772322,3,0.961538462,0.826923077,0.884615385,14356
074f5ae9d31adae361f5c5aca992e58847422534,1,Jaimin Jetly,2014-05-09 11:40:10-07:00,['adaf32e642ede6568252404879f408a6ebae5f37'],42,50,92,17772414,3,,,,14356
f270e9016422110df238df8afe45b433446c387d,0,Xi Wang,2014-05-09 13:59:40-07:00,['074f5ae9d31adae361f5c5aca992e58847422534'],5,4,9,17772423,1,1,0,0,14356
3ad685095efc32159cb8d7a8c07bff37ab44daa6,1,Nate Cole,2014-05-09 17:02:47-04:00,['f270e9016422110df238df8afe45b433446c387d'],0,5,5,17772428,1,,,,14356
282a59a7b2b6615b6a1359af0f65ad1598c5feff,1,Nate Cole,2014-05-09 17:03:18-04:00,['3ad685095efc32159cb8d7a8c07bff37ab44daa6'],45,123,168,17772596,7,0,1,0.777777778,14357
d2265d00b816aa2a2c2f81bbec055fa1762eed90,0,Jaimin Jetly,2014-05-09 15:04:26-07:00,['282a59a7b2b6615b6a1359af0f65ad1598c5feff'],1,14,15,17772611,1,1,1,1,14357
d329dbcc6a1dc92e7dadfd6d4619b9acc4794128,1,Jaimin Jetly,2014-05-09 15:27:44-07:00,['d2265d00b816aa2a2c2f81bbec055fa1762eed90'],1,14,15,17772626,1,1,1,1,14357
86d76395cf5ca62c518d3df30ff5427495147372,1,Jaimin Jetly,2014-05-09 16:08:43-07:00,['d329dbcc6a1dc92e7dadfd6d4619b9acc4794128'],8,44,52,17772678,8,1,1,1,14357
db211f9072c879be559b34f591f8e6dc0cb84104,0,Mahadev Konar,2014-05-09 16:47:49-07:00,['86d76395cf5ca62c518d3df30ff5427495147372'],0,2785,2785,17775463,2,,,,14359
f9f5b2b0307f2cfdc87f891d1fa5cf0a2dd7a259,1,Jaimin Jetly,2014-05-09 20:10:24-07:00,['db211f9072c879be559b34f591f8e6dc0cb84104'],22,84,106,17775569,8,1,1,1,14359
88e42ff33d59cc3fb710d4b32ffee5343abe3898,0,Xi Wang,2014-05-10 00:05:04-07:00,['f9f5b2b0307f2cfdc87f891d1fa5cf0a2dd7a259'],0,0,0,17775569,12,,,,14371
e5fb45aecaffae02c529b00569c6e08cf6406ab3,0,John Speidel,2014-05-11 21:16:24-04:00,['88e42ff33d59cc3fb710d4b32ffee5343abe3898'],17,23,40,17775609,2,0,0,0.333333333,14371
e5a25a91b698f03d12c5de132fe1c0cceefc6777,1,Andrew Onishuk,2014-05-12 13:53:49+03:00,['e5fb45aecaffae02c529b00569c6e08cf6406ab3'],8,24,32,17775641,4,0,1,1,14371
7ee8d998a285f3a131c267f8460b2d185f6b6b2b,0,Vitaly Brodetskyi,2014-05-12 13:54:44+03:00,['e5a25a91b698f03d12c5de132fe1c0cceefc6777'],2,2,4,17775645,2,,,,14371
bab427fc4b0493b55fd5d6416210e5b8062fcb8c,1,atkach,2014-05-12 14:48:58+03:00,['7ee8d998a285f3a131c267f8460b2d185f6b6b2b'],187,812,999,17776644,3,0.647169811,1,1,14371
c7242bcbd81ecd923b0f2620281c56e315e97427,0,Andrew Onishuk,2014-05-12 14:55:18+03:00,['bab427fc4b0493b55fd5d6416210e5b8062fcb8c'],5,2,7,17776651,1,,,,14371
9391b60aa21e7913ceef1b6075fe34c3d7445fe0,0,Andrew Onishuk,2014-05-12 15:05:01+03:00,['c7242bcbd81ecd923b0f2620281c56e315e97427'],4,4,8,17776659,4,,,,14371
b659079cb6889abc1ef19078b49268400b41aa71,1,Andrew Onishuk,2014-05-12 15:06:03+03:00,['9391b60aa21e7913ceef1b6075fe34c3d7445fe0'],17,17,34,17776693,11,,,,14371
1e19f079b18ac5e6a47c68d2e1dff3a3975bfda2,0,tbeerbower,2014-05-12 08:51:54-04:00,['b659079cb6889abc1ef19078b49268400b41aa71'],0,1,1,17776694,1,,,,14371
ca3cce1a5fa76a202ca91abb75d5badab891ef6a,1,tbeerbower,2014-05-12 10:36:21-04:00,['1e19f079b18ac5e6a47c68d2e1dff3a3975bfda2'],32,119,151,17776845,5,,,,14371
5e49df1a65f9ae9cef58131ff8932bb7f841b148,1,Andrew Onishuk,2014-05-12 17:50:51+03:00,['ca3cce1a5fa76a202ca91abb75d5badab891ef6a'],196,228,424,17777269,95,,,,14372
c4bb5bcbf85ab643bfa263f4fc10af27a054b7cf,1,Lisnichenko Dmitro,2014-05-12 17:58:03+03:00,['5e49df1a65f9ae9cef58131ff8932bb7f841b148'],44,60,104,17777373,4,0.285714286,1,1,14372
a41198d502738e1bb158aeb96314d33baa4a37e4,1,tbeerbower,2014-05-12 11:20:04-04:00,['c4bb5bcbf85ab643bfa263f4fc10af27a054b7cf'],2,2,4,17777377,2,,,,14372
7e395b9bbf05213f42079fa47bdb633d4cb6b624,1,Oleg Nechiporenko,2014-05-12 19:02:15+03:00,['a41198d502738e1bb158aeb96314d33baa4a37e4'],91,513,604,17777981,7,0.504155125,1,1,14372
b7dd314479888fe88c6483e875e78396ecb933fe,1,Siddharth Wagle,2014-05-12 10:15:55-07:00,['7e395b9bbf05213f42079fa47bdb633d4cb6b624'],134,221,355,17778336,10,0,1,1,14374
1d0fe34b694d29a078377434dd3a322e9cf8ccac,0,Oleg Nechiporenko,2014-05-12 20:23:54+03:00,['b7dd314479888fe88c6483e875e78396ecb933fe'],11,11,22,17778358,11,,,,14374
55bb122d0f03c5254f5df127656d70cb184f5441,1,Lisnichenko Dmitro,2014-05-12 20:57:24+03:00,['1d0fe34b694d29a078377434dd3a322e9cf8ccac'],4,4,8,17778366,1,,,,14374
105b41b04c2b4969503c5f93061d47d3a00b8ab0,1,aBabiichuk,2014-05-12 21:13:01+03:00,['55bb122d0f03c5254f5df127656d70cb184f5441'],177,758,935,17779301,2,0.581460674,1,0.93258427,14374
ccf34af2aae4417318061382498f34a868ee3796,1,Jaimin Jetly,2014-05-12 11:49:02-07:00,['105b41b04c2b4969503c5f93061d47d3a00b8ab0'],752,1031,1783,17781084,8,0,0,1,14374
fb12cc209bdd30978cd1b2262ab7dc0f0429c9d6,1,Jaimin Jetly,2014-05-12 12:32:14-07:00,['ccf34af2aae4417318061382498f34a868ee3796'],2,25,27,17781111,3,1,1,1,14374
44ce2e7b69d16c77f2feb1aefe7295e59230ec32,0,tbeerbower,2014-05-12 16:09:13-04:00,['fb12cc209bdd30978cd1b2262ab7dc0f0429c9d6'],0,20,20,17781131,1,,,,14374
e3415f2dd9756a368faf10e8f0ace62952548f4f,1,tbeerbower,2014-05-12 18:38:08-04:00,['44ce2e7b69d16c77f2feb1aefe7295e59230ec32'],52,80,132,17781263,4,,,,14374
f6ce8c67b7e1b3d7f3e394ef21da9c4c83884a57,0,tbeerbower,2014-05-12 22:01:16-04:00,['e3415f2dd9756a368faf10e8f0ace62952548f4f'],15,15,30,17781293,2,,,,14374
79076e4c4f83bb09012bbf91063a50636bda3266,0,Jaimin Jetly,2014-05-12 23:01:47-07:00,['f6ce8c67b7e1b3d7f3e394ef21da9c4c83884a57'],286,205,491,17781784,16,1,1,1,14374
c583c9a688fdb9b875c3bd4f1554ff2986aaa298,0,Dmitry Sen,2014-05-13 14:29:28+03:00,['79076e4c4f83bb09012bbf91063a50636bda3266'],0,4,4,17781788,2,0,0,0,14374
0ddd7686c19f9e1e9c9868d35ede7601e709876a,1,Andrew Onishuk,2014-05-13 17:11:08+03:00,['c583c9a688fdb9b875c3bd4f1554ff2986aaa298'],15,27,42,17781830,6,0,0,0.833333333,14374
0e2d86adc399396a541bd3a1783e72581700cd15,1,Dmitry Sen,2014-05-13 18:37:20+03:00,['0ddd7686c19f9e1e9c9868d35ede7601e709876a'],3,10,13,17781843,1,0.333333333,1,1,14374
6a58d9fc1af93d6fe43a14926651203d8da58272,1,Andrew Onishuk,2014-05-13 18:45:21+03:00,['0e2d86adc399396a541bd3a1783e72581700cd15'],162,345,507,17782350,14,0,0.492957746,1,14374
614db762ffa638c32fd10842f487710d11e33999,1,Andrew Onishuk,2014-05-13 20:49:52+03:00,['6a58d9fc1af93d6fe43a14926651203d8da58272'],0,137,137,17782487,6,0.348484848,1,1,14375
7e96b3c4c31281519c75b295f70049e3ca4cf10f,1,Lisnichenko Dmitro,2014-05-13 21:05:13+03:00,['614db762ffa638c32fd10842f487710d11e33999'],61,138,199,17782686,27,0,0.440677966,1,14375
8394825be9f410a26c9f35d983ae270fdf46fc49,1,tbeerbower,2014-05-13 16:15:19-04:00,['7e96b3c4c31281519c75b295f70049e3ca4cf10f'],158,13,171,17782857,29,,,,14375
f96b9ca1a135faa5012d5e29b5b6873e06e2ac6c,0,Xi Wang,2014-05-13 14:29:43-07:00,['8394825be9f410a26c9f35d983ae270fdf46fc49'],0,1,1,17782858,1,1,1,1,14375
999fba765bd639a1b3ccfdeebb529207a776bdd5,0,Jaimin Jetly,2014-05-13 15:48:06-07:00,['f96b9ca1a135faa5012d5e29b5b6873e06e2ac6c'],20,57,77,17782935,3,0.2,0.2,1,14375
7eab2dcdc78039d45b70dfdda66717a9d5f75c22,1,Srimanth Gunturi,2014-05-13 18:04:50-07:00,['999fba765bd639a1b3ccfdeebb529207a776bdd5'],1,119885,119886,17902821,63,0.60331825,0.753761071,0.787446339,14436
d56db548d86ae1489d216783cd8401baebb643bd,1,Aleksandr Kovalenko,2014-05-14 14:07:30+03:00,['7eab2dcdc78039d45b70dfdda66717a9d5f75c22'],1118,1373,2491,17905312,10,0.477272727,0.340909091,0.121212121,14436
3d1171b06ae77276ce1cb6e6553eb339840d799a,1,Dmitry Sen,2014-05-14 17:00:50+03:00,['d56db548d86ae1489d216783cd8401baebb643bd'],26686,161,26847,17932159,381,0.500671141,0.216107383,0.331543624,14436
17a4e3e9ce7d7816645be0563da03d07ff27eece,1,atkach,2014-05-14 17:43:31+03:00,['3d1171b06ae77276ce1cb6e6553eb339840d799a'],258,1350,1608,17933767,4,0.886872999,1,0.991462113,14436
d1e53b326018e3e33173d150109b588c33437da2,0,Lisnichenko Dmitro,2014-05-14 18:46:10+03:00,['17a4e3e9ce7d7816645be0563da03d07ff27eece'],8,15,23,17933790,4,0.285714286,1,1,14436
0ec758ae6622af9188bab2a8b7b689864792d98b,0,Andrew Onishuk,2014-05-14 19:08:37+03:00,['d1e53b326018e3e33173d150109b588c33437da2'],0,6,6,17933796,2,,,,14436
a13a6e9014957487d57c385909df6f67d3f2492a,1,Andrew Onishuk,2014-05-14 19:11:21+03:00,['0ec758ae6622af9188bab2a8b7b689864792d98b'],0,112,112,17933908,2,1,1,1,14438
cbcc93327f9c383ce1d9ef0db9758c5cf21893ed,1,Oleg Nechiporenko,2014-05-14 19:12:55+03:00,['a13a6e9014957487d57c385909df6f67d3f2492a'],2,328,330,17934238,2,0.511235955,1,1,14438
4b565a706fa7184e4735d233bced94ed1416a947,1,Jaimin Jetly,2014-05-14 10:52:25-07:00,['cbcc93327f9c383ce1d9ef0db9758c5cf21893ed'],38,45,83,17934321,2,,,,14438
5a56988027ee7a02e45e190f5c3ef90a4a34c70d,0,tbeerbower,2014-05-14 15:27:49-04:00,['4b565a706fa7184e4735d233bced94ed1416a947'],326,0,326,17934647,11,,,,14438
ad8335c8c48e6928c3c866b48ae8a9c2ca7fc364,0,Jaimin Jetly,2014-05-14 12:31:34-07:00,['5a56988027ee7a02e45e190f5c3ef90a4a34c70d'],39,0,39,17934686,2,,,,14438
6ef7e33d6d9a826acc0a1339f987cd1434f3bc99,1,Jaimin Jetly,2014-05-14 13:30:25-07:00,['ad8335c8c48e6928c3c866b48ae8a9c2ca7fc364'],2,90,92,17934778,8,1,1,0.571428571,14439
97ffc022638a5a0438dcbe3bb0e120f698f781f4,0,Mahadev Konar,2014-05-14 16:17:16-07:00,['6ef7e33d6d9a826acc0a1339f987cd1434f3bc99'],2,2,4,17934782,1,,,,14439
e6e79b222650803325d62bc724613c01b6686e79,0,tbeerbower,2014-05-14 19:52:53-04:00,['97ffc022638a5a0438dcbe3bb0e120f698f781f4'],0,1088,1088,17935870,5,,,,14443
53eba086dd767f9cf2f9d6da7ac42a2258112c07,0,Aleksandr Kovalenko,2014-05-15 13:52:59+03:00,['e6e79b222650803325d62bc724613c01b6686e79'],11,31,42,17935912,2,0,1,1,14443
7b3a3e067d0134a20a3ea53fa0ca8d8dc287cf1a,1,Aleksandr Kovalenko,2014-05-15 14:01:02+03:00,['53eba086dd767f9cf2f9d6da7ac42a2258112c07'],1,516,517,17936429,8,1,1,1,14449
99c3937c9026ec593377e096c4c4c660a386e380,1,Andrew Onishuk,2014-05-15 15:07:31+03:00,['7b3a3e067d0134a20a3ea53fa0ca8d8dc287cf1a'],3,12,15,17936444,4,,,,14449
3ec1f7815240422b28b0e491c21c85752dffb121,1,Oleg Nechiporenko,2014-05-15 16:27:05+03:00,['99c3937c9026ec593377e096c4c4c660a386e380'],0,603,603,17937047,7,,,,14456
db65324cf7b477a3e64d52fdae611afba9c7e7ce,1,Nate Cole,2014-05-15 09:40:39-04:00,['3ec1f7815240422b28b0e491c21c85752dffb121'],142,429,571,17937618,22,0.368055556,0.777777778,0.951388889,14456
5d9649f92acda2e03a1bd55c26399a48a158c5d8,0,tbeerbower,2014-05-15 10:34:26-04:00,['db65324cf7b477a3e64d52fdae611afba9c7e7ce'],94,0,94,17937712,4,,,,14456
73538ee1fe887a89cc83369deecd17e228274d89,0,Nate Cole,2014-05-15 10:44:19-04:00,['5d9649f92acda2e03a1bd55c26399a48a158c5d8'],13,6,19,17937731,2,1,1,0,14456
548a8c29be2a549cb62ce26730bad2caa3a47d7c,1,aBabiichuk,2014-05-15 17:54:29+03:00,['73538ee1fe887a89cc83369deecd17e228274d89'],1,1,2,17937733,1,,,,14456
cb8d880b814467b8a46bcbe9ed3c32f145d2a349,1,Lisnichenko Dmitro,2014-05-15 18:18:59+03:00,['548a8c29be2a549cb62ce26730bad2caa3a47d7c'],9,23,32,17937765,2,0.454545455,0.454545455,1,14456
bb387b231cce892ac0d54e83fa512c8aa2722543,1,atkach,2014-05-15 18:44:57+03:00,['cb8d880b814467b8a46bcbe9ed3c32f145d2a349'],75,553,628,17938393,7,0.9296875,1,1,14458
090d8f91bb0c01540fa33cdeda0c4867fd190649,0,Vitaly Brodetskyi,2014-05-15 18:53:59+03:00,['bb387b231cce892ac0d54e83fa512c8aa2722543'],48,0,48,17938441,2,0,0,0,14458
787e7eb4c17fd2fbc8dc5ef3d09eb7fa9e51be17,1,Nate Cole,2014-05-15 12:14:11-04:00,['090d8f91bb0c01540fa33cdeda0c4867fd190649'],1,5,6,17938447,1,0,0,1,14458
b85af30d7e18422ce6e23d8a2260707b41122159,0,Myroslav Papirkovskyy,2014-05-15 20:25:40+03:00,['787e7eb4c17fd2fbc8dc5ef3d09eb7fa9e51be17'],52,56,108,17938555,1,1,0.083333333,0,14458
a781a4a2eafb6fceb0a0feb6541717efedd66434,1,Myroslav Papirkovskyy,2014-05-15 20:32:54+03:00,['b85af30d7e18422ce6e23d8a2260707b41122159'],3,1,4,17938559,1,1,0,0,14458
27539cd09c2080a9fe474736af15843f885a16bc,0,Dmitry Sen,2014-05-15 20:48:12+03:00,['a781a4a2eafb6fceb0a0feb6541717efedd66434'],9,8,17,17938576,5,,,,14458
b424b21f01ac0837e717f901f292a0627612d24a,0,Myroslav Papirkovskyy,2014-05-15 21:34:44+03:00,['27539cd09c2080a9fe474736af15843f885a16bc'],3,1,4,17938580,1,0,0,1,14458
e7089d4c786e39b988e79eb1ed6d38cefa99891d,0,subin,2014-05-15 23:55:40+05:18,['a781a4a2eafb6fceb0a0feb6541717efedd66434'],37,95,132,17938712,10,0.526315789,0.526315789,0.5,14458
28c249e5332515a8f98fe18de872380fc1f30faa,0,Subin,2014-05-16 00:36:27+05:18,"['e7089d4c786e39b988e79eb1ed6d38cefa99891d', 'b424b21f01ac0837e717f901f292a0627612d24a']",12,9,21,17938733,6,,,,14458
292505cbc5834e12525907f6adfa511d0ea20dbd,1,Jaimin Jetly,2014-05-15 12:41:05-07:00,['28c249e5332515a8f98fe18de872380fc1f30faa'],0,1,1,17938734,1,,,,14458
7f24f9c86666558aa211dc5184c1df2cf73a3288,1,Myroslav Papirkovskyy,2014-05-15 22:52:31+03:00,['292505cbc5834e12525907f6adfa511d0ea20dbd'],0,12,12,17938746,1,0.9,1,1,14458
fde2cd1c24a66d543e8621a0764a6936db99eb1b,0,Myroslav Papirkovskyy,2014-05-15 22:52:43+03:00,['7f24f9c86666558aa211dc5184c1df2cf73a3288'],4,59,63,17938809,1,0,1,0.806451613,14458
0a3ddafe73ce31861a0f4566d7b44fbfb675d7e0,1,Subin,2014-05-16 01:28:38+05:18,['fde2cd1c24a66d543e8621a0764a6936db99eb1b'],9,12,21,17938830,6,1,1,0,14458
da767d5f6fe07d74190bc09e7a358c95bab4ca01,1,Subin,2014-05-16 01:28:38+05:18,['0a3ddafe73ce31861a0f4566d7b44fbfb675d7e0'],95,37,132,17938962,10,0.473684211,0.473684211,0.5,14458
42d19f377aaf12ec42d6fc6283659eacb1b3503c,1,Srimanth Gunturi,2014-05-15 13:18:02-07:00,['da767d5f6fe07d74190bc09e7a358c95bab4ca01'],0,97,97,17939059,5,1,1,1,14462
6ab57b722a3e52ed39d766f65b69a56a0d0bfa4e,1,Siddharth Wagle,2014-05-15 13:35:02-07:00,['42d19f377aaf12ec42d6fc6283659eacb1b3503c'],11,39,50,17939109,4,1,1,1,14462
f8dcdfcfbd018e09db884f02f4ec7764d08d5904,0,Subin,2014-05-16 01:56:55+05:18,['6ab57b722a3e52ed39d766f65b69a56a0d0bfa4e'],37,95,132,17939241,10,0.526315789,0.526315789,0.5,14462
81173e14dd3ce44dea8c31e4b6d6a995dc61f7c7,1,Siddharth Wagle,2014-05-15 15:14:02-07:00,['f8dcdfcfbd018e09db884f02f4ec7764d08d5904'],12,12,24,17939265,3,0,1,1,14462
a9bc8eb86bbd052e19626e6e6cca21304e8a9380,1,Jaimin Jetly,2014-05-15 15:50:59-07:00,['81173e14dd3ce44dea8c31e4b6d6a995dc61f7c7'],49,74,123,17939388,8,1,1,1,14462
d89501c40f6a5848343a2c93ee8cd5c6ece818ae,1,Jaimin Jetly,2014-05-15 16:58:32-07:00,['a9bc8eb86bbd052e19626e6e6cca21304e8a9380'],3,3,6,17939394,3,,,,14462
ec74a4b14b4214d25601c5c6584361e93885552f,1,Nate Cole,2014-05-15 20:38:53-04:00,['d89501c40f6a5848343a2c93ee8cd5c6ece818ae'],29,88,117,17939511,4,0.787878788,0.787878788,0.696969697,14462
0982aa2e309ac38c8b9215492ee0534d911082bd,1,Myroslav Papirkovskyy,2014-05-16 16:32:49+03:00,['ec74a4b14b4214d25601c5c6584361e93885552f'],3,1,4,17939515,1,0,0,1,14462
4b0cd8fd47fa0715ee2fd8bfdb514b44fe423834,1,Oleg Nechiporenko,2014-05-16 16:43:37+03:00,['0982aa2e309ac38c8b9215492ee0534d911082bd'],163,567,730,17940245,2,0.913043478,1,0.959627329,14462
147844591d99d919dc5bd8b4bc758010b50ce424,1,Dmitry Sen,2014-05-16 17:15:56+03:00,['4b0cd8fd47fa0715ee2fd8bfdb514b44fe423834'],9,8,17,17940262,5,,,,14462
7e8c4aad1b70532f57a077a2bf7341c734065214,0,Andrew Onishuk,2014-05-16 18:13:36+03:00,['147844591d99d919dc5bd8b4bc758010b50ce424'],220,0,220,17940482,50,0.4,0.4,0,14462
221b456c66153898c3a2f1c164e0fa6feaa8b407,1,Vitaly Brodetskyi,2014-05-16 18:25:53+03:00,['7e8c4aad1b70532f57a077a2bf7341c734065214'],41,15,56,17940538,6,,,,14462
358cb97db0d78694b1d6afbd6a5242d92e0c2bdd,1,aBabiichuk,2014-05-16 18:53:10+03:00,['221b456c66153898c3a2f1c164e0fa6feaa8b407'],544,14014,14558,17955096,26,0.703381643,0.804830918,0.964251208,14481
0afeed9fc4a7c04bf9200e90a957a67bc61a1ba3,1,Vitaly Brodetskyi,2014-05-16 19:14:25+03:00,['358cb97db0d78694b1d6afbd6a5242d92e0c2bdd'],14,94,108,17955204,3,0.196078431,1,0.764705882,14481
4b775ad5bdce6f42b53fde495dd530b36825ef49,1,Myroslav Papirkovskyy,2014-05-16 20:53:03+03:00,['0afeed9fc4a7c04bf9200e90a957a67bc61a1ba3'],7,4,11,17955215,1,,,,14481
3373c2497766bcdffdbac1bb79dea200514545c8,0,Subin,2014-05-16 23:12:07+05:18,['4b775ad5bdce6f42b53fde495dd530b36825ef49'],1,1,2,17955217,1,,,,14481
5245702010d731403b06474d9a065c5cb1e47190,0,Srimanth Gunturi,2014-05-16 11:00:36-07:00,['3373c2497766bcdffdbac1bb79dea200514545c8'],0,18,18,17955235,1,,,,14481
cc20626ce7a574dfc0824a074144733687364ca8,1,Andrew Onishuk,2014-05-16 21:44:51+03:00,['5245702010d731403b06474d9a065c5cb1e47190'],0,1,1,17955236,1,0,0,1,14481
618095000d85f3e5bb765065840e5b8f9179acda,1,Xi Wang,2014-05-16 14:25:49-07:00,['cc20626ce7a574dfc0824a074144733687364ca8'],1,1,2,17955238,1,,,,14481
b88de637e36103941e73ba2b500ad1ae4bade7ee,1,Xi Wang,2014-05-16 14:25:49-07:00,['618095000d85f3e5bb765065840e5b8f9179acda'],10,16,26,17955264,2,1,1,1,14481
01a2fa5555a956fc3cd59f878ba6645b79f6dc86,1,John Speidel,2014-05-16 17:47:27-04:00,['b88de637e36103941e73ba2b500ad1ae4bade7ee'],11,31,42,17955306,4,0,0.882352941,1,14481
10968254477d7e2942af455125528afec8610352,1,Jaimin Jetly,2014-05-16 17:22:56-07:00,['01a2fa5555a956fc3cd59f878ba6645b79f6dc86'],1,1,2,17955308,1,,,,14481
221ae2f2350e275521837ed76e2e5edb51e6b467,1,Oleg Nechiporenko,2014-05-19 15:07:10+03:00,['10968254477d7e2942af455125528afec8610352'],11,348,359,17955667,8,0.7125,1,1,14482
6c77d26e1805373e09da21d7c1141dac72bef200,1,Subin,2014-05-19 18:30:09+05:18,['221ae2f2350e275521837ed76e2e5edb51e6b467'],1,1,2,17955669,1,,,,14482
3fc3cdcd379bc20ab5f2d7612ebdab5afcfb9808,1,tbeerbower,2014-05-19 10:01:25-04:00,['6c77d26e1805373e09da21d7c1141dac72bef200'],30,118,148,17955817,11,0.360655738,1,1,14482
d429b30a3ef8111bbc1fa100463039b6a8189ed1,1,aBabiichuk,2014-05-19 19:02:10+03:00,['3fc3cdcd379bc20ab5f2d7612ebdab5afcfb9808'],156,661,817,17956634,2,0.8820059,1,1,14482
a9ca4747fbb6579060371a41c2481edd8f3aca3c,1,Srimanth Gunturi,2014-05-19 09:22:59-07:00,['d429b30a3ef8111bbc1fa100463039b6a8189ed1'],0,925,925,17957559,16,0.449871465,0.611825193,0.904884319,14496
f11f0b3f809d60928b52a824523e5c9cd6121117,1,Dmitry Sen,2014-05-19 20:07:57+03:00,['a9ca4747fbb6579060371a41c2481edd8f3aca3c'],3,67,70,17957629,4,0.888888889,0.911111111,0.666666667,14496
dd9cb4ee5b9746aa51e42d7f81e7218d03db1514,1,Andrew Onishuk,2014-05-19 21:09:20+03:00,['f11f0b3f809d60928b52a824523e5c9cd6121117'],5,19,24,17957653,8,0,0.444444444,1,14496
4abd45570e67b86ba44f94ddf7b7501e3cbbf491,1,Andrew Onishuk,2014-05-19 21:14:52+03:00,['dd9cb4ee5b9746aa51e42d7f81e7218d03db1514'],5,24,29,17957682,6,0,1,1,14496
dd85e2feb69bbe1c57d17cd60b69a2a3e111d9b1,1,Aleksandr Kovalenko,2014-05-19 21:21:18+03:00,['4abd45570e67b86ba44f94ddf7b7501e3cbbf491'],7,432,439,17958121,14,1,1,1,14505
742f5af65f4acc5de2fdcce272c839647eafc489,1,tbeerbower,2014-05-19 14:22:36-04:00,['dd85e2feb69bbe1c57d17cd60b69a2a3e111d9b1'],335,349,684,17958805,17,,,,14506
8b1d76cdf4e0d8e54ba157411d997a4e1e00bc3d,1,Xi Wang,2014-05-19 11:50:47-07:00,['742f5af65f4acc5de2fdcce272c839647eafc489'],26,411,437,17959242,7,0.619402985,1,1,14506
7163ea266ea9c1eb9154cff81629d8cd5a3bd9e3,1,Jaimin Jetly,2014-05-19 12:05:21-07:00,['8b1d76cdf4e0d8e54ba157411d997a4e1e00bc3d'],3,3,6,17959248,1,,,,14506
9312b89d0755848d0b6c5c959f0ee7662135ae88,0,Srimanth Gunturi,2014-05-19 14:26:03-07:00,['7163ea266ea9c1eb9154cff81629d8cd5a3bd9e3'],1,1,2,17959250,1,,,,14506
e03d242834f1855f0472670fb3d3511952e7f3e4,1,Srimanth Gunturi,2014-05-19 16:27:49-07:00,['9312b89d0755848d0b6c5c959f0ee7662135ae88'],95,343,438,17959688,9,0,0,0.607142857,14509
6b11e6d4b3be19d4baa11f1e665f9b1fde25fe8d,1,Myroslav Papirkovskyy,2014-05-20 02:47:46+03:00,['e03d242834f1855f0472670fb3d3511952e7f3e4'],5,32,37,17959725,7,1,1,1,14509
2220427aae464b1fde616937457745fe9823177f,1,Yusaku Sako,2014-05-19 18:19:02-07:00,['6b11e6d4b3be19d4baa11f1e665f9b1fde25fe8d'],56,24,80,17959805,4,0,0,0,14509
b6c56e80730c5847d08c0cc0243858188ad86cf8,0,Yusaku Sako,2014-05-19 18:19:17-07:00,['2220427aae464b1fde616937457745fe9823177f'],22,27,49,17959854,2,,,,14509
07193440d619c359bb5a21ec0644f015a6cd19fd,1,Oleg Nechiporenko,2014-05-20 14:12:24+03:00,['b6c56e80730c5847d08c0cc0243858188ad86cf8'],3,30,33,17959887,2,1,1,1,14509
de9097218a6bdb9509bfe2f25c2436cb99b03def,1,Aleksandr Kovalenko,2014-05-20 15:01:56+03:00,['07193440d619c359bb5a21ec0644f015a6cd19fd'],0,288,288,17960175,4,1,1,1,14512
6d029a22764bb30102b9a5beb2792040f0632515,0,Aleksandr Kovalenko,2014-05-20 15:08:24+03:00,['de9097218a6bdb9509bfe2f25c2436cb99b03def'],0,211,211,17960386,3,1,1,0.964912281,14514
82ffda43687b3f792e0247925486d172289abf7f,1,Aleksandr Kovalenko,2014-05-20 15:14:01+03:00,['6d029a22764bb30102b9a5beb2792040f0632515'],3,2816,2819,17963205,18,1,1,1,14528
9e92faa563657e2bffc21c3f9d0d5cbef5b79d59,1,Oleg Nechiporenko,2014-05-20 16:06:25+03:00,['82ffda43687b3f792e0247925486d172289abf7f'],24,295,319,17963524,6,1,1,1,14533
30fc629c85267486a35ce172d2053370dff33305,1,tbeerbower,2014-05-20 09:06:53-04:00,['9e92faa563657e2bffc21c3f9d0d5cbef5b79d59'],2,2,4,17963528,2,,,,14533
fa6fa284280a6158908505b47336bdbc7f165d49,1,Dmitry Sen,2014-05-20 16:26:26+03:00,['30fc629c85267486a35ce172d2053370dff33305'],11,131,142,17963670,6,0.310810811,1,0.918918919,14533
67c5070149b73c2867b5344687345a275bdb49b2,1,Oleg Nechiporenko,2014-05-20 16:30:40+03:00,['fa6fa284280a6158908505b47336bdbc7f165d49'],3,10,13,17963683,3,,,,14533
ad3ff7ed62a6ffb87af041593dcb30918b24db56,1,tbeerbower,2014-05-20 10:17:49-04:00,['67c5070149b73c2867b5344687345a275bdb49b2'],0,288,288,17963971,6,1,1,0.709677419,14537
836691a65b16e2eb3cad1d8a1979444ad9e532f8,1,Andrew Onishuk,2014-05-20 18:31:59+03:00,['ad3ff7ed62a6ffb87af041593dcb30918b24db56'],0,86,86,17964057,3,,,,14540
2bd7b1a09d2d4c5444fa344c2091370cd6258ddb,0,Lisnichenko Dmitro,2014-05-20 20:35:51+03:00,['836691a65b16e2eb3cad1d8a1979444ad9e532f8'],1,2,3,17964060,2,,,,14540
25088b2d1d2ad5b602ac4543136f323815803e36,1,Oleg Nechiporenko,2014-05-21 15:00:54+03:00,['2bd7b1a09d2d4c5444fa344c2091370cd6258ddb'],0,1,1,17964061,1,1,1,1,14540
6641dbfa6adfa84ad7ccf22afd0742f6c71e2ab7,0,Andrew Onishuk,2014-05-21 15:08:44+03:00,['25088b2d1d2ad5b602ac4543136f323815803e36'],0,2,2,17964063,1,,,,14540
48ca3fe0b337f244b1f081c27c27e5442ff36074,1,Andrew Onishuk,2014-05-21 17:10:29+03:00,['6641dbfa6adfa84ad7ccf22afd0742f6c71e2ab7'],0,17,17,17964080,1,,,,14540
b7c9651ec15ea6ddec8fb634caabbb4bea8b6164,1,Vitaly Brodetskyi,2014-05-21 18:19:02+03:00,['48ca3fe0b337f244b1f081c27c27e5442ff36074'],2,50,52,17964132,10,,,,14540
43dc645ecb24f1cba8d84994266612c8ffe440e8,1,aBabiichuk,2014-05-21 18:56:53+03:00,['b7c9651ec15ea6ddec8fb634caabbb4bea8b6164'],0,41,41,17964173,5,0.148148148,0.222222222,1,14540
7dc9d8c531c28e76a1de1ca806c7ca95007cb513,1,Alex Antonenko,2014-05-21 19:01:47+03:00,['43dc645ecb24f1cba8d84994266612c8ffe440e8'],24,32,56,17964229,2,1,1,1,14540
d4f502272e4f249509c96bfdb76d4b831187a5f7,1,Alex Antonenko,2014-05-21 19:28:58+03:00,['7dc9d8c531c28e76a1de1ca806c7ca95007cb513'],25,122,147,17964376,15,1,1,1,14543
d4afecaf06e642c96ecf7d55eb228e845fbbfd29,1,Aleksandr Kovalenko,2014-05-21 20:12:05+03:00,['d4f502272e4f249509c96bfdb76d4b831187a5f7'],14,214,228,17964604,7,0.711864407,1,1,14545
d600e5434d8bb83aa0a30f66644a8c739aab409a,1,aBabiichuk,2014-05-21 20:16:44+03:00,['d4afecaf06e642c96ecf7d55eb228e845fbbfd29'],7,12,19,17964623,4,0.333333333,0.333333333,1,14545
e2de8bd1a8caf6b24de177f37b60db65e1dc4d49,1,Alex Antonenko,2014-05-21 23:37:43+03:00,['d600e5434d8bb83aa0a30f66644a8c739aab409a'],25,107,132,17964755,8,1,1,1,14546
71da26d27ab32619515b569acb9005b251e809b3,0,Xi Wang,2014-05-21 14:33:36-07:00,['e2de8bd1a8caf6b24de177f37b60db65e1dc4d49'],0,2,2,17964757,1,1,1,1,14546
922f8fe9209c5fd07081b23fef19afd781745cad,1,Xi Wang,2014-05-21 15:33:51-07:00,['71da26d27ab32619515b569acb9005b251e809b3'],1,1,2,17964759,1,,,,14546
13ab92caffc6473ff7c4b0043b04df3a3c263f8c,1,Srimanth Gunturi,2014-05-21 16:03:34-07:00,['922f8fe9209c5fd07081b23fef19afd781745cad'],17,20,37,17964796,1,,,,14546
4780d99ca43c4f98be60f306e1c18e0118307e53,0,Jaimin Jetly,2014-05-21 18:58:12-07:00,['13ab92caffc6473ff7c4b0043b04df3a3c263f8c'],72,39,111,17964907,3,,,,14546
3eec911026b0e86650ccf35905093deddb12c865,1,Srimanth Gunturi,2014-05-21 21:02:50-07:00,['4780d99ca43c4f98be60f306e1c18e0118307e53'],41,828,869,17965776,14,0.392655367,0.644067797,0.988700565,14549
e3da23b4c0a894e90e65eb5408cc501a2158861d,1,atkach,2014-05-22 12:47:47+03:00,['3eec911026b0e86650ccf35905093deddb12c865'],141,343,484,17966260,6,0.876923077,0.876923077,0.992307692,14549
8c3196390ea567cb10fdfc9a1a3bafbb157f9360,1,atkach,2014-05-22 13:44:12+03:00,['e3da23b4c0a894e90e65eb5408cc501a2158861d'],109,96,205,17966465,4,1,1,1,14549
1423a43d035493a40bf54ac674fea1decb4de5e3,1,aBabiichuk,2014-05-22 14:15:43+03:00,['8c3196390ea567cb10fdfc9a1a3bafbb157f9360'],1,1,2,17966467,1,,,,14549
fd97403125bf584459ce900ffcb7e7fc208b28d7,0,Andrew Onishuk,2014-05-22 16:07:50+03:00,['1423a43d035493a40bf54ac674fea1decb4de5e3'],18,60,78,17966545,17,1,1,1,14550
60cbd69e7c0a82d8f86963697296be0d9f454a6e,1,atkach,2014-05-22 16:23:45+03:00,['fd97403125bf584459ce900ffcb7e7fc208b28d7'],7,151,158,17966703,7,1,1,0.682926829,14551
79eb5f5bd49e2122c3f608b82a3b991762ebac91,1,Oleg Nechiporenko,2014-05-22 17:42:45+03:00,['60cbd69e7c0a82d8f86963697296be0d9f454a6e'],6674,6961,13635,17980338,19,0,0.035714286,0.916666667,14556
9b940927d7468b3423ab4f8602568ebbffeb048e,1,Nate Cole,2014-05-22 10:51:46-04:00,['79eb5f5bd49e2122c3f608b82a3b991762ebac91'],78,66,144,17980482,14,0,0,0,14556
f0cb0d411954e6199606727a6f6bbb996e6d2595,1,Andrew Onishuk,2014-05-22 18:00:02+03:00,['9b940927d7468b3423ab4f8602568ebbffeb048e'],75,205,280,17980762,11,1,0,0,14560
513afd873c5a093db85461358c5a4bbbf658dee7,1,Siddharth Wagle,2014-05-22 10:05:10-07:00,['f0cb0d411954e6199606727a6f6bbb996e6d2595'],86,782,868,17981630,24,0.554817276,0.803986711,0.910299003,14567
7e9a6df31c0068c453eafa4386e875b6bd15f819,1,Siddharth Wagle,2014-05-22 10:05:10-07:00,['513afd873c5a093db85461358c5a4bbbf658dee7'],0,17,17,17981647,2,0.363636364,1,1,14567
f3db95ff8af20f81c946aecff87d826ef89b786d,0,Siddharth Wagle,2014-05-22 10:19:58-07:00,['7e9a6df31c0068c453eafa4386e875b6bd15f819'],2,2,4,17981651,2,,,,14567
db7c6f50ca0cecf9e84b789d0d6ec543902fdc21,0,Siddharth Wagle,2014-05-22 10:36:04-07:00,['f3db95ff8af20f81c946aecff87d826ef89b786d'],2,2,4,17981655,1,,,,14567
4c45504be3347974f18114de89eb5891f4afd98e,1,Mahadev Konar,2014-05-22 10:46:31-07:00,['db7c6f50ca0cecf9e84b789d0d6ec543902fdc21'],1,25,26,17981681,3,0,1,1,14567
199a0916a2b5f1e6e935018865ee63888e75a257,1,Vitaly Brodetskyi,2014-05-22 18:43:55+03:00,['4c45504be3347974f18114de89eb5891f4afd98e'],10,119,129,17981810,1,0.144927536,0.144927536,1,14567
5376252a60fd24164402e9a276e23bce0c1d05fa,1,Siddharth Wagle,2014-05-22 13:40:59-07:00,['199a0916a2b5f1e6e935018865ee63888e75a257'],16,35,51,17981861,1,0,1,1,14567
42b08d22a519c40f81195c511ed5afd2ab20600d,1,Dmitry Sen,2014-05-23 00:07:34+03:00,['5376252a60fd24164402e9a276e23bce0c1d05fa'],36,497,533,17982394,11,0.249027237,0.59922179,0.918287938,14568
e924455a218853ac3c8168a3b369656a08ba7817,1,Xi Wang,2014-05-22 16:04:12-07:00,['42b08d22a519c40f81195c511ed5afd2ab20600d'],5,24,29,17982423,2,0.923076923,1,1,14568
f715c3a4f095e815f87215e3f1bf6e2b7c30745c,1,Jaimin Jetly,2014-05-22 16:37:00-07:00,['e924455a218853ac3c8168a3b369656a08ba7817'],0,8,8,17982431,2,0.375,0.375,1,14568
f58782c7405930d6629f6f819d84d64d32d92a97,1,Srimanth Gunturi,2014-05-22 18:36:52-07:00,['f715c3a4f095e815f87215e3f1bf6e2b7c30745c'],15,340,355,17982786,6,0.034934498,0.065502183,0.471615721,14569
6d9f0d3dbc16a6951c581ff16e041ab63120e156,1,Aleksandr Kovalenko,2014-05-23 13:48:03+03:00,['f58782c7405930d6629f6f819d84d64d32d92a97'],74,211,285,17983071,13,1,1,1,14570
88d72aab889f4f1a4d0317996b4ace70ee41a66b,1,Oleg Nechiporenko,2014-05-23 14:10:26+03:00,['6d9f0d3dbc16a6951c581ff16e041ab63120e156'],6,104,110,17983181,7,0.956043956,0.989010989,0.945054945,14572
f04324e090d3e714b4413686018c346d0f56e682,1,Alex Antonenko,2014-05-23 14:52:34+03:00,['88d72aab889f4f1a4d0317996b4ace70ee41a66b'],3,394,397,17983578,6,1,1,1,14576
4461d6b1d2df367408001a6ee214cffa47008154,1,Aleksandr Kovalenko,2014-05-23 15:50:39+03:00,['f04324e090d3e714b4413686018c346d0f56e682'],11,135,146,17983724,6,1,1,1,14578
30d91582f9ea8c5a3ed06e37dc18d5ca97eab939,1,Alex Antonenko,2014-05-23 16:59:49+03:00,['4461d6b1d2df367408001a6ee214cffa47008154'],24,34,58,17983782,2,1,1,0,14578
2b235e35398069634f066462eacad2968c2c4908,0,Lisnichenko Dmitro,2014-05-23 17:25:27+03:00,['30d91582f9ea8c5a3ed06e37dc18d5ca97eab939'],17,43,60,17983842,2,1,1,1,14578
76be68182b3665c63157d182d0c880fa5cd5724e,1,Andrew Onishuk,2014-05-23 18:06:08+03:00,['2b235e35398069634f066462eacad2968c2c4908'],63,99,162,17984004,8,1,0,0,14578
82a2b9bcbefe66303c4c2c9e68a6beb432f4db08,1,Andrew Onishuk,2014-05-23 18:07:52+03:00,['76be68182b3665c63157d182d0c880fa5cd5724e'],27,55,82,17984086,4,,,,14578
24ee41cc9c8f758f1af8be5797ffec1b54009812,1,Aleksandr Kovalenko,2014-05-23 19:28:14+03:00,['82a2b9bcbefe66303c4c2c9e68a6beb432f4db08'],18,165,183,17984269,8,1,1,1,14580
546878b820f73fec3c92823a6e8dbd4beb183dac,1,Srimanth Gunturi,2014-05-23 09:30:52-07:00,['24ee41cc9c8f758f1af8be5797ffec1b54009812'],10,108,118,17984387,4,0.209677419,0.741935484,0.677419355,14580
9afd4da63d58c0753c322b8555ac47e4cd85e0c1,1,Aleksandr Kovalenko,2014-05-23 20:26:45+03:00,['546878b820f73fec3c92823a6e8dbd4beb183dac'],6,6,12,17984399,3,,,,14580
b5471945f46093c44051b3aeb4500d8cf762fe6d,1,tbeerbower,2014-05-23 14:00:04-04:00,['9afd4da63d58c0753c322b8555ac47e4cd85e0c1'],51,196,247,17984646,2,0.23655914,1,1,14580
4c04bf87204f0616d36e4e42e91f5cc6d6efeda3,1,Nate Cole,2014-05-23 15:32:46-04:00,['b5471945f46093c44051b3aeb4500d8cf762fe6d'],239,540,779,17985425,24,0.09047619,0.761904762,0.952380952,14580
6d8a9c572dcb6afda99c2b5a354e25b281ebc741,0,Srimanth Gunturi,2014-05-24 09:50:34-07:00,['4c04bf87204f0616d36e4e42e91f5cc6d6efeda3'],20,8,28,17985453,4,,,,14580
2234623b938729d842243d0c38fff35602ab141c,1,Srimanth Gunturi,2014-05-25 00:19:05-07:00,['6d8a9c572dcb6afda99c2b5a354e25b281ebc741'],3,479,482,17985935,9,0.652542373,0.618644068,0.983050847,14584
790217c667a07865f666a1f3cc5de2f3ad2fe4cb,1,Nate Cole,2014-05-25 13:34:25-04:00,['2234623b938729d842243d0c38fff35602ab141c'],99,285,384,17986319,4,0,0.649350649,0.662337662,14586
2350f476d4ed454f8e45342d91198b35bdc3b052,0,Andrew Onishuk,2014-05-26 13:43:19+03:00,['790217c667a07865f666a1f3cc5de2f3ad2fe4cb'],0,11,11,17986330,1,,,,14586
6f740bed9123b264d0d7f086ed42c0bf1665ba5f,0,Andrew Onishuk,2014-05-26 14:05:22+03:00,['2350f476d4ed454f8e45342d91198b35bdc3b052'],0,6,6,17986336,2,,,,14586
572e2a3c13830e5cc6ea2e8a2161d75b0b3279b9,1,atkach,2014-05-26 15:11:08+03:00,['6f740bed9123b264d0d7f086ed42c0bf1665ba5f'],206,316,522,17986858,38,0,0,0,14587
0bbf2f32ababbc20790da60fa672d82a2e0e8740,1,Alex Antonenko,2014-05-26 15:20:45+03:00,['572e2a3c13830e5cc6ea2e8a2161d75b0b3279b9'],309,158,467,17987325,12,0.577777778,1,1,14589
1f51888aacef8031413655821733e5c8ee6d986e,1,Andrew Onishuk,2014-05-26 16:26:27+03:00,['0bbf2f32ababbc20790da60fa672d82a2e0e8740'],1,5,6,17987331,1,,,,14589
bed137b78c32833e0165ffcb5e89d7b9c3e66325,1,Oleg Nechiporenko,2014-05-26 17:23:46+03:00,['1f51888aacef8031413655821733e5c8ee6d986e'],9,585,594,17987925,9,1,1,0.865384615,14591
fe12ebc04b849b8340b9bd46ced0ac0aca579114,1,Lisnichenko Dmitro,2014-05-26 17:24:14+03:00,['bed137b78c32833e0165ffcb5e89d7b9c3e66325'],9,9,18,17987943,1,,,,14591
0c584e6e176cb93e3c04344f0670f8cea26301d8,1,Andrew Onishuk,2014-05-26 18:54:59+03:00,['fe12ebc04b849b8340b9bd46ced0ac0aca579114'],1,1,2,17987945,1,,,,14591
7d5fc02426d6b4eaa31d7aef173ea073dce2a3e9,0,Andrew Onishuk,2014-05-26 19:49:49+03:00,['0c584e6e176cb93e3c04344f0670f8cea26301d8'],0,48,48,17987993,4,0.416666667,1,1,14591
52806bd7fdb392f6e84645ec9e62238a6bffaa05,1,Sumit Mohanty,2014-05-26 17:42:24-07:00,['7d5fc02426d6b4eaa31d7aef173ea073dce2a3e9'],701,1113,1814,17989807,5,0.35971223,0.64028777,0.589928058,14593
5c84352f51b19c28c745beb5cc5ac9f7ba36bd23,1,atkach,2014-05-27 12:41:09+03:00,['52806bd7fdb392f6e84645ec9e62238a6bffaa05'],81,328,409,17990216,11,1,1,1,14595
f42404055afee812b38c1bd339379346d319a840,1,Oleg Nechiporenko,2014-05-27 14:41:27+03:00,['5c84352f51b19c28c745beb5cc5ac9f7ba36bd23'],144,401,545,17990761,13,0.573170732,1,0.93902439,14596
fbb6e7e4c89068f84e15ac3699459a7b72b001c4,0,Andrew Onishuk,2014-05-27 18:30:31+03:00,['f42404055afee812b38c1bd339379346d319a840'],5,10,15,17990776,1,0,0,1,14596
b28d3618485784321fb9b648c8c6fa78e6c12d49,1,Andrew Onishuk,2014-05-27 20:42:19+03:00,['fbb6e7e4c89068f84e15ac3699459a7b72b001c4'],4,4,8,17990784,2,,,,14596
66d8d5bf7b9e019bf8688bb9be915befa89562d0,1,Alex Antonenko,2014-05-27 21:14:22+03:00,['b28d3618485784321fb9b648c8c6fa78e6c12d49'],3,12,15,17990799,1,0,0,1,14596
c7736445d5feb6a19eb31c7692cfdab4e60e1941,1,Srimanth Gunturi,2014-05-27 13:13:24-07:00,['66d8d5bf7b9e019bf8688bb9be915befa89562d0'],162,384,546,17991345,5,0.22,0.573333333,0.84,14596
889675b5856508451dbfffe6ad6cbd9823875776,1,Srimanth Gunturi,2014-05-27 13:46:03-07:00,['c7736445d5feb6a19eb31c7692cfdab4e60e1941'],0,2,2,17991347,1,0,0,1,14596
709f3d6cd532949364db27af6ef94765108353b9,1,Jaimin Jetly,2014-05-27 19:05:04-07:00,['889675b5856508451dbfffe6ad6cbd9823875776'],2,2,4,17991351,1,,,,14596
44b87c60dd2951eadc7263786e3961411d189ec0,1,Srimanth Gunturi,2014-05-27 20:17:20-07:00,['709f3d6cd532949364db27af6ef94765108353b9'],119,152,271,17991622,2,0.444444444,0.444444444,0.444444444,14596
d5453695e19ff8b4aa7e1fd01318b7d8193f9699,0,Artem Baranchuk,2014-05-28 15:11:07+03:00,['44b87c60dd2951eadc7263786e3961411d189ec0'],1,185,186,17991808,5,0.063492063,0.634920635,0.984126984,14598
4ab7c4259ea481eb64ffc227f7b4130d89865432,0,Andrew Onishuk,2014-05-28 17:10:06+03:00,['d5453695e19ff8b4aa7e1fd01318b7d8193f9699'],1,1,2,17991810,1,,,,14598
c8e86f8ffd0e8767ce54899f1d400204be81f5f3,1,Vitaly Brodetskyi,2014-05-28 19:31:45+03:00,['4ab7c4259ea481eb64ffc227f7b4130d89865432'],68,485,553,17992363,14,0.043624161,0.422818792,0.352348993,14598
ad089e812b7fb18ed4c4fa28be00ae7cf6d048b8,0,tbeerbower,2014-05-28 13:06:29-04:00,['c8e86f8ffd0e8767ce54899f1d400204be81f5f3'],14,191,205,17992568,10,,,,14598
9d5a48baa72ba51b52f0b0178a3aca141758eb79,1,Sumit Mohanty,2014-05-28 10:08:50-07:00,['ad089e812b7fb18ed4c4fa28be00ae7cf6d048b8'],17,52,69,17992637,2,0.777777778,1,1,14598
bbab3661b464b6a647207444067612fd30f75ddf,1,Jaimin Jetly,2014-05-28 10:11:28-07:00,['9d5a48baa72ba51b52f0b0178a3aca141758eb79'],2,2,4,17992641,1,0,0,0,14598
c3a41c1fa450dec9367bf3e78d84d914ac57f972,0,Mahadev Konar,2014-05-28 11:06:34-07:00,['bbab3661b464b6a647207444067612fd30f75ddf'],0,4,4,17992645,1,,,,14598
8ec1837c3de8defafdc3074e68d38cb2bce65f61,0,Vitaly Brodetskyi,2014-05-28 21:10:13+03:00,['c3a41c1fa450dec9367bf3e78d84d914ac57f972'],126,3,129,17992774,3,1,0.780952381,0,14598
ccdd4af03b3ca7d81b670c2f27d086ada481adf9,0,Mahadev Konar,2014-05-28 12:16:29-07:00,['8ec1837c3de8defafdc3074e68d38cb2bce65f61'],2,1,3,17992777,1,,,,14598
6d14390a3691f249b8465e274605345877b0902a,1,tbeerbower,2014-05-28 16:22:06-04:00,['ccdd4af03b3ca7d81b670c2f27d086ada481adf9'],76,956,1032,17993809,16,0.976851852,1,0.819444444,14606
889dec5b1ed519bcc8a1cdccf0dbd46bd4b860f3,0,Nate Cole,2014-05-28 17:20:15-04:00,['6d14390a3691f249b8465e274605345877b0902a'],1,1,2,17993811,1,,,,14606
60436ae70109a23bfca55cdca01e6c469c54fcb5,1,Srimanth Gunturi,2014-05-28 14:27:08-07:00,['889dec5b1ed519bcc8a1cdccf0dbd46bd4b860f3'],69,314,383,17994194,6,1,1,1,14606
c36bbc564347cfbff6fe24583693045cac510d3e,0,Siddharth Wagle,2014-05-28 15:42:55-07:00,['60436ae70109a23bfca55cdca01e6c469c54fcb5'],2,2,4,17994198,1,,,,14606
00135dff92e0402a77c48420621a2d49276e8970,1,Jaimin Jetly,2014-05-28 16:09:13-07:00,['c36bbc564347cfbff6fe24583693045cac510d3e'],3,2,5,17994203,2,0,0,0,14606
1064ade010ce05ca6e13a25d1df25bcc4290a8b9,1,Jaimin Jetly,2014-05-28 16:11:45-07:00,['00135dff92e0402a77c48420621a2d49276e8970'],29,235,264,17994467,9,0.8,1,1,14608
53e3d8dd018e694a79982179f9f5fabffd275369,1,Srimanth Gunturi,2014-05-28 16:37:59-07:00,['1064ade010ce05ca6e13a25d1df25bcc4290a8b9'],13,234,247,17994714,7,0.256880734,0.733944954,0.770642202,14608
d1c4a93fe651132b29b26c230b960ddd7b9b3362,1,Sumit Mohanty,2014-05-28 16:52:09-07:00,['53e3d8dd018e694a79982179f9f5fabffd275369'],183,463,646,17995360,6,0.269607843,0.921568627,0.661764706,14609
ebe04d4b82131f32ca357f07b77f3f578abe5932,1,Xi Wang,2014-05-28 18:29:03-07:00,['d1c4a93fe651132b29b26c230b960ddd7b9b3362'],3,79,82,17995442,4,1,1,1,14609
9099842a0e010402d07f542cf5b964d364d7ae85,0,Siddharth Wagle,2014-05-28 18:46:25-07:00,['ebe04d4b82131f32ca357f07b77f3f578abe5932'],3,19,22,17995464,2,1,1,1,14609
c4a6597721ad48bcebe9a8905e1251132cb79e5c,0,Siddharth Wagle,2014-05-28 18:46:25-07:00,['9099842a0e010402d07f542cf5b964d364d7ae85'],1,0,1,17995465,1,,,,14609
776c9d7042ea3a5cd03dc5e24280a79c435caf9a,1,Srimanth Gunturi,2014-05-28 20:06:38-07:00,['c4a6597721ad48bcebe9a8905e1251132cb79e5c'],45,70,115,17995580,2,0,0,0.541666667,14609
ff2b111b15dd690c4aa73b04b8e6fe564e0f29c9,1,atkach,2014-05-29 15:47:50+03:00,['776c9d7042ea3a5cd03dc5e24280a79c435caf9a'],415,586,1001,17996581,12,1,1,0.0625,14609
a384a0e1c4cca0673250ff0cf492e7af942cd64d,0,atkach,2014-05-29 17:43:26+03:00,['ff2b111b15dd690c4aa73b04b8e6fe564e0f29c9'],2,2,4,17996585,2,,,,14609
949ecd21b4001ccd763ad82985ec6efd96eef6ff,1,Myroslav Papirkovskyy,2014-05-29 18:15:40+03:00,['a384a0e1c4cca0673250ff0cf492e7af942cd64d'],12,200,212,17996797,7,0.180327869,0.598360656,0.778688525,14609
3618ecbf7837b360b99e59a9c356bf2cac01596f,0,Jaimin Jetly,2014-05-29 10:30:30-07:00,['949ecd21b4001ccd763ad82985ec6efd96eef6ff'],3,7,10,17996807,2,1,1,1,14609
45adeff46e476e7062bca07d6fa4ad10bf945fc3,1,Oleg Nechiporenko,2014-05-29 20:43:18+03:00,['3618ecbf7837b360b99e59a9c356bf2cac01596f'],41,24433,24474,18021281,35,0.673701026,0.744240794,0.912308727,14631
66848d4d693dcfcb83e846f65d6fd1dd75a604d5,1,Alex Antonenko,2014-05-29 22:12:15+03:00,['45adeff46e476e7062bca07d6fa4ad10bf945fc3'],1,11,12,18021293,1,1,1,1,14631
d4a037036687ac1f2c28a5d8869ef5152a01d1a8,1,tbeerbower,2014-05-29 15:30:30-04:00,['66848d4d693dcfcb83e846f65d6fd1dd75a604d5'],6,357,363,18021656,5,0.6796875,1,0.78125,14632
dc917a9f275710f458d60f1552a749a3f52db3db,0,Artem Baranchuk,2014-05-29 23:05:21+03:00,['d4a037036687ac1f2c28a5d8869ef5152a01d1a8'],66,44,110,18021766,2,1,0,0,14632
bf2484a7d965b6dc0270e04212c76e28d4f0b30d,1,Jaimin Jetly,2014-05-29 13:49:47-07:00,['dc917a9f275710f458d60f1552a749a3f52db3db'],1,1,2,18021768,1,,,,14632
0ba293c1ea95eaf2eb9d01ae24fbe727ab18a24e,1,Srimanth Gunturi,2014-05-29 14:26:50-07:00,['bf2484a7d965b6dc0270e04212c76e28d4f0b30d'],1,6,7,18021775,1,,,,14632
48e3201efd5e9c486cabe17b5db68153ceb32f49,0,Xi Wang,2014-05-29 15:09:03-07:00,['0ba293c1ea95eaf2eb9d01ae24fbe727ab18a24e'],6,6,12,18021787,2,,,,14632
36439d08c2eaa81910f301e037800c53f8f4b4ea,1,Alex Antonenko,2014-05-30 01:32:33+03:00,['48e3201efd5e9c486cabe17b5db68153ceb32f49'],8,50,58,18021845,4,1,1,1,14632
db7f9b6ad9d2fa77c253ecf755efd0a5bb71bada,1,Alex Antonenko,2014-05-30 01:40:14+03:00,['36439d08c2eaa81910f301e037800c53f8f4b4ea'],0,10,10,18021855,1,,,,14632
6826ef4c373179b1f5fa5550cd639d5c224239f9,0,Jaimin Jetly,2014-05-29 15:51:55-07:00,['db7f9b6ad9d2fa77c253ecf755efd0a5bb71bada'],16,37,53,18021908,1,,,,14632
fb77bc4b9f4ec64f787cdc24f3111c8adc42ae41,1,Jaimin Jetly,2014-05-29 15:57:16-07:00,['6826ef4c373179b1f5fa5550cd639d5c224239f9'],6,6,12,18021920,2,,,,14632
6962851fdd62095383c1cfda0eb61b0518f3013d,1,Jaimin Jetly,2014-05-29 16:10:05-07:00,['fb77bc4b9f4ec64f787cdc24f3111c8adc42ae41'],36,58,94,18022014,1,1,1,1,14632
91b56006a863d5235e5eacfd9ec4ce5dcd39d535,0,Jaimin Jetly,2014-05-29 19:11:44-07:00,['6962851fdd62095383c1cfda0eb61b0518f3013d'],1,1,2,18022016,1,,,,14632
31b7da99838cdac15c875c913ddc27466a0f897b,1,tbeerbower,2014-05-30 05:53:46-04:00,['91b56006a863d5235e5eacfd9ec4ce5dcd39d535'],28,284,312,18022328,10,0.521276596,0.989361702,1,14632
fa9903f8080438e3c372ec542a5f6be0cdc67cc5,0,tbeerbower,2014-05-30 05:58:34-04:00,['31b7da99838cdac15c875c913ddc27466a0f897b'],1,2,3,18022331,1,,,,14632
b625ae435b00ef034ae339bdaf5751befa9ee83c,1,Vitaly Brodetskyi,2014-05-30 12:35:51+03:00,['fa9903f8080438e3c372ec542a5f6be0cdc67cc5'],2,25,27,18022358,2,0,0.631578947,0.368421053,14632
4d4b62f8067cde79e72e48a5d2576c692e0446af,1,Nate Cole,2014-05-30 10:17:42-04:00,['b625ae435b00ef034ae339bdaf5751befa9ee83c'],10,39,49,18022407,1,0,0,0,14632
3d66c8efc5bf40bf2e825648513b24b32fad8245,1,Dmitry Sen,2014-05-30 17:22:10+03:00,['4d4b62f8067cde79e72e48a5d2576c692e0446af'],54,81,135,18022542,7,1,1,0.4,14632
1a59711d180f54b117867a5bc6c69730a77b7d09,1,Myroslav Papirkovskyy,2014-05-30 17:39:01+03:00,['3d66c8efc5bf40bf2e825648513b24b32fad8245'],13,16,29,18022571,1,,,,14632
1b038795381cae1a796d4904422e9bd622b3aa80,1,Myroslav Papirkovskyy,2014-05-30 17:39:02+03:00,['1a59711d180f54b117867a5bc6c69730a77b7d09'],13,27,40,18022611,5,0,1,1,14632
7360a79b7add328d6befdebabe0a9d7009ac02ef,1,Lisnichenko Dmitro,2014-05-30 18:27:08+03:00,['1b038795381cae1a796d4904422e9bd622b3aa80'],17,17,34,18022645,2,1,1,0,14632
954a9cbb8f32de1d0d4d860e37fba5018db9bf45,0,aBabiichuk,2014-05-30 18:29:36+03:00,['7360a79b7add328d6befdebabe0a9d7009ac02ef'],1,1,2,18022647,1,,,,14632
38e18b371e40d4d967d5f3f1c68abe96c8aa1d90,1,atkach,2014-05-30 18:50:40+03:00,['954a9cbb8f32de1d0d4d860e37fba5018db9bf45'],113,102,215,18022862,6,0.208333333,1,0.791666667,14632
a6b34b893a80a5e70b4365f4a4b419e3db5fa001,0,Nate Cole,2014-05-30 12:32:32-04:00,['38e18b371e40d4d967d5f3f1c68abe96c8aa1d90'],23,13,36,18022898,1,0,0,0,14632
c8de2f181532309361ed10c8bc901d9c95d828d8,1,tbeerbower,2014-05-30 13:16:14-04:00,['a6b34b893a80a5e70b4365f4a4b419e3db5fa001'],24,157,181,18023079,14,0.677419355,0.806451613,1,14632
aff11a3b5315cbadd35df61a41764522e7b742fb,1,Dmitry Sen,2014-05-30 21:05:37+03:00,['c8de2f181532309361ed10c8bc901d9c95d828d8'],101,220,321,18023400,19,0.215686275,1,0.196078431,14638
d6fbf4694483646e6f0511dcb8a1b1e47fd92dcb,0,Mahadev Konar,2014-05-30 12:23:07-07:00,['aff11a3b5315cbadd35df61a41764522e7b742fb'],18,20,38,18023438,11,,,,14638
e74fc95b838c0a9e024a32cab9495c1dc6c90e4e,1,Dmitry Sen,2014-05-30 22:25:45+03:00,['d6fbf4694483646e6f0511dcb8a1b1e47fd92dcb'],60,93,153,18023591,17,0,0,1,14638
98b55c9113b075452867f20d92a26ef17a11d886,1,Jaimin Jetly,2014-05-30 12:33:08-07:00,['e74fc95b838c0a9e024a32cab9495c1dc6c90e4e'],3,33,36,18023627,2,,,,14638
1ec0958424efee8ee1b0088141301d8c577b9709,1,Myroslav Papirkovskyy,2014-05-30 23:01:01+03:00,['98b55c9113b075452867f20d92a26ef17a11d886'],14,20,34,18023661,1,0,0,1,14638
3261074f8fd72941433737ee9daa3c18c953df44,1,Mahadev Konar,2014-05-30 14:16:07-07:00,['1ec0958424efee8ee1b0088141301d8c577b9709'],20,18,38,18023699,11,,,,14638
262134287f8792feed003550a57721beaa45e5d9,0,Mahadev Konar,2014-05-30 14:24:11-07:00,['3261074f8fd72941433737ee9daa3c18c953df44'],0,2,2,18023701,1,,,,14638
6dc549cce44f9acaae3da325b024ee012a6925f8,0,Mahadev Konar,2014-05-30 15:50:04-07:00,['262134287f8792feed003550a57721beaa45e5d9'],1,3,4,18023705,1,,,,14638
c6402f582740b0157cf907b41cae32fa1e675867,0,Jaimin Jetly,2014-05-30 16:49:58-07:00,['6dc549cce44f9acaae3da325b024ee012a6925f8'],2,4,6,18023711,1,0,1,1,14638
11dd9df85b0470a283feb2d2cde75a5a46927e86,1,Yusaku Sako,2014-05-31 07:02:19+00:00,['c6402f582740b0157cf907b41cae32fa1e675867'],157,4599,4756,18028467,112,0.876462939,1,1,14680
0972cf07ebd0668de12336645ce47c50fdcfb93b,1,Siddharth Wagle,2014-05-31 10:54:53-07:00,['11dd9df85b0470a283feb2d2cde75a5a46927e86'],12,52,64,18028531,8,0.518518519,0.62962963,0.592592593,14680
0028d667ca01cbf7460f4ec7ddd2e6706deb018a,0,Siddharth Wagle,2014-05-31 10:54:53-07:00,['0972cf07ebd0668de12336645ce47c50fdcfb93b'],1,1,2,18028533,1,,,,14680
c37130f7a1476254191e84b13f96a64d8e20ad17,0,Oleg Nechiporenko,2014-06-02 13:36:30+03:00,['0028d667ca01cbf7460f4ec7ddd2e6706deb018a'],193,28,221,18028754,10,0,0,0,14680
7e7e26b4de5f1646981c7c2772234da4a25fc1a2,0,Oleg Nechiporenko,2014-06-02 13:51:31+03:00,['c37130f7a1476254191e84b13f96a64d8e20ad17'],7,11,18,18028772,2,,,,14680
b9ba6753106b407e483eee98dc33e57ad1abe1ce,1,atkach,2014-06-02 13:53:20+03:00,['7e7e26b4de5f1646981c7c2772234da4a25fc1a2'],105,206,311,18029083,4,0,0,0,14680
46abfca2ddf45ba3a41af869185e4b29cbe07c3f,0,Andrew Onishuk,2014-06-02 14:23:46+03:00,['b9ba6753106b407e483eee98dc33e57ad1abe1ce'],3,24,27,18029110,7,1,1,1,14680
2ccf0c7de3222169874783893a525886a5ab7cf2,0,Andrew Onishuk,2014-06-02 17:05:51+03:00,['46abfca2ddf45ba3a41af869185e4b29cbe07c3f'],64,20,84,18029194,10,1,1,0,14680
1a0055ab4b8134a1e47ad81bdde63e96b77a6923,0,Andrew Onishuk,2014-06-02 17:34:11+03:00,['2ccf0c7de3222169874783893a525886a5ab7cf2'],132,0,132,18029326,2,,,,14680
902e62f21c178f690975f1886a9530cd83e5e21e,0,Andrew Onishuk,2014-06-02 17:57:38+03:00,['1a0055ab4b8134a1e47ad81bdde63e96b77a6923'],10,0,10,18029336,2,1,0,0,14680
9ff0e9808904b52be143fdeed8121b85f328e58a,0,Vitaly Brodetskyi,2014-06-02 15:20:13+03:00,['902e62f21c178f690975f1886a9530cd83e5e21e'],3,3,6,18029342,2,,,,14680
f38b5b8ac3edb4adea1449703422970e9bf90a4d,1,Aleksandr Kovalenko,2014-06-02 19:12:24+03:00,['9ff0e9808904b52be143fdeed8121b85f328e58a'],3,1,4,18029346,1,,,,14680
46fdf5cd25ed81525ac4fa1dbc857698b4cff2ba,0,Lisnichenko Dmitro,2014-06-02 19:35:59+03:00,['f38b5b8ac3edb4adea1449703422970e9bf90a4d'],189,4,193,18029539,5,,,,14680
13797a0007f5bfa8e9ea5fcf609c426b8f3f59f5,1,Dmitry Sen,2014-06-02 19:37:00+03:00,['46fdf5cd25ed81525ac4fa1dbc857698b4cff2ba'],13,331,344,18029883,6,0.023809524,0.880952381,1,14682
ad1ce509788743b2718a16574540586c7f223bd9,1,aBabiichuk,2014-06-02 20:05:52+03:00,['13797a0007f5bfa8e9ea5fcf609c426b8f3f59f5'],6,256,262,18030145,6,0.361904762,0.79047619,1,14683
2eab61c824d5f5ea71330e0071b76f89950afa5f,1,tbeerbower,2014-06-02 13:06:48-04:00,['ad1ce509788743b2718a16574540586c7f223bd9'],11,379,390,18030535,4,0.26993865,0.969325153,1,14683
51e8268e56149f43e05111790ab91580a0d7c8f6,0,Dmitry Sen,2014-06-02 20:14:45+03:00,['2eab61c824d5f5ea71330e0071b76f89950afa5f'],1,1,2,18030537,1,,,,14683
5cae75ecab8ecdf9588a8d1ac29b2b9441342b92,0,aBabiichuk,2014-06-02 21:00:48+03:00,['51e8268e56149f43e05111790ab91580a0d7c8f6'],3,3,6,18030543,2,,,,14683
9699b63bc81abbcf5e89b75b85eda003540b2a39,1,Jaimin Jetly,2014-06-02 14:29:04-07:00,['5cae75ecab8ecdf9588a8d1ac29b2b9441342b92'],2,7,9,18030552,1,1,1,1,14683
5eb205f7892ae18eceacd4c306bde15c49c9c7d0,1,Dmitry Sen,2014-06-03 12:10:02+03:00,['9699b63bc81abbcf5e89b75b85eda003540b2a39'],160,55,215,18030767,2,0,0,0,14683
6db4c62ee0160d3788f0a632891182bc1b30a425,0,Andrew Onishuk,2014-06-03 13:07:37+03:00,['5eb205f7892ae18eceacd4c306bde15c49c9c7d0'],14,3,17,18030784,6,0,0,0,14683
b9aa4a80b276dac643b5e970e41132d836197ab4,1,atkach,2014-06-03 14:13:10+03:00,['6db4c62ee0160d3788f0a632891182bc1b30a425'],75,59,134,18030918,8,0.333333333,0.066666667,0,14683
65b11d50c18ae5099a1e66116ba153229b4fc0f1,0,Aleksandr Kovalenko,2014-06-03 14:36:39+03:00,['b9aa4a80b276dac643b5e970e41132d836197ab4'],50,798,848,18031766,7,0.828473413,1,0.969125214,14685
03a458c0c41a377328f0eaf7243fc580509c0aeb,1,Vitaly Brodetskyi,2014-06-03 11:57:52+03:00,['65b11d50c18ae5099a1e66116ba153229b4fc0f1'],18,18,36,18031802,4,1,0,1,14685
def677bd0d71edf3b291074ce4109f972ee5d7de,1,atkach,2014-06-03 15:33:41+03:00,['03a458c0c41a377328f0eaf7243fc580509c0aeb'],65,64,129,18031931,8,0.04,0,0,14685
3a2b83c0e9a22814c000afd9e6ee1c6728d370e5,1,Aleksandr Kovalenko,2014-06-03 15:39:44+03:00,['def677bd0d71edf3b291074ce4109f972ee5d7de'],2,3,5,18031936,1,1,1,1,14685
6f416e39e44b40c54baff8864d4720bb853ad123,0,tbeerbower,2014-06-03 08:49:49-04:00,['3a2b83c0e9a22814c000afd9e6ee1c6728d370e5'],1,192,193,18032129,3,0.675,0.8125,0.7,14686
b0dc168433e92439f1deb7e5f1f94375cd51c158,1,Andrew Onishuk,2014-06-03 16:08:23+03:00,['6f416e39e44b40c54baff8864d4720bb853ad123'],13,63,76,18032205,18,,,,14687
b849349bc3db1c28742c65bc188039e6aa5ad1d4,1,Nate Cole,2014-06-03 09:13:57-04:00,['b0dc168433e92439f1deb7e5f1f94375cd51c158'],4,26,30,18032235,2,0,1,1,14687
719d500ed0517cc93e31b9f4600102554109e119,1,Oleg Nechiporenko,2014-06-03 16:50:23+03:00,['b849349bc3db1c28742c65bc188039e6aa5ad1d4'],48,944,992,18033227,2,0.582175926,0.991898148,0.993055556,14687
56b361102c72f24ecd7fdd2140c696287a7dfd90,0,aBabiichuk,2014-06-03 17:05:40+03:00,['719d500ed0517cc93e31b9f4600102554109e119'],1,5,6,18033233,1,,,,14687
842f2d44d8c46adaeef9e713286621e35105f48e,1,Aleksandr Kovalenko,2014-06-03 17:57:15+03:00,['56b361102c72f24ecd7fdd2140c696287a7dfd90'],0,1,1,18033234,1,0,0,0,14687
5831b8dd717c684a9edd0ea37bb78ab4456536e0,1,aBabiichuk,2014-06-03 18:42:22+03:00,['842f2d44d8c46adaeef9e713286621e35105f48e'],15,1040,1055,18034289,19,0.608344549,0.948855989,0.99461642,14690
1ea7498d7bbc70e50a5c6a8a710234f6599aac9b,1,tbeerbower,2014-06-03 16:11:11-04:00,['5831b8dd717c684a9edd0ea37bb78ab4456536e0'],16,233,249,18034538,14,0.581632653,0.93877551,0.642857143,14690
e81706fc05d5f065bba5ee64dea8443af1aa7924,1,Nate Cole,2014-06-03 16:48:33-04:00,['1ea7498d7bbc70e50a5c6a8a710234f6599aac9b'],4,6,10,18034548,4,,,,14690
ac8641fb30a9acd2e5426f16285716ced78a41c0,1,John Speidel,2014-06-03 17:13:12-04:00,['e81706fc05d5f065bba5ee64dea8443af1aa7924'],607,1140,1747,18036295,20,0.30449827,0.290657439,0.743944637,14691
84d5786e033137272cbd9a4af22dd912ca07fef7,0,Mahadev Konar,2014-06-03 14:35:38-07:00,['ac8641fb30a9acd2e5426f16285716ced78a41c0'],1,1,2,18036297,1,,,,14691
c34090aeae5fe368d8e59a3871f6344c005e91b9,0,Andrew Onishuk,2014-06-04 14:53:54+03:00,['84d5786e033137272cbd9a4af22dd912ca07fef7'],0,11,11,18036308,1,,,,14691
e37f9657ed67d20285f8eba7b5cb03568aec96ad,1,Dmitry Sen,2014-06-04 15:06:53+03:00,['c34090aeae5fe368d8e59a3871f6344c005e91b9'],11,97,108,18036416,2,0.178571429,0.964285714,0.964285714,14691
2d2daf4e4445ba5c7af58eacf86e903f63471f22,1,atkach,2014-06-04 15:34:13+03:00,['e37f9657ed67d20285f8eba7b5cb03568aec96ad'],65,223,288,18036704,9,1,1,0.680851064,14691
6e696269c155bb86de7fda7bcfd7afd19898b045,0,Andrew Onishuk,2014-06-04 15:34:39+03:00,['2d2daf4e4445ba5c7af58eacf86e903f63471f22'],7,0,7,18036711,1,,,,14691
d3b96c6dc85036970fe3ac11d6af5673b6129022,0,Alex Antonenko,2014-06-04 15:41:10+03:00,['6e696269c155bb86de7fda7bcfd7afd19898b045'],0,1,1,18036712,1,0,1,0,14691
a63f9e6dc44664c0ec3484f8ff628008e40261b1,1,Artem Baranchuk,2014-06-04 15:53:47+03:00,['d3b96c6dc85036970fe3ac11d6af5673b6129022'],3,3,6,18036718,2,,,,14691
7d4a0831b083895f090f5eabb7134b12c3704e3f,0,tbeerbower,2014-06-04 10:22:15-04:00,['a63f9e6dc44664c0ec3484f8ff628008e40261b1'],0,0,0,18036718,10,,,,14701
8b60e7a11d9d51222448c61bbfc1b4d45e579e75,1,tbeerbower,2014-06-04 11:00:49-04:00,['7d4a0831b083895f090f5eabb7134b12c3704e3f'],34,51,85,18036803,2,0,0,1,14701
31bbefadfec3141d6edda3cb59deb50d183b2c98,1,Alex Antonenko,2014-06-04 18:19:15+03:00,['8b60e7a11d9d51222448c61bbfc1b4d45e579e75'],2,9,11,18036814,1,0,0,0,14701
c74ec1d5c9f0aabeae493b7125ec54a059249cc9,1,Nate Cole,2014-06-04 11:40:31-04:00,['31bbefadfec3141d6edda3cb59deb50d183b2c98'],11,68,79,18036893,2,0.965517241,1,1,14701
9fab24e60a5f5a6050400ceb5a64663ced6b08e9,1,Aleksandr Kovalenko,2014-06-04 19:53:58+03:00,['c74ec1d5c9f0aabeae493b7125ec54a059249cc9'],16,25,41,18036934,1,0,1,1,14701
361192e313ecb71b1c330c5265501874d7010558,1,atkach,2014-06-04 20:06:56+03:00,['9fab24e60a5f5a6050400ceb5a64663ced6b08e9'],9,8,17,18036951,2,,,,14701
a3665f20577210e973ca023bf8c7e12ba904dcdd,1,Nate Cole,2014-06-04 13:21:36-04:00,['361192e313ecb71b1c330c5265501874d7010558'],25,171,196,18037147,4,0.042105263,0.505263158,0.663157895,14701
43279cc7e4d1c520f860cf99ca6921741d1e4d52,1,Jaimin Jetly,2014-06-04 11:05:34-07:00,['a3665f20577210e973ca023bf8c7e12ba904dcdd'],4,18,22,18037169,1,0,0,0.4,14701
823527e3cda7721b40c806c720047cba6d4de099,1,Dmitry Sen,2014-06-05 12:36:57+03:00,['43279cc7e4d1c520f860cf99ca6921741d1e4d52'],0,50,50,18037219,3,0.322580645,0.967741935,1,14701
bcb31e77aba08f78639c139ac112b5aced518ef8,0,Dmitry Sen,2014-06-05 13:03:23+03:00,['823527e3cda7721b40c806c720047cba6d4de099'],1,1,2,18037221,1,,,,14701
4830ddf5ef111801efc906fac19e95ccc7b7f4b0,1,atkach,2014-06-05 13:15:24+03:00,['bcb31e77aba08f78639c139ac112b5aced518ef8'],110,273,383,18037604,1,1,1,1,14701
735e008fa6179192ee2f8f43d40827e6f1aa8726,1,atkach,2014-06-05 13:52:11+03:00,['4830ddf5ef111801efc906fac19e95ccc7b7f4b0'],19,52,71,18037675,3,1,1,0.75,14701
587482301fc92632fd43f951edaef72ac3552bb6,1,atkach,2014-06-05 14:18:14+03:00,['735e008fa6179192ee2f8f43d40827e6f1aa8726'],522,1028,1550,18039225,21,1,1,0.933333333,14701
dc27f4a08ff8fc0145672af19024da7004ecc6cc,1,aBabiichuk,2014-06-05 16:59:56+03:00,['587482301fc92632fd43f951edaef72ac3552bb6'],13,14,27,18039252,2,0,0.333333333,1,14701
954a7040961603b610a4298cd277d3c31c383099,1,Aleksandr Kovalenko,2014-06-05 17:29:01+03:00,['dc27f4a08ff8fc0145672af19024da7004ecc6cc'],76,148,224,18039476,2,0.153846154,0.557692308,1,14701
930c4a4394bbb42201a550e0dbbb309544d9e82c,1,atkach,2014-06-05 18:08:59+03:00,['954a7040961603b610a4298cd277d3c31c383099'],182,143,325,18039801,14,0.433333333,0,0,14701
1aa76629b4854438aacc61591e4c8897192d8ec0,1,aBabiichuk,2014-06-05 18:15:45+03:00,['930c4a4394bbb42201a550e0dbbb309544d9e82c'],1,16,17,18039818,2,,,,14701
1eab85a4b3523dce0b7721563b6e2b8abf2953b9,1,Andrew Onishuk,2014-06-05 19:28:05+03:00,['1aa76629b4854438aacc61591e4c8897192d8ec0'],26,223,249,18040067,16,,,,14708
84df207bd475e730fff683b8d5d36069c27171fa,1,Lisnichenko Dmitro,2014-06-05 19:34:53+03:00,['1eab85a4b3523dce0b7721563b6e2b8abf2953b9'],1,43,44,18040111,2,0.310344828,1,1,14708
922d38bf4b6123a3e3b2f88f6f4e2519b7cba9b9,1,Alex Antonenko,2014-06-05 19:38:32+03:00,['84df207bd475e730fff683b8d5d36069c27171fa'],35,21,56,18040167,2,1,1,1,14708
d1ae61fef25c31d5da346305a24c8430e50e42d9,1,aBabiichuk,2014-06-05 19:42:09+03:00,['922d38bf4b6123a3e3b2f88f6f4e2519b7cba9b9'],3,2,5,18040172,2,1,1,0,14708
d5b830d395178c02f7a9f48bc5d8bb19a1d61754,1,Alex Antonenko,2014-06-05 19:59:38+03:00,['d1ae61fef25c31d5da346305a24c8430e50e42d9'],15,13,28,18040200,4,1,0,1,14708
4a11ff281fac6f8dc36e4fdac57d09a4365a9368,1,Aleksandr Kovalenko,2014-06-05 20:01:48+03:00,['d5b830d395178c02f7a9f48bc5d8bb19a1d61754'],128,191,319,18040519,9,1,1,0,14708
7e50afca608119c3fd81ad18aa91a3c6ce914b86,0,Aleksandr Kovalenko,2014-06-05 20:14:16+03:00,['4a11ff281fac6f8dc36e4fdac57d09a4365a9368'],213,15,228,18040747,6,0.621428571,0.221428571,0.092857143,14708
81b755c6065230ec7ee064e95371f7f1928caf03,1,tbeerbower,2014-06-05 17:34:13-04:00,['7e50afca608119c3fd81ad18aa91a3c6ce914b86'],19,252,271,18041018,5,0.147286822,0.813953488,0.899224806,14708
9f9ea545841638fcbbcecfcde1db82cb60ba7bae,1,Yusaku Sako,2014-06-05 21:37:06-07:00,['81b755c6065230ec7ee064e95371f7f1928caf03'],24,210,234,18041252,5,0.6796875,0.8125,1,14708
0ba68682faf6769b94514096b163720acf779d11,0,atkach,2014-06-06 14:23:24+03:00,['9f9ea545841638fcbbcecfcde1db82cb60ba7bae'],6,3,9,18041261,1,1,1,0,14708
5e1f13dcdad073e1ae3ac407b217ad84c73cbabf,1,Aleksandr Kovalenko,2014-06-06 14:25:20+03:00,['0ba68682faf6769b94514096b163720acf779d11'],14,24,38,18041299,3,1,1,1,14708
441b02580002b75cbffbf51b1fe777459181d769,1,Oleg Nechiporenko,2014-06-06 15:48:37+03:00,['5e1f13dcdad073e1ae3ac407b217ad84c73cbabf'],344,347,691,18041990,6,1,0.894736842,0,14708
cd60e5aac205b319fa828d5babe9914e5da26fdd,1,Oleg Nechiporenko,2014-06-06 17:04:29+03:00,['441b02580002b75cbffbf51b1fe777459181d769'],18,31,49,18042039,5,1,1,1,14708
e8dde01e380e0328287de1ba528a022aff89ae8e,1,Andrew Onishuk,2014-06-06 17:41:00+03:00,['cd60e5aac205b319fa828d5babe9914e5da26fdd'],42,174,216,18042255,4,0.090909091,0.415584416,0.584415584,14709
0ef16b34d66ba1ad636f77ddc93866223ae2d5f4,1,Nate Cole,2014-06-06 10:45:29-04:00,['e8dde01e380e0328287de1ba528a022aff89ae8e'],33,72,105,18042360,6,0,0.333333333,0.666666667,14710
565ea9793018a0ffbc49518942cc75950ce6904f,0,Nate Cole,2014-06-06 10:48:30-04:00,['0ef16b34d66ba1ad636f77ddc93866223ae2d5f4'],25,0,25,18042385,1,,,,14710
a771980bfc3ca8e7872851d4c73fd6f1e2029378,0,Andrew Onishuk,2014-06-06 18:30:39+03:00,['565ea9793018a0ffbc49518942cc75950ce6904f'],2,2,4,18042389,2,,,,14710
296c2508b844a868db727682e4fa9771380b5a70,1,Aleksandr Kovalenko,2014-06-06 18:44:08+03:00,['a771980bfc3ca8e7872851d4c73fd6f1e2029378'],37,36,73,18042462,4,1,1,1,14710
0eac2f2ad14cbf86947550e898e6fb35e032958c,1,atkach,2014-06-06 19:57:26+03:00,['296c2508b844a868db727682e4fa9771380b5a70'],853,600,1453,18043915,19,0.454545455,0.375,1,14710
34f659b5c3409800bd4ee757ce6333ca54edc0a0,1,atkach,2014-06-06 20:10:46+03:00,['0eac2f2ad14cbf86947550e898e6fb35e032958c'],1,14,15,18043930,2,1,1,1,14710
0a1aaaa4b64e8ca42ef3cf389abd1679def7c117,1,atkach,2014-06-06 20:39:25+03:00,['34f659b5c3409800bd4ee757ce6333ca54edc0a0'],13,17,30,18043960,4,1,1,1,14710
121bc763ad87210c128ecceff2602e195f0e54da,1,Alex Antonenko,2014-06-06 20:48:05+03:00,['0a1aaaa4b64e8ca42ef3cf389abd1679def7c117'],14,5,19,18043979,3,0,0,0,14710
712af7160ec93a90d894e6f973e16a9586ac3d17,0,Jaimin Jetly,2014-06-06 12:12:31-07:00,['121bc763ad87210c128ecceff2602e195f0e54da'],0,1,1,18043980,1,1,1,1,14710
7e29dea03fe87e0946b10e14e284f39b9fda35bf,0,Mahadev Konar,2014-06-06 16:35:25-07:00,['712af7160ec93a90d894e6f973e16a9586ac3d17'],11,0,11,18043991,1,,,,14710
2eb7fcccdecf95bc634469134f8d8eaf03688f93,0,Nate Cole,2014-06-09 12:21:33-04:00,['7e29dea03fe87e0946b10e14e284f39b9fda35bf'],0,25,25,18044016,3,0.583333333,0,0.583333333,14710
f1a2af1017213f7dc78d5901d1089ee2bcdc1944,1,Nate Cole,2014-06-09 12:45:34-04:00,['2eb7fcccdecf95bc634469134f8d8eaf03688f93'],63,199,262,18044278,8,0.928571429,0,0.785714286,14711
645544a998718e17f87de583be0b2350f0685f60,1,Jaimin Jetly,2014-06-09 10:01:06-07:00,['f1a2af1017213f7dc78d5901d1089ee2bcdc1944'],2,11,13,18044291,3,0.2,1,1,14711
e9bf18ee887a543017a2ded3735f05f1b0d4c30c,0,Yusaku Sako,2014-06-09 10:56:09-07:00,['645544a998718e17f87de583be0b2350f0685f60'],0,90,90,18044381,2,,,,14713
4cc2dc1b33cef56c06ecba9281ba6915ed33b018,1,Yusaku Sako,2014-06-09 11:38:41-07:00,['e9bf18ee887a543017a2ded3735f05f1b0d4c30c'],347,344,691,18045072,6,0,0.105263158,1,14713
fc8c5bf4d86208fefde537cd3a060a1a8abe9959,1,Jaimin Jetly,2014-06-09 13:15:09-07:00,['4cc2dc1b33cef56c06ecba9281ba6915ed33b018'],13,8,21,18045093,1,,,,14713
35583abd8d72b0cab978ef27d0dcfbb4251e6ed5,1,Mahadev Konar,2014-06-09 15:10:09-07:00,['fc8c5bf4d86208fefde537cd3a060a1a8abe9959'],14,43,57,18045150,2,0.739130435,0,0.391304348,14713
35ffb98b80f5c16a27e0423df706009260b16437,1,Vitaly Brodetskyi,2014-06-10 03:27:46+03:00,['35583abd8d72b0cab978ef27d0dcfbb4251e6ed5'],13,40,53,18045203,2,0,0.476190476,0.333333333,14713
840cd1c3846ddc2cd2b78b32250ee84163e6d5f3,0,Aleksandr Kovalenko,2014-06-10 13:35:47+03:00,['35ffb98b80f5c16a27e0423df706009260b16437'],1,4,5,18045208,2,,,,14713
c607bb749384bc0afa07d87fb1d48bea4841ddff,1,Andrew Onishuk,2014-06-10 14:13:34+03:00,['840cd1c3846ddc2cd2b78b32250ee84163e6d5f3'],27,56,83,18045291,14,,,,14713
680576cd7fc276a099df342170691ec2d93029f0,1,Vitaly Brodetskyi,2014-06-10 08:01:05+03:00,['c607bb749384bc0afa07d87fb1d48bea4841ddff'],14,14,28,18045319,9,,,,14713
726f5de9d5d6a24298e5f4c5fa853a44846612f1,0,Lisnichenko Dmitro,2014-06-10 17:18:06+03:00,['680576cd7fc276a099df342170691ec2d93029f0'],5,0,5,18045324,1,1,1,0,14713
b4dd29bafb24daf297cc29ebdfd2366fc4f882c3,0,Alex Antonenko,2014-06-10 18:13:43+03:00,['726f5de9d5d6a24298e5f4c5fa853a44846612f1'],1,1,2,18045326,1,,,,14713
ba99194f5513355f1ef9b5787522277b2698d5e0,1,atkach,2014-06-10 18:58:11+03:00,['b4dd29bafb24daf297cc29ebdfd2366fc4f882c3'],21,19,40,18045366,8,0,0,0,14713
dd940d74786f0b187dcb533d4588f384ee257018,0,atkach,2014-06-10 19:39:57+03:00,['ba99194f5513355f1ef9b5787522277b2698d5e0'],8,1,9,18045375,1,1,1,0,14713
7cdb6e4f77b1fb74d05feac9857213a085d21478,1,Lisnichenko Dmitro,2014-06-10 19:44:03+03:00,['dd940d74786f0b187dcb533d4588f384ee257018'],3,21,24,18045399,1,0,1,1,14713
51581ea709259816afbcb3e3251fbac259042d05,0,aBabiichuk,2014-06-10 20:12:45+03:00,['7cdb6e4f77b1fb74d05feac9857213a085d21478'],1,1,2,18045401,1,,,,14713
5e17fed31198b8cc9e1a0511474893d03a9adb63,1,Nate Cole,2014-06-10 13:52:42-04:00,['51581ea709259816afbcb3e3251fbac259042d05'],19,57,76,18045477,2,0.956521739,1,0,14713
6ae52ba4bf9ddd53e182d8636487e3d408d6519b,1,atkach,2014-06-10 21:39:06+03:00,['5e17fed31198b8cc9e1a0511474893d03a9adb63'],26,9,35,18045512,4,0,0,0,14713
f033a869fa39f1ca701fbda9b3776ed10966adb5,1,Andrew Onishuk,2014-06-10 22:03:50+03:00,['6ae52ba4bf9ddd53e182d8636487e3d408d6519b'],24,40,64,18045576,3,,,,14713
d9682afc7bd94c196175bf89fbccdc174b4d4fe5,1,Oleg Nechiporenko,2014-06-11 13:32:10+03:00,['f033a869fa39f1ca701fbda9b3776ed10966adb5'],4,4,8,18045584,1,,,,14713
6f0723794efd4d3ea6e6e0c5465e13b78c6e21c6,1,Aleksandr Kovalenko,2014-06-11 14:57:41+03:00,['d9682afc7bd94c196175bf89fbccdc174b4d4fe5'],51,39,90,18045674,11,0,0,0,14713
cbf926a42fbced05ede76d8b10e9e25176322714,1,Dmitry Sen,2014-06-11 15:32:54+03:00,['6f0723794efd4d3ea6e6e0c5465e13b78c6e21c6'],34,288,322,18045996,4,0.451807229,0.674698795,0.43373494,14713
7b9ec36ad0ef8ae5b803adb7cb3a35393329502e,1,atkach,2014-06-11 15:57:55+03:00,['cbf926a42fbced05ede76d8b10e9e25176322714'],71,82,153,18046149,36,1,1,1,14713
9dc42477c5e1292fd2f47e5a57aa2f7f5482d7ba,1,Lisnichenko Dmitro,2014-06-11 16:32:44+03:00,['7b9ec36ad0ef8ae5b803adb7cb3a35393329502e'],0,1,1,18046150,1,,,,14713
144ed3858f78eba9d24360cb71b9134fffdb0d6f,0,Lisnichenko Dmitro,2014-06-11 16:32:44+03:00,['9dc42477c5e1292fd2f47e5a57aa2f7f5482d7ba'],1,17,18,18046168,1,,,,14713
fded5a1ae180dc5e049e2c77f885b99379546764,0,Lisnichenko Dmitro,2014-06-11 16:32:44+03:00,['144ed3858f78eba9d24360cb71b9134fffdb0d6f'],0,14,14,18046182,1,,,,14713
7d875fbac7d648e79da8a16ec3d9389bd3ccdbe2,1,Lisnichenko Dmitro,2014-06-11 17:05:49+03:00,['fded5a1ae180dc5e049e2c77f885b99379546764'],19,49,68,18046250,3,0.12,1,0.08,14713
451e61c3419eb211018d73974c338ee4b18da544,1,Vitaly Brodetskyi,2014-06-11 08:50:03+03:00,['7d875fbac7d648e79da8a16ec3d9389bd3ccdbe2'],2,2,4,18046254,1,,,,14713
bf8fd74e24650ed93e267c7819bec68c5e4b3a17,0,Vitaly Brodetskyi,2014-06-11 09:34:42+03:00,['451e61c3419eb211018d73974c338ee4b18da544'],0,17,17,18046271,1,0,0,0,14713
b1d8b1b02aaa91a863690e4df94a287b53de4970,0,Vitaly Brodetskyi,2014-06-11 09:43:31+03:00,['bf8fd74e24650ed93e267c7819bec68c5e4b3a17'],18,1,19,18046290,1,,,,14713
cba604e27441c370daa0e75698125b982b4b513a,1,Dmitry Sen,2014-06-11 20:30:40+03:00,['b1d8b1b02aaa91a863690e4df94a287b53de4970'],64,172,236,18046526,6,1,1,0.914893617,14713
107bfd1681d4a1be5519ee942ce5fd61d036a6fe,0,aBabiichuk,2014-06-11 20:32:17+03:00,['cba604e27441c370daa0e75698125b982b4b513a'],0,6,6,18046532,1,1,1,1,14713
7ea3b8af422398b4b4ffba880737383edc870dec,1,Oleg Nechiporenko,2014-06-11 20:59:58+03:00,['107bfd1681d4a1be5519ee942ce5fd61d036a6fe'],12,25,37,18046569,3,0,0,1,14713
c3109ce38f06d769841c195e3df76764f9befd89,0,Srimanth Gunturi,2014-06-11 12:17:50-07:00,['7ea3b8af422398b4b4ffba880737383edc870dec'],18,0,18,18046587,1,1,1,1,14713
191d0a81a0285ec213e555d4ede90c82dbf19d0c,1,John Speidel,2014-06-11 16:06:59-04:00,['c3109ce38f06d769841c195e3df76764f9befd89'],39,436,475,18047062,6,0.07518797,0.827067669,0.759398496,14713
1fc5d59a234fdc402e4e5e24cb38abb511d58cd8,1,Nate Cole,2014-06-11 17:51:15-04:00,['191d0a81a0285ec213e555d4ede90c82dbf19d0c'],58,50,108,18047170,1,1,0.636363636,0,14713
f7a78f0e059ce6c9fb95588df489f28fe3adc159,1,Jaimin Jetly,2014-06-11 15:13:59-07:00,['1fc5d59a234fdc402e4e5e24cb38abb511d58cd8'],0,9,9,18047179,1,,,,14713
6998f95307a57130c33a7a36ee9b5b39477f2b2a,1,Xi Wang,2014-06-11 16:00:50-07:00,['f7a78f0e059ce6c9fb95588df489f28fe3adc159'],5,5,10,18047189,1,0,1,1,14713
6f780f7874d223ccb19ffd1f516eb03169d34160,1,Jaimin Jetly,2014-06-11 17:33:30-07:00,['6998f95307a57130c33a7a36ee9b5b39477f2b2a'],8,18,26,18047215,6,,,,14713
31c5852feea787631f57c39d6f889d248094ced1,1,tbeerbower,2014-06-12 05:20:15-04:00,['6f780f7874d223ccb19ffd1f516eb03169d34160'],21,369,390,18047605,15,0.592814371,0.892215569,0.814371257,14713
778540f89e721b9a88f378fa50eadf66c933182b,1,atkach,2014-06-12 13:07:33+03:00,['31c5852feea787631f57c39d6f889d248094ced1'],113,53,166,18047771,2,0,0,0,14713
5f60646641ecde596e40c630cd70b760907d011c,1,atkach,2014-06-12 14:27:38+03:00,['778540f89e721b9a88f378fa50eadf66c933182b'],1,1,2,18047773,1,,,,14713
c5b53c8e109e5f0dabc91f60a174313ce60a088b,0,Nate Cole,2014-06-12 09:09:19-04:00,['5f60646641ecde596e40c630cd70b760907d011c'],1,1,2,18047775,1,,,,14713
90e7376bc87603851b4c108a41a5825cc44596ca,1,Andrew Onishuk,2014-06-12 16:52:13+03:00,['c5b53c8e109e5f0dabc91f60a174313ce60a088b'],19,114,133,18047908,9,0.375,1,1,14715
44ced4d5d8bcbc8f37fe7be418b1d10f39b2b3fe,1,Nate Cole,2014-06-12 10:58:09-04:00,['90e7376bc87603851b4c108a41a5825cc44596ca'],39,600,639,18048547,17,0.366666667,0.574074074,0.844444444,14718
d7246f0957db836cfb2fdc6494fd32a22c7e32cd,1,Andrew Onishuk,2014-06-12 18:30:58+03:00,['44ced4d5d8bcbc8f37fe7be418b1d10f39b2b3fe'],48,109,157,18048704,11,0,,,14718
f22493a9c739d19a123235b9c50da24645136d80,1,Alex Antonenko,2014-06-12 20:25:22+03:00,['d7246f0957db836cfb2fdc6494fd32a22c7e32cd'],1,1,2,18048706,1,,,,14718
feefe5c16e8b76ed236b0a92036b22069ef271ab,1,Jaimin Jetly,2014-06-12 10:53:51-07:00,['f22493a9c739d19a123235b9c50da24645136d80'],5,7,12,18048718,1,,,,14718
8a2576d67bee1db1d4c62057cb589336370ecde7,1,Vitaly Brodetskyi,2014-06-12 12:27:50+03:00,['feefe5c16e8b76ed236b0a92036b22069ef271ab'],3,3,6,18048724,2,,,,14718
ff28aeeee82478947a20ba20d14e7cc9824edfd0,1,Xi Wang,2014-06-12 22:08:59-07:00,['8a2576d67bee1db1d4c62057cb589336370ecde7'],12,134,146,18048870,1,1,1,1,14718
3782c7c1ff3bdd62567f6701e35f9deb571452ec,0,Andrew Onishuk,2014-06-13 12:46:30+03:00,['ff28aeeee82478947a20ba20d14e7cc9824edfd0'],1,1,2,18048872,1,,,,14718
6492d0ec45b0a04ab2e8f51ef98f89b8582341e4,1,Aleksandr Kovalenko,2014-06-13 13:08:37+03:00,['3782c7c1ff3bdd62567f6701e35f9deb571452ec'],68,51,119,18048991,6,0,0,0,14718
901b59ce460da69ad2ecd50b0b8f24b140e8dfaa,0,Vitaly Brodetskyi,2014-06-13 04:46:33+03:00,['6492d0ec45b0a04ab2e8f51ef98f89b8582341e4'],8,10,18,18049009,2,0,0.666666667,0.333333333,14718
749f6588983bdbaeb8f796144180301911f2456a,1,atkach,2014-06-13 14:02:16+03:00,['901b59ce460da69ad2ecd50b0b8f24b140e8dfaa'],16,26,42,18049051,3,0.75,0.75,1,14718
77f1877c3530d0fc6ebc00991790d433c18e1424,1,atkach,2014-06-13 14:25:27+03:00,['749f6588983bdbaeb8f796144180301911f2456a'],4,12,16,18049067,2,,,,14718
b593a87711f23585ffaf738176fbb439d5702f8a,0,Vitaly Brodetskyi,2014-06-13 06:13:46+03:00,['77f1877c3530d0fc6ebc00991790d433c18e1424'],3,3,6,18049073,3,,,,14718
b34430fa15ca5dfb51dbfa45485996174ceec413,1,Aleksandr Kovalenko,2014-06-13 15:56:57+03:00,['b593a87711f23585ffaf738176fbb439d5702f8a'],1,1,2,18049075,1,,,,14718
2c184414e4839a33001c8f3c48556007b3ef2754,0,aBabiichuk,2014-06-13 15:59:11+03:00,['b34430fa15ca5dfb51dbfa45485996174ceec413'],54,0,54,18049129,3,0,0,0,14718
cc603dca24523db5c9c7530cada868cce0b8e3de,1,Andrew Onishuk,2014-06-13 16:17:54+03:00,['2c184414e4839a33001c8f3c48556007b3ef2754'],219,304,523,18049652,18,0,0.857142857,1,14718
b33ec74ed9bcb10b290657f1eb27f7ba493ec2a6,0,Andrew Onishuk,2014-06-13 16:21:00+03:00,['cc603dca24523db5c9c7530cada868cce0b8e3de'],0,11,11,18049663,2,0,0.555555556,1,14718
d8ff818f783ed3f129f8bf5a48e5ef95e8c03aef,1,Andrew Onishuk,2014-06-13 16:22:07+03:00,['b33ec74ed9bcb10b290657f1eb27f7ba493ec2a6'],0,1,1,18049664,1,,,,14718
05638be1715a5aa46978f9afd57d91b6e864cd75,1,aBabiichuk,2014-06-13 18:17:10+03:00,['d8ff818f783ed3f129f8bf5a48e5ef95e8c03aef'],5,5,10,18049674,3,0,1,1,14718
d2cc6b31cd74a1321f70e69829c0b4de98f9cb85,0,Andrew Onishuk,2014-06-13 18:27:06+03:00,['05638be1715a5aa46978f9afd57d91b6e864cd75'],11,0,11,18049685,2,1,0.444444444,0,14718
5d3fad2c1370097b66cb738c6349f156f1aed118,1,Oleg Nechiporenko,2014-06-13 18:38:03+03:00,['d2cc6b31cd74a1321f70e69829c0b4de98f9cb85'],330,563,893,18050578,7,1,0.985185185,0.948148148,14719
37739ac70c579d93f6c1808bff1f56b7c0ced275,0,Nate Cole,2014-06-13 12:06:38-04:00,['5d3fad2c1370097b66cb738c6349f156f1aed118'],10,6,16,18050594,2,1,0.75,1,14719
3076dfe4bc52caddcd500cf4ef0d577731561f80,1,Mahadev Konar,2014-06-13 12:10:18-07:00,['37739ac70c579d93f6c1808bff1f56b7c0ced275'],32,84,116,18050710,2,0.36,1,1,14719
fbd5235e27e1b95318c21d6222eb7f31e5d16a6e,1,Siddharth Wagle,2014-06-13 12:29:34-07:00,['3076dfe4bc52caddcd500cf4ef0d577731561f80'],311,1051,1362,18052072,45,0.684210526,0.799342105,0.888157895,14728
effb34ff844636fab186f91344c91fe07780f227,1,Xi Wang,2014-06-13 14:57:44-07:00,['fbd5235e27e1b95318c21d6222eb7f31e5d16a6e'],5,30,35,18052107,2,1,1,0,14728
ec0c81a9c00908be78c6c60e5fa99a4f7cb762ef,0,Siddharth Wagle,2014-06-13 15:17:33-07:00,['effb34ff844636fab186f91344c91fe07780f227'],275,976,1251,18053358,10,0.781609195,0.781609195,0.804597701,14733
f88b9dd9824ba942501a4d4fa24801905597cfe9,1,Xi Wang,2014-06-13 16:58:12-07:00,['ec0c81a9c00908be78c6c60e5fa99a4f7cb762ef'],4,6,10,18053368,1,1,1,1,14733
c11bcf5538f2c358ef7b64b1b813538dc56c742b,0,aBabiichuk,2014-06-16 12:03:56+03:00,['f88b9dd9824ba942501a4d4fa24801905597cfe9'],31,8,39,18053407,2,,,,14733
a7232a722950003c9ca1f7a703aee47090ad0acf,0,Vitaly Brodetskyi,2014-06-16 03:43:24+03:00,['c11bcf5538f2c358ef7b64b1b813538dc56c742b'],3,2,5,18053412,2,1,1,0,14733
ab821251746c4f623f158f3554e56ce8754b339b,1,Dmitry Sen,2014-06-16 13:16:36+03:00,['a7232a722950003c9ca1f7a703aee47090ad0acf'],9,9,18,18053430,2,0,1,1,14733
98cf4a96923c12ad6e47e4052d55eb3937c1c043,0,Dmitry Sen,2014-06-16 13:47:45+03:00,['ab821251746c4f623f158f3554e56ce8754b339b'],2,0,2,18053432,1,,,,14733
e29411798d569e7890416c0102021a3834603680,1,Alex Antonenko,2014-06-16 14:40:10+03:00,['98cf4a96923c12ad6e47e4052d55eb3937c1c043'],2,2,4,18053436,1,1,1,0,14733
8a9dddee047b3851106e3a68be173903630966e2,1,atkach,2014-06-16 14:57:10+03:00,['e29411798d569e7890416c0102021a3834603680'],89,100,189,18053625,12,1,0,1,14733
f0f6936f1979a8847d401acacc6bb35d2e8c143b,0,Andrew Onishuk,2014-06-16 17:53:28+03:00,['8a9dddee047b3851106e3a68be173903630966e2'],7,10,17,18053642,3,,,,14733
2326f6c44255a43ea6037c19f57f14a13c0288f9,0,Dmitry Sen,2014-06-16 18:22:22+03:00,['f0f6936f1979a8847d401acacc6bb35d2e8c143b'],1,0,1,18053643,1,,,,14733
40c914d8c7c9e887035fde12c1979b39fb05c42c,1,Alex Antonenko,2014-06-16 18:51:22+03:00,['2326f6c44255a43ea6037c19f57f14a13c0288f9'],1,2,3,18053646,1,,,,14733
d4b0b31f89033585f5dcb144db10847825b7206f,1,Vitaly Brodetskyi,2014-06-16 09:46:29+03:00,['40c914d8c7c9e887035fde12c1979b39fb05c42c'],11,12,23,18053669,5,0,0,1,14733
03e108a8ae4595f48a1f13b8c530a12d976d15f9,0,aBabiichuk,2014-06-16 19:00:42+03:00,['d4b0b31f89033585f5dcb144db10847825b7206f'],12,47,59,18053728,6,1,1,0.533333333,14733
8ec1b7aba235a6c727dc07e3bf54e42634cbf834,0,aBabiichuk,2014-06-16 19:43:27+03:00,['03e108a8ae4595f48a1f13b8c530a12d976d15f9'],24,34,58,18053786,2,1,1,1,14733
9d70900ddbf6903735634f65beec38ace610aca1,0,aBabiichuk,2014-06-16 20:14:33+03:00,['8ec1b7aba235a6c727dc07e3bf54e42634cbf834'],2,2,4,18053790,1,,,,14733
6fdc34f129755cca9f316d6d774c35b8c026d375,1,Alex Antonenko,2014-06-16 20:35:37+03:00,['9d70900ddbf6903735634f65beec38ace610aca1'],22,21,43,18053833,1,0,0,0,14733
cb2b75c67de7819be25075ef46edd27e91f51c4c,1,John Speidel,2014-06-16 14:04:49-04:00,['6fdc34f129755cca9f316d6d774c35b8c026d375'],3,241,244,18054077,2,0.016574586,1,1,14733
0843fc80904ca5be21dab5af84a4ac8cdfe91267,1,Alex Antonenko,2014-06-16 21:41:55+03:00,['cb2b75c67de7819be25075ef46edd27e91f51c4c'],2,2,4,18054081,1,,,,14733
6433f889255c4455a7752d78518bfd87d948fca8,1,Jaimin Jetly,2014-06-16 11:56:19-07:00,['0843fc80904ca5be21dab5af84a4ac8cdfe91267'],6,4,10,18054091,3,,,,14733
975753e2128d63286c18016d2754a3c20313ebcb,0,Xi Wang,2014-06-16 13:58:00-07:00,['6433f889255c4455a7752d78518bfd87d948fca8'],4,4,8,18054099,1,,,,14733
e0ea325b5d1f9b9c97552f08688be6b3392f8a82,1,Jaimin Jetly,2014-06-16 13:59:19-07:00,['975753e2128d63286c18016d2754a3c20313ebcb'],6,36,42,18054141,4,1,1,1,14734
b282aaf15d56421ab7faeb4681043a5d08fd6893,0,Xi Wang,2014-06-16 18:14:56-07:00,['e0ea325b5d1f9b9c97552f08688be6b3392f8a82'],5,5,10,18054151,2,,,,14734
da189fbd0ed4af01380898d8c1e165733bf2e732,1,Xi Wang,2014-06-16 18:33:59-07:00,['b282aaf15d56421ab7faeb4681043a5d08fd6893'],50,180,230,18054381,10,1,0.529411765,1,14736
62e81605e37c49bb3bf1c025193d4c5ebf74184a,1,atkach,2014-06-17 11:35:35+03:00,['da189fbd0ed4af01380898d8c1e165733bf2e732'],90,97,187,18054568,5,0.648148148,1,1,14736
d54c9632f903966b81fde74e26db69c1a2d18bc3,1,Oleg Nechiporenko,2014-06-17 12:04:58+03:00,['62e81605e37c49bb3bf1c025193d4c5ebf74184a'],2,4,6,18054574,2,0,1,1,14736
b642840c035040b0733772d9335753dd9b330121,1,atkach,2014-06-17 15:10:26+03:00,['d54c9632f903966b81fde74e26db69c1a2d18bc3'],96,115,211,18054785,8,0,0,0,14736
bdd844b90a1b60805ad70f40f8cdf8529fa53377,1,Dmitry Sen,2014-06-17 15:47:49+03:00,['b642840c035040b0733772d9335753dd9b330121'],1,1,2,18054787,1,,,,14736
7cd7978e01b8848feabde5807c90ce8ca29d894d,1,Andrew Onishuk,2014-06-17 17:06:17+03:00,['bdd844b90a1b60805ad70f40f8cdf8529fa53377'],12,5,17,18054804,1,,,,14736
20340ef3f8d4dbaaf3ba9b573b7a2c018c874474,0,Andrew Onishuk,2014-06-17 17:06:49+03:00,['7cd7978e01b8848feabde5807c90ce8ca29d894d'],1,1,2,18054806,1,,,,14736
9bc9ed055f49d7a4a8de9ca11a0c677c1262ad0d,1,Oleg Nechiporenko,2014-06-17 17:44:37+03:00,['20340ef3f8d4dbaaf3ba9b573b7a2c018c874474'],4,79,83,18054889,4,0.096774194,0.903225806,1,14736
ae8a71f27e1b9b92c833578730f08945a5304113,1,atkach,2014-06-17 19:31:34+03:00,['9bc9ed055f49d7a4a8de9ca11a0c677c1262ad0d'],126,102,228,18055117,8,0.36,1,0.84,14736
cb656231110a6a7718e31f357c623c89643b50b6,1,Dmitry Sen,2014-06-17 20:38:58+03:00,['ae8a71f27e1b9b92c833578730f08945a5304113'],0,37,37,18055154,2,,,,14736
2d611c7116c077d7585f9e645942659855d6dace,1,Srimanth Gunturi,2014-06-17 13:09:22-07:00,['cb656231110a6a7718e31f357c623c89643b50b6'],2,2,4,18055158,1,,,,14736
faaf799464e35e7946d719d4d8fdde0001c62d59,1,Xi Wang,2014-06-17 13:56:53-07:00,['2d611c7116c077d7585f9e645942659855d6dace'],2,2,4,18055162,2,,,,14736
17990ba2642c086b3c4294f84c48274d5f0796c1,1,Jaimin Jetly,2014-06-17 14:15:40-07:00,['faaf799464e35e7946d719d4d8fdde0001c62d59'],2,15,17,18055179,1,1,1,1,14736
d82625e4e55894b59b9f2de0a2fbef03277ff3c6,1,Siddharth Wagle,2014-06-17 14:19:02-07:00,['17990ba2642c086b3c4294f84c48274d5f0796c1'],1,46,47,18055226,5,,,,14738
269451069f7466acbd5d702610da0eecce08e506,1,Yusaku Sako,2014-06-17 14:33:44-07:00,['d82625e4e55894b59b9f2de0a2fbef03277ff3c6'],569,3839,4408,18059634,56,0.677570093,0.841121495,0.813084112,14775
f414d1c416f1ce5af24ed0c730a605dfe1002e2a,1,Myroslav Papirkovskyy,2014-06-18 03:02:28+03:00,['269451069f7466acbd5d702610da0eecce08e506'],230,212,442,18060076,10,0,0,1,14775
2724fc98874483719fcc63cec56db2f783d659b9,1,Xi Wang,2014-06-17 17:36:32-07:00,['f414d1c416f1ce5af24ed0c730a605dfe1002e2a'],15,15,30,18060106,2,0,0,1,14775
7cdc49bf7bd187c2d31284f9e90c2fa4e5a3c692,0,Xi Wang,2014-06-17 17:36:32-07:00,['2724fc98874483719fcc63cec56db2f783d659b9'],4,8,12,18060118,1,,,,14775
c2588d2787d9618999141b39fde4cfdd50c1a027,1,aBabiichuk,2014-06-18 12:18:02+03:00,['7cdc49bf7bd187c2d31284f9e90c2fa4e5a3c692'],188,18,206,18060324,3,0.784313725,0.470588235,0.431372549,14775
2fcd5b11f576aca3ce462a4454e8aba3c1b8f847,0,Andrew Onishuk,2014-06-18 13:16:10+03:00,['c2588d2787d9618999141b39fde4cfdd50c1a027'],1,18,19,18060343,2,0,1,0,14775
40f0d702cdf66bb7537f97e099e801f31b480985,1,aBabiichuk,2014-06-18 13:35:31+03:00,['2fcd5b11f576aca3ce462a4454e8aba3c1b8f847'],0,6,6,18060349,1,,,,14775
3b0d0d41b26bc26c11c6678c712cd7b969b70150,0,Vitaly Brodetskyi,2014-06-18 12:58:31+03:00,['40f0d702cdf66bb7537f97e099e801f31b480985'],4,4,8,18060357,4,,,,14775
0ab141e8d4a1907eed29bfe0f16bae7219b57324,1,Dmitry Sen,2014-06-18 13:51:54+03:00,['3b0d0d41b26bc26c11c6678c712cd7b969b70150'],8,8,16,18060373,2,1,1,0,14775
afd5844e78d65a249f3d53fcf785d935bd87058b,1,aBabiichuk,2014-06-18 14:00:43+03:00,['0ab141e8d4a1907eed29bfe0f16bae7219b57324'],1,1,2,18060375,1,,,,14775
b19d840f29873f7a9682da5615e9089416404a07,1,atkach,2014-06-18 14:42:13+03:00,['afd5844e78d65a249f3d53fcf785d935bd87058b'],40,85,125,18060500,3,1,0,0,14775
514ed6397894f6f315c992cdf5bf17ee67e315d6,0,Andrew Onishuk,2014-06-18 15:11:51+03:00,['b19d840f29873f7a9682da5615e9089416404a07'],1,1,2,18060502,1,,,,14775
cfcfea9b1922fca25867e3768738b0589ec9aaaa,1,Andrew Onishuk,2014-06-18 15:21:04+03:00,['514ed6397894f6f315c992cdf5bf17ee67e315d6'],100,67,167,18060669,27,,,,14775
8702256d65e36030ea977d0235ea7a9fc3907955,0,Artem Baranchuk,2014-06-18 15:23:12+03:00,['cfcfea9b1922fca25867e3768738b0589ec9aaaa'],2,10,12,18060681,3,,,,14775
52c914170c62fecacf9dc00fe47d7c0c9ca2fae1,1,Myroslav Papirkovskyy,2014-06-18 17:02:22+03:00,['8702256d65e36030ea977d0235ea7a9fc3907955'],5,47,52,18060733,8,1,1,1,14775
c6d86439f70edc07e14dd0986b690b62cfe25a43,1,Andrew Onishuk,2014-06-18 17:14:11+03:00,['52c914170c62fecacf9dc00fe47d7c0c9ca2fae1'],48,73,121,18060854,8,0.166666667,1,1,14775
87da5f323ca09b22542ef23465cc6c1add43b14e,1,Andrew Onishuk,2014-06-18 18:20:13+03:00,['c6d86439f70edc07e14dd0986b690b62cfe25a43'],1,1,2,18060856,1,,,,14775
76e758c4361bac1b864622446e26b3d9beb79a6a,0,aBabiichuk,2014-06-18 18:37:43+03:00,['87da5f323ca09b22542ef23465cc6c1add43b14e'],4,16,20,18060876,2,0.75,0.75,1,14775
8c73f08cf937fea3cf842703b45d619742d2e3d1,1,atkach,2014-06-18 18:45:22+03:00,['76e758c4361bac1b864622446e26b3d9beb79a6a'],0,1,1,18060877,1,1,1,1,14775
d228ca90b6664a26b3df22a206179200cd0a1050,1,Andrew Onishuk,2014-06-18 18:49:42+03:00,['8c73f08cf937fea3cf842703b45d619742d2e3d1'],39,57,96,18060973,4,0,1,1,14775
709444328daea13a0dee220868605f9ed897c414,1,Aleksandr Kovalenko,2014-06-18 18:52:45+03:00,['d228ca90b6664a26b3df22a206179200cd0a1050'],3,16,19,18060992,3,1,1,1,14775
2301fa04eff1d54c7b79afd249ca2ab7cc284d2b,1,Aleksandr Kovalenko,2014-06-18 18:52:46+03:00,['709444328daea13a0dee220868605f9ed897c414'],148,281,429,18061421,11,0.727272727,1,0.872727273,14776
ad1c712f837ce5d99663f03f2feb25f7ad8e497e,1,Aleksandr Kovalenko,2014-06-18 18:52:46+03:00,['2301fa04eff1d54c7b79afd249ca2ab7cc284d2b'],3,25,28,18061449,3,,,,14776
2bd0af0813e65e75a50a9611f4b903dc165b51b1,0,aBabiichuk,2014-06-18 19:00:28+03:00,['ad1c712f837ce5d99663f03f2feb25f7ad8e497e'],2,3,5,18061454,1,1,1,1,14776
30b42a4f58bbc7e14c136aeba617d5042f32c2a5,1,Lisnichenko Dmitro,2014-06-18 19:13:03+03:00,['2bd0af0813e65e75a50a9611f4b903dc165b51b1'],51,63,114,18061568,10,0,0.833333333,0.833333333,14776
3ca5fece0f6f72f209ab99f2c2b003e4f47962d3,1,Andrew Onishuk,2014-06-18 19:14:22+03:00,['30b42a4f58bbc7e14c136aeba617d5042f32c2a5'],4,8,12,18061580,4,0,1,1,14776
2ecfba125ba7470b448e8bc191110100dcfd3e3b,1,Andrew Onishuk,2014-06-18 20:00:53+03:00,['3ca5fece0f6f72f209ab99f2c2b003e4f47962d3'],12,11,23,18061603,3,1,0,1,14776
71c521ad1724f88e517becd72b12b7c9f3436b3e,1,Alex Antonenko,2014-06-18 22:10:03+03:00,['2ecfba125ba7470b448e8bc191110100dcfd3e3b'],26,14,40,18061643,1,1,0,0,14776
ce09149dc50193a127752edd7ca05a4ceb14b7d9,1,aBabiichuk,2014-06-18 22:16:10+03:00,['71c521ad1724f88e517becd72b12b7c9f3436b3e'],7,13,20,18061663,2,0.5,0.5,1,14776
10e6427ac30ebfcfb11603deb69d42673c1adbef,1,Jaimin Jetly,2014-06-18 14:40:50-07:00,['ce09149dc50193a127752edd7ca05a4ceb14b7d9'],2,2,4,18061667,1,,,,14776
14cbe7b4c2f6d92a9ab4d2971b694ca806a5a8cd,0,Xi Wang,2014-06-18 15:04:10-07:00,['10e6427ac30ebfcfb11603deb69d42673c1adbef'],0,1,1,18061668,1,,,,14776
6c900f78462db586e13b64e4dab6d39f6b82cc10,0,Xi Wang,2014-06-18 15:04:10-07:00,['14cbe7b4c2f6d92a9ab4d2971b694ca806a5a8cd'],11,7,18,18061686,1,,,,14776
21076d7d99a1da4821236160bbda999ff1305384,1,Myroslav Papirkovskyy,2014-06-19 02:26:38+03:00,['6c900f78462db586e13b64e4dab6d39f6b82cc10'],44,66,110,18061796,7,0,0.333333333,1,14776
b613415c764cdd645d15a39fba8c0f528d0536ca,0,Xi Wang,2014-06-18 17:06:18-07:00,['21076d7d99a1da4821236160bbda999ff1305384'],0,1,1,18061797,1,,,,14776
084f4a88537c16c21237c27f53f9427604ad299c,1,Jaimin Jetly,2014-06-18 17:17:50-07:00,['b613415c764cdd645d15a39fba8c0f528d0536ca'],2,2,4,18061801,2,,,,14776
c0fc5a5dc6ca67eeecd2458c88721f87d78f0246,1,Erin A Boyd,2014-06-18 20:13:12-06:00,['084f4a88537c16c21237c27f53f9427604ad299c'],286,10183,10469,18072270,85,0.570048309,0.685990338,0.961352657,14839
04cc6b59df8c4f443739b3bd6883e3f1967839b5,1,atkach,2014-06-19 12:03:26+03:00,['c0fc5a5dc6ca67eeecd2458c88721f87d78f0246'],21,21,42,18072312,2,,,,14839
9aae43f09bb70326cabe0a3e8c4cb081128600da,1,Aleksandr Kovalenko,2014-06-19 14:26:34+03:00,['04cc6b59df8c4f443739b3bd6883e3f1967839b5'],1,1,2,18072314,1,,,,14839
34535407286a9c4c5f437ea829b9be9c7f1f098e,1,Aleksandr Kovalenko,2014-06-19 15:39:06+03:00,['9aae43f09bb70326cabe0a3e8c4cb081128600da'],3,3,6,18072320,2,,,,14839
2ce73d7c09d9fd6b4840ce330b87051ec9ebd57a,1,aBabiichuk,2014-06-19 15:48:45+03:00,['34535407286a9c4c5f437ea829b9be9c7f1f098e'],1,5,6,18072326,1,1,1,1,14839
6b2412da23c368ea4f5163c3ea5bc2e5463dc3d0,1,John Speidel,2014-06-19 10:14:20-04:00,['2ce73d7c09d9fd6b4840ce330b87051ec9ebd57a'],31,237,268,18072594,7,0.689655172,1,0.974137931,14839
fd969d928058fe09dbe75e7d8ff5e90df1a99603,0,Erin A Boyd,2014-06-19 08:28:40-06:00,['6b2412da23c368ea4f5163c3ea5bc2e5463dc3d0'],1,1,2,18072596,1,,,,14839
da428c6524520950cfc5a580ab7e74ec7e8114f9,0,Alex Antonenko,2014-06-19 19:04:45+03:00,['fd969d928058fe09dbe75e7d8ff5e90df1a99603'],65,39,104,18072700,1,,,,14839
12dd8bd51f1841aa049e54ff64baed7fff781250,1,Alex Antonenko,2014-06-19 22:11:12+03:00,['da428c6524520950cfc5a580ab7e74ec7e8114f9'],13,52,65,18072765,7,0.75,0.944444444,1,14839
297ccb1b0a7e4ec41c7cd34b48de55c0aecd7bd0,1,Alex Antonenko,2014-06-19 22:47:06+03:00,['12dd8bd51f1841aa049e54ff64baed7fff781250'],1,14,15,18072780,2,1,1,1,14839
09c6d117e4d7eb42aaf8021c08dadeca2b257309,1,Siddharth Wagle,2014-06-19 13:09:35-07:00,['297ccb1b0a7e4ec41c7cd34b48de55c0aecd7bd0'],153,324,477,18073257,19,0.698795181,0.759036145,0.445783133,14839
7efb9d8c3ae357dfbafcc4ef55505dff6f4a97a0,1,Myroslav Papirkovskyy,2014-06-19 23:34:40+03:00,['09c6d117e4d7eb42aaf8021c08dadeca2b257309'],4,9,13,18073270,1,1,1,1,14839
70bbd5a55b8dda2de5a3c7a4b8b8b8ee62abf79e,1,Myroslav Papirkovskyy,2014-06-19 23:37:07+03:00,['7efb9d8c3ae357dfbafcc4ef55505dff6f4a97a0'],2,3,5,18073275,1,0,0,1,14839
036229ca51da349353f8070ce48c874a35c18f87,1,Erin A Boyd,2014-06-19 14:46:06-06:00,['70bbd5a55b8dda2de5a3c7a4b8b8b8ee62abf79e'],1,68,69,18073344,2,,,,14839
68dd332565c742829d01e11fcadb2c7cc4f87104,1,Erin A Boyd,2014-06-19 15:16:47-06:00,['036229ca51da349353f8070ce48c874a35c18f87'],20,11,31,18073375,2,,,,14839
945f355065fab011b747568d8b78deaf02301574,1,John Speidel,2014-06-19 17:36:39-04:00,['68dd332565c742829d01e11fcadb2c7cc4f87104'],16,408,424,18073799,8,0.200913242,1,0.922374429,14840
fef5b218f965c1f57e420fc02348c001cee0fde8,0,Jaimin Jetly,2014-06-19 14:41:48-07:00,['945f355065fab011b747568d8b78deaf02301574'],1,1,2,18073801,1,,,,14840
84ad5db9808262594d398356f864d2200d47b4e1,0,Alex Antonenko,2014-06-20 04:13:27+03:00,['fef5b218f965c1f57e420fc02348c001cee0fde8'],1,5,6,18073807,1,,,,14840
874ab5cc557aa571c535acc84e8cba4733c1e381,0,Xi Wang,2014-06-19 18:31:41-07:00,['84ad5db9808262594d398356f864d2200d47b4e1'],4,5,9,18073816,1,,,,14840
a010022e40d4a77faf139112e42c5fcd02bc55d4,0,Aleksandr Kovalenko,2014-06-20 14:22:16+03:00,['874ab5cc557aa571c535acc84e8cba4733c1e381'],1,1,2,18073818,1,,,,14840
f85a13e2e0a4155d061c3eada21bdacc0b510c30,0,Nate Cole,2014-06-20 07:39:40-04:00,['a010022e40d4a77faf139112e42c5fcd02bc55d4'],22,0,22,18073840,2,1,1,1,14840
fb9ebf2e616ea30d7d9b88a590aae8828a7668ff,0,aBabiichuk,2014-06-20 15:05:09+03:00,['f85a13e2e0a4155d061c3eada21bdacc0b510c30'],6,7,13,18073853,2,,,,14840
431a400669d9720435e0bb538b520c0f3345d35e,1,Myroslav Papirkovskyy,2014-06-20 15:22:13+03:00,['fb9ebf2e616ea30d7d9b88a590aae8828a7668ff'],2,2,4,18073857,2,,,,14840
965696b386dda7bdf1aac7ff60bb47cc8855c822,1,Oleg Nechiporenko,2014-06-20 17:54:07+03:00,['431a400669d9720435e0bb538b520c0f3345d35e'],33,114,147,18074004,8,0.802469136,1,1,14840
a25cd0e084bb5e58afedf734a302bab634426ce7,0,Oleg Nechiporenko,2014-06-20 19:20:58+03:00,['965696b386dda7bdf1aac7ff60bb47cc8855c822'],0,4,4,18074008,1,1,1,1,14840
fc1634029be3844813f3ef1b9d8fc84ec8b69d7d,1,Andrew Onishuk,2014-06-20 20:09:10+03:00,['a25cd0e084bb5e58afedf734a302bab634426ce7'],2,31,33,18074041,2,0.294117647,1,1,14840
6ec6c99700d67898974a9ce00b029a042c211ff4,1,Alex Antonenko,2014-06-20 20:38:02+03:00,['fc1634029be3844813f3ef1b9d8fc84ec8b69d7d'],2,2,4,18074045,1,,,,14840
49028c7f925370718487c235a34bd9b17f377162,0,Yusaku Sako,2014-06-20 11:22:08-07:00,['6ec6c99700d67898974a9ce00b029a042c211ff4'],0,0,0,18074045,1,,,,14841
7e5988c4b200a4111afc4e37cebfc9bef5710aa6,1,Lisnichenko Dmitro,2014-06-20 22:09:34+03:00,['49028c7f925370718487c235a34bd9b17f377162'],1,49,50,18074095,6,0,1,1,14841
0a907e0ab11754255c9d7e920a03ea6fb1cf743c,0,Myroslav Papirkovskyy,2014-06-20 22:26:11+03:00,['7e5988c4b200a4111afc4e37cebfc9bef5710aa6'],1,5,6,18074101,1,0,1,0,14841
d3d583388e349106d8c144fdc191836d48ea2b05,1,Jaimin Jetly,2014-06-20 12:52:52-07:00,['0a907e0ab11754255c9d7e920a03ea6fb1cf743c'],130,87,217,18074318,12,0.941176471,0,0,14841
0d5cc744a4dc3e7de28a4d4ea3b80b76677e7639,1,tbeerbower,2014-06-20 16:30:01-04:00,['d3d583388e349106d8c144fdc191836d48ea2b05'],30,97,127,18074445,4,0.526315789,0,1,14841
b4079b9503bb4c15889134070c6914c5fac4d33d,1,Siddharth Wagle,2014-06-20 14:40:11-07:00,['0d5cc744a4dc3e7de28a4d4ea3b80b76677e7639'],8,161,169,18074614,5,0.06741573,1,0.921348315,14841
1857a45552dbb1343a5a3b98eed75fc5238147ba,0,Xi Wang,2014-06-20 17:00:31-07:00,['b4079b9503bb4c15889134070c6914c5fac4d33d'],7,4,11,18074625,2,0,0,0,14841
1e906dd0e484d8cb333fe3fe37d6ae11cc5de809,1,Xi Wang,2014-06-20 17:14:35-07:00,['1857a45552dbb1343a5a3b98eed75fc5238147ba'],6,26,32,18074657,3,0.0625,0.0625,1,14841
8769ba8cb728eb909c45a4eb97a00a64f73d14c2,1,Aleksandr Kovalenko,2014-06-23 15:02:00+03:00,['1e906dd0e484d8cb333fe3fe37d6ae11cc5de809'],280,269,549,18075206,2,0,0,1,14841
98c9e94d3a626a1aa3f6d4d44625c4b3c1bc2cd2,0,tbeerbower,2014-06-23 08:58:33-04:00,['8769ba8cb728eb909c45a4eb97a00a64f73d14c2'],13,92,105,18075311,3,,,,14841
ce815fbd54e8cc6c244e37d42aa5ea71a9cdf9f5,1,Oleg Nechiporenko,2014-06-23 16:04:40+03:00,['98c9e94d3a626a1aa3f6d4d44625c4b3c1bc2cd2'],2,34,36,18075347,5,1,1,1,14841
7888bbf21a6c867131d138a08f680b458bc1056c,1,Lisnichenko Dmitro,2014-06-23 16:13:29+03:00,['ce815fbd54e8cc6c244e37d42aa5ea71a9cdf9f5'],5,16,21,18075368,2,1,1,1,14841
2c6c0492fa6e4601b58697955f0be07170243b45,1,Lisnichenko Dmitro,2014-06-23 16:13:30+03:00,['7888bbf21a6c867131d138a08f680b458bc1056c'],2,9,11,18075379,2,0.5,0.75,0.75,14841
7d9d452533e8dc23575da11d1082b2e037e1a100,1,Andrew Onishuk,2014-06-23 17:56:44+03:00,['2c6c0492fa6e4601b58697955f0be07170243b45'],4,12,16,18075395,3,0,1,0,14841
0f653358807da358010f0ad6eca6e6e52f98aefb,1,Andrew Onishuk,2014-06-23 17:57:46+03:00,['7d9d452533e8dc23575da11d1082b2e037e1a100'],3,6,9,18075404,2,0,0,1,14841
f71cfb00705bb1ec367e8e1c4287bf1eed36bd69,1,Erin A Boyd,2014-06-23 09:23:06-06:00,['0f653358807da358010f0ad6eca6e6e52f98aefb'],6,6,12,18075416,3,,,,14841
891b1205d33a2291debd6fadeeabf4adaae4f63c,1,Aleksandr Kovalenko,2014-06-23 18:43:08+03:00,['f71cfb00705bb1ec367e8e1c4287bf1eed36bd69'],12,13,25,18075441,1,1,0,1,14841
fd8754d252cdc9c7285a0f2842cb28140f41395e,0,Myroslav Papirkovskyy,2014-06-23 19:03:50+03:00,['891b1205d33a2291debd6fadeeabf4adaae4f63c'],26,58,84,18075525,2,0.481481481,0.481481481,0,14841
02a46f7d1fd4b2e7a7b45f158e82da9f2b4345ea,1,Lisnichenko Dmitro,2014-06-23 20:29:27+03:00,['fd8754d252cdc9c7285a0f2842cb28140f41395e'],985,5391,6376,18081901,84,0.4375,0.395833333,0,14842
ac7f1da22c065ecdad8d4c81e95d4746cbb0ae93,0,Myroslav Papirkovskyy,2014-06-23 21:00:58+03:00,['02a46f7d1fd4b2e7a7b45f158e82da9f2b4345ea'],1,0,1,18081902,1,,,,14842
82f1549641e079427e79af6234fcfb24bb605cd9,1,Andrew Onishuk,2014-06-23 22:40:46+03:00,['ac7f1da22c065ecdad8d4c81e95d4746cbb0ae93'],171,44,215,18082117,4,0.955223881,0.358208955,0.223880597,14842
971685e06fe633560e7d508bd50ca77c54d7e3c6,1,Lisnichenko Dmitro,2014-06-23 22:43:37+03:00,['82f1549641e079427e79af6234fcfb24bb605cd9'],25,23,48,18082165,4,,,,14842
226f30206a98784a19869c802017265c66267b77,1,Mahadev Konar,2014-06-23 15:47:26-07:00,['971685e06fe633560e7d508bd50ca77c54d7e3c6'],0,5,5,18082170,2,0.25,1,1,14842
095d47840eb4ea5788a0db2d75d2113d0011e14f,0,Xi Wang,2014-06-23 17:30:00-07:00,['226f30206a98784a19869c802017265c66267b77'],2,2,4,18082174,1,,,,14842
2798022282f6c02afdb7e08e7de1f8ece2fa4ba8,1,Xi Wang,2014-06-23 18:02:07-07:00,['095d47840eb4ea5788a0db2d75d2113d0011e14f'],6,12,18,18082192,3,0,0,1,14842
7fecef8b7728cf79cd9ca9528c5fbf9d0c2c9edf,1,Yusaku Sako,2014-06-23 19:06:21-07:00,['2798022282f6c02afdb7e08e7de1f8ece2fa4ba8'],2,6,8,18082200,2,,,,14842
33fd0ca179096d256947bcc5241c3937deb4ce54,0,tbeerbower,2014-06-24 05:15:31-04:00,['7fecef8b7728cf79cd9ca9528c5fbf9d0c2c9edf'],9,13,22,18082222,2,1,1,0,14842
45e874d9a5863e92ebd385d9ce7f030524e0ad2f,0,Oleg Nechiporenko,2014-06-24 12:25:46+03:00,['33fd0ca179096d256947bcc5241c3937deb4ce54'],1,1,2,18082224,1,,,,14842
43ed20c0bb45e2f0c5f2727940578857e638f327,1,aBabiichuk,2014-06-24 14:24:23+03:00,['45e874d9a5863e92ebd385d9ce7f030524e0ad2f'],73,96,169,18082393,5,1,1,1,14842
dd8b03cf01935c4babda7d32ef215151cbaa58af,1,Oleg Nechiporenko,2014-06-24 15:49:26+03:00,['43ed20c0bb45e2f0c5f2727940578857e638f327'],9,15,24,18082417,2,1,1,1,14842
7030788e3fafbd06b1cf160c18958877850223bb,0,Lisnichenko Dmitro,2014-06-24 16:43:23+03:00,['dd8b03cf01935c4babda7d32ef215151cbaa58af'],2,2,4,18082421,2,,,,14842
8d4c6b86ab02af530c3ba0e5c13b05e456042e2d,1,aBabiichuk,2014-06-24 16:59:56+03:00,['7030788e3fafbd06b1cf160c18958877850223bb'],27,16,43,18082464,3,0,0,0,14842
1a90900bfe923f5cdb579ad3c8a848bdc56ae6b1,1,Aleksandr Kovalenko,2014-06-24 18:07:56+03:00,['8d4c6b86ab02af530c3ba0e5c13b05e456042e2d'],100,29,129,18082593,5,0.340909091,0.954545455,0,14842
5894156fa6ed9450af72191a10d5aaf0e092319b,1,atkach,2014-06-24 18:12:35+03:00,['1a90900bfe923f5cdb579ad3c8a848bdc56ae6b1'],21,26,47,18082640,3,0,0,0.875,14842
f2d759e05bd110d4720139a82645a266a8939f0b,1,atkach,2014-06-24 19:08:28+03:00,['5894156fa6ed9450af72191a10d5aaf0e092319b'],70,223,293,18082933,9,0.926829268,1,0.902439024,14842
65f786ec5e964d003d35f52d9509e97947fc6b7d,0,Andrew Onishuk,2014-06-24 19:29:23+03:00,['f2d759e05bd110d4720139a82645a266a8939f0b'],1,1,2,18082935,1,,,,14842
8cf8013876afd823d2cf7ff74e041bf725ec4131,0,tbeerbower,2014-06-24 13:07:34-04:00,['65f786ec5e964d003d35f52d9509e97947fc6b7d'],1,24,25,18082960,2,1,1,1,14842
406308408e55c1092927311fdcddc7c6edfae399,1,Dmytro Sen,2014-06-24 20:35:05+03:00,['8cf8013876afd823d2cf7ff74e041bf725ec4131'],53,54,107,18083067,3,0,1,0,14842
a17359c97c51263b51a15acc150e588db921d48a,0,Dmytro Sen,2014-06-25 01:06:44+03:00,['406308408e55c1092927311fdcddc7c6edfae399'],137,256,393,18083460,22,0.148148148,0.407407407,0.666666667,14842
b37a3624c5c0dc9064b4032512940c0c56b39530,0,Xi Wang,2014-06-24 15:56:07-07:00,['a17359c97c51263b51a15acc150e588db921d48a'],1,5,6,18083466,3,1,0,1,14842
ccbdc045710aedb9eba76db0615197ea8c23f990,1,Xi Wang,2014-06-24 17:40:36-07:00,['b37a3624c5c0dc9064b4032512940c0c56b39530'],1,4,5,18083471,1,1,1,1,14842
f89181b42e9b1c1c86423e4b8e217f036e6b6dc9,1,atkach,2014-06-25 13:51:33+03:00,['ccbdc045710aedb9eba76db0615197ea8c23f990'],1,11,12,18083483,1,0,0,1,14842
b41ba67e6090515aa9a13200958bb4642e8ac413,1,atkach,2014-06-25 15:25:51+03:00,['f89181b42e9b1c1c86423e4b8e217f036e6b6dc9'],6,14,20,18083503,2,0,0,1,14842
1785225b04e7610235ded00ed180220d98a84f65,0,Dmytro Sen,2014-06-25 17:13:22+03:00,['b41ba67e6090515aa9a13200958bb4642e8ac413'],9,14,23,18083526,2,1,1,1,14842
f95a23cf4cf242f5005ceec187a330491411c7c5,1,Andrew Onishuk,2014-06-25 18:32:17+03:00,['1785225b04e7610235ded00ed180220d98a84f65'],0,5,5,18083531,1,0,0,0,14842
a6b1217e42f8bd6025f8b4ba3d77c9207a105749,1,Alex Antonenko,2014-06-25 19:26:05+03:00,['f95a23cf4cf242f5005ceec187a330491411c7c5'],33,7,40,18083571,2,0,0,0,14842
b8eb0bb6a643419f453cacf81749b7c20867d458,1,Andrew Onishuk,2014-06-25 19:47:30+03:00,['a6b1217e42f8bd6025f8b4ba3d77c9207a105749'],115,308,423,18083994,18,0.857142857,1,1,14848
20e214feb0916b702d4756d8e3e92b3aa49371e4,1,Aleksandr Kovalenko,2014-06-25 20:41:42+03:00,['b8eb0bb6a643419f453cacf81749b7c20867d458'],7,12,19,18084013,1,1,1,1,14848
b19009e398143c237b514dd4f34891e63dddc16e,1,atkach,2014-06-25 20:46:29+03:00,['20e214feb0916b702d4756d8e3e92b3aa49371e4'],19,16,35,18084048,4,0.2,0.2,0,14848
4173376b930c394c3478bd35b30103eef413cb91,1,Alex Antonenko,2014-06-25 20:53:22+03:00,['b19009e398143c237b514dd4f34891e63dddc16e'],4,15,19,18084067,2,1,0,0,14848
9a8cdf910ff8ecc72a9f1d2acf3e933611060172,1,aBabiichuk,2014-06-25 21:40:26+03:00,['4173376b930c394c3478bd35b30103eef413cb91'],35,79,114,18084181,7,0.9375,0.5625,0.46875,14848
a3403e5d625657fd4494edc66c5cd64f45da5c55,0,Artem Baranchuk,2014-06-26 00:00:05+03:00,['9a8cdf910ff8ecc72a9f1d2acf3e933611060172'],74,300,374,18084555,2,0.550295858,0.650887574,0.982248521,14848
25cb1360e36b629bc9cafedf3f180e61fd0694ac,0,Sumit Mohanty,2014-06-25 16:12:43-07:00,['a3403e5d625657fd4494edc66c5cd64f45da5c55'],33,110,143,18084698,5,0,0,1,14848
444bb8a992636208609b54552b48ef14bd3b2cc9,1,Jaimin Jetly,2014-06-25 16:42:25-07:00,['25cb1360e36b629bc9cafedf3f180e61fd0694ac'],8,3,11,18084709,4,0,0,0,14848
ac78a388845ee3a352d06966b0d383ffb7fd1218,0,Xi Wang,2014-06-25 17:59:00-07:00,['444bb8a992636208609b54552b48ef14bd3b2cc9'],1,4,5,18084714,1,0,0,1,14848
22d0d181d99ada472d9a6eb3278eac650296bb79,0,Aleksandr Kovalenko,2014-06-26 14:47:53+03:00,['ac78a388845ee3a352d06966b0d383ffb7fd1218'],2,2,4,18084718,1,,,,14848
1a549c11945c41df67ca73dcb603f6a156206743,1,Oleg Nechiporenko,2014-06-26 15:25:35+03:00,['22d0d181d99ada472d9a6eb3278eac650296bb79'],12,15,27,18084745,3,1,1,1,14848
71647f50f8563904eef91855d3423675b32e108e,0,Aleksandr Kovalenko,2014-06-26 15:37:08+03:00,['1a549c11945c41df67ca73dcb603f6a156206743'],7,5,12,18084757,1,0,0,0,14848
4b8eef1a95adc25366f585d6df7af52f16f51c40,1,Andrew Onishuk,2014-06-26 15:45:54+03:00,['71647f50f8563904eef91855d3423675b32e108e'],52,113,165,18084922,18,0,1,1,14849
be7d27f49f163ae0587feba8bb16007afb6e9a0a,0,Alex Antonenko,2014-06-26 16:10:49+03:00,['4b8eef1a95adc25366f585d6df7af52f16f51c40'],7,7,14,18084936,1,,0,,14849
922c36714a66bf50527b58b85d1423382ed02588,0,Andrew Onishuk,2014-06-26 16:29:03+03:00,['be7d27f49f163ae0587feba8bb16007afb6e9a0a'],45,81,126,18085062,6,,,,14849
18596f1b0538eb75276b63ac73295e45a8ed6189,1,Andrew Onishuk,2014-06-26 17:42:03+03:00,['922c36714a66bf50527b58b85d1423382ed02588'],1,9,10,18085072,1,0,0,1,14849
76c4c4a5a404db7f77104dc4103e60ed63d15cb8,1,Alex Antonenko,2014-06-26 19:58:58+03:00,['18596f1b0538eb75276b63ac73295e45a8ed6189'],2,1,3,18085075,1,0,0,0,14849
a676f6634b318f9cb3153dbd51c166e2143687c9,0,Lisnichenko Dmitro,2014-06-26 20:32:49+03:00,['76c4c4a5a404db7f77104dc4103e60ed63d15cb8'],10,12,22,18085097,2,1,1,0,14849
06d403beee64398350fb6415744421481b84feda,1,Alex Antonenko,2014-06-26 21:26:20+03:00,['a676f6634b318f9cb3153dbd51c166e2143687c9'],6,30,36,18085133,7,1,1,1,14849
a66d9f252a746368ce34c5e1ec92057fc1b63230,1,Aleksandr Kovalenko,2014-06-26 21:47:02+03:00,['06d403beee64398350fb6415744421481b84feda'],32,17,49,18085182,4,0,0,0,14849
c188b96b303cb96613139828fabdfb00a87acf77,0,Andrew Onishuk,2014-06-26 22:07:21+03:00,['a66d9f252a746368ce34c5e1ec92057fc1b63230'],30,436,466,18085648,6,,,,14853
59e3bd59591bc01397abe0d3a9f120bbc6f89fdd,1,Dmytro Sen,2014-06-26 22:59:43+03:00,['c188b96b303cb96613139828fabdfb00a87acf77'],256,137,393,18086041,22,0.851851852,0.592592593,0.333333333,14853
9fcc9f5a4deff3ea03bfcb4f4199c32bc0ea6527,0,Dmytro Sen,2014-06-26 23:02:58+03:00,['59e3bd59591bc01397abe0d3a9f120bbc6f89fdd'],14,9,23,18086064,2,0,0,0,14853
d26f0c7b36b095ff2c9df4b6ebad500b4a4089d4,1,Dmytro Sen,2014-06-26 23:04:10+03:00,['9fcc9f5a4deff3ea03bfcb4f4199c32bc0ea6527'],39,62,101,18086165,7,0,1,1,14853
732a6dd0fe56c93e1e8ae8249509beae8d242baa,1,Srimanth Gunturi,2014-06-26 14:14:52-07:00,['d26f0c7b36b095ff2c9df4b6ebad500b4a4089d4'],15,27,42,18086207,1,0,0.352941176,1,14853
4431985c732989a612a2fce597baef22d6b19328,1,Dmytro Sen,2014-06-27 00:35:15+03:00,['732a6dd0fe56c93e1e8ae8249509beae8d242baa'],0,16,16,18086223,4,,,,14853
6058debb8ad813037993949ce2c675b4b4e2b33d,0,Myroslav Papirkovskyy,2014-06-27 01:20:29+03:00,['4431985c732989a612a2fce597baef22d6b19328'],26,0,26,18086249,2,1,0.076923077,0.076923077,14853
a2918a8d7b0b789c68f105176fd747fea496f86a,1,Alex Antonenko,2014-06-27 01:34:11+03:00,['6058debb8ad813037993949ce2c675b4b4e2b33d'],36,48,84,18086333,4,1,1,1,14853
9ae132d5c952475fa7b09321fa747c57b22101dc,1,Srimanth Gunturi,2014-06-26 19:37:22-07:00,['a2918a8d7b0b789c68f105176fd747fea496f86a'],9,76,85,18086418,2,1,0.806451613,1,14853
e6a0d45d6ce1328e1cf34d2ae8df387257fd6c1a,0,Yusaku Sako,2014-06-26 19:45:00-07:00,['9ae132d5c952475fa7b09321fa747c57b22101dc'],12,27,39,18086457,3,0.625,0.625,0.625,14853
cde42c76edf40eec7586a5496bd42c68838b1b04,1,Andrew Onishuk,2014-06-27 13:56:12+03:00,['e6a0d45d6ce1328e1cf34d2ae8df387257fd6c1a'],81,45,126,18086583,6,,,,14853
c45fd154cbb920ad93e0109cd89cf18f8e4b74cf,1,aBabiichuk,2014-06-27 15:07:50+03:00,['cde42c76edf40eec7586a5496bd42c68838b1b04'],1,1,2,18086585,1,,,,14853
a6390a83e59b60835268b53e6f99808a418bc0de,1,atkach,2014-06-27 16:00:32+03:00,['c45fd154cbb920ad93e0109cd89cf18f8e4b74cf'],5,9,14,18086599,3,0,0,0,14853
f9082ee99174c0e4f4c53ac021aa640e485f99f4,1,atkach,2014-06-27 16:48:18+03:00,['a6390a83e59b60835268b53e6f99808a418bc0de'],54,130,184,18086783,6,0.166666667,1,0.595238095,14853
712bd49a30a51335d475629d3fdbd06f8eb926ee,1,Andrew Onishuk,2014-06-27 18:14:32+03:00,['f9082ee99174c0e4f4c53ac021aa640e485f99f4'],5,7,12,18086795,3,1,1,1,14853
edc634f6e47393af47dc67c725b88a7ac943fd38,1,Dmytro Sen,2014-06-27 18:42:38+03:00,['712bd49a30a51335d475629d3fdbd06f8eb926ee'],14,26,40,18086835,3,1,1,1,14853
3045cc4090bc74bc25f0fcca66e07b91a35307f4,1,atkach,2014-06-27 18:45:51+03:00,['edc634f6e47393af47dc67c725b88a7ac943fd38'],2,25,27,18086862,2,0.923076923,0.923076923,1,14853
07690b24c750f4f2a7a92ffcc5d59b53c6d5a90d,0,Dmytro Sen,2014-06-27 19:07:19+03:00,['3045cc4090bc74bc25f0fcca66e07b91a35307f4'],144,78,222,18087084,2,0.965517241,0.965517241,0.534482759,14853
af82db118840abe1dbac89302a02abf1ba7ac2f1,1,Dmytro Sen,2014-06-27 19:07:19+03:00,['07690b24c750f4f2a7a92ffcc5d59b53c6d5a90d'],37354,477,37831,18124915,216,1,1,1,14863
484f59a72d7c2f10c5ff3449bbc965ee8d794866,1,Mahadev Konar,2014-06-27 09:23:09-07:00,['af82db118840abe1dbac89302a02abf1ba7ac2f1'],27,12,39,18124954,3,0.375,0.375,0.375,14863
00cab7193bde96f471ac8ab4b8197f2764174ae0,1,Mahadev Konar,2014-06-27 09:51:54-07:00,['484f59a72d7c2f10c5ff3449bbc965ee8d794866'],12,50,62,18125016,3,0.863636364,0.863636364,0.863636364,14863
3bb817acf1158c99b5d1abbb85764a4a14c9a441,1,aBabiichuk,2014-06-27 20:59:51+03:00,['00cab7193bde96f471ac8ab4b8197f2764174ae0'],2,16,18,18125034,2,0.875,0.9375,1,14863
84189cea54e16a520ec35c119720c1894d1ef008,0,Yusaku Sako,2014-06-27 13:24:36-07:00,['3bb817acf1158c99b5d1abbb85764a4a14c9a441'],3,80,83,18125117,1,0,0.781818182,1,14863
1ddd8f1adf120fb5c805f962d46673c613271aac,1,Alex Antonenko,2014-06-27 23:40:04+03:00,['84189cea54e16a520ec35c119720c1894d1ef008'],8,79,87,18125204,4,0.885714286,1,1,14863
1b14eb62762da1fb1700336de6c457a9c09a8146,1,Aleksandr Kovalenko,2014-06-27 23:52:14+03:00,['1ddd8f1adf120fb5c805f962d46673c613271aac'],28,95,123,18125327,7,0.964285714,0.285714286,1,14863
668560125e48ecf72a6db99761da6fbc20360104,1,Xi Wang,2014-06-27 14:40:20-07:00,['1b14eb62762da1fb1700336de6c457a9c09a8146'],4,13,17,18125344,3,1,1,1,14863
563de9f334fb641b242a71a73a2e6702fd9e039d,0,Aleksandr Kovalenko,2014-06-28 01:24:52+03:00,['668560125e48ecf72a6db99761da6fbc20360104'],1,1,2,18125346,1,,,,14863
17e6c95257f98bc73a42380d9f140f086b756af4,1,Yusaku Sako,2014-06-28 00:05:26-07:00,['563de9f334fb641b242a71a73a2e6702fd9e039d'],6,34,40,18125386,4,,,,14863
9f663c7dd285e56b3f26b36461d5ae13e126cf74,0,Dmytro Sen,2014-06-28 11:13:41+03:00,['17e6c95257f98bc73a42380d9f140f086b756af4'],325,0,325,18125711,2,,,,14863
d51d7c68f3db55c68151fe405cb2e6e67f99aec4,1,Jaimin Jetly,2014-06-28 10:02:41-07:00,['9f663c7dd285e56b3f26b36461d5ae13e126cf74'],2,2,4,18125715,1,,,,14863
d4a0041d2a2526f0253e17ffcfb58ed4090fe2f7,1,tbeerbower,2014-06-30 06:58:08-04:00,['d51d7c68f3db55c68151fe405cb2e6e67f99aec4'],1,3,4,18125719,2,0,0.5,1,14863
2cc94aebcfb081480db373247aed6bdf01db2663,0,Subin,2014-06-30 19:32:27+05:18,['d4a0041d2a2526f0253e17ffcfb58ed4090fe2f7'],1854,2462,4316,18130035,26,0.625423729,0.837288136,0.279661017,14864
246136562bb8cee8db6daec3723f7943769fb984,0,Erin A Boyd,2014-06-30 09:02:47-06:00,['2cc94aebcfb081480db373247aed6bdf01db2663'],3,8,11,18130046,1,,,,14864
1fa452f1142149ff0f625852660293a2e5433116,0,Erin A Boyd,2014-06-30 09:14:48-06:00,['246136562bb8cee8db6daec3723f7943769fb984'],2,6,8,18130054,1,,,,14864
96bad666fac95e6060253fb55941da12bf8216a1,1,Srimanth Gunturi,2014-06-30 08:53:24-07:00,['1fa452f1142149ff0f625852660293a2e5433116'],141,812,953,18131007,29,0.190361446,0.869879518,0.985542169,14866
7a7d8e1c8d739f331aa42c858d6cd7b6e8d963eb,0,Srimanth Gunturi,2014-06-30 15:57:59-07:00,['96bad666fac95e6060253fb55941da12bf8216a1'],2,14,16,18131023,1,1,1,1,14866
996b4d6b9e63d6126a2cbe2518d311a282206f28,0,Siddharth Wagle,2014-06-30 16:53:50-07:00,['7a7d8e1c8d739f331aa42c858d6cd7b6e8d963eb'],1,26,27,18131050,2,1,1,1,14866
9f2517c925d6d447e1ea3fdafa7dd5a24f9ca816,0,Xi Wang,2014-06-30 17:05:58-07:00,['996b4d6b9e63d6126a2cbe2518d311a282206f28'],2,6,8,18131058,1,0,0,1,14866
54e99f6f2d5d6e53ee377d3043f2056af33a0dd6,0,Srimanth Gunturi,2014-06-30 18:16:03-07:00,['9f2517c925d6d447e1ea3fdafa7dd5a24f9ca816'],1,1,2,18131060,1,,,,14866
3fd60f31ee59416aaa4777481b31140e204b991f,1,aBabiichuk,2014-07-01 13:24:47+03:00,['54e99f6f2d5d6e53ee377d3043f2056af33a0dd6'],12,2,14,18131074,2,0,0,0,14866
8165be0559ce935da429a6b1976d64ecc64053ed,1,Oleg Nechiporenko,2014-07-01 14:07:56+03:00,['3fd60f31ee59416aaa4777481b31140e204b991f'],2,17,19,18131093,2,1,1,1,14866
c57bceca684c1b8dc95428cc4c2485556186efd4,1,Alex Antonenko,2014-07-01 14:45:33+03:00,['8165be0559ce935da429a6b1976d64ecc64053ed'],20,16,36,18131129,1,1,1,0,14866
c28adbad749087a0090e939e980fd711db8d28f4,1,aBabiichuk,2014-07-01 14:46:58+03:00,['c57bceca684c1b8dc95428cc4c2485556186efd4'],7,4,11,18131140,2,,,,14866
4e27c5a3f271aa3826d2b500f450e280ececdfff,0,Artem Baranchuk,2014-07-01 16:23:08+03:00,['c28adbad749087a0090e939e980fd711db8d28f4'],3,3,6,18131146,1,,,,14866
92a95586e329ddb8674c63506dc54f998ce6c01f,1,Dmytro Sen,2014-07-01 18:12:48+03:00,['4e27c5a3f271aa3826d2b500f450e280ececdfff'],2,121,123,18131269,2,0,1,1,14866
a6c15a0fdb21b8d3b2f5d823815bc0df1f9fdd2d,1,Alex Antonenko,2014-07-01 18:15:17+03:00,['92a95586e329ddb8674c63506dc54f998ce6c01f'],7,34,41,18131310,3,1,1,1,14866
94d8c357aaac028308ca0105341650b01b534ac6,0,Erin A Boyd,2014-07-01 09:44:44-06:00,['a6c15a0fdb21b8d3b2f5d823815bc0df1f9fdd2d'],0,370,370,18131680,1,,,,14867
bc0feaa8c2e7f210dace6de644dd5c3b059f9892,0,Dmytro Sen,2014-07-01 18:57:45+03:00,['94d8c357aaac028308ca0105341650b01b534ac6'],0,2,2,18131682,2,,,,14867
d8045bcfdbb1bd637fc28d0c3fd1d687acd23892,1,atkach,2014-07-01 19:08:27+03:00,['bc0feaa8c2e7f210dace6de644dd5c3b059f9892'],42,113,155,18131837,4,1,1,0.269230769,14867
d267bbb2921f17208209911ab4aecff0a7474eb2,0,Erin A Boyd,2014-07-01 10:46:04-06:00,['d8045bcfdbb1bd637fc28d0c3fd1d687acd23892'],0,0,0,18131837,1,,,,14868
7110b855baf50069d249fbb3b3f8e28d0099c33a,1,Erin A Boyd,2014-07-01 10:59:03-06:00,['d267bbb2921f17208209911ab4aecff0a7474eb2'],59,19670,19729,18151566,40,,,,14904
bb883731cc9d271b7b642dcbde42a1fa9983dd44,1,Aleksandr Kovalenko,2014-07-01 20:32:23+03:00,['7110b855baf50069d249fbb3b3f8e28d0099c33a'],2,17,19,18151585,3,0,0.625,0.375,14904
b9b800a9d77785c8bc6aafd37ac24da3650517b1,1,Nate Cole,2014-07-01 14:02:04-04:00,['bb883731cc9d271b7b642dcbde42a1fa9983dd44'],14,39,53,18151638,3,1,1,0.416666667,14904
ae5c25cf38c9f8dcd67b3b91202ea9b5eeada007,0,Nate Cole,2014-07-01 14:06:26-04:00,['b9b800a9d77785c8bc6aafd37ac24da3650517b1'],19,15,34,18151672,4,0.636363636,0,0,14904
6b52b54b1e2d6ddf1558129246195d7f26928e78,1,Lisnichenko Dmitro,2014-07-01 21:21:03+03:00,['ae5c25cf38c9f8dcd67b3b91202ea9b5eeada007'],34,34,68,18151740,19,,,,14904
c477ba061d6ce9599c70ebb1b399cbef3d6f430a,1,Aleksandr Kovalenko,2014-07-01 21:25:45+03:00,['6b52b54b1e2d6ddf1558129246195d7f26928e78'],3,25,28,18151768,2,1,1,1,14904
69fe4f67c774e07c2e6ecf1e9aadadb4725699ac,1,Andrew Onishuk,2014-07-01 21:45:38+03:00,['c477ba061d6ce9599c70ebb1b399cbef3d6f430a'],1,1,2,18151770,1,,,,14904
49e6fbb6aa6a19b12a46e8e1d833993b3c73896f,1,atkach,2014-07-01 22:00:05+03:00,['69fe4f67c774e07c2e6ecf1e9aadadb4725699ac'],44,57,101,18151871,2,1,1,1,14904
769be41ff0214e2cc47a0703fd956cfd7d107508,1,Srimanth Gunturi,2014-07-01 12:18:10-07:00,['49e6fbb6aa6a19b12a46e8e1d833993b3c73896f'],0,1,1,18151872,1,,,,14904
894d106988d9c0bd33b225a6e87dc81b1f505f29,0,Xi Wang,2014-07-01 13:28:34-07:00,['769be41ff0214e2cc47a0703fd956cfd7d107508'],17,31,48,18151920,1,1,1,1,14904
d853a99a88f34a8eef7bd7b63d32c07337030116,1,Jaimin Jetly,2014-07-01 13:29:21-07:00,['894d106988d9c0bd33b225a6e87dc81b1f505f29'],61,54,115,18152035,3,1,1,0,14904
01e9e76079f4fb5aeffa5ce059644f16296f5291,1,Siddharth Wagle,2014-07-01 13:39:17-07:00,['d853a99a88f34a8eef7bd7b63d32c07337030116'],57,490,547,18152582,23,0.552795031,0.627329193,0.826086957,14908
00a4991eecb205f7936929e7010856661f0ba59e,1,Siddharth Wagle,2014-07-01 13:42:32-07:00,['01e9e76079f4fb5aeffa5ce059644f16296f5291'],161,2797,2958,18155540,39,0.583736689,0.892545983,0.957405615,14929
97a5a947037821a5918e689994b35b0600cde5b4,1,Siddharth Wagle,2014-07-01 14:55:37-07:00,['00a4991eecb205f7936929e7010856661f0ba59e'],46,125,171,18155711,14,0.489795918,0.836734694,0.836734694,14929
79fddb7daa40fa41d52ff60fcafa59464f3c518c,1,Yusaku Sako,2014-07-01 17:09:09-07:00,['97a5a947037821a5918e689994b35b0600cde5b4'],3,3,6,18155717,2,,,,14929
d1769ff0cb4470a696cd0da72d0f9237a9e08b0c,0,Xi Wang,2014-07-01 17:12:59-07:00,['79fddb7daa40fa41d52ff60fcafa59464f3c518c'],6,2,8,18155725,1,,,,14929
3ed90ad248281a3eadcabbfef857d1692a42151a,1,Xi Wang,2014-07-01 17:12:59-07:00,['d1769ff0cb4470a696cd0da72d0f9237a9e08b0c'],15,36,51,18155776,3,1,1,1,14929
f63a5804d94aa7a1a3b8586b421818b65491a172,0,Srimanth Gunturi,2014-07-01 17:35:42-07:00,['3ed90ad248281a3eadcabbfef857d1692a42151a'],1,1,2,18155778,1,,,,14929
b7cd438a514e51b8b02f790f2126e6fc31b1715d,1,atkach,2014-07-02 13:10:13+03:00,['f63a5804d94aa7a1a3b8586b421818b65491a172'],11,7,18,18155796,2,0,0,0,14929
087e00b4ae222d115a95c7fc4b7cf6edb1fb7bd9,1,atkach,2014-07-02 14:43:55+03:00,['b7cd438a514e51b8b02f790f2126e6fc31b1715d'],178,232,410,18156206,10,1,1,0.548387097,14929
9ed0b549b7d25a9da2dae093d6656c6212430ff8,1,atkach,2014-07-02 15:05:12+03:00,['087e00b4ae222d115a95c7fc4b7cf6edb1fb7bd9'],2,1,3,18156209,2,0,0,0,14929
eb0fc28f18d076b092761cb1ee0016e1af391025,0,atkach,2014-07-02 15:54:19+03:00,['9ed0b549b7d25a9da2dae093d6656c6212430ff8'],16,2,18,18156227,1,0,0,0,14929
675590bf53931d5931de119b403691df3aa5b2b2,0,atkach,2014-07-02 16:31:23+03:00,['eb0fc28f18d076b092761cb1ee0016e1af391025'],1,1,2,18156229,1,,,,14929
16911c85e18dfc337fa2be88b37214a1d5074e22,0,tbeerbower,2014-07-02 09:34:35-04:00,['675590bf53931d5931de119b403691df3aa5b2b2'],1,609,610,18156839,9,0.806666667,0.966666667,0.893333333,14935
c9fe537a22a40008c163950fc17a0beb776d07aa,1,Myroslav Papirkovskyy,2014-07-02 17:21:43+03:00,['16911c85e18dfc337fa2be88b37214a1d5074e22'],2,23,25,18156864,4,0.375,0.875,1,14935
e04dc67a6d5960ffc8ea50e68d4fcea501869a98,1,aBabiichuk,2014-07-02 17:48:17+03:00,['c9fe537a22a40008c163950fc17a0beb776d07aa'],5,13,18,18156882,1,1,1,0.222222222,14935
9a85b8b7c9f98c303e20f7ebbd5bc778acd2b072,1,atkach,2014-07-02 18:41:28+03:00,['e04dc67a6d5960ffc8ea50e68d4fcea501869a98'],14,14,28,18156910,3,1,1,,14935
8cc5cabcb3cb7a34b5fa4a0ff016f8dd82268d89,0,tbeerbower,2014-07-02 12:13:39-04:00,['9a85b8b7c9f98c303e20f7ebbd5bc778acd2b072'],1,0,1,18156911,1,,,,14935
bb43d2b29b1bad22ddf78e53f2c993e245a172ad,1,Aleksandr Kovalenko,2014-07-02 19:35:07+03:00,['8cc5cabcb3cb7a34b5fa4a0ff016f8dd82268d89'],21,8,29,18156940,3,0.111111111,0,0,14935
2ff28495a0a3a5c574fdc691e97cff63dd93b611,1,aBabiichuk,2014-07-02 19:42:29+03:00,['bb43d2b29b1bad22ddf78e53f2c993e245a172ad'],6,6,12,18156952,1,,,,14935
c8eceafc9efc6fa305519f27c21ab51531c0d7cb,1,Subin,2014-07-02 22:52:34+05:18,['2ff28495a0a3a5c574fdc691e97cff63dd93b611'],118,2093,2211,18159163,68,0.507102273,0.575284091,0.8125,14961
cc799863d859a93130bbea2109cdd28581c0e1d3,0,atkach,2014-07-02 20:47:18+03:00,['c8eceafc9efc6fa305519f27c21ab51531c0d7cb'],1,1,2,18159165,1,,,,14961
630323d3ceaac07e7a353c007c47811c3b315cdf,0,Alex Antonenko,2014-07-02 21:11:13+03:00,['cc799863d859a93130bbea2109cdd28581c0e1d3'],164,164,328,18159493,3,0,0,0,14961
05760df1e29807e6288ae2728c41d17e7f19dd34,1,Alex Antonenko,2014-07-02 21:18:19+03:00,['630323d3ceaac07e7a353c007c47811c3b315cdf'],0,8,8,18159501,1,1,1,1,14961
02eb858041cc36a1ed038760068a2431cc1f56fa,0,Subin,2014-07-03 00:10:04+05:18,['05760df1e29807e6288ae2728c41d17e7f19dd34'],6,0,6,18159507,1,1,1,1,14961
5361555f1921d3442af3ac55c3c0283be92d2a7a,1,Vitaly Brodetskyi,2014-07-02 21:26:52+03:00,['02eb858041cc36a1ed038760068a2431cc1f56fa'],11,265,276,18159783,12,0.375,1,1,14963
f1e0d84d91b71dc03a5f19a5d6610dbcf68c94c6,1,Xi Wang,2014-07-02 13:16:50-07:00,['5361555f1921d3442af3ac55c3c0283be92d2a7a'],7,5,12,18159795,2,,,,14963
fa9c106c50bb498f26bb66151174db8fc0984508,1,Xi Wang,2014-07-02 15:16:26-07:00,['f1e0d84d91b71dc03a5f19a5d6610dbcf68c94c6'],1,8,9,18159804,2,,,,14963
d3134ce012a3d13e5c480fa5e7c5308b0952731e,1,Siddharth Wagle,2014-07-02 16:16:08-07:00,['fa9c106c50bb498f26bb66151174db8fc0984508'],6,6,12,18159816,6,,,,14963
64b4727cb63659927e2c755912da44866ea3850d,0,Lisnichenko Dmitro,2014-07-03 13:22:19+03:00,['d3134ce012a3d13e5c480fa5e7c5308b0952731e'],2,2,4,18159820,2,,,,14963
065906814385d674d8612c372406a60989264123,1,aBabiichuk,2014-07-03 14:44:25+03:00,['64b4727cb63659927e2c755912da44866ea3850d'],602,284,886,18160706,13,0,0,0,14963
c1571bc0830d756a538ec0e820b15d5f156150ca,0,Vitaly Brodetskyi,2014-07-03 14:56:07+03:00,['065906814385d674d8612c372406a60989264123'],2,8,10,18160716,4,,,,14963
5c350746be9f266b655bd97a4a8f0cfc62fe05ce,0,Alex Antonenko,2014-07-03 21:22:36+03:00,['c1571bc0830d756a538ec0e820b15d5f156150ca'],1,1,2,18160718,1,,,,14963
22a8a0bfa1c61df90ed2167f13dce65065fc92f7,1,Alex Antonenko,2014-07-03 21:23:36+03:00,['5c350746be9f266b655bd97a4a8f0cfc62fe05ce'],19,2,21,18160739,1,0,0,0,14963
bc7df89ddc1ecf8b610d19b941e2cf9cda916c35,1,atkach,2014-07-03 21:33:15+03:00,['22a8a0bfa1c61df90ed2167f13dce65065fc92f7'],4,4,8,18160747,1,,,,14963
d0700c39b7f3500b97d05cdd4a49201b59b7b201,1,atkach,2014-07-03 21:38:52+03:00,['bc7df89ddc1ecf8b610d19b941e2cf9cda916c35'],0,5,5,18160752,1,0.666666667,1,1,14963
df8d549795563c88e98c93a34b88a375b279a4c8,0,Alex Antonenko,2014-07-03 22:18:32+03:00,['d0700c39b7f3500b97d05cdd4a49201b59b7b201'],3,17,20,18160772,4,0.3,1,1,14963
ccc4c3b97291c566bc9648f45ba3d1279c5942bb,1,Aleksandr Kovalenko,2014-07-03 23:09:57+03:00,['df8d549795563c88e98c93a34b88a375b279a4c8'],7,9,16,18160788,1,,,,14963
7e370c3b632a1b0647b23dd6f290e2b124a0a7d2,1,Aleksandr Kovalenko,2014-07-03 23:13:14+03:00,['ccc4c3b97291c566bc9648f45ba3d1279c5942bb'],30,31,61,18160849,4,0,0,0,14963
14739a22b8e886f1e14aba0be957376e6e922ca9,1,Erin A Boyd,2014-07-03 14:31:34-06:00,['7e370c3b632a1b0647b23dd6f290e2b124a0a7d2'],7,9,16,18160865,1,,,,14963
c1a954ced6b14384936d8e3cb19ed327e8dd57ea,0,aBabiichuk,2014-07-04 15:05:31+03:00,['14739a22b8e886f1e14aba0be957376e6e922ca9'],2,4,6,18160871,1,1,1,1,14963
68f0473739ac2e35e9fc14c8fbda6019a5129570,1,Myroslav Papirkovskyy,2014-07-04 16:36:52+03:00,['c1a954ced6b14384936d8e3cb19ed327e8dd57ea'],295,386,681,18161552,46,0.390243902,0.951219512,0,14964
c5e04983aeb875c994e262cc30cadd6320caef91,1,Oleg Nechiporenko,2014-07-04 16:59:48+03:00,['68f0473739ac2e35e9fc14c8fbda6019a5129570'],107,208,315,18161867,6,1,1,0,14964
ea081968dbefa5213619821656ebfc017badad24,0,Andrew Onishuk,2014-07-04 17:59:15+03:00,['c5e04983aeb875c994e262cc30cadd6320caef91'],191,22,213,18162080,35,,,,14964
fb331835532510e4fb195690e115e6b2a29aff51,0,Andrew Onishuk,2014-07-04 18:01:56+03:00,['ea081968dbefa5213619821656ebfc017badad24'],515,6,521,18162601,15,,,,14964
f3af5990411f2542e6b9481e9f5abe7acee6205d,1,Aleksandr Kovalenko,2014-07-04 19:34:58+03:00,['fb331835532510e4fb195690e115e6b2a29aff51'],1,22,23,18162624,1,,,,14964
84368e30a72eb820f566680d23e7f3f8c1d67277,1,Alex Antonenko,2014-07-04 19:35:53+03:00,['f3af5990411f2542e6b9481e9f5abe7acee6205d'],0,1,1,18162625,1,1,1,1,14964
72fdaa36b843a873d95e4d8ac20ec9088df2c62d,1,Alex Antonenko,2014-07-04 19:37:31+03:00,['84368e30a72eb820f566680d23e7f3f8c1d67277'],2,2,4,18162629,1,,,,14964
ce268b2afafc9af728832b61dcdfa324b5d6e90b,0,atkach,2014-07-04 23:57:34+03:00,['72fdaa36b843a873d95e4d8ac20ec9088df2c62d'],0,12,12,18162641,1,0.555555556,1,1,14964
81ccf73a9fad21f06473f5e66c7e07fad9e23050,1,Andrew Onishuk,2014-07-07 15:10:42+03:00,['ce268b2afafc9af728832b61dcdfa324b5d6e90b'],0,2,2,18162643,1,1,1,0,14964
35ae35971733e85216446b218b484d7e6b3e89fb,0,Dmytro Sen,2014-07-07 15:29:58+03:00,['81ccf73a9fad21f06473f5e66c7e07fad9e23050'],6,20,26,18162669,8,,,,14964
699179ab4d554a7431ed5ea7725e31936a56c22c,1,Aleksandr Kovalenko,2014-07-07 15:37:07+03:00,['35ae35971733e85216446b218b484d7e6b3e89fb'],3,25,28,18162697,4,1,1,0.125,14964
9c25b6ce673d2e931a7ce63db73295b842ace1aa,1,Dmytro Sen,2014-07-07 16:30:41+03:00,['699179ab4d554a7431ed5ea7725e31936a56c22c'],40,83,123,18162820,2,0,0,1,14964
dfedb0313552530827eba7899cb5250ae5c9d7d1,1,Nate Cole,2014-07-07 09:51:12-04:00,['9c25b6ce673d2e931a7ce63db73295b842ace1aa'],66,124,190,18163010,7,0,0,0.916666667,14964
3ee0088e0cd88617c4800c8dd2815eae32b380ee,1,Andrew Onishuk,2014-07-07 17:56:27+03:00,['dfedb0313552530827eba7899cb5250ae5c9d7d1'],7,21,28,18163038,2,0,1,0.666666667,14964
8ddd85b0194451d55211381098fc5c401a324767,1,Andrew Onishuk,2014-07-07 18:24:26+03:00,['3ee0088e0cd88617c4800c8dd2815eae32b380ee'],37,77,114,18163152,1,,,,14964
931f8aed25c66200cdb1c51b6b9933be7966113b,1,Lisnichenko Dmitro,2014-07-07 18:29:54+03:00,['8ddd85b0194451d55211381098fc5c401a324767'],227,105,332,18163484,4,1,0.849462366,0,14964
19392c5a46436c1bdc49bdc804c24c5bde8f5a63,1,Lisnichenko Dmitro,2014-07-07 18:45:38+03:00,['931f8aed25c66200cdb1c51b6b9933be7966113b'],11,11,22,18163506,4,,,,14964
54ef1b5a324eb17798b74ed46aed026fd8879811,0,Andrew Onishuk,2014-07-07 19:15:04+03:00,['19392c5a46436c1bdc49bdc804c24c5bde8f5a63'],13,6,19,18163525,1,0,0,0,14964
028f996a55f5f623e777086f2527c9f5563322f2,0,Andrew Onishuk,2014-07-07 19:42:10+03:00,['54ef1b5a324eb17798b74ed46aed026fd8879811'],4,2,6,18163531,2,,,,14964
c0ff6adb4e7d295e15aa662c01991b0945ca1461,1,Andrew Onishuk,2014-07-07 19:55:39+03:00,['028f996a55f5f623e777086f2527c9f5563322f2'],2,48,50,18163581,4,0.935483871,1,0.483870968,14964
510ff0a6aeaebb607ad52cde6825bb235ee7033e,0,Lisnichenko Dmitro,2014-07-07 20:32:19+03:00,['c0ff6adb4e7d295e15aa662c01991b0945ca1461'],79,60,139,18163720,3,0,0,0,14964
67c40e3f5e53e72b80f43e7df1a11c070fdaadea,1,Oleg Nechiporenko,2014-07-07 20:52:15+03:00,['510ff0a6aeaebb607ad52cde6825bb235ee7033e'],9,13,22,18163742,1,0,0,1,14964
c9017f328d81ef6fa9343a6d1565ae3036eae4d0,0,aBabiichuk,2014-07-07 21:12:25+03:00,['67c40e3f5e53e72b80f43e7df1a11c070fdaadea'],0,27,27,18163769,1,,,,14964
e9d8264a55f82436484aedac61ccd378751cceb1,0,Aleksandr Kovalenko,2014-07-07 21:13:40+03:00,['c9017f328d81ef6fa9343a6d1565ae3036eae4d0'],0,9,9,18163778,1,0.9,1,1,14964
e3de7b3b684af470fb8f5b08279ba28d4f979a48,1,atkach,2014-07-07 21:44:05+03:00,['e9d8264a55f82436484aedac61ccd378751cceb1'],32,29,61,18163839,2,1,1,1,14964
cb1ec1e2a599fe36941c622e840bce6e0ebef908,1,atkach,2014-07-07 21:44:05+03:00,['e3de7b3b684af470fb8f5b08279ba28d4f979a48'],5,3,8,18163847,1,1,1,0,14964
b3e1f7cfbbe66936a978cd87779388dd7bebb8cf,1,Jaimin Jetly,2014-07-07 15:07:40-07:00,['cb1ec1e2a599fe36941c622e840bce6e0ebef908'],3,7,10,18163857,2,1,1,1,14964
fcc87a60afe78883d6c1acfb476106e2953160cb,1,Srimanth Gunturi,2014-07-07 15:21:36-07:00,['b3e1f7cfbbe66936a978cd87779388dd7bebb8cf'],2,23,25,18163882,3,1,1,1,14964
84e13aabd2abb141af9d39eb7186b0dc5a69ed92,1,aBabiichuk,2014-07-08 14:00:08+03:00,['fcc87a60afe78883d6c1acfb476106e2953160cb'],331,149,480,18164362,15,0.436893204,0,0.038834951,14964
b69f06e00570c60785b274c7637108c699d125f0,1,Alex Antonenko,2014-07-08 15:53:52+03:00,['84e13aabd2abb141af9d39eb7186b0dc5a69ed92'],1,12,13,18164375,3,1,1,1,14964
97e81197454788d13a20a732a178aca4aa6b4ab7,1,aBabiichuk,2014-07-08 16:32:00+03:00,['b69f06e00570c60785b274c7637108c699d125f0'],186,132,318,18164693,13,0.428571429,0,0.142857143,14964
9c39acb06a12393c1beb6129a61123d82e79f87d,1,Lisnichenko Dmitro,2014-07-08 17:44:19+03:00,['97e81197454788d13a20a732a178aca4aa6b4ab7'],19662,56,19718,18184411,39,,,,14964
09aef90ebd300e78ff65c0002387bb48cca3a058,1,atkach,2014-07-08 17:55:42+03:00,['9c39acb06a12393c1beb6129a61123d82e79f87d'],123,91,214,18184625,5,0,0.146341463,0,14964
dc43984ca0320864ddf3d5085bf1ced4c7f70d4e,1,Andrew Onishuk,2014-07-08 18:12:03+03:00,['09aef90ebd300e78ff65c0002387bb48cca3a058'],3,8,11,18184636,2,,,,14964
18183be428ff50caa5d9dce9696df229f271a1c8,1,Jaimin Jetly,2014-07-08 11:41:48-07:00,['dc43984ca0320864ddf3d5085bf1ced4c7f70d4e'],23,35,58,18184694,5,1,1,1,14964
3efb5fc4897936c855163a9579803f2fbfc97102,1,Xi Wang,2014-07-08 12:05:03-07:00,['18183be428ff50caa5d9dce9696df229f271a1c8'],6,71,77,18184771,4,0.5,0.5,1,14964
cd757e0009ddd2408b742988d74ac9bbfe7a0d8d,1,Yusaku Sako,2014-07-08 12:09:27-07:00,['3efb5fc4897936c855163a9579803f2fbfc97102'],23,27,50,18184821,3,0.333333333,0.333333333,1,14964
6598c9bdf0f7340f1c1b1e7f18cd6c132f5000d3,1,Siddharth Wagle,2014-07-08 12:51:22-07:00,['cd757e0009ddd2408b742988d74ac9bbfe7a0d8d'],2,2,4,18184825,1,,,,14964
699a42f4408474e1f9eae60cf75a85b1d1e9eecb,0,Erin A Boyd,2014-07-08 15:22:12-06:00,['6598c9bdf0f7340f1c1b1e7f18cd6c132f5000d3'],6,6,12,18184837,3,,,,14964
49a14e4f85a6f11aca198b9c204348c894b24512,0,Jaimin Jetly,2014-07-08 17:09:51-07:00,['699a42f4408474e1f9eae60cf75a85b1d1e9eecb'],1,1,2,18184839,1,,,,14964
ed65cfdd026a739d5a112ab0e640b0bd958b9352,1,Erin A Boyd,2014-07-08 20:15:42-06:00,['49a14e4f85a6f11aca198b9c204348c894b24512'],16,39,55,18184894,3,,,,14964
00f8d5c5c41fc3b2590aec3b2cbbd485c53142d7,1,Yusaku Sako,2014-07-08 21:29:58-07:00,['ed65cfdd026a739d5a112ab0e640b0bd958b9352'],3358,3135,6493,18191387,77,1,0,0.893442623,14966
4a2498ea3885fc0cc807ce8179855b6416802a3b,1,Andrew Onishuk,2014-07-09 13:43:19+03:00,['00f8d5c5c41fc3b2590aec3b2cbbd485c53142d7'],9,741,750,18192137,8,0.252525253,0.420875421,0.939393939,14969
5bb59403fea8de54690f6f19a30df5462c99f784,1,Lisnichenko Dmitro,2014-07-09 14:43:23+03:00,['4a2498ea3885fc0cc807ce8179855b6416802a3b'],1,3,4,18192141,2,1,1,1,14969
306e4d4693f35c30f21a56e205cadb3d2534f8ef,1,Aleksandr Kovalenko,2014-07-09 15:34:53+03:00,['5bb59403fea8de54690f6f19a30df5462c99f784'],36,61,97,18192238,3,0.722222222,0.555555556,1,14969
fbeeaf8b544274b51fa15d7b1ddddeafee35ff39,1,atkach,2014-07-09 17:57:56+03:00,['306e4d4693f35c30f21a56e205cadb3d2534f8ef'],172,175,347,18192585,10,1,1,1,14969
ba5430ab09aa17105862111190efd1787f8cd940,0,aBabiichuk,2014-07-09 18:06:23+03:00,['fbeeaf8b544274b51fa15d7b1ddddeafee35ff39'],1,1,2,18192587,1,,,,14969
b5e1256fae972d3d92fd8039522c397612d48660,0,aBabiichuk,2014-07-09 18:06:23+03:00,['ba5430ab09aa17105862111190efd1787f8cd940'],0,4,4,18192591,1,0,0,1,14969
d3b8a5e9eef6ea1152edc492d230bf0c85db9f60,1,Aleksandr Kovalenko,2014-07-09 20:43:55+03:00,['b5e1256fae972d3d92fd8039522c397612d48660'],17,7,24,18192615,1,,,,14969
627e9261bd33de123452fb52549820905dd96942,1,atkach,2014-07-09 20:54:17+03:00,['d3b8a5e9eef6ea1152edc492d230bf0c85db9f60'],9,24,33,18192648,1,1,1,1,14969
a48363fc98bbf9331dcaece7fe0fa765d839803f,0,Jaimin Jetly,2014-07-09 10:56:30-07:00,['627e9261bd33de123452fb52549820905dd96942'],27,0,27,18192675,1,,,,14969
b1e5641d21035f62807c80330183d6e460f3ae35,0,Dmytro Sen,2014-07-09 21:19:00+03:00,['a48363fc98bbf9331dcaece7fe0fa765d839803f'],0,2,2,18192677,2,,,,14969
673f649b0733554542996c47e0546d8d4227c27a,1,Alex Antonenko,2014-07-09 21:23:23+03:00,['b1e5641d21035f62807c80330183d6e460f3ae35'],5,5,10,18192687,1,1,1,1,14969
3b62427a414fd461f18495bf9d83fc5f16c5342a,1,Alex Antonenko,2014-07-09 23:14:12+03:00,['673f649b0733554542996c47e0546d8d4227c27a'],64,65,129,18192816,6,0.714285714,0.714285714,1,14969
b94eb716ba3228be6d39f0fc9009f8e63d146c89,1,Nate Cole,2014-07-09 16:21:48-04:00,['3b62427a414fd461f18495bf9d83fc5f16c5342a'],105,340,445,18193261,15,0.022222222,0.877777778,0.922222222,14971
70eec3b86ebcff9989c303ae1f2ec944cbd9c67c,1,Jaimin Jetly,2014-07-09 15:20:57-07:00,['b94eb716ba3228be6d39f0fc9009f8e63d146c89'],122,66,188,18193449,16,1,0.589285714,0,14971
0bc14443b915030d08b55b7e5248c91d763730d8,1,Jaimin Jetly,2014-07-09 16:30:18-07:00,['70eec3b86ebcff9989c303ae1f2ec944cbd9c67c'],131,138,269,18193718,2,1,1,1,14971
b08909a1f385b66d45cbf90785a41a5e8e5a3687,1,Srimanth Gunturi,2014-07-09 17:10:53-07:00,['0bc14443b915030d08b55b7e5248c91d763730d8'],157,754,911,18194629,131,0.151125402,0.977491961,0.954983923,14974
05517dae3bad5aa5cc75b9f17297e7d4daaa30d6,1,Yusaku Sako,2014-07-09 17:17:14-07:00,['b08909a1f385b66d45cbf90785a41a5e8e5a3687'],3,3,6,18194635,3,,,,14974
8af1ee1f28bf99091cbe03480fb347f2caafe43b,1,Jaimin Jetly,2014-07-09 18:42:44-07:00,['05517dae3bad5aa5cc75b9f17297e7d4daaa30d6'],3,3,6,18194641,2,,,,14974
2934219233c999a5e0fadc183729fda27bae50f4,1,Srimanth Gunturi,2014-07-09 19:15:38-07:00,['8af1ee1f28bf99091cbe03480fb347f2caafe43b'],9,33,42,18194683,3,0,0.625,0.5,14974
4c6ee1f904f116fa7641bca948568305d2a02849,0,Dmytro Sen,2014-07-10 13:07:57+03:00,['2934219233c999a5e0fadc183729fda27bae50f4'],4,4,8,18194691,2,,,,14974
f109887bb40eef4d05a1cb15d6fe74a73e4bed1d,0,Andrew Onishuk,2014-07-10 14:45:16+03:00,['4c6ee1f904f116fa7641bca948568305d2a02849'],1,7,8,18194699,2,,,,14974
eacdb2c46299b1529ce319334a4c0da3e518f2d7,1,atkach,2014-07-10 14:58:44+03:00,['f109887bb40eef4d05a1cb15d6fe74a73e4bed1d'],14,1,15,18194714,2,0,0,0,14974
4b3ab24fc6a0dee2a5dacb7b660e74f880e9cc56,0,Aleksandr Kovalenko,2014-07-10 16:50:58+03:00,['eacdb2c46299b1529ce319334a4c0da3e518f2d7'],1,7,8,18194722,1,1,1,1,14974
30a41aca30242dc6845b3315b1d26469164d2e68,1,Lisnichenko Dmitro,2014-07-10 17:55:59+03:00,['4b3ab24fc6a0dee2a5dacb7b660e74f880e9cc56'],335,999,1334,18196056,21,0.189427313,0.744493392,0.563876652,14974
05630b23244b970bcc3645af02ac56e193125262,1,atkach,2014-07-10 18:14:11+03:00,['30a41aca30242dc6845b3315b1d26469164d2e68'],207,103,310,18196366,10,0.04,0,0.16,14974
edf653280eb24358d902144523b454fbcf0dfe96,1,Vitaly Brodetskyi,2014-07-10 19:42:51+03:00,['05630b23244b970bcc3645af02ac56e193125262'],13,317,330,18196696,2,0,0.691964286,1,14974
9c75be7535fb707abec484c6b85a01ef10f4c79d,1,Alex Antonenko,2014-07-10 20:32:35+03:00,['edf653280eb24358d902144523b454fbcf0dfe96'],54,106,160,18196856,3,1,1,1,14974
5989a30dd61ef6a74f268470cd57cae689ffa800,1,Aleksandr Kovalenko,2014-07-10 20:52:18+03:00,['9c75be7535fb707abec484c6b85a01ef10f4c79d'],1,11,12,18196868,2,1,1,1,14974
919a9f29f20fe718b6193f82e58151f44b22814b,1,Siddharth Wagle,2014-07-10 11:06:40-07:00,['5989a30dd61ef6a74f268470cd57cae689ffa800'],2,2,4,18196872,2,,,,14974
dca4fa3e8a1c159f99aea615c0d064d7202c2f30,1,Siddharth Wagle,2014-07-10 11:21:46-07:00,['919a9f29f20fe718b6193f82e58151f44b22814b'],6,6,12,18196884,6,,,,14974
82c384ef673ace6db8ceb053705254e15a040cc4,1,Srimanth Gunturi,2014-07-10 12:36:07-07:00,['dca4fa3e8a1c159f99aea615c0d064d7202c2f30'],1,161,162,18197046,4,1,1,1,14976
b640b909df51727e9ebc0ad9ac9450926852cf60,0,Yusaku Sako,2014-07-10 15:45:48-07:00,['82c384ef673ace6db8ceb053705254e15a040cc4'],1,1,2,18197048,1,,,,14976
ada7f1eb63002750ca64fd67a832c570408cfbb4,1,Jaimin Jetly,2014-07-10 17:15:21-07:00,['b640b909df51727e9ebc0ad9ac9450926852cf60'],13,21,34,18197082,6,1,1,1,14976
e82561dc4ff84b22e4e503ac4bf5b1432777555e,1,Siddharth Wagle,2014-07-10 21:14:22-07:00,['ada7f1eb63002750ca64fd67a832c570408cfbb4'],0,140,140,18197222,5,,,,14979
76ad10f4a6f10aa9e4ee5b3b2e903d4e28a9f08a,1,Srimanth Gunturi,2014-07-10 22:56:50-07:00,['e82561dc4ff84b22e4e503ac4bf5b1432777555e'],27,174,201,18197423,8,0.426966292,0.426966292,0.93258427,14979
f3c8c28562c6726733541b36b9a271d443aa0b16,1,Oleg Nechiporenko,2014-07-11 14:11:36+03:00,['76ad10f4a6f10aa9e4ee5b3b2e903d4e28a9f08a'],0,752,752,18198175,20,0.23381295,1,1,14999
70ab76b23c1931f530cc82600942f1f2cda5fe0f,1,atkach,2014-07-11 14:47:01+03:00,['f3c8c28562c6726733541b36b9a271d443aa0b16'],1,1,2,18198177,1,,,,14999
e8c7e6ba0fc132c41419e30b810bad5c6fb6baad,1,Alex Antonenko,2014-07-11 20:00:23+03:00,['70ab76b23c1931f530cc82600942f1f2cda5fe0f'],0,54,54,18198231,3,1,1,1,14999
959c0d0fe6323bdffd7ed8cc34ddff278daf0cb8,1,Xi Wang,2014-07-11 13:30:28-07:00,['e8c7e6ba0fc132c41419e30b810bad5c6fb6baad'],3,15,18,18198249,1,1,1,1,14999
9ee720be2d0ab389844540c66a7014893459b93c,0,Siddharth Wagle,2014-07-11 13:48:42-07:00,['959c0d0fe6323bdffd7ed8cc34ddff278daf0cb8'],0,12,12,18198261,2,,,,14999
fa1a119fff5f34c813ecd49fbc6d5c11c1fd68e4,1,Xi Wang,2014-07-11 14:25:38-07:00,['9ee720be2d0ab389844540c66a7014893459b93c'],28,16,44,18198305,3,0,0,0,14999
80b3477682ec409d62541202dd28bdd956cea10e,1,Jaimin Jetly,2014-07-11 14:39:28-07:00,['fa1a119fff5f34c813ecd49fbc6d5c11c1fd68e4'],2,2,4,18198309,2,,,,14999
e781b1a697915ba09b8e7676641011734351270a,1,Srimanth Gunturi,2014-07-12 11:40:16-07:00,['80b3477682ec409d62541202dd28bdd956cea10e'],8,62,70,18198379,1,0.925,1,1,14999
03cbafb35db01b0d96df5bfa7f8c7b7747770b5a,1,Alex Antonenko,2014-07-13 16:05:42+03:00,['e781b1a697915ba09b8e7676641011734351270a'],15,15,30,18198409,2,0,0,1,14999
64a6c03239b3f3ec1194beb7669dc3248b722569,0,Aleksandr Kovalenko,2014-07-14 15:15:26+03:00,['03cbafb35db01b0d96df5bfa7f8c7b7747770b5a'],1,1,2,18198411,1,,,,14999
3bddf7b7c4652c584268040e5e8f2d191db268a9,1,Oleg Nechiporenko,2014-07-14 15:22:42+03:00,['64a6c03239b3f3ec1194beb7669dc3248b722569'],4,4,8,18198419,1,,,,14999
ad0702ccd3c6794134eeda1d59dfd8e047e4df1e,0,Vitaly Brodetskyi,2014-07-14 15:27:09+03:00,['3bddf7b7c4652c584268040e5e8f2d191db268a9'],1,6,7,18198426,2,,,,14999
64a65149f490272129329e1052c9d9427e132fa8,1,Oleg Nechiporenko,2014-07-14 18:10:09+03:00,['ad0702ccd3c6794134eeda1d59dfd8e047e4df1e'],1,896,897,18199323,11,0.564315353,0.647302905,0.846473029,15009
5bf105f75b876e1bf57c9b35f7195226184c01fd,0,aBabiichuk,2014-07-14 18:33:21+03:00,['64a65149f490272129329e1052c9d9427e132fa8'],4,3,7,18199330,1,1,1,0,15009
8932e6472edba92b9183c7b2d9dedb348aebf84a,1,Yusaku Sako,2014-07-14 11:14:54-07:00,['5bf105f75b876e1bf57c9b35f7195226184c01fd'],0,3,3,18199333,1,1,1,1,15009
fedcbb8a51be3a12ce4dcf2a7ec0f49f37552bb2,1,Mahadev Konar,2014-07-14 14:36:39-07:00,['8932e6472edba92b9183c7b2d9dedb348aebf84a'],8,80,88,18199421,6,0,0.872727273,0.945454545,15009
c5b0e48333c28e6b433f8d5538677e433341bfda,1,Mahadev Konar,2014-07-14 16:21:13-07:00,['fedcbb8a51be3a12ce4dcf2a7ec0f49f37552bb2'],75,15,90,18199511,19,,,,15009
f3f4876f7e42162089953c93e15ae12db7264d69,1,Xi Wang,2014-07-14 16:26:58-07:00,['c5b0e48333c28e6b433f8d5538677e433341bfda'],7,68,75,18199586,7,0.933333333,1,1,15009
ff82ef366439d0e036f5c8fc89df526c00780578,0,Oleg Nechiporenko,2014-07-15 14:44:02+03:00,['f3f4876f7e42162089953c93e15ae12db7264d69'],9,12,21,18199607,1,1,1,1,15009
de2ba0fc82304753e76da164999691231879c955,1,atkach,2014-07-15 16:33:17+03:00,['ff82ef366439d0e036f5c8fc89df526c00780578'],5,11,16,18199623,2,1,1,1,15009
08e2350989e5b7fb61a738fa7c8ae06b4373d8b9,1,atkach,2014-07-15 17:43:55+03:00,['de2ba0fc82304753e76da164999691231879c955'],155,402,557,18200180,8,1,1,1,15010
95833e8c4d1cbad67a84e1e828e9729eb662703e,0,Nate Cole,2014-07-15 10:58:38-04:00,['08e2350989e5b7fb61a738fa7c8ae06b4373d8b9'],2,4,6,18200186,1,,,,15010
b86433949bb2796f329e8093e256c311026e9fe2,1,Aleksandr Kovalenko,2014-07-15 19:40:53+03:00,['95833e8c4d1cbad67a84e1e828e9729eb662703e'],76,765,841,18201027,79,0.870967742,1,1,15026
662f9bdb8241c82bde1955f1b96c38b914353e3d,0,Alex Antonenko,2014-07-15 20:10:47+03:00,['b86433949bb2796f329e8093e256c311026e9fe2'],1,1,2,18201029,1,,,,15026
a4c242b8b39dcbca073d2491271811fde2dff998,0,Alex Antonenko,2014-07-15 20:56:33+03:00,['662f9bdb8241c82bde1955f1b96c38b914353e3d'],2,2,4,18201033,1,,,,15026
4eb552e7d7386008c5030ec755b6e71c2a3370a0,1,Nate Cole,2014-07-15 14:38:36-04:00,['a4c242b8b39dcbca073d2491271811fde2dff998'],7,11,18,18201051,1,0,0,1,15026
ebed6dca2f88add7058814eeb656dc5eb8bba2cf,0,Jaimin Jetly,2014-07-15 12:37:54-07:00,['4eb552e7d7386008c5030ec755b6e71c2a3370a0'],1,0,1,18201052,1,,,,15026
8e2993515d3db6018bd38ee5ac423101702e2a01,1,Jaimin Jetly,2014-07-15 16:30:24-07:00,['ebed6dca2f88add7058814eeb656dc5eb8bba2cf'],341,136,477,18201529,6,0.146341463,0.56097561,0.951219512,15026
9075909f06874726f2c99d77a8845aaacf2707a6,1,Xi Wang,2014-07-15 17:34:28-07:00,['8e2993515d3db6018bd38ee5ac423101702e2a01'],12,11,23,18201552,4,1,1,1,15026
8c5490e5992e94121cb1959fe1b8a4fcb633077f,0,Jaimin Jetly,2014-07-15 18:08:03-07:00,['9075909f06874726f2c99d77a8845aaacf2707a6'],4,4,8,18201560,3,,,,15026
2636029542f5910dc031a243de26c2315fcc25fd,1,Oleg Nechiporenko,2014-07-16 14:11:14+03:00,['8c5490e5992e94121cb1959fe1b8a4fcb633077f'],1,1,2,18201562,1,,,,15026
6244c49babe87d8bd34126c95651c42fcedc8a76,1,aBabiichuk,2014-07-16 15:14:08+03:00,['2636029542f5910dc031a243de26c2315fcc25fd'],4000,4083,8083,18209645,23,0,0,0.012048193,15026
b0ae1fdde4cb5f58f64df23f4ffa4e35b25c3601,1,Andrew Onishuk,2014-07-16 15:58:23+03:00,['2636029542f5910dc031a243de26c2315fcc25fd'],2827,3704,6531,18216176,217,0,0.623376623,0.948051948,15033
4e23fa2d8456ebc8b5cdd2cd5c09ebde11596d6a,0,aBabiichuk,2014-07-16 15:59:36+03:00,"['6244c49babe87d8bd34126c95651c42fcedc8a76', 'b0ae1fdde4cb5f58f64df23f4ffa4e35b25c3601']",2827,3704,6531,18222707,217,,,,15033
81dae66ea59bade362ac45061399c5675e458099,1,Alex Antonenko,2014-07-16 16:17:47+03:00,['4e23fa2d8456ebc8b5cdd2cd5c09ebde11596d6a'],0,7,7,18222714,1,0,0,1,15033
d84b2f57b532c8f6361b5d807dd375aa4280b44b,1,Lisnichenko Dmitro,2014-07-16 16:30:03+03:00,['81dae66ea59bade362ac45061399c5675e458099'],2,126,128,18222842,3,1,1,1,15035
8b56b18a39163aaf4c7b8cbc900930a863467d36,1,Vitaly Brodetskyi,2014-07-16 15:50:22+03:00,['d84b2f57b532c8f6361b5d807dd375aa4280b44b'],19,150,169,18223011,15,0.01754386,0.771929825,1,15035
4cc243df0408fb23168048b03a2a43971e9ac81a,0,aBabiichuk,2014-07-16 17:34:30+03:00,['8b56b18a39163aaf4c7b8cbc900930a863467d36'],1,29,30,18223041,2,,,,15035
2293a285a8f018f6e2da45e24e213c5192d447a4,1,atkach,2014-07-16 17:48:18+03:00,['4cc243df0408fb23168048b03a2a43971e9ac81a'],127,144,271,18223312,11,1,1,1,15035
6cf8fb17d618081c8c736bfcad02af003c04a61a,0,Aleksandr Kovalenko,2014-07-16 18:11:16+03:00,['2293a285a8f018f6e2da45e24e213c5192d447a4'],1,4,5,18223317,1,1,1,1,15035
8f2f5bcde7ee2411cb0e121ee28cb215e7112933,1,Andrew Onishuk,2014-07-16 18:19:51+03:00,['6cf8fb17d618081c8c736bfcad02af003c04a61a'],23,30,53,18223370,2,0,0,0,15035
74fac8a264b74ead25625ed1875a9b5f4ae20563,1,Aleksandr Kovalenko,2014-07-16 18:28:41+03:00,['8f2f5bcde7ee2411cb0e121ee28cb215e7112933'],0,8,8,18223378,2,,,,15035
fd15d4c8ce2f389ae7614d42ec9a74002af17d3a,1,aBabiichuk,2014-07-16 18:29:12+03:00,['4cc243df0408fb23168048b03a2a43971e9ac81a'],0,35,35,18223413,3,0,0,1,15035
7c97da6e5e58bbcd9bd2530bc9b1c60b67687267,0,aBabiichuk,2014-07-16 18:34:23+03:00,"['fd15d4c8ce2f389ae7614d42ec9a74002af17d3a', '74fac8a264b74ead25625ed1875a9b5f4ae20563']",151,186,337,18223750,16,,,,15035
f160dcfdac2df9cba3544afa7629d4dc40339ad7,0,Andrew Onishuk,2014-07-16 18:41:56+03:00,['7c97da6e5e58bbcd9bd2530bc9b1c60b67687267'],1,3,4,18223754,2,,,,15035
b76efd5b63eedd6bafd7ab484bf2ec4a3c763b1d,1,Oleg Nechiporenko,2014-07-16 18:42:35+03:00,['2636029542f5910dc031a243de26c2315fcc25fd'],219,1696,1915,18225669,20,0.284946237,0.379032258,0.98655914,15044
8af0d07283a4ed90e44367e2cdbfa3a07c4319de,0,Andrew Onishuk,2014-07-16 19:00:44+03:00,['f160dcfdac2df9cba3544afa7629d4dc40339ad7'],14,1,15,18225684,2,,,,15044
fca841856eb9adca0792ef13880653463e8b73a0,0,Oleg Nechiporenko,2014-07-16 19:09:03+03:00,"['b76efd5b63eedd6bafd7ab484bf2ec4a3c763b1d', '8af0d07283a4ed90e44367e2cdbfa3a07c4319de']",6996,8305,15301,18240985,265,,,,15044
aa2f981e45ddcedffa783f7db46cabe5a43a4d66,1,Lisnichenko Dmitro,2014-07-16 19:11:52+03:00,['fca841856eb9adca0792ef13880653463e8b73a0'],27,81,108,18241093,2,0,0.272727273,0.272727273,15044
04fccec02ed375bc1f0b9ab6d15ade36e34e27a1,0,atkach,2014-07-16 19:33:04+03:00,['aa2f981e45ddcedffa783f7db46cabe5a43a4d66'],1,1,2,18241095,1,,,,15044
c68d382d290a73d2ba8b1c383a72b62e193e5550,0,Andrew Onishuk,2014-07-16 19:47:27+03:00,['04fccec02ed375bc1f0b9ab6d15ade36e34e27a1'],0,1,1,18241096,1,,,,15044
d90d348839c338507d5992117c63ea5a91bf9199,0,Andrew Onishuk,2014-07-16 19:48:35+03:00,['c68d382d290a73d2ba8b1c383a72b62e193e5550'],8,10,18,18241114,4,,,,15044
87db0903ccdd3828eff4ab4d3ddd92804ecf4987,0,Alex Antonenko,2014-07-16 20:03:41+03:00,['d90d348839c338507d5992117c63ea5a91bf9199'],1,2,3,18241117,1,1,1,1,15044
298bb53d6a68d309f7c0539b02aa52222531b864,1,atkach,2014-07-16 20:09:14+03:00,['87db0903ccdd3828eff4ab4d3ddd92804ecf4987'],393,322,715,18241832,29,0.724137931,0.172413793,0.931034483,15047
c13dad9a1a93b913a8067527289f8b0e38560fbb,1,Andrew Onishuk,2014-07-16 20:45:56+03:00,['298bb53d6a68d309f7c0539b02aa52222531b864'],342,70,412,18242244,13,,,,15047
442b7961c739da2e7fb82e6b49b10878faa8c777,1,Alex Antonenko,2014-07-16 20:58:37+03:00,['c13dad9a1a93b913a8067527289f8b0e38560fbb'],9,53,62,18242306,4,0,0.222222222,0.944444444,15047
38999bb177a2445ed3dd6578550e6d9e1665909c,0,atkach,2014-07-16 21:06:06+03:00,['442b7961c739da2e7fb82e6b49b10878faa8c777'],87,98,185,18242491,3,0,1,1,15047
47fd58a07d52f56982be1ee51c863d3e2f0d7632,1,Nate Cole,2014-07-16 14:31:07-04:00,['38999bb177a2445ed3dd6578550e6d9e1665909c'],0,1988,1988,18244479,13,1,1,1,15057
62f1b396065f288c140104c3928c03d047ea327b,0,Srimanth Gunturi,2014-07-16 11:44:39-07:00,['47fd58a07d52f56982be1ee51c863d3e2f0d7632'],3,3,6,18244485,3,,,,15057
f9e4207d56055503373160ee3cf924b55ef5975d,1,Jaimin Jetly,2014-07-16 12:26:44-07:00,['62f1b396065f288c140104c3928c03d047ea327b'],2,7,9,18244494,1,,,,15057
0f37b7aa6e85be1a8a72b3950cfcd7ab7d077150,0,Siddharth Wagle,2014-07-16 17:03:25-07:00,['f9e4207d56055503373160ee3cf924b55ef5975d'],0,7,7,18244501,2,,,,15057
e5d2cf5929958e2dc9da6f1b4189bc2d7e9cb799,0,Xi Wang,2014-07-16 17:37:14-07:00,['0f37b7aa6e85be1a8a72b3950cfcd7ab7d077150'],1,1,2,18244503,1,,,,15057
dc5a2e96efad37ea5b5afe599ad0b47110eaad7f,1,Andrew Onishuk,2014-07-17 13:56:13+03:00,['e5d2cf5929958e2dc9da6f1b4189bc2d7e9cb799'],0,17,17,18244520,1,,,,15057
cc7211f3aa61ff34c89b26e37bea7fdcc670991c,0,Andrew Onishuk,2014-07-17 16:03:48+03:00,['dc5a2e96efad37ea5b5afe599ad0b47110eaad7f'],5,10,15,18244535,1,,,,15057
bb9b9cdcdad7ad0e666dc49be05e95f960c739d1,0,Aleksandr Kovalenko,2014-07-17 17:34:45+03:00,['cc7211f3aa61ff34c89b26e37bea7fdcc670991c'],12,16,28,18244563,5,1,1,1,15057
85255fae800c889a6316a2aa7a031929452ff9ca,1,Andrew Onishuk,2014-07-17 17:47:53+03:00,['bb9b9cdcdad7ad0e666dc49be05e95f960c739d1'],0,14,14,18244577,1,,,,15057
ef23fba3f6e5f9134390a59c37d5bc86b85b969b,1,aBabiichuk,2014-07-17 19:46:52+03:00,['85255fae800c889a6316a2aa7a031929452ff9ca'],2,3,5,18244582,2,1,1,1,15057
c4a6163eec7c43b29e7e60750c112ffd99f32704,0,Srimanth Gunturi,2014-07-17 10:05:00-07:00,['ef23fba3f6e5f9134390a59c37d5bc86b85b969b'],3,31,34,18244616,2,0.714285714,0.714285714,1,15057
110ac80ec881f5c327ee3dd37ff51205246259b6,1,Xi Wang,2014-07-17 15:10:56-07:00,['c4a6163eec7c43b29e7e60750c112ffd99f32704'],4,4,8,18244624,2,,,,15057
d90c8eed8cc42714ff2fbb700cc4663115b8606e,1,Xi Wang,2014-07-17 15:27:49-07:00,['110ac80ec881f5c327ee3dd37ff51205246259b6'],1,1,2,18244626,1,,,,15057
a09565cffaa552540f801e1e5af49dd4e630369a,1,Xi Wang,2014-07-17 16:20:09-07:00,['d90c8eed8cc42714ff2fbb700cc4663115b8606e'],1,16,17,18244643,1,0,0,1,15057
24225fd0bd662ffd15c3b9a103ca24342f373eec,1,Jaimin Jetly,2014-07-17 16:42:07-07:00,['a09565cffaa552540f801e1e5af49dd4e630369a'],36,24,60,18244703,5,1,1,0,15057
b54285b80d1442a00bbf745847fe6620e00c3831,1,aBabiichuk,2014-07-18 12:51:08+03:00,['24225fd0bd662ffd15c3b9a103ca24342f373eec'],22,54,76,18244779,3,0,1,0,15057
7781586747dd1a2c5004427aee11db748732ac20,1,aBabiichuk,2014-07-18 12:53:52+03:00,['b54285b80d1442a00bbf745847fe6620e00c3831'],268,25,293,18245072,4,0,0,0,15057
4a2307c6e21c386fbe2e421ca41916601e780728,1,aBabiichuk,2014-07-18 12:57:53+03:00,['7781586747dd1a2c5004427aee11db748732ac20'],100,119,219,18245291,7,1,1,1,15057
f0b39deb794a7288f61c28dfaf0f33027998a557,0,Oleg Nechiporenko,2014-07-18 14:17:09+03:00,['24225fd0bd662ffd15c3b9a103ca24342f373eec'],2,2,4,18245295,1,,,,15057
7bdb1e42c8be2498cbeda87360bb73d9b5879e4b,0,Oleg Nechiporenko,2014-07-18 14:20:32+03:00,"['f0b39deb794a7288f61c28dfaf0f33027998a557', '4a2307c6e21c386fbe2e421ca41916601e780728']",390,198,588,18245883,13,,,,15057
39a92eb492833ace0b997b2cc4c9523c61832cc0,1,Nate Cole,2014-07-18 07:47:48-04:00,['7bdb1e42c8be2498cbeda87360bb73d9b5879e4b'],36,1594,1630,18247513,35,0.719056974,0.73870334,0.844793713,15068
5659f0a23b2cb8346d496246d0cce635aeefa87d,1,Oleg Nechiporenko,2014-07-18 17:17:03+03:00,['7bdb1e42c8be2498cbeda87360bb73d9b5879e4b'],55,2910,2965,18250478,29,0.699255121,0.768156425,0.956238361,15087
366bcbb6998a87dbd59bd4defabff266079c9461,0,Oleg Nechiporenko,2014-07-18 17:21:11+03:00,"['5659f0a23b2cb8346d496246d0cce635aeefa87d', '39a92eb492833ace0b997b2cc4c9523c61832cc0']",36,1594,1630,18252108,35,,,,15087
5d3d25f2744485eda6207f7876c3e47cb6e0de04,1,Aleksandr Kovalenko,2014-07-18 17:51:47+03:00,['366bcbb6998a87dbd59bd4defabff266079c9461'],105,184,289,18252397,14,0,0,0,15087
2b6482db3c2e18e419df6ff67cbb4d753ace6707,1,atkach,2014-07-18 18:45:05+03:00,['5d3d25f2744485eda6207f7876c3e47cb6e0de04'],577,684,1261,18253658,16,0,0,0,15088
13464cad00f5686cd5e61bb88096029721ce11ed,1,aBabiichuk,2014-07-18 19:25:39+03:00,['2b6482db3c2e18e419df6ff67cbb4d753ace6707'],80,85,165,18253823,9,0,0,0,15088
a1e9fa9a2442f6d3ff89c831a7c1f5821bc4e673,1,Srimanth Gunturi,2014-07-18 09:48:39-07:00,['13464cad00f5686cd5e61bb88096029721ce11ed'],65,1433,1498,18255321,93,0.026584867,0.789366053,0.897750511,15088
8abd488f7d01e9d95a01bf611b854bd1988e78c1,1,Xi Wang,2014-07-18 16:13:28-07:00,['a1e9fa9a2442f6d3ff89c831a7c1f5821bc4e673'],15,37,52,18255373,4,1,1,1,15088
4db5aa98f4b8a1588ab00ae908237f35dd53c51f,1,Sumit Mohanty,2014-07-19 21:23:28-07:00,['8abd488f7d01e9d95a01bf611b854bd1988e78c1'],10,35,45,18255418,4,,,,15088
e19a719bd413ec937071ef610f52dae093175132,1,tbeerbower,2014-07-20 07:47:47-04:00,['4db5aa98f4b8a1588ab00ae908237f35dd53c51f'],136,4136,4272,18259690,62,0.494652406,0.868983957,0.928698752,15119
8afdb0b2361a29843827e3f522a14e735056e0ac,1,Alex Antonenko,2014-07-21 16:19:08+03:00,['e19a719bd413ec937071ef610f52dae093175132'],2,24,26,18259716,2,0,1,1,15119
26a07aacc6b44712c8dfd1b562cdb1a4b7b8df54,1,Nate Cole,2014-07-21 10:37:45-04:00,['8afdb0b2361a29843827e3f522a14e735056e0ac'],65,590,655,18260371,13,0.412280702,0.754385965,1,15121
88f5e9fa14bcb946e796fa6cc0136816519512c5,1,Andrew Onishuk,2014-07-21 17:46:39+03:00,['26a07aacc6b44712c8dfd1b562cdb1a4b7b8df54'],2,2,4,18260375,1,,,,15121
cb335d5d7d3dd4d421259364324ccabc8f3b4485,1,Oleg Nechiporenko,2014-07-21 18:46:45+03:00,['88f5e9fa14bcb946e796fa6cc0136816519512c5'],94,95,189,18260564,46,1,1,1,15121
566e754e550cca58c227d626f2ee41f0e65839a6,1,Oleg Nechiporenko,2014-07-21 18:59:03+03:00,['cb335d5d7d3dd4d421259364324ccabc8f3b4485'],5295,1075,6370,18266934,55,0.434005109,0,0.001986943,15121
e793b6c83812f3e1712437315e8790397c55311a,0,Vitaly Brodetskyi,2014-07-21 18:24:04+03:00,['566e754e550cca58c227d626f2ee41f0e65839a6'],2,72,74,18267008,4,0.826086957,1,1,15121
29475cb1e0037cc2fbd18904265a7e5db818acdd,1,Aleksandr Kovalenko,2014-07-21 20:05:29+03:00,['e793b6c83812f3e1712437315e8790397c55311a'],6,271,277,18267285,8,1,1,1,15122
afb7fea3bb6c9927141e34ccb8ccc75c0fb40dfd,0,Andrew Onishuk,2014-07-21 20:43:06+03:00,['29475cb1e0037cc2fbd18904265a7e5db818acdd'],1,1,2,18267287,1,,,,15122
e40b18a59598f0e76f3e9efa77cb89ef6c6c685d,1,Xi Wang,2014-07-21 11:51:58-07:00,['afb7fea3bb6c9927141e34ccb8ccc75c0fb40dfd'],97,247,344,18267631,5,0.736842105,0.757894737,1,15122
bb0116c3ce165a5a86cd287e058a2c8ebcb5908d,1,Jaimin Jetly,2014-07-21 13:48:38-07:00,['e40b18a59598f0e76f3e9efa77cb89ef6c6c685d'],0,5022,5022,18272653,74,0.877640845,0.967429577,0.906690141,15195
46fd6112c3254ee46edd0b9460b43dd04f4702c5,1,Xi Wang,2014-07-21 15:40:26-07:00,['bb0116c3ce165a5a86cd287e058a2c8ebcb5908d'],1,1,2,18272655,1,,,,15195
10c0362a6ea4f41da7323e356375ea14848a69d8,1,atkach,2014-07-22 14:25:30+03:00,['46fd6112c3254ee46edd0b9460b43dd04f4702c5'],173,772,945,18273600,20,0.974358974,0.974358974,1,15201
b844303663efdf0460141c5e790ad61fb45268dd,1,Lisnichenko Dmitro,2014-07-22 14:30:47+03:00,['10c0362a6ea4f41da7323e356375ea14848a69d8'],27,244,271,18273871,12,0.457142857,0.742857143,0.328571429,15201
f1a5d05318a2d9e08f0051a1adbc8bdbbf298996,1,Oleg Nechiporenko,2014-07-22 16:35:05+03:00,['46fd6112c3254ee46edd0b9460b43dd04f4702c5'],64,527,591,18274462,12,0.965116279,0.779069767,1,15208
fe7f25b54232e0f79d1f79ee2ea0588049d54ffc,0,Oleg Nechiporenko,2014-07-22 16:37:36+03:00,"['f1a5d05318a2d9e08f0051a1adbc8bdbbf298996', 'b844303663efdf0460141c5e790ad61fb45268dd']",200,1016,1216,18275678,32,,,,15208
b90771744a5c2ba0b2aa47ca0e3edab59b174820,1,Nate Cole,2014-07-22 10:52:56-04:00,['fe7f25b54232e0f79d1f79ee2ea0588049d54ffc'],31,279,310,18275988,11,0.088495575,0.646017699,0.716814159,15208
eb2eb91d7583c35c9620f8b37a379f71659c2902,0,Oleg Nechiporenko,2014-07-22 19:00:09+03:00,['fe7f25b54232e0f79d1f79ee2ea0588049d54ffc'],1,0,1,18275989,1,1,1,0,15208
1845940c44be4497f8f313389aeee0585381a585,0,Oleg Nechiporenko,2014-07-22 19:03:22+03:00,"['eb2eb91d7583c35c9620f8b37a379f71659c2902', 'b90771744a5c2ba0b2aa47ca0e3edab59b174820']",31,279,310,18276299,11,,,,15208
340afc1be06ea49769fe5ac121e32da748d89abb,0,Andrew Onishuk,2014-07-22 19:43:29+03:00,['1845940c44be4497f8f313389aeee0585381a585'],1,1,2,18276301,1,,,,15208
e3a93a1db0e1ef411652b4d0727b895aad407ed8,1,Andrew Onishuk,2014-07-22 19:49:39+03:00,['340afc1be06ea49769fe5ac121e32da748d89abb'],75,120,195,18276496,47,0.75,0.875,0.875,15208
bb79b152fccf3b26cd8a2e001180036886a93325,1,Srimanth Gunturi,2014-07-22 10:32:42-07:00,['e3a93a1db0e1ef411652b4d0727b895aad407ed8'],6,70,76,18276572,2,0,0.807017544,1,15208
e784e26310c7d8664b2a40c189dab5e265fe0ccc,1,Alex Antonenko,2014-07-22 22:41:29+03:00,['bb79b152fccf3b26cd8a2e001180036886a93325'],19,31,50,18276622,5,0,0,0,15209
69f2bcf99f161f2a80919410274424f1fc8bcf0e,1,Jaimin Jetly,2014-07-22 17:48:19-07:00,['e784e26310c7d8664b2a40c189dab5e265fe0ccc'],27,2,29,18276651,3,0,0,0,15209
256121dfe75c9439b557e10b52ba17507d191b6d,0,Alex Antonenko,2014-07-23 09:59:44+03:00,['69f2bcf99f161f2a80919410274424f1fc8bcf0e'],0,0,0,18276651,1,,,,15209
415fac0de7251b36b52e30a74c2a2160c4ff5bc9,0,Oleg Nechiporenko,2014-07-23 12:33:51+03:00,['256121dfe75c9439b557e10b52ba17507d191b6d'],1,2,3,18276654,1,1,1,1,15209
3df148d059ccad5640865b56b4bafbf3d2686c2e,1,Oleg Nechiporenko,2014-07-23 14:18:24+03:00,['415fac0de7251b36b52e30a74c2a2160c4ff5bc9'],4,8,12,18276666,1,1,1,1,15209
784cec378c97eb018e12795c5e646585e18cca80,1,Andrew Onishuk,2014-07-23 15:03:14+03:00,['3df148d059ccad5640865b56b4bafbf3d2686c2e'],0,18,18,18276684,2,,,,15209
86f65d6cedc268585c851a0cad4d499765698d5b,1,Andrew Onishuk,2014-07-23 15:04:45+03:00,['784cec378c97eb018e12795c5e646585e18cca80'],0,18,18,18276702,2,,,,15209
d8056bda292a58c3155e44b920059b98848230d1,1,Andrew Onishuk,2014-07-23 15:51:40+03:00,['86f65d6cedc268585c851a0cad4d499765698d5b'],21,31,52,18276754,4,0,0,1,15209
b459ea8653319cd3e4180e1254810e0e8638c9b9,1,Alex Antonenko,2014-07-23 15:52:25+03:00,['d8056bda292a58c3155e44b920059b98848230d1'],2,2,4,18276758,2,,,,15209
6a1814f7cc3d50a3725e2c1fd4c80a571fb49c27,1,Andrew Onishuk,2014-07-23 15:53:24+03:00,['b459ea8653319cd3e4180e1254810e0e8638c9b9'],2,2,4,18276762,2,,,,15209
5a4eab28f0a68471573a6b1cba7e93784d61d431,1,Dmytro Sen,2014-07-23 16:00:10+03:00,['6a1814f7cc3d50a3725e2c1fd4c80a571fb49c27'],210,69,279,18277041,5,,,,15209
2c53202d2468804d441e2b483ba5b34c6d2edf32,0,Aleksandr Kovalenko,2014-07-23 16:02:02+03:00,['5a4eab28f0a68471573a6b1cba7e93784d61d431'],9,13,22,18277063,2,0.25,0.25,1,15209
e7768141150396f95c74d38068355c07bbca564d,1,Oleg Nechiporenko,2014-07-23 16:07:17+03:00,['2c53202d2468804d441e2b483ba5b34c6d2edf32'],694,84,778,18277841,8,0.077844311,0,0,15209
4986296a377f1f17795d9a6f26b6a56d342b388d,1,Oleg Nechiporenko,2014-07-23 19:40:21+03:00,['e7768141150396f95c74d38068355c07bbca564d'],1080,107,1187,18279028,4,0.415876777,0,0,15209
e72900f57814b16ae540777de63d8455688b1e9d,1,Aleksandr Kovalenko,2014-07-23 19:58:15+03:00,['4986296a377f1f17795d9a6f26b6a56d342b388d'],20,220,240,18279268,9,0.880794702,1,0.953642384,15209
98f531d3980cba8a22ef1ab953f32b8b8195a4df,1,atkach,2014-07-23 20:37:46+03:00,['e72900f57814b16ae540777de63d8455688b1e9d'],5,357,362,18279630,11,1,1,1,15211
49d7a3da8db3aae5c4f0f94def37bb5a3f40989a,1,Nate Cole,2014-07-23 16:22:21-04:00,['98f531d3980cba8a22ef1ab953f32b8b8195a4df'],93,527,620,18280250,10,0.08365019,0.615969582,0.866920152,15212
67a106c9496180e17f5068dd02e30520f7469bbf,1,Siddharth Wagle,2014-07-23 14:52:47-07:00,['49d7a3da8db3aae5c4f0f94def37bb5a3f40989a'],11,297,308,18280558,5,0.198019802,0.722772277,0.722772277,15216
86878cdac936aed6dbe9835d6b7595442ff97372,1,Lisnichenko Dmitro,2014-07-24 12:40:53+03:00,['67a106c9496180e17f5068dd02e30520f7469bbf'],1,1,2,18280560,1,,,,15216
c8ba4f3e566558a58358998bba5f1c437b5513db,1,Vitaly Brodetskyi,2014-07-24 12:04:24+03:00,['86878cdac936aed6dbe9835d6b7595442ff97372'],41,168,209,18280769,6,0,0.712643678,0.75862069,15216
367c61c41fa1ab3d89d00ab985df5c288a737b4c,1,Andrew Onishuk,2014-07-24 13:21:53+03:00,['c8ba4f3e566558a58358998bba5f1c437b5513db'],25,25,50,18280819,18,,,,15216
32d0c90b31c9c4de1076cc2817640f1b094ccdb8,1,Dmytro Sen,2014-07-24 14:59:18+03:00,['367c61c41fa1ab3d89d00ab985df5c288a737b4c'],163,343,506,18281325,8,0,0.185483871,0.677419355,15216
7cc52b84da946b6bb7577d6d13399db909dfa99f,0,Andrew Onishuk,2014-07-24 15:02:42+03:00,['32d0c90b31c9c4de1076cc2817640f1b094ccdb8'],0,1,1,18281326,1,,,,15216
bb9de63c78c2868a2d835b8be1d203d4d81cd4a6,1,Oleg Nechiporenko,2014-07-24 15:18:01+03:00,['7cc52b84da946b6bb7577d6d13399db909dfa99f'],185,299,484,18281810,11,0.782608696,1,1,15218
8ec953d69009272fe83d0d775dd43ddb9d9ac70b,1,Aleksandr Kovalenko,2014-07-24 15:29:07+03:00,['bb9de63c78c2868a2d835b8be1d203d4d81cd4a6'],8,26,34,18281844,4,1,1,1,15218
3367667cd12c813546df8010b743a13f4ec19a1e,1,Oleg Nechiporenko,2014-07-24 16:32:33+03:00,['8ec953d69009272fe83d0d775dd43ddb9d9ac70b'],13,134,147,18281991,6,1,1,1,15220
4360fc62ec1351d1b1c833dfa9191b5140f0a1d6,1,atkach,2014-07-24 16:42:52+03:00,['3367667cd12c813546df8010b743a13f4ec19a1e'],30,214,244,18282235,9,1,1,1,15221
5035c7c19b53ae37170c81a8934ddde78da5b77c,1,Alex Antonenko,2014-07-24 17:51:48+03:00,['4360fc62ec1351d1b1c833dfa9191b5140f0a1d6'],3,3,6,18282241,1,,,,15221
3f767220fbec85471851ff4c1183b894a633e902,1,Aleksandr Kovalenko,2014-07-24 18:38:50+03:00,['5035c7c19b53ae37170c81a8934ddde78da5b77c'],0,14,14,18282255,3,0.090909091,0.090909091,1,15221
4bd3471d654c8792fe95bd7cf276dc0961887a4d,1,Dmytro Sen,2014-07-24 19:30:51+03:00,['3f767220fbec85471851ff4c1183b894a633e902'],16,199,215,18282470,8,1,1,0,15221
0246ad310d0a06ef3a9e38815ef897adcf10c61b,1,Lisnichenko Dmitro,2014-07-24 19:31:42+03:00,['4bd3471d654c8792fe95bd7cf276dc0961887a4d'],11,62,73,18282543,2,0,1,1,15221
f5c3c22bd03042d2579b71e4930d5a45760a97af,0,Lisnichenko Dmitro,2014-07-24 19:31:43+03:00,['0246ad310d0a06ef3a9e38815ef897adcf10c61b'],3,10,13,18282556,2,0,1,0.5,15221
2313d20063829cc452b8df589737290fda7b48ce,1,Srimanth Gunturi,2014-07-24 09:37:44-07:00,['f5c3c22bd03042d2579b71e4930d5a45760a97af'],63,448,511,18283067,9,0.36440678,0.843220339,0.966101695,15221
ec858410ef9dcf038b1293281b6a866d9ff9792b,1,Vitaly Brodetskyi,2014-07-24 18:59:59+03:00,['2313d20063829cc452b8df589737290fda7b48ce'],1,1,2,18283069,1,,,,15221
31242e8f7db2ddf4c116213fbca3cc19acbbe389,1,Jaimin Jetly,2014-07-24 11:05:05-07:00,['ec858410ef9dcf038b1293281b6a866d9ff9792b'],15,2049,2064,18285133,41,0.908878505,0.918224299,0.901869159,15259
be9e0b8cbe39a85ab0a03d03e83c86914638c451,1,Srimanth Gunturi,2014-07-24 15:05:11-07:00,['31242e8f7db2ddf4c116213fbca3cc19acbbe389'],40,97,137,18285270,6,0.195121951,0.414634146,0.951219512,15259
0fc60a40b4d34d4facc0d3888423ce1bd7ecdf10,1,Nate Cole,2014-07-24 19:54:30-04:00,['be9e0b8cbe39a85ab0a03d03e83c86914638c451'],23,27,50,18285320,4,1,1,0,15259
f2eae89604228bafb4a8a5d81081a517aa199982,1,Srimanth Gunturi,2014-07-24 16:56:49-07:00,['0fc60a40b4d34d4facc0d3888423ce1bd7ecdf10'],4,16,20,18285340,3,1,1,1,15259
d5bd15bdc60675974fc358f10fbecf2082a722cf,1,Srimanth Gunturi,2014-07-24 17:22:09-07:00,['f2eae89604228bafb4a8a5d81081a517aa199982'],29,52,81,18285421,4,0,1,1,15259
f3aab68ec417d8e2c39c216962e1e1d47d56d401,1,Siddharth Wagle,2014-07-24 23:40:43-07:00,['d5bd15bdc60675974fc358f10fbecf2082a722cf'],75,227,302,18285723,30,0.271186441,0.830508475,0.957627119,15259
fb16c640cf84ea62fc84a60a83e4791b1cefcebe,1,Siddharth Wagle,2014-07-24 23:47:26-07:00,['f3aab68ec417d8e2c39c216962e1e1d47d56d401'],44,14,58,18285781,3,0.518518519,1,0,15259
55f928c9db5a4b45d7e9d80f97a9603d928a2909,0,Andrew Onishuk,2014-07-25 12:17:33+03:00,['fb16c640cf84ea62fc84a60a83e4791b1cefcebe'],0,8,8,18285789,1,,,,15259
54243b8a74c680baa23336e5567525a1a840e8ec,0,Dmytro Sen,2014-07-25 13:24:33+03:00,['55f928c9db5a4b45d7e9d80f97a9603d928a2909'],1,1,2,18285791,1,,,,15259
5399843e4cbb9f394560028b7de92f710ca0aad0,0,Andrew Onishuk,2014-07-25 14:03:33+03:00,['54243b8a74c680baa23336e5567525a1a840e8ec'],0,16,16,18285807,2,,,,15259
ebfd77fd50b3bf40471c6f298420fe9e5eb2fa76,1,Lisnichenko Dmitro,2014-07-25 17:26:50+03:00,['5399843e4cbb9f394560028b7de92f710ca0aad0'],2,6,8,18285815,2,,,,15259
d6949dc3784961da1f70dfa2435d6770df52d173,1,Aleksandr Kovalenko,2014-07-25 19:51:09+03:00,['ebfd77fd50b3bf40471c6f298420fe9e5eb2fa76'],13,27,40,18285855,2,0.846153846,1,1,15259
05549b27347b96d63f8d104b27ed36401daf8c74,0,Srimanth Gunturi,2014-07-25 09:54:03-07:00,['d6949dc3784961da1f70dfa2435d6770df52d173'],2,4,6,18285861,2,,,,15259
d4b0b2f6f4e3119abcae40207ad5991f1e7c9fc0,0,Sumit Mohanty,2014-07-25 11:19:57-07:00,['05549b27347b96d63f8d104b27ed36401daf8c74'],2,2,4,18285865,1,,,,15259
7602acae48d1c6b6369574f53bef552258b5ef21,1,Nate Cole,2014-07-25 16:24:30-04:00,['d4b0b2f6f4e3119abcae40207ad5991f1e7c9fc0'],170,788,958,18286823,17,0.407051282,0.971153846,1,15259
0ae8350bc62ef827c6de471514e2131385201c8c,1,Siddharth Wagle,2014-07-25 14:32:20-07:00,['7602acae48d1c6b6369574f53bef552258b5ef21'],4,118,122,18286945,7,0.2,0.646153846,0.953846154,15259
9100e08a7b7a8c0f050ef6f22843f9f7eaf8cc29,1,Xi Wang,2014-07-25 14:38:39-07:00,['0ae8350bc62ef827c6de471514e2131385201c8c'],4,8,12,18286957,4,0,0,0.5,15259
d7c0d8ae60c595891e038e3aa2ec77b6d1f50ffa,1,Mahadev Konar,2014-07-25 16:47:21-07:00,['9100e08a7b7a8c0f050ef6f22843f9f7eaf8cc29'],31,710,741,18287698,24,0.774456522,0.921195652,0.671195652,15261
cb2bb4dbcf132166aff05cb36d48278f9cb851ea,1,Jaimin Jetly,2014-07-25 17:06:09-07:00,['d7c0d8ae60c595891e038e3aa2ec77b6d1f50ffa'],14,52,66,18287764,4,0.375,1,1,15261
5dd5f657d162a8fd2bb840c75131e2a0e4205470,0,Jaimin Jetly,2014-07-27 10:43:07-07:00,['cb2bb4dbcf132166aff05cb36d48278f9cb851ea'],412,0,412,18288176,4,,,,15261
b12ab2564273ddbd8fe1824dd7c9df1edcc44cb5,1,Srimanth Gunturi,2014-07-27 10:59:56-07:00,['5dd5f657d162a8fd2bb840c75131e2a0e4205470'],2,2,4,18288180,2,,,,15261
46fb9d7eb19e1eafd6ac19da10b19098075efa8d,1,aBabiichuk,2014-07-28 14:33:39+03:00,['b12ab2564273ddbd8fe1824dd7c9df1edcc44cb5'],8,35,43,18288223,3,0.214285714,1,1,15261
0ab80fdeb4a9d2b193f2babb8e2c43e4a6ad0252,1,atkach,2014-07-28 14:56:58+03:00,['46fb9d7eb19e1eafd6ac19da10b19098075efa8d'],61,285,346,18288569,13,0.967741935,1,1,15264
4099da326434de259d3bdb0475eae83c4076beee,1,Andrew Onishuk,2014-07-28 15:11:18+03:00,['0ab80fdeb4a9d2b193f2babb8e2c43e4a6ad0252'],30,321,351,18288920,37,0,0,1,15264
883d7b3a1ea04f2b041e20309ca9bd007bca5b62,1,atkach,2014-07-28 15:17:30+03:00,['4099da326434de259d3bdb0475eae83c4076beee'],2,2,4,18288924,1,,,,15264
a6873d64cf849184974b282ee1fa88a4e4390d66,1,Alex Antonenko,2014-07-28 15:25:07+03:00,['883d7b3a1ea04f2b041e20309ca9bd007bca5b62'],465,900,1365,18290289,8,0,0,0,15264
2f2eeeb3622479551617e557b87f060280b25265,0,Mahadev Konar,2014-07-28 08:28:07-07:00,['a6873d64cf849184974b282ee1fa88a4e4390d66'],0,27,27,18290316,1,,,,15264
79ff7cbdbfd0f3fcf95aeb808f5a873c593063be,0,Mahadev Konar,2014-07-28 08:28:59-07:00,['2f2eeeb3622479551617e557b87f060280b25265'],2,0,2,18290318,1,,,,15264
e4f80ad8b5bbaed8b99bad0631db8ea8d0580d85,1,atkach,2014-07-28 19:44:01+03:00,['79ff7cbdbfd0f3fcf95aeb808f5a873c593063be'],7,5,12,18290330,2,1,1,0,15264
73be90ac0a2a6604768ce43a509994533f6fe0ba,1,Vitaly Brodetskyi,2014-07-28 18:22:24+03:00,['e4f80ad8b5bbaed8b99bad0631db8ea8d0580d85'],62,86,148,18290478,4,1,1,0,15264
41bcd351ed83766f4b404a10bc8d6bb985d18b8b,1,aBabiichuk,2014-07-28 20:16:44+03:00,['73be90ac0a2a6604768ce43a509994533f6fe0ba'],10,76,86,18290564,4,1,1,0.75,15264
f3fa480cc11e87105c5a8fff4e3b98f655c7c0b2,1,aBabiichuk,2014-07-28 20:44:51+03:00,['41bcd351ed83766f4b404a10bc8d6bb985d18b8b'],91,278,369,18290933,6,1,1,1,15266
bf41b50a97638733005011bb21aa78cacdf1afa5,0,Lisnichenko Dmitro,2014-07-28 21:19:59+03:00,['f3fa480cc11e87105c5a8fff4e3b98f655c7c0b2'],1,1,2,18290935,1,,,,15266
bf5c5bdfc22161cc6669a24be50abca542e67a20,1,Alex Antonenko,2014-07-28 22:14:06+03:00,['bf41b50a97638733005011bb21aa78cacdf1afa5'],3,9,12,18290947,1,0,0,1,15266
ee94c2f5b6afadc0b73a3cd2ef11f2286b36cb84,1,Jaimin Jetly,2014-07-28 12:54:43-07:00,['bf5c5bdfc22161cc6669a24be50abca542e67a20'],92,38,130,18291077,2,0,0,0.083333333,15266
b0b58189cc8713642102eadb46e4bfabfaf84c21,1,Srimanth Gunturi,2014-07-28 13:19:40-07:00,['ee94c2f5b6afadc0b73a3cd2ef11f2286b36cb84'],9,1699,1708,18292785,27,0.527590848,0.829071332,0.764468371,15279
3b9e4d1d1f2f039899e01f04569958277bbb1109,1,Jaimin Jetly,2014-07-28 13:21:29-07:00,['b0b58189cc8713642102eadb46e4bfabfaf84c21'],61,6,67,18292852,3,0.890909091,1,0,15279
a69261890b2460e0ed9bdf80bafcf177477fe618,1,Jaimin Jetly,2014-07-28 13:53:41-07:00,['3b9e4d1d1f2f039899e01f04569958277bbb1109'],130,35,165,18293017,1,1,1,0,15279
9986f6c158d1caddd8cb0d0a8d7fc06634a7bcbc,1,Srimanth Gunturi,2014-07-28 14:50:44-07:00,['a69261890b2460e0ed9bdf80bafcf177477fe618'],192,337,529,18293546,8,1,1,0,15280
7d2c4f00f0c2652f6429473f44efb4c72b86710f,0,Vitaly Brodetskyi,2014-07-29 10:40:56+03:00,['9986f6c158d1caddd8cb0d0a8d7fc06634a7bcbc'],2,2,4,18293550,1,,,,15280
05e5476c72582c6722fdcbaf7bf7917293c9ffc0,0,atkach,2014-07-29 12:29:15+03:00,['7d2c4f00f0c2652f6429473f44efb4c72b86710f'],3,11,14,18293564,3,1,1,1,15280
569acf80142937e6da57eb8b75a848bf41fbc9fa,0,atkach,2014-07-29 12:44:46+03:00,['05e5476c72582c6722fdcbaf7bf7917293c9ffc0'],0,2,2,18293566,2,0,1,1,15280
85362043f7365fe59c2900284ef12057f00cf0b1,1,Oleg Nechiporenko,2014-07-29 14:58:06+03:00,['569acf80142937e6da57eb8b75a848bf41fbc9fa'],137,2537,2674,18296240,25,0.435660219,0.663582843,0.846089151,15287
11336361fa4b0e180961f29b95802bb51090c196,1,tbeerbower,2014-07-29 08:01:54-04:00,['85362043f7365fe59c2900284ef12057f00cf0b1'],99,1638,1737,18297977,37,0.700617284,0.75308642,0.728395062,15300
5214ea465eec7836ff92bb0af6cca3573bdd16d5,1,Vitaly Brodetskyi,2014-07-29 13:52:24+03:00,['11336361fa4b0e180961f29b95802bb51090c196'],8,8,16,18297993,2,,,,15300
7f759df5002b3dc5e37f6ae5420e0eeb31d4edc3,1,atkach,2014-07-29 16:51:58+03:00,['5214ea465eec7836ff92bb0af6cca3573bdd16d5'],6,10,16,18298009,1,,,,15300
bdc6a78980d275c7d2437e13448e58e72b7fb3f6,1,Andrew Onishuk,2014-07-29 18:56:11+03:00,['7f759df5002b3dc5e37f6ae5420e0eeb31d4edc3'],29,288,317,18298326,10,0.184971098,0.514450867,0.757225434,15300
968ac4cdfef345a9c9d89264dfa73c7d71a310aa,1,Oleg Nechiporenko,2014-07-29 19:19:07+03:00,['bdc6a78980d275c7d2437e13448e58e72b7fb3f6'],54,38,92,18298418,3,1,1,0,15300
a1e8f545ce8cfd3770077d148d3ff7d71563be61,1,Oleg Nechiporenko,2014-07-29 20:05:06+03:00,['968ac4cdfef345a9c9d89264dfa73c7d71a310aa'],40,19,59,18298477,2,,,,15300
488e4d3cc755df0f8f6c0c716f082431139aba7e,0,Mahadev Konar,2014-07-29 11:56:59-07:00,['a1e8f545ce8cfd3770077d148d3ff7d71563be61'],4,4,8,18298485,1,,,,15300
0f79b23bc64e5020f4c71c4fa6f6cdf8091e5831,1,Mahadev Konar,2014-07-29 12:45:10-07:00,['488e4d3cc755df0f8f6c0c716f082431139aba7e'],2,39,41,18298526,2,0,1,0,15300
77d613663fc85e017ea380c7f7c1f2681df5a62a,1,Andrew Onishuk,2014-07-29 23:25:01+03:00,['0f79b23bc64e5020f4c71c4fa6f6cdf8091e5831'],2,2,4,18298530,2,,,,15300
58347de3d90bfe2d26bb71553d7931bd4f7d37d0,1,Nate Cole,2014-07-29 17:40:01-04:00,['77d613663fc85e017ea380c7f7c1f2681df5a62a'],68,291,359,18298889,8,0.5625,0,0.03125,15300
c84c7a14e1d4df417524574cbe23b8cb95824290,1,Andrew Onishuk,2014-07-30 01:10:04+03:00,['58347de3d90bfe2d26bb71553d7931bd4f7d37d0'],7,36,43,18298932,2,1,1,0.25,15300
01c7d97ef4de9c7151e54c009ffb1c6b83842a90,0,Andrew Onishuk,2014-07-30 13:04:41+03:00,['c84c7a14e1d4df417524574cbe23b8cb95824290'],1,1,2,18298934,1,,,,15300
a5576c90ea1933c5e82c8abb66706140f35cdabf,1,Andrew Onishuk,2014-07-30 13:14:08+03:00,['01c7d97ef4de9c7151e54c009ffb1c6b83842a90'],13,86,99,18299033,3,0.092307692,0.507692308,1,15300
474dec77e323127b584f05cb1cfdbdd9557195b3,1,Andrew Onishuk,2014-07-30 13:15:42+03:00,['a5576c90ea1933c5e82c8abb66706140f35cdabf'],14,56,70,18299103,4,,,,15301
e46a904050d7199c2931b71d16ffc870e1e1e280,0,Andrew Onishuk,2014-07-30 14:06:20+03:00,['474dec77e323127b584f05cb1cfdbdd9557195b3'],0,5,5,18299108,1,0,0,1,15301
8f3c9984bf70e15b7ab06ee8614fe7f68d5fc8df,1,Vitaly Brodetskyi,2014-07-30 12:44:03+03:00,['e46a904050d7199c2931b71d16ffc870e1e1e280'],6,17,23,18299131,3,0,0.222222222,1,15301
abca346b95e4ffa9b792c582d951976ff597e600,1,Vitaly Brodetskyi,2014-07-30 13:53:55+03:00,['8f3c9984bf70e15b7ab06ee8614fe7f68d5fc8df'],1,1,2,18299133,1,,,,15301
6579115538861f8985f6cf702e48d33b15e06942,1,Nate Cole,2014-07-30 09:55:03-04:00,['abca346b95e4ffa9b792c582d951976ff597e600'],234,156,390,18299523,6,0.688888889,0.022222222,0,15301
dfea4b512660758271d80541f98e23a5af3a7eb6,1,Alex Antonenko,2014-07-30 18:36:39+03:00,['6579115538861f8985f6cf702e48d33b15e06942'],4,12,16,18299539,2,1,1,1,15301
7830b3fe2c11eec27b72efa8ef8cddedee2ac951,1,aBabiichuk,2014-07-30 19:17:05+03:00,['dfea4b512660758271d80541f98e23a5af3a7eb6'],2,3,5,18299544,1,1,1,1,15301
88156a3861778ac0813f1adabc121ca550bf9da0,1,Vitaly Brodetskyi,2014-07-30 18:09:15+03:00,['7830b3fe2c11eec27b72efa8ef8cddedee2ac951'],3,3,6,18299550,1,,,,15301
6ece2d24b07f1759c1372e705eb957be4c46d519,0,Oleg Nechiporenko,2014-07-30 19:51:19+03:00,['88156a3861778ac0813f1adabc121ca550bf9da0'],1,1,2,18299552,1,,,,15301
ce77ec515e80f9413e0939ea1134ddd17f2a1a7e,1,Dmytro Sen,2014-07-30 20:19:32+03:00,['6ece2d24b07f1759c1372e705eb957be4c46d519'],71,312,383,18299935,7,0.398550725,0.68115942,0.97826087,15302
ac9ea7bf866b5fbab6992510c425b18aaa1bfd19,1,aBabiichuk,2014-07-30 20:41:17+03:00,['ce77ec515e80f9413e0939ea1134ddd17f2a1a7e'],44,115,159,18300094,7,0,0,1,15302
577da0a949efc96570ea800c9e5679ec0b4dc20e,1,Jaimin Jetly,2014-07-30 11:29:52-07:00,['ac9ea7bf866b5fbab6992510c425b18aaa1bfd19'],24,378,402,18300496,13,1,1,0.892018779,15307
cc51c2a60d5075e7c0da4c742c18006bad04176c,0,Nate Cole,2014-07-30 14:55:45-04:00,['577da0a949efc96570ea800c9e5679ec0b4dc20e'],25,46,71,18300567,1,0,1,0,15307
2885f1912559a2cab1dd0e69495844411425cbdd,1,Srimanth Gunturi,2014-07-30 12:45:26-07:00,['cc51c2a60d5075e7c0da4c742c18006bad04176c'],44,886,930,18301497,10,0.028333333,0.226666667,0.951666667,15309
5d264f886b385a3b9eda4fc8c7ee382d8e2abf8f,1,Mahadev Konar,2014-07-30 13:19:52-07:00,['2885f1912559a2cab1dd0e69495844411425cbdd'],10,10,20,18301517,1,,,,15309
a84a6532006b085a22c555136ab1e63786237b16,1,Srimanth Gunturi,2014-07-30 13:23:07-07:00,['5d264f886b385a3b9eda4fc8c7ee382d8e2abf8f'],35,41,76,18301593,7,1,0,1,15309
ce4020028973fadaa79f1bacea649de0b61dbe0c,1,Myroslav Papirkovskyy,2014-07-31 00:14:52+03:00,['a84a6532006b085a22c555136ab1e63786237b16'],389,1942,2331,18303924,66,0.536684783,0.873641304,0.827445652,15318
15b54439af4b95386fe678b97a1d88a062dc9309,0,Siddharth Wagle,2014-07-30 16:40:48-07:00,['ce4020028973fadaa79f1bacea649de0b61dbe0c'],90,1143,1233,18305157,21,0.353783231,0.642126789,0.969325153,15324
a742693978b49188cf12129356c88ba754e2fe95,1,Srimanth Gunturi,2014-07-30 18:13:59-07:00,['15b54439af4b95386fe678b97a1d88a062dc9309'],286,1275,1561,18306718,22,0.62006079,0.747720365,0.835866261,15334
68b97f03550fd08e9bc330df92e68c63df506c44,0,Andrew Onishuk,2014-07-31 13:15:48+03:00,['a742693978b49188cf12129356c88ba754e2fe95'],4,4,8,18306726,3,,,,15334
0f4f7d7c1def97acd24aedef781fb9a2a0a99a8b,1,atkach,2014-07-31 13:49:33+03:00,['68b97f03550fd08e9bc330df92e68c63df506c44'],272,1303,1575,18308301,8,0.730994152,0.975438596,0.977777778,15336
c635f886bd4766d1601cf832c3aa0f737765a1ed,1,aBabiichuk,2014-07-31 14:59:55+03:00,['0f4f7d7c1def97acd24aedef781fb9a2a0a99a8b'],17,24,41,18308342,1,1,1,1,15336
34c3355de97f332323ec36d184dea42151618ce3,1,Oleg Nechiporenko,2014-07-31 15:10:26+03:00,['0f4f7d7c1def97acd24aedef781fb9a2a0a99a8b'],135,381,516,18308858,13,0,0,0.888888889,15336
bf10914afe888277d16e4a43ea97d98d74c2b256,0,Oleg Nechiporenko,2014-07-31 15:12:58+03:00,"['34c3355de97f332323ec36d184dea42151618ce3', 'c635f886bd4766d1601cf832c3aa0f737765a1ed']",17,24,41,18308899,1,,,,15336
b453fa46a822f9eb61ee1498feae34bd2ffd51bd,1,Andrew Onishuk,2014-07-31 15:19:26+03:00,['bf10914afe888277d16e4a43ea97d98d74c2b256'],4,4,8,18308907,3,,,,15336
48f97d39975b005aaf3b3a262c7a1cdc2c8f86f1,1,tbeerbower,2014-07-31 09:36:03-04:00,['b453fa46a822f9eb61ee1498feae34bd2ffd51bd'],42,673,715,18309622,36,0.235772358,0.841463415,0.910569106,15340
9f1318585eb003581139b33d6e0f20fb152da621,1,Alex Antonenko,2014-07-31 17:42:15+03:00,['48f97d39975b005aaf3b3a262c7a1cdc2c8f86f1'],1,4,5,18309627,1,1,1,1,15340
09ffe3195afe35bc432a938d559f9033fd9d687a,1,Vitaly Brodetskyi,2014-07-31 17:22:06+03:00,['9f1318585eb003581139b33d6e0f20fb152da621'],21,226,247,18309874,13,0.2,1,1,15342
2a268dac5fdfc4dd0da695d434ac622a8d5fbf87,0,Andrew Onishuk,2014-07-31 19:03:25+03:00,['09ffe3195afe35bc432a938d559f9033fd9d687a'],1,11,12,18309886,3,0,1,1,15342
a4d5324a7b45f26b2770804f80b6246560390653,0,aBabiichuk,2014-07-31 19:14:33+03:00,['2a268dac5fdfc4dd0da695d434ac622a8d5fbf87'],1,1,2,18309888,1,,,,15342
fce87bed80e23e4d65373df92f923effa3ce1a9f,1,Dmytro Sen,2014-07-31 19:24:31+03:00,['a4d5324a7b45f26b2770804f80b6246560390653'],0,607,607,18310495,3,0.737179487,0.91025641,0.724358974,15344
322552cdf863925690b80e9702e9e89dc3ef06b6,0,Nate Cole,2014-07-31 13:17:45-04:00,['fce87bed80e23e4d65373df92f923effa3ce1a9f'],0,0,0,18310495,1,,,,15344
167618c15dc3e33e1cd5a7ef46f0e198136411b6,1,Nate Cole,2014-07-31 13:32:38-04:00,['322552cdf863925690b80e9702e9e89dc3ef06b6'],25,125,150,18310645,5,0,1,0.977777778,15344
b1771e2cadc3e3363a20645da616e7fd11a20265,0,Siddharth Wagle,2014-07-31 13:32:52-07:00,['167618c15dc3e33e1cd5a7ef46f0e198136411b6'],1143,90,1233,18311878,21,0.646216769,0.357873211,0.030674847,15344
18340ef32ddde82829e77405ecd5118c7e0b27b6,1,Siddharth Wagle,2014-07-31 13:51:21-07:00,['b1771e2cadc3e3363a20645da616e7fd11a20265'],2,90,92,18311970,2,,,,15344
3667b2b1b10e2ab7db6026db699176facc60d0ff,1,Siddharth Wagle,2014-07-31 13:55:43-07:00,['18340ef32ddde82829e77405ecd5118c7e0b27b6'],68,182,250,18312220,10,0.151162791,0,0.337209302,15344
6705a0f6157e8b2aef821cd599d4f59ed0ded901,1,Nate Cole,2014-07-31 17:04:32-04:00,['3667b2b1b10e2ab7db6026db699176facc60d0ff'],306,461,767,18312987,9,0,0.74025974,1,15344
fc724cb01a4a8ae8cdf2b13950f38ff044830574,0,Srimanth Gunturi,2014-07-31 15:33:08-07:00,['6705a0f6157e8b2aef821cd599d4f59ed0ded901'],2,2,4,18312991,1,,,,15344
896367f381909c42656ce1851f461d64faa8fe6a,1,Andrew Onishuk,2014-08-01 02:13:41+03:00,['fc724cb01a4a8ae8cdf2b13950f38ff044830574'],69,348,417,18313408,7,0.080188679,0.283018868,0.919811321,15344
34263b1c8bf581f41a6dbd99da8ebbbc63c1f4ed,1,Srimanth Gunturi,2014-07-31 16:25:22-07:00,['896367f381909c42656ce1851f461d64faa8fe6a'],24,86,110,18313518,5,1,1,1,15344
27304ee03a2202e199357c7ff7044cf05393236c,1,Andrew Onishuk,2014-08-01 14:11:50+03:00,['34263b1c8bf581f41a6dbd99da8ebbbc63c1f4ed'],8,103,111,18313629,4,0.03125,1,1,15344
dd888838daff5498ebb41d1f1d585fd0e759ee14,1,Oleg Nechiporenko,2014-08-01 16:01:11+03:00,['27304ee03a2202e199357c7ff7044cf05393236c'],49,242,291,18313920,8,0.888888889,1,1,15344
55bbcae4634496cb52041770489963cece38594a,1,Andrew Onishuk,2014-08-01 16:21:55+03:00,['dd888838daff5498ebb41d1f1d585fd0e759ee14'],18,157,175,18314095,62,0,1,1,15345
d728f13bb004e48f9b9d965c595a31220f35f110,1,Andrew Onishuk,2014-08-01 16:55:15+03:00,['55bbcae4634496cb52041770489963cece38594a'],2,2,4,18314099,2,,,,15345
99e42776ebd7bdb5ab97e450b7683626e5a22028,1,Andrew Onishuk,2014-08-01 17:01:41+03:00,['d728f13bb004e48f9b9d965c595a31220f35f110'],4,65,69,18314168,8,0,0.951219512,0.073170732,15345
26d2c9f6e0bb0fdbb1138a3cf3bcdc73b27f1ef8,0,Dmytro Sen,2014-08-01 17:11:11+03:00,['99e42776ebd7bdb5ab97e450b7683626e5a22028'],6,25,31,18314199,3,0.666666667,0.833333333,0,15345
45ded7210aa4b065f9aa3baa06a5b324c2a53660,0,Andrew Onishuk,2014-08-01 17:29:42+03:00,['26d2c9f6e0bb0fdbb1138a3cf3bcdc73b27f1ef8'],5,13,18,18314217,1,1,1,0,15345
7a3585fb4222fbffc8186e198d42c1b249574261,1,Alex Antonenko,2014-08-01 17:56:13+03:00,['45ded7210aa4b065f9aa3baa06a5b324c2a53660'],294,323,617,18314834,14,1,1,0,15350
a63cf2238ddecbe7c1b8be3b3faa09f172b344b5,1,Andrew Onishuk,2014-08-01 19:26:12+03:00,['7a3585fb4222fbffc8186e198d42c1b249574261'],23,34,57,18314891,10,0.5,1,1,15350
6961561be7ecb253f2da86153d8d54f0bcac4a46,1,Srimanth Gunturi,2014-08-01 09:39:39-07:00,['a63cf2238ddecbe7c1b8be3b3faa09f172b344b5'],126,840,966,18315857,22,0.905747126,1,0.705747126,15358
99bab6aba6fac63f3a0182d255d34dc9e1c62e29,1,aBabiichuk,2014-08-01 19:59:41+03:00,['6961561be7ecb253f2da86153d8d54f0bcac4a46'],118,408,526,18316383,4,0.513513514,1,0.924324324,15358
191c2eab68ffde0977b39a2166fc2debc4cbea59,1,Alex Antonenko,2014-08-01 20:06:18+03:00,['99bab6aba6fac63f3a0182d255d34dc9e1c62e29'],3,331,334,18316717,11,0.333333333,0.333333333,1,15363
2e5d0d1fbe4d0366361836f8c01847a995cf71cf,1,Mahadev Konar,2014-08-01 10:08:44-07:00,['191c2eab68ffde0977b39a2166fc2debc4cbea59'],96,1161,1257,18317974,20,0.362348178,0.647773279,0.969635628,15369
249401df1a6596d92c02a7f1887ebffcd9aa5427,0,Alex Antonenko,2014-08-01 21:15:41+03:00,['2e5d0d1fbe4d0366361836f8c01847a995cf71cf'],1,1,2,18317976,1,,,,15369
00b24a491c200feaaeffeb78da0e39a4cbc873ff,1,Srimanth Gunturi,2014-08-01 13:00:33-07:00,['249401df1a6596d92c02a7f1887ebffcd9aa5427'],10,13,23,18317999,7,,,,15369
2c8925345bbad6b1a583275deb57a0a8210373c2,1,Yusaku Sako,2014-08-02 08:27:05-07:00,['00b24a491c200feaaeffeb78da0e39a4cbc873ff'],8,246,254,18318253,8,,,,15371
55c4401c9934988c8ba161c92f513b1bdeb98293,1,Srimanth Gunturi,2014-08-02 10:34:13-07:00,['2c8925345bbad6b1a583275deb57a0a8210373c2'],57,321,378,18318631,8,0.851851852,1,0.972222222,15373
d1e083ea2df74a18c29ae7e77eea6ac962ab6e2d,1,Yusaku Sako,2014-08-02 12:24:50-07:00,['55c4401c9934988c8ba161c92f513b1bdeb98293'],1,2,3,18318634,1,1,1,1,15373
9d665447e1787130149f58ea92fd5974a49595bd,0,Alex Antonenko,2014-08-04 12:11:31+03:00,['d1e083ea2df74a18c29ae7e77eea6ac962ab6e2d'],1,2,3,18318637,2,,,,15373
80b2a1f2e27294f4228bf83ded3d755d120ad0d2,1,atkach,2014-08-04 13:33:05+03:00,['9d665447e1787130149f58ea92fd5974a49595bd'],102,578,680,18319317,14,0.91634981,0.798479087,0.980988593,15375
f4f17ffe2970ac18b728e3b2444913b7600a3623,1,Aleksandr Kovalenko,2014-08-04 15:57:01+03:00,['80b2a1f2e27294f4228bf83ded3d755d120ad0d2'],3,7,10,18319327,4,1,1,1,15375
de4aab95adf06513bdfda0a63637d9b9c4d636cc,0,Aleksandr Kovalenko,2014-08-04 15:58:39+03:00,['f4f17ffe2970ac18b728e3b2444913b7600a3623'],9,9,18,18319345,2,,,,15375
5ca07247bb865a50b18b7d2c71d8bfec835a7ffe,1,Srimanth Gunturi,2014-08-04 09:07:41-07:00,['de4aab95adf06513bdfda0a63637d9b9c4d636cc'],25,242,267,18319612,4,0.166666667,0.528735632,1,15375
54e35331618128358f5416cdebaae9755bb9464a,0,aBabiichuk,2014-08-04 19:38:48+03:00,['5ca07247bb865a50b18b7d2c71d8bfec835a7ffe'],0,7,7,18319619,1,1,1,1,15375
3a02f603991f7894d9ea05cbb5ae9b8be1da28f7,1,Dmytro Sen,2014-08-04 19:46:57+03:00,['54e35331618128358f5416cdebaae9755bb9464a'],34,469,503,18320122,7,0.48,0.44,1,15377
d072327ef833ea51b500dfa379d20057ae663c23,1,Vitaly Brodetskyi,2014-08-04 17:52:29+03:00,['3a02f603991f7894d9ea05cbb5ae9b8be1da28f7'],47,47,94,18320216,9,,,,15377
5423110a38818b6fea6527dfe6a2712e4993a258,1,Jonathan Hurley,2014-08-04 13:14:18-04:00,['d072327ef833ea51b500dfa379d20057ae663c23'],99,528,627,18320843,6,0.022222222,1,1,15377
28abde9c6a58a5eefa40828779f53392bda9583b,1,Aleksandr Kovalenko,2014-08-04 20:38:08+03:00,['5423110a38818b6fea6527dfe6a2712e4993a258'],0,9,9,18320852,1,0,0,1,15377
bb91e787a6aa869324a30d0a5013975a9b2c51cb,1,atkach,2014-08-04 20:38:54+03:00,['28abde9c6a58a5eefa40828779f53392bda9583b'],170,212,382,18321234,12,0.536231884,0.942028986,0.884057971,15377
a431c7588bea10f94184dc1ea24c8435c40e1617,1,Aleksandr Kovalenko,2014-08-04 20:56:26+03:00,['bb91e787a6aa869324a30d0a5013975a9b2c51cb'],0,10,10,18321244,1,1,1,1,15377
f67cd91db8e392d42d8234aba0b8fa2884a57282,1,Jaimin Jetly,2014-08-04 13:54:42-07:00,['a431c7588bea10f94184dc1ea24c8435c40e1617'],127,75,202,18321446,15,0,0,0,15377
a37d44222e318dc0054d9abb94b60ce01c03b79e,0,Jaimin Jetly,2014-08-04 13:58:48-07:00,['f67cd91db8e392d42d8234aba0b8fa2884a57282'],2,2,4,18321450,1,,,,15377
6d48ee4dd64d287b8ca8535029ff826de511c8ac,0,Myroslav Papirkovskyy,2014-08-05 13:54:42+03:00,['a37d44222e318dc0054d9abb94b60ce01c03b79e'],1,1,2,18321452,1,,,,15377
7e879645b83075177c8ea9c80232eff2978c3be1,1,aBabiichuk,2014-08-05 14:31:51+03:00,['6d48ee4dd64d287b8ca8535029ff826de511c8ac'],3,80,83,18321535,2,1,1,0.95,15377
ad26aac3a2e55608fbf554dcbcf0d68647b4cf38,1,Myroslav Papirkovskyy,2014-08-05 14:37:52+03:00,['7e879645b83075177c8ea9c80232eff2978c3be1'],17,17,34,18321569,2,,,,15377
157f5ff441bc430fc230bb227d97988f9c2918fa,0,Aleksandr Kovalenko,2014-08-05 14:41:14+03:00,['ad26aac3a2e55608fbf554dcbcf0d68647b4cf38'],1,1,2,18321571,1,,,,15377
1153b2d9697aad3c3af36f97811ec6a5bffdc11f,1,Myroslav Papirkovskyy,2014-08-05 15:00:37+03:00,['157f5ff441bc430fc230bb227d97988f9c2918fa'],9,33,42,18321613,2,1,1,1,15377
c80ae8b112968759db6e12863275dbf7fe61333d,1,Aleksandr Kovalenko,2014-08-05 16:05:35+03:00,['1153b2d9697aad3c3af36f97811ec6a5bffdc11f'],6,8,14,18321627,4,1,1,1,15377
2280e7451123bad0ebad9f00c8836b3792d44b2b,1,atkach,2014-08-05 16:06:11+03:00,['c80ae8b112968759db6e12863275dbf7fe61333d'],21,128,149,18321776,6,0.956521739,1,1,15377
9f2b109e466f9cc143278c5f40742a5fb9fef5cb,1,aBabiichuk,2014-08-05 18:25:25+03:00,['2280e7451123bad0ebad9f00c8836b3792d44b2b'],0,16,16,18321792,1,,,,15377
d70da2c852521ff552a3baafc298fed9dcb97985,1,aBabiichuk,2014-08-05 19:58:02+03:00,['9f2b109e466f9cc143278c5f40742a5fb9fef5cb'],1,22,23,18321815,2,0,0.714285714,1,15377
24be62564c80426d4c15b24d596113ca3ce6cd12,1,Lisnichenko Dmitro,2014-08-05 22:03:58+03:00,['d70da2c852521ff552a3baafc298fed9dcb97985'],70,71,141,18321956,9,1,0,0,15377
5a0b5810fe4881a791bb9017cf7bb4937ae519d7,0,Jonathan Hurley,2014-08-05 19:27:57-04:00,['24be62564c80426d4c15b24d596113ca3ce6cd12'],4,28,32,18321988,2,1,1,0,15377
b240fa30767ce95638c3996c6826493d36229cd0,1,Mahadev Konar,2014-08-05 16:31:40-07:00,['5a0b5810fe4881a791bb9017cf7bb4937ae519d7'],25,6,31,18322019,3,0.333333333,0.166666667,1,15377
7554662d5744461f44100d93f9f1b9633bba7d96,1,Aleksandr Kovalenko,2014-08-06 14:04:58+03:00,['b240fa30767ce95638c3996c6826493d36229cd0'],5,37,42,18322061,4,0,0,1,15377
063da67cc2057afb443cec7503b09811594e6b33,0,Aleksandr Kovalenko,2014-08-06 15:48:34+03:00,['7554662d5744461f44100d93f9f1b9633bba7d96'],1,4,5,18322066,3,,,,15377
cc022804f1644aa9403e2a32e720ce4d0399df39,1,Alex Antonenko,2014-08-06 19:08:03+03:00,['063da67cc2057afb443cec7503b09811594e6b33'],14,14,28,18322094,5,,,,15377
47e19834b9891245049004c3fbc1ccb5b7910ed3,1,Vitaly Brodetskyi,2014-08-06 19:17:12+03:00,['cc022804f1644aa9403e2a32e720ce4d0399df39'],32,13,45,18322139,10,0,1,0,15377
92a52d4dac983fb6b02eafe65d8ed2a76d52a28e,1,Aleksandr Kovalenko,2014-08-06 20:52:13+03:00,['47e19834b9891245049004c3fbc1ccb5b7910ed3'],3,9,12,18322151,2,0,0,0.5,15377
989a4b97915e0b4564c7f4404815fa83e11151f0,1,Mahadev Konar,2014-08-06 11:14:09-07:00,['92a52d4dac983fb6b02eafe65d8ed2a76d52a28e'],28,1152,1180,18323331,48,0.240088106,0.607929515,0.823788546,15381
c2568ef26ead6989927186c443ed3ea907f56170,0,Xi Wang,2014-08-06 11:43:36-07:00,['989a4b97915e0b4564c7f4404815fa83e11151f0'],6,11,17,18323348,2,,,,15381
92c4d45f6ef69e2bdcc21fae4e5e5766fbba68db,1,Lisnichenko Dmitro,2014-08-06 21:56:02+03:00,['c2568ef26ead6989927186c443ed3ea907f56170'],230,347,577,18323925,22,0.849056604,0.245283019,0.622641509,15382
d2413e112941a48e10f8b3e8f33c509c3866c8b4,1,Nate Cole,2014-08-06 15:33:11-04:00,['92c4d45f6ef69e2bdcc21fae4e5e5766fbba68db'],18,11,29,18323954,2,1,1,0,15382
1a6b662bbec0e07f45f5b65d01ad5b7a8ffc9a7f,1,Xi Wang,2014-08-06 13:28:39-07:00,['d2413e112941a48e10f8b3e8f33c509c3866c8b4'],0,3,3,18323957,1,,,,15382
abf09efdafc900b4a72c85294fb10db4d8b55750,0,Xi Wang,2014-08-06 14:43:37-07:00,['1a6b662bbec0e07f45f5b65d01ad5b7a8ffc9a7f'],4,4,8,18323965,3,,,,15382
3e1ad2a4a1abc818ce331a7c233a9fa674d50a8c,1,Yusaku Sako,2014-08-06 16:35:08-07:00,['abf09efdafc900b4a72c85294fb10db4d8b55750'],309,1830,2139,18326104,39,0.893682589,1,0.747303544,15389
8d464c2b286c522a47e2eb12f55d67e59ee61d37,1,John Speidel,2014-08-06 22:32:48-04:00,['3e1ad2a4a1abc818ce331a7c233a9fa674d50a8c'],574,2182,2756,18328860,11,0.111111111,0.866013072,0.905228758,15392
ebb4217b2e4617613127d2420ad6f692a4049a68,0,atkach,2014-08-07 13:22:13+03:00,['8d464c2b286c522a47e2eb12f55d67e59ee61d37'],2,3,5,18328865,1,0,0,1,15392
5a56e80cd5b22af30fdb66c85852276d9dd45c30,1,atkach,2014-08-07 14:27:30+03:00,['ebb4217b2e4617613127d2420ad6f692a4049a68'],81,163,244,18329109,13,0.744680851,0.978723404,0.489361702,15392
2e432f3b496cc15547b9c6b3664c5b9c64084dba,1,Aleksandr Kovalenko,2014-08-07 15:07:54+03:00,['5a56e80cd5b22af30fdb66c85852276d9dd45c30'],92,182,274,18329383,7,1,1,1,15392
0f24bc24bab737a5998e5063a7b2fddf41884ede,1,aBabiichuk,2014-08-07 16:07:33+03:00,['2e432f3b496cc15547b9c6b3664c5b9c64084dba'],729,777,1506,18330889,13,0,1,1,15394
5bcd375294cc072665097187c76199696859c00b,1,Dmytro Sen,2014-08-07 17:15:54+03:00,['0f24bc24bab737a5998e5063a7b2fddf41884ede'],13,220,233,18331122,8,0.148148148,0.907407407,0.308641975,15394
7c0bab1197b5685f86c39a81372d44f8f8648451,1,Lisnichenko Dmitro,2014-08-07 17:33:50+03:00,['5bcd375294cc072665097187c76199696859c00b'],86,263,349,18331471,15,0.95,1,0.35,15395
c4a55353955e9fb1538cadf53ca1fe3956092448,1,aBabiichuk,2014-08-07 18:11:52+03:00,['7c0bab1197b5685f86c39a81372d44f8f8648451'],57,52,109,18331580,1,1,0,0,15395
334583cdd8dcc3e6d454d626a2734c5e85560396,1,Dmytro Sen,2014-08-07 18:20:12+03:00,['c4a55353955e9fb1538cadf53ca1fe3956092448'],6,25,31,18331611,3,0.666666667,0.833333333,0,15395
7a8de5884e5e856f751e7bb52776f27cf7b828ea,1,Srimanth Gunturi,2014-08-07 08:52:37-07:00,['334583cdd8dcc3e6d454d626a2734c5e85560396'],5,147,152,18331763,2,0,0.811965812,1,15395
9515e6c82483c35bbbd808cdf3fcf4028778b724,1,Jaimin Jetly,2014-08-07 10:16:29-07:00,['7a8de5884e5e856f751e7bb52776f27cf7b828ea'],112,141,253,18332016,5,1,1,0.94,15395
a716f3d7c503f229733ff30f809f99210a0d1d5f,1,Siddharth Wagle,2014-08-07 10:17:12-07:00,['9515e6c82483c35bbbd808cdf3fcf4028778b724'],50,63,113,18332129,4,0.6,0.8,1,15395
be6c3bdd7fb4471f0e23b53739c71c0c0ecec03f,1,Siddharth Wagle,2014-08-07 10:18:27-07:00,['a716f3d7c503f229733ff30f809f99210a0d1d5f'],17,26,43,18332172,2,0,1,1,15395
696c708b99ad392277741d81d85f40f08e828948,1,Siddharth Wagle,2014-08-07 10:26:20-07:00,['be6c3bdd7fb4471f0e23b53739c71c0c0ecec03f'],29,35,64,18332236,3,0,1,1,15395
892ea706b87e21fa911536d05bec458cc5488e20,0,Siddharth Wagle,2014-08-07 10:28:50-07:00,['696c708b99ad392277741d81d85f40f08e828948'],6,47,53,18332289,3,0,0,1,15395
2585179a80c3cdefa7fa69be09689308150ffddb,0,Siddharth Wagle,2014-08-07 10:34:45-07:00,['892ea706b87e21fa911536d05bec458cc5488e20'],54,191,245,18332534,8,0.285714286,0.506493506,1,15395
dddbaaabf75a8c5095588e7a2d66a39df907cdec,0,Siddharth Wagle,2014-08-07 10:37:54-07:00,['2585179a80c3cdefa7fa69be09689308150ffddb'],0,1,1,18332535,1,0,0,1,15395
9355f8f7c3d3d186bb344605f6a909e0dd78f881,1,Siddharth Wagle,2014-08-07 11:08:52-07:00,['dddbaaabf75a8c5095588e7a2d66a39df907cdec'],191,54,245,18332780,8,0.714285714,0.493506494,0,15395
9f74a44a1d27597259912c0c2141e43907536223,1,Srimanth Gunturi,2014-08-07 12:25:31-07:00,['9355f8f7c3d3d186bb344605f6a909e0dd78f881'],108,828,936,18333716,16,0.622641509,0.827493261,0.873315364,15400
6a91834c28cac0a9b20d5a2067dc6337b2d611ae,1,Alex Antonenko,2014-08-07 23:27:44+03:00,['9f74a44a1d27597259912c0c2141e43907536223'],131,171,302,18334018,6,1,1,1,15400
a65ae123b1081d7f7dfd5c121585e9d08992eb33,1,Nate Cole,2014-08-07 17:19:44-04:00,['6a91834c28cac0a9b20d5a2067dc6337b2d611ae'],18,179,197,18334215,6,0.346938776,0.87755102,0.183673469,15400
d8ebf2d67b8856eaebf6dd04bd5232528c79d861,0,Jaimin Jetly,2014-08-07 15:23:18-07:00,['a65ae123b1081d7f7dfd5c121585e9d08992eb33'],0,1,1,18334216,1,0,0,1,15400
e8b3554124adcee975309f9b39487ec1803f11c7,1,Yusaku Sako,2014-08-07 16:22:21-07:00,['d8ebf2d67b8856eaebf6dd04bd5232528c79d861'],193,267,460,18334676,25,0.5,1,0.53125,15402
b13bb71dc27494f220f97f1b5c6ba8d05354a55e,1,Srimanth Gunturi,2014-08-07 16:47:08-07:00,['e8b3554124adcee975309f9b39487ec1803f11c7'],50,544,594,18335270,13,0.317460317,0.900793651,0.452380952,15405
f1273f29d4eace2e3a33a2288cce5283e666d11f,1,Jaimin Jetly,2014-08-07 17:09:26-07:00,['b13bb71dc27494f220f97f1b5c6ba8d05354a55e'],17,34,51,18335321,5,1,0,0,15405
b6851a877b6252593678e35e553e5280f86137f8,1,Srimanth Gunturi,2014-08-07 20:27:47-07:00,['f1273f29d4eace2e3a33a2288cce5283e666d11f'],81,53,134,18335455,4,1,0,0,15405
1d31b9cd45ae191565d24aeecb14ebafbc9411f8,1,Aleksandr Kovalenko,2014-08-08 13:00:22+03:00,['b6851a877b6252593678e35e553e5280f86137f8'],8,17,25,18335480,1,0,1,1,15405
bc011042869297c53acc12b0ea036ab3cab46026,1,Aleksandr Kovalenko,2014-08-08 13:52:54+03:00,['1d31b9cd45ae191565d24aeecb14ebafbc9411f8'],0,7,7,18335487,1,0,0,1,15405
7acf07ace00955f64274b9f615a1aa643f6d8f9b,1,aBabiichuk,2014-08-08 14:12:35+03:00,['bc011042869297c53acc12b0ea036ab3cab46026'],5,14,19,18335506,3,0.666666667,1,1,15405
b6c0e4b7844fb1428cf5bc2c829daeacf14add04,0,aBabiichuk,2014-08-08 14:33:46+03:00,['7acf07ace00955f64274b9f615a1aa643f6d8f9b'],9,4,13,18335519,1,,,,15405
d156c0ee9d676bd128b3793b872c2253663cba5c,0,Dmytro Sen,2014-08-08 16:27:39+03:00,['b6c0e4b7844fb1428cf5bc2c829daeacf14add04'],6,10,16,18335535,2,0,1,1,15405
b3430e7050d90ce873485986f99ad29db2420c0d,1,Jonathan Hurley,2014-08-08 09:57:18-04:00,['d156c0ee9d676bd128b3793b872c2253663cba5c'],153,306,459,18335994,6,0.048387097,0.661290323,0.967741935,15405
70588f5e039df6ad4ecb7c9cfe82602fd88ef7ef,0,Nate Cole,2014-08-08 13:01:20-04:00,['b3430e7050d90ce873485986f99ad29db2420c0d'],5,5,10,18336004,2,,,,15405
cb662f494f27b0ffc2058151f550b0cb08572db1,1,Mahadev Konar,2014-08-08 10:10:21-07:00,['70588f5e039df6ad4ecb7c9cfe82602fd88ef7ef'],276,2942,3218,18339222,49,0.570596798,1,0.6069869,15413
09c575a2261bb4327527c90343fd7b745f68745a,1,Alex Antonenko,2014-08-08 20:25:09+03:00,['cb662f494f27b0ffc2058151f550b0cb08572db1'],3,698,701,18339923,14,0.718411552,0.613718412,1,15415
4da141ec696f5cba7a6bb8abba0648bafa630630,1,Alex Antonenko,2014-08-08 20:58:30+03:00,['09c575a2261bb4327527c90343fd7b745f68745a'],4,142,146,18340069,8,1,0,0,15415
f5b439bf55355f6e778da3ebd616020d2b14063d,1,aBabiichuk,2014-08-08 21:22:17+03:00,['4da141ec696f5cba7a6bb8abba0648bafa630630'],2,4,6,18340075,2,1,0,0,15415
48f033580943d17cb3b5fe1245de470efb8caba6,1,Alex Antonenko,2014-08-08 23:15:08+03:00,['f5b439bf55355f6e778da3ebd616020d2b14063d'],12,21,33,18340108,2,1,1,1,15415
5962d489a6d59600c9bd48e2d79d0362a881c739,1,Yusaku Sako,2014-08-08 13:26:36-07:00,['48f033580943d17cb3b5fe1245de470efb8caba6'],123,162,285,18340393,20,0.925925926,1,0.925925926,15415
48f43e2801e93017ebeb233ecf7ab10ace3ca565,1,Xi Wang,2014-08-08 14:59:13-07:00,['5962d489a6d59600c9bd48e2d79d0362a881c739'],15,18,33,18340426,2,1,1,1,15415
d657fa9cf619790759634c8d97452c17d16300cd,1,Jaimin Jetly,2014-08-08 16:12:18-07:00,['48f43e2801e93017ebeb233ecf7ab10ace3ca565'],19,10,29,18340455,3,0,1,1,15415
2792f3085f52dda2bcb83f9c773980085b59511f,1,Srimanth Gunturi,2014-08-08 16:22:23-07:00,['d657fa9cf619790759634c8d97452c17d16300cd'],3,19,22,18340477,2,,,,15415
6fd7d82b0279f44f1b45a2b12dd1a80e5b858542,0,Yusaku Sako,2014-08-08 16:39:33-07:00,['2792f3085f52dda2bcb83f9c773980085b59511f'],1,1,2,18340479,1,,,,15415
dc080221cfbc957ba0024a3b40e4d0148af10945,0,Jaimin Jetly,2014-08-08 17:15:13-07:00,['6fd7d82b0279f44f1b45a2b12dd1a80e5b858542'],1,1,2,18340481,1,,,,15415
ea41021d084764a2af4d80cd55cad0165996d546,0,Xi Wang,2014-08-08 17:59:13-07:00,['dc080221cfbc957ba0024a3b40e4d0148af10945'],2,2,4,18340485,2,,,,15415
cec8e4b7586230fd33a612953243627f32229c17,0,Srimanth Gunturi,2014-08-08 18:20:48-07:00,['ea41021d084764a2af4d80cd55cad0165996d546'],1,2,3,18340488,1,0,0,1,15415
748ac59fb977ca41d7fa5ffe6b010f1289e4e07c,1,Jaimin Jetly,2014-08-08 18:30:36-07:00,['cec8e4b7586230fd33a612953243627f32229c17'],1,1,2,18340490,1,,,,15415
6396b5b7cbbbfa067d7b78d35f42a7fec3137def,1,Jaimin Jetly,2014-08-08 19:30:07-07:00,['748ac59fb977ca41d7fa5ffe6b010f1289e4e07c'],22,17,39,18340529,2,,,,15415
9293ae9409a435570ec6b8a263a398d7ca3bda5c,0,Nate Cole,2014-08-09 08:06:08-04:00,['6396b5b7cbbbfa067d7b78d35f42a7fec3137def'],2,2,4,18340533,2,,,,15415
778d62e8a3dff4bbdd3d21d795cd919d67be0984,1,Nate Cole,2014-08-10 13:17:48-04:00,['9293ae9409a435570ec6b8a263a398d7ca3bda5c'],1,28,29,18340562,2,,,,15416
da2ac57778b406f2ac6ce0ca1e4c7e6944552568,1,tbeerbower,2014-08-10 20:19:47-04:00,['778d62e8a3dff4bbdd3d21d795cd919d67be0984'],373,1263,1636,18342198,36,0.239520958,0.55988024,0.748502994,15420
7826a3ff41d7a23dec54a636dbd088666a9fd6d9,1,Aleksandr Kovalenko,2014-08-11 12:42:41+03:00,['da2ac57778b406f2ac6ce0ca1e4c7e6944552568'],14,29,43,18342241,2,0,0,0,15420
1aa5bcdd8426bad4c175a34fd9bbc62ead757c4c,1,Myroslav Papirkovskyy,2014-08-11 13:05:05+03:00,['7826a3ff41d7a23dec54a636dbd088666a9fd6d9'],27,167,194,18342435,11,0.296703297,0,1,15420
f1909d72c561095ce579f956b617ba5451d15b1c,0,Aleksandr Kovalenko,2014-08-11 15:26:15+03:00,['1aa5bcdd8426bad4c175a34fd9bbc62ead757c4c'],1,1,2,18342437,1,,,,15420
4897ab831ea6aa0e96e6b89ca15e73d6780c62fc,1,Vitaly Brodetskyi,2014-08-11 18:01:40+03:00,['f1909d72c561095ce579f956b617ba5451d15b1c'],15,109,124,18342561,8,0.431372549,0.823529412,0.725490196,15420
5c0306e68aac3370946ef36e082deac0128bf5fb,0,Aleksandr Kovalenko,2014-08-11 19:02:12+03:00,['4897ab831ea6aa0e96e6b89ca15e73d6780c62fc'],24,20,44,18342605,4,0,0,0,15420
0677c8d12f620adef484ea94638a15234f301602,0,aBabiichuk,2014-08-11 19:25:00+03:00,['5c0306e68aac3370946ef36e082deac0128bf5fb'],0,1,1,18342606,1,1,1,1,15420
989492ba8da41b1eca7c8aae53adda5c837e906b,1,aBabiichuk,2014-08-11 20:10:21+03:00,['0677c8d12f620adef484ea94638a15234f301602'],430,297,727,18343333,14,0.30964467,0,0,15420
88b170d49d17dc03d5a2fc48f41afaccea836307,0,Srimanth Gunturi,2014-08-11 10:13:43-07:00,['989492ba8da41b1eca7c8aae53adda5c837e906b'],8,56,64,18343397,8,0.3,0.366666667,1,15420
a2086b1fc88ccc85b9765a58d53f48f6c14d8ce1,1,Jonathan Hurley,2014-08-11 15:08:37-04:00,['88b170d49d17dc03d5a2fc48f41afaccea836307'],35,173,208,18343605,5,0.071428571,0.114285714,1,15421
3782678a3ad800de3be07dda99183be77ab76192,1,tbeerbower,2014-08-11 15:47:18-04:00,['a2086b1fc88ccc85b9765a58d53f48f6c14d8ce1'],4,10,14,18343619,1,0,1,1,15421
89203a38b1bb1efd4ad56c6790f132dd72dc2b4c,0,Jaimin Jetly,2014-08-11 13:00:15-07:00,['3782678a3ad800de3be07dda99183be77ab76192'],1,1,2,18343621,1,,,,15421
3416197017f766addf22d985900cd94a862dddca,0,subin,2014-08-12 01:27:29+05:18,['89203a38b1bb1efd4ad56c6790f132dd72dc2b4c'],7,54,61,18343682,3,0.25,1,0,15421
6cf54ca53e536bbbe2a7363695a8f0f5a9b012c4,0,subin,2014-08-12 01:36:14+05:18,['3416197017f766addf22d985900cd94a862dddca'],0,1,1,18343683,1,0,0,0,15421
e19a0c8e2933ec29d605ace1846bbbc9ea678ebe,0,subin,2014-08-12 01:38:52+05:18,['6cf54ca53e536bbbe2a7363695a8f0f5a9b012c4'],2,174,176,18343859,4,0.860927152,1,0.913907285,15421
b6f4e586eb157a8b9036f10fb4b77cc8ea87e7d5,1,Siddharth Wagle,2014-08-11 13:22:56-07:00,['e19a0c8e2933ec29d605ace1846bbbc9ea678ebe'],13,37,50,18343909,3,0,0.5,0.5,15421
bf49c0c2fb426263a3619c97fd485afb6122ebec,0,subin,2014-08-12 01:47:39+05:18,['b6f4e586eb157a8b9036f10fb4b77cc8ea87e7d5'],2,2,4,18343913,2,,,,15421
b7f9612b5556d4f14906b54caebefd118a548e73,1,Siddharth Wagle,2014-08-11 14:04:31-07:00,['bf49c0c2fb426263a3619c97fd485afb6122ebec'],145,323,468,18344381,15,0.198412698,0.301587302,0.952380952,15421
64ed974aea6a67ee9a2d95d5a7bdea38ed19236d,1,Yusaku Sako,2014-08-11 14:33:30-07:00,['b7f9612b5556d4f14906b54caebefd118a548e73'],145,241,386,18344767,26,1,1,0.849056604,15421
53e827c2ca59a9cd9289237b52ae26abf6a9d165,0,Yusaku Sako,2014-08-11 17:48:38-07:00,['64ed974aea6a67ee9a2d95d5a7bdea38ed19236d'],2,2,4,18344771,1,,,,15421
6079ad7e3c22b53b5c71c61ae2bc822d2486adf9,1,Andrew Onishuk,2014-08-12 12:46:16+03:00,['53e827c2ca59a9cd9289237b52ae26abf6a9d165'],1,1,2,18344773,1,,,,15421
78605d25dbf45777e7b2fab8d510d97a998b3162,1,Aleksandr Kovalenko,2014-08-12 14:37:38+03:00,['6079ad7e3c22b53b5c71c61ae2bc822d2486adf9'],4,1,5,18344778,1,0,0,0,15421
d7a4c60d59f52630cfdbf5bd2ad7e0981a9a96d8,0,Aleksandr Kovalenko,2014-08-12 15:06:26+03:00,['78605d25dbf45777e7b2fab8d510d97a998b3162'],1,1,2,18344780,1,,,,15421
382e7f3dfd547e4945caecf03164d939fb19b32c,1,aBabiichuk,2014-08-12 15:07:37+03:00,['d7a4c60d59f52630cfdbf5bd2ad7e0981a9a96d8'],30,316,346,18345126,7,0.573333333,0.253333333,0.866666667,15422
9bbb43e57bb6071fabcb23c12ffb222fb33cccdb,1,Lisnichenko Dmitro,2014-08-12 19:13:38+03:00,['382e7f3dfd547e4945caecf03164d939fb19b32c'],92,464,556,18345682,5,0.022508039,0.581993569,1,15422
23c73e67a986cb97658ae56e502368529f6e1712,1,Alex Antonenko,2014-08-12 19:36:50+03:00,['9bbb43e57bb6071fabcb23c12ffb222fb33cccdb'],9,24,33,18345715,3,1,1,1,15422
bc541bd41b04ce7fa04bfe8d027a54992583b864,1,Siddharth Wagle,2014-08-12 10:28:08-07:00,['23c73e67a986cb97658ae56e502368529f6e1712'],63,71,134,18345849,5,1,1,0,15422
0715d9bf3574fd371d2d11191843318d29bce8dd,1,Siddharth Wagle,2014-08-12 10:30:50-07:00,['bc541bd41b04ce7fa04bfe8d027a54992583b864'],31,179,210,18346059,13,0.718309859,0.450704225,0.535211268,15422
dceec5cc67a2740a3af333ebae10cfb0e306c2c6,1,Yusaku Sako,2014-08-12 11:17:46-07:00,['0715d9bf3574fd371d2d11191843318d29bce8dd'],0,18,18,18346077,1,1,1,0.947368421,15422
389b2505d575b66615526e913b9fda91218dd752,1,Yusaku Sako,2014-08-12 11:28:52-07:00,['dceec5cc67a2740a3af333ebae10cfb0e306c2c6'],26,98,124,18346201,7,0.9375,0.958333333,0.75,15422
62e2f9f8efd2d5d934e9c87f0d36568124660248,1,Mahadev Konar,2014-08-12 12:09:13-07:00,['389b2505d575b66615526e913b9fda91218dd752'],1,89,90,18346291,2,0,0,1,15423
221f0e511c4232af2b4ad49b99965a34e4f59df6,1,Mahadev Konar,2014-08-12 13:44:41-07:00,['62e2f9f8efd2d5d934e9c87f0d36568124660248'],225,527,752,18347043,14,0.260606061,0.763636364,0.781818182,15428
2aee43d386e36f8c4999409db02078eb36c08e04,1,Mahadev Konar,2014-08-12 14:47:24-07:00,['221f0e511c4232af2b4ad49b99965a34e4f59df6'],294,203,497,18347540,13,1,0.056603774,0.056603774,15428
f2114d8c9e7905cc6b4d87c2007e1253d6d9e01d,1,Siddharth Wagle,2014-08-12 16:04:45-07:00,['2aee43d386e36f8c4999409db02078eb36c08e04'],3,5,8,18347548,1,0,0,1,15428
e8c80e2213c40e42d89f4db870ab0a8bf0b9e15c,1,Jonathan Hurley,2014-08-12 23:21:52-04:00,['f2114d8c9e7905cc6b4d87c2007e1253d6d9e01d'],50,72,122,18347670,4,0.9,0.7,1,15428
4c41d45f34d04678ebafe7f30100673a41fa03d3,0,Dmytro Sen,2014-08-13 11:53:18+03:00,['e8c80e2213c40e42d89f4db870ab0a8bf0b9e15c'],2,2,4,18347674,2,,,,15428
acd7908d997fe6734aa2f90cb5867dcca003e11d,1,Dmytro Sen,2014-08-13 12:01:06+03:00,['4c41d45f34d04678ebafe7f30100673a41fa03d3'],7,2,9,18347683,1,,,,15428
419f6aa5dac946e860b0619e677aadc1713ee81c,1,Andrew Onishuk,2014-08-13 17:45:08+03:00,['acd7908d997fe6734aa2f90cb5867dcca003e11d'],42,18,60,18347743,6,1,0.142857143,0,15428
fc8378f7f76f2ceec172a462a256c588a914f502,0,Andrew Onishuk,2014-08-13 17:53:33+03:00,['419f6aa5dac946e860b0619e677aadc1713ee81c'],0,1,1,18347744,1,,,,15428
a9cc53a9ec1f2dc8a2077a53d155fe78f36de853,1,Alex Antonenko,2014-08-13 17:55:27+03:00,['fc8378f7f76f2ceec172a462a256c588a914f502'],1,1,2,18347746,1,1,1,1,15428
56ff1abdbfcef2491531a0bdbf29ff907144e9d5,1,Andrew Onishuk,2014-08-13 18:08:00+03:00,['a9cc53a9ec1f2dc8a2077a53d155fe78f36de853'],105,141,246,18347992,9,1,1,1,15428
1eaf6a9e92d5620cf7c7952a100e9dc243b6b576,1,Alex Antonenko,2014-08-13 18:27:00+03:00,['56ff1abdbfcef2491531a0bdbf29ff907144e9d5'],15,55,70,18348062,3,1,1,0.942857143,15428
efc6eee8d9f272ad389924584abb8f21073ecd15,1,aBabiichuk,2014-08-13 19:02:17+03:00,['1eaf6a9e92d5620cf7c7952a100e9dc243b6b576'],132,167,299,18348361,12,0.4,0,1,15430
2a617da83e2483f3733b57cf2600df34784888a6,1,Xi Wang,2014-08-13 11:19:11-07:00,['efc6eee8d9f272ad389924584abb8f21073ecd15'],105,108,213,18348574,9,0,1,1,15430
f3bd5cc8cec545b3513c8442d42957b5fea71cd3,1,Siddharth Wagle,2014-08-13 12:43:32-07:00,['2a617da83e2483f3733b57cf2600df34784888a6'],8,33,41,18348615,1,0.8,0.8,1,15430
1b72f6df78a8e683256ed0654146deb59e341490,1,Siddharth Wagle,2014-08-13 12:45:35-07:00,['f3bd5cc8cec545b3513c8442d42957b5fea71cd3'],86,265,351,18348966,11,0.298076923,0.509615385,0.971153846,15430
84cdfef24120d5c4e98582617135f901f86ab58d,1,Mahadev Konar,2014-08-13 13:22:01-07:00,['1b72f6df78a8e683256ed0654146deb59e341490'],8,268,276,18349242,3,0.005291005,1,0.835978836,15430
952c364abc8e41a9e3e96df23224f84bb397dab0,1,Yusaku Sako,2014-08-13 13:30:57-07:00,['84cdfef24120d5c4e98582617135f901f86ab58d'],146,509,655,18349897,31,0.720338983,0.796610169,1,15432
71d91a7c50c2df8880b0ac3bcae32c579c31d361,1,Srimanth Gunturi,2014-08-13 14:03:32-07:00,['952c364abc8e41a9e3e96df23224f84bb397dab0'],3668,4,3672,18353569,28,0.472626821,0.328478152,0.08839779,15432
646ef29b62f94fb4553c2330884f4c1ee8f79560,1,Srimanth Gunturi,2014-08-13 14:13:27-07:00,['71d91a7c50c2df8880b0ac3bcae32c579c31d361'],4,132,136,18353705,8,,,,15432
30f8c43f81173eea94863c0a1ebb964da2a40b49,1,Myroslav Papirkovskyy,2014-08-14 10:17:23+03:00,['646ef29b62f94fb4553c2330884f4c1ee8f79560'],31,101,132,18353837,15,0.333333333,0.692307692,0,15432
c10ccb2f8d4e7116b2e64817bc803b882b6851d7,1,Dmytro Sen,2014-08-14 14:30:56+03:00,['30f8c43f81173eea94863c0a1ebb964da2a40b49'],237,486,723,18354560,16,0.137440758,0.829383886,0.853080569,15434
5321aeaf46a5e36e1c63f1bd20d45ede92d6be58,1,Andrew Onishuk,2014-08-14 14:56:09+03:00,['c10ccb2f8d4e7116b2e64817bc803b882b6851d7'],2,2,4,18354564,1,,,,15434
932202d7c7951f4d90e77756a134fffbe75d1aba,1,Vitaly Brodetskyi,2014-08-14 15:48:29+03:00,['5321aeaf46a5e36e1c63f1bd20d45ede92d6be58'],2,15,17,18354581,2,0,0,1,15434
2b6b5bc473f74320fa8de4b3d3142330b5c7b0b1,0,Aleksandr Kovalenko,2014-08-14 17:35:13+03:00,['932202d7c7951f4d90e77756a134fffbe75d1aba'],0,1,1,18354582,1,1,1,1,15434
428c352158133eb82fe4ba097fdb02c288bb4cff,1,Nate Cole,2014-08-14 12:29:04-04:00,['2b6b5bc473f74320fa8de4b3d3142330b5c7b0b1'],22,53,75,18354657,3,0.941176471,1,0.176470588,15434
203f0ae1a1a3195e1d6dd0e69a2f5e4cfd1b10e2,0,Jaimin Jetly,2014-08-14 12:14:48-07:00,['428c352158133eb82fe4ba097fdb02c288bb4cff'],0,1,1,18354658,1,,,,15434
abe2e25c23bf42500212d49aeae9aa50d9a484f2,1,Yusaku Sako,2014-08-14 12:25:55-07:00,['203f0ae1a1a3195e1d6dd0e69a2f5e4cfd1b10e2'],146,235,381,18355039,21,0.469387755,1,0,15435
c6c216542cb3f4b5393316b42a5acb1040ddab3d,1,Aleksandr Kovalenko,2014-08-14 23:01:36+03:00,['abe2e25c23bf42500212d49aeae9aa50d9a484f2'],4,13,17,18355056,4,1,1,1,15435
433337402553978dd2ca7818cd935f9c2b625858,1,Yusaku Sako,2014-08-14 13:23:40-07:00,['c6c216542cb3f4b5393316b42a5acb1040ddab3d'],895,57,952,18356008,30,0,0,0.072847682,15435
58ae58d4447ca4de35d878817fb7066f60a46efe,1,Jaimin Jetly,2014-08-14 15:17:20-07:00,['433337402553978dd2ca7818cd935f9c2b625858'],18,7,25,18356033,1,0,0,0,15435
2489e7711505f91ea5b3c3a663120ede2151046b,1,Srimanth Gunturi,2014-08-14 17:29:02-07:00,['58ae58d4447ca4de35d878817fb7066f60a46efe'],68,1120,1188,18357221,17,0.483870968,0.87829912,0.954545455,15438
f825ccaec685d1400042c9a42ce03bcd94130e81,1,Srimanth Gunturi,2014-08-14 18:08:36-07:00,['2489e7711505f91ea5b3c3a663120ede2151046b'],29,554,583,18357804,9,0.44691358,0.795061728,0.792592593,15440
37450a526ce26493d463ff3da190a8750b213c76,1,Siddharth Wagle,2014-08-14 18:37:24-07:00,['f825ccaec685d1400042c9a42ce03bcd94130e81'],49,149,198,18358002,3,0.086956522,1,1,15440
93a60de300621049ca5aa088b1c0e1bd65b529fb,0,Dmytro Sen,2014-08-15 11:20:28+03:00,['37450a526ce26493d463ff3da190a8750b213c76'],1,1,2,18358004,1,,,,15440
dd3a3853d67d9227c1f710a1517a864eae132cc3,1,aBabiichuk,2014-08-15 14:49:02+03:00,['93a60de300621049ca5aa088b1c0e1bd65b529fb'],104,135,239,18358243,3,0,0,1,15440
c26968df46b08c16f4c9fa129500ef92ec352b75,1,Alex Antonenko,2014-08-15 16:45:42+03:00,['dd3a3853d67d9227c1f710a1517a864eae132cc3'],2,4,6,18358249,2,1,1,1,15440
e2fc2c7313d3ffbbd5e764819b944507fdd8a4fa,1,Aleksandr Kovalenko,2014-08-15 17:00:07+03:00,['c26968df46b08c16f4c9fa129500ef92ec352b75'],1500,37,1537,18359786,20,0.108721625,0.051373955,0.086021505,15440
13ed07199f87b7c71ae5c442f914339f4531998b,0,Aleksandr Kovalenko,2014-08-15 17:08:18+03:00,['e2fc2c7313d3ffbbd5e764819b944507fdd8a4fa'],1,0,1,18359787,1,,,,15440
a10f42a7a00a9dc5947e26c78d34af9cdcc6ca1e,1,Dmytro Sen,2014-08-15 17:22:32+03:00,['13ed07199f87b7c71ae5c442f914339f4531998b'],11,165,176,18359963,22,,,,15440
ea915a0d248c344823365ce75a99a5badd328cdf,1,Alex Antonenko,2014-08-15 17:45:37+03:00,['a10f42a7a00a9dc5947e26c78d34af9cdcc6ca1e'],5,37,42,18360005,3,1,1,1,15440
91d69358e40ab4469261c13eced212c4c938054f,1,Alex Antonenko,2014-08-15 18:12:41+03:00,['ea915a0d248c344823365ce75a99a5badd328cdf'],4,18,22,18360027,2,0,0,1,15440
2ad28c63229aab0c9599ba635ea9ce5959cb2037,1,Myroslav Papirkovskyy,2014-08-15 20:39:43+03:00,['91d69358e40ab4469261c13eced212c4c938054f'],0,128,128,18360155,3,0.097826087,0.097826087,1,15440
6afba61c645c429c78a896f4af014579d331cb55,1,Jaimin Jetly,2014-08-15 10:50:50-07:00,['2ad28c63229aab0c9599ba635ea9ce5959cb2037'],394,315,709,18360864,51,1,1,0,15440
76b801783c97bb779c141d976786a6d42a6d23ea,1,Nate Cole,2014-08-15 15:23:59-04:00,['6afba61c645c429c78a896f4af014579d331cb55'],2,90,92,18360956,2,0,0.649122807,0.649122807,15440
b208f6715f0a63e2a35bcdc4148f912525213959,0,Jonathan Hurley,2014-08-15 16:15:17-04:00,['76b801783c97bb779c141d976786a6d42a6d23ea'],123,17,140,18361096,3,0,0,1,15440
0e565a56fbb0ad8e46709a8a104622e6d248156c,1,Jaimin Jetly,2014-08-15 14:42:09-07:00,['b208f6715f0a63e2a35bcdc4148f912525213959'],24,29,53,18361149,1,0,1,1,15440
1ea989b2938b80b7ee26b479add16a307af85e26,1,Siddharth Wagle,2014-08-15 14:47:58-07:00,['0e565a56fbb0ad8e46709a8a104622e6d248156c'],99,276,375,18361524,10,0.097087379,0,1,15440
bd9435daa95532016b34682231a90f8102bb4eac,1,Siddharth Wagle,2014-08-15 14:48:15-07:00,['1ea989b2938b80b7ee26b479add16a307af85e26'],2,15,17,18361541,1,0,1,1,15440
7f76580405e662afcd51c82c3dccfc17f39aa69d,1,Xi Wang,2014-08-15 16:01:19-07:00,['bd9435daa95532016b34682231a90f8102bb4eac'],58,126,184,18361725,7,1,1,1,15440
49a377ce42b8869041b8d8171dafb143980307c8,1,Andrew Onishuk,2014-08-18 15:05:37+03:00,['7f76580405e662afcd51c82c3dccfc17f39aa69d'],9,41,50,18361775,13,0.5,1,1,15440
cbf4fc8231f2816717ecc57531678aa83196bf96,1,Andrew Onishuk,2014-08-18 16:52:50+03:00,['49a377ce42b8869041b8d8171dafb143980307c8'],0,78,78,18361853,2,1,1,1,15442
ec1707fd7dee51ceb106435402931b4cff9b3a2f,0,atkach,2014-08-18 18:08:51+03:00,['cbf4fc8231f2816717ecc57531678aa83196bf96'],26,16,42,18361895,4,0,1,1,15442
1730dc5b87bd3bf9f3ded68a47c7bf2d33725997,1,Vitaly Brodetskyi,2014-08-18 18:17:49+03:00,['ec1707fd7dee51ceb106435402931b4cff9b3a2f'],57,44,101,18361996,1,1,1,0,15442
f0be435e07349e53fb2b9ecf33952efd25d0c90d,1,Dmytro Sen,2014-08-18 19:08:04+03:00,['1730dc5b87bd3bf9f3ded68a47c7bf2d33725997'],1,41,42,18362038,2,0,0.222222222,1,15442
620978b61182d1cbacffe11ceb79014823972aee,1,atkach,2014-08-18 19:21:38+03:00,['f0be435e07349e53fb2b9ecf33952efd25d0c90d'],2,5,7,18362045,2,1,1,1,15442
947899ec670aea29f00ca1aa95ea8ec226c64807,0,Alex Antonenko,2014-08-18 19:42:19+03:00,['620978b61182d1cbacffe11ceb79014823972aee'],5,14,19,18362064,1,1,1,1,15442
eefa2fd57ba0e747f9b894bacc25084633395564,0,Andrew Onishuk,2014-08-18 20:09:46+03:00,['947899ec670aea29f00ca1aa95ea8ec226c64807'],48,0,48,18362112,6,1,0,0,15442
32caa4359b7fd777fc7ca9b74e6d8a1212d6f6a0,1,Srimanth Gunturi,2014-08-18 10:36:04-07:00,['eefa2fd57ba0e747f9b894bacc25084633395564'],180,211,391,18362503,3,1,1,0,15442
50e798395a1ca97ce0d0f2eb4979bed657227ea4,1,Mahadev Konar,2014-08-18 10:49:57-07:00,['32caa4359b7fd777fc7ca9b74e6d8a1212d6f6a0'],21,22,43,18362546,2,1,1,1,15442
1a9abc4ede0618f512d51390d8fdb175a0c96911,1,Mahadev Konar,2014-08-18 13:00:52-07:00,['50e798395a1ca97ce0d0f2eb4979bed657227ea4'],126,121,247,18362793,30,1,1,0,15442
e7d864ca0f0eed4f7011e34131ec6f7f7756d377,0,Jaimin Jetly,2014-08-18 13:23:22-07:00,['1a9abc4ede0618f512d51390d8fdb175a0c96911'],13,13,26,18362819,2,,,,15442
bba2806f76d98a139e83736fd08b72fae0ab27c1,1,Mahadev Konar,2014-08-18 13:29:55-07:00,['e7d864ca0f0eed4f7011e34131ec6f7f7756d377'],13,4,17,18362836,1,1,0,0,15442
b8c8326378f3fe7f58a453f291508a5fd82ba023,0,Jonathan Hurley,2014-08-18 16:32:58-04:00,['bba2806f76d98a139e83736fd08b72fae0ab27c1'],0,1,1,18362837,1,0,0,1,15442
ab128d4ac99e1e6742ea49a3064923556a23167b,1,Jaimin Jetly,2014-08-18 19:15:48-07:00,['b8c8326378f3fe7f58a453f291508a5fd82ba023'],28,98,126,18362963,14,0.941176471,1,0.941176471,15442
bbd9179ad9e6fdc503649bf2cde5484ae8d78571,1,Jonathan Hurley,2014-08-18 22:31:04-04:00,['ab128d4ac99e1e6742ea49a3064923556a23167b'],127,182,309,18363272,10,0.25,0.625,0.9375,15442
388c52ee8fc0d002a82eef3d8a6ddca360fd5fb3,1,Srimanth Gunturi,2014-08-18 20:33:19-07:00,['bbd9179ad9e6fdc503649bf2cde5484ae8d78571'],26,93,119,18363391,7,1,1,1,15442
6cfdd1cfdc43e9b1c4a69106693ebd5b0e31aaac,1,aBabiichuk,2014-08-19 14:44:03+03:00,['388c52ee8fc0d002a82eef3d8a6ddca360fd5fb3'],20,39,59,18363450,2,,,,15442
26c1edca8565a4db3fbd9a68d2622dff874a9dda,1,Aleksandr Kovalenko,2014-08-19 15:33:24+03:00,['6cfdd1cfdc43e9b1c4a69106693ebd5b0e31aaac'],39,96,135,18363585,3,0.111111111,1,0.814814815,15442
0116db8d5ebcfcd919bc908f51bc802dd0c8f018,0,Andrew Onishuk,2014-08-19 16:03:34+03:00,['26c1edca8565a4db3fbd9a68d2622dff874a9dda'],1,9,10,18363595,1,,,,15442
7d8927c8e3026306ad246a18180e083346c00d76,1,Lisnichenko Dmitro,2014-08-19 17:19:13+03:00,['0116db8d5ebcfcd919bc908f51bc802dd0c8f018'],279,277,556,18364151,7,0,0,0,15443
1bd86fb1255087f411d8df3f683e0cba40aa1ab6,0,aBabiichuk,2014-08-19 17:56:06+03:00,['7d8927c8e3026306ad246a18180e083346c00d76'],1,1,2,18364153,1,,,,15443
2745675078ad3ff895b069b1b82179c769442ddb,0,Aleksandr Kovalenko,2014-08-19 19:40:02+03:00,['1bd86fb1255087f411d8df3f683e0cba40aa1ab6'],2,8,10,18364163,2,0,0,1,15443
c9fbc849f8a617a834d979c66c185cf0c364c694,1,Myroslav Papirkovskyy,2014-08-19 20:18:13+03:00,['2745675078ad3ff895b069b1b82179c769442ddb'],0,56,56,18364219,2,,,,15443
0c46e95e646da932d644719377d2584fc2b026c6,1,Mahadev Konar,2014-08-19 10:56:11-07:00,['c9fbc849f8a617a834d979c66c185cf0c364c694'],3,136,139,18364358,2,0.042253521,0.929577465,0.929577465,15444
1c5ceb273a81b0e553cf3c7585db2c0be670cec0,1,Lisnichenko Dmitro,2014-08-19 21:14:35+03:00,['0c46e95e646da932d644719377d2584fc2b026c6'],3,13,16,18364374,2,0,0,1,15444
30f8a87a657993f2b0632289142fd513e7948e75,0,Jonathan Hurley,2014-08-19 14:21:16-04:00,['1c5ceb273a81b0e553cf3c7585db2c0be670cec0'],22,79,101,18364475,4,0,0,0.911111111,15444
40dc5b75ee63358765d52a60d5751c6152100704,0,Xi Wang,2014-08-19 11:36:34-07:00,['30f8a87a657993f2b0632289142fd513e7948e75'],2,4,6,18364481,2,1,1,1,15444
933f7f8b26bf2897534ffa67ef257336a08d4c20,1,Xi Wang,2014-08-19 11:36:34-07:00,['40dc5b75ee63358765d52a60d5751c6152100704'],31,43,74,18364555,6,1,1,0.166666667,15444
5aaa32c19fdca3811d0a942cb1589afbf0448534,0,Srimanth Gunturi,2014-08-19 11:50:35-07:00,['933f7f8b26bf2897534ffa67ef257336a08d4c20'],7,7,14,18364569,1,,,,15444
4644a826ba2b9a13a0815c356faaa9529e1922bc,1,Lisnichenko Dmitro,2014-08-19 22:03:28+03:00,['5aaa32c19fdca3811d0a942cb1589afbf0448534'],19,146,165,18364734,2,0,0.903614458,0.903614458,15444
818dc161fe41b7f9b92e67042b3840e4a8158737,1,aBabiichuk,2014-08-19 22:10:08+03:00,['4644a826ba2b9a13a0815c356faaa9529e1922bc'],90,560,650,18365384,14,0.682539683,1,1,15445
51bebd3daa97478946bbef65ffd77ee62af19ba2,1,Mahadev Konar,2014-08-19 12:16:02-07:00,['818dc161fe41b7f9b92e67042b3840e4a8158737'],19,277,296,18365680,3,0.375,0.975,0.86875,15446
e1eaf3a3176b7e0c6fcb5a75547a0f9f0f0df79d,0,Siddharth Wagle,2014-08-19 13:11:45-07:00,['51bebd3daa97478946bbef65ffd77ee62af19ba2'],0,3,3,18365683,1,0,0,1,15446
b39b998ece510c00f2bae6b9430618ebd9b78d2a,0,Xi Wang,2014-08-19 15:15:57-07:00,['e1eaf3a3176b7e0c6fcb5a75547a0f9f0f0df79d'],0,5,5,18365688,1,0,1,1,15446
356e17af4d47f37185cd91e024333194fa5714ee,0,Jaimin Jetly,2014-08-19 18:05:09-07:00,['b39b998ece510c00f2bae6b9430618ebd9b78d2a'],10,15,25,18365713,1,,,,15446
068cafa9056c490d8abdd4e9bd9322b6f71ca2f3,0,Jaimin Jetly,2014-08-19 19:11:52-07:00,['356e17af4d47f37185cd91e024333194fa5714ee'],12,13,25,18365738,2,1,1,1,15446
f72b323f7e468da16067607221a08d9d0926bf30,1,Siddharth Wagle,2014-08-19 22:46:34-07:00,['068cafa9056c490d8abdd4e9bd9322b6f71ca2f3'],3,14,17,18365755,1,,,,15446
127eec229ed03414776d16cccad7d486a9bb112c,1,Vitaly Brodetskyi,2014-08-20 13:05:17+03:00,['f72b323f7e468da16067607221a08d9d0926bf30'],0,70,70,18365825,6,,,,15448
35dbbe98daab67725dcc1f36039b3c116a81476c,0,Aleksandr Kovalenko,2014-08-20 14:53:12+03:00,['127eec229ed03414776d16cccad7d486a9bb112c'],1,1,2,18365827,1,,,,15448
7581b9aa69b22688db70c99e4bff842a58423fef,1,aBabiichuk,2014-08-20 14:56:34+03:00,['35dbbe98daab67725dcc1f36039b3c116a81476c'],41,80,121,18365948,3,1,0,0.004878049,15448
ed09f6a223e837212f6d44d75a204f133c91ab6d,0,Vitaly Brodetskyi,2014-08-20 15:47:49+03:00,['7581b9aa69b22688db70c99e4bff842a58423fef'],9,4,13,18365961,1,,,,15448
84c4b434e73fcd8667d2b9c5133be7d2ff4c4454,1,Andrew Onishuk,2014-08-20 15:54:55+03:00,['ed09f6a223e837212f6d44d75a204f133c91ab6d'],1,164,165,18366126,26,0.279069767,0.837209302,1,15448
348ebeabaaef566c1502e7b28c546e00d9f27d5e,1,Dmytro Sen,2014-08-20 17:16:05+03:00,['84c4b434e73fcd8667d2b9c5133be7d2ff4c4454'],1,5,6,18366132,1,1,0,1,15448
82fdc695706e13d1d1cc20f9ba9b266775222d58,1,tbeerbower,2014-08-20 10:16:03-04:00,['348ebeabaaef566c1502e7b28c546e00d9f27d5e'],111,43,154,18366286,3,1,0.745454545,0,15448
53ec9ed432deb53aed64db8120db283a2235ad8c,1,Lisnichenko Dmitro,2014-08-20 17:18:02+03:00,['82fdc695706e13d1d1cc20f9ba9b266775222d58'],22,28,50,18366336,2,0,1,0,15448
93e61c0badb99995b7cbac5e8a6c159eab446735,1,Jonathan Hurley,2014-08-20 10:44:36-04:00,['84c4b434e73fcd8667d2b9c5133be7d2ff4c4454'],80,834,914,18367250,10,0.365030675,0.552147239,0.950920245,15450
9b6c02f6e2f7fa6a34457a4ebb39e20b38630e2f,1,Jonathan Hurley,2014-08-20 10:46:38-04:00,['93e61c0badb99995b7cbac5e8a6c159eab446735'],38,280,318,18367568,6,0.1796875,0.5078125,1,15450
8e48128648f0a74942b9e3bcc88261bd2728427e,1,Jonathan Hurley,2014-08-20 10:48:02-04:00,['9b6c02f6e2f7fa6a34457a4ebb39e20b38630e2f'],274,980,1254,18368822,17,0.308441558,0.922077922,0.931818182,15452
14e79ed1fbd6b2891e1b66163c61eb360a4c6c38,1,Jonathan Hurley,2014-08-20 10:50:58-04:00,['8e48128648f0a74942b9e3bcc88261bd2728427e'],1,2505,2506,18371328,27,0.682832948,0.76443418,0.649730562,15477
72ebd2633bb10b611978cedf81dc34eeb3c9f4eb,1,Jonathan Hurley,2014-08-20 10:52:41-04:00,['14e79ed1fbd6b2891e1b66163c61eb360a4c6c38'],238,374,612,18371940,15,0,0.6,0.8,15479
0ac9cb3facaff211c5c679d609f59aaca633d267,1,Jonathan Hurley,2014-08-20 10:54:28-04:00,['72ebd2633bb10b611978cedf81dc34eeb3c9f4eb'],65,626,691,18372631,14,0.14893617,0.75,0.957446809,15484
31f9ff8366823d3978535b6dbbd90a0f23a5c498,1,Jonathan Hurley,2014-08-20 11:03:03-04:00,['0ac9cb3facaff211c5c679d609f59aaca633d267'],162,212,374,18373005,2,0,0.709677419,1,15484
3b2bb3343ed36e34648b29648d339215cf89a22e,1,Alex Antonenko,2014-08-20 18:28:23+03:00,['53ec9ed432deb53aed64db8120db283a2235ad8c'],7,28,35,18373040,4,0.9,1,0.9,15484
85d181dd04da7fd19a8c06a9aa09b0dd291358b7,1,Aleksandr Kovalenko,2014-08-20 18:36:59+03:00,['3b2bb3343ed36e34648b29648d339215cf89a22e'],135,33,168,18373208,13,0,0,0,15484
490903a12816e1c6cd6bd085d8e736f4915ed797,1,atkach,2014-08-20 18:44:59+03:00,['85d181dd04da7fd19a8c06a9aa09b0dd291358b7'],42,53,95,18373303,1,1,1,1,15484
f588928175e6be6bd636755885db94e358735431,1,Nate Cole,2014-08-20 11:45:43-04:00,['31f9ff8366823d3978535b6dbbd90a0f23a5c498'],44,160,204,18373507,8,0.181818182,0.509090909,0.527272727,15485
3eddc800d4ab63be4b7edd945eb43ad8e11ac22d,1,Lisnichenko Dmitro,2014-08-20 18:58:32+03:00,['490903a12816e1c6cd6bd085d8e736f4915ed797'],0,20,20,18373527,1,,,,15485
221506eaa6f2ec17a46c1c786580c5da5ce80691,1,Aleksandr Kovalenko,2014-08-20 19:59:32+03:00,['3eddc800d4ab63be4b7edd945eb43ad8e11ac22d'],3,3,6,18373533,1,,,,15485
ad34ed971acd3e07f3f878fde623629e49189e81,1,Srimanth Gunturi,2014-08-20 10:01:03-07:00,['221506eaa6f2ec17a46c1c786580c5da5ce80691'],0,15,15,18373548,1,,,,15485
269c5cdaf6fa2708dec9b6b76f673a0422940463,1,Srimanth Gunturi,2014-08-20 10:37:20-07:00,['ad34ed971acd3e07f3f878fde623629e49189e81'],15,15,30,18373578,1,,,,15485
be99b295f9a9e6f2017c280a46ec9d54b9d1c671,0,Alex Antonenko,2014-08-20 20:44:46+03:00,['269c5cdaf6fa2708dec9b6b76f673a0422940463'],1,1,2,18373580,1,1,0,0,15485
9f7c878c91dcf26cf38548b2f4f4f2b3249fee56,1,Jaimin Jetly,2014-08-20 11:07:39-07:00,['be99b295f9a9e6f2017c280a46ec9d54b9d1c671'],19,5,24,18373604,2,1,0,0,15485
3107ac10fb09316f33c7a8a5d1046bc3bcf5fe4e,1,atkach,2014-08-20 21:20:53+03:00,['9f7c878c91dcf26cf38548b2f4f4f2b3249fee56'],88,1186,1274,18374878,10,0.840449438,1,0.98988764,15488
dd48a4c5253bba9be36cf3a86a22b27a14c9edde,0,Srimanth Gunturi,2014-08-20 11:31:41-07:00,['3107ac10fb09316f33c7a8a5d1046bc3bcf5fe4e'],19,25,44,18374922,2,0.5,1,0,15488
4b91492d28ab84b05a316afc9600e47a59b37206,1,Vitaly Brodetskyi,2014-08-20 22:12:25+03:00,['dd48a4c5253bba9be36cf3a86a22b27a14c9edde'],5,3,8,18374930,1,1,1,0,15488
22a6007e7118a5b9b6cfc5bab22073e423941ece,1,Mahadev Konar,2014-08-20 13:17:42-07:00,['4b91492d28ab84b05a316afc9600e47a59b37206'],22,58,80,18375010,5,0.147058824,0,0.882352941,15488
d436a843e680cd5e27c6f3cf60aaf1faa47cd2e0,1,Andrew Onishuk,2014-08-21 00:10:07+03:00,['22a6007e7118a5b9b6cfc5bab22073e423941ece'],6,66,72,18375082,3,,,,15488
6fddbb7aa0ccdb6130aec6ed71afb059e91af4ec,0,Andrew Onishuk,2014-08-21 00:12:50+03:00,['d436a843e680cd5e27c6f3cf60aaf1faa47cd2e0'],1,1,2,18375084,1,,,,15488
f6d7e8b3a930d1bed8843a4b439d9a6a912dd16f,1,Siddharth Wagle,2014-08-20 14:18:26-07:00,['6fddbb7aa0ccdb6130aec6ed71afb059e91af4ec'],94,150,244,18375328,7,0,0.095238095,0.857142857,15488
9fc23106fd86b052fb176247292232e887c762c4,0,Siddharth Wagle,2014-08-20 14:19:28-07:00,['f6d7e8b3a930d1bed8843a4b439d9a6a912dd16f'],0,1,1,18375329,1,,,,15488
62fb70e1504f333c303fb4770a581e21b46d10b5,0,Nate Cole,2014-08-20 17:36:05-04:00,['9fc23106fd86b052fb176247292232e887c762c4'],5,25,30,18375359,3,1,1,0.666666667,15488
48b61d0cc5c7ac927bcdd23ab2513d3e22f5ce57,1,Yusaku Sako,2014-08-20 15:00:19-07:00,['62fb70e1504f333c303fb4770a581e21b46d10b5'],213,160,373,18375732,16,0.395833333,0,0.40625,15488
5ed94d53a3c7444ae1dc8143137f1bc528c6fd3d,1,Mahadev Konar,2014-08-20 15:29:22-07:00,['48b61d0cc5c7ac927bcdd23ab2513d3e22f5ce57'],35,251,286,18376018,12,0.375838926,0.577181208,0.704697987,15488
664d53cc5715218a8bbc43416397a2997715a8ae,1,Alex Antonenko,2014-08-21 01:53:49+03:00,['5ed94d53a3c7444ae1dc8143137f1bc528c6fd3d'],3,10,13,18376031,1,1,1,1,15488
20519ec8578a816c7c395432299f17b2caab922f,1,Srimanth Gunturi,2014-08-20 15:56:19-07:00,['664d53cc5715218a8bbc43416397a2997715a8ae'],32,32,64,18376095,3,1,1,0,15488
b750cd8f22443cfb77e7849f6fe42dff400a6200,0,Yusaku Sako,2014-08-20 19:22:30-07:00,['20519ec8578a816c7c395432299f17b2caab922f'],119,209,328,18376423,13,0.818181818,0.484848485,0.742424242,15489
315bf96e2e216d60b3787dc87e393a478f0026b4,0,aBabiichuk,2014-08-21 12:41:23+03:00,['b750cd8f22443cfb77e7849f6fe42dff400a6200'],2,1,3,18376426,2,,,,15489
3a05d2ca1ec4a6f4bb74f53b2ffa4a06e39bb291,1,aBabiichuk,2014-08-21 12:42:53+03:00,['315bf96e2e216d60b3787dc87e393a478f0026b4'],13,50,63,18376489,1,0.95,1,1,15489
9434e18beea56f82a1c2c6d7220b714923e7c2c4,1,Lisnichenko Dmitro,2014-08-21 13:51:27+03:00,['3a05d2ca1ec4a6f4bb74f53b2ffa4a06e39bb291'],4,52,56,18376545,2,0.583333333,0.583333333,0.138888889,15489
9d4164c9cf24bf660a77964f91cb8249b6d1495c,1,Dmytro Sen,2014-08-21 14:42:59+03:00,['9434e18beea56f82a1c2c6d7220b714923e7c2c4'],4,3,7,18376552,4,0,0,0,15489
0883a75b279bb0df74f8729c42b9c7249f37aad3,1,Andrew Onishuk,2014-08-21 15:45:51+03:00,['9d4164c9cf24bf660a77964f91cb8249b6d1495c'],74,38,112,18376664,10,1,0.055555556,0.055555556,15489
d39b0e2cc3de8940d85b1467d68618b5f3886a0a,0,Andrew Onishuk,2014-08-21 15:46:24+03:00,['0883a75b279bb0df74f8729c42b9c7249f37aad3'],16,2,18,18376682,10,,,,15489
ce87ca7a606065268bd94408620c646820ecbfc4,1,Andrew Onishuk,2014-08-21 16:52:33+03:00,['d39b0e2cc3de8940d85b1467d68618b5f3886a0a'],28,95,123,18376805,5,0,1,0.307692308,15489
533d109c8595ec3b625be422a76c5e7d1ec7b1eb,1,Andrew Onishuk,2014-08-21 17:38:47+03:00,['ce87ca7a606065268bd94408620c646820ecbfc4'],123,85,208,18377013,14,0,0,0,15489
0822a54b268f3a87ca9161802fbb8aed87264483,1,Vitaly Brodetskyi,2014-08-21 17:28:48+03:00,['533d109c8595ec3b625be422a76c5e7d1ec7b1eb'],33,15,48,18377061,2,0.5,0,0,15489
8f02714e5bff2c943caa309f020d7060e509735e,1,Lisnichenko Dmitro,2014-08-21 20:14:31+03:00,['0822a54b268f3a87ca9161802fbb8aed87264483'],41,90,131,18377192,2,1,1,0.2,15489
0ea954d7b366e8b93d665f7135fb58fc8065490c,1,Siddharth Wagle,2014-08-21 10:30:11-07:00,['8f02714e5bff2c943caa309f020d7060e509735e'],26,18,44,18377236,1,1,1,0,15489
65417f715c39f36a5d24d7bcf6360af0bcc94fb0,1,Lisnichenko Dmitro,2014-08-21 20:44:12+03:00,['0ea954d7b366e8b93d665f7135fb58fc8065490c'],19,94,113,18377349,24,0,0.454545455,1,15489
f18937acfcf104bc59c801d38d60e266677877ea,1,Xi Wang,2014-08-21 11:01:38-07:00,['65417f715c39f36a5d24d7bcf6360af0bcc94fb0'],87,143,230,18377579,6,1,1,1,15489
3da10f6ef2ba674061094f2036cac1fa33017fb8,1,Jonathan Hurley,2014-08-21 14:38:18-04:00,['f588928175e6be6bd636755885db94e358735431'],76,1220,1296,18378875,24,0.220285261,0.386687797,1,15490
1fc24756668b2dbb467b5652b1291659958c763a,1,tbeerbower,2014-08-21 14:58:18-04:00,['f18937acfcf104bc59c801d38d60e266677877ea'],300,198,498,18379373,9,0.977272727,0.011363636,0,15490
9751b853856b8ad90391e24277a11c2f0d47c5b2,1,Srimanth Gunturi,2014-08-21 16:33:33-07:00,['1fc24756668b2dbb467b5652b1291659958c763a'],64,134,198,18379571,10,1,1,1,15490
8831f36c23c43c549afe2df2e42f4dbd20afb235,1,Yusaku Sako,2014-08-21 16:54:06-07:00,['9751b853856b8ad90391e24277a11c2f0d47c5b2'],3,2,5,18379576,1,,,,15490
fc600523a3842faad04b25fb2817638585d2fc18,0,Yusaku Sako,2014-08-21 17:03:10-07:00,['8831f36c23c43c549afe2df2e42f4dbd20afb235'],209,119,328,18379904,13,0.181818182,0.515151515,0.257575758,15490
7d0c7c2cf5a697684edfdabc8db2ac377affdab8,0,Yusaku Sako,2014-08-21 17:35:57-07:00,['fc600523a3842faad04b25fb2817638585d2fc18'],1,0,1,18379905,1,,,,15490
68a5d44f2f52bf78c32e9358b20a641d2ac6c9b4,0,atkach,2014-08-22 15:15:25+03:00,['7d0c7c2cf5a697684edfdabc8db2ac377affdab8'],1,1,2,18379907,1,,,,15490
30c9b334af9924de438ec994cc383eba8d4dec47,0,Andrew Onishuk,2014-08-22 15:45:04+03:00,['68a5d44f2f52bf78c32e9358b20a641d2ac6c9b4'],1,1,2,18379909,1,,,,15490
a533c1b4f35c94a28a291b493543b74aa7190aa2,0,Jonathan Hurley,2014-08-22 08:45:06-04:00,"['3da10f6ef2ba674061094f2036cac1fa33017fb8', '68a5d44f2f52bf78c32e9358b20a641d2ac6c9b4']",1692,3212,4904,18384813,170,,,,15490
f2d91b20fd61777b594311cbcf20343ee14b074e,0,Andrew Onishuk,2014-08-22 16:54:27+03:00,['30c9b334af9924de438ec994cc383eba8d4dec47'],233,110,343,18385156,6,1,0,0,15490
6480115d23d2e9a37958e6720bc7062afc0641a7,1,Nate Cole,2014-08-22 10:07:21-04:00,['a533c1b4f35c94a28a291b493543b74aa7190aa2'],97,314,411,18385567,13,0.2,0.483333333,0.9,15491
f69618fdf31113f4c228ed57ae9be44c636e82a0,0,Alex Antonenko,2014-08-22 17:20:33+03:00,['f2d91b20fd61777b594311cbcf20343ee14b074e'],0,1,1,18385568,1,1,1,1,15491
43d0bbc68fe15d55fd075812c30364fc5115dc25,1,Alex Antonenko,2014-08-22 17:26:16+03:00,['f69618fdf31113f4c228ed57ae9be44c636e82a0'],0,2,2,18385570,1,1,1,1,15491
9506a6b93de2f13d1a66d716cc9469ae4e3c36f9,1,Alex Antonenko,2014-08-22 19:03:23+03:00,['43d0bbc68fe15d55fd075812c30364fc5115dc25'],1,1,2,18385572,1,,,,15491
73819ca33f22556194bf59440403a35571a8ed18,1,Siddharth Wagle,2014-08-22 09:13:38-07:00,['9506a6b93de2f13d1a66d716cc9469ae4e3c36f9'],987,93,1080,18386652,29,0.801742919,0.261437908,0.037037037,15491
2ac6c726e148e0e541767200b85421886175bf17,1,Nate Cole,2014-08-22 13:50:15-04:00,['6480115d23d2e9a37958e6720bc7062afc0641a7'],25,33,58,18386710,1,0.25,0,1,15491
a1ab301185f40a9f3d01a062c9c1df4251e427e5,0,tbeerbower,2014-08-22 15:24:41-04:00,['73819ca33f22556194bf59440403a35571a8ed18'],110,233,343,18387053,6,0,1,1,15495
3b64d3f7c9c850492e99208f364d924051e72286,1,Yusaku Sako,2014-08-22 13:16:04-07:00,['a1ab301185f40a9f3d01a062c9c1df4251e427e5'],193,162,355,18387408,11,0.923076923,1,1,15495
100fb9c0aa215cb8ac1a7a0f56599f79e269c032,1,Jonathan Hurley,2014-08-22 16:21:58-04:00,['2ac6c726e148e0e541767200b85421886175bf17'],170,413,583,18387991,13,0.08,0.826666667,0.973333333,15496
7bb01940d7b0e6e4396f65c27f0c7a4f081c39d2,0,Nate Cole,2014-08-22 17:05:38-04:00,['100fb9c0aa215cb8ac1a7a0f56599f79e269c032'],1,1,2,18387993,1,,,,15496
cb1a5c0baa049d670215e76505dd661d105333bb,0,Yusaku Sako,2014-08-22 14:24:14-07:00,['3b64d3f7c9c850492e99208f364d924051e72286'],0,53,53,18388046,1,1,1,1,15497
6ca9fb864a5c8c8b94d72f82e7fdedde34e0d825,0,Yusaku Sako,2014-08-22 14:32:56-07:00,['cb1a5c0baa049d670215e76505dd661d105333bb'],53,0,53,18388099,1,0,0,0,15497
0e7a2679b84d3a15d054a0727abb3d75808eed8c,1,Yusaku Sako,2014-08-22 14:34:30-07:00,['6ca9fb864a5c8c8b94d72f82e7fdedde34e0d825'],76,209,285,18388384,12,0.885714286,0.6,0.838095238,15498
cc9ae3f6f05ebf933162c28c8ce9b11be9a3a94b,0,Mahadev Konar,2014-08-22 14:43:06-07:00,['0e7a2679b84d3a15d054a0727abb3d75808eed8c'],7,23,30,18388414,1,1,1,1,15498
bd2e516211a2bbe70aec479f34c41a39264c22ed,1,Srimanth Gunturi,2014-08-22 14:45:11-07:00,['cc9ae3f6f05ebf933162c28c8ce9b11be9a3a94b'],47,105,152,18388566,8,0,1,1,15499
e50da949adb26563d3efb413433d63dd0742ef6f,1,Yusaku Sako,2014-08-22 14:46:15-07:00,['bd2e516211a2bbe70aec479f34c41a39264c22ed'],5,11,16,18388582,3,0,0.8,1,15499
8b90264423602dd2347d7ff1dff2a912623353f1,0,Siddharth Wagle,2014-08-22 15:15:17-07:00,['e50da949adb26563d3efb413433d63dd0742ef6f'],0,1,1,18388583,1,,,,15499
ee275bf4d73823c2afc2f23dd49e3428be36e5ec,1,Jaimin Jetly,2014-08-22 16:40:25-07:00,['8b90264423602dd2347d7ff1dff2a912623353f1'],30,35,65,18388648,7,0.375,0.875,1,15499
66ce3ed8baaf1e939959809ffdd0b7f7e934ffbf,1,Siddharth Wagle,2014-08-22 16:59:58-07:00,['ee275bf4d73823c2afc2f23dd49e3428be36e5ec'],28,71,99,18388747,28,0,1,1,15499
a6febc087c530e822de3ab8f4ccd7f2aad79e1d4,1,Andrew Onishuk,2014-08-24 03:49:00+03:00,['66ce3ed8baaf1e939959809ffdd0b7f7e934ffbf'],232,152,384,18389131,6,1,0,0,15499
ebf47965b9312ace3c56adbf4416021e21f8cdcb,1,Mahadev Konar,2014-08-24 10:21:19-07:00,['a6febc087c530e822de3ab8f4ccd7f2aad79e1d4'],17,91,108,18389239,12,0.468085106,0.489361702,0.978723404,15499
3c13f40fa5fe120cd8b59deb8c7781f193c6e35b,1,tbeerbower,2014-08-24 20:26:43-04:00,['ebf47965b9312ace3c56adbf4416021e21f8cdcb'],43,402,445,18389684,10,0.469387755,0.928571429,0.918367347,15502
6ba11a2a94d1646a08bf49215e6776870302325e,0,Jonathan Hurley,2014-08-25 08:31:55-04:00,"['7bb01940d7b0e6e4396f65c27f0c7a4f081c39d2', '3c13f40fa5fe120cd8b59deb8c7781f193c6e35b']",1659,1352,3011,18392695,121,,,,15502
fefc129b1a50cdc0c8a07e37893a9b3f6ddda5b9,1,root,2014-08-25 17:49:16+00:00,['3c13f40fa5fe120cd8b59deb8c7781f193c6e35b'],277,791,1068,18393763,23,,,,15507
2fd25004b0c783b4838539b1a39862830b282b02,1,Siddharth Wagle,2014-08-25 11:02:15-07:00,['fefc129b1a50cdc0c8a07e37893a9b3f6ddda5b9'],128,69,197,18393960,11,0.764705882,0.823529412,0.941176471,15507
0c1bce053e99bc0de9bbda8ccabaa6c3d20e6c98,1,Yusaku Sako,2014-08-25 12:02:50-07:00,['2fd25004b0c783b4838539b1a39862830b282b02'],3,15,18,18393978,1,,,,15507
46a91dbb0bfacd5cda1f8a0713061b798eac5722,1,Xi Wang,2014-08-25 15:47:43-07:00,['0c1bce053e99bc0de9bbda8ccabaa6c3d20e6c98'],71,182,253,18394231,12,1,1,1,15507
fb1e0ca5260d35938df2c10cd75ee5a594873c30,1,Srimanth Gunturi,2014-08-25 16:57:54-07:00,['46a91dbb0bfacd5cda1f8a0713061b798eac5722'],37,728,765,18394996,14,0.324435318,0.671457906,0.367556468,15510
98660b9e3ee43ce3b2083f010ed55c556980527b,0,Srimanth Gunturi,2014-08-25 17:08:48-07:00,['fb1e0ca5260d35938df2c10cd75ee5a594873c30'],7,0,7,18395003,1,0,0,0.833333333,15510
336a63dac9436d35532135e1e719fa3f8b6ac12f,1,Srimanth Gunturi,2014-08-25 17:41:24-07:00,['98660b9e3ee43ce3b2083f010ed55c556980527b'],3,105,108,18395111,2,0,1,1,15511
a80066ae09dc3ccda574b014028a87136573a4c2,1,Srimanth Gunturi,2014-08-25 17:41:30-07:00,['336a63dac9436d35532135e1e719fa3f8b6ac12f'],57,194,251,18395362,9,0.1875,1,1,15514
160abc549c03cae1f34511582bc8a1cda467157b,1,Vitaly Brodetskyi,2014-08-26 13:49:22+03:00,['a80066ae09dc3ccda574b014028a87136573a4c2'],1,1,2,18395364,1,,,,15514
8bed25926031736ae6eed2f774e7996f230b5e13,0,tbeerbower,2014-08-26 08:28:45-04:00,['160abc549c03cae1f34511582bc8a1cda467157b'],4,8,12,18395376,1,0,0,0,15514
90940781212fbc8c87149bcad99d9292886d8d10,1,Andrew Onishuk,2014-08-26 15:34:16+03:00,['8bed25926031736ae6eed2f774e7996f230b5e13'],40,50,90,18395466,17,0,0.8,0,15514
574461df0847b83967ec64c429387fb4859eecd0,1,Oleg Nechiporenko,2014-08-26 16:25:07+03:00,['90940781212fbc8c87149bcad99d9292886d8d10'],64,23,87,18395553,4,1,0,0,15514
40f1c4e8f35bc718681d28a93ea021a412070206,0,Vitaly Brodetskyi,2014-08-26 16:40:14+03:00,['574461df0847b83967ec64c429387fb4859eecd0'],10,0,10,18395563,2,,,,15514
db83ea24ce47d84895c699137c6c2a9ade2f3577,1,aBabiichuk,2014-08-26 16:49:06+03:00,['40f1c4e8f35bc718681d28a93ea021a412070206'],6,2,8,18395571,4,0,0,0,15514
9faeaf5a525bfee0932c1a654b28651c0b1705dd,1,Lisnichenko Dmitro,2014-08-26 17:24:48+03:00,['db83ea24ce47d84895c699137c6c2a9ade2f3577'],203,381,584,18396155,26,0.251968504,0.968503937,1,15514
6d098ca8af8ba2244469a832b2ff4b1d64160760,1,atkach,2014-08-26 18:54:34+03:00,['9faeaf5a525bfee0932c1a654b28651c0b1705dd'],1,3,4,18396159,2,0,1,1,15514
d566bcaf6338803fb1a91762333c3b2aec23f1d0,1,tbeerbower,2014-08-26 12:24:40-04:00,['6d098ca8af8ba2244469a832b2ff4b1d64160760'],6,107,113,18396272,3,0,1,1,15514
2cceee2ea3933b05cef97e6d48f029dcebe9c200,1,Dmytro Sen,2014-08-26 20:10:18+03:00,['d566bcaf6338803fb1a91762333c3b2aec23f1d0'],195,293,488,18396760,20,0,0,0.364864865,15514
6237724d4f5cb02bd1541deba6542a72be04af2a,1,John Speidel,2014-08-26 14:04:53-04:00,['2cceee2ea3933b05cef97e6d48f029dcebe9c200'],28,584,612,18397372,4,0.044736842,0.878947368,0.947368421,15514
e984e9b844721efd8eef8ddf781c9ff74486d85c,0,Siddharth Wagle,2014-08-26 11:22:01-07:00,['6237724d4f5cb02bd1541deba6542a72be04af2a'],0,1,1,18397373,1,,,,15514
fb9d884be4ea4257831d591cd0e4f19c87321e69,1,Lisnichenko Dmitro,2014-08-26 21:26:28+03:00,['e984e9b844721efd8eef8ddf781c9ff74486d85c'],1,10,11,18397384,1,,,,15514
02ee3d440596c3e159985830ede4f6fe358a576b,1,Jaimin Jetly,2014-08-26 12:40:53-07:00,['fb9d884be4ea4257831d591cd0e4f19c87321e69'],87,312,399,18397783,54,0.659090909,0.75,1,15514
f8193e941f22bac6bbc64a141613d8f8bf90633b,0,Srimanth Gunturi,2014-08-26 13:11:53-07:00,['02ee3d440596c3e159985830ede4f6fe358a576b'],1,1,2,18397785,1,,,,15514
1ab3bb551d3e122fe1a771b98aaffe0e52434f40,1,Xi Wang,2014-08-26 16:24:39-07:00,['f8193e941f22bac6bbc64a141613d8f8bf90633b'],9,13,22,18397807,5,1,1,1,15514
0e9c744f21a7b8aaada917eafbf3fbbed1a87edc,1,Jonathan Hurley,2014-08-26 19:51:38-04:00,['1ab3bb551d3e122fe1a771b98aaffe0e52434f40'],23,60,83,18397890,7,0.923076923,0.769230769,1,15514
a8e6736ac536f08e86503d037446a4d793db1029,1,Mahadev Konar,2014-08-26 17:30:30-07:00,['0e9c744f21a7b8aaada917eafbf3fbbed1a87edc'],66,214,280,18398170,15,0.383838384,0.838383838,0.98989899,15514
2dc55f08fe7b1660122145853ede4d7a04c014a8,1,Xi Wang,2014-08-26 17:48:46-07:00,['a8e6736ac536f08e86503d037446a4d793db1029'],7,28,35,18398205,2,1,1,1,15514
926acf4fc681e01f1568f6c3bdbf4ab254040b07,1,Vitaly Brodetskyi,2014-08-27 13:29:39+03:00,['2dc55f08fe7b1660122145853ede4d7a04c014a8'],17,22,39,18398244,6,0,0.2,0,15514
4430ebf070ddef99bcb5ba610e13d5f39f5cd910,1,aBabiichuk,2014-08-27 14:34:22+03:00,['926acf4fc681e01f1568f6c3bdbf4ab254040b07'],13,8,21,18398265,2,0,0,0,15514
8d8583bd5b7191af8e500cad3ba507817ecee011,1,aBabiichuk,2014-08-27 14:34:23+03:00,['4430ebf070ddef99bcb5ba610e13d5f39f5cd910'],1,6,7,18398272,1,,,,15514
1f48b24feae75f35a0ea6f10dcf61332934b8534,0,aBabiichuk,2014-08-27 14:59:38+03:00,['8d8583bd5b7191af8e500cad3ba507817ecee011'],0,1,1,18398273,1,,,,15514
a82633457b56667238d1824b6d901b1a85b530ca,1,atkach,2014-08-27 15:01:58+03:00,['1f48b24feae75f35a0ea6f10dcf61332934b8534'],57,969,1026,18399299,8,0.620873269,1,1,15515
4a4644b882c9a0d39b249db5a106f7075cb0c93d,1,Jonathan Hurley,2014-08-27 08:51:49-04:00,['6ba11a2a94d1646a08bf49215e6776870302325e'],176,2045,2221,18401520,24,0.460674157,0.887640449,0.891853933,15526
61695fa43735b12a08b15af9504210ac6c9a0bf2,1,Aleksandr Kovalenko,2014-08-27 15:55:38+03:00,['a82633457b56667238d1824b6d901b1a85b530ca'],59,111,170,18401690,7,0.541666667,0,1,15526
c79fad2501a024379d409cb911e6ea72c8574ee5,1,aBabiichuk,2014-08-27 16:03:39+03:00,['61695fa43735b12a08b15af9504210ac6c9a0bf2'],4,8,12,18401702,1,1,1,1,15526
ae8f1e77eafe32c2ad8bded7da24a2cef07b605f,0,Jonathan Hurley,2014-08-27 10:04:14-04:00,"['4a4644b882c9a0d39b249db5a106f7075cb0c93d', 'a82633457b56667238d1824b6d901b1a85b530ca']",1371,5132,6503,18408205,215,,,,15526
eb08925ca4290ad26e90a5f353d97f1aed298422,1,Alex Antonenko,2014-08-27 17:39:02+03:00,['c79fad2501a024379d409cb911e6ea72c8574ee5'],10,122,132,18408337,5,1,1,1,15528
5e3c95fe4efb1efc8cf653f55e2d677208552cd5,1,Oleg Nechiporenko,2014-08-27 17:39:29+03:00,['c79fad2501a024379d409cb911e6ea72c8574ee5'],17,7,24,18408361,5,0,0,0,15528
940abdc4a232c1c354ec3eff17abed89c224c161,0,Oleg Nechiporenko,2014-08-27 17:41:40+03:00,"['5e3c95fe4efb1efc8cf653f55e2d677208552cd5', 'eb08925ca4290ad26e90a5f353d97f1aed298422']",10,122,132,18408493,5,,,,15528
9385d47ab0f09e61e861f6d00a640c94488d385f,0,Aleksandr Kovalenko,2014-08-27 18:06:34+03:00,['940abdc4a232c1c354ec3eff17abed89c224c161'],0,6,6,18408499,1,,,,15528
af1db65118e91792b44eee882fc8eea0fef887a9,1,Andrew Onishuk,2014-08-27 19:33:07+03:00,['9385d47ab0f09e61e861f6d00a640c94488d385f'],3,3,6,18408505,2,,,,15528
8ca145bbda6134f0541c9f14ff7d99a0d3ac081e,1,tbeerbower,2014-08-27 12:45:33-04:00,['af1db65118e91792b44eee882fc8eea0fef887a9'],5,103,108,18408613,4,0.027027027,1,0.72972973,15528
e20f15b61e2d29321537602a4fed24b19db48fdd,1,Vitaly Brodetskyi,2014-08-27 20:56:33+03:00,['8ca145bbda6134f0541c9f14ff7d99a0d3ac081e'],18,18,36,18408649,13,,,,15528
b267bd82817ede48b73c98274f0c4d19ee2a90a4,1,Xi Wang,2014-08-27 11:10:16-07:00,['e20f15b61e2d29321537602a4fed24b19db48fdd'],13,13,26,18408675,5,,,,15528
f6ee0747c1fa2750f0eb5c6822d5023e489d8b91,1,Jaimin Jetly,2014-08-27 13:37:18-07:00,['b267bd82817ede48b73c98274f0c4d19ee2a90a4'],61,115,176,18408851,5,1,1,1,15528
40e3f0fc5d34b4d96a95e0e568e8754b042dc6f5,0,Srimanth Gunturi,2014-08-27 13:45:36-07:00,['f6ee0747c1fa2750f0eb5c6822d5023e489d8b91'],4,196,200,18409051,8,0.268518519,1,0.731481481,15531
e007d7f4fac0bbef2e753e7004e368a0f6329212,0,Srimanth Gunturi,2014-08-27 13:51:39-07:00,['40e3f0fc5d34b4d96a95e0e568e8754b042dc6f5'],32,60,92,18409143,2,0.25,1,0.916666667,15531
966fff415353beff39a4c4cc72ae38b5974ffaa5,0,Srimanth Gunturi,2014-08-27 14:14:53-07:00,['e007d7f4fac0bbef2e753e7004e368a0f6329212'],2,2,4,18409147,1,,,,15531
f23e09de6c9aad0523c3fa77e2eaf7bfda72a5cc,0,Srimanth Gunturi,2014-08-27 14:38:06-07:00,['966fff415353beff39a4c4cc72ae38b5974ffaa5'],6,6,12,18409159,3,,,,15531
f77e9e818614582d9fbcead4fa781076388b3358,1,Xi Wang,2014-08-27 15:05:57-07:00,['f23e09de6c9aad0523c3fa77e2eaf7bfda72a5cc'],37,24,61,18409220,5,0,0,0.666666667,15531
debf29c23365c0826902f699a3f3cc9e23dc76a6,0,Jaimin Jetly,2014-08-27 15:41:52-07:00,['f77e9e818614582d9fbcead4fa781076388b3358'],14,1,15,18409235,1,1,1,0,15531
4c5ed4c0cf7eb305fcdfbfd110476a015afbd5e1,0,Yusaku Sako,2014-08-27 15:44:18-07:00,['debf29c23365c0826902f699a3f3cc9e23dc76a6'],196,4,200,18409435,8,0.731481481,0,0.268518519,15531
9dcb434eab370bafc3410e9fd80d8bef33008cb6,1,Alex Antonenko,2014-08-28 01:49:20+03:00,['4c5ed4c0cf7eb305fcdfbfd110476a015afbd5e1'],4,89,93,18409528,5,1,0.914285714,1,15531
fc626c99cf579a37b1e1c8aad4690ceffc02c1e2,0,Yusaku Sako,2014-08-27 16:00:26-07:00,['9dcb434eab370bafc3410e9fd80d8bef33008cb6'],6,6,12,18409540,3,,,,15531
fdb54a10f7f22dac46e3fcd4aaa6deba0c262916,1,Yusaku Sako,2014-08-27 16:00:38-07:00,['fc626c99cf579a37b1e1c8aad4690ceffc02c1e2'],2,2,4,18409544,1,,,,15531
51215cc36e680b6b0cb1ae318901c7ed78930134,0,Yusaku Sako,2014-08-27 16:03:09-07:00,['fdb54a10f7f22dac46e3fcd4aaa6deba0c262916'],60,32,92,18409636,2,0.75,0,0.083333333,15531
39c7ae74bc9c1b3983a61c032f5c1ca745c9f48c,1,Jaimin Jetly,2014-08-27 16:49:39-07:00,['51215cc36e680b6b0cb1ae318901c7ed78930134'],10,9,19,18409655,1,,,,15531
d87cf7f8d0fee68210296085954a7a1e6ce484c4,1,Srimanth Gunturi,2014-08-27 18:04:00-07:00,['39c7ae74bc9c1b3983a61c032f5c1ca745c9f48c'],4,218,222,18409877,9,0.268518519,1,0.731481481,15534
fa10e3bff6f18aeee1d93eecf1f15ad0d7657235,1,Srimanth Gunturi,2014-08-27 18:31:29-07:00,['d87cf7f8d0fee68210296085954a7a1e6ce484c4'],39,67,106,18409983,3,0.25,1,0.916666667,15534
94ca14a559ddd9eab59bc2db138dd2005dfffeec,1,Srimanth Gunturi,2014-08-27 18:39:43-07:00,['fa10e3bff6f18aeee1d93eecf1f15ad0d7657235'],2,2,4,18409987,1,,,,15534
2051c64e7eec7e5d941cf48d911cf2bbc515db7b,0,Srimanth Gunturi,2014-08-27 18:41:44-07:00,['94ca14a559ddd9eab59bc2db138dd2005dfffeec'],6,6,12,18409999,3,,,,15534
e1634809f0c4c6a6acfe1b2672b4ddfcaf2d5e92,0,Yusaku Sako,2014-08-27 23:09:59-07:00,['2051c64e7eec7e5d941cf48d911cf2bbc515db7b'],44,0,44,18410043,1,0,0.195121951,0,15534
af67390b9ca47bd6b34a54638c9f5cc8323017fd,0,Yusaku Sako,2014-08-27 23:56:32-07:00,['e1634809f0c4c6a6acfe1b2672b4ddfcaf2d5e92'],0,44,44,18410087,1,1,0.804878049,1,15534
cd0081c55f53f87076c191f21648f9f6477119e7,0,Yusaku Sako,2014-08-27 23:59:35-07:00,['af67390b9ca47bd6b34a54638c9f5cc8323017fd'],44,0,44,18410131,1,0,0.195121951,0,15534
b35b87d6f70d5b2cca7501826096f5840b9fc9eb,0,aBabiichuk,2014-08-28 12:50:15+03:00,['cd0081c55f53f87076c191f21648f9f6477119e7'],1,0,1,18410132,1,0,0,0,15534
6bcd6d55c980f13e56ae9ddc8d4ab15371893d98,1,atkach,2014-08-28 14:17:32+03:00,['b35b87d6f70d5b2cca7501826096f5840b9fc9eb'],66,131,197,18410329,7,0,0,1,15534
0fb6e635577aab62157711f1a73c65feb38018c2,1,Oleg Nechiporenko,2014-08-28 16:26:23+03:00,['6bcd6d55c980f13e56ae9ddc8d4ab15371893d98'],26,207,233,18410562,7,1,0.8,1,15534
ff27e56fe8a983c76c40951472575197117b5914,1,Oleg Nechiporenko,2014-08-28 16:34:13+03:00,['0fb6e635577aab62157711f1a73c65feb38018c2'],3,35,38,18410600,4,1,1,1,15534
fb8367080acd88d311ced9de903bbb1ba9452254,0,Subin,2014-08-28 13:36:24+00:00,['ff27e56fe8a983c76c40951472575197117b5914'],365,41,406,18411006,10,1,1,1,15534
76fc94ec1ab6ee904e0efa254c19521a201c06d4,1,Jonathan Hurley,2014-08-28 09:38:28-04:00,['ae8f1e77eafe32c2ad8bded7da24a2cef07b605f'],146,773,919,18411925,15,0.46366782,0.730103806,0.923875433,15535
6b7e796ab162aeb7915539b0e37ca740335366f8,1,Oleg Nechiporenko,2014-08-28 17:00:08+03:00,['fb8367080acd88d311ced9de903bbb1ba9452254'],217,344,561,18412486,7,0.136363636,1,0.920454545,15535
1b017b7cd4b4f8fbd89beaf7b1adf8bf9eaac3a2,1,Andrew Onishuk,2014-08-28 18:05:09+03:00,['6b7e796ab162aeb7915539b0e37ca740335366f8'],6,11,17,18412503,2,1,1,1,15535
6bd0394a5f2254da2421f066473f680dc32772a1,1,Andrew Onishuk,2014-08-28 18:05:43+03:00,['1b017b7cd4b4f8fbd89beaf7b1adf8bf9eaac3a2'],49,892,941,18413444,26,0.54519774,0.875706215,0.694915254,15542
f2f5dff25143545c6ab542ab0d62c7fc61ea418a,1,Aleksandr Kovalenko,2014-08-28 18:09:43+03:00,['6bd0394a5f2254da2421f066473f680dc32772a1'],16,36,52,18413496,6,1,1,1,15542
9f6b7b3867bcf6fe6a07404c84846250a56924eb,0,Oleg Nechiporenko,2014-08-28 19:01:34+03:00,['6b7e796ab162aeb7915539b0e37ca740335366f8'],0,4,4,18413500,1,0,0,1,15542
c4f1e16a74f6afb1d5b9fb12f7257ad2bb554edb,0,Oleg Nechiporenko,2014-08-28 19:05:02+03:00,"['9f6b7b3867bcf6fe6a07404c84846250a56924eb', 'f2f5dff25143545c6ab542ab0d62c7fc61ea418a']",71,939,1010,18414510,34,,,,15542
86d4083972567347c0092288e9a131d4e9a7e705,1,atkach,2014-08-28 19:27:32+03:00,['c4f1e16a74f6afb1d5b9fb12f7257ad2bb554edb'],7,28,35,18414545,4,1,0.5,1,15542
d1bdc818e5d4c481d43955bcd7f4ece253b15eb5,1,Lisnichenko Dmitro,2014-08-28 20:34:34+03:00,['86d4083972567347c0092288e9a131d4e9a7e705'],31,35,66,18414611,14,0,0,1,15542
869b00c61c86037e2514946f288b311b78dbcee8,1,Xi Wang,2014-08-28 10:41:36-07:00,['d1bdc818e5d4c481d43955bcd7f4ece253b15eb5'],14,34,48,18414659,5,0.333333333,0.333333333,1,15542
52d1af7634e4a13ea4f9b94e34a1734c2bcd416c,0,Jonathan Hurley,2014-08-28 13:49:15-04:00,"['76fc94ec1ab6ee904e0efa254c19521a201c06d4', '869b00c61c86037e2514946f288b311b78dbcee8']",1072,2641,3713,18418372,139,,,,15542
663e0d6f087b5a8ed912712d642d1b8fdd04c50a,1,Xi Wang,2014-08-28 18:04:29-07:00,['869b00c61c86037e2514946f288b311b78dbcee8'],6,44,50,18418422,9,1,1,1,15542
33819037526678797645a626950051a54a6bcfc5,1,Yusaku Sako,2014-08-28 20:41:31-07:00,['663e0d6f087b5a8ed912712d642d1b8fdd04c50a'],11,49,60,18418482,8,0.785714286,1,0.785714286,15542
4a61ae33b42aa1f530768fb4dc70f41de92f07d2,1,Dmytro Sen,2014-08-29 12:27:03+03:00,['33819037526678797645a626950051a54a6bcfc5'],4,44,48,18418530,3,0,0.904761905,1,15542
60c0d169b9b868266f911efb05677a2ba84314c5,1,atkach,2014-08-29 13:11:40+03:00,['4a61ae33b42aa1f530768fb4dc70f41de92f07d2'],6,8,14,18418544,2,1,1,1,15542
ccdb670c8b739fb604ec04cec941d6e146f41577,1,atkach,2014-08-29 14:28:02+03:00,['60c0d169b9b868266f911efb05677a2ba84314c5'],67,29,96,18418640,2,0,0,0.21875,15542
248bd72a37d3108fb62b87d3b49cca10fc67587b,1,Andrew Onishuk,2014-08-29 14:43:37+03:00,['ccdb670c8b739fb604ec04cec941d6e146f41577'],4,19,23,18418663,5,1,1,1,15542
c967511f7a037468c66c682acda2cdb089e077df,1,Oleg Nechiporenko,2014-08-29 15:22:39+03:00,['248bd72a37d3108fb62b87d3b49cca10fc67587b'],2,255,257,18418920,4,0.476470588,0.635294118,0.982352941,15543
c485326e9b323b467a383dae3aac93c5d33ab47e,0,Aleksandr Kovalenko,2014-08-29 15:43:50+03:00,['c967511f7a037468c66c682acda2cdb089e077df'],1,3,4,18418924,1,1,1,1,15543
b22ce6c33cad85fcb40b4337b60105391f3b1bef,1,Lisnichenko Dmitro,2014-08-29 15:49:57+03:00,['c485326e9b323b467a383dae3aac93c5d33ab47e'],47,78,125,18419049,7,0,0.888888889,1,15543
74800962898820f9669feb02adc51f7dbb89be87,1,atkach,2014-08-29 15:51:44+03:00,['b22ce6c33cad85fcb40b4337b60105391f3b1bef'],1,5,6,18419055,3,0,1,1,15543
7ec3d3ba4714c1612474befecd305e1caefa7d80,0,Aleksandr Kovalenko,2014-08-29 17:24:06+03:00,['74800962898820f9669feb02adc51f7dbb89be87'],5,3,8,18419063,2,,,,15543
1d8e5497fbb7df4da22650e654abbb74be2313cc,1,aBabiichuk,2014-08-29 17:38:07+03:00,['7ec3d3ba4714c1612474befecd305e1caefa7d80'],6,93,99,18419162,13,1,0.94,0.92,15546
7f889c5a79c26ea9dc28e09d6e6e154d4af08680,1,Aleksandr Kovalenko,2014-08-29 18:37:28+03:00,['1d8e5497fbb7df4da22650e654abbb74be2313cc'],4,47,51,18419213,3,0,0,0,15547
85ccaede3603382f72daa03ed135e0454e591e04,1,Aleksandr Kovalenko,2014-08-29 19:52:01+03:00,['7f889c5a79c26ea9dc28e09d6e6e154d4af08680'],25,76,101,18419314,6,1,1,1,15548
9c281087d096a48695d4382a4e863c24a50b2699,1,Myroslav Papirkovskyy,2014-08-29 20:16:43+03:00,['85ccaede3603382f72daa03ed135e0454e591e04'],55,174,229,18419543,6,0.228571429,1,1,15548
030413409eeabab60bca88dc367e08e895383cc4,1,Myroslav Papirkovskyy,2014-08-29 20:16:43+03:00,['9c281087d096a48695d4382a4e863c24a50b2699'],1,9,10,18419553,2,0,0,0,15548
99319de44248e59463560179db608e798ddc360d,0,Myroslav Papirkovskyy,2014-08-29 20:45:00+03:00,['030413409eeabab60bca88dc367e08e895383cc4'],8,0,8,18419561,1,1,0,0,15548
45ecfc8dd45ce3fe116699c10806d32ba0e8ce5e,1,Alex Antonenko,2014-08-29 21:38:29+03:00,['99319de44248e59463560179db608e798ddc360d'],13,151,164,18419725,8,1,1,1,15550
72fe79c87da9260f398e787b0ecb1d2e0d7f2685,1,Jaimin Jetly,2014-08-29 12:37:42-07:00,['45ecfc8dd45ce3fe116699c10806d32ba0e8ce5e'],189,192,381,18420106,13,0.469387755,0.489795918,0,15550
7dcdeef9b0a8487c92f793b7baa6f52346b1345b,1,Xi Wang,2014-08-29 13:57:15-07:00,['72fe79c87da9260f398e787b0ecb1d2e0d7f2685'],17,68,85,18420191,1,0.902439024,1,1,15550
fa7341fe4699fac64af861d52f1b6332175c4514,1,Xi Wang,2014-08-29 13:57:15-07:00,['7dcdeef9b0a8487c92f793b7baa6f52346b1345b'],8,11,19,18420210,4,1,1,1,15550
1af0a44173d65690804be0aeda746c7ee4088877,1,Xi Wang,2014-08-29 14:58:52-07:00,['fa7341fe4699fac64af861d52f1b6332175c4514'],12,12,24,18420234,2,,,,15550
733f0345c5b726a5a4164214e740102ba8d7a8d1,1,Yusaku Sako,2014-08-29 16:39:44-07:00,['1af0a44173d65690804be0aeda746c7ee4088877'],43,1719,1762,18421996,21,,,,15560
5ceeeb52b9478ad5af86d4346a5d5bb7050462e9,0,Yusaku Sako,2014-08-29 17:14:42-07:00,['733f0345c5b726a5a4164214e740102ba8d7a8d1'],78,408,486,18422482,8,0.438596491,1,0.824561404,15564
b6ff0234748ce3d075fc5ab886028b7fa1d6c76e,1,Xi Wang,2014-08-29 17:34:07-07:00,['5ceeeb52b9478ad5af86d4346a5d5bb7050462e9'],8,10,18,18422500,4,1,1,1,15564
b09e159322a403c4067ad62dbf1ca9a00e9034e2,1,tbeerbower,2014-08-29 20:35:15-04:00,['b6ff0234748ce3d075fc5ab886028b7fa1d6c76e'],22,108,130,18422630,2,0.023255814,0.744186047,0.790697674,15564
2f5c78e7f90f575ab2c469da1095eaa5d252d872,1,Jonathan Hurley,2014-08-31 08:25:14-04:00,['52d1af7634e4a13ea4f9b94e34a1734c2bcd416c'],64,249,313,18422943,7,0.145631068,0.669902913,0.912621359,15564
7d25cb89ad67df9e7aaf759377633ab85f1410e2,1,Vitaly Brodetskyi,2014-09-01 11:54:27+03:00,['b09e159322a403c4067ad62dbf1ca9a00e9034e2'],7,7,14,18422957,1,,,,15564
866f5b20fdb71cb18a5fbcf4207accafd69b0f22,1,Oleg Nechiporenko,2014-09-01 13:57:43+03:00,['7d25cb89ad67df9e7aaf759377633ab85f1410e2'],38,351,389,18423346,3,0.795652174,1,1,15564
c13730a065646ba404c91f0f06819c71d669ebe7,0,Jonathan Hurley,2014-09-01 07:39:49-04:00,"['2f5c78e7f90f575ab2c469da1095eaa5d252d872', '866f5b20fdb71cb18a5fbcf4207accafd69b0f22']",673,3958,4631,18427977,118,,,,15564
f04ba443c60b279f526dc908b21b19847e294f27,1,aBabiichuk,2014-09-01 14:46:18+03:00,['866f5b20fdb71cb18a5fbcf4207accafd69b0f22'],12,39,51,18428028,5,1,1,1,15564
bd60b32e9c1dd7ca44c402dd15105b9b54e2d461,1,Andrew Onishuk,2014-09-01 14:47:47+03:00,['f04ba443c60b279f526dc908b21b19847e294f27'],42,3047,3089,18431117,23,1,1,0,15568
b21759ea422a457e49fc5b0efaf5905deabe4226,0,Dmytro Sen,2014-09-01 14:56:22+03:00,['bd60b32e9c1dd7ca44c402dd15105b9b54e2d461'],2,25,27,18431144,3,0,0.9375,1,15568
ad1d6a3647b10068794471d3a9c28f8b82faffb1,1,atkach,2014-09-01 15:52:16+03:00,['b21759ea422a457e49fc5b0efaf5905deabe4226'],8,22,30,18431174,2,1,1,1,15568
a41ef2a1c01b978751cca6734a0fd6f4649e092e,1,Aleksandr Kovalenko,2014-09-01 16:27:36+03:00,['ad1d6a3647b10068794471d3a9c28f8b82faffb1'],210,600,810,18431984,3,0,0,0,15568
b6b1bf3ae8f9c51db025b5db11f5f1b850367626,0,Vitaly Brodetskyi,2014-09-01 17:07:39+03:00,['a41ef2a1c01b978751cca6734a0fd6f4649e092e'],12,0,12,18431996,2,,,,15568
0ce22ed6c04ff7dae56ae15fe8b28239b6575b92,0,Andrew Onishuk,2014-09-01 18:04:06+03:00,['b6b1bf3ae8f9c51db025b5db11f5f1b850367626'],1,0,1,18431997,1,,,,15568
4a7e06ada1def8ea3b6909cc7cab1ea195cbe936,0,Dmytro Sen,2014-09-01 18:04:32+03:00,['0ce22ed6c04ff7dae56ae15fe8b28239b6575b92'],0,4,4,18432001,1,,,,15568
c59fc3d2d412598c13416ad569577c1e6c0c72ec,1,atkach,2014-09-01 18:29:07+03:00,['4a7e06ada1def8ea3b6909cc7cab1ea195cbe936'],4,21,25,18432026,2,,,,15568
fa507bfd02e8125b8d060f63bc8f3da1586a1759,1,Aleksandr Kovalenko,2014-09-01 18:54:50+03:00,['c59fc3d2d412598c13416ad569577c1e6c0c72ec'],9,23,32,18432058,2,1,1,1,15568
4a0a0edf6ca02ead0a7fc7b5ff22e9fd6d7b98e4,1,Alex Antonenko,2014-09-01 19:12:16+03:00,['fa507bfd02e8125b8d060f63bc8f3da1586a1759'],2,2,4,18432062,1,,,,15568
17e989029529eff80f8c78b1de3695f6c34c481d,1,Oleg Nechiporenko,2014-09-03 15:09:12+03:00,['ca2106fd9ce077f2c77ade507fc4cad64f8921dc'],34,51,85,18432147,6,1,1,1,15568
b0ef8bfee0735f6231a877cdf4aaf94d6f515ee3,1,aBabiichuk,2014-09-03 17:00:18+03:00,['17e989029529eff80f8c78b1de3695f6c34c481d'],15,12,27,18432174,1,0,0,0,15568
d341f7ceb3d05773917d0fcfea5d1d95548b2878,1,Oleg Nechiporenko,2014-09-03 17:57:44+03:00,['b0ef8bfee0735f6231a877cdf4aaf94d6f515ee3'],0,44,44,18432218,3,1,1,1,15569
df34b3a7a707cdb4e1ab6838971441425bd1fa22,1,Lisnichenko Dmitro,2014-09-03 18:18:06+03:00,['d341f7ceb3d05773917d0fcfea5d1d95548b2878'],149,148,297,18432515,63,0,0,0,15569
c76d1ef462ce9c6f7f2d16d8996ff01127dde4f2,1,Andrew Onishuk,2014-09-03 18:26:47+03:00,['df34b3a7a707cdb4e1ab6838971441425bd1fa22'],88,102,190,18432705,4,0,1,1,15569
f1e26f1c59c261d2b5ae3a613ec6dbc3f019298f,1,atkach,2014-09-03 18:27:28+03:00,['c76d1ef462ce9c6f7f2d16d8996ff01127dde4f2'],11,18,29,18432734,5,1,1,0.5,15569
6e917d1f43b6b500f0de0b040d6009f89005a27d,0,atkach,2014-09-03 19:09:28+03:00,['f1e26f1c59c261d2b5ae3a613ec6dbc3f019298f'],2,2,4,18432738,1,,,,15569
baa390918f0db37ac0b4eb2137c6fbfa46a8a563,0,Yusaku Sako,2014-09-03 09:27:31-07:00,['6e917d1f43b6b500f0de0b040d6009f89005a27d'],73,0,73,18432811,4,0.218181818,0,0,15569
ba479a20d80c189448958a3a10576f21954422e9,0,Yusaku Sako,2014-09-03 09:53:58-07:00,['baa390918f0db37ac0b4eb2137c6fbfa46a8a563'],1,0,1,18432812,1,1,0,0,15569
e1f5afe441dfc385bbe5615c3090fc90e8a9650e,1,root,2014-09-02 05:10:07-04:00,['ba479a20d80c189448958a3a10576f21954422e9'],1,45,46,18432858,3,,,,15570
b6abb3d19ab0b305fd3a4b501618de5c275a0d18,0,Oleg Nechiporenko,2014-09-02 14:13:59+03:00,['4a0a0edf6ca02ead0a7fc7b5ff22e9fd6d7b98e4'],2,5,7,18432865,1,1,1,1,15570
7a0f5091784d80b3ea3da535534850f8b6be5201,0,Jonathan Hurley,2014-09-02 08:12:12-04:00,"['c13730a065646ba404c91f0f06819c71d669ebe7', 'b6abb3d19ab0b305fd3a4b501618de5c275a0d18']",304,3788,4092,18436957,43,,,,15570
6738d3d346f4b5af4a1084e880907ba3bf19dffc,1,atkach,2014-09-02 15:28:52+03:00,['b6abb3d19ab0b305fd3a4b501618de5c275a0d18'],273,1639,1912,18438869,12,0,0,1,15574
f853f1c76e2f4af5936f935735a7660010eccf0b,1,aBabiichuk,2014-09-02 16:09:50+03:00,['6738d3d346f4b5af4a1084e880907ba3bf19dffc'],37,37,74,18438943,4,1,0,0,15574
9571ac8d530ee9faff884ff72bc5578911f4e104,0,aBabiichuk,2014-09-02 16:28:08+03:00,['f853f1c76e2f4af5936f935735a7660010eccf0b'],4,0,4,18438947,1,,,,15574
c0f5f01da4f53af15e754fb37c1ba0005984bb15,1,Oleg Nechiporenko,2014-09-02 16:52:32+03:00,['9571ac8d530ee9faff884ff72bc5578911f4e104'],33,22,55,18439002,4,1,0,0,15574
33335cef438369a40c4486ad2b76180676a2dd58,1,Vitaly Brodetskyi,2014-09-02 17:26:53+03:00,['c0f5f01da4f53af15e754fb37c1ba0005984bb15'],0,12,12,18439014,2,,,,15574
39f2a49bbe8047746557afeee5b2abb7073bf17d,1,aBabiichuk,2014-09-03 20:32:58+03:00,['e1f5afe441dfc385bbe5615c3090fc90e8a9650e'],2,3,5,18439019,3,1,1,1,15574
2d99741ab3e975e2d766c9e4a19beb2a9e72b577,1,Vitaly Brodetskyi,2014-09-03 20:48:36+03:00,['39f2a49bbe8047746557afeee5b2abb7073bf17d'],0,46,46,18439065,2,0,1,1,15574
7c3ea59fc05db44f9f8a3aebc3e370918fa53e60,0,Andrew Onishuk,2014-09-03 21:19:09+03:00,['2d99741ab3e975e2d766c9e4a19beb2a9e72b577'],361,361,722,18439787,127,,,,15575
03684175c8f75944de50c6975c6e89596e009c30,1,Xi Wang,2014-09-03 11:21:16-07:00,['7c3ea59fc05db44f9f8a3aebc3e370918fa53e60'],7,23,30,18439817,3,1,1,1,15575
ef2426271472b11bbfabdb70a088aa80b469e890,1,Xi Wang,2014-09-03 11:21:16-07:00,['03684175c8f75944de50c6975c6e89596e009c30'],13,23,36,18439853,5,,,,15575
5c0ef4f62dd734bbcab3016c555da431970d1773,1,Lisnichenko Dmitro,2014-09-03 21:46:03+03:00,['ef2426271472b11bbfabdb70a088aa80b469e890'],63,86,149,18440002,7,0,0.6,1,15575
570de22829e9cbdf481215a4ba9207486cd81dc4,1,Mahadev Konar,2014-09-03 12:34:31-07:00,['5c0ef4f62dd734bbcab3016c555da431970d1773'],361,361,722,18440724,127,,,,15576
24dea68d6e6ec6825805b23abbc254bc61a6e351,0,Jaimin Jetly,2014-09-03 14:34:50-07:00,['570de22829e9cbdf481215a4ba9207486cd81dc4'],1,8,9,18440733,2,0.428571429,0.428571429,1,15576
dc269bb1588bee0bf6619f8a70ad1f144591ca09,1,Srimanth Gunturi,2014-09-03 16:16:20-07:00,['24dea68d6e6ec6825805b23abbc254bc61a6e351'],634,738,1372,18442105,9,0.207407407,1,1,15576
b68d3fabbd893cbcc4dad5ad0b39e78a26d86355,0,Xi Wang,2014-09-03 17:17:56-07:00,['dc269bb1588bee0bf6619f8a70ad1f144591ca09'],2,3,5,18442110,1,,,,15576
ce77f0e7f4f18e1feb6b3f1b156517e97381c67f,1,Xi Wang,2014-09-03 17:17:56-07:00,['b68d3fabbd893cbcc4dad5ad0b39e78a26d86355'],1,1,2,18442112,1,,,,15576
7490cfdaf72d4f323edb40179c57266d8e18acfe,0,Srimanth Gunturi,2014-09-03 17:55:30-07:00,['ce77f0e7f4f18e1feb6b3f1b156517e97381c67f'],11,1,12,18442124,2,1,0.777777778,0.777777778,15576
7343cb2a8c9b4783f55072e2cf529e8ef0f0f4f8,1,atkach,2014-09-04 14:37:07+03:00,['7490cfdaf72d4f323edb40179c57266d8e18acfe'],2,7,9,18442133,2,1,1,1,15576
a537b8e0ae6d1f0fdc8ccd3057ec2f3c9eaa1f9e,1,atkach,2014-09-04 15:26:11+03:00,['7343cb2a8c9b4783f55072e2cf529e8ef0f0f4f8'],2,20,22,18442155,4,1,1,1,15576
658360a5a334b79f8012fd6e07b5017a3bf2b1e7,1,Andrew Onishuk,2014-09-04 16:06:32+03:00,['a537b8e0ae6d1f0fdc8ccd3057ec2f3c9eaa1f9e'],360,362,722,18442877,132,,,,15577
91e0c66db25e43e06fac07f9111d3e20df60865c,1,Andrew Onishuk,2014-09-04 19:30:49+03:00,['658360a5a334b79f8012fd6e07b5017a3bf2b1e7'],4,525,529,18443406,17,,,,15593
a599bb800a9f65ec0eb833adef2ea45fee9a4b11,0,root,2014-09-02 13:59:36-04:00,['91e0c66db25e43e06fac07f9111d3e20df60865c'],0,3,3,18443409,1,,,,15593
29286b4b77c78766e6370084f615fc0fd4afe4db,1,Srimanth Gunturi,2014-09-02 11:00:24-07:00,['33335cef438369a40c4486ad2b76180676a2dd58'],14,45,59,18443468,2,,,,15593
a940986517cbfeb2ef889f0d8a45579b27adad1c,1,Andrew Onishuk,2014-09-02 21:20:21+03:00,['29286b4b77c78766e6370084f615fc0fd4afe4db'],303,247,550,18444018,56,1,1,0,15593
f94ff9b27a48ebfbfae77045603bbe28b1cbc167,1,Vitaly Brodetskyi,2014-09-02 21:39:52+03:00,['a940986517cbfeb2ef889f0d8a45579b27adad1c'],0,5,5,18444023,2,0.333333333,1,1,15593
ea58eab3b253a903d34eac0030b3b500d513821d,1,tbeerbower,2014-09-02 14:53:40-04:00,['f94ff9b27a48ebfbfae77045603bbe28b1cbc167'],74,361,435,18444458,12,,,,15594
15e4032038a48b3f1472f5a1e4940ccb4f7d4102,1,Andrew Onishuk,2014-09-02 22:08:14+03:00,['ea58eab3b253a903d34eac0030b3b500d513821d'],0,56,56,18444514,12,0.5,1,1,15594
641e177b885311d952de31362f2247620b910b72,0,Andrew Onishuk,2014-09-02 22:24:34+03:00,['15e4032038a48b3f1472f5a1e4940ccb4f7d4102'],0,11,11,18444525,1,,,,15594
8697c91b8309aeb9471585249d20fca6ccfee0f0,0,Nate Cole,2014-09-02 16:29:02-04:00,"['7a0f5091784d80b3ea3da535534850f8b6be5201', '641e177b885311d952de31362f2247620b910b72']",738,2435,3173,18447698,102,,,,15594
7a93872f90594e3c93caddad8971debf0eee5d56,0,Jaimin Jetly,2014-09-02 16:39:56-07:00,['641e177b885311d952de31362f2247620b910b72'],0,1,1,18447699,1,,,,15594
a010c341145e7c26458c571db5a26b196d64bf07,1,Yusaku Sako,2014-09-02 17:20:12-07:00,['7a93872f90594e3c93caddad8971debf0eee5d56'],1,1,2,18447701,1,,,,15594
13f6cac88fe9143bd464b6c2256b9c0fb5f86924,0,Jaimin Jetly,2014-09-02 17:44:19-07:00,['a010c341145e7c26458c571db5a26b196d64bf07'],94,25,119,18447820,8,0.586666667,0,0,15594
72a94ec7bce1ebbc0c683fe903c9468899bd6903,1,Yusaku Sako,2014-09-02 22:13:47-07:00,['13f6cac88fe9143bd464b6c2256b9c0fb5f86924'],18,11,29,18447849,10,0.5,1,0,15594
ca2106fd9ce077f2c77ade507fc4cad64f8921dc,1,atkach,2014-09-03 12:39:14+03:00,['72a94ec7bce1ebbc0c683fe903c9468899bd6903'],5,11,16,18447865,2,1,1,1,15594
03a5be1e193d6ade127fe38cd56d63688b9d5598,0,Nate Cole,2014-09-03 07:38:07-04:00,"['8697c91b8309aeb9471585249d20fca6ccfee0f0', 'ca2106fd9ce077f2c77ade507fc4cad64f8921dc']",118,49,167,18448032,22,,,,15594
0de98b0207b48007f39610f8dc8c0d13de6e7d92,1,Nate Cole,2014-09-03 07:59:40-04:00,['03a5be1e193d6ade127fe38cd56d63688b9d5598'],5,358,363,18448395,10,0.221556886,0.892215569,0.862275449,15596
30167824be48ed933a5943c3b1e21aa0780f6555,1,Xi Wang,2014-09-04 13:00:08-07:00,['a599bb800a9f65ec0eb833adef2ea45fee9a4b11'],6,21,27,18448422,1,0,0,1,15596
fd732e3d0f5346802a58a665b57a14d673c729a5,1,Xi Wang,2014-09-04 13:00:08-07:00,['30167824be48ed933a5943c3b1e21aa0780f6555'],5,5,10,18448432,1,,,,15596
301714a3d428543500c96ec04dee8b97ae9e4b4a,1,Alex Antonenko,2014-09-04 23:03:41+03:00,['fd732e3d0f5346802a58a665b57a14d673c729a5'],2,4,6,18448438,1,1,1,1,15596
fcd8d1f7ddfa3e136588d481b7fa9eeeb836e085,0,Siddharth Wagle,2014-09-04 13:03:56-07:00,['301714a3d428543500c96ec04dee8b97ae9e4b4a'],0,2,2,18448440,2,1,1,1,15596
1946654b71da61d097b3fc139dc2d12e20a116cb,1,Siddharth Wagle,2014-09-04 13:40:35-07:00,['fcd8d1f7ddfa3e136588d481b7fa9eeeb836e085'],14,30,44,18448484,5,0.666666667,0.916666667,0.75,15596
ad983dee1c4b5a6d054fd614084a39e9d9a1a416,1,Jaimin Jetly,2014-09-04 14:21:37-07:00,['1946654b71da61d097b3fc139dc2d12e20a116cb'],1,1,2,18448486,1,,,,15596
91ae5f27e98ec4d81c7299480b8adb3619e31c5b,0,Nate Cole,2014-09-04 18:35:01-04:00,"['0de98b0207b48007f39610f8dc8c0d13de6e7d92', 'ad983dee1c4b5a6d054fd614084a39e9d9a1a416']",1500,2330,3830,18452316,271,,,,15596
1c09523b2f40f38bd60e69a855b5f7e5d4bcbcac,0,Mahadev Konar,2014-09-04 15:52:58-07:00,['ad983dee1c4b5a6d054fd614084a39e9d9a1a416'],2,8,10,18452326,2,0.333333333,0.333333333,1,15596
3cec18a1fc04f181665c80bc7c6e71d26ef65b05,1,Srimanth Gunturi,2014-09-04 16:14:30-07:00,['1c09523b2f40f38bd60e69a855b5f7e5d4bcbcac'],17,61,78,18452404,3,0,0.95,0.875,15596
5d487f9ac203736ac8d4ca8d58775f6dbc114be3,1,Xi Wang,2014-09-04 18:27:10-07:00,['3cec18a1fc04f181665c80bc7c6e71d26ef65b05'],4,14,18,18452422,1,1,0,0,15596
c86c781043c04940ccd488238fbd78b4b7ef15b9,1,tbeerbower,2014-09-04 22:36:14-04:00,['5d487f9ac203736ac8d4ca8d58775f6dbc114be3'],110,351,461,18452883,11,0.485981308,1,0.261682243,15596
6c651f6dcda7f5fed1e43b0da8c6b91f8d4e19bc,1,aBabiichuk,2014-09-05 11:23:15+03:00,['c86c781043c04940ccd488238fbd78b4b7ef15b9'],103,187,290,18453173,2,0.405797101,1,0.724637681,15596
71ef2f1d19a8cef3e79793c39389482e59f6fa0c,1,atkach,2014-09-05 12:53:34+03:00,['6c651f6dcda7f5fed1e43b0da8c6b91f8d4e19bc'],6,16,22,18453195,2,0.166666667,0.166666667,1,15596
8477d45d818726ee8a9b80c55266a25d5168bc07,1,atkach,2014-09-05 13:13:29+03:00,['71ef2f1d19a8cef3e79793c39389482e59f6fa0c'],7,107,114,18453309,5,0.666666667,1,0.833333333,15596
d70f52b0edc7eda678823e30b634f1efd3992fbc,1,aBabiichuk,2014-09-05 14:10:08+03:00,['8477d45d818726ee8a9b80c55266a25d5168bc07'],0,2,2,18453311,2,,,,15596
057580fe2f144c5496ec591c9c3a9774a1d5e965,0,atkach,2014-09-05 15:21:39+03:00,['d70f52b0edc7eda678823e30b634f1efd3992fbc'],3,2,5,18453316,1,,,,15596
582c4948b680625b5d26e707f65b880cb905be5d,1,Aleksandr Kovalenko,2014-09-05 15:54:29+03:00,['057580fe2f144c5496ec591c9c3a9774a1d5e965'],22,150,172,18453488,7,0.572916667,1,1,15596
4adf44e12f881e645b9e2609af138791ee9db9b0,1,Andrew Onishuk,2014-09-05 16:32:41+03:00,['582c4948b680625b5d26e707f65b880cb905be5d'],1,52,53,18453541,6,,,,15596
0dd2063f1762af03a4fbe70e0df7db6a45b4087a,1,Andrew Onishuk,2014-09-05 16:35:51+03:00,['4adf44e12f881e645b9e2609af138791ee9db9b0'],12,227,239,18453780,6,0,0.980263158,1,15596
19ea22e4149dd791ac84f58df117968d4dcbc19b,1,Oleg Nechiporenko,2014-09-05 16:39:42+03:00,['0dd2063f1762af03a4fbe70e0df7db6a45b4087a'],1,6,7,18453787,2,0,1,1,15596
1b6088b624c257b3d9e315b15d75324b9fe6266e,1,Andrew Onishuk,2014-09-05 16:42:12+03:00,['19ea22e4149dd791ac84f58df117968d4dcbc19b'],1,7,8,18453795,2,,,,15596
1b3d4c6cb1d23b556b89d8dd4ce108cf0de26833,0,aBabiichuk,2014-09-05 17:17:49+03:00,['1b6088b624c257b3d9e315b15d75324b9fe6266e'],2,2,4,18453799,1,,,,15596
b6a869b07da747bf7f1b33f32feef67906081105,0,aBabiichuk,2014-09-05 17:52:37+03:00,['1b3d4c6cb1d23b556b89d8dd4ce108cf0de26833'],24,0,24,18453823,2,,,,15596
cc6a1157bae0010cc7a1351dbfb8e33c21409a3c,0,aBabiichuk,2014-09-05 18:16:17+03:00,['b6a869b07da747bf7f1b33f32feef67906081105'],1,1,2,18453825,2,,,,15596
dee848109ee545e2bc71796cb3a1a692b38930b1,0,Andrew Onishuk,2014-09-05 18:27:36+03:00,['cc6a1157bae0010cc7a1351dbfb8e33c21409a3c'],0,1,1,18453826,1,,,,15596
e3edd7725bf27cc6cbdfa9c5e28267d82bcdef17,1,Andrew Onishuk,2014-09-05 19:02:35+03:00,['dee848109ee545e2bc71796cb3a1a692b38930b1'],2,2,4,18453830,2,,,,15596
f76e5c9f3d44290477d08188f514df505a8c7c6f,0,aBabiichuk,2014-09-05 19:04:54+03:00,['e3edd7725bf27cc6cbdfa9c5e28267d82bcdef17'],2,10,12,18453842,1,1,1,1,15596
981adc667c3c6a5bfeca34736bba602f2a423d9b,1,Mahadev Konar,2014-09-05 10:22:04-07:00,['f76e5c9f3d44290477d08188f514df505a8c7c6f'],13,127,140,18453982,7,0.909090909,1,0.654545455,15597
e7131fa370540945fae6e14858f66226f04c7f41,1,Jaimin Jetly,2014-09-05 11:09:14-07:00,['981adc667c3c6a5bfeca34736bba602f2a423d9b'],703,754,1457,18455439,80,0.371428571,1,0.685714286,15597
c8ba5e97058f1da767f11e01827d5460a3e062b3,1,Alejandro Fernandez,2014-09-05 11:31:13-07:00,['e7131fa370540945fae6e14858f66226f04c7f41'],228,432,660,18456099,24,0,1,1,15597
1ef1fe47569c2fb3123db34760c2474da130ce43,1,Andrew Onishuk,2014-09-05 21:37:35+03:00,['c8ba5e97058f1da767f11e01827d5460a3e062b3'],16,373,389,18456488,9,0,0.897727273,1,15597
e76fa9ab3306dd6d72099bbe1074867ffb3cede4,1,Jaimin Jetly,2014-09-05 14:53:52-07:00,['1ef1fe47569c2fb3123db34760c2474da130ce43'],26,30,56,18456544,1,,,,15597
07b723e761356fb9a9add8a00324d70d0baf2282,0,tbeerbower,2014-09-05 17:54:34-04:00,['e76fa9ab3306dd6d72099bbe1074867ffb3cede4'],0,2,2,18456546,1,,,,15597
ea3ec5ae83875a591ba794f08ae10dc5b8439a30,1,Srimanth Gunturi,2014-09-05 15:33:58-07:00,['07b723e761356fb9a9add8a00324d70d0baf2282'],8,8,16,18456562,4,,,,15597
a7761fcd8e8b74ba6420c84dbb018dd5d109560c,1,Srimanth Gunturi,2014-09-05 15:58:33-07:00,['ea3ec5ae83875a591ba794f08ae10dc5b8439a30'],1,2,3,18456565,1,,,,15597
a6e5c8b3c5f3385da4a4439c7e3482511f1a8b83,0,Yusaku Sako,2014-09-05 16:15:51-07:00,['a7761fcd8e8b74ba6420c84dbb018dd5d109560c'],36,21,57,18456622,10,,,,15597
bc54512cf289dafabfde4a7dbe769447f3eee7e6,1,Mahadev Konar,2014-09-05 16:17:14-07:00,['a6e5c8b3c5f3385da4a4439c7e3482511f1a8b83'],5,105,110,18456732,2,0,0.806451613,1,15597
badfbce916a7349c5a1b4dc1f4e401e49ca16f16,1,Xi Wang,2014-09-05 16:53:50-07:00,['bc54512cf289dafabfde4a7dbe769447f3eee7e6'],2,3,5,18456737,1,0,0,0,15597
5986ad5fc5c282313905c7066364f0486de3ea36,1,Jaimin Jetly,2014-09-05 17:05:13-07:00,['badfbce916a7349c5a1b4dc1f4e401e49ca16f16'],3,20,23,18456760,1,1,1,1,15597
41a9caa8a0e0ca9b176327acf4f15271274f0706,1,Xi Wang,2014-09-05 18:00:50-07:00,['5986ad5fc5c282313905c7066364f0486de3ea36'],36,57,93,18456853,2,,,,15597
637d521b61be3e788e32a8163bdda42387a4e541,1,Xi Wang,2014-09-05 18:00:50-07:00,['41a9caa8a0e0ca9b176327acf4f15271274f0706'],1,2,3,18456856,1,0,1,1,15597
42a07f94cb1eec9a05ac82100c2ac73ffe263ab1,0,tbeerbower,2014-09-06 21:03:12-04:00,['637d521b61be3e788e32a8163bdda42387a4e541'],3,3,6,18456862,1,,,,15597
e508fe5a331c2fb8a98c55ccddbcee42ec77f2b6,0,Nate Cole,2014-09-07 05:44:24-04:00,"['91ae5f27e98ec4d81c7299480b8adb3619e31c5b', '637d521b61be3e788e32a8163bdda42387a4e541']",1396,3140,4536,18461398,185,,,,15597
84c16c5c5981559454659d069463a5bbd26e7de6,1,Nate Cole,2014-09-07 05:45:13-04:00,['e508fe5a331c2fb8a98c55ccddbcee42ec77f2b6'],10,724,734,18462132,22,0.348591549,0.827464789,0.827464789,15601
0b406cbefdbfc8f53b25d203319c964fcf3f93c7,0,Nate Cole,2014-09-07 16:53:49-04:00,"['84c16c5c5981559454659d069463a5bbd26e7de6', '42a07f94cb1eec9a05ac82100c2ac73ffe263ab1']",3,3,6,18462138,1,,,,15601
bca3d366fd70781a0b0e377edcd5ac1b2ff28d61,1,Oleg Nechiporenko,2014-09-08 13:11:03+03:00,['42a07f94cb1eec9a05ac82100c2ac73ffe263ab1'],162,214,376,18462514,2,0,1,1,15601
3d29c280573ccffb0db02be44b669e60af63a8c5,1,Oleg Nechiporenko,2014-09-08 14:44:21+03:00,['bca3d366fd70781a0b0e377edcd5ac1b2ff28d61'],4,17,21,18462535,2,1,1,1,15601
8b26d8b0b215d3d8385a4051a070ddc6b2752e3f,1,atkach,2014-09-08 15:01:17+03:00,['3d29c280573ccffb0db02be44b669e60af63a8c5'],8,12,20,18462555,3,1,1,1,15601
1f1059cff1ac749e5bdc8fd98febccb7ca346652,1,Nate Cole,2014-09-08 10:04:00-04:00,['0b406cbefdbfc8f53b25d203319c964fcf3f93c7'],99,450,549,18463104,20,0.290697674,0.808139535,0.668604651,15603
7c8299b1c5f1885af8da1fa68a75d89d0a07a601,1,Andrew Onishuk,2014-09-08 17:25:17+03:00,['8b26d8b0b215d3d8385a4051a070ddc6b2752e3f'],31,182,213,18463317,10,0.323943662,1,0.676056338,15604
d4a263c6d1628130fee4108e193f4ec819899856,1,aBabiichuk,2014-09-08 18:11:45+03:00,['7c8299b1c5f1885af8da1fa68a75d89d0a07a601'],32,16,48,18463365,1,0,0,0,15604
8ff74259c3d53484b604db43ce4233aea632e737,0,atkach,2014-09-08 18:58:01+03:00,['d4a263c6d1628130fee4108e193f4ec819899856'],1,1,2,18463367,1,,,,15604
5e36846fac0fe0c13f8aa86b5fc1fa1b54c18832,0,Andrew Onishuk,2014-09-08 19:06:46+03:00,['8ff74259c3d53484b604db43ce4233aea632e737'],1,1,2,18463369,1,,,,15604
fd4282f6126b6d6a6e36111189aba38c0d2af385,1,Yusaku Sako,2014-09-08 09:59:29-07:00,['5e36846fac0fe0c13f8aa86b5fc1fa1b54c18832'],1,3,4,18463373,1,1,1,1,15604
a5fdccda493fbbcd06d0d92b98aac14b0b6f623a,0,Lisnichenko Dmitro,2014-09-08 21:18:57+03:00,['fd4282f6126b6d6a6e36111189aba38c0d2af385'],5,5,10,18463383,5,,,,15604
74de327a0a8dae72c2e5463c7f2295249a68f176,1,Lisnichenko Dmitro,2014-09-08 22:02:56+03:00,['a5fdccda493fbbcd06d0d92b98aac14b0b6f623a'],5,5,10,18463393,5,,,,15604
c0f9fdeccc32c87d241e4b611caf39b2d9f88cb8,1,Jaimin Jetly,2014-09-08 12:25:47-07:00,['74de327a0a8dae72c2e5463c7f2295249a68f176'],4,5,9,18463402,2,1,1,1,15604
32cb4c546488bb28155d101a213747a7764eb0e9,1,tbeerbower,2014-09-08 16:12:31-04:00,['c0f9fdeccc32c87d241e4b611caf39b2d9f88cb8'],27,355,382,18463784,10,0.045454545,0.920454545,0.982954545,15605
d49c19645d9ef134491b0c225a9235def1a5ac99,1,Srimanth Gunturi,2014-09-08 13:20:04-07:00,['32cb4c546488bb28155d101a213747a7764eb0e9'],56,124,180,18463964,9,0.769230769,0,0.512820513,15606
aed657853eec5fea50b3f2ff196ae4e9c8002e8f,0,Yusaku Sako,2014-09-08 18:07:24-07:00,['d49c19645d9ef134491b0c225a9235def1a5ac99'],48,64,112,18464076,2,,,,15606
221c5a13f29d4bdf3df463a968f34b4b45a39203,1,Jaimin Jetly,2014-09-08 18:23:31-07:00,['aed657853eec5fea50b3f2ff196ae4e9c8002e8f'],3,47,50,18464126,3,0.590909091,1,1,15606
2ef3506a9dc4aab0e6eb3799cf0eed0c141b3008,0,Mahadev Konar,2014-09-08 21:40:43-07:00,['221c5a13f29d4bdf3df463a968f34b4b45a39203'],2,2,4,18464130,1,,,,15606
0e3fd88b85841487715e65b5538bf76b4bb58841,1,Aleksandr Kovalenko,2014-09-09 13:59:22+03:00,['2ef3506a9dc4aab0e6eb3799cf0eed0c141b3008'],1,2,3,18464133,1,0,0,1,15606
daae69ebac0ac72a71cf9c8b7d744aaea5aa6d56,1,Oleg Nechiporenko,2014-09-09 16:03:54+03:00,['0e3fd88b85841487715e65b5538bf76b4bb58841'],2,5,7,18464140,1,1,1,1,15606
9ce44c953de1154883887538c5979e5d9036a30c,0,Lisnichenko Dmitro,2014-09-09 16:16:42+03:00,['daae69ebac0ac72a71cf9c8b7d744aaea5aa6d56'],49,217,266,18464406,2,0.266666667,0.777777778,1,15606
8f287ce38d9a692b25119efebb5a95a0c76595f2,1,Alex Antonenko,2014-09-09 16:25:40+03:00,['9ce44c953de1154883887538c5979e5d9036a30c'],255,2,257,18464663,4,0.523529412,0.364705882,0.017647059,15606
245cf1bae02f2815cb71edf56902f6fafa47c03f,1,Aleksandr Kovalenko,2014-09-09 17:11:12+03:00,['8f287ce38d9a692b25119efebb5a95a0c76595f2'],15,26,41,18464704,4,0,1,1,15606
16d435daeeed259b37c4cf5d6892bc7a3adedc48,0,Andrew Onishuk,2014-09-09 18:22:14+03:00,['245cf1bae02f2815cb71edf56902f6fafa47c03f'],2,2,4,18464708,1,,,,15606
923549bd5cdd008bf0331bdaf46a08cbd34860da,0,Andrew Onishuk,2014-09-09 20:03:02+03:00,['16d435daeeed259b37c4cf5d6892bc7a3adedc48'],1,2,3,18464711,1,0,1,0,15606
c2a117febcfcc388de8dcea132fcb1fe7cc5491a,1,Andrew Onishuk,2014-09-09 20:41:44+03:00,['923549bd5cdd008bf0331bdaf46a08cbd34860da'],788,848,1636,18466347,7,0.363636364,1,1,15606
fbe8b876a818fa9ad8215557c407a2f1a6e47412,1,Srimanth Gunturi,2014-09-09 13:22:52-07:00,['c2a117febcfcc388de8dcea132fcb1fe7cc5491a'],30,323,353,18466700,5,0.036734694,1,0.983673469,15607
17b48bf40ff58a1bf429d1fbc14b3049ef79391d,1,Mahadev Konar,2014-09-09 15:09:08-07:00,['fbe8b876a818fa9ad8215557c407a2f1a6e47412'],251,1065,1316,18468016,25,0.588785047,0.392523364,0.831775701,15613
4f624444a247e81dbe80dc484891effe28e418fa,0,Yusaku Sako,2014-09-09 15:35:56-07:00,['17b48bf40ff58a1bf429d1fbc14b3049ef79391d'],42,0,42,18468058,1,0.032258065,0,0.161290323,15613
00be663b5835c3cc4e56b19f3e7521ff187a1926,1,Alex Antonenko,2014-09-10 02:14:18+03:00,['4f624444a247e81dbe80dc484891effe28e418fa'],48,325,373,18468431,6,0.808510638,1,1,15614
3c30d9158db2902f6fca3856b65d4a98886e23f2,1,Jaimin Jetly,2014-09-09 17:01:59-07:00,['00be663b5835c3cc4e56b19f3e7521ff187a1926'],49,254,303,18468734,9,0.76056338,0.915492958,0.85915493,15614
e40e47f8370941cbc0d818150bd7eea6d20a6522,1,Jaimin Jetly,2014-09-09 17:11:36-07:00,['3c30d9158db2902f6fca3856b65d4a98886e23f2'],0,43,43,18468777,2,0,0.137931034,1,15614
364417494428f1b5bad0c8ad1167aee536512b5e,0,Xi Wang,2014-09-09 17:20:44-07:00,['e40e47f8370941cbc0d818150bd7eea6d20a6522'],6,32,38,18468815,2,,,,15614
9cf27bf86046b0061f30e5c29e16b8b7aa7ab921,1,Yusaku Sako,2014-09-09 18:32:43-07:00,['364417494428f1b5bad0c8ad1167aee536512b5e'],97,490,587,18469402,16,0.703389831,1,0.936440678,15616
22b1df06454e32753864ea3a622d9cd5b8d921fa,1,Lisnichenko Dmitro,2014-09-10 13:13:46+03:00,['9cf27bf86046b0061f30e5c29e16b8b7aa7ab921'],217,49,266,18469668,2,0.733333333,0.222222222,0,15616
d3bfd49d4c8e15cadce01e9c7abdc33a5fe8f4bc,1,Aleksandr Kovalenko,2014-09-10 13:28:04+03:00,['22b1df06454e32753864ea3a622d9cd5b8d921fa'],6,9,15,18469683,1,0,1,1,15616
c91fab72a2290b537e2a4036d02239b8f23e2d0f,1,atkach,2014-09-10 14:35:58+03:00,['d3bfd49d4c8e15cadce01e9c7abdc33a5fe8f4bc'],31,732,763,18470446,11,0.563176895,0.620938628,1,15618
813f16c0c731d6f6a35d8462d16194a3abac9f98,1,Jonathan Hurley,2014-09-10 09:01:51-04:00,['c91fab72a2290b537e2a4036d02239b8f23e2d0f'],17,52,69,18470515,3,0.692307692,0.769230769,1,15618
05da121a58e5768d0d0eda2527bd127c7355a23a,0,Jonathan Hurley,2014-09-10 09:02:43-04:00,"['1f1059cff1ac749e5bdc8fd98febccb7ca346652', '813f16c0c731d6f6a35d8462d16194a3abac9f98']",2018,5252,7270,18477785,141,,,,15618
2b78d36ea2efd0cb4d1441399a00f5d196a0b2b2,1,aBabiichuk,2014-09-10 17:47:31+03:00,['c91fab72a2290b537e2a4036d02239b8f23e2d0f'],2,13,15,18477800,2,1,1,1,15618
1ef2af3f704bddc02c6b5532fecd438f13cab02c,1,Andrew Onishuk,2014-09-10 17:51:33+03:00,['2b78d36ea2efd0cb4d1441399a00f5d196a0b2b2'],9,19,28,18477828,6,,,,15618
dc15b7706294371444c455f40f2792d8fea4c0bc,1,tbeerbower,2014-09-10 11:02:03-04:00,['1ef2af3f704bddc02c6b5532fecd438f13cab02c'],12,107,119,18477947,13,0.4,0.45,0.8,15618
dcc00b69b3350729123cbf43dd80cf0da314bae6,1,Lisnichenko Dmitro,2014-09-10 18:27:21+03:00,['dc15b7706294371444c455f40f2792d8fea4c0bc'],3,133,136,18478083,2,0,0.895348837,0.895348837,15618
3f9d5a53f31f2bab0907f0c88cf5fdb1b5e8d5d6,1,Aleksandr Kovalenko,2014-09-10 19:03:16+03:00,['dcc00b69b3350729123cbf43dd80cf0da314bae6'],4,4,8,18478091,2,,,,15618
adb87a44792eaa588ace009ac92e68926ba0cc37,1,Andrew Onishuk,2014-09-10 19:25:27+03:00,['3f9d5a53f31f2bab0907f0c88cf5fdb1b5e8d5d6'],18,71,89,18478180,8,0.666666667,0.871794872,0.512820513,15618
015e6abfd19a9b2759e63df29d99c2f06c387479,1,Andrew Onishuk,2014-09-10 19:28:12+03:00,['adb87a44792eaa588ace009ac92e68926ba0cc37'],2,2,4,18478184,2,,,,15618
9588d2a9cd899193250cdc22c3cbd13dd1be969f,1,Oleg Nechiporenko,2014-09-10 19:48:17+03:00,['015e6abfd19a9b2759e63df29d99c2f06c387479'],44,152,196,18478380,7,1,1,1,15620
6722aba8299d1d50a067928388102653b954f907,1,Vitaly Brodetskyi,2014-09-10 20:45:57+03:00,['9588d2a9cd899193250cdc22c3cbd13dd1be969f'],2,108,110,18478490,2,0,0.234567901,1,15620
3c9bb86cbed926e8024ecf992457cf8008369321,1,Jaimin Jetly,2014-09-10 11:01:53-07:00,['6722aba8299d1d50a067928388102653b954f907'],3,9,12,18478502,5,1,1,1,15620
a3724c69ccf0533b20befeef330c389abb64dc3c,1,Alex Antonenko,2014-09-10 21:06:27+03:00,['3c9bb86cbed926e8024ecf992457cf8008369321'],2,3,5,18478507,2,1,1,1,15620
475d458973bf52870d6d13aa5ee5566e05c6f66c,1,atkach,2014-09-10 21:18:44+03:00,['a3724c69ccf0533b20befeef330c389abb64dc3c'],3,18,21,18478528,2,0.636363636,0.636363636,0.636363636,15620
11146fb67456a40aeab9fc3f3e6973fd3cf9facd,1,Srimanth Gunturi,2014-09-10 13:02:19-07:00,['475d458973bf52870d6d13aa5ee5566e05c6f66c'],530,174,704,18479232,11,1,1,0.122807018,15621
24a486a5340d58f7fe459d7bcd613a5f90b01894,0,Xi Wang,2014-09-10 13:44:19-07:00,['11146fb67456a40aeab9fc3f3e6973fd3cf9facd'],6,123,129,18479361,3,0.696969697,1,0.696969697,15622
11c057d6d144eec02cb71fa8fe74d0103cf6ffad,0,Srimanth Gunturi,2014-09-10 18:55:56-07:00,['24a486a5340d58f7fe459d7bcd613a5f90b01894'],1,1,2,18479363,1,,,,15622
71c984577ff80b1ea0adecd50badf4f632114423,1,aBabiichuk,2014-09-11 12:55:33+03:00,['11c057d6d144eec02cb71fa8fe74d0103cf6ffad'],50,63,113,18479476,4,,,,15622
da78f17816e9fa30d8d7dc9decea642ebfe5e37a,1,Andrew Onishuk,2014-09-11 14:28:44+03:00,['71c984577ff80b1ea0adecd50badf4f632114423'],12,49,61,18479537,5,0.409090909,1,1,15622
daefe5daaa5c3c3e6b4586db2a7e2ed55c9e61a1,0,Alex Antonenko,2014-09-11 16:04:34+03:00,['da78f17816e9fa30d8d7dc9decea642ebfe5e37a'],3,5,8,18479545,1,,,,15622
43a4283bbd1c4cec6ae26b104ab99be43d93a1ff,1,atkach,2014-09-11 17:34:18+03:00,['daefe5daaa5c3c3e6b4586db2a7e2ed55c9e61a1'],24,358,382,18479927,10,0.672566372,0.814159292,1,15626
c405d5feee32cab500a9d5c0e7c29666942fe538,0,Alex Antonenko,2014-09-11 17:39:12+03:00,['43a4283bbd1c4cec6ae26b104ab99be43d93a1ff'],0,1,1,18479928,1,,,,15626
a2f0bcd1afec0859ceab263a140fdce93a123ac3,0,Alex Antonenko,2014-09-11 17:57:53+03:00,['c405d5feee32cab500a9d5c0e7c29666942fe538'],0,3,3,18479931,1,,,,15626
b0fee6d4c6546f650d2e255dd646a52b6dc6d46f,1,Oleg Nechiporenko,2014-09-11 18:39:56+03:00,['a2f0bcd1afec0859ceab263a140fdce93a123ac3'],24,182,206,18480137,6,1,1,1,15627
701165b66eff9214ed22d65f0e2c2b8c62f0137c,1,Aleksandr Kovalenko,2014-09-11 19:43:06+03:00,['b0fee6d4c6546f650d2e255dd646a52b6dc6d46f'],10,24,34,18480171,10,1,1,1,15627
e293b67f6b1893596046c1153483ceb56c1aa1dd,1,Andrew Onishuk,2014-09-11 20:46:59+03:00,['701165b66eff9214ed22d65f0e2c2b8c62f0137c'],32,216,248,18480419,3,0,0.517006803,1,15627
3035978fba2921e81e83eedc8fd77090f6442b94,1,Nate Cole,2014-09-11 14:31:19-04:00,['e293b67f6b1893596046c1153483ceb56c1aa1dd'],1,25,26,18480445,7,0.857142857,1,1,15627
2262400c6057aec451027f432b83f2c88ac1d8c3,0,Jonathan Hurley,2014-09-11 15:02:05-04:00,"['05da121a58e5768d0d0eda2527bd127c7355a23a', '3035978fba2921e81e83eedc8fd77090f6442b94']",780,1846,2626,18483071,96,,,,15627
8778556f438f35c650912ea32e375c5ba0619986,1,atkach,2014-09-11 22:08:20+03:00,['3035978fba2921e81e83eedc8fd77090f6442b94'],2,2,4,18483075,1,,,,15627
7d9feb6afa6cd310fb8b11221ab67f01f048dd38,1,Dmytro Sen,2014-09-11 22:26:27+03:00,['8778556f438f35c650912ea32e375c5ba0619986'],196,1636,1832,18484907,86,0,0.82010582,0.952380952,15651
d961ca0049aaf756616a91220f5d9878f7518f2b,1,Yusaku Sako,2014-09-11 12:57:11-07:00,['7d9feb6afa6cd310fb8b11221ab67f01f048dd38'],33,78,111,18485018,13,1,1,1,15652
9d201f548b3cc77745e6a7616cc2e7be8920dbe1,1,John Speidel,2014-09-11 16:12:09-04:00,['d961ca0049aaf756616a91220f5d9878f7518f2b'],1,425,426,18485444,2,0,0.934362934,1,15653
9ed5e3be948de91a5be923d880b44342343b62d9,0,Alejandro Fernandez,2014-09-11 14:09:00-07:00,['9d201f548b3cc77745e6a7616cc2e7be8920dbe1'],0,15,15,18485459,1,,,,15653
91a01f1cd548ff35883c5a4f894a524d21a835ea,0,Alejandro Fernandez,2014-09-11 15:32:43-07:00,['9ed5e3be948de91a5be923d880b44342343b62d9'],4,54,58,18485517,3,1,1,1,15654
f3e76efe012b9dfea262d9504cefda85ed6ce7d8,1,Alejandro Fernandez,2014-09-11 16:56:14-07:00,['91a01f1cd548ff35883c5a4f894a524d21a835ea'],3,3,6,18485523,1,,,,15654
9bd6873554c83c9ea3ed14adfe32206a9745fbb0,1,Xi Wang,2014-09-11 17:00:34-07:00,['f3e76efe012b9dfea262d9504cefda85ed6ce7d8'],10,39,49,18485572,6,1,1,1,15654
e71d4fa8facd19d0430960025ba3d49dc19737a3,1,Xi Wang,2014-09-11 17:00:34-07:00,['9bd6873554c83c9ea3ed14adfe32206a9745fbb0'],2,6,8,18485580,1,,,,15654
10dd42eab0e6ee83e4c1181a3126681863c558e5,1,Xi Wang,2014-09-11 17:26:51-07:00,['e71d4fa8facd19d0430960025ba3d49dc19737a3'],8,7,15,18485595,1,,,,15654
59765552c48ec83ad2a54077dc00e69aecd85e8b,1,Srimanth Gunturi,2014-09-11 18:19:13-07:00,['10dd42eab0e6ee83e4c1181a3126681863c558e5'],3,87,90,18485685,3,0,1,1,15655
18f427dd12c016a11a81e80913b15ab40865c48f,1,aBabiichuk,2014-09-12 14:05:54+03:00,['59765552c48ec83ad2a54077dc00e69aecd85e8b'],11,163,174,18485859,4,1,1,0.914285714,15656
e10ec8b0943eda245c6ae6959b31430c45515f4a,1,atkach,2014-09-12 14:48:05+03:00,['18f427dd12c016a11a81e80913b15ab40865c48f'],13,27,40,18485899,4,1,1,1,15656
6d6f4dda59c6d8ab76f459b8b16a835f07053195,1,Vitaly Brodetskyi,2014-09-12 14:37:31+03:00,['e10ec8b0943eda245c6ae6959b31430c45515f4a'],0,2,2,18485901,1,0,1,1,15656
941b56a39aff7c53514d235e86143a8269b1b0a5,0,Andrew Onishuk,2014-09-12 17:00:53+03:00,['6d6f4dda59c6d8ab76f459b8b16a835f07053195'],0,40,40,18485941,1,,,,15656
2fbbfb370155ef9adb69fc43362dd0ad1c1448a9,1,Oleg Nechiporenko,2014-09-12 17:22:31+03:00,['941b56a39aff7c53514d235e86143a8269b1b0a5'],223,434,657,18486598,6,0.833333333,0.966666667,0.633333333,15658
1b52db2a467ee0600eea67907abeeb7e51cfcf7d,1,Oleg Nechiporenko,2014-09-12 17:26:55+03:00,['2fbbfb370155ef9adb69fc43362dd0ad1c1448a9'],111,119,230,18486828,3,,,,15658
853497f8eda3fa39c2611391c9e2bce32856119e,1,Nate Cole,2014-09-12 10:37:52-04:00,['2262400c6057aec451027f432b83f2c88ac1d8c3'],50,419,469,18487297,13,0.281818182,0.663636364,0.845454545,15661
ae4801519645b960f66fd6a97a5f4819f9ee2a89,1,Dmytro Sen,2014-09-12 17:42:14+03:00,['2fbbfb370155ef9adb69fc43362dd0ad1c1448a9'],1,1,2,18487299,1,,,,15661
6aeb3be27c4f0f9abc473cd388e954f41fe5172a,0,Dmytro Sen,2014-09-12 17:56:55+03:00,['ae4801519645b960f66fd6a97a5f4819f9ee2a89'],2,9,11,18487310,1,,,,15661
2a7fb78ec0e9e9a0e0220a474f2821bd997c98ad,0,Oleg Nechiporenko,2014-09-12 18:08:09+03:00,"['1b52db2a467ee0600eea67907abeeb7e51cfcf7d', '6aeb3be27c4f0f9abc473cd388e954f41fe5172a']",3,10,13,18487323,2,,,,15661
3cf2ee4d483091519279cc9f0e9db5a7fce2eb71,1,Aleksandr Kovalenko,2014-09-12 20:01:23+03:00,['2a7fb78ec0e9e9a0e0220a474f2821bd997c98ad'],2,6,8,18487331,1,1,0,1,15661
bd28cd9e80dc6026e7c4dfa768b4f14318185644,1,Alejandro Fernandez,2014-09-12 10:22:50-07:00,['3cf2ee4d483091519279cc9f0e9db5a7fce2eb71'],26,98,124,18487455,3,0,0.139534884,0.581395349,15661
093ed17d46e6b3e2e1528e27e4cbd42e18a9d610,1,tbeerbower,2014-09-12 14:59:48-04:00,['bd28cd9e80dc6026e7c4dfa768b4f14318185644'],346,834,1180,18488635,9,0.28,0.834285714,0.851428571,15664
fc569f191f5a44994e68d4e54aae0ff80192935d,0,tbeerbower,2014-09-12 15:16:58-04:00,['093ed17d46e6b3e2e1528e27e4cbd42e18a9d610'],96,188,284,18488919,1,,,,15664
85a8977582171013394604a0308575267c96cbb1,1,Alex Antonenko,2014-09-13 01:30:49+03:00,['fc569f191f5a44994e68d4e54aae0ff80192935d'],1,1,2,18488921,1,,,,15664
4209a492938e541be626d524bf46181bfc8d3f9b,1,Alex Antonenko,2014-09-13 01:30:50+03:00,['85a8977582171013394604a0308575267c96cbb1'],2,18,20,18488941,3,1,1,1,15664
33557337bb7bc917fa08509587031e077652803d,1,Jonathan Hurley,2014-09-12 19:47:24-04:00,['4209a492938e541be626d524bf46181bfc8d3f9b'],17,52,69,18489010,3,0.692307692,0.769230769,1,15664
aaf051357de9493217fd5b2e05daa06c55a13132,0,Jonathan Hurley,2014-09-12 19:52:41-04:00,"['853497f8eda3fa39c2611391c9e2bce32856119e', '33557337bb7bc917fa08509587031e077652803d']",1097,4293,5390,18494400,151,,,,15664
1dcb9dc62e59f5320940dcc3188398d15b706d33,1,Xi Wang,2014-09-12 17:28:54-07:00,['33557337bb7bc917fa08509587031e077652803d'],6,107,113,18494513,5,1,0.644444444,1,15664
a96b3f8fec14bef2b14a729c9e2a9617f757677e,1,Srimanth Gunturi,2014-09-12 19:24:45-07:00,['1dcb9dc62e59f5320940dcc3188398d15b706d33'],46,84,130,18494643,7,1,0,0,15664
ae0b1f36f32233810bda17bd16fccfe047ee0066,1,Oleg Nechiporenko,2014-09-15 13:56:31+03:00,['a96b3f8fec14bef2b14a729c9e2a9617f757677e'],2,2,4,18494647,2,,,,15664
258f454191ad88c0f2ade1c40fb233e0b09b4ebf,1,Dmytro Sen,2014-09-15 14:32:00+03:00,['ae0b1f36f32233810bda17bd16fccfe047ee0066'],6,31,37,18494684,1,0,1,1,15664
db9b7763f5f69b4a4d03352b668b980d2576f8b3,0,Dmytro Sen,2014-09-15 15:28:41+03:00,['258f454191ad88c0f2ade1c40fb233e0b09b4ebf'],1,1,2,18494686,1,,,,15664
1719a5ce20ebc4f0b109e9c9e2ff1ba23c23e58a,0,John Speidel,2014-09-15 10:05:27-04:00,['db9b7763f5f69b4a4d03352b668b980d2576f8b3'],1,50,51,18494737,2,1,1,1,15664
e3dba263475ab4a29c57ed041539eebbef8f16d7,1,Vitaly Brodetskyi,2014-09-15 18:38:01+03:00,['1719a5ce20ebc4f0b109e9c9e2ff1ba23c23e58a'],2,2,4,18494741,2,,,,15664
8dd0e81d8c8c3d4bfb14a0b6e6f301d74c0eac72,1,Aleksandr Kovalenko,2014-09-15 19:09:05+03:00,['e3dba263475ab4a29c57ed041539eebbef8f16d7'],1,24,25,18494766,3,0,0,0,15664
007288a24bb3720117552d60a82beef7c6831263,1,Dmytro Sen,2014-09-15 19:26:54+03:00,['8dd0e81d8c8c3d4bfb14a0b6e6f301d74c0eac72'],58,143,201,18494967,23,,,,15664
02e9fdbc1941c8ce5e2a5c373f86b68ac0d6b34d,0,Aleksandr Kovalenko,2014-09-15 19:33:51+03:00,['007288a24bb3720117552d60a82beef7c6831263'],1,1,2,18494969,1,,,,15664
002a190fc42752c5a695f29bfc5fb5e1ecbf0052,1,tbeerbower,2014-09-15 13:19:43-04:00,['02e9fdbc1941c8ce5e2a5c373f86b68ac0d6b34d'],1,32,33,18495002,1,1,1,1,15664
66048a0539b2239bf2aafdaf897f5afb45f71e5d,0,Aleksandr Kovalenko,2014-09-15 20:31:53+03:00,['002a190fc42752c5a695f29bfc5fb5e1ecbf0052'],14,24,38,18495040,1,1,1,1,15664
bee1d09b0e82f8dea085b227528995dcf879dd23,1,Vitaly Brodetskyi,2014-09-15 20:40:52+03:00,['66048a0539b2239bf2aafdaf897f5afb45f71e5d'],6,12,18,18495058,4,0,1,1,15664
760bedfe32f2a673a14cc14e7f2d41794ca3db98,1,Jonathan Hurley,2014-09-15 14:04:42-04:00,['aaf051357de9493217fd5b2e05daa06c55a13132'],86,663,749,18495807,13,0.465408805,0.987421384,0.962264151,15669
610bb1e7644112f159b15f9fc6f4e51a3350b406,1,tbeerbower,2014-09-15 15:10:31-04:00,['bee1d09b0e82f8dea085b227528995dcf879dd23'],45,44,89,18495896,13,,,,15669
601014ed8b047c676ece41016a3278c19703794f,1,Jaimin Jetly,2014-09-15 12:12:46-07:00,['610bb1e7644112f159b15f9fc6f4e51a3350b406'],2854,1221,4075,18499971,133,0.460992908,1,0.205673759,15669
f84ee8dd7985224b6481a796c6102bb56e0251e8,1,Jaimin Jetly,2014-09-15 15:31:52-07:00,['601014ed8b047c676ece41016a3278c19703794f'],1,4,5,18499976,1,,,,15669
26cd2f4b0f1e7ed23aab9fef3e6365bc4d91094e,1,Srimanth Gunturi,2014-09-15 15:32:20-07:00,['f84ee8dd7985224b6481a796c6102bb56e0251e8'],159,204,363,18500339,10,0.178571429,0,1,15670
a412da83c531ab4c6b0034c4dc087c5b58dff74c,0,tbeerbower,2014-09-15 20:34:54-04:00,['26cd2f4b0f1e7ed23aab9fef3e6365bc4d91094e'],2,27,29,18500368,2,1,1,1,15670
63f5ed2cc25f495cf216a350b32f45132adc0725,1,Srimanth Gunturi,2014-09-15 20:48:12-07:00,['a412da83c531ab4c6b0034c4dc087c5b58dff74c'],1,16,17,18500385,3,0,0,1,15670
127978c2463d8cd8ad55d3ccee276cb350b02b9a,1,Srimanth Gunturi,2014-09-16 00:46:38-07:00,['63f5ed2cc25f495cf216a350b32f45132adc0725'],2,1,3,18500388,2,,,,15670
bd04a28e14171f8d64fb6b62678a0a441f444005,1,atkach,2014-09-16 14:30:45+03:00,['127978c2463d8cd8ad55d3ccee276cb350b02b9a'],38,86,124,18500512,3,1,1,0.807692308,15670
17b8e799048b96c7fb1074a21c52e2e7ecaaf607,1,Jonathan Hurley,2014-09-16 08:50:14-04:00,"['760bedfe32f2a673a14cc14e7f2d41794ca3db98', 'bd04a28e14171f8d64fb6b62678a0a441f444005']",3087,2085,5172,18505684,206,,,,15670
f8aa99b34ae66fd3f06705b6b92edffcd28dfc9c,1,Vitaly Brodetskyi,2014-09-16 16:38:06+03:00,['bd04a28e14171f8d64fb6b62678a0a441f444005'],4,4,8,18505692,4,,,,15670
a8fb52f33c3137313b8651590b828e1cad3da7ff,1,Andrew Onishuk,2014-09-16 16:48:03+03:00,['f8aa99b34ae66fd3f06705b6b92edffcd28dfc9c'],0,94,94,18505786,6,,,,15670
6b2dd66f2d70b7b7d84ab0ce64292384d1753988,0,atkach,2014-09-16 16:51:26+03:00,['a8fb52f33c3137313b8651590b828e1cad3da7ff'],1,1,2,18505788,1,0,0,0,15670
645772647867574620d453ca8b8bb7693a1910eb,1,Lisnichenko Dmitro,2014-09-16 16:59:21+03:00,['6b2dd66f2d70b7b7d84ab0ce64292384d1753988'],68,396,464,18506252,17,0.0375,0.229166667,0.970833333,15670
460ae9ed3026b0a6c9ec1ce0cb42394afe028087,1,Oleg Nechiporenko,2014-09-16 17:37:40+03:00,['645772647867574620d453ca8b8bb7693a1910eb'],2,22,24,18506276,3,1,1,1,15670
42a5a33497e432f3d7f258f7070eeeaf20beb2a8,1,Oleg Nechiporenko,2014-09-16 18:01:26+03:00,['460ae9ed3026b0a6c9ec1ce0cb42394afe028087'],148,207,355,18506631,8,0,0,0.666666667,15672
56e022e554f6775c2bce683cb28d28b5744eec07,0,Myroslav Papirkovskyy,2014-09-16 18:07:16+03:00,['645772647867574620d453ca8b8bb7693a1910eb'],2,18,20,18506651,1,0.846153846,0.846153846,1,15672
2ab5badc1ab721840f1fd92545dd5887677c6877,0,Oleg Nechiporenko,2014-09-16 18:22:41+03:00,"['42a5a33497e432f3d7f258f7070eeeaf20beb2a8', '56e022e554f6775c2bce683cb28d28b5744eec07']",2,18,20,18506671,1,,,,15672
ef6ecf86c4fe7ca6246a567f6390cb189ae733ed,0,Andrew Onishuk,2014-09-16 18:56:06+03:00,['2ab5badc1ab721840f1fd92545dd5887677c6877'],213,0,213,18506884,1,,,,15672
b7ae2d74adcd07759b2308bc2a7b0f8115480a7e,1,Jonathan Hurley,2014-09-16 12:26:36-04:00,['17b8e799048b96c7fb1074a21c52e2e7ecaaf607'],42,572,614,18507498,12,0.767857143,1,0.892857143,15678
a30cef2af433ebfe4ebef1d22a7573f6a09cabb9,0,Andrew Onishuk,2014-09-16 20:08:14+03:00,['ef6ecf86c4fe7ca6246a567f6390cb189ae733ed'],56,4,60,18507558,35,0,0,1,15678
f92c28ed8ebf7d727eff53be13e05e6551348936,0,Andrew Onishuk,2014-09-16 20:42:08+03:00,['a30cef2af433ebfe4ebef1d22a7573f6a09cabb9'],1,1,2,18507560,1,,,,15678
4770717db7e11d904aa59c7acbdaead2060720d4,1,Xi Wang,2014-09-16 10:43:02-07:00,['f92c28ed8ebf7d727eff53be13e05e6551348936'],4,92,96,18507656,3,1,1,0.7,15678
f53e654513c7c0be09b62f748599c804bd18385e,1,aBabiichuk,2014-09-16 20:49:01+03:00,['4770717db7e11d904aa59c7acbdaead2060720d4'],0,1,1,18507657,1,,,,15678
34ffd774c4c05ce98881f920e4b40af9b89a887f,0,aBabiichuk,2014-09-16 20:49:01+03:00,['f53e654513c7c0be09b62f748599c804bd18385e'],13,25,38,18507695,2,1,1,0.2,15678
246ae7239c5a6046a474ce37f310f69b20ee4883,0,aBabiichuk,2014-09-16 20:49:02+03:00,['34ffd774c4c05ce98881f920e4b40af9b89a887f'],1,3,4,18507699,1,,,,15678
db62322f4b16be65ea59577e43a3740c5b408199,0,Andrew Onishuk,2014-09-16 21:39:20+03:00,['246ae7239c5a6046a474ce37f310f69b20ee4883'],31,1,32,18507731,3,,,,15678
ceee5bfedd4a861594f74002ba7228e60803c7a6,0,Andrew Onishuk,2014-09-16 22:10:40+03:00,['db62322f4b16be65ea59577e43a3740c5b408199'],7847,44,7891,18515622,3,0,0.484848485,1,15678
b1336f395a93549b8e0591ff1e67a924aef6cfba,0,root,2014-09-16 14:43:40-04:00,['ceee5bfedd4a861594f74002ba7228e60803c7a6'],20,2,22,18515644,2,,,,15678
e24eb5bc1c08b156fad8e3c202520dd5ca11b390,1,Alex Antonenko,2014-09-16 22:15:58+03:00,['b1336f395a93549b8e0591ff1e67a924aef6cfba'],5,109,114,18515758,2,0,0,0,15678
fe890e9a98d3a2899ede69e07b61592b006a1503,1,Alex Antonenko,2014-09-16 22:16:00+03:00,['e24eb5bc1c08b156fad8e3c202520dd5ca11b390'],1,1,2,18515760,1,,,,15678
e83ab259c582cbe7ab2e9a9cf7505e6d4f364afb,1,Srimanth Gunturi,2014-09-16 15:12:57-07:00,['fe890e9a98d3a2899ede69e07b61592b006a1503'],11,32,43,18515803,5,0.785714286,0.785714286,1,15678
19533465d6ccc4c57d00ed8c9af7815f32b2cead,1,tbeerbower,2014-09-16 19:06:18-04:00,['e83ab259c582cbe7ab2e9a9cf7505e6d4f364afb'],14,186,200,18516003,4,0,0.745901639,0.786885246,15678
cae2fc4d5bdf2ea1234191e9e9cdd8d4eb299825,1,Srimanth Gunturi,2014-09-16 19:41:54-07:00,['19533465d6ccc4c57d00ed8c9af7815f32b2cead'],9,69,78,18516081,4,0,0.604651163,0.627906977,15678
e033815cc723900ef52884439634e5732f7eabc0,1,Srimanth Gunturi,2014-09-16 22:28:24-07:00,['cae2fc4d5bdf2ea1234191e9e9cdd8d4eb299825'],3,5,8,18516089,1,0,0,1,15678
f63dd8a6eea79defd93837dbfc3011f42692ae91,1,Aleksandr Kovalenko,2014-09-17 14:06:44+03:00,['e033815cc723900ef52884439634e5732f7eabc0'],45,84,129,18516218,5,1,1,1,15678
0fb11d23e7c312aa34140ab7ecf3db5826a5e7ab,1,atkach,2014-09-17 15:10:27+03:00,['f63dd8a6eea79defd93837dbfc3011f42692ae91'],82,192,274,18516492,4,0.265625,0.65625,0.703125,15678
24f0b47e5220a8e696233658fd99a08b8cdc399c,1,Aleksandr Kovalenko,2014-09-17 15:19:08+03:00,['0fb11d23e7c312aa34140ab7ecf3db5826a5e7ab'],45,52,97,18516589,2,1,1,1,15678
a4e97aaa2df20b7434676dbdcc8afa9f28bdc84d,0,Jonathan Hurley,2014-09-17 08:33:22-04:00,"['b7ae2d74adcd07759b2308bc2a7b0f8115480a7e', '24f0b47e5220a8e696233658fd99a08b8cdc399c']",8622,1641,10263,18526852,108,,,,15678
ac290e25937baf6f4ccefde823a6ef84a5288aed,1,Andrew Onishuk,2014-09-17 16:44:11+03:00,['24f0b47e5220a8e696233658fd99a08b8cdc399c'],17,18,35,18526887,4,1,0,,15678
d6a4a68d0fbf0d076b201e4b4d635330dab530b8,1,Lisnichenko Dmitro,2014-09-17 16:54:31+03:00,['ac290e25937baf6f4ccefde823a6ef84a5288aed'],10,49,59,18526946,2,0,0.236842105,1,15678
c46d4916abc8775d6ad8c6446a6d640005458ac6,1,tbeerbower,2014-09-17 10:41:20-04:00,['d6a4a68d0fbf0d076b201e4b4d635330dab530b8'],17,29,46,18526992,5,0,0,1,15678
4bcf111f1f8539df666fbe3d9c41609547d4e5b3,1,aBabiichuk,2014-09-17 17:56:20+03:00,['c46d4916abc8775d6ad8c6446a6d640005458ac6'],25,73,98,18527090,7,,,,15678
c09edb729fce602f0943b048df7810353ecd4975,1,Andrew Onishuk,2014-09-17 18:11:06+03:00,['4bcf111f1f8539df666fbe3d9c41609547d4e5b3'],9,37,46,18527136,5,0.041666667,0,0.625,15678
892f423c8266ddaf205cc74d8996dd2a378928d2,1,Aleksandr Kovalenko,2014-09-17 18:13:47+03:00,['c09edb729fce602f0943b048df7810353ecd4975'],5,8,13,18527149,2,1,1,1,15678
760d9894d3939dfd4b4d343ddbbeef05f48f9208,1,atkach,2014-09-17 18:27:55+03:00,['892f423c8266ddaf205cc74d8996dd2a378928d2'],6,17,23,18527172,2,0,1,1,15678
6952fa4482cc999a437e6b498ec1d1a2a893ff21,1,Vitaly Brodetskyi,2014-09-17 18:39:50+03:00,['760d9894d3939dfd4b4d343ddbbeef05f48f9208'],5,6,11,18527183,4,0,,,15678
0449d22238aedc5c6fe5489b40e58d01f0a9caf1,1,Andrew Onishuk,2014-09-17 18:49:09+03:00,['6952fa4482cc999a437e6b498ec1d1a2a893ff21'],1,2,3,18527186,1,,,,15678
117b4558c347a80ac4d26db295f12c37237a3b8b,1,Andrew Onishuk,2014-09-17 18:55:23+03:00,['0449d22238aedc5c6fe5489b40e58d01f0a9caf1'],4,4,8,18527194,1,,,,15678
b4e1aed4a7e3b67e48eb330e518786c3a24a07d8,1,aBabiichuk,2014-09-17 19:26:46+03:00,['117b4558c347a80ac4d26db295f12c37237a3b8b'],0,76,76,18527270,3,1,1,1,15680
1f4d315ce2c9be2e3077fb4c264b1a10e1cc11d8,1,Alex Antonenko,2014-09-17 19:45:40+03:00,['b4e1aed4a7e3b67e48eb330e518786c3a24a07d8'],1,28,29,18527299,4,1,0,1,15680
f3345be0b99b40f6811745808f51f924a10740e2,1,Yusaku Sako,2014-09-17 10:00:36-07:00,['1f4d315ce2c9be2e3077fb4c264b1a10e1cc11d8'],75,490,565,18527864,16,0.828571429,1,0.838095238,15687
9efa63da0eab71c7d1aefbe95fcd4e21ac742762,1,atkach,2014-09-17 20:06:24+03:00,['f3345be0b99b40f6811745808f51f924a10740e2'],1,1,2,18527866,1,,,,15687
372514d904d935a8220dfbdc261c1825c1431ead,0,Jaimin Jetly,2014-09-17 13:57:18-07:00,['9efa63da0eab71c7d1aefbe95fcd4e21ac742762'],0,1,1,18527867,1,,,,15687
2a5759c5d39fbb70db2b4549bb6cee49601c86d9,1,Srimanth Gunturi,2014-09-17 15:01:59-07:00,['372514d904d935a8220dfbdc261c1825c1431ead'],21,257,278,18528145,6,0.493333333,0.706666667,0.986666667,15690
dcc03bc735f1258ba5503847b38d11ef8c725ecd,1,Sumit Mohanty,2014-09-17 15:59:44-07:00,['2a5759c5d39fbb70db2b4549bb6cee49601c86d9'],0,816,816,18528961,13,0.387596899,1,1,15703
856ac44f8074527f44df79d43e6335479ae712c1,0,Yusaku Sako,2014-09-17 16:34:02-07:00,['dcc03bc735f1258ba5503847b38d11ef8c725ecd'],3,5,8,18528969,3,1,1,1,15703
0cec52d5f0bd9ce83af62f7050d7ec1d8a7bd74e,1,Yusaku Sako,2014-09-17 16:40:52-07:00,['856ac44f8074527f44df79d43e6335479ae712c1'],11,111,122,18529091,3,,,,15703
7a087b1860ab80bbce5d3574e08068042b63d530,1,Yusaku Sako,2014-09-17 17:21:49-07:00,['0cec52d5f0bd9ce83af62f7050d7ec1d8a7bd74e'],2,3,5,18529096,2,1,1,1,15703
c7651de83d16e2d9de16ca99399aaa9ad3c595cd,0,Srimanth Gunturi,2014-09-17 17:37:39-07:00,['7a087b1860ab80bbce5d3574e08068042b63d530'],4,3,7,18529103,1,1,1,1,15703
0058924443bee9cb4b55afade3bfa08196765308,1,Srimanth Gunturi,2014-09-17 21:00:46-07:00,['c7651de83d16e2d9de16ca99399aaa9ad3c595cd'],15,29,44,18529147,5,0,0.5625,0.5625,15703
3f932cfeefb780530a05d3c328418635836a9b0b,1,aBabiichuk,2014-09-18 12:39:59+03:00,['0058924443bee9cb4b55afade3bfa08196765308'],5,24,29,18529176,3,,,,15703
a14ca23882a76c1daa27038c8e00a20d231ce55f,0,Artem Baranchuk,2014-09-18 13:47:48+03:00,['3f932cfeefb780530a05d3c328418635836a9b0b'],16,91,107,18529283,2,1,1,1,15703
731d7b4a7beca2d7a3ab810b5f83f96ee301a15c,1,atkach,2014-09-18 14:16:26+03:00,['a14ca23882a76c1daa27038c8e00a20d231ce55f'],35,12,47,18529330,3,1,1,0,15703
38a18126ff070847d26f8fe913de93ea00f72bd9,1,Aleksandr Kovalenko,2014-09-18 15:18:25+03:00,['731d7b4a7beca2d7a3ab810b5f83f96ee301a15c'],57,78,135,18529465,3,1,0,1,15703
19bf2a6a8f81e6a336cbf2617326065c36dc9dbd,1,aBabiichuk,2014-09-18 15:53:08+03:00,['38a18126ff070847d26f8fe913de93ea00f72bd9'],20,16,36,18529501,3,1,1,1,15703
21ff383056dd9fa3c84fb952135b37126693aa53,1,Andrew Onishuk,2014-09-18 16:01:54+03:00,['19bf2a6a8f81e6a336cbf2617326065c36dc9dbd'],31,79,110,18529611,6,1,0.5,0.5,15705
fd0b582c1d663fb7d04a6474273f7112111a4c74,0,atkach,2014-09-18 16:12:36+03:00,['21ff383056dd9fa3c84fb952135b37126693aa53'],12,6,18,18529629,1,0,0,0,15705
8b682da4b80ea7ae1ca1913c979e4f3983ded807,0,Andrew Onishuk,2014-09-18 16:46:25+03:00,['fd0b582c1d663fb7d04a6474273f7112111a4c74'],2,2,4,18529633,2,,,,15705
4c69d631e9c90805405b17da97c787725325bdef,1,aBabiichuk,2014-09-18 17:09:17+03:00,['8b682da4b80ea7ae1ca1913c979e4f3983ded807'],36,77,113,18529746,4,1,1,1,15706
bf0f4a9e41ff58883f43cf6297e161c8bc6539c9,1,Sumit Mohanty,2014-09-18 07:19:15-07:00,['4c69d631e9c90805405b17da97c787725325bdef'],12,22,34,18529780,4,,,,15706
5fc58284f1f286c5b5eaa8d5d40ac240ec0f8aa3,1,Jonathan Hurley,2014-09-18 10:42:39-04:00,['bf0f4a9e41ff58883f43cf6297e161c8bc6539c9'],55,215,270,18530050,8,0.642857143,0.785714286,0.928571429,15706
f1018b176a64451c2d62fcd3e2f5238e4587ab02,0,Jonathan Hurley,2014-09-18 10:43:23-04:00,"['a4e97aaa2df20b7434676dbdcc8afa9f28bdc84d', '5fc58284f1f286c5b5eaa8d5d40ac240ec0f8aa3']",451,2565,3016,18533066,105,,,,15706
31a410662cb626b04ec551495120b9bf2109cad1,0,Dmytro Sen,2014-09-18 18:29:53+03:00,['5fc58284f1f286c5b5eaa8d5d40ac240ec0f8aa3'],1,1,2,18533068,1,,,,15706
3bbbb5ec804bf2a2dadff6348f1fdfa5b64295f1,1,Andrew Onishuk,2014-09-18 20:14:34+03:00,['31a410662cb626b04ec551495120b9bf2109cad1'],162,166,328,18533396,17,0,,,15708
742b71893633afd7ce1424239bd8937ba502a7a5,1,Jaimin Jetly,2014-09-18 11:21:27-07:00,['3bbbb5ec804bf2a2dadff6348f1fdfa5b64295f1'],74,88,162,18533558,2,0,0,0.933333333,15708
5c24d29ad21848707eabd4a3ae3fdedeb7044fca,0,root,2014-09-18 19:02:44+00:00,['742b71893633afd7ce1424239bd8937ba502a7a5'],0,8,8,18533566,1,,,,15708
ba325d0831e9816992849490766e511450ef7f3a,1,Jonathan Hurley,2014-09-18 15:21:26-04:00,['f1018b176a64451c2d62fcd3e2f5238e4587ab02'],46,847,893,18534459,24,0.557788945,0.783919598,1,15715
1498061ee682e92f60b82ce496f7e25fc5ff474b,1,Sumit Mohanty,2014-09-18 13:30:16-07:00,['5c24d29ad21848707eabd4a3ae3fdedeb7044fca'],4,6,10,18534469,2,,,,15715
bf5f1c6da72ed46844298a152906fdd77c1fba28,1,Srimanth Gunturi,2014-09-18 14:48:03-07:00,['1498061ee682e92f60b82ce496f7e25fc5ff474b'],1,10,11,18534480,1,1,1,1,15715
e0215f5401d03ff90cf35cf9cb01b9aba843829b,1,Xi Wang,2014-09-18 16:26:58-07:00,['bf5f1c6da72ed46844298a152906fdd77c1fba28'],22,23,45,18534525,8,0,1,1,15715
84133c222408788a15b35310c7194dc36d7fe4e3,1,Xi Wang,2014-09-18 16:26:58-07:00,['e0215f5401d03ff90cf35cf9cb01b9aba843829b'],3,2,5,18534530,2,,,,15715
6446499d27acfa78c78608293a377a43835911e2,1,Xi Wang,2014-09-18 16:50:29-07:00,['84133c222408788a15b35310c7194dc36d7fe4e3'],60,63,123,18534653,8,0,0,0,15715
01ff6a79b6d6d4bb4f3d3dc36a0642db350e1b3a,1,Xi Wang,2014-09-18 18:03:54-07:00,['6446499d27acfa78c78608293a377a43835911e2'],1,1,2,18534655,1,0,0,1,15715
7270881fbe18f1b115c2551ff86db290ddd406c2,1,Sumit Mohanty,2014-09-18 18:59:09-07:00,['01ff6a79b6d6d4bb4f3d3dc36a0642db350e1b3a'],76,740,816,18535471,9,0.295212766,0.390957447,0.486702128,15719
44fbccef840e07899b4ba18eac1007f8e15336aa,1,Srimanth Gunturi,2014-09-18 19:58:22-07:00,['7270881fbe18f1b115c2551ff86db290ddd406c2'],9,174,183,18535654,5,0.623655914,0.655913978,1,15720
d7b09b61a996772f1ad44d728b53d4306c1a95c3,1,Alex Antonenko,2014-09-19 11:43:07+03:00,['44fbccef840e07899b4ba18eac1007f8e15336aa'],19,56,75,18535729,5,1,1,1,15720
d62147ed37864f7f9f321448c3036ade0eeb681f,1,Oleg Nechiporenko,2014-09-19 13:13:34+03:00,['d7b09b61a996772f1ad44d728b53d4306c1a95c3'],607,1815,2422,18538151,20,0.237777778,0.305925926,0.6,15723
6eda8c66a44189320c2e2270be0f74a33c0a6f68,1,Aleksandr Kovalenko,2014-09-19 13:19:24+03:00,['d62147ed37864f7f9f321448c3036ade0eeb681f'],13,25,38,18538189,4,1,1,1,15723
5c48015d6b62e3052b2555fefc0cc4604c74a88a,1,aBabiichuk,2014-09-19 13:36:35+03:00,['6eda8c66a44189320c2e2270be0f74a33c0a6f68'],3,9,12,18538201,2,1,0,1,15723
0eb3937c208ac650725059356ec909effc367534,1,Vitaly Brodetskyi,2014-09-19 13:41:24+03:00,['5c48015d6b62e3052b2555fefc0cc4604c74a88a'],3,4,7,18538208,2,0,1,0,15723
201bcb3e81b172d585744c66449d76ca2f1b1d89,1,Oleg Nechiporenko,2014-09-19 14:12:23+03:00,['0eb3937c208ac650725059356ec909effc367534'],2,2,4,18538212,2,,,,15723
05f0b402fc8ee7d79325985ed4468809455e13ef,1,Andrew Onishuk,2014-09-19 15:10:30+03:00,['201bcb3e81b172d585744c66449d76ca2f1b1d89'],8,42,50,18538262,6,0.1875,1,0.875,15723
0f7dee0b4582e277604ab8866dcc9711f3b8643a,1,atkach,2014-09-19 15:59:18+03:00,['05f0b402fc8ee7d79325985ed4468809455e13ef'],12,137,149,18538411,7,1,1,0.875,15725
52d8c27aa5f709074bbf33a2c908dd6ca739b89b,1,Aleksandr Kovalenko,2014-09-19 16:15:09+03:00,['0f7dee0b4582e277604ab8866dcc9711f3b8643a'],0,48,48,18538459,2,,,,15725
0255e5dacf6ad02d262969d87edb9639c5bfb9ec,1,Oleg Nechiporenko,2014-09-19 17:01:10+03:00,['52d8c27aa5f709074bbf33a2c908dd6ca739b89b'],5,41,46,18538505,17,,,,15739
69e8e9cc44bb55dc14c6625e740b0dc8e39b69fe,1,atkach,2014-09-19 17:26:02+03:00,['0255e5dacf6ad02d262969d87edb9639c5bfb9ec'],1,4,5,18538510,2,,,,15739
179290e0fc5370b9d46a18d5ba9d187d6c1112c8,1,Nate Cole,2014-09-19 10:56:10-04:00,['ba325d0831e9816992849490766e511450ef7f3a'],49,592,641,18539151,20,0.154882155,0.801346801,1,15740
843579eb2926a48572111dec63167de3155b364a,1,Oleg Nechiporenko,2014-09-19 18:14:02+03:00,['69e8e9cc44bb55dc14c6625e740b0dc8e39b69fe'],1,10,11,18539162,1,1,1,1,15740
5da5019a81323dbb3ef2a5699afac28679b138ea,1,Alex Antonenko,2014-09-19 18:48:08+03:00,['843579eb2926a48572111dec63167de3155b364a'],0,1,1,18539163,1,1,1,1,15740
d7ed4316202b6af7e6157ec97f9f137b43ad4eb0,1,Dmytro Sen,2014-09-19 19:12:06+03:00,['5da5019a81323dbb3ef2a5699afac28679b138ea'],356,249,605,18539768,65,0.028571429,1,0.828571429,15740
edce1b29b098a764a6c3da6d8914ff8cb80ce8af,1,Alex Antonenko,2014-09-19 19:48:10+03:00,['d7ed4316202b6af7e6157ec97f9f137b43ad4eb0'],2,16,18,18539786,4,,,,15740
e2e79668ed94266487fe9d1d2ccba2003922e883,0,Jonathan Hurley,2014-09-19 13:18:45-04:00,"['179290e0fc5370b9d46a18d5ba9d187d6c1112c8', 'd7ed4316202b6af7e6157ec97f9f137b43ad4eb0']",1421,3703,5124,18544910,167,,,,15740
d99a275f552813593ff378270a8d411f34a25937,1,Andrew Onishuk,2014-09-19 20:53:05+03:00,['edce1b29b098a764a6c3da6d8914ff8cb80ce8af'],104,216,320,18545230,6,0.205479452,0.205479452,0.246575342,15740
fbe97db797a276a490b9aeba752a22df3e5a8f07,1,Vitaly Brodetskyi,2014-09-19 21:01:24+03:00,['d99a275f552813593ff378270a8d411f34a25937'],0,3,3,18545233,2,1,1,1,15740
d018aa6a1b720149fe4417801122cd72c322e4ab,1,Alex Antonenko,2014-09-19 21:22:46+03:00,['fbe97db797a276a490b9aeba752a22df3e5a8f07'],4,4,8,18545241,2,,,,15740
21d784b68764899c8aa7262ba4b9a447911ddc22,1,Siddharth Wagle,2014-09-19 11:24:05-07:00,['d018aa6a1b720149fe4417801122cd72c322e4ab'],225,1673,1898,18547139,14,0.041666667,0.898809524,1,15740
1f7dbd5df4b624a083cc8f8fe4141e6289ecf46e,1,tbeerbower,2014-09-19 14:25:08-04:00,['21d784b68764899c8aa7262ba4b9a447911ddc22'],1,1596,1597,18548736,13,0.709784411,0.941956882,0.951907131,15750
40050513e2cecaabf4139e40e09f8b198e6a7bd5,1,Alejandro Fernandez,2014-09-19 11:47:20-07:00,['1f7dbd5df4b624a083cc8f8fe4141e6289ecf46e'],38,687,725,18549461,18,1,0.897260274,1,15757
c840be073d1b969b50bedee9d8252dbc20ea9ab9,0,tbeerbower,2014-09-19 18:49:46-04:00,['40050513e2cecaabf4139e40e09f8b198e6a7bd5'],22,46,68,18549529,3,0.666666667,0.666666667,0.666666667,15757
348d918a91cd12688ea43b08931b419a7325ac9d,0,Alejandro Fernandez,2014-09-19 16:07:52-07:00,['c840be073d1b969b50bedee9d8252dbc20ea9ab9'],30,164,194,18549723,2,0.293478261,0.956521739,1,15757
380fc2c70c24a6fd719cfd6843043b1189243f70,1,Alejandro Fernandez,2014-09-19 17:24:17-07:00,['348d918a91cd12688ea43b08931b419a7325ac9d'],164,30,194,18549917,2,0.706521739,0.043478261,0,15757
b82ac7abf4e9979a8c9d5a244565e2e3e58c2374,1,Alejandro Fernandez,2014-09-19 22:11:50-07:00,['380fc2c70c24a6fd719cfd6843043b1189243f70'],30,174,204,18550121,2,0.275510204,0.959183673,1,15757
327accb1345a7648b5cb740b94ed649721919f2c,1,Sumit Mohanty,2014-09-20 00:16:09-07:00,['b82ac7abf4e9979a8c9d5a244565e2e3e58c2374'],53,10,63,18550184,4,1,0,0,15757
7f86e75c0c1e4868973340197b7cab112a319cb1,0,Jonathan Hurley,2014-09-20 10:54:04-04:00,"['e2e79668ed94266487fe9d1d2ccba2003922e883', '327accb1345a7648b5cb740b94ed649721919f2c']",542,4422,4964,18555148,68,,,,15757
d46bbdfa95e52063899c62d5711b3fcab31c5d81,1,Srimanth Gunturi,2014-09-20 18:10:36-07:00,['327accb1345a7648b5cb740b94ed649721919f2c'],33,132,165,18555313,4,1,1,1,15758
3590d7d41b926cc5dfdc8b58322ebe97a80c80a4,1,Oleg Nechiporenko,2014-09-22 13:29:15+03:00,['d46bbdfa95e52063899c62d5711b3fcab31c5d81'],5,38,43,18555356,5,0,0,1,15758
af150a1be3dd007625397c5dc03aa6547343cf28,1,aBabiichuk,2014-09-22 14:40:03+03:00,['3590d7d41b926cc5dfdc8b58322ebe97a80c80a4'],3,82,85,18555441,3,0.970588235,0.970588235,1,15758
6236d6245413eadf794c266c7f953cd4548cf2b1,1,atkach,2014-09-22 14:40:28+03:00,['3590d7d41b926cc5dfdc8b58322ebe97a80c80a4'],1,6,7,18555448,1,1,1,1,15758
02215416f701215570bfb3eeb23db3cf1461824f,0,aBabiichuk,2014-09-22 14:43:24+03:00,"['af150a1be3dd007625397c5dc03aa6547343cf28', '6236d6245413eadf794c266c7f953cd4548cf2b1']",1,6,7,18555455,1,,,,15758
7b2f467377e13ae81dd17930c49b9755968ef679,1,Andrew Onishuk,2014-09-22 15:42:17+03:00,['02215416f701215570bfb3eeb23db3cf1461824f'],0,39,39,18555494,2,,,,15759
e582b1e3e27ee08078bffbee8315afd19f612654,1,Andrew Onishuk,2014-09-22 16:15:06+03:00,['7b2f467377e13ae81dd17930c49b9755968ef679'],6,6,12,18555506,2,,,,15759
201b7e9584c98f6dd93884999dbdced158e68428,1,Dmytro Sen,2014-09-22 16:16:04+03:00,['e582b1e3e27ee08078bffbee8315afd19f612654'],30,48,78,18555584,9,0,0.75,1,15759
f4ddfd65b9f070f23fb9489ad09e893bd5257be8,0,Dmytro Sen,2014-09-22 17:03:05+03:00,['201b7e9584c98f6dd93884999dbdced158e68428'],0,5,5,18555589,3,1,1,1,15759
6eecc2c156cdb9058f3c098770590a00b6ab32ff,1,Vitaly Brodetskyi,2014-09-22 17:49:54+03:00,['f4ddfd65b9f070f23fb9489ad09e893bd5257be8'],3,7,10,18555599,1,0,0,1,15759
329b62fd7f88ffeb0e3005b9cf6431f560e14928,1,atkach,2014-09-22 18:52:08+03:00,['6eecc2c156cdb9058f3c098770590a00b6ab32ff'],7,42,49,18555648,4,1,1,1,15759
97ff55ae272e4ea9d37584bd33e2c2f3b15499c8,0,Jaimin Jetly,2014-09-22 09:34:53-07:00,['329b62fd7f88ffeb0e3005b9cf6431f560e14928'],6,5,11,18555659,2,,,,15759
fc89a92df5a7686f7e072789467c3fcfbafda718,1,Jaimin Jetly,2014-09-22 09:53:18-07:00,['97ff55ae272e4ea9d37584bd33e2c2f3b15499c8'],80,103,183,18555842,2,0,1,1,15759
57030a4d1915ea3d219c66ca2a65840b3e078481,1,Lisnichenko Dmitro,2014-09-22 20:04:35+03:00,['fc89a92df5a7686f7e072789467c3fcfbafda718'],7,35,42,18555884,2,0,0.925925926,1,15759
802df768ac0415e91e951c61592ea370a5975957,1,Dmytro Sen,2014-09-22 20:18:13+03:00,['57030a4d1915ea3d219c66ca2a65840b3e078481'],4,48,52,18555936,2,0,0.848484848,1,15759
e6cc05872462d53f9b420837f129921d0e2e0b24,0,Jonathan Hurley,2014-09-22 10:47:55-07:00,"['7f86e75c0c1e4868973340197b7cab112a319cb1', '802df768ac0415e91e951c61592ea370a5975957']",185,596,781,18556717,41,,,,15759
58611d8f6174a43e0199d95747ab2bbb990b81a3,0,Alejandro Fernandez,2014-09-22 11:43:05-07:00,['802df768ac0415e91e951c61592ea370a5975957'],11,104,115,18556832,2,0,0,0.281690141,15759
2ef524fd69ee5cf686177704d049022f8a30c1b9,0,Siddharth Wagle,2014-09-22 11:47:35-07:00,['58611d8f6174a43e0199d95747ab2bbb990b81a3'],3,7,10,18556842,1,0,0,1,15759
ffc9532fd734d4f75b4fb47633a660df24314c0b,1,Srimanth Gunturi,2014-09-22 13:10:00-07:00,['2ef524fd69ee5cf686177704d049022f8a30c1b9'],0,14,14,18556856,1,,,,15759
6c6bd5f054e291fbed748fb53c2af7a9b2669824,1,Srimanth Gunturi,2014-09-22 13:46:30-07:00,['ffc9532fd734d4f75b4fb47633a660df24314c0b'],4,4,8,18556864,2,,,,15759
01a760621327e4cf1074e12b5dc254c9e586503d,1,Xi Wang,2014-09-22 16:39:05-07:00,['6c6bd5f054e291fbed748fb53c2af7a9b2669824'],67,85,152,18557016,6,1,1,1,15759
4010ff4177176910db7fea1c6f2ca0a23e14cd06,1,Xi Wang,2014-09-22 16:39:05-07:00,['01a760621327e4cf1074e12b5dc254c9e586503d'],0,6,6,18557022,1,,,,15759
061dc10c6cf5dc5e3c585e3710d1e7d13e84b5aa,1,Srimanth Gunturi,2014-09-22 18:34:23-07:00,['4010ff4177176910db7fea1c6f2ca0a23e14cd06'],16,48,64,18557086,7,0,0,1,15759
715ffa83445774cb9b0f34434fae3f4ddb594a20,1,Dmytro Sen,2014-09-23 13:31:45+03:00,['061dc10c6cf5dc5e3c585e3710d1e7d13e84b5aa'],8,6,14,18557100,3,,,,15759
2be32128d93d2723195fab392b68d568bae4c7cf,1,Aleksandr Kovalenko,2014-09-23 13:57:13+03:00,['715ffa83445774cb9b0f34434fae3f4ddb594a20'],3,7,10,18557110,1,1,1,1,15759
4365e44675b0432c58bc1510bd0a51825efcac92,1,Oleg Nechiporenko,2014-09-23 14:18:08+03:00,['2be32128d93d2723195fab392b68d568bae4c7cf'],53,265,318,18557428,11,0.6875,1,1,15763
efa0fa6aba000ef90aca3b04fec059cfa465f38f,1,John Speidel,2014-09-23 11:29:09-04:00,['4365e44675b0432c58bc1510bd0a51825efcac92'],21,1069,1090,18558518,2,0.06466877,1,1,15763
d838ca95b644a3222c27b7415f2711373affcd83,1,Jonathan Hurley,2014-09-23 09:02:11-07:00,['e6cc05872462d53f9b420837f129921d0e2e0b24'],129,984,1113,18559631,18,0.329073482,0.661341853,0.92971246,15768
090ed5143c3869e070c0df91d15c3f77fffcd8f8,0,Jonathan Hurley,2014-09-23 09:02:47-07:00,"['d838ca95b644a3222c27b7415f2711373affcd83', 'efa0fa6aba000ef90aca3b04fec059cfa465f38f']",184,1613,1797,18561428,33,,,,15768
535559fab2cc7e9a75e133c7a35d061d23490e59,1,Oleg Nechiporenko,2014-09-23 19:38:32+03:00,['efa0fa6aba000ef90aca3b04fec059cfa465f38f'],28,13,41,18561469,5,1,1,1,15768
3715605d0ac6ced6a82300fc3fc95b8ca2e4f49c,1,Aleksandr Kovalenko,2014-09-23 19:53:41+03:00,['535559fab2cc7e9a75e133c7a35d061d23490e59'],16,39,55,18561524,4,1,1,1,15768
d29c34ae2e6156dfa21a7f3cbfca74f663b4bb57,1,Andrew Onishuk,2014-09-23 20:04:56+03:00,['3715605d0ac6ced6a82300fc3fc95b8ca2e4f49c'],44,33,77,18561601,2,1,0,0,15768
061fb880440ff757bf5cc22fcab6d7b513e659b6,1,Vitaly Brodetskyi,2014-09-23 21:08:51+03:00,['d29c34ae2e6156dfa21a7f3cbfca74f663b4bb57'],1,15,16,18561617,2,1,1,1,15768
d09adabcda1f30155f1a60a0c2c6a62a70ca50c6,1,Srimanth Gunturi,2014-09-23 11:14:30-07:00,['061fb880440ff757bf5cc22fcab6d7b513e659b6'],13,14,27,18561644,1,0,1,1,15768
35075e0afa81a324c6d67bf4fb755830948b5a1b,1,atkach,2014-09-23 21:27:24+03:00,['d09adabcda1f30155f1a60a0c2c6a62a70ca50c6'],58,53,111,18561755,8,0.666666667,1,0,15768
2696c40ba42c9386b564209c0e06a3b22dd61fc0,1,Alex Antonenko,2014-09-23 22:29:03+03:00,['35075e0afa81a324c6d67bf4fb755830948b5a1b'],39,68,107,18561862,4,1,1,1,15768
0680d1e5ca6e9d97919605c1cbe0c433cf2d1117,0,Jaimin Jetly,2014-09-23 13:26:55-07:00,['2696c40ba42c9386b564209c0e06a3b22dd61fc0'],12,10,22,18561884,2,,,,15768
3f7fdf5018d9f01cd6200a4a31dfccb3c8450559,1,root,2014-09-23 16:34:09-04:00,['0680d1e5ca6e9d97919605c1cbe0c433cf2d1117'],8210,10240,18450,18580334,51,0.282560706,0.894039735,0.838852097,15811
1591aaa48929bae9b54676b8b816411dd028a0f2,1,Siddharth Wagle,2014-09-23 15:34:01-07:00,['3f7fdf5018d9f01cd6200a4a31dfccb3c8450559'],9,22,31,18580365,3,0,0,1,15811
464e77f0325bcf5e8fb12ec7ad1eacc77733fdf6,0,Siddharth Wagle,2014-09-23 15:34:02-07:00,['1591aaa48929bae9b54676b8b816411dd028a0f2'],0,1,1,18580366,1,,,,15812
4dec6525a927cf0bfc6ef037920d186997204102,0,Jaimin Jetly,2014-09-23 15:39:24-07:00,['464e77f0325bcf5e8fb12ec7ad1eacc77733fdf6'],4,4,8,18580374,4,,,,15812
b749dd538b8f41c7ff2df8e40d93286f25032349,1,Jaimin Jetly,2014-09-23 15:49:43-07:00,['4dec6525a927cf0bfc6ef037920d186997204102'],26,135,161,18580535,3,0.246153846,0.830769231,0.830769231,15812
6e73363bb31221cc47d301a65a729049a0475b2f,1,Yusaku Sako,2014-09-23 17:22:17-07:00,['b749dd538b8f41c7ff2df8e40d93286f25032349'],0,1203,1203,18581738,2,,,,15814
1ea56f9f817cc1f588093004ab033695a2b25c2b,0,Srimanth Gunturi,2014-09-23 19:05:24-07:00,['6e73363bb31221cc47d301a65a729049a0475b2f'],4,266,270,18582008,1,,,,15814
1977a1254653dc1e42c7567872bc6764fe58b270,1,Lisnichenko Dmitro,2014-09-24 11:52:43+03:00,['1ea56f9f817cc1f588093004ab033695a2b25c2b'],7,7,14,18582022,1,,,,15814
10b0038c48f90b86a3b04984cb6471dd0d1159dc,0,atkach,2014-09-24 14:21:48+03:00,['1977a1254653dc1e42c7567872bc6764fe58b270'],5,7,12,18582034,1,0,0,0,15814
03a1ff97384fee8cfe248278fd995c4640569b89,1,ababiichuk,2014-09-24 17:52:08+03:00,['10b0038c48f90b86a3b04984cb6471dd0d1159dc'],240,40,280,18582314,10,0.392045455,0.005681818,0.0625,15814
e13db051f8cb6e9eebe02926fa268a1be13ce5dd,1,Andrew Onishuk,2014-09-24 18:42:11+03:00,['03a1ff97384fee8cfe248278fd995c4640569b89'],2,100,102,18582416,5,0,1,1,15814
7ca86a9560a7292c9d6a277f56dbf6d24c1cb921,0,ababiichuk,2014-09-24 18:56:17+03:00,['03a1ff97384fee8cfe248278fd995c4640569b89'],32,36,68,18582484,2,1,0,0.5,15814
e5a0206d530705e89a1369676e38b09e49004dd4,0,ababiichuk,2014-09-24 19:00:22+03:00,"['7ca86a9560a7292c9d6a277f56dbf6d24c1cb921', 'e13db051f8cb6e9eebe02926fa268a1be13ce5dd']",2,100,102,18582586,5,,,,15814
d8af15e8a72fd080cb981569110aa741686cccc4,1,Oleg Nechiporenko,2014-09-24 19:16:12+03:00,['e5a0206d530705e89a1369676e38b09e49004dd4'],16,520,536,18583122,4,0.260869565,1,1,15814
6c6e4fc2eabd1af1c8bd89aa6aebf4068bdcdefb,1,John Speidel,2014-09-24 13:20:09-04:00,['d8af15e8a72fd080cb981569110aa741686cccc4'],2,80,82,18583204,2,0.085714286,1,1,15814
738d8b1acea8606c5fdf06b9e785e3cb2fd48d14,0,Alejandro Fernandez,2014-09-24 10:56:20-07:00,['6c6e4fc2eabd1af1c8bd89aa6aebf4068bdcdefb'],7,13,20,18583224,7,,,,15814
6d2fb690ace55e46b9683798afd80dbdb48a70db,1,Andrew Onishuk,2014-09-24 21:07:13+03:00,['738d8b1acea8606c5fdf06b9e785e3cb2fd48d14'],3,38,41,18583265,5,0.034482759,0.103448276,1,15814
ec17befc20c96eda8f7a50c781a20e13a9b599c0,1,Srimanth Gunturi,2014-09-24 11:15:58-07:00,['6d2fb690ace55e46b9683798afd80dbdb48a70db'],9,60,69,18583334,7,,,,15817
45ddf9f2435418f169df0b03d67d06c44298167a,1,Dmytro Sen,2014-09-24 21:36:20+03:00,['ec17befc20c96eda8f7a50c781a20e13a9b599c0'],27,67,94,18583428,11,0,0.942857143,1,15817
ddf92be12a7f874a291f67aabf23d28639b3ca60,1,Alejandro Fernandez,2014-09-24 12:46:45-07:00,['45ddf9f2435418f169df0b03d67d06c44298167a'],3,24,27,18583455,3,1,1,1,15817
9d5ba9a1a9c61980bdd6df9d0f488cb9cff8edb1,1,Srimanth Gunturi,2014-09-24 13:09:32-07:00,['ddf92be12a7f874a291f67aabf23d28639b3ca60'],0,19,19,18583474,1,,,,15817
7d6731b7f84d07f2b3369649a8c213daa451b471,1,Srimanth Gunturi,2014-09-24 13:25:51-07:00,['9d5ba9a1a9c61980bdd6df9d0f488cb9cff8edb1'],12,8,20,18583494,1,,,,15817
ae9bf4c38705074821c853301c079f2f2c484ed7,1,Jonathan Hurley,2014-09-24 13:49:59-07:00,['090ed5143c3869e070c0df91d15c3f77fffcd8f8'],136,482,618,18584112,22,0.413793103,0.586206897,0.965517241,15821
24483521f96f395b61b786e12c444901c90073c7,0,Jonathan Hurley,2014-09-24 13:50:41-07:00,"['ae9bf4c38705074821c853301c079f2f2c484ed7', '7d6731b7f84d07f2b3369649a8c213daa451b471']",8814,13120,21934,18606046,138,,,,15821
1d7fa6ad02f59c5f1854fb58f184cbab8e82383a,1,atkach,2014-09-25 13:01:02+03:00,['7d6731b7f84d07f2b3369649a8c213daa451b471'],9,113,122,18606168,7,0.627906977,1,0.860465116,15822
b0981a98a92520bf964a640fc1c45008a2978dcb,1,Dmytro Sen,2014-09-25 15:26:43+03:00,['1d7fa6ad02f59c5f1854fb58f184cbab8e82383a'],2,3,5,18606173,1,0,1,1,15822
b588278d04c3fae40d4ef2c0f42bc150f789ff2c,0,Andrew Onishuk,2014-09-25 16:03:41+03:00,['b0981a98a92520bf964a640fc1c45008a2978dcb'],0,9,9,18606182,1,,,,15822
344a96fbcf57eb50814db9f2c937598c12699708,0,Andrew Onishuk,2014-09-25 16:33:10+03:00,['b588278d04c3fae40d4ef2c0f42bc150f789ff2c'],0,16,16,18606198,1,,,,15822
0d220839cdc7a18e1416035b0b88610165b9fe19,1,Dmytro Sen,2014-09-25 16:40:47+03:00,['344a96fbcf57eb50814db9f2c937598c12699708'],17,18,35,18606233,7,0,0,1,15822
0833a91d03a7f8e2fb2e007c1b033450f30a46f4,1,Vitaly Brodetskyi,2014-09-25 18:10:55+03:00,['0d220839cdc7a18e1416035b0b88610165b9fe19'],29,25,54,18606287,10,0.666666667,1,0.333333333,15822
c9a7a3c4aa0f1414af611c59b583aafe219fdc33,1,Vitaly Brodetskyi,2014-09-25 18:14:58+03:00,['0833a91d03a7f8e2fb2e007c1b033450f30a46f4'],4,7,11,18606298,1,0,0,1,15822
cb3e2eef274a721ada7c65d17aff9c117c1c8654,1,aBabiichuk,2014-09-25 18:45:05+03:00,['c9a7a3c4aa0f1414af611c59b583aafe219fdc33'],21,48,69,18606367,5,0.727272727,0.727272727,0.909090909,15822
0e1ebc25d6ce65656f2a1b0e6e2e0606e2869eed,1,aBabiichuk,2014-09-25 19:09:23+03:00,['cb3e2eef274a721ada7c65d17aff9c117c1c8654'],42,85,127,18606494,8,1,1,1,15822
0502673717c8654a36d18fda8e6b1ed657048c35,0,aBabiichuk,2014-09-25 19:20:59+03:00,['0e1ebc25d6ce65656f2a1b0e6e2e0606e2869eed'],2,2,4,18606498,1,,,,15822
405ccff20deb6686a3f94dfe5ce5dd9d5f73b9b7,1,Aleksandr Kovalenko,2014-09-25 20:13:59+03:00,['0502673717c8654a36d18fda8e6b1ed657048c35'],7,25,32,18606530,8,1,1,1,15822
2df5f254b460391e644c49aa5be483c236f5e5e8,1,Vitaly Brodetskyi,2014-09-25 22:07:09+03:00,['405ccff20deb6686a3f94dfe5ce5dd9d5f73b9b7'],2,14,16,18606546,2,0,0,1,15822
5a154221c9ac9e67cec7b572174bf5fa20dfdcff,1,Jaimin Jetly,2014-09-25 12:20:15-07:00,['2df5f254b460391e644c49aa5be483c236f5e5e8'],852,1310,2162,18608708,23,1,0.357894737,0,15828
314669431c0643ded210a6e65ec3243c97fde101,1,Andrew Onishuk,2014-09-25 22:27:08+03:00,['5a154221c9ac9e67cec7b572174bf5fa20dfdcff'],0,4,4,18608712,4,0,0.5,1,15828
749bb2843287bbb33bc3c5469e95af85d223ea73,0,root,2014-09-25 06:47:57-04:00,['314669431c0643ded210a6e65ec3243c97fde101'],47,0,47,18608759,3,,,,15828
cb6561206244ca32ac3193bfb16fcc9f3a080100,1,tbeerbower,2014-09-25 13:14:56-07:00,['749bb2843287bbb33bc3c5469e95af85d223ea73'],187,603,790,18609549,14,0.4921875,0.671875,0.9921875,15830
6c74b724c815e7bed7d4ff8c36bad4fd3d4dda85,1,Srimanth Gunturi,2014-09-25 13:16:10-07:00,['cb6561206244ca32ac3193bfb16fcc9f3a080100'],75,74,149,18609698,4,0,0,0,15830
fcdade6b56becd000f78d85889191bb90c3c6cd0,0,Srimanth Gunturi,2014-09-25 16:08:21-07:00,['6c74b724c815e7bed7d4ff8c36bad4fd3d4dda85'],1,6,7,18609705,2,,,,15831
0ea1f0e9d8b4a7ccfe372e967f7db4775d316c08,0,Srimanth Gunturi,2014-09-25 16:14:37-07:00,['fcdade6b56becd000f78d85889191bb90c3c6cd0'],1,1,2,18609707,1,,,,15831
89f3a2c860ed57c1830072dc266d3e8a0ab0c2da,1,Jaimin Jetly,2014-09-25 16:22:05-07:00,['0ea1f0e9d8b4a7ccfe372e967f7db4775d316c08'],0,1,1,18609708,1,0,1,1,15831
a539800a65c56427fabac41d1f92664e3671d677,0,Xi Wang,2014-09-25 16:51:33-07:00,['89f3a2c860ed57c1830072dc266d3e8a0ab0c2da'],4,4,8,18609716,2,,,,15831
c2020980791134aef2500ede142c265759faf0de,1,Srimanth Gunturi,2014-09-25 17:09:18-07:00,['a539800a65c56427fabac41d1f92664e3671d677'],11,6,17,18609733,2,,,,15831
88e940c39c6bd30b892240e71541b408285ab57e,0,Yusaku Sako,2014-09-25 17:12:13-07:00,['c2020980791134aef2500ede142c265759faf0de'],0,0,0,18609733,2,,,,15831
9074f835744eb16c43b2702971c7849f7fdcead8,1,Oleg Nechiporenko,2014-09-26 13:09:08+03:00,['88e940c39c6bd30b892240e71541b408285ab57e'],1076,1329,2405,18612138,14,0,0,0,15836
bf3a614e19529fd1346bbf4525de9c06f6e35696,1,Aleksandr Kovalenko,2014-09-26 13:48:59+03:00,['9074f835744eb16c43b2702971c7849f7fdcead8'],1,1,2,18612140,1,,,,15836
2bb687ba8484c0404cf7d591dc12df851c1614df,0,atkach,2014-09-26 14:14:12+03:00,['bf3a614e19529fd1346bbf4525de9c06f6e35696'],0,30,30,18612170,4,,,,15836
1acb739586904135591278be0a6fd69f0e8c2dc3,1,Sumit Mohanty,2014-09-30 14:08:43-07:00,['753fe29e555542208b388086b06537da19e2f635'],11,8,19,18612189,3,,,,15836
73c169e32ed3e9c4e8d73dcb7b88dac3fb0bd98e,1,Siddharth Wagle,2014-09-30 14:36:08-07:00,['1acb739586904135591278be0a6fd69f0e8c2dc3'],714,1561,2275,18614464,27,1,0,0.041009464,15843
3843209c127aeab29c63799c5c38df2b54b2b9f1,0,Jaimin Jetly,2014-09-30 14:41:42-07:00,['73c169e32ed3e9c4e8d73dcb7b88dac3fb0bd98e'],23,250,273,18614737,10,0.663157895,1,0.873684211,15846
b346b582bd9fc373d43c728a3f07f4f411b8212e,1,Xi Wang,2014-09-30 14:45:56-07:00,['3843209c127aeab29c63799c5c38df2b54b2b9f1'],10,26,36,18614773,6,1,1,1,15846
d284e71968bab4e699b0ac1b5c0b72a30c249d2a,1,Srimanth Gunturi,2014-09-30 14:55:12-07:00,['b346b582bd9fc373d43c728a3f07f4f411b8212e'],22,1635,1657,18616430,5,0.941176471,0,1,15848
b803c9e4629a0120d355fdbeb46c7931f45d09c3,1,Jaimin Jetly,2014-09-30 15:02:21-07:00,['d284e71968bab4e699b0ac1b5c0b72a30c249d2a'],31,27,58,18616488,7,1,0,0,15848
5dee23ff408c3d8de22e3241400b4cec0abf49ab,1,Srimanth Gunturi,2014-09-30 15:07:19-07:00,['b803c9e4629a0120d355fdbeb46c7931f45d09c3'],30,30,60,18616548,7,,,,15848
d17ede1b71257dd2d913ebf9c267967d3a4ca5b2,0,root,2014-09-26 07:51:21-04:00,['5dee23ff408c3d8de22e3241400b4cec0abf49ab'],2163,0,2163,18618711,17,0,0,0,15848
e95ec9659ba2196530334a5795f09f27ea91ce82,1,Oleg Nechiporenko,2014-09-26 15:38:02+03:00,['2bb687ba8484c0404cf7d591dc12df851c1614df'],0,6,6,18618717,1,0.428571429,0.428571429,1,15848
a43c0816bcce43d5ef181284fbb38431d02ead6d,0,atkach,2014-09-26 15:42:17+03:00,['e95ec9659ba2196530334a5795f09f27ea91ce82'],6,16,22,18618739,3,1,1,0.666666667,15848
4a5d07d66a51a5d6569cb4430e7c16603057aa7b,0,aBabiichuk,2014-09-26 15:51:39+03:00,['2bb687ba8484c0404cf7d591dc12df851c1614df'],5,5,10,18618749,2,,,,15848
d7dd184c36985d58f501d729cc13022e040b7f23,0,aBabiichuk,2014-09-26 16:03:24+03:00,"['4a5d07d66a51a5d6569cb4430e7c16603057aa7b', 'a43c0816bcce43d5ef181284fbb38431d02ead6d']",6,22,28,18618777,4,,,,15848
1a71bdcda708f70bc8036ca44ba8f612f2aa2952,1,Lisnichenko Dmitro,2014-09-26 16:33:12+03:00,['d7dd184c36985d58f501d729cc13022e040b7f23'],17,17,34,18618811,2,,,,15848
09bc5b904f26e63dcae01b6d40a4b6ea8e0663e0,0,Vitaly Brodetskyi,2014-09-26 16:38:20+03:00,['1a71bdcda708f70bc8036ca44ba8f612f2aa2952'],1,5,6,18618817,1,1,1,1,15848
89590371cb06b509e38bc38502b3a7f146e27068,0,Dmytro Sen,2014-09-26 17:04:38+03:00,['09bc5b904f26e63dcae01b6d40a4b6ea8e0663e0'],530,0,530,18619347,16,,,,15848
90cca9bba11b6ee9d3ce10902afce685f922c6ce,1,aBabiichuk,2014-09-26 17:08:49+03:00,['89590371cb06b509e38bc38502b3a7f146e27068'],4,25,29,18619376,5,0,0,0.4,15848
9e2a81d61829a6b29c0fae75fa4b27d3c0a1ba44,1,Oleg Nechiporenko,2014-09-26 17:13:11+03:00,['89590371cb06b509e38bc38502b3a7f146e27068'],132,25,157,18619533,4,0.270491803,0,0,15848
1cd81bec552f57dda605468393e71b40c8c40475,0,Oleg Nechiporenko,2014-09-26 17:14:55+03:00,"['9e2a81d61829a6b29c0fae75fa4b27d3c0a1ba44', '90cca9bba11b6ee9d3ce10902afce685f922c6ce']",4,25,29,18619562,5,,,,15848
bd635eceaab604c73458bf6adeff333ae3040052,1,Dmytro Sen,2014-09-26 17:58:22+03:00,['1cd81bec552f57dda605468393e71b40c8c40475'],42,42,84,18619646,14,,,,15848
353daeb940f47ef92ad01daa9086104539809795,0,John Speidel,2014-09-26 11:08:16-04:00,['bd635eceaab604c73458bf6adeff333ae3040052'],11,0,11,18619657,1,,,,15848
e7ce4bb6fd7b287051214ffeb4c9828b6ee43e94,1,atkach,2014-09-26 18:27:05+03:00,['353daeb940f47ef92ad01daa9086104539809795'],1,23,24,18619681,3,0.6,1,1,15848
2e3082af1763b48d72a219e3bd97b27254631c55,1,Aleksandr Kovalenko,2014-09-26 18:31:19+03:00,['e7ce4bb6fd7b287051214ffeb4c9828b6ee43e94'],0,3,3,18619684,1,1,1,1,15848
20f112acd619f58aaad85a5fa65ff82c2e4cc498,1,John Speidel,2014-09-26 11:42:07-04:00,['2e3082af1763b48d72a219e3bd97b27254631c55'],0,69,69,18619753,2,0.681818182,1,0.863636364,15848
94bda467597a55e75bda1e1469ec969dc7d5e5dc,1,Myroslav Papirkovskyy,2014-09-26 19:34:55+03:00,['20f112acd619f58aaad85a5fa65ff82c2e4cc498'],1,1,2,18619755,1,,,,15848
7db82c923c2903a2e2fab3d302fb9337423da08b,1,Jonathan Hurley,2014-09-26 09:38:10-07:00,['24483521f96f395b61b786e12c444901c90073c7'],182,755,937,18620692,26,0.38976378,0.657480315,0.728346457,15849
73243741b60846264bf6924387719418f04b7089,0,Jonathan Hurley,2014-09-26 09:47:59-07:00,"['7db82c923c2903a2e2fab3d302fb9337423da08b', '20f112acd619f58aaad85a5fa65ff82c2e4cc498']",3043,3874,6917,18627609,160,,,,15849
b098be07ba5a2e7beecc6f70324ae0ff6e38fe3c,1,Myroslav Papirkovskyy,2014-09-26 19:49:00+03:00,['94bda467597a55e75bda1e1469ec969dc7d5e5dc'],0,9,9,18627618,1,0,0,0,15849
e2853962c5e0256303b95653a40ff04154caf61b,1,Alex Antonenko,2014-09-26 20:11:07+03:00,['b098be07ba5a2e7beecc6f70324ae0ff6e38fe3c'],7,72,79,18627697,5,1,1,1,15849
5f683a538fcb3fa9195def7b613df063fb2b982d,0,Yusaku Sako,2014-09-26 10:14:29-07:00,['e2853962c5e0256303b95653a40ff04154caf61b'],3,14,17,18627714,1,,,,15849
6befb480331e6206e17b2ece981a2cbe23df7c99,1,Alejandro Fernandez,2014-09-26 10:14:24-07:00,['5f683a538fcb3fa9195def7b613df063fb2b982d'],6,22,28,18627742,6,,,,15849
1f840098ea2bbefa07323e1589e4826c360e7868,0,Yusaku Sako,2014-09-26 10:36:48-07:00,['6befb480331e6206e17b2ece981a2cbe23df7c99'],0,1,1,18627743,1,,,,15849
c37648dd55da913775c3e97a131d113bd1d96b75,1,Aleksandr Kovalenko,2014-09-26 21:30:35+03:00,['1f840098ea2bbefa07323e1589e4826c360e7868'],5,10,15,18627758,4,1,1,1,15849
62a50a695d398e701760d4612f364fa83399646f,1,Dmytro Sen,2014-09-26 22:14:52+03:00,['c37648dd55da913775c3e97a131d113bd1d96b75'],34,70,104,18627862,8,0.066666667,0.933333333,1,15849
dcedac20674ba278b764cacd569e40c0c12d7278,1,Mahadev Konar,2014-09-26 15:31:05-07:00,['62a50a695d398e701760d4612f364fa83399646f'],6,9,15,18627877,4,,,,15849
1ea0f474ee9316dbb18beda3cec6935d3ffc14f3,1,Siddharth Wagle,2014-09-26 16:57:41-07:00,['dcedac20674ba278b764cacd569e40c0c12d7278'],62,181,243,18628120,5,0.035294118,0.494117647,0.352941176,15849
f92ad8f520b230feaf6c0bc7d8c7248448566e0b,1,Siddharth Wagle,2014-09-26 17:15:55-07:00,['1ea0f474ee9316dbb18beda3cec6935d3ffc14f3'],69,335,404,18628524,6,0.113861386,0.648514851,0.648514851,15849
be13513cf3db7cfc7a16d64766db95b5dd1e19bf,0,Siddharth Wagle,2014-09-26 17:28:04-07:00,['f92ad8f520b230feaf6c0bc7d8c7248448566e0b'],0,1,1,18628525,1,,,,15849
15745f4f80b67b88efb9900e94abc905f4f6ba46,1,Srimanth Gunturi,2014-09-26 18:05:14-07:00,['be13513cf3db7cfc7a16d64766db95b5dd1e19bf'],2,2,4,18628529,1,,,,15849
4b7bed29592203aec345b42604f1a25cf4a8af25,1,Sumit Mohanty,2014-09-27 00:30:45-07:00,['15745f4f80b67b88efb9900e94abc905f4f6ba46'],11,9,20,18628549,4,,,,15849
10f1f73b810e2c84d5818314ff9d1743c644a3bf,1,Jonathan Hurley,2014-09-27 09:33:43-04:00,['73243741b60846264bf6924387719418f04b7089'],7,101,108,18628657,4,0,1,1,15849
f1557e8f7f79153808f42d3b83251ef383484db2,0,Srimanth Gunturi,2014-09-27 16:02:18-07:00,['4b7bed29592203aec345b42604f1a25cf4a8af25'],7,6,13,18628670,2,0,0,0,15849
f923fd880b49548bc1cc289e89c18039fc3552b0,0,Jonathan Hurley,2014-09-29 08:13:51-04:00,"['10f1f73b810e2c84d5818314ff9d1743c644a3bf', 'f1557e8f7f79153808f42d3b83251ef383484db2']",212,741,953,18629623,47,,,,15849
59284b48bde8099c52528b00b74d9c0bc6125a92,1,atkach,2014-09-29 15:46:29+03:00,['f1557e8f7f79153808f42d3b83251ef383484db2'],5,2,7,18629630,3,0,0,0,15849
f10eb9182be99a1d47f2bba10d8253e06c92b75c,0,Oleg Nechiporenko,2014-09-29 16:00:48+03:00,['59284b48bde8099c52528b00b74d9c0bc6125a92'],67,3120,3187,18632817,12,0.450295276,0.554133858,0.845472441,15854
c102acac63e5bf56a8a6ac4ded6a63550ae9defe,0,subin,2014-09-29 18:50:23+05:18,['f10eb9182be99a1d47f2bba10d8253e06c92b75c'],1,1,2,18632819,1,,,,15854
cfc7347ff7741319e2f2ae27537534a51c0a7e17,1,tbeerbower,2014-09-29 10:16:50-04:00,['c102acac63e5bf56a8a6ac4ded6a63550ae9defe'],28,113,141,18632960,2,0,0.388888889,1,15854
2f5738ccd38d5a20715318d7cadd34cc2047b463,1,aBabiichuk,2014-09-29 17:44:18+03:00,['cfc7347ff7741319e2f2ae27537534a51c0a7e17'],56,57,113,18633073,9,1,0,0,15854
377280bf31a4e224ebaabbe3003e5e7b9420fe18,1,Aleksandr Kovalenko,2014-09-29 18:27:25+03:00,['2f5738ccd38d5a20715318d7cadd34cc2047b463'],8,6,14,18633087,2,0,0,0,15854
7faf263af1d16d929b6dd06dba12208d2417a202,1,atkach,2014-09-29 18:49:25+03:00,['377280bf31a4e224ebaabbe3003e5e7b9420fe18'],11,55,66,18633153,7,0,0,1,15854
a42b727260fde066429347f640c4cb1958f712e3,1,Jonathan Hurley,2014-09-29 12:17:53-04:00,['f923fd880b49548bc1cc289e89c18039fc3552b0'],5,62,67,18633220,4,0.041666667,0.958333333,1,15854
8cfd5cd29c671995218b392238eadf4c7257d3c4,1,Aleksandr Kovalenko,2014-09-29 20:51:08+03:00,['7faf263af1d16d929b6dd06dba12208d2417a202'],31,35,66,18633286,3,1,1,1,15854
7faca858dfded47a1a4d7ca000cf23104f372c71,1,Yusaku Sako,2014-09-29 11:39:07-07:00,['8cfd5cd29c671995218b392238eadf4c7257d3c4'],3120,67,3187,18636473,12,0.549704724,0.445866142,0.154527559,15856
70801b980eec5dcf463ca48f17d8494d7ffd0f8e,1,Alex Antonenko,2014-09-29 22:02:21+03:00,['7faca858dfded47a1a4d7ca000cf23104f372c71'],0,1,1,18636474,1,0,0,1,15856
a6ad0f7623a734c974c6edfbe307af6512b32eb9,0,Jaimin Jetly,2014-09-29 15:09:58-07:00,['70801b980eec5dcf463ca48f17d8494d7ffd0f8e'],1,1,2,18636476,1,,,,15856
cc9adeeb1eb10919cd9769b22157430102160f2d,0,Xi Wang,2014-09-29 15:23:59-07:00,['a6ad0f7623a734c974c6edfbe307af6512b32eb9'],4,15,19,18636495,1,1,0,0.375,15856
4d229c8db5b8df3302a04a0f1a17165ac79c3ce3,1,Srimanth Gunturi,2014-09-29 15:42:56-07:00,['cc9adeeb1eb10919cd9769b22157430102160f2d'],28,91,119,18636614,5,0.531914894,0,1,15856
b7f3bc675386caa63f96311dad1a9417d117962d,1,Alejandro Fernandez,2014-09-29 16:25:10-07:00,['4d229c8db5b8df3302a04a0f1a17165ac79c3ce3'],0,54,54,18636668,2,1,1,0.859649123,15856
cd5a4b96f0b0d6cc1758c13c3d191bd5ee4fd596,0,Srimanth Gunturi,2014-09-29 17:32:45-07:00,['b7f3bc675386caa63f96311dad1a9417d117962d'],0,54,54,18636722,1,0.365853659,0.365853659,1,15856
5300786a736c54895c77aeeaba5dd316cd3a5f66,1,Xi Wang,2014-09-29 17:41:12-07:00,['cd5a4b96f0b0d6cc1758c13c3d191bd5ee4fd596'],3,10,13,18636735,2,,,,15856
901de19d0dd83424f5973b4e4b0ff9734c08586c,0,Xi Wang,2014-09-29 17:41:12-07:00,['5300786a736c54895c77aeeaba5dd316cd3a5f66'],1,10,11,18636746,1,,,,15856
9170a41eac4fb13266b7b4b07a5c2a08e23f9c92,1,Srimanth Gunturi,2014-09-30 00:21:48-07:00,['901de19d0dd83424f5973b4e4b0ff9734c08586c'],6,1,7,18636753,1,,,,15856
bbed85247291e282a6edbedc1312e0d628799fdb,1,Jaimin Jetly,2014-09-30 01:31:21-07:00,['9170a41eac4fb13266b7b4b07a5c2a08e23f9c92'],15,16,31,18636784,2,0,0,0,15856
ba530c8d3c7f10f40069c0b8734dbd1cbca557c6,1,Vitaly Brodetskyi,2014-09-30 09:34:08+03:00,['bbed85247291e282a6edbedc1312e0d628799fdb'],9,56,65,18636849,4,0,0,1,15856
503d0f236de254168f2767ec63af0e7d0981cdc0,1,Vitaly Brodetskyi,2014-09-30 12:04:10+03:00,['ba530c8d3c7f10f40069c0b8734dbd1cbca557c6'],28,28,56,18636905,26,,,,15856
7772efb4527a7834705e3e0444c797846f1a066a,1,aBabiichuk,2014-09-30 16:08:59+03:00,['503d0f236de254168f2767ec63af0e7d0981cdc0'],4,4,8,18636913,1,,,,15856
d8f4b1e5908f6810501659489b8ede3372e6c357,1,Dmytro Sen,2014-09-30 17:13:11+03:00,['7772efb4527a7834705e3e0444c797846f1a066a'],39,50,89,18637002,18,1,1,1,15856
5518104c102e0ea9ad01bcff9161638f83146f12,1,Oleg Nechiporenko,2014-09-30 17:40:02+03:00,['d8f4b1e5908f6810501659489b8ede3372e6c357'],15,14,29,18637031,3,0,0,0,15856
cf4108794dd79e75df8368adf7fa934a31a96027,1,Myroslav Papirkovskyy,2014-09-30 18:01:17+03:00,['5518104c102e0ea9ad01bcff9161638f83146f12'],3,7,10,18637041,2,1,1,1,15856
ff0e3b0cd6d8e5b72b790dc0fd62d1829b470e98,1,atkach,2014-09-30 18:19:59+03:00,['cf4108794dd79e75df8368adf7fa934a31a96027'],5,6,11,18637052,4,1,1,1,15856
b3a98642fbe3cac31403fd3a9caa52f3a44fc22a,1,Alex Antonenko,2014-09-30 19:40:31+03:00,['ff0e3b0cd6d8e5b72b790dc0fd62d1829b470e98'],1,1,2,18637054,1,,,,15856
07e73ca2e90cf253b051b984a311f004536cadde,1,Aleksandr Kovalenko,2014-09-30 20:00:21+03:00,['b3a98642fbe3cac31403fd3a9caa52f3a44fc22a'],4,9,13,18637067,2,1,1,1,15856
04688200deb10a0425234b9956b4b2aa3630133d,1,atkach,2014-09-30 21:07:03+03:00,['07e73ca2e90cf253b051b984a311f004536cadde'],36,41,77,18637144,6,1,1,1,15856
63d507275cbfc4e9f38a86894ed550ea1e0573d4,0,Jun Aoki,2014-09-30 12:09:07-07:00,['04688200deb10a0425234b9956b4b2aa3630133d'],62,0,62,18637206,1,,,,15856
11405289e525d1d67eb12df3eb4942e82fc5adf3,1,Andrew Onishuk,2014-09-30 22:11:48+03:00,['63d507275cbfc4e9f38a86894ed550ea1e0573d4'],368,589,957,18638163,27,0.166666667,0,0,15856
753fe29e555542208b388086b06537da19e2f635,1,Srimanth Gunturi,2014-09-30 13:22:18-07:00,['11405289e525d1d67eb12df3eb4942e82fc5adf3'],14,26,40,18638203,1,0,0.818181818,1,15856
b9cca7137540a6233a016ccf8ff3eba4c119b2b6,0,Jonathan Hurley,2014-09-30 16:47:50-04:00,"['a42b727260fde066429347f640c4cb1958f712e3', '753fe29e555542208b388086b06537da19e2f635']",781,1348,2129,18640332,124,,,,15856
83efcfeae5821f82f3a808276ca42f642b4b4e62,1,root,2014-09-30 22:12:30+00:00,['d17ede1b71257dd2d913ebf9c267967d3a4ca5b2'],0,59369,59369,18699701,299,0.356014047,0.677568042,0.894424934,16154
9db24dad0d29cbfb27db5b9a6a3e8372204ee602,1,Yusaku Sako,2014-09-30 15:42:21-07:00,['83efcfeae5821f82f3a808276ca42f642b4b4e62'],250,23,273,18699974,10,0.336842105,0,0.126315789,16154
122e5d183de79a2e3d2af8e79b9da295d4667b71,0,Jaimin Jetly,2014-09-30 18:18:15-07:00,['9db24dad0d29cbfb27db5b9a6a3e8372204ee602'],87,1,88,18700062,2,,,,16154
95ac1d63de221773c04faa4b5b627c91cddbbcf7,0,Jaimin Jetly,2014-09-30 18:40:26-07:00,['122e5d183de79a2e3d2af8e79b9da295d4667b71'],41,55,96,18700158,7,0,0.916666667,1,16154
eee03845e85ab7cf64707446007a315ff5352434,1,Srimanth Gunturi,2014-09-30 19:15:27-07:00,['95ac1d63de221773c04faa4b5b627c91cddbbcf7'],8,29,37,18700195,4,0.875,1,1,16154
054745d06472ef74430f47f09e1c8881f9f9780a,1,Jonathan Hurley,2014-09-30 23:12:48-04:00,['b9cca7137540a6233a016ccf8ff3eba4c119b2b6'],42,389,431,18700626,13,0.051612903,0.580645161,0.767741935,16155
fb6c685cbcf01f32c0840c32f6aa1e98f8c8e30a,1,atkach,2014-10-01 13:50:01+03:00,['eee03845e85ab7cf64707446007a315ff5352434'],22,36,58,18700684,4,0.900990099,0.910891089,0,16155
ff734047e15b6c74ef656ac95ad9d1fb45d6833a,0,Oleg Nechiporenko,2014-10-01 14:06:54+03:00,['fb6c685cbcf01f32c0840c32f6aa1e98f8c8e30a'],1,1,2,18700686,1,,,,16155
82dc3d85b0137e02a08fdf99c294bb9d38f6df29,0,Dmytro Sen,2014-10-01 14:31:47+03:00,['ff734047e15b6c74ef656ac95ad9d1fb45d6833a'],1,1,2,18700688,1,,,,16155
01e82f233895dc3a948f7b18a216e9c8481b785e,1,Aleksandr Kovalenko,2014-10-01 15:11:27+03:00,['82dc3d85b0137e02a08fdf99c294bb9d38f6df29'],16,19,35,18700723,4,,,,16155
d469516dee9d318f9bd1fd14dd7ab373de3cfa27,1,Oleg Nechiporenko,2014-10-01 15:16:12+03:00,['01e82f233895dc3a948f7b18a216e9c8481b785e'],47,3229,3276,18703999,14,0.457497612,0.567335244,0.850047755,16161
a172f7555c746687c599f1603721d59c4a167b75,1,Andrew Onishuk,2014-10-01 15:30:49+03:00,['d469516dee9d318f9bd1fd14dd7ab373de3cfa27'],371,335,706,18704705,22,1,0,0,16161
ec0034df789179576cd7e2e3e45b41c5b3243c13,0,Aleksandr Kovalenko,2014-10-01 15:35:09+03:00,['a172f7555c746687c599f1603721d59c4a167b75'],25,17,42,18704747,3,1,1,1,16161
9f9e64006e2f46ea7fd976c87f9558b2a56494f7,0,Dmytro Sen,2014-10-01 15:45:21+03:00,['ec0034df789179576cd7e2e3e45b41c5b3243c13'],2,2,4,18704751,2,,,,16161
1e6b21639918efbb6cf24cade73568fcbba292f5,0,Andrew Onishuk,2014-10-01 16:27:36+03:00,['9f9e64006e2f46ea7fd976c87f9558b2a56494f7'],0,2,2,18704753,1,,,,16161
bb7d5f71e80b8bcad5e69fb4df10788b1c2376a8,1,tbeerbower,2014-10-01 09:29:16-04:00,['1e6b21639918efbb6cf24cade73568fcbba292f5'],37,181,218,18704971,3,0.068965517,0.459770115,0.436781609,16161
f3c4e436eae156320c41660322604ee24988f426,1,Vitaly Brodetskyi,2014-10-01 12:41:54+03:00,['bb7d5f71e80b8bcad5e69fb4df10788b1c2376a8'],4,10,14,18704985,2,0,1,1,16161
33f3e9952e760bcdbb51ba3629daf9de22905a6c,1,Vitaly Brodetskyi,2014-10-01 14:46:27+03:00,['bd851c14fb853da13031b15571e2a96eb67a1603'],0,29,29,18705014,1,,,,16162
c8d3a0aa05731f7f77f3b1b0cd2ea28ca332a6a3,1,Oleg Nechiporenko,2014-10-01 17:50:30+03:00,['f3c4e436eae156320c41660322604ee24988f426'],1,80,81,18705095,3,0.90625,1,1,16163
bd851c14fb853da13031b15571e2a96eb67a1603,1,atkach,2014-10-01 17:54:08+03:00,['c8d3a0aa05731f7f77f3b1b0cd2ea28ca332a6a3'],21,23,44,18705139,2,,,,16163
6f9398f0ff45da86c001eb86322695a3d76b7232,0,Jonathan Hurley,2014-10-01 11:26:26-04:00,"['054745d06472ef74430f47f09e1c8881f9f9780a', 'bd851c14fb853da13031b15571e2a96eb67a1603']",3067,66079,69146,18774285,424,,,,16163
34858c8bd585c48d45cee7eb5b290a44a53c0d9f,1,Srimanth Gunturi,2014-10-01 08:38:45-07:00,['33f3e9952e760bcdbb51ba3629daf9de22905a6c'],17,25,42,18774327,3,0,0,0,16163
c2a8c66e495d9c714733e8ccff819f0d774d7850,1,Srimanth Gunturi,2014-10-01 08:38:45-07:00,['34858c8bd585c48d45cee7eb5b290a44a53c0d9f'],1,1,2,18774329,1,,,,16163
352d32cc0710a15f44cc6c0d4e7f92ed1b75ae65,0,atkach,2014-10-01 19:27:03+03:00,['c2a8c66e495d9c714733e8ccff819f0d774d7850'],5,4,9,18774338,2,,,,16163
f3218b1a8785baa9afef76713c953a1ab08d07b7,1,aBabiichuk,2014-10-01 19:45:15+03:00,['352d32cc0710a15f44cc6c0d4e7f92ed1b75ae65'],8,29,37,18774375,4,0.111111111,1,1,16163
1ce97794bee1419328a171a18be4e12e4e053f57,1,aBabiichuk,2014-10-01 19:45:30+03:00,['f3218b1a8785baa9afef76713c953a1ab08d07b7'],2,2,4,18774379,1,,,,16163
842f0735200b79280da1a1cac3a58f7200c8e070,0,Jaimin Jetly,2014-10-01 10:43:15-07:00,['1ce97794bee1419328a171a18be4e12e4e053f57'],23,251,274,18774653,10,0.663157895,1,0.873684211,16166
e1c1a2e5a086fac7be2825d13ef438e966577b38,1,Alejandro Fernandez,2014-10-01 10:46:06-07:00,['842f0735200b79280da1a1cac3a58f7200c8e070'],62,500,562,18775215,17,0.38410596,0.298013245,1,16169
a0a990b571d5e0aa5d74871bba6887610d746339,1,Alejandro Fernandez,2014-10-01 10:48:40-07:00,['e1c1a2e5a086fac7be2825d13ef438e966577b38'],0,3,3,18775218,1,,,,16169
b68368a7686b95aaafae268143274ca2483259d6,0,tbeerbower,2014-10-01 14:06:15-04:00,['a0a990b571d5e0aa5d74871bba6887610d746339'],1,1,2,18775220,1,,,,16169
fcaf1f24249814293f4f5e06c6e78fc2be20e620,1,Xi Wang,2014-10-01 11:13:35-07:00,['b68368a7686b95aaafae268143274ca2483259d6'],1,5,6,18775226,2,,,,16169
49c6ec45a364cfd92cd23b759ccb9fc2f89a70aa,1,Yusaku Sako,2014-10-01 11:28:08-07:00,['fcaf1f24249814293f4f5e06c6e78fc2be20e620'],251,23,274,18775500,10,0.336842105,0,0.126315789,16169
ee2b308eba8819c75b83c2b46043105aeb1e5208,1,Jaimin Jetly,2014-10-01 12:21:48-07:00,['49c6ec45a364cfd92cd23b759ccb9fc2f89a70aa'],23,253,276,18775776,10,0.663157895,1,0.873684211,16172
610b21a307dbbed149a2eabfea3ae81b7d35fcb6,0,Jaimin Jetly,2014-10-01 13:05:29-07:00,['ee2b308eba8819c75b83c2b46043105aeb1e5208'],13,11,24,18775800,2,0,1,1,16172
0da1d32eacb2c7ecd6f054bfa4a100c88f9496dd,1,Srimanth Gunturi,2014-10-01 13:06:14-07:00,['610b21a307dbbed149a2eabfea3ae81b7d35fcb6'],0,46,46,18775846,2,0,0,1,16172
85ce5c201c8e5793ad2982ad31b9edfe0a6983e9,0,Jaimin Jetly,2014-10-01 13:10:27-07:00,['0da1d32eacb2c7ecd6f054bfa4a100c88f9496dd'],11,13,24,18775870,2,1,0,0,16172
2430e397b911863b934b49f8b1f51217de3f623f,0,Jaimin Jetly,2014-10-01 13:12:12-07:00,['85ce5c201c8e5793ad2982ad31b9edfe0a6983e9'],13,11,24,18775894,2,0,1,1,16172
5e549b9e6133ea359b247c27a9065e9fec83ad51,1,Srimanth Gunturi,2014-10-01 13:33:15-07:00,['2430e397b911863b934b49f8b1f51217de3f623f'],9,6,15,18775909,1,1,1,0,16172
b10cb648cf5593ded61e9f4588a8319826bfece7,1,Srimanth Gunturi,2014-10-01 16:55:12-07:00,['5e549b9e6133ea359b247c27a9065e9fec83ad51'],18,26,44,18775953,1,1,1,1,16172
051f0705bcde09387952e14ec805b5324f9f4cc4,1,Alex Antonenko,2014-10-02 03:27:10+03:00,['b10cb648cf5593ded61e9f4588a8319826bfece7'],11,7,18,18775971,2,1,1,1,16172
0fdd4b3483a3c6bed37953f4c2de1f94392f6d7e,1,Alejandro Fernandez,2014-10-01 18:46:55-07:00,['051f0705bcde09387952e14ec805b5324f9f4cc4'],201,277,478,18776449,18,0.222222222,0,0.555555556,16173
a23758831a3a3352d9d7a29e3a61af9a87963d34,1,atkach,2014-10-02 13:59:55+03:00,['0fdd4b3483a3c6bed37953f4c2de1f94392f6d7e'],1,70,71,18776520,2,1,1,1,16173
e040511e9b68e4d016802cfbfa00a447c36a4e90,1,Oleg Nechiporenko,2014-10-02 14:47:07+03:00,['a23758831a3a3352d9d7a29e3a61af9a87963d34'],3,178,181,18776701,2,0.682539683,1,1,16174
ef1d6988a06668814edad5d16773de812c845ad9,1,Oleg Nechiporenko,2014-10-02 14:49:01+03:00,['e040511e9b68e4d016802cfbfa00a447c36a4e90'],2,2,4,18776705,1,,,,16174
cc4dfe351f3ece0082cfbbe4a3657202cf93967b,1,Andrew Onishuk,2014-10-02 15:03:11+03:00,['ef1d6988a06668814edad5d16773de812c845ad9'],678,2448,3126,18779831,13,0.172727273,0.612121212,0.342424242,16178
efbaf5cbd33bbd4ab3a837513992741c59f41063,0,atkach,2014-10-02 15:47:51+03:00,['cc4dfe351f3ece0082cfbbe4a3657202cf93967b'],31,36,67,18779898,4,1,1,1,16178
5c45997e1f4b5a3c6c26323779379b6ca697c2ea,1,atkach,2014-10-02 16:14:05+03:00,['efbaf5cbd33bbd4ab3a837513992741c59f41063'],2,12,14,18779912,1,0.75,0.75,1,16178
76579d1faa64cedbb4ec6a00cf4ca5d5fc3ef759,0,Andrew Onishuk,2014-10-02 17:03:04+03:00,['5c45997e1f4b5a3c6c26323779379b6ca697c2ea'],1,0,1,18779913,1,,,,16178
8f7f717779b5249bfe2f36f2635df240231babcb,0,John Speidel,2014-10-02 10:09:49-04:00,['76579d1faa64cedbb4ec6a00cf4ca5d5fc3ef759'],0,10,10,18779923,2,0,1,1,16178
9073879cd808d53485da22201c4d02d1a5ab9619,1,Aleksandr Kovalenko,2014-10-02 18:25:12+03:00,['8f7f717779b5249bfe2f36f2635df240231babcb'],27,77,104,18780027,8,1,1,1,16178
e9f2b4a8535036488e2dbca7445d72d725af6377,0,Lisnichenko Dmitro,2014-10-02 18:33:22+03:00,['9073879cd808d53485da22201c4d02d1a5ab9619'],41,120,161,18780188,4,0.9375,0.9375,1,16178
0f7dcba1165d2bd7de4ae01b92947746fcb9eebc,1,Jaimin Jetly,2014-10-02 11:04:39-07:00,['e9f2b4a8535036488e2dbca7445d72d725af6377'],37,38,75,18780263,2,,,,16178
a95d1e220fd6dc19bd3a019b342ad1e2b1acc8c9,1,Yusaku Sako,2014-10-02 11:16:44-07:00,['0f7dcba1165d2bd7de4ae01b92947746fcb9eebc'],120,41,161,18780424,4,0.0625,0.0625,0,16178
7da3a8e312f62ca66918ceb4ffdb413b86364e08,1,Lisnichenko Dmitro,2014-10-02 22:54:49+03:00,['a95d1e220fd6dc19bd3a019b342ad1e2b1acc8c9'],18,925,943,18781367,10,0.078324226,0.763205829,0.757741348,16181
354bdbac9291ba1ac6a335572ad8b521911d6f95,0,Jaimin Jetly,2014-10-02 15:11:59-07:00,['7da3a8e312f62ca66918ceb4ffdb413b86364e08'],1,0,1,18781368,1,,,,16181
9299f92de218f28f70795c57fd2fa1694a13da93,1,Srimanth Gunturi,2014-10-02 15:19:26-07:00,['354bdbac9291ba1ac6a335572ad8b521911d6f95'],9,9,18,18781386,9,,,,16181
8cc65e396f948591f22a9fa68d0e72401c155f4f,1,Srimanth Gunturi,2014-10-02 23:39:13-07:00,['9299f92de218f28f70795c57fd2fa1694a13da93'],184,340,524,18781910,5,0.177777778,0.172222222,1,16181
659682d86f1013af114132b1647a8a6bff046441,1,Srimanth Gunturi,2014-10-03 01:20:20-07:00,['8cc65e396f948591f22a9fa68d0e72401c155f4f'],99,123,222,18782132,12,1,1,0,16183
712d99e088f06ff13ebc09843e092af0c77d8ed0,1,Oleg Nechiporenko,2014-10-03 13:03:32+03:00,['659682d86f1013af114132b1647a8a6bff046441'],14,14,28,18782160,2,0,0,0,16183
9f0d9a327fa2095ec3baf8adbaa8caa09c89966d,0,Lisnichenko Dmitro,2014-10-03 14:00:11+03:00,['659682d86f1013af114132b1647a8a6bff046441'],1,1,2,18782162,1,,,,16183
84e0849b9be21734f0e683c05ac918ce43d4b97d,0,Oleg Nechiporenko,2014-10-03 14:02:24+03:00,"['712d99e088f06ff13ebc09843e092af0c77d8ed0', '9f0d9a327fa2095ec3baf8adbaa8caa09c89966d']",1,1,2,18782164,1,,,,16183
9ceaa15ce6a1bf4c0464a58d3a2639648a53461c,1,Lisnichenko Dmitro,2014-10-03 14:24:13+03:00,['84e0849b9be21734f0e683c05ac918ce43d4b97d'],37,33,70,18782234,3,1,0,0,16183
d1c6476c8a8673f948b589c0436ffffff350f505,0,aBabiichuk,2014-10-03 14:28:50+03:00,['9ceaa15ce6a1bf4c0464a58d3a2639648a53461c'],1,2,3,18782237,1,1,1,1,16183
d69a418ff690ee78295eeec0a3d7c989551d425f,1,Myroslav Papirkovskyy,2014-10-03 16:18:50+03:00,['d1c6476c8a8673f948b589c0436ffffff350f505'],208,68,276,18782513,10,1,0,0,16183
727b7ac9f6de12712228482e66f065e1bc5e9e27,1,Dmytro Sen,2014-10-03 17:08:11+03:00,['d69a418ff690ee78295eeec0a3d7c989551d425f'],89,84,173,18782686,2,,,,16184
6897128aa8d98cb66160479a58384fcf426aa05e,1,aBabiichuk,2014-10-03 17:13:55+03:00,['727b7ac9f6de12712228482e66f065e1bc5e9e27'],4,4,8,18782694,2,,,,16184
0329800f2ec0ae6d699a65cdb088327368e224c0,1,Dmytro Sen,2014-10-03 18:00:57+03:00,['6897128aa8d98cb66160479a58384fcf426aa05e'],101,101,202,18782896,5,,,,16184
601b1e05859f1cea4fcfa2bf30eaa40006fefa6b,1,Andrew Onishuk,2014-10-03 18:34:50+03:00,['0329800f2ec0ae6d699a65cdb088327368e224c0'],0,9,9,18782905,1,,,,16184
def4c946bb82d135adba1c69f5c803662aee6418,1,Oleg Nechiporenko,2014-10-03 18:53:05+03:00,['601b1e05859f1cea4fcfa2bf30eaa40006fefa6b'],12,38,50,18782955,7,1,1,1,16184
ac70302451872c9c25f8eda907e1b4d1299eec85,1,Oleg Nechiporenko,2014-10-03 19:12:26+03:00,['def4c946bb82d135adba1c69f5c803662aee6418'],3,36,39,18782994,4,1,1,1,16185
d5b9af74587ad918e82fc418aa9c77716bb6f299,1,Jaimin Jetly,2014-10-03 09:54:34-07:00,['ac70302451872c9c25f8eda907e1b4d1299eec85'],537,1306,1843,18784837,36,0.819047619,0.89047619,0.938095238,16199
eaa67b97dc276bc53c1399a8fd23194ad22e28fa,1,aBabiichuk,2014-10-03 20:00:01+03:00,['d5b9af74587ad918e82fc418aa9c77716bb6f299'],121,140,261,18785098,1,0,1,1,16199
401fb199381bd04d7fab63f102f5d64e94572cc8,1,Dmytro Sen,2014-10-03 20:46:55+03:00,['eaa67b97dc276bc53c1399a8fd23194ad22e28fa'],3,7,10,18785108,3,0.5,0.5,1,16199
7cd4d454aa3a42b29aedd90e91a1321ad3c4e2d3,1,Jaimin Jetly,2014-10-03 10:49:43-07:00,['401fb199381bd04d7fab63f102f5d64e94572cc8'],0,53,53,18785161,4,0.967741935,0.967741935,1,16200
bde50b34b5cd26a98780092237646378f75877c1,0,Siddharth Wagle,2014-10-03 11:14:50-07:00,['7cd4d454aa3a42b29aedd90e91a1321ad3c4e2d3'],3,3,6,18785167,1,,,,16200
d0c85e5311a2056b5f41351f3ecd8b50da263aa8,1,tbeerbower,2014-10-03 14:55:15-04:00,['bde50b34b5cd26a98780092237646378f75877c1'],9,114,123,18785290,1,0.405405405,1,0.108108108,16200
c2726070aaa3f0b9ad24001be91b6953f3fbc761,1,Andrew Onishuk,2014-10-03 22:13:33+03:00,['d0c85e5311a2056b5f41351f3ecd8b50da263aa8'],0,16,16,18785306,2,,,,16200
30bdc96f8f3f7519e4006c2bc61d6b6daed494ac,1,Srimanth Gunturi,2014-10-03 12:32:03-07:00,['c2726070aaa3f0b9ad24001be91b6953f3fbc761'],8,16,24,18785330,3,,,,16200
ddabf125b5d7b0eda5d2fe6b8f56be9b5a5dc0ca,1,Alejandro Fernandez,2014-10-03 14:03:52-07:00,['30bdc96f8f3f7519e4006c2bc61d6b6daed494ac'],0,6,6,18785336,1,1,1,1,16200
546f0eadebe9afbee9dc449db6cea04d6a7c1a24,0,Alejandro Fernandez,2014-10-03 14:04:23-07:00,['ddabf125b5d7b0eda5d2fe6b8f56be9b5a5dc0ca'],0,6,6,18785342,1,,,,16200
5e0010e276999fcabbb6cbe1c12742a33d05607b,0,Alejandro Fernandez,2014-10-03 14:07:26-07:00,['546f0eadebe9afbee9dc449db6cea04d6a7c1a24'],6,0,6,18785348,1,,,,16200
4b0ff93019793425f8c6a4ede38f63a9f2da4256,1,Srimanth Gunturi,2014-10-03 14:07:50-07:00,['5e0010e276999fcabbb6cbe1c12742a33d05607b'],1,9,10,18785358,2,0.125,0,1,16200
e069b3076cd2d56671f3322e64b09e84e7643216,0,Yusaku Sako,2014-10-03 16:58:08-07:00,['4b0ff93019793425f8c6a4ede38f63a9f2da4256'],4,12,16,18785374,1,,,,16200
3e54f95689d7854fc17a31a2734aea080efd7d71,1,Jonathan Hurley,2014-10-03 23:13:44-04:00,['6f9398f0ff45da86c001eb86322695a3d76b7232'],153,1280,1433,18786807,18,0.153374233,0.45603272,0.979550102,16205
445a53cf5bcbba89ff04131d9802e205bfc3ab42,0,Jonathan Hurley,2014-10-03 23:15:57-04:00,"['3e54f95689d7854fc17a31a2734aea080efd7d71', 'e069b3076cd2d56671f3322e64b09e84e7643216']",2534,7478,10012,18796819,207,,,,16205
0e959b0ed80fc1a170cc10b1c75050c88a7b2d06,0,tbeerbower,2014-10-04 17:35:33-04:00,['e069b3076cd2d56671f3322e64b09e84e7643216'],32,36,68,18796887,3,0,0,0,16205
26c4cc800dd87802e5758576629c1313bd11db3d,1,Oleg Nechiporenko,2014-10-06 13:51:00+03:00,['0e959b0ed80fc1a170cc10b1c75050c88a7b2d06'],51,148,199,18797086,4,1,1,1,16206
7f0ea265c877b665e4744272fc4bd2c72e698bcb,0,Dmytro Sen,2014-10-06 14:52:30+03:00,['26c4cc800dd87802e5758576629c1313bd11db3d'],0,3,3,18797089,2,,,,16206
bb1b5135bd6ec9f872232a1000d7b683f57b6bff,1,Dmytro Sen,2014-10-06 15:26:20+03:00,['7f0ea265c877b665e4744272fc4bd2c72e698bcb'],3,86,89,18797178,4,0,1,1,16206
5ce6ebfcbd4b3ec6f1e0e342347d5a083300d40a,1,Subin,2014-10-06 20:17:26+05:18,['bb1b5135bd6ec9f872232a1000d7b683f57b6bff'],7,40,47,18797225,6,0.85,0,1,16206
76e3bb4ba1528173b6ed399fb2872c5a69c744f8,1,aBabiichuk,2014-10-06 18:00:23+03:00,['5ce6ebfcbd4b3ec6f1e0e342347d5a083300d40a'],1,9,10,18797235,2,1,1,1,16206
9919b3f4faf0ead6d7495d28e910f21cbc0f42f5,0,Jonathan Hurley,2014-10-06 11:12:39-04:00,"['445a53cf5bcbba89ff04131d9802e205bfc3ab42', '76e3bb4ba1528173b6ed399fb2872c5a69c744f8']",94,322,416,18797651,21,,,,16206
a5551b730b1c5111ae2fd6c1e369edded393323c,1,Andrew Onishuk,2014-10-06 19:54:49+03:00,['76e3bb4ba1528173b6ed399fb2872c5a69c744f8'],10,19,29,18797680,2,0,0.428571429,0,16206
0e869ffbfa2ecc7f3485b4ed2241ed1ed3fb28ab,0,Dmytro Sen,2014-10-06 19:55:34+03:00,['a5551b730b1c5111ae2fd6c1e369edded393323c'],0,5,5,18797685,1,,,,16206
1b06b93506beb732a6f1380e457f1d1aa1ee2595,0,tbeerbower,2014-10-06 13:07:00-04:00,['0e869ffbfa2ecc7f3485b4ed2241ed1ed3fb28ab'],527,0,527,18798212,9,0.64628821,0.64628821,0.065502183,16206
94d76a41458fc53a9ff8abb35c636c810e8b9010,1,aBabiichuk,2014-10-06 20:54:27+03:00,['1b06b93506beb732a6f1380e457f1d1aa1ee2595'],14,20,34,18798246,4,1,1,1,16206
af9ceed0f62ea58813207c04cc45a72f224b508c,1,Aleksandr Kovalenko,2014-10-06 21:22:57+03:00,['94d76a41458fc53a9ff8abb35c636c810e8b9010'],3,41,44,18798290,4,1,1,1,16207
e40a2188940909e41c38bd81d5a6072dcc008109,1,Alejandro Fernandez,2014-10-06 11:46:13-07:00,['af9ceed0f62ea58813207c04cc45a72f224b508c'],2,2,4,18798294,1,,,,16207
a619219ff6e9a812ecc283751a5c1f3e12ed182e,0,Jun Aoki,2014-10-06 11:51:07-07:00,['e40a2188940909e41c38bd81d5a6072dcc008109'],5,251,256,18798550,4,0,0.888888889,1,16209
0800415cacf997914941a3465914cf55bf2c573c,0,Lisnichenko Dmitro,2014-10-06 22:23:04+03:00,['a619219ff6e9a812ecc283751a5c1f3e12ed182e'],21,121,142,18798692,2,0,1,1,16209
811ea5860bfd27fb95aa5da04073835188742b89,0,Lisnichenko Dmitro,2014-10-06 22:55:11+03:00,['0800415cacf997914941a3465914cf55bf2c573c'],3,10,13,18798705,1,0,0,1,16209
cc2d9341336218878af81bea0cc8ee7fc2a7d9ec,0,Jonathan Hurley,2014-10-06 16:27:12-04:00,"['9919b3f4faf0ead6d7495d28e910f21cbc0f42f5', '811ea5860bfd27fb95aa5da04073835188742b89']",585,469,1054,18799759,26,,,,16209
0d953b46868580a99c56d806994ee90cd299d40a,1,Lisnichenko Dmitro,2014-10-06 23:40:53+03:00,['811ea5860bfd27fb95aa5da04073835188742b89'],1,7,8,18799767,2,,,,16209
80bceaf3abc8028e7d6b9f9d3a7738132ece6b8a,0,Jonathan Hurley,2014-10-06 17:02:54-04:00,"['0d953b46868580a99c56d806994ee90cd299d40a', 'cc2d9341336218878af81bea0cc8ee7fc2a7d9ec']",1292,18299,19591,18819358,181,,,,16209
4a4b0e69353d9cc675632e71f31c9c90db337166,0,Srimanth Gunturi,2014-10-06 14:09:07-07:00,['80bceaf3abc8028e7d6b9f9d3a7738132ece6b8a'],3,0,3,18819361,1,0,0,0,16209
5b60658766856232b1198a21866db2aefe655662,1,tbeerbower,2014-10-06 19:12:23-04:00,['4a4b0e69353d9cc675632e71f31c9c90db337166'],0,48,48,18819409,2,0,0.08,0.84,16209
6b8ecd54c5a25e65fb43df8cca15dc69bd32ee5e,0,Siddharth Wagle,2014-10-06 16:32:14-07:00,['5b60658766856232b1198a21866db2aefe655662'],86,205,291,18819700,7,0,1,1,16209
bba0d5446c3af8394a82c72d844deaf88d77d661,0,atkach,2014-10-07 11:48:38+03:00,['6b8ecd54c5a25e65fb43df8cca15dc69bd32ee5e'],2,2,4,18819704,1,,,,16209
7d3235638b40f33dfc0728fef47ba4d5b4bacd97,1,aBabiichuk,2014-10-07 13:45:22+03:00,['bba0d5446c3af8394a82c72d844deaf88d77d661'],0,1,1,18819705,1,0,0,1,16209
dfbb11fcc436acd288f7a036eb4030e558b685e6,1,aBabiichuk,2014-10-07 13:45:41+03:00,['7d3235638b40f33dfc0728fef47ba4d5b4bacd97'],3,25,28,18819733,3,0.75,0.75,0.875,16209
90438f4cb14c7b582205a97434ce7030b5901a1d,1,aBabiichuk,2014-10-07 14:25:54+03:00,['dfbb11fcc436acd288f7a036eb4030e558b685e6'],4,7774,7778,18827511,3,0.346349467,0.738638228,0.828876128,16210
12f28db407838a643f12566bb374e424f938ebf9,1,Aleksandr Kovalenko,2014-10-07 18:08:09+03:00,['90438f4cb14c7b582205a97434ce7030b5901a1d'],2,80,82,18827593,3,0,1,1,16211
2a00559013bf0d8efce972cb4b73b14d92eecc94,1,Oleg Nechiporenko,2014-10-07 18:20:26+03:00,['12f28db407838a643f12566bb374e424f938ebf9'],60,280,340,18827933,15,1,1,1,16213
45c2a9d9eb1739f39a250a7633e7808cfe30bbbe,1,Yusaku Sako,2014-10-07 09:36:06-07:00,['2a00559013bf0d8efce972cb4b73b14d92eecc94'],205,86,291,18828224,7,1,0,0,16213
86798709cc554f18dc47550951652f86058753a6,1,Aleksandr Kovalenko,2014-10-07 20:06:05+03:00,['45c2a9d9eb1739f39a250a7633e7808cfe30bbbe'],4,6,10,18828234,2,0,0,1,16213
d2e82f4ccfe0e999bfb4cbb1f537c1e3d7c4457f,1,John Speidel,2014-10-07 13:29:30-04:00,['86798709cc554f18dc47550951652f86058753a6'],37,57,94,18828328,2,0.125,0,1,16213
f702bb529d98016c6a5ec7dfd1a953f9e6178cda,1,Jonathan Hurley,2014-10-07 14:11:58-04:00,['d2e82f4ccfe0e999bfb4cbb1f537c1e3d7c4457f'],8,42,50,18828378,3,0.588235294,0.647058824,0.647058824,16213
31d8208b8ba2bf87bb089532a8fe093ef606385f,1,Siddharth Wagle,2014-10-07 11:14:00-07:00,['f702bb529d98016c6a5ec7dfd1a953f9e6178cda'],89,224,313,18828691,9,0.058823529,1,1,16213
0a0186b157df86e3f3f4a721da8f708e77a19a5d,0,Siddharth Wagle,2014-10-07 12:31:49-07:00,['31d8208b8ba2bf87bb089532a8fe093ef606385f'],1,0,1,18828692,1,,,,16213
e0cea9ceb48dc4925479a347f13f3e33a0cc8492,0,Alejandro Fernandez,2014-10-07 13:37:41-07:00,['0a0186b157df86e3f3f4a721da8f708e77a19a5d'],7,5,12,18828704,1,,,,16213
d6024ce70f064da7eb878d0698fcb9a63d8a1e42,1,Alejandro Fernandez,2014-10-07 13:49:04-07:00,['e0cea9ceb48dc4925479a347f13f3e33a0cc8492'],0,6,6,18828710,1,,,,16213
b688a41d81d216cdf2fc5a30d2e9561dd6af87d6,0,Yusaku Sako,2014-10-07 16:01:38-07:00,['d6024ce70f064da7eb878d0698fcb9a63d8a1e42'],2,2,4,18828714,1,,,,16213
fd71af109c8fad6ea86753b080ccb23f0847005c,1,Yusaku Sako,2014-10-07 16:49:37-07:00,['b688a41d81d216cdf2fc5a30d2e9561dd6af87d6'],34,34,68,18828782,2,,,,16213
f072da354d2c2fd5fd87cb7bd18a4541a87e292c,1,Siddharth Wagle,2014-10-07 17:42:44-07:00,['fd71af109c8fad6ea86753b080ccb23f0847005c'],12,79,91,18828873,3,0.132075472,0.924528302,1,16213
760e9b7504aa7927ea78e6eb02c97b14fa98b1a2,1,Lisnichenko Dmitro,2014-10-08 14:04:05+03:00,['f072da354d2c2fd5fd87cb7bd18a4541a87e292c'],3,72,75,18828948,2,0.040816327,0.93877551,1,16213
48ede6cfcee28cc36a8b1504b4515cd41824e064,1,atkach,2014-10-08 15:00:33+03:00,['760e9b7504aa7927ea78e6eb02c97b14fa98b1a2'],127,862,989,18829937,5,0.923558897,1,1,16214
3403160f555c9a655042d052c51dcf8eb2e9cc44,1,Dmytro Sen,2014-10-08 15:59:41+03:00,['48ede6cfcee28cc36a8b1504b4515cd41824e064'],3,3,6,18829943,1,,,,16214
54a3de777f58ebd0b0ff5801f6b0c8e522024780,1,Myroslav Papirkovskyy,2014-10-08 17:09:23+03:00,['3403160f555c9a655042d052c51dcf8eb2e9cc44'],5,185,190,18830133,3,0.246031746,1,0.738095238,16214
8ad5abd75c9f790df9df9f054fc32da6eafd4c43,0,atkach,2014-10-08 18:34:24+03:00,['54a3de777f58ebd0b0ff5801f6b0c8e522024780'],3,9,12,18830145,3,0,1,1,16214
4ccdde45189fadab080fd814ac243b8bc3eb345a,1,Dmytro Sen,2014-10-08 18:40:55+03:00,['8ad5abd75c9f790df9df9f054fc32da6eafd4c43'],14,30,44,18830189,10,0,0.666666667,1,16214
5343d1f671a237fffd3657788bf7abeef5b8504b,1,Oleg Nechiporenko,2014-10-08 19:00:10+03:00,['8ad5abd75c9f790df9df9f054fc32da6eafd4c43'],2886,1106,3992,18834181,10,0.675,1,1,16215
08fe86d261f5b50e396bc347b73c4561d5fc0ec1,0,Oleg Nechiporenko,2014-10-08 19:04:51+03:00,"['5343d1f671a237fffd3657788bf7abeef5b8504b', '4ccdde45189fadab080fd814ac243b8bc3eb345a']",14,30,44,18834225,10,,,,16215
15443f79afcc7d20f7fe6ea01518236ae17ec7f6,0,aBabiichuk,2014-10-08 19:06:07+03:00,['08fe86d261f5b50e396bc347b73c4561d5fc0ec1'],15,4,19,18834244,1,,,,16215
a1613b0ff2ca83d66d427a2144356b5fc419f9ee,0,Vitaly Brodetskyi,2014-10-08 13:11:58+03:00,['15443f79afcc7d20f7fe6ea01518236ae17ec7f6'],0,3,3,18834247,1,,,,16215
edef266e7a5985f2e551278bfc47204c8c41c8b0,1,atkach,2014-10-08 20:16:06+03:00,['a1613b0ff2ca83d66d427a2144356b5fc419f9ee'],9,3,12,18834259,3,1,0,0,16215
0b7fcf6f39a032dbfd41242bba5af6439c6ef9f0,1,Andrew Onishuk,2014-10-08 20:58:17+03:00,['edef266e7a5985f2e551278bfc47204c8c41c8b0'],59,259,318,18834577,18,0.324324324,0.594594595,0.405405405,16218
eb563008d33c8da0fbf2289123b2daee07269ed0,1,Andrew Onishuk,2014-10-08 20:59:55+03:00,['0b7fcf6f39a032dbfd41242bba5af6439c6ef9f0'],22,84,106,18834683,2,0.565217391,0.826086957,1,16218
c764a574fe8f5c6807a9677228da3ef2938d34ec,1,Jun Aoki,2014-10-08 11:40:13-07:00,['eb563008d33c8da0fbf2289123b2daee07269ed0'],0,351,351,18835034,7,0.180851064,1,1,16224
eb8f23d2c4e90777cc6f114f9bf1d868e1cefbb3,1,Srimanth Gunturi,2014-10-08 11:55:26-07:00,['c764a574fe8f5c6807a9677228da3ef2938d34ec'],5,31,36,18835070,5,0,0.357142857,1,16224
7627eecfadfa46cedbba3955c2d34d2432a93266,1,Srimanth Gunturi,2014-10-08 13:13:30-07:00,['eb8f23d2c4e90777cc6f114f9bf1d868e1cefbb3'],9,262,271,18835341,12,1,1,0.881481481,16224
ac31c6b7ffde4274bc54a1c8531798f2c31a31d9,1,Jonathan Hurley,2014-10-08 22:11:20-04:00,['7627eecfadfa46cedbba3955c2d34d2432a93266'],150,143,293,18835634,37,0,0,1,16224
e98948acda3f4900e28073e1f764928fbf5f2aa2,1,Srimanth Gunturi,2014-10-08 19:48:28-07:00,['ac31c6b7ffde4274bc54a1c8531798f2c31a31d9'],3,138,141,18835775,1,0.043478261,0.304347826,1,16224
6e731837cea7967f71a1dde15e542c8014a7d6cf,1,Srimanth Gunturi,2014-10-08 20:14:42-07:00,['e98948acda3f4900e28073e1f764928fbf5f2aa2'],2,8,10,18835785,1,,,,16224
3f1c15ce5565d8ad4ea98f323595934ebd08d10d,1,atkach,2014-10-09 15:46:14+03:00,['6e731837cea7967f71a1dde15e542c8014a7d6cf'],4,16,20,18835805,4,0,1,1,16224
0d2a34daad9b235d41e446874c8afdb7d184dec7,0,Lisnichenko Dmitro,2014-10-09 18:18:58+03:00,['3f1c15ce5565d8ad4ea98f323595934ebd08d10d'],6,5,11,18835816,1,1,1,0,16224
c5e09dadbfda5472d403277681275c391d55c26c,0,Dmytro Sen,2014-10-09 18:21:56+03:00,['0d2a34daad9b235d41e446874c8afdb7d184dec7'],1,3,4,18835820,2,,,,16224
e41a19201e359b14127f8e35f3179e9163fec109,0,Andrew Onishuk,2014-10-09 20:07:01+03:00,['c5e09dadbfda5472d403277681275c391d55c26c'],2,2,4,18835824,1,,,,16224
c5495dd879846e689dccf53fb4d6c4985e17df60,1,Dmytro Sen,2014-10-09 21:34:44+03:00,['e41a19201e359b14127f8e35f3179e9163fec109'],94,103,197,18836021,26,0.5,1,1,16224
edbd1f7d4eb3509ceb29d54b40445a8bcaf8f1c3,1,Jun Aoki,2014-10-09 13:39:22-07:00,['c5495dd879846e689dccf53fb4d6c4985e17df60'],11,38,49,18836070,5,1,1,1,16224
908307f804b5de250b7eb74d07b4ff4371f1a4e1,1,tbeerbower,2014-10-09 17:00:07-04:00,['edbd1f7d4eb3509ceb29d54b40445a8bcaf8f1c3'],8,370,378,18836448,5,1,1,1,16226
cf8e48d9d71cf45bffa7b325e4a62bcc94049646,1,Sumit Mohanty,2014-10-09 16:16:10-07:00,['908307f804b5de250b7eb74d07b4ff4371f1a4e1'],49,94,143,18836591,9,1,0,0,16227
06f54386c30a5c5f54d8308e4582e065cf1e88f7,1,Srimanth Gunturi,2014-10-09 16:34:28-07:00,['cf8e48d9d71cf45bffa7b325e4a62bcc94049646'],17,36,53,18836644,1,0,1,1,16227
4d5d882db57041898be7286dfd948e6e8a946202,0,Jun Aoki,2014-10-09 17:20:13-07:00,['06f54386c30a5c5f54d8308e4582e065cf1e88f7'],11,221,232,18836876,2,1,1,1,16227
6ebbddd053e05ba893c7afa94474c839e33b4d46,1,Srimanth Gunturi,2014-10-09 18:10:38-07:00,['4d5d882db57041898be7286dfd948e6e8a946202'],11,29,40,18836916,4,0.222222222,1,1,16227
ab532a54bd2ebf851edeb82a3866a56f72a54557,0,Jaimin Jetly,2014-10-09 18:16:52-07:00,['6ebbddd053e05ba893c7afa94474c839e33b4d46'],16,50,66,18836982,3,0.96875,1,1,16227
3d7fa6a44c26ead72c5ee08ab6b7374d03a34fff,1,Lisnichenko Dmitro,2014-10-10 11:11:19+03:00,['ab532a54bd2ebf851edeb82a3866a56f72a54557'],32,65,97,18837079,10,0,0,0,16227
34741fe383e67ea3615deeda29597bbbbc973c13,1,aBabiichuk,2014-10-10 12:43:35+03:00,['3d7fa6a44c26ead72c5ee08ab6b7374d03a34fff'],3,13,16,18837095,4,0.818181818,0.818181818,0.909090909,16227
1fd8eb6658d22012535060cc42fbcf879795b854,1,Oleg Nechiporenko,2014-10-10 14:01:33+03:00,['34741fe383e67ea3615deeda29597bbbbc973c13'],18,297,315,18837410,9,0.241245136,1,1,16227
196b4df7da885c84b286646bf1859a358f78530e,1,atkach,2014-10-10 15:05:00+03:00,['1fd8eb6658d22012535060cc42fbcf879795b854'],0,49,49,18837459,4,,,,16227
b422c21f3d2465d5464596a291a30be6eb4e0245,1,Lisnichenko Dmitro,2014-10-10 15:55:22+03:00,['196b4df7da885c84b286646bf1859a358f78530e'],0,12,12,18837471,1,,,,16227
923128f60ca39cb3f65374d92686bbf328f68f8c,0,Dmytro Sen,2014-10-10 16:11:36+03:00,['b422c21f3d2465d5464596a291a30be6eb4e0245'],20,17,37,18837508,2,1,0,0,16227
7f2f04eccd2d7c34ea321837ae64796b37f2c9c3,1,aBabiichuk,2014-10-10 16:50:41+03:00,['923128f60ca39cb3f65374d92686bbf328f68f8c'],21,167,188,18837696,7,0.760683761,1,0.572649573,16228
0d9a9ef6d5afbb192d9dd3389620b05f8acc9da6,1,atkach,2014-10-10 17:25:35+03:00,['7f2f04eccd2d7c34ea321837ae64796b37f2c9c3'],0,2,2,18837698,1,0,0,1,16228
6e4e2b9051e552ae6d37a3b3d710a7a4bd77a953,0,Aleksandr Kovalenko,2014-10-10 17:46:22+03:00,['0d9a9ef6d5afbb192d9dd3389620b05f8acc9da6'],3,6,9,18837707,1,0,1,1,16228
67c69f29d4264f212120874e5b90b0089e52c329,1,Aleksandr Kovalenko,2014-10-10 18:11:43+03:00,['6e4e2b9051e552ae6d37a3b3d710a7a4bd77a953'],6,3,9,18837716,1,1,0,0,16228
8f8778bffda51a95bd69217a60acc2a325d71575,1,Aleksandr Kovalenko,2014-10-10 18:12:54+03:00,['67c69f29d4264f212120874e5b90b0089e52c329'],21,1,22,18837738,1,0,0,0,16228
f38162a8b4a6873c1a3001e8c00c2eb6db1c74e2,1,Aleksandr Kovalenko,2014-10-10 18:15:26+03:00,['8f8778bffda51a95bd69217a60acc2a325d71575'],3,6,9,18837747,1,0,1,1,16228
57bded5f23ef526cc92b94e6d8019670d797faf6,1,Aleksandr Kovalenko,2014-10-10 18:36:56+03:00,['f38162a8b4a6873c1a3001e8c00c2eb6db1c74e2'],6,94,100,18837847,4,0.5,1,0.867647059,16229
9d7f877f450175a285c8c67f6c9b0afd29f7007c,1,Andrew Onishuk,2014-10-10 19:27:14+03:00,['57bded5f23ef526cc92b94e6d8019670d797faf6'],8,10,18,18837865,2,0,1,1,16229
d9c3838913f8c9f959c3543d4898483cb851f877,1,Andrew Onishuk,2014-10-10 19:45:46+03:00,['9d7f877f450175a285c8c67f6c9b0afd29f7007c'],26,48,74,18837939,14,0.125,0.9375,0,16229
8ff254b4dcea31c02faff2bef7173a18b2a1d12e,1,Dmytro Sen,2014-10-10 20:05:34+03:00,['d9c3838913f8c9f959c3543d4898483cb851f877'],7,29,36,18837975,3,1,1,1,16229
9a57ede5d35103b50ea3200de52cae6b7076db58,1,Alejandro Fernandez,2014-10-10 10:37:08-07:00,['8ff254b4dcea31c02faff2bef7173a18b2a1d12e'],29,59,88,18838063,2,0,1,1,16229
61248e6aee9b78ccb1bb603772eeb1bcb7cf6891,1,Andrew Onishuk,2014-10-10 22:23:57+03:00,['9a57ede5d35103b50ea3200de52cae6b7076db58'],16,416,432,18838495,3,0.077922078,1,0.978354978,16230
effc64c1e87fc5a73195c56dffeabe4c3b76e5b2,1,Yusaku Sako,2014-10-10 14:41:28-07:00,['61248e6aee9b78ccb1bb603772eeb1bcb7cf6891'],0,1,1,18838496,1,,,,16230
b86e49abe39fc8509c71913a830c420a77df181b,1,Alejandro Fernandez,2014-10-10 20:14:18-07:00,['effc64c1e87fc5a73195c56dffeabe4c3b76e5b2'],40,87,127,18838623,4,1,1,0.5,16231
aa837da8ed53c64bd2dacc90335e9c9f263432e8,0,aBabiichuk,2014-10-11 09:25:33+03:00,['b86e49abe39fc8509c71913a830c420a77df181b'],1,79,80,18838703,2,0.348837209,1,1,16231
ffb8e3fa016601259fd9030ab92cd2265a39482e,1,ababiichuk,2014-10-11 14:54:41+03:00,['aa837da8ed53c64bd2dacc90335e9c9f263432e8'],2,129,131,18838834,5,0.333333333,1,0.433333333,16231
07242605371b7f72f54430f40b41658128150d7a,1,Dmytro Sen,2014-10-11 16:02:34+03:00,['ffb8e3fa016601259fd9030ab92cd2265a39482e'],3,3,6,18838840,2,,,,16231
c826bcf064b3f69763d61c4a9bb8a1c604104312,1,Oleg Nechiporenko,2014-10-11 18:35:02+03:00,['07242605371b7f72f54430f40b41658128150d7a'],5,37,42,18838882,2,0,0.866666667,1,16231
183ab7a801b2425bd9db57491e8809de0b7dcd71,1,Andrew Onishuk,2014-10-12 12:05:05+03:00,['c826bcf064b3f69763d61c4a9bb8a1c604104312'],4,13,17,18838899,2,0,1,0,16231
4862ae3b380df448a4dd8d91d96ba06cd109adff,1,atkach,2014-10-12 14:03:53+03:00,['183ab7a801b2425bd9db57491e8809de0b7dcd71'],103,202,305,18839204,6,0.486956522,1,0.92173913,16231
9c27eaf0e83068f33be8163526236858e34b41ad,1,Andrew Onishuk,2014-10-12 15:16:50+03:00,['4862ae3b380df448a4dd8d91d96ba06cd109adff'],6,8,14,18839218,1,1,1,0,16231
2db973144de76f596bf88df82eef236bb5a3ecca,1,atkach,2014-10-12 15:49:16+03:00,['9c27eaf0e83068f33be8163526236858e34b41ad'],1,1,2,18839220,1,,,,16231
d6d1ffa6d382e24fc76ea7a022e1c42817865c5e,1,ababiichuk,2014-10-12 18:22:03+03:00,['2db973144de76f596bf88df82eef236bb5a3ecca'],2,3,5,18839225,1,,,,16231
61f63e3ad0ae1711dface64a4694837afa2d55db,1,Siddharth Wagle,2014-10-12 09:09:14-07:00,['d6d1ffa6d382e24fc76ea7a022e1c42817865c5e'],154,283,437,18839662,9,1,1,0.961538462,16231
4bbaf7f2a571ec7937954e3ca2ddaa226a168c0e,1,Siddharth Wagle,2014-10-12 09:09:15-07:00,['61f63e3ad0ae1711dface64a4694837afa2d55db'],16,695,711,18840373,17,0.558052434,0.737827715,0.91011236,16236
19eeff5511af4881d188871102e065e0a67a16cd,0,tbeerbower,2014-10-12 14:45:07-04:00,['4bbaf7f2a571ec7937954e3ca2ddaa226a168c0e'],38,333,371,18840744,1,,,,16236
03784ecad819a6b6ee422b4ba6158e9d860f3655,1,Jonathan Hurley,2014-10-12 20:27:04-04:00,['19eeff5511af4881d188871102e065e0a67a16cd'],83,1433,1516,18842260,24,0.247916667,0.772916667,0.970833333,16244
1dfe7fd93a5800a95baf8939f291b1208cabe18e,1,Jonathan Hurley,2014-10-12 20:59:11-04:00,['03784ecad819a6b6ee422b4ba6158e9d860f3655'],4,4,8,18842268,1,0,0,1,16244
cabbcfcb40d7b8893efd1055be87d2ab7ac5023f,1,Jaimin Jetly,2014-10-12 23:00:43-07:00,['1dfe7fd93a5800a95baf8939f291b1208cabe18e'],9,1381,1390,18843658,28,0.643410853,0.968992248,0.937984496,16258
4c62073d85febb22f483c7930df0ca60439c3fb8,1,aBabiichuk,2014-10-13 15:43:33+03:00,['cabbcfcb40d7b8893efd1055be87d2ab7ac5023f'],12,29,41,18843699,4,0.875,0.875,0.875,16258
442ccdd4f98579943118307cb86d33583e0eec80,1,Lisnichenko Dmitro,2014-10-13 17:07:35+03:00,['4c62073d85febb22f483c7930df0ca60439c3fb8'],13,24,37,18843736,2,,,,16258
f1a9a949214a727d0af51d0cdc25dfb4020f9124,0,Aleksandr Kovalenko,2014-10-13 18:48:02+03:00,['442ccdd4f98579943118307cb86d33583e0eec80'],6,1,7,18843743,2,1,1,0,16258
5af225e60bb21aea4c2d60a0a966c268d4cb3711,0,aBabiichuk,2014-10-13 19:39:34+03:00,['f1a9a949214a727d0af51d0cdc25dfb4020f9124'],17,13,30,18843773,2,0,0,0,16258
d383ebb3912df9fe43044143c0e4ee039efead62,1,Dmytro Sen,2014-10-13 20:16:40+03:00,['5af225e60bb21aea4c2d60a0a966c268d4cb3711'],11,208,219,18843992,11,0.282894737,1,1,16258
f489f0b2ff13e92cb286307e4a108824a2d725e7,1,Jaimin Jetly,2014-10-13 10:51:42-07:00,['d383ebb3912df9fe43044143c0e4ee039efead62'],4,4,8,18844000,2,,,,16258
62542465b1ee3c3e2051984695826abf841dcc41,1,Vitaly Brodetskyi,2014-10-13 19:53:58+03:00,['f489f0b2ff13e92cb286307e4a108824a2d725e7'],13,73,86,18844086,2,0.935483871,0.35483871,0,16258
a0d37dcc32a0bae71ca8d5daaa05a3f5075e7cd8,1,Alejandro Fernandez,2014-10-13 11:18:40-07:00,['62542465b1ee3c3e2051984695826abf841dcc41'],14,77,91,18844177,5,,,,16259
535bcb476b6ef41f11d738ece7b5cf63a4d7b232,1,Jun Aoki,2014-10-13 15:40:35-07:00,['a0d37dcc32a0bae71ca8d5daaa05a3f5075e7cd8'],0,1,1,18844178,1,,,,16259
6cf98ff4abe352f0bfaf33dbf731b85f13ed454f,1,Alejandro Fernandez,2014-10-13 17:03:35-07:00,['535bcb476b6ef41f11d738ece7b5cf63a4d7b232'],1,204,205,18844383,6,1,1,1,16263
a5716364cba4cbbd58c55d915b3ac0e86433dca3,0,Jun Aoki,2014-10-13 17:13:02-07:00,['6cf98ff4abe352f0bfaf33dbf731b85f13ed454f'],3,42,45,18844428,5,0.848484848,0.878787879,1,16263
8eb52d4cfa4ec82ffa5f8b234d9c39f5f6408c6d,0,tbeerbower,2014-10-13 23:38:01-04:00,['a5716364cba4cbbd58c55d915b3ac0e86433dca3'],19,92,111,18844539,2,0,0.886363636,0.113636364,16263
264b55ff1b461aa175691685c5673ec87ca4daf2,1,Srimanth Gunturi,2014-10-14 01:05:50-07:00,['8eb52d4cfa4ec82ffa5f8b234d9c39f5f6408c6d'],28,81,109,18844648,4,0.5,1,0.411764706,16263
f8acccbab97298cae4dda0ef032b399cbd04a349,1,Yusaku Sako,2014-10-14 03:41:24-07:00,['264b55ff1b461aa175691685c5673ec87ca4daf2'],0,71,71,18844719,1,1,1,1,16264
1ad425fc3a284490130bad2ac2177c3df07b19e7,1,Aleksandr Kovalenko,2014-10-14 14:03:59+03:00,['f8acccbab97298cae4dda0ef032b399cbd04a349'],3,3,6,18844725,2,,,,16264
e15399aa05c944f19ade734e63c3a79c5b631848,1,tbeerbower,2014-10-14 09:16:37-04:00,['1ad425fc3a284490130bad2ac2177c3df07b19e7'],21,80,101,18844826,3,0.088235294,0.852941176,1,16264
a50ac9d13d54156bad1b15cfb58f151f96ee8683,1,Lisnichenko Dmitro,2014-10-14 16:25:21+03:00,['e15399aa05c944f19ade734e63c3a79c5b631848'],0,36,36,18844862,3,,,,16264
abd9fcacbf05c6fed8509ee689c9c342d28ce960,1,Lisnichenko Dmitro,2014-10-14 16:32:09+03:00,['a50ac9d13d54156bad1b15cfb58f151f96ee8683'],13,275,288,18845150,8,0.071428571,0.714285714,0.517857143,16268
66f442c8acb3cd36f563099d12023cf902d7ce88,0,Andrew Onishuk,2014-10-14 16:45:41+03:00,['abd9fcacbf05c6fed8509ee689c9c342d28ce960'],19,4,23,18845173,4,,,,16268
a1bb3bc90b14d1404f177462bc40130fb49fa0b5,1,Jonathan Hurley,2014-10-14 09:51:45-04:00,['66f442c8acb3cd36f563099d12023cf902d7ce88'],47,123,170,18845343,9,0,0,1,16268
a97d5c6f27fbffbbecf2eea7bb9d36d120b8a158,1,tbeerbower,2014-10-14 10:54:55-04:00,['a1bb3bc90b14d1404f177462bc40130fb49fa0b5'],9,11,20,18845363,2,1,1,1,16268
61c8f5f982df4d2d74156dda2af63f67b09616f0,1,Oleg Nechiporenko,2014-10-14 18:05:37+03:00,['a97d5c6f27fbffbbecf2eea7bb9d36d120b8a158'],17,134,151,18845514,5,0.795180723,1,1,16269
3e873a95037adb2f49f83c74cc0a44fcd2fbac6d,0,Artem Baranchuk,2014-10-14 19:14:09+03:00,['61c8f5f982df4d2d74156dda2af63f67b09616f0'],43,63,106,18845620,3,1,1,1,16269
73b780206568a107fdb56dc95bf90f66eeb82f8a,1,Lisnichenko Dmitro,2014-10-14 20:38:42+03:00,['3e873a95037adb2f49f83c74cc0a44fcd2fbac6d'],0,14,14,18845634,1,,,,16269
c6d0056867bb8a20471511a7be9004d5a71e4645,1,Yusaku Sako,2014-10-14 15:06:54-07:00,['73b780206568a107fdb56dc95bf90f66eeb82f8a'],1,1,2,18845636,1,,,,16269
4b63b0958d56aa15116e67f412bdd66a61dd451c,1,Jaimin Jetly,2014-10-14 18:04:21-07:00,['c6d0056867bb8a20471511a7be9004d5a71e4645'],1,1,2,18845638,1,,,,16269
088da07d45e4f89561266b07c2b301c10bdb2df4,0,Alejandro Fernandez,2014-10-14 18:11:08-07:00,['4b63b0958d56aa15116e67f412bdd66a61dd451c'],3,7,10,18845648,1,,,,16269
fb82ca57c490a6b749f61138f309f2fd16ceff92,1,Srimanth Gunturi,2014-10-14 21:42:09-07:00,['088da07d45e4f89561266b07c2b301c10bdb2df4'],1,193,194,18845842,6,0.760330579,1,0.94214876,16269
e6cd915a795958226caa2fe87ef7ae6bb519ab86,1,Srimanth Gunturi,2014-10-14 22:09:47-07:00,['fb82ca57c490a6b749f61138f309f2fd16ceff92'],79,98,177,18846019,4,0.375,1,1,16269
6b888324889c691550f00aead1ec0a0544f30c11,1,aBabiichuk,2014-10-15 14:14:19+03:00,['e6cd915a795958226caa2fe87ef7ae6bb519ab86'],36,61,97,18846116,5,0,0.833333333,0,16270
d1c082c969988f9de1d46f4295eda56cdaffd32b,1,atkach,2014-10-15 15:20:17+03:00,['6b888324889c691550f00aead1ec0a0544f30c11'],101,113,214,18846330,2,0,1,1,16270
ecacc6a06b99f15c4a1ae27bc65282050e45c793,1,Andrew Onishuk,2014-10-15 15:36:12+03:00,['d1c082c969988f9de1d46f4295eda56cdaffd32b'],28,10,38,18846368,2,1,0,1,16270
32187893edabcfc29f1cfb4961146566c2215433,1,Andrew Onishuk,2014-10-15 15:40:00+03:00,['ecacc6a06b99f15c4a1ae27bc65282050e45c793'],219,431,650,18847018,50,0.804878049,0.93902439,0.987804878,16272
cc03038516e479cec099a927d8e3104e1c5fb062,1,aBabiichuk,2014-10-15 16:10:03+03:00,['32187893edabcfc29f1cfb4961146566c2215433'],21,232,253,18847271,10,0.893854749,0.899441341,0.944134078,16274
dd086a5bb4acc54bdb3540374fa62f47df9cf721,0,Andrew Onishuk,2014-10-15 16:30:52+03:00,['cc03038516e479cec099a927d8e3104e1c5fb062'],35,35,70,18847341,3,0,0,1,16274
25acb64ef46d19ac664a1cfb4c80d940d7cfb761,1,Dmytro Sen,2014-10-15 16:59:40+03:00,['dd086a5bb4acc54bdb3540374fa62f47df9cf721'],1,2,3,18847344,1,1,1,1,16274
da27f4124d91f3b1f037703b60b24769cb32adcd,1,atkach,2014-10-15 18:35:32+03:00,['25acb64ef46d19ac664a1cfb4c80d940d7cfb761'],111,553,664,18848008,8,0.483091787,0.968599034,0.961352657,16276
ac657bd98219cb3c08f8c3907d71c782ecfda54c,1,Dmytro Sen,2014-10-15 18:40:13+03:00,['da27f4124d91f3b1f037703b60b24769cb32adcd'],16,8,24,18848032,3,,,,16276
f3de31a886281991c8dfa129aa8b62d456cb1c67,1,Jaimin Jetly,2014-10-15 09:43:46-07:00,['ac657bd98219cb3c08f8c3907d71c782ecfda54c'],52,88,140,18848172,2,0.322580645,0.967741935,1,16276
71d79afb23e185f093f15c818894baf4254b7bd8,1,Oleg Nechiporenko,2014-10-15 19:59:06+03:00,['f3de31a886281991c8dfa129aa8b62d456cb1c67'],6,48,54,18848226,3,1,1,1,16276
a8677ebe5fcc611967f58ce7e64aa3f72af34430,1,Dmytro Sen,2014-10-15 20:14:41+03:00,['71d79afb23e185f093f15c818894baf4254b7bd8'],0,101,101,18848327,11,0,1,1,16276
13b097c3d5b49d9ca709f42d2d3a29a3c401b8e1,1,aBabiichuk,2014-10-15 20:15:24+03:00,['a8677ebe5fcc611967f58ce7e64aa3f72af34430'],45,87,132,18848459,2,0.191176471,1,1,16276
80f2e82e3ee90e59f5ab99879ff638f05684e369,1,Andrew Onishuk,2014-10-15 21:44:18+03:00,['13b097c3d5b49d9ca709f42d2d3a29a3c401b8e1'],24,39,63,18848522,2,1,1,0.181818182,16276
ec5ec6c7c29b9bbe407d73b6b808d2f1bde7e02d,0,Jaimin Jetly,2014-10-15 12:07:49-07:00,['80f2e82e3ee90e59f5ab99879ff638f05684e369'],325,0,325,18848847,8,,,,16276
3befc557a9550f0bff5fce85eacd985b57707138,1,Jonathan Hurley,2014-10-15 15:50:47-04:00,['ec5ec6c7c29b9bbe407d73b6b808d2f1bde7e02d'],267,1434,1701,18850548,23,0.451697128,1,1,16284
06f8f87d2e09b08d386b58d3bb3415b86e830a74,1,tbeerbower,2014-10-15 17:01:40-04:00,['3befc557a9550f0bff5fce85eacd985b57707138'],4,86,90,18850638,5,0.891304348,1,1,16284
a400f5a98bc361d3c15d7f21e0c4a76b69271805,0,Andrew Onishuk,2014-10-16 00:55:47+03:00,['06f8f87d2e09b08d386b58d3bb3415b86e830a74'],9,0,9,18850647,3,,,,16284
4386b4fc0005197ebbc42b57e809ce52de22ff1c,0,root,2014-10-01 04:14:56-04:00,['a400f5a98bc361d3c15d7f21e0c4a76b69271805'],31,8,39,18850686,4,,,,16284
ecb5aff2f855ee4a26eb847a9805bb48682ba0f2,1,Jun Aoki,2014-10-15 15:57:08-07:00,['4386b4fc0005197ebbc42b57e809ce52de22ff1c'],27,3813,3840,18854526,3,1,1,1,16285
7c8d4f6dc060d0b0d053dea6256baa0a5f86185f,1,Srimanth Gunturi,2014-10-15 15:58:02-07:00,['ecb5aff2f855ee4a26eb847a9805bb48682ba0f2'],196,272,468,18854994,4,0.229508197,0.327868852,0.967213115,16285
9000f43791bc476417dca20ad3b3c09c22893989,1,Srimanth Gunturi,2014-10-15 16:10:52-07:00,['7c8d4f6dc060d0b0d053dea6256baa0a5f86185f'],21,54,75,18855069,2,1,1,1,16285
718a90918bb74a91946a3f897be7b1c6930707e3,0,Andrew Onishuk,2014-10-16 14:38:24+03:00,['9000f43791bc476417dca20ad3b3c09c22893989'],16,5,21,18855090,5,1,0,0,16285
90bb18e7c47216d842caee64441878e99e659b26,1,Oleg Nechiporenko,2014-10-16 15:16:29+03:00,['718a90918bb74a91946a3f897be7b1c6930707e3'],15,51,66,18855156,2,1,1,1,16285
59d2cc8ca99cfdbb902c0a12365811f298897e43,0,Lisnichenko Dmitro,2014-10-16 16:19:17+03:00,['90bb18e7c47216d842caee64441878e99e659b26'],5,5,10,18855166,4,,,,16285
456dcb246bb575c4c84c4294a7341e77932a566f,1,tbeerbower,2014-10-16 09:46:35-04:00,['59d2cc8ca99cfdbb902c0a12365811f298897e43'],15,12,27,18855193,2,,0,,16285
d1e4a81cb24658eaf335dc91567f286093568317,1,Dmytro Sen,2014-10-16 18:32:17+03:00,['456dcb246bb575c4c84c4294a7341e77932a566f'],4,74,78,18855271,8,0,0.666666667,1,16285
7092d80d32a39e80b4f0d71c645a48f9a2090889,1,Lisnichenko Dmitro,2014-10-16 19:29:39+03:00,['d1e4a81cb24658eaf335dc91567f286093568317'],274,1632,1906,18857177,19,0.165834166,0.763236763,0.677322677,16289
799a0d54ad0dd560c37482c24290cd954d9bfeeb,1,Jaimin Jetly,2014-10-16 10:10:46-07:00,['7092d80d32a39e80b4f0d71c645a48f9a2090889'],14,1144,1158,18858335,20,0.566929134,0.960629921,0.960629921,16300
ad99289698452fe168e203d6423d9850dcc83576,1,Lisnichenko Dmitro,2014-10-16 20:54:19+03:00,['799a0d54ad0dd560c37482c24290cd954d9bfeeb'],1,4,5,18858340,1,0,0,1,16300
0a4408162d7511099aaa8725fa72322eb4b8edb8,1,Jaimin Jetly,2014-10-16 12:17:04-07:00,['ad99289698452fe168e203d6423d9850dcc83576'],16,78,94,18858434,5,0.733333333,1,1,16301
f873b147a431c539e52a74670e0d0cc16ed307e6,1,Alejandro Fernandez,2014-10-16 13:01:17-07:00,['0a4408162d7511099aaa8725fa72322eb4b8edb8'],4,59,63,18858497,4,1,0.820512821,0.846153846,16302
1be4506a460e2c7a228970a512ba8639c4cf4fd2,1,Jun Aoki,2014-10-16 13:32:26-07:00,['f873b147a431c539e52a74670e0d0cc16ed307e6'],29,75,104,18858601,8,0,0.625,1,16302
1cf2b98520914f32ac33685951fc24cfadb55be6,1,Jun Aoki,2014-10-16 14:55:36-07:00,['1be4506a460e2c7a228970a512ba8639c4cf4fd2'],69,146,215,18858816,4,1,1,0,16303
383d3e7116565fba181ec823c455867a99ff09e3,0,Siddharth Wagle,2014-10-16 17:47:54-07:00,['1cf2b98520914f32ac33685951fc24cfadb55be6'],133,254,387,18859203,2,0.464285714,1,0.869047619,16303
43ab9e61f076affb0a6fc92e39053cf0e8b6d163,0,Siddharth Wagle,2014-10-16 18:45:45-07:00,['383d3e7116565fba181ec823c455867a99ff09e3'],3,2,5,18859208,1,1,1,1,16303
336e2b1ff3984f892c4d1d8c1b3fa93a86026de9,0,Srimanth Gunturi,2014-10-16 23:07:42-07:00,['43ab9e61f076affb0a6fc92e39053cf0e8b6d163'],4,50,54,18859262,4,0.4375,0,0.65625,16303
8c59e4a3d049435e66a3332958e1a30ed8d4b347,0,Srimanth Gunturi,2014-10-16 23:36:09-07:00,['336e2b1ff3984f892c4d1d8c1b3fa93a86026de9'],1,32,33,18859295,1,,,,16303
4abb993ee4e519a6bdfa6f1bedea85563b401cac,0,atkach,2014-10-17 13:45:35+03:00,['8c59e4a3d049435e66a3332958e1a30ed8d4b347'],12,23,35,18859330,2,1,1,0.857142857,16303
48fc3507444b86fee5cc0e29d3f3a2763c98e319,0,aBabiichuk,2014-10-17 14:37:22+03:00,['4abb993ee4e519a6bdfa6f1bedea85563b401cac'],25,23,48,18859378,2,0,0,0,16303
04c3eead3bfa18e3ba4a86910117ef5e63957b3c,0,Lisnichenko Dmitro,2014-10-17 16:55:47+03:00,['48fc3507444b86fee5cc0e29d3f3a2763c98e319'],102,282,384,18859762,2,0,1,1,16303
b0f97ba843504da106477f8ef5973225e296a72d,0,Alex Antonenko,2014-10-17 17:23:20+03:00,['04c3eead3bfa18e3ba4a86910117ef5e63957b3c'],32,1,33,18859795,1,,,,16303
42d2f14ac25ea0f73a001697617dc967fe586bcd,1,Alex Antonenko,2014-10-17 17:24:03+03:00,['b0f97ba843504da106477f8ef5973225e296a72d'],50,4,54,18859849,4,0.5625,1,0.34375,16303
4f09bd6b6162d561983f5aca1bec2bd9cfbd10b1,0,Yusaku Sako,2014-10-17 07:50:17-07:00,['42d2f14ac25ea0f73a001697617dc967fe586bcd'],2,3,5,18859854,1,0,0,0,16303
1411d8e42b6a74e0b77921dd603d8100b3fafac6,0,Yusaku Sako,2014-10-17 07:51:24-07:00,['4f09bd6b6162d561983f5aca1bec2bd9cfbd10b1'],254,133,387,18860241,2,0.535714286,0,0.130952381,16303
07772c90bf57b363ba0c8d3c10d113512702bdbd,1,Oleg Nechiporenko,2014-10-17 18:23:37+03:00,['1411d8e42b6a74e0b77921dd603d8100b3fafac6'],4,36,40,18860281,5,1,1,1,16303
025adab082cb6778ef1bd06ef79bce1228cf3737,1,Vitaly Brodetskyi,2014-10-17 19:18:57+03:00,['07772c90bf57b363ba0c8d3c10d113512702bdbd'],0,6,6,18860287,1,,,,16303
c0dd81615ea35b868d425905aa63744d3847dc77,1,Aleksandr Kovalenko,2014-10-17 19:20:33+03:00,['025adab082cb6778ef1bd06ef79bce1228cf3737'],2,50,52,18860339,3,1,1,1,16303
15ce79a9551f88731cafc0d96e6c5bf69abc9386,0,Subin,2014-10-17 21:48:48+05:18,['c0dd81615ea35b868d425905aa63744d3847dc77'],17,37,54,18860393,1,0,1,1,16303
83924e09bcaa06b4e7aca855e8f8e1cae0d2edc8,1,Srimanth Gunturi,2014-10-17 10:07:46-07:00,['15ce79a9551f88731cafc0d96e6c5bf69abc9386'],4,50,54,18860447,4,0.4375,0,0.65625,16303
007cb13f1bcb87f067538f648237ce4a700f14d4,1,Srimanth Gunturi,2014-10-17 10:07:55-07:00,['83924e09bcaa06b4e7aca855e8f8e1cae0d2edc8'],2,4,6,18860453,1,0,0,1,16303
0844d54edf3d6b974d7402f8ae607c13bd4d1246,1,Srimanth Gunturi,2014-10-17 10:08:05-07:00,['007cb13f1bcb87f067538f648237ce4a700f14d4'],1,32,33,18860486,1,,,,16303
43229ade9530744f22c58dc0cb210bdf6cb47719,1,Srimanth Gunturi,2014-10-17 10:23:11-07:00,['0844d54edf3d6b974d7402f8ae607c13bd4d1246'],3,5,8,18860494,1,0,0,1,16303
ec6b44eca069721a68024b518c9531e31c24e6a0,1,Sumit Mohanty,2014-10-17 10:40:50-07:00,['43229ade9530744f22c58dc0cb210bdf6cb47719'],3,6,9,18860503,3,,,,16303
8162fd399e4c52dec4bb3611f58486416345f231,0,Jaimin Jetly,2014-10-17 10:54:59-07:00,['ec6b44eca069721a68024b518c9531e31c24e6a0'],48,70,118,18860621,3,0.090909091,1,1,16303
0ab58755d53ab2f599194aef7aa4054326aa9cfa,1,Srimanth Gunturi,2014-10-17 10:59:02-07:00,['8162fd399e4c52dec4bb3611f58486416345f231'],3,77,80,18860701,6,0.384615385,0.923076923,1,16304
75f78825bbdf7f73feb51aa60326b008f6cfb551,1,Srimanth Gunturi,2014-10-17 11:12:18-07:00,['0ab58755d53ab2f599194aef7aa4054326aa9cfa'],1,40,41,18860742,2,1,1,1,16304
a1ba750e85a3cb8b6614eb6406408d595821d5fa,1,Aleksandr Kovalenko,2014-10-17 21:36:45+03:00,['75f78825bbdf7f73feb51aa60326b008f6cfb551'],6,27,33,18860775,6,0.727272727,1,1,16304
74c39752ab3a2fcc4612ed796ebba2342cf78b01,0,Yusaku Sako,2014-10-17 11:38:16-07:00,['a1ba750e85a3cb8b6614eb6406408d595821d5fa'],21,177,198,18860973,1,,,,16304
30e5d2d12410cc689711c1fb4787a4a2a06c62b1,1,Jonathan Hurley,2014-10-17 14:47:02-04:00,['74c39752ab3a2fcc4612ed796ebba2342cf78b01'],145,988,1133,18862106,21,0.049535604,0.792569659,0.93498452,16305
801eb6864ad1da898687c58d534662f55bc5240e,0,Jonathan Hurley,2014-10-17 16:42:11-04:00,['30e5d2d12410cc689711c1fb4787a4a2a06c62b1'],5,12,17,18862123,1,0,1,1,16305
c8018243c6bf3b3dca1e4f998073dfc2b45ec5e5,1,Srimanth Gunturi,2014-10-17 15:24:57-07:00,['801eb6864ad1da898687c58d534662f55bc5240e'],1,55,56,18862179,2,1,1,1,16306
b340f9a9519cd999862e205199ebe9ed44afe45d,1,Srimanth Gunturi,2014-10-17 17:10:18-07:00,['c8018243c6bf3b3dca1e4f998073dfc2b45ec5e5'],76,604,680,18862859,72,,,,16306
15802cf281eadf674251dfb5014bc876486e7c99,1,Srimanth Gunturi,2014-10-18 14:27:48-07:00,['b340f9a9519cd999862e205199ebe9ed44afe45d'],1,1,2,18862861,1,,,,16306
290a813bb030dcb54469a6bcec639851ebd1acc2,1,Aleksandr Kovalenko,2014-10-20 13:26:24+03:00,['15802cf281eadf674251dfb5014bc876486e7c99'],16,63,79,18862940,9,0.871794872,0.897435897,1,16306
7699e1ddc2f2fcdb60ca258a8ff2ede6a4dd022a,1,Oleg Nechiporenko,2014-10-20 14:13:13+03:00,['290a813bb030dcb54469a6bcec639851ebd1acc2'],14,10,24,18862964,2,0,0,0,16306
40c4fd201e6e0d4bca30ecfbdec4e20ccf0098be,1,Andrew Onishuk,2014-10-20 14:47:33+03:00,['7699e1ddc2f2fcdb60ca258a8ff2ede6a4dd022a'],118,103,221,18863185,8,0,0,1,16306
5dd65e5bbb6f37afa22e2c614466604284b58386,1,Oleg Nechiporenko,2014-10-20 14:54:19+03:00,['40c4fd201e6e0d4bca30ecfbdec4e20ccf0098be'],7,8,15,18863200,2,1,1,1,16306
29a51e8861406cbb5fe0541ef5ba5286cdfe6994,1,Dmytro Sen,2014-10-20 17:40:48+03:00,['5dd65e5bbb6f37afa22e2c614466604284b58386'],0,1,1,18863201,1,1,1,1,16306
9bd3e90d927d11be965ed0f5f0687b5355773f4a,1,Dmytro Sen,2014-10-20 17:42:40+03:00,['29a51e8861406cbb5fe0541ef5ba5286cdfe6994'],83,205,288,18863489,16,,,,16306
6930dd92892c1b261a3bb3fbc7cb7575d91e9e05,1,Vitaly Brodetskyi,2014-10-20 17:24:28+03:00,['9bd3e90d927d11be965ed0f5f0687b5355773f4a'],1,24,25,18863514,3,0,0,1,16306
06f9816b7eff019c2e2e5f0ef6e0453e6effd2c6,1,Oleg Nechiporenko,2014-10-20 17:30:58+03:00,['5dd65e5bbb6f37afa22e2c614466604284b58386'],4,33,37,18863551,2,1,1,1,16306
2fc6217b4271ac747b6dd618e1b077669c51f6e1,1,Yusaku Sako,2014-10-20 10:12:06-07:00,['6930dd92892c1b261a3bb3fbc7cb7575d91e9e05'],3,9,12,18863563,3,1,1,0.833333333,16306
dd0ae15bc77ea8f78f48af01a93181840920e7fa,1,atkach,2014-10-20 20:23:04+03:00,['2fc6217b4271ac747b6dd618e1b077669c51f6e1'],175,952,1127,18864690,2,0.838274933,1,1,16306
807f3c885528c13382749c82b69094e9830627c8,1,Alex Antonenko,2014-10-20 20:24:42+03:00,['dd0ae15bc77ea8f78f48af01a93181840920e7fa'],12,12,24,18864714,1,,,,16306
d54b747aee0b90f9a17b4852c0a9c471a4b4e623,1,Jaimin Jetly,2014-10-20 10:48:14-07:00,['807f3c885528c13382749c82b69094e9830627c8'],31,353,384,18865098,13,0.23255814,0.720930233,1,16307
7711dadb2030da70ddae2633825a1720ee9f7cd9,0,Oleg Nechiporenko,2014-10-20 20:51:47+03:00,"['06f9816b7eff019c2e2e5f0ef6e0453e6effd2c6', 'd54b747aee0b90f9a17b4852c0a9c471a4b4e623']",305,1556,1861,18866959,39,,,,16307
f9fe992f1d5c185c9f39dd498f5345c9fc0931f5,0,Lisnichenko Dmitro,2014-10-20 20:56:01+03:00,['7711dadb2030da70ddae2633825a1720ee9f7cd9'],1,2,3,18866962,1,,,,16307
47929dce2e854a5ee1ad7944da83d90545c517da,1,Lisnichenko Dmitro,2014-10-20 20:57:44+03:00,['f9fe992f1d5c185c9f39dd498f5345c9fc0931f5'],3,5,8,18866970,2,0,0.333333333,1,16307
f145b5ab37c3d0cb5a603b3dab451e84b0e7c9aa,0,Lisnichenko Dmitro,2014-10-20 20:58:54+03:00,['47929dce2e854a5ee1ad7944da83d90545c517da'],1,1,2,18866972,1,,,,16307
3d1787b338cf94072b14128233eb2fd28ccefb82,1,Lisnichenko Dmitro,2014-10-20 21:00:29+03:00,['f145b5ab37c3d0cb5a603b3dab451e84b0e7c9aa'],5,10,15,18866987,2,0,1,0,16307
dc74d045d5f39cc129295464747071e6f7f1aea2,1,Alex Antonenko,2014-10-20 22:06:52+03:00,['3d1787b338cf94072b14128233eb2fd28ccefb82'],3,3,6,18866993,1,,,,16307
747b5c4c93609d5e19e15097eefe6921bbdce755,1,tbeerbower,2014-10-20 16:01:59-04:00,['dc74d045d5f39cc129295464747071e6f7f1aea2'],1,14,15,18867008,2,0,1,1,16307
f5119b457882c0d60e60e0890e9cfcde08d3dd6a,1,Alejandro Fernandez,2014-10-20 16:02:46-07:00,['747b5c4c93609d5e19e15097eefe6921bbdce755'],203,421,624,18867632,13,1,0.083333333,0,16308
c2e69c4c7c659ba2c58c8a9602ec0d3823da9249,1,Srimanth Gunturi,2014-10-20 16:11:36-07:00,['f5119b457882c0d60e60e0890e9cfcde08d3dd6a'],2,8,10,18867642,3,,,,16308
4e8a6529b4011ba972a58f1627f6e8940acc85b5,1,Srimanth Gunturi,2014-10-20 17:52:05-07:00,['c2e69c4c7c659ba2c58c8a9602ec0d3823da9249'],17,37715,37732,18905374,8,0.50617284,0.53909465,0.279835391,16314
65611067beb02185cfe1003f26c10fbd88e35f32,1,Alejandro Fernandez,2014-10-20 20:04:11-07:00,['4e8a6529b4011ba972a58f1627f6e8940acc85b5'],3,4,7,18905381,1,,,,16314
c52c180a3fe0376292e2d58b6f267530b5074d7f,1,jaoki,2014-10-20 22:18:46-07:00,['65611067beb02185cfe1003f26c10fbd88e35f32'],2,2,4,18905385,1,,,,16314
88d3fb085ddda93bb1f4066a0e88a0d566797023,1,Lisnichenko Dmitro,2014-10-21 13:19:50+03:00,['c52c180a3fe0376292e2d58b6f267530b5074d7f'],4,79,83,18905468,6,0,1,1,16314
6fe0285c5be0dde9331818934d47a339090a83f9,0,Aleksandr Kovalenko,2014-10-21 13:23:11+03:00,['88d3fb085ddda93bb1f4066a0e88a0d566797023'],0,2,2,18905470,1,0,0,1,16314
2034600f17fcc3ec4ff89fdc97caabfd00f29456,1,aBabiichuk,2014-10-21 13:54:10+03:00,['6fe0285c5be0dde9331818934d47a339090a83f9'],13,47,60,18905530,4,1,0.44,1,16314
55fe1273100d667a1af783429294377bcee06abc,0,Dmytro Sen,2014-10-21 16:32:20+03:00,['2034600f17fcc3ec4ff89fdc97caabfd00f29456'],11,0,11,18905541,1,,,,16314
64a73207ec4a4131af420a84e374b94f4ee7c220,1,John Speidel,2014-10-21 10:44:19-04:00,['55fe1273100d667a1af783429294377bcee06abc'],5,75,80,18905621,2,0.162790698,1,1,16314
99de55ab85662d0050b7030a8f17175723e0cf97,0,Andrew Onishuk,2014-10-21 18:15:16+03:00,['64a73207ec4a4131af420a84e374b94f4ee7c220'],1,14,15,18905636,4,0,1,1,16314
2db08fb149ed78e37051102412be421ea1d5c7bb,1,atkach,2014-10-21 19:08:09+03:00,['99de55ab85662d0050b7030a8f17175723e0cf97'],15,120,135,18905771,2,0.873417722,1,1,16314
5923ee89c33b5c70da9e4848468894dfd03b1b67,0,Aleksandr Kovalenko,2014-10-21 19:10:52+03:00,['2db08fb149ed78e37051102412be421ea1d5c7bb'],2,6,8,18905779,2,0,1,0,16314
9933aac47798527883a2c3c2471b690a24c060d2,1,Aleksandr Kovalenko,2014-10-21 19:10:53+03:00,['5923ee89c33b5c70da9e4848468894dfd03b1b67'],20,33,53,18905832,4,1,1,1,16314
a2bf93dcb7b109a9b5ddcbc4c04fdb6253835939,1,aBabiichuk,2014-10-21 19:49:12+03:00,['9933aac47798527883a2c3c2471b690a24c060d2'],106,170,276,18906108,10,1,0.903225806,0.919354839,16314
bc0ae7de9682cfec29f326293b087b54c971fc69,0,Myroslav Papirkovskyy,2014-10-21 19:57:54+03:00,['a2bf93dcb7b109a9b5ddcbc4c04fdb6253835939'],0,5,5,18906113,1,,,,16314
12df0682d8390292aa9b99921d0c823bfa2e8693,0,aBabiichuk,2014-10-21 20:23:04+03:00,['bc0ae7de9682cfec29f326293b087b54c971fc69'],1,3,4,18906117,3,1,0,1,16314
c6f068c8578db7b7030adeea755533bdd6aa1665,1,Siddharth Wagle,2014-10-21 11:03:34-07:00,['12df0682d8390292aa9b99921d0c823bfa2e8693'],131,256,387,18906504,2,0.443181818,1,0.886363636,16314
463dae91a1daca97c82a92866a520ff7d985ea00,1,Jonathan Hurley,2014-10-21 17:19:31-04:00,['c6f068c8578db7b7030adeea755533bdd6aa1665'],72,1063,1135,18907639,15,0.145896657,0.568389058,0.90881459,16317
5e5e715b6b15dffffe15418dfe5732835d24ef57,1,Srimanth Gunturi,2014-10-21 21:08:17-07:00,['463dae91a1daca97c82a92866a520ff7d985ea00'],4,5,9,18907648,4,0,0,1,16317
0a638f3cfb9cc6ca2f8989a309f91a46009303ad,1,Aleksandr Kovalenko,2014-10-22 15:26:29+03:00,['5e5e715b6b15dffffe15418dfe5732835d24ef57'],1,2,3,18907651,2,,,,16317
fd045a4d97010f241252508ac82a7efdbf11a20e,1,Andrew Onishuk,2014-10-22 17:06:57+03:00,['0a638f3cfb9cc6ca2f8989a309f91a46009303ad'],2,2,4,18907655,2,,,,16317
e5f9fbb0420f51d5871e7b722945a9dc26cb6947,1,Andrew Onishuk,2014-10-22 17:25:46+03:00,['fd045a4d97010f241252508ac82a7efdbf11a20e'],3,3,6,18907661,2,,,,16317
4fb2a8e021d65f5a7b5dfc4b26ca007226ceb6d1,1,atkach,2014-10-22 17:54:59+03:00,['e5f9fbb0420f51d5871e7b722945a9dc26cb6947'],11,21,32,18907693,1,0.916666667,1,0.916666667,16317
dfe352adb527d92602bd39bd1d7dbaaa1fa0821c,0,Andrew Onishuk,2014-10-22 17:55:25+03:00,['4fb2a8e021d65f5a7b5dfc4b26ca007226ceb6d1'],5,0,5,18907698,1,,,,16317
06ff32dcd13959efcdca5a89353e2e425474b84f,1,Dmytro Sen,2014-10-22 18:13:44+03:00,['dfe352adb527d92602bd39bd1d7dbaaa1fa0821c'],9,54,63,18907761,7,0.441176471,0.764705882,0.852941176,16317
4e003e581ae6797b93ab6b94cba7750465b8c738,1,atkach,2014-10-22 18:15:53+03:00,['06ff32dcd13959efcdca5a89353e2e425474b84f'],5,6,11,18907772,2,0,0,,16317
b2740331a514cb7289384d201a10c289e9beba9b,1,Dmytro Sen,2014-10-22 18:18:12+03:00,['4e003e581ae6797b93ab6b94cba7750465b8c738'],145,117,262,18908034,41,,,,16317
147955bb3be297ecbb1665cff45cb75e97d05420,1,Oleg Nechiporenko,2014-10-22 18:34:07+03:00,['b2740331a514cb7289384d201a10c289e9beba9b'],22,30,52,18908086,2,,,,16317
a64a370551f128c7230d26f23081aeb7b642485b,0,aBabiichuk,2014-10-22 18:50:49+03:00,['147955bb3be297ecbb1665cff45cb75e97d05420'],1,2,3,18908089,1,,,,16317
2e3658194b7c5d7a41588931aff35754ac261ac4,0,John Speidel,2014-10-22 13:19:41-04:00,['a64a370551f128c7230d26f23081aeb7b642485b'],0,6,6,18908095,2,0,1,1,16317
72799ea18894a1f87aa9b38f9ef1fde1076fdeef,1,Alex Antonenko,2014-10-22 21:03:14+03:00,['2e3658194b7c5d7a41588931aff35754ac261ac4'],1,75,76,18908171,2,1,1,1,16317
58f5fcb4b19e5c082b69bdd80c7f4af0d29ccdce,1,Alejandro Fernandez,2014-10-22 11:58:22-07:00,['72799ea18894a1f87aa9b38f9ef1fde1076fdeef'],136,373,509,18908680,14,0.873015873,0.634920635,1,16319
0a51444deb1efc1de816394c1f716bf94d6f2b4c,1,Srimanth Gunturi,2014-10-22 13:07:34-07:00,['58f5fcb4b19e5c082b69bdd80c7f4af0d29ccdce'],4,15,19,18908699,1,0,0,1,16319
5db075bf5053ee8540a55d0ddc430f73034df7e1,1,Andrew Onishuk,2014-10-22 23:26:45+03:00,['0a51444deb1efc1de816394c1f716bf94d6f2b4c'],23,41,64,18908763,8,0,1,1,16319
093cfd639a0c4397f70cb538256ad1f923b5f986,0,Srimanth Gunturi,2014-10-22 14:28:19-07:00,['5db075bf5053ee8540a55d0ddc430f73034df7e1'],1,1,2,18908765,1,,,,16319
a7adbe275cec758257dc98c0d60ac12af30935f6,1,Sumit Mohanty,2014-10-22 15:14:48-07:00,['093cfd639a0c4397f70cb538256ad1f923b5f986'],1,262,263,18909028,1,,,,16319
e463a1670564890e4dd7a9237caa2bfb49ece49d,1,Srimanth Gunturi,2014-10-22 16:32:35-07:00,['a7adbe275cec758257dc98c0d60ac12af30935f6'],1,6,7,18909035,1,0,0,1,16319
2bcc5d12ba1ffcaa60ce672ba746afcae237a8c6,1,Srimanth Gunturi,2014-10-22 22:33:39-07:00,['e463a1670564890e4dd7a9237caa2bfb49ece49d'],1,41,42,18909077,3,0.363636364,0.363636364,1,16319
37299ab312febb5b979c2d325a1a1f090ea98923,0,Oleg Nechiporenko,2014-10-23 12:23:30+03:00,['2bcc5d12ba1ffcaa60ce672ba746afcae237a8c6'],86,1,87,18909164,2,0.5,0,0.132352941,16319
59b0f65977498eedd723dc0412d8c5405d1ea451,1,atkach,2014-10-23 13:48:46+03:00,['37299ab312febb5b979c2d325a1a1f090ea98923'],3,60,63,18909227,3,1,1,1,16320
2ad3fc6a9fcf6f1b66bf3f134ff58279f15089fc,0,Andrew Onishuk,2014-10-23 14:23:19+03:00,['59b0f65977498eedd723dc0412d8c5405d1ea451'],9,6,15,18909242,1,,,,16320
8e9adf4c764f5036ec687620bd3b5c849ddf34a7,1,Andrew Onishuk,2014-10-23 14:59:43+03:00,['2ad3fc6a9fcf6f1b66bf3f134ff58279f15089fc'],0,6,6,18909248,1,,,,16320
d2b8f3e96e3b84033c738f1620e1624bbba46ff0,1,Jonathan Hurley,2014-10-23 08:50:12-04:00,['8e9adf4c764f5036ec687620bd3b5c849ddf34a7'],664,1176,1840,18911088,21,0,0,0.767857143,16322
e001e62294ed13cb0a8bbcfcd5fa1e4e5666e92a,1,Aleksandr Kovalenko,2014-10-23 16:05:07+03:00,['d2b8f3e96e3b84033c738f1620e1624bbba46ff0'],4,9,13,18911101,3,1,1,1,16322
69f6fd4e899570ed90b06e6c0483b84258d5ff99,1,Alex Antonenko,2014-10-23 16:30:08+03:00,['e001e62294ed13cb0a8bbcfcd5fa1e4e5666e92a'],5,80,85,18911186,4,0.265306122,1,1,16322
2b48d33ed2cde8059d7d9e77132944d88f7585af,1,aBabiichuk,2014-10-23 16:46:19+03:00,['69f6fd4e899570ed90b06e6c0483b84258d5ff99'],1,371,372,18911558,10,0.264705882,0.264705882,1,16328
fe395d7f244b3d8761fba87ca2562f786e635852,1,Lisnichenko Dmitro,2014-10-23 17:42:40+03:00,['2b48d33ed2cde8059d7d9e77132944d88f7585af'],5,5,10,18911568,3,,,,16328
0579e7113aa0afbdbb226693c7d430cfcc0349c7,1,Alex Antonenko,2014-10-23 17:49:22+03:00,['fe395d7f244b3d8761fba87ca2562f786e635852'],0,60,60,18911628,2,,,,16328
724ef08702354c50129fcec753567fb770afbe9f,1,Subin,2014-10-23 20:37:44+05:18,['0579e7113aa0afbdbb226693c7d430cfcc0349c7'],1,2,3,18911631,1,,,,16328
53b163866e2beab179631f4ea4b088a3764e778c,0,Andrew Onishuk,2014-10-23 19:19:36+03:00,['724ef08702354c50129fcec753567fb770afbe9f'],9,45,54,18911685,5,0.055555556,0.777777778,0.805555556,16328
efddf553fb4aa0603fda3765ef8e3faa8c06d29a,1,Alex Antonenko,2014-10-23 20:02:58+03:00,['53b163866e2beab179631f4ea4b088a3764e778c'],1,2,3,18911688,1,1,1,1,16328
7777302b7f53304bcaafb0c0035bd729eb61628b,1,Jonathan Hurley,2014-10-23 13:17:48-04:00,['efddf553fb4aa0603fda3765ef8e3faa8c06d29a'],1,484,485,18912173,7,,,,16334
b7902decc82ba02f9ab1f286ab407ca4d99767d1,0,Alejandro Fernandez,2014-10-23 10:54:32-07:00,['7777302b7f53304bcaafb0c0035bd729eb61628b'],10,120,130,18912303,2,,,,16334
de1dae5315cc612620554a4357a7de48130f48e3,0,Alejandro Fernandez,2014-10-23 10:57:34-07:00,['b7902decc82ba02f9ab1f286ab407ca4d99767d1'],0,13,13,18912316,1,0,0,1,16334
896d0a2e3ae336f433de1466077c8f8dbeeea1eb,0,Alejandro Fernandez,2014-10-23 10:59:37-07:00,['de1dae5315cc612620554a4357a7de48130f48e3'],13,0,13,18912329,1,1,1,0,16334
27a9d78c921cbfd56fb4dc7e3b440d2a2fe5dbca,1,aBabiichuk,2014-10-23 21:02:14+03:00,['896d0a2e3ae336f433de1466077c8f8dbeeea1eb'],4,5,9,18912338,2,1,1,1,16334
c19b7896667bbeedf83525b7b7c7e62e31a96b57,1,John Speidel,2014-10-23 14:45:51-04:00,['27a9d78c921cbfd56fb4dc7e3b440d2a2fe5dbca'],563,812,1375,18913713,8,0.037593985,0.992481203,0.909774436,16336
16aa7da623e1b923af879f4a5d6a6fac0be41950,1,Alex Antonenko,2014-10-23 22:55:13+03:00,['c19b7896667bbeedf83525b7b7c7e62e31a96b57'],3,90,93,18913806,4,1,1,1,16336
5ce9b52bb781146d9ecfa4bd43eef6df1417270a,1,Alex Antonenko,2014-10-23 22:55:14+03:00,['16aa7da623e1b923af879f4a5d6a6fac0be41950'],2,15,17,18913823,1,,,,16336
6065783b10e8ca45e81c6ac71d2e804af02b4ea0,1,Alex Antonenko,2014-10-23 22:55:15+03:00,['5ce9b52bb781146d9ecfa4bd43eef6df1417270a'],3,3,6,18913829,1,,,,16336
4c56e4e66b0a3a63fbb08149bfe7b8d1d312a44b,1,Jaimin Jetly,2014-10-23 13:30:23-07:00,['6065783b10e8ca45e81c6ac71d2e804af02b4ea0'],25,303,328,18914157,19,0.428571429,1,1,16339
897b67a5549b1fa93b339370c789764c489ed471,1,John Speidel,2014-10-23 17:22:57-04:00,['4c56e4e66b0a3a63fbb08149bfe7b8d1d312a44b'],5,18,23,18914180,2,1,1,1,16339
2d4f7d4b894209c51feec2160ed3d6bf1ac37080,0,Alejandro Fernandez,2014-10-23 17:26:36-07:00,['897b67a5549b1fa93b339370c789764c489ed471'],0,3,3,18914183,2,,,,16339
65971b663a06984bb22886649caccd92a9d99515,1,Lisnichenko Dmitro,2014-10-24 12:51:59+03:00,['2d4f7d4b894209c51feec2160ed3d6bf1ac37080'],49,46,95,18914278,1,0,0,0,16339
6dcab6103d5894e0af4e2726f6f2b1afeeee3336,1,Lisnichenko Dmitro,2014-10-24 12:51:59+03:00,['65971b663a06984bb22886649caccd92a9d99515'],8,12,20,18914298,7,,,,16339
06d61c1adcbda275d03080113dbce50b7c466cf2,1,Lisnichenko Dmitro,2014-10-24 12:51:59+03:00,['6dcab6103d5894e0af4e2726f6f2b1afeeee3336'],0,2,2,18914300,1,,,,16339
f30729d2dbe01efef8b91a9231e1d8383dbd826b,1,Aleksandr Kovalenko,2014-10-24 13:14:56+03:00,['06d61c1adcbda275d03080113dbce50b7c466cf2'],5,15,20,18914320,4,,,,16339
469fd557930cac67c642cfaa0a809a8c4db6039f,1,atkach,2014-10-24 16:50:35+03:00,['f30729d2dbe01efef8b91a9231e1d8383dbd826b'],2,11,13,18914333,2,,,,16339
f89a0b9bb5e210e30ebf38f076cf9e961b6efc26,1,Oleg Nechiporenko,2014-10-24 16:56:53+03:00,['469fd557930cac67c642cfaa0a809a8c4db6039f'],10,876,886,18915219,9,0.420245399,0.547546012,0.834355828,16342
28f01df4e7ffabcc9edaa206a03a7935bffedb3c,1,atkach,2014-10-24 17:58:05+03:00,['f89a0b9bb5e210e30ebf38f076cf9e961b6efc26'],3,14,17,18915236,1,0,0,,16342
d4dcb54e740a390644d5fc8476b2c4abbb889f22,1,Oleg Nechiporenko,2014-10-24 18:03:45+03:00,['28f01df4e7ffabcc9edaa206a03a7935bffedb3c'],2,2,4,18915240,1,,,,16342
522744fc2f4f74d102488381cf0d6e9fd7ceb13a,1,Andrew Onishuk,2014-10-24 19:39:28+03:00,['d4dcb54e740a390644d5fc8476b2c4abbb889f22'],1,75,76,18915316,2,0,0.898305085,0.898305085,16342
beecccea89b68b0bfca47af8df356f57653ec755,1,Vitaly Brodetskyi,2014-10-24 17:58:04+03:00,['522744fc2f4f74d102488381cf0d6e9fd7ceb13a'],17,10,27,18915343,2,1,1,0,16342
52422ca16076843f62af71057f0ab2417bc389f8,1,Alex Antonenko,2014-10-24 20:04:40+03:00,['beecccea89b68b0bfca47af8df356f57653ec755'],5,7,12,18915355,2,,,,16342
439a0a40d5bffdfa38059deb212d3658ea79adf1,1,tbeerbower,2014-10-24 13:21:18-04:00,['52422ca16076843f62af71057f0ab2417bc389f8'],123,737,860,18916215,14,0.62962963,0.814814815,0.796296296,16349
6d80fa9274375e8a4fbf29762ee360009cdbbf3f,1,Srimanth Gunturi,2014-10-24 10:35:43-07:00,['439a0a40d5bffdfa38059deb212d3658ea79adf1'],36,105,141,18916356,2,0,0,0.724137931,16349
aa15c03d04a21903ad0bc519ad3f5198debb1e50,1,Aleksandr Kovalenko,2014-10-24 21:06:47+03:00,['6d80fa9274375e8a4fbf29762ee360009cdbbf3f'],0,8,8,18916364,1,,,,16349
f93670872d48a9600d8cc07569171880c44a805c,1,Andrew Onishuk,2014-10-24 21:15:18+03:00,['aa15c03d04a21903ad0bc519ad3f5198debb1e50'],0,84,84,18916448,2,0.202531646,1,0.82278481,16349
1c85788c91b9bfd77d0c233d00f7754eebfc891c,1,Aleksandr Kovalenko,2014-10-24 21:17:13+03:00,['f93670872d48a9600d8cc07569171880c44a805c'],1,137,138,18916586,2,0.659574468,1,1,16349
1e7e5e99e442c7b8fd4996ed029f1988613c1176,1,Sumit Mohanty,2014-10-24 12:21:22-07:00,['1c85788c91b9bfd77d0c233d00f7754eebfc891c'],0,65,65,18916651,5,0,1,1,16350
1e7607b892f01bed811e3092a208a29c87d61bb3,0,Jaimin Jetly,2014-10-24 12:32:23-07:00,['1e7e5e99e442c7b8fd4996ed029f1988613c1176'],10,10,20,18916671,8,,,,16350
54989df2a8a83f3108a6b94b8a4a0c2dc783edf3,1,Srimanth Gunturi,2014-10-24 13:17:56-07:00,['1e7607b892f01bed811e3092a208a29c87d61bb3'],0,16,16,18916687,1,0,0,0,16350
17b05b23633b8fa055de4b619a1c98ae4145716f,1,Jonathan Hurley,2014-10-24 16:55:20-04:00,['54989df2a8a83f3108a6b94b8a4a0c2dc783edf3'],325,750,1075,18917762,19,0.417266187,0.510791367,0.884892086,16354
6697e6b05c81e56da229dde055869edd6a4174db,1,Jaimin Jetly,2014-10-24 14:12:06-07:00,['17b05b23633b8fa055de4b619a1c98ae4145716f'],10,10,20,18917782,8,,,,16354
2d5623fd5b3e5b9c0e5ae876f34369e31cc3d51b,1,Srimanth Gunturi,2014-10-24 15:35:43-07:00,['6697e6b05c81e56da229dde055869edd6a4174db'],42,509,551,18918333,3,0.569078947,1,0.282894737,16356
6ba07c192a73603291778a88b19c984a6213a3d6,1,Alejandro Fernandez,2014-10-24 15:53:37-07:00,['2d5623fd5b3e5b9c0e5ae876f34369e31cc3d51b'],145,42,187,18918520,6,0.454545455,0.757575758,0.333333333,16356
33ed5921d638c4ffeeb09a572a4c51cb5fc9d6f9,1,Jaimin Jetly,2014-10-24 17:35:03-07:00,['6ba07c192a73603291778a88b19c984a6213a3d6'],4535,633,5168,18923688,80,0.516802906,0.342415985,0.004541326,16356
ad9b02b155d3b1e7f9a47b20a5dc4328fe016081,1,Jun Aoki,2014-10-24 18:04:46-07:00,['33ed5921d638c4ffeeb09a572a4c51cb5fc9d6f9'],6,62,68,18923756,3,0.433333333,1,1,16357
0fe10a04eef68d6152835ddb6134feae409e7c31,1,Jaimin Jetly,2014-10-24 19:24:37-07:00,['ad9b02b155d3b1e7f9a47b20a5dc4328fe016081'],11,11,22,18923778,8,,,,16357
3b9c1edf6c92a8320b46da8ff65383a00ad95e93,1,Lisnichenko Dmitro,2014-10-25 19:46:50+03:00,['0fe10a04eef68d6152835ddb6134feae409e7c31'],24,104,128,18923906,7,1,0,0,16357
217f43d0de3ca14e0e33b4f8f1e7adcbd9c8ecfb,1,Lisnichenko Dmitro,2014-10-25 20:48:22+03:00,['3b9c1edf6c92a8320b46da8ff65383a00ad95e93'],0,8,8,18923914,1,,,,16357
101c41a49c7e7a3ed7892e2fe70e620596ab4d1c,1,atkach,2014-10-25 22:53:32+03:00,['217f43d0de3ca14e0e33b4f8f1e7adcbd9c8ecfb'],24,27,51,18923965,1,0,0,1,16357
2115609432b40f19b448f551d2e485650cb0dfb9,0,atkach,2014-10-26 01:30:34+03:00,['101c41a49c7e7a3ed7892e2fe70e620596ab4d1c'],1,10,11,18923976,3,0.25,0.25,1,16357
2a4f67ae9cb56e9132956bc0fffecdc6779677ea,1,Dmytro Sen,2014-10-26 17:40:01+02:00,['2115609432b40f19b448f551d2e485650cb0dfb9'],3,5,8,18923984,1,0,0,1,16357
42cf9b21c593f64bf13d53b8272b62bc73e28c85,1,Andrew Onishuk,2014-10-26 18:31:52+02:00,['2a4f67ae9cb56e9132956bc0fffecdc6779677ea'],8,101,109,18924093,7,0,0.8125,1,16358
1b94497d3183528c344d751f059f4e1ef5d20f81,1,Andrew Onishuk,2014-10-26 18:34:20+02:00,['42cf9b21c593f64bf13d53b8272b62bc73e28c85'],1,4,5,18924098,3,0,0.666666667,1,16358
a019383aec937e279367a0e6f728274cdfb64503,0,Lisnichenko Dmitro,2014-10-26 20:23:44+02:00,['1b94497d3183528c344d751f059f4e1ef5d20f81'],1,1,2,18924100,1,,,,16358
950ed5da567e5b1f597a24c99fe000ddf89d870b,1,Lisnichenko Dmitro,2014-10-26 20:24:47+02:00,['a019383aec937e279367a0e6f728274cdfb64503'],12,39,51,18924151,3,0.238095238,0.238095238,1,16358
7e39342aebc58ac45eb1bde584bb6db5f637bdd0,1,Lisnichenko Dmitro,2014-10-26 20:26:42+02:00,['950ed5da567e5b1f597a24c99fe000ddf89d870b'],0,51,51,18924202,1,,,,16358
4f9b148600df7f1a25fbe0e16025898891dd2a38,0,Jaimin Jetly,2014-10-26 22:20:42-07:00,['7e39342aebc58ac45eb1bde584bb6db5f637bdd0'],90,90,180,18924382,1,,,,16358
af0253506faf7a5cb07c8d78cbac3d9b858f50d9,1,Dmytro Sen,2014-10-27 14:31:45+02:00,['4f9b148600df7f1a25fbe0e16025898891dd2a38'],7,139,146,18924528,9,1,1,0.15,16359
2bebb6e1e3e7a0570996f2c4b458289f6763feda,1,tbeerbower,2014-10-27 10:09:05-04:00,['af0253506faf7a5cb07c8d78cbac3d9b858f50d9'],12,209,221,18924749,8,0.966666667,1,0.966666667,16361
51fd872939439cb0f6e38a038d31ad4e9cb0ffad,1,atkach,2014-10-27 17:03:44+02:00,['2bebb6e1e3e7a0570996f2c4b458289f6763feda'],1,1,2,18924751,1,,,,16361
4b2f1ab0c3749dbc73fb2e1f697b53c62555b06f,1,atkach,2014-10-27 17:04:02+02:00,['51fd872939439cb0f6e38a038d31ad4e9cb0ffad'],746,4850,5596,18930347,14,0,0,0,16365
baebf45239384b47161af086a7937d42a9902429,1,Oleg Nechiporenko,2014-10-27 17:23:41+02:00,['4b2f1ab0c3749dbc73fb2e1f697b53c62555b06f'],21,62,83,18930430,3,0.333333333,1,1,16365
5432949b1362bb74daede665a1334aac18606b4a,1,Aleksandr Kovalenko,2014-10-27 18:13:11+02:00,['baebf45239384b47161af086a7937d42a9902429'],0,66,66,18930496,2,,,,16366
e0b17bf689fff30ed5d5e9aa5975c2a8664457e8,1,Dmytro Sen,2014-10-27 18:43:05+02:00,['5432949b1362bb74daede665a1334aac18606b4a'],9,8,17,18930513,5,0,0,0,16366
c0c738072218a74dd83554f5b0c86b742280091f,1,Alejandro Fernandez,2014-10-27 12:36:30-07:00,['e0b17bf689fff30ed5d5e9aa5975c2a8664457e8'],29,34,63,18930576,5,1,1,1,16366
148f5a9b8ea0ba666b485c2080ace556a7dbf5b1,1,Jun Aoki,2014-10-27 12:58:05-07:00,['c0c738072218a74dd83554f5b0c86b742280091f'],0,11,11,18930587,2,0,1,1,16366
b42c3c9bed122368d66e317d8943071a69534ac2,1,Jun Aoki,2014-10-27 13:02:54-07:00,['148f5a9b8ea0ba666b485c2080ace556a7dbf5b1'],0,535,535,18931122,8,0.571428571,0.827380952,1,16374
f57ae79ccbdee3be606cd9fc5b815813d7671d7c,1,Alex Antonenko,2014-10-27 23:33:14+02:00,['b42c3c9bed122368d66e317d8943071a69534ac2'],6,8,14,18931136,1,1,1,1,16374
697c5a47e8d3d1a445b162b363c799634d83647a,1,Alex Antonenko,2014-10-27 23:33:15+02:00,['f57ae79ccbdee3be606cd9fc5b815813d7671d7c'],2,2,4,18931140,2,,,,16374
eebb085e8887baa751e6967e6fbc6bab86a3022f,1,Srimanth Gunturi,2014-10-27 17:20:25-07:00,['697c5a47e8d3d1a445b162b363c799634d83647a'],15,31,46,18931186,6,0,0,0,16374
f1720123b881b2377fef73bc4f3f7b922c50c64d,1,John Speidel,2014-10-27 20:49:17-04:00,['eebb085e8887baa751e6967e6fbc6bab86a3022f'],1,84,85,18931271,2,0.057692308,1,1,16374
a0916c8b45f37b6b4b6043c4fc23299c1b360024,1,Aleksandr Kovalenko,2014-10-28 14:56:15+02:00,['f1720123b881b2377fef73bc4f3f7b922c50c64d'],5,892,897,18932168,5,0.624796085,1,1,16376
ad71f0bf7144ba790f103deaeac1cf668b1ca4b5,1,atkach,2014-10-28 16:42:45+02:00,['a0916c8b45f37b6b4b6043c4fc23299c1b360024'],14,2,16,18932184,3,1,1,0,16376
bc25d5ae2052e35bd40e8e3e3db3b53d11f25b86,1,Jonathan Hurley,2014-10-28 11:01:24-04:00,['ad71f0bf7144ba790f103deaeac1cf668b1ca4b5'],10,526,536,18932720,11,0.104972376,0.104972376,1,16380
bb72045c142103f5a81f41b819d3b29f85c72d2c,0,Jonathan Hurley,2014-10-28 12:16:43-04:00,['bc25d5ae2052e35bd40e8e3e3db3b53d11f25b86'],1,1,2,18932722,1,,,,16380
a165c508010a317f5ed017c8e3bdd310fa45ffe9,1,Aleksandr Kovalenko,2014-10-28 18:21:47+02:00,['bb72045c142103f5a81f41b819d3b29f85c72d2c'],9,17,26,18932748,1,,,,16380
2afa44ae4862300526280bf965ed1337570602f0,1,aBabiichuk,2014-10-28 18:45:51+02:00,['a165c508010a317f5ed017c8e3bdd310fa45ffe9'],2,64,66,18932814,4,0.347826087,0.739130435,1,16380
8c04a1ee6f8830f8624fee46251ad145d61bbe61,1,Andrew Onishuk,2014-10-28 20:06:24+02:00,['2afa44ae4862300526280bf965ed1337570602f0'],4,15,19,18932833,2,0,0,1,16380
5fb9a9ffe4de0bec1df03c390e664e6848c86350,1,Jaimin Jetly,2014-10-28 11:28:12-07:00,['8c04a1ee6f8830f8624fee46251ad145d61bbe61'],0,1,1,18932834,1,1,1,1,16380
96517a9b183a24838d5b17cd3c9381ed1e8f6584,0,Jaimin Jetly,2014-10-28 11:33:06-07:00,['5fb9a9ffe4de0bec1df03c390e664e6848c86350'],0,8,8,18932842,1,,,,16380
db0aa3e1411d341919590b09cca8e0346a66b46a,0,Jun Aoki,2014-10-28 12:58:58-07:00,['96517a9b183a24838d5b17cd3c9381ed1e8f6584'],3,54,57,18932899,5,1,1,1,16380
2054284defcc59a0119b07477d5b6562203b161e,0,Andrew Onishuk,2014-10-28 22:07:42+02:00,['db0aa3e1411d341919590b09cca8e0346a66b46a'],2,2,4,18932903,1,,,,16380
eee89b79bad82986e58da2ce5a3dbd63a90dbf8a,1,Alex Antonenko,2014-10-29 00:26:37+02:00,['2054284defcc59a0119b07477d5b6562203b161e'],1,1,2,18932905,1,,,,16380
6742635d7633fff1c1d638bf016863ae30dec12e,1,Srimanth Gunturi,2014-10-28 16:13:30-07:00,['eee89b79bad82986e58da2ce5a3dbd63a90dbf8a'],19,91,110,18933015,2,0,0,1,16380
552792b932ec3804b2a411b8c164eabba3d97382,1,Jun Aoki,2014-10-28 17:16:49-07:00,['6742635d7633fff1c1d638bf016863ae30dec12e'],1,1,2,18933017,1,,,,16380
d6652e8dc8fd5642ce89cfb683f62c4c98cd3bff,1,Alejandro Fernandez,2014-10-28 17:23:45-07:00,['552792b932ec3804b2a411b8c164eabba3d97382'],127,114,241,18933258,12,0.769230769,0.807692308,0.769230769,16380
ea4dbc1c7fe6ea2a4233f916799fafa641f34f3e,1,Srimanth Gunturi,2014-10-28 17:39:19-07:00,['d6652e8dc8fd5642ce89cfb683f62c4c98cd3bff'],14,20,34,18933292,1,,,,16380
e1ad9d3f384b230b7ccc7c62b49e28fc5b489fa1,1,Alejandro Fernandez,2014-10-28 19:35:03-07:00,['ea4dbc1c7fe6ea2a4233f916799fafa641f34f3e'],35,21,56,18933348,4,,,,16380
54cba9cac6aab85bdb51015832bdb048566ff8d2,1,Srimanth Gunturi,2014-10-28 19:55:19-07:00,['e1ad9d3f384b230b7ccc7c62b49e28fc5b489fa1'],6,20,26,18933374,2,0,0,1,16380
9c024238fc9d1fde3359185b1d5cb49c773ca933,0,Sumit Mohanty,2014-10-28 22:29:47-07:00,['54cba9cac6aab85bdb51015832bdb048566ff8d2'],28,37,65,18933439,1,,,,16380
bcf1c9914b03ceec1d639b6c1078becaa9f6aff0,1,aBabiichuk,2014-10-29 14:07:10+02:00,['9c024238fc9d1fde3359185b1d5cb49c773ca933'],5,5,10,18933449,3,,,,16380
f645c21cfca27872829a1cf4349b0a25202ee40c,1,Jonathan Hurley,2014-10-29 10:22:46-04:00,['bcf1c9914b03ceec1d639b6c1078becaa9f6aff0'],69,214,283,18933732,15,0.384615385,0.615384615,1,16382
f784ed9187bd747a2d5291384819c7f690466c6d,1,Jonathan Hurley,2014-10-29 10:22:46-04:00,['f645c21cfca27872829a1cf4349b0a25202ee40c'],87,258,345,18934077,6,0,0,1,16385
4fcce7dd0a4d52398bfa6b40d574e6e4280f257e,1,Andrew Onishuk,2014-10-29 17:50:09+02:00,['f784ed9187bd747a2d5291384819c7f690466c6d'],0,3,3,18934080,1,,,,16385
d638d9bffa11a12bd2fd3837f7d3004f81e3c095,1,Sumit Mohanty,2014-10-29 09:13:06-07:00,['4fcce7dd0a4d52398bfa6b40d574e6e4280f257e'],0,4,4,18934084,1,,,,16385
6a29afb0ffc7770866cf5fb03fd8e41d7ea950e5,1,Andrew Onishuk,2014-10-29 18:26:23+02:00,['d638d9bffa11a12bd2fd3837f7d3004f81e3c095'],0,7,7,18934091,2,0.571428571,1,0.428571429,16385
0e93c5d5e44a93202a2dfe01713b74fad2788546,1,Lisnichenko Dmitro,2014-10-29 18:48:08+02:00,['6a29afb0ffc7770866cf5fb03fd8e41d7ea950e5'],15,31,46,18934137,3,1,1,1,16385
957077c5c986272db4715b1ea98c2c4bb7fcb917,1,Dmytro Sen,2014-10-29 19:16:16+02:00,['0e93c5d5e44a93202a2dfe01713b74fad2788546'],1,171,172,18934309,4,0.016129032,0.419354839,1,16386
d063cc637991c152d0dfd2da5479f66909197f2a,1,Jonathan Hurley,2014-10-29 14:26:50-04:00,['957077c5c986272db4715b1ea98c2c4bb7fcb917'],3,70,73,18934382,2,0,1,0.928571429,16386
be4815b3edc42532cb37cf24a041b860d71c34c2,1,Yusaku Sako,2014-10-29 14:47:33-07:00,['d063cc637991c152d0dfd2da5479f66909197f2a'],0,95,95,18934477,3,,,,16388
b500548102992bcc276de12be8b7f7411b701bbc,0,Alejandro Fernandez,2014-10-29 15:23:53-07:00,['be4815b3edc42532cb37cf24a041b860d71c34c2'],1,1,2,18934479,1,,,,16388
90855a0dba130b387b193d825f76684028ac0c43,1,atkach,2014-10-30 00:38:51+02:00,['b500548102992bcc276de12be8b7f7411b701bbc'],23,74,97,18934576,13,1,1,1,16388
7bb936b65f209af8d64494fd50ded1ab29c3de64,1,Srimanth Gunturi,2014-10-29 15:46:23-07:00,['90855a0dba130b387b193d825f76684028ac0c43'],0,21,21,18934597,2,1,1,1,16388
350f6ff0c1efe3d6c163f500fbf658899ead5fdd,1,Jaimin Jetly,2014-10-29 17:41:59-07:00,['7bb936b65f209af8d64494fd50ded1ab29c3de64'],1,2,3,18934600,2,0,0,0,16388
44b304b456a1886d3acd8ebf05997e97a085d1a9,1,Alejandro Fernandez,2014-10-29 19:30:08-07:00,['350f6ff0c1efe3d6c163f500fbf658899ead5fdd'],1,3,4,18934604,1,0,1,1,16388
6e4c89bb069fc6c0723c6ce11fcb2e48fe08f3e0,0,tbeerbower,2014-10-30 05:01:19-04:00,['44b304b456a1886d3acd8ebf05997e97a085d1a9'],0,4,4,18934608,1,0,0.25,1,16388
f65a5af6c62c14c8442e7c3c6a88e07ac2a4a76e,1,Jonathan Hurley,2014-10-30 08:22:06-04:00,['6e4c89bb069fc6c0723c6ce11fcb2e48fe08f3e0'],77,200,277,18934885,4,0.09375,1,0.515625,16388
22c5e69d752569e03b2e6ae03124471eca5b66a1,1,Nate Cole,2014-10-30 10:31:53-04:00,['f65a5af6c62c14c8442e7c3c6a88e07ac2a4a76e'],1,102,103,18934988,3,0.152173913,0.847826087,0.304347826,16389
587743d08c1637eed283b80f2ba05522eb2ef1bf,0,Andrew Onishuk,2014-10-30 16:41:24+02:00,['22c5e69d752569e03b2e6ae03124471eca5b66a1'],0,2,2,18934990,1,,,,16389
2fa1ffb5f6eb0704182de78a756a787290b0d85d,1,Andrew Onishuk,2014-10-30 16:47:45+02:00,['587743d08c1637eed283b80f2ba05522eb2ef1bf'],24,59,83,18935073,14,1,1,1,16390
cb2b446da835aeb52049e36544dba170c9521bce,1,Dmytro Sen,2014-10-30 17:30:40+02:00,['2fa1ffb5f6eb0704182de78a756a787290b0d85d'],1,1,2,18935075,1,,,,16390
bff65d1601bf9f472558aea7a3a3811af59e7a0d,0,Lisnichenko Dmitro,2014-10-30 17:32:20+02:00,['cb2b446da835aeb52049e36544dba170c9521bce'],12,22,34,18935109,3,0.5,0.333333333,1,16390
df98ca9e46c197dc5dc1ec50dc5d8144a084aaef,0,Lisnichenko Dmitro,2014-10-30 18:17:15+02:00,['bff65d1601bf9f472558aea7a3a3811af59e7a0d'],11,20,31,18935140,2,0.5,0.333333333,1,16390
adbf453a570371582bf338bf5b08062702b04441,1,aBabiichuk,2014-10-30 18:29:48+02:00,['df98ca9e46c197dc5dc1ec50dc5d8144a084aaef'],27,3,30,18935170,5,0.28,0.28,0.12,16390
9f2e955e1fe35d89440d09cc04a0af4f37bd0ce1,1,aBabiichuk,2014-10-30 18:29:48+02:00,['adbf453a570371582bf338bf5b08062702b04441'],3,4,7,18935177,1,0,1,1,16390
297a3589697dc421a6b4453a9890324a57f2024d,0,aBabiichuk,2014-10-30 18:29:49+02:00,['9f2e955e1fe35d89440d09cc04a0af4f37bd0ce1'],0,1,1,18935178,1,,,,16390
b333ee843d6ba6b811e09ccf1c957bb353021bb6,1,Dmytro Sen,2014-10-30 18:47:03+02:00,['297a3589697dc421a6b4453a9890324a57f2024d'],1,1,2,18935180,1,,,,16390
d8e8a09158cd50bd1b5d27a1d16f2bf0bb2f4b9a,1,Srimanth Gunturi,2014-10-30 09:48:32-07:00,['b333ee843d6ba6b811e09ccf1c957bb353021bb6'],0,36,36,18935216,2,,,,16391
ce69d0077c9f45f9ad0824a40352771604b3b17a,1,John Speidel,2014-10-30 13:39:08-04:00,['d8e8a09158cd50bd1b5d27a1d16f2bf0bb2f4b9a'],0,162,162,18935378,2,0.063829787,1,1,16391
dc93cbb3769417ebccc34f6703ebd99f21238c19,1,Aleksandr Kovalenko,2014-10-30 19:44:12+02:00,['ce69d0077c9f45f9ad0824a40352771604b3b17a'],12,1368,1380,18936758,9,0.191919192,0.414141414,1,16393
b2aec15e84903bc99022e9a3cf8f348d76fe4bde,1,Xi Wang,2014-10-30 11:03:46-07:00,['dc93cbb3769417ebccc34f6703ebd99f21238c19'],3,175,178,18936936,10,0,1,1,16397
9e3d0c1b30ee47b8f18915ec5eeb7d5ee75b360a,0,Lisnichenko Dmitro,2014-10-30 21:08:08+02:00,['b2aec15e84903bc99022e9a3cf8f348d76fe4bde'],5,11,16,18936952,2,0,0.4,1,16397
c032eb494b0d6d51eebb1caa8eb257bc79886a61,0,Alex Antonenko,2014-10-30 21:56:07+02:00,['9e3d0c1b30ee47b8f18915ec5eeb7d5ee75b360a'],0,1,1,18936953,1,0,0,1,16397
37cfa697bc09e3b7576e722ec38680c9f2723842,1,atkach,2014-10-30 22:24:54+02:00,['c032eb494b0d6d51eebb1caa8eb257bc79886a61'],1,1,2,18936955,1,,,,16397
cb54d4778cfc009705f84fbfdfb3f9d758463e84,1,tbeerbower,2014-10-30 19:30:09-04:00,['37cfa697bc09e3b7576e722ec38680c9f2723842'],0,17,17,18936972,1,0,0,0,16397
ee6852e22260c076de00a04eed562d523d06132d,1,Scott Creeley,2014-10-30 20:21:38-04:00,['cb54d4778cfc009705f84fbfdfb3f9d758463e84'],4,5,9,18936981,1,0,0,1,16397
3f6589dcd5bf030bf8a8dc6d85ce456fdfd8edc5,1,Srimanth Gunturi,2014-10-30 18:55:34-07:00,['ee6852e22260c076de00a04eed562d523d06132d'],5,17,22,18937003,4,0.4,0.4,0.4,16397
6280aca95e0b7402af06aa1b2f3a7cf463a66b8f,1,Alejandro Fernandez,2014-10-30 20:46:10-07:00,['3f6589dcd5bf030bf8a8dc6d85ce456fdfd8edc5'],3,3,6,18937009,2,,,,16397
bc5d7e07cc2b46acd648cddd8a6710153a1e8a6f,0,Dmytro Sen,2014-10-31 14:04:28+02:00,['6280aca95e0b7402af06aa1b2f3a7cf463a66b8f'],15,21,36,18937045,2,0,0.8,1,16397
fb016d5cce61e1b06b9c467bc28f4c0a98b1481c,1,Jonathan Hurley,2014-10-31 08:22:47-04:00,['bc5d7e07cc2b46acd648cddd8a6710153a1e8a6f'],19,1403,1422,18938467,15,0.15,0.228571429,1,16408
93d8fdf0fb8749a6702c9b903d4dfe1cb3ec2dbe,1,Srimanth Gunturi,2014-10-31 07:25:58-07:00,['fb016d5cce61e1b06b9c467bc28f4c0a98b1481c'],3,8,11,18938478,1,0,0,1,16408
158ec3c355785559027ac8ee1f9239070584c0ff,1,Lisnichenko Dmitro,2014-10-31 17:23:57+02:00,['93d8fdf0fb8749a6702c9b903d4dfe1cb3ec2dbe'],18,21,39,18938517,3,,,,16408
930bbaa18e1869d77f6c2830aed3023c2f2af9c5,1,Alejandro Fernandez,2014-10-31 09:21:50-07:00,['158ec3c355785559027ac8ee1f9239070584c0ff'],34,78,112,18938629,21,0,0,1,16408
fb5dca7db8dc8cecae8c58dcb963841a33a5e501,0,aBabiichuk,2014-10-31 18:29:22+02:00,['930bbaa18e1869d77f6c2830aed3023c2f2af9c5'],13,79,92,18938721,2,0.015151515,1,1,16408
0af0d9b3ce1d380df232852036d69d8a50f10574,1,aBabiichuk,2014-10-31 18:29:23+02:00,['fb5dca7db8dc8cecae8c58dcb963841a33a5e501'],1,1,2,18938723,1,,,,16408
6fc532bc4a7cab0a667229be68491c9dc83e9dc8,1,Oleg Nechiporenko,2014-10-31 19:28:29+02:00,['0af0d9b3ce1d380df232852036d69d8a50f10574'],27,823,850,18939573,16,0.70952381,0.823809524,0.938095238,16414
b935b50b62f63a210b25cfc6ddf3df2672f54602,1,Andrew Onishuk,2014-10-31 20:16:48+02:00,['6fc532bc4a7cab0a667229be68491c9dc83e9dc8'],5,6,11,18939584,4,,,,16414
79c147a5e27adccd64baf0516adc263f5ff58c40,0,Andrew Onishuk,2014-10-31 20:38:03+02:00,['b935b50b62f63a210b25cfc6ddf3df2672f54602'],2,2,4,18939588,2,,,,16414
3cb71c0ba7d99488601e9b3e3ea9b16cda839ac1,1,Andrew Onishuk,2014-10-31 21:01:52+02:00,['79c147a5e27adccd64baf0516adc263f5ff58c40'],1,1,2,18939590,1,,,,16414
73b6d6b13c7253f0613d3c58d05474b6e13e166e,1,Alex Antonenko,2014-10-31 21:22:27+02:00,['3cb71c0ba7d99488601e9b3e3ea9b16cda839ac1'],4,3,7,18939597,2,0,0,0,16414
482b7686c1616cbd1d916b0732c32c5602f78fa1,1,Andrew Onishuk,2014-10-31 21:38:19+02:00,['73b6d6b13c7253f0613d3c58d05474b6e13e166e'],16,136,152,18939749,6,0,0.071428571,1,16414
b0887b3fe6e332a8efd6613c6aa1d35c4f34e74b,1,Andrew Onishuk,2014-10-31 21:47:07+02:00,['482b7686c1616cbd1d916b0732c32c5602f78fa1'],0,13,13,18939762,3,,,,16414
52f70fd7eeada3c83dfcd4255115195dc37ccaf2,0,tbeerbower,2014-10-31 16:12:10-04:00,['b0887b3fe6e332a8efd6613c6aa1d35c4f34e74b'],4,7,11,18939773,1,0,0,1,16414
632857d4d532080309154eea80b8d40d7f9b8ce0,1,Mahadev Konar,2014-10-31 13:13:57-07:00,['52f70fd7eeada3c83dfcd4255115195dc37ccaf2'],111,95,206,18939979,10,1,0,0,16416
87956856bb371bd61d9e154e554352486dba38ba,1,Siddharth Wagle,2014-10-31 14:13:23-07:00,['632857d4d532080309154eea80b8d40d7f9b8ce0'],0,84,84,18940063,1,0,1,1,16416
e2d4f2f390b7db0693a1a48c69b4b27601f8e685,0,Siddharth Wagle,2014-10-31 14:13:38-07:00,['87956856bb371bd61d9e154e554352486dba38ba'],3,3,6,18940069,1,,,,16416
41b37c414ed146ddaae8e16fdd650d22ccf524d4,0,Mahadev Konar,2014-10-31 14:34:44-07:00,['e2d4f2f390b7db0693a1a48c69b4b27601f8e685'],4,17,21,18940090,1,0,0,1,16416
40f0c056be356194960cd33d9f98596df13fb175,0,Srimanth Gunturi,2014-10-31 15:01:00-07:00,['41b37c414ed146ddaae8e16fdd650d22ccf524d4'],32,0,32,18940122,2,,,,16416
93265aa983e913749c381fe0a07ec110076ac29a,0,Yusaku Sako,2014-10-31 15:25:11-07:00,['40f0c056be356194960cd33d9f98596df13fb175'],29,0,29,18940151,1,,,,16416
a7a8f1be2bf62fe08af60a20efbfd05900eeaf1c,1,Siddharth Wagle,2014-10-31 15:31:00-07:00,['93265aa983e913749c381fe0a07ec110076ac29a'],9,174,183,18940334,5,0,0.070175439,1,16417
4482d2ccd30ffe587dd09d9106381c60ddbf52ee,1,Alejandro Fernandez,2014-10-31 15:34:49-07:00,['a7a8f1be2bf62fe08af60a20efbfd05900eeaf1c'],2,3,5,18940339,1,,,,16417
6cd446efe364ed86d00172ada4a9eab37435b8ec,1,Alejandro Fernandez,2014-10-31 16:22:35-07:00,['4482d2ccd30ffe587dd09d9106381c60ddbf52ee'],2,2,4,18940343,1,,,,16417
974ade37e7bf6862a7d60b0a62e42f0fb346b84e,1,Siddharth Wagle,2014-10-31 17:23:18-07:00,['6cd446efe364ed86d00172ada4a9eab37435b8ec'],4,9,13,18940356,1,0,0,0,16417
f3fe2eb2168378a555d441e7b248adfba621fd8f,0,Xi Wang,2014-10-31 17:32:25-07:00,['974ade37e7bf6862a7d60b0a62e42f0fb346b84e'],3,14,17,18940373,3,,,,16417
2ca27fadc6a6cc077b57cbbe85deab1f7fe26d85,0,Siddharth Wagle,2014-10-31 17:52:05-07:00,['f3fe2eb2168378a555d441e7b248adfba621fd8f'],1,2,3,18940376,1,0,0,0,16417
ab7fc1ffecc363dd1e4ed51dfcd1cc9cdc5e86fb,1,Andrew Onishuk,2014-11-01 15:16:18+02:00,['2ca27fadc6a6cc077b57cbbe85deab1f7fe26d85'],3,25,28,18940404,4,0,0.125,1,16417
76a6dd6a064c0fa9d6ac3f39aa01b50724aae495,1,Oleg Nechiporenko,2014-11-01 16:33:06+02:00,['ab7fc1ffecc363dd1e4ed51dfcd1cc9cdc5e86fb'],0,194,194,18940598,8,1,1,1,16421
a38de7baec1d750bb5c05ea27202885e542f78cc,1,Dmytro Sen,2014-11-01 20:18:02+02:00,['76a6dd6a064c0fa9d6ac3f39aa01b50724aae495'],18,11,29,18940627,4,,,,16421
74877bf7cc8f51772d51e3f2b144658d3a6cd016,1,Nate Cole,2014-11-01 14:47:16-04:00,['a38de7baec1d750bb5c05ea27202885e542f78cc'],3,890,893,18941520,5,0,1,1,16422
3d7b434cf3323a7b5b607f776b8b107c37d7e5b8,1,Dmytro Sen,2014-11-01 21:34:27+02:00,['74877bf7cc8f51772d51e3f2b144658d3a6cd016'],0,383,383,18941903,4,,,,16424
6a9662ad5771cc5d40e4351c3e9ce4e7b047d722,1,Dmytro Sen,2014-11-01 21:38:08+02:00,['3d7b434cf3323a7b5b607f776b8b107c37d7e5b8'],8,9,17,18941920,4,0,1,1,16424
7ee4aed1fd463a6bbdce70dfc1c8c05c141a89ae,1,Myroslav Papirkovskyy,2014-11-01 21:48:24+02:00,['6a9662ad5771cc5d40e4351c3e9ce4e7b047d722'],12,15,27,18941947,2,0,0,1,16424
5eb44e3625bc219c80cd852bb6ed2388285fbb4c,0,Andrew Onishuk,2014-11-01 21:51:35+02:00,['7ee4aed1fd463a6bbdce70dfc1c8c05c141a89ae'],0,5,5,18941952,1,0,0,1,16424
b7799aa93527a4240a7be7a14bcd08c720ded5be,1,Andrew Onishuk,2014-11-01 22:07:42+02:00,['5eb44e3625bc219c80cd852bb6ed2388285fbb4c'],1,2,3,18941955,1,0,0,1,16424
212a13d358c385913d038cd124420878dc8e2694,1,Andrew Onishuk,2014-11-01 22:55:31+02:00,['b7799aa93527a4240a7be7a14bcd08c720ded5be'],2,2,4,18941959,2,,,,16424
3609e5f2148ac5ad870e31118e4eb29d4b0d0fdc,1,Oleg Nechiporenko,2014-11-01 22:59:13+02:00,['212a13d358c385913d038cd124420878dc8e2694'],1,1,2,18941961,1,,,,16424
f93e73c4b151709664101b23a6c59e479dd84eac,1,Srimanth Gunturi,2014-11-01 14:31:29-07:00,['3609e5f2148ac5ad870e31118e4eb29d4b0d0fdc'],39,297,336,18942297,6,0.790419162,1,1,16424
29c42549b40e61ff4401fd8ebd0603ec6b199711,1,Jaimin Jetly,2014-11-01 15:46:57-07:00,['f93e73c4b151709664101b23a6c59e479dd84eac'],4,15,19,18942316,2,0,0,1,16424
c54b16f4795eed7263b9948a47011d0857ad0640,1,Jaimin Jetly,2014-11-01 16:18:35-07:00,['29c42549b40e61ff4401fd8ebd0603ec6b199711'],0,8,8,18942324,2,0,0.875,1,16424
96a7e977466f8ab109bfc7c17cebb9a084eff71f,0,Alejandro Fernandez,2014-11-01 17:54:33-07:00,['c54b16f4795eed7263b9948a47011d0857ad0640'],1,1,2,18942326,1,,,,16424
0ac7138fd53f8be9b6f615f8513dc04a0de459a9,1,atkach,2014-11-02 18:41:42+02:00,['96a7e977466f8ab109bfc7c17cebb9a084eff71f'],5,254,259,18942585,13,0.261904762,0.947619048,1,16425
2414fec43475a286900fae8feb7908cac79d0dcb,0,atkach,2014-11-02 18:51:10+02:00,['0ac7138fd53f8be9b6f615f8513dc04a0de459a9'],2,110,112,18942697,2,0.393162393,0.803418803,1,16425
7cea66b6e0d9f45a86f69757d57e7922c15988ed,1,atkach,2014-11-02 20:52:52+02:00,['2414fec43475a286900fae8feb7908cac79d0dcb'],50,87,137,18942834,5,0.944444444,0.055555556,1,16425
ec94629891bb4592593f9060b496629d6f2aaa64,1,atkach,2014-11-02 22:22:37+02:00,['7cea66b6e0d9f45a86f69757d57e7922c15988ed'],4,191,195,18943029,4,0.467741935,1,1,16426
9b82517977ac8baa7c3b65abca1a1f2c0a885d27,1,atkach,2014-11-02 22:32:32+02:00,['ec94629891bb4592593f9060b496629d6f2aaa64'],3,6,9,18943038,1,1,1,1,16426
ee374e94a2c413281a1f05fc1b083b294e408c83,0,Mahadev Konar,2014-11-02 12:49:25-08:00,['9b82517977ac8baa7c3b65abca1a1f2c0a885d27'],26,1,27,18943065,1,,,,16426
2583407a82a572bca6619ced6ae0c9f27c567946,1,Alex Antonenko,2014-11-02 23:42:26+02:00,['ee374e94a2c413281a1f05fc1b083b294e408c83'],3,3,6,18943071,1,,,,16426
d744db13ad75ad4eabd9a128e3b32597347ddb98,1,Srimanth Gunturi,2014-11-02 17:22:54-08:00,['2583407a82a572bca6619ced6ae0c9f27c567946'],2,7,9,18943080,4,0.8,0.8,1,16426
b583fa9f53c29a3a3640396fc8a2e58cc1a18fe8,1,John Speidel,2014-11-02 22:29:59-05:00,['d744db13ad75ad4eabd9a128e3b32597347ddb98'],227,323,550,18943630,5,1,1,0,16426
c3eff50747709fd9ca0ec01bf6cd495155952d7a,1,Alejandro Fernandez,2014-11-02 21:11:39-08:00,['b583fa9f53c29a3a3640396fc8a2e58cc1a18fe8'],2,6,8,18943638,2,,,,16426
3ee81bce18be5e8772b593839cc12b1451d96681,1,Oleg Nechiporenko,2014-11-03 13:01:52+02:00,['c3eff50747709fd9ca0ec01bf6cd495155952d7a'],6,68,74,18943712,2,0.475,1,1,16426
38853c94f8e1c3968eb28049bb2876fe64c2b8fb,1,Jonathan Hurley,2014-11-03 08:06:17-05:00,['3ee81bce18be5e8772b593839cc12b1451d96681'],16,105,121,18943833,4,0.086956522,0.108695652,0.913043478,16426
1ac1eecf7a0686ab421c1b4d7577fe9f03aa6906,0,Andrew Onishuk,2014-11-03 16:55:49+02:00,['38853c94f8e1c3968eb28049bb2876fe64c2b8fb'],4,5,9,18943842,1,0,0,1,16426
7a22e62ea0359529a482530ed2666ee5f984c0f8,1,Andrew Onishuk,2014-11-03 17:24:54+02:00,['1ac1eecf7a0686ab421c1b4d7577fe9f03aa6906'],6,249,255,18944097,4,1,1,0,16428
aeff76e14be1a32ab564a232fe8f6c23e0c198f9,1,aBabiichuk,2014-11-03 18:23:48+02:00,['7a22e62ea0359529a482530ed2666ee5f984c0f8'],3,8,11,18944108,2,1,1,1,16428
930cbc22e448b743e6e4480e28edec186f1c47b9,1,Andrii Tkach,2014-11-03 20:18:34+02:00,['aeff76e14be1a32ab564a232fe8f6c23e0c198f9'],5,5,10,18944118,2,0,1,1,16428
0f9e6ffd2ec48958b89ba76904a8bf276c7acac7,1,Alejandro Fernandez,2014-11-03 10:28:10-08:00,['930cbc22e448b743e6e4480e28edec186f1c47b9'],9,12,21,18944139,3,1,0,1,16428
0de2eb028a6abfa68c4e6c5b4d43a868201cd1f0,0,Jaimin Jetly,2014-11-03 10:41:20-08:00,['0f9e6ffd2ec48958b89ba76904a8bf276c7acac7'],1,3,4,18944143,1,,,,16428
08101e4300d9d1c7093ca0e32ff3ba38d00f84bf,1,Nate Cole,2014-11-03 13:50:04-05:00,['0de2eb028a6abfa68c4e6c5b4d43a868201cd1f0'],103,7,110,18944253,3,0.474576271,0.06779661,0.016949153,16428
b2116e173ab053be4a6960949b4c0edee3941b50,1,Dmytro Sen,2014-11-03 21:58:49+02:00,['08101e4300d9d1c7093ca0e32ff3ba38d00f84bf'],1,14,15,18944268,4,0,0,1,16428
4f3f1a662b050eb0c903634fbad29f532501b74d,0,Jaimin Jetly,2014-11-03 13:30:48-08:00,['b2116e173ab053be4a6960949b4c0edee3941b50'],0,4,4,18944272,2,0,0.5,1,16428
4beab82be39e69c72dbfd4b746b2f3be73c950a0,0,Alejandro Fernandez,2014-11-03 13:58:48-08:00,['4f3f1a662b050eb0c903634fbad29f532501b74d'],1,1,2,18944274,1,,,,16428
1df912537095d4b9de79f904b71681ebef073ef5,1,tbeerbower,2014-11-03 17:03:04-05:00,['4beab82be39e69c72dbfd4b746b2f3be73c950a0'],125,125,250,18944524,4,0,0,0,16428
d684bb677b685024f500c2327cb1edc718f9b16e,1,Srimanth Gunturi,2014-11-03 14:04:19-08:00,['1df912537095d4b9de79f904b71681ebef073ef5'],4,4,8,18944532,1,,,,16428
18b6518524e44e4c9cd4d5f3c21c6ac04f81a9a5,1,Alejandro Fernandez,2014-11-03 16:29:52-08:00,['d684bb677b685024f500c2327cb1edc718f9b16e'],10,9,19,18944551,5,,,,16428
acd4899c6de1d5df5b768fb3f542b4349a3332e3,0,Andrew Onishuk,2014-11-04 02:31:25+02:00,['18b6518524e44e4c9cd4d5f3c21c6ac04f81a9a5'],1,1,2,18944553,1,,,,16428
57fcb878d7d6ebd8910db9a22a6ac2d7c447b948,0,Siddharth Wagle,2014-11-03 17:49:10-08:00,['acd4899c6de1d5df5b768fb3f542b4349a3332e3'],6,0,6,18944559,1,,,,16428
9f27e084b64fc86526a19537011e8aa19fde5482,1,Jaimin Jetly,2014-11-04 03:06:12-08:00,['57fcb878d7d6ebd8910db9a22a6ac2d7c447b948'],22,341,363,18944922,10,1,1,1,16429
5f05539b1a04948ea141670bcaa7f25f08c3a3ad,0,aBabiichuk,2014-11-04 16:17:48+02:00,['9f27e084b64fc86526a19537011e8aa19fde5482'],1,1,2,18944924,1,,,,16429
dac8a9d7533f6d433935268594765b67b216adde,1,tbeerbower,2014-11-04 11:53:58-05:00,['5f05539b1a04948ea141670bcaa7f25f08c3a3ad'],8,8,16,18944940,2,1,0,0,16429
e302ffed4d50daba46af748076fb12b0a044a7c0,1,aBabiichuk,2014-11-04 20:37:01+02:00,['dac8a9d7533f6d433935268594765b67b216adde'],3,11,14,18944954,1,1,1,1,16429
ca12fe4360fa1c8c1efb98c27cca92e194e550b8,1,Lisnichenko Dmitro,2014-11-04 22:08:33+02:00,['e302ffed4d50daba46af748076fb12b0a044a7c0'],44,115,159,18945113,4,0.319148936,1,1,16430
0e5804f4cc927fa86ae1195d99d08f722fcbf24c,1,Alex Antonenko,2014-11-05 00:38:09+02:00,['ca12fe4360fa1c8c1efb98c27cca92e194e550b8'],5,14,19,18945132,2,1,1,1,16430
804fab44b59ecb20096f0a02725e423e65e8b939,1,Srimanth Gunturi,2014-11-04 15:04:07-08:00,['0e5804f4cc927fa86ae1195d99d08f722fcbf24c'],7,6,13,18945145,1,1,1,0,16430
84da60f37d93777083e6e1a6bc130f9791160268,1,Xi Wang,2014-11-04 15:30:43-08:00,['804fab44b59ecb20096f0a02725e423e65e8b939'],6,120,126,18945271,6,,,,16433
90478a89df1f6b49eb7f7123b3dcb6a3188cccb8,1,Jonathan Hurley,2014-11-04 18:35:05-05:00,['84da60f37d93777083e6e1a6bc130f9791160268'],38,610,648,18945919,22,0.262672811,0.267281106,0.976958525,16436
3c887415d396b3e2ed184abb40858a23a39cb2a1,1,Xi Wang,2014-11-04 16:09:04-08:00,['90478a89df1f6b49eb7f7123b3dcb6a3188cccb8'],3,15,18,18945937,2,,,,16436
646ba61da9998d6709d2ef10b6bd38a7dcc3ff1a,0,Yusaku Sako,2014-11-04 16:31:13-08:00,['3c887415d396b3e2ed184abb40858a23a39cb2a1'],0,3,3,18945940,1,,,,16436
2b36334f2d799a65f3dc3ed322651dc51dce06e4,1,Jaimin Jetly,2014-11-04 17:07:40-08:00,['646ba61da9998d6709d2ef10b6bd38a7dcc3ff1a'],0,14,14,18945954,3,0,1,1,16436
d6b88232cf3356e6b707b77841c7903a8ed97a96,1,Alejandro Fernandez,2014-11-04 17:09:51-08:00,['2b36334f2d799a65f3dc3ed322651dc51dce06e4'],1,24,25,18945979,2,0,1,1,16436
6872cbad4758a6f0bea0852bba49266e3d709627,1,Nate Cole,2014-11-04 20:56:52-05:00,['d6b88232cf3356e6b707b77841c7903a8ed97a96'],11,1119,1130,18947109,18,0.670926518,0.734824281,0.821086262,16448
508af3e5bb56598e618b5c16c6c3d25682ef0097,1,Lisnichenko Dmitro,2014-11-05 12:51:27+02:00,['6872cbad4758a6f0bea0852bba49266e3d709627'],6,40,46,18947155,2,0,0.071428571,1,16448
00eba5806d8afe723041e26d9d7b6b4964770902,1,Andrii Tkach,2014-11-05 15:15:35+02:00,['508af3e5bb56598e618b5c16c6c3d25682ef0097'],19,124,143,18947298,5,0.253731343,0.962686567,1,16448
885ff73d2fff9485fe11e45731391007d7dd6c28,0,Andrew Onishuk,2014-11-05 19:08:00+02:00,['00eba5806d8afe723041e26d9d7b6b4964770902'],1,1,2,18947300,1,,,,16448
2b0a9aa6e3552c6957c20b1ff65e3e49e568a0ae,1,Aleksandr Kovalenko,2014-11-05 19:34:22+02:00,['885ff73d2fff9485fe11e45731391007d7dd6c28'],92,523,615,18947915,15,1,1,1,16451
776743beb424157697be94e57aaf220ba10846ee,1,Dmytro Sen,2014-11-05 20:01:13+02:00,['2b0a9aa6e3552c6957c20b1ff65e3e49e568a0ae'],1,50,51,18947966,3,0,1,1,16452
c68cf2fdc5c96521fc39e5b609278bdb40a18c25,1,Oleg Nechiporenko,2014-11-05 20:02:47+02:00,['776743beb424157697be94e57aaf220ba10846ee'],1,67,68,18948034,3,0.162790698,1,1,16453
5ad408c98353ce84e58fb575713154d8570f03a5,1,Yusaku Sako,2014-11-05 11:32:40-08:00,['c68cf2fdc5c96521fc39e5b609278bdb40a18c25'],2,9,11,18948045,1,0,1,1,16453
9219aefc371a48a681143464001776ab09ae5b9a,0,Lisnichenko Dmitro,2014-11-05 21:59:58+02:00,['5ad408c98353ce84e58fb575713154d8570f03a5'],1,1,2,18948047,1,,,,16453
6dc6cc78234538b76190d5dd3bf85530e076fda8,1,Yusaku Sako,2014-11-05 16:29:55-08:00,['9219aefc371a48a681143464001776ab09ae5b9a'],1,15,16,18948063,4,0.230769231,0.615384615,1,16453
ec37a765e2a2a9ea926ec3e83970cb23fb93a476,1,Srimanth Gunturi,2014-11-05 23:28:33-08:00,['6dc6cc78234538b76190d5dd3bf85530e076fda8'],3,3,6,18948069,2,,,,16453
4d9685f4f6c033625fd11b61c575103833d6f362,1,Andrii Tkach,2014-11-06 13:36:23+02:00,['ec37a765e2a2a9ea926ec3e83970cb23fb93a476'],13,49,62,18948131,4,0.8,1,0.7,16453
f159e40bf0f344dc1994548bc82aaa9e1480579b,1,aBabiichuk,2014-11-06 14:48:29+02:00,['4d9685f4f6c033625fd11b61c575103833d6f362'],1,295,296,18948427,8,1,1,1,16458
c55e77f2f920d834747834c3cc1b69736ccd44b4,0,Dmytro Sen,2014-11-06 15:55:04+02:00,['f159e40bf0f344dc1994548bc82aaa9e1480579b'],4,3,7,18948434,3,,,,16458
9089bdc163659b234d52eefc056d1b75dd7812cb,0,Oleg Nechiporenko,2014-11-06 15:57:02+02:00,['c55e77f2f920d834747834c3cc1b69736ccd44b4'],1,1,2,18948436,1,,,,16458
836541a2f54eb36afebd46a9396827f7d59e246f,0,Aleksandr Kovalenko,2014-11-06 16:52:34+02:00,['9089bdc163659b234d52eefc056d1b75dd7812cb'],1,1,2,18948438,1,,,,16458
264c1c3149e8e912132e4f5abc219282d0f46c9d,1,Lisnichenko Dmitro,2014-11-06 17:50:32+02:00,['836541a2f54eb36afebd46a9396827f7d59e246f'],33,1132,1165,18949603,4,1,1,1,16459
f003a20bfeff82d7e03ccc2e55858c1c940738bb,1,Oleg Nechiporenko,2014-11-06 17:52:21+02:00,['264c1c3149e8e912132e4f5abc219282d0f46c9d'],2,98,100,18949703,4,1,1,1,16460
a9092f99087d4305bc323352204d2005fed0053d,1,Lisnichenko Dmitro,2014-11-06 18:40:19+02:00,['f003a20bfeff82d7e03ccc2e55858c1c940738bb'],252,252,504,18950207,70,,,,16460
e50d850cecc1c7c8bbc5c1c384dec4c29c185147,1,aBabiichuk,2014-11-06 18:43:19+02:00,['a9092f99087d4305bc323352204d2005fed0053d'],4,5,9,18950216,2,1,1,1,16460
a4b8c9b30f2756cb24ee372e5741d76db7b517a1,1,Siddharth Wagle,2014-11-06 09:35:53-08:00,['e50d850cecc1c7c8bbc5c1c384dec4c29c185147'],2,100,102,18950318,6,0,0.926829268,0.926829268,16460
a1e5cadd589e72c38f31035c74e08e0adce0edcc,1,Jaimin Jetly,2014-11-06 10:20:18-08:00,['a4b8c9b30f2756cb24ee372e5741d76db7b517a1'],1,7,8,18950326,2,1,1,1,16460
a320e033ced9361ca5fcd2116feda5014bbd308a,0,Jaimin Jetly,2014-11-06 10:30:18-08:00,['a1e5cadd589e72c38f31035c74e08e0adce0edcc'],2,2,4,18950330,1,,,,16460
c72888df0f6cccbd67a4106b76a26dea12631a96,1,Andrew Onishuk,2014-11-06 20:39:26+02:00,['a320e033ced9361ca5fcd2116feda5014bbd308a'],3,46,49,18950379,9,0.096774194,0,0.903225806,16460
c097a8f7bcd86aa4b102bedda714c4122682b058,0,Yusaku Sako,2014-11-06 11:00:47-08:00,['c72888df0f6cccbd67a4106b76a26dea12631a96'],0,6,6,18950385,2,0,1,1,16460
662ce6007ade2413c965e6340706522469357de9,1,Alejandro Fernandez,2014-11-06 11:40:23-08:00,['c097a8f7bcd86aa4b102bedda714c4122682b058'],18,21,39,18950424,5,0,1,1,16460
f0d571c3a780ae952de0b272f82b6047b7c7f9fd,0,Yusaku Sako,2014-11-06 12:05:12-08:00,['662ce6007ade2413c965e6340706522469357de9'],6,0,6,18950430,2,1,0,0,16460
24c39273ff0487c71f5688c14bf2ef8df9786210,1,Siddharth Wagle,2014-11-06 12:20:09-08:00,['f0d571c3a780ae952de0b272f82b6047b7c7f9fd'],7,7,14,18950444,2,,,,16460
2dcb2153d948af8922a8b4007a26ccf41c08c059,1,Mahadev Konar,2014-11-06 14:45:33-08:00,['24c39273ff0487c71f5688c14bf2ef8df9786210'],1,1,2,18950446,1,,,,16460
5b1be0f35d34c13f4b3240c59f03bf8e1a2334ec,0,Siddharth Wagle,2014-11-06 14:46:12-08:00,['2dcb2153d948af8922a8b4007a26ccf41c08c059'],2,2,4,18950450,2,,,,16460
5172bdf2ad6f83e3be38df03a13c37992e80231d,1,Srimanth Gunturi,2014-11-06 15:25:55-08:00,['5b1be0f35d34c13f4b3240c59f03bf8e1a2334ec'],9,17,26,18950476,4,0.571428571,0.571428571,1,16460
41cf385ffe59c297f4a1a7c4c72866186fcc4cea,1,Alejandro Fernandez,2014-11-06 16:47:12-08:00,['5172bdf2ad6f83e3be38df03a13c37992e80231d'],16,780,796,18951272,17,0.786069652,0.805970149,0.995024876,16464
d256ab8f94e9dc1292c9ce69e76235b215ca8dc0,0,Siddharth Wagle,2014-11-06 19:11:39-08:00,['41cf385ffe59c297f4a1a7c4c72866186fcc4cea'],87,27,114,18951386,5,1,0,0,16464
742d404efff2c985ebd959fbecd20fa7fbc78530,1,Siddharth Wagle,2014-11-06 20:57:03-08:00,['d256ab8f94e9dc1292c9ce69e76235b215ca8dc0'],27,87,114,18951500,5,0,1,1,16464
be0a3c15ec23e62cfa2ec9ae3ff542f77c823cd8,0,Siddharth Wagle,2014-11-06 20:57:56-08:00,['742d404efff2c985ebd959fbecd20fa7fbc78530'],7,7,14,18951514,2,,,,16464
37af1a64f4eb32c839933ad1b436eae5da3136a8,0,Siddharth Wagle,2014-11-06 20:59:11-08:00,['be0a3c15ec23e62cfa2ec9ae3ff542f77c823cd8'],100,2,102,18951616,6,1,0.073170732,0.073170732,16464
5b69bea270767f8ff71d0e8faa1b00e352408da4,1,Vitaly Brodetskyi,2014-11-07 13:07:22+02:00,['37af1a64f4eb32c839933ad1b436eae5da3136a8'],0,7,7,18951623,1,,,,16464
eaddabf2666ecfc5f8e50508986dfcd0ee4804ea,1,Andrii Tkach,2014-11-07 13:14:50+02:00,['5b69bea270767f8ff71d0e8faa1b00e352408da4'],131,1126,1257,18952880,6,0.635969664,1,1,16464
a59bbb2bc8897bc3f204ac8ea119e5827a0404ac,1,aBabiichuk,2014-11-07 14:28:03+02:00,['eaddabf2666ecfc5f8e50508986dfcd0ee4804ea'],6,8,14,18952894,3,,,,16464
b67ddc7c1fb94a13a2c10bb899d33f7cb5d86e44,1,aBabiichuk,2014-11-07 14:49:18+02:00,['a59bbb2bc8897bc3f204ac8ea119e5827a0404ac'],5,70,75,18952969,3,0.631578947,1,1,16464
1bf2795a462e9780f482de306b7eeaf3c6e51f13,1,Nate Cole,2014-11-07 08:33:16-05:00,['b67ddc7c1fb94a13a2c10bb899d33f7cb5d86e44'],46,1111,1157,18954126,20,0.687338501,0.726098191,0.976744186,16473
c079e906674c274c23f4c46f5fb312ec3e97c8fc,1,Nate Cole,2014-11-07 09:35:03-05:00,['1bf2795a462e9780f482de306b7eeaf3c6e51f13'],6,498,504,18954630,9,0.583690987,0.678111588,0.575107296,16475
d5d898a93184d9c62e828fde112b26cdcb1b9667,1,aBabiichuk,2014-11-07 17:10:12+02:00,['c079e906674c274c23f4c46f5fb312ec3e97c8fc'],2,679,681,18955311,12,0.817204301,1,1,16478
8c0ab9fb49846a8e8303b7bc1e94a8b35610a4bc,1,Andrew Onishuk,2014-11-07 17:20:51+02:00,['d5d898a93184d9c62e828fde112b26cdcb1b9667'],212,192,404,18955715,23,0.684210526,0.105263158,0,16480
a25de18716d65d389517c921d10094ea4758da6c,1,Dmytro Sen,2014-11-07 18:29:07+02:00,['8c0ab9fb49846a8e8303b7bc1e94a8b35610a4bc'],19,27,46,18955761,3,1,1,1,16480
96bcff5e3740e3b4865ff2e92dead0b0a7f3ed2e,1,Srimanth Gunturi,2014-11-07 08:35:13-08:00,['a25de18716d65d389517c921d10094ea4758da6c'],4,20,24,18955785,4,0.230769231,0.769230769,1,16480
cd3b01a9a28c013985e3cbc721f5673dcbbf4497,1,Alex Antonenko,2014-11-07 19:29:43+02:00,['96bcff5e3740e3b4865ff2e92dead0b0a7f3ed2e'],11,20,31,18955816,4,1,1,1,16480
b1c4853a61edd2a87977077d065356ea419ca3b3,1,Alex Antonenko,2014-11-07 19:29:44+02:00,['cd3b01a9a28c013985e3cbc721f5673dcbbf4497'],15,9,24,18955840,2,,,,16480
4aae5e4c8e4b1f632065b6fbadafc47ef2d30638,1,Alex Antonenko,2014-11-07 19:29:44+02:00,['b1c4853a61edd2a87977077d065356ea419ca3b3'],3,400,403,18956243,2,0.385135135,1,1,16480
b7fca727722b5ca5983ebd7ba05439e6d3fabc16,1,Oleg Nechiporenko,2014-11-07 19:42:30+02:00,['4aae5e4c8e4b1f632065b6fbadafc47ef2d30638'],17,50,67,18956310,2,1,1,1,16480
4f2eefeae4a4dac717ad199a803d06119d0587f2,1,Andrew Onishuk,2014-11-07 20:06:52+02:00,['b7fca727722b5ca5983ebd7ba05439e6d3fabc16'],3,30,33,18956343,4,0.24,1,0.8,16480
0cdde042b4a9018c2a70fd237a821eed52fbcb37,0,tbeerbower,2014-11-07 13:13:10-05:00,['4f2eefeae4a4dac717ad199a803d06119d0587f2'],0,3,3,18956346,1,0,0,1,16480
af31f3ec343043bb39e54175e7deb3f6950fa481,0,Nate Cole,2014-11-07 13:13:51-05:00,['0cdde042b4a9018c2a70fd237a821eed52fbcb37'],3,30,33,18956379,3,,,,16480
e59d95b3106c976997350c6b0a8b95d74ddf2d77,1,Vitaly Brodetskyi,2014-11-07 20:15:22+02:00,['af31f3ec343043bb39e54175e7deb3f6950fa481'],2,2,4,18956383,2,,,,16480
e7a77bdc17a567bc8448c7ef31cc71fba3e32261,1,Aleksandr Kovalenko,2014-11-07 21:33:53+02:00,['e59d95b3106c976997350c6b0a8b95d74ddf2d77'],8,468,476,18956859,2,0.626911315,1,1,16480
a99ca40618f45404c2c97719480e1bb8300fd766,1,Siddharth Wagle,2014-11-07 12:06:46-08:00,['e7a77bdc17a567bc8448c7ef31cc71fba3e32261'],47,98,145,18957004,10,1,1,1,16480
f4af798a5b12188f9d1835230d06a4e23ce3d1c4,0,Xi Wang,2014-11-07 13:00:40-08:00,['a99ca40618f45404c2c97719480e1bb8300fd766'],2,29,31,18957035,2,0.304347826,0.304347826,1,16480
d348f5db54e3a59a7a228fa698a8eb6d05712d6c,1,Jonathan Hurley,2014-11-07 16:12:17-05:00,['f4af798a5b12188f9d1835230d06a4e23ce3d1c4'],6,2024,2030,18959065,21,0.090116279,0.174418605,0.997093023,16496
2c1dd171adaf8e94c3df4a036b0afe0ab183f84a,0,Jaimin Jetly,2014-11-07 13:28:09-08:00,['d348f5db54e3a59a7a228fa698a8eb6d05712d6c'],33,7,40,18959105,10,,,,16496
7c648f7796bd6c73918302032f7feb98cc1f3790,0,Siddharth Wagle,2014-11-07 14:19:46-08:00,['2c1dd171adaf8e94c3df4a036b0afe0ab183f84a'],23,71,94,18959199,2,,,,16496
f812baf5871929b44d759933bf040b76170e2828,0,Yusaku Sako,2014-11-07 15:14:52-08:00,['7c648f7796bd6c73918302032f7feb98cc1f3790'],0,12,12,18959211,1,,,,16496
26a9c73022d283d4bc90b2943dc58a0cd0d02e0f,0,Mahadev Konar,2014-11-07 15:16:41-08:00,['f812baf5871929b44d759933bf040b76170e2828'],1,1,2,18959213,1,,,,16496
700d1d99c55b70b28137de120e1d60c48fbe815b,0,Mahadev Konar,2014-11-07 15:39:48-08:00,['26a9c73022d283d4bc90b2943dc58a0cd0d02e0f'],3,3,6,18959219,1,,,,16496
9590cfbd1967b798c793da5dcde8b6e0a8616eb7,0,Alejandro Fernandez,2014-11-07 16:25:36-08:00,['700d1d99c55b70b28137de120e1d60c48fbe815b'],8,20,28,18959247,4,0.142857143,0.142857143,0,16496
45658d2aa2935e05f4ae42ad9187d2482029e1bf,0,John Speidel,2014-11-07 19:34:21-05:00,['9590cfbd1967b798c793da5dcde8b6e0a8616eb7'],11,6,17,18959264,2,0,1,1,16496
689e16e6b9336704a63292b47addaca7866c7ae3,1,Srimanth Gunturi,2014-11-07 16:47:40-08:00,['45658d2aa2935e05f4ae42ad9187d2482029e1bf'],1,10,11,18959275,1,1,1,1,16496
0e143629d35b1d27ca5be9c00aed30357071f7cd,0,Jaimin Jetly,2014-11-07 16:51:02-08:00,['689e16e6b9336704a63292b47addaca7866c7ae3'],6,6,12,18959287,1,,,,16496
9e9071356a11de201c35da920e6366db7d58bf5f,0,Xi Wang,2014-11-07 16:59:52-08:00,['0e143629d35b1d27ca5be9c00aed30357071f7cd'],5,1,6,18959293,1,,,,16496
f9532293bafca45ebb665d6bee8d591c210cdf17,0,Mahadev Konar,2014-11-07 17:43:21-08:00,['9e9071356a11de201c35da920e6366db7d58bf5f'],71,23,94,18959387,2,,,,16496
ae2cd3d7aed505e5aaeb38ca087f3c6dbb4b7774,1,Yusaku Sako,2014-11-07 18:02:16-08:00,['f9532293bafca45ebb665d6bee8d591c210cdf17'],0,8,8,18959395,3,0,1,1,16496
b6326be3ae26f5b3ca9f24d2b861b2bb8bad3f18,1,John Speidel,2014-11-07 21:12:37-05:00,['ae2cd3d7aed505e5aaeb38ca087f3c6dbb4b7774'],4,59,63,18959458,2,0.096774194,0.903225806,1,16496
fc136f5e4f9724aadfe1e7437437032a0d739630,1,Yusaku Sako,2014-11-07 21:47:33-08:00,['b6326be3ae26f5b3ca9f24d2b861b2bb8bad3f18'],20,8,28,18959486,4,0.857142857,0.857142857,1,16496
54057219e1fed010a5abcc3e3b0c4a984fe1802d,1,Andrew Onishuk,2014-11-08 20:18:58+02:00,['fc136f5e4f9724aadfe1e7437437032a0d739630'],4,10,14,18959500,1,,,,16496
2afc26d4df00ec254026411f51b1b47a664aac13,1,Jaimin Jetly,2014-11-08 13:56:59-08:00,['54057219e1fed010a5abcc3e3b0c4a984fe1802d'],0,24,24,18959524,5,1,1,1,16496
f781e6db59e7670fc52d39c2e0d29bbce1b785bc,1,Jaimin Jetly,2014-11-08 14:26:43-08:00,['2afc26d4df00ec254026411f51b1b47a664aac13'],25,73,98,18959622,2,,,,16496
b40fae1c59bc2b7025cb85368747444653b1659e,1,Alejandro Fernandez,2014-11-08 14:41:04-08:00,['f781e6db59e7670fc52d39c2e0d29bbce1b785bc'],8,20,28,18959650,4,0.142857143,0.142857143,0,16496
b4b9a9700a80a45dbe899b7854bff50d08a21af6,1,Srimanth Gunturi,2014-11-08 16:18:21-08:00,['b40fae1c59bc2b7025cb85368747444653b1659e'],3,3,6,18959656,1,,,,16496
d11292226e758e574c17755b63dda733d39cb404,1,ababiichuk,2014-11-09 09:50:07+02:00,['b4b9a9700a80a45dbe899b7854bff50d08a21af6'],9,12,21,18959677,2,1,1,1,16496
24a1d3d15fdd4f3b5dcaff49646922775c3d2960,0,Yusaku Sako,2014-11-09 07:50:12-08:00,['d11292226e758e574c17755b63dda733d39cb404'],9,12,21,18959698,2,0,1,1,16496
ce06152e2e4b405344d1ceceb9a2fe3e5ac29539,0,ababiichuk,2014-11-09 18:15:03+02:00,['24a1d3d15fdd4f3b5dcaff49646922775c3d2960'],1,1,2,18959700,1,,,,16496
551fd3c648b3a611f1f0132f52902ee772732181,0,Yusaku Sako,2014-11-09 09:27:51-08:00,['ce06152e2e4b405344d1ceceb9a2fe3e5ac29539'],2,2,4,18959704,1,,,,16496
087f24cdd7824c1c5e51a8c9b5ddc9017b0d9a15,0,Xi Wang,2014-11-09 09:39:44-08:00,['551fd3c648b3a611f1f0132f52902ee772732181'],1,0,1,18959705,1,0,0,0,16496
a0d10fc1d63daf6c46c266a48d494e882f24024a,1,Srimanth Gunturi,2014-11-09 12:25:57-08:00,['087f24cdd7824c1c5e51a8c9b5ddc9017b0d9a15'],17,6,23,18959728,1,,,,16496
5ad48c755d5cf83d6406aa812ed1c67041217f0b,0,Jaimin Jetly,2014-11-09 12:41:24-08:00,['a0d10fc1d63daf6c46c266a48d494e882f24024a'],2,4,6,18959734,1,1,1,1,16496
a9a641d513d9546416436f6aaaed2251d38ff386,0,Yusaku Sako,2014-11-09 13:53:37-08:00,['5ad48c755d5cf83d6406aa812ed1c67041217f0b'],1,7,8,18959742,1,1,1,1,16496
c1759714175d0609f43dd54b337538363ceeb374,1,Yusaku Sako,2014-11-09 14:00:08-08:00,['a9a641d513d9546416436f6aaaed2251d38ff386'],8,9,17,18959759,2,0,0,0,16496
b5a3d2ab3e26a20751076b3a051c56787ef09eb0,1,Alejandro Fernandez,2014-11-09 16:12:13-08:00,['c1759714175d0609f43dd54b337538363ceeb374'],1,1,2,18959761,1,,,,16496
3266c7da8ac3ff70173c9c10908220260d8a937f,1,Andrii Tkach,2014-11-10 14:01:35+02:00,['b5a3d2ab3e26a20751076b3a051c56787ef09eb0'],20,406,426,18960187,13,0.935779817,1,1,16500
6f1e47637ae1ab3b0a98022be2c4aae02f6092cc,0,Dmytro Sen,2014-11-10 14:26:31+02:00,['3266c7da8ac3ff70173c9c10908220260d8a937f'],3,3,6,18960193,3,,,,16500
e2fc2da45e6b392502dee2955096371cf21c3398,0,Oleg Nechiporenko,2014-11-10 14:32:14+02:00,['6f1e47637ae1ab3b0a98022be2c4aae02f6092cc'],14,26,40,18960233,2,0,1,1,16500
771d17e8458476851e1dab401561fbc5f8692a29,1,Oleg Nechiporenko,2014-11-10 14:32:14+02:00,['e2fc2da45e6b392502dee2955096371cf21c3398'],0,5,5,18960238,2,1,1,1,16500
5c6bfc765ca9923ceb9341c12d5b7bb8e5fb627b,1,Andrew Onishuk,2014-11-10 16:16:42+02:00,['771d17e8458476851e1dab401561fbc5f8692a29'],1,1,2,18960240,1,,,,16500
b17637c9b8b42594f92a017cf0846589251917f1,1,Nate Cole,2014-11-10 09:39:42-05:00,['5c6bfc765ca9923ceb9341c12d5b7bb8e5fb627b'],72,1015,1087,18961327,16,0.398963731,0.787564767,1,16512
de1f8ff64d138e647148bb8b660cec5e9a081a02,1,Oleg Nechiporenko,2014-11-10 17:44:05+02:00,['b17637c9b8b42594f92a017cf0846589251917f1'],26,14,40,18961367,2,1,0,0,16512
f088f55e4d9853ec0f671e1d095abb349d9d8a20,1,Jonathan Hurley,2014-11-10 11:00:14-05:00,['de1f8ff64d138e647148bb8b660cec5e9a081a02'],50,426,476,18961843,4,0.056497175,0.344632768,1,16513
ae0d8257440f7399f457ebbf71e03f1198296727,0,Alex Antonenko,2014-11-10 18:09:39+02:00,['f088f55e4d9853ec0f671e1d095abb349d9d8a20'],12,13,25,18961868,3,,,,16513
596226d0b88ed85eceeffcefa987ba0067552ee2,1,Andrew Onishuk,2014-11-10 18:39:10+02:00,['ae0d8257440f7399f457ebbf71e03f1198296727'],4,7,11,18961879,1,0,0,1,16513
caf03d022e90e97a9ccf3ff9ecd910d15b8a5099,1,Lisnichenko Dmitro,2014-11-10 18:59:34+02:00,['596226d0b88ed85eceeffcefa987ba0067552ee2'],1,1,2,18961881,1,,,,16513
8d7b99343abc0711c9c50b635b7621a374eec7e1,1,Andrii Tkach,2014-11-10 19:28:40+02:00,['caf03d022e90e97a9ccf3ff9ecd910d15b8a5099'],129,411,540,18962421,9,0,0,0,16513
294f3df45deb27cacbb89c61e0eb347bf7c01bcb,0,Dmytro Sen,2014-11-10 19:57:13+02:00,['8d7b99343abc0711c9c50b635b7621a374eec7e1'],1,1,2,18962423,1,,,,16513
4e255b71721a7dc4e3c8b7c354415ecc0f9c68df,1,Lisnichenko Dmitro,2014-11-10 20:06:23+02:00,['294f3df45deb27cacbb89c61e0eb347bf7c01bcb'],2,2,4,18962427,2,,,,16513
f8106748a6b9088a97efbbf8a7bad6bd0bbb6d9c,1,Yusaku Sako,2014-11-10 10:23:56-08:00,['4e255b71721a7dc4e3c8b7c354415ecc0f9c68df'],13,12,25,18962452,3,,,,16513
b3cba943938b04cf6b007510cf986357e1a7d946,0,Andrii Tkach,2014-11-10 21:54:42+02:00,['f8106748a6b9088a97efbbf8a7bad6bd0bbb6d9c'],2,2,4,18962456,1,,,,16513
b71407f064500fcbd21cb3bc6bbe6f57df5bd527,0,Andrew Onishuk,2014-11-10 21:56:58+02:00,['b3cba943938b04cf6b007510cf986357e1a7d946'],2,2,4,18962460,2,,,,16513
2fc7adecea03ec70141f41e98f1aa2d089c3b364,1,John Speidel,2014-11-10 16:31:43-05:00,['b71407f064500fcbd21cb3bc6bbe6f57df5bd527'],3001,23438,26439,18988899,110,0.852941176,1,1,16574
5fefa7f37e343026b49e305befdb875a07ea554f,1,Myroslav Papirkovskyy,2014-11-11 00:10:26+02:00,['2fc7adecea03ec70141f41e98f1aa2d089c3b364'],14,16,30,18988929,2,0,0,1,16574
7ab7fb2171e27e96536e040bacb27c9c0907addb,1,Alejandro Fernandez,2014-11-10 15:19:41-08:00,['5fefa7f37e343026b49e305befdb875a07ea554f'],2,2,4,18988933,1,,,,16574
31e118f96f08f6889ec7f8cce1e8cda558d26363,1,Alejandro Fernandez,2014-11-10 15:43:30-08:00,['7ab7fb2171e27e96536e040bacb27c9c0907addb'],2,2,4,18988937,1,,,,16574
1c575c8cecbea2698bda3cefab94c790f1b6c412,0,Srimanth Gunturi,2014-11-10 16:44:06-08:00,['31e118f96f08f6889ec7f8cce1e8cda558d26363'],4,4,8,18988945,3,,,,16574
0229f9393aba6b3ffda6c192099edc36f55ea23c,1,Srimanth Gunturi,2014-11-10 17:25:01-08:00,['1c575c8cecbea2698bda3cefab94c790f1b6c412'],0,5,5,18988950,1,0,0,0,16574
a4719666bd3655711a51166c6860f6f5dea533d4,1,Srimanth Gunturi,2014-11-10 17:26:49-08:00,['0229f9393aba6b3ffda6c192099edc36f55ea23c'],0,1,1,18988951,1,0,0,1,16574
69fe8e4048d2ac9c747dc97d275f4761874007b3,0,Dmytro Sen,2014-11-11 13:20:52+02:00,['a4719666bd3655711a51166c6860f6f5dea533d4'],3,3,6,18988957,3,,,,16574
11e7c9f60fc26e0964200b6f5d78c28f8f3e9dde,0,Aleksandr Kovalenko,2014-11-11 13:36:21+02:00,['69fe8e4048d2ac9c747dc97d275f4761874007b3'],0,6,6,18988963,1,,,,16574
ba5bc737a13578ca27a2f0f15227248e022d4f38,1,Dmytro Sen,2014-11-11 16:58:16+02:00,['11e7c9f60fc26e0964200b6f5d78c28f8f3e9dde'],5,19,24,18988987,5,,,,16574
6c94df6b24251e8eb111096d81ab61ce3fd4f83e,1,Alex Antonenko,2014-11-11 17:16:10+02:00,['ba5bc737a13578ca27a2f0f15227248e022d4f38'],91,13,104,18989091,4,0.484375,0,0,16574
2fdf2403a15c884d877a6f878661d79cda4ffedc,1,aBabiichuk,2014-11-11 17:42:22+02:00,['6c94df6b24251e8eb111096d81ab61ce3fd4f83e'],2,3,5,18989096,2,0,1,1,16574
6b98cfc084e9194ff4df578796953d1f8e93d642,1,Alex Antonenko,2014-11-11 19:01:50+02:00,['2fdf2403a15c884d877a6f878661d79cda4ffedc'],0,17,17,18989113,1,,,,16574
fc0cda8793c740838074500e6941e6ee9c9715bd,0,aBabiichuk,2014-11-11 19:21:49+02:00,['6b98cfc084e9194ff4df578796953d1f8e93d642'],263,432,695,18989808,17,0.611940299,1,1,16578
3a4f020de56b0ab2f4f05ad36d84df3dbe4d0a97,1,Oleg Nechiporenko,2014-11-11 20:49:29+02:00,['fc0cda8793c740838074500e6941e6ee9c9715bd'],4,500,504,18990312,9,1,1,1,16581
7eabb749f2fafb2226df837a1b1b2a2cc5716f31,0,Andrew Onishuk,2014-11-11 21:22:00+02:00,['3a4f020de56b0ab2f4f05ad36d84df3dbe4d0a97'],1,0,1,18990313,1,,,,16581
0bf66729c97aac3a9e8fb227f428511c4df33b8f,0,Jaimin Jetly,2014-11-11 12:01:43-08:00,['7eabb749f2fafb2226df837a1b1b2a2cc5716f31'],0,2,2,18990315,1,,,,16581
e4ededeb69dde413b35a6400197b23a889b3963d,1,Jonathan Hurley,2014-11-11 15:42:45-05:00,['0bf66729c97aac3a9e8fb227f428511c4df33b8f'],26345,467,26812,19017127,252,0.767659574,0.362978723,0.112340426,16581
1b320cc7acfb5cae696662c2d3fd0924ceb4c2fc,1,Alejandro Fernandez,2014-11-11 12:47:13-08:00,['e4ededeb69dde413b35a6400197b23a889b3963d'],3,462,465,19017592,5,0.378640777,0.72815534,0.898058252,16583
0f33f71b636f5a1849b3b425ef9ea7547fd19011,0,Yusaku Sako,2014-11-11 14:00:52-08:00,['1b320cc7acfb5cae696662c2d3fd0924ceb4c2fc'],0,309,309,19017901,1,,,,16583
b2acb75c3df25361b4f13816b35a09210f56874d,0,Srimanth Gunturi,2014-11-11 15:01:26-08:00,['0f33f71b636f5a1849b3b425ef9ea7547fd19011'],9,9,18,19017919,8,,,,16584
bc0772f574162a4ada67217a6abd1d6535c34e15,1,Jaimin Jetly,2014-11-11 16:42:46-08:00,['b2acb75c3df25361b4f13816b35a09210f56874d'],8,204,212,19018131,7,1,1,1,16587
5c3a7a7550fb431db6b48cf2e4ed2f7d211580eb,1,Jaimin Jetly,2014-11-11 17:10:02-08:00,['bc0772f574162a4ada67217a6abd1d6535c34e15'],114,91,205,19018336,7,0.307692308,0,0,16587
355ff1f75c4d1c360c1f8be70a897aa238ca8068,1,aBabiichuk,2014-11-12 10:01:35+02:00,['5c3a7a7550fb431db6b48cf2e4ed2f7d211580eb'],122,418,540,19018876,7,0.684210526,1,1,16587
512c1dfcfc148f8e0a55eafc7962506306262f7a,0,Andrii Tkach,2014-11-12 14:07:12+02:00,['355ff1f75c4d1c360c1f8be70a897aa238ca8068'],1,2,3,19018879,1,,,,16587
c234e978106364c63258a9664c5d7e1e167a3a6c,1,aBabiichuk,2014-11-12 14:19:40+02:00,['512c1dfcfc148f8e0a55eafc7962506306262f7a'],632,185,817,19019696,19,0.596153846,0.088461538,0.026923077,16591
76c27f200c17d4ca9e70acd512917e4c932ea86a,1,Andrii Tkach,2014-11-12 14:42:43+02:00,['c234e978106364c63258a9664c5d7e1e167a3a6c'],15,5,20,19019716,1,,,,16591
212adff46f4bfc64837fbaa6dcfccf9d7bc2f948,1,Jonathan Hurley,2014-11-12 09:33:27-05:00,['76c27f200c17d4ca9e70acd512917e4c932ea86a'],13,357,370,19020086,5,0.12173913,0.356521739,1,16592
013c7f11357ec4fa20e2c044f4d432bcd1746b12,0,Oleg Nechiporenko,2014-11-12 17:13:34+02:00,['212adff46f4bfc64837fbaa6dcfccf9d7bc2f948'],1,8,9,19020095,2,1,1,1,16592
eb4eb8a029c89fcf379f1ab21f615159bab23c1a,1,Alejandro Fernandez,2014-11-12 10:55:31-08:00,['013c7f11357ec4fa20e2c044f4d432bcd1746b12'],227,1727,1954,19022049,4,,,,16592
5567b34ee2d4c08742d899941df833f6a30a94c0,1,Alejandro Fernandez,2014-11-12 11:08:17-08:00,['eb4eb8a029c89fcf379f1ab21f615159bab23c1a'],59,512,571,19022620,7,0.528138528,0.848484848,0.87012987,16594
252e94c63a3a6b40079915c56e4ec405a99979bf,1,Lisnichenko Dmitro,2014-11-12 21:43:39+02:00,['5567b34ee2d4c08742d899941df833f6a30a94c0'],3,30,33,19022653,2,0,0,1,16594
e2757784ca251c18ecdd248a7a1a8e4a3019fac3,1,tbeerbower,2014-11-12 15:22:10-05:00,['252e94c63a3a6b40079915c56e4ec405a99979bf'],38,835,873,19023526,17,0.673992674,0.846153846,1,16600
2f639afe72d6097ea6868acafc7ff5fa70c3755d,1,Andrew Onishuk,2014-11-12 22:29:19+02:00,['e2757784ca251c18ecdd248a7a1a8e4a3019fac3'],1,10,11,19023537,3,0.5,0.666666667,1,16600
a77f8bd1dc3588d9342dc6aabcf5b16dd2e9a01c,0,Jun Aoki,2014-11-12 12:40:07-08:00,['2f639afe72d6097ea6868acafc7ff5fa70c3755d'],5,8,13,19023550,3,,,,16600
291974ee66d24b1c06191109c5716efdc5df1c65,1,Jonathan Hurley,2014-11-12 16:15:00-05:00,['a77f8bd1dc3588d9342dc6aabcf5b16dd2e9a01c'],1702,872,2574,19026124,41,0.734736842,0,0.463157895,16600
16b84e77f17d9636be4eea984d7dd4d3aae5fe26,0,Jonathan Hurley,2014-11-12 23:25:49-05:00,['291974ee66d24b1c06191109c5716efdc5df1c65'],0,2,2,19026126,1,0,0,1,16600
f327b0a2350b33e8999d440e15aec003b1fade94,1,Andrii Tkach,2014-11-13 13:20:24+02:00,['16b84e77f17d9636be4eea984d7dd4d3aae5fe26'],77,387,464,19026590,15,0.62601626,0.975609756,1,16601
f630f12936e99f53cd7425c76b18f443c9d39f13,1,Lisnichenko Dmitro,2014-11-13 14:00:11+02:00,['f327b0a2350b33e8999d440e15aec003b1fade94'],192,474,666,19027256,12,0.096296296,0.511111111,0.940740741,16603
eaa54b33a643424a7c0df740d685c3ae5bcda018,1,Oleg Nechiporenko,2014-11-13 14:09:40+02:00,['f630f12936e99f53cd7425c76b18f443c9d39f13'],0,8,8,19027264,1,1,1,1,16603
ab48cfbf041a22c48cea3bc29571d1a17a498fa6,1,aBabiichuk,2014-11-13 14:21:19+02:00,['eaa54b33a643424a7c0df740d685c3ae5bcda018'],2308,1,2309,19029573,25,0.494768311,0.079970105,0.014947683,16603
93b6119cfb37253dfe5006bc61591dbd56354300,1,Oleg Nechiporenko,2014-11-13 16:03:34+02:00,['ab48cfbf041a22c48cea3bc29571d1a17a498fa6'],95,531,626,19030199,18,0.523584906,1,1,16608
6f915a4e49683495ccd37a220dbeb5e9c1fafce6,1,Andrii Tkach,2014-11-13 17:04:37+02:00,['93b6119cfb37253dfe5006bc61591dbd56354300'],3,13,16,19030215,3,,,,16608
05a62644c5cade198bd18bfa44cc2b111e35d252,1,Alex Antonenko,2014-11-13 17:05:42+02:00,['6f915a4e49683495ccd37a220dbeb5e9c1fafce6'],6,13,19,19030234,1,0.2,1,1,16608
f0a7a1be327a4b41a0d723bf68b45811116cd6fd,1,Alex Antonenko,2014-11-13 18:09:59+02:00,['05a62644c5cade198bd18bfa44cc2b111e35d252'],13,2,15,19030249,4,0,0,0,16608
90b77c72a5c214cd9171a2420a8752ece0133354,1,Oleg Nechiporenko,2014-11-13 19:49:21+02:00,['f0a7a1be327a4b41a0d723bf68b45811116cd6fd'],6,98,104,19030353,7,1,1,1,16609
14d1a5de49d38a6436c22510e15dd1b531f116cb,1,Jonathan Hurley,2014-11-13 15:39:13-05:00,['90b77c72a5c214cd9171a2420a8752ece0133354'],173,26,199,19030552,15,0.5,0,0,16609
d6b0db0b58e1d91ff8cb4002ddc163c5894f60c9,1,Jonathan Hurley,2014-11-13 15:39:13-05:00,['14d1a5de49d38a6436c22510e15dd1b531f116cb'],78,89,167,19030719,9,0.692307692,1,0.384615385,16612
43704d451dc8186b829502e4e9e351af37a0ece4,1,Xi Wang,2014-11-13 16:05:15-08:00,['d6b0db0b58e1d91ff8cb4002ddc163c5894f60c9'],2,1583,1585,19032304,20,0.830609212,0.872213967,0.915304606,16621
0ece0a0db5f43f4e0872ee08c21b73f2934331b3,0,Alejandro Fernandez,2014-11-13 16:26:12-08:00,['43704d451dc8186b829502e4e9e351af37a0ece4'],0,7,7,19032311,1,,,,16621
16cc1769d5954803d481791b5e7b1c8411891dea,1,Yusaku Sako,2014-11-13 16:46:57-08:00,['0ece0a0db5f43f4e0872ee08c21b73f2934331b3'],1,2,3,19032314,2,,,,16621
0d5224ebf8448c293cb4adfe786ed86ca45ea675,1,Jaimin Jetly,2014-11-13 17:01:40-08:00,['16cc1769d5954803d481791b5e7b1c8411891dea'],5,5,10,19032324,3,,,,16621
8de3425f3fe106edddd54261927b44481685b1cc,1,Yusaku Sako,2014-11-13 17:40:55-08:00,['0d5224ebf8448c293cb4adfe786ed86ca45ea675'],2109,66191,68300,19100624,350,0.44991146,0.592461422,0.805337718,16843
8add2183126056b777ab57caa5edab320e2a0694,0,Jaimin Jetly,2014-11-13 18:53:48-08:00,['8de3425f3fe106edddd54261927b44481685b1cc'],4,2,6,19100630,1,,,,16843
02f535cf9ff204dd53f7d78272c07eb33ac4b532,1,Andrew Onishuk,2014-11-14 15:08:41+02:00,['8add2183126056b777ab57caa5edab320e2a0694'],7,7,14,19100644,2,,,,16843
3c7ec34cb757d50cb7ee9b61981c2b048be9ed8a,0,Dmytro Sen,2014-11-14 15:11:24+02:00,['02f535cf9ff204dd53f7d78272c07eb33ac4b532'],1,7,8,19100652,1,,,,16843
ef42c32b4431bdb92cf20e9af121692646041bc3,1,aBabiichuk,2014-11-14 15:21:33+02:00,['3c7ec34cb757d50cb7ee9b61981c2b048be9ed8a'],5,69,74,19100726,5,1,1,1,16843
2ae72262758b2a05c9d5181315136facefbc413e,0,Andrew Onishuk,2014-11-14 16:19:41+02:00,['ef42c32b4431bdb92cf20e9af121692646041bc3'],38,94,132,19100858,10,0.652173913,0.782608696,0.260869565,16843
feab062b8a51f3815472d6998016c6c73f8b03ee,1,Andrii Tkach,2014-11-14 16:52:48+02:00,['2ae72262758b2a05c9d5181315136facefbc413e'],3,4,7,19100865,1,1,1,1,16843
99a24d8c32ad0cc2b8df650b536f1a153c7b97fc,1,tbeerbower,2014-11-14 10:29:39-05:00,['feab062b8a51f3815472d6998016c6c73f8b03ee'],13,64,77,19100942,8,0.810810811,0.972972973,0.972972973,16843
87e03ea3c39122d3cac3fc84bec252857b099ee0,1,Andrii Tkach,2014-11-14 17:39:56+02:00,['99a24d8c32ad0cc2b8df650b536f1a153c7b97fc'],506,396,902,19101844,14,0,0.135416667,0.135416667,16845
71d92ba0c1b5ef3eca76b0f63a2825b4c340672f,1,Yusaku Sako,2014-11-14 08:23:01-08:00,['87e03ea3c39122d3cac3fc84bec252857b099ee0'],94,38,132,19101976,10,0.347826087,0.217391304,0.739130435,16845
27c239f13ed330ec0c4a962e57d60dd71eb472f5,1,aBabiichuk,2014-11-14 18:25:44+02:00,['71d92ba0c1b5ef3eca76b0f63a2825b4c340672f'],35,100,135,19102111,4,0.029850746,0.895522388,1,16845
692d1481924fa9fbc081c8214bf7c73cf7e94486,1,Nate Cole,2014-11-14 13:05:44-05:00,['27c239f13ed330ec0c4a962e57d60dd71eb472f5'],22,201,223,19102334,2,0,0.71641791,1,16845
c7aea4b32bd0bf2a92cbe8f76547a67eb2965202,1,tbeerbower,2014-11-14 14:38:35-05:00,['692d1481924fa9fbc081c8214bf7c73cf7e94486'],0,20,20,19102354,2,0,0,1,16845
135b00e22cd116ee54413ef8acc049a1ac75ad32,0,Mahadev Konar,2014-11-14 15:49:20-08:00,['c7aea4b32bd0bf2a92cbe8f76547a67eb2965202'],1,1,2,19102356,1,,,,16845
6f38721c76aba47728c72e6e49b12ca0d25e6326,1,Xi Wang,2014-11-14 16:32:56-08:00,['135b00e22cd116ee54413ef8acc049a1ac75ad32'],5,23,28,19102384,3,1,1,1,16845
816fe1f6c9995f0a970d41be5a1ee69fd049bb35,0,Xi Wang,2014-11-14 16:32:56-08:00,['6f38721c76aba47728c72e6e49b12ca0d25e6326'],2,19,21,19102405,1,0,1,1,16845
88b29ea2d63d0fb693f5bc12c59a11871c129c76,1,Srimanth Gunturi,2014-11-14 17:20:32-08:00,['816fe1f6c9995f0a970d41be5a1ee69fd049bb35'],94,333,427,19102832,12,1,1,1,16849
bb546c6da653cd644930e76db6e0d08d629cfebe,0,Yusaku Sako,2014-11-14 18:22:28-08:00,['88b29ea2d63d0fb693f5bc12c59a11871c129c76'],13,10,23,19102855,10,,,,16849
d5dae873047f168f1eeb75e2e3ca13a85820d58d,1,Srimanth Gunturi,2014-11-15 15:50:48-08:00,['bb546c6da653cd644930e76db6e0d08d629cfebe'],1,5,6,19102861,1,0,1,1,16849
c8f8045e0c18af0b1872912354c1bc56673aa82c,1,Mahadev Konar,2014-11-16 12:19:20-08:00,['d5dae873047f168f1eeb75e2e3ca13a85820d58d'],7,7,14,19102875,2,,,,16849
491dcfd7140a2b754b73d6c4047fed5da0ab14b4,1,Srimanth Gunturi,2014-11-16 20:32:39-08:00,['c8f8045e0c18af0b1872912354c1bc56673aa82c'],0,1,1,19102876,1,,,,16849
025892604966bd68c9758da5da00b9ce6b53e71f,0,Lisnichenko Dmitro,2014-11-17 14:36:21+02:00,['491dcfd7140a2b754b73d6c4047fed5da0ab14b4'],1,1,2,19102878,1,,,,16849
aa43727ea3ee301eb79245739dafde336623d86d,1,Jonathan Hurley,2014-11-17 08:37:24-05:00,['025892604966bd68c9758da5da00b9ce6b53e71f'],541,80,621,19103499,12,0.838709677,0.290322581,0.344086022,16849
6dd73517b22c3dc234546c9d25d41557a5f46a23,1,Aleksandr Kovalenko,2014-11-17 18:12:12+02:00,['aa43727ea3ee301eb79245739dafde336623d86d'],177,1255,1432,19104931,19,0.672941176,0.936470588,1,16857
e7cfd66c93ec60c891c113b82f8f48f030a970a0,1,Andrii Tkach,2014-11-17 18:17:47+02:00,['6dd73517b22c3dc234546c9d25d41557a5f46a23'],2,2,4,19104935,2,,,,16857
cc076cf34c2533fb29932b6df2ea4c8c20a34568,0,Oleg Nechiporenko,2014-11-17 19:21:29+02:00,['e7cfd66c93ec60c891c113b82f8f48f030a970a0'],6,9,15,19104950,2,1,1,1,16857
3d397dc04aab8d81c00aae2a8e5afa099fc57567,1,John Speidel,2014-11-17 12:25:43-05:00,['cc076cf34c2533fb29932b6df2ea4c8c20a34568'],366,1581,1947,19106897,23,0.143556281,0.683523654,0.856443719,16862
a496f8bc10638e68d7f9e78e1c7ec348cc87d4f9,1,Nate Cole,2014-11-17 15:57:19-05:00,['3d397dc04aab8d81c00aae2a8e5afa099fc57567'],98,1016,1114,19108011,27,0.300291545,0.819241983,0.924198251,16863
1bf9a49cccc79d989c1fb7a6c8c68e700492d237,0,Alejandro Fernandez,2014-11-17 15:49:38-08:00,['a496f8bc10638e68d7f9e78e1c7ec348cc87d4f9'],0,14,14,19108025,2,0,1,1,16863
a7f832097362d33e47db10732ac040391ec3557d,1,Jaimin Jetly,2014-11-17 16:12:59-08:00,['1bf9a49cccc79d989c1fb7a6c8c68e700492d237'],2,8,10,19108035,1,0,0,0,16863
4955e5a19a142f3f3cdb8b339bc32a089c840644,0,Jonathan Hurley,2014-11-18 00:22:44-05:00,['a7f832097362d33e47db10732ac040391ec3557d'],17,84,101,19108136,3,0.24137931,1,0.896551724,16863
70c640772dfaf55fed45027be9fc953b09028953,1,Lisnichenko Dmitro,2014-11-18 14:15:06+02:00,['4955e5a19a142f3f3cdb8b339bc32a089c840644'],15,234,249,19108385,2,0.071895425,0.816993464,0.738562092,16863
03b45ee1dbbadcf1960be3656234f6a1920aa1d6,0,aBabiichuk,2014-11-18 14:21:00+02:00,['70c640772dfaf55fed45027be9fc953b09028953'],129,404,533,19108918,15,1,0.826086957,1,16865
a518ede5d15c1a66db99242138f6fd48dd0d555a,1,Lisnichenko Dmitro,2014-11-18 14:23:54+02:00,['03b45ee1dbbadcf1960be3656234f6a1920aa1d6'],70,596,666,19109584,15,0,0.730941704,0.641255605,16872
efcf07c7b0b14830dd9d38cfee695068e05e67c5,1,Andrii Tkach,2014-11-18 14:43:12+02:00,['a518ede5d15c1a66db99242138f6fd48dd0d555a'],252,712,964,19110548,13,0.967171717,1,1,16876
8eaf00328d8de9543fa842f34527686a4992735f,1,Andrew Onishuk,2014-11-18 18:58:38+02:00,['efcf07c7b0b14830dd9d38cfee695068e05e67c5'],74,127,201,19110749,12,0.619047619,0.761904762,0.19047619,16876
0a3463c973ad1ebdba8314e519d424da6a0aeffb,0,Lisnichenko Dmitro,2014-11-18 19:54:01+02:00,['8eaf00328d8de9543fa842f34527686a4992735f'],5,4,9,19110758,1,,,,16876
d9eb57388316f5cc680d6b210f3d0ab5e64f7668,1,Andrii Tkach,2014-11-18 20:44:06+02:00,['0a3463c973ad1ebdba8314e519d424da6a0aeffb'],21,566,587,19111345,12,0.837587007,1,1,16882
d531181dad51878498336a243ec3fb0de7094a17,0,Jun Aoki,2014-11-18 11:35:31-08:00,['d9eb57388316f5cc680d6b210f3d0ab5e64f7668'],10,0,10,19111355,1,,,,16882
7eee111cdb767e403aabd00c73d21729d2b3750d,1,Jonathan Hurley,2014-11-18 15:37:30-05:00,['d531181dad51878498336a243ec3fb0de7094a17'],35,335,370,19111725,13,0.198412698,0.555555556,0.984126984,16882
8b6e7e9e2144aad895b37f8fb99edfbbf4657334,0,Jonathan Hurley,2014-11-18 15:37:30-05:00,['7eee111cdb767e403aabd00c73d21729d2b3750d'],0,25,25,19111750,2,0.777777778,1,1,16882
36f6b878760ed8b9c6ac07b3efe610fbed5cfc9d,1,Srimanth Gunturi,2014-11-18 13:16:22-08:00,['8b6e7e9e2144aad895b37f8fb99edfbbf4657334'],17,46,63,19111813,12,1,1,1,16882
c9e24d5a1cb4348ba90f0532021a858f42118502,0,Artem Baranchuk,2014-11-19 00:21:17+02:00,['36f6b878760ed8b9c6ac07b3efe610fbed5cfc9d'],1,1,2,19111815,1,,,,16882
32b1fc38e374bfc2285c37f8dd83c04b35ab3c92,1,Jun Aoki,2014-11-18 14:38:06-08:00,['c9e24d5a1cb4348ba90f0532021a858f42118502'],1711,1596,3307,19115122,116,0,0,0,16884
4ca08bbe4b0960e441310e9c8bb32a158a8ca02c,0,Artem Baranchuk,2014-11-19 00:48:08+02:00,['32b1fc38e374bfc2285c37f8dd83c04b35ab3c92'],0,21,21,19115143,1,0,0,1,16884
3d99629705a8ea59f8fce91fa3e64728f9ed5de1,0,Mahadev Konar,2014-11-18 15:24:20-08:00,['4ca08bbe4b0960e441310e9c8bb32a158a8ca02c'],1,1,2,19115145,1,,,,16884
c0dc64ca3f9b634ed3e98fc614c0e7feb7fd5651,1,Jun Aoki,2014-11-18 15:28:16-08:00,['3d99629705a8ea59f8fce91fa3e64728f9ed5de1'],5,121,126,19115271,5,0,1,1,16886
defa49b7815a39977f8c9c02a0887670bc1185e7,1,Alejandro Fernandez,2014-11-18 17:47:45-08:00,['c0dc64ca3f9b634ed3e98fc614c0e7feb7fd5651'],1,108,109,19115380,5,0.125,0.125,1,16886
6fbfdb4a0774b64ca92760747e90f9de01db5542,1,Jaimin Jetly,2014-11-18 22:41:25-08:00,['defa49b7815a39977f8c9c02a0887670bc1185e7'],0,2336,2336,19117716,18,0.302325581,0.742071882,0.866807611,16903
46e4d943b1950023388258fd0126e5b4d1f541f4,0,Oleg Nechiporenko,2014-11-19 12:46:17+02:00,['6fbfdb4a0774b64ca92760747e90f9de01db5542'],6,31,37,19117753,4,0.4,1,1,16903
e7998390978b3676235fba89b9f4ce98b847e2e9,1,Andrii Tkach,2014-11-19 12:59:26+02:00,['46e4d943b1950023388258fd0126e5b4d1f541f4'],11,41,52,19117805,3,1,1,1,16903
959525e0e3b65b54a95b63f19957e81f3988ea38,1,Andrii Tkach,2014-11-19 13:37:11+02:00,['e7998390978b3676235fba89b9f4ce98b847e2e9'],46,130,176,19117981,8,1,1,1,16904
27821a2677692a889b50603f4f66adc7e5ff1434,0,Lisnichenko Dmitro,2014-11-19 14:06:18+02:00,['959525e0e3b65b54a95b63f19957e81f3988ea38'],9,7,16,19117997,3,0,0,0,16904
8378fd6de93e84a7e0bac1b5e27a548ba87ebf95,1,Andrii Tkach,2014-11-19 14:14:57+02:00,['27821a2677692a889b50603f4f66adc7e5ff1434'],129,199,328,19118325,3,0.723684211,0.973684211,1,16904
a098ddd49697442a33b38f106232a66c66201e3c,1,Jonathan Hurley,2014-11-19 08:31:42-05:00,['8378fd6de93e84a7e0bac1b5e27a548ba87ebf95'],4,153,157,19118482,19,0.181818182,0.787878788,0.984848485,16904
040794d9dcc65e3097c9822abf7a16f3c1faa825,1,Oleg Nechiporenko,2014-11-19 18:00:26+02:00,['a098ddd49697442a33b38f106232a66c66201e3c'],512,2183,2695,19121177,12,0.230072464,0.994565217,1,16907
112300cd421494459f67b0ab9dd12bdc18db5534,0,ababiichuk,2014-11-19 20:01:46+02:00,['040794d9dcc65e3097c9822abf7a16f3c1faa825'],3,8,11,19121188,2,1,1,1,16907
92f794eb3c8bf19c915797fc0bb983b6c0de8474,1,Aleksandr Kovalenko,2014-11-19 20:54:16+02:00,['112300cd421494459f67b0ab9dd12bdc18db5534'],6,19,25,19121213,6,0,1,1,16907
335bde3a84f5a24639f2df1db2091d46515a15ac,1,Andrii Tkach,2014-11-19 21:27:41+02:00,['92f794eb3c8bf19c915797fc0bb983b6c0de8474'],3,334,337,19121550,8,0.294117647,1,0.566176471,16911
cb8987357f02b08e14c99a2b244f479c7473b1c6,0,Alejandro Fernandez,2014-11-19 11:38:21-08:00,['335bde3a84f5a24639f2df1db2091d46515a15ac'],3,3,6,19121556,1,,,,16911
a52b04976f09b34e37467238811baab5fbb9102b,1,John Speidel,2014-11-19 16:40:45-05:00,['cb8987357f02b08e14c99a2b244f479c7473b1c6'],2,2,4,19121560,2,,,,16911
b0d0552e7214bf32ee1577482b71a950bb591803,1,Jaimin Jetly,2014-11-19 14:01:02-08:00,['a52b04976f09b34e37467238811baab5fbb9102b'],6,20,26,19121586,5,,,,16911
7414a35faa8982b38b4df165b6abfac26bcc2800,1,Srimanth Gunturi,2014-11-19 15:36:40-08:00,['b0d0552e7214bf32ee1577482b71a950bb591803'],5,28,33,19121619,5,1,1,1,16911
1fab75b3a25536084636b3161ac8eae5bdcbd66d,1,Srimanth Gunturi,2014-11-19 16:14:52-08:00,['7414a35faa8982b38b4df165b6abfac26bcc2800'],2,7,9,19121628,2,1,1,1,16911
7a4e75796f03c9e6ba707042db5e7a36c92c1268,1,Srimanth Gunturi,2014-11-19 16:26:47-08:00,['1fab75b3a25536084636b3161ac8eae5bdcbd66d'],3,321,324,19121952,10,1,1,1,16914
54f8ea58a8cbb11941ef0418088492846863118a,0,Artem Baranchuk,2014-11-20 12:03:21+02:00,['7a4e75796f03c9e6ba707042db5e7a36c92c1268'],43,52,95,19122047,5,,,,16914
648a2d8f15c0e8bb9c324ce1700a417cae08a760,0,Artem Baranchuk,2014-11-20 12:04:59+02:00,['54f8ea58a8cbb11941ef0418088492846863118a'],5,5,10,19122057,1,,,,16914
55c691f49f8afe9d3873ae1c2af58343c060c3eb,1,Oleg Nechiporenko,2014-11-20 13:15:49+02:00,['648a2d8f15c0e8bb9c324ce1700a417cae08a760'],5,97,102,19122159,6,0.35,0.95,1,16914
4425a555920d27043530d7f4a99a6cf8ec7f8138,1,Andrii Tkach,2014-11-20 13:39:15+02:00,['55c691f49f8afe9d3873ae1c2af58343c060c3eb'],7,188,195,19122354,6,0,1,0,16916
e35126fedfd8c00f287f48ab244027d095ab45cf,1,Nate Cole,2014-11-20 07:25:34-05:00,['4425a555920d27043530d7f4a99a6cf8ec7f8138'],69,167,236,19122590,5,0.045454545,0,1,16916
d5d9a9dfb842c24f88f38e7c8a8469c741f9284e,0,Oleg Nechiporenko,2014-11-20 15:05:06+02:00,['e35126fedfd8c00f287f48ab244027d095ab45cf'],15,48,63,19122653,3,0.958333333,1,1,16916
2f00656c824390bbebb9a3441d3839c37427f3bc,1,Nate Cole,2014-11-20 09:29:01-05:00,['d5d9a9dfb842c24f88f38e7c8a8469c741f9284e'],129,1132,1261,19123914,29,0.673972603,0.717808219,0.978082192,16925
6f2875cee6e7098bac0d317e560d23c1f3d8be8a,1,Andrii Tkach,2014-11-20 17:38:46+02:00,['2f00656c824390bbebb9a3441d3839c37427f3bc'],5,313,318,19124232,9,0.214285714,1,0.916666667,16927
f543cc6c08909b3ed157fda4ba23827a745a7881,1,Aleksandr Kovalenko,2014-11-20 18:38:09+02:00,['6f2875cee6e7098bac0d317e560d23c1f3d8be8a'],51,274,325,19124557,9,0.828571429,0.99047619,0.933333333,16927
beccf117a3e002afe39c7f75abdc553b55486d1c,1,Oleg Nechiporenko,2014-11-20 19:46:33+02:00,['f543cc6c08909b3ed157fda4ba23827a745a7881'],31,252,283,19124840,5,0.259493671,1,1,16928
6adc6a500b43bcf0fccb00cb44b439e7bb8cd722,1,Nate Cole,2014-11-20 13:32:16-05:00,['beccf117a3e002afe39c7f75abdc553b55486d1c'],110,245,355,19125195,7,0.019230769,0.711538462,0.288461538,16929
9a8752573653bacd9f293cf9bb790f655920cd83,1,Xi Wang,2014-11-20 12:06:57-08:00,['6adc6a500b43bcf0fccb00cb44b439e7bb8cd722'],10,319,329,19125524,9,1,1,1,16930
c938c4840c8ecd22e01ce923a6ededa069830802,1,Alejandro Fernandez,2014-11-20 13:37:01-08:00,['9a8752573653bacd9f293cf9bb790f655920cd83'],154,575,729,19126253,28,0.183168317,0.633663366,0.212871287,16930
dc50702ef27db5a243597abd7c54f0f4f6dc1b96,0,Andrew Onishuk,2014-11-21 00:00:03+02:00,['c938c4840c8ecd22e01ce923a6ededa069830802'],1,0,1,19126254,1,1,1,0,16930
eeac84a522bfac86c6e28f9756bfc02bc8961edc,1,Xi Wang,2014-11-20 18:48:26-08:00,['dc50702ef27db5a243597abd7c54f0f4f6dc1b96'],19,416,435,19126689,9,0.814814815,1,1,16932
15ffd2ece6b20712ca505cd1f06361f224ac2c20,1,Oleg Nechiporenko,2014-11-21 14:22:58+02:00,['eeac84a522bfac86c6e28f9756bfc02bc8961edc'],5,50,55,19126744,5,0.96,1,1,16932
650e9d4372d0f9b6a1cec8b64ae8f09b4d565728,1,Jonathan Hurley,2014-11-21 08:50:39-05:00,['15ffd2ece6b20712ca505cd1f06361f224ac2c20'],87,1206,1293,19128037,12,0.369047619,0.595238095,0.895833333,16935
c507a1017554a34896bbb8bf57fc329ef45df45a,1,Oleg Nechiporenko,2014-11-21 16:17:03+02:00,['650e9d4372d0f9b6a1cec8b64ae8f09b4d565728'],2,51,53,19128090,3,0.8,0.971428571,1,16935
7da19ffd8594d40911738d9848d93f7ba13bfb61,0,Oleg Nechiporenko,2014-11-21 17:42:27+02:00,['c507a1017554a34896bbb8bf57fc329ef45df45a'],10,56,66,19128156,5,1,1,1,16936
2b2accd9ca5b385aec14e5c5025c10d7d2cdc62e,1,Aleksandr Kovalenko,2014-11-21 18:17:43+02:00,['7da19ffd8594d40911738d9848d93f7ba13bfb61'],37,149,186,19128342,3,1,1,1,16936
d0b8bed79096bbbb0c9f9d1fac1e3ed90a3dd2d1,0,Srimanth Gunturi,2014-11-21 10:04:00-08:00,['2b2accd9ca5b385aec14e5c5025c10d7d2cdc62e'],3,48,51,19128393,3,1,1,0.860465116,16936
1c655c7920c46d392b1ee8b8eeee38b97613fd62,1,Nate Cole,2014-11-21 14:19:33-05:00,['d0b8bed79096bbbb0c9f9d1fac1e3ed90a3dd2d1'],90,229,319,19128712,5,0.172413793,0.844827586,0.137931034,16937
dd87511efa0d6b741b1b6acab3b399b8722a994b,1,Jaimin Jetly,2014-11-21 14:04:24-08:00,['1c655c7920c46d392b1ee8b8eeee38b97613fd62'],729,3288,4017,19132729,59,0.938211382,0.993495935,1,16969
870a5a5795f7ae757b47679281dcfcf64e6cfbaf,0,Xi Wang,2014-11-21 14:37:20-08:00,['dd87511efa0d6b741b1b6acab3b399b8722a994b'],0,1,1,19132730,1,1,1,1,16969
3dab802cedd256b0952cce1f478b11f741335fd8,1,Xi Wang,2014-11-21 14:37:20-08:00,['870a5a5795f7ae757b47679281dcfcf64e6cfbaf'],928,11,939,19133669,15,0.267581475,0.070325901,0,16969
b5755a54da02fd379bdb2d08a6af981229abb056,1,Jaimin Jetly,2014-11-21 17:01:36-08:00,['3dab802cedd256b0952cce1f478b11f741335fd8'],4,4,8,19133677,4,,,,16969
88a872215b79f1cc6c2b8f87bdeef4fa45dc3a83,1,aBabiichuk,2014-11-24 11:48:30+02:00,['b5755a54da02fd379bdb2d08a6af981229abb056'],36,184,220,19133897,7,0.854545455,1,1,16969
855998383381d80966428b481d4448216956eb6f,1,Dmytro Sen,2014-11-24 15:10:05+02:00,['88a872215b79f1cc6c2b8f87bdeef4fa45dc3a83'],15,57,72,19133969,2,0.727272727,0.727272727,1,16969
84ecfa56265f39b8c28022aca7b22825bfd51536,1,Nate Cole,2014-11-24 09:19:58-05:00,['855998383381d80966428b481d4448216956eb6f'],29,613,642,19134611,52,0.024734982,0.938162544,1,16969
ab77f2bf0787f4d80abd4bd38958bca62f822033,1,Andrii Tkach,2014-11-24 18:45:36+02:00,['84ecfa56265f39b8c28022aca7b22825bfd51536'],92,155,247,19134858,9,0.666666667,0.916666667,1,16969
531c4384bd6304fc8f32e4704b8653fd7ad91578,1,Oleg Nechiporenko,2014-11-24 19:08:34+02:00,['ab77f2bf0787f4d80abd4bd38958bca62f822033'],1,639,640,19135498,21,1,1,1,16983
f04b03941c8945a17cff9cff9c2e6af27b90d7d1,1,Lisnichenko Dmitro,2014-11-24 19:45:13+02:00,['531c4384bd6304fc8f32e4704b8653fd7ad91578'],52,1660,1712,19137210,16,0.15483871,0.612903226,0.864516129,16985
6b93fb54452211af1ed678e9fabd8ed165b005a2,1,Bob Nettleton,2014-11-24 12:47:18-05:00,['f04b03941c8945a17cff9cff9c2e6af27b90d7d1'],12,467,479,19137689,17,0.400862069,1,0.99137931,16986
ae77687f0e712b9682ee46236e78ce6b14a00135,1,tbeerbower,2014-11-24 13:17:42-05:00,['6b93fb54452211af1ed678e9fabd8ed165b005a2'],364,1773,2137,19139826,28,0.680089485,1,0.903803132,16997
eff6a7b3120c02afe3e72199802d49939ac3dc89,1,Andrew Onishuk,2014-11-24 22:30:57+02:00,['ae77687f0e712b9682ee46236e78ce6b14a00135'],16,16,32,19139858,4,,,,16997
41bc7902e5542ecde4c45322dbf00c815b50d573,1,Nate Cole,2014-11-24 16:03:58-05:00,['eff6a7b3120c02afe3e72199802d49939ac3dc89'],37,189,226,19140084,15,0.168831169,0.337662338,0.922077922,16997
bd32ef392deaeb6e318c9b7f329eb2118599944f,1,Xi Wang,2014-11-24 13:58:31-08:00,['41bc7902e5542ecde4c45322dbf00c815b50d573'],2,247,249,19140333,3,1,1,1,16998
e7d0703033f5b799e9237c1cb369b1b8557182af,1,Jun Aoki,2014-11-24 15:43:40-08:00,['bd32ef392deaeb6e318c9b7f329eb2118599944f'],0,63716,63716,19204049,291,0.335167074,0.630399348,0.870823146,17288
81d5c7bdf41c069d06a65fd72065e342f4039b44,1,Oleg Nechiporenko,2014-11-25 12:08:42+02:00,['e7d0703033f5b799e9237c1cb369b1b8557182af'],9,12,21,19204070,2,1,1,1,17288
b4dd68dacf69fa30d44108fc755bbe79b118ae90,1,Oleg Nechiporenko,2014-11-25 12:56:15+02:00,['81d5c7bdf41c069d06a65fd72065e342f4039b44'],467,229,696,19204766,27,0,0,0,17290
accbbf2735d8a3ec1747cbdd7110bbac32db95db,1,Dmytro Sen,2014-11-25 13:31:40+02:00,['b4dd68dacf69fa30d44108fc755bbe79b118ae90'],55,39,94,19204860,28,,0,,17290
b35464a7f4967fabae72426d55aaa6dad83ead73,1,Andrii Tkach,2014-11-25 14:47:25+02:00,['accbbf2735d8a3ec1747cbdd7110bbac32db95db'],171,426,597,19205457,12,0.893401015,1,1,17292
68c5572817afab19c6aa7ce628c77ffc82efae15,1,Andrew Onishuk,2014-11-25 18:55:15+02:00,['b35464a7f4967fabae72426d55aaa6dad83ead73'],221,254,475,19205932,21,1,0,1,17293
34e0274d1f24457b4a144e55e929e829eab3f51f,0,aBabiichuk,2014-11-25 19:05:35+02:00,['68c5572817afab19c6aa7ce628c77ffc82efae15'],31,33,64,19205996,4,,,,17293
bf193642ddb3f83943df6749f7d2bf5acda01f71,1,Alex Antonenko,2014-11-25 19:13:18+02:00,['34e0274d1f24457b4a144e55e929e829eab3f51f'],22,392,414,19206410,2,0.524271845,0.708737864,1,17293
82e72e517f3b86db25d2026b53b77c5c72fa8eab,1,Alex Antonenko,2014-11-25 19:13:19+02:00,['bf193642ddb3f83943df6749f7d2bf5acda01f71'],2405,10037,12442,19218852,147,0.479151246,0.592894152,0.912657291,17338
4d614988c1448cb0edab522acdfdab21020380ee,0,Andrew Onishuk,2014-11-25 19:43:08+02:00,['82e72e517f3b86db25d2026b53b77c5c72fa8eab'],0,21,21,19218873,1,,,,17338
20591d2e244763ca86e426ee60e829b2b80411de,0,Andrew Onishuk,2014-11-25 19:47:54+02:00,['4d614988c1448cb0edab522acdfdab21020380ee'],0,11,11,19218884,1,0,0,1,17338
848e78742452f5f66c97435035210470ebdf288a,0,Artem Baranchuk,2014-11-25 20:07:25+02:00,['20591d2e244763ca86e426ee60e829b2b80411de'],542,666,1208,19220092,4,0,0.506493506,0.61038961,17338
6a67051886abbfada5990e64e480d03b0c2ed7e6,0,Artem Baranchuk,2014-11-25 20:12:01+02:00,['848e78742452f5f66c97435035210470ebdf288a'],16,12,28,19220120,6,,,,17338
d4f9cb13d687b8a85a1db944dcc77f7bb81567b2,0,Artem Baranchuk,2014-11-25 20:25:27+02:00,['6a67051886abbfada5990e64e480d03b0c2ed7e6'],12,30,42,19220162,3,1,1,1,17338
e1f7b49ce5a56e9a8a7b9e7742d4e890c2eab79a,1,Alex Antonenko,2014-11-25 20:33:49+02:00,['d4f9cb13d687b8a85a1db944dcc77f7bb81567b2'],1,1,2,19220164,1,,,,17338
024a301b1673da0c800554c55b28d0e7848bb9d2,1,Jonathan Hurley,2014-11-25 16:47:59-05:00,['e1f7b49ce5a56e9a8a7b9e7742d4e890c2eab79a'],255,1755,2010,19222174,45,0.567741935,0.883870968,1,17350
80ffaa9d0fddee462336584e90692e9090772601,1,Jonathan Hurley,2014-11-25 16:47:59-05:00,['024a301b1673da0c800554c55b28d0e7848bb9d2'],71,4,75,19222249,2,0.3,0.3,0.4,17350
3af54a1ff275df89e6ec24cd5a7f8dd9a4350fe1,1,Xi Wang,2014-11-25 16:20:05-08:00,['80ffaa9d0fddee462336584e90692e9090772601'],138,268,406,19222655,10,0.918918919,0.918918919,1,17350
6961473c026d0b85c6e0e487554cc165b2b9a902,1,Xi Wang,2014-11-25 16:20:05-08:00,['3af54a1ff275df89e6ec24cd5a7f8dd9a4350fe1'],56,33,89,19222744,4,1,1,1,17350
cab42f233793c140412e3583300451a061f75f52,1,Artem Baranchuk,2014-11-26 12:51:16+02:00,['6961473c026d0b85c6e0e487554cc165b2b9a902'],68,102,170,19222914,6,,,,17351
a5acc8e57b886a175f1e993f0b32ec75a3c86796,1,Artem Baranchuk,2014-11-26 12:53:25+02:00,['cab42f233793c140412e3583300451a061f75f52'],8,16,24,19222938,7,0.5,1,1,17351
b4753afd17ba454a7323998c9db61ca6398cb6c4,1,Andrii Tkach,2014-11-26 13:18:53+02:00,['a5acc8e57b886a175f1e993f0b32ec75a3c86796'],20,65,85,19223023,4,0.541666667,1,1,17351
7b7f0c92bc84e92e51775700ad87904c39d4cef6,1,Oleg Nechiporenko,2014-11-26 17:59:19+02:00,['b4753afd17ba454a7323998c9db61ca6398cb6c4'],121,541,662,19223685,18,0.591623037,1,1,17353
a61271583c7bd85f5c1b3cf537cdcce2a461e0a1,1,Alex Antonenko,2014-11-26 18:40:08+02:00,['7b7f0c92bc84e92e51775700ad87904c39d4cef6'],113,177,290,19223975,19,0.351851852,0.518518519,0.648148148,17353
9218a8ebf7011df6f4259c43aa88f14f11673851,1,Alex Antonenko,2014-11-26 18:40:09+02:00,['a61271583c7bd85f5c1b3cf537cdcce2a461e0a1'],23,27,50,19224025,1,1,0,0,17353
ee9abd1b105e01bb5b6aad092f1754333368d508,1,Andrii Tkach,2014-11-26 19:15:01+02:00,['9218a8ebf7011df6f4259c43aa88f14f11673851'],5,445,450,19224475,14,1,1,1,17358
6b7a1c9b0d39ccf878fe9ac97bdb55fc9982004f,1,Alejandro Fernandez,2014-11-26 10:08:38-08:00,['ee9abd1b105e01bb5b6aad092f1754333368d508'],34,448,482,19224957,19,0,0.421348315,0.797752809,17358
133381bac4ed3a8225c044eba663064299de65b4,1,Jaimin Jetly,2014-11-26 10:37:04-08:00,['6b7a1c9b0d39ccf878fe9ac97bdb55fc9982004f'],814,447,1261,19226218,11,0.465517241,0.925287356,0.965517241,17358
aebd5c0b3ff005435e2fbd404c338e31fb118f26,0,John Speidel,2014-11-26 16:27:26-05:00,['133381bac4ed3a8225c044eba663064299de65b4'],0,30,30,19226248,2,0,0.842105263,1,17358
501785fa532525dbae61ca69f6e6a5098577862a,0,Jun Aoki,2014-11-26 14:20:25-08:00,['aebd5c0b3ff005435e2fbd404c338e31fb118f26'],9,58,67,19226315,4,0,0.461538462,1,17358
058dc168e6173f4206837a1db87d066b372b07b1,1,John Speidel,2014-11-26 17:56:02-05:00,['501785fa532525dbae61ca69f6e6a5098577862a'],588,1239,1827,19228142,16,0.476047904,1,0.775449102,17358
a80dc9ac93dee273f8f995f4e6bdd2f22d05dcc5,0,Jaimin Jetly,2014-11-26 15:57:16-08:00,['058dc168e6173f4206837a1db87d066b372b07b1'],20,49,69,19228211,4,0.230769231,1,1,17358
ca7b8fdb89979ec587626649f1e8931808bc8887,1,Aleksandr Kovalenko,2014-11-27 15:25:54+02:00,['a80dc9ac93dee273f8f995f4e6bdd2f22d05dcc5'],56,946,1002,19229213,15,0.682600382,0.944550669,1,17362
b68b716a597e484958a8a5c8a18b00aa577befd9,1,Andrii Tkach,2014-11-28 12:14:37+02:00,['ca7b8fdb89979ec587626649f1e8931808bc8887'],85,206,291,19229504,37,0.811320755,0.811320755,1,17362
378cf13667c7b368f4cee564afe725343cc65961,1,Oleg Nechiporenko,2014-11-28 13:45:55+02:00,['b68b716a597e484958a8a5c8a18b00aa577befd9'],35,45,80,19229584,2,,,,17362
9159421b39c4ef677a0bdc9445afe2ca2bd545ee,1,Jonathan Hurley,2014-11-28 08:04:39-05:00,['378cf13667c7b368f4cee564afe725343cc65961'],552,1043,1595,19231179,23,0.328703704,1,0.638888889,17364
a56e9247449071a96e2d9a0646e4b2d094220e0a,1,Andrew Onishuk,2014-11-28 18:15:24+02:00,['9159421b39c4ef677a0bdc9445afe2ca2bd545ee'],1,1,2,19231181,1,,,,17364
9c3ed394cd5fa7236ee52ffc058e76c74f4dbe7c,1,Andrew Onishuk,2014-11-28 18:43:00+02:00,['a56e9247449071a96e2d9a0646e4b2d094220e0a'],18,21,39,19231220,4,0,1,1,17364
ce7bfeb0abc70b47f1b826e8148557d228c18ac9,1,Alex Antonenko,2014-11-28 18:52:15+02:00,['9c3ed394cd5fa7236ee52ffc058e76c74f4dbe7c'],15,56,71,19231291,5,0.19047619,1,0.904761905,17364
10f4afc6019880a797adaf07531766bcc87e9e76,0,Alex Antonenko,2014-11-28 18:52:16+02:00,['ce7bfeb0abc70b47f1b826e8148557d228c18ac9'],11,2,13,19231304,3,,,,17364
0fc4e7f0e50135906205e58bfd07acdeec053f05,1,Alex Antonenko,2014-11-28 18:52:17+02:00,['10f4afc6019880a797adaf07531766bcc87e9e76'],19,37,56,19231360,6,1,1,1,17364
5d07646eedc1965def6c1b81d9bcea8b5ddc5673,1,Andrew Onishuk,2014-11-29 00:29:08+02:00,['0fc4e7f0e50135906205e58bfd07acdeec053f05'],78,149,227,19231587,13,0.904761905,0.904761905,0.523809524,17364
f9a08f9f8c5100dc35c7233057f5dc5acde83ab5,1,Artem Baranchuk,2014-12-01 13:57:04+02:00,['5d07646eedc1965def6c1b81d9bcea8b5ddc5673'],181,28,209,19231796,14,1,1,0,17364
38cce21774214cc530112abf9ef70fdb4f3a2a66,1,Andrew Onishuk,2014-12-01 14:41:21+02:00,['f9a08f9f8c5100dc35c7233057f5dc5acde83ab5'],12,8,20,19231816,1,0,0,1,17364
fc2c0ba907fbefcbff8d382a4061b2474c2022e3,0,Aleksandr Kovalenko,2014-12-01 15:10:47+02:00,['38cce21774214cc530112abf9ef70fdb4f3a2a66'],0,2,2,19231818,1,0,0,1,17364
4f1039457b91bc2e2a941d689feb59d938baf0a7,1,Oleg Nechiporenko,2014-12-01 16:15:15+02:00,['fc2c0ba907fbefcbff8d382a4061b2474c2022e3'],19,93,112,19231930,8,1,1,1,17364
1af3149e7308d2af20f54d2ff5cbd5b297337543,1,Oleg Nechiporenko,2014-12-01 17:19:37+02:00,['4f1039457b91bc2e2a941d689feb59d938baf0a7'],2,2,4,19231934,2,,,,17364
fd635e74c2c555924c23ace7a462d34020242ed1,0,Andrew Onishuk,2014-12-01 19:37:14+02:00,['1af3149e7308d2af20f54d2ff5cbd5b297337543'],0,26,26,19231960,2,,,,17364
5fc87355a8fbd8c25ded9937f340ac131172f52b,1,tbeerbower,2014-12-01 12:37:51-05:00,['fd635e74c2c555924c23ace7a462d34020242ed1'],39,409,448,19232408,10,,,,17367
1f272c278107171bea9d08780989ad3332ff3673,1,Andrii Tkach,2014-12-01 19:54:19+02:00,['5fc87355a8fbd8c25ded9937f340ac131172f52b'],190,319,509,19232917,18,1,0,0,17374
3506e4ee3fd1d980d05c4e81fb55ee5cb9a60702,1,Nate Cole,2014-12-01 10:56:57-08:00,['1f272c278107171bea9d08780989ad3332ff3673'],153,587,740,19233657,26,0.634482759,0.751724138,0.772413793,17377
716b9b783134a0fc8cb770b78277b8c9938111a5,1,Andrew Onishuk,2014-12-01 22:21:26+02:00,['3506e4ee3fd1d980d05c4e81fb55ee5cb9a60702'],249,364,613,19234270,35,0.198198198,0.990990991,0.972972973,17377
6de203aad44c5184e8f913b44b0743c645ce64bc,0,Yusaku Sako,2014-12-01 12:46:24-08:00,['716b9b783134a0fc8cb770b78277b8c9938111a5'],527,0,527,19234797,1,,,,17377
73352f4bf23d456e7347ad5ba3a10f5e3bb81bc1,1,Andrew Onishuk,2014-12-02 00:45:06+02:00,['6de203aad44c5184e8f913b44b0743c645ce64bc'],1,1,2,19234799,1,,,,17377
03872cafaba7c03266b1320c530df9c30c356dca,1,Yusaku Sako,2014-12-01 15:56:35-08:00,['73352f4bf23d456e7347ad5ba3a10f5e3bb81bc1'],130,240,370,19235169,18,0.555555556,1,1,17377
6967f5b02380e55b1a9d4b75c8ea2641388757bc,0,Alejandro Fernandez,2014-12-01 18:41:28-08:00,['03872cafaba7c03266b1320c530df9c30c356dca'],44,3,47,19235216,6,1,0,0,17377
b7ddffc76a628899687274e2b92b50b1650dbc8d,1,Oleg Nechiporenko,2014-12-02 14:22:51+02:00,['6967f5b02380e55b1a9d4b75c8ea2641388757bc'],18,114,132,19235348,3,1,1,1,17377
15343acd852f7bae43e282b14764ed19ed3ab5f9,1,Oleg Nechiporenko,2014-12-02 15:48:53+02:00,['b7ddffc76a628899687274e2b92b50b1650dbc8d'],10,41,51,19235399,3,1,1,0.961538462,17377
5abc3b85e6056b73443cf3d3a23c19c198b48110,1,aBabiichuk,2014-12-02 17:36:47+02:00,['15343acd852f7bae43e282b14764ed19ed3ab5f9'],1,8,9,19235408,2,0,1,1,17377
3eaaef1d41d801390040bb54115d9c0e2350649a,1,Jonathan Hurley,2014-12-02 11:15:35-05:00,['5abc3b85e6056b73443cf3d3a23c19c198b48110'],315,524,839,19236247,6,0,0.254545455,0.254545455,17378
c6f574349f0c7a71694f55fd2f12fc84f13ee16f,1,Oleg Nechiporenko,2014-12-02 18:17:27+02:00,['3eaaef1d41d801390040bb54115d9c0e2350649a'],5,21,26,19236273,2,0.833333333,1,1,17378
a52f8a5572f689351a22d41f62bd083c27a3bfa8,1,Siddharth Wagle,2014-12-02 09:26:41-08:00,['c6f574349f0c7a71694f55fd2f12fc84f13ee16f'],685,51215,51900,19288173,315,0.365484998,0.571875993,0.874903545,17658
93b8348fabb4a50e2ed95ed1b98fea7fff4b2ab1,0,Siddharth Wagle,2014-12-02 09:26:41-08:00,['a52f8a5572f689351a22d41f62bd083c27a3bfa8'],1,5,6,19288179,2,,,,17658
96285c82788be05f20edddd28365ce7620650128,1,Alex Antonenko,2014-12-02 19:37:06+02:00,['93b8348fabb4a50e2ed95ed1b98fea7fff4b2ab1'],65,115,180,19288359,9,0.177419355,1,1,17658
5b6223f6b04b7045c55659fe081657538bba523b,1,Alex Antonenko,2014-12-02 20:49:47+02:00,['96285c82788be05f20edddd28365ce7620650128'],2,2,4,19288363,1,,,,17658
a930a742fb3ad2ada0ff3bff2453ae70a870d587,1,Alex Antonenko,2014-12-02 23:15:19+02:00,['5b6223f6b04b7045c55659fe081657538bba523b'],1,1,2,19288365,1,,,,17658
7ed98d53c1f1c24dc841baef54e02d2664f6a381,1,Nate Cole,2014-12-02 13:23:51-08:00,['a930a742fb3ad2ada0ff3bff2453ae70a870d587'],730,1200,1930,19290295,47,0.916256158,0.84729064,1,17662
047498d717a7d4df53992032e48bd4e3ea0be1a4,0,Xi Wang,2014-12-02 13:54:24-08:00,['7ed98d53c1f1c24dc841baef54e02d2664f6a381'],16,15,31,19290326,1,1,1,0,17662
9280bb1d3741c8941b5bfcd79e8fd8e06b49ce44,1,Andrew Onishuk,2014-12-03 01:21:52+02:00,['047498d717a7d4df53992032e48bd4e3ea0be1a4'],173,169,342,19290668,22,0,1,1,17662
956a0e70849a6d544a06332a8c2cfdedfa0d74f3,1,Xi Wang,2014-12-02 19:13:51-08:00,['9280bb1d3741c8941b5bfcd79e8fd8e06b49ce44'],40,77,117,19290785,5,0.565217391,1,1,17662
498a13bab6f38ffa529da1a5cdd7cc400728ca01,1,Artem Baranchuk,2014-12-03 13:54:04+02:00,['956a0e70849a6d544a06332a8c2cfdedfa0d74f3'],189,419,608,19291393,13,0,0,1,17662
ff1459b88ce23298f5a705fc9e6c091fb30344e3,1,Aleksandr Kovalenko,2014-12-03 15:08:43+02:00,['498a13bab6f38ffa529da1a5cdd7cc400728ca01'],150,356,506,19291899,12,0.61,0.83,1,17662
71cf447e6aafb1aa1cf3cd52e5e43e23bb378080,1,Lisnichenko Dmitro,2014-12-03 15:53:36+02:00,['ff1459b88ce23298f5a705fc9e6c091fb30344e3'],85,1140,1225,19293124,18,0.118446602,0.45631068,0.955339806,17664
0a6a64477e1cc45c22a7542cb43498645fe37f74,0,Andrew Onishuk,2014-12-03 17:59:54+02:00,['71cf447e6aafb1aa1cf3cd52e5e43e23bb378080'],12,3,15,19293139,2,1,0,0,17664
1b6002a5e6f12c142185f8a0a827b944c267290a,1,Oleg Nechiporenko,2014-12-03 18:15:34+02:00,['0a6a64477e1cc45c22a7542cb43498645fe37f74'],63,349,412,19293551,9,0.960784314,1,0.803921569,17665
44bb69e732acd2de5875667c08c3eca0d0b9eacf,1,Andrew Onishuk,2014-12-03 19:34:54+02:00,['1b6002a5e6f12c142185f8a0a827b944c267290a'],0,1,1,19293552,1,,,,17665
bc8c329376b3ed242984e0bf720408350ed8a587,1,aBabiichuk,2014-12-03 19:51:03+02:00,['44bb69e732acd2de5875667c08c3eca0d0b9eacf'],416,432,848,19294400,19,1,1,1,17667
a3bc46cf8400d7e829f8d4968518714d444163f4,1,Alex Antonenko,2014-12-03 19:55:45+02:00,['bc8c329376b3ed242984e0bf720408350ed8a587'],23,24,47,19294447,1,,,,17667
9b0c3ec03054ee4efdd29de344817298cb09fd57,1,Andrii Tkach,2014-12-03 20:16:54+02:00,['a3bc46cf8400d7e829f8d4968518714d444163f4'],181,618,799,19295246,18,0.163398693,0.718954248,1,17668
87ba96e27cf69b5a9d0d9856b824b325b1ee108f,1,Aleksandr Kovalenko,2014-12-03 20:51:36+02:00,['9b0c3ec03054ee4efdd29de344817298cb09fd57'],104,306,410,19295656,10,0.68627451,1,1,17669
0eb91c222c4a579144067cc0c2ffa2dc2d1c04c7,1,Nate Cole,2014-12-03 11:06:18-08:00,['87ba96e27cf69b5a9d0d9856b824b325b1ee108f'],521,1094,1615,19297271,22,0.907407407,0.435185185,0.555555556,17676
2518a56a3c0e6a530ca46b3d3d5ba7dc42b5246b,1,Jonathan Hurley,2014-12-03 14:27:44-05:00,['0eb91c222c4a579144067cc0c2ffa2dc2d1c04c7'],160,477,637,19297908,20,0.54248366,0.960784314,1,17676
2160d544a648224f5320337bff5184fa0498b655,1,Siddharth Wagle,2014-12-03 12:29:37-08:00,['2518a56a3c0e6a530ca46b3d3d5ba7dc42b5246b'],211,718,929,19298837,20,0.151020408,1,0.591836735,17680
b87c52aeb9ae3791eb53dfe009d7184a7f76e945,1,Alejandro Fernandez,2014-12-03 14:02:20-08:00,['2160d544a648224f5320337bff5184fa0498b655'],9,63,72,19298909,7,0.272727273,0.272727273,0.303030303,17680
a4b48f2ad71bf3bcdbc500314c7f403e383894b2,1,tbeerbower,2014-12-03 17:35:20-05:00,['b87c52aeb9ae3791eb53dfe009d7184a7f76e945'],53,256,309,19299218,18,0.529411765,1,0.661764706,17680
7b77f4dc64c826a23df29ed0a45a3abf36b088b9,1,sposetti,2014-12-03 19:10:10-05:00,['a4b48f2ad71bf3bcdbc500314c7f403e383894b2'],4,164,168,19299386,4,0.833333333,1,1,17681
3a8e1c5e121d5bf532271c7b123e98338f274010,1,Srimanth Gunturi,2014-12-03 20:30:52-08:00,['7b77f4dc64c826a23df29ed0a45a3abf36b088b9'],4,20,24,19299410,4,0.058823529,1,1,17681
61687ead92f7bc638d6d5c50dd5aed047344e087,1,Dmytro Sen,2014-12-04 15:24:04+02:00,['3a8e1c5e121d5bf532271c7b123e98338f274010'],2,60,62,19299472,4,0.461538462,0.871794872,1,17681
a1b32f08e4ef6643c3ec2e8e9b922a4d15453090,1,Alex Antonenko,2014-12-04 17:57:33+02:00,['61687ead92f7bc638d6d5c50dd5aed047344e087'],140,111,251,19299723,6,0.885714286,0,0,17681
403cb0c7e1f609670c1fec7b91826ee55d523664,1,sposetti,2014-12-04 11:22:50-05:00,['a1b32f08e4ef6643c3ec2e8e9b922a4d15453090'],140,196,336,19300059,6,0,0,0,17682
b9d8fd0396beda5b6f6529798c812e188359d0a9,1,sposetti,2014-12-04 11:30:05-05:00,['403cb0c7e1f609670c1fec7b91826ee55d523664'],0,367,367,19300426,5,1,1,1,17687
46325c5637df25c865776121f397c3d83ae04b95,0,sposetti,2014-12-04 12:11:08-05:00,['b9d8fd0396beda5b6f6529798c812e188359d0a9'],5,7,12,19300438,1,,,,17687
21e3d2a73ba2048292e42b5e01c1d95d9d5896f8,1,Dmytro Sen,2014-12-04 19:27:40+02:00,['46325c5637df25c865776121f397c3d83ae04b95'],0,219,219,19300657,2,1,1,1,17689
f6e34a54469e6ecb10a93cd9a595d0a13323cea7,1,Oleg Nechiporenko,2014-12-04 19:54:20+02:00,['21e3d2a73ba2048292e42b5e01c1d95d9d5896f8'],33,135,168,19300825,11,0.586206897,0.586206897,0.913793103,17689
472206f10792e9c00a1c34dfb220184d615efebe,1,Srimanth Gunturi,2014-12-04 12:04:14-08:00,['f6e34a54469e6ecb10a93cd9a595d0a13323cea7'],39,76,115,19300940,8,0,0,1,17689
53013484a3293a32cfa1eadbd7d771d19bd645a2,1,Srimanth Gunturi,2014-12-04 12:18:58-08:00,['472206f10792e9c00a1c34dfb220184d615efebe'],127,1186,1313,19302253,42,0.728434505,0.948881789,0.968051118,17694
772f7b48b9bb5bff5159a5d87d140f5d28360ea0,0,Jaimin Jetly,2014-12-04 12:42:18-08:00,['53013484a3293a32cfa1eadbd7d771d19bd645a2'],27,105,132,19302385,4,0,0.660377358,0.735849057,17694
356309d16de58d67f3a57a596fd4d936d625146e,1,Srimanth Gunturi,2014-12-04 13:26:58-08:00,['772f7b48b9bb5bff5159a5d87d140f5d28360ea0'],11,245,256,19302641,4,1,1,1,17694
96c9e2045f5b30b1289846c60528deaddbc6a423,1,Jaimin Jetly,2014-12-04 17:01:33-08:00,['356309d16de58d67f3a57a596fd4d936d625146e'],53,225,278,19302919,3,0.961904762,1,1,17695
f5ed63590a038b51e0a0d9212c009876b03568af,1,Xi Wang,2014-12-04 18:09:52-08:00,['96c9e2045f5b30b1289846c60528deaddbc6a423'],5,15,20,19302939,1,,,,17695
ae24c7331f3583c400a6b4f469fc1ae487c109f9,1,Xi Wang,2014-12-04 18:09:52-08:00,['f5ed63590a038b51e0a0d9212c009876b03568af'],22,61,83,19303022,16,0,1,1,17695
76ca626b6001c867a2970fa516e3a9ce529f3a02,0,Siddharth Wagle,2014-12-04 19:09:12-08:00,['ae24c7331f3583c400a6b4f469fc1ae487c109f9'],10,23,33,19303055,2,1,1,0,17695
d91074a0cb968dd1b6df52cf943689740ac2a3b8,1,Srimanth Gunturi,2014-12-04 20:32:59-08:00,['76ca626b6001c867a2970fa516e3a9ce529f3a02'],12,106,118,19303173,7,0.764705882,1,1,17695
a5c6834d6a51e8efe8a7ca4698242e33bc88a8d0,1,Dmytro Sen,2014-12-05 14:09:32+02:00,['d91074a0cb968dd1b6df52cf943689740ac2a3b8'],16,58,74,19303247,4,0,1,1,17695
753029ff55c07cda1fbe20108cd6e0000f08bee5,1,Oleg Nechiporenko,2014-12-05 14:13:09+02:00,['a5c6834d6a51e8efe8a7ca4698242e33bc88a8d0'],4,12,16,19303263,2,1,1,1,17695
0fb990959f598ec04bf0c4cded9611038cc08622,1,Andrew Onishuk,2014-12-05 16:19:46+02:00,['753029ff55c07cda1fbe20108cd6e0000f08bee5'],0,9,9,19303272,3,,,,17695
3c8e7ba780bd61332d61aff14b363c438ea18d9f,1,Aleksandr Kovalenko,2014-12-05 19:00:16+02:00,['0fb990959f598ec04bf0c4cded9611038cc08622'],178,224,402,19303674,12,1,1,1,17695
cd07f8844180a352c88241f8ae80968d5139776d,1,Oleg Nechiporenko,2014-12-05 19:40:21+02:00,['3c8e7ba780bd61332d61aff14b363c438ea18d9f'],172,479,651,19304325,8,1,1,1,17696
38b798b158f3c3f329ec1f8224e2dcc4fbfb170c,1,Srimanth Gunturi,2014-12-05 10:07:03-08:00,['cd07f8844180a352c88241f8ae80968d5139776d'],5,5,10,19304335,1,,,,17696
4d783d809334ce61d284fd2f980a5f01f975eaed,1,Andrew Onishuk,2014-12-05 20:33:38+02:00,['38b798b158f3c3f329ec1f8224e2dcc4fbfb170c'],6,32,38,19304373,4,,,,17697
93ca85b54e0b38a764ccfe4290305de44d46c2ad,1,Andrew Onishuk,2014-12-05 20:58:25+02:00,['4d783d809334ce61d284fd2f980a5f01f975eaed'],3,3,6,19304379,2,,,,17697
9cdd4e24487e04f714abb1b4716fd4a56893e245,1,Aleksandr Kovalenko,2014-12-05 20:58:39+02:00,['93ca85b54e0b38a764ccfe4290305de44d46c2ad'],4,146,150,19304529,4,0,1,1,17697
b42150cad1fb21d777519e029154614072a5b219,1,Myroslav Papirkovskyy,2014-12-05 21:42:06+02:00,['9cdd4e24487e04f714abb1b4716fd4a56893e245'],179,852,1031,19305560,19,0.519337017,0.889502762,0.82320442,17706
1e94bc1abf647a53450dcd9f8251bee185bb92bf,1,Alex Antonenko,2014-12-05 22:56:08+02:00,['b42150cad1fb21d777519e029154614072a5b219'],6,9,15,19305575,2,0,1,1,17706
9e052eed1a582072a448e923f50107e00716c04f,1,Myroslav Papirkovskyy,2014-12-06 00:11:06+02:00,['1e94bc1abf647a53450dcd9f8251bee185bb92bf'],83,216,299,19305874,13,0,1,1,17708
05f2f77555a44e00c288a7ef3ddec570c55e6745,1,Siddharth Wagle,2014-12-05 16:08:44-08:00,['9e052eed1a582072a448e923f50107e00716c04f'],45,45,90,19305964,2,,,,17708
70dc609350839d620ca8573d947236b4326892d8,1,Yusaku Sako,2014-12-05 16:57:00-08:00,['05f2f77555a44e00c288a7ef3ddec570c55e6745'],48,152,200,19306164,7,1,1,1,17709
8eb500e603d5e1f22d3470ddeff1595419fea65e,1,Jaimin Jetly,2014-12-06 12:03:47-08:00,['70dc609350839d620ca8573d947236b4326892d8'],352,1776,2128,19308292,30,0.794736842,0.794736842,0.936842105,17711
e7c512c2c45256ef7cb5a26bc1b7282be0574c20,1,Nate Cole,2014-12-06 16:47:04-05:00,['8eb500e603d5e1f22d3470ddeff1595419fea65e'],177,484,661,19308953,12,0.244444444,0.822222222,0.733333333,17711
abb48a464d7e8c58b08d0f5d78579d5e9820b616,1,Srimanth Gunturi,2014-12-06 16:15:53-08:00,['e7c512c2c45256ef7cb5a26bc1b7282be0574c20'],95,63,158,19309111,16,0.37037037,0.111111111,1,17711
0dbbf5cb68ad14c1eeae819cd24668663b4451df,1,Srimanth Gunturi,2014-12-07 11:58:46-08:00,['abb48a464d7e8c58b08d0f5d78579d5e9820b616'],8,147,155,19309266,13,1,1,1,17713
2a031a830e57a35e7c0e3fed0bbfbf99e7d431dc,1,Srimanth Gunturi,2014-12-07 20:05:53-08:00,['0dbbf5cb68ad14c1eeae819cd24668663b4451df'],95,167,262,19309528,13,1,1,1,17713
d8f78c16f57173cf274a0599028a15708422352f,1,Oleg Nechiporenko,2014-12-08 13:40:32+02:00,['2a031a830e57a35e7c0e3fed0bbfbf99e7d431dc'],1,28,29,19309557,3,0.923076923,0.923076923,0.923076923,17713
022dc468cf0da8723602defa022d65c7747c504e,1,Andrew Onishuk,2014-12-08 15:26:51+02:00,['d8f78c16f57173cf274a0599028a15708422352f'],106,204,310,19309867,15,0,0.805194805,1,17713
77cf8b605bbeb5d6a0a2ade780517d5ea15d509a,1,Vitaly Brodetskyi,2014-12-08 16:46:45+02:00,['022dc468cf0da8723602defa022d65c7747c504e'],0,21,21,19309888,1,,,,17713
efc7ba2e09017a71da01a27df6a9073c78d50d82,0,Andrew Onishuk,2014-12-08 17:35:52+02:00,['77cf8b605bbeb5d6a0a2ade780517d5ea15d509a'],3,2,5,19309893,2,,,,17713
4ae267ce214f8919cb2424d929271c2db655f07d,1,Aleksandr Kovalenko,2014-12-08 18:03:41+02:00,['efc7ba2e09017a71da01a27df6a9073c78d50d82'],689,690,1379,19311272,4,,,,17713
438326f69de353b92331e6df4c59739afd22fa66,1,Andrew Onishuk,2014-12-08 18:09:57+02:00,['4ae267ce214f8919cb2424d929271c2db655f07d'],187,220,407,19311679,10,0.2,0.8,1,17714
e551069762a3387a3f7c7fe7a07530e45408f44b,1,Jonathan Hurley,2014-12-08 11:19:51-05:00,['438326f69de353b92331e6df4c59739afd22fa66'],55,268,323,19312002,32,0.264150943,0.924528302,1,17714
fd68afd318b688de8712b2c8fb29b57c4eaa2ab8,1,Andrew Onishuk,2014-12-08 19:04:18+02:00,['e551069762a3387a3f7c7fe7a07530e45408f44b'],14,14,28,19312030,2,,,,17714
dcbdcdfa71492916d1f8e9d96077c17688932694,0,Lisnichenko Dmitro,2014-12-08 19:05:57+02:00,['fd68afd318b688de8712b2c8fb29b57c4eaa2ab8'],14,0,14,19312044,2,0,0,0,17714
2e7b019e300caea925a056b3f4e5a4fcab1fb05e,0,Alex Antonenko,2014-12-08 20:04:10+02:00,['dcbdcdfa71492916d1f8e9d96077c17688932694'],10,10,20,19312064,4,,,,17714
5f2c1a2178dc703c9a4a7de1883fcf2afb7fe8a1,0,Alex Antonenko,2014-12-08 20:04:11+02:00,['2e7b019e300caea925a056b3f4e5a4fcab1fb05e'],5,5,10,19312074,3,,,,17714
e222d2f5de410b6b63c4136f10681a9fb001fbee,1,Alex Antonenko,2014-12-08 20:04:11+02:00,['5f2c1a2178dc703c9a4a7de1883fcf2afb7fe8a1'],1,1,2,19312076,1,,,,17714
4a42b6d5b9c69e8822e6bf35ef656e3c7f8ae0ac,1,Andrew Onishuk,2014-12-08 20:21:46+02:00,['e222d2f5de410b6b63c4136f10681a9fb001fbee'],50,49,99,19312175,5,1,1,,17714
3ba1889f454ffcd14352954ef30ad0393b02dc4a,1,Vitaly Brodetskyi,2014-12-08 20:23:03+02:00,['4a42b6d5b9c69e8822e6bf35ef656e3c7f8ae0ac'],11,55,66,19312241,3,0.315789474,0.131578947,0.789473684,17714
74f9ddcf8b0d9a8c0650de7352015745e8e2af28,1,John Speidel,2014-12-08 14:07:27-05:00,['3ba1889f454ffcd14352954ef30ad0393b02dc4a'],56,154,210,19312451,7,0,0,0,17714
0d6e0c57f654c6bcefdd85b5e0fe0f8b6759ba7c,1,Aleksandr Kovalenko,2014-12-08 21:18:14+02:00,['74f9ddcf8b0d9a8c0650de7352015745e8e2af28'],55,106,161,19312612,10,0.95,1,1,17714
9053513f66023e6d062f94e3df00e9de1791a9f0,1,Lisnichenko Dmitro,2014-12-08 21:50:01+02:00,['0d6e0c57f654c6bcefdd85b5e0fe0f8b6759ba7c'],57,121,178,19312790,7,0,0.803921569,0.549019608,17714
8a322603de3cdc01d296226cd98d0965948fcd44,1,Xi Wang,2014-12-08 12:11:18-08:00,['9053513f66023e6d062f94e3df00e9de1791a9f0'],183,293,476,19313266,12,0.540540541,0.77027027,0.918918919,17715
ed0681a842f7b85882284f231c67354601ba8c43,1,Aleksandr Kovalenko,2014-12-08 22:54:45+02:00,['8a322603de3cdc01d296226cd98d0965948fcd44'],36,36,72,19313338,6,,,,17715
1a18ddeed1b4c00a822a6c125eb4e73bf0af515a,1,Bob Nettleton,2014-12-08 16:59:05-05:00,['ed0681a842f7b85882284f231c67354601ba8c43'],0,2725,2725,19316063,18,0.242553191,0.533617021,0.85787234,17731
e7b8383b5af0a39b2530dbfc24563eefd7f781c7,1,John Speidel,2014-12-08 17:45:52-05:00,['1a18ddeed1b4c00a822a6c125eb4e73bf0af515a'],0,4358,4358,19320421,17,0.446219382,0.727369542,1,17748
bca33177dd129d341e5df4cb338b5a413cee76ea,0,Xi Wang,2014-12-08 14:48:38-08:00,['e7b8383b5af0a39b2530dbfc24563eefd7f781c7'],2,5,7,19320428,3,1,1,1,17748
15c65b93005c7c7470d73db1cd6d53cab184e398,1,Artem Baranchuk,2014-12-09 01:36:46+02:00,['bca33177dd129d341e5df4cb338b5a413cee76ea'],1539,1050,2589,19323017,35,0.222222222,0,0.844444444,17750
f947bfb4194bef1ab8346bf1d8b8ed7a216e5034,1,tbeerbower,2014-12-08 19:58:02-05:00,['15c65b93005c7c7470d73db1cd6d53cab184e398'],53,560,613,19323630,16,0.785714286,1,1,17753
23e0228c466a6a1fcc78c16f8f5e244dd6e2673d,1,Alejandro Fernandez,2014-12-08 18:53:01-08:00,['f947bfb4194bef1ab8346bf1d8b8ed7a216e5034'],46,188,234,19323864,11,0.569444444,0.680555556,0.916666667,17754
cda2ea25f55d05b8d995af63ba05c055e9d313df,1,Siddharth Wagle,2014-12-08 20:14:40-08:00,['23e0228c466a6a1fcc78c16f8f5e244dd6e2673d'],10,20,30,19323894,5,1,1,1,17754
e0c8df5a93726933021cdfb62b94bd1894c17d20,1,Siddharth Wagle,2014-12-08 20:17:58-08:00,['cda2ea25f55d05b8d995af63ba05c055e9d313df'],4,38,42,19323936,2,0,0,1,17754
996a07b4bbcf6f69e1871254a6a6980bf48dbc9b,1,Srimanth Gunturi,2014-12-08 22:52:51-08:00,['e0c8df5a93726933021cdfb62b94bd1894c17d20'],59,154,213,19324149,10,1,1,1,17754
4fbfe4c5b35d481c5a28e6d0f82b07753654ef2c,1,Oleg Nechiporenko,2014-12-09 13:10:53+02:00,['996a07b4bbcf6f69e1871254a6a6980bf48dbc9b'],2,62,64,19324213,4,1,1,1,17755
3bbcc13bf56a7c716d1e8eab6dcc36d6b28609ca,0,Andrew Onishuk,2014-12-09 14:19:25+02:00,['4fbfe4c5b35d481c5a28e6d0f82b07753654ef2c'],1,2,3,19324216,1,0,0,1,17755
5c204d86a3d72a065e16f2c60453b24c6eb54625,1,Aleksandr Kovalenko,2014-12-09 15:55:44+02:00,['3bbcc13bf56a7c716d1e8eab6dcc36d6b28609ca'],0,3,3,19324219,1,1,1,1,17755
f3aa618f9a87088e90b5199b9f7828bc19a85755,0,aBabiichuk,2014-12-09 16:02:18+02:00,['5c204d86a3d72a065e16f2c60453b24c6eb54625'],34,938,972,19325191,18,1,1,0.977777778,17761
3022e2749460089896f681bd64ed549237fd1f9d,1,Jonathan Hurley,2014-12-09 10:18:53-05:00,['f3aa618f9a87088e90b5199b9f7828bc19a85755'],1,190,191,19325382,6,0.254385965,0.868421053,1,17761
9e2ebf8a42e4d2e11b0756148b2ded14d1bcb7db,1,Nate Cole,2014-12-09 10:22:08-05:00,['3022e2749460089896f681bd64ed549237fd1f9d'],55,216,271,19325653,8,0.076923077,0.743589744,0.307692308,17762
80e1d9fb96a0527507dc0c62503ff8e9c465b537,0,Aleksandr Kovalenko,2014-12-09 17:32:41+02:00,['9e2ebf8a42e4d2e11b0756148b2ded14d1bcb7db'],0,11,11,19325664,2,0,0.909090909,1,17762
1f950c054c956dbc36e8531abc434752060b51bb,1,Andrii Tkach,2014-12-09 17:47:37+02:00,['80e1d9fb96a0527507dc0c62503ff8e9c465b537'],436,1277,1713,19327377,23,1,1,1,17765
cff01d6ffda174c6a5be34de5d41a3f638c9a3dd,0,Siddharth Wagle,2014-12-09 09:34:38-08:00,['1f950c054c956dbc36e8531abc434752060b51bb'],1,2,3,19327380,2,0,1,1,17765
793c8a2c70421ac7ce8dd6b664fe7a937f1a2a66,1,Alex Antonenko,2014-12-09 19:43:03+02:00,['cff01d6ffda174c6a5be34de5d41a3f638c9a3dd'],236,463,699,19328079,27,1,1,0.726190476,17772
45468b65af0f731cd14c2ad0516bba9f7cddf217,1,Dmytro Sen,2014-12-09 19:54:38+02:00,['793c8a2c70421ac7ce8dd6b664fe7a937f1a2a66'],72,279,351,19328430,9,0.317365269,0.592814371,0.467065868,17772
6ed4fe4508cf7b1927bacca29a5b85f89b86746a,1,Andrew Onishuk,2014-12-09 20:39:38+02:00,['45468b65af0f731cd14c2ad0516bba9f7cddf217'],427,696,1123,19329553,59,0,0.850574713,1,17772
1a04f7c7d077a94484afd42a159213966ed73c26,1,Srimanth Gunturi,2014-12-09 13:42:27-08:00,['6ed4fe4508cf7b1927bacca29a5b85f89b86746a'],36,22,58,19329611,5,1,0,0,17772
abff00010279aa64cf36d489f260702206ba4444,0,Srimanth Gunturi,2014-12-09 14:09:57-08:00,['1a04f7c7d077a94484afd42a159213966ed73c26'],2,6,8,19329619,2,1,1,1,17772
a665a3cc13abba23224999a18e4eae1f1f8bc754,1,Jaimin Jetly,2014-12-09 23:09:38-08:00,['abff00010279aa64cf36d489f260702206ba4444'],31,822,853,19330472,10,0.598784195,1,0.963525836,17774
dacca7b5fa782a4d08b12017474bb91d747a706f,1,Andrii Tkach,2014-12-10 14:18:33+02:00,['a665a3cc13abba23224999a18e4eae1f1f8bc754'],74,316,390,19330862,14,1,1,0.9765625,17775
b1853c2f4436254e374c5af0a9d4e5ade662247d,1,aBabiichuk,2014-12-10 15:09:37+02:00,['dacca7b5fa782a4d08b12017474bb91d747a706f'],5,215,220,19331082,9,1,1,1,17777
e148fca5aadff1f8720de8285d700c1fde7f8a7b,1,Lisnichenko Dmitro,2014-12-10 15:58:36+02:00,['b1853c2f4436254e374c5af0a9d4e5ade662247d'],49,72,121,19331203,9,0.8,0.05,1,17777
00f7a6a61cdffb9e6bc0b3055332aa40e84c3a57,1,Oleg Nechiporenko,2014-12-10 16:17:20+02:00,['e148fca5aadff1f8720de8285d700c1fde7f8a7b'],89,185,274,19331477,8,0.775,1,1,17777
cd38a54d6d48152e65623af6c4ddc4b4f00a5ad5,1,aBabiichuk,2014-12-10 17:33:45+02:00,['00f7a6a61cdffb9e6bc0b3055332aa40e84c3a57'],0,5,5,19331482,2,0.75,1,0.75,17777
c1482f8202d9c02879e566b7885174cc331d4c47,1,Andrii Tkach,2014-12-10 17:44:22+02:00,['cd38a54d6d48152e65623af6c4ddc4b4f00a5ad5'],0,38,38,19331520,2,0.564102564,1,0.871794872,17777
96b7f56fec4fe89d0b1a1721a8d8badc8573d207,1,Oleg Nechiporenko,2014-12-10 17:48:09+02:00,['c1482f8202d9c02879e566b7885174cc331d4c47'],309,462,771,19332291,5,0.041666667,1,1,17777
b60f26ee9a3ae20a37e49f0158e581862643ef86,1,Lisnichenko Dmitro,2014-12-10 18:39:55+02:00,['96b7f56fec4fe89d0b1a1721a8d8badc8573d207'],60,94,154,19332445,11,0.48,0.6,0,17777
da44fafcc965df016a01746147bd466d226a76c8,1,Alex Antonenko,2014-12-10 20:06:09+02:00,['b60f26ee9a3ae20a37e49f0158e581862643ef86'],8,66,74,19332519,5,1,1,1,17778
a5c9225c2445884149c4c27aec041ebcc9fef4b4,0,Andrew Onishuk,2014-12-10 20:11:57+02:00,['da44fafcc965df016a01746147bd466d226a76c8'],1,1,2,19332521,1,,,,17778
c20ff90d8d5c2d2aabcec2b66a7490ab115a0e5c,1,tbeerbower,2014-12-10 13:32:42-05:00,['a5c9225c2445884149c4c27aec041ebcc9fef4b4'],30,347,377,19332898,5,0.008130081,1,1,17780
a91ac591ab31c7642b1f405504a0ac022b67cf0a,1,Andrew Onishuk,2014-12-10 21:03:32+02:00,['c20ff90d8d5c2d2aabcec2b66a7490ab115a0e5c'],2,20,22,19332920,3,1,1,1,17780
7bf992ddbdd0e5d96c5ea21a1db251e99e101abd,1,Andrew Onishuk,2014-12-10 21:06:25+02:00,['a91ac591ab31c7642b1f405504a0ac022b67cf0a'],56,55,111,19333031,18,1,1,1,17780
d2bc0ac8193e13988879bde4078a7406bacd0935,1,Siddharth Wagle,2014-12-10 11:39:43-08:00,['7bf992ddbdd0e5d96c5ea21a1db251e99e101abd'],0,16,16,19333047,1,0,0,1,17780
bf2e5190078fd68a4d4dcd3a8f5064623dab1bf4,1,Lisnichenko Dmitro,2014-12-10 22:16:07+02:00,['d2bc0ac8193e13988879bde4078a7406bacd0935'],14,14,28,19333075,1,,,,17780
bd3aea50a66199d16de10096069f906db0b8b944,1,Jaimin Jetly,2014-12-10 12:37:57-08:00,['bf2e5190078fd68a4d4dcd3a8f5064623dab1bf4'],53,71,124,19333199,8,,,,17780
1aff154abe88c1c71ad07cb5c30eb1095f648a73,1,Xi Wang,2014-12-10 12:59:08-08:00,['bd3aea50a66199d16de10096069f906db0b8b944'],185,156,341,19333540,6,0.314814815,0,0,17780
494ae7a15fd78d47bae9ed775b6b3c221aa57495,0,Xi Wang,2014-12-10 12:59:08-08:00,['1aff154abe88c1c71ad07cb5c30eb1095f648a73'],1,4,5,19333545,1,1,1,1,17780
9d806633ebec751a46c196dcb5b5e32a710d54d4,1,Jaimin Jetly,2014-12-10 13:07:54-08:00,['494ae7a15fd78d47bae9ed775b6b3c221aa57495'],33,492,525,19334070,8,0.553398058,0.553398058,1,17782
86b0ce46c69c22d1bb23e976fcea06cd93dae8ea,1,Myroslav Papirkovskyy,2014-12-10 23:48:44+02:00,['9d806633ebec751a46c196dcb5b5e32a710d54d4'],2,38,40,19334110,5,0,0,1,17783
391a53b40abf59ec8117b9e5434606fe52c73dfc,1,Myroslav Papirkovskyy,2014-12-10 23:48:44+02:00,['86b0ce46c69c22d1bb23e976fcea06cd93dae8ea'],4,44,48,19334158,2,,,,17784
8e4a00308147ba496325bd4e3766ca4f9fba9d54,1,Siddharth Wagle,2014-12-10 13:51:52-08:00,['391a53b40abf59ec8117b9e5434606fe52c73dfc'],0,500,500,19334658,11,0.355140187,0.719626168,0.700934579,17791
89dc6c1c5bfe06eac6bd188a53103bc766218f81,0,Nate Cole,2014-12-10 16:52:17-05:00,['8e4a00308147ba496325bd4e3766ca4f9fba9d54'],158,653,811,19335469,21,0.218390805,0,1,17794
4ae9bb9c86bb08e2a829b16e4c66d200b7f94208,1,Myroslav Papirkovskyy,2014-12-11 00:51:00+02:00,['89dc6c1c5bfe06eac6bd188a53103bc766218f81'],3,4,7,19335476,2,,,,17794
f6248ae5f65ff403311262eb5e51631b9f5081c0,0,Yusaku Sako,2014-12-10 15:19:56-08:00,['4ae9bb9c86bb08e2a829b16e4c66d200b7f94208'],653,158,811,19336287,21,0.781609195,1,0,17794
14c869961a4bc5cb9ffa041d8ef79ade3ffff3bb,1,John Speidel,2014-12-10 21:26:43-05:00,['f6248ae5f65ff403311262eb5e51631b9f5081c0'],191,4452,4643,19340930,50,0.302040816,0.783673469,0.089795918,17827
c3bf0db08f5f761f3519740239f5342a05561475,1,Nate Cole,2014-12-10 22:54:35-05:00,['14c869961a4bc5cb9ffa041d8ef79ade3ffff3bb'],157,659,816,19341746,21,0.211111111,0,1,17830
8382315075c9908c099c2f64d9929c31b134f70d,1,Yusaku Sako,2014-12-10 20:26:09-08:00,['c3bf0db08f5f761f3519740239f5342a05561475'],135,352,487,19342233,11,1,1,0.946236559,17831
a51afbe54e1588b945dc1d879e3298dc829e5c04,1,Jonathan Hurley,2014-12-10 23:59:20-05:00,['8382315075c9908c099c2f64d9929c31b134f70d'],9,282,291,19342524,5,0.1484375,0.546875,0.9453125,17832
e9d39f9513efb5b07556c313c651c1e5f4d458a6,1,Nate Cole,2014-12-11 04:58:35-05:00,['a51afbe54e1588b945dc1d879e3298dc829e5c04'],76,416,492,19343016,10,0.174311927,0.605504587,0.577981651,17834
59fa68e77e90141647538775f81dc5aff57f22ac,0,aBabiichuk,2014-12-11 12:53:06+02:00,['e9d39f9513efb5b07556c313c651c1e5f4d458a6'],164,669,833,19343849,15,0.511627907,0.930232558,1,17835
5b0e8bd9cf04432d8bfcccbbf838491b18e36fc4,1,Artem Baranchuk,2014-12-11 13:28:22+02:00,['59fa68e77e90141647538775f81dc5aff57f22ac'],7,25,32,19343881,6,1,1,0,17835
869702d10598b360aca71d8e56fe0f13b278e1c9,1,Oleg Nechiporenko,2014-12-11 13:29:53+02:00,['5b0e8bd9cf04432d8bfcccbbf838491b18e36fc4'],95,168,263,19344144,7,0.212121212,1,1,17835
2cfc2f843d092b8b13f1bd560525a3d0315e59e9,0,Dmytro Sen,2014-12-11 16:52:01+02:00,['869702d10598b360aca71d8e56fe0f13b278e1c9'],18,21,39,19344183,1,0,1,1,17835
24bb34444d41a567587c7dc5a810924c43eab627,1,Myroslav Papirkovskyy,2014-12-11 18:50:52+02:00,['2cfc2f843d092b8b13f1bd560525a3d0315e59e9'],43,20,63,19344246,4,,,,17835
4772593c58ff84809215d55f65867c392ef67693,1,John Speidel,2014-12-11 12:26:05-05:00,['24bb34444d41a567587c7dc5a810924c43eab627'],9,454,463,19344709,15,0,1,0.909090909,17845
400b1af7e0c417cebe95257f3dc8cb9fbb91b415,0,Lisnichenko Dmitro,2014-12-11 19:29:28+02:00,['4772593c58ff84809215d55f65867c392ef67693'],3,3,6,19344715,1,,,,17845
79be85886bbd457e49fd1ee5d14905f64e9c1890,1,Andrew Onishuk,2014-12-11 19:30:47+02:00,['400b1af7e0c417cebe95257f3dc8cb9fbb91b415'],6,12,18,19344733,2,0,1,0.75,17845
f42378ec9123626a6dbb21fdb04062c52759c776,1,Dmytro Sen,2014-12-11 19:34:33+02:00,['79be85886bbd457e49fd1ee5d14905f64e9c1890'],55,811,866,19345599,10,0.019512195,0.614634146,0.970731707,17846
45f2c9169a391886c0f321bc6c6d65956bda68bf,1,Andrew Onishuk,2014-12-11 19:39:50+02:00,['f42378ec9123626a6dbb21fdb04062c52759c776'],49,48,97,19345696,11,1,1,1,17846
298d8109a8056fdc52cad7dde89d913499776597,1,Andrew Onishuk,2014-12-11 19:45:48+02:00,['45f2c9169a391886c0f321bc6c6d65956bda68bf'],12,26,38,19345734,10,1,1,1,17846
4e04189d7071b44b74ced36801cb157416373bb1,1,Lisnichenko Dmitro,2014-12-11 19:48:54+02:00,['298d8109a8056fdc52cad7dde89d913499776597'],7,9,16,19345750,3,0,0.5,1,17846
54d01fc5426abaa68c21c7e173b26f4083acb351,1,Jaimin Jetly,2014-12-11 10:12:47-08:00,['4e04189d7071b44b74ced36801cb157416373bb1'],157,44,201,19345951,5,1,1,1,17846
8e4ce69df8acb9696c197b1bdb0bda8662881b52,1,Yusaku Sako,2014-12-11 10:13:22-08:00,['54d01fc5426abaa68c21c7e173b26f4083acb351'],3,3,6,19345957,1,,,,17846
da7643e51b4cb22181af4bc739f44339ba637e16,1,Aleksandr Kovalenko,2014-12-11 20:32:25+02:00,['8e4ce69df8acb9696c197b1bdb0bda8662881b52'],234,259,493,19346450,22,1,0.75,1,17846
aa696e0d83364b39cff50725bbb020cc6ab536b5,0,Jonathan Hurley,2014-12-11 13:33:49-05:00,['da7643e51b4cb22181af4bc739f44339ba637e16'],0,189,189,19346639,4,,,,17848
c15cd0e093c2fe3303c36972a5c943e4f00b5ee8,1,Scott Creeley,2014-12-11 13:49:50-05:00,['aa696e0d83364b39cff50725bbb020cc6ab536b5'],4,11125,11129,19357768,92,0.469635628,0.732793522,0.859649123,17936
4d7c2e4f203d23bd1eaee5b22e5a73de054d0ee2,1,Vitaly Brodetskyi,2014-12-11 21:13:08+02:00,['c15cd0e093c2fe3303c36972a5c943e4f00b5ee8'],3,4,7,19357775,1,,,,17936
d613ef5226db85289393537c58924aeb4f8d5ef3,1,Vitaly Brodetskyi,2014-12-11 21:19:38+02:00,['4d7c2e4f203d23bd1eaee5b22e5a73de054d0ee2'],0,81,81,19357856,1,0,0,0,17936
5b75e7abf6ee0034184e2a79db5fe6304a172b08,1,Alejandro Fernandez,2014-12-11 12:02:03-08:00,['d613ef5226db85289393537c58924aeb4f8d5ef3'],115,575,690,19358546,36,0.322751323,0.322751323,0,17938
841483b9bf05e7887aa02a60fb2594a3f36d39bd,1,Srimanth Gunturi,2014-12-11 12:06:29-08:00,['5b75e7abf6ee0034184e2a79db5fe6304a172b08'],4,171,175,19358721,5,1,0.78125,0.859375,17939
6e09a2ff3a49782c90462bf99b0da6bd7fdb9fb3,0,Srimanth Gunturi,2014-12-11 12:13:09-08:00,['841483b9bf05e7887aa02a60fb2594a3f36d39bd'],7,0,7,19358728,2,0.428571429,0,0.571428571,17939
f5558eb8271076757a994be71211e71a70e2f885,0,Siddharth Wagle,2014-12-11 12:21:32-08:00,['6e09a2ff3a49782c90462bf99b0da6bd7fdb9fb3'],0,2,2,19358730,1,,,,17939
f7414a762ca24883bd9a2f7e906a0638116172b0,1,Alex Antonenko,2014-12-11 22:24:43+02:00,['f5558eb8271076757a994be71211e71a70e2f885'],145,4451,4596,19363326,52,0.49192463,0.584791386,0.849259758,17951
836df671abc584f70b94a7728e1ebe12bb5f39c4,0,Alex Antonenko,2014-12-11 22:24:44+02:00,['f7414a762ca24883bd9a2f7e906a0638116172b0'],3,68,71,19363397,2,0.044117647,0.926470588,0.926470588,17951
8ead0a50b8d07dd28e4ddc0c94c1b72ddd522588,1,Alex Antonenko,2014-12-11 22:24:45+02:00,['836df671abc584f70b94a7728e1ebe12bb5f39c4'],15,114,129,19363526,9,0.80952381,0.357142857,0.928571429,17951
2f8de0be4b46221afc9b66cdc76ed18231fe3b00,1,Yusaku Sako,2014-12-11 15:04:26-08:00,['8ead0a50b8d07dd28e4ddc0c94c1b72ddd522588'],244,505,749,19364275,18,0.793478261,0.793478261,1,17953
16f1b9cea986211765a69489fe31e172d717d8e7,1,Srimanth Gunturi,2014-12-11 15:28:34-08:00,['2f8de0be4b46221afc9b66cdc76ed18231fe3b00'],26,46,72,19364347,6,,,,17953
cfc8fe180c27749a939f4d66f317f821515da2d8,0,Yusaku Sako,2014-12-11 15:41:27-08:00,['16f1b9cea986211765a69489fe31e172d717d8e7'],6,11,17,19364364,2,1,1,1,17953
4c0ac95e84fa918eeba68e172d74be1043546b74,1,Yusaku Sako,2014-12-11 16:32:23-08:00,['cfc8fe180c27749a939f4d66f317f821515da2d8'],1,1,2,19364366,1,,,,17953
8235e7d63fbb0fb4f30ba209e3ac7f95bf3bf76f,0,Siddharth Wagle,2014-12-11 16:45:15-08:00,['4c0ac95e84fa918eeba68e172d74be1043546b74'],1,6,7,19364373,1,1,1,1,17953
5cba41704c4a5c1defbba522253b00e5a2b8a345,1,Yusaku Sako,2014-12-11 17:14:11-08:00,['8235e7d63fbb0fb4f30ba209e3ac7f95bf3bf76f'],4,99,103,19364476,4,0.209677419,0.629032258,0.580645161,17953
23590a3b4c20de9088ad7d98d2ee62fbb0c8f12f,0,Srimanth Gunturi,2014-12-11 18:59:27-08:00,['5cba41704c4a5c1defbba522253b00e5a2b8a345'],0,1,1,19364477,1,1,1,1,17953
01d898529e5f2cf33fd4ba14b1839eb7043c133b,1,Alex Antonenko,2014-12-12 12:44:23+02:00,['23590a3b4c20de9088ad7d98d2ee62fbb0c8f12f'],9,24,33,19364510,1,1,0,1,17953
42f8d67dd4ff09b8773140b8ff8a6cca014505c3,1,Alex Antonenko,2014-12-12 14:32:54+02:00,['01d898529e5f2cf33fd4ba14b1839eb7043c133b'],2,2,4,19364514,2,,,,17953
dcbc0d956710aa9c7cee7418ff023bd01cc6aa2f,0,Artem Baranchuk,2014-12-12 15:15:28+02:00,['42f8d67dd4ff09b8773140b8ff8a6cca014505c3'],3,4,7,19364521,2,1,0,1,17953
69afc2a0505b4852b10a93cac74d9badf368e8ec,1,Artem Baranchuk,2014-12-12 15:16:45+02:00,['dcbc0d956710aa9c7cee7418ff023bd01cc6aa2f'],1,2,3,19364524,1,0,1,1,17953
439f4a5d0e5f23d5265ed42a092ba3008485f376,1,aBabiichuk,2014-12-12 16:20:23+02:00,['69afc2a0505b4852b10a93cac74d9badf368e8ec'],4,12,16,19364540,2,1,1,1,17953
a8767d6f3d3dfd53bfe857d5bad0f2a52d28d89e,1,Nate Cole,2014-12-12 11:02:53-05:00,['439f4a5d0e5f23d5265ed42a092ba3008485f376'],44,167,211,19364751,16,0.5625,0.916666667,0.916666667,17954
593e2b2bf2158e87f4988a56345c745b03ecb0b0,1,Artem Baranchuk,2014-12-12 18:15:29+02:00,['a8767d6f3d3dfd53bfe857d5bad0f2a52d28d89e'],1,1,2,19364753,1,,,,17954
8c0a2f83bedf9ad848842e90ba21f6fa70e80b5c,1,Artem Baranchuk,2014-12-12 18:21:05+02:00,['593e2b2bf2158e87f4988a56345c745b03ecb0b0'],0,66,66,19364819,1,,,,17955
7fc0508c28683511a0a23e86a3dc4f4aa9034b32,1,Andrii Tkach,2014-12-12 18:44:52+02:00,['8c0a2f83bedf9ad848842e90ba21f6fa70e80b5c'],225,664,889,19365708,19,0.373493976,1,1,17959
f74c490fa2ce6d88df6095bfabab8932bb46d9b7,1,Nate Cole,2014-12-12 12:18:06-05:00,['7fc0508c28683511a0a23e86a3dc4f4aa9034b32'],87,433,520,19366228,16,0.728971963,0.981308411,1,17961
563861f7fe2bd58c8155372c27023902cd542c37,0,aBabiichuk,2014-12-12 19:45:02+02:00,['f74c490fa2ce6d88df6095bfabab8932bb46d9b7'],17,123,140,19366368,9,0.885416667,0.96875,0.979166667,17961
51fafb9b8ab7542dd400c77de94f4e84f01471e2,1,Aleksandr Kovalenko,2014-12-12 19:51:39+02:00,['563861f7fe2bd58c8155372c27023902cd542c37'],31,48,79,19366447,1,1,1,1,17961
bbd7a13e9e4ea1e400e135d24db3a91cd0028a14,0,Alex Antonenko,2014-12-12 20:34:06+02:00,['51fafb9b8ab7542dd400c77de94f4e84f01471e2'],19,2,21,19366468,4,0,0,0,17961
0ebde089d08273956af2a6dfb1e5b1dc827d2eb0,1,Andrew Onishuk,2014-12-12 21:23:51+02:00,['bbd7a13e9e4ea1e400e135d24db3a91cd0028a14'],147,184,331,19366799,23,0.368421053,1,0.368421053,17961
9338767f2d991350701bdedbe24fd47d6d6c03d4,0,Andrew Onishuk,2014-12-12 21:39:31+02:00,['0ebde089d08273956af2a6dfb1e5b1dc827d2eb0'],4,9,13,19366812,2,0,1,1,17961
ee9f52421a80a99585caa01e95f6d0a0d154b2c4,1,Yusaku Sako,2014-12-12 12:18:40-08:00,['9338767f2d991350701bdedbe24fd47d6d6c03d4'],85,165,250,19367062,9,1,1,1,17962
40b5a39f0b9dc02789b1facfa2568dbf4dbdd413,1,Myroslav Papirkovskyy,2014-12-12 23:21:11+02:00,['ee9f52421a80a99585caa01e95f6d0a0d154b2c4'],15,19,34,19367096,8,,,,17962
62dcbb11e7391d61a0acceefd2d78f2055e30d36,1,Xi Wang,2014-12-12 13:37:04-08:00,['40b5a39f0b9dc02789b1facfa2568dbf4dbdd413'],0,1,1,19367097,1,,,,17962
0d78d6ab4962b7fc93655e7b68089a831c91bcd9,1,Xi Wang,2014-12-12 13:37:04-08:00,['62dcbb11e7391d61a0acceefd2d78f2055e30d36'],4,10,14,19367111,3,,,,17962
71e13776967cb64579a93d4d5f635f994ccaeed7,0,Yusaku Sako,2014-12-12 14:04:51-08:00,['0d78d6ab4962b7fc93655e7b68089a831c91bcd9'],123,17,140,19367251,9,0.114583333,0.03125,0.020833333,17962
3cb6f6aea3865952fced27677ef341970b6d661e,1,Nate Cole,2014-12-12 17:21:18-05:00,['71e13776967cb64579a93d4d5f635f994ccaeed7'],64,108,172,19367423,7,0.03125,0.703125,0.46875,17962
12d13e8b076c6690514683b5764c7a76aeee6a49,1,Srimanth Gunturi,2014-12-12 16:29:07-08:00,['3cb6f6aea3865952fced27677ef341970b6d661e'],64,477,541,19367964,13,0.541284404,1,1,17964
bf499456c17a5cabaa1fb7d8610f6fa8f08bf854,1,Xi Wang,2014-12-12 17:18:26-08:00,['12d13e8b076c6690514683b5764c7a76aeee6a49'],9,65,74,19368038,6,1,0.225806452,1,17964
b62846d25f4a3d65ee3e01a9d1b03697548a96bc,1,John Speidel,2014-12-12 22:25:05-05:00,['bf499456c17a5cabaa1fb7d8610f6fa8f08bf854'],4,689,693,19368731,16,0.234285714,0.205714286,0.954285714,17966
3c08f6f7d724dd566ebfb684fcf6e8acb598d27e,1,John Speidel,2014-12-12 23:24:01-05:00,['b62846d25f4a3d65ee3e01a9d1b03697548a96bc'],293,705,998,19369729,12,0.52,0.28,1,17972
1d53dc8f8ca80a2177250a7fcf115ec6e6d875cc,1,Srimanth Gunturi,2014-12-13 06:29:03-08:00,['3c08f6f7d724dd566ebfb684fcf6e8acb598d27e'],4,5,9,19369738,3,,,,17972
a1b2d1dd7e30fc1b5e8244186d560406e7482d88,1,Nate Cole,2014-12-14 07:49:53-05:00,['1d53dc8f8ca80a2177250a7fcf115ec6e6d875cc'],14,77,91,19369829,4,0.705882353,1,1,17972
7f2cfb47d18c4dfa60fc7882dcd28d144734c3c9,0,Yusaku Sako,2014-12-14 08:41:40-08:00,['a1b2d1dd7e30fc1b5e8244186d560406e7482d88'],2,57,59,19369888,3,1,1,1,17973
dbdd86268c275f4a7e2a2b3540f1b5989b7e738d,1,Yusaku Sako,2014-12-14 18:40:17-08:00,['7f2cfb47d18c4dfa60fc7882dcd28d144734c3c9'],57,2,59,19369947,3,0,0,0,17973
74469757694d1ea58f7f293865b44413d9d835fe,1,Yusaku Sako,2014-12-14 18:41:05-08:00,['dbdd86268c275f4a7e2a2b3540f1b5989b7e738d'],2,75,77,19370024,3,1,1,1,17974
1a270b81cc698af98e0a016e8caec0a3aa6478a0,1,Oleg Nechiporenko,2014-12-15 14:04:04+02:00,['74469757694d1ea58f7f293865b44413d9d835fe'],62,220,282,19370306,4,0,0,0,17974
12ac2945fba3aa15ba1dc4fc0502aff825a76758,1,Nate Cole,2014-12-15 07:41:22-05:00,['1a270b81cc698af98e0a016e8caec0a3aa6478a0'],98,113,211,19370517,34,0,0,0.0625,17974
bbd9961cd650624660e646dc49e823ba459480fb,0,aBabiichuk,2014-12-15 14:49:23+02:00,['12ac2945fba3aa15ba1dc4fc0502aff825a76758'],20,126,146,19370663,9,0.885416667,0.96875,0.979166667,17974
44501c12bae048a7029aeb4899ffc6eac29dd5a3,1,Jonathan Hurley,2014-12-15 08:33:18-05:00,['bbd9961cd650624660e646dc49e823ba459480fb'],168,533,701,19371364,27,0,0.209302326,0,17974
59442e3bab7d4488a211155d6a720b320b1b14b6,0,Oleg Nechiporenko,2014-12-15 15:38:56+02:00,['44501c12bae048a7029aeb4899ffc6eac29dd5a3'],1,5,6,19371370,1,1,1,1,17974
597c31733db8a8616d1d41321201eecc6dc3cbd1,1,Oleg Nechiporenko,2014-12-15 15:58:03+02:00,['59442e3bab7d4488a211155d6a720b320b1b14b6'],2,2,4,19371374,1,,,,17974
bde8a5bb101fa34e9fe38684a0b2b8703554ed7f,0,Oleg Nechiporenko,2014-12-15 16:49:53+02:00,['597c31733db8a8616d1d41321201eecc6dc3cbd1'],2,2,4,19371378,2,,,,17974
93fc4221dd3dda65115dc366798d840766377b9f,1,John Speidel,2014-12-15 10:52:13-05:00,['bde8a5bb101fa34e9fe38684a0b2b8703554ed7f'],0,284,284,19371662,2,0.024193548,0.419354839,1,17975
5bcb0ff4eb72ab4db31f5aeb3cae585cc94ba918,1,Andrii Tkach,2014-12-15 19:47:48+02:00,['93fc4221dd3dda65115dc366798d840766377b9f'],14,28,42,19371704,2,1,1,1,17975
2ccfa617a92a77582835d0cedffdb2853f25b41f,0,ababiichuk,2014-12-15 19:54:17+02:00,['5bcb0ff4eb72ab4db31f5aeb3cae585cc94ba918'],0,8,8,19371712,3,0.625,0,1,17975
190176e6174b7d610d1a9f26cda91662ad8171ff,1,Nate Cole,2014-12-15 14:12:23-05:00,['2ccfa617a92a77582835d0cedffdb2853f25b41f'],4,610,614,19372326,12,0.558252427,0.674757282,0.95631068,17982
ded6402147a03b65f22e9b65216aab9ef7da856f,0,Alejandro Fernandez,2014-12-15 16:13:14-08:00,['190176e6174b7d610d1a9f26cda91662ad8171ff'],15,22,37,19372363,4,,,,17982
ff7f908431df4c4a0b7bda376cfca764ab7e094f,0,Yusaku Sako,2014-12-15 16:13:42-08:00,['ded6402147a03b65f22e9b65216aab9ef7da856f'],1,25,26,19372389,1,,,,17982
5b0ccc0120f2f302ad788acb199ec2b3ff8dff75,1,Jonathan Hurley,2014-12-15 20:13:10-05:00,['ff7f908431df4c4a0b7bda376cfca764ab7e094f'],82,371,453,19372842,10,0.703225806,1,0.419354839,17984
c78d584e3979bb253cbd681fa80be9e70fe16787,1,Jonathan Hurley,2014-12-15 20:13:10-05:00,['5b0ccc0120f2f302ad788acb199ec2b3ff8dff75'],36,221,257,19373099,12,0.338028169,0.929577465,1,17985
7691aa4a5b74c5fd744e1d5033e384572034007d,0,Yusaku Sako,2014-12-15 18:04:27-08:00,['c78d584e3979bb253cbd681fa80be9e70fe16787'],8,0,8,19373107,3,0.375,1,0,17985
a1348d3c20bacef12fbb66f463b9b1c2be50382c,1,Alejandro Fernandez,2014-12-15 18:52:28-08:00,['7691aa4a5b74c5fd744e1d5033e384572034007d'],147,427,574,19373681,20,0.20212766,0.276595745,0.117021277,17988
8474c3497184e84362dc11b233ac3e9648484e0e,1,Jaimin Jetly,2014-12-15 19:09:34-08:00,['a1348d3c20bacef12fbb66f463b9b1c2be50382c'],364,444,808,19374489,9,1,0.571428571,1,17988
15cea53e254db471f6562603f00867ecf3c62d48,1,Jaimin Jetly,2014-12-15 19:18:05-08:00,['8474c3497184e84362dc11b233ac3e9648484e0e'],10,63,73,19374562,3,1,1,1,17988
f85260bed2d2c67bbbab7fa2a6505ca961829b90,1,Bob Nettleton,2014-12-16 09:17:41-05:00,['15cea53e254db471f6562603f00867ecf3c62d48'],131,284,415,19374977,4,0.203125,0.46875,1,17989
523b0ca6cff89b08fc2c2eaa80eb823e43f613db,0,aBabiichuk,2014-12-16 16:14:01+02:00,['f85260bed2d2c67bbbab7fa2a6505ca961829b90'],48,174,222,19375199,14,1,1,1,17991
bdf2695708969a6e3d5fa3a7b1a77e252e85b82c,1,Nate Cole,2014-12-16 09:37:09-05:00,['523b0ca6cff89b08fc2c2eaa80eb823e43f613db'],3,37,40,19375239,5,0.444444444,0,0.888888889,17991
120681b8314f2bc3d49c64b478ac36bf581d273d,1,Andrew Onishuk,2014-12-16 16:38:02+02:00,['bdf2695708969a6e3d5fa3a7b1a77e252e85b82c'],1,12,13,19375252,2,,,,17991
384c98ea3a87ae6cde50d7bc985c47f9b466bd6a,0,Vitaly Brodetskyi,2014-12-16 17:33:01+02:00,['120681b8314f2bc3d49c64b478ac36bf581d273d'],2,2,4,19375256,2,,,,17991
be896c4ec2dfbfce21f6bf5f026e232d434c5f5d,0,Aleksandr Kovalenko,2014-12-16 17:46:14+02:00,['384c98ea3a87ae6cde50d7bc985c47f9b466bd6a'],31,46,77,19375333,3,1,1,0,17991
56ad13d96ece46abe3d23e23b978a16893ad2cac,1,Jonathan Hurley,2014-12-16 11:23:43-05:00,['be896c4ec2dfbfce21f6bf5f026e232d434c5f5d'],64,126,190,19375523,12,0.75,1,1,17991
828dc79faeae3cf52d616c137597cf9dd9bca162,1,Andrii Tkach,2014-12-16 18:29:39+02:00,['56ad13d96ece46abe3d23e23b978a16893ad2cac'],38,453,491,19376014,8,0.45959596,0.994949495,1,17992
a840c24d5e18219e5063152287f9d03a8fef3d16,1,Oleg Nechiporenko,2014-12-16 19:35:12+02:00,['828dc79faeae3cf52d616c137597cf9dd9bca162'],10,42,52,19376066,5,1,0,1,17992
254280c3cf6f0f78bc178ad10b8c7ec563e656b3,1,John Speidel,2014-12-16 12:45:16-05:00,['828dc79faeae3cf52d616c137597cf9dd9bca162'],72,92,164,19376230,2,0,0.818181818,1,17992
d45f3864176cc0c2901331037ab684d06c47af5c,0,Oleg Nechiporenko,2014-12-16 19:55:25+02:00,"['a840c24d5e18219e5063152287f9d03a8fef3d16', '254280c3cf6f0f78bc178ad10b8c7ec563e656b3']",72,92,164,19376394,2,,,,17992
a42be2cc7f3978c6d09eab5b4be3622dae19db75,1,aBabiichuk,2014-12-16 20:09:15+02:00,['d45f3864176cc0c2901331037ab684d06c47af5c'],0,8,8,19376402,3,0.625,0,1,17992
870030a44c407b17d0bca62b82cb9320b4f1ca8b,1,aBabiichuk,2014-12-16 20:09:15+02:00,['a42be2cc7f3978c6d09eab5b4be3622dae19db75'],18,10,28,19376430,1,0,0,0,17992
6247e8bdeb82074dbeeab0d63a5020cd49f67109,1,tbeerbower,2014-12-16 13:55:10-05:00,['870030a44c407b17d0bca62b82cb9320b4f1ca8b'],315,269,584,19377014,21,0.125,0,0.375,17992
e0c421af49f60c1fd2c0d1729395c5500917b43a,1,Jaimin Jetly,2014-12-16 11:23:57-08:00,['6247e8bdeb82074dbeeab0d63a5020cd49f67109'],10,38,48,19377062,3,1,1,1,17992
432ddcbeb9628a9e2a141be676f3aa0602fd3796,0,Andrew Onishuk,2014-12-16 21:35:45+02:00,['e0c421af49f60c1fd2c0d1729395c5500917b43a'],3,0,3,19377065,1,,,,17992
4b0d9aeb9a8bfeb4ac5493544e71ac3ddf28d8f6,1,Yusaku Sako,2014-12-16 21:19:26-08:00,['432ddcbeb9628a9e2a141be676f3aa0602fd3796'],10,474,484,19377549,3,0.369369369,0.761261261,0.878378378,17994
4d5b3be717e5e28a809d767d7bbd25eaa1a1f02f,1,Yusaku Sako,2014-12-16 21:35:47-08:00,['4b0d9aeb9a8bfeb4ac5493544e71ac3ddf28d8f6'],0,746,746,19378295,5,,,,17999
e643e40b06a253495258ae0f2628d15ff93c1a56,0,Artem Baranchuk,2014-12-17 14:22:34+02:00,['4d5b3be717e5e28a809d767d7bbd25eaa1a1f02f'],0,9,9,19378304,1,1,1,1,17999
40759894da10f6e1329b2b186ed64ecd5a27bf5a,0,Aleksandr Kovalenko,2014-12-17 15:32:01+02:00,['e643e40b06a253495258ae0f2628d15ff93c1a56'],18,29,47,19378351,2,1,1,1,17999
3702ad8dea850eae17f00e0ec72e9d3b43478800,0,Andrew Onishuk,2014-12-17 15:59:30+02:00,['40759894da10f6e1329b2b186ed64ecd5a27bf5a'],1,1,2,19378353,1,,,,17999
c62b378c51170c971bc861c26c9853b51a26258d,1,aBabiichuk,2014-12-17 17:06:49+02:00,['3702ad8dea850eae17f00e0ec72e9d3b43478800'],98,48,146,19378499,6,1,1,1,17999
1c79b812689ad205877e42ce7e15b8425bc34f3e,0,aBabiichuk,2014-12-17 17:06:49+02:00,['c62b378c51170c971bc861c26c9853b51a26258d'],14,8,22,19378521,2,,,,17999
97115a760f43f3b0c2d75cd71a6837434971c250,1,Oleg Nechiporenko,2014-12-17 17:30:43+02:00,['1c79b812689ad205877e42ce7e15b8425bc34f3e'],1,1,2,19378523,1,,,,17999
92815dd588597842a02d3143657554a8085d880e,1,Lisnichenko Dmitro,2014-12-17 18:30:19+02:00,['97115a760f43f3b0c2d75cd71a6837434971c250'],330,358,688,19379211,31,0,0,1,17999
fa294ad774967de85e777337fdc5c681bdedd97a,1,Andrii Tkach,2014-12-17 19:01:47+02:00,['92815dd588597842a02d3143657554a8085d880e'],41,650,691,19379902,10,0.617977528,0.97752809,1,17999
4830715bef59f458a36b23d697a377babaef62e0,1,Andrew Onishuk,2014-12-17 19:29:01+02:00,['fa294ad774967de85e777337fdc5c681bdedd97a'],7,56,63,19379965,5,0,0,1,18000
a6a34763d30541c6d2648f2e7a637bfec342514f,1,Andrew Onishuk,2014-12-17 19:38:11+02:00,['4830715bef59f458a36b23d697a377babaef62e0'],3,4,7,19379972,2,,,,18000
9a6110a3a76f04b3764f7170d1b7644eb441a9ca,0,Andrew Onishuk,2014-12-17 19:42:22+02:00,['a6a34763d30541c6d2648f2e7a637bfec342514f'],1,1,2,19379974,1,,,,18000
b0cb8edae40b61cc301bb68bdabcb37d5c4bff5c,1,sposetti,2014-12-17 12:54:26-05:00,['9a6110a3a76f04b3764f7170d1b7644eb441a9ca'],0,370,370,19380344,5,0,1,1,18005
d03662aedc5bb1ade5897cdc84f6cd340f13898d,1,Jayush Luniya,2014-12-17 10:01:22-08:00,['b0cb8edae40b61cc301bb68bdabcb37d5c4bff5c'],45,234,279,19380623,12,0.571428571,1,1,18009
7f3b8e9f66d6eb3dba88c31c3f9561db6ea18c24,1,Nate Cole,2014-12-17 13:57:32-05:00,['d03662aedc5bb1ade5897cdc84f6cd340f13898d'],101,201,302,19380925,6,0.49122807,1,0.754385965,18009
75cdb28b8011648d9946802ba49eb09597ac5ef5,0,Lisnichenko Dmitro,2014-12-17 21:41:25+02:00,['7f3b8e9f66d6eb3dba88c31c3f9561db6ea18c24'],16,16,32,19380957,15,,,,18009
17b71553d05cfdca9fd047bfd467f621edc284e1,1,Jayush Luniya,2014-12-17 11:57:09-08:00,['75cdb28b8011648d9946802ba49eb09597ac5ef5'],418,631,1049,19382006,76,0,1,0.620967742,18011
b4cd4cb71ffe406d1d75824ea29880e9f824ae20,1,Jayush Luniya,2014-12-17 11:58:43-08:00,['17b71553d05cfdca9fd047bfd467f621edc284e1'],343,522,865,19382871,85,0,1,0.843373494,18014
46e9bcb845ee32186744536b3b77b735c4363631,1,Jayush Luniya,2014-12-17 11:59:50-08:00,['b4cd4cb71ffe406d1d75824ea29880e9f824ae20'],512,4885,5397,19388268,86,0,1,0.901960784,18028
191232e290f0a3e9b0f3ac7e737cd374858d0941,1,Jayush Luniya,2014-12-17 12:00:52-08:00,['46e9bcb845ee32186744536b3b77b735c4363631'],144,220,364,19388632,22,0,1,1,18030
ef341466e49d8f7f2cc144bb63416fb25a77f6d3,1,John Speidel,2014-12-17 15:08:43-05:00,['191232e290f0a3e9b0f3ac7e737cd374858d0941'],68,1828,1896,19390528,12,0.141695703,0.454123113,0.5029036,18033
6355c79a46b78dcd02734df32560392af756548c,1,Siddharth Wagle,2014-12-17 12:11:25-08:00,['ef341466e49d8f7f2cc144bb63416fb25a77f6d3'],128,476,604,19391132,14,0.131868132,0.532967033,0.565934066,18034
0dcbcc1ba1140bba71cc95dcd93305c125aa4085,1,Alex Antonenko,2014-12-17 22:17:19+02:00,['6355c79a46b78dcd02734df32560392af756548c'],1,2,3,19391135,1,1,1,1,18034
cd3fb17f4d770fb354c76f0eb1df738aa66848d5,1,Siddharth Wagle,2014-12-17 12:53:50-08:00,['0dcbcc1ba1140bba71cc95dcd93305c125aa4085'],54,303,357,19391492,2,0.169117647,1,0.926470588,18035
24493d3cf122db8d5b1ed3fb96c09c4a4609827d,1,Siddharth Wagle,2014-12-17 14:20:26-08:00,['cd3fb17f4d770fb354c76f0eb1df738aa66848d5'],2,18,20,19391512,1,,,,18035
6f948db83274abd72d0099fe0a65d3b9441b896a,1,Siddharth Wagle,2014-12-17 15:30:49-08:00,['24493d3cf122db8d5b1ed3fb96c09c4a4609827d'],3,5,8,19391520,1,0,1,0,18035
2b09328fa3ea304271e4db145268494c81ef0abd,1,Yusaku Sako,2014-12-17 16:56:19-08:00,['6f948db83274abd72d0099fe0a65d3b9441b896a'],13,39,52,19391572,6,0.857142857,1,0.857142857,18035
b950cea20a04a895c5fcfd5dcc9d7b828f7a8437,1,John Speidel,2014-12-17 19:59:14-05:00,['2b09328fa3ea304271e4db145268494c81ef0abd'],55,81,136,19391708,4,0,0.941176471,1,18035
19f25115090fd6b7e8e6bec6d85555f606decc37,1,Yusaku Sako,2014-12-17 17:13:52-08:00,['b950cea20a04a895c5fcfd5dcc9d7b828f7a8437'],86,170,256,19391964,8,1,1,0.222222222,18035
4d4fc0cbb5929655080ba79604244a7a0eba862c,1,Jaimin Jetly,2014-12-17 17:50:20-08:00,['19f25115090fd6b7e8e6bec6d85555f606decc37'],7,294,301,19392265,8,,,,18039
40aa66f548c5387ed08f867ca84bdb477c90b9ad,1,Siddharth Wagle,2014-12-17 18:29:50-08:00,['4d4fc0cbb5929655080ba79604244a7a0eba862c'],600,840,1440,19393705,22,,,,18044
e80f7aa4a8ffe5959d0ab1d91376b974eac048b4,0,Siddharth Wagle,2014-12-17 19:43:30-08:00,['40aa66f548c5387ed08f867ca84bdb477c90b9ad'],0,16,16,19393721,1,,,,18044
4719d472451649c594bdb0ff74e158a4f9d69ad4,1,Jonathan Hurley,2014-12-17 23:11:45-05:00,['e80f7aa4a8ffe5959d0ab1d91376b974eac048b4'],0,1,1,19393722,1,,,,18044
737b0e5ade072bb8d0a416ed174c7f15f3d77c8a,1,aBabiichuk,2014-12-18 12:08:27+02:00,['4719d472451649c594bdb0ff74e158a4f9d69ad4'],15,217,232,19393954,6,0.125,1,1,18044
18e831deabcf66007be72e69eac2c77b16ccd4c2,1,Oleg Nechiporenko,2014-12-18 12:25:01+02:00,['737b0e5ade072bb8d0a416ed174c7f15f3d77c8a'],15,130,145,19394099,5,0,1,0,18044
95fe4b028ea7a3176a24315cd417b4147d31ff21,1,tbeerbower,2014-12-18 05:35:43-05:00,['18e831deabcf66007be72e69eac2c77b16ccd4c2'],20,118,138,19394237,3,0.933333333,0.933333333,0.7,18045
556f1249a266175a85da26e5bdc3763d55cf1576,1,Andrii Tkach,2014-12-18 13:43:57+02:00,['95fe4b028ea7a3176a24315cd417b4147d31ff21'],5,6,11,19394248,1,1,1,1,18045
cd171c7d5331460ffc8b7257206f19e4c1e58fe9,1,Oleg Nechiporenko,2014-12-18 14:42:33+02:00,['556f1249a266175a85da26e5bdc3763d55cf1576'],9,43,52,19394300,4,1,1,1,18045
19bb0bf4488dedc659bb43cbcca419e23fdb8a3e,1,Andrii Tkach,2014-12-18 15:55:18+02:00,['cd171c7d5331460ffc8b7257206f19e4c1e58fe9'],35,562,597,19394897,15,0.821176471,0.957647059,1,18050
259e56298a57b6f3ff170a7fe75e6e8b4745e03e,1,Nate Cole,2014-12-18 09:43:37-05:00,['19bb0bf4488dedc659bb43cbcca419e23fdb8a3e'],60,1643,1703,19396600,26,0.821428571,0.857142857,0.904761905,18052
8dba77e8b50b1189790c9000089fce160d4073a3,1,tbeerbower,2014-12-18 10:01:28-05:00,['259e56298a57b6f3ff170a7fe75e6e8b4745e03e'],4,10,14,19396614,3,0.5,1,0,18052
0a05a2f7db2870b81f7bc344b63f13030d240edb,1,Oleg Nechiporenko,2014-12-18 17:29:59+02:00,['8dba77e8b50b1189790c9000089fce160d4073a3'],1,9,10,19396624,1,,,,18052
aa3cc9402e903663632f5b9b27fc01b71dac5022,1,Oleg Nechiporenko,2014-12-18 17:46:15+02:00,['0a05a2f7db2870b81f7bc344b63f13030d240edb'],1,19,20,19396644,2,1,1,1,18052
0e91ecb834fa8ad3274aaaa01ad75cee7f5151a7,1,Aleksandr Kovalenko,2014-12-18 18:05:56+02:00,['aa3cc9402e903663632f5b9b27fc01b71dac5022'],7,17,24,19396668,2,1,1,1,18052
106590550000de1716a9216467325a0a940e50e2,0,Lisnichenko Dmitro,2014-12-18 20:41:16+02:00,['0e91ecb834fa8ad3274aaaa01ad75cee7f5151a7'],1891,2239,4130,19400798,5,1,0,1,18055
6703610ec30424ab66bafebbce8df0b5e7407537,1,Nate Cole,2014-12-18 13:48:12-05:00,['106590550000de1716a9216467325a0a940e50e2'],55,338,393,19401191,14,0.25,0.057692308,0.75,18058
c5b9cc3d0c9f53b0e5af6479aaaacff50e2ec4b8,1,Yusaku Sako,2014-12-18 11:09:21-08:00,['6703610ec30424ab66bafebbce8df0b5e7407537'],0,433,433,19401624,2,0.202764977,0.405529954,0.66359447,18060
d5d40d154c475a2f8167a4743a047de43fbe7c07,0,Yusaku Sako,2014-12-18 11:19:37-08:00,['c5b9cc3d0c9f53b0e5af6479aaaacff50e2ec4b8'],2239,1891,4130,19405754,5,0,1,0,18062
1073da759316eb13b4290558575e1603048e23eb,1,Jaimin Jetly,2014-12-18 11:33:41-08:00,['d5d40d154c475a2f8167a4743a047de43fbe7c07'],22,269,291,19406045,6,0.057553957,0.294964029,1,18063
68f9cb88e04a8b7c12e18f41762301dad81187a6,1,Nate Cole,2014-12-18 14:44:46-05:00,['1073da759316eb13b4290558575e1603048e23eb'],3,4,7,19406052,1,,,,18063
c2b9a1a72c434aceef7e905c86e85adf61f4cfd9,1,Lisnichenko Dmitro,2014-12-18 21:59:41+02:00,['68f9cb88e04a8b7c12e18f41762301dad81187a6'],1893,2257,4150,19410202,6,1,0,1,18066
02b034bea2af3ab4d85d4f9d5def249291929186,1,Jaimin Jetly,2014-12-18 13:21:49-08:00,['c2b9a1a72c434aceef7e905c86e85adf61f4cfd9'],65,103,168,19410370,3,0.269230769,1,1,18067
9f68828ebf1d52dcb44e8195d56ac5fb16d5a872,0,Siddharth Wagle,2014-12-18 13:37:46-08:00,['02b034bea2af3ab4d85d4f9d5def249291929186'],1,1,2,19410372,1,,,,18067
550563a1cb04a8f9a237998511949b2740dcaf36,1,Alejandro Fernandez,2014-12-18 14:18:10-08:00,['9f68828ebf1d52dcb44e8195d56ac5fb16d5a872'],84,279,363,19410735,14,0.037037037,0.111111111,0.851851852,18069
e9bbe6564612e3e74b7fc3590f2ab3076817bc45,1,Jaimin Jetly,2014-12-18 14:43:23-08:00,['550563a1cb04a8f9a237998511949b2740dcaf36'],7,7,14,19410749,3,,,,18069
1f8e6d83f8b9095b211b32490047b5e7417ab737,0,Lisnichenko Dmitro,2014-12-19 00:48:04+02:00,['e9bbe6564612e3e74b7fc3590f2ab3076817bc45'],0,67,67,19410816,2,0.351351351,0.972972973,0.972972973,18069
60c9f8c82c1715ada544d8ccbbba69db478e1a87,1,Jaimin Jetly,2014-12-18 14:49:04-08:00,['1f8e6d83f8b9095b211b32490047b5e7417ab737'],31,417,448,19411264,5,0.256,0.888,1,18069
105d073abc9e08bfd4d7ac749e75d95118d362a9,1,Siddharth Wagle,2014-12-18 14:54:43-08:00,['60c9f8c82c1715ada544d8ccbbba69db478e1a87'],65,96,161,19411425,2,0,1,1,18069
e075a2ec4f4daad6803a52987b90aa1068748731,0,Alejandro Fernandez,2014-12-18 15:17:40-08:00,['105d073abc9e08bfd4d7ac749e75d95118d362a9'],3,3,6,19411431,2,,,,18069
4b52b64d1d7337973c4a9f17afb89fe8bf86c3ed,0,Siddharth Wagle,2014-12-18 15:18:00-08:00,['e075a2ec4f4daad6803a52987b90aa1068748731'],9,20,29,19411460,1,,,,18069
438d6c244f3135635aada9cc46b88ba71fa42730,1,Jaimin Jetly,2014-12-18 15:30:32-08:00,['4b52b64d1d7337973c4a9f17afb89fe8bf86c3ed'],4,102,106,19411566,2,0.566666667,1,1,18069
912bf77966c741b4a817bde0836bd7726527a2b1,1,Jaimin Jetly,2014-12-18 15:49:12-08:00,['438d6c244f3135635aada9cc46b88ba71fa42730'],10,21,31,19411597,2,0,0,0,18069
814bf1d43b70f44f1089f2022ae522270c8683be,0,Yusaku Sako,2014-12-18 17:06:48-08:00,['912bf77966c741b4a817bde0836bd7726527a2b1'],2239,1891,4130,19415727,5,0,1,0,18071
c01fda4506f69e395053e9d097e4c039058dade8,1,Jayush Luniya,2014-12-18 19:23:45-08:00,['814bf1d43b70f44f1089f2022ae522270c8683be'],74,34,108,19415835,10,0.1875,0.625,0.5625,18071
9e22e173102f15c2cfb181262fbfa8d8711423d2,1,Bob Nettleton,2014-12-18 23:36:38-05:00,['c01fda4506f69e395053e9d097e4c039058dade8'],4,5,9,19415844,1,0,1,1,18071
ef7fe6b5cefa87042083deaa484bf7bd773b9ec7,1,Jayush Luniya,2014-12-18 21:26:54-08:00,['9e22e173102f15c2cfb181262fbfa8d8711423d2'],316,437,753,19416597,78,0,1,1,18075
dc534389a7fdf54cec2be3ad939ff59c1e33d636,0,Jayush Luniya,2014-12-18 21:31:43-08:00,['ef7fe6b5cefa87042083deaa484bf7bd773b9ec7'],349,551,900,19417497,63,0.194444444,1,1,18078
c3e76b0e7c38447f8a5997be87848f9e5a652185,1,Jaimin Jetly,2014-12-18 21:41:21-08:00,['dc534389a7fdf54cec2be3ad939ff59c1e33d636'],0,54,54,19417551,1,,,,18079
aaadb0a4f9a7c57bd9146909f863a29e99f32efc,1,Jaimin Jetly,2014-12-18 21:49:32-08:00,['c3e76b0e7c38447f8a5997be87848f9e5a652185'],52,69,121,19417672,2,0.02173913,0.152173913,0.130434783,18079
0564a1584e9c88243442d8b92db5483b8db97b66,0,Jayush Luniya,2014-12-18 22:12:56-08:00,['aaadb0a4f9a7c57bd9146909f863a29e99f32efc'],2,4,6,19417678,1,1,1,1,18079
7ecf19c044fcaf0b755f8967836eb60e6c6b176b,0,Jayush Luniya,2014-12-18 22:17:08-08:00,['0564a1584e9c88243442d8b92db5483b8db97b66'],4,2,6,19417684,1,0,0,0,18079
c0ed3fd0b4f8635e1e2d7e4ee17ec58bd257efda,0,Jayush Luniya,2014-12-18 22:18:30-08:00,['7ecf19c044fcaf0b755f8967836eb60e6c6b176b'],551,349,900,19418584,63,0.805555556,0,0,18079
bab3dbc84062ac5218b7197ea5356c14ea9e3612,1,Jayush Luniya,2014-12-18 22:21:30-08:00,['c0ed3fd0b4f8635e1e2d7e4ee17ec58bd257efda'],351,555,906,19419490,63,0.209090909,1,1,18082
f13beb866d227117d37271dc56e21d21d99f77b2,1,Andrii Tkach,2014-12-19 11:59:12+02:00,['bab3dbc84062ac5218b7197ea5356c14ea9e3612'],20,54,74,19419564,8,1,0.941176471,1,18082
91700e7828e1564809c291a3cd4ad16308c8a6f6,1,Lisnichenko Dmitro,2014-12-19 13:02:44+02:00,['f13beb866d227117d37271dc56e21d21d99f77b2'],8,69,77,19419641,6,0.294117647,0.970588235,1,18082
8b0e4f8782486d9f44dafa7e0d34a48d3d2aa9f5,1,Oleg Nechiporenko,2014-12-19 13:57:52+02:00,['91700e7828e1564809c291a3cd4ad16308c8a6f6'],175,336,511,19420152,15,0.588235294,0.588235294,0.588235294,18088
abf405522fe0844de11e97d31a005e49f9e00710,1,Lisnichenko Dmitro,2014-12-19 15:39:32+02:00,['8b0e4f8782486d9f44dafa7e0d34a48d3d2aa9f5'],1891,2241,4132,19424284,5,1,0,1,18091
3cd575b8667d2cd2db65f94e04c73e1a2a3f7065,1,Andrew Onishuk,2014-12-19 16:22:51+02:00,['abf405522fe0844de11e97d31a005e49f9e00710'],0,8,8,19424292,1,,,,18091
814594e524071da471c0d41a8a407e5f7eca96c1,1,tbeerbower,2014-12-19 10:57:05-05:00,['3cd575b8667d2cd2db65f94e04c73e1a2a3f7065'],105,162,267,19424559,4,1,1,1,18091
3a9fe940e98dd3bf91d1a2f4a6ebec41b9135d70,1,Lisnichenko Dmitro,2014-12-19 18:33:40+02:00,['814594e524071da471c0d41a8a407e5f7eca96c1'],7,8,15,19424574,1,,,,18091
418cc8d69866880ec508c98eb90e311322ae93d8,1,Oleg Nechiporenko,2014-12-19 18:44:47+02:00,['3a9fe940e98dd3bf91d1a2f4a6ebec41b9135d70'],12,49,61,19424635,2,0.457142857,1,1,18091
979f1949c63bc07ecd87432b821fa0b801df879c,1,Nate Cole,2014-12-19 11:48:20-05:00,['418cc8d69866880ec508c98eb90e311322ae93d8'],2,2501,2503,19427138,7,0,1,1,18094
72552aa6543643d0c2b05a1d464388cceb3f38b5,0,aBabiichuk,2014-12-19 18:57:28+02:00,['979f1949c63bc07ecd87432b821fa0b801df879c'],692,795,1487,19428625,27,1,1,1,18096
42ae84bbd01a67f4f82582986eaaadcea79302ff,1,Andrew Onishuk,2014-12-19 19:34:54+02:00,['72552aa6543643d0c2b05a1d464388cceb3f38b5'],29,73,102,19428727,6,1,1,1,18097
6734ea3de788f849416c88f2fba52d29a145caae,1,Andrew Onishuk,2014-12-19 19:35:45+02:00,['42ae84bbd01a67f4f82582986eaaadcea79302ff'],5,7,12,19428739,2,0.5,1,1,18097
405edb28951fce001cfedae92e119b0acfcada68,1,Andrew Onishuk,2014-12-19 19:58:52+02:00,['6734ea3de788f849416c88f2fba52d29a145caae'],52,50,102,19428841,4,,,,18097
85b89578580f9caf0b199cb863ee8b980aff2e0e,1,Alex Antonenko,2014-12-19 20:00:30+02:00,['405edb28951fce001cfedae92e119b0acfcada68'],18,38,56,19428897,5,1,1,1,18097
9caa2bbe80e86cb763003383b214f9312d7b5758,0,Alex Antonenko,2014-12-19 20:15:32+02:00,['85b89578580f9caf0b199cb863ee8b980aff2e0e'],7,3,10,19428907,4,,,,18097
a975766419827ac2a65c43575cc5256fac2221aa,1,Alex Antonenko,2014-12-19 20:25:28+02:00,['9caa2bbe80e86cb763003383b214f9312d7b5758'],9,10,19,19428926,2,1,1,1,18097
3d37d5323752075c4f57d387caa6cb3f77e6957f,1,Andrii Tkach,2014-12-19 20:28:50+02:00,['a975766419827ac2a65c43575cc5256fac2221aa'],274,1215,1489,19430415,7,0.866242038,1,1,18097
156b9b547db36813a3f30b6dc8d032f3f64be5c3,1,Siddharth Wagle,2014-12-19 10:40:11-08:00,['3d37d5323752075c4f57d387caa6cb3f77e6957f'],56,128,184,19430599,13,0.838709677,0.838709677,1,18097
bee937981cbc837af98af3d787fedef511a8d738,0,Siddharth Wagle,2014-12-19 11:03:43-08:00,['156b9b547db36813a3f30b6dc8d032f3f64be5c3'],2,2,4,19430603,1,,,,18097
2914d681dacc675a0a4a379fd20066cfd415e8b8,0,Florian Barca,2014-12-19 11:41:49-08:00,['bee937981cbc837af98af3d787fedef511a8d738'],5210,4149,9359,19439962,29,0.908955224,1,0,18097
dcab10878476a9f956ec4085f8d10224f8d8c9de,1,Vitaly Brodetskyi,2014-12-19 21:48:00+02:00,['2914d681dacc675a0a4a379fd20066cfd415e8b8'],168,240,408,19440370,19,0.409090909,0.590909091,1,18097
613bdd763d25aeb51fe71a8394d9412de256fa21,1,Alejandro Fernandez,2014-12-19 12:25:36-08:00,['dcab10878476a9f956ec4085f8d10224f8d8c9de'],14,41,55,19440425,3,,,,18097
fad56746f7a6181c883fa0b0ba8e58f137dfde52,1,Yusaku Sako,2014-12-19 13:51:22-08:00,['613bdd763d25aeb51fe71a8394d9412de256fa21'],4149,5210,9359,19449784,29,0.091044776,0,1,18101
181f3ab4dea07151aaded509ad55b55d0919f60b,1,Jonathan Hurley,2014-12-19 16:52:41-05:00,['fad56746f7a6181c883fa0b0ba8e58f137dfde52'],184,1370,1554,19451338,12,0.20754717,0.698113208,0.122641509,18103
43abcf0d767eb4d2ef46847dd6d75e7a9270ebff,1,Aleksandr Kovalenko,2014-12-20 00:26:47+02:00,['181f3ab4dea07151aaded509ad55b55d0919f60b'],10,47,57,19451395,4,1,1,1,18103
fa8c51e41990664db274643f8113c490dd5c17b4,1,Siddharth Wagle,2014-12-19 14:44:07-08:00,['43abcf0d767eb4d2ef46847dd6d75e7a9270ebff'],16,37,53,19451448,6,1,1,1,18103
f8a9bd90cb2a384e7bb5f6c4464657c49db67da3,0,Siddharth Wagle,2014-12-19 15:09:29-08:00,['fa8c51e41990664db274643f8113c490dd5c17b4'],4,4,8,19451456,1,,,,18103
9ba8138754a7caed5c765c2060393fe9ba24c46a,1,Jaimin Jetly,2014-12-19 15:17:27-08:00,['f8a9bd90cb2a384e7bb5f6c4464657c49db67da3'],55,59,114,19451570,2,1,1,1,18103
50819a309b64032a13add9ac2127a27a71ba6740,1,Yusaku Sako,2014-12-19 16:35:02-08:00,['9ba8138754a7caed5c765c2060393fe9ba24c46a'],1215,274,1489,19453059,7,0.133757962,0,0,18103
ecce96ad62a60f4ea79dabeb4749be02fae3ab65,0,Siddharth Wagle,2014-12-19 16:40:30-08:00,['50819a309b64032a13add9ac2127a27a71ba6740'],5,12,17,19453076,4,,,,18103
8f4ff3950e62ae3e6abb3dc9a60bd7d54d7d3b35,1,Alejandro Fernandez,2014-12-19 19:39:16-08:00,['ecce96ad62a60f4ea79dabeb4749be02fae3ab65'],48,49,97,19453173,24,,,,18103
dceb41f724ff22eb4d7867040426e05bec2bd73d,1,Yusaku Sako,2014-12-19 22:50:02-08:00,['8f4ff3950e62ae3e6abb3dc9a60bd7d54d7d3b35'],300,309,609,19453782,8,,,,18103
4800d6b37d83220308fa4ab5301047756617a0f2,1,Jayush Luniya,2014-12-20 00:57:43-08:00,['dceb41f724ff22eb4d7867040426e05bec2bd73d'],1,1516,1517,19455299,29,0.453731343,0.686567164,0.937313433,18130
615a62b0158c6f2bded80036776c48d95bc6af01,1,Yusaku Sako,2014-12-20 02:56:10-08:00,['4800d6b37d83220308fa4ab5301047756617a0f2'],1,1,2,19455301,1,,,,18130
4cf2b173d24a4fb5ab453f728cd29cacd77ef748,0,Vitaly Brodetskyi,2014-12-22 13:18:27+02:00,['615a62b0158c6f2bded80036776c48d95bc6af01'],0,36,36,19455337,1,,,,18130
7924fce7f06b2ae0c79d790d59817d8cb70f936f,1,Andrii Tkach,2014-12-22 14:39:26+02:00,['4cf2b173d24a4fb5ab453f728cd29cacd77ef748'],1,1,2,19455339,1,,,,18130
84d642fb1d65eb27b4cd72835a4f433c4de16561,0,Oleg Nechiporenko,2014-12-22 15:44:34+02:00,['7924fce7f06b2ae0c79d790d59817d8cb70f936f'],2,69,71,19455410,3,1,1,1,18131
90e6159b32f2f0982a2c353f4435af5004b4f1c1,1,Andrew Onishuk,2014-12-22 16:04:57+02:00,['84d642fb1d65eb27b4cd72835a4f433c4de16561'],80,96,176,19455586,18,0.5,0.5,0.5,18131
78768d9428da43a61f86b78e6167381270ec5c04,1,Andrii Tkach,2014-12-22 16:26:39+02:00,['90e6159b32f2f0982a2c353f4435af5004b4f1c1'],271,1222,1493,19457079,7,0.86825596,1,1,18131
9715bc9ffaa8f6e2a1669ebe90cc7f2eda529d7c,1,Andrew Onishuk,2014-12-22 17:52:57+02:00,['78768d9428da43a61f86b78e6167381270ec5c04'],39,38,77,19457156,20,,,,18131
6bc7c69ebb8242ce9caf2f05b5e22711c6236270,1,Andrii Tkach,2014-12-22 18:03:03+02:00,['9715bc9ffaa8f6e2a1669ebe90cc7f2eda529d7c'],5,11,16,19457172,2,1,1,1,18131
afbbf51ecd86eb15d93c0efe9dfd73f6ef13dd97,1,Vitaly Brodetskyi,2014-12-22 18:50:05+02:00,['6bc7c69ebb8242ce9caf2f05b5e22711c6236270'],74,34,108,19457280,9,1,0,0,18131
4f919d2c17a1ceccaa1136c3d2b444d384853b7c,1,Nate Cole,2014-12-22 12:16:59-05:00,['afbbf51ecd86eb15d93c0efe9dfd73f6ef13dd97'],4,120,124,19457404,4,0,1,1,18132
4320de6eeffda783e1c6592d80bf11f6fbfff31b,1,Bob Nettleton,2014-12-22 12:32:09-05:00,['4f919d2c17a1ceccaa1136c3d2b444d384853b7c'],7,2138,2145,19459549,11,0.028346457,0.878740157,0.948031496,18134
8bb5cafba4d54fdaad86a24dc4c4e6694f19a3fa,0,Vitaly Brodetskyi,2014-12-22 20:17:40+02:00,['4320de6eeffda783e1c6592d80bf11f6fbfff31b'],1,1,2,19459551,1,,,,18134
2c33f87625d1918c765dcc6aaefc772532a23b24,1,Alex Antonenko,2014-12-22 20:48:19+02:00,['8bb5cafba4d54fdaad86a24dc4c4e6694f19a3fa'],244,4735,4979,19464530,42,0.469993477,0.561969993,0.853555121,18147
623d2f2cf4d94da72d5c28e074ca312f75bbd51f,1,Alex Antonenko,2014-12-22 20:48:20+02:00,['2c33f87625d1918c765dcc6aaefc772532a23b24'],1,1,2,19464532,1,,,,18147
c11100587d8d3334320836acbe53eddb9ee9d317,1,Jaimin Jetly,2014-12-22 11:11:10-08:00,['623d2f2cf4d94da72d5c28e074ca312f75bbd51f'],52,67,119,19464651,6,0.066666667,0.8,0,18147
f9014f604e0ae60ee93d8c4cc4805573063bb095,1,Jaimin Jetly,2014-12-22 11:43:49-08:00,['c11100587d8d3334320836acbe53eddb9ee9d317'],2,8,10,19464661,2,0,0.6,0.6,18147
4bab98c9e84ee3af6e7b7d6115d50dfaba276820,1,Jonathan Hurley,2014-12-22 15:43:50-05:00,['f9014f604e0ae60ee93d8c4cc4805573063bb095'],5,9,14,19464675,1,0,0,1,18147
57490ffa6a93184fa7dc65bc2104cbd0e93b78d1,0,Siddharth Wagle,2014-12-22 12:45:12-08:00,['4bab98c9e84ee3af6e7b7d6115d50dfaba276820'],0,9,9,19464684,1,,,,18147
ff4c6c114b626b7164c6160f677e459fdcbaf1e6,0,Siddharth Wagle,2014-12-22 12:57:02-08:00,['57490ffa6a93184fa7dc65bc2104cbd0e93b78d1'],1,1,2,19464686,1,,,,18147
e6cdb06bc7cd6d7ff010592c20e49de0a0f5b855,1,Siddharth Wagle,2014-12-22 13:53:30-08:00,['ff4c6c114b626b7164c6160f677e459fdcbaf1e6'],50,375,425,19465111,8,,,,18150
c40a9dec23e73b47d9c13cdca60468d20d7cac99,1,Jaimin Jetly,2014-12-22 15:05:35-08:00,['e6cdb06bc7cd6d7ff010592c20e49de0a0f5b855'],81,104,185,19465296,3,0.928571429,0.857142857,1,18150
03463912a95bdddab9c78a120b1de75b34c03395,1,John Speidel,2014-12-22 18:19:53-05:00,['c40a9dec23e73b47d9c13cdca60468d20d7cac99'],6,12,18,19465314,1,0,0,0,18150
fa74434baffdaf01fa6cfbbd2f42860027aeac62,0,Siddharth Wagle,2014-12-22 15:31:10-08:00,['03463912a95bdddab9c78a120b1de75b34c03395'],8,0,8,19465322,1,,,,18150
f0f889cecd53108fe7a150ddecf4226ece1ec7a1,0,Siddharth Wagle,2014-12-22 16:14:28-08:00,['fa74434baffdaf01fa6cfbbd2f42860027aeac62'],0,1,1,19465323,1,,,,18150
f582b59a920e309f607b92e03eda1a56e783943e,1,Yusaku Sako,2014-12-22 16:16:06-08:00,['f0f889cecd53108fe7a150ddecf4226ece1ec7a1'],0,3,3,19465326,1,,,,18150
cb95f1c6004b1ea5a0fa430bfc8069b676914f13,1,Yusaku Sako,2014-12-22 16:19:20-08:00,['f582b59a920e309f607b92e03eda1a56e783943e'],3,60,63,19465389,3,0.975609756,1,0.975609756,18151
6801758fff3230d218ff46df36d6357a94e1dc18,0,Jaimin Jetly,2014-12-22 16:58:22-08:00,['cb95f1c6004b1ea5a0fa430bfc8069b676914f13'],2,2,4,19465393,1,,,,18151
9bf9034a5c2481a8b40befab8c3713dcd3b6f584,1,Siddharth Wagle,2014-12-22 17:07:17-08:00,['6801758fff3230d218ff46df36d6357a94e1dc18'],341,833,1174,19466567,10,0.381656805,0.893491124,0.857988166,18151
6a39f2b37e157d9d35fc10efb0cd5b66d05b69d9,1,Yusaku Sako,2014-12-22 17:08:53-08:00,['9bf9034a5c2481a8b40befab8c3713dcd3b6f584'],21,36,57,19466624,4,1,1,1,18151
72e56dc6dd20464c2ddf1ee9b6c81e863a466401,1,Yusaku Sako,2014-12-22 17:10:54-08:00,['6a39f2b37e157d9d35fc10efb0cd5b66d05b69d9'],64,197,261,19466885,16,0.91011236,0.91011236,1,18151
63d65a4f3ff79af99705184023cfae384cbaa982,0,Yusaku Sako,2014-12-22 17:47:53-08:00,['72e56dc6dd20464c2ddf1ee9b6c81e863a466401'],2,2,4,19466889,1,,,,18151
511f64d762e0ed09499e794c29ae28a5222703fd,1,Yusaku Sako,2014-12-22 17:49:31-08:00,['63d65a4f3ff79af99705184023cfae384cbaa982'],3,3,6,19466895,3,1,1,1,18151
4e6597059a337f130580b4d804c590e8b050b9e9,1,Jayush Luniya,2014-12-22 23:59:39-08:00,['511f64d762e0ed09499e794c29ae28a5222703fd'],97,221,318,19467213,20,0.5,1,0.5,18152
a1e9cde502588cba86f90135d8d342ec0140234d,1,Oleg Nechiporenko,2014-12-23 12:25:05+02:00,['4e6597059a337f130580b4d804c590e8b050b9e9'],1081,1317,2398,19469611,17,0,0.5,1,18159
ad9e72027024f15943d37a0d0743f50da1016a80,1,Andrew Onishuk,2014-12-23 14:10:25+02:00,['a1e9cde502588cba86f90135d8d342ec0140234d'],0,535,535,19470146,5,0.613259669,0.552486188,0.718232044,18164
2ec55887c04955cedab7da8d384e04221c7f073d,0,aBabiichuk,2014-12-23 14:39:28+02:00,['ad9e72027024f15943d37a0d0743f50da1016a80'],81,246,327,19470473,13,1,1,1,18164
85ff51496d555bdac09198523a9860b20be31c35,0,tbeerbower,2014-12-23 07:54:49-05:00,['2ec55887c04955cedab7da8d384e04221c7f073d'],176,356,532,19471005,32,0.227848101,0.898734177,0,18164
e94d9403b6ef8c6f90fbbfda79d66ffa7f8f4034,1,Andrew Onishuk,2014-12-23 15:37:41+02:00,['85ff51496d555bdac09198523a9860b20be31c35'],1,1,2,19471007,1,,,,18164
3029048b54ca3eed92ec2c60f288dd2105bc63d3,0,Vitaly Brodetskyi,2014-12-23 16:06:42+02:00,['e94d9403b6ef8c6f90fbbfda79d66ffa7f8f4034'],11,8,19,19471026,5,0,0,0,18164
5704491c269f61cbe29ac329425adde51dfdeb67,1,aBabiichuk,2014-12-23 16:32:16+02:00,['3029048b54ca3eed92ec2c60f288dd2105bc63d3'],46,283,329,19471355,7,0.491891892,0.864864865,1,18164
8cf3fa11b8e325fb1fe323f210136591724119ce,1,Oleg Nechiporenko,2014-12-23 16:45:06+02:00,['5704491c269f61cbe29ac329425adde51dfdeb67'],241,417,658,19472013,4,0.4,1,1,18165
9842b40d2b2cd6c80cbdfc0086f3529a94c423b3,1,Lisnichenko Dmitro,2014-12-23 16:59:57+02:00,['8cf3fa11b8e325fb1fe323f210136591724119ce'],12,12,24,19472037,2,1,0,1,18165
fa763504b3a240d9d864f5c3f2ac8c13f3c47328,1,aBabiichuk,2014-12-23 17:31:56+02:00,['9842b40d2b2cd6c80cbdfc0086f3529a94c423b3'],41,43,84,19472121,5,1,1,1,18165
ef3da6d483d1f18fcd2853d47c2cd1a1bfd83e5f,1,John Speidel,2014-12-23 10:58:15-05:00,['fa763504b3a240d9d864f5c3f2ac8c13f3c47328'],270,321,591,19472712,8,1,0,0,18165
5df4636fb7bc6956d45aafacd375948110da62d6,1,Oleg Nechiporenko,2014-12-23 18:00:52+02:00,['ef3da6d483d1f18fcd2853d47c2cd1a1bfd83e5f'],505,804,1309,19474021,7,0.673076923,1,0.692307692,18165
c5cb5a16bd0cf6abb0a335c86d2987f2e7a99398,1,Aleksandr Kovalenko,2014-12-23 19:56:58+02:00,['5df4636fb7bc6956d45aafacd375948110da62d6'],2,65,67,19474088,8,1,1,0.9,18165
3603ce63fcf3c8c3e31b893790dd029803d7cf26,1,Jonathan Hurley,2014-12-23 13:32:24-05:00,['c5cb5a16bd0cf6abb0a335c86d2987f2e7a99398'],1,713,714,19474802,4,0.294252874,1,0.988505747,18167
7efe39526e27aa8ffcb32684b546109e4c2d1e02,1,Alex Antonenko,2014-12-23 20:35:19+02:00,['3603ce63fcf3c8c3e31b893790dd029803d7cf26'],0,1,1,19474803,1,0,1,1,18167
781deba167a6bd81791cf5ea4dcb5815cc5434d0,1,Alex Antonenko,2014-12-23 20:41:27+02:00,['7efe39526e27aa8ffcb32684b546109e4c2d1e02'],1,2,3,19474806,2,,,,18167
895b1adc0dd284cb6a81b959042b1960a3070693,1,Aleksandr Kovalenko,2014-12-23 21:28:47+02:00,['781deba167a6bd81791cf5ea4dcb5815cc5434d0'],22,22,44,19474850,2,,,,18167
0c1c14b765ab73a634a231e64ef511d2731c92ce,0,Siddharth Wagle,2014-12-23 12:50:28-08:00,['895b1adc0dd284cb6a81b959042b1960a3070693'],6,8,14,19474864,3,1,1,1,18167
1e393e6fc67c2b6a18d5c1a3889cdb490eefc53a,0,Jaimin Jetly,2014-12-23 12:56:40-08:00,['0c1c14b765ab73a634a231e64ef511d2731c92ce'],8,14,22,19474886,1,,,,18167
3f1d3dfac12e6d870c60d583af7ba1bdeb54a546,1,Jaimin Jetly,2014-12-23 13:15:52-08:00,['1e393e6fc67c2b6a18d5c1a3889cdb490eefc53a'],19,804,823,19475709,9,0.093203883,0.359223301,0.803883495,18169
70f1170b037ca0a9ac1cc175db8f957de50d5055,0,Siddharth Wagle,2014-12-23 14:36:02-08:00,['3f1d3dfac12e6d870c60d583af7ba1bdeb54a546'],2,2,4,19475713,1,,,,18169
102b47736e9f721baa6bac434cd58bfeaf105aff,1,Siddharth Wagle,2014-12-23 14:43:58-08:00,['70f1170b037ca0a9ac1cc175db8f957de50d5055'],833,341,1174,19476887,10,0.618343195,0.106508876,0.142011834,18169
1ea1577c9bfbcde45b6ddd315e4032950efb7342,1,Myroslav Papirkovskyy,2014-12-19 06:41:20+02:00,['102b47736e9f721baa6bac434cd58bfeaf105aff'],1,34,35,19476922,1,,,,18169
600f1afcd9f2f4f70c20e005a0f6b748214e15c8,0,Mahadev Konar,2014-12-23 16:09:24-08:00,['1ea1577c9bfbcde45b6ddd315e4032950efb7342'],356,176,532,19477454,32,0.772151899,0.101265823,1,18169
0ccded80fd88cd69b77682b0d87b08d4de151a36,1,Yusaku Sako,2014-12-23 16:39:24-08:00,['600f1afcd9f2f4f70c20e005a0f6b748214e15c8'],42,88,130,19477584,5,1,1,1,18169
568a1385fd887d20b714545c6c7eb25646b7a35f,1,Jaimin Jetly,2014-12-23 16:55:24-08:00,['0ccded80fd88cd69b77682b0d87b08d4de151a36'],2,2,4,19477588,1,,,,18169
c1c980525b46c62e43501f23e8acc3a7b49fa575,1,Jaimin Jetly,2014-12-23 17:52:46-08:00,['568a1385fd887d20b714545c6c7eb25646b7a35f'],4,24,28,19477616,3,1,1,1,18169
bf3d2857f25914b49cd20b85378c5fda92b4189f,0,Siddharth Wagle,2014-12-23 20:19:50-08:00,['c1c980525b46c62e43501f23e8acc3a7b49fa575'],1,1,2,19477618,1,,,,18169
bbb346667a80af773f8b9d2b10c6d53d01d024d2,0,Oleg Nechiporenko,2014-12-24 13:51:42+02:00,['bf3d2857f25914b49cd20b85378c5fda92b4189f'],49,54,103,19477721,2,0,1,1,18169
14c614fb99726dde426792662f5777e2c1d276f4,1,Aleksandr Kovalenko,2014-12-24 15:40:24+02:00,['bbb346667a80af773f8b9d2b10c6d53d01d024d2'],110,37,147,19477868,7,0.921052632,0.921052632,0,18169
f93c6031ae3e6fc69c321088d43cff73978a4202,1,Vitaly Brodetskyi,2014-12-24 15:54:51+02:00,['14c614fb99726dde426792662f5777e2c1d276f4'],8,15,23,19477891,3,0,1,1,18169
3eb7ebda189c627173e0e1e61d606847c5b588c2,1,aBabiichuk,2014-12-24 19:39:26+02:00,['f93c6031ae3e6fc69c321088d43cff73978a4202'],51,176,227,19478118,3,0.802325581,1,1,18169
edce91c3e59177c465420675b56f8c178326686e,0,Lisnichenko Dmitro,2014-12-24 21:29:43+02:00,['3eb7ebda189c627173e0e1e61d606847c5b588c2'],20,20,40,19478158,1,,,,18169
4dd3bcb47140b333c7bd92d36418ab333eb6d04d,0,Lisnichenko Dmitro,2014-12-24 22:48:22+02:00,['edce91c3e59177c465420675b56f8c178326686e'],1,1,2,19478160,2,,,,18169
8413cb3e9db08a1a5ad5483e118451eebf236d6a,1,Oleg Nechiporenko,2014-12-25 14:59:55+02:00,['4dd3bcb47140b333c7bd92d36418ab333eb6d04d'],17,121,138,19478298,4,0.426829268,1,1,18170
ea1c9f1ac4747575b18fd561cbce77f518daf190,1,Aleksandr Kovalenko,2014-12-25 16:04:12+02:00,['8413cb3e9db08a1a5ad5483e118451eebf236d6a'],30,85,115,19478413,11,0.357142857,1,1,18170
79cffa16dcf08a5baddbc861cf0212449deb5956,1,Andrew Onishuk,2014-12-25 16:18:28+02:00,['ea1c9f1ac4747575b18fd561cbce77f518daf190'],184,222,406,19478819,21,1,1,0,18170
ec37c603c92969251f6c89318d403452f555b7ba,1,Andrew Onishuk,2014-12-25 16:28:34+02:00,['79cffa16dcf08a5baddbc861cf0212449deb5956'],201,220,421,19479240,25,0.428571429,0.428571429,0.928571429,18172
3ae9a5c4f804706d6b86df4e5353f9415e0efc6d,1,aBabiichuk,2014-12-25 17:08:11+02:00,['ec37c603c92969251f6c89318d403452f555b7ba'],30185,98,30283,19509523,124,0.400460299,0.100115075,0.024165708,18172
bf9a825fe1f5e8a505024fc99faafeaa780bf287,1,aBabiichuk,2014-12-25 17:21:42+02:00,['3ae9a5c4f804706d6b86df4e5353f9415e0efc6d'],52,262,314,19509837,15,0.322033898,1,0.93220339,18172
e8d6672ce24177554754f8f7a520e1918cef8dc6,1,Andrew Onishuk,2014-12-25 17:52:56+02:00,['bf9a825fe1f5e8a505024fc99faafeaa780bf287'],17,58,75,19509912,4,0,0.685714286,0.685714286,18172
942ad74ead4593e85e95b572e861a6b3d94b86a9,1,Oleg Nechiporenko,2014-12-26 14:17:49+02:00,['e8d6672ce24177554754f8f7a520e1918cef8dc6'],4,4,8,19509920,2,,,,18172
bd3a0bb72c17dec825cbb71324836d381ceafb6b,1,aBabiichuk,2014-12-26 15:05:29+02:00,['942ad74ead4593e85e95b572e861a6b3d94b86a9'],7346,100,7446,19517366,124,0.486123545,0.368845121,0,18172
df1fc174952a4d72073b6ed2c5541050bb1edeaf,0,Vitaly Brodetskyi,2014-12-26 16:10:01+02:00,['bd3a0bb72c17dec825cbb71324836d381ceafb6b'],1,2,3,19517369,1,,,,18172
24ac933325b7a48ee8ff5de93cb0301a1286463a,1,Andrew Onishuk,2014-12-26 17:32:07+02:00,['df1fc174952a4d72073b6ed2c5541050bb1edeaf'],112,161,273,19517642,20,1,1,0,18172
0f8bdd7c97266cc762e2e85b6fa4f9d1781f94c1,1,Lisnichenko Dmitro,2014-12-26 18:43:04+02:00,['24ac933325b7a48ee8ff5de93cb0301a1286463a'],0,101,101,19517743,3,0.5,0.657894737,0.710526316,18172
08d73372ef0e4e01e320afcc0bdf0624468263ee,0,aBabiichuk,2014-12-26 18:50:32+02:00,['0f8bdd7c97266cc762e2e85b6fa4f9d1781f94c1'],13,32,45,19517788,6,1,1,1,18172
5659711cfd800aaacab619fae55d94a00cd0cd3a,0,aBabiichuk,2014-12-26 19:30:53+02:00,['08d73372ef0e4e01e320afcc0bdf0624468263ee'],31,15,46,19517834,4,0.666666667,0.181818182,0,18172
5e35865ed4f477d6a89bb87ef58e329c3c2a1334,1,Myroslav Papirkovskyy,2014-12-26 20:05:51+02:00,['5659711cfd800aaacab619fae55d94a00cd0cd3a'],125,57,182,19518016,7,,,,18172
0d325da335201df2156238744a90e66fe3737361,1,Alex Antonenko,2014-12-26 20:37:46+02:00,['5e35865ed4f477d6a89bb87ef58e329c3c2a1334'],77,226,303,19518319,26,1,1,1,18172
737fd1712d39852d909a5b384bdfea2795c9ee12,1,Andrew Onishuk,2014-12-26 21:17:56+02:00,['0d325da335201df2156238744a90e66fe3737361'],0,2,2,19518321,1,,,,18172
a66df38533fa93fa3b97d9581b051ae8ef28863e,0,Alex Antonenko,2014-12-26 21:30:32+02:00,['737fd1712d39852d909a5b384bdfea2795c9ee12'],0,2,2,19518323,1,,,,18172
9c73f2cbba3e0d0cb6a6f9e8e94ef6c830afcbf4,1,Bob Nettleton,2014-12-28 20:57:32-05:00,['a66df38533fa93fa3b97d9581b051ae8ef28863e'],1,10,11,19518334,1,0,0,1,18172
4af27666afb0892a8403302ac95333393c026aeb,1,Jonathan Hurley,2014-12-29 00:19:19-05:00,['9c73f2cbba3e0d0cb6a6f9e8e94ef6c830afcbf4'],7,1307,1314,19519648,7,0.28,0.733333333,0.626666667,18174
b7dc5dce9009f9ec718fdc950c660d9f311a4412,0,aBabiichuk,2014-12-29 14:48:45+02:00,['4af27666afb0892a8403302ac95333393c026aeb'],34,30,64,19519712,1,1,0,0,18174
df9e096f1731d1b0fb3c53e5f306101191f8195c,1,Andrew Onishuk,2014-12-29 15:39:48+02:00,['b7dc5dce9009f9ec718fdc950c660d9f311a4412'],1613,1668,3281,19522993,66,1,0.87804878,0,18179
1652163e873a3015e841665c22fcbb45e092708e,1,Andrew Onishuk,2014-12-29 16:24:38+02:00,['df9e096f1731d1b0fb3c53e5f306101191f8195c'],4,10,14,19523007,1,0,1,1,18179
a0ea540ceb628bd7f73c86faa8797e61b8f9f834,1,Andrew Onishuk,2014-12-29 16:35:39+02:00,['1652163e873a3015e841665c22fcbb45e092708e'],7,6,13,19523020,1,,,,18179
dc097d18d458bcdaab7de77af3f2ccffe81e86b1,1,Andrew Onishuk,2014-12-29 18:23:14+02:00,['a0ea540ceb628bd7f73c86faa8797e61b8f9f834'],3,53,56,19523076,5,0.333333333,0.333333333,1,18179
9d31c3ce544c8acad14da31086843b4e84e31127,1,Aleksandr Kovalenko,2014-12-29 19:05:24+02:00,['dc097d18d458bcdaab7de77af3f2ccffe81e86b1'],1,42,43,19523119,3,1,1,1,18179
6271c9c41f1a2b49bb6472d3eb86f23c14d714ee,1,Vitaly Brodetskyi,2014-12-29 21:00:09+02:00,['9d31c3ce544c8acad14da31086843b4e84e31127'],58,58,116,19523235,12,1,0.071428571,0,18179
e7303b1ce6605c2986d0a0cf93340ef8ffe1e73b,1,Lisnichenko Dmitro,2014-12-29 21:01:24+02:00,['6271c9c41f1a2b49bb6472d3eb86f23c14d714ee'],176,356,532,19523767,32,0.227848101,0.898734177,0,18179
19e972cf98423200bf30518803f066669f2dcd2a,0,Florian Barca,2014-12-29 12:40:40-08:00,['e7303b1ce6605c2986d0a0cf93340ef8ffe1e73b'],105,2210,2315,19526082,35,0.571614583,0.634114583,0.78515625,18199
cbbd413c9d11449fdc87cb664931272da225003b,0,Siddharth Wagle,2014-12-29 14:31:04-08:00,['19e972cf98423200bf30518803f066669f2dcd2a'],27,15,42,19526124,3,0,0,0,18199
1395c8b8c13255422155305d0370763200082149,1,Siddharth Wagle,2014-12-29 14:56:12-08:00,['cbbd413c9d11449fdc87cb664931272da225003b'],0,6,6,19526130,1,,,,18199
0b77b43e9ad0c7af900d8ad628bccb940ec3d7e4,0,Alex Antonenko,2014-12-30 01:44:05+02:00,['1395c8b8c13255422155305d0370763200082149'],6,0,6,19526136,1,0,0,0,18199
9401a4937c58b90c889a93f37e5061d5e25e5d9f,1,Alex Antonenko,2014-12-30 01:44:06+02:00,['0b77b43e9ad0c7af900d8ad628bccb940ec3d7e4'],32,132,164,19526300,15,0.537313433,0.925373134,0.895522388,18199
dc8355c64bd0469b1a836b87b70351f4d415701c,1,Jonathan Hurley,2014-12-29 19:48:15-05:00,['9401a4937c58b90c889a93f37e5061d5e25e5d9f'],85,191,276,19526576,14,0.102040816,0,1,18199
ab8c0e350fded50f32edbe23e2a14376caebbbfc,0,Siddharth Wagle,2014-12-29 19:11:02-08:00,['dc8355c64bd0469b1a836b87b70351f4d415701c'],2210,105,2315,19528891,35,0.428385417,0.365885417,0.21484375,18199
6c687711c1f2358f41e58eea2a052df5884b3bcc,1,Lisnichenko Dmitro,2014-12-30 11:54:06+02:00,['ab8c0e350fded50f32edbe23e2a14376caebbbfc'],28,527,555,19529446,12,0.22295082,0.642622951,0.875409836,18200
d9db1db3d6e7188550a69bdcb63123f3627e7ace,0,aBabiichuk,2014-12-30 12:23:09+02:00,['6c687711c1f2358f41e58eea2a052df5884b3bcc'],7,5,12,19529458,3,1,1,1,18200
10a9c63e8a8ddc9dd9ff8cf2fc22960874b3d320,0,Andrew Onishuk,2014-12-30 13:31:44+02:00,['d9db1db3d6e7188550a69bdcb63123f3627e7ace'],1,1,2,19529460,1,,,,18200
d40a2e5f1b8256aa2c510c3535cb5f95bbf90df9,1,Alex Antonenko,2014-12-30 13:50:54+02:00,['10a9c63e8a8ddc9dd9ff8cf2fc22960874b3d320'],25,102,127,19529587,9,0.692307692,0.692307692,0.051282051,18201
e8e1e340216689a8dd6056f49bbb35fb9fd00f69,1,Aleksandr Kovalenko,2014-12-30 16:49:21+02:00,['d40a2e5f1b8256aa2c510c3535cb5f95bbf90df9'],16,27,43,19529630,3,1,0,1,18201
b4c48c262fe0b0cfadcae5be8d2860eecff9d1cf,1,Andrew Onishuk,2014-12-30 17:00:39+02:00,['e8e1e340216689a8dd6056f49bbb35fb9fd00f69'],49,68,117,19529747,10,0,1,1,18201
cef3f2ccbca0532b16bf6bae7061ef1127f1b14b,1,Aleksandr Kovalenko,2014-12-30 17:08:15+02:00,['b4c48c262fe0b0cfadcae5be8d2860eecff9d1cf'],7,76,83,19529830,4,0.820512821,1,1,18201
f1e86c999f3bf2075feb2b7207d29b84e4c4c11d,1,Aleksandr Kovalenko,2014-12-30 17:39:39+02:00,['cef3f2ccbca0532b16bf6bae7061ef1127f1b14b'],362,372,734,19530564,14,1,1,1,18201
f186c4bad15aac50244fb24f65c9dfa5e621a582,1,Oleg Nechiporenko,2014-12-30 18:33:15+02:00,['f1e86c999f3bf2075feb2b7207d29b84e4c4c11d'],59,92,151,19530715,3,0.076923077,1,0,18201
72881097dc0f4c9432c62427f2ce5ae6c54c966d,1,Siddharth Wagle,2014-12-30 09:45:14-08:00,['f186c4bad15aac50244fb24f65c9dfa5e621a582'],341,835,1176,19531891,10,0.385294118,0.894117647,0.858823529,18201
8cf0e91550619ec4101427d721bf859cdbeafb9d,1,Andrew Onishuk,2014-12-30 19:52:21+02:00,['72881097dc0f4c9432c62427f2ce5ae6c54c966d'],1710,1611,3321,19535212,67,0,0.052631579,1,18206
9884cbdd51f6d465044d4573a265f124424ec821,1,Siddharth Wagle,2014-12-30 10:16:45-08:00,['8cf0e91550619ec4101427d721bf859cdbeafb9d'],6,12,18,19535230,1,,,,18206
6c21b0942f40791ab4a461048d55e975593eab85,1,Florian Barca,2014-12-30 10:35:45-08:00,['9884cbdd51f6d465044d4573a265f124424ec821'],118,2238,2356,19537586,36,0.572727273,0.635064935,0.785714286,18226
e3c9aa7a4336a43be61342c80395b45288979d5f,1,Jaimin Jetly,2014-12-30 11:01:50-08:00,['6c21b0942f40791ab4a461048d55e975593eab85'],67,300,367,19537953,13,0,0.572289157,0.518072289,18226
321cdbf3673430c6578011cd5c4541938cca0e24,1,Vitaly Brodetskyi,2014-12-30 21:07:56+02:00,['e3c9aa7a4336a43be61342c80395b45288979d5f'],38,80,118,19538071,2,0.125,0.125,1,18226
b768b9e9562aa81ad7bfc80516f6e342083652de,0,Florian Barca,2014-12-30 13:25:22-08:00,['321cdbf3673430c6578011cd5c4541938cca0e24'],2,2,4,19538075,2,,,,18226
4e31964a744a35187511458627eb99e8afda0b25,1,Nate Cole,2014-12-30 17:01:30-05:00,['b768b9e9562aa81ad7bfc80516f6e342083652de'],5,14,19,19538094,1,0,0,1,18226
b01fdc5bd9db7d8a8f5b4cd6b1b5964259418dae,0,Jaimin Jetly,2014-12-30 15:07:29-08:00,['4e31964a744a35187511458627eb99e8afda0b25'],4,6,10,19538104,1,0,1,1,18226
85679051769b83d863868e3e2f8e57ffb925382c,1,Artem Baranchuk,2014-12-31 01:23:04+02:00,['b01fdc5bd9db7d8a8f5b4cd6b1b5964259418dae'],5,22,27,19538131,3,0.285714286,0,0.142857143,18226
af6f6e877209d5ab5d25fe2858259c234137eae5,1,Jayush Luniya,2014-12-30 21:44:28-08:00,['85679051769b83d863868e3e2f8e57ffb925382c'],4286,610,4896,19543027,40,1,1,1,18229
b6f3dd6b40bdaacd3a945ff50f3b59789d82d14c,0,Andrii Tkach,2014-12-31 11:23:39+02:00,['af6f6e877209d5ab5d25fe2858259c234137eae5'],12,13,25,19543052,4,,,,18229
aaf84e3ac10dcca075c85d3e2791fedfb20855a0,0,Lisnichenko Dmitro,2014-12-31 13:05:01+02:00,['b6f3dd6b40bdaacd3a945ff50f3b59789d82d14c'],2,16,18,19543070,2,0,0,0.384615385,18229
536901a5d8f90320cc0548ff22e5d814e6f4d7e2,1,Alex Antonenko,2014-12-31 14:39:57+02:00,['aaf84e3ac10dcca075c85d3e2791fedfb20855a0'],20,45,65,19543135,7,1,0.066666667,1,18229
6dff2c162d435c949390689a9d6b16f1a9e7b5d6,1,Dmytro Sen,2015-01-02 12:57:00+02:00,['536901a5d8f90320cc0548ff22e5d814e6f4d7e2'],74,83,157,19543292,6,0,1,1,18229
6298e804394096c8fc894ea3df787ff6624b4504,0,Aleksandr Kovalenko,2015-01-02 15:18:04+02:00,['6dff2c162d435c949390689a9d6b16f1a9e7b5d6'],2,30,32,19543324,3,1,1,1,18229
16d0a86c1a2a7d830aa9bc745cd5c996b8703380,0,Andrii Tkach,2015-01-02 15:19:35+02:00,['6298e804394096c8fc894ea3df787ff6624b4504'],5,19,24,19543348,2,0,1,1,18229
1cb1d211f3c90f02f6d6c16c9777e7d949375dc4,1,Myroslav Papirkovskyy,2015-01-02 16:01:49+02:00,['16d0a86c1a2a7d830aa9bc745cd5c996b8703380'],35,58,93,19543441,1,,,,18229
7d299d0c69d8125da188a7af2ab4371e03fd725d,1,Dmytro Sen,2015-01-02 17:25:18+02:00,['1cb1d211f3c90f02f6d6c16c9777e7d949375dc4'],643,442,1085,19544526,17,1,0,0,18229
2bae0bb28fb98659954c4e463bd567f9af6eaed2,0,Oleg Nechiporenko,2015-01-02 18:26:12+02:00,['7d299d0c69d8125da188a7af2ab4371e03fd725d'],9,3,12,19544538,1,0,0,0,18229
c4fceabbc46a3e1be7fc87519e8076e41a538bbd,1,Aleksandr Kovalenko,2015-01-02 19:40:20+02:00,['2bae0bb28fb98659954c4e463bd567f9af6eaed2'],9,18,27,19544565,5,1,1,1,18229
1cc10ed3b6202aa7bd3a1b4f8b1306ad97f9b4aa,1,tbeerbower,2015-01-02 13:01:12-05:00,['c4fceabbc46a3e1be7fc87519e8076e41a538bbd'],1,8,9,19544574,2,0,1,1,18229
6e5df9188d512cfd966e2f85e95ae89b2f30ef18,0,Siddharth Wagle,2015-01-02 10:02:31-08:00,['1cc10ed3b6202aa7bd3a1b4f8b1306ad97f9b4aa'],2,2,4,19544578,1,,,,18229
4aa2090ad46bf5faa5e6c0519d2102d5800dd186,1,Jonathan Hurley,2015-01-02 13:21:27-05:00,['6e5df9188d512cfd966e2f85e95ae89b2f30ef18'],166,567,733,19545311,19,0.360465116,1,0.796511628,18229
50342566d51457147b0926ec30448eb4c4d4ff4b,0,Jaimin Jetly,2015-01-02 10:54:21-08:00,['4aa2090ad46bf5faa5e6c0519d2102d5800dd186'],21,21,42,19545353,7,,,,18229
d81bc9b330d84e3e56ea15bd3c4588abc7291d6b,1,sposetti,2015-01-02 14:53:35-05:00,['50342566d51457147b0926ec30448eb4c4d4ff4b'],1,602,603,19545956,7,0.663793103,0.887931034,0.887931034,18235
64424e6ff3f21f465f3aa479c2af82e427bd1051,1,Nate Cole,2015-01-02 15:56:58-05:00,['d81bc9b330d84e3e56ea15bd3c4588abc7291d6b'],174,607,781,19546737,7,0.846889952,0.980861244,0.976076555,18238
6df5648d3e748b78e1d60ec86df32b09d6caa6a3,1,Jayush Luniya,2015-01-05 00:48:17-08:00,['64424e6ff3f21f465f3aa479c2af82e427bd1051'],22,27,49,19546786,3,0,0.428571429,0.571428571,18238
c205e06fa70adebdc32d85ea50353ddc96228169,1,Jayush Luniya,2015-01-05 01:44:11-08:00,['6df5648d3e748b78e1d60ec86df32b09d6caa6a3'],0,3197,3197,19549983,28,,,,18266
a886ee7da94e16c7e9954ee0b7f255f09f98a89b,1,Oleg Nechiporenko,2015-01-05 14:29:35+02:00,['c205e06fa70adebdc32d85ea50353ddc96228169'],53,130,183,19550166,4,0.15,0.483333333,1,18266
acf4de18438aca9f6a05c4b0a9a1c5ac4d2c8f1d,1,Jonathan Hurley,2015-01-05 09:07:51-05:00,['a886ee7da94e16c7e9954ee0b7f255f09f98a89b'],126,230,356,19550522,6,0.083333333,1,1,18268
8a7a4f2e391479db2d0d903d947a21d13fde8ab8,1,Lisnichenko Dmitro,2015-01-05 16:36:04+02:00,['acf4de18438aca9f6a05c4b0a9a1c5ac4d2c8f1d'],2,187,189,19550711,5,0.167741935,1,0.851612903,18268
3247aa4617154579bd426054f3a1b809225fa860,0,Florian Barca,2015-01-05 08:50:58-08:00,['8a7a4f2e391479db2d0d903d947a21d13fde8ab8'],54,15,69,19550780,5,0.037037037,0.037037037,0,18268
aa90346ec0937348639fe70ce87ce385f8c9ac87,1,Florian Barca,2015-01-05 08:57:24-08:00,['3247aa4617154579bd426054f3a1b809225fa860'],1,435,436,19551216,7,,,,18271
ccda41901254a44cde433f91a873388c1b005300,1,Alejandro Fernandez,2015-01-05 10:16:45-08:00,['aa90346ec0937348639fe70ce87ce385f8c9ac87'],217,325,542,19551758,19,0.518987342,0.64556962,0.569620253,18272
f28975c41dc8de71b4f74e23f80522a055dfa69a,1,Myroslav Papirkovskyy,2015-01-05 20:22:19+02:00,['ccda41901254a44cde433f91a873388c1b005300'],18,652,670,19552428,3,0,0,0.083333333,18274
b501215d2693cf21ab7db9b1006a91c0e4a7dfd9,0,Lisnichenko Dmitro,2015-01-05 21:07:24+02:00,['f28975c41dc8de71b4f74e23f80522a055dfa69a'],535,0,535,19552963,5,0.386740331,0.447513812,0.281767956,18274
0d7976bc3d6f4b2e564b9defd7c5e73fd7de1f97,1,Jayush Luniya,2015-01-05 11:35:14-08:00,['b501215d2693cf21ab7db9b1006a91c0e4a7dfd9'],124,187,311,19553274,15,0.066666667,1,1,18275
83b8ab969a08cae84d5e116088eec72735169887,1,Lisnichenko Dmitro,2015-01-05 21:55:43+02:00,['0d7976bc3d6f4b2e564b9defd7c5e73fd7de1f97'],327,511,838,19554112,26,0,0.137096774,1,18276
dec5f7d69c43db12a4080d6e65de8be102936fb1,1,Siddharth Wagle,2015-01-05 14:19:34-08:00,['83b8ab969a08cae84d5e116088eec72735169887'],15,180,195,19554307,6,0.13592233,1,1,18276
3af7a835338e3ebf1030796ba22463e3dfe49eb2,1,Jaimin Jetly,2015-01-05 14:48:04-08:00,['dec5f7d69c43db12a4080d6e65de8be102936fb1'],8,114,122,19554429,8,1,1,1,18277
016604db04fffb68cc9416117a9fab907baf8b7b,0,Jaimin Jetly,2015-01-05 14:54:28-08:00,['3af7a835338e3ebf1030796ba22463e3dfe49eb2'],7,3,10,19554439,1,1,0,0,18277
c9969233be5703ad4431cc95e180ca75d94d4cd7,0,Jaimin Jetly,2015-01-05 14:59:14-08:00,['016604db04fffb68cc9416117a9fab907baf8b7b'],0,43,43,19554482,2,1,1,1,18278
1767fcfa4e99c39dfe92f989749b828de143d918,1,Yusaku Sako,2015-01-05 15:01:20-08:00,['c9969233be5703ad4431cc95e180ca75d94d4cd7'],0,761,761,19555243,11,1,1,0.964285714,18289
e4b2d34b6bf1f1c31944576277cb71f8d771c2e8,0,Florian Barca,2015-01-05 15:51:48-08:00,['1767fcfa4e99c39dfe92f989749b828de143d918'],5,37,42,19555285,1,1,1,1,18289
ddbd346c2a764c0a8938367decf85ab5abcb52a0,1,Srimanth Gunturi,2015-01-05 16:05:48-08:00,['e4b2d34b6bf1f1c31944576277cb71f8d771c2e8'],10,10,20,19555305,4,,,,18289
685f9dd7313a85e9adf90c23824bdf9fea887b9a,0,Srimanth Gunturi,2015-01-05 16:23:44-08:00,['ddbd346c2a764c0a8938367decf85ab5abcb52a0'],1,1,2,19555307,1,,,,18289
2c9820f694bb54cfbf109824f5b7c793f0da1fc9,1,Florian Barca,2015-01-05 17:15:04-08:00,['685f9dd7313a85e9adf90c23824bdf9fea887b9a'],7,112,119,19555426,12,1,1,1,18289
08a13e49eab35ac02e017213204cf349da4b8184,0,Siddharth Wagle,2015-01-05 17:20:45-08:00,['2c9820f694bb54cfbf109824f5b7c793f0da1fc9'],8,0,8,19555434,2,0,0,0,18289
2ed76c80efc880bfe634e1755e8b3352ede62adb,1,Yusaku Sako,2015-01-05 17:44:03-08:00,['08a13e49eab35ac02e017213204cf349da4b8184'],72,61,133,19555567,8,0,1,0.916666667,18289
1d1ebb487e506aed9d76b6c44561435488d8797c,1,Jaimin Jetly,2015-01-05 17:45:39-08:00,['2ed76c80efc880bfe634e1755e8b3352ede62adb'],38,386,424,19555991,12,0.402985075,0.78358209,0.78358209,18291
c6ccbf427843e42eea8797e2834974ae6e5c0713,1,Xi Wang,2015-01-05 17:49:01-08:00,['1d1ebb487e506aed9d76b6c44561435488d8797c'],2,2,4,19555995,1,,,,18291
ab7d4630ae83efdca9e7a03ef9afefba15913f36,0,Xi Wang,2015-01-05 17:49:01-08:00,['c6ccbf427843e42eea8797e2834974ae6e5c0713'],1,1,2,19555997,1,,,,18291
aba38ba2d9bc6a138ab2d7d0f292245150f45b4e,0,Yusaku Sako,2015-01-05 20:48:18-08:00,['ab7d4630ae83efdca9e7a03ef9afefba15913f36'],1,1,2,19555999,1,,,,18291
1dbf72ef47a387cf19df2f85bf2abbd0311e9e0a,1,Andrii Tkach,2015-01-06 12:42:21+02:00,['aba38ba2d9bc6a138ab2d7d0f292245150f45b4e'],330,44,374,19556373,5,0.194444444,1,1,18291
01e2af6ce97566b013ff6f93649d89a5683cefa3,1,Andrii Tkach,2015-01-06 13:04:28+02:00,['1dbf72ef47a387cf19df2f85bf2abbd0311e9e0a'],5,19,24,19556397,3,1,1,1,18291
e88b22b6bea02c51a9d7d992e5ffc15398124248,0,Andrii Tkach,2015-01-06 13:21:05+02:00,['01e2af6ce97566b013ff6f93649d89a5683cefa3'],0,1,1,19556398,1,,,,18291
1ea49d0a729bf6f90c72edd80239f1a155eaab7b,1,Lisnichenko Dmitro,2015-01-06 14:53:36+02:00,['e88b22b6bea02c51a9d7d992e5ffc15398124248'],3,126,129,19556527,4,0.089285714,1,0.928571429,18291
dd3d39a4234e74ca3c99bf933f4f652a6fdcc3e1,0,aBabiichuk,2015-01-06 15:32:14+02:00,['1ea49d0a729bf6f90c72edd80239f1a155eaab7b'],5744,0,5744,19562271,47,0.208857574,0.057876195,0.058882738,18291
8750c70441c377cbee24f2e8e254274fa8d9ba97,1,Aleksandr Kovalenko,2015-01-06 15:42:12+02:00,['dd3d39a4234e74ca3c99bf933f4f652a6fdcc3e1'],1,1,2,19562273,1,,,,18291
0d601a8d13613492d94b0d56cefa9fa7c1a17a49,1,Oleg Nechiporenko,2015-01-06 16:41:56+02:00,['8750c70441c377cbee24f2e8e254274fa8d9ba97'],3,61,64,19562337,3,0.787878788,1,0.181818182,18291
b3e556f787bf5b466a1258d2934fcda3a9375055,0,Jonathan Hurley,2015-01-06 09:46:50-05:00,['0d601a8d13613492d94b0d56cefa9fa7c1a17a49'],10,73,83,19562420,4,0.022727273,0,1,18291
2d4011ebaf4aa7df4bfe0c2d3e313b938fbf710f,1,Lisnichenko Dmitro,2015-01-06 17:14:47+02:00,['b3e556f787bf5b466a1258d2934fcda3a9375055'],1,1,2,19562422,1,,,,18291
c2da10c286721acb3ee23c0a49103716ae1c9ef3,1,Robert Levas,2015-01-06 10:24:32-05:00,['2d4011ebaf4aa7df4bfe0c2d3e313b938fbf710f'],10,216,226,19562648,4,0.058823529,0.562091503,0.437908497,18291
71def630e40093e007782aa0b9f7622f60a2d643,1,Aleksandr Kovalenko,2015-01-06 18:40:40+02:00,['c2da10c286721acb3ee23c0a49103716ae1c9ef3'],71,106,177,19562825,8,0.523809524,1,1,18291
25726ae176919208a4290f7901d76c2b43720657,1,Robert Levas,2015-01-06 13:58:53-05:00,['71def630e40093e007782aa0b9f7622f60a2d643'],1,156,157,19562982,3,0,0.584745763,0.415254237,18291
7b177ea5d22ee655d5e0c94d4e53cbc0fbcfb571,1,tbeerbower,2015-01-06 14:20:55-05:00,['25726ae176919208a4290f7901d76c2b43720657'],27,74,101,19563083,6,0,0.782608696,0.695652174,18291
09a01c2b9217acb63839ea4b0626cec8782ac0bf,1,Robert Levas,2015-01-06 14:58:26-05:00,['7b177ea5d22ee655d5e0c94d4e53cbc0fbcfb571'],4,396,400,19563483,6,0,0.477419355,0.522580645,18291
4000258cb2846b0dca620be26ee0ee3be26cf326,1,Siddharth Wagle,2015-01-06 13:02:28-08:00,['09a01c2b9217acb63839ea4b0626cec8782ac0bf'],7,4,11,19563494,1,0,0,0,18291
40ffee9c87160a085284d47dcf20d0a9643004a9,1,Robert Levas,2015-01-06 16:51:27-05:00,['4000258cb2846b0dca620be26ee0ee3be26cf326'],0,16,16,19563510,1,1,1,1,18291
4c5af44c8481453f6a987302a514e77b80eee0fe,1,Robert Levas,2015-01-06 17:53:15-05:00,['40ffee9c87160a085284d47dcf20d0a9643004a9'],6,316,322,19563832,6,0,0.652542373,0.347457627,18291
9651889419332fb94636e1f6c71cffc6074f1b9f,1,Yusaku Sako,2015-01-06 14:58:43-08:00,['4c5af44c8481453f6a987302a514e77b80eee0fe'],54,102,156,19563988,5,0.530612245,1,0.918367347,18291
14cb9b4ce86b1bffd46f33067664ee50f89f628f,1,Jaimin Jetly,2015-01-06 15:27:23-08:00,['9651889419332fb94636e1f6c71cffc6074f1b9f'],97,237,334,19564322,16,0.933333333,0.933333333,1,18294
db3b306d828994af5e7bc5e4537261536f24e040,1,Robert Levas,2015-01-06 20:20:56-05:00,['14cb9b4ce86b1bffd46f33067664ee50f89f628f'],11,560,571,19564893,11,0,0.619815668,0.380184332,18294
7159bdc40f440b0d5fd38a72f15faaab02a8740d,1,Robert Levas,2015-01-06 21:08:16-05:00,['db3b306d828994af5e7bc5e4537261536f24e040'],1,190,191,19565084,5,0,0.589552239,0.410447761,18294
53c391541f8701cb8b3923da7ae713d20e4d14d7,1,Jayush Luniya,2015-01-06 18:35:39-08:00,['7159bdc40f440b0d5fd38a72f15faaab02a8740d'],1575,623,2198,19567282,51,0.222222222,1,0.652777778,18297
b0e587e42ad8e0c9acbbc9b643581e6a98e13652,1,Robert Levas,2015-01-07 06:45:29-05:00,['53c391541f8701cb8b3923da7ae713d20e4d14d7'],3,197,200,19567482,5,0,0.577922078,0.422077922,18297
be2adc4d2a9b73ba75813cc7b8137dbef2f76360,1,Jonathan Hurley,2015-01-07 08:27:44-05:00,['b0e587e42ad8e0c9acbbc9b643581e6a98e13652'],4,109,113,19567595,2,0.465753425,0.767123288,0.849315068,18297
ad75eeb0336e69ff880f6a23f07490c68909653c,1,Robert Levas,2015-01-07 09:16:56-05:00,['be2adc4d2a9b73ba75813cc7b8137dbef2f76360'],38,138,176,19567771,3,0,1,1,18297
3105ccdbea65e499dd371e94034d4c15280510f3,1,Robert Levas,2015-01-07 10:55:55-05:00,['ad75eeb0336e69ff880f6a23f07490c68909653c'],0,23,23,19567794,2,0,1,1,18297
7c1142b322be5528d69403610073b4482cecb4d5,1,Nate Cole,2015-01-07 13:50:07-05:00,['3105ccdbea65e499dd371e94034d4c15280510f3'],3,90,93,19567887,2,0.305084746,0.898305085,1,18297
46fb0471c70ef52722a7c76a13faeb498cc3a1f2,1,tbeerbower,2015-01-07 14:37:05-05:00,['7c1142b322be5528d69403610073b4482cecb4d5'],4,56,60,19567947,4,1,1,0,18298
e58e53fab4ed4c83d5e0b7248e6b7900a3505157,1,Nate Cole,2015-01-07 15:04:01-05:00,['46fb0471c70ef52722a7c76a13faeb498cc3a1f2'],87,205,292,19568239,12,0.120689655,0.698275862,0.689655172,18298
a00189a36375038c3d500f3f36e03b4aa4191737,0,Yusaku Sako,2015-01-07 12:31:12-08:00,['e58e53fab4ed4c83d5e0b7248e6b7900a3505157'],12,14,26,19568265,4,1,1,1,18299
915f0e7892a6b6be091923264a4b6005c9132466,1,Alejandro Fernandez,2015-01-07 12:48:51-08:00,['a00189a36375038c3d500f3f36e03b4aa4191737'],7,408,415,19568680,45,0.637837838,0.756756757,0.718918919,18301
f90ac9e67eb5d2348b8e5ec5a13fd53090e11d7f,0,Xi Wang,2015-01-07 12:57:39-08:00,['915f0e7892a6b6be091923264a4b6005c9132466'],1,5,6,19568686,2,,,,18301
0e1cc1de436c396476f43794d070c2759fd26d95,1,Xi Wang,2015-01-07 12:57:39-08:00,['f90ac9e67eb5d2348b8e5ec5a13fd53090e11d7f'],12,84,96,19568782,4,0.524590164,0.442622951,1,18301
b6ecaa2444e41cccea5a84640e1bd23550076e54,0,Jaimin Jetly,2015-01-07 13:20:07-08:00,['0e1cc1de436c396476f43794d070c2759fd26d95'],4,7,11,19568793,2,,,,18301
d111c8ee157e295cffcf63ba07736f827dfcb007,0,Siddharth Wagle,2015-01-07 15:20:00-08:00,['b6ecaa2444e41cccea5a84640e1bd23550076e54'],46,161,207,19569000,10,0,1,1,18301
07a3078cc46fd31bdb58aee22a91f2c2ff3007d8,0,Siddharth Wagle,2015-01-07 15:32:38-08:00,['d111c8ee157e295cffcf63ba07736f827dfcb007'],6,6,12,19569012,1,,,,18301
d7a293bfe384989ab1a6b3556a459752f7d46efa,1,Mahadev Konar,2015-01-07 15:48:54-08:00,['07a3078cc46fd31bdb58aee22a91f2c2ff3007d8'],61,168,229,19569241,6,0.579710145,0.884057971,0.942028986,18301
6b1eef55ec692db337233c8f676b8725eae10652,0,Mahadev Konar,2015-01-07 15:55:52-08:00,['d7a293bfe384989ab1a6b3556a459752f7d46efa'],0,222,222,19569463,5,,,,18306
78efd0483f56026059f858b0eedaa8ba5db24e50,0,Siddharth Wagle,2015-01-07 18:33:42-08:00,['6b1eef55ec692db337233c8f676b8725eae10652'],5,5,10,19569473,2,,,,18306
fc7394bf99fa963e5a1e3a205d4db1fe7e80374b,0,Siddharth Wagle,2015-01-07 18:42:26-08:00,['78efd0483f56026059f858b0eedaa8ba5db24e50'],5,5,10,19569483,2,,,,18306
af38b560f569d4260d13a4e5a89ac05c4dd12ca8,0,Siddharth Wagle,2015-01-07 18:42:51-08:00,['fc7394bf99fa963e5a1e3a205d4db1fe7e80374b'],6,6,12,19569495,1,,,,18306
789b6544d91d1344142c88fa709a67b214aa3d3a,0,Siddharth Wagle,2015-01-07 18:48:37-08:00,['af38b560f569d4260d13a4e5a89ac05c4dd12ca8'],161,46,207,19569702,10,1,0,0,18306
61f3c0227a5e76d24c3ee8358253332b13b47338,1,Jayush Luniya,2015-01-07 22:23:49-08:00,['789b6544d91d1344142c88fa709a67b214aa3d3a'],474,9,483,19570185,9,0.854460094,0.76056338,0,18306
4bc86e37e33d072c289d3bd36d9860464f5a33ed,1,Florian Barca,2015-01-08 00:06:08-08:00,['61f3c0227a5e76d24c3ee8358253332b13b47338'],4,7,11,19570196,3,,,,18306
7c5c777469d57218510e4e454ae5c952e250e584,0,aBabiichuk,2015-01-08 10:09:09+02:00,['4bc86e37e33d072c289d3bd36d9860464f5a33ed'],2,2,4,19570200,2,,,,18306
6eb5bd63160b150902eb0d68d92e98281780a852,1,aBabiichuk,2015-01-08 11:11:34+02:00,['7c5c777469d57218510e4e454ae5c952e250e584'],23,46,69,19570269,9,0,1,1,18306
95088d579971c30d6be7af258e3aec78016c63dc,1,aBabiichuk,2015-01-08 12:41:15+02:00,['6eb5bd63160b150902eb0d68d92e98281780a852'],2,5,7,19570276,1,1,1,1,18306
aa41e110aff1e74c4d374954dd1fe9efc69d55f9,1,Oleg Nechiporenko,2015-01-08 15:25:00+02:00,['95088d579971c30d6be7af258e3aec78016c63dc'],548,694,1242,19571518,7,1,1,1,18306
a49cf5858fdda5446a6b2b7463d45d7985b076f9,1,Bob Nettleton,2015-01-08 12:12:21-05:00,['aa41e110aff1e74c4d374954dd1fe9efc69d55f9'],3,140,143,19571661,2,0.14084507,1,0.901408451,18306
2f32fb329c6497e7025196092a886242e9e0cc31,1,Andrii Tkach,2015-01-08 19:15:25+02:00,['a49cf5858fdda5446a6b2b7463d45d7985b076f9'],30,25,55,19571716,7,1,0,0,18306
a06b07d43087bc897120ac09f1e200d4d2a0cd19,1,Alex Antonenko,2015-01-08 19:41:56+02:00,['2f32fb329c6497e7025196092a886242e9e0cc31'],202,299,501,19572217,37,0,0,0,18306
d49eeb6a291ba4dc1b7ee1cddaee346d053984b0,1,Lisnichenko Dmitro,2015-01-08 19:55:24+02:00,['a06b07d43087bc897120ac09f1e200d4d2a0cd19'],9,12,21,19572238,2,0,0,1,18306
273e1b1070c1433fa1c99f2f8352479f37bce465,1,Florian Barca,2015-01-08 10:37:28-08:00,['d49eeb6a291ba4dc1b7ee1cddaee346d053984b0'],5,9,14,19572252,3,0,1,0,18306
76b7d3d465324f73b2d8e3a6f92cf3b9e24430d7,1,Oleg Nechiporenko,2015-01-08 20:49:15+02:00,['273e1b1070c1433fa1c99f2f8352479f37bce465'],20,175,195,19572447,7,0.157534247,1,1,18306
48aea274efedb325db8be9ce20124fb7a00d5408,1,Lisnichenko Dmitro,2015-01-08 21:47:38+02:00,['76b7d3d465324f73b2d8e3a6f92cf3b9e24430d7'],2,19,21,19572468,5,1,1,1,18306
eaa65facf817aedbfd0ae55e74281ab04974aaba,0,Lisnichenko Dmitro,2015-01-08 21:48:59+02:00,['48aea274efedb325db8be9ce20124fb7a00d5408'],0,32,32,19572500,2,1,1,1,18306
0455aac0305288494178088daf581c6841dab7ce,0,Alex Antonenko,2015-01-08 23:10:07+02:00,['eaa65facf817aedbfd0ae55e74281ab04974aaba'],21,38,59,19572559,3,1,1,1,18306
818d1afadbb21920d5d813ad50c10d251424d574,1,Robert Levas,2015-01-08 17:02:49-05:00,['0455aac0305288494178088daf581c6841dab7ce'],1,64,65,19572624,2,0,1,1,18306
b0a23797807f4ecf83f610bf100347a130ad0839,1,Xi Wang,2015-01-08 14:16:13-08:00,['818d1afadbb21920d5d813ad50c10d251424d574'],759,1298,2057,19574681,9,1,0,0,18306
5350550c5eeed21e354c1ad82dc87bb2d7594ffb,1,Myroslav Papirkovskyy,2015-01-09 01:04:01+02:00,['b0a23797807f4ecf83f610bf100347a130ad0839'],6,30,36,19574717,4,,,,18306
942706041919a82d4c2752969a23e4cb3c7f97d9,1,Nate Cole,2015-01-08 20:16:46-05:00,['5350550c5eeed21e354c1ad82dc87bb2d7594ffb'],2,249,251,19574968,4,1,1,1,18308
37e3f924e54004ef87a8b89f49a8902d33f307de,0,aBabiichuk,2015-01-09 11:51:05+02:00,['942706041919a82d4c2752969a23e4cb3c7f97d9'],52,158,210,19575178,7,0.684210526,1,1,18308
0e8b717b246fc9534efa93ef5c588804b415a6ce,1,Oleg Nechiporenko,2015-01-09 13:29:19+02:00,['37e3f924e54004ef87a8b89f49a8902d33f307de'],6,39,45,19575223,3,1,1,1,18308
edb27ea87eb895e50015e4718e5c0a7c71a93668,1,Andrii Tkach,2015-01-09 14:34:17+02:00,['0e8b717b246fc9534efa93ef5c588804b415a6ce'],1036,1030,2066,19577289,12,0.86746988,0,0,18308
01b86400db4f3b3c3a0d41599c8fec3926fb99ac,1,Lisnichenko Dmitro,2015-01-09 15:12:16+02:00,['edb27ea87eb895e50015e4718e5c0a7c71a93668'],6,6,12,19577301,1,,,,18308
39aeeb0eee77cf6ec01cc681cf26fdc9ddea4522,1,aBabiichuk,2015-01-09 15:41:00+02:00,['01b86400db4f3b3c3a0d41599c8fec3926fb99ac'],3,37,40,19577341,5,1,1,1,18308
c1fd867e29d629b79a9c08f171e7eb9778673e00,1,aBabiichuk,2015-01-09 15:41:00+02:00,['39aeeb0eee77cf6ec01cc681cf26fdc9ddea4522'],18,340,358,19577699,7,0.916666667,1,1,18308
d2dd6962a05fa7237973ba913185e519f2e94931,1,Andrii Tkach,2015-01-09 16:01:17+02:00,['c1fd867e29d629b79a9c08f171e7eb9778673e00'],22,6,28,19577727,1,0.95,0,0,18308
ec8aa75329d81d44cf24af8f70767c7fb43a27fc,1,Andrii Tkach,2015-01-09 16:01:17+02:00,['d2dd6962a05fa7237973ba913185e519f2e94931'],6,3,9,19577736,3,0,0,0,18308
d822bf34e13483e6ad53552647eea97756c76a56,1,John Speidel,2015-01-09 09:52:03-05:00,['ec8aa75329d81d44cf24af8f70767c7fb43a27fc'],3,751,754,19578490,14,0.478787879,0.678787879,0.754545455,18312
1f53d011e3c93951a046c88f37a405c4d34e5108,1,Lisnichenko Dmitro,2015-01-09 17:58:27+02:00,['d822bf34e13483e6ad53552647eea97756c76a56'],3,3,6,19578496,3,,,,18312
7efa121200b4a089507bc697e7287a01d06f6823,1,aBabiichuk,2015-01-09 18:07:49+02:00,['1f53d011e3c93951a046c88f37a405c4d34e5108'],26,154,180,19578676,11,1,1,0.72972973,18313
c87fa43bec2d92089598a3acd6a4cc3ead78a8dc,0,aBabiichuk,2015-01-09 18:07:50+02:00,['7efa121200b4a089507bc697e7287a01d06f6823'],47,13,60,19578736,3,0.297297297,0.648648649,0,18313
11763dca2e62b310ff97eb8cd03bd0ff89221663,1,Jonathan Hurley,2015-01-09 11:28:33-05:00,['c87fa43bec2d92089598a3acd6a4cc3ead78a8dc'],27,42,69,19578805,3,0,1,0,18313
c4d131fbc00eea9e224d3b6ed370c131fd0f99c0,1,tbeerbower,2015-01-09 12:08:47-05:00,['11763dca2e62b310ff97eb8cd03bd0ff89221663'],3,34,37,19578842,2,0.052631579,0.947368421,0.947368421,18313
a9ca6fac4f364a17f9e1b3abc5b4a6085d01b338,1,aBabiichuk,2015-01-09 19:23:35+02:00,['c4d131fbc00eea9e224d3b6ed370c131fd0f99c0'],9,29,38,19578880,3,1,1,1,18313
8c68301d0d9c0aeb2a397f9d919d25e21da82ab1,1,aBabiichuk,2015-01-09 19:23:35+02:00,['a9ca6fac4f364a17f9e1b3abc5b4a6085d01b338'],7,21,28,19578908,3,0.6,0.6,1,18313
a8fc971b1af3367c7d4054aa3c2cca9ba1c16243,1,Jonathan Hurley,2015-01-09 15:22:38-05:00,['8c68301d0d9c0aeb2a397f9d919d25e21da82ab1'],1154,743,1897,19580805,10,0.284671533,0.766423358,0.686131387,18315
fe7996466fda0da4c9851e3eac4d5dab9351fba8,1,Srimanth Gunturi,2015-01-09 12:44:37-08:00,['a8fc971b1af3367c7d4054aa3c2cca9ba1c16243'],1,3,4,19580809,2,,,,18315
25a3a1962c1f843e07ed2fd7eeb337b9f5e67580,1,Srimanth Gunturi,2015-01-09 12:44:37-08:00,['fe7996466fda0da4c9851e3eac4d5dab9351fba8'],1,1,2,19580811,1,,,,18315
29ef1616271a5a30be23beb5454e4c7f27519e2d,1,Nate Cole,2015-01-09 15:56:45-05:00,['25a3a1962c1f843e07ed2fd7eeb337b9f5e67580'],12,13,25,19580836,3,0,0,1,18315
9342083790a3e867659a773e84d23e8f7624a6a1,1,Srimanth Gunturi,2015-01-09 13:01:34-08:00,['29ef1616271a5a30be23beb5454e4c7f27519e2d'],5,33,38,19580874,5,0,0,1,18315
ed44a11f4f7e9dcee0901b68c912205619bc7eed,0,Jaimin Jetly,2015-01-09 17:10:00-08:00,['9342083790a3e867659a773e84d23e8f7624a6a1'],20,2312,2332,19583206,44,0.144345238,0.480654762,0.702380952,18333
3d87de5cc22e7ea3f3bfd3e6b9ec73d14066073e,1,tbeerbower,2015-01-10 18:27:14-05:00,['ed44a11f4f7e9dcee0901b68c912205619bc7eed'],18,204,222,19583428,17,1,1,0.292929293,18333
7f361ad96f759caab4da588751a1e5d2a2444e2b,0,Jonathan Hurley,2015-01-11 17:00:30-05:00,['3d87de5cc22e7ea3f3bfd3e6b9ec73d14066073e'],1,1,2,19583430,1,,,,18333
01b3af1b7d191019aafc0d8d670941548a7d4b14,0,Mahadev Konar,2015-01-11 20:33:12-08:00,['7f361ad96f759caab4da588751a1e5d2a2444e2b'],2312,20,2332,19585762,44,0.855654762,0.519345238,0.297619048,18333
31cdf9fab34c07f8a1f1f5f6b97de432ea55fc44,0,Mahadev Konar,2015-01-11 20:37:05-08:00,['01b3af1b7d191019aafc0d8d670941548a7d4b14'],20,2312,2332,19588094,44,0.144345238,0.480654762,0.702380952,18351
e7e865dee2f2305e9723f21ad80aa723cff47fc0,0,Dmytro Sen,2015-01-12 12:17:49+02:00,['31cdf9fab34c07f8a1f1f5f6b97de432ea55fc44'],193,768,961,19589055,20,0.374647887,0.811267606,0.994366197,18354
f898c04796a7851f39228ae8d55ec4e08eda5fd4,1,Lisnichenko Dmitro,2015-01-12 13:48:41+02:00,['e7e865dee2f2305e9723f21ad80aa723cff47fc0'],26,79,105,19589160,21,,,,18354
23b7c1108da35fde71db959b7c2655c2030131e5,0,Lisnichenko Dmitro,2015-01-12 13:51:31+02:00,['f898c04796a7851f39228ae8d55ec4e08eda5fd4'],34610,2,34612,19623772,287,0.803009419,0.117505169,0.044337239,18354
5a43202b4dbd02aab450ceb60efc325c5f77930b,1,Andrii Tkach,2015-01-12 15:43:53+02:00,['23b7c1108da35fde71db959b7c2655c2030131e5'],43,152,195,19623967,10,0.79047619,1,1,18354
c1402587369a508942ff060ce336bf7b2c7e1bc4,0,Dmytro Sen,2015-01-12 15:51:59+02:00,['5a43202b4dbd02aab450ceb60efc325c5f77930b'],768,193,961,19624928,20,0.625352113,0.188732394,0.005633803,18354
c73b74f6764a8bdaa0b2f420c387ce2ca2a98192,1,Lisnichenko Dmitro,2015-01-12 16:11:24+02:00,['c1402587369a508942ff060ce336bf7b2c7e1bc4'],9,228,237,19625165,2,0,0.966666667,1,18354
679fe2f9326d6bbbb694bcfd1bc62dbcd6df499b,1,Vitaly Brodetskyi,2014-12-31 13:13:00+02:00,['c73b74f6764a8bdaa0b2f420c387ce2ca2a98192'],24,193,217,19625382,1,0,1,1,18354
ebdc22e73feb824e94e4e1818166803f8aaeea18,1,Lisnichenko Dmitro,2015-01-12 18:14:24+02:00,['679fe2f9326d6bbbb694bcfd1bc62dbcd6df499b'],0,21,21,19625403,7,,,,18354
321ffed2478bf5f4bcdb3d8b147428b62124f982,1,aBabiichuk,2015-01-12 18:35:06+02:00,['ebdc22e73feb824e94e4e1818166803f8aaeea18'],8,43,51,19625454,3,0.942857143,1,0.685714286,18354
05969421deb2b7c7a0c89ec0a76ba8ff433f3ae4,0,Myroslav Papirkovskyy,2015-01-12 20:06:15+02:00,['321ffed2478bf5f4bcdb3d8b147428b62124f982'],1,1,2,19625456,1,,,,18354
e4e817cc6775a0000cf838ed805d8e127d675cc5,1,Nate Cole,2015-01-12 13:21:36-05:00,['05969421deb2b7c7a0c89ec0a76ba8ff433f3ae4'],9,60,69,19625525,9,0.032258065,0,0.516129032,18354
e2c81b45b0127726f211d77d50f8e5327a1480ae,1,Aleksandr Kovalenko,2015-01-12 21:49:08+02:00,['e4e817cc6775a0000cf838ed805d8e127d675cc5'],141,53,194,19625719,4,0,0,0,18354
6938ad5e5cb6c7a6f198a3a8094c6903be511acf,1,Jun Aoki,2015-01-12 12:06:07-08:00,['e2c81b45b0127726f211d77d50f8e5327a1480ae'],3,4,7,19625726,2,,,,18354
a6b334f286050f14357a3acbf94fb3a0c0103b36,0,Jaimin Jetly,2015-01-12 13:13:34-08:00,['6938ad5e5cb6c7a6f198a3a8094c6903be511acf'],2312,20,2332,19628058,44,0.855654762,0.519345238,0.297619048,18354
c7c8c6d94181cffc8bc28b9c4a4cbbebe88e4e4c,0,Myroslav Papirkovskyy,2015-01-13 01:33:04+02:00,['a6b334f286050f14357a3acbf94fb3a0c0103b36'],1,1,2,19628060,1,,,,18354
0fe4ac5ce3fafa3107474a11f1b628a8401ccada,1,Yusaku Sako,2015-01-12 15:48:28-08:00,['c7c8c6d94181cffc8bc28b9c4a4cbbebe88e4e4c'],30,55,85,19628145,15,,,,18354
e6b4e2fbbc10cf1563570443b809103739ee7a01,1,Alejandro Fernandez,2015-01-12 19:33:41-08:00,['0fe4ac5ce3fafa3107474a11f1b628a8401ccada'],29,37,66,19628211,9,0.666666667,1,0.666666667,18354
698d030bd002112adce60c858b3557ab373d159b,1,Jaimin Jetly,2015-01-12 20:06:43-08:00,['e6b4e2fbbc10cf1563570443b809103739ee7a01'],13,86,99,19628310,4,0,1,1,18355
0bf26f36e90538cfb23ff01a26a48425f09d267e,1,aBabiichuk,2015-01-13 12:05:51+02:00,['698d030bd002112adce60c858b3557ab373d159b'],47,215,262,19628572,13,0.869565217,0.971014493,1,18356
967f9c96fdf04d313a196b1dc8b9420fb4a20a3f,1,aBabiichuk,2015-01-13 13:16:29+02:00,['0bf26f36e90538cfb23ff01a26a48425f09d267e'],358,798,1156,19629728,2,,,,18356
666aec8aac40970036c5b264ca6b0cb0f148d16d,1,Lisnichenko Dmitro,2015-01-13 16:27:12+02:00,['967f9c96fdf04d313a196b1dc8b9420fb4a20a3f'],139,304,443,19630171,7,0.941176471,0.941176471,0.588235294,18358
17da93d58b25b687119c2ce7a9c1a886910790c7,1,Aleksandr Kovalenko,2015-01-13 17:08:12+02:00,['666aec8aac40970036c5b264ca6b0cb0f148d16d'],19,29,48,19630219,2,1,1,0,18358
2eeebfa2f75162776b39eefbfe150ae31622ae07,0,Bob Nettleton,2015-01-13 11:31:34-05:00,['17da93d58b25b687119c2ce7a9c1a886910790c7'],6,267,273,19630492,5,0.123595506,0.185393258,0.97752809,18358
275e8986b1d45685e20676dc077fd9f8ff5bbf18,1,Jonathan Hurley,2015-01-13 11:42:18-05:00,['2eeebfa2f75162776b39eefbfe150ae31622ae07'],39,452,491,19630983,10,0.890784983,0.890784983,1,18358
e67c5ea50c0ac1a71855b1f0e3af8dbb39a9c793,1,Alex Antonenko,2015-01-13 18:45:50+02:00,['275e8986b1d45685e20676dc077fd9f8ff5bbf18'],38,497,535,19631518,8,0.680781759,1,0.993485342,18360
efe79f015a1ea995a62db922cdbf9edb47c8bcf8,1,Robert Levas,2015-01-13 13:27:14-05:00,['e67c5ea50c0ac1a71855b1f0e3af8dbb39a9c793'],778,1377,2155,19633673,15,0,0.49537037,0.824074074,18360
3d445e739019815d51233114dac5cb5889dd0896,1,Robert Levas,2015-01-13 13:29:15-05:00,['efe79f015a1ea995a62db922cdbf9edb47c8bcf8'],0,328,328,19634001,6,1,1,0.871428571,18366
b3ff359ad3ac00cbc045fb1d8fe2b9c3955ffd81,1,Lisnichenko Dmitro,2015-01-13 21:11:33+02:00,['3d445e739019815d51233114dac5cb5889dd0896'],11,127,138,19634139,4,1,0.845238095,0.261904762,18366
c22e1ec08569cbca6898ac6fc6b781bc1de28d48,1,Lisnichenko Dmitro,2015-01-13 21:46:26+02:00,['b3ff359ad3ac00cbc045fb1d8fe2b9c3955ffd81'],32,36,68,19634207,8,0,0.75,1,18366
a84acc27f703e3e74e33e8022c0af6df6838b69a,1,Lisnichenko Dmitro,2015-01-13 22:24:26+02:00,['c22e1ec08569cbca6898ac6fc6b781bc1de28d48'],19,42,61,19634268,11,0.111111111,0,0.777777778,18366
95b466923393a48ffd3008018ff4392c1a03f89d,1,Robert Levas,2015-01-13 15:50:45-05:00,['a84acc27f703e3e74e33e8022c0af6df6838b69a'],4,471,475,19634743,9,0,0.629737609,0.370262391,18366
fb947b0cce36c53d10ad94e9d1056f6f6a01f5f1,0,Nate Cole,2015-01-13 15:56:01-05:00,['95b466923393a48ffd3008018ff4392c1a03f89d'],19,232,251,19634994,14,0.359649123,0.447368421,0.824561404,18366
16bee3858711178dd4025b56211f03b11fa75954,1,Florian Barca,2015-01-13 13:46:04-08:00,['fb947b0cce36c53d10ad94e9d1056f6f6a01f5f1'],1512,1574,3086,19638080,23,1,1,0.243243243,18366
a4c94d70577fb5a1b5e01ab6c94dea632aad210a,1,Jonathan Hurley,2015-01-13 17:25:51-05:00,['16bee3858711178dd4025b56211f03b11fa75954'],102,424,526,19638606,11,0.026086957,0.582608696,0.591304348,18366
89eeb617154f98c3bf264802b91ea568dd172c56,0,Alejandro Fernandez,2015-01-13 16:24:35-08:00,['a4c94d70577fb5a1b5e01ab6c94dea632aad210a'],110,116,226,19638832,44,0.071428571,1,1,18366
f0f0c7b4bfe690a1e23c14c80b28a397d49cbc65,1,Srimanth Gunturi,2015-01-13 17:51:40-08:00,['89eeb617154f98c3bf264802b91ea568dd172c56'],0,28,28,19638860,1,,,,18366
e904eb7fa1bb8260bd89fed62cf9bd042f2c0aa3,1,Siddharth Wagle,2015-01-13 18:06:58-08:00,['f0f0c7b4bfe690a1e23c14c80b28a397d49cbc65'],77,240,317,19639177,13,0,0.4,0.371428571,18366
a4af6ca4d943ee739b15196a502cd6e3bfdab43f,1,Siddharth Wagle,2015-01-13 18:06:58-08:00,['e904eb7fa1bb8260bd89fed62cf9bd042f2c0aa3'],0,21,21,19639198,2,0,1,1,18366
572251803f6fe25262234bf72a5dc5512eb3aa74,1,Siddharth Wagle,2015-01-13 18:06:58-08:00,['a4af6ca4d943ee739b15196a502cd6e3bfdab43f'],3,1,4,19639202,1,,,,18366
b89786e88608a736c770b2f4135dadb1ee95be59,1,Jaimin Jetly,2015-01-13 18:36:49-08:00,['572251803f6fe25262234bf72a5dc5512eb3aa74'],6,5,11,19639213,4,,,,18366
b0a345635edf585ec8efd8e44cfbc3ff6baf329d,1,Lisnichenko Dmitro,2015-01-14 11:05:19+02:00,['b89786e88608a736c770b2f4135dadb1ee95be59'],14,47,61,19639274,5,1,1,1,18366
c59df55e536f60c32c955292eefbdfe5e9123c5b,1,Andrii Tkach,2015-01-14 13:50:49+02:00,['b0a345635edf585ec8efd8e44cfbc3ff6baf329d'],2242,801,3043,19642317,37,0.134194831,0.012922465,0.001988072,18372
992b0cb50b2237090ecb16070a9f50ba60b93900,1,Yusaku Sako,2015-01-14 04:34:33-08:00,['c59df55e536f60c32c955292eefbdfe5e9123c5b'],116,110,226,19642543,44,0.928571429,0,0,18372
3e38fda01237a525945742cc875c4e60a7b37e91,0,Yusaku Sako,2015-01-14 04:47:52-08:00,['992b0cb50b2237090ecb16070a9f50ba60b93900'],232,19,251,19642794,14,0.640350877,0.552631579,0.175438596,18372
fc2b911517a942484b4af3f7f5e3e77c650ab2ac,1,Aleksandr Kovalenko,2015-01-14 14:51:49+02:00,['3e38fda01237a525945742cc875c4e60a7b37e91'],1,9,10,19642804,2,0,1,1,18372
fdc2d7798f53611b29a3cacad57796e3db402ba8,1,Robert Levas,2015-01-14 09:11:03-05:00,['fc2b911517a942484b4af3f7f5e3e77c650ab2ac'],24,167,191,19642995,23,0.411764706,0.029411765,0.852941176,18373
7f491baea39b57c2645de0aa216adf0f4324ced9,1,sposetti,2015-01-14 10:20:40-05:00,['fdc2d7798f53611b29a3cacad57796e3db402ba8'],302,460,762,19643757,24,0,0,1,18375
7de7343bc00af48b049db5a8b7cee89fd400ae60,1,Nate Cole,2015-01-14 10:51:47-05:00,['7f491baea39b57c2645de0aa216adf0f4324ced9'],20,241,261,19644018,15,0.336065574,0.409836066,0.836065574,18375
1a4d5aa6d0f1e59f0387ab7d3986964c15c45cdd,1,tbeerbower,2015-01-14 11:00:55-05:00,['7de7343bc00af48b049db5a8b7cee89fd400ae60'],22,159,181,19644199,4,0.296296296,1,1,18375
b5c907032321d101be123b18906f7738bafed60d,1,Vitaly Brodetskyi,2015-01-02 14:05:56+02:00,['1a4d5aa6d0f1e59f0387ab7d3986964c15c45cdd'],8,16,24,19644223,4,0,1,1,18375
20e67bcd62cd5a3cce2d459d777719361bb5b6d9,1,Andrii Tkach,2015-01-14 18:40:43+02:00,['b5c907032321d101be123b18906f7738bafed60d'],5,9,14,19644237,1,1,1,1,18375
a88c69f3076d8386a01202da4901d6117624063d,0,Alex Antonenko,2015-01-14 20:02:02+02:00,['20e67bcd62cd5a3cce2d459d777719361bb5b6d9'],0,2,2,19644239,1,1,1,1,18375
bf9f73e214576c25fdbafac002f02b597b76dbf1,0,Alex Antonenko,2015-01-14 20:02:03+02:00,['a88c69f3076d8386a01202da4901d6117624063d'],40,49,89,19644328,5,,,,18375
32f1b05fdf12150a23ad05616377fa41d25fd8aa,1,Alex Antonenko,2015-01-14 20:02:04+02:00,['bf9f73e214576c25fdbafac002f02b597b76dbf1'],1,2,3,19644331,1,,,,18375
477899fb45d64dc62a01e061982498962a978f70,1,tbeerbower,2015-01-14 13:06:36-05:00,['32f1b05fdf12150a23ad05616377fa41d25fd8aa'],15,146,161,19644492,8,0,0.474576271,1,18376
0d2a6cbf2b3020ea020380cecd52801f5d6b7287,1,Jayush Luniya,2015-01-14 11:08:06-08:00,['477899fb45d64dc62a01e061982498962a978f70'],2,50,52,19644544,4,,,,18376
8056e25dc330d4a8bb9e251014ab7f92c9bc7209,0,tbeerbower,2015-01-14 14:39:13-05:00,['0d2a6cbf2b3020ea020380cecd52801f5d6b7287'],0,15,15,19644559,2,1,1,1,18376
fcfc8c17c295bf178e210434b4a5cd8f6c13b5fa,0,Jaimin Jetly,2015-01-14 11:58:21-08:00,['8056e25dc330d4a8bb9e251014ab7f92c9bc7209'],49,40,89,19644648,5,,,,18376
e19c46f0e6b08cbf4d35ef8bb75c75176a7da021,1,Jaimin Jetly,2015-01-14 12:09:12-08:00,['fcfc8c17c295bf178e210434b4a5cd8f6c13b5fa'],40,49,89,19644737,5,,,,18376
daea86e2e6c20f8d9a76e047f3ffbf63165a9334,1,Alex Antonenko,2015-01-14 22:13:49+02:00,['e19c46f0e6b08cbf4d35ef8bb75c75176a7da021'],4,5,9,19644746,4,0,1,0,18376
e56c82998d5cc537a3360a03309a1122ff119ea6,1,Jaimin Jetly,2015-01-14 12:35:46-08:00,['daea86e2e6c20f8d9a76e047f3ffbf63165a9334'],0,407,407,19645153,4,0.712230216,0.985611511,0.769784173,18379
a6df75fd6146569096a2678fbfbb56665a43c296,1,Robert Levas,2015-01-14 15:48:14-05:00,['e56c82998d5cc537a3360a03309a1122ff119ea6'],24,151,175,19645328,7,0.307692308,0.58974359,0.743589744,18379
de18175ff2cbb23603a33cc79f29e1650941d335,1,Jun Aoki,2015-01-14 13:45:02-08:00,['a6df75fd6146569096a2678fbfbb56665a43c296'],70,25,95,19645423,4,0,0,0,18379
7c98d6ecdd7e4f7e237e4957e0fbe9bc170ee31c,1,Alejandro Fernandez,2015-01-14 14:56:31-08:00,['de18175ff2cbb23603a33cc79f29e1650941d335'],83,68,151,19645574,43,0,0,1,18379
3c202998ef286d5074be6b713780546b9f5d73ef,1,Jayush Luniya,2015-01-14 15:37:52-08:00,['7c98d6ecdd7e4f7e237e4957e0fbe9bc170ee31c'],11120,906,12026,19657600,42,0.442424242,0.324242424,0.587878788,18394
1441a4cdcefd75a163302eda161a32710f4abe8f,1,Jayush Luniya,2015-01-14 17:07:16-08:00,['3c202998ef286d5074be6b713780546b9f5d73ef'],1,1,2,19657602,1,,,,18394
65577e2231c439a0b88aba2d67205fc0d063e624,0,Robert Levas,2015-01-14 20:39:22-05:00,['1441a4cdcefd75a163302eda161a32710f4abe8f'],5,5,10,19657612,1,,,,18394
d32eefdafd14c30b852128b38245581223fb97ed,1,Jaimin Jetly,2015-01-14 18:05:41-08:00,['65577e2231c439a0b88aba2d67205fc0d063e624'],45,152,197,19657809,6,0,0.294117647,0.470588235,18394
5620318518f4899eab81a122ec6a952356adcb7b,1,Jonathan Hurley,2015-01-14 23:38:02-05:00,['d32eefdafd14c30b852128b38245581223fb97ed'],6,16,22,19657831,3,0,0.8,0.2,18394
cd2a67c8277bb899bb886f00f044a95fbf88fc06,1,Florian Barca,2015-01-14 23:04:04-08:00,['5620318518f4899eab81a122ec6a952356adcb7b'],1269,750,2019,19659850,15,0.171232877,0.517123288,0.404109589,18394
9cea058fb194797c8d91521f035edab6b4e4f3e6,0,aBabiichuk,2015-01-15 09:47:53+02:00,['cd2a67c8277bb899bb886f00f044a95fbf88fc06'],2,10,12,19659862,3,0,1,1,18394
7a082ecd742695187372f49676d20356115f8acc,1,Andrii Tkach,2015-01-15 12:59:55+02:00,['9cea058fb194797c8d91521f035edab6b4e4f3e6'],1,1,2,19659864,1,,,,18394
65393a52eb38ff6ac779efed3536c837f5a17ae1,1,Robert Levas,2015-01-15 06:42:17-05:00,['7a082ecd742695187372f49676d20356115f8acc'],73,229,302,19660166,13,0.27,0.34,0,18394
fe3b93c87a54d96ff531f5e927f851c0a11ab7c2,1,aBabiichuk,2015-01-15 14:07:43+02:00,['65393a52eb38ff6ac779efed3536c837f5a17ae1'],4,8,12,19660178,3,1,1,1,18394
0613eeb010d947a11796203b999e4d2bbacb7389,1,Nate Cole,2015-01-15 08:02:48-05:00,['fe3b93c87a54d96ff531f5e927f851c0a11ab7c2'],98,270,368,19660546,15,0.132653061,0.591836735,0.581632653,18394
2fe5a5c9fd914edebf2fdc0c808cbd1445ad6e57,0,Aleksandr Kovalenko,2015-01-15 16:19:23+02:00,['0613eeb010d947a11796203b999e4d2bbacb7389'],4,7,11,19660557,2,1,1,1,18394
93e79d0d039f98f5c962b072b7cf49e19dcef89a,0,Bob Nettleton,2015-01-15 09:38:11-05:00,['2fe5a5c9fd914edebf2fdc0c808cbd1445ad6e57'],3,18,21,19660578,2,0,1,1,18394
261f04b7d00305e9ab36d26ab1a441a82e945cc6,1,Andrii Tkach,2015-01-15 16:52:53+02:00,['93e79d0d039f98f5c962b072b7cf49e19dcef89a'],48,61,109,19660687,2,0.431372549,1,1,18394
e2b3f4deb6175f8f3291a5bddfbe09330414dadd,1,Jonathan Hurley,2015-01-15 11:20:50-05:00,['261f04b7d00305e9ab36d26ab1a441a82e945cc6'],3,3,6,19660693,1,,,,18394
d902509f755701285bda9bc23b51bd2e58064133,1,John Speidel,2015-01-15 13:27:42-05:00,['e2b3f4deb6175f8f3291a5bddfbe09330414dadd'],7,1616,1623,19662316,23,0.587412587,0.935314685,0.835664336,18400
51ff43834de99e9f4e43770a1319ca888829ae83,1,Jaimin Jetly,2015-01-15 10:33:14-08:00,['d902509f755701285bda9bc23b51bd2e58064133'],4,4,8,19662324,4,,,,18400
265f13f467f9d190cba4a0e59271b68d45d5caae,1,John Speidel,2015-01-15 14:22:23-05:00,['51ff43834de99e9f4e43770a1319ca888829ae83'],2,85,87,19662411,3,0.4,1,1,18400
a10d56f0b2a14b11d97e835ed81bedc4b361eb17,1,Siddharth Wagle,2015-01-15 14:14:21-08:00,['265f13f467f9d190cba4a0e59271b68d45d5caae'],4,4,8,19662419,2,,,,18400
fcce59e8ca5410ea1ac893b21406861c3d003a80,1,Alejandro Fernandez,2015-01-15 14:44:24-08:00,['a10d56f0b2a14b11d97e835ed81bedc4b361eb17'],5,202,207,19662626,5,0.108910891,0.108910891,0.782178218,18401
d1c99a06b8e7cccc9bd534f8dc4681dcbc876c7e,1,Jaimin Jetly,2015-01-15 15:38:51-08:00,['fcce59e8ca5410ea1ac893b21406861c3d003a80'],7,9,16,19662642,2,,,,18401
c7528452c59501d809abe9f7b93e497748ddeffb,0,Jaimin Jetly,2015-01-15 15:40:21-08:00,['d1c99a06b8e7cccc9bd534f8dc4681dcbc876c7e'],5,21,26,19662668,2,1,1,1,18401
ad0d0b094798b8cc143f7e369896b5e4803bfeac,1,Jun Aoki,2015-01-15 16:21:21-08:00,['c7528452c59501d809abe9f7b93e497748ddeffb'],9,23,32,19662700,2,1,1,1,18401
43f227ac7e01f6aac5b3d4b93bf02fb25f6a2240,1,Siddharth Wagle,2015-01-15 16:46:49-08:00,['ad0d0b094798b8cc143f7e369896b5e4803bfeac'],0,5,5,19662705,1,,,,18401
45d785df763a452f312e37fcadc9a79792ea0460,0,Jaimin Jetly,2015-01-15 19:24:32-08:00,['43f227ac7e01f6aac5b3d4b93bf02fb25f6a2240'],1,8,9,19662714,1,0,1,1,18401
06f4a89fd52f6f2f15c53d29271b50980a442e2b,1,Aleksandr Kovalenko,2015-01-16 11:27:33+02:00,['45d785df763a452f312e37fcadc9a79792ea0460'],47,178,225,19662939,5,1,1,1,18401
111b2e53348c5539006601e48b03dbfc62ec01da,1,Andrii Tkach,2015-01-16 14:19:41+02:00,['06f4a89fd52f6f2f15c53d29271b50980a442e2b'],401,276,677,19663616,14,1,1,1,18401
0a1d66488ea4a512c23baacd7e629772afd2f717,0,Dmytro Sen,2015-01-16 15:09:40+02:00,['111b2e53348c5539006601e48b03dbfc62ec01da'],1,114,115,19663731,4,0.032258065,0.032258065,0.967741935,18402
e465ddad25787127408c6e511add11157c9f4714,0,Andrii Tkach,2015-01-16 16:16:50+02:00,['0a1d66488ea4a512c23baacd7e629772afd2f717'],9,12,21,19663752,2,1,1,1,18402
80b4392abdab68eb820c8c405039104f7ad0d610,1,Jonathan Hurley,2015-01-16 09:18:20-05:00,['e465ddad25787127408c6e511add11157c9f4714'],1,14,15,19663767,4,1,1,1,18402
6d6812a2c77bc7c8d77d8e8969651edcc46e7880,1,Alex Antonenko,2015-01-16 16:48:02+02:00,['80b4392abdab68eb820c8c405039104f7ad0d610'],1,1,2,19663769,1,,,,18402
a8b57314a2183dcef315a4e98f12392845927cad,0,Andrii Tkach,2015-01-16 17:34:53+02:00,['6d6812a2c77bc7c8d77d8e8969651edcc46e7880'],1,3,4,19663773,3,1,1,1,18402
e3763edde2b971bb22bfa7cd5281b2ede493e1cb,1,Myroslav Papirkovskyy,2015-01-16 18:09:41+02:00,['a8b57314a2183dcef315a4e98f12392845927cad'],47,119,166,19663939,15,0.195652174,0.282608696,0.5,18402
a71f942eda00930e85f4c3b9451da2a58b58303f,1,tbeerbower,2015-01-16 11:26:51-05:00,['e3763edde2b971bb22bfa7cd5281b2ede493e1cb'],3,121,124,19664063,5,0.487179487,0.487179487,0.205128205,18403
1f257e39d668166a098b51a3d267e31fb36ca2ed,1,aBabiichuk,2015-01-16 18:29:41+02:00,['a71f942eda00930e85f4c3b9451da2a58b58303f'],3,167,170,19664233,9,1,1,0.959183673,18405
b52e2543f1b66dbf073f48ad3b3398836e62dc1e,0,aBabiichuk,2015-01-16 18:29:42+02:00,['1f257e39d668166a098b51a3d267e31fb36ca2ed'],1,1,2,19664235,1,,,,18405
c9f875d84e9cacc37369d4940ddd2bdc3f52f49d,1,Alejandro Fernandez,2015-01-16 08:34:42-08:00,['b52e2543f1b66dbf073f48ad3b3398836e62dc1e'],8,32,40,19664275,4,1,1,0.25,18405
c061d7213172d13f12da597a46db2ccaec1e01c3,1,Nate Cole,2015-01-16 13:03:38-05:00,['c9f875d84e9cacc37369d4940ddd2bdc3f52f49d'],3,57,60,19664335,2,0,0.170731707,1,18405
15dbe35786a62aec81618665f90c91fe04c7d52d,0,Andrii Tkach,2015-01-16 21:16:30+02:00,['c061d7213172d13f12da597a46db2ccaec1e01c3'],1,1,2,19664337,1,,,,18405
8d27ac2b77abdeeb61fd8d9bc6b51ce113fcd900,0,Siddharth Wagle,2015-01-16 12:37:46-08:00,['15dbe35786a62aec81618665f90c91fe04c7d52d'],12,1259,1271,19665608,17,0.437219731,0.762331839,0.621076233,18413
7330d0eacc2e825a441cddbfa1684e4aae6557f9,1,Nate Cole,2015-01-16 15:56:47-05:00,['8d27ac2b77abdeeb61fd8d9bc6b51ce113fcd900'],4,152,156,19665764,6,0.362068966,0.362068966,0.965517241,18414
d7ca3036e59348cfbfcdc01c38c602241e0741f9,0,Siddharth Wagle,2015-01-16 13:35:57-08:00,['7330d0eacc2e825a441cddbfa1684e4aae6557f9'],114,1,115,19665879,4,0.967741935,0.967741935,0.032258065,18414
f1d354ccae8f95a63735628c133183a87249d1b2,0,Siddharth Wagle,2015-01-16 15:25:57-08:00,['d7ca3036e59348cfbfcdc01c38c602241e0741f9'],1259,12,1271,19667150,17,0.562780269,0.237668161,0.378923767,18414
1ab69ecdbbe4a534bc1edc06c3fee501bf4e78e8,0,Jayush Luniya,2015-01-16 16:07:26-08:00,['f1d354ccae8f95a63735628c133183a87249d1b2'],206,7,213,19667363,10,0.640350877,0.342105263,0.324561404,18414
521e2e391eb1c6a707a498d351ba9111e2bdc41b,1,Jaimin Jetly,2015-01-16 16:42:46-08:00,['1ab69ecdbbe4a534bc1edc06c3fee501bf4e78e8'],29,80,109,19667472,1,1,1,0.52,18414
968c4b9de36f0c19f7c285dbee8770ad81ae6b3c,0,Yusaku Sako,2015-01-16 19:52:52-08:00,['521e2e391eb1c6a707a498d351ba9111e2bdc41b'],30,2639,2669,19670141,46,0.143667297,0.495274102,0.620037807,18432
b3f0afbfcc3f09d189ab6493d972711c442bd19e,1,Alex Antonenko,2015-01-18 15:39:30+02:00,['968c4b9de36f0c19f7c285dbee8770ad81ae6b3c'],2,10,12,19670153,4,,,,18432
11295a897c4fb0ccf9c36cd9f87c10708e758119,1,aBabiichuk,2015-01-19 12:50:52+02:00,['b3f0afbfcc3f09d189ab6493d972711c442bd19e'],2,2,4,19670157,1,,,,18432
fe17e117fdff2cf61ffe71c8a149d08fc63d8a0b,1,aBabiichuk,2015-01-19 12:55:25+02:00,['11295a897c4fb0ccf9c36cd9f87c10708e758119'],9,186,195,19670352,2,0.472222222,1,1,18432
bcae2e893878790aa5ae7ddbede1e5903d460f27,1,Andrew Onishuk,2015-01-19 16:40:09+02:00,['fe17e117fdff2cf61ffe71c8a149d08fc63d8a0b'],0,31,31,19670383,1,0.375,0.375,0.291666667,18432
6121d56df94db25cc8d69ac4e24f96690281906d,1,Andrii Tkach,2015-01-19 17:06:33+02:00,['bcae2e893878790aa5ae7ddbede1e5903d460f27'],24,50,74,19670457,3,,,,18432
a757dcb501a08b4e5562238bf75c567bced9efbb,1,Nate Cole,2015-01-19 10:13:29-05:00,['6121d56df94db25cc8d69ac4e24f96690281906d'],85,614,699,19671156,10,0.082191781,0.767123288,0.924657534,18434
7621f9013391093eeb8dd1aee2524e91dddd9e7f,1,Dmytro Sen,2015-01-19 18:24:26+02:00,['a757dcb501a08b4e5562238bf75c567bced9efbb'],194,784,978,19672134,20,0.38147139,0.803814714,0.994550409,18437
20250f473e30f5c4989291e0033f99ed3f1f4bdd,1,Andrew Onishuk,2015-01-19 19:01:39+02:00,['7621f9013391093eeb8dd1aee2524e91dddd9e7f'],3,3,6,19672140,2,,,,18437
ea6c4ecaf7e7d7f0cb0beeed889b8192ded2254a,1,Lisnichenko Dmitro,2015-01-19 19:11:25+02:00,['20250f473e30f5c4989291e0033f99ed3f1f4bdd'],9,69,78,19672218,5,0.152173913,1,0.847826087,18437
4d71477d10193fcc48030093914fa69793297292,0,Yusaku Sako,2015-01-19 09:46:16-08:00,['ea6c4ecaf7e7d7f0cb0beeed889b8192ded2254a'],0,156,156,19672374,1,,,,18438
908e7354cb25c5513dc6104486699c985f27bec7,1,Lisnichenko Dmitro,2015-01-19 19:54:50+02:00,['4d71477d10193fcc48030093914fa69793297292'],4,89,93,19672467,2,0.177419355,0.387096774,0.516129032,18438
ba98455cc6749a1d0980f021c8b6e276c3652040,1,Dmytro Sen,2015-01-19 19:57:32+02:00,['908e7354cb25c5513dc6104486699c985f27bec7'],2,3,5,19672472,2,,,,18438
88094f6ba4ef536f2431e55b9a2f07a36c04c935,0,Andrii Tkach,2015-01-19 20:19:43+02:00,['ba98455cc6749a1d0980f021c8b6e276c3652040'],0,2,2,19672474,2,1,1,1,18438
d3b139b5d121abdddd3f8b9a5886e11f498dcf16,0,Dmytro Sen,2015-01-19 20:30:31+02:00,['88094f6ba4ef536f2431e55b9a2f07a36c04c935'],1,3,4,19672478,1,0,1,0,18438
7e33ea589eb70eeec85011b6e7917dc4b118286c,0,Jaimin Jetly,2015-01-19 10:49:56-08:00,['d3b139b5d121abdddd3f8b9a5886e11f498dcf16'],20,35,55,19672533,2,0.857142857,1,1,18438
ddf020dd6102b1918a0d9e1c669f3e54765cd344,1,tbeerbower,2015-01-19 13:57:58-05:00,['7e33ea589eb70eeec85011b6e7917dc4b118286c'],29,317,346,19672879,10,0.25,0.766666667,1,18438
38429224c724202fda1e217aee1624e116470d1f,1,Siddharth Wagle,2015-01-19 11:00:39-08:00,['ddf020dd6102b1918a0d9e1c669f3e54765cd344'],12,1263,1275,19674154,17,0.436241611,0.762863535,0.621923937,18446
7c5fb7b534eaec38c67dfed510ba97341bd2f0ce,1,Jayush Luniya,2015-01-19 11:32:02-08:00,['38429224c724202fda1e217aee1624e116470d1f'],105,164,269,19674423,9,0,1,1,18446
01fa8eb03bc1a7de7bb914a8d8bc468cd87c4bd5,1,Robert Levas,2015-01-19 15:00:42-05:00,['7c5fb7b534eaec38c67dfed510ba97341bd2f0ce'],229,630,859,19675282,18,0.014285714,0.578571429,0.889285714,18446
fe3f405fadeafec62e2e257a60342fe7ebe52484,1,Nate Cole,2015-01-19 15:15:03-05:00,['01fa8eb03bc1a7de7bb914a8d8bc468cd87c4bd5'],98,167,265,19675547,9,0.909090909,0.886363636,0.818181818,18446
3f2a91b469048578dafe278bf6bc2f28cc772a83,0,Jaimin Jetly,2015-01-19 12:45:51-08:00,['fe3f405fadeafec62e2e257a60342fe7ebe52484'],156,0,156,19675703,1,,,,18446
a0c5d8f2389f64c4572f212d08c77db171802036,0,Jaimin Jetly,2015-01-19 12:45:51-08:00,['3f2a91b469048578dafe278bf6bc2f28cc772a83'],2633,30,2663,19678366,46,0.858365019,0.522813688,0.378326996,18446
8c940368cc54f19437fcfc9f809b4abe23ebd265,1,Jun Aoki,2015-01-19 13:02:12-08:00,['a0c5d8f2389f64c4572f212d08c77db171802036'],9,5,14,19678380,2,,,,18446
b285bd0884fd2de6ed3c10291e787f23fb83cb98,1,Dmytro Sen,2015-01-19 23:25:25+02:00,['8c940368cc54f19437fcfc9f809b4abe23ebd265'],1,120,121,19678501,6,0.03030303,0.03030303,0.96969697,18447
a902c53720cfbfb8aca5f69a7a7ff579a8911d4b,0,Florian Barca,2015-01-19 13:43:40-08:00,['b285bd0884fd2de6ed3c10291e787f23fb83cb98'],2,5,7,19678508,1,0,0,0,18447
7e691292ad2323341e77a5399db388ca0128387c,1,Robert Levas,2015-01-19 19:04:57-05:00,['a902c53720cfbfb8aca5f69a7a7ff579a8911d4b'],583,876,1459,19679967,18,0.818181818,0.818181818,0,18458
af463646ad94c65e768df7720ce28d9de58b2f4c,1,Siddharth Wagle,2015-01-19 16:50:32-08:00,['7e691292ad2323341e77a5399db388ca0128387c'],11,286,297,19680264,6,0,0.637931034,1,18459
f37d999664c5540478a053c21ddd311ed98c5b61,1,Jonathan Hurley,2015-01-19 20:06:08-05:00,['af463646ad94c65e768df7720ce28d9de58b2f4c'],30,110,140,19680404,3,0.054545455,0.890909091,1,18459
a41e45e431bcfaae69ccd43b37206742be5f9d46,1,aBabiichuk,2015-01-20 11:23:13+02:00,['f37d999664c5540478a053c21ddd311ed98c5b61'],1422,1308,2730,19683134,20,0,1,1,18463
9c8650b82d28579908802e8e798e97eed15ba647,1,Andrii Tkach,2015-01-20 12:56:11+02:00,['a41e45e431bcfaae69ccd43b37206742be5f9d46'],45,56,101,19683235,6,0.777777778,1,1,18463
6a464426a7d96b2e3e733b48b79078adced82eb6,1,Robert Levas,2015-01-20 05:57:50-05:00,['9c8650b82d28579908802e8e798e97eed15ba647'],348,972,1320,19684555,6,0.122249389,1,0.936430318,18463
d9836e314b0f76adb0b5387594572b8f489c9d36,1,Andrii Tkach,2015-01-20 13:32:06+02:00,['6a464426a7d96b2e3e733b48b79078adced82eb6'],96,80,176,19684731,5,0,0,0,18463
d72693d66cbad9cfcbfbb1911d0d5c5ae1d85f8b,1,Vitaly Brodetskyi,2015-01-08 12:21:52+02:00,['d9836e314b0f76adb0b5387594572b8f489c9d36'],2,2,4,19684735,2,,,,18463
aff6fc825d773c0cbf338a4df1aaad0050de6ea7,0,Jonathan Hurley,2015-01-20 09:37:12-05:00,['d72693d66cbad9cfcbfbb1911d0d5c5ae1d85f8b'],40,49,89,19684824,8,0,0,1,18463
3ec191f44009c8e55001581c60a18df0dbd3b06d,1,Andrii Tkach,2015-01-20 17:03:45+02:00,['aff6fc825d773c0cbf338a4df1aaad0050de6ea7'],1,1,2,19684826,1,,,,18463
1abd35a7bd991e7e380aec2c8708d8d794fcb3cc,1,Nate Cole,2015-01-20 10:19:05-05:00,['3ec191f44009c8e55001581c60a18df0dbd3b06d'],65,319,384,19685210,10,0.557894737,1,0.936842105,18465
e9ecb672a3211582af984661e36a84de93c4b37a,1,aBabiichuk,2015-01-20 18:34:24+02:00,['1abd35a7bd991e7e380aec2c8708d8d794fcb3cc'],25,49,74,19685284,6,0.882352941,1,1,18465
3ae28d8b2c36d49958b936c0740302ab414eaaeb,1,Yusaku Sako,2015-01-20 10:01:23-08:00,['e9ecb672a3211582af984661e36a84de93c4b37a'],972,348,1320,19686604,6,0.877750611,0,0.063569682,18465
0898c7373c39247c413b806bb2f5ecc5ce6d1f66,1,tbeerbower,2015-01-20 13:44:48-05:00,['3ae28d8b2c36d49958b936c0740302ab414eaaeb'],35,229,264,19686868,10,0.885714286,0.928571429,0,18467
6b543ea139b4c68f77b51a00cee5a791ce0273bc,0,Siddharth Wagle,2015-01-20 12:54:01-08:00,['0898c7373c39247c413b806bb2f5ecc5ce6d1f66'],1,1,2,19686870,1,,,,18467
756a1037043b1ac4f400964dd8d5b2c147f4148c,1,Jaimin Jetly,2015-01-20 13:07:50-08:00,['6b543ea139b4c68f77b51a00cee5a791ce0273bc'],4485,4514,8999,19695869,3,,,,18467
8f30fc6a8db83448812cc729e648671aba48b60a,1,Artem Baranchuk,2015-01-20 23:13:13+02:00,['756a1037043b1ac4f400964dd8d5b2c147f4148c'],1,658,659,19696528,4,0,1,1,18469
350f551f3ea47f80857e229af21b9c3439f3ca12,1,Alex Antonenko,2015-01-21 00:15:47+02:00,['8f30fc6a8db83448812cc729e648671aba48b60a'],2,30,32,19696560,1,1,1,0.772727273,18469
10b76dc5a237512f693b2fdfa64227f7da3ad269,1,Alex Antonenko,2015-01-21 00:15:48+02:00,['350f551f3ea47f80857e229af21b9c3439f3ca12'],1,2,3,19696563,1,1,1,1,18469
c9619f1a9aeee260a5a6e0de059cecd449437ba0,1,Alex Antonenko,2015-01-21 00:15:49+02:00,['10b76dc5a237512f693b2fdfa64227f7da3ad269'],1,1,2,19696565,1,,,,18469
0e1d8bbb556e95d364e6524f8e98d5fcb0dc154e,1,Siddharth Wagle,2015-01-20 16:50:05-08:00,['c9619f1a9aeee260a5a6e0de059cecd449437ba0'],23,9,32,19696597,7,1,1,0,18469
1052efd85d86a80898cce31105e9d7c374050acd,1,Yusaku Sako,2015-01-20 21:33:16-08:00,['0e1d8bbb556e95d364e6524f8e98d5fcb0dc154e'],27,2767,2794,19699391,48,0.138358779,0.47519084,0.620229008,18488
e6816418e01a550971f65b9edf092a658a82bbb6,1,Andrii Tkach,2015-01-21 11:56:20+02:00,['1052efd85d86a80898cce31105e9d7c374050acd'],1,1,2,19699393,1,,,,18488
f3b73cd3a4dfaa5bbd097c7a9baa70b547757ecc,1,Andrew Onishuk,2015-01-21 13:37:51+02:00,['e6816418e01a550971f65b9edf092a658a82bbb6'],74,116,190,19699583,31,0.142857143,0.428571429,0.428571429,18488
ea9e63662cce6f3993918b11b35ded7c0f41c027,1,Lisnichenko Dmitro,2015-01-21 14:24:53+02:00,['f3b73cd3a4dfaa5bbd097c7a9baa70b547757ecc'],6,15,21,19699604,3,0,0,1,18488
80202b89e0525791b7b2a480e99981bfe343f17c,1,aBabiichuk,2015-01-21 14:27:37+02:00,['ea9e63662cce6f3993918b11b35ded7c0f41c027'],150,266,416,19700020,6,0.820359281,0.922155689,0.760479042,18488
7d09160d81f0affc8f7c10a7aac782d004b6050d,0,Andrew Onishuk,2015-01-21 14:45:57+02:00,['80202b89e0525791b7b2a480e99981bfe343f17c'],6,0,6,19700026,1,,,,18488
b2d57da6d5dc002fd74834e31b8569e16bd681e2,1,Andrii Tkach,2015-01-21 16:17:18+02:00,['7d09160d81f0affc8f7c10a7aac782d004b6050d'],80,104,184,19700210,5,1,0,,18488
2f41d19522b8851ce44a3b997388a62f7c7a7fa5,0,Vitaly Brodetskyi,2015-01-09 13:25:10+02:00,['b2d57da6d5dc002fd74834e31b8569e16bd681e2'],0,10,10,19700220,1,0,0,1,18488
153705a65f88b570563132ac40466272c5210ded,1,Dmytro Sen,2015-01-21 17:40:51+02:00,['2f41d19522b8851ce44a3b997388a62f7c7a7fa5'],5,20,25,19700245,1,0,0,1,18488
9c82bd8a3db14942d6937bcc229221ee2651d780,1,Andrii Tkach,2015-01-21 17:58:16+02:00,['153705a65f88b570563132ac40466272c5210ded'],10,28,38,19700283,3,0,1,1,18488
ec86b1b4f882cfbff3b123a60aec875524030233,1,Robert Levas,2015-01-21 11:20:51-05:00,['9c82bd8a3db14942d6937bcc229221ee2651d780'],220,582,802,19701085,6,0.751937984,1,0.914728682,18490
2f44c6aa5040de43c771ce7d0703fa89cabf9771,0,Andrii Tkach,2015-01-21 18:42:57+02:00,['ec86b1b4f882cfbff3b123a60aec875524030233'],2471,0,2471,19703556,24,0.429420505,0.315007429,0.016344725,18490
f5672d009a9dee25b6c1267b1b817f1c7a3e94cf,1,Alex Antonenko,2015-01-21 18:59:16+02:00,['2f44c6aa5040de43c771ce7d0703fa89cabf9771'],1,1,2,19703558,1,,,,18490
bc6f2c78552e5a21eaff72919d9b55d1dd79a290,1,Bob Nettleton,2015-01-21 12:03:48-05:00,['f5672d009a9dee25b6c1267b1b817f1c7a3e94cf'],14,213,227,19703785,4,0.069230769,0.1,1,18490
3b205d4f014eac27a07bdef5c521aa6936e675bf,0,Andrii Tkach,2015-01-21 19:14:07+02:00,['bc6f2c78552e5a21eaff72919d9b55d1dd79a290'],3,14,17,19703802,3,1,1,1,18490
8346c3c66fac384bf630b547e5493d4b2a7291d9,1,Alex Antonenko,2015-01-21 20:03:10+02:00,['3b205d4f014eac27a07bdef5c521aa6936e675bf'],34,379,413,19704215,9,0.353146853,0.968531469,0.895104895,18491
01a9f1776a64d92c1073e1c9364f035a86d5ae25,1,Robert Levas,2015-01-21 13:52:53-05:00,['8346c3c66fac384bf630b547e5493d4b2a7291d9'],352,992,1344,19705559,8,0.08801956,1,0.936430318,18492
e54801a51d47e50a670f0a89745aebecbec3033b,0,Robert Levas,2015-01-21 15:32:27-05:00,['01a9f1776a64d92c1073e1c9364f035a86d5ae25'],4,337,341,19705900,4,0,0,0.642857143,18492
d58b71624e2d38f3bd11609e30931aa934f83a68,0,Yusaku Sako,2015-01-21 13:27:52-08:00,['e54801a51d47e50a670f0a89745aebecbec3033b'],337,4,341,19706241,4,1,1,0.357142857,18492
72386bf020d7831a8c7278eb7927120e25fbecbf,1,Nate Cole,2015-01-21 16:32:01-05:00,['d58b71624e2d38f3bd11609e30931aa934f83a68'],39,70,109,19706350,6,0.375,1,0.875,18492
fe14f498e1e209c71306e42fbc1790757426d074,1,Lisnichenko Dmitro,2015-01-21 23:45:39+02:00,['72386bf020d7831a8c7278eb7927120e25fbecbf'],4,35,39,19706389,3,0.928571429,0.928571429,0.5,18492
07c78ba39989192d9942386c70f5bc8708cf5af0,1,Jaimin Jetly,2015-01-21 14:20:02-08:00,['fe14f498e1e209c71306e42fbc1790757426d074'],29,23,52,19706441,2,0,1,0,18492
fcc6a4ccf7bd4e49e5ad0d6062c0ce727183b4b2,0,John Speidel,2015-01-21 17:45:00-05:00,['07c78ba39989192d9942386c70f5bc8708cf5af0'],20,146,166,19706607,5,0.010526316,1,1,18492
aab897d57a9c53a66205421a64e3c265bfd231a0,1,Alejandro Fernandez,2015-01-21 16:11:19-08:00,['fcc6a4ccf7bd4e49e5ad0d6062c0ce727183b4b2'],191,460,651,19707258,27,0,0.529411765,1,18492
e606c9d810ccdbaed2aeb9a1d065aea942c14512,1,Yusaku Sako,2015-01-21 16:38:23-08:00,['aab897d57a9c53a66205421a64e3c265bfd231a0'],10,15,25,19707283,2,1,1,1,18492
2686976e85fbc9c701e6478f1f48b0b057d66579,1,Robert Levas,2015-01-21 21:09:28-05:00,['e606c9d810ccdbaed2aeb9a1d065aea942c14512'],1,51,52,19707335,2,0,0.970588235,1,18492
03171bb7dddcb89407d31624acc651decd044623,1,Srimanth Gunturi,2015-01-21 18:11:54-08:00,['2686976e85fbc9c701e6478f1f48b0b057d66579'],0,2,2,19707337,1,1,1,1,18492
382e1c6c65d5321c8655a4cb26e73d28e1499dad,1,Jaimin Jetly,2015-01-21 20:22:01-08:00,['03171bb7dddcb89407d31624acc651decd044623'],36,69,105,19707442,41,0,1,1,18492
8ebade7508563040c07516a1922bb578c9979e0d,1,Jayush Luniya,2015-01-21 22:44:07-08:00,['382e1c6c65d5321c8655a4cb26e73d28e1499dad'],221,131,352,19707794,24,0,0,1,18492
0dbcee2644a93e41bd0740b8d1a443d63a0e240b,0,Andrii Tkach,2015-01-22 13:33:15+02:00,['8ebade7508563040c07516a1922bb578c9979e0d'],1,7,8,19707802,1,,,,18492
752a52b2d5d3240128d42748bc543570d258d214,1,aBabiichuk,2015-01-22 15:59:54+02:00,['0dbcee2644a93e41bd0740b8d1a443d63a0e240b'],3,3,6,19707808,2,,,,18492
5f4adaa6cd57755a39ffdd6891bbac11a459931e,1,aBabiichuk,2015-01-22 15:59:56+02:00,['752a52b2d5d3240128d42748bc543570d258d214'],28,94,122,19707930,5,0.56097561,1,1,18493
11efa2f5580b28acb3484586c2f74d5b9adfc17d,1,aBabiichuk,2015-01-22 16:41:20+02:00,['5f4adaa6cd57755a39ffdd6891bbac11a459931e'],19,251,270,19708200,10,0.75,1,1,18493
92b05b9baeb87c58e6c1ef57751336e2e437722f,1,aBabiichuk,2015-01-22 16:57:22+02:00,['11efa2f5580b28acb3484586c2f74d5b9adfc17d'],5,3,8,19708208,2,0,0,0,18493
45407a22aeb782d75c7f07d63daf0a84cff575d3,0,Andrii Tkach,2015-01-22 17:11:55+02:00,['92b05b9baeb87c58e6c1ef57751336e2e437722f'],0,4,4,19708212,1,1,1,1,18493
603775cfef58cb10c68c2eddfc7712915f10a8c7,0,tbeerbower,2015-01-22 10:18:47-05:00,['45407a22aeb782d75c7f07d63daf0a84cff575d3'],1,22,23,19708235,2,1,1,0,18493
e14f3530fb7fbf86af475221ae1141e6032a43a8,1,Vitaly Brodetskyi,2015-01-10 13:07:55+02:00,['603775cfef58cb10c68c2eddfc7712915f10a8c7'],16,177,193,19708428,2,0,0.576576577,0.576576577,18493
6a552002d27cf79886edd8205faaba5d3469454c,0,Lisnichenko Dmitro,2015-01-22 17:24:11+02:00,['e14f3530fb7fbf86af475221ae1141e6032a43a8'],0,3,3,19708431,1,0,0,1,18493
3ba23d27c0aa284087a910e21928f119fc3d4228,1,aBabiichuk,2015-01-22 17:32:59+02:00,['6a552002d27cf79886edd8205faaba5d3469454c'],10,27,37,19708468,7,1,1,1,18493
8d4af57074607ce1b6d01fc2bf5b59c7e9cceeb8,1,Lisnichenko Dmitro,2015-01-22 18:11:20+02:00,['3ba23d27c0aa284087a910e21928f119fc3d4228'],6,13,19,19708487,6,0,1,1,18493
9f296a25c67db4c21b059b102785cd93482b38e8,1,Andrew Onishuk,2015-01-22 19:09:13+02:00,['8d4af57074607ce1b6d01fc2bf5b59c7e9cceeb8'],7,27,34,19708521,4,0,0.9,0.9,18493
f77be4c4df25aef336f00a7aa9bc0591b347dfb6,1,Dmytro Sen,2015-01-22 19:23:35+02:00,['9f296a25c67db4c21b059b102785cd93482b38e8'],15,231,246,19708767,2,0.618644068,0.805084746,1,18493
0edce3c4f275b2ebca042e1fd8fb877acb7c5336,1,Dmytro Sen,2015-01-22 19:23:35+02:00,['f77be4c4df25aef336f00a7aa9bc0591b347dfb6'],16,63,79,19708846,3,1,1,1,18493
ac240927ab0d836f0fd57df4589787b5799ce03c,0,Siddharth Wagle,2015-01-22 09:24:18-08:00,['0edce3c4f275b2ebca042e1fd8fb877acb7c5336'],3,9,12,19708858,2,,,,18493
373afaad7ff826ab7e1a284527e399fd033611bb,1,Siddharth Wagle,2015-01-22 12:10:10-08:00,['ac240927ab0d836f0fd57df4589787b5799ce03c'],15,40,55,19708913,7,0.047619048,0.047619048,1,18493
77ae28e8410ae2141c5140f8b72cca9e5e7983c8,0,Lisnichenko Dmitro,2015-01-22 22:30:07+02:00,['373afaad7ff826ab7e1a284527e399fd033611bb'],1,4,5,19708918,1,,,,18493
0a46a47eafe9e85331de237deca95f6ac06cb786,1,Bob Nettleton,2015-01-22 15:41:09-05:00,['77ae28e8410ae2141c5140f8b72cca9e5e7983c8'],1,142,143,19709061,2,0,1,1,18493
2e10a7528cc2b675702582636dd3cab12c1757f4,1,Alex Antonenko,2015-01-22 22:50:28+02:00,['0a46a47eafe9e85331de237deca95f6ac06cb786'],2,4,6,19709067,3,1,1,1,18493
1d01d35a6cc612ca4562371fa84e4a3064a05f91,1,Alex Antonenko,2015-01-22 22:50:29+02:00,['2e10a7528cc2b675702582636dd3cab12c1757f4'],8,25,33,19709100,2,1,1,1,18493
06277ee15a9fb451147237873f28371d1c0ab3c4,1,Lisnichenko Dmitro,2015-01-22 23:18:42+02:00,['1d01d35a6cc612ca4562371fa84e4a3064a05f91'],20,23,43,19709143,8,1,1,1,18493
08738a55d5558e0850ab6c6e33b5ef94a11932ee,1,Robert Levas,2015-01-22 16:30:00-05:00,['06277ee15a9fb451147237873f28371d1c0ab3c4'],1,7,8,19709151,2,0,0.166666667,1,18493
af5372656b9679b10e2792da8dd0ca4510ba1962,0,Siddharth Wagle,2015-01-22 13:33:50-08:00,['08738a55d5558e0850ab6c6e33b5ef94a11932ee'],3,14,17,19709168,2,0.333333333,1,1,18493
6110665c6ab2e126492e40d6ff99f2e3edf62b31,0,Srimanth Gunturi,2015-01-22 13:44:43-08:00,['af5372656b9679b10e2792da8dd0ca4510ba1962'],4,4,8,19709176,2,,,,18493
859279a37d098bd4da89ec2e7c08c837f8698f15,0,Robert Levas,2015-01-22 17:08:31-05:00,['6110665c6ab2e126492e40d6ff99f2e3edf62b31'],24,102,126,19709302,3,0,0.413793103,1,18493
943a16ba868b33a4e8aa0b8d31e822be93e2f9f5,1,Aleksandr Kovalenko,2015-01-23 00:31:33+02:00,['859279a37d098bd4da89ec2e7c08c837f8698f15'],239,68,307,19709609,14,0.610526316,0,0,18493
4a3e05a9d4bb9f1a8c714e5b707772d540caabe8,1,Yusaku Sako,2015-01-22 14:56:09-08:00,['943a16ba868b33a4e8aa0b8d31e822be93e2f9f5'],102,24,126,19709735,3,1,0.586206897,0,18493
49b43d1d1da75370dba4aaf7c2195b90ae9be5af,0,Srimanth Gunturi,2015-01-22 15:23:44-08:00,['4a3e05a9d4bb9f1a8c714e5b707772d540caabe8'],1,3,4,19709739,1,,,,18493
9260d4ee530e660f6ffeae1f9632042873ed66bf,1,Yusaku Sako,2015-01-22 16:52:53-08:00,['49b43d1d1da75370dba4aaf7c2195b90ae9be5af'],4,5,9,19709748,4,,,,18493
3985154fe7dab84276976b6761fa9442ee991fc1,1,Robert Levas,2015-01-22 19:54:08-05:00,['9260d4ee530e660f6ffeae1f9632042873ed66bf'],11,89,100,19709848,3,0,0.48,1,18493
c579d2747e01543bb5dd9bf6ed4e16a87fc7c4c7,0,Yusaku Sako,2015-01-22 17:52:42-08:00,['3985154fe7dab84276976b6761fa9442ee991fc1'],14,3,17,19709865,2,0.666666667,0,0,18493
c99ebb5cf0bed3f1bc1a44efa86628f4ec423b3f,0,Siddharth Wagle,2015-01-22 18:35:54-08:00,['c579d2747e01543bb5dd9bf6ed4e16a87fc7c4c7'],3,18,21,19709886,2,0.25,1,1,18493
ae49f7c9664178560428af227e769bcf63421d38,0,Srimanth Gunturi,2015-01-22 19:33:51-08:00,['c99ebb5cf0bed3f1bc1a44efa86628f4ec423b3f'],434,19,453,19710339,8,,,,18493
a964003c7f8c83b254d6279271fb3d1296091765,1,Srimanth Gunturi,2015-01-22 19:38:00-08:00,['ae49f7c9664178560428af227e769bcf63421d38'],488,463,951,19711290,8,1,1,1,18496
5ad79b9644f90c38efafd0b9084a9c22221bc82e,1,Srimanth Gunturi,2015-01-22 20:05:40-08:00,['a964003c7f8c83b254d6279271fb3d1296091765'],19,434,453,19711743,8,,,,18502
9906552a2a622b06fb188ba3f138085c81a14c16,0,Siddharth Wagle,2015-01-22 20:58:20-08:00,['5ad79b9644f90c38efafd0b9084a9c22221bc82e'],0,4,4,19711747,4,,,,18502
ba121b52301e03d263c5f1dbe1c26eb6a1884948,1,Andrii Tkach,2015-01-23 11:58:51+02:00,['9906552a2a622b06fb188ba3f138085c81a14c16'],8,2,10,19711757,4,0.166666667,0,0,18502
7a75ff614c5b5cd2c5cec4f97f832c734ac1dde8,0,aBabiichuk,2015-01-23 12:42:00+02:00,['ba121b52301e03d263c5f1dbe1c26eb6a1884948'],13,21,34,19711791,2,1,1,1,18502
91adc8dbf115de34641e0465be0379d8c0db11c1,1,aBabiichuk,2015-01-23 12:42:01+02:00,['7a75ff614c5b5cd2c5cec4f97f832c734ac1dde8'],43,56,99,19711890,9,1,0,1,18502
474cfcd3db4d686b8036e429976678bbe7dc5c92,0,tbeerbower,2015-01-23 06:20:11-05:00,['91adc8dbf115de34641e0465be0379d8c0db11c1'],47,138,185,19712075,4,0,1,0.860465116,18502
69bc4f02af367c8fe0299c61be54d66bd3bba6ee,1,aBabiichuk,2015-01-23 13:43:37+02:00,['474cfcd3db4d686b8036e429976678bbe7dc5c92'],18,159,177,19712252,3,1,1,1,18503
fddf04318cfc7e6111f433fcd47e99bdc652a49f,0,Andrew Onishuk,2015-01-23 15:09:14+02:00,['69bc4f02af367c8fe0299c61be54d66bd3bba6ee'],19,19,38,19712290,58,,,,18503
df55775367338cf52f4b222b2a765208f65a1ec6,0,Dmytro Sen,2015-01-23 15:43:42+02:00,['fddf04318cfc7e6111f433fcd47e99bdc652a49f'],5,30,35,19712325,2,0,0,0.5,18503
e44291fa5da0617dd2c8462dd1cfc806066991a0,0,Vitaly Brodetskyi,2015-01-11 12:10:06+02:00,['df55775367338cf52f4b222b2a765208f65a1ec6'],0,6,6,19712331,1,,,,18503
5d5fcaa818fe374bcb68e644eb336ee99087357e,0,aBabiichuk,2015-01-23 17:56:43+02:00,['e44291fa5da0617dd2c8462dd1cfc806066991a0'],1,1,2,19712333,1,,,,18503
e5622e26a64f062b83347bd9bb64015470db2114,0,tbeerbower,2015-01-23 11:39:13-05:00,['5d5fcaa818fe374bcb68e644eb336ee99087357e'],0,12,12,19712345,2,0.3,1,1,18503
a1e130fa1227d6f1d86d82aff877e7a68a882420,1,Yusaku Sako,2015-01-23 09:33:01-08:00,['e5622e26a64f062b83347bd9bb64015470db2114'],19,19,38,19712383,58,,,,18503
dcf47a45f9c5a05f1d6f279f408d37a7b11c78b6,1,Alex Antonenko,2015-01-23 19:48:43+02:00,['a1e130fa1227d6f1d86d82aff877e7a68a882420'],5,36,41,19712424,1,0,1,1,18503
731fe266192a35da113d65df9b2371bdf8c86dfa,1,Andrii Tkach,2015-01-23 20:24:59+02:00,['dcf47a45f9c5a05f1d6f279f408d37a7b11c78b6'],76,194,270,19712694,21,1,1,1,18503
eb7e11c639be80d89531232b202d44f25e1c2636,0,Mahadev Konar,2015-01-23 10:31:07-08:00,['731fe266192a35da113d65df9b2371bdf8c86dfa'],20,13,33,19712727,1,1,0,0,18503
b7613c0b3d6c64d6024d5158a6e7a299f86e0498,1,Srimanth Gunturi,2015-01-23 10:40:51-08:00,['eb7e11c639be80d89531232b202d44f25e1c2636'],3,14,17,19712744,4,1,1,1,18503
471b3c853dd8fd925107cb004e47965343e4df2d,1,Aleksandr Kovalenko,2015-01-23 20:48:32+02:00,['b7613c0b3d6c64d6024d5158a6e7a299f86e0498'],52,10,62,19712806,4,0.105263158,0.078947368,0,18503
acf9018a745b68a6e5e939ee71b86d60b986b7f7,1,Nate Cole,2015-01-23 14:07:20-05:00,['471b3c853dd8fd925107cb004e47965343e4df2d'],41,174,215,19713021,7,0.144329897,0.639175258,1,18503
ae95ee68f88f96eb8395b6fdd3e3c91abcbc2ac1,0,tbeerbower,2015-01-23 14:49:05-05:00,['acf9018a745b68a6e5e939ee71b86d60b986b7f7'],5,11,16,19713037,2,0.5,1,1,18503
8d785ce3d09fd7b1a0707cfcdb0dfa56f512115e,1,Srimanth Gunturi,2015-01-23 12:25:15-08:00,['ae95ee68f88f96eb8395b6fdd3e3c91abcbc2ac1'],36,79,115,19713152,13,1,1,1,18503
f7efd2b3af03a10ae04c96d8af91da2926e72d54,1,Dmytro Sen,2015-01-23 22:43:10+02:00,['8d785ce3d09fd7b1a0707cfcdb0dfa56f512115e'],1,121,122,19713274,4,0.484375,1,1,18504
9bb3bc007c927bca9d85af645eebd027f2c633c8,1,Dmytro Sen,2015-01-23 22:43:10+02:00,['f7efd2b3af03a10ae04c96d8af91da2926e72d54'],84,58,142,19713416,3,0,0,0.4375,18504
687996868df7773f4721b6232b6017f1e112ad18,0,Dmytro Sen,2015-01-23 22:51:32+02:00,['9bb3bc007c927bca9d85af645eebd027f2c633c8'],2,2,4,19713420,1,,,,18504
faa5b17b8b8054ea13e4878eac6a245dfe56c294,1,Siddharth Wagle,2015-01-23 14:41:40-08:00,['687996868df7773f4721b6232b6017f1e112ad18'],1,5,6,19713426,1,1,1,1,18504
2adcc744b91aeafd751e0fb7d7afd19bbec52654,1,Myroslav Papirkovskyy,2015-01-24 01:00:28+02:00,['faa5b17b8b8054ea13e4878eac6a245dfe56c294'],3,4,7,19713433,2,1,1,0,18504
ccc58c1cdee2bfc49a57312820521d8d25dc4f36,1,Jaimin Jetly,2015-01-23 15:23:57-08:00,['2adcc744b91aeafd751e0fb7d7afd19bbec52654'],307,326,633,19714066,7,1,1,1,18504
49955a35971f723dcc8d4acee57fbd9d6bec58f5,1,Florian Barca,2015-01-23 17:36:55-08:00,['ccc58c1cdee2bfc49a57312820521d8d25dc4f36'],6547,4782,11329,19725395,23,0.670194004,0.695767196,0,18505
85f61a73e7f345673106410f972ba438aaa49a96,1,Alejandro Fernandez,2015-01-23 18:11:42-08:00,['49955a35971f723dcc8d4acee57fbd9d6bec58f5'],0,29,29,19725424,3,1,1,1,18505
244f1879eb70a63a0846352b305b4c2d21e96895,1,Florian Barca,2015-01-24 01:38:45-08:00,['85f61a73e7f345673106410f972ba438aaa49a96'],3379,2561,5940,19731364,19,1,1,0,18509
cdc7fee38736612c6ec20d3c900172146afbdbae,1,Alex Antonenko,2015-01-24 11:59:11+02:00,['244f1879eb70a63a0846352b305b4c2d21e96895'],1,1,2,19731366,1,,,,18509
c0167f89d7c293f39f62fbf9df0b6640bde25b51,1,Yusaku Sako,2015-01-24 07:24:49-08:00,['cdc7fee38736612c6ec20d3c900172146afbdbae'],3,3,6,19731372,2,,,,18509
48a759ccec2090ed686e8ae775f7fbc786804b55,1,Alex Antonenko,2015-01-24 18:16:24+02:00,['c0167f89d7c293f39f62fbf9df0b6640bde25b51'],3,14,17,19731389,1,0,0,1,18509
3449ef33fd4e29934228a9acdd1ac16a0a23f9af,1,Aleksandr Kovalenko,2015-01-24 19:32:51+02:00,['48a759ccec2090ed686e8ae775f7fbc786804b55'],26,87,113,19731502,5,1,1,1,18509
0395706b6cd6d7e31002a7baaf31c1ecd13e72e9,1,Alex Antonenko,2015-01-24 21:02:23+02:00,['3449ef33fd4e29934228a9acdd1ac16a0a23f9af'],4,83,87,19731589,5,0,0.842105263,1,18509
c101ddfea9f98cb16732cc5b368d5a126d7a8c82,1,Andrew Onishuk,2015-01-25 19:09:35+02:00,['0395706b6cd6d7e31002a7baaf31c1ecd13e72e9'],0,5,5,19731594,1,,,,18509
b4dbd5df0c32e80a86fabaac22f0fb3f43fc2157,1,Aleksandr Kovalenko,2015-01-25 22:23:43+02:00,['c101ddfea9f98cb16732cc5b368d5a126d7a8c82'],1,18,19,19731613,1,1,1,1,18509
736511f001596ce86fd0cb99eda0fa0d0a49db63,1,Oleg Nechiporenko,2015-01-26 12:14:51+02:00,['b4dbd5df0c32e80a86fabaac22f0fb3f43fc2157'],65,70,135,19731748,2,1,1,0,18509
257c2cf62188e185f43042e6233ebb8a84f30619,1,aBabiichuk,2015-01-26 12:35:25+02:00,['736511f001596ce86fd0cb99eda0fa0d0a49db63'],16,27,43,19731791,2,1,1,1,18509
03456c57d211179a11a76f9c9cc923bc162fba58,1,Andrii Tkach,2015-01-26 15:21:45+02:00,['257c2cf62188e185f43042e6233ebb8a84f30619'],28,115,143,19731934,7,1,0,1,18509
7552355ce0223313e2bbc34a7c8b7d27786ec831,1,Dmytro Sen,2015-01-26 16:20:38+02:00,['03456c57d211179a11a76f9c9cc923bc162fba58'],16,51,67,19732001,2,0.060606061,0.484848485,0.484848485,18509
d8dc285a5c5499e70ff14154889c1ec6d1f30ddc,1,Andrew Onishuk,2015-01-26 16:44:15+02:00,['7552355ce0223313e2bbc34a7c8b7d27786ec831'],85,25,110,19732111,4,1,0,0.081632653,18509
6c649d0a70d2fe7a6bee99d2f0e7d2c6b986d42f,1,Nate Cole,2015-01-26 10:55:22-05:00,['d8dc285a5c5499e70ff14154889c1ec6d1f30ddc'],209,256,465,19732576,12,0,0,1,18511
688656c673eafa9c2730be9cdda2dff5d249a252,0,Andrii Tkach,2015-01-26 18:22:38+02:00,['6c649d0a70d2fe7a6bee99d2f0e7d2c6b986d42f'],0,2,2,19732578,2,1,1,1,18511
f28c64f8d2cdec200360f8c6c7f09e97c0aa11f0,0,Andrii Tkach,2015-01-26 18:40:07+02:00,['688656c673eafa9c2730be9cdda2dff5d249a252'],2,2,4,19732582,1,,,,18511
6a4925f5904e5319677ea80ae3c42b22c5fd13ea,1,Aleksandr Kovalenko,2015-01-26 19:29:43+02:00,['f28c64f8d2cdec200360f8c6c7f09e97c0aa11f0'],37,41,78,19732660,1,,,,18511
dc4c216c9366048011acbd8e1bf0e2713c74db6a,1,aBabiichuk,2015-01-26 19:57:14+02:00,['6a4925f5904e5319677ea80ae3c42b22c5fd13ea'],2,2,4,19732664,1,,,,18511
6a70baa2a0ef444444f933584a8cf3a8c1a79074,1,Andrew Onishuk,2015-01-26 20:14:09+02:00,['dc4c216c9366048011acbd8e1bf0e2713c74db6a'],1,6,7,19732671,2,0,1,1,18511
ec99d75104343291b8f7629863f3efc66508c5b4,1,Andrii Tkach,2015-01-26 20:32:04+02:00,['6a70baa2a0ef444444f933584a8cf3a8c1a79074'],230,72,302,19732973,4,0.673076923,1,1,18511
e803670a89a91b60d2f3d963a4105ec4da599021,1,Mahadev Konar,2015-01-26 10:58:01-08:00,['ec99d75104343291b8f7629863f3efc66508c5b4'],1,37,38,19733011,2,0.03030303,1,0.96969697,18511
694ca91fd57665c8f2a60d1fc675165bea5481fe,1,Mahadev Konar,2015-01-26 11:59:07-08:00,['e803670a89a91b60d2f3d963a4105ec4da599021'],9,15,24,19733035,2,0,0,0,18511
bb36d2a3b345063339752eb6ff8493ba90294477,1,Mahadev Konar,2015-01-26 12:03:43-08:00,['694ca91fd57665c8f2a60d1fc675165bea5481fe'],2,2,4,19733039,2,,,,18511
5cef47f44d99a33945a44cf8d8b830ab8f8cb930,1,Jonathan Hurley,2015-01-26 16:50:50-05:00,['bb36d2a3b345063339752eb6ff8493ba90294477'],21,369,390,19733429,4,0,0.903225806,0.096774194,18512
862a176d4a9fb0ee2b9a9076a281a86e9099d2b7,1,Robert Levas,2015-01-26 18:47:37-05:00,['5cef47f44d99a33945a44cf8d8b830ab8f8cb930'],180,19,199,19733628,4,1,1,1,18512
50d8c783dee911fadccc6f68fb0ce45ae7b7beb5,1,Yusaku Sako,2015-01-26 16:31:20-08:00,['862a176d4a9fb0ee2b9a9076a281a86e9099d2b7'],25,53,78,19733706,5,1,1,1,18512
f296ba851494ec9cb876e52f1ece6ed74592ca7d,1,Yusaku Sako,2015-01-26 16:31:20-08:00,['50d8c783dee911fadccc6f68fb0ce45ae7b7beb5'],231,619,850,19734556,30,0.182320442,0.988950276,0.906077348,18513
e44e73ed8d728d5fce407b25e4288795fac2e010,1,aBabiichuk,2015-01-27 10:22:03+02:00,['f296ba851494ec9cb876e52f1ece6ed74592ca7d'],23,59,82,19734638,7,0.944444444,1,1,18513
7458ff226911a6987a397ce1bbe97b64768e4f70,1,aBabiichuk,2015-01-27 11:20:03+02:00,['e44e73ed8d728d5fce407b25e4288795fac2e010'],2,9,11,19734649,3,1,1,1,18513
57b382598920527c4335081cea0fa1a3b54e041c,1,Andrew Onishuk,2015-01-27 13:57:44+02:00,['7458ff226911a6987a397ce1bbe97b64768e4f70'],0,11,11,19734660,1,,,,18513
d2f332603410d119ec02db384ac1be567e22040a,1,Andrew Onishuk,2015-01-27 13:58:56+02:00,['57b382598920527c4335081cea0fa1a3b54e041c'],3,7,10,19734670,3,0,0.333333333,1,18513
02190c4f38ba95353730b7cc210d08979d4cb40e,1,Andrii Tkach,2015-01-27 14:17:05+02:00,['d2f332603410d119ec02db384ac1be567e22040a'],5,5,10,19734680,1,0,0,0,18513
97de6e8c40d9cb67de5a34c69ba9c5be43f35cb6,1,Dmytro Sen,2015-01-27 14:36:08+02:00,['02190c4f38ba95353730b7cc210d08979d4cb40e'],38,30,68,19734748,5,1,0,1,18513
e50a1a6a08369dc7952da8cb1bb4d315b8ace956,0,Dmytro Sen,2015-01-27 14:36:08+02:00,['97de6e8c40d9cb67de5a34c69ba9c5be43f35cb6'],1,1,2,19734750,1,,,,18513
9fbcce8a36e5f50db0be847eae882695a1dddebd,1,Robert Levas,2015-01-27 08:02:01-05:00,['e50a1a6a08369dc7952da8cb1bb4d315b8ace956'],82,266,348,19735098,10,1,0.816666667,0.6,18515
68b35a509bccb35cdf32ed34a376d98dde10e915,1,Andrew Onishuk,2015-01-27 15:29:17+02:00,['9fbcce8a36e5f50db0be847eae882695a1dddebd'],5,22,27,19735125,4,0,0,1,18515
08783b6cb01915518355c850a3f91e28ec108c90,0,Vitaly Brodetskyi,2015-01-15 11:32:34+02:00,['68b35a509bccb35cdf32ed34a376d98dde10e915'],517,0,517,19735642,2,,,,18515
2bb1eb2ae9bec3dad5bd3f01af0472256949d239,1,Vitaly Brodetskyi,2015-01-15 11:46:12+02:00,['08783b6cb01915518355c850a3f91e28ec108c90'],1,2,3,19735645,1,1,1,1,18515
a913b50edc54a63b0999bdc2fb6e86dafce74b7e,1,Andrew Onishuk,2015-01-27 16:43:25+02:00,['2bb1eb2ae9bec3dad5bd3f01af0472256949d239'],0,2,2,19735647,2,0,1,1,18515
77ad3fec511c7e29b85daef03788ad685e748532,0,Dmytro Sen,2015-01-27 17:16:40+02:00,['a913b50edc54a63b0999bdc2fb6e86dafce74b7e'],22,10,32,19735679,1,1,0,1,18515
085079036e460a677ac4d83e8265e526ac0db5b2,1,Dmytro Sen,2015-01-27 17:26:31+02:00,['77ad3fec511c7e29b85daef03788ad685e748532'],1,1,2,19735681,1,,,,18515
abdeefd52a3996c77f96c909244b76da401af394,1,tbeerbower,2015-01-27 10:30:01-05:00,['085079036e460a677ac4d83e8265e526ac0db5b2'],7,38,45,19735726,2,0,1,1,18515
c8d39fbcdbca647f89177d21a69c4fd4e32d25fb,1,Andrii Tkach,2015-01-27 17:57:14+02:00,['abdeefd52a3996c77f96c909244b76da401af394'],44,75,119,19735845,9,0,0.058823529,1,18515
f1f3e39717f3f4845acb685f4050706283253dcc,1,Andrii Tkach,2015-01-27 17:57:15+02:00,['c8d39fbcdbca647f89177d21a69c4fd4e32d25fb'],0,8,8,19735853,1,,,,18515
fcb317ae42480d0ab7f1167973c6bf55e4a13659,1,Aleksandr Kovalenko,2015-01-27 18:09:58+02:00,['f1f3e39717f3f4845acb685f4050706283253dcc'],2,14,16,19735869,2,1,1,0,18515
cb1cd6b0d08f989062cfd7baa2db076617d00d02,1,Robert Levas,2015-01-27 12:34:49-05:00,['fcb317ae42480d0ab7f1167973c6bf55e4a13659'],0,3,3,19735872,1,0,1,0,18515
39a8b24c4b15801eb692e0cd2c95bcf98e92d64b,1,Robert Levas,2015-01-27 13:21:20-05:00,['cb1cd6b0d08f989062cfd7baa2db076617d00d02'],12,91,103,19735975,3,0,0.8,0.830769231,18515
59711d3369e797198755f24cdfce5cc0094f63d3,1,Nate Cole,2015-01-27 13:35:38-05:00,['39a8b24c4b15801eb692e0cd2c95bcf98e92d64b'],24,52,76,19736051,2,0,0,1,18515
14852dc8a75d137b362668d546dfb0af141f354b,0,Nate Cole,2015-01-27 13:58:31-05:00,['59711d3369e797198755f24cdfce5cc0094f63d3'],9,22,31,19736082,2,0,0,1,18515
b624ce91476ebe227d4608c756d3fb56ebad390f,0,Florian Barca,2015-01-27 11:33:47-08:00,['14852dc8a75d137b362668d546dfb0af141f354b'],2,25,27,19736109,1,0,0,0,18515
46b23d40b4397de7b7a81086b183d3aad638f7d5,0,Robert Levas,2015-01-27 14:34:51-05:00,['b624ce91476ebe227d4608c756d3fb56ebad390f'],32,203,235,19736344,8,0,0.491071429,0.821428571,18515
4cbf3a876bafcea62cd2e84062523b5088b3ab42,1,Yusaku Sako,2015-01-27 12:44:24-08:00,['46b23d40b4397de7b7a81086b183d3aad638f7d5'],815,1619,2434,19738778,26,0,0.273743017,0.703910615,18518
f27c22b0c57c1b48ba372abb0c0fa6b74f6eda0e,1,Florian Barca,2015-01-27 15:17:23-08:00,['4cbf3a876bafcea62cd2e84062523b5088b3ab42'],35,30,65,19738843,8,1,1,0,18518
5c1537babf1e5953f855cdb65e609be54c002eb4,0,Jayush Luniya,2015-01-27 15:37:43-08:00,['f27c22b0c57c1b48ba372abb0c0fa6b74f6eda0e'],0,1,1,19738844,1,1,1,1,18518
c242beeac73c071da2502ab8f1884ea723fafa2a,1,Alejandro Fernandez,2015-01-27 15:49:06-08:00,['5c1537babf1e5953f855cdb65e609be54c002eb4'],119,351,470,19739314,15,0.766666667,0.766666667,0,18520
1dd3ad2178dc1b1a11511ce163a64aa78d3dfdd7,1,John Speidel,2015-01-27 19:37:16-05:00,['c242beeac73c071da2502ab8f1884ea723fafa2a'],24,436,460,19739774,4,0.326829268,0,0,18520
5e930e44c8412cab73554a8ab17c13b32f5bb630,0,John Speidel,2015-01-27 19:49:27-05:00,['1dd3ad2178dc1b1a11511ce163a64aa78d3dfdd7'],1,1,2,19739776,1,,,,18520
c0ed966ff78f1d24dba6820463b9d728e02af615,1,Andrii Tkach,2015-01-28 13:31:30+02:00,['5e930e44c8412cab73554a8ab17c13b32f5bb630'],19,8,27,19739803,6,0,1,0,18520
b11fe88106811cb7ae7a073191028f61ce680db0,1,tbeerbower,2015-01-28 08:31:06-05:00,['c0ed966ff78f1d24dba6820463b9d728e02af615'],341,966,1307,19741110,8,0.378205128,0.996794872,1,18522
c915d2c31b282d7890f1e76d7b00e7892f3b7dc2,1,aBabiichuk,2015-01-28 15:32:40+02:00,['b11fe88106811cb7ae7a073191028f61ce680db0'],5,357,362,19741472,2,0.163888889,1,1,18522
f0f5c28d4681208691a7a9ca8ea6459ff383d5f4,1,Andrii Tkach,2015-01-28 15:36:20+02:00,['c915d2c31b282d7890f1e76d7b00e7892f3b7dc2'],3,33,36,19741508,3,1,1,1,18522
d88dfe6cf9c6f46330ea71cd225d897b7a8178f3,1,Nate Cole,2015-01-28 08:56:19-05:00,['f0f5c28d4681208691a7a9ca8ea6459ff383d5f4'],13,88,101,19741609,15,0.175,0.05,0.95,18522
ed03ce07abd015c3caac69e54719fbda4bb8b8b2,1,Myroslav Papirkovskyy,2015-01-28 17:24:53+02:00,['d88dfe6cf9c6f46330ea71cd225d897b7a8178f3'],15,86,101,19741710,6,,,,18522
dafcd4510cbd9df7960d1bcac09c7d320e207655,1,Lisnichenko Dmitro,2015-01-28 17:35:21+02:00,['ed03ce07abd015c3caac69e54719fbda4bb8b8b2'],1,105,106,19741816,2,0,0.985294118,1,18522
760e15583369b0834abac92e3a2ea321328f62cd,1,Florian Barca,2015-01-28 08:29:42-08:00,['dafcd4510cbd9df7960d1bcac09c7d320e207655'],16,77,93,19741909,5,0.117647059,0.764705882,1,18522
62e0a5952aadf04f17843f347a64d1ed5d7bb470,1,Myroslav Papirkovskyy,2015-01-28 18:49:18+02:00,['760e15583369b0834abac92e3a2ea321328f62cd'],32,44,76,19741985,1,0.2,1,0,18522
2ea7209c147ed6d90ecab3ad213b4b72f6654ac3,1,Vitaly Brodetskyi,2015-01-28 18:50:40+02:00,['62e0a5952aadf04f17843f347a64d1ed5d7bb470'],7,7,14,19741999,4,,,,18522
9c1e3a9d7843842b94b353cf20724a9312729a82,1,Vitaly Brodetskyi,2015-01-28 19:44:07+02:00,['2ea7209c147ed6d90ecab3ad213b4b72f6654ac3'],4,3,7,19742006,1,0,0,1,18522
6b0e4a90cde498d47789353134157190025b288b,1,Robert Levas,2015-01-28 12:53:20-05:00,['9c1e3a9d7843842b94b353cf20724a9312729a82'],2,4,6,19742012,2,0,0.5,1,18522
dad9c2bc95835a7c85211e148a02362ace15ccdd,1,Andrew Onishuk,2015-01-28 20:12:28+02:00,['6b0e4a90cde498d47789353134157190025b288b'],5,11,16,19742028,3,0,0,1,18522
2919506e4bfd2d019d7409c7b22d6ff4841749b4,1,Andrew Onishuk,2015-01-28 20:13:26+02:00,['dad9c2bc95835a7c85211e148a02362ace15ccdd'],8,7,15,19742043,1,,,,18522
1ce3af0a52542408ccc57cf1cf350ffa03fb4f91,1,Lisnichenko Dmitro,2015-01-28 20:59:38+02:00,['2919506e4bfd2d019d7409c7b22d6ff4841749b4'],122,6,128,19742171,2,1,0.268041237,0,18522
4884a307ac6a823a1f670c421916f84b71ebe74b,1,Alex Antonenko,2015-01-28 21:11:02+02:00,['1ce3af0a52542408ccc57cf1cf350ffa03fb4f91'],3,11,14,19742185,2,1,1,1,18522
454b31fd299aff30d60dda9d6bef05e4e2345973,0,Robert Levas,2015-01-28 14:14:15-05:00,['4884a307ac6a823a1f670c421916f84b71ebe74b'],7,7,14,19742199,3,,,,18522
640a283aef3b0e616dbe9c2ff21402af47d23282,1,Jayush Luniya,2015-01-28 11:20:32-08:00,['454b31fd299aff30d60dda9d6bef05e4e2345973'],11,19,30,19742229,5,0.375,1,0.625,18522
86dc9394c90e282b2e2dd562193dedb995e3000a,1,Srimanth Gunturi,2015-01-28 14:38:25-08:00,['640a283aef3b0e616dbe9c2ff21402af47d23282'],201,90,291,19742520,14,0.86746988,0,0,18522
23d506e2aec743f129aaa48a7a1619be9d33910a,1,Jonathan Hurley,2015-01-28 18:32:55-05:00,['86dc9394c90e282b2e2dd562193dedb995e3000a'],1857,1540,3397,19745917,5,0.934599156,0.069620253,0,18523
63bc3f7d53c9e3af55cbb081f2e393733544f5a8,1,Srimanth Gunturi,2015-01-28 16:50:42-08:00,['23d506e2aec743f129aaa48a7a1619be9d33910a'],2,3,5,19745922,1,,,,18523
438980d3a6fad82983bf8d2a35c49e0640b55e81,1,Robert Levas,2015-01-28 23:21:48-05:00,['63bc3f7d53c9e3af55cbb081f2e393733544f5a8'],9,223,232,19746154,6,0,0.541935484,0.477419355,18523
c67010d63d507a295d2d016cc8c2263a0b488cff,0,aBabiichuk,2015-01-29 09:30:12+02:00,['438980d3a6fad82983bf8d2a35c49e0640b55e81'],1,1,2,19746156,1,,,,18523
8e94e205931eb7e1683512aa8f5efa36845e1b2c,0,Jayush Luniya,2015-01-29 00:32:58-08:00,['c67010d63d507a295d2d016cc8c2263a0b488cff'],0,8,8,19746164,3,0,1,1,18523
8b79e4326036db64d6e7a70f0590ef5a70183dd6,1,Artem Baranchuk,2015-01-29 12:17:10+02:00,['8e94e205931eb7e1683512aa8f5efa36845e1b2c'],31,324,355,19746519,12,0.411764706,0.411764706,1,18530
4497f00cc76ed6a99b69111a743038619aa7ab63,1,Artem Baranchuk,2015-01-29 12:17:11+02:00,['8b79e4326036db64d6e7a70f0590ef5a70183dd6'],40,541,581,19747100,22,0.505617978,1,1,18541
fd06b4f929af9ca078a36c9b0de9fd74d16ff2a0,1,Vitaly Brodetskyi,2015-01-29 13:00:15+02:00,['4497f00cc76ed6a99b69111a743038619aa7ab63'],0,4,4,19747104,1,0,0,1,18541
ad73c195b2f9b2ba7ff1a9bdde16d85f9785154d,1,aBabiichuk,2015-01-29 15:13:27+02:00,['fd06b4f929af9ca078a36c9b0de9fd74d16ff2a0'],5,605,610,19747714,6,0.655172414,0.448275862,1,18541
be9e4fb32f5c1230bae31b74d2ad2496714122d2,1,Andrii Tkach,2015-01-29 16:35:17+02:00,['ad73c195b2f9b2ba7ff1a9bdde16d85f9785154d'],3,17,20,19747734,2,1,1,1,18541
e3fccc2da9e3eaae3cef6e9e4c1789101c4bdf14,0,Andrii Tkach,2015-01-29 16:35:18+02:00,['be9e4fb32f5c1230bae31b74d2ad2496714122d2'],0,59,59,19747793,4,0.25,1,1,18541
423f8fc37e96208ebb15fcf83d8aed64851298fa,1,Andrii Tkach,2015-01-29 16:35:19+02:00,['e3fccc2da9e3eaae3cef6e9e4c1789101c4bdf14'],6,6,12,19747805,3,,,,18541
a16e37ee90c0a2bfa2a9b02ee1fd2529c7609d02,0,aBabiichuk,2015-01-29 16:36:46+02:00,['423f8fc37e96208ebb15fcf83d8aed64851298fa'],0,3,3,19747808,1,0,0,1,18541
78d0af1b8c0a8686b731d112183f9261479aadbb,1,tbeerbower,2015-01-29 10:24:02-05:00,['a16e37ee90c0a2bfa2a9b02ee1fd2529c7609d02'],38,81,119,19747927,5,0.714285714,0,0,18541
aa27096762ddab99f16b150ecb67e9c86bac74d1,1,Lisnichenko Dmitro,2015-01-29 18:22:37+02:00,['78d0af1b8c0a8686b731d112183f9261479aadbb'],5,18,23,19747950,2,0.363636364,0.454545455,0.909090909,18541
d2af57f63dbd6839eaae1d408e4c2425e8bb58f0,1,Andrew Onishuk,2015-01-29 19:14:06+02:00,['aa27096762ddab99f16b150ecb67e9c86bac74d1'],2,6,8,19747958,3,,,,18541
3d744e879f194a72aaf300db8038b40535a662ce,1,Aleksandr Kovalenko,2015-01-29 19:40:42+02:00,['d2af57f63dbd6839eaae1d408e4c2425e8bb58f0'],117,362,479,19748437,7,0.456896552,1,0.982758621,18541
899ead72d3a567092c8d7258d7d84c9f3f47af45,0,Jayush Luniya,2015-01-29 10:01:47-08:00,['3d744e879f194a72aaf300db8038b40535a662ce'],0,2,2,19748439,1,,,,18541
79aced6395abc28d868fe0b688ba46f04fb6a0cc,1,Lisnichenko Dmitro,2015-01-29 20:21:56+02:00,['899ead72d3a567092c8d7258d7d84c9f3f47af45'],6,9,15,19748454,2,0,0,1,18541
a4f16b954759145f7cf5a0e5c492e3e9ba6c6312,1,Florian Barca,2015-01-29 13:31:02-08:00,['79aced6395abc28d868fe0b688ba46f04fb6a0cc'],47,71,118,19748572,7,1,1,1,18541
72dcffc313b022be819ec5df9b2bfa7c5fe94fe0,1,Jonathan Hurley,2015-01-29 17:17:02-05:00,['a4f16b954759145f7cf5a0e5c492e3e9ba6c6312'],20,2527,2547,19751119,9,0.41025641,1,0,18545
876b1969c126e49f37e0163490bd5f6def3c3fe4,1,Alex Antonenko,2015-01-30 11:24:30+02:00,['72dcffc313b022be819ec5df9b2bfa7c5fe94fe0'],162,147,309,19751428,20,0,0,0,18546
bfa0e4aec8279db13afc4cb55e7919591894f1c4,1,Lisnichenko Dmitro,2015-01-30 13:23:51+02:00,['876b1969c126e49f37e0163490bd5f6def3c3fe4'],13,10,23,19751451,1,1,1,0,18546
cb4df42ff706c6b05590b6951149504269db509c,1,Aleksandr Kovalenko,2015-01-30 13:54:40+02:00,['bfa0e4aec8279db13afc4cb55e7919591894f1c4'],13,28,41,19751492,3,1,1,1,18546
30e4917970dc0dd7f27a1a443775bd273bb87186,1,aBabiichuk,2015-01-30 14:40:31+02:00,['cb4df42ff706c6b05590b6951149504269db509c'],2,53,55,19751547,3,1,1,1,18546
b2f392d8fc5fecd4753aff17f97b84bddac826c3,1,Aleksandr Kovalenko,2015-01-30 17:51:21+02:00,['30e4917970dc0dd7f27a1a443775bd273bb87186'],0,175,175,19751722,3,0.205673759,1,1,18547
ee4e786a4daf639da34ea81a7ff1a11f3dad378f,1,John Speidel,2015-01-30 11:54:39-05:00,['b2f392d8fc5fecd4753aff17f97b84bddac826c3'],59,607,666,19752388,7,0.419847328,1,0.709923664,18547
4e80ff992fdf4132d166e3ab16c89f62accdbbeb,1,Andrii Tkach,2015-01-30 19:03:59+02:00,['ee4e786a4daf639da34ea81a7ff1a11f3dad378f'],4,48,52,19752440,2,1,1,1,18547
a116498e92babd241f2bc083bb1ef2325f4ca3d7,1,Robert Levas,2015-01-30 12:46:44-05:00,['4e80ff992fdf4132d166e3ab16c89f62accdbbeb'],18,435,453,19752893,5,0.126279863,0.204778157,0.266211604,18547
f1bc1bdad427e8d81d3f3776e80f8b8ed73cf218,1,aBabiichuk,2015-01-30 20:08:10+02:00,['a116498e92babd241f2bc083bb1ef2325f4ca3d7'],37,81,118,19753011,12,0,0,0,18547
326238b8444a1389100fb44f1107518bb49a64b6,1,Alex Antonenko,2015-01-30 20:51:04+02:00,['f1bc1bdad427e8d81d3f3776e80f8b8ed73cf218'],29,61,90,19753101,6,0.214285714,1,1,18547
3e601aa3efb57b3fa6d0e87fb91deb43c66d8ada,0,Jayush Luniya,2015-01-30 10:55:34-08:00,['326238b8444a1389100fb44f1107518bb49a64b6'],0,6,6,19753107,1,,,,18547
d8997295d3ad692ce871ccb1759dc9c87d5ad7fa,0,Aleksandr Kovalenko,2015-01-31 01:38:50+02:00,['3e601aa3efb57b3fa6d0e87fb91deb43c66d8ada'],32,6,38,19753145,3,1,0,0,18547
082beafcb28d2e2b2c34349805ee97061a8eb103,1,Alejandro Fernandez,2015-01-30 16:36:05-08:00,['d8997295d3ad692ce871ccb1759dc9c87d5ad7fa'],80,220,300,19753445,7,0.413043478,0.782608696,0.869565217,18548
31243e45f4cdf98023e6761aea50a851229a79f7,1,Andrew Onishuk,2015-02-02 13:32:44+02:00,['082beafcb28d2e2b2c34349805ee97061a8eb103'],2,2,4,19753449,1,,,,18548
a0284cc33fa9a22359953103c0516222acb3757e,1,Andrew Onishuk,2015-02-02 13:32:45+02:00,['31243e45f4cdf98023e6761aea50a851229a79f7'],0,41,41,19753490,2,0.033333333,0.166666667,1,18548
cd03c327952b5683a945f21a6a1f8b9dbbddd81b,1,Vitaly Brodetskyi,2015-02-02 12:40:35+02:00,['a0284cc33fa9a22359953103c0516222acb3757e'],4,19,23,19753513,2,0,0.916666667,0.083333333,18548
40f7acc709075838a950e2d73119876fe5b094af,0,Andrew Onishuk,2015-02-02 15:27:12+02:00,['cd03c327952b5683a945f21a6a1f8b9dbbddd81b'],1,5,6,19753519,1,0,0,1,18548
d044490652c3c8f4bd5a0692a4d6ec95a88e72b9,1,Andrii Tkach,2015-02-02 15:36:22+02:00,['40f7acc709075838a950e2d73119876fe5b094af'],7,40,47,19753566,2,0.314285714,1,1,18548
65209687cd9729121bffff31d72c28fac51051ac,1,Andrii Tkach,2015-02-02 15:36:23+02:00,['d044490652c3c8f4bd5a0692a4d6ec95a88e72b9'],2,8,10,19753576,2,0,0,1,18548
594daa40637be1ed138c05d20e4df8c2b3d681cf,0,Artem Baranchuk,2015-02-02 17:42:37+02:00,['65209687cd9729121bffff31d72c28fac51051ac'],7,4,11,19753587,3,,,,18548
9b1a855b94259092dccdf36c4be05e7f86d7b464,1,Myroslav Papirkovskyy,2015-02-02 17:46:14+02:00,['594daa40637be1ed138c05d20e4df8c2b3d681cf'],120,122,242,19753829,5,1,1,1,18548
1767806a7eb272bcf95a84deebc063252d6797f2,0,Myroslav Papirkovskyy,2015-02-02 18:33:52+02:00,['9b1a855b94259092dccdf36c4be05e7f86d7b464'],7,1,8,19753837,2,,,,18548
91ff07e16e828c0471e00bf3a7ba3b6bb8fc5445,1,Jonathan Hurley,2015-02-02 12:33:26-05:00,['1767806a7eb272bcf95a84deebc063252d6797f2'],48,391,439,19754276,8,0.045454545,0.890909091,0.836363636,18548
d4faf0bc5ce4116d2bd0117321bc539b977b0b36,0,Alex Antonenko,2015-02-02 20:04:41+02:00,['91ff07e16e828c0471e00bf3a7ba3b6bb8fc5445'],1,1,2,19754278,1,,,,18548
b02773753bab196aa245af8a9cc36cb31877a17a,1,aBabiichuk,2015-02-02 20:11:44+02:00,['d4faf0bc5ce4116d2bd0117321bc539b977b0b36'],0,23,23,19754301,4,1,1,1,18548
ccdb917e2927b7cb42b713766f24960f79ea0bc1,1,aBabiichuk,2015-02-02 20:11:44+02:00,['b02773753bab196aa245af8a9cc36cb31877a17a'],25,21,46,19754347,1,,,,18548
0865f9e2f3fa465027b44bae3da0927ac727babb,1,aBabiichuk,2015-02-02 20:11:45+02:00,['ccdb917e2927b7cb42b713766f24960f79ea0bc1'],9,117,126,19754473,4,0.64516129,1,1,18549
dac85349e098afc76616a652246d86adb4c4e16e,1,Vitaly Brodetskyi,2015-02-02 19:20:15+02:00,['0865f9e2f3fa465027b44bae3da0927ac727babb'],97,143,240,19754713,2,0,0,1,18549
c0a7442550d49122e9f7d206d33f857e1d5d1efd,0,Andrii Tkach,2015-02-02 20:22:32+02:00,['dac85349e098afc76616a652246d86adb4c4e16e'],1,1,2,19754715,1,,,,18549
015d89b7cd827f2743a21a2b5bea6567d0800083,0,Vitaly Brodetskyi,2015-02-02 19:33:54+02:00,['c0a7442550d49122e9f7d206d33f857e1d5d1efd'],0,1,1,19754716,1,0,0,1,18549
44b2a5ccaa7b58878d19634acf364eb90a9ef34e,1,John Speidel,2015-02-02 16:52:26-05:00,['015d89b7cd827f2743a21a2b5bea6567d0800083'],29,90,119,19754835,3,0.368421053,0.157894737,0.842105263,18549
a2f3be6c9fcdc7387bb9b66e95698883ca72c6fb,0,Jayush Luniya,2015-02-02 17:51:23-08:00,['44b2a5ccaa7b58878d19634acf364eb90a9ef34e'],1,1,2,19754837,1,,,,18549
314ae0b10feb3ddb1884ff031d598627e0ba9977,1,Florian Barca,2015-02-02 18:23:07-08:00,['a2f3be6c9fcdc7387bb9b66e95698883ca72c6fb'],103,143,246,19755083,7,1,1,0,18549
b178920dda64edc3b9298e6d117fcc4047283230,1,Yusaku Sako,2015-02-02 18:52:59-08:00,['314ae0b10feb3ddb1884ff031d598627e0ba9977'],6,8,14,19755097,4,,,,18549
54230335ddd43a5f0271dc69ff5e0abdfcf4e6d2,1,Alejandro Fernandez,2015-02-02 19:20:16-08:00,['b178920dda64edc3b9298e6d117fcc4047283230'],5,10,15,19755112,2,,,,18549
edd8f0d165f0abcebf77f76b36f9e3fa58ac0c4f,1,aBabiichuk,2015-02-03 10:09:06+02:00,['54230335ddd43a5f0271dc69ff5e0abdfcf4e6d2'],43,11,54,19755166,2,,,,18549
28f65d747d4c6d69f4082a44e08a2ada35b702a4,0,Andrii Tkach,2015-02-03 13:02:48+02:00,['edd8f0d165f0abcebf77f76b36f9e3fa58ac0c4f'],0,2,2,19755168,2,0,1,1,18549
ab10cff01928bd7153d1d42258fa224ff9f8116d,0,Andrii Tkach,2015-02-03 13:03:09+02:00,['28f65d747d4c6d69f4082a44e08a2ada35b702a4'],1,1,2,19755170,1,,,,18549
58523e14a1403f55fd1b5e741e56933ce4d832ee,1,Aleksandr Kovalenko,2015-02-03 14:06:07+02:00,['ab10cff01928bd7153d1d42258fa224ff9f8116d'],15,7,22,19755192,3,1,1,0,18549
4406f938abb348ebdfce1e6f341b980b8269f986,0,Andrew Onishuk,2015-02-03 15:04:23+02:00,['58523e14a1403f55fd1b5e741e56933ce4d832ee'],1,2,3,19755195,1,0,0,1,18549
6533a7e66626f857161b965a7b3030ffabbe2ac4,0,Vitaly Brodetskyi,2015-02-03 14:24:26+02:00,['4406f938abb348ebdfce1e6f341b980b8269f986'],10,10,20,19755215,2,,,,18549
663d20249c43548013d78b55242b0de9920d5009,0,Andrew Onishuk,2015-02-03 16:49:56+02:00,['6533a7e66626f857161b965a7b3030ffabbe2ac4'],4,8,12,19755227,2,0,0.5,1,18549
ebea7966250a43418e03125a67b63ac8f0c6cf02,1,aBabiichuk,2015-02-03 17:04:29+02:00,['663d20249c43548013d78b55242b0de9920d5009'],35,124,159,19755386,10,0.901408451,0.61971831,1,18549
185e5d7fb833c66c840fb4a98e96f840433efb84,1,aBabiichuk,2015-02-03 17:18:02+02:00,['ebea7966250a43418e03125a67b63ac8f0c6cf02'],23,24,47,19755433,3,,,,18549
18136fb6e9d046692d68d864c1ba06e6c2e8e7e1,1,aBabiichuk,2015-02-03 17:23:22+02:00,['185e5d7fb833c66c840fb4a98e96f840433efb84'],0,10,10,19755443,1,,,,18549
02ccb17fab9357f0b130b5b127aebfc3b6fb2dd7,1,Robert Levas,2015-02-03 11:17:38-05:00,['18136fb6e9d046692d68d864c1ba06e6c2e8e7e1'],557,1134,1691,19757134,4,0,0.223350254,0.246192893,18549
15efecea882fdf3f5210107d021407baa9a0574e,1,Nate Cole,2015-02-03 11:29:31-05:00,['02ccb17fab9357f0b130b5b127aebfc3b6fb2dd7'],61,280,341,19757475,13,0.239316239,0.794871795,0.94017094,18549
c895c8a76ab48388036eddc5e3ee1cc6a50d5198,0,Aleksandr Kovalenko,2015-02-03 18:40:14+02:00,['15efecea882fdf3f5210107d021407baa9a0574e'],0,1,1,19757476,1,1,1,1,18549
dac9200e75d89714be470f9796ed21e7e94be477,1,Srimanth Gunturi,2015-02-03 10:25:20-08:00,['c895c8a76ab48388036eddc5e3ee1cc6a50d5198'],7,13,20,19757496,1,0,1,1,18549
714a006d865fd4f5a9509eaa0baae1e4c9af0bff,1,Alejandro Fernandez,2015-02-03 11:05:23-08:00,['dac9200e75d89714be470f9796ed21e7e94be477'],805,3217,4022,19761518,23,0.370165746,0.464088398,0.845303867,18554
5d833e324e61c7512d369c8717fbc29325c9879d,0,Alex Antonenko,2015-02-03 21:55:11+02:00,['714a006d865fd4f5a9509eaa0baae1e4c9af0bff'],9,9,18,19761536,1,,,,18554
90e05a9c55282b25ecfcb0ede443818b992d8f51,0,Jayush Luniya,2015-02-03 12:17:02-08:00,['5d833e324e61c7512d369c8717fbc29325c9879d'],0,15,15,19761551,1,1,1,1,18554
370d9272418d15edb3f0ea3fec5895005765e4fc,1,Nate Cole,2015-02-03 15:27:05-05:00,['90e05a9c55282b25ecfcb0ede443818b992d8f51'],107,232,339,19761890,8,0.426229508,0.459016393,0.704918033,18554
a4d96450030976bdad9f5607cbe0d4ba22a37de1,1,tbeerbower,2015-02-03 15:37:57-05:00,['370d9272418d15edb3f0ea3fec5895005765e4fc'],78,120,198,19762088,5,0,0.117647059,1,18554
373ff1137e8c0352181f9a603ac14500218ccd6c,1,Alex Antonenko,2015-02-03 23:06:54+02:00,['a4d96450030976bdad9f5607cbe0d4ba22a37de1'],3,67,70,19762158,3,1,1,1,18554
d128a0dc6f3298f613435762aecda5cce606ce4b,1,Lisnichenko Dmitro,2015-02-03 23:07:36+02:00,['373ff1137e8c0352181f9a603ac14500218ccd6c'],118,97,215,19762373,4,0,0,1,18554
fcdbadd59be9fdb2defed94567560b33f4b43905,1,Srimanth Gunturi,2015-02-03 13:31:27-08:00,['d128a0dc6f3298f613435762aecda5cce606ce4b'],12,45,57,19762430,2,0.121212121,1,1,18554
45d67f60f40d692cb28a5cbc1f6546b4107bb8a8,1,Srimanth Gunturi,2015-02-03 13:50:55-08:00,['fcdbadd59be9fdb2defed94567560b33f4b43905'],8,12,20,19762450,1,1,1,1,18554
5ff857cd2259c91286934ed522f54502d4f15fae,1,Florian Barca,2015-02-03 14:56:02-08:00,['45d67f60f40d692cb28a5cbc1f6546b4107bb8a8'],119,161,280,19762730,2,0.148148148,1,0.444444444,18554
d6c389c115194e6055f5e21fefdf389a4b5c586f,1,Robert Levas,2015-02-03 20:39:13-05:00,['5ff857cd2259c91286934ed522f54502d4f15fae'],602,643,1245,19763975,24,0.4375,1,1,18557
354998beb8cc7682b879803404f0eb9b40f11deb,1,Lisnichenko Dmitro,2015-02-04 11:49:20+02:00,['d6c389c115194e6055f5e21fefdf389a4b5c586f'],0,206,206,19764181,3,0.25,0.72826087,0.902173913,18558
63fb625e700aa503673786354b00afabdb5d1290,1,tbeerbower,2015-02-04 08:49:48-05:00,['354998beb8cc7682b879803404f0eb9b40f11deb'],1,3,4,19764185,1,0,0,1,18558
3beda060b31d1b5a359ff52567e12a00eb70147d,1,Jonathan Hurley,2015-02-04 09:48:40-05:00,['63fb625e700aa503673786354b00afabdb5d1290'],204,506,710,19764895,11,0.153333333,0.546666667,0.926666667,18558
3e69d3a75b74af3275a78eba01d65d68476b70b2,0,tbeerbower,2015-02-04 10:09:44-05:00,['3beda060b31d1b5a359ff52567e12a00eb70147d'],3,3,6,19764901,1,,,,18558
b8301188c9982e7c3a6e5bcb5e743bab59a6bfe9,1,Andrew Onishuk,2015-02-04 18:25:52+02:00,['3e69d3a75b74af3275a78eba01d65d68476b70b2'],18,24,42,19764943,4,0,0,0,18558
7316f1d147d02c608c314578eac736c11a88a14b,1,Alex Antonenko,2015-02-04 19:21:01+02:00,['b8301188c9982e7c3a6e5bcb5e743bab59a6bfe9'],1,3,4,19764947,1,1,1,0,18558
a89db038cedc95ae8bb4da449f918c93fcced4e2,1,Yusaku Sako,2015-02-04 10:12:25-08:00,['7316f1d147d02c608c314578eac736c11a88a14b'],9,74,83,19765030,12,0.936170213,1,0.829787234,18558
61a34e63ddf813d298a989543a94ad16679af34e,1,Andrew Onishuk,2015-02-04 20:50:26+02:00,['a89db038cedc95ae8bb4da449f918c93fcced4e2'],1,264,265,19765295,2,0.127906977,0.313953488,0,18559
0dd8d0932125ecdc51fd105c30ac41a5bc5d4f40,0,aBabiichuk,2015-02-04 21:26:03+02:00,['61a34e63ddf813d298a989543a94ad16679af34e'],0,2,2,19765297,1,,,,18559
9876a036cef5ff2e7e4144281d4ba27817c3dff4,1,Andrii Tkach,2015-02-05 11:26:08+02:00,['0dd8d0932125ecdc51fd105c30ac41a5bc5d4f40'],42,963,1005,19766302,14,0.973977695,1,1,18560
300890e878ca899f1aa84157bc68093b472a426e,1,Andrii Tkach,2015-02-05 11:26:09+02:00,['9876a036cef5ff2e7e4144281d4ba27817c3dff4'],1,1,2,19766304,1,,,,18560
55feab5fb19ff45d4e1c2fe807ac98ce7c36be51,1,aBabiichuk,2015-02-05 11:29:20+02:00,['300890e878ca899f1aa84157bc68093b472a426e'],123,528,651,19766955,9,1,1,1,18564
b8eb2d687c441463abc546a42b4a39fef7d5d562,0,aBabiichuk,2015-02-05 11:29:21+02:00,['55feab5fb19ff45d4e1c2fe807ac98ce7c36be51'],2,1,3,19766958,1,,,,18564
ecab2b40d4b196820263fc63701a1c9c0de05c62,1,aBabiichuk,2015-02-05 11:42:35+02:00,['b8eb2d687c441463abc546a42b4a39fef7d5d562'],158,62,220,19767178,8,0.048192771,0.253012048,0.012048193,18564
18c50aaae8c3f7f730f9da72473ec35755ff3afc,1,aBabiichuk,2015-02-05 12:00:22+02:00,['ecab2b40d4b196820263fc63701a1c9c0de05c62'],1,9,10,19767188,2,1,1,1,18564
e36b23166e4a40b456ded2bc72a7d045ad019175,0,Robert Levas,2015-02-05 07:54:01-05:00,['18c50aaae8c3f7f730f9da72473ec35755ff3afc'],29,406,435,19767623,16,0,0,1,18568
318bf835a31e6f3064ab39bbee0bb47961546e74,1,Nate Cole,2015-02-05 08:22:16-05:00,['e36b23166e4a40b456ded2bc72a7d045ad019175'],46,113,159,19767782,6,0.257142857,1,0.485714286,18568
72c8adfa42c25bb09c05460aa4acc4c7b1943e5e,0,tbeerbower,2015-02-05 10:25:58-05:00,['318bf835a31e6f3064ab39bbee0bb47961546e74'],69,108,177,19767959,2,0.580645161,0.580645161,0.806451613,18568
905abaf1cfb94e8d22e783f9e3b32c4d6c15b4e9,1,aBabiichuk,2015-02-05 17:39:22+02:00,['72c8adfa42c25bb09c05460aa4acc4c7b1943e5e'],2173,31,2204,19770163,95,0.425,0.233333333,0.008333333,18568
c7db1c5c62c24bd3f57fd34a5146ab5fe1ea639b,1,Jonathan Hurley,2015-02-05 11:02:36-05:00,['905abaf1cfb94e8d22e783f9e3b32c4d6c15b4e9'],20,2,22,19770185,3,0.6,0,0.6,18568
c52f70bcfdc207e7ea2dd4a5e8966855d631e61f,1,Andrew Onishuk,2015-02-05 18:54:06+02:00,['c7db1c5c62c24bd3f57fd34a5146ab5fe1ea639b'],9,9,18,19770203,4,,,,18568
1548d0a474c2f969921127b13351214d2c967219,0,Andrew Onishuk,2015-02-05 18:59:36+02:00,['c52f70bcfdc207e7ea2dd4a5e8966855d631e61f'],3,14,17,19770220,2,0,0.75,1,18568
419e45dc8dba555b59bf470c5a12f8b92a63544d,1,Srimanth Gunturi,2015-02-05 09:22:24-08:00,['1548d0a474c2f969921127b13351214d2c967219'],9,35,44,19770264,2,1,0,1,18568
ffbee7b2ec082a5c724d34bc7e3e9248c54a5837,1,Jayush Luniya,2015-02-05 09:52:11-08:00,['419e45dc8dba555b59bf470c5a12f8b92a63544d'],940,139,1079,19771343,20,0,0.444444444,1,18569
4aa80b9a7b48dfa446b2aa8195f87542b328d36a,1,Alejandro Fernandez,2015-02-05 10:00:10-08:00,['ffbee7b2ec082a5c724d34bc7e3e9248c54a5837'],14,56,70,19771413,8,0,1,1,18569
2ec1a8a35d4cf970ee5dbfd79691b39583736c5e,0,Alex Antonenko,2015-02-05 20:06:59+02:00,['4aa80b9a7b48dfa446b2aa8195f87542b328d36a'],2,2,4,19771417,2,,,,18569
c19d6d00e944f232f7988482581f285cc72342f9,1,Nate Cole,2015-02-05 13:09:52-05:00,['2ec1a8a35d4cf970ee5dbfd79691b39583736c5e'],32,32,64,19771481,1,,,,18569
8a6627ff23400299481ecc35c7b4727dfbe27c65,0,Andrew Onishuk,2015-02-05 21:34:31+02:00,['c19d6d00e944f232f7988482581f285cc72342f9'],1,1,2,19771483,1,,,,18569
f5c7f1eb17da4bfb26798edfa9000eed8434e5c3,1,Alejandro Fernandez,2015-02-05 12:07:17-08:00,['8a6627ff23400299481ecc35c7b4727dfbe27c65'],3,4,7,19771490,1,,,,18569
c6f4d069db63dec3361ecd63d8c2a3d08a4c78f6,0,Nate Cole,2015-02-05 16:23:08-05:00,['f5c7f1eb17da4bfb26798edfa9000eed8434e5c3'],1,1,2,19771492,1,,,,18569
de026eb5ece3459f45956a4b4ad85d383111973d,1,Artem Baranchuk,2015-02-06 01:10:28+02:00,['c6f4d069db63dec3361ecd63d8c2a3d08a4c78f6'],36,26,62,19771554,3,,,,18569
50ee8e02993e3d34ea46dc81dffbbf2c02348332,1,Artem Baranchuk,2015-02-06 01:19:20+02:00,['de026eb5ece3459f45956a4b4ad85d383111973d'],2,13,15,19771569,1,,,,18569
9f2eb9f16210bec63166816732d071afc8675192,1,Florian Barca,2015-02-05 16:06:10-08:00,['50ee8e02993e3d34ea46dc81dffbbf2c02348332'],0,10,10,19771579,1,1,1,1,18569
ab632ee9d26f55e123069bbff36512e124018021,1,Alejandro Fernandez,2015-02-05 16:19:24-08:00,['9f2eb9f16210bec63166816732d071afc8675192'],0,6,6,19771585,1,,,,18569
306d11253cd13b9958b4d3c47b98b92eef5027c3,0,Sumit Mohanty,2015-02-05 17:32:13-08:00,['ab632ee9d26f55e123069bbff36512e124018021'],25,197,222,19771807,11,0.226190476,0.964285714,0.869047619,18570
232d82ec4b97e94dd4b345b51390050f964e7095,1,Andrii Tkach,2015-02-06 13:35:17+02:00,['306d11253cd13b9958b4d3c47b98b92eef5027c3'],3,1,4,19771811,1,1,0,0,18570
b3799508d5788059ae7ad7ecf4506eb8b7a26778,1,Dmytro Sen,2015-02-06 16:48:46+02:00,['232d82ec4b97e94dd4b345b51390050f964e7095'],0,6,6,19771817,1,,,,18570
b45d4706dea969b3783ce84d47672e0825220ddc,1,Vitaly Brodetskyi,2015-02-06 16:24:10+02:00,['b3799508d5788059ae7ad7ecf4506eb8b7a26778'],4,29,33,19771850,1,,,,18570
3b88165640b33cbf6221fa905f8b659223ca1f90,1,Vitaly Brodetskyi,2015-02-06 16:32:28+02:00,['b45d4706dea969b3783ce84d47672e0825220ddc'],8,34,42,19771892,3,0.866666667,0.866666667,0.733333333,18570
c54c7e2470c602437e1747e3de120dee48458b36,1,Andrii Tkach,2015-02-06 17:37:17+02:00,['3b88165640b33cbf6221fa905f8b659223ca1f90'],2,523,525,19772417,12,0.516025641,1,1,18574
7e03e099bc85bddc310f1d13d5b7b28d6044de6e,0,Lisnichenko Dmitro,2015-02-06 18:29:31+02:00,['c54c7e2470c602437e1747e3de120dee48458b36'],1,2,3,19772420,1,0,0,1,18574
9736a20990e9c35b295a0647742cd4e8291426a3,0,Bob Nettleton,2015-02-06 12:27:13-05:00,['7e03e099bc85bddc310f1d13d5b7b28d6044de6e'],31,41,72,19772492,5,,,,18574
9bedbe2e29dfef9fb80f7553e01084b8df61c4c8,0,Dmytro Sen,2015-02-06 20:09:01+02:00,['9736a20990e9c35b295a0647742cd4e8291426a3'],1,1,2,19772494,1,,,,18574
21bf7c330938b575a943fb90d837fd2787aa0e15,1,Alejandro Fernandez,2015-02-06 10:15:07-08:00,['9bedbe2e29dfef9fb80f7553e01084b8df61c4c8'],27,45,72,19772566,1,0,0,0.285714286,18574
62130336971b2a8c6f84557b3931eaa48c2b4b4b,1,Jun Aoki,2015-02-06 10:22:04-08:00,['21bf7c330938b575a943fb90d837fd2787aa0e15'],13,81,94,19772660,2,0,0.761904762,1,18574
f6fd6e5423ebf48407cc1dbf2c48174edee01c48,1,Dmytro Sen,2015-02-06 20:23:55+02:00,['62130336971b2a8c6f84557b3931eaa48c2b4b4b'],18,170,188,19772848,10,0.518518519,0.148148148,1,18576
93e70b6ad7ac82f3fdccce75d4bb1ddd5f556074,1,Nate Cole,2015-02-06 13:36:02-05:00,['f6fd6e5423ebf48407cc1dbf2c48174edee01c48'],2,115,117,19772965,5,0.109589041,0.410958904,1,18576
f84f639806e1691d8f31084b588650e30cecb255,1,Andrew Onishuk,2015-02-06 20:38:29+02:00,['93e70b6ad7ac82f3fdccce75d4bb1ddd5f556074'],1,6,7,19772972,1,0,0,0,18576
1d28f9891061fa794ea87cb90d6de1a1d19ccd19,1,Lisnichenko Dmitro,2015-02-06 20:42:39+02:00,['f84f639806e1691d8f31084b588650e30cecb255'],48,141,189,19773161,4,0.233333333,1,1,18577
d7a538165d66dfc673689fba14aed967fe4db475,0,Sumit Mohanty,2015-02-06 11:02:38-08:00,['1d28f9891061fa794ea87cb90d6de1a1d19ccd19'],197,25,222,19773383,11,0.773809524,0.035714286,0.130952381,18577
bca1c7b9385ada52bc4325dc6693509805b589b2,1,Alex Antonenko,2015-02-06 21:04:45+02:00,['d7a538165d66dfc673689fba14aed967fe4db475'],5,5,10,19773393,2,,,,18577
293114af6d65adbb3224c54ba60494a537412ca0,1,Sumit Mohanty,2015-02-06 13:32:44-08:00,['bca1c7b9385ada52bc4325dc6693509805b589b2'],26,203,229,19773622,12,0.226190476,0.964285714,0.869047619,18578
bb28c88d94743cc3389771f0502a05ddd48c21d2,1,Andrii Tkach,2015-02-06 23:47:28+02:00,['293114af6d65adbb3224c54ba60494a537412ca0'],4,31,35,19773657,3,1,1,1,18578
655e1e81b7054824f0a308fe890a4ba3b27040c1,1,Srimanth Gunturi,2015-02-06 14:53:33-08:00,['bb28c88d94743cc3389771f0502a05ddd48c21d2'],10,28,38,19773695,5,,,,18578
bdee006b55527a94a8240e218e3fba1e807c384e,1,Yusaku Sako,2015-02-06 14:56:31-08:00,['655e1e81b7054824f0a308fe890a4ba3b27040c1'],41,31,72,19773767,5,,,,18578
87b85a5277044373eb2170a0f419477f376a7d2e,1,Srimanth Gunturi,2015-02-06 15:17:38-08:00,['bdee006b55527a94a8240e218e3fba1e807c384e'],14,120,134,19773901,1,0.435897436,0.435897436,1,18578
a2fdf5d1668fcce5741295c9b2221dfb063ee5f9,1,Yusaku Sako,2015-02-06 15:32:41-08:00,['87b85a5277044373eb2170a0f419477f376a7d2e'],528,123,651,19774552,9,0,0,0,18578
a22bcccf087d0c07d45b0b2dc08a1b3ea08ffc2a,1,Yusaku Sako,2015-02-06 15:38:46-08:00,['a2fdf5d1668fcce5741295c9b2221dfb063ee5f9'],1528,1898,3426,19777978,34,1,0,0,18578
405b3762c5bde6a929f7b22732fa39b42bd24291,1,Jonathan Hurley,2015-02-06 18:41:55-05:00,['a22bcccf087d0c07d45b0b2dc08a1b3ea08ffc2a'],0,189,189,19778167,4,0.113636364,0.113636364,1,18579
56e90a3a49e77776b32f45503a032bbf4a14de63,1,Yusaku Sako,2015-02-06 15:43:46-08:00,['405b3762c5bde6a929f7b22732fa39b42bd24291'],0,29,29,19778196,1,1,1,1,18580
69108c36671bb0524b5a341e649594bf5b35e4bb,1,Yusaku Sako,2015-02-06 15:44:28-08:00,['56e90a3a49e77776b32f45503a032bbf4a14de63'],0,59,59,19778255,1,,,,18581
443a71abee0989c2f7be1651ac69ab5270c565ce,0,Yusaku Sako,2015-02-06 16:06:38-08:00,['69108c36671bb0524b5a341e649594bf5b35e4bb'],16,24,40,19778295,1,,,,18581
acc29738a6525a8b70e3ccc76180ff2d8b750a9b,1,Robert Levas,2015-02-06 19:47:46-05:00,['443a71abee0989c2f7be1651ac69ab5270c565ce'],26,37,63,19778358,2,0.375,1,1,18581
b9a06522ef07bb5216a04575aabb5d251d9097ab,0,Srimanth Gunturi,2015-02-06 17:51:21-08:00,['acc29738a6525a8b70e3ccc76180ff2d8b750a9b'],3,3,6,19778364,2,,,,18581
7f67f34c09e6d54b93524f1c844a907f6d2563f5,1,Yusaku Sako,2015-02-06 22:55:36-08:00,['b9a06522ef07bb5216a04575aabb5d251d9097ab'],406,29,435,19778799,16,1,1,0,18581
a1cceeb9d407b09dc93581d00b8c4cf664e9e932,1,Aleksandr Kovalenko,2015-02-07 12:13:30+02:00,['7f67f34c09e6d54b93524f1c844a907f6d2563f5'],14,121,135,19778934,7,1,1,0.901408451,18581
e90be740a67b31d39aa2de8c29e1d8f591ae048e,1,Aleksandr Kovalenko,2015-02-07 12:13:30+02:00,['a1cceeb9d407b09dc93581d00b8c4cf664e9e932'],15,80,95,19779029,3,0.94,0.56,1,18581
1de3215971fcf0c580af377c64c8f81eddf74070,1,Robert Levas,2015-02-08 06:35:31-05:00,['e90be740a67b31d39aa2de8c29e1d8f591ae048e'],27,401,428,19779457,14,0,0,1,18585
26d0682069d4a3cb0f18630ea2e86af23974be99,1,Andrew Onishuk,2015-02-09 16:48:12+02:00,['1de3215971fcf0c580af377c64c8f81eddf74070'],5,12,17,19779474,2,,,,18585
21a97cc73121201df0bae150dd6af86576885c12,1,Aleksandr Kovalenko,2015-02-09 18:36:23+02:00,['26d0682069d4a3cb0f18630ea2e86af23974be99'],0,62,62,19779536,5,1,1,1,18585
5806ec1ec49b8fc9abcad99df35c2e301638e718,1,Dmytro Sen,2015-02-09 19:24:44+02:00,['21a97cc73121201df0bae150dd6af86576885c12'],26,19,45,19779581,5,,,,18585
38f97ca39c90e985ace63a7a88c262197094b136,0,Alex Antonenko,2015-02-09 19:29:48+02:00,['5806ec1ec49b8fc9abcad99df35c2e301638e718'],8,951,959,19780540,9,0.744712991,1,0.986404834,18593
8f72baf7dbc5e0c36602cc4a22059f88767c2238,1,Vitaly Brodetskyi,2015-02-09 19:10:39+02:00,['38f97ca39c90e985ace63a7a88c262197094b136'],0,15,15,19780555,5,0,0.75,0.5,18593
0d12727642e68288e831605c15b20184e738f8e1,1,Andrii Tkach,2015-02-09 20:38:20+02:00,['8f72baf7dbc5e0c36602cc4a22059f88767c2238'],1,9,10,19780565,2,1,1,1,18593
2f3020c7e377cc7b3f253d20a82754e1ef9799f6,0,Nate Cole,2015-02-09 14:52:31-05:00,['0d12727642e68288e831605c15b20184e738f8e1'],15,37,52,19780617,2,0.1875,0.1875,1,18593
2e78ed709d82b6f1b19f881c6d1f29f8a32bf7b1,0,Nate Cole,2015-02-09 15:09:41-05:00,['2f3020c7e377cc7b3f253d20a82754e1ef9799f6'],13,121,134,19780751,11,0.170731707,0.609756098,0.926829268,18594
b654355970ed42676be34a1c13c3ae947792ddc0,1,Alejandro Fernandez,2015-02-09 12:23:27-08:00,['2e78ed709d82b6f1b19f881c6d1f29f8a32bf7b1'],5,374,379,19781130,3,0.28125,0.96875,0.15625,18596
6db7f8e8400f7bfcd7665ba73d6ee301f503cf5c,1,Srimanth Gunturi,2015-02-09 12:48:23-08:00,['b654355970ed42676be34a1c13c3ae947792ddc0'],434,19,453,19781583,8,,,,18596
44d9bacfb1d75ad89e132d0eaab8d8f497c65575,1,Jonathan Hurley,2015-02-09 16:03:29-05:00,['6db7f8e8400f7bfcd7665ba73d6ee301f503cf5c'],17,71,88,19781671,6,0.032258065,0.967741935,1,18596
345290d808246ad09a95f835c181e51462fa0dcd,1,Nate Cole,2015-02-09 17:39:00-05:00,['44d9bacfb1d75ad89e132d0eaab8d8f497c65575'],39,144,183,19781854,11,0.730769231,0.884615385,0.596153846,18596
0cbc4f114c2e0708c166c223cbb7b41f08220bee,0,Jonathan Hurley,2015-02-09 19:01:36-05:00,['345290d808246ad09a95f835c181e51462fa0dcd'],121,13,134,19781988,11,0.829268293,0.390243902,0.073170732,18596
c08982aef4cbb7d54c88842d999548d0c1c43c27,0,Jonathan Hurley,2015-02-09 19:02:09-05:00,['0cbc4f114c2e0708c166c223cbb7b41f08220bee'],37,15,52,19782040,2,0.8125,0.8125,0,18596
43352a755adff5db84ed8c8cfc8c5d6fa60eff82,1,Alejandro Fernandez,2015-02-09 18:37:49-08:00,['c08982aef4cbb7d54c88842d999548d0c1c43c27'],0,1056,1056,19783096,13,0.472222222,0.855555556,0.705555556,18609
4eccfbc43386fea6f5117f02b96fda6bd704ba3a,1,Dmytro Sen,2015-02-10 13:25:11+02:00,['43352a755adff5db84ed8c8cfc8c5d6fa60eff82'],457,318,775,19783871,93,0.948051948,1,0,18611
f7dc2a037b9c54a5535196420dc3babc8fbdf1f9,1,Vitaly Brodetskyi,2015-02-10 13:37:56+02:00,['4eccfbc43386fea6f5117f02b96fda6bd704ba3a'],0,53,53,19783924,4,,,,18613
874b048c71c98d77c1c7b5e3fc7479a55dd66c88,1,Andrii Tkach,2015-02-10 14:43:51+02:00,['f7dc2a037b9c54a5535196420dc3babc8fbdf1f9'],7,51,58,19783982,5,1,1,1,18613
43150b95aa3a2974193338d23e4b3e3632927bd3,1,Andrew Onishuk,2015-02-10 15:32:47+02:00,['874b048c71c98d77c1c7b5e3fc7479a55dd66c88'],4,6,10,19783992,2,0.5,1,0.5,18613
77a0b2bbe40ce730a7f46223353f914e1c2035c0,1,Alex Antonenko,2015-02-10 15:41:18+02:00,['43150b95aa3a2974193338d23e4b3e3632927bd3'],2,2,4,19783996,2,,,,18613
f4a6e1b6a2ff1a2c68843807e800f359090f90fc,0,Alex Antonenko,2015-02-10 15:41:19+02:00,['77a0b2bbe40ce730a7f46223353f914e1c2035c0'],2,63,65,19784061,5,1,1,1,18614
276879e727d0203150810b7beee6f5bd17b6dfd9,1,Andrew Onishuk,2015-02-10 16:29:53+02:00,['f4a6e1b6a2ff1a2c68843807e800f359090f90fc'],0,8,8,19784069,1,,,,18614
c75a18e5eb265a24afa584345a7c3bb30679f6b1,0,Vitaly Brodetskyi,2015-02-10 15:31:31+02:00,['276879e727d0203150810b7beee6f5bd17b6dfd9'],1,2,3,19784072,1,,,,18614
5789a20bb873105807df6302748c884d6d8a2b95,1,Dmytro Sen,2015-02-10 17:40:39+02:00,['c75a18e5eb265a24afa584345a7c3bb30679f6b1'],0,1,1,19784073,1,0,0,1,18614
631d913da909b3978f772678fdc458ba8ab0456f,1,Andrew Onishuk,2015-02-10 18:56:49+02:00,['5789a20bb873105807df6302748c884d6d8a2b95'],945,54,999,19785072,22,0.307359307,0,0.372294372,18614
f5fe049eb7f078f34cada0258c441c9affa5a6d0,0,Florian Barca,2015-02-10 09:35:31-08:00,['631d913da909b3978f772678fdc458ba8ab0456f'],7,7,14,19785086,1,0,0,1,18614
5a3a1f56a02da6e3bbd5afc4c6423dce2f3f30fe,1,Vitaly Brodetskyi,2015-02-10 19:04:39+02:00,['f5fe049eb7f078f34cada0258c441c9affa5a6d0'],8,24,32,19785118,2,0,0.875,0,18614
c775c60710095259f9c089378d7cd960393ea49f,1,Robert Levas,2015-02-10 13:30:16-05:00,['5a3a1f56a02da6e3bbd5afc4c6423dce2f3f30fe'],371,1624,1995,19787113,26,0.482288828,0.847411444,0.70027248,18621
c8032c6d13dd3cf3afb1d6cb76ec48dd19782031,1,tbeerbower,2015-02-10 15:09:35-05:00,['c775c60710095259f9c089378d7cd960393ea49f'],5,154,159,19787272,3,0.388059701,1,0.47761194,18621
5ad444d72bf8156ebcc996439fa0c7d3356ec217,0,Lisnichenko Dmitro,2015-02-10 22:16:23+02:00,['c8032c6d13dd3cf3afb1d6cb76ec48dd19782031'],1,2,3,19787275,1,,,,18621
dc4aba258c450075659bcb1665f5bc632cfb711b,1,Dmytro Sen,2015-02-10 22:44:10+02:00,['5ad444d72bf8156ebcc996439fa0c7d3356ec217'],1,1,2,19787277,1,,,,18621
586a5d7f64fd56e2625fe753e055555335144289,1,Alejandro Fernandez,2015-02-10 12:57:01-08:00,['dc4aba258c450075659bcb1665f5bc632cfb711b'],25,73,98,19787375,5,0.333333333,0,1,18622
c58f1f3afcc381b3ee4a75d62d18683e46d664fb,1,Srimanth Gunturi,2015-02-10 14:12:04-08:00,['586a5d7f64fd56e2625fe753e055555335144289'],3,7,10,19787385,1,0,0,0.5,18622
c0a8f783fb94805362da3503d39936c725a3e58b,0,Yusaku Sako,2015-02-10 16:12:46-08:00,['c58f1f3afcc381b3ee4a75d62d18683e46d664fb'],24,0,24,19787409,1,,,,18622
524732beedf9c0f7c1a12e9819c82360167be1e6,1,Nate Cole,2015-02-10 22:38:31-05:00,['c0a8f783fb94805362da3503d39936c725a3e58b'],14,306,320,19787729,2,0.127388535,0.369426752,1,18623
edec73af9b30d720734c99c8504fa2997cd88366,1,Oleg Nechiporenko,2015-02-11 14:14:17+02:00,['524732beedf9c0f7c1a12e9819c82360167be1e6'],4,207,211,19787940,3,0.246987952,0.93373494,1,18623
e52dbb5f471b2e4d315a38c145cbf00e5694b9a1,1,Aleksandr Kovalenko,2015-02-11 15:13:53+02:00,['edec73af9b30d720734c99c8504fa2997cd88366'],1,55,56,19787996,3,0.703703704,1,1,18623
0f22258c801d409527cc3b5a894c377525a8bbbd,1,Andrii Tkach,2015-02-11 15:32:41+02:00,['e52dbb5f471b2e4d315a38c145cbf00e5694b9a1'],33,41,74,19788070,13,0.666666667,1,1,18623
e1114f57cf6e01cebb45a0f5fd71bd2d63992ff4,0,aBabiichuk,2015-02-11 16:16:42+02:00,['0f22258c801d409527cc3b5a894c377525a8bbbd'],4,16,20,19788090,2,0,1,1,18623
7e667816a55466ee5114bdb76277cdb9c442be7f,1,aBabiichuk,2015-02-11 16:18:21+02:00,['e1114f57cf6e01cebb45a0f5fd71bd2d63992ff4'],31,130,161,19788251,6,0.421875,0.984375,0.765625,18623
dbafa08de1105a8d012837fb7a0b41659f955182,1,Andrii Tkach,2015-02-11 18:03:06+02:00,['7e667816a55466ee5114bdb76277cdb9c442be7f'],13,16,29,19788280,3,0,1,1,18623
3959000c69419f29e8ef76b4fe41f98025cf5c99,0,Andrew Onishuk,2015-02-11 18:08:49+02:00,['dbafa08de1105a8d012837fb7a0b41659f955182'],0,1,1,19788281,1,0,0,1,18623
fb0903e505cb4a5dbe5c84cff6d6a048d2efd03c,0,Aleksandr Kovalenko,2015-02-11 18:12:07+02:00,['3959000c69419f29e8ef76b4fe41f98025cf5c99'],1,1,2,19788283,1,,,,18623
7656f2fb28dce988999906664e2f2a5f527a8bd1,1,aBabiichuk,2015-02-11 19:00:55+02:00,['fb0903e505cb4a5dbe5c84cff6d6a048d2efd03c'],101,220,321,19788604,4,0,0,1,18623
1d6379345f6ff69ec0ac7b8ce051ae04b8afcef4,1,aBabiichuk,2015-02-11 19:00:56+02:00,['7656f2fb28dce988999906664e2f2a5f527a8bd1'],0,5,5,19788609,1,1,1,1,18623
45a1cb14e2025b4c01aa9d8b0b019f3d9d1da66f,0,Yusaku Sako,2015-02-11 10:09:31-08:00,['1d6379345f6ff69ec0ac7b8ce051ae04b8afcef4'],0,5,5,19788614,1,,,,18623
f36ffea7de0c76406b62b959bce1697f9ce615ab,1,Alex Antonenko,2015-02-11 20:22:30+02:00,['45a1cb14e2025b4c01aa9d8b0b019f3d9d1da66f'],4,1,5,19788619,1,,,,18623
a49bc274e142d62d74a80067c22b1283309f7976,1,Lisnichenko Dmitro,2015-02-11 21:00:25+02:00,['f36ffea7de0c76406b62b959bce1697f9ce615ab'],22,47,69,19788688,3,0.176470588,0.235294118,1,18623
fad54e324da628568b3a6aad3243ce36a62a3894,1,Lisnichenko Dmitro,2015-02-11 21:05:04+02:00,['a49bc274e142d62d74a80067c22b1283309f7976'],5,16,21,19788709,2,0.5,0.9,1,18623
d248fd7c150db9e827fe5f1b837c43d89e6fef08,1,Lisnichenko Dmitro,2015-02-11 21:10:22+02:00,['fad54e324da628568b3a6aad3243ce36a62a3894'],13,121,134,19788843,11,0.170731707,0.609756098,0.926829268,18624
fe2122c72f1e2bd214f81b1eb326502bdcd7a43c,1,Lisnichenko Dmitro,2015-02-11 21:15:54+02:00,['d248fd7c150db9e827fe5f1b837c43d89e6fef08'],4,120,124,19788967,2,0,0.236842105,0.776315789,18624
ca074d01f834740cf7a81c227a5528b961cd41d3,1,Alejandro Fernandez,2015-02-11 11:21:24-08:00,['fe2122c72f1e2bd214f81b1eb326502bdcd7a43c'],2,81,83,19789050,3,1,1,1,18625
143f38144fc59c2a8776118cb3d2d10ca2807f92,1,Andrii Tkach,2015-02-11 21:34:10+02:00,['ca074d01f834740cf7a81c227a5528b961cd41d3'],5,5,10,19789060,2,,,,18625
032bbd760fb4dae566734779f1b6999958a0ffcc,1,Andrii Tkach,2015-02-11 21:34:11+02:00,['143f38144fc59c2a8776118cb3d2d10ca2807f92'],3,83,86,19789146,4,0.565217391,1,1,18626
a5e43551d8e410f7128fb02b66bf126173ca25e0,1,Yusaku Sako,2015-02-11 11:42:18-08:00,['032bbd760fb4dae566734779f1b6999958a0ffcc'],13,49,62,19789208,1,0,0,0,18626
4a25974b195aadb6ff12534e383e72b4aae6c5fb,0,Andrew Onishuk,2015-02-11 22:51:29+02:00,['a5e43551d8e410f7128fb02b66bf126173ca25e0'],213,156,369,19789577,29,0.983870968,0.758064516,0,18626
88ae3af0fd2156d8798858f0900b9f511159cb6b,1,Lisnichenko Dmitro,2015-02-11 23:04:03+02:00,['4a25974b195aadb6ff12534e383e72b4aae6c5fb'],13,8,21,19789598,3,1,0.5,1,18626
52250d5e1df7e8b873e880f100ee59e52b3663ec,1,tbeerbower,2015-02-11 17:20:35-05:00,['88ae3af0fd2156d8798858f0900b9f511159cb6b'],13,179,192,19789790,5,0,0.849056604,0.150943396,18626
b9c9832cd71a621e63b90002c0e04bd282dec5dc,1,Robert Levas,2015-02-11 19:21:15-05:00,['52250d5e1df7e8b873e880f100ee59e52b3663ec'],54,44,98,19789888,10,0,1,1,18626
41e275b1df128b18ee595e6b8b963f48312010ef,1,Robert Levas,2015-02-11 22:12:17-05:00,['b9c9832cd71a621e63b90002c0e04bd282dec5dc'],0,69,69,19789957,5,0.666666667,1,0.666666667,18627
590770a89101f01979eb4e48d6a05168688434b6,0,Yusaku Sako,2015-02-11 20:50:47-08:00,['41e275b1df128b18ee595e6b8b963f48312010ef'],0,6,6,19789963,1,,,,18627
e757885683d769da5b84257b2ae115427aadce1e,1,Yusaku Sako,2015-02-11 20:53:49-08:00,['590770a89101f01979eb4e48d6a05168688434b6'],156,213,369,19790332,29,0.016129032,0.241935484,1,18627
bb99a97bd5bc3e19d2f7147eed21ef9e164a3926,0,Yusaku Sako,2015-02-11 21:34:21-08:00,['e757885683d769da5b84257b2ae115427aadce1e'],6,0,6,19790338,1,,,,18627
2ddd1004ea82c59a247310f7e48d63540b5685a4,1,John Speidel,2015-02-12 00:52:08-05:00,['bb99a97bd5bc3e19d2f7147eed21ef9e164a3926'],111,623,734,19791072,4,0.442804428,0.830258303,0.963099631,18627
2ba93ec733748716520f50c490029a3e31edcfea,1,Dmytro Sen,2015-02-12 12:14:54+02:00,['2ddd1004ea82c59a247310f7e48d63540b5685a4'],5,13,18,19791090,2,0,0.5,1,18627
6bab9e94144b3f3b2b211ebc644cc6372e6cc32d,0,aBabiichuk,2015-02-12 12:29:49+02:00,['2ba93ec733748716520f50c490029a3e31edcfea'],2,2,4,19791094,1,,,,18627
0ee5b5ecb8dffda95e5ecae05ccc583a982b4470,1,aBabiichuk,2015-02-12 12:29:49+02:00,['6bab9e94144b3f3b2b211ebc644cc6372e6cc32d'],24,25,49,19791143,4,0,0,0,18627
b3ea5116a3feb42df1ae574c2bee11b1272b725a,1,Andrew Onishuk,2015-02-12 13:59:42+02:00,['0ee5b5ecb8dffda95e5ecae05ccc583a982b4470'],334,191,525,19791668,31,0.603603604,0.432432432,0.414414414,18627
1cd12ce362c7baee9d0657297ab2618bc8eb59e3,1,Vitaly Brodetskyi,2015-02-12 14:16:47+02:00,['b3ea5116a3feb42df1ae574c2bee11b1272b725a'],3,6,9,19791677,1,0,0,0,18627
f95eb95295668eab7a56f8e24378f83675ccd60a,1,Andrew Onishuk,2015-02-12 15:13:28+02:00,['1cd12ce362c7baee9d0657297ab2618bc8eb59e3'],5,5,10,19791687,2,,,,18627
c474a75150da7f2e04d95cad7e9ce02bf0c5b38d,1,aBabiichuk,2015-02-12 15:51:15+02:00,['f95eb95295668eab7a56f8e24378f83675ccd60a'],3,4,7,19791694,1,1,0,1,18627
7224a607b27053816873147f324af138e1d5657b,1,Andrii Tkach,2015-02-12 16:34:13+02:00,['c474a75150da7f2e04d95cad7e9ce02bf0c5b38d'],2,35,37,19791731,4,1,1,1,18627
f8bdd0696d445455e1a5964eb725346a64a016e6,1,Andrii Tkach,2015-02-12 16:34:14+02:00,['7224a607b27053816873147f324af138e1d5657b'],3,4,7,19791738,3,,,,18627
570f04286db18d5ef0b73c1efd0e5ed5b7832177,0,Aleksandr Kovalenko,2015-02-12 17:13:51+02:00,['f8bdd0696d445455e1a5964eb725346a64a016e6'],1,3,4,19791742,1,1,1,1,18627
58e1da97e15bac4a2486bdd13c256aa1c4e3f9b3,1,Andrew Onishuk,2015-02-12 17:24:32+02:00,['570f04286db18d5ef0b73c1efd0e5ed5b7832177'],47,58,105,19791847,8,0,1,1,18627
cf80e59c6ca5cf3d0a0ba1c53d3dcc3a2be15cdc,1,Jonathan Hurley,2015-02-12 11:36:58-05:00,['58e1da97e15bac4a2486bdd13c256aa1c4e3f9b3'],19,208,227,19792074,12,0.188679245,0.962264151,1,18627
76365bc6e009ca982d7924f7debca120c9a2aaae,1,Dmytro Sen,2015-02-12 18:44:51+02:00,['cf80e59c6ca5cf3d0a0ba1c53d3dcc3a2be15cdc'],156,156,312,19792386,13,,,,18627
6a9dada6a289c654504529cc53b4a34e6129665b,1,Sumit Mohanty,2015-02-12 09:08:08-08:00,['76365bc6e009ca982d7924f7debca120c9a2aaae'],3,6,9,19792395,3,0.666666667,1,0.333333333,18627
f2420f6e164e4372a33eb6699f1c8cb8662d465e,0,Nate Cole,2015-02-12 12:58:13-05:00,['6a9dada6a289c654504529cc53b4a34e6129665b'],13,23,36,19792431,3,0,0.222222222,0.777777778,18627
28e8b256c79b5b90db0598ef611c3189e0b353dc,1,Aleksandr Kovalenko,2015-02-12 20:01:40+02:00,['f2420f6e164e4372a33eb6699f1c8cb8662d465e'],218,6,224,19792655,7,0.231884058,0,0,18627
df26a7026f7d718cb49d6285f2caceb1b02200dc,1,Nate Cole,2015-02-12 13:05:50-05:00,['28e8b256c79b5b90db0598ef611c3189e0b353dc'],50,82,132,19792787,4,0.352941176,0.941176471,1,18627
b8fa0fc4909aaea2b0b8cbb8abc5c7f0155a2ce9,0,Bob Nettleton,2015-02-12 13:08:02-05:00,['df26a7026f7d718cb49d6285f2caceb1b02200dc'],0,180,180,19792967,2,,,,18627
5f351bace30506539e3c443f32f9226cd8e33e14,0,Yusaku Sako,2015-02-12 10:21:31-08:00,['b8fa0fc4909aaea2b0b8cbb8abc5c7f0155a2ce9'],4,9,13,19792980,1,0,0,0,18627
54f5c0ab46b3e437623284dd7f2352d55711d3ab,1,Oleg Nechiporenko,2015-02-12 20:23:52+02:00,['5f351bace30506539e3c443f32f9226cd8e33e14'],74,212,286,19793266,8,1,1,1,18630
3d62861fa73e17d64f2419cc468c00eaeca163d8,1,Alejandro Fernandez,2015-02-12 10:27:42-08:00,['54f5c0ab46b3e437623284dd7f2352d55711d3ab'],9,32,41,19793307,1,0,0,1,18630
4a3672056d616c9eca5b84d6ff7cd7ab4bdb7e08,1,Yusaku Sako,2015-02-12 10:38:42-08:00,['3d62861fa73e17d64f2419cc468c00eaeca163d8'],1,1,2,19793309,1,,,,18630
daf676ef5e5df37874bf011355c971d4e3719645,0,Yusaku Sako,2015-02-12 10:40:08-08:00,['4a3672056d616c9eca5b84d6ff7cd7ab4bdb7e08'],0,6,6,19793315,1,,,,18630
1ce323b450fe6981e9edc4bf2235da5aae8ea9cd,1,Srimanth Gunturi,2015-02-12 10:42:43-08:00,['daf676ef5e5df37874bf011355c971d4e3719645'],46,68,114,19793429,1,1,1,1,18630
dffad97ad4e770da471e4ce34c7fd8bfba75140b,1,Alejandro Fernandez,2015-02-12 10:49:05-08:00,['1ce323b450fe6981e9edc4bf2235da5aae8ea9cd'],2,3,5,19793434,1,,,,18630
82fb0bb56be7fd4ffc179db557fe410cfd891f5a,1,Andrew Onishuk,2015-02-12 21:19:22+02:00,['dffad97ad4e770da471e4ce34c7fd8bfba75140b'],27,107,134,19793568,7,0.425,0,0,18630
ad620eee3cd3623818c623448884eefea8704c7b,0,Robert Levas,2015-02-12 14:34:22-05:00,['82fb0bb56be7fd4ffc179db557fe410cfd891f5a'],8,8,16,19793584,1,,,,18630
87ddb4792734777cc9db0d74c2ac07789c672fda,1,Nate Cole,2015-02-12 15:09:01-05:00,['ad620eee3cd3623818c623448884eefea8704c7b'],160,327,487,19794071,16,0.015873016,1,0.936507937,18631
94205c744402e90e44eb8d4d67cb801ce1f7d7fc,1,Robert Levas,2015-02-12 15:54:11-05:00,['87ddb4792734777cc9db0d74c2ac07789c672fda'],97,138,235,19794306,19,1,1,0.96,18631
2952039a844435f195458281b353bce033dfe75c,1,Mahadev Konar,2015-02-12 15:51:36-08:00,['94205c744402e90e44eb8d4d67cb801ce1f7d7fc'],17,41,58,19794364,1,0,0,0,18631
de2ef9c8c65eb621dcb521d637ce2c8037cfc71e,1,Yusaku Sako,2015-02-12 21:18:02-08:00,['2952039a844435f195458281b353bce033dfe75c'],0,2,2,19794366,1,,,,18631
91357d07f84e245833b1eea637e16d99d821b877,0,Yusaku Sako,2015-02-12 21:19:35-08:00,['de2ef9c8c65eb621dcb521d637ce2c8037cfc71e'],0,1,1,19794367,1,,,,18631
63c683f3272e5c5ef294b43f1157cb49a8bd4e58,1,Andrii Tkach,2015-02-13 13:21:08+02:00,['91357d07f84e245833b1eea637e16d99d821b877'],14,44,58,19794425,4,1,1,1,18631
6f4045eb3b6bbcde7cd3664bcbd12735e3397442,1,Oleg Nechiporenko,2015-02-13 14:18:08+02:00,['63c683f3272e5c5ef294b43f1157cb49a8bd4e58'],89,158,247,19794672,3,0.185185185,1,1,18631
2c4c81df31a10889549554ccf8c7772918be5935,0,Andrii Tkach,2015-02-13 15:11:13+02:00,['6f4045eb3b6bbcde7cd3664bcbd12735e3397442'],4,10,14,19794686,1,,,,18631
9bb05ecedfacdf68d97a401925ff276938f0423b,0,Aleksandr Kovalenko,2015-02-13 15:51:20+02:00,['2c4c81df31a10889549554ccf8c7772918be5935'],1,1,2,19794688,1,,,,18631
14cc17d5f0f7fe8642552a842d02c2f9ac343460,1,aBabiichuk,2015-02-13 15:57:43+02:00,['9bb05ecedfacdf68d97a401925ff276938f0423b'],10,37,47,19794735,3,1,1,1,18631
6e815174af52653169d4b4650cc75908c583a4b4,1,aBabiichuk,2015-02-13 15:57:43+02:00,['14cc17d5f0f7fe8642552a842d02c2f9ac343460'],0,5,5,19794740,1,1,1,1,18631
ba557d1039199c26b26482d3ee647f12efc92ace,0,Nate Cole,2015-02-13 09:15:52-05:00,['6e815174af52653169d4b4650cc75908c583a4b4'],1,2,3,19794743,1,,,,18631
12ed8b5538faf0fd4093ddd68ceee26f39d486ec,1,Jonathan Hurley,2015-02-13 10:37:40-05:00,['ba557d1039199c26b26482d3ee647f12efc92ace'],75,151,226,19794969,9,0.214285714,0.69047619,0,18631
4bdc4ad744aa5c1107021688a33308a4f06961b5,1,tbeerbower,2015-02-13 10:44:36-05:00,['12ed8b5538faf0fd4093ddd68ceee26f39d486ec'],63,183,246,19795215,10,0,1,0.659090909,18631
a4550d12d6376a88da962985cf6fdf1257ad7ebf,0,Andrew Onishuk,2015-02-13 18:58:05+02:00,['4bdc4ad744aa5c1107021688a33308a4f06961b5'],5,8,13,19795228,5,1,1,1,18631
27f763450f8f3c972940cbd599723c300ad9763f,1,Jonathan Hurley,2015-02-13 12:03:02-05:00,['a4550d12d6376a88da962985cf6fdf1257ad7ebf'],1,1,2,19795230,1,,,,18631
6bbed2779d05ef11294239f746abc40961fd83f7,1,Jonathan Hurley,2015-02-13 12:08:19-05:00,['27f763450f8f3c972940cbd599723c300ad9763f'],39,129,168,19795398,9,0,0,1,18631
19ff44731b983f3251211411cb4678e987e445f2,0,Alejandro Fernandez,2015-02-13 09:41:11-08:00,['6bbed2779d05ef11294239f746abc40961fd83f7'],1,4,5,19795403,1,,,,18631
73416b6a7bd1feb04a8d113bd3cf7f5dff867cb6,0,Alex Antonenko,2015-02-13 20:03:01+02:00,['19ff44731b983f3251211411cb4678e987e445f2'],13,73,86,19795489,4,0.375,0.589285714,1,18631
94b3509f4db0254ea738470b36e058b28f237fe5,1,Alex Antonenko,2015-02-13 20:03:02+02:00,['73416b6a7bd1feb04a8d113bd3cf7f5dff867cb6'],1,87,88,19795577,4,1,1,1,18632
c337b6ea5c740fcf3c0d88ac4bcf9d744273ee26,1,Alex Antonenko,2015-02-13 20:03:03+02:00,['94b3509f4db0254ea738470b36e058b28f237fe5'],1,1,2,19795579,1,,,,18632
53dbf69f9d60891cf76179b10ff2019515022709,1,Robert Levas,2015-02-13 14:40:14-05:00,['c337b6ea5c740fcf3c0d88ac4bcf9d744273ee26'],52,328,380,19795959,14,0.485714286,0.985714286,0.942857143,18632
5a2b894644334e06e3567f6936858db1873ecc5d,1,Alex Antonenko,2015-02-13 22:54:59+02:00,['53dbf69f9d60891cf76179b10ff2019515022709'],13,306,319,19796278,6,0.693877551,1,0.987755102,18633
7f752bed246b38c252b82c1105b66ca7551bfd68,0,Mahadev Konar,2015-02-13 13:04:12-08:00,['5a2b894644334e06e3567f6936858db1873ecc5d'],1,1,2,19796280,1,,,,18633
ec4bed3a9e4de72fd04f1dfc81f5788f005ce293,1,Srimanth Gunturi,2015-02-13 13:36:56-08:00,['7f752bed246b38c252b82c1105b66ca7551bfd68'],118,700,818,19797098,13,1,1,0.837837838,18640
c0d435e51083b12913caa6e9e2cab73838f8d0dc,1,Srimanth Gunturi,2015-02-13 13:36:56-08:00,['ec4bed3a9e4de72fd04f1dfc81f5788f005ce293'],0,5,5,19797103,1,,,,18640
41a25def25056e3f59894fcf509687c8b117a673,1,Srimanth Gunturi,2015-02-13 17:21:36-08:00,['c0d435e51083b12913caa6e9e2cab73838f8d0dc'],1,17,18,19797121,2,,,,18640
da7acb02d979fd2b4c910edbc13c77896937bd69,1,Srimanth Gunturi,2015-02-13 17:52:33-08:00,['41a25def25056e3f59894fcf509687c8b117a673'],37,173,210,19797331,8,0.620689655,1,1,18641
182b34732350e4a515950bc3667d3824bbd7f15a,0,Yusaku Sako,2015-02-13 18:02:57-08:00,['da7acb02d979fd2b4c910edbc13c77896937bd69'],17,0,17,19797348,2,1,0,0,18641
4b54c366f676e99187916760523276205ceb7b5b,1,Robert Levas,2015-02-14 09:14:20-05:00,['182b34732350e4a515950bc3667d3824bbd7f15a'],0,30,30,19797378,1,,,,18641
140213f2da3273ca3fe012ab55d231b6622dc369,1,John Speidel,2015-02-14 16:32:21-05:00,['4b54c366f676e99187916760523276205ceb7b5b'],136,548,684,19798062,6,0.073394495,0.802752294,1,18643
a2b3b4c52dffb7a0a7eecae87a637f0c2a771248,1,Dmytro Sen,2015-02-15 03:08:27+02:00,['140213f2da3273ca3fe012ab55d231b6622dc369'],15,15,30,19798092,7,,,,18643
7d002b1550db508f4e6561522e0f176491732500,1,Oleg Nechiporenko,2015-02-15 13:47:46+02:00,['a2b3b4c52dffb7a0a7eecae87a637f0c2a771248'],10,80,90,19798182,5,1,1,1,18644
3944716224003e371484e3c43b6a2a4851e94343,1,aBabiichuk,2015-02-15 13:54:21+02:00,['7d002b1550db508f4e6561522e0f176491732500'],80,170,250,19798432,2,1,0,1,18644
97eac81b0bdfae1293d9fbbe75a80751d3d239e3,1,Andrew Onishuk,2015-02-15 14:21:22+02:00,['3944716224003e371484e3c43b6a2a4851e94343'],37,58,95,19798527,4,0.083333333,0.083333333,0,18644
8a708f7830c8525444e930cc670f3de4d2356a41,0,aBabiichuk,2015-02-15 14:42:19+02:00,['97eac81b0bdfae1293d9fbbe75a80751d3d239e3'],34,3,37,19798564,4,0.458333333,0,0,18644
9a66c77808190602cc3f017ba15918e35fa04052,0,Dmytro Sen,2015-02-15 16:28:17+02:00,['8a708f7830c8525444e930cc670f3de4d2356a41'],1,1,2,19798566,1,,,,18644
075acd71f34c1c0648bfa25a08fa8e630cc6662f,1,Dmytro Sen,2015-02-15 16:28:59+02:00,['9a66c77808190602cc3f017ba15918e35fa04052'],575,980,1555,19800121,24,0.281420765,0.926229508,0.786885246,18649
58597876ef6893ef32a59f03be36c03e7dd7cb10,0,Dmytro Sen,2015-02-15 18:22:08+02:00,['075acd71f34c1c0648bfa25a08fa8e630cc6662f'],8,180,188,19800309,7,1,1,1,18653
1be56cb9eee19b313ea202bd5cfa6d5a801b24e0,1,Dmytro Sen,2015-02-15 18:22:57+02:00,['58597876ef6893ef32a59f03be36c03e7dd7cb10'],5,6,11,19800320,1,0,1,1,18653
f7a1327998dc78ee0d42c14fb03e88cd7aaebb8f,0,Dmytro Sen,2015-02-15 19:30:24+02:00,['1be56cb9eee19b313ea202bd5cfa6d5a801b24e0'],4,4,8,19800328,2,,,,18653
bff7124bb934005cee93c13cd93226bb9c1609ea,1,Alex Antonenko,2015-02-16 02:18:01+02:00,['f7a1327998dc78ee0d42c14fb03e88cd7aaebb8f'],39,81,120,19800448,3,0,0.533333333,1,18653
dea6e433afab3caaf1eb76f6f0e124d3dae07252,1,Alex Antonenko,2015-02-16 02:18:01+02:00,['bff7124bb934005cee93c13cd93226bb9c1609ea'],86,97,183,19800631,7,0.272727273,1,1,18653
d4f17d3a58a7fb47029bb6464698647ab89e2ac3,1,Oleg Nechiporenko,2015-02-16 15:55:11+02:00,['dea6e433afab3caaf1eb76f6f0e124d3dae07252'],0,1,1,19800632,1,1,1,1,18653
579329ade53bc2f26b3351cda46ed5fe4227e320,1,Andrew Onishuk,2015-02-16 17:40:14+02:00,['d4f17d3a58a7fb47029bb6464698647ab89e2ac3'],0,8,8,19800640,1,,,,18653
ae38076ab41391714ae5003e4cb31e7015686f55,1,Yusaku Sako,2015-02-16 07:44:09-08:00,['579329ade53bc2f26b3351cda46ed5fe4227e320'],1,1,2,19800642,1,,,,18653
bc5155b5ddf4badf88a68263e1836e6735f79f89,0,Andrew Onishuk,2015-02-16 18:01:00+02:00,['ae38076ab41391714ae5003e4cb31e7015686f55'],2,2,4,19800646,1,,,,18653
63b78f2e7dbc9acf560c94c128122359a5dfe61a,1,Robert Levas,2015-02-16 11:08:46-05:00,['bc5155b5ddf4badf88a68263e1836e6735f79f89'],1,161,162,19800808,4,0.279069767,0.430232558,0.837209302,18653
fe74bc8cd0c8a2b9b101c093967d0e3bd26d80a1,1,Oleg Nechiporenko,2015-02-16 18:25:54+02:00,['63b78f2e7dbc9acf560c94c128122359a5dfe61a'],0,1,1,19800809,1,1,1,1,18653
1e112dea3e2d732a2c68f41d39e4df6974a6a41b,1,Dmytro Sen,2015-02-16 18:45:40+02:00,['fe74bc8cd0c8a2b9b101c093967d0e3bd26d80a1'],24,141,165,19800974,10,0,0,1,18653
d607123639b187335911c8259a5f25f63c0ef17f,1,Oleg Nechiporenko,2015-02-16 19:19:47+02:00,['1e112dea3e2d732a2c68f41d39e4df6974a6a41b'],0,17,17,19800991,1,1,1,1,18653
c4a2dd74d58c3b2f77712162f8f48b86a3124a74,1,Andrew Onishuk,2015-02-16 19:59:58+02:00,['d607123639b187335911c8259a5f25f63c0ef17f'],2,2,4,19800995,4,,,,18653
0ed6fd688f7566f85519215bc91f8b41a5fb608b,1,Dmytro Sen,2015-02-16 20:06:09+02:00,['c4a2dd74d58c3b2f77712162f8f48b86a3124a74'],180,8,188,19801183,7,0,0,0,18653
c268236255fd141f25fea0143c2589a111686695,1,Dmytro Sen,2015-02-16 20:06:09+02:00,['0ed6fd688f7566f85519215bc91f8b41a5fb608b'],14,14,28,19801211,1,,,,18653
960ee94a2c1a7f53ee6ecbec59bb94a192448013,1,aBabiichuk,2015-02-16 20:36:42+02:00,['c268236255fd141f25fea0143c2589a111686695'],127,129,256,19801467,10,0,1,0,18653
46fbae9eb84ab09b6d4cae0e37e9dbde64b2543a,1,Andrew Onishuk,2015-02-16 21:03:29+02:00,['960ee94a2c1a7f53ee6ecbec59bb94a192448013'],6,10,16,19801483,2,0,0,0,18653
edfd9ab1fbddeaacffdaa608ba60a088e9e8f3f4,1,Andrew Onishuk,2015-02-16 21:17:28+02:00,['46fbae9eb84ab09b6d4cae0e37e9dbde64b2543a'],2,16,18,19801501,2,0.4,1,1,18653
1bf9a6fbefc2d894408476d75120e5c01fddc3f2,1,Andrii Tkach,2015-02-16 21:24:39+02:00,['edfd9ab1fbddeaacffdaa608ba60a088e9e8f3f4'],5,321,326,19801827,10,0.304054054,0.959459459,1,18653
fd07a3e3446767588b1427d600151684e9798023,1,Lisnichenko Dmitro,2015-02-16 21:37:26+02:00,['1bf9a6fbefc2d894408476d75120e5c01fddc3f2'],0,1,1,19801828,1,,,,18653
3e0a9c9ce06be2d73d84454b5a5753f51303aec4,1,sposetti,2015-02-16 21:40:31-05:00,['d4f17d3a58a7fb47029bb6464698647ab89e2ac3'],92,45,137,19801965,6,,,,18653
976e4bcf7d090a4eb107a7d9f9c4908e0ca7c385,0,sposetti,2015-02-16 21:43:05-05:00,"['3e0a9c9ce06be2d73d84454b5a5753f51303aec4', 'fd07a3e3446767588b1427d600151684e9798023']",362,830,1192,19803157,53,,,,18653
4889eba69dd11a4f92e07b4427ca71a2009f1090,1,Alejandro Fernandez,2015-02-17 00:23:00-08:00,['976e4bcf7d090a4eb107a7d9f9c4908e0ca7c385'],3,52,55,19803212,20,,,,18653
aa3ea63f0aa66ebd9405fa7f13991ff9363016ca,1,Oleg Nechiporenko,2015-02-17 11:43:19+02:00,['4889eba69dd11a4f92e07b4427ca71a2009f1090'],4,10,14,19803226,2,,,,18653
0a49dc918c49726cc54c017bac4cc27ceef8e157,0,Andrii Tkach,2015-02-17 11:48:12+02:00,['aa3ea63f0aa66ebd9405fa7f13991ff9363016ca'],3,1,4,19803230,1,,,,18653
ef8750d83ebf12608be0cb5b1f5361695fca3323,1,Nate Cole,2015-02-17 07:18:57-05:00,['0a49dc918c49726cc54c017bac4cc27ceef8e157'],14,32,46,19803276,3,0,0.916666667,0,18653
12050a98ae148182ecaeea9f377cb7c90728e72d,0,Dmytro Sen,2015-02-17 15:33:13+02:00,['ef8750d83ebf12608be0cb5b1f5361695fca3323'],0,6,6,19803282,1,,,,18653
1f134c310467f73413730827d4e5ac71992861e8,1,Oleg Nechiporenko,2015-02-17 16:02:01+02:00,['12050a98ae148182ecaeea9f377cb7c90728e72d'],44,55,99,19803381,3,1,1,1,18653
9429e62f8a972275469bf98b792d65f261d8737d,0,Dmytro Sen,2015-02-17 16:19:48+02:00,['1f134c310467f73413730827d4e5ac71992861e8'],32,113,145,19803526,5,0.245901639,0,0.360655738,18653
dd55ce784642b311ceb84c4b6d8a8fc52ad2c581,1,Lisnichenko Dmitro,2015-02-17 16:31:32+02:00,['9429e62f8a972275469bf98b792d65f261d8737d'],1,1,2,19803528,1,,,,18653
d7f51aa40d5df3531cd2cb8e7d967aac7a417779,1,tbeerbower,2015-02-17 09:47:10-05:00,['dd55ce784642b311ceb84c4b6d8a8fc52ad2c581'],40,10,50,19803578,10,,,,18653
382cf5828c2fe35c4ffef85d2c321fd1059780dc,1,Andrew Onishuk,2015-02-17 17:04:30+02:00,['d7f51aa40d5df3531cd2cb8e7d967aac7a417779'],1,6,7,19803585,2,,,,18653
704325d5c50bb952200ab510ab29402037124016,1,Andrew Onishuk,2015-02-17 17:10:15+02:00,['382cf5828c2fe35c4ffef85d2c321fd1059780dc'],8,21,29,19803614,8,0.7,0.7,1,18653
9a3d22a08ab7ad7228af84f4ff48b02344883a27,1,Vitaly Brodetskyi,2015-02-17 19:18:26+02:00,['704325d5c50bb952200ab510ab29402037124016'],3,4,7,19803621,1,0,0,1,18653
e154a14269caa1a80cf6f0405069f445eb5a9de1,1,aBabiichuk,2015-02-17 19:46:36+02:00,['9a3d22a08ab7ad7228af84f4ff48b02344883a27'],74,59,133,19803754,12,0.357142857,1,0,18653
1ca00e2e45a6b9c61aa78d2649709646142e2975,0,Robert Levas,2015-02-17 12:59:37-05:00,['e154a14269caa1a80cf6f0405069f445eb5a9de1'],0,0,0,19803754,1,,,,18653
90d7b5393977cdf1eb50a91692cf4d3e695ec290,1,Alex Antonenko,2015-02-17 20:17:43+02:00,['1ca00e2e45a6b9c61aa78d2649709646142e2975'],1,1,2,19803756,1,,,,18653
86d8bbc440cdb3cb8448dd165fc50f46605f9318,0,Alex Antonenko,2015-02-17 20:17:44+02:00,['90d7b5393977cdf1eb50a91692cf4d3e695ec290'],7,7,14,19803770,2,,,,18653
5fda959250dd6dd32106b6ee1be814ddadc95641,1,Alejandro Fernandez,2015-02-17 11:04:34-08:00,['86d8bbc440cdb3cb8448dd165fc50f46605f9318'],4,28,32,19803802,4,,,,18653
01c35a7fd2b70c3ca08742c0d0b05a7b138429ed,1,Jonathan Hurley,2015-02-17 14:36:28-05:00,['5fda959250dd6dd32106b6ee1be814ddadc95641'],18,388,406,19804208,10,0.5,0.5,1,18654
b27c266aa17fa0ca1581f73a0edb6b1521534f78,1,Lisnichenko Dmitro,2015-02-17 21:42:48+02:00,['01c35a7fd2b70c3ca08742c0d0b05a7b138429ed'],6,16,22,19804230,3,,,,18654
bed8260b354962b060b4312ea7ba3a5a1aea3e0a,1,Srimanth Gunturi,2015-02-17 13:06:44-08:00,['b27c266aa17fa0ca1581f73a0edb6b1521534f78'],3,5,8,19804238,2,0,1,1,18654
f7d97c74b01a4d2ecd28169b9c170ad96f2fe6ea,0,Nate Cole,2015-02-17 16:47:28-05:00,['bed8260b354962b060b4312ea7ba3a5a1aea3e0a'],4,22,26,19804264,3,1,1,1,18655
a8ede908b40d5a4a49e356d5352633ad00b97b24,1,Xi Wang,2015-02-17 16:05:35-08:00,['f7d97c74b01a4d2ecd28169b9c170ad96f2fe6ea'],0,2,2,19804266,1,1,0,1,18655
747326a28d02f3a092b9e7fec75ef122acae4cb0,1,Srimanth Gunturi,2015-02-17 18:10:57-08:00,['a8ede908b40d5a4a49e356d5352633ad00b97b24'],0,5,5,19804271,1,,,,18655
48a8de15868e9289cb3c71d7ff003f64cabc7d24,1,Yusaku Sako,2015-02-18 00:50:51-08:00,['747326a28d02f3a092b9e7fec75ef122acae4cb0'],73,127,200,19804471,30,,,,18655
45716f1628739dfb12a051fb8f76ea9bf180ed19,1,Oleg Nechiporenko,2015-02-18 13:42:35+02:00,['48a8de15868e9289cb3c71d7ff003f64cabc7d24'],4,10,14,19804485,2,,,,18655
53241b914dbb2dc6d967f22cc18ee51217bec18c,1,Lisnichenko Dmitro,2015-02-18 14:21:58+02:00,['45716f1628739dfb12a051fb8f76ea9bf180ed19'],14,1383,1397,19805882,21,0.28125,0.951388889,1,18669
2e1d9c6b2aeddaa02a59f9b6a5cfc6f0e89c8c52,1,Lisnichenko Dmitro,2015-02-18 14:39:22+02:00,['53241b914dbb2dc6d967f22cc18ee51217bec18c'],26,79,105,19805987,2,0.285714286,1,0,18669
e9c8b2660910c8f07ac78c4e60ef517a7d02f1c7,1,Andrew Onishuk,2015-02-18 15:28:15+02:00,['2e1d9c6b2aeddaa02a59f9b6a5cfc6f0e89c8c52'],40,53,93,19806080,6,0,0.5,1,18669
43f916b9056c8cea813cc6b5d514344da194d11a,1,tbeerbower,2015-02-18 08:58:55-05:00,['e9c8b2660910c8f07ac78c4e60ef517a7d02f1c7'],9,95,104,19806184,6,0.583333333,0.583333333,0.75,18670
1e37bff5a77bf1fc0c2faf0ebb7d650a296e08de,0,tbeerbower,2015-02-18 09:04:05-05:00,['43f916b9056c8cea813cc6b5d514344da194d11a'],1,438,439,19806623,4,,,,18673
8ae21c8b72c873a611d0f9a8e352f7ac77280e9a,1,Vitaly Brodetskyi,2015-02-18 17:31:40+02:00,['1e37bff5a77bf1fc0c2faf0ebb7d650a296e08de'],33,80,113,19806736,6,0.230769231,0.230769231,1,18673
34b629e353d838010201e9a059bdd4048dd1e579,1,aBabiichuk,2015-02-18 17:38:30+02:00,['8ae21c8b72c873a611d0f9a8e352f7ac77280e9a'],3,18,21,19806757,4,1,1,1,18673
c82eb0c8bf692366d38c31697a8160c2f7bf9b9a,1,aBabiichuk,2015-02-18 17:38:31+02:00,['34b629e353d838010201e9a059bdd4048dd1e579'],6,10,16,19806773,2,1,1,1,18673
9b176b5ff84f7f26188258cd94d5ec41b9b54317,1,Aleksandr Kovalenko,2015-02-18 17:56:52+02:00,['c82eb0c8bf692366d38c31697a8160c2f7bf9b9a'],84,24,108,19806881,7,0,0,0,18673
cd3ae1e6229740fb6feba7e64e50fa63570a20a3,1,Florian Barca,2015-02-18 09:22:53-08:00,['9b176b5ff84f7f26188258cd94d5ec41b9b54317'],138,99,237,19807118,1,1,0,1,18673
ab1c91993514f11fa610a9d99573d549fb1ee1f3,1,Jonathan Hurley,2015-02-18 15:51:11-05:00,['cd3ae1e6229740fb6feba7e64e50fa63570a20a3'],51,81,132,19807250,2,0,0,1,18673
0c6ca6bb462980860742a4837d7c4a3e74b30de4,1,Yusaku Sako,2015-02-18 23:37:07-08:00,['ab1c91993514f11fa610a9d99573d549fb1ee1f3'],153,171,324,19807574,9,,,,18673
3e50e06a24c96d595e5edb015c37ae46723c5560,1,Lisnichenko Dmitro,2015-02-19 13:36:18+02:00,['0c6ca6bb462980860742a4837d7c4a3e74b30de4'],1,41,42,19807616,2,0,1,0,18673
01aff40b92306ae3b5642ac2c4339ec11328905f,1,Andrew Onishuk,2015-02-19 15:38:03+02:00,['3e50e06a24c96d595e5edb015c37ae46723c5560'],2,6,8,19807624,2,,,,18673
9fd4a0ccc2744ab989e15029096e1e2e4f59f635,1,Oleg Nechiporenko,2015-02-19 15:40:58+02:00,['01aff40b92306ae3b5642ac2c4339ec11328905f'],42,234,276,19807900,6,1,1,0.663793103,18675
4e7134c86d12451b8ae86cb8594d7b2bc29a0643,1,tbeerbower,2015-02-19 08:56:58-05:00,['9fd4a0ccc2744ab989e15029096e1e2e4f59f635'],9,50,59,19807959,2,0.206896552,0.206896552,0.206896552,18675
70c732047ac6087019b7140439de11978cb09f37,1,Andrew Onishuk,2015-02-19 16:20:13+02:00,['4e7134c86d12451b8ae86cb8594d7b2bc29a0643'],13,50,63,19808022,1,0,0,1,18675
b179b724ea09f37b8589112b1c3d7812c4ebf698,1,Vitaly Brodetskyi,2015-02-19 16:31:08+02:00,['70c732047ac6087019b7140439de11978cb09f37'],0,15,15,19808037,2,0,0.727272727,1,18675
6c22c4deb95c6c837b833e4fb31dc24fd5b64589,1,aBabiichuk,2015-02-19 16:53:41+02:00,['b179b724ea09f37b8589112b1c3d7812c4ebf698'],37,166,203,19808240,3,0.076923077,1,1,18675
cbac6ba253b9386f8d07dcc242962ef68e67c22b,0,Aleksandr Kovalenko,2015-02-19 16:56:18+02:00,['6c22c4deb95c6c837b833e4fb31dc24fd5b64589'],1,1,2,19808242,1,0,0,0,18675
205666cfe1081905ec1830bed5a02821b29e0abf,0,Andrew Onishuk,2015-02-19 17:42:45+02:00,['cbac6ba253b9386f8d07dcc242962ef68e67c22b'],8,3,11,19808253,1,1,0,0,18675
53922274bb3b977686b626e4864f9227934f3a88,0,Yusaku Sako,2015-02-19 07:57:23-08:00,['205666cfe1081905ec1830bed5a02821b29e0abf'],0,1,1,19808254,1,,,,18675
0fde880b8d4a0a8c659c1f9099f77ec0f08f252f,1,Dmytro Sen,2015-02-19 18:50:57+02:00,['53922274bb3b977686b626e4864f9227934f3a88'],113,32,145,19808399,5,0.754098361,1,0.639344262,18675
ca273f7a64e6076c867bdfdc73389a7d4f8100fb,1,Dmytro Sen,2015-02-19 18:50:57+02:00,['0fde880b8d4a0a8c659c1f9099f77ec0f08f252f'],31,103,134,19808533,4,0.288461538,0,0.403846154,18675
00eccc6e5adb71c87985184f09326dd1a2c7df4c,0,Dmytro Sen,2015-02-19 18:50:57+02:00,['ca273f7a64e6076c867bdfdc73389a7d4f8100fb'],5,1,6,19808539,2,,,,18675
8ecc7b4050e58f7efe13c82b5bc468b22f6dd6d3,1,Alex Antonenko,2015-02-19 19:01:37+02:00,['00eccc6e5adb71c87985184f09326dd1a2c7df4c'],0,2,2,19808541,1,0,0,1,18675
d1f9d6665060c432c932379d4bbe4dfff06187b3,1,Jonathan Hurley,2015-02-19 12:40:17-05:00,['8ecc7b4050e58f7efe13c82b5bc468b22f6dd6d3'],79,225,304,19808845,3,0,0,1,18675
6b64cfec96b3735f36e81fe4427b7f4e63f180c8,0,Andrii Tkach,2015-02-19 20:21:18+02:00,['d1f9d6665060c432c932379d4bbe4dfff06187b3'],1,1,2,19808847,1,,,,18675
114e9a490e1fa9bb4494e1f198751825ec3bd64e,0,tbeerbower,2015-02-19 15:09:31-05:00,['6b64cfec96b3735f36e81fe4427b7f4e63f180c8'],1,32,33,19808880,2,0,1,1,18675
ab491eaba7fd1cb6f4052469563dfa79958500fb,0,Myroslav Papirkovskyy,2015-02-19 22:41:06+02:00,['114e9a490e1fa9bb4494e1f198751825ec3bd64e'],79,129,208,19809088,19,0,0,1,18675
1646be07045abf0812468fa9f127d7af5b8e6538,1,Robert Levas,2015-02-19 16:17:06-05:00,['ab491eaba7fd1cb6f4052469563dfa79958500fb'],482,774,1256,19810344,25,0.392592593,0.392592593,0.577777778,18675
585f1ed619e277182e33e8e8b55bfd82f49b6d8d,0,Yusaku Sako,2015-02-19 14:03:52-08:00,['1646be07045abf0812468fa9f127d7af5b8e6538'],129,79,208,19810552,19,1,1,0,18675
8a7b7559ce51beb7fd3fe7514b81dd233dba7500,1,Yusaku Sako,2015-02-19 20:13:12-08:00,['585f1ed619e277182e33e8e8b55bfd82f49b6d8d'],102,86,188,19810740,3,,,,18675
0774c150825fa8c9ddb5707bd9ad402305178fa4,1,aBabiichuk,2015-02-20 12:12:22+02:00,['8a7b7559ce51beb7fd3fe7514b81dd233dba7500'],1,8,9,19810749,1,0,1,1,18675
afc6a9dc1426a015da7bf8bfc4a2d09bae8eb337,1,Andrii Tkach,2015-02-20 13:07:04+02:00,['0774c150825fa8c9ddb5707bd9ad402305178fa4'],0,8,8,19810757,1,1,1,1,18675
1103f0cec3ab6de046c23012031c49b8a251064b,1,Oleg Nechiporenko,2015-02-20 15:45:33+02:00,['afc6a9dc1426a015da7bf8bfc4a2d09bae8eb337'],3,39,42,19810799,4,0.166666667,0.833333333,0.833333333,18675
4131254e42a11e5c4c385da2885d10b49402ba21,1,Vitaly Brodetskyi,2015-02-20 16:08:10+02:00,['1103f0cec3ab6de046c23012031c49b8a251064b'],4,4,8,19810807,4,,,,18675
a1d0aac603b7f7a9717fd3e8082590c6e0cdec3e,1,Aleksandr Kovalenko,2015-02-20 16:11:25+02:00,['4131254e42a11e5c4c385da2885d10b49402ba21'],14,48,62,19810869,4,0,0.947368421,1,18675
3ccdd989f734007cb54508a7af8ab9cb3ebfb399,1,aBabiichuk,2015-02-20 16:37:25+02:00,['a1d0aac603b7f7a9717fd3e8082590c6e0cdec3e'],28,37,65,19810934,3,1,1,1,18675
9bcc3527768085a9daf2653a4d4b18f390fc6c21,1,aBabiichuk,2015-02-20 16:37:45+02:00,['3ccdd989f734007cb54508a7af8ab9cb3ebfb399'],11,25,36,19810970,1,0.25,1,0.75,18675
667df41cfa2a7cd3bb1f306ed69cf99622ce20af,1,Oleg Nechiporenko,2015-02-20 18:03:58+02:00,['9bcc3527768085a9daf2653a4d4b18f390fc6c21'],1,11,12,19810982,2,,,,18675
78c0bbb5a4f29fb95c2ed148769710d607dc2b1f,1,Aleksandr Kovalenko,2015-02-20 18:24:25+02:00,['667df41cfa2a7cd3bb1f306ed69cf99622ce20af'],1,50,51,19811033,3,1,1,0.846153846,18676
db43413ee457c07aaee9eb9c33538e697bb2b248,1,Dmytro Sen,2015-02-20 18:45:37+02:00,['78c0bbb5a4f29fb95c2ed148769710d607dc2b1f'],11,21,32,19811065,3,0,0,0.2,18676
bd8af3f27bb23ff0b2fc988365abcf486ca7f6c1,1,Dmytro Sen,2015-02-20 18:51:01+02:00,['db43413ee457c07aaee9eb9c33538e697bb2b248'],2,4,6,19811071,1,,,,18676
1eeaf523cb25263796387ead560b3e29e873ea9b,0,tbeerbower,2015-02-20 13:16:35-05:00,['bd8af3f27bb23ff0b2fc988365abcf486ca7f6c1'],0,3,3,19811074,1,,,,18676
733394aa6d01fde9918014c3c30b594f9ce68c35,1,Aleksandr Kovalenko,2015-02-20 21:14:55+02:00,['1eeaf523cb25263796387ead560b3e29e873ea9b'],2,2,4,19811078,2,,,,18676
6da3dec5c43aae38db15ca8142ef1bec89b4f4ed,1,Alex Antonenko,2015-02-20 22:59:29+02:00,['733394aa6d01fde9918014c3c30b594f9ce68c35'],8,21,29,19811107,2,1,1,1,18676
53b75619a9961c6a55de8fd5a1ca56b8da794deb,1,Andrew Onishuk,2015-02-20 23:48:30+02:00,['6da3dec5c43aae38db15ca8142ef1bec89b4f4ed'],0,30,30,19811137,2,0.043478261,1,1,18676
225afe35c7ef9d0cef44bcb08f6eaebcdc980202,1,Alejandro Fernandez,2015-02-20 14:14:20-08:00,['53b75619a9961c6a55de8fd5a1ca56b8da794deb'],15,2167,2182,19813319,8,1,1,1,18680
6e23af6a443de04f148cfff0e7da572497ee9d9e,1,Alejandro Fernandez,2015-02-20 15:38:59-08:00,['225afe35c7ef9d0cef44bcb08f6eaebcdc980202'],62,82,144,19813463,5,0,1,1,18681
6d7d82ce4d8c9eb510193c0754ff8d8fe4ee4e5a,1,Jonathan Hurley,2015-02-20 20:53:43-05:00,['6e23af6a443de04f148cfff0e7da572497ee9d9e'],336,692,1028,19814491,14,0.506944444,0.75,1,18682
d87bfc07cc2c6f047d773bee3fb2b8b17e07abb2,1,Bob Nettleton,2015-02-20 21:37:01-05:00,['6d7d82ce4d8c9eb510193c0754ff8d8fe4ee4e5a'],1,39,40,19814531,2,0.166666667,0.666666667,0.666666667,18682
904cb434f1e0d1bf0c171009e893a38ac5c93a8a,0,Vitaly Brodetskyi,2015-02-21 15:25:52+02:00,['d87bfc07cc2c6f047d773bee3fb2b8b17e07abb2'],1,1,2,19814533,1,,,,18682
fad971d392ff8b1e856e42a7fa16989ce2d21029,1,Robert Levas,2015-02-21 12:13:15-05:00,['904cb434f1e0d1bf0c171009e893a38ac5c93a8a'],2,203,205,19814738,3,0.00877193,0.657894737,1,18682
6d44e51e21e419f47d8d2847dbf18483e5d17a6d,0,Sumit Mohanty,2015-02-22 11:45:55-08:00,['fad971d392ff8b1e856e42a7fa16989ce2d21029'],1,1,2,19814740,1,,,,18682
6eb571c2b8c6071e4c77ff3879b5f10315202d21,1,Jonathan Hurley,2015-02-22 15:47:18-05:00,['6d44e51e21e419f47d8d2847dbf18483e5d17a6d'],0,7,7,19814747,1,1,1,1,18682
ef040d68a727aa766eda662e6d75bdd862c89366,1,Andrew Onishuk,2015-02-23 15:14:54+02:00,['6eb571c2b8c6071e4c77ff3879b5f10315202d21'],71,70,141,19814888,9,0,0,1,18682
f704351befd57cfa585be214337c141b06dac4f3,1,Andrii Tkach,2015-02-23 15:17:31+02:00,['ef040d68a727aa766eda662e6d75bdd862c89366'],5,6,11,19814899,1,,,,18682
913bf4ed6cfeb7c5f2884f54feb266849905bef6,0,Robert Levas,2015-02-23 09:50:37-05:00,['f704351befd57cfa585be214337c141b06dac4f3'],8,24,32,19814931,1,1,1,1,18682
923bf81ae125ac6581cef053aa2c31baca1dcb65,1,Jonathan Hurley,2015-02-23 10:14:29-05:00,['913bf4ed6cfeb7c5f2884f54feb266849905bef6'],121,374,495,19815426,3,0.598039216,1,0.833333333,18683
c4bbc30e5d2e3b1fed5384fefb0ec8219e69ec44,1,aBabiichuk,2015-02-23 19:02:35+02:00,['923bf81ae125ac6581cef053aa2c31baca1dcb65'],12,12,24,19815450,1,,,,18683
1ef3c74b7b6f3b1df32f7af71d5debc86a8d8673,0,aBabiichuk,2015-02-23 19:02:37+02:00,['c4bbc30e5d2e3b1fed5384fefb0ec8219e69ec44'],0,1,1,19815451,1,1,1,1,18683
3716c553a9234304d343fab8a1d4250ef9f59786,1,Alex Antonenko,2015-02-23 19:40:48+02:00,['1ef3c74b7b6f3b1df32f7af71d5debc86a8d8673'],19,89,108,19815559,4,0.64,1,0.74,18683
57645a814fea816eeea09e37d392d37988823f79,1,Alex Antonenko,2015-02-23 19:40:49+02:00,['3716c553a9234304d343fab8a1d4250ef9f59786'],172,135,307,19815866,9,1,1,0,18683
99411c4110ae8ec5d72b7ba2e60e3f803d9a6b45,1,Lisnichenko Dmitro,2015-02-23 20:24:31+02:00,['57645a814fea816eeea09e37d392d37988823f79'],0,902,902,19816768,2,,,,18685
46f1ffbec1c2cbeabedfbfd39db281ac58708769,1,Lisnichenko Dmitro,2015-02-23 20:37:39+02:00,['99411c4110ae8ec5d72b7ba2e60e3f803d9a6b45'],13,44,57,19816825,10,0.875,0.875,0.875,18685
575097117230f5111dd9171efbf632eff3f58d1e,1,Robert Levas,2015-02-23 14:13:30-05:00,['46f1ffbec1c2cbeabedfbfd39db281ac58708769'],14,170,184,19817009,3,0.023809524,0,0,18685
7b73e225b4b82f195286f3610f191cc196ae7071,1,Robert Levas,2015-02-23 14:54:27-05:00,['575097117230f5111dd9171efbf632eff3f58d1e'],1,78,79,19817088,2,0.536585366,0.536585366,1,18685
1d495944291077fe69e62c692f21e9e8223bcbd5,1,Srimanth Gunturi,2015-02-23 14:01:06-08:00,['7b73e225b4b82f195286f3610f191cc196ae7071'],4,4,8,19817096,1,,,,18685
52f34cc7a7f824caffbf54d8e61a23dd3406a45b,1,Nate Cole,2015-02-23 17:43:22-05:00,['1d495944291077fe69e62c692f21e9e8223bcbd5'],10,149,159,19817255,4,0.138613861,0.623762376,0.623762376,18685
c903e0f703ac7678b38c75c536cd1a3c0d139eca,1,Yusaku Sako,2015-02-23 18:28:08-08:00,['52f34cc7a7f824caffbf54d8e61a23dd3406a45b'],1,53,54,19817309,2,,,,18685
92b75ea44e811db7a807e30d97b185178ebacc8c,1,Jonathan Hurley,2015-02-23 21:38:21-05:00,['c903e0f703ac7678b38c75c536cd1a3c0d139eca'],41,47,88,19817397,6,1,0.25,0,18685
150a7118f12af2e87e6a187e0360b2e561fdd734,0,Yusaku Sako,2015-02-23 19:34:48-08:00,['92b75ea44e811db7a807e30d97b185178ebacc8c'],0,3,3,19817400,1,1,1,1,18685
f80eb83fa66e24bebc3bbd2a112cfd343bb3d44e,1,Yusaku Sako,2015-02-23 19:36:36-08:00,['150a7118f12af2e87e6a187e0360b2e561fdd734'],1,13,14,19817414,1,1,1,1,18685
3ef3651c62c827adc172d27102a73d1fd9528528,1,Vitaly Brodetskyi,2015-02-24 12:17:58+02:00,['f80eb83fa66e24bebc3bbd2a112cfd343bb3d44e'],52,102,154,19817568,2,0,1,1,18685
a5daa7b21b979fde32797c8b415a1f9c7e3801ac,1,aBabiichuk,2015-02-24 12:43:35+02:00,['3ef3651c62c827adc172d27102a73d1fd9528528'],15,35,50,19817618,3,1,0,0,18685
6d90466f656b087f64055be247f8b9d86c3b59b3,1,Lisnichenko Dmitro,2015-02-24 13:57:55+02:00,['a5daa7b21b979fde32797c8b415a1f9c7e3801ac'],47,692,739,19818357,21,0.56187291,0.387959866,0.879598662,18686
ec4d1b808ad105cf2a38e4da7f4d52eaa46cc028,0,Artem Baranchuk,2015-02-24 14:33:09+02:00,['6d90466f656b087f64055be247f8b9d86c3b59b3'],1504,0,1504,19819861,4,,,,18686
ac2990f4c337c0c1e4eaf85d398c146840ab57f6,1,Artem Baranchuk,2015-02-24 14:33:10+02:00,['ec4d1b808ad105cf2a38e4da7f4d52eaa46cc028'],13,19,32,19819893,1,0,0,1,18686
fc17911f28f8496c11e70b1844f43fc650720d58,1,Andrew Onishuk,2015-02-24 15:25:06+02:00,['ac2990f4c337c0c1e4eaf85d398c146840ab57f6'],1,1,2,19819895,1,,,,18686
d7b816f297043d8eadb0a505ea226ede5643a509,0,Myroslav Papirkovskyy,2015-02-24 15:45:58+02:00,['fc17911f28f8496c11e70b1844f43fc650720d58'],79,240,319,19820214,20,0.5,0.5,1,18687
ab0ab610c1aef1c78b9aef5d8180fcbec76ee75c,0,Myroslav Papirkovskyy,2015-02-24 15:45:58+02:00,['d7b816f297043d8eadb0a505ea226ede5643a509'],148,0,148,19820362,2,1,0.633663366,0,18687
eac00e7b2c7d6efde278be1f8ae6f419c38166dd,0,Myroslav Papirkovskyy,2015-02-24 15:45:58+02:00,['ab0ab610c1aef1c78b9aef5d8180fcbec76ee75c'],288,180,468,19820830,19,0.145695364,0.298013245,0,18693
0c23443535412b035a11fa750500fcd13c527497,0,aBabiichuk,2015-02-24 16:07:16+02:00,['eac00e7b2c7d6efde278be1f8ae6f419c38166dd'],1,1,2,19820832,1,,,,18693
32c30c8f9678477a0be53678e36577e5c9a40897,1,aBabiichuk,2015-02-24 16:07:17+02:00,['0c23443535412b035a11fa750500fcd13c527497'],5,54,59,19820891,6,1,1,1,18693
00ae60adb279d07f4050ffe56c39306af552ac7b,1,Jonathan Hurley,2015-02-24 09:12:00-05:00,['32c30c8f9678477a0be53678e36577e5c9a40897'],167,296,463,19821354,5,0.9,1,1,18693
cb04578b4a901914f5abb0e97e16a007e278831e,1,Aleksandr Kovalenko,2015-02-24 16:50:50+02:00,['00ae60adb279d07f4050ffe56c39306af552ac7b'],277,214,491,19821845,7,0.538461538,0.169230769,0.015384615,18693
3114fb5dc0b20f9f135734970c000280bc7decb5,1,tbeerbower,2015-02-24 10:42:28-05:00,['cb04578b4a901914f5abb0e97e16a007e278831e'],8,108,116,19821961,6,0.24137931,0.948275862,0.948275862,18693
47401e7980ed4ce6b122c58123f83f9b7ec287f3,1,Alex Antonenko,2015-02-24 18:28:59+02:00,['3114fb5dc0b20f9f135734970c000280bc7decb5'],0,21147,21147,19843108,274,0.790147783,0.912643678,0.904980843,18965
a5c7e2e7ff809c4608261275844d39cb015dba44,1,Andrew Onishuk,2015-02-24 19:47:05+02:00,['47401e7980ed4ce6b122c58123f83f9b7ec287f3'],53,115,168,19843276,7,0.46875,0.46875,1,18966
af900c70d0a92c53cd7c24fd3fc7f7426e35259a,1,Oleg Nechiporenko,2015-02-24 19:54:20+02:00,['a5c7e2e7ff809c4608261275844d39cb015dba44'],1,1,2,19843278,1,,,,18966
382075dde7f4b20abe7f3a0d85ab8f1d0907d344,1,Alex Antonenko,2015-02-24 22:28:15+02:00,['af900c70d0a92c53cd7c24fd3fc7f7426e35259a'],4,4,8,19843286,2,,,,18966
39775f41b1405f5aa67f00c7794488672ec779a8,1,Alejandro Fernandez,2015-02-24 13:54:22-08:00,['382075dde7f4b20abe7f3a0d85ab8f1d0907d344'],217,150,367,19843653,7,0,0,1,18966
a3af9fbf60327d2d0adc9935f5997ceef36dc88d,0,Yusaku Sako,2015-02-24 16:44:12-08:00,['39775f41b1405f5aa67f00c7794488672ec779a8'],240,79,319,19843972,20,0.5,0.5,0,18966
d9af23b18043cd36883c85aec90b7969b4551990,1,Jonathan Hurley,2015-02-24 20:13:59-05:00,['a3af9fbf60327d2d0adc9935f5997ceef36dc88d'],57,414,471,19844443,7,0.5,0.938596491,0.947368421,18968
255f9ceb5e133a51d9fe0b9a822b18ebbad9a23d,1,Yusaku Sako,2015-02-24 17:41:35-08:00,['d9af23b18043cd36883c85aec90b7969b4551990'],180,288,468,19844911,19,0.854304636,0.701986755,1,18970
13b9bee464b2fa99f5f89503c5cd7ec8abfd1cdf,0,Xi Wang,2015-02-24 18:08:13-08:00,['255f9ceb5e133a51d9fe0b9a822b18ebbad9a23d'],1,1,2,19844913,1,,,,18970
8211d7a4451c5f3499d8374830131a47975e073d,1,Dmytro Sen,2015-02-25 12:38:41+02:00,['13b9bee464b2fa99f5f89503c5cd7ec8abfd1cdf'],14,40,54,19844967,1,0,0.740740741,0.259259259,18970
c17500a41bb24375a9b318f9be30a3465bf4014d,1,Andrew Onishuk,2015-02-25 14:12:52+02:00,['8211d7a4451c5f3499d8374830131a47975e073d'],4,21,25,19844992,1,0.125,0.125,0.125,18970
35539ef00979c0c942b0805044fa7837d48531e5,0,Lisnichenko Dmitro,2015-02-25 14:24:00+02:00,['c17500a41bb24375a9b318f9be30a3465bf4014d'],2,2,4,19844996,2,,,,18970
b900461e7730e0d43bf90617c659179d15539e86,0,Dmytro Sen,2015-02-25 14:44:16+02:00,['35539ef00979c0c942b0805044fa7837d48531e5'],8,21,29,19845025,1,0,1,1,18970
b1b5857471a806a3501157a1cc6a4d1a1c078c12,0,Artem Baranchuk,2015-02-25 15:35:33+02:00,['b900461e7730e0d43bf90617c659179d15539e86'],0,508,508,19845533,1,,,,18971
5a2dbeab0e7d5601dccad16940b28a6edf19bdc0,1,Nate Cole,2015-02-25 09:11:40-05:00,['b1b5857471a806a3501157a1cc6a4d1a1c078c12'],185,547,732,19846265,30,0.237288136,0.838983051,0.788135593,18972
3ca4b038352457f70539a139964500a2edc03d80,0,Oleg Nechiporenko,2015-02-25 17:51:42+02:00,['5a2dbeab0e7d5601dccad16940b28a6edf19bdc0'],49,96,145,19846410,3,0.047619048,1,1,18972
38d3e21833c62492e878ff753c49f96db7046fff,1,Alex Antonenko,2015-02-25 18:02:28+02:00,['3ca4b038352457f70539a139964500a2edc03d80'],0,47,47,19846457,2,1,1,1,18972
eac74053256818c01bd9e08c5268f1a0bf895700,1,Robert Levas,2015-02-25 11:07:04-05:00,['38d3e21833c62492e878ff753c49f96db7046fff'],2,14,16,19846473,2,,,,18972
58fb4135e83c390ceca3ee6e3cd6248d6fc93f9b,1,Aleksandr Kovalenko,2015-02-25 18:33:46+02:00,['eac74053256818c01bd9e08c5268f1a0bf895700'],19,73,92,19846565,9,0.263157895,1,1,18972
0c57d030a8079c8a0b1f0623d42f5e65f2aec931,0,Andrew Onishuk,2015-02-25 18:36:48+02:00,['58fb4135e83c390ceca3ee6e3cd6248d6fc93f9b'],143,185,328,19846893,9,0.947368421,0,1,18972
986392c5c9a4e58d7f98b54621a0f3afd262f4d9,0,Alex Antonenko,2015-02-25 19:11:07+02:00,['0c57d030a8079c8a0b1f0623d42f5e65f2aec931'],1,1,2,19846895,1,,,,18972
b06cbccbccabb271a38d14e88f3319085582fde3,1,Alex Antonenko,2015-02-25 20:07:10+02:00,['986392c5c9a4e58d7f98b54621a0f3afd262f4d9'],7,8,15,19846910,2,,,,18972
f55736f4956bd3bdf60fd0e77a383363bf36d091,0,Aleksandr Kovalenko,2015-02-25 20:15:04+02:00,['b06cbccbccabb271a38d14e88f3319085582fde3'],2,1,3,19846913,1,0,0,0,18972
76cdfbf4d5ba16512ef5ab85e1b937204ae1c435,1,aBabiichuk,2015-02-25 20:52:08+02:00,['f55736f4956bd3bdf60fd0e77a383363bf36d091'],1,14,15,19846928,1,0.9,1,0.4,18972
212aa9b50797400718f6752c9c8ad6d4ca44ca24,1,aBabiichuk,2015-02-25 20:52:08+02:00,['76cdfbf4d5ba16512ef5ab85e1b937204ae1c435'],5,6,11,19846939,1,1,1,1,18972
340d93e993a4f8fd9215d2cce0992fdf9b1142f3,1,Robert Levas,2015-02-25 15:01:24-05:00,['212aa9b50797400718f6752c9c8ad6d4ca44ca24'],2,4,6,19846945,1,,,,18972
269a172bc9b249b8378dbec4f2ee073256da5eb0,0,Lisnichenko Dmitro,2015-02-25 22:22:19+02:00,['340d93e993a4f8fd9215d2cce0992fdf9b1142f3'],15,114,129,19847074,4,0.106060606,0.939393939,0.939393939,18972
08cdfdc66ba3819b03130d74df5d979871aef111,1,Nate Cole,2015-02-25 15:50:54-05:00,['269a172bc9b249b8378dbec4f2ee073256da5eb0'],32,49,81,19847155,6,,,,18972
a8d7913818f73e6650265600c389a1d01dc44c29,0,Andrew Onishuk,2015-02-25 23:50:06+02:00,['08cdfdc66ba3819b03130d74df5d979871aef111'],1,1,2,19847157,1,,0,,18972
418028efaa5aaa7ad6077f4bf7ecbab9204c7640,1,Alejandro Fernandez,2015-02-25 16:16:46-08:00,['a8d7913818f73e6650265600c389a1d01dc44c29'],185,143,328,19847485,9,0.052631579,1,0,18972
30cd7ee6556b68d7c3b25ec5f4b287158d930c66,1,Alejandro Fernandez,2015-02-25 16:21:27-08:00,['418028efaa5aaa7ad6077f4bf7ecbab9204c7640'],114,15,129,19847614,4,0.893939394,0.060606061,0.060606061,18972
7dfb0e4a58285f5477e7e7a9c9772d3f68303e57,1,Srimanth Gunturi,2015-02-25 19:06:44-08:00,['30cd7ee6556b68d7c3b25ec5f4b287158d930c66'],0,20,20,19847634,1,,,,18972
29fc87f74d3dd0bb3def7ece52d4da1c54fd8fff,1,Andrew Onishuk,2015-02-26 12:22:06+02:00,['7dfb0e4a58285f5477e7e7a9c9772d3f68303e57'],143,186,329,19847963,10,0.947368421,0,1,18972
71bea2aabca4b3deac73c63c6e9b02d72e98a307,1,Lisnichenko Dmitro,2015-02-26 15:03:46+02:00,['29fc87f74d3dd0bb3def7ece52d4da1c54fd8fff'],15,117,132,19848095,4,0.104477612,0.940298507,0.940298507,18972
e8c1bbe745661ff4634b122796db98ca46095231,1,Aleksandr Kovalenko,2015-02-26 16:22:15+02:00,['71bea2aabca4b3deac73c63c6e9b02d72e98a307'],1,54,55,19848150,4,0.85,1,1,18973
e41329702520caff1a71a3d7c690264f4340208c,1,aBabiichuk,2015-02-26 16:33:12+02:00,['e8c1bbe745661ff4634b122796db98ca46095231'],5,88,93,19848243,2,1,1,1,18973
0b855e9a03786e0ecc39ff7c762090e72391dc20,0,Andrew Onishuk,2015-02-26 16:48:43+02:00,['e41329702520caff1a71a3d7c690264f4340208c'],1,3,4,19848247,1,0,1,0.5,18973
c3d56f6c816d6a5a6a91416c52c77a71d87152d0,0,Alex Antonenko,2015-02-26 17:37:23+02:00,['0b855e9a03786e0ecc39ff7c762090e72391dc20'],1,2,3,19848250,1,1,0,1,18973
85941642588d90a301e78d21d2399fa3a7ab80a2,0,Alex Antonenko,2015-02-26 17:37:24+02:00,['c3d56f6c816d6a5a6a91416c52c77a71d87152d0'],1,1,2,19848252,1,,,,18973
05348ff9e0e7d487168629cc1d28ccba36c95384,0,Aleksandr Kovalenko,2015-02-26 17:52:05+02:00,['85941642588d90a301e78d21d2399fa3a7ab80a2'],0,9,9,19848261,1,1,1,1,18973
f5f13b3d4c24aa31cbc8b7f197f9e904c5ae5759,1,Jonathan Hurley,2015-02-26 11:41:24-05:00,['05348ff9e0e7d487168629cc1d28ccba36c95384'],410,714,1124,19849385,10,0.05511811,1,1,18975
5e64d87f647d6d6a26bcd00dade73028aac6cf55,1,Alex Antonenko,2015-02-26 19:01:20+02:00,['f5f13b3d4c24aa31cbc8b7f197f9e904c5ae5759'],50,18,68,19849453,3,0,0,0,18975
acbe6f10832af0f3fcc95c524c968a17b9efc3e5,1,Mahadev Konar,2015-02-26 10:44:14-08:00,['5e64d87f647d6d6a26bcd00dade73028aac6cf55'],2,63,65,19849518,4,0,0.887096774,1,18975
24a7e6442b765ea7e817533714ccc98c3e8ff9e4,1,Yusaku Sako,2015-02-26 10:54:36-08:00,['acbe6f10832af0f3fcc95c524c968a17b9efc3e5'],9,50,59,19849577,11,,,,18975
f76de1329035395841300335e37257ea63e20f9c,0,Lisnichenko Dmitro,2015-02-26 21:33:02+02:00,['24a7e6442b765ea7e817533714ccc98c3e8ff9e4'],3,7,10,19849587,1,,,,18975
f701b9c7bed8a79dbac0f0e9dc76fac531c358e7,1,aBabiichuk,2015-02-26 22:21:07+02:00,['f76de1329035395841300335e37257ea63e20f9c'],24,46,70,19849657,5,1,1,1,18975
2068caa7ebc029752b0db1eaef1372177e7003ba,1,Nate Cole,2015-02-26 15:31:35-05:00,['f701b9c7bed8a79dbac0f0e9dc76fac531c358e7'],3,88,91,19849748,4,0,0.24137931,0.24137931,18975
002af97367f55343a8cc93876035fba67cefc32a,1,Robert Levas,2015-02-26 16:43:34-05:00,['2068caa7ebc029752b0db1eaef1372177e7003ba'],1,209,210,19849958,2,,,,18976
3d8fc35408f75ec55da23c2b2043fd62a231803c,1,Alejandro Fernandez,2015-02-26 14:17:48-08:00,['002af97367f55343a8cc93876035fba67cefc32a'],1,43,44,19850002,4,0,1,1,18976
76369345300d3f55699341dcff0f763b676d97fd,0,Yusaku Sako,2015-02-26 16:25:44-08:00,['3d8fc35408f75ec55da23c2b2043fd62a231803c'],2,2,4,19850006,1,,,,18976
30c132500410c364e9e7d2a13143e8b7e15ecdf1,0,Siddharth Wagle,2015-02-26 16:31:36-08:00,['76369345300d3f55699341dcff0f763b676d97fd'],3,10,13,19850019,4,0,0,1,18976
e077605cba9c135ade4d6db1e02edd4343452a42,0,Yusaku Sako,2015-02-26 17:08:31-08:00,['30c132500410c364e9e7d2a13143e8b7e15ecdf1'],1,1,2,19850021,2,,,,18976
e5c0bb3d78302067bdfe283034f407dee5469afd,1,aBabiichuk,2015-02-27 12:32:17+02:00,['e077605cba9c135ade4d6db1e02edd4343452a42'],1,7,8,19850029,1,1,1,1,18976
6b3c23535fb570d68263e9c67d92bc6e646bc7e2,1,Vitaly Brodetskyi,2015-02-27 14:11:26+02:00,['e5c0bb3d78302067bdfe283034f407dee5469afd'],50,138,188,19850217,34,0.740740741,0.740740741,1,18977
6076060d7608140b400b7ea2670c070fa9619972,1,Andrew Onishuk,2015-02-27 14:45:18+02:00,['6b3c23535fb570d68263e9c67d92bc6e646bc7e2'],247,337,584,19850801,64,1,1,0,18980
e1b2a0fe9c248b73da18da9e8b12d191594b53bd,1,Lisnichenko Dmitro,2015-02-27 15:20:37+02:00,['6076060d7608140b400b7ea2670c070fa9619972'],4,4,8,19850809,1,1,1,0,18980
6ed6784c366d5a28d36f413d6d2207686a9bfa4f,1,Andrew Onishuk,2015-02-27 15:28:49+02:00,['e1b2a0fe9c248b73da18da9e8b12d191594b53bd'],5,6,11,19850820,4,1,1,1,18980
3cdc032ee89346bde07aa69eb56dc2f34e826308,0,Andrew Onishuk,2015-02-27 15:36:17+02:00,['6ed6784c366d5a28d36f413d6d2207686a9bfa4f'],0,20,20,19850840,1,,,,18980
4b8cd75d6e0674b73d7c1781a4994071f164dd4f,1,Robert Levas,2015-02-27 09:02:31-05:00,['3cdc032ee89346bde07aa69eb56dc2f34e826308'],435,1211,1646,19852486,25,0.006791171,0.942275042,0.064516129,18980
394674c1842e945e95c5538309ff21685aa0f6a8,1,Jonathan Hurley,2015-02-27 09:17:04-05:00,['4b8cd75d6e0674b73d7c1781a4994071f164dd4f'],11,105,116,19852602,8,0.125,1,1,18980
bc8fbbe4b642d3c579098787c99c08ffa4e56f36,1,aBabiichuk,2015-02-27 16:28:56+02:00,['394674c1842e945e95c5538309ff21685aa0f6a8'],41,55,96,19852698,6,1,0.916666667,1,18980
44aae81097e2556531d9655c7b93d00086983a56,1,Oleg Nechiporenko,2015-02-27 17:25:32+02:00,['bc8fbbe4b642d3c579098787c99c08ffa4e56f36'],90,176,266,19852964,7,1,1,1,18980
74b4287f9d765fb3e6ec6d4064edf7693edb2a42,1,aBabiichuk,2015-02-27 17:50:53+02:00,['44aae81097e2556531d9655c7b93d00086983a56'],5,48,53,19853017,3,1,1,1,18980
9cbaab8dd2dd9538fba1510191b4e549add1d79e,1,Aleksandr Kovalenko,2015-02-27 18:47:07+02:00,['74b4287f9d765fb3e6ec6d4064edf7693edb2a42'],63,62,125,19853142,3,0.257142857,0.971428571,1,18980
7d1520095132313f8d07249326146019a1324c19,1,Lisnichenko Dmitro,2015-02-27 20:20:51+02:00,['9cbaab8dd2dd9538fba1510191b4e549add1d79e'],3,83,86,19853228,3,0.112903226,0.983870968,0.129032258,18980
57b8c7190d0f9cefaa44b3b49deab5b0f48b31d4,0,Lisnichenko Dmitro,2015-02-27 21:25:18+02:00,['7d1520095132313f8d07249326146019a1324c19'],5,10,15,19853243,1,0,0,0,18980
5bc11b68b8be47ed21da0ce44e14a0645eb41ff0,0,Siddharth Wagle,2015-02-27 13:31:04-08:00,['57b8c7190d0f9cefaa44b3b49deab5b0f48b31d4'],7,0,7,19853250,1,1,1,1,18980
8126567562f8790651dec44c98944764e174e11d,0,Srimanth Gunturi,2015-02-27 15:44:55-08:00,['5bc11b68b8be47ed21da0ce44e14a0645eb41ff0'],1,1,2,19853252,1,,,,18980
b1dccde13efabd2c06575d76cd02f05e60366893,1,Florian Barca,2015-02-27 16:14:04-08:00,['8126567562f8790651dec44c98944764e174e11d'],342,576,918,19854170,9,0.787878788,1,1,18985
e8ea0a5cae05ff80f17a134d5d71cd391b2a9f53,1,Alex Antonenko,2015-02-28 03:37:02+02:00,['b1dccde13efabd2c06575d76cd02f05e60366893'],24,28,52,19854222,3,1,0.25,0,18985
4c222ce6fbc51ed4e42e9f2ad0946c84ff17ea48,1,Robert Levas,2015-02-27 20:41:33-05:00,['e8ea0a5cae05ff80f17a134d5d71cd391b2a9f53'],107,192,299,19854521,35,0,0,0.96875,18985
e29152193af2a579c7d05529ab10067f70943042,1,Robert Levas,2015-02-27 20:41:33-05:00,['4c222ce6fbc51ed4e42e9f2ad0946c84ff17ea48'],0,75,75,19854596,2,1,1,1,18987
32fc073fb7631477d684c8d7214846d3dbbc6128,1,Robert Levas,2015-02-27 22:14:19-05:00,['e29152193af2a579c7d05529ab10067f70943042'],216,939,1155,19855751,18,0.192307692,0.87854251,0.738866397,18987
71486fb4a3450da9bf8d40cf88b32c3b06f420fb,0,Oleg Nechiporenko,2015-02-28 13:27:37+02:00,['32fc073fb7631477d684c8d7214846d3dbbc6128'],1,1,2,19855753,1,,,,18987
a0fd0cb3cb83911622ff4d5b06f2dcca5255c607,1,Oleg Nechiporenko,2015-02-28 15:00:58+02:00,['71486fb4a3450da9bf8d40cf88b32c3b06f420fb'],34,59,93,19855846,2,,,,18987
709e17a88374a74482999c948c21adaacd8c238f,1,Alex Antonenko,2015-02-28 17:41:20+02:00,['a0fd0cb3cb83911622ff4d5b06f2dcca5255c607'],16,133,149,19855995,5,0.627118644,1,1,18987
ec90b074f442671f44f771223cd02f5b63ff030e,1,Oleg Nechiporenko,2015-02-28 17:45:35+02:00,['709e17a88374a74482999c948c21adaacd8c238f'],4,15,19,19856014,2,,,,18987
c59cd7f9e010b14cad27a68b680781ad534ce876,1,Dmytro Sen,2015-02-28 19:13:27+02:00,['ec90b074f442671f44f771223cd02f5b63ff030e'],82,101,183,19856197,1,,,,18987
38d805e725858d609f89b9fdc54104f305cdb4e0,1,Dmytro Sen,2015-02-28 19:34:58+02:00,['c59cd7f9e010b14cad27a68b680781ad534ce876'],1,3,4,19856201,1,,,,18987
35a00d0d85c72b94b653164b1621a1f97e38ab38,1,Alejandro Fernandez,2015-02-28 10:07:49-08:00,['38d805e725858d609f89b9fdc54104f305cdb4e0'],290,1037,1327,19857528,18,0.046263345,0.12455516,0.612099644,18994
594b71daba30531f043756d0b10ff348cabcca9d,1,Robert Levas,2015-02-28 13:52:10-05:00,['35a00d0d85c72b94b653164b1621a1f97e38ab38'],5,5,10,19857538,1,,,,18994
44e8ea4f56d11f1a473fd05306e40a531bedfe41,1,Alex Antonenko,2015-02-28 22:19:20+02:00,['594b71daba30531f043756d0b10ff348cabcca9d'],4,21,25,19857563,5,0.2,0.8,1,18994
faa4e2703aedac2d6a83788933cb345fa68c4fac,1,Alex Antonenko,2015-02-28 22:19:20+02:00,['44e8ea4f56d11f1a473fd05306e40a531bedfe41'],0,16,16,19857579,1,,,,18994
965676cbdd6e04be3c8f5b629fa1a1f70a7bd2ed,0,Andrew Onishuk,2015-03-01 12:21:07+02:00,['faa4e2703aedac2d6a83788933cb345fa68c4fac'],1,1,2,19857581,1,,,,18994
3ef3607a10806592ee5bf038cfc16c60e3662dd3,1,Dmytro Sen,2015-03-01 12:32:46+02:00,['965676cbdd6e04be3c8f5b629fa1a1f70a7bd2ed'],1,2,3,19857584,1,1,1,1,18994
d153d4b61edf2f00af026d5be55fb7772b6dbcd6,1,Andrii Tkach,2015-03-01 12:47:40+02:00,['3ef3607a10806592ee5bf038cfc16c60e3662dd3'],241,145,386,19857970,9,0.349315068,0,0,18995
38a6f390662f822d084d94d44912ebae5e1e1fe8,1,Vitaly Brodetskyi,2015-03-01 17:45:42+02:00,['d153d4b61edf2f00af026d5be55fb7772b6dbcd6'],20,27,47,19858017,1,0,1,0,18995
56a67351716c95e420f236bd78bd8228e8c92442,0,aBabiichuk,2015-03-01 18:20:42+02:00,['38a6f390662f822d084d94d44912ebae5e1e1fe8'],0,5,5,19858022,1,,,,18995
8dac828ee0be9e6bfdfa50b128698606f53e9e78,1,Robert Levas,2015-03-01 12:40:06-05:00,['56a67351716c95e420f236bd78bd8228e8c92442'],1,1,2,19858024,1,,,,18995
d41b50c725b99b00ec834e6626385af9cbcd2153,1,Alex Antonenko,2015-03-01 20:15:31+02:00,['8dac828ee0be9e6bfdfa50b128698606f53e9e78'],1,157,158,19858182,2,0.153846154,0.993589744,1,18995
3ef90e1938e5547bd8f2bc1c4c62518d84869d7e,1,Siddharth Wagle,2015-03-01 10:38:56-08:00,['d41b50c725b99b00ec834e6626385af9cbcd2153'],1,1,2,19858184,1,,,,18995
0270df87a32248060d014657c9465c878917d9d3,0,Lisnichenko Dmitro,2015-03-01 21:52:51+02:00,['3ef90e1938e5547bd8f2bc1c4c62518d84869d7e'],13,2,15,19858199,3,1,0,0.555555556,18995
dae0dadca97c5eb0ac47cec786f631a434ec0386,1,Lisnichenko Dmitro,2015-03-01 23:08:25+02:00,['0270df87a32248060d014657c9465c878917d9d3'],13,72,85,19858284,3,0,0.846153846,0.846153846,18995
95de72e248bcaf621e045177b4e1a440f7302128,0,Alex Antonenko,2015-03-02 00:19:40+02:00,['dae0dadca97c5eb0ac47cec786f631a434ec0386'],0,1,1,19858285,1,1,1,1,18995
303628ce396ee3427099d1c8bf2c29fb75d65f54,1,Alex Antonenko,2015-03-02 00:19:40+02:00,['95de72e248bcaf621e045177b4e1a440f7302128'],7,37,44,19858329,3,1,1,1,18995
568e49dff5ef9472aec4af842a9994e5b23b5636,1,Alex Antonenko,2015-03-02 00:19:40+02:00,['303628ce396ee3427099d1c8bf2c29fb75d65f54'],1,4715,4716,19863045,19,0.151515152,0.393939394,1,19009
8371a8a0e6fbb28cdcc137863a2d6ec3cfd209fc,1,Alex Antonenko,2015-03-02 00:19:40+02:00,['568e49dff5ef9472aec4af842a9994e5b23b5636'],2,13,15,19863060,1,1,1,1,19009
3b6d56da8eba849b5dd3612355eff084de33d065,0,Jayush Luniya,2015-03-02 01:20:58-08:00,['8371a8a0e6fbb28cdcc137863a2d6ec3cfd209fc'],8,9,17,19863077,3,,,,19009
7607fc1e5ccea98f068a7e26b188154db0b003ca,1,Jonathan Hurley,2015-03-02 08:42:37-05:00,['3b6d56da8eba849b5dd3612355eff084de33d065'],89,501,590,19863667,5,0.185185185,0.703703704,1,19009
a42b6894e39a5419f6855489d447322e203d7914,0,Sumit Mohanty,2015-03-02 07:08:08-08:00,['7607fc1e5ccea98f068a7e26b188154db0b003ca'],5,5,10,19863677,1,1,0,0,19009
70b912c6a441ad3dff091554d8b2872290d2bb28,1,Oleg Nechiporenko,2015-03-02 18:44:49+02:00,['a42b6894e39a5419f6855489d447322e203d7914'],53,665,718,19864395,15,0.60137457,1,0.986254296,19011
37e0d6d510f7325a8d77943fa9ebb818000da7a6,1,Alex Antonenko,2015-03-02 19:35:12+02:00,['70b912c6a441ad3dff091554d8b2872290d2bb28'],9,87,96,19864491,2,0.168831169,0.545454545,1,19011
d54457c20376bebcee6a2a8b7051567701b75cc9,1,Vitaly Brodetskyi,2015-03-02 20:04:49+02:00,['37e0d6d510f7325a8d77943fa9ebb818000da7a6'],54,71,125,19864616,6,1,1,0,19011
8793f44a7582d7df12684c70d99fad7304317737,0,Yusaku Sako,2015-03-02 11:00:06-08:00,['d54457c20376bebcee6a2a8b7051567701b75cc9'],1,0,1,19864617,1,0,0,0,19011
f20500b272479df261efc1b7586fb2ba4cf8ae5c,1,Alex Antonenko,2015-03-02 21:18:25+02:00,['8793f44a7582d7df12684c70d99fad7304317737'],2,6,8,19864625,4,1,1,1,19011
1219248741ef975bac3f851cbf7a410339cd44c3,0,Alex Antonenko,2015-03-02 21:18:25+02:00,['f20500b272479df261efc1b7586fb2ba4cf8ae5c'],12,8,20,19864645,2,0,0,0,19011
86d6589382ac0467640c2f286c950877387fd41a,1,John Speidel,2015-03-02 15:26:44-05:00,['1219248741ef975bac3f851cbf7a410339cd44c3'],6,321,327,19864972,4,0.36196319,0.754601227,1,19011
434885c7633b988de2656d9c19cdad23c1fc5c42,1,Oleg Nechiporenko,2015-03-03 00:04:30+02:00,['86d6589382ac0467640c2f286c950877387fd41a'],12,6,18,19864990,4,,,,19011
94c55e865058f4730480f53c044c909b5c9d2525,1,Lisnichenko Dmitro,2015-03-03 00:08:15+02:00,['434885c7633b988de2656d9c19cdad23c1fc5c42'],1,4,5,19864995,2,1,1,1,19011
9a00dec0afae02369ad6a10561d345570e7de411,1,Jonathan Hurley,2015-03-02 17:24:34-05:00,['94c55e865058f4730480f53c044c909b5c9d2525'],116,178,294,19865289,5,0,0.909090909,1,19011
45b47ed4a984194737ab964d44a38397572a727e,1,Jayush Luniya,2015-03-02 14:29:28-08:00,['9a00dec0afae02369ad6a10561d345570e7de411'],2,2,4,19865293,1,,,,19011
f18c9fa2525bc93a20179c612d442590f7b7bbfc,1,tbeerbower,2015-03-02 17:32:54-05:00,['45b47ed4a984194737ab964d44a38397572a727e'],9,372,381,19865674,9,0.573643411,1,1,19014
cbfd153eb768c3c7563e85832e9c7d66f8e724c3,1,Siddharth Wagle,2015-03-02 17:05:27-08:00,['f18c9fa2525bc93a20179c612d442590f7b7bbfc'],13,15,28,19865702,4,0,1,1,19014
26aaca7fbb0bb2c95169d9c77c08e94446d595f7,1,Sumit Mohanty,2015-03-02 17:35:45-08:00,['cbfd153eb768c3c7563e85832e9c7d66f8e724c3'],1,1,2,19865704,1,,,,19014
05c2d2f257fc784f13628af188101fa780f199fc,1,Jonathan Hurley,2015-03-02 21:54:21-05:00,['26aaca7fbb0bb2c95169d9c77c08e94446d595f7'],38,79,117,19865821,2,0,0.12,0,19014
5474d796160ddb0be828d01c2697e3d86f9e71b2,1,aBabiichuk,2015-03-03 09:08:30+02:00,['05c2d2f257fc784f13628af188101fa780f199fc'],18,63,81,19865902,4,0.392857143,1,1,19014
48eb11e78d533de6a9252634bed6de4ee9a9a352,1,Oleg Nechiporenko,2015-03-03 12:14:05+02:00,['5474d796160ddb0be828d01c2697e3d86f9e71b2'],25,61,86,19865988,4,0.344827586,1,1,19014
b432db1c783388a191f290c55b8170c009f7dbf6,1,Andrew Onishuk,2015-03-03 15:08:43+02:00,['48eb11e78d533de6a9252634bed6de4ee9a9a352'],2,3,5,19865993,1,0,1,0,19014
6f5d57e0cfbfcc23ee5c1bedb3fbca6b069e7604,1,Oleg Nechiporenko,2015-03-03 15:21:09+02:00,['b432db1c783388a191f290c55b8170c009f7dbf6'],11,15,26,19866019,4,0.4,1,1,19014
fcda5e1f035a783773b264e02edbe4bed9916d0a,1,aBabiichuk,2015-03-03 15:39:06+02:00,['6f5d57e0cfbfcc23ee5c1bedb3fbca6b069e7604'],4,2,6,19866025,2,1,0,0,19014
5ba2689a389d1e887efb41722dbdcc108e625456,0,aBabiichuk,2015-03-03 15:39:06+02:00,['fcda5e1f035a783773b264e02edbe4bed9916d0a'],17,18,35,19866060,2,1,1,1,19014
087b990aaa96264d65d9fbb28141b441db2f2820,0,aBabiichuk,2015-03-03 15:39:07+02:00,['5ba2689a389d1e887efb41722dbdcc108e625456'],1,5,6,19866066,2,1,1,1,19014
d27807b145d2d6c58eb5b1b7ed23e60b172ff119,1,Andrii Tkach,2015-03-03 16:19:11+02:00,['087b990aaa96264d65d9fbb28141b441db2f2820'],11,3,14,19866080,2,0,0,0,19014
c313023bd25d4a0fc1d23be5b6b1931638feb20c,0,Andrii Tkach,2015-03-03 16:19:14+02:00,['d27807b145d2d6c58eb5b1b7ed23e60b172ff119'],0,9,9,19866089,1,1,1,1,19014
954b96e1edf8fc313ce06d57928b3e26e714770a,1,Robert Levas,2015-03-03 09:59:59-05:00,['c313023bd25d4a0fc1d23be5b6b1931638feb20c'],189,946,1135,19867224,5,0.111111111,0.775793651,0.722222222,19014
ba16ce33e8b9ea6c6e44e50140da1ae797e789bc,1,Vitaly Brodetskyi,2015-03-03 17:18:38+02:00,['954b96e1edf8fc313ce06d57928b3e26e714770a'],4,7,11,19867235,2,0.333333333,0.666666667,1,19014
faf69f4b611e4c5737a5789ee9d268a7c7e8ef81,1,Myroslav Papirkovskyy,2015-03-03 18:18:53+02:00,['ba16ce33e8b9ea6c6e44e50140da1ae797e789bc'],79,240,319,19867554,20,0.5,0.5,1,19015
587924496802523c3ab9fe4468e04651eb4e738f,1,Andrew Onishuk,2015-03-03 18:56:12+02:00,['faf69f4b611e4c5737a5789ee9d268a7c7e8ef81'],74,65,139,19867693,6,1,0.7,0.7,19015
42c77f15a5897c523fe2c84fc36d78103454f9b6,0,Andrew Onishuk,2015-03-03 19:10:45+02:00,['587924496802523c3ab9fe4468e04651eb4e738f'],0,9,9,19867702,1,0,0,1,19015
57251f4b3b048e3d38f1df0e769c6da70c25efbb,1,Nate Cole,2015-03-03 12:13:03-05:00,['42c77f15a5897c523fe2c84fc36d78103454f9b6'],116,475,591,19868293,10,0.047619048,0.922619048,0.553571429,19016
52bcd9f06356febfe09a04df8a2717f3161a4026,1,Alex Antonenko,2015-03-03 21:40:00+02:00,['57251f4b3b048e3d38f1df0e769c6da70c25efbb'],1,236,237,19868530,3,0.009569378,0.947368421,1,19017
2cb028c555fa14f028f263ee21413b5007c8bca2,1,Alex Antonenko,2015-03-03 21:40:00+02:00,['52bcd9f06356febfe09a04df8a2717f3161a4026'],5,14,19,19868549,6,0.666666667,0,1,19017
76983f3e722e4707176b4b0094eda7c96d6d26fb,1,Srimanth Gunturi,2015-03-03 09:43:17-08:00,['2cb028c555fa14f028f263ee21413b5007c8bca2'],10,19,29,19868578,3,0,0,0,19017
02ac3940c87cb53e6c9a98ab7479816e257019ec,1,Sumit Mohanty,2015-03-03 09:45:10-08:00,['76983f3e722e4707176b4b0094eda7c96d6d26fb'],19,13,32,19868610,4,0,1,0,19017
5221eb4b1132d77b8e25802176cf731b3100a0d8,0,Robert Levas,2015-03-03 13:13:33-05:00,['02ac3940c87cb53e6c9a98ab7479816e257019ec'],1,1,2,19868612,1,,,,19017
ef25e4de84cf1cc86767db5ffffd24616e33d9d3,1,Robert Levas,2015-03-03 13:52:10-05:00,['5221eb4b1132d77b8e25802176cf731b3100a0d8'],308,325,633,19869245,31,0,1,0,19017
da8c9879c1697fe44ce4d556cb696a99a2d65c5a,0,Myroslav Papirkovskyy,2015-03-03 21:06:23+02:00,['ef25e4de84cf1cc86767db5ffffd24616e33d9d3'],288,180,468,19869713,19,0.145695364,0.298013245,0,19023
1fb50b9d45344e82525f93563f71f97c46bf589b,1,Robert Levas,2015-03-03 16:06:19-05:00,['da8c9879c1697fe44ce4d556cb696a99a2d65c5a'],2,2,4,19869717,1,,,,19023
1710156e29498bf5f13ef1326a2a01a245fff056,1,Jaimin Jetly,2015-03-03 13:07:59-08:00,['1fb50b9d45344e82525f93563f71f97c46bf589b'],8,51,59,19869776,4,1,1,1,19023
35333fa2dda7668b159f1de212a39fdcf5d99947,1,Alex Antonenko,2015-03-04 02:02:31+02:00,['1710156e29498bf5f13ef1326a2a01a245fff056'],4,12,16,19869792,2,1,1,1,19023
3dc44a4290d4d37de006b427ea719ecdbd505c40,1,Jonathan Hurley,2015-03-03 17:29:14-05:00,['35333fa2dda7668b159f1de212a39fdcf5d99947'],53,63,116,19869908,2,0,1,1,19023
63bf08e09bd3827a6baa86a86d6ac2caf9d41d19,1,Florian Barca,2015-03-03 17:14:39-08:00,['3dc44a4290d4d37de006b427ea719ecdbd505c40'],26,35,61,19869969,5,0.666666667,0,0.666666667,19023
99cc49b784e0abeb754b20e0ea6d24ed7c6d6f3b,0,Florian Barca,2015-03-03 17:54:11-08:00,['63bf08e09bd3827a6baa86a86d6ac2caf9d41d19'],5,7,12,19869981,2,,,,19023
3d1dd509a9c329dd049114fd7c91ac64f52ab60f,1,Alejandro Fernandez,2015-03-03 18:08:59-08:00,['99cc49b784e0abeb754b20e0ea6d24ed7c6d6f3b'],16,796,812,19870793,9,0,0.984615385,0.953846154,19025
33a84155f28ebeee5584c690860342f9ce604fe1,1,Robert Levas,2015-03-03 21:29:26-05:00,['3d1dd509a9c329dd049114fd7c91ac64f52ab60f'],16,6,22,19870815,2,1,0,1,19025
81209311ef259b2a16a2f7319ea7470b6ca11698,1,Alex Antonenko,2015-03-04 06:33:05+02:00,['33a84155f28ebeee5584c690860342f9ce604fe1'],6,32,38,19870853,4,1,0.285714286,0.571428571,19025
e4b5f42c009586bc2e47984dc12ca61d346bb852,0,Jayush Luniya,2015-03-03 22:37:14-08:00,['81209311ef259b2a16a2f7319ea7470b6ca11698'],6,6,12,19870865,1,,,,19025
666fe656a569b92d0060b13a528c47dd404559d0,1,Oleg Nechiporenko,2015-03-04 13:38:22+02:00,['e4b5f42c009586bc2e47984dc12ca61d346bb852'],3,3,6,19870871,3,,,,19025
fdab48d6ba2efe23fd5729448b00752a61ae0059,1,Jonathan Hurley,2015-03-04 09:16:05-05:00,['666fe656a569b92d0060b13a528c47dd404559d0'],347,572,919,19871790,7,1,0,0,19026
d0406b65e1e6c51aa11bb5f226c1acfec3708fb9,1,tbeerbower,2015-03-04 09:45:53-05:00,['fdab48d6ba2efe23fd5729448b00752a61ae0059'],112,256,368,19872158,3,1,0.983870968,0.935483871,19027
e3c751aeff617c8b1ef5270b36b18af933038dc3,1,Nate Cole,2015-03-04 09:55:40-05:00,['d0406b65e1e6c51aa11bb5f226c1acfec3708fb9'],2,2,4,19872162,1,,,,19027
eb5bfb8a2875326e9cbc02cf986ad883204124fd,1,Lisnichenko Dmitro,2015-03-04 16:58:56+02:00,['e3c751aeff617c8b1ef5270b36b18af933038dc3'],16,124,140,19872302,2,0.037735849,0.037735849,1,19028
b487827073f0cd3337b9887ab8ff438e9a943d1f,1,Andrew Onishuk,2015-03-04 18:02:19+02:00,['eb5bfb8a2875326e9cbc02cf986ad883204124fd'],0,3,3,19872305,2,,,,19028
dbbecdf92fc65ebb6cb14b6e7884b5bf7946a24c,0,Oleg Nechiporenko,2015-03-04 18:41:23+02:00,['b487827073f0cd3337b9887ab8ff438e9a943d1f'],3,8,11,19872316,1,,,,19028
be855bedf1f3391ba64f304695d2d3c46dbeb55d,1,aBabiichuk,2015-03-04 19:13:01+02:00,['dbbecdf92fc65ebb6cb14b6e7884b5bf7946a24c'],10,40,50,19872366,3,0.952380952,1,1,19028
1475c7a953762ab3e20311434b30304e0ed07766,1,Alex Antonenko,2015-03-04 19:35:33+02:00,['be855bedf1f3391ba64f304695d2d3c46dbeb55d'],3,10,13,19872379,1,1,1,1,19028
0482a29ca02bf0d5964a7a832705fc1f22efcb8d,0,Myroslav Papirkovskyy,2015-03-04 19:49:48+02:00,['1475c7a953762ab3e20311434b30304e0ed07766'],60,53,113,19872492,2,,,,19028
67c8448bcf2b1832860cec352d9e60e741e72aee,1,Andrew Onishuk,2015-03-04 19:55:55+02:00,['0482a29ca02bf0d5964a7a832705fc1f22efcb8d'],1,5,6,19872498,1,0,0,0,19028
68404cc82b4999fe6b13735906597679fc42a78c,1,aBabiichuk,2015-03-04 19:56:56+02:00,['67c8448bcf2b1832860cec352d9e60e741e72aee'],5,8,13,19872511,3,,,,19028
a2354b50945ae8636ff0924818aa1a5e9487cefe,1,Myroslav Papirkovskyy,2015-03-04 20:02:52+02:00,['68404cc82b4999fe6b13735906597679fc42a78c'],53,60,113,19872624,2,,,,19029
3db526ca91be620eb91ed8deeb4f80bbb69fbde7,1,Myroslav Papirkovskyy,2015-03-04 20:02:52+02:00,['a2354b50945ae8636ff0924818aa1a5e9487cefe'],60,53,113,19872737,2,,,,19029
a6a5618c798860a5ac9df56db7c48dee051ef2e5,1,Alex Antonenko,2015-03-04 20:07:03+02:00,['3db526ca91be620eb91ed8deeb4f80bbb69fbde7'],10,238,248,19872985,7,0.743902439,0.969512195,1,19030
6549fe8746392981cbf8a2009670750bc1085157,1,Myroslav Papirkovskyy,2015-03-04 20:27:01+02:00,['a6a5618c798860a5ac9df56db7c48dee051ef2e5'],3,7,10,19872995,2,0,0,1,19030
04d63afd1eba9a246031de261cfe9473ec345bb5,1,Lisnichenko Dmitro,2015-03-04 20:39:16+02:00,['6549fe8746392981cbf8a2009670750bc1085157'],9,84,93,19873088,6,0.236363636,0.581818182,0.854545455,19030
16a97aaceeb406d6df64326126c60981f645dd3f,1,Lisnichenko Dmitro,2015-03-04 20:39:22+02:00,['04d63afd1eba9a246031de261cfe9473ec345bb5'],2,12,14,19873102,1,1,1,0,19030
d906f7d1e17db4551f8afba9b156f744c697cbb2,0,Nate Cole,2015-03-04 13:52:56-05:00,['16a97aaceeb406d6df64326126c60981f645dd3f'],0,134,134,19873236,2,,,,19031
a3f7a1fb2d7e8c5c93bf56a8df0f87bca9db701d,0,Alex Antonenko,2015-03-04 22:07:07+02:00,['d906f7d1e17db4551f8afba9b156f744c697cbb2'],6,0,6,19873242,1,0,0,0,19031
e63063f6cc30fb065ad92cd90ee9efc4819c9e10,1,Robert Levas,2015-03-04 16:47:13-05:00,['a3f7a1fb2d7e8c5c93bf56a8df0f87bca9db701d'],55,136,191,19873433,3,0.018518519,0.814814815,0.796296296,19031
971f7878f9712700ed759aa63ccc4dec1d9825b5,1,Jaimin Jetly,2015-03-04 15:07:56-08:00,['e63063f6cc30fb065ad92cd90ee9efc4819c9e10'],32,15,47,19873480,2,0.6,1,1,19031
d174383a5826e19b96281e76edfd37d78c7180d8,1,Dmytro Sen,2015-03-05 02:41:48+02:00,['971f7878f9712700ed759aa63ccc4dec1d9825b5'],9,12,21,19873501,1,0,1,1,19031
cac52fd91fa73ba8e4c138dd5360f3e91009b90c,1,Sumit Mohanty,2015-03-04 19:57:54-08:00,['d174383a5826e19b96281e76edfd37d78c7180d8'],1,1,2,19873503,1,,,,19031
d385af880df04690bcd56a562391914541dfe145,0,Andrii Tkach,2015-03-05 11:58:33+02:00,['cac52fd91fa73ba8e4c138dd5360f3e91009b90c'],2,12,14,19873517,2,0.909090909,1,1,19031
f149fd15cf83c64a28e7ce1e20d3b7b08f159cb5,1,Andrii Tkach,2015-03-05 13:39:32+02:00,['d385af880df04690bcd56a562391914541dfe145'],118,245,363,19873880,8,0.828571429,1,1,19031
4a54f03048e827bc7affb2262e44ae6d14cfd74c,1,Oleg Nechiporenko,2015-03-05 15:20:06+02:00,['f149fd15cf83c64a28e7ce1e20d3b7b08f159cb5'],4,215,219,19874099,2,0.099502488,1,0.980099502,19031
64648d034cc1cb69f83ed60912a339290a86be40,1,Dmytro Sen,2015-03-05 17:45:39+02:00,['4a54f03048e827bc7affb2262e44ae6d14cfd74c'],4,165,169,19874268,5,0.032786885,0.213114754,0.016393443,19031
9a0b211a877fac2e030c27ca8eef0c40d78b6fe3,1,Andrew Onishuk,2015-03-05 17:55:24+02:00,['64648d034cc1cb69f83ed60912a339290a86be40'],108,168,276,19874544,15,0.369565217,1,1,19031
fb3f33539eb9f49a30bd99238e607603d4d6d9c7,1,Sumit Mohanty,2015-03-05 09:08:32-08:00,['9a0b211a877fac2e030c27ca8eef0c40d78b6fe3'],1,2,3,19874547,2,,,,19031
1fcffa7319fb485cf722444b01b466c0db4ac97d,1,Dmytro Sen,2015-03-05 19:27:31+02:00,['fb3f33539eb9f49a30bd99238e607603d4d6d9c7'],2,3,5,19874552,2,0,1,1,19031
d39ceac00289c0372467db506abc856fdf3b4a1e,1,aBabiichuk,2015-03-05 20:50:57+02:00,['1fcffa7319fb485cf722444b01b466c0db4ac97d'],44,74,118,19874670,9,0.882352941,0.882352941,1,19031
bdfba90bb6185ca90b2fc1fcca6d66695aa5f71d,1,Vitaly Brodetskyi,2015-03-05 21:43:00+02:00,['d39ceac00289c0372467db506abc856fdf3b4a1e'],14,32,46,19874716,4,0,1,1,19031
4dc9a3087b7a42f45c6cf0019c628a4fc3c69f20,1,Alejandro Fernandez,2015-03-05 14:41:54-08:00,['bdfba90bb6185ca90b2fc1fcca6d66695aa5f71d'],34,89,123,19874839,6,0,0,1,19032
7a3b5ba1f78557f0ff8a7a841e09efbb2ad7de75,1,Alex Antonenko,2015-03-06 03:02:02+02:00,['4dc9a3087b7a42f45c6cf0019c628a4fc3c69f20'],2,87,89,19874928,2,0.32,1,1,19032
9c14b8f66cef7671eafa1815a5434a37dd6af281,1,Alex Antonenko,2015-03-06 03:35:28+02:00,['7a3b5ba1f78557f0ff8a7a841e09efbb2ad7de75'],27,147,174,19875102,3,0,0.66,0.54,19032
b5ef4a1bc2052b628b20d4ac85976e6e12517663,1,Lisnichenko Dmitro,2015-03-06 11:57:59+02:00,['9c14b8f66cef7671eafa1815a5434a37dd6af281'],22,91,113,19875215,3,0,0.714285714,0.142857143,19032
4bfde435104e79293c02c34efbdff547123df729,1,aBabiichuk,2015-03-06 12:16:40+02:00,['b5ef4a1bc2052b628b20d4ac85976e6e12517663'],2,11,13,19875228,2,,,,19032
8edd3d33e69dcb948f26841739a1d72abfca920a,1,Andrew Onishuk,2015-03-06 13:54:18+02:00,['4bfde435104e79293c02c34efbdff547123df729'],0,6,6,19875234,1,,,,19032
f165b5cd5182b7abddb4d8e57a2c5d5d392a37f6,1,Lisnichenko Dmitro,2015-03-06 13:55:15+02:00,['8edd3d33e69dcb948f26841739a1d72abfca920a'],0,1004,1004,19876238,3,0,0.978021978,1,19033
6c949f4b52be096c1b98e01abb3ac448ca50055f,0,aBabiichuk,2015-03-06 14:02:14+02:00,['f165b5cd5182b7abddb4d8e57a2c5d5d392a37f6'],1,98,99,19876337,2,1,1,1,19033
31a497f4543ba8bfc18b901baef687fa62412461,0,aBabiichuk,2015-03-06 14:25:29+02:00,['6c949f4b52be096c1b98e01abb3ac448ca50055f'],2,3,5,19876342,3,,,,19033
ee6754a7258e6ed43df8bda86506cceaba410989,1,Florian Barca,2015-03-06 09:24:11-08:00,['31a497f4543ba8bfc18b901baef687fa62412461'],0,3,3,19876345,1,1,1,1,19033
813973a051329b721b3f60cbd836ec58f631f4fb,1,Sumit Mohanty,2015-03-06 09:51:04-08:00,['ee6754a7258e6ed43df8bda86506cceaba410989'],24,28,52,19876397,1,,,,19033
4894eabd5d05e585b563aa4e2e5c055418e404a1,1,Jayush Luniya,2015-03-06 10:09:20-08:00,['813973a051329b721b3f60cbd836ec58f631f4fb'],0,9,9,19876406,3,0.285714286,0,1,19033
8775d8846da2ecaf82a16a92712d47d8bc5f5745,1,Lisnichenko Dmitro,2015-03-06 20:55:39+02:00,['4894eabd5d05e585b563aa4e2e5c055418e404a1'],16,336,352,19876758,6,0.044334975,0.54679803,0.694581281,19033
844687f0c81104403226c55af356edcf43532aa5,1,Lisnichenko Dmitro,2015-03-06 20:55:39+02:00,['8775d8846da2ecaf82a16a92712d47d8bc5f5745'],3,3,6,19876764,3,,,,19033
6576da65722ae1c7fd6ee3a006f71b1248b68447,1,Lisnichenko Dmitro,2015-03-06 20:55:39+02:00,['844687f0c81104403226c55af356edcf43532aa5'],3,3,6,19876770,2,,,,19033
24b005a7edafe104e914a0763394a7757f8852a7,0,Myroslav Papirkovskyy,2015-03-07 00:10:45+02:00,['6576da65722ae1c7fd6ee3a006f71b1248b68447'],1,1,2,19876772,1,,,,19033
ef262ecf2ad73ab23bc398bcb43765320aeda1ab,1,Jayush Luniya,2015-03-06 14:19:02-08:00,['24b005a7edafe104e914a0763394a7757f8852a7'],5,1,6,19876778,2,1,0,0,19033
61839b3dcf543e2b07ac23b4ab5cbd3ef3bc6317,0,Siddharth Wagle,2015-03-06 20:02:02-08:00,['ef262ecf2ad73ab23bc398bcb43765320aeda1ab'],90,14,104,19876882,8,0.466666667,0.822222222,0.111111111,19033
d451aced806958611d1539e8696591fee28dc0f2,0,Alex Antonenko,2015-03-07 12:56:59+02:00,['61839b3dcf543e2b07ac23b4ab5cbd3ef3bc6317'],8,16,24,19876906,2,0,0,0,19033
e1d4d9766a222e9375a114e6f959499cabf05ea8,1,tbeerbower,2015-03-07 09:48:28-05:00,['d451aced806958611d1539e8696591fee28dc0f2'],33,259,292,19877198,5,0.744680851,0.744680851,0.744680851,19036
0ae91589651c0ad383c1c36cd143239e1026519a,1,Alex Antonenko,2015-03-07 17:05:40+02:00,['e1d4d9766a222e9375a114e6f959499cabf05ea8'],3,79,82,19877280,7,1,1,1,19038
e0ee513d36733dc6ea4256461102db9d72e69944,0,Andrew Onishuk,2015-03-07 17:42:00+02:00,['0ae91589651c0ad383c1c36cd143239e1026519a'],6,7,13,19877293,1,1,0,1,19038
78c2de2c203e2a8d65cb60186cc9e44867bdcef9,0,Alex Antonenko,2015-03-08 13:10:08+02:00,['e0ee513d36733dc6ea4256461102db9d72e69944'],7,1,8,19877301,2,1,0,0,19038
29d3010991237b804e859f5776c574aec6cdea5e,1,Andrew Onishuk,2015-03-08 16:46:02+02:00,['78c2de2c203e2a8d65cb60186cc9e44867bdcef9'],6,13,19,19877320,3,0,0.714285714,1,19038
7f0ef185c5d218eee19efe9b36864e26e312d916,1,Alex Antonenko,2015-03-08 18:31:51+02:00,['29d3010991237b804e859f5776c574aec6cdea5e'],4,5,9,19877329,1,1,1,1,19038
c81390eaf0d7c56250b4faed2ab108fa0887042e,1,Dmytro Sen,2015-03-09 00:14:01+02:00,['7f0ef185c5d218eee19efe9b36864e26e312d916'],2,6,8,19877337,2,1,1,1,19038
c095bd9116d3391b4745adde0ef03b861b4a099c,0,Robert Levas,2015-03-09 08:20:54-04:00,['c81390eaf0d7c56250b4faed2ab108fa0887042e'],1,1,2,19877339,1,,,,19038
e671f631bb9a4bba0663c4d514185185b89a90db,1,Andrew Onishuk,2015-03-09 14:43:46+02:00,['c095bd9116d3391b4745adde0ef03b861b4a099c'],4,4,8,19877347,2,,,,19038
671146ee51dc78a7486e998dc747a75b1db2193b,0,Robert Levas,2015-03-09 11:01:43-04:00,['e671f631bb9a4bba0663c4d514185185b89a90db'],1,1,2,19877349,1,,,,19038
59e6b48b5b19cc155452dd0e725e88b881a4b94f,1,Jonathan Hurley,2015-03-09 12:41:03-04:00,['671146ee51dc78a7486e998dc747a75b1db2193b'],8,851,859,19878208,5,,,,19041
a0910f7f6cb2394adb8daf8e434f40a7eb155515,1,Nate Cole,2015-03-09 13:20:36-04:00,['59e6b48b5b19cc155452dd0e725e88b881a4b94f'],12,151,163,19878371,4,0.047619048,1,0.642857143,19041
3e1857071efdb50d6c289e8d232812b3002be4c2,1,Alejandro Fernandez,2015-03-09 10:57:12-07:00,['a0910f7f6cb2394adb8daf8e434f40a7eb155515'],2,286,288,19878659,4,0,1,0.075757576,19043
89be8e5581079337432922f2ed7f4640314ba086,1,Robert Levas,2015-03-09 15:11:42-04:00,['3e1857071efdb50d6c289e8d232812b3002be4c2'],579,817,1396,19880055,36,0.270531401,0.289855072,0.797101449,19044
99995afc33ea46f8c4479f192190202fbe506b7e,0,Dmytro Sen,2015-03-09 21:52:10+02:00,['89be8e5581079337432922f2ed7f4640314ba086'],3,3,6,19880061,2,,,,19044
4e8163364d5a1188c324f350502b4371400d78f3,1,aBabiichuk,2015-03-09 22:06:09+02:00,['99995afc33ea46f8c4479f192190202fbe506b7e'],3,3,6,19880067,1,,,,19044
bc7ff9ea58d27b859d0aabc3aadfac802c87d3d1,1,aBabiichuk,2015-03-09 22:06:09+02:00,['4e8163364d5a1188c324f350502b4371400d78f3'],1,2,3,19880070,1,0,0,1,19044
cd155366ba9ee2617cd3e2952f5ba7cda2b90ccf,1,Alex Antonenko,2015-03-09 23:04:58+02:00,['bc7ff9ea58d27b859d0aabc3aadfac802c87d3d1'],3,7,10,19880080,2,1,1,1,19044
7f78dffd637e879d56d77225a3ab2728ef88f653,1,Robert Levas,2015-03-09 18:09:42-04:00,['cd155366ba9ee2617cd3e2952f5ba7cda2b90ccf'],0,1,1,19880081,1,1,1,1,19044
6954c55805153bc39c159d12fc09e4f8d02e38dd,1,Jayush Luniya,2015-03-09 18:23:34-07:00,['7f78dffd637e879d56d77225a3ab2728ef88f653'],4,462,466,19880547,4,0,0.03125,0.34375,19045
00da270d1f9fd4a8247791672534bbcf24141aee,1,Jonathan Hurley,2015-03-10 00:16:46-04:00,['6954c55805153bc39c159d12fc09e4f8d02e38dd'],82,105,187,19880734,11,1,0.25,0,19046
6e949c8c3fbe57ca642ade81e54f3066ceecc383,0,Jonathan Hurley,2015-03-10 08:32:58-04:00,['00da270d1f9fd4a8247791672534bbcf24141aee'],0,1,1,19880735,1,,,,19046
70e3e1f344a897bf0e2c48643006ddbcfd47719e,1,Oleg Nechiporenko,2015-03-10 16:08:53+02:00,['6e949c8c3fbe57ca642ade81e54f3066ceecc383'],20,100,120,19880855,6,1,1,1,19046
57915556bf0daf845a6068ff6d5f722ca499908d,1,Oleg Nechiporenko,2015-03-10 16:38:10+02:00,['70e3e1f344a897bf0e2c48643006ddbcfd47719e'],1,1,2,19880857,1,,,,19046
435f9a14bfaf11f5eb0c35f9c141afea2dc36cbd,1,Alex Antonenko,2015-03-10 19:40:48+02:00,['57915556bf0daf845a6068ff6d5f722ca499908d'],127,340,467,19881324,7,0.880794702,0.880794702,1,19046
7ca07ca71832bac562913cf5382868f61798768f,0,Vitaly Brodetskyi,2015-03-10 20:00:40+02:00,['435f9a14bfaf11f5eb0c35f9c141afea2dc36cbd'],1,1,2,19881326,1,,,,19046
96e8bbdf080d7dd5abee5ec5ae8497269303c543,1,Alejandro Fernandez,2015-03-10 11:52:15-07:00,['7ca07ca71832bac562913cf5382868f61798768f'],0,8,8,19881334,3,0,1,1,19046
72ad30b9a610d4bf822b61662cc63faff0c3029c,1,Andrew Onishuk,2015-03-10 20:54:35+02:00,['96e8bbdf080d7dd5abee5ec5ae8497269303c543'],10,3,13,19881347,2,1,0,0,19046
86c253a97e15a9200c88e0ccf083efda18cb7aa4,1,Alejandro Fernandez,2015-03-10 11:56:43-07:00,['72ad30b9a610d4bf822b61662cc63faff0c3029c'],1,1,2,19881349,1,,,,19046
3297b15ad26031c18b060a0cf8c59b5e9500dde3,1,Lisnichenko Dmitro,2015-03-10 21:09:21+02:00,['86c253a97e15a9200c88e0ccf083efda18cb7aa4'],1,1,2,19881351,1,,,,19046
97cf296c98ce50874bc30b1718bbd49ddd207219,1,Dmytro Sen,2015-03-10 21:44:07+02:00,['3297b15ad26031c18b060a0cf8c59b5e9500dde3'],16,98,114,19881465,2,0.148648649,0.472972973,0.662162162,19046
bc5047acbeb3895d12e248ed8ba04fb058a06654,1,Dmytro Sen,2015-03-10 22:02:47+02:00,['97cf296c98ce50874bc30b1718bbd49ddd207219'],17,17,34,19881499,7,,,,19046
7d8b92234a3b578aacfcedf468569b2fc062772d,1,Jonathan Hurley,2015-03-10 16:19:24-04:00,['bc5047acbeb3895d12e248ed8ba04fb058a06654'],1,1,2,19881501,1,,,,19046
fea33155acdf317473a695f1d90060e70fd05aa1,1,Lisnichenko Dmitro,2015-03-10 23:32:04+02:00,['7d8b92234a3b578aacfcedf468569b2fc062772d'],126,149,275,19881776,9,1,0,1,19046
e8daa485f66d4c14d21d81101e79ab21ae5b3d7e,1,Alex Antonenko,2015-03-10 23:42:00+02:00,['fea33155acdf317473a695f1d90060e70fd05aa1'],3,6,9,19881785,2,1,1,0,19046
eba68bfcced0aae26bb5c3f50fdb51ac8f9d3271,1,Alex Antonenko,2015-03-10 23:42:00+02:00,['e8daa485f66d4c14d21d81101e79ab21ae5b3d7e'],5,310,315,19882100,2,0.049342105,0.983552632,1,19046
c736b57a3c0835466bdc30fbc1aea669b80e21df,0,Alex Antonenko,2015-03-11 01:02:22+02:00,['eba68bfcced0aae26bb5c3f50fdb51ac8f9d3271'],2,2,4,19882104,1,,,,19046
72a0c9f045177bc1f2628d0c5c974d066f3129d2,1,Srimanth Gunturi,2015-03-10 16:45:02-07:00,['c736b57a3c0835466bdc30fbc1aea669b80e21df'],0,172,172,19882276,1,,,,19047
730c081d78f7a49bc0dee8f878585d685f61c773,1,Siddharth Wagle,2015-03-10 16:52:04-07:00,['72a0c9f045177bc1f2628d0c5c974d066f3129d2'],2,16,18,19882294,1,0.5,0.5,1,19047
75e982a9d84774929fb225bb0bdebedf043f9c08,0,Alejandro Fernandez,2015-03-10 18:10:21-07:00,['730c081d78f7a49bc0dee8f878585d685f61c773'],0,19,19,19882313,1,0,1,0,19047
08dd22f940b5669ff3e4e9d001687d668b7e3c25,1,Sumit Mohanty,2015-03-10 21:35:41-07:00,['75e982a9d84774929fb225bb0bdebedf043f9c08'],3,2212,2215,19884528,34,0.183962264,0.483490566,0.983490566,19078
9e920aae7a7fe5e129e37791040909e0ae55ff84,1,Vitaly Brodetskyi,2015-03-11 15:14:16+02:00,['08dd22f940b5669ff3e4e9d001687d668b7e3c25'],1,15,16,19884544,1,0,0,1,19078
a4dbcf321ed55b1b152fe7689aefaa8a85fa9676,1,Nate Cole,2015-03-11 09:27:21-04:00,['9e920aae7a7fe5e129e37791040909e0ae55ff84'],7,1,8,19884552,1,,,,19078
91ca6666d8862029882abf806e32dab051167d9c,1,tbeerbower,2015-03-11 10:19:49-04:00,['a4dbcf321ed55b1b152fe7689aefaa8a85fa9676'],55,50,105,19884657,2,1,1,0,19078
d84898e59893bf8bf1c419ff8d8791087782e0fd,1,Alex Antonenko,2015-03-11 18:20:54+02:00,['91ca6666d8862029882abf806e32dab051167d9c'],13,43,56,19884713,2,0.357142857,1,1,19078
1c78b20151f12d2714da2e033db672fe5f080ced,0,Robert Levas,2015-03-11 12:43:25-04:00,['d84898e59893bf8bf1c419ff8d8791087782e0fd'],15,2,17,19884730,1,0.833333333,0.833333333,0.333333333,19078
928545392aaad89fc82a22c2b38f11429b571647,0,Oleg Nechiporenko,2015-03-11 19:01:05+02:00,['1c78b20151f12d2714da2e033db672fe5f080ced'],0,49,49,19884779,2,0.551020408,1,1,19078
c12bce3acce61d226a58a3aca482580e52fb9376,1,Andrew Onishuk,2015-03-11 19:27:32+02:00,['928545392aaad89fc82a22c2b38f11429b571647'],7,15,22,19884801,1,1,1,1,19078
1b22d34e51375e265fc125fda6b587438e02d185,1,Andrew Onishuk,2015-03-11 20:01:37+02:00,['c12bce3acce61d226a58a3aca482580e52fb9376'],17,17,34,19884835,3,,,,19078
f81da87c09788118df46ce907e0e6891003aa0b7,0,Andrew Onishuk,2015-03-11 20:03:23+02:00,['1b22d34e51375e265fc125fda6b587438e02d185'],4,4,8,19884843,1,,,,19078
516d718fc96625a146a9e276c65a8fd9990a5976,1,Jonathan Hurley,2015-03-11 14:15:03-04:00,['f81da87c09788118df46ce907e0e6891003aa0b7'],126,250,376,19885219,24,0.528846154,0.538461538,0.913461538,19078
14ef5195c9ba643302759e0c82a7d4a210951bfd,1,aBabiichuk,2015-03-11 21:18:19+02:00,['516d718fc96625a146a9e276c65a8fd9990a5976'],3,10,13,19885232,2,0,1,0.833333333,19078
7d6ab56a671aef6d5bea2192aebfc43bf8b2e653,1,Dmytro Sen,2015-03-11 21:50:00+02:00,['14ef5195c9ba643302759e0c82a7d4a210951bfd'],7,10,17,19885249,1,0,0,1,19078
da3a88f2c8583e5fdefdc088fd51f38a409cd1c1,1,Andrew Onishuk,2015-03-11 23:48:08+02:00,['7d6ab56a671aef6d5bea2192aebfc43bf8b2e653'],0,1130,1130,19886379,22,,,,19100
04f54294eb182c719c2998c67b9865d3e0b3fc9c,1,Florian Barca,2015-03-11 16:09:45-07:00,['da3a88f2c8583e5fdefdc088fd51f38a409cd1c1'],2,58,60,19886439,3,0.666666667,1,0.333333333,19101
6bf7adc5e1e9ce2ade3163d50087257d727d830b,1,Robert Levas,2015-03-11 20:38:28-04:00,['04f54294eb182c719c2998c67b9865d3e0b3fc9c'],67,350,417,19886856,5,0.083333333,0.80952381,1,19102
4d1334719e92c2dfa5327675995ce44593772177,1,Alejandro Fernandez,2015-03-11 19:19:33-07:00,['6bf7adc5e1e9ce2ade3163d50087257d727d830b'],1,3,4,19886860,2,,,,19102
8196a5d793490b4325adf74eb55d668922a22dcf,0,Andrew Onishuk,2015-03-12 15:46:47+02:00,['4d1334719e92c2dfa5327675995ce44593772177'],3,3,6,19886866,2,,,,19102
223a65cc1d94a0a2dc45e7c397399d935f8edc56,1,Alex Antonenko,2015-03-12 17:33:16+02:00,['8196a5d793490b4325adf74eb55d668922a22dcf'],32,2,34,19886900,1,,,,19102
4530322bdd65889ac55c2e39fb314ff8d00b4701,1,Aleksandr Kovalenko,2015-03-12 19:27:20+02:00,['223a65cc1d94a0a2dc45e7c397399d935f8edc56'],1,50,51,19886951,3,0.5,1,1,19102
190bd0b0433923fa0db9c9d91900aa0d5f59a18b,1,Florian Barca,2015-03-12 10:37:43-07:00,['4530322bdd65889ac55c2e39fb314ff8d00b4701'],161,213,374,19887325,14,1,1,0,19102
4cf5414f5a83459efc983a9c37ac80dee41729e6,0,Dmytro Sen,2015-03-12 19:49:07+02:00,['190bd0b0433923fa0db9c9d91900aa0d5f59a18b'],3,10,13,19887338,2,,,,19102
832d60529df56218ed5aaa29e0ee1d5c8d60085b,0,Dmytro Sen,2015-03-12 19:49:07+02:00,['4cf5414f5a83459efc983a9c37ac80dee41729e6'],1,2,3,19887341,2,,,,19102
0488f74427d6b3bf7d6d46bc97d9c86e4abe8f70,1,Dmytro Sen,2015-03-12 19:57:37+02:00,['832d60529df56218ed5aaa29e0ee1d5c8d60085b'],2,1,3,19887344,2,,,,19102
df67ca27f45240a4b48eae6c9239e98d73bd946c,0,Dmytro Sen,2015-03-12 19:58:06+02:00,['0488f74427d6b3bf7d6d46bc97d9c86e4abe8f70'],10,3,13,19887357,2,,,,19102
8eaadd0908ccf59a42ca443cc9b40dc7273ff6a3,0,Srimanth Gunturi,2015-03-12 10:58:48-07:00,['df67ca27f45240a4b48eae6c9239e98d73bd946c'],2,69,71,19887428,2,1,1,1,19102
1f260e0a84662eb3e2ac88a95a980f76bfda0453,1,Dmytro Sen,2015-03-12 20:01:31+02:00,['8eaadd0908ccf59a42ca443cc9b40dc7273ff6a3'],2,3,5,19887433,3,,,,19102
473372c91110a10d5933bf9f04de22cf52e2f908,1,Robert Levas,2015-03-12 14:03:20-04:00,['1f260e0a84662eb3e2ac88a95a980f76bfda0453'],1,2,3,19887436,1,0,0,1,19102
bdfd5d0546263dba215958d96b2b0b7d496f1f23,1,Andrew Onishuk,2015-03-12 20:06:53+02:00,['473372c91110a10d5933bf9f04de22cf52e2f908'],11,8,19,19887455,4,0.333333333,1,0,19102
751b310478dd0b8de51724e668113629de0e4c7d,1,Nate Cole,2015-03-12 14:36:53-04:00,['bdfd5d0546263dba215958d96b2b0b7d496f1f23'],362,328,690,19888145,5,1,0.213483146,0,19102
d786be4ae63c89a1157e54997e79e7aa3439c143,1,Alex Antonenko,2015-03-12 21:31:20+02:00,['751b310478dd0b8de51724e668113629de0e4c7d'],3,22,25,19888170,2,0,1,1,19102
db97312728bf9c04b3ec7711593fecd04a7554d1,1,Alex Antonenko,2015-03-12 21:31:20+02:00,['d786be4ae63c89a1157e54997e79e7aa3439c143'],773,3211,3984,19892154,112,0.459107807,0.932156134,0.941449814,19130
ae997b1ddac891a5f8b896800b6a8b5d77b52d94,1,Robert Levas,2015-03-12 15:38:04-04:00,['db97312728bf9c04b3ec7711593fecd04a7554d1'],26,28,54,19892208,1,,,,19130
ad8536b9561060529e74aa5721d80e28b492724e,1,Jonathan Hurley,2015-03-12 16:26:25-04:00,['ae997b1ddac891a5f8b896800b6a8b5d77b52d94'],91,130,221,19892429,7,1,1,1,19130
7b1500ef568ee8de0187d65901360344294a3ec3,1,Jayush Luniya,2015-03-12 16:51:43-07:00,['ad8536b9561060529e74aa5721d80e28b492724e'],16,43,59,19892488,2,0,0.692307692,0.961538462,19130
776c93f0606815f57e0c78ca5af583b8ceba5e1f,1,Jayush Luniya,2015-03-12 18:47:55-07:00,['7b1500ef568ee8de0187d65901360344294a3ec3'],472,892,1364,19893852,16,0.6,1,0.7,19130
63eea8b1ca88e2d5002bd837062ee94d65ee0836,1,Siddharth Wagle,2015-03-12 20:59:08-07:00,['776c93f0606815f57e0c78ca5af583b8ceba5e1f'],0,4,4,19893856,1,0,1,1,19130
a7be81f598133e59b7766eee26ad0569ff741da4,1,Siddharth Wagle,2015-03-12 21:05:25-07:00,['63eea8b1ca88e2d5002bd837062ee94d65ee0836'],3,9,12,19893868,1,0,1,1,19130
ff8a0f04b09d868889b52e18f96c4140785f1da9,0,Mahadev Konar,2015-03-12 22:44:09-07:00,['a7be81f598133e59b7766eee26ad0569ff741da4'],3,1,4,19893872,1,,,,19130
1ea0ffbfae782d7401044243e569f9374d6877c5,0,Jayush Luniya,2015-03-12 23:15:35-07:00,['ff8a0f04b09d868889b52e18f96c4140785f1da9'],5,5,10,19893882,1,0,0,0,19130
e88914da66382a5396434d0a546eb72f3f522473,1,aBabiichuk,2015-03-13 10:40:40+02:00,['1ea0ffbfae782d7401044243e569f9374d6877c5'],4,454,458,19894340,9,1,1,1,19135
49e894f4be5244e50b33388ed1b8ba88eecc61c8,1,Dmytro Sen,2015-03-13 12:31:56+02:00,['e88914da66382a5396434d0a546eb72f3f522473'],5,14,19,19894359,3,0,0,1,19135
fa53f0afcddd766e697e74bca979d054354fc65c,0,Dmytro Sen,2015-03-13 14:20:51+02:00,['49e894f4be5244e50b33388ed1b8ba88eecc61c8'],2,2,4,19894363,1,,,,19135
92b13e35764bbb9e7b0d9842e1e7a0bba332e59e,1,Jonathan Hurley,2015-03-13 09:23:56-04:00,['fa53f0afcddd766e697e74bca979d054354fc65c'],69,313,382,19894745,7,0,0.8125,1,19137
79326d96452e694468273b40c480194a38146724,1,Nate Cole,2015-03-13 09:29:46-04:00,['92b13e35764bbb9e7b0d9842e1e7a0bba332e59e'],1,245,246,19894991,3,0.875,1,1,19138
ed9b4fb9842128da2cfa5b260252e4000010fe3c,0,Jonathan Hurley,2015-03-13 10:40:10-04:00,['79326d96452e694468273b40c480194a38146724'],0,4,4,19894995,1,0,0,1,19138
f92c3f13fac6af66b2d429feade5414146ca63f2,0,Andrew Onishuk,2015-03-13 16:59:08+02:00,['ed9b4fb9842128da2cfa5b260252e4000010fe3c'],2,2,4,19894999,1,,,,19138
5c4d8bb1df63a7e7ebde9b685cd6a4d95a6a8c29,1,Alejandro Fernandez,2015-03-13 11:53:19-07:00,['f92c3f13fac6af66b2d429feade5414146ca63f2'],33,42,75,19895074,8,0,0,1,19138
78be980698a023701d11bdbc22204874ec616dd6,1,Siddharth Wagle,2015-03-13 13:49:27-07:00,['5c4d8bb1df63a7e7ebde9b685cd6a4d95a6a8c29'],0,8,8,19895082,1,,,,19138
88aed0b8e3f0db2e2726358a7622c4d5519ea709,0,Nate Cole,2015-03-13 17:23:10-04:00,['78be980698a023701d11bdbc22204874ec616dd6'],58,93,151,19895233,6,1,1,1,19138
a5c571e973badd90da3cb34e6c8345a3d80c9e4c,1,Jayush Luniya,2015-03-13 15:28:27-07:00,['88aed0b8e3f0db2e2726358a7622c4d5519ea709'],35,52,87,19895320,3,0,0.947368421,0.789473684,19138
d7569a202e292d0a8d1757c95f508a7ca82ab36d,1,Siddharth Wagle,2015-03-13 17:21:53-07:00,['a5c571e973badd90da3cb34e6c8345a3d80c9e4c'],2,2,4,19895324,2,,,,19138
af98d3bb08758b1b47917a7f625df4b4d8ef06a8,1,Andrew Onishuk,2015-03-14 16:36:30+02:00,['d7569a202e292d0a8d1757c95f508a7ca82ab36d'],3,3,6,19895330,2,,,,19138
a5f99f4f4f641166fae476ca733858cca4bc4cd0,1,Alejandro Fernandez,2015-03-14 10:55:29-07:00,['af98d3bb08758b1b47917a7f625df4b4d8ef06a8'],8,350,358,19895688,6,0,0.142857143,1,19140
95103a905df36745b8e9f01768a612193626c221,1,Alex Antonenko,2015-03-14 22:56:52+02:00,['a5f99f4f4f641166fae476ca733858cca4bc4cd0'],1149,2869,4018,19899706,34,0.892100193,0.799614644,1,19144
def3848f393a3eaf6476b70e98098820212cc338,1,Alejandro Fernandez,2015-03-14 18:15:51-07:00,['95103a905df36745b8e9f01768a612193626c221'],1,1,2,19899708,1,,,,19144
7a23cdaf6677b759d3744ffc6fcbcf07feb8d5d0,1,Robert Levas,2015-03-14 23:13:02-04:00,['def3848f393a3eaf6476b70e98098820212cc338'],26,155,181,19899889,5,0.227848101,1,1,19144
0082ca1aa70fa23582a2e6401669b048224c934c,0,Jaimin Jetly,2015-03-14 20:52:11-07:00,['7a23cdaf6677b759d3744ffc6fcbcf07feb8d5d0'],3,7,10,19899899,1,1,1,1,19144
9c22eafba430f7e15a62ca64dabc49e42633bae3,1,Andrew Onishuk,2015-03-15 17:14:43+02:00,['0082ca1aa70fa23582a2e6401669b048224c934c'],0,11,11,19899910,3,0,0.666666667,1,19144
c12ffd18fc74633d721842a9aa327c22654cca8d,1,Dmytro Sen,2015-03-15 19:15:54+02:00,['9c22eafba430f7e15a62ca64dabc49e42633bae3'],39,72,111,19900021,5,0.043478261,0.956521739,0.391304348,19144
e008be5decac48f6f07da5652748fabc32ea513f,0,Siddharth Wagle,2015-03-15 10:53:21-07:00,['c12ffd18fc74633d721842a9aa327c22654cca8d'],2,2,4,19900025,1,,,,19144
39157df9d93024015547191e3ef036dd57b7d3e5,1,aBabiichuk,2015-03-16 09:11:47+02:00,['e008be5decac48f6f07da5652748fabc32ea513f'],1,18000,18001,19918026,11,0.393048128,1,0.989304813,19150
72b40b7b70daf5ad42e32aef4f94f08cddb35403,1,Oleg Nechiporenko,2015-03-16 10:58:43+02:00,['39157df9d93024015547191e3ef036dd57b7d3e5'],207,300,507,19918533,17,1,1,1,19150
ed616f1d544eb1311c734d5199e9d081e794eaf1,1,Oleg Nechiporenko,2015-03-16 11:10:53+02:00,['72b40b7b70daf5ad42e32aef4f94f08cddb35403'],106,7246,7352,19925885,13,0.56169127,0.708219428,0.875888464,19152
bfad3faed8716984ac44bece7c7ba777499b54e0,1,Alex Antonenko,2015-03-16 13:49:23+02:00,['ed616f1d544eb1311c734d5199e9d081e794eaf1'],1,1,2,19925887,1,,,,19152
e4bfb03c7ce01cc533b27c23bff3c278971bf41b,1,Alex Antonenko,2015-03-16 15:14:05+02:00,['bfad3faed8716984ac44bece7c7ba777499b54e0'],13,15,28,19925915,2,0,1,0,19152
8cf83e953f6297932913ddc568bd31d2188c424c,1,Andrii Tkach,2015-03-16 16:10:13+02:00,['e4bfb03c7ce01cc533b27c23bff3c278971bf41b'],2,80,82,19925997,3,0.217948718,1,1,19152
5796e12de7240dd47411eaa2f25be620b5dab2db,0,Billie Rinaldi,2015-03-16 09:34:20-07:00,['8cf83e953f6297932913ddc568bd31d2188c424c'],1,27,28,19926025,6,0,0,0.75,19152
35b96f7283be0469594c3fda7cb3b6a8b5aeec91,1,Oleg Nechiporenko,2015-03-16 18:40:09+02:00,['5796e12de7240dd47411eaa2f25be620b5dab2db'],9,97,106,19926131,4,1,1,1,19152
8bba8c7e2730b3819d7101390b3d9ec54960e7a3,1,Andrii Tkach,2015-03-16 18:40:29+02:00,['35b96f7283be0469594c3fda7cb3b6a8b5aeec91'],6,16,22,19926153,3,1,1,1,19152
7ff455102bac70e6e85a8776f4d26615192e1f59,0,Alex Antonenko,2015-03-16 18:52:41+02:00,['8bba8c7e2730b3819d7101390b3d9ec54960e7a3'],27,1,28,19926181,6,1,1,0.25,19152
fcb18659be579ff832b066f645476ffe1c3ec847,1,Jonathan Hurley,2015-03-16 13:00:14-04:00,['7ff455102bac70e6e85a8776f4d26615192e1f59'],99,103,202,19926383,7,1,0.833333333,0,19152
656fd855fa62c31bb23277fa1d0ad5ddbe8dc0f7,0,Oleg Nechiporenko,2015-03-16 19:18:37+02:00,['fcb18659be579ff832b066f645476ffe1c3ec847'],1,21,22,19926405,2,1,1,1,19152
34c3951c20b1703aa00abddcf234f60c210571a4,1,aBabiichuk,2015-03-16 19:28:47+02:00,['656fd855fa62c31bb23277fa1d0ad5ddbe8dc0f7'],29,2269,2298,19928703,15,0.353233831,1,0.860696517,19155
c61c920bcac93d7b0fa012c2e93a73d43d319700,1,Jaimin Jetly,2015-03-16 11:02:23-07:00,['34c3951c20b1703aa00abddcf234f60c210571a4'],2,24,26,19928729,2,0,0.944444444,0.944444444,19155
e813af2fe942fba96627f54744d9ee758d328830,1,aBabiichuk,2015-03-16 20:43:32+02:00,['c61c920bcac93d7b0fa012c2e93a73d43d319700'],14,120,134,19928863,3,1,1,1,19155
3a652f0c99b25dd33091e58dab489810f8aaefa5,1,Dmytro Sen,2015-03-16 21:06:57+02:00,['e813af2fe942fba96627f54744d9ee758d328830'],1,2,3,19928866,1,0,0,1,19155
6effe457e493d682de652c277a572fde7e1885e8,0,Nate Cole,2015-03-16 15:29:57-04:00,['3a652f0c99b25dd33091e58dab489810f8aaefa5'],15,35,50,19928916,3,1,1,1,19155
d8b862388a9df0779585eb78964c00c4bf14dc84,1,Vitaly Brodetskyi,2015-03-15 23:19:33+02:00,['6effe457e493d682de652c277a572fde7e1885e8'],0,11,11,19928927,2,,,,19155
fae1eb7f385eb1924fdd98152d58bde53c5d0c1b,1,Andrew Onishuk,2015-03-16 22:41:48+02:00,['d8b862388a9df0779585eb78964c00c4bf14dc84'],4,5,9,19928936,1,1,1,1,19155
7d0cd6536aa822f6b6b900bc92b3d49ce358a06a,1,Jaimin Jetly,2015-03-16 17:04:39-07:00,['fae1eb7f385eb1924fdd98152d58bde53c5d0c1b'],32,43,75,19929011,2,0.888888889,0.888888889,1,19155
2cbf236eb87b53693270cbc092001bb950b4e870,1,Siddharth Wagle,2015-03-16 20:11:34-07:00,['7d0cd6536aa822f6b6b900bc92b3d49ce358a06a'],11,81,92,19929103,8,0,0.173913043,0.826086957,19155
de3667a2195fd7796bc5a9cbc4f7a79d945979b9,1,Andrii Tkach,2015-03-17 11:40:46+02:00,['2cbf236eb87b53693270cbc092001bb950b4e870'],0,6,6,19929109,1,,,,19155
80afc9f027244eb17cd32c778f47e0bfd2398bf0,1,Florian Barca,2015-03-17 03:25:57-07:00,['de3667a2195fd7796bc5a9cbc4f7a79d945979b9'],68,304,372,19929481,5,0.821428571,0.821428571,0,19157
4f84615da39c64aab3ee31b23420b98db7926223,1,Dmytro Sen,2015-03-17 12:36:36+02:00,['80afc9f027244eb17cd32c778f47e0bfd2398bf0'],1,4,5,19929486,2,0,0.666666667,1,19157
9a2214f1c0388b8f3df5c29b2d4fb4bcf70bf799,1,Artem Baranchuk,2015-03-17 12:45:43+02:00,['4f84615da39c64aab3ee31b23420b98db7926223'],72,238,310,19929796,6,,,,19157
ff711095e1e3300798af8fa5bcef49ff8dd97176,0,Dmytro Sen,2015-03-17 12:54:18+02:00,['9a2214f1c0388b8f3df5c29b2d4fb4bcf70bf799'],2,2,4,19929800,1,,,,19157
8a821dbf2d5ae61e30a5dbbf40b1b866c25276e0,1,Jonathan Hurley,2015-03-17 09:22:55-04:00,['ff711095e1e3300798af8fa5bcef49ff8dd97176'],45,58,103,19929903,10,0,0,1,19157
966d39333e60b9b0c2a0b01954f067471e87c152,1,Jonathan Hurley,2015-03-17 09:43:01-04:00,['8a821dbf2d5ae61e30a5dbbf40b1b866c25276e0'],7,7,14,19929917,2,,,,19157
9fe2741dcc5fbee571ca9fd67ca026c45a480433,1,Lisnichenko Dmitro,2015-03-17 15:56:08+02:00,['966d39333e60b9b0c2a0b01954f067471e87c152'],4,153,157,19930074,5,0.253968254,1,0.507936508,19159
ea1d531beb002af36e320550873594acae5147d4,1,aBabiichuk,2015-03-17 16:47:37+02:00,['9fe2741dcc5fbee571ca9fd67ca026c45a480433'],65,800,865,19930939,16,0.484745763,1,1,19165
72bd502b051a5343bf5ff3987ecbccec22f47ff4,1,Andrii Tkach,2015-03-17 17:13:50+02:00,['ea1d531beb002af36e320550873594acae5147d4'],3,182,185,19931124,9,1,1,1,19168
434ce972e7e609a8b2922e2836615119680c29f5,1,Billie Rinaldi,2015-03-17 08:20:57-07:00,['72bd502b051a5343bf5ff3987ecbccec22f47ff4'],3,33,36,19931160,7,0,0,0.8125,19168
1db1692eec500c5d93332b8f0a3e3b6b752641bc,0,Alex Antonenko,2015-03-17 17:40:19+02:00,['434ce972e7e609a8b2922e2836615119680c29f5'],3,2,5,19931165,1,0,0,0,19168
c34b474108be07ea5db8fd56b04af96fb3dc06d1,1,Andrew Onishuk,2015-03-17 18:41:05+02:00,['1db1692eec500c5d93332b8f0a3e3b6b752641bc'],21,27,48,19931213,9,0,0,1,19168
a0dab0ce868f55f668c2a2ed9ce575fb5af3cd46,1,aBabiichuk,2015-03-17 19:20:23+02:00,['c34b474108be07ea5db8fd56b04af96fb3dc06d1'],3,24,27,19931240,5,1,1,1,19168
9d5ff60d7d640f14ad0dd33e1d6e48514ab39e6e,1,Aleksandr Kovalenko,2015-03-17 19:34:36+02:00,['a0dab0ce868f55f668c2a2ed9ce575fb5af3cd46'],52,325,377,19931617,20,0.808,0.96,1,19169
ed021fa82f8168c35f9a87d715e9ec88429c3e93,1,Alejandro Fernandez,2015-03-17 10:58:25-07:00,['9d5ff60d7d640f14ad0dd33e1d6e48514ab39e6e'],0,2,2,19931619,2,,,,19169
a67fc09e2559cae9c01738fc8ec44ec70c717937,1,Andrii Tkach,2015-03-17 20:19:38+02:00,['ed021fa82f8168c35f9a87d715e9ec88429c3e93'],2,28,30,19931649,6,0.333333333,1,1,19169
78a1eb58056706d6eeceeb0a5fd4d80cfad95cb7,1,Robert Levas,2015-03-17 16:51:50-04:00,['a67fc09e2559cae9c01738fc8ec44ec70c717937'],4,16,20,19931669,2,0,0,1,19169
f751bfa6aed3aeb98792ac435b737a901ad240ed,0,Alex Antonenko,2015-03-17 23:47:20+02:00,['78a1eb58056706d6eeceeb0a5fd4d80cfad95cb7'],0,3,3,19931672,1,1,1,1,19169
709ad140e2b9870dff41b0d49e8c76c2fc5111ac,1,Yusaku Sako,2015-03-17 17:06:39-07:00,['f751bfa6aed3aeb98792ac435b737a901ad240ed'],6,9,15,19931687,4,,,,19169
f7109d2ffb37acf823cc192bcf81acc7930b0f9c,1,Xi Wang,2015-03-17 17:44:38-07:00,['709ad140e2b9870dff41b0d49e8c76c2fc5111ac'],25,106,131,19931818,8,0,0,0,19170
8599d19d93a774fa248d97400b7b6270c1d677fd,1,Siddharth Wagle,2015-03-17 18:32:21-07:00,['f7109d2ffb37acf823cc192bcf81acc7930b0f9c'],33,109,142,19931960,5,0.175,0.425,0.2,19170
e11724985b6c0139b16380b112ee1415d5af4a2b,1,aBabiichuk,2015-03-18 11:11:25+02:00,['8599d19d93a774fa248d97400b7b6270c1d677fd'],92,98,190,19932150,11,1,0.666666667,1,19170
bef5a71deb3690c9c8c36c8c9ee4681ea9cb1854,1,Aleksandr Kovalenko,2015-03-18 14:28:19+02:00,['e11724985b6c0139b16380b112ee1415d5af4a2b'],9,8,17,19932167,1,0,0,0,19170
365dc3b540b166fc87aaa9ab556f4a39a2b1c008,1,Andrew Onishuk,2015-03-18 14:39:46+02:00,['bef5a71deb3690c9c8c36c8c9ee4681ea9cb1854'],14,14,28,19932195,2,,,,19170
b21d8176fbdb6f8cd535220af1fdc9e51b414955,1,aBabiichuk,2015-03-18 15:25:23+02:00,['365dc3b540b166fc87aaa9ab556f4a39a2b1c008'],9,11,20,19932215,3,1,1,1,19170
7d4fdd9be0814b6fcd92651edfefd07af3842f16,0,Alex Antonenko,2015-03-18 17:56:50+02:00,['b21d8176fbdb6f8cd535220af1fdc9e51b414955'],0,8,8,19932223,2,0,0,1,19170
21602caf64cfc88381de882b4ed566711342ab22,1,Florian Barca,2015-03-18 09:27:26-07:00,['7d4fdd9be0814b6fcd92651edfefd07af3842f16'],31,43,74,19932297,3,0,0,0,19170
806d31f5f39aaa13cbd7872f41a00b7f31750d64,1,Oleg Nechiporenko,2015-03-18 19:10:59+02:00,['21602caf64cfc88381de882b4ed566711342ab22'],0,497,497,19932794,8,1,1,1,19175
217f3d71c63bb02ed776580562f24d7c751c5c35,0,aBabiichuk,2015-03-18 19:29:40+02:00,['806d31f5f39aaa13cbd7872f41a00b7f31750d64'],1,1,2,19932796,1,,,,19175
32e1215639f3cdfea68e2955f316576f1ded85fe,1,Robert Levas,2015-03-18 15:13:58-04:00,['217f3d71c63bb02ed776580562f24d7c751c5c35'],3,3,6,19932802,1,0,0,1,19175
68468feeeeb35ca9edd4899ea8b1abafb7c2742a,1,Jonathan Hurley,2015-03-18 16:26:14-04:00,['32e1215639f3cdfea68e2955f316576f1ded85fe'],2,2,4,19932806,1,0,,0,19175
6edfe30eca1091ad3de0d7b24e7bc187e11cfd29,0,Alex Antonenko,2015-03-19 00:07:04+02:00,['68468feeeeb35ca9edd4899ea8b1abafb7c2742a'],0,4,4,19932810,2,0,0,1,19175
d4607e5f14a5c803f20da4f6dbebb66a06471883,0,Alex Antonenko,2015-03-19 00:07:05+02:00,['6edfe30eca1091ad3de0d7b24e7bc187e11cfd29'],0,1,1,19932811,1,1,0,1,19175
442ad8322370ae133c0a5ba6994011024e0589b1,1,Srimanth Gunturi,2015-03-18 17:09:28-07:00,['d4607e5f14a5c803f20da4f6dbebb66a06471883'],172,221,393,19933204,2,,,,19176
8ced13165bf2b13dc6ba7e5223fac5b5f80906ff,1,Yusaku Sako,2015-03-18 18:48:56-07:00,['442ad8322370ae133c0a5ba6994011024e0589b1'],42,12,54,19933258,6,,,,19176
d461e3330e011eb5f59092a61f0284124967ed04,1,Aleksandr Kovalenko,2015-03-19 16:04:07+02:00,['8ced13165bf2b13dc6ba7e5223fac5b5f80906ff'],1,43,44,19933302,4,1,1,1,19176
9a7cfc80d34cbb643029d0e6fec5be627e324ae4,1,Andrii Tkach,2015-03-19 17:52:03+02:00,['d461e3330e011eb5f59092a61f0284124967ed04'],9,258,267,19933569,2,0.048192771,0.931726908,1,19176
75ecd3e448796d25ec36ba6d807b143db23093be,0,Srimanth Gunturi,2015-03-19 10:26:32-07:00,['9a7cfc80d34cbb643029d0e6fec5be627e324ae4'],8,8,16,19933585,1,,,,19176
ec5cc9d1ac838f50d2f858ca0f12f5eeb89d07aa,1,Alex Antonenko,2015-03-19 20:19:30+02:00,['75ecd3e448796d25ec36ba6d807b143db23093be'],129,429,558,19934143,28,0.785,0.87,0.72,19176
c217b8d8bd4088108b485af87891155e785d9a57,1,Alejandro Fernandez,2015-03-19 14:20:30-07:00,['ec5cc9d1ac838f50d2f858ca0f12f5eeb89d07aa'],1,572,573,19934716,6,0.117647059,0.867007673,0.757033248,19179
1ca948f347bad8d5f829ff5b71d803bd224da1d6,0,Alejandro Fernandez,2015-03-19 15:12:12-07:00,['c217b8d8bd4088108b485af87891155e785d9a57'],2,3,5,19934721,1,0,1,0,19179
faae1cbe088b852ed554176e746dcfdf83a38904,0,Jayush Luniya,2015-03-19 16:15:13-07:00,['1ca948f347bad8d5f829ff5b71d803bd224da1d6'],0,18,18,19934739,1,,,,19179
0fe14ef0c64d5a28780668dd070a82a5173e412f,1,Alex Antonenko,2015-03-20 01:40:59+02:00,['faae1cbe088b852ed554176e746dcfdf83a38904'],2,3,5,19934744,1,1,1,1,19179
594fab6ce3f452e0886568ff7e29462bf93e9b83,1,Alex Antonenko,2015-03-20 01:40:59+02:00,['0fe14ef0c64d5a28780668dd070a82a5173e412f'],1,3,4,19934748,1,1,1,1,19179
dc6540318d14f8d8ead089de5707374d4d744b35,0,Alex Antonenko,2015-03-20 01:40:59+02:00,['594fab6ce3f452e0886568ff7e29462bf93e9b83'],1,3,4,19934752,1,1,1,1,19179
e0935981a7da033537911eef9acc87278d78cc8c,1,Alex Antonenko,2015-03-20 01:40:59+02:00,['dc6540318d14f8d8ead089de5707374d4d744b35'],2,8,10,19934762,1,0.857142857,0.857142857,1,19179
a35d9295af61e447489a74eff0cf4747f4c4b28c,1,Alex Antonenko,2015-03-20 01:40:59+02:00,['e0935981a7da033537911eef9acc87278d78cc8c'],1,1,2,19934764,1,,,,19179
30bd08b510ef089280a9b26ff8adff4b49f0a04b,1,Alex Antonenko,2015-03-20 01:40:59+02:00,['a35d9295af61e447489a74eff0cf4747f4c4b28c'],5,26,31,19934795,5,1,1,0.933333333,19179
77f223215cac59305e0718727c33f003ea3b884d,1,Srimanth Gunturi,2015-03-19 16:42:39-07:00,['30bd08b510ef089280a9b26ff8adff4b49f0a04b'],11,704,715,19935510,15,0.621212121,0.65530303,0.950757576,19181
b3666a3ed4902f0a9981b60689ba11d6fb7b1acc,1,Lisnichenko Dmitro,2015-03-20 12:56:30+02:00,['77f223215cac59305e0718727c33f003ea3b884d'],49,17,66,19935576,4,1,0.733333333,0.2,19181
458363fe240860964e14b34f01e461cdb8711632,0,Lisnichenko Dmitro,2015-03-20 13:54:22+02:00,['b3666a3ed4902f0a9981b60689ba11d6fb7b1acc'],1,1,2,19935578,1,,,,19181
1a89565f170fb934227f99bf7d3a62d8979e447c,0,Lisnichenko Dmitro,2015-03-20 13:55:35+02:00,['458363fe240860964e14b34f01e461cdb8711632'],2,1,3,19935581,1,,,,19181
91926434a0bc15c593dfc53801327a1fb2f9d8da,1,Oleg Nechiporenko,2015-03-20 13:58:55+02:00,['1a89565f170fb934227f99bf7d3a62d8979e447c'],21,409,430,19936011,14,0.859649123,0.801169591,0.912280702,19186
ea8e32ff1e9501f7cf4254e603959f676fdbf932,1,Vitaly Brodetskyi,2015-03-20 16:51:50+02:00,['91926434a0bc15c593dfc53801327a1fb2f9d8da'],0,775,775,19936786,13,0.255033557,1,1,19197
b17747ec509d970fa0b873579c668fcd2ff0194c,1,aBabiichuk,2015-03-20 16:59:23+02:00,['ea8e32ff1e9501f7cf4254e603959f676fdbf932'],44,586,630,19937416,16,0.950549451,1,0.93956044,19200
499b0d97048670c1488c1e38242df2e4ba65d079,1,Oleg Nechiporenko,2015-03-20 18:55:15+02:00,['b17747ec509d970fa0b873579c668fcd2ff0194c'],6,671,677,19938093,9,0.627306273,0.915129151,1,19205
903ce253f7598ced2e91320046dd6c98fffaf630,1,Jonathan Hurley,2015-03-20 13:10:21-04:00,['499b0d97048670c1488c1e38242df2e4ba65d079'],1,1,2,19938095,1,,,,19205
ab570fff57108e3a3b288a276e2dcc6f864626a2,0,aBabiichuk,2015-03-20 20:06:32+02:00,['903ce253f7598ced2e91320046dd6c98fffaf630'],0,18,18,19938113,1,,,,19205
52e8e9b2ae5fe0f1c4883d718422a75bfb799e44,1,Alex Antonenko,2015-03-20 20:27:29+02:00,['ab570fff57108e3a3b288a276e2dcc6f864626a2'],5,6,11,19938124,4,,,,19205
2bb070b6d67764fec7e142f71a5ad35a15bf044d,0,Florian Barca,2015-03-20 13:07:43-07:00,['52e8e9b2ae5fe0f1c4883d718422a75bfb799e44'],6,9,15,19938139,2,,,,19205
20537072e19992c38266ed5cce647ae73f39a86d,1,Dmytro Sen,2015-03-20 22:08:55+02:00,['2bb070b6d67764fec7e142f71a5ad35a15bf044d'],0,2,2,19938141,2,1,1,0,19205
6655d9886503066e0ff61c66bba8d1dd9f71c64a,1,Alejandro Fernandez,2015-03-20 13:16:46-07:00,['20537072e19992c38266ed5cce647ae73f39a86d'],3,3,6,19938147,2,,,,19205
e514c9be38dba024fc098bd12d92d074ce4dedad,1,Srimanth Gunturi,2015-03-20 14:54:31-07:00,['6655d9886503066e0ff61c66bba8d1dd9f71c64a'],5,429,434,19938581,9,0.378378378,0.583783784,0.940540541,19208
b681b55a956f51faa7a23ecfeaa07a7e5d577787,1,Sumit Mohanty,2015-03-20 16:59:16-07:00,['e514c9be38dba024fc098bd12d92d074ce4dedad'],5,11,16,19938597,4,0.5,0,1,19208
8a24c720270e973ce4d7a17573699b6a9d4d8224,1,Andrew Onishuk,2015-03-23 13:29:27+02:00,['b681b55a956f51faa7a23ecfeaa07a7e5d577787'],0,138,138,19938735,7,0,0.888888889,1,19209
360d4c814ef64529a292c8b67c0e12c3d22178d9,0,Andrew Onishuk,2015-03-23 16:02:16+02:00,['8a24c720270e973ce4d7a17573699b6a9d4d8224'],6,1,7,19938742,1,,,,19209
a67afa9450306e4bc22e03d5a18ffcd8aae6abf6,0,Artem Baranchuk,2015-03-23 16:56:06+02:00,['360d4c814ef64529a292c8b67c0e12c3d22178d9'],6,66,72,19938814,3,,,,19210
f424e9c30024d6e403f8221d1fb98abececafc62,1,aBabiichuk,2015-03-23 17:14:39+02:00,['a67afa9450306e4bc22e03d5a18ffcd8aae6abf6'],126,572,698,19939512,14,0.650557621,0.802973978,0.866171004,19212
bcc6c36dc9c35e645383368431199438593918c1,1,Aleksandr Kovalenko,2015-03-23 17:29:15+02:00,['f424e9c30024d6e403f8221d1fb98abececafc62'],9,71,80,19939592,5,0.444444444,1,1,19213
bdd18f59f6800250ec2472f298f6cab44cde1c02,1,Vitaly Brodetskyi,2015-03-23 17:33:01+02:00,['bcc6c36dc9c35e645383368431199438593918c1'],0,8,8,19939600,1,,,,19213
db4729f4d1e4c77a42806c3ea126902a6a8b87ed,0,Andrii Tkach,2015-03-23 17:50:49+02:00,['bdd18f59f6800250ec2472f298f6cab44cde1c02'],158,13357,13515,19953115,30,1,1,1,19231
7ed1d2e3760461c3ad6e589bac92bae1bbe7837f,1,Andrew Onishuk,2015-03-23 17:59:27+02:00,['db4729f4d1e4c77a42806c3ea126902a6a8b87ed'],0,1,1,19953116,1,,,,19231
10e61fff798a050ef25bbcc68d71f54d35dac350,1,Andrew Onishuk,2015-03-23 18:00:03+02:00,['7ed1d2e3760461c3ad6e589bac92bae1bbe7837f'],7,46,53,19953169,5,0.916666667,0.916666667,1,19231
34ac699aa012cc3d4564248fb9e7b120391c099a,0,aBabiichuk,2015-03-23 18:06:44+02:00,['10e61fff798a050ef25bbcc68d71f54d35dac350'],2,2,4,19953173,1,,,,19231
c830c7e66c2d0cd5f1213e21ba56520af71e2677,1,Alex Antonenko,2015-03-23 19:05:04+02:00,['34ac699aa012cc3d4564248fb9e7b120391c099a'],30,143,173,19953346,6,0.195402299,1,1,19232
b770c992d0aea3aa16c5a71d744f9106bc16f660,1,Alex Antonenko,2015-03-23 19:05:04+02:00,['c830c7e66c2d0cd5f1213e21ba56520af71e2677'],1,3,4,19953350,1,1,1,1,19232
78eb548498b79b13473c0c8973b8d35b0e2e7268,1,Andrew Onishuk,2015-03-23 19:23:02+02:00,['b770c992d0aea3aa16c5a71d744f9106bc16f660'],22,19,41,19953391,18,,,,19232
f54d75b8b2b0e5a747c49c34849e82cabc1c57fc,0,Artem Baranchuk,2015-03-23 19:35:46+02:00,['78eb548498b79b13473c0c8973b8d35b0e2e7268'],25,43,68,19953459,1,,,,19232
34a89e8b16603707ba32b8d1829dae9fb020c0f4,1,Srimanth Gunturi,2015-03-23 12:01:18-07:00,['f54d75b8b2b0e5a747c49c34849e82cabc1c57fc'],279,782,1061,19954520,21,0.686046512,0.73255814,0.965116279,19235
6fae188975e62d3344fa7d043425566b33da34a9,1,Andrew Onishuk,2015-03-23 21:25:43+02:00,['34a89e8b16603707ba32b8d1829dae9fb020c0f4'],2,101,103,19954623,7,0,0.96969697,1,19235
b56adfff348ad05b10b5b5b524af8ee5ea770e77,1,Nate Cole,2015-03-23 16:53:23-04:00,['6fae188975e62d3344fa7d043425566b33da34a9'],0,109,109,19954732,2,0,0.868421053,1,19235
3b103960b7560cbbb868a4bdcfaf73aba381eb79,1,Alejandro Fernandez,2015-03-23 18:39:37-07:00,['b56adfff348ad05b10b5b5b524af8ee5ea770e77'],34,19,53,19954785,5,0.083333333,0.083333333,0,19235
e79fc7b86113ff52ac9ff5a64d296d738531d700,1,Srimanth Gunturi,2015-03-23 18:55:44-07:00,['3b103960b7560cbbb868a4bdcfaf73aba381eb79'],24,49,73,19954858,2,,,,19235
ed231beaddaf6347d4defb2fb26d75849c0cafc9,1,Robert Levas,2015-03-24 06:31:15-04:00,['e79fc7b86113ff52ac9ff5a64d296d738531d700'],72,254,326,19955184,11,0.573529412,0.970588235,0.955882353,19236
fd5e6e6823cec08ef3334286924e964638c9fa16,1,Oleg Nechiporenko,2015-03-24 14:59:18+02:00,['ed231beaddaf6347d4defb2fb26d75849c0cafc9'],52,187,239,19955423,8,1,1,1,19236
3b8e577dba282d97f3e8dd511d520aac29cf1629,1,aBabiichuk,2015-03-24 15:52:15+02:00,['fd5e6e6823cec08ef3334286924e964638c9fa16'],160,226,386,19955809,10,0.980769231,0.980769231,1,19236
86f5870e6775474adfca5880f4368890c978829b,1,Andrew Onishuk,2015-03-24 16:16:16+02:00,['3b8e577dba282d97f3e8dd511d520aac29cf1629'],19,76,95,19955904,16,0.84,0.96,1,19236
2cb80ce3f5b80fb0d0c90b2159a631a75ef3a266,1,Vitaly Brodetskyi,2015-03-24 16:52:25+02:00,['86f5870e6775474adfca5880f4368890c978829b'],4,57,61,19955965,2,0.392857143,1,1,19236
241f83115983038ae26784b3ec36e75d50b81ece,1,Vitaly Brodetskyi,2015-03-24 18:05:12+02:00,['2cb80ce3f5b80fb0d0c90b2159a631a75ef3a266'],26,39,65,19956030,2,0,1,0,19236
2518f87fdc9e90494ed81b7f09ea68a82d3ad825,1,Alex Antonenko,2015-03-24 18:22:46+02:00,['241f83115983038ae26784b3ec36e75d50b81ece'],4,14,18,19956048,2,0,1,1,19236
68f9bcd08d22113f851604cbe5a049c2ecbadd0f,1,Alex Antonenko,2015-03-24 18:22:46+02:00,['2518f87fdc9e90494ed81b7f09ea68a82d3ad825'],11,245,256,19956304,4,0.136792453,1,1,19237
70bb8db8445e7ea034bea437dc53f06aa7b87655,1,Alejandro Fernandez,2015-03-24 10:19:55-07:00,['68f9bcd08d22113f851604cbe5a049c2ecbadd0f'],2,118,120,19956424,10,0.785714286,0.785714286,1,19237
8f2232c047d98b2edd5049c07c5d598471a38de7,1,Sumit Mohanty,2015-03-24 12:42:50-07:00,['70bb8db8445e7ea034bea437dc53f06aa7b87655'],73,422,495,19956919,7,0,0.147368421,1,19239
c42db2ebe37b4658c8b5a52024520c9ea7875d93,0,Alex Antonenko,2015-03-25 00:25:46+02:00,['8f2232c047d98b2edd5049c07c5d598471a38de7'],11,134,145,19957064,3,1,0.831460674,1,19239
86a8bbb3416eb6dfa820d2c56457d337e5b895eb,1,Srimanth Gunturi,2015-03-24 16:11:00-07:00,['c42db2ebe37b4658c8b5a52024520c9ea7875d93'],24,29,53,19957117,2,1,1,1,19239
d95dfe3b4e246c01ac9efe0385ef294d72d89316,0,Alejandro Fernandez,2015-03-24 16:34:32-07:00,['86a8bbb3416eb6dfa820d2c56457d337e5b895eb'],22,22,44,19957161,1,,,,19239
d83c14c401d90e6355283a23d17b41b5d778fd28,1,Siddharth Wagle,2015-03-24 19:20:55-07:00,['d95dfe3b4e246c01ac9efe0385ef294d72d89316'],121650,124182,245832,20202993,34,0.263513514,0.601351351,0.959459459,19240
f73936a281896b82e89a64399f712d0e17142637,1,Alejandro Fernandez,2015-03-25 00:26:07-07:00,['d83c14c401d90e6355283a23d17b41b5d778fd28'],188,848,1036,20204029,17,0.313901345,0.484304933,1,19242
f5594591ebcd4f872002c004c787a75616ec19d4,0,Aleksandr Kovalenko,2015-03-25 14:10:26+02:00,['f73936a281896b82e89a64399f712d0e17142637'],6,16,22,20204051,4,0.333333333,1,1,19242
8d3da8ef2458cc49d9093bda605f2099e5683573,1,Robert Levas,2015-03-25 09:14:02-04:00,['f5594591ebcd4f872002c004c787a75616ec19d4'],41,130,171,20204222,8,0.172413793,0.172413793,0.310344828,19242
90a88c6aab93717c9c498e5a10e46327ed1c6d2c,1,Andrew Onishuk,2015-03-25 17:45:42+02:00,['8d3da8ef2458cc49d9093bda605f2099e5683573'],1,2,3,20204225,2,,,,19242
008cc6bad32f054de1686af0921ca0a2d024fa5a,1,Andrew Onishuk,2015-03-25 17:46:08+02:00,['90a88c6aab93717c9c498e5a10e46327ed1c6d2c'],100,103,203,20204428,13,1,1,0,19243
087c555f8c9f5e40e8db773c6e795668430b1cce,1,Oleg Nechiporenko,2015-03-25 18:07:11+02:00,['008cc6bad32f054de1686af0921ca0a2d024fa5a'],11,20,31,20204459,4,0.833333333,1,1,19243
7f191208e7a1117026d30efbc570fa23eaff091e,0,Alex Antonenko,2015-03-25 18:27:25+02:00,['087c555f8c9f5e40e8db773c6e795668430b1cce'],3,3,6,20204465,1,1,1,1,19243
65b5b9c287483deb478f6fc2109703b624952dd5,1,Florian Barca,2015-03-25 10:22:58-07:00,['7f191208e7a1117026d30efbc570fa23eaff091e'],22,512,534,20204999,8,0.498113208,0.713207547,0.61509434,19243
ce6d7454fb3df31470091b751b4fea1d46354377,1,Jonathan Hurley,2015-03-25 13:24:03-04:00,['65b5b9c287483deb478f6fc2109703b624952dd5'],66,38,104,20205103,4,0,0,1,19243
271660a6d0520e836d6613a5972b659cbdebd13e,1,Vitaly Brodetskyi,2015-03-25 19:51:44+02:00,['ce6d7454fb3df31470091b751b4fea1d46354377'],81,291,372,20205475,15,0.025974026,1,0.974025974,19246
907166990a87469f89fc9d3e0508dc2ad4b0ff9d,1,Alex Antonenko,2015-03-25 20:38:35+02:00,['271660a6d0520e836d6613a5972b659cbdebd13e'],3,212,215,20205690,2,0.175609756,1,1,19246
d44a478cd2de22b4e93fb8f768831523fa3887b1,0,Alejandro Fernandez,2015-03-25 12:03:20-07:00,['907166990a87469f89fc9d3e0508dc2ad4b0ff9d'],63,71,134,20205824,8,0,1,0,19246
ae9c18141f5d612942bd210e5d64e352e2f23846,1,Alejandro Fernandez,2015-03-25 12:03:20-07:00,['d44a478cd2de22b4e93fb8f768831523fa3887b1'],17,14,31,20205855,5,,,,19246
295f4f5bc50cc56df6e5263b9cdf22a73946bb55,0,Sumit Mohanty,2015-03-25 12:15:42-07:00,['ae9c18141f5d612942bd210e5d64e352e2f23846'],1,3,4,20205859,1,1,1,0,19246
7f8992ec8c0e2bd8a41b37d16e9483184caf2c4d,1,Alejandro Fernandez,2015-03-25 14:11:00-07:00,['295f4f5bc50cc56df6e5263b9cdf22a73946bb55'],71,63,134,20205993,8,1,0,1,19246
6e67329b81d429e26ac55f62c46818aa329aaa91,1,Sumit Mohanty,2015-03-25 17:05:44-07:00,['7f8992ec8c0e2bd8a41b37d16e9483184caf2c4d'],6,63,69,20206062,6,0.222222222,0.6,1,19246
308a618f40f3c724dbbd33c178ebbab2c38b2ea4,1,Siddharth Wagle,2015-03-25 17:22:58-07:00,['6e67329b81d429e26ac55f62c46818aa329aaa91'],1,1196,1197,20207259,15,0.768878719,0.963386728,1,19254
f3359f526edd55f1d6319fe147d156e7ff5cf56b,1,Sumit Mohanty,2015-03-25 17:37:37-07:00,['308a618f40f3c724dbbd33c178ebbab2c38b2ea4'],2,5,7,20207266,1,,,,19254
4f5f3d1dd4082d76f3aff0290c072ad88be0fb14,1,Dmytro Sen,2015-03-26 10:11:37+02:00,['f3359f526edd55f1d6319fe147d156e7ff5cf56b'],117,8,125,20207391,4,,,,19254
65fe89c9631ecdf03bf66132f4ffa8dab2217fa7,1,Andrii Tkach,2015-03-26 13:22:59+02:00,['4f5f3d1dd4082d76f3aff0290c072ad88be0fb14'],239,2350,2589,20209980,17,0.751552795,0.956521739,0.968944099,19256
5d035d51e748975ee6c56567ae2d0b2a5c034d48,1,Oleg Nechiporenko,2015-03-26 13:27:22+02:00,['65fe89c9631ecdf03bf66132f4ffa8dab2217fa7'],51,395,446,20210426,16,0.375,1,0.95,19260
aaf4233c15a5e0d6ec6fc06cfc8cba06a375a7fc,1,Oleg Nechiporenko,2015-03-26 13:36:56+02:00,['5d035d51e748975ee6c56567ae2d0b2a5c034d48'],7,598,605,20211031,15,0.921348315,0.985018727,1,19268
6638f3fb464a0ef3695b2dd6cdfd32c3ba3e537d,1,Oleg Nechiporenko,2015-03-26 14:16:18+02:00,['aaf4233c15a5e0d6ec6fc06cfc8cba06a375a7fc'],68,74,142,20211173,1,,,,19268
2c2645767bf1ffe48b1b72b3e7953c8f43a54ed8,0,Vitaly Brodetskyi,2015-03-26 15:28:35+02:00,['6638f3fb464a0ef3695b2dd6cdfd32c3ba3e537d'],5,9,14,20211187,1,0,0,0,19268
2ae23688c6f9d54d2355f173eae89694c77ec697,1,Jonathan Hurley,2015-03-26 09:29:55-04:00,['2c2645767bf1ffe48b1b72b3e7953c8f43a54ed8'],1,39,40,20211227,2,0,1,1,19268
8cdd1f5504c265ec93b8d67d196446b284f74e5f,1,Oleg Nechiporenko,2015-03-26 17:35:12+02:00,['2ae23688c6f9d54d2355f173eae89694c77ec697'],363,420,783,20212010,7,0,,,19268
19b57e565d793274b14894e34c9ba818b30e61db,0,Vitaly Brodetskyi,2015-03-26 17:37:04+02:00,['8cdd1f5504c265ec93b8d67d196446b284f74e5f'],0,16,16,20212026,2,0,0,1,19268
5746ee6d99c4a71b1c1c87e5aabeb966dfe47e87,1,tbeerbower,2015-03-26 11:39:55-04:00,['19b57e565d793274b14894e34c9ba818b30e61db'],88,594,682,20212708,25,0.293103448,0.814655172,0.827586207,19272
8c5756519e0fdbb8c9666906017d6efbada2c003,1,Florian Barca,2015-03-26 09:26:40-07:00,['5746ee6d99c4a71b1c1c87e5aabeb966dfe47e87'],1,5,6,20212714,2,,,,19272
465c20ec21928e803394456e7d472c87982f2f9d,0,Jayush Luniya,2015-03-26 10:04:40-07:00,['8c5756519e0fdbb8c9666906017d6efbada2c003'],3,8,11,20212725,2,0.571428571,0.571428571,1,19272
cc69a00c33586b47355d23b2491d2a5a8e5b1d92,1,Sumit Mohanty,2015-03-26 10:05:09-07:00,['465c20ec21928e803394456e7d472c87982f2f9d'],4,21,25,20212750,1,1,1,1,19272
08833fe285fc60cf3f87becb6913bc61130ba16c,1,Alex Antonenko,2015-03-26 21:22:46+02:00,['cc69a00c33586b47355d23b2491d2a5a8e5b1d92'],23,187,210,20212960,8,1,1,1,19272
6bceddf1731fa9a32981bad3c599c1f20b14137d,1,Alex Antonenko,2015-03-26 21:22:46+02:00,['08833fe285fc60cf3f87becb6913bc61130ba16c'],15,50,65,20213025,6,1,1,0.529411765,19272
fb763311e25fe8a5f7ac42ac82b934e5d381dea7,1,Srimanth Gunturi,2015-03-26 18:17:22-07:00,['6bceddf1731fa9a32981bad3c599c1f20b14137d'],102,394,496,20213521,15,0.734848485,0.871212121,0.704545455,19273
9f87c98dcf352f2bae671556e74e06798ee0a5a6,1,aBabiichuk,2015-03-27 12:31:25+02:00,['fb763311e25fe8a5f7ac42ac82b934e5d381dea7'],432,764,1196,20214717,11,0.684684685,0.846846847,0.630630631,19275
3937b6f7ade965e08925259d8c76bc50f856ae17,1,aBabiichuk,2015-03-27 13:56:30+02:00,['9f87c98dcf352f2bae671556e74e06798ee0a5a6'],31,292,323,20215040,19,1,1,1,19283
589faa74a9eb7a521ce2e601895d11bc4ad93743,1,Oleg Nechiporenko,2015-03-27 14:30:50+02:00,['3937b6f7ade965e08925259d8c76bc50f856ae17'],6,44,50,20215090,6,0.888888889,1,1,19283
9b2291bfa33017cf3ce64214b4da2a9eb7fa7259,1,Oleg Nechiporenko,2015-03-27 16:24:30+02:00,['589faa74a9eb7a521ce2e601895d11bc4ad93743'],31,131,162,20215252,8,0.984375,1,1,19284
4c348dfb086be12923b2084766186e2ef5797022,1,Andrew Onishuk,2015-03-27 16:39:11+02:00,['9b2291bfa33017cf3ce64214b4da2a9eb7fa7259'],22,902,924,20216176,2,0.205167173,1,0.506079027,19284
080b1826013f5b0e27b5570e97874fcab507a4fc,0,Andrew Onishuk,2015-03-27 16:40:04+02:00,['4c348dfb086be12923b2084766186e2ef5797022'],69,7,76,20216252,8,,,,19284
e2a68b660b1be301ad8b31773efdd44ebb85eb6f,1,Andrew Onishuk,2015-03-27 16:40:35+02:00,['080b1826013f5b0e27b5570e97874fcab507a4fc'],53,53,106,20216358,45,,,,19284
43e44d97b57ae8391c0fc9b0b44b959afadcd2bc,0,Vitaly Brodetskyi,2015-03-27 16:50:26+02:00,['e2a68b660b1be301ad8b31773efdd44ebb85eb6f'],0,9,9,20216367,1,,,,19284
bc09eaa251faee01d8d92c66937b9540bf5ddc1f,0,Dmytro Sen,2015-03-27 17:03:43+02:00,['43e44d97b57ae8391c0fc9b0b44b959afadcd2bc'],0,5,5,20216372,1,,,,19284
8073405a4f0d29fdbdb91fe8080a5d30de6d10ba,1,Andrew Onishuk,2015-03-27 17:17:18+02:00,['bc09eaa251faee01d8d92c66937b9540bf5ddc1f'],2,2,4,20216376,1,,,,19284
e4686db52f7bc624634f67524c961cfee89296bc,1,Jayush Luniya,2015-03-27 08:49:55-07:00,['8073405a4f0d29fdbdb91fe8080a5d30de6d10ba'],457,273,730,20217106,19,0,0,0,19285
194df087131fe9a254e6c0e2c47499305bc72075,1,Jayush Luniya,2015-03-27 08:54:00-07:00,['e4686db52f7bc624634f67524c961cfee89296bc'],143,125,268,20217374,8,0,0,0,19286
626ef03daf847ad4e480ce5eb27fca7f6f9fcb81,1,Jayush Luniya,2015-03-27 08:58:57-07:00,['194df087131fe9a254e6c0e2c47499305bc72075'],190,137,327,20217701,9,0,0,0,19287
391cc7a6f6bad90888603c31c46c282a3e91a306,1,Jayush Luniya,2015-03-27 09:03:00-07:00,['626ef03daf847ad4e480ce5eb27fca7f6f9fcb81'],348,216,564,20218265,15,0,0,0,19288
bfb586d8562c7ffe54e9f313f0eac22389e075f5,1,Andrii Tkach,2015-03-27 18:11:33+02:00,['391cc7a6f6bad90888603c31c46c282a3e91a306'],267,594,861,20219126,13,0.494699647,1,1,19293
250c24399d3490a7bfcdc1ddbc9ac561e27c612a,1,aBabiichuk,2015-03-27 18:55:26+02:00,['bfb586d8562c7ffe54e9f313f0eac22389e075f5'],28,39,67,20219193,2,0,1,0.636363636,19293
fd9649dd0083380b659894a79e486acfe0f4e0a3,0,Myroslav Papirkovskyy,2015-03-27 19:03:15+02:00,['250c24399d3490a7bfcdc1ddbc9ac561e27c612a'],1,7,8,20219201,2,0.2,0,1,19293
36ac57824554600b63fe8e979bcf888047bdd14a,1,Andrew Onishuk,2015-03-27 19:27:02+02:00,['fd9649dd0083380b659894a79e486acfe0f4e0a3'],286,426,712,20219913,58,0.734375,1,0,19295
aae47bd59249a4d98b6ea6692e602ea29d66e916,1,Mahadev Konar,2015-03-27 10:41:10-07:00,['36ac57824554600b63fe8e979bcf888047bdd14a'],0,12,12,20219925,1,,,,19295
e2ea86f4fa384a454ac9fcab4336ad29ef3556d9,1,Oleg Nechiporenko,2015-03-27 19:42:01+02:00,['aae47bd59249a4d98b6ea6692e602ea29d66e916'],5,10,15,20219940,2,,,,19295
6ef5786debe431d248721ea8cae7bdb4b3bcd433,0,Alex Antonenko,2015-03-27 21:51:59+02:00,['e2ea86f4fa384a454ac9fcab4336ad29ef3556d9'],0,1,1,20219941,1,1,1,1,19295
59c248521169e9752596eb78e76f52a411567b7a,1,Alex Antonenko,2015-03-27 21:51:59+02:00,['6ef5786debe431d248721ea8cae7bdb4b3bcd433'],10,13,23,20219964,3,0,0,0,19295
77ccdf256fabb64a50380987cfe8ed0866322e36,0,Alex Antonenko,2015-03-27 21:51:59+02:00,['59c248521169e9752596eb78e76f52a411567b7a'],1,9,10,20219974,1,1,1,0.833333333,19295
5f7de77033f0ade33207312f3af12daeadeff9b2,0,Alex Antonenko,2015-03-27 21:51:59+02:00,['77ccdf256fabb64a50380987cfe8ed0866322e36'],0,3,3,20219977,1,1,1,1,19295
e0a8107346dee966219b71361add0b88bb3404bc,1,Alex Antonenko,2015-03-27 21:51:59+02:00,['5f7de77033f0ade33207312f3af12daeadeff9b2'],168,267,435,20220412,12,0.80952381,1,1,19297
4872d4e80aff3e80bc61f82d25c3af1672a6bd32,1,Jonathan Hurley,2015-03-27 16:37:38-04:00,['e0a8107346dee966219b71361add0b88bb3404bc'],31,65,96,20220508,5,0,0,1,19297
62d6c1cb2b11f5e93e9ec1af9df64084afac1dd3,0,Alex Antonenko,2015-03-27 22:52:42+02:00,['4872d4e80aff3e80bc61f82d25c3af1672a6bd32'],1,1,2,20220510,1,,,,19297
592609bb077e157f094da7c968ca629dc5095ae5,1,Jaimin Jetly,2015-03-27 16:20:08-07:00,['62d6c1cb2b11f5e93e9ec1af9df64084afac1dd3'],0,26,26,20220536,1,,,,19297
a982836df6fad9a8d648c6bcc5b1852b2be4d7de,1,Siddharth Wagle,2015-03-27 16:49:49-07:00,['592609bb077e157f094da7c968ca629dc5095ae5'],7,834,841,20221377,14,0.494505495,0.873626374,0.868131868,19301
5d06a31309bb6ced2aef16116860e4aba9c0b571,1,Siddharth Wagle,2015-03-27 17:11:08-07:00,['a982836df6fad9a8d648c6bcc5b1852b2be4d7de'],1,44,45,20221422,4,0.92,0.52,1,19301
9a9492d7ae14851df919303c9d4fa859cb018b9d,0,Jonathan Hurley,2015-03-27 22:41:03-04:00,['5d06a31309bb6ced2aef16116860e4aba9c0b571'],2,27,29,20221451,1,0,1,1,19301
bfd0babd4f08c002aec747afd154727c83076900,0,Andrew Onishuk,2015-03-28 16:27:53+02:00,['9a9492d7ae14851df919303c9d4fa859cb018b9d'],2,0,2,20221453,1,,,,19301
de6ff03f0bd09e2f6066f062eae87490e572559e,0,Andrew Onishuk,2015-03-28 16:28:28+02:00,['bfd0babd4f08c002aec747afd154727c83076900'],25,25,50,20221503,1,,,,19301
120af108ac2c77edaba19abe71972c37283393b9,0,Yusaku Sako,2015-03-28 14:20:31-07:00,['de6ff03f0bd09e2f6066f062eae87490e572559e'],70,70,140,20221643,2,,,,19301
de9425dbc18049cdfc09cbe8ab5e9a5a46a83aa4,1,Yusaku Sako,2015-03-28 14:37:51-07:00,['120af108ac2c77edaba19abe71972c37283393b9'],1,1,2,20221645,1,,,,19301
5cd8c291a24c369ad035e3d6094377b7ba5fabee,1,Billie Rinaldi,2015-03-28 16:14:17-07:00,['de9425dbc18049cdfc09cbe8ab5e9a5a46a83aa4'],63,13,76,20221721,2,,,,19301
d2e2a79141afe440f713533f99ab98722c3084dd,1,Andrii Tkach,2015-03-30 13:52:35+03:00,['5cd8c291a24c369ad035e3d6094377b7ba5fabee'],82,328,410,20222131,12,1,1,0.934579439,19303
d794a8470e671d4188317c5a525cdabc92fa5407,1,Oleg Nechiporenko,2015-03-30 14:35:55+03:00,['d2e2a79141afe440f713533f99ab98722c3084dd'],56,117,173,20222304,6,1,0,1,19304
1cfd63b538aefe41b6e347fd7ac943d5a95cc506,0,Oleg Nechiporenko,2015-03-30 16:06:29+03:00,['d794a8470e671d4188317c5a525cdabc92fa5407'],1,1,2,20222306,1,,,,19304
f15fce5bb379cd0fa3540964fbb0c0e94fa47900,1,Vitaly Brodetskyi,2015-03-30 16:21:06+03:00,['1cfd63b538aefe41b6e347fd7ac943d5a95cc506'],1,14,15,20222321,1,0.6,0.6,1,19304
8769adc3536a11e73e49addaa3458958444b1336,1,aBabiichuk,2015-03-30 17:48:42+03:00,['f15fce5bb379cd0fa3540964fbb0c0e94fa47900'],30,196,226,20222547,9,0.571428571,0.571428571,1,19304
8c237ec8660ea728b7ec5632fd9ea555d2373d1a,0,Vitaly Brodetskyi,2015-03-30 18:10:38+03:00,['8769adc3536a11e73e49addaa3458958444b1336'],68,180,248,20222795,5,0.094594595,0.797297297,1,19304
d75309a7b98f8f68c227514f2109003a9efa7f40,1,Alex Antonenko,2015-03-30 19:54:19+03:00,['8c237ec8660ea728b7ec5632fd9ea555d2373d1a'],17,18,35,20222830,3,,,,19304
6fd09d24bf16d8ae76c9acc46df0ee95ffe131a1,1,Alex Antonenko,2015-03-30 19:58:11+03:00,['d75309a7b98f8f68c227514f2109003a9efa7f40'],1,2,3,20222833,1,0,0,1,19304
03f96b2513754e8846d3a093f448bc0054e0d896,1,Alex Antonenko,2015-03-30 20:00:47+03:00,['6fd09d24bf16d8ae76c9acc46df0ee95ffe131a1'],1,44,45,20222878,2,1,1,1,19304
c77993e13eff49aca09be4503872dc19498f947c,1,Lisnichenko Dmitro,2015-03-30 20:52:56+03:00,['03f96b2513754e8846d3a093f448bc0054e0d896'],42,156,198,20223076,59,0.684210526,0.947368421,0.947368421,19304
804577346e85297a61fca6119df51d5ec1f10335,1,Aleksandr Kovalenko,2015-03-30 21:29:29+03:00,['c77993e13eff49aca09be4503872dc19498f947c'],3,673,676,20223752,28,0.842105263,1,1,19320
2b43a272c2fed8e36565f2e6727cd1fd0760cab1,1,Alex Antonenko,2015-03-30 22:11:55+03:00,['804577346e85297a61fca6119df51d5ec1f10335'],1,92,93,20223845,4,1,1,1,19322
4e5e8dc719b88730d9a42157423b7fccf029e9b2,0,Siddharth Wagle,2015-03-30 12:39:44-07:00,['2b43a272c2fed8e36565f2e6727cd1fd0760cab1'],0,2,2,20223847,1,,,,19322
e426e715137e8d0dd60a47317990498bac2e8150,0,Florian Barca,2015-03-30 13:47:47-07:00,['4e5e8dc719b88730d9a42157423b7fccf029e9b2'],2,2,4,20223851,1,,,0,19322
c86d38823fd44c8d4e98088e94e98f786f3b7922,0,Florian Barca,2015-03-30 14:19:15-07:00,['e426e715137e8d0dd60a47317990498bac2e8150'],6,4,10,20223861,1,,,,19322
27d3514595a9858d68f3d8dc491c5fed78469024,0,Florian Barca,2015-03-30 14:23:31-07:00,['c86d38823fd44c8d4e98088e94e98f786f3b7922'],1,1,2,20223863,1,,,,19322
6af1c2cb0658ba27433e60a3d6787085a6b9e44c,1,Srimanth Gunturi,2015-03-30 15:13:22-07:00,['27d3514595a9858d68f3d8dc491c5fed78469024'],10,586,596,20224459,11,,,,19322
9a1b0eb4ec0b54381aa5987574bd98cae1c4ee76,1,Florian Barca,2015-03-30 16:02:34-07:00,['6af1c2cb0658ba27433e60a3d6787085a6b9e44c'],119,336,455,20224914,13,,,,19328
c37394ad06526c8eaec826af95282b99aa4ccb9e,1,Florian Barca,2015-03-30 16:31:14-07:00,['9a1b0eb4ec0b54381aa5987574bd98cae1c4ee76'],336,119,455,20225369,13,,,,19328
4541b382a634452224626473748f24da209962a2,1,Oleg Nechiporenko,2015-03-31 15:01:16+03:00,['c37394ad06526c8eaec826af95282b99aa4ccb9e'],385,769,1154,20226523,11,0,1,1,19331
cf094a7e5f5dfc88c5496aa504ca895a01cb58b3,1,Jonathan Hurley,2015-03-31 08:18:02-04:00,['4541b382a634452224626473748f24da209962a2'],8,154,162,20226685,6,0.277108434,0.277108434,1,19331
4acfcf20ddfd678543f1ed6de01cf90f087be1a4,1,Nate Cole,2015-03-31 08:36:25-04:00,['cf094a7e5f5dfc88c5496aa504ca895a01cb58b3'],20,86,106,20226791,3,0,0,1,19331
3508f08f9509ed17e6e650244b2d5934fb1bc2e8,1,Andrew Onishuk,2015-03-31 16:06:50+03:00,['4acfcf20ddfd678543f1ed6de01cf90f087be1a4'],4,25,29,20226820,2,0.636363636,0.909090909,0,19331
fe39b6460b1f0ad50ece5a5cdc8bfede688956fa,1,Robert Levas,2015-03-31 10:40:36-04:00,['3508f08f9509ed17e6e650244b2d5934fb1bc2e8'],514,769,1283,20228103,26,1,1,0,19337
1212fb42a18fa914151d40fa7b8da782b879c011,0,Oleg Nechiporenko,2015-03-31 19:57:36+03:00,['fe39b6460b1f0ad50ece5a5cdc8bfede688956fa'],202,263,465,20228568,6,1,1,0,19337
9301f9b16277c0b31b93b09d6836a68ab44e9a03,0,aBabiichuk,2015-03-31 20:37:36+03:00,['1212fb42a18fa914151d40fa7b8da782b879c011'],2,11,13,20228581,4,0,1,1,19337
12598cff5876fe4a2323828722a5869ed5373f97,1,Andrii Tkach,2015-03-31 21:19:00+03:00,['9301f9b16277c0b31b93b09d6836a68ab44e9a03'],55,304,359,20228940,21,0.981132075,0.981132075,1,19338
af5a151ab63e3f47d01208fbb6dd77ab4339ee25,0,Nate Cole,2015-03-31 14:37:35-04:00,['12598cff5876fe4a2323828722a5869ed5373f97'],177,67,244,20229184,5,0.905405405,0.202702703,0,19338
3cedb0200c1d39460b17ac5c505f3cd05d28ce95,1,Alex Antonenko,2015-03-31 21:46:14+03:00,['af5a151ab63e3f47d01208fbb6dd77ab4339ee25'],0,2,2,20229186,1,1,1,1,19338
1beb7d1afc687935e5f4b4f0a3acab4938cb959f,1,Alex Antonenko,2015-03-31 21:46:14+03:00,['3cedb0200c1d39460b17ac5c505f3cd05d28ce95'],9,38,47,20229233,6,0,1,0.88,19338
e1e4790575b7d292e1e267af2a65dce81a800ed1,1,Alex Antonenko,2015-03-31 21:46:14+03:00,['1beb7d1afc687935e5f4b4f0a3acab4938cb959f'],62,205,267,20229500,5,0.285714286,1,1,19338
fcec84546ef6f2e37d16001855e1892758e3c624,0,Lisnichenko Dmitro,2015-03-31 23:21:39+03:00,['e1e4790575b7d292e1e267af2a65dce81a800ed1'],0,1,1,20229501,1,,,,19338
de97e38cd747ab25793531a3d8a508f08d027867,1,Sumit Mohanty,2015-03-31 13:43:29-07:00,['fcec84546ef6f2e37d16001855e1892758e3c624'],12,954,966,20230467,10,0,0.956521739,1,19339
f72e0bdb1df87242a144fbd43cef462c17f73de1,1,Florian Barca,2015-03-31 14:08:35-07:00,['de97e38cd747ab25793531a3d8a508f08d027867'],121,338,459,20230926,13,,,,19345
b8e6923d97fc89f4161172a6e9066deed0f2429d,0,Jayush Luniya,2015-03-31 14:13:02-07:00,['f72e0bdb1df87242a144fbd43cef462c17f73de1'],165,123,288,20231214,9,0,0,0,19346
7be96532bbda54f15f2f759cecb375841302197a,1,Jayush Luniya,2015-03-31 14:15:34-07:00,['b8e6923d97fc89f4161172a6e9066deed0f2429d'],422,365,787,20232001,16,0.166666667,0,0,19347
b95fe4423f9620b3b7692779b67c0fad3cb628b2,0,Jayush Luniya,2015-03-31 15:06:40-07:00,['7be96532bbda54f15f2f759cecb375841302197a'],16,56,72,20232073,2,,,,19347
d7fcd258d9788923a03d0d121320e0d39636a2cd,1,Srimanth Gunturi,2015-03-31 16:31:44-07:00,['b95fe4423f9620b3b7692779b67c0fad3cb628b2'],100,734,834,20232907,31,0.211934156,0.639917695,0.820987654,19348
9b4c5a2e6de047d36535e1b0ad96bd585f742e08,1,Srimanth Gunturi,2015-03-31 16:45:44-07:00,['d7fcd258d9788923a03d0d121320e0d39636a2cd'],9,111,120,20233027,6,0.516483516,0.747252747,1,19348
8985bcf11296d540a861a8634c17d6b9b1accd5a,1,Jaimin Jetly,2015-03-31 17:52:28-07:00,['9b4c5a2e6de047d36535e1b0ad96bd585f742e08'],88,938,1026,20234053,23,0.898113208,0.996226415,1,19361
43b4a9a538eb6b49c802dd50ab3d2980dc780524,1,Vitaly Brodetskyi,2015-04-01 07:02:32+03:00,['8985bcf11296d540a861a8634c17d6b9b1accd5a'],2,2,4,20234057,1,,,,19361
694ff41affce3ce226c835aaa17c145e4632fc42,1,Andrii Tkach,2015-04-01 14:29:18+03:00,['43b4a9a538eb6b49c802dd50ab3d2980dc780524'],12,130,142,20234199,10,0.961538462,0.961538462,1,19363
b54cfb8d09568c6de607641ea8fffb94043e8128,1,Oleg Nechiporenko,2015-04-01 16:11:17+03:00,['694ff41affce3ce226c835aaa17c145e4632fc42'],40,129,169,20234368,18,1,1,1,19364
7450f4e17c5d29bd401a9fbd938380b8033e9e99,1,Alex Antonenko,2015-04-01 16:23:32+03:00,['b54cfb8d09568c6de607641ea8fffb94043e8128'],19,65,84,20234452,2,,,,19364
72cf909a822b498d9e6d1f769d345c2d2a7f7bcb,1,Alex Antonenko,2015-04-01 16:23:32+03:00,['7450f4e17c5d29bd401a9fbd938380b8033e9e99'],29,9,38,20234490,3,0,0,0,19364
eb2cff8625ae6c011113a2c7fd3e91e4992192c6,1,Alex Antonenko,2015-04-01 16:23:32+03:00,['72cf909a822b498d9e6d1f769d345c2d2a7f7bcb'],25,272,297,20234787,4,0.145833333,1,1,19364
ce5cc87c514a5149e7066560cd38072f960a515d,1,Andrew Onishuk,2015-04-01 17:28:21+03:00,['eb2cff8625ae6c011113a2c7fd3e91e4992192c6'],3,10,13,20234800,6,1,1,1,19364
91155dd15cdab133e21cf7617891551e7ac9fb71,1,Andrew Onishuk,2015-04-01 18:17:23+03:00,['ce5cc87c514a5149e7066560cd38072f960a515d'],8,11,19,20234819,4,,,,19364
16e96dda71bce3ed900c9dfb7adea6821b2a1458,1,Oleg Nechiporenko,2015-04-01 18:34:40+03:00,['91155dd15cdab133e21cf7617891551e7ac9fb71'],350,575,925,20235744,11,0,1,0.944444444,19367
75f9c51f631155aea350c3a29e8df11a36ac37a1,1,Lisnichenko Dmitro,2015-04-01 18:38:29+03:00,['16e96dda71bce3ed900c9dfb7adea6821b2a1458'],6,31,37,20235781,2,0,0,1,19367
1eb9315d15fbd97b79b7d58eec2c450b9b6e82ec,1,Dmytro Sen,2015-04-01 18:56:48+03:00,['75f9c51f631155aea350c3a29e8df11a36ac37a1'],5,9,14,20235795,3,,,,19367
aa6ef089ba16f4841c6af0666cc5d5d4b451df3d,1,Lisnichenko Dmitro,2015-04-01 19:01:44+03:00,['1eb9315d15fbd97b79b7d58eec2c450b9b6e82ec'],6,4,10,20235805,1,,,,19367
5d077fba8fdc25ed0995ca29db9d417c1bb78c81,1,Alex Antonenko,2015-04-01 19:34:39+03:00,['aa6ef089ba16f4841c6af0666cc5d5d4b451df3d'],6,14,20,20235825,1,,,,19367
759edd4d37aea54dcaf7056a715f786c26f9f2e8,0,Alex Antonenko,2015-04-01 20:29:03+03:00,['5d077fba8fdc25ed0995ca29db9d417c1bb78c81'],41,17,58,20235883,1,,,,19367
e22b671035bcaa026f2ce5c3b77e1d49b3c74c73,1,Robert Levas,2015-04-01 16:21:34-04:00,['759edd4d37aea54dcaf7056a715f786c26f9f2e8'],9,109,118,20236001,4,0,0.833333333,1,19368
5da97da85bd9868621f574c4907a96d218a2418b,0,Srimanth Gunturi,2015-04-01 13:24:12-07:00,['e22b671035bcaa026f2ce5c3b77e1d49b3c74c73'],0,49,49,20236050,3,,,,19368
e508a5fbf8209ca119e56167c6269b1b6cb0f898,1,Dmytro Sen,2015-04-02 00:07:33+03:00,['5da97da85bd9868621f574c4907a96d218a2418b'],141,80,221,20236271,7,1,0.322033898,0,19368
acdaae986b428b09310c06f08ec42fc98b93d3b4,1,tbeerbower,2015-04-01 17:23:57-04:00,['e508a5fbf8209ca119e56167c6269b1b6cb0f898'],69,546,615,20236886,27,0.779220779,0.980519481,0.993506494,19371
ce175f1688a1f54d8ef1ed9ae4192db5ae644040,0,Yusaku Sako,2015-04-01 15:48:55-07:00,['acdaae986b428b09310c06f08ec42fc98b93d3b4'],17,41,58,20236944,1,,,,19371
cc4a9a3e0257d86ead325be054e60539943c738c,0,Yusaku Sako,2015-04-01 15:49:15-07:00,['ce175f1688a1f54d8ef1ed9ae4192db5ae644040'],14,6,20,20236964,1,,,,19371
69197e6302f28e69ccfc11b1e31d77d9dcf61a97,1,Jonathan Hurley,2015-04-01 19:00:42-04:00,['cc4a9a3e0257d86ead325be054e60539943c738c'],421,1074,1495,20238459,52,0.686567164,0.910447761,1,19375
93ad280624e4484d68ffa22eb0de8e2bfe6bff3f,0,Jonathan Hurley,2015-04-01 19:04:56-04:00,['69197e6302f28e69ccfc11b1e31d77d9dcf61a97'],5,5,10,20238469,5,,,,19375
3c6647e09a74e95ad4ccad2248f25d353d513ee4,1,Yusaku Sako,2015-04-01 16:10:27-07:00,['93ad280624e4484d68ffa22eb0de8e2bfe6bff3f'],65,19,84,20238553,2,,,,19375
d331e853295e60928174cf0a7c4ffa558b65813a,1,Alejandro Fernandez,2015-04-01 17:22:05-07:00,['3c6647e09a74e95ad4ccad2248f25d353d513ee4'],55,109,164,20238717,5,0,0.121212121,0.757575758,19375
3f452debd86a53dc4ea197dc9944334b03d2c7a9,1,Jonathan Hurley,2015-04-01 22:16:49-04:00,['d331e853295e60928174cf0a7c4ffa558b65813a'],6,8,14,20238731,3,,,,19375
ce6255033dd0ee8a8c85d8d46f8d4c0d6bb8ff74,0,Alex Antonenko,2015-04-02 07:05:29+03:00,['3f452debd86a53dc4ea197dc9944334b03d2c7a9'],24,66,90,20238821,2,,,,19375
55bfe3abab084294d7b24651ceb79df8588d3522,1,Alex Antonenko,2015-04-02 10:19:13+03:00,['ce6255033dd0ee8a8c85d8d46f8d4c0d6bb8ff74'],66,24,90,20238911,2,,,,19375
fbc69dce33cb0afa9598011d89690f2fabbb66db,1,aBabiichuk,2015-04-02 12:24:04+03:00,['55bfe3abab084294d7b24651ceb79df8588d3522'],554,365,919,20239830,14,0.72972973,0.385135135,0.155405405,19375
b119d12529607a0a68fab8e179979fa2d25db509,1,Andrii Tkach,2015-04-02 12:48:07+03:00,['fbc69dce33cb0afa9598011d89690f2fabbb66db'],86,278,364,20240194,15,0.512820513,0.974358974,1,19376
7d118f7a1c3a2ad0646c8044c4da7c56e7b16a72,1,Vitaly Brodetskyi,2015-04-02 06:28:34+03:00,['b119d12529607a0a68fab8e179979fa2d25db509'],1,97,98,20240292,6,0,1,1,19377
77c0be2f0d68a4e393ab86765d7f826c14a68bfd,1,aBabiichuk,2015-04-02 15:18:48+03:00,['7d118f7a1c3a2ad0646c8044c4da7c56e7b16a72'],178,420,598,20240890,8,0.661971831,0.61971831,0.338028169,19380
6dd00195e650c2f3e5873b286d4502d0a56a6394,0,Vitaly Brodetskyi,2015-04-02 09:10:22+03:00,['77c0be2f0d68a4e393ab86765d7f826c14a68bfd'],67,178,245,20241135,5,0.094594595,0.797297297,1,19380
97347b7d79323018c52bf684f12e51ec65dba9fe,1,Jonathan Hurley,2015-04-02 10:35:34-04:00,['6dd00195e650c2f3e5873b286d4502d0a56a6394'],100,131,231,20241366,5,1,0.571428571,1,19380
1487ad371827d80197d185428ef1a380baf10e6f,1,Alejandro Fernandez,2015-04-02 10:36:52-07:00,['97347b7d79323018c52bf684f12e51ec65dba9fe'],375,741,1116,20242482,36,0.497237569,0,0.966850829,19381
fb92ad29fea52283464b18df7114ffb81989c207,1,Florian Barca,2015-04-02 10:39:29-07:00,['1487ad371827d80197d185428ef1a380baf10e6f'],21,44,65,20242547,5,,,,19381
05de8adfc7da3cdf9786142920c14bc778c8eca3,0,Alex Antonenko,2015-04-02 21:46:28+03:00,['fb92ad29fea52283464b18df7114ffb81989c207'],28,28,56,20242603,14,,,,19381
64f4f66b72cfdee330230963b73049533e4212c0,1,Lisnichenko Dmitro,2015-04-02 22:05:06+03:00,['05de8adfc7da3cdf9786142920c14bc778c8eca3'],14,39,53,20242656,1,0.052631579,1,0.263157895,19381
19ce4a6ca8ff20ab08e67d53d1c4fe06b2745e7e,1,Srimanth Gunturi,2015-04-02 12:25:44-07:00,['64f4f66b72cfdee330230963b73049533e4212c0'],209,426,635,20243291,12,1,1,0.875,19382
9c6ac14e96305ee0100b82037fe5b0496824f7bd,0,Vitaly Brodetskyi,2015-04-02 14:44:34+03:00,['19ce4a6ca8ff20ab08e67d53d1c4fe06b2745e7e'],178,67,245,20243536,5,0.905405405,0.202702703,0,19382
22fb15a0af9ad35daa966271007fbb50e8ada0ac,1,Alex Antonenko,2015-04-02 22:53:12+03:00,['9c6ac14e96305ee0100b82037fe5b0496824f7bd'],2,39,41,20243577,3,0.411764706,1,1,19382
05b0d0b7e6ccaf6ec3a07ccdf40e436beba1648b,1,Alex Antonenko,2015-04-02 22:54:27+03:00,['22fb15a0af9ad35daa966271007fbb50e8ada0ac'],28,28,56,20243633,14,,,,19382
33377bf0905502f50254cf5629b2e32ab54cc29e,1,Andrew Onishuk,2015-04-03 00:09:37+03:00,['05b0d0b7e6ccaf6ec3a07ccdf40e436beba1648b'],0,12,12,20243645,1,,,,19382
7d39d63ff5082eb502585103defd92e6356e3282,1,Andrew Onishuk,2015-04-03 00:10:45+03:00,['33377bf0905502f50254cf5629b2e32ab54cc29e'],1,2,3,20243648,1,,,,19382
1272108d97e60a0f927ef92d553bda2a87ca0d90,1,Srimanth Gunturi,2015-04-02 14:25:12-07:00,['7d39d63ff5082eb502585103defd92e6356e3282'],45,702,747,20244395,18,0.48,0.614545455,0.952727273,19389
81f311baf4bdbec2d221ec9d88ca6793da9c6296,0,Yusaku Sako,2015-04-02 14:48:55-07:00,['1272108d97e60a0f927ef92d553bda2a87ca0d90'],1,1,2,20244397,1,,,,19389
b93452edab3d93a7217751192145eab3944876c1,1,Siddharth Wagle,2015-04-02 14:55:29-07:00,['81f311baf4bdbec2d221ec9d88ca6793da9c6296'],563,933,1496,20245893,35,0.291044776,0.813432836,0.507462687,19393
23faabc4a9bcb6908314a4c5679b1d4045de8f53,1,Siddharth Wagle,2015-04-02 14:55:29-07:00,['b93452edab3d93a7217751192145eab3944876c1'],1296,2327,3623,20249516,24,0.283870968,0.806451613,0.767741935,19394
3e07f0af3f248d90c3e511ff6dff01efd3c96d75,1,Srimanth Gunturi,2015-04-02 15:21:09-07:00,['23faabc4a9bcb6908314a4c5679b1d4045de8f53'],2,69,71,20249587,2,1,1,1,19394
ec1c7f99a096746de27b22b207382fc4da51a8d7,0,vagrant,2015-04-02 22:59:03+00:00,['3e07f0af3f248d90c3e511ff6dff01efd3c96d75'],123,165,288,20249875,9,1,1,1,19397
c897f07523b5cab6ca808b25295c1beb077d740a,1,Siddharth Wagle,2015-04-02 16:38:28-07:00,['ec1c7f99a096746de27b22b207382fc4da51a8d7'],534,536,1070,20250945,1,,,,19397
6d0eb71da6775ce577a2b812eb111d4054600e5a,1,Jaimin Jetly,2015-04-02 16:58:21-07:00,['c897f07523b5cab6ca808b25295c1beb077d740a'],0,9,9,20250954,1,,,,19397
ff45983735c5346635af876233c9a02fcd8d247f,1,Xi Wang,2015-04-02 17:35:19-07:00,['6d0eb71da6775ce577a2b812eb111d4054600e5a'],3,461,464,20251418,8,0.742138365,0.742138365,1,19399
105a62060d0f41f5f66dd54cd101663bbf5d0186,1,Srimanth Gunturi,2015-04-02 21:40:05-07:00,['ff45983735c5346635af876233c9a02fcd8d247f'],14,80,94,20251512,5,0.583333333,0.583333333,1,19399
f34f2df9c106b140dcd9c098dc19fadfcb4d8017,1,aBabiichuk,2015-04-03 13:19:36+03:00,['105a62060d0f41f5f66dd54cd101663bbf5d0186'],151,138,289,20251801,7,1,1,0.588235294,19399
888a24daa3260d011508bd11e2e36529b4e90a59,1,Aleksandr Kovalenko,2015-04-03 13:53:47+03:00,['f34f2df9c106b140dcd9c098dc19fadfcb4d8017'],9,80,89,20251890,4,0.328358209,0.955223881,0.955223881,19399
11950930ddc3aae00e537ff2b5e9484576cbf271,1,Oleg Nechiporenko,2015-04-03 15:52:14+03:00,['888a24daa3260d011508bd11e2e36529b4e90a59'],1,11,12,20251902,2,,,,19399
5d817eaee694a710bb5e3dd19eec655c7f7b9f63,1,Andrew Onishuk,2015-04-03 16:13:20+03:00,['11950930ddc3aae00e537ff2b5e9484576cbf271'],332,32,364,20252266,31,,,,19399
0055b86bfa5a2b3d498dacd5d8440df6a3aa201f,1,aBabiichuk,2015-04-03 16:48:57+03:00,['5d817eaee694a710bb5e3dd19eec655c7f7b9f63'],19,23,42,20252308,4,1,1,1,19399
c06fe29f325ac90df0abc4cd655f9ec76e94b831,1,Oleg Nechiporenko,2015-04-03 17:03:40+03:00,['0055b86bfa5a2b3d498dacd5d8440df6a3aa201f'],332,585,917,20253225,11,0,1,1,19399
e44c856176f89a5a166fb081e442ae863e720f61,1,Andrew Onishuk,2015-04-03 18:13:13+03:00,['c06fe29f325ac90df0abc4cd655f9ec76e94b831'],22,34,56,20253281,21,,,,19399
b3fc39395d82b8b37cb2d2e5b9b8e3edec3cd0bf,1,Dmytro Sen,2015-04-03 19:02:58+03:00,['e44c856176f89a5a166fb081e442ae863e720f61'],10,242,252,20253533,4,0,1,1,19399
6b5ef474b0b43a4b8d9fa49b76ff55c85a04c52d,1,Lisnichenko Dmitro,2015-04-03 19:07:27+03:00,['b3fc39395d82b8b37cb2d2e5b9b8e3edec3cd0bf'],2,49,51,20253584,2,0,0,1,19399
ebe3c659ad77afcecbb0ae349672a09ca7e7c8a6,0,Dmytro Sen,2015-04-03 20:54:16+03:00,['6b5ef474b0b43a4b8d9fa49b76ff55c85a04c52d'],2,2,4,20253588,1,,,,19399
c9033c986c7e2f4d8853c35abfa0bffb75d70e85,1,Alejandro Fernandez,2015-04-03 14:10:41-07:00,['ebe3c659ad77afcecbb0ae349672a09ca7e7c8a6'],14,24,38,20253626,2,0,1,1,19399
a27378257cec945e154afcaa3b5e3e22dfe06121,1,Oleg Nechiporenko,2015-04-04 11:35:22+03:00,['c9033c986c7e2f4d8853c35abfa0bffb75d70e85'],174,92,266,20253892,20,0,0,0,19399
fc18e469b17ed3c146bc6e6531f1389c95a429f9,1,Oleg Nechiporenko,2015-04-04 11:36:21+03:00,['a27378257cec945e154afcaa3b5e3e22dfe06121'],44,58,102,20253994,1,0,1,1,19399
f4a44bdb53e9d985787abbcb88a0c810361257ec,1,tbeerbower,2015-04-04 19:38:01-04:00,['fc18e469b17ed3c146bc6e6531f1389c95a429f9'],14,40,54,20254048,3,0.636363636,0.636363636,0.636363636,19399
a49d5a7913f61443ac8236e589cc81d8af8cf243,0,Lisnichenko Dmitro,2015-04-06 13:19:37+03:00,['f4a44bdb53e9d985787abbcb88a0c810361257ec'],2,6,8,20254056,1,,,,19399
97f18c046ea6a31491f9b3446560523192ce7b03,1,Lisnichenko Dmitro,2015-04-06 13:29:12+03:00,['a49d5a7913f61443ac8236e589cc81d8af8cf243'],9,7,16,20254072,2,1,0,1,19399
d09dd4ecc5044daee80a06c761cd0808e78ed52b,1,Lisnichenko Dmitro,2015-04-06 13:29:58+03:00,['97f18c046ea6a31491f9b3446560523192ce7b03'],19,43,62,20254134,8,,,,19399
df3ab63c97ac5b55706d2fb6cc47feb7fc381b1e,1,aBabiichuk,2015-04-06 13:33:57+03:00,['d09dd4ecc5044daee80a06c761cd0808e78ed52b'],1496,1478,2974,20257108,8,0.422222222,0,0,19401
2034d4ee7cb4bd8abade43f23dcb87528dfcfb3b,0,Andrew Onishuk,2015-04-06 16:16:50+03:00,['df3ab63c97ac5b55706d2fb6cc47feb7fc381b1e'],1,2,3,20257111,1,,,,19401
6fd80a2325bb323687cc302a4500aafb3ac24069,1,Andrew Onishuk,2015-04-06 16:19:31+03:00,['2034d4ee7cb4bd8abade43f23dcb87528dfcfb3b'],1,40,41,20257152,4,,,,19402
8cce657f956e467898e2fc890dd6ad290e79b306,1,Andrii Tkach,2015-04-06 17:17:06+03:00,['6fd80a2325bb323687cc302a4500aafb3ac24069'],8,21,29,20257181,4,0.909090909,0.909090909,1,19402
fc03a3928ddf79f043369d58102924e91ada2596,1,Andrew Onishuk,2015-04-06 17:28:45+03:00,['8cce657f956e467898e2fc890dd6ad290e79b306'],1,1,2,20257183,1,,,,19402
4d37ee7d1849f79ad03e8dbfacaabf79871ba8c8,1,Vitaly Brodetskyi,2015-04-06 10:06:18+03:00,['fc03a3928ddf79f043369d58102924e91ada2596'],4,131,135,20257318,6,0,1,1,19402
0de10b795b66820bb55f1217a4df9e44a9de28c5,1,Florian Barca,2015-04-06 09:50:13-07:00,['4d37ee7d1849f79ad03e8dbfacaabf79871ba8c8'],1,49,50,20257368,3,0,1,1,19402
1afb7e6a7fa35912713b905306c35325c727ea9c,1,Alex Antonenko,2015-04-06 20:04:48+03:00,['0de10b795b66820bb55f1217a4df9e44a9de28c5'],64,111,175,20257543,12,0.909090909,1,1,19402
75c9df8216a0555023a143396bb9a218529fb043,1,Alex Antonenko,2015-04-06 20:04:48+03:00,['1afb7e6a7fa35912713b905306c35325c727ea9c'],11,35,46,20257589,5,0.458333333,0.458333333,0.875,19402
4b3caee767a2dc2dbd0061021ebafff9156bcbd3,1,Siddharth Wagle,2015-04-06 11:25:21-07:00,['75c9df8216a0555023a143396bb9a218529fb043'],107,1379,1486,20259075,27,0.370486656,0.729984301,0.926216641,19408
5c030d43149a1012a8d74e75fc52edd3928e58d3,0,Siddharth Wagle,2015-04-06 11:35:57-07:00,['4b3caee767a2dc2dbd0061021ebafff9156bcbd3'],0,17,17,20259092,1,,,,19408
2bb9aa2de6f675626b0acf63a02d14ab9286f4f3,1,Srimanth Gunturi,2015-04-06 11:40:04-07:00,['5c030d43149a1012a8d74e75fc52edd3928e58d3'],68,717,785,20259877,15,0.324675325,1,0.974025974,19409
c55d89c1a0d53197598da2f60ff85c19f7aa9157,1,Srimanth Gunturi,2015-04-06 15:30:20-07:00,['2bb9aa2de6f675626b0acf63a02d14ab9286f4f3'],6,40,46,20259923,4,1,1,1,19409
79659d31d83805abd5a9e9981a3b7068b0ca7408,0,Srimanth Gunturi,2015-04-06 16:22:08-07:00,['c55d89c1a0d53197598da2f60ff85c19f7aa9157'],1,1,2,20259925,1,,,,19409
ad8e9ea8cc85f3ccc1aca23a5935eed2939904fe,1,Jonathan Hurley,2015-04-06 19:54:21-04:00,['79659d31d83805abd5a9e9981a3b7068b0ca7408'],176,1655,1831,20261756,27,0.178846154,0.653846154,1,19416
3640b6cd65395b4d6281a21d253a4c66f05cd424,0,Artem Baranchuk,2015-04-07 10:14:24+03:00,['ad8e9ea8cc85f3ccc1aca23a5935eed2939904fe'],3,16,19,20261775,2,,,,19416
926e1586c207b3196198472e01e0a4f5cc656e1d,0,Artem Baranchuk,2015-04-07 10:34:31+03:00,['3640b6cd65395b4d6281a21d253a4c66f05cd424'],16,3,19,20261794,2,,,,19416
a88a155ee78472ec5e00454ec60c3f5ad55c31d0,1,Artem Baranchuk,2015-04-07 10:35:32+03:00,['926e1586c207b3196198472e01e0a4f5cc656e1d'],3,16,19,20261813,2,,,,19416
4970f55435cc79e54754070513cee428583319c8,1,Myroslav Papirkovskyy,2015-04-07 20:44:20+03:00,['a88a155ee78472ec5e00454ec60c3f5ad55c31d0'],17,17,34,20261847,6,,,,19416
793e3614869faab3be80d98f1cecd4edbe83cffc,1,Alex Antonenko,2015-04-07 22:20:31+03:00,['4970f55435cc79e54754070513cee428583319c8'],3,3,6,20261853,1,,,,19416
e07c1e57f860217accd66d24716b1d5f72860e7f,0,Andrew Onishuk,2015-04-07 22:34:55+03:00,['793e3614869faab3be80d98f1cecd4edbe83cffc'],2,159,161,20262014,5,1,1,0.916666667,19418
a1cd22f99d786e165b9e78a2f07aceeda0433c74,0,Jayush Luniya,2015-04-07 13:02:57-07:00,['e07c1e57f860217accd66d24716b1d5f72860e7f'],16,16,32,20262046,4,,,,19418
90da27509c93825eee1db57a5e962ab31f0cc550,0,Bob Nettleton,2015-04-07 18:49:29-04:00,['a1cd22f99d786e165b9e78a2f07aceeda0433c74'],1,164,165,20262211,2,0,1,1,19418
e74950cd51d46c1940849d4749f1d3ccb2861917,1,Srimanth Gunturi,2015-04-07 16:20:41-07:00,['90da27509c93825eee1db57a5e962ab31f0cc550'],5,5,10,20262221,2,,,,19418
95c9ed0d35a88016aaae51b0935fd1cdcf36b2a9,1,Jaimin Jetly,2015-04-07 16:49:29-07:00,['e74950cd51d46c1940849d4749f1d3ccb2861917'],40,231,271,20262492,8,,,,19420
ced666f35b247e7183d25b1ca2d32210ef6dae16,1,Alejandro Fernandez,2015-04-07 20:09:26-07:00,['95c9ed0d35a88016aaae51b0935fd1cdcf36b2a9'],6,6,12,20262504,6,,,,19420
728b2d47083d0a08453643bf7b166a289bba0df2,1,aBabiichuk,2015-04-08 20:22:49+03:00,['ced666f35b247e7183d25b1ca2d32210ef6dae16'],1,20,21,20262525,2,1,1,1,19420
a1f409cb206442c55fd043610a415624eda02b7d,1,Alex Antonenko,2015-04-09 01:52:43+03:00,['728b2d47083d0a08453643bf7b166a289bba0df2'],20,71,91,20262616,7,0.214285714,1,0.738095238,19420
f41b8f235a43671764628bc945de2f28748d63b7,0,Jaimin Jetly,2015-04-08 17:31:41-07:00,['a1f409cb206442c55fd043610a415624eda02b7d'],3,3,6,20262622,3,,,,19420
3171ad54c3fe71890e547dbc24d1d30478bc6080,1,Aleksandr Kovalenko,2015-04-09 18:15:39+03:00,['f41b8f235a43671764628bc945de2f28748d63b7'],21,25,46,20262668,1,1,1,1,19420
3f49c7e0dbafc680777e45495a4e65e3ffd751bc,1,Billie Rinaldi,2015-04-09 13:21:47-07:00,['3171ad54c3fe71890e547dbc24d1d30478bc6080'],1,43,44,20262712,2,0,0.892857143,0.892857143,19420
aaac2b551bac799a8e50819599503d450fc1c743,1,Sumit Mohanty,2015-04-09 17:19:08-07:00,['3f49c7e0dbafc680777e45495a4e65e3ffd751bc'],2,2,4,20262716,2,,,,19420
2d30cd5736104cb6cf19b6fa88fbb9deb157c603,1,Srimanth Gunturi,2015-04-09 18:14:03-07:00,['aaac2b551bac799a8e50819599503d450fc1c743'],1008,825,1833,20264549,6,0.5,0.179104478,0,19420
afae3449b92244f43b553bc55ad04b0fdab0709c,1,Srimanth Gunturi,2015-04-09 18:14:03-07:00,['2d30cd5736104cb6cf19b6fa88fbb9deb157c603'],98,85,183,20264732,7,0,0,0.2,19420
73dca62d949c649b54fda6a92d2a16de88a5ed29,1,Srimanth Gunturi,2015-04-09 18:14:03-07:00,['afae3449b92244f43b553bc55ad04b0fdab0709c'],0,124,124,20264856,2,,,,19421
8b9637611516f628a0502edd8ef6023125f2f236,1,Srimanth Gunturi,2015-04-09 18:20:02-07:00,['73dca62d949c649b54fda6a92d2a16de88a5ed29'],42,57,99,20264955,15,0,0.7,1,19421
76dc6034fbc424b92555b8c25f1930aef80e91cf,1,Srimanth Gunturi,2015-04-09 18:58:15-07:00,['8b9637611516f628a0502edd8ef6023125f2f236'],12,285,297,20265252,3,1,1,1,19422
880098c75c822f2b38881ef158769ecfc4bbcb23,1,Jayush Luniya,2015-04-09 22:49:08-07:00,['76dc6034fbc424b92555b8c25f1930aef80e91cf'],200,153,353,20265605,9,0,0,0,19423
e989ec0e5f54ae40598217c8ccab248a7e15c7d8,1,Jayush Luniya,2015-04-09 23:05:47-07:00,['880098c75c822f2b38881ef158769ecfc4bbcb23'],1201,816,2017,20267622,27,0,0,0,19424
cbdfbfca0c936c6ec7dfe1155b14cf5b5bc17ac1,1,Vitaly Brodetskyi,2015-04-08 23:26:24+03:00,['e989ec0e5f54ae40598217c8ccab248a7e15c7d8'],3,3,6,20267628,2,,,,19424
d52dba07df3020012a1904531f01082ef82e31b1,1,Vitaly Brodetskyi,2015-04-08 23:36:17+03:00,['cbdfbfca0c936c6ec7dfe1155b14cf5b5bc17ac1'],12,153,165,20267793,8,0,0.971223022,1,19424
defac75b05908b510fb35f872f0e6c7342e50653,1,Andrew Onishuk,2015-04-10 12:25:30+03:00,['d52dba07df3020012a1904531f01082ef82e31b1'],2,2,4,20267797,1,,,,19424
9d9dc00bba503adf21f325fbe123d71327f293e1,0,Andrew Onishuk,2015-04-10 12:26:23+03:00,['defac75b05908b510fb35f872f0e6c7342e50653'],2,17,19,20267816,1,1,1,0,19424
24a93410fa6bb611211e510d9526f312190554dd,0,Andrew Onishuk,2015-04-10 12:27:31+03:00,['9d9dc00bba503adf21f325fbe123d71327f293e1'],3,2,5,20267821,1,,,,19424
7f933e321d5914f0f6a0c761089fedf4e0cacaeb,0,Andrew Onishuk,2015-04-10 12:28:07+03:00,['24a93410fa6bb611211e510d9526f312190554dd'],2,2,4,20267825,1,,,,19424
b8d2992e454f62d988e9fb73a77c84fb49a9fa41,1,Andrew Onishuk,2015-04-10 12:29:04+03:00,['7f933e321d5914f0f6a0c761089fedf4e0cacaeb'],0,9,9,20267834,2,0,1,1,19424
860d0094a95474fc10690230b90e1a82682aef40,1,Andrew Onishuk,2015-04-10 12:29:37+03:00,['b8d2992e454f62d988e9fb73a77c84fb49a9fa41'],5,18,23,20267857,3,0,1,1,19424
ae2e9cf98d2c7ce44cfbeffa79dc7df031ce3956,0,Andrew Onishuk,2015-04-10 12:36:08+03:00,['860d0094a95474fc10690230b90e1a82682aef40'],3,1,4,20267861,2,,,,19424
8d576ebdc1f569997d795a80deb3ffb47d1b7292,1,Aleksandr Kovalenko,2015-04-10 12:37:37+03:00,['ae2e9cf98d2c7ce44cfbeffa79dc7df031ce3956'],1899,1462,3361,20271222,36,0.375438596,0.052631579,0,19426
4aae04801e9239bcfebc2effe59acc7fcad9a4b8,0,Lisnichenko Dmitro,2015-04-10 12:47:26+03:00,['8d576ebdc1f569997d795a80deb3ffb47d1b7292'],2,2,4,20271226,2,,,,19426
747c3b88cc13386734a6e886da0e626049bf453a,1,Oleg Nechiporenko,2015-04-10 12:49:15+03:00,['4aae04801e9239bcfebc2effe59acc7fcad9a4b8'],327,1178,1505,20272731,33,1,1,1,19428
48e9ae1f9d5872ff5a54ca7471d3e9ee2ec7041e,1,Andrii Tkach,2015-04-10 12:57:30+03:00,['747c3b88cc13386734a6e886da0e626049bf453a'],33,13986,14019,20286750,17,0.743902439,1,1,19432
cf4fa7d9fd0492b63c4c8514adaffeb5167d7d49,0,Andrii Tkach,2015-04-10 12:57:31+03:00,['48e9ae1f9d5872ff5a54ca7471d3e9ee2ec7041e'],7,255,262,20287012,5,0.106951872,1,1,19433
4b4bcbfb67f2cbd18da39276a59de61d0540c2e6,1,Vitaly Brodetskyi,2015-04-09 01:09:51+03:00,['cf4fa7d9fd0492b63c4c8514adaffeb5167d7d49'],82,248,330,20287342,4,0.203539823,1,0.530973451,19433
6cb623fd830958f3272cf1081bd9b70820838818,1,Artem Baranchuk,2015-04-10 14:03:39+03:00,['4b4bcbfb67f2cbd18da39276a59de61d0540c2e6'],149,560,709,20288051,9,0.455357143,0.848214286,0.9375,19437
4a9f8391677c143cca8c11784438b22e7cb915cf,1,Artem Baranchuk,2015-04-10 14:07:24+03:00,['6cb623fd830958f3272cf1081bd9b70820838818'],586,361,947,20288998,21,0.58974359,0.58974359,0.153846154,19438
f126bec036656b51aa138566d30a64630261d72d,1,Artem Baranchuk,2015-04-10 14:10:50+03:00,['4a9f8391677c143cca8c11784438b22e7cb915cf'],743,416,1159,20290157,18,0.495726496,0.495726496,0.034188034,19439
ff2f00614ba1389d450aba8ba5d96e778fdad735,0,Vitaly Brodetskyi,2015-04-09 02:11:59+03:00,['f126bec036656b51aa138566d30a64630261d72d'],1,11,12,20290169,2,0,1,1,19439
c8c9be80b8e49ca9e3ad450d3935a1c617a278e8,1,Lisnichenko Dmitro,2015-04-10 14:42:26+03:00,['ff2f00614ba1389d450aba8ba5d96e778fdad735'],1,1,2,20290171,1,,,,19439
7a8a7f71f633e52e9f87a6d1ca87fc155fe105cb,0,Lisnichenko Dmitro,2015-04-10 14:49:01+03:00,['c8c9be80b8e49ca9e3ad450d3935a1c617a278e8'],15,96,111,20290282,4,0,0,0.28,19439
53da928baa8f0e14b8d1545835e27ce4993c0225,1,Andrii Tkach,2015-04-10 14:58:21+03:00,['7a8a7f71f633e52e9f87a6d1ca87fc155fe105cb'],56,557,613,20290895,19,0.635294118,0.841176471,1,19442
26472889fd57aa6182af7e1727eb97c563f90495,1,aBabiichuk,2015-04-10 15:56:23+03:00,['53da928baa8f0e14b8d1545835e27ce4993c0225'],17,114,131,20291026,7,0.625,1,1,19442
fc8552e54cf59b342de5f0ebbdfd26090780fd6b,1,Andrii Tkach,2015-04-10 16:25:44+03:00,['26472889fd57aa6182af7e1727eb97c563f90495'],19,527,546,20291572,5,0.974358974,1,1,19442
ed3cd953393f12d0b1114415ddf2dca2a7aa5621,0,Lisnichenko Dmitro,2015-04-10 16:38:24+03:00,['fc8552e54cf59b342de5f0ebbdfd26090780fd6b'],96,15,111,20291683,4,1,1,0.72,19442
82c90a7dc6f8053f3dc219f2ee6eca21ef7a4069,1,Lisnichenko Dmitro,2015-04-10 17:16:39+03:00,['ed3cd953393f12d0b1114415ddf2dca2a7aa5621'],16,99,115,20291798,4,0,0,0.269230769,19442
3eba89a146d533c47f95ecefef13acfb6c2a7a31,1,Oleg Nechiporenko,2015-04-10 18:34:24+03:00,['82c90a7dc6f8053f3dc219f2ee6eca21ef7a4069'],25,25,50,20291848,2,,,,19442
136b3b65c0837dd2b163bf722091431b3f6cca41,1,Alex Antonenko,2015-04-10 18:41:51+03:00,['3eba89a146d533c47f95ecefef13acfb6c2a7a31'],20,7,27,20291875,5,0,0,0,19442
3ae841a2494152d53a00dbf6487a966091d94ca6,1,Alex Antonenko,2015-04-10 18:41:51+03:00,['136b3b65c0837dd2b163bf722091431b3f6cca41'],3,15,18,20291893,3,,,,19442
4659255e4cc847135c31f381a4f0f6603124b9e7,0,Florian Barca,2015-04-10 09:46:03-07:00,['3ae841a2494152d53a00dbf6487a966091d94ca6'],6,33,39,20291932,2,1,1,0,19443
64cb538edae0f482c8bd89e49fb385e1a5cbe183,0,Florian Barca,2015-04-10 09:48:06-07:00,['4659255e4cc847135c31f381a4f0f6603124b9e7'],13,33,46,20291978,3,0,0,1,19443
3133b1db4e6d5a01b60f8c73acca98409c1bd44c,1,Robert Levas,2015-04-10 12:52:05-04:00,['64cb538edae0f482c8bd89e49fb385e1a5cbe183'],199,402,601,20292579,7,0.544642857,0.883928571,0.892857143,19443
83df8c2a99ee2d68aa287d9a1db1dfd0cc423033,1,Alejandro Fernandez,2015-04-10 11:05:12-07:00,['3133b1db4e6d5a01b60f8c73acca98409c1bd44c'],2,127,129,20292708,3,0.495575221,1,0.831858407,19443
40b8b2b445746143dbea37c8cea5c943c6f3149c,1,Scott Creeley,2015-04-10 14:47:38-04:00,['83df8c2a99ee2d68aa287d9a1db1dfd0cc423033'],0,3345,3345,20296053,45,1,1,1,19488
aa492e1732e66166a3522aebbde04c05b2de3de6,1,Lisnichenko Dmitro,2015-04-10 22:26:52+03:00,['40b8b2b445746143dbea37c8cea5c943c6f3149c'],17,180,197,20296250,10,0.659090909,1,1,19488
f71f175e2742c790e02990b4bdbfb534e9523191,1,Scott Creeley,2015-04-10 15:28:32-04:00,['aa492e1732e66166a3522aebbde04c05b2de3de6'],1,1,2,20296252,1,,,,19488
2f2e372672e908628de5e0dbd40d0b491bee4eb6,1,Jaimin Jetly,2015-04-10 12:49:15-07:00,['f71f175e2742c790e02990b4bdbfb534e9523191'],50,1044,1094,20297346,14,0.15916955,0.673010381,0.946366782,19491
c71624a60654b1ed2ef04068fe986a0409fdd648,1,Siddharth Wagle,2015-04-10 15:09:08-07:00,['2f2e372672e908628de5e0dbd40d0b491bee4eb6'],104,374,478,20297824,21,0.19047619,0.44973545,0.915343915,19491
fe702ab2a0e36371d0a311d04e5c58a028ead9c2,1,Siddharth Wagle,2015-04-10 15:26:32-07:00,['c71624a60654b1ed2ef04068fe986a0409fdd648'],6,6,12,20297836,3,,,,19491
25fe9bd51d6eb03196267d6abf226a0f75a08280,0,Siddharth Wagle,2015-04-10 16:01:37-07:00,['fe702ab2a0e36371d0a311d04e5c58a028ead9c2'],1,2,3,20297839,1,,,,19491
55aaed016eff89592843cb779a0ca8f308a3d9b3,1,Srimanth Gunturi,2015-04-10 16:26:40-07:00,['25fe9bd51d6eb03196267d6abf226a0f75a08280'],31,250,281,20298120,6,0,0.842105263,0.821052632,19491
d3d73f7624ee6a3ba412ebda52cc889e0e8532e9,0,Srimanth Gunturi,2015-04-10 16:49:46-07:00,['55aaed016eff89592843cb779a0ca8f308a3d9b3'],12,10,22,20298142,2,,,,19491
5dad81c3df577bc81f588cb61eae6b0f56089b87,1,Siddharth Wagle,2015-04-10 17:24:32-07:00,['d3d73f7624ee6a3ba412ebda52cc889e0e8532e9'],4,4,8,20298150,1,,,,19491
dba8f65691a7042569d77deb3929f93c86a96e72,1,Jaimin Jetly,2015-04-10 17:48:03-07:00,['5dad81c3df577bc81f588cb61eae6b0f56089b87'],400,2081,2481,20300631,16,0.741935484,1,1,19493
4d5050c23dce477ecdbb2d0c22cdf2ae8e8d5008,0,Srimanth Gunturi,2015-04-10 18:16:39-07:00,['dba8f65691a7042569d77deb3929f93c86a96e72'],1,4,5,20300636,1,,,,19493
f8b83e2f699848ba1d4d913859af9fff3e405f53,0,Srimanth Gunturi,2015-04-10 18:22:01-07:00,['4d5050c23dce477ecdbb2d0c22cdf2ae8e8d5008'],7,10,17,20300653,3,0,0,1,19493
37717dd4cd55ee75f3f218e6fee20af529cc0f87,1,Siddharth Wagle,2015-04-10 18:49:57-07:00,['f8b83e2f699848ba1d4d913859af9fff3e405f53'],0,114,114,20300767,2,0.015384615,0.707692308,1,19493
473c583c2d8a686b1a5acfb709fae3962f2212cd,1,Xi Wang,2015-04-10 18:51:10-07:00,['37717dd4cd55ee75f3f218e6fee20af529cc0f87'],13,121,134,20300901,7,1,1,1,19493
e59089b40fbc08ef247ecbba5501bf28ab45920b,1,Sumit Mohanty,2015-04-10 19:17:22-07:00,['473c583c2d8a686b1a5acfb709fae3962f2212cd'],1,12,13,20300914,6,0,0.75,0.75,19493
b0d1c232ae6a1e855fd9f4fcee1d4855727a9a9c,1,Florian Barca,2015-04-13 08:34:22-07:00,['e59089b40fbc08ef247ecbba5501bf28ab45920b'],0,2,2,20300916,1,,,,19493
9c1c722f0339a8257f4d0b1192fef8be4b8faa68,1,Jayush Luniya,2015-04-13 12:27:26-07:00,['b0d1c232ae6a1e855fd9f4fcee1d4855727a9a9c'],46,121,167,20301083,8,0.294117647,0.68627451,0.333333333,19493
dbc2eef82029236fffb1f7f66ab979e293cf3eab,1,Siddharth Wagle,2015-04-13 14:09:25-07:00,['9c1c722f0339a8257f4d0b1192fef8be4b8faa68'],32,79,111,20301194,1,0,0.76744186,0.23255814,19493
e5e72d80d898569d0583e227e9a694f09a559f67,1,Alejandro Fernandez,2015-04-13 14:43:08-07:00,['dbc2eef82029236fffb1f7f66ab979e293cf3eab'],8,10,18,20301212,1,0,0,1,19493
68dbaa64f82fcf5c467e484ada77aa8f37adbffc,1,Siddharth Wagle,2015-04-13 15:29:09-07:00,['e5e72d80d898569d0583e227e9a694f09a559f67'],2,2,4,20301216,1,,,,19493
5a60fa18a58ec1c38cdde625adb2b7e61eaf936b,1,tbeerbower,2015-04-13 19:23:48-04:00,['68dbaa64f82fcf5c467e484ada77aa8f37adbffc'],12,553,565,20301781,12,0.486486486,0.854054054,0.556756757,19495
e5efc57ae7828ce379079385454d58142db9b44b,0,Siddharth Wagle,2015-04-13 16:57:53-07:00,['5a60fa18a58ec1c38cdde625adb2b7e61eaf936b'],3,4,7,20301788,1,0,0,1,19495
dc69558c8e53eaac02812e79cac721292911ba0a,1,Xi Wang,2015-04-13 18:46:04-07:00,['e5efc57ae7828ce379079385454d58142db9b44b'],43,771,814,20302602,14,1,1,1,19502
922cf0773479d818cc258cd42922866c1efc1773,1,Srimanth Gunturi,2015-04-13 20:45:23-07:00,['dc69558c8e53eaac02812e79cac721292911ba0a'],6,16,22,20302624,5,1,1,1,19502
ad1ad93181a569213364668c995af423ea97698d,1,Srimanth Gunturi,2015-04-13 20:55:09-07:00,['922cf0773479d818cc258cd42922866c1efc1773'],9,15,24,20302648,2,1,1,1,19502
85acd9fa92ac6f2920ee2f5d1b5429832b3eeabc,1,Andrew Onishuk,2015-04-14 11:08:49+03:00,['ad1ad93181a569213364668c995af423ea97698d'],335,568,903,20303551,16,0.376,1,1,19505
31b1700e4628fbf3815b95aa82c9487be3f42a62,1,Dmytro Sen,2015-04-14 11:43:57+03:00,['85acd9fa92ac6f2920ee2f5d1b5429832b3eeabc'],4,4,8,20303559,3,,,,19505
0d5883ff6fb7c2b6aa7e7a52cfc0a907669953bc,1,Dmytro Sen,2015-04-14 12:32:33+03:00,['31b1700e4628fbf3815b95aa82c9487be3f42a62'],77,291,368,20303927,6,0.057142857,0,0.923809524,19507
cc0384d1ab2a7644de0e65cfa69bef45bc9436fb,0,Oleg Nechiporenko,2015-04-14 14:30:33+03:00,['0d5883ff6fb7c2b6aa7e7a52cfc0a907669953bc'],14,12,26,20303953,3,0,0,0,19507
09579d107f5aa1c300d6b7684c29441e536c0f23,1,Aleksandr Kovalenko,2015-04-14 14:46:40+03:00,['cc0384d1ab2a7644de0e65cfa69bef45bc9436fb'],135,123,258,20304211,10,0,0,0.153846154,19507
a08297cc2da81087093cc3d9246267f79f8b4634,1,Robert Levas,2015-04-14 10:52:05-04:00,['09579d107f5aa1c300d6b7684c29441e536c0f23'],81,150,231,20304442,65,0.033333333,0.033333333,0.866666667,19507
5788780b44312838d764798019238b0543a0e215,1,Lisnichenko Dmitro,2015-04-14 18:19:40+03:00,['a08297cc2da81087093cc3d9246267f79f8b4634'],3,8,11,20304453,2,0,0.4,0,19507
1de06bbe23f1b8764b568ac506ddf23387e405bf,1,Aleksandr Kovalenko,2015-04-14 18:34:26+03:00,['5788780b44312838d764798019238b0543a0e215'],60,34,94,20304547,8,,,,19507
7f648f9fa3885e412cd0687b6a88197201f8d144,1,Oleg Nechiporenko,2015-04-14 18:39:23+03:00,['1de06bbe23f1b8764b568ac506ddf23387e405bf'],158,273,431,20304978,8,1,0.980769231,0.711538462,19507
b58024b78dca8d347044f8be288048460c3b35cd,1,Andrii Tkach,2015-04-14 18:59:47+03:00,['7f648f9fa3885e412cd0687b6a88197201f8d144'],64,127,191,20305169,10,0.979452055,0.746575342,0.993150685,19509
4ffe157cc2a397809142542d1985203269bc209a,1,Aleksandr Kovalenko,2015-04-14 19:19:08+03:00,['b58024b78dca8d347044f8be288048460c3b35cd'],2,2,4,20305173,2,,,,19509
7b98a31c69adb7449f93be28d2edcb6ac5153280,1,Lisnichenko Dmitro,2015-04-14 20:03:03+03:00,['4ffe157cc2a397809142542d1985203269bc209a'],15,14,29,20305202,4,0.5,0.5,0.5,19509
fbe2d4e59627fe071e7d41250f1ee3dd53a7f3d3,1,Lisnichenko Dmitro,2015-04-14 20:13:09+03:00,['7b98a31c69adb7449f93be28d2edcb6ac5153280'],4,47,51,20305253,3,,,,19510
ceb196b8392183c8daea9df343ba4e3e1d16e021,0,Srimanth Gunturi,2015-04-14 10:23:02-07:00,['fbe2d4e59627fe071e7d41250f1ee3dd53a7f3d3'],24,239,263,20305516,6,,,,19512
f11e2f0630f922cf7102fe4291d5c80230b4cb8c,1,Jonathan Hurley,2015-04-14 13:58:27-04:00,['ceb196b8392183c8daea9df343ba4e3e1d16e021'],197,350,547,20306063,14,1,1,0.457142857,19513
6f6106f326b0451dcc154818fb2a7d92a2f1d841,0,Robert Levas,2015-04-14 14:23:21-04:00,['f11e2f0630f922cf7102fe4291d5c80230b4cb8c'],1,3,4,20306067,1,0,1,1,19513
7b468d04ad5bff3b59ee6706d741000c792a7878,0,Srimanth Gunturi,2015-04-14 11:32:13-07:00,['6f6106f326b0451dcc154818fb2a7d92a2f1d841'],9,20,29,20306096,3,0,0,0,19513
8bf8687c66690eadb9391707a44c03c3c8a7e329,0,Florian Barca,2015-04-14 11:59:42-07:00,['7b468d04ad5bff3b59ee6706d741000c792a7878'],1,2,3,20306099,1,,,,19513
0944ad66a509bde360a946df6b753e4bb7d30456,1,tbeerbower,2015-04-14 15:16:58-04:00,['8bf8687c66690eadb9391707a44c03c3c8a7e329'],20,59,79,20306178,2,1,0.941176471,0.647058824,19513
43550a78dcffeec00888141995fa8103539dad43,1,Nate Cole,2015-04-14 15:17:27-04:00,['0944ad66a509bde360a946df6b753e4bb7d30456'],98,2090,2188,20308366,22,0.325892857,0.736607143,0.96875,19519
8669ec812d0c7e7f268caad259b81d77601eaa84,0,tbeerbower,2015-04-14 15:26:37-04:00,['43550a78dcffeec00888141995fa8103539dad43'],1,1,2,20308368,1,,,,19519
d2bc7bd37549ef29fa610c4687151df96e7b454b,0,Jonathan Hurley,2015-04-14 15:57:51-04:00,['8669ec812d0c7e7f268caad259b81d77601eaa84'],13,31,44,20308412,10,,,,19519
073cec990dc65e17909a64dc26fcef854e7d85bb,0,Xi Wang,2015-04-14 13:35:10-07:00,['d2bc7bd37549ef29fa610c4687151df96e7b454b'],15,14,29,20308441,4,1,1,1,19519
958fd13ec71ccbb4b2ce86abb5b007c32e90cba8,1,Siddharth Wagle,2015-04-14 14:33:15-07:00,['073cec990dc65e17909a64dc26fcef854e7d85bb'],3,705,708,20309149,18,0.363957597,0.74204947,0.883392226,19523
dbb2ee9a0995ea70f791f9b4addca8e0c9a92f95,0,Srimanth Gunturi,2015-04-14 14:44:43-07:00,['958fd13ec71ccbb4b2ce86abb5b007c32e90cba8'],239,24,263,20309412,6,,,,19523
a58352b7425d0af40799897802fb06a448d10175,0,Yusaku Sako,2015-04-14 15:26:28-07:00,['dbb2ee9a0995ea70f791f9b4addca8e0c9a92f95'],20,9,29,20309441,3,1,1,1,19523
dcbf12ef92b3922d13e5fb00bc5551fd927cbf08,1,Sumit Mohanty,2015-04-14 15:28:16-07:00,['a58352b7425d0af40799897802fb06a448d10175'],64,2166,2230,20311671,32,0.317923763,0.728304947,0.807785888,19529
2e528164e296ba8ae0b7be7d8a93c692072f92e8,1,Jaimin Jetly,2015-04-14 16:04:51-07:00,['dcbf12ef92b3922d13e5fb00bc5551fd927cbf08'],585,1907,2492,20314163,8,,,,19533
db3bd809aafbc1ca0640e5c3d320e1dfc6d07cce,1,Srimanth Gunturi,2015-04-14 16:13:16-07:00,['2e528164e296ba8ae0b7be7d8a93c692072f92e8'],24,239,263,20314426,6,,,,19535
731c56ecd8d6b6ec3a48cf804ab6efbc66016743,0,Srimanth Gunturi,2015-04-14 16:13:16-07:00,['db3bd809aafbc1ca0640e5c3d320e1dfc6d07cce'],0,2,2,20314428,1,,,,19535
61cd7e8f5f611b3aa05cfeccb328cccda6b92641,1,Srimanth Gunturi,2015-04-14 16:13:16-07:00,['731c56ecd8d6b6ec3a48cf804ab6efbc66016743'],9,20,29,20314457,3,0,0,0,19535
2ca4a9b43cc98fda609e438d9f4ebc1f9d2cb7dd,0,Srimanth Gunturi,2015-04-14 16:13:16-07:00,['61cd7e8f5f611b3aa05cfeccb328cccda6b92641'],2,2,4,20314461,1,,,,19535
ab52fb399d992b288b0893590c8db2fc380e639b,0,Xi Wang,2015-04-14 17:44:13-07:00,['2ca4a9b43cc98fda609e438d9f4ebc1f9d2cb7dd'],26,146,172,20314633,5,1,1,1,19535
8938de8ae757900b79738de90ab46320db1b54aa,1,Srimanth Gunturi,2015-04-14 18:47:13-07:00,['ab52fb399d992b288b0893590c8db2fc380e639b'],59,452,511,20315144,10,0,0.659235669,0.659235669,19535
821172c5e1e3605b8bf5366e5ae2ad9bb7a8f976,1,Srimanth Gunturi,2015-04-14 19:34:25-07:00,['8938de8ae757900b79738de90ab46320db1b54aa'],93,171,264,20315408,9,1,1,1,19535
ac6a1d4d05d02b03952a44b2d6da72b5aa68dbae,0,Alejandro Fernandez,2015-04-14 19:43:06-07:00,['821172c5e1e3605b8bf5366e5ae2ad9bb7a8f976'],0,110,110,20315518,1,,,,19535
c6d8afddb9886b2aa53babb3611f397f5b7f5416,0,Srimanth Gunturi,2015-04-14 20:02:35-07:00,['ac6a1d4d05d02b03952a44b2d6da72b5aa68dbae'],0,2,2,20315520,1,,,,19535
64850bb77dba38437d4981541d35d8344ce5b9ef,1,Jayush Luniya,2015-04-14 22:36:37-07:00,['c6d8afddb9886b2aa53babb3611f397f5b7f5416'],37,90,127,20315647,7,1,0,1,19535
7262f985d6995378df7862718b7fcd5170df3c67,1,Oleg Nechiporenko,2015-04-15 13:37:01+03:00,['64850bb77dba38437d4981541d35d8344ce5b9ef'],9,6,15,20315662,2,1,1,1,19535
899fe99f140b21ffb527b59571763898713e13cc,1,Aleksandr Kovalenko,2015-04-15 14:20:20+03:00,['7262f985d6995378df7862718b7fcd5170df3c67'],21,22,43,20315705,4,0,0,0,19535
316021844bb7ef6f8b362b91c76579309d5df02c,1,Artem Baranchuk,2015-04-15 14:47:11+03:00,['899fe99f140b21ffb527b59571763898713e13cc'],1048,607,1655,20317360,29,0,0,0,19536
7a68f8e49bafbc34a316c0a9fe9046ab3e5c2ffd,1,Artem Baranchuk,2015-04-15 15:43:11+03:00,['316021844bb7ef6f8b362b91c76579309d5df02c'],3876,700,4576,20321936,33,0,0,0,19537
80d8eb388258c16506498973872d412e7361f93d,0,Artem Baranchuk,2015-04-15 16:18:52+03:00,['7a68f8e49bafbc34a316c0a9fe9046ab3e5c2ffd'],1,1,2,20321938,1,,,,19537
70fb033b77cc1360eedeefcd5bf5bb571382ca1c,1,Andrew Onishuk,2015-04-15 17:42:59+03:00,['80d8eb388258c16506498973872d412e7361f93d'],98,91,189,20322127,7,0,1,1,19537
ecb141f9e6b69180da8b3d6f5a922a1298c999ba,1,Andrii Tkach,2015-04-15 17:45:47+03:00,['70fb033b77cc1360eedeefcd5bf5bb571382ca1c'],119,294,413,20322540,18,1,0.933333333,1,19537
ba25a16a3239148bc8158a1b95cb3be3e2a98dbb,1,aBabiichuk,2015-04-15 18:03:03+03:00,['ecb141f9e6b69180da8b3d6f5a922a1298c999ba'],96,106,202,20322742,5,0,1,1,19537
cfdb955bd3e24212672066f3a179e39a1d35e8b4,1,Oleg Nechiporenko,2015-04-15 18:26:46+03:00,['ba25a16a3239148bc8158a1b95cb3be3e2a98dbb'],16,19,35,20322777,8,1,1,1,19537
4af2453a52f0079ed779b9df16b4d01b7256df2d,0,Florian Barca,2015-04-15 10:00:57-07:00,['cfdb955bd3e24212672066f3a179e39a1d35e8b4'],0,9,9,20322786,1,,,,19537
308633d2184786e93a289395ad4c490bf476fd22,0,Jayush Luniya,2015-04-15 10:59:21-07:00,['4af2453a52f0079ed779b9df16b4d01b7256df2d'],2,2,4,20322790,1,,,,19537
9420d3816c6be50c677b6fa4165d9537a9ff2ca5,1,Lisnichenko Dmitro,2015-04-15 21:25:13+03:00,['308633d2184786e93a289395ad4c490bf476fd22'],5,171,176,20322966,9,0.75,1,0.871428571,19537
b92bfc352d41a84327824fcba34fa44c541db795,1,Siddharth Wagle,2015-04-15 12:20:45-07:00,['9420d3816c6be50c677b6fa4165d9537a9ff2ca5'],24,24,48,20323014,3,,,,19537
e9617f7f6bb5784da84113a691379f0316ec59d2,1,tbeerbower,2015-04-15 15:38:14-04:00,['b92bfc352d41a84327824fcba34fa44c541db795'],0,614,614,20323628,9,1,1,1,19545
f05543d393aed760f49f799a447366d45b3a128b,1,Siddharth Wagle,2015-04-15 13:58:56-07:00,['e9617f7f6bb5784da84113a691379f0316ec59d2'],1,74,75,20323703,2,0,1,1,19545
b58969228db8a34fb1c3c8a249b8691bf83bce21,0,Yusaku Sako,2015-04-15 14:15:39-07:00,['f05543d393aed760f49f799a447366d45b3a128b'],4,1,5,20323708,1,,,,19545
5464754717b0be739df6171ee5b6119548ec7bd9,1,Alejandro Fernandez,2015-04-15 15:52:27-07:00,['b58969228db8a34fb1c3c8a249b8691bf83bce21'],0,20835,20835,20344543,45,0.189694482,0.845873233,0.897400821,19590
bcc80c68424cb2b310a34b5ac32c2043858f55c4,1,Xi Wang,2015-04-15 17:10:36-07:00,['5464754717b0be739df6171ee5b6119548ec7bd9'],31,103,134,20344677,5,1,1,1,19590
2a7ec815fede26a3282983e6b61fc0cd3d487d96,1,Srimanth Gunturi,2015-04-15 18:58:24-07:00,['bcc80c68424cb2b310a34b5ac32c2043858f55c4'],2,5,7,20344684,2,0,0,0,19590
37aa58ff68e4d613984ff34a48feaa57c948c520,1,Oleg Nechiporenko,2015-04-16 11:50:30+03:00,['2a7ec815fede26a3282983e6b61fc0cd3d487d96'],127,83,210,20344894,17,0.36,1,1,19590
cf5703a7cde3834f22c0ac0abefc843e481e13d8,1,Andrii Tkach,2015-04-16 13:10:31+03:00,['37aa58ff68e4d613984ff34a48feaa57c948c520'],244,233,477,20345371,13,0.592592593,0,0,19590
28e68643d8a67acc88628ef6e13da0b90d101a0b,1,Andrii Tkach,2015-04-16 14:33:38+03:00,['cf5703a7cde3834f22c0ac0abefc843e481e13d8'],59,250,309,20345680,9,1,1,1,19591
7d62dbb7ba1ca98d583513d92291a45cbe13be98,1,Dmytro Sen,2015-04-16 15:25:02+03:00,['28e68643d8a67acc88628ef6e13da0b90d101a0b'],2,2,4,20345684,2,,,,19591
d445eed53ba2bc3981a62669320ee94a490f10b9,1,Andrew Onishuk,2015-04-16 16:10:02+03:00,['7d62dbb7ba1ca98d583513d92291a45cbe13be98'],353,656,1009,20346693,19,1,1,1,19593
e6a02eed7b99546fa7032ab06f8a23a9a60d8465,1,Andrew Onishuk,2015-04-16 16:36:31+03:00,['d445eed53ba2bc3981a62669320ee94a490f10b9'],3,3,6,20346699,2,,,,19593
746df034c630081df187dd442fb460596568113f,1,Jonathan Hurley,2015-04-16 10:37:14-04:00,['e6a02eed7b99546fa7032ab06f8a23a9a60d8465'],1687,3402,5089,20351788,101,0,0.65034965,0.903846154,19593
d6659bcfdd0af160176499fc2f47be4f31002f3c,0,Dmytro Sen,2015-04-16 18:05:40+03:00,['746df034c630081df187dd442fb460596568113f'],1,1,2,20351790,1,,,,19593
564df71661715105d021ef00e50b87135bc82336,1,aBabiichuk,2015-04-16 18:09:50+03:00,['d6659bcfdd0af160176499fc2f47be4f31002f3c'],1,11,12,20351802,1,1,1,1,19593
eb481241af9da6873b32436178fb2d64f3cd01b5,0,Myroslav Papirkovskyy,2015-04-15 00:36:29+03:00,['564df71661715105d021ef00e50b87135bc82336'],1,1,2,20351804,1,,,,19593
40e4b807da25e9840108ad8b3552603573e2294e,1,Vitaly Brodetskyi,2015-04-16 19:03:54+03:00,['eb481241af9da6873b32436178fb2d64f3cd01b5'],1,47,48,20351852,8,0,0,1,19593
d3e647a9020c09c90d9e211e706cd190d0eaff06,0,Jonathan Hurley,2015-04-16 12:12:23-04:00,['40e4b807da25e9840108ad8b3552603573e2294e'],2,5,7,20351859,2,0,1,1,19593
39306bf5817070377e7206e0d6e6fd4b074a9813,1,Oleg Nechiporenko,2015-04-16 19:41:15+03:00,['d3e647a9020c09c90d9e211e706cd190d0eaff06'],13,31,44,20351903,2,0,1,1,19593
f618d5f5363e6762e6d6ac52c934f17802175ba3,1,aBabiichuk,2015-04-16 19:50:05+03:00,['39306bf5817070377e7206e0d6e6fd4b074a9813'],10,14,24,20351927,5,,,,19593
abb2fa1d5f4cdd274f1c7934b1cc252601eadf98,1,Myroslav Papirkovskyy,2015-04-16 19:53:16+03:00,['f618d5f5363e6762e6d6ac52c934f17802175ba3'],1,1,2,20351929,1,,,,19593
cb9fd8e3c44b05d808b15c9cf206a6e2ccc06f60,0,Oleg Nechiporenko,2015-04-16 20:15:09+03:00,['abb2fa1d5f4cdd274f1c7934b1cc252601eadf98'],3,72,75,20352004,4,0,0,0,19593
035af842c48548f1107a1bbee27e87d6f95f1cfd,1,Alex Antonenko,2015-04-16 20:39:25+03:00,['cb9fd8e3c44b05d808b15c9cf206a6e2ccc06f60'],36,67,103,20352107,7,1,1,1,19593
d835f4485006c1684e247f3a1baca8f2c10ab035,0,Alex Antonenko,2015-04-16 20:39:25+03:00,['035af842c48548f1107a1bbee27e87d6f95f1cfd'],1,11,12,20352119,1,1,1,1,19593
34e60b07ff340f786b4e73a36959e6974d5bed8b,1,Alex Antonenko,2015-04-16 20:50:19+03:00,['d835f4485006c1684e247f3a1baca8f2c10ab035'],5,57,62,20352181,6,0.367346939,1,1,19593
ecaf2d15f3657ca53625434bbfcce2c36fbaf4b4,0,Alex Antonenko,2015-04-16 21:06:52+03:00,['34e60b07ff340f786b4e73a36959e6974d5bed8b'],20,188,208,20352389,10,0.806451613,0.975806452,0.89516129,19596
9dfbf91df05320ab382a714d1186685645c4c35e,1,Alex Antonenko,2015-04-16 21:10:51+03:00,['ecaf2d15f3657ca53625434bbfcce2c36fbaf4b4'],19,76,95,20352484,2,0.387096774,1,1,19596
5bb1faefb10bce6f2eee5d65d98f4ad9e05d4e8d,0,Siddharth Wagle,2015-04-16 11:17:49-07:00,['9dfbf91df05320ab382a714d1186685645c4c35e'],14,24,38,20352522,2,0,1,1,19596
c7022dc36a89a6660def99bf8eadd0f95154144f,0,Alex Antonenko,2015-04-16 21:18:27+03:00,['5bb1faefb10bce6f2eee5d65d98f4ad9e05d4e8d'],3,13,16,20352538,2,1,1,1,19596
d87c8bc20d04fe70a799cfa6988646b839cc6401,0,Alex Antonenko,2015-04-16 21:20:11+03:00,['c7022dc36a89a6660def99bf8eadd0f95154144f'],0,1,1,20352539,1,,,,19596
db058a451af4ad0c824fe4ab89a1b40d397512ae,1,Lisnichenko Dmitro,2015-04-16 21:22:19+03:00,['d87c8bc20d04fe70a799cfa6988646b839cc6401'],0,32,32,20352571,1,,,,19597
c7e310d62dd99db348faa00baca3af4ddc8ee1c1,0,Vitaly Brodetskyi,2015-04-16 20:13:47+03:00,['db058a451af4ad0c824fe4ab89a1b40d397512ae'],2,2,4,20352575,1,,,,19597
6dae33e54caeb42cf3bda5f8b8c88e1917f5b73d,1,Jaimin Jetly,2015-04-16 13:14:56-07:00,['c7e310d62dd99db348faa00baca3af4ddc8ee1c1'],625,1378,2003,20354578,21,0.074074074,0.074074074,0.148148148,19598
3c2fa88f54ab794e069d729c61c3dbb39407a1a9,1,Jaimin Jetly,2015-04-16 14:06:04-07:00,['6dae33e54caeb42cf3bda5f8b8c88e1917f5b73d'],17,27,44,20354622,2,0,0.4,0.4,19598
2ca95b32bd0a39fc16270857266c01428d4ed49f,1,Sumit Mohanty,2015-04-16 14:57:15-07:00,['3c2fa88f54ab794e069d729c61c3dbb39407a1a9'],4,8,12,20354634,1,0,1,1,19598
c7157e00feff0eb0cc5ccb308cfce54e2950c82f,1,Sumit Mohanty,2015-04-16 15:23:02-07:00,['2ca95b32bd0a39fc16270857266c01428d4ed49f'],6,7,13,20354647,3,,,,19598
a69d17fad8e76c45a182218724de19aae8173d2e,0,Sumit Mohanty,2015-04-16 16:04:42-07:00,['c7157e00feff0eb0cc5ccb308cfce54e2950c82f'],0,8,8,20354655,8,,,,19598
23f7428a050d6c2a593d53d717875f75a5c2e614,1,Xi Wang,2015-04-16 17:40:48-07:00,['a69d17fad8e76c45a182218724de19aae8173d2e'],31,106,137,20354792,5,1,1,1,19598
68c68a6f0eb09f0bbdd530c9c9e1baa8dbfa9828,1,Alex Antonenko,2015-04-17 06:17:28+03:00,['23f7428a050d6c2a593d53d717875f75a5c2e614'],98,284,382,20355174,6,0.101010101,1,0.858585859,19598
962a8a006e35860d391d10781d0b911d7f602d9d,0,Florian Barca,2015-04-16 20:45:03-07:00,['68c68a6f0eb09f0bbdd530c9c9e1baa8dbfa9828'],142,200,342,20355516,7,0.526315789,1,0.631578947,19598
2ea37fbcd7cacc38e388f89aa6bd55a79eecce53,1,Jaimin Jetly,2015-04-16 21:24:46-07:00,['962a8a006e35860d391d10781d0b911d7f602d9d'],51,53,104,20355620,6,,,,19598
04c986186cacb34bdfca3266215da9f00aa93a18,0,Jayush Luniya,2015-04-16 22:34:30-07:00,['2ea37fbcd7cacc38e388f89aa6bd55a79eecce53'],200,142,342,20355962,7,0.473684211,0,0.368421053,19598
55e31bb820fc80c264cf96b52a3caeb3ed069154,0,aBabiichuk,2015-04-17 13:33:19+03:00,['04c986186cacb34bdfca3266215da9f00aa93a18'],2,3,5,20355967,2,1,1,1,19598
4f1607bb0f9a1b35a8ab7394bcf0c47ec75a8c1d,1,Andrii Tkach,2015-04-17 14:05:12+03:00,['55e31bb820fc80c264cf96b52a3caeb3ed069154'],21,80,101,20356068,7,1,1,1,19598
f5b17aa50e6ad73130c130fbab803d96f4aec342,1,aBabiichuk,2015-04-17 14:30:22+03:00,['4f1607bb0f9a1b35a8ab7394bcf0c47ec75a8c1d'],1,4,5,20356073,3,,0,,19598
7808566db8440aa32330da5a48785169c79a4e96,1,Oleg Nechiporenko,2015-04-17 15:25:00+03:00,['f5b17aa50e6ad73130c130fbab803d96f4aec342'],3,128,131,20356204,6,0.236111111,1,1,19599
52fe9f77f2faded84ff3142cf89dd9e5660eca20,1,aBabiichuk,2015-04-17 15:29:57+03:00,['7808566db8440aa32330da5a48785169c79a4e96'],0,9,9,20356213,2,1,1,1,19599
51b2c338bf1489dd0223a6e2bf105a737676495c,1,Lisnichenko Dmitro,2015-04-17 16:05:25+03:00,['52fe9f77f2faded84ff3142cf89dd9e5660eca20'],4,1148,1152,20357365,10,0.352095808,0.998802395,0.752095808,19605
77e77010c8b142d6228a8cb4f8cf9e137f115abf,1,Aleksandr Kovalenko,2015-04-17 17:29:16+03:00,['51b2c338bf1489dd0223a6e2bf105a737676495c'],5,44,49,20357414,4,0.153846154,0,1,19605
affca503f2521d009790d69e80c298e8f3ca3325,1,Alex Antonenko,2015-04-17 18:11:24+03:00,['77e77010c8b142d6228a8cb4f8cf9e137f115abf'],188,20,208,20357622,10,0.193548387,0.024193548,0.10483871,19605
4bb98e46f39b97ad0f86460fada8e2b9f9a3d883,1,Jayush Luniya,2015-04-17 09:13:11-07:00,['affca503f2521d009790d69e80c298e8f3ca3325'],3,4,7,20357629,1,,,,19605
ac7507975ad450d2e39eb9459129f04fc1e5dbc8,0,Lisnichenko Dmitro,2015-04-17 20:03:48+03:00,['4bb98e46f39b97ad0f86460fada8e2b9f9a3d883'],40,13,53,20357682,2,1,0,0,19605
85aa856ba232ebd9836914b54585773c7a3d7d30,0,Lisnichenko Dmitro,2015-04-17 20:05:24+03:00,['ac7507975ad450d2e39eb9459129f04fc1e5dbc8'],13,40,53,20357735,2,0,1,1,19605
4254fb4a1d5309b9a1b3133550f744419afc8533,1,Lisnichenko Dmitro,2015-04-17 20:05:41+03:00,['85aa856ba232ebd9836914b54585773c7a3d7d30'],40,13,53,20357788,2,1,0,0,19605
2917d0dede140260ae01ece25a536fb894863e7c,1,Florian Barca,2015-04-17 10:31:05-07:00,['4254fb4a1d5309b9a1b3133550f744419afc8533'],57,98,155,20357943,1,,,,19605
672eee34dce8200f7375f164c307d864b4f5ffd1,1,Alex Antonenko,2015-04-17 22:10:24+03:00,['2917d0dede140260ae01ece25a536fb894863e7c'],541,2896,3437,20361380,116,0.787102473,0.81360424,0.847173145,19630
8f253dfd366b0bef41d2cace978363e61e410796,1,Lisnichenko Dmitro,2015-04-17 22:18:30+03:00,['672eee34dce8200f7375f164c307d864b4f5ffd1'],1,21,22,20361402,1,0,0,1,19630
12d608141f6ea4f58c83c310b1f647e591455001,1,Robert Levas,2015-04-17 15:25:48-04:00,['8f253dfd366b0bef41d2cace978363e61e410796'],1,25,26,20361428,3,1,1,1,19630
e7643d5eb34621c5fb1256aac8625b970c43dc8e,1,Jaimin Jetly,2015-04-17 12:39:44-07:00,['12d608141f6ea4f58c83c310b1f647e591455001'],49,134,183,20361611,6,1,1,1,19630
7f542913bae6cd0a3fe4ead9d507a5e3858545f0,1,Sumit Mohanty,2015-04-17 13:23:08-07:00,['e7643d5eb34621c5fb1256aac8625b970c43dc8e'],6,10,16,20361627,5,1,1,0,19630
b392c686171dcfdcc59a6813df1f137149c7107a,0,Florian Barca,2015-04-17 13:55:11-07:00,['7f542913bae6cd0a3fe4ead9d507a5e3858545f0'],1,7,8,20361635,1,,,,19630
0f2a90489fe7da89417f03abd1c6c422c61714c8,1,Aleksandr Kovalenko,2015-04-18 00:09:51+03:00,['b392c686171dcfdcc59a6813df1f137149c7107a'],4,80,84,20361719,4,1,1,1,19631
2e6d9d61f8b7e11f548b3f12da49edd9d1f8843a,1,Robert Levas,2015-04-17 17:15:56-04:00,['0f2a90489fe7da89417f03abd1c6c422c61714c8'],436,484,920,20362639,4,0.413793103,0,0.931034483,19631
1e631ce386a3c7fb5080ad3d09236645c84191be,0,Andrew Onishuk,2015-04-18 00:28:13+03:00,['2e6d9d61f8b7e11f548b3f12da49edd9d1f8843a'],1,1,2,20362641,1,,,,19631
bdf5effbe899c93b7da408417474f1c8cdbb4b2b,1,Jonathan Hurley,2015-04-17 17:56:15-04:00,['1e631ce386a3c7fb5080ad3d09236645c84191be'],67,342,409,20363050,11,0,0.98245614,0.988304094,19631
180640d943736b90ca2bc03f3ed6512e73e8d5e6,1,Florian Barca,2015-04-17 15:33:59-07:00,['bdf5effbe899c93b7da408417474f1c8cdbb4b2b'],144,201,345,20363395,6,0.540540541,1,0.621621622,19631
f76f239d809c9ab9d1380a1bdb133c91d9eccb17,0,Jayush Luniya,2015-04-17 15:44:42-07:00,['180640d943736b90ca2bc03f3ed6512e73e8d5e6'],330,2,332,20363727,6,0.779816514,0.440366972,0.376146789,19631
fc5b29f435a2e4504d191c885403d1b6038be806,1,Jaimin Jetly,2015-04-17 16:58:59-07:00,['f76f239d809c9ab9d1380a1bdb133c91d9eccb17'],81,55,136,20363863,11,0,0,0,19631
871981252da501cecb33290a4e191be0b66c595a,1,Xi Wang,2015-04-17 17:36:30-07:00,['fc5b29f435a2e4504d191c885403d1b6038be806'],9,19,28,20363891,7,1,1,1,19631
f69d157c8d428f31a206ec9e92a66e43c3e4e980,1,Xi Wang,2015-04-17 17:36:30-07:00,['871981252da501cecb33290a4e191be0b66c595a'],17,16,33,20363924,3,,,,19631
7c3015fee5afd647c73b1af6ac492569dc958ee4,1,Robert Levas,2015-04-17 21:35:16-04:00,['f69d157c8d428f31a206ec9e92a66e43c3e4e980'],18,18,36,20363960,2,,,,19631
a1bd8610a3c2b2a7a3b709c397547e43ddecd4b1,1,Alex Antonenko,2015-04-18 22:29:09+03:00,['7c3015fee5afd647c73b1af6ac492569dc958ee4'],0,1,1,20363961,1,,,,19631
7ad3d2f206eb36239719a1e8edfafb2c3e78617e,0,Srimanth Gunturi,2015-04-18 13:14:21-07:00,['a1bd8610a3c2b2a7a3b709c397547e43ddecd4b1'],0,1,1,20363962,1,,,,19631
81021351bf23cc365a90f47f08fc70cbdd9d0bb3,1,Srimanth Gunturi,2015-04-18 13:53:45-07:00,['7ad3d2f206eb36239719a1e8edfafb2c3e78617e'],50,108,158,20364120,6,1,1,1,19631
ee79dd21cca51646e3344c161ea61bc2e68f21fb,1,Alejandro Fernandez,2015-04-18 16:18:05-07:00,['81021351bf23cc365a90f47f08fc70cbdd9d0bb3'],571,1040,1611,20365731,50,1,1,0,19634
1cc1526c26d391771b65680a921c3db3c06dbd81,1,aBabiichuk,2015-04-19 18:29:05+03:00,['ee79dd21cca51646e3344c161ea61bc2e68f21fb'],3,18,21,20365752,2,1,1,1,19634
027ac67694a0f4f96352a997890673e70af47cad,0,Srimanth Gunturi,2015-04-19 12:16:15-07:00,['1cc1526c26d391771b65680a921c3db3c06dbd81'],18,24,42,20365794,1,1,1,1,19634
4e5910d01d86a1afefb326e2d932c37dab5e343e,0,Srimanth Gunturi,2015-04-19 18:55:54-07:00,['027ac67694a0f4f96352a997890673e70af47cad'],23,251,274,20366068,9,0.310559006,0.540372671,0.664596273,19634
f3a418c31f7ef30cb077a4e976f76f27025d1732,1,Srimanth Gunturi,2015-04-19 22:55:59-07:00,['4e5910d01d86a1afefb326e2d932c37dab5e343e'],16,105,121,20366189,6,0.072463768,0.927536232,0.927536232,19634
3156c3ad6b2d5b8459c99f839f92059e4ab82625,0,Srimanth Gunturi,2015-04-20 00:26:12-07:00,['f3a418c31f7ef30cb077a4e976f76f27025d1732'],251,23,274,20366463,9,0.689440994,0.459627329,0.335403727,19634
4f7fc3eea26bf178322c38c5a41f30eee45d9a37,1,Alex Antonenko,2015-04-20 11:00:15+03:00,['3156c3ad6b2d5b8459c99f839f92059e4ab82625'],1,291,292,20366755,10,0,0,1,19640
4b953b715941e084bd5dd55faf162daf6bf69545,1,Alex Antonenko,2015-04-20 11:14:32+03:00,['4f7fc3eea26bf178322c38c5a41f30eee45d9a37'],1,510,511,20367266,2,0.623737374,0.997474747,0.997474747,19640
d36d8946413f4748ba3ffd2fc706e8415ac7a279,1,Andrii Tkach,2015-04-20 14:06:12+03:00,['4b953b715941e084bd5dd55faf162daf6bf69545'],1,14,15,20367281,1,1,1,1,19640
e5cfe183f87ca0a8fa93d8797f360338893927a5,1,Oleg Nechiporenko,2015-04-20 14:55:36+03:00,['d36d8946413f4748ba3ffd2fc706e8415ac7a279'],21,27,48,20367329,2,1,1,1,19640
6f33889d91a1714cf27b66992bae8796fa606a3c,1,aBabiichuk,2015-04-20 15:42:10+03:00,['e5cfe183f87ca0a8fa93d8797f360338893927a5'],21,23,44,20367373,10,0,1,1,19640
5cf68111db1a8bc322c3775cfd44f5e006059bee,1,Andrii Tkach,2015-04-20 16:06:44+03:00,['6f33889d91a1714cf27b66992bae8796fa606a3c'],1,101,102,20367475,3,1,1,1,19640
9a41fd16ff3628e7377c53358a7106e41e90d929,1,Alex Antonenko,2015-04-20 16:23:48+03:00,['5cf68111db1a8bc322c3775cfd44f5e006059bee'],24,18,42,20367517,1,0,0,0,19640
38a9bbae5c62258436f15f969cae06c2027f64e7,1,Vitaly Brodetskyi,2015-04-20 01:09:10+03:00,['9a41fd16ff3628e7377c53358a7106e41e90d929'],0,17,17,20367534,2,0,1,1,19640
19e8490dfa11dcad37245639125bc2c29ec600b5,0,Lisnichenko Dmitro,2015-04-20 16:47:20+03:00,['38a9bbae5c62258436f15f969cae06c2027f64e7'],0,29,29,20367563,1,,,,19641
6ffa2b7257b1b3995dd64174ba8d3e1d9aab061e,0,Oleg Nechiporenko,2015-04-20 17:39:21+03:00,['19e8490dfa11dcad37245639125bc2c29ec600b5'],2,1,3,20367566,2,,,,19641
b031c745d3a966e152b53fc1bf5c80b6a37d0692,1,Alex Antonenko,2015-04-20 17:54:06+03:00,['6ffa2b7257b1b3995dd64174ba8d3e1d9aab061e'],21,401,422,20367988,3,0.502487562,1,1,19641
62e89232c7a1841ac97d85fd1216fe73adca33a1,1,Alex Antonenko,2015-04-20 18:26:36+03:00,['b031c745d3a966e152b53fc1bf5c80b6a37d0692'],17,206,223,20368211,7,0.826923077,1,0.961538462,19642
0b5c79064bf7d23a6fa15b4edabbde3bb629902e,1,Jonathan Hurley,2015-04-20 12:20:05-04:00,['62e89232c7a1841ac97d85fd1216fe73adca33a1'],133,405,538,20368749,17,0.010309278,0.979381443,1,19644
c230d0f527ce8ef9f211054559eaa060ee28971b,1,Srimanth Gunturi,2015-04-20 09:27:31-07:00,['0b5c79064bf7d23a6fa15b4edabbde3bb629902e'],24,256,280,20369029,11,0.323170732,0.548780488,0.670731707,19644
b1d9cf98bcb8913bb3a89d8d8d618ebe1e9f3760,1,aBabiichuk,2015-04-20 19:35:29+03:00,['c230d0f527ce8ef9f211054559eaa060ee28971b'],3,29,32,20369061,2,1,0.176470588,0.176470588,19644
03dc496a80252d8434ba8ef61301fdbaf5026ca0,1,aBabiichuk,2015-04-20 19:35:29+03:00,['b1d9cf98bcb8913bb3a89d8d8d618ebe1e9f3760'],20,25,45,20369106,4,0,1,0.111111111,19644
646b1dde7eea3b6fa51d8c364942886f3b36d1d7,1,Lisnichenko Dmitro,2015-04-20 20:05:28+03:00,['03dc496a80252d8434ba8ef61301fdbaf5026ca0'],10,56,66,20369172,1,,,,19644
4e06a89f8625d0a03481028615a467470dfe54d9,0,Lisnichenko Dmitro,2015-04-20 20:16:36+03:00,['646b1dde7eea3b6fa51d8c364942886f3b36d1d7'],0,4,4,20369176,1,0,0,1,19644
7ad8c9acb5fdf27874d24ade5cbe38f1a59bba34,1,Lisnichenko Dmitro,2015-04-20 20:17:25+03:00,['4e06a89f8625d0a03481028615a467470dfe54d9'],5,27,32,20369208,6,0.1875,0.875,0.5625,19644
fecd6aad46af8a701ac6c3b1a18a80b979658fc6,0,Robert Levas,2015-04-20 13:20:19-04:00,['7ad8c9acb5fdf27874d24ade5cbe38f1a59bba34'],8,51,59,20369267,2,0,1,1,19644
aed7c85cac5de5ad1d9b1d98c167c68447b482f7,1,Jayush Luniya,2015-04-20 11:42:22-07:00,['fecd6aad46af8a701ac6c3b1a18a80b979658fc6'],1,1273,1274,20370541,14,0.198237885,0.550660793,0.656387665,19657
14b863738a57b933a4b143e39e863614d8d05667,0,Artem Baranchuk,2015-04-20 22:01:58+03:00,['aed7c85cac5de5ad1d9b1d98c167c68447b482f7'],1,1,2,20370543,1,,,,19657
3d2684addc4108cd7a3f6a4d429dd2a1511cd748,1,Nate Cole,2015-04-20 15:12:04-04:00,['14b863738a57b933a4b143e39e863614d8d05667'],57,730,787,20371330,10,0.118012422,0.636645963,1,19660
6d3570c0507db1868beab7118683524b2079dcf6,0,Srimanth Gunturi,2015-04-20 12:50:33-07:00,['3d2684addc4108cd7a3f6a4d429dd2a1511cd748'],1,1,2,20371332,1,,,,19660
2505191ddaafc058925e8a4d7374f5ffabdcfc74,0,Xi Wang,2015-04-20 13:58:32-07:00,['6d3570c0507db1868beab7118683524b2079dcf6'],28,23,51,20371383,4,0,0,0,19660
e1d998f8c452737148342ce1a07660e229727b9a,0,Jaimin Jetly,2015-04-20 15:01:37-07:00,['2505191ddaafc058925e8a4d7374f5ffabdcfc74'],1,1,2,20371385,1,,,,19660
d9f6bbec2eeb275146eca739951664fd55c47cc1,1,Alejandro Fernandez,2015-04-20 15:10:15-07:00,['e1d998f8c452737148342ce1a07660e229727b9a'],5,45,50,20371435,2,0.133333333,0.6,1,19660
f04358d7199c2e3e5b2233a91be9ea7f45baa840,1,Andrew Onishuk,2015-04-21 01:12:07+03:00,['d9f6bbec2eeb275146eca739951664fd55c47cc1'],1,3,4,20371439,2,,,,19660
9e2b60bacddd0b22196a74cb8d6160ca86e87e83,1,Andrew Onishuk,2015-04-21 01:28:01+03:00,['f04358d7199c2e3e5b2233a91be9ea7f45baa840'],5,16,21,20371460,5,0,0,1,19660
47a74487c3879ea187a97acf4876c380d0afc218,1,Xi Wang,2015-04-20 17:37:32-07:00,['9e2b60bacddd0b22196a74cb8d6160ca86e87e83'],10,114,124,20371584,5,1,1,1,19660
cf0169c918201886a7d0992acf82b4dc0df2ee1b,1,Robert Levas,2015-04-20 21:13:45-04:00,['47a74487c3879ea187a97acf4876c380d0afc218'],51,8,59,20371643,2,1,0,0,19660
c79bd1245bcbfd8de3d2710e529db843aee90a53,1,Bob Nettleton,2015-04-20 21:30:17-04:00,['cf0169c918201886a7d0992acf82b4dc0df2ee1b'],8,419,427,20372070,2,0.06870229,0.927480916,0.91221374,19660
eeea2eebec7d77ce4cea242b456c44f10610b331,1,Robert Levas,2015-04-20 21:56:05-04:00,['c79bd1245bcbfd8de3d2710e529db843aee90a53'],8,51,59,20372129,2,0,1,1,19660
3fd5c16e3a070bd4dd6a6529d5dff70c7be81cc1,1,Jonathan Hurley,2015-04-20 22:09:37-04:00,['eeea2eebec7d77ce4cea242b456c44f10610b331'],232,353,585,20372714,14,0,0,1,19660
7a4242166637a5660d05de28cd2a3c6dd65fdfc0,1,Srimanth Gunturi,2015-04-20 19:47:10-07:00,['3fd5c16e3a070bd4dd6a6529d5dff70c7be81cc1'],1,203,204,20372918,3,0,0.899470899,0.920634921,19660
4063af87c2010ff905329df254f8ec92b1996be0,1,Srimanth Gunturi,2015-04-20 21:29:18-07:00,['7a4242166637a5660d05de28cd2a3c6dd65fdfc0'],2,2,4,20372922,1,,,,19660
54c5fbe17b7a72f85bb318e22d81bab88e84aa35,1,Srimanth Gunturi,2015-04-20 21:32:27-07:00,['4063af87c2010ff905329df254f8ec92b1996be0'],0,10,10,20372932,1,1,1,1,19660
766cb64ef58882a57a205c90953cbd1be473437c,1,aBabiichuk,2015-04-21 09:24:17+03:00,['54c5fbe17b7a72f85bb318e22d81bab88e84aa35'],2,32,34,20372966,3,0.958333333,1,1,19660
c3e0771e40fb255ff69bb6cbc70495435486512e,1,Dmytro Sen,2015-04-21 11:55:56+03:00,['766cb64ef58882a57a205c90953cbd1be473437c'],38,233,271,20373237,4,0,0.802259887,0.802259887,19660
c97446c5860f16261a0a19214c5a17c7cc23d4a4,1,Oleg Nechiporenko,2015-04-21 14:21:33+03:00,['c3e0771e40fb255ff69bb6cbc70495435486512e'],4,208,212,20373449,13,1,0.871794872,1,19662
26e376ae9ec015a546edcb61d3f1a316854b0fac,0,Andrew Onishuk,2015-04-21 14:45:35+03:00,['c97446c5860f16261a0a19214c5a17c7cc23d4a4'],1,1,2,20373451,1,,,,19662
48942574e16040c0dac6f393ad2a5fad2739107c,1,Alex Antonenko,2015-04-21 15:53:40+03:00,['26e376ae9ec015a546edcb61d3f1a316854b0fac'],3,9,12,20373463,3,,,,19662
0136d89350dec8e5602e33d23b3ba6c77804d3bb,0,Andrew Onishuk,2015-04-21 16:28:47+03:00,['48942574e16040c0dac6f393ad2a5fad2739107c'],18995,36,19031,20392494,44,0.845290386,0.164958516,0.105417277,19662
8de76e83c3a473ea24143fd22dc05402c042628a,1,Oleg Nechiporenko,2015-04-21 17:28:08+03:00,['0136d89350dec8e5602e33d23b3ba6c77804d3bb'],0,10,10,20392504,1,,,,19662
c136edff173404c09f7174d85f680ae30d1efd0b,1,aBabiichuk,2015-04-21 17:51:55+03:00,['8de76e83c3a473ea24143fd22dc05402c042628a'],19,24,43,20392547,1,1,1,1,19662
0c428ebae5f9f2f6a0744df8b8485a2c267ab838,0,Oleg Nechiporenko,2015-04-21 18:14:55+03:00,['c136edff173404c09f7174d85f680ae30d1efd0b'],2,95,97,20392644,2,1,1,1,19662
2dd2548f33c7befe09ea2d3275e2dea2eec8e957,1,Andrew Onishuk,2015-04-21 19:08:34+03:00,['0c428ebae5f9f2f6a0744df8b8485a2c267ab838'],11,57,68,20392712,3,1,0,1,19663
2557d9a8fb7d9e2f7fe3b2e0deb5b5bec0d14dc1,1,Aleksandr Kovalenko,2015-04-21 19:11:19+03:00,['2dd2548f33c7befe09ea2d3275e2dea2eec8e957'],9,158,167,20392879,9,0.739726027,0.794520548,1,19663
67c425acfd22dcd701d05eab16f22d423db045dd,1,Siddharth Wagle,2015-04-21 09:51:58-07:00,['2557d9a8fb7d9e2f7fe3b2e0deb5b5bec0d14dc1'],737,1065,1802,20394681,22,0,0.676616915,0.825870647,19665
e463d2758874f8ec9ade547b0e302247c841ef0e,1,aBabiichuk,2015-04-21 19:54:51+03:00,['0c428ebae5f9f2f6a0744df8b8485a2c267ab838'],95,2,97,20394778,2,0,0,0,19665
b9662cef66d5e4a5b53405dab40e9d17eafeb966,0,aBabiichuk,2015-04-21 19:55:14+03:00,"['e463d2758874f8ec9ade547b0e302247c841ef0e', '67c425acfd22dcd701d05eab16f22d423db045dd']",757,1280,2037,20396815,34,,,,19665
6035a891c2ea718c147e9304e6090d50a6e362d9,1,Jayush Luniya,2015-04-21 10:15:16-07:00,['b9662cef66d5e4a5b53405dab40e9d17eafeb966'],1,336,337,20397152,16,0,1,1,19671
5d4fb317764cfde48898377975f1df17b20e40a4,1,Jonathan Hurley,2015-04-21 13:18:58-04:00,['6035a891c2ea718c147e9304e6090d50a6e362d9'],1,3,4,20397156,2,0,1,1,19671
e1ccd2f11b5593b26e8339a4eeef0e2c678e4bd0,1,Aleksandr Kovalenko,2015-04-21 20:20:38+03:00,['5d4fb317764cfde48898377975f1df17b20e40a4'],2,2,4,20397160,1,,,,19671
91eb6961ef508a06659a5ce4c1acfd803e6502fd,1,Lisnichenko Dmitro,2015-04-21 21:36:54+03:00,['e1ccd2f11b5593b26e8339a4eeef0e2c678e4bd0'],1,1,2,20397162,1,,,,19671
c254db4b3592e910599ce25c7add8db2650ccfbb,1,Sumit Mohanty,2015-04-21 13:29:52-07:00,['91eb6961ef508a06659a5ce4c1acfd803e6502fd'],26,266,292,20397454,8,0.064102564,0.826923077,0.044871795,19671
9b2f26698d964b0cb5eaccc8f394edc87f8d94d0,1,tbeerbower,2015-04-21 18:38:51-04:00,['c254db4b3592e910599ce25c7add8db2650ccfbb'],1,15,16,20397470,1,0,0.181818182,0.818181818,19671
f24531d1bbab130fc89b09720c536f3c345bd038,1,Jayush Luniya,2015-04-21 17:34:47-07:00,['9b2f26698d964b0cb5eaccc8f394edc87f8d94d0'],19,292,311,20397781,5,0,1,1,19671
55c0f792f76e16abd252d63bbf27d0f77c91adb4,1,Xi Wang,2015-04-21 17:38:54-07:00,['f24531d1bbab130fc89b09720c536f3c345bd038'],22,32,54,20397835,5,,,,19671
375266ddc3aeed0ba849a87386b5b2166732f294,1,Jayush Luniya,2015-04-21 18:20:05-07:00,['55c0f792f76e16abd252d63bbf27d0f77c91adb4'],62,2,64,20397899,2,1,0,0,19671
1a02c9cce64124bb8994aa9fa8b1699a2d2c468f,1,Srimanth Gunturi,2015-04-21 19:56:08-07:00,['375266ddc3aeed0ba849a87386b5b2166732f294'],50,88,138,20398037,7,0,0.857142857,0.857142857,19671
048c158400ae06185b09dbafffd487f9ff5cc8fd,1,Sumit Mohanty,2015-04-21 20:16:09-07:00,['1a02c9cce64124bb8994aa9fa8b1699a2d2c468f'],45,1041,1086,20399123,43,0.281690141,0.746478873,0.507042254,19672
55d06c3d7a8fd6c3b03d2b1332d6d96e2aeba986,0,Jonathan Hurley,2015-04-22 00:05:17-04:00,['048c158400ae06185b09dbafffd487f9ff5cc8fd'],1,29,30,20399153,1,,,,19672
5ff0c867447a311fd94ef605441215212c04b8d0,1,aBabiichuk,2015-04-22 08:36:06+03:00,['55d06c3d7a8fd6c3b03d2b1332d6d96e2aeba986'],3,96,99,20399252,3,1,1,1,19672
0678ca10ea3a0042c6714951cb87f32ebf2583f2,1,aBabiichuk,2015-04-22 12:06:37+03:00,['5ff0c867447a311fd94ef605441215212c04b8d0'],148,375,523,20399775,4,0.565217391,0.608695652,1,19672
99a9f0696e5c034f92aa43bc4c904e8a04c24c5d,1,aBabiichuk,2015-04-22 13:17:54+03:00,['0678ca10ea3a0042c6714951cb87f32ebf2583f2'],5,3,8,20399783,1,0,0,0,19672
24672f0ffa9be2d41210b17a5c1b261ae418f2e3,1,Andrii Tkach,2015-04-22 13:44:47+03:00,['99a9f0696e5c034f92aa43bc4c904e8a04c24c5d'],30,608,638,20400421,18,0.651376147,1,0.972477064,19676
1ff5182eef64b2861e1742dc38dbd8d6c2d3f671,0,Andrii Tkach,2015-04-22 13:44:48+03:00,['24672f0ffa9be2d41210b17a5c1b261ae418f2e3'],6,2,8,20400429,2,0,0,0,19676
1da29560de193d3189edb4d4200f7c0a8eb98928,1,Oleg Nechiporenko,2015-04-22 13:53:21+03:00,['1ff5182eef64b2861e1742dc38dbd8d6c2d3f671'],6,93,99,20400528,2,0.590163934,1,1,19676
831b2d4da502609c003809cfdc2a3478510f13c4,0,Oleg Nechiporenko,2015-04-22 14:20:04+03:00,['1da29560de193d3189edb4d4200f7c0a8eb98928'],6,6,12,20400540,1,,,,19676
f59e5af5a22d380aa715650c19f7eaa1848ca0bf,1,aBabiichuk,2015-04-22 14:51:33+03:00,['831b2d4da502609c003809cfdc2a3478510f13c4'],2,40,42,20400582,2,1,0.222222222,1,19676
3bc8fc43766f4a5db480060e3d545c7ab0f2d7fd,1,aBabiichuk,2015-04-22 15:12:44+03:00,['f59e5af5a22d380aa715650c19f7eaa1848ca0bf'],4,14,18,20400600,2,0.857142857,1,1,19676
d539ffbb27dc652d403aae6611e097aec3190f00,1,aBabiichuk,2015-04-22 15:32:30+03:00,['3bc8fc43766f4a5db480060e3d545c7ab0f2d7fd'],10,41,51,20400651,5,0.285714286,0.571428571,1,19676
718d879ecb26b2a4e643b09e33b8caeec7bc3ebc,0,Lisnichenko Dmitro,2015-04-22 16:07:35+03:00,['d539ffbb27dc652d403aae6611e097aec3190f00'],1,1,2,20400653,1,,,,19676
f23f12618223d556a79c24fc061d21c95b821b52,1,Nate Cole,2015-04-22 09:41:49-04:00,['718d879ecb26b2a4e643b09e33b8caeec7bc3ebc'],49,461,510,20401163,8,0,0.227272727,0.654545455,19677
6ea66b63ebae3b4fa71a6741893fd14ee7d592db,1,Andrew Onishuk,2015-04-22 17:26:10+03:00,['f23f12618223d556a79c24fc061d21c95b821b52'],3,29,32,20401195,3,0,0.846153846,0,19677
7c55d5b54c6fcbf656fe5bb61d56181fcf360de8,1,Andrii Tkach,2015-04-22 17:35:05+03:00,['6ea66b63ebae3b4fa71a6741893fd14ee7d592db'],226,107,333,20401528,5,0.360655738,0.524590164,0,19677
511b744161ea528a8c16729202eb05da4e3715ee,1,Jonathan Hurley,2015-04-22 10:38:34-04:00,['7c55d5b54c6fcbf656fe5bb61d56181fcf360de8'],134,381,515,20402043,9,0.639534884,0.906976744,0.651162791,19678
aa0f6bf9921200a67044645fa288b8a97e9a0afe,1,Alex Antonenko,2015-04-22 17:59:19+03:00,['511b744161ea528a8c16729202eb05da4e3715ee'],1,1,2,20402045,1,,,,19678
502d40b02a63304c77201d9804d892675156ff87,1,Aleksandr Kovalenko,2015-04-22 18:02:35+03:00,['aa0f6bf9921200a67044645fa288b8a97e9a0afe'],2,58,60,20402105,4,1,1,1,19678
2d683330e02120d1dc965b6cef3108061f533c25,1,Srimanth Gunturi,2015-04-22 09:25:34-07:00,['502d40b02a63304c77201d9804d892675156ff87'],0,6,6,20402111,1,,,,19678
043ce9da58d4678c009a225a59845569a3e5ca2e,0,Aleksandr Kovalenko,2015-04-22 19:53:13+03:00,['2d683330e02120d1dc965b6cef3108061f533c25'],2,2,4,20402115,1,,,,19678
ff90c33ba6e6b2f0df21e6932b6a4b0a2caa2007,0,Lisnichenko Dmitro,2015-04-22 20:41:21+03:00,['043ce9da58d4678c009a225a59845569a3e5ca2e'],0,30,30,20402145,3,,,,19678
fb87f8d291836e7465878ac29cadbd874310d6a5,1,Alex Antonenko,2015-04-22 21:06:49+03:00,['ff90c33ba6e6b2f0df21e6932b6a4b0a2caa2007'],14,24,38,20402183,2,0,1,0,19678
b1196605ee95560cbda723bdcb3590d84bd434ed,0,Sumit Mohanty,2015-04-22 11:38:42-07:00,['fb87f8d291836e7465878ac29cadbd874310d6a5'],49,119,168,20402351,9,0,0.980392157,0.254901961,19678
606ac375a5ed6f4a8e090306b93c47d3789e6c8e,1,Sumit Mohanty,2015-04-22 12:30:04-07:00,['b1196605ee95560cbda723bdcb3590d84bd434ed'],18,23,41,20402392,1,,,,19678
a93a31265d7ba8799b911a015697415860651bfd,0,Sumit Mohanty,2015-04-22 13:12:49-07:00,['606ac375a5ed6f4a8e090306b93c47d3789e6c8e'],119,49,168,20402560,9,1,0.019607843,0.745098039,19678
9639005f6464117195632d57d4cfbcb9e12e7ed1,1,Jaimin Jetly,2015-04-22 13:48:18-07:00,['a93a31265d7ba8799b911a015697415860651bfd'],2369,968,3337,20405897,63,0.699367089,0,0.007383966,19684
e4976458fcbefb92f0192a044176356b2637a8af,1,Sumit Mohanty,2015-04-22 14:22:16-07:00,['9639005f6464117195632d57d4cfbcb9e12e7ed1'],50,120,170,20406067,9,0,0.980392157,0.254901961,19684
387ca9df4a90d2d28467631dfd565c17324484d2,1,Nate Cole,2015-04-22 19:28:39-04:00,['e4976458fcbefb92f0192a044176356b2637a8af'],19,27,46,20406113,3,0,0.333333333,1,19684
1aea1d69a4ad546c9bb22f9ec3e0b60ed5efbf32,0,Xi Wang,2015-04-22 18:52:17-07:00,['387ca9df4a90d2d28467631dfd565c17324484d2'],81,92,173,20406286,1,,,,19684
dc92b6d6b58f3fba20c0485ee61435d14673129c,1,Xi Wang,2015-04-22 18:52:17-07:00,['1aea1d69a4ad546c9bb22f9ec3e0b60ed5efbf32'],4,22,26,20406312,4,1,0,1,19684
cc76c39dd0b1ecc8ffbf7220e8ff1986a99525e6,1,Jonathan Hurley,2015-04-22 22:25:37-04:00,['dc92b6d6b58f3fba20c0485ee61435d14673129c'],237,426,663,20406975,12,0,0.747572816,0.834951456,19684
4a9e9bd4ad8fd33ae7bc2af068280ed0d69bbda6,1,Srimanth Gunturi,2015-04-22 19:53:38-07:00,['cc76c39dd0b1ecc8ffbf7220e8ff1986a99525e6'],5,6,11,20406986,5,1,1,1,19684
245b59972a12d7ba6986e2c5c245d76f7aef09d9,1,aBabiichuk,2015-04-23 12:20:18+03:00,['4a9e9bd4ad8fd33ae7bc2af068280ed0d69bbda6'],14,31,45,20407031,5,0.6,1,1,19684
a0d3b5e865950f6f47914b69afcedf614587ca4b,1,aBabiichuk,2015-04-23 13:09:59+03:00,['245b59972a12d7ba6986e2c5c245d76f7aef09d9'],4,111,115,20407146,3,,,0,19684
dcfe0d46233e2c4ef498c4646976a2e59860ddc8,1,aBabiichuk,2015-04-23 13:21:39+03:00,['a0d3b5e865950f6f47914b69afcedf614587ca4b'],46,74,120,20407266,11,0,0,0,19684
8d8b5280df608f8e218b7195880364097fa1d189,1,Andrew Onishuk,2015-04-23 13:55:43+03:00,['dcfe0d46233e2c4ef498c4646976a2e59860ddc8'],231,480,711,20407977,12,0.965909091,0.681818182,0.068181818,19684
ec5de27122290f3a37f15800d1f606d005b9f0bd,1,aBabiichuk,2015-04-23 14:19:56+03:00,['8d8b5280df608f8e218b7195880364097fa1d189'],120,33,153,20408130,3,0,0,1,19684
d3aada22d2c010a4117dcae70b8bd649396d9d3e,1,Andrii Tkach,2015-04-23 14:39:11+03:00,['ec5de27122290f3a37f15800d1f606d005b9f0bd'],26,18,44,20408174,4,0,0,0,19684
7e44537bd9e7d84cb458d20bbf5e948f545dd1f3,1,Andrew Onishuk,2015-04-23 15:24:48+03:00,['d3aada22d2c010a4117dcae70b8bd649396d9d3e'],418,685,1103,20409277,18,0.973684211,0.728070175,0.228070175,19684
ce98754d5057fbcbe601c9a7aab4727d3b6169fc,1,aBabiichuk,2015-04-23 15:26:29+03:00,['7e44537bd9e7d84cb458d20bbf5e948f545dd1f3'],36,70,106,20409383,5,0,0.642857143,1,19684
e585d23917c84ab01ee1033fb52e861fe47ff362,1,aBabiichuk,2015-04-23 16:25:24+03:00,['ce98754d5057fbcbe601c9a7aab4727d3b6169fc'],12,22,34,20409417,10,1,1,1,19684
c7df7bd0b977af5490bd9b60bad5fa78f8dadc2f,0,Sumit Mohanty,2015-04-23 06:48:50-07:00,['e585d23917c84ab01ee1033fb52e861fe47ff362'],1,1,2,20409419,1,,,,19684
e5fb8d72c0b7a3aae5e36ebdb17a94bfb8587425,0,Andrii Tkach,2015-04-23 16:58:55+03:00,['c7df7bd0b977af5490bd9b60bad5fa78f8dadc2f'],5,1,6,20409425,2,1,1,1,19684
b4d7b388b289cac955171914e8066152633ae0a5,1,Lisnichenko Dmitro,2015-04-23 17:04:57+03:00,['e5fb8d72c0b7a3aae5e36ebdb17a94bfb8587425'],34,39,73,20409498,2,0,1,1,19684
7113ce22801baef6626ad49358a3d014064be6c4,0,Billie Rinaldi,2015-04-23 07:49:25-07:00,['b4d7b388b289cac955171914e8066152633ae0a5'],2,46,48,20409546,3,0.266666667,0.266666667,1,19685
14436286b425c2b83ba9afa57cded39319abbef8,1,Alex Antonenko,2015-04-23 18:04:48+03:00,['7113ce22801baef6626ad49358a3d014064be6c4'],83,206,289,20409835,3,0.951807229,1,1,19685
f333a78c0134b1b059b2ad137ca917a38be6f062,1,Alex Antonenko,2015-04-23 18:04:49+03:00,['14436286b425c2b83ba9afa57cded39319abbef8'],4,4,8,20409843,1,,,,19685
5ab5f3f779620865bbf245f7a69b41b7d790c425,1,Alex Antonenko,2015-04-23 18:04:49+03:00,['f333a78c0134b1b059b2ad137ca917a38be6f062'],40,80,120,20409963,8,0.378378378,1,1,19685
571c192643e4abba6a9b4eaa00888f53626c8e08,0,Alex Antonenko,2015-04-23 18:04:49+03:00,['5ab5f3f779620865bbf245f7a69b41b7d790c425'],1,0,1,20409964,1,,,,19685
ee3bfa112e02e147e595e0eddb5eb44c38010b8c,1,Alex Antonenko,2015-04-23 18:04:49+03:00,['571c192643e4abba6a9b4eaa00888f53626c8e08'],0,1017,1017,20410981,3,0.644400786,1,1,19685
5a71e013db7ae396d347bfab7cd2d846dd54a004,1,Oleg Nechiporenko,2015-04-23 18:21:23+03:00,['ee3bfa112e02e147e595e0eddb5eb44c38010b8c'],56,146,202,20411183,5,0.08,1,0.96,19686
64cae309c91d3d4b82b4ca1eaa758dae78123680,1,Oleg Nechiporenko,2015-04-23 18:29:26+03:00,['5a71e013db7ae396d347bfab7cd2d846dd54a004'],11,43,54,20411237,4,1,1,1,19686
c902a32b11ad38ed4839720f410397d26b88312c,1,Vitaly Brodetskyi,2015-04-21 01:58:15+03:00,['64cae309c91d3d4b82b4ca1eaa758dae78123680'],0,978,978,20412215,2,,,,19688
8779baea98e546fa120f8bc9c3eec367c7ba6423,0,Andrew Onishuk,2015-04-23 19:59:15+03:00,['c902a32b11ad38ed4839720f410397d26b88312c'],4,7,11,20412226,1,0,0,1,19688
6fb7ee357210d69e48f072b6f12ea3a71d7f75cd,1,Sumit Mohanty,2015-04-23 10:06:06-07:00,['8779baea98e546fa120f8bc9c3eec367c7ba6423'],3,3,6,20412232,1,,,,19688
e8e7c827d33bea75bb3fdfd99dbcd5ca25f2d61a,1,Andrew Onishuk,2015-04-23 20:13:31+03:00,['6fb7ee357210d69e48f072b6f12ea3a71d7f75cd'],7,4,11,20412243,1,1,1,0,19688
727b76f0f8e5b7bf8f965adb531b0c08950834b3,1,Bob Nettleton,2015-04-23 13:37:56-04:00,['e8e7c827d33bea75bb3fdfd99dbcd5ca25f2d61a'],16,523,539,20412782,3,0.070422535,0.830985915,0.813380282,19688
2f25e3b1298391dcff9d5145a7ff8b039e6e58bb,1,Sumit Mohanty,2015-04-23 11:17:47-07:00,['727b76f0f8e5b7bf8f965adb531b0c08950834b3'],0,57,57,20412839,5,,,,19689
d3f08c97e8de468e4405621d88d5e76fea169cab,1,Xi Wang,2015-04-23 11:23:31-07:00,['2f25e3b1298391dcff9d5145a7ff8b039e6e58bb'],11,28,39,20412878,2,,,,19689
638862c6d4cd488d8047026ba6ddf284e85a426c,0,Xi Wang,2015-04-23 11:23:31-07:00,['d3f08c97e8de468e4405621d88d5e76fea169cab'],2,1,3,20412881,1,,,,19689
a2c86f2a20a82fb78f07b4107bbac7ee40d94529,1,Siddharth Wagle,2015-04-23 11:34:34-07:00,['638862c6d4cd488d8047026ba6ddf284e85a426c'],0,41,41,20412922,1,0,0,1,19689
9d46a9837da6dc5674880772c54367e539fe3963,1,Dmytro Sen,2015-04-23 21:35:36+03:00,['a2c86f2a20a82fb78f07b4107bbac7ee40d94529'],3,82,85,20413007,4,0.069444444,0.694444444,0.680555556,19689
a3cf2d39ef6cde2bb13ecbb6b252d033969ed48d,1,Lisnichenko Dmitro,2015-04-23 22:04:07+03:00,['9d46a9837da6dc5674880772c54367e539fe3963'],9,142,151,20413158,11,0.798319328,1,0.957983193,19689
8adb1b0bfa5bc1e4be54529aa05b6563cab06ac6,1,Srimanth Gunturi,2015-04-23 12:48:35-07:00,['a3cf2d39ef6cde2bb13ecbb6b252d033969ed48d'],0,22,22,20413180,1,,,,19689
d8bff0381cf307672652bb402292f91465783670,1,Srimanth Gunturi,2015-04-23 13:39:33-07:00,['8adb1b0bfa5bc1e4be54529aa05b6563cab06ac6'],918,2057,2975,20416155,24,0.67699115,0.829646018,0.986725664,19703
aa3bd6e2b4e19182cc99d870c0f30648738e16b6,1,Nate Cole,2015-04-23 16:45:53-04:00,['d8bff0381cf307672652bb402292f91465783670'],44,126,170,20416325,6,0.0625,0,0,19703
d951909c1c491a23952ab505cd4812ee3f1f9669,0,Siddharth Wagle,2015-04-23 13:49:17-07:00,['aa3bd6e2b4e19182cc99d870c0f30648738e16b6'],1,1,2,20416327,1,,,,19703
0730247ee4396bce0aa2fbb6bdb9f19287405d7d,1,Siddharth Wagle,2015-04-23 14:19:28-07:00,['d951909c1c491a23952ab505cd4812ee3f1f9669'],6701,2406,9107,20425434,1,,,,19703
1256d0e366f90be7219757b73acd25684b2a5b6b,1,Srimanth Gunturi,2015-04-23 15:41:38-07:00,['0730247ee4396bce0aa2fbb6bdb9f19287405d7d'],40,40,80,20425514,1,,,,19703
909677516ac97191646dfe081763dbfe7cb46e78,1,Srimanth Gunturi,2015-04-23 16:08:23-07:00,['1256d0e366f90be7219757b73acd25684b2a5b6b'],3,20,23,20425537,1,1,1,1,19703
290276c62152f331e0859c1d81534cc160471327,1,Alejandro Fernandez,2015-04-23 16:16:30-07:00,['909677516ac97191646dfe081763dbfe7cb46e78'],625,867,1492,20427029,39,0.43030303,0.575757576,0.83030303,19703
194e160e2014965cc11d216a18aec58834eae9ef,1,Xi Wang,2015-04-23 18:47:01-07:00,['290276c62152f331e0859c1d81534cc160471327'],99,75,174,20427203,4,0,0,0,19703
da10b23eb3574ff1eb7cff84520d3b0be5483bac,1,Jayush Luniya,2015-04-23 19:11:40-07:00,['194e160e2014965cc11d216a18aec58834eae9ef'],1,103,104,20427307,4,,,,19704
bc85c29e6cb5af051cd8cd8d2f2456848114104b,1,Jaimin Jetly,2015-04-23 19:56:14-07:00,['da10b23eb3574ff1eb7cff84520d3b0be5483bac'],10,26,36,20427343,4,0,0.2,1,19704
14cbdabe7232bd2d020824a1bbed1f6f905a458b,1,Jayush Luniya,2015-04-23 22:56:32-07:00,['bc85c29e6cb5af051cd8cd8d2f2456848114104b'],37,16,53,20427396,32,,,,19704
3f06d298d9ea5d862c500b8a6549ce5bb5267ffa,0,Andrii Tkach,2015-04-24 12:00:49+03:00,['14cbdabe7232bd2d020824a1bbed1f6f905a458b'],2,2,4,20427400,1,,,,19704
6553e6a1907dc72eb3c92f674b219d618bd81b50,1,Oleg Nechiporenko,2015-04-24 12:52:40+03:00,['3f06d298d9ea5d862c500b8a6549ce5bb5267ffa'],0,10,10,20427410,1,,,,19704
3e30ca2677916333cdef282bcfda82c04e3b3753,0,Andrew Onishuk,2015-04-24 12:58:38+03:00,['6553e6a1907dc72eb3c92f674b219d618bd81b50'],6,11,17,20427427,2,0,0.333333333,1,19704
27266f57d6462730e49b7725d860558bba2d38a0,1,Oleg Nechiporenko,2015-04-24 14:14:49+03:00,['3e30ca2677916333cdef282bcfda82c04e3b3753'],15,108,123,20427550,4,1,1,1,19704
08e957c2e1baac3a715d7c66eb7e0b69a70a59ed,1,Andrii Tkach,2015-04-24 15:11:36+03:00,['27266f57d6462730e49b7725d860558bba2d38a0'],15,27,42,20427592,6,1,1,1,19704
e4c9e53a36f5182f2fa64064bc11703f28ec69d5,0,Dmytro Sen,2015-04-24 15:29:20+03:00,['08e957c2e1baac3a715d7c66eb7e0b69a70a59ed'],6,127,133,20427725,2,0,0.991525424,1,19704
e8771915387015c3e57f5f5d3e71d7fb29380ca2,1,Oleg Nechiporenko,2015-04-24 15:59:26+03:00,['e4c9e53a36f5182f2fa64064bc11703f28ec69d5'],14,24,38,20427763,2,1,1,1,19704
df35cf8c06645f25aa0af69ea7cd39a631f50b0a,1,Andrew Onishuk,2015-04-24 16:09:52+03:00,['e8771915387015c3e57f5f5d3e71d7fb29380ca2'],1,67,68,20427831,2,1,1,0.538461538,19704
b9532f1c0c79a97f9498813f8cdcf045f1741a51,0,Dmytro Sen,2015-04-24 16:11:11+03:00,['df35cf8c06645f25aa0af69ea7cd39a631f50b0a'],0,12,12,20427843,2,0,1,0.833333333,19704
52b5022bc58906a3579d291b078d5a49b240ce6e,0,Robert Levas,2015-04-24 10:01:03-04:00,['b9532f1c0c79a97f9498813f8cdcf045f1741a51'],4,222,226,20428069,6,0.107142857,0.797619048,0.303571429,19704
bdb46fec104a53c25f5476cdf409303c62b97540,1,Andrew Onishuk,2015-04-24 17:45:48+03:00,['52b5022bc58906a3579d291b078d5a49b240ce6e'],2,2,4,20428073,2,,,,19704
b971804e5d0d479aa180d0921a42834e2b4f1efa,1,Robert Levas,2015-04-24 11:10:53-04:00,['bdb46fec104a53c25f5476cdf409303c62b97540'],222,4,226,20428299,6,0.892857143,0.202380952,0.696428571,19704
239d3ac7541ab3642c1031191e4bbafd5fd9a9e6,1,Robert Levas,2015-04-24 11:12:38-04:00,['b971804e5d0d479aa180d0921a42834e2b4f1efa'],4,613,617,20428916,7,0.107142857,0.797619048,0.303571429,19705
b034bab2f68e16d3ffe3d184dd38461bfe71cd2c,1,Vitaly Brodetskyi,2015-04-21 06:01:47+03:00,['239d3ac7541ab3642c1031191e4bbafd5fd9a9e6'],30,68,98,20429014,4,1,0,1,19705
ae4118c960a983c577bb2e11e2d5cfd264cc1032,1,Robert Levas,2015-04-24 12:05:35-04:00,['b034bab2f68e16d3ffe3d184dd38461bfe71cd2c'],256,311,567,20429581,7,0.181818182,0.977272727,0.840909091,19705
eae822fa04452e9a6f4e9206473b02690525e5e3,0,Artem Baranchuk,2015-04-24 19:59:44+03:00,['ae4118c960a983c577bb2e11e2d5cfd264cc1032'],4,10,14,20429595,2,,,,19705
43c8cd496c8521f32f2bdebef296f54b37061ce7,1,Artem Baranchuk,2015-04-24 20:01:42+03:00,['eae822fa04452e9a6f4e9206473b02690525e5e3'],3,10,13,20429608,6,1,1,1,19705
00ea696531fe15435c81b05eae66e0de442c1c2b,1,Artem Baranchuk,2015-04-24 20:04:00+03:00,['43c8cd496c8521f32f2bdebef296f54b37061ce7'],6,11,17,20429625,3,0.4,0.4,0,19705
4bd764ed70d7b0b1ce5102cbf521fee0f27022ca,1,Srimanth Gunturi,2015-04-24 10:42:54-07:00,['00ea696531fe15435c81b05eae66e0de442c1c2b'],49,733,782,20430407,28,0.601398601,0.923076923,0.867132867,19712
673a2d080825976290c787104335ce4e60dad8c7,1,Jayush Luniya,2015-04-24 10:52:02-07:00,['4bd764ed70d7b0b1ce5102cbf521fee0f27022ca'],0,12,12,20430419,1,,,,19712
0dd08215681dce64b67314dac03b590e5662ce0d,1,Alejandro Fernandez,2015-04-24 11:38:55-07:00,['673a2d080825976290c787104335ce4e60dad8c7'],170,198,368,20430787,15,0,0,0.771929825,19712
3e776a51165cd56cd59dee02236ed88e3825c10a,1,Myroslav Papirkovskyy,2015-04-24 22:00:54+03:00,['0dd08215681dce64b67314dac03b590e5662ce0d'],5,12,17,20430804,5,0.75,0.75,1,19712
00cd61a9fcde78e0dc8eedeb77b67afa34771245,1,Myroslav Papirkovskyy,2015-04-24 22:00:54+03:00,['3e776a51165cd56cd59dee02236ed88e3825c10a'],1,1,2,20430806,1,,,,19712
f9d488b4868dc40e30d76192e9c2d27732160da3,0,Myroslav Papirkovskyy,2015-04-24 22:00:54+03:00,['00cd61a9fcde78e0dc8eedeb77b67afa34771245'],3,3,6,20430812,1,,,,19712
3b9073e4630dbb297e96056c0cfd6d892e2d38ab,0,Alejandro Fernandez,2015-04-24 13:34:29-07:00,['f9d488b4868dc40e30d76192e9c2d27732160da3'],1,1,2,20430814,1,,,,19712
ac96799834cbc500d42160c64be8db269af3bcc1,0,Srimanth Gunturi,2015-04-24 14:17:40-07:00,['3b9073e4630dbb297e96056c0cfd6d892e2d38ab'],46,63,109,20430923,2,0,1,1,19712
c06571f0efa228c161f8abd44de37c388a6ddf8b,1,Alejandro Fernandez,2015-04-24 15:13:34-07:00,['ac96799834cbc500d42160c64be8db269af3bcc1'],1,1,2,20430925,1,,,,19712
ac6fd63f95a38130ef707a5b872c0c51ec23573d,1,Jonathan Hurley,2015-04-24 19:01:10-04:00,['c06571f0efa228c161f8abd44de37c388a6ddf8b'],201,956,1157,20432082,13,0.372654155,0.627345845,0.603217158,19712
ed3e8ca4844112415377408259c1902557380ea3,0,Alejandro Fernandez,2015-04-24 16:58:00-07:00,['ac6fd63f95a38130ef707a5b872c0c51ec23573d'],1,11,12,20432094,2,,,,19712
27eae30ddb849a65dd7f660bd5fd5c8e30e8941d,1,Xi Wang,2015-04-24 17:13:25-07:00,['ed3e8ca4844112415377408259c1902557380ea3'],13,90,103,20432197,4,,,,19712
682d82eef2e1229f4aaf9cd217c27c4c857d37fe,1,Nate Cole,2015-04-24 21:17:14-04:00,['27eae30ddb849a65dd7f660bd5fd5c8e30e8941d'],17,333,350,20432547,5,0.103703704,0.607407407,0.977777778,19713
36ab07ca6f786c8cc2c8dc8b28bd831b917322f4,1,Jaimin Jetly,2015-04-25 09:36:44-07:00,['682d82eef2e1229f4aaf9cd217c27c4c857d37fe'],164,1479,1643,20434190,22,1,1,1,19724
6aa96902f841993b818f46aea1b63bb9697c5496,1,Srimanth Gunturi,2015-04-25 10:28:27-07:00,['36ab07ca6f786c8cc2c8dc8b28bd831b917322f4'],13,36,49,20434239,14,1,1,1,19724
6f67c4f664846e6372cccdfbb64c0b66d0b03853,1,Srimanth Gunturi,2015-04-25 13:12:15-07:00,['6aa96902f841993b818f46aea1b63bb9697c5496'],62,106,168,20434407,5,1,1,1,19724
c9f0dd0b8206956a7a71fa0adca64160710d2910,1,John Speidel,2015-04-27 01:51:01-04:00,['6f67c4f664846e6372cccdfbb64c0b66d0b03853'],10499,13113,23612,20458019,83,1,1,0.075067024,19761
623929f58e40a04429d696879205a955f7cceb41,1,Srimanth Gunturi,2015-04-26 23:26:39-07:00,['c9f0dd0b8206956a7a71fa0adca64160710d2910'],140,159,299,20458318,10,0.282608696,0.739130435,0.739130435,19761
9077a9d3044302860d543907e23542c25603f79f,1,aBabiichuk,2015-04-27 11:50:08+03:00,['623929f58e40a04429d696879205a955f7cceb41'],11,80,91,20458409,3,0.451612903,1,1,19761
efb92354748c29a13f8dbcd7ca12e092ee42f013,1,Andrii Tkach,2015-04-27 12:25:52+03:00,['9077a9d3044302860d543907e23542c25603f79f'],4,270,274,20458683,7,0.521327014,1,1,19763
fdf2e2ab13a1ce9724f26dcaa9c16adb20982dcc,1,Oleg Nechiporenko,2015-04-27 12:47:43+03:00,['efb92354748c29a13f8dbcd7ca12e092ee42f013'],75,132,207,20458890,4,0.873015873,0,0,19763
85e595b149e21002d3e3abbe0e234e983bda2713,0,Oleg Nechiporenko,2015-04-27 13:20:42+03:00,['fdf2e2ab13a1ce9724f26dcaa9c16adb20982dcc'],2,2,4,20458894,1,,0,,19763
ebea5413f93eb63e545d12fffd7f8cc1c3a1191b,1,aBabiichuk,2015-04-27 13:45:36+03:00,['85e595b149e21002d3e3abbe0e234e983bda2713'],3,4,7,20458901,3,,,,19763
57ba7014abcecca9c766253545104640ce77202e,1,Oleg Nechiporenko,2015-04-27 15:33:11+03:00,['ebea5413f93eb63e545d12fffd7f8cc1c3a1191b'],8,26,34,20458935,7,0.8125,1,0,19763
43e792cfc710f0f699b854771090cb11e20abc31,1,Lisnichenko Dmitro,2015-04-27 15:40:30+03:00,['57ba7014abcecca9c766253545104640ce77202e'],1,6,7,20458942,1,0,0,1,19763
4bef8d076399cc42eadb4374d01868c16b2bb6fd,1,Andrew Onishuk,2015-04-27 16:24:18+03:00,['43e792cfc710f0f699b854771090cb11e20abc31'],29,59,88,20459030,2,,,,19764
289a1447487b49cdc1f6a03ef8a01d9eb0e6c735,0,Andrew Onishuk,2015-04-27 16:36:53+03:00,['4bef8d076399cc42eadb4374d01868c16b2bb6fd'],0,18,18,20459048,1,,,,19764
21d911316e56af1c91641af8ab648dd9cb3beb2a,1,aBabiichuk,2015-04-27 17:37:28+03:00,['289a1447487b49cdc1f6a03ef8a01d9eb0e6c735'],14,54,68,20459116,3,1,1,1,19764
76348013473e9b4c9ebe2e1bb5ebb5dd9ed07e87,1,Oleg Nechiporenko,2015-04-27 18:22:20+03:00,['21d911316e56af1c91641af8ab648dd9cb3beb2a'],6,7,13,20459129,3,1,0,1,19764
71f72903430949a4b153846ee448be24e1e9b98d,1,tbeerbower,2015-04-27 11:44:49-04:00,['76348013473e9b4c9ebe2e1bb5ebb5dd9ed07e87'],397,302,699,20459828,13,1,0.392857143,0.964285714,19766
e9430b16f5643a86e701559429432152146963ca,1,Aleksandr Kovalenko,2015-04-27 19:16:29+03:00,['71f72903430949a4b153846ee448be24e1e9b98d'],481,262,743,20460571,31,0,0,0,19766
4bad90667bb9d41faf61456be6e6fa4215ff6be2,1,Aleksandr Kovalenko,2015-04-27 19:16:29+03:00,['e9430b16f5643a86e701559429432152146963ca'],8,42,50,20460621,2,1,1,1,19766
52705c2668d29dcec126e0c60a6b457250355084,1,aBabiichuk,2015-04-27 19:20:13+03:00,['4bad90667bb9d41faf61456be6e6fa4215ff6be2'],3,5,8,20460629,2,1,0,1,19766
f13d983dd0d27ce1c9e25447c9eea11ea72eceff,1,Andrew Onishuk,2015-04-27 20:12:19+03:00,['52705c2668d29dcec126e0c60a6b457250355084'],385,506,891,20461520,18,1,0.610687023,0,19767
e8f315cea72f95a8de5011eefd6c298cf47b14c5,1,Andrew Onishuk,2015-04-27 20:24:32+03:00,['f13d983dd0d27ce1c9e25447c9eea11ea72eceff'],6,81,87,20461607,4,,,,19768
1c46571f95bf0c2034163349a58b6417d0271984,1,Andrii Tkach,2015-04-27 20:54:24+03:00,['e8f315cea72f95a8de5011eefd6c298cf47b14c5'],4,62,66,20461673,4,1,1,1,19768
6d737ddc6daa9cae302fe79c4063cf1a0a975d6f,1,tbeerbower,2015-04-27 14:19:08-04:00,['1c46571f95bf0c2034163349a58b6417d0271984'],0,455,455,20462128,8,1,1,1,19775
3a42dfa7719bb213547ca78b4d3a48fff16e787a,1,Alejandro Fernandez,2015-04-27 11:32:50-07:00,['6d737ddc6daa9cae302fe79c4063cf1a0a975d6f'],5,5,10,20462138,5,,,,19775
fa6194265f8ae0ba98806b50f88497bf659cdead,1,John Speidel,2015-04-27 15:09:21-04:00,['3a42dfa7719bb213547ca78b4d3a48fff16e787a'],15,137,152,20462290,2,0.446808511,1,1,19776
14395f9b4ad3720804505922304734537070cf4a,1,Srimanth Gunturi,2015-04-27 12:35:09-07:00,['fa6194265f8ae0ba98806b50f88497bf659cdead'],0,6,6,20462296,2,,,,19776
ea080a25966e5b18cd31a9c52bfd669d0dbae6b2,0,Jonathan Hurley,2015-04-27 15:38:16-04:00,['14395f9b4ad3720804505922304734537070cf4a'],2,2,4,20462300,2,,,,19776
35a99761ef38c13054c677fe7156f56ed47d4931,0,Srimanth Gunturi,2015-04-27 12:40:24-07:00,['ea080a25966e5b18cd31a9c52bfd669d0dbae6b2'],4,1,5,20462305,1,,,,19776
6a054b35a3a4034788d83455a124d9ece0d72811,1,Siddharth Wagle,2015-04-27 16:17:21-07:00,['35a99761ef38c13054c677fe7156f56ed47d4931'],1290,177,1467,20463772,6,0.253333333,0.973333333,0.866666667,19777
5e2f6b85a25e7a87fee7054c71289c6cebd8d4b7,0,Artem Baranchuk,2015-04-28 02:27:03+03:00,['6a054b35a3a4034788d83455a124d9ece0d72811'],2,2,4,20463776,1,,,,19777
930b3e4ee567006d2611d1dcb4a694726e984899,1,Artem Baranchuk,2015-04-28 02:27:04+03:00,['5e2f6b85a25e7a87fee7054c71289c6cebd8d4b7'],1,17,18,20463794,3,,,,19777
eb31a92a5a9906587befcab2c3249e4c99618f19,1,Jaimin Jetly,2015-04-28 00:19:37-07:00,['930b3e4ee567006d2611d1dcb4a694726e984899'],11,83,94,20463888,9,0.857142857,0.952380952,0.904761905,19777
673980a06887e66a41dd820fe69e21b878412414,0,Andrew Onishuk,2015-04-28 10:33:57+03:00,['eb31a92a5a9906587befcab2c3249e4c99618f19'],2,20,22,20463910,1,,,,19777
70c66cbd8c54876a795c7a05a1fce15f75f103ca,1,Srimanth Gunturi,2015-04-28 01:23:38-07:00,['673980a06887e66a41dd820fe69e21b878412414'],0,172,172,20464082,6,0,0.646153846,0.646153846,19777
f00c0f1422020b38877756e3564cff91b1c055f0,1,Andrii Tkach,2015-04-28 11:59:16+03:00,['70c66cbd8c54876a795c7a05a1fce15f75f103ca'],25,88,113,20464195,8,1,1,1,19777
e1c5d5029ec668c62707b9a40861fdc7f6c2c1d7,1,Andrew Onishuk,2015-04-28 12:54:14+03:00,['f00c0f1422020b38877756e3564cff91b1c055f0'],1,1,2,20464197,1,,,,19777
7b7b66fd12fcaf770b5b29aa91c85e16cefa084a,1,Aleksandr Kovalenko,2015-04-28 13:46:11+03:00,['e1c5d5029ec668c62707b9a40861fdc7f6c2c1d7'],36,36,72,20464269,6,,,,19777
2d917162314487f002610b5e0675380fbc26b66f,0,Andrii Tkach,2015-04-28 14:17:12+03:00,['7b7b66fd12fcaf770b5b29aa91c85e16cefa084a'],0,1,1,20464270,1,1,1,1,19777
9d9c00fcc2da77b46b7bb1fec8b833915bb81da5,1,Andrew Onishuk,2015-04-28 15:49:24+03:00,['2d917162314487f002610b5e0675380fbc26b66f'],498,428,926,20465196,12,1,0.711111111,0.231111111,19777
f254d2e55981a929d0cab476986aee1af6059470,1,Robert Levas,2015-04-28 09:12:23-04:00,['9d9c00fcc2da77b46b7bb1fec8b833915bb81da5'],14,53,67,20465263,4,0,0.447368421,1,19777
5314c6904e1eb5de2f70548ddc2a344e26d3a1b8,1,Lisnichenko Dmitro,2015-04-28 16:42:21+03:00,['f254d2e55981a929d0cab476986aee1af6059470'],86,187,273,20465536,5,0.119402985,0.552238806,0.23880597,19777
bcffb924fa9eafa1a244ad590183145f38650349,0,Vitaly Brodetskyi,2015-04-25 04:54:06+03:00,['5314c6904e1eb5de2f70548ddc2a344e26d3a1b8'],0,3,3,20465539,1,,,,19777
b878091426bc3c36ef5777bbfc0dad72d66112af,1,Oleg Nechiporenko,2015-04-28 17:38:19+03:00,['bcffb924fa9eafa1a244ad590183145f38650349'],0,27,27,20465566,1,1,1,1,19777
0807f65ce06120a4a3d2f182e5bd7f685e461958,0,Vitaly Brodetskyi,2015-04-25 05:38:54+03:00,['b878091426bc3c36ef5777bbfc0dad72d66112af'],0,8,8,20465574,1,,,,19777
7ead84821ce51e8bc6bdaefbea809d92a9bf2998,1,Vitaly Brodetskyi,2015-04-25 05:40:14+03:00,['0807f65ce06120a4a3d2f182e5bd7f685e461958'],0,1,1,20465575,1,,,,19777
cf1e8db9dcba4cdae4e700e584308a527fb536e9,1,Vitaly Brodetskyi,2015-04-25 05:41:23+03:00,['7ead84821ce51e8bc6bdaefbea809d92a9bf2998'],1,6,7,20465582,1,0,0,1,19777
c32f0bff80cc675b89bb4af6b5496521254049e2,1,aBabiichuk,2015-04-28 19:07:44+03:00,['cf1e8db9dcba4cdae4e700e584308a527fb536e9'],0,5,5,20465587,2,1,1,1,19777
39eb618e966f695ac8b368a9cd8293592a8726d1,1,Jonathan Hurley,2015-04-28 12:18:58-04:00,['c32f0bff80cc675b89bb4af6b5496521254049e2'],88,955,1043,20466630,15,0.378737542,0.913621262,0.903654485,19780
bd62bf9a33356216c4d2b386a61c1b24210c2258,1,Vitaly Brodetskyi,2015-04-25 06:34:54+03:00,['39eb618e966f695ac8b368a9cd8293592a8726d1'],27,28,55,20466685,1,1,1,1,19780
f5df2721c71446aa5f1763bb2c23782c280ec582,1,tbeerbower,2015-04-28 12:45:08-04:00,['bd62bf9a33356216c4d2b386a61c1b24210c2258'],12,37,49,20466734,1,1,1,0.333333333,19780
03457b7c62d37c394233bd611943d0d07ba046c1,0,Srimanth Gunturi,2015-04-28 09:56:06-07:00,['f5df2721c71446aa5f1763bb2c23782c280ec582'],1,1,2,20466736,1,,,,19780
92553bd6e01697360c078e6e547ef695e003b202,1,Nate Cole,2015-04-28 13:03:23-04:00,['03457b7c62d37c394233bd611943d0d07ba046c1'],3,4,7,20466743,1,,,,19780
8a1f93d474bff7ca8196f575e65ed0e7c35c835f,1,aBabiichuk,2015-04-28 20:24:45+03:00,['92553bd6e01697360c078e6e547ef695e003b202'],13,180,193,20466936,13,1,0.594594595,1,19781
c404871b54e7b0dfdaada9c46d2aded4b86eef43,1,Srimanth Gunturi,2015-04-28 11:42:54-07:00,['8a1f93d474bff7ca8196f575e65ed0e7c35c835f'],22,8,30,20466966,3,0,0.375,0.375,19781
821b343082691d755082b4bc5c5ae4ecac77dde3,0,Robert Levas,2015-04-28 15:10:27-04:00,['c404871b54e7b0dfdaada9c46d2aded4b86eef43'],1,1,2,20466968,1,,,,19781
a8536dda6d1352f3fbd01fb23786ccd5b5628ae6,1,Nate Cole,2015-04-28 15:24:47-04:00,['821b343082691d755082b4bc5c5ae4ecac77dde3'],53,85,138,20467106,5,0.428571429,0.857142857,0.857142857,19781
c9fdccd9646acc45a71d09959cd1e9000f15a69e,1,Xi Wang,2015-04-28 13:59:02-07:00,['a8536dda6d1352f3fbd01fb23786ccd5b5628ae6'],108,92,200,20467306,12,0,0.75,0,19781
2cf8030e3728005426925417f12f9bca4c8b3b80,1,Srimanth Gunturi,2015-04-28 15:03:25-07:00,['c9fdccd9646acc45a71d09959cd1e9000f15a69e'],1,39,40,20467346,3,0,0.885714286,0.885714286,19781
fcdc218d60476bdb6871979a7579dcf03935ae01,1,Alex Antonenko,2015-04-29 01:30:40+03:00,['2cf8030e3728005426925417f12f9bca4c8b3b80'],45,74,119,20467465,10,1,1,1,19781
d0290c095db04620f10fca7f2365852ae2654158,0,Alex Antonenko,2015-04-29 01:30:40+03:00,['fcdc218d60476bdb6871979a7579dcf03935ae01'],0,1,1,20467466,1,1,1,1,19781
132cf31bc4eb797f708b09c388ce06860d598dd6,1,Srimanth Gunturi,2015-04-28 17:00:37-07:00,['d0290c095db04620f10fca7f2365852ae2654158'],318,82,400,20467866,5,,,,19781
43ae930b0188f22913dcc67ec5c8ea168ff4deae,1,jspeidel,2015-04-28 20:45:13-04:00,['132cf31bc4eb797f708b09c388ce06860d598dd6'],34,142,176,20468042,4,0.157142857,0.542857143,0.442857143,19781
a3a0ae041a43aaa1ffdc8f9247338bb68dd5675f,1,Sumit Mohanty,2015-04-28 17:48:29-07:00,['43ae930b0188f22913dcc67ec5c8ea168ff4deae'],50,454,504,20468546,16,0.211604096,0.498293515,0.880546075,19781
79b269d8e624735921abaffdc37a92cfb63c65d7,1,Srimanth Gunturi,2015-04-28 18:55:54-07:00,['a3a0ae041a43aaa1ffdc8f9247338bb68dd5675f'],6,67,73,20468619,8,1,1,1,19782
69ab430fb8f4d80b6650d7af60946db47626e7aa,1,Sumit Mohanty,2015-04-28 21:03:07-07:00,['79b269d8e624735921abaffdc37a92cfb63c65d7'],14,1,15,20468634,1,1,1,1,19782
47907b96105015979190cc87ace79f643456f959,1,Jaimin Jetly,2015-04-28 21:44:50-07:00,['69ab430fb8f4d80b6650d7af60946db47626e7aa'],253,416,669,20469303,28,1,1,1,19782
98098a89115f6e144e81dbd82a5c443bf7706c7d,1,Srimanth Gunturi,2015-04-28 23:16:35-07:00,['47907b96105015979190cc87ace79f643456f959'],13,79,92,20469395,3,0,0.851851852,0.666666667,19782
06c7233d36cfd7d9f1f4a14a9b62d4b2ebb1692f,0,Srimanth Gunturi,2015-04-28 23:43:56-07:00,['98098a89115f6e144e81dbd82a5c443bf7706c7d'],1,1,2,20469397,1,,,,19782
7be88f62168af949c1d21560e35fc8a47ed27300,1,aBabiichuk,2015-04-29 10:46:51+03:00,['06c7233d36cfd7d9f1f4a14a9b62d4b2ebb1692f'],8,39,47,20469444,3,0.09375,1,0.4375,19782
a39eb7d3bc158844e62d59af620d98740518e12b,1,aBabiichuk,2015-04-29 11:43:06+03:00,['7be88f62168af949c1d21560e35fc8a47ed27300'],18,33,51,20469495,3,1,0,0,19782
1ba28aa47c58566d5dd4605a3608b7c03ee90351,1,Lisnichenko Dmitro,2015-04-29 14:31:25+03:00,['a39eb7d3bc158844e62d59af620d98740518e12b'],1,120,121,20469616,2,,,,19782
798f1072dd1db98a1980f8c245a10b14883235ce,1,Lisnichenko Dmitro,2015-04-29 14:32:19+03:00,['1ba28aa47c58566d5dd4605a3608b7c03ee90351'],1,9,10,20469626,1,1,1,0,19782
11a09c57836e8adb4f69c66231131d68fa37cd7e,1,aBabiichuk,2015-04-29 14:58:52+03:00,['798f1072dd1db98a1980f8c245a10b14883235ce'],1707,1982,3689,20473315,16,1,0.950819672,0,19789
2514cda00537319837be819a38f748a0f194f2a7,1,aBabiichuk,2015-04-29 14:59:11+03:00,['11a09c57836e8adb4f69c66231131d68fa37cd7e'],28,176,204,20473519,10,0.727891156,0.931972789,1,19789
4a579a72eb320f12b9aabb78ab0a4f7f1047009e,1,Oleg Nechiporenko,2015-04-29 15:16:39+03:00,['2514cda00537319837be819a38f748a0f194f2a7'],3,5,8,20473527,2,,,,19789
de06e8e0877fe5be8240e24b9f4bc88c8e34efaa,1,Andrii Tkach,2015-04-29 15:54:06+03:00,['4a579a72eb320f12b9aabb78ab0a4f7f1047009e'],7,21,28,20473555,1,1,1,1,19789
bc55f2d4e76bedeb79db44199fbf3e588329699c,1,Andrii Tkach,2015-04-29 15:55:11+03:00,['de06e8e0877fe5be8240e24b9f4bc88c8e34efaa'],38,20,58,20473613,3,1,0,0,19789
6727c1dc8c32abbc4ea1a7e3c9652707bb4fd23d,1,Jonathan Hurley,2015-04-29 11:52:04-04:00,['bc55f2d4e76bedeb79db44199fbf3e588329699c'],373,1096,1469,20475082,31,0.17167382,0.163090129,0,19789
6cfff2107852df046627ffbb33a7d40702c26295,1,Aleksandr Kovalenko,2015-04-29 19:39:47+03:00,['6727c1dc8c32abbc4ea1a7e3c9652707bb4fd23d'],8,98,106,20475188,6,0.270833333,1,1,19790
705a0fb6f466e1b7f82def4039b814fb736c9511,1,aBabiichuk,2015-04-29 19:59:21+03:00,['6cfff2107852df046627ffbb33a7d40702c26295'],57,106,163,20475351,16,1,1,0.416666667,19791
1e3afa8678fd9513d77b559b7f8882a6bc15d2f5,0,aBabiichuk,2015-04-29 19:59:21+03:00,['705a0fb6f466e1b7f82def4039b814fb736c9511'],21,32,53,20475404,2,1,0,0,19791
66e42cbab8a714eac49b4ae84eb238d0c08accb5,1,Robert Levas,2015-04-29 13:02:01-04:00,['1e3afa8678fd9513d77b559b7f8882a6bc15d2f5'],36,2482,2518,20477922,35,0.136233951,0.808131241,0.717546362,19800
6bed3a703f1dd0d0566efbb20da0b953ecb24cad,1,Alex Antonenko,2015-04-29 20:05:25+03:00,['66e42cbab8a714eac49b4ae84eb238d0c08accb5'],7,709,716,20478638,6,0.674180328,1,1,19801
6f00dd8a173e6379230b348da6c8ab3bf481c6ed,1,Alex Antonenko,2015-04-29 20:06:46+03:00,['6bed3a703f1dd0d0566efbb20da0b953ecb24cad'],2,2,4,20478642,1,,,,19801
7f753b4448e4b370c100d663e8a4f4fd1f0ec5b0,1,Siddharth Wagle,2015-04-29 11:34:31-07:00,['6f00dd8a173e6379230b348da6c8ab3bf481c6ed'],3,332,335,20478977,4,0.051020408,0.765306122,0.87244898,19803
4189dcca8ea334b099aed550191148fbc2c7395e,0,Siddharth Wagle,2015-04-29 13:59:47-07:00,['7f753b4448e4b370c100d663e8a4f4fd1f0ec5b0'],88,89,177,20479154,3,,,,19803
742f3f86392f02468066abf0535a371e05956220,1,Alex Antonenko,2015-04-30 00:05:54+03:00,['4189dcca8ea334b099aed550191148fbc2c7395e'],3,44,47,20479201,3,1,0.8,1,19803
36f92c70b628ff8f0f71635f0af8edff13ceee06,1,Jayush Luniya,2015-04-29 14:17:01-07:00,['742f3f86392f02468066abf0535a371e05956220'],232,377,609,20479810,15,0.62962963,0.432098765,0.654320988,19811
53bc491ca4d8bf828e699bbe1587e12687efe1eb,1,Alex Antonenko,2015-04-30 00:25:21+03:00,['36f92c70b628ff8f0f71635f0af8edff13ceee06'],45,111,156,20479966,6,,,,19811
8346b21c85598f6a040967751edaff9f36fdc51a,1,Artem Baranchuk,2015-04-30 01:21:46+03:00,['53bc491ca4d8bf828e699bbe1587e12687efe1eb'],3,8,11,20479977,2,1,1,1,19811
e866f0426b16bfcae664ab81bbed95a73517685e,1,Artem Baranchuk,2015-04-30 01:21:47+03:00,['8346b21c85598f6a040967751edaff9f36fdc51a'],29,1019,1048,20481025,3,0.211750306,0.325581395,0.140758874,19811
54be9c4e67a035a4316ff8784c5686fd84f04141,0,Srimanth Gunturi,2015-04-29 16:45:49-07:00,['e866f0426b16bfcae664ab81bbed95a73517685e'],40,65,105,20481130,6,0.727272727,0.090909091,0.090909091,19811
73a9275c3e15c75c224ea2e1e4ef63e4e177ee28,1,Xi Wang,2015-04-29 17:00:54-07:00,['54be9c4e67a035a4316ff8784c5686fd84f04141'],60,37,97,20481227,5,0,0,0,19811
0e741d6a22b0537df5ad478e41981eff07679482,1,Xi Wang,2015-04-29 17:00:54-07:00,['73a9275c3e15c75c224ea2e1e4ef63e4e177ee28'],0,1,1,20481228,1,,,,19811
5f95f11bc2f57f56521145c80e839cffb682dfbe,0,Xi Wang,2015-04-29 17:50:58-07:00,['0e741d6a22b0537df5ad478e41981eff07679482'],2,12,14,20481242,1,1,1,1,19811
97c524d969fb7b1d405ade65e3237bf7cb8ccb78,1,Yusaku Sako,2015-04-29 19:38:54-07:00,['5f95f11bc2f57f56521145c80e839cffb682dfbe'],1,190,191,20481433,6,0.52293578,0.972477064,0.899082569,19811
89144ad4e04223d46571d6f7e9124c35ee48c791,1,Jaimin Jetly,2015-04-29 22:41:31-07:00,['97c524d969fb7b1d405ade65e3237bf7cb8ccb78'],12,24,36,20481469,3,1,1,1,19811
9a62b4e0447702d75e409e7aa8c9bbb57adb4be3,0,Srimanth Gunturi,2015-04-29 23:28:07-07:00,['89144ad4e04223d46571d6f7e9124c35ee48c791'],65,68,133,20481602,4,,,,19811
8606a0b6e20db8db79f4b670bdefb703043c89f6,0,Srimanth Gunturi,2015-04-29 23:31:45-07:00,['9a62b4e0447702d75e409e7aa8c9bbb57adb4be3'],1,5,6,20481608,1,1,1,1,19811
5be634f02a29353618fa222a3d27819e74ad4d1b,0,Srimanth Gunturi,2015-04-29 23:40:27-07:00,['8606a0b6e20db8db79f4b670bdefb703043c89f6'],3,1,4,20481612,1,0,0,0,19811
a73782d52ece502beb05494b17eac7002903dd19,0,Vitaly Brodetskyi,2015-04-26 20:49:57+03:00,['5be634f02a29353618fa222a3d27819e74ad4d1b'],0,4,4,20481616,2,0,0.75,1,19811
24f2548ae0085d137b94bc1c59b4ae09c2806f07,1,Andrew Onishuk,2015-04-30 11:44:49+03:00,['a73782d52ece502beb05494b17eac7002903dd19'],1,20,21,20481637,2,,,,19811
b4d7605496215b6d4cd9aafd35c7488db9f01f32,1,Oleg Nechiporenko,2015-04-30 13:10:38+03:00,['24f2548ae0085d137b94bc1c59b4ae09c2806f07'],13,5,18,20481655,4,0,0,0,19811
46c96582ed54ae36bb8d942f9c254ba328da58a0,1,Andrii Tkach,2015-04-30 14:16:28+03:00,['b4d7605496215b6d4cd9aafd35c7488db9f01f32'],34,82,116,20481771,6,1,1,1,19811
39272fc41a43c2b8c3d45a8ba8f50341c1a11762,1,Artem Baranchuk,2015-04-30 14:28:43+03:00,['46c96582ed54ae36bb8d942f9c254ba328da58a0'],4,17,21,20481792,4,1,1,1,19811
a9997f3c417fde2ac4e6136e87a0774cc701eb3e,0,aBabiichuk,2015-04-30 14:52:15+03:00,['39272fc41a43c2b8c3d45a8ba8f50341c1a11762'],37,64,101,20481893,4,0,1,1,19811
2ac95cf323d6ee8f411236048024b97af6d2e0e0,1,Andrew Onishuk,2015-04-30 15:39:40+03:00,['a9997f3c417fde2ac4e6136e87a0774cc701eb3e'],8,8,16,20481909,8,,,,19811
4f86ebaef3aeed9b9b60936f5443c784f7573420,1,Aleksandr Kovalenko,2015-04-30 16:14:37+03:00,['2ac95cf323d6ee8f411236048024b97af6d2e0e0'],2,8,10,20481919,3,,,,19811
e814ba20ebd422f05ddfff7440e7281a3d3a3d12,1,Aleksandr Kovalenko,2015-04-30 16:14:37+03:00,['4f86ebaef3aeed9b9b60936f5443c784f7573420'],6,16,22,20481941,2,1,1,1,19811
8727232cd22933c463b7bb2a99376f74df98f1f2,1,Andrew Onishuk,2015-04-30 16:25:30+03:00,['e814ba20ebd422f05ddfff7440e7281a3d3a3d12'],124,97,221,20482162,5,1,0,0,19811
9eaacd3dbf9edd51f044b2a1f7948791e1edf8ec,1,Jonathan Hurley,2015-04-30 09:38:15-04:00,['8727232cd22933c463b7bb2a99376f74df98f1f2'],120,297,417,20482579,2,0.46031746,1,1,19812
b3ef40c693e00bc411c0b9c10ea2ba5adb46c4fd,1,Oleg Nechiporenko,2015-04-30 17:42:48+03:00,['9eaacd3dbf9edd51f044b2a1f7948791e1edf8ec'],97,197,294,20482873,9,1,1,1,19812
4102d919a18d24442910daba0c1de2016f035fae,1,Oleg Nechiporenko,2015-04-30 19:02:43+03:00,['b3ef40c693e00bc411c0b9c10ea2ba5adb46c4fd'],182,244,426,20483299,10,0,0,0.063829787,19815
93687a29934f7bd0608c14849e36e3ae74860a8e,0,Florian Barca,2015-04-30 09:17:02-07:00,['4102d919a18d24442910daba0c1de2016f035fae'],11,10,21,20483320,1,,,,19815
f5c86d990a8611a609840224b53471c855ed771d,1,Yusaku Sako,2015-04-30 10:25:05-07:00,['93687a29934f7bd0608c14849e36e3ae74860a8e'],0,43,43,20483363,1,,,,19816
2be054d180fd1b7328e68f01732ed51bc67c0862,1,Florian Barca,2015-04-30 10:51:35-07:00,['f5c86d990a8611a609840224b53471c855ed771d'],12,15,27,20483390,3,1,1,1,19816
3fda2bcca040233b208be23f8c54c837f6e12551,0,Florian Barca,2015-04-30 11:42:28-07:00,['2be054d180fd1b7328e68f01732ed51bc67c0862'],10,14,24,20483414,2,0.5,0.5,0.5,19816
1cf49eb3bd04ab2a5250adb23086446e272753ff,0,Sumit Mohanty,2015-04-30 13:25:53-07:00,['3fda2bcca040233b208be23f8c54c837f6e12551'],12,0,12,20483426,4,,,,19816
8e39a705c390d2a442c5b0ceeb2c64092e48e601,1,Alex Antonenko,2015-05-01 00:40:25+03:00,['1cf49eb3bd04ab2a5250adb23086446e272753ff'],12,42,54,20483480,6,,,,19816
61dc3344a55e90bf2f5a9d513d7925c7e8d2ddce,1,Jaimin Jetly,2015-04-30 16:34:37-07:00,['8e39a705c390d2a442c5b0ceeb2c64092e48e601'],9,56,65,20483545,4,0.388888889,0.416666667,1,19816
4bb3f33ca6aac2f306b9eac810724968362dd772,0,Jayush Luniya,2015-04-30 18:06:49-07:00,['61dc3344a55e90bf2f5a9d513d7925c7e8d2ddce'],1,1,2,20483547,1,,,,19816
cd01675b56cdef0cdbff72e3331a760ec10781bb,1,Sumit Mohanty,2015-04-30 18:09:17-07:00,['4bb3f33ca6aac2f306b9eac810724968362dd772'],1,2,3,20483550,1,,,,19816
2c7e0340c5de2f11536bccd94a8a05eac14e576f,1,Xi Wang,2015-04-30 18:31:22-07:00,['cd01675b56cdef0cdbff72e3331a760ec10781bb'],82,111,193,20483743,15,0.958333333,0.958333333,1,19816
968ff91d93933c3aa9671bdcd049f6fff5e57eee,1,Alex Antonenko,2015-05-01 09:42:49+03:00,['2c7e0340c5de2f11536bccd94a8a05eac14e576f'],483,1514,1997,20485740,41,0.85202864,0.854415274,0.928400955,19825
53c5b621a80fcd1ff6450948875071938f063419,1,Jayush Luniya,2015-05-01 01:22:46-07:00,['968ff91d93933c3aa9671bdcd049f6fff5e57eee'],24,80,104,20485844,2,0,0,1,19825
fea608d052a0538b3f7900ca785aa9d378a36dab,1,Jonathan Hurley,2015-05-01 09:33:37-04:00,['53c5b621a80fcd1ff6450948875071938f063419'],18,401,419,20486263,17,0.393939394,0.660606061,1,19826
c7d6fcbc5311301b9478e4305e612f5e72df20c4,1,Robert Levas,2015-05-01 12:37:32-04:00,['fea608d052a0538b3f7900ca785aa9d378a36dab'],178,191,369,20486632,2,0.6,1,0.6,19826
91b78201181af4c2e316f49ac6a806b76c77d46e,1,Sumit Mohanty,2015-05-01 09:51:19-07:00,['c7d6fcbc5311301b9478e4305e612f5e72df20c4'],2,1147,1149,20487781,16,0.302884615,1,0.894230769,19840
99d96d15c90ff11f1483d63c48194e31c54bf83e,1,Alejandro Fernandez,2015-05-01 10:18:43-07:00,['91b78201181af4c2e316f49ac6a806b76c77d46e'],154,121,275,20488056,13,1,0.68,0,19840
77e4d50c8c4c73ee446f01b05ea1d1d17567197b,1,Florian Barca,2015-05-01 10:37:04-07:00,['99d96d15c90ff11f1483d63c48194e31c54bf83e'],116,463,579,20488635,50,0.182692308,0.725961538,1,19840
89711d74312553a8f6f16f745d7542b40081c5d1,1,Siddharth Wagle,2015-05-01 13:00:57-07:00,['77e4d50c8c4c73ee446f01b05ea1d1d17567197b'],7,1847,1854,20490489,21,0.703099511,1,1,19853
7fc85761a203f3279e87209f62348a8a0505f551,1,Siddharth Wagle,2015-05-01 14:27:54-07:00,['89711d74312553a8f6f16f745d7542b40081c5d1'],0,1,1,20490490,1,0,0,1,19853
0670e953a8b820163e546b21ce5cb40248986966,1,Siddharth Wagle,2015-05-01 14:29:39-07:00,['7fc85761a203f3279e87209f62348a8a0505f551'],1,1,2,20490492,1,,,,19853
a851dffba329380374c427d8919ec9b595706242,1,Sumit Mohanty,2015-05-01 15:39:56-07:00,['0670e953a8b820163e546b21ce5cb40248986966'],11,12,23,20490515,1,0,0,1,19853
48edffff0383e48d5164fbee4e10ee0a7a376e71,1,Alejandro Fernandez,2015-05-01 18:42:48-07:00,['a851dffba329380374c427d8919ec9b595706242'],4,14,18,20490533,3,0.285714286,0,0,19853
bb4633918eb4ee18359b870ff681a619bd6839f3,1,Jaimin Jetly,2015-05-01 18:49:40-07:00,['48edffff0383e48d5164fbee4e10ee0a7a376e71'],432,915,1347,20491880,8,0,1,1,19853
727f550f828aff8832123bd941e1d1ca4f5ed423,0,Xi Wang,2015-05-01 19:10:17-07:00,['bb4633918eb4ee18359b870ff681a619bd6839f3'],49,57,106,20491986,5,,,,19853
0e849f6d4a58224a02fca848edea35230e3536c4,1,Alex Antonenko,2015-05-04 00:20:44+03:00,['727f550f828aff8832123bd941e1d1ca4f5ed423'],122,242,364,20492350,4,1,0.833333333,0.904761905,19853
64b8e235a6a65bc38aa2e5f2049319cd14d6845f,1,Sumit Mohanty,2015-05-04 08:20:02-05:00,['0e849f6d4a58224a02fca848edea35230e3536c4'],19,1434,1453,20493803,4,0.06557377,1,0.081967213,19855
2a4b64444a68b8afa88572be1f73bc5bf6f35759,0,Siddharth Wagle,2015-05-04 12:16:45-07:00,['64b8e235a6a65bc38aa2e5f2049319cd14d6845f'],4,4,8,20493811,1,,,,19855
061d062c41200537a26a7c1d676963017f44d926,0,Siddharth Wagle,2015-05-04 12:57:51-07:00,['2a4b64444a68b8afa88572be1f73bc5bf6f35759'],4,4,8,20493819,1,,,,19855
1111996fe96cd693a95a805996b02adcda08a9f5,1,Srimanth Gunturi,2015-05-04 15:20:09-07:00,['061d062c41200537a26a7c1d676963017f44d926'],1,99,100,20493919,3,0.103448276,0.103448276,0.103448276,19855
002d9c286d46f131b963613223ed15f189cf810f,1,Srimanth Gunturi,2015-05-04 15:32:30-07:00,['1111996fe96cd693a95a805996b02adcda08a9f5'],1,8,9,20493928,2,1,1,1,19855
46e2bb3616fc6882317a582813a6e55dcc11af9d,1,Srimanth Gunturi,2015-05-04 15:56:33-07:00,['002d9c286d46f131b963613223ed15f189cf810f'],0,8,8,20493936,1,0,1,1,19855
1f1a9c792e9cdabf306e92cb1e8eb2898868d59d,1,Xi Wang,2015-05-04 16:18:20-07:00,['46e2bb3616fc6882317a582813a6e55dcc11af9d'],24,169,193,20494129,8,0.759615385,1,1,19855
0ebdf4e660bf7ff97b623e2bbca76055e3c9956b,1,Srimanth Gunturi,2015-05-04 16:25:02-07:00,['1f1a9c792e9cdabf306e92cb1e8eb2898868d59d'],2,8,10,20494139,2,0.5,1,0,19855
ce3e14370e23204c3da0486489cce860232a89aa,1,Srimanth Gunturi,2015-05-04 16:54:35-07:00,['0ebdf4e660bf7ff97b623e2bbca76055e3c9956b'],15,10,25,20494164,2,1,0.25,0,19855
0c39d4ef5343c8fb055cd2581538ae26d9a77fba,1,Siddharth Wagle,2015-05-04 17:52:40-07:00,['ce3e14370e23204c3da0486489cce860232a89aa'],17,27,44,20494208,7,,,,19855
5226ae1be4ceafb0ca4544a48d69c85edbc4a410,1,Siddharth Wagle,2015-05-04 18:06:44-07:00,['0c39d4ef5343c8fb055cd2581538ae26d9a77fba'],36,85,121,20494329,7,0.692307692,0.961538462,0.923076923,19855
7dd2041bed8f287d8df50413cc4ea79116614913,1,Srimanth Gunturi,2015-05-04 18:43:13-07:00,['5226ae1be4ceafb0ca4544a48d69c85edbc4a410'],2,26,28,20494357,4,,,,19855
a3b691482c4f72729421654963d462a11011db15,0,Srimanth Gunturi,2015-05-04 19:01:48-07:00,['7dd2041bed8f287d8df50413cc4ea79116614913'],5,5,10,20494367,1,,,,19855
326d5928cf546557597fc3c787dd945e3bd950bd,1,Alex Antonenko,2015-05-05 07:58:26+03:00,['a3b691482c4f72729421654963d462a11011db15'],2,53,55,20494422,6,1,1,1,19855
2bcbf2db012215bb23126cf19386102d7ae4625c,1,Alex Antonenko,2015-05-05 08:03:19+03:00,['326d5928cf546557597fc3c787dd945e3bd950bd'],60,549,609,20495031,4,0.1875,0.375,0.923611111,19855
2ef3a5c17a998738a6f46d9e1ca4e01193bd7ca2,0,Srimanth Gunturi,2015-05-04 23:35:27-07:00,['2bcbf2db012215bb23126cf19386102d7ae4625c'],1,1,2,20495033,1,,,,19855
8f69640327f2c0945b975e38827e3970011863e6,0,Aleksandr Kovalenko,2015-05-05 13:31:05+03:00,['2ef3a5c17a998738a6f46d9e1ca4e01193bd7ca2'],2,4,6,20495039,2,,,,19855
237802151037edbe0a2cb4529d27b30451e80e1e,0,Andrii Tkach,2015-05-05 13:55:45+03:00,['8f69640327f2c0945b975e38827e3970011863e6'],1,5,6,20495045,2,0.8,0.8,1,19855
47f3bfb16f02cd52f99671497ac688950e218bf3,1,Oleg Nechiporenko,2015-05-05 14:04:41+03:00,['237802151037edbe0a2cb4529d27b30451e80e1e'],4,67,71,20495116,5,1,1,1,19855
eb9487bfcf3d9e02eb75c50c174a6bef016c2a38,1,Andrew Onishuk,2015-05-05 14:13:31+03:00,['47f3bfb16f02cd52f99671497ac688950e218bf3'],0,5,5,20495121,1,,,,19855
c22791cbdf6a7458831c3b7d744e7b457e264797,0,Andrew Onishuk,2015-05-05 14:30:37+03:00,['eb9487bfcf3d9e02eb75c50c174a6bef016c2a38'],2,2,4,20495125,1,,,,19855
272095e049537c78abbc7540d7e9cc2ab28da79f,0,Andrii Tkach,2015-05-05 15:00:44+03:00,['c22791cbdf6a7458831c3b7d744e7b457e264797'],9,32,41,20495166,2,1,1,1,19855
2200dcc56e0ddc2922400588d3e5fc8e052145de,1,tbeerbower,2015-05-05 09:14:09-04:00,['272095e049537c78abbc7540d7e9cc2ab28da79f'],65,19,84,20495250,3,0.457142857,0.571428571,0,19855
0ab1d361d9a2e0c6f4198a5d4d91f48f8fb41fe8,1,Robert Levas,2015-05-05 09:54:10-04:00,['2200dcc56e0ddc2922400588d3e5fc8e052145de'],75,118,193,20495443,5,0.615384615,0,0.615384615,19855
a6b9e95596de4e16f773cf0c361e2a7dbd65f94e,1,Nate Cole,2015-05-05 10:08:55-04:00,['0ab1d361d9a2e0c6f4198a5d4d91f48f8fb41fe8'],33,1475,1508,20496951,82,0.049270073,0.999087591,0.898722628,19856
0dbb7054e394b373e8b8fe729c878157b1efc776,1,Oleg Nechiporenko,2015-05-05 18:25:55+03:00,['a6b9e95596de4e16f773cf0c361e2a7dbd65f94e'],8,28,36,20496987,4,1,1,1,19856
7492c33dd232650e11f155b5d87739dc4ad8038e,1,Oleg Nechiporenko,2015-05-05 18:27:14+03:00,['0dbb7054e394b373e8b8fe729c878157b1efc776'],4,31,35,20497022,3,1,1,1,19857
fb3bad86767f430ce2606ed33e517ecc6ff87295,1,Jaimin Jetly,2015-05-05 08:48:32-07:00,['7492c33dd232650e11f155b5d87739dc4ad8038e'],5,5,10,20497032,5,,,,19857
175e78472452746141bf2caaa4f03374344b5a59,1,Oleg Nechiporenko,2015-05-05 19:09:39+03:00,['fb3bad86767f430ce2606ed33e517ecc6ff87295'],136,55,191,20497223,9,0.733333333,0.266666667,0.5,19858
172dd8cf4c3e944a1d42d90f39108b2ad7ac22b6,1,Oleg Nechiporenko,2015-05-05 20:00:52+03:00,['175e78472452746141bf2caaa4f03374344b5a59'],17,24,41,20497264,4,1,1,1,19858
2fb314f7d17e3115c9e5ec7cec4c242eab0bd068,1,Alex Antonenko,2015-05-05 20:21:09+03:00,['172dd8cf4c3e944a1d42d90f39108b2ad7ac22b6'],4,12,16,20497280,2,0.25,0,0.25,19858
78c7b43534754ad3219e9a59166690ba0553ab4b,1,Alex Antonenko,2015-05-05 20:37:57+03:00,['2fb314f7d17e3115c9e5ec7cec4c242eab0bd068'],202,529,731,20498011,26,0.877697842,0.913669065,0.971223022,19861
88fa680d05273d27ae6a6d9078db87e44717f8e4,1,Jayush Luniya,2015-05-05 10:59:30-07:00,['78c7b43534754ad3219e9a59166690ba0553ab4b'],0,1,1,20498012,1,,,,19861
c465e9e125c79212c38b737d36afcbf2365ecfbb,1,Siddharth Wagle,2015-05-05 11:03:02-07:00,['88fa680d05273d27ae6a6d9078db87e44717f8e4'],8,8,16,20498028,1,,,,19861
03918cf3a653ae8d4871adf9a48ff5f77859027b,1,Jonathan Hurley,2015-05-05 14:19:35-04:00,['c465e9e125c79212c38b737d36afcbf2365ecfbb'],657,1010,1667,20499695,70,1,0,1,19861
bd44220a566b230d005cdb5bea76a9453fa1885e,1,Jaimin Jetly,2015-05-05 11:26:25-07:00,['03918cf3a653ae8d4871adf9a48ff5f77859027b'],15,15,30,20499725,7,0.083333333,1,0,19861
9735a78d696e62ff0d50f2a7846f7b7bd3cd0f4b,1,Alejandro Fernandez,2015-05-05 12:33:51-07:00,['bd44220a566b230d005cdb5bea76a9453fa1885e'],303,452,755,20500480,17,0.537313433,1,0.955223881,19861
03bbb08b5d5b493bf8f2d013ebae340fc35179c9,1,Srimanth Gunturi,2015-05-05 13:02:49-07:00,['9735a78d696e62ff0d50f2a7846f7b7bd3cd0f4b'],1,5,6,20500486,2,0,0.25,0.25,19861
8a42b232f0971559161a505e30291cd5a353e6b4,1,tbeerbower,2015-05-05 16:19:47-04:00,['03bbb08b5d5b493bf8f2d013ebae340fc35179c9'],6,11,17,20500503,5,,,,19861
81f1b978c80fee92727a04eaafd52efb76c721ac,1,Jaimin Jetly,2015-05-05 13:30:03-07:00,['8a42b232f0971559161a505e30291cd5a353e6b4'],2603,2669,5272,20505775,9,0.317073171,0.902439024,1,19862
ef9dc0f1949f258e553176c780105bddf9fef899,0,Srimanth Gunturi,2015-05-05 13:52:09-07:00,['81f1b978c80fee92727a04eaafd52efb76c721ac'],6,42,48,20505823,3,,,,19862
1d058849733d5f57894697d88885bbb3a010efca,0,Srimanth Gunturi,2015-05-05 14:06:04-07:00,['ef9dc0f1949f258e553176c780105bddf9fef899'],45,0,45,20505868,1,,,,19862
c6a69c0ef594223ceee100abcfcc404b27de24f7,1,Xi Wang,2015-05-05 14:33:19-07:00,['1d058849733d5f57894697d88885bbb3a010efca'],2,5,7,20505875,3,,,,19862
eaefe6d304110c0d9a3f74536f4d0a1a79f40f37,1,Jaimin Jetly,2015-05-05 14:40:18-07:00,['c6a69c0ef594223ceee100abcfcc404b27de24f7'],9,37,46,20505921,4,,,,19863
3f6ef73b63742fcbbc0ff1b006610c580cabfb26,1,Alejandro Fernandez,2015-05-05 14:41:35-07:00,['eaefe6d304110c0d9a3f74536f4d0a1a79f40f37'],309,121,430,20506351,5,0.974683544,0.215189873,0.329113924,19863
260edad611620998e1f4b5e494763a7531895272,1,Alejandro Fernandez,2015-05-05 14:45:07-07:00,['3f6ef73b63742fcbbc0ff1b006610c580cabfb26'],13,644,657,20507008,13,0.139175258,0.417525773,0.128865979,19867
22c9243d2e208ce6c48672ec6ff8130e12d47364,1,Jaimin Jetly,2015-05-05 16:33:05-07:00,['260edad611620998e1f4b5e494763a7531895272'],2,5,7,20507015,3,,,,19867
da9ab2821e7b198f1357849078fa06f7ef42d45e,0,Florian Barca,2015-05-05 16:42:39-07:00,['22c9243d2e208ce6c48672ec6ff8130e12d47364'],0,22,22,20507037,1,,,,19867
a2390c699c94abcc80233cd6cd2d7139cbbc8ffd,0,Robert Levas,2015-05-05 21:43:31-04:00,['da9ab2821e7b198f1357849078fa06f7ef42d45e'],3,39,42,20507079,2,0,0.925925926,0,19867
878b6fa0b9b06b6edaf6e4e7bf27954cfc1c8256,0,Robert Levas,2015-05-05 21:51:09-04:00,['a2390c699c94abcc80233cd6cd2d7139cbbc8ffd'],39,3,42,20507121,2,1,0.074074074,1,19867
d6d3600c566fc1a8b28ef0c89dcc002e844cafc9,1,Robert Levas,2015-05-05 21:51:51-04:00,['878b6fa0b9b06b6edaf6e4e7bf27954cfc1c8256'],3,147,150,20507271,3,0.218181818,0.963636364,0.454545455,19868
aa477d93cb840dbe3876660a57d535ef9046ff82,0,Robert Levas,2015-05-05 21:54:23-04:00,['d6d3600c566fc1a8b28ef0c89dcc002e844cafc9'],0,1,1,20507272,1,,,,19868
28a88d3f51d0ed70552d7008b28937f1483c8aa9,0,Andrew Onishuk,2015-05-06 12:03:26+03:00,['aa477d93cb840dbe3876660a57d535ef9046ff82'],3,3,6,20507278,1,,,,19868
373427ff3b40b0b777bd533906e3a4e8e379f707,0,Oleg Nechiporenko,2015-05-06 12:38:13+03:00,['28a88d3f51d0ed70552d7008b28937f1483c8aa9'],1,1,2,20507280,1,,,,19868
a5d0caf3255487e90b61089bf9a7ebd304e98981,0,Lisnichenko Dmitro,2015-05-06 14:39:55+03:00,['373427ff3b40b0b777bd533906e3a4e8e379f707'],30,0,30,20507310,3,,,,19868
ccd0c44b64e6768f5fab3a2d349ba365f9af6b34,1,Lisnichenko Dmitro,2015-05-06 15:05:01+03:00,['a5d0caf3255487e90b61089bf9a7ebd304e98981'],69,112,181,20507491,7,0.034482759,0.620689655,1,19868
24726e90e55f1c936bc9240e4373dde350fecd49,0,Lisnichenko Dmitro,2015-05-06 15:05:39+03:00,['ccd0c44b64e6768f5fab3a2d349ba365f9af6b34'],1,1,2,20507493,1,,,,19868
4dac157e9be719ae473046409f1d9ff20b13ac91,1,Lisnichenko Dmitro,2015-05-06 15:06:21+03:00,['24726e90e55f1c936bc9240e4373dde350fecd49'],3,2,5,20507498,2,,,,19868
dff2e0e026eb56366c7b6009175a7c4bc70916c9,1,Andrii Tkach,2015-05-06 15:41:55+03:00,['4dac157e9be719ae473046409f1d9ff20b13ac91'],25,329,354,20507852,10,0.856140351,1,1,19869
1cde5c70a7a101298836955dae85720efafe420e,1,Lisnichenko Dmitro,2015-05-06 15:58:37+03:00,['dff2e0e026eb56366c7b6009175a7c4bc70916c9'],3,6,9,20507861,1,0,0,1,19869
39ab95abc4ba3413d80febf38c4283a18d89725a,0,Andrew Onishuk,2015-05-06 16:03:54+03:00,['1cde5c70a7a101298836955dae85720efafe420e'],0,6,6,20507867,1,,,,19869
9ee1721f7d7f1b407ed5acd30fe52068574ae3d8,1,Andrew Onishuk,2015-05-06 16:31:47+03:00,['39ab95abc4ba3413d80febf38c4283a18d89725a'],0,3,3,20507870,1,1,1,1,19869
dcc3c7ed17a68968b116868a9881c347196c3bea,1,Lisnichenko Dmitro,2015-05-06 17:09:00+03:00,['9ee1721f7d7f1b407ed5acd30fe52068574ae3d8'],1,1,2,20507872,1,,,,19869
ef9b2f4a807e93aa9a17be783ecbb211bc6fb7e4,1,Andrii Tkach,2015-05-06 17:18:33+03:00,['dcc3c7ed17a68968b116868a9881c347196c3bea'],2,17,19,20507891,4,0.052631579,1,1,19869
29e1ad6a178ee17757da1b1faf85123bb6200976,0,Robert Levas,2015-05-06 11:01:50-04:00,['ef9b2f4a807e93aa9a17be783ecbb211bc6fb7e4'],90,400,490,20508381,6,1,1,1,19872
a72e62c79f3e0dfa07005ca9ba5cfe3690647e90,0,Oleg Nechiporenko,2015-05-06 18:18:50+03:00,['29e1ad6a178ee17757da1b1faf85123bb6200976'],0,2,2,20508383,1,,,,19872
a1effe19f9dc931b103501df24da4cbd3b339a3d,1,Andrew Onishuk,2015-05-06 18:19:29+03:00,['a72e62c79f3e0dfa07005ca9ba5cfe3690647e90'],6,50,56,20508439,8,,,,19873
8ce46ac2614a2da6b62b54fa6df3789dc6b75b6d,0,Florian Barca,2015-05-06 09:52:30-07:00,['a1effe19f9dc931b103501df24da4cbd3b339a3d'],5,5,10,20508449,1,,,,19873
0041836a232ca25f71271757460548fe777baa0e,0,Florian Barca,2015-05-06 09:55:52-07:00,['8ce46ac2614a2da6b62b54fa6df3789dc6b75b6d'],6,5,11,20508460,1,,,,19873
6182ef3c86ba30618f2653116a8cfc9e82b8954c,1,Sumit Mohanty,2015-05-06 10:17:01-07:00,['0041836a232ca25f71271757460548fe777baa0e'],1,1692,1693,20510153,2,,,,19874
03e0836b07e81d31e3ef103517ccb6183da86cde,1,Robert Levas,2015-05-06 13:22:19-04:00,['6182ef3c86ba30618f2653116a8cfc9e82b8954c'],400,90,490,20510643,6,0,0,0,19874
690dfde82eab74d8a6399ec31741d20108fae085,1,Robert Levas,2015-05-06 13:26:40-04:00,['03e0836b07e81d31e3ef103517ccb6183da86cde'],90,395,485,20511128,6,1,1,1,19877
4699a1b75811aace747dc9c87072b29b8b41fbd1,1,Siddharth Wagle,2015-05-06 10:30:23-07:00,['690dfde82eab74d8a6399ec31741d20108fae085'],4,22,26,20511154,2,0.142857143,0.857142857,1,19877
a9c47820e75ab9213aeba5ef1e73a6813fb6a4c7,0,Srimanth Gunturi,2015-05-06 11:31:36-07:00,['4699a1b75811aace747dc9c87072b29b8b41fbd1'],1,1,2,20511156,1,,,,19877
be9066f6dd046eee1dd9efd6960901d147e2ccbb,1,Srimanth Gunturi,2015-05-06 11:39:45-07:00,['a9c47820e75ab9213aeba5ef1e73a6813fb6a4c7'],5,5,10,20511166,2,,,,19877
7473b1d7097edb787a73638a32a06d54dc3c739b,0,Srimanth Gunturi,2015-05-06 11:56:14-07:00,['be9066f6dd046eee1dd9efd6960901d147e2ccbb'],1,1,2,20511168,1,,,,19877
e4613a328683f49eb6e89da3aa5efa964af77fcc,0,tbeerbower,2015-05-06 16:03:52-04:00,['7473b1d7097edb787a73638a32a06d54dc3c739b'],4,24,28,20511196,2,0.555555556,1,1,19877
44bfa35dbb72380ca8608b43b1cd12158f9f26b3,1,Srimanth Gunturi,2015-05-06 13:10:35-07:00,['e4613a328683f49eb6e89da3aa5efa964af77fcc'],18,109,127,20511323,16,1,1,1,19877
d7e8a796916e264222eb44672fd65619dcb2108c,1,Srimanth Gunturi,2015-05-06 14:00:12-07:00,['44bfa35dbb72380ca8608b43b1cd12158f9f26b3'],3,4,7,20511330,2,0,1,0,19877
73f4d8ee0569b48c994c946ad3b4e33b72813e29,0,Jaimin Jetly,2015-05-06 14:36:31-07:00,['d7e8a796916e264222eb44672fd65619dcb2108c'],1,2,3,20511333,2,0,1,1,19877
8cbe1e1063ef26670862374ed2e9b713f4f92580,0,Sumit Mohanty,2015-05-06 15:13:43-07:00,['73f4d8ee0569b48c994c946ad3b4e33b72813e29'],0,6,6,20511339,1,,,,19877
2ca58368e60671580e246199da392167c371338e,1,Siddharth Wagle,2015-05-06 18:12:39-07:00,['8cbe1e1063ef26670862374ed2e9b713f4f92580'],2,5,7,20511346,1,1,1,1,19877
8963501be6c25ebd421d1935cb2a1ddb5b6ffee9,1,Srimanth Gunturi,2015-05-06 19:05:31-07:00,['2ca58368e60671580e246199da392167c371338e'],6,120,126,20511472,4,0,0.410958904,0.410958904,19877
807b3c2df7a9a9fe1d728e75cf80c130848d4756,1,John Speidel,2015-05-07 01:17:10-04:00,['8963501be6c25ebd421d1935cb2a1ddb5b6ffee9'],991,2595,3586,20515058,46,0.507462687,0.788557214,0.804726368,19886
ac1ba0e4f2595e4dc109f3aa5a0ae06f47f4c012,0,Lisnichenko Dmitro,2015-05-07 08:44:32+03:00,['807b3c2df7a9a9fe1d728e75cf80c130848d4756'],77,89,166,20515224,2,0,0.375,1,19886
524368b4a1ba8297a1462a8f98c65653c0a527ad,1,Nate Cole,2015-05-07 07:05:23-04:00,['ac1ba0e4f2595e4dc109f3aa5a0ae06f47f4c012'],28,446,474,20515698,8,0.013824885,0.529953917,0.963133641,19887
e65bad149d6722b788715a32aaec075183d2f3a8,1,Oleg Nechiporenko,2015-05-07 14:44:01+03:00,['524368b4a1ba8297a1462a8f98c65653c0a527ad'],5,36,41,20515739,3,1,1,1,19887
f4725228e79416712986d0c2de1cb251c47e80b0,1,Jonathan Hurley,2015-05-07 08:12:02-04:00,['e65bad149d6722b788715a32aaec075183d2f3a8'],110,1246,1356,20517095,28,0.297650131,0.788511749,0.966057441,19897
57759d049e8f2427e13777f482bb204548f7bd20,0,Andrii Tkach,2015-05-07 15:59:03+03:00,['f4725228e79416712986d0c2de1cb251c47e80b0'],1,6,7,20517102,2,,,,19897
629d8cd5c496d6bb600994e93aa4fccbf3f2f7f1,0,Aleksandr Kovalenko,2015-05-07 16:42:50+03:00,['57759d049e8f2427e13777f482bb204548f7bd20'],5,5,10,20517112,2,,,,19897
c8030852a50982144e514deab76e73cb48d0c7fb,1,Andrii Tkach,2015-05-07 18:21:32+03:00,['629d8cd5c496d6bb600994e93aa4fccbf3f2f7f1'],96,109,205,20517317,14,1,0,1,19897
f69b5240939f61aa336bccf304636f2f5889b216,1,aBabiichuk,2015-05-07 19:49:08+03:00,['c8030852a50982144e514deab76e73cb48d0c7fb'],21,23,44,20517361,7,1,1,1,19897
7b822e42b2faf2910d4776d8651f841e621eeb2d,0,Robert Levas,2015-05-07 13:04:28-04:00,['f69b5240939f61aa336bccf304636f2f5889b216'],139,264,403,20517764,12,0,0,0,19897
34c1e9b2c7726a92d18de68d5b292cb87e564740,1,Siddharth Wagle,2015-05-07 10:37:50-07:00,['7b822e42b2faf2910d4776d8651f841e621eeb2d'],14,155,169,20517933,7,0.528301887,0.075471698,0.962264151,19899
c775434edc34e2cc0a51f78a7b3eedb2415dc1c6,1,Robert Levas,2015-05-07 14:43:53-04:00,['34c1e9b2c7726a92d18de68d5b292cb87e564740'],264,139,403,20518336,12,1,1,1,19899
6691a1742fe9927d68008d8f54d7a38bff97f524,1,Robert Levas,2015-05-07 14:44:50-04:00,['c775434edc34e2cc0a51f78a7b3eedb2415dc1c6'],139,607,746,20519082,14,0.053333333,0.506666667,0.373333333,19901
90e9e811b5eca94d2597069ac5e563285455aa4e,1,Robert Levas,2015-05-07 15:46:37-04:00,['6691a1742fe9927d68008d8f54d7a38bff97f524'],28,62,90,20519172,9,0.869565217,1,0.739130435,19901
1f91b67e9d34fa764278344d972a6774dfa4a9e2,0,Robert Levas,2015-05-07 16:24:15-04:00,['90e9e811b5eca94d2597069ac5e563285455aa4e'],1,4,5,20519177,1,,,,19901
1d618371a53507a8fb00a5033a4f2038dfe07b87,1,Robert Levas,2015-05-07 16:28:12-04:00,['1f91b67e9d34fa764278344d972a6774dfa4a9e2'],6,33,39,20519216,4,1,1,1,19901
0f6ca9210da598d7cdd729c9fdcbc5381f7ef374,1,Srimanth Gunturi,2015-05-07 13:29:47-07:00,['1d618371a53507a8fb00a5033a4f2038dfe07b87'],48,115,163,20519379,10,0,0,0.852941176,19901
afb8b3b71ac6db4c045acfe7e3c8c3c8ec8689b3,0,Jaimin Jetly,2015-05-07 15:48:43-07:00,['0f6ca9210da598d7cdd729c9fdcbc5381f7ef374'],1,1,2,20519381,1,,,,19901
41f54cc0163430439e45b0f1fe8b3c2b88222c90,1,Sumit Mohanty,2015-05-07 18:27:40-07:00,['afb8b3b71ac6db4c045acfe7e3c8c3c8ec8689b3'],18,43,61,20519442,1,0,0,1,19901
1b66baac0ee85e7cec472db845937f20ec7203ed,1,Billie Rinaldi,2015-05-07 18:38:05-07:00,['41f54cc0163430439e45b0f1fe8b3c2b88222c90'],146,466,612,20520054,22,0,0,1,19906
8c3d2acd445dde75f0c6af7f13ef874aa071603d,1,Jonathan Hurley,2015-05-07 23:48:37-04:00,['1b66baac0ee85e7cec472db845937f20ec7203ed'],15,95,110,20520164,8,0,0.64,1,19906
f8d75a60870d1942d85f1ed1d3d2e393b681a7d8,1,aBabiichuk,2015-05-08 12:16:54+03:00,['8c3d2acd445dde75f0c6af7f13ef874aa071603d'],17,17,34,20520198,1,1,1,1,19906
684ffd294ded1375b0212b54907f74b27a45ab4e,1,Andrii Tkach,2015-05-08 13:47:33+03:00,['f8d75a60870d1942d85f1ed1d3d2e393b681a7d8'],23,48,71,20520269,4,0,0,0.545454545,19906
2a09dfeebf271a462a955f25c0ff42618be21462,1,Oleg Nechiporenko,2015-05-08 14:14:50+03:00,['684ffd294ded1375b0212b54907f74b27a45ab4e'],15,27,42,20520311,4,0,0,0,19906
c0bbddb2d63b9c0156429a270ea6475775251e98,1,Andrew Onishuk,2015-05-08 14:54:27+03:00,['2a09dfeebf271a462a955f25c0ff42618be21462'],2,8,10,20520321,2,0,1,0.25,19906
ec9684763a516f8c3f13a00228071ae4e4ef6a62,1,aBabiichuk,2015-05-08 14:55:15+03:00,['c0bbddb2d63b9c0156429a270ea6475775251e98'],20,44,64,20520385,2,0,0.965517241,1,19906
8de5bf38f1c56f3661b63064b422bed4c359bd49,1,Robert Levas,2015-05-08 10:26:59-04:00,['ec9684763a516f8c3f13a00228071ae4e4ef6a62'],2,29,31,20520416,3,0,0.652173913,0.956521739,19906
258837693cd70b57bb26adf6f8db92decbd03986,1,Nate Cole,2015-05-08 10:42:35-04:00,['8de5bf38f1c56f3661b63064b422bed4c359bd49'],61,289,350,20520766,23,0.696629213,0.853932584,1,19908
cf62f66a1cfd473dbdb4c05f2f2b188fcd74016a,1,Srimanth Gunturi,2015-05-08 09:35:02-07:00,['258837693cd70b57bb26adf6f8db92decbd03986'],8,64,72,20520838,4,,,,19908
5c4e25e2b109c004bd2e85c038cf4aa04965c1e1,1,Siddharth Wagle,2015-05-08 10:01:28-07:00,['cf62f66a1cfd473dbdb4c05f2f2b188fcd74016a'],53,69,122,20520960,20,1,1,0,19908
41a41e64b0bfe5c14479555c95dcab2680f25f1f,0,Jonathan Hurley,2015-05-08 13:06:20-04:00,['5c4e25e2b109c004bd2e85c038cf4aa04965c1e1'],2,7,9,20520969,1,,,,19908
c0da0a1d9b295b2ac7f0ac5638b255852e816feb,1,Siddharth Wagle,2015-05-08 10:42:26-07:00,['41a41e64b0bfe5c14479555c95dcab2680f25f1f'],146,292,438,20521407,9,0.793478261,0,0.391304348,19909
642fd46cbf5d8e232007b487ceef0618aa2dd9e7,1,Alex Antonenko,2015-05-08 21:02:37+03:00,['c0da0a1d9b295b2ac7f0ac5638b255852e816feb'],622,1803,2425,20523832,125,0.862129145,0.902268761,0.912739965,19918
55394ec0a2cf24b3f180b2b5c3f5f9221ab825e2,1,aBabiichuk,2015-05-08 21:17:42+03:00,['642fd46cbf5d8e232007b487ceef0618aa2dd9e7'],0,2,2,20523834,1,1,1,1,19918
6016fc6e8ff30f891fc4d6d3524b396c43a7aa07,1,Srimanth Gunturi,2015-05-08 11:49:38-07:00,['55394ec0a2cf24b3f180b2b5c3f5f9221ab825e2'],11,73,84,20523918,4,0.068181818,1,0.931818182,19918
41bdc34d56da18a921116bbd22207220cd74ca05,1,Robert Levas,2015-05-08 15:26:39-04:00,['6016fc6e8ff30f891fc4d6d3524b396c43a7aa07'],61,68,129,20524047,3,1,1,1,19918
92da024a53d5f608a116e0da54897561567d45bb,1,Srimanth Gunturi,2015-05-08 12:41:19-07:00,['41bdc34d56da18a921116bbd22207220cd74ca05'],10,36,46,20524093,8,,,,19918
6e8dce44336c0afaa34a5aefbc500a116b4b91e8,1,Andrew Onishuk,2015-05-08 23:34:21+03:00,['92da024a53d5f608a116e0da54897561567d45bb'],2144,3064,5208,20529301,103,0.269135802,0.918518519,0.935802469,19929
0564f0c3ba2f82235925101a33c4316082c43e98,0,Andrew Onishuk,2015-05-08 23:49:55+03:00,['6e8dce44336c0afaa34a5aefbc500a116b4b91e8'],6,0,6,20529307,1,,,,19929
8df37d1f7432ca43d0206c3bc4e578b6b8fc6214,1,Srimanth Gunturi,2015-05-08 14:10:06-07:00,['0564f0c3ba2f82235925101a33c4316082c43e98'],5,23,28,20529335,6,0.5,1,1,19929
db47268f675a9c35da017bd260f77de4b96d4a6a,1,Srimanth Gunturi,2015-05-08 14:10:06-07:00,['8df37d1f7432ca43d0206c3bc4e578b6b8fc6214'],0,5,5,20529340,1,1,1,1,19929
bf9301247db36a504bc02a39ab8cc92fcca10a52,0,Andrew Onishuk,2015-05-09 00:13:01+03:00,['db47268f675a9c35da017bd260f77de4b96d4a6a'],1,1,2,20529342,1,,,,19929
1345ec71ec1cc486ca9b26fe6656c1d2a40a000d,1,Jayush Luniya,2015-05-08 14:27:19-07:00,['bf9301247db36a504bc02a39ab8cc92fcca10a52'],297,475,772,20530114,20,0.909090909,1,1,19932
562cb1270eea08387a789cc9b68b4d6f108f3940,0,Srimanth Gunturi,2015-05-08 14:29:50-07:00,['1345ec71ec1cc486ca9b26fe6656c1d2a40a000d'],52,53,105,20530219,2,,,,19932
75469235478edbf1e83377c341ad67e98aeade8a,1,Jaimin Jetly,2015-05-08 14:46:26-07:00,['562cb1270eea08387a789cc9b68b4d6f108f3940'],12,316,328,20530547,10,0.333333333,0,1,19936
23f41d8a7b2a8816ca092e695d0fe2ddf5b5216e,1,Sumit Mohanty,2015-05-08 14:49:01-07:00,['75469235478edbf1e83377c341ad67e98aeade8a'],1,24,25,20530572,4,0,0,1,19936
0f4aea1491bf239eb7a135e779274b8b6826f253,0,Aleksandr Kovalenko,2015-05-09 02:11:44+03:00,['23f41d8a7b2a8816ca092e695d0fe2ddf5b5216e'],53,3,56,20530628,4,1,0,0,19936
92f07a92a044b4da396ddf5cf3ae060924470fcf,1,Xi Wang,2015-05-08 17:07:02-07:00,['0f4aea1491bf239eb7a135e779274b8b6826f253'],364,305,669,20531297,8,0,1,1,19936
bbde6b9150374a170f711bcd257692414c2fe5b8,1,Billie Rinaldi,2015-05-08 18:18:22-07:00,['92f07a92a044b4da396ddf5cf3ae060924470fcf'],1,1,2,20531299,1,,,,19936
261f9e73c45e01b40f7bb1bd316742e3da2cb07c,1,Sumit Mohanty,2015-05-08 22:12:59-07:00,['bbde6b9150374a170f711bcd257692414c2fe5b8'],5,33,38,20531337,2,0.125,1,1,19936
02cd3ae9a98f9a3adaeba8e4c50203ca6e042755,0,Andrew Onishuk,2015-05-09 21:08:06+03:00,['261f9e73c45e01b40f7bb1bd316742e3da2cb07c'],1,1,2,20531339,1,,,,19936
3383a2f58d0f41d7e36969b35a68e9d3f5ec0713,1,Yusaku Sako,2015-05-10 09:15:41-07:00,['02cd3ae9a98f9a3adaeba8e4c50203ca6e042755'],1,1,2,20531341,1,,,,19936
4c247ba19c020e578f6d65766073751bdc9a7987,0,Yusaku Sako,2015-05-10 09:18:46-07:00,['3383a2f58d0f41d7e36969b35a68e9d3f5ec0713'],5,5,10,20531351,1,,,,19936
c415528d495bc89b3e0399289f02fdf13b74475a,1,Yusaku Sako,2015-05-10 09:25:45-07:00,['4c247ba19c020e578f6d65766073751bdc9a7987'],21,33,54,20531405,3,0.909090909,0.818181818,1,19936
b0fa86ce88ca5f88e21392c41b48ae3ab15615e9,1,Robert Levas,2015-05-11 11:10:24-04:00,['c415528d495bc89b3e0399289f02fdf13b74475a'],4,4,8,20531413,14,,,,19936
661d143b9010711a55bb3f7f903aa148425733e2,1,Alejandro Fernandez,2015-05-11 11:09:50-07:00,['b0fa86ce88ca5f88e21392c41b48ae3ab15615e9'],23,456,479,20531892,10,0.09009009,1,1,19939
714838d8a9984954377b37a2c55ba7d8a0199bb6,0,Jonathan Hurley,2015-05-11 15:30:02-04:00,['661d143b9010711a55bb3f7f903aa148425733e2'],1,1,2,20531894,1,,,,19939
d2ebd9c9ea9414a293ec73f416e9aac40c9ad48a,0,Jonathan Hurley,2015-05-11 15:30:02-04:00,['714838d8a9984954377b37a2c55ba7d8a0199bb6'],1,1,2,20531896,1,,,,19939
20161e62769797b4780df1faccd20ab8b6f9e6da,0,Jonathan Hurley,2015-05-11 15:30:02-04:00,['d2ebd9c9ea9414a293ec73f416e9aac40c9ad48a'],0,6,6,20531902,1,,,,19939
e833066e72050bed2b34cbdb00d70167a7c09835,1,Jonathan Hurley,2015-05-11 15:30:03-04:00,['20161e62769797b4780df1faccd20ab8b6f9e6da'],3064,2144,5208,20537110,103,0.730864198,0.081481481,0.064197531,19944
78bc075ffe8517a971a253dc1ce2762b58d1505a,1,Robert Levas,2015-05-11 16:02:33-04:00,['e833066e72050bed2b34cbdb00d70167a7c09835'],0,3,3,20537113,1,,,,19944
51475f2f9e8d972f0639311fd2f19b6ce55b507e,0,Jaimin Jetly,2015-05-11 13:13:15-07:00,['78bc075ffe8517a971a253dc1ce2762b58d1505a'],9,3,12,20537125,4,0.5,0,0,19944
4cf145e71b70e872e79d73c736065ae9e8167f72,1,tbeerbower,2015-05-11 16:32:13-04:00,['51475f2f9e8d972f0639311fd2f19b6ce55b507e'],108,92,200,20537325,2,0.5,0,0.5,19944
d05c9c287151b4205e1bacad25bb6235b82a1d19,1,“Erin,2015-05-11 16:37:04-04:00,['4cf145e71b70e872e79d73c736065ae9e8167f72'],0,703,703,20538028,2,,,,19946
66a4bfb26ad5ffffa59d925e56f465bec3346696,1,John Speidel,2015-05-11 17:37:03-04:00,['d05c9c287151b4205e1bacad25bb6235b82a1d19'],72,50,122,20538150,4,0.411764706,0,0,19946
3da48c232f08dea8f536356e0b0b8f6e25a0bf2b,1,Nate Cole,2015-05-11 17:43:46-04:00,['66a4bfb26ad5ffffa59d925e56f465bec3346696'],54,149,203,20538353,17,0.17721519,1,1,19946
790c211d63b4f8a1f4b21075e1a8bf5a32151744,1,Yusaku Sako,2015-05-11 15:17:51-07:00,['3da48c232f08dea8f536356e0b0b8f6e25a0bf2b'],11,34,45,20538398,6,1,1,1,19946
54fd07325399f9ce57af05a27b783c28e759cd39,1,Srimanth Gunturi,2015-05-11 15:42:49-07:00,['790c211d63b4f8a1f4b21075e1a8bf5a32151744'],2,2,4,20538402,2,,,,19946
6dfa2455088182d4d5048c6f30aec042a518b3af,1,Jayush Luniya,2015-05-11 17:39:34-07:00,['54fd07325399f9ce57af05a27b783c28e759cd39'],376,837,1213,20539615,25,1,1,0.4,19959
21442eb8fd765626e1a0284c37a15ec8a5307fb8,1,Siddharth Wagle,2015-05-11 17:49:35-07:00,['6dfa2455088182d4d5048c6f30aec042a518b3af'],78,157,235,20539850,8,0,0.380952381,1,19959
7aecacbf74e063c2039cfbfa3f973447ef8aa4bf,1,Yusaku Sako,2015-05-11 18:08:15-07:00,['21442eb8fd765626e1a0284c37a15ec8a5307fb8'],8,207,215,20540065,5,1,1,1,19962
c3690fecf23eb787901a70f077add6b1df54fd5b,1,Dmytro Sen,2015-05-12 12:12:08+03:00,['7aecacbf74e063c2039cfbfa3f973447ef8aa4bf'],2,266,268,20540333,2,0,1,0.977011494,19962
a1b19ea27f9d1cdf7999f1ce079efd29fd907b4a,1,Oleg Nechiporenko,2015-05-12 15:09:56+03:00,['c3690fecf23eb787901a70f077add6b1df54fd5b'],24,31,55,20540388,4,0,0,1,19962
3b0b2e41dc40d6621df18daefc1e8a7f2466cbed,1,Andrew Onishuk,2015-05-12 15:31:37+03:00,['a1b19ea27f9d1cdf7999f1ce079efd29fd907b4a'],1,8,9,20540397,1,0,0,1,19962
6f6c38310e230dd54f0959fa6dd55e34e7f98678,0,aBabiichuk,2015-05-12 15:57:27+03:00,['3b0b2e41dc40d6621df18daefc1e8a7f2466cbed'],0,3,3,20540400,2,1,1,1,19962
c2f35d48976aa02d73a34a56be256dbd8946fa23,1,Andrew Onishuk,2015-05-12 17:52:50+03:00,['6f6c38310e230dd54f0959fa6dd55e34e7f98678'],2144,3063,5207,20545607,104,0.245614035,0.944862155,0.932330827,19973
dd218d20b085edb1b4fc0d04164303e0b04c4bcd,1,Robert Levas,2015-05-12 10:58:50-04:00,['c2f35d48976aa02d73a34a56be256dbd8946fa23'],2,5,7,20545614,1,,,,19973
ce407e6216b0f9d4154d3bcebe10d9d21c003dd4,1,Aleksandr Kovalenko,2015-05-12 18:06:41+03:00,['dd218d20b085edb1b4fc0d04164303e0b04c4bcd'],76,123,199,20545813,4,0.235294118,0,1,19973
bb9963c7833b5441c83bbae544edea028377a2fd,1,tbeerbower,2015-05-12 11:23:49-04:00,['ce407e6216b0f9d4154d3bcebe10d9d21c003dd4'],3,6,9,20545822,2,,,,19973
e65579818b077a3c803f672c9a05203bc5c3e056,0,Andrew Onishuk,2015-05-12 18:29:22+03:00,['bb9963c7833b5441c83bbae544edea028377a2fd'],3,0,3,20545825,1,,,,19973
89cbc4594b91ba010934a2d8e15ad3810ac83728,1,Andrii Tkach,2015-05-12 18:31:41+03:00,['e65579818b077a3c803f672c9a05203bc5c3e056'],13,83,96,20545921,4,0.666666667,0.703703704,1,19973
eaaef9a1f64daf66e0934e382025d0fd694cfa96,0,Robert Levas,2015-05-12 11:42:42-04:00,['89cbc4594b91ba010934a2d8e15ad3810ac83728'],12,7,19,20545940,2,,,,19973
294268060cd35e6cdc716b7673f3ac86a2e9332c,0,Vitaly Brodetskyi,2015-05-09 02:57:05+03:00,['eaaef9a1f64daf66e0934e382025d0fd694cfa96'],1,1,2,20545942,1,,,,19973
df513801b3de4ee7901d2891a53dba4c80f0eafa,1,aBabiichuk,2015-05-12 18:49:21+03:00,['294268060cd35e6cdc716b7673f3ac86a2e9332c'],44,54,98,20546040,5,0,0,0,19973
5378bd91289e1943ff28f39a01c1c4e7981e9aba,1,Lisnichenko Dmitro,2015-05-12 20:53:59+03:00,['df513801b3de4ee7901d2891a53dba4c80f0eafa'],15,18,33,20546073,3,,,,19973
fa1303aaa6c4ac61a8f3f213dc33adf5b062b458,0,Lisnichenko Dmitro,2015-05-12 21:00:18+03:00,['5378bd91289e1943ff28f39a01c1c4e7981e9aba'],180,0,180,20546253,3,0.861111111,0.277777778,0,19973
2dcf4f3107da6c58bba68308163ea79cead04b09,1,Sumit Mohanty,2015-05-12 11:13:01-07:00,['fa1303aaa6c4ac61a8f3f213dc33adf5b062b458'],15,18,33,20546286,3,1,,0,19973
bd197161612b70739a2e6145916ce2074e63e8ab,0,Srimanth Gunturi,2015-05-12 11:39:34-07:00,['2dcf4f3107da6c58bba68308163ea79cead04b09'],0,6,6,20546292,1,,,,19973
017ae9f0e4a1e4fbe933168ca9a30499b83c5d3a,1,Siddharth Wagle,2015-05-12 12:41:31-07:00,['bd197161612b70739a2e6145916ce2074e63e8ab'],0,1,1,20546293,1,0,0,1,19973
891f668cc987165479875fe8db11d0364e873476,1,Siddharth Wagle,2015-05-12 12:55:20-07:00,['017ae9f0e4a1e4fbe933168ca9a30499b83c5d3a'],0,38,38,20546331,1,0,0,1,19973
c94780aa3e3636818e3011bede6acdf2066e3fe4,0,Dmytro Sen,2015-05-12 23:45:53+03:00,['891f668cc987165479875fe8db11d0364e873476'],4,27,31,20546362,3,0,1,1,19973
7ccaca98597f1c448096d5a1b9ace0d17a3f34c0,1,Alex Antonenko,2015-05-12 23:48:37+03:00,['c94780aa3e3636818e3011bede6acdf2066e3fe4'],10,167,177,20546539,9,1,1,0.764705882,19975
17f4eca6daccdc5b5963f15cb0811a6d11fceca6,1,Alex Antonenko,2015-05-12 23:48:37+03:00,['7ccaca98597f1c448096d5a1b9ace0d17a3f34c0'],2,2,4,20546543,1,,,,19975
81a3eebdd47c4c0179d3af2f5c45baf69a474db7,1,Alex Antonenko,2015-05-12 23:48:37+03:00,['17f4eca6daccdc5b5963f15cb0811a6d11fceca6'],37,223,260,20546803,4,0.4,1,1,19975
bd8a5f98df2ec403480122a10b1d60d38f7507cc,1,Alex Antonenko,2015-05-12 23:48:37+03:00,['81a3eebdd47c4c0179d3af2f5c45baf69a474db7'],13,17,30,20546833,8,,,,19975
f085f59e7ce04c991c36af97f5b5590fb0e9bbe3,1,Alex Antonenko,2015-05-12 23:48:37+03:00,['bd8a5f98df2ec403480122a10b1d60d38f7507cc'],1,35,36,20546869,3,1,1,0.875,19975
bcfffdb55ad182d8c816b45cd5df3fc7a13f2b74,1,Alex Antonenko,2015-05-12 23:48:37+03:00,['f085f59e7ce04c991c36af97f5b5590fb0e9bbe3'],2,68,70,20546939,2,1,1,0.695652174,19975
e6b3972f4dc28cae594c8c5719c84986e8044e30,1,Alex Antonenko,2015-05-12 23:48:37+03:00,['bcfffdb55ad182d8c816b45cd5df3fc7a13f2b74'],2,89,91,20547030,3,1,1,1,19975
6701cfc172a5cea92766a125e707ee439c0a7686,0,Billie Rinaldi,2015-05-12 13:53:42-07:00,['e6b3972f4dc28cae594c8c5719c84986e8044e30'],7,7,14,20547044,2,,,,19975
628812a16025a23f21067d1d58b1666146141538,0,Srimanth Gunturi,2015-05-12 14:38:57-07:00,['6701cfc172a5cea92766a125e707ee439c0a7686'],0,34,34,20547078,1,0.523809524,0.523809524,0.523809524,19975
4ae8d645999450b47e75663cb1212ce60d3eda6d,1,Srimanth Gunturi,2015-05-12 15:22:01-07:00,['628812a16025a23f21067d1d58b1666146141538'],21,16,37,20547115,10,,,,19975
5ba9a426e93273ba3cc0c962804f2ca4894d3224,0,Siddharth Wagle,2015-05-12 16:17:10-07:00,['4ae8d645999450b47e75663cb1212ce60d3eda6d'],6,32,38,20547153,1,0,0,1,19975
875bcfe4a4ebd78d4415d8d7ff6c2e6722a0fafb,1,Sumit Mohanty,2015-05-12 17:07:13-07:00,['5ba9a426e93273ba3cc0c962804f2ca4894d3224'],4,4,8,20547161,2,,,,19975
449818c6752eb3bdc9ba9da3255006385618ccb2,0,Jaimin Jetly,2015-05-12 17:26:00-07:00,['875bcfe4a4ebd78d4415d8d7ff6c2e6722a0fafb'],11,25,36,20547197,2,0.785714286,0,1,19975
af0debf52f576bb9736c0f73f5dae5ee36ca07a4,1,Xi Wang,2015-05-12 17:40:18-07:00,['449818c6752eb3bdc9ba9da3255006385618ccb2'],0,80,80,20547277,3,0.428571429,0.428571429,1,19975
54e22bc941f74d1fac9e07b052079a77c5dd53db,0,Jaimin Jetly,2015-05-12 17:52:09-07:00,['af0debf52f576bb9736c0f73f5dae5ee36ca07a4'],14,12,26,20547303,2,0,0,0,19975
e7fdb7146bc278aafd3d9530b7c9f824e4716cb2,1,Sumit Mohanty,2015-05-12 19:55:20-07:00,['54e22bc941f74d1fac9e07b052079a77c5dd53db'],4,160,164,20547467,6,0.256410256,0.495726496,0.52991453,19975
0b7f6a8f404511e4ead5ed93e3a4c8f362090c24,0,Dmytro Sen,2015-05-13 10:24:49+03:00,['e7fdb7146bc278aafd3d9530b7c9f824e4716cb2'],4,1,5,20547472,1,0,0,1,19975
090d8b53291ed0e011cdab109eb3fa60cefbf7dc,1,Andrew Onishuk,2015-05-13 12:42:56+03:00,['0b7f6a8f404511e4ead5ed93e3a4c8f362090c24'],2,26,28,20547500,3,0,1,1,19975
1aa1ad2927987a37685f1a11660ea0443794f292,1,Oleg Nechiporenko,2015-05-13 12:44:44+03:00,['090d8b53291ed0e011cdab109eb3fa60cefbf7dc'],27,147,174,20547674,7,0.642857143,0.678571429,0.964285714,19975
d9a834983feeb803fa7f23db18dea3d186d525fc,0,Lisnichenko Dmitro,2015-05-13 13:29:20+03:00,['1aa1ad2927987a37685f1a11660ea0443794f292'],1,1,2,20547676,1,,,,19975
9c3e5dd22c110d6ecc6fb26b211130a8efb1ffb5,1,Aleksandr Kovalenko,2015-05-13 13:46:50+03:00,['d9a834983feeb803fa7f23db18dea3d186d525fc'],36,52,88,20547764,4,0,1,1,19975
f33e5838959eb1d28f06500c0314fd2d8b595fe2,1,Artem Baranchuk,2015-05-13 15:54:05+03:00,['9c3e5dd22c110d6ecc6fb26b211130a8efb1ffb5'],341,317,658,20548422,12,0,1,1,19975
e7955140cd6c6485d63f3ebd63583b47a6c925c3,1,Nate Cole,2015-05-13 09:16:56-04:00,['f33e5838959eb1d28f06500c0314fd2d8b595fe2'],0,1,1,20548423,1,,,,19975
88947af23d601f702760954ce8d47f33fc445a8e,1,Lisnichenko Dmitro,2015-05-13 16:29:26+03:00,['e7955140cd6c6485d63f3ebd63583b47a6c925c3'],7,8,15,20548438,2,,,,19975
ed138a290a5e9f342ba40708e7b8dc68df8c701c,1,aBabiichuk,2015-05-13 16:41:59+03:00,['88947af23d601f702760954ce8d47f33fc445a8e'],35,125,160,20548598,15,0.973684211,1,1,19975
833caa343703e8d0736924c7844c3802a00e00f6,1,aBabiichuk,2015-05-13 16:42:00+03:00,['ed138a290a5e9f342ba40708e7b8dc68df8c701c'],1,3,4,20548602,2,0.5,0.5,0.5,19975
cd4f302fde9ad1d4fbcaba3a1f5040613b2cb0c9,0,“Erin,2015-05-12 12:16:42-04:00,['833caa343703e8d0736924c7844c3802a00e00f6'],0,7,7,20548609,1,,,,19975
7e4cba5cfb5b2c853a4472244ea0a5b660dcf7eb,1,Jonathan Hurley,2015-05-13 10:34:37-04:00,['cd4f302fde9ad1d4fbcaba3a1f5040613b2cb0c9'],153,641,794,20549403,52,0.229813665,0.608695652,0.99378882,19977
27f566dd7d456aa585c9ebeebfb49574d25c5679,0,Lisnichenko Dmitro,2015-05-13 17:46:35+03:00,['7e4cba5cfb5b2c853a4472244ea0a5b660dcf7eb'],89,77,166,20549569,2,1,0.625,0,19977
7edcfc4d6dac9088ad019c532916c64fe1754e73,1,Andrii Tkach,2015-05-13 18:04:37+03:00,['27f566dd7d456aa585c9ebeebfb49574d25c5679'],36,163,199,20549768,10,1,1,1,19979
df3fca0fb5b60d52bc7bbfb149e1a178f47d640c,1,Andrii Tkach,2015-05-13 18:04:38+03:00,['7edcfc4d6dac9088ad019c532916c64fe1754e73'],76,67,143,20549911,6,0.291666667,0,0,19979
c8e7c98fb3a18948cbee1d14df46d345b1890dbb,1,Bob Nettleton,2015-05-13 12:33:08-04:00,['df3fca0fb5b60d52bc7bbfb149e1a178f47d640c'],2,165,167,20550078,2,0.114583333,0.760416667,0.96875,19979
597951c1f1301d465db8c4c2fbc74cd2a283457a,1,Aleksandr Kovalenko,2015-05-13 19:34:19+03:00,['c8e7c98fb3a18948cbee1d14df46d345b1890dbb'],14,15,29,20550107,3,1,1,1,19979
43dd0cddf656bd54cda90e182786e304655b4765,1,John Speidel,2015-05-13 12:37:50-04:00,['597951c1f1301d465db8c4c2fbc74cd2a283457a'],126,987,1113,20551220,7,0.268980477,0.937093275,1,19981
868c6da5fa21d7ce31c8f531ac541df858cafcf7,1,Andrii Tkach,2015-05-13 20:09:04+03:00,['43dd0cddf656bd54cda90e182786e304655b4765'],34,22,56,20551276,5,1,0.166666667,0,19981
00c5d3fed22826622d2165325473a903de474542,1,Alex Antonenko,2015-05-13 20:32:44+03:00,['868c6da5fa21d7ce31c8f531ac541df858cafcf7'],4,4,8,20551284,4,,,,19981
4efd4ef31c70ca9a95653950039ff1f711046041,1,Aleksandr Kovalenko,2015-05-13 20:35:36+03:00,['00c5d3fed22826622d2165325473a903de474542'],1,1,2,20551286,1,,,,19981
ecfb55c8df612cb59b8c60e9d5ce26c48b69608e,1,Andrew Onishuk,2015-05-13 20:38:29+03:00,['4efd4ef31c70ca9a95653950039ff1f711046041'],35,10,45,20551331,2,1,0,0,19981
7266faea1d0e74cca337e605ec82334106f8f9db,1,Dmytro Sen,2015-05-13 20:50:27+03:00,['ecfb55c8df612cb59b8c60e9d5ce26c48b69608e'],5,171,176,20551507,4,,,,19982
a103aaa0b3813bc2067d3c9e9291acdb5c2494c3,0,Siddharth Wagle,2015-05-13 10:51:08-07:00,['7266faea1d0e74cca337e605ec82334106f8f9db'],71,316,387,20551894,3,,,,19982
db748e55544549c0fdea71356977e79d1ad5b509,1,Robert Levas,2015-05-13 14:43:50-04:00,['a103aaa0b3813bc2067d3c9e9291acdb5c2494c3'],14,22,36,20551930,3,0,0,0,19982
4232d32a19d0d77e82d73c3102fd4e08a6306255,0,Jaimin Jetly,2015-05-13 12:39:48-07:00,['db748e55544549c0fdea71356977e79d1ad5b509'],316,71,387,20552317,3,,,,19982
1db9471e78f90dd2d30167c723a5e85c70a217bc,1,Srimanth Gunturi,2015-05-13 14:28:46-07:00,['4232d32a19d0d77e82d73c3102fd4e08a6306255'],2,8,10,20552327,4,0,0.333333333,1,19982
162709a825dc6184b8d2125f6dd3d1515be36f32,1,Sumit Mohanty,2015-05-13 15:46:15-07:00,['1db9471e78f90dd2d30167c723a5e85c70a217bc'],0,4,4,20552331,1,0,0,1,19982
153895e11c48acd6c214f08b7cae9cdfbe054fb0,1,Xi Wang,2015-05-13 17:31:22-07:00,['162709a825dc6184b8d2125f6dd3d1515be36f32'],2,1,3,20552334,1,,,,19982
9fab4435c946a1c3ca1fdab196cef19b905114b7,0,Robert Levas,2015-05-13 21:05:40-04:00,['153895e11c48acd6c214f08b7cae9cdfbe054fb0'],33,0,33,20552367,3,1,1,0,19982
c20250c5c20db43fcbd71fc9f76bcce8624c3fba,1,Alejandro Fernandez,2015-05-13 20:12:39-07:00,['9fab4435c946a1c3ca1fdab196cef19b905114b7'],5,44,49,20552416,2,0,1,1,19982
8452f207d7b9343a162698f2a2b79bf2c512e9d3,1,Jaimin Jetly,2015-05-13 23:38:37-07:00,['c20250c5c20db43fcbd71fc9f76bcce8624c3fba'],18,24,42,20552458,2,1,1,1,19982
81af756ada66bd65b05b6e3443c2936a3ab8f9fb,1,Andrew Onishuk,2015-05-14 12:22:19+03:00,['8452f207d7b9343a162698f2a2b79bf2c512e9d3'],0,14,14,20552472,2,0,1,1,19982
630b501ef478d6b63226ae5b66768ac16692c3d8,1,Andrew Onishuk,2015-05-14 12:22:45+03:00,['81af756ada66bd65b05b6e3443c2936a3ab8f9fb'],4,4,8,20552480,2,,,,19982
1c4cca32291c364f1132b82e51de435ec05fc954,0,Dmytro Sen,2015-05-14 12:56:18+03:00,['630b501ef478d6b63226ae5b66768ac16692c3d8'],0,260,260,20552740,1,,,,19982
a8bbcc7766696b4e5cc241a83b158cc1b790ec2c,1,Aleksandr Kovalenko,2015-05-14 14:36:27+03:00,['1c4cca32291c364f1132b82e51de435ec05fc954'],6,30,36,20552776,8,,,,19982
b93f3aab2fb505e046b0f7ea4fdf8d470e8778a8,0,Aleksandr Kovalenko,2015-05-14 15:28:10+03:00,['a8bbcc7766696b4e5cc241a83b158cc1b790ec2c'],1,5,6,20552782,2,,,,19982
1eb5445b8f3a53ec5ba20596c6633e34607b9c42,0,Andrew Onishuk,2015-05-14 15:42:06+03:00,['b93f3aab2fb505e046b0f7ea4fdf8d470e8778a8'],0,116,116,20552898,1,,,,19982
bfbb92003a22c2307f4dc24afb40bd54f48e7c4b,1,Andrew Onishuk,2015-05-14 15:58:41+03:00,['1eb5445b8f3a53ec5ba20596c6633e34607b9c42'],0,1,1,20552899,1,0,0,1,19982
2ce23cd4ab105dca1e43ee0b709c18447d3d6aa7,1,Andrii Tkach,2015-05-14 16:51:25+03:00,['bfbb92003a22c2307f4dc24afb40bd54f48e7c4b'],3,7,10,20552909,2,1,1,1,19982
1884cd12c8e60ba6ec519bd647b937431736d4aa,0,tbeerbower,2015-05-14 09:54:51-04:00,['2ce23cd4ab105dca1e43ee0b709c18447d3d6aa7'],0,2,2,20552911,2,0.5,1,1,19982
f9cefd23197d317b0ed06c8d04ae2eb3c1667149,1,Andrew Onishuk,2015-05-14 17:02:48+03:00,['1884cd12c8e60ba6ec519bd647b937431736d4aa'],166,29,195,20553106,2,,,,19983
9c570b859470e68427c399a870af426a3062ada9,1,John Speidel,2015-05-14 11:00:12-04:00,['f9cefd23197d317b0ed06c8d04ae2eb3c1667149'],17,264,281,20553387,4,0.095238095,0.682539683,0.595238095,19984
e50a2ac31b28e90ba1cfee70bf337c65910b7ee7,1,Alejandro Fernandez,2015-05-14 10:31:10-07:00,['9c570b859470e68427c399a870af426a3062ada9'],172,4773,4945,20558332,56,0,1,0.664473684,20009
8263f2f1b5de393f2f3eeefb3fc1c4112f6da8d2,1,Vitaly Brodetskyi,2015-05-10 19:15:03+03:00,['e50a2ac31b28e90ba1cfee70bf337c65910b7ee7'],3,17,20,20558352,2,0,0,1,20009
f4a4d0d9a224d1d679dbc21286eb57a3ecb129a9,1,Jonathan Hurley,2015-05-14 13:40:40-04:00,['8263f2f1b5de393f2f3eeefb3fc1c4112f6da8d2'],21,216,237,20558589,8,0,0.444444444,0.888888889,20010
bd9672314dd5989d2f3a860aacbcc0f90dd2e658,0,Billie Rinaldi,2015-05-14 11:14:53-07:00,['f4a4d0d9a224d1d679dbc21286eb57a3ecb129a9'],11,0,11,20558600,1,,,,20010
e8ae1fac9d381016836f1e2479bc4e27617a2b54,0,Alejandro Fernandez,2015-05-14 11:40:13-07:00,['bd9672314dd5989d2f3a860aacbcc0f90dd2e658'],178,0,178,20558778,1,,,,20010
2437a799adb0906a71749adf06999ce3602861a0,1,Srimanth Gunturi,2015-05-14 12:21:43-07:00,['e8ae1fac9d381016836f1e2479bc4e27617a2b54'],0,38,38,20558816,1,1,0.724137931,0.275862069,20010
af675f47df28dec850cd603ee6ac2520bf444d1c,1,Sumit Mohanty,2015-05-14 12:40:42-07:00,['2437a799adb0906a71749adf06999ce3602861a0'],110,184,294,20559110,8,0.413043478,0,1,20010
9f93b027c82f6a421991033a8451221571ea3ded,0,Jaimin Jetly,2015-05-14 13:12:52-07:00,['af675f47df28dec850cd603ee6ac2520bf444d1c'],15,0,15,20559125,1,,,,20010
f32be8ae93609a95b84ac364b8179ee802438de3,0,Siddharth Wagle,2015-05-14 13:56:58-07:00,['9f93b027c82f6a421991033a8451221571ea3ded'],10,2,12,20559137,2,,,,20010
3d9072733908c2d0d4910e0ebe833da320b4433d,1,Srimanth Gunturi,2015-05-14 15:49:11-07:00,['f32be8ae93609a95b84ac364b8179ee802438de3'],16,29,45,20559182,4,0,0,1,20010
501afc0f58c65eaeccf6c388ae6100c2c3d31048,0,Siddharth Wagle,2015-05-14 16:07:19-07:00,['3d9072733908c2d0d4910e0ebe833da320b4433d'],9,31,40,20559222,3,0,1,1,20010
9bec90a6ac5416d6f0789af261fbabc22446693c,1,Srimanth Gunturi,2015-05-14 16:46:27-07:00,['501afc0f58c65eaeccf6c388ae6100c2c3d31048'],12,44,56,20559278,5,1,1,1,20010
9b1938fd65f9d1a7642bdb56238f172d83f2c338,0,Yusaku Sako,2015-05-14 17:00:23-07:00,['9bec90a6ac5416d6f0789af261fbabc22446693c'],45,0,45,20559323,1,,,,20010
00bd07866e558b97befda8296c40c7ac7c4d6a9a,1,sposetti,2015-05-14 20:36:13-04:00,['9b1938fd65f9d1a7642bdb56238f172d83f2c338'],1,396,397,20559720,6,0,1,1,20015
546c919ae27c9bb108765645ac6443da15c28d01,1,Xi Wang,2015-05-14 17:40:50-07:00,['00bd07866e558b97befda8296c40c7ac7c4d6a9a'],6,20,26,20559746,2,,,,20015
77bb70603d40461b12a57f27dc72ba4929f7898d,1,Xi Wang,2015-05-14 17:40:50-07:00,['546c919ae27c9bb108765645ac6443da15c28d01'],6,10,16,20559762,3,1,1,1,20015
9b6223b90f0ee5c174993cc8a9bfd17e836d907e,0,sposetti,2015-05-14 22:33:33-04:00,['77bb70603d40461b12a57f27dc72ba4929f7898d'],4,4,8,20559770,1,,,,20015
94ba7c0f9904e6c6834a36f8b4de982f86cc94c7,1,Siddharth Wagle,2015-05-14 19:58:10-07:00,['9b6223b90f0ee5c174993cc8a9bfd17e836d907e'],31,9,40,20559810,3,1,0,0,20015
5e8e7ac789ab02ca99e1ef78a21005c761d194d6,0,Alex Antonenko,2015-05-15 12:53:45+03:00,['94ba7c0f9904e6c6834a36f8b4de982f86cc94c7'],21,21,42,20559852,1,1,1,0,20015
68d02943a9d5df28587a7f89a900b4a9d746226a,1,Alex Antonenko,2015-05-15 12:53:45+03:00,['5e8e7ac789ab02ca99e1ef78a21005c761d194d6'],8,34,42,20559894,2,0,1,1,20015
8dbdf1d003b0ab62cd73a928ebe765e047072094,1,Alex Antonenko,2015-05-15 12:53:46+03:00,['68d02943a9d5df28587a7f89a900b4a9d746226a'],4,9,13,20559907,4,0.333333333,0.666666667,1,20015
3ccfc42bda19d5f2e642f81ca020674b2ca1590c,1,Alex Antonenko,2015-05-15 12:53:46+03:00,['8dbdf1d003b0ab62cd73a928ebe765e047072094'],5,37,42,20559949,3,1,1,1,20015
ea8a8046da69a266c267ef299389d43d825505ae,1,Alex Antonenko,2015-05-15 12:53:46+03:00,['3ccfc42bda19d5f2e642f81ca020674b2ca1590c'],0,366,366,20560315,1,,,,20016
d239381ebce715e56ab840a227dc32c333b7e493,1,Alex Antonenko,2015-05-15 12:53:46+03:00,['ea8a8046da69a266c267ef299389d43d825505ae'],22,27,49,20560364,4,1,1,0,20016
69e112bae1bba1c06b7165616a7b59b4f9e22ae9,1,Oleg Nechiporenko,2015-05-15 13:01:15+03:00,['d239381ebce715e56ab840a227dc32c333b7e493'],21,112,133,20560497,8,0.53,0.77,0.99,20016
8f7fb3d263057e23e6adeffcf4203e76169ba183,1,Oleg Nechiporenko,2015-05-15 13:38:24+03:00,['69e112bae1bba1c06b7165616a7b59b4f9e22ae9'],17,41,58,20560555,2,,,,20016
e10531e2720bb30f15468d19d4942c4269ee1771,1,Andrew Onishuk,2015-05-15 13:54:21+03:00,['8f7fb3d263057e23e6adeffcf4203e76169ba183'],4,4,8,20560563,1,,,,20016
c36ec90919918aeeeb5217f8280d40cc36ae0082,1,Andrew Onishuk,2015-05-15 14:03:37+03:00,['e10531e2720bb30f15468d19d4942c4269ee1771'],3,8,11,20560574,1,,,,20016
eef00a9ec7d9561eeac087d743a852e3d34d67ba,1,Lisnichenko Dmitro,2015-05-15 14:09:51+03:00,['c36ec90919918aeeeb5217f8280d40cc36ae0082'],12,33,45,20560619,5,0,1,1,20016
dfc77fb2155ee9d80b1479c0f90aec208aa2f483,1,Oleg Nechiporenko,2015-05-15 14:36:23+03:00,['eef00a9ec7d9561eeac087d743a852e3d34d67ba'],17,898,915,20561534,3,0.515402844,1,0.984597156,20016
a52976e2ba62f8ca0a8d664f9994d1e98d418c0b,1,Oleg Nechiporenko,2015-05-15 14:54:20+03:00,['dfc77fb2155ee9d80b1479c0f90aec208aa2f483'],0,1,1,20561535,1,0,0,1,20016
aea31b6b8c8e26787eeb08ab41ee59ab559364d1,1,tbeerbower,2015-05-15 09:34:57-04:00,['a52976e2ba62f8ca0a8d664f9994d1e98d418c0b'],28,78,106,20561641,9,0.260869565,1,1,20016
52d2cc421e1ce1b35366d5fd1b9ffa1ac3a0dcbf,1,Lisnichenko Dmitro,2015-05-15 16:35:36+03:00,['aea31b6b8c8e26787eeb08ab41ee59ab559364d1'],1,146,147,20561788,27,,,,20016
0fe39d5e856f43ccfca00a70b9354e8bf899e768,1,Andrii Tkach,2015-05-15 17:54:47+03:00,['52d2cc421e1ce1b35366d5fd1b9ffa1ac3a0dcbf'],70,189,259,20562047,9,0.308823529,0.602941176,0.691176471,20016
46c802daed7ec886da1a678fba4ab361b2800e3d,1,Bob Nettleton,2015-05-15 11:11:51-04:00,['0fe39d5e856f43ccfca00a70b9354e8bf899e768'],0,200,200,20562247,2,0.129411765,0.8,1,20016
9085d9ee66e6f2d174415c26213ba1ce6ec01817,1,Dmytro Sen,2015-05-15 18:13:27+03:00,['46c802daed7ec886da1a678fba4ab361b2800e3d'],34,37,71,20562318,3,0,0.5,1,20016
4ade1cd8588b385329d1570579a2a49ae2597210,1,Oleg Nechiporenko,2015-05-15 18:50:41+03:00,['9085d9ee66e6f2d174415c26213ba1ce6ec01817'],0,4,4,20562322,1,1,1,1,20016
21a74e9f890d75cfc8f5d294bceb600dc6bb46ac,1,Myroslav Papirkovskyy,2015-05-15 19:14:03+03:00,['4ade1cd8588b385329d1570579a2a49ae2597210'],15,44,59,20562381,5,0.37037037,1,0.62962963,20016
5463432a1b6cd0d8878e345843eb8f7dbb959bd6,0,Jayush Luniya,2015-05-15 09:27:28-07:00,['21a74e9f890d75cfc8f5d294bceb600dc6bb46ac'],20,100,120,20562501,5,,,,20016
e07d8c9316bcc10fe13b1f7e7ca6628edb755cb3,0,Robert Levas,2015-05-15 12:47:04-04:00,['5463432a1b6cd0d8878e345843eb8f7dbb959bd6'],2,2,4,20562505,1,,,,20016
c8ac13489d5c01aacc826b5aa58a560008f3c5d4,1,Alex Antonenko,2015-05-15 20:43:38+03:00,['e07d8c9316bcc10fe13b1f7e7ca6628edb755cb3'],13,532,545,20563050,8,0.936479129,1,1,20018
b85c6faf23d4068365f0e389a82c2b4ad78833ae,0,Alex Antonenko,2015-05-15 20:49:27+03:00,['c8ac13489d5c01aacc826b5aa58a560008f3c5d4'],5,0,5,20563055,1,,,,20018
aedb50c0eb64c29833bfd956d5f4680049666419,1,Alex Antonenko,2015-05-15 20:53:04+03:00,['b85c6faf23d4068365f0e389a82c2b4ad78833ae'],1,7,8,20563063,2,0,1,1,20018
59f15b2ac55d6e92212a8c9a7afae7565633df46,1,Jonathan Hurley,2015-05-15 14:56:25-04:00,['aedb50c0eb64c29833bfd956d5f4680049666419'],51,197,248,20563311,6,0,0.892857143,1,20019
a736f5ce6fbd97e7723f7c291a0928f93a7724a8,0,Srimanth Gunturi,2015-05-15 13:15:14-07:00,['59f15b2ac55d6e92212a8c9a7afae7565633df46'],2,1,3,20563314,2,,,,20019
6ce1ae551e8dcdf083c86ffa86a8bae96dab0513,0,Jonathan Hurley,2015-05-15 17:41:21-04:00,['a736f5ce6fbd97e7723f7c291a0928f93a7724a8'],4,4,8,20563322,1,,,,20019
fe3d6b2216233e80f121a25c5ef28d11eebe371a,1,Yusaku Sako,2015-05-15 15:21:03-07:00,['6ce1ae551e8dcdf083c86ffa86a8bae96dab0513'],0,11,11,20563333,1,,,,20019
16ce5aef628ef78842046d6e6b7f74f41a794bbf,1,Florian Barca,2015-05-15 16:08:18-07:00,['fe3d6b2216233e80f121a25c5ef28d11eebe371a'],84,137,221,20563554,2,,,,20019
0ce9c074434cca40e5fbc9d022fbe76be3409926,0,Mahadev Konar,2015-05-15 16:38:44-07:00,['16ce5aef628ef78842046d6e6b7f74f41a794bbf'],0,8,8,20563562,1,,,,20019
7e4f57b16493cf6df1ef68a1270bfcec8e9df48c,1,Alejandro Fernandez,2015-05-15 17:59:09-07:00,['0ce9c074434cca40e5fbc9d022fbe76be3409926'],25,152,177,20563739,3,0.461538462,1,0.707692308,20019
e5e1c3d79773027ba7fa39fccb84083dd080c6ef,1,Jonathan Hurley,2015-05-15 21:13:52-04:00,['7e4f57b16493cf6df1ef68a1270bfcec8e9df48c'],34,116,150,20563889,17,0.944444444,1,0.5,20019
8cd295c10e935b49e7669a23d4ccdfeeab84188d,0,Oleg Nechiporenko,2015-05-16 12:49:11+03:00,['e5e1c3d79773027ba7fa39fccb84083dd080c6ef'],7,8,15,20563904,2,0,0,0,20019
45822d24765b913f07f28828956508ed09f37258,0,Artem Baranchuk,2015-05-16 16:29:22+03:00,['8cd295c10e935b49e7669a23d4ccdfeeab84188d'],18,0,18,20563922,5,0,0,0,20019
9a4b24cb2f6973fed229365253afc4dda8994c45,0,Artem Baranchuk,2015-05-16 16:29:23+03:00,['45822d24765b913f07f28828956508ed09f37258'],11,25,36,20563958,3,,,,20019
a15e75c1f0a6ea6195c7487382d5aac6c9c22053,1,Andrew Onishuk,2015-05-16 20:25:38+03:00,['9a4b24cb2f6973fed229365253afc4dda8994c45'],2,21,23,20563981,2,0,0.933333333,0.933333333,20019
fcbde3243792a49a269ded9fd8d64638d71a0b5e,0,tbeerbower,2015-05-16 15:26:42-04:00,['a15e75c1f0a6ea6195c7487382d5aac6c9c22053'],0,41,41,20564022,2,1,1,1,20019
e205bd15d6c50bbcab00062a6d7157b51bff2b32,1,Alex Antonenko,2015-05-16 23:45:43+03:00,['fcbde3243792a49a269ded9fd8d64638d71a0b5e'],10,29,39,20564061,2,0.769230769,0.384615385,0.769230769,20019
88294bb09fbb047cdfee7a256d241805cc2bd7e3,1,Alex Antonenko,2015-05-16 23:45:43+03:00,['e205bd15d6c50bbcab00062a6d7157b51bff2b32'],2,14,16,20564077,2,,,,20019
423df959179db4ebedec9a79c1181fda6544adfc,1,Mahadev Konar,2015-05-16 14:26:48-07:00,['88294bb09fbb047cdfee7a256d241805cc2bd7e3'],2,2,4,20564081,1,,,,20019
094c56ef31f7fb29feae928799c20893175e18c4,0,Jonathan Hurley,2015-05-16 18:44:05-04:00,['423df959179db4ebedec9a79c1181fda6544adfc'],0,6,6,20564087,1,,,,20019
c23de40d31d807ed9bde8e6c8d53a68b83a6f118,1,Nate Cole,2015-05-16 20:18:35-04:00,['094c56ef31f7fb29feae928799c20893175e18c4'],63,437,500,20564587,19,0,0.828451883,0.489539749,20019
45f0cd3f870a41dea9a185d85c577bb71aa918f6,1,Yusaku Sako,2015-05-17 06:04:57-07:00,['c23de40d31d807ed9bde8e6c8d53a68b83a6f118'],1,43,44,20564631,2,0.36,1,1,20019
79f3d96e6ef3b7168c67f3f07ad523379bab154b,1,Dmytro Sen,2015-05-17 17:51:09+03:00,['45f0cd3f870a41dea9a185d85c577bb71aa918f6'],1,1,2,20564633,1,,,,20019
3839cd8f889d3e7da5e86e5853d44858bab0b64c,1,Andrew Onishuk,2015-05-17 21:02:19+03:00,['79f3d96e6ef3b7168c67f3f07ad523379bab154b'],128,199,327,20564960,5,1,1,0.88,20019
88ea1d8b3cf4899b973dc4f619bc5905c1481129,0,Mahadev Konar,2015-05-17 11:31:23-07:00,['3839cd8f889d3e7da5e86e5853d44858bab0b64c'],1,1,2,20564962,1,,,,20019
67c65aba9f89ffa6ec87a060768aeda3c8ea6217,1,Jayush Luniya,2015-05-17 11:33:11-07:00,['88ea1d8b3cf4899b973dc4f619bc5905c1481129'],0,25,25,20564987,3,0,0.714285714,0.857142857,20019
421770b27048fedfdfbff7c9f659e5f1ade387b7,1,Jaimin Jetly,2015-05-17 12:41:05-07:00,['67c65aba9f89ffa6ec87a060768aeda3c8ea6217'],23,303,326,20565313,5,0.257142857,0.93877551,1,20020
6b873569d1808c5aca7f60ab3aac913e3b50960a,1,Jaimin Jetly,2015-05-17 13:29:26-07:00,['421770b27048fedfdfbff7c9f659e5f1ade387b7'],71,242,313,20565626,4,0,1,1,20020
df69e99664648cbb49ce8bf5345ac37904b5a19d,1,Alejandro Fernandez,2015-05-17 13:48:48-07:00,['6b873569d1808c5aca7f60ab3aac913e3b50960a'],1,1,2,20565628,1,,,,20020
55b6f7858253e870d9ba5d37ce6d432f25f78a65,1,Alex Antonenko,2015-05-18 02:47:10+03:00,['df69e99664648cbb49ce8bf5345ac37904b5a19d'],22,10,32,20565660,4,0,0,1,20020
28cb5fb2ff66416db02de25893117e102dd78500,1,Robert Levas,2015-05-17 20:08:33-04:00,['55b6f7858253e870d9ba5d37ce6d432f25f78a65'],3,3,6,20565666,1,,,,20020
a01d92b18cb0f1a2e1f526702707ce3edf0bdf11,0,Florian Barca,2015-05-18 05:34:46-07:00,['28cb5fb2ff66416db02de25893117e102dd78500'],1,9,10,20565676,2,1,1,1,20020
736696ba1532e1f23e293e5948fb541b0393cb68,1,Andrii Tkach,2015-05-18 16:24:25+03:00,['a01d92b18cb0f1a2e1f526702707ce3edf0bdf11'],50,339,389,20566065,3,0.778787879,1,0.981818182,20020
b950812eb89cd0571aea16a12dc9dee8653fb883,1,Florian Barca,2015-05-18 06:29:23-07:00,['736696ba1532e1f23e293e5948fb541b0393cb68'],4,7,11,20566076,3,1,1,1,20020
7389c57f75c5b09b78a319b946aaaca69bc9f643,1,Andrew Onishuk,2015-05-18 17:13:18+03:00,['b950812eb89cd0571aea16a12dc9dee8653fb883'],0,15,15,20566091,7,0,0.933333333,1,20020
b7ddf8287bfd4b409478e9ccaf8001d413886583,0,Oleg Nechiporenko,2015-05-18 18:01:45+03:00,['7389c57f75c5b09b78a319b946aaaca69bc9f643'],1,3,4,20566095,3,,,,20020
2dd80b90379663265e5e1001b32f18f1c6be23ee,0,Robert Levas,2015-05-18 11:17:03-04:00,['b7ddf8287bfd4b409478e9ccaf8001d413886583'],11,1,12,20566107,2,,,,20020
49ecd6b2e9ad872a47324960150157e6d928e17f,1,Andrew Onishuk,2015-05-18 19:08:50+03:00,['2dd80b90379663265e5e1001b32f18f1c6be23ee'],79,79,158,20566265,6,0,0.833333333,0.166666667,20020
07616603c4388c0a9c1dc769659de92edb64b2cb,1,aBabiichuk,2015-05-18 19:10:40+03:00,['49ecd6b2e9ad872a47324960150157e6d928e17f'],1653,1079,2732,20568997,61,0.424615385,0.098461538,0.129230769,20020
b19cee16915f28b95deef881c1b520cb1b2458ee,1,Oleg Nechiporenko,2015-05-18 20:11:45+03:00,['07616603c4388c0a9c1dc769659de92edb64b2cb'],19,26,45,20569042,3,0.384615385,0.384615385,1,20020
efbc665c783b40ee0c2a465597cd0d601ab248a8,0,Myroslav Papirkovskyy,2015-05-18 20:21:29+03:00,['b19cee16915f28b95deef881c1b520cb1b2458ee'],25,0,25,20569067,1,,,,20020
3c4e9111ef95015ab4a365b08008ee5e6ec08b72,1,Myroslav Papirkovskyy,2015-05-18 20:21:29+03:00,['efbc665c783b40ee0c2a465597cd0d601ab248a8'],7,103,110,20569177,6,0.933333333,1,1,20021
ef40b86f5588a0c7f21e4c2830d000e25163267f,1,Bob Nettleton,2015-05-18 13:55:40-04:00,['3c4e9111ef95015ab4a365b08008ee5e6ec08b72'],17,239,256,20569433,4,0.325581395,1,1,20021
220a5a27196ca0d0d8e98d95c47a76f377b24282,0,Andrew Onishuk,2015-05-18 21:34:11+03:00,['ef40b86f5588a0c7f21e4c2830d000e25163267f'],11,937,948,20570381,10,,,,20023
2015be59acced0845a614e68bba3ed97a2552af7,1,Nate Cole,2015-05-18 15:27:21-04:00,['220a5a27196ca0d0d8e98d95c47a76f377b24282'],5,40,45,20570426,3,0.090909091,0.090909091,0.090909091,20023
8b0c964a89ffd4d352d0deac0756923242a252e9,1,Siddharth Wagle,2015-05-18 13:07:06-07:00,['2015be59acced0845a614e68bba3ed97a2552af7'],74,290,364,20570790,8,0.014084507,0.73943662,0.450704225,20023
67ca6364d5917eba79fd2ead5ba0df6ba876f631,1,Jonathan Hurley,2015-05-18 16:30:32-04:00,['8b0c964a89ffd4d352d0deac0756923242a252e9'],68,105,173,20570963,8,0,0,1,20023
514a4d8d15b2ea5c534cd016433f474c427c1d35,0,Jonathan Hurley,2015-05-18 16:35:11-04:00,['67ca6364d5917eba79fd2ead5ba0df6ba876f631'],10,0,10,20570973,3,0,0,0,20023
cf0877cea1cbc5de42c89a342924f5081db8e3f7,0,Jonathan Hurley,2015-05-18 16:53:52-04:00,['514a4d8d15b2ea5c534cd016433f474c427c1d35'],937,11,948,20571921,10,,,,20023
747e5ba2398e16022ddf2d6af3bb7a2f67f9183a,0,tbeerbower,2015-05-18 17:20:19-04:00,['cf0877cea1cbc5de42c89a342924f5081db8e3f7'],1,35,36,20571957,2,0.818181818,0.818181818,1,20023
871667c36043bcfabf8e4b9d97248738ab0f0e3d,0,Alejandro Fernandez,2015-05-18 14:22:50-07:00,['747e5ba2398e16022ddf2d6af3bb7a2f67f9183a'],1,1,2,20571959,1,,,,20023
14bb3012597d6463ec375c6a86b7039b43ee4278,0,Bob Nettleton,2015-05-18 17:51:18-04:00,['871667c36043bcfabf8e4b9d97248738ab0f0e3d'],15,3,18,20571977,5,,,,20023
6971baebb976d1b316e75a74a88c39350c79b956,1,John Speidel,2015-05-18 18:00:49-04:00,['14bb3012597d6463ec375c6a86b7039b43ee4278'],7,167,174,20572151,2,0.285714286,1,1,20024
2932476fb031e0b2b0749a96c66d7e0835b21382,1,Xi Wang,2015-05-18 15:13:24-07:00,['6971baebb976d1b316e75a74a88c39350c79b956'],1,2,3,20572154,1,,,,20024
7fba253156e6899ebc46bb9fdcb2cbfe2a079e47,1,Yusaku Sako,2015-05-18 15:57:17-07:00,['2932476fb031e0b2b0749a96c66d7e0835b21382'],7,68,75,20572229,4,1,1,1,20024
e698e38d73f2b12b1c9f2c07d9f02710d70de1ec,1,Xi Wang,2015-05-18 17:21:11-07:00,['7fba253156e6899ebc46bb9fdcb2cbfe2a079e47'],2,6,8,20572237,1,,,,20024
afe427a0f5365e5d9343ddda90085cd9997a0a48,1,Yusaku Sako,2015-05-18 21:45:23-07:00,['e698e38d73f2b12b1c9f2c07d9f02710d70de1ec'],10,10,20,20572257,2,,,,20024
2e64b3b9f71d3681b6c37ab5e7b39087c989a306,1,Lisnichenko Dmitro,2015-05-19 12:30:28+03:00,['afe427a0f5365e5d9343ddda90085cd9997a0a48'],60,42,102,20572359,10,0.75,0.9,1,20024
558925301b22a06f5b7b35b84f68588e904703b4,1,Oleg Nechiporenko,2015-05-19 12:48:37+03:00,['2e64b3b9f71d3681b6c37ab5e7b39087c989a306'],7,8,15,20572374,3,0.5,1,1,20024
3441765407ee544f80e97fa9ebe3de2e2f9ccb71,1,aBabiichuk,2015-05-19 13:08:00+03:00,['558925301b22a06f5b7b35b84f68588e904703b4'],6,8,14,20572388,2,0,0,1,20024
fddbaf4ddf2cbac63ca629d44e41ae8e56a0fec9,0,aBabiichuk,2015-05-19 13:08:18+03:00,['3441765407ee544f80e97fa9ebe3de2e2f9ccb71'],2,3,5,20572393,1,1,1,1,20024
211c78bbbae794a0c5d7fdb04327bf2960bb96ea,1,Artem Baranchuk,2015-05-19 14:24:23+03:00,['fddbaf4ddf2cbac63ca629d44e41ae8e56a0fec9'],2,60,62,20572455,5,0.125,0.28125,1,20024
27a228977c02860926ae71d90395b6dde5b16517,1,Robert Levas,2015-05-19 09:35:23-04:00,['211c78bbbae794a0c5d7fdb04327bf2960bb96ea'],44,163,207,20572662,2,0.067226891,0.840336134,1,20024
e3d5fd61864872121f994e769e8a7e4e496912c1,0,tbeerbower,2015-05-19 10:06:59-04:00,['27a228977c02860926ae71d90395b6dde5b16517'],1,12,13,20572675,2,0,1,1,20024
7e8d3dea89a9ff80f7e7e315498f71ff97c521b2,0,Lisnichenko Dmitro,2015-05-19 18:51:55+03:00,['e3d5fd61864872121f994e769e8a7e4e496912c1'],3,4,7,20572682,2,,1,,20024
21fde676532f4073e7e089e8e1780412f827a949,1,Andrew Onishuk,2015-05-19 19:04:25+03:00,['7e8d3dea89a9ff80f7e7e315498f71ff97c521b2'],42,138,180,20572862,7,0.594594595,1,0.189189189,20025
1ee56761efaa9e049f37ff81cdbc69a096b0e494,0,Jonathan Hurley,2015-05-19 13:34:28-04:00,['21fde676532f4073e7e089e8e1780412f827a949'],11,937,948,20573810,10,,,,20027
15616fd67c76360d9364a23ab9efdc01a809ea92,1,Oleg Nechiporenko,2015-05-19 22:03:55+03:00,['1ee56761efaa9e049f37ff81cdbc69a096b0e494'],29,69,98,20573908,11,0.536585366,0.682926829,1,20027
8a7c54c6334b986bada53965d9512d79d951a7dc,0,Dmytro Sen,2015-05-19 22:06:59+03:00,['15616fd67c76360d9364a23ab9efdc01a809ea92'],78,143,221,20574129,15,0,0.526315789,0.929824561,20027
824bc8b6a45682638147d24197cdf106c4fe96c5,0,Siddharth Wagle,2015-05-19 12:56:06-07:00,['8a7c54c6334b986bada53965d9512d79d951a7dc'],2,131,133,20574262,5,0.071428571,0.846938776,0.846938776,20027
2e0fd3d897f807f3086d7390d1c0af6fc3704fad,1,tbeerbower,2015-05-19 16:28:55-04:00,['824bc8b6a45682638147d24197cdf106c4fe96c5'],51,324,375,20574637,11,0.327102804,1,0.738317757,20027
cb8308064bd5851f449fe0be19ee8b72aba9e848,0,Alex Antonenko,2015-05-19 23:30:19+03:00,['2e0fd3d897f807f3086d7390d1c0af6fc3704fad'],1,1,2,20574639,1,,,,20027
3fa6a25252bc1359bbb40ff4bef2238d56d9103b,1,Alex Antonenko,2015-05-19 23:30:19+03:00,['cb8308064bd5851f449fe0be19ee8b72aba9e848'],1,3,4,20574643,1,1,1,1,20027
b1980207eb6e33cbedc536b576838126510471c6,1,Alex Antonenko,2015-05-19 23:30:19+03:00,['3fa6a25252bc1359bbb40ff4bef2238d56d9103b'],2,2,4,20574647,2,,,,20027
8f82a1a0dee185236acdc434f47f52ef1ff2ee28,1,Alex Antonenko,2015-05-19 23:30:19+03:00,['b1980207eb6e33cbedc536b576838126510471c6'],1,20,21,20574668,3,,,,20027
1b7afa940a98dbf83580a14d585dd672cff95584,1,Sumit Mohanty,2015-05-19 15:00:38-07:00,['8f82a1a0dee185236acdc434f47f52ef1ff2ee28'],0,1,1,20574669,1,,,,20027
7290fa0c2a6a11a2e3fac13e7834eead89b9e854,1,Alejandro Fernandez,2015-05-19 15:05:15-07:00,['1b7afa940a98dbf83580a14d585dd672cff95584'],93,145,238,20574907,28,,,,20027
d37bef923bbcee87c1eae1abbe9420e752df7a01,1,Xi Wang,2015-05-19 15:07:20-07:00,['7290fa0c2a6a11a2e3fac13e7834eead89b9e854'],2,8,10,20574917,4,1,1,1,20027
be383cf3dd37e076b5226357babbd1f51cc4b7d7,1,Florian Barca,2015-05-19 15:36:59-07:00,['d37bef923bbcee87c1eae1abbe9420e752df7a01'],143,78,221,20575138,15,1,0.473684211,0.070175439,20027
6a3c1e3405fd1d030a8537d31137bd8ffba79646,1,Jaimin Jetly,2015-05-19 17:25:05-07:00,['be383cf3dd37e076b5226357babbd1f51cc4b7d7'],15,28,43,20575181,7,1,1,1,20027
d42c2113d8dbccb122eb944a2fd4e38e60024e02,1,Sumit Mohanty,2015-05-19 18:02:45-07:00,['6a3c1e3405fd1d030a8537d31137bd8ffba79646'],2,2,4,20575185,2,,,,20027
c05d2389fda7514b7fa486c64f4b8daa6a32dde5,0,Xi Wang,2015-05-19 18:15:08-07:00,['d42c2113d8dbccb122eb944a2fd4e38e60024e02'],0,1,1,20575186,1,,,,20027
74d2d234e7d74e16afbc9df3ace0754d5e80df8f,1,Sumit Mohanty,2015-05-19 19:02:23-07:00,['c05d2389fda7514b7fa486c64f4b8daa6a32dde5'],5,10,15,20575201,3,1,1,0.8,20027
e26e8ee5eeafd18ed25a9bf424b573ee27ccdc33,1,Alejandro Fernandez,2015-05-19 20:14:55-07:00,['74d2d234e7d74e16afbc9df3ace0754d5e80df8f'],1,31,32,20575233,3,,,,20028
c9b6c7874ea04c58cce39833f1740c4456f5c9d4,1,Srimanth Gunturi,2015-05-19 21:01:07-07:00,['e26e8ee5eeafd18ed25a9bf424b573ee27ccdc33'],4,25,29,20575262,2,0,1,1,20028
15000e5057d0c072fbd5d6b1e40fe9e8b0300f61,1,Jonathan Hurley,2015-05-20 00:46:20-04:00,['c9b6c7874ea04c58cce39833f1740c4456f5c9d4'],161,346,507,20575769,11,0,0.652892562,1,20028
29410e60a1ec98f5779fd6fcd570de8c83df6490,0,Jonathan Hurley,2015-05-20 01:14:35-04:00,['15000e5057d0c072fbd5d6b1e40fe9e8b0300f61'],3,4,7,20575776,1,,,,20028
f97890f952d48672563808824a26f31448c3e535,1,Andrew Onishuk,2015-05-20 12:33:31+03:00,['29410e60a1ec98f5779fd6fcd570de8c83df6490'],937,11,948,20576724,10,,,,20028
3761bda7cb54e7cfe90e0046f99345337f55c6d1,1,Andrew Onishuk,2015-05-20 14:14:17+03:00,['f97890f952d48672563808824a26f31448c3e535'],136,147,283,20577007,9,0,0,0,20028
44b6e7b979df43dbea7d648a92f4e2b44fa02d05,1,Dmytro Sen,2015-05-20 15:26:10+03:00,['3761bda7cb54e7cfe90e0046f99345337f55c6d1'],79,144,223,20577230,15,0,0.526315789,0.929824561,20028
444faa1e9bf5005ac26b1deccb727ac0a55bf5da,1,tbeerbower,2015-05-20 09:27:46-04:00,['44b6e7b979df43dbea7d648a92f4e2b44fa02d05'],7,24,31,20577261,4,0,0,0.846153846,20028
ce8f5aaa0bfbdc48f71140cd89c47d3aa7869dcf,0,Robert Levas,2015-05-20 09:28:07-04:00,['444faa1e9bf5005ac26b1deccb727ac0a55bf5da'],4,15,19,20577280,2,,,,20028
990193e97c99917b2c072d0691f634b155306c8e,1,Robert Levas,2015-05-20 10:15:52-04:00,['ce8f5aaa0bfbdc48f71140cd89c47d3aa7869dcf'],15,4,19,20577299,2,,,,20028
91c628dade3f96d5a45567def9df6b6acb07d8a5,1,Robert Levas,2015-05-20 10:45:18-04:00,['990193e97c99917b2c072d0691f634b155306c8e'],5,23,28,20577327,4,,,,20028
f24ae8c0b241770d7a281cd5f6cbc79c88cd1406,1,Andrii Tkach,2015-05-20 17:50:55+03:00,['91c628dade3f96d5a45567def9df6b6acb07d8a5'],27,240,267,20577594,4,0.738461538,1,1,20029
3c673e8e20736348b3879337830e23350a98dca8,1,Aleksandr Kovalenko,2015-05-20 18:16:03+03:00,['f24ae8c0b241770d7a281cd5f6cbc79c88cd1406'],4,6,10,20577604,3,0.5,0.5,1,20029
943389d335f6340ac9ae22fbc576c58a06012995,0,Srimanth Gunturi,2015-05-20 09:04:38-07:00,['3c673e8e20736348b3879337830e23350a98dca8'],2,0,2,20577606,1,,,,20029
111bc4dfe16ab59e94eb1f939e76e793d9d53258,0,Alex Antonenko,2015-05-20 19:18:01+03:00,['943389d335f6340ac9ae22fbc576c58a06012995'],0,0,0,20577606,2,,,,20029
95157fadbed1a8895cd90a4b83c9a9032f3a9a15,1,Jonathan Hurley,2015-05-20 12:22:58-04:00,['111bc4dfe16ab59e94eb1f939e76e793d9d53258'],6,4,10,20577616,1,,,,20029
b21f48299ccaa46f9a092d56d728221d8814f6c3,1,Dmytro Sen,2015-05-20 19:24:09+03:00,['95157fadbed1a8895cd90a4b83c9a9032f3a9a15'],6,25,31,20577647,4,0,0.55,0.55,20029
440f5c7757d3fd433ce899a83e3fb75d611e771d,1,Artem Baranchuk,2015-05-20 19:36:54+03:00,['b21f48299ccaa46f9a092d56d728221d8814f6c3'],6,9,15,20577662,2,1,1,1,20029
6a3fe547286dd56b917c9608396ca58fb7572a00,1,Artem Baranchuk,2015-05-20 19:36:55+03:00,['440f5c7757d3fd433ce899a83e3fb75d611e771d'],0,2,2,20577664,1,,,,20029
832f3b9c3dc64997e1a5dbccc585d9acb3e3591c,1,Dmytro Sen,2015-05-20 19:38:26+03:00,['6a3fe547286dd56b917c9608396ca58fb7572a00'],2,2,4,20577668,1,,,,20029
9647b3980ed06771f5c9a38665e4fc959892967b,0,Andrew Onishuk,2015-05-20 19:46:09+03:00,['832f3b9c3dc64997e1a5dbccc585d9acb3e3591c'],1,1,2,20577670,1,,,,20029
e70733ae2e990593be5dc860e12b2b2390129638,0,Andrew Onishuk,2015-05-20 19:50:57+03:00,['9647b3980ed06771f5c9a38665e4fc959892967b'],24,0,24,20577694,1,,,,20029
461b374efee9e1e1a4e2ec2fb6ad763b82e9c62a,1,Andrew Onishuk,2015-05-20 19:59:03+03:00,['e70733ae2e990593be5dc860e12b2b2390129638'],348,331,679,20578373,31,1,0,0,20029
6c7f47c3601fca103c5ec551727a1a745272410c,0,Robert Levas,2015-05-20 13:01:23-04:00,['461b374efee9e1e1a4e2ec2fb6ad763b82e9c62a'],256,38,294,20578667,7,1,0.264285714,0,20029
a40b2b69187baec4db721386243cda3a3aba715e,1,Alex Antonenko,2015-05-20 20:04:55+03:00,['6c7f47c3601fca103c5ec551727a1a745272410c'],6,6,12,20578679,2,,,,20029
64ed815a844412a63c05eac692a762c1245e6652,1,Robert Levas,2015-05-20 13:31:06-04:00,['a40b2b69187baec4db721386243cda3a3aba715e'],38,256,294,20578973,7,0,0.735714286,1,20029
dac2f08c655991ec04160875ed94f37be2bf5fca,1,Robert Levas,2015-05-20 13:31:06-04:00,['64ed815a844412a63c05eac692a762c1245e6652'],240,438,678,20579651,8,0.075757576,0.333333333,1,20031
c7a0ca812ce7daea0bb8ee06c06881ba14c87f1f,1,Srimanth Gunturi,2015-05-20 10:35:03-07:00,['dac2f08c655991ec04160875ed94f37be2bf5fca'],6,19,25,20579676,3,1,1,1,20031
c4d452900f5fb8c2efe818bf74a68c409956497f,1,Srimanth Gunturi,2015-05-20 10:42:00-07:00,['c7a0ca812ce7daea0bb8ee06c06881ba14c87f1f'],5,2,7,20579683,2,,,,20031
d1e4b6b0125022a8a7f382d1cd007a9d8f0aec7e,0,Oleg Nechiporenko,2015-05-20 20:48:44+03:00,['c4d452900f5fb8c2efe818bf74a68c409956497f'],4,3,7,20579690,3,0,0,0,20031
ef5929ec9d7717ee5bec1f84139673cddd06421e,0,Xi Wang,2015-05-20 11:02:09-07:00,['d1e4b6b0125022a8a7f382d1cd007a9d8f0aec7e'],2,7,9,20579699,1,1,1,1,20031
932855f9a4d50ae3f2ed1ccd99ba4b9c1dfb33f5,1,Aleksandr Kovalenko,2015-05-20 21:07:23+03:00,['ef5929ec9d7717ee5bec1f84139673cddd06421e'],0,1,1,20579700,1,,,,20031
e9e8c4eff188f7ffdd78558d6f618bf7e9924423,1,Alex Antonenko,2015-05-20 21:10:20+03:00,['932855f9a4d50ae3f2ed1ccd99ba4b9c1dfb33f5'],0,212,212,20579912,5,0.362573099,0.935672515,1,20031
f5f2a64553e1d21d2accf698c10ee89b12f64a0b,1,Alex Antonenko,2015-05-20 21:10:20+03:00,['e9e8c4eff188f7ffdd78558d6f618bf7e9924423'],4,7,11,20579923,3,,,,20031
aeb11c93f92b28b319772a649884fc039410246d,1,Alex Antonenko,2015-05-20 21:17:22+03:00,['f5f2a64553e1d21d2accf698c10ee89b12f64a0b'],1,1,2,20579925,1,,,,20031
80e2477317b2f11b3635872014604a258044288c,1,John Speidel,2015-05-20 16:44:25-04:00,['aeb11c93f92b28b319772a649884fc039410246d'],103,209,312,20580237,10,1,1,0,20031
e733b72ddad169987f88c465161738949e24ac26,1,Jaimin Jetly,2015-05-20 16:18:19-07:00,['80e2477317b2f11b3635872014604a258044288c'],41,51,92,20580329,3,1,1,0.666666667,20031
544c74e72dd3d4be0fa30812d53a18989ad9650e,1,Srimanth Gunturi,2015-05-20 17:15:37-07:00,['e733b72ddad169987f88c465161738949e24ac26'],2,15,17,20580346,3,0,0.333333333,0.333333333,20031
045d612efd2488145db07ee8966f802e90b03d26,1,Jayush Luniya,2015-05-20 17:29:15-07:00,['544c74e72dd3d4be0fa30812d53a18989ad9650e'],264,828,1092,20581438,11,0.106060606,0.848484848,0.924242424,20036
9d99580050a3778a265e0164cb35434b46b72fc0,1,Jayush Luniya,2015-05-20 18:16:04-07:00,['045d612efd2488145db07ee8966f802e90b03d26'],6,28,34,20581472,4,0,1,1,20036
3703a8aa40ef7265a662396da273ccf8287a2990,1,aBabiichuk,2015-05-21 13:09:56+03:00,['9d99580050a3778a265e0164cb35434b46b72fc0'],16,25,41,20581513,4,1,1,1,20036
101be8eb3498c770c8e642ef7cafd04569b3b23c,0,aBabiichuk,2015-05-21 13:13:37+03:00,['3703a8aa40ef7265a662396da273ccf8287a2990'],0,1,1,20581514,1,0,0,1,20036
6bb70cc4aad6f4d96bfbe5b086e78dac5bf17166,1,Oleg Nechiporenko,2015-05-21 14:25:07+03:00,['101be8eb3498c770c8e642ef7cafd04569b3b23c'],93,133,226,20581740,8,0.958333333,1,1,20036
4b528d191fc924d1effdc6b4eb9c4bff1e4afc97,1,Andrii Tkach,2015-05-21 14:52:48+03:00,['6bb70cc4aad6f4d96bfbe5b086e78dac5bf17166'],6,4,10,20581750,3,0,0,0,20036
0cd4aaa15cce3ddf264df1a8f9790bda4e0ed01f,1,Andrii Tkach,2015-05-21 14:52:49+03:00,['4b528d191fc924d1effdc6b4eb9c4bff1e4afc97'],4,5,9,20581759,4,1,1,1,20036
46d142795bc4d1fabd61b9148ef822e35a8461dd,1,Nate Cole,2015-05-21 08:39:15-04:00,['0cd4aaa15cce3ddf264df1a8f9790bda4e0ed01f'],51,38,89,20581848,8,,,,20036
6f3617353498fdf306eab36a3e5ee1fba93f90d2,1,aBabiichuk,2015-05-21 15:57:17+03:00,['46d142795bc4d1fabd61b9148ef822e35a8461dd'],9,54,63,20581911,3,0.05,0.05,1,20036
78b4450e38512aab609478e8da980ded00795526,1,Billie Rinaldi,2015-05-21 06:30:38-07:00,['6f3617353498fdf306eab36a3e5ee1fba93f90d2'],1,1537,1538,20583449,4,,,,20038
b8eccc7e8d18a4e6591ad0fb7e81f2bb85956a95,1,Jonathan Hurley,2015-05-21 09:48:53-04:00,['78b4450e38512aab609478e8da980ded00795526'],3,229,232,20583681,5,0.486111111,1,1,20040
ce9f4f091b90af33c428c550519825c391649911,1,Oleg Nechiporenko,2015-05-21 17:27:27+03:00,['b8eccc7e8d18a4e6591ad0fb7e81f2bb85956a95'],43,10,53,20583734,4,0.03030303,0,0,20040
f592dbe39a44e85f6a514dc87cb71961146b15e3,1,Dmytro Sen,2015-05-21 17:56:09+03:00,['ce9f4f091b90af33c428c550519825c391649911'],33,89,122,20583856,2,0,0.857142857,1,20040
18e9d2d319d418296058a2f757be9503e781a849,1,Myroslav Papirkovskyy,2015-05-21 17:57:27+03:00,['f592dbe39a44e85f6a514dc87cb71961146b15e3'],4,72,76,20583932,8,0,0.592592593,1,20041
3be87ee559e67dca703e6077f0539f9408de52be,1,Lisnichenko Dmitro,2015-05-21 18:07:40+03:00,['18e9d2d319d418296058a2f757be9503e781a849'],5,4,9,20583941,2,1,1,0,20041
0d5a3b28e18cc46042b32d2277b2a102a01b6d0a,0,Oleg Nechiporenko,2015-05-21 18:12:33+03:00,['3be87ee559e67dca703e6077f0539f9408de52be'],1,1,2,20583943,1,,,,20041
3b4c7aea6fc010935ea76439a0e08b774c4641cd,0,Dmytro Sen,2015-05-21 18:30:32+03:00,['0d5a3b28e18cc46042b32d2277b2a102a01b6d0a'],1,4,5,20583948,2,0,1,1,20041
97eec61d185489a82682b06b2491b491126722ba,0,Andrew Onishuk,2015-05-21 19:53:19+03:00,['3b4c7aea6fc010935ea76439a0e08b774c4641cd'],12,18,30,20583978,10,0,0,0,20041
9371bb7601c42b250ec258b85a95a5cc1f55ba61,1,Siddharth Wagle,2015-05-21 10:08:26-07:00,['97eec61d185489a82682b06b2491b491126722ba'],114,361,475,20584453,11,0.2,0.066666667,0.895238095,20042
8e3433c82063a0308596db37a940a6e264ca45de,1,Nate Cole,2015-05-21 13:29:30-04:00,['9371bb7601c42b250ec258b85a95a5cc1f55ba61'],7,140,147,20584600,4,0.666666667,1,1,20042
36711dbde9b0a794bbef3be83850e324773a794f,1,Jonathan Hurley,2015-05-21 13:49:36-04:00,['8e3433c82063a0308596db37a940a6e264ca45de'],4,113,117,20584717,4,,,,20042
698be84bbafe89e1de7123eb7a549898655f1286,1,Oleg Nechiporenko,2015-05-21 21:41:54+03:00,['36711dbde9b0a794bbef3be83850e324773a794f'],119,72,191,20584908,4,0.333333333,0.166666667,0,20042
93ff22f24761abda87c1de7b0dbf6bd4e931b928,0,Sumit Mohanty,2015-05-21 11:46:31-07:00,['698be84bbafe89e1de7123eb7a549898655f1286'],3,3,6,20584914,2,,,,20042
7833901f6d71bd8c5dc1f1e98b17106017435ed6,1,tbeerbower,2015-05-21 15:21:12-04:00,['93ff22f24761abda87c1de7b0dbf6bd4e931b928'],4,130,134,20585048,4,0,1,1,20042
8bdb7850dd37cb9b80dc865ec08326ee8d587a38,0,Sumit Mohanty,2015-05-21 13:14:49-07:00,['7833901f6d71bd8c5dc1f1e98b17106017435ed6'],9,0,9,20585057,1,,,,20042
86638417edbb45d1534dc91a40497bf75879ec22,1,Sumit Mohanty,2015-05-21 13:18:54-07:00,['8bdb7850dd37cb9b80dc865ec08326ee8d587a38'],0,9,9,20585066,1,,,,20042
9e5647d99cbaec20878017cc53e1373e88965c20,1,Siddharth Wagle,2015-05-21 13:37:47-07:00,['86638417edbb45d1534dc91a40497bf75879ec22'],2,4,6,20585072,2,,,,20042
fac6c4899cf4530a00ce53f5f330946ee70eba12,1,Jonathan Hurley,2015-05-21 16:57:20-04:00,['9e5647d99cbaec20878017cc53e1373e88965c20'],5,54,59,20585131,3,,,,20042
d2042f10f9e4d5280dea4d7de8e07236826569cd,0,Nate Cole,2015-05-21 17:49:20-04:00,['fac6c4899cf4530a00ce53f5f330946ee70eba12'],0,1,1,20585132,1,,,,20042
35c3625cce5f04783f8a8b220c9acbc7598ef71c,1,Sumit Mohanty,2015-05-21 14:50:01-07:00,['d2042f10f9e4d5280dea4d7de8e07236826569cd'],1,1,2,20585134,1,,,,20042
cf2283b88dab5aeb156bedd6ceec8f0268b3d816,1,Srimanth Gunturi,2015-05-21 15:35:42-07:00,['35c3625cce5f04783f8a8b220c9acbc7598ef71c'],99,3003,3102,20588236,20,0.138666667,0.034666667,0.128,20049
16683c43573106fedf2c51538c75370c194f0352,0,Sumit Mohanty,2015-05-21 16:26:01-07:00,['cf2283b88dab5aeb156bedd6ceec8f0268b3d816'],128,8,136,20588372,4,0.817073171,0,0,20049
fb03976ade5342f3482b46f5c8bc4553fd4dae44,0,Xi Wang,2015-05-21 16:50:55-07:00,['16683c43573106fedf2c51538c75370c194f0352'],3,4,7,20588379,1,,,,20049
08e5eef44d34935a5551af2beb7ea4e9cd8372f1,1,Nate Cole,2015-05-21 19:53:37-04:00,['fb03976ade5342f3482b46f5c8bc4553fd4dae44'],6,54,60,20588439,4,0.096774194,0.516129032,1,20049
0c67a83cecce659fa365a0abbc9ac8bc26983ead,1,Xi Wang,2015-05-21 17:35:50-07:00,['08e5eef44d34935a5551af2beb7ea4e9cd8372f1'],4,12,16,20588455,5,1,1,1,20049
954bc6f6d8cde1633eef945ad1115be3e31a44f0,1,Robert Levas,2015-05-21 20:50:55-04:00,['0c67a83cecce659fa365a0abbc9ac8bc26983ead'],10,23,33,20588488,4,0,1,1,20049
2230cc62f89d19c80fd7df0e02b6418f79000ddc,1,Jaimin Jetly,2015-05-21 17:51:12-07:00,['954bc6f6d8cde1633eef945ad1115be3e31a44f0'],40,104,144,20588632,5,1,1,1,20051
12dd68ecefadec32b0b81b4c7ccfeb77d2f20283,1,Robert Levas,2015-05-21 21:02:39-04:00,['2230cc62f89d19c80fd7df0e02b6418f79000ddc'],39,89,128,20588760,8,0.884615385,0.923076923,0.884615385,20051
004785dd812bc2b722fc1b7c12842ca291b4ddcc,0,Jaimin Jetly,2015-05-21 18:23:18-07:00,['12dd68ecefadec32b0b81b4c7ccfeb77d2f20283'],0,1,1,20588761,1,,,,20051
818dadfae8761bf2507f6170fcd98b03b9a33c18,0,Siddharth Wagle,2015-05-21 19:49:06-07:00,['004785dd812bc2b722fc1b7c12842ca291b4ddcc'],16,21,37,20588798,1,0,0,1,20051
f1787236115ea091a15e1e3a45deb4ec9be05f85,1,Alejandro Fernandez,2015-05-21 20:10:59-07:00,['818dadfae8761bf2507f6170fcd98b03b9a33c18'],1094,500,1594,20590392,65,1,0,0,20052
162c10e9507c54b16f9101fd11daf5c3b9d0af7c,1,Jaimin Jetly,2015-05-21 20:30:08-07:00,['f1787236115ea091a15e1e3a45deb4ec9be05f85'],3095,2665,5760,20596152,1,,,,20052
c0478e89232cf6500c40b321418d55d195807d61,1,Alex Antonenko,2015-05-22 11:45:57+03:00,['162c10e9507c54b16f9101fd11daf5c3b9d0af7c'],13,334,347,20596499,5,0.52970297,1,0.940594059,20054
53c80e82c24d33ec2127e04ffcf1a0efdbf6be2c,1,Alex Antonenko,2015-05-22 11:45:57+03:00,['c0478e89232cf6500c40b321418d55d195807d61'],4,4,8,20596507,2,,,,20054
7eae3564f084e78746a0a28c2dea3edabbe6d832,1,Alex Antonenko,2015-05-22 11:45:57+03:00,['53c80e82c24d33ec2127e04ffcf1a0efdbf6be2c'],2,25,27,20596534,2,1,1,1,20054
254fba3fec45c0d988b19d615cb04e63f04b7e68,0,Lisnichenko Dmitro,2015-05-22 13:06:20+03:00,['7eae3564f084e78746a0a28c2dea3edabbe6d832'],4,9,13,20596547,2,,,,20054
5e14020039568ca5057c20ebc1f084691bc55eef,0,Oleg Nechiporenko,2015-05-22 14:04:33+03:00,['254fba3fec45c0d988b19d615cb04e63f04b7e68'],5,4,9,20596556,2,,,,20054
badf77f4557a976730beb5f8ccbdf46417a20655,0,Lisnichenko Dmitro,2015-05-22 16:14:20+03:00,['5e14020039568ca5057c20ebc1f084691bc55eef'],77,148,225,20596781,24,0,0,0,20056
f9977c2699b9304b20ea882f9812372779ebe949,0,Dmytro Sen,2015-05-22 16:44:11+03:00,['badf77f4557a976730beb5f8ccbdf46417a20655'],1,1,2,20596783,1,,,,20056
a2dcc044c70459295e258cb8f084290bcc8bc6f8,1,Oleg Nechiporenko,2015-05-22 17:34:14+03:00,['f9977c2699b9304b20ea882f9812372779ebe949'],1,103,104,20596887,2,1,1,1,20056
ee13537090ceee904f8822de77fd9143eb2d212b,1,Billie Rinaldi,2015-05-22 07:39:20-07:00,['a2dcc044c70459295e258cb8f084290bcc8bc6f8'],5,106,111,20596998,6,0.676470588,0.308823529,1,20056
1a45bf10aecb6be2f677c675719e0a3197037a03,0,Oleg Nechiporenko,2015-05-22 17:58:03+03:00,['ee13537090ceee904f8822de77fd9143eb2d212b'],4,5,9,20597007,1,1,1,1,20056
714d2535edfc23a0ec2f9c8153e84e8f93c5d5ff,0,tbeerbower,2015-05-22 11:03:26-04:00,['1a45bf10aecb6be2f677c675719e0a3197037a03'],0,9,9,20597016,2,0.2,1,1,20056
832f7e1ec7a04c8ade400f9bfa679d2d7069ae13,1,Bob Nettleton,2015-05-22 11:17:31-04:00,['714d2535edfc23a0ec2f9c8153e84e8f93c5d5ff'],1,142,143,20597159,3,0.2875,0.7125,1,20056
0e772bef5109e08acf163a6136f3486da66d258f,0,Alex Antonenko,2015-05-22 18:46:01+03:00,['832f7e1ec7a04c8ade400f9bfa679d2d7069ae13'],3,29,32,20597191,3,0.36,1,0.84,20056
b9d82cf98f762d2d279555f6238444a1abf0375e,1,Andrii Tkach,2015-05-22 18:49:03+03:00,['0e772bef5109e08acf163a6136f3486da66d258f'],4,60,64,20597255,2,0.481481481,1,0.907407407,20056
76648a0a5a3523ad4c2eb249ae6bba2723f926d4,0,Sumit Mohanty,2015-05-22 09:52:18-07:00,['b9d82cf98f762d2d279555f6238444a1abf0375e'],3,3,6,20597261,2,,,,20056
de669dcaa89be08e5d60430b9c5e30e5a82f7aa6,1,Florian Barca,2015-05-22 10:10:27-07:00,['76648a0a5a3523ad4c2eb249ae6bba2723f926d4'],1,5,6,20597267,1,0,0,1,20056
e79cf4ee3b22842fbdd2302616aa13c703075fd8,1,Artem Baranchuk,2015-05-22 20:15:25+03:00,['de669dcaa89be08e5d60430b9c5e30e5a82f7aa6'],44,29,73,20597340,9,1,1,1,20056
aa51bd75b88a5d8e8d7bdec7240c6b561a94805d,1,Andrew Onishuk,2015-05-22 20:36:55+03:00,['e79cf4ee3b22842fbdd2302616aa13c703075fd8'],184,931,1115,20598455,41,0.352678571,0.685267857,0.727678571,20058
d6556e905a5fcc0487359e634a405616bd678414,1,Sumit Mohanty,2015-05-22 10:39:10-07:00,['aa51bd75b88a5d8e8d7bdec7240c6b561a94805d'],3,3,6,20598461,2,,,,20058
52aaaa0df974457a1f4ef2848838eb26ee0e731c,0,Srimanth Gunturi,2015-05-22 10:41:40-07:00,['d6556e905a5fcc0487359e634a405616bd678414'],2,2,4,20598465,2,,0,,20058
6a572bb2053545800221bba2e8af0a2a6144066a,1,Alex Antonenko,2015-05-22 21:55:16+03:00,['52aaaa0df974457a1f4ef2848838eb26ee0e731c'],5,30,35,20598500,3,,,,20058
11ef5ca16ec87fe29e6b20cf671bd7925c7c8ab0,1,Alex Antonenko,2015-05-22 21:55:16+03:00,['6a572bb2053545800221bba2e8af0a2a6144066a'],5,123,128,20598628,1,0.274509804,0.039215686,0.039215686,20058
cd6398a1dad3ea9503d408d98623088ecb76ef3b,1,Srimanth Gunturi,2015-05-22 12:41:02-07:00,['11ef5ca16ec87fe29e6b20cf671bd7925c7c8ab0'],0,40284,40284,20638912,83,0.589929819,0.661335074,0.777215603,20140
b235825327c2f23915677b1f0d7707c56f5cddad,0,Billie Rinaldi,2015-05-22 13:05:51-07:00,['cd6398a1dad3ea9503d408d98623088ecb76ef3b'],3,17,20,20638932,2,0,0,0.083333333,20140
b75d59727013a67a6a185ebe1b33f6b6509543e7,1,Sumit Mohanty,2015-05-22 13:27:34-07:00,['b235825327c2f23915677b1f0d7707c56f5cddad'],148,77,225,20639157,24,1,1,1,20140
064f841ad8c3ed002b2a8f9ed69b8ce7bdea2fc5,0,Sumit Mohanty,2015-05-22 13:56:02-07:00,['b75d59727013a67a6a185ebe1b33f6b6509543e7'],39,45,84,20639241,10,,,,20140
d2ad633a304385d9e09270c5d10933974a29e60e,1,Siddharth Wagle,2015-05-22 14:49:35-07:00,['064f841ad8c3ed002b2a8f9ed69b8ce7bdea2fc5'],1,1,2,20639243,1,,,,20140
d538f38e71bb57f795c4982999284a98ea46946c,1,Mahadev Konar,2015-05-22 14:58:49-07:00,['d2ad633a304385d9e09270c5d10933974a29e60e'],0,46,46,20639289,1,,,,20141
17e2bdcb1c74b11cbacea9bdb1ecc6d023aa57f4,0,Srimanth Gunturi,2015-05-22 15:04:17-07:00,['d538f38e71bb57f795c4982999284a98ea46946c'],4,13,17,20639306,5,1,1,1,20141
7f28110ba5af3bc1b5838ca4c516cff2364c8081,0,Xi Wang,2015-05-22 15:42:32-07:00,['17e2bdcb1c74b11cbacea9bdb1ecc6d023aa57f4'],1,0,1,20639307,1,,,,20141
1ee0328b10e4c120888a2342c1af6f985ea6dd4b,1,Sumit Mohanty,2015-05-22 15:53:44-07:00,['7f28110ba5af3bc1b5838ca4c516cff2364c8081'],2,12,14,20639321,1,,,,20141
b0693c86dffca89c38e742b9260953348d0f275b,0,Jayush Luniya,2015-05-22 16:36:51-07:00,['1ee0328b10e4c120888a2342c1af6f985ea6dd4b'],5,9,14,20639335,4,,,,20141
cf5293a2c06de405a8aeb740481d98d7cd19baa2,1,Robert Levas,2015-05-22 20:36:37-04:00,['b0693c86dffca89c38e742b9260953348d0f275b'],4,17,21,20639356,3,1,1,1,20141
48e0f3c723927d5d49160ac7ed3c5275f8eb66f2,0,Sumit Mohanty,2015-05-22 17:43:01-07:00,['cf5293a2c06de405a8aeb740481d98d7cd19baa2'],1,4,5,20639361,1,0,0,1,20141
c74e0e85d6efe1bd9c145ca4da5ca0afd42f757b,1,Robert Levas,2015-05-22 21:27:08-04:00,['48e0f3c723927d5d49160ac7ed3c5275f8eb66f2'],211,761,972,20640333,44,0.882352941,0.88627451,1,20143
b6a67dcbca7386257684f22068f224a016cedd5c,1,Jonathan Hurley,2015-05-22 21:29:01-04:00,['c74e0e85d6efe1bd9c145ca4da5ca0afd42f757b'],0,18,18,20640351,1,,,,20143
058f164bab1f55f34c97d1b259b72ca8360e6333,1,Sumit Mohanty,2015-05-22 19:11:29-07:00,['b6a67dcbca7386257684f22068f224a016cedd5c'],9,4,13,20640364,2,,,,20143
4b472cc68294cb14a073b6a5e34b77b87a9a73c3,1,Yusaku Sako,2015-05-23 09:47:41-07:00,['058f164bab1f55f34c97d1b259b72ca8360e6333'],13,13,26,20640390,4,,,,20143
49164681ea670cc498a18af39381245e00796b34,0,Sumit Mohanty,2015-05-23 22:39:43-07:00,['4b472cc68294cb14a073b6a5e34b77b87a9a73c3'],4,1,5,20640395,1,1,1,0,20143
8fe5ee9a83d16483dfc254c486033dd51c4a0460,1,Sumit Mohanty,2015-05-24 06:56:51-07:00,['49164681ea670cc498a18af39381245e00796b34'],15,30,45,20640440,8,0.733333333,1,1,20143
e6f975a644ae20a4374197c205d2eb5fae84ac27,1,Sumit Mohanty,2015-05-24 07:20:09-07:00,['8fe5ee9a83d16483dfc254c486033dd51c4a0460'],45,39,84,20640524,10,,,,20143
75a806cc675915f74641d35349faa17f9492e7a6,1,Jaimin Jetly,2015-05-24 19:06:16-07:00,['e6f975a644ae20a4374197c205d2eb5fae84ac27'],9,12,21,20640545,2,0.2,0.2,1,20143
2f218e7eadb1b7083835f2542f4fd599b4f85c2f,1,Jaimin Jetly,2015-05-24 19:09:47-07:00,['75a806cc675915f74641d35349faa17f9492e7a6'],4,4,8,20640553,2,1,1,0,20143
4a3797d8012c3bc0365ddd4e16bd12c1ac49672b,1,Alejandro Fernandez,2015-05-25 01:30:08-07:00,['2f218e7eadb1b7083835f2542f4fd599b4f85c2f'],19,181,200,20640753,6,1,0,0,20144
80d8e560d1ce75c2b5520933f725418ae3b58ce4,1,Alejandro Fernandez,2015-05-25 01:46:56-07:00,['4a3797d8012c3bc0365ddd4e16bd12c1ac49672b'],1386,343,1729,20642482,16,,,,20144
f6e465ed1a612e7f0904b043838a4cc43274bc70,1,Oleg Nechiporenko,2015-05-25 12:34:30+03:00,['80d8e560d1ce75c2b5520933f725418ae3b58ce4'],42,42,84,20642566,40,,,,20144
b2cc1c929b73e9ac322f1eccd02cf981a3053da8,0,Andrew Onishuk,2015-05-25 12:46:20+03:00,['f6e465ed1a612e7f0904b043838a4cc43274bc70'],2,2,4,20642570,1,,,,20144
8690cfdb4ab8e97c84d4c0a4e4296277617355b7,1,Aleksandr Kovalenko,2015-05-25 12:51:28+03:00,['b2cc1c929b73e9ac322f1eccd02cf981a3053da8'],25,302,327,20642897,9,0.047619048,1,0.94047619,20147
ad2f5442b3706235969c8982d3fa92fea808dc29,1,Jonathan Hurley,2015-05-25 07:23:01-04:00,['8690cfdb4ab8e97c84d4c0a4e4296277617355b7'],173,438,611,20643508,26,0.352941176,0.926470588,1,20148
e59405796ee977155d4810a87fdd445263183acd,1,Lisnichenko Dmitro,2015-05-25 15:56:15+03:00,['ad2f5442b3706235969c8982d3fa92fea808dc29'],81,234,315,20643823,25,0,1,1,20150
171f8b8e0599c7d65a3857be0333dcdf79b40903,1,Robert Levas,2015-05-25 09:45:09-04:00,['e59405796ee977155d4810a87fdd445263183acd'],83,24,107,20643930,2,0.615384615,0.615384615,0,20150
bc0bbca97d00755eecd2a9636c9a6e02a270293d,0,Andrew Onishuk,2015-05-25 17:10:28+03:00,['171f8b8e0599c7d65a3857be0333dcdf79b40903'],131,2,133,20644063,5,0.928571429,0.153061224,0.153061224,20150
7102a7765be17338d5d2d4d6ce4558dcfc30e93b,0,Andrew Onishuk,2015-05-25 17:14:55+03:00,['bc0bbca97d00755eecd2a9636c9a6e02a270293d'],3,10,13,20644076,1,,,,20150
0ee9f1676ab55cac4ee941ae368d2c97458233b6,1,Alex Antonenko,2015-05-25 18:18:02+03:00,['7102a7765be17338d5d2d4d6ce4558dcfc30e93b'],47,3,50,20644126,5,0.574468085,0.191489362,0.106382979,20150
a92cac157ba16dbcb61aa75413f19eea66f950f4,0,aBabiichuk,2015-05-25 19:06:53+03:00,['0ee9f1676ab55cac4ee941ae368d2c97458233b6'],4,31,35,20644161,6,,,,20150
be170909cf4fff290416f2ca00f5fc4b9e5416cd,1,Andrii Tkach,2015-05-25 19:10:58+03:00,['a92cac157ba16dbcb61aa75413f19eea66f950f4'],1,3,4,20644165,1,1,1,1,20150
043357d8dc7633a720c0b4f4aeb428ded4566346,1,Sumit Mohanty,2015-05-25 09:22:03-07:00,['be170909cf4fff290416f2ca00f5fc4b9e5416cd'],38,44,82,20644247,10,,,,20150
c035bdadd1ccef6428e8083282b3a3fa67ee0e12,1,Alex Antonenko,2015-05-25 21:50:02+03:00,['043357d8dc7633a720c0b4f4aeb428ded4566346'],1,25,26,20644273,2,0.96,0.68,0.92,20150
46b159a2d81973d12363943f518ba74b66ebc529,0,Alex Antonenko,2015-05-25 21:50:02+03:00,['c035bdadd1ccef6428e8083282b3a3fa67ee0e12'],12,8,20,20644293,3,1,0,0,20150
b5a8bd52202c9657890061953c604e2bc8bcf17a,1,Andrew Onishuk,2015-05-26 00:44:40+03:00,['46b159a2d81973d12363943f518ba74b66ebc529'],5,5,10,20644303,1,0,0,1,20150
08e920eaf4a3d94585ace5506115a8f98a39ae55,0,Sumit Mohanty,2015-05-25 15:59:23-07:00,['b5a8bd52202c9657890061953c604e2bc8bcf17a'],2,2,4,20644307,1,,,,20150
d12a79c4021ef5fbc574e46fb0e4fe99abf05fc0,0,Sumit Mohanty,2015-05-25 22:17:23-07:00,['08e920eaf4a3d94585ace5506115a8f98a39ae55'],1,4,5,20644312,1,0,0,1,20150
af7cc7480afc02c88838c31889f4f2959a391765,1,Sumit Mohanty,2015-05-25 22:23:09-07:00,['d12a79c4021ef5fbc574e46fb0e4fe99abf05fc0'],4,1,5,20644317,1,1,1,0,20150
c6f5ecdbdb06064abc251d678cb0c81e454d8b98,1,aBabiichuk,2015-05-26 11:44:08+03:00,['af7cc7480afc02c88838c31889f4f2959a391765'],1,1,2,20644319,1,,,,20150
f2be7c501fe247e0787b37b12b6af9e2e19bda76,1,aBabiichuk,2015-05-26 11:44:24+03:00,['c6f5ecdbdb06064abc251d678cb0c81e454d8b98'],1,1,2,20644321,1,,,,20150
d935afd2578e08dcc5aceafadc38ba0933f95186,0,Aleksandr Kovalenko,2015-05-26 13:02:20+03:00,['f2be7c501fe247e0787b37b12b6af9e2e19bda76'],0,77,77,20644398,5,1,1,1,20150
d0580393b31184ccf5cb62206fc5a9e87d4fd830,0,Oleg Nechiporenko,2015-05-26 13:08:00+03:00,['d935afd2578e08dcc5aceafadc38ba0933f95186'],5,7,12,20644410,1,1,1,0.8,20150
b7f9b041f75783e237c53dac2170c1596a5a8f7b,1,Dmytro Sen,2015-05-26 13:15:04+03:00,['d0580393b31184ccf5cb62206fc5a9e87d4fd830'],9,5,14,20644424,2,1,0,1,20150
955a668508fed5746efa8bc0531f556686f0190b,1,Robert Levas,2015-05-26 06:56:57-04:00,['b7f9b041f75783e237c53dac2170c1596a5a8f7b'],28,7,35,20644459,2,1,0,1,20150
3410ba4e12f0fdaf0ca6a49171716cfdf84128dd,0,Aleksandr Kovalenko,2015-05-26 15:01:03+03:00,['955a668508fed5746efa8bc0531f556686f0190b'],77,0,77,20644536,5,0,0,0,20150
599c1da8138dd881ed863525cfa56a482677f9b4,1,Andrii Tkach,2015-05-26 15:11:08+03:00,['3410ba4e12f0fdaf0ca6a49171716cfdf84128dd'],127,283,410,20644946,6,0.404958678,1,1,20150
614a74fbf8bc95de0ab33a014859aaa3101ee10a,0,Andrii Tkach,2015-05-26 15:47:23+03:00,['599c1da8138dd881ed863525cfa56a482677f9b4'],0,5,5,20644951,1,1,1,1,20150
256f47ab18488d5783567bf6bd5aea8371a99279,0,Aleksandr Kovalenko,2015-05-26 18:03:36+03:00,['614a74fbf8bc95de0ab33a014859aaa3101ee10a'],1,14,15,20644966,1,1,1,0.7,20150
2302764c322dc60ccd4b4817aa8b5f455aa42c37,0,Dmytro Sen,2015-05-26 19:56:28+03:00,['256f47ab18488d5783567bf6bd5aea8371a99279'],1,1,2,20644968,1,,,,20150
591ab48101065da7561115391b747991d4e47d2d,1,tbeerbower,2015-05-26 13:01:14-04:00,['2302764c322dc60ccd4b4817aa8b5f455aa42c37'],28,99,127,20645095,7,0.833333333,0.944444444,0.611111111,20150
84d774ce140cc3ebd0590edb3d85f82e048dbb4d,1,Sumit Mohanty,2015-05-26 10:03:50-07:00,['591ab48101065da7561115391b747991d4e47d2d'],19,19,38,20645133,9,,,,20150
d636d70d7a448b87b1443afb78dfec89b2f5d752,0,Alejandro Fernandez,2015-05-26 10:26:54-07:00,['84d774ce140cc3ebd0590edb3d85f82e048dbb4d'],0,35,35,20645168,2,0.384615385,0.384615385,1,20150
49403a68d9afa9f544bfafe6a841f2f82a714e70,1,Alex Antonenko,2015-05-26 22:17:35+03:00,['d636d70d7a448b87b1443afb78dfec89b2f5d752'],11,135,146,20645314,6,0.456,0.976,0.976,20150
988248ca061c29ec22d9bb657e47884f47e43e5c,0,John Speidel,2015-05-26 16:01:39-04:00,['49403a68d9afa9f544bfafe6a841f2f82a714e70'],1,0,1,20645315,1,,,,20150
8ac6583078e3c181455423910de353cb8d01525a,0,Bob Nettleton,2015-05-26 16:50:48-04:00,['988248ca061c29ec22d9bb657e47884f47e43e5c'],3,57,60,20645375,2,1,1,0.85,20150
5be5b138b835671844844ebd226c22d1d7d18d1f,1,Jaimin Jetly,2015-05-26 14:17:04-07:00,['8ac6583078e3c181455423910de353cb8d01525a'],29,84,113,20645488,3,1,1,0,20151
3db25744455dd3a4e0ce2f4f94bfab54beb9c69f,0,Jaimin Jetly,2015-05-26 14:25:50-07:00,['5be5b138b835671844844ebd226c22d1d7d18d1f'],5,0,5,20645493,1,0,0,0,20151
78430140ff00294f19b4b245bbf941a9fe473d99,1,Florian Barca,2015-05-26 14:58:05-07:00,['3db25744455dd3a4e0ce2f4f94bfab54beb9c69f'],82,1396,1478,20646971,52,0.8125,0.8125,0.5,20177
8f2032e59a910d4a9669949fb963971f96dd2f57,0,Yusaku Sako,2015-05-26 15:22:30-07:00,['78430140ff00294f19b4b245bbf941a9fe473d99'],0,2,2,20646973,1,1,1,1,20177
d14f044445a2f768ed0e8375279821c3a7daab5c,1,Jonathan Hurley,2015-05-26 18:39:30-04:00,['8f2032e59a910d4a9669949fb963971f96dd2f57'],55,240,295,20647268,4,0,0.694444444,0.944444444,20177
031d3e782d22e5aea70e8a1a4c1f52be99e1d6a6,0,Jaimin Jetly,2015-05-26 15:59:07-07:00,['d14f044445a2f768ed0e8375279821c3a7daab5c'],0,1,1,20647269,1,1,1,1,20177
a077ad3f61ea66612427d5012b9e0bf7ca79056a,0,Srimanth Gunturi,2015-05-26 16:10:09-07:00,['031d3e782d22e5aea70e8a1a4c1f52be99e1d6a6'],1,6,7,20647276,3,1,1,1,20177
a285987dde69c28e9fee7a14298150393dd185c9,0,Yusaku Sako,2015-05-26 16:21:10-07:00,['a077ad3f61ea66612427d5012b9e0bf7ca79056a'],4,43,47,20647323,3,0.814814815,0.814814815,1,20177
ee8e2f650b8f0c328a39d5b6a1317ee75dcd5b33,0,Xi Wang,2015-05-26 16:43:10-07:00,['a285987dde69c28e9fee7a14298150393dd185c9'],5,9,14,20647337,3,0.8,0.8,1,20177
8f5af335eae4f03699cc6807a930b7b6829e9f9c,1,Jaimin Jetly,2015-05-26 19:00:07-07:00,['ee8e2f650b8f0c328a39d5b6a1317ee75dcd5b33'],4,10,14,20647351,3,1,1,1,20177
f57d0e2ec68161bfc0293a3e5556ab39f39719af,0,Jaimin Jetly,2015-05-26 19:00:52-07:00,['8f5af335eae4f03699cc6807a930b7b6829e9f9c'],199,541,740,20648091,1,,,,20177
efe31292337eab8ab07a5f7befca26d69dba829d,1,Sumit Mohanty,2015-05-26 20:06:49-07:00,['f57d0e2ec68161bfc0293a3e5556ab39f39719af'],2,3,5,20648096,1,,,,20177
d363c3d3bd22b3db2708aefbb7bbfdf4ec9921e3,1,Dmytro Sen,2015-05-27 12:32:44+03:00,['efe31292337eab8ab07a5f7befca26d69dba829d'],16,65,81,20648177,4,0,0.133333333,1,20177
a4008c18b3e5e05cde7306464c70eca896914887,1,Andrew Onishuk,2015-05-27 13:11:29+03:00,['d363c3d3bd22b3db2708aefbb7bbfdf4ec9921e3'],4,9,13,20648190,2,,,,20177
27e6797f02c970d00cb51bf3b3d5ca692f4f396e,1,Oleg Nechiporenko,2015-05-27 13:23:06+03:00,['a4008c18b3e5e05cde7306464c70eca896914887'],1,36,37,20648227,2,0.294117647,1,1,20177
9b331fec790d376f5b8dd3532979c5c32888dd2c,1,Andrii Tkach,2015-05-27 13:24:06+03:00,['27e6797f02c970d00cb51bf3b3d5ca692f4f396e'],100,122,222,20648449,9,0,1,1,20177
a8fc9a263cc73cdcade4b68e0f8c7b3bd5f819f3,1,Aleksandr Kovalenko,2015-05-27 13:55:04+03:00,['9b331fec790d376f5b8dd3532979c5c32888dd2c'],84,92,176,20648625,10,0.375,0.4375,0,20177
b570fc1f73785106f3dff59dd8c02b1c42613b88,1,Andrew Onishuk,2015-05-27 14:48:24+03:00,['a8fc9a263cc73cdcade4b68e0f8c7b3bd5f819f3'],92,152,244,20648869,6,0,1,1,20177
64ce4989eee30dc9d83dbc8e7731336ab20f37eb,1,Oleg Nechiporenko,2015-05-27 14:51:27+03:00,['b570fc1f73785106f3dff59dd8c02b1c42613b88'],21,85,106,20648975,3,1,1,1,20177
e7d2d3fee327ffba771f17df9af0ed3d7aa55b22,0,Artem Baranchuk,2015-05-27 14:55:09+03:00,['64ce4989eee30dc9d83dbc8e7731336ab20f37eb'],2,2,4,20648979,1,,,,20177
9efa8f9c879df5552519232fe970b12501603a9a,0,Artem Baranchuk,2015-05-27 14:55:12+03:00,['e7d2d3fee327ffba771f17df9af0ed3d7aa55b22'],208,38,246,20649225,1,,,,20177
fd66b4120c33e01d520e9d644eb88d16d2f655a8,1,Oleg Nechiporenko,2015-05-27 15:41:05+03:00,['9efa8f9c879df5552519232fe970b12501603a9a'],3,41,44,20649269,2,0,1,1,20177
47f26687d186fd05699f19687dae4027509f4a24,0,Aleksandr Kovalenko,2015-05-27 15:51:45+03:00,['fd66b4120c33e01d520e9d644eb88d16d2f655a8'],15,21,36,20649305,3,,,,20177
6df4da1683c56b0f8facc6fb5d33529fd9781fdb,1,Andrew Onishuk,2015-05-27 16:55:57+03:00,['47f26687d186fd05699f19687dae4027509f4a24'],177,217,394,20649699,27,0.19047619,0,0.738095238,20177
1d1e219c7ef88204e9fdd967050e56aef47fa5fa,1,Vitaly Brodetskyi,2015-05-27 17:01:17+03:00,['6df4da1683c56b0f8facc6fb5d33529fd9781fdb'],107,403,510,20650209,13,0.00617284,0.00617284,0,20178
f62a6057a4587d6b02dc0e434c8caf449f9d68b4,1,Andrii Tkach,2015-05-27 17:31:34+03:00,['1d1e219c7ef88204e9fdd967050e56aef47fa5fa'],7,29,36,20650245,2,0.2,0.2,1,20178
2b9a6cac69c50e0a43905548d53701d95d29950b,1,Andrew Onishuk,2015-05-27 18:24:56+03:00,['f62a6057a4587d6b02dc0e434c8caf449f9d68b4'],0,3,3,20650248,1,0,0,1,20178
30cb201dde7f8cf8dc355564cb24932d1fcd24ae,0,Alex Antonenko,2015-05-27 18:41:52+03:00,['2b9a6cac69c50e0a43905548d53701d95d29950b'],3,6,9,20650257,1,,,,20178
34bffa8a538360c3fa0bb53d1e50888e09b607e2,0,Oleg Nechiporenko,2015-05-27 18:44:19+03:00,['30cb201dde7f8cf8dc355564cb24932d1fcd24ae'],6,43,49,20650306,2,0.269230769,1,1,20178
a245ce69a1eab9b06563260bde12f41898d52037,0,Dmytro Sen,2015-05-27 18:49:53+03:00,['34bffa8a538360c3fa0bb53d1e50888e09b607e2'],0,1,1,20650307,1,,,,20178
b5ce4e5f68a53767fadeda2654fbdb4d85f13154,1,aBabiichuk,2015-05-27 18:54:58+03:00,['a245ce69a1eab9b06563260bde12f41898d52037'],3,3,6,20650313,2,,,,20178
7790316da6e8fb11c088859c9c0a9d3b0e7b818c,0,Andrew Onishuk,2015-05-27 18:55:21+03:00,['b5ce4e5f68a53767fadeda2654fbdb4d85f13154'],1,4,5,20650318,3,0,1,1,20178
d6882d341d670b815532c4a2951f418618cb6e76,1,Alex Antonenko,2015-05-27 19:31:29+03:00,['7790316da6e8fb11c088859c9c0a9d3b0e7b818c'],31,112,143,20650461,4,0,1,1,20178
f119a671f9a6e93e53a5e26ab8dc0a4328debcd7,0,Dmytro Sen,2015-05-27 19:53:41+03:00,['d6882d341d670b815532c4a2951f418618cb6e76'],2,9,11,20650472,1,0,0,1,20178
57579be4f8dc7ebc3add481b110459c743369a4b,0,Srimanth Gunturi,2015-05-27 10:10:35-07:00,['f119a671f9a6e93e53a5e26ab8dc0a4328debcd7'],1,31,32,20650504,4,1,1,1,20179
fea0afa2e95d5a1bc01272014f234861e805c4d3,1,Srimanth Gunturi,2015-05-27 10:10:35-07:00,['57579be4f8dc7ebc3add481b110459c743369a4b'],2,2,4,20650508,1,1,0,0,20179
36ec3be8335df492fdc2971da3d118a1ab5275fd,1,Alejandro Fernandez,2015-05-27 10:14:26-07:00,['fea0afa2e95d5a1bc01272014f234861e805c4d3'],1,11,12,20650520,1,0,0,1,20179
766b934c086024a65e53b5441f561828e388578c,1,Alejandro Fernandez,2015-05-27 10:16:52-07:00,['36ec3be8335df492fdc2971da3d118a1ab5275fd'],28,328,356,20650876,7,0.102040816,0.428571429,0.714285714,20180
1a6dd84d242fcdd0e26c96b5ce3e564049b5095f,0,Lisnichenko Dmitro,2015-05-27 20:20:43+03:00,['766b934c086024a65e53b5441f561828e388578c'],5,9,14,20650890,2,0.666666667,1,1,20180
90bd51a81b7b93de3ed73d6f674fbc6c035786e8,1,Lisnichenko Dmitro,2015-05-27 20:22:12+03:00,['1a6dd84d242fcdd0e26c96b5ce3e564049b5095f'],23,45,68,20650958,4,1,0,0,20180
1b4bfafad0b1f98bbfa52229cbd4d1ebe13554b0,1,Jaimin Jetly,2015-05-27 10:32:28-07:00,['90bd51a81b7b93de3ed73d6f674fbc6c035786e8'],4,4,8,20650966,1,,,,20180
e28a9c073c2cc0586d595162f53b684817b67218,1,Robert Levas,2015-05-27 13:36:26-04:00,['1b4bfafad0b1f98bbfa52229cbd4d1ebe13554b0'],234,1674,1908,20652874,24,0.701438849,0.955035971,0.872302158,20193
90eae672d26bc2f9f773e948c4cf0e40e330fde3,1,Jaimin Jetly,2015-05-27 11:41:29-07:00,['e28a9c073c2cc0586d595162f53b684817b67218'],2,131,133,20653007,5,0.071428571,0.846938776,0.846938776,20193
b16501803c8f1bab98aafa1cce45294eb155b39f,0,Srimanth Gunturi,2015-05-27 11:47:27-07:00,['90eae672d26bc2f9f773e948c4cf0e40e330fde3'],6,6,12,20653019,3,,,,20193
1d2aaa303add528e891c0eaf701e41ae6ca23af3,1,Robert Levas,2015-05-27 15:21:55-04:00,['b16501803c8f1bab98aafa1cce45294eb155b39f'],1,1,2,20653021,1,,,,20193
6ce8f6078342389fa46816517bdfb80518df0378,0,Yusaku Sako,2015-05-27 12:32:44-07:00,['1d2aaa303add528e891c0eaf701e41ae6ca23af3'],23,4073,4096,20657117,14,0.47210452,0.569915254,0.844279661,20204
e2a0f817c6084ad545f7a2c109a347541d8ae17b,0,Srimanth Gunturi,2015-05-27 12:37:12-07:00,['6ce8f6078342389fa46816517bdfb80518df0378'],1,1,2,20657119,1,,,,20204
c5d244246ed168370112ccf596102624768efb73,0,Sumit Mohanty,2015-05-27 13:04:16-07:00,['e2a0f817c6084ad545f7a2c109a347541d8ae17b'],0,37,37,20657156,1,,,,20205
82b86622eea02db1e898456663beafe8a8414ba3,1,Alejandro Fernandez,2015-05-27 13:24:35-07:00,['c5d244246ed168370112ccf596102624768efb73'],2,3,5,20657161,1,,,,20205
8deabc2cb0a0dbd9f64908d77a9cc99098a0c2a7,1,Jayush Luniya,2015-05-27 14:17:12-07:00,['82b86622eea02db1e898456663beafe8a8414ba3'],6,109,115,20657276,8,,,,20208
8419e55bf2a4484c651cfe4b476d7c34b05301d9,1,Florian Barca,2015-05-27 14:51:33-07:00,['8deabc2cb0a0dbd9f64908d77a9cc99098a0c2a7'],37,63,100,20657376,3,1,1,0.777777778,20208
f00daf0065390fe5fa0cd4b254ae3fa376d6085f,1,Srimanth Gunturi,2015-05-27 16:01:31-07:00,['8419e55bf2a4484c651cfe4b476d7c34b05301d9'],5,29,34,20657410,4,0,0.888888889,0.888888889,20208
39b56b4829b604b103240dfc3c7a3f788a0949db,0,Siddharth Wagle,2015-05-27 16:20:54-07:00,['f00daf0065390fe5fa0cd4b254ae3fa376d6085f'],16,25,41,20657451,2,1,1,1,20208
510a2dd26d06bc5860b8466fce0c1cd89a152fe5,1,Xi Wang,2015-05-27 16:27:36-07:00,['39b56b4829b604b103240dfc3c7a3f788a0949db'],2,2,4,20657455,2,,,,20208
7d2a1310576171ccce9f07a1d7cb0f13a1ed6a37,1,Jaimin Jetly,2015-05-27 17:49:17-07:00,['510a2dd26d06bc5860b8466fce0c1cd89a152fe5'],3,5,8,20657463,4,,,,20208
fcdf20823de8a954b3a7394bf2e5735d70825c5c,1,Jonathan Hurley,2015-05-27 21:08:13-04:00,['7d2a1310576171ccce9f07a1d7cb0f13a1ed6a37'],11,15,26,20657489,2,,,,20208
38156eafd50940998281443d58b9f6c443d1ddf1,1,Bob Nettleton,2015-05-27 22:17:21-04:00,['fcdf20823de8a954b3a7394bf2e5735d70825c5c'],0,12,12,20657501,2,0,0,1,20208
8dd29ced1f8bc3e96e12ed76dbe500c47361d94c,1,Jonathan Hurley,2015-05-27 22:39:16-04:00,['38156eafd50940998281443d58b9f6c443d1ddf1'],54,238,292,20657793,11,0.0875,0.5625,1,20210
46444b14883a02e1618f4572b81b091a0f2aa7fc,1,Jayush Luniya,2015-05-27 23:48:58-07:00,['8dd29ced1f8bc3e96e12ed76dbe500c47361d94c'],0,477,477,20658270,11,0.090909091,1,0.909090909,20216
8211d82c1152ff6e35cc2273ad763c3aecee40d3,1,Jayush Luniya,2015-05-28 00:26:10-07:00,['46444b14883a02e1618f4572b81b091a0f2aa7fc'],17,113,130,20658400,26,0,1,1,20216
da826636c50eb4c55b25d19574ecfdd7510bdde4,1,Vitaly Brodetskyi,2015-05-28 12:38:39+03:00,['8211d82c1152ff6e35cc2273ad763c3aecee40d3'],1,1,2,20658402,1,,,,20216
da02aeef78008ed82b67132c1e3c4843883acff7,0,Aleksandr Kovalenko,2015-05-28 13:58:53+03:00,['da826636c50eb4c55b25d19574ecfdd7510bdde4'],9,24,33,20658435,2,0,1,1,20216
283ec21ec3946713124a098e3a42a41cf7e110f0,1,Aleksandr Kovalenko,2015-05-28 14:01:23+03:00,['da02aeef78008ed82b67132c1e3c4843883acff7'],0,1,1,20658436,1,,,,20216
8775fe29cd931e588df009a3ff25e77fc9aed40a,1,Oleg Nechiporenko,2015-05-28 16:09:06+03:00,['283ec21ec3946713124a098e3a42a41cf7e110f0'],356,210,566,20659002,8,0.515625,0,0,20216
087d9003ecf6af33890e4f48743d7237a30d6438,1,tbeerbower,2015-05-28 09:44:37-04:00,['8775fe29cd931e588df009a3ff25e77fc9aed40a'],15,33,48,20659050,3,0.230769231,1,1,20216
b20dbb7fae7fc029f353f4eddf280c5f53878421,1,John Speidel,2015-05-28 10:22:42-04:00,['087d9003ecf6af33890e4f48743d7237a30d6438'],93,123,216,20659266,2,0.409090909,1,1,20216
1f1742b1d7f2eb4f4e5bfd1b64c565fcdcf18553,0,Oleg Nechiporenko,2015-05-28 17:33:14+03:00,['b20dbb7fae7fc029f353f4eddf280c5f53878421'],8,48,56,20659322,3,1,1,1,20216
aba28e05e975adedeb6f76a4e88b209d9b6f7397,1,Alex Antonenko,2015-05-28 17:52:11+03:00,['1f1742b1d7f2eb4f4e5bfd1b64c565fcdcf18553'],48,8,56,20659378,3,0,0,0,20216
a52eb51d1af0edc9273a947535a2a36886e625da,0,Oleg Nechiporenko,2015-05-28 18:02:28+03:00,['aba28e05e975adedeb6f76a4e88b209d9b6f7397'],1,23,24,20659402,3,,,,20216
adbfa0933cf3ec854ea7274ad165353c4071ea9a,0,Robert Levas,2015-05-28 11:22:30-04:00,['a52eb51d1af0edc9273a947535a2a36886e625da'],3,4,7,20659409,1,0,1,1,20216
e2b8a0e92c8e73fd52050bb986238996b7b6cd94,1,Robert Levas,2015-05-28 12:11:44-04:00,['adbfa0933cf3ec854ea7274ad165353c4071ea9a'],524,481,1005,20660414,20,0,0,0,20217
b04fb769a3bd6ef7a3968f01a374bd08490502a6,1,Jonathan Hurley,2015-05-28 12:12:21-04:00,['e2b8a0e92c8e73fd52050bb986238996b7b6cd94'],14,63,77,20660491,4,0.470588235,0.941176471,1,20217
b0634464e625fe80fbe693905a46d2555088afec,1,Robert Levas,2015-05-28 12:54:29-04:00,['b04fb769a3bd6ef7a3968f01a374bd08490502a6'],630,555,1185,20661676,53,0,0,0.448979592,20218
27a376734fe95fb3055f5e21e00c071a00bc10ff,0,Vitaly Brodetskyi,2015-05-28 19:54:49+03:00,['b0634464e625fe80fbe693905a46d2555088afec'],0,1,1,20661677,1,,,,20218
70a59ef0904dc2229381be5fb9809243e7bc6b47,0,Robert Levas,2015-05-28 13:00:57-04:00,['27a376734fe95fb3055f5e21e00c071a00bc10ff'],1,1,2,20661679,1,,,,20218
2cb335c47b16c01457ec57c22eb826b739cf2bea,1,Alex Antonenko,2015-05-28 20:08:18+03:00,['70a59ef0904dc2229381be5fb9809243e7bc6b47'],3,67,70,20661749,3,0.609756098,1,1,20218
3cfc2be315644e342b301d6144ada4ab012bc55c,1,Sumit Mohanty,2015-05-28 10:38:42-07:00,['2cb335c47b16c01457ec57c22eb826b739cf2bea'],4,4,8,20661757,1,,,,20218
c20d80b658470ea2014b003f1f5b3ac60939f7da,1,Srimanth Gunturi,2015-05-28 10:52:27-07:00,['3cfc2be315644e342b301d6144ada4ab012bc55c'],4,4,8,20661765,4,,,,20218
d4ec03f345f44ebe01285c7a8cab5188d3048c4c,0,Srimanth Gunturi,2015-05-28 11:05:06-07:00,['c20d80b658470ea2014b003f1f5b3ac60939f7da'],9,9,18,20661783,9,,,,20218
62bfe93ccc8cbc3b1f857ff3979df26f59534152,0,Alex Antonenko,2015-05-28 21:09:40+03:00,['d4ec03f345f44ebe01285c7a8cab5188d3048c4c'],0,1,1,20661784,1,,,,20218
7dfcbe27b2373139f5da2d356d3b584b5b36c730,1,Alex Antonenko,2015-05-28 21:14:07+03:00,['62bfe93ccc8cbc3b1f857ff3979df26f59534152'],9,14,23,20661807,3,1,0,1,20218
be7aa40d5fbf267359c29209e66bc03fd184ad12,1,Alex Antonenko,2015-05-28 21:14:55+03:00,['7dfcbe27b2373139f5da2d356d3b584b5b36c730'],10,18,28,20661835,3,1,1,1,20218
f81b4f8966d14b941d9f503ff386d39f996d9337,0,Alex Antonenko,2015-05-28 21:15:32+03:00,['be7aa40d5fbf267359c29209e66bc03fd184ad12'],1,1,2,20661837,1,,,,20218
98586c0ceccb94092b0f3698361ec3ac7b099eb4,1,Dmytro Sen,2015-05-28 22:11:24+03:00,['f81b4f8966d14b941d9f503ff386d39f996d9337'],13,14,27,20661864,3,0,0,0,20218
e7e350390a85f237e961f143c87953c42c29213e,1,Nate Cole,2015-05-28 15:17:17-04:00,['98586c0ceccb94092b0f3698361ec3ac7b099eb4'],30,490,520,20662384,13,0.042553191,0.095744681,0.989361702,20220
cf4df7e6e660e07e2b873590557afecc73abd5fc,0,Nate Cole,2015-05-28 15:19:19-04:00,['e7e350390a85f237e961f143c87953c42c29213e'],3,0,3,20662387,1,,,,20220
869709914977e5671cf7207dc5da18fe65bf2ad7,1,Artem Baranchuk,2015-05-28 22:25:07+03:00,['cf4df7e6e660e07e2b873590557afecc73abd5fc'],72,73,145,20662532,4,,,,20220
3af7d0147a1ac02948ed547d4b9edfb67758a4cc,1,Srimanth Gunturi,2015-05-28 12:32:43-07:00,['869709914977e5671cf7207dc5da18fe65bf2ad7'],10,31,41,20662573,1,1,1,1,20220
872c62457e6ae469f4fb3a0cbd1564a0e7c0f521,0,Xi Wang,2015-05-28 13:24:41-07:00,['3af7d0147a1ac02948ed547d4b9edfb67758a4cc'],0,9,9,20662582,1,,,,20220
db09f15f9eb9ea078c5b457af241fea11c3abed5,1,tbeerbower,2015-05-28 16:47:21-04:00,['872c62457e6ae469f4fb3a0cbd1564a0e7c0f521'],126,86,212,20662794,4,0.702702703,0.054054054,0.378378378,20220
ce429e75014edfb08ea20dbff3826127ab3a509a,1,Alejandro Fernandez,2015-05-28 14:21:07-07:00,['db09f15f9eb9ea078c5b457af241fea11c3abed5'],19,52,71,20662865,5,0,1,1,20220
46e2d3e129d6876d3706fa234a3aebfc2c38c9e5,1,Alejandro Fernandez,2015-05-28 14:24:33-07:00,['ce429e75014edfb08ea20dbff3826127ab3a509a'],4,22,26,20662891,3,0,0,1,20220
2975e5108d5d20a136c3815cd552abd1c73c4b04,1,Jaimin Jetly,2015-05-28 14:47:46-07:00,['46e2d3e129d6876d3706fa234a3aebfc2c38c9e5'],48,75,123,20663014,5,,,,20220
025ca257a4598ce05c4e1295a57ffa9cc03fea2b,1,Srimanth Gunturi,2015-05-28 14:58:55-07:00,['2975e5108d5d20a136c3815cd552abd1c73c4b04'],0,30,30,20663044,3,0,0.391304348,0.391304348,20220
2bd0014a66082079a703d7ea2b43d97d7cb132a2,0,Siddharth Wagle,2015-05-28 15:28:05-07:00,['025ca257a4598ce05c4e1295a57ffa9cc03fea2b'],1,1,2,20663046,1,,,,20220
3d8e9acc978cdc68dc9e4088fc073be23b7c6961,1,Myroslav Papirkovskyy,2015-05-29 01:47:07+03:00,['2bd0014a66082079a703d7ea2b43d97d7cb132a2'],27,14,41,20663087,6,0.5,1,0.1,20220
c74ebac528eadb0f6b4e0578a1188c60e4f99696,1,Jayush Luniya,2015-05-28 17:19:00-07:00,['3d8e9acc978cdc68dc9e4088fc073be23b7c6961'],92,197,289,20663376,4,,,,20220
6c0f9acef0f7ada38ebbd59a4fc2a70652050f4c,1,tbeerbower,2015-05-28 21:46:37-04:00,['c74ebac528eadb0f6b4e0578a1188c60e4f99696'],18,311,329,20663705,7,1,1,0.582524272,20221
4e7a135edf02ee49088b7523b22f1a428511df8f,1,Jaimin Jetly,2015-05-28 19:51:25-07:00,['6c0f9acef0f7ada38ebbd59a4fc2a70652050f4c'],70,154,224,20663929,4,0.333333333,1,1,20222
0f602e15c137df0da40aae8451d2864b326d1dce,1,aBabiichuk,2015-05-29 11:12:41+03:00,['4e7a135edf02ee49088b7523b22f1a428511df8f'],16,43,59,20663988,3,1,1,1,20222
3dd19b16027440e837f0a5acd0369771eca95122,1,Oleg Nechiporenko,2015-05-29 12:21:26+03:00,['0f602e15c137df0da40aae8451d2864b326d1dce'],17,202,219,20664207,2,0.64,1,1,20222
d8da5af93306f194f90365f6bf4123a123c53bca,1,Oleg Nechiporenko,2015-05-29 12:50:03+03:00,['3dd19b16027440e837f0a5acd0369771eca95122'],5,13,18,20664225,1,1,1,1,20222
0224b675cbac6134f0f1bf25fb7a9d0de091e098,1,Andrew Onishuk,2015-05-29 15:00:06+03:00,['d8da5af93306f194f90365f6bf4123a123c53bca'],93,1405,1498,20665723,66,0.266313933,0.24691358,0.610229277,20228
81a2fa3b711ec78aaaefaef2acc8b59805e40f5d,1,Oleg Nechiporenko,2015-05-29 16:21:48+03:00,['0224b675cbac6134f0f1bf25fb7a9d0de091e098'],17,103,120,20665843,11,0.782608696,0.797101449,1,20228
a48150ff2f678439054e9f86dd864ca02eff8d43,1,Dmytro Sen,2015-05-29 17:41:21+03:00,['81a2fa3b711ec78aaaefaef2acc8b59805e40f5d'],87,110,197,20666040,12,1,1,0,20228
6cbddf478a6d05e5ccabd1a3b756f09cfb1eeb81,0,Artem Baranchuk,2015-05-29 17:58:16+03:00,['a48150ff2f678439054e9f86dd864ca02eff8d43'],1,2,3,20666043,1,,,,20228
eeb8655acca8d8e2d4face8f3730348ffedcdbde,1,Robert Levas,2015-05-29 12:10:40-04:00,['6cbddf478a6d05e5ccabd1a3b756f09cfb1eeb81'],2,2,4,20666047,1,,,,20228
46ef6df48e24279b2cfae5adf344a36f7a761d4f,0,Florian Barca,2015-05-29 09:17:42-07:00,['eeb8655acca8d8e2d4face8f3730348ffedcdbde'],5,8,13,20666060,1,1,0,1,20228
2831bdb3f90104b12c795ebb06057c0ccb37f154,0,Srimanth Gunturi,2015-05-29 09:22:01-07:00,['46ef6df48e24279b2cfae5adf344a36f7a761d4f'],2,27,29,20666089,2,,,,20228
2dbb7b2842807359937b5d15fb4a35635333622f,1,Florian Barca,2015-05-29 09:43:46-07:00,['2831bdb3f90104b12c795ebb06057c0ccb37f154'],30,130,160,20666249,9,0.719298246,0.719298246,0.877192982,20228
c8d214fc4c8505bec60046006e671f3c96e5e1dd,1,Robert Levas,2015-05-29 13:01:44-04:00,['2dbb7b2842807359937b5d15fb4a35635333622f'],2,34,36,20666285,3,,,,20228
c2764be2f12d4ef6c12d6ad73a8d810443e9124d,1,Jonathan Hurley,2015-05-29 13:08:17-04:00,['c8d214fc4c8505bec60046006e671f3c96e5e1dd'],15,80,95,20666380,5,0.230769231,1,1,20228
3c563d3b282ab7a552f9dc95b84d6e2a13414166,1,Sumit Mohanty,2015-05-29 10:36:34-07:00,['c2764be2f12d4ef6c12d6ad73a8d810443e9124d'],4,34,38,20666418,3,0,0.857142857,1,20228
e5339f3cd861c8891c2c976b8a33b0a003f85233,0,Andrew Onishuk,2015-05-29 21:53:57+03:00,['3c563d3b282ab7a552f9dc95b84d6e2a13414166'],0,2,2,20666420,1,,,,20228
f4db0142840e1948005fd57dba4d9736600cf7d6,0,Alex Antonenko,2015-05-29 22:30:04+03:00,['e5339f3cd861c8891c2c976b8a33b0a003f85233'],11,23,34,20666454,2,0.125,1,1,20228
337f45e1df7724aef0bdecb95b0a331a76f64513,0,Alex Antonenko,2015-05-29 22:30:04+03:00,['f4db0142840e1948005fd57dba4d9736600cf7d6'],1,55,56,20666510,2,0.346153846,1,1,20228
784675c7676595d4c7e7058b582378b84af11a50,0,Alex Antonenko,2015-05-29 22:30:04+03:00,['337f45e1df7724aef0bdecb95b0a331a76f64513'],0,4,4,20666514,1,0,1,1,20228
07a04c95e16d92a0ce27492c109bed00a3b5c0a2,0,Sumit Mohanty,2015-05-29 12:57:34-07:00,['784675c7676595d4c7e7058b582378b84af11a50'],1,1,2,20666516,1,,,,20228
5767697ca26d0c3d458dd6cdb6128d20d105c6ca,1,John Speidel,2015-05-29 16:06:04-04:00,['07a04c95e16d92a0ce27492c109bed00a3b5c0a2'],30,38,68,20666584,1,0,0,0,20228
8f077e15416d1627ce15536e27c3f0626d19d9b0,1,tbeerbower,2015-05-29 16:27:36-04:00,['5767697ca26d0c3d458dd6cdb6128d20d105c6ca'],19,18,37,20666621,2,1,1,0,20228
f8a5cc1d5ccc4457ca767428f95a915d022f1b4a,0,Florian Barca,2015-05-29 13:20:38-07:00,['8f077e15416d1627ce15536e27c3f0626d19d9b0'],0,8,8,20666629,2,,,,20228
1296ca586f83194776c1c80843070e726b9dc340,1,tbeerbower,2015-05-29 16:33:14-04:00,['f8a5cc1d5ccc4457ca767428f95a915d022f1b4a'],16,93,109,20666738,2,0,0,1,20228
01e9655cfbfbac946227f66a54caacf457028c72,0,Xi Wang,2015-05-29 14:14:28-07:00,['1296ca586f83194776c1c80843070e726b9dc340'],3,7,10,20666748,2,0.75,1,1,20228
7e88541ce5f46405f2c73995769a7dfa00c359d9,1,Robert Levas,2015-05-29 17:29:25-04:00,['01e9655cfbfbac946227f66a54caacf457028c72'],0,4,4,20666752,1,0,1,0,20228
e3acc7f06ab42bdfa84d59880d7f6c76f78277fc,1,Robert Levas,2015-05-29 19:48:15-04:00,['7e88541ce5f46405f2c73995769a7dfa00c359d9'],3270,4003,7273,20674025,14,0.358490566,0,1,20233
69849050d9eafe4b72c591be2c00aadb0d944443,1,Jonathan Hurley,2015-05-29 21:07:11-04:00,['e3acc7f06ab42bdfa84d59880d7f6c76f78277fc'],11,38,49,20674074,3,0,0.636363636,1,20233
4ed15d018b99311cd6849dd578178f84e6053752,0,Oleg Nechiporenko,2015-05-30 12:46:18+03:00,['69849050d9eafe4b72c591be2c00aadb0d944443'],0,3,3,20674077,1,0,1,1,20233
b79fd597cd54f8029b21d247b2647695aa95a7b9,1,Andrew Onishuk,2015-05-30 19:23:58+03:00,['4ed15d018b99311cd6849dd578178f84e6053752'],83,205,288,20674365,7,0.040816327,0.887755102,0.969387755,20233
212e23f3d31b49a4c3c6fc765d53455d14fc0c04,1,Alex Antonenko,2015-05-30 21:46:22+03:00,['b79fd597cd54f8029b21d247b2647695aa95a7b9'],6,1045,1051,20675416,2,0.709159585,0.997167139,1,20233
77593a2a378301dd4c75b6492a84b35406901c0e,0,Alex Antonenko,2015-05-30 21:46:23+03:00,['212e23f3d31b49a4c3c6fc765d53455d14fc0c04'],0,4,4,20675420,1,1,1,1,20233
f11aa6245bf64a3f12407aa1dc18b1a8eda6786e,1,Alex Antonenko,2015-05-30 21:46:23+03:00,['77593a2a378301dd4c75b6492a84b35406901c0e'],1,4,5,20675425,1,0.666666667,1,1,20233
858a52d18ee694938ccb48aca6f363a05c07576e,1,Aleksandr Kovalenko,2015-05-30 21:58:10+03:00,['f11aa6245bf64a3f12407aa1dc18b1a8eda6786e'],211,215,426,20675851,10,1,1,0.4,20233
bd155e9379af8b5abe821b858f44f6be638d7e0a,0,Dmytro Sen,2015-05-30 23:23:02+03:00,['858a52d18ee694938ccb48aca6f363a05c07576e'],0,1,1,20675852,1,,,,20233
af1198c5815fad897fb45495c104b68f74b75383,1,Srimanth Gunturi,2015-05-30 13:42:48-07:00,['bd155e9379af8b5abe821b858f44f6be638d7e0a'],1,1,2,20675854,1,,,,20233
3353ec2dacdc419faca2bea85edf6565344e35ff,1,Myroslav Papirkovskyy,2015-05-29 06:30:59+03:00,['af1198c5815fad897fb45495c104b68f74b75383'],8,92,100,20675954,7,0.146666667,0.986666667,0.84,20233
04673a2663d50d3ae81cbc0b7dc0a3502271a4c3,1,Srimanth Gunturi,2015-05-30 15:22:06-07:00,['3353ec2dacdc419faca2bea85edf6565344e35ff'],7,27,34,20675988,5,,,,20233
340e7dab1f769e722f3f4401f500d51b1abcb04b,1,Srimanth Gunturi,2015-05-30 15:37:07-07:00,['04673a2663d50d3ae81cbc0b7dc0a3502271a4c3'],0,12,12,20676000,1,1,1,1,20233
f6c4fd992a4532f08087c60f537e3e21ee44159b,1,Jonathan Hurley,2015-05-30 19:03:47-04:00,['340e7dab1f769e722f3f4401f500d51b1abcb04b'],16,65,81,20676081,2,0.208333333,1,1,20233
517bdeb4a91736f7b1a05318bfd45678e9171f3c,1,Bob Nettleton,2015-05-30 22:50:10-04:00,['f6c4fd992a4532f08087c60f537e3e21ee44159b'],10,586,596,20676677,4,0.149635036,0.857664234,0.773722628,20233
f4114bc3b37fb1f9327803ff199f14f4983e99b1,1,Vitaly Brodetskyi,2015-05-31 13:32:06+03:00,['517bdeb4a91736f7b1a05318bfd45678e9171f3c'],47,114,161,20676838,2,0.01754386,0.070175439,1,20233
4024cf3665ccc600ecfb43d14be016a19a0cd1fe,1,Robert Levas,2015-05-31 10:02:38-04:00,['f4114bc3b37fb1f9327803ff199f14f4983e99b1'],7,124,131,20676969,2,0.965517241,0.965517241,0.965517241,20234
8c569a8b0c661a10effca68f4b1b5da98fb8079d,1,Siddharth Wagle,2015-05-31 08:25:40-07:00,['4024cf3665ccc600ecfb43d14be016a19a0cd1fe'],3,71,74,20677043,3,0,0,1,20234
bf2a1ec1846e8b1bc87b72af539b595dd8df4814,1,Aleksandr Kovalenko,2015-05-31 18:46:58+03:00,['8c569a8b0c661a10effca68f4b1b5da98fb8079d'],0,77,77,20677120,5,1,1,1,20234
74418fe9a7dfeebe15b659062aee5bec2c3e2cf7,1,Andrew Onishuk,2015-05-31 18:51:37+03:00,['bf2a1ec1846e8b1bc87b72af539b595dd8df4814'],64,29,93,20677213,11,1,0,0.072727273,20234
c6e485c8e113c9739fad08a6044fb839073a1051,0,Sumit Mohanty,2015-05-31 09:06:23-07:00,['74418fe9a7dfeebe15b659062aee5bec2c3e2cf7'],9,9,18,20677231,1,,,,20234
d959fa23aae1437e48ce06d18e05f0dd88f31b01,0,Jonathan Hurley,2015-05-31 14:04:42-04:00,['c6e485c8e113c9739fad08a6044fb839073a1051'],18,81,99,20677330,2,0,0.885714286,1,20234
226b9a076f063d5174b78d0adfa835a25a8a97c7,1,Siddharth Wagle,2015-05-31 11:43:00-07:00,['d959fa23aae1437e48ce06d18e05f0dd88f31b01'],32,34,66,20677396,4,0,0,0,20234
6c078c7ad97565ac7fb1eca5bf43aa35f378cce3,1,Vitaly Brodetskyi,2015-05-31 19:24:21+03:00,['226b9a076f063d5174b78d0adfa835a25a8a97c7'],1,1,2,20677398,1,,,,20234
0603d0048ad831a24da6ab3175227f2c09d604d8,1,Sumit Mohanty,2015-05-31 12:39:17-07:00,['6c078c7ad97565ac7fb1eca5bf43aa35f378cce3'],5,60,65,20677463,3,0,0.413793103,1,20234
f3d49fade0106f3373a042a65d1808459d8499e7,0,Artem Baranchuk,2015-05-31 22:55:36+03:00,['0603d0048ad831a24da6ab3175227f2c09d604d8'],10,17,27,20677490,3,1,1,1,20234
f4631d7045fe6d76309f61f2a0adf7ce797d7b96,1,Alex Antonenko,2015-05-31 23:02:55+03:00,['f3d49fade0106f3373a042a65d1808459d8499e7'],7,23,30,20677520,4,0.882352941,1,0.882352941,20234
2ea32f886d06f30acb1ba03449447894cbbe5492,1,Alex Antonenko,2015-05-31 23:06:29+03:00,['f4631d7045fe6d76309f61f2a0adf7ce797d7b96'],0,90,90,20677610,2,0.519480519,1,1,20234
23604e3a199457030cb531e05e2dc594b3db80b6,1,Alex Antonenko,2015-05-31 23:06:29+03:00,['2ea32f886d06f30acb1ba03449447894cbbe5492'],11,16,27,20677637,1,0.8,1,1,20234
3ac16966d577f8d956ef3b1189fb4d97a55e3f79,1,Jayush Luniya,2015-05-31 14:59:39-07:00,['23604e3a199457030cb531e05e2dc594b3db80b6'],21,110,131,20677768,4,,,,20237
5204b3a02d48720eb61ea3465aa9f7adb893c6e3,1,Aleksandr Kovalenko,2015-06-01 01:00:27+03:00,['3ac16966d577f8d956ef3b1189fb4d97a55e3f79'],0,79,79,20677847,3,1,1,1,20238
c7ed673bbea8371331ea92b564c61a2b8e8689ac,0,Robert Levas,2015-05-31 18:17:44-04:00,['5204b3a02d48720eb61ea3465aa9f7adb893c6e3'],13,14,27,20677874,2,1,1,,20238
643a7261530ca32fa251f0314cad17c005383c9c,1,Robert Levas,2015-05-31 19:14:14-04:00,['c7ed673bbea8371331ea92b564c61a2b8e8689ac'],53,179,232,20678106,13,0,0.933333333,0.983333333,20238
06d152490ba71ce831fbbf7510dff6cf7469d839,0,Sumit Mohanty,2015-05-31 18:27:10-07:00,['643a7261530ca32fa251f0314cad17c005383c9c'],1,1,2,20678108,1,,,,20238
2b9c0e64f9e9de6febb946ba49c08be9992f2670,0,Sumit Mohanty,2015-05-31 19:02:05-07:00,['06d152490ba71ce831fbbf7510dff6cf7469d839'],2,2,4,20678112,1,,,,20238
106c9fa09b53c24800d017e6074b917c1046c964,0,Sumit Mohanty,2015-05-31 19:16:17-07:00,['2b9c0e64f9e9de6febb946ba49c08be9992f2670'],0,1,1,20678113,1,0,0,0,20238
933745e2e44f6dc64a6fe0284e1c57064291cd6a,0,Sumit Mohanty,2015-05-31 22:38:54-07:00,['106c9fa09b53c24800d017e6074b917c1046c964'],5,1,6,20678119,1,1,0,0,20238
60ea8dbf5457267d5754c72e6a15c7ba010efd56,1,Andrew Onishuk,2015-06-01 12:06:51+03:00,['933745e2e44f6dc64a6fe0284e1c57064291cd6a'],64,626,690,20678809,29,0,1,1,20240
dcc93c9c6f2b4a23051fa66537ffd203bfc2101e,0,Aleksandr Kovalenko,2015-06-01 14:46:24+03:00,['60ea8dbf5457267d5754c72e6a15c7ba010efd56'],1,1,2,20678811,1,,,,20240
ee96fdebcbed850814a8d1b2369530478aa5f0f5,1,Andrew Onishuk,2015-06-01 15:30:28+03:00,['dcc93c9c6f2b4a23051fa66537ffd203bfc2101e'],11,50,61,20678872,9,,,,20240
6f13d10ac7b86bb8dc53e7a9da4573fb6116fc49,1,Andrew Onishuk,2015-06-01 15:46:40+03:00,['ee96fdebcbed850814a8d1b2369530478aa5f0f5'],0,54,54,20678926,2,0,1,0.688888889,20240
3258b649e2bf0131e7d0c131a816b78f4dbfc091,0,tbeerbower,2015-06-01 09:19:38-04:00,['6f13d10ac7b86bb8dc53e7a9da4573fb6116fc49'],29,233,262,20679188,3,0.75,0.973684211,1,20241
45d7790312a57ae5cdd6845adc89a853b4295137,1,Myroslav Papirkovskyy,2015-06-01 19:42:14+03:00,['3258b649e2bf0131e7d0c131a816b78f4dbfc091'],24,50,74,20679262,5,0.6,1,1,20241
6ba3da22baee31aefa6ff98ba706d7233cd8dc68,1,Andrew Onishuk,2015-06-01 17:36:55+03:00,['45d7790312a57ae5cdd6845adc89a853b4295137'],130,114,244,20679506,2,1,0.611111111,1,20241
8db087af8f3358bbd795c4ae4643289429151400,1,Srimanth Gunturi,2015-06-01 09:39:31-07:00,['6ba3da22baee31aefa6ff98ba706d7233cd8dc68'],1895,205,2100,20681606,11,0,0.27027027,0.27027027,20241
748b2a188fb87b8311677f34b232c960816ab72f,1,Alex Antonenko,2015-06-01 20:13:55+03:00,['8db087af8f3358bbd795c4ae4643289429151400'],37,57,94,20681700,6,1,1,1,20241
aefc39aaa3bda41e19872be61a0ccab2cd26d706,1,Alex Antonenko,2015-06-01 20:13:55+03:00,['748b2a188fb87b8311677f34b232c960816ab72f'],3,153,156,20681856,4,0.779069767,1,1,20241
5059af2eb7dc27f073138224cb4023ba9b6e3c49,1,Sumit Mohanty,2015-06-01 10:14:11-07:00,['aefc39aaa3bda41e19872be61a0ccab2cd26d706'],7,15,22,20681878,2,0,0.625,0.625,20241
9ff3a81c50b1469b1a7f67e632daab697cf8c6f0,1,Jaimin Jetly,2015-06-01 10:42:03-07:00,['5059af2eb7dc27f073138224cb4023ba9b6e3c49'],55,76,131,20682009,4,,,,20241
94e9657165888e64769844a1f6a0e82bdc7b2053,1,Myroslav Papirkovskyy,2015-06-01 20:56:44+03:00,['9ff3a81c50b1469b1a7f67e632daab697cf8c6f0'],9,9,18,20682027,1,,,,20241
994f6ccdcd521329bbf604c3005851f22bb7d218,1,Nate Cole,2015-06-01 15:47:13-04:00,['94e9657165888e64769844a1f6a0e82bdc7b2053'],23,25,48,20682075,2,,,,20241
fd1baecfd30a3a0ff4388d9585fee3bf7b2824c3,1,Aleksandr Kovalenko,2015-06-01 23:22:16+03:00,['994f6ccdcd521329bbf604c3005851f22bb7d218'],72,141,213,20682288,9,1,1,1,20243
70ec7ecad1f8a0bfb20910bb0b5afe07d9e7fe48,1,Jaimin Jetly,2015-06-01 13:52:04-07:00,['fd1baecfd30a3a0ff4388d9585fee3bf7b2824c3'],2,15,17,20682305,2,1,1,1,20243
7f5d9487e283ac3d7d527673debe44a4e9961a7e,1,Alejandro Fernandez,2015-06-01 14:27:18-07:00,['70ec7ecad1f8a0bfb20910bb0b5afe07d9e7fe48'],6,6,12,20682317,4,,,,20243
43747102b5ebd862e6ae3e9348ab7420802e8592,1,Srimanth Gunturi,2015-06-01 15:23:40-07:00,['7f5d9487e283ac3d7d527673debe44a4e9961a7e'],19,23,42,20682359,2,0,0.5,0.5,20243
7a2c3d9523559a5ff2b97fe2120c6e7c13cba59f,1,Xi Wang,2015-06-01 15:30:36-07:00,['43747102b5ebd862e6ae3e9348ab7420802e8592'],4,2,6,20682365,1,,,,20243
7f75455fbac9e09d7d2fff5caaf94d38757d4474,0,Srimanth Gunturi,2015-06-01 16:59:23-07:00,['7a2c3d9523559a5ff2b97fe2120c6e7c13cba59f'],0,7,7,20682372,1,,,,20243
aa9aaf6a15ebdb65fca9180c1f5fe408c059a4bb,0,Sumit Mohanty,2015-06-01 17:00:52-07:00,['7f75455fbac9e09d7d2fff5caaf94d38757d4474'],3,108,111,20682483,10,0.8125,0.8125,1,20244
58286e01ebf7716c6e4470912ffdd2445c417e97,1,Jaimin Jetly,2015-06-01 17:09:07-07:00,['aa9aaf6a15ebdb65fca9180c1f5fe408c059a4bb'],5,6,11,20682494,2,1,1,1,20244
8cd80a1f48378be57f839eb0652496eefe47ef1e,1,Srimanth Gunturi,2015-06-01 17:18:09-07:00,['58286e01ebf7716c6e4470912ffdd2445c417e97'],5,24,29,20682523,5,0.142857143,1,1,20244
7650c98672862233d74b514daf14860c4e0fc388,1,Yusaku Sako,2015-06-01 17:19:21-07:00,['8cd80a1f48378be57f839eb0652496eefe47ef1e'],1,1,2,20682525,1,,,,20244
aacda1fa3be825572549a156c14f94bd24d56665,1,Srimanth Gunturi,2015-06-01 17:20:15-07:00,['7650c98672862233d74b514daf14860c4e0fc388'],2,2,4,20682529,1,,,,20244
51caa8a042891cdae1b7dbdb8ecb06fda75e38d6,1,Jonathan Hurley,2015-06-01 20:54:29-04:00,['aacda1fa3be825572549a156c14f94bd24d56665'],207,259,466,20682995,17,0,0.142857143,1,20244
6a9620ab4a0e55e37ef00388592e4e5dba48a886,0,Srimanth Gunturi,2015-06-01 18:54:35-07:00,['51caa8a042891cdae1b7dbdb8ecb06fda75e38d6'],2,18,20,20683015,3,0,0.583333333,0.583333333,20244
4e1e89d104f2615ad82a91f6005c4079d6beb28b,1,Sumit Mohanty,2015-06-01 21:33:21-07:00,['6a9620ab4a0e55e37ef00388592e4e5dba48a886'],108,3,111,20683126,10,0.1875,0.1875,0,20244
ad5b545248a67cc0045ffc986b4d2f05f38a4eca,0,Srimanth Gunturi,2015-06-01 22:43:27-07:00,['4e1e89d104f2615ad82a91f6005c4079d6beb28b'],1,1,2,20683128,1,,,,20244
46bf5cb1377db5168f6c99e79f436030d9531ab5,1,Oleg Nechiporenko,2015-06-02 14:10:28+03:00,['ad5b545248a67cc0045ffc986b4d2f05f38a4eca'],12,53,65,20683193,3,0.259259259,1,1,20244
f4a6b76b63f35a8e52dfea5c443c1edd27e165a8,1,Oleg Nechiporenko,2015-06-02 15:02:56+03:00,['46bf5cb1377db5168f6c99e79f436030d9531ab5'],1,5,6,20683199,1,,,,20244
3bb7a6dc3a8fa45b589c171b0fe54a1beb0bd8a1,1,Lisnichenko Dmitro,2015-06-02 16:02:57+03:00,['f4a6b76b63f35a8e52dfea5c443c1edd27e165a8'],0,71,71,20683270,2,0,0.333333333,1,20244
1bb0a8dad6da296dd06cc3b998c974389b2e765f,1,Lisnichenko Dmitro,2015-06-02 16:03:25+03:00,['3bb7a6dc3a8fa45b589c171b0fe54a1beb0bd8a1'],2,4,6,20683276,1,,,,20244
cc0d68b98ffd54589b7c157e55a91260decaa34b,1,Jonathan Hurley,2015-06-02 09:20:47-04:00,['1bb0a8dad6da296dd06cc3b998c974389b2e765f'],4,5,9,20683285,1,,,,20244
e83125106fdc5815cff12913708f65304dd9c8cc,1,Lisnichenko Dmitro,2015-06-02 16:22:45+03:00,['cc0d68b98ffd54589b7c157e55a91260decaa34b'],0,353,353,20683638,3,0.245901639,0.245901639,0.344262295,20247
d4a26a8fe78cc8d18b4bb0899711dd4fa08f8c88,0,Andrii Tkach,2015-06-02 16:23:15+03:00,['e83125106fdc5815cff12913708f65304dd9c8cc'],34,76,110,20683748,4,1,1,0.428571429,20247
eb2cae7bc64aa496a10ef74228b88f12f2d80185,1,Robert Levas,2015-06-02 10:14:49-04:00,['d4a26a8fe78cc8d18b4bb0899711dd4fa08f8c88'],1,1,2,20683750,1,,,,20247
e30a1c82908349b2621a1600e6d4c1e03e88a5ec,1,Sumit Mohanty,2015-06-02 07:27:52-07:00,['eb2cae7bc64aa496a10ef74228b88f12f2d80185'],3,109,112,20683862,10,0.8125,0.8125,1,20248
9fa9c756e8994ad374a897dbd6c6167aef94a492,1,Vitaly Brodetskyi,2015-06-02 13:01:18+03:00,['e30a1c82908349b2621a1600e6d4c1e03e88a5ec'],18,24,42,20683904,1,0,0,1,20248
9614eb6a2344be89beffeba5cd1230d8f3f76ee2,1,Alex Antonenko,2015-06-02 17:50:51+03:00,['9fa9c756e8994ad374a897dbd6c6167aef94a492'],40,137,177,20684081,10,0.508196721,0.31147541,0.868852459,20249
abb7028956c328a98cdeccb6f2a7e63b0f45f55e,0,Alex Antonenko,2015-06-02 17:50:51+03:00,['9614eb6a2344be89beffeba5cd1230d8f3f76ee2'],2,2,4,20684085,1,,,,20249
9e75a73704d2965bea3de033fe4dcb230dcad895,1,Alex Antonenko,2015-06-02 17:50:51+03:00,['abb7028956c328a98cdeccb6f2a7e63b0f45f55e'],4,15,19,20684104,3,0,1,0.8,20249
7f3945548e419099a17a72d86a4ff6a236f5519d,1,Lisnichenko Dmitro,2015-06-02 17:58:16+03:00,['9e75a73704d2965bea3de033fe4dcb230dcad895'],2,5,7,20684111,1,,,,20249
dfe0dfebe4b90efc0eca2ed66da654a2e890c3df,1,Vitaly Brodetskyi,2015-06-02 13:12:44+03:00,['7f3945548e419099a17a72d86a4ff6a236f5519d'],12,25,37,20684148,1,1,1,1,20249
1208fc5385296d89ca4513948ce06147e1f5476f,1,Aleksandr Kovalenko,2015-06-02 18:10:16+03:00,['dfe0dfebe4b90efc0eca2ed66da654a2e890c3df'],5,78,83,20684231,2,0.138888889,1,1,20249
19f18f5772ce42c10307405df92d82151c6601b6,0,Aleksandr Kovalenko,2015-06-02 18:10:17+03:00,['1208fc5385296d89ca4513948ce06147e1f5476f'],2,4,6,20684237,1,,,,20249
ed5558742e4b8b88e495e0190ec1cbe04683ffe1,1,Robert Levas,2015-06-02 11:15:42-04:00,['19f18f5772ce42c10307405df92d82151c6601b6'],12,27,39,20684276,5,1,1,0,20249
62898b3d4a29024719ae0086420cdf226398bb89,1,Andrii Tkach,2015-06-02 18:46:21+03:00,['ed5558742e4b8b88e495e0190ec1cbe04683ffe1'],18,31,49,20684325,2,1,1,1,20249
82e2ac39e5f3c1fe242ab2a637f122e0badd9d8b,1,Jayush Luniya,2015-06-02 09:41:21-07:00,['62898b3d4a29024719ae0086420cdf226398bb89'],2,16,18,20684343,3,,,,20249
25191edf385963a3392c8e1789598065d1b285a5,0,Alejandro Fernandez,2015-06-02 10:14:57-07:00,['82e2ac39e5f3c1fe242ab2a637f122e0badd9d8b'],7,0,7,20684350,1,,,,20249
b6c115ba2487d16101e253f034e91ae686edb755,1,Alejandro Fernandez,2015-06-02 10:18:06-07:00,['25191edf385963a3392c8e1789598065d1b285a5'],83,95,178,20684528,4,1,0,0,20249
b40d808d3a4ee9c7855532e555d89dd5910301f3,1,Jonathan Hurley,2015-06-02 13:48:03-04:00,['b6c115ba2487d16101e253f034e91ae686edb755'],2,38,40,20684568,2,0,1,1,20249
8dcade74e2c669f0ec15e5562232fe12d51ca57e,1,Srimanth Gunturi,2015-06-02 11:12:56-07:00,['b40d808d3a4ee9c7855532e555d89dd5910301f3'],11,22,33,20684601,3,0,1,0,20249
79437ef2b9a6a85f5f7f5e9c0839e50c5cfe883c,0,Sumit Mohanty,2015-06-02 11:54:05-07:00,['8dcade74e2c669f0ec15e5562232fe12d51ca57e'],3,3,6,20684607,2,,,,20249
df12905a44300e2bf9107a0f408f54aeaba10eca,1,Jayush Luniya,2015-06-02 12:02:43-07:00,['79437ef2b9a6a85f5f7f5e9c0839e50c5cfe883c'],241,3,244,20684851,4,,0,,20249
2d0d5022f776e4cf347602d0ec6815a234341758,0,Billie Rinaldi,2015-06-02 12:48:56-07:00,['df12905a44300e2bf9107a0f408f54aeaba10eca'],0,0,0,20684851,1,,,,20249
b6d9b9c4e6b499b324c3d285648a54043189a939,0,Alejandro Fernandez,2015-06-02 15:37:10-07:00,['2d0d5022f776e4cf347602d0ec6815a234341758'],0,44,44,20684895,2,,,,20249
8d82fe45e13a9518e46bf2f058a4ef5c5026b64d,0,Florian Barca,2015-06-02 16:48:06-07:00,['b6d9b9c4e6b499b324c3d285648a54043189a939'],27,70,97,20684992,4,0,0,0.88,20249
216275d9572461be8437296e12d980f0ec68eaf7,1,Florian Barca,2015-06-02 16:51:55-07:00,['8d82fe45e13a9518e46bf2f058a4ef5c5026b64d'],0,68,68,20685060,3,0,0,1,20250
1f37453977488a855cbf5f0d7b2871930e0e4c92,1,Florian Barca,2015-06-02 16:54:17-07:00,['216275d9572461be8437296e12d980f0ec68eaf7'],1,1,2,20685062,1,,,,20250
167baf39e9f1a2c09a9102ce7e850c32d6e15f4b,1,Jayush Luniya,2015-06-02 17:01:16-07:00,['1f37453977488a855cbf5f0d7b2871930e0e4c92'],1,1,2,20685064,1,,,,20250
b7e1bcebf8244a63ffc594928dbb278370261c68,1,Jonathan Hurley,2015-06-02 20:53:30-04:00,['167baf39e9f1a2c09a9102ce7e850c32d6e15f4b'],142,178,320,20685384,4,1,0.84,0,20250
377693013263c03ae31d4fa129652584927b025b,0,Srimanth Gunturi,2015-06-02 21:47:38-07:00,['b7e1bcebf8244a63ffc594928dbb278370261c68'],1,10,11,20685395,2,1,1,1,20250
8661bdf06919f60cfd3df76ee7dba56d9636265d,0,Siddharth Wagle,2015-06-02 23:04:32-07:00,['377693013263c03ae31d4fa129652584927b025b'],2,2,4,20685399,2,,,,20250
f259fd1d0e0f7ae1e0d9bd859bdbd7218b5fecc7,1,Srimanth Gunturi,2015-06-02 23:16:46-07:00,['8661bdf06919f60cfd3df76ee7dba56d9636265d'],204,1894,2098,20687497,10,1,0.72972973,0.72972973,20251
cf37e4ce20b2d68359d51ddbb131e990a5db2cb1,1,Oleg Nechiporenko,2015-06-03 13:16:51+03:00,['f259fd1d0e0f7ae1e0d9bd859bdbd7218b5fecc7'],4,11,15,20687512,2,1,1,1,20251
1ecc4199646a44be91e2f2e3f1705f6a6d81ea8d,0,Oleg Nechiporenko,2015-06-03 13:27:50+03:00,['cf37e4ce20b2d68359d51ddbb131e990a5db2cb1'],5,27,32,20687544,1,0,1,1,20251
4ca2ba7a333f82ab289f1089a57c62789477c606,1,Andrew Onishuk,2015-06-03 13:40:03+03:00,['1ecc4199646a44be91e2f2e3f1705f6a6d81ea8d'],3,5,8,20687552,1,0,0,0,20251
5d24667912731399e86d2898089509f4df39a97f,1,Dmytro Sen,2015-06-03 15:23:03+03:00,['4ca2ba7a333f82ab289f1089a57c62789477c606'],7,30,37,20687589,6,0,0,1,20251
fd91efc03c5276ebbe49f9f742f5c37705912e7d,0,Lisnichenko Dmitro,2015-06-03 15:43:39+03:00,['5d24667912731399e86d2898089509f4df39a97f'],2,2,4,20687593,1,,,,20251
819b67bb3b264fb6d727918eb0a271b60e10ed69,1,Andrew Onishuk,2015-06-03 15:47:26+03:00,['fd91efc03c5276ebbe49f9f742f5c37705912e7d'],3,6,9,20687602,1,0,0,1,20251
e06e19c8f8d1bb4a72dabebd522e8ebc84107b04,1,Aleksandr Kovalenko,2015-06-03 16:16:52+03:00,['819b67bb3b264fb6d727918eb0a271b60e10ed69'],6,6,12,20687614,1,,,,20251
627401f6e6e4091529d67bc6d8188a44d010e282,0,Scott Creeley,2015-06-03 09:38:10-04:00,['e06e19c8f8d1bb4a72dabebd522e8ebc84107b04'],11293,0,11293,20698907,91,0.513333333,0.284,0.138666667,20251
5e778f0c11942ec7d67dfe511e45bf270fa2f6bc,0,Andrii Tkach,2015-06-03 16:55:23+03:00,['627401f6e6e4091529d67bc6d8188a44d010e282'],1,26,27,20698934,3,1,1,1,20251
8b379e39ee49518c0a9998ea42f6e2ec6003060d,0,Myroslav Papirkovskyy,2015-06-02 14:16:40+03:00,['5e778f0c11942ec7d67dfe511e45bf270fa2f6bc'],1,1,2,20698936,1,,,,20251
692c3a8c4c260dc8f9705e755efae0b6fe349bba,0,Artem Baranchuk,2015-06-03 17:34:24+03:00,['8b379e39ee49518c0a9998ea42f6e2ec6003060d'],2,3,5,20698941,2,,,,20251
b549e35d4dea2c57a4eb297faabb25d66f6a76fc,1,Andrew Onishuk,2015-06-03 18:09:28+03:00,['692c3a8c4c260dc8f9705e755efae0b6fe349bba'],44,67,111,20699052,7,0.5,0.5,1,20251
29fc9c2976352d60d4708d99dd525a084a34f28e,1,Andrew Onishuk,2015-06-03 18:12:06+03:00,['b549e35d4dea2c57a4eb297faabb25d66f6a76fc'],0,24,24,20699076,2,0,0,0.25,20251
64e033d081d2e715ebcbf97b691b6cacacc74ee0,1,Jonathan Hurley,2015-06-03 11:24:05-04:00,['29fc9c2976352d60d4708d99dd525a084a34f28e'],9,73,82,20699158,2,0,0.346153846,1,20251
576796f76104b9b6d04322f72af85b0fc9a9d5b8,1,Oleg Nechiporenko,2015-06-03 18:27:00+03:00,['64e033d081d2e715ebcbf97b691b6cacacc74ee0'],20,90,110,20699268,3,1,0,0,20251
eb1be1194cf010251e24b077a06890c31d034e58,1,Andrii Tkach,2015-06-03 19:06:31+03:00,['576796f76104b9b6d04322f72af85b0fc9a9d5b8'],10,53,63,20699331,3,0.97826087,0.760869565,1,20251
5c256cb5adc47be999b9bb17f776f3d2314e8fca,1,Andrii Tkach,2015-06-03 19:06:32+03:00,['eb1be1194cf010251e24b077a06890c31d034e58'],0,2,2,20699333,1,,,,20251
d7603b364c19e3320df01fa7f0df5945bc226cf9,1,Jayush Luniya,2015-06-03 09:29:44-07:00,['5c256cb5adc47be999b9bb17f776f3d2314e8fca'],1,151,152,20699485,3,0.069767442,0.069767442,0.058139535,20251
4a5076d7628acc1fdccfe3bfb90b6b687a597fe0,1,Nate Cole,2015-06-03 12:40:00-04:00,['d7603b364c19e3320df01fa7f0df5945bc226cf9'],11,117,128,20699613,7,0.194029851,0.76119403,1,20251
45fdb8eb1010688833f8446f96c3f4eabbf43723,0,Alex Antonenko,2015-06-03 20:03:04+03:00,['4a5076d7628acc1fdccfe3bfb90b6b687a597fe0'],1,1,2,20699615,1,,,,20251
f37920be1ff24ee57e0e735dbb304b8241b64281,1,Alex Antonenko,2015-06-03 20:03:05+03:00,['45fdb8eb1010688833f8446f96c3f4eabbf43723'],2,2,4,20699619,2,,,,20251
22cac0a2af6ee6f198650aa15e1d2c0d59dd13d6,0,Alex Antonenko,2015-06-03 20:03:05+03:00,['f37920be1ff24ee57e0e735dbb304b8241b64281'],4,0,4,20699623,1,,,,20251
7a75fb0a3eaf8ffcf253c9bad2ca0e76afca5d7f,0,Andrew Onishuk,2015-06-03 20:36:45+03:00,['22cac0a2af6ee6f198650aa15e1d2c0d59dd13d6'],0,7,7,20699630,1,1,1,1,20251
a4b215884e58e1185a83f539f2cd0696ccaefae2,0,Jaimin Jetly,2015-06-03 11:04:14-07:00,['7a75fb0a3eaf8ffcf253c9bad2ca0e76afca5d7f'],0,5,5,20699635,1,0,1,0,20251
e1314fc4cd7b6b8e4860a4d404b7dff7e9dfd51d,0,Xi Wang,2015-06-03 11:10:41-07:00,['a4b215884e58e1185a83f539f2cd0696ccaefae2'],1,1,2,20699637,1,,,,20251
42ac63163eb98aa08f270abbc9c1361847633f7d,1,Jaimin Jetly,2015-06-03 12:33:22-07:00,['e1314fc4cd7b6b8e4860a4d404b7dff7e9dfd51d'],4,4,8,20699645,2,,,,20251
2ef578f3c67041ca51b89a71461a830427efead8,0,Siddharth Wagle,2015-06-03 12:43:07-07:00,['42ac63163eb98aa08f270abbc9c1361847633f7d'],0,6,6,20699651,1,0,0,0,20251
414dbe00893d7daa59fdfb5e28e3852f80f5a44b,1,Jayush Luniya,2015-06-03 14:40:43-07:00,['2ef578f3c67041ca51b89a71461a830427efead8'],8,142,150,20699801,9,0.827586207,0.793103448,0.275862069,20252
01f70297665b92c031c774fbc438f700fb2507cf,0,Siddharth Wagle,2015-06-03 14:53:27-07:00,['414dbe00893d7daa59fdfb5e28e3852f80f5a44b'],0,9,9,20699810,1,0,1,1,20252
d59c24becc5ec553ef2dae23056b9d3beafde697,1,Bob Nettleton,2015-06-03 18:00:20-04:00,['01f70297665b92c031c774fbc438f700fb2507cf'],2,83,85,20699895,2,0.074074074,1,0.925925926,20252
8fcf9f1150dff97c67ffaaf166076b80f477a2ed,0,Florian Barca,2015-06-03 15:14:44-07:00,['d59c24becc5ec553ef2dae23056b9d3beafde697'],5,30,35,20699930,2,0.714285714,0.785714286,1,20252
302370d94f7b65ca7d278edb4fd181e8b66c32d5,0,Florian Barca,2015-06-03 15:22:43-07:00,['8fcf9f1150dff97c67ffaaf166076b80f477a2ed'],7,10,17,20699947,1,0,0,1,20252
77040938d8447669d8691f030fe24cbb89491453,1,Robert Levas,2015-06-03 18:55:38-04:00,['302370d94f7b65ca7d278edb4fd181e8b66c32d5'],0,1,1,20699948,1,,,,20252
a86701cc465a8e32ce92e713eeedf76bc52a03bc,1,Robert Levas,2015-06-03 19:58:03-04:00,['77040938d8447669d8691f030fe24cbb89491453'],16,236,252,20700200,4,0.067669173,0.969924812,0.827067669,20252
aeccbc7fe458509241e16c47f653f65a6ed8c2e4,1,Srimanth Gunturi,2015-06-03 17:09:16-07:00,['a86701cc465a8e32ce92e713eeedf76bc52a03bc'],24,301,325,20700525,4,0.026200873,0.903930131,0.860262009,20253
cb2a69aa4de160a6fb946a34ee0b2d048827a1c5,0,Florian Barca,2015-06-03 18:10:49-07:00,['aeccbc7fe458509241e16c47f653f65a6ed8c2e4'],0,28,28,20700553,2,,,,20253
d658e6fd72b1081ddd5c9eaeec026c2540dad3f3,1,Jonathan Hurley,2015-06-03 21:54:43-04:00,['cb2a69aa4de160a6fb946a34ee0b2d048827a1c5'],26,276,302,20700855,6,0.620689655,1,0.844827586,20254
33f24d57537c5055b896d5b011e535be96d31c8f,0,Siddharth Wagle,2015-06-03 19:40:19-07:00,['d658e6fd72b1081ddd5c9eaeec026c2540dad3f3'],11,164,175,20701030,2,0.04,0.49,1,20254
705c35a8b3c701fe0c6a50ce053239110f84dd5b,1,Srimanth Gunturi,2015-06-03 19:44:49-07:00,['33f24d57537c5055b896d5b011e535be96d31c8f'],2,1,3,20701033,1,,,,20254
0dc911e3a83eb7352f2ea32d0381e1b23c2cdafc,0,Lisnichenko Dmitro,2015-06-04 12:14:03+03:00,['705c35a8b3c701fe0c6a50ce053239110f84dd5b'],0,4,4,20701037,1,,,,20254
2209b7203d92e25efd0b12fd1eb1bde61a039c72,1,Vitaly Brodetskyi,2015-06-04 05:06:27+03:00,['0dc911e3a83eb7352f2ea32d0381e1b23c2cdafc'],16,37,53,20701090,6,0,1,0,20254
d46949d9189021af6b4f1911c53fe7a53b4661e2,1,Oleg Nechiporenko,2015-06-04 15:25:48+03:00,['2209b7203d92e25efd0b12fd1eb1bde61a039c72'],3,8,11,20701101,2,0.2,1,0.2,20254
f1625d780b3b70a53b57da703c75f1716b15a3d9,0,Vitaly Brodetskyi,2015-06-04 07:49:20+03:00,['d46949d9189021af6b4f1911c53fe7a53b4661e2'],164,11,175,20701276,2,0.96,0.51,0,20254
b3ed8061144d6bf5c35b68e4ab9e6ccd141b7884,1,aBabiichuk,2015-06-04 16:35:04+03:00,['f1625d780b3b70a53b57da703c75f1716b15a3d9'],3,18,21,20701297,2,0,1,1,20254
4117e4beeabe83ab7b9657e8870ed52e43b5ecfd,1,Andrew Onishuk,2015-06-04 17:34:44+03:00,['b3ed8061144d6bf5c35b68e4ab9e6ccd141b7884'],17,27,44,20701341,3,1,1,0,20254
09f6e93f59847af3db424ea07eedaba2c98b0bc1,1,Oleg Nechiporenko,2015-06-04 17:42:09+03:00,['4117e4beeabe83ab7b9657e8870ed52e43b5ecfd'],1,19,20,20701361,2,0.705882353,0.823529412,1,20254
cc6f4a68209fedc97bcc2fb15697c1f176d6b183,1,Andrew Onishuk,2015-06-04 17:51:35+03:00,['09f6e93f59847af3db424ea07eedaba2c98b0bc1'],1,12,13,20701374,5,0,0.909090909,0.818181818,20254
36a1c669970bf219c01157b40385218608685a38,1,Jonathan Hurley,2015-06-04 11:20:33-04:00,['cc6f4a68209fedc97bcc2fb15697c1f176d6b183'],0,72,72,20701446,2,0.102564103,0.384615385,0.256410256,20254
75bce8aee6fa8b4f68fca1a5aba483553401468a,1,Alex Antonenko,2015-06-04 18:38:26+03:00,['36a1c669970bf219c01157b40385218608685a38'],2,11,13,20701459,2,1,1,1,20254
f9ed7a3a7e285386769486ce704a06628c428048,1,Alex Antonenko,2015-06-04 18:38:26+03:00,['75bce8aee6fa8b4f68fca1a5aba483553401468a'],1,4,5,20701464,2,0.75,0.75,1,20254
0bc81fd9df4ac8a0ec5139a56a6940d4ca710bfb,1,Alex Antonenko,2015-06-04 18:46:34+03:00,['f9ed7a3a7e285386769486ce704a06628c428048'],5,10,15,20701479,2,1,1,1,20254
ef601102c0f5469439654d7f28229df7065dd291,1,Alejandro Fernandez,2015-06-04 09:32:22-07:00,['0bc81fd9df4ac8a0ec5139a56a6940d4ca710bfb'],16,71,87,20701566,4,0.081081081,0.081081081,0.864864865,20254
2f1fd9103abac21aaed8174ed66bb31229734118,1,Alejandro Fernandez,2015-06-04 09:42:31-07:00,['ef601102c0f5469439654d7f28229df7065dd291'],1,1,2,20701568,1,,,,20254
cddf20e330235a8c136c5f4fecb7a053ee53527e,1,Lisnichenko Dmitro,2015-06-04 19:50:54+03:00,['2f1fd9103abac21aaed8174ed66bb31229734118'],216,777,993,20702561,15,1,0.661157025,0.55785124,20255
e7982e319efdb7a57d2bb5bd0cdbe7f56a55dcba,0,Srimanth Gunturi,2015-06-04 10:28:01-07:00,['cddf20e330235a8c136c5f4fecb7a053ee53527e'],1,2,3,20702564,1,,,,20255
c01865ade6bf8819a23c951ac2fcf87d60a1a0ef,1,Siddharth Wagle,2015-06-04 10:41:17-07:00,['e7982e319efdb7a57d2bb5bd0cdbe7f56a55dcba'],3,161,164,20702728,2,0.038095238,0.514285714,1,20255
a4f9081c7af18a5f08b4aec800e3f4f9b624d2fa,1,Jayush Luniya,2015-06-04 11:35:29-07:00,['c01865ade6bf8819a23c951ac2fcf87d60a1a0ef'],7,7,14,20702742,1,,,,20255
6a0d1e0a2dbf241fd729d4d50f4f09e45e17baf6,1,Dmytro Sen,2015-06-04 21:41:38+03:00,['a4f9081c7af18a5f08b4aec800e3f4f9b624d2fa'],34,148,182,20702924,7,0.573770492,0.901639344,0.983606557,20255
98640c63692960188d54a981665a2468769751e2,0,Siddharth Wagle,2015-06-04 13:54:44-07:00,['6a0d1e0a2dbf241fd729d4d50f4f09e45e17baf6'],44,63,107,20703031,2,0.666666667,0.666666667,1,20255
332eca7253e6fde33c4f7fbce07558752a8028e3,1,Sumit Mohanty,2015-06-04 14:05:59-07:00,['98640c63692960188d54a981665a2468769751e2'],2,5,7,20703038,1,0,0,0,20255
e5e2cfd417d2aae05a9d0f8e771a16acaa0ad1f0,0,Srimanth Gunturi,2015-06-04 14:18:02-07:00,['332eca7253e6fde33c4f7fbce07558752a8028e3'],8,8,16,20703054,2,,0,,20255
0160dd62a525c86262d803b6801d36f18b0d1562,0,Xi Wang,2015-06-04 14:20:46-07:00,['e5e2cfd417d2aae05a9d0f8e771a16acaa0ad1f0'],3,8,11,20703065,1,,,,20255
ec196cff1a520a0f442f6bcae75db95a6c0440dd,1,Scott Creeley,2015-06-04 17:21:52-04:00,['0160dd62a525c86262d803b6801d36f18b0d1562'],2,230,232,20703297,4,,,,20255
e92007d0467e52e4137086864c2ca03d6a5ac4cb,1,Bob Nettleton,2015-06-04 18:27:55-04:00,['ec196cff1a520a0f442f6bcae75db95a6c0440dd'],1,82,83,20703380,2,0,1,1,20255
fb25e19f69549fa129c6370408c5f1b09b0097ce,1,Myroslav Papirkovskyy,2015-06-02 21:30:39+03:00,['e92007d0467e52e4137086864c2ca03d6a5ac4cb'],10,109,119,20703499,13,1,1,0.225,20255
b9f794d4763f2f9a992ae403e63fe0eb76297832,1,Jayush Luniya,2015-06-04 16:16:52-07:00,['fb25e19f69549fa129c6370408c5f1b09b0097ce'],1,99,100,20703599,3,,,,20257
ec16c5f7c3e96f6800fa4f5594abac9247edb029,1,Jayush Luniya,2015-06-04 16:48:16-07:00,['b9f794d4763f2f9a992ae403e63fe0eb76297832'],1,1,2,20703601,1,,,,20257
7ff1bbeff1167c1d980e2eacdfa2bb42af1c6172,0,Scott Creeley,2015-06-04 19:57:36-04:00,['ec16c5f7c3e96f6800fa4f5594abac9247edb029'],2,123,125,20703726,3,,,,20259
d99abd01fa714f52ae8b9b2936571f58bf7145db,0,Srimanth Gunturi,2015-06-04 17:03:01-07:00,['7ff1bbeff1167c1d980e2eacdfa2bb42af1c6172'],0,634,634,20704360,1,,,,20260
ef9a456a7687d0478ba49cc4e50b1877704be304,1,Jonathan Hurley,2015-06-04 20:12:55-04:00,['d99abd01fa714f52ae8b9b2936571f58bf7145db'],86,319,405,20704765,14,0.432835821,0.970149254,0.970149254,20261
cbcadd2c3e1006eece7ff7f45122cf606cc2160b,1,Sumit Mohanty,2015-06-04 19:35:18-07:00,['ef9a456a7687d0478ba49cc4e50b1877704be304'],10,13,23,20704788,2,0,0,0,20261
56876e2a9f7df59c15469183ee6f03a30023d470,0,Sumit Mohanty,2015-06-04 19:46:11-07:00,['cbcadd2c3e1006eece7ff7f45122cf606cc2160b'],5,0,5,20704793,1,1,1,0,20261
3afdc672a6ffa752462f3d5d17571d13dcdbfaa1,0,Sumit Mohanty,2015-06-04 19:46:56-07:00,['56876e2a9f7df59c15469183ee6f03a30023d470'],3,3,6,20704799,3,,,,20261
368ee72fa45e82c878d9fbc51fa755fe1b44b9cd,0,Jaimin Jetly,2015-06-04 22:38:24-07:00,['3afdc672a6ffa752462f3d5d17571d13dcdbfaa1'],3,4,7,20704806,1,,,,20261
3bb8af2bb11f94a4134d7dc98f3c34e881640a53,1,Jaimin Jetly,2015-06-04 22:38:24-07:00,['368ee72fa45e82c878d9fbc51fa755fe1b44b9cd'],287,1302,1589,20706395,5,,,,20263
13225f9de5e1533c1aa399401499174ca6fedd84,1,Andrew Onishuk,2015-06-05 11:59:32+03:00,['3bb8af2bb11f94a4134d7dc98f3c34e881640a53'],7,10,17,20706412,2,0,0,0,20263
46c15e852f5ca1b002423b8f6c3fcdf4d454c83a,1,Lisnichenko Dmitro,2015-06-05 12:04:47+03:00,['13225f9de5e1533c1aa399401499174ca6fedd84'],181,157,338,20706750,35,1,0.145833333,1,20263
d62287237b1a15b6b1852e242a46e43a1cfde6b0,1,Andrii Tkach,2015-06-05 12:53:14+03:00,['46c15e852f5ca1b002423b8f6c3fcdf4d454c83a'],147,56,203,20706953,3,0.553846154,0,0,20263
ed3d49a59eb8ee51300882bd847ad79682fd5b5e,1,Andrii Tkach,2015-06-05 12:53:45+03:00,['d62287237b1a15b6b1852e242a46e43a1cfde6b0'],1,19,20,20706973,3,1,1,1,20263
add8bf4b6dc4456e6abb87bcef12617a8038e9c0,1,Oleg Nechiporenko,2015-06-05 14:04:16+03:00,['ed3d49a59eb8ee51300882bd847ad79682fd5b5e'],7,11,18,20706991,1,,,,20263
7d793c2b33730184e8ba8cb6d8dfd6589578e21d,1,Robert Levas,2015-06-05 07:12:30-04:00,['add8bf4b6dc4456e6abb87bcef12617a8038e9c0'],85,813,898,20707889,33,0.710610932,0.855305466,1,20269
615c2d6984b5283250a2a2e09fc459c8aea2d93c,1,Andrew Onishuk,2015-06-05 15:18:58+03:00,['7d793c2b33730184e8ba8cb6d8dfd6589578e21d'],11,75,86,20707975,22,,,,20269
ea7485ae568d533d7aea9f31de8a96846d0d5a8c,0,Dmytro Sen,2015-06-05 15:50:53+03:00,['615c2d6984b5283250a2a2e09fc459c8aea2d93c'],1,1,2,20707977,1,,,,20269
fb90a26e82a58c9b72d506786fbdb6decc759dff,1,Andrew Onishuk,2015-06-05 16:50:32+03:00,['ea7485ae568d533d7aea9f31de8a96846d0d5a8c'],147,25,172,20708149,15,1,0.094017094,0,20269
a22f819d4673d8187b61f41bbaa2388997b0eda6,1,Andrii Tkach,2015-06-05 17:18:44+03:00,['fb90a26e82a58c9b72d506786fbdb6decc759dff'],4,11,15,20708164,2,1,0.875,1,20269
d65accdcf859616d942754c87b12bec46ccd099b,0,Jonathan Hurley,2015-06-05 10:49:17-04:00,['a22f819d4673d8187b61f41bbaa2388997b0eda6'],54,116,170,20708334,4,0.935483871,1,1,20269
ae679e4efa85ee99748ccde00bde8775dc0a4dcb,1,Jonathan Hurley,2015-06-05 11:52:03-04:00,['d65accdcf859616d942754c87b12bec46ccd099b'],116,54,170,20708504,4,0.064516129,0,0,20269
13a74fb21a7cda988d35f94d1e8b90b32ceb5fc2,1,Jonathan Hurley,2015-06-05 11:54:49-04:00,['ae679e4efa85ee99748ccde00bde8775dc0a4dcb'],54,116,170,20708674,4,0.935483871,1,1,20269
85b05bae4f01274c3fc7aa85d08e262a0eb5ea77,1,Aleksandr Kovalenko,2015-06-05 19:05:16+03:00,['13a74fb21a7cda988d35f94d1e8b90b32ceb5fc2'],0,4,4,20708678,3,0,0,1,20269
4ae28b812bf4980752d5f2c7c7c62bec04769254,1,Aleksandr Kovalenko,2015-06-05 19:14:06+03:00,['85b05bae4f01274c3fc7aa85d08e262a0eb5ea77'],32,36,68,20708746,4,1,1,1,20269
ca9911163b2fd6d6be7704b741b9ffecdcda9a74,0,Bob Nettleton,2015-06-05 12:39:09-04:00,['4ae28b812bf4980752d5f2c7c7c62bec04769254'],1,35,36,20708782,1,,,,20269
4b2ca8066a41cbcc08eeb203728b3e4542a05f6f,1,Alex Antonenko,2015-06-05 19:41:50+03:00,['ca9911163b2fd6d6be7704b741b9ffecdcda9a74'],2,32,34,20708816,3,0.076923077,0.076923077,0.153846154,20269
d1ccd284380c2bd32459dc5310f340ae1fe92817,1,Dmytro Sen,2015-06-05 20:25:06+03:00,['4b2ca8066a41cbcc08eeb203728b3e4542a05f6f'],0,61,61,20708877,5,0,0,1,20270
975cf26ab2087fd4f5046928fdf68a2a8ffab9cb,0,Siddharth Wagle,2015-06-05 10:38:43-07:00,['d1ccd284380c2bd32459dc5310f340ae1fe92817'],3,1,4,20708881,1,,,,20270
e881532da13671f1843166ef9b74751dee0051b4,1,Xi Wang,2015-06-05 11:11:59-07:00,['975cf26ab2087fd4f5046928fdf68a2a8ffab9cb'],7,42,49,20708930,4,0,1,1,20270
6b382fc709e843bf4247dca94fb61c304c60ae72,1,Jayush Luniya,2015-06-05 12:05:40-07:00,['e881532da13671f1843166ef9b74751dee0051b4'],10,55,65,20708995,10,,,,20270
12fd6d8cdcc2235d3ff581928afcc26ed7941411,1,Yusaku Sako,2015-06-05 12:12:31-07:00,['6b382fc709e843bf4247dca94fb61c304c60ae72'],11,22,33,20709028,1,1,0,1,20270
c7b0688a400e56c51a53b3f335cda3fbe1f9386d,0,Jaimin Jetly,2015-06-05 12:15:59-07:00,['12fd6d8cdcc2235d3ff581928afcc26ed7941411'],6,6,12,20709040,1,,,,20270
8e496ce6114fd6ee0a8450ab9cbde6df68bbca1a,1,Jaimin Jetly,2015-06-05 13:48:52-07:00,['c7b0688a400e56c51a53b3f335cda3fbe1f9386d'],6,92,98,20709138,4,1,1,1,20270
7eaf73c3086f842eac2eba344fc7080b4f6b477a,1,Sumit Mohanty,2015-06-05 14:22:50-07:00,['8e496ce6114fd6ee0a8450ab9cbde6df68bbca1a'],25,147,172,20709310,15,0,0.905982906,1,20270
4afac3006c4d9f7c102d15752382597a3da6effe,1,John Speidel,2015-06-05 17:30:32-04:00,['7eaf73c3086f842eac2eba344fc7080b4f6b477a'],183,1455,1638,20710948,10,0.172634271,1,0.97314578,20271
f4245091058f8b1e6a1bd094f147134f9305dd82,0,Jayush Luniya,2015-06-05 15:27:51-07:00,['4afac3006c4d9f7c102d15752382597a3da6effe'],8,16,24,20710972,1,0,0,0,20271
bf408fb48701861b9efea61d4b402ebe34727915,1,Xi Wang,2015-06-05 15:42:19-07:00,['f4245091058f8b1e6a1bd094f147134f9305dd82'],2,2,4,20710976,1,,,,20271
89ba4a4bbcb64ad802bc94fa356c2f180e774ca5,1,Xi Wang,2015-06-05 17:23:26-07:00,['bf408fb48701861b9efea61d4b402ebe34727915'],19,23,42,20711018,1,,,,20271
e973a534f0fcb331dc8d71bdb59843189fdfc2b5,1,Sumit Mohanty,2015-06-05 18:43:45-07:00,['89ba4a4bbcb64ad802bc94fa356c2f180e774ca5'],9,28,37,20711055,1,1,1,1,20271
fdaa98043ffbd3b6322c8a68e9d8417cf5b450af,0,Sumit Mohanty,2015-06-05 19:03:11-07:00,['e973a534f0fcb331dc8d71bdb59843189fdfc2b5'],126,66,192,20711247,6,0,1,1,20271
c33b8ee26849accf516ca0afd0bb811513e65c9c,1,Jonathan Hurley,2015-06-05 22:05:20-04:00,['fdaa98043ffbd3b6322c8a68e9d8417cf5b450af'],28,57,85,20711332,7,1,1,0,20271
e202aaa850e5b176160ed6a3b496341b83483448,0,Srimanth Gunturi,2015-06-05 19:23:12-07:00,['c33b8ee26849accf516ca0afd0bb811513e65c9c'],3,3,6,20711338,2,,,,20271
b2cb508858bca937e55bea7d019cfa4dbc4e3aea,1,Srimanth Gunturi,2015-06-05 19:23:24-07:00,['e202aaa850e5b176160ed6a3b496341b83483448'],5,163,168,20711506,5,1,1,0.833333333,20272
c0ff2b7e806d956f65ff137a6af4281d8fc77019,1,Jaimin Jetly,2015-06-05 23:27:50-07:00,['b2cb508858bca937e55bea7d019cfa4dbc4e3aea'],11,9,20,20711526,3,1,1,1,20272
f8a32948440192a1071dc6a25fbc80684ca7c2f0,1,Andrew Onishuk,2015-06-06 16:41:20+03:00,['c0ff2b7e806d956f65ff137a6af4281d8fc77019'],3,81,84,20711610,2,0,0.698113208,1,20272
09003780069128f94f5c33c17c50504b6cde7700,0,Oleg Nechiporenko,2015-06-06 16:52:18+03:00,['f8a32948440192a1071dc6a25fbc80684ca7c2f0'],1,36,37,20711647,2,1,1,1,20272
2bfca09c3e8a4d989e36aeddda3e213825c91e59,0,Andrew Onishuk,2015-06-06 17:01:48+03:00,['09003780069128f94f5c33c17c50504b6cde7700'],10,13,23,20711670,2,0,0,1,20272
2f07bcb41dc82f6a3f7f05839674426f8a6a39c4,0,Oleg Nechiporenko,2015-06-06 17:42:12+03:00,['2bfca09c3e8a4d989e36aeddda3e213825c91e59'],11,21,32,20711702,2,0,1,1,20272
da9187063093756b78e4c201d11ebbd9779320ff,1,Alex Antonenko,2015-06-06 18:49:43+03:00,['2f07bcb41dc82f6a3f7f05839674426f8a6a39c4'],0,12,12,20711714,1,0,0,1,20272
599a963be65ee57a320247ebfcb44bdb86157735,1,Srimanth Gunturi,2015-06-06 08:56:33-07:00,['da9187063093756b78e4c201d11ebbd9779320ff'],6,7,13,20711727,1,0,0,0,20272
a8ab3e9dc7f7a8c1815dbaaee28163582cca69aa,0,Srimanth Gunturi,2015-06-06 09:07:59-07:00,['599a963be65ee57a320247ebfcb44bdb86157735'],1,1,2,20711729,1,,,,20272
0474ef6ec6477d7fd34dd9835691f1fb1880249f,1,Andrew Onishuk,2015-06-06 19:20:21+03:00,['a8ab3e9dc7f7a8c1815dbaaee28163582cca69aa'],36,33,69,20711798,4,1,0,1,20272
27aea4ce3e35b37ea1ec654bb4c3089b72cfd7c0,1,Srimanth Gunturi,2015-06-06 09:35:15-07:00,['0474ef6ec6477d7fd34dd9835691f1fb1880249f'],65,9,74,20711872,7,1,1,1,20272
b1e1a131f67b879e20401ba4d8dc5fd38eb24f54,0,Srimanth Gunturi,2015-06-06 09:45:28-07:00,['27aea4ce3e35b37ea1ec654bb4c3089b72cfd7c0'],2,3,5,20711877,2,0,0,1,20272
9132aa70c84413bd0e23458c391b03dad5cd6563,1,Sumit Mohanty,2015-06-06 11:14:45-07:00,['b1e1a131f67b879e20401ba4d8dc5fd38eb24f54'],66,126,192,20712069,6,1,0,0,20272
09fffe8ae1d0c4b852a4bbb9a6edcad3632e67af,0,Alex Antonenko,2015-06-06 22:58:30+03:00,['9132aa70c84413bd0e23458c391b03dad5cd6563'],1,12,13,20712082,1,,,,20272
9dea997bee14a18442b2eff435596a07701e4d81,0,Aleksandr Kovalenko,2015-06-06 23:00:07+03:00,['09fffe8ae1d0c4b852a4bbb9a6edcad3632e67af'],36,0,36,20712118,3,,,,20272
cf6cb47c3689204ba6390002196c08dba629649d,0,Jaimin Jetly,2015-06-06 15:17:27-07:00,['9dea997bee14a18442b2eff435596a07701e4d81'],0,6,6,20712124,1,1,1,1,20272
f2e12158f82df38b256ee6b3fcc4989ce6751c5a,0,Siddharth Wagle,2015-06-06 15:47:44-07:00,['cf6cb47c3689204ba6390002196c08dba629649d'],56,61,117,20712241,2,0,1,1,20272
34cf5df636e8b739c322c34061bb99334e0837a8,1,Sumit Mohanty,2015-06-06 17:56:38-07:00,['f2e12158f82df38b256ee6b3fcc4989ce6751c5a'],127,67,194,20712435,7,0,1,1,20272
5722f5225150870b620e099443787b7cb7fc1e12,1,Jonathan Hurley,2015-06-06 21:21:24-04:00,['34cf5df636e8b739c322c34061bb99334e0837a8'],17,59,76,20712511,5,0,0,1,20272
4a0227e6e3f9e26b78dfa8a7ff714702231c677b,0,Jonathan Hurley,2015-06-06 21:21:25-04:00,['5722f5225150870b620e099443787b7cb7fc1e12'],12,9,21,20712532,1,,,,20272
ecfc8b632923b8e923749f46d897a14de428eef3,0,Nate Cole,2015-06-06 21:50:21-04:00,['4a0227e6e3f9e26b78dfa8a7ff714702231c677b'],1,2,3,20712535,1,,,,20272
9127e198720d9b436e666bad9ae4e6073e036647,1,Yusaku Sako,2015-06-06 20:36:20-07:00,['ecfc8b632923b8e923749f46d897a14de428eef3'],3,2,5,20712540,2,1,1,0,20272
219e2f95368abc8cfee3849e90031c5243719983,1,Robert Levas,2015-06-07 06:57:27-04:00,['9127e198720d9b436e666bad9ae4e6073e036647'],14,30,44,20712584,4,0.333333333,0,0.916666667,20272
ed5f01e0006479e586b149b55dbfee37c4900e1e,0,Aleksandr Kovalenko,2015-06-07 15:29:18+03:00,['219e2f95368abc8cfee3849e90031c5243719983'],1,1,2,20712586,1,,,,20272
5459fefdb2ac2368f683f2b864127e252707484b,1,Jonathan Hurley,2015-06-07 09:44:58-04:00,['ed5f01e0006479e586b149b55dbfee37c4900e1e'],9,38,47,20712633,5,0.230769231,0.230769231,1,20272
2fc88fa7646e914ff2a04ef2a2546407f013e228,1,Andrew Onishuk,2015-06-07 16:52:46+03:00,['5459fefdb2ac2368f683f2b864127e252707484b'],2,2,4,20712637,1,,,,20272
21ddf8b86af187a1fc8d27b11c500604dc61de55,1,Dmytro Sen,2015-06-07 17:07:08+03:00,['2fc88fa7646e914ff2a04ef2a2546407f013e228'],7,9,16,20712653,6,0.5,1,0.5,20272
83114eab13316b7171161fb1dee5a4876b4c6c42,1,Dmytro Sen,2015-06-07 17:31:09+03:00,['21ddf8b86af187a1fc8d27b11c500604dc61de55'],163,193,356,20713009,6,1,1,0,20272
ca87af1ce111af1edd0ecb9f0f79994183f7c7c9,0,aBabiichuk,2015-06-07 18:28:01+03:00,['83114eab13316b7171161fb1dee5a4876b4c6c42'],1,1,2,20713011,1,0,0,0,20272
c05cec26482ad52e74f09a46bb2d05ea706494ae,1,Aleksandr Kovalenko,2015-06-07 19:17:52+03:00,['ca87af1ce111af1edd0ecb9f0f79994183f7c7c9'],1,139,140,20713151,3,1,1,1,20273
8ee03b62008ca652aabf69b435122e0b27a13d6b,0,Sumit Mohanty,2015-06-07 12:14:40-07:00,['c05cec26482ad52e74f09a46bb2d05ea706494ae'],1,1,2,20713153,1,,,,20273
4cbd1dc27c69492c2a631ead1f252661aec3ee7d,1,Xi Wang,2015-06-07 16:35:14-07:00,['8ee03b62008ca652aabf69b435122e0b27a13d6b'],0,6,6,20713159,1,1,1,1,20273
aac067e52c30e3e79356d5d8d24da86a53cbb1aa,0,Yusaku Sako,2015-06-07 21:41:26-07:00,['4cbd1dc27c69492c2a631ead1f252661aec3ee7d'],2,4,6,20713165,3,0,0,1,20273
f2c892ad9a07fbd5f306aa4e7a8aa28857921f7a,0,Andrew Onishuk,2015-06-08 12:39:30+03:00,['aac067e52c30e3e79356d5d8d24da86a53cbb1aa'],1,1,2,20713167,1,,,,20273
f25834109c3096985631db8490c90a33656ecee9,0,tbeerbower,2015-06-08 06:01:06-04:00,['f2c892ad9a07fbd5f306aa4e7a8aa28857921f7a'],0,7,7,20713174,2,0,1,1,20273
df2d8e3f853b5ade5852ff5e18bbe8f9069f4e94,1,Robert Levas,2015-06-08 06:14:26-04:00,['f25834109c3096985631db8490c90a33656ecee9'],521,843,1364,20714538,7,0.13671875,0,0.89453125,20274
cbc34867b0679266161b7efaf153d01a1eb5050e,1,aBabiichuk,2015-06-08 13:20:14+03:00,['df2d8e3f853b5ade5852ff5e18bbe8f9069f4e94'],162,260,422,20714960,14,0.061728395,0.296296296,0.716049383,20274
7b41d3114db74082119990d92b9d0f7760ee6261,1,Jonathan Hurley,2015-06-08 07:48:26-04:00,['cbc34867b0679266161b7efaf153d01a1eb5050e'],12,255,267,20715227,5,0.4,0.847058824,1,20275
efe8ee6a0a3bbc253abb3a3a2afd6e879a39a4dc,1,Lisnichenko Dmitro,2015-06-08 14:57:10+03:00,['7b41d3114db74082119990d92b9d0f7760ee6261'],0,81,81,20715308,2,,,,20276
82ff8884c1fd67358c77d1cb41cdf4747903b868,1,Oleg Nechiporenko,2015-06-08 14:59:19+03:00,['efe8ee6a0a3bbc253abb3a3a2afd6e879a39a4dc'],3,61,64,20715372,3,0.970588235,1,0.970588235,20276
f3e633ce2d8f52de6afc1bad992dafea07d444d9,1,Andrii Tkach,2015-06-08 15:42:17+03:00,['82ff8884c1fd67358c77d1cb41cdf4747903b868'],11,347,358,20715730,16,0.702439024,1,0.985365854,20276
0eeac02e0aa545b344eadcb7a0bf9bc40dfbb2b7,1,aBabiichuk,2015-06-08 16:13:25+03:00,['f3e633ce2d8f52de6afc1bad992dafea07d444d9'],1,13,14,20715744,1,0,0,1,20276
3602b583515a1bdad4711b54779e477112f56d9f,1,Robert Levas,2015-06-08 09:19:18-04:00,['0eeac02e0aa545b344eadcb7a0bf9bc40dfbb2b7'],597,521,1118,20716862,22,0,0,0,20279
ef9e122df72e1b1c7303b988649484c4ab165b65,0,Alex Antonenko,2015-06-08 16:22:32+03:00,['3602b583515a1bdad4711b54779e477112f56d9f'],2,16,18,20716880,1,1,1,1,20279
73229f26e78d1efa859446e3d4efca6b3554d8bc,1,Vitaly Brodetskyi,2015-06-08 08:05:20+03:00,['ef9e122df72e1b1c7303b988649484c4ab165b65'],48,38,86,20716966,1,1,1,0,20279
590a2e249c24d64d5864a24846436adc7575b72c,1,Myroslav Papirkovskyy,2015-06-03 00:18:14+03:00,['73229f26e78d1efa859446e3d4efca6b3554d8bc'],32,47,79,20717045,4,0.4,0,1,20279
ecb2b05e0ea9482245255ecd219ad95162495739,1,Robert Levas,2015-06-08 10:31:28-04:00,['590a2e249c24d64d5864a24846436adc7575b72c'],15,52,67,20717112,9,,,,20279
0e6fc2409253df89eb2eb5fa581094a4a7db1959,1,Andrew Onishuk,2015-06-08 17:59:13+03:00,['ecb2b05e0ea9482245255ecd219ad95162495739'],4,7,11,20717123,4,,,,20279
d64cf1ffe7e6a5e6e5e3b5756220cf4a0b000da1,1,Aleksandr Kovalenko,2015-06-08 18:03:57+03:00,['0e6fc2409253df89eb2eb5fa581094a4a7db1959'],0,2,2,20717125,1,1,1,1,20279
ce33632aa1aab77a40ba711928b2b0576b8efbc6,1,Nate Cole,2015-06-08 13:03:58-04:00,['d64cf1ffe7e6a5e6e5e3b5756220cf4a0b000da1'],3,38,41,20717166,2,0,1,1,20279
6a9d590aaeeb24045a62fa3780582dbb51a7521f,0,John Speidel,2015-06-08 13:11:27-04:00,['ce33632aa1aab77a40ba711928b2b0576b8efbc6'],11,48,59,20717225,2,1,1,1,20279
562021efc9ba4be03744eefa04bc2f15e02dee1f,1,Lisnichenko Dmitro,2015-06-08 20:16:14+03:00,['6a9d590aaeeb24045a62fa3780582dbb51a7521f'],24,74,98,20717323,2,0,0.955555556,0.044444444,20279
59fa63f1837bd3a19b2e0a903334cbf0e8c7dd68,1,tbeerbower,2015-06-08 13:37:44-04:00,['562021efc9ba4be03744eefa04bc2f15e02dee1f'],69,247,316,20717639,12,0.525773196,0.979381443,0.907216495,20279
2df3a954e4542e3fc91ffa9368835e79acfa3ddf,0,Andrii Tkach,2015-06-08 20:54:35+03:00,['59fa63f1837bd3a19b2e0a903334cbf0e8c7dd68'],1,2,3,20717642,1,,,,20279
c13c5828b2f9dc169aca41df5bc2c4363a6919be,1,Alejandro Fernandez,2015-06-08 12:56:46-07:00,['2df3a954e4542e3fc91ffa9368835e79acfa3ddf'],85,125,210,20717852,5,0,1,0.322580645,20279
d668f2cb1dae5a69a10af4c339c8469fbdabeb52,1,Alex Antonenko,2015-06-09 00:35:18+03:00,['c13c5828b2f9dc169aca41df5bc2c4363a6919be'],1,3,4,20717856,1,1,1,1,20279
87586c6703ec2c4952d8e4d0e399f5b8b3938fdb,1,Alex Antonenko,2015-06-09 00:35:40+03:00,['d668f2cb1dae5a69a10af4c339c8469fbdabeb52'],1,1,2,20717858,1,,,,20279
49fa52150079c7ed70699ac6fc96be847d0c144e,0,Jayush Luniya,2015-06-08 15:14:26-07:00,['87586c6703ec2c4952d8e4d0e399f5b8b3938fdb'],1,1,2,20717860,1,,,,20279
181699d2ff6e485e5d27552cf4e22b9e8d419225,1,Sumit Mohanty,2015-06-08 16:07:20-07:00,['49fa52150079c7ed70699ac6fc96be847d0c144e'],5,8,13,20717873,2,0,1,0.666666667,20279
b12b16cf35d60acdc5ee1b8818340ede3ca3fe94,1,Nate Cole,2015-06-08 19:16:05-04:00,['181699d2ff6e485e5d27552cf4e22b9e8d419225'],0,29,29,20717902,2,1,1,1,20279
e90bb8f916c79486ada2064c1858285d944e598f,1,Srimanth Gunturi,2015-06-08 16:36:32-07:00,['b12b16cf35d60acdc5ee1b8818340ede3ca3fe94'],2059,211,2270,20720172,16,0,0,0,20279
3447a4780713c12a1aa231bab6df0f08aa7383ea,1,Sumit Mohanty,2015-06-08 16:44:59-07:00,['e90bb8f916c79486ada2064c1858285d944e598f'],3,3,6,20720178,2,,,,20279
757f07bb9f6bd567158c1e3633bb7152608e9600,1,Srimanth Gunturi,2015-06-08 16:46:34-07:00,['3447a4780713c12a1aa231bab6df0f08aa7383ea'],5,6,11,20720189,3,,0,0,20279
4abe8fbff8908f6de8277ef4ccd6ebf0724eb0df,0,Yusaku Sako,2015-06-08 17:06:10-07:00,['757f07bb9f6bd567158c1e3633bb7152608e9600'],2,2,4,20720193,1,,,,20279
b14161906861b339108ee9494d41a41ddd16e0a4,0,Yusaku Sako,2015-06-08 17:13:12-07:00,['4abe8fbff8908f6de8277ef4ccd6ebf0724eb0df'],2,2,4,20720197,1,,,,20279
125a823a27066f44b57a5ef3abcdb311c4042b4d,0,Jaimin Jetly,2015-06-08 21:15:27-07:00,['b14161906861b339108ee9494d41a41ddd16e0a4'],0,0,0,20720197,1,,,,20279
5f6b5871a1368968d2fadf0b3b839a3b795218d1,0,Alex Antonenko,2015-06-09 09:37:18+03:00,['125a823a27066f44b57a5ef3abcdb311c4042b4d'],23,37,60,20720257,1,0.5,0,1,20279
289f4887c77a221cd8dd0cefe443077a14e0ae66,1,aBabiichuk,2015-06-09 12:41:32+03:00,['5f6b5871a1368968d2fadf0b3b839a3b795218d1'],3,3,6,20720263,2,,,,20279
a7c5edb3567964d5e228f6b582bb6e11d18a0f97,1,Andrii Tkach,2015-06-09 13:42:46+03:00,['289f4887c77a221cd8dd0cefe443077a14e0ae66'],19,11,30,20720293,4,0.647058824,0.235294118,0,20279
b5f4872ae7f780b7ef7e031017af51552076f4c0,0,Vitaly Brodetskyi,2015-06-09 06:40:51+03:00,['a7c5edb3567964d5e228f6b582bb6e11d18a0f97'],1,1,2,20720295,1,,,,20279
529ec1026ffeda69ba4f34febc05655be5ee10fd,1,Robert Levas,2015-06-09 08:42:00-04:00,['b5f4872ae7f780b7ef7e031017af51552076f4c0'],123,9,132,20720427,6,1,0.444444444,0.622222222,20279
37004be8d9f2e2d0460f3303c3fd61e02477d774,1,Artem Baranchuk,2015-06-09 16:02:36+03:00,['529ec1026ffeda69ba4f34febc05655be5ee10fd'],4,4,8,20720435,3,,,,20279
75b87d6483eebf9f754b2afd6ac0af441e3dbb6b,0,Vitaly Brodetskyi,2015-06-09 08:47:38+03:00,['37004be8d9f2e2d0460f3303c3fd61e02477d774'],197,0,197,20720632,2,,,,20279
3726656ec6eb93a66db3fda6e2df2246ee2d3632,1,Dmytro Sen,2015-06-09 17:24:43+03:00,['75b87d6483eebf9f754b2afd6ac0af441e3dbb6b'],5,10,15,20720647,2,0,0,0.6,20279
e71784299a526d8fa11d5430cc82aa9080c768d0,1,Robert Levas,2015-06-09 11:21:01-04:00,['3726656ec6eb93a66db3fda6e2df2246ee2d3632'],4,79,83,20720730,6,0.228571429,0.971428571,0.971428571,20279
7452077a325f7ac952fad9c02f0616c88659e6ec,1,Andrew Onishuk,2015-06-09 18:21:54+03:00,['e71784299a526d8fa11d5430cc82aa9080c768d0'],46,11,57,20720787,4,0,1,1,20279
97bf29a3533623422a1d3c8e746e73e54f122924,0,Andrii Tkach,2015-06-09 18:38:08+03:00,['7452077a325f7ac952fad9c02f0616c88659e6ec'],7,21,28,20720815,2,0.2,0.2,1,20279
5240ca45e65a01f4006226aee9a4f6b4e95f9e8d,1,tbeerbower,2015-06-09 12:08:44-04:00,['97bf29a3533623422a1d3c8e746e73e54f122924'],3,84,87,20720902,15,0.965517241,1,0.965517241,20279
b66d46aed49c0bbe60a496e34ddb8f35a666b3a6,0,Jayush Luniya,2015-06-09 10:45:48-07:00,['5240ca45e65a01f4006226aee9a4f6b4e95f9e8d'],1,19,20,20720922,3,0.066666667,0.066666667,1,20279
721f8a36b02fa4500ad173cc75887bba8d8e26f3,1,Alejandro Fernandez,2015-06-09 12:14:07-07:00,['b66d46aed49c0bbe60a496e34ddb8f35a666b3a6'],3,71,74,20720996,3,0.193548387,0.258064516,1,20279
a44784f0d0fb291987fe545c29bdb054bd9b7d4b,1,Alex Antonenko,2015-06-09 22:59:02+03:00,['721f8a36b02fa4500ad173cc75887bba8d8e26f3'],7,12,19,20721015,3,1,1,1,20279
1862126a061dca808871d6efa331ee75ae8d5daa,1,Alex Antonenko,2015-06-09 22:59:02+03:00,['a44784f0d0fb291987fe545c29bdb054bd9b7d4b'],92,135,227,20721242,7,1,1,1,20281
8b535db8bd50c05534b765c252d3bc0521640d71,0,Siddharth Wagle,2015-06-09 13:20:26-07:00,['1862126a061dca808871d6efa331ee75ae8d5daa'],0,15,15,20721257,2,0,0,1,20281
7084cb798451b842dc5d1a894f8492bbcf318cbf,0,Nate Cole,2015-06-09 16:31:33-04:00,['8b535db8bd50c05534b765c252d3bc0521640d71'],9,16,25,20721282,3,0,0.090909091,1,20281
3ef169e020842fc01f614c8152939edd01684afe,1,Yusaku Sako,2015-06-09 15:07:55-07:00,['7084cb798451b842dc5d1a894f8492bbcf318cbf'],4,2,6,20721288,1,,,,20281
52dd06d720a5b6007adffd2feba05b533c405d82,1,Sumit Mohanty,2015-06-09 18:30:42-07:00,['3ef169e020842fc01f614c8152939edd01684afe'],44,271,315,20721603,8,0,0.798941799,0.71957672,20281
9d9ec5e219c2afecdace63cb6a22277d652e8742,1,aBabiichuk,2015-06-10 14:08:09+03:00,['52dd06d720a5b6007adffd2feba05b533c405d82'],1,3,4,20721607,1,0,0,1,20281
87d95d299b19ed4f2bcb15e0e39e14b5661ce5b0,1,tbeerbower,2015-06-10 08:34:05-04:00,['9d9ec5e219c2afecdace63cb6a22277d652e8742'],8,43,51,20721658,4,0.909090909,0.909090909,1,20281
4c6f74aa7e307ce80171216d6392829cf95aa3c6,1,tbeerbower,2015-06-10 08:42:53-04:00,['87d95d299b19ed4f2bcb15e0e39e14b5661ce5b0'],1,2,3,20721661,1,1,1,1,20281
4d18b2db2c81b4e9b67025f6f695193ce344a090,1,Lisnichenko Dmitro,2015-06-10 16:14:05+03:00,['4c6f74aa7e307ce80171216d6392829cf95aa3c6'],0,70,70,20721731,1,,,,20282
b38e29f3d81c731d41d65ec52abe625919401c6f,0,Andrii Tkach,2015-06-10 16:22:04+03:00,['4d18b2db2c81b4e9b67025f6f695193ce344a090'],1,395,396,20722127,3,,,,20284
cd869694fc6d20e95c8b348a55d1a1804b977c94,0,Oleg Nechiporenko,2015-06-10 16:24:40+03:00,['b38e29f3d81c731d41d65ec52abe625919401c6f'],2,6,8,20722135,2,1,1,1,20284
247a72cb1e1c2f05f1f3fd004aeb1de9c13e47d7,1,Vitaly Brodetskyi,2015-06-10 08:19:53+03:00,['cd869694fc6d20e95c8b348a55d1a1804b977c94'],1,2,3,20722138,1,0,0,1,20284
fd4290e054f10b55c218d6fee75ab523be7ea39a,0,Vitaly Brodetskyi,2015-06-10 09:20:33+03:00,['247a72cb1e1c2f05f1f3fd004aeb1de9c13e47d7'],0,7,7,20722145,1,,,,20284
cbd1d94805a81dd1652ac47507dd207d2db54a09,1,Andrew Onishuk,2015-06-10 17:54:29+03:00,['fd4290e054f10b55c218d6fee75ab523be7ea39a'],162,291,453,20722598,12,0,0.62962963,0,20284
cd2e39790c0c68060f9e54df548807b0be71c778,1,Aleksandr Kovalenko,2015-06-10 18:32:57+03:00,['cbd1d94805a81dd1652ac47507dd207d2db54a09'],222,108,330,20722928,10,0.272727273,0,0.109090909,20284
efc04b28a4cf17c7f9fed1d01aba8d32b5f43014,1,Andrew Onishuk,2015-06-10 18:37:06+03:00,['cd2e39790c0c68060f9e54df548807b0be71c778'],0,204,204,20723132,2,,,,20285
1f371a592d8ea478c1a0c5852f810c8c7277c93e,1,Florian Barca,2015-06-10 08:38:17-07:00,['efc04b28a4cf17c7f9fed1d01aba8d32b5f43014'],2,2,4,20723136,2,,,,20285
1df38e6dec4bb2c8751c43fef056e41c17a343ea,1,Andrew Onishuk,2015-06-10 18:41:19+03:00,['1f371a592d8ea478c1a0c5852f810c8c7277c93e'],15,26,41,20723177,3,0,0,0,20285
614fd801fc489fe27cbb0ea6f1ac4a09ebd75477,1,Siddharth Wagle,2015-06-10 09:42:52-07:00,['1df38e6dec4bb2c8751c43fef056e41c17a343ea'],1,86,87,20723264,6,0.101694915,0.372881356,0.491525424,20285
0f71307494d982d6bad1825c2a5295e4e0ce7b64,1,Siddharth Wagle,2015-06-10 09:53:36-07:00,['614fd801fc489fe27cbb0ea6f1ac4a09ebd75477'],3,9413,9416,20732680,2,,,,20286
e93d40045b8bbfefb78ccac7741ef50ebf4014ae,1,Aleksandr Kovalenko,2015-06-10 19:54:46+03:00,['0f71307494d982d6bad1825c2a5295e4e0ce7b64'],3,3,6,20732686,2,,,,20286
95f7f6d89a9a5883faaf99dbb9dd6c085452679b,0,Andrew Onishuk,2015-06-10 20:00:25+03:00,['e93d40045b8bbfefb78ccac7741ef50ebf4014ae'],1,0,1,20732687,1,,,,20286
829a5e85cb65f2474c4f9fe354ef0ef42de0877b,0,Vitaly Brodetskyi,2015-06-10 11:41:43+03:00,['95f7f6d89a9a5883faaf99dbb9dd6c085452679b'],1,1,2,20732689,2,1,1,,20286
cd9d915aa6f9d1f84455f739e6ed5be826adcba1,0,Nate Cole,2015-06-10 13:21:54-04:00,['829a5e85cb65f2474c4f9fe354ef0ef42de0877b'],2,2,4,20732693,2,,,,20286
ec31c8a9dae0c2b9ccddc13dc5a1119ee472489c,0,Alex Antonenko,2015-06-10 20:37:21+03:00,['cd9d915aa6f9d1f84455f739e6ed5be826adcba1'],1,1,2,20732695,1,,,,20286
6779e0c95a23e7c45b9792d8136f4792f4587da1,1,Alex Antonenko,2015-06-10 20:37:22+03:00,['ec31c8a9dae0c2b9ccddc13dc5a1119ee472489c'],5,43,48,20732743,3,0.944444444,1,0.944444444,20286
e05ee943e513467b40830a2513c4e778221d3ea3,1,Lisnichenko Dmitro,2015-06-10 20:46:39+03:00,['6779e0c95a23e7c45b9792d8136f4792f4587da1'],10,11,21,20732764,4,,,,20286
eb3f9cf74ef2ad8c8e95a2e09e9408bf989e9a3a,0,Xi Wang,2015-06-10 11:50:53-07:00,['e05ee943e513467b40830a2513c4e778221d3ea3'],4,3,7,20732771,1,,,,20286
58516530508d929ed62d87189e120fc1479ee1ce,1,Nate Cole,2015-06-10 15:35:29-04:00,['eb3f9cf74ef2ad8c8e95a2e09e9408bf989e9a3a'],55,99,154,20732925,9,0,1,1,20286
5ade3e643d67d9b6b141aff9edb69374ef9f749c,1,Jayush Luniya,2015-06-10 12:55:11-07:00,['58516530508d929ed62d87189e120fc1479ee1ce'],2,13,15,20732940,2,,,,20286
9b75f819e5acd7c46a029bde4f755abd440d501f,0,Jaimin Jetly,2015-06-10 14:50:21-07:00,['5ade3e643d67d9b6b141aff9edb69374ef9f749c'],137,189,326,20733266,10,0,0.880597015,1,20286
012519fa4187dc5041cde83c248cc83e132ff3f4,1,Nate Cole,2015-06-10 19:58:50-04:00,['9b75f819e5acd7c46a029bde4f755abd440d501f'],3,24,27,20733293,2,0,1,1,20286
a5b0053778448c97765100149373363df438cf85,1,Jayush Luniya,2015-06-11 01:00:09-07:00,['012519fa4187dc5041cde83c248cc83e132ff3f4'],3,8,11,20733304,4,,,,20286
ed7a084340b006fbd1d2a441993f17d75ca904bf,1,Vitaly Brodetskyi,2015-06-11 06:39:54+03:00,['a5b0053778448c97765100149373363df438cf85'],35,58,93,20733397,5,0,0,1,20286
3dd9ae471abfd6df36bf6fe902c3de9c81c57579,1,Vitaly Brodetskyi,2015-06-11 06:49:22+03:00,['ed7a084340b006fbd1d2a441993f17d75ca904bf'],10,361,371,20733768,3,0.346938776,0.540816327,0.93877551,20288
98405ef9bee07b974baeaa13cb143aeea6aeadfd,1,Bob Nettleton,2015-06-11 09:20:30-04:00,['3dd9ae471abfd6df36bf6fe902c3de9c81c57579'],2,216,218,20733986,7,0.155172414,0.422413793,1,20288
25ebb0532c8f1f7779012b576c035a213edc26f5,0,Aleksandr Kovalenko,2015-06-11 17:07:36+03:00,['98405ef9bee07b974baeaa13cb143aeea6aeadfd'],0,5,5,20733991,1,0,0,0.6,20288
974430a450e336baa0a985579081359c17205d33,1,aBabiichuk,2015-06-11 17:43:59+03:00,['25ebb0532c8f1f7779012b576c035a213edc26f5'],0,1,1,20733992,1,1,1,1,20288
b314e8db0c0625e9ab9251757474789c1946ad0f,1,Robert Levas,2015-06-11 10:59:26-04:00,['974430a450e336baa0a985579081359c17205d33'],47,77,124,20734116,15,1,1,1,20288
1b71e10c34f06d5a03749daa3b005c0691be38e7,0,Robert Levas,2015-06-11 11:05:29-04:00,['b314e8db0c0625e9ab9251757474789c1946ad0f'],8,48,56,20734172,2,0.794117647,0.794117647,0.852941176,20288
3fc7682d6d9ab4b57f11532888eaaa658cbc0e75,1,Alex Antonenko,2015-06-11 18:57:32+03:00,['1b71e10c34f06d5a03749daa3b005c0691be38e7'],189,137,326,20734498,10,1,0.119402985,0,20288
50be667fbc30021842ee00ff92a5f1e1a34d80fe,1,Vitaly Brodetskyi,2015-06-11 12:12:29+03:00,['3fc7682d6d9ab4b57f11532888eaaa658cbc0e75'],3,3,6,20734504,1,,,,20288
5cdafecfbdaf10326328286fd9c6cbbcc9cf0f9f,1,Robert Levas,2015-06-11 16:23:49-04:00,['50be667fbc30021842ee00ff92a5f1e1a34d80fe'],1187,1504,2691,20737195,96,0.369747899,0.462184874,1,20291
d6900c1b20c9465e48e452b2f2c0f54fe0cee22d,0,Billie Rinaldi,2015-06-11 14:16:32-07:00,['5cdafecfbdaf10326328286fd9c6cbbcc9cf0f9f'],17,0,17,20737212,1,1,1,0,20291
dc25acbc953d0c6895e7fd6fee69618108fcbb8d,1,Bob Nettleton,2015-06-11 17:41:46-04:00,['d6900c1b20c9465e48e452b2f2c0f54fe0cee22d'],0,105,105,20737317,2,0.20754717,0.981132075,1,20291
043e35a6b5bf970406b1d935edeb7ee06e4e9936,0,John Speidel,2015-06-11 18:28:39-04:00,['dc25acbc953d0c6895e7fd6fee69618108fcbb8d'],8,33,41,20737358,4,0.583333333,0,0.75,20291
4cb8180de671b1deab1ec814f481a7ed1e7c5724,0,Florian Barca,2015-06-11 22:33:11-07:00,['043e35a6b5bf970406b1d935edeb7ee06e4e9936'],1,1,2,20737360,1,,,,20291
8817a7cdc391d9aabe2daec07407e959386a7270,1,Yusaku Sako,2015-06-12 01:37:07-07:00,['4cb8180de671b1deab1ec814f481a7ed1e7c5724'],1,1,2,20737362,1,,,,20291
c4710db437b176b057ece319b436b0c482bc6c25,1,Lisnichenko Dmitro,2015-06-12 12:38:41+03:00,['8817a7cdc391d9aabe2daec07407e959386a7270'],2,87,89,20737451,3,0,0,0.875,20291
f1c17475f6a2ca22e374a61868733bc758eafd25,1,Lisnichenko Dmitro,2015-06-12 13:15:13+03:00,['c4710db437b176b057ece319b436b0c482bc6c25'],14,96,110,20737561,7,0.933333333,0.966666667,0.766666667,20292
6dbe315f9ab47fead66eeff5daea61dbfe8dee88,1,Vitaly Brodetskyi,2015-06-12 05:31:21+03:00,['f1c17475f6a2ca22e374a61868733bc758eafd25'],30,33,63,20737624,2,0,1,1,20292
6cfb8dff37a48c8573405c01da6cfd6621ec777e,1,Vitaly Brodetskyi,2015-06-12 05:49:06+03:00,['6dbe315f9ab47fead66eeff5daea61dbfe8dee88'],2,2,4,20737628,2,,,,20292
67cb4cc0cb719568e3c949a8e8d48ccccb3e3244,0,Lisnichenko Dmitro,2015-06-12 14:49:49+03:00,['6cfb8dff37a48c8573405c01da6cfd6621ec777e'],0,12,12,20737640,2,,,,20292
0e8b9bd1ee8fd9c3ec87cd473ab8fb880086f2b8,0,Aleksandr Kovalenko,2015-06-12 15:09:08+03:00,['67cb4cc0cb719568e3c949a8e8d48ccccb3e3244'],2,4,6,20737646,2,1,1,1,20292
de59d01c3f21ed476d1b00c08fe77a34183df845,1,Andrii Tkach,2015-06-12 15:17:35+03:00,['0e8b9bd1ee8fd9c3ec87cd473ab8fb880086f2b8'],2,25,27,20737673,3,0.2,1,1,20292
25322e999eb2709901ea618e5db88027bc24e469,1,Oleg Nechiporenko,2015-06-12 15:31:26+03:00,['de59d01c3f21ed476d1b00c08fe77a34183df845'],6,55,61,20737734,2,0.428571429,1,1,20292
0624e8cd360eb6b68d31641621cc5bd09ea66808,1,aBabiichuk,2015-06-12 15:34:48+03:00,['25322e999eb2709901ea618e5db88027bc24e469'],4,55,59,20737793,5,0.551020408,1,1,20292
acecac3702b4b9ea9fb5dddae7364861b01bf43f,0,Artem Baranchuk,2015-06-12 16:27:52+03:00,['0624e8cd360eb6b68d31641621cc5bd09ea66808'],1,1,2,20737795,1,,,,20292
d918c2c1887c1a3811a7f093bc75e86b7a930a40,1,aBabiichuk,2015-06-12 17:00:08+03:00,['acecac3702b4b9ea9fb5dddae7364861b01bf43f'],9,4,13,20737808,1,1,1,0,20292
3f673d343851bffd9ddf2d9978c74b8ad695ef99,0,Andrew Onishuk,2015-06-12 17:07:58+03:00,['d918c2c1887c1a3811a7f093bc75e86b7a930a40'],2,2,4,20737812,6,,,,20292
4a946466e1ddb9feee324bbcf8d80dab0f50964a,0,Andrew Onishuk,2015-06-12 17:25:02+03:00,['3f673d343851bffd9ddf2d9978c74b8ad695ef99'],3,3,6,20737818,1,,,,20292
51ed522ebff3f7d191967f0aacc49166a4360b43,1,Jonathan Hurley,2015-06-12 10:42:38-04:00,['4a946466e1ddb9feee324bbcf8d80dab0f50964a'],1,42,43,20737861,3,1,1,1,20293
e41e121e39e9ff2024f3ae7064ad62e83cc9c311,0,Nate Cole,2015-06-12 10:43:18-04:00,['51ed522ebff3f7d191967f0aacc49166a4360b43'],3,0,3,20737864,1,,,,20293
569290d7b0e6edaa3bd44e71260eb194d48d0b3e,0,Lisnichenko Dmitro,2015-06-12 17:59:04+03:00,['e41e121e39e9ff2024f3ae7064ad62e83cc9c311'],2,3,5,20737869,2,,,,20293
fbbe77c3d760f8de57995fcb4cd29e3bd67c05a3,0,Vitaly Brodetskyi,2015-06-12 09:45:30+03:00,['569290d7b0e6edaa3bd44e71260eb194d48d0b3e'],2,9,11,20737880,2,1,1,1,20293
5918aa57211fa1103a5b7418b3364cf5b5b4bfb5,1,Aleksandr Kovalenko,2015-06-12 18:16:01+03:00,['fbbe77c3d760f8de57995fcb4cd29e3bd67c05a3'],4,4,8,20737888,2,,,,20293
4987bfa0ac5fd1579fb54c0cf85c4608d378cf51,0,Robert Levas,2015-06-12 12:47:43-04:00,['5918aa57211fa1103a5b7418b3364cf5b5b4bfb5'],58,58,116,20738004,11,,,,20293
80c221bd407469cdc47de187aa1d65a43be5c3a4,1,John Speidel,2015-06-12 13:11:06-04:00,['4987bfa0ac5fd1579fb54c0cf85c4608d378cf51'],1,5,6,20738010,1,0,1,1,20293
ac8b64f211520c7f95ea016e5fc009c78a1bf802,1,Xi Wang,2015-06-12 10:46:51-07:00,['80c221bd407469cdc47de187aa1d65a43be5c3a4'],8,45,53,20738063,9,1,1,1,20293
1a5658b4b2f63f1088ddb9c121f25aea94b7f850,1,Srimanth Gunturi,2015-06-12 11:19:50-07:00,['ac8b64f211520c7f95ea016e5fc009c78a1bf802'],0,288,288,20738351,3,0,0.881040892,0.959107807,20293
7d463e79ca0038ca562c2ba3744ce5a9b59cbf18,1,Aleksandr Kovalenko,2015-06-12 21:28:59+03:00,['1a5658b4b2f63f1088ddb9c121f25aea94b7f850'],0,2,2,20738353,1,0,0,1,20293
fbb8bc7da0909f20c5a6696b26acde358f26d564,1,Jaimin Jetly,2015-06-12 13:20:04-07:00,['7d463e79ca0038ca562c2ba3744ce5a9b59cbf18'],139,214,353,20738706,12,0,0.842857143,1,20293
102ef9c439aaefd02ac2b743a9133fa07fcd2fc6,0,Srimanth Gunturi,2015-06-12 14:46:12-07:00,['fbb8bc7da0909f20c5a6696b26acde358f26d564'],1,2,3,20738709,1,,,,20293
39bdfbb6c903bdb12f88990cc1daa1a16c10652b,0,Xi Wang,2015-06-12 15:24:00-07:00,['102ef9c439aaefd02ac2b743a9133fa07fcd2fc6'],2,0,2,20738711,1,0,0,0,20293
b011588c62296a9e849898a7887387a7c4d7712e,0,Xi Wang,2015-06-12 15:32:31-07:00,['39bdfbb6c903bdb12f88990cc1daa1a16c10652b'],0,1,1,20738712,1,,,,20293
ffe4fdbfc25a61f77cace823f6ca6836a32dbf28,0,Jaimin Jetly,2015-06-12 18:28:24-07:00,['b011588c62296a9e849898a7887387a7c4d7712e'],0,20,20,20738732,2,1,1,1,20293
6e5e984b66ad3dd3445e85ca82507daecad43c99,1,Bob Nettleton,2015-06-12 22:08:47-04:00,['ffe4fdbfc25a61f77cace823f6ca6836a32dbf28'],2,13,15,20738747,2,0,1,1,20293
6e6042db2531ff621c69ced2b2e62e12fb24d28c,0,Sumit Mohanty,2015-06-12 23:03:45-07:00,['6e5e984b66ad3dd3445e85ca82507daecad43c99'],1,1,2,20738749,1,,,,20293
4c8b84d0fc546e74198681ebbe745b497440b862,0,Artem Baranchuk,2015-06-13 14:06:24+03:00,['6e6042db2531ff621c69ced2b2e62e12fb24d28c'],0,4,4,20738753,1,0,0,1,20293
d580761f64f05f0006331ff4ee269a6ef8647cb4,1,Oleg Nechiporenko,2015-06-13 18:00:17+03:00,['4c8b84d0fc546e74198681ebbe745b497440b862'],1,15,16,20738769,2,1,1,1,20293
91ec0fb8601c87d27a734ac80a43c2a0c55275ed,1,Oleg Nechiporenko,2015-06-13 18:01:02+03:00,['d580761f64f05f0006331ff4ee269a6ef8647cb4'],3,16,19,20738788,2,,,,20293
e71aef020b874ddecc20f87fb9f63fce55302117,1,Myroslav Papirkovskyy,2015-06-13 18:43:38+03:00,['91ec0fb8601c87d27a734ac80a43c2a0c55275ed'],151,232,383,20739171,9,0.563380282,0.957746479,0.591549296,20293
029e462f47827ac5507adcc0187df78972cda34f,0,Myroslav Papirkovskyy,2015-06-13 18:49:17+03:00,['e71aef020b874ddecc20f87fb9f63fce55302117'],1,1,2,20739173,1,,,,20293
65b6a8931498eb52aecd1fca287262447fa127b7,1,Myroslav Papirkovskyy,2015-06-13 18:57:52+03:00,['029e462f47827ac5507adcc0187df78972cda34f'],4,15,19,20739192,2,1,0,1,20293
a1c0a4643d518d6d78b3f2208bd2eb63d77c7aea,1,Jonathan Hurley,2015-06-13 14:56:59-04:00,['65b6a8931498eb52aecd1fca287262447fa127b7'],339,500,839,20740031,7,0,1,1,20293
a8d8e12350afc009e6e30d66505c1e2e5d61f560,1,Sumit Mohanty,2015-06-13 14:32:59-07:00,['a1c0a4643d518d6d78b3f2208bd2eb63d77c7aea'],112,111,223,20740254,14,,,,20293
458e7094e07813a65df2424932e5b379a0a80594,1,Alex Antonenko,2015-06-14 01:05:35+03:00,['a8d8e12350afc009e6e30d66505c1e2e5d61f560'],220,171,391,20740645,12,0.757142857,0,0.228571429,20293
93a93c1ef71d30c274d31b9eda5c83b926b34fb8,1,Vitaly Brodetskyi,2015-06-14 12:10:41+03:00,['458e7094e07813a65df2424932e5b379a0a80594'],41,172,213,20740858,5,0.75,1,0.6875,20293
478b77ef3a0b1c3b40b1bba16b9176faf6e4fb41,1,Andrew Onishuk,2015-06-14 13:06:12+03:00,['93a93c1ef71d30c274d31b9eda5c83b926b34fb8'],1,7,8,20740866,1,,,,20293
e7a4ce3236c3f52d5baf5e331a263b28d3ea0940,1,Nate Cole,2015-06-14 07:07:13-04:00,['478b77ef3a0b1c3b40b1bba16b9176faf6e4fb41'],20,400,420,20741286,13,0.072368421,0.875,0.677631579,20295
aea31f7407c135d41842b02c86218ad8ed8a9e69,1,Alex Antonenko,2015-06-14 16:03:45+03:00,['e7a4ce3236c3f52d5baf5e331a263b28d3ea0940'],5,7,12,20741298,1,0.5,0.5,1,20295
094245f3192345ce6bead138f1b8b5687b1cf6ad,0,Florian Barca,2015-06-14 09:47:05-07:00,['aea31f7407c135d41842b02c86218ad8ed8a9e69'],1,1,2,20741300,1,,,,20295
9ad9dcc25cf26a269637db8d3ffc26be205bc5eb,1,Dmytro Sen,2015-06-14 20:31:49+03:00,['094245f3192345ce6bead138f1b8b5687b1cf6ad'],17,17,34,20741334,1,0,0,0,20295
5ce9314f6df8cec9ddc7bf78b4001fd8871f87c6,1,Siddharth Wagle,2015-06-14 10:36:59-07:00,['9ad9dcc25cf26a269637db8d3ffc26be205bc5eb'],1,1,2,20741336,1,,,,20295
899705d074836918f25f500a7e895aaba993e760,1,Dmytro Sen,2015-06-14 21:50:56+03:00,['5ce9314f6df8cec9ddc7bf78b4001fd8871f87c6'],200,273,473,20741809,26,0.25,0,0.819444444,20295
08cd5d0417290a42d7acba6208ec8c85eb269a94,1,Siddharth Wagle,2015-06-14 12:05:42-07:00,['899705d074836918f25f500a7e895aaba993e760'],5,14,19,20741828,4,0,1,1,20295
b8ddd2341bdd64005143ed663d03a9057c0b6f93,1,Vitaly Brodetskyi,2015-06-15 02:01:03+03:00,['08cd5d0417290a42d7acba6208ec8c85eb269a94'],18,63,81,20741909,2,0.387096774,0.903225806,1,20295
18ef979bdc18dc10063edea1e002a127ef62b447,0,Robert Levas,2015-06-14 23:00:10-04:00,['b8ddd2341bdd64005143ed663d03a9057c0b6f93'],2,2,4,20741913,1,,,,20295
a0a2524a50ea80ef7ec49f3a705de860bcc1cfec,0,Jayush Luniya,2015-06-14 22:15:07-07:00,['18ef979bdc18dc10063edea1e002a127ef62b447'],6,8,14,20741927,3,,,,20295
4d43586c98dca0cde6acbac4ab930db7299ef31f,0,aBabiichuk,2015-06-15 10:53:35+03:00,['a0a2524a50ea80ef7ec49f3a705de860bcc1cfec'],0,2,2,20741929,1,1,1,1,20295
e5f2c6406a7d8db86dbdb378e94fcf532f9f5c46,1,Lisnichenko Dmitro,2015-06-15 12:06:19+03:00,['4d43586c98dca0cde6acbac4ab930db7299ef31f'],4,86,90,20742019,2,0,0.5,1,20295
0ba18770ddbc9af88ee3a074ec7a1c762916d5ef,1,Andrew Onishuk,2015-06-15 12:35:25+03:00,['e5f2c6406a7d8db86dbdb378e94fcf532f9f5c46'],1,1,2,20742021,1,,,,20295
0542f55521c4c7777a6d943719535ab7dd4ca032,1,Andrew Onishuk,2015-06-15 12:56:22+03:00,['0ba18770ddbc9af88ee3a074ec7a1c762916d5ef'],6,21,27,20742048,7,0,0.571428571,1,20295
277f770a611e267845ea3c67321955b8abe954c8,1,Alex Antonenko,2015-06-15 13:31:30+03:00,['0542f55521c4c7777a6d943719535ab7dd4ca032'],5,15,20,20742068,3,1,1,1,20295
eaf9a277910f67420c2622af96192802cc7a8091,1,Alex Antonenko,2015-06-15 19:49:45+03:00,['277f770a611e267845ea3c67321955b8abe954c8'],6,15,21,20742089,3,0,0,1,20295
df082c1b17967528b71d617fc35f4251cc33b52f,1,Dmytro Sen,2015-06-15 20:42:25+03:00,['eaf9a277910f67420c2622af96192802cc7a8091'],1,33,34,20742123,4,0,0,1,20295
cae5552e607bcc2b369819ea05805cfa1af685bd,1,aBabiichuk,2015-06-15 20:44:26+03:00,['df082c1b17967528b71d617fc35f4251cc33b52f'],2,17,19,20742142,4,0,1,1,20295
8a01bebe48e76787f3e37707eb669b3ac79601da,1,Dmytro Sen,2015-06-15 21:00:04+03:00,['cae5552e607bcc2b369819ea05805cfa1af685bd'],3,6,9,20742151,1,,,,20295
b695dbea92edf6cdb186d21c011fa09a0007a196,1,Jaimin Jetly,2015-06-15 11:25:00-07:00,['8a01bebe48e76787f3e37707eb669b3ac79601da'],1,6,7,20742158,2,,,,20295
6ee32914032850caa452a64e7a2b83658fffecf9,0,Jaimin Jetly,2015-06-15 11:44:49-07:00,['b695dbea92edf6cdb186d21c011fa09a0007a196'],46,746,792,20742950,1,,,,20295
3fa380d07873f76652aefd4e2bda2c0548c12804,1,Robert Levas,2015-06-15 15:16:31-04:00,['6ee32914032850caa452a64e7a2b83658fffecf9'],0,7,7,20742957,7,,,,20295
1800b0b2166abcb858888d171486f666e57fdf2a,0,Aleksandr Kovalenko,2015-06-15 22:19:27+03:00,['3fa380d07873f76652aefd4e2bda2c0548c12804'],1,1,2,20742959,1,,,,20295
e518ac33ab2dc5734dc376695fb9b42157af375a,1,Robert Levas,2015-06-15 15:45:05-04:00,['1800b0b2166abcb858888d171486f666e57fdf2a'],47,63,110,20743069,5,0.294117647,1,1,20295
780dea082e715398adb43fd0359efa2c5c7b9213,1,Jayush Luniya,2015-06-15 13:26:20-07:00,['e518ac33ab2dc5734dc376695fb9b42157af375a'],1,99,100,20743169,3,,,,20297
76499d9cdc808cfdf4f6d87cf7867bf510a00563,1,Srimanth Gunturi,2015-06-15 13:59:26-07:00,['780dea082e715398adb43fd0359efa2c5c7b9213'],2,31,33,20743202,6,0.272727273,0.545454545,0.545454545,20297
93f61157745d71e03f02b2b307f30848fe18c717,0,Sumit Mohanty,2015-06-15 14:04:37-07:00,['76499d9cdc808cfdf4f6d87cf7867bf510a00563'],2,24,26,20743228,2,0.888888889,0.888888889,1,20297
25b2536d82de87090dbe4c850ff619616d5ac7f6,1,Alex Antonenko,2015-06-16 00:11:40+03:00,['93f61157745d71e03f02b2b307f30848fe18c717'],1,1,2,20743230,1,,,,20297
d4d256de43c18cc842524e0cd33b584ba26eaab6,1,Jaimin Jetly,2015-06-15 14:50:27-07:00,['25b2536d82de87090dbe4c850ff619616d5ac7f6'],746,46,792,20744022,1,,,,20297
61e3392113329f1e1a44b3247e9e1baab2bc7985,1,Srimanth Gunturi,2015-06-15 16:46:36-07:00,['d4d256de43c18cc842524e0cd33b584ba26eaab6'],3,201,204,20744226,2,0,0.951612903,0.951612903,20297
776a45d2a90a773adc41e3988176e141d6213efc,0,Robert Levas,2015-06-15 19:55:37-04:00,['61e3392113329f1e1a44b3247e9e1baab2bc7985'],6,11,17,20744243,3,0,1,1,20297
296ad04c8f61d54bc99de011eb49af6c2356e9b1,1,tbeerbower,2015-06-15 21:47:31-04:00,['776a45d2a90a773adc41e3988176e141d6213efc'],2,2,4,20744247,1,,,,20297
9b8b308feba4964511ca0fdbe253cb15ca182223,1,Jayush Luniya,2015-06-16 00:18:55-07:00,['296ad04c8f61d54bc99de011eb49af6c2356e9b1'],1,1,2,20744249,1,,,,20297
345f99588c924b3f9c271cee13ae5e53b3e69261,1,Florian Barca,2015-06-16 01:15:03-07:00,['9b8b308feba4964511ca0fdbe253cb15ca182223'],39,146,185,20744434,13,1,1,1,20298
b508d0396dd572850c5018a4fcea6865261ac5be,1,Oleg Nechiporenko,2015-06-16 12:39:22+03:00,['345f99588c924b3f9c271cee13ae5e53b3e69261'],6,328,334,20744768,14,0.459770115,0.959770115,1,20298
f84ef816c2027bad092c7a33d133ea35c6fb94d1,0,Dmytro Sen,2015-06-16 14:28:29+03:00,['b508d0396dd572850c5018a4fcea6865261ac5be'],44,1,45,20744813,2,1,1,1,20298
d13f7098b3bd220413bd13534877383e0bfe66a2,1,Jonathan Hurley,2015-06-16 08:16:15-04:00,['f84ef816c2027bad092c7a33d133ea35c6fb94d1'],19,46,65,20744878,2,0,1,1,20298
7b031f9e0d7cfdba34ae317920d52fe21c28c8e4,1,aBabiichuk,2015-06-16 16:05:34+03:00,['d13f7098b3bd220413bd13534877383e0bfe66a2'],5,11,16,20744894,1,1,1,1,20298
adbfdb8050fc5ca9f96f921a278f99cdb0d56424,1,Lisnichenko Dmitro,2015-06-16 16:16:11+03:00,['7b031f9e0d7cfdba34ae317920d52fe21c28c8e4'],3,34,37,20744931,1,0.0625,0.0625,0.0625,20298
058983f10ffcd2c87d805c4bd8118a94ee5187d7,0,Andrew Onishuk,2015-06-16 16:48:02+03:00,['adbfdb8050fc5ca9f96f921a278f99cdb0d56424'],32,0,32,20744963,3,,,,20298
67add3fd3bd02853bb8a62cf2d6d9a0e9d4a9654,1,Andrew Onishuk,2015-06-16 16:57:52+03:00,['058983f10ffcd2c87d805c4bd8118a94ee5187d7'],3,3,6,20744969,1,,,,20298
222b0292e4e22db1e2be6bd03764280b3cbce837,1,Sumit Mohanty,2015-06-16 07:35:30-07:00,['67add3fd3bd02853bb8a62cf2d6d9a0e9d4a9654'],135,173,308,20745277,3,0.15,0.625,0.375,20298
3e4ac6e7a8014e0266598d9ccac6f4879b38f6f8,1,Lisnichenko Dmitro,2015-06-16 20:31:25+03:00,['222b0292e4e22db1e2be6bd03764280b3cbce837'],8,6,14,20745291,1,,,,20298
e7a8b35d647cb8b07d641325904b9041382f00c1,1,Xi Wang,2015-06-16 11:14:33-07:00,['3e4ac6e7a8014e0266598d9ccac6f4879b38f6f8'],3,361,364,20745655,5,0.142405063,1,1,20300
8c92ed631f11f534d6b7de0a5b8f2f89699ebb00,0,Nate Cole,2015-06-16 14:32:19-04:00,['e7a8b35d647cb8b07d641325904b9041382f00c1'],1,1,2,20745657,1,,,,20300
8d98d930743b78006ca11eb283fcf49450c1042a,0,Jayush Luniya,2015-06-16 11:45:33-07:00,['8c92ed631f11f534d6b7de0a5b8f2f89699ebb00'],3,4,7,20745664,3,,,,20300
5e2e50533add8afe3a8b9e619372bc4e20cbab47,1,Sumit Mohanty,2015-06-16 12:37:03-07:00,['8d98d930743b78006ca11eb283fcf49450c1042a'],15,27,42,20745706,1,1,1,1,20300
3197470db2bc4ac058c50b9d3a55d985ef4f3ac4,1,Srimanth Gunturi,2015-06-16 12:52:35-07:00,['5e2e50533add8afe3a8b9e619372bc4e20cbab47'],9,84,93,20745799,3,0,0.863636364,0.863636364,20300
8da4ca1b45a6b01956699aab869dcbe265f28e2e,0,Jonathan Hurley,2015-06-16 16:28:15-04:00,['3197470db2bc4ac058c50b9d3a55d985ef4f3ac4'],21,28,49,20745848,2,0,0,1,20300
ac508b8dffb923b717bf66572b0bc14ba9f2ff3f,1,Bob Nettleton,2015-06-16 16:35:39-04:00,['8da4ca1b45a6b01956699aab869dcbe265f28e2e'],1,63,64,20745912,2,0.258064516,1,0.870967742,20300
1cdf8864c1d52d44a910b836e31acf6f6ded161d,1,tbeerbower,2015-06-16 17:36:59-04:00,['ac508b8dffb923b717bf66572b0bc14ba9f2ff3f'],7,144,151,20746063,2,0.06097561,1,1,20300
5c47a61f390fe0ea565b3ab9b3303f4ed984b592,0,Alex Antonenko,2015-06-17 00:53:55+03:00,['1cdf8864c1d52d44a910b836e31acf6f6ded161d'],0,9,9,20746072,1,1,1,1,20300
0930a74fc54ac21e67c2a912de9618bcb2e65169,0,Alex Antonenko,2015-06-17 00:53:55+03:00,['5c47a61f390fe0ea565b3ab9b3303f4ed984b592'],4,20,24,20746096,2,1,1,1,20300
9a5edfdea27b2627952577542436e20dfddf0e81,1,Dmytro Sen,2015-06-17 01:29:48+03:00,['0930a74fc54ac21e67c2a912de9618bcb2e65169'],3,427,430,20746526,6,0,0.987654321,1,20301
48f785c23120d1893274e9fc3ba142bd86a63329,1,Artem Baranchuk,2015-06-17 01:32:26+03:00,['9a5edfdea27b2627952577542436e20dfddf0e81'],29,33,62,20746588,5,0.25,0.25,1,20301
94c091e280a99e07db5f3910873e70aa3c18394f,1,Artem Baranchuk,2015-06-17 01:32:26+03:00,['48f785c23120d1893274e9fc3ba142bd86a63329'],183,319,502,20747090,16,0,0,0.645833333,20301
c9c93c5b9462d5e36a584acc51f49358b80b5c01,0,Yusaku Sako,2015-06-16 16:52:27-07:00,['94c091e280a99e07db5f3910873e70aa3c18394f'],4,4,8,20747098,1,,,,20301
983b3cd23cbde486b45eeb8903bc375c8a564cac,0,Sumit Mohanty,2015-06-16 17:08:20-07:00,['c9c93c5b9462d5e36a584acc51f49358b80b5c01'],1,1,2,20747100,1,,,,20301
043fb9850b18be7b7c311e1ad7095a4acebb0cba,1,Jaimin Jetly,2015-06-16 18:42:22-07:00,['983b3cd23cbde486b45eeb8903bc375c8a564cac'],52,742,794,20747894,1,,,,20301
3607163418c3b16782ec85a4ec146be567c55a7a,1,Jayush Luniya,2015-06-16 22:31:52-07:00,['043fb9850b18be7b7c311e1ad7095a4acebb0cba'],47,118,165,20748059,7,0.049180328,0.393442623,0.409836066,20301
0fcbabfcd8d41bd59743eadd7779555f81c8745b,1,Yusaku Sako,2015-06-17 00:05:47-07:00,['3607163418c3b16782ec85a4ec146be567c55a7a'],319,183,502,20748561,16,1,1,0.354166667,20301
27c6d7542fdd4d792f2101679095f544159894e7,1,aBabiichuk,2015-06-17 13:57:43+03:00,['0fcbabfcd8d41bd59743eadd7779555f81c8745b'],192,588,780,20749341,21,0.806451613,0.747311828,0.892473118,20302
9ca9a1deb36f2fa9536f50d9e6f575d4bae1c8fa,1,Andrew Onishuk,2015-06-17 15:46:09+03:00,['27c6d7542fdd4d792f2101679095f544159894e7'],136,45,181,20749522,16,0.142857143,0.171428571,0.285714286,20302
386506ffdb4327aa9cc38c6493b472b50a257e1b,1,Oleg Nechiporenko,2015-06-17 15:51:33+03:00,['9ca9a1deb36f2fa9536f50d9e6f575d4bae1c8fa'],13,38,51,20749573,2,0.230769231,1,1,20302
ca20312826b571743f04dccb9b5568de33ef1dd8,1,Alex Antonenko,2015-06-17 19:06:48+03:00,['386506ffdb4327aa9cc38c6493b472b50a257e1b'],3,3,6,20749579,1,,,,20302
5306e0d20a1839f8e0b951ddfdd345a1316c6739,0,aBabiichuk,2015-06-17 19:13:26+03:00,['ca20312826b571743f04dccb9b5568de33ef1dd8'],2,15,17,20749596,2,0,1,1,20302
45c7b27ed9c6d005a3dd5a7a5f84ba56bfc4621a,0,Aleksandr Kovalenko,2015-06-17 19:26:54+03:00,['5306e0d20a1839f8e0b951ddfdd345a1316c6739'],10,28,38,20749634,2,0.105263158,1,1,20302
fc41f66738c38aa25455f4b4d1c721a29f5df95d,1,Vitaly Brodetskyi,2015-06-17 20:48:45+03:00,['45c7b27ed9c6d005a3dd5a7a5f84ba56bfc4621a'],7,13,20,20749654,4,0,0,1,20302
76b211fa72fe13b60a6881f90ddc5209a1a80f6f,1,Robert Levas,2015-06-17 14:00:05-04:00,['fc41f66738c38aa25455f4b4d1c721a29f5df95d'],0,5,5,20749659,1,1,1,1,20302
d7df0c3930be64ff6c1f15b3333ccec90725ef2a,0,Aleksandr Kovalenko,2015-06-17 21:03:07+03:00,['76b211fa72fe13b60a6881f90ddc5209a1a80f6f'],11,3,14,20749673,3,1,1,1,20302
357b594b3ee7c35258400cbe807f9847438d82d2,1,Robert Levas,2015-06-17 14:20:13-04:00,['d7df0c3930be64ff6c1f15b3333ccec90725ef2a'],1005,949,1954,20751627,30,1,0,1,20307
6fc7bdef34f3afa1ca5a7611777797bfebe11041,0,Alex Antonenko,2015-06-17 21:21:36+03:00,['357b594b3ee7c35258400cbe807f9847438d82d2'],1,10,11,20751638,1,1,1,1,20307
8f598c55219f4db90ccf2f778d2586a73e9b9085,1,Vitaly Brodetskyi,2015-06-17 21:29:25+03:00,['6fc7bdef34f3afa1ca5a7611777797bfebe11041'],0,223,223,20751861,1,,,,20308
97d796de331b381f989b62cfe0a0888643969134,0,Srimanth Gunturi,2015-06-17 11:52:04-07:00,['8f598c55219f4db90ccf2f778d2586a73e9b9085'],2,2,4,20751865,1,,,,20308
26f527e6523287db58219d552e98d5198be035e0,1,Dmytro Sen,2015-06-17 21:55:44+03:00,['97d796de331b381f989b62cfe0a0888643969134'],37,32,69,20751934,2,0,0,0,20308
53e3d9851f98dc684dcbc21662ec1c9b4da75c3a,1,Xi Wang,2015-06-17 12:32:30-07:00,['26f527e6523287db58219d552e98d5198be035e0'],3,32,35,20751969,4,0,1,1,20308
85ce4353c546d8c9fb23f016b7e16cd37e9a871e,0,Xi Wang,2015-06-17 12:32:41-07:00,['53e3d9851f98dc684dcbc21662ec1c9b4da75c3a'],2,2,4,20751973,2,,,,20308
2ad152a5cfe26e412f1b52d3c30e62e5d7398ab3,0,Sumit Mohanty,2015-06-17 12:57:17-07:00,['85ce4353c546d8c9fb23f016b7e16cd37e9a871e'],203,84,287,20752260,6,1,0.079646018,0,20308
b2d54dc0493bb164bf1d76b621306cc3ae5c9494,0,Sumit Mohanty,2015-06-17 12:58:25-07:00,['2ad152a5cfe26e412f1b52d3c30e62e5d7398ab3'],8,8,16,20752276,4,,,,20308
5cfc567b62a9aade74235807f8468fa4a485ee3d,1,Nate Cole,2015-06-17 20:42:17-04:00,['b2d54dc0493bb164bf1d76b621306cc3ae5c9494'],0,79,79,20752355,2,0,1,0,20309
570eeccaad02c37ecdd5372d3e7a2e20814fae9a,1,Sumit Mohanty,2015-06-17 18:17:03-07:00,['5cfc567b62a9aade74235807f8468fa4a485ee3d'],0,36,36,20752391,3,,,,20309
10fb2789cd3deffb00f9ece61b8be3a2d3865dd4,1,Srimanth Gunturi,2015-06-17 19:12:01-07:00,['570eeccaad02c37ecdd5372d3e7a2e20814fae9a'],9,87,96,20752487,3,0,0.917808219,0.917808219,20309
cbf4c72d86289e1ded07a42e3130cb09114c6c54,0,Jayush Luniya,2015-06-17 20:04:29-07:00,['10fb2789cd3deffb00f9ece61b8be3a2d3865dd4'],1,1,2,20752489,1,,,,20309
82cfc3ee295cdf5b9f87ea1aef0346837c255f10,0,Srimanth Gunturi,2015-06-17 23:33:37-07:00,['cbf4c72d86289e1ded07a42e3130cb09114c6c54'],7,0,7,20752496,1,,,,20309
59a74cfda17bd3ad559f64fd967aa2dd13398e72,0,tbeerbower,2015-06-18 09:15:03-04:00,['82cfc3ee295cdf5b9f87ea1aef0346837c255f10'],7,20,27,20752523,2,0,0.857142857,0,20309
c61933d870b94f85aa41f91fa6728019ed74211f,1,aBabiichuk,2015-06-18 16:44:06+03:00,['59a74cfda17bd3ad559f64fd967aa2dd13398e72'],8504,11,8515,20761038,50,0.286709113,0.030640669,0.01850378,20309
4fd35351b103c51e8cb8957734d11d67c52ee07e,0,Myroslav Papirkovskyy,2015-06-18 17:29:15+03:00,['c61933d870b94f85aa41f91fa6728019ed74211f'],1,1,2,20761040,1,,,,20309
47f925efff2ddfa1d5483aeaf8b25d042ea43879,1,Andrew Onishuk,2015-06-18 18:01:56+03:00,['4fd35351b103c51e8cb8957734d11d67c52ee07e'],19,20,39,20761079,6,0,1,1,20309
862827df6107d7e0aec968e03bbf396bf2fe46a2,1,Bob Nettleton,2015-06-18 11:48:19-04:00,['47f925efff2ddfa1d5483aeaf8b25d042ea43879'],1,58,59,20761138,2,0,1,1,20309
7092b53dbf0907933efd2382074db99d6b3a69ba,0,Oleg Nechiporenko,2015-06-18 19:42:52+03:00,['862827df6107d7e0aec968e03bbf396bf2fe46a2'],2,187,189,20761327,3,0.251533742,1,1,20310
316f341813b17ed24c2c166d02607b7c3afa3247,1,Xi Wang,2015-06-18 10:34:00-07:00,['7092b53dbf0907933efd2382074db99d6b3a69ba'],4,36,40,20761367,4,1,1,1,20310
e28c40b239c3d934f7c1ea9594cec9b1a627bff1,0,Robert Levas,2015-06-18 15:11:07-04:00,['316f341813b17ed24c2c166d02607b7c3afa3247'],2,2,4,20761371,1,,,,20310
6d29aa47a62ee84d74e820c2fce0128e1a1f3126,1,Aleksandr Kovalenko,2015-06-19 00:15:54+03:00,['e28c40b239c3d934f7c1ea9594cec9b1a627bff1'],2,16,18,20761389,2,0,0,0,20310
4bff675a89048804fad3ceba028eaff70f544779,1,Sumit Mohanty,2015-06-18 14:21:23-07:00,['6d29aa47a62ee84d74e820c2fce0128e1a1f3126'],10,358,368,20761757,3,,,,20311
2c5ecc39ec919af7e911237635382e6fe9a18abb,0,tbeerbower,2015-06-18 17:22:35-04:00,['4bff675a89048804fad3ceba028eaff70f544779'],20,7,27,20761784,2,1,0.142857143,1,20311
af7e2670435fedc71c9e13c1446ba8b6fc4d1efe,1,Florian Barca,2015-06-18 14:45:26-07:00,['2c5ecc39ec919af7e911237635382e6fe9a18abb'],3,8,11,20761795,4,0,0,1,20311
1b6d7a9e1a5484c56107a2957284392ebbbc8272,0,John Speidel,2015-06-18 18:47:45-04:00,['af7e2670435fedc71c9e13c1446ba8b6fc4d1efe'],9,219,228,20762023,2,0.704918033,1,1,20312
ecc44d2cda600467552658e806cf0393eaa3e709,0,Srimanth Gunturi,2015-06-18 15:55:21-07:00,['1b6d7a9e1a5484c56107a2957284392ebbbc8272'],14,31,45,20762068,4,0,1,1,20312
ee59abc9d6fd66d71e25af85d7deccf52161cee4,0,Srimanth Gunturi,2015-06-18 16:39:55-07:00,['ecc44d2cda600467552658e806cf0393eaa3e709'],0,11,11,20762079,1,,,,20312
55758cdebed15a67d6171ee63e37d7648f6741f8,1,Jayush Luniya,2015-06-18 17:00:55-07:00,['ee59abc9d6fd66d71e25af85d7deccf52161cee4'],25,30,55,20762134,14,0,1,1,20312
f0559128d27dc97501a66528167d3f6eeb4b463d,1,tbeerbower,2015-06-18 20:11:05-04:00,['55758cdebed15a67d6171ee63e37d7648f6741f8'],7,28,35,20762169,2,0,0.615384615,0,20312
cf842a05a7de4e6755e2aaef03eb36052495a824,1,tbeerbower,2015-06-18 20:14:24-04:00,['f0559128d27dc97501a66528167d3f6eeb4b463d'],24,60,84,20762253,3,0,0,1,20312
2418787ede32d1e1c88dcff8e883a8bfdbe91a11,1,Yusaku Sako,2015-06-18 23:50:51-07:00,['cf842a05a7de4e6755e2aaef03eb36052495a824'],0,51,51,20762304,1,1,1,1,20312
3e0677678492125111b1f2321e16bae11f14e973,1,Andrii Tkach,2015-06-19 11:33:12+03:00,['2418787ede32d1e1c88dcff8e883a8bfdbe91a11'],74,271,345,20762649,9,0.820224719,1,0.938202247,20312
80a7c54723a48bd6c7a31aab38fafecfbd901e25,1,Oleg Nechiporenko,2015-06-19 11:38:54+03:00,['3e0677678492125111b1f2321e16bae11f14e973'],2,3,5,20762654,1,,,,20312
a59c66c67b0544f594f48b13a964b90608060a17,1,Artem Baranchuk,2015-06-19 13:42:59+03:00,['80a7c54723a48bd6c7a31aab38fafecfbd901e25'],1,69,70,20762724,2,0.018181818,0.618181818,1,20312
8a2cb5b35a6c9b7a98185e96808551123e7fc647,1,Artem Baranchuk,2015-06-19 16:32:03+03:00,['a59c66c67b0544f594f48b13a964b90608060a17'],363,585,948,20763672,24,0,0.176706827,0.847389558,20312
88f5c45d265e82bcaf1722efc7ca7192fa309c6a,0,Sumit Mohanty,2015-06-19 07:13:26-07:00,['8a2cb5b35a6c9b7a98185e96808551123e7fc647'],348,0,348,20764020,1,,,,20312
e6d973c821533375c89b5ef2d49ecd0389b6aff7,0,Alex Antonenko,2015-06-19 17:37:15+03:00,['88f5c45d265e82bcaf1722efc7ca7192fa309c6a'],2,2,4,20764024,2,,,,20312
93e6d0d9c1e097f5c5d7288a9a7cc1c59efd6ce8,1,Aleksandr Kovalenko,2015-06-19 18:15:49+03:00,['e6d973c821533375c89b5ef2d49ecd0389b6aff7'],8,9,17,20764041,1,0,1,1,20312
65ab30dd4247f9739f7093b54242723853fd1f54,0,Nate Cole,2015-06-19 11:52:36-04:00,['93e6d0d9c1e097f5c5d7288a9a7cc1c59efd6ce8'],4,0,4,20764045,1,,,,20312
db55ececd7cb8a8da67d53fe9e3becbcdc554984,1,Dmytro Sen,2015-06-19 18:56:46+03:00,['65ab30dd4247f9739f7093b54242723853fd1f54'],1,9,10,20764055,2,,,,20312
e7a4800b2c0bd2cc83ec8340f95636012366db58,1,Alex Antonenko,2015-06-19 19:38:40+03:00,['db55ececd7cb8a8da67d53fe9e3becbcdc554984'],4,18,22,20764077,3,0,0,1,20312
2a8c9e9fa30ac8708c118ac24ed7129804b8702a,1,Alex Antonenko,2015-06-19 19:51:56+03:00,['e7a4800b2c0bd2cc83ec8340f95636012366db58'],2,50,52,20764129,3,1,1,1,20312
61fc03f174220c2dfb4a996196b6c80f31e2cd10,1,Dmytro Sen,2015-06-19 20:07:01+03:00,['2a8c9e9fa30ac8708c118ac24ed7129804b8702a'],3,110,113,20764242,3,0.182926829,0.585365854,0.902439024,20312
0e2a40c0925f6a796131ab006057b34ff1da9867,1,Andrew Onishuk,2015-06-19 20:40:29+03:00,['61fc03f174220c2dfb4a996196b6c80f31e2cd10'],1,9,10,20764252,3,0,0,1,20312
cbc01607350fa2c219eebb56f5e631a79b902684,1,Robert Levas,2015-06-19 13:57:55-04:00,['0e2a40c0925f6a796131ab006057b34ff1da9867'],5,51,56,20764308,3,1,1,1,20312
24f1cdec4a315e44b602867c24e2766a338a656f,1,Alejandro Fernandez,2015-06-19 11:00:16-07:00,['cbc01607350fa2c219eebb56f5e631a79b902684'],58,73,131,20764439,6,0.2,1,1,20312
38145997908568e489dd801b1a0834b765e61f45,1,Jonathan Hurley,2015-06-19 14:08:42-04:00,['24f1cdec4a315e44b602867c24e2766a338a656f'],27,6,33,20764472,2,0.277777778,0.777777778,1,20312
519461587799668fea4f90d2efce5e002a02c890,1,Alejandro Fernandez,2015-06-19 12:53:21-07:00,['38145997908568e489dd801b1a0834b765e61f45'],11,25,36,20764508,3,0.666666667,1,0,20312
322abbe050f63f1715d198a702ad522fb5367e92,1,Robert Levas,2015-06-19 17:33:37-04:00,['519461587799668fea4f90d2efce5e002a02c890'],30,77,107,20764615,6,0,1,1,20312
aec96f9437cd7ad05b14e75d36bceb81e3867948,0,Sumit Mohanty,2015-06-19 16:01:46-07:00,['322abbe050f63f1715d198a702ad522fb5367e92'],29,0,29,20764644,9,,,,20312
d825760843d29fe818811d1ee4c647dd64c418b3,1,Jayush Luniya,2015-06-19 16:29:52-07:00,['aec96f9437cd7ad05b14e75d36bceb81e3867948'],2,2,4,20764648,1,,,,20312
d960d2a95ffd49177d45fa8367d22587879003d0,1,Florian Barca,2015-06-19 16:39:27-07:00,['d825760843d29fe818811d1ee4c647dd64c418b3'],3,14,17,20764665,1,1,1,1,20312
bec93e18b8bc5228d553774f926a5ebfceaaf87d,1,Srimanth Gunturi,2015-06-19 17:27:56-07:00,['d960d2a95ffd49177d45fa8367d22587879003d0'],0,32,32,20764697,1,,,,20313
66c576f1b924f958d8d452ee167c08843386aee7,1,Alejandro Fernandez,2015-06-19 18:19:57-07:00,['bec93e18b8bc5228d553774f926a5ebfceaaf87d'],0,32,32,20764729,3,0,0.64,1,20313
7e414bbe30608edb217a24acf1fe706243bcdcd6,0,Jonathan Hurley,2015-06-19 23:18:32-04:00,['66c576f1b924f958d8d452ee167c08843386aee7'],40,0,40,20764769,1,1,0,0,20313
4c956389b298db91de1c7c596d4bbd7caabae8d3,1,Vitaly Brodetskyi,2015-06-20 13:20:31+03:00,['7e414bbe30608edb217a24acf1fe706243bcdcd6'],3,68,71,20764840,3,0.388888889,0.388888889,1,20313
5be7a260b6c5899cf233794cb67393e80d435968,1,Oleg Nechiporenko,2015-06-20 16:36:00+03:00,['4c956389b298db91de1c7c596d4bbd7caabae8d3'],1,65,66,20764906,3,1,1,1,20314
f20b5fb6843a44eb7b0fba0e719d7b33e1c99ee4,0,Andrew Onishuk,2015-06-20 17:27:26+03:00,['5be7a260b6c5899cf233794cb67393e80d435968'],6,11,17,20764923,3,0,1,1,20314
7d5e419012245d135ecdf29a1fb58fadf65eecb8,1,Lisnichenko Dmitro,2015-06-20 18:07:56+03:00,['f20b5fb6843a44eb7b0fba0e719d7b33e1c99ee4'],1,27,28,20764951,2,,,,20314
b871984a628e0aeaa310695a2cb7528688e09839,1,Andrew Onishuk,2015-06-20 19:37:18+03:00,['7d5e419012245d135ecdf29a1fb58fadf65eecb8'],6,2,8,20764959,1,0,0,0.5,20314
e35b02e7d20e8831ea41cb5a672185b9cbb3c9d9,1,Myroslav Papirkovskyy,2015-06-20 15:15:24+03:00,['b871984a628e0aeaa310695a2cb7528688e09839'],104,300,404,20765363,3,0.395833333,0.708333333,0.986111111,20314
f7220786bba1af48773b0c6242ddb436b86a577f,0,Alex Antonenko,2015-06-20 23:28:24+03:00,['e35b02e7d20e8831ea41cb5a672185b9cbb3c9d9'],15,27,42,20765405,1,0.818181818,1,1,20314
e858b20bee3119fb1e97077cfd76223e3107fc11,1,tbeerbower,2015-06-20 17:12:56-04:00,['f7220786bba1af48773b0c6242ddb436b86a577f'],65,55,120,20765525,4,1,0,0.25,20314
53b4464582ea118447f1f8991269fd3caf2d2286,1,Myroslav Papirkovskyy,2015-06-21 03:41:29+03:00,['e858b20bee3119fb1e97077cfd76223e3107fc11'],300,104,404,20765929,3,0.604166667,0.291666667,0.013888889,20314
4ce1e8340cc2efd188b5d03ccd5c0462ca70552f,0,Jaimin Jetly,2015-06-20 15:42:21-07:00,['53b4464582ea118447f1f8991269fd3caf2d2286'],1,16,17,20765946,2,0.941176471,1,1,20314
482de8df4e85fb7d8fcc93026d5e0631d5484d88,0,Myroslav Papirkovskyy,2015-06-21 05:04:01+03:00,['4ce1e8340cc2efd188b5d03ccd5c0462ca70552f'],139,336,475,20766421,3,0.25170068,0.80952381,1,20314
ceaff9f1fc85c2f6335dc5891d3f6668e7b13a2c,1,Alex Antonenko,2015-06-21 02:57:51+03:00,['482de8df4e85fb7d8fcc93026d5e0631d5484d88'],0,51,51,20766472,2,0.688888889,0.688888889,1,20314
968e350259321bcdf65974e118b870583acea410,0,Alex Antonenko,2015-06-21 02:57:51+03:00,['ceaff9f1fc85c2f6335dc5891d3f6668e7b13a2c'],2,2,4,20766476,1,,,,20314
71617d03db094fd152cc478cf1a8d526a6e8d1fb,0,Myroslav Papirkovskyy,2015-06-21 11:15:08+03:00,['968e350259321bcdf65974e118b870583acea410'],2,4,6,20766482,3,0,0,1,20314
37a3d36c4aa942c9d70219fcd8b2a72fe5bd503d,0,Dmytro Sen,2015-06-21 18:03:06+03:00,['71617d03db094fd152cc478cf1a8d526a6e8d1fb'],0,2,2,20766484,1,,,,20314
957f6f19da20cc289d60b7c0efbe8a31c7cdc531,1,Andrew Onishuk,2015-06-21 19:27:27+03:00,['37a3d36c4aa942c9d70219fcd8b2a72fe5bd503d'],41,61,102,20766586,10,0,0.1,0.3,20314
bb02ff73338a41542de8cf39346cab5facad3302,1,Alejandro Fernandez,2015-06-21 10:28:36-07:00,['957f6f19da20cc289d60b7c0efbe8a31c7cdc531'],10,89,99,20766685,6,0,1,1,20314
564948ff514fb9b87a3d479c20c50a4919d70da6,1,Alex Antonenko,2015-06-21 22:40:39+03:00,['bb02ff73338a41542de8cf39346cab5facad3302'],5,5,10,20766695,2,,,,20314
d36f955bb0e597cfec17aa9c8159d07f19daced4,0,Xi Wang,2015-06-21 12:52:05-07:00,['564948ff514fb9b87a3d479c20c50a4919d70da6'],1,14,15,20766710,1,,,,20314
beb59d32b6ac84eb86d5de4dd8704e10641c5e84,1,Xi Wang,2015-06-21 12:54:13-07:00,['d36f955bb0e597cfec17aa9c8159d07f19daced4'],2,6,8,20766718,2,,,,20314
8eb5a2a644e648f16ca3b3c2acb760428a7d8c3f,0,Aleksandr Kovalenko,2015-06-21 23:35:15+03:00,['beb59d32b6ac84eb86d5de4dd8704e10641c5e84'],4,0,4,20766722,1,1,0,1,20314
03bb08558445739fc89d34932df13b34f3aa01a2,0,Alex Antonenko,2015-06-22 00:55:51+03:00,['8eb5a2a644e648f16ca3b3c2acb760428a7d8c3f'],2,2,4,20766726,2,,,,20314
161eec9fe540b725fa1c1270180c32646d488030,0,Jaimin Jetly,2015-06-21 20:36:37-07:00,['03bb08558445739fc89d34932df13b34f3aa01a2'],136,31,167,20766893,1,,,,20314
d9a315e0486a9a4f161517128a49a19659116bd0,1,Andrew Onishuk,2015-06-22 12:19:47+03:00,['161eec9fe540b725fa1c1270180c32646d488030'],13,13,26,20766919,1,,,,20314
02509318096f94afb566521d6c41afee5fc42dc4,1,Dmytro Sen,2015-06-22 12:49:10+03:00,['d9a315e0486a9a4f161517128a49a19659116bd0'],13,8,21,20766940,2,0,0,0,20314
f7492eb1df4cfcd55b33d0ee347c8a189082ffac,0,Artem Baranchuk,2015-06-22 14:21:42+03:00,['02509318096f94afb566521d6c41afee5fc42dc4'],9,0,9,20766949,1,,,,20314
533c8ee11f02759ddfc8cf394676f49d041ceff2,0,Artem Baranchuk,2015-06-22 14:21:43+03:00,['f7492eb1df4cfcd55b33d0ee347c8a189082ffac'],3,3,6,20766955,1,,,,20314
1271328c0349471c7d16590f9be469fb658a0a63,1,aBabiichuk,2015-06-22 14:22:55+03:00,['533c8ee11f02759ddfc8cf394676f49d041ceff2'],684,532,1216,20768171,12,0.45890411,0.109589041,0.02739726,20315
0212c06e4e973709727144e70c4ddec9856deb35,1,Lisnichenko Dmitro,2015-06-22 15:07:01+03:00,['1271328c0349471c7d16590f9be469fb658a0a63'],2,286,288,20768459,3,0.333333333,0.977777778,0.792592593,20317
ed341ece11a9ddbac135c1ecc764265c740a42df,0,Artem Baranchuk,2015-06-22 15:29:22+03:00,['0212c06e4e973709727144e70c4ddec9856deb35'],6,6,12,20768471,2,,,,20317
66894cb23f608d64486b0a96366e94933cefa022,1,aBabiichuk,2015-06-22 17:59:41+03:00,['ed341ece11a9ddbac135c1ecc764265c740a42df'],1,1,2,20768473,1,,,,20317
15a369bb85a8032f4ac1b1102fd261b0b1338d42,0,aBabiichuk,2015-06-22 18:02:50+03:00,['66894cb23f608d64486b0a96366e94933cefa022'],0,4,4,20768477,1,1,1,1,20317
c07374f64ef4e66ac3ce9a30e3608f3d85526529,1,aBabiichuk,2015-06-22 18:03:10+03:00,['15a369bb85a8032f4ac1b1102fd261b0b1338d42'],32,37,69,20768546,5,1,1,1,20317
116cd6e67eba27a6302e36b3b266504200f25025,1,Robert Levas,2015-06-22 11:22:55-04:00,['c07374f64ef4e66ac3ce9a30e3608f3d85526529'],44,56,100,20768646,8,0,1,1,20317
df305f47035b63d6e2877396ab600f4fe0e0226d,1,tbeerbower,2015-06-22 11:34:09-04:00,['116cd6e67eba27a6302e36b3b266504200f25025'],52,44,96,20768742,3,0,1,1,20317
8c007984bfac64643d20527edf86bc4966b6a0a8,1,aBabiichuk,2015-06-22 18:52:04+03:00,['df305f47035b63d6e2877396ab600f4fe0e0226d'],8,10,18,20768760,1,,,,20317
7b3374b275d1033c64ecfb02b578b8cf375f76d9,0,Jaimin Jetly,2015-06-22 09:13:56-07:00,['8c007984bfac64643d20527edf86bc4966b6a0a8'],0,12,12,20768772,1,,,,20317
7c42f93530725eb6a729aba34db81c53ee19291a,0,Aleksandr Kovalenko,2015-06-22 19:18:24+03:00,['7b3374b275d1033c64ecfb02b578b8cf375f76d9'],1,4,5,20768777,1,1,1,1,20317
a2d31f52458891832384608faea4cb750be68f43,1,Lisnichenko Dmitro,2015-06-22 19:40:24+03:00,['7c42f93530725eb6a729aba34db81c53ee19291a'],1,1,2,20768779,1,,,,20317
67f3ed342c38ed6bc574882ec8231394098971b0,0,aBabiichuk,2015-06-22 19:42:08+03:00,['a2d31f52458891832384608faea4cb750be68f43'],1,2,3,20768782,1,1,1,1,20317
d8724c0770618a3318e85c4c3b135671b02dcea9,1,aBabiichuk,2015-06-22 19:47:23+03:00,['67f3ed342c38ed6bc574882ec8231394098971b0'],69,252,321,20769103,11,0.803418803,1,1,20318
fc1422a7e05e2a6f7d1d9b1baa0e6d4e700b8eea,1,Dmytro Sen,2015-06-22 20:16:29+03:00,['d8724c0770618a3318e85c4c3b135671b02dcea9'],90,132,222,20769325,4,0,1,1,20318
165090d46074e14be3b260d011a40cebbd661fd4,0,Robert Levas,2015-06-22 14:03:17-04:00,['fc1422a7e05e2a6f7d1d9b1baa0e6d4e700b8eea'],11,26,37,20769362,9,,,,20318
9dc6858c03087752d011ed49fb728c63ddcf5fb3,1,Alex Antonenko,2015-06-22 21:06:03+03:00,['165090d46074e14be3b260d011a40cebbd661fd4'],1,2,3,20769365,1,,,,20318
f36ff36d030cda174c39d7b70cb1758da50af3f0,0,aBabiichuk,2015-06-22 21:11:47+03:00,['9dc6858c03087752d011ed49fb728c63ddcf5fb3'],18,16,34,20769399,2,1,0,0,20318
0dc14caec4df6c38202200c8bbf7dd71bc4843f1,0,Xi Wang,2015-06-22 11:36:35-07:00,['f36ff36d030cda174c39d7b70cb1758da50af3f0'],0,1,1,20769400,1,1,1,1,20318
e1c78f8ba14363f1c66e245e37a9b4055b10c172,0,Robert Levas,2015-06-22 15:43:36-04:00,['0dc14caec4df6c38202200c8bbf7dd71bc4843f1'],0,1,1,20769401,1,,,,20318
d43913730c571ad1edb59537fc945e85e3817359,0,Robert Levas,2015-06-22 16:56:20-04:00,['e1c78f8ba14363f1c66e245e37a9b4055b10c172'],10,0,10,20769411,1,,,,20318
ef18bc3f6a27a4ba98345dd78825054709524ae9,0,Sumit Mohanty,2015-06-22 17:43:12-07:00,['d43913730c571ad1edb59537fc945e85e3817359'],12,0,12,20769423,1,,,,20318
f97189fdc8d77ed42e18412dc4db857a084dcb7c,0,Xi Wang,2015-06-22 17:43:50-07:00,['ef18bc3f6a27a4ba98345dd78825054709524ae9'],1,1,2,20769425,1,,,,20318
06900325786572bde7ad2e935782238cac720cad,0,Andrew Onishuk,2015-06-23 11:34:39+03:00,['f97189fdc8d77ed42e18412dc4db857a084dcb7c'],2,1,3,20769428,2,1,1,0,20318
fece50c7232e2aefdfe7e04e3732e5c6ea521d57,1,Andrew Onishuk,2015-06-23 11:48:42+03:00,['06900325786572bde7ad2e935782238cac720cad'],149,162,311,20769739,8,0,1,1,20318
6c845315e1c4a5620d6b8b831b7036f86ab52714,1,Andrii Tkach,2015-06-23 15:08:21+03:00,['fece50c7232e2aefdfe7e04e3732e5c6ea521d57'],3,5,8,20769747,2,1,1,1,20318
f0d86a9140b3b17e48c73148689e4b19763a3f55,1,Dmytro Sen,2015-06-23 16:04:44+03:00,['6c845315e1c4a5620d6b8b831b7036f86ab52714'],4,68,72,20769819,5,,,,20318
405caf1ebbe251ee21af8332a63c073ecf89eb5b,0,Andrew Onishuk,2015-06-23 16:34:38+03:00,['f0d86a9140b3b17e48c73148689e4b19763a3f55'],0,1,1,20769820,1,,,,20318
0c98119f5fa09bf884e3c3ed394415bc8776fb74,1,Robert Levas,2015-06-23 10:08:44-04:00,['405caf1ebbe251ee21af8332a63c073ecf89eb5b'],1,1,2,20769822,1,,,,20318
5acc324b7f6a11e90c266d89353c84938a19becb,0,aBabiichuk,2015-06-23 17:45:29+03:00,['0c98119f5fa09bf884e3c3ed394415bc8776fb74'],1,1,2,20769824,1,,,,20318
19c85e0d3a70dbf6dba81e9bb2ddd6eef5bae25f,0,aBabiichuk,2015-06-23 17:46:59+03:00,['5acc324b7f6a11e90c266d89353c84938a19becb'],1,1,2,20769826,1,,,,20318
bd3d83fdc8dd58f56a6a5685b051d2d3818e1326,1,Andrii Tkach,2015-06-23 18:05:06+03:00,['19c85e0d3a70dbf6dba81e9bb2ddd6eef5bae25f'],8,6,14,20769840,1,,,,20318
3e1bd89b6b5c11a9f2902c4f4a844293fb29859e,0,tbeerbower,2015-06-23 11:08:00-04:00,['bd3d83fdc8dd58f56a6a5685b051d2d3818e1326'],18,7,25,20769865,2,1,0.7,0,20318
2f26e7f6fece43e3836f78d05a8609552e901305,1,aBabiichuk,2015-06-23 18:40:48+03:00,['3e1bd89b6b5c11a9f2902c4f4a844293fb29859e'],1,1,2,20769867,1,,,,20318
aa170c033452c3e331ea1e7311aa88997337845c,1,aBabiichuk,2015-06-23 18:44:46+03:00,['2f26e7f6fece43e3836f78d05a8609552e901305'],31,35,66,20769933,3,1,1,1,20318
9454bfee5a8c2498e55f336ca288cacd8d0545ac,1,Myroslav Papirkovskyy,2015-06-23 18:51:43+03:00,['aa170c033452c3e331ea1e7311aa88997337845c'],18,71,89,20770022,2,0,1,1,20318
5f9cf5a8737e8d6c1e9fb194782a44ad4c6803aa,0,aBabiichuk,2015-06-23 19:38:43+03:00,['9454bfee5a8c2498e55f336ca288cacd8d0545ac'],5,5,10,20770032,2,,,,20318
334b7c458eb92e10491e1cb021d9a6faca2e4489,0,aBabiichuk,2015-06-23 19:56:27+03:00,['5f9cf5a8737e8d6c1e9fb194782a44ad4c6803aa'],0,6,6,20770038,1,1,1,1,20318
5c3884d4021eb1b4a7161ba317ea67bc1cee8de3,1,Srimanth Gunturi,2015-06-23 10:07:35-07:00,['334b7c458eb92e10491e1cb021d9a6faca2e4489'],6,36,42,20770080,8,0.071428571,0.214285714,0.285714286,20318
d1d980f535e7b533521d6cbbca41326eed25a636,0,aBabiichuk,2015-06-23 20:22:46+03:00,['5c3884d4021eb1b4a7161ba317ea67bc1cee8de3'],1,1,2,20770082,1,,,,20318
3cd06662c01e49d41dcbeb979d4f5c92cabc48e9,1,Jayush Luniya,2015-06-23 10:49:15-07:00,['d1d980f535e7b533521d6cbbca41326eed25a636'],1,8,9,20770091,1,0,1,1,20318
7acbb8894d5b2f49470cd979550dcfcc6c13a9a9,1,Alejandro Fernandez,2015-06-23 11:20:43-07:00,['3cd06662c01e49d41dcbeb979d4f5c92cabc48e9'],69,212,281,20770372,4,0.164835165,0.351648352,0.879120879,20318
df1fc98b5ce73df2801a98ab6b1a6af0246776b0,1,Dmytro Sen,2015-06-23 22:01:03+03:00,['7acbb8894d5b2f49470cd979550dcfcc6c13a9a9'],0,12,12,20770384,1,0,0,1,20318
f7caec53675bffcde53c7adade517a9fdd4adb0f,0,Alex Antonenko,2015-06-24 00:13:25+03:00,['df1fc98b5ce73df2801a98ab6b1a6af0246776b0'],1,1,2,20770386,1,,,,20318
16d86d582440e2339fc5538ebcce1a3eb1be6cbc,1,Alex Antonenko,2015-06-24 00:13:25+03:00,['f7caec53675bffcde53c7adade517a9fdd4adb0f'],1,16,17,20770403,2,1,1,1,20318
11afa8073b64f801a0cb732da535983453127ad9,0,Alex Antonenko,2015-06-24 00:13:25+03:00,['16d86d582440e2339fc5538ebcce1a3eb1be6cbc'],1,5,6,20770409,1,1,1,1,20318
637e5ad921115c7c6e3d2f5d55c6b65921680e1a,1,Jonathan Hurley,2015-06-23 17:19:23-04:00,['11afa8073b64f801a0cb732da535983453127ad9'],6,359,365,20770774,4,0,1,1,20320
925a393b81a945c3012de992e5c7cc5f4a842751,1,tbeerbower,2015-06-23 17:26:58-04:00,['637e5ad921115c7c6e3d2f5d55c6b65921680e1a'],4,5,9,20770783,2,1,1,1,20320
cc1032ecbe22f4c7a7969c5681260c90a8c0e31e,0,Xi Wang,2015-06-23 14:34:26-07:00,['925a393b81a945c3012de992e5c7cc5f4a842751'],1,1,2,20770785,1,,,,20320
af12bc565bf8c77d028512162f4a67e9a96bd949,1,Nate Cole,2015-06-23 18:03:29-04:00,['cc1032ecbe22f4c7a7969c5681260c90a8c0e31e'],3,4,7,20770792,1,,,,20320
3ab123a109f6384f019db455f256520f4a8b85dd,1,Sumit Mohanty,2015-06-23 17:34:19-07:00,['af12bc565bf8c77d028512162f4a67e9a96bd949'],21,297,318,20771110,4,0,0.759562842,0.956284153,20320
4ef534b555514f3f0319212323218209ad95b50a,1,Oleg Nechiporenko,2015-06-24 13:00:40+03:00,['3ab123a109f6384f019db455f256520f4a8b85dd'],3,70,73,20771183,4,0.491803279,1,1,20320
81427c5288cff6200bd4798435dcd3b2e51d2dfb,1,aBabiichuk,2015-06-24 14:27:48+03:00,['4ef534b555514f3f0319212323218209ad95b50a'],5,8,13,20771196,1,1,1,1,20320
0004fd99fc47f7a7c678b13c3f4c242869d69445,0,Andrii Tkach,2015-06-24 14:34:33+03:00,['81427c5288cff6200bd4798435dcd3b2e51d2dfb'],8,11,19,20771215,2,1,1,1,20320
fe9dad662698344ebe58118a001fade4da491c79,1,Alex Antonenko,2015-06-24 15:49:37+03:00,['0004fd99fc47f7a7c678b13c3f4c242869d69445'],6,32,38,20771253,2,,,,20320
ad2c2695aa428d4d4ec4fc11cdf38e9b2f7ad199,1,Alex Antonenko,2015-06-24 15:49:37+03:00,['fe9dad662698344ebe58118a001fade4da491c79'],3,3,6,20771259,1,0,1,1,20320
185593e51bc4c184cc2598c722b0d8206a18aa86,0,aBabiichuk,2015-06-24 18:00:59+03:00,['ad2c2695aa428d4d4ec4fc11cdf38e9b2f7ad199'],0,6,6,20771265,1,1,1,1,20320
d68783254af98f0e9a5c57f171a7c335331e4544,1,Dmytro Sen,2015-06-24 18:51:04+03:00,['185593e51bc4c184cc2598c722b0d8206a18aa86'],215,373,588,20771853,16,0,0,0.962025316,20320
d998d056fcfc3de56eb9b905eb2a84075b28e291,1,Lisnichenko Dmitro,2015-06-24 19:19:24+03:00,['d68783254af98f0e9a5c57f171a7c335331e4544'],20,37,57,20771910,4,1,1,0,20320
440a45906cabb53dc8dbe289e67017a67821be6f,1,Andrew Onishuk,2015-06-24 19:55:06+03:00,['d998d056fcfc3de56eb9b905eb2a84075b28e291'],5,8,13,20771923,1,1,1,1,20320
520146e74fafd25ef552076e6aa6b38e61e87684,1,Andrew Onishuk,2015-06-24 20:13:02+03:00,['440a45906cabb53dc8dbe289e67017a67821be6f'],6,11,17,20771940,3,0,1,1,20320
8ada61e8bceb2ce5cd1eae32d8945c0d5e767658,1,Andrii Tkach,2015-06-24 20:14:17+03:00,['520146e74fafd25ef552076e6aa6b38e61e87684'],15,16,31,20771971,2,1,1,1,20320
ecb7eb740bc1cdaa976e9a1ea38fd34254f54b36,1,Sumit Mohanty,2015-06-24 10:49:38-07:00,['8ada61e8bceb2ce5cd1eae32d8945c0d5e767658'],9,11,20,20771991,1,1,1,0,20320
be85313e2048af7bde5e197ecd9d5527b02542ee,1,Srimanth Gunturi,2015-06-24 11:20:54-07:00,['ecb7eb740bc1cdaa976e9a1ea38fd34254f54b36'],82,245,327,20772318,7,0,0.959183673,1,20321
854eb46303845d542eadba398de3539631505454,0,Jayush Luniya,2015-06-24 11:35:55-07:00,['be85313e2048af7bde5e197ecd9d5527b02542ee'],3,6,9,20772327,2,0,0,1,20321
4b82c38de190bcc7fdf6a9b8e6ec4ebc4eaea132,1,Robert Levas,2015-06-24 15:04:02-04:00,['854eb46303845d542eadba398de3539631505454'],5,13,18,20772345,2,0,1,1,20321
10f7f42c74578a655a728075f23423db970a5253,1,tbeerbower,2015-06-24 15:42:17-04:00,['4b82c38de190bcc7fdf6a9b8e6ec4ebc4eaea132'],43,41,84,20772429,2,1,0,0,20321
81a55a541a5be38773f126f7e39b2516e9b81412,0,Vitaly Brodetskyi,2015-06-24 23:43:43+03:00,['10f7f42c74578a655a728075f23423db970a5253'],10,5,15,20772444,2,1,0.833333333,0,20321
24aa88020c772ea72a10a1a3f133c516a9d04e78,0,Xi Wang,2015-06-24 14:09:34-07:00,['81a55a541a5be38773f126f7e39b2516e9b81412'],1,1,2,20772446,1,,,,20321
04fb8fe35441f667dfeb16f8d2d04eddaaed9b4c,0,Yusaku Sako,2015-06-24 16:28:41-07:00,['24aa88020c772ea72a10a1a3f133c516a9d04e78'],2,6,8,20772454,2,,,,20321
41fe3e89f333b29dad03c2d152ba862bbb929e29,1,Srimanth Gunturi,2015-06-24 17:43:04-07:00,['04fb8fe35441f667dfeb16f8d2d04eddaaed9b4c'],214,1030,1244,20773698,20,0.378698225,0.447731755,0.960552268,20323
7fef71070c8c1f66f27355816a1a49b5cb441320,1,Yusaku Sako,2015-06-24 21:15:59-07:00,['41fe3e89f333b29dad03c2d152ba862bbb929e29'],6,2,8,20773706,2,,,,20323
0c358e901efdccc953f2de4ea18ffdcba487c0a3,1,Andrew Onishuk,2015-06-25 12:23:46+03:00,['7fef71070c8c1f66f27355816a1a49b5cb441320'],162,183,345,20774051,13,0,0.947368421,0.842105263,20323
095e5fbccf4d1eda22cd7f0775c1d855172154b0,1,Andrew Onishuk,2015-06-25 15:39:03+03:00,['0c358e901efdccc953f2de4ea18ffdcba487c0a3'],110,127,237,20774288,12,1,0,1,20323
25ee93a677bb235bfbfd80a9ac596ff94314c211,0,Srimanth Gunturi,2015-06-25 06:42:20-07:00,['095e5fbccf4d1eda22cd7f0775c1d855172154b0'],2,2,4,20774292,1,,,,20323
85d89c699cb357ca940d9d724b9ea7126d37175d,0,aBabiichuk,2015-06-25 17:27:11+03:00,['25ee93a677bb235bfbfd80a9ac596ff94314c211'],28,50,78,20774370,10,,,,20323
d9ecee0173f14ad3fd8da68698ef108aba2d4d10,0,Andrew Onishuk,2015-06-25 18:03:48+03:00,['85d89c699cb357ca940d9d724b9ea7126d37175d'],2,4,6,20774376,2,0,1,1,20323
287b7cfde8f261e4c83c527531eb1cbaa774523c,1,Sumit Mohanty,2015-06-25 09:03:38-07:00,['d9ecee0173f14ad3fd8da68698ef108aba2d4d10'],2,20,22,20774398,2,0,0.8,0.8,20323
85a602d105360bd00d787b43133a710b585122e2,1,Andrii Tkach,2015-06-25 19:11:51+03:00,['287b7cfde8f261e4c83c527531eb1cbaa774523c'],15,20,35,20774433,4,0.4,1,1,20323
aed83dd775e6d51452c1c9f311c8fd2d3601220b,0,Alex Antonenko,2015-06-25 19:43:23+03:00,['85a602d105360bd00d787b43133a710b585122e2'],3,39,42,20774475,3,1,1,1,20323
0f5c5e57a1be369c8173696086de0976f4243688,1,Yusaku Sako,2015-06-25 09:44:20-07:00,['aed83dd775e6d51452c1c9f311c8fd2d3601220b'],8,9,17,20774492,6,1,1,1,20323
00da4de0fe7d45a99b1236ffebfd3f1643def06d,1,Alejandro Fernandez,2015-06-25 10:10:06-07:00,['0f5c5e57a1be369c8173696086de0976f4243688'],64,202,266,20774758,17,0.25,0.225,0.6,20324
1c0e7c53090ec3fb1009f8ec1964367d2be35341,1,Robert Levas,2015-06-25 13:29:00-04:00,['00da4de0fe7d45a99b1236ffebfd3f1643def06d'],8,8,16,20774774,6,,,,20324
dfec3f348b70ae1ab0d2c7351dbde9775128e0a7,1,Dmytro Sen,2015-06-25 20:57:06+03:00,['1c0e7c53090ec3fb1009f8ec1964367d2be35341'],8,63,71,20774845,4,0.606060606,0.727272727,0.939393939,20324
bf07a967100230aec2f6ab99aae58e679012879c,1,Dmytro Sen,2015-06-25 23:09:32+03:00,['dfec3f348b70ae1ab0d2c7351dbde9775128e0a7'],0,17,17,20774862,1,0,0,1,20324
f9cefa244ed551be1bf7b97f25b6c3f430ca4be7,1,Richard Zang,2015-06-25 16:56:32-07:00,['bf07a967100230aec2f6ab99aae58e679012879c'],1,1,2,20774864,1,,,,20324
ce962b73da6c9a46e47a2382b1e9f38a32832395,0,Sumit Mohanty,2015-06-25 17:08:43-07:00,['f9cefa244ed551be1bf7b97f25b6c3f430ca4be7'],4,4,8,20774872,1,1,1,0,20324
65b59e51fcd5e941fe1e23601d104fc41828a504,1,Aleksandr Kovalenko,2015-06-26 13:26:58+03:00,['ce962b73da6c9a46e47a2382b1e9f38a32832395'],2,3,5,20774877,1,0,0,0,20324
9d833ee2ba49a20b995281ec9c9d73dd0fe51da2,0,Oleg Nechiporenko,2015-06-26 13:30:39+03:00,['65b59e51fcd5e941fe1e23601d104fc41828a504'],4,1,5,20774882,2,0,0,0,20324
08450c06ae8947c4713b04aa80295f9dddc7c624,1,aBabiichuk,2015-06-26 15:06:02+03:00,['9d833ee2ba49a20b995281ec9c9d73dd0fe51da2'],332,299,631,20775513,10,0,0.527777778,0,20325
d94a5da8fdb4da35e09aa2d00641aef18dac7520,1,Dmytro Sen,2015-06-26 16:21:34+03:00,['08450c06ae8947c4713b04aa80295f9dddc7c624'],2,6,8,20775521,1,0,0,1,20325
a9e122e85c7ab614626acb2f47b49429e484425b,0,Oleg Nechiporenko,2015-06-26 16:50:57+03:00,['d94a5da8fdb4da35e09aa2d00641aef18dac7520'],29,56,85,20775606,3,0.25,1,1,20325
4221fb9bc01511b92f9f1d66995800af4c9fbd17,1,Dmytro Sen,2015-06-26 17:02:19+03:00,['a9e122e85c7ab614626acb2f47b49429e484425b'],6,125,131,20775737,2,0.596491228,0.684210526,0.631578947,20325
95f8a0a06cf7252b2ba41c2d89650eb82488ca5d,1,Alex Antonenko,2015-06-26 17:21:55+03:00,['4221fb9bc01511b92f9f1d66995800af4c9fbd17'],1,4,5,20775742,1,0,0.75,1,20325
e01a0ba836e83bb30fba2b4611b62b72593f77f7,1,Andrii Tkach,2015-06-26 17:46:18+03:00,['95f8a0a06cf7252b2ba41c2d89650eb82488ca5d'],69,291,360,20776102,3,1,1,0.9342723,20325
c177f46577251ec32c20cee8d491d3d2a32dfa9f,0,Andrii Tkach,2015-06-26 17:46:19+03:00,['e01a0ba836e83bb30fba2b4611b62b72593f77f7'],5,67,72,20776174,2,0.484848485,1,1,20325
bc8e32e98095fd509355a3588c19ba339f916404,0,Alex Antonenko,2015-06-26 19:51:10+03:00,['c177f46577251ec32c20cee8d491d3d2a32dfa9f'],2,1,3,20776177,1,0,0,0,20325
e229e7b779edbdd10db4dae001680dbe56372409,1,Sumit Mohanty,2015-06-26 09:53:54-07:00,['bc8e32e98095fd509355a3588c19ba339f916404'],2,1,3,20776180,1,,,,20325
0376eb1a3c8dc0b73b3cb1fcc1c0a50a26deeb0f,0,aBabiichuk,2015-06-26 20:56:13+03:00,['e229e7b779edbdd10db4dae001680dbe56372409'],4,3,7,20776187,1,1,1,0,20325
0c68a6e1e02cbad10a5c66e54aebbc728f169f4b,1,Dmytro Sen,2015-06-26 21:20:31+03:00,['0376eb1a3c8dc0b73b3cb1fcc1c0a50a26deeb0f'],50,49,99,20776286,8,1,1,0,20325
6d889f0cbf87434269b8fcc1a130f61b7f8096cd,0,Jaimin Jetly,2015-06-26 13:52:40-07:00,['0c68a6e1e02cbad10a5c66e54aebbc728f169f4b'],1,0,1,20776287,1,,,,20325
4a0c4098c6476bcb6ecdc0138a619f3277c31db9,0,Alejandro Fernandez,2015-06-26 14:34:52-07:00,['6d889f0cbf87434269b8fcc1a130f61b7f8096cd'],15,1,16,20776303,1,,,,20325
e4012e95857c87b526ec2d7f6f9ebec0b6e58b35,1,Robert Levas,2015-06-26 18:10:30-04:00,['4a0c4098c6476bcb6ecdc0138a619f3277c31db9'],37,69,106,20776409,15,,,,20325
f09c555282a91646468de37a7c30449ba7221340,0,Yusaku Sako,2015-06-26 17:20:39-07:00,['e4012e95857c87b526ec2d7f6f9ebec0b6e58b35'],16,37,53,20776462,1,1,1,1,20325
ea29042edacb9c4c9f97b0fd92b877e0327147b2,1,tbeerbower,2015-06-26 21:07:47-04:00,['f09c555282a91646468de37a7c30449ba7221340'],36,53,89,20776551,2,0,0,0,20325
a394f2f7a1277da9abe576d1bf3f5ec6ba2b0c57,1,Alejandro Fernandez,2015-06-26 20:25:37-07:00,['ea29042edacb9c4c9f97b0fd92b877e0327147b2'],22,416,438,20776989,12,0.308571429,0.782857143,0.845714286,20326
7b19db6b2d2c68f13f4fcc94ac6396533c6cdf43,1,Jonathan Hurley,2015-06-27 00:45:26-04:00,['a394f2f7a1277da9abe576d1bf3f5ec6ba2b0c57'],128,149,277,20777266,8,1,0,0,20326
bdca9b676f10c3c910c2bbe4925138264fd4a529,1,Andrew Onishuk,2015-06-27 11:38:01+03:00,['7b19db6b2d2c68f13f4fcc94ac6396533c6cdf43'],47,49,96,20777362,3,,,,20326
5930dc7729719760cbdaff4d0237fc3e73a59f9c,0,Andrii Tkach,2015-06-27 13:48:41+03:00,['bdca9b676f10c3c910c2bbe4925138264fd4a529'],1,1,2,20777364,1,,,,20326
0254474a047875f87b2310f65388aafdda861671,1,Oleg Nechiporenko,2015-06-27 19:42:16+03:00,['5930dc7729719760cbdaff4d0237fc3e73a59f9c'],9,15,24,20777388,3,1,1,1,20326
d90a101c2db06d14336a39254e94fc7cf444cb07,1,Aleksandr Kovalenko,2015-06-27 21:07:48+03:00,['0254474a047875f87b2310f65388aafdda861671'],45,20,65,20777453,3,0.444444444,0.444444444,0,20326
e664553984ad2188aceabebb916622a1de52fea4,0,Alex Antonenko,2015-06-27 22:56:55+03:00,['d90a101c2db06d14336a39254e94fc7cf444cb07'],5,5,10,20777463,1,,,,20326
cd9ed4623a5084984e61583ca9a0e1c28c9464d9,0,Jaimin Jetly,2015-06-27 13:34:28-07:00,['e664553984ad2188aceabebb916622a1de52fea4'],37,16,53,20777516,1,0,0,0,20326
b079040d89e92a14dfd1ba51cda22b34f661f1e6,0,Jonathan Hurley,2015-06-27 18:38:05-04:00,['cd9ed4623a5084984e61583ca9a0e1c28c9464d9'],0,8,8,20777524,1,0,1,1,20326
036a8b779536e833d220b54acaee1a8460733c25,0,Sumit Mohanty,2015-06-27 17:32:50-07:00,['b079040d89e92a14dfd1ba51cda22b34f661f1e6'],0,24,24,20777548,1,,,,20326
64064c3f22d526855e1f2bfeaf3c67f203900866,0,Robert Levas,2015-06-28 06:53:33-04:00,['036a8b779536e833d220b54acaee1a8460733c25'],3,0,3,20777551,1,,,,20326
c1848637a466d15c59f4fae0c8ea9e7202039124,1,Andrew Onishuk,2015-06-28 18:49:16+03:00,['64064c3f22d526855e1f2bfeaf3c67f203900866'],101,101,202,20777753,46,,,,20326
1ac5c58e666d75bc6b78ecb6d0a795c308a3f296,1,Srimanth Gunturi,2015-06-28 09:34:18-07:00,['c1848637a466d15c59f4fae0c8ea9e7202039124'],8,443,451,20778204,5,0.099526066,0.492890995,0.943127962,20327
955cfce2c37f282f4600ab6b86f31c865ef4f883,1,Oleg Nechiporenko,2015-06-28 21:01:23+03:00,['1ac5c58e666d75bc6b78ecb6d0a795c308a3f296'],2,11,13,20778217,2,1,1,1,20327
cebcfdee0a9b8599d9d82a45246b658ceffa3c68,1,Sumit Mohanty,2015-06-28 11:44:34-07:00,['955cfce2c37f282f4600ab6b86f31c865ef4f883'],0,15,15,20778232,2,0,0.75,1,20327
fb32cd331ea44e1cd0c9d1ae812c6f55984a9291,1,Alex Antonenko,2015-06-28 22:41:16+03:00,['cebcfdee0a9b8599d9d82a45246b658ceffa3c68'],8,16,24,20778256,3,1,1,1,20327
434fb995c74e0f62a527f65f3ba85994d8963e11,1,Jayush Luniya,2015-06-28 16:47:21-07:00,['fb32cd331ea44e1cd0c9d1ae812c6f55984a9291'],42,60,102,20778358,7,0,0,0.631578947,20327
5e27d2a785496ca055333dad408e97f70e468dd2,1,Srimanth Gunturi,2015-06-28 19:54:07-07:00,['434fb995c74e0f62a527f65f3ba85994d8963e11'],2,2,4,20778362,2,,,,20327
f76d28bb98e89692b4b4164f3931c179072af620,1,Andrew Onishuk,2015-06-29 14:30:27+03:00,['5e27d2a785496ca055333dad408e97f70e468dd2'],4,8,12,20778374,1,0,1,1,20327
1a6ecc7b2dfc5204c39fd540e33fbcd37f6943cb,0,Nate Cole,2015-06-29 07:40:45-04:00,['f76d28bb98e89692b4b4164f3931c179072af620'],1,1,2,20778376,1,,,,20327
228f742539cf5d24328db040ac12d52c477e55a3,0,Alejandro Fernandez,2015-06-29 11:54:47-07:00,['1a6ecc7b2dfc5204c39fd540e33fbcd37f6943cb'],0,3,3,20778379,3,,,,20327
7daa93945dcfbf452e820e42c80ae9fadc282a6f,1,Alex Antonenko,2015-06-29 22:16:53+03:00,['228f742539cf5d24328db040ac12d52c477e55a3'],1,3,4,20778383,1,1,1,1,20327
5afeaea3bcf567356fbfb28c88edea41f58f00fc,1,Jonathan Hurley,2015-06-29 15:54:46-04:00,['7daa93945dcfbf452e820e42c80ae9fadc282a6f'],66,85,151,20778534,12,0,0,1,20327
841e99b05fa34e3bfa370cce6bf7c13119c76b94,1,Nate Cole,2015-06-29 16:22:41-04:00,['5afeaea3bcf567356fbfb28c88edea41f58f00fc'],19,376,395,20778929,12,0.283870968,0.55483871,0.503225806,20327
42dfdbbd0b0f5a877035babd4e17292f619881b1,1,Jaimin Jetly,2015-06-29 13:46:12-07:00,['841e99b05fa34e3bfa370cce6bf7c13119c76b94'],8,51,59,20778988,3,1,0.725,1,20327
1dd3e8f2d7b881f9c33036ff13281199808ccf32,1,Richard Zang,2015-06-29 14:17:46-07:00,['42dfdbbd0b0f5a877035babd4e17292f619881b1'],3,69,72,20779060,7,0.886792453,1,1,20327
36de6948f934c453c16a5d8fe71d2a479d4a9c71,0,Sumit Mohanty,2015-06-29 18:41:46-07:00,['1dd3e8f2d7b881f9c33036ff13281199808ccf32'],46,0,46,20779106,1,,,,20327
6f94c4fd3fecf57e553844d7f243f2ab9ab42182,1,aBabiichuk,2015-06-30 11:18:10+03:00,['36de6948f934c453c16a5d8fe71d2a479d4a9c71'],1,1,2,20779108,1,,,,20327
67f52acee027d08faf7e4ae346b080711ac7cb3d,0,Vitaly Brodetskyi,2015-06-30 15:15:58+03:00,['6f94c4fd3fecf57e553844d7f243f2ab9ab42182'],0,49,49,20779157,1,0,0,1,20327
df9c510732a8dab6bfc14936e0241683f5b0eb4e,1,tbeerbower,2015-06-30 08:35:14-04:00,['67f52acee027d08faf7e4ae346b080711ac7cb3d'],1,1,2,20779159,1,,,,20327
52520d0fb4a7bd2246928682b8468fddcb8f0737,1,Lisnichenko Dmitro,2015-06-30 16:27:41+03:00,['df9c510732a8dab6bfc14936e0241683f5b0eb4e'],785,636,1421,20780580,2,0.975757576,0.096969697,0.266666667,20327
c14454419b7948fea9e53d3589fda9e279063816,1,Andrew Onishuk,2015-06-30 16:29:14+03:00,['52520d0fb4a7bd2246928682b8468fddcb8f0737'],7,18,25,20780605,3,0,0,1,20327
6d3633c442497ba5cea407dacf0a397dd38431f7,0,Vitaly Brodetskyi,2015-06-30 16:57:42+03:00,['c14454419b7948fea9e53d3589fda9e279063816'],49,0,49,20780654,1,1,1,0,20327
83f1b62a120a42fd86aff61a0dabea4aa9b6f9d3,1,Andrii Tkach,2015-06-30 17:23:49+03:00,['6d3633c442497ba5cea407dacf0a397dd38431f7'],38,3,41,20780695,4,0.15625,0,0,20327
5882f4788e7666f3b0f00362cff06db276d75cac,0,Sumit Mohanty,2015-06-30 07:26:51-07:00,['83f1b62a120a42fd86aff61a0dabea4aa9b6f9d3'],0,1,1,20780696,1,,,,20327
5605e4ed7d5e747b387235d13de5b99de1689f6d,0,Vitaly Brodetskyi,2015-06-30 17:37:56+03:00,['5882f4788e7666f3b0f00362cff06db276d75cac'],1,3,4,20780700,1,,,,20327
65723c613c5888a909bca60ca16142bdae7304fb,1,Sumit Mohanty,2015-06-30 07:52:52-07:00,['5605e4ed7d5e747b387235d13de5b99de1689f6d'],2,166,168,20780868,4,0,0.736111111,1,20327
9b6abb57448ecc70300d3882174e28c34efd6121,1,Yusaku Sako,2015-06-30 08:26:07-07:00,['65723c613c5888a909bca60ca16142bdae7304fb'],38,74,112,20780980,4,1,1,0.066666667,20327
fa11e3c1b74979ca826ff88d2f422eb23dc39431,1,aBabiichuk,2015-06-30 18:28:24+03:00,['9b6abb57448ecc70300d3882174e28c34efd6121'],65,451,516,20781496,3,0.337696335,0.853403141,0.947643979,20327
49c049a73f7bb6895da6e77bf201cca2f7eb8598,1,Vitaly Brodetskyi,2015-06-30 19:59:24+03:00,['fa11e3c1b74979ca826ff88d2f422eb23dc39431'],1,50,51,20781547,2,0,0,1,20327
c7455ea8a1ba2d631ffae401445d6783a6acdd5d,1,Robert Levas,2015-06-30 13:16:35-04:00,['49c049a73f7bb6895da6e77bf201cca2f7eb8598'],0,5,5,20781552,1,0,0,0,20327
416f60063c94eee9f00d19ad060ef7f082990bf0,1,Alejandro Fernandez,2015-06-30 10:18:19-07:00,['c7455ea8a1ba2d631ffae401445d6783a6acdd5d'],55,82,137,20781689,4,0,0.380952381,1,20327
bf5fe282be0348ff82c592baca2a1b0daea42408,0,Dmytro Sen,2015-06-30 20:45:24+03:00,['416f60063c94eee9f00d19ad060ef7f082990bf0'],15,12,27,20781716,1,1,1,0,20327
c74443d9fb593bd0fecc3d64f92b334f7687f6b1,0,tbeerbower,2015-06-30 13:55:41-04:00,['bf5fe282be0348ff82c592baca2a1b0daea42408'],27,9,36,20781752,3,0,0,0,20327
41d7716dbf98259dcb714531f3015e9c0e2d64f3,1,Lisnichenko Dmitro,2015-06-30 20:59:47+03:00,['c74443d9fb593bd0fecc3d64f92b334f7687f6b1'],35,59,94,20781846,2,1,1,1,20327
cde963572df4f48b14fd46826d36ad3b33d96698,1,Srimanth Gunturi,2015-06-30 14:16:04-07:00,['41d7716dbf98259dcb714531f3015e9c0e2d64f3'],21,51,72,20781918,7,0,0,0,20327
7f4b94d995e35d582961cdb106c3624420197099,1,Sumit Mohanty,2015-06-30 17:11:14-07:00,['cde963572df4f48b14fd46826d36ad3b33d96698'],3,81,84,20782002,2,0.015625,0.671875,1,20327
5dd1dbd453bddb375e9b9529cfc120ef4f21a7d4,1,Srimanth Gunturi,2015-06-30 17:22:20-07:00,['7f4b94d995e35d582961cdb106c3624420197099'],60,90,150,20782152,6,0,1,0.647058824,20327
1a48a736ab19675d2652d184b7fe20397b53d785,1,Jayush Luniya,2015-06-30 18:45:35-07:00,['5dd1dbd453bddb375e9b9529cfc120ef4f21a7d4'],15,115,130,20782282,3,,,,20327
a2e9b4af4ae7a99556d473bfd36cef39a7f5f2ff,0,Andrew Onishuk,2015-07-01 12:17:11+03:00,['1a48a736ab19675d2652d184b7fe20397b53d785'],4,0,4,20782286,4,,,,20327
db1425a906e7bb10dbda11d0b831ecce9da8646f,0,Andrew Onishuk,2015-07-01 12:17:46+03:00,['a2e9b4af4ae7a99556d473bfd36cef39a7f5f2ff'],10,0,10,20782296,2,,,,20327
18443a0c6acbce73cf411b13d75678674949a9be,1,Andrew Onishuk,2015-07-01 12:18:21+03:00,['db1425a906e7bb10dbda11d0b831ecce9da8646f'],7,23,30,20782326,3,1,0,1,20327
1fefb5f157773f438837d3de6909481a98ccb8bc,1,Andrii Tkach,2015-07-01 13:29:37+03:00,['18443a0c6acbce73cf411b13d75678674949a9be'],5,22,27,20782353,2,1,1,1,20327
f17f197c914c7d661ae0953e7fd47864d1f6f24a,1,Alex Antonenko,2015-07-01 14:36:05+03:00,['1fefb5f157773f438837d3de6909481a98ccb8bc'],1,1,2,20782355,1,,,,20327
2c344cbfe2109cac23d96aad9908ecc8300606ab,1,Nate Cole,2015-07-01 08:17:23-04:00,['f17f197c914c7d661ae0953e7fd47864d1f6f24a'],0,15,15,20782370,2,0,0,1,20327
d118a57e7ac6d94775287d5268150ea3fccc83e2,1,Oleg Nechiporenko,2015-07-01 17:19:48+03:00,['2c344cbfe2109cac23d96aad9908ecc8300606ab'],3,5,8,20782378,2,,,,20327
82c5c6a183041dcbdbc46f3029937ccde8869fba,0,Aleksandr Kovalenko,2015-07-01 18:32:30+03:00,['d118a57e7ac6d94775287d5268150ea3fccc83e2'],0,2,2,20782380,1,0,0,1,20327
0498d9351cdc1a67d05edcbf8e8299244d3415d6,1,Andrew Onishuk,2015-07-01 19:45:24+03:00,['82c5c6a183041dcbdbc46f3029937ccde8869fba'],7,4,11,20782391,1,1,1,0,20327
c6dde222e7ab798f07284acd3ca8f7770cfaf9f8,1,Andrew Onishuk,2015-07-01 19:45:57+03:00,['0498d9351cdc1a67d05edcbf8e8299244d3415d6'],14,11,25,20782416,2,1,0.666666667,0.333333333,20327
ce27023f344f3e6011860c434b1f9d10932f7b67,1,Vitaly Brodetskyi,2015-07-01 20:10:43+03:00,['c6dde222e7ab798f07284acd3ca8f7770cfaf9f8'],0,382,382,20782798,3,0.419354839,0.64516129,0.935483871,20328
1148d12da1bc4716a7f50ab37ca0d15130e5fab7,1,Jonathan Hurley,2015-07-01 15:08:37-04:00,['ce27023f344f3e6011860c434b1f9d10932f7b67'],299,471,770,20783568,11,1,0.227272727,1,20329
bc848ae1f5835b184e3751d5a7d0bac6a2a40378,1,Sumit Mohanty,2015-07-01 12:36:35-07:00,['1148d12da1bc4716a7f50ab37ca0d15130e5fab7'],4,14,18,20783586,3,0,0.285714286,0.285714286,20329
f3546fc285a77b57677501176dc21e1dd419995d,1,Dmytro Sen,2015-07-02 00:12:16+03:00,['bc848ae1f5835b184e3751d5a7d0bac6a2a40378'],7,6,13,20783599,2,0,0,1,20329
dcbd7f5b75f8dc8c97155fa15ad7723f06b51988,1,Alex Antonenko,2015-07-02 03:59:33+03:00,['f3546fc285a77b57677501176dc21e1dd419995d'],12,101,113,20783712,6,0.868852459,0.868852459,1,20329
c3f8f648ec475a5c36958874fd9d62339a400764,1,Jayush Luniya,2015-07-01 21:09:35-07:00,['dcbd7f5b75f8dc8c97155fa15ad7723f06b51988'],2,114,116,20783828,2,0,0.936842105,1,20329
5590db281baf54314432494dc0033a52cb5fae00,0,Lisnichenko Dmitro,2015-07-02 11:32:53+03:00,['c3f8f648ec475a5c36958874fd9d62339a400764'],6,0,6,20783834,3,,,,20329
d6ceb5c5d0180a19941d742862b304f327bb6fd4,1,Andrew Onishuk,2015-07-02 12:11:15+03:00,['5590db281baf54314432494dc0033a52cb5fae00'],0,552,552,20784386,2,0,0.696969697,0.696969697,20330
a871dd1403f8adbad682296367ea1169f87df129,1,Andrew Onishuk,2015-07-02 15:56:18+03:00,['d6ceb5c5d0180a19941d742862b304f327bb6fd4'],0,5,5,20784391,1,0,0,0,20330
4d03e8c5b50176106a7eb6731334ae1c5c55e2ad,1,Jayush Luniya,2015-07-02 06:47:15-07:00,['a871dd1403f8adbad682296367ea1169f87df129'],12,21,33,20784424,3,0,0,0,20330
260d9d46aaa641c259316b356a2cbecbe6a0b8f4,1,Robert Levas,2015-07-02 10:32:33-04:00,['4d03e8c5b50176106a7eb6731334ae1c5c55e2ad'],0,38,38,20784462,1,0.222222222,0.222222222,0.222222222,20330
260ebef0d1f9d810a346d4e51263e4c9391a7086,1,Robert Levas,2015-07-02 11:13:40-04:00,['260d9d46aaa641c259316b356a2cbecbe6a0b8f4'],1,11,12,20784474,1,0,0,1,20330
f52b0a12adafeb3513590a4defb72cc6456b82d4,1,Vitaly Brodetskyi,2015-07-02 18:01:11+03:00,['260ebef0d1f9d810a346d4e51263e4c9391a7086'],8,21,29,20784503,1,0,0,0,20330
3fb3c48a62c61f1b6e8ba43dcac6fd925914b730,0,Lisnichenko Dmitro,2015-07-02 18:46:25+03:00,['f52b0a12adafeb3513590a4defb72cc6456b82d4'],6,185,191,20784694,10,0,1,1,20333
5ddb6c732c0573b18ab1e175617024fa448ae978,1,Vitaly Brodetskyi,2015-07-02 18:34:48+03:00,['3fb3c48a62c61f1b6e8ba43dcac6fd925914b730'],0,18,18,20784712,4,,,,20333
f5696614e2a9a75bc84ef983c84826b0565ceadf,1,Oleg Nechiporenko,2015-07-02 19:41:20+03:00,['5ddb6c732c0573b18ab1e175617024fa448ae978'],5,51,56,20784768,4,1,1,1,20333
01b1522e193a1e729da1ed0d96416f285b530274,1,Artem Baranchuk,2015-07-02 19:57:28+03:00,['f5696614e2a9a75bc84ef983c84826b0565ceadf'],6,99,105,20784873,2,0.172839506,0.086419753,1,20333
30c76ee481b59bbb3c0e23dcd13608b58f4397cb,1,Alejandro Fernandez,2015-07-02 13:24:43-07:00,['01b1522e193a1e729da1ed0d96416f285b530274'],37,312,349,20785222,4,0.5,0.6875,0,20334
b5b5817fc101dfc23542164efd298e45050e58db,0,Jaimin Jetly,2015-07-02 13:32:10-07:00,['30c76ee481b59bbb3c0e23dcd13608b58f4397cb'],1,2,3,20785225,1,0,0,1,20334
387b07a5228419cb4009e9743ea60f2a2ee2bb50,1,Dmytro Sen,2015-07-02 23:51:02+03:00,['b5b5817fc101dfc23542164efd298e45050e58db'],9,19,28,20785253,4,,,,20334
32d5e8da10775ab915a1374d86678438ed256977,1,Alejandro Fernandez,2015-07-02 14:22:20-07:00,['387b07a5228419cb4009e9743ea60f2a2ee2bb50'],8,83,91,20785344,2,0.126984127,1,0.126984127,20334
d5f7b69fc1b412d3a1b7c69ffa8bd8ee7db7738e,1,tbeerbower,2015-07-02 17:53:22-04:00,['32d5e8da10775ab915a1374d86678438ed256977'],8,7,15,20785359,1,1,1,0,20334
9a6d2abbe9537174baee2c5462b0ece807454c61,1,Jonathan Hurley,2015-07-02 19:46:05-04:00,['d5f7b69fc1b412d3a1b7c69ffa8bd8ee7db7738e'],238,247,485,20785844,5,1,0.333333333,1,20334
621759acda9f1973e079bd3d2e6b0eae3f081b48,1,Dmytro Sen,2015-07-03 10:52:37+03:00,['9a6d2abbe9537174baee2c5462b0ece807454c61'],8,8,16,20785860,4,,,,20334
b1ea08ba26dbc15f7556e8d3c8245f0561712118,0,Dmytro Sen,2015-07-03 10:57:48+03:00,['621759acda9f1973e079bd3d2e6b0eae3f081b48'],1,1,2,20785862,1,,,,20334
97a3097de695a74428839d05a08866199b492b1f,1,Dmytro Sen,2015-07-03 11:01:59+03:00,['b1ea08ba26dbc15f7556e8d3c8245f0561712118'],3,31,34,20785896,1,0.928571429,0.928571429,0.285714286,20334
0d57c45682f31edd510bcf428e0cf48e0ce66bdd,0,Vitaly Brodetskyi,2015-07-03 10:51:06+03:00,['97a3097de695a74428839d05a08866199b492b1f'],9,11,20,20785916,1,,,,20334
b7b518a9c19572d001d0d2b7b2d99e73d60146d1,0,Vitaly Brodetskyi,2015-07-03 11:26:47+03:00,['0d57c45682f31edd510bcf428e0cf48e0ce66bdd'],1,1,2,20785918,1,,,,20334
957bf2b8cf5234f9f2c42a6f928a6fedb6e88534,0,Artem Baranchuk,2015-07-03 12:54:08+03:00,['b7b518a9c19572d001d0d2b7b2d99e73d60146d1'],9,24,33,20785951,2,0,0,0,20334
6e15a5caa96416ac64cf7574e2a3e7f5f4e41375,1,Vitaly Brodetskyi,2015-07-03 12:58:10+03:00,['957bf2b8cf5234f9f2c42a6f928a6fedb6e88534'],5,1260,1265,20787216,4,0.591240876,0.299270073,0.591240876,20334
35dc8d8588f3b3f0d292e66eda270003fc03ae56,1,Nate Cole,2015-07-03 07:19:17-04:00,['6e15a5caa96416ac64cf7574e2a3e7f5f4e41375'],24,118,142,20787358,3,0,0.507936508,1,20334
b74ba518298813fd6113c62a3ec54e6f86bcfcea,0,Alex Antonenko,2015-07-03 15:12:07+03:00,['35dc8d8588f3b3f0d292e66eda270003fc03ae56'],1,6,7,20787365,1,0,0,1,20334
b613ced477a9569d507341f830917dd1525da802,1,Artem Baranchuk,2015-07-03 15:42:47+03:00,['b74ba518298813fd6113c62a3ec54e6f86bcfcea'],39,43,82,20787447,3,0,1,1,20334
3568d7176b09007ee9d500e3260b900bb31fb1d0,0,Andrew Onishuk,2015-07-03 16:43:53+03:00,['b613ced477a9569d507341f830917dd1525da802'],22,12,34,20787481,2,1,0.75,1,20334
f4456980206fbc8d522d0c083bb54bb858b646c9,1,Aleksandr Kovalenko,2015-07-03 19:41:01+03:00,['3568d7176b09007ee9d500e3260b900bb31fb1d0'],8,17,25,20787506,2,0.5,0,1,20334
5e983ba82bfa07d817f1cf97e8a5b10d369c8cc0,0,Robert Levas,2015-07-04 07:42:59-04:00,['f4456980206fbc8d522d0c083bb54bb858b646c9'],3,3,6,20787512,2,,,,20334
2c942d50f88179955ecd45c2358790a5fb7e71eb,0,Robert Levas,2015-07-04 07:57:15-04:00,['5e983ba82bfa07d817f1cf97e8a5b10d369c8cc0'],5,5,10,20787522,1,,,,20334
3ad9339b3576b5e33c8388ebc82e3c1de1ecc476,1,Andrew Onishuk,2015-07-06 14:08:46+03:00,['2c942d50f88179955ecd45c2358790a5fb7e71eb'],8,16,24,20787546,1,,,,20334
84b21baff8b2d553317af36d4310753fb08dc1c2,1,Vitaly Brodetskyi,2015-07-06 14:11:27+03:00,['3ad9339b3576b5e33c8388ebc82e3c1de1ecc476'],1,24,25,20787571,6,0.916666667,1,1,20334
f89f7913192aba0a6ef1820c380640ef9af2d494,0,Vitaly Brodetskyi,2015-07-06 15:22:50+03:00,['84b21baff8b2d553317af36d4310753fb08dc1c2'],1,3,4,20787575,1,0,0,0,20334
0f22516df8a01ab9958b8fd5f07232fc4c2f47ab,1,Andrew Onishuk,2015-07-06 15:35:22+03:00,['f89f7913192aba0a6ef1820c380640ef9af2d494'],253,506,759,20788334,47,0,1,0.197580645,20334
1c6c6a4596de24aa19557a765243b51f3ee04563,1,Andrew Onishuk,2015-07-06 16:06:53+03:00,['0f22516df8a01ab9958b8fd5f07232fc4c2f47ab'],30,29,59,20788393,4,0,1,1,20334
9c1c7f9356490f0717b491bff33c4db84d2717ba,1,Jonathan Hurley,2015-07-06 11:53:23-04:00,['1c6c6a4596de24aa19557a765243b51f3ee04563'],60,192,252,20788645,5,0,0.553398058,1,20334
b0af95f5d64d32510ea42eea00db340b4fd15423,1,Oleg Nechiporenko,2015-07-06 20:15:52+03:00,['9c1c7f9356490f0717b491bff33c4db84d2717ba'],5,26,31,20788676,1,0.555555556,0.555555556,1,20334
6adee814fc2d1add80221d3a08aa994d484751ff,1,Oleg Nechiporenko,2015-07-06 20:16:06+03:00,['b0af95f5d64d32510ea42eea00db340b4fd15423'],1,2,3,20788679,1,1,1,1,20334
2a253c056c9718e64d69b622d405efa17e69fd27,1,Jonathan Hurley,2015-07-06 16:10:12-04:00,['6adee814fc2d1add80221d3a08aa994d484751ff'],36,123,159,20788838,4,0,1,1,20334
113d6565d67c1f5d2531e1eac468fb897e798e9e,1,Jonathan Hurley,2015-07-06 16:28:57-04:00,['2a253c056c9718e64d69b622d405efa17e69fd27'],185,6,191,20789029,10,1,0,0,20334
3d78a7ef3811314ff1e16f58290e3071df196499,1,tbeerbower,2015-07-06 17:38:55-04:00,['113d6565d67c1f5d2531e1eac468fb897e798e9e'],5,71,76,20789105,2,0,0.085106383,0,20334
cc9e4599a2402d6aba501015cc79fa3775a7ce76,1,Yusaku Sako,2015-07-06 16:01:15-07:00,['3d78a7ef3811314ff1e16f58290e3071df196499'],69,3,72,20789177,7,0.113207547,0,0,20334
9b991a4a6682dba47b5d0b58aa34485e7c472ad6,1,Yusaku Sako,2015-07-06 16:15:45-07:00,['cc9e4599a2402d6aba501015cc79fa3775a7ce76'],11,20,31,20789208,2,0,0,0,20334
7763a47eb1a7f23aa015de490fd04f976cdce6c8,1,Siddharth Wagle,2015-07-06 16:49:39-07:00,['9b991a4a6682dba47b5d0b58aa34485e7c472ad6'],119,316,435,20789643,17,0.414414414,0.918918919,0,20334
96d056e26de7133426cc1f80f7edf40f84e60e27,0,Siddharth Wagle,2015-07-06 16:50:58-07:00,['7763a47eb1a7f23aa015de490fd04f976cdce6c8'],23,38,61,20789704,4,0.363636364,0.363636364,0,20334
b234664cdc22382b2605f60fdffa7c1da185b381,1,Siddharth Wagle,2015-07-06 17:20:59-07:00,['96d056e26de7133426cc1f80f7edf40f84e60e27'],0,264,264,20789968,1,,,,20335
c46d25398ea168a4e666cc380eae3b742d9cb6df,1,Andrew Onishuk,2015-07-07 11:37:14+03:00,['b234664cdc22382b2605f60fdffa7c1da185b381'],99,124,223,20790191,7,0,0.95,0.725,20335
6ca17505bb78db830ef21e169e54551110561ad0,1,Aleksandr Kovalenko,2015-07-07 14:06:33+03:00,['c46d25398ea168a4e666cc380eae3b742d9cb6df'],61,78,139,20790330,3,1,1,1,20335
9131213895c9bf9cb05023f4ffba74e21a41549e,1,Andrew Onishuk,2015-07-07 14:10:58+03:00,['6ca17505bb78db830ef21e169e54551110561ad0'],10,14,24,20790354,5,,,,20335
31159474a2f4dcc85e1808f8a5e20c138bd34c76,0,Andrew Onishuk,2015-07-07 15:49:37+03:00,['9131213895c9bf9cb05023f4ffba74e21a41549e'],0,14,14,20790368,1,0,0,1,20335
29ca92f7ab66db429814e1ec94c8c02e7b205eca,1,Oleg Nechiporenko,2015-07-07 16:09:44+03:00,['31159474a2f4dcc85e1808f8a5e20c138bd34c76'],7,11,18,20790386,4,1,1,1,20335
4ff7f4ae525b0a38e8e88a45b6eccfba8901168b,1,Vitaly Brodetskyi,2015-07-07 19:56:45+03:00,['29ca92f7ab66db429814e1ec94c8c02e7b205eca'],24,74,98,20790484,7,0.090909091,0.636363636,0.954545455,20335
0a93c2853a148d9504e2b73333ab444f7830da70,1,Siddharth Wagle,2015-07-07 10:44:45-07:00,['4ff7f4ae525b0a38e8e88a45b6eccfba8901168b'],22,2,24,20790508,2,,,,20335
2735157fa807e2fd2263a4c96b28a6baa014e6bc,0,Alejandro Fernandez,2015-07-07 10:56:38-07:00,['0a93c2853a148d9504e2b73333ab444f7830da70'],23,3,26,20790534,4,1,0.466666667,0,20335
4d71f7540a72b166711de97ed15201c7c5860632,1,Yusaku Sako,2015-07-07 11:05:01-07:00,['2735157fa807e2fd2263a4c96b28a6baa014e6bc'],41,116,157,20790691,4,1,1,1,20335
cbb80f68fbf7e7074b4f1f2b204b4bcbf0008a36,1,Nate Cole,2015-07-07 14:23:53-04:00,['4d71f7540a72b166711de97ed15201c7c5860632'],6,94,100,20790791,5,0,0.927272727,0.981818182,20335
6f2b5c2f9ca37ed5681f554da87c618c75ca9abe,1,Lisnichenko Dmitro,2015-07-07 21:44:10+03:00,['cbb80f68fbf7e7074b4f1f2b204b4bcbf0008a36'],106,717,823,20791614,4,0,1,0,20336
23cdd769ae1ef056b2afc770fea672ca4421f447,1,Srimanth Gunturi,2015-07-07 13:04:25-07:00,['6f2b5c2f9ca37ed5681f554da87c618c75ca9abe'],30,187,217,20791831,11,0.465909091,0.488636364,1,20336
26dcf89c67afc5729f4e8a89ffbec13c379a73f9,0,Richard Zang,2015-07-07 13:24:39-07:00,['23cdd769ae1ef056b2afc770fea672ca4421f447'],18,0,18,20791849,6,0,0,0,20336
7d059e7dc184b3828e1f5f5dc291a9b064dfa5cd,0,Vivek Ratnavel,2015-07-07 14:11:35-07:00,['26dcf89c67afc5729f4e8a89ffbec13c379a73f9'],3,7212,7215,20799064,23,0.528652668,0.751093613,0.732939633,20352
b800592c4e58f34acdd84ab4da4e8fedbf50a31f,0,Vivek Ratnavel,2015-07-07 14:15:29-07:00,['7d059e7dc184b3828e1f5f5dc291a9b064dfa5cd'],7212,3,7215,20806279,23,0.471347332,0.248906387,0.267060367,20352
63164d9b82655b8f6c0dee362b6c3110b1f2b007,0,Jaimin Jetly,2015-07-07 16:19:38-07:00,['b800592c4e58f34acdd84ab4da4e8fedbf50a31f'],1,21,22,20806301,1,1,1,1,20352
978fd351293f7d61184095fedffc9169afc34de7,0,Jaimin Jetly,2015-07-07 16:57:55-07:00,['63164d9b82655b8f6c0dee362b6c3110b1f2b007'],4,101,105,20806406,2,0,0.714285714,1,20352
12dbf92b8529f904ba2218f5cd307ff32600780f,1,Sumit Mohanty,2015-07-07 17:34:58-07:00,['978fd351293f7d61184095fedffc9169afc34de7'],2,12,14,20806420,2,0.857142857,1,1,20352
dc3b8d1206e4a198674481e75694a9286c2e98ec,0,Alejandro Fernandez,2015-07-07 17:43:05-07:00,['12dbf92b8529f904ba2218f5cd307ff32600780f'],1,1,2,20806422,1,,,,20352
0b20c1d3665e339c826f4821ba760c768a46e6e4,1,Srimanth Gunturi,2015-07-07 18:00:08-07:00,['dc3b8d1206e4a198674481e75694a9286c2e98ec'],13,21,34,20806456,5,1,1,1,20352
508c9d18728fc39408545f1b7a1cd446b8c573e4,0,Alejandro Fernandez,2015-07-07 19:28:25-07:00,['0b20c1d3665e339c826f4821ba760c768a46e6e4'],3,3,6,20806462,2,,,,20352
02dfbab5821bdf3114b73cceea0714504f2b4895,0,Sumit Mohanty,2015-07-07 22:05:45-07:00,['508c9d18728fc39408545f1b7a1cd446b8c573e4'],1,2,3,20806465,1,,,,20352
877141d784b6dba018ca0926abe4297ca4eae2cc,0,Andrew Onishuk,2015-07-08 12:18:34+03:00,['02dfbab5821bdf3114b73cceea0714504f2b4895'],5,5,10,20806475,2,,,,20352
b490df785e19e2c59c1c90c5b9586aaacd3163a9,1,tbeerbower,2015-07-08 08:34:50-04:00,['877141d784b6dba018ca0926abe4297ca4eae2cc'],2,100,102,20806577,2,0.244444444,0.8,1,20352
2dbad5bf4bab097a6f373e9defed03dff998ad3a,0,Andrii Tkach,2015-07-08 16:52:05+03:00,['b490df785e19e2c59c1c90c5b9586aaacd3163a9'],0,4,4,20806581,1,,,,20352
d637d5f0b114032839a2beb83b4ce5162a86058b,0,Oleg Nechiporenko,2015-07-08 17:20:12+03:00,['2dbad5bf4bab097a6f373e9defed03dff998ad3a'],8,5,13,20806594,1,1,1,0,20352
bebe23872db9cfbc666849fe589df4c7833f241e,1,Jonathan Hurley,2015-07-08 10:33:52-04:00,['d637d5f0b114032839a2beb83b4ce5162a86058b'],49,176,225,20806819,9,0.483333333,0,0.916666667,20352
cebb515d4a4109d951687d5c932fdd9af27e3b48,1,Andrew Onishuk,2015-07-08 17:48:01+03:00,['bebe23872db9cfbc666849fe589df4c7833f241e'],135,309,444,20807263,8,0,1,0.070754717,20352
601af4efb5d8053bcb2d972ce5930ab8be6f3665,1,Andrew Onishuk,2015-07-08 17:53:55+03:00,['cebb515d4a4109d951687d5c932fdd9af27e3b48'],5,9,14,20807277,5,,,,20352
197c8479301c83a36c2aa69afac4207d01f5a5e4,1,Jonathan Hurley,2015-07-08 10:59:14-04:00,['601af4efb5d8053bcb2d972ce5930ab8be6f3665'],6,21,27,20807304,1,0,1,1,20352
d881d0d98fc25b067cd9b42826a44133402ba41e,0,Artem Baranchuk,2015-07-08 18:09:49+03:00,['197c8479301c83a36c2aa69afac4207d01f5a5e4'],54,161,215,20807519,5,0,0.545454545,0.838383838,20352
27712cc8c2ecf8dbb1fa40a64fc4dfa787ad86fa,0,Vitaly Brodetskyi,2015-07-08 20:00:58+03:00,['d881d0d98fc25b067cd9b42826a44133402ba41e'],2,3,5,20807524,1,0,1,1,20352
1c7f70f8fc25b42e46470be7060f72ee310eb289,1,Siddharth Wagle,2015-07-08 10:40:45-07:00,['27712cc8c2ecf8dbb1fa40a64fc4dfa787ad86fa'],15,23,38,20807562,2,0,0,0,20352
2275ae8392432d986bcf014dca88ac0a190dab91,0,Siddharth Wagle,2015-07-08 10:41:01-07:00,['1c7f70f8fc25b42e46470be7060f72ee310eb289'],13,36,49,20807611,1,0,0,1,20352
8a31b1043e9c5bae78b2171937d7a25a1a9bfa37,1,John Speidel,2015-07-08 13:51:43-04:00,['2275ae8392432d986bcf014dca88ac0a190dab91'],2,2,4,20807615,1,,,,20352
4e201d411ac033df397cf6de8235bbdc9f209281,0,Sumit Mohanty,2015-07-08 11:12:18-07:00,['8a31b1043e9c5bae78b2171937d7a25a1a9bfa37'],7,8,15,20807630,4,,,,20352
c68bc623786bc5ec7bf1d29bcca29eb300c4cbe6,0,Jaimin Jetly,2015-07-08 11:39:42-07:00,['4e201d411ac033df397cf6de8235bbdc9f209281'],161,54,215,20807845,5,1,0.454545455,0.161616162,20352
4b97eb7791b083b0cb734fa37ec10e30333e31b2,1,Sumit Mohanty,2015-07-08 11:40:55-07:00,['c68bc623786bc5ec7bf1d29bcca29eb300c4cbe6'],244,402,646,20808491,2,0.492063492,0.492063492,0.492063492,20352
aee137f1c0f9ede614eaaec0cd8dee50c610b774,0,Siddharth Wagle,2015-07-08 12:44:53-07:00,['4b97eb7791b083b0cb734fa37ec10e30333e31b2'],11,13,24,20808515,2,0.5,0.5,0.5,20352
85f7a3f9f47c5c49d87d2d700218377a47b30dff,0,Robert Levas,2015-07-08 15:55:44-04:00,['aee137f1c0f9ede614eaaec0cd8dee50c610b774'],2,5,7,20808522,1,0,1,1,20352
a50573bc6c04c91c95700040eb842a59f5067537,1,Sumit Mohanty,2015-07-08 13:04:06-07:00,['85f7a3f9f47c5c49d87d2d700218377a47b30dff'],6,212,218,20808740,10,0,0,1,20355
cd782f9d820830768419c2a50201ab4929ca445e,0,Alejandro Fernandez,2015-07-08 13:54:21-07:00,['a50573bc6c04c91c95700040eb842a59f5067537'],0,349,349,20809089,2,,,,20357
eb323fa80c509cda8d27dd7ea098084aa3b480d4,0,Yusaku Sako,2015-07-08 14:19:35-07:00,['cd782f9d820830768419c2a50201ab4929ca445e'],1,4,5,20809094,1,1,1,1,20357
fb0ee419cfc11b4347d0a9ec43cca306ae8abafc,0,tbeerbower,2015-07-08 17:22:59-04:00,['eb323fa80c509cda8d27dd7ea098084aa3b480d4'],3,19,22,20809116,3,0,1,1,20357
ffa9f75bd87f1f8473269546d7114850aa9d2577,1,Nate Cole,2015-07-08 17:47:19-04:00,['fb0ee419cfc11b4347d0a9ec43cca306ae8abafc'],297,415,712,20809828,7,0.266666667,0,0.866666667,20357
67ce8a385ac4e3b54698cd75f51d94005993171c,0,Richard Zang,2015-07-08 15:36:31-07:00,['ffa9f75bd87f1f8473269546d7114850aa9d2577'],2,2,4,20809832,1,,,,20357
15168d296d97229b24bb0f3b32a339f4986fbed2,0,Yusaku Sako,2015-07-08 15:58:19-07:00,['67ce8a385ac4e3b54698cd75f51d94005993171c'],2,6,8,20809840,2,,,,20357
126114a96ff5b29a169c73ea2541ba3259b4a965,0,Robert Levas,2015-07-08 20:59:35-04:00,['15168d296d97229b24bb0f3b32a339f4986fbed2'],5,17,22,20809862,1,0,0,0,20357
4e2ef1e0d54043f0c4e6089d312a63c31b2b948a,1,Jonathan Hurley,2015-07-09 00:30:36-04:00,['126114a96ff5b29a169c73ea2541ba3259b4a965'],7,20,27,20809889,3,,,,20357
f46ec8df8fec7b31bee86f545655ccf85cc56de2,1,Vitaly Brodetskyi,2015-07-09 11:45:18+03:00,['4e2ef1e0d54043f0c4e6089d312a63c31b2b948a'],17,211,228,20810117,4,0.050359712,0.892086331,0.848920863,20357
f8008fcb970649aebb581ebfc3de8e36f8ff76bb,0,Andrew Onishuk,2015-07-09 13:42:04+03:00,['f46ec8df8fec7b31bee86f545655ccf85cc56de2'],0,2,2,20810119,1,,,,20357
5330972d692856c93871fabeebd47abb7cb5647f,0,Andrew Onishuk,2015-07-09 15:41:49+03:00,['f8008fcb970649aebb581ebfc3de8e36f8ff76bb'],4,4,8,20810127,1,,,,20357
e09b5c8006e5df32e64bfc5976cd0dd25c9e9267,0,Lisnichenko Dmitro,2015-07-09 17:06:41+03:00,['5330972d692856c93871fabeebd47abb7cb5647f'],0,390,390,20810517,7,0.133757962,0.757961783,1,20360
94a4adc994f9ee2f058bbb8b908d5600adb92ae9,0,Vitaly Brodetskyi,2015-07-09 17:56:12+03:00,['e09b5c8006e5df32e64bfc5976cd0dd25c9e9267'],59,57,116,20810633,7,1,1,1,20360
e9daaaa79758dd01cff3fbca693f3db2405cd5e6,1,Robert Levas,2015-07-09 11:00:52-04:00,['94a4adc994f9ee2f058bbb8b908d5600adb92ae9'],2,2,4,20810637,2,,,,20360
c952878e286ad3838757f8428b370958a8e9ebde,0,Oleg Nechiporenko,2015-07-09 18:24:32+03:00,['e9daaaa79758dd01cff3fbca693f3db2405cd5e6'],3,14,17,20810654,4,1,1,1,20360
a51accc1c5735cbade1870430af4216f0b5944da,1,Oleg Nechiporenko,2015-07-09 18:24:34+03:00,['c952878e286ad3838757f8428b370958a8e9ebde'],12,29,41,20810695,3,0,0.833333333,0.833333333,20360
bef904722a685ca3eb2c87863016399da7098a18,0,Oleg Nechiporenko,2015-07-09 18:26:48+03:00,['a51accc1c5735cbade1870430af4216f0b5944da'],3,34,37,20810732,2,1,1,1,20360
d9097096d84102150f9d5d370b3bc7aaf59b8bc6,0,aBabiichuk,2015-07-09 18:42:31+03:00,['bef904722a685ca3eb2c87863016399da7098a18'],1,1,2,20810734,1,,,,20360
cd3f63c49ee4f6fd26e34d65b201bfa435eb21cc,1,Andrew Onishuk,2015-07-09 20:27:46+03:00,['d9097096d84102150f9d5d370b3bc7aaf59b8bc6'],32,43,75,20810809,2,1,1,0.526315789,20360
757523e1f8fd0636d82ac6906c5d21df8ed700d9,0,Aleksandr Kovalenko,2015-07-09 20:43:09+03:00,['cd3f63c49ee4f6fd26e34d65b201bfa435eb21cc'],26,74,100,20810909,2,1,1,1,20360
6eedd624780965de606c64f89e0add07f131fb24,1,Srimanth Gunturi,2015-07-09 10:46:26-07:00,['757523e1f8fd0636d82ac6906c5d21df8ed700d9'],3,80,83,20810992,3,0,0.115384615,0.115384615,20360
f3e06dc214bb421096febfaf952296df1da6f9fd,1,Lisnichenko Dmitro,2015-07-09 21:11:02+03:00,['6eedd624780965de606c64f89e0add07f131fb24'],14,23,37,20811029,3,0,0,1,20360
3f9802f43552af42b5e4d0ed3f785ea5bf426afb,0,Jaimin Jetly,2015-07-09 12:36:21-07:00,['f3e06dc214bb421096febfaf952296df1da6f9fd'],4,12,16,20811045,1,1,0,1,20360
ace93eadfe6564bdda2b6d4a4a04d5c8cebb26b2,1,Xi Wang,2015-07-09 12:48:26-07:00,['3f9802f43552af42b5e4d0ed3f785ea5bf426afb'],2,7,9,20811054,2,1,1,1,20360
a74ae4a21fa45707e5e2e2c00ac2d06a9df61786,1,Siddharth Wagle,2015-07-09 13:33:00-07:00,['ace93eadfe6564bdda2b6d4a4a04d5c8cebb26b2'],6,108,114,20811168,4,0.052631579,0.947368421,0.947368421,20360
ad328948049cb75abe0579d27784e5224d863f28,0,Jonathan Hurley,2015-07-09 16:36:40-04:00,['a74ae4a21fa45707e5e2e2c00ac2d06a9df61786'],2,9,11,20811179,1,0,0,1,20360
630299fb3c03a41daea6237e9ed679216e6b00a8,1,Nate Cole,2015-07-09 17:07:00-04:00,['ad328948049cb75abe0579d27784e5224d863f28'],5,27,32,20811211,4,0.083333333,1,1,20360
ba21f89881d80de8be1256336fa6f655db02fd54,0,John Speidel,2015-07-09 19:06:45-04:00,['630299fb3c03a41daea6237e9ed679216e6b00a8'],28,21,49,20811260,2,,0,,20360
6eb0e6b16632b4ddf7f5397e4adce00852306c4b,0,Alejandro Fernandez,2015-07-09 16:30:09-07:00,['ba21f89881d80de8be1256336fa6f655db02fd54'],0,823,823,20812083,17,0.64516129,0.9390681,0.673835125,20377
23c1e93247fe91f098c13a999cc807ec74e470df,1,Yusaku Sako,2015-07-09 17:22:56-07:00,['6eb0e6b16632b4ddf7f5397e4adce00852306c4b'],57,59,116,20812199,7,0,0,0,20377
dbf9ccbbbbe49e46b3d11d5c730c484f69963241,0,Sumit Mohanty,2015-07-09 17:29:25-07:00,['23c1e93247fe91f098c13a999cc807ec74e470df'],390,0,390,20812589,7,0.866242038,0.242038217,0,20377
2c5073a43bde2708f90b510a05fd2d295fb60d38,1,Vitaly Brodetskyi,2015-07-10 14:57:07+03:00,['dbf9ccbbbbe49e46b3d11d5c730c484f69963241'],59,57,116,20812705,7,1,1,1,20377
f438398fd76741b01f39cbed3bba58aa1d9a4bc5,1,Sumit Mohanty,2015-07-10 06:26:31-07:00,['2c5073a43bde2708f90b510a05fd2d295fb60d38'],0,394,394,20813099,7,0.130434783,0.677018634,1,20380
4fbab311df79264e4bbc65e7b5d546409f0a3622,1,Andrew Onishuk,2015-07-10 18:08:28+03:00,['f438398fd76741b01f39cbed3bba58aa1d9a4bc5'],5,17,22,20813121,2,0,0.222222222,1,20380
ac4d262f4a0d15351f1eeaa6abdb8c8c2b8b81db,1,aBabiichuk,2015-07-10 18:19:22+03:00,['4fbab311df79264e4bbc65e7b5d546409f0a3622'],404,254,658,20813779,4,0.486486486,0.878378378,0.040540541,20380
8e5c54076dd859a8f9a0b2f098c3012b95243e58,1,Jonathan Hurley,2015-07-10 11:41:58-04:00,['ac4d262f4a0d15351f1eeaa6abdb8c8c2b8b81db'],0,2,2,20813781,1,,,,20380
eda2f90bbd745cebacbbb1c414c1652ba282cb3c,1,Lisnichenko Dmitro,2015-07-10 20:59:50+03:00,['8e5c54076dd859a8f9a0b2f098c3012b95243e58'],19,23,42,20813823,7,1,1,1,20380
9e4e95f54aea52c05dc471c2d5529a6b73a7f31c,1,Nate Cole,2015-07-10 14:24:37-04:00,['eda2f90bbd745cebacbbb1c414c1652ba282cb3c'],4,7,11,20813834,2,1,1,1,20380
7d0fd97cc697b22357f4c499b80b8baf9a1c1dbc,1,Jaimin Jetly,2015-07-10 12:57:38-07:00,['9e4e95f54aea52c05dc471c2d5529a6b73a7f31c'],7,27,34,20813868,2,1,0,0,20380
2f68125ea97c790d2b4dd7e65ed9343c0bdb3117,0,Srimanth Gunturi,2015-07-10 14:48:47-07:00,['7d0fd97cc697b22357f4c499b80b8baf9a1c1dbc'],0,3,3,20813871,1,1,1,1,20380
afdb7f9df508acfcc958dca15408b6356a4c0fc0,1,Jonathan Hurley,2015-07-11 01:40:37-04:00,['2f68125ea97c790d2b4dd7e65ed9343c0bdb3117'],73,172,245,20814116,8,0,0.897959184,0.204081633,20380
75b789e177191908f9750ed48f875e96fc73b631,1,Andrew Onishuk,2015-07-11 10:21:26+03:00,['afdb7f9df508acfcc958dca15408b6356a4c0fc0'],5,5,10,20814126,1,,,,20380
e43e37f07cbd5cadd239b40e5b7692ab4aa29a8e,0,Vitaly Brodetskyi,2015-07-11 11:45:32+03:00,['75b789e177191908f9750ed48f875e96fc73b631'],2,2,4,20814130,2,,,,20380
f540afa050303d6500c0f0096881848c96b4e1be,1,Vitaly Brodetskyi,2015-07-11 23:19:53+03:00,['e43e37f07cbd5cadd239b40e5b7692ab4aa29a8e'],2,74,76,20814206,3,0.053571429,0.839285714,0.946428571,20380
99c5ab3369723a1ef56783fbf8b9cea149f828a5,0,Andrew Onishuk,2015-07-12 12:01:48+03:00,['f540afa050303d6500c0f0096881848c96b4e1be'],0,1,1,20814207,1,1,1,1,20380
871b1aaa86cb248d675f1bfad9fcc85159b80be1,1,Lisnichenko Dmitro,2015-07-13 12:56:40+03:00,['99c5ab3369723a1ef56783fbf8b9cea149f828a5'],0,9,9,20814216,2,0,0.5,0.5,20380
a663dff6fe3e5fed14666cfbaeca9c62551a9a0b,1,Dmytro Sen,2015-07-13 13:12:44+03:00,['871b1aaa86cb248d675f1bfad9fcc85159b80be1'],0,4,4,20814220,1,,,,20380
8d00616b16b19506a5bd10ba9ed2b5787aae978c,1,Robert Levas,2015-07-13 09:34:57-04:00,['a663dff6fe3e5fed14666cfbaeca9c62551a9a0b'],25,775,800,20815020,8,0.24375,0.8,0.85625,20382
68caf58c661a0b15ae8bde04b1845b1ed654dc4f,0,aBabiichuk,2015-07-13 17:08:11+03:00,['8d00616b16b19506a5bd10ba9ed2b5787aae978c'],1,1,2,20815022,1,,,,20382
541a2cf577792bfc7e8d7db4a46f9fde39dec08a,0,aBabiichuk,2015-07-13 17:32:07+03:00,['68caf58c661a0b15ae8bde04b1845b1ed654dc4f'],2,2,4,20815026,1,,,,20382
9879cea4309e8673c68b18d61e0a9d103629b495,0,Aleksandr Kovalenko,2015-07-13 18:03:39+03:00,['541a2cf577792bfc7e8d7db4a46f9fde39dec08a'],51,0,51,20815077,2,0.311111111,0.311111111,0,20382
906d1517dd7784a7c1f2029c937a8ddd755f78a5,1,Dmytro Sen,2015-07-13 18:53:40+03:00,['9879cea4309e8673c68b18d61e0a9d103629b495'],1,1,2,20815079,1,,,,20382
036e7af87546f139381a259d2ef689a7879ee2ad,1,Lisnichenko Dmitro,2015-07-13 21:03:57+03:00,['906d1517dd7784a7c1f2029c937a8ddd755f78a5'],1,25,26,20815105,2,0,1,1,20382
5bda17ca13f43a1304bbaccb3ba340a6d22f3109,1,Richard Zang,2015-07-13 11:17:56-07:00,['036e7af87546f139381a259d2ef689a7879ee2ad'],2,6,8,20815113,1,1,1,1,20382
ac49cda9110ca22e32def56a83bbb6a3e3f41e12,1,Andrew Onishuk,2015-07-13 21:34:43+03:00,['5bda17ca13f43a1304bbaccb3ba340a6d22f3109'],0,35,35,20815148,2,0,0,0.9,20382
0dae8c33ea83598b922ad795fc627f052eb394f0,1,Sumit Mohanty,2015-07-13 14:34:30-07:00,['ac49cda9110ca22e32def56a83bbb6a3e3f41e12'],2,2,4,20815152,1,,,,20382
461ce541a37792f73e3fecb61a18f46d5cf30a78,1,Sumit Mohanty,2015-07-13 14:57:34-07:00,['0dae8c33ea83598b922ad795fc627f052eb394f0'],3,35,38,20815190,2,0,1,0.9,20382
798357d81e33882a5e918b0220effdc07c20d72c,1,Oleg Nechiporenko,2015-07-14 15:03:51+03:00,['461ce541a37792f73e3fecb61a18f46d5cf30a78'],40,187,227,20815417,10,0.536585366,1,0.87804878,20382
5d894952e025928d155ec2da9e17c17919bc7a38,1,Andrew Onishuk,2015-07-14 16:41:29+03:00,['798357d81e33882a5e918b0220effdc07c20d72c'],1,65,66,20815483,4,0,1,1,20383
5f095d2b244f7d5d743d7ee92aa7e4d869a9f1a9,1,Aleksandr Kovalenko,2015-07-14 16:55:05+03:00,['5d894952e025928d155ec2da9e17c17919bc7a38'],4,3,7,20815490,1,0,0,0,20383
6fddd642085a805f7c45f55e6b3f8a1434403d65,0,Andrew Onishuk,2015-07-14 19:55:31+03:00,['5f095d2b244f7d5d743d7ee92aa7e4d869a9f1a9'],2,2,4,20815494,1,,,,20383
71f80203df3c32bea91f60e84eb1c4aee37caa46,1,Alejandro Fernandez,2015-07-14 10:59:34-07:00,['6fddd642085a805f7c45f55e6b3f8a1434403d65'],339,441,780,20816274,26,0.593220339,0.525423729,0,20383
afc984538b1b7b08e8ab959860bacd010f76aac8,1,Nate Cole,2015-07-14 14:23:09-04:00,['71f80203df3c32bea91f60e84eb1c4aee37caa46'],1,97,98,20816372,4,0,0.810810811,1,20383
86b7bb55eb3a5a7bf5902698b675ebeb10f5ef2f,0,Jaimin Jetly,2015-07-14 13:26:30-07:00,['afc984538b1b7b08e8ab959860bacd010f76aac8'],0,1,1,20816373,1,,,,20383
29e5c5605e0e160e43ae57c228b16141a8bdc63b,1,Andrew Onishuk,2015-07-15 16:29:06+03:00,['86b7bb55eb3a5a7bf5902698b675ebeb10f5ef2f'],5,20,25,20816398,2,0.166666667,1,0.75,20383
1eb38c298b228a73ae5fd5127769b7b75e64f374,1,Dmytro Sen,2015-07-15 20:54:59+03:00,['29e5c5605e0e160e43ae57c228b16141a8bdc63b'],24,92,116,20816514,2,0.176470588,0.843137255,0.607843137,20383
515bcf1649134d669c12c26c7418694ec5e1655e,1,Jaimin Jetly,2015-07-15 13:02:31-07:00,['1eb38c298b228a73ae5fd5127769b7b75e64f374'],14,5,19,20816533,1,1,0,0,20383
73ef2ec032b69811234816415f5a8a501745932f,1,Sumit Mohanty,2015-07-15 13:22:12-07:00,['515bcf1649134d669c12c26c7418694ec5e1655e'],33,4,37,20816570,2,0,0.736842105,0,20383
7ccde2b51bcc0e6d0705adf97dfe8f81b7b08383,1,Alejandro Fernandez,2015-07-15 15:06:21-07:00,['73ef2ec032b69811234816415f5a8a501745932f'],2,2,4,20816574,2,,,,20383
58802fbef09c6f785f9e4c824e28078369767474,1,Lisnichenko Dmitro,2015-07-16 08:41:36+03:00,['7ccde2b51bcc0e6d0705adf97dfe8f81b7b08383'],1,15,16,20816590,2,0,0.428571429,1,20383
8ebbe8f3a83c0037477e169dbb02b13001e2a0c5,0,Lisnichenko Dmitro,2015-07-16 22:01:06+03:00,['58802fbef09c6f785f9e4c824e28078369767474'],6,6,12,20816602,1,1,1,0,20383
f6ea3c60b9c7591a43e03c851b34792ab8f866c9,1,Lisnichenko Dmitro,2015-07-16 22:01:12+03:00,['8ebbe8f3a83c0037477e169dbb02b13001e2a0c5'],3,107,110,20816712,3,0.04,0.04,0.92,20383
89b13c7e193b6456edded783778ae599ea3800b6,0,Bob Nettleton,2015-07-16 15:31:33-04:00,['f6ea3c60b9c7591a43e03c851b34792ab8f866c9'],14,15,29,20816741,4,,,,20383
a37091ee6d43e983afafb826b9f671de16b812ef,1,Richard Zang,2015-07-16 13:57:43-07:00,['89b13c7e193b6456edded783778ae599ea3800b6'],1,1,2,20816743,1,,,,20383
9d8ce4f0607203f2b2132984fde6134fb1681694,1,Sumit Mohanty,2015-07-16 17:38:18-07:00,['a37091ee6d43e983afafb826b9f671de16b812ef'],0,9,9,20816752,1,,,,20383
a56a5912ac6947ba534a75e3b43e46ae35c0cbdb,1,Jonathan Hurley,2015-07-16 23:39:56-04:00,['9d8ce4f0607203f2b2132984fde6134fb1681694'],2,58,60,20816812,3,0.444444444,1,0.555555556,20383
358dc1d8eb361480932380d8546d58b264a25c38,1,Alejandro Fernandez,2015-07-16 23:22:47-07:00,['a56a5912ac6947ba534a75e3b43e46ae35c0cbdb'],31,171,202,20817014,10,0.421875,0.671875,1,20384
002ea2f5deaf85d05d272c49ea3b1077549961e2,1,Aleksandr Kovalenko,2015-07-17 12:21:23+03:00,['358dc1d8eb361480932380d8546d58b264a25c38'],29,80,109,20817123,7,0,0.925,1,20384
306f28f550dcac464e25255ac5e5be2bf476f996,1,Andrew Onishuk,2015-07-17 15:22:30+03:00,['002ea2f5deaf85d05d272c49ea3b1077549961e2'],21,46,67,20817190,4,0.153846154,0.692307692,1,20384
ee08a07c2f49fa23966edf7d7869f593182af96b,1,Nate Cole,2015-07-17 08:26:33-04:00,['306f28f550dcac464e25255ac5e5be2bf476f996'],26,56,82,20817272,6,0,1,1,20384
1d644b457cb928d2def3dccf018fdb789d3cee21,1,Sumit Mohanty,2015-07-17 06:53:24-07:00,['ee08a07c2f49fa23966edf7d7869f593182af96b'],0,8,8,20817280,1,0,0,0,20384
36b89a16a368ff254004529d80bf003ceae523bb,1,Andrew Onishuk,2015-07-17 18:11:19+03:00,['1d644b457cb928d2def3dccf018fdb789d3cee21'],11,14,25,20817305,2,1,1,0,20384
7997bf0b53cd1e4e40e73aa443d5fdf80ba34da8,1,Myroslav Papirkovskyy,2015-07-17 22:18:26+03:00,['36b89a16a368ff254004529d80bf003ceae523bb'],0,90,90,20817395,2,,,,20385
1e81d16efa2c520384e9100c87c643bb5c0b7092,1,Mahadev Konar,2015-07-19 20:33:21-07:00,['7997bf0b53cd1e4e40e73aa443d5fdf80ba34da8'],4,4,8,20817403,1,,,,20385
7481fbbf1f14d20bada35d0298ddee11493a021e,1,Andrii Tkach,2015-07-20 16:47:30+03:00,['1e81d16efa2c520384e9100c87c643bb5c0b7092'],49,118,167,20817570,7,0.985074627,1,1,20385
305911ef834efbb22d6955d52fd266d111a2581e,0,Siddharth Wagle,2015-07-20 16:49:09-07:00,['7481fbbf1f14d20bada35d0298ddee11493a021e'],3,3,6,20817576,1,,,,20385
b951789d64e0aa617ffe7d7bbaa4b89292250375,1,Richard Zang,2015-07-20 17:10:11-07:00,['305911ef834efbb22d6955d52fd266d111a2581e'],3,561,564,20818140,8,0.270707071,0.292929293,0.557575758,20386
9848b1647c3ef08fb1d34d781296487aaa2b3762,0,Sumit Mohanty,2015-07-20 17:59:48-07:00,['b951789d64e0aa617ffe7d7bbaa4b89292250375'],1,15,16,20818156,2,,,,20386
41019f051ac8fe22a23b12c73e80477edea405e3,1,Sumit Mohanty,2015-07-20 21:58:14-07:00,['9848b1647c3ef08fb1d34d781296487aaa2b3762'],2,39,41,20818197,3,0.555555556,0.888888889,1,20386
b1add6e16336a638f1cfc12fe1f2a7a0b957df23,1,Andrew Onishuk,2015-07-21 12:45:11+03:00,['41019f051ac8fe22a23b12c73e80477edea405e3'],11,12,23,20818220,2,0,1,1,20386
6172fb8634887bba485beb7ebb2f7ff54d55e702,1,Alex Antonenko,2015-07-21 12:57:35+03:00,['b1add6e16336a638f1cfc12fe1f2a7a0b957df23'],7,31,38,20818258,2,1,1,0.909090909,20386
0cb2f9b0c09ce80a5af398e00e2fd87f2a54d89c,1,Alex Antonenko,2015-07-21 12:57:35+03:00,['6172fb8634887bba485beb7ebb2f7ff54d55e702'],0,3,3,20818261,3,,,,20386
aa16e8da2ce27bc513469f530e32d33b65b56f2c,1,Alex Antonenko,2015-07-21 12:57:35+03:00,['0cb2f9b0c09ce80a5af398e00e2fd87f2a54d89c'],1,9,10,20818271,1,0.5,1,1,20386
5dab6ca07c3deea026b2fe279d3dc2fca5817ebe,1,Vitaly Brodetskyi,2015-07-21 13:06:14+03:00,['aa16e8da2ce27bc513469f530e32d33b65b56f2c'],1751,2141,3892,20822163,2,1,0,0.333333333,20386
eddaa298295687a0e653b32b5f5894ffedbf046f,1,Vitaly Brodetskyi,2015-07-21 13:11:16+03:00,['5dab6ca07c3deea026b2fe279d3dc2fca5817ebe'],3,4,7,20822170,1,0,0,1,20386
4bdf0253c0eaee3440346f8f15d2ceb16d315714,1,Artem Baranchuk,2015-07-21 13:42:51+03:00,['eddaa298295687a0e653b32b5f5894ffedbf046f'],54,169,223,20822393,5,0,0.504672897,0.775700935,20386
4f78030c424556a1040879697dbc87c44c73459e,1,aBabiichuk,2015-07-21 13:57:43+03:00,['4bdf0253c0eaee3440346f8f15d2ceb16d315714'],957,319,1276,20823669,24,0.652892562,0.150413223,0.062809917,20386
e6ada901a63fdea3e6244e3ecc00f34f069325fa,0,aBabiichuk,2015-07-21 14:02:10+03:00,['4f78030c424556a1040879697dbc87c44c73459e'],2,1,3,20823672,1,,,,20386
78286e21aa35e13e05ecc3a552579c42842cc800,0,Robert Levas,2015-07-21 08:35:17-04:00,['e6ada901a63fdea3e6244e3ecc00f34f069325fa'],28,107,135,20823807,3,0,0.93877551,0.346938776,20386
dca90aaa2eadcbde94f45ffc005816a0db2be64a,1,Andrew Onishuk,2015-07-21 15:35:55+03:00,['78286e21aa35e13e05ecc3a552579c42842cc800'],117,41,158,20823965,6,1,0,0.94047619,20386
1472e1b09309851c2d60acbf44e644a1797ae5ea,1,Andrew Onishuk,2015-07-21 15:36:29+03:00,['dca90aaa2eadcbde94f45ffc005816a0db2be64a'],0,24,24,20823989,1,,,,20386
c0a5296759ea5e79b54535cc6808a601a3e116ba,1,Alex Antonenko,2015-07-21 17:08:11+03:00,['1472e1b09309851c2d60acbf44e644a1797ae5ea'],5,20,25,20824014,1,1,1,1,20386
82589fc4d060443a88d3709631a9f07edc11e715,0,Alex Antonenko,2015-07-21 17:24:23+03:00,['c0a5296759ea5e79b54535cc6808a601a3e116ba'],1,2,3,20824017,1,,,,20386
a30d31795e2ed830e10e6dc0cc78a9f1191cef43,0,Alex Antonenko,2015-07-21 17:34:46+03:00,['82589fc4d060443a88d3709631a9f07edc11e715'],4,4,8,20824025,2,,,,20386
e7726e44773db9d3ba506c9bdff99a1eca158b24,1,aBabiichuk,2015-07-21 17:50:08+03:00,['a30d31795e2ed830e10e6dc0cc78a9f1191cef43'],43,16,59,20824084,2,0,0,0.461538462,20386
99cac719dbcbb97f35b58be730cc3f856156f13a,1,Andrii Tkach,2015-07-21 19:39:11+03:00,['e7726e44773db9d3ba506c9bdff99a1eca158b24'],227,185,412,20824496,20,0,0,0,20386
4e2b2d8481260f1d2c06c2251b97a4105e987be7,1,Florian Barca,2015-07-21 09:40:52-07:00,['99cac719dbcbb97f35b58be730cc3f856156f13a'],277,256,533,20825029,26,0,1,0,20386
53969a5304fdba6ceb809fb90aff02b0243a1689,0,Florian Barca,2015-07-21 09:42:36-07:00,['4e2b2d8481260f1d2c06c2251b97a4105e987be7'],5,14,19,20825048,1,0,0,1,20386
fe55b9c9555f21c224c00af3ec58f1511cb084d2,1,Florian Barca,2015-07-21 09:42:36-07:00,['53969a5304fdba6ceb809fb90aff02b0243a1689'],25,78,103,20825151,24,0,1,1,20386
a541127a52622c75373493de2e6954da13e67690,1,Xi Wang,2015-07-21 11:25:05-07:00,['fe55b9c9555f21c224c00af3ec58f1511cb084d2'],4,18,22,20825173,1,,,,20386
8225cdb5b463c655b85bd80a62665086909a9e06,0,Xi Wang,2015-07-21 11:25:05-07:00,['a541127a52622c75373493de2e6954da13e67690'],2,3,5,20825178,1,,,,20386
1157dac6d1f635bb4c46e0fb98e2c8e1ec83f388,0,Xi Wang,2015-07-21 11:25:05-07:00,['8225cdb5b463c655b85bd80a62665086909a9e06'],4,4,8,20825186,3,,,,20386
81b4febe63f0f2e826664567e871a8fbebe0b9b7,1,Florian Barca,2015-07-21 11:35:31-07:00,['1157dac6d1f635bb4c46e0fb98e2c8e1ec83f388'],18,17,35,20825221,3,0,0,0,20386
fb7e4e608421e50807310bf46b2c35e5ced69bfe,1,Andrii Tkach,2015-07-21 22:30:11+03:00,['81b4febe63f0f2e826664567e871a8fbebe0b9b7'],19,17,36,20825257,2,0,0,0,20386
7839c973e9581b24a4dea37c1683aec45361b8da,1,Richard Zang,2015-07-21 12:36:01-07:00,['fb7e4e608421e50807310bf46b2c35e5ced69bfe'],494,79,573,20825830,3,0.836492891,0.829383886,0.514218009,20386
a6c86eec9b84a44665024f0727cbbdc3d69cbfba,1,Jaimin Jetly,2015-07-21 12:58:37-07:00,['7839c973e9581b24a4dea37c1683aec45361b8da'],915,843,1758,20827588,63,0,0,0.02020202,20387
1142206476aff1fdebe4ddb72b488ad40e87472e,1,Florian Barca,2015-07-21 13:00:34-07:00,['a6c86eec9b84a44665024f0727cbbdc3d69cbfba'],35,70,105,20827693,14,,,,20387
5ecdce4cea7e0eeda7e5f855d2f48f14235137c4,0,Richard Zang,2015-07-21 17:28:38-07:00,['1142206476aff1fdebe4ddb72b488ad40e87472e'],2,527,529,20828222,3,0.203991131,0.215077605,0.507760532,20388
558f64d164f02e0148e47e3d1714eb430466f437,1,Siddharth Wagle,2015-07-21 19:49:48-07:00,['5ecdce4cea7e0eeda7e5f855d2f48f14235137c4'],3,39,42,20828264,3,0.857142857,1,1,20388
145e84a7a095455d661cb3e2a53bd9203136a9bb,1,Vitaly Brodetskyi,2015-07-22 11:56:07+03:00,['558f64d164f02e0148e47e3d1714eb430466f437'],16,66,82,20828346,5,0.205882353,1,1,20388
dd25f9974887e361726c910b09899089e48c67f3,0,Alex Antonenko,2015-07-22 12:12:50+03:00,['145e84a7a095455d661cb3e2a53bd9203136a9bb'],1,1,2,20828348,1,,,,20388
9f7a9c805fa33fe145d8f3392223bce079a4da82,0,Alex Antonenko,2015-07-22 12:12:50+03:00,['dd25f9974887e361726c910b09899089e48c67f3'],0,7,7,20828355,2,,,,20388
215d27b95ee13671683da437ffb5c1f805c92127,1,Andrew Onishuk,2015-07-22 12:18:08+03:00,['9f7a9c805fa33fe145d8f3392223bce079a4da82'],0,36,36,20828391,1,,,,20388
8d1eed848f601bb8d0fc58efba5e529d5458c55b,1,aBabiichuk,2015-07-22 13:08:57+03:00,['215d27b95ee13671683da437ffb5c1f805c92127'],4,16,20,20828411,3,1,1,1,20388
4b05497f8a02945fe7cba039c32a56eccc487980,0,Andrii Tkach,2015-07-22 13:27:53+03:00,['8d1eed848f601bb8d0fc58efba5e529d5458c55b'],1,3,4,20828415,1,1,1,1,20388
469ca00e4958421a1f9a8201fee3e1588d92ae44,1,Aleksandr Kovalenko,2015-07-22 13:28:09+03:00,['4b05497f8a02945fe7cba039c32a56eccc487980'],68,32,100,20828515,4,0,0,0,20388
7f3bd6692b6256ed576f1e0113b06a46e3b15537,1,Alex Antonenko,2015-07-22 14:23:02+03:00,['469ca00e4958421a1f9a8201fee3e1588d92ae44'],9,99,108,20828623,3,0.342857143,1,0.814285714,20388
43f2ef9aabcf2d3537db5d4298bf28f0b56e5d7d,1,Aleksandr Kovalenko,2015-07-22 15:04:12+03:00,['7f3bd6692b6256ed576f1e0113b06a46e3b15537'],3,7,10,20828633,2,1,1,1,20388
81bfa8c6743ff44156d9eff595fca5fcd4b6b305,0,Andrew Onishuk,2015-07-22 15:22:48+03:00,['43f2ef9aabcf2d3537db5d4298bf28f0b56e5d7d'],1,2,3,20828636,1,,,,20388
2605a8450aef54a387cd651432db944c96dd8b8f,1,Alex Antonenko,2015-07-22 17:02:22+03:00,['81bfa8c6743ff44156d9eff595fca5fcd4b6b305'],13,80,93,20828729,3,0.292307692,1,1,20388
c3017b90f12894916128b31ffdce6516d3be8beb,1,Alex Antonenko,2015-07-22 17:02:22+03:00,['2605a8450aef54a387cd651432db944c96dd8b8f'],4,24,28,20828757,5,1,1,1,20388
b3fd502c6c067ffbbb3bc3a14c1399dcaff574cc,1,Alex Antonenko,2015-07-22 17:02:22+03:00,['c3017b90f12894916128b31ffdce6516d3be8beb'],5,166,171,20828928,4,0.275641026,0.935897436,1,20388
b0a28fecee2867e70fd8237499ec4635bde4333b,1,Lisnichenko Dmitro,2015-07-22 17:07:43+03:00,['b3fd502c6c067ffbbb3bc3a14c1399dcaff574cc'],28,39,67,20828995,4,0,1,1,20388
497eed3b214b23501d7ffe825096b1e56accd8e8,1,Alex Antonenko,2015-07-22 19:00:24+03:00,['b0a28fecee2867e70fd8237499ec4635bde4333b'],10,93,103,20829098,3,1,1,1,20388
f89a93ebb2ce95894c12b50d5b5c9e5311032dc2,0,Alex Antonenko,2015-07-22 19:44:51+03:00,['497eed3b214b23501d7ffe825096b1e56accd8e8'],0,1,1,20829099,1,1,1,1,20388
3f5d39da0f298a8bc1bbd36a46f815d1f00b3f01,1,Aleksandr Kovalenko,2015-07-22 20:40:09+03:00,['f89a93ebb2ce95894c12b50d5b5c9e5311032dc2'],0,1,1,20829100,1,1,1,1,20388
3a59642b4caaaef5a6d5df990b2b5b64a92fa21a,1,Alex Antonenko,2015-07-22 22:43:10+03:00,['3f5d39da0f298a8bc1bbd36a46f815d1f00b3f01'],13,72,85,20829185,4,1,1,1,20388
b5c303ac5a0749c69914eae8b99607304cbbb444,0,Alejandro Fernandez,2015-07-22 13:10:15-07:00,['3a59642b4caaaef5a6d5df990b2b5b64a92fa21a'],0,1,1,20829186,1,,,,20388
e39eca7e06d8c8b06df86e7c18dbdccead207e19,1,Florian Barca,2015-07-22 13:35:54-07:00,['b5c303ac5a0749c69914eae8b99607304cbbb444'],17,53,70,20829256,4,0.470588235,0,0.470588235,20388
cb0ef79427bf408a2fa800473e17815b9fec58ec,1,Alejandro Fernandez,2015-07-22 13:43:32-07:00,['e39eca7e06d8c8b06df86e7c18dbdccead207e19'],36,58,94,20829350,6,0,0,1,20388
76598b7e13fc369233992fb3ca92e460d5be3076,0,Jaimin Jetly,2015-07-22 14:02:24-07:00,['cb0ef79427bf408a2fa800473e17815b9fec58ec'],1,0,1,20829351,1,1,0,0,20388
0e01ff15e51073a6e2cbebf1f4e988cbacca5d6a,1,Alejandro Fernandez,2015-07-22 14:06:39-07:00,['76598b7e13fc369233992fb3ca92e460d5be3076'],0,1,1,20829352,1,,,,20388
6728797f059bcf1c66a2fb0923e73d46e5a7d334,1,Sumit Mohanty,2015-07-22 14:31:31-07:00,['0e01ff15e51073a6e2cbebf1f4e988cbacca5d6a'],3,21,24,20829376,2,0,0.230769231,1,20388
47879c7ca3e78617b156bc3c7608f3b6b3a5cabc,1,Alex Antonenko,2015-07-23 12:11:36+03:00,['6728797f059bcf1c66a2fb0923e73d46e5a7d334'],1,19,20,20829396,1,1,1,1,20388
097fffa34517d100fa42c0ba5edaef0a214c283d,1,Andrew Onishuk,2015-07-23 13:49:24+03:00,['47879c7ca3e78617b156bc3c7608f3b6b3a5cabc'],5,15,20,20829416,3,0.25,1,1,20388
b8d2b2b64e492ea6d7b93c03c3abade3f6a4ce05,1,aBabiichuk,2015-07-23 15:20:42+03:00,['097fffa34517d100fa42c0ba5edaef0a214c283d'],147,53,200,20829616,7,1,0,0.939393939,20388
8e9f5e8dacf7db67daea2b8a95d80c5bec36ac18,1,Nate Cole,2015-07-23 09:00:48-04:00,['b8d2b2b64e492ea6d7b93c03c3abade3f6a4ce05'],419,660,1079,20830695,23,1,0,1,20390
cc03263ee64cfff77259d3c64e825c90d1aced9e,1,Vitaly Brodetskyi,2015-07-23 18:09:10+03:00,['8e9f5e8dacf7db67daea2b8a95d80c5bec36ac18'],2,61,63,20830758,2,0,0.617647059,0.382352941,20390
6b7e7bc022efc87a104b8de38baf8669fc55962f,1,Dmytro Sen,2015-07-23 19:02:42+03:00,['cc03263ee64cfff77259d3c64e825c90d1aced9e'],8,176,184,20830942,4,0.2,0.317241379,0.751724138,20390
53b0b57ff6b94dce92e699b8d28005386fae1976,1,Nate Cole,2015-07-23 15:37:56-04:00,['6b7e7bc022efc87a104b8de38baf8669fc55962f'],8,248,256,20831198,2,0.02020202,0.984848485,0,20390
a81df332bf6bafa3ebd6bfec91a4670a10197fa1,1,Xi Wang,2015-07-23 14:13:41-07:00,['53b0b57ff6b94dce92e699b8d28005386fae1976'],1,2,3,20831201,1,,,,20390
578a35c80787d914c784bf94075e43b58bc4d388,1,Xi Wang,2015-07-23 14:13:42-07:00,['a81df332bf6bafa3ebd6bfec91a4670a10197fa1'],1,1,2,20831203,1,,,,20390
9ce140c0cab3594c66508f300dabd485c466e979,1,Alejandro Fernandez,2015-07-23 15:28:04-07:00,['578a35c80787d914c784bf94075e43b58bc4d388'],0,6,6,20831209,1,,,,20390
a49c214ada0c1cf922b222e6910fe80c9cc8df21,0,Lisnichenko Dmitro,2015-07-24 10:51:01+03:00,['9ce140c0cab3594c66508f300dabd485c466e979'],1,0,1,20831210,1,,,,20390
e58c811b65dc5a08099779d84558e7ce52dc37b3,0,Aleksandr Kovalenko,2015-07-24 14:14:08+03:00,['a49c214ada0c1cf922b222e6910fe80c9cc8df21'],2,14,16,20831226,2,0.5,0.75,1,20390
f2bafc2b25f6995000220c68e2cdcfb526d5c2da,1,Robert Levas,2015-07-24 07:58:41-04:00,['e58c811b65dc5a08099779d84558e7ce52dc37b3'],72,750,822,20832048,18,0.336842105,0.964912281,0.922807018,20392
35ba887db26bc9e5a4e8f8857052f34232f6c98e,0,Andrew Onishuk,2015-07-24 17:42:08+03:00,['f2bafc2b25f6995000220c68e2cdcfb526d5c2da'],1,5,6,20832054,1,0,0,1,20392
b02319d46344c43416a52c0c777eb39ec73d8190,1,aBabiichuk,2015-07-24 18:22:29+03:00,['35ba887db26bc9e5a4e8f8857052f34232f6c98e'],2,2,4,20832058,2,,,,20392
8e0d9d5b2a2892994faeb669cb69eeead3b47834,1,Aleksandr Kovalenko,2015-07-24 19:01:39+03:00,['b02319d46344c43416a52c0c777eb39ec73d8190'],1,2,3,20832061,1,1,1,1,20392
7c12637cbb1aaec53a600c420b8d731044bc6ba5,1,Lisnichenko Dmitro,2015-07-24 19:10:04+03:00,['8e0d9d5b2a2892994faeb669cb69eeead3b47834'],8,10,18,20832079,3,0,1,1,20392
768bcdaf471a75280997114a668846fca173f87f,1,aBabiichuk,2015-07-24 20:42:24+03:00,['7c12637cbb1aaec53a600c420b8d731044bc6ba5'],3,33,36,20832115,3,0.72,0.76,1,20392
17ac0d69d01366f2cfd376de23c1e6b8b61cd670,0,Dmytro Sen,2015-07-24 20:58:37+03:00,['768bcdaf471a75280997114a668846fca173f87f'],3,25,28,20832143,2,0,0,0.529411765,20392
03a927ddb2fca9c2984e554361ff98cd0fc1f8b0,1,Florian Barca,2015-07-24 11:03:38-07:00,['17ac0d69d01366f2cfd376de23c1e6b8b61cd670'],399,1857,2256,20834399,21,0.227524972,0.89900111,0.395116537,20392
868bd1c5a17099e7d8248f29797096688d1941b8,0,Dmytro Sen,2015-07-24 21:12:09+03:00,['03a927ddb2fca9c2984e554361ff98cd0fc1f8b0'],5,7,12,20834411,3,,,,20392
274b836677bbc83948eb3f9e20e257b55bcdccb2,1,Jonathan Hurley,2015-07-24 15:43:00-04:00,['868bd1c5a17099e7d8248f29797096688d1941b8'],210,558,768,20835179,14,0.480314961,0.881889764,0.834645669,20393
fc15fdef2deb64d241e693dc772acc498724168d,1,Jaimin Jetly,2015-07-24 12:57:59-07:00,['274b836677bbc83948eb3f9e20e257b55bcdccb2'],2,5,7,20835186,1,0.75,1,1,20393
8388c7d0607e0010831e02acf6ad24e88fbb5f41,1,Bob Nettleton,2015-07-24 17:14:30-04:00,['fc15fdef2deb64d241e693dc772acc498724168d'],33,214,247,20835433,7,0,0.606557377,0.245901639,20393
6b3009397acbd701a2216c24d9bda53f11e528b0,1,Jayush Luniya,2015-07-26 06:49:03-07:00,['8388c7d0607e0010831e02acf6ad24e88fbb5f41'],29,63,92,20835525,11,,,,20393
808eef457d71bffeaf1d6c496c2b33a614a35aab,0,Richard Zang,2015-07-26 22:56:33-07:00,['6b3009397acbd701a2216c24d9bda53f11e528b0'],1,1,2,20835527,1,,,,20393
bdcdb4b99f500bc6b6a0ff1f4a268066a13383e1,1,Lisnichenko Dmitro,2015-07-27 11:47:25+03:00,['808eef457d71bffeaf1d6c496c2b33a614a35aab'],1,33,34,20835561,2,0,1,1,20393
819ab1049fbe57bd12e94331e0823a5c153e7a78,1,Dmytro Sen,2015-07-27 13:16:56+03:00,['bdcdb4b99f500bc6b6a0ff1f4a268066a13383e1'],8,14,22,20835583,3,0,0.5,0.5,20393
01054f76df4fafc44cfb1b326e74f7d645a2788f,1,Vitaly Brodetskyi,2015-07-27 13:21:38+03:00,['819ab1049fbe57bd12e94331e0823a5c153e7a78'],2,11,13,20835596,3,0,0,0,20393
7d275300f40d3b8cbbd8d3401df974a2f1ff50e0,1,aBabiichuk,2015-07-27 13:29:45+03:00,['01054f76df4fafc44cfb1b326e74f7d645a2788f'],147,51,198,20835794,4,0,0,0,20393
4b8fab60a156bfbac4bcf6d7978ce5b277439be3,0,aBabiichuk,2015-07-27 14:07:08+03:00,['7d275300f40d3b8cbbd8d3401df974a2f1ff50e0'],0,1,1,20835795,1,1,1,1,20393
60125aac5f1670be6fe331e8f3e4610faec32317,1,Alex Antonenko,2015-07-27 14:19:59+03:00,['4b8fab60a156bfbac4bcf6d7978ce5b277439be3'],1,7,8,20835803,3,1,1,1,20393
26d99f5724f51d268a081e7c5d32af5fa6964e78,0,Alex Antonenko,2015-07-27 15:52:51+03:00,['60125aac5f1670be6fe331e8f3e4610faec32317'],5,10,15,20835818,2,1,1,0.666666667,20393
0da69f466b30673dab6604771fa37c0a436eaed5,0,Aleksandr Kovalenko,2015-07-27 15:55:32+03:00,['26d99f5724f51d268a081e7c5d32af5fa6964e78'],1,1,2,20835820,1,,,,20393
aa66a3e9b38bbbe0fd96cc2a11b69ec50466bd6f,0,Andrew Onishuk,2015-07-27 18:31:24+03:00,['0da69f466b30673dab6604771fa37c0a436eaed5'],17,18,35,20835855,1,1,1,1,20393
b18f486bd6d5324aba8ee0abbeba3f3bb384e4ba,0,Aleksandr Kovalenko,2015-07-27 19:25:44+03:00,['aa66a3e9b38bbbe0fd96cc2a11b69ec50466bd6f'],1,1,2,20835857,1,,,,20393
892ef84772c3b096ec24da94050a79966e0d6c33,1,Aleksandr Kovalenko,2015-07-27 19:28:28+03:00,['b18f486bd6d5324aba8ee0abbeba3f3bb384e4ba'],2,13,15,20835872,3,1,0,1,20393
71d34fe28e0305a912d041ce86119b15fb8baa8d,0,Florian Barca,2015-07-27 09:45:50-07:00,['892ef84772c3b096ec24da94050a79966e0d6c33'],1,1,2,20835874,1,,,,20393
e8f27c332078892b4eeaf07a5d4d55ec801c2650,1,Alex Antonenko,2015-07-27 20:08:22+03:00,['71d34fe28e0305a912d041ce86119b15fb8baa8d'],27,29,56,20835930,3,,,,20393
c2f10d57c0e6912acb346a46b342c9495884345f,1,Dmytro Sen,2015-07-28 11:20:50+03:00,['e8f27c332078892b4eeaf07a5d4d55ec801c2650'],4,25,29,20835959,1,0.733333333,1,1,20393
0144f793c5dfc1fac54a8bcb39e787b605e676fe,1,Andrew Onishuk,2015-07-28 15:09:27+03:00,['c2f10d57c0e6912acb346a46b342c9495884345f'],2,64,66,20836025,3,0,0,0,20394
bcb8255c2ee41452bd871859fe35b8ac8fc5b84d,0,Aleksandr Kovalenko,2015-07-28 15:22:22+03:00,['0144f793c5dfc1fac54a8bcb39e787b605e676fe'],1,1,2,20836027,1,,,,20394
d43ea4d6731cc002d4ddbba16b979804181e1eef,1,Lisnichenko Dmitro,2015-07-28 15:30:18+03:00,['bcb8255c2ee41452bd871859fe35b8ac8fc5b84d'],187,236,423,20836450,11,0.130434783,0.782608696,1,20394
f97945c9f441882094734b01a41726767249bb56,1,Andrew Onishuk,2015-07-28 15:51:01+03:00,['d43ea4d6731cc002d4ddbba16b979804181e1eef'],3,13,16,20836466,1,1,1,1,20394
be911fe762d823e7c0b3f50c634f706dbff5de60,1,Vitaly Brodetskyi,2015-07-28 16:18:33+03:00,['f97945c9f441882094734b01a41726767249bb56'],0,1088,1088,20837554,1,,,,20395
3411efbc55017c4947ee494faaa05270aaecee4f,0,Dmytro Sen,2015-07-28 16:21:37+03:00,['be911fe762d823e7c0b3f50c634f706dbff5de60'],30,83,113,20837667,5,0,0.866666667,1,20395
2f585817cf6da90b0ff43a639747d4354fd25a27,0,Alex Antonenko,2015-07-28 17:05:51+03:00,['3411efbc55017c4947ee494faaa05270aaecee4f'],2,2,4,20837671,1,,,,20395
a0fc2a1bb6e6f5c92ed2fc6df385c284a00cc519,1,Aleksandr Kovalenko,2015-07-28 17:49:10+03:00,['2f585817cf6da90b0ff43a639747d4354fd25a27'],0,1,1,20837672,1,0,1,1,20395
7841f25b0db368f88913d6e48b00a297d2c688b9,1,Alejandro Fernandez,2015-07-28 11:22:47-07:00,['a0fc2a1bb6e6f5c92ed2fc6df385c284a00cc519'],25,34,59,20837731,6,,,0,20395
02a7bcc1739ec325122cc80425c2233fb0d3d030,1,Bob Nettleton,2015-07-28 16:07:30-04:00,['7841f25b0db368f88913d6e48b00a297d2c688b9'],4,82,86,20837817,5,0,0.363636364,0.618181818,20395
6346d821a943a6f0be6ea213e749fce49a186bb0,0,Alex Antonenko,2015-07-28 23:44:34+03:00,['02a7bcc1739ec325122cc80425c2233fb0d3d030'],3,1,4,20837821,1,1,1,0,20395
9693916ddc013bc9635d6b49e5f39916cf760f4a,0,Xi Wang,2015-07-28 14:25:13-07:00,['6346d821a943a6f0be6ea213e749fce49a186bb0'],184,1234,1418,20839239,13,0.56779661,0.813559322,0.550847458,20396
ff7be869d8bc39d1370a9cdacca9c4259b51dc5d,0,Xi Wang,2015-07-28 14:36:48-07:00,['9693916ddc013bc9635d6b49e5f39916cf760f4a'],1,0,1,20839240,1,1,0,0,20396
4c27db62466b08962ee6b9dae44cac2fd22a3c8f,0,Andrew Onishuk,2015-07-29 13:52:26+03:00,['ff7be869d8bc39d1370a9cdacca9c4259b51dc5d'],0,77,77,20839317,9,0.090909091,0.295454545,1,20396
204dc8ddf8aaccbd6518112620fb1de9eb1187b6,1,aBabiichuk,2015-07-29 14:05:17+03:00,['4c27db62466b08962ee6b9dae44cac2fd22a3c8f'],225,1,226,20839543,4,0.33,0.31,0.02,20396
2c0f8087856e192680a398d56723d4ec0b79ad15,1,Alex Antonenko,2015-07-29 16:33:55+03:00,['204dc8ddf8aaccbd6518112620fb1de9eb1187b6'],6,31,37,20839580,3,0,0.613636364,1,20396
15d1ada7070e15c297f764be3e9cbac84b07f9b7,0,Aleksandr Kovalenko,2015-07-29 17:41:42+03:00,['2c0f8087856e192680a398d56723d4ec0b79ad15'],0,4,4,20839584,1,1,1,1,20396
c4078c650947c3235c91d7457f8404be5dc056b5,1,Andrew Onishuk,2015-07-29 19:23:03+03:00,['15d1ada7070e15c297f764be3e9cbac84b07f9b7'],0,1322,1322,20840906,25,,,,20421
8bd16add847833a54e8efc6681700b77f569531a,1,Jayush Luniya,2015-07-29 09:42:26-07:00,['c4078c650947c3235c91d7457f8404be5dc056b5'],9,56,65,20840971,3,0,0.466666667,1,20421
1d524a7f24c5f319308cfb2b7ebd02d6c51e4586,1,Alex Antonenko,2015-07-29 20:22:42+03:00,['8bd16add847833a54e8efc6681700b77f569531a'],5,14,19,20840990,2,0,0,1,20421
f6dfbf41d44a736faafc7ef7f7d2e88e25246632,0,Alex Antonenko,2015-07-29 20:55:40+03:00,['1d524a7f24c5f319308cfb2b7ebd02d6c51e4586'],1,0,1,20840991,1,,,,20421
2de5d2b4b89a7e1dce226c9b504fdeeaa76a02c0,0,Sumit Mohanty,2015-07-29 14:43:21-07:00,['f6dfbf41d44a736faafc7ef7f7d2e88e25246632'],4,0,4,20840995,1,,,,20421
2064878209d86ae97554515c3f714d4b9453a3bc,1,Jaimin Jetly,2015-07-29 17:09:30-07:00,['2de5d2b4b89a7e1dce226c9b504fdeeaa76a02c0'],2160,742,2902,20843897,62,1,1,0,20421
5ed0f4267a4ceb79ff0c4767216981d9aaace126,0,Xi Wang,2015-07-29 17:23:21-07:00,['2064878209d86ae97554515c3f714d4b9453a3bc'],1,1,2,20843899,1,,,,20421
b46db5d554e0f1da216c488b58247efc8d7df235,0,aBabiichuk,2015-07-30 15:10:45+03:00,['5ed0f4267a4ceb79ff0c4767216981d9aaace126'],8,1,9,20843908,1,0,0,0,20421
9552b8649804981adc99a4223210d79c34175b48,1,Aleksandr Kovalenko,2015-07-30 17:15:41+03:00,['b46db5d554e0f1da216c488b58247efc8d7df235'],40,3,43,20843951,6,0.2,0,0,20421
a1e0caedd0acc5da52048286efd39f9d5a02ab59,1,Andrii Tkach,2015-07-30 18:27:14+03:00,['9552b8649804981adc99a4223210d79c34175b48'],12,83,95,20844046,4,1,1,1,20421
9e7d0d51893713a9a823ae66f54e80a389c16fe1,1,Alex Antonenko,2015-07-30 18:31:46+03:00,['a1e0caedd0acc5da52048286efd39f9d5a02ab59'],16,228,244,20844290,6,0.229946524,1,1,20421
4728e31679dff2f73279667173b2ca9c87abb513,1,Alex Antonenko,2015-07-30 18:31:46+03:00,['9e7d0d51893713a9a823ae66f54e80a389c16fe1'],55,79,134,20844424,5,1,1,1,20421
178db9fc96d76231ef6449132fc8b1bda3c01999,0,Alex Antonenko,2015-07-30 18:31:46+03:00,['4728e31679dff2f73279667173b2ca9c87abb513'],8,102,110,20844534,6,0.647887324,0.971830986,1,20422
b478d70c0319c9d64297ad1cb5b41e12bc48176f,1,Xi Wang,2015-07-30 15:34:31-07:00,['178db9fc96d76231ef6449132fc8b1bda3c01999'],1243,184,1427,20845961,13,0.430016863,0.18549747,0.44688027,20422
6b3431c2021852b43e09defdd419f0e8ad97dd6c,1,Jaimin Jetly,2015-07-30 16:20:49-07:00,['b478d70c0319c9d64297ad1cb5b41e12bc48176f'],102,8,110,20846071,6,0.352112676,0.028169014,0,20422
7ce1d7a16d00a4426691d781538e9b1f25f73722,1,Jaimin Jetly,2015-07-30 16:47:58-07:00,['6b3431c2021852b43e09defdd419f0e8ad97dd6c'],0,11,11,20846082,1,1,1,1,20422
3287763cade0d8e7c0ce008b9baca64257e840b7,0,Siddharth Wagle,2015-07-30 16:48:59-07:00,['7ce1d7a16d00a4426691d781538e9b1f25f73722'],0,18,18,20846100,1,,,,20422
327519cde317ef97c8abe90b30b22e748219c773,1,Sumit Mohanty,2015-07-30 17:46:27-07:00,['3287763cade0d8e7c0ce008b9baca64257e840b7'],2,16,18,20846118,2,0.153846154,1,1,20422
d8921d38cb6d1244c48b5e96511d64c8fc6f6e08,1,Andrew Onishuk,2015-07-31 11:26:38+03:00,['327519cde317ef97c8abe90b30b22e748219c773'],4,4,8,20846126,1,,,,20422
bcf15099dd36acd4c0be8e19b27b436044357b9b,1,aBabiichuk,2015-07-31 12:37:03+03:00,['d8921d38cb6d1244c48b5e96511d64c8fc6f6e08'],33,31,64,20846190,4,1,1,1,20422
eee2a7a8807982b71163a54f097f815fa9cb2eb9,1,aBabiichuk,2015-07-31 13:13:39+03:00,['bcf15099dd36acd4c0be8e19b27b436044357b9b'],7,10,17,20846207,3,1,1,1,20422
3a4d890351e63031faafa235d647edbb8076bfff,0,Andrew Onishuk,2015-07-31 13:51:36+03:00,['eee2a7a8807982b71163a54f097f815fa9cb2eb9'],3,2,5,20846212,1,,,,20422
dde648d7c42eb3bf0fd47f418c916cd9ee341e91,1,Andrew Onishuk,2015-07-31 14:07:55+03:00,['3a4d890351e63031faafa235d647edbb8076bfff'],335,626,961,20847173,5,0.350649351,0.350649351,0.324675325,20424
8ef13054985b69b8d5e44b2e419723b7dc658b33,0,Andrii Tkach,2015-07-31 14:47:24+03:00,['dde648d7c42eb3bf0fd47f418c916cd9ee341e91'],10,3,13,20847186,1,0,0,0,20424
8171776ba7bf6fc53541fb295e3f2bed29cc3473,0,Nate Cole,2015-07-31 09:23:01-04:00,['8ef13054985b69b8d5e44b2e419723b7dc658b33'],1,1,2,20847188,1,,,,20424
03bad617aac82e16b00beeeefdc3e6dbaa634b7f,1,Alex Antonenko,2015-07-31 18:27:34+03:00,['8171776ba7bf6fc53541fb295e3f2bed29cc3473'],0,1,1,20847189,1,1,1,1,20424
10409b3d8a1f747d5e2ee7a9b2c0cbe93ccddd71,1,Alex Antonenko,2015-07-31 18:33:42+03:00,['03bad617aac82e16b00beeeefdc3e6dbaa634b7f'],7,104,111,20847300,6,0.657534247,0.97260274,1,20425
52ee2ffef96db0f6fade15c8786280cbca93f913,1,Dmytro Sen,2015-07-31 19:00:40+03:00,['10409b3d8a1f747d5e2ee7a9b2c0cbe93ccddd71'],16,19,35,20847335,2,0,0,0,20425
ffc45f57a83006493f4c763cddd71e879e5bbe6b,1,Dmytro Sen,2015-07-31 19:25:49+03:00,['52ee2ffef96db0f6fade15c8786280cbca93f913'],2,5,7,20847342,1,0,0,1,20425
69a29494c375a24e895f3d363073a3bc0952ee18,1,Nate Cole,2015-07-31 13:18:34-04:00,['ffc45f57a83006493f4c763cddd71e879e5bbe6b'],2,4,6,20847348,1,,,,20425
3a2381f589c291721cbc740ed68fce10d50f3a2c,0,Jaimin Jetly,2015-07-31 10:57:54-07:00,['69a29494c375a24e895f3d363073a3bc0952ee18'],0,32,32,20847380,2,0,0,1,20426
1063607070ddc488952c5ff23f07eb6293f8bb64,0,Xi Wang,2015-07-31 11:03:40-07:00,['3a2381f589c291721cbc740ed68fce10d50f3a2c'],4,5,9,20847389,2,,,,20426
7c1f7a803b18f8384800cc9ca52ac34a42eee18b,1,Robert Levas,2015-07-31 15:55:47-04:00,['1063607070ddc488952c5ff23f07eb6293f8bb64'],9,411,420,20847809,2,0,0.990990991,1,20426
49b47c354fae80b3c0f748d756f439d5553d8e7e,1,Richard Zang,2015-07-31 17:09:13-07:00,['7c1f7a803b18f8384800cc9ca52ac34a42eee18b'],3,38,41,20847850,6,0.857142857,1,1,20426
316404fe5231b75b590f5a7f5c630d6824451786,0,Andrew Onishuk,2015-08-03 15:02:36+03:00,['49b47c354fae80b3c0f748d756f439d5553d8e7e'],2,1,3,20847853,1,,,,20426
fb28fe7ac286e679112a7da19f72cabbf3caa8ee,1,Lisnichenko Dmitro,2015-08-03 15:48:24+03:00,['316404fe5231b75b590f5a7f5c630d6824451786'],10,15,25,20847878,3,0,0,1,20426
2462dbeffd7f3795bdf6259a759190e239db2595,1,Alex Antonenko,2015-08-03 16:38:59+03:00,['fb28fe7ac286e679112a7da19f72cabbf3caa8ee'],3,7,10,20847888,1,0.75,1,1,20426
6c4eba4af0a21c03aedc21d5a9bac7c00ea4ed83,1,Bob Nettleton,2015-08-03 09:59:07-04:00,['2462dbeffd7f3795bdf6259a759190e239db2595'],2,36,38,20847926,2,0.55,0.55,0.6,20426
2f950f9c2a84359eeb61e119a248240a12457e54,1,Myroslav Papirkovskyy,2015-08-03 17:09:46+03:00,['6c4eba4af0a21c03aedc21d5a9bac7c00ea4ed83'],4,12,16,20847942,1,1,1,1,20426
a2e6535943671a8a16636a2eea054324e4ebc0c5,1,Lisnichenko Dmitro,2015-08-03 20:18:51+03:00,['2f950f9c2a84359eeb61e119a248240a12457e54'],1,17,18,20847960,2,0,0.4,0.6,20426
d6058d956fcc190edefe534c5441977f2d2b3791,1,Sumit Mohanty,2015-08-03 10:21:17-07:00,['a2e6535943671a8a16636a2eea054324e4ebc0c5'],11,131,142,20848102,3,,,,20426
5cfe6d60d0e8b338a89a57ad623ee54afcca3312,1,Lisnichenko Dmitro,2015-08-03 20:40:15+03:00,['d6058d956fcc190edefe534c5441977f2d2b3791'],2,39,41,20848143,3,0.166666667,1,0.958333333,20426
45e8ca90c5645e2d3cbd41c9e733227aeb2e8f69,0,Xi Wang,2015-08-03 14:16:52-07:00,['5cfe6d60d0e8b338a89a57ad623ee54afcca3312'],0,4,4,20848147,1,0,1,1,20426
9e4ea6d92e2546e1d9b3b81cdf3fd5a190fa91b9,0,Siddharth Wagle,2015-08-03 17:38:46-07:00,['45e8ca90c5645e2d3cbd41c9e733227aeb2e8f69'],9,70,79,20848226,11,,,,20426
48a0d2accac3a6950737a0a14f393c71436bec3d,1,Sumit Mohanty,2015-08-03 20:11:51-07:00,['9e4ea6d92e2546e1d9b3b81cdf3fd5a190fa91b9'],2,94,96,20848322,3,0.304347826,0.913043478,0.391304348,20426
d7b3ec8e1e47f792685630daaa17976ea193ac4e,1,Alex Antonenko,2015-08-04 14:06:33+03:00,['48a0d2accac3a6950737a0a14f393c71436bec3d'],75,205,280,20848602,11,0.788461538,0.951923077,1,20426
f3638bd83a6f2445421e03b2f99eb051873e41b6,1,Dmytro Sen,2015-08-04 15:05:59+03:00,['d7b3ec8e1e47f792685630daaa17976ea193ac4e'],8,77,85,20848687,5,0.125,0,1,20426
1063f2dddbb9a7e5f684f888f20ad63eecbed9ea,1,aBabiichuk,2015-08-04 15:34:55+03:00,['f3638bd83a6f2445421e03b2f99eb051873e41b6'],428,58,486,20849173,10,0.108974359,0,0.179487179,20426
b5bd53a10744a8ea9cf587fda58f453dd913b163,1,aBabiichuk,2015-08-04 16:53:20+03:00,['1063f2dddbb9a7e5f684f888f20ad63eecbed9ea'],1,3,4,20849177,2,1,1,1,20426
5dbb0e1b87a8720a1e20920190a552193ed90bf4,1,Jonathan Hurley,2015-08-04 10:40:31-04:00,['b5bd53a10744a8ea9cf587fda58f453dd913b163'],29,190,219,20849396,4,0,0.862385321,0.972477064,20426
5da5456256d8a59c75e6a8f5e4cebef25af744b6,0,Andrew Onishuk,2015-08-04 18:21:06+03:00,['5dbb0e1b87a8720a1e20920190a552193ed90bf4'],2,2,4,20849400,1,,,,20426
de15d42f0adb0fb50f7f7fe8105046cde75420e5,1,Andrew Onishuk,2015-08-04 19:05:58+03:00,['5da5456256d8a59c75e6a8f5e4cebef25af744b6'],6,6,12,20849412,2,0,0,0,20426
a06a3243866b5938f6c0972f91222bb0998c776a,0,Andrew Onishuk,2015-08-04 19:34:29+03:00,['de15d42f0adb0fb50f7f7fe8105046cde75420e5'],77,0,77,20849489,9,0.909090909,0.704545455,0,20426
000848949cd0b7d96bfd2ff56d56bc484c24c937,1,Andrew Onishuk,2015-08-04 19:57:41+03:00,['a06a3243866b5938f6c0972f91222bb0998c776a'],4,5,9,20849498,1,,,,20426
1c58762886c323f9a024e9d463a646243119e5df,1,Robert Levas,2015-08-04 15:36:01-04:00,['000848949cd0b7d96bfd2ff56d56bc484c24c937'],0,1,1,20849499,1,,,,20426
26a3efd75cf814da3519ce06030049c9a36d5757,1,aBabiichuk,2015-08-05 13:45:16+03:00,['1c58762886c323f9a024e9d463a646243119e5df'],0,5,5,20849504,1,0,0,1,20426
b737df41bfaeb63b1fcb450331f81aa784cb6cdc,0,aBabiichuk,2015-08-05 14:18:59+03:00,['26a3efd75cf814da3519ce06030049c9a36d5757'],1,7,8,20849512,1,1,1,1,20426
a471f3391ad97191a77fac055ebd681c69d9c274,1,Andrii Tkach,2015-08-05 15:01:37+03:00,['b737df41bfaeb63b1fcb450331f81aa784cb6cdc'],11,85,96,20849608,6,1,1,1,20427
b4f13a2fee5875a5079df3ccb08289b3a197f96f,1,aBabiichuk,2015-08-05 15:05:48+03:00,['a471f3391ad97191a77fac055ebd681c69d9c274'],3,6,9,20849617,4,0,0,1,20427
1a4ad49566a6651a73ecf14723975b2ae5ef0c98,1,Lisnichenko Dmitro,2015-08-05 15:25:08+03:00,['b4f13a2fee5875a5079df3ccb08289b3a197f96f'],149,175,324,20849941,4,0.818181818,0.818181818,1,20427
c2ecbdf6e8154de7c2965c01ccaff1c318e0ee29,1,aBabiichuk,2015-08-05 15:53:56+03:00,['1a4ad49566a6651a73ecf14723975b2ae5ef0c98'],4,8,12,20849953,2,1,1,1,20427
9d3fa7318ff6055cdaf0c6f346bd4f49cbd6815d,0,Lisnichenko Dmitro,2015-08-05 16:30:24+03:00,['c2ecbdf6e8154de7c2965c01ccaff1c318e0ee29'],13,39,52,20850005,4,0.0625,0.9375,0,20427
b33f19d92737b6c55d356721348424cab97b5631,1,Andrew Onishuk,2015-08-05 17:00:55+03:00,['9d3fa7318ff6055cdaf0c6f346bd4f49cbd6815d'],1,1,2,20850007,1,,,,20427
77f2c23dfab972e713c6a0357fbb1fa3f1ab95d4,1,Andrew Onishuk,2015-08-05 17:04:27+03:00,['b33f19d92737b6c55d356721348424cab97b5631'],79,84,163,20850170,8,0,0,0,20427
eff899893482c67ce6edd83f7a595e07fcbff834,1,Robert Levas,2015-08-05 11:24:09-04:00,['77f2c23dfab972e713c6a0357fbb1fa3f1ab95d4'],136,249,385,20850555,6,0.818181818,1,0,20427
d592ba9b0e7d97e95866a2c1742db5386cf95fa6,1,Jonathan Hurley,2015-08-05 13:00:14-04:00,['eff899893482c67ce6edd83f7a595e07fcbff834'],309,436,745,20851300,18,0,0,0.880597015,20427
0862422cd08c80787a272aec08207146e527819e,1,Jonathan Hurley,2015-08-05 14:44:06-04:00,['d592ba9b0e7d97e95866a2c1742db5386cf95fa6'],124,138,262,20851562,2,0.5,0.5,0,20427
c2c762120e7fa8bf1e51b978dc6782f24b185d22,1,Jonathan Hurley,2015-08-05 15:51:03-04:00,['0862422cd08c80787a272aec08207146e527819e'],19,26,45,20851607,1,0,1,1,20427
b32bf6e424b2badc7293f8cbf7cc27afe69f0e49,1,Alejandro Fernandez,2015-08-05 13:46:43-07:00,['c2c762120e7fa8bf1e51b978dc6782f24b185d22'],18,34,52,20851659,5,0,0.818181818,0.636363636,20427
314ae6c046a3031a9fd8f9c3a3eabdd26a112a86,1,Sumit Mohanty,2015-08-05 14:25:32-07:00,['b32bf6e424b2badc7293f8cbf7cc27afe69f0e49'],7,127,134,20851793,4,0.08,1,0.12,20428
209b61b60f64736334e1b1d21bb3bc668768dd98,1,Jaimin Jetly,2015-08-05 16:10:04-07:00,['314ae6c046a3031a9fd8f9c3a3eabdd26a112a86'],46,60,106,20851899,6,0.933333333,0.933333333,1,20428
daf8ed5d33dfabcf904971129d5bb38fbbf89a88,1,Alejandro Fernandez,2015-08-05 19:27:40-07:00,['209b61b60f64736334e1b1d21bb3bc668768dd98'],18,27,45,20851944,1,0,1,1,20428
a142789d728a33195909808f43e2e8a14a4974d0,1,Yusaku Sako,2015-08-05 23:27:52-07:00,['daf8ed5d33dfabcf904971129d5bb38fbbf89a88'],38,319,357,20852301,15,0.536585366,0.817073171,0.768292683,20433
35ea40faa5eb1956a1fbb9115fb8f9fbb0adf840,1,aBabiichuk,2015-08-06 10:08:45+03:00,['a142789d728a33195909808f43e2e8a14a4974d0'],5,5,10,20852311,1,,,,20433
6dc2c7f7546252afadac28273413ef14c90348e6,0,aBabiichuk,2015-08-06 10:55:08+03:00,['35ea40faa5eb1956a1fbb9115fb8f9fbb0adf840'],5,10,15,20852326,2,1,1,1,20433
07319d530980d1fa48bd24fc9397cb467a2dba29,1,Aleksandr Kovalenko,2015-08-06 12:29:12+03:00,['6dc2c7f7546252afadac28273413ef14c90348e6'],11,12,23,20852349,8,1,1,1,20433
6e7a65c65a5f890581b17cd62953aad91438ff94,0,Alex Antonenko,2015-08-06 15:09:06+03:00,['07319d530980d1fa48bd24fc9397cb467a2dba29'],0,1,1,20852350,1,1,1,1,20433
fba2293abe83d150587dfc794c97d99b033574e4,0,aBabiichuk,2015-08-06 15:13:56+03:00,['6e7a65c65a5f890581b17cd62953aad91438ff94'],1,1,2,20852352,1,,,,20433
aa930751b26f5cb436b46f61dd9f89cfbcc36d75,1,Alex Antonenko,2015-08-06 15:34:20+03:00,['fba2293abe83d150587dfc794c97d99b033574e4'],52,56,108,20852460,4,1,1,0,20433
c8e3e27d4a7bec9c282f1de20f03a5037f8069b1,0,Andrew Onishuk,2015-08-06 17:13:34+03:00,['aa930751b26f5cb436b46f61dd9f89cfbcc36d75'],2,1,3,20852463,1,,,,20433
422c6e1202d013a1873a14f000814fa582306cf4,1,Bob Nettleton,2015-08-06 11:39:37-04:00,['c8e3e27d4a7bec9c282f1de20f03a5037f8069b1'],1,1,2,20852465,1,,,,20433
9a7f18ace8a18a6181cba2d1c1a76e853f38606c,1,Dmytro Sen,2015-08-06 19:16:50+03:00,['422c6e1202d013a1873a14f000814fa582306cf4'],0,4,4,20852469,1,,,,20433
e6ed547f7a636caceb5e0684ea726594431e8ea0,1,Jaimin Jetly,2015-08-06 09:35:18-07:00,['9a7f18ace8a18a6181cba2d1c1a76e853f38606c'],43,178,221,20852690,4,0.949367089,0.962025316,0.962025316,20433
5fd790f276c15507bf97fe35b3cda6142b7d92db,1,Alex Antonenko,2015-08-06 20:25:45+03:00,['e6ed547f7a636caceb5e0684ea726594431e8ea0'],0,6,6,20852696,1,,,,20433
53dd362457a32b68640ae1647ab8639afe3b432e,0,Alejandro Fernandez,2015-08-06 11:30:05-07:00,['5fd790f276c15507bf97fe35b3cda6142b7d92db'],438,2321,2759,20855455,33,0.415909091,0.722727273,0.686363636,20448
c09261311e0bbc6607bb4c833cb938cbc41715fe,0,Sumit Mohanty,2015-08-06 12:17:52-07:00,['53dd362457a32b68640ae1647ab8639afe3b432e'],32,103,135,20855590,2,0.181818182,0.181818182,0.181818182,20448
26812c1f9b1de079d808debb33cde3e726a94789,0,Robert Levas,2015-08-06 16:08:16-04:00,['c09261311e0bbc6607bb4c833cb938cbc41715fe'],0,7,7,20855597,1,,,,20448
91c969ac367abbf0c1c603af084da823d5e52e92,0,Jonathan Hurley,2015-08-06 16:19:31-04:00,['26812c1f9b1de079d808debb33cde3e726a94789'],3,3,6,20855603,1,,,,20448
62eaa026608186f0b0050b4ec079c5440aa6fad9,1,Xi Wang,2015-08-06 14:37:27-07:00,['91c969ac367abbf0c1c603af084da823d5e52e92'],5,5,10,20855613,1,,,,20448
f1550245cf3ae345ace6073096476fddc64f9280,1,Sumit Mohanty,2015-08-06 19:28:52-07:00,['62eaa026608186f0b0050b4ec079c5440aa6fad9'],3,78,81,20855694,2,0,0.027777778,1,20448
6ce594e0436fe96ffacab73e87463bc80c0da604,1,Alex Antonenko,2015-08-07 12:00:41+03:00,['f1550245cf3ae345ace6073096476fddc64f9280'],1,1,2,20855696,1,,,,20448
db7149dd2ea6b2b9ee01ff1ac3a52329debff0f6,1,Aleksandr Kovalenko,2015-08-07 14:15:13+03:00,['6ce594e0436fe96ffacab73e87463bc80c0da604'],5,12,17,20855713,2,0,1,1,20448
683ea1a06e245c7f82be43588c290bab7e55fe15,1,aBabiichuk,2015-08-07 16:26:02+03:00,['db7149dd2ea6b2b9ee01ff1ac3a52329debff0f6'],25,10,35,20855748,5,0,0,1,20448
8565ccdb551f16eb38336cd1e933644e941fe055,1,Oleg Nechiporenko,2015-08-07 17:25:09+03:00,['683ea1a06e245c7f82be43588c290bab7e55fe15'],12,64,76,20855824,3,1,1,1,20448
f5f3d7539f2295fe25952a5f4e26bb66280e2ec6,1,aBabiichuk,2015-08-07 17:31:03+03:00,['8565ccdb551f16eb38336cd1e933644e941fe055'],4,4,8,20855832,1,0,0,1,20448
dcd23a7a762b27911bb2f21b1d1e422cfae24bd9,1,Jonathan Hurley,2015-08-07 11:13:12-04:00,['f5f3d7539f2295fe25952a5f4e26bb66280e2ec6'],3,3,6,20855838,1,,,,20448
c89d427c75d15ca7ce1ad66fa6347987a36068f3,0,Andrew Onishuk,2015-08-07 19:06:29+03:00,['dcd23a7a762b27911bb2f21b1d1e422cfae24bd9'],4,0,4,20855842,1,1,1,0,20448
a566bb143a81954005f0bd1133d559bc208dc960,1,Dmytro Sen,2015-08-07 19:42:56+03:00,['c89d427c75d15ca7ce1ad66fa6347987a36068f3'],10,254,264,20856106,2,0.857142857,0.675324675,0.636363636,20448
f0713c36a9ead25c7465c27f6c80e719c415d7a6,0,Alex Antonenko,2015-08-07 19:52:42+03:00,['a566bb143a81954005f0bd1133d559bc208dc960'],0,4,4,20856110,1,1,1,1,20448
ba3a2caa53ad9bf426664041f32abfb2d8df959d,1,Jonathan Hurley,2015-08-07 14:34:01-04:00,['f0713c36a9ead25c7465c27f6c80e719c415d7a6'],15,9,24,20856134,2,0,0,0,20448
6baeac53634ebdc63190b4a1e4b12061594b4d50,0,Alejandro Fernandez,2015-08-07 15:15:32-07:00,['ba3a2caa53ad9bf426664041f32abfb2d8df959d'],169,412,581,20856715,17,0.666666667,1,0.666666667,20450
49de6139a1b23921c76190a8ba94fac3957ad669,0,Alejandro Fernandez,2015-08-07 15:26:02-07:00,['6baeac53634ebdc63190b4a1e4b12061594b4d50'],0,0,0,20856715,1,,,,20451
97e913eb0d9b4a4da7052e7802e950c7f7d666f2,0,Alejandro Fernandez,2015-08-07 15:30:28-07:00,['49de6139a1b23921c76190a8ba94fac3957ad669'],1,1,2,20856717,1,,,,20451
65e50eee97fb6e739556d8b93c691273b52fce36,1,Jonathan Hurley,2015-08-08 14:23:33-04:00,['97e913eb0d9b4a4da7052e7802e950c7f7d666f2'],16,101,117,20856834,3,0.469387755,0.469387755,0.591836735,20451
34e96e247949f10dd9d0c70f873f654f4b04dc5a,0,Jaimin Jetly,2015-08-09 12:55:01-07:00,['65e50eee97fb6e739556d8b93c691273b52fce36'],37,45,82,20856916,4,1,1,1,20451
6f8206cdb03d26bd8855e534ab05ef7327239088,1,Aleksandr Kovalenko,2015-08-10 13:24:12+03:00,['34e96e247949f10dd9d0c70f873f654f4b04dc5a'],22,3,25,20856941,2,0,0,0,20451
4a9f2c2e99947a6b1130d6df6e09b2b52343d08e,1,Vitaly Brodetskyi,2015-08-10 17:21:09+03:00,['6f8206cdb03d26bd8855e534ab05ef7327239088'],11,31,42,20856983,4,0,0,0,20451
bbb2bdc188086c0f04cadfcda140605408a95eb9,1,Vitaly Brodetskyi,2015-08-10 17:32:35+03:00,['4a9f2c2e99947a6b1130d6df6e09b2b52343d08e'],4,4,8,20856991,2,,,,20451
b6a3f70b92ece452ec69be8fcc57c54a63c2b264,0,Oleg Nechiporenko,2015-08-10 17:36:13+03:00,['bbb2bdc188086c0f04cadfcda140605408a95eb9'],1,1,2,20856993,1,,,,20451
91b42b5431afaea1f6b21a24c8a14d97bf1afadc,0,Aleksandr Kovalenko,2015-08-10 19:06:00+03:00,['b6a3f70b92ece452ec69be8fcc57c54a63c2b264'],1,1,2,20856995,1,1,0,0,20451
c3d5cd16f182acca0d5d76c34a787725b398ee5c,1,Jonathan Hurley,2015-08-10 12:14:20-04:00,['91b42b5431afaea1f6b21a24c8a14d97bf1afadc'],4,170,174,20857169,5,0,0,1,20452
f5155c913980dd9b0c198a7fd925c8c3d88079e8,1,Sumit Mohanty,2015-08-10 09:43:22-07:00,['c3d5cd16f182acca0d5d76c34a787725b398ee5c'],4,777,781,20857950,4,0,0.803738318,1,20453
7e490edecd3fbf68c7202ea9933b3fa34cc7c1bc,1,Dmytro Sen,2015-08-10 20:24:55+03:00,['f5155c913980dd9b0c198a7fd925c8c3d88079e8'],0,34,34,20857984,2,0,1,1,20453
8516e3dfbcb30669fada4eea07cec07b51ef0ab8,1,Robert Levas,2015-08-10 14:37:58-04:00,['7e490edecd3fbf68c7202ea9933b3fa34cc7c1bc'],2,2,4,20857988,2,,,,20453
b98f515715c980fdc7b290863b91777ed65a63df,0,Alejandro Fernandez,2015-08-10 13:22:48-07:00,['8516e3dfbcb30669fada4eea07cec07b51ef0ab8'],1,3,4,20857992,2,,,,20453
3f4153f207be9915d24017220123006066e2482c,1,Alejandro Fernandez,2015-08-10 14:21:50-07:00,['b98f515715c980fdc7b290863b91777ed65a63df'],0,1138,1138,20859130,5,0.157212318,0.136142626,0.696920583,20457
5c712df70a8100f4fb3a71de8cf851f6d28df260,1,Jaimin Jetly,2015-08-10 16:28:57-07:00,['3f4153f207be9915d24017220123006066e2482c'],85,71,156,20859286,3,1,1,1,20457
43ea79baf6f3c989c5a8f53230385d9047300bda,1,Dmytro Sen,2015-08-11 10:32:10+03:00,['5c712df70a8100f4fb3a71de8cf851f6d28df260'],0,7,7,20859293,2,0,0.666666667,1,20457
483c8b6bb02d084169dd0f0f99b71713205f5713,1,Andrii Tkach,2015-08-11 11:02:52+03:00,['43ea79baf6f3c989c5a8f53230385d9047300bda'],67,129,196,20859489,7,0.08,0.56,0.96,20457
3644af3ac748c84cdbe4082e116f0190479773fe,1,aBabiichuk,2015-08-11 11:32:56+03:00,['483c8b6bb02d084169dd0f0f99b71713205f5713'],3,8,11,20859500,1,0,0,1,20457
89f4162b1bb35df97b230b8e10f4518405b76913,1,Alex Antonenko,2015-08-11 11:38:46+03:00,['3644af3ac748c84cdbe4082e116f0190479773fe'],3582,81,3663,20863163,4,1,1,1,20458
f52236c59df3839c9fdf9e1bb5eb00f0d6305189,0,Alex Antonenko,2015-08-11 11:38:46+03:00,['89f4162b1bb35df97b230b8e10f4518405b76913'],4,29,33,20863196,2,0.4,0.4,1,20458
a4203583f8714442ec48f5318b75960c6f8a892a,1,Oleg Nechiporenko,2015-08-11 11:54:41+03:00,['f52236c59df3839c9fdf9e1bb5eb00f0d6305189'],46,55,101,20863297,5,1,1,1,20458
8a12fecf1e359138074b210ba4d1e19234a15bf3,1,Oleg Nechiporenko,2015-08-11 12:06:07+03:00,['a4203583f8714442ec48f5318b75960c6f8a892a'],0,2,2,20863299,1,,,,20458
02eb29b1473d79ebbae82b3c9455a1f0e47fabd2,1,Oleg Nechiporenko,2015-08-11 12:16:05+03:00,['8a12fecf1e359138074b210ba4d1e19234a15bf3'],21,23,44,20863343,3,0,0,0,20458
ce7f89923e3bc0e3fe493b9d6928849ab768b4f6,1,Oleg Nechiporenko,2015-08-11 12:37:29+03:00,['02eb29b1473d79ebbae82b3c9455a1f0e47fabd2'],9,41,50,20863393,2,1,1,1,20458
049d9e3fc11c3d8da6dae8b19d1d735b332c3856,0,Aleksandr Kovalenko,2015-08-11 12:40:55+03:00,['ce7f89923e3bc0e3fe493b9d6928849ab768b4f6'],3,3,6,20863399,1,,,,20458
fd49fb9e212e8c5424bb3527f979d21041f9416c,0,Oleg Nechiporenko,2015-08-11 12:44:42+03:00,['049d9e3fc11c3d8da6dae8b19d1d735b332c3856'],18,28,46,20863445,2,1,1,1,20458
ff953625b9171f7f21f8b9ea79cfd98edb04177e,1,Alex Antonenko,2015-08-11 17:26:32+03:00,['fd49fb9e212e8c5424bb3527f979d21041f9416c'],0,13,13,20863458,1,0.2,0.2,1,20458
6cd51d24602973d4ec37a530fb4b89b6b1320788,1,Oleg Nechiporenko,2015-08-11 17:54:47+03:00,['ff953625b9171f7f21f8b9ea79cfd98edb04177e'],149,217,366,20863824,7,0,0,0,20458
51ea0ec32f102315011903702f78f408800070a2,1,Alex Antonenko,2015-08-11 18:20:28+03:00,['6cd51d24602973d4ec37a530fb4b89b6b1320788'],11,20,31,20863855,4,0.888888889,0.888888889,1,20458
09f6101719b83dc577a6ff1eb17e90c1108a7e7a,1,Alex Antonenko,2015-08-11 18:28:48+03:00,['51ea0ec32f102315011903702f78f408800070a2'],14,31,45,20863900,1,,,,20458
18c6130f2682dffb1c34f10b0b18a9a2ca89404e,1,Dmytro Sen,2015-08-11 19:06:24+03:00,['09f6101719b83dc577a6ff1eb17e90c1108a7e7a'],51,128,179,20864079,2,0,0.933333333,1,20458
6ae04cb951d8321eff12e1874162c9ed98c4c8fa,0,Srimanth Gunturi,2015-08-11 11:08:15-07:00,['18c6130f2682dffb1c34f10b0b18a9a2ca89404e'],1,16,17,20864096,2,1,1,1,20458
12c002c2c17b82d7bd078122bab45bdc97bb854b,1,Srimanth Gunturi,2015-08-11 11:15:52-07:00,['6ae04cb951d8321eff12e1874162c9ed98c4c8fa'],27,40,67,20864163,3,0,1,1,20458
6ac03f0433118105a51ffb581c608256d8de80e3,1,Dmytro Sen,2015-08-11 21:27:23+03:00,['12c002c2c17b82d7bd078122bab45bdc97bb854b'],8,8,16,20864179,2,,,,20458
e3b3c3ef0aad91eed13c813db5e39c071652fa2b,1,Srimanth Gunturi,2015-08-11 13:12:27-07:00,['6ac03f0433118105a51ffb581c608256d8de80e3'],3,3,6,20864185,3,,,,20458
ad97b30493646309ecf2fd8a188b7379acb4ca9e,1,Srimanth Gunturi,2015-08-11 13:17:06-07:00,['e3b3c3ef0aad91eed13c813db5e39c071652fa2b'],0,2,2,20864187,1,,,,20458
f111bb3a0dc2103d0a708e98246bb214daa50e92,0,Dmytro Sen,2015-08-11 23:21:54+03:00,['ad97b30493646309ecf2fd8a188b7379acb4ca9e'],35,47,82,20864269,5,0,0.875,0.625,20458
cd635282ae085df7b1cdad548d564bc7cc5b05c7,1,Jonathan Hurley,2015-08-11 16:27:53-04:00,['f111bb3a0dc2103d0a708e98246bb214daa50e92'],93,73,166,20864435,2,1,0,1,20458
3f607731f8f6dcda2ecd0eaae70aa668b71b9940,1,Jaimin Jetly,2015-08-11 14:53:49-07:00,['cd635282ae085df7b1cdad548d564bc7cc5b05c7'],1,1,2,20864437,1,,,,20458
38d5eaf0c867d0cbd47fe11eca55bb16f7640c52,1,Sumit Mohanty,2015-08-11 18:11:32-07:00,['3f607731f8f6dcda2ecd0eaae70aa668b71b9940'],1,43,44,20864481,6,0.777777778,0.814814815,0.888888889,20458
8b96592a0e30fb01f8f4f81412b6bdd972255e2e,1,Richard Zang,2015-08-11 18:22:20-07:00,['38d5eaf0c867d0cbd47fe11eca55bb16f7640c52'],6,40,46,20864527,3,0.952380952,0.428571429,0.333333333,20458
721acd8eee7584a1cbb51b502771a54055d491df,1,Richard Zang,2015-08-11 18:22:20-07:00,['8b96592a0e30fb01f8f4f81412b6bdd972255e2e'],2,35,37,20864564,4,1,1,1,20458
cf3965b756423d42c264448f0d86adddec0a0f89,1,Richard Zang,2015-08-11 18:22:21-07:00,['721acd8eee7584a1cbb51b502771a54055d491df'],3,13,16,20864580,4,0.5,0,1,20458
b63ff52d7eec4908c55d0e0c3848f5050040b869,1,Vitaly Brodetskyi,2015-08-12 12:10:35+03:00,['cf3965b756423d42c264448f0d86adddec0a0f89'],81,87,168,20864748,7,1,0,0,20458
e482d7c4eec310f4dba16eb4853b48c7f5b1cbe5,1,Vitaly Brodetskyi,2015-08-12 12:38:45+03:00,['b63ff52d7eec4908c55d0e0c3848f5050040b869'],20,125,145,20864893,3,0.41509434,0.716981132,0.811320755,20458
0613c0a8a307d62767b1c4edf13e943e45841cf9,1,Vitaly Brodetskyi,2015-08-12 15:19:51+03:00,['e482d7c4eec310f4dba16eb4853b48c7f5b1cbe5'],10,90,100,20864993,6,0.1,0.871428571,0.9,20458
4b07879b3a3bde37319c4e8457088a588e70504f,1,Oleg Nechiporenko,2015-08-12 15:40:17+03:00,['0613c0a8a307d62767b1c4edf13e943e45841cf9'],26,67,93,20865086,2,0,1,1,20458
a788a9f28bca56689d833eef6f1b4004a920d88c,0,Dmytro Sen,2015-08-12 16:40:00+03:00,['4b07879b3a3bde37319c4e8457088a588e70504f'],8,11,19,20865105,2,0,1,1,20458
46caf1b9b29b799254d270d80f2f3ab6e1268ca3,1,Vitaly Brodetskyi,2015-08-12 16:53:49+03:00,['a788a9f28bca56689d833eef6f1b4004a920d88c'],1,3,4,20865109,1,,,,20458
fdb72ccdbff605a00a648e687d6a43d7c67f530c,0,Alex Antonenko,2015-08-12 17:33:06+03:00,['46caf1b9b29b799254d270d80f2f3ab6e1268ca3'],1,11,12,20865121,2,0.4,1,1,20458
def3da8a309a334d8391cb93a936075802af847d,0,Dmytro Sen,2015-08-12 18:43:40+03:00,['fdb72ccdbff605a00a648e687d6a43d7c67f530c'],0,4,4,20865125,2,,,,20458
1667fbf99352586d6cb55a19706a5daa278329ac,1,Aleksandr Kovalenko,2015-08-12 19:47:11+03:00,['def3da8a309a334d8391cb93a936075802af847d'],3,2,5,20865130,1,1,1,1,20458
77b3016884ae87c57de07c58997da1e2cebea237,1,Jayush Luniya,2015-08-12 10:02:07-07:00,['1667fbf99352586d6cb55a19706a5daa278329ac'],0,50,50,20865180,3,0,0.944444444,1,20458
049bfa8a649a79753b95aa4742f87a20a31988de,1,Alex Antonenko,2015-08-12 20:32:19+03:00,['77b3016884ae87c57de07c58997da1e2cebea237'],1,27,28,20865208,1,1,1,1,20458
2deb2437b93b9e9c0d6d707a86881863b10f00a6,0,Alex Antonenko,2015-08-12 20:40:25+03:00,['049bfa8a649a79753b95aa4742f87a20a31988de'],1,1,2,20865210,1,1,1,1,20458
1b6c479f72c1a0adc0d9ed0f6f9cb1ddbac9cc52,1,Alex Antonenko,2015-08-12 20:43:43+03:00,['2deb2437b93b9e9c0d6d707a86881863b10f00a6'],1,4,5,20865215,1,1,1,1,20458
0c929beb262e002a37bc4d239f8834f3e3683750,1,Artem Baranchuk,2015-08-12 20:50:30+03:00,['1b6c479f72c1a0adc0d9ed0f6f9cb1ddbac9cc52'],55,41,96,20865311,1,1,1,1,20458
9e962270bff7d61625617266eff9789c352b5be2,0,Artem Baranchuk,2015-08-12 22:00:58+03:00,['0c929beb262e002a37bc4d239f8834f3e3683750'],2,2,4,20865315,2,,,,20458
9e2e2b0d7429ad73c249813d84204c8c6845a87e,0,Robert Levas,2015-08-12 15:28:50-04:00,['9e962270bff7d61625617266eff9789c352b5be2'],149,241,390,20865705,2,0.118421053,0.671052632,0.144736842,20458
f04e4944d3de22037ab04767be7da1d7678a25f6,1,Alejandro Fernandez,2015-08-12 13:08:23-07:00,['9e2e2b0d7429ad73c249813d84204c8c6845a87e'],4,106,110,20865815,2,0.153846154,1,1,20458
469a090c44d3de28afee23cbc923d8ad2a813cc2,0,Jayush Luniya,2015-08-12 14:20:07-07:00,['f04e4944d3de22037ab04767be7da1d7678a25f6'],2,2,4,20865819,1,,,,20458
cef6f49b51839199fa7cfbd4ae83aaac5c1c55e6,1,Sumit Mohanty,2015-08-12 14:55:58-07:00,['469a090c44d3de28afee23cbc923d8ad2a813cc2'],47,35,82,20865901,5,1,0.125,0.375,20458
6dc98001f283b9eb0c52b9f47854ec4449f9ee89,1,Srimanth Gunturi,2015-08-12 17:47:38-07:00,['cef6f49b51839199fa7cfbd4ae83aaac5c1c55e6'],1,14,15,20865916,2,0.7,0.7,1,20458
477c56dfa7fdba2630f3197cbe4f35ab257edd71,1,aBabiichuk,2015-08-13 12:00:27+03:00,['6dc98001f283b9eb0c52b9f47854ec4449f9ee89'],1,10,11,20865927,2,1,1,1,20458
08ce3411fa3d9d76bdacb4ded2d3f265f8c6a9ac,1,Oleg Nechiporenko,2015-08-13 12:31:10+03:00,['477c56dfa7fdba2630f3197cbe4f35ab257edd71'],0,7,7,20865934,1,1,1,1,20458
c8508e82bdebd6eaeee2244ff6d56b59a7b50fa3,0,aBabiichuk,2015-08-13 15:44:15+03:00,['08ce3411fa3d9d76bdacb4ded2d3f265f8c6a9ac'],0,6,6,20865940,1,,,,20458
ac1e5f6d4006c8ca6c56d9e5c51e2e46cc14898f,1,Aleksandr Kovalenko,2015-08-13 17:51:04+03:00,['c8508e82bdebd6eaeee2244ff6d56b59a7b50fa3'],27,12,39,20865979,2,0,0,0,20458
5ea12f064706522737c84155d3ee749524251cd4,1,Oleg Nechiporenko,2015-08-13 18:36:03+03:00,['ac1e5f6d4006c8ca6c56d9e5c51e2e46cc14898f'],13,20,33,20866012,2,0.666666667,1,1,20458
d1adaa293d83fbcd4731ad5f2d2f310190ccf2da,1,Andrii Tkach,2015-08-13 19:48:04+03:00,['5ea12f064706522737c84155d3ee749524251cd4'],46,136,182,20866194,6,1,1,1,20458
fd7bcd4e5c1888cda7b832c1985a8b2ba4f4320e,1,Andrii Tkach,2015-08-13 19:55:37+03:00,['d1adaa293d83fbcd4731ad5f2d2f310190ccf2da'],3,151,154,20866348,17,0.986842105,0.986842105,1,20460
288fffb702d6462b8945c97741777bf3975edee2,1,Dmytro Sen,2015-08-13 20:00:50+03:00,['fd7bcd4e5c1888cda7b832c1985a8b2ba4f4320e'],8,17,25,20866373,4,,,,20460
8bb25bed2c857ca0c351a1e3863aa56d07ab8e8e,1,Richard Zang,2015-08-13 10:43:33-07:00,['288fffb702d6462b8945c97741777bf3975edee2'],33,13,46,20866419,5,0.454545455,1,0,20460
43511187b140b32ab400ea13dce07300f0864c5b,0,Bob Nettleton,2015-08-13 18:19:02-04:00,['8bb25bed2c857ca0c351a1e3863aa56d07ab8e8e'],35,42,77,20866496,1,0,0,0,20460
de457dcb8b48eba70976fb172bb5a48a2cb52d74,1,Jayush Luniya,2015-08-13 22:19:34-07:00,['43511187b140b32ab400ea13dce07300f0864c5b'],0,307,307,20866803,3,,,,20463
739cdecf6c6ccaabd74b1608262b85a0277bf7ad,1,aBabiichuk,2015-08-14 14:21:29+03:00,['de457dcb8b48eba70976fb172bb5a48a2cb52d74'],1,16,17,20866820,2,,,,20463
446ef801ddc86b57c6122bc5fe4a0e9a48539aa5,0,Jayush Luniya,2015-08-14 16:05:53-07:00,['739cdecf6c6ccaabd74b1608262b85a0277bf7ad'],3,2,5,20866825,1,,,,20463
a236102cf8ac1c06fef955fb9f858e5f2953e29c,1,Jonathan Hurley,2015-08-17 00:03:55-04:00,['446ef801ddc86b57c6122bc5fe4a0e9a48539aa5'],7,225,232,20867057,7,0.092783505,0.092783505,0.371134021,20463
930d449997c3b2fb9754bfb7c59d14f5e2f04164,0,Jayush Luniya,2015-08-16 22:13:19-07:00,['a236102cf8ac1c06fef955fb9f858e5f2953e29c'],60031,0,60031,20927088,289,0.664832926,0.369600652,0.129176854,20463
0f693987c6162e0edf7716af543198ac65e8e603,0,Oleg Nechiporenko,2015-08-17 15:02:26+03:00,['930d449997c3b2fb9754bfb7c59d14f5e2f04164'],4,18,22,20927110,1,0,1,1,20463
63134a7b6ebfef1ab82cd4a91b837c34bdc8a003,1,Oleg Nechiporenko,2015-08-17 15:03:48+03:00,['0f693987c6162e0edf7716af543198ac65e8e603'],10,88,98,20927208,5,0.578125,0.609375,1,20463
baed7e987ce5ad1628120655d6de33bf314bf08b,1,Dmytro Sen,2015-08-17 15:58:40+03:00,['63134a7b6ebfef1ab82cd4a91b837c34bdc8a003'],2,2,4,20927212,1,,,,20463
3299ce44ecc661a4dec678a50a730e4a162e88cc,1,Aleksandr Kovalenko,2015-08-17 17:13:29+03:00,['baed7e987ce5ad1628120655d6de33bf314bf08b'],4,14,18,20927230,1,0.6,1,1,20463
9d9b6c70ef9d7419f69fa9d6d7e33c483be2ac07,1,Alex Antonenko,2015-08-17 17:51:31+03:00,['3299ce44ecc661a4dec678a50a730e4a162e88cc'],8,47,55,20927285,2,,,,20463
9d81647962ef46e6fcd4cdaf4bc7d9d98a102683,1,Aleksandr Kovalenko,2015-08-17 18:25:21+03:00,['9d9b6c70ef9d7419f69fa9d6d7e33c483be2ac07'],6,17,23,20927308,2,0,0,1,20463
7cf27fc4e9aa74b790ddafbfb4aa6c2c6841cc1b,1,Lisnichenko Dmitro,2015-08-17 18:54:05+03:00,['9d81647962ef46e6fcd4cdaf4bc7d9d98a102683'],3,38,41,20927349,3,0,0.807692308,0.923076923,20463
5d0d63119f27e8de16fb174ba39d7598823151a4,1,Andrii Tkach,2015-08-17 20:08:12+03:00,['7cf27fc4e9aa74b790ddafbfb4aa6c2c6841cc1b'],8,5,13,20927362,1,0,0,0,20463
6e077b43c7152dd47b17ccb30b7c1f59c7fe06b1,0,Jaimin Jetly,2015-08-17 11:18:20-07:00,['5d0d63119f27e8de16fb174ba39d7598823151a4'],9,27,36,20927398,3,,,,20463
d4c0780ba321fcc4546df0279d49a7b1912c47a8,1,Xi Wang,2015-08-17 12:48:26-07:00,['6e077b43c7152dd47b17ccb30b7c1f59c7fe06b1'],7,8,15,20927413,2,0,0,1,20463
5b38d8766be4535e64da600682a604d969ef17ee,1,Dmytro Sen,2015-08-17 23:25:09+03:00,['d4c0780ba321fcc4546df0279d49a7b1912c47a8'],19,134,153,20927566,5,0.02970297,0.02970297,0.673267327,20463
02fd9a7966d3085b54c8346db7ddc8e8f4232d82,1,Siddharth Wagle,2015-08-17 16:58:27-07:00,['5b38d8766be4535e64da600682a604d969ef17ee'],241,3737,3978,20931544,32,0.345430108,0.782258065,0.849462366,20471
25ee587432dcc46f7300ad3c9059c9774d6591db,1,Jayush Luniya,2015-08-17 19:52:04-07:00,['02fd9a7966d3085b54c8346db7ddc8e8f4232d82'],2,29,31,20931575,1,,,,20471
677e233c76d80472260e7a55eb91352ea6614790,1,Jayush Luniya,2015-08-17 19:59:19-07:00,['25ee587432dcc46f7300ad3c9059c9774d6591db'],207,57,264,20931839,9,0,0.8,0.685714286,20471
c41f360a973a47554c36c0333dd84ead239bf25d,1,Jayush Luniya,2015-08-17 23:42:29-07:00,['677e233c76d80472260e7a55eb91352ea6614790'],0,13,13,20931852,2,0,0,0,20471
c2f2320ca3361d72b8bef8f622e87e7354a9db28,0,Alex Antonenko,2015-08-18 11:27:39+03:00,['c41f360a973a47554c36c0333dd84ead239bf25d'],6,8,14,20931866,1,,,,20471
5c99c9b0766d99cf3f3a26a0fe0f493a478deec4,0,Dmytro Sen,2015-08-18 12:25:59+03:00,['c2f2320ca3361d72b8bef8f622e87e7354a9db28'],1,4,5,20931871,1,0,1,0,20471
424e07a5e5735c72b1e4452a135dca71e17e4c29,0,Oleg Nechiporenko,2015-08-18 12:38:50+03:00,['5c99c9b0766d99cf3f3a26a0fe0f493a478deec4'],8,27,35,20931906,1,0,1,1,20471
febf93bd3f2bd2a88df6637e6924dda6518bc0f3,0,Aleksandr Kovalenko,2015-08-18 14:04:56+03:00,['424e07a5e5735c72b1e4452a135dca71e17e4c29'],4,5,9,20931915,2,1,1,1,20471
c956f210caa927dfaccce7d0e5122fc64fa0887b,0,Oleg Nechiporenko,2015-08-18 14:17:00+03:00,['febf93bd3f2bd2a88df6637e6924dda6518bc0f3'],8,45,53,20931968,1,1,1,1,20471
a6a0a5caa277a8b67e52329f3633f62eca684547,0,Aleksandr Kovalenko,2015-08-18 15:49:44+03:00,['c956f210caa927dfaccce7d0e5122fc64fa0887b'],2,2,4,20931972,2,,,,20471
0db24d6b8b35a510c7ccd982c8acfa1ff1a475e2,1,Dmytro Sen,2015-08-18 16:02:40+03:00,['a6a0a5caa277a8b67e52329f3633f62eca684547'],0,4,4,20931976,1,0,0,1,20471
9492207a1f4e1f3d2fd8c5e8a9cf9183cc948bed,1,Alejandro Fernandez,2015-08-18 10:44:00-07:00,['0db24d6b8b35a510c7ccd982c8acfa1ff1a475e2'],3,3,6,20931982,3,,,,20471
8d39c2a5f32bf6a5dcf39a23b3393cf8df669d01,1,Richard Zang,2015-08-18 11:37:00-07:00,['9492207a1f4e1f3d2fd8c5e8a9cf9183cc948bed'],10,17,27,20932009,1,0,0,0,20471
afe86bdf4b71eb105264bc0c76afc63f73cc8eb2,0,Siddharth Wagle,2015-08-18 14:30:48-07:00,['8d39c2a5f32bf6a5dcf39a23b3393cf8df669d01'],6,5,11,20932020,2,,,,20471
3043933b008b349ff9735355c9056ebe37722e24,1,Andrii Tkach,2015-08-19 13:28:02+03:00,['afe86bdf4b71eb105264bc0c76afc63f73cc8eb2'],1,1,2,20932022,1,0,0,0,20471
9a8d5d9928b1b4ebfa7a57753f735282cafe9e03,1,Dmytro Sen,2015-08-19 14:58:06+03:00,['3043933b008b349ff9735355c9056ebe37722e24'],3,3,6,20932028,3,,,,20471
8abab3106ee86083beb7804fa56b53d5ff5bed46,1,Lisnichenko Dmitro,2015-08-19 17:11:22+03:00,['9a8d5d9928b1b4ebfa7a57753f735282cafe9e03'],5,5,10,20932038,1,,,,20471
b4991a03ca57ca31edb0820f1930fff93ec3e54b,1,Alex Antonenko,2015-08-19 17:49:11+03:00,['8abab3106ee86083beb7804fa56b53d5ff5bed46'],9,73,82,20932120,7,0.395348837,0,1,20471
3705d29684db13bba08bfb8b7476761d9784dfcc,1,aBabiichuk,2015-08-19 19:03:34+03:00,['b4991a03ca57ca31edb0820f1930fff93ec3e54b'],1445,371,1816,20933936,11,1,0.689944134,0,20472
73a1db1ac6f71d2ed50be7130de52c85bfde03c2,1,Dmytro Sen,2015-08-19 20:39:35+03:00,['3705d29684db13bba08bfb8b7476761d9784dfcc'],21,92,113,20934049,11,0.5,0.108695652,0.826086957,20472
ba7a94fde5088662d9c02f7e3e1a1fc5213b3d23,1,Jayush Luniya,2015-08-19 13:00:30-07:00,['73a1db1ac6f71d2ed50be7130de52c85bfde03c2'],2,61,63,20934112,2,,,,20472
bcbb0ae41e98b9e9c4e1d91383b900525633becb,1,Jayush Luniya,2015-08-19 13:21:27-07:00,['ba7a94fde5088662d9c02f7e3e1a1fc5213b3d23'],12,73,85,20934197,4,1,1,0.846153846,20472
c55b4a61d3806d91be96f787902237eeff9a5e18,0,Dmytro Sen,2015-08-20 00:25:33+03:00,['bcbb0ae41e98b9e9c4e1d91383b900525633becb'],5,455,460,20934657,4,0.35483871,0.817204301,1,20474
0a815fac8f89e9516fa48bc5fa1deec7f2c1877b,0,Dmytro Sen,2015-08-20 00:32:24+03:00,['c55b4a61d3806d91be96f787902237eeff9a5e18'],455,5,460,20935117,4,0.64516129,0.182795699,0,20474
7b39741064b3693290fdc00afed7f746c938af58,1,Jaimin Jetly,2015-08-19 15:20:08-07:00,['0a815fac8f89e9516fa48bc5fa1deec7f2c1877b'],1,21,22,20935139,2,1,1,0,20474
1b803c570103dad7a13ceb308e53da5f70956115,0,Siddharth Wagle,2015-08-19 15:48:06-07:00,['7b39741064b3693290fdc00afed7f746c938af58'],1,1,2,20935141,1,,,,20474
25237d3fe11bc0bd436d20774a4371d7794f7725,1,Jayush Luniya,2015-08-19 20:50:45-07:00,['1b803c570103dad7a13ceb308e53da5f70956115'],17,148,165,20935306,22,0.515789474,1,1,20474
108b4961ebf19e8a7076439bfb65e9de1472022c,1,Jayush Luniya,2015-08-19 22:58:26-07:00,['25237d3fe11bc0bd436d20774a4371d7794f7725'],36,133,169,20935475,4,0,1,1,20474
988d7e1c52f6dbdd04ce6ca7e924a8f8d6c720f2,1,Richard Zang,2015-08-19 23:16:16-07:00,['108b4961ebf19e8a7076439bfb65e9de1472022c'],16,7,23,20935498,3,0,0,0,20474
8c6a57bf1e8f19e929a6d1cddb87675851572adc,0,Jayush Luniya,2015-08-19 23:39:24-07:00,['988d7e1c52f6dbdd04ce6ca7e924a8f8d6c720f2'],52,261,313,20935811,7,0.157894737,0.187969925,0.37593985,20474
12a30799e17cb3e1487a0f67f5b628eaa41172db,1,Vitaly Brodetskyi,2015-08-20 12:16:00+03:00,['8c6a57bf1e8f19e929a6d1cddb87675851572adc'],17,1238,1255,20937066,16,0,0.887417219,0.798013245,20475
ba3547f4c5f22df2d002afdb6f4a98f8194994b3,1,Dmytro Sen,2015-08-20 12:55:42+03:00,['12a30799e17cb3e1487a0f67f5b628eaa41172db'],5,455,460,20937526,4,0.35483871,0.817204301,1,20477
78d04fe4579e30c5bc9eaa7db34a610b897bd2d1,0,Dmytro Sen,2015-08-20 16:09:47+03:00,['ba3547f4c5f22df2d002afdb6f4a98f8194994b3'],1,1,2,20937528,1,,,,20477
0562c9c7d65f8b5e956fdb61852cfb872e824bc7,0,Oleg Nechiporenko,2015-08-20 16:17:44+03:00,['78d04fe4579e30c5bc9eaa7db34a610b897bd2d1'],3,12,15,20937543,2,1,1,1,20477
98727e22cf9074e82c2f1d6df35e7b5919d92f23,1,aBabiichuk,2015-08-20 16:27:04+03:00,['0562c9c7d65f8b5e956fdb61852cfb872e824bc7'],213,53,266,20937809,6,0.965517241,0.413793103,0,20477
4fb5f66dff89b84fcd3ac8f1151ccc3576f7e3b1,1,Oleg Nechiporenko,2015-08-20 18:25:56+03:00,['98727e22cf9074e82c2f1d6df35e7b5919d92f23'],45,102,147,20937956,8,0.52173913,1,1,20477
ba4e1c956ed30a1cd6553af85ddd61d136061f6c,1,Alejandro Fernandez,2015-08-20 10:36:34-07:00,['4fb5f66dff89b84fcd3ac8f1151ccc3576f7e3b1'],17,26,43,20937999,3,0,0.444444444,0.666666667,20477
a4d5ebc31b05a39c5d905ccbe07ff1666eef1003,0,Alejandro Fernandez,2015-08-20 10:45:27-07:00,['ba4e1c956ed30a1cd6553af85ddd61d136061f6c'],2,2,4,20938003,1,,,,20477
30d9dcf4110f3ca02afa91fee4386ce16ab39a06,0,Jayush Luniya,2015-08-20 10:53:54-07:00,['a4d5ebc31b05a39c5d905ccbe07ff1666eef1003'],0,12,12,20938015,1,,,,20477
0bfb1ccf327b3392638d8aaf9802a2875658dcdb,1,Yusaku Sako,2015-08-20 11:16:56-07:00,['30d9dcf4110f3ca02afa91fee4386ce16ab39a06'],12,25,37,20938052,4,1,1,1,20477
df98f0b53c3f78fb9f9e0b82eab77d7131e5a623,1,Dmytro Sen,2015-08-20 21:23:23+03:00,['0bfb1ccf327b3392638d8aaf9802a2875658dcdb'],11,8,19,20938071,1,1,1,0,20477
75bab5ae003eb57d4d57e24ba456a561de6c4c9e,1,Yusaku Sako,2015-08-20 11:28:09-07:00,['df98f0b53c3f78fb9f9e0b82eab77d7131e5a623'],1,1,2,20938073,1,,,,20477
2b1a0f62d7e1636942d862b37eaf28349ef30a60,1,Dmytro Sen,2015-08-20 21:33:05+03:00,['75bab5ae003eb57d4d57e24ba456a561de6c4c9e'],2,14,16,20938089,5,0.222222222,1,1,20477
593c0b2c9cfce925ea05e9f2690bc50e93ae7433,1,Alex Antonenko,2015-08-20 23:46:55+03:00,['2b1a0f62d7e1636942d862b37eaf28349ef30a60'],25,18,43,20938132,3,0,0,0,20477
0d4a1657857de12b3ff9b9359c97d8ea62303826,1,Alex Antonenko,2015-08-20 23:46:55+03:00,['593c0b2c9cfce925ea05e9f2690bc50e93ae7433'],6,6,12,20938144,6,,,,20477
4e5adb2656c6a09006f40765a2ac249e14f622ad,1,Jaimin Jetly,2015-08-20 17:01:04-07:00,['0d4a1657857de12b3ff9b9359c97d8ea62303826'],2,3,5,20938149,3,1,1,1,20477
188d39c2e71efbdd007508c6eca0c97ba15d5bda,1,Xi Wang,2015-08-20 17:37:49-07:00,['4e5adb2656c6a09006f40765a2ac249e14f622ad'],1,1,2,20938151,1,,,,20477
995343371f0fdc4088881e5b0aacdb56b7156e88,1,Artem Baranchuk,2015-08-21 12:12:35+03:00,['188d39c2e71efbdd007508c6eca0c97ba15d5bda'],31,47,78,20938229,1,1,1,1,20477
66d0b6e2c136335841fb99a47d5122ebde18d046,1,Oleg Nechiporenko,2015-08-21 13:07:57+03:00,['995343371f0fdc4088881e5b0aacdb56b7156e88'],30,69,99,20938328,17,,,,20478
eadde3d5806b71eacc1540fc4e4dbec31412b3f7,0,Oleg Nechiporenko,2015-08-21 13:14:15+03:00,['66d0b6e2c136335841fb99a47d5122ebde18d046'],1,1,2,20938330,1,,,,20478
762f7d9e47479fa2b19fd23a7593d57a117052c0,0,Alex Antonenko,2015-08-21 15:22:35+03:00,['eadde3d5806b71eacc1540fc4e4dbec31412b3f7'],15,0,15,20938345,1,,,,20478
00ba98448bccdf8814b87aad4f353242f51a3dd9,1,aBabiichuk,2015-08-21 15:50:09+03:00,['762f7d9e47479fa2b19fd23a7593d57a117052c0'],8,8,16,20938361,4,,,,20478
c30cca0b95b706850048c603dfa3c54916de43ed,1,Dmytro Sen,2015-08-21 17:24:58+03:00,['00ba98448bccdf8814b87aad4f353242f51a3dd9'],7,10,17,20938378,4,0,1,1,20478
485bd8af0dbbe206b130f1736110bee6827b60f1,1,Dmytro Sen,2015-08-21 17:41:12+03:00,['c30cca0b95b706850048c603dfa3c54916de43ed'],17,104,121,20938499,9,0.014925373,0.611940299,1,20478
a696f9ffda285f5711a77a40605f478731f1c1f3,1,Dmytro Sen,2015-08-21 17:44:51+03:00,['485bd8af0dbbe206b130f1736110bee6827b60f1'],0,5,5,20938504,1,,,,20478
991feb736702af00332133e369e5ffde3a65f4b1,1,Jayush Luniya,2015-08-21 11:28:57-07:00,['a696f9ffda285f5711a77a40605f478731f1c1f3'],10,14,24,20938528,4,,,0,20478
2ba8d67a4dd1ebbc66fa4f49a561f7d693d6628d,1,Richard Zang,2015-08-21 12:02:23-07:00,['991feb736702af00332133e369e5ffde3a65f4b1'],1,1,2,20938530,1,,0,,20478
4ab90629f37a1fe9f817f4a134584035018b879e,1,Jonathan Hurley,2015-08-21 15:20:46-04:00,['2ba8d67a4dd1ebbc66fa4f49a561f7d693d6628d'],355,425,780,20939310,9,0,0.391304348,1,20478
64bb08688b872b78243994f7d5bf09a531c2a8c8,1,Xi Wang,2015-08-21 16:04:27-07:00,['4ab90629f37a1fe9f817f4a134584035018b879e'],5,60,65,20939375,2,0,0.62745098,0.823529412,20478
712d74bef59a9badb1065772e740d00407b409c4,1,Vitaly Brodetskyi,2015-08-22 23:18:17+03:00,['64bb08688b872b78243994f7d5bf09a531c2a8c8'],19,45,64,20939439,3,0,0,0,20478
488192adaed3d6b5a3ddb3d8d77bba1a1fb18976,1,Myroslav Papirkovskyy,2015-08-23 23:21:43+03:00,['712d74bef59a9badb1065772e740d00407b409c4'],38,1429,1467,20940906,10,0.543103448,0.896551724,0.767241379,20480
c447418762806513d5168bb841935a5dff08a226,0,Vitaly Brodetskyi,2015-08-24 08:38:03+03:00,['488192adaed3d6b5a3ddb3d8d77bba1a1fb18976'],7,2,9,20940915,3,,,,20480
98ff9e735ca98216376bf0789038a4d8d679705a,1,Aleksandr Kovalenko,2015-08-24 14:15:08+03:00,['c447418762806513d5168bb841935a5dff08a226'],30,74,104,20941019,7,1,1,1,20481
0c5c1c789b08973683e1c088f94fb47c8896214f,0,Jayush Luniya,2015-08-24 08:33:04-07:00,['98ff9e735ca98216376bf0789038a4d8d679705a'],0,26,26,20941045,2,,,,20481
274616eb86066372dd714cc8c54a641a0b4f01b1,1,Srimanth Gunturi,2015-08-24 13:46:47-07:00,['0c5c1c789b08973683e1c088f94fb47c8896214f'],1,31,32,20941077,4,0.428571429,0.428571429,1,20481
fc0078f8f30aa1973cea9d697c8fac46b437bc92,1,Nate Cole,2015-08-24 16:57:06-04:00,['274616eb86066372dd714cc8c54a641a0b4f01b1'],4,45,49,20941126,6,0.176470588,1,1,20481
b5a309b9fee6fac78c279113d7818d4914c9926a,0,Srimanth Gunturi,2015-08-24 14:01:31-07:00,['fc0078f8f30aa1973cea9d697c8fac46b437bc92'],0,1,1,20941127,1,,,,20481
0817eec9d26b787f68c3ce7ea16a9d3a07c93f05,0,Yusaku Sako,2015-08-24 14:27:09-07:00,['b5a309b9fee6fac78c279113d7818d4914c9926a'],2,130,132,20941259,1,,,,20481
2e4c0785397c6c28292923f5b3dc042c24d8cd1b,1,Vitaly Brodetskyi,2015-08-25 13:29:06+03:00,['0817eec9d26b787f68c3ce7ea16a9d3a07c93f05'],1,1,2,20941261,1,,,,20481
8b82c1bd857946dc340a21a67b3d20a09b38e1c0,1,Lisnichenko Dmitro,2015-08-25 13:48:52+03:00,['2e4c0785397c6c28292923f5b3dc042c24d8cd1b'],2,12,14,20941275,2,0,0,1,20481
fef858b70961dcad084a121a9156cdfacb9c30ea,1,Oleg Nechiporenko,2015-08-25 14:00:27+03:00,['8b82c1bd857946dc340a21a67b3d20a09b38e1c0'],95,204,299,20941574,10,1,0.890625,1,20481
e6ad02fe3144124bd640e604f438ee45cde8daf0,1,Oleg Nechiporenko,2015-08-25 14:04:28+03:00,['fef858b70961dcad084a121a9156cdfacb9c30ea'],102,141,243,20941817,16,1,0.785714286,1,20481
cdb98f73bd1827f6e6ad0c3670705473abb7d3f3,1,Andrew Onishuk,2015-08-25 14:55:57+03:00,['e6ad02fe3144124bd640e604f438ee45cde8daf0'],0,4,4,20941821,1,,,,20481
5b0acfbdc0fd1da0ee71ca232ff0dd647f435278,1,Artem Baranchuk,2015-08-25 15:06:41+03:00,['cdb98f73bd1827f6e6ad0c3670705473abb7d3f3'],12,23,35,20941856,3,,,,20481
bba679959b3edc16db507faeacd84d33167bbcf4,1,Jonathan Hurley,2015-08-25 09:03:24-04:00,['5b0acfbdc0fd1da0ee71ca232ff0dd647f435278'],54,76,130,20941986,3,0.5,1,1,20481
9b3fff2fc1fff130633f577b8429281c824baa82,0,Oleg Nechiporenko,2015-08-25 16:21:43+03:00,['bba679959b3edc16db507faeacd84d33167bbcf4'],15,14,29,20942015,6,,,,20481
fc9a2725962a2d4feae229e2ea66a94d1540a32a,1,Srimanth Gunturi,2015-08-25 11:22:14-07:00,['9b3fff2fc1fff130633f577b8429281c824baa82'],43,53,96,20942111,3,0,1,1,20481
ec5d18d4a2bdc0c562c71bafd886fbe9ea1948e9,0,Nate Cole,2015-08-25 15:23:44-04:00,['fc9a2725962a2d4feae229e2ea66a94d1540a32a'],0,34,34,20942145,1,,,,20481
4d731f73f025bf7b9996e04646468def92edcaaa,0,Yusaku Sako,2015-08-25 12:52:47-07:00,['ec5d18d4a2bdc0c562c71bafd886fbe9ea1948e9'],0,8,8,20942153,1,,,,20481
153ecfa56f4a388df9efb487afce156ef50baf7c,0,Yusaku Sako,2015-08-25 13:04:57-07:00,['4d731f73f025bf7b9996e04646468def92edcaaa'],1,1,2,20942155,1,,,,20481
e60dbb4e0dbc4be8bf6905dbbd2567a9270aac69,1,Siddharth Wagle,2015-08-25 13:41:02-07:00,['153ecfa56f4a388df9efb487afce156ef50baf7c'],1999,94,2093,20944248,9,0.217391304,0.652173913,1,20481
7852bc431565acea04a2b0df5ac43b673e4ec1a1,1,Alejandro Fernandez,2015-08-25 14:40:04-07:00,['e60dbb4e0dbc4be8bf6905dbbd2567a9270aac69'],20,55,75,20944323,9,0,1,1,20481
8fc7155ceefae88d345c2c8383b9e533adc13613,0,Jaimin Jetly,2015-08-25 17:26:04-07:00,['7852bc431565acea04a2b0df5ac43b673e4ec1a1'],1,1,2,20944325,1,,,,20481
fac57e538fb75d9107b011fc4da1a6143c091faf,1,Sumit Mohanty,2015-08-25 17:56:57-07:00,['8fc7155ceefae88d345c2c8383b9e533adc13613'],0,6,6,20944331,2,,,,20481
6ccabc61e451347d1b3168d8fe1eb7a98d6bd6b6,1,Andrew Onishuk,2015-08-26 12:30:49+03:00,['fac57e538fb75d9107b011fc4da1a6143c091faf'],25,5,30,20944361,2,1,0.1,0.9,20481
76990f4a8b0d48e1a2987f314d57ea0efae86005,0,Andrew Onishuk,2015-08-26 14:11:42+03:00,['6ccabc61e451347d1b3168d8fe1eb7a98d6bd6b6'],1,5,6,20944367,2,,,,20481
adc32c91e7ebf316bd04b50bfac63e88db2133d5,1,Vitaly Brodetskyi,2015-08-26 14:34:51+03:00,['76990f4a8b0d48e1a2987f314d57ea0efae86005'],8,118,126,20944493,6,0,0.066666667,0.066666667,20482
5d159a376d2315f08aa579e47bf35a1fa2d3c47b,1,Oleg Nechiporenko,2015-08-26 14:37:39+03:00,['adc32c91e7ebf316bd04b50bfac63e88db2133d5'],5,151,156,20944649,8,0.817307692,1,1,20482
7819edfd176c96e3471632363e3e53febed76d1c,1,Andrii Tkach,2015-08-26 18:04:48+03:00,['5d159a376d2315f08aa579e47bf35a1fa2d3c47b'],693,244,937,20945586,18,0.046082949,0.082949309,0,20482
bbb042f32d5b7bb3937d6426f16243fd27effb45,1,Jayush Luniya,2015-08-26 08:48:49-07:00,['7819edfd176c96e3471632363e3e53febed76d1c'],4,73,77,20945663,4,0,0,1,20482
24e752b942afc73335f828d26fd95accbc1e8e2e,1,Jayush Luniya,2015-08-26 08:57:45-07:00,['bbb042f32d5b7bb3937d6426f16243fd27effb45'],1,23,24,20945687,2,,,,20482
d7f3f31a6e70af12d632382bc92d9dded4b1e020,1,Jayush Luniya,2015-08-26 14:52:59-07:00,['24e752b942afc73335f828d26fd95accbc1e8e2e'],46,1,47,20945734,2,0,0,0.518518519,20482
892270d0df9c9f4e708c0d74da7af294a9988289,1,Jaimin Jetly,2015-08-26 16:22:36-07:00,['d7f3f31a6e70af12d632382bc92d9dded4b1e020'],91,102,193,20945927,2,0.166666667,0,0,20482
84339970bbca782bbf05e0382d7cfa95b06ad438,0,Xi Wang,2015-08-26 18:01:12-07:00,['892270d0df9c9f4e708c0d74da7af294a9988289'],2,7,9,20945936,2,,,,20482
4c73ea906d02df2c79ef76f5cf6fd2b94ea78ca6,1,Sumit Mohanty,2015-08-26 18:04:36-07:00,['84339970bbca782bbf05e0382d7cfa95b06ad438'],73,4,77,20946013,4,1,1,0,20482
89ca3be22aaecd466a537259a2f73bc85525f18a,0,Andrii Tkach,2015-08-27 10:41:36+03:00,['4c73ea906d02df2c79ef76f5cf6fd2b94ea78ca6'],0,4,4,20946017,1,1,1,1,20482
34b4f9e267b9502c69ce84c0deca279a2b624bc4,0,Dmytro Sen,2015-08-27 12:22:13+03:00,['89ca3be22aaecd466a537259a2f73bc85525f18a'],0,1,1,20946018,1,,,,20482
a54812b44bc38ae9e96f9d7fa654abcfb8aefb34,1,Dmytro Sen,2015-08-27 13:23:31+03:00,['34b4f9e267b9502c69ce84c0deca279a2b624bc4'],4,137,141,20946159,2,0,1,1,20482
2ec1f8558283f64cde6bab32032bdf07778d3255,0,Andrew Onishuk,2015-08-27 15:38:47+03:00,['a54812b44bc38ae9e96f9d7fa654abcfb8aefb34'],0,6,6,20946165,1,,,,20482
b0137be7ab9e0388e6266b1911976ec253747ac9,1,Andrew Onishuk,2015-08-27 15:45:57+03:00,['2ec1f8558283f64cde6bab32032bdf07778d3255'],2,10,12,20946177,3,0,0,0,20482
6e8d00cffba54e3983b4a0c251b6ff88424998c2,1,Dmytro Sen,2015-08-27 15:53:18+03:00,['b0137be7ab9e0388e6266b1911976ec253747ac9'],7,39,46,20946223,3,0,0.5,1,20482
e0a78028b4484b8238c58b8d8eef8054f604e654,0,Andrew Onishuk,2015-08-27 15:58:04+03:00,['6e8d00cffba54e3983b4a0c251b6ff88424998c2'],2,2,4,20946227,1,,,,20482
d02fa761665b896d87751294471c3054d5a294f2,1,Dmytro Sen,2015-08-27 16:46:00+03:00,['e0a78028b4484b8238c58b8d8eef8054f604e654'],5,81,86,20946313,12,0.75,0.925,0.95,20482
a71c52838207b2846cb04e02ce34d80aea44a206,1,Vitaly Brodetskyi,2015-08-27 21:15:42+03:00,['d02fa761665b896d87751294471c3054d5a294f2'],3,2,5,20946318,1,1,1,1,20482
3b5efe48706f34ad5f89290d45ae16980237d5ce,1,Jonathan Hurley,2015-08-27 15:22:57-04:00,['a71c52838207b2846cb04e02ce34d80aea44a206'],57,164,221,20946539,5,0.217391304,0.304347826,1,20482
59dd207c39968df161341568f7538b9e3a990de2,1,Jonathan Hurley,2015-08-27 15:22:58-04:00,['3b5efe48706f34ad5f89290d45ae16980237d5ce'],51,111,162,20946701,4,0,0,1,20482
a19c9258104f6fa767dfc7af2c17872d17d2cb85,0,Jaimin Jetly,2015-08-27 16:26:08-07:00,['59dd207c39968df161341568f7538b9e3a990de2'],1,1,2,20946703,1,,,,20482
97c4bc5ec4877c7b516ee4d921254c5f694b3506,1,Jaimin Jetly,2015-08-27 16:51:15-07:00,['a19c9258104f6fa767dfc7af2c17872d17d2cb85'],3,3,6,20946709,1,,,,20482
60d3a7613b0c011f987a6c18aa6ee376a40f5461,1,Alejandro Fernandez,2015-08-27 17:05:24-07:00,['97c4bc5ec4877c7b516ee4d921254c5f694b3506'],63,238,301,20947010,16,0.084745763,0,0.983050847,20482
b39288aab9a8d92e35360c376f4b9da97d934c72,1,Jayush Luniya,2015-08-27 20:14:16-07:00,['60d3a7613b0c011f987a6c18aa6ee376a40f5461'],0,477,477,20947487,2,0.030769231,0,1,20483
49c052e59343283828858d723573d7ba4c59a8d9,1,Dmytro Sen,2015-08-28 12:28:00+03:00,['b39288aab9a8d92e35360c376f4b9da97d934c72'],4,4,8,20947495,3,,,,20483
85c87bffae1d24d0aeb0170427b8dd775b23f79b,0,Andrew Onishuk,2015-08-28 12:28:21+03:00,['49c052e59343283828858d723573d7ba4c59a8d9'],4,8,12,20947507,1,,,,20483
cd3a55783dc76803b644902da142f0509c5e808f,0,Andrii Tkach,2015-08-28 12:35:54+03:00,['85c87bffae1d24d0aeb0170427b8dd775b23f79b'],1,37,38,20947545,1,1,1,1,20483
f4286d596a07f29a53585e59344e311f63f3b780,0,Oleg Nechiporenko,2015-08-28 13:08:51+03:00,['cd3a55783dc76803b644902da142f0509c5e808f'],1,1,2,20947547,1,,,,20483
6fc31441476879fb668bc47f6d0c00d18cba4fd7,1,Oleg Nechiporenko,2015-08-28 13:10:41+03:00,['f4286d596a07f29a53585e59344e311f63f3b780'],1,3,4,20947551,1,1,1,1,20483
04d0eae4cd789eb8e983e08a6f7bce7989df2b52,1,Alex Antonenko,2015-08-28 13:14:47+03:00,['6fc31441476879fb668bc47f6d0c00d18cba4fd7'],11,175,186,20947737,8,0.626666667,0.626666667,1,20483
a8786789ff43a848dae2788a33d1bc577d49ca38,1,Dmytro Sen,2015-08-28 16:48:33+03:00,['04d0eae4cd789eb8e983e08a6f7bce7989df2b52'],12,12,24,20947761,1,,,,20483
92d345591b3fcd28d54a1f28104939b09cdeb376,1,Dmytro Sen,2015-08-28 17:14:24+03:00,['a8786789ff43a848dae2788a33d1bc577d49ca38'],1,1,2,20947763,1,,,,20483
48ba8e15d628f55f991d57e6093237bb83a2f3e4,1,Alex Antonenko,2015-08-28 17:55:45+03:00,['92d345591b3fcd28d54a1f28104939b09cdeb376'],4,6,10,20947773,1,1,1,1,20483
3bccd97a78e7c10c6e93d2e157bed267fe2ecae4,1,Alex Antonenko,2015-08-28 19:01:10+03:00,['48ba8e15d628f55f991d57e6093237bb83a2f3e4'],2,17,19,20947792,1,0,0,0,20483
c472279bf6f58a8debfe28352b41067efc74af85,1,Jayush Luniya,2015-08-28 11:29:40-07:00,['3bccd97a78e7c10c6e93d2e157bed267fe2ecae4'],1,24,25,20947817,3,0,0,1,20484
08b8cdd93ded4461a790530aa2060d84447b23bf,0,Nate Cole,2015-08-28 15:03:23-04:00,['c472279bf6f58a8debfe28352b41067efc74af85'],6,8,14,20947831,4,,,,20484
6bae723eb49806012d7081262d81bf655d628195,0,Jayush Luniya,2015-08-28 14:52:54-07:00,['08b8cdd93ded4461a790530aa2060d84447b23bf'],7,7,14,20947845,1,,,,20484
ab72beede0ebb7563c59e97a1fa62876d5f3d354,1,Jaimin Jetly,2015-08-28 15:01:40-07:00,['6bae723eb49806012d7081262d81bf655d628195'],2,2,4,20947849,1,,,,20484
7493d18ddad526f9c04aafd0acf8aa70bc52ee32,1,Jaimin Jetly,2015-08-28 15:03:42-07:00,['ab72beede0ebb7563c59e97a1fa62876d5f3d354'],2,9,11,20947860,1,1,0,1,20484
24d5ce92075d75a3ff812dc3e391c3c114160e5b,1,Vitaly Brodetskyi,2015-08-29 12:58:15+03:00,['7493d18ddad526f9c04aafd0acf8aa70bc52ee32'],19,20,39,20947899,3,0,1,1,20484
1d2e6e667b70b848880d7aba9d1713c40999eae7,0,aBabiichuk,2015-08-31 13:38:13+03:00,['24d5ce92075d75a3ff812dc3e391c3c114160e5b'],68,0,68,20947967,2,0.639344262,0.31147541,0,20484
0e675ff28914f461ec19b0b98539c5e6583cb33e,1,Dmytro Sen,2015-08-31 15:13:48+03:00,['1d2e6e667b70b848880d7aba9d1713c40999eae7'],34,73,107,20948074,4,0,0.130434783,1,20484
10e58173e7f869b640d0706eb745a98e26fb6dc6,1,Alex Antonenko,2015-08-31 15:40:38+03:00,['0e675ff28914f461ec19b0b98539c5e6583cb33e'],1,1,2,20948076,1,,,,20484
fb6ae2c19950ccdf091b110e5c71d92b0491d940,1,Dmytro Sen,2015-08-31 16:21:00+03:00,['10e58173e7f869b640d0706eb745a98e26fb6dc6'],0,5,5,20948081,1,,,,20484
0e4d7540668e8612403d6a5cbd97621a075e1432,1,Andrew Onishuk,2015-08-31 16:40:23+03:00,['fb6ae2c19950ccdf091b110e5c71d92b0491d940'],33,47,80,20948161,2,0,0.333333333,0.666666667,20484
f0109402d536543915e251f4605847f80c79433f,0,Vitaly Brodetskyi,2015-08-31 17:43:19+03:00,['0e4d7540668e8612403d6a5cbd97621a075e1432'],28,27,55,20948216,5,1,0.166666667,0,20484
016cbb6e9f4fbcaa4a1387a9bb474086c6b0f7f8,1,Jonathan Hurley,2015-08-31 10:47:06-04:00,['f0109402d536543915e251f4605847f80c79433f'],26,96,122,20948338,4,0,0.8125,0.9375,20484
74a29e47c6a0c401c23b73befa478b27e6bbc083,1,Dmytro Sen,2015-08-31 17:49:16+03:00,['016cbb6e9f4fbcaa4a1387a9bb474086c6b0f7f8'],2,2,4,20948342,2,,,,20484
c42aad3d309faed920ab03e403f82ff02c025de0,1,Vitaly Brodetskyi,2015-08-31 18:27:05+03:00,['74a29e47c6a0c401c23b73befa478b27e6bbc083'],1,4,5,20948347,1,,,,20484
9a5dc13f065b92fe9870311f4cafe55e03bb58d3,1,Alex Antonenko,2015-08-31 19:16:59+03:00,['c42aad3d309faed920ab03e403f82ff02c025de0'],1,2,3,20948350,1,,,,20484
59bc26139325ab0d85c4afe9a6d389064a3e8bd5,1,Andrew Onishuk,2015-08-31 20:01:00+03:00,['9a5dc13f065b92fe9870311f4cafe55e03bb58d3'],2,6,8,20948358,2,0,0.75,1,20484
bcd5cfb66c40788f77ad27b7fa4c1e8f1feb1adb,0,Yusaku Sako,2015-08-31 12:34:12-07:00,['fc64eae4f59786cb190c61a5a5156d42f90fa203'],4,6,10,20948426,1,0,1,1,20484
f3f7e09aae29091ea659fd5e9ae2e938ab4872c5,1,Jaimin Jetly,2015-08-31 13:32:12-07:00,['bcd5cfb66c40788f77ad27b7fa4c1e8f1feb1adb'],4,4,8,20948434,2,,,,20484
6cc7781bb6722021252252f0589040bfc3f6dedd,1,Srimanth Gunturi,2015-08-31 13:53:50-07:00,['f3f7e09aae29091ea659fd5e9ae2e938ab4872c5'],47,47,94,20948528,9,1,1,1,20484
ef44337d0befa328896f35165e9f975d44524638,0,Srimanth Gunturi,2015-08-31 13:54:30-07:00,['6cc7781bb6722021252252f0589040bfc3f6dedd'],1,1,2,20948530,1,,,,20484
ba04e8df9385a3171adf5c3e296cf3782c6b93cc,1,Yusaku Sako,2015-08-31 14:11:22-07:00,['ef44337d0befa328896f35165e9f975d44524638'],43,418,461,20948991,3,0.612334802,0.929515419,1,20485
55b13a9dd1179f135c5a7cf3b609ce646bbff0f3,1,Jayush Luniya,2015-08-31 16:40:17-07:00,['ba04e8df9385a3171adf5c3e296cf3782c6b93cc'],43,421,464,20949455,10,1,0.055555556,0,20491
08d94f18379e67c752323a65cec230772c2b23ed,1,Jayush Luniya,2015-08-31 17:59:08-07:00,['55b13a9dd1179f135c5a7cf3b609ce646bbff0f3'],0,15,15,20949470,1,,,,20491
8631fdce4ea0cb4287d370db23e5b5042215ef5e,0,Sumit Mohanty,2015-08-31 18:13:01-07:00,['08d94f18379e67c752323a65cec230772c2b23ed'],18,255,273,20949743,22,0.666666667,0.9375,0.958333333,20496
d145dd6dcaf354ba053ab36220d3271f1a9ca81e,0,Jayush Luniya,2015-08-31 22:13:40-07:00,['8631fdce4ea0cb4287d370db23e5b5042215ef5e'],7,53,60,20949803,4,0.024390244,0.365853659,0,20496
d81c7de319f78ebfcaceaac23acce5bebe8293a7,1,Vitaly Brodetskyi,2015-09-01 12:02:52+03:00,['d145dd6dcaf354ba053ab36220d3271f1a9ca81e'],6,7,13,20949816,2,0,0,0,20496
de21b29c2e76d11a7e07561686e7e05235e76a2f,1,Vitaly Brodetskyi,2015-09-01 12:42:09+03:00,['d81c7de319f78ebfcaceaac23acce5bebe8293a7'],17,62,79,20949895,1,0.518518519,0.518518519,0.851851852,20496
4eb219b8a9fbc4b086eb8c22fe4b6e22bcfb7e33,0,Oleg Nechiporenko,2015-09-01 14:07:33+03:00,['de21b29c2e76d11a7e07561686e7e05235e76a2f'],0,5,5,20949900,1,0,1,1,20496
e6fb3934badaad9d3e93efbdff2bd77d0b025c1b,0,Andrew Onishuk,2015-09-01 15:13:05+03:00,['4eb219b8a9fbc4b086eb8c22fe4b6e22bcfb7e33'],3,4,7,20949907,2,,,,20496
2e543abc65f7f01c94ce8bde61aafd7a64b93f88,1,Alex Antonenko,2015-09-01 15:20:52+03:00,['e6fb3934badaad9d3e93efbdff2bd77d0b025c1b'],0,1,1,20949908,1,1,1,1,20496
7ffd863e4a6b40dfa0ce0b116acbc7961d7ba349,0,Alex Antonenko,2015-09-01 15:26:17+03:00,['2e543abc65f7f01c94ce8bde61aafd7a64b93f88'],5,76,81,20949989,2,,,,20496
a7dfbfa45c274aec6d4bd24c676b8ec8b8c7a689,1,aBabiichuk,2015-09-01 16:36:25+03:00,['7ffd863e4a6b40dfa0ce0b116acbc7961d7ba349'],1,4,5,20949994,2,0.666666667,0.666666667,1,20496
ee53343d507565e75238c984f794e821f37fd630,1,Andrew Onishuk,2015-09-01 17:45:41+03:00,['a7dfbfa45c274aec6d4bd24c676b8ec8b8c7a689'],3,15,18,20950012,3,,,,20496
35bc58de3e7e882e6607103fcc2f3ccd1b951ac5,0,Andrew Onishuk,2015-09-01 18:02:49+03:00,['ee53343d507565e75238c984f794e821f37fd630'],1,1,2,20950014,1,,,,20496
9b23a9b49e5ee79b7a10b865557291d476bad468,1,Alex Antonenko,2015-09-01 18:05:59+03:00,['35bc58de3e7e882e6607103fcc2f3ccd1b951ac5'],1,41,42,20950056,5,0,1,1,20496
9a05ae6a9b630b3873784fa25e84b333c98ebbcf,0,Alex Antonenko,2015-09-01 18:31:10+03:00,['9b23a9b49e5ee79b7a10b865557291d476bad468'],4,6,10,20950066,1,0,0,0,20496
7680d7e74dbb20ac7b40692d96f11206397ad4c9,1,Myroslav Papirkovskyy,2015-09-01 18:42:40+03:00,['9a05ae6a9b630b3873784fa25e84b333c98ebbcf'],20,100,120,20950186,6,0.125,0,0.875,20496
c85f044ff2b2c7f8d13f727f91e230952d96ab17,0,Myroslav Papirkovskyy,2015-09-01 21:32:10+03:00,['7680d7e74dbb20ac7b40692d96f11206397ad4c9'],2,7,9,20950195,1,0,0,1,20496
5cdf4e911b668648f167655ee2cc187ead0b62a8,1,Yusaku Sako,2015-09-01 15:52:26-07:00,['c85f044ff2b2c7f8d13f727f91e230952d96ab17'],49,395,444,20950639,9,0.66,0.892,1,20496
25b0f3ea2d36ead842990dc73de28155f708d233,0,Siddharth Wagle,2015-09-01 17:07:33-07:00,['5cdf4e911b668648f167655ee2cc187ead0b62a8'],23,9,32,20950671,1,0,0,0,20496
205e45d53f9baf79848fb6bf9a3d20136657a65f,1,Jaimin Jetly,2015-09-01 17:51:50-07:00,['25b0f3ea2d36ead842990dc73de28155f708d233'],2,13,15,20950686,2,1,1,1,20496
ac06e6d839009d802357a5fcdf45dd493d782906,1,Vitaly Brodetskyi,2015-09-02 13:48:25+03:00,['205e45d53f9baf79848fb6bf9a3d20136657a65f'],1,70,71,20950757,2,0.6,0.6,1,20496
f917a88f8a9f7f5a5918e51a0bd91ff1ef0679ea,1,Andrii Tkach,2015-09-02 14:07:42+03:00,['ac06e6d839009d802357a5fcdf45dd493d782906'],6,19,25,20950782,2,0,0,1,20496
c93d2b932e78bc24c12a615ed2037e6ad186a50a,1,aBabiichuk,2015-09-02 15:43:56+03:00,['f917a88f8a9f7f5a5918e51a0bd91ff1ef0679ea'],5,38,43,20950825,4,0.272727273,0.272727273,1,20496
32d485ae169da97272c555eea9a2b3c774bd0a51,1,Myroslav Papirkovskyy,2015-09-02 16:17:29+03:00,['c93d2b932e78bc24c12a615ed2037e6ad186a50a'],1,5,6,20950831,1,,,,20496
133535e6efdba81d8c9c8f38fb8c5253b294901f,0,Vitaly Brodetskyi,2015-09-02 16:33:00+03:00,['32d485ae169da97272c555eea9a2b3c774bd0a51'],60,10,70,20950901,1,,,,20496
d2e92bbdd6b99ba26a3e5da92359df6da85586c6,1,Andrew Onishuk,2015-09-02 18:52:02+03:00,['133535e6efdba81d8c9c8f38fb8c5253b294901f'],14,18,32,20950933,2,,,,20496
c3d1306af8683ef0a8528c3bdcadc33e012f484c,1,Sumit Mohanty,2015-09-02 09:35:42-07:00,['d2e92bbdd6b99ba26a3e5da92359df6da85586c6'],24,60,84,20951017,12,0,0.705882353,0.676470588,20496
58fdcb5c9224d3ecfd133f7a453a32d48fc74c2d,1,Andrew Onishuk,2015-09-02 21:46:49+03:00,['c3d1306af8683ef0a8528c3bdcadc33e012f484c'],5,18,23,20951040,2,0,0.857142857,0.142857143,20496
50b1294985c1c17d74ce12f4a814d51b8d0ad8c6,1,Jayush Luniya,2015-09-02 13:28:19-07:00,['58fdcb5c9224d3ecfd133f7a453a32d48fc74c2d'],2,49,51,20951091,2,1,1,1,20496
0fde6a747c003ab68574958dfa7b5f3ba0d03967,1,Jayush Luniya,2015-09-02 16:04:37-07:00,['50b1294985c1c17d74ce12f4a814d51b8d0ad8c6'],4,30,34,20951125,2,,,,20496
b838dcfb0d43360e1a7116820bd12d7370922bd0,1,Richard Zang,2015-09-02 16:06:44-07:00,['0fde6a747c003ab68574958dfa7b5f3ba0d03967'],8,25,33,20951158,4,1,1,1,20496
b9a0b39ca3390f4a0879d048bf1fbf6be4d73929,0,Jaimin Jetly,2015-09-02 18:08:49-07:00,['b838dcfb0d43360e1a7116820bd12d7370922bd0'],1,1,2,20951160,1,,,,20496
fbbd684e69b2b859b4580038cc011c9cb2ab0141,0,Oleg Nechiporenko,2015-09-03 13:14:40+03:00,['b9a0b39ca3390f4a0879d048bf1fbf6be4d73929'],0,8,8,20951168,2,1,1,1,20496
61098026bf0d44c16837057f7009a630f999d3f5,1,Lisnichenko Dmitro,2015-09-03 13:45:05+03:00,['fbbd684e69b2b859b4580038cc011c9cb2ab0141'],1,522,523,20951691,3,0.075675676,0.578378378,1,20498
7aafe0e59fdabca5153f187f284cd0595a228eee,1,Andrew Onishuk,2015-09-03 14:23:23+03:00,['61098026bf0d44c16837057f7009a630f999d3f5'],5,30,35,20951726,6,1,1,1,20498
42d3c54937405008e180727d2e40629fa569a9f8,0,Andrew Onishuk,2015-09-03 14:51:45+03:00,['7aafe0e59fdabca5153f187f284cd0595a228eee'],1,2,3,20951729,1,0,0,1,20498
6bdcd6c19a5f9fec44d8e38b8c8f83ba0ee6d284,1,Andrew Onishuk,2015-09-03 15:34:58+03:00,['42d3c54937405008e180727d2e40629fa569a9f8'],7,7,14,20951743,2,,,,20498
8b31a26274889281a111255779184c054bce2831,1,Vitaly Brodetskyi,2015-09-03 15:46:31+03:00,['6bdcd6c19a5f9fec44d8e38b8c8f83ba0ee6d284'],0,130,130,20951873,1,,,,20498
c3a81ca000a07246492a3c60665174a1f9e193cb,0,aBabiichuk,2015-09-03 16:53:54+03:00,['8b31a26274889281a111255779184c054bce2831'],4,4,8,20951881,1,,,,20498
2ae7e8f505bf75071af555d9b05222a4f616db5d,1,Alex Antonenko,2015-09-03 18:21:24+03:00,['c3a81ca000a07246492a3c60665174a1f9e193cb'],2,176,178,20952059,5,0,0.85106383,0.85106383,20498
2771d477fd2f2dca3f7fac350758857af7a59bd0,1,Alex Antonenko,2015-09-03 18:21:24+03:00,['2ae7e8f505bf75071af555d9b05222a4f616db5d'],3,29,32,20952091,4,0,0,1,20498
8af7df30ea5e966c5d137f5fb53221ba9b2e046b,1,Vitaly Brodetskyi,2015-09-03 18:38:42+03:00,['2771d477fd2f2dca3f7fac350758857af7a59bd0'],1,5,6,20952097,1,0,0,1,20498
c2d4b1db547b30766ca3da3f0deba7bc40d9b0cb,1,Vitaly Brodetskyi,2015-09-03 20:13:07+03:00,['8af7df30ea5e966c5d137f5fb53221ba9b2e046b'],0,46,46,20952143,1,,,,20498
3e0b8f07c388ad2bd67ef23b6dc313f3fef4d117,1,Siddharth Wagle,2015-09-03 10:31:22-07:00,['c2d4b1db547b30766ca3da3f0deba7bc40d9b0cb'],126,736,862,20953005,20,0.410828025,0.964968153,0.866242038,20501
b8a38d766ec0994c5859ba0ae490d5ecd4156d10,1,Alejandro Fernandez,2015-09-03 11:40:26-07:00,['3e0b8f07c388ad2bd67ef23b6dc313f3fef4d117'],2,198,200,20953205,3,,,,20501
4ff26efb178a2ef410a0ab20a865b6fe76ab8957,1,Sumit Mohanty,2015-09-03 12:57:21-07:00,['b8a38d766ec0994c5859ba0ae490d5ecd4156d10'],34,73,107,20953312,5,0.243902439,0.951219512,0.975609756,20501
bca624057e9a359c35d20a4600ceae3b486d6353,1,Sumit Mohanty,2015-09-03 13:38:04-07:00,['4ff26efb178a2ef410a0ab20a865b6fe76ab8957'],8,8,16,20953328,2,,,,20501
7871a32927cf740034d54635ad3acf03724f0512,0,Jaimin Jetly,2015-09-03 14:50:29-07:00,['bca624057e9a359c35d20a4600ceae3b486d6353'],2,70,72,20953400,2,1,1,1,20501
0e5d3fe73cb6e385a91ecf6a9c510fa169ce31df,1,Jaimin Jetly,2015-09-03 15:32:27-07:00,['7871a32927cf740034d54635ad3acf03724f0512'],8,14,22,20953422,2,1,1,1,20501
a591d233c4cd979d834839ef09121f9ef8d43c6c,0,Jaimin Jetly,2015-09-03 16:13:38-07:00,['0e5d3fe73cb6e385a91ecf6a9c510fa169ce31df'],1,0,1,20953423,1,,,,20501
0263993f69b41e6c322d0872b67c31c35584338f,0,Siddharth Wagle,2015-09-03 16:41:16-07:00,['a591d233c4cd979d834839ef09121f9ef8d43c6c'],11,27,38,20953461,4,,,,20501
a5c247f32eb444a6d63497654e4fe2315a16e424,1,Sumit Mohanty,2015-09-03 17:06:25-07:00,['0263993f69b41e6c322d0872b67c31c35584338f'],6,11,17,20953478,4,,,,20501
5fa8db23c706cc1bbb5dcc8d22dc7bde27cd60e1,0,Richard Zang,2015-09-03 17:25:32-07:00,['a5c247f32eb444a6d63497654e4fe2315a16e424'],8,1,9,20953487,2,0,0,0,20501
a84a5b5ebc4fac761d762e519db3f4d2ccf50973,0,Richard Zang,2015-09-03 17:33:49-07:00,['5fa8db23c706cc1bbb5dcc8d22dc7bde27cd60e1'],1,1,2,20953489,1,,,,20501
09bb34e9d6e723dcd96555d9b31ca987bd2622f0,1,Oleg Nechiporenko,2015-09-04 15:01:35+03:00,['a84a5b5ebc4fac761d762e519db3f4d2ccf50973'],15,76,91,20953580,5,0,0.655172414,1,20501
6b3ff72dc5c0b5396f15bf325922c2327622a572,1,Alex Antonenko,2015-09-04 17:01:10+03:00,['09bb34e9d6e723dcd96555d9b31ca987bd2622f0'],17,13,30,20953610,5,0,0,0,20501
515e4987398d9ea9be1054f5660c0ecad521560c,0,Alex Antonenko,2015-09-04 17:06:04+03:00,['6b3ff72dc5c0b5396f15bf325922c2327622a572'],6,6,12,20953622,1,,,,20501
6577e8b825f6729178f8080522df1eab72412af8,0,Alex Antonenko,2015-09-04 17:29:47+03:00,['515e4987398d9ea9be1054f5660c0ecad521560c'],16,70,86,20953708,2,1,1,1,20501
cc93d351e67cd0806f1f7b3af21dcbebb06c5c4c,1,Andrii Tkach,2015-09-04 17:31:55+03:00,['6577e8b825f6729178f8080522df1eab72412af8'],18,93,111,20953819,2,0.180555556,1,1,20501
cb3dd00b3f9bb6c5dba33ae27795eab19d419b46,1,Andrii Tkach,2015-09-04 17:37:25+03:00,['cc93d351e67cd0806f1f7b3af21dcbebb06c5c4c'],74,411,485,20954304,19,1,1,1,20505
890c27a4f9b6b3f1ba0d21d1942491a98d170707,0,Oleg Nechiporenko,2015-09-04 17:38:25+03:00,['cb3dd00b3f9bb6c5dba33ae27795eab19d419b46'],0,3,3,20954307,1,0,1,1,20505
6c98f47a5b5c887ada8bf0556c96942a5baec9f5,1,Alex Antonenko,2015-09-04 17:54:58+03:00,['890c27a4f9b6b3f1ba0d21d1942491a98d170707'],7,14,21,20954328,1,0,0,1,20505
e681f2bf4d2f902d9d46c195baf5c405ab9ebc8e,1,Robert Levas,2015-09-04 10:55:49-04:00,['6c98f47a5b5c887ada8bf0556c96942a5baec9f5'],692,1338,2030,20956358,23,0.409356725,1,1,20507
d257b12be765e1507cf3da60c103c36f2b787240,0,Siddharth Wagle,2015-09-04 09:54:44-07:00,['e681f2bf4d2f902d9d46c195baf5c405ab9ebc8e'],27,11,38,20956396,4,,,,20507
98d3f320fa2f4f0770645c9cccd9ae8fc8aa109e,1,Yusaku Sako,2015-09-04 10:16:30-07:00,['d257b12be765e1507cf3da60c103c36f2b787240'],12,39,51,20956447,4,0.428571429,1,1,20507
7a5433d7f9295501201abd52c41a9c19bd51d8da,0,Sumit Mohanty,2015-09-04 10:22:05-07:00,['98d3f320fa2f4f0770645c9cccd9ae8fc8aa109e'],255,18,273,20956720,22,0.333333333,0.0625,0.041666667,20507
1d8ea339bc528510688868379a91f2c2ae9d159e,1,Sumit Mohanty,2015-09-04 10:22:06-07:00,['7a5433d7f9295501201abd52c41a9c19bd51d8da'],18,250,268,20956988,22,0.644444444,0.933333333,0.955555556,20512
9c452e8bba216f5d4f8d9ae6178fd3ff972a46b6,1,Srimanth Gunturi,2015-09-04 11:44:06-07:00,['1d8ea339bc528510688868379a91f2c2ae9d159e'],24,36,60,20957048,12,,,,20512
55193c8fa76fbc8bab6087f097b76b76e3a86f24,1,Srimanth Gunturi,2015-09-04 11:47:44-07:00,['9c452e8bba216f5d4f8d9ae6178fd3ff972a46b6'],69,148,217,20957265,5,1,1,1,20512
9bc3440a4ba35f1209d6170d62bfdded2c3b6f7c,1,Xi Wang,2015-09-04 15:49:53-07:00,['55193c8fa76fbc8bab6087f097b76b76e3a86f24'],13,53,66,20957331,4,1,1,1,20512
0bfe4d864f90e96a200305da57c83c802746b891,1,Alex Antonenko,2015-09-07 14:09:44+03:00,['9bc3440a4ba35f1209d6170d62bfdded2c3b6f7c'],7,55,62,20957393,2,0,0.25,0.395833333,20512
a639659d1ad5082a11bc4a30849f965ed82806da,1,Oleg Nechiporenko,2015-09-07 15:56:50+03:00,['0bfe4d864f90e96a200305da57c83c802746b891'],4,16,20,20957413,1,1,1,1,20512
45c172f3b5ff0a77a4f7d8739a09be4640c5b367,1,Andrii Tkach,2015-09-07 20:08:06+03:00,['a639659d1ad5082a11bc4a30849f965ed82806da'],8,16,24,20957437,3,1,1,0.9,20512
bfba14cbd06efb0d41029575118ce6ea0ae06b21,0,Andrew Onishuk,2015-09-08 11:36:36+03:00,['45c172f3b5ff0a77a4f7d8739a09be4640c5b367'],1,1,2,20957439,1,,,,20512
1757b859125ea0bf9c8fc4d683e9567e73aa537e,1,Vitaly Brodetskyi,2015-09-08 11:51:17+03:00,['bfba14cbd06efb0d41029575118ce6ea0ae06b21'],18,19,37,20957476,1,0,0,1,20512
9acb26f275ef0a0b5dc2f221d877cd91a4368201,0,aBabiichuk,2015-09-08 12:57:32+03:00,['1757b859125ea0bf9c8fc4d683e9567e73aa537e'],2,2,4,20957480,1,1,0,1,20512
efb10fb0268c224b0892c1a1ace09cf3cbbb15d1,0,Alex Antonenko,2015-09-08 16:23:05+03:00,['9acb26f275ef0a0b5dc2f221d877cd91a4368201'],1,1,2,20957482,1,,,,20512
00eb338f62ad6ce45a2739483656228107581538,1,Alex Antonenko,2015-09-08 18:53:24+03:00,['efb10fb0268c224b0892c1a1ace09cf3cbbb15d1'],11,18,29,20957511,2,1,1,1,20512
577ae0ced464fcdc06fda5592f589f73afd481ed,0,Alejandro Fernandez,2015-09-08 11:00:05-07:00,['00eb338f62ad6ce45a2739483656228107581538'],18,0,18,20957529,3,,,,20512
8def5a407399c56c51ad4edca1a59377dc3c3ba6,1,Jonathan Hurley,2015-09-08 17:15:22-04:00,['577ae0ced464fcdc06fda5592f589f73afd481ed'],364,680,1044,20958573,40,0.6,0.930434783,1,20512
dca7e5d03e78b34fc2a9718182127494e772e48b,1,Jonathan Hurley,2015-09-08 19:58:03-04:00,['8def5a407399c56c51ad4edca1a59377dc3c3ba6'],3,2,5,20958578,1,0,0,1,20512
27803b592a53253e6e65cea63d363c8eb4f018ef,0,Richard Zang,2015-09-08 18:07:12-07:00,['dca7e5d03e78b34fc2a9718182127494e772e48b'],1,7,8,20958586,1,1,1,1,20512
82396b1fd322506b705662d097176481c94130d9,0,Lisnichenko Dmitro,2015-09-09 11:47:12+03:00,['27803b592a53253e6e65cea63d363c8eb4f018ef'],1,80,81,20958667,2,0,0.78125,1,20513
c1f34ba7133585acb29e730bfa335340b77815cc,0,Alex Antonenko,2015-09-09 12:15:56+03:00,['82396b1fd322506b705662d097176481c94130d9'],6,55,61,20958728,1,1,1,1,20513
81a64b83bdfa2c734cf6ced7e6df8d0f848b6159,1,Oleg Nechiporenko,2015-09-09 14:03:04+03:00,['c1f34ba7133585acb29e730bfa335340b77815cc'],3,23,26,20958754,5,0.5,1,0.5,20513
c8c6c9ce17a80bd529bccec1a14bf89cbfa47d79,0,Vitaly Brodetskyi,2015-09-09 15:10:48+03:00,['81a64b83bdfa2c734cf6ced7e6df8d0f848b6159'],1,0,1,20958755,1,,,,20513
74dc9474b600458a52e7bf038d239283e067708d,1,Lisnichenko Dmitro,2015-09-09 15:24:42+03:00,['c8c6c9ce17a80bd529bccec1a14bf89cbfa47d79'],23,451,474,20959229,10,0.148255814,0.718023256,0.752906977,20514
7716a8eb0e3f3da6efe44ec7ee9e4f7c8c69295f,1,aBabiichuk,2015-09-09 15:27:18+03:00,['74dc9474b600458a52e7bf038d239283e067708d'],59,47,106,20959335,4,1,0.416666667,0,20514
09633340e176f5e6988e404a6723159f9db02ad9,0,Vitaly Brodetskyi,2015-09-09 16:00:30+03:00,['7716a8eb0e3f3da6efe44ec7ee9e4f7c8c69295f'],9,10,19,20959354,1,0,0,1,20514
37f8c88f205b196fb02324169f5f55650af0d568,1,Andrew Onishuk,2015-09-09 16:54:43+03:00,['09633340e176f5e6988e404a6723159f9db02ad9'],145,374,519,20959873,37,0.393333333,0.68,0.92,20514
40f2ac2f17837eec848489478b70db1162267804,1,Andrii Tkach,2015-09-09 17:01:19+03:00,['37f8c88f205b196fb02324169f5f55650af0d568'],28,36,64,20959937,5,0.666666667,1,0,20514
a6d2947403eb5ca644ba5f3dbb8c7705a9f108eb,0,Andrew Onishuk,2015-09-09 17:39:52+03:00,['40f2ac2f17837eec848489478b70db1162267804'],11,11,22,20959959,3,0,1,1,20514
c2825271b90cd3f16d3065f171de28d5cbd92b80,1,Siddharth Wagle,2015-09-09 13:18:53-07:00,['a6d2947403eb5ca644ba5f3dbb8c7705a9f108eb'],4,2722,2726,20962685,12,0.188679245,0.452830189,0.949685535,20523
cffc56e23a21d2cf6d362c9ed781d09cbb2e8690,0,Richard Zang,2015-09-09 16:08:58-07:00,['c2825271b90cd3f16d3065f171de28d5cbd92b80'],1,1,2,20962687,1,,,,20523
26b093a1a20e4d26b08114aeb1e95b8fb049105a,1,Siddharth Wagle,2015-09-09 16:18:46-07:00,['cffc56e23a21d2cf6d362c9ed781d09cbb2e8690'],11,27,38,20962725,4,,,,20523
b4731890272e216ab327656101ec26e051d6b9f8,0,Srimanth Gunturi,2015-09-09 16:42:33-07:00,['26b093a1a20e4d26b08114aeb1e95b8fb049105a'],5,237,242,20962967,4,0,0.603053435,0.312977099,20524
c2ec02fe6314a538281c6dd997928ec09224f77c,1,Yusaku Sako,2015-09-09 16:57:36-07:00,['b4731890272e216ab327656101ec26e051d6b9f8'],4,599,603,20963570,5,0.244067797,1,1,20524
357a927f9751e543082794af95ce495dae2e4ecd,0,Siddharth Wagle,2015-09-09 17:14:26-07:00,['c2ec02fe6314a538281c6dd997928ec09224f77c'],0,1,1,20963571,1,,,,20524
ecdab497180f1d9f1b4997532c60e41c0adfb90c,1,Vitaly Brodetskyi,2015-09-10 11:20:58+03:00,['357a927f9751e543082794af95ce495dae2e4ecd'],2,2,4,20963575,1,,,,20524
9659891e6da5619bdf415d4efdec9dbf8fca1c36,1,aBabiichuk,2015-09-10 11:56:35+03:00,['ecdab497180f1d9f1b4997532c60e41c0adfb90c'],14,12,26,20963601,5,0,1,0,20524
eccadf9ced4290662808bc731d0812f991d9cf91,1,Dmytro Sen,2015-09-10 12:46:19+03:00,['9659891e6da5619bdf415d4efdec9dbf8fca1c36'],4,150,154,20963755,2,0,0.792207792,1,20525
c985602ccb4a8b9696f0f0eab33425aa7d03d706,1,Andrii Tkach,2015-09-10 15:14:24+03:00,['eccadf9ced4290662808bc731d0812f991d9cf91'],11,165,176,20963931,2,0.93877551,0.93877551,1,20525
a2931529c16ebc48d8cb14226e9a65a2984a2550,1,Alex Antonenko,2015-09-10 17:42:54+03:00,['c985602ccb4a8b9696f0f0eab33425aa7d03d706'],151,57,208,20964139,6,0,0,0,20525
335dcb1ed0e469d67f9293707466a4c028b2f5a5,1,Alex Antonenko,2015-09-10 17:54:01+03:00,['a2931529c16ebc48d8cb14226e9a65a2984a2550'],1,1,2,20964141,1,,,,20525
6688cb6f1dbcc4033f83f6b5ce3641d5e71205ae,1,Robert Levas,2015-09-10 11:19:25-04:00,['335dcb1ed0e469d67f9293707466a4c028b2f5a5'],3,18,21,20964162,1,0,0,0,20525
f88ae30b2a6adf407beb5075d10ebb6c5fa1c3d5,0,Jaimin Jetly,2015-09-10 11:17:44-07:00,['6688cb6f1dbcc4033f83f6b5ce3641d5e71205ae'],1,1,2,20964164,1,,,,20525
f1d6ef340718c93bba54bac661a6056a79882909,1,Sumit Mohanty,2015-09-10 11:54:35-07:00,['f88ae30b2a6adf407beb5075d10ebb6c5fa1c3d5'],10,63,73,20964237,6,0,0.5,0.552631579,20525
621e5c31cd12648e88bf644ec1fb930da51ec447,0,Dmytro Sen,2015-09-10 21:56:49+03:00,['f1d6ef340718c93bba54bac661a6056a79882909'],3,3,6,20964243,2,,,,20525
1ec86cd8350ce4e9a36ffd6ec715a5cc27f2dcdb,1,Dmytro Sen,2015-09-10 22:04:10+03:00,['621e5c31cd12648e88bf644ec1fb930da51ec447'],117,389,506,20964749,32,0,0,0.520618557,20525
5a8c2a74b69712449ec92d73b78eb4232ffa0242,0,Alex Antonenko,2015-09-10 22:14:13+03:00,['1ec86cd8350ce4e9a36ffd6ec715a5cc27f2dcdb'],5,1,6,20964755,1,0,0,0,20525
129741c597e97f452b428de78436f2facac7b227,1,Siddharth Wagle,2015-09-10 13:27:05-07:00,['5a8c2a74b69712449ec92d73b78eb4232ffa0242'],2,2,4,20964759,2,,,,20525
d4182e13d199be5a3870e3649088a3bd682f5bb3,1,Jayush Luniya,2015-09-10 15:30:24-07:00,['129741c597e97f452b428de78436f2facac7b227'],7,70,77,20964836,4,0,0,1,20525
e6a8256963e3ba6a85cc5e7f4ea64786703f7a56,1,Siddharth Wagle,2015-09-10 16:24:00-07:00,['d4182e13d199be5a3870e3649088a3bd682f5bb3'],3,10,13,20964849,1,0,0,0,20525
8de1efcab298932b9ec51c5c31906008a3435aed,1,Sumit Mohanty,2015-09-10 16:28:07-07:00,['e6a8256963e3ba6a85cc5e7f4ea64786703f7a56'],6,6,12,20964861,4,,,,20525
067d4ee73498113ab0588c087c9950f91920ba55,1,Jaimin Jetly,2015-09-10 17:16:51-07:00,['8de1efcab298932b9ec51c5c31906008a3435aed'],6,6,12,20964873,2,,,,20525
eb4a68d5ca1582867ec7f8511f42bdb22cf732e2,1,Nate Cole,2015-09-10 20:22:50-04:00,['067d4ee73498113ab0588c087c9950f91920ba55'],10,28,38,20964911,3,0,1,1,20525
18f9437b708f4c7c973e08a950ec8bf449880125,0,Xi Wang,2015-09-10 18:01:47-07:00,['eb4a68d5ca1582867ec7f8511f42bdb22cf732e2'],0,1,1,20964912,1,,,,20525
2b45e161bd77314ca01688bc09b0faaad5276f00,1,Sumit Mohanty,2015-09-10 19:19:39-07:00,['18f9437b708f4c7c973e08a950ec8bf449880125'],1,2,3,20964915,1,,,,20525
bf8f798bce5ca7ec6cc7cf6f586f424f239da963,0,Siddharth Wagle,2015-09-10 22:13:26-07:00,['2b45e161bd77314ca01688bc09b0faaad5276f00'],1,1,2,20964917,1,,,,20525
a13ae6ada55487dcd6757d83b3958e88b83660d2,1,Siddharth Wagle,2015-09-10 22:25:50-07:00,['bf8f798bce5ca7ec6cc7cf6f586f424f239da963'],1,1,2,20964919,1,,,,20525
36c135c29a98ef8516599eec74fa59787ffac4df,1,Srimanth Gunturi,2015-09-11 00:09:48-07:00,['a13ae6ada55487dcd6757d83b3958e88b83660d2'],18,79,97,20965016,5,0,0.043478261,0.043478261,20525
f41ed7f1e67b21b4463d4330da8ed8090f222e29,1,Lisnichenko Dmitro,2015-09-11 15:06:02+03:00,['36c135c29a98ef8516599eec74fa59787ffac4df'],529,192,721,20965737,7,1,0.165137615,0,20526
b3eacea90cb05aac0c01b789c312c33db2974f43,0,Andrii Tkach,2015-09-11 16:46:46+03:00,['f41ed7f1e67b21b4463d4330da8ed8090f222e29'],6,99,105,20965842,3,1,1,1,20526
544f96e85e1c755032f75f7615dae8c574f1ceed,0,Dmytro Sen,2015-09-11 17:05:17+03:00,['b3eacea90cb05aac0c01b789c312c33db2974f43'],2,2,4,20965846,1,,,,20526
1c9df2d3f9fbfb98eeb7be651cd511cbe6727358,1,Andrew Onishuk,2015-09-11 17:16:23+03:00,['544f96e85e1c755032f75f7615dae8c574f1ceed'],0,23,23,20965869,8,0,0.5,0.5,20526
7c2dd39448643c428e9deb9decc47bec73937484,1,Andrew Onishuk,2015-09-11 17:30:02+03:00,['1c9df2d3f9fbfb98eeb7be651cd511cbe6727358'],1,151,152,20966021,5,0.184,0.912,1,20526
8cd6cfc6f01f224195a76e3ad362be41e69d17bb,1,Alex Antonenko,2015-09-11 18:41:45+03:00,['7c2dd39448643c428e9deb9decc47bec73937484'],87,217,304,20966325,10,0.306306306,0.792792793,0.711711712,20526
542bbf22e801b01a52229ab12c07f5ef5d7a7f21,1,Andrew Onishuk,2015-09-11 21:50:44+03:00,['8cd6cfc6f01f224195a76e3ad362be41e69d17bb'],13,41,54,20966379,11,0,0.857142857,0.964285714,20526
e8f2f2fd767bab5fff67c163d672ee7fdf2d5054,1,Jayush Luniya,2015-09-11 12:45:41-07:00,['542bbf22e801b01a52229ab12c07f5ef5d7a7f21'],218,185,403,20966782,19,,,,20526
02fcea6c3c38f2fff4e73bdc3d235cf87477d4e2,1,Jayush Luniya,2015-09-11 13:08:25-07:00,['e8f2f2fd767bab5fff67c163d672ee7fdf2d5054'],0,7,7,20966789,1,0,0,1,20526
93a2106a6edb8ae26dc30a0b277ec0de586b8d05,1,Sumit Mohanty,2015-09-11 15:54:00-07:00,['02fcea6c3c38f2fff4e73bdc3d235cf87477d4e2'],45,272,317,20967106,43,0.023952096,0.730538922,0.928143713,20526
70ca85005b49a93970164af9a047bebd2b290427,1,Jaimin Jetly,2015-09-11 18:04:24-07:00,['93a2106a6edb8ae26dc30a0b277ec0de586b8d05'],3279,2776,6055,20973161,153,0.578571429,0.542857143,1,20528
c7a714cf0f4d0a86f6840a5e5d7997a185ae4166,1,Jonathan Hurley,2015-09-11 22:51:25-04:00,['70ca85005b49a93970164af9a047bebd2b290427'],65,784,849,20974010,14,0.382022472,0.662921348,0.827715356,20531
e5f6fb164b44244527009ea3f74fe086aed7c7e0,1,Jonathan Hurley,2015-09-11 22:51:25-04:00,['c7a714cf0f4d0a86f6840a5e5d7997a185ae4166'],80,246,326,20974336,9,0.509433962,0.962264151,1,20532
eb36305a342fcd32cc1d17fea15e7f2a00244e5c,0,Sumit Mohanty,2015-09-12 12:42:19-07:00,['e5f6fb164b44244527009ea3f74fe086aed7c7e0'],1,6,7,20974343,1,1,1,1,20532
25de1567acad680b8d5fd025b26b5082796609bf,1,Andrew Onishuk,2015-09-14 09:18:42+03:00,['eb36305a342fcd32cc1d17fea15e7f2a00244e5c'],6,8,14,20974357,3,1,1,1,20532
0c77e3d2392323ec6f8b206427db0eca4217b7ea,1,aBabiichuk,2015-09-14 11:40:26+03:00,['25de1567acad680b8d5fd025b26b5082796609bf'],52,16,68,20974425,9,1,0.8,0,20532
63dded51d90d06f1ca7e55e6b756a5343c22659e,1,aBabiichuk,2015-09-14 12:04:33+03:00,['0c77e3d2392323ec6f8b206427db0eca4217b7ea'],14,5,19,20974444,4,0,0,0,20532
e837d4f082d32a69bd345ba805ee1d96b8981296,1,Dmytro Sen,2015-09-14 13:08:43+03:00,['63dded51d90d06f1ca7e55e6b756a5343c22659e'],237,237,474,20974918,5,,,,20532
b8388e12b348e3989490e812dd2fe993b2ca603e,1,Andrew Onishuk,2015-09-14 15:01:01+03:00,['e837d4f082d32a69bd345ba805ee1d96b8981296'],26,2020,2046,20976964,20,1,1,0.666666667,20537
f68b0f0251e52d1a5dbd58e0fdc88aae1c940f75,1,Vitaly Brodetskyi,2015-09-14 15:57:56+03:00,['b8388e12b348e3989490e812dd2fe993b2ca603e'],5,10,15,20976979,1,0,0,1,20537
8aac1802ad3aa62666f99cc558b892b45efadfbc,0,Andrii Tkach,2015-09-14 16:30:20+03:00,['f68b0f0251e52d1a5dbd58e0fdc88aae1c940f75'],71,0,71,20977050,4,0,0,0,20537
0397d527fb527535cfa0a27b114c93a3d96685fb,0,Vitaly Brodetskyi,2015-09-14 16:31:03+03:00,['8aac1802ad3aa62666f99cc558b892b45efadfbc'],1,2,3,20977053,1,,,,20537
a7152651ba1e4bb5b6ae201d62491e2f944f9f8f,0,Alex Antonenko,2015-09-14 17:44:27+03:00,['0397d527fb527535cfa0a27b114c93a3d96685fb'],42,61,103,20977156,5,1,1,1,20537
91885add8113782a3c399fca8715065d02419d4e,0,Sumit Mohanty,2015-09-14 08:02:14-07:00,['a7152651ba1e4bb5b6ae201d62491e2f944f9f8f'],23,43,66,20977222,11,0,0,0,20537
535e33a828e36198f78d3d4cd5fa84b4278dbf71,1,Alex Antonenko,2015-09-14 20:41:13+03:00,['91885add8113782a3c399fca8715065d02419d4e'],22,47,69,20977291,3,,,,20537
b4fdcf87a07a22eeefc72503879a087c5e3d5217,1,Sumit Mohanty,2015-09-14 11:11:28-07:00,['535e33a828e36198f78d3d4cd5fa84b4278dbf71'],43,23,66,20977357,11,1,1,1,20537
c6e61d8bb5ce97926a2d68bc08a134f80c9769ba,0,Jaimin Jetly,2015-09-14 14:49:21-07:00,['b4fdcf87a07a22eeefc72503879a087c5e3d5217'],239,258,497,20977854,26,,,,20537
9b6d33d0cb8635ca13f23b468c32bb31c30bd966,1,Robert Levas,2015-09-14 17:57:26-04:00,['c6e61d8bb5ce97926a2d68bc08a134f80c9769ba'],8,126,134,20977988,9,0.152941176,0.988235294,0.988235294,20537
bf1a65ee2811da73fa234a84a155406023081078,1,Sumit Mohanty,2015-09-14 16:16:23-07:00,['9b6d33d0cb8635ca13f23b468c32bb31c30bd966'],258,239,497,20978485,26,,,,20537
89e239cae1afe62035dd720a22b6a66bd2baf898,1,Siddharth Wagle,2015-09-14 17:47:35-07:00,['bf1a65ee2811da73fa234a84a155406023081078'],5,56,61,20978546,3,0,0,0.111111111,20537
53878959a618dd0e27b545c7f809f3b105bb4b4b,1,aBabiichuk,2015-09-15 11:21:45+03:00,['89e239cae1afe62035dd720a22b6a66bd2baf898'],6,4,10,20978556,1,,,,20537
950f732bc5c84e9d65f6d4f1214a7239dd903d97,1,Andrew Onishuk,2015-09-15 12:21:02+03:00,['53878959a618dd0e27b545c7f809f3b105bb4b4b'],1,1,2,20978558,1,,,,20537
afdfd2b0954df4d8035e0b6a7bd062e92ae836ed,0,Oleg Nechiporenko,2015-09-15 15:06:13+03:00,['950f732bc5c84e9d65f6d4f1214a7239dd903d97'],0,1,1,20978559,1,,,,20537
02668bfdc83bd8aeb39f28342307cf74d8996cee,1,Andrew Onishuk,2015-09-15 15:59:54+03:00,['afdfd2b0954df4d8035e0b6a7bd062e92ae836ed'],1,2,3,20978562,2,0,0,1,20537
d32556a03b5dc8b976d66f02abe374fba622b251,1,Vitaly Brodetskyi,2015-09-15 16:43:57+03:00,['02668bfdc83bd8aeb39f28342307cf74d8996cee'],2,2,4,20978566,2,,,,20537
05a0932e85276d6b283b3bc45bee4f6c3e1b55b1,1,Aleksandr Kovalenko,2015-09-15 17:51:39+03:00,['d32556a03b5dc8b976d66f02abe374fba622b251'],13,16,29,20978595,1,,,,20537
e9af9be3728ec6a15a2178724bc19eed66e97f8f,1,Alejandro Fernandez,2015-09-15 13:23:03-07:00,['05a0932e85276d6b283b3bc45bee4f6c3e1b55b1'],33,55,88,20978683,11,1,1,1,20537
2fce6d258bb997fa80ace2bd2f637517ee4fbec2,0,Dmytro Sen,2015-09-16 15:35:52+03:00,['e9af9be3728ec6a15a2178724bc19eed66e97f8f'],156,291,447,20979130,12,0,1,0.857142857,20537
a249e30f2435f6a985c0b04a10bd364533ada33a,1,Dmytro Sen,2015-09-16 17:32:33+03:00,['2fce6d258bb997fa80ace2bd2f637517ee4fbec2'],3,50,53,20979183,2,0,0.853658537,0.853658537,20537
8a615b0c6b93dfaef18afc87ff60cf83ec72e45d,0,Alex Antonenko,2015-09-16 19:39:37+03:00,['a249e30f2435f6a985c0b04a10bd364533ada33a'],1,1,2,20979185,1,,,,20537
8216e4e6764b8f947b021c26d38901adaaa1a650,0,Alex Antonenko,2015-09-16 19:45:41+03:00,['8a615b0c6b93dfaef18afc87ff60cf83ec72e45d'],1,1,2,20979187,1,,,,20537
bf6db1ff93b1ce12c85def5007d0498e9024cb97,1,Andrew Onishuk,2015-09-16 20:15:45+03:00,['8216e4e6764b8f947b021c26d38901adaaa1a650'],15,22,37,20979224,2,0,0,0,20537
0a204e04f0a2163cc0ade0318ebb7df98770214e,0,Andrew Onishuk,2015-09-16 20:19:02+03:00,['bf6db1ff93b1ce12c85def5007d0498e9024cb97'],4,7,11,20979235,1,,,,20537
3f29fcc0a5ca6e44fda7a7c1b58dfb587472730a,1,Siddharth Wagle,2015-09-16 12:15:12-07:00,['0a204e04f0a2163cc0ade0318ebb7df98770214e'],4,31,35,20979270,2,0,0.823529412,0.882352941,20537
44effc56526e7afe8f9ca8fc2a80c65c844f8d30,1,Srimanth Gunturi,2015-09-16 12:55:03-07:00,['3f29fcc0a5ca6e44fda7a7c1b58dfb587472730a'],1,110,111,20979381,3,0,0.864864865,1,20537
40ea7bc26cded293a32a7b6327d6c55289ebc816,0,Jaimin Jetly,2015-09-16 16:47:15-07:00,['44effc56526e7afe8f9ca8fc2a80c65c844f8d30'],18,14,32,20979413,8,0.6,0.6,1,20537
c49581bdf8b910bade5eb65761ef0aed2f7af0e5,0,Jaimin Jetly,2015-09-16 17:48:53-07:00,['40ea7bc26cded293a32a7b6327d6c55289ebc816'],3,3,6,20979419,2,,,,20537
50c6fa53c6beaa265058bb9d258d420c981cdd8e,1,Jaimin Jetly,2015-09-16 18:20:31-07:00,['c49581bdf8b910bade5eb65761ef0aed2f7af0e5'],239,258,497,20979916,26,,,,20537
a2260c7f0ed96f57ec7bf6974aa30061a948e713,0,Dmytro Sen,2015-09-17 13:39:20+03:00,['50c6fa53c6beaa265058bb9d258d420c981cdd8e'],58,4,62,20979978,2,1,0.3,0,20537
9763e6447a34206e12bbd5a52de926793d75ad5d,1,Andrii Tkach,2015-09-17 14:55:53+03:00,['a2260c7f0ed96f57ec7bf6974aa30061a948e713'],50,390,440,20980418,28,0.932038835,0.883495146,1,20539
b58fa92582c5b820c0bd9b536ce99c4dfac677f5,1,Aleksandr Kovalenko,2015-09-17 15:01:06+03:00,['9763e6447a34206e12bbd5a52de926793d75ad5d'],77,96,173,20980591,9,,,,20539
b99ba4d24801fea17785a02c8c793eee341a6508,1,Lisnichenko Dmitro,2015-09-17 15:24:37+03:00,['b58fa92582c5b820c0bd9b536ce99c4dfac677f5'],7,15,22,20980613,2,0,1,0.666666667,20539
f08a40f845421e13b01187590c4d630d7345374c,1,Jonathan Hurley,2015-09-17 11:07:59-04:00,['b99ba4d24801fea17785a02c8c793eee341a6508'],10,16,26,20980639,2,0,1,1,20539
e1bf82e57c3a87fdad8a97b95393745e2d157559,1,Alex Antonenko,2015-09-17 18:28:42+03:00,['f08a40f845421e13b01187590c4d630d7345374c'],9,230,239,20980878,7,0.327102804,0.61682243,1,20539
4f133eafe31d006b3c66d78802e56390d3bf18ed,1,Alex Antonenko,2015-09-17 18:29:14+03:00,['e1bf82e57c3a87fdad8a97b95393745e2d157559'],3,21,24,20980902,2,0,1,1,20539
989583b0beca4192788092b0cd6b53b7fc70c524,0,Vitaly Brodetskyi,2015-09-17 19:09:04+03:00,['4f133eafe31d006b3c66d78802e56390d3bf18ed'],1,0,1,20980903,1,,,,20539
9b8473c5a16734a42ab7be64e02ebc3b9352a809,1,Vitaly Brodetskyi,2015-09-17 19:13:03+03:00,['989583b0beca4192788092b0cd6b53b7fc70c524'],1,49,50,20980953,7,0,1,1,20540
ad810ae466248db87a50aaaf5d90d76ab1bbceb8,1,Aleksandr Kovalenko,2015-09-17 19:34:37+03:00,['9b8473c5a16734a42ab7be64e02ebc3b9352a809'],34,96,130,20981083,11,1,1,1,20540
8ff7db8058cc20fba06b3d28b63187ed87d76e65,1,Dmytro Sen,2015-09-17 19:39:14+03:00,['ad810ae466248db87a50aaaf5d90d76ab1bbceb8'],53,287,340,20981423,3,0.061320755,0.91509434,0.919811321,20540
24dfa2fb03956aeb2d30d8b2b06f9a66060fb9de,1,Myroslav Papirkovskyy,2015-09-17 19:41:09+03:00,['8ff7db8058cc20fba06b3d28b63187ed87d76e65'],1,1,2,20981425,1,,,,20540
f438b28c2c75332b5e2a767acb338478337ce00c,0,Lisnichenko Dmitro,2015-09-17 20:24:32+03:00,['24dfa2fb03956aeb2d30d8b2b06f9a66060fb9de'],7,8,15,20981440,1,,,,20540
0f746256a0a73ab8aaa6f3d425f463befa03f58d,1,Dmytro Sen,2015-09-17 21:35:50+03:00,['f438b28c2c75332b5e2a767acb338478337ce00c'],0,68,68,20981508,1,0,0,1,20540
3ce0bea5ae49eaad1dab2921cd59c9b133798efd,1,Myroslav Papirkovskyy,2015-09-17 21:44:58+03:00,['0f746256a0a73ab8aaa6f3d425f463befa03f58d'],0,12,12,20981520,4,0.428571429,0.714285714,1,20540
ec9e4149f3f3fb53fc38825717adbff421a2095f,1,Yusaku Sako,2015-09-17 16:14:57-07:00,['3ce0bea5ae49eaad1dab2921cd59c9b133798efd'],0,91,91,20981611,1,,,,20541
d40bf10b8fc2be9046e278f4bd2685fc62f06513,1,Sumit Mohanty,2015-09-17 17:08:12-07:00,['ec9e4149f3f3fb53fc38825717adbff421a2095f'],26,1,27,20981638,2,0.266666667,0.266666667,0.266666667,20541
294bba8038e575c22385d8f5c87be6e601235195,1,Andrew Onishuk,2015-09-18 13:24:09+03:00,['d40bf10b8fc2be9046e278f4bd2685fc62f06513'],0,12,12,20981650,1,0,0,1,20541
1ad65df0b5e47b7b83542eb78451b8f2cbcbd142,0,Andrii Tkach,2015-09-18 13:45:59+03:00,['294bba8038e575c22385d8f5c87be6e601235195'],2,2,4,20981654,1,,,,20541
8867b3685820b2f293b749de919766137f230f23,1,aBabiichuk,2015-09-18 14:24:46+03:00,['1ad65df0b5e47b7b83542eb78451b8f2cbcbd142'],2478,46,2524,20984178,25,0.564007421,0.230055659,0.011131725,20541
9a070cff5404a005834d7462a5d9e5dc6efc7325,1,Oleg Nechiporenko,2015-09-18 14:40:26+03:00,['8867b3685820b2f293b749de919766137f230f23'],46,47,93,20984271,5,,,,20541
7bc58ac7c76bd5550d5794ec679860c7c0531e3c,0,Robert Levas,2015-09-18 09:08:31-04:00,['9a070cff5404a005834d7462a5d9e5dc6efc7325'],15,1,16,20984287,5,1,0.230769231,0.538461538,20541
535e752a66c696ddc4a0e79ef16ba87ac43eede6,0,Vitaly Brodetskyi,2015-09-18 18:20:20+03:00,['7bc58ac7c76bd5550d5794ec679860c7c0531e3c'],3,16,19,20984306,2,1,1,1,20541
d35d52088b995d10ecb929d52c36072b1833d4a7,1,Vitaly Brodetskyi,2015-09-18 18:27:34+03:00,['535e752a66c696ddc4a0e79ef16ba87ac43eede6'],1,1,2,20984308,1,,,,20541
ad20650cdcb3415c5231228bceefa085c827a9cb,0,Lisnichenko Dmitro,2015-09-18 20:12:58+03:00,['d35d52088b995d10ecb929d52c36072b1833d4a7'],0,1,1,20984309,1,0,1,0,20541
797e3973731e23356c012705855e5d8f08e31301,1,Aleksandr Kovalenko,2015-09-18 20:32:46+03:00,['ad20650cdcb3415c5231228bceefa085c827a9cb'],1,1,2,20984311,1,,,,20541
abd3e5bd04df32076cd7ba662b8afaf72c2fdba2,1,Sumit Mohanty,2015-09-18 11:36:40-07:00,['797e3973731e23356c012705855e5d8f08e31301'],1,1115,1116,20985427,4,1,1,1,20543
950616d48522fdb91f5f9dfaf64dc9ae9d5538a7,1,Nate Cole,2015-09-18 15:26:47-04:00,['abd3e5bd04df32076cd7ba662b8afaf72c2fdba2'],12,25,37,20985464,2,0,1,1,20543
9dd623abb78e094bbf6ab5fcd4763cf2efa96c4b,1,Jonathan Hurley,2015-09-18 16:20:14-04:00,['950616d48522fdb91f5f9dfaf64dc9ae9d5538a7'],36,187,223,20985687,2,0.009259259,0.009259259,1,20543
c8595d6e9a60584f371a513c8dd3579a53f66d69,1,Jonathan Hurley,2015-09-18 19:12:19-04:00,['9dd623abb78e094bbf6ab5fcd4763cf2efa96c4b'],16,410,426,20986113,4,0.074204947,0.636042403,1,20543
9ba52c37ffd534f3d807f4b98a074016341b40bf,0,Yusaku Sako,2015-09-18 16:33:21-07:00,['c8595d6e9a60584f371a513c8dd3579a53f66d69'],1,9,10,20986123,1,,,,20543
02cdab026dad2ef33b0636dde8ec9a1a963791dd,0,Siddharth Wagle,2015-09-18 16:35:51-07:00,['9ba52c37ffd534f3d807f4b98a074016341b40bf'],1,1,2,20986125,1,,,,20543
25fd9a627e6a451fdf734ff8cdbd86c74f10634c,1,Jayush Luniya,2015-09-18 17:23:32-07:00,['02cdab026dad2ef33b0636dde8ec9a1a963791dd'],30,613,643,20986768,8,0.02,0.68,0.663333333,20547
1065bc5155629ce5951c370c5cc74ad849ae222d,0,Jayush Luniya,2015-09-18 17:25:38-07:00,['25fd9a627e6a451fdf734ff8cdbd86c74f10634c'],7,40,47,20986815,3,0.148148148,1,0.444444444,20547
131c8cd510c23a4e3d7c9b305f5064cce051b947,1,Dmytro Sen,2015-09-19 13:45:22+03:00,['1065bc5155629ce5951c370c5cc74ad849ae222d'],0,19,19,20986834,1,,,,20547
fa4240e71e3bd7ff740179f04e894218a1249e3d,1,Vitaly Brodetskyi,2015-09-19 15:52:27+03:00,['131c8cd510c23a4e3d7c9b305f5064cce051b947'],1,1,2,20986836,1,,,,20547
d095713a1e9cd3e96862d4fbd4061ce43f829754,1,Andrew Onishuk,2015-09-19 17:36:23+03:00,['fa4240e71e3bd7ff740179f04e894218a1249e3d'],0,28,28,20986864,2,0.9375,1,1,20547
d2ae799f7205f9f0149584a4ff33407e77b41dc2,1,Dmytro Sen,2015-09-19 18:24:07+03:00,['d095713a1e9cd3e96862d4fbd4061ce43f829754'],32,121,153,20987017,8,0.3,0.7,0.5,20547
338360b6ed359bd1c3f52df06d279f07017851c4,1,Alex Antonenko,2015-09-19 22:13:58+03:00,['d2ae799f7205f9f0149584a4ff33407e77b41dc2'],26,235,261,20987278,6,0.123152709,0.990147783,0.906403941,20547
61edc13bc7c7510d7682c8897d9b9662a4867095,1,Vitaly Brodetskyi,2015-09-21 13:27:54+03:00,['338360b6ed359bd1c3f52df06d279f07017851c4'],1,100,101,20987379,3,0.066666667,0.48,0.946666667,20547
1d292fbbacd79e42ade101f957c1ee680ac680ed,0,Andrii Tkach,2015-09-21 15:05:47+03:00,['61edc13bc7c7510d7682c8897d9b9662a4867095'],1,13,14,20987393,3,0.909090909,1,1,20547
cbd8ec16475b8d6263b238026d48a4112578b581,1,Vitaly Brodetskyi,2015-09-21 16:21:54+03:00,['1d292fbbacd79e42ade101f957c1ee680ac680ed'],2,10,12,20987405,1,0,0,1,20547
e59f157447e2d69623ccf7d3558a118032041554,1,Dmytro Sen,2015-09-21 18:41:03+03:00,['cbd8ec16475b8d6263b238026d48a4112578b581'],4,16,20,20987425,3,0.75,1,0.875,20547
78ded38f96d4d03967feddae2c96478ad578e89b,1,Sumit Mohanty,2015-09-21 09:56:45-07:00,['e59f157447e2d69623ccf7d3558a118032041554'],8,1153,1161,20988586,3,0,1,0,20548
4e39212135ae6e4ce998c432b392a0dd2b77f86a,0,Vitaly Brodetskyi,2015-09-21 20:11:24+03:00,['78ded38f96d4d03967feddae2c96478ad578e89b'],1,1,2,20988588,1,,,,20548
d278ed1a2c61653aab10ea43e4d13bf37a0b8ec2,0,Lisnichenko Dmitro,2015-09-21 20:57:06+03:00,['4e39212135ae6e4ce998c432b392a0dd2b77f86a'],2,5,7,20988595,1,0,0,1,20548
2d12f1edec147f317f55345531b200e5d4f7d9fe,1,Myroslav Papirkovskyy,2015-09-21 21:49:39+03:00,['d278ed1a2c61653aab10ea43e4d13bf37a0b8ec2'],1,1,2,20988597,1,,,,20548
26da70b3f06b1b2729572a4ac29588a4a17111b5,1,Richard Zang,2015-09-21 12:28:14-07:00,['2d12f1edec147f317f55345531b200e5d4f7d9fe'],65,77,142,20988739,2,1,1,1,20548
f9271abc25614adbcfa00599db643a24ac20f0f2,1,Alejandro Fernandez,2015-09-21 13:39:42-07:00,['26da70b3f06b1b2729572a4ac29588a4a17111b5'],17,232,249,20988988,5,0.105263158,0.894736842,0.105263158,20548
6d165213e25ff31ce64e0bd92f07ed986f8bac28,1,Yusaku Sako,2015-09-21 16:58:55-07:00,['f9271abc25614adbcfa00599db643a24ac20f0f2'],5,75,80,20989068,5,0.11627907,0.488372093,1,20548
f596785cdec78a1a975509d72ba305904749f2c2,1,Jaimin Jetly,2015-09-21 18:24:50-07:00,['6d165213e25ff31ce64e0bd92f07ed986f8bac28'],18,73,91,20989159,6,0.454545455,0.454545455,0.424242424,20548
a892ba9c8060041bbc07bce3486c44e5f71fddf0,1,Vitaly Brodetskyi,2015-09-22 12:54:31+03:00,['f596785cdec78a1a975509d72ba305904749f2c2'],2,10,12,20989171,2,1,1,1,20548
06d75466caaea806508917f7b6e30809168fed38,0,Oleg Nechiporenko,2015-09-22 13:14:24+03:00,['a892ba9c8060041bbc07bce3486c44e5f71fddf0'],1,1,2,20989173,1,,,,20548
9095539cc75f0ee7473f550d5ea317a3dc4f9242,1,Andrew Onishuk,2015-09-22 13:18:54+03:00,['06d75466caaea806508917f7b6e30809168fed38'],1,1,2,20989175,1,,,,20548
528be0a33bdc276f5f79e774cbe4e223e1486734,0,Andrew Onishuk,2015-09-22 13:21:51+03:00,['9095539cc75f0ee7473f550d5ea317a3dc4f9242'],6,5,11,20989186,2,1,0,0,20548
82b2b960e4ae4b2de2cc39c38a9e62667b0c6020,0,Andrew Onishuk,2015-09-22 13:36:27+03:00,['528be0a33bdc276f5f79e774cbe4e223e1486734'],12,23,35,20989221,2,0,0.666666667,1,20548
574dda5d1e2669f83439e40e2f8703b515aec8e6,1,Oleg Nechiporenko,2015-09-22 14:50:50+03:00,['82b2b960e4ae4b2de2cc39c38a9e62667b0c6020'],0,3,3,20989224,1,1,1,0,20548
e5159520bffcbe5e1b907659cb67615a34b60a8d,1,aBabiichuk,2015-09-22 14:53:58+03:00,['574dda5d1e2669f83439e40e2f8703b515aec8e6'],1743,187,1930,20991154,25,0.676567657,0.653465347,0.452145215,20548
59be5a4912b8a8ca6b7638a631d797bcb5300d86,1,Aleksandr Kovalenko,2015-09-22 15:09:21+03:00,['e5159520bffcbe5e1b907659cb67615a34b60a8d'],0,16,16,20991170,1,1,1,1,20548
79809b2628e06147d9dd16353df1637d7d574d9e,1,aBabiichuk,2015-09-22 15:19:10+03:00,['59be5a4912b8a8ca6b7638a631d797bcb5300d86'],9,9,18,20991188,5,,,,20548
3f2478cacd9a70ef5289bbed9ad430cf1775f94c,1,Jonathan Hurley,2015-09-22 08:28:43-04:00,['79809b2628e06147d9dd16353df1637d7d574d9e'],59,220,279,20991467,9,0.209302326,0.686046512,0.941860465,20548
23b2b802eb1683eb67a432a2ff14865f92593a37,0,aBabiichuk,2015-09-22 17:10:20+03:00,['3f2478cacd9a70ef5289bbed9ad430cf1775f94c'],1,1,2,20991469,1,,,,20548
b0ecd59901c7beaa037d7a9d94782c97d69b25e9,0,aBabiichuk,2015-09-22 17:22:53+03:00,['23b2b802eb1683eb67a432a2ff14865f92593a37'],1,2,3,20991472,2,,,,20548
e537178b1bedd615df7a172c15032e363e22db02,1,Andrew Onishuk,2015-09-22 18:11:46+03:00,['b0ecd59901c7beaa037d7a9d94782c97d69b25e9'],1,3,4,20991476,1,,,,20548
0fc88bed2dd3829cf5c33885c92018cec9a788e6,0,Oleg Nechiporenko,2015-09-22 18:13:27+03:00,['e537178b1bedd615df7a172c15032e363e22db02'],389,376,765,20992241,12,0.02,0,0,20551
e159406c408012d0d918d596f1470c2bc445d17f,1,Dmytro Sen,2015-09-22 20:25:40+03:00,['0fc88bed2dd3829cf5c33885c92018cec9a788e6'],7,7,14,20992255,3,,,,20551
2ecda9da7f4d3d6c8496ecd106e277adeace8082,0,Yusaku Sako,2015-09-22 10:26:10-07:00,['e159406c408012d0d918d596f1470c2bc445d17f'],376,389,765,20993020,12,0.98,1,1,20552
0b2c1822d0659264e329c415e341c65ed3fb8989,0,Siddharth Wagle,2015-09-22 11:22:24-07:00,['2ecda9da7f4d3d6c8496ecd106e277adeace8082'],0,3,3,20993023,1,0,0,1,20552
38230dddd5cd607a35564bb46a0c56f53c44b360,1,Xi Wang,2015-09-22 15:53:48-07:00,['0b2c1822d0659264e329c415e341c65ed3fb8989'],5,6,11,20993034,4,,,,20552
f2c14a3093c8309b9c081cf377b7afc210950f50,1,Aleksandr Kovalenko,2015-09-23 02:33:36+03:00,['38230dddd5cd607a35564bb46a0c56f53c44b360'],17,80,97,20993131,1,1,1,1,20552
e4e9c9f5c7f6a3f88a6aeb522d52e68ce8b642d2,1,Siddharth Wagle,2015-09-22 17:41:04-07:00,['f2c14a3093c8309b9c081cf377b7afc210950f50'],1039,225,1264,20994395,8,0.245901639,0.327868852,0.967213115,20552
82418c6d2847a9b85d93bae77485de1e66e32118,1,Yusaku Sako,2015-09-22 21:56:57-07:00,['e4e9c9f5c7f6a3f88a6aeb522d52e68ce8b642d2'],50,286,336,20994731,12,0.66,1,0.9,20555
3df60b4fb2e78fe27e97063260d2a2172304fe63,1,Yusaku Sako,2015-09-22 22:02:57-07:00,['82418c6d2847a9b85d93bae77485de1e66e32118'],0,54,54,20994785,5,,,,20555
e24e3c8b75ad7b466d7ab82ebb4ffb6ac6ee6dcc,1,Sumit Mohanty,2015-09-22 22:32:26-07:00,['3df60b4fb2e78fe27e97063260d2a2172304fe63'],1,85,86,20994871,3,0.254901961,0.725490196,0.392156863,20555
f7e29cd78e004fb13aeb20283bbc950369ddb0d5,0,aBabiichuk,2015-09-23 11:45:00+03:00,['e24e3c8b75ad7b466d7ab82ebb4ffb6ac6ee6dcc'],16,2,18,20994889,4,,,,20555
4f4959d2113ea9e2f579b4719ef7be39fb2450b8,1,aBabiichuk,2015-09-23 11:45:00+03:00,['f7e29cd78e004fb13aeb20283bbc950369ddb0d5'],102,104,206,20995095,3,1,1,1,20555
7ded8eb81dd5529cc264a891f7f43865516fe214,1,Oleg Nechiporenko,2015-09-23 12:32:47+03:00,['4f4959d2113ea9e2f579b4719ef7be39fb2450b8'],389,392,781,20995876,12,0.02,0,0,20558
5b79462a50f137223ed1bdf91e9fce9742c5cf40,0,Oleg Nechiporenko,2015-09-23 16:52:53+03:00,['7ded8eb81dd5529cc264a891f7f43865516fe214'],0,8,8,20995884,1,1,1,1,20558
5579a8f374d5ff47a9dfc4ae1b7f310b0b550f5c,0,aBabiichuk,2015-09-23 17:07:29+03:00,['5b79462a50f137223ed1bdf91e9fce9742c5cf40'],1,1,2,20995886,1,,,,20558
44573693b3cd4a7e44c46d5f2379889ec0d2c281,1,Vitaly Brodetskyi,2015-09-23 17:18:08+03:00,['5579a8f374d5ff47a9dfc4ae1b7f310b0b550f5c'],10,4,14,20995900,2,1,0,0,20558
d05dd665487aabad6f3b75297c396615f4eff94c,0,Lisnichenko Dmitro,2015-09-23 18:30:11+03:00,['44573693b3cd4a7e44c46d5f2379889ec0d2c281'],36,20,56,20995956,1,1,1,0,20558
52bad3ea82e53f5bba915ae92f7bf61aebf77423,1,Alejandro Fernandez,2015-09-23 09:14:07-07:00,['d05dd665487aabad6f3b75297c396615f4eff94c'],12,42,54,20996010,2,0.136363636,0,1,20558
c7d3f5a69ce36528817ccd362c6aaf1884c0e61e,0,Andrew Onishuk,2015-09-23 19:46:25+03:00,['52bad3ea82e53f5bba915ae92f7bf61aebf77423'],3,3,6,20996016,2,,,,20558
54fe2ea4e654bb4054d544d77df43fb494a45128,1,Vitaly Brodetskyi,2015-09-23 20:09:02+03:00,['c7d3f5a69ce36528817ccd362c6aaf1884c0e61e'],4,8,12,20996028,4,,,,20558
3e63b159135cc30d2429caf22253311e8a0d5a03,1,Sumit Mohanty,2015-09-23 10:12:10-07:00,['54fe2ea4e654bb4054d544d77df43fb494a45128'],29,1115,1144,20997172,15,0.213903743,0.631016043,0.919786096,20564
d957874f5db31d02aad9d424fdc69804e978b08d,0,Sumit Mohanty,2015-09-23 10:17:25-07:00,['3e63b159135cc30d2429caf22253311e8a0d5a03'],0,2,2,20997174,1,0,1,1,20564
baf559abeed5b613afe94e73a0548116b8f625e0,1,Lisnichenko Dmitro,2015-09-23 21:16:56+03:00,['d957874f5db31d02aad9d424fdc69804e978b08d'],30,10,40,20997214,4,,,,20564
b2b88ee89d59ef02912dd0f32af44f79b68d2f43,1,Yusaku Sako,2015-09-23 11:32:51-07:00,['baf559abeed5b613afe94e73a0548116b8f625e0'],1,1,2,20997216,1,,0,,20564
51620c6e2c7c846df26294d52c83fab9f141d202,1,Alejandro Fernandez,2015-09-23 14:37:22-07:00,['b2b88ee89d59ef02912dd0f32af44f79b68d2f43'],18,430,448,20997664,6,0.331578947,0.552631579,0.184210526,20566
16bcc80e0334be22e08a5dcb21cc1d66417fd880,1,Srimanth Gunturi,2015-09-23 17:33:17-07:00,['51620c6e2c7c846df26294d52c83fab9f141d202'],94,1527,1621,20999285,30,1,1,0.897435897,20576
0a0e29d0ec82130ad52bf5bd9248c512cce0e912,1,Andrii Tkach,2015-09-24 13:11:51+03:00,['16bcc80e0334be22e08a5dcb21cc1d66417fd880'],48,301,349,20999634,13,0.740909091,0.9,1,20576
0f10e841a24940bbba4281a0a09e936b43df00ee,1,Andrii Tkach,2015-09-24 13:15:49+03:00,['0a0e29d0ec82130ad52bf5bd9248c512cce0e912'],7,44,51,20999685,5,1,1,1,20576
43da8facca2056670fe58226f201eb6ac029439a,0,Vitaly Brodetskyi,2015-09-24 13:32:13+03:00,['0f10e841a24940bbba4281a0a09e936b43df00ee'],2,2,4,20999689,2,,,,20576
49c10612c00c5b321d3550b6d8137d9024900341,0,Aleksandr Kovalenko,2015-09-24 15:56:05+03:00,['43da8facca2056670fe58226f201eb6ac029439a'],31,28,59,20999748,3,0,0,0,20576
664a626e25988f596235ec4994fba1d05aeabd31,1,AndriyBabiychuk,2015-09-24 16:19:47+03:00,['49c10612c00c5b321d3550b6d8137d9024900341'],2,2,4,20999752,2,,,,20576
d058428782391ac2e6524f3e7b35a9f4a69c1c9d,1,Vitaly Brodetskyi,2015-09-24 17:25:30+03:00,['664a626e25988f596235ec4994fba1d05aeabd31'],0,34,34,20999786,1,1,1,0,20576
4b87356572f1a5479c1ac77374766534d23637bc,1,Andrew Onishuk,2015-09-24 17:59:37+03:00,['d058428782391ac2e6524f3e7b35a9f4a69c1c9d'],7,46,53,20999839,4,0.75,0.208333333,0.75,20576
688666137427ccae7ee94df4b160979f87d1f31a,0,Andrew Onishuk,2015-09-24 18:08:00+03:00,['4b87356572f1a5479c1ac77374766534d23637bc'],121,124,245,21000084,54,,,,20576
04febac926e70aed3e0546acf6a5b6d92437f19a,0,Sumit Mohanty,2015-09-24 08:14:11-07:00,['688666137427ccae7ee94df4b160979f87d1f31a'],4,78,82,21000166,4,0,1,0.9375,20576
57733408464fb798108391b3e2585732602a9932,1,Aleksandr Kovalenko,2015-09-24 19:55:13+03:00,['04febac926e70aed3e0546acf6a5b6d92437f19a'],2,2,4,21000170,1,1,1,0,20576
d66b4de05cab88b3cfb5425c1a11a4f8ba65196e,1,Lisnichenko Dmitro,2015-09-24 21:12:41+03:00,['57733408464fb798108391b3e2585732602a9932'],30,10,40,21000210,7,,,,20576
eb2e61585e491555d214103ecbef53b2d0819fe0,1,Jayush Luniya,2015-09-24 12:00:29-07:00,['d66b4de05cab88b3cfb5425c1a11a4f8ba65196e'],23,34,57,21000267,10,,,,20576
a8301564a937ec1486b19d2be344e5c83ae9e28c,0,Yusaku Sako,2015-09-24 12:12:56-07:00,['eb2e61585e491555d214103ecbef53b2d0819fe0'],1,1,2,21000269,1,,,,20576
4515215a24c066f91218b2815838e920edf5b01a,0,Yusaku Sako,2015-09-24 14:07:35-07:00,['a8301564a937ec1486b19d2be344e5c83ae9e28c'],1,4,5,21000274,1,0.75,0.75,1,20576
93f86a487e133ce2a04cd3d30ac2a02a6ff63b7a,0,Yusaku Sako,2015-09-24 15:22:17-07:00,['4515215a24c066f91218b2815838e920edf5b01a'],12,16,28,21000302,1,1,1,1,20576
23bf111a00391dcd3cee4e92d19a136fbdc3ca3c,1,Jayush Luniya,2015-09-24 15:55:36-07:00,['93f86a487e133ce2a04cd3d30ac2a02a6ff63b7a'],45,171,216,21000518,5,0.260869565,0.652173913,0.449275362,20576
e1f697a866a7b425dead3186b49ba5c281f4a001,0,Richard Zang,2015-09-24 17:21:31-07:00,['23bf111a00391dcd3cee4e92d19a136fbdc3ca3c'],7,11,18,21000536,2,1,1,1,20576
bc94537f7c32efc094b012573ff457d12e1fdca7,1,Richard Zang,2015-09-24 17:41:31-07:00,['e1f697a866a7b425dead3186b49ba5c281f4a001'],11,24,35,21000571,2,0.5,0.5,1,20576
cda6853564bd68f38ed25543351247bea58e26b2,1,Srimanth Gunturi,2015-09-24 18:29:22-07:00,['bc94537f7c32efc094b012573ff457d12e1fdca7'],5,9,14,21000585,2,0,0,1,20576
360e608861229d7052b49ba44edbd9e3a3cd3854,1,Siddharth Wagle,2015-09-24 18:32:28-07:00,['cda6853564bd68f38ed25543351247bea58e26b2'],5,21,26,21000611,2,1,1,1,20576
31096c8ab690e96029e360710db275642c952fb7,1,Aleksandr Kovalenko,2015-09-25 16:35:34+03:00,['360e608861229d7052b49ba44edbd9e3a3cd3854'],40,47,87,21000698,1,1,1,1,20576
ad31c9e8deed0e15a7fdfd5b7704a095882ac982,1,Lisnichenko Dmitro,2015-09-25 18:17:17+03:00,['31096c8ab690e96029e360710db275642c952fb7'],5,5,10,21000708,2,,,,20576
80e2f2036539e5cf55924c61ab56599092c1987d,1,Dmytro Sen,2015-09-25 20:06:24+03:00,['ad31c9e8deed0e15a7fdfd5b7704a095882ac982'],71,40,111,21000819,4,1,0,0.5,20576
9a7ceb54ec7503f4f1fcad77b7a0a6a6f22b166c,1,Richard Zang,2015-09-25 11:25:11-07:00,['80e2f2036539e5cf55924c61ab56599092c1987d'],3,9,12,21000831,1,0,0,1,20576
e3b0c362fcf5542ce826ba4c798a8be71e2f3bb0,1,Jonathan Hurley,2015-09-25 15:47:21-04:00,['9a7ceb54ec7503f4f1fcad77b7a0a6a6f22b166c'],124,121,245,21001076,54,,,,20576
631ea43d6a82ebf13002ca26bfd57c7083a6996c,0,Nate Cole,2015-09-25 16:23:06-04:00,['e3b0c362fcf5542ce826ba4c798a8be71e2f3bb0'],14,20,34,21001110,1,,,,20576
67b9d4839f4260b782ffd19f4f617174a1bc624f,0,Vitaly Brodetskyi,2015-09-26 00:06:52+03:00,['631ea43d6a82ebf13002ca26bfd57c7083a6996c'],1,1,2,21001112,1,,,,20576
7e2a1c0e24ed9bf1656a31b80b6e2d752739a350,1,Sumit Mohanty,2015-09-25 15:38:07-07:00,['67b9d4839f4260b782ffd19f4f617174a1bc624f'],4,8,12,21001124,1,1,1,1,20576
156afda504ce75fdfaf0efd2509ca757baefc463,1,Jonathan Hurley,2015-09-25 22:29:56-04:00,['7e2a1c0e24ed9bf1656a31b80b6e2d752739a350'],66,26,92,21001216,3,1,0.454545455,0.454545455,20576
474e40862f0e66d12d333d83509453ab5c8728e6,0,Jayush Luniya,2015-09-26 11:27:32-07:00,['156afda504ce75fdfaf0efd2509ca757baefc463'],11,56,67,21001283,2,0,0.777777778,0.777777778,20576
94baa2f02540f1d0cb4d2e0cc7fdb3bf6b17fccf,1,Srimanth Gunturi,2015-09-26 13:16:22-07:00,['474e40862f0e66d12d333d83509453ab5c8728e6'],0,1,1,21001284,1,0,1,1,20576
bb1491f073fd011b91dd58225ff8513923e2629d,0,Jayush Luniya,2015-09-26 13:25:42-07:00,['94baa2f02540f1d0cb4d2e0cc7fdb3bf6b17fccf'],1,1,2,21001286,1,,,,20576
62b7fe87fce2f4d052a358f156aa19ad5c260b8d,0,Andrew Onishuk,2015-09-27 01:15:50+03:00,['bb1491f073fd011b91dd58225ff8513923e2629d'],1,13,14,21001300,4,0,0.833333333,0.833333333,20576
3e7308a1d4cf14216288006955654baa7e867f32,1,Mahadev Konar,2015-09-27 11:27:49-07:00,['62b7fe87fce2f4d052a358f156aa19ad5c260b8d'],24,66,90,21001390,3,0,1,0.733333333,20576
360a4b4a2f6a325e0d51792124d394d180e4788d,1,aBabiichuk,2015-09-28 09:55:05+03:00,['3e7308a1d4cf14216288006955654baa7e867f32'],265,126,391,21001781,9,0.333333333,0,0,20578
a00b06ea10b48f68021ec0406fb6575a4d09d71c,1,Andrew Onishuk,2015-09-28 13:33:36+03:00,['360a4b4a2f6a325e0d51792124d394d180e4788d'],123,128,251,21002032,54,,,,20578
291b7cbf5852db3fa37f4f180158d0958241e05b,0,Andrii Tkach,2015-09-28 14:06:06+03:00,['a00b06ea10b48f68021ec0406fb6575a4d09d71c'],6,0,6,21002038,1,1,0,1,20578
f67543c406be7d014c3c35c1c572f6ff501241be,1,aBabiichuk,2015-09-28 15:02:54+03:00,['291b7cbf5852db3fa37f4f180158d0958241e05b'],19,80,99,21002137,3,0.564102564,1,1,20578
a6ed3633de472ac9dfc159629eb0fefb8322cb33,0,Aleksandr Kovalenko,2015-09-28 19:10:07+03:00,['f67543c406be7d014c3c35c1c572f6ff501241be'],10,5,15,21002152,1,0,0,0,20578
4d44ec7cc4e150d88069c6870477234d8be721ff,1,Myroslav Papirkovskyy,2015-09-28 20:34:36+03:00,['a6ed3633de472ac9dfc159629eb0fefb8322cb33'],0,9,9,21002161,1,,,,20578
6a5a6a3963035a9967dc82cd5a1795c23dca2bc3,1,Alejandro Fernandez,2015-09-28 11:16:21-07:00,['4d44ec7cc4e150d88069c6870477234d8be721ff'],157,97,254,21002415,55,1,0,1,20578
4119f0e5588ee3603efa6e6e57a7856e86b3efe9,0,Andrii Tkach,2015-09-28 21:34:04+03:00,['6a5a6a3963035a9967dc82cd5a1795c23dca2bc3'],3,3,6,21002421,1,,,,20578
460d191a1abdf7c59344149b3e5fb8a24050afb1,1,Bob Nettleton,2015-09-28 14:45:23-04:00,['4119f0e5588ee3603efa6e6e57a7856e86b3efe9'],15,109,124,21002545,2,0,1,1,20578
2b3401640473c0b0988f52dff5683820107d3ecc,0,Alejandro Fernandez,2015-09-28 15:04:25-07:00,['460d191a1abdf7c59344149b3e5fb8a24050afb1'],1,1,2,21002547,1,,,,20578
61540bbb54d023b52ce7e59fee81a067a1cbdcc8,1,Jaimin Jetly,2015-09-28 20:23:52-07:00,['2b3401640473c0b0988f52dff5683820107d3ecc'],91,1278,1369,21003916,32,0.645011601,0.747099768,0.983758701,20583
02c74c87ff35a1570369d0ee8b4acaeae2934cbe,1,Richard Zang,2015-09-28 21:50:51-07:00,['61540bbb54d023b52ce7e59fee81a067a1cbdcc8'],3,9,12,21003928,1,1,1,1,20583
c8ea8573a5b0c37dd467892be3e4774b4b01de20,0,Jayush Luniya,2015-09-28 22:29:31-07:00,['02c74c87ff35a1570369d0ee8b4acaeae2934cbe'],4,17,21,21003949,3,0.666666667,0.333333333,0.666666667,20583
9f5d29784af26a3a98fa83387eb3c610600a7cfb,1,Andrew Onishuk,2015-09-29 13:10:52+03:00,['c8ea8573a5b0c37dd467892be3e4774b4b01de20'],105,105,210,21004159,44,,,,20583
7db1f10c731c67db79214f975ce519d70658a50e,1,Oleg Nechiporenko,2015-09-29 15:42:52+03:00,['9f5d29784af26a3a98fa83387eb3c610600a7cfb'],1,1,2,21004161,1,,,,20583
a1488cec7378b29bf04be08b901d6a210cfa9269,1,Dmytro Sen,2015-09-29 16:21:03+03:00,['7db1f10c731c67db79214f975ce519d70658a50e'],6,15,21,21004182,1,,,,20583
d4edf4619c1c0bb309920ba86e66012a2a2e7090,1,Aleksandr Kovalenko,2015-09-29 18:31:38+03:00,['a1488cec7378b29bf04be08b901d6a210cfa9269'],13,18,31,21004213,6,,,,20583
50099dd40c72f07f55cbe60a0426f9e70e2102bb,1,Dmytro Sen,2015-09-29 21:00:43+03:00,['d4edf4619c1c0bb309920ba86e66012a2a2e7090'],10,25,35,21004248,2,0.384615385,0.846153846,0.615384615,20583
e203fae4d8b37f1438fea93c9da7c72b504d613e,0,Oleg Nechiporenko,2015-09-30 15:14:02+03:00,['50099dd40c72f07f55cbe60a0426f9e70e2102bb'],2,85,87,21004335,3,1,1,1,20583
b3d36fb5c7dcd498bb48c629c810a74161c139f3,0,Andrew Onishuk,2015-09-30 15:59:37+03:00,['e203fae4d8b37f1438fea93c9da7c72b504d613e'],8,42,50,21004385,4,0.8,0.8,0.4,20583
bff61b83e962dfc7a8c7c9f8198bd038f16b6ec7,1,Dmytro Sen,2015-09-30 17:41:48+03:00,['b3d36fb5c7dcd498bb48c629c810a74161c139f3'],9,182,191,21004576,9,0,0.909090909,1,20584
578a15351a0526d7725a2f93b8f519ed03e58192,0,Aleksandr Kovalenko,2015-09-30 18:00:52+03:00,['bff61b83e962dfc7a8c7c9f8198bd038f16b6ec7'],0,7,7,21004583,1,,,,20584
7624366b4b4020892c6f87787635bfc4542e8834,1,Aleksandr Kovalenko,2015-09-30 18:00:52+03:00,['578a15351a0526d7725a2f93b8f519ed03e58192'],126,212,338,21004921,15,0.583333333,0.520833333,0.895833333,20585
c538a4d2c900b90aeae92181a93a10bc5ede75c6,1,Jayush Luniya,2015-09-30 21:28:04-07:00,['7624366b4b4020892c6f87787635bfc4542e8834'],2,44,46,21004967,2,0,0.64516129,1,20585
abf1cb84757d0f6132a7db59ea24a3c5a80f3f50,1,Andrew Onishuk,2015-10-01 14:43:57+03:00,['c538a4d2c900b90aeae92181a93a10bc5ede75c6'],42,8,50,21005017,4,0.2,0.2,0.6,20585
d2e11c86805d998796a23374a9f55b898066bbee,1,Andrew Onishuk,2015-10-01 14:43:57+03:00,['abf1cb84757d0f6132a7db59ea24a3c5a80f3f50'],1,49,50,21005067,3,0.5,0.5,1,20586
0fc2cd584d9f82f07879d4d00b6dc01666da288c,0,Andrew Onishuk,2015-10-01 14:49:09+03:00,['d2e11c86805d998796a23374a9f55b898066bbee'],16,0,16,21005083,1,,,,20586
4e5489bac15f92771eaaa86e548bc7b09dd1945f,1,Andrii Tkach,2015-10-01 15:58:30+03:00,['0fc2cd584d9f82f07879d4d00b6dc01666da288c'],355,1743,2098,21007181,23,0.714983713,1,1,20591
c4b48e9fa34601ec216911c700929682d2163067,1,Robert Levas,2015-10-01 11:59:52-04:00,['4e5489bac15f92771eaaa86e548bc7b09dd1945f'],1,509,510,21007691,6,0.192982456,0.929824561,0.934210526,20593
805a2e81ae8fb014aa193f17fe3cdd43aad22918,1,Andrew Onishuk,2015-10-01 19:42:50+03:00,['c4b48e9fa34601ec216911c700929682d2163067'],10,46,56,21007747,4,0,0.814814815,0.37037037,20593
8cd16dc8a4c30104f3a0094ac1416ef4fa365498,1,Jonathan Hurley,2015-10-01 14:19:51-04:00,['805a2e81ae8fb014aa193f17fe3cdd43aad22918'],31,127,158,21007905,4,0.5,0,1,20594
2df0abec1cd3b2651712abe04861ce4b5e4e8b48,1,Andrew Onishuk,2015-10-01 22:14:21+03:00,['8cd16dc8a4c30104f3a0094ac1416ef4fa365498'],53,58,111,21008016,3,0,0,0,20594
3b41174457b8c15800812f54b81ee90683c32724,1,Robert Levas,2015-10-01 16:10:56-04:00,['2df0abec1cd3b2651712abe04861ce4b5e4e8b48'],481,4094,4575,21012591,45,0.331899642,0.850179211,0.94265233,20615
64769850741b7aa39c5193040b9682df56cb3fbf,1,Bob Nettleton,2015-10-01 18:00:05-04:00,['3b41174457b8c15800812f54b81ee90683c32724'],73,1018,1091,21013682,12,0.310869565,0.993478261,0.991304348,20619
13dc76c72103056c5a8b9ed35587e59b0857f0f6,1,aBabiichuk,2015-10-02 09:43:24+03:00,['64769850741b7aa39c5193040b9682df56cb3fbf'],517,286,803,21014485,16,0,0,1,20620
13ffc4d203f1695b2119fddd9f2d7a12aabd0db4,0,aBabiichuk,2015-10-02 10:08:41+03:00,['13dc76c72103056c5a8b9ed35587e59b0857f0f6'],8,9,17,21014502,4,,,,20620
ade3dfb06b3ec3ece6985f4dbf7c03541cdbba61,0,Vitaly Brodetskyi,2015-10-02 10:34:06+03:00,['13ffc4d203f1695b2119fddd9f2d7a12aabd0db4'],3,4,7,21014509,2,,,,20620
69988db509308168f896109534b1e3bffdb200a1,0,Vitaly Brodetskyi,2015-10-02 11:01:33+03:00,['ade3dfb06b3ec3ece6985f4dbf7c03541cdbba61'],0,7,7,21014516,1,,,,20620
f0949259f0b2a22acb1a8ae6d3c8af24964464a1,1,Oleg Nechiporenko,2015-10-02 12:42:48+03:00,['69988db509308168f896109534b1e3bffdb200a1'],7745,4358,12103,21026619,35,0.828944004,0.220659678,0.190744055,20623
9286b1c0206221ffd4fe0774c1b151da12ac8cc3,1,Andrew Onishuk,2015-10-02 14:41:30+03:00,['f0949259f0b2a22acb1a8ae6d3c8af24964464a1'],0,62,62,21026681,4,0,0,1,20624
3fbdd9d6e093e972d16eb865e504662f328fa5bf,1,Oleg Nechiporenko,2015-10-02 15:54:55+03:00,['9286b1c0206221ffd4fe0774c1b151da12ac8cc3'],1,1,2,21026683,1,,,,20624
4b437ea4f1461d6bec197b7d748b7aa86f7e89f6,0,Robert Levas,2015-10-02 11:38:11-04:00,['3fbdd9d6e093e972d16eb865e504662f328fa5bf'],1,42,43,21026726,2,0,0.826086957,1,20624
e04c4d0f6cedf686e7865287f33a3893f6e5dc4d,1,Lisnichenko Dmitro,2015-10-02 18:48:03+03:00,['4b437ea4f1461d6bec197b7d748b7aa86f7e89f6'],0,12,12,21026738,2,,,,20624
37f2617a6a7d2b339f3ee62111e01c3ad89dbc00,0,Lisnichenko Dmitro,2015-10-02 18:48:08+03:00,['e04c4d0f6cedf686e7865287f33a3893f6e5dc4d'],18,51,69,21026807,5,,,,20625
bfc35fe8f6d992afade25889387c3274d2c3ab02,0,Siddharth Wagle,2015-10-02 09:29:05-07:00,['37f2617a6a7d2b339f3ee62111e01c3ad89dbc00'],0,126,126,21026933,6,,,,20625
321d57b0de3475977741497d206990dccd4b6f40,1,John Speidel,2015-10-02 15:17:17-04:00,['bfc35fe8f6d992afade25889387c3274d2c3ab02'],5,256,261,21027194,4,0.229885057,1,0.896551724,20626
ccd64811d87dfd9ccb3c814285c8cf082270d237,1,Jaimin Jetly,2015-10-02 12:35:15-07:00,['321d57b0de3475977741497d206990dccd4b6f40'],57,1015,1072,21028266,18,0.860759494,0.835443038,1,20627
c9f8d1a84acb5275ca184e6a42b4553c3f03e0f8,1,Sumit Mohanty,2015-10-02 15:20:02-07:00,['ccd64811d87dfd9ccb3c814285c8cf082270d237'],1,1700,1701,21029967,36,0.2,0.882352941,0.882352941,20662
279a269e60b84f20780000bbe016e3df0ba2b517,1,Yusaku Sako,2015-10-02 15:53:56-07:00,['c9f8d1a84acb5275ca184e6a42b4553c3f03e0f8'],20,13,33,21030000,3,,,,20662
1f5acf20f19c0965c88185b5e19b487694db9c56,0,Yusaku Sako,2015-10-02 15:56:25-07:00,['279a269e60b84f20780000bbe016e3df0ba2b517'],0,2,2,21030002,1,,,,20662
7aa9f6ca335812f57625a6aed7bbd274d0165b5e,1,Jaimin Jetly,2015-10-02 17:51:17-07:00,['1f5acf20f19c0965c88185b5e19b487694db9c56'],78,243,321,21030323,8,0.75,0.75,1,20662
a125f978cb3bbae5ffcb81742cfe12dec2177f1f,0,Sumit Mohanty,2015-10-04 07:45:20-07:00,['7aa9f6ca335812f57625a6aed7bbd274d0165b5e'],0,21,21,21030344,1,,,,20662
b8be80b08cf50436fb1285b5deaa6a4ca8fe8739,0,Andrew Onishuk,2015-10-05 12:12:34+03:00,['a125f978cb3bbae5ffcb81742cfe12dec2177f1f'],0,4,4,21030348,1,0,1,0,20662
920c29dd8d17f874448855398813e140863caf35,0,Oleg Nechiporenko,2015-10-05 12:49:30+03:00,['b8be80b08cf50436fb1285b5deaa6a4ca8fe8739'],2,12,14,21030362,2,0.909090909,0.909090909,1,20662
a845a44a22c6a2ba6222a110359233f365feb51b,1,Alex Antonenko,2015-10-05 13:21:07+03:00,['920c29dd8d17f874448855398813e140863caf35'],12,2,14,21030376,2,0.090909091,0.090909091,0,20662
cad57c562692ac7bc8c61a3d4504a8c12fdae2f0,1,Andrew Onishuk,2015-10-05 14:30:43+03:00,['a845a44a22c6a2ba6222a110359233f365feb51b'],14,10,24,21030400,2,1,0,1,20662
33c8681709894495263ebc9f22f7825c08605155,1,Andrew Onishuk,2015-10-05 15:12:47+03:00,['cad57c562692ac7bc8c61a3d4504a8c12fdae2f0'],16,23,39,21030439,5,0.714285714,0.714285714,0,20662
c53cfffdd09774906a7a97b9b9fff6b4cd5c7c3d,0,Aleksandr Kovalenko,2015-10-05 15:19:16+03:00,['33c8681709894495263ebc9f22f7825c08605155'],4,21,25,21030464,4,0,1,1,20662
f20ebd72bbf21098680d66cf8777b9fcb7d6b72e,1,Alex Antonenko,2015-10-05 15:45:01+03:00,['c53cfffdd09774906a7a97b9b9fff6b4cd5c7c3d'],3,3,6,21030470,1,,,,20662
ce8238b605449bee2134cfa8880b44d5fc8545f8,1,Andrii Tkach,2015-10-05 16:14:36+03:00,['f20ebd72bbf21098680d66cf8777b9fcb7d6b72e'],152,63,215,21030685,2,0,0,0,20662
ef80b5ef38f8761b69ea2c01cf225d36e39c58a1,1,Alex Antonenko,2015-10-05 20:15:00+03:00,['ce8238b605449bee2134cfa8880b44d5fc8545f8'],137,756,893,21031578,18,0.587131367,0.970509383,0.90616622,20665
93f0896ec28a60a70e72ea9870374003fd2dcc90,1,Lisnichenko Dmitro,2015-10-05 20:51:06+03:00,['ef80b5ef38f8761b69ea2c01cf225d36e39c58a1'],1,332,333,21031911,5,0.540322581,0.838709677,1,20667
329d2b5424492eac6c6b16f3e85ce5e33da6f51f,1,Andrew Onishuk,2015-10-05 23:57:25+03:00,['93f0896ec28a60a70e72ea9870374003fd2dcc90'],1,46,47,21031958,2,,,,20667
e6725016f7417b6e90c1d3cde028a33bda41bf23,1,Oleg Nechiporenko,2015-10-06 10:57:55+03:00,['329d2b5424492eac6c6b16f3e85ce5e33da6f51f'],7,14,21,21031979,2,0,0,0,20667
aeebae6eb7609398c807360985724e1310829681,1,Andrii Tkach,2015-10-06 11:19:39+03:00,['e6725016f7417b6e90c1d3cde028a33bda41bf23'],58,117,175,21032154,5,1,1,1,20667
4011611574cf2c1de9517b165ec109feba97c622,0,Andrew Onishuk,2015-10-06 12:39:08+03:00,['aeebae6eb7609398c807360985724e1310829681'],1,10,11,21032165,2,0,1,1,20667
6b8f692437a923510c60b157aceef57e749c271b,1,Aleksandr Kovalenko,2015-10-06 13:28:03+03:00,['4011611574cf2c1de9517b165ec109feba97c622'],1,1,2,21032167,1,,,,20667
815c5caaa846a45dbded22da488a0242127ead2e,1,Andrew Onishuk,2015-10-06 14:12:23+03:00,['6b8f692437a923510c60b157aceef57e749c271b'],38,34,72,21032239,1,0,0,0,20667
ebccd7224d53ce4178c57cb0fa6379d6a6470c3b,0,Andrew Onishuk,2015-10-06 15:16:13+03:00,['815c5caaa846a45dbded22da488a0242127ead2e'],26,4,30,21032269,3,0.166666667,1,0.833333333,20667
7ffa43ef5aafa716f8e4d0f7647d85e4675c9371,1,aBabiichuk,2015-10-06 16:30:44+03:00,['ebccd7224d53ce4178c57cb0fa6379d6a6470c3b'],20,19,39,21032308,1,1,1,1,20667
0d676b3234a5f31c5b11d6b52e6648e44b39e09d,1,Alex Antonenko,2015-10-06 20:17:29+03:00,['7ffa43ef5aafa716f8e4d0f7647d85e4675c9371'],3,790,793,21033101,3,0.399103139,0.778026906,0.822869955,20667
828c7fa8a818b4b7e8d83b4d2c470894cac0c714,1,Jaimin Jetly,2015-10-06 18:12:32-07:00,['0d676b3234a5f31c5b11d6b52e6648e44b39e09d'],37,68,105,21033206,3,0,0,0,20667
8eceffe5de2e82ce1ca38430d068e35cda56be45,1,Alex Antonenko,2015-10-07 11:35:04+03:00,['828c7fa8a818b4b7e8d83b4d2c470894cac0c714'],39,236,275,21033481,16,0.712328767,1,1,20671
20d08834df93376d9845facc2581e5c8267fe436,1,Robert Levas,2015-10-07 01:59:24-07:00,['8eceffe5de2e82ce1ca38430d068e35cda56be45'],0,14,14,21033495,2,0.4,1,1,20671
d729ce3fb565b6e06a7d51e89642fa267d4cbdb2,1,aBabiichuk,2015-10-07 12:00:37+03:00,['20d08834df93376d9845facc2581e5c8267fe436'],3,4,7,21033502,4,,,,20671
e1caac3aaa6e719bed91ab0cde814c14347288ed,1,Oleg Nechiporenko,2015-10-07 12:18:10+03:00,['d729ce3fb565b6e06a7d51e89642fa267d4cbdb2'],15,98,113,21033615,5,1,0.65,1,20671
61f6523a637e661cc6c5bb4e3f7e31d357bfc904,1,Lisnichenko Dmitro,2015-10-07 12:23:52+03:00,['e1caac3aaa6e719bed91ab0cde814c14347288ed'],66,307,373,21033988,13,0.139784946,0.64516129,1,20671
15ac283641e22a5c1ce25a24020480ade79ffd0e,1,Andrii Tkach,2015-10-07 15:10:33+03:00,['61f6523a637e661cc6c5bb4e3f7e31d357bfc904'],4,10,14,21034002,1,,,,20671
4e12263b91743174386f348bb5b77b13694c714a,1,Nate Cole,2015-10-07 06:52:52-07:00,['15ac283641e22a5c1ce25a24020480ade79ffd0e'],19,297,316,21034318,11,0.256410256,0.371794872,0.846153846,20672
78e49db0a1ba569a8e580c4ef182246475e0693f,1,Alex Antonenko,2015-10-07 18:03:46+03:00,['15ac283641e22a5c1ce25a24020480ade79ffd0e'],15,721,736,21035054,15,0.943859649,1,0.807017544,20675
44c2646668f29c7e79c8ffb3ff290bed1f53ed0d,1,Robert Levas,2015-10-07 08:17:45-07:00,['78e49db0a1ba569a8e580c4ef182246475e0693f'],864,343,1207,21036261,14,0.661971831,0.643192488,0,20675
998c17132bd3e18ebee72617747ad63725bbf510,0,Oleksandr Diachenko,2015-10-07 13:53:45-07:00,['44c2646668f29c7e79c8ffb3ff290bed1f53ed0d'],0,114,114,21036375,3,0,0,0,20675
3c8bf9de2afaab2e4894e875d9f2cd44a9a7eab6,0,Jonathan Hurley,2015-10-07 14:12:11-07:00,['998c17132bd3e18ebee72617747ad63725bbf510'],4,0,4,21036379,1,1,0,1,20675
b0fc4a6ffcecdd84100a4dbcd7b677ca63cf6221,0,Oleksandr Diachenko,2015-10-07 16:16:57-07:00,['3c8bf9de2afaab2e4894e875d9f2cd44a9a7eab6'],114,0,114,21036493,3,1,1,1,20675
7d6b2d74d6d14b1df5e1391adc7d7ee640da2e1f,1,Jaimin Jetly,2015-10-07 22:00:33-07:00,['b0fc4a6ffcecdd84100a4dbcd7b677ca63cf6221'],4,487,491,21036984,14,0.642857143,0.523809524,0.071428571,20676
e9389246dc3dbe98eccf32e8ad89eca808e6438f,1,Gautam Borad,2015-10-08 11:38:43+05:18,['7d6b2d74d6d14b1df5e1391adc7d7ee640da2e1f'],45,24,69,21037053,4,1,1,1,20676
c6303b67b363790128eea12f99e7d8ad14ecb6d7,1,Andrew Onishuk,2015-10-08 13:08:54+03:00,['e9389246dc3dbe98eccf32e8ad89eca808e6438f'],12,7,19,21037072,2,0,1,0,20676
be01031a36a3c5c8b6a334aecb175a684f910e9b,1,Andrew Onishuk,2015-10-08 13:11:22+03:00,['c6303b67b363790128eea12f99e7d8ad14ecb6d7'],0,9,9,21037081,2,0,0.666666667,1,20676
3c9a79e67082edc5b731fb42eed9fbadc54ca848,0,Lisnichenko Dmitro,2015-10-08 14:29:40+03:00,['be01031a36a3c5c8b6a334aecb175a684f910e9b'],1,1,2,21037083,1,,,,20676
ef7b9aa29eb7dfafd23eacdf10b2af08e0ef2c01,1,Andrii Tkach,2015-10-08 15:09:23+03:00,['3c9a79e67082edc5b731fb42eed9fbadc54ca848'],43,33,76,21037159,1,1,0.125,0,20676
77281dd5826ce8860c26c8b79b3afe5e30832414,1,Dmytro Sen,2015-10-08 16:20:44+03:00,['ef7b9aa29eb7dfafd23eacdf10b2af08e0ef2c01'],0,314,314,21037473,3,,,,20679
e28dce4d502119b280ebc9c3e8071f15e2eb3284,1,Oleg Nechiporenko,2015-10-08 16:47:43+03:00,['77281dd5826ce8860c26c8b79b3afe5e30832414'],15,285,300,21037773,10,0.777777778,1,1,20681
361f0a49da0f8b64e8421ed3b0eed40e54d793d7,1,Andrii Tkach,2015-10-08 17:17:29+03:00,['e28dce4d502119b280ebc9c3e8071f15e2eb3284'],7,9,16,21037789,2,0,0,1,20681
664bde1c6e15961b39eb673b337be9f7bc6a50d2,0,Andrew Onishuk,2015-10-08 18:22:20+03:00,['361f0a49da0f8b64e8421ed3b0eed40e54d793d7'],7,5,12,21037801,2,,,,20681
b434f18915954a725c1f8cd81b71907c2a9f5174,1,Vitaly Brodetskyi,2015-10-08 18:41:07+03:00,['664bde1c6e15961b39eb673b337be9f7bc6a50d2'],21,227,248,21038049,4,0,0.795180723,0.253012048,20683
3588fc790a05b36c6d02b7d239af48bad5dc1bd8,1,Alex Antonenko,2015-10-08 19:52:43+03:00,['b434f18915954a725c1f8cd81b71907c2a9f5174'],40,110,150,21038199,13,1,1,1,20685
588d4313819a85c87ba66761134bcb8ba66a53a3,1,Alex Antonenko,2015-10-08 19:52:43+03:00,['3588fc790a05b36c6d02b7d239af48bad5dc1bd8'],245,29,274,21038473,11,0.865284974,0.031088083,0,20685
7bb91551e772756c4ffcc12a79114aa074145130,1,Dmytro Sen,2015-10-08 20:21:54+03:00,['588d4313819a85c87ba66761134bcb8ba66a53a3'],132,274,406,21038879,9,1,1,0,20687
992124379b4bbaf1f35eaa337595657c5f9f79d7,0,Xi Wang,2015-10-08 13:46:44-07:00,['7bb91551e772756c4ffcc12a79114aa074145130'],0,10,10,21038889,1,1,1,1,20687
cfe3c8041fd53162f8c7393dfb38299f17508141,1,Vitaly Brodetskyi,2015-10-09 00:02:55+03:00,['992124379b4bbaf1f35eaa337595657c5f9f79d7'],45,42,87,21038976,1,1,0,0,20687
a1f105496dfad5085653f18097d6e1e18da7f224,0,Andrew Onishuk,2015-10-09 09:44:30+03:00,['cfe3c8041fd53162f8c7393dfb38299f17508141'],10,1,11,21038987,2,1,0,0,20687
a6c6faf2b132bdb5c6c50804390544b447c83f63,1,Gautam Borad,2015-10-09 12:24:40+05:18,['a1f105496dfad5085653f18097d6e1e18da7f224'],22,33,55,21039042,9,0.166666667,0.166666667,0,20687
6eb63621183a45e084fee458e431644967dd5c2d,1,Andrew Onishuk,2015-10-09 12:20:38+03:00,['a6c6faf2b132bdb5c6c50804390544b447c83f63'],3,14,17,21039059,3,0,0.666666667,1,20687
9464049229afc83fe33dc39eeb75980b56d71f89,1,Vitaly Brodetskyi,2015-10-09 12:44:38+03:00,['6eb63621183a45e084fee458e431644967dd5c2d'],11,17,28,21039087,2,0.266666667,0.466666667,1,20687
800e425973f38b6239246e192b65e8bc82498f76,1,Vitaly Brodetskyi,2015-10-09 13:23:32+03:00,['9464049229afc83fe33dc39eeb75980b56d71f89'],150,63,213,21039300,3,1,0.921052632,0,20687
9ea0ffd0f41f510d683da7da9e3fb32605f15033,1,Andrew Onishuk,2015-10-09 14:52:37+03:00,['800e425973f38b6239246e192b65e8bc82498f76'],1,33,34,21039334,2,0.08,0.08,1,20687
a64c469718a5395e9adfdabf46fe15b7040adf89,0,Andrew Onishuk,2015-10-09 15:21:38+03:00,['9ea0ffd0f41f510d683da7da9e3fb32605f15033'],17,26,43,21039377,2,0.333333333,1,0,20687
f1404eaf877a76c943e6097db95bd5088e30826f,0,Andrii Tkach,2015-10-09 16:10:04+03:00,['a64c469718a5395e9adfdabf46fe15b7040adf89'],2,2,4,21039381,1,,,,20687
370077ea8268e2d4c06a1886391c9ed467530015,1,Alex Antonenko,2015-10-09 16:35:07+03:00,['f1404eaf877a76c943e6097db95bd5088e30826f'],1,1,2,21039383,1,,,,20687
1fcc5ab1e043728e86d81b3eae7113811ff6eaff,1,Oleg Nechiporenko,2015-10-09 16:48:47+03:00,['370077ea8268e2d4c06a1886391c9ed467530015'],7,17,24,21039407,3,1,1,1,20687
375205079bf198bc16b4cdf8838692486e910ae5,1,Alex Antonenko,2015-10-09 16:53:20+03:00,['1fcc5ab1e043728e86d81b3eae7113811ff6eaff'],7,106,113,21039520,5,1,1,0.829268293,20687
a143c01ad3b440135e74e7426f43aa3c691d7ab2,1,Oleg Nechiporenko,2015-10-09 17:06:56+03:00,['375205079bf198bc16b4cdf8838692486e910ae5'],0,1,1,21039521,1,1,1,1,20687
88414a5d1d7b7ce02259e21bfc5465ab73548072,1,Dmytro Sen,2015-10-09 18:55:10+03:00,['a143c01ad3b440135e74e7426f43aa3c691d7ab2'],3,3,6,21039527,3,,,,20687
9992147b040a695d9ebaeabadcf43d33b6598a08,1,Lisnichenko Dmitro,2015-10-09 20:00:13+03:00,['88414a5d1d7b7ce02259e21bfc5465ab73548072'],0,115,115,21039642,2,0,0.614583333,0.75,20687
a3906844606a2b2b681d0a3d863e8dba8a95ae1f,1,Jaimin Jetly,2015-10-09 12:11:09-07:00,['9992147b040a695d9ebaeabadcf43d33b6598a08'],69,305,374,21040016,10,0.454545455,0.454545455,1,20687
a40ce75e50b256bf64a4890e266908fa7a7df8ff,0,Xi Wang,2015-10-09 12:48:45-07:00,['a3906844606a2b2b681d0a3d863e8dba8a95ae1f'],4,32,36,21040052,2,1,1,1,20687
8967ed9bc8967f6f6783c16f6403a3de0a0b2792,1,Jaimin Jetly,2015-10-09 13:29:23-07:00,['a40ce75e50b256bf64a4890e266908fa7a7df8ff'],23,23,46,21040098,2,1,1,1,20687
1e49680b14107f22e40c93ef2dd8f84167c899cc,0,Eric Yang,2015-10-11 11:32:54-07:00,['8967ed9bc8967f6f6783c16f6403a3de0a0b2792'],1,1,2,21040100,1,,,,20687
03c399c0f2cb5945cfbc3c89f986ffa6b959a5b6,1,Alex Antonenko,2015-10-12 12:23:44+03:00,['1e49680b14107f22e40c93ef2dd8f84167c899cc'],3,92,95,21040195,4,0.707692308,1,1,20688
15bdb71047f33f77bf9fef451f24ec2e2b0b4e34,0,Oleg Nechiporenko,2015-10-12 12:39:03+03:00,['03c399c0f2cb5945cfbc3c89f986ffa6b959a5b6'],2,44,46,21040241,2,0.425,1,1,20688
fa6f80a7652861e8a573347b6e8959d49aa8ac6a,1,Alex Antonenko,2015-10-12 15:19:37+03:00,['15bdb71047f33f77bf9fef451f24ec2e2b0b4e34'],79,74,153,21040394,1,,,,20688
c58162fe3538f8e4d67ad11da6f7d3c8940012a6,1,Lisnichenko Dmitro,2015-10-12 15:20:44+03:00,['fa6f80a7652861e8a573347b6e8959d49aa8ac6a'],1954,5244,7198,21047592,123,0.327054795,0.354452055,0.592465753,20707
aef3af9b3dc4011e65bcf43586a8e7677677e111,0,Lisnichenko Dmitro,2015-10-12 15:22:29+03:00,['c58162fe3538f8e4d67ad11da6f7d3c8940012a6'],7,35,42,21047634,2,0,0.913043478,0.913043478,20707
633242ccebf45b9516debefde04f146f6a173fed,1,Dmytro Sen,2015-10-12 16:02:34+03:00,['aef3af9b3dc4011e65bcf43586a8e7677677e111'],56,75,131,21047765,6,0,0,0,20707
e8dbb1327d5a6bd98538fc5f35d69775677aa85b,1,Oleg Nechiporenko,2015-10-12 16:13:38+03:00,['633242ccebf45b9516debefde04f146f6a173fed'],12,34,46,21047811,2,0.777777778,0.777777778,1,20707
9b0c24687fe47624e8284daf3609b1134e330323,1,Andrew Onishuk,2015-10-12 17:48:05+03:00,['e8dbb1327d5a6bd98538fc5f35d69775677aa85b'],12,135,147,21047958,6,0,1,1,20707
62b9f9551b596d5abd114492ea0c6c976a0e6cea,1,Andrew Onishuk,2015-10-12 18:48:24+03:00,['9b0c24687fe47624e8284daf3609b1134e330323'],0,875,875,21048833,4,0,0.97826087,1,20708
5601b1404ee116e8994102525227817f88176706,1,Andrii Tkach,2015-10-12 19:17:40+03:00,['62b9f9551b596d5abd114492ea0c6c976a0e6cea'],1,76,77,21048910,2,0.673469388,1,1,20708
922828e95be49263741a76fddaa8a2c216db4d87,1,Dmytro Sen,2015-10-12 19:22:05+03:00,['5601b1404ee116e8994102525227817f88176706'],3390,1675,5065,21053975,21,1,0,1,20708
e5f5a83ea02443eab8d906d14a40203971ae7730,1,Lisnichenko Dmitro,2015-10-12 20:06:31+03:00,['922828e95be49263741a76fddaa8a2c216db4d87'],0,1,1,21053976,1,,,,20708
259ee9807e5f41d91aeb9d746a5267881ff2d5c8,1,Oleksandr Diachenko,2015-10-12 13:03:51-07:00,['e5f5a83ea02443eab8d906d14a40203971ae7730'],0,105,105,21054081,3,0,0,0,20708
98d677395c319a65b349c00b6c98cca04402ff64,1,Xi Wang,2015-10-12 16:07:05-07:00,['259ee9807e5f41d91aeb9d746a5267881ff2d5c8'],4,4,8,21054089,2,,,,20708
7874e15b02080f500284ed37e77b454f4e477439,0,Alejandro Fernandez,2015-10-12 16:35:19-07:00,['98d677395c319a65b349c00b6c98cca04402ff64'],0,0,0,21054089,2,,,,20708
f942dad807f69d81dd34101d3bfca6a536e5e96f,0,Sumit Mohanty,2015-10-12 17:12:25-07:00,['7874e15b02080f500284ed37e77b454f4e477439'],0,4,4,21054093,1,,,,20708
879fc9b4969d49fba7e2961c816bf3d807d3858e,1,Gautam Borad,2015-10-13 10:02:55+05:18,['f942dad807f69d81dd34101d3bfca6a536e5e96f'],114,138,252,21054345,2,1,0.045454545,1,20708
f32e65b08ba5dbc3bca95d6ca1f295e24b9706a7,1,Vitaly Brodetskyi,2015-10-13 15:08:29+03:00,['879fc9b4969d49fba7e2961c816bf3d807d3858e'],40,115,155,21054500,4,0,0.672413793,1,20708
232829c508e5d5a25ba06d5a4f48d67121684081,1,Andrii Tkach,2015-10-13 15:34:33+03:00,['f32e65b08ba5dbc3bca95d6ca1f295e24b9706a7'],31,103,134,21054634,4,1,1,1,20708
0da6327ac2290dac608c86551cac485c59a7972d,1,Dmytro Sen,2015-10-13 16:11:43+03:00,['232829c508e5d5a25ba06d5a4f48d67121684081'],15,93,108,21054742,5,0.013513514,0.594594595,1,20708
45ce79631b95066664e3a8a01661f1daa9739dd2,1,Sumit Mohanty,2015-10-13 06:52:33-07:00,['0da6327ac2290dac608c86551cac485c59a7972d'],3,50,53,21054795,3,0.875,0.90625,1,20708
c6c7f3955ddae61ac8dadb15dd1503e1e19a5766,1,Andrew Onishuk,2015-10-13 18:32:40+03:00,['45ce79631b95066664e3a8a01661f1daa9739dd2'],76,76,152,21054947,23,,,,20708
51c7688e840adb9799fbab101d8d12ed49713feb,1,Srimanth Gunturi,2015-10-13 10:12:06-07:00,['c6c7f3955ddae61ac8dadb15dd1503e1e19a5766'],29,9,38,21054985,3,0,0,0,20708
595a99611ff60c7fc54bbf756872706d501f7b7e,1,Srimanth Gunturi,2015-10-13 10:15:19-07:00,['51c7688e840adb9799fbab101d8d12ed49713feb'],3,11,14,21054999,4,1,1,1,20708
d7269e6e08d2b9e9de735c89277a889c8499b6a1,0,Sumit Mohanty,2015-10-13 10:51:57-07:00,['595a99611ff60c7fc54bbf756872706d501f7b7e'],0,7,7,21055006,1,,,,20708
6df37bba87c2951f564c00ee69fa2c385d1cf1ff,1,Sumit Mohanty,2015-10-13 10:56:16-07:00,['d7269e6e08d2b9e9de735c89277a889c8499b6a1'],80,205,285,21055291,12,0.378947368,0.547368421,0.768421053,20708
81eff4e59046bfd29737548527ede2a8ad391526,1,Jonathan Hurley,2015-10-13 14:13:16-04:00,['6df37bba87c2951f564c00ee69fa2c385d1cf1ff'],154,154,308,21055599,4,,,,20708
b33ad0791e5e643b4c621898c18f48245514dea8,1,Andrew Onishuk,2015-10-13 22:21:14+03:00,['81eff4e59046bfd29737548527ede2a8ad391526'],2,2,4,21055603,1,,,,20708
92915952abe64e390b5ec348abc0768746b8be7b,1,Xi Wang,2015-10-13 18:10:12-07:00,['b33ad0791e5e643b4c621898c18f48245514dea8'],28,595,623,21056226,9,0.815286624,1,0.74522293,20709
31542ae31be265e0fa309e3a33bccccc91b4cb90,1,Robert Levas,2015-10-13 22:25:15-04:00,['92915952abe64e390b5ec348abc0768746b8be7b'],68,345,413,21056639,12,1,1,0.87804878,20713
7a38f385e61be17de7dc9366b536d10293fe6c8f,1,Jaimin Jetly,2015-10-13 21:50:15-07:00,['31542ae31be265e0fa309e3a33bccccc91b4cb90'],71,505,576,21057215,8,0.214285714,1,0.428571429,20713
703192fd8c7db3d925441bbfcf8a8e61f82b34b1,1,Jonathan Hurley,2015-10-14 09:01:11-04:00,['7a38f385e61be17de7dc9366b536d10293fe6c8f'],29,141,170,21057385,2,0,0.836065574,1,20713
f99d821189c00310435e9ec1847bb86ee73bdb8f,1,Nate Cole,2015-10-14 13:20:55-04:00,['4e12263b91743174386f348bb5b77b13694c714a'],102,129,231,21057616,6,0.35,0,1,20713
5298bde6150b7558374ef9999d3a863e99d8265c,0,jaoki,2015-10-14 12:05:13-07:00,['703192fd8c7db3d925441bbfcf8a8e61f82b34b1'],5,10,15,21057631,2,,,,20713
5cd87b03cb7eba3a6dca119455b4d1a3466f66ac,0,jaoki,2015-10-14 12:16:29-07:00,['5298bde6150b7558374ef9999d3a863e99d8265c'],1,1,2,21057633,1,,,,20713
6994fc7b04c75253984f6ca068f7e597bab635cd,0,Jaimin Jetly,2015-10-14 13:35:45-07:00,['5cd87b03cb7eba3a6dca119455b4d1a3466f66ac'],4,21,25,21057658,1,0,0,1,20713
5a93dfd4ade85c4ddba4d97fc184d44241d919ec,1,Alejandro Fernandez,2015-10-14 13:37:43-07:00,['6994fc7b04c75253984f6ca068f7e597bab635cd'],3150,95,3245,21060903,13,0.052631579,0.473684211,0.578947368,20713
e019c6c15026f90370363965070baea1d921d8a9,0,Alejandro Fernandez,2015-10-14 14:06:10-07:00,['5a93dfd4ade85c4ddba4d97fc184d44241d919ec'],0,14,14,21060917,1,,,,20713
c00908495953e7c725bd49b7a124883d12621324,0,Jayush Luniya,2015-10-14 15:43:34-07:00,['e019c6c15026f90370363965070baea1d921d8a9'],61,58,119,21061036,2,0,0,1,20713
55645640dbc27c33517220197643b0d7d0d78a85,1,Richard Zang,2015-10-14 18:17:39-07:00,['c00908495953e7c725bd49b7a124883d12621324'],10,148,158,21061194,5,0.957983193,0.890756303,0.957983193,20713
8c972fc52f96299f9904cdbe418cf98e4e1d1294,1,Jayush Luniya,2015-10-14 19:04:18-07:00,['55645640dbc27c33517220197643b0d7d0d78a85'],34,34,68,21061262,10,,,,20713
bb65cc04937d75c35606ed737299ecd894af69d4,1,aBabiichuk,2015-10-15 09:53:46+03:00,['8c972fc52f96299f9904cdbe418cf98e4e1d1294'],0,64,64,21061326,44,,,,20713
b23069409876c2c9e63eabd5f1737c6b7c315345,1,aBabiichuk,2015-10-15 10:50:51+03:00,['bb65cc04937d75c35606ed737299ecd894af69d4'],6,8,14,21061340,2,1,1,1,20713
80c1c9c308a7c2d9c45169f146be4a9f9b6a142a,1,Vitaly Brodetskyi,2015-10-15 14:06:48+03:00,['b23069409876c2c9e63eabd5f1737c6b7c315345'],2,48,50,21061390,3,0.518518519,0.962962963,1,20713
6bcdcd9ac9c44c6536355b061024e91eacafa960,0,aBabiichuk,2015-10-15 16:30:17+03:00,['80c1c9c308a7c2d9c45169f146be4a9f9b6a142a'],3,2,5,21061395,1,,,,20713
95d85dbc4a890678a9565b649c037db97076fe67,1,Dmytro Sen,2015-10-15 17:33:02+03:00,['6bcdcd9ac9c44c6536355b061024e91eacafa960'],25,77,102,21061497,3,0.40625,1,1,20713
c877445e4863a14754faea893555f80b6f909491,1,Alex Antonenko,2015-10-15 17:40:24+03:00,['95d85dbc4a890678a9565b649c037db97076fe67'],115,196,311,21061808,20,0.955223881,0.955223881,0.955223881,20713
81280ea39f787ac823f5287e792a655039983576,1,Sumit Mohanty,2015-10-15 08:06:19-07:00,['c877445e4863a14754faea893555f80b6f909491'],173,1096,1269,21063077,27,0.670250896,0.856630824,0.892473118,20722
52083d1ff8425948485149cd1c862ba9ddcb58db,1,Andrew Onishuk,2015-10-15 19:58:27+03:00,['81280ea39f787ac823f5287e792a655039983576'],0,56,56,21063133,6,0.789473684,1,1,20722
22f0982df86002b08ee772bff73d648fbb046c5f,0,Dmytro Sen,2015-10-15 20:28:39+03:00,['52083d1ff8425948485149cd1c862ba9ddcb58db'],0,22,22,21063155,2,0,1,1,20722
868a15d65074b2c4ab8aaf653e7f8779f1124769,0,Robert Levas,2015-10-15 13:42:57-04:00,['22f0982df86002b08ee772bff73d648fbb046c5f'],3,277,280,21063435,3,0.004761905,0.138095238,0.138095238,20722
05ee3061beec38b6a6ae65cc59cf5e43817fe32d,1,Robert Levas,2015-10-15 13:47:33-04:00,['868a15d65074b2c4ab8aaf653e7f8779f1124769'],277,3,280,21063715,3,0.995238095,0.861904762,0.861904762,20722
5c800d27bc81e589a338269c07e6435ec0334dd4,1,Robert Levas,2015-10-15 13:48:29-04:00,['05ee3061beec38b6a6ae65cc59cf5e43817fe32d'],3,277,280,21063995,3,0.004761905,0.138095238,0.138095238,20722
520e41f8c4a51cfc238f9cac7619e78cff191ad0,1,Jayush Luniya,2015-10-15 12:25:47-07:00,['5c800d27bc81e589a338269c07e6435ec0334dd4'],2,355,357,21064352,6,0.084745763,0.807909605,1,20724
716e25803d686a5d466ef8350404c9676509051d,1,Xi Wang,2015-10-15 12:43:25-07:00,['520e41f8c4a51cfc238f9cac7619e78cff191ad0'],20,20,40,21064392,2,,,,20724
fbc65a9c4b6b3f33c93e46d04c451eba07eb157c,0,Oleksandr Diachenko,2015-10-15 14:27:24-07:00,['716e25803d686a5d466ef8350404c9676509051d'],0,2,2,21064394,1,,,,20724
86fb7574aa8bdb02791ef31b45322c92c9e5ac02,1,Robert Levas,2015-10-15 18:01:35-04:00,['fbc65a9c4b6b3f33c93e46d04c451eba07eb157c'],3,45,48,21064442,2,0.217391304,1,1,20724
d834d3a3756d42def793aa487e6abab8c27297c6,1,Jaimin Jetly,2015-10-15 17:23:32-07:00,['86fb7574aa8bdb02791ef31b45322c92c9e5ac02'],80,510,590,21065032,15,0.189655172,0.482758621,0.603448276,20724
082db1cc29c106f1a817683485143b39f39ca8f4,1,Richard Zang,2015-10-15 17:37:26-07:00,['d834d3a3756d42def793aa487e6abab8c27297c6'],3,9,12,21065044,2,1,1,1,20724
a509510ee7fca526178afbed93847112b510b59d,1,Andrew Onishuk,2015-10-16 13:07:42+03:00,['082db1cc29c106f1a817683485143b39f39ca8f4'],26,31,57,21065101,6,0,1,0,20724
4a954283e96a1e598e436b9c264939398793c59d,1,Alex Antonenko,2015-10-16 13:38:21+03:00,['a509510ee7fca526178afbed93847112b510b59d'],1,113,114,21065215,2,0.254545455,1,1,20724
1076ec760bdafae4de876e66e39acad4f26c0b7e,1,Alex Antonenko,2015-10-16 13:38:21+03:00,['4a954283e96a1e598e436b9c264939398793c59d'],16,535,551,21065766,15,0.764084507,1,0.978873239,20728
c402daed925c8b1f6085cca154fa737567b377ba,1,Andrii Tkach,2015-10-16 13:42:09+03:00,['1076ec760bdafae4de876e66e39acad4f26c0b7e'],44,310,354,21066120,2,0.545454545,1,1,20728
2fbbadf85d86004b0df97747cbf3f46e7a904a2e,0,aBabiichuk,2015-10-16 14:36:48+03:00,['c402daed925c8b1f6085cca154fa737567b377ba'],0,3,3,21066123,1,,,,20728
34082a5a7aa90f4c937b46c133629b26aba5e909,1,Oleg Nechiporenko,2015-10-16 15:51:44+03:00,['2fbbadf85d86004b0df97747cbf3f46e7a904a2e'],456,512,968,21067091,36,0.756218905,0.850746269,1,20730
8bb2b14fb3ac7d80031d618767e3b43972ad0f0f,1,Andrew Onishuk,2015-10-16 16:01:05+03:00,['34082a5a7aa90f4c937b46c133629b26aba5e909'],2,1,3,21067094,1,,,,20730
88175691e6d414ccca6d07fb33cf7412419b913d,1,Alex Antonenko,2015-10-16 16:39:57+03:00,['8bb2b14fb3ac7d80031d618767e3b43972ad0f0f'],3,28,31,21067125,2,0,1,0.625,20730
e3958e2da099f783ce637a57d752353fafd3f5b9,1,Andrew Onishuk,2015-10-16 17:25:05+03:00,['88175691e6d414ccca6d07fb33cf7412419b913d'],53,36,89,21067214,10,0,1,1,20730
e89a0036a4155e40ee53c3efa6b77defcbd2aece,1,Andrew Onishuk,2015-10-16 17:59:01+03:00,['e3958e2da099f783ce637a57d752353fafd3f5b9'],3,3,6,21067220,1,,,,20730
2f7184af40599922e1e23b0150cf9c9c9d78cfc3,1,Aleksandr Kovalenko,2015-10-16 18:17:25+03:00,['e89a0036a4155e40ee53c3efa6b77defcbd2aece'],0,6,6,21067226,1,1,1,1,20730
ce356ddc8ca233737e270fec097381192bc4bcb8,0,Jayush Luniya,2015-10-16 08:43:13-07:00,['2f7184af40599922e1e23b0150cf9c9c9d78cfc3'],2,25,27,21067253,1,1,1,0,20730
dec7c8eed63393e8fbc5e3114695eb6b43b6c25e,1,Jayush Luniya,2015-10-16 09:26:20-07:00,['ce356ddc8ca233737e270fec097381192bc4bcb8'],25,2,27,21067280,1,0,0,1,20730
3318eb682611fffbe817815cdffdf6aca2aacfa2,1,Jayush Luniya,2015-10-16 11:30:38-07:00,['dec7c8eed63393e8fbc5e3114695eb6b43b6c25e'],5,44,49,21067329,3,0.35483871,1,0.451612903,20730
1d61e6662942902c721df03b306ef02fd958a1f1,0,Alejandro Fernandez,2015-10-16 11:58:54-07:00,['3318eb682611fffbe817815cdffdf6aca2aacfa2'],1,1,2,21067331,1,,,,20730
4023dcf9ece78995fde9dbb2e70644489aaad01f,0,Aleksandr Kovalenko,2015-10-16 22:19:27+03:00,['1d61e6662942902c721df03b306ef02fd958a1f1'],16,0,16,21067347,1,0,0,0,20730
d8d19268a4c7078216d3a1dd3d589d9ff0cf23bb,1,Jonathan Hurley,2015-10-16 16:07:50-04:00,['4023dcf9ece78995fde9dbb2e70644489aaad01f'],14,24,38,21067385,2,0,1,0,20730
f6ff71b8cb4d9d2b5dc0acd98eb8d27865302cc8,1,Jayush Luniya,2015-10-16 14:53:41-07:00,['d8d19268a4c7078216d3a1dd3d589d9ff0cf23bb'],13,165,178,21067563,3,0.06,0.9,0.9,20730
c9085317bd65c100741a5655c59188df329128cc,0,Richard Zang,2015-10-16 15:22:30-07:00,['f6ff71b8cb4d9d2b5dc0acd98eb8d27865302cc8'],0,8,8,21067571,1,0.428571429,1,0.428571429,20730
4017f064c9bbb3337ae1aa55f0e29e915806d1b0,1,Yusaku Sako,2015-10-16 23:19:35-07:00,['c9085317bd65c100741a5655c59188df329128cc'],69,97,166,21067737,4,1,0,1,20730
4ba6aceb270037a6e1c33db3ed394b13e2add05c,1,Sumit Mohanty,2015-10-18 18:33:18-07:00,['4017f064c9bbb3337ae1aa55f0e29e915806d1b0'],43,221,264,21068001,7,0.244094488,0.669291339,0.866141732,20730
85489482409753a81aa34354f70fda344fd89ca9,1,Gautam Borad,2015-10-19 11:16:19+05:18,['4ba6aceb270037a6e1c33db3ed394b13e2add05c'],19,30,49,21068050,4,0,0.5,0,20730
42742cabad68283e2293866f6163eaf167866268,1,Alex Antonenko,2015-10-19 12:05:52+03:00,['85489482409753a81aa34354f70fda344fd89ca9'],7,15,22,21068072,1,,,,20730
6d4a93159681383613e2fc71958223deacc37471,0,Alex Antonenko,2015-10-19 12:48:43+03:00,['42742cabad68283e2293866f6163eaf167866268'],2,1,3,21068075,1,,,,20730
823c3b988dad59af5d421ae674fee5ec2c939fc8,1,Alex Antonenko,2015-10-19 13:05:26+03:00,['6d4a93159681383613e2fc71958223deacc37471'],1,25,26,21068101,3,1,1,1,20730
0ccc873e884f713025e1f56f21a3d8e5aab4c5af,1,Oleg Nechiporenko,2015-10-19 14:07:29+03:00,['823c3b988dad59af5d421ae674fee5ec2c939fc8'],29,159,188,21068289,4,0.99047619,1,1,20730
87999547f18c560744a2296853e9106ca377ad5a,1,Andrew Onishuk,2015-10-19 14:25:30+03:00,['0ccc873e884f713025e1f56f21a3d8e5aab4c5af'],4,4,8,21068297,1,,,,20730
27acc3af4c0ff4327f65e175939adf7acc5b88e7,0,Dmytro Sen,2015-10-19 15:31:11+03:00,['87999547f18c560744a2296853e9106ca377ad5a'],1,1,2,21068299,1,,,,20730
16b2f928c74204fda45dedca4605568cd3ef0aa7,1,Alex Antonenko,2015-10-19 15:49:02+03:00,['27acc3af4c0ff4327f65e175939adf7acc5b88e7'],72,27,99,21068398,11,0,0,0,20730
7bd1a2a3ba0198111d0447b1ff8ec8cf364e9fef,1,Lisnichenko Dmitro,2015-10-19 16:18:08+03:00,['16b2f928c74204fda45dedca4605568cd3ef0aa7'],4,127,131,21068529,13,0.397058824,0.985294118,0.970588235,20730
d23917f8156c810748450c289c2fc10b43a5294e,1,Srimanth Gunturi,2015-10-19 06:51:35-07:00,['7bd1a2a3ba0198111d0447b1ff8ec8cf364e9fef'],10,578,588,21069117,10,0.280442804,0.365313653,0.852398524,20733
3265d0b8f2c0c30c5c73bbb1851a909796c574d2,0,Nate Cole,2015-10-19 09:53:01-04:00,"['f99d821189c00310435e9ec1847bb86ee73bdb8f', '7bd1a2a3ba0198111d0447b1ff8ec8cf364e9fef']",12178,19919,32097,21101214,571,,,,20733
67da040afbb3af86c3fec72b776f2816b3843697,0,Andrii Tkach,2015-10-19 17:33:27+03:00,['d23917f8156c810748450c289c2fc10b43a5294e'],14,22,36,21101250,4,1,0.444444444,1,20733
fefa1c44d5e8ec7a54ca044f41effb2ec4c5843b,0,Aleksandr Kovalenko,2015-10-19 18:03:59+03:00,['67da040afbb3af86c3fec72b776f2816b3843697'],1,1,2,21101252,1,,,,20733
fe230132f472d64b1cca39d365e958cc37fb150f,1,Dmytro Sen,2015-10-19 19:05:22+03:00,['fefa1c44d5e8ec7a54ca044f41effb2ec4c5843b'],24,72,96,21101348,3,0.682926829,1,1,20733
fa26a59eff334f94bc07861d7295649d5bfaf0c2,0,Alex Antonenko,2015-10-19 19:20:40+03:00,['fe230132f472d64b1cca39d365e958cc37fb150f'],1,2,3,21101351,1,1,1,1,20733
e526efa78572312a99453583e61392acf5b44939,1,Lisnichenko Dmitro,2015-10-20 10:52:12+03:00,['fa26a59eff334f94bc07861d7295649d5bfaf0c2'],3,3,6,21101357,3,,,,20733
3056a7642544ed11b4036b901c5f64fb8743e819,1,Alex Antonenko,2015-10-20 11:04:48+03:00,['e526efa78572312a99453583e61392acf5b44939'],3,230,233,21101590,3,0.233333333,1,1,20733
28c059f08f26225f51e158a7ecab56bf6796ace9,1,Oleg Nechiporenko,2015-10-20 12:41:11+03:00,['3056a7642544ed11b4036b901c5f64fb8743e819'],25,81,106,21101696,1,0.254545455,0.6,0.854545455,20733
c9d75dd5d5e14c5b971c86795d49a8d27bf0a454,1,Dmytro Sen,2015-10-20 13:51:45+03:00,['28c059f08f26225f51e158a7ecab56bf6796ace9'],0,17,17,21101713,4,0,1,1,20733
99de0edb7f33a3e878032a5bb0d95466087ec408,1,Lisnichenko Dmitro,2015-10-20 17:10:31+03:00,['c9d75dd5d5e14c5b971c86795d49a8d27bf0a454'],65,65,130,21101843,1,,,,20733
1cd72bddd362dbc8916759ef4f0e5b7b5531b0bd,1,Andrew Onishuk,2015-10-20 17:19:54+03:00,['99de0edb7f33a3e878032a5bb0d95466087ec408'],0,26,26,21101869,1,1,1,1,20733
f1e9e3460ea4c50154a91c0aaa8c827bc39f3fde,1,Andrew Onishuk,2015-10-20 19:58:53+03:00,['1cd72bddd362dbc8916759ef4f0e5b7b5531b0bd'],13,85,98,21101967,8,0.136363636,0,0.772727273,20733
02814780fa779b08a778754a0aeee1f5b1da3097,0,Aleksandr Kovalenko,2015-10-20 20:06:08+03:00,['f1e9e3460ea4c50154a91c0aaa8c827bc39f3fde'],24,86,110,21102077,4,0.161290323,0.161290323,1,20733
476d2700d88264dbaf29f2608a3c07e3a2c7e768,1,Jonathan Hurley,2015-10-20 16:46:24-04:00,['02814780fa779b08a778754a0aeee1f5b1da3097'],53,248,301,21102378,12,0.075,0.975,0.95,20733
f19a8da034698060f75afabb42ee96f27c7aec05,1,Oleksandr Diachenko,2015-10-20 14:56:53-07:00,['476d2700d88264dbaf29f2608a3c07e3a2c7e768'],0,1634,1634,21104012,21,0.866004963,0.933002481,0.947890819,20753
d5b7d404c251dfe8b33095b5b1b750b862d6839c,1,aBabiichuk,2015-10-21 09:24:06+03:00,['f19a8da034698060f75afabb42ee96f27c7aec05'],696,646,1342,21105354,67,1,1,0,20754
1f2aa2c21e0275f257c1e93b45cfec8182bf6040,1,Oleg Nechiporenko,2015-10-21 11:49:06+03:00,['d5b7d404c251dfe8b33095b5b1b750b862d6839c'],71,144,215,21105569,10,1,1,1,20754
cfb6ccd47eb48f25c236fdab3c201da84aadacf0,1,Lisnichenko Dmitro,2015-10-21 15:13:12+03:00,['1f2aa2c21e0275f257c1e93b45cfec8182bf6040'],27,44,71,21105640,3,0.238095238,1,1,20754
28106d3a60ca67b3f8111fec9c973d0817ebbacf,0,aBabiichuk,2015-10-21 16:19:56+03:00,['cfb6ccd47eb48f25c236fdab3c201da84aadacf0'],1,1,2,21105642,1,,,,20754
b60b3af8bf208b969338c96ff5fd297319f99501,0,aBabiichuk,2015-10-21 16:49:09+03:00,['28106d3a60ca67b3f8111fec9c973d0817ebbacf'],2,0,2,21105644,1,,,,20754
2ff2d2fb3b9f583b35b95aa15bbf18dfa1214c6c,0,Alex Antonenko,2015-10-21 20:02:34+03:00,['b60b3af8bf208b969338c96ff5fd297319f99501'],8,8,16,21105660,5,,,,20754
0a9df8c8b4ac6502c72c2bc25aa6cf87081bb814,0,Alex Antonenko,2015-10-21 20:02:35+03:00,['2ff2d2fb3b9f583b35b95aa15bbf18dfa1214c6c'],1,4,5,21105665,1,,,,20754
66f8ad413aa94a034fc3e5477fd8c37177587d07,1,Alex Antonenko,2015-10-21 20:02:35+03:00,['0a9df8c8b4ac6502c72c2bc25aa6cf87081bb814'],2,4,6,21105671,1,1,1,0,20754
d259917d7cc3a574250ded191097d6cbd6c08900,1,Andrii Tkach,2015-10-21 20:07:15+03:00,['66f8ad413aa94a034fc3e5477fd8c37177587d07'],177,216,393,21106064,43,1,1,1,20754
85bd7cdbc01da56b9d16abd29f18153cefcdead6,1,Lisnichenko Dmitro,2015-10-21 20:12:35+03:00,['d259917d7cc3a574250ded191097d6cbd6c08900'],4,43,47,21106111,4,0.35483871,0.35483871,0.677419355,20754
a5162a71c4a03d3ac803c69e17492132b829fd9c,0,Yusaku Sako,2015-10-21 14:56:38-07:00,['85bd7cdbc01da56b9d16abd29f18153cefcdead6'],2,2,4,21106115,1,,,,20754
844b1e9d3effd2d9d54d8b75532d208e1c629e40,0,Jun Aoki,2015-10-21 15:22:07-07:00,['a5162a71c4a03d3ac803c69e17492132b829fd9c'],4,4,8,21106123,1,,,,20754
383aac0f581e833614b4307635d263e90ad90171,0,Yusaku Sako,2015-10-21 15:23:29-07:00,['844b1e9d3effd2d9d54d8b75532d208e1c629e40'],3,35,38,21106161,2,1,1,1,20754
8ef5beb857cc4c1fa077bdf2e0dbb1bc55ebb2f5,0,Yusaku Sako,2015-10-21 15:25:07-07:00,['383aac0f581e833614b4307635d263e90ad90171'],0,6,6,21106167,1,,,,20754
ac51d8b6cee62aee30b940d38da10f0f266ba7a5,1,Richard Zang,2015-10-21 15:31:21-07:00,['8ef5beb857cc4c1fa077bdf2e0dbb1bc55ebb2f5'],21,119,140,21106307,6,0.711864407,1,1,20755
34a03533b1bf844a9f7b3f56919de1db3d24754c,1,Jaimin Jetly,2015-10-21 19:10:57-07:00,['ac51d8b6cee62aee30b940d38da10f0f266ba7a5'],21,109,130,21106437,7,0.131147541,0.721311475,1,20755
7afe5a4ec9200c41922fb1c0809f34a0d8d700bd,1,Alejandro Fernandez,2015-10-21 19:22:52-07:00,['34a03533b1bf844a9f7b3f56919de1db3d24754c'],304,894,1198,21107635,56,0.5,0.5,0.326666667,20755
5eff7979a37af5e7339b6b65fa99dee612db6c38,1,Dmytro Sen,2015-10-22 11:10:26+03:00,['7afe5a4ec9200c41922fb1c0809f34a0d8d700bd'],0,167,167,21107802,4,0,0.772727273,0.772727273,20755
e652b358748f8785622f5e6f50002f620a907678,1,Lisnichenko Dmitro,2015-10-22 11:35:26+03:00,['5eff7979a37af5e7339b6b65fa99dee612db6c38'],1,1289,1290,21109092,4,,,,20757
96fecce1a350b1ba71c07438782883a3d17f509c,0,Oleg Nechiporenko,2015-10-22 13:18:36+03:00,['e652b358748f8785622f5e6f50002f620a907678'],1,1,2,21109094,1,,,,20757
1f702fbf922a64b81efc2c70496afa8dba8ae3ab,0,Aleksandr Kovalenko,2015-10-22 15:21:21+03:00,['96fecce1a350b1ba71c07438782883a3d17f509c'],0,1,1,21109095,1,,,,20757
565dc0de86fc8954cc3331941f3b86aaa52d4d42,1,Andrew Onishuk,2015-10-22 15:57:00+03:00,['1f702fbf922a64b81efc2c70496afa8dba8ae3ab'],8,118,126,21109221,14,0,0,1,20757
39c04ac9b44f4eb1035b378337d745d77ee83d53,1,Andrew Onishuk,2015-10-22 16:08:48+03:00,['565dc0de86fc8954cc3331941f3b86aaa52d4d42'],95,205,300,21109521,12,0.771428571,0.928571429,0.957142857,20757
306e44a48ebffae9df20d5f6cae561c8c50173b2,0,Alex Antonenko,2015-10-22 16:22:59+03:00,['39c04ac9b44f4eb1035b378337d745d77ee83d53'],1,1,2,21109523,1,,,,20757
381c49f459815117e22d5d45ccf6b408d5760aa2,1,Alex Antonenko,2015-10-22 16:24:01+03:00,['306e44a48ebffae9df20d5f6cae561c8c50173b2'],24,70,94,21109617,2,0,1,0.833333333,20757
b9bb0d3518c592b07e4b23db53905c1de20c8529,0,Dmytro Sen,2015-10-22 17:09:48+03:00,['381c49f459815117e22d5d45ccf6b408d5760aa2'],7,403,410,21110027,4,0.203539823,0.731563422,0.764011799,20757
a8445c9aa699622be486695fcfc6a1c9cf10a518,1,Dmytro Sen,2015-10-22 17:18:18+03:00,['b9bb0d3518c592b07e4b23db53905c1de20c8529'],27,89,116,21110143,2,0,0.5,0.5,20757
3383f0245079865c353d5457a3ec6967fbdf1eac,1,aBabiichuk,2015-10-22 18:05:15+03:00,['a8445c9aa699622be486695fcfc6a1c9cf10a518'],2,9,11,21110154,2,1,1,1,20757
2ff92a914cd14441fd33ec0b5ef1535c8fa315c6,0,Aleksandr Kovalenko,2015-10-22 18:21:53+03:00,['3383f0245079865c353d5457a3ec6967fbdf1eac'],1,3,4,21110158,1,,,,20757
1ff22dffec728f5df40f41aaf1fa7a5da3f98f35,1,Lisnichenko Dmitro,2015-10-22 19:47:32+03:00,['2ff92a914cd14441fd33ec0b5ef1535c8fa315c6'],7,419,426,21110584,9,0.183391003,0.788927336,0.871972318,20758
c4c833842978d321c0d08c319b2f308d5861e323,1,Sumit Mohanty,2015-10-22 10:17:07-07:00,['1ff22dffec728f5df40f41aaf1fa7a5da3f98f35'],36,218,254,21110838,22,0.06,0.54,0.59,20758
bb7ca76db357b5c9781818278e008611f9369044,1,Dmytro Sen,2015-10-22 20:51:46+03:00,['c4c833842978d321c0d08c319b2f308d5861e323'],3,54,57,21110895,3,0.394736842,0.842105263,0.973684211,20758
3b9b7c7e7a09fd3e635d525a6df02386d6622461,1,Jun Aoki,2015-10-22 11:16:12-07:00,['bb7ca76db357b5c9781818278e008611f9369044'],49,340,389,21111284,10,0.238095238,1,1,20760
0294343025e5a9bd19a69c1ca3d4c69c1ecbaa62,1,Siddharth Wagle,2015-10-22 13:38:20-07:00,['3b9b7c7e7a09fd3e635d525a6df02386d6622461'],44,300,344,21111628,16,0.306451613,0.798387097,0.879032258,20762
063e79f686f849ca6c93f7a0c63ebfb02e6b005f,1,Jun Aoki,2015-10-22 16:31:08-07:00,['0294343025e5a9bd19a69c1ca3d4c69c1ecbaa62'],1,1,2,21111630,1,,,,20762
b2f306d95e41cc132a3d92a650d0faa03c44c844,1,Siddharth Wagle,2015-10-22 17:03:47-07:00,['063e79f686f849ca6c93f7a0c63ebfb02e6b005f'],6,3945,3951,21115581,28,0.412462908,0.599406528,0.735905045,20785
3864bc161ecde5845e6cf105412189a7b1ba3574,1,Jaimin Jetly,2015-10-22 17:30:52-07:00,['b2f306d95e41cc132a3d92a650d0faa03c44c844'],466,659,1125,21116706,17,0,0.547550432,0.602305476,20785
6cd152c4d834ee9d7782e85e9fe7ad2c4060135d,1,Xi Wang,2015-10-22 17:40:29-07:00,['3864bc161ecde5845e6cf105412189a7b1ba3574'],13,9,22,21116728,4,0,0,0,20785
049934f9c485ad53905e079f474539a83288c944,0,Siddharth Wagle,2015-10-22 18:31:11-07:00,['6cd152c4d834ee9d7782e85e9fe7ad2c4060135d'],1,1,2,21116730,1,,,,20785
b4468ce44b28bc72a64681e6dc7617b4a2812792,1,Jayush Luniya,2015-10-22 19:31:32-07:00,['049934f9c485ad53905e079f474539a83288c944'],27,40,67,21116797,7,0,0,0.307692308,20785
4b66a8243eb23531188127349ec50163dd88c9b7,1,Oleg Nechiporenko,2015-10-23 11:27:37+03:00,['b4468ce44b28bc72a64681e6dc7617b4a2812792'],70,221,291,21117088,11,1,1,1,20785
4e2f5f8607c8b52a87475aed15aededca53802fe,1,Oleg Nechiporenko,2015-10-23 12:24:00+03:00,['4b66a8243eb23531188127349ec50163dd88c9b7'],24,32,56,21117144,3,,,,20785
e7f77b6b25fb3b29ca7fff40994e5f7a79c0025d,1,Andrii Tkach,2015-10-23 12:48:31+03:00,['4e2f5f8607c8b52a87475aed15aededca53802fe'],4,9,13,21117157,2,0,1,1,20785
d30b5f0369672bd62a246f37d07bfddc50df8c7a,1,Dmytro Sen,2015-10-23 12:59:58+03:00,['e7f77b6b25fb3b29ca7fff40994e5f7a79c0025d'],63,647,710,21117867,2,0.009118541,0.303951368,1,20785
a61a83fae8170ebf3be7d4bc58b91b75dc7e0b32,1,aBabiichuk,2015-10-23 14:19:43+03:00,['d30b5f0369672bd62a246f37d07bfddc50df8c7a'],2,2,4,21117871,1,,,,20785
502dc1862d974eb4c072864db0981a11bdfe4f66,1,Jonathan Hurley,2015-10-23 08:04:09-04:00,['a61a83fae8170ebf3be7d4bc58b91b75dc7e0b32'],37,221,258,21118129,4,0.244186047,0.558139535,0.581395349,20785
b27212da487b3853388ff656793bc38c5b0b79d7,1,Alex Antonenko,2015-10-23 16:13:51+03:00,['502dc1862d974eb4c072864db0981a11bdfe4f66'],41,44,85,21118214,8,0.15,1,1,20785
6a10db2b6c81e7baf4b0cfc0acd6f69a5ef94dc2,1,Alex Antonenko,2015-10-23 16:13:51+03:00,['b27212da487b3853388ff656793bc38c5b0b79d7'],45,808,853,21119067,14,0.308411215,1,1,20791
2ac17444bcc4f542507188250ebd835ae067e87e,1,Andrii Tkach,2015-10-23 16:34:12+03:00,['6a10db2b6c81e7baf4b0cfc0acd6f69a5ef94dc2'],1,8,9,21119076,3,0,0,1,20791
b25c8a8480044b125f077df6c308059b42270fb3,0,Nate Cole,2015-10-23 10:46:42-04:00,"['3265d0b8f2c0c30c5c73bbb1851a909796c574d2', '2ac17444bcc4f542507188250ebd835ae067e87e']",2619,15695,18314,21137390,432,,,,20791
bf0e3db8ea16de66b447822fd86ad4ff0a12ca79,1,Sumit Mohanty,2015-10-23 09:05:30-07:00,['2ac17444bcc4f542507188250ebd835ae067e87e'],1,227,228,21137618,9,0,1,1,20793
2116e000abe9419e5c603a21334db02791b9bdc2,0,Jayush Luniya,2015-10-23 09:12:36-07:00,['bf0e3db8ea16de66b447822fd86ad4ff0a12ca79'],12,0,12,21137630,2,1,1,0,20793
6d5df47daa1929c0a06840e75b3dc97e17bca4ba,1,Jayush Luniya,2015-10-23 09:29:17-07:00,['2116e000abe9419e5c603a21334db02791b9bdc2'],6,297,303,21137933,8,0.451612903,0.462365591,1,20795
0c1d4b928e62bcceddc5b787314246ca3e4c981a,1,Dmytro Sen,2015-10-23 20:35:54+03:00,['6d5df47daa1929c0a06840e75b3dc97e17bca4ba'],102,232,334,21138267,24,0.214285714,0.214285714,0.976190476,20795
e4404a19a77b42ce8df37a267147339b9a8fe25a,1,Aleksandr Kovalenko,2015-10-23 21:08:54+03:00,['0c1d4b928e62bcceddc5b787314246ca3e4c981a'],14,17,31,21138298,2,0,0,0,20795
9243033cc516ecadc197b0386bc0e3136df4894a,0,Srimanth Gunturi,2015-10-23 11:51:29-07:00,['e4404a19a77b42ce8df37a267147339b9a8fe25a'],1,1,2,21138300,1,,,,20795
78f2a05f70974f6432fcdb557a6a688bbb40c721,1,Nate Cole,2015-10-23 15:50:09-04:00,['9243033cc516ecadc197b0386bc0e3136df4894a'],3,5,8,21138308,2,0,0.333333333,1,20795
2c5694b8017dfe3b065565166862c7aab0b97c09,1,Siddharth Wagle,2015-10-23 14:12:03-07:00,['78f2a05f70974f6432fcdb557a6a688bbb40c721'],156,319,475,21138783,18,0.198113208,1,0.952830189,20795
7a54da06dc36140643afad9eca56a45c9d7294f2,1,Alejandro Fernandez,2015-10-23 14:21:26-07:00,['2c5694b8017dfe3b065565166862c7aab0b97c09'],39,43,82,21138865,7,1,1,1,20795
0e321a489f6ca06199181f87cab67cc2c7f89a3b,1,Siddharth Wagle,2015-10-23 15:52:34-07:00,['7a54da06dc36140643afad9eca56a45c9d7294f2'],1,2,3,21138868,1,0,1,1,20795
42bd7e4688b8a9417a047121e742ff7feee13a80,1,Xi Wang,2015-10-23 17:28:50-07:00,['0e321a489f6ca06199181f87cab67cc2c7f89a3b'],33,85,118,21138986,9,1,0,1,20795
0a1bb1136f1dcfb5ff948e90663036f651a71d86,0,Richard Zang,2015-10-24 14:55:22-07:00,['42bd7e4688b8a9417a047121e742ff7feee13a80'],2,2,4,21138990,1,1,1,0,20795
16a457543208fd54329de9f4f42f445965f787a0,1,Alejandro Fernandez,2015-10-24 23:05:25-07:00,['0a1bb1136f1dcfb5ff948e90663036f651a71d86'],4,10,14,21139004,1,0,0,1,20795
a9546afcab20f8419c0fb26e2ae8ad43b3bcb3a6,0,Gautam Borad,2015-10-26 14:36:26+05:18,['16a457543208fd54329de9f4f42f445965f787a0'],1,14,15,21139019,2,0.8,0.8,1,20795
0e8dddabdee9a87d421c6ab6c4adcf6b6c3747b3,1,Lisnichenko Dmitro,2015-10-26 13:29:49+02:00,['a9546afcab20f8419c0fb26e2ae8ad43b3bcb3a6'],0,13,13,21139032,3,0,0.4,0.4,20795
402d97912d2aff501eb6ae1ecedd780c342284fe,1,Oleg Nechiporenko,2015-10-26 14:32:33+02:00,['0e8dddabdee9a87d421c6ab6c4adcf6b6c3747b3'],13,62,75,21139107,5,1,1,1,20795
ab031a3c8a116d041f96582e5c125d8fca53b795,0,Nate Cole,2015-10-26 10:18:39-04:00,"['b25c8a8480044b125f077df6c308059b42270fb3', '402d97912d2aff501eb6ae1ecedd780c342284fe']",388,1329,1717,21140824,94,,,,20795
395ff09412737ab8a2ff1d4fd0051f65e482a62e,1,Andrew Onishuk,2015-10-26 17:44:33+02:00,['402d97912d2aff501eb6ae1ecedd780c342284fe'],20,49,69,21140893,3,0,1,0,20795
88bb0a73d3e782b0ccd1fe2d09885bcc383e39f8,1,Dmytro Sen,2015-10-26 18:27:51+02:00,['395ff09412737ab8a2ff1d4fd0051f65e482a62e'],3,81,84,21140977,3,0.194029851,1,0.76119403,20795
b030c4f237dd493f1fd28f7f15079a88f94fd6f3,0,Andrew Onishuk,2015-10-26 19:19:20+02:00,['88bb0a73d3e782b0ccd1fe2d09885bcc383e39f8'],2,0,2,21140979,2,,,,20795
8cdb2a8e94dd1852dace111b76fb4037195ee6c7,1,Andrew Onishuk,2015-10-26 19:28:13+02:00,['b030c4f237dd493f1fd28f7f15079a88f94fd6f3'],7,3,10,21140989,1,1,1,1,20795
f4448448bf3c63f180006a8c1aa579efc8c11b57,1,Andrew Onishuk,2015-10-26 19:30:12+02:00,['8cdb2a8e94dd1852dace111b76fb4037195ee6c7'],33,24,57,21141046,5,0.357142857,0,0,20795
66b1c27176fde8b66711403aa9d2caef03c79b59,1,Andrii Tkach,2015-10-26 19:32:48+02:00,['f4448448bf3c63f180006a8c1aa579efc8c11b57'],5,31,36,21141082,3,0,1,1,20795
6d662b17a7e88799e01c4b8d8cd27732a11758bd,1,Lisnichenko Dmitro,2015-10-26 20:16:48+02:00,['66b1c27176fde8b66711403aa9d2caef03c79b59'],13,52,65,21141147,2,0.08,0.92,0.08,20795
f8a9f63cc27ac593b953323b16697bf4da292995,1,Siddharth Wagle,2015-10-26 11:33:27-07:00,['6d662b17a7e88799e01c4b8d8cd27732a11758bd'],6,16,22,21141169,3,0.5,0.5,1,20795
7a0aa253d934e1b5a4997da9626ed9c8766a6a3e,1,Alejandro Fernandez,2015-10-26 13:54:34-07:00,['f8a9f63cc27ac593b953323b16697bf4da292995'],4,14,18,21141187,5,,,,20795
46a20019de96f02437720f93f1d442fc33898585,1,Jun Aoki,2015-10-26 13:56:44-07:00,['7a0aa253d934e1b5a4997da9626ed9c8766a6a3e'],0,20485,20485,21161672,12,0.323863636,0.107954545,0.761363636,20805
859790f42f6bed1eff37365effffb5843189f38a,1,Jaimin Jetly,2015-10-26 17:48:54-07:00,['46a20019de96f02437720f93f1d442fc33898585'],182,906,1088,21162760,16,0,0.633333333,0.633333333,20805
5857a3ee4fd4e63ded503e5173d08896e9860d27,0,Jaimin Jetly,2015-10-26 19:27:00-07:00,['859790f42f6bed1eff37365effffb5843189f38a'],44,98,142,21162902,11,0,0.576923077,0.576923077,20805
f9e73665b48c44cb6e8118bb613d81584fddc497,1,Gautam Borad,2015-10-27 11:07:48+05:18,['5857a3ee4fd4e63ded503e5173d08896e9860d27'],11,57,68,21162970,3,0,0,1,20805
2aef6ff29882ad9349c8874945aab40a51c6d1e2,1,Lisnichenko Dmitro,2015-10-27 10:17:05+02:00,['f9e73665b48c44cb6e8118bb613d81584fddc497'],31,57,88,21163058,8,0,0,0,20805
53346888904e4af4ac7aedb5d5bf7a30edab4c0b,1,Vitaly Brodetskyi,2015-10-27 13:28:17+02:00,['2aef6ff29882ad9349c8874945aab40a51c6d1e2'],18,705,723,21163781,6,0.17357513,0.279792746,0.92746114,20807
10653cf4678fe436214c10211ecf556e211a3263,1,Andrii Tkach,2015-10-27 13:47:06+02:00,['53346888904e4af4ac7aedb5d5bf7a30edab4c0b'],40,79,119,21163900,2,1,1,1,20807
bd7d61d5b1774d57101c00763c5527f261827445,1,Oleg Nechiporenko,2015-10-27 14:37:46+02:00,['10653cf4678fe436214c10211ecf556e211a3263'],25,26,51,21163951,1,0,0,1,20807
17d6d8a59001e865ea31a2a06cfb93295f772963,0,Alex Antonenko,2015-10-27 14:43:44+02:00,['bd7d61d5b1774d57101c00763c5527f261827445'],1,13,14,21163965,1,1,1,1,20807
c1312ee78d2e4a93502d87b2e259d4af70888169,1,Alex Antonenko,2015-10-27 14:43:44+02:00,['17d6d8a59001e865ea31a2a06cfb93295f772963'],3,82,85,21164050,3,0.553191489,1,1,20807
8c7b9f8fdb2bdb9f880c19be120d1e7e7db9ed3b,1,Aleksandr Kovalenko,2015-10-27 15:52:59+02:00,['c1312ee78d2e4a93502d87b2e259d4af70888169'],3,2,5,21164055,3,0,0,0,20807
c55233a83cf51fb880fc5c63a844deed68ce2589,1,Jayush Luniya,2015-10-27 08:35:36-07:00,['8c7b9f8fdb2bdb9f880c19be120d1e7e7db9ed3b'],33,46,79,21164134,3,,,,20807
4a1ff5cb12ab9cad24cb69390b9ca5762d16ff61,1,Jonathan Hurley,2015-10-27 12:03:10-04:00,['c55233a83cf51fb880fc5c63a844deed68ce2589'],2,37,39,21164173,2,0.411764706,0.411764706,1,20807
200dae12b097a47511f5c930ed4c01c0c32f540f,1,Lisnichenko Dmitro,2015-10-27 18:53:35+02:00,['4a1ff5cb12ab9cad24cb69390b9ca5762d16ff61'],13,121,134,21164307,4,0.283018868,1,1,20808
2a382efa73af178e5377e6f99a6a60bd64b9dd36,1,Jayush Luniya,2015-10-27 10:39:51-07:00,['200dae12b097a47511f5c930ed4c01c0c32f540f'],1,2,3,21164310,1,,,,20808
92cde3d222bb9f807e7eaa38e74f7eeadad53f8e,1,Alejandro Fernandez,2015-10-27 11:53:06-07:00,['2a382efa73af178e5377e6f99a6a60bd64b9dd36'],80,242,322,21164632,3,0.152380952,0.704761905,1,20809
d3eb8a8ee621221edc10ffae685f664c9b97be08,1,Xi Wang,2015-10-27 11:56:17-07:00,['92cde3d222bb9f807e7eaa38e74f7eeadad53f8e'],6,10,16,21164648,3,0,,,20809
85689e3a5ca9b666753497aaf0760967f1761f82,1,Xi Wang,2015-10-27 11:56:17-07:00,['d3eb8a8ee621221edc10ffae685f664c9b97be08'],5,16,21,21164669,5,0.5,1,1,20809
0934a5c95f80d787d59421c5a6ce48409d8979dd,1,Srimanth Gunturi,2015-10-27 14:04:30-07:00,['85689e3a5ca9b666753497aaf0760967f1761f82'],5,95,100,21164769,5,0.238095238,1,1,20811
f342ea96015d717e6cda1d21134ce4f0e38d38fa,0,Siddharth Wagle,2015-10-27 14:07:57-07:00,['0934a5c95f80d787d59421c5a6ce48409d8979dd'],1,2,3,21164772,1,,,,20811
376f80fc20defbce8b369490a40f7f65fd2253da,1,Xi Wang,2015-10-27 15:29:33-07:00,['f342ea96015d717e6cda1d21134ce4f0e38d38fa'],2,6,8,21164780,2,1,1,1,20811
9e085dfd04ecb1ff01f6d1b10b9ec646f1cc6c4f,0,Jaimin Jetly,2015-10-27 18:16:22-07:00,['376f80fc20defbce8b369490a40f7f65fd2253da'],0,1,1,21164781,1,,,,20811
deb782c796cf4ee792f1f1d98769583698b89f60,1,Jonathan Hurley,2015-10-28 00:56:28-04:00,['9e085dfd04ecb1ff01f6d1b10b9ec646f1cc6c4f'],62,115,177,21164958,19,0.789473684,1,0,20811
e4c62592f7025bd5c8e67dd1bdfafee895afe7a6,1,Gautam Borad,2015-10-28 13:32:28+05:18,['deb782c796cf4ee792f1f1d98769583698b89f60'],4,59,63,21165021,4,0,0.128205128,0.128205128,20811
cfd548cff0f874809e25cc1ae2211a3beb631ffe,0,Oleg Nechiporenko,2015-10-28 11:43:56+02:00,['e4c62592f7025bd5c8e67dd1bdfafee895afe7a6'],9,16,25,21165046,1,0,0,1,20811
fd2ac2a7b8e0d8925109eb4a4c9ae832d6a47937,1,Andrew Onishuk,2015-10-28 14:52:49+02:00,['cfd548cff0f874809e25cc1ae2211a3beb631ffe'],10,10,20,21165066,2,,,,20811
7402d19e993c845e45af30a7c44fc05f6e742b32,1,Oleg Nechiporenko,2015-10-28 15:33:37+02:00,['fd2ac2a7b8e0d8925109eb4a4c9ae832d6a47937'],872,915,1787,21166853,8,0,0,0,20813
6254019a9a8c7f62f297d32d4e00cd64d72db3b8,1,Jonathan Hurley,2015-10-28 10:11:16-04:00,['7402d19e993c845e45af30a7c44fc05f6e742b32'],48,785,833,21167686,10,0.740601504,0.887218045,0.909774436,20815
72630f2ed76b5be88cbcc98c4da0be780df85105,1,Robert Levas,2015-10-28 10:36:20-04:00,['6254019a9a8c7f62f297d32d4e00cd64d72db3b8'],91,236,327,21168013,8,0.144444444,0,0.788888889,20815
c52c40fa1f79e2cf3e9398286d6582368cf63d1a,1,aBabiichuk,2015-10-28 17:02:20+02:00,['72630f2ed76b5be88cbcc98c4da0be780df85105'],16,27,43,21168056,2,1,1,1,20815
81c608f4896828411871f7874168bff2e8bdb84b,1,Nate Cole,2015-10-28 11:10:08-04:00,['c52c40fa1f79e2cf3e9398286d6582368cf63d1a'],66,433,499,21168555,9,0.131455399,0.9342723,0.727699531,20815
640d1523256e923517184e6a22394df7c9530ff8,1,Robert Levas,2015-10-28 12:46:55-04:00,['81c608f4896828411871f7874168bff2e8bdb84b'],15,171,186,21168741,3,0,0.5,0.913043478,20815
f30f9b58148604f5dac7bdae4ad094bda6a0465d,1,Andrew Onishuk,2015-10-28 19:21:59+02:00,['640d1523256e923517184e6a22394df7c9530ff8'],0,225,225,21168966,2,,,,20817
5ad53b6c91b707069fa89ec9159edaa024032536,0,Andrew Onishuk,2015-10-28 19:22:44+02:00,['f30f9b58148604f5dac7bdae4ad094bda6a0465d'],2,4,6,21168972,1,,,,20817
48539f0df4a3e2f1d7db2405f774519ceeabfd9f,1,Srimanth Gunturi,2015-10-28 10:32:46-07:00,['5ad53b6c91b707069fa89ec9159edaa024032536'],0,1,1,21168973,1,1,1,0,20817
4c0cb055903295c095b3561fc39cfba39b70a0d4,1,Alex Antonenko,2015-10-28 19:46:23+02:00,['48539f0df4a3e2f1d7db2405f774519ceeabfd9f'],1722,573,2295,21171268,51,0.787305122,0.506681514,0.013363029,20817
9873736281e3adf123dd96ac3520245c7ed44d1d,1,Xi Wang,2015-10-28 10:56:30-07:00,['4c0cb055903295c095b3561fc39cfba39b70a0d4'],1,62,63,21171331,4,1,1,1,20818
11db1a4258b78f22e5bd3892239246a9989ef4f6,1,Yusaku Sako,2015-10-28 11:42:54-07:00,['9873736281e3adf123dd96ac3520245c7ed44d1d'],82,291,373,21171704,13,0.102941176,0.647058824,1,20818
bb5b77c5fffa9f8ac5d49bf2768fcfc6a88ff1da,1,Jayush Luniya,2015-10-28 12:39:22-07:00,['11db1a4258b78f22e5bd3892239246a9989ef4f6'],275,287,562,21172266,28,0.454545455,0,0,20819
b72032b5ce26df917d9d86583cce49f1250e5d36,1,Yusaku Sako,2015-10-28 12:44:55-07:00,['bb5b77c5fffa9f8ac5d49bf2768fcfc6a88ff1da'],3,3,6,21172272,1,,,,20819
25ca5ceecc1d5eea5f4cb1cc28dffd7cf6af8924,1,Yusaku Sako,2015-10-28 13:09:19-07:00,['b72032b5ce26df917d9d86583cce49f1250e5d36'],291,82,373,21172645,13,0.897058824,0.352941176,0,20819
f2ce9db943d3eedbf7c47331c21e7e2a131415b5,0,Jayush Luniya,2015-10-28 13:42:00-07:00,['25ca5ceecc1d5eea5f4cb1cc28dffd7cf6af8924'],1,1,2,21172647,1,,,,20819
2337e5390cac806f80db0e1880b8616cfab7e80d,1,Bob Nettleton,2015-10-28 17:58:21-04:00,['f2ce9db943d3eedbf7c47331c21e7e2a131415b5'],481,1531,2012,21174659,45,0.355140187,0.727102804,0.859813084,20823
897703b72f9a5274f01d277f894d30b3af87faac,1,Jun Aoki,2015-10-28 15:10:46-07:00,['2337e5390cac806f80db0e1880b8616cfab7e80d'],6,21,27,21174686,2,,,,20823
b9d68d2a14a2a94b9481c3e95ce3084452479dbe,1,Alejandro Fernandez,2015-10-28 15:23:10-07:00,['897703b72f9a5274f01d277f894d30b3af87faac'],72,1240,1312,21175998,10,0,0.285714286,0,20823
50d36f9a58663548a730e327341031cccfffa176,1,Alejandro Fernandez,2015-10-28 15:34:47-07:00,['b9d68d2a14a2a94b9481c3e95ce3084452479dbe'],8,8,16,21176014,2,,,,20823
b591250fba9c95fdf6423232337441308681a36b,1,Yusaku Sako,2015-10-29 01:07:22-07:00,['50d36f9a58663548a730e327341031cccfffa176'],5,5,10,21176024,2,,,,20823
60925f39b8ab6838db8f3636645e9591b00e1f1b,1,Andrew Onishuk,2015-10-29 11:27:33+02:00,['b591250fba9c95fdf6423232337441308681a36b'],5,14,19,21176043,2,0,1,1,20823
d18c4e272f5e45b8017cd8e6a1802963f93c875a,0,aBabiichuk,2015-10-29 11:40:56+02:00,['60925f39b8ab6838db8f3636645e9591b00e1f1b'],1,1,2,21176045,1,,,,20823
cf9eb74b63f270213724dbae3bf6ee6d00930736,1,aBabiichuk,2015-10-29 11:40:57+02:00,['d18c4e272f5e45b8017cd8e6a1802963f93c875a'],9,11,20,21176065,1,,,,20823
e593c5ae3c8861978fe373c61155955d0409164e,1,aBabiichuk,2015-10-29 11:40:58+02:00,['cf9eb74b63f270213724dbae3bf6ee6d00930736'],11,27,38,21176103,4,1,0,0,20823
db399a13f306e91a4456fb4cd3a597411edb7cc5,1,Oleg Nechiporenko,2015-10-29 12:40:24+02:00,['e593c5ae3c8861978fe373c61155955d0409164e'],308,358,666,21176769,3,0,0.785714286,1,20823
0388379b7d1032ee2314d6bce31b6de2d791b44a,1,Andrew Onishuk,2015-10-29 13:45:56+02:00,['db399a13f306e91a4456fb4cd3a597411edb7cc5'],34,41,75,21176844,8,,,,20823
8f3f3569dc376755dd9b469eaf1f26d6c8bb1200,0,Andrew Onishuk,2015-10-29 13:49:52+02:00,['0388379b7d1032ee2314d6bce31b6de2d791b44a'],5,9,14,21176858,1,,,,20823
67a7848be560110fa3a4fd65fbb7bb1e251eb99d,1,Vitaly Brodetskyi,2015-10-29 13:56:03+02:00,['8f3f3569dc376755dd9b469eaf1f26d6c8bb1200'],45,590,635,21177493,4,0.051428571,1,0.931428571,20824
4dac97f7241c5bc26133414012dae04bf891f527,1,Jonathan Hurley,2015-10-29 10:02:38-04:00,['67a7848be560110fa3a4fd65fbb7bb1e251eb99d'],187,142,329,21177822,18,1,0.073684211,0,20824
ca7732a9f3f3e6a3716ccf014127ae2b65029ada,1,Alex Antonenko,2015-10-29 16:39:50+02:00,['4dac97f7241c5bc26133414012dae04bf891f527'],3,3,6,21177828,2,,,,20824
59ff41558d7f459e1433fc3288875179dc031d3c,1,Jayush Luniya,2015-10-29 08:02:31-07:00,['ca7732a9f3f3e6a3716ccf014127ae2b65029ada'],1,1,2,21177830,1,,,,20824
37a3f4458843dc05efa78868865e14a91f97dc3b,1,Dmytro Sen,2015-10-29 19:07:38+02:00,['59ff41558d7f459e1433fc3288875179dc031d3c'],0,115,115,21177945,2,0.010416667,0.604166667,1,20824
c1985dac9fca0dbe4f05155b9628f735eba8bd0f,1,Dmytro Sen,2015-10-29 19:29:28+02:00,['37a3f4458843dc05efa78868865e14a91f97dc3b'],13,82,95,21178040,2,0.322033898,1,1,20824
026816d41675974a4d164f8e0c344270327b139f,0,Robert Levas,2015-10-29 13:33:16-04:00,['c1985dac9fca0dbe4f05155b9628f735eba8bd0f'],5,3,8,21178048,1,1,0,0,20824
0e2d221675ff6a7a0670eda4051bd3a660bfb9dc,1,Yusaku Sako,2015-10-29 10:47:03-07:00,['026816d41675974a4d164f8e0c344270327b139f'],1,50,51,21178099,4,0.804878049,0.097560976,0.829268293,20824
91323146825c1da65afa2d4bd63514c42b8921db,0,Alejandro Fernandez,2015-10-29 11:17:54-07:00,['0e2d221675ff6a7a0670eda4051bd3a660bfb9dc'],19,21,40,21178139,6,1,0,0,20824
9b7c8ffdb83395d8fa3dcba76162fe866ebc677b,0,Alejandro Fernandez,2015-10-29 11:20:22-07:00,['91323146825c1da65afa2d4bd63514c42b8921db'],2,2,4,21178143,1,0,1,0,20824
397b66f8e8dbf2339447c5a9da7a306bfb217b10,0,Alejandro Fernandez,2015-10-29 11:21:22-07:00,['9b7c8ffdb83395d8fa3dcba76162fe866ebc677b'],3,5,8,21178151,2,1,1,0,20824
5cd0d3b1a469ce6c329a21c7a61d453f3d395656,0,Yusaku Sako,2015-10-29 11:31:38-07:00,['397b66f8e8dbf2339447c5a9da7a306bfb217b10'],0,1,1,21178152,1,,,,20824
369e8135dc32d28bf02ea20a1925818dbc70a4db,0,Yusaku Sako,2015-10-29 12:06:26-07:00,['5cd0d3b1a469ce6c329a21c7a61d453f3d395656'],25,1,26,21178178,2,0,0,0,20824
8c33381ad7e7322b3ebe9d67e57cc313d3d66116,1,Jonathan Hurley,2015-10-29 15:32:27-04:00,['369e8135dc32d28bf02ea20a1925818dbc70a4db'],26,56,82,21178260,6,,,0,20824
8a0fddcd9e0a4e80e7425d23cfc3587481e322c6,1,Lisnichenko Dmitro,2015-10-29 21:42:39+02:00,['8c33381ad7e7322b3ebe9d67e57cc313d3d66116'],3,11,14,21178274,1,0,0,0,20824
4690c8f0cbe30f672309234f9c85aec1255544c3,1,Nate Cole,2015-10-29 15:58:28-04:00,['8a0fddcd9e0a4e80e7425d23cfc3587481e322c6'],5,326,331,21178605,3,0,0.947368421,1,20825
ea98fd691f0ffc0b5734027df22d278840cad911,1,Xi Wang,2015-10-29 14:33:40-07:00,['4690c8f0cbe30f672309234f9c85aec1255544c3'],0,3,3,21178608,1,,,,20825
de05399dfbf93c9cdd3e9fbcbbd826678895db89,1,Jayush Luniya,2015-10-29 15:22:17-07:00,['ea98fd691f0ffc0b5734027df22d278840cad911'],2,197,199,21178807,3,0,1,1,20827
c972889b4ba98f148a3eec5608aa13d0f12619ea,0,Jayush Luniya,2015-10-29 15:38:08-07:00,['de05399dfbf93c9cdd3e9fbcbbd826678895db89'],6,0,6,21178813,1,,,,20827
c8e138d98fcfbd25a7d8c46726c956fa50f30fac,1,Robert Levas,2015-10-29 19:53:59-04:00,['c972889b4ba98f148a3eec5608aa13d0f12619ea'],27,853,880,21179693,14,0.34261242,0.948608137,0.948608137,20831
1ea950806629a3b0c3a41bbcaaa322aab64492dd,1,Jayush Luniya,2015-10-29 17:16:28-07:00,['c8e138d98fcfbd25a7d8c46726c956fa50f30fac'],1,25,26,21179719,2,1,1,1,20831
028143c4033f832b177d6d4d829ac4ad57a95c88,0,Jayush Luniya,2015-10-29 17:21:31-07:00,['1ea950806629a3b0c3a41bbcaaa322aab64492dd'],25,46,71,21179790,3,,,,20832
3ff718e3ae1e4756ce83d72369f8a5c8733bb391,1,Jayush Luniya,2015-10-29 22:11:21-07:00,['028143c4033f832b177d6d4d829ac4ad57a95c88'],33,59,92,21179882,4,0,0.928571429,0.571428571,20832
b714027dc1878445b4d3cf01637a4d6747bdb968,1,Gautam Borad,2015-10-30 12:27:54+05:18,['3ff718e3ae1e4756ce83d72369f8a5c8733bb391'],25,27,52,21179934,5,,,,20832
af4d8acebb4a994bea8f525d57dac18dfdf52344,1,Andrii Tkach,2015-10-30 11:49:21+02:00,['b714027dc1878445b4d3cf01637a4d6747bdb968'],28,78,106,21180040,3,0.512820513,0.512820513,1,20832
55c150be188d35939f903a2f16ac756d206d91a7,0,Aleksandr Kovalenko,2015-10-30 12:21:15+02:00,['af4d8acebb4a994bea8f525d57dac18dfdf52344'],16,61,77,21180117,9,0.342105263,1,1,20832
227bd813e5ce0ee6aaec6d77e127d02f580ce638,0,aBabiichuk,2015-10-30 12:22:36+02:00,['55c150be188d35939f903a2f16ac756d206d91a7'],5,10,15,21180132,1,1,1,1,20832
37fb051ae35f48dd11b73850ac41a916a38efded,0,aBabiichuk,2015-10-30 12:22:37+02:00,['227bd813e5ce0ee6aaec6d77e127d02f580ce638'],7,0,7,21180139,1,1,1,1,20832
491a3284e26ddb0d2655ccb783f18e88bb75838b,1,Dmytro Sen,2015-10-30 14:18:25+02:00,['37fb051ae35f48dd11b73850ac41a916a38efded'],7,37,44,21180183,2,,,,20832
b2abf50ea94c7f5896704a62aca2de7e86bfe436,0,Vitaly Brodetskyi,2015-10-30 14:33:04+02:00,['491a3284e26ddb0d2655ccb783f18e88bb75838b'],5,9,14,21180197,2,0,1,0,20832
8e06ea681605f22a08015afb91b7e087b7e04e79,1,aBabiichuk,2015-10-30 15:03:39+02:00,['b2abf50ea94c7f5896704a62aca2de7e86bfe436'],12,32,44,21180241,3,0.466666667,0,1,20832
7e45cd3ef9e2691bb68f3ef12d7fedd1cbdf6ed4,0,Andrew Onishuk,2015-10-30 15:26:01+02:00,['8e06ea681605f22a08015afb91b7e087b7e04e79'],1,1,2,21180243,1,,,,20832
0e80a853bb31c709f38b9652a034e9e8a9090c5a,1,Andrii Tkach,2015-10-30 15:53:00+02:00,['7e45cd3ef9e2691bb68f3ef12d7fedd1cbdf6ed4'],5,8,13,21180256,1,0.857142857,1,1,20832
06c481581a645b7fd81b733d9976dbd042fc440e,1,Dmytro Sen,2015-10-30 16:21:24+02:00,['0e80a853bb31c709f38b9652a034e9e8a9090c5a'],9,7,16,21180272,2,1,1,1,20832
ae8610f3959d5b2071e8b399219327713be44aee,1,Andrii Tkach,2015-10-30 16:27:04+02:00,['06c481581a645b7fd81b733d9976dbd042fc440e'],4,15,19,21180291,3,0.769230769,1,1,20832
51116d06e8e2c0dbd4baf1cb4e94d8152ecf4023,1,Aleksandr Kovalenko,2015-10-30 17:05:02+02:00,['ae8610f3959d5b2071e8b399219327713be44aee'],1,1,2,21180293,1,,,,20832
44baa24bfcfe5057c3f14b96be0fbc80b6790e33,1,Srimanth Gunturi,2015-10-30 09:12:55-07:00,['51116d06e8e2c0dbd4baf1cb4e94d8152ecf4023'],5,5,10,21180303,1,,,,20832
dd8bdd2748b6ae276752b3601b64a5f36dade466,1,Srimanth Gunturi,2015-10-30 09:23:39-07:00,['44baa24bfcfe5057c3f14b96be0fbc80b6790e33'],7,329,336,21180639,8,0.714285714,1,0.89010989,20837
ccbb90fdc3d74e3e87e7f8cbc90416eb616e8d08,0,Jaimin Jetly,2015-10-30 09:56:09-07:00,['dd8bdd2748b6ae276752b3601b64a5f36dade466'],20,21,41,21180680,1,0,0,0,20837
467f846e58b352ce7553a0294ec2a5d2b4de53d5,1,Jayush Luniya,2015-10-30 11:10:42-07:00,['ccbb90fdc3d74e3e87e7f8cbc90416eb616e8d08'],38,66,104,21180784,19,,,0,20837
4ed0a03a4d0e1acb6648c4c8c26dc9a632e8c20c,1,Alejandro Fernandez,2015-10-30 11:36:09-07:00,['467f846e58b352ce7553a0294ec2a5d2b4de53d5'],146,156,302,21181086,12,0,1,0,20837
35fd12de5e791af97ef84b102432671e4b13ce18,1,Alejandro Fernandez,2015-10-30 11:45:58-07:00,['4ed0a03a4d0e1acb6648c4c8c26dc9a632e8c20c'],196,288,484,21181570,28,0,0,0,20838
db12ed3b0641093d91e2cb8edd08a947fa66269b,0,Siddharth Wagle,2015-10-30 12:36:16-07:00,['35fd12de5e791af97ef84b102432671e4b13ce18'],70,100,170,21181740,6,0,0.35,0.25,20838
b71d335fbe7a6f261e0e9d9dda17343854b39c59,1,Siddharth Wagle,2015-10-30 13:21:06-07:00,['db12ed3b0641093d91e2cb8edd08a947fa66269b'],24,91,115,21181855,6,0,0.37254902,0.411764706,20838
49d3efe7a38e7f239188f0f62dfed1560c874b0e,0,Xi Wang,2015-10-30 13:32:34-07:00,['b71d335fbe7a6f261e0e9d9dda17343854b39c59'],1,10,11,21181866,1,0,0,1,20838
3347a6bb0e23e0fbca31afe9d2075e26a1bf0bad,1,Srimanth Gunturi,2015-10-30 13:48:52-07:00,['49d3efe7a38e7f239188f0f62dfed1560c874b0e'],1,13,14,21181880,2,0,0,1,20838
32e64a3fd842fb01984782d3e5887e4fb4d8f5b1,1,Nate Cole,2015-10-30 16:49:52-04:00,['3347a6bb0e23e0fbca31afe9d2075e26a1bf0bad'],16,74,90,21181970,8,1,1,0,20838
3fcf094daf394857142e71f73a9261f5bff989e0,1,Alejandro Fernandez,2015-10-30 14:15:44-07:00,['32e64a3fd842fb01984782d3e5887e4fb4d8f5b1'],7,7,14,21181984,7,,,,20838
d79b3d5e7d445f47113116bfe89ca7450eaff845,0,Jaimin Jetly,2015-10-30 14:43:21-07:00,['3fcf094daf394857142e71f73a9261f5bff989e0'],1,1,2,21181986,1,,,,20838
b4aaf2a3e3043e163141172ab8567b71d271dc39,1,Siddharth Wagle,2015-10-30 15:56:36-07:00,['d79b3d5e7d445f47113116bfe89ca7450eaff845'],19,17,36,21182022,2,0,1,1,20838
060215d6446043599e97ed316d780a05d92f8bf3,0,Jaimin Jetly,2015-10-30 17:02:45-07:00,['b4aaf2a3e3043e163141172ab8567b71d271dc39'],0,38,38,21182060,2,,,,20838
eaa105cb5ae73c173b30207cf2156412e33c5c5d,0,Jaimin Jetly,2015-10-30 17:19:38-07:00,['060215d6446043599e97ed316d780a05d92f8bf3'],1,1,2,21182062,1,,,,20838
8b0371bb76869d228c67c77d87ca621caf49453a,1,Siddharth Wagle,2015-11-01 08:59:25-08:00,['eaa105cb5ae73c173b30207cf2156412e33c5c5d'],6,19,25,21182087,3,0.5,1,1,20838
ca4d5b1d68a8883def5a6ab02a25eeaf5beb4365,1,Siddharth Wagle,2015-11-01 21:27:02-08:00,['8b0371bb76869d228c67c77d87ca621caf49453a'],2,7,9,21182096,1,1,1,1,20838
0492aa4f21d12977b914b81bd3f640eeaad01ddc,1,Andrew Onishuk,2015-11-02 11:45:26+02:00,['ca4d5b1d68a8883def5a6ab02a25eeaf5beb4365'],15,21,36,21182132,5,0,0,0,20838
c5d1aeeb0d21adf8c4204e9a52a4bdabe490e5f0,1,Oleg Nechiporenko,2015-11-02 12:17:28+02:00,['0492aa4f21d12977b914b81bd3f640eeaad01ddc'],630,295,925,21183057,18,0,0,0.00660066,20839
2cd129431dc3688bc931e565a1e6096bf94ccbca,0,Oleg Nechiporenko,2015-11-02 12:18:46+02:00,['c5d1aeeb0d21adf8c4204e9a52a4bdabe490e5f0'],387,14,401,21183458,83,0.645833333,0.086309524,0.1875,20839
745036ebb5a6729c3e34a9c70a4bffd8ef713e4c,0,Sumit Mohanty,2015-11-02 03:37:41-08:00,['2cd129431dc3688bc931e565a1e6096bf94ccbca'],1,1,2,21183460,1,,,,20839
0f0cf13d7d1931f3df4c80e9be172e73cd14a08e,1,Andrii Tkach,2015-11-02 14:20:41+02:00,['745036ebb5a6729c3e34a9c70a4bffd8ef713e4c'],2,4,6,21183466,2,0,1,1,20839
a6f9562d38cbe0cd7700df4c6e426dd9a05c837a,1,Andrew Onishuk,2015-11-02 15:53:36+02:00,['0f0cf13d7d1931f3df4c80e9be172e73cd14a08e'],12,16,28,21183494,5,,,,20839
223247120318ce9f0df9ac995d0ba6c5e7974dfa,1,Vitaly Brodetskyi,2015-11-02 18:04:10+02:00,['a6f9562d38cbe0cd7700df4c6e426dd9a05c837a'],68,134,202,21183696,14,0.233333333,1,1,20839
646de5754fd031270ed265cf7332a925ada24df2,1,Dmytro Sen,2015-11-02 18:08:47+02:00,['223247120318ce9f0df9ac995d0ba6c5e7974dfa'],6,145,151,21183847,7,0.096774194,0.752688172,0.956989247,20839
7e62c5c11265d41c545830d8c438a32537d45608,1,Dmytro Sen,2015-11-02 20:16:38+02:00,['646de5754fd031270ed265cf7332a925ada24df2'],3,3,6,21183853,2,,,,20839
cc5b6106613b71f74b2e7d7791bd6adcd58fe5cc,1,Siddharth Wagle,2015-11-02 15:00:20-08:00,['7e62c5c11265d41c545830d8c438a32537d45608'],18,18,36,21183889,1,,,,20839
3bfd4cb491c50a7735e05e77c25fbe66e7d36e2d,1,Jun Aoki,2015-11-02 16:51:12-08:00,['cc5b6106613b71f74b2e7d7791bd6adcd58fe5cc'],236,166,402,21184291,9,,,,20839
94b8f7b258601a00b884a7777e3612ae5aeb9157,0,Xi Wang,2015-11-02 17:09:51-08:00,['3bfd4cb491c50a7735e05e77c25fbe66e7d36e2d'],1,1,2,21184293,1,,,,20839
715437a5fd519005c2d868ea8dd676d0389064a0,1,Jun Aoki,2015-11-02 17:13:17-08:00,['94b8f7b258601a00b884a7777e3612ae5aeb9157'],1,3,4,21184297,1,,,,20839
bb5c8975f3215dcb5a13ee0ae3a08c9453031fb1,1,Gautam Borad,2015-11-03 10:55:45+05:18,['715437a5fd519005c2d868ea8dd676d0389064a0'],14,14,28,21184325,3,,,,20839
b38be7fc9abcd72ccc1cbe61b7ba0d071a213f0b,0,Jayush Luniya,2015-11-02 22:05:49-08:00,['bb5c8975f3215dcb5a13ee0ae3a08c9453031fb1'],6,8,14,21184339,2,0,1,0,20839
8098e39dedc2035f4e97adfe646965a9a326b128,1,Jayush Luniya,2015-11-02 22:08:32-08:00,['b38be7fc9abcd72ccc1cbe61b7ba0d071a213f0b'],8,6,14,21184353,2,1,0,1,20839
14537c6f16116c1cd7745d5dc8aa9a5798986722,1,Jayush Luniya,2015-11-02 22:13:05-08:00,['8098e39dedc2035f4e97adfe646965a9a326b128'],1,2,3,21184356,2,0,1,0,20839
9b87326e877311927b5d49999b76d7c5733b50ae,1,Jayush Luniya,2015-11-02 22:20:21-08:00,['14537c6f16116c1cd7745d5dc8aa9a5798986722'],6,8,14,21184370,2,0,1,0,20839
e86d1cd7c3fa6a03f289cd83ed945b5b9acfc668,1,Dmytro Sen,2015-11-03 11:43:59+02:00,['9b87326e877311927b5d49999b76d7c5733b50ae'],18,64,82,21184452,4,0.333333333,1,1,20839
a2062703c4e86f28fb939168a5d2ac45b376240b,0,Oleg Nechiporenko,2015-11-03 11:59:08+02:00,['e86d1cd7c3fa6a03f289cd83ed945b5b9acfc668'],0,3,3,21184455,1,1,1,1,20839
dc0ac133dedef8a59550cb060e6afe9a225542ec,0,Andrew Onishuk,2015-11-03 12:15:02+02:00,['a2062703c4e86f28fb939168a5d2ac45b376240b'],2,0,2,21184457,1,,,,20839
df693b7e1af62fe28413e569b687cae16bd67e2d,0,Andrii Tkach,2015-11-03 12:40:39+02:00,['dc0ac133dedef8a59550cb060e6afe9a225542ec'],1,25,26,21184483,2,1,1,1,20839
6321a0da5274f550e398f929f4a0ea75caa95152,1,Vitaly Brodetskyi,2015-11-03 13:21:18+02:00,['df693b7e1af62fe28413e569b687cae16bd67e2d'],91,298,389,21184872,13,0.172932331,0.616541353,1,20839
76dd478e5d701ae2c64989d5e07a9caada3ddfb6,1,Oleg Nechiporenko,2015-11-03 14:50:27+02:00,['6321a0da5274f550e398f929f4a0ea75caa95152'],779,1388,2167,21187039,6,0.863636364,1,1,20841
60b835847603c165f4235856a1ae04981cc10bd8,1,Nate Cole,2015-11-03 07:58:29-05:00,['76dd478e5d701ae2c64989d5e07a9caada3ddfb6'],100,97,197,21187236,4,0,0,0.315789474,20841
9ce6311f6c644b629e268101b3dd6ea8277c9fb4,1,Nate Cole,2015-11-03 08:42:45-05:00,['60b835847603c165f4235856a1ae04981cc10bd8'],1,4,5,21187241,2,1,0,0,20841
f24058f79e9b12e8c80aa4c03f6b82b0123ce7c3,1,Andrew Onishuk,2015-11-03 16:29:16+02:00,['9ce6311f6c644b629e268101b3dd6ea8277c9fb4'],35,95,130,21187371,8,0,1,1,20841
b5406c597f2b7bf83a070fd6f0c69a233a2e1064,1,Dmytro Sen,2015-11-03 16:54:23+02:00,['f24058f79e9b12e8c80aa4c03f6b82b0123ce7c3'],6,51,57,21187428,4,1,1,1,20842
ca7b8298366b5cb549d6a9de838274ab2cb139f7,1,Lisnichenko Dmitro,2015-11-03 17:06:20+02:00,['b5406c597f2b7bf83a070fd6f0c69a233a2e1064'],2,8,10,21187438,1,0,1,0,20842
d501a38a144a037f282e53861deb942ea649d88e,0,Andrew Onishuk,2015-11-03 17:13:15+02:00,['ca7b8298366b5cb549d6a9de838274ab2cb139f7'],2,2,4,21187442,1,,,,20842
8aba9a4d6802c8cceb441e9e2af49c11cbbf2826,1,Andrew Onishuk,2015-11-03 17:13:46+02:00,['d501a38a144a037f282e53861deb942ea649d88e'],0,4,4,21187446,2,0,1,1,20842
3cb80cfc16365861596e3fd3b9a94d6774db9f50,0,Alex Antonenko,2015-11-03 19:19:41+02:00,['8aba9a4d6802c8cceb441e9e2af49c11cbbf2826'],39,217,256,21187702,22,0.357954545,1,1,20842
de3147d5dece64ab1c64366ef99f8a3de75afc96,0,Alex Antonenko,2015-11-03 19:19:41+02:00,['3cb80cfc16365861596e3fd3b9a94d6774db9f50'],11,38,49,21187751,2,0,0,1,20842
1e86d690d308451481e9043c393e60d3ba089f04,1,Srimanth Gunturi,2015-11-03 10:10:08-08:00,['de3147d5dece64ab1c64366ef99f8a3de75afc96'],26,111,137,21187888,2,1,1,1,20842
4763c759cc728d9fd8f24402c90012ae527985e5,1,Jun Aoki,2015-11-03 12:14:45-08:00,['1e86d690d308451481e9043c393e60d3ba089f04'],19,193,212,21188100,5,1,1,1,20845
463ed4bd91cfc4ac7a0f199deed1a42b1f511ef9,1,Richard Zang,2015-11-03 12:46:08-08:00,['4763c759cc728d9fd8f24402c90012ae527985e5'],1,3,4,21188104,1,1,1,1,20845
b179d8de9551d8963f4903fc1736cde548050434,1,Sumit Mohanty,2015-11-03 15:33:57-08:00,['463ed4bd91cfc4ac7a0f199deed1a42b1f511ef9'],110,735,845,21188949,16,0.270833333,0.666666667,0.958333333,20849
6bc870f6c955aec07a19c1b7d222c99a2701d999,1,Myroslav Papirkovskyi,2015-11-04 02:02:26+02:00,['b179d8de9551d8963f4903fc1736cde548050434'],6,261,267,21189216,8,0.675159236,0.840764331,0.993630573,20850
4c3be3975ace624be966639c9575d5b38aa038c9,1,Siddharth Wagle,2015-11-03 21:33:52-08:00,['6bc870f6c955aec07a19c1b7d222c99a2701d999'],67,356,423,21189639,13,0.085365854,0.823170732,1,20850
ac0db6e25246a4067da6ad1e9d6b17b7a814b5a5,1,Vitaly Brodetskyi,2015-11-04 11:01:14+02:00,['4c3be3975ace624be966639c9575d5b38aa038c9'],2,4,6,21189645,1,0,0,0,20850
b8a9064ab1c6211deaf9f8d6f87760ac917b6c69,0,Andrii Tkach,2015-11-04 13:23:22+02:00,['ac0db6e25246a4067da6ad1e9d6b17b7a814b5a5'],2,2,4,21189649,1,,,,20850
7546f20237ec7c18116edb9f4efda4f5eb9932ca,1,Nate Cole,2015-11-04 08:08:27-05:00,['b8a9064ab1c6211deaf9f8d6f87760ac917b6c69'],31,652,683,21190332,10,0.202247191,1,0.516853933,20852
fefcdf5db65d07c2f755e40d89823ad799fc6c30,0,Nate Cole,2015-11-04 08:36:05-05:00,"['ab031a3c8a116d041f96582e5c125d8fca53b795', '7546f20237ec7c18116edb9f4efda4f5eb9932ca']",7748,39255,47003,21237335,600,,,,20852
4b0b1041cb45474cf5825e0fe50d7e13ca09806e,1,Aleksandr Kovalenko,2015-11-04 18:15:44+02:00,['7546f20237ec7c18116edb9f4efda4f5eb9932ca'],6,70,76,21237411,8,0,0.5,1,20853
e97b321647e5966bdd94291ce454bf29b8cf2ed5,1,Andrii Tkach,2015-11-04 19:20:19+02:00,['4b0b1041cb45474cf5825e0fe50d7e13ca09806e'],773,1091,1864,21239275,12,0.935849057,0.983018868,1,20854
198755193692848e126071f81c3073d9587cf949,0,Vitaly Brodetskyi,2015-11-04 20:26:48+02:00,['e97b321647e5966bdd94291ce454bf29b8cf2ed5'],1138,0,1138,21240413,5,0.842787682,0.863857374,0.303079417,20854
af56de5ac24ed8101a3ed17fbed7c633ec320435,1,Vitaly Brodetskyi,2015-11-04 20:44:33+02:00,['198755193692848e126071f81c3073d9587cf949'],0,16,16,21240429,2,0,1,1,20854
03a7b9d0ef4b814b27778e5479ddd4a50a632ac4,1,Srimanth Gunturi,2015-11-04 11:38:34-08:00,['af56de5ac24ed8101a3ed17fbed7c633ec320435'],6,324,330,21240759,12,0.626760563,0.823943662,0.774647887,20858
b841e95c4b9b656101b659efa5493fd3154208ae,1,Andrew Onishuk,2015-11-04 21:51:39+02:00,['03a7b9d0ef4b814b27778e5479ddd4a50a632ac4'],1,1,2,21240761,1,,,,20858
ae3701de671b614df4c15bfb70b30a0a238573ad,0,Yusaku Sako,2015-11-04 12:52:20-08:00,['b841e95c4b9b656101b659efa5493fd3154208ae'],5,13,18,21240779,1,,,,20858
da7d926e06dcced337d6f1c2a1d6746677fc586e,1,Nate Cole,2015-11-04 16:27:21-05:00,['ae3701de671b614df4c15bfb70b30a0a238573ad'],31,552,583,21241362,3,0.053459119,0.924528302,0.927672956,20859
f859570ae8cedbff71986e5940f42bba195b9f2f,1,Jayush Luniya,2015-11-04 13:40:48-08:00,['da7d926e06dcced337d6f1c2a1d6746677fc586e'],16,357,373,21241735,8,0.083333333,0.727777778,1,20861
943323fc613e7b3a81a37d1814fcb19963de9485,1,Srimanth Gunturi,2015-11-04 14:16:49-08:00,['f859570ae8cedbff71986e5940f42bba195b9f2f'],114,244,358,21242093,10,1,1,1,20862
67e069ef37400221ced55356f215ab591f8798ea,1,Alejandro Fernandez,2015-11-04 15:27:03-08:00,['943323fc613e7b3a81a37d1814fcb19963de9485'],1,77,78,21242171,2,1,1,1,20863
c49a8540b2fdc9f51ac2aeac1b5b15557624aa89,0,Jaimin Jetly,2015-11-04 16:26:08-08:00,['67e069ef37400221ced55356f215ab591f8798ea'],6,0,6,21242177,1,,,,20863
efca65bfff18c8fe1340d5923a91726121359d93,1,Alejandro Fernandez,2015-11-04 16:27:14-08:00,['c49a8540b2fdc9f51ac2aeac1b5b15557624aa89'],21,259,280,21242457,7,0,0,1,20863
e24078b2b91a3a86bf252cb6a7d4cb8b3bbb77b3,1,Oleg Nechiporenko,2015-11-05 12:52:45+02:00,['efca65bfff18c8fe1340d5923a91726121359d93'],399,1291,1690,21244147,4,1,1,0.420512821,20863
f3f97311bf06fb7f8bdea72804d3c6b0b588f6bb,1,Andrii Tkach,2015-11-05 13:26:20+02:00,['e24078b2b91a3a86bf252cb6a7d4cb8b3bbb77b3'],9,5,14,21244161,1,0,0.5,0,20863
abd6fb589ae6cfb84782f1d275b90e3ec528ecc8,0,Dmytro Sen,2015-11-05 15:15:46+02:00,['f3f97311bf06fb7f8bdea72804d3c6b0b588f6bb'],2,2,4,21244165,1,,,,20863
6c39604268c67989e7a87a66e3a12f1562b6bb42,1,Vitaly Brodetskyi,2015-11-05 15:44:14+02:00,['abd6fb589ae6cfb84782f1d275b90e3ec528ecc8'],2,6,8,21244173,2,0,0,1,20863
c62f4416305277b4f8929eb5243d616773c8f315,1,Alex Antonenko,2015-11-05 15:58:11+02:00,['6c39604268c67989e7a87a66e3a12f1562b6bb42'],44,166,210,21244383,8,1,1,1,20866
ab16f41780639b1a1e38061dfd172f7bea77265e,1,Dmytro Sen,2015-11-05 18:05:47+02:00,['c62f4416305277b4f8929eb5243d616773c8f315'],11,13,24,21244407,2,0,1,1,20866
4db9a1eefe7ea847f93d7c7c19ee025d8ca638c6,1,Vitaly Brodetskyi,2015-11-05 18:19:49+02:00,['ab16f41780639b1a1e38061dfd172f7bea77265e'],10,5,15,21244422,2,1,0.4,0.4,20866
b3a562c6356a63d597bc1105886e7dcfc2d03607,1,Myroslav Papirkovskyi,2015-11-05 19:34:57+02:00,['4db9a1eefe7ea847f93d7c7c19ee025d8ca638c6'],59,191,250,21244672,7,0,0.936170213,0.563829787,20866
625e4ff293f36b83a2b03ac9cc48d746f692e4ee,1,Jayush Luniya,2015-11-05 10:28:26-08:00,['b3a562c6356a63d597bc1105886e7dcfc2d03607'],25,322,347,21245019,16,0.054347826,0.206521739,0.902173913,20869
b4397f32d7f15817c7fd21f4b692b91784a4a9a8,1,Srimanth Gunturi,2015-11-05 11:02:41-08:00,['625e4ff293f36b83a2b03ac9cc48d746f692e4ee'],12,12,24,21245043,7,,,,20869
31e73c6c04dcee0a1787aef4ba1e16394b44c69b,1,Yusaku Sako,2015-11-05 14:33:12-08:00,['b4397f32d7f15817c7fd21f4b692b91784a4a9a8'],39,244,283,21245326,5,1,0.833333333,1,20869
95ca56f9cb7892a5a9e124e59b6171ad63cdc09e,1,Bob Nettleton,2015-11-05 17:45:11-05:00,['31e73c6c04dcee0a1787aef4ba1e16394b44c69b'],28,258,286,21245612,4,0,0.517482517,1,20869
f6af4897861f3ef91418c1bc41e65b0739cbfc05,1,Dmytro Sen,2015-11-06 01:26:14+02:00,['95ca56f9cb7892a5a9e124e59b6171ad63cdc09e'],0,138,138,21245750,4,0.017699115,1,1,20869
103dd7c2d7ae4efb8663ecbb3b936997467f9c84,1,Jaimin Jetly,2015-11-05 17:27:36-08:00,['f6af4897861f3ef91418c1bc41e65b0739cbfc05'],12,36,48,21245798,10,0,0.5625,0.5625,20869
d01a143ffaf6349cc8f1c77ce295ec8daca4e4a3,0,Jaimin Jetly,2015-11-05 17:34:06-08:00,['103dd7c2d7ae4efb8663ecbb3b936997467f9c84'],8,8,16,21245814,2,,,,20869
02e113d09735ec2cf42bb078d9837032eca09c39,1,Oleg Nechiporenko,2015-11-06 12:37:35+02:00,['d01a143ffaf6349cc8f1c77ce295ec8daca4e4a3'],14,40,54,21245868,1,,,,20869
223feece188581a696f66dba0b32824bc5675272,0,Vitaly Brodetskyi,2015-11-06 12:38:44+02:00,['02e113d09735ec2cf42bb078d9837032eca09c39'],2,16,18,21245886,3,0,0.666666667,0.333333333,20869
18274ea01379527fceb8ee8fe6120dd262544f44,1,Andrew Onishuk,2015-11-06 12:49:17+02:00,['223feece188581a696f66dba0b32824bc5675272'],1,36,37,21245923,2,0.909090909,0.909090909,1,20869
1469a0e6236e680b6ac1b18cd8250bc904c20eb7,1,Lisnichenko Dmitro,2015-11-06 14:29:08+02:00,['18274ea01379527fceb8ee8fe6120dd262544f44'],16,17,33,21245956,3,0,1,1,20869
a8a2387428393715890e322b3ba03d8787fe7920,1,Oleg Nechiporenko,2015-11-06 14:54:46+02:00,['1469a0e6236e680b6ac1b18cd8250bc904c20eb7'],5,108,113,21246069,10,1,1,1,20869
6b3599a002eaaa5ed8eb15c2ef33f71fe1552417,1,Andrii Tkach,2015-11-06 16:16:44+02:00,['a8a2387428393715890e322b3ba03d8787fe7920'],24,40,64,21246133,12,0,1,1,20869
1317c8f173b008aa33be902b95e4a8d0970c9c4b,0,Alex Antonenko,2015-11-06 16:44:05+02:00,['6b3599a002eaaa5ed8eb15c2ef33f71fe1552417'],2,133,135,21246268,3,0.150943396,1,1,20870
d6c7038b8132b9c66ac34aa3b00a944f752a984c,0,Lisnichenko Dmitro,2015-11-06 17:13:41+02:00,['1317c8f173b008aa33be902b95e4a8d0970c9c4b'],2,14,16,21246284,3,0.333333333,0,0.666666667,20870
62ff7acfe7f8e209364f49dd4a2b07e97ffafe00,1,Aleksandr Kovalenko,2015-11-06 18:03:43+02:00,['d6c7038b8132b9c66ac34aa3b00a944f752a984c'],11,73,84,21246368,2,0.050847458,1,1,20870
beb5c49d3adefc9b484e225acf85e93257e5b423,1,Jaimin Jetly,2015-11-06 10:47:13-08:00,['62ff7acfe7f8e209364f49dd4a2b07e97ffafe00'],2,16,18,21246386,2,1,1,1,20870
36e20f9f691eace4775ad55e1aa438de0e15a0e9,1,Xi Wang,2015-11-06 11:03:36-08:00,['beb5c49d3adefc9b484e225acf85e93257e5b423'],6,4,10,21246396,2,0,0,0,20870
9cee9a22e0131da206e6fa3afb01e37da5680407,1,Alejandro Fernandez,2015-11-06 11:46:54-08:00,['36e20f9f691eace4775ad55e1aa438de0e15a0e9'],143,92,235,21246631,8,1,0,0,20870
5dac27bef4a89a049c7e77f49828a20370d0b518,0,Jun Aoki,2015-11-06 13:49:33-08:00,['9cee9a22e0131da206e6fa3afb01e37da5680407'],0,0,0,21246631,23,,,,20870
d0883c5894ec8ca7a48f5b8de1e5a851ecadbd6a,1,Srimanth Gunturi,2015-11-06 16:05:56-08:00,['5dac27bef4a89a049c7e77f49828a20370d0b518'],2,33,35,21246666,3,1,1,1,20870
147796127ba74d784e8f116f5fd5adf69e059b3d,1,Srimanth Gunturi,2015-11-06 16:19:39-08:00,['d0883c5894ec8ca7a48f5b8de1e5a851ecadbd6a'],2,2,4,21246670,1,,,,20870
6e8760d328f23d3fd4b7dfc5e1c6f300ec9f55f6,1,Srimanth Gunturi,2015-11-06 16:19:48-08:00,['147796127ba74d784e8f116f5fd5adf69e059b3d'],0,1,1,21246671,1,,,,20870
810a32abbdae394fbe8f6f9263e70ec172ae8dfa,0,Yusaku Sako,2015-11-06 16:47:11-08:00,['6e8760d328f23d3fd4b7dfc5e1c6f300ec9f55f6'],0,0,0,21246671,23,,,,20870
079293935aed3650f5240c1b2dc2975d2875b82f,1,Yusaku Sako,2015-11-06 16:50:15-08:00,['810a32abbdae394fbe8f6f9263e70ec172ae8dfa'],5,1584,1589,21248260,26,0.700740741,0.866666667,0.942222222,20885
66e2eb424bd8d8e6611f518b66a3dcd44ae9948e,1,Sumit Mohanty,2015-11-07 06:51:07-08:00,['079293935aed3650f5240c1b2dc2975d2875b82f'],9,144,153,21248413,5,0.290322581,1,1,20885
db224500f253f2bd6c842f9097efe572943001cf,1,Sumit Mohanty,2015-11-08 17:13:35-08:00,['66e2eb424bd8d8e6611f518b66a3dcd44ae9948e'],65,60,125,21248538,4,,,,20886
a5d5dc99a80cf4f8d4639c829f84e7112d95d0dd,1,Sumit Mohanty,2015-11-08 17:20:34-08:00,['db224500f253f2bd6c842f9097efe572943001cf'],1,1,2,21248540,1,,,,20886
618d843c1b8b436748117b9e3852f85ae802873b,0,Sumit Mohanty,2015-11-08 17:21:23-08:00,['a5d5dc99a80cf4f8d4639c829f84e7112d95d0dd'],4,2,6,21248546,1,,,,20886
da8ca2ae386874ba3b8d28f355578c2f340a0d13,1,Oleg Nechiporenko,2015-11-09 12:07:19+02:00,['618d843c1b8b436748117b9e3852f85ae802873b'],42,41,83,21248629,10,1,1,1,20886
48ad32a2000e4e02fd915a53df4488685595e5cb,1,Dmytro Sen,2015-11-09 13:12:03+02:00,['da8ca2ae386874ba3b8d28f355578c2f340a0d13'],3,8,11,21248640,1,,,,20886
18a25ce13108d3ef0de857a3db412ebb7a559ea6,0,Andrew Onishuk,2015-11-09 15:15:31+02:00,['48ad32a2000e4e02fd915a53df4488685595e5cb'],3,2,5,21248645,1,,,,20886
88c850bbef0025b0016869fe66ec25f6edc94d81,0,Dmytro Sen,2015-11-09 16:31:26+02:00,['18a25ce13108d3ef0de857a3db412ebb7a559ea6'],1,0,1,21248646,1,,,,20886
9cb0cc07abbcf42317f56a777f758b4fa60f77b3,1,Bob Nettleton,2015-11-09 10:31:07-05:00,['88c850bbef0025b0016869fe66ec25f6edc94d81'],10,11,21,21248667,3,1,1,1,20886
47ab1426e6e1f13a794ec0a7e73fdbfec8339192,1,Andrew Onishuk,2015-11-09 18:59:23+02:00,['9cb0cc07abbcf42317f56a777f758b4fa60f77b3'],17,20,37,21248704,3,0,0,1,20886
ac8147b6c9786da067b068ded9c87865ba711547,0,Alex Antonenko,2015-11-09 19:06:19+02:00,['47ab1426e6e1f13a794ec0a7e73fdbfec8339192'],6,103,109,21248813,4,0.52173913,1,1,20887
d7f6f18e547a230134b720d731f5e3d75bd4f6c5,1,Alex Antonenko,2015-11-09 19:06:19+02:00,['ac8147b6c9786da067b068ded9c87865ba711547'],0,1,1,21248814,1,0,1,0,20887
a20d8f73c37984ffd743100c7ef6faa865da73fb,0,Vitaly Brodetskyi,2015-11-09 19:25:17+02:00,['d7f6f18e547a230134b720d731f5e3d75bd4f6c5'],45,49,94,21248908,4,,,,20887
edefa4858ff95d82e742dbb86d2c48bbd34af2c2,1,Lisnichenko Dmitro,2015-11-09 19:35:53+02:00,['a20d8f73c37984ffd743100c7ef6faa865da73fb'],2,21,23,21248931,3,0,0,0.866666667,20887
8997ce0d50d91c4cb008d303a07dfd7a949d1788,0,Myroslav Papirkovskyy,2015-11-09 20:09:12+02:00,['edefa4858ff95d82e742dbb86d2c48bbd34af2c2'],44,1214,1258,21250189,32,0.40608229,0.629695886,0.813953488,20894
e10d40208a4188ef44866633a8c0c492feb492d3,1,Andrii Tkach,2015-11-09 20:44:35+02:00,['8997ce0d50d91c4cb008d303a07dfd7a949d1788'],14,36,50,21250239,5,1,1,1,20894
9c086c303fb6f772d2fb5d654b6bf7de2225ca62,1,Dmytro Sen,2015-11-09 20:47:40+02:00,['e10d40208a4188ef44866633a8c0c492feb492d3'],2,38,40,21250279,2,0,0,1,20894
4cccb8708a37de5a83ced70565ccdb1103fc30e6,0,Dmytro Sen,2015-11-09 20:57:41+02:00,['9c086c303fb6f772d2fb5d654b6bf7de2225ca62'],21,0,21,21250300,3,1,0.625,0,20894
253b489879e9509ae5d0866317d6ed182a67a8b9,1,Dmytro Sen,2015-11-09 21:06:33+02:00,['4cccb8708a37de5a83ced70565ccdb1103fc30e6'],51,169,220,21250520,40,0,0.804878049,1,20894
84570411436f2b93887a5c0bca3d52761573217b,1,Bob Nettleton,2015-11-09 15:39:51-05:00,['253b489879e9509ae5d0866317d6ed182a67a8b9'],72,163,235,21250755,3,0,1,1,20894
de5093a5c8e56959d050e309f7bd5f52ecad36bc,0,Jonathan Hurley,2015-11-09 16:55:37-05:00,['84570411436f2b93887a5c0bca3d52761573217b'],1214,44,1258,21252013,32,0.59391771,0.370304114,0.186046512,20894
c715189ab50311f5fc2ed0b089e426173b59fd25,1,Jonathan Hurley,2015-11-09 16:55:38-05:00,['de5093a5c8e56959d050e309f7bd5f52ecad36bc'],38,195,233,21252246,6,0.083333333,1,1,20896
d7a9655350126d2958382a5095b9499bf450bf07,1,Yusaku Sako,2015-11-09 14:21:06-08:00,['c715189ab50311f5fc2ed0b089e426173b59fd25'],6,55,61,21252307,3,0,0.652173913,1,20896
70f2cfe74bb54ce9579eb073c4348b179ce76ad1,1,Xi Wang,2015-11-09 14:33:14-08:00,['d7a9655350126d2958382a5095b9499bf450bf07'],20,61,81,21252388,3,1,1,1,20896
47e8d3ad99e7c759b47c65cded25aa778cd50413,1,Jaimin Jetly,2015-11-09 15:58:12-08:00,['70f2cfe74bb54ce9579eb073c4348b179ce76ad1'],13,13,26,21252414,2,,,,20896
ec6da401e28f5146ab2d71c7e0a078254c0282b3,1,Srimanth Gunturi,2015-11-09 21:45:39-08:00,['47e8d3ad99e7c759b47c65cded25aa778cd50413'],113,33,146,21252560,1,0,0,0.119047619,20896
86820bc921961fb20a2bd97702a6dbb6389d241d,1,Srimanth Gunturi,2015-11-09 21:51:13-08:00,['ec6da401e28f5146ab2d71c7e0a078254c0282b3'],1,1,2,21252562,1,,,,20896
d02ec979f223e91efaa5ad9db1ad6e6377f86dd5,1,jaoki,2015-11-09 22:40:14-08:00,['86820bc921961fb20a2bd97702a6dbb6389d241d'],19,73,92,21252654,27,,,,20899
7b539281da23aad7a25c0ed25e666c21c4b07518,1,Andrii Tkach,2015-11-10 13:14:10+02:00,['d02ec979f223e91efaa5ad9db1ad6e6377f86dd5'],53,152,205,21252859,4,0.711864407,1,1,20899
6f9ef6a9e9a9382786e8ce4e0be75d41de7c90c5,1,Oleg Nechiporenko,2015-11-10 13:34:30+02:00,['7b539281da23aad7a25c0ed25e666c21c4b07518'],356,1091,1447,21254306,8,0.522580645,1,0.429032258,20902
6be4969058e3c1678bba647eebcffcc67ccc641f,1,Andrew Onishuk,2015-11-10 14:29:31+02:00,['6f9ef6a9e9a9382786e8ce4e0be75d41de7c90c5'],28,113,141,21254447,14,0,0.776470588,1,20902
101dc1d8fe3d2b06580d929ad30b7d6227514c95,1,Andrii Tkach,2015-11-10 15:50:24+02:00,['6be4969058e3c1678bba647eebcffcc67ccc641f'],3,20,23,21254470,3,0.947368421,1,1,20902
9b8701c7934201e4593fced6128841031f7ef2b0,0,Oleg Nechiporenko,2015-11-10 16:15:57+02:00,['101dc1d8fe3d2b06580d929ad30b7d6227514c95'],227,347,574,21255044,5,1,0.333333333,1,20904
0fdd089424e98478df87f4a7720d893fa94cfee6,1,Dmytro Sen,2015-11-10 16:41:40+02:00,['9b8701c7934201e4593fced6128841031f7ef2b0'],97,1233,1330,21256374,6,0,0.962962963,0,20905
b08c09873325cacf58e07ad0f7dea07f5da94db3,1,Vitaly Brodetskyi,2015-11-10 17:34:01+02:00,['0fdd089424e98478df87f4a7720d893fa94cfee6'],2,11,13,21256387,2,0,0,1,20905
ed594409994665cd684aa3a5de995c9f7443aca6,0,Myroslav Papirkovskyi,2015-11-10 18:27:08+02:00,['b08c09873325cacf58e07ad0f7dea07f5da94db3'],44,1218,1262,21257649,33,0.405357143,0.630357143,0.814285714,20912
4f054cec46ddd6f4648b02a508c5c76efda9b2bf,1,Srimanth Gunturi,2015-11-10 09:31:05-08:00,['ed594409994665cd684aa3a5de995c9f7443aca6'],4,11,15,21257664,1,0,1,1,20912
6123770cc4c6032f0644937548ea1da4b40b9035,1,Siddharth Wagle,2015-11-10 09:35:42-08:00,['4f054cec46ddd6f4648b02a508c5c76efda9b2bf'],90,120,210,21257874,12,0,0,0,20912
7b758e87e13fd62ae5a6579bfbe63835fa70c025,0,Jayush Luniya,2015-11-10 09:47:15-08:00,['6123770cc4c6032f0644937548ea1da4b40b9035'],5,0,5,21257879,1,,,,20912
65629e789e0f305f88aeab927585db342e46030c,1,Alex Antonenko,2015-11-10 21:03:06+02:00,['7b758e87e13fd62ae5a6579bfbe63835fa70c025'],3,95,98,21257977,2,0.619047619,1,1,20912
7870a4f246145465c329fd1cc0c38512220aaee5,0,Jun Aoki,2015-11-10 11:03:58-08:00,['65629e789e0f305f88aeab927585db342e46030c'],0,5,5,21257982,1,,,,20912
36121f6c63e473a2dd4ccf089fc9e0c315c2e543,0,Myroslav Papirkovskyi,2015-11-10 21:55:52+02:00,['7870a4f246145465c329fd1cc0c38512220aaee5'],1218,44,1262,21259244,33,0.594642857,0.369642857,0.185714286,20912
590a27119853b525990c4953fb85efa9e1fce7c3,1,Jonathan Hurley,2015-11-10 16:08:00-05:00,['36121f6c63e473a2dd4ccf089fc9e0c315c2e543'],122,465,587,21259831,29,0.197278912,0.367346939,0.727891156,20912
9ef7b802aa28a6f3e45a2f58d3e8d9ed39453621,1,Jaimin Jetly,2015-11-10 13:34:15-08:00,['590a27119853b525990c4953fb85efa9e1fce7c3'],4,20,24,21259855,1,1,1,1,20912
ae209e239e8b096e2665744af5b541e35e667503,1,Jaimin Jetly,2015-11-10 14:20:24-08:00,['9ef7b802aa28a6f3e45a2f58d3e8d9ed39453621'],5,5,10,21259865,2,1,0,0,20912
a7bf78e959f034489bc0329ceb9dff0f47a6de62,0,Nate Cole,2015-11-10 18:55:57-05:00,['ae209e239e8b096e2665744af5b541e35e667503'],12,4,16,21259881,9,0,1,1,20912
fa4409ae52a96dceeb905f4a37abbcc575d604b0,1,Nate Cole,2015-11-10 19:18:05-05:00,['a7bf78e959f034489bc0329ceb9dff0f47a6de62'],0,932,932,21260813,3,0.218181818,0.717171717,0.872727273,20914
67b18c127cb6600cce2bfdee2c6083497f60a624,1,Jaimin Jetly,2015-11-10 16:37:39-08:00,['fa4409ae52a96dceeb905f4a37abbcc575d604b0'],3,3,6,21260819,1,,,,20914
975c0bc44439a8056f718325ab8b8caab4c3f255,1,Siddharth Wagle,2015-11-10 17:29:55-08:00,['67b18c127cb6600cce2bfdee2c6083497f60a624'],32,60,92,21260911,2,1,1,1,20914
d49cc72e92a72596571061622aacb3c5b5721200,1,Siddharth Wagle,2015-11-10 21:13:38-08:00,['975c0bc44439a8056f718325ab8b8caab4c3f255'],41,343,384,21261295,4,0.5,0.920454545,1,20916
f96f822497d5830cd147cc7e9d07d8e9f3757897,1,Gautam Borad,2015-11-11 10:35:49+05:18,['d49cc72e92a72596571061622aacb3c5b5721200'],5,22,27,21261322,5,0.571428571,0.571428571,0.642857143,20916
7e1cb684d96d7614e6d3b0125691b05c0109c27a,1,Aleksandr Kovalenko,2015-11-11 14:18:29+02:00,['f96f822497d5830cd147cc7e9d07d8e9f3757897'],56,157,213,21261535,4,0.663366337,1,1,20916
9c5e8844ae68a6ce07a5260182fe41243e3bad38,1,Dmytro Sen,2015-11-11 14:44:36+02:00,['7e1cb684d96d7614e6d3b0125691b05c0109c27a'],1,43,44,21261579,2,0,0.617647059,1,20916
62b6547eec314fa6e81af765d3326e8bfb982e74,1,Andrew Onishuk,2015-11-11 15:36:09+02:00,['9c5e8844ae68a6ce07a5260182fe41243e3bad38'],2,4,6,21261585,2,0,0,0,20916
1ca59255ed13e615dfddeffa3b3660f5cb6dbb90,0,Dmytro Sen,2015-11-11 15:58:59+02:00,['62b6547eec314fa6e81af765d3326e8bfb982e74'],12,7,19,21261604,2,1,0.8,0,20916
d8bf840ce13be2ff8d9444ee4f2751e5d5fc2db3,1,Dmytro Sen,2015-11-11 16:09:15+02:00,['1ca59255ed13e615dfddeffa3b3660f5cb6dbb90'],8,160,168,21261772,5,0,0.756097561,1,20916
40ec645a59b9c27e180d5686ca7513933bd98383,1,Myroslav Papirkovskyi,2015-11-11 17:32:03+02:00,['d8bf840ce13be2ff8d9444ee4f2751e5d5fc2db3'],44,1242,1286,21263058,33,0.405357143,0.630357143,0.814285714,20923
f2a9787fa60da160adfb0094a380dcd656cb30cb,1,Andrii Tkach,2015-11-11 17:41:52+02:00,['40ec645a59b9c27e180d5686ca7513933bd98383'],0,4,4,21263062,1,0,1,1,20923
e384c7d8bccf026ec4e45bd0ec16f3c16531d2bd,1,Andrii Tkach,2015-11-11 19:02:40+02:00,['f2a9787fa60da160adfb0094a380dcd656cb30cb'],0,16,16,21263078,2,1,1,1,20923
ed62bae05705ff30c729948f33531e7f6b650f27,1,Andrew Onishuk,2015-11-11 19:07:43+02:00,['e384c7d8bccf026ec4e45bd0ec16f3c16531d2bd'],5,5,10,21263088,3,,,,20923
b5d436203f53f7c08cc2c141a90ae50af7bb33ec,1,aBabiichuk,2015-11-11 19:26:27+02:00,['ed62bae05705ff30c729948f33531e7f6b650f27'],907,720,1627,21264715,77,0.624772313,0.136612022,0.029143898,20925
6ee80e70efae3dfb396d457781fcb2502b53bdb5,1,aBabiichuk,2015-11-11 19:26:27+02:00,['b5d436203f53f7c08cc2c141a90ae50af7bb33ec'],44,50,94,21264809,2,1,1,1,20925
820f5cd224fce0adb42ab0fa47a59ee777d9a468,1,Andrew Onishuk,2015-11-11 19:36:23+02:00,['6ee80e70efae3dfb396d457781fcb2502b53bdb5'],0,102,102,21264911,4,,,,20929
a1e5b2329d1a4e0924fb3e249b02d69d82d5e234,0,Jonathan Hurley,2015-11-11 13:58:05-05:00,['820f5cd224fce0adb42ab0fa47a59ee777d9a468'],76,5,81,21264992,10,0.523809524,0.523809524,0.142857143,20929
85647998806346379042535692349c1b492e4bf6,1,Lisnichenko Dmitro,2015-11-11 21:49:05+02:00,['a1e5b2329d1a4e0924fb3e249b02d69d82d5e234'],12,113,125,21265117,3,0.234042553,0.914893617,0.893617021,20929
1f9e1623f8caa51bb9e3f842f22acca2bebb0085,1,Alejandro Fernandez,2015-11-11 11:56:15-08:00,['85647998806346379042535692349c1b492e4bf6'],40,37,77,21265194,6,0,1,1,20929
5a18b6b739b99c1d6c020369d6889613ad537103,1,Robert Levas,2015-11-11 15:00:51-05:00,['1f9e1623f8caa51bb9e3f842f22acca2bebb0085'],30,474,504,21265698,18,0.794871795,0.974358974,1,20935
1c9307f9fc2396754c0234c9c08af6845cb2c295,0,Sumit Mohanty,2015-11-11 13:40:07-08:00,['5a18b6b739b99c1d6c020369d6889613ad537103'],1,1,2,21265700,1,,,,20935
34db83ae90c187a477bccd604daf6ec2b21e3b5c,1,Bob Nettleton,2015-11-11 16:58:08-05:00,['1c9307f9fc2396754c0234c9c08af6845cb2c295'],20,513,533,21266233,2,0.011450382,0.980916031,0.980916031,20935
a4fd7223a65b7313928754b61ad36091d4472c8c,1,Jayush Luniya,2015-11-11 14:58:49-08:00,['34db83ae90c187a477bccd604daf6ec2b21e3b5c'],122,619,741,21266974,25,0.057627119,0.850847458,1,20935
9e97d97e32e13f04fb1b26b640f3b9ce3b43f83b,0,Xi Wang,2015-11-11 15:44:44-08:00,['a4fd7223a65b7313928754b61ad36091d4472c8c'],41,47,88,21267062,2,,,,20935
1315b8ebefa2927686d4d7f390982045f1e89f2b,0,Sumit Mohanty,2015-11-11 17:34:33-08:00,['9e97d97e32e13f04fb1b26b640f3b9ce3b43f83b'],4,2,6,21267068,2,,,,20935
0c25a4decfbf408e588d750726cd8b4314c82969,1,Jonathan Hurley,2015-11-11 23:45:10-05:00,['1315b8ebefa2927686d4d7f390982045f1e89f2b'],61,42,103,21267171,5,1,0,0,20935
696e58bd869574f6c9b013360d2f32d5a9b883a4,0,Andrew Onishuk,2015-11-12 14:56:09+02:00,['0c25a4decfbf408e588d750726cd8b4314c82969'],35,25,60,21267231,2,1,0.888888889,0.888888889,20935
4da648d4448a01361229f789457f3b970553474d,1,aBabiichuk,2015-11-12 14:58:57+02:00,['696e58bd869574f6c9b013360d2f32d5a9b883a4'],2,12,14,21267245,3,,,,20935
77e402ef71bad4522342688c2a9ab8ce55dca70a,1,aBabiichuk,2015-11-12 14:58:57+02:00,['4da648d4448a01361229f789457f3b970553474d'],8,17,25,21267270,7,0,1,1,20935
bffa4d3688b1ff537871f0b9915cd2e8d227460d,0,Alex Antonenko,2015-11-12 15:26:52+02:00,['77e402ef71bad4522342688c2a9ab8ce55dca70a'],19,18,37,21267307,3,0.25,0,0,20935
baccff832c7ad2d52c35e750b4c4d045c39b5abd,1,aBabiichuk,2015-11-12 15:38:36+02:00,['bffa4d3688b1ff537871f0b9915cd2e8d227460d'],1,1,2,21267309,1,,,,20935
14587d6eb23d7775427e01c49c3af1b9608ec3f8,1,Lisnichenko Dmitro,2015-11-12 18:59:10+02:00,['baccff832c7ad2d52c35e750b4c4d045c39b5abd'],0,50,50,21267359,9,,,,20935
14c13c1c6419c94a3e51da9cc592079e24f04067,1,Andrew Onishuk,2015-11-12 19:01:09+02:00,['14587d6eb23d7775427e01c49c3af1b9608ec3f8'],24,74,98,21267457,8,0,0.78,0.7,20935
0d203448bed3468aeb0ee703b97a1a3cb5ac03e5,0,Vitaly Brodetskyi,2015-11-12 19:01:55+02:00,['14c13c1c6419c94a3e51da9cc592079e24f04067'],16,22,38,21267495,6,0,0,0,20935
2ce7b6357b898f5fa3c5432d5efa9d95ca4d6fdc,1,Robert Levas,2015-11-12 12:43:58-05:00,['0d203448bed3468aeb0ee703b97a1a3cb5ac03e5'],161,204,365,21267860,42,0.081081081,1,1,20935
3083cdbab4ba03f2ae9f0b6fa02c63747dd82fa0,1,Siddharth Wagle,2015-11-12 10:42:35-08:00,['2ce7b6357b898f5fa3c5432d5efa9d95ca4d6fdc'],203,613,816,21268676,17,0,0.9296875,0.93359375,20936
d5ae6ae035d4dd634d0a42aa8066342d2aa256bc,1,Robert Levas,2015-11-12 13:53:25-05:00,['3083cdbab4ba03f2ae9f0b6fa02c63747dd82fa0'],3,54,57,21268733,2,0,0.945945946,0.945945946,20936
e94e3ff9e407efdb7695818473619c2919a1c29a,0,Jaimin Jetly,2015-11-12 11:10:39-08:00,['d5ae6ae035d4dd634d0a42aa8066342d2aa256bc'],7,15,22,21268755,4,0,0,0,20936
75c80346f2f79ee13b40213bfaf8f5d9010cb7c5,0,Jaimin Jetly,2015-11-12 11:21:43-08:00,['e94e3ff9e407efdb7695818473619c2919a1c29a'],8,0,8,21268763,1,1,1,1,20936
9108b522eb41d95a3664e4c4716d9df2fff4a947,1,Alejandro Fernandez,2015-11-12 11:23:06-08:00,['75c80346f2f79ee13b40213bfaf8f5d9010cb7c5'],0,1,1,21268764,1,,,,20936
8429a6a1d2f079f112929a0e21b34aac28c0c628,0,Jaimin Jetly,2015-11-12 11:33:28-08:00,['9108b522eb41d95a3664e4c4716d9df2fff4a947'],7,57,64,21268828,5,0.609756098,0.634146341,1,20936
7f725853f6e4282ef0710371c57d18d784998527,0,Alejandro Fernandez,2015-11-12 11:34:51-08:00,['8429a6a1d2f079f112929a0e21b34aac28c0c628'],43,153,196,21269024,9,0.55,0.55,0.333333333,20937
8fa73496a4c4c62bd5d45a734f5e38022160ca65,0,Jaimin Jetly,2015-11-12 11:54:09-08:00,['7f725853f6e4282ef0710371c57d18d784998527'],1,1,2,21269026,1,,,,20937
113f3712b25660e474009fac090c8ef0b304bf4e,1,Jonathan Hurley,2015-11-12 14:54:24-05:00,['8fa73496a4c4c62bd5d45a734f5e38022160ca65'],96,387,483,21269509,7,,,,20937
545ea7493a58f3190b29ee394f18a3f88499e6c9,1,Jun Aoki,2015-11-12 12:01:14-08:00,['113f3712b25660e474009fac090c8ef0b304bf4e'],1,4,5,21269514,1,1,0,1,20937
dd17417072e576edd9d86ba5772ba786c72f835e,1,Jun Aoki,2015-11-12 12:03:43-08:00,['545ea7493a58f3190b29ee394f18a3f88499e6c9'],9,12,21,21269535,3,1,1,1,20937
f6b6dfa6787787887be3bcee0dfff58c432461ba,0,Alejandro Fernandez,2015-11-12 13:27:06-08:00,['dd17417072e576edd9d86ba5772ba786c72f835e'],0,17,17,21269552,1,,,,20937
1bf80a6df756418504c6a2420f55450d26e53931,0,Richard Zang,2015-11-12 14:04:33-08:00,['f6b6dfa6787787887be3bcee0dfff58c432461ba'],1,1,2,21269554,1,,,,20937
8dc133502028dd4f402c1a4516a8325849c1d696,1,Xi Wang,2015-11-12 14:54:28-08:00,['1bf80a6df756418504c6a2420f55450d26e53931'],1,6,7,21269561,2,,,,20937
5d2b2a4adc8e47f502d81aa71191d5264a49f9ca,1,Siddharth Wagle,2015-11-12 22:43:55-08:00,['8dc133502028dd4f402c1a4516a8325849c1d696'],17,93,110,21269671,2,0,0.618181818,0.618181818,20937
0e990b9525f6d6b2f62b55cce340c1569b4120e4,1,aBabiichuk,2015-11-13 11:16:10+02:00,['5d2b2a4adc8e47f502d81aa71191d5264a49f9ca'],1,1,2,21269673,1,,,,20937
74a563bec01dae31a3746e74f350d02c04284edb,0,aBabiichuk,2015-11-13 11:24:46+02:00,['0e990b9525f6d6b2f62b55cce340c1569b4120e4'],2,2,4,21269677,2,,,,20937
99d9c26dcc949a1b622ec456cb821b664864de55,1,Oleg Nechiporenko,2015-11-13 12:06:18+02:00,['74a563bec01dae31a3746e74f350d02c04284edb'],572,1233,1805,21271482,18,1,1,0,20944
59ee076e6edba88a714343f6fccca8d46c13288b,1,Andrew Onishuk,2015-11-13 13:40:09+02:00,['99d9c26dcc949a1b622ec456cb821b664864de55'],25,35,60,21271542,2,0,0.111111111,0.111111111,20944
e85822db638c10a8c29e480fb48f24b51994d46a,1,Oleg Nechiporenko,2015-11-13 14:14:13+02:00,['59ee076e6edba88a714343f6fccca8d46c13288b'],6,6,12,21271554,3,1,0,0,20944
18e595aeb960c4cc08bc5d55f0d8c251d894bf5f,1,Andrii Tkach,2015-11-13 14:44:22+02:00,['e85822db638c10a8c29e480fb48f24b51994d46a'],105,648,753,21272307,12,0.421787709,0.980446927,1,20947
a05e5b6b55f400cbda163ceec385f07a4d670328,1,Andrew Onishuk,2015-11-13 14:47:58+02:00,['18e595aeb960c4cc08bc5d55f0d8c251d894bf5f'],0,40,40,21272347,3,0,0.833333333,1,20947
a2aa69ec183f1880deb91de8d7126db61dea1abf,1,Lisnichenko Dmitro,2015-11-13 14:51:26+02:00,['a05e5b6b55f400cbda163ceec385f07a4d670328'],5,121,126,21272473,8,0.382352941,0.5,0.617647059,20948
92720011524bcad716868d865debba8540dae6ae,1,Andrii Tkach,2015-11-13 16:16:33+02:00,['a2aa69ec183f1880deb91de8d7126db61dea1abf'],35,65,100,21272573,2,1,1,0,20948
2d03c6d00224eeb974416345c804bc0cbb732c46,0,Andrew Onishuk,2015-11-13 16:20:22+02:00,['92720011524bcad716868d865debba8540dae6ae'],51,0,51,21272624,2,,,,20948
77d0fc15880e286ccd147dd77a15641ef91d6fd3,0,Vitaly Brodetskyi,2015-11-13 16:42:25+02:00,['2d03c6d00224eeb974416345c804bc0cbb732c46'],0,6,6,21272630,1,0,0,0,20948
090905be3d2706e701d6f1a3455af37cd3982953,0,Andrew Onishuk,2015-11-13 17:19:35+02:00,['77d0fc15880e286ccd147dd77a15641ef91d6fd3'],0,1,1,21272631,1,,,,20948
52346faba7af51f326ff7c35f0942019fe6c137d,1,Dmytro Sen,2015-11-13 17:22:40+02:00,['090905be3d2706e701d6f1a3455af37cd3982953'],5,79,84,21272715,7,0,0.363636364,1,20948
9fae285c60f48489ed6a521d3c2c5742092fda25,1,Myroslav Papirkovskyi,2015-11-13 17:42:51+02:00,['52346faba7af51f326ff7c35f0942019fe6c137d'],18,51,69,21272784,5,0.875,0.9375,0.9375,20948
b6a3476c78588ba6d3841f495ca9b87dbe4418a6,1,Dmytro Sen,2015-11-13 18:05:14+02:00,['9fae285c60f48489ed6a521d3c2c5742092fda25'],3,11,14,21272798,2,1,1,1,20948
6929008bdf34c98ecaa65ab8d8b6dcb90a149196,1,Jaimin Jetly,2015-11-13 09:23:52-08:00,['b6a3476c78588ba6d3841f495ca9b87dbe4418a6'],1,7,8,21272806,1,0,0,1,20948
9319c67f94a7e61ba4da0cf52a92a3b72ea0cb2a,1,Dmytro Sen,2015-11-13 19:28:32+02:00,['6929008bdf34c98ecaa65ab8d8b6dcb90a149196'],1,323,324,21273130,8,0.23015873,0.96031746,1,20950
a75e81c310704b4af800132b274c10e12955fbb0,1,Lisnichenko Dmitro,2015-11-13 19:33:45+02:00,['9319c67f94a7e61ba4da0cf52a92a3b72ea0cb2a'],1,3,4,21273134,1,0,0,0,20950
04063cc56c3d6ade6dcaf571008bffc158d1fd50,1,Alex Antonenko,2015-11-13 20:33:48+02:00,['a75e81c310704b4af800132b274c10e12955fbb0'],2,2,4,21273138,2,,,,20950
68a31b28575a4179caae6c2dd2718f32019eef87,0,Alex Antonenko,2015-11-13 20:33:48+02:00,['04063cc56c3d6ade6dcaf571008bffc158d1fd50'],5,4,9,21273147,1,,,,20950
883c77f1f60b8e23113f854a69d5641247aa88b7,0,Alex Antonenko,2015-11-13 20:33:48+02:00,['68a31b28575a4179caae6c2dd2718f32019eef87'],85,3,88,21273235,1,0,0,0,20950
3a84d5f4a87b8de68685fdfde242e782c9e1e07f,0,Jayush Luniya,2015-11-13 11:23:15-08:00,['883c77f1f60b8e23113f854a69d5641247aa88b7'],9,9,18,21273253,1,1,1,0,20950
e39da458b75535b40f40875938286c09027fc854,1,Jonathan Hurley,2015-11-13 14:37:33-05:00,['3a84d5f4a87b8de68685fdfde242e782c9e1e07f'],27,30,57,21273310,3,,,,20950
19089fee46fed6e8808096769f8b5a4a8268e30f,1,Alejandro Fernandez,2015-11-13 11:41:23-08:00,['e39da458b75535b40f40875938286c09027fc854'],170,43,213,21273523,9,0.45,0.45,0.666666667,20950
46d71541866ed3fd28bea6b75bbfaa369d74acfd,1,Sumit Mohanty,2015-11-13 14:35:56-08:00,['19089fee46fed6e8808096769f8b5a4a8268e30f'],2,6,8,21273531,1,0,0,1,20950
aeac887af133834553355ef803a8ac59827795d1,1,Jayush Luniya,2015-11-13 15:01:50-08:00,['46d71541866ed3fd28bea6b75bbfaa369d74acfd'],5,117,122,21273653,4,0.379746835,0.53164557,1,20951
9196eb7a270f12b8b373843e78cf7370103aceeb,0,Jayush Luniya,2015-11-13 15:06:36-08:00,['aeac887af133834553355ef803a8ac59827795d1'],0,67,67,21273720,3,0.916666667,0.916666667,1,20953
29027ed75c0e1ce17aaa416d989e37551d2e5b16,1,Siddharth Wagle,2015-11-13 15:23:16-08:00,['9196eb7a270f12b8b373843e78cf7370103aceeb'],48,153,201,21273921,25,0.702702703,0.756756757,0.891891892,20954
4e237b495b48e8b97bbf3928b02d7ef4a5d15c9e,1,Siddharth Wagle,2015-11-13 15:25:31-08:00,['29027ed75c0e1ce17aaa416d989e37551d2e5b16'],1,1,2,21273923,1,,,,20954
686dcc57f6ffaef7f62ee6649438c97f021efcfc,1,Jayush Luniya,2015-11-13 15:26:49-08:00,['4e237b495b48e8b97bbf3928b02d7ef4a5d15c9e'],613,203,816,21274739,17,1,0.0703125,0.06640625,20954
d626d0c1ae1b015384699f3fb21c1ed5e60689c6,1,Jayush Luniya,2015-11-13 16:03:20-08:00,['686dcc57f6ffaef7f62ee6649438c97f021efcfc'],9,9,18,21274757,1,0,0,1,20954
15cc90c0e7227f7fe3d42427b06dc1ebfab1d093,1,Sumit Mohanty,2015-11-14 08:23:32-08:00,['d626d0c1ae1b015384699f3fb21c1ed5e60689c6'],0,3,3,21274760,2,0,1,1,20954
66e90bcfa5a8298bf617973f3fa43fabd30ca32a,0,Sumit Mohanty,2015-11-15 17:26:09-08:00,['15cc90c0e7227f7fe3d42427b06dc1ebfab1d093'],51,1,52,21274812,2,,,,20954
cacbb5532611131ebdc6f8ca4bc6a71d6998f7db,0,Sumit Mohanty,2015-11-15 20:37:20-08:00,['66e90bcfa5a8298bf617973f3fa43fabd30ca32a'],123,8,131,21274943,12,1,0.166666667,0.166666667,20954
888c8b2af88f004624df60f11c6ee2c6e52b6a69,0,Jayush Luniya,2015-11-16 01:21:57-08:00,['cacbb5532611131ebdc6f8ca4bc6a71d6998f7db'],0,2,2,21274945,1,,,,20954
d71f17d4eb3073a7cc1d398e98ba1bc75e44fa09,1,Andrew Onishuk,2015-11-16 12:37:15+02:00,['888c8b2af88f004624df60f11c6ee2c6e52b6a69'],0,24,24,21274969,2,0.4375,0.9375,0.5,20954
92f5d07b47330ddfa20c57a19204009b39ae144f,1,Lisnichenko Dmitro,2015-11-16 13:40:24+02:00,['d71f17d4eb3073a7cc1d398e98ba1bc75e44fa09'],32,85,117,21275086,8,0,1,1,20954
627e40bf43b277a0c0756069f28c541d1df3ee81,1,Dmytro Sen,2015-11-16 14:33:35+02:00,['92f5d07b47330ddfa20c57a19204009b39ae144f'],14,32,46,21275132,9,0,0,0.5,20954
af52444f7d07d44de85df4f4d32d7c8980262775,1,Alex Antonenko,2015-11-16 16:03:11+02:00,['627e40bf43b277a0c0756069f28c541d1df3ee81'],6,21,27,21275159,5,1,1,1,20954
5a98a3f954b66672fab2ab030f94eec55b865589,0,aBabiichuk,2015-11-16 17:22:42+02:00,['af52444f7d07d44de85df4f4d32d7c8980262775'],0,33,33,21275192,2,1,1,1,20954
9395f20598c4047f9033a24f5f18e2f3656a323d,0,Yusaku Sako,2015-11-17 02:46:10+09:00,['5a98a3f954b66672fab2ab030f94eec55b865589'],2,2,4,21275196,2,,,,20954
120021cdf6e3585101b23c9fa5019d1185b84749,1,Andrew Onishuk,2015-11-16 20:26:52+02:00,['9395f20598c4047f9033a24f5f18e2f3656a323d'],68,195,263,21275459,19,,,,20958
313bd0d7e1464d9dc45d0544f8c8da15882f7367,1,Jaimin Jetly,2015-11-16 11:27:03-08:00,['120021cdf6e3585101b23c9fa5019d1185b84749'],35,56,91,21275550,5,0,0.384615385,0.384615385,20958
364cee5972d4b55a7990cf60a9dca7e9cca5762a,1,Xi Wang,2015-11-16 12:40:18-08:00,['313bd0d7e1464d9dc45d0544f8c8da15882f7367'],177,194,371,21275921,3,1,1,1,20958
5d35c6db7c3e7aac7aa870d392a414814003f9f9,0,Alejandro Fernandez,2015-11-16 14:07:17-08:00,['364cee5972d4b55a7990cf60a9dca7e9cca5762a'],0,119,119,21276040,3,1,1,0.741935484,20960
946fe25019b9bcc4e2522126d01f16111c939418,1,Xi Wang,2015-11-16 14:37:08-08:00,['5d35c6db7c3e7aac7aa870d392a414814003f9f9'],1,1,2,21276042,1,,,,20960
b6b812c1199278e252df95b1a9a2604d8ec61b9a,1,Jaimin Jetly,2015-11-16 14:53:51-08:00,['946fe25019b9bcc4e2522126d01f16111c939418'],3,85,88,21276130,1,1,1,1,20960
696b4399bc1db774b63d23d8e47ebdb53bd057c9,1,Jayush Luniya,2015-11-16 15:23:09-08:00,['b6b812c1199278e252df95b1a9a2604d8ec61b9a'],16,41,57,21276187,2,0.368421053,1,1,20960
4892c9bf5fc77ced4996850b759b8212691b8b6b,1,Jayush Luniya,2015-11-16 15:31:47-08:00,['696b4399bc1db774b63d23d8e47ebdb53bd057c9'],0,84,84,21276271,2,0.015625,1,1,20960
2d82360b1428da13379118a2f75f618a6beea9ca,1,Siddharth Wagle,2015-11-16 15:34:29-08:00,['4892c9bf5fc77ced4996850b759b8212691b8b6b'],217,626,843,21277114,16,0,0.9296875,0.93359375,20961
004e4f98e7d20dbecdd31a7b889f55bfd1008897,1,Jonathan Hurley,2015-11-16 19:19:07-05:00,['2d82360b1428da13379118a2f75f618a6beea9ca'],13,86,99,21277213,2,0,0.918367347,1,20961
55d0b18448542868d4f94abd388a46025d87ffbd,1,Alejandro Fernandez,2015-11-16 17:23:28-08:00,['004e4f98e7d20dbecdd31a7b889f55bfd1008897'],7,88,95,21277308,5,0.352941176,0.882352941,1,20961
644d8ba4bb654bd6c8cdaafc4f906bfae7b0a523,1,Alejandro Fernandez,2015-11-16 17:26:49-08:00,['55d0b18448542868d4f94abd388a46025d87ffbd'],24,31,55,21277363,6,0.25,0,0,20961
819e4e7998c0ddf7003281b69e2b1c6101672883,1,Alejandro Fernandez,2015-11-16 18:29:02-08:00,['644d8ba4bb654bd6c8cdaafc4f906bfae7b0a523'],60,155,215,21277578,12,0.27027027,0.27027027,0.243243243,20962
b5ad10adcb1626162ccf64e67f8ee87140c3f8d1,1,Alejandro Fernandez,2015-11-16 18:38:53-08:00,['819e4e7998c0ddf7003281b69e2b1c6101672883'],0,15,15,21277593,2,,,,20962
6e69ef00d39e5d803832d4f74aed9ba3e41bbeca,1,Sumit Mohanty,2015-11-16 18:55:36-08:00,['b5ad10adcb1626162ccf64e67f8ee87140c3f8d1'],0,7,7,21277600,2,0,1,1,20962
ccdb1556fdab62209f119a48f020459a8afe58ad,1,Gautam Borad,2015-11-17 13:34:44+05:18,['6e69ef00d39e5d803832d4f74aed9ba3e41bbeca'],15,232,247,21277847,13,0.019047619,0.219047619,0.019047619,20963
f52dceb1882754d71836877167dda61b209ddb03,1,Lisnichenko Dmitro,2015-11-17 12:42:12+02:00,['ccdb1556fdab62209f119a48f020459a8afe58ad'],0,6,6,21277853,1,,,,20963
bc4e41d30829e536b8ba6e47e7a86bfc386d53f6,1,Aleksandr Kovalenko,2015-11-17 14:10:54+02:00,['f52dceb1882754d71836877167dda61b209ddb03'],12,138,150,21278003,9,0.421568627,1,1,20963
e89233e7d3044169273d6ddd3ae79290190b6c55,0,Lisnichenko Dmitro,2015-11-17 16:35:57+02:00,['bc4e41d30829e536b8ba6e47e7a86bfc386d53f6'],1,1,2,21278005,1,,,,20963
bb371da605d766dd4a026778e1c0e40f27600b46,1,Lisnichenko Dmitro,2015-11-17 18:07:40+02:00,['e89233e7d3044169273d6ddd3ae79290190b6c55'],0,37,37,21278042,3,0,0.470588235,0.705882353,20963
69db84a6848f7d1c75b3cc0d90f61cd1c352aa19,1,Jaimin Jetly,2015-11-17 09:01:14-08:00,['bb371da605d766dd4a026778e1c0e40f27600b46'],1,50,51,21278093,3,1,1,1,20964
ed2d58a6b051e4a465cc79bfece96dd8e7daf0e4,1,Dmytro Sen,2015-11-17 19:07:18+02:00,['69db84a6848f7d1c75b3cc0d90f61cd1c352aa19'],1,289,290,21278383,6,0.08839779,0.994475138,0.917127072,20964
836ad328cde61de996fcb10e3f67ecec2b7a36af,1,Siddharth Wagle,2015-11-17 10:22:38-08:00,['ed2d58a6b051e4a465cc79bfece96dd8e7daf0e4'],79,147,226,21278609,5,0.542857143,1,1,20964
e32482997640a03d5dc7b4e6d03d1e317d95d20e,1,Jonathan Hurley,2015-11-17 13:38:40-05:00,['836ad328cde61de996fcb10e3f67ecec2b7a36af'],29,15,44,21278653,3,,,,20964
27cbe86a68b25f655737a158b8990627ffed5322,1,Alex Antonenko,2015-11-17 21:02:36+02:00,['e32482997640a03d5dc7b4e6d03d1e317d95d20e'],26,76,102,21278755,7,1,1,1,20965
21733026c76850a7211fcd7d5095c8bbd9db5979,1,Vitaly Brodetskyi,2015-11-17 18:06:45+02:00,['27cbe86a68b25f655737a158b8990627ffed5322'],1,1,2,21278757,1,,,,20965
09c9134793dcb1ec1691f2ca38147519b28f61f0,1,Robert Levas,2015-11-17 15:16:00-05:00,['21733026c76850a7211fcd7d5095c8bbd9db5979'],4,1055,1059,21279816,13,0.314977974,0.742290749,0.870044053,20969
6212d9d657fbd832e7cde4f3a1734397c33064f3,1,Alejandro Fernandez,2015-11-17 13:02:17-08:00,['09c9134793dcb1ec1691f2ca38147519b28f61f0'],14,124,138,21279954,5,0,0,0.657894737,20969
82a53982fddca70c5593ab6d74760805d05f9eaa,0,Siddharth Wagle,2015-11-17 13:57:07-08:00,['6212d9d657fbd832e7cde4f3a1734397c33064f3'],0,1,1,21279955,1,0,0,1,20969
6ddab1b01a2a4b87ef50f6ec021036f44ac55229,1,Siddharth Wagle,2015-11-17 14:59:24-08:00,['82a53982fddca70c5593ab6d74760805d05f9eaa'],10,19,29,21279984,20,,,,20969
edae7bd5c3c6afeb6c4facddc2c9124268379baa,0,Xi Wang,2015-11-17 16:34:55-08:00,['6ddab1b01a2a4b87ef50f6ec021036f44ac55229'],2,6,8,21279992,1,,,,20969
7c271fb8a5520438a7b3382850ad5ad8fb96e2c7,0,Sumit Mohanty,2015-11-17 17:18:58-08:00,['edae7bd5c3c6afeb6c4facddc2c9124268379baa'],1,10,11,21280003,2,,,,20969
137e665a67a46ad0bd85cde8c501594c5e30fa4e,0,Sumit Mohanty,2015-11-17 17:41:56-08:00,['7c271fb8a5520438a7b3382850ad5ad8fb96e2c7'],10,1,11,21280014,2,,,,20969
e383cf9f9a380ddf6e78ffeadaf9e25dae3b3793,1,Oleg Nechiporenko,2015-11-18 11:46:53+02:00,['137e665a67a46ad0bd85cde8c501594c5e30fa4e'],0,1,1,21280015,1,1,0,1,20969
6db7de9f3a10dc97531866fa8e2ce666568d61e4,1,Andrew Onishuk,2015-11-18 12:03:30+02:00,['e383cf9f9a380ddf6e78ffeadaf9e25dae3b3793'],7,19,26,21280041,2,0,0,0,20969
15ffc016c0beafd59c0db3208042c9a367d43230,0,Oleg Nechiporenko,2015-11-18 12:22:05+02:00,['6db7de9f3a10dc97531866fa8e2ce666568d61e4'],31,1016,1047,21281088,5,1,1,0.967791411,20971
31c99869f341dec5c9b7821dcd5c5a9247f27ada,1,Andrii Tkach,2015-11-18 13:54:16+02:00,['15ffc016c0beafd59c0db3208042c9a367d43230'],7,77,84,21281172,4,0.626666667,1,1,20971
0fdf876ce2abdf5d753af8422e034171d669e240,1,aBabiichuk,2015-11-18 15:05:38+02:00,['31c99869f341dec5c9b7821dcd5c5a9247f27ada'],37,578,615,21281787,148,0.0625,0.625,0.5625,20971
8769f4187e7e56c2bd23ea722fae0255c8697908,1,Dmytro Sen,2015-11-18 15:42:59+02:00,['0fdf876ce2abdf5d753af8422e034171d669e240'],2,1521,1523,21283310,7,0.032154341,0.887459807,1,20973
7031576d252e27c268b5b873f57452350d08251c,0,Oleg Nechiporenko,2015-11-18 16:41:07+02:00,['8769f4187e7e56c2bd23ea722fae0255c8697908'],1,3,4,21283314,1,1,0,1,20973
4ffa82967a657fad1919a3fe6ed4f6dd8b77099a,0,Aleksandr Kovalenko,2015-11-18 17:49:19+02:00,['7031576d252e27c268b5b873f57452350d08251c'],8,2,10,21283324,1,1,1,0,20973
0959b6099ba6bbbc6a554b92e416d5d93d4ac0c4,0,Lisnichenko Dmitro,2015-11-18 17:58:15+02:00,['4ffa82967a657fad1919a3fe6ed4f6dd8b77099a'],1,5,6,21283330,1,0,0,0,20973
5b67afe55f8cdbfb33a81db22fc9e156a0c62f53,1,Alex Antonenko,2015-11-18 18:21:17+02:00,['0959b6099ba6bbbc6a554b92e416d5d93d4ac0c4'],8,10,18,21283348,4,,,,20973
70597274696e6162b50588128d57a73a28c1f52d,1,Oleg Nechiporenko,2015-11-18 18:35:29+02:00,['5b67afe55f8cdbfb33a81db22fc9e156a0c62f53'],152,53,205,21283553,26,0,0,0,20973
177a91f405b2cfd74bfa740c38fc643bde56049e,1,Oleg Nechiporenko,2015-11-18 18:37:05+02:00,['70597274696e6162b50588128d57a73a28c1f52d'],515,176,691,21284244,75,0,0,0.026465028,20973
779b4f9d51fe3a0e523e5577477209e05f84b52d,1,Oleg Nechiporenko,2015-11-18 18:38:44+02:00,['177a91f405b2cfd74bfa740c38fc643bde56049e'],286,142,428,21284672,35,0,0,0,20973
47a1bcfea42900076d9791575a3b75a7eeb29ab6,0,Nate Cole,2015-11-18 11:50:22-05:00,"['fefcdf5db65d07c2f755e40d89823ad799fc6c30', '779b4f9d51fe3a0e523e5577477209e05f84b52d']",8343,29138,37481,21322153,1023,,,,20973
6e7c75bb006eb7a207b404304a14f24fd0676a52,0,Alex Antonenko,2015-11-18 19:08:50+02:00,['779b4f9d51fe3a0e523e5577477209e05f84b52d'],3,5,8,21322161,2,,,,20973
58b598a5b453e31a30101b27a25f8e18b52c2083,1,Dmytro Sen,2015-11-18 19:54:30+02:00,['6e7c75bb006eb7a207b404304a14f24fd0676a52'],58,87,145,21322306,9,0,0,1,20973
d08107d70a71932a92fb9b7dc0b7652f0c365be7,1,Robert Levas,2015-11-18 13:42:58-05:00,['58b598a5b453e31a30101b27a25f8e18b52c2083'],341,2716,3057,21325363,20,0.300639659,0.991471215,1,20979
f90c2b04357b4ab0e3e704438f8e8f921a5ed97f,1,Myroslav Papirkovskyi,2015-11-18 21:25:05+02:00,['d08107d70a71932a92fb9b7dc0b7652f0c365be7'],16,78,94,21325457,6,0.848484848,0.878787879,0.909090909,20979
a63b73f2d219de0aab7281abe3497aa822e98ac1,0,Richard Zang,2015-11-18 11:35:38-08:00,['f90c2b04357b4ab0e3e704438f8e8f921a5ed97f'],0,1,1,21325458,1,1,1,1,20979
851b662b748aac2e46e3a8f5dc1af15e0de716bf,0,Jayush Luniya,2015-11-18 11:48:50-08:00,['a63b73f2d219de0aab7281abe3497aa822e98ac1'],2,18,20,21325478,3,0,0.545454545,1,20979
d05e05ced090d6ca7e576908afc199ade450aa00,0,Oleksandr Diachenko,2015-11-18 12:05:13-08:00,['851b662b748aac2e46e3a8f5dc1af15e0de716bf'],2,2,4,21325482,2,,,,20979
73eb6b2c8da2800239f6c7dfb59f003b03378910,0,Siddharth Wagle,2015-11-18 12:50:48-08:00,['d05e05ced090d6ca7e576908afc199ade450aa00'],1,16,17,21325499,2,,,,20979
285111f36f542a7af50ea7baff00c767925013de,0,Sumit Mohanty,2015-11-18 13:04:29-08:00,['73eb6b2c8da2800239f6c7dfb59f003b03378910'],1,1,2,21325501,1,,,,20979
344ed725182c2094f00ce4153515467ddcb52cc0,1,Alejandro Fernandez,2015-11-18 13:06:19-08:00,['285111f36f542a7af50ea7baff00c767925013de'],20,25,45,21325546,3,1,1,1,20979
d078af8cba9c99750ed2e049d9af5aaa69a2b73c,0,Jaimin Jetly,2015-11-18 13:16:56-08:00,['344ed725182c2094f00ce4153515467ddcb52cc0'],25,2,27,21325573,2,,,,20979
317f49b64a62279a1b160aa1d944bf0c97f3462b,1,Myroslav Papirkovskyi,2015-11-18 23:17:35+02:00,['d078af8cba9c99750ed2e049d9af5aaa69a2b73c'],6,142,148,21325721,2,0,0.85,0.15,20979
63dab04d1ada4edc254e4ec3c18f95fbe36a016c,1,Siddharth Wagle,2015-11-18 13:23:18-08:00,['317f49b64a62279a1b160aa1d944bf0c97f3462b'],21,119,140,21325861,7,0.134328358,0,0.865671642,20979
499167caa323f87f4f358f3d1bc17b6d86cf6253,1,Siddharth Wagle,2015-11-18 13:41:22-08:00,['63dab04d1ada4edc254e4ec3c18f95fbe36a016c'],1,3,4,21325865,1,0,0,1,20979
396e8725a3d3232a6672c65f9c3829ec6ddbf3b6,0,Sumit Mohanty,2015-11-18 16:00:48-08:00,['499167caa323f87f4f358f3d1bc17b6d86cf6253'],0,2,2,21325867,1,,,,20979
d5f2853df4a89ad66ea50d3e360781ff28896cdd,1,Andrew Onishuk,2015-11-19 13:05:42+02:00,['396e8725a3d3232a6672c65f9c3829ec6ddbf3b6'],47,58,105,21325972,5,0,1,1,20979
5334953e1f36f9ab0d760c5c1319a82876b0b486,1,Oleg Nechiporenko,2015-11-19 17:26:21+02:00,['d5f2853df4a89ad66ea50d3e360781ff28896cdd'],19,426,445,21326417,4,0.947712418,1,0.980392157,20979
6a13ed85a5026db6b27316410620f05d5646c225,0,Sumit Mohanty,2015-11-19 07:31:14-08:00,['5334953e1f36f9ab0d760c5c1319a82876b0b486'],1,1,2,21326419,1,,,,20979
23919c184409683b0ff4165304ceb4d756c06fda,0,Andrew Onishuk,2015-11-19 17:33:57+02:00,['6a13ed85a5026db6b27316410620f05d5646c225'],8,0,8,21326427,5,1,0.125,0.125,20979
7603d3ff5b4df29b81d5e320ffe6f5424cbd0c57,1,Dmytro Sen,2015-11-19 18:36:57+02:00,['23919c184409683b0ff4165304ceb4d756c06fda'],3,5,8,21326435,2,0,1,1,20979
9331012bc0fe83ee453032c2ae2d8dba8c2f1ddd,1,Lisnichenko Dmitro,2015-11-19 19:43:35+02:00,['7603d3ff5b4df29b81d5e320ffe6f5424cbd0c57'],3,70,73,21326508,4,0.2,0.28,1,20979
58f5b678920fbb92476a0de1a734d2f5e55696e6,1,Lisnichenko Dmitro,2015-11-19 20:22:15+02:00,['9331012bc0fe83ee453032c2ae2d8dba8c2f1ddd'],0,38,38,21326546,2,0.095238095,1,0,20979
4a83215b58226454b29df4409e1fb4f536949bfa,0,Alex Antonenko,2015-11-19 20:28:49+02:00,['58f5b678920fbb92476a0de1a734d2f5e55696e6'],3,2,5,21326551,1,,,,20979
d6201d4f713bb23846042c6cd57f8303a454f591,0,Vitaly Brodetskyi,2015-11-19 17:53:08+02:00,['4a83215b58226454b29df4409e1fb4f536949bfa'],0,14,14,21326565,8,0,0.928571429,1,20979
e146aa2ba4455347904775e952d715bd78fdfb03,1,Jonathan Hurley,2015-11-19 14:39:22-05:00,['d6201d4f713bb23846042c6cd57f8303a454f591'],3,66,69,21326634,2,0.897435897,0.923076923,0.128205128,20979
eac8a0ce54099aad24d2baed0a2e4c3fb02d0e0e,1,Jaimin Jetly,2015-11-19 11:58:22-08:00,['e146aa2ba4455347904775e952d715bd78fdfb03'],20,110,130,21326764,18,0.558139535,0.953488372,1,20979
15a7f1c62011aed516f9b8b35e9e73ba210198cf,1,Sumit Mohanty,2015-11-19 14:50:26-08:00,['eac8a0ce54099aad24d2baed0a2e4c3fb02d0e0e'],99,109,208,21326972,3,0,1,1,20980
e8cc76e6e3546f6ac769e29c7345359c6b1c17e8,1,Richard Zang,2015-11-19 15:06:32-08:00,['15a7f1c62011aed516f9b8b35e9e73ba210198cf'],2,122,124,21327096,3,0.48,1,1,20980
f3e5523c7d2dc9d11cdf189ae3b2b347cacb7bed,1,Robert Levas,2015-11-19 18:51:52-05:00,['e8cc76e6e3546f6ac769e29c7345359c6b1c17e8'],3,25,28,21327124,8,0,0.933333333,0.866666667,20980
b7a32bdc7700aab63f9110afbe5b1e94dbf79538,0,Oleksandr Diachenko,2015-11-19 15:57:52-08:00,['f3e5523c7d2dc9d11cdf189ae3b2b347cacb7bed'],10,26,36,21327160,3,,,,20980
765e68b258864f202a8a00ac770ba8223dc006d5,1,Richard Zang,2015-11-19 17:00:38-08:00,['b7a32bdc7700aab63f9110afbe5b1e94dbf79538'],28,306,334,21327494,14,0.644444444,1,0.851851852,20982
15b12bc714bd47377c594bd2f7d382e8308ccfa4,1,Siddharth Wagle,2015-11-19 17:12:25-08:00,['765e68b258864f202a8a00ac770ba8223dc006d5'],38,50,88,21327582,1,0,0,0,20982
3d3af0bce733a13b81c6c3752648e110f976c441,0,Alejandro Fernandez,2015-11-19 17:29:28-08:00,['15b12bc714bd47377c594bd2f7d382e8308ccfa4'],2,51,53,21327635,2,1,1,1,20982
0416bead4ccc5fee2f9eda79af7e8bf872f4a7ab,1,Sumit Mohanty,2015-11-19 17:39:49-08:00,['3d3af0bce733a13b81c6c3752648e110f976c441'],0,16,16,21327651,2,1,1,1,20982
f0ae4198601a2f1e843ecf152cc47c756a361a5e,0,Sumit Mohanty,2015-11-19 18:51:21-08:00,['0416bead4ccc5fee2f9eda79af7e8bf872f4a7ab'],0,0,0,21327651,1,,,,20982
0a5c9da1dde1836cda3e7fd62f81552de7fa2e8f,1,Jonathan Hurley,2015-11-19 23:17:25-05:00,['f0ae4198601a2f1e843ecf152cc47c756a361a5e'],625,510,1135,21328786,15,0.074324324,0.074324324,0.074324324,20983
d48a9b6851928d054bb2063160811f69f4ccad7f,1,Dmytro Sen,2015-11-20 11:33:00+02:00,['0a5c9da1dde1836cda3e7fd62f81552de7fa2e8f'],51,395,446,21329232,15,0.175531915,0.696808511,0.808510638,20985
ef89fb85cc217fea0d237f815500ebe49e954b3f,1,Lisnichenko Dmitro,2015-11-20 12:50:52+02:00,['d48a9b6851928d054bb2063160811f69f4ccad7f'],0,12,12,21329244,1,,,,20985
3a65b4723fc8fc5229f9e3d90b77d7ea4fc270ef,1,Aleksandr Kovalenko,2015-11-20 13:21:08+02:00,['ef89fb85cc217fea0d237f815500ebe49e954b3f'],0,178,178,21329422,5,0.627906977,1,1,20985
65d1b4125d2f5a9bdba726e50eb37bd726bcdef6,0,Oleg Nechiporenko,2015-11-20 13:40:41+02:00,['3a65b4723fc8fc5229f9e3d90b77d7ea4fc270ef'],1,1,2,21329424,1,,,,20985
0d93e93144d0e9051d49a70d3f9edbef499dde01,0,Myroslav Papirkovskyy,2015-11-20 14:37:56+02:00,['65d1b4125d2f5a9bdba726e50eb37bd726bcdef6'],2,6,8,21329432,1,,,,20985
45fe1f07108283ced28d5319234263668f0d9175,1,Alex Antonenko,2015-11-20 15:13:27+02:00,['0d93e93144d0e9051d49a70d3f9edbef499dde01'],2,82,84,21329516,2,0.483870968,1,1,20985
aec920c390718b0ace19a9055656ea69fc01175d,1,Robert Levas,2015-11-20 08:36:55-05:00,['45fe1f07108283ced28d5319234263668f0d9175'],111,1216,1327,21330843,31,0.602941176,0.867647059,0.794117647,20989
9de11b0d6e2d7a1d6e249bba2625590288655967,1,Andrii Tkach,2015-11-20 15:46:05+02:00,['aec920c390718b0ace19a9055656ea69fc01175d'],10,19,29,21330872,3,0,1,1,20989
ef208aaac1bd5b3919297012308986262ac6dc88,1,aBabiichuk,2015-11-20 16:22:45+02:00,['9de11b0d6e2d7a1d6e249bba2625590288655967'],1125,255,1380,21332252,33,0.272463768,0.046376812,0.011594203,20989
397ddb59652ee8b5cf4be0d7c3e761a6679e0831,1,Vitaly Brodetskyi,2015-11-20 13:29:23+02:00,['ef208aaac1bd5b3919297012308986262ac6dc88'],4,4,8,21332260,2,,,,20989
cd39cde2985468e9d43f7821b81e6849876d1d20,1,Dmytro Sen,2015-11-20 16:42:28+02:00,['397ddb59652ee8b5cf4be0d7c3e761a6679e0831'],1,2,3,21332263,1,,,,20989
d8e97b17210a79c82ffe00abd67c0c829027951f,1,Bob Nettleton,2015-11-20 10:41:47-05:00,['cd39cde2985468e9d43f7821b81e6849876d1d20'],33,474,507,21332770,5,0.775510204,1,0.952380952,20992
c6e946f052bf77c6af36bc5f7a4dde2b08cb0e71,1,Dmytro Sen,2015-11-20 18:49:35+02:00,['d8e97b17210a79c82ffe00abd67c0c829027951f'],9,32,41,21332811,3,0.032258065,1,1,20992
2d18d2df97b7bb66f678cd959e329bf97e1e69ab,1,Myroslav Papirkovskyi,2015-11-20 21:47:55+02:00,['c6e946f052bf77c6af36bc5f7a4dde2b08cb0e71'],5,9,14,21332825,5,0,0,0,20992
aa1389dede76127707de92aca3fad3c0808390c9,0,Jaimin Jetly,2015-11-20 14:04:34-08:00,['2d18d2df97b7bb66f678cd959e329bf97e1e69ab'],0,88,88,21332913,6,,,,20992
44ea03d127a5fa770760c8178b6fe60ef322b512,0,Xi Wang,2015-11-20 14:55:42-08:00,['aa1389dede76127707de92aca3fad3c0808390c9'],1,1,2,21332915,1,1,1,1,20992
a797349de75c89966fab119f91adf2dd64181937,1,Jayush Luniya,2015-11-20 16:18:52-08:00,['44ea03d127a5fa770760c8178b6fe60ef322b512'],10,9,19,21332934,1,,,,20992
1ded3fde68701975d5ce51c7fc52ae3c099c82dc,0,Jaimin Jetly,2015-11-20 16:19:38-08:00,['a797349de75c89966fab119f91adf2dd64181937'],1,2,3,21332937,1,,,,20992
f94d41d3a532a6bcab6730283fff3c398644464e,1,Alex Antonenko,2015-11-21 03:49:10+02:00,['1ded3fde68701975d5ce51c7fc52ae3c099c82dc'],39,75,114,21333051,3,1,1,1,20992
e8e6c74f47c8fad301dd921eeb3dc163c40008d8,1,Alex Antonenko,2015-11-21 03:49:10+02:00,['f94d41d3a532a6bcab6730283fff3c398644464e'],0,1,1,21333052,1,1,1,1,20992
2fd574039acbc2b182d91be62e7e2da6fbe37d9c,1,Andrew Onishuk,2015-11-21 18:06:11+02:00,['e8e6c74f47c8fad301dd921eeb3dc163c40008d8'],28,13,41,21333093,5,,,,20992
fa2f120e87d309abc2ede5bcf0afb3a596ede517,1,Gautam Borad,2015-11-21 22:27:16+05:18,['2fd574039acbc2b182d91be62e7e2da6fbe37d9c'],1,80,81,21333174,3,,,,20992
45bb354c771e6438158a1475a4f987d5a5553f09,0,Robert Levas,2015-11-21 15:06:27-05:00,['fa2f120e87d309abc2ede5bcf0afb3a596ede517'],0,247,247,21333421,10,0,0.941860465,1,20992
033b74632c768389fed9e7a13a93c94d8c756da2,1,Andrew Onishuk,2015-11-22 18:05:57+02:00,['45bb354c771e6438158a1475a4f987d5a5553f09'],49,51,100,21333521,45,0,1,1,20992
8ce995ac025d673430ccfe5667aeab586e03567b,1,Robert Levas,2015-11-22 11:44:23-05:00,['033b74632c768389fed9e7a13a93c94d8c756da2'],89,654,743,21334264,10,0.034782609,0.892753623,0.884057971,20994
6c53c254d1b984e6f4003f2769211e341c2f4459,1,Sumit Mohanty,2015-11-22 17:58:10-08:00,['8ce995ac025d673430ccfe5667aeab586e03567b'],11,40,51,21334315,9,0,0.666666667,0.933333333,20994
3b1e5c5d8ead67622f48ef010cbeace397e08526,1,Jaimin Jetly,2015-11-22 19:26:39-08:00,['6c53c254d1b984e6f4003f2769211e341c2f4459'],26,60,86,21334401,4,1,1,1,20994
d750b960a697eeb24204f67b745039f7f95bea87,1,Siddharth Wagle,2015-11-22 21:32:51-08:00,['3b1e5c5d8ead67622f48ef010cbeace397e08526'],41,283,324,21334725,15,0.406015038,0.616541353,0.330827068,20996
0b950d306628349b5600939893ef869db8615f89,1,Jaimin Jetly,2015-11-22 23:27:54-08:00,['d750b960a697eeb24204f67b745039f7f95bea87'],3,64,67,21334792,3,1,1,0.975,20996
c71a1016dea73f400bcc7529f18666f8622ab30e,0,Gautam Borad,2015-11-23 13:03:06+05:18,['0b950d306628349b5600939893ef869db8615f89'],0,16,16,21334808,2,,,,20996
b639de0383304077daf0ae192bc705002dee527d,0,Alex Antonenko,2015-11-23 14:49:17+02:00,['c71a1016dea73f400bcc7529f18666f8622ab30e'],6,6,12,21334820,1,1,1,1,20996
2b539ef17d21c42690a3c98bf9e3198d31354b50,1,Andrew Onishuk,2015-11-23 17:04:28+02:00,['b639de0383304077daf0ae192bc705002dee527d'],67,200,267,21335087,18,0.456140351,1,0.807017544,20997
8e7eb7d1739b85d3b3c75538019578492d85d3c5,1,Andrew Onishuk,2015-11-23 17:32:39+02:00,['2b539ef17d21c42690a3c98bf9e3198d31354b50'],11,68,79,21335166,5,0.387096774,0.387096774,0.193548387,20997
2f94036e90014f1d4d2a6484565cbe50e81db736,1,Lisnichenko Dmitro,2015-11-23 17:41:34+02:00,['8e7eb7d1739b85d3b3c75538019578492d85d3c5'],8,6,14,21335180,1,,,1,20997
bd2bf2543337387d19c844c6f198e5839be7e1ac,1,aBabiichuk,2015-11-23 18:01:19+02:00,['2f94036e90014f1d4d2a6484565cbe50e81db736'],38,56,94,21335274,2,1,1,0,20997
4b20e5c1ade0e70b6027c92737af476af77ada65,0,Andrew Onishuk,2015-11-23 19:20:03+02:00,['bd2bf2543337387d19c844c6f198e5839be7e1ac'],3,3,6,21335280,2,,,,20997
b26aa4ad22b8dd14feb850d6d2e1d5cc4c54b010,0,aBabiichuk,2015-11-23 19:24:59+02:00,['4b20e5c1ade0e70b6027c92737af476af77ada65'],1,3,4,21335284,1,0,1,1,20997
e1584720b499979a948fc2c4348ca4c4d8c21a97,1,Jaimin Jetly,2015-11-23 14:16:00-08:00,['b26aa4ad22b8dd14feb850d6d2e1d5cc4c54b010'],4,9,13,21335297,2,,,,20997
7d45f1f71f9b569d3d541ebb7cbd6b79bfd8fdb4,1,Robert Levas,2015-11-23 18:57:44-05:00,['e1584720b499979a948fc2c4348ca4c4d8c21a97'],982,2157,3139,21338436,23,0.649526387,0.914749662,0.948579161,20998
bf82dfe69e44ed0b87105a99dfef7ac533c9e6b4,0,Jaimin Jetly,2015-11-23 16:14:07-08:00,['7d45f1f71f9b569d3d541ebb7cbd6b79bfd8fdb4'],5,13,18,21338454,2,1,1,1,20998
bbf95144cd5bef938413dd87f8dcf970e79429ec,1,Siddharth Wagle,2015-11-23 22:06:43-08:00,['bf82dfe69e44ed0b87105a99dfef7ac533c9e6b4'],5,23,28,21338482,1,0.2,0,1,20998
702f832a2743950c3ed9da05eefdfe3ea686619d,1,Alex Antonenko,2015-11-24 10:20:07+02:00,['bbf95144cd5bef938413dd87f8dcf970e79429ec'],9,90,99,21338581,2,0.152777778,1,0.944444444,20998
bd1b743cf404d6c9e3d67b4ebaca4de7d332300b,1,Dmytro Sen,2015-11-24 10:58:21+02:00,['702f832a2743950c3ed9da05eefdfe3ea686619d'],7,37,44,21338625,2,0,0.827586207,0.827586207,20998
9f7e87e3e0d460ede82b4fc32dd8160147f3aea8,0,aBabiichuk,2015-11-24 11:25:40+02:00,['bd1b743cf404d6c9e3d67b4ebaca4de7d332300b'],139,149,288,21338913,131,1,1,1,20998
ed6f3ab01aa67384dac728454c86a45df318a287,1,Oleg Nechiporenko,2015-11-24 13:13:42+02:00,['9f7e87e3e0d460ede82b4fc32dd8160147f3aea8'],9,14,23,21338936,6,0.5,0.5,1,20998
5c219c74a8015db51affc59a56b7857ae9300083,1,Lisnichenko Dmitro,2015-11-24 14:00:25+02:00,['ed6f3ab01aa67384dac728454c86a45df318a287'],1,10,11,21338947,1,0,0,1,20998
37a3b9152425dad19b01db2a5924024138703a5d,1,aBabiichuk,2015-11-24 15:19:56+02:00,['5c219c74a8015db51affc59a56b7857ae9300083'],6,10,16,21338963,1,1,1,1,20998
b20ae5fe1ed70560007af4c8c10741b855bfd2a3,1,Andrew Onishuk,2015-11-24 15:48:06+02:00,['37a3b9152425dad19b01db2a5924024138703a5d'],14,13,27,21338990,1,,,,20998
fb9dfc00aabe855249a5b667cea9f8506e4ff523,0,Vitaly Brodetskyi,2015-11-24 12:57:42+02:00,['b20ae5fe1ed70560007af4c8c10741b855bfd2a3'],12,18,30,21339020,3,,,,20998
b227b13768ca3a8e58b1530ad2e0d260631ce80c,1,Alex Antonenko,2015-11-24 17:13:23+02:00,['fb9dfc00aabe855249a5b667cea9f8506e4ff523'],6,18,24,21339044,7,0,0,1,20998
944b8edb09522e2fb13de8e8d72e586efab85977,1,Bob Nettleton,2015-11-24 11:35:08-05:00,['b227b13768ca3a8e58b1530ad2e0d260631ce80c'],11,11,22,21339066,2,,,,20998
36dc7a0b796cfca9d9150ec16f9de02bc4c13fb6,0,Aleksandr Kovalenko,2015-11-24 19:00:10+02:00,['944b8edb09522e2fb13de8e8d72e586efab85977'],5,12,17,21339083,2,1,1,1,20998
dffd7760fb3bb93746546e86f1c8cdaaa3c9906d,0,Myroslav Papirkovskyy,2015-11-24 19:04:43+02:00,['36dc7a0b796cfca9d9150ec16f9de02bc4c13fb6'],1,1,2,21339085,1,,,,20998
59c888536d444b82164f9b8a596fa5d92f870453,1,Myroslav Papirkovskyy,2015-11-24 19:04:43+02:00,['dffd7760fb3bb93746546e86f1c8cdaaa3c9906d'],23,22,45,21339130,17,,,,20998
6106262fe4b6eb7db863f8b8bf34c2de84bff5c4,0,Sumit Mohanty,2015-11-24 10:59:41-08:00,['59c888536d444b82164f9b8a596fa5d92f870453'],0,9,9,21339139,2,0,0,0,20998
009c783bff26d75580fb215342da45afcef8c788,1,Nate Cole,2015-11-24 14:18:21-05:00,['6106262fe4b6eb7db863f8b8bf34c2de84bff5c4'],46,173,219,21339358,10,0,0.753424658,0.849315068,20998
198f799d2c6553cd7aac42c7d5a91b87b6db5d7f,1,Jaimin Jetly,2015-11-24 12:38:44-08:00,['009c783bff26d75580fb215342da45afcef8c788'],1,39,40,21339398,2,0.392857143,0.392857143,1,20998
7f1e2f6702b8a3f40a0e876e131c8e0c6f1f8601,1,Alejandro Fernandez,2015-11-24 12:43:23-08:00,['198f799d2c6553cd7aac42c7d5a91b87b6db5d7f'],14,8,22,21339420,2,0,0,1,20998
5c6f8a4029476fb466ad2513200db487b744e189,1,Jonathan Hurley,2015-11-24 16:26:44-05:00,['7f1e2f6702b8a3f40a0e876e131c8e0c6f1f8601'],74,161,235,21339655,2,0.384615385,1,0.230769231,20998
689cfea16f0f557c0017b03fb5d83ff3b62363ea,1,Dmytro Sen,2015-11-24 23:31:45+02:00,['5c6f8a4029476fb466ad2513200db487b744e189'],100,95,195,21339850,13,1,1,0,20998
aa465686f3959d76254a8a00cfdd832747a602f4,0,Xi Wang,2015-11-24 15:20:32-08:00,['689cfea16f0f557c0017b03fb5d83ff3b62363ea'],14,16,30,21339880,1,0,0,1,20998
b5e8a3bf825413ad8d03a14416ae7813c3123dea,1,Sumit Mohanty,2015-11-24 15:37:16-08:00,['aa465686f3959d76254a8a00cfdd832747a602f4'],92,3283,3375,21343255,38,0.773207991,0.903642773,0.846063455,21032
6a36a14deb194a97d39f15a508922c8bc200acd0,1,Alejandro Fernandez,2015-11-24 16:04:24-08:00,['b5e8a3bf825413ad8d03a14416ae7813c3123dea'],9,52,61,21343316,2,0,0,0,21032
d5a661aa228f4b35f6033a02711b283c46337a49,1,Robert Levas,2015-11-24 20:00:59-05:00,['6a36a14deb194a97d39f15a508922c8bc200acd0'],68,96,164,21343480,19,0,0.583333333,0.416666667,21032
21bbfd9955377fedc821ace9ac0f5e9c91c8b153,0,Sumit Mohanty,2015-11-24 17:30:53-08:00,['d5a661aa228f4b35f6033a02711b283c46337a49'],0,4,4,21343484,2,,,,21032
a1729a3e977a00379fe3ebf788ced391eeb4102e,1,Gautam Borad,2015-11-25 12:32:34+05:18,['21bbfd9955377fedc821ace9ac0f5e9c91c8b153'],10,57,67,21343551,9,,,,21032
a9484c6e67b1eacc064feb2476c305276e3f03c4,1,Oleg Nechiporenko,2015-11-25 14:19:58+02:00,['a1729a3e977a00379fe3ebf788ced391eeb4102e'],4,8,12,21343563,4,0,0,1,21032
e69c96f74e1373cf002f07853b3356a167c775e7,1,Alex Antonenko,2015-11-25 14:42:22+02:00,['a9484c6e67b1eacc064feb2476c305276e3f03c4'],20,70,90,21343653,5,0,1,1,21032
8680bf4a49d0410ee833db0f5d3de2c01dacaa5e,0,Andrew Onishuk,2015-11-25 15:59:01+02:00,['e69c96f74e1373cf002f07853b3356a167c775e7'],0,4,4,21343657,1,0,0,1,21032
a2623d63e2c5a85f310ec535f66b4360184ffd21,0,aBabiichuk,2015-11-25 17:00:23+02:00,['8680bf4a49d0410ee833db0f5d3de2c01dacaa5e'],0,2,2,21343659,2,,,,21032
a147e43c8fb2a0ed71442b0375565b70a59ab72a,0,Myroslav Papirkovskyy,2015-11-25 17:04:09+02:00,['a2623d63e2c5a85f310ec535f66b4360184ffd21'],1,1,2,21343661,1,,,,21032
a8b2853547d53d277bb0a320f74cd99a7dc90ebd,1,Dmytro Sen,2015-11-25 17:19:42+02:00,['a147e43c8fb2a0ed71442b0375565b70a59ab72a'],12,16,28,21343689,2,0,0.666666667,0.666666667,21032
65e858ec116a9831ebf395b3bc8f5ef84b047b23,1,Aleksandr Kovalenko,2015-11-25 18:15:21+02:00,['a8b2853547d53d277bb0a320f74cd99a7dc90ebd'],5,5,10,21343699,2,,,,21032
82c93425d85b893a8454cf63694b1ce190b0ae3d,1,Vitaly Brodetskyi,2015-11-25 16:56:23+02:00,['65e858ec116a9831ebf395b3bc8f5ef84b047b23'],92,579,671,21344370,5,0.026894866,0.723716381,0.938875306,21032
9a05c0591255e1e69a4b1478f089be5fe2a2e42c,1,Vitaly Brodetskyi,2015-11-25 17:03:27+02:00,['82c93425d85b893a8454cf63694b1ce190b0ae3d'],83,70,153,21344523,2,1,0.545454545,0.545454545,21032
ebba6caec221b7c915cdd9c0717c1b4d48075420,1,Jonathan Hurley,2015-11-25 14:36:32-05:00,['9a05c0591255e1e69a4b1478f089be5fe2a2e42c'],25,65,90,21344613,3,0,0.956521739,0.956521739,21032
cc3d1b83ce31727e8b7335584bc8351fd55678d9,1,Sumit Mohanty,2015-11-25 12:07:39-08:00,['ebba6caec221b7c915cdd9c0717c1b4d48075420'],2,4,6,21344619,1,,,,21032
ab19210f0539f6236018c07439438ce57cc47123,0,Sumit Mohanty,2015-11-25 12:46:07-08:00,['cc3d1b83ce31727e8b7335584bc8351fd55678d9'],1,1,2,21344621,1,,,,21032
fb479d0260f9396de555350c2285fc099f4ac163,1,Jaimin Jetly,2015-11-25 12:49:49-08:00,['ab19210f0539f6236018c07439438ce57cc47123'],1,1,2,21344623,1,,,,21032
d846e2a217c87620a3c24d53c699c5e3177ac4a9,1,Alejandro Fernandez,2015-11-25 13:16:09-08:00,['fb479d0260f9396de555350c2285fc099f4ac163'],6,32,38,21344661,4,,,,21032
677e4e30616cabaa9dd4afc7d1fc079223295369,1,Jaimin Jetly,2015-11-25 13:24:10-08:00,['d846e2a217c87620a3c24d53c699c5e3177ac4a9'],0,43,43,21344704,13,0.25,0.25,1,21032
3c1944c187ee429a0a87ac1ddd135d7109d724c2,1,Jaimin Jetly,2015-11-25 17:20:52-08:00,['677e4e30616cabaa9dd4afc7d1fc079223295369'],8,8,16,21344720,1,1,0,0,21032
c51227fd02e9dffde4e224d365320e687e3f7a4b,0,Lisnichenko Dmitro,2015-11-26 10:37:59+02:00,['3c1944c187ee429a0a87ac1ddd135d7109d724c2'],5,35,40,21344760,2,0,0.722222222,1,21032
babb3164a55ed39b4c47a7f746c91e0c8a526fa5,1,Sumit Mohanty,2015-11-26 01:04:45-08:00,['c51227fd02e9dffde4e224d365320e687e3f7a4b'],37,16220,16257,21361017,6,0.676470588,0,0.676470588,21035
b9f87c180c4f8bf09a92111b9e9f1b475451c88c,1,Dmytro Sen,2015-11-26 13:49:41+02:00,['babb3164a55ed39b4c47a7f746c91e0c8a526fa5'],5,18,23,21361040,2,0,0,1,21035
54fa239e20d5f8ed723b448602bccfcc6cfd64c0,0,Andrii Tkach,2015-11-26 14:15:36+02:00,['b9f87c180c4f8bf09a92111b9e9f1b475451c88c'],8,6,14,21361054,2,0,0,0,21035
44e595588d72194ac434585e61f91b8366769d39,1,Oleg Nechiporenko,2015-11-26 15:03:41+02:00,['54fa239e20d5f8ed723b448602bccfcc6cfd64c0'],510,309,819,21361873,91,0,0,0.018087855,21035
56c23bb65ec4ba41dd3722e817a2905a72d093fe,0,Andrew Onishuk,2015-11-26 15:16:01+02:00,['44e595588d72194ac434585e61f91b8366769d39'],5,10,15,21361888,4,0,1,1,21035
b3422548b635f86f2cf30cfbfff881ba589edc75,0,Lisnichenko Dmitro,2015-11-26 16:56:09+02:00,['56c23bb65ec4ba41dd3722e817a2905a72d093fe'],7,68,75,21361963,7,1,1,1,21035
94fe1bfa9d7a1c87cbae59a073660c85d1ee9ff7,0,Myroslav Papirkovskyy,2015-11-26 17:29:12+02:00,['b3422548b635f86f2cf30cfbfff881ba589edc75'],1,0,1,21361964,1,,,,21035
e7adba92fcaa48f1ce286a6697a9ef220bd6c9ea,1,Sumit Mohanty,2015-11-26 07:51:26-08:00,['94fe1bfa9d7a1c87cbae59a073660c85d1ee9ff7'],3,60,63,21362027,2,0.382352941,1,1,21035
b34cf6d95cb72200b417a63c2977f51ead645d6a,0,Vitaly Brodetskyi,2015-11-26 18:52:10+02:00,['e7adba92fcaa48f1ce286a6697a9ef220bd6c9ea'],87,77,164,21362191,2,1,0.333333333,0,21035
db2ca773b5bd73f5aa1dee956d586c691c360ba1,1,Jaimin Jetly,2015-11-26 20:24:00-08:00,['b34cf6d95cb72200b417a63c2977f51ead645d6a'],1,1,2,21362193,1,,,,21035
6c3cf4993e520c2bfc60707fa54e1aa0783bd557,1,Gautam Borad,2015-11-27 11:37:12+05:18,['db2ca773b5bd73f5aa1dee956d586c691c360ba1'],7,257,264,21362457,16,0,0,0.993103448,21035
b19bf6eab3821de71c5ffcf8c1f87ea1b338a50b,0,Oleg Nechiporenko,2015-11-27 11:45:06+02:00,['6c3cf4993e520c2bfc60707fa54e1aa0783bd557'],46,552,598,21363055,2,1,0.953846154,1,21035
7312dbf1ef5f37c7c981dce40adbbf25d8efcbeb,1,Oleg Nechiporenko,2015-11-27 11:58:47+02:00,['b19bf6eab3821de71c5ffcf8c1f87ea1b338a50b'],49,113,162,21363217,4,0,0,0.958333333,21035
b470e3e7d9cd78b747f6cc08e100e9a2b8b709fc,0,Alex Antonenko,2015-11-27 14:17:36+02:00,['7312dbf1ef5f37c7c981dce40adbbf25d8efcbeb'],103,352,455,21363672,7,0,1,0.951612903,21036
00cb7bad7666fd86a0bec332928a42f58a656707,1,Andrew Onishuk,2015-11-27 14:37:02+02:00,['b470e3e7d9cd78b747f6cc08e100e9a2b8b709fc'],4,4,8,21363680,1,,,,21036
667e1e8be2b84903248cad302ebffe39795183f7,0,Oleg Nechiporenko,2015-11-27 14:39:21+02:00,['00cb7bad7666fd86a0bec332928a42f58a656707'],35,86,121,21363801,3,0.6,1,1,21036
ebdda3bcf051d31e1cb49204ee662e6480aa44bc,0,Dmytro Sen,2015-11-27 16:39:18+02:00,['667e1e8be2b84903248cad302ebffe39795183f7'],4,4,8,21363809,2,,,,21036
01f7d709e8f49b3d2095ebb4de6c269e4aad1230,0,Andrew Onishuk,2015-11-27 16:51:28+02:00,['ebdda3bcf051d31e1cb49204ee662e6480aa44bc'],3,15,18,21363827,3,,,,21036
5becb314e91e79f13911e85dbe82e95b50a19e58,1,aBabiichuk,2015-11-27 17:48:34+02:00,['01f7d709e8f49b3d2095ebb4de6c269e4aad1230'],6,9,15,21363842,8,1,1,0,21036
d855386b9798ef9c5a8669498b6b9c853b45edce,1,Lisnichenko Dmitro,2015-11-27 18:14:58+02:00,['5becb314e91e79f13911e85dbe82e95b50a19e58'],103,1505,1608,21365450,6,0.030769231,1,1,21037
bea418b75ed3ee9b2e4fa12d29a034bdfff96b4e,1,Sumit Mohanty,2015-11-27 09:12:23-08:00,['d855386b9798ef9c5a8669498b6b9c853b45edce'],1,20,21,21365471,1,0.764705882,0.764705882,0.058823529,21037
20a9ba1890d4bede13f2971d9e39cbeb0c743086,1,Jaimin Jetly,2015-11-28 12:42:19-08:00,['bea418b75ed3ee9b2e4fa12d29a034bdfff96b4e'],6,271,277,21365748,2,0.277777778,0.477777778,1,21037
f801369917633d357be0e59c645c9979e5686287,1,Sumit Mohanty,2015-11-29 08:08:20-08:00,['20a9ba1890d4bede13f2971d9e39cbeb0c743086'],0,2,2,21365750,1,,,,21037
d8a42253fdbad9c8d11ecbee4d267d67f4b28928,1,Sumit Mohanty,2015-11-29 08:24:18-08:00,['f801369917633d357be0e59c645c9979e5686287'],43,51,94,21365844,1,0,0,0,21037
b3cdc4e33cc03dba381f269e3b5cd80888bc82b1,1,Jaimin Jetly,2015-11-29 20:20:06-08:00,['d8a42253fdbad9c8d11ecbee4d267d67f4b28928'],9,32,41,21365885,3,0,1,1,21037
c1b520502a0fd3b946643be97b0e3a6a5e0701b2,1,Jaimin Jetly,2015-11-29 21:46:02-08:00,['b3cdc4e33cc03dba381f269e3b5cd80888bc82b1'],3,13,16,21365901,1,1,1,1,21037
85c751557746e224bd67ee153d005d31ea2d4b80,1,Jaimin Jetly,2015-11-29 21:54:08-08:00,['c1b520502a0fd3b946643be97b0e3a6a5e0701b2'],6,47,53,21365954,3,1,1,1,21038
c4d5ff90c1946cfbff81200bff2376b372bc7fff,1,Vitaly Brodetskyi,2015-11-30 09:51:17+02:00,['85c751557746e224bd67ee153d005d31ea2d4b80'],2,2,4,21365958,2,,,,21038
1eb64079548342fb1550eae2cbd3ddabf9398598,1,Andrii Tkach,2015-11-30 14:24:12+02:00,['c4d5ff90c1946cfbff81200bff2376b372bc7fff'],2,5,7,21365965,1,,,,21038
78bef69aa58bdb386aafc6c30ea880c5ccadc7a0,1,Alex Antonenko,2015-11-30 17:59:37+02:00,['1eb64079548342fb1550eae2cbd3ddabf9398598'],1,4,5,21365970,2,1,1,1,21038
61abd869b64eae39b77aa5da143034887dca3875,0,Oleg Nechiporenko,2015-11-30 19:10:34+02:00,['78bef69aa58bdb386aafc6c30ea880c5ccadc7a0'],6,9,15,21365985,2,0,0,1,21038
bbe5e76bdd2cdb973e5deea836706ba436c47b60,1,Jonathan Hurley,2015-11-30 12:32:27-05:00,['61abd869b64eae39b77aa5da143034887dca3875'],32,121,153,21366138,5,0,1,0.918367347,21038
c838f314dde60700d89562b2dac66d29445623ab,1,Srimanth Gunturi,2015-11-30 10:14:10-08:00,['bbe5e76bdd2cdb973e5deea836706ba436c47b60'],2,2,4,21366142,1,,,,21038
93bf1d370c6df7cfd50123c98aa0b8ac0582e962,1,Lisnichenko Dmitro,2015-11-30 20:14:50+02:00,['c838f314dde60700d89562b2dac66d29445623ab'],6,10,16,21366158,1,0,0,0,21038
fd1181f474e39492653fc70ccbf86d31f192a1e6,0,Bob Nettleton,2015-11-30 14:02:35-05:00,['93bf1d370c6df7cfd50123c98aa0b8ac0582e962'],4,7,11,21366169,2,1,1,1,21038
edc8d14ec38ad5c0c7a10c0576da60e60a670fb4,1,Dmytro Sen,2015-11-30 21:12:37+02:00,['fd1181f474e39492653fc70ccbf86d31f192a1e6'],4,12,16,21366185,3,0,1,1,21038
fe690bfdc71ecfb0d66285a13ab2b3babccb0b8d,0,Bob Nettleton,2015-11-30 16:51:05-05:00,['edc8d14ec38ad5c0c7a10c0576da60e60a670fb4'],6,10,16,21366201,2,0.5,0.5,1,21038
89c6f26286540651ee46bcb50f618014863c5e79,0,Yusaku Sako,2015-11-30 15:51:15-08:00,['fe690bfdc71ecfb0d66285a13ab2b3babccb0b8d'],1,23,24,21366225,2,1,1,1,21038
0ada28abc97e1b54833b98340a43e09c948a7e25,1,Yusaku Sako,2015-11-30 15:56:13-08:00,['89c6f26286540651ee46bcb50f618014863c5e79'],2,3,5,21366230,1,0,1,1,21038
a62c4b8aad56fce846603b9ad45ceead0300ae29,1,Alejandro Fernandez,2015-11-30 16:01:50-08:00,['0ada28abc97e1b54833b98340a43e09c948a7e25'],8,134,142,21366372,4,0,0.958333333,1,21038
006f0fe3f8aa7f288d77e3192542e8478cc60933,1,Bob Nettleton,2015-11-30 19:05:40-05:00,['a62c4b8aad56fce846603b9ad45ceead0300ae29'],68,97,165,21366537,2,1,1,0.518518519,21038
1f1c661a100f4136d24c9526a18c3d920a5bff8f,1,Yusaku Sako,2015-11-30 16:11:55-08:00,['006f0fe3f8aa7f288d77e3192542e8478cc60933'],23,1,24,21366561,2,0,0,0,21038
ca53dfd106099a37712a04e5f6dc65329baca9d1,0,Oleksandr Diachenko,2015-11-30 16:30:04-08:00,['1f1c661a100f4136d24c9526a18c3d920a5bff8f'],1,48,49,21366610,3,0,1,1,21039
67672e6331f30b7401fc59a1b716c0f68ad071b5,0,Yusaku Sako,2015-11-30 17:01:00-08:00,['ca53dfd106099a37712a04e5f6dc65329baca9d1'],0,8,8,21366618,1,,,,21039
24094e179dc2c2bba21634e1361cbbcbf053b145,0,Yusaku Sako,2015-11-30 17:12:23-08:00,['67672e6331f30b7401fc59a1b716c0f68ad071b5'],1,1,2,21366620,1,,,,21039
278d4c9ebe854ef66a323fef47f663eda809dca1,1,Jaimin Jetly,2015-11-30 17:43:21-08:00,['24094e179dc2c2bba21634e1361cbbcbf053b145'],352,103,455,21367075,7,1,0,0.048387097,21039
878c61d5c9a5b50a21f76590eecba95d5e1b5bf0,1,Siddharth Wagle,2015-11-30 22:30:41-08:00,['278d4c9ebe854ef66a323fef47f663eda809dca1'],214,33,247,21367322,6,0.969325153,0.337423313,0,21039
6c945804b5971eae9158ebb98d1a044d47f910f6,1,Andrii Tkach,2015-12-01 12:50:42+02:00,['878c61d5c9a5b50a21f76590eecba95d5e1b5bf0'],2,76,78,21367400,4,0.265625,0.984375,1,21039
2d8f69e75b5ab3b3be8d2dd42a76c046484de7d0,0,Dmytro Sen,2015-12-01 13:09:37+02:00,['6c945804b5971eae9158ebb98d1a044d47f910f6'],7,7,14,21367414,2,,,,21039
95a71a68f6f8d9ad3df1a573262f330d65a45111,0,Andrew Onishuk,2015-12-01 13:21:02+02:00,['2d8f69e75b5ab3b3be8d2dd42a76c046484de7d0'],2,5,7,21367421,2,0,0,0,21039
5cc99b224c8870815f978b7bc631275843c3bb06,0,aBabiichuk,2015-12-01 13:26:28+02:00,['95a71a68f6f8d9ad3df1a573262f330d65a45111'],4,4,8,21367429,1,,,,21039
1d01a85adef1aa0d6f66e83203c45efbe9038ae5,1,Andrew Onishuk,2015-12-01 13:38:35+02:00,['5cc99b224c8870815f978b7bc631275843c3bb06'],1,1,2,21367431,2,,,,21039
f74ec8712beb8414cbbe830aee16266bf4bd197e,1,aBabiichuk,2015-12-01 14:01:58+02:00,['1d01a85adef1aa0d6f66e83203c45efbe9038ae5'],0,68,68,21367499,13,,,,21039
fd29b081504d22715d46382484b8795daf8b2798,0,Oleg Nechiporenko,2015-12-01 14:06:31+02:00,['f74ec8712beb8414cbbe830aee16266bf4bd197e'],6,549,555,21368054,2,1,1,0.913907285,21039
730e6f47cd51a6d691e41371f432a0e7d9a02bbf,0,Andrii Tkach,2015-12-01 14:14:58+02:00,['fd29b081504d22715d46382484b8795daf8b2798'],8,1,9,21368063,1,1,0,0,21039
58f62665379586e044a4801aec253dbf30b57a3e,0,Vitaly Brodetskyi,2015-12-01 12:41:45+02:00,['730e6f47cd51a6d691e41371f432a0e7d9a02bbf'],6,64,70,21368133,3,0.146341463,1,0.585365854,21039
c5d7cf643fe9fccacadd5b47a52792f87bc7bb73,1,Alex Antonenko,2015-12-01 16:02:15+02:00,['58f62665379586e044a4801aec253dbf30b57a3e'],105,356,461,21368594,7,0,1,0.944,21040
5ca6b453d7b42ed426ba6bd2dcd503bafed76f9b,0,Vitaly Brodetskyi,2015-12-01 17:26:02+02:00,['108fc4499a545ee6f60eca26eefec7f5192c6b07'],8,27,35,21368629,1,1,1,0.454545455,21040
108fc4499a545ee6f60eca26eefec7f5192c6b07,1,Aleksandr Kovalenko,2015-12-01 18:07:33+02:00,['c5d7cf643fe9fccacadd5b47a52792f87bc7bb73'],0,3,3,21368632,1,0,1,1,21040
6ae63efd6fdb52aa42795b78a4105e82a2ab96f4,0,Nate Cole,2015-12-01 13:19:24-05:00,"['47a1bcfea42900076d9791575a3b75a7eeb29ab6', '108fc4499a545ee6f60eca26eefec7f5192c6b07']",6120,38369,44489,21413121,789,,,,21040
472734ecb94aae403bfefe8556ac89f2cba034c8,1,Yusaku Sako,2015-12-01 13:47:08-08:00,['5ca6b453d7b42ed426ba6bd2dcd503bafed76f9b'],3,3,6,21413127,3,,,,21040
a74bc730f53956a48f6355ddb4ff2fa690fa3e5e,1,Nate Cole,2015-12-01 17:03:49-05:00,['472734ecb94aae403bfefe8556ac89f2cba034c8'],1,423,424,21413551,3,0.153846154,1,0.153846154,21041
4fb40440b77e2c5302d386fff2092a6d1fa6ff3b,1,Bob Nettleton,2015-12-01 17:35:58-05:00,['a74bc730f53956a48f6355ddb4ff2fa690fa3e5e'],4,37,41,21413592,2,0.380952381,0.380952381,0.619047619,21041
ac42d479c2aa7e82b3c31a4ef05b302c62e9dd52,0,Xi Wang,2015-12-01 15:09:04-08:00,['4fb40440b77e2c5302d386fff2092a6d1fa6ff3b'],1,3,4,21413596,1,1,1,1,21041
764e5f1e697cc93805df637c7e07c4763e403aed,1,Alejandro Fernandez,2015-12-01 16:24:31-08:00,['ac42d479c2aa7e82b3c31a4ef05b302c62e9dd52'],33,42,75,21413671,2,0,0.666666667,1,21041
fec19f364f2c09266cddc441df674521c5f9c278,1,Srimanth Gunturi,2015-12-01 17:46:37-08:00,['764e5f1e697cc93805df637c7e07c4763e403aed'],23,19,42,21413713,6,,,,21041
21b37c20f66f3b87fe2d521d47bb240593b247a6,1,Yusaku Sako,2015-12-01 21:56:22-08:00,['fec19f364f2c09266cddc441df674521c5f9c278'],12,144,156,21413869,8,0.318681319,1,1,21041
29264fabf08ca8fea7be48d17a3670581125ad1a,1,Yusaku Sako,2015-12-01 22:03:19-08:00,['21b37c20f66f3b87fe2d521d47bb240593b247a6'],1,116,117,21413986,5,1,1,1,21043
316942510bdbe950b1e14b1b6ca1983628eece2d,1,Siddharth Wagle,2015-12-01 22:47:47-08:00,['29264fabf08ca8fea7be48d17a3670581125ad1a'],7,66,73,21414059,2,0.324324324,0.783783784,1,21043
d28134dab9cbb8758a0fc820d208231eec327aa4,1,Gautam Borad,2015-12-02 13:28:24+05:18,['316942510bdbe950b1e14b1b6ca1983628eece2d'],18,47,65,21414124,3,0,1,0.769230769,21043
aa1eb7e492faa237bb8ad60354dce38fdf0b2a08,1,Andrew Onishuk,2015-12-02 11:56:01+02:00,['d28134dab9cbb8758a0fc820d208231eec327aa4'],1,8,9,21414133,1,0,1,1,21043
e33b1f7586e421a96e68687cc86f0418706e9894,0,aBabiichuk,2015-12-02 12:05:09+02:00,['aa1eb7e492faa237bb8ad60354dce38fdf0b2a08'],4,8,12,21414145,1,1,1,1,21043
08227a64e3d26aeb9035c5f97e4abf7576917169,1,Dmytro Sen,2015-12-02 12:57:20+02:00,['e33b1f7586e421a96e68687cc86f0418706e9894'],0,45,45,21414190,3,0.783783784,0.783783784,1,21043
1de9934216c653843b7e4cec9065a5c76f9b84a4,1,Alex Antonenko,2015-12-02 17:28:44+02:00,['08227a64e3d26aeb9035c5f97e4abf7576917169'],20,26,46,21414236,2,1,,,21043
ed80206e891093e3c9708c4c164ea2349cf8f1ba,1,Robert Levas,2015-12-02 10:52:26-05:00,['1de9934216c653843b7e4cec9065a5c76f9b84a4'],16,16,32,21414268,8,,,,21043
233afcd2d621f40b029e5bdb33a4b496bf9e23c3,1,Dmytro Sen,2015-12-02 17:52:45+02:00,['ed80206e891093e3c9708c4c164ea2349cf8f1ba'],7,8,15,21414283,2,0,0,0,21043
c2f1cef29f5390ff28d450199e75bff144ddc665,1,Aleksandr Kovalenko,2015-12-02 18:34:11+02:00,['233afcd2d621f40b029e5bdb33a4b496bf9e23c3'],1,27,28,21414311,2,0.36,1,1,21043
9f0538e023f0dd5f1e357f2f2623377c1aee865d,1,Alex Antonenko,2015-12-02 19:12:40+02:00,['c2f1cef29f5390ff28d450199e75bff144ddc665'],3,4,7,21414318,2,0,0,1,21043
4fe479b0f4ad7bdf97e8609b3a1182ad3c0f57fd,1,Dmytro Sen,2015-12-02 19:14:54+02:00,['9f0538e023f0dd5f1e357f2f2623377c1aee865d'],4,84,88,21414406,3,0,0.811320755,1,21043
35f0d3c4234361dc74bf64bbe91720d79b8ecaa7,1,Robert Levas,2015-12-02 12:36:54-05:00,['4fe479b0f4ad7bdf97e8609b3a1182ad3c0f57fd'],41,236,277,21414683,6,0.543103448,1,0.913793103,21043
2a970f8de48656012d7aba364f1066cec31de99b,0,Dmytro Sen,2015-12-02 19:43:01+02:00,['35f0d3c4234361dc74bf64bbe91720d79b8ecaa7'],86,0,86,21414769,22,0.396551724,0,0,21043
4b57a0f8aa7329526b8c53bd7ad60f73cc19649d,1,Alejandro Fernandez,2015-12-02 10:35:05-08:00,['2a970f8de48656012d7aba364f1066cec31de99b'],36,50,86,21414855,6,0,0,0.428571429,21043
e9ae39cb6b33024c9829c09402f0bc1bdb03a70c,1,Alejandro Fernandez,2015-12-02 10:38:28-08:00,['4b57a0f8aa7329526b8c53bd7ad60f73cc19649d'],35,1162,1197,21416052,7,0.067567568,0.945945946,0.959459459,21044
f4a38e0cc0827b5805b3d1a6529f4d2945f95759,1,Dmytro Sen,2015-12-02 20:59:51+02:00,['e9ae39cb6b33024c9829c09402f0bc1bdb03a70c'],8,59,67,21416119,8,0.162162162,0,0.540540541,21044
f7ce017a742062f67f4f188d66a4b10087af4934,0,Yusaku Sako,2015-12-02 11:52:28-08:00,['f4a38e0cc0827b5805b3d1a6529f4d2945f95759'],0,10,10,21416129,2,,,,21044
e6c6e17a4dadb99947f496db1adba89baf0437f2,1,Yusaku Sako,2015-12-02 11:56:19-08:00,['f7ce017a742062f67f4f188d66a4b10087af4934'],5,72,77,21416206,4,1,1,1,21045
5d081baeb84a219bb1452b88429f6efdd07ee75d,1,Yusaku Sako,2015-12-02 12:00:12-08:00,['e6c6e17a4dadb99947f496db1adba89baf0437f2'],2,49,51,21416257,3,0.25,0.25,1,21045
c7c5a1b981d8140ef347e40e924031377b9be937,0,Jun Aoki,2015-12-02 13:12:10-08:00,['5d081baeb84a219bb1452b88429f6efdd07ee75d'],6,0,6,21416263,2,0,0,0,21045
cf867cfd8b535dfe564adf67ee00592a4cd2387f,1,Nate Cole,2015-12-02 17:46:54-05:00,['c7c5a1b981d8140ef347e40e924031377b9be937'],6,12,18,21416281,1,0.333333333,0,1,21045
4fbdb31d97e380b475ff9c23dcec92f4567093d4,1,Srimanth Gunturi,2015-12-02 18:32:23-08:00,['cf867cfd8b535dfe564adf67ee00592a4cd2387f'],0,1,1,21416282,1,1,1,1,21045
04f42043871fa3a7f16784329c98fe0fc0665b3b,1,Andrew Onishuk,2015-12-03 10:55:36+02:00,['4fbdb31d97e380b475ff9c23dcec92f4567093d4'],4,54,58,21416340,3,0,0.708333333,0.708333333,21045
da1c64c1f57d100151eeb472b43a0bc77c6bb8fb,0,aBabiichuk,2015-12-03 11:48:40+02:00,['04f42043871fa3a7f16784329c98fe0fc0665b3b'],2,2,4,21416344,2,,,,21045
53ab860fcb87814d283ec7cb4fb662f7b46ef873,1,aBabiichuk,2015-12-03 11:48:41+02:00,['da1c64c1f57d100151eeb472b43a0bc77c6bb8fb'],6,8,14,21416358,2,,,,21045
4d13432f14456037f980416698cb406e372cfbc3,1,Andrii Tkach,2015-12-03 12:16:48+02:00,['53ab860fcb87814d283ec7cb4fb662f7b46ef873'],16,6,22,21416380,4,0.933333333,0,0,21045
35b28f01e923ed521e4c633d58afd37651b6f99a,1,Oleg Nechiporenko,2015-12-03 12:43:55+02:00,['4d13432f14456037f980416698cb406e372cfbc3'],737,256,993,21417373,76,0.049924357,0.004538578,0.015128593,21045
5d1f56df8f408a1e1c54cfe993f9674eb39ad807,0,Andrew Onishuk,2015-12-03 13:13:25+02:00,['35b28f01e923ed521e4c633d58afd37651b6f99a'],0,2,2,21417375,1,0,0,1,21045
c17d6ddf732497ad1f46d9aa1473befc31ceacd2,1,Alex Antonenko,2015-12-03 13:15:49+02:00,['5d1f56df8f408a1e1c54cfe993f9674eb39ad807'],96,435,531,21417906,11,0.569832402,1,1,21045
6019649ecee59f4f94f4abd0d2b5a873b8b9ec15,0,Aleksandr Kovalenko,2015-12-03 13:19:20+02:00,['c17d6ddf732497ad1f46d9aa1473befc31ceacd2'],5,106,111,21418017,3,0.131147541,1,1,21046
3711b365c23f78984a519cbd517aada4a965a64f,0,aBabiichuk,2015-12-03 13:45:11+02:00,['6019649ecee59f4f94f4abd0d2b5a873b8b9ec15'],0,3,3,21418020,1,,,,21046
59bce855491f4c2f5a72384ea441ab7d4c307688,0,Alex Antonenko,2015-12-03 18:55:13+02:00,['3711b365c23f78984a519cbd517aada4a965a64f'],2,2,4,21418024,1,,,,21046
4ab6afc2ff187ab5ff597d20dd51d1e46c982080,1,Myroslav Papirkovskyy,2015-12-03 18:56:13+02:00,['59bce855491f4c2f5a72384ea441ab7d4c307688'],43,100,143,21418167,4,1,0.038461538,0.538461538,21046
2f553c2675803062b383c1bce252bf29a91050da,0,Andrew Onishuk,2015-12-03 19:47:01+02:00,['4ab6afc2ff187ab5ff597d20dd51d1e46c982080'],4,41,45,21418212,2,0,0.592592593,0.407407407,21046
a532b8c22d6b4d50cc298e243db6b15417976f84,1,Lisnichenko Dmitro,2015-12-03 20:05:50+02:00,['2f553c2675803062b383c1bce252bf29a91050da'],26,35,61,21418273,14,1,1,0.777777778,21046
3b4d8f1877d44d37094263a7cf2123fe0ffa228b,1,Oleksandr Diachenko,2015-12-03 12:08:24-08:00,['a532b8c22d6b4d50cc298e243db6b15417976f84'],0,209,209,21418482,2,0.794871795,1,1,21048
19c1e4021b2d2d285ec65d3f9fa92265a261b7cd,1,Oleksandr Diachenko,2015-12-03 12:23:42-08:00,['3b4d8f1877d44d37094263a7cf2123fe0ffa228b'],2,157,159,21418641,4,0.058823529,0.058823529,1,21049
19b323d6cf15015b32e298339bcee4f4faf9f4b9,1,Sumit Mohanty,2015-12-03 13:15:47-08:00,['19c1e4021b2d2d285ec65d3f9fa92265a261b7cd'],4,4,8,21418649,3,,,,21049
66e1a3a5b34a888e76a101a87b5deda71d0aaeac,0,Xi Wang,2015-12-03 14:05:40-08:00,['19b323d6cf15015b32e298339bcee4f4faf9f4b9'],18,72,90,21418739,4,1,0.619047619,1,21049
998baa59303093508a6569703d6c6354f69b8445,1,Sumit Mohanty,2015-12-03 14:35:55-08:00,['66e1a3a5b34a888e76a101a87b5deda71d0aaeac'],0,3,3,21418742,1,,,,21049
9a105fffd10561d5dec8593e08c919eedf74771e,1,Robert Levas,2015-12-03 17:39:22-05:00,['998baa59303093508a6569703d6c6354f69b8445'],58,304,362,21419104,13,0.555555556,1,1,21049
aaeab4912a8f35a7243d12e0093c7d6ef7e2fc00,0,Alejandro Fernandez,2015-12-03 14:44:24-08:00,['9a105fffd10561d5dec8593e08c919eedf74771e'],0,1,1,21419105,1,,,,21049
0ace4a5f6589656bdb71063f176de36253434dae,1,Yusaku Sako,2015-12-03 15:07:16-08:00,['aaeab4912a8f35a7243d12e0093c7d6ef7e2fc00'],1,1,2,21419107,1,,,,21049
e62e8eaa30b7d725a006773e197378ea9e8c797f,1,Jaimin Jetly,2015-12-03 15:43:37-08:00,['0ace4a5f6589656bdb71063f176de36253434dae'],123,27,150,21419257,5,,,,21049
19194e0b2f370c3039596b755a86dcdf02f7d8dd,1,Robert Levas,2015-12-03 18:47:04-05:00,['e62e8eaa30b7d725a006773e197378ea9e8c797f'],1050,475,1525,21420782,16,0.952380952,0.523809524,1,21049
12f70d99cd6a391aa96347188c03048f9651e954,0,Vitaly Brodetskyi,2015-12-03 22:50:16+02:00,['19194e0b2f370c3039596b755a86dcdf02f7d8dd'],5,20,25,21420807,4,0,1,1,21049
fe65472acbd4c76e9be7e3d29e24e1f747438a8d,1,Robert Levas,2015-12-03 19:51:39-05:00,['12f70d99cd6a391aa96347188c03048f9651e954'],10,91,101,21420908,4,0.826086957,0.760869565,1,21049
f468e9bcabd127f7882c9947fc4696a66c29602a,1,Jonathan Hurley,2015-12-03 23:41:05-05:00,['fe65472acbd4c76e9be7e3d29e24e1f747438a8d'],195,267,462,21421370,4,0,0.939393939,0.939393939,21049
f95b9b9324f3a722469355792464c824d89f4cf3,0,Lisnichenko Dmitro,2015-12-04 11:57:36+02:00,['f468e9bcabd127f7882c9947fc4696a66c29602a'],1,1,2,21421372,1,,,,21049
b1eaff4c60c9c77f826cbacad2cf2574de49c1d1,1,Robert Levas,2015-12-04 06:40:24-05:00,['f95b9b9324f3a722469355792464c824d89f4cf3'],166,711,877,21422249,3,0.244988864,1,0.859688196,21049
a8649b0f0edc452fe73f32151bcd04f6323d288d,1,Dmytro Sen,2015-12-04 13:40:56+02:00,['b1eaff4c60c9c77f826cbacad2cf2574de49c1d1'],11,162,173,21422422,7,0,0.512820513,1,21049
78bfef83197fd77029d4ead5b6eaf3254f97d173,1,Andrii Tkach,2015-12-04 15:31:38+02:00,['a8649b0f0edc452fe73f32151bcd04f6323d288d'],37,18,55,21422477,5,1,0,0,21049
a6d6ed51a286872f7543c1d5873da6d3eaf4b135,1,Lisnichenko Dmitro,2015-12-04 16:15:19+02:00,['78bfef83197fd77029d4ead5b6eaf3254f97d173'],3,5,8,21422485,3,,,,21049
789a35fbebdd013e98c0788600dcbd76bce19e99,1,Alex Antonenko,2015-12-04 16:16:56+02:00,['a6d6ed51a286872f7543c1d5873da6d3eaf4b135'],73,87,160,21422645,5,0,1,1,21049
e591e9093090537af505f706ff1a0628f9f572bd,0,Andrew Onishuk,2015-12-04 16:34:54+02:00,['789a35fbebdd013e98c0788600dcbd76bce19e99'],1,1,2,21422647,1,,,,21049
49ffd98e0a14a3ab1d461dc4013c8a8b77688411,0,Dmytro Sen,2015-12-04 18:24:57+02:00,['e591e9093090537af505f706ff1a0628f9f572bd'],14,131,145,21422792,5,0.317073171,0.93902439,0.06097561,21049
7d547369a099c1786c9b23639322d4f48c17b21c,1,Yusaku Sako,2015-12-04 09:15:44-08:00,['49ffd98e0a14a3ab1d461dc4013c8a8b77688411'],141,115,256,21423048,16,0,0,0,21050
557939293377c88aec42f17606fa0a893e517e25,1,Vitaly Brodetskyi,2015-12-04 16:27:26+02:00,['7d547369a099c1786c9b23639322d4f48c17b21c'],0,92,92,21423140,2,0,1,1,21050
ea7a0f6f336da797bcaa20ea01974c10e72424ca,0,Yusaku Sako,2015-12-04 09:30:08-08:00,['557939293377c88aec42f17606fa0a893e517e25'],0,18,18,21423158,2,1,1,1,21050
32dd052d195b8979aed7e68b2d77b639345b37c5,1,Gautam Borad,2015-12-04 22:52:45+05:18,['ea7a0f6f336da797bcaa20ea01974c10e72424ca'],3,3,6,21423164,1,,,,21050
01cc3c2d64ae6fec1460063a25f299d0b8a245ce,0,Vitaly Brodetskyi,2015-12-04 16:39:35+02:00,['32dd052d195b8979aed7e68b2d77b639345b37c5'],4,8,12,21423176,1,0,1,1,21050
8b9d23ba9256d30da5f72216ac3c1dff1e1f42cb,1,Yusaku Sako,2015-12-04 10:43:32-08:00,['01cc3c2d64ae6fec1460063a25f299d0b8a245ce'],2,2,4,21423180,1,,,,21050
cf976c922ac52d0273187a6cbb9e806a6491da7f,1,Robert Levas,2015-12-04 13:44:29-05:00,['8b9d23ba9256d30da5f72216ac3c1dff1e1f42cb'],27,36,63,21423243,4,0,0.727272727,0.727272727,21050
b5041a107947afe3fa95d649887d8ea24b5610e9,0,Alex Antonenko,2015-12-04 23:57:30+02:00,['cf976c922ac52d0273187a6cbb9e806a6491da7f'],514,378,892,21424135,59,0.382550336,0.087248322,0,21050
e763e693099afa726e16e6ff8775492166461af6,0,John Speidel,2015-12-04 17:20:34-05:00,['b5041a107947afe3fa95d649887d8ea24b5610e9'],0,16,16,21424151,1,,,,21050
6d63960fcd365e748a2e62d7b3e71d6b43dda98c,1,John Speidel,2015-12-04 17:20:34-05:00,['e763e693099afa726e16e6ff8775492166461af6'],0,3,3,21424154,1,,,,21050
e5d043e6b4d8439ee7c2f9e4d531bc321e53d6da,0,Jaimin Jetly,2015-12-04 15:06:09-08:00,['6d63960fcd365e748a2e62d7b3e71d6b43dda98c'],3,0,3,21424157,1,,,,21050
5381c3b98c9050d031d03e3a03ff7a07e9b9ee69,1,Siddharth Wagle,2015-12-04 15:21:46-08:00,['e5d043e6b4d8439ee7c2f9e4d531bc321e53d6da'],2,3,5,21424162,1,,,,21050
b9b7b6866266369c1b4ffad4e4624859b2a42a70,0,Sumit Mohanty,2015-12-04 15:54:35-08:00,['5381c3b98c9050d031d03e3a03ff7a07e9b9ee69'],6,1026,1032,21425194,5,,,,21051
1343ff3163a03cc9395f17782d35e6e1b5cc0a80,1,Sumit Mohanty,2015-12-04 15:56:31-08:00,['b9b7b6866266369c1b4ffad4e4624859b2a42a70'],1026,6,1032,21426226,5,,,,21051
dfb18d97827bc1d0bd1ebf2ca8a4f1b3dd3adaa3,1,Sumit Mohanty,2015-12-04 15:58:23-08:00,['1343ff3163a03cc9395f17782d35e6e1b5cc0a80'],6,53,59,21426285,4,,,,21051
357d196efcf19af956faff3f7051d16bdeb74263,1,Jonathan Hurley,2015-12-04 20:26:51-05:00,['dfb18d97827bc1d0bd1ebf2ca8a4f1b3dd3adaa3'],330,381,711,21426996,48,0,0,0,21051
7d6f28d97206ef6e7cb8f876607d78226c14be98,0,Sumit Mohanty,2015-12-04 22:35:04-08:00,['357d196efcf19af956faff3f7051d16bdeb74263'],3,3,6,21427002,1,,,,21051
96088ab7aa3347602bba73af35827010eadaf20c,1,Andrew Onishuk,2015-12-05 17:20:32+02:00,['7d6f28d97206ef6e7cb8f876607d78226c14be98'],2,2,4,21427006,1,,,,21051
2fd058f4dbcc81b2a6324dbdd9d309ccc520aaeb,1,Srimanth Gunturi,2015-12-05 11:56:54-08:00,['96088ab7aa3347602bba73af35827010eadaf20c'],70,74,144,21427150,13,0,0,0,21051
1efb3abed4054bfbde75d5c7987ef7a75c5cc175,1,Jaimin Jetly,2015-12-05 13:40:21-08:00,['2fd058f4dbcc81b2a6324dbdd9d309ccc520aaeb'],378,514,892,21428042,59,0.617449664,0.912751678,1,21051
10c51442791ac36188e8f01d4bb1e45333b748f9,1,Alex Antonenko,2015-12-06 06:00:22+02:00,['1efb3abed4054bfbde75d5c7987ef7a75c5cc175'],526,418,944,21428986,61,0.576,0.072,0.072,21051
db63c2b4feb4c08cc434032b2089bc6716a69de0,1,Nate Cole,2015-12-06 07:58:41-05:00,['10c51442791ac36188e8f01d4bb1e45333b748f9'],30,50,80,21429066,3,0.222222222,0.444444444,0.777777778,21051
ec2ba540eb88765878912e78bf3315606b6966b2,1,Lisnichenko Dmitro,2015-12-06 15:09:01+02:00,['db63c2b4feb4c08cc434032b2089bc6716a69de0'],0,78,78,21429144,2,0,0.676923077,1,21051
85a14993d6eb848b69b6717512f792f62ff5978f,1,Andrew Onishuk,2015-12-06 17:11:57+02:00,['ec2ba540eb88765878912e78bf3315606b6966b2'],0,12,12,21429156,1,1,1,1,21051
c1b3692d7f0c70bb55875ffe3c354367d0ccf481,1,Sumit Mohanty,2015-12-06 07:27:15-08:00,['85a14993d6eb848b69b6717512f792f62ff5978f'],7,83,90,21429246,4,0.263157895,0.289473684,0.289473684,21051
c4dea5a04c57712d2cc22f25a01f1656ab22c4f5,1,Dmytro Sen,2015-12-06 17:34:23+02:00,['c1b3692d7f0c70bb55875ffe3c354367d0ccf481'],18,57,75,21429321,4,0,0.931034483,0.931034483,21051
4d58b1a71e20fee8e744f877bda3328173d419cb,0,Sumit Mohanty,2015-12-06 15:58:58-08:00,['c4dea5a04c57712d2cc22f25a01f1656ab22c4f5'],6,1,7,21429328,1,1,1,1,21051
4f0acbf1a786e07a5f76009b37b3e51cd0a6283c,1,Sumit Mohanty,2015-12-06 16:06:35-08:00,['4d58b1a71e20fee8e744f877bda3328173d419cb'],16,282,298,21429626,7,0.414965986,0.68707483,1,21051
40ab0204082e7c3a2d92fb3770ec7f9d103714b2,0,Lisnichenko Dmitro,2015-12-07 09:48:11+02:00,['4f0acbf1a786e07a5f76009b37b3e51cd0a6283c'],4,4,8,21429634,1,,,,21051
285539424ef5285708178b553e7ed05d38d0a754,0,Lisnichenko Dmitro,2015-12-07 09:57:23+02:00,['40ab0204082e7c3a2d92fb3770ec7f9d103714b2'],4,4,8,21429642,1,,,,21051
dcaaca2ea87cd5bed4a44730f446de443349a92a,0,Alex Antonenko,2015-12-07 12:34:23+02:00,['285539424ef5285708178b553e7ed05d38d0a754'],3,10,13,21429655,2,0,1,1,21051
2915a9a34b0fee2d001be60bd85fceddc9c57f0d,1,Alex Antonenko,2015-12-07 12:39:45+02:00,['dcaaca2ea87cd5bed4a44730f446de443349a92a'],6,10,16,21429671,4,1,1,1,21051
e67521e27c533bf7aa131904a8ba32e8e2f5b319,1,Lisnichenko Dmitro,2015-12-07 14:19:58+02:00,['2915a9a34b0fee2d001be60bd85fceddc9c57f0d'],12,15,27,21429698,1,0,0,1,21051
aa1177cb97b2e109581fe96ffa98e778d8ec641c,1,Oleg Nechiporenko,2015-12-07 15:41:14+02:00,['e67521e27c533bf7aa131904a8ba32e8e2f5b319'],15,12,27,21429725,5,1,1,1,21051
01820d6f0ba80a778f46a2edf3430e66ba3405ec,1,Andrew Onishuk,2015-12-07 15:58:37+02:00,['aa1177cb97b2e109581fe96ffa98e778d8ec641c'],2,7,9,21429734,1,1,1,1,21051
a0d8e722c643c676f8e2b0b4dd5e1ee7a77cb56a,1,Vitaly Brodetskyi,2015-12-07 16:47:10+02:00,['01820d6f0ba80a778f46a2edf3430e66ba3405ec'],25,30,55,21429789,1,0,0,0,21051
53583b2df6282318ce20bd1d80c9025cb179f761,0,Dmytro Sen,2015-12-07 19:11:10+02:00,['a0d8e722c643c676f8e2b0b4dd5e1ee7a77cb56a'],1,1,2,21429791,1,,,,21051
ecd7d092beab85aa3ab4c666d7ea7d402a5c19a6,0,Aleksandr Kovalenko,2015-12-07 19:56:25+02:00,['53583b2df6282318ce20bd1d80c9025cb179f761'],11,26,37,21429828,2,0.714285714,1,1,21051
63ec0ea4b00b4c3e5ce0671287ccfea528cb202f,1,Alex Antonenko,2015-12-07 20:50:53+02:00,['ecd7d092beab85aa3ab4c666d7ea7d402a5c19a6'],3,3,6,21429834,2,,,,21051
67edc4079e26304a914520bae1337702c3957ede,1,Andrew Onishuk,2015-12-07 22:04:51+02:00,['63ec0ea4b00b4c3e5ce0671287ccfea528cb202f'],19,131,150,21429984,4,0.692307692,0.769230769,0.769230769,21051
f65486346807c7b5389fb4d6bd97f366f9f5d408,0,Siddharth Wagle,2015-12-07 13:54:05-08:00,['67edc4079e26304a914520bae1337702c3957ede'],13,46,59,21430043,8,0,1,1,21051
80ffae6b1183f957a2277c5a10b58809631da089,1,Jayush Luniya,2015-12-07 15:17:20-08:00,['f65486346807c7b5389fb4d6bd97f366f9f5d408'],39,164,203,21430246,9,0,0.828282828,0.777777778,21051
53fb588f27fcda6791ac440dc170cb01b89cf498,0,Siddharth Wagle,2015-12-07 16:49:04-08:00,['80ffae6b1183f957a2277c5a10b58809631da089'],2,2,4,21430250,2,,,,21051
858d3fc11b0f0c5cd93617a409b8613bd78f3803,1,Oleksandr Diachenko,2015-12-07 18:04:03-08:00,['53fb588f27fcda6791ac440dc170cb01b89cf498'],3,20,23,21430273,2,0,0,0,21051
751cb14399a6527f342284b5130515d24ea3711d,1,Jayush Luniya,2015-12-07 21:41:14-08:00,['858d3fc11b0f0c5cd93617a409b8613bd78f3803'],11,76,87,21430360,2,0,1,0.216216216,21051
67e0b50940fdb64f25501b4393275396e4b4568a,1,Andrii Tkach,2015-12-08 13:46:42+02:00,['751cb14399a6527f342284b5130515d24ea3711d'],5,15,20,21430380,1,1,1,0,21051
139764681b49706c2f2919d0d0903185ca4bc64d,0,Andrew Onishuk,2015-12-08 14:26:14+02:00,['67e0b50940fdb64f25501b4393275396e4b4568a'],0,4,4,21430384,1,0,0,1,21051
4bd35dfbab90d85965caf03e7808fcd5b6054e27,1,Lisnichenko Dmitro,2015-12-08 14:46:03+02:00,['139764681b49706c2f2919d0d0903185ca4bc64d'],7,272,279,21430663,2,0.365079365,1,0.944444444,21052
c776ec588dcad82beb342edc83466e6bf15e1681,0,Dmytro Sen,2015-12-08 15:27:46+02:00,['4bd35dfbab90d85965caf03e7808fcd5b6054e27'],2,2,4,21430667,1,,,,21052
59b891c60509ad541d34dd36a7acb7eac9d95697,1,Lisnichenko Dmitro,2015-12-08 15:46:39+02:00,['c776ec588dcad82beb342edc83466e6bf15e1681'],6,103,109,21430776,1,0.096774194,0.096774194,1,21052
d925b2fa2b99144b614db07bee1a6e25245a9981,1,aBabiichuk,2015-12-08 15:55:47+02:00,['59b891c60509ad541d34dd36a7acb7eac9d95697'],16,14,30,21430806,4,0.5,0,1,21052
94878ae094111e8bbaf490fdf08edc016eb3b1ca,0,Andrii Tkach,2015-12-08 16:19:35+02:00,['d925b2fa2b99144b614db07bee1a6e25245a9981'],17,52,69,21430875,4,1,1,1,21052
d57ec60f9646c2691db0c3a0607b8735cbf2656f,0,Vitaly Brodetskyi,2015-12-08 17:34:48+02:00,['94878ae094111e8bbaf490fdf08edc016eb3b1ca'],15,39,54,21430929,8,0,1,0,21052
a55b1ac0d1fde2a40e6119a8a832dd9f05e56be7,1,Alex Antonenko,2015-12-08 18:19:25+02:00,['d57ec60f9646c2691db0c3a0607b8735cbf2656f'],7,8,15,21430944,2,0,0,0,21052
a624de7beb12be3d473a0911a56e7defcdd0805a,1,Dmytro Sen,2015-12-08 19:00:20+02:00,['a55b1ac0d1fde2a40e6119a8a832dd9f05e56be7'],2,2,4,21430948,2,,,,21052
26139c8a636f3ec1879afe62b0e6383033fd145e,0,Srimanth Gunturi,2015-12-08 09:34:20-08:00,['a624de7beb12be3d473a0911a56e7defcdd0805a'],1,10,11,21430959,1,0,0,1,21052
6732e718fd3ccb99c231aa782c1e93c86b0d26b6,1,Aleksandr Kovalenko,2015-12-08 19:38:40+02:00,['26139c8a636f3ec1879afe62b0e6383033fd145e'],206,21,227,21431186,5,0.093264249,0,0,21052
cd5693277adb598061dd4e8ed52e78328b88df25,1,Alex Antonenko,2015-12-08 20:38:56+02:00,['6732e718fd3ccb99c231aa782c1e93c86b0d26b6'],6,19,25,21431211,2,0,0.928571429,1,21052
7d3320db8adf2ebdbfde06620add162b48968a78,1,Jun Aoki,2015-12-08 11:37:27-08:00,['cd5693277adb598061dd4e8ed52e78328b88df25'],47,333,380,21431591,3,0,1,1,21053
5a5f16de95f3b7eac43382e3a613cb33a7bfcaec,1,Bob Nettleton,2015-12-08 17:33:01-05:00,['7d3320db8adf2ebdbfde06620add162b48968a78'],9,236,245,21431836,5,0,1,0.948717949,21054
f2ca027f0290211b683d8dffb668f11813d13125,1,Richard Zang,2015-12-08 15:28:56-08:00,['5a5f16de95f3b7eac43382e3a613cb33a7bfcaec'],14,26,40,21431876,6,1,1,1,21054
cfec7af6c38114375915c3ed21412f5406a58a35,1,Jaimin Jetly,2015-12-08 16:45:41-08:00,['f2ca027f0290211b683d8dffb668f11813d13125'],33,116,149,21432025,2,0.951807229,0.987951807,1,21054
9f2a72aefb8a33d59c0d0077794df3595427d348,1,Andrew Onishuk,2015-12-09 11:34:45+02:00,['cfec7af6c38114375915c3ed21412f5406a58a35'],171,191,362,21432387,1,0,1,1,21054
e934634317631ef4339b1d4fa3f0bdb2c8f2861a,1,Dmytro Sen,2015-12-09 12:17:13+02:00,['9f2a72aefb8a33d59c0d0077794df3595427d348'],1,1,2,21432389,1,,,,21054
4390c7a672148f3cfd8da02a6ae45368d05afd65,0,Andrew Onishuk,2015-12-09 13:04:36+02:00,['e934634317631ef4339b1d4fa3f0bdb2c8f2861a'],1,1,2,21432391,1,,,,21054
c7c7bcad19fae8b0117610d7eb6b218d8eb01f7d,0,aBabiichuk,2015-12-09 14:19:27+02:00,['4390c7a672148f3cfd8da02a6ae45368d05afd65'],1485,1,1486,21433877,22,0.30789826,0.03480589,0,21054
1e6d80f3cdc66420af8047780efdc6318990f3f8,1,Vitaly Brodetskyi,2015-12-09 14:34:21+02:00,['c7c7bcad19fae8b0117610d7eb6b218d8eb01f7d'],6,27,33,21433910,3,0.666666667,0,0,21054
b5b87682646e55ec102ffcf978814ff27d0a60d4,0,Andrew Onishuk,2015-12-09 15:10:10+02:00,['1e6d80f3cdc66420af8047780efdc6318990f3f8'],3,8,11,21433921,2,0,1,0.4,21054
bb6dd3e333d77043eef15563b6b05159aa3253a5,1,aBabiichuk,2015-12-09 15:43:35+02:00,['b5b87682646e55ec102ffcf978814ff27d0a60d4'],9,20,29,21433950,5,,,,21054
0404d061384a9b7be2622c363ea4cb1d0deedc9e,0,Dmytro Sen,2015-12-09 16:23:39+02:00,['bb6dd3e333d77043eef15563b6b05159aa3253a5'],4,4,8,21433958,2,,,,21054
4bd4f27dd2fb817a418623969b8c86d4ff18e22a,1,Aleksandr Kovalenko,2015-12-09 17:46:27+02:00,['0404d061384a9b7be2622c363ea4cb1d0deedc9e'],44,87,131,21434089,6,0.40625,0.375,0.40625,21054
c17f410a186328d66a878b73e1a0eed266492852,0,Lisnichenko Dmitro,2015-12-09 17:59:08+02:00,['4bd4f27dd2fb817a418623969b8c86d4ff18e22a'],5,0,5,21434094,1,1,1,1,21054
f08db5c996757d265f3fe8d4ecfe5b5e03e693d2,1,Robert Levas,2015-12-09 12:51:35-05:00,['c17f410a186328d66a878b73e1a0eed266492852'],284,1113,1397,21435491,31,0.513347023,0.714579055,0.911704312,21054
b31dbf3e69697facaa3ee53d42ef4237dbc85f0a,0,Jun Aoki,2015-12-09 10:30:28-08:00,['f08db5c996757d265f3fe8d4ecfe5b5e03e693d2'],10,0,10,21435501,1,,,,21054
f7a0617ddc4f285139d402cd3b0bd9b8c32dc93a,1,Alejandro Fernandez,2015-12-09 10:32:32-08:00,['b31dbf3e69697facaa3ee53d42ef4237dbc85f0a'],0,9,9,21435510,1,,,,21054
89ef3b5c799269f5097835a1dc99a40b10e4cd38,1,Sumit Mohanty,2015-12-09 10:53:55-08:00,['f7a0617ddc4f285139d402cd3b0bd9b8c32dc93a'],12,18,30,21435540,2,,,,21054
05c8eb5f61ec70cd15e0772290a2e44a6502a8c0,1,Robert Levas,2015-12-09 14:23:09-05:00,['89ef3b5c799269f5097835a1dc99a40b10e4cd38'],40,124,164,21435704,7,0.757575758,0.96969697,1,21054
4f636865f4374bc2b59e0b3feccf16028beb6a49,1,Jun Aoki,2015-12-09 11:25:36-08:00,['05c8eb5f61ec70cd15e0772290a2e44a6502a8c0'],60,66,126,21435830,1,,,,21054
30424f72d35351e8bacc285d7e93c66bc3e56d1f,1,Alejandro Fernandez,2015-12-09 13:32:29-08:00,['4f636865f4374bc2b59e0b3feccf16028beb6a49'],3,31,34,21435864,2,0,0.476190476,1,21054
7430c094b7f9183c475585ba0ef6d552b20d682e,1,Siddharth Wagle,2015-12-09 13:40:43-08:00,['30424f72d35351e8bacc285d7e93c66bc3e56d1f'],20,506,526,21436390,8,0.17535545,0.957345972,1,21055
e90fd73010cf514039dca0ddcea02ebff272a4cd,1,Nate Cole,2015-12-09 16:40:55-05:00,['7430c094b7f9183c475585ba0ef6d552b20d682e'],5,424,429,21436819,4,0.03125,0,0.03125,21056
133a71d956f0bed452e5e26e2c04a45b5343e2b1,1,Nate Cole,2015-12-09 16:53:10-05:00,['e90fd73010cf514039dca0ddcea02ebff272a4cd'],68,183,251,21437070,5,0,0,0.5,21056
a462452282575eb75a3ab8f2ada7be16e44e2bfe,1,Richard Zang,2015-12-09 14:49:53-08:00,['133a71d956f0bed452e5e26e2c04a45b5343e2b1'],2,2,4,21437074,1,,,,21056
c35b47d13cb5985aebe15c7330f90b1691dee1f4,1,Jonathan Hurley,2015-12-09 18:06:25-05:00,['a462452282575eb75a3ab8f2ada7be16e44e2bfe'],2,12,14,21437088,2,,,,21056
58dab9f14b38d1114984feb8752e17fe09176e46,1,Oleksandr Diachenko,2015-12-09 15:31:09-08:00,['c35b47d13cb5985aebe15c7330f90b1691dee1f4'],4,42,46,21437134,6,1,1,1,21057
f8d9bfb5d139ceb111d566af0c7555a1a1859d59,1,Sumit Mohanty,2015-12-09 15:41:57-08:00,['58dab9f14b38d1114984feb8752e17fe09176e46'],2,144,146,21437280,2,0.903225806,0.903225806,1,21057
40bd722f4591a1447dfd537eb4068406aa404721,1,Xi Wang,2015-12-09 15:49:13-08:00,['f8d9bfb5d139ceb111d566af0c7555a1a1859d59'],137,60,197,21437477,13,0.469387755,0.204081633,0,21057
7ba41b54a34f3e3cd2c3da1d0671d6f107ac9123,1,Siddharth Wagle,2015-12-09 17:06:18-08:00,['40bd722f4591a1447dfd537eb4068406aa404721'],2,2,4,21437481,2,,,,21057
0039084a87f9771025cebc6b9a7b934623ed783e,1,Siddharth Wagle,2015-12-09 17:21:27-08:00,['7ba41b54a34f3e3cd2c3da1d0671d6f107ac9123'],101,89,190,21437671,1,,,,21057
cb407d0eeda747326f6a87e471a0f28124f146f4,0,Yusaku Sako,2015-12-09 17:32:43-08:00,['0039084a87f9771025cebc6b9a7b934623ed783e'],27,27,54,21437725,27,,,,21057
2d259af943071acb56b3b3cb63031648b76a39c2,0,Jayush Luniya,2015-12-09 19:24:27-08:00,['cb407d0eeda747326f6a87e471a0f28124f146f4'],178,1,179,21437904,4,,,,21057
3071857c38efcf9810905dbaf85eb276c6ac96e7,1,Jayush Luniya,2015-12-09 19:27:31-08:00,['2d259af943071acb56b3b3cb63031648b76a39c2'],0,105,105,21438009,2,0,1,1,21058
6b45ca82e5f5b4663fe04bbaf984ed6aadb74228,0,Robert Levas,2015-12-09 22:31:00-05:00,['3071857c38efcf9810905dbaf85eb276c6ac96e7'],0,3,3,21438012,1,0,1,1,21058
a5a353b024c35c59bfd9199750202a10f303fb33,1,Andrew Onishuk,2015-12-10 13:08:03+02:00,['6b45ca82e5f5b4663fe04bbaf984ed6aadb74228'],2,2,4,21438016,1,,,,21058
df4bbdd8549529257dd9afed610c45d354cca955,0,Andrew Onishuk,2015-12-10 13:28:35+02:00,['a5a353b024c35c59bfd9199750202a10f303fb33'],3,5,8,21438024,1,0,1,1,21058
240a27a506419691a6556be67d193da1a04ffeea,1,Oleg Nechiporenko,2015-12-10 15:45:37+02:00,['df4bbdd8549529257dd9afed610c45d354cca955'],13,1997,2010,21440034,33,0.983700863,1,0.905081496,21088
43306594eae138b6b8e2bf6acfe1866c20cf67ae,1,Oleg Nechiporenko,2015-12-10 15:45:37+02:00,['240a27a506419691a6556be67d193da1a04ffeea'],875,569,1444,21441478,57,0.079522863,0,0,21088
8750537a335f1975bdee53ff229b6a7a2cb07a4d,1,Oleg Nechiporenko,2015-12-10 16:07:57+02:00,['43306594eae138b6b8e2bf6acfe1866c20cf67ae'],477,354,831,21442309,32,0.534722222,0,0,21090
5de1d0547c087a863fb488778c38b781ee7c33e1,1,Robert Levas,2015-12-10 10:42:08-05:00,['8750537a335f1975bdee53ff229b6a7a2cb07a4d'],419,579,998,21443307,3,0.798076923,0.721153846,0.759615385,21090
9df68b97804e9f56234823e74b98ce31fba88a6c,1,Alex Antonenko,2015-12-10 19:48:35+02:00,['5de1d0547c087a863fb488778c38b781ee7c33e1'],2,2,4,21443311,2,,,,21090
5ed67a0905031dca22445be814afc988f73e30d4,0,Myroslav Papirkovskyy,2015-12-10 19:52:11+02:00,['9df68b97804e9f56234823e74b98ce31fba88a6c'],1,4,5,21443316,1,1,1,1,21090
1c218dc749e4b7687b52cbbd7ef7ef5f471aa886,1,Robert Levas,2015-12-10 13:08:04-05:00,['5ed67a0905031dca22445be814afc988f73e30d4'],165,212,377,21443693,11,1,1,1,21090
1813b0062bb8e52c4616261d9ad7c3517ee523d0,1,Alex Antonenko,2015-12-10 20:45:59+02:00,['1c218dc749e4b7687b52cbbd7ef7ef5f471aa886'],2,2,4,21443697,1,,,,21090
0d6027983a56942ad6d7f0cd794322cf5e2c7c90,1,Jun Aoki,2015-12-10 11:00:11-08:00,['1813b0062bb8e52c4616261d9ad7c3517ee523d0'],97,97,194,21443891,9,,,,21090
13ba48bb6bf78e561285bbfe52bab0bedf36527e,1,Siddharth Wagle,2015-12-10 11:27:20-08:00,['0d6027983a56942ad6d7f0cd794322cf5e2c7c90'],11,29,40,21443931,4,0,0,1,21090
3831adab9f19394a526829c331dfb330da294e9f,0,Jaimin Jetly,2015-12-10 12:25:23-08:00,['13ba48bb6bf78e561285bbfe52bab0bedf36527e'],7,4,11,21443942,3,1,1,1,21090
a34030d633fa70da3c4995a8308997dc0dcc699a,0,AndriyBabiychuk,2015-12-10 23:08:13+02:00,['3831adab9f19394a526829c331dfb330da294e9f'],1,1,2,21443944,1,,,,21090
27f2b09e8045fff71e6660edc147e5e9b24c13b9,1,Bob Nettleton,2015-12-10 16:21:45-05:00,['a34030d633fa70da3c4995a8308997dc0dcc699a'],7,107,114,21444058,2,0.911111111,0.911111111,0.911111111,21090
ccc3d2d7c0fc14a5719a3ac96902c69e510ef7ce,1,Yusaku Sako,2015-12-10 13:33:45-08:00,['27f2b09e8045fff71e6660edc147e5e9b24c13b9'],72,18,90,21444148,4,0,0.380952381,0,21090
f790baac485ef60bc3fde92b6c558f8d4af97de8,1,Robert Levas,2015-12-10 17:19:20-05:00,['ccc3d2d7c0fc14a5719a3ac96902c69e510ef7ce'],214,203,417,21444565,29,0.333333333,1,1,21090
3559218e37d7f11eadabdd5ea3cb6415796d56ac,1,Richard Zang,2015-12-10 14:22:16-08:00,['f790baac485ef60bc3fde92b6c558f8d4af97de8'],6,9,15,21444580,1,,,,21090
2b0cb80629243d01a4723a2b5f43da7d9604eaba,1,Richard Zang,2015-12-10 14:35:28-08:00,['3559218e37d7f11eadabdd5ea3cb6415796d56ac'],0,22,22,21444602,2,1,1,1,21090
7bb890075e5c70a2ea24cddc753428fe51ac9810,0,Lisnichenko Dmitro,2015-12-11 01:07:53+02:00,['2b0cb80629243d01a4723a2b5f43da7d9604eaba'],1,3,4,21444606,1,0,0,1,21090
7e52e66d5f2c118f822d4b0d9e1bc9eb6043663c,1,Jaimin Jetly,2015-12-10 16:09:46-08:00,['7bb890075e5c70a2ea24cddc753428fe51ac9810'],1,586,587,21445193,3,0.166969147,0.938294011,0.938294011,21090
f4ad3057a9a85256e812a26c3ad594f1fd3d555e,0,Xi Wang,2015-12-10 16:51:36-08:00,['7e52e66d5f2c118f822d4b0d9e1bc9eb6043663c'],8,13,21,21445214,3,1,1,1,21090
7923e59cd951b065011a87d97c83ed71135e5609,1,Sumit Mohanty,2015-12-10 20:54:20-08:00,['f4ad3057a9a85256e812a26c3ad594f1fd3d555e'],53,28,81,21445295,2,,,,21090
65542232144200adfd9530c076278bc8f55c9403,1,Yusaku Sako,2015-12-10 23:21:08-08:00,['7923e59cd951b065011a87d97c83ed71135e5609'],2,2,4,21445299,1,,,,21090
d037ed73c278fc4d0698bfebc90fcf4458a1914c,0,Dmytro Sen,2015-12-11 11:39:22+02:00,['65542232144200adfd9530c076278bc8f55c9403'],5,5,10,21445309,5,,,,21090
baf230fddbfb7fec369866ee1dcf31afd6947f67,0,Alex Antonenko,2015-12-11 12:33:32+02:00,['d037ed73c278fc4d0698bfebc90fcf4458a1914c'],35,47,82,21445391,2,0.375,1,1,21090
edcf3ca7e089093ab71b996dceb3148a44dfba36,0,Robert Levas,2015-12-11 06:31:28-05:00,['baf230fddbfb7fec369866ee1dcf31afd6947f67'],1,14,15,21445406,1,1,1,1,21090
a1baa5c092b12b093bd08f1bb1684ca5b31cfbd8,0,Richard Zang,2015-12-11 04:55:10-08:00,['edcf3ca7e089093ab71b996dceb3148a44dfba36'],1,1,2,21445408,1,,,,21090
310c31535954174b824fe6db7dacd423419384ed,0,Nate Cole,2015-12-11 08:29:45-05:00,['a1baa5c092b12b093bd08f1bb1684ca5b31cfbd8'],23,9,32,21445440,2,1,1,0,21090
c5065addc9f51da9bfaa26093ad10754a49345d6,1,Andrew Onishuk,2015-12-11 16:17:57+02:00,['310c31535954174b824fe6db7dacd423419384ed'],1,4,5,21445445,3,0,0.5,1,21090
06855e8433a2ac82cca4ce67f88a91f2f46f395b,0,Alex Antonenko,2015-12-11 18:55:39+02:00,['c5065addc9f51da9bfaa26093ad10754a49345d6'],1,2,3,21445448,1,1,1,1,21090
77d68fb90ee29f3af6b1933fa21862040e6c8b52,1,Alex Antonenko,2015-12-11 20:51:39+02:00,['06855e8433a2ac82cca4ce67f88a91f2f46f395b'],2,2,4,21445452,1,,,,21090
d342a7627975226c7c6a32f45f333a6fa24bc842,1,Alex Antonenko,2015-12-11 21:22:36+02:00,['77d68fb90ee29f3af6b1933fa21862040e6c8b52'],1,20,21,21445473,2,0,1,1,21090
7c617e64f3f465c91894d790c0095636a13f4a5c,1,Jaimin Jetly,2015-12-11 11:53:02-08:00,['d342a7627975226c7c6a32f45f333a6fa24bc842'],9,14,23,21445496,1,0,1,1,21090
56c12489cd7b2eee696d3e0b1257efddad3112e6,0,Dmytro Sen,2015-12-11 21:55:20+02:00,['7c617e64f3f465c91894d790c0095636a13f4a5c'],5,4,9,21445505,2,1,0,0,21090
9535a51eb31ffcaf9e9a8616c77b7fe056e3179f,1,Jonathan Hurley,2015-12-11 15:26:32-05:00,['56c12489cd7b2eee696d3e0b1257efddad3112e6'],44,383,427,21445932,9,0.336842105,1,1,21093
1f7dfdad3b14b22b4f671d9514da5e2c467623e7,0,Yusaku Sako,2015-12-11 15:24:17-08:00,['9535a51eb31ffcaf9e9a8616c77b7fe056e3179f'],1,6,7,21445939,1,,,,21093
3c566a6458967ef3423b6c6b4cb85136023460c3,0,Yusaku Sako,2015-12-11 17:25:45-08:00,['1f7dfdad3b14b22b4f671d9514da5e2c467623e7'],12,28,40,21445979,1,,,,21093
5295cc25212b54a334d50b9aae16e9eabfe2dca5,0,Sumit Mohanty,2015-12-11 20:01:07-08:00,['3c566a6458967ef3423b6c6b4cb85136023460c3'],5,5,10,21445989,5,,,,21093
46047accd48088c4d4955a63df88a3bf9ca1952d,1,Lisnichenko Dmitro,2015-12-12 10:41:48+02:00,['5295cc25212b54a334d50b9aae16e9eabfe2dca5'],38,278,316,21446305,18,0,1,0.723300971,21094
6944d61f05cda5d4b47810bc4f835a2bb8e44016,0,Andrew Onishuk,2015-12-12 18:14:03+02:00,['46047accd48088c4d4955a63df88a3bf9ca1952d'],3,9,12,21446317,1,0,1,1,21094
82f449dd11dc8880c5a9e7fffa5456bdbe83c808,0,Sumit Mohanty,2015-12-12 08:29:49-08:00,['6944d61f05cda5d4b47810bc4f835a2bb8e44016'],0,637,637,21446954,5,0,0.423076923,0.576923077,21096
e3272a8878627f47e33ae8c51b97a533dafda041,0,Sumit Mohanty,2015-12-12 08:33:13-08:00,['82f449dd11dc8880c5a9e7fffa5456bdbe83c808'],637,0,637,21447591,5,1,0.576923077,0.423076923,21096
f15bcc833fe8751efe48b8727faee4070816038c,1,Sumit Mohanty,2015-12-12 08:34:57-08:00,['e3272a8878627f47e33ae8c51b97a533dafda041'],0,42,42,21447633,3,0,0.423076923,0.576923077,21096
f578d42dc99a2fc23285d642a8122d6bd00c3284,0,Jayush Luniya,2015-12-12 16:47:12-08:00,['f15bcc833fe8751efe48b8727faee4070816038c'],3,92,95,21447728,4,0.015873016,1,1,21096
fd8ffed25dfb6e1a43c872a385b16e663d7b7ca6,1,Jayush Luniya,2015-12-12 16:55:56-08:00,['f578d42dc99a2fc23285d642a8122d6bd00c3284'],92,3,95,21447823,4,0.984126984,0,0,21096
54be5b8286a7f38291369641037e513f4082e329,0,Jayush Luniya,2015-12-12 19:26:14-08:00,['fd8ffed25dfb6e1a43c872a385b16e663d7b7ca6'],2,2,4,21447827,2,,,,21096
869ecc234fd778c9c87e7f2c209a3277fa12c249,0,Jaimin Jetly,2015-12-12 23:56:48-08:00,['54be5b8286a7f38291369641037e513f4082e329'],6,28,34,21447861,3,1,1,1,21096
c6ed608602b1376d8a087f3e246f08d7e2b70a8e,0,Dmytro Sen,2015-12-13 20:49:22+02:00,['869ecc234fd778c9c87e7f2c209a3277fa12c249'],1,5,6,21447867,1,0,1,0,21096
82eb633affc7feb501ab9721006868dd0fd116d5,0,Andrew Onishuk,2015-12-13 22:53:37+02:00,['c6ed608602b1376d8a087f3e246f08d7e2b70a8e'],4,8,12,21447879,3,0,0,0.75,21096
8f60188d6b83e8dcdaddcde2c49b9d71bc997fe0,1,Yusaku Sako,2015-12-13 12:58:28-08:00,['82eb633affc7feb501ab9721006868dd0fd116d5'],28,6,34,21447913,3,0,0,0,21096
9e566f3c9b1df44e226e39393551ad68ce2ace06,0,Sumit Mohanty,2015-12-13 13:05:07-08:00,['8f60188d6b83e8dcdaddcde2c49b9d71bc997fe0'],1,96,97,21448010,4,,,,21097
7edea1cdac5054ab94a8199f4d1e3b7efece9197,1,Jayush Luniya,2015-12-13 13:40:59-08:00,['9e566f3c9b1df44e226e39393551ad68ce2ace06'],3427,3506,6933,21454943,8,0,1,1,21099
f4325f4411f7710137aa2f9a3a9a13b79a676652,1,Jaimin Jetly,2015-12-13 14:25:18-08:00,['7edea1cdac5054ab94a8199f4d1e3b7efece9197'],1,10,11,21454954,2,1,1,1,21099
9a22519f4fb2bacc1614dd358ea5adc367f6095f,1,Oleg Nechiporenko,2015-12-14 15:23:45+02:00,['f4325f4411f7710137aa2f9a3a9a13b79a676652'],5,5,10,21454964,1,1,1,1,21099
77cf8477b049113925a91a7b62842afb88765454,1,Lisnichenko Dmitro,2015-12-14 15:48:08+02:00,['9a22519f4fb2bacc1614dd358ea5adc367f6095f'],6,55,61,21455025,4,0.2,1,0.542857143,21099
9cb0e457c9960114bd6a892852616784f1755c28,0,Andrew Onishuk,2015-12-14 18:07:04+02:00,['77cf8477b049113925a91a7b62842afb88765454'],2,10,12,21455037,1,0,0,0,21099
e6fde308048915ad401a935bfeb9dce06cc369b5,1,Andrii Tkach,2015-12-14 18:08:54+02:00,['9cb0e457c9960114bd6a892852616784f1755c28'],3,31,34,21455071,2,1,1,1,21099
155ae8554cd9f62cbc9933a3f7e17fb70f936cc9,0,Myroslav Papirkovskyy,2015-12-14 21:47:18+02:00,['e6fde308048915ad401a935bfeb9dce06cc369b5'],3,36,39,21455110,2,0,1,1,21099
55b84c55bcaa79df8955a2249abb4b1f63b0364c,1,Alejandro Fernandez,2015-12-14 12:22:36-08:00,['155ae8554cd9f62cbc9933a3f7e17fb70f936cc9'],85,222,307,21455417,12,0.242424242,0.464646465,0.808080808,21099
24f0a1ca2547b8fb85bb035423187f063336d0e7,1,Myroslav Papirkovskyy,2015-12-14 23:39:40+02:00,['55b84c55bcaa79df8955a2249abb4b1f63b0364c'],102,284,386,21455803,24,0.425,0,0.925,21099
f3778325ccca21a7f17548a1ed8ea4ba09107f4b,0,Sumit Mohanty,2015-12-14 13:40:55-08:00,['24f0a1ca2547b8fb85bb035423187f063336d0e7'],1,1,2,21455805,1,,,,21099
e9c9f18cc0c0112f83b95d6edffbb657a33a72e5,0,Alejandro Fernandez,2015-12-14 13:57:16-08:00,['f3778325ccca21a7f17548a1ed8ea4ba09107f4b'],18,19,37,21455842,2,,,,21099
3469a3c266abe424d57cc61fd7b3d400a8d6076b,0,Sumit Mohanty,2015-12-14 15:02:01-08:00,['e9c9f18cc0c0112f83b95d6edffbb657a33a72e5'],4,96,100,21455942,2,0,0.793103448,1,21099
94fd36de33d35d77bb50cd007af4880d2f5f6da5,1,Jun Aoki,2015-12-14 15:36:08-08:00,['3469a3c266abe424d57cc61fd7b3d400a8d6076b'],2,100,102,21456044,5,0,1,1,21100
55be31abcb3f8f1419df3387eb93bf1f51f18e54,1,Alejandro Fernandez,2015-12-14 15:45:02-08:00,['94fd36de33d35d77bb50cd007af4880d2f5f6da5'],12,95,107,21456151,4,0.188679245,1,0.698113208,21100
4196801e8fe308735142cc9ab13f255932269ef8,1,Jun Aoki,2015-12-14 17:26:16-08:00,['55be31abcb3f8f1419df3387eb93bf1f51f18e54'],11,39,50,21456201,6,1,1,0,21100
1bc270aac7282aef824b55e46c64c38a51eb9ed0,1,Oleksandr Diachenko,2015-12-14 17:43:59-08:00,['4196801e8fe308735142cc9ab13f255932269ef8'],35,97,132,21456333,1,0.634146341,1,0.365853659,21100
c0b1f4094b51148ad856129e1de4e1fa8bc6bcae,0,Sumit Mohanty,2015-12-14 20:15:50-08:00,['1bc270aac7282aef824b55e46c64c38a51eb9ed0'],1,4,5,21456338,1,,,,21100
ffb4d3b8ce043d3cb3e9b8a69619dc82797c68ce,1,Sumit Mohanty,2015-12-14 22:01:32-08:00,['c0b1f4094b51148ad856129e1de4e1fa8bc6bcae'],178,64812,64990,21521328,396,0.423887588,0.822014052,0.932084309,21459
729a6c8f3bd554d7f8e73d23012ad87579bc1378,1,Andrii Tkach,2015-12-15 12:58:04+02:00,['ffb4d3b8ce043d3cb3e9b8a69619dc82797c68ce'],4,27,31,21521359,3,1,1,1,21459
54d2326cac4f11808b246bbf626ac2354b180a36,1,Andrew Onishuk,2015-12-15 15:31:07+02:00,['729a6c8f3bd554d7f8e73d23012ad87579bc1378'],0,224,224,21521583,1,0.335766423,0.773722628,1,21460
a9a20f6b94ab9e35574c46486944d1fbeedc261d,1,Andrew Onishuk,2015-12-15 16:28:05+02:00,['54d2326cac4f11808b246bbf626ac2354b180a36'],6,7,13,21521596,2,1,0,0,21460
e351b1458c8de9cb2c30f7ce9b6d1ccf6359fb30,1,Jonathan Hurley,2015-12-15 11:45:13-05:00,['a9a20f6b94ab9e35574c46486944d1fbeedc261d'],109,29,138,21521734,4,0.43902439,0,0,21460
96e8ba4c6dcf65f42f30000de8087ff527f54c04,0,Dmytro Sen,2015-12-15 20:55:32+02:00,['e351b1458c8de9cb2c30f7ce9b6d1ccf6359fb30'],46,13,59,21521793,8,1,0,0,21460
5024b2b2eabe8cc0ed541b07cbbb84869e4507c5,1,Dmytro Sen,2015-12-15 20:56:49+02:00,['96e8ba4c6dcf65f42f30000de8087ff527f54c04'],0,5,5,21521798,3,,,,21460
a196eed8030bea498b437ba923b461db031bf096,1,Di Li,2015-12-15 11:06:06-08:00,['5024b2b2eabe8cc0ed541b07cbbb84869e4507c5'],8,8,16,21521814,8,,,,21460
d154f451c4164036e72421eae8a53282715503d3,1,Lisnichenko Dmitro,2015-12-15 21:22:51+02:00,['a196eed8030bea498b437ba923b461db031bf096'],13,22,35,21521849,2,1,1,1,21460
a66fc1b2fe915430a6564af9a61c4ffbf4c6d07b,1,Richard Zang,2015-12-15 11:32:41-08:00,['d154f451c4164036e72421eae8a53282715503d3'],18,82,100,21521949,12,0.185185185,1,0.888888889,21460
f3ab77ca197f54f6409b33309f398ea7e37e409f,0,Aravindan Vijayan,2015-12-15 15:11:38-08:00,['a66fc1b2fe915430a6564af9a61c4ffbf4c6d07b'],1,1,2,21521951,1,,,,21460
e3e91155adb831bb487133b16c7ab78a230a713f,0,Aravindan Vijayan,2015-12-15 15:57:44-08:00,['f3ab77ca197f54f6409b33309f398ea7e37e409f'],1,1,2,21521953,1,,,,21460
7153112e7951af1b91c2254202148fd6afd83726,1,Sumit Mohanty,2015-12-15 17:06:07-08:00,['e3e91155adb831bb487133b16c7ab78a230a713f'],343,991,1334,21523287,14,0.448616601,0.835968379,0.960474308,21460
9e2a6030b052e64ce65067c90bf4666e0a63e4a5,0,Jaimin Jetly,2015-12-15 18:30:43-08:00,['7153112e7951af1b91c2254202148fd6afd83726'],0,57,57,21523344,1,,,,21460
314bbc6b876f04d579d315f49c81062443c37998,1,Lisnichenko Dmitro,2015-12-16 10:00:27+02:00,['9e2a6030b052e64ce65067c90bf4666e0a63e4a5'],0,61,61,21523405,4,0,0,0,21460
92c054b1d6fcc0dc436ae4ff6b1cd9b8da68b459,1,Andrew Onishuk,2015-12-16 13:10:29+02:00,['314bbc6b876f04d579d315f49c81062443c37998'],1009,1064,2073,21525478,138,1,0,0,21460
eca979132c7da114e6a6e0537d92b024b0b45a9d,1,Di Li,2015-12-16 06:25:49-08:00,['92c054b1d6fcc0dc436ae4ff6b1cd9b8da68b459'],297,3122,3419,21528897,60,0.547677262,0.944987775,0.993887531,21492
fa9997205df9636e48bd315115d9504c9ee965aa,1,Robert Levas,2015-12-16 10:57:53-05:00,['eca979132c7da114e6a6e0537d92b024b0b45a9d'],158,582,740,21529637,5,0.057142857,0.665306122,0.542857143,21492
0061301ef42e787a4b8941c2a6515d153b3e89e5,0,AndriyBabiychuk,2015-12-16 19:44:41+02:00,['fa9997205df9636e48bd315115d9504c9ee965aa'],125,74,199,21529836,7,0,0.325,0,21492
ea8ed9f687a718bfdceb880a6c09db50bfade15f,1,Andrew Onishuk,2015-12-16 20:10:26+02:00,['0061301ef42e787a4b8941c2a6515d153b3e89e5'],2,8,10,21529846,2,,,,21492
07ee9b8ca5580f1759b52720c9702ff03465c9ac,1,Siddharth Wagle,2015-12-16 10:29:02-08:00,['ea8ed9f687a718bfdceb880a6c09db50bfade15f'],2,12,14,21529860,2,,,,21492
b85a15c8aa68049b5af24bc71953ce84bd04bff8,1,Aleksandr Kovalenko,2015-12-16 21:08:20+02:00,['07ee9b8ca5580f1759b52720c9702ff03465c9ac'],74,125,199,21530059,7,1,0.675,1,21492
74a9d7223acf85b64405ba88f65e56d3154b782b,1,Aleksandr Kovalenko,2015-12-16 21:10:17+02:00,['b85a15c8aa68049b5af24bc71953ce84bd04bff8'],32,50,82,21530141,7,1,0,1,21492
c7c991e85ab22400901f9c66798d4c1f8d0e4949,0,Andrew Onishuk,2015-12-16 22:47:10+02:00,['74a9d7223acf85b64405ba88f65e56d3154b782b'],1,1,2,21530143,1,,,,21492
b3edc70991c9d974d470ee9bce8d16d0e6964657,1,Nate Cole,2015-12-16 16:05:12-05:00,['c7c991e85ab22400901f9c66798d4c1f8d0e4949'],4,9,13,21530156,2,0.5,0.5,1,21492
18fcecb0301954f404753f1f70b862c14f8c284a,1,Richard Zang,2015-12-16 14:23:27-08:00,['b3edc70991c9d974d470ee9bce8d16d0e6964657'],2,2,4,21530160,1,,,,21492
c569305894f513e3044bc0ecea2d23b55daccb12,0,Xi Wang,2015-12-16 16:42:18-08:00,['18fcecb0301954f404753f1f70b862c14f8c284a'],0,12,12,21530172,2,1,1,1,21492
4fb0f6ec07b4e4df40bdfd63e26cb240305a8715,1,Siddharth Wagle,2015-12-16 18:54:30-08:00,['c569305894f513e3044bc0ecea2d23b55daccb12'],63,295,358,21530530,7,0.18,0.526666667,1,21492
f2e797abd9ce6db53995085c6693ed16d278f185,1,Sumit Mohanty,2015-12-16 21:42:42-08:00,['4fb0f6ec07b4e4df40bdfd63e26cb240305a8715'],217,2422,2639,21533169,15,0.777777778,1,0.746031746,21499
795450b374e851e59e9c516dcd80726288f41c6b,0,Andrew Onishuk,2015-12-17 10:07:51+02:00,['f2e797abd9ce6db53995085c6693ed16d278f185'],1,2,3,21533172,2,0,0,0,21499
abfb05978875e8ceb5cfd5eedf93e40431685bed,0,Andrii Tkach,2015-12-17 11:32:35+02:00,['795450b374e851e59e9c516dcd80726288f41c6b'],134,1600,1734,21534906,22,0.732452519,1,1,21501
1af1a31fe7185e592c8a7e6a8d03834a42255fd2,1,Andrii Tkach,2015-12-17 15:56:52+02:00,['abfb05978875e8ceb5cfd5eedf93e40431685bed'],1600,134,1734,21536640,22,0.267547481,0,0,21501
a55c81267c787b3ab980ba22375b47cf66bd6ec0,1,Andrii Tkach,2015-12-17 16:00:51+02:00,['1af1a31fe7185e592c8a7e6a8d03834a42255fd2'],129,1592,1721,21538361,21,0.732452519,1,1,21503
a93c5d2892b92ae22b3d1b7f7967dc43d45f6740,1,Robert Levas,2015-12-17 09:44:02-05:00,['a55c81267c787b3ab980ba22375b47cf66bd6ec0'],0,414,414,21538775,2,0,0.825503356,0.825503356,21503
0a62b7e01e92d0ac664dbee5724ca746d772bd86,1,Andrew Onishuk,2015-12-17 19:01:02+02:00,['a93c5d2892b92ae22b3d1b7f7967dc43d45f6740'],1,1,2,21538777,1,,,,21503
66e1595c3f4cda4100d71a41940a18fe3ed36424,1,Robert Levas,2015-12-17 12:40:16-05:00,['0a62b7e01e92d0ac664dbee5724ca746d772bd86'],276,2058,2334,21541111,25,0.705622933,0.782800441,0.955898567,21504
d86dbf35cf3f28972db79eb322c5b6994a25db26,0,Andrew Onishuk,2015-12-17 20:38:13+02:00,['66e1595c3f4cda4100d71a41940a18fe3ed36424'],1,7,8,21541119,4,0,1,0.5,21504
cc452ed8f634531a3d0471a3f1220054b7efaa37,1,Jonathan Hurley,2015-12-17 13:52:44-05:00,['d86dbf35cf3f28972db79eb322c5b6994a25db26'],20,136,156,21541275,2,0,0.915662651,1,21504
6b810e1415699571c0e34d419d033130de15a7d8,1,Oleksandr Diachenko,2015-12-17 10:54:54-08:00,['cc452ed8f634531a3d0471a3f1220054b7efaa37'],8,114,122,21541397,7,0.746478873,0.929577465,0.85915493,21504
39873e83a30b16823f946ea78b3aa5a41f1d4216,0,Oleksandr Diachenko,2015-12-17 11:00:09-08:00,['6b810e1415699571c0e34d419d033130de15a7d8'],1,1,2,21541399,1,,,,21504
3a9b0bbaf5458cbc72c96a243ec839483d939daa,1,Oleksandr Diachenko,2015-12-17 11:03:21-08:00,['39873e83a30b16823f946ea78b3aa5a41f1d4216'],12,136,148,21541547,5,1,1,0.806451613,21504
52d1a911e084fb17fae265a284cc23f5efe1eb79,0,Oleksandr Diachenko,2015-12-17 11:07:24-08:00,['3a9b0bbaf5458cbc72c96a243ec839483d939daa'],2,90,92,21541639,5,1,1,0.526315789,21504
d67270f67f3a1a3db4581543d2f5dd521dca88cf,1,Jayush Luniya,2015-12-17 11:19:51-08:00,['52d1a911e084fb17fae265a284cc23f5efe1eb79'],16,20,36,21541675,18,,,,21504
17f7b7127abce6d14f06ed53615ccd452ddfa87f,1,Jun Aoki,2015-12-17 15:19:57-08:00,['d67270f67f3a1a3db4581543d2f5dd521dca88cf'],1,1,2,21541677,1,,,,21504
1901b395c274a0ad3833b282164e54a7a1e74eb3,1,Oleg Nechiporenko,2015-12-18 11:36:17+02:00,['17f7b7127abce6d14f06ed53615ccd452ddfa87f'],1149,1453,2602,21544279,66,1,1,1,21504
5ce4f544807b733b12596b828d430017683a525b,1,Andrew Onishuk,2015-12-18 12:41:47+02:00,['1901b395c274a0ad3833b282164e54a7a1e74eb3'],1281,245,1526,21545805,68,1,1,1,21504
c575b6ea97387676103be7ee06d2c0c5f334b1b8,1,Andrii Tkach,2015-12-18 13:15:03+02:00,['5ce4f544807b733b12596b828d430017683a525b'],4,4,8,21545813,3,,,,21504
d7d0ba288be1d14cd229c2b0d1e833a056c9d2a9,1,AndriyBabiychuk,2015-12-18 15:10:42+02:00,['c575b6ea97387676103be7ee06d2c0c5f334b1b8'],479,151,630,21546443,13,0.00729927,0.094890511,0,21504
4c3d38c6f989b72a12b0c1461ba0ffca6d66ee76,1,AndriyBabiychuk,2015-12-18 16:42:35+02:00,['d7d0ba288be1d14cd229c2b0d1e833a056c9d2a9'],34,113,147,21546590,8,0.746031746,1,0.888888889,21504
d090dbf78c8860a7e7c7d20330b3f810556f6325,1,Andrew Onishuk,2015-12-18 18:21:31+02:00,['4c3d38c6f989b72a12b0c1461ba0ffca6d66ee76'],1,1,2,21546592,1,,,,21504
2c7ecd12ece30851395d518e6ad3f1fdf8b94cf9,1,Alex Antonenko,2015-12-18 18:50:42+02:00,['d090dbf78c8860a7e7c7d20330b3f810556f6325'],11,57,68,21546660,3,0.261904762,1,1,21504
6c38d84b1152807c0b94f175e090d90ad0c74a28,1,Alex Antonenko,2015-12-18 18:59:19+02:00,['2c7ecd12ece30851395d518e6ad3f1fdf8b94cf9'],1068,2095,3163,21549823,13,0.545454545,0.967532468,0.441558442,21508
d804eb398c5f0fe796f8417054cb97fc46795caa,1,Alex Antonenko,2015-12-18 19:44:01+02:00,['6c38d84b1152807c0b94f175e090d90ad0c74a28'],27,35,62,21549885,6,,,,21508
232522483bb3445aabd0c2a5eec99dc789eda47a,1,Bob Nettleton,2015-12-18 13:21:56-05:00,['d804eb398c5f0fe796f8417054cb97fc46795caa'],4,36,40,21549925,5,0,0.363636364,0.363636364,21508
32e86548cb69b244f11ba08e927cdda2f96f9331,0,Richard Zang,2015-12-18 10:56:58-08:00,['232522483bb3445aabd0c2a5eec99dc789eda47a'],1,2,3,21549928,1,1,1,1,21508
fd6e9cc00ea511c3433c847654d994dd605c6368,0,Xi Wang,2015-12-18 11:51:21-08:00,['32e86548cb69b244f11ba08e927cdda2f96f9331'],0,20,20,21549948,2,1,1,1,21508
f0b029e57daf5e3ec01b8dbc53ea41886ebe5e55,1,Robert Levas,2015-12-18 16:23:45-05:00,['fd6e9cc00ea511c3433c847654d994dd605c6368'],18,38,56,21550004,1,0,0,0,21508
3b693eab67e5f37229cc0070fa52d68f730c7c3e,0,Jonathan Hurley,2015-12-18 16:36:20-05:00,['f0b029e57daf5e3ec01b8dbc53ea41886ebe5e55'],0,2,2,21550006,2,,,,21508
b61f6eafab1e2eb6ef7ae8dacce87baa742933eb,1,Jonathan Hurley,2015-12-18 16:36:20-05:00,['3b693eab67e5f37229cc0070fa52d68f730c7c3e'],4,57,61,21550067,2,0.291666667,1,0.708333333,21508
7d0da5ae57ecf3a4863a32011fa11e17f14eb7e7,1,Andrii Babiichuk,2015-12-21 10:09:01+02:00,['b61f6eafab1e2eb6ef7ae8dacce87baa742933eb'],17,16,33,21550100,1,0,0,0,21508
8a7e563dd7a7f55b784b9758e2bf0199874bbf65,0,Andrii Tkach,2015-12-21 12:43:55+02:00,['7d0da5ae57ecf3a4863a32011fa11e17f14eb7e7'],84,1,85,21550185,2,0.048780488,0,0,21508
1ad5db19470ee28f5acd6cd7b6313174dedc0b6a,0,Andrew Onishuk,2015-12-21 16:35:55+02:00,['8a7e563dd7a7f55b784b9758e2bf0199874bbf65'],129,347,476,21550661,30,1,1,0.625,21509
d4adc1a9fb2c28ca516f3c9911540db2eb5f2d78,1,Vitaly Brodetskyi,2015-12-21 17:12:23+02:00,['1ad5db19470ee28f5acd6cd7b6313174dedc0b6a'],9,9,18,21550679,1,0,1,1,21509
901d6afca459fa2d1bf66234f07b351f78266413,1,Andrew Onishuk,2015-12-21 17:20:56+02:00,['d4adc1a9fb2c28ca516f3c9911540db2eb5f2d78'],347,129,476,21551155,30,0,0,0.375,21509
c104563da79073455b81072d37f73d5b0969b1bc,0,Andrii Tkach,2015-12-21 17:59:51+02:00,['901d6afca459fa2d1bf66234f07b351f78266413'],494,2,496,21551651,2,0.531791908,0.61849711,0,21509
094eb25bff3f8d047eeb62d6514e3deeed2ae069,1,Aleksandr Kovalenko,2015-12-21 19:15:22+02:00,['c104563da79073455b81072d37f73d5b0969b1bc'],15,12,27,21551678,2,1,0,0,21509
5c6c719c1c1942b249190d708eb908bc1dd7a18d,0,Jaimin Jetly,2015-12-21 12:33:02-08:00,['094eb25bff3f8d047eeb62d6514e3deeed2ae069'],10,22,32,21551710,4,,,,21509
ea195cb28d2ca35ac18e5a21eb7a7dec1670e0e2,1,Robert Levas,2015-12-21 17:19:46-05:00,['5c6c719c1c1942b249190d708eb908bc1dd7a18d'],60,82,142,21551852,3,0,1,1,21509
9a591a5e2642f44d652c82b8415f36e59bc66149,1,Jaimin Jetly,2015-12-21 14:34:04-08:00,['ea195cb28d2ca35ac18e5a21eb7a7dec1670e0e2'],6,8,14,21551866,2,1,1,1,21509
ef76fa534dfa2f3daa9e886846400fcb59eb6359,0,Robert Levas,2015-12-21 19:25:43-05:00,['9a591a5e2642f44d652c82b8415f36e59bc66149'],0,2,2,21551868,1,,,,21509
c87c9d24debfdbebeb7a693f10c2b9f33f64d6cc,1,Andrew Onishuk,2015-12-22 12:19:53+02:00,['ef76fa534dfa2f3daa9e886846400fcb59eb6359'],129,347,476,21552344,30,1,1,0.625,21510
878f71a76373c0010e2fe02375d7eae1137f0e33,1,Vitaly Brodetskyi,2015-12-22 12:35:17+02:00,['c87c9d24debfdbebeb7a693f10c2b9f33f64d6cc'],14,10,24,21552368,5,1,1,0,21510
a4a530ab36abffa90c523b0ad898b237fa4fc7e9,1,Vitaly Brodetskyi,2015-12-22 12:46:20+02:00,['878f71a76373c0010e2fe02375d7eae1137f0e33'],1,39,40,21552408,2,0,1,1,21510
2d8721a8babb509b63d85eb26f266ec4c280b7ee,0,Andrew Onishuk,2015-12-22 13:12:24+02:00,['a4a530ab36abffa90c523b0ad898b237fa4fc7e9'],1,18,19,21552427,1,0,0,1,21510
676f3176524dd9d07804a16a0bafd43911cdc8f6,0,Dmytro Sen,2015-12-22 14:46:31+02:00,['2d8721a8babb509b63d85eb26f266ec4c280b7ee'],2,4,6,21552433,2,0,0.5,1,21510
a8238e0a9de74b592aba75e23a17f5c582741832,0,Dmytro Sen,2015-12-22 16:01:40+02:00,['676f3176524dd9d07804a16a0bafd43911cdc8f6'],1,1,2,21552435,1,,,,21510
ff4e90e4d76060f1143bcf9efca09e857e367e2a,1,Dmytro Sen,2015-12-22 16:34:30+02:00,['a8238e0a9de74b592aba75e23a17f5c582741832'],8,12,20,21552455,1,1,1,1,21510
2b9e278fb70887a5d1678b18dd5348a7fc3b127b,0,Alex Antonenko,2015-12-22 16:53:56+02:00,['ff4e90e4d76060f1143bcf9efca09e857e367e2a'],49,218,267,21552722,2,0.234234234,0.72972973,1,21510
e82d8f2339dc9c483a5dc0ef0baa187fb660696e,0,Andrii Tkach,2015-12-22 17:15:53+02:00,['2b9e278fb70887a5d1678b18dd5348a7fc3b127b'],10,8,18,21552740,3,0,0,0,21510
e7b17583b4c718026b507a4c9c4eb65bd3097cf4,1,Andrii Tkach,2015-12-22 17:18:09+02:00,['e82d8f2339dc9c483a5dc0ef0baa187fb660696e'],98,101,199,21552939,2,1,1,1,21510
f0c1e2eabaf2f44592c0a9aa4618dfcaf51e8202,1,Vitaly Brodetskyi,2015-12-22 17:58:34+02:00,['e7b17583b4c718026b507a4c9c4eb65bd3097cf4'],22,367,389,21553328,7,0.519083969,0.709923664,0.954198473,21512
1ed72b8c564af8b392c2794d049ee7fe7472cbbf,0,Yusaku Sako,2015-12-22 10:07:41-08:00,['f0c1e2eabaf2f44592c0a9aa4618dfcaf51e8202'],12,0,12,21553340,2,0,0,0,21512
c947fcdf93ec4da8be0654b85fb1ddb467fc239b,1,Jonathan Hurley,2015-12-22 17:00:42-05:00,['1ed72b8c564af8b392c2794d049ee7fe7472cbbf'],16,82,98,21553438,4,0,0.970588235,0.970588235,21512
6b4aaa013ebb7c78c98df59a5957658c7c994ea5,1,Jayush Luniya,2015-12-22 15:25:18-08:00,['c947fcdf93ec4da8be0654b85fb1ddb467fc239b'],81,116,197,21553635,4,0,,,21512
b613c336d611b3995f7eb0cf8ebe482500e02d39,1,Aravindan Vijayan,2015-12-22 16:50:26-08:00,['6b4aaa013ebb7c78c98df59a5957658c7c994ea5'],80,436,516,21554151,22,0.036630037,0.673992674,0.695970696,21512
0f4c98ccbfa2648e1b9a4bdb2b7bb7ea61751b97,0,Sumit Mohanty,2015-12-22 21:30:05-08:00,['b613c336d611b3995f7eb0cf8ebe482500e02d39'],0,37,37,21554188,1,,,,21512
9c94ac95b97f66da5a6f5d0b988904949396afd2,1,ababiichuk,2015-12-23 08:53:14+02:00,['0f4c98ccbfa2648e1b9a4bdb2b7bb7ea61751b97'],12,34,46,21554234,2,0.181818182,1,1,21512
8eb449b46b5bfc0ad6c54b0b340b0ff2354fbc06,1,Andrew Onishuk,2015-12-23 13:48:35+02:00,['9c94ac95b97f66da5a6f5d0b988904949396afd2'],0,4,4,21554238,1,,,,21512
37a0ff7ec1bd07f1ebfe35ed82bb6149b15e2234,1,Alex Antonenko,2015-12-23 13:50:04+02:00,['8eb449b46b5bfc0ad6c54b0b340b0ff2354fbc06'],1,11,12,21554250,2,1,1,1,21512
c32cbbe2bb9c6962ce252005060eeee61bdecadf,1,Lisnichenko Dmitro,2015-12-23 15:08:20+02:00,['37a0ff7ec1bd07f1ebfe35ed82bb6149b15e2234'],12,12,24,21554274,4,,,,21512
a69a54456d26087dd12d82d85fee347dd42c87b6,1,Dmytro Sen,2015-12-23 16:34:58+02:00,['c32cbbe2bb9c6962ce252005060eeee61bdecadf'],8,4,12,21554286,2,1,0,0.5,21512
c9981170a04fa80f23c8a71a11a2dab2f6a45805,1,Andrew Onishuk,2015-12-23 16:55:30+02:00,['a69a54456d26087dd12d82d85fee347dd42c87b6'],13,39,52,21554338,3,0.888888889,0.888888889,0.888888889,21512
99ce307715bf1c482ccca4e3682d6a500d18b291,0,Nate Cole,2015-12-23 10:06:13-05:00,"['6ae63efd6fdb52aa42795b78a4105e82a2ab96f4', 'c9981170a04fa80f23c8a71a11a2dab2f6a45805']",20169,106757,126926,21681264,1535,,,,21512
764fda9aba84b935ae21a4efa5ca0179ee97d6e3,1,Alex Antonenko,2015-12-23 17:07:18+02:00,['c9981170a04fa80f23c8a71a11a2dab2f6a45805'],134,478,612,21681876,23,0.348148148,1,1,21512
9f59ed5b07f3d44ed0ef1539003a19db9bd56498,0,Alex Antonenko,2015-12-23 17:07:18+02:00,['764fda9aba84b935ae21a4efa5ca0179ee97d6e3'],2,1,3,21681879,1,,,,21512
5592240b68bb4b7d86d0c2518378014753f12f2f,1,Aleksandr Kovalenko,2015-12-23 17:08:49+02:00,['9f59ed5b07f3d44ed0ef1539003a19db9bd56498'],11,134,145,21682024,3,0.173913043,1,0.965217391,21512
6f8b840aa7b15cf240ccdf3cfc819ed16235d06f,1,Dmytro Sen,2015-12-23 18:58:44+02:00,['5592240b68bb4b7d86d0c2518378014753f12f2f'],5,26,31,21682055,3,0,0.357142857,0.357142857,21512
8acfcd8921ed89328eee060ee7b1383f2d35eb0e,1,Oleg Nechiporenko,2015-12-23 20:06:29+02:00,['6f8b840aa7b15cf240ccdf3cfc819ed16235d06f'],975,2081,3056,21685111,53,1,1,1,21512
810d6e82b03726f68b45b9c31cfc37469ea5decb,1,ababiichuk,2015-12-24 13:15:40+02:00,['8acfcd8921ed89328eee060ee7b1383f2d35eb0e'],381,286,667,21685778,7,1,0.725,0,21512
9857429d44f3292b4f12ede03b513cfb4ac17472,0,Andrew Onishuk,2015-12-24 15:14:18+02:00,['810d6e82b03726f68b45b9c31cfc37469ea5decb'],1,1,2,21685780,2,,,,21512
e0f3490e9c4f63c86c8053f8073bbb2ab3a7b480,1,Andrii Tkach,2015-12-24 16:42:47+02:00,['9857429d44f3292b4f12ede03b513cfb4ac17472'],64,321,385,21686165,3,0.580246914,1,1,21512
9df5e635a2fbdc735a1186ed55ab5a277b6d48df,0,Alex Antonenko,2015-12-24 18:07:39+02:00,['e0f3490e9c4f63c86c8053f8073bbb2ab3a7b480'],2,10,12,21686177,1,1,0,1,21512
bc841dce6305fd3b4a018c79dfbf258cd9910a12,0,Andrew Onishuk,2015-12-25 16:03:12+02:00,['9df5e635a2fbdc735a1186ed55ab5a277b6d48df'],1,15,16,21686193,5,0,1,1,21512
f8213edb4fe67fb0c6f9b3c8f881430aeb188e2d,1,Oleg Nechiporenko,2015-12-25 16:27:53+02:00,['bc841dce6305fd3b4a018c79dfbf258cd9910a12'],1128,1633,2761,21688954,23,1,1,1,21512
2a7ccf4d6fb1c4e3a7cb674cc99fcad67e920a8b,0,Gautam Borad,2015-12-28 10:35:09+05:18,['f8213edb4fe67fb0c6f9b3c8f881430aeb188e2d'],0,12,12,21688966,1,0,0,1,21512
ff3643cdff812510c027e0e11d7e36e42b463ccc,0,Andrew Onishuk,2015-12-28 12:48:10+02:00,['2a7ccf4d6fb1c4e3a7cb674cc99fcad67e920a8b'],0,2,2,21688968,1,,,,21512
73a850eb0bb781d3f6650b176d375aca9b5021f2,1,ababiichuk,2015-12-28 14:17:03+02:00,['ff3643cdff812510c027e0e11d7e36e42b463ccc'],449,770,1219,21690187,19,1,1,0,21515
48604428b05e8baa1c71e3a013f510aa5bb3a61e,0,Andrew Onishuk,2015-12-28 15:58:26+02:00,['73a850eb0bb781d3f6650b176d375aca9b5021f2'],119,2,121,21690308,3,1,0,0,21515
30e6c68420da78c27f5527f8ae69776873918781,1,Andrew Onishuk,2015-12-28 16:22:16+02:00,['48604428b05e8baa1c71e3a013f510aa5bb3a61e'],2,119,121,21690429,3,0,1,1,21516
9c6f7490d5d4c8365c00c860fb3aacf554ab7bad,1,Dmytro Sen,2015-12-28 17:20:42+02:00,['30e6c68420da78c27f5527f8ae69776873918781'],23,102,125,21690554,2,0.269230769,0.865384615,0.403846154,21516
f2b1a89ac66946ea3b86bace27e78ac59a737a12,0,ababiichuk,2015-12-28 18:15:35+02:00,['9c6f7490d5d4c8365c00c860fb3aacf554ab7bad'],2,4,6,21690560,2,,,,21516
23653924d6016ce6b3b52d5ea84d53298721ad6f,1,Alex Antonenko,2015-12-28 21:17:57+02:00,['f2b1a89ac66946ea3b86bace27e78ac59a737a12'],1,25,26,21690586,4,1,0,1,21516
4a58cd46fdfadd5deb5038db9849dd89cc289b80,1,Alex Antonenko,2015-12-28 21:17:57+02:00,['23653924d6016ce6b3b52d5ea84d53298721ad6f'],14,786,800,21691386,13,0.316998469,1,0.941807044,21519
c763570f4cbe1a41f00cfec77d599a1fdcdbb778,0,Alex Antonenko,2015-12-28 21:17:57+02:00,['4a58cd46fdfadd5deb5038db9849dd89cc289b80'],1,1,2,21691388,1,,,,21519
7d6caf6cdbfaefec8c992647a56e64e3fab3dd45,1,Alex Antonenko,2015-12-28 21:17:57+02:00,['c763570f4cbe1a41f00cfec77d599a1fdcdbb778'],3,6,9,21691397,2,,,,21519
b328f6dbe3ed94df662858962aad37b4e889bcd9,1,Jayush Luniya,2015-12-28 12:49:51-08:00,['7d6caf6cdbfaefec8c992647a56e64e3fab3dd45'],590,234,824,21692221,3,1,0.914012739,0.210191083,21519
f697f4aff80ab8f49eed654e70087bf436f9240f,1,Andrew Onishuk,2015-12-29 13:16:32+02:00,['b328f6dbe3ed94df662858962aad37b4e889bcd9'],15,109,124,21692345,5,,,,21520
65752c9bd95af7f64002e1b1da6b734b3bd99d8f,1,Andrew Onishuk,2015-12-29 13:33:42+02:00,['f697f4aff80ab8f49eed654e70087bf436f9240f'],5,148,153,21692498,5,0.152380952,0.19047619,0.914285714,21520
2b9bfd982f7203a6fc7f4f2432a93376e0cf52b3,1,Lisnichenko Dmitro,2015-12-29 14:17:45+02:00,['65752c9bd95af7f64002e1b1da6b734b3bd99d8f'],2,6,8,21692506,1,0,1,1,21520
376fc6ffccab683b9f83f825762e0ef2efaf0d82,1,Lisnichenko Dmitro,2015-12-29 14:23:12+02:00,['2b9bfd982f7203a6fc7f4f2432a93376e0cf52b3'],56,47,103,21692609,3,1,1,0,21520
a487e5018d320bb0943df0a27fcd6242e084ff80,1,Oleg Nechiporenko,2015-12-29 15:13:47+02:00,['376fc6ffccab683b9f83f825762e0ef2efaf0d82'],1023,2202,3225,21695834,31,1,0.999140155,1,21520
48c0df464f915438f8eaad35b4c2a443ca9e9aed,1,Dmytro Sen,2015-12-29 17:48:27+02:00,['a487e5018d320bb0943df0a27fcd6242e084ff80'],18,34,52,21695886,3,0.111111111,0.333333333,1,21520
6c71cd1f022841d94152b6c704a17374bb4ba4c2,1,ababiichuk,2015-12-29 17:48:58+02:00,['48c0df464f915438f8eaad35b4c2a443ca9e9aed'],29,91,120,21696006,7,0.8,1,0.44,21520
9022bfb113feba9f212dd843e38263f2f7e9f176,1,Vitaly Brodetskyi,2015-12-28 23:31:28+02:00,['6c71cd1f022841d94152b6c704a17374bb4ba4c2'],142,160,302,21696308,6,0.909090909,0,0.909090909,21520
8a748ffd9829cc25350ea79ed9f44abe0a98b012,1,Myroslav Papirkovskyy,2015-12-29 19:45:27+02:00,['9022bfb113feba9f212dd843e38263f2f7e9f176'],5,110,115,21696423,12,0.18,0.62,1,21520
0050787b853898a1387556b8f16cd1bfe609c3b5,1,Andrew Onishuk,2015-12-30 12:23:53+02:00,['8a748ffd9829cc25350ea79ed9f44abe0a98b012'],3,3,6,21696429,3,,,,21520
23a921bf03c86aeb3af88892a38469ed4a06aa07,1,Andrew Onishuk,2015-12-30 12:27:33+02:00,['0050787b853898a1387556b8f16cd1bfe609c3b5'],31,33,64,21696493,2,0,0,1,21520
1c40e9c29999e07367959bf6e0675355264d7243,1,Andrew Onishuk,2015-12-30 15:21:27+02:00,['23a921bf03c86aeb3af88892a38469ed4a06aa07'],69,71,140,21696633,1,0,0,1,21520
df267643d7ff1d03eeb12ff82eea45720f76c132,1,Alex Antonenko,2015-12-30 15:26:08+02:00,['1c40e9c29999e07367959bf6e0675355264d7243'],17,102,119,21696752,5,0.425531915,1,1,21521
ce4e4ea305f0ede6fa7129063751d37e19b72d03,1,Dmytro Sen,2015-12-30 16:44:52+02:00,['df267643d7ff1d03eeb12ff82eea45720f76c132'],32,164,196,21696948,8,0,0.811965812,0.786324786,21521
83ea508b621c5f17468f3698f0960cfcdf953f0c,1,Alex Antonenko,2015-12-30 19:50:19+02:00,['ce4e4ea305f0ede6fa7129063751d37e19b72d03'],341,365,706,21697654,34,0.428571429,1,1,21521
746e90d1de23060d3d7f33f3995714a0950938b4,1,Oleksandr Diachenko,2015-12-30 11:27:14-08:00,['83ea508b621c5f17468f3698f0960cfcdf953f0c'],16,114,130,21697784,3,0.417582418,0.967032967,1,21521
c96a9e4170564e9eafc6781443d7bbd0aecd4e75,1,Oleksandr Diachenko,2015-12-30 11:35:39-08:00,['746e90d1de23060d3d7f33f3995714a0950938b4'],7,3518,3525,21701309,3,1,0.615384615,0.615384615,21522
09406ac65f78a5213236ec33735dccd35e61d90b,1,Oleksandr Diachenko,2015-12-30 11:41:22-08:00,['c96a9e4170564e9eafc6781443d7bbd0aecd4e75'],29,36,65,21701374,5,1,1,1,21522
b8aede2a8e57cff8bb981064dbec13951a969679,1,Oleg Nechiporenko,2015-12-31 15:24:20+02:00,['09406ac65f78a5213236ec33735dccd35e61d90b'],1165,1773,2938,21704312,43,1,1,1,21522
371376de42d2d8e45eef6b01de9b3f1119e1c914,0,Alex Antonenko,2015-12-31 16:52:10+02:00,['b8aede2a8e57cff8bb981064dbec13951a969679'],1,162,163,21704475,2,0.02484472,0.97515528,1,21522
52ca9daa68b8302775dd2ee8d0b901d53ce69df7,0,Dmytro Sen,2015-12-31 16:53:04+02:00,['371376de42d2d8e45eef6b01de9b3f1119e1c914'],0,10,10,21704485,1,,,,21522
2feea0bd878fa2cce0f4c4e00c4c757b07352632,1,Lisnichenko Dmitro,2015-12-31 18:02:41+02:00,['52ca9daa68b8302775dd2ee8d0b901d53ce69df7'],1,3714,3715,21708200,7,,,,21527
d6883af71dc90c21e400e32553adad76e653f00d,1,Aleksandr Kovalenko,2016-01-04 17:14:35+02:00,['2feea0bd878fa2cce0f4c4e00c4c757b07352632'],34,32,66,21708266,3,1,1,1,21527
e8deead668a09affd94374f3bd3f9d95a6501eb4,1,Aleksandr Kovalenko,2016-01-04 19:34:38+02:00,['d6883af71dc90c21e400e32553adad76e653f00d'],6,15,21,21708287,3,1,1,1,21527
1d76f9571e77978205054b143233480e1075b51e,0,Di Li,2016-01-04 13:25:22-05:00,['e8deead668a09affd94374f3bd3f9d95a6501eb4'],2,2,4,21708291,2,,,,21527
32c8cfa852e3cf618d8c0fcb471eb120d93e0b95,1,Oleksandr Diachenko,2016-01-04 10:28:00-08:00,['1d76f9571e77978205054b143233480e1075b51e'],4,30,34,21708325,2,1,1,1,21527
7a9e6243bdbd1deca16c447ce48701a3be3adde3,1,Robert Levas,2016-01-04 15:16:46-05:00,['32c8cfa852e3cf618d8c0fcb471eb120d93e0b95'],12,116,128,21708453,5,0.449275362,0.884057971,0.942028986,21527
5310b95e63b955c697f33413b3af0bce8068f9fc,0,Nate Cole,2016-01-04 16:37:36-05:00,"['99ce307715bf1c482ccca4e3682d6a500d18b291', '7a9e6243bdbd1deca16c447ce48701a3be3adde3']",6510,19753,26263,21734716,294,,,,21527
a9419143f0c3749328f98d782fa4a2ed1ffdc880,0,Sumit Mohanty,2016-01-04 16:00:25-08:00,['7a9e6243bdbd1deca16c447ce48701a3be3adde3'],8,8,16,21734732,1,,,,21527
8e85227f70eaa3ff6e19125314d7b520bfa65680,1,Siddharth Wagle,2016-01-04 19:22:24-08:00,['a9419143f0c3749328f98d782fa4a2ed1ffdc880'],10,29,39,21734771,6,0,0.5,0.916666667,21527
2fb219fb39d54f8e135e8b65833d3b56d7f7ea45,1,ababiichuk,2016-01-05 13:20:30+02:00,['8e85227f70eaa3ff6e19125314d7b520bfa65680'],337,334,671,21735442,12,0.888888889,0,1,21527
b53de7f6ab4fad3d9a3c3579d04fb810f6cb5dc4,0,ababiichuk,2016-01-05 14:07:36+02:00,['2fb219fb39d54f8e135e8b65833d3b56d7f7ea45'],9,11,20,21735462,1,1,1,1,21527
09b55dfe70776a6ae1dc8d79b31ec739ee5400c7,0,Lisnichenko Dmitro,2016-01-05 15:04:41+02:00,['b53de7f6ab4fad3d9a3c3579d04fb810f6cb5dc4'],36,79,115,21735577,5,0.043478261,1,0,21527
7f291622570900875e15a52ea839b05c037861d1,1,Lisnichenko Dmitro,2016-01-05 16:40:18+02:00,['09b55dfe70776a6ae1dc8d79b31ec739ee5400c7'],5,50,55,21735632,1,0,0.571428571,1,21527
ba2b970012ad0b7151fb19b7552869f8d6ddce16,1,Lisnichenko Dmitro,2016-01-05 17:33:19+02:00,['7f291622570900875e15a52ea839b05c037861d1'],2143,1743,3886,21739518,23,1,0,0.571646341,21544
bb4b9aa7b51a5fe23daada738dc85fb0faded7a3,1,Myroslav Papirkovskyy,2016-01-05 17:42:46+02:00,['ba2b970012ad0b7151fb19b7552869f8d6ddce16'],1,2,3,21739521,1,,,,21544
24e2ba6d166e1079da8ca31d8be00c96781511a9,0,Andrii Tkach,2016-01-05 18:46:04+02:00,['bb4b9aa7b51a5fe23daada738dc85fb0faded7a3'],1,4,5,21739526,1,0,0,1,21544
fd46a9979cf15b9733481b783b6af3425fa4dd6b,1,Jonathan Hurley,2016-01-05 14:02:53-05:00,['24e2ba6d166e1079da8ca31d8be00c96781511a9'],51,37,88,21739614,6,0.333333333,0.066666667,0.733333333,21544
3ffb972528264b9dce5f5af9bbd187782765fc9e,1,Oleksandr Diachenko,2016-01-05 11:05:43-08:00,['fd46a9979cf15b9733481b783b6af3425fa4dd6b'],20,22,42,21739656,1,1,0.75,1,21544
6ad6d441b8f4beff6c5c97ef4b7d69eb71393ceb,0,Xi Wang,2016-01-05 11:22:14-08:00,['3ffb972528264b9dce5f5af9bbd187782765fc9e'],1,49,50,21739706,4,0,1,1,21544
4ec1f0e93c332f3c5817a6c20fe1d8220d4e51f9,0,Xi Wang,2016-01-05 11:22:22-08:00,['6ad6d441b8f4beff6c5c97ef4b7d69eb71393ceb'],1,20,21,21739727,2,1,1,1,21544
02b5770444f9422977b907ecc255b4bad8ba1e1e,0,Jaimin Jetly,2016-01-05 12:41:13-08:00,['4ec1f0e93c332f3c5817a6c20fe1d8220d4e51f9'],19,0,19,21739746,1,0,0,1,21544
ab975d3c2b0673bb79b51fea0802b5eeef9a6e42,1,Siddharth Wagle,2016-01-05 13:24:30-08:00,['02b5770444f9422977b907ecc255b4bad8ba1e1e'],2,4,6,21739752,1,0,0,0,21544
d04c7b03ed0c45f337f804327e531a1bd4811b56,0,Jayush Luniya,2016-01-05 13:44:25-08:00,['ab975d3c2b0673bb79b51fea0802b5eeef9a6e42'],13,13,26,21739778,1,,,,21544
215c21cf08185908f82139477d2e12a66b2d8203,1,Jun Aoki,2016-01-05 14:48:43-08:00,['d04c7b03ed0c45f337f804327e531a1bd4811b56'],22,96,118,21739896,3,0,0,1,21544
5d8a97cfb4e846d8319e6225465f1668584ab14c,1,Yusaku Sako,2016-01-05 15:24:56-08:00,['215c21cf08185908f82139477d2e12a66b2d8203'],79,36,115,21740011,5,0.956521739,0,1,21544
c0efc80d8b920473ade027a1383e9b92f2d6f28f,1,Oleksandr Diachenko,2016-01-05 16:02:20-08:00,['5d8a97cfb4e846d8319e6225465f1668584ab14c'],3,91,94,21740105,2,0.189189189,0.932432432,1,21544
fe8a8d1e1626a5a2f294622174f34cb0f65543fe,1,Jun Aoki,2016-01-05 17:49:14-08:00,['c0efc80d8b920473ade027a1383e9b92f2d6f28f'],8,27,35,21740140,3,0,0.666666667,0.666666667,21544
d97b6294634a028a13a9a57354fec72ad3465686,1,Sumit Mohanty,2016-01-05 19:43:59-08:00,['fe8a8d1e1626a5a2f294622174f34cb0f65543fe'],1,1,2,21740142,1,,,,21544
aa8c7fad8686af8933b7fec7c2aad3de765a800a,0,Sumit Mohanty,2016-01-05 19:52:53-08:00,['d97b6294634a028a13a9a57354fec72ad3465686'],0,9,9,21740151,1,0,1,1,21544
5ff2ae9a2a07386a45449f47d00b97acb95e5013,1,Sumit Mohanty,2016-01-05 23:08:55-08:00,['aa8c7fad8686af8933b7fec7c2aad3de765a800a'],0,1,1,21740152,1,,,,21544
37e5c13350c3d2aaf64f4cdd176495c545a5e411,1,ababiichuk,2016-01-06 10:25:41+02:00,['5ff2ae9a2a07386a45449f47d00b97acb95e5013'],1,7,8,21740160,2,1,1,1,21544
f5b87e008cd69320d93a00cf8048b5b0a812c7ee,1,ababiichuk,2016-01-06 12:30:15+02:00,['37e5c13350c3d2aaf64f4cdd176495c545a5e411'],244,507,751,21740911,13,0.417266187,0.996402878,0.989208633,21545
15a33a59297b4cbc41aed6e6dbe0ddd6268580b0,1,Oleg Nechiporenko,2016-01-06 17:52:13+02:00,['f5b87e008cd69320d93a00cf8048b5b0a812c7ee'],48,1083,1131,21742042,9,0.661697248,1,1,21545
7ef244158b3bf896c717c1c9697b1ff29937c1d6,1,Robert Levas,2016-01-06 13:01:00-05:00,['15a33a59297b4cbc41aed6e6dbe0ddd6268580b0'],20,102,122,21742164,2,0,0.271186441,0.271186441,21545
0ee8b7e087de6d90ffb9c2bfc93e810f2a60d78c,1,Jonathan Hurley,2016-01-06 14:36:00-05:00,['7ef244158b3bf896c717c1c9697b1ff29937c1d6'],46,182,228,21742392,18,0.018518519,0.62962963,0.981481481,21545
f48abf4bd377b57dff42477963731194a5c2a24c,1,Jonathan Hurley,2016-01-06 14:36:00-05:00,['0ee8b7e087de6d90ffb9c2bfc93e810f2a60d78c'],15,63,78,21742470,5,0.272727273,1,0.181818182,21545
7f132511a2c3d279f97c6b22cecc5ac4183352e6,1,Jonathan Hurley,2016-01-06 14:47:33-05:00,['f48abf4bd377b57dff42477963731194a5c2a24c'],0,1,1,21742471,1,,,,21545
b63aa4799266de5f4b52213c2957d9a1fb298185,1,Siddharth Wagle,2016-01-06 11:55:59-08:00,['7f132511a2c3d279f97c6b22cecc5ac4183352e6'],282,324,606,21743077,2,0,0,0.795454545,21545
d5c29f9d468a252f30bb29d5f4b9b392000685a7,1,Jun Aoki,2016-01-06 11:59:51-08:00,['b63aa4799266de5f4b52213c2957d9a1fb298185'],2,3,5,21743082,1,,,,21545
9b99d4982710faab64a39ab93a30e7fe0fdefe46,1,Yusaku Sako,2016-01-06 12:16:58-08:00,['d5c29f9d468a252f30bb29d5f4b9b392000685a7'],2,134,136,21743218,3,0.805309735,1,1,21545
ac2def335ad387e7e8ef92584223cee30d1a70bd,1,Yusaku Sako,2016-01-06 12:24:17-08:00,['9b99d4982710faab64a39ab93a30e7fe0fdefe46'],3,23,26,21743244,2,1,1,1,21545
b73623f6a84e73562fe692309a08ac66b5f5b870,0,Bob Nettleton,2016-01-06 15:26:49-05:00,['ac2def335ad387e7e8ef92584223cee30d1a70bd'],0,74,74,21743318,2,0.153846154,0.897435897,0.897435897,21545
09bfcff68ef741d09e7a1aab9fdba8d4ed165fd0,1,Yusaku Sako,2016-01-06 12:27:19-08:00,['b73623f6a84e73562fe692309a08ac66b5f5b870'],8,100,108,21743426,2,0.044776119,0.059701493,0,21545
55651a9b93e442ecb5cec2eb6226711845c92de2,1,Siddharth Wagle,2016-01-06 14:07:36-08:00,['09bfcff68ef741d09e7a1aab9fdba8d4ed165fd0'],5,39,44,21743470,3,0,0.133333333,0.866666667,21545
18dca6011aa153fccd806c292e018f559a98e422,0,Siddharth Wagle,2016-01-06 14:27:40-08:00,['55651a9b93e442ecb5cec2eb6226711845c92de2'],1,1,2,21743472,1,,,,21545
a456577ea00d63cba4073223f52d0bc591f788f0,1,Oleksandr Diachenko,2016-01-06 15:07:26-08:00,['18dca6011aa153fccd806c292e018f559a98e422'],3,3,6,21743478,1,,,,21545
a3a0c153af59dcf93aeaa3cd582af017464c3f6d,1,Lisnichenko Dmitro,2016-01-07 09:27:21+02:00,['a456577ea00d63cba4073223f52d0bc591f788f0'],38,99,137,21743615,7,0.029411765,1,0.323529412,21545
134e5343ea09962ef64aa6e682b0608715050243,1,Sumit Mohanty,2016-01-07 09:44:09-08:00,['a3a0c153af59dcf93aeaa3cd582af017464c3f6d'],4,25,29,21743644,2,0.555555556,1,0.833333333,21545
acc75b0f5a9a8faa70718400fc1db4d98b8b5f02,1,Yusaku Sako,2016-01-07 10:00:35-08:00,['134e5343ea09962ef64aa6e682b0608715050243'],0,1,1,21743645,1,,,,21545
8a949be2f90068d6241a30ee90082266b9b8c27e,0,Oleksandr Diachenko,2016-01-07 14:08:32-08:00,['acc75b0f5a9a8faa70718400fc1db4d98b8b5f02'],42,51,93,21743738,1,0,0,0,21545
14fd73e985b766ee05e7ce1b8a684b5a1f30a8c8,0,Oleksandr Diachenko,2016-01-07 14:24:23-08:00,['8a949be2f90068d6241a30ee90082266b9b8c27e'],1,9,10,21743748,2,,,,21545
b8d4a898d694492bbffd645063ae1d026c7f9e61,1,Jun Aoki,2016-01-07 15:57:46-08:00,['14fd73e985b766ee05e7ce1b8a684b5a1f30a8c8'],5,103,108,21743856,2,0.333333333,0.966666667,1,21545
8ae6743ba18c64614d640f71ab3f2a3d7eef6b0f,1,Jun Aoki,2016-01-07 17:24:53-08:00,['b8d4a898d694492bbffd645063ae1d026c7f9e61'],51,42,93,21743949,1,1,1,1,21545
413f4d6e43619261edfcbead9a001b0944e426ff,1,Siddharth Wagle,2016-01-07 18:03:31-08:00,['8ae6743ba18c64614d640f71ab3f2a3d7eef6b0f'],119,131,250,21744199,15,0,0.923076923,0.538461538,21545
c60e63e406399669bfb9b22a5f81e52278ab5343,1,Sumit Mohanty,2016-01-07 18:59:39-08:00,['413f4d6e43619261edfcbead9a001b0944e426ff'],30,30,60,21744259,10,,,,21545
74facbd443d876dffae6a11098a7cb5b9199f21d,0,Gautam Borad,2016-01-08 09:58:47+05:18,['c60e63e406399669bfb9b22a5f81e52278ab5343'],20,586,606,21744865,12,0.022988506,0.195402299,0.609195402,21546
33ca59fcaa76c3e94344eba7b1a9eda5aa700f1d,1,Yusaku Sako,2016-01-07 21:27:21-08:00,['74facbd443d876dffae6a11098a7cb5b9199f21d'],14,82,96,21744961,4,1,1,1,21547
c3df8e9c7f5fcc2353d87c8821004e71146fe454,1,ababiichuk,2016-01-08 12:00:37+02:00,['33ca59fcaa76c3e94344eba7b1a9eda5aa700f1d'],138,161,299,21745260,68,0,0,0,21548
9a3e1768721f904fdd0121097b6fc53eedc6a785,1,Oleg Nechiporenko,2016-01-08 14:13:10+02:00,['c3df8e9c7f5fcc2353d87c8821004e71146fe454'],12,35,47,21745307,2,1,1,1,21548
848371dfad55e07de195688895a217ee3ca234f8,1,Andrii Tkach,2016-01-08 15:24:54+02:00,['9a3e1768721f904fdd0121097b6fc53eedc6a785'],5,170,175,21745482,10,1,1,1,21550
e2670f40e13cf49ed9aeef20d6e2ac2dfc8fc3eb,0,Nate Cole,2016-01-08 13:03:49-05:00,"['5310b95e63b955c697f33413b3af0bce8068f9fc', '848371dfad55e07de195688895a217ee3ca234f8']",3668,6576,10244,21755726,235,,,,21550
f662e407fc2e7e3e6795d887f39c7e12518ad1e4,0,Nate Cole,2016-01-08 13:15:03-05:00,['e2670f40e13cf49ed9aeef20d6e2ac2dfc8fc3eb'],2,1,3,21755729,1,,,,21550
30e17c7f108b6795808d7594372fe937d332514c,1,Oleg Nechiporenko,2016-01-08 21:06:37+02:00,['848371dfad55e07de195688895a217ee3ca234f8'],35,174,209,21755938,2,0.182481752,0.99270073,1,21550
4a619a410c653e4a2dfcd565c66a3ee815b02eba,0,Oleksandr Diachenko,2016-01-08 11:45:43-08:00,['30e17c7f108b6795808d7594372fe937d332514c'],37,1,38,21755976,1,1,1,0,21550
96c0b4b7f65f98947b87eca369e506371d8dd3ce,1,Yusaku Sako,2016-01-08 12:39:30-08:00,['4a619a410c653e4a2dfcd565c66a3ee815b02eba'],586,20,606,21756582,12,0.977011494,0.804597701,0.390804598,21550
6633c6e7b9e8e651ecdad946cc86483d8090f205,0,Sumit Mohanty,2016-01-08 14:37:04-08:00,['96c0b4b7f65f98947b87eca369e506371d8dd3ce'],2,41,43,21756625,1,,,,21550
c484c905d6d6a5936bc54311b152c9e20d329f6b,0,Sumit Mohanty,2016-01-08 18:47:31-08:00,['6633c6e7b9e8e651ecdad946cc86483d8090f205'],9,0,9,21756634,1,1,0,0,21550
0c049aa710036c23bbef62e0f509635865b50718,1,Oleksandr Diachenko,2016-01-08 19:16:43-08:00,['c484c905d6d6a5936bc54311b152c9e20d329f6b'],9,17,26,21756660,6,0,1,0,21550
6d06814f729d45db11d63465d0e9d640c49d2b23,1,Bob Nettleton,2016-01-08 22:26:27-05:00,['0c049aa710036c23bbef62e0f509635865b50718'],103,401,504,21757164,42,0.428571429,0.348214286,0.455357143,21552
c7476d8a34151f0dc1ecc0087499e309366edc30,1,Richard Zang,2016-01-08 19:50:57-08:00,['6d06814f729d45db11d63465d0e9d640c49d2b23'],3,6404,6407,21763571,14,0.632422243,0.659283695,0.825164939,21560
5549bd48565ae6d7acc67fc8bf63aee4c4b068ae,1,Sumit Mohanty,2016-01-09 15:40:39-08:00,['c7476d8a34151f0dc1ecc0087499e309366edc30'],9,148,157,21763728,7,0.056338028,0.774647887,1,21560
df29c7750acbd7d6ec2b6c91bc9f6bc546a43240,1,Jonathan Hurley,2016-01-09 23:58:55-05:00,['5549bd48565ae6d7acc67fc8bf63aee4c4b068ae'],17,19,36,21763764,3,1,0,1,21560
fbeba1bf34e12c4a3077eaa3f3f6e14c5d248883,0,Sumit Mohanty,2016-01-10 18:51:53-08:00,['df29c7750acbd7d6ec2b6c91bc9f6bc546a43240'],0,7,7,21763771,1,,,,21560
c76a47af8d16380f1d13f1afe217aae75c400cd5,1,Sumit Mohanty,2016-01-10 21:24:24-08:00,['fbeba1bf34e12c4a3077eaa3f3f6e14c5d248883'],6,13,19,21763790,2,0,0.142857143,0,21560
35073a28173e89004fb0a4347d4150b5c169122e,1,Lisnichenko Dmitro,2016-01-11 15:19:10+02:00,['c76a47af8d16380f1d13f1afe217aae75c400cd5'],7,107,114,21763904,2,0.082191781,0.630136986,0.273972603,21560
ae780b6181fbec5fc6d955f873484bdc65883d78,0,Lisnichenko Dmitro,2016-01-11 15:20:14+02:00,['35073a28173e89004fb0a4347d4150b5c169122e'],1,1,2,21763906,1,,,,21560
639c40bc0950cad8fd40f2f365b45f880bb00e33,1,Lisnichenko Dmitro,2016-01-11 15:25:01+02:00,['ae780b6181fbec5fc6d955f873484bdc65883d78'],1,1,2,21763908,1,,,,21560
5f7aa152412de03922e40a6e5c6d4916c0b120dc,0,Lisnichenko Dmitro,2016-01-11 15:25:09+02:00,['639c40bc0950cad8fd40f2f365b45f880bb00e33'],1,1,2,21763910,1,,,,21560
dfd9ef63aa603d07c6973da513f6aa3b450f4abb,0,Andrew Onishuk,2016-01-11 16:24:51+02:00,['5f7aa152412de03922e40a6e5c6d4916c0b120dc'],1,11,12,21763922,2,0.875,0.875,0.875,21560
39e7bc0a2e8fb92295106dc47a6afc7f8bd233c9,0,Andrew Onishuk,2016-01-11 16:29:03+02:00,['dfd9ef63aa603d07c6973da513f6aa3b450f4abb'],10,17,27,21763949,2,0,0,1,21560
d071934a50447357d5d56414acceaf910a425d7c,1,Sumit Mohanty,2016-01-11 06:33:50-08:00,['39e7bc0a2e8fb92295106dc47a6afc7f8bd233c9'],3,95,98,21764047,13,0.8,0.85,0.5,21560
1c675d0a7d1107da206a78f753e77343354038a6,1,Nate Cole,2016-01-11 09:33:57-05:00,['f662e407fc2e7e3e6795d887f39c7e12518ad1e4'],47,653,700,21764747,10,0.6,1,1,21567
e001ed1b3de521d57b2efcf4cc93cafffbea0ec2,0,Nate Cole,2016-01-11 09:38:28-05:00,"['1c675d0a7d1107da206a78f753e77343354038a6', 'd071934a50447357d5d56414acceaf910a425d7c']",837,7475,8312,21773059,98,,,,21567
9d256334b77d0b75367555cd5419654b4c70b81f,0,Sumit Mohanty,2016-01-11 06:39:16-08:00,['d071934a50447357d5d56414acceaf910a425d7c'],7,7,14,21773073,4,,,,21567
f15ca1a0925665d3369127db64cc31c6fafa73f5,0,Andrew Onishuk,2016-01-11 20:26:36+02:00,['9d256334b77d0b75367555cd5419654b4c70b81f'],7,2,9,21773082,1,1,1,0,21567
19d424c7209cf1e728285376e2401b7e11b33ae2,1,Alejandro Fernandez,2016-01-11 10:57:55-08:00,['f15ca1a0925665d3369127db64cc31c6fafa73f5'],1,8,9,21773091,1,0,0,1,21567
c06e1e21a20ccd7b72c5d431dc2a7134220d93e2,0,Jayush Luniya,2016-01-11 11:17:53-08:00,['19d424c7209cf1e728285376e2401b7e11b33ae2'],0,18,18,21773109,1,,,,21567
bcbf878f7e2ac7944cd835898ccc6bfbf9758f53,0,Jayush Luniya,2016-01-11 11:18:41-08:00,['c06e1e21a20ccd7b72c5d431dc2a7134220d93e2'],18,0,18,21773127,1,,,,21567
9dac1d606cca6a2a803950910d7cd5b44492bf50,1,Jayush Luniya,2016-01-11 11:19:55-08:00,['bcbf878f7e2ac7944cd835898ccc6bfbf9758f53'],0,18,18,21773145,1,,,,21567
18eb4e2cbdcf5c1e0e3284e36b8a4d0ff3435ad6,1,Alex Antonenko,2016-01-11 22:18:23+02:00,['9dac1d606cca6a2a803950910d7cd5b44492bf50'],262,849,1111,21774256,18,0.271186441,0.886198547,1,21568
0f3d56c66221dd133e62398aa4c6cbec5074524d,1,Aleksandr Kovalenko,2016-01-12 00:04:29+02:00,['18eb4e2cbdcf5c1e0e3284e36b8a4d0ff3435ad6'],22,95,117,21774373,4,1,1,1,21568
3a9ecc09249320b08c7ff69a1384ece5a90c6b63,0,Bob Nettleton,2016-01-11 17:30:50-05:00,['0f3d56c66221dd133e62398aa4c6cbec5074524d'],5,0,5,21774378,2,,,,21568
723333de658ee1070d91938e419d5191f2e07d55,0,Jun Aoki,2016-01-11 15:59:42-08:00,['3a9ecc09249320b08c7ff69a1384ece5a90c6b63'],42,75,117,21774495,2,0,0,0.68,21568
31e9d0a8f35c217055c7901d28231fa761b8dd0f,1,Jun Aoki,2016-01-11 16:18:28-08:00,['723333de658ee1070d91938e419d5191f2e07d55'],1,1,2,21774497,1,,,,21568
42d13fd25e827879b95da78aba5db42a148b37dd,1,Alejandro Fernandez,2016-01-11 17:21:07-08:00,['31e9d0a8f35c217055c7901d28231fa761b8dd0f'],2,2232,2234,21776731,8,,,,21570
40341c29a96ddc78ec690e8970f31da3989c7e20,0,Jun Aoki,2016-01-11 17:34:48-08:00,['42d13fd25e827879b95da78aba5db42a148b37dd'],1,204,205,21776936,3,,,,21572
9f18d409d28464499b3ebe637c2bc5d6d8ff1e3a,1,ababiichuk,2016-01-12 09:13:44+02:00,['40341c29a96ddc78ec690e8970f31da3989c7e20'],2,24,26,21776962,1,1,1,1,21572
ceea27dbbd86c8b3afeccdd7bb3eec2fb16e2471,1,Lisnichenko Dmitro,2016-01-12 11:43:47+02:00,['9f18d409d28464499b3ebe637c2bc5d6d8ff1e3a'],1,187,188,21777150,4,0.145833333,0.510416667,0.510416667,21573
b9e9795788958e140e5f665087c82990db403ea4,1,Lisnichenko Dmitro,2016-01-12 11:58:23+02:00,['ceea27dbbd86c8b3afeccdd7bb3eec2fb16e2471'],19,280,299,21777449,6,,,,21573
40aac602f69579ee2c245832b40afa5e194b13a0,1,Oleg Nechiporenko,2016-01-12 12:52:02+02:00,['b9e9795788958e140e5f665087c82990db403ea4'],1032,539,1571,21779020,123,1,0,0.090909091,21573
4917a2385e83be80617bce30c1d0d6b1a859d907,1,Vitaly Brodetskyi,2016-01-12 18:03:14+02:00,['40aac602f69579ee2c245832b40afa5e194b13a0'],11,18,29,21779049,2,0,1,1,21573
27a6ecf2df0e2401dd12737e62dd8171fc4a00dc,0,Andrew Onishuk,2016-01-12 18:55:54+02:00,['4917a2385e83be80617bce30c1d0d6b1a859d907'],1,1,2,21779051,1,,,,21573
fd1cc22812ac79ad1701677825da3168a35483cb,0,Jonathan Hurley,2016-01-12 13:32:10-05:00,['27a6ecf2df0e2401dd12737e62dd8171fc4a00dc'],45,135,180,21779231,6,0,0.931034483,0.931034483,21573
0715226fb36c7f1e72ba6cb1c297c69828e33d5e,0,Sumit Mohanty,2016-01-12 10:35:29-08:00,['fd1cc22812ac79ad1701677825da3168a35483cb'],36,19,55,21779286,4,0.2,0.6,0.8,21573
fa7a565bd01e43e3eefb9deb66d572b68e65e99d,1,Yusaku Sako,2016-01-12 10:52:03-08:00,['0715226fb36c7f1e72ba6cb1c297c69828e33d5e'],20,631,651,21779937,13,0.016528926,0.421487603,0.719008264,21574
bfedff0ae7461fb2a405e58a46875b2313417e6d,1,Lisnichenko Dmitro,2016-01-12 20:55:59+02:00,['fa7a565bd01e43e3eefb9deb66d572b68e65e99d'],1,40,41,21779978,2,0.407407407,1,0.333333333,21574
9df40783b1588114d035a47dad47a6d3e2a46a67,1,Alex Antonenko,2016-01-12 21:24:05+02:00,['bfedff0ae7461fb2a405e58a46875b2313417e6d'],1,155,156,21780134,10,0.416666667,1,1,21580
91f4c05c5db25fbf7c2b2475e3201ce2523304b1,0,Jun Aoki,2016-01-12 12:39:53-08:00,['9df40783b1588114d035a47dad47a6d3e2a46a67'],0,250,250,21780384,6,0,1,1,21582
faeb7391277cd2c1039fd58085ab9765c050355d,1,Alejandro Fernandez,2016-01-12 13:08:07-08:00,['91f4c05c5db25fbf7c2b2475e3201ce2523304b1'],14,98,112,21780496,7,,,,21582
96276e693a0b3ae95624947331fe99208a473c02,0,Jun Aoki,2016-01-12 13:31:13-08:00,['faeb7391277cd2c1039fd58085ab9765c050355d'],1,81,82,21780578,2,,,,21582
5c5c70b3fe8bfe5b9b2a5eb62fd5c8454a7529da,0,Alejandro Fernandez,2016-01-12 13:52:47-08:00,['96276e693a0b3ae95624947331fe99208a473c02'],2,2,4,21780582,1,,,,21582
1696aec0cdb6e414ba72b7f843138edda23c0346,1,Oleksandr Diachenko,2016-01-12 14:39:12-08:00,['5c5c70b3fe8bfe5b9b2a5eb62fd5c8454a7529da'],0,47,47,21780629,2,1,0.909090909,1,21583
53aa581586eb66b78c5d3d6a3748015642b4d9e2,1,Oleksandr Diachenko,2016-01-12 14:46:52-08:00,['1696aec0cdb6e414ba72b7f843138edda23c0346'],13,147,160,21780789,2,0.34,0.19,0.79,21583
2c7d84c39c4fa7686f6fe826815420bc25fbd295,0,Oleksandr Diachenko,2016-01-12 14:59:39-08:00,['53aa581586eb66b78c5d3d6a3748015642b4d9e2'],1,3,4,21780793,1,,,,21583
ce5f337ef7540517b0db4a7fb12610ed2d216636,0,Alex Antonenko,2016-01-13 01:42:35+02:00,['2c7d84c39c4fa7686f6fe826815420bc25fbd295'],0,36,36,21780829,2,,,,21583
5f78338310ee666fc4c376fc1be777249c9c5bac,1,Richard Zang,2016-01-12 17:36:51-08:00,['ce5f337ef7540517b0db4a7fb12610ed2d216636'],267,694,961,21781790,2,0.419354839,0.838709677,1,21583
44faf76e03d1b45640ff6cdfc8e73d5725316502,1,Jun Aoki,2016-01-12 18:15:28-08:00,['5f78338310ee666fc4c376fc1be777249c9c5bac'],27,21,48,21781838,3,1,0,0,21583
627f5ad80720b145650b558dda6db9631a8d68f3,1,Jonathan Hurley,2016-01-12 23:23:38-05:00,['44faf76e03d1b45640ff6cdfc8e73d5725316502'],0,4,4,21781842,1,1,1,1,21583
ce40d2864ebfadc011f7407c45616c118e0bab37,1,Jonathan Hurley,2016-01-12 23:23:38-05:00,['627f5ad80720b145650b558dda6db9631a8d68f3'],2,3,5,21781847,1,,,,21583
a251dca1da9df22683370a32a84c772828501c96,1,Andrew Onishuk,2016-01-13 09:19:16+02:00,['ce40d2864ebfadc011f7407c45616c118e0bab37'],8,4,12,21781859,2,0,0,0,21583
1bdc8aeea75fc7a80d8fd6d9ed878c0a9d5260c3,0,Andrew Onishuk,2016-01-13 09:36:43+02:00,['a251dca1da9df22683370a32a84c772828501c96'],2,5,7,21781866,1,0,0,1,21583
8896d892c4b700b0db12d0cee5c56202fd4d194c,0,Andrew Onishuk,2016-01-13 11:36:40+02:00,['1bdc8aeea75fc7a80d8fd6d9ed878c0a9d5260c3'],195,15,210,21782076,7,1,0.014084507,0,21583
a688559755fee0af62b00dd1508dd987358dd9ff,1,Yusaku Sako,2016-01-13 03:30:05-08:00,['8896d892c4b700b0db12d0cee5c56202fd4d194c'],1,90,91,21782167,7,0.303030303,1,1,21583
ce192a4884e4cb60157d813b3d990b7926847372,1,Andrii Tkach,2016-01-13 13:53:26+02:00,['a688559755fee0af62b00dd1508dd987358dd9ff'],111,1625,1736,21783903,15,0.999218139,1,0.992963253,21585
e080e678ac766f407065cdc2c670c9ccdbe5d23e,0,ababiichuk,2016-01-13 14:38:49+02:00,['ce192a4884e4cb60157d813b3d990b7926847372'],0,174,174,21784077,3,1,1,0.853658537,21587
a71727569a7c96adae0c6931564450e8cf42cc67,1,Myroslav Papirkovskyy,2016-01-13 16:26:28+02:00,['e080e678ac766f407065cdc2c670c9ccdbe5d23e'],142,76,218,21784295,5,0.920634921,0.26984127,0.174603175,21587
ac1fbc23d2d9d759cf24e61ba7c5fdf0be434ea4,1,ababiichuk,2016-01-13 17:07:37+02:00,['a71727569a7c96adae0c6931564450e8cf42cc67'],56,583,639,21784934,5,0.696098563,0.995893224,0.921971253,21588
ddba476c7b858faead028c9564f3ebbbf90ce8ab,1,ababiichuk,2016-01-13 17:31:49+02:00,['ac1fbc23d2d9d759cf24e61ba7c5fdf0be434ea4'],37,39,76,21785010,3,0,0,0,21588
014aa6ddb40ba8565d6bffa9c0e8afa11ec1b1ab,0,Alex Antonenko,2016-01-13 17:59:49+02:00,['ddba476c7b858faead028c9564f3ebbbf90ce8ab'],2,4,6,21785016,1,1,1,0,21588
c7c1206a99b414712c61936c015bd27cad6e4e0e,1,Siddharth Wagle,2016-01-13 09:14:36-08:00,['014aa6ddb40ba8565d6bffa9c0e8afa11ec1b1ab'],29,44,73,21785089,10,1,1,1,21588
69c3e0d0e09cae90937797da12fd10ee8004d77b,0,Jun Aoki,2016-01-13 10:55:28-08:00,['c7c1206a99b414712c61936c015bd27cad6e4e0e'],3,55,58,21785147,3,0,1,1,21588
21e855127cc802073ab0b20082871998e2877f38,1,Aleksandr Kovalenko,2016-01-13 21:13:11+02:00,['69c3e0d0e09cae90937797da12fd10ee8004d77b'],38,39,77,21785224,3,1,1,0,21588
b641d5216e5ba20418fc66ec3db6b4da52e1ed13,0,Sumit Mohanty,2016-01-13 11:57:48-08:00,['21e855127cc802073ab0b20082871998e2877f38'],1,1,2,21785226,1,,,,21588
7cacc4093285db5a7271df2d8939c767556fda46,1,tbeerbower,2016-01-13 16:26:28-05:00,['b641d5216e5ba20418fc66ec3db6b4da52e1ed13'],1,368,369,21785595,6,0.8125,1,1,21590
6105ab5f56a08ba27667404aac003c6689b412fb,0,Xi Wang,2016-01-13 13:30:13-08:00,['7cacc4093285db5a7271df2d8939c767556fda46'],5,94,99,21785694,7,1,0.789473684,1,21590
2503b606a159741e3230095837a4e38ae8e28968,1,Nate Cole,2016-01-13 18:04:29-05:00,['6105ab5f56a08ba27667404aac003c6689b412fb'],0,22,22,21785716,5,,,,21590
ff7e363f240173c32f18d16614982ae56e4bb6ef,1,Jun Aoki,2016-01-13 16:15:28-08:00,['2503b606a159741e3230095837a4e38ae8e28968'],11,61,72,21785788,2,1,0.974358974,1,21590
4a2a1949d8ac9759a794d2596b84616864b27145,1,Aravindan Vijayan,2016-01-13 16:56:45-08:00,['ff7e363f240173c32f18d16614982ae56e4bb6ef'],19,62,81,21785869,4,0,0.24137931,0.413793103,21590
2669a7a49f50b6138c22c89000f76dcf0bb7acf3,0,Jonathan Hurley,2016-01-13 22:07:52-05:00,['4a2a1949d8ac9759a794d2596b84616864b27145'],0,16,16,21785885,3,,,,21590
99b800c599f8692b9b009d8804837f5a8e1927b7,0,Aravindan Vijayan,2016-01-13 20:53:27-08:00,['2669a7a49f50b6138c22c89000f76dcf0bb7acf3'],13,19,32,21785917,4,0,0,1,21590
d5d07e767f51b694bd068d82e1f1c52796b12303,1,Andrew Onishuk,2016-01-14 12:44:44+02:00,['99b800c599f8692b9b009d8804837f5a8e1927b7'],0,18,18,21785935,1,0,0,1,21590
8ae2c8b7c78231a486bdba1bbd7c67e1951521bc,1,Oleg Nechiporenko,2016-01-14 13:07:30+02:00,['d5d07e767f51b694bd068d82e1f1c52796b12303'],19,33,52,21785987,3,0,1,1,21590
d0fe0a3292a2c612567bb3fcf240eac920566bee,1,Alex Antonenko,2016-01-14 16:56:20+02:00,['8ae2c8b7c78231a486bdba1bbd7c67e1951521bc'],6,95,101,21786088,4,0.5625,1,1,21590
7e306c555ba9a73b54c8200340789547e8182ec5,1,Nate Cole,2016-01-14 11:43:22-05:00,['e001ed1b3de521d57b2efcf4cc93cafffbea0ec2'],7,7,14,21786102,4,,,,21590
9be679cbeae088d20f01b1966e4d61f83204ac78,0,Nate Cole,2016-01-14 11:43:22-05:00,['7e306c555ba9a73b54c8200340789547e8182ec5'],7,2,9,21786111,1,1,1,0,21590
f3938a99613fd86a3476fca26dbf030189ffd3f7,1,Nate Cole,2016-01-14 11:43:22-05:00,['9be679cbeae088d20f01b1966e4d61f83204ac78'],1,8,9,21786120,1,0,0,1,21590
6eb049f97598c04b77ee142eb2fa1dd2ec6597fe,0,Nate Cole,2016-01-14 11:43:22-05:00,['f3938a99613fd86a3476fca26dbf030189ffd3f7'],0,18,18,21786138,1,,,,21590
6de0124b764af47bf3a916124df03a866e09f913,0,Nate Cole,2016-01-14 11:43:22-05:00,['6eb049f97598c04b77ee142eb2fa1dd2ec6597fe'],18,0,18,21786156,1,,,,21590
dfa9c5673707f3710b438e92a9357ce0e37ed011,0,Nate Cole,2016-01-14 11:43:22-05:00,['6de0124b764af47bf3a916124df03a866e09f913'],0,18,18,21786174,1,,,,21590
7631364161983ca3f9095eff73836c2e3560000b,0,Nate Cole,2016-01-14 11:43:23-05:00,['dfa9c5673707f3710b438e92a9357ce0e37ed011'],262,849,1111,21787285,18,0.271186441,0.886198547,1,21591
a58258dc935124b6e33772f91f81da57a2cab864,1,Nate Cole,2016-01-14 11:43:23-05:00,['7631364161983ca3f9095eff73836c2e3560000b'],22,95,117,21787402,4,1,1,1,21591
b751ef062153cd1ac422412848da5680bccce75c,0,Nate Cole,2016-01-14 11:43:23-05:00,['a58258dc935124b6e33772f91f81da57a2cab864'],5,0,5,21787407,2,,,,21591
363d986095e26101c911b925b8cd6db8b8fa25fa,0,Nate Cole,2016-01-14 11:43:23-05:00,['b751ef062153cd1ac422412848da5680bccce75c'],42,75,117,21787524,2,0,0,0.68,21591
676fee32dba035659728b33b48a37699e82f4178,0,Nate Cole,2016-01-14 11:43:23-05:00,['363d986095e26101c911b925b8cd6db8b8fa25fa'],1,1,2,21787526,1,,,,21591
5b31f8bf0261c0021cf4e738c1bfb8c4ca483784,1,Nate Cole,2016-01-14 11:43:23-05:00,['676fee32dba035659728b33b48a37699e82f4178'],2,2232,2234,21789760,8,,,,21593
b2278d02cb6eb63e28773ac8c09e4ae993377437,0,Nate Cole,2016-01-14 11:43:23-05:00,['5b31f8bf0261c0021cf4e738c1bfb8c4ca483784'],1,204,205,21789965,3,,,,21595
7857a16b4bcc0f5bb42142c1c5ec3cf72715f315,0,Nate Cole,2016-01-14 11:43:24-05:00,['b2278d02cb6eb63e28773ac8c09e4ae993377437'],2,24,26,21789991,1,1,1,1,21595
53c4b6b2fc0c71412a812bc44a59de0d8f9294b1,1,Nate Cole,2016-01-14 11:43:24-05:00,['7857a16b4bcc0f5bb42142c1c5ec3cf72715f315'],1,187,188,21790179,4,0.145833333,0.510416667,0.510416667,21596
7b916e255fe2b986a2e8826f0d8b0fe095998bf2,0,Nate Cole,2016-01-14 11:43:24-05:00,['53c4b6b2fc0c71412a812bc44a59de0d8f9294b1'],19,280,299,21790478,6,,,,21596
c263626ea920c7445788cb08b3a7ca0f4eab4e98,1,Nate Cole,2016-01-14 11:43:24-05:00,['7b916e255fe2b986a2e8826f0d8b0fe095998bf2'],1032,539,1571,21792049,123,1,0,0.090909091,21596
f176b4505da867a3ebe22b5c2b401317c1540e93,0,Nate Cole,2016-01-14 11:43:24-05:00,['c263626ea920c7445788cb08b3a7ca0f4eab4e98'],11,18,29,21792078,2,0,1,1,21596
0afdd9b97ea3db050b8f14071e79b4365053c092,0,Nate Cole,2016-01-14 11:43:24-05:00,['f176b4505da867a3ebe22b5c2b401317c1540e93'],1,1,2,21792080,1,,,,21596
54f0e270fdccd71271650684b04c57f2c079b229,1,Nate Cole,2016-01-14 11:43:24-05:00,['0afdd9b97ea3db050b8f14071e79b4365053c092'],45,135,180,21792260,6,0,0.931034483,0.931034483,21596
ad63e8f1cee0b7f0f1d063b3a096a1a9513cc456,1,Nate Cole,2016-01-14 11:43:25-05:00,['54f0e270fdccd71271650684b04c57f2c079b229'],36,19,55,21792315,4,0.2,0.6,0.8,21596
e310fdab5b15d29b8cc4a6238607e4b5c37e8495,1,Nate Cole,2016-01-14 11:43:25-05:00,['ad63e8f1cee0b7f0f1d063b3a096a1a9513cc456'],20,631,651,21792966,13,0.016528926,0.421487603,0.719008264,21597
f181e9e772266658c285f113c4d3bdf811b51643,1,Nate Cole,2016-01-14 11:43:25-05:00,['e310fdab5b15d29b8cc4a6238607e4b5c37e8495'],1,40,41,21793007,2,0.407407407,1,0.333333333,21597
377901dacbacd62ecd3688bfa934203a760fa2fc,0,Nate Cole,2016-01-14 11:43:25-05:00,['f181e9e772266658c285f113c4d3bdf811b51643'],1,155,156,21793163,10,0.416666667,1,1,21603
5c68080da2f96b087f37958d654ae19509f02292,0,Nate Cole,2016-01-14 11:43:25-05:00,['377901dacbacd62ecd3688bfa934203a760fa2fc'],0,250,250,21793413,6,0,1,1,21605
a1505d55c19dc57ea5cb9ab7f3d93bde5213a616,0,Nate Cole,2016-01-14 11:43:25-05:00,['5c68080da2f96b087f37958d654ae19509f02292'],14,98,112,21793525,7,,,,21605
6fdfcc01efecb3c585bc9f51cfe52c800f00933b,0,Nate Cole,2016-01-14 11:43:25-05:00,['a1505d55c19dc57ea5cb9ab7f3d93bde5213a616'],1,81,82,21793607,2,,,,21605
a7af25247de32b2d337ef92c1e27c85c274ce1cc,0,Nate Cole,2016-01-14 11:43:26-05:00,['6fdfcc01efecb3c585bc9f51cfe52c800f00933b'],2,2,4,21793611,1,,,,21605
019d6f4ccaa3f0fc94bfb7299fa1f98f46a5dade,0,Nate Cole,2016-01-14 11:43:26-05:00,['a7af25247de32b2d337ef92c1e27c85c274ce1cc'],0,47,47,21793658,2,1,0.909090909,1,21606
935173728b2d9344322a98ff4764f69e6ea6c40c,0,Nate Cole,2016-01-14 11:43:26-05:00,['019d6f4ccaa3f0fc94bfb7299fa1f98f46a5dade'],13,147,160,21793818,2,0.34,0.19,0.79,21606
9215d63333d7f38bd649dbce75621278f7a9c73d,0,Nate Cole,2016-01-14 11:43:26-05:00,['935173728b2d9344322a98ff4764f69e6ea6c40c'],1,3,4,21793822,1,,,,21606
48196ea6496c0e6b6e8fb6f53325519f8bfc9bc7,0,Nate Cole,2016-01-14 11:43:26-05:00,['9215d63333d7f38bd649dbce75621278f7a9c73d'],0,36,36,21793858,2,,,,21606
4b2a6e9e8a4aac9ec6f7125339555e82261b4ef5,0,Nate Cole,2016-01-14 11:43:26-05:00,['48196ea6496c0e6b6e8fb6f53325519f8bfc9bc7'],267,694,961,21794819,2,0.419354839,0.838709677,1,21606
ec580b1d161a0a1ba1f74243686dfb799e8bc968,0,Nate Cole,2016-01-14 11:43:27-05:00,['4b2a6e9e8a4aac9ec6f7125339555e82261b4ef5'],27,21,48,21794867,3,1,0,0,21606
e86e44e8d0391e0f9cc63fec80c7332dfac4cd1b,0,Nate Cole,2016-01-14 11:43:27-05:00,['ec580b1d161a0a1ba1f74243686dfb799e8bc968'],0,4,4,21794871,1,1,1,1,21606
4758c3b099c610aae8269703151b67217b1d4312,0,Nate Cole,2016-01-14 11:43:27-05:00,['e86e44e8d0391e0f9cc63fec80c7332dfac4cd1b'],2,3,5,21794876,1,,,,21606
b7af5219b25aed42e52be440b475736d8490dc5e,0,Nate Cole,2016-01-14 11:43:27-05:00,['4758c3b099c610aae8269703151b67217b1d4312'],8,4,12,21794888,2,0,0,0,21606
61e81e60ad7c0a4f8e1bf75f98339e55708c7d22,0,Nate Cole,2016-01-14 11:43:27-05:00,['b7af5219b25aed42e52be440b475736d8490dc5e'],2,5,7,21794895,1,0,0,1,21606
1d96f61a78146b7c382709fc9acb06d54201e3f5,0,Nate Cole,2016-01-14 11:43:27-05:00,['61e81e60ad7c0a4f8e1bf75f98339e55708c7d22'],195,15,210,21795105,7,1,0.014084507,0,21606
74e7cc440c030e55cef4b41fff046fc0ab531343,1,Nate Cole,2016-01-14 11:43:27-05:00,['1d96f61a78146b7c382709fc9acb06d54201e3f5'],1,90,91,21795196,7,0.303030303,1,1,21606
fee1c3aa1f909f3fb5abba474cf9badf33f919ed,1,Nate Cole,2016-01-14 11:43:27-05:00,['74e7cc440c030e55cef4b41fff046fc0ab531343'],111,1625,1736,21796932,15,0.999218139,1,0.992963253,21608
aa4e3ce3687a23c18c3444f7ac62808d2ea9c48c,0,Nate Cole,2016-01-14 11:43:28-05:00,['fee1c3aa1f909f3fb5abba474cf9badf33f919ed'],0,174,174,21797106,3,1,1,0.853658537,21610
0088bf712b358ce7d59c10112b0201c414f76366,0,Nate Cole,2016-01-14 11:43:28-05:00,['aa4e3ce3687a23c18c3444f7ac62808d2ea9c48c'],142,76,218,21797324,5,0.920634921,0.26984127,0.174603175,21610
b3b17874ae52559e50ae91fa64120b71831b90b8,1,Nate Cole,2016-01-14 11:43:28-05:00,['0088bf712b358ce7d59c10112b0201c414f76366'],56,583,639,21797963,5,0.696098563,0.995893224,0.921971253,21611
503d28e1811f0c6c4955441ba6bda746741419b6,0,Nate Cole,2016-01-14 11:43:28-05:00,['b3b17874ae52559e50ae91fa64120b71831b90b8'],37,39,76,21798039,3,0,0,0,21611
b36dc287a0bb469823475e5d60c37ea6cdb94f79,0,Nate Cole,2016-01-14 11:43:28-05:00,['503d28e1811f0c6c4955441ba6bda746741419b6'],2,4,6,21798045,1,1,1,0,21611
7300277ae5cc26bcd00d839934c432fab067796e,1,Nate Cole,2016-01-14 11:43:28-05:00,['b36dc287a0bb469823475e5d60c37ea6cdb94f79'],29,44,73,21798118,10,1,1,1,21611
c0e2269247efb2d8fecec21cfa741d8a7fd827bb,0,Nate Cole,2016-01-14 11:43:28-05:00,['7300277ae5cc26bcd00d839934c432fab067796e'],3,55,58,21798176,3,0,1,1,21611
fea14c271d9b73e541cd401eea5844bd8c3fd270,1,Nate Cole,2016-01-14 11:43:29-05:00,['c0e2269247efb2d8fecec21cfa741d8a7fd827bb'],38,39,77,21798253,3,1,1,0,21611
283560d560727fceda57b5546e8056a311f01493,0,Nate Cole,2016-01-14 11:43:29-05:00,['fea14c271d9b73e541cd401eea5844bd8c3fd270'],1,1,2,21798255,1,,,,21611
8eea78fc5fb1f00bc18166963599ad0e93bd2528,1,Nate Cole,2016-01-14 11:43:29-05:00,['283560d560727fceda57b5546e8056a311f01493'],1,368,369,21798624,6,0.8125,1,1,21613
f8faa4ebac446f0de2d467c5bc06f380e84b768d,1,Nate Cole,2016-01-14 11:43:29-05:00,['8eea78fc5fb1f00bc18166963599ad0e93bd2528'],5,94,99,21798723,7,1,0.789473684,1,21613
92abe3de5fc6c45ffad5b07cb958879f43ab61d0,0,Nate Cole,2016-01-14 11:43:29-05:00,['f8faa4ebac446f0de2d467c5bc06f380e84b768d'],0,22,22,21798745,5,,,,21613
665d9e4c3967425564f5a9e39263c28790c5e03f,1,Nate Cole,2016-01-14 11:43:29-05:00,['92abe3de5fc6c45ffad5b07cb958879f43ab61d0'],11,61,72,21798817,2,1,0.974358974,1,21613
9e6078623b2d14923b18ccfedd426769dcf32559,0,Nate Cole,2016-01-14 11:43:29-05:00,['665d9e4c3967425564f5a9e39263c28790c5e03f'],19,62,81,21798898,4,0,0.24137931,0.413793103,21613
ba50c8b6c705b6e34ea71850b143a6e0f9792bb3,0,Nate Cole,2016-01-14 11:43:29-05:00,['9e6078623b2d14923b18ccfedd426769dcf32559'],0,16,16,21798914,3,,,,21613
8796f5e21cc0b9d95e595354f28a5ae722eba4f4,0,Nate Cole,2016-01-14 11:43:30-05:00,['ba50c8b6c705b6e34ea71850b143a6e0f9792bb3'],13,19,32,21798946,4,0,0,1,21613
dfcea581e87f391199bc7bddf68a5675fc678303,0,Nate Cole,2016-01-14 11:43:30-05:00,['8796f5e21cc0b9d95e595354f28a5ae722eba4f4'],0,18,18,21798964,1,0,0,1,21613
121481ce11a1e8af90febc995f14d21222716fcf,0,Nate Cole,2016-01-14 11:43:30-05:00,['dfcea581e87f391199bc7bddf68a5675fc678303'],19,33,52,21799016,3,0,1,1,21613
5da392b7be39ad94f0fd7ca36379d8ffb3d3564e,1,Nate Cole,2016-01-14 11:43:30-05:00,['121481ce11a1e8af90febc995f14d21222716fcf'],6,95,101,21799117,4,0.5625,1,1,21613
5289cb66a50f132afb8fb02b0b843e6e62123963,1,Yusaku Sako,2016-01-14 09:56:35-08:00,['d0fe0a3292a2c612567bb3fcf240eac920566bee'],4,12,16,21799133,2,0,0.25,1,21613
7d07b6bac86e67b24d471083ad2fafa9b2554940,1,Jonathan Hurley,2016-01-14 13:18:14-05:00,['5289cb66a50f132afb8fb02b0b843e6e62123963'],17,70,87,21799220,7,0.857142857,0.857142857,0.857142857,21613
2cd2e38978746f8cc92d1022bd1a60007c9b449d,1,Yusaku Sako,2016-01-14 10:25:34-08:00,['7d07b6bac86e67b24d471083ad2fafa9b2554940'],1,1,2,21799222,1,,,,21613
8e86ef183992bddce0f1c355b340ba1b274d2f61,1,Bob Nettleton,2016-01-14 13:59:51-05:00,['2cd2e38978746f8cc92d1022bd1a60007c9b449d'],21,192,213,21799435,3,0.325,0.683333333,0.983333333,21613
bb887c9d316861d717d957ca592bb2f2680b9d03,0,Jun Aoki,2016-01-14 12:41:12-08:00,['8e86ef183992bddce0f1c355b340ba1b274d2f61'],119,0,119,21799554,2,0.513043478,0.07826087,0,21613
b59a34ff10d042773eda489477d3bae99530387d,1,Yusaku Sako,2016-01-14 14:41:45-08:00,['bb887c9d316861d717d957ca592bb2f2680b9d03'],70,17,87,21799641,7,0.142857143,0.142857143,0.142857143,21613
ff0d72d1932e1377ea35134df5df94bf63fdb1cd,1,Jonathan Hurley,2016-01-14 18:00:22-05:00,['b59a34ff10d042773eda489477d3bae99530387d'],21,74,95,21799736,8,0.857142857,0.857142857,0.857142857,21613
b880a7d5a3f9773f34d489b9dab52f9798b379ec,0,Richard Zang,2016-01-14 17:44:13-08:00,['ff0d72d1932e1377ea35134df5df94bf63fdb1cd'],177,9,186,21799922,3,1,1,1,21613
9d39ab2e4cfb8534ce18acbb3589edfa475152bc,1,Jaimin Jetly,2016-01-14 17:52:11-08:00,['b880a7d5a3f9773f34d489b9dab52f9798b379ec'],123,161,284,21800206,8,0.379310345,0.413793103,1,21613
10a07da8febd0b0c19956aba63096e63c04e8f48,0,Andrew Onishuk,2016-01-15 12:35:02+02:00,['9d39ab2e4cfb8534ce18acbb3589edfa475152bc'],0,13,13,21800219,1,1,1,1,21613
fad7367ef5fb42064a7a10a90b091b66ec4f27fd,1,Andrii Tkach,2016-01-15 13:05:26+02:00,['10a07da8febd0b0c19956aba63096e63c04e8f48'],9,211,220,21800439,5,1,1,1,21613
a14444e6a4d7e44241dd9e01019a30a6c0823d7f,1,Oleg Nechiporenko,2016-01-15 13:20:21+02:00,['fad7367ef5fb42064a7a10a90b091b66ec4f27fd'],167,316,483,21800922,7,1,1,1,21613
696c404a2e15d3d892faad0af9ad63f35a34dae3,0,Andrew Onishuk,2016-01-15 13:52:39+02:00,['a14444e6a4d7e44241dd9e01019a30a6c0823d7f'],12,19,31,21800953,1,0,0,1,21613
07bfbc4fe1c594c69db035ac85dcd5de7e997a74,1,Andrew Onishuk,2016-01-15 15:46:43+02:00,['696c404a2e15d3d892faad0af9ad63f35a34dae3'],2,19,21,21800974,2,,,,21613
672fb60859e4d6e0d97809c30871ca9e27e9193c,0,Andrew Onishuk,2016-01-15 15:57:28+02:00,['07bfbc4fe1c594c69db035ac85dcd5de7e997a74'],0,3,3,21800977,1,,,,21613
e0957d397a2780683cc3387c30359c68669a9343,1,Myroslav Papirkovskyy,2016-01-15 16:25:41+02:00,['672fb60859e4d6e0d97809c30871ca9e27e9193c'],0,174,174,21801151,3,0,1,1,21614
b9226d3ea9d75cc37a505fd8730d91324c5659e0,1,Andrew Onishuk,2016-01-15 16:41:19+02:00,['e0957d397a2780683cc3387c30359c68669a9343'],1,32,33,21801184,2,0.55,1,1,21614
fa6b943de81b799ebb2d63d98f965c2515ca57ec,1,Andrew Onishuk,2016-01-15 16:54:49+02:00,['b9226d3ea9d75cc37a505fd8730d91324c5659e0'],1,135,136,21801320,8,0.014084507,0.647887324,1,21614
d212ea58bd515840ee3f25321b9181e9c258eb30,0,Oleg Nechiporenko,2016-01-15 18:27:52+02:00,['fa6b943de81b799ebb2d63d98f965c2515ca57ec'],163,101,264,21801584,2,0,0.12,0,21614
deb15171388ae965fdda92467378908ca09c0f8d,0,Dmytro Sen,2016-01-15 18:29:37+02:00,['d212ea58bd515840ee3f25321b9181e9c258eb30'],9,75,84,21801668,3,0.222222222,0.222222222,1,21615
fb628379aff3042288c75cde11157bd212458a0c,1,Oleg Nechiporenko,2016-01-15 18:59:41+02:00,['deb15171388ae965fdda92467378908ca09c0f8d'],93,125,218,21801886,15,1,1,1,21615
ee623b7ff2b58c3a957a745a9351c3899e650f9b,1,Nate Cole,2016-01-15 12:30:36-05:00,['5da392b7be39ad94f0fd7ca36379d8ffb3d3564e'],207,597,804,21802690,20,0.354330709,1,1,21618
eaf27bfd65b2ca4966476b3871cde73805570c16,1,Jonathan Hurley,2016-01-15 15:00:21-05:00,['fb628379aff3042288c75cde11157bd212458a0c'],61,154,215,21802905,4,0,0.950819672,1,21618
a329199047c7b0566c14653c56a669a6ebf4369e,1,Vitaly Brodetskyi,2016-01-15 19:38:03+02:00,['eaf27bfd65b2ca4966476b3871cde73805570c16'],10,21,31,21802936,3,0,0,1,21618
9e4708876db6d6cc7fbaab4fdba3b87b1ba3e660,0,Vitaly Brodetskyi,2016-01-15 20:41:32+02:00,['a329199047c7b0566c14653c56a669a6ebf4369e'],4,5,9,21802945,2,0,1,1,21618
0fa6d9fda5b77cd6215fc6755591e1fd40206234,0,Nate Cole,2016-01-15 13:51:27-05:00,"['ee623b7ff2b58c3a957a745a9351c3899e650f9b', 'fb628379aff3042288c75cde11157bd212458a0c']",889,1687,2576,21805521,72,,,,21618
98bf536a7369d3e7af27c1ff52b6a3284d3bc723,0,Nate Cole,2016-01-15 14:30:52-05:00,['0fa6d9fda5b77cd6215fc6755591e1fd40206234'],51,1,52,21805573,3,0,0,0,21618
5436fa243ce68a92e273555a0a458c6da2c6995e,1,Alex Antonenko,2016-01-15 23:23:02+02:00,['9e4708876db6d6cc7fbaab4fdba3b87b1ba3e660'],103,281,384,21805957,15,0.6484375,0.515625,1,21618
846b4ab9086ce141a722bcdc086e47fa4110e011,1,Sumit Mohanty,2016-01-15 14:08:04-08:00,['5436fa243ce68a92e273555a0a458c6da2c6995e'],10,20,30,21805987,3,0.25,0.5,0.125,21618
9ab4b5e6f49005bed3b077d7d12fce08b6445342,0,Jun Aoki,2016-01-15 15:11:41-08:00,['846b4ab9086ce141a722bcdc086e47fa4110e011'],2,6,8,21805995,3,0,0,1,21618
9404e2439f3b9a740a5ecaf303d4ea2586b503bc,1,Aravindan Vijayan,2016-01-15 15:24:20-08:00,['9ab4b5e6f49005bed3b077d7d12fce08b6445342'],10,7,17,21806012,4,1,1,0,21618
a385f77ffad58d8e4c6b530c8b64ad85e2d0dd52,0,Nate Cole,2016-01-16 09:47:25-05:00,"['98bf536a7369d3e7af27c1ff52b6a3284d3bc723', '9404e2439f3b9a740a5ecaf303d4ea2586b503bc']",200,494,694,21806706,33,,,,21618
6e9d25cafa4c7d91828b3c33cea6e26f96c2a736,1,Sumit Mohanty,2016-01-16 09:30:56-08:00,['9404e2439f3b9a740a5ecaf303d4ea2586b503bc'],1,47,48,21806754,2,0,0,0,21619
8f2c5dd1eb032075bc7ddc227385621e5a47df69,1,Aravindan Vijayan,2016-01-17 10:55:43-08:00,['6e9d25cafa4c7d91828b3c33cea6e26f96c2a736'],0,55,55,21806809,3,0.236842105,0.815789474,0.973684211,21619
4876cf6109a33bef6c44705df2b49f3f8341850b,1,Andrii Tkach,2016-01-18 12:46:10+02:00,['8f2c5dd1eb032075bc7ddc227385621e5a47df69'],2,101,103,21806912,3,1,1,0.95,21619
5164bc54fe218026102b13446afc7b48f8c710c8,1,Andrew Onishuk,2016-01-18 14:21:15+02:00,['4876cf6109a33bef6c44705df2b49f3f8341850b'],28,77,105,21807017,9,1,0.44,0.48,21619
f40df6b57819f749993547c8e17e74493d354e84,0,Nate Cole,2016-01-18 08:31:02-05:00,"['a385f77ffad58d8e4c6b530c8b64ad85e2d0dd52', '5164bc54fe218026102b13446afc7b48f8c710c8']",31,280,311,21807328,17,,,,21619
40aa6121fa9cc0a3a39f02b2fb7acbe612f426ad,0,Andrew Onishuk,2016-01-18 17:02:29+02:00,['5164bc54fe218026102b13446afc7b48f8c710c8'],5,5,10,21807338,1,,,,21619
ba3db6d79b7204b6fcf3e105d7aa4a472ca451b0,1,Sumit Mohanty,2016-01-18 08:39:13-08:00,['40aa6121fa9cc0a3a39f02b2fb7acbe612f426ad'],8,62,70,21807408,3,0.117647059,1,0.941176471,21619
8684e45065b3849b9ba86588309f75c535cde39b,0,Aravindan Vijayan,2016-01-18 09:22:15-08:00,['ba3db6d79b7204b6fcf3e105d7aa4a472ca451b0'],11,0,11,21807419,1,1,1,0,21619
36af9bba684278f40c93eb7e80687f9bcec8f86f,1,Alex Antonenko,2016-01-18 19:33:05+02:00,['8684e45065b3849b9ba86588309f75c535cde39b'],1,1,2,21807421,1,,,,21619
0cbefb3e6ceebea32d71461152aa1f141a8ed5d6,1,Robert Levas,2016-01-18 13:36:02-05:00,['36af9bba684278f40c93eb7e80687f9bcec8f86f'],16,49,65,21807486,1,0,1,1,21619
342363ff0d2192eea3e87949adad1c725a4b871e,1,Jun Aoki,2016-01-18 11:06:24-08:00,['0cbefb3e6ceebea32d71461152aa1f141a8ed5d6'],2,2,4,21807490,1,,,,21619
21b6b31696718f5190a5b2cd52c469b097e00ffa,1,Jaimin Jetly,2016-01-18 11:20:58-08:00,['342363ff0d2192eea3e87949adad1c725a4b871e'],3,53,56,21807546,2,0.269230769,1,1,21619
132c5350e40be4964b88d6f3feca275457523d92,1,Jun Aoki,2016-01-18 13:10:51-08:00,['21b6b31696718f5190a5b2cd52c469b097e00ffa'],0,68,68,21807614,2,0,0.88372093,0.88372093,21619
f3ffe0c2094bd619cffbdd2daf4a0aa7e033f128,1,Robert Levas,2016-01-18 20:01:29-05:00,['132c5350e40be4964b88d6f3feca275457523d92'],70,362,432,21808046,13,0.015544041,0.186528497,0.310880829,21619
cbed6402604d7e80a017c358a131191706255e16,1,Alejandro Fernandez,2016-01-18 19:17:15-08:00,['f3ffe0c2094bd619cffbdd2daf4a0aa7e033f128'],280,520,800,21808846,23,0.081632653,0.469387755,0.989795918,21620
58903d89cf0cd50507b6cfddc25c405d6f725c5c,1,Sumit Mohanty,2016-01-18 20:13:37-08:00,['cbed6402604d7e80a017c358a131191706255e16'],0,80,80,21808926,7,,,,21620
869e0858ccd835baa53ec3b88f50439cdecfd2c7,0,Gautam Borad,2016-01-19 09:44:21+05:18,['58903d89cf0cd50507b6cfddc25c405d6f725c5c'],10,6,16,21808942,2,1,0,0,21620
39400f4e97233a9d19391a28a0e47008a270d316,1,Andrii Tkach,2016-01-19 11:37:45+02:00,['869e0858ccd835baa53ec3b88f50439cdecfd2c7'],9,31,40,21808982,3,1,1,1,21620
1c2c6a9f6678931936585761a242651b8a6871ce,0,Andrew Onishuk,2016-01-19 14:15:03+02:00,['39400f4e97233a9d19391a28a0e47008a270d316'],28,3,31,21809013,7,1,0.083333333,0,21620
48246c9fbdbe13b73e9851df58c1813fc134f635,1,Andrew Onishuk,2016-01-19 15:48:11+02:00,['1c2c6a9f6678931936585761a242651b8a6871ce'],5,48,53,21809066,2,0,0.034482759,0.034482759,21620
8f6b45d5a13179cc49d0d4a857c5c157d757bb11,1,Andrew Onishuk,2016-01-19 17:03:11+02:00,['48246c9fbdbe13b73e9851df58c1813fc134f635'],145,12,157,21809223,8,0.85106383,0.510638298,0.510638298,21620
07b8a3ab2c8fa72a9f8d63fa5564a1f13835e26c,1,ababiichuk,2016-01-19 17:20:25+02:00,['8f6b45d5a13179cc49d0d4a857c5c157d757bb11'],20,38,58,21809281,5,1,1,0.733333333,21620
09d3e8bd636b8a4cf150d3b6b62c9738ee46bc2b,0,Nate Cole,2016-01-19 12:48:38-05:00,['07b8a3ab2c8fa72a9f8d63fa5564a1f13835e26c'],0,19,19,21809300,1,,,,21620
4b36397ffd14f2afed81f0c8d16ce2d2e709530f,0,Nate Cole,2016-01-19 13:26:47-05:00,"['f40df6b57819f749993547c8e17e74493d354e84', '09d3e8bd636b8a4cf150d3b6b62c9738ee46bc2b']",613,1359,1972,21811272,78,,,,21620
822be76931129eabf218eaf0682394c1e6431478,1,Alex Antonenko,2016-01-19 21:32:01+02:00,['09d3e8bd636b8a4cf150d3b6b62c9738ee46bc2b'],101,163,264,21811536,2,1,0.88,1,21620
d32f36eb60180d5de97568487eadfd86d90822b1,1,Yusaku Sako,2016-01-19 14:20:23-08:00,['822be76931129eabf218eaf0682394c1e6431478'],2,85,87,21811623,4,1,0.696969697,0.757575758,21621
2e6aaf58e31928721350b026b1c4e8da9e3c48f5,1,Siddharth Wagle,2016-01-19 15:36:22-08:00,['d32f36eb60180d5de97568487eadfd86d90822b1'],36,61,97,21811720,3,0.5,1,1,21621
f42a1a81c371fee1f9d830d0064d403b47082f88,1,Alejandro Fernandez,2016-01-19 16:45:21-08:00,['2e6aaf58e31928721350b026b1c4e8da9e3c48f5'],14,385,399,21812119,14,0,0,0,21624
3f59c1f8dfa0d1207b066166e1e774192da0650e,0,Yusaku Sako,2016-01-19 17:26:30-08:00,['f42a1a81c371fee1f9d830d0064d403b47082f88'],12,36,48,21812167,1,,,,21624
5990fabf51683ff99043892c2e256c9cf6e4a1a6,0,ababiichuk,2016-01-20 11:24:25+02:00,['3f59c1f8dfa0d1207b066166e1e774192da0650e'],2,4,6,21812173,1,1,1,1,21624
a7a979623179f060fabba493b70e211d0af1356f,0,Alex Antonenko,2016-01-20 18:10:48+02:00,['5990fabf51683ff99043892c2e256c9cf6e4a1a6'],3,19,22,21812195,3,0,0,1,21624
8b7aa920bb7d34361e4b2ee2059c547fe01ca238,1,Aleksandr Kovalenko,2016-01-20 19:00:23+02:00,['a7a979623179f060fabba493b70e211d0af1356f'],132,184,316,21812511,4,1,0.384615385,1,21624
f31a06dafc5b6a6a3f0162de5c9b0d09c5e489aa,0,Nate Cole,2016-01-20 12:03:51-05:00,"['4b36397ffd14f2afed81f0c8d16ce2d2e709530f', 'a7a979623179f060fabba493b70e211d0af1356f']",170,753,923,21813434,27,,,,21624
fc402ebc50929f30224481d605325157cb302ec9,1,Nate Cole,2016-01-20 12:04:15-05:00,['f31a06dafc5b6a6a3f0162de5c9b0d09c5e489aa'],16,348,364,21813798,6,0.050847458,0.903954802,1,21625
9f76f6019d09464e0f3fd04aba3b02bf059d003d,1,Andrew Onishuk,2016-01-20 19:08:04+02:00,['8b7aa920bb7d34361e4b2ee2059c547fe01ca238'],80,184,264,21814062,47,1,0.87755102,1,21626
ddf479ef9ef1f4754cbfae075f0a9f36d99c901e,1,Oleg Nechiporenko,2016-01-20 19:19:39+02:00,['9f76f6019d09464e0f3fd04aba3b02bf059d003d'],1763,1151,2914,21816976,77,0.223443223,0,0,21626
862336189317b6dab6e86377049532d5264f0636,1,Mahadev Konar,2016-01-20 10:32:35-08:00,['ddf479ef9ef1f4754cbfae075f0a9f36d99c901e'],3,28,31,21817007,7,0,0.916666667,1,21626
f8fe788a2d208acff4a88fc5a1a17549cfe16100,1,Bob Nettleton,2016-01-20 13:33:18-05:00,['862336189317b6dab6e86377049532d5264f0636'],2,33,35,21817042,2,0.666666667,1,1,21626
2c80cab2fef0167da13ec1836c5ba98fdc897c0b,0,Andrew Onishuk,2016-01-20 21:19:09+02:00,['f8fe788a2d208acff4a88fc5a1a17549cfe16100'],26,0,26,21817068,6,1,0.083333333,0,21626
6225849e6910413a5c5810c18c22225a7ca862ed,1,Alex Antonenko,2016-01-20 22:20:48+02:00,['2c80cab2fef0167da13ec1836c5ba98fdc897c0b'],34,86,120,21817188,6,0.939393939,1,1,21626
109311d5280cd453d1487434fdabaa274f865197,1,Alejandro Fernandez,2016-01-20 13:35:43-08:00,['6225849e6910413a5c5810c18c22225a7ca862ed'],0,83,83,21817271,10,,,,21626
03a0f9f508a3a32e21f4124f89b6ab9badd873ad,1,Jun Aoki,2016-01-20 14:54:28-08:00,['109311d5280cd453d1487434fdabaa274f865197'],3,3,6,21817277,1,,,,21626
5380fefdee8c73780d9a40e00e68e53f4d665c9c,1,Jun Aoki,2016-01-20 16:01:14-08:00,['03a0f9f508a3a32e21f4124f89b6ab9badd873ad'],1,377,378,21817655,5,0.643312102,1,0.891719745,21629
a8887eb175afdc0e9340647a83e0f02cddbfdb8b,1,Vitaly Brodetskyi,2016-01-21 09:32:58+02:00,['5380fefdee8c73780d9a40e00e68e53f4d665c9c'],0,429,429,21818084,3,0.291666667,0.527777778,1,21631
c9bb7319e75b3c50031296dfd29bcd7a10f3fa87,0,Oleg Nechiporenko,2016-01-21 14:26:33+02:00,['a8887eb175afdc0e9340647a83e0f02cddbfdb8b'],2,1,3,21818087,1,1,0,0,21631
b0aeefc87daa7ed8040032a2998764f27bbdaa8d,0,Dmytro Sen,2016-01-21 15:28:25+02:00,['c9bb7319e75b3c50031296dfd29bcd7a10f3fa87'],3,3,6,21818093,2,,,,21631
3c455299d4a189ac27ea3c1473b6a38ff1192c39,1,Dmytro Sen,2016-01-21 15:59:56+02:00,['b0aeefc87daa7ed8040032a2998764f27bbdaa8d'],5,5,10,21818103,2,,,,21631
1217a56dcfba4ffec9ec87c4baa12790b31b45a2,1,Andrew Onishuk,2016-01-21 16:11:29+02:00,['3c455299d4a189ac27ea3c1473b6a38ff1192c39'],2,2,4,21818107,2,,,,21631
59ed986cfdab8632e610a7eff9271009b011151d,1,Andrew Onishuk,2016-01-21 19:39:06+02:00,['1217a56dcfba4ffec9ec87c4baa12790b31b45a2'],2,2,4,21818111,2,,,,21631
a9c644f94b9c03e47a7be518a5873428635a1fc4,1,Myroslav Papirkovskyy,2016-01-21 20:20:36+02:00,['59ed986cfdab8632e610a7eff9271009b011151d'],5,75,80,21818191,5,0,0.818181818,1,21631
780cb6912306beee5fad9b93652045d98ccdc362,1,Aravindan Vijayan,2016-01-21 10:21:54-08:00,['a9c644f94b9c03e47a7be518a5873428635a1fc4'],8,214,222,21818413,3,0.160305344,1,1,21633
77ea2eba044f7ca9761e6e77799751d1b3a9f263,1,Alejandro Fernandez,2016-01-21 11:14:54-08:00,['780cb6912306beee5fad9b93652045d98ccdc362'],34,192,226,21818639,23,0.169491525,0.06779661,1,21634
abc961a13a15cdced7bb3678e4ac67364ba656aa,0,Nate Cole,2016-01-21 14:20:49-05:00,"['fc402ebc50929f30224481d605325157cb302ec9', '77ea2eba044f7ca9761e6e77799751d1b3a9f263']",2076,3023,5099,21823738,194,,,,21634
8f7576f20d60da75b06f16e7e3dee1cf1089f94c,1,Richard Zang,2016-01-22 05:27:13+08:00,['77ea2eba044f7ca9761e6e77799751d1b3a9f263'],103,138,241,21823979,5,1,1,1,21635
cddb46fe0c8b580d5cf0bb5ee0cdf1de50d1be7b,1,Richard Zang,2016-01-22 07:09:34+08:00,['8f7576f20d60da75b06f16e7e3dee1cf1089f94c'],0,43,43,21824022,4,0.833333333,0.833333333,1,21635
a471ce2acdb94a3f5a98a2158e3bd17223baf74b,1,Alejandro Fernandez,2016-01-21 15:50:53-08:00,['cddb46fe0c8b580d5cf0bb5ee0cdf1de50d1be7b'],0,9,9,21824031,2,,,,21636
662da80776c86502049665f435a7c81c26273d44,1,Oleg Nechiporenko,2016-01-22 09:57:47+02:00,['a471ce2acdb94a3f5a98a2158e3bd17223baf74b'],10,15,25,21824056,2,0.857142857,1,1,21636
8bf8539565f69a19637f0b8283c851c14b2a0f92,0,Andrew Onishuk,2016-01-22 14:13:03+02:00,['662da80776c86502049665f435a7c81c26273d44'],19,19,38,21824094,1,,,,21636
1d2b8ef1529c4ee7326de1c87eba15ca8c021f8a,1,Alex Antonenko,2016-01-22 14:18:44+02:00,['8bf8539565f69a19637f0b8283c851c14b2a0f92'],270,413,683,21824777,28,0,0.689320388,0.40776699,21636
8177bbb2d5c9e553fbc405c9d913c9c1999358c0,1,Alex Antonenko,2016-01-22 14:18:44+02:00,['1d2b8ef1529c4ee7326de1c87eba15ca8c021f8a'],1,128,129,21824906,10,1,1,1,21639
277677746a3a6fe72fa073d450aa92b648d2a7d8,1,Aleksandr Kovalenko,2016-01-22 14:31:57+02:00,['8177bbb2d5c9e553fbc405c9d913c9c1999358c0'],7,7,14,21824920,1,,,,21639
880506c7027c80c1fd7c8e51535980d87b0f04fd,0,Alex Antonenko,2016-01-22 14:56:30+02:00,['277677746a3a6fe72fa073d450aa92b648d2a7d8'],42,152,194,21825114,21,0.805825243,1,1,21639
e9b167e25e3476b538b829c707f5ae04c4f819b7,1,Alex Antonenko,2016-01-22 15:02:02+02:00,['880506c7027c80c1fd7c8e51535980d87b0f04fd'],152,42,194,21825308,21,0.194174757,0,0,21639
034cb321b7407be77dd7754d369c1b29de161436,0,Andrii Tkach,2016-01-22 15:35:31+02:00,['e9b167e25e3476b538b829c707f5ae04c4f819b7'],20,66,86,21825394,2,1,1,1,21639
6f6a7ce72986b20538fbf0578615ebc71ca0813b,1,Andrew Onishuk,2016-01-22 15:50:20+02:00,['034cb321b7407be77dd7754d369c1b29de161436'],2,4,6,21825400,1,0,0,0,21639
209724a2c7115bd44b0fd3b8f3507090b40b5a67,0,Aleksandr Kovalenko,2016-01-22 16:07:52+02:00,['6f6a7ce72986b20538fbf0578615ebc71ca0813b'],0,2,2,21825402,1,0,0,0,21639
cc0b752c9c7749601a024ca2f567049bab7d3727,0,Myroslav Papirkovskyy,2016-01-22 16:53:37+02:00,['209724a2c7115bd44b0fd3b8f3507090b40b5a67'],2,2,4,21825406,1,,,,21639
8d329087bc39d4089866aba68f3f7ae2fcd76442,0,Nate Cole,2016-01-22 12:03:58-05:00,['cc0b752c9c7749601a024ca2f567049bab7d3727'],4,0,4,21825410,1,,,,21639
f2a44a7e101cfdd9ff30abcc2bf36127a7ce75e9,0,Nahappan Somasundaram,2016-01-22 10:15:13-08:00,['8d329087bc39d4089866aba68f3f7ae2fcd76442'],8,1048,1056,21826466,11,0.605726872,0.907488987,0.947136564,21646
5acbc4d832b0c8b14d76578c783bfb8f94523b15,1,Srimanth Gunturi,2016-01-22 10:41:42-08:00,['f2a44a7e101cfdd9ff30abcc2bf36127a7ce75e9'],25,451,476,21826942,12,0.386792453,0.924528302,0.858490566,21649
7485883f38d2604885edc17c478a8fbac2f39a0c,1,Andrii Tkach,2016-01-22 20:43:08+02:00,['5acbc4d832b0c8b14d76578c783bfb8f94523b15'],5,167,172,21827114,5,0.847682119,0.98013245,1,21649
3765a3905588d14fe14d985e236616a5b6f127da,1,Oleksandr Diachenko,2016-01-22 11:00:27-08:00,['7485883f38d2604885edc17c478a8fbac2f39a0c'],43,140,183,21827297,4,0.522727273,1,1,21649
c4f643ab9c6596da508c61de757fee05e3ff3568,1,Myroslav Papirkovskyy,2016-01-22 21:46:37+02:00,['3765a3905588d14fe14d985e236616a5b6f127da'],12,11,23,21827320,2,1,1,0,21649
c305bc9f30ec07a46cd492e44bb9f1247441404f,0,Oleksandr Diachenko,2016-01-22 14:04:19-08:00,['c4f643ab9c6596da508c61de757fee05e3ff3568'],50,0,50,21827370,5,0,0,0,21649
0776956c1a85a932ed39a7e362e368997e6e6df2,0,Jun Aoki,2016-01-22 18:15:54-08:00,['c305bc9f30ec07a46cd492e44bb9f1247441404f'],13,5,18,21827388,2,1,0,0,21649
1be4be17bdc3c180b664def7238e17a2a432815b,1,Myroslav Papirkovskyy,2016-01-23 15:37:59+02:00,['0776956c1a85a932ed39a7e362e368997e6e6df2'],5,5,10,21827398,2,,,,21649
e94362c35e0a046dcd7ab802cbf258ce603780c6,1,Myroslav Papirkovskyy,2016-01-23 20:27:28+02:00,['1be4be17bdc3c180b664def7238e17a2a432815b'],12,5,17,21827415,1,0,0.4,0,21649
eaf8cc4cd2015456307ff3fcf98e49f2826fa270,1,Robert Levas,2016-01-25 07:03:52-05:00,['e94362c35e0a046dcd7ab802cbf258ce603780c6'],57,133,190,21827605,6,1,1,1,21651
2e44e2649a53b5ef2674fe5e057f9f1bb4ce9bd6,0,Lisnichenko Dmitro,2016-01-25 14:10:17+02:00,['eaf8cc4cd2015456307ff3fcf98e49f2826fa270'],1,39,40,21827645,4,,,,21651
cd1fdddb3e438640af1d132e8e6b9cf60b527939,1,Andrii Tkach,2016-01-25 14:37:53+02:00,['2e44e2649a53b5ef2674fe5e057f9f1bb4ce9bd6'],2,2,4,21827649,2,,,,21651
e41f2dcb889c53e062bcb0c414a2c92266cbddb3,0,Robert Levas,2016-01-25 09:35:24-05:00,['cd1fdddb3e438640af1d132e8e6b9cf60b527939'],0,34,34,21827683,1,,,,21651
1fecf136c16af21abefbcab20a328bec9d6b6892,1,Alex Antonenko,2016-01-25 16:57:59+02:00,['e41f2dcb889c53e062bcb0c414a2c92266cbddb3'],2,3,5,21827688,1,0,0,1,21651
815d27eea60dce04219c1fea6321fa0767f5579f,0,ababiichuk,2016-01-25 17:28:36+02:00,['1fecf136c16af21abefbcab20a328bec9d6b6892'],6,13,19,21827707,4,1,1,0,21651
b2d2b72c48a8621cd45f219086e9bfbb617221cd,1,Andrew Onishuk,2016-01-25 18:02:11+02:00,['815d27eea60dce04219c1fea6321fa0767f5579f'],2,46,48,21827755,5,0,0.833333333,0.833333333,21651
150eb0e92c89efe8e2e36c88e083e6f962b9e121,0,Robert Levas,2016-01-25 11:14:40-05:00,['b2d2b72c48a8621cd45f219086e9bfbb617221cd'],0,1,1,21827756,1,0,0,1,21651
746bc1e828f1948c695eab5c351953f8053c1e3e,1,Oleg Nechiporenko,2016-01-25 18:30:26+02:00,['150eb0e92c89efe8e2e36c88e083e6f962b9e121'],24,71,95,21827851,5,1,1,1,21651
b711de82431aab468de571e4fa0255316665f265,1,Vitaly Brodetskyi,2016-01-25 16:09:15+02:00,['746bc1e828f1948c695eab5c351953f8053c1e3e'],2,3,5,21827856,1,,,,21651
f680b52f9057cea3b06e315e97dc6e3226c53c94,0,Robert Levas,2016-01-25 12:14:24-05:00,['b711de82431aab468de571e4fa0255316665f265'],1,0,1,21827857,1,1,1,0,21651
c0b4e5528ca39f2c0d2dcbf70558b0fdc6b7cd0f,0,Gautam Borad,2016-01-25 22:34:26+05:18,['f680b52f9057cea3b06e315e97dc6e3226c53c94'],36,21,57,21827914,2,1,1,1,21651
94c03505d245fbce820603eef0dbcff7662168af,0,Robert Levas,2016-01-25 12:17:22-05:00,['c0b4e5528ca39f2c0d2dcbf70558b0fdc6b7cd0f'],0,1,1,21827915,1,0,0,1,21651
9e84052999c25e837e205d281a639c338d02d163,1,Alex Antonenko,2016-01-25 20:01:28+02:00,['94c03505d245fbce820603eef0dbcff7662168af'],42,150,192,21828107,21,0.801980198,1,1,21651
05a4020eb56a51b9f94f8c38675de51d1d917314,0,Myroslav Papirkovskyy,2016-01-25 20:11:35+02:00,['9e84052999c25e837e205d281a639c338d02d163'],2,2,4,21828111,2,,,,21651
e9eed7ea89e6c8b53f59016b0c949e9927946c46,0,Aleksandr Kovalenko,2016-01-25 20:24:03+02:00,['05a4020eb56a51b9f94f8c38675de51d1d917314'],9,3,12,21828123,1,1,0,0,21651
e26775eddaeb4b83f1fc13591d116a50e94d263b,1,Lisnichenko Dmitro,2016-01-25 20:50:57+02:00,['e9eed7ea89e6c8b53f59016b0c949e9927946c46'],18,36,54,21828177,5,0,0,1,21651
ba97f134153fdd91e20a96d624314e8cb9e2f8e0,1,Alejandro Fernandez,2016-01-25 12:47:33-08:00,['e26775eddaeb4b83f1fc13591d116a50e94d263b'],1,221,222,21828399,2,0,1,1,21652
f755efc52bb80c5dbafbf6c63deb60a9c387f82e,1,Jun Aoki,2016-01-25 16:48:41-08:00,['ba97f134153fdd91e20a96d624314e8cb9e2f8e0'],30,1373,1403,21829802,32,0.733208955,0.940298507,0.861940299,21670
b2b1122dbf1b540450dc52baae63c48ec24568ad,0,Jun Aoki,2016-01-25 16:53:52-08:00,['f755efc52bb80c5dbafbf6c63deb60a9c387f82e'],42,4,46,21829848,3,0,0,0.642857143,21670
5b177fdbfab0ec21d565cc48863b58bd7bbc26de,0,Nahappan Somasundaram,2016-01-25 17:03:29-08:00,['b2b1122dbf1b540450dc52baae63c48ec24568ad'],41,293,334,21830182,11,0.955555556,1,1,21671
e404eee589a7c7d6345e427804e4277fd0f70980,1,Yusaku Sako,2016-01-25 18:05:20-08:00,['5b177fdbfab0ec21d565cc48863b58bd7bbc26de'],3,4,7,21830189,2,1,1,1,21671
c852a0db34d7fec4f123f18ac482f780aec0f691,1,Robert Levas,2016-01-26 11:02:06-05:00,['e404eee589a7c7d6345e427804e4277fd0f70980'],14,86,100,21830289,5,0,0.12244898,1,21671
a9c78221f5738171e3b97fa45ac6fc2cc65eea64,1,Alex Antonenko,2016-01-26 19:16:18+02:00,['c852a0db34d7fec4f123f18ac482f780aec0f691'],27,94,121,21830410,3,0.303030303,1,1,21671
be1024ef3661c93a5c2a3a99abb8094c0146d2b2,1,Andrew Onishuk,2016-01-26 19:33:24+02:00,['a9c78221f5738171e3b97fa45ac6fc2cc65eea64'],6,6,12,21830422,6,,,,21671
32270d3dc76949b8ff0c2ba9f1363cbaf45a37dd,1,Dmytro Sen,2016-01-26 20:03:26+02:00,['be1024ef3661c93a5c2a3a99abb8094c0146d2b2'],0,821,821,21831243,2,0.247368421,0.168421053,0.247368421,21672
7bac2a1d80c6c031a2f7cc113fdc58bb68486a58,0,Robert Levas,2016-01-26 16:11:39-05:00,['32270d3dc76949b8ff0c2ba9f1363cbaf45a37dd'],2,2,4,21831247,2,,,,21672
c7be26ad659d35bc6bc57d3d022da7847a967184,0,Nate Cole,2016-01-26 16:44:49-05:00,"['abc961a13a15cdced7bb3678e4ac67364ba656aa', '7bac2a1d80c6c031a2f7cc113fdc58bb68486a58']",934,6093,7027,21838274,206,,,,21672
5403549d9809bb8b9ca5d30e8e46b2d5d22a9762,1,Aleksandr Kovalenko,2016-01-26 23:50:18+02:00,['7bac2a1d80c6c031a2f7cc113fdc58bb68486a58'],5,45,50,21838324,8,1,1,1,21672
e53d7ba0cc0298ea74c6ffccac52ae9846b69fdc,0,Aravindan Vijayan,2016-01-26 15:27:51-08:00,['5403549d9809bb8b9ca5d30e8e46b2d5d22a9762'],0,3,3,21838327,1,0,1,1,21672
a816cada6ab75e05cd2099ed97586294ed30a73d,1,Nahappan Somasundaram,2016-01-26 16:43:43-08:00,['e53d7ba0cc0298ea74c6ffccac52ae9846b69fdc'],2,2,4,21838331,2,,,,21672
c530e00900b28b1c129dc364f70523ffa91b6f3a,1,Andrew Onishuk,2016-01-27 11:34:08+02:00,['a816cada6ab75e05cd2099ed97586294ed30a73d'],11,20,31,21838362,5,,,,21672
d1e59133f7f867a16d6cb4c7e5cc8508893a29fe,1,Vitaly Brodetskyi,2016-01-27 11:02:22+02:00,['c530e00900b28b1c129dc364f70523ffa91b6f3a'],45,248,293,21838655,5,0.985507246,1,0.913043478,21674
34bbd8b458fd0bf01345abbeffd2906cc72c371b,0,Dmytro Sen,2016-01-27 14:06:18+02:00,['d1e59133f7f867a16d6cb4c7e5cc8508893a29fe'],2,6,8,21838663,1,0,1,1,21674
a88678fc7d3aeba814236d53ad9c98803f3cf4b8,1,Andrew Onishuk,2016-01-27 14:08:30+02:00,['34bbd8b458fd0bf01345abbeffd2906cc72c371b'],0,141,141,21838804,6,0,0.875,1,21675
8e15bec8e941cd62ba1722e9da362cd383b7a25c,1,Dmytro Sen,2016-01-27 15:29:47+02:00,['a88678fc7d3aeba814236d53ad9c98803f3cf4b8'],3,239,242,21839046,7,0.188118812,0.376237624,1,21677
f4edad887fe5881e3772e3a937cbf87eb9d0c03a,0,Andrii Tkach,2016-01-27 15:33:28+02:00,['8e15bec8e941cd62ba1722e9da362cd383b7a25c'],0,9,9,21839055,1,1,1,0.875,21677
54311b78863219e5702873e7d9ac94a942210ea9,0,Andrii Tkach,2016-01-27 15:35:40+02:00,['f4edad887fe5881e3772e3a937cbf87eb9d0c03a'],0,8,8,21839063,2,0,0.625,1,21677
986a5188334b51cf5728b4b54c2aefc48866558e,1,Nate Cole,2016-01-27 09:36:31-05:00,['c7be26ad659d35bc6bc57d3d022da7847a967184'],90,601,691,21839754,12,0.403314917,0.850828729,0.591160221,21680
e7bdb7b05478d39970680cc92c95177595ff3277,0,Nate Cole,2016-01-27 10:33:04-05:00,"['986a5188334b51cf5728b4b54c2aefc48866558e', 'f4edad887fe5881e3772e3a937cbf87eb9d0c03a']",68,713,781,21840535,36,,,,21680
ce7252909acddde2d8872e4944e1bd52148dab03,1,Dmytro Sen,2016-01-27 18:33:34+02:00,['54311b78863219e5702873e7d9ac94a942210ea9'],48,95,143,21840678,5,0,0.84,0.24,21680
29243e7ff9ee401e0ad8c0c17772341f44aad5dd,0,Aleksandr Kovalenko,2016-01-27 19:40:39+02:00,['ce7252909acddde2d8872e4944e1bd52148dab03'],1,2,3,21840681,1,0,1,1,21680
73b5399b12b4c17c119d37031d8e92ca398ca195,0,Jonathan Hurley,2016-01-27 15:47:17-05:00,['29243e7ff9ee401e0ad8c0c17772341f44aad5dd'],3,45,48,21840729,3,0,1,1,21680
646fb429f53adaa687dd9d4e7acdff617203caf6,1,Siddharth Wagle,2016-01-27 15:51:26-08:00,['73b5399b12b4c17c119d37031d8e92ca398ca195'],77,1123,1200,21841929,20,0.351851852,0.538888889,0.944444444,21686
75be3b97a7ca771f7d2d74aea92d3c017c354159,0,Alex Antonenko,2016-01-28 02:40:06+02:00,['646fb429f53adaa687dd9d4e7acdff617203caf6'],2,2,4,21841933,1,,,,21686
d38a9531efa667e644ce7b67e041f8f6ad2d06a9,1,Alex Antonenko,2016-01-28 04:56:59+02:00,['75be3b97a7ca771f7d2d74aea92d3c017c354159'],3,4,7,21841940,3,1,1,1,21686
62ff3b963052cdf73b2913ea3b162e0586016bc8,0,Andrii Tkach,2016-01-28 10:54:08+02:00,['d38a9531efa667e644ce7b67e041f8f6ad2d06a9'],0,1,1,21841941,1,,,,21686
7371c1b24979c373a53c17cc5a6e226a179c8dba,0,Oleg Nechiporenko,2016-01-28 13:23:16+02:00,['62ff3b963052cdf73b2913ea3b162e0586016bc8'],4,2,6,21841947,1,0,0,0,21686
d057581b5b6930c988fe805b799258a9fb5a9744,0,Oleg Nechiporenko,2016-01-28 15:05:11+02:00,['7371c1b24979c373a53c17cc5a6e226a179c8dba'],2,28,30,21841977,2,1,1,1,21686
f10d41ccbc935cdad2627f51a7b3ddba38190abf,1,ababiichuk,2016-01-28 16:01:19+02:00,['d057581b5b6930c988fe805b799258a9fb5a9744'],53,245,298,21842275,12,1,1,1,21690
e72a6b4665bceb472a1cc1d9a2080b741d1cb560,1,Dmytro Sen,2016-01-28 20:04:06+02:00,['f10d41ccbc935cdad2627f51a7b3ddba38190abf'],0,5,5,21842280,2,0.2,1,1,21690
195a35953606263d2810b10a731f3b295aa29a60,1,Vitaly Brodetskyi,2016-01-28 21:29:15+02:00,['e72a6b4665bceb472a1cc1d9a2080b741d1cb560'],5,20,25,21842305,3,0,1,1,21690
c9e51380bdb155dcb4f4f1885dfa739c6c6a6445,0,Alejandro Fernandez,2016-01-28 15:00:11-08:00,['195a35953606263d2810b10a731f3b295aa29a60'],0,20,20,21842325,3,,,,21690
5e09053deb0700b09ced4f8f12902ff2ea60154a,0,Richard Zang,2016-01-29 08:37:44+08:00,['c9e51380bdb155dcb4f4f1885dfa739c6c6a6445'],6,29,35,21842360,4,1,1,1,21690
cad69e6132b554386e82d45950fc1b302f689af7,1,Richard Zang,2016-01-29 08:51:50+08:00,['5e09053deb0700b09ced4f8f12902ff2ea60154a'],29,6,35,21842395,4,0,0,0,21690
b037ef5cfc9cfd72126818cf8c5c5e7c3525dc52,1,Richard Zang,2016-01-29 08:58:08+08:00,['cad69e6132b554386e82d45950fc1b302f689af7'],14,34,48,21842443,4,1,1,0,21690
d63469935d0933af5e625cfea1d581f056055685,0,Jun Aoki,2016-01-28 17:42:04-08:00,['b037ef5cfc9cfd72126818cf8c5c5e7c3525dc52'],1,2,3,21842446,1,,,,21690
981ede5455c02ae1bd4aac7495c2c667bc889dbc,0,Jonathan Hurley,2016-01-28 23:12:48-05:00,['d63469935d0933af5e625cfea1d581f056055685'],8,31,39,21842485,3,,,,21690
a2f436a610b130799c49fdafa30b11f6de1c8157,0,Jonathan Hurley,2016-01-28 23:12:48-05:00,['981ede5455c02ae1bd4aac7495c2c667bc889dbc'],76,0,76,21842561,1,,,,21690
6d83195a72a1dc6435ebf29fd470c512a49b7a69,1,Andrew Onishuk,2016-01-29 13:41:28+02:00,['a2f436a610b130799c49fdafa30b11f6de1c8157'],0,69,69,21842630,3,,,,21691
516912bb2fec21688a554401feca18f61ca84c66,1,Jonathan Hurley,2016-01-29 11:26:44-05:00,['6d83195a72a1dc6435ebf29fd470c512a49b7a69'],31,8,39,21842669,3,,,,21691
6bac8ec15e774349d454aa05ec38e23d762b3ce8,0,Jonathan Hurley,2016-01-29 11:34:41-05:00,['516912bb2fec21688a554401feca18f61ca84c66'],23,29,52,21842721,4,,,,21691
ea60d2980beb0bfe78fb312c583b3af928661d6e,0,Vitaly Brodetskyi,2016-01-29 16:29:16+02:00,['6bac8ec15e774349d454aa05ec38e23d762b3ce8'],6,6,12,21842733,3,,,,21691
69c83419517a5d87f9c460fc2b1bb8f41e50961a,1,Jun Aoki,2016-01-29 13:31:46-08:00,['ea60d2980beb0bfe78fb312c583b3af928661d6e'],1,67,68,21842801,4,0.222222222,0,0.777777778,21691
44c98665a4bf9c76434741d1bdae1f1a35145f45,1,Aravindan Vijayan,2016-01-29 14:10:01-08:00,['69c83419517a5d87f9c460fc2b1bb8f41e50961a'],0,50,50,21842851,2,0,0.105263158,1,21691
5facf9a5e7fecfbf433a8af274911b527f737fcb,1,Alex Antonenko,2016-01-30 01:06:32+02:00,['44c98665a4bf9c76434741d1bdae1f1a35145f45'],2,127,129,21842980,5,0.568181818,1,1,21692
1be4a2d3bd4899270c1c52c33fbc4dd5fb701814,1,Aleksandr Kovalenko,2016-01-30 03:06:17+02:00,['5facf9a5e7fecfbf433a8af274911b527f737fcb'],3,4,7,21842987,3,0,1,1,21692
528e8ea5e05d98866e14dcfbe2d2becf6b7ceb7e,0,Nahappan Somasundaram,2016-01-29 17:16:42-08:00,['1be4a2d3bd4899270c1c52c33fbc4dd5fb701814'],2,22,24,21843011,3,0.857142857,1,1,21692
7444981ff63694c8851064c4f7e346a480855de5,1,Richard Zang,2016-01-30 12:27:20+08:00,['528e8ea5e05d98866e14dcfbe2d2becf6b7ceb7e'],6,29,35,21843046,4,1,1,1,21692
e15ed4429d5bf8e7c2861342c9b890665fbd1ab7,1,ababiichuk,2016-02-01 11:02:54+02:00,['7444981ff63694c8851064c4f7e346a480855de5'],1,2,3,21843049,2,0,1,1,21692
40a0ef623d3b213213ac5a8340ed825b535b0234,1,ababiichuk,2016-02-01 11:12:58+02:00,['e15ed4429d5bf8e7c2861342c9b890665fbd1ab7'],4,54,58,21843107,3,1,1,1,21692
60db82ebd345c033a2983f54c973c8f15767705c,0,Vitaly Brodetskyi,2016-02-01 12:56:52+02:00,['40a0ef623d3b213213ac5a8340ed825b535b0234'],2,0,2,21843109,1,,,,21692
2fd458e720c3d52aa4bebc82e4229dad721f9ce0,1,Andrew Onishuk,2016-02-01 15:57:02+02:00,['60db82ebd345c033a2983f54c973c8f15767705c'],927,304,1231,21844340,2,,,,21692
bb3b5096136f0ac652aabea86b5f378659e597c8,1,Andrew Onishuk,2016-02-01 15:57:40+02:00,['2fd458e720c3d52aa4bebc82e4229dad721f9ce0'],487,182,669,21845009,2,,,,21692
d8804cfb576681f86d52cfb9778b18f2f958b09d,0,Myroslav Papirkovskyy,2016-02-01 16:45:14+02:00,['bb3b5096136f0ac652aabea86b5f378659e597c8'],1,2,3,21845012,1,0,0,0,21692
3ab6a3a8365b31417f8afd83b668d2986702246b,1,Jonathan Hurley,2016-02-01 10:09:08-05:00,['d8804cfb576681f86d52cfb9778b18f2f958b09d'],42,165,207,21845219,7,0.5,0.5,0.5,21694
73aee31ef67348bbfc942bdf719c6952964a82ab,0,Nate Cole,2016-02-01 10:41:26-05:00,"['e7bdb7b05478d39970680cc92c95177595ff3277', '3ab6a3a8365b31417f8afd83b668d2986702246b']",1774,2726,4500,21849719,105,,,,21694
31477a588a1af89f8a156af4d9efb04b61508fe0,1,Oleg Nechiporenko,2016-02-01 18:17:44+02:00,['3ab6a3a8365b31417f8afd83b668d2986702246b'],288,386,674,21850393,30,1,1,1,21694
5e36bdc922a92405f9d82ccbdff0ba8006903052,1,Vitaly Brodetskyi,2016-02-01 18:56:56+02:00,['31477a588a1af89f8a156af4d9efb04b61508fe0'],97,249,346,21850739,5,0.136752137,0.846153846,0.393162393,21694
d456b158041fe87b92cfd45942714dde16924a2a,0,Vitaly Brodetskyi,2016-02-01 22:45:30+02:00,['5e36bdc922a92405f9d82ccbdff0ba8006903052'],2,2,4,21850743,1,,,,21694
c84da24939b691951244840e07526a0ed9dee30a,1,Nate Cole,2016-02-01 16:33:19-05:00,['73aee31ef67348bbfc942bdf719c6952964a82ab'],118,398,516,21851259,14,0.47706422,0.587155963,1,21695
9991ad88b8a226fe6fce8b28b17feec314112fa0,1,Bob Nettleton,2016-02-01 17:35:46-05:00,['d456b158041fe87b92cfd45942714dde16924a2a'],6,160,166,21851425,2,0.090909091,0.79338843,0.842975207,21695
9a0348957540b3ce3ab5cdcc609bb938ba424c1e,1,Robert Levas,2016-02-01 17:48:59-05:00,['9991ad88b8a226fe6fce8b28b17feec314112fa0'],12,72,84,21851509,7,0.16,0.76,1,21695
6ce156554600214339c7e8c35219abaf570346e9,0,Jun Aoki,2016-02-01 17:19:59-08:00,['9a0348957540b3ce3ab5cdcc609bb938ba424c1e'],21,0,21,21851530,1,,,,21695
774d689eee8a26a0511e23f182a1d3e65c22c5eb,1,Nahappan Somasundaram,2016-02-01 18:15:03-08:00,['6ce156554600214339c7e8c35219abaf570346e9'],269,268,537,21852067,20,,,,21695
6e098207dd0d8c015df7dd5f7ddede87ee269216,1,Gautam Borad,2016-02-02 15:06:48+05:18,['774d689eee8a26a0511e23f182a1d3e65c22c5eb'],1,28,29,21852096,4,0,0.066666667,0.333333333,21695
8ba3d0beb794f979f24174ed5324d99a1c4a8e73,1,Oleg Nechiporenko,2016-02-02 12:09:18+02:00,['6e098207dd0d8c015df7dd5f7ddede87ee269216'],1,14,15,21852111,3,,,,21695
77af8e54fe4f793f9affa2a70e8ca52ccc90d0cb,1,Nate Cole,2016-02-02 07:36:29-05:00,['c84da24939b691951244840e07526a0ed9dee30a'],9,167,176,21852287,3,0.260869565,0.565217391,0.891304348,21695
4c5d2bd0a927f45f99c4045c4c9036859f0d19c8,0,Nate Cole,2016-02-02 07:40:38-05:00,"['77af8e54fe4f793f9affa2a70e8ca52ccc90d0cb', '8ba3d0beb794f979f24174ed5324d99a1c4a8e73']",697,1179,1876,21854163,73,,,,21695
9cc01b45ec9d534c73d10c2b0d1e4c7639883d69,1,Andrew Onishuk,2016-02-02 16:19:57+02:00,['8ba3d0beb794f979f24174ed5324d99a1c4a8e73'],11,19,30,21854193,3,0.2,0.6,0,21695
aab6d889895ddf2c02fd6fa2c79ec9901fb9e768,1,Alex Antonenko,2016-02-02 19:14:33+02:00,['9cc01b45ec9d534c73d10c2b0d1e4c7639883d69'],50,158,208,21854401,9,0.596491228,1,1,21696
94c13eee7f1536d343586ad3e5519961be57a356,0,ababiichuk,2016-02-02 20:55:20+02:00,['aab6d889895ddf2c02fd6fa2c79ec9901fb9e768'],5,11,16,21854417,1,0,1,1,21696
6fb00585cf9b7e55ce615bbfc4d7ee11f4ed319e,0,Jun Aoki,2016-02-02 15:51:24-08:00,['94c13eee7f1536d343586ad3e5519961be57a356'],13,13,26,21854443,2,0,1,1,21696
7632b7bb2454a67015308da25c588dd0bf4aafe2,1,Jun Aoki,2016-02-02 16:19:24-08:00,['6fb00585cf9b7e55ce615bbfc4d7ee11f4ed319e'],32,76,108,21854551,3,0.965517241,1,1,21696
58b91c845e6a260602373499c22a384f4ca7cbdb,1,Siddharth Wagle,2016-02-02 16:38:03-08:00,['7632b7bb2454a67015308da25c588dd0bf4aafe2'],133,233,366,21854917,16,0.432835821,0,0.71641791,21696
f6a75a609caa1ce24c6cf9ab1f6303eb5bc9e923,1,Andrew Onishuk,2016-02-03 11:52:49+02:00,['58b91c845e6a260602373499c22a384f4ca7cbdb'],133,92,225,21855142,14,,,,21696
2be0ec36231e7fd07216066d53e1b973b4dc8b78,0,Alex Antonenko,2016-02-03 14:53:19+02:00,['f6a75a609caa1ce24c6cf9ab1f6303eb5bc9e923'],3,28,31,21855173,3,0,1,0.888888889,21696
18463c86afc348d985c8638cd4542201372998e3,1,Andrii Tkach,2016-02-03 16:54:02+02:00,['2be0ec36231e7fd07216066d53e1b973b4dc8b78'],1,20,21,21855194,3,0.782608696,1,1,21696
1d9f1bb069895d6dbc344a5cf0d81e56ff0b7371,1,tbeerbower,2016-02-03 09:57:36-05:00,['18463c86afc348d985c8638cd4542201372998e3'],2,64,66,21855260,7,,,,21696
079a5b3b129eb217cbded5b0cc4859a0a62db86e,1,Alex Antonenko,2016-02-03 18:03:39+02:00,['1d9f1bb069895d6dbc344a5cf0d81e56ff0b7371'],9,9,18,21855278,4,,,,21696
46f6030b06dc9a1e1adfa18cd5df4d9ad7456ebc,1,Alex Antonenko,2016-02-03 18:03:40+02:00,['079a5b3b129eb217cbded5b0cc4859a0a62db86e'],8,483,491,21855769,5,0.458128079,0.9408867,0.699507389,21696
6d9e05995f6815a600021e0e84f3f29518989b36,1,Oleg Nechiporenko,2016-02-03 18:12:10+02:00,['46f6030b06dc9a1e1adfa18cd5df4d9ad7456ebc'],26,341,367,21856136,10,0.684210526,0.889473684,1,21697
7259d972e98b69415bf786f430a6a1276f9e78b7,1,Alejandro Fernandez,2016-02-03 09:43:53-08:00,['6d9e05995f6815a600021e0e84f3f29518989b36'],27,156,183,21856319,2,0,0.810126582,0.35443038,21697
424cca6c3744eca2c44dff0fbc47791492845f88,1,Jun Aoki,2016-02-03 10:58:56-08:00,['7259d972e98b69415bf786f430a6a1276f9e78b7'],0,304,304,21856623,3,1,0.857142857,0.857142857,21700
c72dc41db25fe5898fe7dc36d1aa3bdaf4d0fc5d,0,Nate Cole,2016-02-03 14:14:07-05:00,"['4c5d2bd0a927f45f99c4045c4c9036859f0d19c8', '424cca6c3744eca2c44dff0fbc47791492845f88']",447,2001,2448,21859071,78,,,,21700
5833aabd811f726d328d5b2ddd565e45cbd48a15,1,Aleksandr Kovalenko,2016-02-03 22:13:43+02:00,['424cca6c3744eca2c44dff0fbc47791492845f88'],9,46,55,21859126,5,0.953488372,1,0.953488372,21700
e4d03b5b5879aff474abdbb3a9d571215383a6c4,1,Xi Wang,2016-02-03 13:55:05-08:00,['c72dc41db25fe5898fe7dc36d1aa3bdaf4d0fc5d'],2,225,227,21859353,6,0.5,1,0.852941176,21700
d89f8a5f91bba77b68ff32a221baac589b017896,1,Di Li,2016-02-03 17:24:03-05:00,['5833aabd811f726d328d5b2ddd565e45cbd48a15'],1,1,2,21859355,1,,,,21700
ad67efd2d67dfefb2fb20249bfc42e4d569b7a07,1,Dmytro Sen,2016-02-04 01:09:56+02:00,['d89f8a5f91bba77b68ff32a221baac589b017896'],197,769,966,21860321,9,,,,21706
65558a5a660062ebb1c9380e4a7101ce45ad4fe2,1,Jun Aoki,2016-02-03 15:27:26-08:00,['ad67efd2d67dfefb2fb20249bfc42e4d569b7a07'],3,1160,1163,21861484,29,0.834451902,1,0.950782998,21722
4fbf172c31e65bab503ab8e0acbfefd2b7a3adbe,1,Jun Aoki,2016-02-03 15:38:40-08:00,['65558a5a660062ebb1c9380e4a7101ce45ad4fe2'],15,7,22,21861506,2,0.181818182,0,0,21722
0b47564002b295efb6be1b41aa66381561dbe7e4,1,Xi Wang,2016-02-03 16:02:48-08:00,['e4d03b5b5879aff474abdbb3a9d571215383a6c4'],64,269,333,21861839,6,0.044585987,0.904458599,1,21722
efc3a07da28857221e21592a6b62210b41dffdbb,1,Xi Wang,2016-02-03 16:07:04-08:00,['0b47564002b295efb6be1b41aa66381561dbe7e4'],306,218,524,21862363,6,0.762711864,0,0.016949153,21722
0f9da42829c5d7118284d09e98190403bfdce41e,1,Xi Wang,2016-02-03 16:15:24-08:00,['efc3a07da28857221e21592a6b62210b41dffdbb'],464,357,821,21863184,9,0.647058824,0,0,21722
ed3ca611b98a6a68c12a735ca934a83755913b39,1,Myroslav Papirkovskyy,2016-02-04 13:14:06+02:00,['4fbf172c31e65bab503ab8e0acbfefd2b7a3adbe'],0,27,27,21863211,3,0.928571429,0.928571429,1,21722
04b02273a611377602f023f4b6700856dc8eb115,1,Andrew Onishuk,2016-02-04 14:06:02+02:00,['ed3ca611b98a6a68c12a735ca934a83755913b39'],69,313,382,21863593,7,0.714285714,0.714285714,0.557142857,21723
81b46da33da91d672f16e88c9165e69954d2b292,1,Alex Antonenko,2016-02-04 17:08:46+02:00,['04b02273a611377602f023f4b6700856dc8eb115'],28,30,58,21863651,9,1,,,21723
549ee24c38746f2073969e4838a78f87d4c49860,1,Dmytro Sen,2016-02-04 19:08:07+02:00,['81b46da33da91d672f16e88c9165e69954d2b292'],19,67,86,21863737,2,0,0.739130435,0.739130435,21723
407822583d2d4f1a21e9d610e80fb32de548d9ac,0,Dmytro Sen,2016-02-04 19:49:57+02:00,['549ee24c38746f2073969e4838a78f87d4c49860'],1,52,53,21863790,1,,,,21723
7d2191c9d89570de6394e71d02ccfd7564c36e40,0,Aravindan Vijayan,2016-02-04 10:07:18-08:00,['407822583d2d4f1a21e9d610e80fb32de548d9ac'],2,2,4,21863794,1,,,,21723
8c6c13da3ffbf9349232dfcaa7b7504c48156fcf,1,Srimanth Gunturi,2016-02-04 10:15:25-08:00,['7d2191c9d89570de6394e71d02ccfd7564c36e40'],59,160,219,21864013,13,0.98,1,1,21723
d0bec5cb3c0298d83413342d55baf36133632ab8,1,Aravindan Vijayan,2016-02-04 10:48:38-08:00,['8c6c13da3ffbf9349232dfcaa7b7504c48156fcf'],2,127,129,21864142,3,0.013333333,0.64,1,21723
8ff0b5ed82784a202978017345348d0d130b64af,1,Yusaku Sako,2016-02-04 11:05:37-08:00,['d0bec5cb3c0298d83413342d55baf36133632ab8'],0,923,923,21865065,9,0.660220994,0.762430939,1,21731
7616e0f5d6939509d1914857dc03150eacc9e3b9,1,Bob Nettleton,2016-02-04 14:07:02-05:00,['8ff0b5ed82784a202978017345348d0d130b64af'],79,370,449,21865514,2,0.120879121,1,1,21731
7af40ca158e83c6d8c0de3d8381a6ad0c8a6b903,0,Yusaku Sako,2016-02-04 11:13:24-08:00,['7616e0f5d6939509d1914857dc03150eacc9e3b9'],0,0,0,21865514,21,,,,21752
ab06c68acafd9e31a24e6b136f5772fdbf25655c,0,Srimanth Gunturi,2016-02-04 11:19:12-08:00,['7af40ca158e83c6d8c0de3d8381a6ad0c8a6b903'],1,1,2,21865516,1,,0,,21752
eb3f995965b2749910ceae9e5cc8f8bc043e6862,0,Robert Levas,2016-02-04 15:46:23-05:00,['ab06c68acafd9e31a24e6b136f5772fdbf25655c'],23,133,156,21865672,6,0.455882353,0.955882353,1,21752
f026accf2df9f2be6e6f4dac049593c90f37bbc9,0,Yusaku Sako,2016-02-04 13:15:49-08:00,['eb3f995965b2749910ceae9e5cc8f8bc043e6862'],0,1,1,21865673,1,,,,21752
080991d131768ece5e0d7065df2bb8443e14053f,1,Bob Nettleton,2016-02-04 17:41:16-05:00,['f026accf2df9f2be6e6f4dac049593c90f37bbc9'],11,125,136,21865809,2,0.385964912,1,0.649122807,21752
3d7643b41c214dfc2bca4af2ab5dc37f27b8e652,0,Jun Aoki,2016-02-04 14:52:27-08:00,['080991d131768ece5e0d7065df2bb8443e14053f'],0,7,7,21865816,1,,,,21752
74d5a016711c8c9d8641953e8732e65534db1a88,0,Oleg Nechiporenko,2016-02-05 10:02:36+02:00,['3d7643b41c214dfc2bca4af2ab5dc37f27b8e652'],9,34,43,21865859,5,0.260869565,1,1,21752
dc8e5c3c68d25e74ab875a87f66959fc86a9631c,1,Andrew Onishuk,2016-02-05 11:02:39+02:00,['74d5a016711c8c9d8641953e8732e65534db1a88'],42,27,69,21865928,5,,,,21752
94932c99bb8ff5ad309c15c6a0ecf382f428c73b,1,ababiichuk,2016-02-05 11:15:13+02:00,['dc8e5c3c68d25e74ab875a87f66959fc86a9631c'],2,41,43,21865971,3,0,0,1,21752
315f502b0e7fed166f7d91387fa41f85e8dc891a,1,ababiichuk,2016-02-05 12:37:25+02:00,['94932c99bb8ff5ad309c15c6a0ecf382f428c73b'],51,189,240,21866211,5,0.773109244,1,0.966386555,21752
c62233236dffe0eb4b4664fc685fc663db1feb70,1,Dmytro Sen,2016-02-05 13:38:38+02:00,['315f502b0e7fed166f7d91387fa41f85e8dc891a'],0,2,2,21866213,1,0,1,1,21752
691958665eb13e58c302a5cf392f4e587853e551,0,Dmytro Sen,2016-02-05 14:27:25+02:00,['c62233236dffe0eb4b4664fc685fc663db1feb70'],1,203,204,21866417,1,,,,21752
ed492292cd4fedd41ebe95ba97a73e57cceb0bae,1,Andrew Onishuk,2016-02-05 15:44:04+02:00,['691958665eb13e58c302a5cf392f4e587853e551'],21,239,260,21866677,5,0.253521127,0.478873239,0.985915493,21754
a2561302530c859f27c678920014db4e4c4a5f7d,1,Nate Cole,2016-02-05 08:50:13-05:00,['0f9da42829c5d7118284d09e98190403bfdce41e'],8,184,192,21866869,8,0.076923077,0.811965812,0.837606838,21754
83bef413c47c76cbf54bc64847620769168389ac,0,Dmytro Sen,2016-02-05 16:30:18+02:00,['ed492292cd4fedd41ebe95ba97a73e57cceb0bae'],4,8,12,21866881,1,1,1,1,21754
b02150a8e1ad66128857370db005e00602a09eac,0,ababiichuk,2016-02-05 17:01:30+02:00,['83bef413c47c76cbf54bc64847620769168389ac'],17,22,39,21866920,1,1,1,1,21754
1eb846c153b156f87a7e55b65decb1f2118f90dc,1,Aravindan Vijayan,2016-02-05 07:58:48-08:00,['b02150a8e1ad66128857370db005e00602a09eac'],53,608,661,21867581,18,0.34,0.75,0.96,21758
cd35e806c0cfd63056afea61d2168e74cf1c1ae8,1,Bob Nettleton,2016-02-05 11:08:23-05:00,['1eb846c153b156f87a7e55b65decb1f2118f90dc'],8,128,136,21867717,6,0.239130435,0.641304348,0.989130435,21758
3a2add5dcde4f1cb730253627b87683f3057c5c1,1,Alex Antonenko,2016-02-05 18:21:10+02:00,['cd35e806c0cfd63056afea61d2168e74cf1c1ae8'],3,1099,1102,21868819,14,0.844262295,1,1,21766
b567ca441c213c816019dc5a45884f69a286f54c,1,Alex Antonenko,2016-02-05 18:30:24+02:00,['3a2add5dcde4f1cb730253627b87683f3057c5c1'],5,257,262,21869081,9,0.865168539,1,1,21768
13325ab07821cdfc3813457c0ca05c6b065f5879,1,Dmytro Sen,2016-02-05 19:52:19+02:00,['b567ca441c213c816019dc5a45884f69a286f54c'],27,33,60,21869141,3,0,1,0,21768
14d53f79156b0b0badb118714948be883881f213,1,Di Li,2016-02-05 12:56:39-05:00,['13325ab07821cdfc3813457c0ca05c6b065f5879'],8,26,34,21869175,4,1,1,1,21768
bb864df5da25093ff386433dd591898d713fd092,1,Lisnichenko Dmitro,2016-02-05 19:58:32+02:00,['14d53f79156b0b0badb118714948be883881f213'],28,730,758,21869933,24,0.237209302,0.865116279,1,21774
0f2c3375da8b3a5ab5739a5ae79db44bf5f91815,1,Nate Cole,2016-02-05 14:22:28-05:00,['a2561302530c859f27c678920014db4e4c4a5f7d'],3,402,405,21870338,3,0.403846154,0.740384615,0.966346154,21776
26ad97b6406008981ce8bec6158f6a47bb1459a4,1,Jun Aoki,2016-02-05 13:23:36-08:00,['bb864df5da25093ff386433dd591898d713fd092'],28,139,167,21870505,5,0.159090909,1,1,21776
f57f9b2910ad1d888b2bd608e3d8b450154a0a23,1,Jonathan Hurley,2016-02-05 16:24:28-05:00,['26ad97b6406008981ce8bec6158f6a47bb1459a4'],7,162,169,21870674,3,0.125,0.885416667,1,21776
c11a41138b02994e54070177efc99241bebfade0,0,Nate Cole,2016-02-05 16:55:44-05:00,"['0f2c3375da8b3a5ab5739a5ae79db44bf5f91815', 'f57f9b2910ad1d888b2bd608e3d8b450154a0a23']",664,8085,8749,21879423,205,,,,21776
31309e28b470f45f4a9c44ad7e0393dd31eb2dd6,1,Jun Aoki,2016-02-05 15:47:56-08:00,['f57f9b2910ad1d888b2bd608e3d8b450154a0a23'],7,93,100,21879523,3,0,0.24137931,0.74137931,21776
60adfbcf8f88ec4429a5fd444491af39ff9173fe,1,Jun Aoki,2016-02-05 15:52:18-08:00,['31309e28b470f45f4a9c44ad7e0393dd31eb2dd6'],4,21,25,21879548,2,1,1,0.923076923,21776
b95d52e986d90b4f2e98d3da566a1a3d4731107b,1,Jun Aoki,2016-02-05 16:14:46-08:00,['60adfbcf8f88ec4429a5fd444491af39ff9173fe'],3,3,6,21879554,1,,,,21776
d10b8767a3c61544850722b298171e6d4aa95c99,0,Robert Levas,2016-02-07 13:50:41-05:00,['b95d52e986d90b4f2e98d3da566a1a3d4731107b'],18,10,28,21879582,3,,,,21776
817ca06309472927447f803bcd90e7d786c7445d,0,Dmytro Sen,2016-02-08 12:00:33+02:00,['d10b8767a3c61544850722b298171e6d4aa95c99'],259,288,547,21880129,2,,,,21776
74eb20a8a3f665175a6be10cbc69886b14923aa1,1,Andrii Tkach,2016-02-08 13:27:44+02:00,['817ca06309472927447f803bcd90e7d786c7445d'],599,310,909,21881038,19,0,0,0,21778
268ae5b62681f5f41b18da4164d570bd6690d411,1,Andrew Onishuk,2016-02-08 14:18:57+02:00,['74eb20a8a3f665175a6be10cbc69886b14923aa1'],92,188,280,21881318,59,0.785714286,0.785714286,1,21778
cff83481348b7e6def8403b344f83f51ef6d2d91,1,Dipayan Bhowmick,2016-02-08 17:51:03+05:18,['268ae5b62681f5f41b18da4164d570bd6690d411'],1,4,5,21881323,1,,,,21778
91897d970150a36a41eb5e04b76186d88b885266,0,ababiichuk,2016-02-08 14:43:13+02:00,['cff83481348b7e6def8403b344f83f51ef6d2d91'],11,14,25,21881348,1,1,1,1,21778
7051ef64e76b93ddfe7b7eb996b8e33961af406f,1,ababiichuk,2016-02-08 14:43:13+02:00,['91897d970150a36a41eb5e04b76186d88b885266'],39,115,154,21881502,3,0.714285714,0,1,21778
f60472d5fa3705f31a0b024d4fb93c0d96048a10,1,ababiichuk,2016-02-08 14:43:13+02:00,['7051ef64e76b93ddfe7b7eb996b8e33961af406f'],1,6,7,21881509,1,0,1,0.25,21778
d3db8daddcdae75f5ccff2760b7bd646e7d63bce,0,Nate Cole,2016-02-08 09:03:13-05:00,"['c11a41138b02994e54070177efc99241bebfade0', 'f60472d5fa3705f31a0b024d4fb93c0d96048a10']",1034,1052,2086,21883595,94,,,,21778
62f3a3bb7f72c5564b45b8d1fd64a567471084c1,1,Alex Antonenko,2016-02-08 17:27:01+02:00,['f60472d5fa3705f31a0b024d4fb93c0d96048a10'],18,30,48,21883643,1,0.916666667,1,0,21778
5cb0faddaee06332ab703c237a7514742fbc3588,1,Di Li,2016-02-08 11:30:26-05:00,['62f3a3bb7f72c5564b45b8d1fd64a567471084c1'],69,360,429,21884072,28,1,0.4,0,21782
e139ef57ce0ec3d705489a36cb2d7cc78f6458c1,0,Oleg Nechiporenko,2016-02-08 18:52:14+02:00,['5cb0faddaee06332ab703c237a7514742fbc3588'],82,116,198,21884270,3,0.944444444,1,1,21782
a396ff0203093ba80460657b4f7a4fecfb2b7ed1,1,Robert Levas,2016-02-08 13:39:30-05:00,['e139ef57ce0ec3d705489a36cb2d7cc78f6458c1'],236,381,617,21884887,3,0,0.898989899,0.838383838,21782
f905a0243ec34df9c74cc76551cecd53a8251523,1,Alex Antonenko,2016-02-08 21:29:47+02:00,['a396ff0203093ba80460657b4f7a4fecfb2b7ed1'],26,136,162,21885049,2,0,0.619565217,1,21782
e76099a275793607a86e7c34eb91c89db74021d6,1,Alejandro Fernandez,2016-02-08 11:43:14-08:00,['f905a0243ec34df9c74cc76551cecd53a8251523'],121,143,264,21885313,4,1,0,0,21782
53526383411f4709a6a59befeee8e68c7420cdc5,0,Jayush Luniya,2016-02-08 14:36:00-08:00,['e76099a275793607a86e7c34eb91c89db74021d6'],13,18,31,21885344,1,,,,21782
d9faf7412c5d1968ba74d1eab3487b7e374ea002,0,Alex Antonenko,2016-02-09 02:41:31+02:00,['53526383411f4709a6a59befeee8e68c7420cdc5'],1,10,11,21885355,1,,,,21782
12faf8cbae92cfa7836e7508ec2df8f2bd41d286,0,Gautam Borad,2016-02-09 15:15:36+05:18,['d9faf7412c5d1968ba74d1eab3487b7e374ea002'],21,39,60,21885415,2,,,,21782
472d62a7b3c0383ad4d95fe659ac87b4a8da3a1f,1,Gautam Borad,2016-02-09 15:18:01+05:18,['12faf8cbae92cfa7836e7508ec2df8f2bd41d286'],30,61,91,21885506,4,1,1,0,21783
f734aec99bacb9ec6115574d890b74cc1d9477f5,0,Andrii Tkach,2016-02-09 12:04:34+02:00,['472d62a7b3c0383ad4d95fe659ac87b4a8da3a1f'],3,5,8,21885514,1,0,0,1,21783
f25dd31aa998b257a7bb9d1efc2aca9144b5f607,1,Andrew Onishuk,2016-02-09 12:38:01+02:00,['f734aec99bacb9ec6115574d890b74cc1d9477f5'],1,3,4,21885518,1,,,,21783
cb3b3ed444812fa34baf05222c21360ec7268c6a,1,Alex Antonenko,2016-02-09 12:39:30+02:00,['f25dd31aa998b257a7bb9d1efc2aca9144b5f607'],6,41,47,21885565,2,1,1,1,21783
dfff43d747b0b8c65756e4c0d7623fe7f45c6c4b,0,Andrew Onishuk,2016-02-09 13:47:22+02:00,['cb3b3ed444812fa34baf05222c21360ec7268c6a'],1,1,2,21885567,1,,,,21783
697c309c19e04949f1bb9a746f5a5d1e87fb3e39,1,Jonathan Hurley,2016-02-09 09:37:18-05:00,['d3db8daddcdae75f5ccff2760b7bd646e7d63bce'],284,270,554,21886121,23,0.444444444,0.240740741,0,21783
4294500105a3e7f12be3f14801dd319a6b95f489,1,Lisnichenko Dmitro,2016-02-09 17:02:44+02:00,['dfff43d747b0b8c65756e4c0d7623fe7f45c6c4b'],1,28,29,21886150,3,0,0,0,21783
ef1b98b3c77a5b4ebafbd5cc9c720ad9f13b63e8,0,Andrew Onishuk,2016-02-09 17:40:11+02:00,['4294500105a3e7f12be3f14801dd319a6b95f489'],1,4,5,21886155,1,1,1,1,21783
400d49548755a8c50760dd1bfcba81dacaba79f6,0,ababiichuk,2016-02-09 17:46:47+02:00,['ef1b98b3c77a5b4ebafbd5cc9c720ad9f13b63e8'],1,1,2,21886157,1,,,,21783
38a52256e0d421fe52beef4e4860b990000676b5,0,Dmytro Sen,2016-02-09 18:03:29+02:00,['400d49548755a8c50760dd1bfcba81dacaba79f6'],6,6,12,21886169,1,,,,21783
14396f2b74115744d6f4c93b97a9911cd1e58ff1,1,Aravindan Vijayan,2016-02-09 08:18:51-08:00,['38a52256e0d421fe52beef4e4860b990000676b5'],4,163,167,21886336,4,0.011764706,0.023529412,1,21785
37122a6d3aa7f5b5cb48c85a420be1c389010951,0,Aravindan Vijayan,2016-02-09 11:09:26-08:00,['14396f2b74115744d6f4c93b97a9911cd1e58ff1'],0,18,18,21886354,1,,,,21785
73fbe14c2a14619a5023ea0698cda72858c05fbe,0,Jayush Luniya,2016-02-09 15:08:42-08:00,['37122a6d3aa7f5b5cb48c85a420be1c389010951'],109,88,197,21886551,1,1,1,0,21785
feb50e3a3f5edb1105780d06254bb9538d19063e,1,Jun Aoki,2016-02-09 15:33:08-08:00,['73fbe14c2a14619a5023ea0698cda72858c05fbe'],22,76,98,21886649,2,0.757575758,0.272727273,0.636363636,21785
46bbbf9c2c72b52f107d4d929ab3dc6dc05577d4,0,Andrew Onishuk,2016-02-10 13:20:54+02:00,['feb50e3a3f5edb1105780d06254bb9538d19063e'],17,0,17,21886666,1,1,1,1,21785
c543ef8b23f75c828d87e6d0fc4866b567dd5dd7,0,Nate Cole,2016-02-10 11:12:38-05:00,"['697c309c19e04949f1bb9a746f5a5d1e87fb3e39', '46bbbf9c2c72b52f107d4d929ab3dc6dc05577d4']",792,1730,2522,21889188,66,,,,21785
ac5ca8fd1cd51360f7394c1fd85f8a062a4fb8e2,1,Nahappan Somasundaram,2016-02-10 09:27:47-08:00,['46bbbf9c2c72b52f107d4d929ab3dc6dc05577d4'],99,167,266,21889454,6,0,1,1,21785
2a9f49c0e3a1839076fd271cb7caf09b3fc897f4,0,Jonathan Hurley,2016-02-10 12:47:38-05:00,['c543ef8b23f75c828d87e6d0fc4866b567dd5dd7'],3,2,5,21889459,1,1,0,0,21785
8f3b9c49d3fecf7db43b16ef8c06571fd2f79ed9,1,Yusaku Sako,2016-02-10 10:05:27-08:00,['ac5ca8fd1cd51360f7394c1fd85f8a062a4fb8e2'],71,82,153,21889612,4,1,1,0,21786
4870e1f89b155521713d63d8feef18f610f44f58,0,Dmytro Sen,2016-02-10 20:34:26+02:00,['8f3b9c49d3fecf7db43b16ef8c06571fd2f79ed9'],11,6,17,21889629,2,,,,21786
946ac82e7aeabc926ce33a7a6b277a6be1f72f5f,1,Alejandro Fernandez,2016-02-10 11:27:55-08:00,['4870e1f89b155521713d63d8feef18f610f44f58'],2,54,56,21889685,30,,,,21786
5e6a5556b2a40435c6d35d7851e88d896350f53d,1,Jonathan Hurley,2016-02-10 15:12:42-05:00,['946ac82e7aeabc926ce33a7a6b277a6be1f72f5f'],15,80,95,21889780,7,0,1,1,21786
49e33511c4306e2c4f43916405ff223cdd901d97,1,Aravindan Vijayan,2016-02-10 12:28:26-08:00,['5e6a5556b2a40435c6d35d7851e88d896350f53d'],30,203,233,21890013,8,0.166666667,0.325,0.975,21786
0d52ebc05593ebce6e3ab37535bf1345df8f8492,1,Aravindan Vijayan,2016-02-10 12:29:23-08:00,['49e33511c4306e2c4f43916405ff223cdd901d97'],3,5,8,21890021,2,0,0,1,21786
364ee0269f1fecfd58e7bdfca846270850db040f,1,Srimanth Gunturi,2016-02-10 12:38:48-08:00,['0d52ebc05593ebce6e3ab37535bf1345df8f8492'],13,319,332,21890353,9,0.884057971,1,0.942028986,21788
4fe6f000b3851cc7c43664e6e4df4738ab019810,1,Robert Levas,2016-02-11 09:13:27-05:00,['96bdecf8474064465b2ecc1261152d9ba68730e2'],0,1,1,21890354,1,0,1,1,21788
6d258d7c0ddebcc4a9e172e3c473b5ea462d79bf,1,Vitaly Brodetskyi,2016-02-11 02:07:16+02:00,['4fe6f000b3851cc7c43664e6e4df4738ab019810'],3,892,895,21891249,7,0.054054054,0.538738739,0.951351351,21791
c147b27e9bb886ba0380e2b926903343a568ad9d,1,Jun Aoki,2016-02-10 16:45:15-08:00,['364ee0269f1fecfd58e7bdfca846270850db040f'],2,15,17,21891266,3,1,1,1,21791
3242a5590a6cf84f9cd664e38c7ae8b1c2fe968a,1,Jun Aoki,2016-02-10 17:12:48-08:00,['c147b27e9bb886ba0380e2b926903343a568ad9d'],5,17,22,21891288,6,1,1,1,21791
ba604ea6be57bcbd5cff2219b0d821e6ff16d695,1,Yusaku Sako,2016-02-10 17:28:20-08:00,['3242a5590a6cf84f9cd664e38c7ae8b1c2fe968a'],116,82,198,21891486,3,0.055555556,0,0,21791
af560ae372ba171cf8077a3c827df6fd1b4c0e2c,0,Oleg Nechiporenko,2016-02-11 10:38:08+02:00,['ba604ea6be57bcbd5cff2219b0d821e6ff16d695'],5,5,10,21891496,1,1,1,1,21791
6270fe39331eb8f8e16a49ad7b8df59edecd2ce5,1,Andrew Onishuk,2016-02-11 11:15:25+02:00,['af560ae372ba171cf8077a3c827df6fd1b4c0e2c'],137,192,329,21891825,8,0.880952381,0.547619048,1,21792
b9a35f1ea6201c7f7c45a9f1463c0802504ee4a5,0,Jaimin Jetly,2016-02-11 14:53:22+05:18,['6270fe39331eb8f8e16a49ad7b8df59edecd2ce5'],137,18,155,21891980,10,1,0.727272727,0.727272727,21792
209ec330def90559aa767211f3b869d21c13b673,1,Alex Antonenko,2016-02-11 11:48:18+02:00,['b9a35f1ea6201c7f7c45a9f1463c0802504ee4a5'],6,176,182,21892162,4,0.607843137,0.666666667,0.833333333,21792
96bdecf8474064465b2ecc1261152d9ba68730e2,1,Alex Antonenko,2016-02-11 11:48:18+02:00,['209ec330def90559aa767211f3b869d21c13b673'],13,311,324,21892486,10,0.8,1,0.970588235,21794
1809161eb5914c7905745911cecea4d9da7a3f26,0,Nate Cole,2016-02-11 08:46:52-05:00,"['2a9f49c0e3a1839076fd271cb7caf09b3fc897f4', '96bdecf8474064465b2ecc1261152d9ba68730e2']",665,1732,2397,21894883,108,,,,21794
03bc22607d533896f44ee3d60e29aa2a08ffe31e,1,Nate Cole,2016-02-11 08:47:10-05:00,['1809161eb5914c7905745911cecea4d9da7a3f26'],99,535,634,21895517,19,0.096385542,0.746987952,0.843373494,21796
2ca172d4ce7fa6e025ce512212b07eab25f38bcc,0,ababiichuk,2016-02-11 17:46:11+02:00,['6d258d7c0ddebcc4a9e172e3c473b5ea462d79bf'],64,31,95,21895612,9,0.12,0.12,0,21796
b144caae1a219fc461edac9fa352660d2747538b,0,ababiichuk,2016-02-11 17:46:11+02:00,['2ca172d4ce7fa6e025ce512212b07eab25f38bcc'],13,17,30,21895642,1,1,0.5,1,21796
754d0fad592e74bc7e1bdac233ed19e9a5124c7a,1,Yusaku Sako,2016-02-11 08:11:06-08:00,['b144caae1a219fc461edac9fa352660d2747538b'],192,137,329,21895971,8,0.119047619,0.452380952,0,21796
fdb101bdd78a4d6d2626008dc4a146374283e8f3,1,Alex Antonenko,2016-02-11 18:17:50+02:00,['754d0fad592e74bc7e1bdac233ed19e9a5124c7a'],33,204,237,21896208,11,0.691489362,0.872340426,1,21796
58fe67c199b9dde7cd0963c9567e728db983def0,1,Alex Antonenko,2016-02-11 18:17:50+02:00,['fdb101bdd78a4d6d2626008dc4a146374283e8f3'],27,42,69,21896277,5,,,,21796
e0492163d060e1840eecc1d463a9e5ddebbf81a5,1,Dmytro Sen,2016-02-11 19:37:11+02:00,['58fe67c199b9dde7cd0963c9567e728db983def0'],8,8,16,21896293,1,,,,21796
2871d674f57f46220c2448c6e5dbcb456f04878f,1,Robert Levas,2016-02-11 12:59:04-05:00,['e0492163d060e1840eecc1d463a9e5ddebbf81a5'],63,187,250,21896543,12,0,0.970588235,1,21796
f247ddcfa6c7cc48508cbcfa1e681169dce3b495,0,Nahappan Somasundaram,2016-02-11 10:35:00-08:00,['2871d674f57f46220c2448c6e5dbcb456f04878f'],1,5,6,21896549,1,0,0,1,21796
966f3031d50b0106dfe5d19abbdd1e3b84d1f059,0,Nahappan Somasundaram,2016-02-11 10:35:00-08:00,['f247ddcfa6c7cc48508cbcfa1e681169dce3b495'],1,11,12,21896561,1,0,0,1,21796
7d1ab29c5860a8cab6f19eb98c0a7bd25529ec5e,1,Di Li,2016-02-11 13:54:01-05:00,['966f3031d50b0106dfe5d19abbdd1e3b84d1f059'],3,18,21,21896582,2,0,1,1,21796
a638ccb5345cb7f34e2c42b075c33cf3814565db,0,Andrii Tkach,2016-02-11 21:19:13+02:00,['7d1ab29c5860a8cab6f19eb98c0a7bd25529ec5e'],1,63,64,21896646,6,0,0.666666667,1,21797
9419400da987d1a09c17ce511c1fdc307ad7ff65,1,Dmytro Sen,2016-02-11 23:29:27+02:00,['a638ccb5345cb7f34e2c42b075c33cf3814565db'],0,6,6,21896652,3,0,0.833333333,1,21797
a98adb7eb9c61b40a2724f61cc45fc9e70504c2a,0,Dmytro Sen,2016-02-12 00:21:51+02:00,['9419400da987d1a09c17ce511c1fdc307ad7ff65'],1,40,41,21896693,2,0,0.7,1,21797
9fdaf4ed757974fc74df55ac5f86afaf82125283,1,Andrew Onishuk,2016-02-12 01:03:21+02:00,['a98adb7eb9c61b40a2724f61cc45fc9e70504c2a'],208,260,468,21897161,12,0.880952381,0.547619048,1,21798
1e89d1d578d6ae38fe706e7e07eb0cde52429d92,1,Xi Wang,2016-02-11 15:37:49-08:00,['03bc22607d533896f44ee3d60e29aa2a08ffe31e'],32,495,527,21897688,14,0.23853211,0.321100917,0.972477064,21801
6c6ec6304a8acf2876113cd4f930922a183aed2d,1,Jun Aoki,2016-02-11 16:07:31-08:00,['9fdaf4ed757974fc74df55ac5f86afaf82125283'],1,2,3,21897691,1,,,,21801
8aab63270ebfe34aa75c47a150fbb4a1838d0ec1,1,Jun Aoki,2016-02-11 17:05:46-08:00,['6c6ec6304a8acf2876113cd4f930922a183aed2d'],1,61,62,21897753,2,0,1,1,21801
1ead250562513b38e7f2eb57df7cd4bb1d68f06e,1,Alejandro Fernandez,2016-02-11 17:09:45-08:00,['8aab63270ebfe34aa75c47a150fbb4a1838d0ec1'],26,109,135,21897888,19,0,0,0.24,21801
6ffe51450d359a9ad076083a0db8976d6d95c74f,1,Siddharth Wagle,2016-02-11 17:17:36-08:00,['1ead250562513b38e7f2eb57df7cd4bb1d68f06e'],1,1,2,21897890,1,,,,21801
6eed33322291c90c03386b72806fc3be461df5ec,0,Yusaku Sako,2016-02-11 19:10:13-08:00,['6ffe51450d359a9ad076083a0db8976d6d95c74f'],3,3,6,21897896,1,,,,21801
c47fff3576382e0e4efcd9f8b952b7362cec4390,0,Yusaku Sako,2016-02-11 19:12:39-08:00,['6eed33322291c90c03386b72806fc3be461df5ec'],2,2,4,21897900,1,,,,21801
30438e9052d5782d8e2b5fe4b28c6adf9d78c5d7,1,Andrii Tkach,2016-02-12 12:09:23+02:00,['c47fff3576382e0e4efcd9f8b952b7362cec4390'],96,772,868,21898768,16,0.875685558,1,0.989031079,21805
ddba3c5d4e2dbd7f0edf07429df4fa24bbaa2d21,0,Oleg Nechiporenko,2016-02-12 12:23:04+02:00,['30438e9052d5782d8e2b5fe4b28c6adf9d78c5d7'],1,1,2,21898770,1,,,,21805
77daca7a62abb3f6caa8f4be349aee704a1d7267,0,Andrew Onishuk,2016-02-12 16:17:36+02:00,['ddba3c5d4e2dbd7f0edf07429df4fa24bbaa2d21'],7,9,16,21898786,4,,,,21805
b22aa2e4a848ddf39ea7757902f55a1125cb1889,1,Jaimin Jetly,2016-02-12 20:42:06+05:18,['77daca7a62abb3f6caa8f4be349aee704a1d7267'],0,2196,2196,21900982,4,1,1,0.727272727,21807
0a9a3aa514f4859f2f4560fd3bd6c6036b173de8,0,Vitaly Brodetskyi,2016-02-12 03:10:15+02:00,['b22aa2e4a848ddf39ea7757902f55a1125cb1889'],1,33,34,21901016,2,,,,21808
9d8675ade510fa9617a48fa761cd7a829c40ef0b,1,Robert Levas,2016-02-12 11:35:44-05:00,['0a9a3aa514f4859f2f4560fd3bd6c6036b173de8'],24,67,91,21901107,3,0.84,0.92,1,21808
f7055ae76a64f445d2845ce66f6ec925dc94f99d,1,Aleksandr Kovalenko,2016-02-12 20:01:58+02:00,['9d8675ade510fa9617a48fa761cd7a829c40ef0b'],16,29,45,21901152,5,0,0.866666667,1,21808
aac5389fea7867141a3f4f421b2bc0d1e61117f3,1,Aravindan Vijayan,2016-02-12 10:49:22-08:00,['f7055ae76a64f445d2845ce66f6ec925dc94f99d'],4,7,11,21901163,3,0,0,0.333333333,21808
ed55354abaa8bf53ad0c1fda0d935976baf4c53d,1,Andrii Tkach,2016-02-12 22:38:32+02:00,['aac5389fea7867141a3f4f421b2bc0d1e61117f3'],19,30,49,21901212,3,0.666666667,0,1,21808
e18755393326d10564f7d68c2d025572fed25d63,0,Robert Levas,2016-02-12 16:26:35-05:00,['ed55354abaa8bf53ad0c1fda0d935976baf4c53d'],1,13,14,21901226,3,0.6,1,0.7,21808
9e5dd9f8990956e1c9de650822d52d4fdddaba0a,1,Jun Aoki,2016-02-12 18:15:15-08:00,['e18755393326d10564f7d68c2d025572fed25d63'],12,25,37,21901263,1,1,1,1,21808
1319763ec7aa4e436ce2ff30d138180d2a2194b1,1,Jaimin Jetly,2016-02-13 12:52:29+05:18,['9e5dd9f8990956e1c9de650822d52d4fdddaba0a'],31,64,95,21901358,9,0.88,0.88,1,21808
2444745889faed0ccf38c3696c8e91f7e32e4c5b,1,Jaimin Jetly,2016-02-13 12:52:57+05:18,['1319763ec7aa4e436ce2ff30d138180d2a2194b1'],22,1,23,21901381,2,1,1,0,21808
350e9b3eed3608417536d90259a497b3ebd7079d,1,Sumit Mohanty,2016-02-13 09:47:25-08:00,['2444745889faed0ccf38c3696c8e91f7e32e4c5b'],0,50,50,21901431,2,0,1,1,21808
604040fbf71654c2218baef970c27d71b5f449c1,0,Vitaly Brodetskyi,2016-02-12 08:06:01+02:00,['350e9b3eed3608417536d90259a497b3ebd7079d'],10,13,23,21901454,2,0,1,1,21808
230c1d662d5322623e5402fee3f5d766bf985e6f,1,Sumit Mohanty,2016-02-14 11:07:20-08:00,['604040fbf71654c2218baef970c27d71b5f449c1'],1,61,62,21901516,2,0,0.974358974,0.025641026,21808
0ff86b1c869ea1a3e13087e37225dd99a8e37926,1,Andrew Onishuk,2016-02-15 14:18:45+02:00,['230c1d662d5322623e5402fee3f5d766bf985e6f'],5,55,60,21901576,4,0.5,0.5,1,21809
c86964b542c5ac64c0f05ecf12fa1b2677e4ece8,1,Oleg Nechiporenko,2016-02-15 14:38:15+02:00,['0ff86b1c869ea1a3e13087e37225dd99a8e37926'],4,40,44,21901620,11,0.428571429,1,0.714285714,21809
be1b6b9b1cb419725edb8e647d61d48756d184e4,0,Yusaku Sako,2016-02-16 10:30:42-08:00,['0ce5fea6dc47085b75ca83de455f059d7ffc6976'],1,1,2,21901622,1,,,,21809
b900d03a9a4bef2292f1ad0857edf6d73f7abb24,0,Yusaku Sako,2016-02-16 10:38:56-08:00,['be1b6b9b1cb419725edb8e647d61d48756d184e4'],2,2,4,21901626,1,,,,21809
d036fc0170521a46b4b8977ef5d2d71f3daacfb7,0,Richard Zang,2016-02-16 11:09:09-08:00,['b900d03a9a4bef2292f1ad0857edf6d73f7abb24'],4,4,8,21901634,2,,,,21809
f18601c7c786945e0da8883e59b65686338ee2c9,0,Richard Zang,2016-02-16 11:11:54-08:00,['d036fc0170521a46b4b8977ef5d2d71f3daacfb7'],6,6,12,21901646,2,,1,,21809
f41fccfc829919546fcb8e2a79a36a4b477affa6,1,Jun Aoki,2016-02-16 11:33:30-08:00,['f18601c7c786945e0da8883e59b65686338ee2c9'],59,104,163,21901809,10,0.538461538,0.538461538,1,21809
1e510f590f9caa9ef7fb4e71e9badd54cb36b5c0,0,Yusaku Sako,2016-02-16 12:15:43-08:00,['f41fccfc829919546fcb8e2a79a36a4b477affa6'],11,60,71,21901880,3,0.647058824,1,1,21810
21fd70c9bf911d56a91cad514a033fbff3c5bcb4,1,Richard Zang,2016-02-16 14:27:47-08:00,['1e510f590f9caa9ef7fb4e71e9badd54cb36b5c0'],5,2,7,21901887,1,1,1,1,21810
d412ca11c8347fb89e7a5318c72a7dc24d0c2ff9,1,Aravindan Vijayan,2016-02-16 14:41:00-08:00,['21fd70c9bf911d56a91cad514a033fbff3c5bcb4'],4,4,8,21901895,2,,,,21810
529c588add78ce4d0a82542144ba94f89c80299e,0,Jun Aoki,2016-02-16 16:27:02-08:00,['d412ca11c8347fb89e7a5318c72a7dc24d0c2ff9'],18,18,36,21901931,14,,,,21810
e4800e1c97709e8218989080fceb0df406e744ea,1,Jun Aoki,2016-02-16 16:43:39-08:00,['529c588add78ce4d0a82542144ba94f89c80299e'],1,212,213,21902144,3,0.412121212,0.890909091,1,21811
8cfb2db63021fe5d1ed7f44f1d4412e397810090,1,ababiichuk,2016-02-17 11:55:27+02:00,['e4800e1c97709e8218989080fceb0df406e744ea'],392,140,532,21902676,9,0.059322034,0.004237288,0.105932203,21811
03f804c24772bec7e7ccfd31d5d2f594ac0f0262,1,Andrew Onishuk,2016-02-17 14:28:05+02:00,['8cfb2db63021fe5d1ed7f44f1d4412e397810090'],0,3,3,21902679,1,,,,21811
b339542e04290725d3a171afb62e6233950e30b0,1,Dmytro Sen,2016-02-17 16:46:55+02:00,['03f804c24772bec7e7ccfd31d5d2f594ac0f0262'],7,728,735,21903414,27,,,,21836
506bb8d186500ba700bc3f58f1520f105876e0c4,0,Jaimin Jetly,2016-02-17 20:06:15+05:18,['b339542e04290725d3a171afb62e6233950e30b0'],1,19,20,21903434,1,,,,21836
a91890a819e77638d5cb371e49a9a5d0fdebf4d1,1,Alex Antonenko,2016-02-17 17:46:45+02:00,['506bb8d186500ba700bc3f58f1520f105876e0c4'],45,179,224,21903658,7,0.786407767,0.631067961,0.961165049,21836
7d06e8bf68abe725620c0eb60cce16959901c747,1,Nahappan Somasundaram,2016-02-17 09:06:39-08:00,['a91890a819e77638d5cb371e49a9a5d0fdebf4d1'],36,132,168,21903826,2,0.573529412,1,1,21836
d4b67b1fd39fdbdc05c8f0d9449d0c0156befa6c,0,Andrew Onishuk,2016-02-17 19:58:17+02:00,['7d06e8bf68abe725620c0eb60cce16959901c747'],3,3,6,21903832,2,,,,21836
4124ae032646ca3f7bbea19288da9cba259933e5,1,Richard Zang,2016-02-17 11:00:59-08:00,['d4b67b1fd39fdbdc05c8f0d9449d0c0156befa6c'],7,1,8,21903840,1,1,1,1,21836
c282a0eec34809290be93a4c08f6686948ff896f,0,Jun Aoki,2016-02-17 11:12:57-08:00,['4124ae032646ca3f7bbea19288da9cba259933e5'],7,3,10,21903850,1,0,0,0,21836
5a9bb715811f93104cc593215049a861c13d45d0,1,Robert Levas,2016-02-17 14:14:39-05:00,['c282a0eec34809290be93a4c08f6686948ff896f'],0,804,804,21904654,9,0.311827957,0.833333333,0.852150538,21840
0ea255c59005eda4d5684230460d8b1c647c78f7,1,Jun Aoki,2016-02-17 12:27:50-08:00,['5a9bb715811f93104cc593215049a861c13d45d0'],69,56,125,21904779,1,,,,21840
4761fe7c40b10d4a5c1f7b2564df475c4a66222b,1,Vitaly Brodetskyi,2016-02-15 14:51:36+02:00,['0ea255c59005eda4d5684230460d8b1c647c78f7'],69,152,221,21905000,7,0.125,0.3125,1,21840
7f3928bad958f9c57bb21afd43634e3d9ddfedff,0,Andrii Tkach,2016-02-15 17:48:35+02:00,['c86964b542c5ac64c0f05ecf12fa1b2677e4ece8'],8,33,41,21905041,3,0.157894737,1,1,21840
c9858260547854f0b1077cdbe09e459ee5a7678b,1,Alex Antonenko,2016-02-16 11:21:09+02:00,['7f3928bad958f9c57bb21afd43634e3d9ddfedff'],3,8,11,21905052,1,1,1,1,21840
f3e693194dff06513d425d5189a72d3c2169f8ab,0,Dmytro Sen,2016-02-16 14:03:09+02:00,['c9858260547854f0b1077cdbe09e459ee5a7678b'],7,7,14,21905066,7,,,,21840
2926a4ecd3526c3d15291633c287cb6cfcc75b50,1,Oleg Nechiporenko,2016-02-18 17:32:28+02:00,['f92714910c74336a6e797056173dc287185f5ed1'],21,36,57,21905123,6,1,1,1,21840
0c568cc8a20f1f33c1476f7c267c9245efd6dd0f,0,Alex Antonenko,2016-02-18 17:49:31+02:00,['2926a4ecd3526c3d15291633c287cb6cfcc75b50'],10,12,22,21905145,2,0,0,1,21840
0bd63c80b337e0818a5cb55781998c174e4cf6fa,1,Andrew Onishuk,2016-02-18 17:56:22+02:00,['0c568cc8a20f1f33c1476f7c267c9245efd6dd0f'],127,185,312,21905457,14,1,1,1,21841
0a9101e97c21b5bb5f25a84d264176a86f159f2e,1,ababiichuk,2016-02-18 18:54:01+02:00,['0bd63c80b337e0818a5cb55781998c174e4cf6fa'],510,225,735,21906192,5,0.320574163,0.086124402,0.057416268,21841
260419bb848ce962bbc238379221096eb2a31a58,1,tbeerbower,2016-02-18 12:15:55-05:00,['0a9101e97c21b5bb5f25a84d264176a86f159f2e'],1,121,122,21906314,8,0,1,1,21842
fab9fa5d89a188719aa1c873123a94995e1c8aa3,0,Andrew Onishuk,2016-02-18 19:24:10+02:00,['260419bb848ce962bbc238379221096eb2a31a58'],2,18,20,21906334,7,,,,21842
1d7af0ebd37e2e0d01d6e03380cd52750754fea3,1,Andrew Onishuk,2016-02-18 19:43:10+02:00,['fab9fa5d89a188719aa1c873123a94995e1c8aa3'],0,7,7,21906341,1,1,1,1,21842
7da4706a33a03ce38739b5d5f0c11c4b2fc4bb94,0,Jun Aoki,2016-02-18 10:55:42-08:00,['1d7af0ebd37e2e0d01d6e03380cd52750754fea3'],6,3,9,21906350,1,,,,21842
8f58e5f97e0e6c7853956ad4f48d45603cee9d7f,1,Alejandro Fernandez,2016-02-18 11:21:16-08:00,['7da4706a33a03ce38739b5d5f0c11c4b2fc4bb94'],31,178,209,21906559,5,0.350649351,0.662337662,0.766233766,21842
b09994b81c29ce0b9b835205ea7b8ff161a5f517,0,Jaimin Jetly,2016-02-19 00:50:45+05:18,['8f58e5f97e0e6c7853956ad4f48d45603cee9d7f'],5,11,16,21906575,1,1,1,1,21842
a35b3c6dfb5733aef7119dd3b26e295db12d1882,0,Alejandro Fernandez,2016-02-18 11:35:05-08:00,['b09994b81c29ce0b9b835205ea7b8ff161a5f517'],6,9,15,21906590,2,,,,21842
b57749da6dc77e7d1c6340d515ea08a6a4ea4722,0,Vitaly Brodetskyi,2016-02-16 14:15:47+02:00,['a35b3c6dfb5733aef7119dd3b26e295db12d1882'],3,3,6,21906596,3,,,,21842
5fcb71602b1c680d143e39f4aca17e1cc5af7889,0,Alex Antonenko,2016-02-16 15:32:16+02:00,['f3e693194dff06513d425d5189a72d3c2169f8ab'],0,1,1,21906597,1,,,,21842
ea699bb9b1be059949fa6f1ddf6f563e52ed4f5f,1,Alex Antonenko,2016-02-16 15:32:16+02:00,['5fcb71602b1c680d143e39f4aca17e1cc5af7889'],24,39,63,21906660,3,1,1,1,21842
47c8d94fa7df92ccad6a27a4b52a25b9a94c1db7,1,Andrew Onishuk,2016-02-16 16:55:11+02:00,['ea699bb9b1be059949fa6f1ddf6f563e52ed4f5f'],0,6,6,21906666,2,,,,21842
0868a0fc1bce5a5d58ac44eba1af2aaa4c161ef6,1,Robert Levas,2016-02-16 10:28:34-05:00,['47c8d94fa7df92ccad6a27a4b52a25b9a94c1db7'],1,58,59,21906725,2,0,1,1,21842
7e75e52a91568d7ed0dd2bdaafbd60b37a3e7dc8,1,Dmytro Sen,2016-02-16 17:53:11+02:00,['0868a0fc1bce5a5d58ac44eba1af2aaa4c161ef6'],721,1113,1834,21908559,64,0.138888889,0.25,0.416666667,21844
aa06ebe4cced24c3f2830e95053bf8a1507bbbb9,1,Robert Levas,2016-02-16 12:13:54-05:00,['7e75e52a91568d7ed0dd2bdaafbd60b37a3e7dc8'],2,6,8,21908567,1,0,1,1,21844
a4f8a9567b68c755eb78438233959e50d2095a41,1,Aleksandr Kovalenko,2016-02-16 19:34:59+02:00,['aa06ebe4cced24c3f2830e95053bf8a1507bbbb9'],4,107,111,21908678,6,0.5625,1,1,21845
0ce5fea6dc47085b75ca83de455f059d7ffc6976,1,Andrew Onishuk,2016-02-16 19:40:10+02:00,['a4f8a9567b68c755eb78438233959e50d2095a41'],46,57,103,21908781,3,1,0.263157895,0,21845
718f2ea1832eb10f666fd0519c0cf0c7005b6d4a,0,Jonathan Hurley,2016-02-16 13:29:05-05:00,"['1e89d1d578d6ae38fe706e7e07eb0cde52429d92', '0ce5fea6dc47085b75ca83de455f059d7ffc6976']",1235,6513,7748,21916529,215,,,,21845
e4d1475eab7be09baeed6624447b122f2bf7853c,1,Jonathan Hurley,2016-02-16 15:54:39-05:00,['718f2ea1832eb10f666fd0519c0cf0c7005b6d4a'],57,599,656,21917185,12,0.429292929,0.772727273,0.944444444,21846
f11d76db25714e0bea2b52f907051664ee160aaa,1,Richard Zang,2016-02-17 13:51:07-08:00,['4761fe7c40b10d4a5c1f7b2564df475c4a66222b'],27,74,101,21917286,3,0.242424242,0.333333333,1,21846
b15c0f3d7432dbd6b6ce6c678b6cc2884a73c68b,1,Jun Aoki,2016-02-17 14:46:58-08:00,['f11d76db25714e0bea2b52f907051664ee160aaa'],56,26,82,21917368,2,0,0,0,21846
df2dbe150b97ecb74ddf4652463b8062f288203a,1,Andrew Onishuk,2016-02-18 00:50:48+02:00,['b15c0f3d7432dbd6b6ce6c678b6cc2884a73c68b'],175,267,442,21917810,39,0.511111111,1,1,21846
8999aee37b2f4129304f6e93b7928d0bafd68f25,1,Aravindan Vijayan,2016-02-17 15:20:10-08:00,['df2dbe150b97ecb74ddf4652463b8062f288203a'],3,3,6,21917816,1,,,,21846
b53a13fe6a96eb8e620f0ee86643c8b96ed19c77,1,Alejandro Fernandez,2016-02-17 16:24:02-08:00,['8999aee37b2f4129304f6e93b7928d0bafd68f25'],11,18,29,21917845,9,,,,21846
dcebcca60d47743176519b7758b86505263e39a7,1,Jun Aoki,2016-02-17 18:52:38-08:00,['b53a13fe6a96eb8e620f0ee86643c8b96ed19c77'],4,5,9,21917854,2,1,1,1,21846
84ca6a88d0ba80011394a0ab767a80c7e342aa3c,0,Nahappan Somasundaram,2016-02-17 22:39:49-08:00,['dcebcca60d47743176519b7758b86505263e39a7'],93,24,117,21917971,3,,,,21847
1bd4c2329192157f0977bb7e1941485202b04837,1,Andrii Tkach,2016-02-18 09:51:59+02:00,['84ca6a88d0ba80011394a0ab767a80c7e342aa3c'],377,1040,1417,21919388,12,1,1,0.985024958,21849
f92714910c74336a6e797056173dc287185f5ed1,1,Alex Antonenko,2016-02-18 13:14:49+02:00,['1bd4c2329192157f0977bb7e1941485202b04837'],10,33,43,21919431,2,0,1,1,21849
418745d1297e41d08ba522544ffb17d3bbb22f77,0,Nate Cole,2016-02-18 08:33:10-05:00,"['e4d1475eab7be09baeed6624447b122f2bf7853c', 'f92714910c74336a6e797056173dc287185f5ed1']",1496,4116,5612,21925043,168,,,,21849
0818202169217994fab9dcc254b7728a2bfc238f,1,Jayush Luniya,2016-02-18 12:55:38-08:00,['b57749da6dc77e7d1c6340d515ea08a6a4ea4722'],8,24,32,21925075,10,0,1,1,21849
6d121dd6e361b36a144134cd6f89c72e7cc17f27,1,Andrew Onishuk,2016-02-18 23:43:41+02:00,['0818202169217994fab9dcc254b7728a2bfc238f'],0,1,1,21925076,1,,,,21849
defbeddae55d110b3323b389c2666071eec6883d,0,Oleksandr Diachenko,2016-02-18 13:54:05-08:00,['6d121dd6e361b36a144134cd6f89c72e7cc17f27'],2,7,9,21925085,1,0,1,1,21849
5ae72ac59e14dc033140ee4626dbe0761a574893,1,Aravindan Vijayan,2016-02-18 14:28:35-08:00,['defbeddae55d110b3323b389c2666071eec6883d'],15,16,31,21925116,1,,,,21849
183f71f90495cfbba29961182b293c9408d3effb,0,Sumit Mohanty,2016-02-18 14:53:44-08:00,['5ae72ac59e14dc033140ee4626dbe0761a574893'],1,0,1,21925117,1,,,,21849
0941997b0f68f1044242354c9f3f0f4b3a476c7d,1,Jun Aoki,2016-02-18 17:44:41-08:00,['183f71f90495cfbba29961182b293c9408d3effb'],75,96,171,21925288,11,0.625,0.625,1,21849
9c9b4ab3b6c7822168ad2c5e408ead2170ecc65d,1,Andrii Tkach,2016-02-19 11:38:18+02:00,['0941997b0f68f1044242354c9f3f0f4b3a476c7d'],5,20,25,21925313,2,1,1,1,21849
d48fb9b6dda40873da3ef46a1d8738678fe8b62f,1,Dmytro Sen,2016-02-19 13:44:50+02:00,['9c9b4ab3b6c7822168ad2c5e408ead2170ecc65d'],0,721,721,21926034,25,,,,21874
4b5a250e7778ffa89e318d293dafe727d8a20644,0,Lisnichenko Dmitro,2016-02-19 15:24:50+02:00,"['418745d1297e41d08ba522544ffb17d3bbb22f77', 'd48fb9b6dda40873da3ef46a1d8738678fe8b62f']",826,1691,2517,21928551,103,,,,21874
9873e69624ca429446312dfdb736f8b3d3d572cf,1,Nate Cole,2016-02-19 08:31:44-05:00,['4b5a250e7778ffa89e318d293dafe727d8a20644'],70,148,218,21928769,9,1,1,0.526315789,21875
739ed206ef5e1152f7080b463a32127716d96711,1,Dmytro Sen,2016-02-19 15:57:40+02:00,['d48fb9b6dda40873da3ef46a1d8738678fe8b62f'],32,83,115,21928884,11,0,0.611111111,0.944444444,21875
a0c4dcc5db21903391e6bd5e819fefb921f4e3ca,1,Dmytro Sen,2016-02-19 16:18:03+02:00,['739ed206ef5e1152f7080b463a32127716d96711'],5,44,49,21928933,3,0.636363636,1,0.636363636,21875
fca04c305c472db7a11d9b121b3de38a4f176f84,1,Nahappan Somasundaram,2016-02-19 07:55:33-08:00,['a0c4dcc5db21903391e6bd5e819fefb921f4e3ca'],30,218,248,21929181,16,0.3125,0.741071429,0.705357143,21875
4f78af7ae47564fdc6a2c013cf1757f19005e6a5,1,Jonathan Hurley,2016-02-19 11:11:30-05:00,['9873e69624ca429446312dfdb736f8b3d3d572cf'],72,397,469,21929650,7,0.167664671,0.646706587,0.952095808,21875
f000a5c44342095fa9664518649cbf60d684783e,0,Dmytro Sen,2016-02-19 20:52:36+02:00,['fca04c305c472db7a11d9b121b3de38a4f176f84'],1,0,1,21929651,1,,,,21875
bd5fcae473fe6ad0815b3958024542a5204feefa,0,Jaimin Jetly,2016-02-20 00:34:31+05:18,['f000a5c44342095fa9664518649cbf60d684783e'],15,26,41,21929692,3,0,0.75,0.75,21875
d207bef2513f31d6fc2501e28aacbd70ed930028,1,Jaimin Jetly,2016-02-20 00:39:48+05:18,['bd5fcae473fe6ad0815b3958024542a5204feefa'],3,38,41,21929733,1,,,,21875
997749f73d2403a634c7543e1a6d16eb3d6950e4,0,Alex Antonenko,2016-02-19 22:01:24+02:00,['d207bef2513f31d6fc2501e28aacbd70ed930028'],2,2,4,21929737,1,,,,21875
82d944017eb90c380e374e6f7aeddab6004c6a84,1,Jun Aoki,2016-02-19 12:05:40-08:00,['997749f73d2403a634c7543e1a6d16eb3d6950e4'],4,286,290,21930027,7,0.607594937,0.746835443,1,21877
dccacb9528f81c06d8e9bef85f4a0dbce6b0e507,0,Sumit Mohanty,2016-02-19 12:28:11-08:00,['82d944017eb90c380e374e6f7aeddab6004c6a84'],17,18,35,21930062,1,0,1,1,21877
32173ff17642b8cdca6f0fdd5318683b633bb681,1,Jun Aoki,2016-02-19 13:37:08-08:00,['dccacb9528f81c06d8e9bef85f4a0dbce6b0e507'],16,62,78,21930140,2,0,0.974358974,0.974358974,21877
20056273ec9279f4823e495cdecfe514537f1223,1,Sumit Mohanty,2016-02-19 13:37:50-08:00,['32173ff17642b8cdca6f0fdd5318683b633bb681'],75,435,510,21930650,20,0.738095238,0.68452381,0.910714286,21877
1ba6722d14f54910d73f4b4d8decbb9a3cb1c5d6,0,Jun Aoki,2016-02-19 14:16:20-08:00,['20056273ec9279f4823e495cdecfe514537f1223'],1,1,2,21930652,1,,,,21877
4bdd8dd9c6a391e7caa1bbf817989edadd4e8e10,0,Andrew Onishuk,2016-02-20 22:01:25+02:00,['1ba6722d14f54910d73f4b4d8decbb9a3cb1c5d6'],19,22,41,21930693,1,1,1,1,21877
6044f0c829c0879f3195d7fd445da413d8176222,1,Nahappan Somasundaram,2016-02-20 17:10:06-08:00,['4bdd8dd9c6a391e7caa1bbf817989edadd4e8e10'],4,29,33,21930726,6,0.357142857,1,1,21877
a8e337caf432008a5d935648c852cb3ab4aed67f,1,Vitaly Brodetskyi,2016-02-22 11:37:56+02:00,['6044f0c829c0879f3195d7fd445da413d8176222'],1,1,2,21930728,1,,,,21877
29d3f6cc7fdb03619de8e6819832927315b303b7,1,Vitaly Brodetskyi,2016-02-22 15:07:17+02:00,['a8e337caf432008a5d935648c852cb3ab4aed67f'],60,97,157,21930885,2,0.24,0,1,21877
1536e42a481a2f2672b98e8278230cc24392ba83,0,Alex Antonenko,2016-02-22 15:30:29+02:00,['29d3f6cc7fdb03619de8e6819832927315b303b7'],11,0,11,21930896,11,,,,21877
c8f65e3512c6f4095aff651936e655f013a8243e,1,Andrew Onishuk,2016-02-22 16:27:23+02:00,['1536e42a481a2f2672b98e8278230cc24392ba83'],0,132,132,21931028,4,0.011363636,0.681818182,1,21877
dea22be16c172ed0ca7a6e66ac29bda04027ca2f,0,Lisnichenko Dmitro,2016-02-22 17:19:56+02:00,['4f78af7ae47564fdc6a2c013cf1757f19005e6a5'],222,1270,1492,21932520,63,0.48381295,0.748201439,0.895683453,21879
2a7196d77bca67203e73209cf5c5f9cbdcab28ec,0,Andrew Onishuk,2016-02-22 18:03:01+02:00,['c8f65e3512c6f4095aff651936e655f013a8243e'],2,3,5,21932525,1,,,,21879
4fcca627e1094e87ee471a3f21e6d57cadf09b79,1,Oleg Nechiporenko,2016-02-22 18:12:11+02:00,['2a7196d77bca67203e73209cf5c5f9cbdcab28ec'],83,72,155,21932680,23,0,0,0,21879
4d3839c7f9ce921e92de82bc66440167cb6173a9,0,Nate Cole,2016-02-22 11:24:56-05:00,['dea22be16c172ed0ca7a6e66ac29bda04027ca2f'],1270,222,1492,21934172,63,0.51618705,0.251798561,0.104316547,21879
5366af8ca9cdf245396e9ee92a2dba9170a0456f,0,Sumit Mohanty,2016-02-22 08:35:25-08:00,['4fcca627e1094e87ee471a3f21e6d57cadf09b79'],2,2,4,21934176,1,,,,21879
2eea1bfa9008b0e17dcca8c196ea911fdce041fd,1,Nate Cole,2016-02-22 11:48:00-05:00,"['4d3839c7f9ce921e92de82bc66440167cb6173a9', '4fcca627e1094e87ee471a3f21e6d57cadf09b79']",378,1564,1942,21936118,100,,,,21879
ec91f74a45544d67cb8bece50bd0ba44d9eeb749,0,Nate Cole,2016-02-22 11:48:50-05:00,"['2eea1bfa9008b0e17dcca8c196ea911fdce041fd', '5366af8ca9cdf245396e9ee92a2dba9170a0456f']",2,2,4,21936122,1,,,,21879
55342fc621aed290173cc09f137af97afa18dc0d,1,Jonathan Hurley,2016-02-22 11:50:00-05:00,['ec91f74a45544d67cb8bece50bd0ba44d9eeb749'],19,198,217,21936339,3,0.151515152,0.808080808,0,21879
1dbf7d4ef5d41837f36c961d333506057751a855,1,Dipayan Bhowmick,2016-02-22 22:16:05+05:18,['5366af8ca9cdf245396e9ee92a2dba9170a0456f'],2,5,7,21936346,1,0,0,1,21879
b0ab893ff09a014b704c84615c852fdb6b1d84e7,1,Dipayan Bhowmick,2016-02-22 22:32:52+05:18,['1dbf7d4ef5d41837f36c961d333506057751a855'],0,32,32,21936378,4,1,1,1,21879
9dfe929ee399953177611fe1f26abe98f5b9a265,1,Dipayan Bhowmick,2016-02-22 22:38:52+05:18,['b0ab893ff09a014b704c84615c852fdb6b1d84e7'],1,6,7,21936385,1,0,0,1,21879
ecd6a3057dafe7adb12e46e7348fea5d912635a6,1,Oleksandr Diachenko,2016-02-22 13:25:41-08:00,['9dfe929ee399953177611fe1f26abe98f5b9a265'],3,102,105,21936490,2,0,0,0.978494624,21879
49813c987a491d1527f6499927d22746a11f3631,1,Jun Aoki,2016-02-22 14:44:07-08:00,['ecd6a3057dafe7adb12e46e7348fea5d912635a6'],75,96,171,21936661,3,0,0.8,0.75,21879
d741e438db58bcea2d59f902ccf9d7ad40097b7f,1,Jun Aoki,2016-02-22 14:51:07-08:00,['49813c987a491d1527f6499927d22746a11f3631'],1,8,9,21936670,2,,,,21879
7091250a932bbb5cd4edc2d4c421f64abc710a13,1,Richard Zang,2016-02-22 16:00:54-08:00,['d741e438db58bcea2d59f902ccf9d7ad40097b7f'],22,22,44,21936714,4,,,,21879
0682fb603f96bf9ded5333b19751011399c33099,0,Jun Aoki,2016-02-22 16:06:24-08:00,['7091250a932bbb5cd4edc2d4c421f64abc710a13'],2,2,4,21936718,1,,,,21879
b1be75f9a718863b942a5f1117804f1636d42768,1,Richard Zang,2016-02-22 18:34:37-08:00,['0682fb603f96bf9ded5333b19751011399c33099'],38,62,100,21936818,9,1,1,1,21879
396b7da71b18a837416b67e6b8a29cde62265709,0,Andrew Onishuk,2016-02-23 12:42:06+02:00,['b1be75f9a718863b942a5f1117804f1636d42768'],13,38,51,21936869,4,0,0,0,21879
9310ab70ce178f6cd89d1be2be92081b26e2e832,1,Vitaly Brodetskyi,2016-02-23 14:15:58+02:00,['396b7da71b18a837416b67e6b8a29cde62265709'],20,79,99,21936968,2,0,1,1,21879
50547c5ed6076a6fdd18830b179cd28411288496,0,Nate Cole,2016-02-23 09:06:59-05:00,"['55342fc621aed290173cc09f137af97afa18dc0d', '9310ab70ce178f6cd89d1be2be92081b26e2e832']",177,452,629,21937597,32,,,,21879
ea6a7a614190917abaa22dbec5895cb9b66b13b4,1,ababiichuk,2016-02-23 17:02:00+02:00,['9310ab70ce178f6cd89d1be2be92081b26e2e832'],338,227,565,21938162,16,0.779527559,0.236220472,0.062992126,21880
cbef0c14682ae24f2754063c48ce521c58cdca27,1,Lisnichenko Dmitro,2016-02-23 17:18:57+02:00,['50547c5ed6076a6fdd18830b179cd28411288496'],897,979,1876,21940038,59,1,1,0,21880
e1ca24160027d73cf27b90b35bc0757442a0cbdd,0,Robert Levas,2016-02-23 11:12:05-05:00,['ea6a7a614190917abaa22dbec5895cb9b66b13b4'],10,35,45,21940083,6,1,1,1,21880
f7ebe912b7647caa97b8c28f243d0f8a92f5dfb6,1,Robert Levas,2016-02-23 11:13:11-05:00,['e1ca24160027d73cf27b90b35bc0757442a0cbdd'],35,10,45,21940128,6,0,0,0,21880
2b42559f516d0f45072174dac5f9d230b8e7c31c,1,Robert Levas,2016-02-23 11:14:02-05:00,['f7ebe912b7647caa97b8c28f243d0f8a92f5dfb6'],10,182,192,21940320,8,0.37704918,1,0.37704918,21882
df0b18ca5da59d9ed6bc4340ac09eb51db9963a4,1,Alex Antonenko,2016-02-23 19:17:41+02:00,['2b42559f516d0f45072174dac5f9d230b8e7c31c'],25,55,80,21940400,4,0.678571429,1,1,21882
18d5a6964212237c0cd9a5c8c8211cd059cae716,1,Andrew Onishuk,2016-02-23 19:42:54+02:00,['df0b18ca5da59d9ed6bc4340ac09eb51db9963a4'],53,127,180,21940580,17,1,1,1,21884
9d7ff5f14f44a58ba280a964a51a85e9f654b27f,0,Andrew Onishuk,2016-02-23 20:06:24+02:00,['18d5a6964212237c0cd9a5c8c8211cd059cae716'],0,0,0,21940580,1,,,,21884
083ac6dab5cf59c01da054eb656507c089a54620,1,Myroslav Papirkovskyi,2016-02-23 21:04:22+02:00,['9d7ff5f14f44a58ba280a964a51a85e9f654b27f'],1975,2559,4534,21945114,10,0.88028169,0.950704225,1,21887
e06d95d1b779da2762e46de6c8d72a3523498401,0,Nate Cole,2016-02-23 16:21:20-05:00,"['cbef0c14682ae24f2754063c48ce521c58cdca27', '083ac6dab5cf59c01da054eb656507c089a54620']",2368,3149,5517,21950631,54,,,,21887
e5d580f28880a981b16dd5b729243a3eda0cf722,1,Nate Cole,2016-02-23 17:09:03-05:00,['e06d95d1b779da2762e46de6c8d72a3523498401'],83,48,131,21950762,2,1,1,1,21887
d032056754246880a48939255784767bc31302e4,0,Jun Aoki,2016-02-23 16:03:37-08:00,['083ac6dab5cf59c01da054eb656507c089a54620'],0,8,8,21950770,1,0,0,0,21887
a5b673dd18b5849792aace38f8e377f57f45b610,1,Xi Wang,2016-02-23 16:05:23-08:00,['e5d580f28880a981b16dd5b729243a3eda0cf722'],254,275,529,21951299,9,1,0,0,21887
4ae5200fd92833e8e6bb42f66432598404223cdb,0,Jayush Luniya,2016-02-23 17:35:02-08:00,['d032056754246880a48939255784767bc31302e4'],4,163,167,21951466,1,,,,21887
03534a08dc901a67485f2def034a2cf3920240f1,0,Alex Antonenko,2016-02-24 13:46:31+02:00,['4ae5200fd92833e8e6bb42f66432598404223cdb'],1,4,5,21951471,1,1,1,1,21887
9246125443dca9d2c59d1617f59e4229cb85fb88,1,Alex Antonenko,2016-02-24 13:46:31+02:00,['03534a08dc901a67485f2def034a2cf3920240f1'],33,165,198,21951669,8,0.256410256,0.564102564,1,21887
1c561140787d6cae8784ad894a0cfd7e354a98e1,0,Alex Antonenko,2016-02-24 14:02:49+02:00,['9246125443dca9d2c59d1617f59e4229cb85fb88'],6,14,20,21951689,6,0.75,1,0.25,21887
6e002b25c891c04d4d4308071ffab865c624c942,1,Dmytro Sen,2016-02-24 15:54:21+02:00,['1c561140787d6cae8784ad894a0cfd7e354a98e1'],94,355,449,21952138,17,0.42384106,0.794701987,0.695364238,21889
db999ae82c148dd69340fb40efff4d0b1c06fa04,0,Nate Cole,2016-02-24 09:23:53-05:00,"['a5b673dd18b5849792aace38f8e377f57f45b610', '6e002b25c891c04d4d4308071ffab865c624c942']",138,709,847,21952985,34,,,,21889
b988562aa75531aef5f77ec5ee02d22bbb13fe07,1,Dipayan Bhowmick,2016-02-24 23:35:02+05:18,['db999ae82c148dd69340fb40efff4d0b1c06fa04'],8666,5457,14123,21967108,170,0.665653495,0.531046461,0.156752063,21974
b81db70e5bdfdcb6b82274ccce84fb051eeae180,1,Bob Nettleton,2016-02-24 13:47:40-05:00,['b988562aa75531aef5f77ec5ee02d22bbb13fe07'],66,82,148,21967256,21,0,0,0,21974
c83bcbd9ef776155eda3f8c1e933d6097cdb8e50,0,Nahappan Somasundaram,2016-02-24 11:12:52-08:00,['b81db70e5bdfdcb6b82274ccce84fb051eeae180'],37,4,41,21967297,1,0,0,0.294117647,21974
3cee3de489821c9482309363ead40c74dfa457d8,1,Richard Zang,2016-02-24 11:29:20-08:00,['c83bcbd9ef776155eda3f8c1e933d6097cdb8e50'],110,117,227,21967524,5,0.222222222,1,0.888888889,21974
970f2cf8f5ca6ca80fc683cab8b781d04e7e2d1f,1,Alejandro Fernandez,2016-02-24 11:53:48-08:00,['3cee3de489821c9482309363ead40c74dfa457d8'],15,205,220,21967744,11,0.327868852,0.426229508,1,21974
3f33edf50aeecca3396a62ef395b44c29b1d3065,1,Robert Levas,2016-02-24 15:44:54-05:00,['970f2cf8f5ca6ca80fc683cab8b781d04e7e2d1f'],97,193,290,21968034,6,0,0.393442623,0.262295082,21974
9bad06c0f27135bba2e377bdb87927c45ae41502,1,Andrew Onishuk,2016-02-24 22:56:02+02:00,['3f33edf50aeecca3396a62ef395b44c29b1d3065'],0,7,7,21968041,1,,,,21974
22ec03b69762a03691b6c76b7cbccaa2cc571852,1,Siddharth Wagle,2016-02-24 14:26:45-08:00,['9bad06c0f27135bba2e377bdb87927c45ae41502'],39,273,312,21968353,9,0.075630252,0.25210084,1,21975
198f315881dbf78eb90a9c3b7456b5cdaf751ca1,0,Jayush Luniya,2016-02-24 18:12:49-08:00,['22ec03b69762a03691b6c76b7cbccaa2cc571852'],0,1,1,21968354,1,,,,21975
4c8d75df6fdb876b538f047f8fc8ab5dfaf1f689,1,Dipayan Bhowmick,2016-02-25 12:37:49+05:18,['198f315881dbf78eb90a9c3b7456b5cdaf751ca1'],3,12,15,21968369,2,1,1,1,21975
16a0d794be60614b1c5a4e3fd464e5c986754c09,1,Andrew Onishuk,2016-02-25 09:29:22+02:00,['4c8d75df6fdb876b538f047f8fc8ab5dfaf1f689'],1,1,2,21968371,1,,,,21975
0abc53fa55767e72229d783aa862813e51ffd067,0,Aleksandr Kovalenko,2016-02-25 11:27:22+02:00,['16a0d794be60614b1c5a4e3fd464e5c986754c09'],0,9,9,21968380,2,0.888888889,1,1,21975
35db055aaef6e410d9d3e0c9744871453088b85e,0,Andrew Onishuk,2016-02-25 12:41:06+02:00,['0abc53fa55767e72229d783aa862813e51ffd067'],4,6,10,21968390,1,,,,21975
70c6dbc4701ed4ec73caec547c75c36b78fc8585,0,Andrew Onishuk,2016-02-25 12:44:00+02:00,['35db055aaef6e410d9d3e0c9744871453088b85e'],0,2,2,21968392,1,,,,21975
afc2f7b24f3112466432c9e5dcff07a4fa3931ff,1,Lisnichenko Dmitro,2016-02-25 14:04:52+02:00,['70c6dbc4701ed4ec73caec547c75c36b78fc8585'],3,12,15,21968407,2,0,0,0,21975
87f8746f46494d688b5cc0ae6040ec137723b414,1,Oleg Nechiporenko,2016-02-25 14:15:25+02:00,['afc2f7b24f3112466432c9e5dcff07a4fa3931ff'],1288,610,1898,21970305,38,0.588850174,0.344947735,0,21977
66ba9f294f879d1636038b8873447207df130300,0,Oleg Nechiporenko,2016-02-25 15:04:55+02:00,['87f8746f46494d688b5cc0ae6040ec137723b414'],6,5,11,21970316,1,0,0,0,21977
46b4a797ee60803b553e1a7611b6fd2468c79386,0,Andrew Onishuk,2016-02-25 16:07:13+02:00,['66ba9f294f879d1636038b8873447207df130300'],0,7,7,21970323,1,,,,21977
efb4b877850ca5d56153afe278d48a459b0f07b3,1,tbeerbower,2016-02-25 09:50:37-05:00,['46b4a797ee60803b553e1a7611b6fd2468c79386'],10,79,89,21970412,4,0,0,0,21977
ed954bbe86575d8aa0730968c4642807fb87a6d5,0,Alex Antonenko,2016-02-25 18:09:37+02:00,['efb4b877850ca5d56153afe278d48a459b0f07b3'],0,4,4,21970416,2,0,0,1,21977
c82f1337e406b37d5515c5de4fc1a9d4b541f843,0,Myroslav Papirkovskyi,2016-02-25 18:13:49+02:00,['ed954bbe86575d8aa0730968c4642807fb87a6d5'],17,121,138,21970554,3,0.028571429,0.585714286,1,21977
0817b4d22b17f8b797fb509827ca3e93d190621c,1,Andrew Onishuk,2016-02-25 19:13:47+02:00,['c82f1337e406b37d5515c5de4fc1a9d4b541f843'],8,15,23,21970577,2,0,0,1,21977
e4aeab5f870cedfe3c97c75e126e856176c5f46b,0,Aleksandr Kovalenko,2016-02-25 19:41:21+02:00,['0817b4d22b17f8b797fb509827ca3e93d190621c'],1,1,2,21970579,1,,,,21977
1621a53dc5820ba1ca5bf5204628b51d341f0caa,1,Jonathan Hurley,2016-02-25 13:02:03-05:00,['e4aeab5f870cedfe3c97c75e126e856176c5f46b'],100,710,810,21971389,9,0.361111111,0.798611111,0.951388889,21981
1df953d68aea7bc33d0fa01f5500c8e896c3abe7,1,Lisnichenko Dmitro,2016-02-25 21:23:34+02:00,['1621a53dc5820ba1ca5bf5204628b51d341f0caa'],0,44,44,21971433,2,0.275862069,1,1,21981
f495bbc02e462981720956b5e61ec102f746728f,0,Jun Aoki,2016-02-25 14:11:19-08:00,['1df953d68aea7bc33d0fa01f5500c8e896c3abe7'],8,4,12,21971445,2,0,0,0,21981
a4deda3477925d52df9fc95e7736b8b5d6fece81,1,Jayush Luniya,2016-02-25 14:14:58-08:00,['f495bbc02e462981720956b5e61ec102f746728f'],121,17,138,21971583,3,0.971428571,0.414285714,0,21981
4221872a6d9827ba3e026c767c3f3f7efe01bee0,0,Jayush Luniya,2016-02-25 14:50:11-08:00,['a4deda3477925d52df9fc95e7736b8b5d6fece81'],7,36,43,21971626,2,0,0,0,21981
be893d04004ebb17076e1416f96a576fded42984,1,Myroslav Papirkovskyi,2016-02-26 00:57:42+02:00,['4221872a6d9827ba3e026c767c3f3f7efe01bee0'],17,122,139,21971765,4,0.028169014,0.591549296,1,21981
c3b3bac940e766914567f3c10ff85137a3ad3e14,1,Jayush Luniya,2016-02-25 15:01:32-08:00,['be893d04004ebb17076e1416f96a576fded42984'],105,119,224,21971989,2,0,0.3,0,21981
8fb17ab09e4b71817b5eea90097b2cb11979b5fb,1,Jayush Luniya,2016-02-25 15:03:18-08:00,['c3b3bac940e766914567f3c10ff85137a3ad3e14'],1,1,2,21971991,1,,,,21981
29115e81ee2ba6643c7725903300f070c4ba2ea5,1,Jun Aoki,2016-02-25 15:45:58-08:00,['8fb17ab09e4b71817b5eea90097b2cb11979b5fb'],2,310,312,21972303,4,1,1,0.825396825,21983
d1cec98c9a98d8e183e13ceeb06e11ebd02a0701,1,Dmytro Sen,2016-02-26 09:25:43+02:00,['29115e81ee2ba6643c7725903300f070c4ba2ea5'],21,87,108,21972411,2,0,1,1,21983
1485e3f04730daa4e425fc72e7d577a5b646b068,0,Dipayan Bhowmick,2016-02-26 12:47:17+05:18,['d1cec98c9a98d8e183e13ceeb06e11ebd02a0701'],3,137,140,21972551,3,0.547169811,0.547169811,1,21983
7af320663005f1c07d8f3973be501a704bac0e17,0,Dipayan Bhowmick,2016-02-26 12:53:47+05:18,['1485e3f04730daa4e425fc72e7d577a5b646b068'],3,25,28,21972579,3,,,,21983
0ea54c830fdc553d150fe2805e4cd88b843141fa,0,Dipayan Bhowmick,2016-02-26 12:57:30+05:18,['7af320663005f1c07d8f3973be501a704bac0e17'],3,21,24,21972603,4,1,1,1,21983
a5f81f8618a5e0b1b90a8dc2da9c0cf7d36dcff4,1,ababiichuk,2016-02-26 11:11:10+02:00,['0ea54c830fdc553d150fe2805e4cd88b843141fa'],66,72,138,21972741,5,0.921052632,0,0,21983
2fee278f6826c467a298a1e896cb9d9c8267c0f9,1,Pallav Kulshreshtha,2016-02-26 15:18:01+05:18,['a5f81f8618a5e0b1b90a8dc2da9c0cf7d36dcff4'],625,4224,4849,21977590,47,0.56031746,0.848677249,0.925925926,22011
965c42fb69a6a3c593ada3c69a80b57b4cd76d5c,0,Dipayan Bhowmick,2016-02-26 15:34:41+05:18,['2fee278f6826c467a298a1e896cb9d9c8267c0f9'],3,8,11,21977601,2,1,0,0,22011
4e253f6765cb2e4a7269547e72027bb1711f4034,0,Dipayan Bhowmick,2016-02-26 15:36:10+05:18,['965c42fb69a6a3c593ada3c69a80b57b4cd76d5c'],12,44,56,21977657,2,0.208333333,1,1,22011
6e758b76a0d0802db89163467997433fa43f4a11,1,Dipayan Bhowmick,2016-02-26 15:37:29+05:18,['4e253f6765cb2e4a7269547e72027bb1711f4034'],0,13,13,21977670,1,1,1,1,22011
6a808b19f1ae5a368ffac30709e8182df5513cc4,1,Andrii Tkach,2016-02-26 12:33:53+02:00,['6e758b76a0d0802db89163467997433fa43f4a11'],60,1031,1091,21978761,11,0.701986755,1,1,22013
5fd757939cddaafa9f8426044ebee3c72f28c23c,0,Pallav Kulshreshtha,2016-02-26 17:14:01+05:18,['6a808b19f1ae5a368ffac30709e8182df5513cc4'],103,8,111,21978872,10,0,0,0,22013
180cc399dc658dc33962ba41e7017c899dd77a76,0,Alex Antonenko,2016-02-26 17:57:01+02:00,['5fd757939cddaafa9f8426044ebee3c72f28c23c'],0,3,3,21978875,1,,,,22013
51b067f910828d55652988bdb9799a032e4f6c9d,1,"Toader, Sebastian",2016-02-26 18:20:42+01:00,['180cc399dc658dc33962ba41e7017c899dd77a76'],9,71,80,21978955,3,0.393939394,1,0.303030303,22013
02cfa649195ec2202242e767893ac3ba425d14ad,0,Jaimin Jetly,2016-02-26 12:06:17-08:00,['51b067f910828d55652988bdb9799a032e4f6c9d'],4,5,9,21978964,3,,,,22013
73ac59fc33e64cc1443fc19ba5360d047b0e348a,1,Jonathan Hurley,2016-02-26 15:17:01-05:00,['02cfa649195ec2202242e767893ac3ba425d14ad'],191,404,595,21979559,7,0.484848485,0.949494949,1,22014
2f8636e5eafa4d9d26097a6e0d8f8dcde59d2e75,1,Jun Aoki,2016-02-26 12:24:11-08:00,['73ac59fc33e64cc1443fc19ba5360d047b0e348a'],2,1997,1999,21981558,6,0.136363636,1,0.631818182,22019
02782506dd0c3f6e763faadb50702900ff8139b0,1,Siddharth Wagle,2016-02-26 12:56:34-08:00,['2f8636e5eafa4d9d26097a6e0d8f8dcde59d2e75'],11,24,35,21981593,1,0,1,1,22019
1d7beb35639323d48875ce11b855a0ddff835d13,0,Sumit Mohanty,2016-02-26 14:14:42-08:00,['02782506dd0c3f6e763faadb50702900ff8139b0'],6,6,12,21981605,1,,,,22019
3a5fc0261e94a67749ffd4df46cd0ea53a63c0b7,0,Xi Wang,2016-02-26 15:04:40-08:00,['1d7beb35639323d48875ce11b855a0ddff835d13'],5,5,10,21981615,1,,0,,22019
27710808bf4a83cf1c5d981270df57f187ecbd5b,0,Nahappan Somasundaram,2016-02-26 16:45:18-08:00,['3a5fc0261e94a67749ffd4df46cd0ea53a63c0b7'],1,112,113,21981728,8,0.62962963,0.703703704,0.888888889,22019
11137ea88607dae63c3bf330c298d19df57cc890,1,Richard Zang,2016-02-26 17:17:33-08:00,['27710808bf4a83cf1c5d981270df57f187ecbd5b'],28,121,149,21981877,5,0.258426966,0.662921348,0.943820225,22019
a281dfc097df502ed0b9941ea2e57c30b1d032ba,0,Jun Aoki,2016-02-26 17:40:46-08:00,['11137ea88607dae63c3bf330c298d19df57cc890'],1,1,2,21981879,1,,,,22019
afea5a578a1fd8a2efa1d41e677ebde9e211cc7d,1,Alex Antonenko,2016-02-27 07:52:09+02:00,['a281dfc097df502ed0b9941ea2e57c30b1d032ba'],10,11,21,21981900,2,0,0,0,22019
a69b8cc8e676c35cb0a8af8ca8e8fd0e6669233c,0,Aleksandr Kovalenko,2016-02-27 15:20:48+02:00,['afea5a578a1fd8a2efa1d41e677ebde9e211cc7d'],54,60,114,21982014,4,,,,22019
8255f40c0548552eb859fd81da8323deb87483a4,1,Siddharth Wagle,2016-02-27 10:22:01-08:00,['a69b8cc8e676c35cb0a8af8ca8e8fd0e6669233c'],90,2217,2307,21984321,13,0.260162602,0.821138211,0.585365854,22027
b305aecaed28e721e20c5a45a6261f68e99b2ce3,1,"Toader, Sebastian",2016-02-28 00:14:41+01:00,['8255f40c0548552eb859fd81da8323deb87483a4'],17,185,202,21984523,4,0.063829787,0.914893617,1,22028
c4e5cdf5c68563f3b8a5c7e0d1043eddfc236ae0,1,Lisnichenko Dmitro,2016-02-29 13:34:40+02:00,['b305aecaed28e721e20c5a45a6261f68e99b2ce3'],0,197,197,21984720,4,0.548780488,1,0.62195122,22030
771deecd2a2f7d04e354f211ca64f3b2f41e6043,1,Di Li,2016-02-29 08:49:38-05:00,['c4e5cdf5c68563f3b8a5c7e0d1043eddfc236ae0'],124,1534,1658,21986378,7,0.102140078,0.98540856,0.881322957,22030
cb280b5832ed5464fb6dcbc3f5c879948a0493bd,0,Alex Antonenko,2016-02-29 16:21:25+02:00,['771deecd2a2f7d04e354f211ca64f3b2f41e6043'],1,4,5,21986383,2,,,,22030
067cc6223b0b7ff44c7c75485d12088821e89cc9,0,Alex Antonenko,2016-02-29 16:45:48+02:00,['cb280b5832ed5464fb6dcbc3f5c879948a0493bd'],0,2,2,21986385,2,0,0,1,22030
7ee9fa8759818d80e15783afda1aa2e5c25ee802,0,Lisnichenko Dmitro,2016-02-29 17:08:17+02:00,['067cc6223b0b7ff44c7c75485d12088821e89cc9'],0,34,34,21986419,2,,,,22030
ae6dbcea63d5fe8b691723e0c86d80480719aefd,1,Robert Levas,2016-02-29 10:28:03-05:00,['7ee9fa8759818d80e15783afda1aa2e5c25ee802'],3,137,140,21986559,4,0.141176471,0.976470588,0.976470588,22030
5e0ad173d34e16f3c4cb231e0e8b496e659ae3e9,0,ababiichuk,2016-02-29 17:39:39+02:00,['ae6dbcea63d5fe8b691723e0c86d80480719aefd'],7,11,18,21986577,1,1,1,1,22030
7452f7165842612d10aff8a9438f535518aa149e,1,Oleg Nechiporenko,2016-02-29 17:42:09+02:00,['5e0ad173d34e16f3c4cb231e0e8b496e659ae3e9'],104,546,650,21987227,20,0.711462451,1,0.988142292,22036
042345c1bc909ba4ec22b0aec55af25452e69860,0,Nahappan Somasundaram,2016-02-29 10:17:58-08:00,['7452f7165842612d10aff8a9438f535518aa149e'],0,1,1,21987228,1,,,,22036
4cd5ad4e61c2a9a3cfc7e22233b484e8fc88e8b2,1,Yusaku Sako,2016-02-29 11:21:28-08:00,['042345c1bc909ba4ec22b0aec55af25452e69860'],10,89,99,21987327,13,1,1,1,22036
aaca7c47909510453ab5b1034190c9a8ab28e338,0,Oleksandr Diachenko,2016-02-29 11:48:29-08:00,['4cd5ad4e61c2a9a3cfc7e22233b484e8fc88e8b2'],4,20,24,21987351,1,,,,22036
365c74b53c653a96fda189846ad5e07ab268e0fc,1,Jonathan Hurley,2016-02-29 15:24:27-05:00,['aaca7c47909510453ab5b1034190c9a8ab28e338'],91,280,371,21987722,8,0.433333333,0.983333333,0.9,22037
15c992c5beb3210c5be23eda73869bab85b50fcb,1,Nate Cole,2016-02-29 15:25:23-05:00,['365c74b53c653a96fda189846ad5e07ab268e0fc'],17,48,65,21987787,5,0,1,1,22037
ba59c242d65428e1ebcf7758a2dd7de3e90c7f5b,1,Jun Aoki,2016-02-29 12:34:59-08:00,['15c992c5beb3210c5be23eda73869bab85b50fcb'],7,7,14,21987801,5,,,,22037
6bdc7fc7fe88a151116b92f1b9023780c2f219ad,0,"Toader, Sebastian",2016-02-29 21:43:33+01:00,['ba59c242d65428e1ebcf7758a2dd7de3e90c7f5b'],10,31,41,21987842,5,0.909090909,1,1,22037
3286b00f3d69be4b9944a8243a69613677e1a90f,1,Richard Zang,2016-02-29 13:49:24-08:00,['6bdc7fc7fe88a151116b92f1b9023780c2f219ad'],5,30,35,21987877,2,1,1,1,22037
8d38f163852e07318ef15a46cc1baf4f7cba055d,0,Jun Aoki,2016-02-29 13:51:03-08:00,['3286b00f3d69be4b9944a8243a69613677e1a90f'],6,5,11,21987888,4,,,,22037
7abe374dd5375f908514a0e4c266e661d6b20298,0,Jonathan Hurley,2016-02-29 17:24:44-05:00,['8d38f163852e07318ef15a46cc1baf4f7cba055d'],1,9,10,21987898,1,0,1,1,22037
7a36ae74861b369aea4a0a2351e8a341e6eedc6f,1,Richard Zang,2016-02-29 14:45:22-08:00,['7abe374dd5375f908514a0e4c266e661d6b20298'],51,164,215,21988113,9,1,1,1,22039
a5ed43fcab5de7fcb94fa56e7279f32e158760e3,1,Jaimin Jetly,2016-02-29 14:46:19-08:00,['7a36ae74861b369aea4a0a2351e8a341e6eedc6f'],4,114,118,21988231,2,0.102803738,0.925233645,1,22039
e175f770f99a48ebee07b143a85c2ffbb2a6d99c,0,Richard Zang,2016-02-29 14:55:39-08:00,['a5ed43fcab5de7fcb94fa56e7279f32e158760e3'],0,2,2,21988233,2,0,0,1,22039
93bdd5eebf4fffcd09c4c8d140f2d78a14951507,1,Richard Zang,2016-02-29 16:40:29-08:00,['e175f770f99a48ebee07b143a85c2ffbb2a6d99c'],1,10,11,21988244,2,0,0.222222222,1,22039
ee6929be8a06a1db7c45b9523f7e195dd34eab4b,1,Siddharth Wagle,2016-02-29 17:41:34-08:00,['93bdd5eebf4fffcd09c4c8d140f2d78a14951507'],22,83,105,21988349,8,0,0.5,0,22039
a323c387f37b669e9cd7963f1535680abf20f8c2,1,Jun Aoki,2016-02-29 17:42:45-08:00,['ee6929be8a06a1db7c45b9523f7e195dd34eab4b'],0,25,25,21988374,2,0,0.8,0.8,22039
d68235871267ab6ff836c2a1e9ec7a810fa59e70,1,Siddharth Wagle,2016-02-29 18:07:29-08:00,['a323c387f37b669e9cd7963f1535680abf20f8c2'],13,27,40,21988414,1,0,1,0.857142857,22039
8b6fa3931470ff7ddaedbdf4f6a4ca25426006d6,1,tbeerbower,2016-02-29 21:11:56-05:00,['d68235871267ab6ff836c2a1e9ec7a810fa59e70'],0,1,1,21988415,1,,,,22039
a19cf17ae5dd7b18b59929ce0b9b4d8dc53a7eb5,0,Alex Antonenko,2016-03-01 10:15:59+02:00,['8b6fa3931470ff7ddaedbdf4f6a4ca25426006d6'],2,0,2,21988417,2,1,1,0,22039
56e79cd5bc46f5196d8368b4cd75157c0193cb72,1,Pallav Kulshreshtha,2016-03-01 14:18:30+05:18,['a19cf17ae5dd7b18b59929ce0b9b4d8dc53a7eb5'],66,68,134,21988551,6,1,1,1,22039
2ca2e9734614a4b5c7f1a1cad0f665d6af0034db,1,Andrew Onishuk,2016-03-01 12:26:34+02:00,['56e79cd5bc46f5196d8368b4cd75157c0193cb72'],1,5,6,21988557,2,0,0,1,22039
590631830432f5301890c0219ba2cdc03d7f739f,1,Lisnichenko Dmitro,2016-03-01 12:36:03+02:00,['2ca2e9734614a4b5c7f1a1cad0f665d6af0034db'],905,1163,2068,21990625,4,0,0,0,22039
a933507450dae22bbc515fcfeedbfc6a2c5ba440,0,Pallav Kulshreshtha,2016-03-01 15:59:33+05:18,['590631830432f5301890c0219ba2cdc03d7f739f'],3,12,15,21990640,3,,,,22039
61be6b22e5e06079d6a8b3a82ba1e4510a79953e,1,Dipayan Bhowmick,2016-03-01 16:02:43+05:18,['a933507450dae22bbc515fcfeedbfc6a2c5ba440'],44,53,97,21990737,2,1,1,1,22039
4019afa252244d21f17d10473196ee283678ee2c,1,Andrew Onishuk,2016-03-01 14:43:21+02:00,['61be6b22e5e06079d6a8b3a82ba1e4510a79953e'],49,59,108,21990845,7,1,1,0.25,22039
8db1e302ac689459f58d6527f667144d10123fdf,1,Oleg Nechiporenko,2016-03-01 16:52:33+02:00,['4019afa252244d21f17d10473196ee283678ee2c'],6,7,13,21990858,2,,,,22039
4c5e03b849805a8d64d1fc2e925709d078d5c467,0,Alex Antonenko,2016-03-01 18:20:20+02:00,['8db1e302ac689459f58d6527f667144d10123fdf'],3,83,86,21990944,4,0.636363636,1,1,22039
940b2ffe498ef7e26080671e30e30e3c42e35248,1,Andrew Onishuk,2016-03-01 19:04:56+02:00,['4c5e03b849805a8d64d1fc2e925709d078d5c467'],62,96,158,21991102,5,0.761904762,0,1,22039
97f3089badbf4f16f828d92b317bb623605ee66b,0,Jonathan Hurley,2016-03-01 13:30:21-05:00,['940b2ffe498ef7e26080671e30e30e3c42e35248'],26,37,63,21991165,1,1,0,1,22039
b07ef5851f9ef3bf7a406432e202172134777d80,1,Alex Antonenko,2016-03-01 23:29:41+02:00,['97f3089badbf4f16f828d92b317bb623605ee66b'],70,15,85,21991250,3,0.673469388,0.244897959,0,22039
c871f286d90119b2b606b266204ba3e7eae08f8a,0,"Toader, Sebastian",2016-03-01 22:44:05+01:00,['b07ef5851f9ef3bf7a406432e202172134777d80'],10,1041,1051,21992301,20,0.699669967,0.844884488,0.881188119,22051
e6fde445c07c552156dbadf409ccf964a2ae5b70,1,Richard Zang,2016-03-01 14:10:50-08:00,['c871f286d90119b2b606b266204ba3e7eae08f8a'],381,29,410,21992711,8,0,0,0.069444444,22051
19e29fd4da65f559b00ab2d60b799cfff2a25fc1,1,Yusaku Sako,2016-03-01 16:07:06-08:00,['e6fde445c07c552156dbadf409ccf964a2ae5b70'],4,17,21,21992732,2,1,1,1,22051
874d4d57795c11001919ed7de9289863e32d0036,0,Oleksandr Diachenko,2016-03-01 16:14:44-08:00,['19e29fd4da65f559b00ab2d60b799cfff2a25fc1'],1,1,2,21992734,1,,,,22051
fa38d29a13fe26625f7225d249f72d05e997fa3b,0,Jun Aoki,2016-03-01 16:32:49-08:00,['874d4d57795c11001919ed7de9289863e32d0036'],27,63,90,21992824,4,0.242424242,1,1,22051
9979e429e628cb146533977136a0b85319377f1b,1,Jaimin Jetly,2016-03-01 18:45:41-08:00,['fa38d29a13fe26625f7225d249f72d05e997fa3b'],21,585,606,21993430,19,0.728813559,0.813559322,1,22057
cc4c739845f587cbbe8b746f537ba1a149270da5,0,Yusaku Sako,2016-03-01 18:46:43-08:00,['9979e429e628cb146533977136a0b85319377f1b'],1041,10,1051,21994481,20,0.300330033,0.155115512,0.118811881,22057
271412882b03950b66bf04e69c92731e6fbf9421,1,"Toader, Sebastian",2016-03-02 06:55:59+01:00,['cc4c739845f587cbbe8b746f537ba1a149270da5'],10,1041,1051,21995532,20,0.699669967,0.844884488,0.881188119,22069
cc5c07fcee3c4048d8b1a6883370342c9cd5dc56,1,Vitaly Brodetskyi,2016-03-02 13:06:31+02:00,['271412882b03950b66bf04e69c92731e6fbf9421'],32,26,58,21995590,1,1,0,0,22069
1c8d7b968a4d57cf9beceee58c4fe3cf29a116ec,0,Oleg Nechiporenko,2016-03-02 13:46:04+02:00,['cc5c07fcee3c4048d8b1a6883370342c9cd5dc56'],26,7,33,21995623,2,1,0,0,22069
c3c723e7a78b74ba35c46cda86bb33ee6e06eb66,0,Dipayan Bhowmick,2016-03-02 17:24:04+05:18,['1c8d7b968a4d57cf9beceee58c4fe3cf29a116ec'],3,36,39,21995662,6,0.944444444,0.944444444,0.944444444,22069
43d3a27c5541af661108677658040550dae3e1e4,1,Jonathan Hurley,2016-03-02 09:42:59-05:00,['c3c723e7a78b74ba35c46cda86bb33ee6e06eb66'],63,102,165,21995827,2,0,0,0.9,22069
db7945d204279f2bbbf727ad940d86e1c2bc78c2,1,ababiichuk,2016-03-02 17:06:24+02:00,['43d3a27c5541af661108677658040550dae3e1e4'],1,46,47,21995874,34,0,0,1,22069
d6fddcddf4209c77106e6db0c73f6743b8fae01e,1,Lisnichenko Dmitro,2016-03-02 17:29:42+02:00,['db7945d204279f2bbbf727ad940d86e1c2bc78c2'],36,244,280,21996154,2,1,1,1,22069
464c3ac4559b795f846362d0b36c1aacd842ecf2,1,Andrew Onishuk,2016-03-02 18:22:24+02:00,['d6fddcddf4209c77106e6db0c73f6743b8fae01e'],24,10,34,21996188,2,1,0,1,22069
2ab290e009b80942258e2e625477a946cf4dab8d,0,Robert Levas,2016-03-02 12:25:26-05:00,['464c3ac4559b795f846362d0b36c1aacd842ecf2'],4,110,114,21996302,5,0.22972973,0.716216216,0.391891892,22069
ba41f2a9e650923a8ae832e12ca3bae237939ed8,1,Andrew Onishuk,2016-03-02 20:06:36+02:00,['2ab290e009b80942258e2e625477a946cf4dab8d'],9,21,30,21996332,3,0.428571429,0.428571429,1,22069
863c1d17f4f2c8901967dd5f07632290b0aa873e,1,Yusaku Sako,2016-03-02 10:10:38-08:00,['ba41f2a9e650923a8ae832e12ca3bae237939ed8'],0,13,13,21996345,2,0,1,1,22069
4ecb3c10fede992fde82e54cf252f28160ba5f07,0,"Toader, Sebastian",2016-03-02 19:29:34+01:00,['863c1d17f4f2c8901967dd5f07632290b0aa873e'],3,101,104,21996449,2,0,0.28,1,22069
eb166d6f55be1115c73c41cae84f7c3c92d0ee28,1,Aravindan Vijayan,2016-03-02 12:35:01-08:00,['4ecb3c10fede992fde82e54cf252f28160ba5f07'],20,37,57,21996506,4,,,,22069
cea5d2cdb9ff652c91e9e96bb2668592c69a2f5a,0,Yusaku Sako,2016-03-02 13:47:26-08:00,['eb166d6f55be1115c73c41cae84f7c3c92d0ee28'],3,2,5,21996511,2,1,0,0,22069
06747adfdfea80869b07cd097cb1926877b8df57,0,Yusaku Sako,2016-03-02 14:13:07-08:00,['cea5d2cdb9ff652c91e9e96bb2668592c69a2f5a'],0,6,6,21996517,1,0.857142857,1,1,22069
9df2eb74e517c59c5c2149712b0198d52ce9cc1f,1,Alex Antonenko,2016-03-03 00:20:01+02:00,['06747adfdfea80869b07cd097cb1926877b8df57'],3,9,12,21996529,3,1,1,0.833333333,22069
235e8e7ed0947e6c4d7f243e3bee3b8f1d04c928,1,Alex Antonenko,2016-03-03 00:20:01+02:00,['9df2eb74e517c59c5c2149712b0198d52ce9cc1f'],1,1,2,21996531,1,,,,22069
e347aef4236c8abd0f31ae37c27b36c65854ffde,1,Alex Antonenko,2016-03-03 00:20:01+02:00,['235e8e7ed0947e6c4d7f243e3bee3b8f1d04c928'],5,207,212,21996743,3,0.32642487,1,1,22069
f707cb50fd0f5616c74ff8b2f15917a6eda608c2,1,Bhuvnesh Chaudhary,2016-03-02 14:33:07-08:00,['e347aef4236c8abd0f31ae37c27b36c65854ffde'],29,62,91,21996834,2,0,0.761904762,0.761904762,22069
c0ecec05c5f0d0efa6a4ceadca5bcd6d4dc56461,1,Matt,2016-03-02 16:36:21-08:00,['f707cb50fd0f5616c74ff8b2f15917a6eda608c2'],53,93,146,21996980,2,0,0.909090909,1,22069
e5a563024d5f67dcc08e010289130724b817a250,1,Siddharth Wagle,2016-03-02 21:13:28-08:00,['c0ecec05c5f0d0efa6a4ceadca5bcd6d4dc56461'],4,4,8,21996988,2,,,,22069
353736cad544c5f110b86cc3022ffd25e8ad607c,0,Pallav Kulshreshtha,2016-03-03 12:47:31+05:18,['e5a563024d5f67dcc08e010289130724b817a250'],2,6,8,21996996,1,0,1,1,22069
2ff6c32d390453c7c29f1e279818ff7cade62b02,1,"Toader, Sebastian",2016-03-03 08:50:05+01:00,['353736cad544c5f110b86cc3022ffd25e8ad607c'],4,9,13,21997009,1,0,0,1,22069
f6ecddf69f615d800a0146b730a44ba075013760,0,Matt,2016-03-03 01:01:07-08:00,['2ff6c32d390453c7c29f1e279818ff7cade62b02'],10,937,947,21997956,28,0.822157434,1,0.941690962,22083
41edfc4e93cc2663e8b3f4ef33eef1b4816988e6,1,Lisnichenko Dmitro,2016-03-03 12:27:01+02:00,['f6ecddf69f615d800a0146b730a44ba075013760'],466,52,518,21998474,8,0.718631179,0.117870722,0.197718631,22083
2bff7a56bb3bc4d4b53fec7f33d5d61f6bc626c8,0,Andrew Onishuk,2016-03-03 13:17:07+02:00,['41edfc4e93cc2663e8b3f4ef33eef1b4816988e6'],1,1,2,21998476,1,,,,22083
b187984b07f1deed7595a14dd5dc384aae8e38db,0,Andrew Onishuk,2016-03-03 13:21:08+02:00,['2bff7a56bb3bc4d4b53fec7f33d5d61f6bc626c8'],2,4,6,21998482,1,0,0,0,22083
3df1c5408e2e93336e6a755b13e62ec75c54a007,0,"Toader, Sebastian",2016-03-03 14:04:20+01:00,['b187984b07f1deed7595a14dd5dc384aae8e38db'],110,4,114,21998596,5,0.77027027,0.283783784,0.608108108,22083
60b611540ca7c2a2476f6c06a4e1eedbc403cf9a,1,"Toader, Sebastian",2016-03-03 14:39:56+01:00,['3df1c5408e2e93336e6a755b13e62ec75c54a007'],7,104,111,21998707,3,0,0.958333333,1,22083
93a2fe4f9b2ff7e82f2e237465ba09d370d8fba5,0,Alex Antonenko,2016-03-03 15:43:59+02:00,['60b611540ca7c2a2476f6c06a4e1eedbc403cf9a'],937,10,947,21999654,28,0.177842566,0,0.058309038,22083
1158f9342921d07d09316205678352addbf9e7b3,1,Oleg Nechiporenko,2016-03-03 15:49:26+02:00,['93a2fe4f9b2ff7e82f2e237465ba09d370d8fba5'],220,409,629,22000283,10,0.68,1,1,22089
236beac472b77b0f5b098ff15a7ce9d6332e52ae,1,Myroslav Papirkovskyi,2016-03-03 16:43:17+02:00,['1158f9342921d07d09316205678352addbf9e7b3'],6,84,90,22000373,2,0,1,1,22089
492a305409a26f687e55be7be624b9e95ce422d7,1,"Toader, Sebastian",2016-03-03 16:36:27+01:00,['236beac472b77b0f5b098ff15a7ce9d6332e52ae'],4,110,114,22000487,5,0.22972973,0.716216216,0.391891892,22089
0db3044e5f868e916aacf50e086220fedbbe47d4,0,Alex Antonenko,2016-03-03 17:38:55+02:00,['492a305409a26f687e55be7be624b9e95ce422d7'],3,15,18,22000505,1,1,1,0,22089
4e714d4f4d7985f07831ca6f86cb8ba910670a04,0,Dmytro Sen,2016-03-03 17:42:58+02:00,['0db3044e5f868e916aacf50e086220fedbbe47d4'],2,0,2,22000507,1,,,,22089
008503e128f9cbe34eda24ac47f7804c0fde5e35,0,Nahappan Somasundaram,2016-03-03 07:45:27-08:00,['4e714d4f4d7985f07831ca6f86cb8ba910670a04'],14,1,15,22000522,1,0,0,0,22089
e336ee02c537e15a68a1b7c34a0fafe04f2e0c0f,1,Yusaku Sako,2016-03-03 09:08:19-08:00,['008503e128f9cbe34eda24ac47f7804c0fde5e35'],12,59,71,22000593,1,0.528301887,0.320754717,1,22089
4fde93a2a1c908c82488f6ca555b37471dad2aac,1,Myroslav Papirkovskyi,2016-03-03 19:12:00+02:00,['e336ee02c537e15a68a1b7c34a0fafe04f2e0c0f'],2,8,10,22000603,1,1,1,1,22089
a133f7c9822c392362374f68bb774933db1d4375,1,Andrew Onishuk,2016-03-03 19:13:23+02:00,['4fde93a2a1c908c82488f6ca555b37471dad2aac'],17,24,41,22000644,4,,,,22089
e1811bcad3c90fa46ddf3a7860f62babfc594efe,0,Yusaku Sako,2016-03-03 10:37:52-08:00,['a133f7c9822c392362374f68bb774933db1d4375'],0,48,48,22000692,1,,,,22089
ec94842e2d7095767cbfa0634c2813b2a8c7079a,1,Jun Aoki,2016-03-03 13:31:18-08:00,['e1811bcad3c90fa46ddf3a7860f62babfc594efe'],2,254,256,22000948,5,0.454545455,1,0.454545455,22092
f1c2b3da0248ea706fd9d7ccff9300b1689f7aa4,1,Richard Zang,2016-03-03 13:42:00-08:00,['ec94842e2d7095767cbfa0634c2813b2a8c7079a'],29,29,58,22001006,4,1,1,0,22092
8d4243c61b9dc1c5f29c2950d59b9ccdba4d6663,1,Xi Wang,2016-03-03 13:45:35-08:00,['f1c2b3da0248ea706fd9d7ccff9300b1689f7aa4'],144,10,154,22001160,6,1,1,0,22092
65724a9b9bf8fd86c602109de581f65479427be1,1,Richard Zang,2016-03-03 14:11:58-08:00,['8d4243c61b9dc1c5f29c2950d59b9ccdba4d6663'],20,61,81,22001241,3,0.032258065,0.032258065,1,22092
75555dc56810bc296294d44623ace1bac598511a,1,"Toader, Sebastian",2016-03-04 09:23:52+01:00,['65724a9b9bf8fd86c602109de581f65479427be1'],4,134,138,22001379,2,0.27027027,0.986486486,0.918918919,22092
0d0a3d3406d0c2d03eb6bb998d62679469589426,0,Vitaly Brodetskyi,2016-03-04 12:15:43+02:00,['75555dc56810bc296294d44623ace1bac598511a'],0,31,31,22001410,1,,,,22092
61d40303b6c0ddf6a41d0892bfa8986af28b605f,1,Aleksandr Kovalenko,2016-03-04 14:26:34+02:00,['0d0a3d3406d0c2d03eb6bb998d62679469589426'],16,30,46,22001456,1,1,1,1,22092
654b9a3b03252dc692728f557df19f1ff65a4032,1,Dmytro Sen,2016-03-04 16:00:13+02:00,['61d40303b6c0ddf6a41d0892bfa8986af28b605f'],7,13,20,22001476,3,0,1,0,22092
fe0c7ab9976a27a2284b64c71c1a8a5b7283eac6,1,Lisnichenko Dmitro,2016-03-04 16:04:02+02:00,['654b9a3b03252dc692728f557df19f1ff65a4032'],0,1,1,22001477,1,1,1,1,22092
e146400e661d23f7ee2f08a06b0eadcbf798e476,1,Robert Levas,2016-03-04 10:54:14-05:00,['fe0c7ab9976a27a2284b64c71c1a8a5b7283eac6'],0,303,303,22001780,3,0.311827957,0.548387097,0.64516129,22094
9a2a8b8a357e001a50a189dc2917959e89ae52a8,1,Vitaly Brodetskyi,2016-03-04 20:34:33+02:00,['e146400e661d23f7ee2f08a06b0eadcbf798e476'],2,61,63,22001843,3,0,1,1,22094
2c3bc30dc2ac6aee302b0cef8766e39afde65e3f,0,Sumit Mohanty,2016-03-04 11:10:26-08:00,['9a2a8b8a357e001a50a189dc2917959e89ae52a8'],2,2,4,22001847,1,,,,22094
8486be6aa1a79a8c123e41d5267cddb8504c1dbc,1,Aravindan Vijayan,2016-03-04 11:23:19-08:00,['2c3bc30dc2ac6aee302b0cef8766e39afde65e3f'],253,157,410,22002257,11,1,0.566666667,0.1,22094
211a48d56eb6975d002b9c8c12aaab76049d6ee0,1,Jonathan Hurley,2016-03-04 14:56:49-05:00,['8486be6aa1a79a8c123e41d5267cddb8504c1dbc'],1,274,275,22002532,4,0,0.744966443,1,22094
f3659cce6946895bc8fdda0bfb1232643d49223a,1,Siddharth Wagle,2016-03-04 11:57:28-08:00,['211a48d56eb6975d002b9c8c12aaab76049d6ee0'],115,756,871,22003403,13,0.098143236,0.644562334,0.864721485,22094
5b89dc7525357268e862e27eb1e99c007cf074ea,1,Robert Levas,2016-03-04 16:57:22-05:00,['f3659cce6946895bc8fdda0bfb1232643d49223a'],237,310,547,22003950,16,1,0.9,1,22094
5e3c40f3706d0bc7fc06da123a054accc58bf8a5,0,Siddharth Wagle,2016-03-04 14:11:01-08:00,['5b89dc7525357268e862e27eb1e99c007cf074ea'],12,46,58,22004008,1,,,,22094
7ade22258e09bbc50e1186619cd89f4dd06497f5,1,Richard Zang,2016-03-04 15:37:41-08:00,['5e3c40f3706d0bc7fc06da123a054accc58bf8a5'],20,59,79,22004087,2,1,1,1,22094
2b1437c4cc5369db09774cb0ca3ec8c29e6e9db4,1,Xi Wang,2016-03-04 15:44:54-08:00,['7ade22258e09bbc50e1186619cd89f4dd06497f5'],11,13,24,22004111,3,1,1,1,22094
0f7110f2b3ae4fe6752957f1555e93e17b0f663e,0,Matt,2016-03-05 19:35:47-08:00,['2b1437c4cc5369db09774cb0ca3ec8c29e6e9db4'],78,114,192,22004303,1,0,0.85,1,22094
58503bbdc7f421507d628e0374bc462fdd747881,1,Matt,2016-03-05 22:40:20-08:00,['0f7110f2b3ae4fe6752957f1555e93e17b0f663e'],10,938,948,22005251,28,0.822157434,1,0.941690962,22108
79579989c626637669342ced59baaece49dd381a,1,Vitaly Brodetskyi,2016-03-06 21:45:25+02:00,['58503bbdc7f421507d628e0374bc462fdd747881'],0,16,16,22005267,2,,,,22108
6fb4655ad22fe053f1fe1fa9167662a8998a902f,1,Matt,2016-03-06 12:17:08-08:00,['79579989c626637669342ced59baaece49dd381a'],433,898,1331,22006598,8,,,,22109
eeef001d4702b5dbae1c1e9e8bfaac8a5a626b18,1,Gautam Borad,2016-03-07 09:15:52+05:18,['6fb4655ad22fe053f1fe1fa9167662a8998a902f'],140,539,679,22007277,16,0.488888889,1,0.844444444,22109
65f0ff68f77fd1d640e705c7b628252c72d15be3,1,Gautam Borad,2016-03-07 11:05:06+05:18,['eeef001d4702b5dbae1c1e9e8bfaac8a5a626b18'],29,29,58,22007335,10,,,,22109
b88ede8dfef4fb6595ac7fe122a09eee7dba5d17,1,ababiichuk,2016-03-07 11:49:20+02:00,['65f0ff68f77fd1d640e705c7b628252c72d15be3'],55,242,297,22007632,8,0.826086957,0.989130435,0.989130435,22109
c2aec6fb14ae49dd5fb6f217093e4606ab36588f,1,Alex Antonenko,2016-03-07 12:21:03+02:00,['b88ede8dfef4fb6595ac7fe122a09eee7dba5d17'],15,25,40,22007672,4,1,0,1,22109
b4fe1b6605bd09566bc68ff4fb9ce0ebebb51e52,0,Lisnichenko Dmitro,2016-03-07 13:37:56+02:00,['c2aec6fb14ae49dd5fb6f217093e4606ab36588f'],0,28,28,22007700,2,0,0,1,22110
074a7a52ab8c0422cd9f426b360c5bb2efd916c6,1,ababiichuk,2016-03-07 16:55:05+02:00,['b4fe1b6605bd09566bc68ff4fb9ce0ebebb51e52'],6,4,10,22007710,2,0,0,0.5,22110
fcdb5620592fd1263a8b6fe847fad6e24733e0ef,0,Oleg Nechiporenko,2016-03-07 20:13:03+02:00,['074a7a52ab8c0422cd9f426b360c5bb2efd916c6'],14,10,24,22007734,7,0,0,0.833333333,22110
29d636ccbaae6c349fd260f98e0414be52f089b7,0,Aravindan Vijayan,2016-03-07 11:19:12-08:00,['fcdb5620592fd1263a8b6fe847fad6e24733e0ef'],3,4,7,22007741,2,,,,22110
7cc897bd6c700fb74028ec90426392411905e7a2,1,Richard Zang,2016-03-07 11:46:45-08:00,['29d636ccbaae6c349fd260f98e0414be52f089b7'],2,179,181,22007922,6,0.802083333,0.96875,0.854166667,22110
037d93385d8872587c568b5793b3723ee4a7050f,1,Alejandro Fernandez,2016-03-07 12:54:40-08:00,['7cc897bd6c700fb74028ec90426392411905e7a2'],93,93,186,22008108,6,,,,22110
03eb1c518b8d0fb82871aa83588e425f6f176c10,1,Aravindan Vijayan,2016-03-07 13:25:10-08:00,['037d93385d8872587c568b5793b3723ee4a7050f'],7,15,22,22008130,1,0,1,1,22110
3dd4c4a4686318e8c7c55f81ff3c8a9bed518c1d,0,Di Li,2016-03-07 16:38:04-05:00,['03eb1c518b8d0fb82871aa83588e425f6f176c10'],12,12,24,22008154,6,,,,22110
bf186cfdc36264b7cdf3ab19a7fda32091c09591,1,Richard Zang,2016-03-07 14:29:45-08:00,['3dd4c4a4686318e8c7c55f81ff3c8a9bed518c1d'],9,19,28,22008182,2,1,1,1,22110
283d8167da8daf4c4895610e08de2e95f0bf2b74,0,Siddharth Wagle,2016-03-07 16:03:29-08:00,['bf186cfdc36264b7cdf3ab19a7fda32091c09591'],11,17,28,22008210,1,,,,22110
bdba8cbd56d4ed3c9f3ad239c1e0bd82d1fd58ec,0,Yusaku Sako,2016-03-07 16:34:06-08:00,['283d8167da8daf4c4895610e08de2e95f0bf2b74'],12,12,24,22008234,1,,,,22110
549e70e27097dc55ee081fbdfedac2d8bca11d83,0,Aravindan Vijayan,2016-03-07 17:18:32-08:00,['bdba8cbd56d4ed3c9f3ad239c1e0bd82d1fd58ec'],1,1,2,22008236,1,,,,22110
7e81d37669aefa4aea6c1ab8f1aebbb1e23768d9,1,Alejandro Fernandez,2016-03-07 20:53:55-08:00,['549e70e27097dc55ee081fbdfedac2d8bca11d83'],227,488,715,22008951,84,0.234042553,0.712765957,0.861702128,22110
be7bafec27e8e9b77e24b174292f303e3759ed62,1,Yusaku Sako,2016-03-08 00:18:19-08:00,['7e81d37669aefa4aea6c1ab8f1aebbb1e23768d9'],0,18,18,22008969,1,,,,22110
1986078f78e545eefc64f5315304ccebbb6dbae8,1,Robert Levas,2016-03-08 12:44:24-05:00,['be7bafec27e8e9b77e24b174292f303e3759ed62'],4,70,74,22009043,2,0,0.962264151,0.962264151,22110
86d37806535715ae38a4062ab83b3e6e57877f38,0,Richard Zang,2016-03-08 10:55:09-08:00,['1986078f78e545eefc64f5315304ccebbb6dbae8'],11,0,11,22009054,1,,,,22110
8615cac3a9cee7edfee18e0c8c6fd0da021f8d2e,0,Matt,2016-03-08 11:06:34-08:00,['86d37806535715ae38a4062ab83b3e6e57877f38'],15,37,52,22009106,2,0,0,1,22110
2efe8945c152fa5d4bdc51bf1828ca0ade4a004e,1,Jonathan Hurley,2016-03-08 15:53:52-05:00,['8615cac3a9cee7edfee18e0c8c6fd0da021f8d2e'],133,270,403,22009509,24,0.333333333,0.277777778,0.305555556,22110
f7221e5a601abb74977389f453754432f4008616,1,Jayush Luniya,2016-03-08 15:33:30-08:00,['2efe8945c152fa5d4bdc51bf1828ca0ade4a004e'],1308,1308,2616,22012125,220,,,,22110
2763c309d1d1304c192c596e96547528b8838faf,0,Matt,2016-03-08 15:39:13-08:00,['f7221e5a601abb74977389f453754432f4008616'],7,7,14,22012139,1,,,,22110
2c2c201e97cc2dec9c0298c41d2b47597d6cac70,1,Yusaku Sako,2016-03-08 15:59:02-08:00,['2763c309d1d1304c192c596e96547528b8838faf'],51,116,167,22012306,2,0.746268657,0.432835821,1,22110
249014b373a0a2fc6757f8bebc5bfb1e7929c166,1,Siddharth Wagle,2016-03-08 17:54:07-08:00,['2c2c201e97cc2dec9c0298c41d2b47597d6cac70'],0,17,17,22012323,2,0,0.75,0.25,22110
ec4b1d14bbd5d38c9e4c42cab1c9b6b37730f762,1,Yusaku Sako,2016-03-08 19:05:56-08:00,['249014b373a0a2fc6757f8bebc5bfb1e7929c166'],5,14,19,22012342,3,0,1,1,22110
5e69da9d0c5ca21d6e046cf7c7ab5b9c21063fba,1,Yusaku Sako,2016-03-08 21:23:04-08:00,['ec4b1d14bbd5d38c9e4c42cab1c9b6b37730f762'],2,19,21,22012363,2,1,1,1,22110
112d3857edd8c0d2719a995a6ca65bc97cc5fbfd,1,Vitaly Brodetskyi,2016-03-09 13:30:34+02:00,['5e69da9d0c5ca21d6e046cf7c7ab5b9c21063fba'],10,12,22,22012385,3,,,,22110
664ccd185a3ba7ffb3489e49f527e7aa902e8cd0,1,Sandor Magyari,2016-03-09 14:03:04+01:00,['112d3857edd8c0d2719a995a6ca65bc97cc5fbfd'],30,107,137,22012522,4,1,1,1,22110
dddffd5c6a54e1fb08bde98dd874edc68add4198,0,Andrew Onishuk,2016-03-09 16:23:55+02:00,['664ccd185a3ba7ffb3489e49f527e7aa902e8cd0'],6,0,6,22012528,1,,,,22110
354d07933f7a5ad27ff2e7a93d802fd8d10798e8,0,Di Li,2016-03-09 10:50:15-05:00,['dddffd5c6a54e1fb08bde98dd874edc68add4198'],0,0,0,22012528,1,,,,22110
087fcffa91743356a172c6c652ec961826928394,0,ababiichuk,2016-03-09 18:38:48+02:00,['354d07933f7a5ad27ff2e7a93d802fd8d10798e8'],2,2,4,22012532,1,,,,22110
20de17a827f47ed9bf0d6b9b476032bb16c78eb1,1,Di Li,2016-03-09 11:45:29-05:00,['087fcffa91743356a172c6c652ec961826928394'],34,93,127,22012659,9,0.023809524,0.642857143,0.738095238,22110
f5bd0585bfcd6e22a99e60a1304501d938a4361b,0,Bhuvnesh Chaudhary,2016-03-09 09:12:27-08:00,['20de17a827f47ed9bf0d6b9b476032bb16c78eb1'],2,2,4,22012663,1,,,,22110
456b451180b427e89f52a5dc0a644e27fe346efb,1,Jayush Luniya,2016-03-09 10:09:45-08:00,['f5bd0585bfcd6e22a99e60a1304501d938a4361b'],139,139,278,22012941,52,,,,22110
28430f37cdae8d84eddaf2cce9f6d99a41ed4922,1,Lisnichenko Dmitro,2016-03-09 20:50:23+02:00,['456b451180b427e89f52a5dc0a644e27fe346efb'],3,3,6,22012947,2,,,,22110
eb6b0da8eb11b14b053c822a6de147e0af6b9d8a,1,Alex Antonenko,2016-03-09 21:09:28+02:00,['28430f37cdae8d84eddaf2cce9f6d99a41ed4922'],12,12,24,22012971,2,,,,22110
c0d07416e2f75912cacbd3f4a3adb0b918729892,1,Richard Zang,2016-03-09 11:42:24-08:00,['eb6b0da8eb11b14b053c822a6de147e0af6b9d8a'],44,82,126,22013097,5,0,0.214285714,0.257142857,22110
cbc3f1a900367d27ed69748cbec31e1b73bb28be,0,Siddharth Wagle,2016-03-09 13:10:43-08:00,['c0d07416e2f75912cacbd3f4a3adb0b918729892'],13,15,28,22013125,2,0,1,1,22110
f7711af89df6db4d4a304993c670faf577640351,0,Di Li,2016-03-09 16:22:03-05:00,['cbc3f1a900367d27ed69748cbec31e1b73bb28be'],3,0,3,22013128,1,,,,22110
6d3e2912d49a5343bfdef54a04add9210ba16657,1,Siddharth Wagle,2016-03-09 14:00:01-08:00,['f7711af89df6db4d4a304993c670faf577640351'],47,94,141,22013269,2,0,0.391304348,0.652173913,22110
e5d261f84c8f10d3276ece640659c7b53a6684d1,1,Xi Wang,2016-03-09 14:53:26-08:00,['6d3e2912d49a5343bfdef54a04add9210ba16657'],10,23,33,22013302,3,0.833333333,1,1,22110
335ddb1fda405782399517d49077738fa533b47d,1,Richard Zang,2016-03-09 15:24:48-08:00,['e5d261f84c8f10d3276ece640659c7b53a6684d1'],113,6,119,22013421,4,0,0,0,22110
0cc8382f1f5b6e9bde2eb7be0d7d3b45f37cd75a,1,Siddharth Wagle,2016-03-09 16:38:51-08:00,['335ddb1fda405782399517d49077738fa533b47d'],103,75,178,22013599,3,1,0.909090909,0,22110
98b2b238e68b5632c9ea4da970baedf1c2918398,1,Sumit Mohanty,2016-03-09 18:15:47-08:00,['0cc8382f1f5b6e9bde2eb7be0d7d3b45f37cd75a'],0,257,257,22013856,2,0.114942529,0.114942529,0.091954023,22111
5166908915fbef7b3e9cab2a5bfd17e44bfc1953,1,Siddharth Wagle,2016-03-09 19:25:31-08:00,['98b2b238e68b5632c9ea4da970baedf1c2918398'],15,15,30,22013886,4,,,,22111
0887e8e3d6b6030143a8f3b38475e72875f899f1,1,Jonathan Hurley,2016-03-09 23:40:14-05:00,['5166908915fbef7b3e9cab2a5bfd17e44bfc1953'],7,205,212,22014098,5,0.326086957,0.695652174,1,22112
26b3357907362ba75b1e25360633a8634473e12d,0,Gautam Borad,2016-03-10 12:51:01+05:18,['0887e8e3d6b6030143a8f3b38475e72875f899f1'],4,4,8,22014106,2,,,,22112
0c44129ad18fc6c30e1f49ffa0580fd2d64c3351,0,Oleg Nechiporenko,2016-03-10 10:06:52+02:00,['26b3357907362ba75b1e25360633a8634473e12d'],21,12,33,22014139,3,0,0,0,22112
f9d317bd29dd88e46038ebfab34682ea524f2d37,1,Andrii Tkach,2016-03-10 12:34:48+02:00,['0c44129ad18fc6c30e1f49ffa0580fd2d64c3351'],9,14,23,22014162,3,0,0,0,22112
6626796191833c77130302653d3afad5f4bf8aec,1,Andrew Onishuk,2016-03-10 13:07:58+02:00,['f9d317bd29dd88e46038ebfab34682ea524f2d37'],64,600,664,22014826,137,0.120930233,0.83255814,0.83255814,22113
e4544a575a39c25a20bc91822f9befd0ed865d1a,1,Alex Antonenko,2016-03-10 13:13:14+02:00,['6626796191833c77130302653d3afad5f4bf8aec'],119,40,159,22014985,14,0.693548387,0.35483871,0,22113
3f3fdbd47a20a6401c7090a909d5235ccf996d83,1,Matt,2016-03-10 03:52:33-08:00,['e4544a575a39c25a20bc91822f9befd0ed865d1a'],8,298,306,22015291,11,0.583333333,1,0.922619048,22116
e1762a4281bbd78228c0ac162d8c19932de955e5,0,Matt,2016-03-10 04:11:31-08:00,['3f3fdbd47a20a6401c7090a909d5235ccf996d83'],0,4,4,22015295,1,1,1,1,22116
e1686f51a47621dce195d805286377470f45c1c9,1,Andrii Tkach,2016-03-10 17:48:41+02:00,['e1762a4281bbd78228c0ac162d8c19932de955e5'],27,34,61,22015356,5,0,1,1,22116
76627aa8e4af8818fff6e9cd56e67b3df5344b10,1,Sumit Mohanty,2016-03-10 10:50:12-08:00,['e1686f51a47621dce195d805286377470f45c1c9'],0,1373,1373,22016729,18,0.422619048,0.857142857,0.827380952,22133
ac6b0d1fbbe459633cb02e17971dc365f57290ce,1,Matt,2016-03-10 12:22:13-08:00,['76627aa8e4af8818fff6e9cd56e67b3df5344b10'],32,38,70,22016799,1,,,,22133
7cdb16c1d8e575dc00b71877858abe9d95bdd871,0,Jayush Luniya,2016-03-10 12:31:02-08:00,['ac6b0d1fbbe459633cb02e17971dc365f57290ce'],1,1,2,22016801,1,,,,22133
a9d562171596f7bb9734e41e9c3ab83295205be8,0,Sumit Mohanty,2016-03-10 13:20:20-08:00,['7cdb16c1d8e575dc00b71877858abe9d95bdd871'],0,19,19,22016820,1,,,,22133
171379abd1bd525c5ff9693f7e8bc27bc182fec4,0,Richard Zang,2016-03-10 15:08:35-08:00,['a9d562171596f7bb9734e41e9c3ab83295205be8'],4,3,7,22016827,1,1,0,0,22133
5839ecbaa9efc8e11f01fc728eae57e7bb4856cb,0,Lisnichenko Dmitro,2016-03-11 12:47:12+02:00,['171379abd1bd525c5ff9693f7e8bc27bc182fec4'],3,3,6,22016833,2,,,,22133
68034ae84354f82eac8c875c319e0c8d5cd699ac,0,Alex Antonenko,2016-03-11 14:52:15+02:00,['5839ecbaa9efc8e11f01fc728eae57e7bb4856cb'],1,1,2,22016835,1,,,,22133
977cb4bc9f8c61792ee8ff2a611a2990c9ab5df0,1,Alex Antonenko,2016-03-11 14:52:15+02:00,['68034ae84354f82eac8c875c319e0c8d5cd699ac'],18,67,85,22016920,8,1,1,0.925925926,22133
39eded40b1dcf063c351f4bb6832117d14fd0583,1,Myroslav Papirkovskyi,2016-03-11 16:37:35+02:00,['977cb4bc9f8c61792ee8ff2a611a2990c9ab5df0'],0,33,33,22016953,2,0.75,0.75,1,22133
962a9730454f1b771d08ff3280f773a8a1251b7e,1,Myroslav Papirkovskyi,2016-03-11 16:37:36+02:00,['39eded40b1dcf063c351f4bb6832117d14fd0583'],11,23,34,22016987,3,0,0.166666667,0.166666667,22133
7eba6fd39d84ddbf9a002d60651e7ebef1692e4f,0,Lisnichenko Dmitro,2016-03-11 17:45:28+02:00,['962a9730454f1b771d08ff3280f773a8a1251b7e'],0,317,317,22017304,2,0.560810811,0.871621622,0.635135135,22135
1b82cdab05d3717d608fcce1b0e685a5755218e9,0,Lisnichenko Dmitro,2016-03-11 17:47:33+02:00,['7eba6fd39d84ddbf9a002d60651e7ebef1692e4f'],317,0,317,22017621,2,0.439189189,0.128378378,0.364864865,22135
ba58ad1c20c173315c099a9e7364f51fd0d4bd57,1,Lisnichenko Dmitro,2016-03-11 19:10:18+02:00,['1b82cdab05d3717d608fcce1b0e685a5755218e9'],1,4,5,22017626,1,0,0,1,22135
bdec3bbe33f85190e08e194d8ac3ff370bcf26aa,0,Andrew Onishuk,2016-03-11 19:17:59+02:00,['ba58ad1c20c173315c099a9e7364f51fd0d4bd57'],14,24,38,22017664,2,0,1,1,22135
304bdcfa5ad45c7433fa521d73c958044ca13697,1,Richard Zang,2016-03-11 10:56:34-08:00,['bdec3bbe33f85190e08e194d8ac3ff370bcf26aa'],90,210,300,22017964,9,0.848387097,0,0,22135
c15b088ca3c0b0e5a69340ba9e95eeae3dbc3aad,1,Bhuvnesh Chaudhary,2016-03-11 11:43:34-08:00,['304bdcfa5ad45c7433fa521d73c958044ca13697'],126,292,418,22018382,10,,,,22135
be9d76ed0eeacfc70f47023503475b1f05c4df85,0,Bhuvnesh Chaudhary,2016-03-11 11:46:19-08:00,['c15b088ca3c0b0e5a69340ba9e95eeae3dbc3aad'],3,3,6,22018388,1,,,,22135
0f0d7766017d697f8e1e19be476743516f360b4f,1,Alejandro Fernandez,2016-03-11 12:20:16-08:00,['be9d76ed0eeacfc70f47023503475b1f05c4df85'],0,850,850,22019238,13,0.304477612,0.817910448,0.832835821,22139
c17e227cb61875804e88f7b67c7663252863f456,1,Xi Wang,2016-03-11 15:50:13-08:00,['0f0d7766017d697f8e1e19be476743516f360b4f'],112,124,236,22019474,58,1,1,1,22139
d02eb1f9b369c33aca5f78758bb7301a102a8ac4,0,Sumit Mohanty,2016-03-11 17:07:30-08:00,['c17e227cb61875804e88f7b67c7663252863f456'],36,999,1035,22020509,20,0.066666667,1,0.066666667,22139
8d2265bcf4dcace45cbebf1348c3817341cc9778,1,oleewere,2016-03-13 17:45:22+01:00,['d02eb1f9b369c33aca5f78758bb7301a102a8ac4'],10,80,90,22020599,6,0.318181818,1,1,22139
6ee6a978cf4357decd7e36159a8d734276c48303,0,Oleg Nechiporenko,2016-03-14 12:11:30+02:00,['8d2265bcf4dcace45cbebf1348c3817341cc9778'],53,23,76,22020675,3,0,0,0,22139
d8d790e1fff42f28d1f825c5e2f6161d5023053b,1,Andrii Tkach,2016-03-14 12:41:43+02:00,['6ee6a978cf4357decd7e36159a8d734276c48303'],139,139,278,22020953,9,,,,22139
2b596be9b93682ed436837f4f2b75197ae4349c7,0,Dmytro Sen,2016-03-14 14:34:50+02:00,['d8d790e1fff42f28d1f825c5e2f6161d5023053b'],16,142,158,22021111,5,0.16,0.853333333,0.653333333,22139
3b3c660467b2596142c4011a9080926a0f12bc2c,1,Vitaly Brodetskyi,2016-03-14 15:18:46+02:00,['2b596be9b93682ed436837f4f2b75197ae4349c7'],168,206,374,22021485,18,0,1,0.62962963,22139
070babc0f023c7ce1e1abced20bdf78a139f3542,1,Andrew Onishuk,2016-03-14 16:08:22+02:00,['3b3c660467b2596142c4011a9080926a0f12bc2c'],6,62,68,22021553,2,0,0.893617021,1,22139
c341a0f59f1ee4b630afe37c1b415cfc8e972827,1,Vitaly Brodetskyi,2016-03-14 16:56:05+02:00,['070babc0f023c7ce1e1abced20bdf78a139f3542'],1,1,2,22021555,1,,,,22139
2f9945fadf8f67d1ee5a7478a5284ba2e237166b,1,Sumit Mohanty,2016-03-14 10:44:28-07:00,['c341a0f59f1ee4b630afe37c1b415cfc8e972827'],999,37,1036,22022591,20,0.933333333,0,0.933333333,22139
5bd7c2bc7db2808a1fe9d6048e72ff483a6208ef,1,Andrew Onishuk,2016-03-14 19:49:57+02:00,['2f9945fadf8f67d1ee5a7478a5284ba2e237166b'],1,1,2,22022593,1,,,,22139
7210c9dfb804cbe0622b4f568f29f57e311df024,0,Myroslav Papirkovskyi,2016-03-14 19:58:42+02:00,['5bd7c2bc7db2808a1fe9d6048e72ff483a6208ef'],43,36,79,22022672,2,1,1,0,22139
cbd88027a4cfd287e6b8669c30db06231a63c2b6,1,Robert Levas,2016-03-14 14:33:28-04:00,['7210c9dfb804cbe0622b4f568f29f57e311df024'],4,1245,1249,22023921,12,0.353996737,0.830342577,0.970636215,22143
b9d06931abf989eb8c6715ff9a4cc4c3f4f25ece,1,Dmytro Sen,2016-03-14 20:42:27+02:00,['cbd88027a4cfd287e6b8669c30db06231a63c2b6'],22,74,96,22024017,2,0.057142857,1,0.828571429,22143
b99085b7c1beb78896e98f0d39f94eafb9c26afb,0,Jonathan Hurley,2016-03-14 15:51:58-04:00,['b9d06931abf989eb8c6715ff9a4cc4c3f4f25ece'],142,16,158,22024175,5,0.84,0.146666667,0.346666667,22143
be57b745dbd8cb695fed883130a6028825fe0241,1,Dmytro Sen,2016-03-14 23:28:05+02:00,['b99085b7c1beb78896e98f0d39f94eafb9c26afb'],6,6,12,22024187,3,,,,22143
b88aaa3ea00be20ec65590d5dd4f9a67d2d8fecc,0,Richard Zang,2016-03-14 14:33:41-07:00,['be57b745dbd8cb695fed883130a6028825fe0241'],2,4,6,22024193,1,0,1,1,22143
c612a462cbb1cef67a245b78234e66ab541577b8,1,Xi Wang,2016-03-14 15:52:47-07:00,['b88aaa3ea00be20ec65590d5dd4f9a67d2d8fecc'],11,39,50,22024243,7,0.888888889,1,1,22143
3eb766410f35cd8769f9e77969ef0c4b0c5bcb90,0,Jaimin Jetly,2016-03-14 17:11:42-07:00,['c612a462cbb1cef67a245b78234e66ab541577b8'],13,0,13,22024256,1,0,0,1,22143
d4b76ad92e6a06d65c34fc28704791d205b1f54e,1,Aravindan Vijayan,2016-03-14 18:16:41-07:00,['3eb766410f35cd8769f9e77969ef0c4b0c5bcb90'],18,10,28,22024284,4,0.166666667,0,0.5,22143
122bebf2661d33c20fe679724901eed5f0aa4925,0,Siddharth Wagle,2016-03-14 19:14:16-07:00,['d4b76ad92e6a06d65c34fc28704791d205b1f54e'],50,412,462,22024746,3,0,0,0,22143
17bdcaf0954a9636c64fbb98bfce4ccde5fdb5f2,1,Siddharth Wagle,2016-03-14 19:14:50-07:00,['122bebf2661d33c20fe679724901eed5f0aa4925'],0,21,21,22024767,2,0,0,0.368421053,22143
ac774546d1bdb4a38ffb391b75062c12b776d53a,1,Bhuvnesh Chaudhary,2016-03-14 20:08:03-07:00,['17bdcaf0954a9636c64fbb98bfce4ccde5fdb5f2'],17,48,65,22024832,4,0.333333333,1,1,22143
752b5a05189eb5e76954fddb4d3eab771532259a,1,Dmytro Sen,2016-03-15 09:55:04+02:00,['ac774546d1bdb4a38ffb391b75062c12b776d53a'],412,50,462,22025294,3,1,1,1,22143
87f8431976866c6302d2af89208fa3ebbfbd2d3e,0,Oleg Nechiporenko,2016-03-15 09:56:05+02:00,['752b5a05189eb5e76954fddb4d3eab771532259a'],15,17,32,22025326,3,0,0,0,22143
6e5c6d4083fc065940d2c0ac36543035ddeb4359,1,Vitaly Brodetskyi,2016-03-15 11:26:19+02:00,['87f8431976866c6302d2af89208fa3ebbfbd2d3e'],4,3,7,22025333,1,,,,22143
69a25e324cb7b10cd55b529075a63ed3ff05a5cf,0,Oleg Nechiporenko,2016-03-15 12:19:03+02:00,['6e5c6d4083fc065940d2c0ac36543035ddeb4359'],1,3,4,22025337,1,,,,22143
3c37c38e60d5e65afacec60d0ab3019a43bbe00c,1,Oleg Nechiporenko,2016-03-15 12:32:24+02:00,['69a25e324cb7b10cd55b529075a63ed3ff05a5cf'],2,11,13,22025350,2,0,0,1,22143
9bf7c6e223d56d5cac4bd267e6ce3e6fb4e325fd,1,Dmytro Sen,2016-03-15 13:51:45+02:00,['3c37c38e60d5e65afacec60d0ab3019a43bbe00c'],109,45,154,22025504,7,0.782608696,0.782608696,0,22143
2ab19a6c9f7cbc7fcbb340229e5824d545e044e0,1,Dipayan Bhowmick,2016-03-15 17:15:37+05:18,['9bf7c6e223d56d5cac4bd267e6ce3e6fb4e325fd'],1,1,2,22025506,1,,,,22143
1d1620a327a041236a1b7ea75859a1f47c63aff3,0,Dipayan Bhowmick,2016-03-15 17:18:49+05:18,['2ab19a6c9f7cbc7fcbb340229e5824d545e044e0'],1,31,32,22025538,2,1,1,1,22144
226143a5b8df4e44611672f540d09b9e8f6f4389,1,Dipayan Bhowmick,2016-03-15 17:20:45+05:18,['1d1620a327a041236a1b7ea75859a1f47c63aff3'],21,61,82,22025620,3,1,1,1,22144
2ac0c1da5a5451b672446c125c48de69f1ca25ec,1,Dipayan Bhowmick,2016-03-15 17:26:19+05:18,['226143a5b8df4e44611672f540d09b9e8f6f4389'],2,24,26,22025646,3,1,1,1,22144
bc2719a77e57f0225d4575c43038629250a1f903,0,Robert Levas,2016-03-15 08:29:41-04:00,['2ac0c1da5a5451b672446c125c48de69f1ca25ec'],9,27,36,22025682,1,0,1,1,22144
1816cfb998f41de649d97cbf5ef45a1d3429d37f,1,Jonathan Hurley,2016-03-15 10:14:02-04:00,['bc2719a77e57f0225d4575c43038629250a1f903'],54,248,302,22025984,4,0.433962264,0.433962264,0.849056604,22145
dfe66f6907c7bd04aaa5e8a3a45a52de70e700dc,0,Vitaly Brodetskyi,2016-03-15 16:18:50+02:00,['1816cfb998f41de649d97cbf5ef45a1d3429d37f'],0,1,1,22025985,1,0,1,1,22145
5e093c9ebc120dbdb86356b100b49f6da7c05747,1,Dmytro Sen,2016-03-15 17:58:04+02:00,['dfe66f6907c7bd04aaa5e8a3a45a52de70e700dc'],20,162,182,22026167,7,0.147727273,0.659090909,0.602272727,22145
044673b768abe71e239dbd350576f8ad23d6490e,1,Andrew Onishuk,2016-03-15 18:25:00+02:00,['5e093c9ebc120dbdb86356b100b49f6da7c05747'],2,2,4,22026171,1,,,,22145
e9753476c4e039d4fd20cfa3dd22cd9d8821f349,1,Di Li,2016-03-15 12:52:32-04:00,['044673b768abe71e239dbd350576f8ad23d6490e'],27,156,183,22026354,5,0.375,1,1,22145
b4e3bb0de9210d43891380c13f1bfb713644bf85,0,Lisnichenko Dmitro,2016-03-15 18:54:57+02:00,['e9753476c4e039d4fd20cfa3dd22cd9d8821f349'],0,3,3,22026357,1,1,0,1,22145
c44300ea6bb339586a20537b67dbc3b583a5337c,1,Bhuvnesh Chaudhary,2016-03-15 10:08:15-07:00,['b4e3bb0de9210d43891380c13f1bfb713644bf85'],0,1,1,22026358,1,,,,22145
82ac281ee69040ded0ed7800587d75cb36173345,1,Sumit Mohanty,2016-03-15 10:49:39-07:00,['c44300ea6bb339586a20537b67dbc3b583a5337c'],38,999,1037,22027395,20,0.066666667,1,0.066666667,22145
63baf1844c3e1cae8e08f2417b7baba7bb30310c,0,Sumit Mohanty,2016-03-15 10:52:14-07:00,['82ac281ee69040ded0ed7800587d75cb36173345'],0,307,307,22027702,1,,,,22146
40a906ec26ad5b8c68d0dba377ff69841dc7a356,0,Bhuvnesh Chaudhary,2016-03-15 12:18:09-07:00,['63baf1844c3e1cae8e08f2417b7baba7bb30310c'],6,9,15,22027717,3,,,,22146
afb69f02f416afef9d0c69444e974dd33a9fd08b,1,Siddharth Wagle,2016-03-15 12:55:28-07:00,['40a906ec26ad5b8c68d0dba377ff69841dc7a356'],49,410,459,22028176,3,0,0,0,22146
3e75bb3a645a01502af4c0b6e456a2c7d6e31a90,1,Nahappan Somasundaram,2016-03-15 14:10:11-07:00,['afb69f02f416afef9d0c69444e974dd33a9fd08b'],170,431,601,22028777,11,0.848837209,0.825581395,0.453488372,22148
803bc73545e62e3ea1f145c215ee31d342999ba6,1,ababiichuk,2016-03-16 12:42:03+02:00,['3e75bb3a645a01502af4c0b6e456a2c7d6e31a90'],17,24,41,22028818,3,1,0,0,22148
27262b897dba1b1c4201bf2086da644381cec933,1,Andrew Onishuk,2016-03-16 13:05:48+02:00,['803bc73545e62e3ea1f145c215ee31d342999ba6'],111,170,281,22029099,6,0.75,0.958333333,0.958333333,22148
6dcb48422b870187f0ea0e12a68a85d5580e64ac,1,Vitaly Brodetskyi,2016-03-16 13:11:30+02:00,['27262b897dba1b1c4201bf2086da644381cec933'],21,23,44,22029143,1,0,0,1,22148
23a24ca9c2bea6fa238f2808c338fcea52b21d75,1,Dmytro Sen,2016-03-16 16:03:58+02:00,['6dcb48422b870187f0ea0e12a68a85d5580e64ac'],1,183,184,22029327,8,0.673076923,1,1,22150
8eb7f6cd027dbecc5df958308578cbf7e87b7ad6,1,Andrew Onishuk,2016-03-16 17:09:42+02:00,['23a24ca9c2bea6fa238f2808c338fcea52b21d75'],8,20,28,22029355,4,,,,22150
e4418ee382aadc20d50a830ff19331d0da54739b,1,Andrew Onishuk,2016-03-16 17:29:45+02:00,['8eb7f6cd027dbecc5df958308578cbf7e87b7ad6'],18,33,51,22029406,4,0,0,0.375,22150
9d6f526827e2dfe5cc138865c593330f2391736f,1,Bhuvnesh Chaudhary,2016-03-16 13:07:05-07:00,['e4418ee382aadc20d50a830ff19331d0da54739b'],3,8,11,22029417,1,0,0,0,22150
b76a5f5661fb0eed325e8c650e4a931535114399,1,Yusaku Sako,2016-03-16 17:04:05-07:00,['9d6f526827e2dfe5cc138865c593330f2391736f'],1244,26637,27881,22057298,21,,,,22163
04620902c76ecf32c82a08e146dc8fdfb3229bed,1,Bhuvnesh Chaudhary,2016-03-16 17:06:31-07:00,['b76a5f5661fb0eed325e8c650e4a931535114399'],5,7,12,22057310,1,,,,22163
0c29bc5f08c05a4c817667e1a7897d2ec4aa4a29,0,Yusaku Sako,2016-03-16 17:06:25-07:00,['04620902c76ecf32c82a08e146dc8fdfb3229bed'],11,4,15,22057325,1,1,1,0,22163
1e673420e50959841bee04f168882f843f132696,0,Bhuvnesh Chaudhary,2016-03-16 17:09:13-07:00,['0c29bc5f08c05a4c817667e1a7897d2ec4aa4a29'],0,12,12,22057337,2,,,,22163
9c53f439973f106f92b82b64eeb3de583f3daeae,1,tbeerbower,2016-03-16 20:11:53-04:00,['1e673420e50959841bee04f168882f843f132696'],24,613,637,22057974,15,0.128205128,0.961538462,0.961538462,22166
628e74c2f4a88906332bbbdd6ecb699c214c8212,1,Siddharth Wagle,2016-03-16 23:32:36-07:00,['9c53f439973f106f92b82b64eeb3de583f3daeae'],81,154,235,22058209,8,0,0.64,0.98,22166
df2d304b18f53f0594af3e8f373c13c0b61b73c6,1,Oleg Nechiporenko,2016-03-17 08:36:35+02:00,['628e74c2f4a88906332bbbdd6ecb699c214c8212'],12,32,44,22058253,4,1,1,1,22166
dcb4ed80392219717e11dc6e14b646810fc83f7e,0,Vitaly Brodetskyi,2016-03-17 11:04:03+02:00,['df2d304b18f53f0594af3e8f373c13c0b61b73c6'],41,58,99,22058352,5,0,0,0,22166
cb3d49bb456e3a7ff81c18d1a03635c185273ee0,0,Alex Antonenko,2016-03-17 14:07:45+02:00,['dcb4ed80392219717e11dc6e14b646810fc83f7e'],0,1,1,22058353,1,1,1,1,22166
f7cde0c7ab041a0f56e96c996a6fa80b2fda33e9,1,Alex Antonenko,2016-03-17 14:07:45+02:00,['cb3d49bb456e3a7ff81c18d1a03635c185273ee0'],395,329,724,22059077,8,0.425,0,0,22166
016ff398ac75844d1b0e14b190184308b3c90f26,1,Andrew Onishuk,2016-03-17 14:44:48+02:00,['f7cde0c7ab041a0f56e96c996a6fa80b2fda33e9'],0,8,8,22059085,2,0,0.666666667,1,22166
0503753da02ac067e85f3ca895e6d91e54f5013c,1,Gautam Borad,2016-03-17 18:23:35+05:18,['016ff398ac75844d1b0e14b190184308b3c90f26'],14,10,24,22059109,1,1,1,0,22166
fac2eece9fe9b5bf8169f49448417b922bb56b5e,1,Andrii Tkach,2016-03-17 15:20:32+02:00,['0503753da02ac067e85f3ca895e6d91e54f5013c'],24,745,769,22059878,10,0.996753247,1,1,22170
d7596e769f7546e621981f9e5501c1094e6e4f84,1,Vitaly Brodetskyi,2016-03-17 12:40:33+02:00,['fac2eece9fe9b5bf8169f49448417b922bb56b5e'],2,16,18,22059896,2,,,,22170
670ad6f4c6dd66b0c75147b4b68a8576d5438d7e,1,Andrew Onishuk,2016-03-17 16:36:34+02:00,['d7596e769f7546e621981f9e5501c1094e6e4f84'],1,1,2,22059898,1,,,,22170
01a43eef35106ea27dcf4412f1d876873675cf2c,1,ababiichuk,2016-03-17 17:06:01+02:00,['670ad6f4c6dd66b0c75147b4b68a8576d5438d7e'],16,35,51,22059949,5,1,1,1,22170
3cc686f648b29b54053dd52c26c91d0b50097a10,1,Oleg Nechiporenko,2016-03-17 17:08:04+02:00,['01a43eef35106ea27dcf4412f1d876873675cf2c'],2,6,8,22059957,3,,,,22170
961c33dcd14ce4152f5e97bea9c45f26f349390a,0,Vitaly Brodetskyi,2016-03-17 15:07:29+02:00,['3cc686f648b29b54053dd52c26c91d0b50097a10'],1,1,2,22059959,1,,,,22170
96d76f5c26914d8380f8b2045135189bc513b063,1,Siddharth Wagle,2016-03-17 11:41:09-07:00,['961c33dcd14ce4152f5e97bea9c45f26f349390a'],1,1,2,22059961,1,,,,22170
f2b8164e3973a29012105713429cc13b52bdc89e,1,Richard Zang,2016-03-17 11:55:38-07:00,['96d76f5c26914d8380f8b2045135189bc513b063'],190,207,397,22060358,9,0.333333333,1,0.996376812,22172
95798ad96a19902dabec855c65a96bcfab63400d,1,Nate Cole,2016-03-17 15:07:14-04:00,['f2b8164e3973a29012105713429cc13b52bdc89e'],73,432,505,22060863,10,0,0.797619048,0.678571429,22172
33eeec80051601b7931a186cff1ee405fc64e179,0,Siddharth Wagle,2016-03-17 12:21:40-07:00,['95798ad96a19902dabec855c65a96bcfab63400d'],1,2,3,22060866,1,0,0,1,22172
201961a4a4f86b50a39bbb0cec0e33d05da2c842,1,Aravindan Vijayan,2016-03-17 12:51:56-07:00,['33eeec80051601b7931a186cff1ee405fc64e179'],3,110,113,22060979,3,0,0.701492537,1,22172
5291228c30e17eed6e7b7fdc67bf8907e9a8f632,1,Robert Levas,2016-03-17 17:02:35-04:00,['201961a4a4f86b50a39bbb0cec0e33d05da2c842'],3,15,18,22060997,3,0.6,0.6,0.8,22172
1bf667ead7e164fa16896a8bba9ba91d802aab14,1,Andrew Onishuk,2016-03-18 00:41:10+02:00,['5291228c30e17eed6e7b7fdc67bf8907e9a8f632'],2,14,16,22061013,1,,,,22172
b663dbe1be5291d8d32de7ec2b4434612d0861c0,1,Jun Aoki,2016-03-17 16:42:56-07:00,['1bf667ead7e164fa16896a8bba9ba91d802aab14'],42,157,199,22061212,4,1,1,0.25,22172
e9e1556f6c26c06095d18da84bf9e13a958bd3c1,0,Pallav Kulshreshtha,2016-03-18 12:00:33+05:18,['b663dbe1be5291d8d32de7ec2b4434612d0861c0'],3,3,6,22061218,2,,,,22172
bec76707f0e000712c909b7c91bc0d14136604dd,1,Pallav Kulshreshtha,2016-03-18 12:34:19+05:18,['e9e1556f6c26c06095d18da84bf9e13a958bd3c1'],11,11,22,22061240,2,1,1,1,22172
795fac68f5b963ed6437d3bf902e7ce033f8b987,1,Pallav Kulshreshtha,2016-03-18 12:46:19+05:18,['bec76707f0e000712c909b7c91bc0d14136604dd'],23,20,43,22061283,2,1,1,0,22172
ba2c77f15fadb29898b8674ec1a3b2a264ddb457,0,Oleg Nechiporenko,2016-03-18 13:16:10+02:00,['795fac68f5b963ed6437d3bf902e7ce033f8b987'],23,22,45,22061328,2,0,1,1,22172
9ff6b8762f35871ca1c9f537adda06711993e562,1,Andrew Onishuk,2016-03-18 14:58:35+02:00,['ba2c77f15fadb29898b8674ec1a3b2a264ddb457'],5,54,59,22061387,3,0.631578947,0.631578947,0.368421053,22172
fa611afd26075d1d6e4c41550a481c213efcfe77,1,Nate Cole,2016-03-18 09:52:13-04:00,['9ff6b8762f35871ca1c9f537adda06711993e562'],19,232,251,22061638,6,0.056603774,0.716981132,0.943396226,22173
a4d5a31bb34dab85dc526e70c9ec8328f16bd3a2,1,Alex Antonenko,2016-03-18 17:08:39+02:00,['fa611afd26075d1d6e4c41550a481c213efcfe77'],2,2,4,22061642,1,,,,22173
711e64ac0b01a134bd46f1527931827a030a9a2b,1,Vitaly Brodetskyi,2016-03-18 14:37:44+02:00,['a4d5a31bb34dab85dc526e70c9ec8328f16bd3a2'],36,125,161,22061803,15,0.390243902,0.804878049,0.975609756,22173
d752f5ec875811da3f13fee766cc029150a92645,0,Lisnichenko Dmitro,2016-03-18 17:46:31+02:00,['711e64ac0b01a134bd46f1527931827a030a9a2b'],2,5,7,22061810,2,0,0,0,22173
f983862a4dd8b840ce133f0d6d5f8b004df7aafc,0,Jonathan Hurley,2016-03-18 13:05:12-04:00,['d752f5ec875811da3f13fee766cc029150a92645'],1,1,2,22061812,1,,,,22173
7242a4a1803c6d707d40063d9a708609a5fe4bcf,1,Jonathan Hurley,2016-03-18 13:05:12-04:00,['f983862a4dd8b840ce133f0d6d5f8b004df7aafc'],16,2,18,22061830,2,,,,22173
95c9f155f9a5cbf1c722f3bcfe9552921ae48b04,0,Andrew Onishuk,2016-03-18 20:14:12+02:00,['7242a4a1803c6d707d40063d9a708609a5fe4bcf'],0,167,167,22061997,2,0.263157895,0.263157895,0.649122807,22174
bb6ba25f9a04d17e7146820137d95d2c1bc18174,0,Andrew Onishuk,2016-03-18 20:14:52+02:00,['95c9f155f9a5cbf1c722f3bcfe9552921ae48b04'],3,3,6,22062003,1,,,,22174
74517116a666a5d9d72d27efb73c02309fca0b05,1,Yusaku Sako,2016-03-18 17:15:34-07:00,['bb6ba25f9a04d17e7146820137d95d2c1bc18174'],4,50,54,22062057,4,1,1,1,22174
9dc52fc9f156252ca206fdb8ca07af09f2bf582e,0,Yusaku Sako,2016-03-18 18:44:54-07:00,['74517116a666a5d9d72d27efb73c02309fca0b05'],12,0,12,22062069,1,,,,22174
36ad561114236c962397f0383878c78197b5c8e2,1,Siddharth Wagle,2016-03-18 19:15:53-07:00,['9dc52fc9f156252ca206fdb8ca07af09f2bf582e'],2,2,4,22062073,2,,,,22174
74f31459800db97b5d355139eea7e79c47156c7b,1,"Toader, Sebastian",2016-03-19 06:41:18+01:00,['36ad561114236c962397f0383878c78197b5c8e2'],2,4,6,22062079,2,,,,22174
b65b7c2ddbe6e11d8c0514346f2c00da3feceaae,1,Jun Aoki,2016-03-19 01:13:08-07:00,['74f31459800db97b5d355139eea7e79c47156c7b'],33,40,73,22062152,7,0.5,1,1,22174
a6dd447b0878029197f00b2f4cd34adba88e5d47,1,"Toader, Sebastian",2016-03-19 11:52:51+01:00,['b65b7c2ddbe6e11d8c0514346f2c00da3feceaae'],25,255,280,22062432,19,0.919191919,0.949494949,0.98989899,22175
2dac4846a3382f57ad29cdf9c2c86d439b71318a,1,Bhuvnesh Chaudhary,2016-03-19 19:40:10-07:00,['a6dd447b0878029197f00b2f4cd34adba88e5d47'],47,144,191,22062623,4,0.013513514,0.621621622,0.675675676,22175
5d52b70dd386d1f6950841950c8a4f36b8f46c94,1,Dmytro Sen,2016-03-21 10:53:34+02:00,['2dac4846a3382f57ad29cdf9c2c86d439b71318a'],70,182,252,22062875,23,0,0.714285714,0.904761905,22175
76fd6809d9d8d8483412f89734a83d19b36840ca,1,Vitaly Brodetskyi,2016-03-21 09:46:48+02:00,['5d52b70dd386d1f6950841950c8a4f36b8f46c94'],3,5,8,22062883,1,1,1,1,22175
e7bbfe10d5aa097fbfa4f3132a94135e4c0cb3c0,0,Andrii Tkach,2016-03-21 13:39:10+02:00,['76fd6809d9d8d8483412f89734a83d19b36840ca'],0,1,1,22062884,1,,,,22175
11c1066c4d246418492e6ba4e24aac5a49557f64,1,Andrew Onishuk,2016-03-21 15:35:01+02:00,['e7bbfe10d5aa097fbfa4f3132a94135e4c0cb3c0'],26,48,74,22062958,4,0,0.714285714,0.523809524,22175
e0bf50fdc06e944da8b1b72975d7af2363c2fa93,1,Dipayan Bhowmick,2016-03-21 19:59:54+05:18,['11c1066c4d246418492e6ba4e24aac5a49557f64'],0,93,93,22063051,16,0.875,1,0.875,22183
b52073ad9dc1a612cdf2e64190ef5b0626c84728,1,Dipayan Bhowmick,2016-03-21 20:05:49+05:18,['e0bf50fdc06e944da8b1b72975d7af2363c2fa93'],9,30,39,22063090,3,1,1,0.5,22183
b66374324fc00533a90344b4db91a3bd21f631ab,1,Dipayan Bhowmick,2016-03-21 20:09:56+05:18,['b52073ad9dc1a612cdf2e64190ef5b0626c84728'],64,149,213,22063303,1,1,1,0.944444444,22183
c78296809ef24e516a7d42ef4d7ae606c29ff8d8,0,Dipayan Bhowmick,2016-03-21 20:52:36+05:18,['b66374324fc00533a90344b4db91a3bd21f631ab'],25,74,99,22063402,6,0,1,1,22183
e4d955cdf25442a2bd45c4bba15161402ff2bd4c,1,Andrew Onishuk,2016-03-21 17:58:22+02:00,['c78296809ef24e516a7d42ef4d7ae606c29ff8d8'],7,12,19,22063421,1,,,,22183
8d8b61f4eaf555e1662e0d8120844877b447602b,0,Dipayan Bhowmick,2016-03-21 21:24:17+05:18,['e4d955cdf25442a2bd45c4bba15161402ff2bd4c'],74,25,99,22063520,6,1,0,0,22183
34a8b13aa4b54663d33148cfb8a76f43efc3adf1,1,Dipayan Bhowmick,2016-03-21 21:28:07+05:18,['8d8b61f4eaf555e1662e0d8120844877b447602b'],33,78,111,22063631,6,0,1,1,22183
a0877a9c7252de528502e35730860f50aa412559,1,Andrew Onishuk,2016-03-21 18:13:10+02:00,['34a8b13aa4b54663d33148cfb8a76f43efc3adf1'],0,16,16,22063647,3,,,,22184
d862f7aa8d6570b7d1ce2a9e1ccaebc4db0377b5,0,Andrew Onishuk,2016-03-21 18:13:11+02:00,['a0877a9c7252de528502e35730860f50aa412559'],0,1,1,22063648,1,0,0,0,22184
4697bd290f097679e7495e9ac6cd1fccd7ac35f2,0,Andrew Onishuk,2016-03-21 18:16:30+02:00,['d862f7aa8d6570b7d1ce2a9e1ccaebc4db0377b5'],10,0,10,22063658,1,,,,22184
e80464cd0917f4b9afa7946e03593746c64bb2b2,1,Dipayan Bhowmick,2016-03-21 21:57:17+05:18,['4697bd290f097679e7495e9ac6cd1fccd7ac35f2'],1,1,2,22063660,1,,,,22184
ada7f51b27a92374abcb95b48d0f7ec4a57640a1,1,Dipayan Bhowmick,2016-03-21 22:04:37+05:18,['e80464cd0917f4b9afa7946e03593746c64bb2b2'],2,9,11,22063671,3,0,1,1,22184
aa8409fd1e6cbef664766f9ffba45be6c2284b2e,0,Alex Antonenko,2016-03-21 19:34:22+02:00,['ada7f51b27a92374abcb95b48d0f7ec4a57640a1'],2,9,11,22063682,1,0,0,1,22184
0f3bf8aa8b126a50af778d8504c73a5c8f24b334,1,Jayush Luniya,2016-03-21 11:45:14-07:00,['aa8409fd1e6cbef664766f9ffba45be6c2284b2e'],402,992,1394,22065076,71,0.412371134,0.726804124,0.891752577,22189
8285e246c9788269985a21741bb3c354e8ab762b,1,Jonathan Hurley,2016-03-21 14:59:41-04:00,['0f3bf8aa8b126a50af778d8504c73a5c8f24b334'],93,334,427,22065503,22,0.563106796,0.72815534,0.86407767,22189
38f363f1816ab1a4fe5e0cf704b945717b814d8f,1,Vitaly Brodetskyi,2016-03-21 18:14:17+02:00,['8285e246c9788269985a21741bb3c354e8ab762b'],28,30,58,22065561,2,,,,22189
0521787d8a2de8124ab9d84cca228ba560eaab5c,0,Vitaly Brodetskyi,2016-03-21 20:03:07+02:00,['38f363f1816ab1a4fe5e0cf704b945717b814d8f'],2,2,4,22065565,2,,,,22189
79b9e570fe1549bfc312dc02c29246c56043face,1,Alejandro Fernandez,2016-03-21 14:00:19-07:00,['0521787d8a2de8124ab9d84cca228ba560eaab5c'],1,746,747,22066312,17,0.360501567,0.652037618,0.987460815,22191
3a42f6131c37043f712215cbf5744b5b07167b6e,0,Jonathan Hurley,2016-03-21 17:18:48-04:00,['79b9e570fe1549bfc312dc02c29246c56043face'],3,3,6,22066318,1,,,,22191
d2ccdcaa44350000c15c6559c405383c12aac5ae,0,"Toader, Sebastian",2016-03-21 23:19:10+01:00,['3a42f6131c37043f712215cbf5744b5b07167b6e'],2,11,13,22066331,2,,,,22191
c7a10450ce7add4a7f98927b3a4ba931a3a79e75,0,Jayush Luniya,2016-03-21 18:00:59-07:00,['d2ccdcaa44350000c15c6559c405383c12aac5ae'],0,3,3,22066334,1,,,,22191
688da50edf95824c524d92f599bad14636466c01,0,Richard Zang,2016-03-21 18:05:35-07:00,['c7a10450ce7add4a7f98927b3a4ba931a3a79e75'],1,1,2,22066336,1,,,,22191
7f5e903554d89b8115f714a86b333f3ad9ac8897,1,Oleg Nechiporenko,2016-03-22 12:07:29+02:00,['688da50edf95824c524d92f599bad14636466c01'],7,10,17,22066353,2,,,,22191
2925a6aa5adbdcad2a7311207f754dd79cd6b5fb,1,Oleg Nechiporenko,2016-03-22 12:09:57+02:00,['7f5e903554d89b8115f714a86b333f3ad9ac8897'],192,271,463,22066816,17,1,1,0,22193
0e4084c37a68ec143af766cf1fd93330a899c650,1,Myroslav Papirkovskyi,2016-03-22 15:36:08+02:00,['2925a6aa5adbdcad2a7311207f754dd79cd6b5fb'],268,273,541,22067357,12,1,1,0,22193
e26e80a84ac0c45339f3676ed2279f1205c56191,1,Lisnichenko Dmitro,2016-03-22 16:36:54+02:00,['0e4084c37a68ec143af766cf1fd93330a899c650'],0,136,136,22067493,2,0.009433962,0.650943396,1,22193
8a89066710b8940157f9cfc92f677f75435d42a2,1,Lisnichenko Dmitro,2016-03-22 16:38:44+02:00,['e26e80a84ac0c45339f3676ed2279f1205c56191'],3,19,22,22067515,3,,,,22193
42b7b3f44695c605af71a179ff22f55682b5ff37,1,Lisnichenko Dmitro,2016-03-22 16:53:17+02:00,['8a89066710b8940157f9cfc92f677f75435d42a2'],13,15,28,22067543,7,1,1,1,22193
3508a7ef60369fb6aac7b40efd69a08ba490530f,1,tbeerbower,2016-03-22 11:04:25-04:00,['42b7b3f44695c605af71a179ff22f55682b5ff37'],4,80,84,22067627,3,0.448275862,1,1,22194
8bd43711a284b521af0a883ee5b7b77e3471e0ed,1,Andrew Onishuk,2016-03-22 17:07:08+02:00,['3508a7ef60369fb6aac7b40efd69a08ba490530f'],5,84,89,22067716,3,0,0.444444444,1,22194
cd7d46a924493bd06fb67309ae9dc45fa466ddc8,0,Vitaly Brodetskyi,2016-03-22 16:23:50+02:00,['8bd43711a284b521af0a883ee5b7b77e3471e0ed'],0,6,6,22067722,1,0,1,1,22194
6b933cc9ec3f82a8513d5dadffa92ab989743550,0,Matt,2016-03-22 10:28:30-07:00,['cd7d46a924493bd06fb67309ae9dc45fa466ddc8'],10,10,20,22067742,3,,,,22194
da7f00c4432d3299be8895243a867af7a5fcb57f,1,Jaimin Jetly,2016-03-22 10:49:20-07:00,['6b933cc9ec3f82a8513d5dadffa92ab989743550'],350,1864,2214,22069956,30,0.722857143,0.831428571,0.874285714,22200
5daf835191c49e17d9a63f6a6a014adb563a99d5,1,Siddharth Wagle,2016-03-22 11:31:35-07:00,['da7f00c4432d3299be8895243a867af7a5fcb57f'],1,3,4,22069960,1,0,0,0,22200
b95ab2f7cb9c154c8aeb27e99964309b52f9e136,0,Alex Antonenko,2016-03-22 20:40:27+02:00,['5daf835191c49e17d9a63f6a6a014adb563a99d5'],6,1,7,22069967,1,0,0,0,22200
340f7ce6b6d9d46b4f04f7e40892700288b26c9a,1,Nahappan Somasundaram,2016-03-22 12:00:27-07:00,['b95ab2f7cb9c154c8aeb27e99964309b52f9e136'],109,846,955,22070922,19,0.503225806,1,0.870967742,22202
1563708204eac4ec24ea43aa9d260d341bec97d1,0,Jaimin Jetly,2016-03-22 13:07:26-07:00,['340f7ce6b6d9d46b4f04f7e40892700288b26c9a'],3,282,285,22071207,1,,,,22202
0f8c24956b700949aa79943bb841c238a74e2f0b,1,Aravindan Vijayan,2016-03-22 13:07:56-07:00,['1563708204eac4ec24ea43aa9d260d341bec97d1'],16,361,377,22071584,11,0.172619048,0.589285714,0.642857143,22205
127dcf94b3e02ca17c2e2b5fe4bbc13689e7a772,1,Richard Zang,2016-03-22 14:25:42-07:00,['0f8c24956b700949aa79943bb841c238a74e2f0b'],2,19,21,22071605,5,0.75,0.875,0.875,22205
cb98bcb918a7a3b1249dc6d8281ef76aca31c881,0,Richard Zang,2016-03-22 17:11:30-07:00,['127dcf94b3e02ca17c2e2b5fe4bbc13689e7a772'],9,50,59,22071664,3,1,1,1,22205
215a61df16d93b781e0cfa5c424d847e2c735efb,1,Jayush Luniya,2016-03-22 23:38:17-07:00,['cb98bcb918a7a3b1249dc6d8281ef76aca31c881'],18,140,158,22071822,10,0,0,1,22207
3ae91d255e717055dcc66ed514de2eec67f71f94,0,Oleg Nechiporenko,2016-03-23 09:53:02+02:00,['215a61df16d93b781e0cfa5c424d847e2c735efb'],379,207,586,22072408,15,0.361111111,0.416666667,0,22207
7e1815db51adc60b2944b7cf17cf99ac293af84c,1,ababiichuk,2016-03-23 13:29:58+02:00,['3ae91d255e717055dcc66ed514de2eec67f71f94'],141,22,163,22072571,3,0.103448276,0,0,22207
2a5f4f810326efe1eb250eda067914b6952c5828,1,Andrew Onishuk,2016-03-23 18:10:19+02:00,['7e1815db51adc60b2944b7cf17cf99ac293af84c'],158,114,272,22072843,6,1,1,0,22208
e45d869e7434dba29bf55a06a54707f267b1f8f6,0,Andrew Onishuk,2016-03-23 18:16:56+02:00,['2a5f4f810326efe1eb250eda067914b6952c5828'],1,5,6,22072849,2,1,0,0,22208
1744996ce5faeeb9dd5913b161a35eff430a796d,0,Aravindan Vijayan,2016-03-23 10:06:54-07:00,['e45d869e7434dba29bf55a06a54707f267b1f8f6'],2,4,6,22072855,2,0,0.5,1,22208
7213fda8d2e7de435592b6180d7d13282500ffa6,1,Lisnichenko Dmitro,2016-03-23 19:11:55+02:00,['1744996ce5faeeb9dd5913b161a35eff430a796d'],1,1,2,22072857,1,,,,22208
360a09ef95522182cb0c6e700c307611e9aadb7a,0,Bhuvnesh Chaudhary,2016-03-23 10:17:12-07:00,['7213fda8d2e7de435592b6180d7d13282500ffa6'],29,19,48,22072905,1,,,,22208
13d487b778dbc8500ff206c2ac9adac78c71d044,0,Richard Zang,2016-03-23 10:29:52-07:00,['360a09ef95522182cb0c6e700c307611e9aadb7a'],1,1,2,22072907,1,,,,22208
f90d0beaeb3e22da5245710b1cdfc49bf24f08c9,0,Jonathan Hurley,2016-03-23 13:44:35-04:00,['13d487b778dbc8500ff206c2ac9adac78c71d044'],4,24,28,22072935,1,1,1,1,22208
2d7dffce52dff12a9409487508c230abb4a96d6b,1,Aravindan Vijayan,2016-03-23 13:45:43-07:00,['f90d0beaeb3e22da5245710b1cdfc49bf24f08c9'],7,5,12,22072947,1,1,1,1,22208
476d87b70b42a58914c69c3ce8098531d9405e48,1,Robert Levas,2016-03-23 17:55:16-04:00,['2d7dffce52dff12a9409487508c230abb4a96d6b'],43,1555,1598,22074545,37,0.163513514,0.351351351,0.828378378,22210
1fbf7f15d9d25ef592bca07fd11d7b63b3b48b0f,1,Jaimin Jetly,2016-03-23 15:42:55-07:00,['476d87b70b42a58914c69c3ce8098531d9405e48'],13,57,70,22074615,1,1,1,1,22210
c5c5da75af617637ea91a29528ac9cc8f6113ab1,1,tbeerbower,2016-03-23 18:49:17-04:00,['1fbf7f15d9d25ef592bca07fd11d7b63b3b48b0f'],20,20,40,22074655,5,,,,22210
18dc714dbfbb655c8fcf2eba8585054561bd2bd5,1,Richard Zang,2016-03-23 17:24:37-07:00,['c5c5da75af617637ea91a29528ac9cc8f6113ab1'],3,10,13,22074668,1,,,,22210
7242a8e51310147793bac8ff5f1af125482ed734,1,Bhuvnesh Chaudhary,2016-03-23 20:54:08-07:00,['18dc714dbfbb655c8fcf2eba8585054561bd2bd5'],261,74,335,22075003,8,0.634615385,0,1,22210
751e69209bbe4857c51997e076417afeaae73883,1,ababiichuk,2016-03-24 11:50:07+02:00,['7242a8e51310147793bac8ff5f1af125482ed734'],5,24,29,22075032,4,1,1,1,22210
bd7b8693c9a2453066af6e42a65df4e8449f7286,0,Andrew Onishuk,2016-03-24 15:57:08+02:00,['751e69209bbe4857c51997e076417afeaae73883'],2,2,4,22075036,1,,,,22210
c4791973dc5df4b6448776af3bfd08ea7a6cf940,1,Lisnichenko Dmitro,2016-03-24 16:15:49+02:00,['bd7b8693c9a2453066af6e42a65df4e8449f7286'],1,74,75,22075111,2,0.262295082,1,1,22210
22c3dcd5b366c0390d9d50d4273e28b4e3f2daa9,1,Andrew Onishuk,2016-03-24 17:14:29+02:00,['c4791973dc5df4b6448776af3bfd08ea7a6cf940'],43,35,78,22075189,6,0.333333333,0,1,22210
8f24e155112b1f35c6163cb368cc706127c086d3,1,Dmytro Sen,2016-03-24 17:19:13+02:00,['22c3dcd5b366c0390d9d50d4273e28b4e3f2daa9'],1,14,15,22075204,2,0,0,1,22210
fe7f1462bce61a7459f1c6498e588af6315eb9cf,0,oleewere,2016-03-24 17:13:24+01:00,['8f24e155112b1f35c6163cb368cc706127c086d3'],5,62,67,22075271,2,0,0.394736842,1,22210
17697bb3716332286781d3dcd758b7a6d91e80b3,1,Myroslav Papirkovskyi,2016-03-24 18:58:26+02:00,['fe7f1462bce61a7459f1c6498e588af6315eb9cf'],21,26,47,22075318,2,,,,22210
c4bcceace372f0f6407d0261541ad1728a7c90f5,0,Bhuvnesh Chaudhary,2016-03-24 10:25:42-07:00,['17697bb3716332286781d3dcd758b7a6d91e80b3'],5,4,9,22075327,1,0,0,0,22210
a4c9dc3dd054dff76f9f306f55b060a2527efdd4,0,Robert Levas,2016-03-24 13:42:28-04:00,['c4bcceace372f0f6407d0261541ad1728a7c90f5'],1,62,63,22075390,2,0.151515152,1,0.848484848,22210
769c39cee604304ee566fe272ff3fe3df061aa78,1,Sandor Magyari,2016-03-24 18:52:30+01:00,['a4c9dc3dd054dff76f9f306f55b060a2527efdd4'],0,16,16,22075406,1,0,0,1,22210
7afb17719bb4178d651c595e71179d6a95840a05,1,Jayush Luniya,2016-03-24 11:13:29-07:00,['769c39cee604304ee566fe272ff3fe3df061aa78'],63,142,205,22075611,11,1,1,1,22210
dbbce96b130dd83b4ec6e9f328fda01076cc784a,0,Nahappan Somasundaram,2016-03-24 11:18:21-07:00,['7afb17719bb4178d651c595e71179d6a95840a05'],3,59,62,22075673,2,0.16,0.2,0.88,22210
c98c7eb70d1b1e58410090e4be1c2e7826cbc32d,0,Andrew Onishuk,2016-03-24 20:30:25+02:00,['dbbce96b130dd83b4ec6e9f328fda01076cc784a'],1,1,2,22075675,1,,,,22210
161dcefb31572f5007ebd468db519bd91e962bf4,1,Yusaku Sako,2016-03-24 11:35:18-07:00,['c98c7eb70d1b1e58410090e4be1c2e7826cbc32d'],25,53,78,22075753,1,0.807692308,0.807692308,1,22210
eb7e8b2dda9f386351e67ed00f530676c533df74,0,Richard Zang,2016-03-24 11:41:14-07:00,['161dcefb31572f5007ebd468db519bd91e962bf4'],1,1,2,22075755,1,,,,22210
706bc29c3dce7fe79738f31c1272b85481c18de3,1,Jayush Luniya,2016-03-24 12:03:37-07:00,['eb7e8b2dda9f386351e67ed00f530676c533df74'],13,21,34,22075789,4,1,1,1,22210
126c226d814dabc103255996be20d7b0a0f6e955,0,Bhuvnesh Chaudhary,2016-03-24 12:19:27-07:00,['706bc29c3dce7fe79738f31c1272b85481c18de3'],2,3,5,22075794,1,1,1,1,22210
e308b8a966aad651c8ba1fcd5e63181400538460,1,Myroslav Papirkovskyi,2016-03-24 21:33:17+02:00,['126c226d814dabc103255996be20d7b0a0f6e955'],3,23,26,22075820,1,0,1,1,22210
9752f7e772398bf0c7eb86b63984a8f5b2b2f9b7,1,Robert Levas,2016-03-24 16:11:06-04:00,['e308b8a966aad651c8ba1fcd5e63181400538460'],4,92,96,22075916,2,0,1,1,22210
72ac920cd1632bcd3a92e55d1fb9830f0d3d2540,1,Richard Zang,2016-03-24 13:26:13-07:00,['9752f7e772398bf0c7eb86b63984a8f5b2b2f9b7'],6,150,156,22076072,5,0.846153846,1,1,22210
6be61dbaa8886aa4a0c83d7e484b705c4cde24aa,0,Yusaku Sako,2016-03-24 14:13:25-07:00,['72ac920cd1632bcd3a92e55d1fb9830f0d3d2540'],405,403,808,22076880,15,,,,22210
05c22041596606316dd7bc719fe93b8d9d286612,1,Jayush Luniya,2016-03-24 15:43:46-07:00,['6be61dbaa8886aa4a0c83d7e484b705c4cde24aa'],40,82,122,22077002,16,1,1,1,22210
4a64727fb55e2462fece58511d63d732970de07d,1,Jayush Luniya,2016-03-24 15:45:30-07:00,['05c22041596606316dd7bc719fe93b8d9d286612'],6,6,12,22077014,2,,,,22210
7cbf3f4b44beaca76d95035567ca38b23a92a741,1,Jayush Luniya,2016-03-24 16:10:36-07:00,['4a64727fb55e2462fece58511d63d732970de07d'],20,67,87,22077101,7,0.333333333,0.333333333,1,22210
1ee8e88a028d6b1e14f3377ed5a6f0a5f60da9cb,1,Aravindan Vijayan,2016-03-24 16:12:27-07:00,['7cbf3f4b44beaca76d95035567ca38b23a92a741'],1,5,6,22077107,2,,,,22210
97446d3ab14d3f2fbcdbaf7c187cd28074c52b0d,1,Sumit Mohanty,2016-03-24 16:59:55-07:00,['1ee8e88a028d6b1e14f3377ed5a6f0a5f60da9cb'],13,201,214,22077321,10,,,,22210
67ebe852f41c266851a5f31ba21c28d8cb4600dd,0,Siddharth Wagle,2016-03-24 17:58:25-07:00,['97446d3ab14d3f2fbcdbaf7c187cd28074c52b0d'],0,8,8,22077329,1,,,,22210
838fbeb8c7c214c17381ac7bc2804838dff26216,1,Robert Levas,2016-03-24 21:09:12-04:00,['67ebe852f41c266851a5f31ba21c28d8cb4600dd'],62,1,63,22077392,2,0.848484848,0,0.151515152,22210
f3cab462ff78081dd65d87ef873b278f6261319c,1,Robert Levas,2016-03-24 21:11:37-04:00,['838fbeb8c7c214c17381ac7bc2804838dff26216'],1,62,63,22077455,2,0.151515152,1,0.848484848,22210
303f28037407e81a7b800a492d53dd0388bfb646,0,Robert Levas,2016-03-24 21:17:52-04:00,['f3cab462ff78081dd65d87ef873b278f6261319c'],2,2,4,22077459,2,,,,22210
99ffb6eb55847652f4feddaedd18accf2c45f761,1,"Toader, Sebastian",2016-03-25 09:51:35+01:00,['303f28037407e81a7b800a492d53dd0388bfb646'],2,48,50,22077509,2,0,0.818181818,1,22210
efd734739281b37213b8b0cc929882c2ffbb4686,0,Alex Antonenko,2016-03-25 11:32:09+02:00,['99ffb6eb55847652f4feddaedd18accf2c45f761'],0,1,1,22077510,1,1,1,1,22210
7d6c99de2ad00ee8fa4750172c6fcfe1407ec9d4,1,Oleg Nechiporenko,2016-03-25 12:00:18+02:00,['efd734739281b37213b8b0cc929882c2ffbb4686'],17,18,35,22077545,4,,,,22210
a9598ce46656086278be67447ca0654acba8bd4e,1,Vitaly Brodetskyi,2016-03-25 12:19:55+02:00,['7d6c99de2ad00ee8fa4750172c6fcfe1407ec9d4'],32,93,125,22077670,3,0.340425532,1,1,22210
15e58e419ce7086b21b4e9fec82c111f0d61b1ad,1,ababiichuk,2016-03-25 12:50:06+02:00,['a9598ce46656086278be67447ca0654acba8bd4e'],4,11,15,22077685,2,1,1,1,22210
c0a4d5eef5eeeb76b672f59cbb4ab871fb695f80,0,Dmytro Sen,2016-03-25 13:35:54+02:00,['15e58e419ce7086b21b4e9fec82c111f0d61b1ad'],6,5,11,22077696,1,1,1,0,22210
93624db6d7740b8d877af77978328bc7243be42b,1,Andrew Onishuk,2016-03-25 13:54:08+02:00,['c0a4d5eef5eeeb76b672f59cbb4ab871fb695f80'],1,1,2,22077698,1,,,,22210
2910f9f57e210985296819b71f67a1ea3c1f584f,1,Andrii Tkach,2016-03-25 15:50:29+02:00,['93624db6d7740b8d877af77978328bc7243be42b'],45,958,1003,22078701,16,0.943012212,1,0.995929444,22215
24b307588c7df391cee9f8a83d3155e807b58f8c,0,Alex Antonenko,2016-03-25 17:56:37+02:00,['2910f9f57e210985296819b71f67a1ea3c1f584f'],1,0,1,22078702,1,,,,22215
f151a43b4efaf1225b163d553897cb0e8dc02bab,0,Alex Antonenko,2016-03-25 17:57:58+02:00,['24b307588c7df391cee9f8a83d3155e807b58f8c'],1,1,2,22078704,1,,,,22215
eec5fc3092ac2900d2adde505ed983db72b378f0,0,Nahappan Somasundaram,2016-03-25 10:55:44-07:00,['f151a43b4efaf1225b163d553897cb0e8dc02bab'],15,70,85,22078789,2,0,0.714285714,1,22215
09c44cbc9b701e3cd23c341b7046d3edabe4577a,0,Bhuvnesh Chaudhary,2016-03-25 12:21:06-07:00,['eec5fc3092ac2900d2adde505ed983db72b378f0'],5,75,80,22078869,2,0,0.571428571,0.732142857,22215
e8656628efd2d624bd078973347834504e33e854,1,Bhuvnesh Chaudhary,2016-03-25 14:00:28-07:00,['09c44cbc9b701e3cd23c341b7046d3edabe4577a'],0,11,11,22078880,2,0,1,1,22215
5cdfce3c4dbda40d8caaa51cfb92f7d015cc4288,1,Matt,2016-03-27 15:08:11-07:00,['e8656628efd2d624bd078973347834504e33e854'],98,314,412,22079292,4,0,0,0.961722488,22215
12b59857e547a6af4e0e075829d597b7b5ef1257,1,Andrii Tkach,2016-03-28 11:46:15+03:00,['5cdfce3c4dbda40d8caaa51cfb92f7d015cc4288'],58,68,126,22079418,3,,,0,22215
aa033d0c152acdc8d1f7640ccd60f77b9710ed80,1,Alex Antonenko,2016-03-28 11:49:57+03:00,['12b59857e547a6af4e0e075829d597b7b5ef1257'],3,132,135,22079553,4,0,0,0.901785714,22215
d5d1afea8be684fed1e712f7a80b5e06f4d79ba5,1,Alex Antonenko,2016-03-28 11:53:29+03:00,['aa033d0c152acdc8d1f7640ccd60f77b9710ed80'],21,6646,6667,22086220,15,0.396105497,1,1,22224
c9f4bcc6c3ddd4729941132bdb7b2af1e94bd7a0,1,Vitaly Brodetskyi,2016-03-28 12:49:17+03:00,['d5d1afea8be684fed1e712f7a80b5e06f4d79ba5'],1,2,3,22086223,2,,,,22224
d0672c2ba8d1f8a15ae58c6af62f62f7edc47466,0,Lisnichenko Dmitro,2016-03-28 13:32:00+03:00,['c9f4bcc6c3ddd4729941132bdb7b2af1e94bd7a0'],15,17,32,22086255,1,0,0,0,22224
71b4c624fb219bb1626c238322bda6c2e5589f72,1,"Toader, Sebastian",2016-03-28 13:04:17+02:00,['d0672c2ba8d1f8a15ae58c6af62f62f7edc47466'],41,1816,1857,22088112,29,0.780487805,0.947735192,0.961672474,22234
4f3983b11d4b52a62b8022542be6fbb319236516,0,ababiichuk,2016-03-28 14:27:02+03:00,['71b4c624fb219bb1626c238322bda6c2e5589f72'],3,3,6,22088118,1,,,,22234
3b6bea5c92939475bbdec5545bfd41a92b500b38,1,Oleg Nechiporenko,2016-03-28 16:15:14+03:00,['4f3983b11d4b52a62b8022542be6fbb319236516'],193,243,436,22088554,17,0,0,0,22235
c8d6c9f5467a02a611fd9fb192fa9a08cb43938b,1,Nate Cole,2016-03-28 10:26:09-04:00,['3b6bea5c92939475bbdec5545bfd41a92b500b38'],216,469,685,22089239,16,0.071428571,0.528571429,0.971428571,22235
c4b16eefb5685a02a2dc3626109ea28a4dc45314,0,Alex Antonenko,2016-03-28 22:35:23+03:00,['c8d6c9f5467a02a611fd9fb192fa9a08cb43938b'],1,14,15,22089254,2,0.909090909,1,1,22235
466467617bf49498c37fd9ba6df3772e8cee3afc,1,Dipayan Bhowmick,2016-03-29 00:59:20+05:18,['c4b16eefb5685a02a2dc3626109ea28a4dc45314'],6,6,12,22089266,4,1,1,1,22235
d4ab6fdf8c38ec2113f8ccef079dc4e4627ad9a7,1,Sumit Mohanty,2016-03-28 12:55:36-07:00,['466467617bf49498c37fd9ba6df3772e8cee3afc'],1909,533,2442,22091708,11,0.195266272,0.532544379,0.692307692,22238
5785e2bca501f8ddc3c6ef4049832ec0fed87c00,1,Di Li,2016-03-28 16:05:40-04:00,['d4ab6fdf8c38ec2113f8ccef079dc4e4627ad9a7'],19,19,38,22091746,9,,,,22238
5994e0ad02071713433202b159caf304ac47fe07,0,Aravindan Vijayan,2016-03-28 13:17:27-07:00,['5785e2bca501f8ddc3c6ef4049832ec0fed87c00'],5,5,10,22091756,1,0,0,0,22238
ea894ef80f7400c4e583673a1f75f66008975f7e,1,Sandor Magyari,2016-03-28 23:41:41+03:00,['5994e0ad02071713433202b159caf304ac47fe07'],5,52,57,22091813,3,0,0.972222222,0.027777778,22238
be444cc145edd6f58d5e43c28fbfef3bffb06e98,1,Aleksandr Kovalenko,2016-03-29 00:32:10+03:00,['ea894ef80f7400c4e583673a1f75f66008975f7e'],18,78,96,22091909,7,0.647058824,0.980392157,1,22238
54cbe9e7d1d0c057bb7c6dd099dda6ad9ef13c5b,1,Alejandro Fernandez,2016-03-28 16:12:02-07:00,['be444cc145edd6f58d5e43c28fbfef3bffb06e98'],26,111,137,22092046,6,0,0.49122807,0.649122807,22238
55df8f22d7b8edbe4cfd0eef154fde07ec8f2f80,0,Alejandro Fernandez,2016-03-28 16:22:02-07:00,['54cbe9e7d1d0c057bb7c6dd099dda6ad9ef13c5b'],8,1,9,22092055,2,0,0,0,22238
58bc44f3f4ad6621ed010f9b88348f7206abafd8,1,Vitaly Brodetskyi,2016-03-29 12:35:07+03:00,['55df8f22d7b8edbe4cfd0eef154fde07ec8f2f80'],6,20,26,22092081,6,,,,22238
172d02aa48710ea0625e99d37d9830acf82fb13d,1,Dmytro Sen,2016-03-29 15:26:59+03:00,['58bc44f3f4ad6621ed010f9b88348f7206abafd8'],345,503,848,22092929,9,0.318584071,0.433628319,0.469026549,22238
e09ae1c6eb466bdfe742137fa33012b315f1bad1,1,Jonathan Hurley,2016-03-29 08:39:32-04:00,['172d02aa48710ea0625e99d37d9830acf82fb13d'],5,179,184,22093113,11,0.326923077,0.673076923,0.961538462,22238
abca3050c1065293a9bcfb68402c8fc9089295b4,1,Andrew Onishuk,2016-03-29 15:39:54+03:00,['e09ae1c6eb466bdfe742137fa33012b315f1bad1'],64,126,190,22093303,34,0.454545455,0.454545455,0,22239
6d668d29525e722b9408bef29594125e0ebd8793,1,Bhuvnesh Chaudhary,2016-03-29 07:00:31-07:00,['abca3050c1065293a9bcfb68402c8fc9089295b4'],55,69,124,22093427,8,1,0,1,22239
d606234655c9afc043852a664ef147a7d447d3a8,0,Lisnichenko Dmitro,2016-03-29 19:11:04+03:00,['6d668d29525e722b9408bef29594125e0ebd8793'],1,2,3,22093430,1,,,,22239
a672d402810d255851c6a1d81bf04a348fd8815d,0,Pallav Kulshreshtha,2016-03-29 21:50:38+05:18,['d606234655c9afc043852a664ef147a7d447d3a8'],0,23,23,22093453,3,1,1,1,22239
0808f2cb5bac1862fd1d8aea37f9edfc195a40eb,1,Richard Zang,2016-03-29 11:36:12-07:00,['a672d402810d255851c6a1d81bf04a348fd8815d'],16,16,32,22093485,2,,,,22239
220c88c377d904044a118065c617477a21b3ac53,0,Alex Antonenko,2016-03-29 22:14:59+03:00,['0808f2cb5bac1862fd1d8aea37f9edfc195a40eb'],0,12,12,22093497,2,,,,22239
5738dd4cbfc2d887cc99e6624b7f02e6073a9b07,0,Jaimin Jetly,2016-03-29 14:41:22-07:00,['220c88c377d904044a118065c617477a21b3ac53'],23,0,23,22093520,3,0,0,0,22239
e23ed7bf334f0c9736dc78f5b1166200b1a07d28,1,Sumit Mohanty,2016-03-29 15:16:35-07:00,['5738dd4cbfc2d887cc99e6624b7f02e6073a9b07'],14,1,15,22093535,2,1,1,0,22239
5b4e663f820390f7bc006509eb517c3477b8f453,1,Jayush Luniya,2016-03-29 18:50:35-07:00,['e23ed7bf334f0c9736dc78f5b1166200b1a07d28'],44,81,125,22093660,16,1,1,1,22239
5c20a2488a69691b27544a41fb57fb8f05aae8ac,1,Jayush Luniya,2016-03-29 18:54:51-07:00,['5b4e663f820390f7bc006509eb517c3477b8f453'],8,27,35,22093695,6,1,1,1,22239
954a7072b0d3d82e5f818794b0a192a743b9c76a,1,Jayush Luniya,2016-03-29 19:02:06-07:00,['5c20a2488a69691b27544a41fb57fb8f05aae8ac'],29,58,87,22093782,11,1,1,1,22239
a189c91b027f4949f0100820b2f1c96d90b38fce,1,Jayush Luniya,2016-03-29 19:06:33-07:00,['954a7072b0d3d82e5f818794b0a192a743b9c76a'],14,21,35,22093817,3,1,1,1,22239
08ffdea380897db44737b87b449212136d453c1d,1,Jayush Luniya,2016-03-29 19:20:26-07:00,['a189c91b027f4949f0100820b2f1c96d90b38fce'],32,76,108,22093925,12,1,1,1,22239
ac35c6dd83fc61ff0ea35a454a78f9df54b57aec,1,Gautam Borad,2016-03-30 10:23:33+05:18,['08ffdea380897db44737b87b449212136d453c1d'],9,53,62,22093987,6,0,0,1,22239
13dfd3f195442bdc4dfe0783d27b9133cd7a7d20,1,Andrii Tkach,2016-03-30 12:11:40+03:00,['ac35c6dd83fc61ff0ea35a454a78f9df54b57aec'],43,248,291,22094278,13,0.406666667,0.98,1,22239
7bc68e1626c8ea82820cbea391a3026d8824c586,0,oleewere,2016-03-30 12:20:17+02:00,['13dfd3f195442bdc4dfe0783d27b9133cd7a7d20'],25,377,402,22094680,20,0.351851852,0.962962963,1,22240
dd0086cb9f77fcfc656a578fb54b5029ea0cfd1a,1,ababiichuk,2016-03-30 14:54:49+03:00,['7bc68e1626c8ea82820cbea391a3026d8824c586'],372,122,494,22095174,16,0.710526316,0.357894737,0.021052632,22240
93b068c87a38bac297dd2210122beeabf7645db2,0,Alex Antonenko,2016-03-30 15:12:21+03:00,['dd0086cb9f77fcfc656a578fb54b5029ea0cfd1a'],4,2,6,22095180,3,,,,22240
8e7a1db1b0add2fc29af668a70363baed86f0008,1,Vitaly Brodetskyi,2016-03-30 15:52:09+03:00,['93b068c87a38bac297dd2210122beeabf7645db2'],2,21,23,22095203,4,0.538461538,0.692307692,0.692307692,22240
70c4f709642829fdcf513a274ccd58b156bea901,1,Andrew Onishuk,2016-03-30 17:05:27+03:00,['8e7a1db1b0add2fc29af668a70363baed86f0008'],9,92,101,22095304,2,,,,22240
d627c66d69cb2a17025c4516f57bddd05e1c5dc7,0,Oleg Nechiporenko,2016-03-30 17:22:17+03:00,['70c4f709642829fdcf513a274ccd58b156bea901'],24,99,123,22095427,3,0.151898734,1,1,22240
9da28fec1c5ed3b1bfa21250ad9cfa141eb83201,1,Nate Cole,2016-03-30 11:17:14-04:00,['d627c66d69cb2a17025c4516f57bddd05e1c5dc7'],141,233,374,22095801,3,0.142857143,0.542857143,0,22241
deb45e81a3555de0430e65231e243919d1b9da32,0,Lisnichenko Dmitro,2016-03-30 19:34:19+03:00,['9da28fec1c5ed3b1bfa21250ad9cfa141eb83201'],47,21,68,22095869,2,0,0,0,22241
6c008c83d1fa069d9a4fe30c7b2928dbaad86242,1,Sandor Magyari,2016-03-30 19:14:30+02:00,['deb45e81a3555de0430e65231e243919d1b9da32'],119,809,928,22096797,20,0.087058824,0.287058824,0.112941176,22242
e35eaba8fbd6272aac51a825852132d6a27ac25d,0,Pallav Kulshreshtha,2016-03-30 22:38:07+05:18,['6c008c83d1fa069d9a4fe30c7b2928dbaad86242'],1,25,26,22096823,4,1,1,1,22242
63f8d74f806aa55fcbb4e51b2c84a3fd0146c062,1,Jayush Luniya,2016-03-30 10:33:20-07:00,['e35eaba8fbd6272aac51a825852132d6a27ac25d'],33,56,89,22096912,15,0.75,1,0.75,22242
28318b16ac9c7fcd472fd387bbc6534651ccc8b4,0,Richard Zang,2016-03-30 10:44:18-07:00,['63f8d74f806aa55fcbb4e51b2c84a3fd0146c062'],6,2,8,22096920,3,,,,22242
c479fdd968b085f9ba398117ad872587da0bb65a,1,Aravindan Vijayan,2016-03-30 11:06:17-07:00,['28318b16ac9c7fcd472fd387bbc6534651ccc8b4'],80,71,151,22097071,4,0,0,0,22242
dfa4454e7d69fb160924a3877d3f3f1a6314c7bd,1,Siddharth Wagle,2016-03-30 11:35:07-07:00,['c479fdd968b085f9ba398117ad872587da0bb65a'],146,1112,1258,22098329,29,0.472222222,0.722222222,0.416666667,22247
d41203d729d98506b390859df2e5d3100d97f7e5,1,Aleksandr Kovalenko,2016-03-30 21:49:28+03:00,['dfa4454e7d69fb160924a3877d3f3f1a6314c7bd'],45,72,117,22098446,7,0.666666667,0.666666667,1,22247
52be4cb739da546bcb89e23e57ad1f0836b495d2,0,Siddharth Wagle,2016-03-30 11:50:51-07:00,['d41203d729d98506b390859df2e5d3100d97f7e5'],12,12,24,22098470,1,,,,22247
b197a6f6eafdab70d0ab91fba3fda1a9bc33a372,0,Alex Antonenko,2016-03-30 22:01:01+03:00,['52be4cb739da546bcb89e23e57ad1f0836b495d2'],0,2,2,22098472,1,1,1,1,22247
46a34ccdeeeeabe0ad4172e94a63c9b077e17861,1,"Toader, Sebastian",2016-03-30 21:50:51+02:00,['b197a6f6eafdab70d0ab91fba3fda1a9bc33a372'],225,12582,12807,22111279,144,0.64805881,0.900987824,0.96393292,22352
ef30868be7e5c0300bf27f0a6a62d2277d5f68a6,1,Jonathan Hurley,2016-03-30 15:59:41-04:00,['46a34ccdeeeeabe0ad4172e94a63c9b077e17861'],82,300,382,22111661,6,0.108108108,0.774774775,1,22352
2ba00782081141a6fe7ab5451ceb1c9ca410e7b9,1,Jayush Luniya,2016-03-30 13:29:19-07:00,['ef30868be7e5c0300bf27f0a6a62d2277d5f68a6'],11,20,31,22111692,5,1,1,1,22352
bdc54e5ddfa77bca671527bc5ca7c69a61262fd3,0,Siddharth Wagle,2016-03-30 16:51:01-07:00,['2ba00782081141a6fe7ab5451ceb1c9ca410e7b9'],3,3,6,22111698,1,,,,22352
3e6e9932ca7d5ba240853bbe3c3d4ca6e44811ef,1,Dipayan Bhowmick,2016-03-31 10:49:44+05:18,['bdc54e5ddfa77bca671527bc5ca7c69a61262fd3'],0,10,10,22111708,1,,,,22352
f0be765a15ea17e386b5fbc6cc9bc4968d9bcd5a,1,Oleg Nechiporenko,2016-03-31 13:38:18+03:00,['3e6e9932ca7d5ba240853bbe3c3d4ca6e44811ef'],327,128,455,22112163,11,0.5,0.081521739,0.108695652,22352
a88f8cba3d2f825fb608e299d9467a6bf292423f,0,Andrew Onishuk,2016-03-31 14:48:51+03:00,['f0be765a15ea17e386b5fbc6cc9bc4968d9bcd5a'],1,1,2,22112165,1,,,,22352
1fb2aab41c35cbe85fbb9545505872199fef8822,1,Alex Antonenko,2016-03-31 17:34:55+03:00,['a88f8cba3d2f825fb608e299d9467a6bf292423f'],1,3,4,22112169,1,1,0,1,22352
7a909ade91da851d3b6910fe4f724f2dc23009c8,0,Jonathan Hurley,2016-03-31 10:47:21-04:00,['1fb2aab41c35cbe85fbb9545505872199fef8822'],9,4,13,22112182,1,0,0,0,22352
017fbf130f7a3ce880baa11bf6a783f3ca850d78,1,Andrew Onishuk,2016-03-31 18:45:27+03:00,['7a909ade91da851d3b6910fe4f724f2dc23009c8'],141,358,499,22112681,24,0,0,0.53164557,22353
8d91e710995d2b9444411c60882f84b6a46d8f26,0,Andrew Onishuk,2016-03-31 18:48:01+03:00,['017fbf130f7a3ce880baa11bf6a783f3ca850d78'],12,21,33,22112714,4,0,1,0.4,22353
6f61de093943a75868925cb7f76cbceea6215ae9,1,"Toader, Sebastian",2016-03-31 18:37:26+02:00,['8d91e710995d2b9444411c60882f84b6a46d8f26'],113,224,337,22113051,2,0,1,1,22353
a6f0fbfb48e27e0199ade5eb4d9cfdfb7d5807c5,1,oleewere,2016-03-31 19:10:58+02:00,['6f61de093943a75868925cb7f76cbceea6215ae9'],32,300,332,22113383,5,0.458064516,0.838709677,0.993548387,22353
1fbc106b88c04fe7da16491b4740b94b71130db1,0,Richard Zang,2016-03-31 11:20:55-07:00,['a6f0fbfb48e27e0199ade5eb4d9cfdfb7d5807c5'],3,3,6,22113389,2,,,,22353
354b0a9756f24d2dcbbaa7c4867e95cfd4c03471,1,Zhe (Joe) Wang,2016-03-31 11:36:15-07:00,['1fbc106b88c04fe7da16491b4740b94b71130db1'],2,12,14,22113403,3,0,1,0.666666667,22353
7d70695a0d80189ef7f72184d1908997afa694b4,1,Nahappan Somasundaram,2016-03-31 11:48:57-07:00,['354b0a9756f24d2dcbbaa7c4867e95cfd4c03471'],25,968,993,22114396,23,0.418300654,0.823529412,0.980392157,22359
2410929485dc8d8b3baac28528d8762322d748a4,1,Di Li,2016-03-31 14:54:40-04:00,['7d70695a0d80189ef7f72184d1908997afa694b4'],37,329,366,22114762,21,0.566878981,0.923566879,0.98089172,22360
449be0f5c8c3a06b2f414d53e91136f66c0f1743,1,Jonathan Hurley,2016-03-31 15:18:53-04:00,['2410929485dc8d8b3baac28528d8762322d748a4'],59,148,207,22114969,5,0.340909091,0.931818182,1,22360
2b122b3b70c115d60f9c042e625c0b6e4422fbc3,1,Andrew Onishuk,2016-03-31 23:07:39+03:00,['449be0f5c8c3a06b2f414d53e91136f66c0f1743'],12,52,64,22115033,2,0,1,1,22360
e630228cd703509fe0177640346280c61c27f4f5,1,Jayush Luniya,2016-03-31 13:35:18-07:00,['2b122b3b70c115d60f9c042e625c0b6e4422fbc3'],12,35,47,22115080,7,1,1,1,22360
0c4b2954963b5975557de664e7f3d08dde3f29f3,1,Jayush Luniya,2016-03-31 13:37:09-07:00,['e630228cd703509fe0177640346280c61c27f4f5'],10,21,31,22115111,3,1,1,1,22360
490fa51f104ce4a87469069fc72033ace08d537f,0,Jaimin Jetly,2016-03-31 13:39:34-07:00,['0c4b2954963b5975557de664e7f3d08dde3f29f3'],0,8,8,22115119,1,,,,22360
4ecd3c7620edcfa1ced4a25abd022c21f42960af,1,Jayush Luniya,2016-03-31 13:55:46-07:00,['490fa51f104ce4a87469069fc72033ace08d537f'],18,31,49,22115168,4,1,1,1,22360
1d6ca13aec42e864235d9b5fa3047cbc1e9c0f7c,1,Jayush Luniya,2016-03-31 13:57:06-07:00,['4ecd3c7620edcfa1ced4a25abd022c21f42960af'],33,68,101,22115269,8,0,0.5,1,22360
d812b17048afbb418e87dc46212b2b165456472c,1,Jayush Luniya,2016-03-31 14:03:27-07:00,['1d6ca13aec42e864235d9b5fa3047cbc1e9c0f7c'],8,31,39,22115308,6,1,1,1,22360
b0d6a57819cfac1d950f1ce7bbde4ef739c90ca8,0,Richard Zang,2016-03-31 15:38:18-07:00,['d812b17048afbb418e87dc46212b2b165456472c'],1,1,2,22115310,1,,,,22360
6fe7f83277a269dc6d9634b186ff3fc05fca8505,1,Alejandro Fernandez,2016-03-31 17:23:08-07:00,['b0d6a57819cfac1d950f1ce7bbde4ef739c90ca8'],31,256,287,22115597,12,0.301724138,0.474137931,0.905172414,22360
9404dee98b626e9066977459955b4737a530a644,1,Jayush Luniya,2016-03-31 23:44:34-07:00,['6fe7f83277a269dc6d9634b186ff3fc05fca8505'],11,720,731,22116328,10,0.319004525,0.34841629,0.658371041,22361
b019e1dcf22b1c79c8fef0f63979b7289f0c66ce,1,Alex Antonenko,2016-04-01 10:39:16+03:00,['9404dee98b626e9066977459955b4737a530a644'],8,7,15,22116343,7,1,1,1,22361
0ada5769a54e687d54bbedd3011f456c6de4559e,0,"Toader, Sebastian",2016-04-01 10:17:16+02:00,['b019e1dcf22b1c79c8fef0f63979b7289f0c66ce'],4,5,9,22116352,2,,,,22361
0312e29ffe564ce56a5f82574a8a3ba9a7ba7d39,1,Vitaly Brodetskyi,2016-04-01 11:23:57+03:00,['0ada5769a54e687d54bbedd3011f456c6de4559e'],0,5,5,22116357,1,0,1,1,22361
df665c529d97a240557849e21c16c1796397f643,1,Lisnichenko Dmitro,2016-04-01 12:14:28+03:00,['0312e29ffe564ce56a5f82574a8a3ba9a7ba7d39'],46,229,275,22116632,6,0.260869565,0,0.836956522,22361
a6d89bede6f3640fdca80959a70e14bc26eeff9a,1,Oleg Nechiporenko,2016-04-01 12:42:09+03:00,['df665c529d97a240557849e21c16c1796397f643'],0,14,14,22116646,3,,,,22361
dc4186f50cd1cbe1186014be13a815768061922f,1,Gautam Borad,2016-04-01 18:38:55+05:18,['a6d89bede6f3640fdca80959a70e14bc26eeff9a'],191,132,323,22116969,22,1,0.85,1,22361
6b8b7436631b7e32b95676c80b5fb5afe683d70a,1,Jonathan Hurley,2016-04-01 09:41:12-04:00,['dc4186f50cd1cbe1186014be13a815768061922f'],5,177,182,22117151,13,0.175,0.775,0.8875,22361
f88f9f3567c44ffa405209a0b26020f06e167cf2,1,Vitaly Brodetskyi,2016-04-01 17:38:22+03:00,['6b8b7436631b7e32b95676c80b5fb5afe683d70a'],55,70,125,22117276,4,0,1,0.307692308,22361
67cd9d9ee17f59adcec358c90bad515b2590d7d1,1,Myroslav Papirkovskyi,2016-04-01 18:12:55+03:00,['f88f9f3567c44ffa405209a0b26020f06e167cf2'],10,178,188,22117464,2,0.03649635,0.058394161,0.96350365,22361
a8a72355798ed42e5705bfe83efb438dabd07292,0,Aleksandr Kovalenko,2016-04-01 19:26:58+03:00,['67cd9d9ee17f59adcec358c90bad515b2590d7d1'],16,24,40,22117504,4,,,,22361
12d19c9f82f66c2db19b72199d29a6691ae398a8,1,Alejandro Fernandez,2016-04-01 11:32:12-07:00,['a8a72355798ed42e5705bfe83efb438dabd07292'],1,2,3,22117507,1,,,,22361
69c636eb20427de5f203c97021077b659bd41081,1,Nate Cole,2016-04-01 14:47:20-04:00,['12d19c9f82f66c2db19b72199d29a6691ae398a8'],170,765,935,22118442,21,0.155063291,0.240506329,0.981012658,22362
31cbdd24bce314da75b43ed0b2fb7d2323fb15b6,1,Aravindan Vijayan,2016-04-01 12:42:47-07:00,['69c636eb20427de5f203c97021077b659bd41081'],10,15,25,22118467,4,0,0,1,22362
d312e310db3ec41044c3157b8c1a29e605fe3244,1,Jayush Luniya,2016-04-01 15:12:00-07:00,['31cbdd24bce314da75b43ed0b2fb7d2323fb15b6'],227,46,273,22118740,6,0.739130435,1,0.163043478,22362
836647a36966b1b534e1419b30d4b31858773478,1,"Toader, Sebastian",2016-04-02 11:29:37+02:00,['d312e310db3ec41044c3157b8c1a29e605fe3244'],121,9,130,22118870,26,0.791044776,0.134328358,0,22362
62f1982b79c8b848c1c7ce1b9ae3e0730a3a4496,1,Gautam Borad,2016-04-04 09:57:09+05:18,['836647a36966b1b534e1419b30d4b31858773478'],1,35,36,22118906,3,0.043478261,1,0.956521739,22362
79175d03373486b9d50dac745f7d1c8e31e1980f,1,oleewere,2016-04-04 11:10:33+02:00,['62f1982b79c8b848c1c7ce1b9ae3e0730a3a4496'],263,429,692,22119598,10,0,0.44375,0,22362
b09dfe4a2b313f5defb5641ddca40922cbf05dda,0,Vitaly Brodetskyi,2016-04-04 14:50:32+03:00,['79175d03373486b9d50dac745f7d1c8e31e1980f'],8,8,16,22119614,3,,,,22362
8eb03cd5734f28af5d194fa4883f72e9e82315bf,1,Andrew Onishuk,2016-04-04 15:21:56+03:00,['b09dfe4a2b313f5defb5641ddca40922cbf05dda'],84,116,200,22119814,6,1,1,1,22362
1b06cd40c6ed34a02e94355c2cf35367c5caa9f1,0,Oleg Nechiporenko,2016-04-04 15:53:55+03:00,['8eb03cd5734f28af5d194fa4883f72e9e82315bf'],35,5,40,22119854,2,0,0,0,22362
fce74508c7e235314f723fe98e3ebbb67458794a,1,Andrew Onishuk,2016-04-04 16:10:40+03:00,['1b06cd40c6ed34a02e94355c2cf35367c5caa9f1'],3,4,7,22119861,1,,,,22362
0b2bc6f58538eb9f6458e95e3bfe8fc563e0adaa,1,Vitaly Brodetskyi,2016-04-04 16:17:33+03:00,['fce74508c7e235314f723fe98e3ebbb67458794a'],4,155,159,22120020,2,,,,22363
3e8abab8ff258fe11e8423e149816ac038c342ac,0,Andrew Onishuk,2016-04-04 18:51:14+03:00,['0b2bc6f58538eb9f6458e95e3bfe8fc563e0adaa'],3,2,5,22120025,1,,,,22363
b4fc32596ba228a8da6dc914a078513a9c277a03,0,Aravindan Vijayan,2016-04-04 09:57:34-07:00,['3e8abab8ff258fe11e8423e149816ac038c342ac'],0,6,6,22120031,1,0,0,0,22363
b60e3056198b0022a81f75c4bac1b4a363a403c3,0,Andrew Onishuk,2016-04-04 19:58:00+03:00,['b4fc32596ba228a8da6dc914a078513a9c277a03'],81,90,171,22120202,5,,,,22363
a8dd52b19aa440d8804d16e73bf445a2851d4674,1,Jayush Luniya,2016-04-04 10:28:33-07:00,['b60e3056198b0022a81f75c4bac1b4a363a403c3'],60,132,192,22120394,10,1,1,1,22363
58f4e5b809ce9b58c61918bfc367d5e1dea98398,1,Richard Zang,2016-04-04 11:22:53-07:00,['a8dd52b19aa440d8804d16e73bf445a2851d4674'],4,7,11,22120405,1,0.25,0.25,0.25,22363
43c67bc463d96e1c4a1a5aa30e196ea444c8d5cd,1,Yusaku Sako,2016-04-04 12:17:19-07:00,['58f4e5b809ce9b58c61918bfc367d5e1dea98398'],109,126,235,22120640,13,,,,22363
fa6550c4ef38f9c15e7a341c02bdac046e0e28d4,0,Alejandro Fernandez,2016-04-04 12:18:29-07:00,['43c67bc463d96e1c4a1a5aa30e196ea444c8d5cd'],17,5,22,22120662,1,1,1,0,22363
27d06a1bd459e3f3654dbdc030c96bb9c9b32aea,0,Yusaku Sako,2016-04-04 12:25:42-07:00,['fa6550c4ef38f9c15e7a341c02bdac046e0e28d4'],2,2,4,22120666,1,,,,22363
18449b5b804790c15f0917ccb43b9a8be4bd5ca1,1,Jonathan Hurley,2016-04-04 15:49:42-04:00,['27d06a1bd459e3f3654dbdc030c96bb9c9b32aea'],159,696,855,22121521,21,0.065637066,0.768339768,0.945945946,22364
825d557ae63e5bb6a7d22e0132c96dc599d12ad0,1,Myroslav Papirkovskyi,2016-04-04 22:58:17+03:00,['18449b5b804790c15f0917ccb43b9a8be4bd5ca1'],41,47,88,22121609,2,0.666666667,0.166666667,0.333333333,22364
62e406a6143ef83991478c8518c688b2b31f0367,1,Jayush Luniya,2016-04-04 13:46:06-07:00,['825d557ae63e5bb6a7d22e0132c96dc599d12ad0'],86,82,168,22121777,16,0,1,0,22364
492954e42e631604fc02c7086d6036568b2a7fd7,0,Jayush Luniya,2016-04-04 13:48:34-07:00,['62e406a6143ef83991478c8518c688b2b31f0367'],43,33,76,22121853,2,1,1,0.125,22364
0300a6aee863274fc5fcb67a04d24bda78dc3847,1,Jayush Luniya,2016-04-04 15:05:26-07:00,['492954e42e631604fc02c7086d6036568b2a7fd7'],33,43,76,22121929,2,0,0,0.875,22364
891addc7d134cc1edf710b2b524764f3c867726c,0,Alex Antonenko,2016-04-05 01:21:54+03:00,['0300a6aee863274fc5fcb67a04d24bda78dc3847'],18,97,115,22122044,2,0.455357143,1,1,22364
af19b7d0f16f850eef1a8164ea9670402f33049d,1,Alex Antonenko,2016-04-05 01:21:54+03:00,['891addc7d134cc1edf710b2b524764f3c867726c'],5,6,11,22122055,3,,,,22364
780cd60957219aea422fd454bf26ad26f0faa6e2,1,Zhe (Joe) Wang,2016-04-04 15:23:08-07:00,['af19b7d0f16f850eef1a8164ea9670402f33049d'],3,110,113,22122168,4,0.68,1,1,22364
60b54592d39598808da9934a4619904c140d5a0d,1,Jayush Luniya,2016-04-04 15:25:31-07:00,['780cd60957219aea422fd454bf26ad26f0faa6e2'],44,34,78,22122246,2,1,1,0.125,22364
e195171f39bb455d3536c35c90bf145b9a16d0f6,1,Jayush Luniya,2016-04-04 18:03:23-07:00,['60b54592d39598808da9934a4619904c140d5a0d'],19,343,362,22122608,10,,,,22367
bf04d16b103e89a2d6a0d4538b47a99d3d75a772,0,Gautam Borad,2016-04-05 09:09:04+05:18,['e195171f39bb455d3536c35c90bf145b9a16d0f6'],11,907,918,22123526,18,0.303225806,0.303225806,0.709677419,22371
074fe227b7fb53c5d565278c83411d02cd7f1e1b,1,Vitaly Brodetskyi,2016-04-05 12:46:19+03:00,['bf04d16b103e89a2d6a0d4538b47a99d3d75a772'],3,19,22,22123548,1,1,1,1,22371
b6e4894123f22f5397508f190155e2d405d07ed0,1,Pallav Kulshreshtha,2016-04-05 16:12:01+05:18,['074fe227b7fb53c5d565278c83411d02cd7f1e1b'],18,111,129,22123677,9,,,,22371
69ea74eadebbed0718f60579b0fdc0b66de6a70b,0,Oleg Nechiporenko,2016-04-05 14:14:07+03:00,['b6e4894123f22f5397508f190155e2d405d07ed0'],1,3,4,22123681,1,1,1,1,22371
cdd97b08ce3b02c62d40b5bbbd80116466f474d2,1,Dmytro Sen,2016-04-05 14:44:19+03:00,['69ea74eadebbed0718f60579b0fdc0b66de6a70b'],907,11,918,22124599,18,0.696774194,0.696774194,0.290322581,22371
710a8fea44d56e71c4e21989021d9332b726e089,1,Nate Cole,2016-04-05 07:51:08-04:00,['cdd97b08ce3b02c62d40b5bbbd80116466f474d2'],11,446,457,22125056,14,0.078947368,0.888157895,0.819078947,22371
46176c9aa1da601a73c48940b352c3bef9977499,0,Andrew Onishuk,2016-04-05 15:00:20+03:00,['710a8fea44d56e71c4e21989021d9332b726e089'],0,4,4,22125060,1,,,,22371
7cb18c22b85a196a30ed941cf34f63121fdd639f,0,Andrew Onishuk,2016-04-05 15:19:58+03:00,['46176c9aa1da601a73c48940b352c3bef9977499'],2,5,7,22125067,1,1,1,1,22371
63e278dc8088e16475686e1cb8718a5655687a5e,0,Pallav Kulshreshtha,2016-04-05 17:56:06+05:18,['7cb18c22b85a196a30ed941cf34f63121fdd639f'],92,0,92,22125159,8,,,,22371
cdb866d7a8f9c313da76f164f738ca24d27b0893,0,Alex Antonenko,2016-04-05 15:43:01+03:00,['63e278dc8088e16475686e1cb8718a5655687a5e'],11,0,11,22125170,1,,,,22371
7debaaee71cc1a76ecfd453eb8e2088d695c29ef,1,Andrew Onishuk,2016-04-05 16:01:52+03:00,['cdb866d7a8f9c313da76f164f738ca24d27b0893'],44,226,270,22125440,5,0.260869565,0,0.836956522,22371
fa2fe9d8efe0bf0bc6c12c1b3291ce8f272aec4d,0,Myroslav Papirkovskyi,2016-04-05 16:15:34+03:00,['7debaaee71cc1a76ecfd453eb8e2088d695c29ef'],6,9,15,22125455,2,0,0,1,22371
2fa50206fb3ae1c077ef03e6558b0782b05af4a3,1,Andrew Onishuk,2016-04-05 17:22:34+03:00,['fa2fe9d8efe0bf0bc6c12c1b3291ce8f272aec4d'],1,1,2,22125457,1,,,,22371
b5aa1d34a1c259dcfc4ebf3b9bce233bd8cdfbc6,1,Dmytro Sen,2016-04-05 18:12:21+03:00,['2fa50206fb3ae1c077ef03e6558b0782b05af4a3'],23,31,54,22125511,5,1,1,1,22371
36edfee565e17bbd5a32fe8ec7a691b7a06965fe,0,Andrew Onishuk,2016-04-05 18:24:08+03:00,['b5aa1d34a1c259dcfc4ebf3b9bce233bd8cdfbc6'],1,1,2,22125513,1,,,,22371
5f3c6c11d3caadf3a2081c94ca1d56f25b768235,1,Jonathan Hurley,2016-04-05 11:34:08-04:00,['36edfee565e17bbd5a32fe8ec7a691b7a06965fe'],95,356,451,22125964,14,0.369369369,0.972972973,0.837837838,22371
32b2f739d4636bf81bb9e0da948ccac100fd7395,0,Alex Antonenko,2016-04-05 19:39:02+03:00,['5f3c6c11d3caadf3a2081c94ca1d56f25b768235'],1,1,2,22125966,1,,,,22371
68fe82f5d437a54432189bb1c061102375e8b843,1,Andrew Onishuk,2016-04-05 20:02:37+03:00,['32b2f739d4636bf81bb9e0da948ccac100fd7395'],0,367,367,22126333,1,0.373913043,0.7,1,22372
79c0a4f350c951c5225877ce6ddec8772dc0b47d,0,Matt,2016-04-05 10:26:37-07:00,['68fe82f5d437a54432189bb1c061102375e8b843'],1,2,3,22126336,1,,,,22372
a2c6ea46f0f180f75b1e76dc2adff2bd53258d36,1,Zhe (Joe) Wang,2016-04-05 10:28:09-07:00,['79c0a4f350c951c5225877ce6ddec8772dc0b47d'],13,41,54,22126390,8,1,1,1,22372
dc088141a40511a0bb51173b594826393da46e69,0,Jonathan Hurley,2016-04-05 13:52:41-04:00,['a2c6ea46f0f180f75b1e76dc2adff2bd53258d36'],9,125,134,22126524,2,0,0.918367347,1,22372
8672138926f2b88c6d798a470b4beb279f4c071f,1,Matt,2016-04-05 11:00:49-07:00,['dc088141a40511a0bb51173b594826393da46e69'],20,100,120,22126644,10,0.066666667,0.8,0.755555556,22372
7e3b8673bd7a2444f2d7ecf0cb13692d47046bb0,0,Jonathan Hurley,2016-04-05 14:07:28-04:00,['8672138926f2b88c6d798a470b4beb279f4c071f'],0,6,6,22126650,1,,,,22372
32da806c990b6f399beaa44bcd6ed67ce13d8b0e,1,Zhe (Joe) Wang,2016-04-05 11:09:06-07:00,['7e3b8673bd7a2444f2d7ecf0cb13692d47046bb0'],19,30,49,22126699,4,0.875,0.875,1,22372
29b6542b014a0d1c4183a055c6b3bb4600526c12,1,Nahappan Somasundaram,2016-04-05 11:24:07-07:00,['32da806c990b6f399beaa44bcd6ed67ce13d8b0e'],3,15,18,22126717,3,0,0.272727273,1,22372
24bb7843c109e71bf744bc722e23e216e975b1ff,0,Yusaku Sako,2016-04-05 11:29:59-07:00,['29b6542b014a0d1c4183a055c6b3bb4600526c12'],0,36,36,22126753,1,,,,22372
48e418ee603b3f1cf11bbec9820b829945cd7161,0,Jonathan Hurley,2016-04-05 14:33:36-04:00,['24bb7843c109e71bf744bc722e23e216e975b1ff'],1,71,72,22126825,2,0,1,1,22372
3de6be60a73d8a6231d144c3415308b972d5b80f,0,Yusaku Sako,2016-04-05 11:40:50-07:00,['48e418ee603b3f1cf11bbec9820b829945cd7161'],1,1,2,22126827,1,,,,22372
3811e1921599dae035cce4ebc5bddaf982837045,1,Di Li,2016-04-05 14:45:19-04:00,['3de6be60a73d8a6231d144c3415308b972d5b80f'],1,160,161,22126988,18,0.879120879,0.923076923,0.967032967,22372
d7c5a1bbf3db24292dadfe919b010c174e86d387,1,Richard Zang,2016-04-05 11:46:54-07:00,['3811e1921599dae035cce4ebc5bddaf982837045'],8,26,34,22127022,2,,,,22372
d0da3f7c8f00b84240f3c2d0222c769db97efd13,1,Matt,2016-04-05 11:57:37-07:00,['d7c5a1bbf3db24292dadfe919b010c174e86d387'],0,300,300,22127322,3,0.807017544,0.807017544,0.368421053,22374
7cefcb2a7ba73fc503b0d343af8a6a5bca9d6834,1,Matt,2016-04-05 12:27:25-07:00,['d0da3f7c8f00b84240f3c2d0222c769db97efd13'],4,4,8,22127330,3,,,,22374
2486b8cbb7643089692e3bf0bea87da9f617bad1,1,Zhe (Joe) Wang,2016-04-05 13:31:05-07:00,['7cefcb2a7ba73fc503b0d343af8a6a5bca9d6834'],28,171,199,22127529,10,1,1,1,22374
f453b27fba7b74b4c2ceb74397c1a6d6f32b7f93,0,Yusaku Sako,2016-04-05 14:45:56-07:00,['2486b8cbb7643089692e3bf0bea87da9f617bad1'],3,3,6,22127535,1,,,,22374
7343f6d6bc7550dfc969fdb3d7179031618169fc,1,Andrew Onishuk,2016-04-06 00:47:22+03:00,['f453b27fba7b74b4c2ceb74397c1a6d6f32b7f93'],70,326,396,22127931,14,0.177142857,0.085714286,0.857142857,22374
dc366dbe7f993630e1af91e656059c221007a3c0,1,Aravindan Vijayan,2016-04-05 19:03:26-07:00,['7343f6d6bc7550dfc969fdb3d7179031618169fc'],15,25,40,22127971,3,0,0,1,22374
598835003e036f7c72d61905cdeab3a0a63eb31d,1,ababiichuk,2016-04-06 12:58:36+03:00,['dc366dbe7f993630e1af91e656059c221007a3c0'],472,181,653,22128624,14,0.088050314,0.150943396,0.050314465,22374
c31a077708213c8288f92f1ab7aa1019bf4be7c1,0,Alex Antonenko,2016-04-06 13:01:30+03:00,['598835003e036f7c72d61905cdeab3a0a63eb31d'],2,205,207,22128831,2,0.532338308,1,1,22374
b2be40bfa87ca6e6eeb98bcc744b907d415be6c7,1,Andrew Onishuk,2016-04-06 14:02:10+03:00,['c31a077708213c8288f92f1ab7aa1019bf4be7c1'],1,1,2,22128833,1,,,,22374
786d1ed6e927cc54fe50cc644ac494019ce00b05,0,Dmytro Sen,2016-04-06 14:53:13+03:00,['b2be40bfa87ca6e6eeb98bcc744b907d415be6c7'],1,1,2,22128835,1,,,,22374
fb8f34855f81a0b439ebdb59d4ca297d835189fe,0,Aleksandr Kovalenko,2016-04-06 15:12:09+03:00,['786d1ed6e927cc54fe50cc644ac494019ce00b05'],21,70,91,22128926,2,0.527777778,1,1,22374
064f1d195ea86b8a6478fab65b55a4a4bdab51f3,1,Andrew Onishuk,2016-04-06 18:58:04+03:00,['fb8f34855f81a0b439ebdb59d4ca297d835189fe'],2,2,4,22128930,2,,,,22374
3e57dc24c7ba3eaafe4a9d0e179c6e813726bcaa,1,Nate Cole,2016-04-06 12:20:26-04:00,['064f1d195ea86b8a6478fab65b55a4a4bdab51f3'],102,298,400,22129330,8,0.128712871,0.455445545,1,22374
1d93c53b81e56d107d075c97b2399788015f7c4e,0,Zhe (Joe) Wang,2016-04-06 11:05:18-07:00,['3e57dc24c7ba3eaafe4a9d0e179c6e813726bcaa'],37,41,78,22129408,2,,,,22374
97c11244b3f521618ef45683d815dfdf432dc573,1,Alejandro Fernandez,2016-04-06 11:17:48-07:00,['1d93c53b81e56d107d075c97b2399788015f7c4e'],110,209,319,22129727,10,0.631578947,0.631578947,0.263157895,22374
1cb8b0c103d55329bb533a6f4e341791d4eaf237,0,Andrew Onishuk,2016-04-06 21:41:03+03:00,['97c11244b3f521618ef45683d815dfdf432dc573'],2,66,68,22129795,2,0.026315789,1,1,22374
d1655dc571accf913e720992d7645b764665aa98,1,Richard Zang,2016-04-06 11:49:04-07:00,['1cb8b0c103d55329bb533a6f4e341791d4eaf237'],15,43,58,22129853,2,,,,22374
ef30d78a3913abdb3ab91fd4b683e140bef21bfc,0,Zhe (Joe) Wang,2016-04-06 12:55:39-07:00,['d1655dc571accf913e720992d7645b764665aa98'],14,10,24,22129877,2,,,,22374
21b82cc4e26df76b449b5f4978045187778019ff,1,Alejandro Fernandez,2016-04-06 13:29:19-07:00,['ef30d78a3913abdb3ab91fd4b683e140bef21bfc'],2,26,28,22129905,2,0.333333333,1,1,22374
b02680091efcf9b392d40f65f0a1a7cc99550159,1,Yusaku Sako,2016-04-06 13:52:11-07:00,['21b82cc4e26df76b449b5f4978045187778019ff'],2,14,16,22129921,1,1,1,1,22374
fd3692ecf23bfcccaeb4b83aa95735e084ca8f2b,0,Sumit Mohanty,2016-04-06 14:14:53-07:00,['b02680091efcf9b392d40f65f0a1a7cc99550159'],3,5,8,22129929,1,,,,22374
5060b4f8c13d3746d72138324ad7cbf609462338,1,Aravindan Vijayan,2016-04-06 14:34:07-07:00,['fd3692ecf23bfcccaeb4b83aa95735e084ca8f2b'],1,87,88,22130017,3,0,0.8,1,22374
d4f2d999362507bd91d7b8583702b98b3fb53b99,0,Zhe (Joe) Wang,2016-04-06 15:03:43-07:00,['5060b4f8c13d3746d72138324ad7cbf609462338'],51,5,56,22130073,3,0,0,0,22374
548ed9fdabf8c711d507abb080bab24ec78b501a,0,Sumit Mohanty,2016-04-06 15:57:07-07:00,['d4f2d999362507bd91d7b8583702b98b3fb53b99'],5,3,8,22130081,1,,,,22374
df00fd6e4b769276a72373980aa819c26465b12f,0,Jaimin Jetly,2016-04-06 16:30:00-07:00,['548ed9fdabf8c711d507abb080bab24ec78b501a'],3,5,8,22130089,2,0,0,1,22374
2c660d32ea1b499cb8ee7908d43fec25f011f96f,0,Ajit Kumar,2016-04-06 17:42:51-07:00,['df00fd6e4b769276a72373980aa819c26465b12f'],0,4,4,22130093,1,1,1,1,22374
e68968dd9bc0a20e26c10db6d00893cbc48ae4af,1,Sumit Mohanty,2016-04-06 17:44:53-07:00,['2c660d32ea1b499cb8ee7908d43fec25f011f96f'],4,6,10,22130103,1,,,,22374
1df39c324fc97d4db4cc19023d1e8aed92efc36d,1,Pallav Kulshreshtha,2016-04-07 13:17:37+05:18,['e68968dd9bc0a20e26c10db6d00893cbc48ae4af'],1,507,508,22130611,7,0.402654867,0.668141593,1,22377
85bb079447706e004e2b2dcb103b0fdac5704290,0,Pallav Kulshreshtha,2016-04-07 13:21:33+05:18,['1df39c324fc97d4db4cc19023d1e8aed92efc36d'],507,1,508,22131119,7,0.597345133,0.331858407,0,22377
688f6d46d1fe1ba7fc30df1f47d6792414c4e4d4,1,Pallav Kulshreshtha,2016-04-07 13:25:40+05:18,['85bb079447706e004e2b2dcb103b0fdac5704290'],1,507,508,22131627,7,0.402654867,0.668141593,1,22380
04fe46d74bccd09f4a367193378e90bda09e7bba,1,Andrii Tkach,2016-04-07 11:51:07+03:00,['688f6d46d1fe1ba7fc30df1f47d6792414c4e4d4'],206,108,314,22131941,10,0.209876543,0.049382716,0,22380
1cc4a20b33157de8c547929321567911a13d8942,1,"Toader, Sebastian",2016-04-07 11:33:31+02:00,['04fe46d74bccd09f4a367193378e90bda09e7bba'],5,68,73,22132014,2,0.12,1,1,22380
7b67232361e394a9ae72d2a26dab6201b9fab88b,0,Oleg Nechiporenko,2016-04-07 13:51:33+03:00,['1cc4a20b33157de8c547929321567911a13d8942'],0,3,3,22132017,1,,,,22380
8bb0d16a66d6d0b7f85ca44daa070c2f35a397f8,0,Oleg Nechiporenko,2016-04-07 13:51:33+03:00,['7b67232361e394a9ae72d2a26dab6201b9fab88b'],3,3,6,22132023,2,,,,22380
9c3fe327d45a384cad8489e3bf65de8a357e0f75,1,Oleg Nechiporenko,2016-04-07 13:51:34+03:00,['8bb0d16a66d6d0b7f85ca44daa070c2f35a397f8'],9,98,107,22132130,4,0.16,1,1,22380
aceeacef678006493d51d7ad80cf69ab91083433,0,Alex Antonenko,2016-04-07 14:37:49+03:00,['9c3fe327d45a384cad8489e3bf65de8a357e0f75'],0,9,9,22132139,2,0.428571429,1,1,22380
6568b583d6a31c0c2dcecc0a7a82def22103270f,1,Oleg Nechiporenko,2016-04-07 15:17:36+03:00,['aceeacef678006493d51d7ad80cf69ab91083433'],1,1,2,22132141,1,0,,0,22380
0e87151795a9bf97f8b7ef8033204b03f08ab91b,0,"Toader, Sebastian",2016-04-07 15:08:37+02:00,['6568b583d6a31c0c2dcecc0a7a82def22103270f'],3,8,11,22132152,2,0,0,1,22380
de09ef87cbaae7d8684f9d8931ed09111d6c0ec2,1,Pallav Kulshreshtha,2016-04-07 18:43:12+05:18,['0e87151795a9bf97f8b7ef8033204b03f08ab91b'],1,1,2,22132154,1,,,,22380
9ca341d4dabe07b2097b3e89a977d6935fc8da24,1,Pallav Kulshreshtha,2016-04-07 18:51:48+05:18,['de09ef87cbaae7d8684f9d8931ed09111d6c0ec2'],0,330,330,22132484,7,0.824427481,1,1,22383
81497776eeefc7190645186bd20adfb50f3c7471,1,Pallav Kulshreshtha,2016-04-07 18:58:04+05:18,['9ca341d4dabe07b2097b3e89a977d6935fc8da24'],1,260,261,22132745,7,0.828571429,1,1,22386
10371363d2bae1ee2c5e968afc9e94240a2ee49a,0,Di Li,2016-04-07 09:59:05-04:00,['81497776eeefc7190645186bd20adfb50f3c7471'],6,6,12,22132757,2,,,,22386
b1d43fbe00e3396524f75904ace3492c44d1de2e,1,Gautam Borad,2016-04-07 19:39:30+05:18,['10371363d2bae1ee2c5e968afc9e94240a2ee49a'],93,1045,1138,22133895,20,0.278106509,0.360946746,0.650887574,22390
6e349d9adca9f2d73fc9790f875e6d653757247c,0,Alex Antonenko,2016-04-07 18:05:24+03:00,['b1d43fbe00e3396524f75904ace3492c44d1de2e'],0,10,10,22133905,2,,,,22390
d17ea8be32fefe83d23de94ddd18906a0fa426c3,0,Alex Antonenko,2016-04-07 18:05:24+03:00,['6e349d9adca9f2d73fc9790f875e6d653757247c'],1,1,2,22133907,1,,,,22390
73472dc1cea0fdf00afa88d802048269483e2f91,0,Andrew Onishuk,2016-04-07 18:45:57+03:00,['d17ea8be32fefe83d23de94ddd18906a0fa426c3'],1,26,27,22133934,2,0.882352941,0.941176471,0.941176471,22390
1c737d3a29d42640cd16ffef1c179f6856a9ec76,0,Andrew Onishuk,2016-04-07 18:59:43+03:00,['73472dc1cea0fdf00afa88d802048269483e2f91'],4,81,85,22134019,5,0.684210526,0.684210526,1,22392
aabc4d7236e5a180ae58f5bc947cb1d356306d7f,1,Yusaku Sako,2016-04-07 09:12:40-07:00,['1c737d3a29d42640cd16ffef1c179f6856a9ec76'],4,4,8,22134027,3,,,,22392
016a303bd8ed3fdcbb543e359a3f8acde87f5059,1,ababiichuk,2016-04-07 19:30:45+03:00,['aabc4d7236e5a180ae58f5bc947cb1d356306d7f'],588,88,676,22134703,3,0.655172414,0.108374384,0.123152709,22392
5f0a09690310fee76c4cab3639c1c4ec08ecca8a,0,Andrew Onishuk,2016-04-07 20:30:19+03:00,['016a303bd8ed3fdcbb543e359a3f8acde87f5059'],2,145,147,22134850,4,0.659574468,1,0.936170213,22394
28f1a958d09216e7a69d42ef3b0796c90cdcc0c4,1,Jonathan Hurley,2016-04-07 14:02:11-04:00,['5f0a09690310fee76c4cab3639c1c4ec08ecca8a'],555,1369,1924,22136774,15,0.293103448,0.543103448,0.853448276,22398
f0645b68abdcc61876313fd2e9aa5fec552a566e,0,Matt,2016-04-07 11:08:03-07:00,['28f1a958d09216e7a69d42ef3b0796c90cdcc0c4'],2,2,4,22136778,1,,,,22398
6320d589f942b41cdab34c1de241423ccb5b4752,1,"Toader, Sebastian",2016-04-07 20:11:29+02:00,['f0645b68abdcc61876313fd2e9aa5fec552a566e'],599,748,1347,22138125,61,0.753623188,0.782608696,0.536231884,22400
71a1f7e0e5985b1a77bf09b976ebda3ab3fdbbf5,0,Sumit Mohanty,2016-04-07 12:45:36-07:00,['6320d589f942b41cdab34c1de241423ccb5b4752'],3,52,55,22138180,4,,,,22401
e3edcf574c387aa8d4f16a07ae97d268a105247e,1,Yusaku Sako,2016-04-07 14:15:19-07:00,['71a1f7e0e5985b1a77bf09b976ebda3ab3fdbbf5'],10,65,75,22138255,2,1,1,1,22401
7c211e3ee365889bf1e38f392f5f5adafe41e4a5,1,Alejandro Fernandez,2016-04-07 14:19:35-07:00,['e3edcf574c387aa8d4f16a07ae97d268a105247e'],5,59,64,22138319,4,0.541666667,0.541666667,0.666666667,22401
129041f548923abab41191e63a892d23193a7d52,0,Nate Cole,2016-04-07 19:36:14-04:00,['7c211e3ee365889bf1e38f392f5f5adafe41e4a5'],17,191,208,22138527,10,0.147058824,0.460784314,1,22401
71cfa6124e149065a69cca7724ba643b46e71b1f,0,Matt,2016-04-07 19:10:19-07:00,['129041f548923abab41191e63a892d23193a7d52'],5,5,10,22138537,1,1,1,1,22401
5772ceb05a1804b1c16cccc7968cd17a25de8ccd,1,Andrew Onishuk,2016-04-08 11:50:26+03:00,['71cfa6124e149065a69cca7724ba643b46e71b1f'],8,105,113,22138650,19,0,0.925925926,0.950617284,22401
b18ecf015ac4651566cbb76fe2338f6bd5101f54,1,Jayush Luniya,2016-04-08 02:22:00-07:00,['5772ceb05a1804b1c16cccc7968cd17a25de8ccd'],127,209,336,22138986,19,1,0,1,22401
14fcf31aaa33cd1f8b3b7ae855a9baef9efb40e4,1,Myroslav Papirkovskyi,2016-04-08 13:09:00+03:00,['b18ecf015ac4651566cbb76fe2338f6bd5101f54'],6,3,9,22138995,2,0,0,0,22401
49c7dcd1557b294af78ec90030ff6df7bd0284ed,0,Sumit Mohanty,2016-04-08 07:32:59-07:00,['14fcf31aaa33cd1f8b3b7ae855a9baef9efb40e4'],145,2,147,22139142,4,0.340425532,0,0.063829787,22401
438657cbacabe4bee6f6ac720561a1f659c4f498,1,Di Li,2016-04-08 13:36:23-04:00,['49c7dcd1557b294af78ec90030ff6df7bd0284ed'],2,428,430,22139572,23,0.875,0.920454545,0.965909091,22402
bc17f9cf4fafee7cc405160b51ef13b89743c238,1,Dmytro Sen,2016-04-08 20:38:48+03:00,['438657cbacabe4bee6f6ac720561a1f659c4f498'],0,87,87,22139659,2,0.014925373,0.686567164,1,22402
ddc656714914c34597eb4791920dd68f1430b242,1,Jonathan Hurley,2016-04-08 13:39:50-04:00,['bc17f9cf4fafee7cc405160b51ef13b89743c238'],39,147,186,22139845,4,0,1,1,22402
59791f461ea05fec1ab321bf0b8c14fcb50ae8b6,0,Matt,2016-04-08 10:51:22-07:00,['ddc656714914c34597eb4791920dd68f1430b242'],13,10,23,22139868,1,0,0,0,22402
2817ce67e9a5a08787ef1219a9f3b29ab41bc094,1,Matt,2016-04-08 10:59:34-07:00,['59791f461ea05fec1ab321bf0b8c14fcb50ae8b6'],0,58,58,22139926,6,0.25,1,1,22402
84214c5ae1ba107931a735a685951239fc0c9a1e,1,tbeerbower,2016-04-08 14:44:43-04:00,['2817ce67e9a5a08787ef1219a9f3b29ab41bc094'],330,777,1107,22141033,12,1,1,1,22408
9c74212e772e1cbc46445536d1ab2e2d921accab,0,Myroslav Papirkovskyi,2016-04-08 21:54:27+03:00,['84214c5ae1ba107931a735a685951239fc0c9a1e'],1,1,2,22141035,1,,,,22408
666b3c6909f7f78ac99007f2626e62d3d05ac269,1,Zhe (Joe) Wang,2016-04-08 13:51:56-07:00,['9c74212e772e1cbc46445536d1ab2e2d921accab'],1,7,8,22141043,4,0.5,0.5,0.666666667,22408
faae7ad8f01fe2a8432945d446e4ea1a79b25dcf,1,Alejandro Fernandez,2016-04-08 15:40:25-07:00,['666b3c6909f7f78ac99007f2626e62d3d05ac269'],18,69,87,22141130,5,0.027777778,0.25,1,22408
03d2cdb45cb86b99b4620008790a66c140de9c64,0,Sumit Mohanty,2016-04-08 17:26:33-07:00,['faae7ad8f01fe2a8432945d446e4ea1a79b25dcf'],916,0,916,22142046,25,,,,22408
1be0e6c8f509dd48fca5727f1fccb07428b42de7,0,Dmytro Sen,2016-04-09 16:05:06+03:00,['03d2cdb45cb86b99b4620008790a66c140de9c64'],3,0,3,22142049,2,1,0.333333333,0,22408
356cb943221f6bfe75d6eb1cbfb3376ef35f85c7,1,Andrew Onishuk,2016-04-09 16:07:06+03:00,['1be0e6c8f509dd48fca5727f1fccb07428b42de7'],7,16,23,22142072,1,0,0,1,22408
e44c4f76c9741b4cf541d8a45a584b16b81c0626,1,Alex Antonenko,2016-04-09 21:14:47+03:00,['356cb943221f6bfe75d6eb1cbfb3376ef35f85c7'],1,1,2,22142074,1,,,,22408
6de04a33c63ed9f6523839048e0d5a588d2037a3,1,Alex Antonenko,2016-04-09 21:14:47+03:00,['e44c4f76c9741b4cf541d8a45a584b16b81c0626'],31,553,584,22142658,5,0.81512605,0.985994398,0.927170868,22408
7b64e964db9e44a42cf10d0a2a717349a78cfbe6,0,Alex Antonenko,2016-04-09 21:14:47+03:00,['6de04a33c63ed9f6523839048e0d5a588d2037a3'],0,2,2,22142660,1,,,,22408
55e5a785fea5cff8dceb5dc1d43371b68726b848,1,tbeerbower,2016-04-10 17:36:38-04:00,['7b64e964db9e44a42cf10d0a2a717349a78cfbe6'],6,74,80,22142740,4,0,0,1,22408
88984efde16cd3bfd32616db454abab56f818c7d,1,Sumit Mohanty,2016-04-10 17:45:20-07:00,['55e5a785fea5cff8dceb5dc1d43371b68726b848'],2,2802,2804,22145544,5,0.318627451,0.661764706,0.573529412,22412
d00fc4c6fadb8e215e1b519f97b13e2ceae68e2a,0,Andrew Onishuk,2016-04-11 12:05:44+03:00,['88984efde16cd3bfd32616db454abab56f818c7d'],1,2,3,22145547,1,,,,22412
01a08cfa5f5f18468b3a1da800efad1b6e60dc32,1,Andrew Onishuk,2016-04-11 12:07:57+03:00,['d00fc4c6fadb8e215e1b519f97b13e2ceae68e2a'],3,3,6,22145553,1,,,,22412
026eef87fb4a0ec2130992a6c0f73cdda1244670,0,Pallav Kulshreshtha,2016-04-11 14:34:55+05:18,['01a08cfa5f5f18468b3a1da800efad1b6e60dc32'],0,9,9,22145562,1,1,1,1,22412
878a0dd8829b97eb2741e8bcf2d0b357410a60da,0,Alex Antonenko,2016-04-11 13:21:34+03:00,['026eef87fb4a0ec2130992a6c0f73cdda1244670'],0,1,1,22145563,1,1,1,1,22412
251c741bc52741ea96372a444ba8da6adf8506d1,1,Pallav Kulshreshtha,2016-04-11 15:48:07+05:18,['878a0dd8829b97eb2741e8bcf2d0b357410a60da'],20,15,35,22145598,3,1,0,0,22412
c6fa8c26f40b8a776574b322560c94b01089f980,1,Robert Levas,2016-04-11 09:46:18-04:00,['251c741bc52741ea96372a444ba8da6adf8506d1'],361,464,825,22146423,35,0,1,0.883116883,22412
dcca89db5ef39b514c1d7b92cc585f46b55ef908,1,Sumit Mohanty,2016-04-11 07:42:55-07:00,['c6fa8c26f40b8a776574b322560c94b01089f980'],6,10,16,22146439,3,0,0,1,22412
39c85bb8253def4c3c0d694a989ab07b2232ffff,1,oleewere,2016-04-11 16:45:36+02:00,['dcca89db5ef39b514c1d7b92cc585f46b55ef908'],0,359829,359829,22506268,1146,0.413321943,0.705579692,0.885286795,23557
9954f5049ca494038cde027a2c5e8707f1acbae1,1,Andrii Tkach,2016-04-11 20:03:31+03:00,['39c85bb8253def4c3c0d694a989ab07b2232ffff'],5,10,15,22506283,1,0.8,1,0.8,23557
16c13980874bde8f38660447a848c0de96d93d47,1,Dmytro Sen,2016-04-11 20:33:45+03:00,['9954f5049ca494038cde027a2c5e8707f1acbae1'],2,141,143,22506426,2,0.081081081,0.567567568,1,23558
3691090923d141ea57a8d13931692d0e4b441f37,1,Dmytro Sen,2016-04-11 20:45:29+03:00,['16c13980874bde8f38660447a848c0de96d93d47'],36,926,962,22507388,16,0.216432866,0.753507014,0.865731463,23562
a95ed0aa62d986f088c95571b38fef304456067f,0,Sumit Mohanty,2016-04-11 11:14:00-07:00,['3691090923d141ea57a8d13931692d0e4b441f37'],1,0,1,22507389,1,0,1,1,23562
64c721182cf64cb930bfd02b56edc4259a8f3930,1,Siddharth Wagle,2016-04-11 12:17:35-07:00,['a95ed0aa62d986f088c95571b38fef304456067f'],72,341,413,22507802,10,0,0.847058824,0.952941176,23562
4c91a694ddf47f558bd3331a385cd88fe3ea5e89,0,Bhuvnesh Chaudhary,2016-04-11 12:33:02-07:00,['64c721182cf64cb930bfd02b56edc4259a8f3930'],1,1,2,22507804,1,,,,23562
6ea7fd75073399761e41ea77e8977933aee873a5,0,Andrew Onishuk,2016-04-11 23:27:13+03:00,['4c91a694ddf47f558bd3331a385cd88fe3ea5e89'],5,5,10,22507814,1,,,,23562
9f61db3d12921dabf7572e708206b186dc8f5ffe,1,swapan,2016-04-11 13:33:02-07:00,['6ea7fd75073399761e41ea77e8977933aee873a5'],4,441,445,22508259,6,0.533333333,0.533333333,0.366666667,23564
c589c543b4767d45c028dcf016aec625e66e1dd1,1,Yusaku Sako,2016-04-11 13:44:18-07:00,['9f61db3d12921dabf7572e708206b186dc8f5ffe'],5,321,326,22508585,2,,,,23564
7b11dcd7080b85b7bcfd34e62b911de3adcedf6c,0,Zhe (Joe) Wang,2016-04-11 14:47:56-07:00,['c589c543b4767d45c028dcf016aec625e66e1dd1'],6,6,12,22508597,1,,,,23564
579982cddbd3d7cbde5e8d8cdbdcf3061afe3017,1,Nate Cole,2016-04-11 17:52:59-04:00,['7b11dcd7080b85b7bcfd34e62b911de3adcedf6c'],83,145,228,22508825,3,0.705882353,0.176470588,0,23564
e91f2a656dd4bb037bd0a29b0cf207e6993d4836,1,Aravindan Vijayan,2016-04-11 15:18:57-07:00,['579982cddbd3d7cbde5e8d8cdbdcf3061afe3017'],5,10,15,22508840,3,0,0,0.25,23564
ca7b901e701fe76429bc1e0f8afbf8c30da50a21,1,Aravindan Vijayan,2016-04-11 15:40:31-07:00,['e91f2a656dd4bb037bd0a29b0cf207e6993d4836'],52,308,360,22509200,2,0.168949772,0.98630137,0.657534247,23564
1a7c781ce5340e332dc182c2c93d010cf0eec902,0,Sumit Mohanty,2016-04-11 15:45:59-07:00,['ca7b901e701fe76429bc1e0f8afbf8c30da50a21'],7,1221,1228,22510428,3,0,0,0.333333333,23565
995fc0be488d45bd9b44e412e034565267649a1a,1,Sumit Mohanty,2016-04-11 15:48:30-07:00,['1a7c781ce5340e332dc182c2c93d010cf0eec902'],1221,7,1228,22511656,3,1,1,0.666666667,23565
1046c8fec72285dee07342afd8ff941a000a6718,1,Sumit Mohanty,2016-04-11 15:49:23-07:00,['995fc0be488d45bd9b44e412e034565267649a1a'],7,63,70,22511726,2,0,0,0.333333333,23565
128f26ce98481a1d46da7d85b6c2b52a0a61db91,0,Richard Zang,2016-04-11 16:34:14-07:00,['1046c8fec72285dee07342afd8ff941a000a6718'],2,4,6,22511732,1,1,1,1,23565
602fb5d2058e241b99eb98f9ecfb88332a6c75af,1,Aravindan Vijayan,2016-04-11 16:37:19-07:00,['128f26ce98481a1d46da7d85b6c2b52a0a61db91'],5,144,149,22511881,2,0,0,1,23565
45bac47f8980cef1871155b5b3dd201c3055bbcd,1,Aravindan Vijayan,2016-04-11 16:37:19-07:00,['602fb5d2058e241b99eb98f9ecfb88332a6c75af'],7,41,48,22511929,4,0.95,1,1,23565
7603656472cc711f2224ec3fa9b37237d43c49ef,1,Matt,2016-04-11 16:49:15-07:00,['45bac47f8980cef1871155b5b3dd201c3055bbcd'],20,20,40,22511969,5,0,0,0,23565
8531c115f8e3b814974efc3a75ecfa379ab7f764,0,Jaimin Jetly,2016-04-11 16:54:16-07:00,['7603656472cc711f2224ec3fa9b37237d43c49ef'],17,8,25,22511994,2,,,,23565
bce64344fc8238a50c2f01f72c1050e47d7c3dc3,1,Matt,2016-04-11 17:29:07-07:00,['8531c115f8e3b814974efc3a75ecfa379ab7f764'],13,14,27,22512021,2,,,,23565
79ab063711390b4990c04c477267136939ba9d71,0,Jonathan Hurley,2016-04-11 23:35:24-04:00,['bce64344fc8238a50c2f01f72c1050e47d7c3dc3'],9,6,15,22512036,2,1,1,0,23565
3f2d5bea20ce647d6fff64a9b2d7a488b005f0c9,1,Jonathan Hurley,2016-04-11 23:35:39-04:00,['79ab063711390b4990c04c477267136939ba9d71'],47,41,88,22512124,2,0.333333333,0.833333333,0.666666667,23565
1fed70cab776015408ffae7897d7ddf307d1276f,1,Jonathan Hurley,2016-04-11 23:35:58-04:00,['3f2d5bea20ce647d6fff64a9b2d7a488b005f0c9'],178,10,188,22512312,2,0.96350365,0.941605839,0.03649635,23565
2d25706dfb62fb557b6186d0a8c0f512724f39ea,0,"Toader, Sebastian",2016-04-12 09:27:22+02:00,['1fed70cab776015408ffae7897d7ddf307d1276f'],2,398,400,22512712,2,0.076502732,0.770491803,1,23566
407c63f823589c34ddf20c9b4afab2dfa994922f,1,Dmytro Sen,2016-04-12 10:42:26+03:00,['2d25706dfb62fb557b6186d0a8c0f512724f39ea'],0,6038,6038,22518750,7,,,,23573
c3ea7ef1cf69e10e067b7a70b0f0187212713730,0,Oleg Nechiporenko,2016-04-12 11:08:43+03:00,['407c63f823589c34ddf20c9b4afab2dfa994922f'],2,3,5,22518755,2,0,0,1,23573
2619eee168d6ef099117b196585a35fa8e5c2e6c,1,Oleg Nechiporenko,2016-04-12 11:34:34+03:00,['c3ea7ef1cf69e10e067b7a70b0f0187212713730'],3,10,13,22518768,1,1,1,1,23573
0da68672a25d0f920f358f0e4b40465121db9326,1,Oleg Nechiporenko,2016-04-12 11:36:09+03:00,['2619eee168d6ef099117b196585a35fa8e5c2e6c'],13,22,35,22518803,8,1,1,1,23573
7f8da72ffbbb6c44060e1df11a10a3baeb3227a0,0,Myroslav Papirkovskyi,2016-04-12 15:09:18+03:00,['0da68672a25d0f920f358f0e4b40465121db9326'],4,5,9,22518812,3,,1,,23573
af13ef73931bf672536199b944d4c3e26ad24ac4,1,"Toader, Sebastian",2016-04-12 14:59:45+02:00,['7f8da72ffbbb6c44060e1df11a10a3baeb3227a0'],67,3076,3143,22521955,47,0.363636364,0.98245614,0.884370016,23605
6eeb1a65c8da32f1811e10cf49f8f17540d7711b,0,Andrew Onishuk,2016-04-12 17:15:50+03:00,['af13ef73931bf672536199b944d4c3e26ad24ac4'],4,8,12,22521967,1,1,1,1,23605
e0bc22e18b85e16800225076a60606f4e8f13e87,0,"Toader, Sebastian",2016-04-12 16:27:25+02:00,['6eeb1a65c8da32f1811e10cf49f8f17540d7711b'],7,8,15,22521982,1,0,0,0,23605
cf2c82959dfb40afd5cd06536ce2eb47eae3e11d,1,Andrew Onishuk,2016-04-12 17:58:54+03:00,['e0bc22e18b85e16800225076a60606f4e8f13e87'],6,201,207,22522189,7,0.283950617,0.50617284,0.851851852,23607
65369f908e7ff084adda8c315526c42bc8526afe,1,Vitaly Brodetskyi,2016-04-12 18:52:01+03:00,['cf2c82959dfb40afd5cd06536ce2eb47eae3e11d'],47,51,98,22522287,37,,,,23607
ba610b5cf927af306cb79807b7ff4ea8700e7f78,0,Robert Levas,2016-04-12 11:59:17-04:00,['65369f908e7ff084adda8c315526c42bc8526afe'],8,34,42,22522329,3,1,1,1,23607
7256ef0b9b0da1fa4b3207c390261871ca9e2ced,1,Aleksandr Kovalenko,2016-04-12 19:06:46+03:00,['ba610b5cf927af306cb79807b7ff4ea8700e7f78'],199,95,294,22522623,18,0.88,0,1,23607
badef3dcc145043cee9d15f0e26c4c3a1307c937,1,Dmytro Sen,2016-04-12 19:08:22+03:00,['7256ef0b9b0da1fa4b3207c390261871ca9e2ced'],15,22,37,22522660,2,0,0,1,23607
e371ac5c0b9d8734301edab1dcd2c90f6325492b,1,ababiichuk,2016-04-12 19:16:30+03:00,['badef3dcc145043cee9d15f0e26c4c3a1307c937'],32,30,62,22522722,8,1,1,0,23607
5dddc529f359d8557535efa4bf9eb33add9cda60,1,Jayush Luniya,2016-04-12 10:19:24-07:00,['e371ac5c0b9d8734301edab1dcd2c90f6325492b'],25,1215,1240,22523962,41,0.136363636,0.964646465,0.20959596,23643
49e91c38a42f4929442a34f156a6ab54c7bfab63,1,tbeerbower,2016-04-12 13:59:31-04:00,['5dddc529f359d8557535efa4bf9eb33add9cda60'],87,172,259,22524221,10,0,1,1,23644
fe9375abda3167d6a35a85898f990a8b30ebb75b,1,Alexander Denissov,2016-04-12 11:35:41-07:00,['49e91c38a42f4929442a34f156a6ab54c7bfab63'],1,1,2,22524223,1,,,,23644
e517a886084b72d9a6f1ea91511b727cade97468,1,Jaimin Jetly,2016-04-12 11:36:23-07:00,['fe9375abda3167d6a35a85898f990a8b30ebb75b'],4,5,9,22524232,2,1,1,1,23644
81279faedf80ffc6841408f5a2ae2c5f83e6c8f6,1,Nate Cole,2016-04-12 14:47:49-04:00,['e517a886084b72d9a6f1ea91511b727cade97468'],22,166,188,22524420,3,0.020408163,0.714285714,0.979591837,23644
391b45e934b8d4e94cb64adab0293736671395db,1,Xi Wang,2016-04-12 13:38:26-07:00,['81279faedf80ffc6841408f5a2ae2c5f83e6c8f6'],780,2426,3206,22527626,23,0.302904564,0.995850622,0.87966805,23646
ea0f60b606960dc1efd7db4c5e6cf3879d948e60,0,Zhe (Joe) Wang,2016-04-12 13:43:44-07:00,['391b45e934b8d4e94cb64adab0293736671395db'],0,20,20,22527646,1,1,1,1,23646
20e66fbb2b5c92b755b8d85e8009d64ccb1c5403,1,oleewere,2016-04-13 00:33:47+02:00,['ea0f60b606960dc1efd7db4c5e6cf3879d948e60'],6,2266,2272,22529918,23,0.40378198,0.912124583,0.854282536,23663
ef0bc272c5385aa6c935de78553106307da8a31e,1,Aravindan Vijayan,2016-04-12 17:30:27-07:00,['20e66fbb2b5c92b755b8d85e8009d64ccb1c5403'],4,4,8,22529926,2,,0,1,23663
89fef12a4f4f51f63000f4b4de41495ec287b96c,1,Bhuvnesh Chaudhary,2016-04-12 17:35:27-07:00,['ef0bc272c5385aa6c935de78553106307da8a31e'],29,9,38,22529964,4,0,0,0,23663
799c09851d9a371253ba54390ef284d53d2f05f3,1,Oleg Nechiporenko,2016-04-13 09:39:50+03:00,['89fef12a4f4f51f63000f4b4de41495ec287b96c'],75,4,79,22530043,5,0.014084507,0,0,23663
12b00a4d9959bb1648fbdf3d2883a496b8085783,1,Andrew Onishuk,2016-04-13 11:58:50+03:00,['799c09851d9a371253ba54390ef284d53d2f05f3'],2,8,10,22530053,2,0.333333333,0.333333333,1,23663
4db1ddac65c3419918ddc6b3de1e8055f9b5e8b1,1,Andrii Tkach,2016-04-13 12:45:01+03:00,['12b00a4d9959bb1648fbdf3d2883a496b8085783'],28,28,56,22530109,8,,,,23663
05d8743bcb587ab1a6646583ee8f83d3a2e5c2ff,0,ababiichuk,2016-04-13 13:42:07+03:00,['4db1ddac65c3419918ddc6b3de1e8055f9b5e8b1'],19,77,96,22530205,6,1,1,0.69047619,23663
bf6a2c94b2cd265891a2140077ade430347ca29b,0,Dipayan Bhowmick,2016-04-13 16:42:31+05:18,['05d8743bcb587ab1a6646583ee8f83d3a2e5c2ff'],53,343,396,22530601,25,0.630769231,0.646153846,0.992307692,23664
33ef653dd6972d6a84d653ea3c775dd2dc9149fa,0,Dipayan Bhowmick,2016-04-13 17:32:44+05:18,['bf6a2c94b2cd265891a2140077ade430347ca29b'],1,1,2,22530603,1,,,,23664
281307fceb533c1a557d9972991263546288bb41,1,Dipayan Bhowmick,2016-04-13 17:40:01+05:18,['33ef653dd6972d6a84d653ea3c775dd2dc9149fa'],102,1838,1940,22532543,68,0.886462882,1,1,23717
b3a9a7c361b910b7076263fde613ac5877e65a36,0,Alex Antonenko,2016-04-13 15:48:35+03:00,['281307fceb533c1a557d9972991263546288bb41'],10,10,20,22532563,5,,,,23717
9f803fe9aca0c5817179f8f5a0bffc5ea1723d12,0,Alex Antonenko,2016-04-13 15:48:35+03:00,['b3a9a7c361b910b7076263fde613ac5877e65a36'],10,61,71,22532634,2,0.72972973,0.675675676,1,23717
a7f0c09bdedeea61965bc4a7629fc599de2c71b8,0,Alex Antonenko,2016-04-13 15:48:35+03:00,['9f803fe9aca0c5817179f8f5a0bffc5ea1723d12'],3,15,18,22532652,2,,,,23717
f903d17f8f8184275357f03586c924c376ad78a1,1,oleewere,2016-04-13 15:01:05+02:00,['a7f0c09bdedeea61965bc4a7629fc599de2c71b8'],4,8505,8509,22541161,69,0.307565789,0.995065789,0.848684211,23769
6f340ec2d93332dd7ba6459dbb8f552effa22f5f,1,Alex Antonenko,2016-04-13 16:33:34+03:00,['f903d17f8f8184275357f03586c924c376ad78a1'],1838,102,1940,22543101,68,0.113537118,0,0,23769
10f824beec67f851160f5be18a68e692159aaa3d,0,Gautam Borad,2016-04-13 19:29:01+05:18,['6f340ec2d93332dd7ba6459dbb8f552effa22f5f'],15,16,31,22543132,2,0,0,1,23769
b4adae5cc5912cab6d6992efb944138487823ca3,1,Oleg Nechiporenko,2016-04-13 17:20:20+03:00,['10f824beec67f851160f5be18a68e692159aaa3d'],16,215,231,22543363,5,0,0.899159664,1,23769
fbb314a710dc8a7225f3aaf95800fbb9f795d57a,1,Di Li,2016-04-13 10:34:23-04:00,['b4adae5cc5912cab6d6992efb944138487823ca3'],8,54,62,22543425,3,0.5,1,1,23769
3a3802ce01b1dabd6c1a8eaaaaf871dd3401ab51,1,Sumit Mohanty,2016-04-13 07:40:09-07:00,['fbb314a710dc8a7225f3aaf95800fbb9f795d57a'],2,2,4,22543429,2,,,,23769
e57576bf1f9ffc246a16181bfd38737dcb2bb1a3,1,Aleksandr Kovalenko,2016-04-13 18:01:59+03:00,['3a3802ce01b1dabd6c1a8eaaaaf871dd3401ab51'],6,7,13,22543442,1,0,1,1,23769
4938e84794fae9b84acbd732199c7c4cdbd088dc,1,Bob Nettleton,2016-04-13 11:43:14-04:00,['e57576bf1f9ffc246a16181bfd38737dcb2bb1a3'],23,115,138,22543580,2,0,0.966101695,0.966101695,23769
9741e4aab6f8c9f11798ce4f872867e3313bf328,1,Andrii Tkach,2016-04-13 18:51:17+03:00,['4938e84794fae9b84acbd732199c7c4cdbd088dc'],58,941,999,22544579,10,0.770231214,1,1,23771
5a52d1576fb7e5a818508908d03816c5014d88c1,0,Vitaly Brodetskyi,2016-04-13 19:33:44+03:00,['9741e4aab6f8c9f11798ce4f872867e3313bf328'],7,7,14,22544593,2,,,,23771
620b5d38e059bfc182680de23a98eaaa2cca24ec,1,Jonathan Hurley,2016-04-13 13:14:48-04:00,['5a52d1576fb7e5a818508908d03816c5014d88c1'],0,432,432,22545025,2,0.55952381,1,1,23773
085b1c0a74c40afc44b970c259f7f33e68dd7621,1,Jonathan Hurley,2016-04-13 13:14:48-04:00,['620b5d38e059bfc182680de23a98eaaa2cca24ec'],11,22,33,22545058,4,0,0,0,23773
c7ba19a33431b46890688d5bb9cd6387146bf36c,1,Nate Cole,2016-04-13 15:45:30-04:00,['085b1c0a74c40afc44b970c259f7f33e68dd7621'],6,122,128,22545186,7,0.1875,0.9375,1,23776
f678554439a60bcf9a5b5894ccd276507a2c2f8d,1,Alejandro Fernandez,2016-04-13 14:43:58-07:00,['c7ba19a33431b46890688d5bb9cd6387146bf36c'],144,143,287,22545473,10,0,1,0,23776
ef156489906570e6b755735659eabbaef6b9dc6c,0,Jayush Luniya,2016-04-13 15:08:59-07:00,['f678554439a60bcf9a5b5894ccd276507a2c2f8d'],12,161,173,22545646,8,,,,23780
7055d9e7be7ca3be1754d37c113b7c7c17da53ce,0,Alexander Denissov,2016-04-13 16:27:17-07:00,['ef156489906570e6b755735659eabbaef6b9dc6c'],1,1,2,22545648,1,,,,23780
bd526e4ff14a66e5a1ebda25b891eb876546cebb,1,Jayush Luniya,2016-04-13 16:34:15-07:00,['7055d9e7be7ca3be1754d37c113b7c7c17da53ce'],343,53,396,22546044,25,0.369230769,0.353846154,0.007692308,23780
bb5322e70df533440ccf8e1df4d4882d75e15754,1,Matt,2016-04-13 17:02:15-07:00,['bd526e4ff14a66e5a1ebda25b891eb876546cebb'],52,34,86,22546130,4,1,0,0,23780
b8ab5fa1a28d678c59be6f86de6494b0780ff020,1,Zhe (Joe) Wang,2016-04-13 17:12:50-07:00,['bb5322e70df533440ccf8e1df4d4882d75e15754'],2425,791,3216,22549346,23,0.717948718,0.004273504,0.123931624,23780
19723f5bfcbb682e2024a2c5d1ed76f4c6c8aefa,1,Aravindan Vijayan,2016-04-13 23:07:24-07:00,['b8ab5fa1a28d678c59be6f86de6494b0780ff020'],4,37,41,22549387,3,0,0,0.954545455,23780
3dd83d6b142825ad3839c8ffaaa91c8acce0dfae,0,ababiichuk,2016-04-14 12:58:02+03:00,['19723f5bfcbb682e2024a2c5d1ed76f4c6c8aefa'],1,11,12,22549399,1,1,1,1,23780
7bd0ad7338718c0f0554904d57c42c1637617c53,1,Dipayan Bhowmick,2016-04-14 18:14:59+05:18,['3dd83d6b142825ad3839c8ffaaa91c8acce0dfae'],54,354,408,22549807,26,0.602941176,0.661764706,0.992647059,23781
a8f1279baeb5fb787a66dfda3f491b5bb88e315f,1,Dmytro Sen,2016-04-14 16:22:25+03:00,['7bd0ad7338718c0f0554904d57c42c1637617c53'],4,93,97,22549904,2,0.314285714,0.685714286,1,23782
081b48d41bc224d7ef880a844b1f228bf4852549,0,tbeerbower,2016-04-14 10:13:52-04:00,['a8f1279baeb5fb787a66dfda3f491b5bb88e315f'],3,1,4,22549908,1,,,,23782
6d081b19a5637e4f5682daf1dcc27f6b1a5e8b60,1,Dmytro Sen,2016-04-14 17:33:44+03:00,['081b48d41bc224d7ef880a844b1f228bf4852549'],0,132,132,22550040,2,0,0.948979592,1,23782
32f7ec368aea96a9cd5147b341802e99e9c6a024,1,Andrew Onishuk,2016-04-14 18:07:35+03:00,['6d081b19a5637e4f5682daf1dcc27f6b1a5e8b60'],8,6,14,22550054,3,1,0.333333333,0,23782
d63147ff0dc8c949a060330a3c593f9f60ad5385,1,oleewere,2016-04-14 17:56:24+02:00,['32f7ec368aea96a9cd5147b341802e99e9c6a024'],3,112,115,22550169,3,0.481481481,1,1,23782
76f831cdf2c5d62518db6d6075bd8632b5350fc3,1,Andrew Onishuk,2016-04-14 20:25:37+03:00,['d63147ff0dc8c949a060330a3c593f9f60ad5385'],2,114,116,22550285,2,0.0125,1,1,23782
dfe6f023af8ffc5716c5c6757bca6f3d60471b0e,1,Andrew Onishuk,2016-04-14 20:29:07+03:00,['76f831cdf2c5d62518db6d6075bd8632b5350fc3'],1,3,4,22550289,1,0,0,0,23782
921fda7054035e1650b818b3bcf3a4621e21dbfc,0,oleewere,2016-04-14 21:36:15+02:00,['dfe6f023af8ffc5716c5c6757bca6f3d60471b0e'],0,5,5,22550294,1,1,1,0,23782
6bd2de218e6def935f7a7e0d68a84f81669776c7,1,Sandor Magyari,2016-04-14 22:14:17+02:00,['921fda7054035e1650b818b3bcf3a4621e21dbfc'],30,80,110,22550404,6,0,1,0.34375,23782
f2b3c2a76f24b9509e21eb8c7f435a5694c268cc,1,Ajit Kumar,2016-04-14 13:52:46-07:00,['6bd2de218e6def935f7a7e0d68a84f81669776c7'],41,57,98,22550502,7,1,1,1,23782
683b7893cd88b5d911424bce6fe541a0243a8b48,1,Jonathan Hurley,2016-04-14 17:04:58-04:00,['f2b3c2a76f24b9509e21eb8c7f435a5694c268cc'],1,5,6,22550508,2,0.5,1,1,23782
fb18e971501e2ef6feb4d884b017a724ce7f3ea6,1,Jaimin Jetly,2016-04-14 14:22:09-07:00,['683b7893cd88b5d911424bce6fe541a0243a8b48'],667,299,966,22551474,3,,,,23783
e8cdf0991a0ed18f5b96fd0298f0802f6d26b9c0,1,Aravindan Vijayan,2016-04-14 14:32:37-07:00,['fb18e971501e2ef6feb4d884b017a724ce7f3ea6'],17,3,20,22551494,3,,,,23783
827fb206976c0ee68d8cfa6c1b3fdfca5e20a093,1,Dipayan Bhowmick,2016-04-15 14:51:43+05:18,['e8cdf0991a0ed18f5b96fd0298f0802f6d26b9c0'],102,1841,1943,22553437,68,0.886462882,1,1,23836
e405be9defb7603a5fbbc02b769cce2dc484f567,1,ababiichuk,2016-04-15 12:48:49+03:00,['827fb206976c0ee68d8cfa6c1b3fdfca5e20a093'],8,22,30,22553467,6,,,,23836
ebc66f70916b8b54873e7f45cc7bd72ce6d52039,1,Vitaly Brodetskyi,2016-04-15 11:41:34+03:00,['e405be9defb7603a5fbbc02b769cce2dc484f567'],0,10,10,22553477,1,,,,23836
94c23298adc0410b963a25290b9eb5d7f6932a65,1,Oleg Nechiporenko,2016-04-15 14:43:14+03:00,['ebc66f70916b8b54873e7f45cc7bd72ce6d52039'],62,44,106,22553583,15,0,0,0,23836
2d3fb6b6babe682e928d01121c9fa8841adf771a,0,Oleg Nechiporenko,2016-04-15 14:43:14+03:00,['94c23298adc0410b963a25290b9eb5d7f6932a65'],3,4,7,22553590,3,0,1,1,23836
4ff99fccb94e11ea705b91a87284c495f605829d,1,Oleg Nechiporenko,2016-04-15 14:43:14+03:00,['2d3fb6b6babe682e928d01121c9fa8841adf771a'],12,54,66,22553656,3,1,1,1,23836
e693406ea3037c41b902981159a292787f8f9855,0,Nate Cole,2016-04-15 08:29:53-04:00,['4ff99fccb94e11ea705b91a87284c495f605829d'],0,1,1,22553657,1,,,,23836
0f299a53a49767d06fbd40ab066995abe4326433,0,Alex Antonenko,2016-04-15 16:01:39+03:00,['e693406ea3037c41b902981159a292787f8f9855'],0,1,1,22553658,1,,,,23836
fdf6eb8a6c80316de0e6ed738a29c22b2f2d831f,1,Lisnichenko Dmitro,2016-04-15 17:02:08+03:00,['0f299a53a49767d06fbd40ab066995abe4326433'],16,107,123,22553781,4,0,0.882352941,1,23836
073eed0d9b653f98b7188797773e6ad1d5b0f69f,1,Aleksandr Kovalenko,2016-04-15 17:08:31+03:00,['fdf6eb8a6c80316de0e6ed738a29c22b2f2d831f'],118,166,284,22554065,6,,,,23838
2491dee6f925f64f0df3aa84813d5a4614e33aa8,1,Jonathan Hurley,2016-04-15 10:33:54-04:00,['073eed0d9b653f98b7188797773e6ad1d5b0f69f'],140,203,343,22554408,7,0,0.64,0.32,23838
57cde8e8393e16f20db50b629e0c0998ebf32dd9,0,Vitaly Brodetskyi,2016-04-15 13:31:16+03:00,['2491dee6f925f64f0df3aa84813d5a4614e33aa8'],0,1,1,22554409,1,,,,23838
ff1b4497bc6f40e14811f23f2ae08cd52e996ea4,1,Lisnichenko Dmitro,2016-04-15 19:07:28+03:00,['57cde8e8393e16f20db50b629e0c0998ebf32dd9'],0,40,40,22554449,2,,,,23838
e3c9816403ebef2f777d48405fb96a43ec46462c,1,Siddharth Wagle,2016-04-15 09:29:52-07:00,['ff1b4497bc6f40e14811f23f2ae08cd52e996ea4'],31,288,319,22554768,8,0.22556391,0.917293233,1,23839
f39a799f3a1dad9e23482cb810151e3f73266ef3,1,Zhe (Joe) Wang,2016-04-15 10:02:35-07:00,['e3c9816403ebef2f777d48405fb96a43ec46462c'],199,178,377,22555145,13,0.916666667,1,1,23839
f2cf51706dd200a7b0091b20f58d63f9b7b565c9,1,Zhe (Joe) Wang,2016-04-15 10:16:24-07:00,['f39a799f3a1dad9e23482cb810151e3f73266ef3'],103,136,239,22555384,5,0,0,0,23839
eb4a4e080860fb12a64614340f0390f926adb551,1,Siddharth Wagle,2016-04-15 10:23:08-07:00,['f2cf51706dd200a7b0091b20f58d63f9b7b565c9'],59,39,98,22555482,5,0,0,,23839
a8bebef30f50d9dad995ba846f1f350230d990ba,1,Vitaly Brodetskyi,2016-04-15 16:25:33+03:00,['eb4a4e080860fb12a64614340f0390f926adb551'],0,2,2,22555484,2,,,,23839
a55c055a8df179d7408520b9f11c795b18468406,0,Bhuvnesh Chaudhary,2016-04-15 12:12:44-07:00,['a8bebef30f50d9dad995ba846f1f350230d990ba'],1,1,2,22555486,1,,,,23839
e5c13a3ada85ffd0ffc8d05171c934eabe6243d8,1,oleewere,2016-04-15 21:12:13+02:00,['a55c055a8df179d7408520b9f11c795b18468406'],458,1657,2115,22557601,14,0.822612086,1,0.945419103,23849
0f9d0b0870e240ca2da47d9d28bc9c298f8edf4b,1,Matt,2016-04-15 12:26:06-07:00,['e5c13a3ada85ffd0ffc8d05171c934eabe6243d8'],10,13,23,22557624,1,0,0,0,23849
e72502dfc0a27189adb097dd4a331b3592f5fc66,0,Jonathan Hurley,2016-04-15 16:00:04-04:00,['0f9d0b0870e240ca2da47d9d28bc9c298f8edf4b'],5,9,14,22557638,1,0,1,1,23849
a2aeb98b5d15c0ae42d26d62ef1cccef4b172827,0,Di Li,2016-04-15 16:13:43-04:00,['e72502dfc0a27189adb097dd4a331b3592f5fc66'],1,17,18,22557656,1,1,1,1,23849
08a93325262d36c93e5ccb47532864bd642d1032,1,Nate Cole,2016-04-15 18:49:31-04:00,['a2aeb98b5d15c0ae42d26d62ef1cccef4b172827'],3,263,266,22557922,4,0.014285714,0.985714286,0.004761905,23849
a224f2657bfe17d6047fa7dbb6dc5599fc964567,1,swapan,2016-04-15 16:58:16-07:00,['08a93325262d36c93e5ccb47532864bd642d1032'],61,1980,2041,22559963,5,0.023081722,0.910168434,0.898315658,23850
d13aa508569c2ee8afce4a746560e7a1d2b0e1a8,1,Jun Aoki,2016-04-15 17:44:10-07:00,['a224f2657bfe17d6047fa7dbb6dc5599fc964567'],38,73,111,22560074,11,0.5,1,0,23851
81c418165dcf154fa89a8fef915418ce611aa1d8,1,Sumit Mohanty,2016-04-15 17:59:24-07:00,['d13aa508569c2ee8afce4a746560e7a1d2b0e1a8'],11,72,83,22560157,2,0.018181818,0.690909091,0.690909091,23851
94d91127ca9a3bea21fa86b899ce8833b1855184,1,Sumit Mohanty,2016-04-15 18:22:34-07:00,['81c418165dcf154fa89a8fef915418ce611aa1d8'],1,20,21,22560178,1,,,,23851
cbb538505857e7f1cb71d9334139759e5af0d9e8,0,Sumit Mohanty,2016-04-15 23:08:45-07:00,['94d91127ca9a3bea21fa86b899ce8833b1855184'],1,1,2,22560180,1,,,,23851
67cb6a4b27b46681a0a3fca8280b4187bd1fe08b,1,Bhuvnesh Chaudhary,2016-04-16 00:10:39-07:00,['cbb538505857e7f1cb71d9334139759e5af0d9e8'],2,6,8,22560188,2,0,1,0,23851
36e3138662489d20df3c8529644b6be687e5ee34,0,Sumit Mohanty,2016-04-16 07:58:22-07:00,['67cb6a4b27b46681a0a3fca8280b4187bd1fe08b'],1,1,2,22560190,1,,,,23851
b8b5d80f0f7983f9dba47c93a2712de9edd5775c,1,oleewere,2016-04-17 16:59:38+02:00,['36e3138662489d20df3c8529644b6be687e5ee34'],0,3,3,22560193,3,,,,23851
b40ae349a5d05be4595620e73c26431c92396114,1,Nahappan Somasundaram,2016-04-17 08:29:26-07:00,['b8b5d80f0f7983f9dba47c93a2712de9edd5775c'],2,114,116,22560309,1,0,0,1,23851
10cda6ed6e86bc16e2c57fbb0468d8e4f8d2b136,1,oleewere,2016-04-18 11:15:43+02:00,['b40ae349a5d05be4595620e73c26431c92396114'],4123,4268,8391,22568700,21,0,0.695652174,1,23861
a788b3517f3508a0d9dc39bcd0bd3a1785b8cba8,1,Dmytro Sen,2016-04-18 12:29:43+03:00,['10cda6ed6e86bc16e2c57fbb0468d8e4f8d2b136'],5,26,31,22568731,2,0,0,1,23861
044094604aea05e64751f404d6c376d5e5f9191e,1,Sandor Magyari,2016-04-18 12:00:44+02:00,['a788b3517f3508a0d9dc39bcd0bd3a1785b8cba8'],31,157,188,22568919,2,0.158536585,0.987804878,0.841463415,23861
ba349039921c10a844e0ca37cd664e1656d6465a,1,Andrii Tkach,2016-04-18 13:11:12+03:00,['044094604aea05e64751f404d6c376d5e5f9191e'],23,106,129,22569048,5,1,0.538461538,1,23861
5d03b5288fc06465a8e0af21aebebc2085c8182b,1,ababiichuk,2016-04-18 14:09:56+03:00,['ba349039921c10a844e0ca37cd664e1656d6465a'],52,74,126,22569174,5,0,0,0,23861
b36dbbdf858de839bdcec48ff9f552f3e113eddc,0,Vitaly Brodetskyi,2016-04-18 10:28:07+03:00,['5d03b5288fc06465a8e0af21aebebc2085c8182b'],0,6,6,22569180,1,,,,23861
4ff426f9b72b1d4080065cd2fd3bc58bf868820a,0,Aleksandr Kovalenko,2016-04-18 16:16:56+03:00,['b36dbbdf858de839bdcec48ff9f552f3e113eddc'],1,8,9,22569189,3,1,1,1,23861
f7f2ebe036395f0c51e4114ab8ab59916635ce63,1,Jonathan Hurley,2016-04-18 10:10:30-04:00,['4ff426f9b72b1d4080065cd2fd3bc58bf868820a'],36,97,133,22569322,4,0.181818182,0.954545455,1,23861
9e154086394d7a98a2139580d3e33a899be87b13,1,oleewere,2016-04-18 18:53:39+02:00,['f7f2ebe036395f0c51e4114ab8ab59916635ce63'],3,115,118,22569440,6,0,1,1,23863
2d554f8c12484bac7fcfcde887e5ef2f561a82b9,1,Yusaku Sako,2016-04-18 10:47:40-07:00,['9e154086394d7a98a2139580d3e33a899be87b13'],633,614,1247,22570687,18,1,0,1,23863
58e7b1259de9f8cf28bb0034c6fa3f134a6d66b6,1,Sumit Mohanty,2016-04-18 11:25:18-07:00,['2d554f8c12484bac7fcfcde887e5ef2f561a82b9'],32,1549,1581,22572268,5,0,0.556034483,0.327586207,23865
10ae6cddfbfe27cdd0ac15297159e4da3b30910f,0,Nahappan Somasundaram,2016-04-18 11:29:57-07:00,['58e7b1259de9f8cf28bb0034c6fa3f134a6d66b6'],21,127,148,22572416,5,0.093023256,0.906976744,0.906976744,23865
4f487e8f8293a674efa9846f03f1f2942991769b,1,Vitaly Brodetskyi,2016-04-18 16:46:47+03:00,['10ae6cddfbfe27cdd0ac15297159e4da3b30910f'],32,27,59,22572475,2,1,1,0,23865
c623e42701c233fbd04f761b23129555c1f47945,0,Dmytro Sen,2016-04-18 23:54:41+03:00,['4f487e8f8293a674efa9846f03f1f2942991769b'],3,35,38,22572513,2,0.142857143,0.714285714,1,23865
acf45f862f111a5c7b6fa17efd87fcfb0933dbd2,1,Nahappan Somasundaram,2016-04-18 14:45:36-07:00,['c623e42701c233fbd04f761b23129555c1f47945'],1,19,20,22572533,1,0,0,1,23865
ef9106762da3f55b66704af6d21e92efcde84448,1,Jaimin Jetly,2016-04-18 16:53:07-07:00,['acf45f862f111a5c7b6fa17efd87fcfb0933dbd2'],79,119,198,22572731,11,0,0.5,0,23867
53dba85138f4c520086ba6e3a7f4f2fcfe32dfec,1,Aravindan Vijayan,2016-04-18 18:01:30-07:00,['ef9106762da3f55b66704af6d21e92efcde84448'],8,572,580,22573311,11,0.356125356,0.655270655,0.943019943,23868
ec9adba8e3c4bc489f35dd41ba02f4824699d44a,1,Jonathan Hurley,2016-04-18 22:51:46-04:00,['53dba85138f4c520086ba6e3a7f4f2fcfe32dfec'],14,138,152,22573463,2,0.814814815,0.814814815,0.592592593,23868
83452cbdc47a6cc8ba57820f2ebb8cfec20c81b0,1,Gautam Borad,2016-04-19 10:31:19+05:18,['ec9adba8e3c4bc489f35dd41ba02f4824699d44a'],256,881,1137,22574600,23,,,,23879
91122e4fc0522762b64048a96a8ad82e646fdd46,1,Oleg Nechiporenko,2016-04-19 10:08:25+03:00,['83452cbdc47a6cc8ba57820f2ebb8cfec20c81b0'],6,16,22,22574622,5,1,1,1,23879
6c192789fe8b6d99c97df35da36dbf70bb3f3144,1,Gautam Borad,2016-04-19 12:37:54+05:18,['91122e4fc0522762b64048a96a8ad82e646fdd46'],37,20,57,22574679,2,0.5,0.6875,0,23879
1faa5acd4102ac8299596445df7744ed26d34d0f,1,Gautam Borad,2016-04-19 14:08:44+05:18,['6c192789fe8b6d99c97df35da36dbf70bb3f3144'],12,34,46,22574725,4,0.789473684,0.789473684,0.105263158,23879
1042f1cd8050874a36be98c12c44f23e5a8abbd5,1,Andrew Onishuk,2016-04-19 13:07:29+03:00,['1faa5acd4102ac8299596445df7744ed26d34d0f'],39,105,144,22574869,4,0.018518519,0.444444444,1,23879
8aac6a10b065589f11bfc24c305a04c9253b9fe2,0,Gautam Borad,2016-04-19 15:58:21+05:18,['1042f1cd8050874a36be98c12c44f23e5a8abbd5'],1,2,3,22574872,1,1,0,0,23879
5c6bb4e4c296e35380441eb493e18fe4d7f65a40,0,Aleksandr Kovalenko,2016-04-19 13:55:39+03:00,['8aac6a10b065589f11bfc24c305a04c9253b9fe2'],7,9,16,22574888,1,1,1,1,23879
3c2492322765584487db4fa5ff354865922e7ed5,1,Aleksandr Kovalenko,2016-04-19 14:45:12+03:00,['5c6bb4e4c296e35380441eb493e18fe4d7f65a40'],9,7,16,22574904,1,0,0,0,23879
8b92561fb3b3c258d1644a0f4c29696771f878dd,1,Aleksandr Kovalenko,2016-04-19 14:47:39+03:00,['3c2492322765584487db4fa5ff354865922e7ed5'],7,9,16,22574920,1,1,1,1,23879
9d4e0228fee794dd729743679fbd5cee0609a8cc,1,Lisnichenko Dmitro,2016-04-19 15:06:27+03:00,['8b92561fb3b3c258d1644a0f4c29696771f878dd'],4,36,40,22574960,2,,,,23879
8965be4cfb1d1d19f7ef7266ef1078d3e55064be,1,Alex Antonenko,2016-04-19 15:20:11+03:00,['9d4e0228fee794dd729743679fbd5cee0609a8cc'],2,2,4,22574964,1,,,,23879
c8a2da207af504a70c19ab903a7cefbade667cbf,0,Andrew Onishuk,2016-04-19 15:26:04+03:00,['8965be4cfb1d1d19f7ef7266ef1078d3e55064be'],29,26,55,22575019,3,1,1,0,23879
3d2ba98fd3cdff011333dafbc8c460552bc20651,1,Lisnichenko Dmitro,2016-04-19 15:33:27+03:00,['c8a2da207af504a70c19ab903a7cefbade667cbf'],19,182,201,22575220,3,0.189873418,1,1,23880
1d4effce606a0ec434032cb2ae56211ab7b86cfa,1,oleewere,2016-04-19 14:50:50+02:00,['3d2ba98fd3cdff011333dafbc8c460552bc20651'],39,318,357,22575577,35,0.216216216,0.635135135,1,23880
381ace20dc16ef4b6ce1ad625e543fb2be6ee0ae,0,Andrii Tkach,2016-04-19 16:10:05+03:00,['1d4effce606a0ec434032cb2ae56211ab7b86cfa'],3,0,3,22575580,1,0,0,0,23880
89fd30b40f3108bfcbcc73eb2d74c94a2ba14a7a,1,tbeerbower,2016-04-19 09:21:40-04:00,['381ace20dc16ef4b6ce1ad625e543fb2be6ee0ae'],76,505,581,22576161,14,0,0.754658385,0.872670807,23883
e5f6b0fd13e5699e9fb48d37917a37d94720f91d,0,Dipayan Bhowmick,2016-04-19 19:49:15+05:18,['89fd30b40f3108bfcbcc73eb2d74c94a2ba14a7a'],0,1,1,22576162,1,,,,23883
c36e4589197f64dd2f834abf9459d1a1a6d57d29,1,Robert Levas,2016-04-19 10:55:09-04:00,['e5f6b0fd13e5699e9fb48d37917a37d94720f91d'],4,24,28,22576190,2,1,1,1,23883
77477c69c9a80ee3c03d3bfcf6807627f9da2b20,0,Robert Levas,2016-04-19 11:06:08-04:00,['c36e4589197f64dd2f834abf9459d1a1a6d57d29'],0,126,126,22576316,1,,,,23884
0a5a721f1ca6e685210a55cdf938a7d14551a0d7,1,Andrew Onishuk,2016-04-19 18:10:11+03:00,['77477c69c9a80ee3c03d3bfcf6807627f9da2b20'],1,71,72,22576388,2,0.965517241,1,1,23885
b32f64c5d2fc4ad27f4ba4f55809ab6a447fa28b,1,Alex Antonenko,2016-04-19 19:21:49+03:00,['0a5a721f1ca6e685210a55cdf938a7d14551a0d7'],2,9,11,22576399,1,,,,23885
5d17bfab711dd6eb4a9f23a60222a9522d91b137,0,Zhe (Joe) Wang,2016-04-19 09:40:40-07:00,['b32f64c5d2fc4ad27f4ba4f55809ab6a447fa28b'],6,8,14,22576413,3,,,,23885
0be4a567b67b68a8aee87e0b15a4b56e86655de3,0,Andrii Tkach,2016-04-19 19:43:42+03:00,['5d17bfab711dd6eb4a9f23a60222a9522d91b137'],1,2,3,22576416,1,,,,23885
92b11fc48ecfe6838512ef7058298b64d248c7c1,0,ababiichuk,2016-04-19 19:52:19+03:00,['0be4a567b67b68a8aee87e0b15a4b56e86655de3'],12,19,31,22576447,3,1,1,0.333333333,23885
22cd004c416205cd8dc60e09a68a29e235d063d5,1,Bob Nettleton,2016-04-19 13:18:36-04:00,['92b11fc48ecfe6838512ef7058298b64d248c7c1'],122,660,782,22577229,15,0.341666667,0.825,1,23888
1fc8fe9fa0e9ada94ca3f523f32ce17642f82849,0,Matt,2016-04-19 10:43:37-07:00,['22cd004c416205cd8dc60e09a68a29e235d063d5'],0,4,4,22577233,1,,,,23888
d4ee11cc087254a26434d5f7cd9677c3096e8eba,1,Jayush Luniya,2016-04-19 11:05:47-07:00,['1fc8fe9fa0e9ada94ca3f523f32ce17642f82849'],11,75,86,22577319,3,0,0.62,0.36,23888
9ed03583b8bdce6be57f482cb88db62d185dd027,0,Jun Aoki,2016-04-19 11:39:16-07:00,['d4ee11cc087254a26434d5f7cd9677c3096e8eba'],0,4,4,22577323,1,1,1,1,23888
4a46fe4d85934be1715973600a1edfcbc6ef72cb,1,Sumit Mohanty,2016-04-19 11:41:37-07:00,['9ed03583b8bdce6be57f482cb88db62d185dd027'],0,7,7,22577330,1,0,0,1,23888
7c6a40901f16313b057874dda00e727bb99a936a,1,Robert Levas,2016-04-19 15:52:26-04:00,['4a46fe4d85934be1715973600a1edfcbc6ef72cb'],443,526,969,22578299,11,1,0,0.172413793,23890
3e88244a35e127b1ff660691f8ad89d77331c450,0,Nahappan Somasundaram,2016-04-19 13:10:03-07:00,['7c6a40901f16313b057874dda00e727bb99a936a'],4,14,18,22578317,1,1,1,0.75,23890
40620860e3c1811c35625c8106c73c2271eaccd7,0,Jonathan Hurley,2016-04-19 16:14:26-04:00,['3e88244a35e127b1ff660691f8ad89d77331c450'],95,98,193,22578510,2,1,0,0,23890
198acaa0186aa2dd62c5aafa67d8510e66aa28aa,1,Richard Zang,2016-04-19 14:05:52-07:00,['40620860e3c1811c35625c8106c73c2271eaccd7'],0,4,4,22578514,1,,,,23890
6eb521d96ec411cec7200c3581a79ed711ad0271,1,Nate Cole,2016-04-19 17:30:48-04:00,['198acaa0186aa2dd62c5aafa67d8510e66aa28aa'],27,221,248,22578762,14,0.107438017,0.785123967,0.347107438,23890
36d2b0c91fb365448ba140015f48616ff9c4426f,1,Ajit Kumar,2016-04-19 15:38:53-07:00,['6eb521d96ec411cec7200c3581a79ed711ad0271'],216,182,398,22579160,116,0.857142857,0,0,23890
0a13257f80dbb6b4b2a7fbef24c8f27e5eeb6278,1,Siddharth Wagle,2016-04-19 15:50:44-07:00,['36d2b0c91fb365448ba140015f48616ff9c4426f'],51,199,250,22579410,5,0.2,0.507692308,0.846153846,23891
43567ff1de4f5260679d70eb784d9955303fca26,1,Aravindan Vijayan,2016-04-19 15:58:28-07:00,['0a13257f80dbb6b4b2a7fbef24c8f27e5eeb6278'],1,70,71,22579481,2,0,0.843137255,1,23891
86dece09b5e78c2fd3094344d62953281289982d,0,Matt,2016-04-19 16:31:09-07:00,['43567ff1de4f5260679d70eb784d9955303fca26'],5,10,15,22579496,2,1,1,1,23891
a02ae60d1ac18d270e85318756d6d6b3b6f0dcee,1,Alejandro Fernandez,2016-04-19 16:58:30-07:00,['86dece09b5e78c2fd3094344d62953281289982d'],75,153,228,22579724,12,0,0.893617021,0.14893617,23891
172eb111144afce79d91d6029945366bd4f0628c,1,swapan,2016-04-19 23:07:40-07:00,['a02ae60d1ac18d270e85318756d6d6b3b6f0dcee'],11,518,529,22580253,12,0.72,0.725,0.355,23897
a26fc867024f91705f8e3e32c6bbc47e6edf89bd,1,"Toader, Sebastian",2016-04-20 11:37:47+02:00,['172eb111144afce79d91d6029945366bd4f0628c'],3,370,373,22580626,2,0.013157895,1,1,23897
9bce349b871517d57b39f54f7427bd50834456e0,0,Alex Antonenko,2016-04-20 15:34:58+03:00,['a26fc867024f91705f8e3e32c6bbc47e6edf89bd'],0,20,20,22580646,2,1,1,1,23897
ee95300414803f77e875a3272e6d2d0ecf24f16b,1,Gautam Borad,2016-04-20 18:24:25+05:18,['9bce349b871517d57b39f54f7427bd50834456e0'],1,300,301,22580947,6,,,,23897
7948fe75d3816e047918138c46ec8137e6f58e2e,1,Andrew Onishuk,2016-04-20 16:43:21+03:00,['ee95300414803f77e875a3272e6d2d0ecf24f16b'],12,12,24,22580971,3,,,,23897
291a6195484c529f464b20ac47b583137d6b5ffd,0,Andrew Onishuk,2016-04-20 18:39:57+03:00,['7948fe75d3816e047918138c46ec8137e6f58e2e'],1,7,8,22580979,1,0,0,1,23897
b5682ff8f25af94ee5bd886a8bf04b6e36258499,1,Andrew Onishuk,2016-04-20 19:20:52+03:00,['291a6195484c529f464b20ac47b583137d6b5ffd'],29,9,38,22581017,1,0.9375,1,0,23897
8c6796f38bb9be8f4b9f88dce35861ad4ce653d3,1,Zhe (Joe) Wang,2016-04-20 10:08:12-07:00,['b5682ff8f25af94ee5bd886a8bf04b6e36258499'],6,19,25,22581042,5,0,1,1,23897
c6c4d5ecf615da3bfa537e152f7f316196360440,1,Robert Levas,2016-04-20 15:48:43-04:00,['8c6796f38bb9be8f4b9f88dce35861ad4ce653d3'],14,11,25,22581067,7,1,0,0,23897
7046b2ba1728218d3550210a761e8dbcb8411e54,1,Xi Wang,2016-04-20 13:34:36-07:00,['c6c4d5ecf615da3bfa537e152f7f316196360440'],869,2388,3257,22584324,30,0.25464684,0.949814126,0.875464684,23898
e6a449f5e09826604cfb25ddce6c034338c4fb9f,1,Swapan Shridhar,2016-04-20 13:58:25-07:00,['7046b2ba1728218d3550210a761e8dbcb8411e54'],26,133,159,22584483,3,0.071428571,1,0,23899
5af48693efa2dad3b702f64f87e6daaec253c869,1,Ajit Kumar,2016-04-20 15:26:33-07:00,['e6a449f5e09826604cfb25ddce6c034338c4fb9f'],70,543,613,22585096,20,0.854748603,1,0.899441341,23905
cc10ec0b4acdfb522ff193fc66f777aa82b9f6be,1,Ajit Kumar,2016-04-20 16:01:24-07:00,['5af48693efa2dad3b702f64f87e6daaec253c869'],84,77,161,22585257,4,1,1,0,23905
460f493a88371a9fabe9754db0dd831a3b1afdc4,0,Ajit Kumar,2016-04-20 21:40:34-07:00,['cc10ec0b4acdfb522ff193fc66f777aa82b9f6be'],1,0,1,22585258,1,1,0,0,23905
02627054ed67bdc1b9e5eb8fd5b25b0607a518c3,1,Dmytro Sen,2016-04-21 09:57:42+03:00,['460f493a88371a9fabe9754db0dd831a3b1afdc4'],26,814,840,22586098,24,0.009090909,0.963636364,0.981818182,23906
e7f84d7181858a9f7acfbac79dbe1ee026504cac,0,Andrii Tkach,2016-04-21 12:18:03+03:00,['02627054ed67bdc1b9e5eb8fd5b25b0607a518c3'],2,2,4,22586102,1,,,,23906
973b3de303999cd44e0c4596bf4cba456dc5aae9,1,oleewere,2016-04-21 11:37:16+02:00,['e7f84d7181858a9f7acfbac79dbe1ee026504cac'],3,374,377,22586479,3,,,,23906
75f02a912ba61e1cedac214b8359ba1b7d588d10,0,oleewere,2016-04-21 11:37:16+02:00,['973b3de303999cd44e0c4596bf4cba456dc5aae9'],1,1,2,22586481,1,,,,23906
32ba72830fccebfca99cac880ee5ead64e6b7d0b,0,Andrew Onishuk,2016-04-21 12:55:58+03:00,['75f02a912ba61e1cedac214b8359ba1b7d588d10'],2,2,4,22586485,1,,,,23906
fce65dbad67e9346b54b5389bcad1b90aafad20c,0,Dmytro Sen,2016-04-21 13:36:23+03:00,['32ba72830fccebfca99cac880ee5ead64e6b7d0b'],21,21,42,22586527,4,,,,23906
8a6141a46808ac28a04dbcd5ee4b9d204b4eea38,1,Andrew Onishuk,2016-04-21 13:36:49+03:00,['fce65dbad67e9346b54b5389bcad1b90aafad20c'],10,9,19,22586546,3,0,1,1,23906
0c73a4b4fe4dc1e8eb6d305ecd90c2fcb78af8ff,0,Dmytro Sen,2016-04-21 14:11:48+03:00,['8a6141a46808ac28a04dbcd5ee4b9d204b4eea38'],1,1,2,22586548,1,,,,23906
b842054596eb3723104eef5d5f6c8c8c7e0ee439,1,Alex Antonenko,2016-04-21 14:45:16+03:00,['0c73a4b4fe4dc1e8eb6d305ecd90c2fcb78af8ff'],2388,869,3257,22589805,30,0.74535316,0.050185874,0.124535316,23906
7799ac32fb9dc75b823069876a44f438961ba8aa,1,Vitaly Brodetskyi,2016-04-21 06:10:11+03:00,['b842054596eb3723104eef5d5f6c8c8c7e0ee439'],0,12,12,22589817,1,,,,23906
a242621822867b548da84b3cdcb8bad8c6dd2e50,1,Lisnichenko Dmitro,2016-04-21 16:25:27+03:00,['7799ac32fb9dc75b823069876a44f438961ba8aa'],11,184,195,22590012,5,0.23853211,0.23853211,0.550458716,23906
346dfe7eb78b8a71e4981c034fb2f3fddba0db81,1,"Toader, Sebastian",2016-04-21 15:50:58+02:00,['a242621822867b548da84b3cdcb8bad8c6dd2e50'],2401,3028,5429,22595441,9,0.487068966,0.5625,0.829741379,23908
8006d3d6a77615b43aeb619bac6231d9f3ff2b75,1,Gautam Borad,2016-04-21 19:12:01+05:18,['346dfe7eb78b8a71e4981c034fb2f3fddba0db81'],4,266,270,22595711,9,0,0,1,23911
2adf08faa41dc9bfd602186585f026cb977858a3,0,Andrew Onishuk,2016-04-21 17:00:02+03:00,['8006d3d6a77615b43aeb619bac6231d9f3ff2b75'],39,65,104,22595815,2,0,1,0.9375,23911
4a6dadc3c25d33298865e1f0fec83624834c16c1,0,Dmytro Sen,2016-04-21 17:04:54+03:00,['2adf08faa41dc9bfd602186585f026cb977858a3'],85,0,85,22595900,1,,,,23911
9be2ba28880dd7a87d3bd246d9566f0f745ce6c2,1,Andrew Onishuk,2016-04-21 17:14:39+03:00,['4a6dadc3c25d33298865e1f0fec83624834c16c1'],128,162,290,22596190,82,0,0,0,23911
dc6cde341097308aca190b1dde38591f90108b17,1,Ajit Kumar,2016-04-21 07:20:40-07:00,['9be2ba28880dd7a87d3bd246d9566f0f745ce6c2'],13,80,93,22596283,2,0.872340426,1,1,23911
6e46135ba1166da28321ad092c2207b570b6f83f,0,Nate Cole,2016-04-21 10:22:08-04:00,['dc6cde341097308aca190b1dde38591f90108b17'],3,10,13,22596296,1,0,0,1,23911
8416c0df87282329be143cca13b5bbfc62e630c8,1,Lisnichenko Dmitro,2016-04-21 17:48:27+03:00,['6e46135ba1166da28321ad092c2207b570b6f83f'],0,53,53,22596349,2,0.027777778,1,1,23911
5b5bf1a34b1b060202421fcdb91a73f47376c273,0,"Toader, Sebastian",2016-04-21 19:09:56+02:00,['8416c0df87282329be143cca13b5bbfc62e630c8'],0,16,16,22596365,2,1,1,1,23911
783b4d39213b5819037f4eb707754a32eb722b71,1,Robert Levas,2016-04-21 13:59:18-04:00,['5b5bf1a34b1b060202421fcdb91a73f47376c273'],2,70,72,22596437,2,0,0.962962963,0.981481481,23911
c3a72eb3079538b0ff6caabdf3fa78e43046cc27,0,Alex Antonenko,2016-04-21 21:25:21+03:00,['783b4d39213b5819037f4eb707754a32eb722b71'],2,0,2,22596439,1,,,,23911
04f7d5c3efe8af2c43824f32c1ce04d2ddc6cee2,1,Richard Zang,2016-04-21 11:29:27-07:00,['c3a72eb3079538b0ff6caabdf3fa78e43046cc27'],17,41,58,22596497,1,0.863636364,1,1,23911
360fcfeb82d45cb0db0ce3e857ab2ac327d7ca99,1,Alejandro Fernandez,2016-04-21 13:29:12-07:00,['04f7d5c3efe8af2c43824f32c1ce04d2ddc6cee2'],13,28,41,22596538,3,1,1,0.5,23911
5534cd5231afaf466775cbffceee252d115dcd5f,0,Swapan Shridhar,2016-04-21 13:51:50-07:00,['360fcfeb82d45cb0db0ce3e857ab2ac327d7ca99'],9,1,10,22596548,1,0,0,0,23911
d408e2c808138a23dbf4d038a8ebde9fbd1bb9a4,1,Dmytro Sen,2016-04-22 00:50:13+03:00,['5534cd5231afaf466775cbffceee252d115dcd5f'],12,72,84,22596632,2,0.155172414,0.724137931,1,23911
1c7a284b2f2747670cd8d68292f29930312d3fc1,1,Jaimin Jetly,2016-04-21 15:56:29-07:00,['d408e2c808138a23dbf4d038a8ebde9fbd1bb9a4'],26,181,207,22596839,10,0.628205128,0.692307692,0.987179487,23911
9c142715019fb028bf9ee5acad5343dc4b0a9d04,1,Bob Nettleton,2016-04-21 19:23:06-04:00,['1c7a284b2f2747670cd8d68292f29930312d3fc1'],62,793,855,22597694,3,0.027149321,1,0.977375566,23912
e508c2244684b590aaafa2547e8a5db61e125ecf,0,Yusaku Sako,2016-04-21 17:19:37-07:00,['9c142715019fb028bf9ee5acad5343dc4b0a9d04'],20,26,46,22597740,7,,,,23912
6ce711bcbc390bae1ee5b070d9d2ea4a3d62d09d,1,Aravindan Vijayan,2016-04-21 20:06:52-07:00,['e508c2244684b590aaafa2547e8a5db61e125ecf'],31,38,69,22597809,8,0,0,0.636363636,23912
b2c3daa89d1d0d337eaeb93b050313baa42bf710,1,Oleg Nechiporenko,2016-04-22 09:56:13+03:00,['6ce711bcbc390bae1ee5b070d9d2ea4a3d62d09d'],183,335,518,22598327,2,1,1,1,23912
80c803b8caeb6787442f91abd3d75c3dfa3119c3,1,Andrii Tkach,2016-04-22 11:17:54+03:00,['b2c3daa89d1d0d337eaeb93b050313baa42bf710'],8,12,20,22598347,2,,,,23912
bf2a6445c9fef7d0a606a2bf57d4411f3d70862a,0,Pallav Kulshreshtha,2016-04-22 14:12:38+05:18,['80c803b8caeb6787442f91abd3d75c3dfa3119c3'],1,1,2,22598349,1,,,,23912
3e3bb2dab8f7a3d2777c8df31bc18f7be86eac5e,1,Pallav Kulshreshtha,2016-04-22 14:17:13+05:18,['bf2a6445c9fef7d0a606a2bf57d4411f3d70862a'],19,79,98,22598447,9,0.391304348,0,1,23912
33c01273e919e344f5a062d5666ec9404b19d513,1,Andrew Onishuk,2016-04-22 12:56:23+03:00,['3e3bb2dab8f7a3d2777c8df31bc18f7be86eac5e'],56,71,127,22598574,4,0,0.642857143,1,23912
1734b5c7ba965d9a4939d139463a1d2e6950d3da,0,Oleg Nechiporenko,2016-04-22 13:12:04+03:00,['33c01273e919e344f5a062d5666ec9404b19d513'],26,121,147,22598721,9,1,1,1,23915
5db6f1d21f05b61d9da1240da693350021984001,1,tbeerbower,2016-04-22 07:20:20-04:00,['1734b5c7ba965d9a4939d139463a1d2e6950d3da'],10,178,188,22598909,13,0,1,1,23916
5d92271a63a247ca98a0903ff1e0d734c9060d3d,0,ababiichuk,2016-04-22 16:25:50+03:00,['5db6f1d21f05b61d9da1240da693350021984001'],0,15,15,22598924,1,1,1,1,23916
cc5aded3b5ff25f9918b101e20fc1234fe773096,1,Aleksandr Kovalenko,2016-04-22 16:38:41+03:00,['5d92271a63a247ca98a0903ff1e0d734c9060d3d'],20,31,51,22598975,24,0.846153846,1,1,23916
7232ea8dc26d8b7a4668c00c392b949af8aeb41e,1,oleewere,2016-04-22 17:46:36+02:00,['cc5aded3b5ff25f9918b101e20fc1234fe773096'],25,60,85,22599060,5,1,1,0.791666667,23916
55c5f7e03360ffb701d9ca380e06c19609f72f7e,0,Jonathan Hurley,2016-04-22 14:17:39-04:00,['7232ea8dc26d8b7a4668c00c392b949af8aeb41e'],0,2,2,22599062,2,,,,23916
693e758a2e46f0c7b8a92eb96f36efba82331d9d,0,Jayush Luniya,2016-04-22 11:41:04-07:00,['55c5f7e03360ffb701d9ca380e06c19609f72f7e'],7,51,58,22599120,3,0.428571429,0.685714286,1,23916
5fc46180435bcd1aebcfc650d12a2ff4c752c9ae,1,oleewere,2016-04-22 21:23:21+02:00,['693e758a2e46f0c7b8a92eb96f36efba82331d9d'],0,402,402,22599522,4,0.053571429,0.053571429,0.053571429,23919
108a1209b4724f365bc53da55919d544dcff70bd,1,Jayush Luniya,2016-04-22 13:35:35-07:00,['5fc46180435bcd1aebcfc650d12a2ff4c752c9ae'],9,8,17,22599539,1,1,1,0,23919
9906c393aaa2be37c2ef815d90ed7eaccac59b45,1,Zhe (Joe) Wang,2016-04-22 15:12:19-07:00,['108a1209b4724f365bc53da55919d544dcff70bd'],2,3,5,22599544,2,0,,,23919
4ddaed0eb7ae617c85b7ddd97b84e3d47f4194bd,1,Alejandro Fernandez,2016-04-22 15:23:43-07:00,['9906c393aaa2be37c2ef815d90ed7eaccac59b45'],10,173,183,22599727,11,0.691176471,0.691176471,0.926470588,23919
e8cc06400ec2080e88b365eeab72f35a97df9ecf,1,Yusaku Sako,2016-04-22 16:25:09-07:00,['4ddaed0eb7ae617c85b7ddd97b84e3d47f4194bd'],0,2469,2469,22602196,3,,,,23922
550a5ff09c30f1065102115b21340c7eaeb1d414,0,Yusaku Sako,2016-04-22 16:29:52-07:00,['e8cc06400ec2080e88b365eeab72f35a97df9ecf'],1,1,2,22602198,1,,,,23922
d14654bf5f9eee40fb9dce57f9c1f53643637571,1,Jaimin Jetly,2016-04-22 17:00:46-07:00,['550a5ff09c30f1065102115b21340c7eaeb1d414'],151,326,477,22602675,18,0.007142857,1,1,23922
9c53dffb95b55d91c594c90ef22f21b5eb0030e5,0,Jayush Luniya,2016-04-22 23:11:22-07:00,['d14654bf5f9eee40fb9dce57f9c1f53643637571'],185,123,308,22602983,56,0,0,0,23922
f63c8db05405dad85582d8c843e994015cdfee83,0,Sumit Mohanty,2016-04-23 12:47:15-07:00,['9c53dffb95b55d91c594c90ef22f21b5eb0030e5'],0,2,2,22602985,1,0,1,1,23922
0a336e156eca7dd67579fadd07d516bd727f83af,1,Nate Cole,2016-04-23 22:22:51-04:00,['f63c8db05405dad85582d8c843e994015cdfee83'],13,19,32,22603017,2,,,,23922
a28f1e48e6a85ddba3c138559ce59f1bfb4b4cbf,0,Andrew Onishuk,2016-04-24 13:34:35+03:00,['0a336e156eca7dd67579fadd07d516bd727f83af'],1,1,2,22603019,1,,,,23922
3ea71e3338a0e9a9e300f3279686e6e04ddd8060,0,Robert Levas,2016-04-24 07:35:47-04:00,['a28f1e48e6a85ddba3c138559ce59f1bfb4b4cbf'],8,289,297,22603316,5,0,0.872037915,0.995260664,23922
3024c43bdfe437ad3db7970ed3d2a779668f21cb,0,Sumit Mohanty,2016-04-24 07:12:41-07:00,['3ea71e3338a0e9a9e300f3279686e6e04ddd8060'],12,81,93,22603409,2,0,1,1,23922
412af4295842302233a30279f928226e23b7d356,1,Sumit Mohanty,2016-04-24 11:03:54-07:00,['3024c43bdfe437ad3db7970ed3d2a779668f21cb'],2,28,30,22603439,1,0.75,1,1,23922
67303c0db4468f9589a1483406d8da04498228f2,1,Andrew Onishuk,2016-04-25 07:33:02+03:00,['412af4295842302233a30279f928226e23b7d356'],22,374,396,22603835,46,0.977358491,0.981132075,0.966037736,23922
004d496038ed408f83ca7db5ba3f60b86d7ca123,0,Gautam Borad,2016-04-25 10:27:26+05:18,['67303c0db4468f9589a1483406d8da04498228f2'],6,25,31,22603866,7,,,0,23922
f4e0db98bf34ebe132537d6d40b13ee76bf3caf4,1,Vitaly Brodetskyi,2016-04-25 00:26:04+03:00,['004d496038ed408f83ca7db5ba3f60b86d7ca123'],4,22,26,22603892,1,0,0,0,23922
b2ef85bf7254694823b45655033d305e27fc8cf1,0,ababiichuk,2016-04-25 12:08:24+03:00,['f4e0db98bf34ebe132537d6d40b13ee76bf3caf4'],0,18,18,22603910,8,,,,23922
8a20810b208e02b32a77045a7f3b68eb88575b5f,1,ababiichuk,2016-04-25 12:14:11+03:00,['b2ef85bf7254694823b45655033d305e27fc8cf1'],0,8,8,22603918,2,1,1,1,23922
0806468bedeb764f2d97025cb086944e482ace84,1,oleewere,2016-04-25 12:01:46+02:00,['8a20810b208e02b32a77045a7f3b68eb88575b5f'],22,18,40,22603958,3,0,0,0.5,23922
ab41bca8d6cca9970b119598cc5fb5a9faa39b0f,1,Gautam Borad,2016-04-25 18:39:44+05:18,['0806468bedeb764f2d97025cb086944e482ace84'],2,284,286,22604244,8,0,0,1,23925
b33b9805989ce31e790ad3f81b951f9cf7536955,1,Gautam Borad,2016-04-25 19:16:24+05:18,['ab41bca8d6cca9970b119598cc5fb5a9faa39b0f'],24,394,418,22604662,11,0.5,0.5,0.636363636,23928
25ed583ee7926456a3ade0ba0644ccd2608b3aaf,0,Di Li,2016-04-25 10:20:32-04:00,['b33b9805989ce31e790ad3f81b951f9cf7536955'],5,33,38,22604700,1,0.88,1,0.36,23928
888faf260d2d9fc454072ed69d1149c733ca98f0,1,oleewere,2016-04-25 17:10:34+02:00,['25ed583ee7926456a3ade0ba0644ccd2608b3aaf'],2668,5346,8014,22612714,105,0.439622642,0.1,0.432075472,23930
cda7f2a3eb82a494a09ffca1a1c75ba3d658e307,0,oleewere,2016-04-25 17:10:34+02:00,['888faf260d2d9fc454072ed69d1149c733ca98f0'],18,53,71,22612785,7,,,,23930
134a15daf10bf1ca6079480a68acf9949424b125,1,tbeerbower,2016-04-25 11:38:57-04:00,['cda7f2a3eb82a494a09ffca1a1c75ba3d658e307'],2,138,140,22612925,4,0.076190476,1,0.933333333,23930
d917dd9d6ba8a9d995842072631d91fbfe3b7159,1,Vitaly Brodetskyi,2016-04-25 07:25:01+03:00,['134a15daf10bf1ca6079480a68acf9949424b125'],0,2,2,22612927,1,0,0,0,23930
aa6a2a9ceec8c8dae5c493debf12e6b6a69f0f1d,1,oleewere,2016-04-25 18:31:51+02:00,['d917dd9d6ba8a9d995842072631d91fbfe3b7159'],180,2037,2217,22615144,45,0.581920904,0.679378531,0.922316384,23953
b70758413013351b4af10239b1ef661327294784,1,Jonathan Hurley,2016-04-25 13:18:12-04:00,['aa6a2a9ceec8c8dae5c493debf12e6b6a69f0f1d'],94,365,459,22615603,13,0,0.883116883,0.714285714,23953
51cd067b056adb1013a168b59b8d65d1e2946a0c,1,Lisnichenko Dmitro,2016-04-25 20:23:21+03:00,['b70758413013351b4af10239b1ef661327294784'],12,180,192,22615795,4,0,0.652173913,0.905797101,23953
97b83d599a9ab212a869bd212bb6f5ffccb33bf0,1,Andrii Tkach,2016-04-25 20:28:30+03:00,['51cd067b056adb1013a168b59b8d65d1e2946a0c'],53,18,71,22615866,7,,,,23953
12c43397f835339e7751bf0cb5a7e5b1970adc15,1,oleewere,2016-04-25 20:37:05+02:00,['97b83d599a9ab212a869bd212bb6f5ffccb33bf0'],18,53,71,22615937,7,,,,23953
e1e51217e801696640ea5fa25b3d4e7fb61be412,1,Bob Nettleton,2016-04-25 14:41:06-04:00,['12c43397f835339e7751bf0cb5a7e5b1970adc15'],5,353,358,22616295,4,0.487951807,0.993975904,0.873493976,23955
fb90e9b2081dce6b87ef03ad8c0cb7c642b7cfbb,0,Andrew Onishuk,2016-04-25 22:04:20+03:00,['e1e51217e801696640ea5fa25b3d4e7fb61be412'],14,9,23,22616318,1,1,1,1,23955
020b1c7872c2fe88a19c5ed087de22db38db7ddc,0,Andrew Onishuk,2016-04-25 22:42:18+03:00,['fb90e9b2081dce6b87ef03ad8c0cb7c642b7cfbb'],9,14,23,22616341,1,0,0,0,23955
acfa1c0e7a9b8513eb74747008a43d70728e07bb,0,Andrew Onishuk,2016-04-25 22:51:25+03:00,['020b1c7872c2fe88a19c5ed087de22db38db7ddc'],14,9,23,22616364,1,1,1,1,23955
6db7fa262b757e9b9e255627a005a500d4a18eb5,0,Alex Antonenko,2016-04-25 23:55:36+03:00,['acfa1c0e7a9b8513eb74747008a43d70728e07bb'],0,24,24,22616388,4,0.647058824,0.647058824,1,23955
b9bbb6a5f39579817502073e82499f3ff5df7a40,1,Richard Zang,2016-04-25 14:08:30-07:00,['6db7fa262b757e9b9e255627a005a500d4a18eb5'],3,27,30,22616418,2,0.260869565,1,0.869565217,23955
29179e766f957bd61feae767ec2c34655ef080b0,1,Swapan Shridhar,2016-04-25 16:41:53-07:00,['b9bbb6a5f39579817502073e82499f3ff5df7a40'],147,2340,2487,22618905,9,0.05840708,0.919764012,0.843067847,23955
47510ed78590116dd3c34c89b47a43b45abb1fba,0,Matt,2016-04-25 21:12:30-07:00,['29179e766f957bd61feae767ec2c34655ef080b0'],10,185,195,22619100,8,0.914634146,0.93902439,1,23957
d718d3de1dbb067cf284430f37cd03453e703e1d,1,Swapan Shridhar,2016-04-25 22:00:28-07:00,['47510ed78590116dd3c34c89b47a43b45abb1fba'],99,101,200,22619300,1,,,,23957
614b12fc382fee77b63f253926bab6aa359ae5df,1,Dipayan Bhowmick,2016-04-26 12:13:56+05:18,['d718d3de1dbb067cf284430f37cd03453e703e1d'],27,2502,2529,22621829,39,0.563616071,0.977678571,0.863839286,23972
f62a927708bddb5f1dffe7342131cb307a550eee,1,Dipayan Bhowmick,2016-04-26 12:21:26+05:18,['614b12fc382fee77b63f253926bab6aa359ae5df'],246,1853,2099,22623928,44,0.764932563,0.973025048,0.971098266,23985
784c5414d4ee0e1cb475a91ea2e854b3695986ec,1,Lisnichenko Dmitro,2016-04-26 10:09:35+03:00,['f62a927708bddb5f1dffe7342131cb307a550eee'],0,236,236,22624164,3,0.435897436,1,0.935897436,23987
dbf42773bd03842fcadead813a72f39c1e851a9b,0,Andrii Tkach,2016-04-26 12:10:05+03:00,['784c5414d4ee0e1cb475a91ea2e854b3695986ec'],39,53,92,22624256,5,0.214285714,1,1,23987
9f10816fc83ad4394a5726dcee6e8b4d028edea7,1,Dipayan Bhowmick,2016-04-26 14:58:16+05:18,['dbf42773bd03842fcadead813a72f39c1e851a9b'],0,1,1,22624257,1,,,,23987
75aae4551069b435caeb4e59b31c45f6d2e83e03,0,oleewere,2016-04-26 11:57:54+02:00,['9f10816fc83ad4394a5726dcee6e8b4d028edea7'],6,6,12,22624269,2,,,,23987
ee4dfb96337e05ed177e1783335c0c347cded96d,1,Aleksandr Kovalenko,2016-04-26 13:37:11+03:00,['75aae4551069b435caeb4e59b31c45f6d2e83e03'],0,1,1,22624270,1,1,1,1,23987
071c175a119c54f26cb12a092992d18e69a425ba,1,oleewere,2016-04-26 14:22:10+02:00,['ee4dfb96337e05ed177e1783335c0c347cded96d'],1018,5,1023,22625293,11,0.229038855,0.206543967,0.022494888,23987
962be15c765346b7dd4e2059e6c1cf4227190e9c,1,Nate Cole,2016-04-26 08:59:13-04:00,['071c175a119c54f26cb12a092992d18e69a425ba'],2096,2209,4305,22629598,1,0.243902439,0.804878049,0,23987
980420449d7b31994f1e21f5959a78d239a4b819,0,Nate Cole,2016-04-26 09:20:43-04:00,['962be15c765346b7dd4e2059e6c1cf4227190e9c'],6,68,74,22629672,2,0,0.971428571,1,23987
2e2588efc5dbc12b16e58e8f709e600acd7decd1,1,Robert Levas,2016-04-26 10:54:23-04:00,['980420449d7b31994f1e21f5959a78d239a4b819'],18,91,109,22629781,2,0,1,1,23987
8add212b39500c2e38f389bf59ed427acce7c5ce,1,Dmytro Sen,2016-04-26 17:56:22+03:00,['2e2588efc5dbc12b16e58e8f709e600acd7decd1'],1,36,37,22629818,2,0.56,0.56,0.56,23987
4c4879e439a953fd7556fffa81704eae5e0bb048,1,Dmytro Sen,2016-04-26 18:08:31+03:00,['8add212b39500c2e38f389bf59ed427acce7c5ce'],4,19,23,22629841,2,0,0,1,23987
b24f72f60313e887d4073f5786142d15d6ec65b7,1,ababiichuk,2016-04-26 18:13:16+03:00,['4c4879e439a953fd7556fffa81704eae5e0bb048'],1,2,3,22629844,1,,,,23987
694a2d839d4f5edb25587fec98f745b2c6e6266c,1,Lisnichenko Dmitro,2016-04-26 18:24:51+03:00,['b24f72f60313e887d4073f5786142d15d6ec65b7'],14,14,28,22629872,2,,,,23987
56e3491e5f50d73c3a8a455fe8efe9036a6a456e,0,Nate Cole,2016-04-26 12:55:26-04:00,['694a2d839d4f5edb25587fec98f745b2c6e6266c'],3,7,10,22629882,1,0,1,1,23987
af9654ff12baf24935ac8846435143db50ff04da,1,Dipayan Bhowmick,2016-04-26 22:40:54+05:18,['56e3491e5f50d73c3a8a455fe8efe9036a6a456e'],0,6213,6213,22636095,33,0.14888535,0.592754777,0.482882166,24019
e6fc15dfcdab59d306ac7aef9b60770cf147f832,1,Sumit Mohanty,2016-04-26 10:25:27-07:00,['af9654ff12baf24935ac8846435143db50ff04da'],1,1251,1252,22637347,4,0.457142857,0.685714286,1,24020
2816fc229d5d123c780068a014b1dcdc6f5a191b,1,Jaimin Jetly,2016-04-26 10:27:14-07:00,['e6fc15dfcdab59d306ac7aef9b60770cf147f832'],2,376,378,22637725,13,0,0.660377358,0.811320755,24025
e1cf8db0d568b3ffbc25bb8dcb6a591399ad5eb4,1,Swapan Shridhar,2016-04-26 10:43:34-07:00,['2816fc229d5d123c780068a014b1dcdc6f5a191b'],2,4,6,22637731,1,0,0,0,24025
39320fd8ada68ee4bfbb016926f1f3c69508cca7,0,Bhuvnesh Chaudhary,2016-04-26 11:11:06-07:00,['e1cf8db0d568b3ffbc25bb8dcb6a591399ad5eb4'],1,1,2,22637733,1,,,,24025
a763ace5ef86bce33ef4539f47c3d0ec22d16d87,1,Jaimin Jetly,2016-04-26 11:53:04-07:00,['39320fd8ada68ee4bfbb016926f1f3c69508cca7'],9,9,18,22637751,2,,0,,24025
f9e70802c7833e7e49b306a7bf0004dbb25bc08f,1,Vitaly Brodetskyi,2016-04-26 10:42:45+03:00,['a763ace5ef86bce33ef4539f47c3d0ec22d16d87'],1,1,2,22637753,1,,,,24025
fee485798ea0f271f51a41d6e05386ed28b9b755,0,"Toader, Sebastian",2016-04-26 21:16:13+02:00,['f9e70802c7833e7e49b306a7bf0004dbb25bc08f'],2,10,12,22637765,1,0,0,1,24025
88f82ebfaecf157df8a7d590516bd7d64d240099,1,Alejandro Fernandez,2016-04-26 16:37:14-07:00,['fee485798ea0f271f51a41d6e05386ed28b9b755'],289,8,297,22638062,5,1,0.127962085,0.004739336,24025
5fecb4e05fa2d33aabfcbccc487fe4d6d441ce5e,0,Swapan Shridhar,2016-04-26 16:38:24-07:00,['88f82ebfaecf157df8a7d590516bd7d64d240099'],1,1,2,22638064,1,,,,24025
dd237dd8ed10b938010e297a04fecf5f7cfce03f,0,Oleg Nechiporenko,2016-04-27 10:51:54+03:00,['5fecb4e05fa2d33aabfcbccc487fe4d6d441ce5e'],9,24,33,22638097,3,1,1,0.785714286,24025
a5807823299cc575e8269167a6c0f45b003bb60c,1,Andrew Onishuk,2016-04-27 12:22:07+03:00,['dd237dd8ed10b938010e297a04fecf5f7cfce03f'],2,2,4,22638101,1,,,,24025
03ce1907b795ee6bbd15b685eda4271e61feada9,1,oleewere,2016-04-27 13:19:00+02:00,['a5807823299cc575e8269167a6c0f45b003bb60c'],140,206,346,22638447,24,,,,24026
d0d86edd57cf5a0f50058bf7fa621f8874136bd3,1,Sandor Magyari,2016-04-27 14:23:53+02:00,['03ce1907b795ee6bbd15b685eda4271e61feada9'],1,10,11,22638458,3,0,0,0.5,24026
e8a79db74252a01cd530ce7dc796863eaa733945,1,Andrew Onishuk,2016-04-27 15:50:22+03:00,['d0d86edd57cf5a0f50058bf7fa621f8874136bd3'],67,206,273,22638731,1,0.257425743,0,1,24026
fbd53ed757e63b6370e7f83c232c09912a93653e,1,Dmytro Sen,2016-04-27 16:32:36+03:00,['e8a79db74252a01cd530ce7dc796863eaa733945'],48,49,97,22638828,7,,,,24026
bff239c08cb0409898f71c764c0514c03b0ca087,0,Nate Cole,2016-04-27 10:27:55-04:00,['fbd53ed757e63b6370e7f83c232c09912a93653e'],40,0,40,22638868,1,1,1,0,24026
025b3446ffe4c3389654932e5b9b619432c25d36,1,Bob Nettleton,2016-04-27 11:40:14-04:00,['bff239c08cb0409898f71c764c0514c03b0ca087'],26,118,144,22639012,5,0,1,1,24026
4104f2f9d61dbc3d01ea8dfcbfe9faa6ece2b03c,1,tbeerbower,2016-04-27 13:57:47-04:00,['025b3446ffe4c3389654932e5b9b619432c25d36'],3,281,284,22639296,6,0,1,1,24026
85ac3c22ea6aedd4a75e79ee25798677e07a7bdd,1,Jonathan Hurley,2016-04-27 14:07:17-04:00,['4104f2f9d61dbc3d01ea8dfcbfe9faa6ece2b03c'],48,434,482,22639778,6,0.188679245,0.943396226,0.735849057,24028
6a906e6309d634461d683f38badc0b5440cff5e0,1,Hitesh Shah,2016-04-27 11:29:36-07:00,['85ac3c22ea6aedd4a75e79ee25798677e07a7bdd'],76,107,183,22639961,3,1,1,1,24028
0b02517ad0b44a4b90d2fd856fd86dd61634f4d8,1,Vitaly Brodetskyi,2016-04-27 10:19:31+03:00,['6a906e6309d634461d683f38badc0b5440cff5e0'],0,42,42,22640003,2,0,0.111111111,1,24028
1c29f1df06db04e744b6a3342f341977442472ae,0,Jaimin Jetly,2016-04-27 11:56:21-07:00,['0b02517ad0b44a4b90d2fd856fd86dd61634f4d8'],5,67,72,22640075,3,1,1,1,24028
116d9853461c6fc81e32a28c11b73ffb65849d44,1,Sumit Mohanty,2016-04-27 14:56:34-07:00,['1c29f1df06db04e744b6a3342f341977442472ae'],6,14,20,22640095,2,0.833333333,0.833333333,0,24028
80f1beaac13812a5c0f743242247f6b8e6b0aea2,1,Ajit Kumar,2016-04-27 16:10:07-07:00,['116d9853461c6fc81e32a28c11b73ffb65849d44'],33,142,175,22640270,7,0.102941176,0.911764706,0.838235294,24028
237a5d6926ddf841859695b4fcc469ab1cc04fcf,1,Ajit Kumar,2016-04-27 16:12:42-07:00,['80f1beaac13812a5c0f743242247f6b8e6b0aea2'],21,39,60,22640330,3,0.25,1,0,24028
e74bfa4a4ba7689f7f7d3a363fc817871b32c798,1,Gautam Borad,2016-04-28 10:15:21+05:18,['237a5d6926ddf841859695b4fcc469ab1cc04fcf'],106,577,683,22641013,18,0.164912281,0.235087719,0.442105263,24028
9bef76ba08fe190ad40d128cf317dce0df36f7f4,1,Andrii Tkach,2016-04-28 11:53:07+03:00,['e74bfa4a4ba7689f7f7d3a363fc817871b32c798'],9,169,178,22641191,5,1,1,1,24028
82bea1cbfde826d13579b516f19e730e051adf72,1,Swapan Shridhar,2016-04-28 02:41:45-07:00,['9bef76ba08fe190ad40d128cf317dce0df36f7f4'],9,280,289,22641480,5,0.038834951,0.038834951,0.038834951,24029
6915791523e0cfc73019bb06b082db12abb03303,1,"Toader, Sebastian",2016-04-28 12:47:59+02:00,['82bea1cbfde826d13579b516f19e730e051adf72'],7,19,26,22641506,6,0,0.833333333,0.916666667,24029
ac731f7b5d069ac415e7ef418b7d01a77f3ba16d,1,Pallav Kulshreshtha,2016-04-28 16:24:51+05:18,['6915791523e0cfc73019bb06b082db12abb03303'],1,1,2,22641508,1,,,,24029
79489a8f35a6b808277a91251beae704aaad982f,1,Dipayan Bhowmick,2016-04-28 16:30:33+05:18,['ac731f7b5d069ac415e7ef418b7d01a77f3ba16d'],3,2657,2660,22644168,33,0.834532374,0.834532374,1,24056
97b44238e58b10fbfdabae988e11a7c051aad8a3,1,Andrew Onishuk,2016-04-28 14:17:25+03:00,['79489a8f35a6b808277a91251beae704aaad982f'],6,16,22,22644190,2,0,0,0.666666667,24056
099f6e562f67f58d1cc64b9233a25214e3d44fd2,1,Andrew Onishuk,2016-04-28 16:07:25+03:00,['97b44238e58b10fbfdabae988e11a7c051aad8a3'],2,18,20,22644210,2,0,0,1,24056
32e437d4234e95d5988a9237eb6c841fb16f33a7,0,ababiichuk,2016-04-28 17:02:25+03:00,['099f6e562f67f58d1cc64b9233a25214e3d44fd2'],3,19,22,22644232,1,1,1,1,24056
0fa71ff92f25cc03289b41ef9599bdd79f6052e8,0,Myroslav Papirkovskyi,2016-04-28 17:09:10+03:00,['32e437d4234e95d5988a9237eb6c841fb16f33a7'],1,1,2,22644234,1,,,,24056
126626857ffdabfb61788ff72a83023262bd58da,1,Gautam Borad,2016-04-28 19:35:57+05:18,['0fa71ff92f25cc03289b41ef9599bdd79f6052e8'],11,13,24,22644258,8,0,0,0,24056
35ebd80d87e2a46c1dfcccc3a243bf59fb3c510c,1,Andrew Onishuk,2016-04-28 18:26:49+03:00,['126626857ffdabfb61788ff72a83023262bd58da'],45,16,61,22644319,3,1,0,0,24056
84a2595eb0dda84c4a7baf2b3e78a0ebc0b357be,0,Di Li,2016-04-28 11:30:15-04:00,['35ebd80d87e2a46c1dfcccc3a243bf59fb3c510c'],2,2,4,22644323,2,,,,24056
e1069651db0f503f15c8b31ec50f1932d65ab7be,1,Andrew Onishuk,2016-04-28 18:56:31+03:00,['84a2595eb0dda84c4a7baf2b3e78a0ebc0b357be'],32,128,160,22644483,1,0,0.070175439,1,24056
f9ee4a0b87ef19f8956c9efa6c8d763b4e96d34d,1,oleewere,2016-04-28 18:28:06+02:00,['e1069651db0f503f15c8b31ec50f1932d65ab7be'],217,59,276,22644759,12,0,1,0,24056
c16c306b63509a167f60d1785c26005a1b315cda,1,Alex Antonenko,2016-04-28 19:53:48+03:00,['f9ee4a0b87ef19f8956c9efa6c8d763b4e96d34d'],35,78,113,22644872,2,,,,24056
f3cb35cf6c3d0df8b9a59b7cea65289a12edc753,1,Alex Antonenko,2016-04-28 19:53:48+03:00,['c16c306b63509a167f60d1785c26005a1b315cda'],10,225,235,22645107,3,0.272727273,0.840909091,0.778409091,24056
7cfcf657951be5ca824e37ecb2f3c7ed54ca8a56,1,Alex Antonenko,2016-04-28 19:53:48+03:00,['f3cb35cf6c3d0df8b9a59b7cea65289a12edc753'],88,1193,1281,22646388,30,0.81797235,0.875576037,0.99078341,24061
1b49c6c97f3a38652b9b8231b7c65cec2c2a0a2e,1,Lisnichenko Dmitro,2016-04-28 20:01:29+03:00,['7cfcf657951be5ca824e37ecb2f3c7ed54ca8a56'],1,284,285,22646673,4,0.113207547,0.330188679,1,24063
c26e2ff61b2fd02c2c72232de154d62401287847,1,ababiichuk,2016-04-28 20:18:51+03:00,['1b49c6c97f3a38652b9b8231b7c65cec2c2a0a2e'],401,224,625,22647298,18,0.591133005,0.532019704,0,24063
2ff332504c6f7ac5b0a3e64231521258f096f664,1,oleewere,2016-04-28 19:40:07+02:00,['c26e2ff61b2fd02c2c72232de154d62401287847'],2,2,4,22647302,2,,,,24063
51480ecaccae514035d3fae2b0a4757f51152567,0,Dmytro Sen,2016-04-28 20:56:48+03:00,['2ff332504c6f7ac5b0a3e64231521258f096f664'],11,37,48,22647350,2,0.526315789,0.526315789,1,24063
c91f07ea858fa692bca2ee1536434930f71ab90b,1,Aleksandr Kovalenko,2016-04-29 00:59:31+03:00,['51480ecaccae514035d3fae2b0a4757f51152567'],4,78,82,22647432,8,0.6,0.6,1,24064
a4af9429235eb67fb847adf1cf2abb6903fe930d,1,Jaimin Jetly,2016-04-28 16:07:17-07:00,['c91f07ea858fa692bca2ee1536434930f71ab90b'],1,1,2,22647434,1,,,,24064
35b4ef6fe18b6a88abdef9998e41010c9035f293,1,Siddharth Wagle,2016-04-28 16:20:41-07:00,['a4af9429235eb67fb847adf1cf2abb6903fe930d'],39,130,169,22647603,7,0,0.701754386,0.736842105,24064
06ae6674c7414ec801d38ce2d45fb22d1d67890d,1,Swapan Shridhar,2016-04-28 17:39:53-07:00,['35b4ef6fe18b6a88abdef9998e41010c9035f293'],29,156,185,22647788,5,0.04,0.79,0.57,24064
287e2416cc5c7472b6e254579ee574532450e649,0,Pallav Kulshreshtha,2016-04-29 13:06:29+05:18,['06ae6674c7414ec801d38ce2d45fb22d1d67890d'],4,13,17,22647805,1,1,1,1,24064
03600998f060daf7c3a4cbd336fea1c6737b2e45,1,Andrii Tkach,2016-04-29 11:03:02+03:00,['287e2416cc5c7472b6e254579ee574532450e649'],22,3,25,22647830,4,,,,24064
a3c4d46c71a8f38750612ce154e7707617cba8ae,1,Oleg Nechiporenko,2016-04-29 14:07:47+03:00,['03600998f060daf7c3a4cbd336fea1c6737b2e45'],181,45,226,22648056,9,1,0,0,24064
051f09a400509fe1e38b768553a6bcd755e4ed5e,1,Sumit Mohanty,2016-04-29 05:14:06-07:00,['a3c4d46c71a8f38750612ce154e7707617cba8ae'],36,62,98,22648154,2,0,0.96,0.92,24064
f9eade043756f59a92e10705bc09edc6c16f964c,1,Andrew Onishuk,2016-04-29 16:02:25+03:00,['051f09a400509fe1e38b768553a6bcd755e4ed5e'],10,42,52,22648206,1,0.130434783,0.130434783,1,24064
fdd07bd8159efed093a5bea5b92fe6ec677f251e,1,Jonathan Hurley,2016-04-29 09:36:02-04:00,['f9eade043756f59a92e10705bc09edc6c16f964c'],157,261,418,22648624,14,0.461538462,0.923076923,0.076923077,24065
ce279f7d8fe8a7b2f265436ba5593a7cb2da8a4d,0,Alex Antonenko,2016-04-29 17:04:28+03:00,['fdd07bd8159efed093a5bea5b92fe6ec677f251e'],3,10,13,22648637,2,0.428571429,1,1,24065
7b7331a3d2efaefb070ac1cc8c7bda21cd601044,0,Robert Levas,2016-04-29 11:19:06-04:00,['ce279f7d8fe8a7b2f265436ba5593a7cb2da8a4d'],8,289,297,22648934,5,0,0.872037915,0.995260664,24065
af22c8c494ceac6ed0d2f13aa7312fcb10a45b6f,0,Jonathan Hurley,2016-04-29 11:33:12-04:00,['7b7331a3d2efaefb070ac1cc8c7bda21cd601044'],1,1,2,22648936,1,,,,24065
fd679a97eafe3f37105dd4c890dc100bd1f14f1d,1,Vitaly Brodetskyi,2016-04-29 18:40:12+03:00,['af22c8c494ceac6ed0d2f13aa7312fcb10a45b6f'],15,45,60,22648996,1,0.583333333,0,0,24065
9ac82a5958c6797aceeae9fdfdc3b9d1307b0656,1,Myroslav Papirkovskyi,2016-04-29 19:12:05+03:00,['fd679a97eafe3f37105dd4c890dc100bd1f14f1d'],25,72,97,22649093,5,0.666666667,0,1,24065
d033fa7141013328cff7e4b9aae4a5e17fb84235,0,Myroslav Papirkovskyi,2016-04-29 20:09:36+03:00,['9ac82a5958c6797aceeae9fdfdc3b9d1307b0656'],7,22,29,22649122,1,0,1,1,24065
4132310990655c0d7a442ad4b0d915ae2b6db1b1,1,Myroslav Papirkovskyi,2016-04-29 20:11:04+03:00,['d033fa7141013328cff7e4b9aae4a5e17fb84235'],0,25,25,22649147,3,0.8,0.8,1,24065
a606a046d3e327dc9180ca9d67e030887f4eca66,1,oleewere,2016-04-29 19:39:22+02:00,['4132310990655c0d7a442ad4b0d915ae2b6db1b1'],6,24,30,22649177,6,,,,24065
b90a77a06ff1bd2df1a15b1fe7a483c5c50e543c,0,Srimanth Gunturi,2016-04-29 11:54:56-07:00,['a606a046d3e327dc9180ca9d67e030887f4eca66'],10,12,22,22649199,4,,,,24065
3a5ae334b9ffc819685420903aaba06cb9d6ec90,0,Alexander Denissov,2016-04-29 12:26:43-07:00,['b90a77a06ff1bd2df1a15b1fe7a483c5c50e543c'],1,3,4,22649203,1,,,,24065
0b77adc2f79b4d2b9561bfb165dbc671c897834a,1,Zhe (Joe) Wang,2016-04-29 15:52:49-07:00,['3a5ae334b9ffc819685420903aaba06cb9d6ec90'],930,2677,3607,22652810,36,0.449189985,0.994108984,0.901325479,24066
3422b51e29e39c3bad43beda9336e438b6fa9679,1,Zhe (Joe) Wang,2016-04-29 16:35:49-07:00,['0b77adc2f79b4d2b9561bfb165dbc671c897834a'],6,16,22,22652832,6,1,1,1,24066
47b9e1a832f58df13e3c987965db88c58dd37892,1,Matt,2016-04-29 17:46:58-07:00,['3422b51e29e39c3bad43beda9336e438b6fa9679'],18,246,264,22653096,3,0.465116279,1,0.96124031,24066
8c278eab0e2dd1ea08dc8d2ccf6887f6ace40852,1,Ajit Kumar,2016-04-29 23:44:56-07:00,['47b9e1a832f58df13e3c987965db88c58dd37892'],70,44,114,22653210,2,1,0,0,24066
8ccb1d3300c10be3ee6f267485712aaeb02cbe5f,1,Nate Cole,2016-04-30 11:05:08-04:00,['8c278eab0e2dd1ea08dc8d2ccf6887f6ace40852'],9,69,78,22653288,3,0,0,1,24066
6dc2c95582c5000f87d75ec82fb3ef812628a40c,1,Swapan Shridhar,2016-05-01 16:25:48-07:00,['8ccb1d3300c10be3ee6f267485712aaeb02cbe5f'],104,190,294,22653582,4,0.087912088,0.395604396,0.593406593,24066
6a6f55d66981ef421935d0e595bfc5f254560746,1,Bhuvnesh Chaudhary,2016-05-02 09:35:30-07:00,['6dc2c95582c5000f87d75ec82fb3ef812628a40c'],4,49,53,22653635,3,0,1,0.757575758,24066
c0607621bd5c91d6ab50f87fa0753ea5e1dc51cb,0,Bhuvnesh Chaudhary,2016-05-02 10:05:23-07:00,['6a6f55d66981ef421935d0e595bfc5f254560746'],1,2,3,22653638,1,0,1,1,24066
b913220368f086c2c01125fab8f8fc2bff8d5f3c,1,oleewere,2016-05-02 19:09:24+02:00,['c0607621bd5c91d6ab50f87fa0753ea5e1dc51cb'],0,54,54,22653692,2,,,,24067
f44b99e93ccf3465c2995e46d32d79d5a4ba160c,1,oleewere,2016-05-02 19:18:24+02:00,['b913220368f086c2c01125fab8f8fc2bff8d5f3c'],16,337,353,22654045,18,,,,24069
a5945c9f4ff41b49e23728a7f92e2dced1630a63,1,Jaimin Jetly,2016-05-02 11:13:13-07:00,['f44b99e93ccf3465c2995e46d32d79d5a4ba160c'],0,2,2,22654047,2,,,,24069
f8aecbba123399c797fc9cc1d19c78e1bc8a5284,1,Zhe (Joe) Wang,2016-05-02 13:37:49-07:00,['a5945c9f4ff41b49e23728a7f92e2dced1630a63'],1,2,3,22654050,2,,,,24069
acd99827ed85ff0cf2665f14940d83d1783e4e8a,1,Jaimin Jetly,2016-05-02 18:21:26-07:00,['f8aecbba123399c797fc9cc1d19c78e1bc8a5284'],2,1,3,22654053,1,1,0,0,24069
d32f61c9e008a69d95d74b1048b56aeab33d6a85,1,"Toader, Sebastian",2016-05-03 06:57:04+02:00,['acd99827ed85ff0cf2665f14940d83d1783e4e8a'],8,13,21,22654074,2,0,0,1,24069
f57185fbfe24e1b0b7f1d72e8495c12e2fa0923d,1,Dipayan Bhowmick,2016-05-03 10:48:26+05:18,['d32f61c9e008a69d95d74b1048b56aeab33d6a85'],255,633,888,22654962,12,0.191489362,1,0.987234043,24070
1fce0cabb96da233a283dcb428a3abd93fc8cd4c,0,Matt,2016-05-02 23:16:52-07:00,['f57185fbfe24e1b0b7f1d72e8495c12e2fa0923d'],4,7,11,22654973,2,0,1,1,24070
b571e4a0b05d813adfcbbfe7f90563555844ca28,1,tbeerbower,2016-05-03 06:04:28-04:00,['1fce0cabb96da233a283dcb428a3abd93fc8cd4c'],19,94,113,22655086,14,0.173913043,1,1,24071
3d3f06ad83188e086564a60b687e35a1956258b0,1,"Toader, Sebastian",2016-05-03 14:53:44+02:00,['b571e4a0b05d813adfcbbfe7f90563555844ca28'],8,107,115,22655201,5,0.925,0.925,1,24071
61a3ac44dddd330dd4cf1b60ca1f40d8b7613dcc,1,Sandor Magyari,2016-05-03 15:15:35+02:00,['3d3f06ad83188e086564a60b687e35a1956258b0'],16,20,36,22655237,1,1,1,0,24071
51c0cb4ff1d56704265014e890275dd6284bdb8c,1,Jonathan Hurley,2016-05-03 09:43:22-04:00,['61a3ac44dddd330dd4cf1b60ca1f40d8b7613dcc'],14,81,95,22655332,3,1,1,1,24071
46d1d7b188d3f8c020f992c91406d994bac5eebc,1,Sumit Mohanty,2016-05-03 07:30:40-07:00,['51c0cb4ff1d56704265014e890275dd6284bdb8c'],14,167,181,22655513,6,0,0.631578947,0.368421053,24072
7eeab53c715f4667afed0217721841eabadeea76,1,Matt,2016-05-03 10:36:50-07:00,['46d1d7b188d3f8c020f992c91406d994bac5eebc'],0,2,2,22655515,1,,,,24072
4342a6b7eb6eed781d879c46435acc9f0ea8c981,1,Dipayan Bhowmick,2016-05-03 23:00:27+05:18,['7eeab53c715f4667afed0217721841eabadeea76'],482,1488,1970,22657485,45,0.277661795,0.889352818,0.853862213,24074
15a7ea3d5f5aa3843dd44cd8032003ef3854e25c,1,Dipayan Bhowmick,2016-05-03 23:11:44+05:18,['4342a6b7eb6eed781d879c46435acc9f0ea8c981'],4,23,27,22657512,2,1,1,0.933333333,24074
7d0d33a49cfd4b8fb832ad6f0aa5f7e4b48ea048,1,Jun Aoki,2016-05-03 10:59:32-07:00,['15a7ea3d5f5aa3843dd44cd8032003ef3854e25c'],8,107,115,22657627,3,0.210526316,0.280701754,0.631578947,24074
3116193060c93a676980b74c92d7a752c5f85633,0,oleewere,2016-05-03 21:47:00+02:00,['7d0d33a49cfd4b8fb832ad6f0aa5f7e4b48ea048'],16,17,33,22657660,1,,,,24074
e87d962c8f5493f5f78e9fc5cb2a3c9a0b8b9afb,1,Nahappan Somasundaram,2016-05-03 12:49:14-07:00,['3116193060c93a676980b74c92d7a752c5f85633'],2,88,90,22657750,7,,,,24074
360fda044adab15dfba9e7bbadc0dd0878c7d898,1,Bob Nettleton,2016-05-03 16:41:21-04:00,['e87d962c8f5493f5f78e9fc5cb2a3c9a0b8b9afb'],2,2,4,22657754,1,,,,24074
5b80f490227a3908608af314aded3cb8b2adc5c7,1,Bob Nettleton,2016-05-03 16:52:12-04:00,['360fda044adab15dfba9e7bbadc0dd0878c7d898'],38,437,475,22658229,9,,,,24075
5fea54102c8534ad80ee46bb56334eb2b2a24e33,0,Sumit Mohanty,2016-05-03 14:01:36-07:00,['5b80f490227a3908608af314aded3cb8b2adc5c7'],3,3,6,22658235,2,,,,24075
529ef7f7042764a060d782719cfe5e72cd636f83,1,Srimanth Gunturi,2016-05-03 17:01:32-07:00,['5fea54102c8534ad80ee46bb56334eb2b2a24e33'],37115,50826,87941,22746176,133,0.22645951,0.707313245,0.172316384,24127
e72d9b0b67067231fca0510e55df0be9e2f2db80,1,Jayush Luniya,2016-05-03 17:16:14-07:00,['529ef7f7042764a060d782719cfe5e72cd636f83'],10,10,20,22746196,1,,,,24127
2c5de15b3dd18453f67a11194d9ef7d3dab46e45,1,Jayush Luniya,2016-05-03 17:53:56-07:00,['e72d9b0b67067231fca0510e55df0be9e2f2db80'],4,53,57,22746253,5,0,1,1,24127
05db279fd7ae846402a6c5420f5b6d4d26b5d293,0,Richard Zang,2016-05-03 18:05:39-07:00,['2c5de15b3dd18453f67a11194d9ef7d3dab46e45'],1,1,2,22746255,1,,,,24127
04b6f14be5fa8e23d784469fdc73d6df41c2ca4d,1,Sumit Mohanty,2016-05-03 20:55:07-07:00,['05db279fd7ae846402a6c5420f5b6d4d26b5d293'],1,1,2,22746257,1,,,,24127
b933445cf7d7f79b7c754e788557f1476bb37689,1,Nahappan Somasundaram,2016-05-03 20:59:51-07:00,['04b6f14be5fa8e23d784469fdc73d6df41c2ca4d'],2,2,4,22746261,2,,,,24127
71305effa9ac00e2e9adb36e6a66a13c9105a811,1,Sumit Mohanty,2016-05-03 23:30:06-07:00,['b933445cf7d7f79b7c754e788557f1476bb37689'],1,1,2,22746263,1,,,,24127
efa35f49b82a4db88bc49830d63df41c3ae33ccc,1,Gautam Borad,2016-05-04 13:22:56+05:18,['71305effa9ac00e2e9adb36e6a66a13c9105a811'],29,135,164,22746427,6,0,0,1,24128
4540d4611b0951a8de20e77e800f1e9789442e3f,1,Alex Antonenko,2016-05-04 13:13:40+03:00,['efa35f49b82a4db88bc49830d63df41c3ae33ccc'],15,68,83,22746510,11,0.236842105,0.526315789,0.973684211,24128
46abb14ce88ca2bea043c0b9b4090cfdceaaf6c4,0,Sandor Magyari,2016-05-04 12:32:24+02:00,['4540d4611b0951a8de20e77e800f1e9789442e3f'],1,5,6,22746516,1,1,1,1,24128
cb8dca09c7794c93233b2546464f1327be261c60,1,Vitaly Brodetskyi,2016-05-04 15:28:05+03:00,['46abb14ce88ca2bea043c0b9b4090cfdceaaf6c4'],211,418,629,22747145,15,0.090909091,0,1,24129
4bdca9aee7aa89a4beb620955f4f4c62d0639a55,0,Vitaly Brodetskyi,2016-05-04 17:54:48+03:00,['cb8dca09c7794c93233b2546464f1327be261c60'],4,12,16,22747161,1,0,0,1,24129
4b2de80ba267ebfc9bd9aa379eee3151b23ca7b0,1,Sandor Magyari,2016-05-04 17:18:03+02:00,['4bdca9aee7aa89a4beb620955f4f4c62d0639a55'],26,94,120,22747281,4,0.228070175,0.192982456,0,24129
3bd507eca5475d59b827088f7be78f1c9971c1f5,0,ababiichuk,2016-05-04 18:22:31+03:00,['4b2de80ba267ebfc9bd9aa379eee3151b23ca7b0'],0,16,16,22747297,1,1,1,1,24129
95f5457ab9843d7094ed7955bc21b64d1103cacb,0,Aleksandr Kovalenko,2016-05-04 18:34:19+03:00,['3bd507eca5475d59b827088f7be78f1c9971c1f5'],1,1,2,22747299,1,,,,24129
f29058895721873223757555d87ca6fb45bf572c,1,Bob Nettleton,2016-05-04 12:04:53-04:00,['95f5457ab9843d7094ed7955bc21b64d1103cacb'],0,31,31,22747330,1,,,,24129
48efeb45165ecbdb36cac4558e977af2c71277b6,1,Bhuvnesh Chaudhary,2016-05-04 10:08:19-07:00,['f29058895721873223757555d87ca6fb45bf572c'],1,1,2,22747332,1,,,,24129
22988751d981abb48f9bc80c4f8536a9cded366f,0,Nate Cole,2016-05-04 13:45:39-04:00,['48efeb45165ecbdb36cac4558e977af2c71277b6'],32,34,66,22747398,2,1,0,1,24129
864f6de298e5a2d2cbba660d786ec20f127dd77a,1,Zhe (Joe) Wang,2016-05-04 10:49:06-07:00,['22988751d981abb48f9bc80c4f8536a9cded366f'],64,184,248,22747646,24,0.84,1,1,24130
8b77766f4fc4efc951d353006e541e8b48769391,1,Dipayan Bhowmick,2016-05-04 23:56:47+05:18,['864f6de298e5a2d2cbba660d786ec20f127dd77a'],2,2,4,22747650,1,,0,,24130
ff83f4dd803c6da52fddc3a51650317cb8cd7ac5,1,Dipayan Bhowmick,2016-05-05 00:01:46+05:18,['8b77766f4fc4efc951d353006e541e8b48769391'],35,80,115,22747765,12,0.416666667,0.916666667,1,24130
39f4cb806ab7522b27a48d6871c0de5a019195d3,1,Robert Levas,2016-05-04 14:50:56-04:00,['ff83f4dd803c6da52fddc3a51650317cb8cd7ac5'],1,362,363,22748128,2,0.036363636,0.690909091,1,24130
3e11675be515cc6eaac98cfbe8214ecd87caf424,1,oleewere,2016-05-04 23:23:59+02:00,['39f4cb806ab7522b27a48d6871c0de5a019195d3'],67,43,110,22748238,10,1,1,1,24130
8a2a9fdc153eee316c49e68067741d0d59339e7b,1,oleewere,2016-05-04 23:40:31+02:00,['3e11675be515cc6eaac98cfbe8214ecd87caf424'],2,115,117,22748355,3,0.134615385,1,0.865384615,24130
3f59d882f3291e643d9321861d63b00e77635045,1,Zhe (Joe) Wang,2016-05-04 15:01:28-07:00,['8a2a9fdc153eee316c49e68067741d0d59339e7b'],11,74,85,22748440,3,1,1,1,24130
264111afc44b311a37b6da64f6cbca42c8622109,1,Sumit Mohanty,2016-05-04 15:23:22-07:00,['3f59d882f3291e643d9321861d63b00e77635045'],5,327,332,22748772,6,0.453333333,0.453333333,0.8,24133
111cc827d0983c31a879f0bdcad31237c8aa2583,1,Jaimin Jetly,2016-05-04 16:35:50-07:00,['264111afc44b311a37b6da64f6cbca42c8622109'],41,204,245,22749017,10,1,0.9375,0.859375,24135
8a49b60f65601113b17822188995ea5e99453e29,1,Sumit Mohanty,2016-05-04 16:55:00-07:00,['111cc827d0983c31a879f0bdcad31237c8aa2583'],289,8,297,22749314,5,1,0.127962085,0.004739336,24135
0a745f8bacf924b13cb4ba5d444dec45fd492830,1,Vitaly Brodetskyi,2016-05-05 12:01:50+03:00,['8a49b60f65601113b17822188995ea5e99453e29'],2,2,4,22749318,1,,,,24135
5c782dd843c3fca5891e8c937c1d93c9d0fdfaad,1,Andrii Tkach,2016-05-05 13:26:29+03:00,['0a745f8bacf924b13cb4ba5d444dec45fd492830'],114,2808,2922,22752240,18,0.854166667,1,0.998366013,24139
e04bca9ba04b86c93670b9333dbccd81f5eeb8a9,1,Dipayan Bhowmick,2016-05-05 19:40:40+05:18,['5c782dd843c3fca5891e8c937c1d93c9d0fdfaad'],6,19,25,22752265,1,1,1,1,24139
1770820a7aa9aacca7a6352d70be7cde7b280556,0,Zhe (Joe) Wang,2016-05-05 10:29:40-07:00,['e04bca9ba04b86c93670b9333dbccd81f5eeb8a9'],0,34,34,22752299,2,0,1,1,24139
be7f69625e354123facf0df369a29a3da85462ec,1,Jun Aoki,2016-05-05 11:28:20-07:00,['1770820a7aa9aacca7a6352d70be7cde7b280556'],3,2,5,22752304,1,0,0,1,24139
538a3f13adef72af4b3bf1c8ed140332cda65eaf,0,Jaimin Jetly,2016-05-05 11:58:12-07:00,['be7f69625e354123facf0df369a29a3da85462ec'],1,1,2,22752306,1,,,,24139
96d3afe028891123b42034c8ecad761836e3b376,1,Jayush Luniya,2016-05-05 14:54:44-07:00,['538a3f13adef72af4b3bf1c8ed140332cda65eaf'],32,61,93,22752399,33,,,,24140
10e4d1cd5123c02c34bc342b4d2a4e064623f789,0,Jayush Luniya,2016-05-05 15:00:33-07:00,['96d3afe028891123b42034c8ecad761836e3b376'],56,120,176,22752575,33,,,,24142
f1c7514d60cb5ea46647bc759343b20e1a1920e4,0,Jayush Luniya,2016-05-05 15:04:40-07:00,['10e4d1cd5123c02c34bc342b4d2a4e064623f789'],259,673,932,22753507,75,0.666666667,0.666666667,0,24152
2337a0bbd3138e55074118b64e898572277f7331,1,Swapan Shridhar,2016-05-05 16:05:37-07:00,['f1c7514d60cb5ea46647bc759343b20e1a1920e4'],7,7,14,22753521,1,,,,24152
fdd16f3c32cd7cbc2e86bb631569ba013623eb97,1,Jayush Luniya,2016-05-05 23:02:05-07:00,['2337a0bbd3138e55074118b64e898572277f7331'],120,56,176,22753697,33,,,,24152
d216c12832bf65e226cb482cec327dc91f1650d9,1,Jayush Luniya,2016-05-05 23:03:29-07:00,['fdd16f3c32cd7cbc2e86bb631569ba013623eb97'],673,259,932,22754629,75,0.333333333,0.333333333,1,24152
aaaa9884e7f8ee71649c6e2a24eae7f9d64dd1d6,1,Jayush Luniya,2016-05-05 23:07:05-07:00,['d216c12832bf65e226cb482cec327dc91f1650d9'],56,120,176,22754805,33,,,,24154
8e5eeb4dea099249d616a243d96f6cb2ffcf01c8,1,Jayush Luniya,2016-05-05 23:51:52-07:00,['aaaa9884e7f8ee71649c6e2a24eae7f9d64dd1d6'],260,674,934,22755739,76,0.666666667,0.666666667,0,24164
4ce716f8e2b49e35c782b58a5889bfbf563712ae,1,Jayush Luniya,2016-05-06 01:10:15-07:00,['8e5eeb4dea099249d616a243d96f6cb2ffcf01c8'],425,1106,1531,22757270,17,0.627272727,0.648484848,0.536363636,24167
41abdbb01d2af411e1c86a9e3424cd8b068abd54,1,"Toader, Sebastian",2016-05-06 16:40:27+02:00,['4ce716f8e2b49e35c782b58a5889bfbf563712ae'],2,78,80,22757350,2,0,0,1,24167
3c12461dbc4739187f6fa20087df41b51dadb342,1,Dmytro Sen,2016-05-06 19:36:41+03:00,['41abdbb01d2af411e1c86a9e3424cd8b068abd54'],25,42,67,22757417,4,0,0.416666667,0.416666667,24167
abe7eb50fdf06f8410717476261ff8e952f4b174,1,Zhe (Joe) Wang,2016-05-06 10:27:59-07:00,['3c12461dbc4739187f6fa20087df41b51dadb342'],107,96,203,22757620,4,0,0,0,24167
9a9b8ccba51d709d02b0670ac974068d3353baaa,1,Jaimin Jetly,2016-05-06 11:58:31-07:00,['abe7eb50fdf06f8410717476261ff8e952f4b174'],13,56,69,22757689,2,1,1,1,24167
fb5f9b304b3c17e3397b475ec3b96500623e46c6,0,Alex Antonenko,2016-05-06 22:37:29+03:00,['9a9b8ccba51d709d02b0670ac974068d3353baaa'],2,2,4,22757693,1,,,,24167
65834423f3033cf63c2df48e917f162cc5f740eb,0,Siddharth Wagle,2016-05-06 14:25:09-07:00,['fb5f9b304b3c17e3397b475ec3b96500623e46c6'],6,17,23,22757716,2,0,1,1,24167
766ad0a70fd5e027b8d94bfb09e1b0019127c1e5,1,Richard Zang,2016-05-06 14:51:35-07:00,['65834423f3033cf63c2df48e917f162cc5f740eb'],73,30,103,22757819,2,,,,24167
bd6eecce681c9bce75d76e3d589f56bccb7ef8db,1,Jayush Luniya,2016-05-06 15:59:28-07:00,['766ad0a70fd5e027b8d94bfb09e1b0019127c1e5'],104,133,237,22758056,37,,,,24169
178a350f6c35a54476715123aee50404b7e3659a,1,Jaimin Jetly,2016-05-06 16:37:32-07:00,['bd6eecce681c9bce75d76e3d589f56bccb7ef8db'],4,8,12,22758068,1,1,1,1,24169
177d7a3babf0c23b419b72b40e251adf788d82b1,1,"Toader, Sebastian",2016-05-09 17:12:00+02:00,['178a350f6c35a54476715123aee50404b7e3659a'],5,10,15,22758083,2,,,,24169
b26ef1e6761b5408cca992378b44ce33616ea559,0,Alexander Denissov,2016-05-09 13:18:35-07:00,['177d7a3babf0c23b419b72b40e251adf788d82b1'],0,65,65,22758148,2,0.151515152,0.848484848,1,24169
477e5848a11de87726d14da8f2df1784a9b895ad,1,Jaimin Jetly,2016-05-09 14:49:31-07:00,['b26ef1e6761b5408cca992378b44ce33616ea559'],0,4174,4174,22762322,3,,,,24172
f66f08a92bafa4134f80d866c8a09a9b178737d4,1,Nate Cole,2016-05-09 17:58:53-04:00,['477e5848a11de87726d14da8f2df1784a9b895ad'],5,110,115,22762437,2,0,0.873239437,0.873239437,24172
3bbc5afec728b03602cb8c900f2104bc95110cca,0,Jaimin Jetly,2016-05-09 16:38:05-07:00,['f66f08a92bafa4134f80d866c8a09a9b178737d4'],7,1,8,22762445,2,,0,,24172
d3bac3a1d6ba6bc0e3bda91d3ee8194651fa8daa,1,Nahappan Somasundaram,2016-05-09 17:16:37-07:00,['3bbc5afec728b03602cb8c900f2104bc95110cca'],53,376,429,22762874,9,0,0,1,24175
05895dd43f1f658ab536a009a91c7d1e39e75154,1,Nahappan Somasundaram,2016-05-09 17:17:58-07:00,['d3bac3a1d6ba6bc0e3bda91d3ee8194651fa8daa'],117,116,233,22763107,2,1,0.416666667,0.583333333,24175
5577b4387972c263a4bf715ca17cde7f0cb09144,1,Swapan Shridhar,2016-05-09 18:18:08-07:00,['05895dd43f1f658ab536a009a91c7d1e39e75154'],1,2,3,22763110,1,0,0,0,24175
2865b1b4a28a69314db3c210fe197502d1db6217,0,Ajit Kumar,2016-05-09 19:38:32-07:00,['5577b4387972c263a4bf715ca17cde7f0cb09144'],3,0,3,22763113,1,,,,24175
6ea2cc1dffb9b45a4e7f43a4eb97dd8ae14b70da,1,Robert Levas,2016-05-09 23:39:10-04:00,['2865b1b4a28a69314db3c210fe197502d1db6217'],583,547,1130,22764243,15,1,1,0.148148148,24175
6c7c63fb3f5419d371fcdc6b594ffb4a0af88ef8,0,Sumit Mohanty,2016-05-09 21:06:03-07:00,['6ea2cc1dffb9b45a4e7f43a4eb97dd8ae14b70da'],1,12,13,22764256,1,,,,24175
1821873562219a960784e6c1177627ce805d89fe,1,oleewere,2016-05-10 11:34:51+02:00,['6c7c63fb3f5419d371fcdc6b594ffb4a0af88ef8'],12,34,46,22764302,5,1,1,1,24175
bdbe7d956cb54f84c49d725babd264f05fae8c0d,0,oleewere,2016-05-10 11:34:51+02:00,['1821873562219a960784e6c1177627ce805d89fe'],110,0,110,22764412,1,,,,24175
24b2391efab918ae86dce996912772dc9fbd673f,1,oleewere,2016-05-10 11:34:51+02:00,['bdbe7d956cb54f84c49d725babd264f05fae8c0d'],29,352,381,22764793,7,0.219354839,0.858064516,0.722580645,24177
796c2fe0c47115cab476fc4ea4e427e7c0dc3f42,1,oleewere,2016-05-10 11:34:51+02:00,['24b2391efab918ae86dce996912772dc9fbd673f'],2,2,4,22764797,2,,,,24177
06e51e5e32f4c10d4be8d9247a8c676b54531e7b,0,oleewere,2016-05-10 11:34:51+02:00,['796c2fe0c47115cab476fc4ea4e427e7c0dc3f42'],1,1,2,22764799,1,,,,24177
02a7eb72e603cefe919106aaece9457d8cbbdc33,1,oleewere,2016-05-10 11:34:51+02:00,['06e51e5e32f4c10d4be8d9247a8c676b54531e7b'],14,8,22,22764821,2,,,,24177
18ed939b2f5fc5e1dbd011d10ff0b1c596410727,1,"Toader, Sebastian",2016-05-10 12:11:05+02:00,['02a7eb72e603cefe919106aaece9457d8cbbdc33'],18,88,106,22764927,2,0,0.375,0.7,24177
c4114f645db75a8ef29719fdd3051846ef9e1ae5,1,Vitaly Brodetskyi,2016-05-10 10:57:37+03:00,['18ed939b2f5fc5e1dbd011d10ff0b1c596410727'],1,6,7,22764934,1,0,0,1,24177
c77b2c6a6296fd1fc71decd89dc762164a98e65e,0,Vitaly Brodetskyi,2016-05-10 11:10:20+03:00,['c4114f645db75a8ef29719fdd3051846ef9e1ae5'],1,1,2,22764936,1,,,,24177
4f2c531d71ecfdcae269643d42c3e81dfe252168,1,Andrew Onishuk,2016-05-10 13:50:24+03:00,['c77b2c6a6296fd1fc71decd89dc762164a98e65e'],1,2,3,22764939,1,,,,24177
60d939ff03b55a42edd825bb7606cfb5299b56f1,0,Andrew Onishuk,2016-05-10 14:05:50+03:00,['4f2c531d71ecfdcae269643d42c3e81dfe252168'],1,1,2,22764941,1,,,,24177
96a5be4f87bad3d4a79a27947f5bbb5307c773e9,0,Oleg Nechiporenko,2016-05-10 15:06:36+03:00,['60d939ff03b55a42edd825bb7606cfb5299b56f1'],31,38,69,22765010,1,0,1,1,24177
bbe212804a33945efaa112e7bfd50ece11826b94,0,Lisnichenko Dmitro,2016-05-10 15:11:35+03:00,['96a5be4f87bad3d4a79a27947f5bbb5307c773e9'],1,1,2,22765012,1,,,,24177
c39996a572d8018dd96d85613f5b411e998d8e2a,1,Jonathan Hurley,2016-05-10 08:49:35-04:00,['bbe212804a33945efaa112e7bfd50ece11826b94'],30,188,218,22765230,16,0.067567568,0.824324324,1,24177
45be225713c05b3c1a9e4c88e708bec261f10395,1,oleewere,2016-05-10 14:59:36+02:00,['c39996a572d8018dd96d85613f5b411e998d8e2a'],1,44,45,22765275,4,,,,24177
3332dad4d6da83defc61dba6db3a147db63deecb,1,oleewere,2016-05-10 14:59:36+02:00,['45be225713c05b3c1a9e4c88e708bec261f10395'],58,126,184,22765459,9,0,1,0.533333333,24177
b788f4ab4ba3e35690c748e499ad633e7169be3d,1,Robert Levas,2016-05-10 09:33:54-04:00,['3332dad4d6da83defc61dba6db3a147db63deecb'],547,583,1130,22766589,15,0,0,0.851851852,24177
90fa308655261ee49f28f60235e9f0af0b5d0f47,1,Robert Levas,2016-05-10 09:44:38-04:00,['b788f4ab4ba3e35690c748e499ad633e7169be3d'],583,547,1130,22767719,15,1,1,0.148148148,24177
4ea207290dfa27c18aeb647220ce9ce10fae6668,1,Nate Cole,2016-05-10 09:47:13-04:00,['90fa308655261ee49f28f60235e9f0af0b5d0f47'],10,67,77,22767796,2,0,0.714285714,1,24177
21657ce5e7965c33da4f829599af53bd7aa6e6d6,0,oleewere,2016-05-10 16:29:09+02:00,['4ea207290dfa27c18aeb647220ce9ce10fae6668'],13,1,14,22767810,1,,,,24177
cb932038ed508d53990ec3597bfa4b8826471abf,0,Aravindan Vijayan,2016-05-10 08:15:07-07:00,['21657ce5e7965c33da4f829599af53bd7aa6e6d6'],2,2,4,22767814,1,,,,24177
a3f3a74ba67dca5581d10f99e6879b66c8ff1576,1,ababiichuk,2016-05-10 18:25:21+03:00,['cb932038ed508d53990ec3597bfa4b8826471abf'],0,2,2,22767816,1,1,1,1,24177
c7ed0f81d34c2e924166d0d4bf37ec2bc2b22476,1,ababiichuk,2016-05-10 18:25:21+03:00,['a3f3a74ba67dca5581d10f99e6879b66c8ff1576'],87,154,241,22768057,5,1,1,1,24178
dcd198178c8de5ca7a10471bdfae16968578ce66,1,oleewere,2016-05-10 18:25:12+02:00,['c7ed0f81d34c2e924166d0d4bf37ec2bc2b22476'],388,617,1005,22769062,20,1,1,1,24182
430c01d6ae3fe458803d9277eab5bcd7d717a6b1,1,Alex Antonenko,2016-05-10 19:35:38+03:00,['dcd198178c8de5ca7a10471bdfae16968578ce66'],3,3,6,22769068,3,,,,24182
cb2212aeb60fbf796c226ae235ea40124e300f23,1,Alex Antonenko,2016-05-10 19:44:00+03:00,['430c01d6ae3fe458803d9277eab5bcd7d717a6b1'],0,19,19,22769087,3,0.85,1,0.85,24182
f83e258dad0e5417d816f0d41d8189fedac1efe7,0,oleewere,2016-05-10 18:47:48+02:00,['cb2212aeb60fbf796c226ae235ea40124e300f23'],4,1,5,22769092,1,0,0,0,24182
6c36aa437d0e86ac9b82cab52b221af837c47519,1,Lisnichenko Dmitro,2016-05-10 20:22:28+03:00,['f83e258dad0e5417d816f0d41d8189fedac1efe7'],5,210,215,22769307,9,0.419354839,0.967741935,0.967741935,24184
9933600ca7e8f82ee75039ed17e9cdd7a86ea4d6,0,Sandor Magyari,2016-05-10 19:54:14+02:00,['6c36aa437d0e86ac9b82cab52b221af837c47519'],29,0,29,22769336,1,,,,24184
07dbee41a2be7cc65daa7efd6e89a2ec31df7c55,0,Sumit Mohanty,2016-05-10 10:58:23-07:00,['9933600ca7e8f82ee75039ed17e9cdd7a86ea4d6'],1,1,2,22769338,1,,,,24184
a14fd4a54bd6a99f448e9053c15dd430cb81ef9c,1,Robert Levas,2016-05-10 14:08:20-04:00,['07dbee41a2be7cc65daa7efd6e89a2ec31df7c55'],104,170,274,22769612,2,0.125,0.78125,0.90625,24184
5703b872ddcdb421c6292a3bb4db75ae6edea05c,1,Jonathan Hurley,2016-05-10 15:33:00-04:00,['a14fd4a54bd6a99f448e9053c15dd430cb81ef9c'],81,321,402,22770014,3,0.075862069,0.786206897,0.786206897,24184
70ffe8d1e3628fabbd072a6e918795fa5c60f612,0,Nahappan Somasundaram,2016-05-10 12:37:34-07:00,['5703b872ddcdb421c6292a3bb4db75ae6edea05c'],1,1,2,22770016,1,,,,24184
9290e0091bef9b84dc1ae227186aa5c077f9c71d,1,Richard Zang,2016-05-10 13:21:44-07:00,['70ffe8d1e3628fabbd072a6e918795fa5c60f612'],17,22,39,22770055,1,0.25,0.25,0.25,24184
da33e437157b64d48c8b2959e795391b6f7e0859,1,Swapan Shridhar,2016-05-10 14:24:28-07:00,['9290e0091bef9b84dc1ae227186aa5c077f9c71d'],9,9,18,22770073,2,,,,24184
47c7b5ef6d17ca199a1b3b5799e7c66fe9ecc606,1,Aravindan Vijayan,2016-05-10 14:32:02-07:00,['da33e437157b64d48c8b2959e795391b6f7e0859'],245,767,1012,22771085,14,0.754266212,1,0.894197952,24187
347dc63e0907dc43113a46b109cc1fd35ff943c4,1,Aravindan Vijayan,2016-05-10 14:32:03-07:00,['47c7b5ef6d17ca199a1b3b5799e7c66fe9ecc606'],9,201,210,22771295,3,0.059602649,0.496688742,0.496688742,24187
19aaa641cf6053e5f73a93a5eb8f2f0694694493,1,Zhe (Joe) Wang,2016-05-10 21:31:02-04:00,['347dc63e0907dc43113a46b109cc1fd35ff943c4'],25,32,57,22771352,9,1,1,1,24187
58badf8d6a0d86d32cbd17a4e3fdc68c4afe90aa,0,Vitaly Brodetskyi,2016-05-11 08:45:46+03:00,['19aaa641cf6053e5f73a93a5eb8f2f0694694493'],2,2,4,22771356,1,,,,24187
bc82a6eca1ea9062d184add0d3acd099c6893434,1,Oleg Nechiporenko,2016-05-11 11:13:20+03:00,['58badf8d6a0d86d32cbd17a4e3fdc68c4afe90aa'],111,109,220,22771576,18,0.071428571,0,0,24187
c150f0ded83c0a2f4eac1d5bf12a0fbb643c9610,1,Dipayan Bhowmick,2016-05-11 14:10:34+05:18,['bc82a6eca1ea9062d184add0d3acd099c6893434'],1031,3458,4489,22776065,73,0.506293706,0.753846154,0.973426573,24210
9207fa3c45b923bfc6b796ba358af1de54b22685,0,oleewere,2016-05-11 11:40:22+02:00,['c150f0ded83c0a2f4eac1d5bf12a0fbb643c9610'],1,10,11,22776076,1,0,1,1,24210
50c3d816af1eedc71379c35ed157739e2439b9eb,0,Andrii Tkach,2016-05-11 13:45:32+03:00,['9207fa3c45b923bfc6b796ba358af1de54b22685'],0,1,1,22776077,1,,,,24210
3d99b680c438b6bbbe0b7a36c47fda3c367358ef,1,Alex Antonenko,2016-05-11 15:14:00+03:00,['50c3d816af1eedc71379c35ed157739e2439b9eb'],1,2,3,22776080,1,0,1,1,24210
84c3e7f06e1fb2e55d37f046ec584407c0b5c8eb,0,oleewere,2016-05-11 14:42:45+02:00,['3d99b680c438b6bbbe0b7a36c47fda3c367358ef'],16,8,24,22776104,7,0,0.1,0.1,24210
3861add9b8ceaceb94d019dfcf97db43da2567ac,1,oleewere,2016-05-11 15:44:27+02:00,['84c3e7f06e1fb2e55d37f046ec584407c0b5c8eb'],178,168,346,22776450,28,0.95,0.95,0.95,24210
41aa24740e06accc9faf9a591ec09505106f4f1b,1,oleewere,2016-05-11 16:33:51+02:00,['3861add9b8ceaceb94d019dfcf97db43da2567ac'],1,2,3,22776453,2,,,,24210
a23fbd7639373fd1f2bfb5d643871a094e302329,1,Srimanth Gunturi,2016-05-11 09:43:32-07:00,['41aa24740e06accc9faf9a591ec09505106f4f1b'],9,70,79,22776532,1,0,0,1,24210
a4e72f648357a58987fcfab1d078feb1e3558e3f,1,Robert Levas,2016-05-11 12:47:41-04:00,['a23fbd7639373fd1f2bfb5d643871a094e302329'],1,4,5,22776537,1,1,1,1,24210
95fb3a16cfaf542b5fe221cecaa3cbeb68528852,1,Jonathan Hurley,2016-05-11 13:42:38-04:00,['a4e72f648357a58987fcfab1d078feb1e3558e3f'],64,412,476,22777013,8,0.162601626,0.983739837,1,24211
559894b7eff3e0575fab2b703bbe1cece45d8451,1,Vitaly Brodetskyi,2016-05-11 18:35:27+03:00,['95fb3a16cfaf542b5fe221cecaa3cbeb68528852'],0,8,8,22777021,2,,,,24211
40823388e273f5a35769c716e663837f54d732f6,0,Sumit Mohanty,2016-05-11 11:53:25-07:00,['559894b7eff3e0575fab2b703bbe1cece45d8451'],1,1,2,22777023,1,,,,24211
63ede81959381698ecffe035c00a050fbb08316b,1,Jonathan Hurley,2016-05-11 16:05:01-04:00,['40823388e273f5a35769c716e663837f54d732f6'],8,16,24,22777047,7,1,0.9,0.9,24211
80040e0f2cb53fe8296a7cf5d4898d7a2eab7003,0,Richard Zang,2016-05-11 13:19:40-07:00,['63ede81959381698ecffe035c00a050fbb08316b'],14,23,37,22777084,5,1,1,1,24211
9c5122aaf333089a466440c371d924634e544bb8,0,Srimanth Gunturi,2016-05-11 14:17:55-07:00,['80040e0f2cb53fe8296a7cf5d4898d7a2eab7003'],0,0,0,22777084,14,,,,24225
b9ed455d5df1c5cec968234e0e6c7019413b68c8,0,Jun Aoki,2016-05-11 14:20:28-07:00,['9c5122aaf333089a466440c371d924634e544bb8'],14,18,32,22777116,2,1,1,1,24225
fb9455562ab17188765a7163dd444bd2d9a598a8,0,Sumit Mohanty,2016-05-11 14:24:02-07:00,['b9ed455d5df1c5cec968234e0e6c7019413b68c8'],0,29,29,22777145,1,,,,24226
b86507829d11eb8a16b9046a9458879881e3ab4e,0,Matt,2016-05-11 19:30:13-07:00,['fb9455562ab17188765a7163dd444bd2d9a598a8'],0,114,114,22777259,3,0.589473684,0.831578947,1,24226
931021f5627de0f8e7eca85faafdfdb98326ad20,1,Pallav Kulshreshtha,2016-05-12 13:06:00+05:18,['b86507829d11eb8a16b9046a9458879881e3ab4e'],12,32,44,22777303,1,0,1,1,24226
c63a8627cc447d4ecd3f01155a79709d9009e9c5,1,Pallav Kulshreshtha,2016-05-12 13:14:09+05:18,['931021f5627de0f8e7eca85faafdfdb98326ad20'],1,4,5,22777308,1,1,1,1,24226
4bd4b3ca53f2c8e2ec05bc9072b59b599f16e22b,1,Pallav Kulshreshtha,2016-05-12 13:22:38+05:18,['c63a8627cc447d4ecd3f01155a79709d9009e9c5'],0,5,5,22777313,1,,,,24226
4b6fe031eb1aa0384104767a96e8afe580ad4198,1,Pallav Kulshreshtha,2016-05-12 13:27:58+05:18,['4bd4b3ca53f2c8e2ec05bc9072b59b599f16e22b'],0,13,13,22777326,1,1,1,1,24226
78310fd00100cac7c1e401dd0378fa624acf70ec,0,Pallav Kulshreshtha,2016-05-12 14:26:20+05:18,['4b6fe031eb1aa0384104767a96e8afe580ad4198'],1,1,2,22777328,1,,,,24226
270a8098942d1b80347a798a3b5241bae1bd16d1,0,Pallav Kulshreshtha,2016-05-12 14:59:06+05:18,['78310fd00100cac7c1e401dd0378fa624acf70ec'],2,9,11,22777339,2,1,1,1,24226
0a0009a97defb12db9d9a5c75bc73388154bfd7f,1,Alex Antonenko,2016-05-12 14:29:36+03:00,['270a8098942d1b80347a798a3b5241bae1bd16d1'],1,5,6,22777345,2,1,1,1,24226
56f4c618a7fa6cfc714e429e73d468788740352f,1,Alex Antonenko,2016-05-12 14:29:36+03:00,['0a0009a97defb12db9d9a5c75bc73388154bfd7f'],1,1,2,22777347,1,,,,24226
e9cfce9c38bd6f80974bd438f2434a44d14a4b02,1,Andrew Onishuk,2016-05-12 14:38:37+03:00,['56f4c618a7fa6cfc714e429e73d468788740352f'],4,13,17,22777364,2,0.222222222,0.222222222,1,24226
3a98919ee6cefbf4b9ac17f3619285e82e438c21,1,oleewere,2016-05-12 14:19:03+02:00,['e9cfce9c38bd6f80974bd438f2434a44d14a4b02'],2,2,4,22777368,2,,,,24226
402f9c73fe875f46356bce8c0de6eea08cb1a881,1,oleewere,2016-05-12 15:55:52+02:00,['3a98919ee6cefbf4b9ac17f3619285e82e438c21'],1,11,12,22777380,2,0,0.777777778,0.777777778,24226
21984fcc430ab57a5de6e96ca398c51fdef9d453,1,Andrew Onishuk,2016-05-12 17:50:18+03:00,['402f9c73fe875f46356bce8c0de6eea08cb1a881'],6,47,53,22777433,3,0,1,1,24227
7bdfd3b542a80510e91a94072161a63a2c488bc2,1,Myroslav Papirkovskyi,2016-05-12 18:33:21+03:00,['21984fcc430ab57a5de6e96ca398c51fdef9d453'],7,96,103,22777536,4,0.925,0.925,1,24228
be25c9e77197be8e056c1bb9aa3651c16dd6fd62,1,Myroslav Papirkovskyi,2016-05-12 18:40:27+03:00,['7bdfd3b542a80510e91a94072161a63a2c488bc2'],26,177,203,22777739,4,0.18556701,0.927835052,0.855670103,24228
aab01b70caa4671f4120e6fdd155454340b56de0,1,oleewere,2016-05-12 18:05:56+02:00,['be25c9e77197be8e056c1bb9aa3651c16dd6fd62'],56,56,112,22777851,10,,,,24228
392e57dc5b653ae9756a2416c4858b60c5878e37,1,Nate Cole,2016-05-12 12:53:45-04:00,['aab01b70caa4671f4120e6fdd155454340b56de0'],76,170,246,22778097,10,0,0.253521127,0.774647887,24228
76785453ba0b63464088c34aac1ad61ee99dd797,1,tbeerbower,2016-05-12 13:54:13-04:00,['392e57dc5b653ae9756a2416c4858b60c5878e37'],19,4,23,22778120,3,1,1,0,24228
8f67e1c80bfd11de34af763b98103183fbb0177a,1,tbeerbower,2016-05-12 13:58:19-04:00,['76785453ba0b63464088c34aac1ad61ee99dd797'],12,75,87,22778207,9,0,1,1,24229
2d4e49f772a8cf4f30a26a3157e6e3f3384ff097,1,Jaimin Jetly,2016-05-12 11:02:00-07:00,['8f67e1c80bfd11de34af763b98103183fbb0177a'],0,126,126,22778333,4,0,0.555555556,0.444444444,24231
765b259e505cc71fe15ff368ed2fe337c8067052,1,Vitaly Brodetskyi,2016-05-12 19:19:26+03:00,['2d4e49f772a8cf4f30a26a3157e6e3f3384ff097'],8,8,16,22778349,2,,,,24231
0c910b31d429b8f83619cdebe5ab9fbac44360b1,1,Aleksandr Kovalenko,2016-05-12 23:55:35+03:00,['765b259e505cc71fe15ff368ed2fe337c8067052'],19,38,57,22778406,4,0.80952381,1,1,24231
57bda34701c634cdb98a65d8289aac470932b798,0,Jaimin Jetly,2016-05-12 17:11:27-07:00,['0c910b31d429b8f83619cdebe5ab9fbac44360b1'],2,0,2,22778408,1,0,0,0,24231
862d5b36dd37b226e9c6bc5b9bb7c232ed141bf8,1,Gautam Borad,2016-05-13 10:57:21+05:18,['57bda34701c634cdb98a65d8289aac470932b798'],127,41,168,22778576,14,0.623188406,0.405797101,0.985507246,24231
94cd86df3d76b7056ad512113bf6f53b7b2e862d,1,Andrew Onishuk,2016-05-13 15:20:15+03:00,['862d5b36dd37b226e9c6bc5b9bb7c232ed141bf8'],0,4,4,22778580,1,1,1,1,24231
64ae247a146560c704744da7f4e3156ac45d7327,0,Robert Levas,2016-05-13 09:08:50-04:00,['94cd86df3d76b7056ad512113bf6f53b7b2e862d'],1,11,12,22778592,1,,,,24231
1dccde21949beb3bf0f5da2addf57f597a965d24,1,Dipayan Bhowmick,2016-05-13 18:27:41+05:18,['64ae247a146560c704744da7f4e3156ac45d7327'],0,10,10,22778602,1,0,1,1,24231
f5cfd9c4e6bc73969fca8bd85dede3f8a92ad081,1,oleewere,2016-05-13 15:10:57+02:00,['1dccde21949beb3bf0f5da2addf57f597a965d24'],0,17,17,22778619,1,,,,24231
a729e7c25e97bf8b5dacbec4a234fbd448230a25,1,Dipayan Bhowmick,2016-05-13 18:36:08+05:18,['f5cfd9c4e6bc73969fca8bd85dede3f8a92ad081'],10,122,132,22778751,2,0.941176471,1,0.549019608,24232
5ce2024969a77139dd1430b2c1328717c273130d,0,Srimanth Gunturi,2016-05-13 07:00:01-07:00,['a729e7c25e97bf8b5dacbec4a234fbd448230a25'],0,4,4,22778755,2,,,,24232
16014374ec3c8f33eee247f1bf7cf7455deea176,1,Oleg Nechiporenko,2016-05-13 17:07:58+03:00,['5ce2024969a77139dd1430b2c1328717c273130d'],18,28,46,22778801,5,,,,24232
13fda8a38a4f84de0fa557249481cc89950da9f8,1,Dipayan Bhowmick,2016-05-13 19:44:37+05:18,['16014374ec3c8f33eee247f1bf7cf7455deea176'],3,3,6,22778807,1,,,,24232
65bad4e39f86150eba45046747d599ff9adaf106,1,Andrii Tkach,2016-05-13 17:33:33+03:00,['13fda8a38a4f84de0fa557249481cc89950da9f8'],8,76,84,22778891,3,1,1,1,24232
7d6d24743a36a6bcd68d0b7d11e80c8d257fd38e,1,Robert Levas,2016-05-13 11:10:08-04:00,['65bad4e39f86150eba45046747d599ff9adaf106'],19,19,38,22778929,14,,,,24232
ca630b868ed27b1c6ead3b645f453387c84586fb,0,oleewere,2016-05-13 17:11:51+02:00,['7d6d24743a36a6bcd68d0b7d11e80c8d257fd38e'],26,9,35,22778964,9,1,0,0.133333333,24232
c3e482f7817a91eadb5b804af8bee267105f2ae1,1,Alex Antonenko,2016-05-13 18:13:45+03:00,['ca630b868ed27b1c6ead3b645f453387c84586fb'],340,371,711,22779675,14,1,1,1,24232
bd377e67b476d93596be72697f4a6b2a7808504e,1,oleewere,2016-05-13 18:03:34+02:00,['c3e482f7817a91eadb5b804af8bee267105f2ae1'],31,64,95,22779770,5,0.92,0.92,1,24232
8ea88104fc3628b59ece827238214eff9604b2fe,1,oleewere,2016-05-13 18:20:19+02:00,['bd377e67b476d93596be72697f4a6b2a7808504e'],66,232,298,22780068,6,0.210526316,0,0.431578947,24232
0b18f023b4188b952e3fc835da3f5a6ccf1e206e,1,Aleksandr Kovalenko,2016-05-13 20:14:14+03:00,['8ea88104fc3628b59ece827238214eff9604b2fe'],0,2,2,22780070,2,,,,24232
4245645c375e958ad90c3c34f322e46c35768375,1,Matt,2016-05-13 10:29:43-07:00,['0b18f023b4188b952e3fc835da3f5a6ccf1e206e'],14,319,333,22780403,13,0.393939394,1,0.825757576,24236
14303394d6b31244bdff65016903a98d82c9f32b,1,Robert Levas,2016-05-13 14:44:28-04:00,['4245645c375e958ad90c3c34f322e46c35768375'],8,289,297,22780700,5,0,0.872037915,0.995260664,24236
69b7d2742895221696723f15373fe61140529f94,1,Jayush Luniya,2016-05-13 14:14:56-07:00,['14303394d6b31244bdff65016903a98d82c9f32b'],250,235,485,22781185,15,1,1,0,24236
4cb895c6cda9a3abd03ff163eebc61f1c61d4eaf,1,Matt,2016-05-13 15:08:19-07:00,['69b7d2742895221696723f15373fe61140529f94'],13,180,193,22781378,4,0.11023622,0.68503937,0.897637795,24237
8af1a231e3c7f88f167a40ea2c8ee12eccb5495e,1,Bhuvnesh Chaudhary,2016-05-13 15:12:57-07:00,['4cb895c6cda9a3abd03ff163eebc61f1c61d4eaf'],8,10,18,22781396,5,,,,24237
3c7dbd948d00e6e069c5259365e4058161a2a137,1,Jonathan Hurley,2016-05-13 18:16:59-04:00,['8af1a231e3c7f88f167a40ea2c8ee12eccb5495e'],17,17,34,22781430,7,,,,24237
e306c393d05ea3d6c28f004a4528f522b5e771cf,1,Richard Zang,2016-05-13 15:27:36-07:00,['3c7dbd948d00e6e069c5259365e4058161a2a137'],19,692,711,22782141,4,0.168614357,0.87312187,1,24237
d0551d46a4df5001ba4a31345005f0dd2d14cdcb,0,Jayush Luniya,2016-05-13 16:48:00-07:00,['e306c393d05ea3d6c28f004a4528f522b5e771cf'],0,0,0,22782141,1,,,,24237
1184a18b2c42492b46e39b57da472bf1354c0d1a,0,Bhuvnesh Chaudhary,2016-05-13 17:07:57-07:00,['d0551d46a4df5001ba4a31345005f0dd2d14cdcb'],0,3,3,22782144,1,,,,24237
4e272347441918c0f7ef0010f1530eeceb9187f4,0,Jayush Luniya,2016-05-13 23:02:09-07:00,['1184a18b2c42492b46e39b57da472bf1354c0d1a'],7,652,659,22782803,17,0.144329897,0.721649485,0.206185567,24244
84bd9ca44b57a7a0157fb7fe394e3e42f1809bd6,1,Jayush Luniya,2016-05-14 02:09:45-07:00,['4e272347441918c0f7ef0010f1530eeceb9187f4'],64,128,192,22782995,36,,,,24244
9a4c0d6bd1017787ee3e4d03fe4bb1eec321c771,1,Swapan Shridhar,2016-05-14 11:56:28-07:00,['84bd9ca44b57a7a0157fb7fe394e3e42f1809bd6'],6,67,73,22783068,2,0,0.893617021,0,24244
ab2d40aa1f315671ac15ce0d64ec08ae38a337ed,1,Jayush Luniya,2016-05-15 23:12:19-07:00,['9a4c0d6bd1017787ee3e4d03fe4bb1eec321c771'],654,857,1511,22784579,32,,,,24249
0e6e4d21d5d30305048b603897d54677a9bb94e9,0,Jayush Luniya,2016-05-15 23:15:58-07:00,['ab2d40aa1f315671ac15ce0d64ec08ae38a337ed'],652,7,659,22785238,17,0.855670103,0.278350515,0.793814433,24249
3f0c743e244495a478320333e1dcbcd63009c754,1,Jaimin Jetly,2016-05-16 00:01:15-07:00,['0e6e4d21d5d30305048b603897d54677a9bb94e9'],375,2548,2923,22788161,4,0.6,0,0,24249
9540df5a8184ab9f8ffd9248c775192212f3e3b5,0,Andrii Tkach,2016-05-16 12:37:55+03:00,['3f0c743e244495a478320333e1dcbcd63009c754'],0,30,30,22788191,2,1,1,1,24249
31ea86c73b4ce8778b6bf6f44949c140cc553c13,0,ababiichuk,2016-05-16 13:00:21+03:00,['9540df5a8184ab9f8ffd9248c775192212f3e3b5'],4,77,81,22788272,2,0.912280702,1,0.947368421,24249
aa92214eacf4df8d7c1994ea28626bbf1d3aba27,1,ababiichuk,2016-05-16 13:21:00+03:00,['31ea86c73b4ce8778b6bf6f44949c140cc553c13'],1,1,2,22788274,1,,,,24249
b9dd34fb873b468c204569e9120afb03d31b7130,0,Alex Antonenko,2016-05-16 13:55:25+03:00,['aa92214eacf4df8d7c1994ea28626bbf1d3aba27'],10,10,20,22788294,2,,,,24249
d7fcddef2f59712e187110ec3969ca7e60b4befb,1,Alex Antonenko,2016-05-16 13:55:25+03:00,['b9dd34fb873b468c204569e9120afb03d31b7130'],53,261,314,22788608,9,0.373417722,1,0.892405063,24250
c431ef36a22e1daf14671885122c02092142d04e,1,Pallav Kulshreshtha,2016-05-16 18:43:44+05:18,['d7fcddef2f59712e187110ec3969ca7e60b4befb'],64,354,418,22789026,10,0,0.920930233,0.962790698,24250
715062b5de5c65ab85f52542358a2b5d162e0699,1,Pallav Kulshreshtha,2016-05-16 18:55:54+05:18,['c431ef36a22e1daf14671885122c02092142d04e'],6,13,19,22789045,1,1,1,1,24250
5b1f2a6ccb9c2fc7c5a44eb3f48b28e8ff6ba2dc,1,ababiichuk,2016-05-16 16:38:34+03:00,['715062b5de5c65ab85f52542358a2b5d162e0699'],2,8,10,22789055,2,0.833333333,1,1,24250
f4569bb4a0473418ccebd40af80d49e531ac44ef,1,Pallav Kulshreshtha,2016-05-16 19:05:17+05:18,['5b1f2a6ccb9c2fc7c5a44eb3f48b28e8ff6ba2dc'],2,3,5,22789060,1,,,,24250
dd475a9a0ee33007a2759ef6bb68e17f8a69d671,1,Andrii Tkach,2016-05-16 18:19:43+03:00,['f4569bb4a0473418ccebd40af80d49e531ac44ef'],0,58,58,22789118,3,1,1,1,24250
48767597873a5465e4fc095b22c11d7e9a597a49,1,Vitaly Brodetskyi,2016-05-16 16:33:30+03:00,['dd475a9a0ee33007a2759ef6bb68e17f8a69d671'],5,57,62,22789180,4,0,0,1,24251
b9ec3e68c1ce80625fbc91be1c7ad5501ea0eac1,0,Andrew Onishuk,2016-05-16 19:23:49+03:00,['48767597873a5465e4fc095b22c11d7e9a597a49'],6,11,17,22789197,4,1,0,1,24251
acccd3acb2c2dcbd0347538be29d64366fb220c4,1,Andrew Onishuk,2016-05-16 19:29:03+03:00,['b9ec3e68c1ce80625fbc91be1c7ad5501ea0eac1'],11,6,17,22789214,4,0,1,0,24251
b9b634ac4737b01ef90d3f0d79dae47cb3e03b8f,1,Andrew Onishuk,2016-05-16 19:30:30+03:00,['acccd3acb2c2dcbd0347538be29d64366fb220c4'],5,5,10,22789224,5,,,,24251
08d61373fa40077d76e09fa61de9b1c58de830e1,1,Aravindan Vijayan,2016-05-16 09:46:48-07:00,['b9b634ac4737b01ef90d3f0d79dae47cb3e03b8f'],2,2,4,22789228,1,,,,24251
b33bebb5d81d95bbb53734d14c617d53de3f9555,1,Aravindan Vijayan,2016-05-16 09:47:30-07:00,['08d61373fa40077d76e09fa61de9b1c58de830e1'],1,45,46,22789274,2,1,1,1,24251
93a045df49b48de52cbd39821e89cfd65e49d923,1,Aleksandr Kovalenko,2016-05-16 19:53:06+03:00,['b33bebb5d81d95bbb53734d14c617d53de3f9555'],17,49,66,22789340,4,1,1,1,24251
b2ece8c2bee477d0aab81ff35ce2e6032a639ef8,0,Richard Zang,2016-05-16 14:36:24-07:00,['93a045df49b48de52cbd39821e89cfd65e49d923'],3,3,6,22789346,1,0,1,0,24251
1c60f63504be0f72878a8395ccefb0165d0c996e,1,Jonathan Hurley,2016-05-16 19:44:54-04:00,['b2ece8c2bee477d0aab81ff35ce2e6032a639ef8'],950,1358,2308,22791654,20,0.37254902,0.176470588,1,24252
e2a1a5f8ae61cfb82834efaacb827ad7177aeecb,1,Siddharth Wagle,2016-05-16 17:48:21-07:00,['1c60f63504be0f72878a8395ccefb0165d0c996e'],9,15,24,22791678,23,1,0,,24252
218bda793b97b4affddc17e6e7b35ec9e79f0966,0,Andrii Tkach,2016-05-17 12:07:22+03:00,['e2a1a5f8ae61cfb82834efaacb827ad7177aeecb'],1,5,6,22791684,1,,,,24252
5fdbc1625233546c22933320c86ac0262a751ed1,1,oleewere,2016-05-17 11:59:53+02:00,['218bda793b97b4affddc17e6e7b35ec9e79f0966'],64,420,484,22792168,15,0.208695652,0.504347826,1,24252
76d2edc516fe2bcbc767a987aee2ba9caf037cad,1,oleewere,2016-05-17 12:13:30+02:00,['5fdbc1625233546c22933320c86ac0262a751ed1'],0,163,163,22792331,1,,,,24252
0d5b881c418264287c07455f0b96bf41c3df9c02,0,oleewere,2016-05-17 12:43:55+02:00,['76d2edc516fe2bcbc767a987aee2ba9caf037cad'],1,1,2,22792333,1,,,,24252
ea08b971c370a784e47977cc4f6358d86f6b6f7d,1,tbeerbower,2016-05-17 09:13:55-04:00,['0d5b881c418264287c07455f0b96bf41c3df9c02'],1,2,3,22792336,1,,,,24252
2289c766126482e0f7eff7ad31f90db6b942d8ce,1,Andrew Onishuk,2016-05-17 16:55:06+03:00,['ea08b971c370a784e47977cc4f6358d86f6b6f7d'],5,16,21,22792357,3,0,0,0,24252
9d6aecf570932619e7a45cc7200dc2a5addbb7a0,0,Nate Cole,2016-05-17 10:38:58-04:00,['2289c766126482e0f7eff7ad31f90db6b942d8ce'],2,2,4,22792361,1,,,,24252
a63917335d99a7569eba7d9a392aa940cdafba16,0,Andrew Onishuk,2016-05-17 17:58:40+03:00,['9d6aecf570932619e7a45cc7200dc2a5addbb7a0'],0,2,2,22792363,1,,,,24252
83017ecec497e5bc80478737ccfbbe164d3b39aa,1,ababiichuk,2016-05-17 18:02:03+03:00,['a63917335d99a7569eba7d9a392aa940cdafba16'],0,1,1,22792364,1,,,,24252
1893d15f9ee2faff2ad680daa27208aa752ef081,1,ababiichuk,2016-05-17 18:02:50+03:00,['83017ecec497e5bc80478737ccfbbe164d3b39aa'],24,53,77,22792441,2,1,1,1,24252
0ed6f8a8eb2107220977ebc1429b9cb469c2bdf9,1,Alex Antonenko,2016-05-17 18:48:46+03:00,['1893d15f9ee2faff2ad680daa27208aa752ef081'],1,1,2,22792443,1,,,,24252
9dccb666fd71b1cadbeb5c16cbc8bc0d12b50cb9,1,Aleksandr Kovalenko,2016-05-17 19:00:57+03:00,['0ed6f8a8eb2107220977ebc1429b9cb469c2bdf9'],7,31,38,22792481,5,1,1,1,24252
e758bbecc4e1b8eedb313e5a409d66f2ba6a72a8,1,Dipayan Bhowmick,2016-05-18 01:01:01+05:18,['9dccb666fd71b1cadbeb5c16cbc8bc0d12b50cb9'],0,42,42,22792523,2,1,1,1,24253
80448bbfbfca3607af0110912e41d7c73234d0cf,1,Dipayan Bhowmick,2016-05-18 01:09:05+05:18,['e758bbecc4e1b8eedb313e5a409d66f2ba6a72a8'],25,127,152,22792675,15,0.202898551,0.043478261,1,24253
4dbb9807cef104d64e9cc2120879f4f77e6a5341,1,Dipayan Bhowmick,2016-05-18 01:14:46+05:18,['80448bbfbfca3607af0110912e41d7c73234d0cf'],48,135,183,22792858,9,0.022727273,0.568181818,1,24253
4432c1f75bb359f21efed4a40517d61669b13b32,1,Jaimin Jetly,2016-05-17 13:28:34-07:00,['4dbb9807cef104d64e9cc2120879f4f77e6a5341'],201,158,359,22793217,4,0,0,0.228571429,24253
a01d50b085e3b68e3c7494b3cb7ca5d8be0dea4e,0,Andrew Onishuk,2016-05-17 23:57:26+03:00,['4432c1f75bb359f21efed4a40517d61669b13b32'],11,13,24,22793241,1,,,,24253
00320d9acbe753cbc822f262fbf7ec432939b268,0,Bhuvnesh Chaudhary,2016-05-17 16:27:12-07:00,['a01d50b085e3b68e3c7494b3cb7ca5d8be0dea4e'],38,0,38,22793279,1,,,,24253
6564825312f59cfc6566bb1307e459b04ae69679,0,Siddharth Wagle,2016-05-17 16:46:48-07:00,['00320d9acbe753cbc822f262fbf7ec432939b268'],1,39,40,22793319,2,0,0,0,24253
2700b4470c8ef1d87e298dbb34d02fc369a65309,0,Siddharth Wagle,2016-05-17 17:18:15-07:00,['6564825312f59cfc6566bb1307e459b04ae69679'],4,4,8,22793327,1,,,,24253
bffde0a59c3d8f203878c35a93372a29cb50bf23,0,Siddharth Wagle,2016-05-17 19:14:45-07:00,['2700b4470c8ef1d87e298dbb34d02fc369a65309'],2,2,4,22793331,1,,,,24253
187ab949db1a982c407534f3969f177728e632d5,0,Siddharth Wagle,2016-05-17 19:16:51-07:00,['bffde0a59c3d8f203878c35a93372a29cb50bf23'],1,1,2,22793333,1,,,,24253
701ea2bd82e68465118308d7d9e136630f79eeee,1,Pallav Kulshreshtha,2016-05-18 12:15:24+05:18,['187ab949db1a982c407534f3969f177728e632d5'],104,245,349,22793682,8,1,1,0.2,24255
40fe30bfe7d58ce56e128d8c09be6cb947eff92f,1,"Toader, Sebastian",2016-05-18 09:17:00+02:00,['701ea2bd82e68465118308d7d9e136630f79eeee'],4,8,12,22793694,2,0,0,1,24255
7d516272c6a035e0bd970cb592061ea08a40a942,0,"Toader, Sebastian",2016-05-18 09:22:28+02:00,['40fe30bfe7d58ce56e128d8c09be6cb947eff92f'],0,1,1,22793695,1,0,0,0,24255
c418de5cd602d259da8476b414646b6ce744f3b2,1,tbeerbower,2016-05-18 09:14:37-04:00,['7d516272c6a035e0bd970cb592061ea08a40a942'],9,14,23,22793718,4,,,,24255
e598ce2b12f2c4c1166ce9ed71705ffe64607823,1,Gautam Borad,2016-05-18 18:59:17+05:18,['c418de5cd602d259da8476b414646b6ce744f3b2'],3,8,11,22793729,2,0,0,1,24255
82149886c1c883945e3cd1043f7cc87881be5f8c,1,Alex Antonenko,2016-05-18 16:58:12+03:00,['e598ce2b12f2c4c1166ce9ed71705ffe64607823'],2,37,39,22793768,4,0.444444444,0.694444444,1,24255
4426c62edd21d6c9c30ac4d29abddca0d0112b1d,1,Andrew Onishuk,2016-05-18 17:05:36+03:00,['82149886c1c883945e3cd1043f7cc87881be5f8c'],3,43,46,22793814,2,0.291666667,0.291666667,1,24255
3f080663a4b84ddf8cae52fcbf05599114503e1b,1,Andrew Onishuk,2016-05-18 18:26:52+03:00,['4426c62edd21d6c9c30ac4d29abddca0d0112b1d'],3,10,13,22793827,2,0.666666667,0.666666667,0,24255
bffcbd28561ce2940ab659cbbd0fd32be81dd3f5,1,Jonathan Hurley,2016-05-18 14:20:07-04:00,['3f080663a4b84ddf8cae52fcbf05599114503e1b'],474,86,560,22794387,22,0.753424658,0.164383562,0.666666667,24255
14617e76a3122920dd73605897f7372822695547,0,Zhe (Joe) Wang,2016-05-18 14:33:34-04:00,['bffcbd28561ce2940ab659cbbd0fd32be81dd3f5'],1,7,8,22794395,2,0.2,0.8,0.8,24255
24e9b6d262528029b581ecdab789e148de998e1a,0,Jonathan Hurley,2016-05-18 14:44:41-04:00,['14617e76a3122920dd73605897f7372822695547'],1,4,5,22794400,1,1,1,1,24255
e3a8cd552b490a56fd56b91c01530333c4ab963b,1,Richard Zang,2016-05-18 11:53:33-07:00,['24e9b6d262528029b581ecdab789e148de998e1a'],41,87,128,22794528,4,1,1,1,24255
c53de061f3c48504881a18a9fb19f1c702bd72ce,0,Srimanth Gunturi,2016-05-18 13:45:44-07:00,['e3a8cd552b490a56fd56b91c01530333c4ab963b'],23,214,237,22794765,18,0.317460317,0.785714286,0.928571429,24255
e30a3c086d231bdcac6c0bc12f4e1cf126d55052,1,Swapan Shridhar,2016-05-18 16:03:17-07:00,['c53de061f3c48504881a18a9fb19f1c702bd72ce'],1647,2216,3863,22798628,5,0,0.938162544,1,24255
2344384421465e5dae3ae418bc985f9af60199b2,0,Zhe (Joe) Wang,2016-05-19 00:58:29-04:00,['e30a3c086d231bdcac6c0bc12f4e1cf126d55052'],3,17,20,22798648,2,0.8,1,1,24255
accda5c15ce6dca917ea09cda486e6d889f857d9,0,Zhe (Joe) Wang,2016-05-19 01:03:42-04:00,['2344384421465e5dae3ae418bc985f9af60199b2'],1,43,44,22798692,1,1,1,1,24255
6672b74f933f2eb8b436e709241e2cd1385f5894,1,Matt,2016-05-18 23:22:45-07:00,['accda5c15ce6dca917ea09cda486e6d889f857d9'],3,48,51,22798743,2,0.085714286,1,1,24255
420c8d58c8dd0fd60b36b9376c170d96c95c59c7,0,Alex Antonenko,2016-05-19 12:43:52+03:00,['6672b74f933f2eb8b436e709241e2cd1385f5894'],0,59,59,22798802,2,0.66,1,1,24255
4440db3fdf6db64c1565b696be5959c19cf8d81c,0,Alex Antonenko,2016-05-19 12:43:52+03:00,['420c8d58c8dd0fd60b36b9376c170d96c95c59c7'],3,2,5,22798807,1,0,0,0,24255
347fd2fac574f98974c60321ce81af2cd81acb4a,0,Alex Antonenko,2016-05-19 12:43:52+03:00,['4440db3fdf6db64c1565b696be5959c19cf8d81c'],3,3,6,22798813,1,,,,24255
291577035c076435376c224c8d987ad6bd8b702e,0,Andrew Onishuk,2016-05-19 13:24:01+03:00,['347fd2fac574f98974c60321ce81af2cd81acb4a'],20,40,60,22798873,3,0,1,1,24257
042f26110b13dd5ab6a8af129157f283f9224bde,1,Aleksandr Kovalenko,2016-05-19 14:00:31+03:00,['291577035c076435376c224c8d987ad6bd8b702e'],23,115,138,22799011,2,0.290322581,1,1,24257
82af4e0d813e45c03d61de4bc111b2245a6d3d08,1,Andrew Onishuk,2016-05-19 14:18:40+03:00,['042f26110b13dd5ab6a8af129157f283f9224bde'],96,105,201,22799212,4,1,0,0,24257
45d58644817447770fe913b36ff0db5647132508,1,Dmytro Sen,2016-05-19 14:32:00+03:00,['82af4e0d813e45c03d61de4bc111b2245a6d3d08'],2,41,43,22799255,2,0.44,1,1,24257
41247c17401ea7382732ebd5e5581ce0084af87d,1,Myroslav Papirkovskyi,2016-05-19 14:38:21+03:00,['45d58644817447770fe913b36ff0db5647132508'],4,4,8,22799263,2,,,,24257
8ee7ddbb9806269cf2ee9793b9ca7a340d9c042a,1,Andrew Onishuk,2016-05-19 14:59:18+03:00,['41247c17401ea7382732ebd5e5581ce0084af87d'],40,20,60,22799323,3,1,0,0,24257
6e44c8d981d60c66ec50ffbaa331dd643c1bb97a,0,Gautam Borad,2016-05-19 17:36:38+05:18,['8ee7ddbb9806269cf2ee9793b9ca7a340d9c042a'],3,4,7,22799330,1,0,0,1,24257
4408d779b8aa9c56eb8d63208003ba1d3f2281ac,1,Andrew Onishuk,2016-05-19 15:53:56+03:00,['6e44c8d981d60c66ec50ffbaa331dd643c1bb97a'],20,36,56,22799386,2,0,1,1,24258
234b9cdadadf9096ff49965b9c81b1abc3d5a751,1,Alex Antonenko,2016-05-19 17:01:06+03:00,['4408d779b8aa9c56eb8d63208003ba1d3f2281ac'],0,46,46,22799432,2,1,1,0.285714286,24259
9d5f1b4005278d237f094a8a32258d20a046dd75,0,Alex Antonenko,2016-05-19 17:01:06+03:00,['234b9cdadadf9096ff49965b9c81b1abc3d5a751'],1,1,2,22799434,1,,,,24259
6a03b338143857eb5c7325c070315c59ab513794,1,Nahappan Somasundaram,2016-05-19 07:24:25-07:00,['9d5f1b4005278d237f094a8a32258d20a046dd75'],3,3,6,22799440,1,,,,24259
785dd318ff42a8d934f0bce394bdf3da4125f4f8,0,ababiichuk,2016-05-19 17:44:36+03:00,['6a03b338143857eb5c7325c070315c59ab513794'],1,40,41,22799481,2,0.3125,1,1,24259
9a5f012d20f554fd4fbc817902ee1124291d7551,1,tbeerbower,2016-05-19 10:46:54-04:00,['785dd318ff42a8d934f0bce394bdf3da4125f4f8'],0,32,32,22799513,1,,,,24259
1389d2c4f79ebffbbcd9d89ee959ae4b14fee954,1,Di Li,2016-05-19 11:09:43-04:00,['9a5f012d20f554fd4fbc817902ee1124291d7551'],1,1,2,22799515,1,,,,24259
950532c9a931fe3488b780752dbb172b29015110,1,Hitesh Shah,2016-05-19 08:34:14-07:00,['1389d2c4f79ebffbbcd9d89ee959ae4b14fee954'],1,1,2,22799517,1,,,,24259
b381562174c249925f4ec6e2fde4b292ac2297da,1,Pallav Kulshreshtha,2016-05-19 22:12:42+05:18,['950532c9a931fe3488b780752dbb172b29015110'],0,5,5,22799522,1,,,,24259
cca6968efbe4c7f2c1bbc76c5f4a39a328a10791,1,Pallav Kulshreshtha,2016-05-19 22:40:20+05:18,['b381562174c249925f4ec6e2fde4b292ac2297da'],18,140,158,22799680,9,0.972222222,1,0.777777778,24261
239e7a6e3eade9f9e896348051e7cb46311c1f7a,1,Vitaly Brodetskyi,2016-05-19 18:23:06+03:00,['cca6968efbe4c7f2c1bbc76c5f4a39a328a10791'],61,292,353,22800033,34,0,0,0.810526316,24261
44809778363567c632cc0bf1f803310379274555,1,Alex Antonenko,2016-05-19 20:48:55+03:00,['239e7a6e3eade9f9e896348051e7cb46311c1f7a'],21,23,44,22800077,3,1,1,1,24261
db899b51438ee6ba317e37ac1508488b21f07a29,1,Andrii Tkach,2016-05-19 20:59:36+03:00,['44809778363567c632cc0bf1f803310379274555'],7,19,26,22800103,3,1,1,1,24261
4136ea74fec1c00e4a78653ddedb8078259011e8,1,Pallav Kulshreshtha,2016-05-19 23:27:41+05:18,['db899b51438ee6ba317e37ac1508488b21f07a29'],1,19,20,22800123,3,1,1,1,24261
fef680331e741956997cc94ffc7aadbde6d0ac1c,0,Pallav Kulshreshtha,2016-05-19 23:40:20+05:18,['4136ea74fec1c00e4a78653ddedb8078259011e8'],2,8,10,22800133,1,0,0,1,24261
5660554ec0568bb9764017e0c54bd7a626036c71,1,Pallav Kulshreshtha,2016-05-19 23:52:23+05:18,['fef680331e741956997cc94ffc7aadbde6d0ac1c'],21,89,110,22800243,3,0.32,0.32,1,24261
766b4d983484b9a2eb5534e42912a8455db51857,1,Bhuvnesh Chaudhary,2016-05-19 11:46:53-07:00,['5660554ec0568bb9764017e0c54bd7a626036c71'],1,2,3,22800246,1,1,1,1,24261
42e69f371fe1f757f48938f7ebb09eb8d5798b1a,1,Bhuvnesh Chaudhary,2016-05-19 12:15:13-07:00,['766b4d983484b9a2eb5534e42912a8455db51857'],8,67,75,22800321,2,0,0.717948718,0.717948718,24261
f8b427494b36c92f8a36c59d1a7233b5a130f4e7,1,Jayush Luniya,2016-05-19 14:21:22-07:00,['42e69f371fe1f757f48938f7ebb09eb8d5798b1a'],48,1905,1953,22802274,30,0.238683128,0.654320988,0.911522634,24272
fb3afc6a0214fad2971e55a44c98c93236a9b933,1,Jayush Luniya,2016-05-19 14:30:39-07:00,['f8b427494b36c92f8a36c59d1a7233b5a130f4e7'],27,53,80,22802354,16,,,,24272
9e98dc039e5bb92e8bf536a35be5a23c067f67a4,1,Nate Cole,2016-05-19 17:31:33-04:00,['fb3afc6a0214fad2971e55a44c98c93236a9b933'],4,5,9,22802363,1,0,0,1,24272
0aa21bc02822f83ce14f806fc2cb543c66af2f07,1,Jayush Luniya,2016-05-19 14:34:29-07:00,['9e98dc039e5bb92e8bf536a35be5a23c067f67a4'],23,36,59,22802422,11,,,,24272
5b2863cd7faec2c71de87c5bbeeb480819632650,1,Jayush Luniya,2016-05-19 14:48:40-07:00,['0aa21bc02822f83ce14f806fc2cb543c66af2f07'],16,35,51,22802473,10,,,,24272
1be1d049531b695db7b830667ea1c51073ea06f0,1,Jayush Luniya,2016-05-19 14:51:35-07:00,['5b2863cd7faec2c71de87c5bbeeb480819632650'],4,19,23,22802496,4,,,,24272
b3f72e1e5d89369e5f15538e90a977baf4f9be37,0,Matt,2016-05-19 15:04:06-07:00,['1be1d049531b695db7b830667ea1c51073ea06f0'],5,144,149,22802645,2,0.368421053,1,0.778947368,24273
999ec6cbd7aef6b8ddac5927c374a7b301d28b86,0,Matt,2016-05-19 15:27:40-07:00,['b3f72e1e5d89369e5f15538e90a977baf4f9be37'],1,0,1,22802646,1,,,,24273
5c84ff011de7f8dfab753a98ce6e209350a29cdc,0,Pallav Kulshreshtha,2016-05-20 12:38:52+05:18,['999ec6cbd7aef6b8ddac5927c374a7b301d28b86'],1,0,1,22802647,1,0,0,0,24273
83c9237b88c75b86c031ea5496e19d7b957562d7,1,Alex Antonenko,2016-05-20 10:30:48+03:00,['5c84ff011de7f8dfab753a98ce6e209350a29cdc'],31,72,103,22802750,2,,,,24273
9fb75ef6eb09638c8ed5031fde4eac5315f0ff7a,1,Dipayan Bhowmick,2016-05-20 14:58:31+05:18,['83c9237b88c75b86c031ea5496e19d7b957562d7'],15,42,57,22802807,6,0.818181818,0.818181818,1,24273
2d310cf0ebd730da8f0fe0facdecafb0edf81bbd,1,tbeerbower,2016-05-20 06:49:41-04:00,['9fb75ef6eb09638c8ed5031fde4eac5315f0ff7a'],4,4,8,22802815,2,,,,24273
848f40766cede55a4926d05f459fe001b9993fb4,1,Pallav Kulshreshtha,2016-05-20 16:27:08+05:18,['2d310cf0ebd730da8f0fe0facdecafb0edf81bbd'],17,38,55,22802870,8,1,1,1,24273
2bd3d3240482c53597e49a4c1a5ad350aa707840,0,Alex Antonenko,2016-05-20 14:10:54+03:00,['848f40766cede55a4926d05f459fe001b9993fb4'],2,0,2,22802872,1,0,0,0,24273
40ccef06b851c45346de4098f4793034b4f65b15,1,Alex Antonenko,2016-05-20 14:10:54+03:00,['2bd3d3240482c53597e49a4c1a5ad350aa707840'],4,70,74,22802946,6,1,1,1,24273
c2c5cb3f59c4efd25acb51cb89791bf7d4a4c699,1,Pallav Kulshreshtha,2016-05-20 16:45:07+05:18,['40ccef06b851c45346de4098f4793034b4f65b15'],4,12,16,22802962,3,1,1,1,24273
286e614cf67025b5a2338e9fd1a400ada8f15798,1,Pallav Kulshreshtha,2016-05-20 16:50:45+05:18,['c2c5cb3f59c4efd25acb51cb89791bf7d4a4c699'],14,16,30,22802992,3,0,0,0,24273
97cddacef16b9ab4969c8cd0cb15d3ef2f09b666,0,Dmytro Sen,2016-05-20 14:44:30+03:00,['286e614cf67025b5a2338e9fd1a400ada8f15798'],116,302,418,22803410,8,0.277227723,0.643564356,0.603960396,24274
18302d7dcfc06af3fe564c279dcbbd8b2a407efd,1,Pallav Kulshreshtha,2016-05-20 17:06:55+05:18,['97cddacef16b9ab4969c8cd0cb15d3ef2f09b666'],7,25,32,22803442,2,0.9375,1,1,24274
cff1e89307f44ff53cf70cc178b5460e5320878d,1,Pallav Kulshreshtha,2016-05-20 17:12:54+05:18,['18302d7dcfc06af3fe564c279dcbbd8b2a407efd'],71,109,180,22803622,5,0,0.137931034,0.827586207,24274
248239dfb491eb31abf25d007c7b720adf6dc56e,1,Andrew Onishuk,2016-05-20 14:56:30+03:00,['cff1e89307f44ff53cf70cc178b5460e5320878d'],0,5,5,22803627,2,1,1,1,24274
85798b397e9c551d18a685a4d67bfc5d36aed20a,1,Pallav Kulshreshtha,2016-05-20 17:49:39+05:18,['248239dfb491eb31abf25d007c7b720adf6dc56e'],441,389,830,22804457,14,1,0,0,24274
1acdb3a8d66817e463ccfc966f168f14f0254133,1,Pallav Kulshreshtha,2016-05-20 17:56:13+05:18,['85798b397e9c551d18a685a4d67bfc5d36aed20a'],5,44,49,22804506,1,0,0,1,24274
5664786995b99c8c2429f00456fbe7017724ec18,1,Alex Antonenko,2016-05-20 16:27:55+03:00,['1acdb3a8d66817e463ccfc966f168f14f0254133'],1,5,6,22804512,1,1,1,1,24274
776c63b69b2d02faec036187aa143267dbfd5426,1,oleewere,2016-05-20 17:07:05+02:00,['5664786995b99c8c2429f00456fbe7017724ec18'],3,3,6,22804518,3,,,,24274
f1acbe38110dd0d236db14b729830a06d4fd2738,1,Dmytro Sen,2016-05-20 20:22:23+03:00,['776c63b69b2d02faec036187aa143267dbfd5426'],5,31,36,22804554,2,0,0.72,1,24274
d818782d87aeb937840e8a045b02e4582099c4d3,1,Aleksandr Kovalenko,2016-05-20 20:33:31+03:00,['f1acbe38110dd0d236db14b729830a06d4fd2738'],25,20,45,22804599,6,,,,24274
2425189d76ffaf9f75faf596e1d86c3c84dc0e1e,1,Swapan Shridhar,2016-05-20 11:18:25-07:00,['d818782d87aeb937840e8a045b02e4582099c4d3'],1,28,29,22804628,3,0.714285714,0.047619048,0.952380952,24274
ae6d0106751467a1a38fb6e60213fb0f09ba692c,1,Vitaly Brodetskyi,2016-05-20 20:20:42+03:00,['2425189d76ffaf9f75faf596e1d86c3c84dc0e1e'],10,126,136,22804764,4,1,1,1,24274
9f0af38f2b01f74770e31affe78ccba49e712351,0,Robert Levas,2016-05-20 16:06:04-04:00,['ae6d0106751467a1a38fb6e60213fb0f09ba692c'],15,295,310,22805074,4,0.110497238,0.552486188,1,24274
3be74462f1e85163806cc6932e6c74a5d4845d4b,1,Srimanth Gunturi,2016-05-20 13:47:17-07:00,['9f0af38f2b01f74770e31affe78ccba49e712351'],17,7,24,22805098,1,,,,24274
c8a42f15d31d00aae5c75844966107ae6aa25546,0,Aravindan Vijayan,2016-05-20 14:10:51-07:00,['3be74462f1e85163806cc6932e6c74a5d4845d4b'],302,116,418,22805516,8,0.722772277,0.356435644,0.396039604,24274
364661dfa2a97198c492a4db1b7dece7e0481874,0,Bhuvnesh Chaudhary,2016-05-20 14:24:51-07:00,['c8a42f15d31d00aae5c75844966107ae6aa25546'],1,1,2,22805518,1,,,,24274
809b537175e074adb239fbdc24ac48c53eef29de,1,Bhuvnesh Chaudhary,2016-05-20 17:49:36-07:00,['364661dfa2a97198c492a4db1b7dece7e0481874'],1,72,73,22805591,2,0.310344828,1,0.689655172,24274
71a0f1e13a1d7b6dc186c6fcd60981f1135324e1,1,Jayush Luniya,2016-05-22 06:10:25-07:00,['809b537175e074adb239fbdc24ac48c53eef29de'],1,11,12,22805603,11,,,,24274
ac5215815958b912c5a4d4ec3c584bee14d4dec8,1,Matt,2016-05-22 13:12:29-07:00,['71a0f1e13a1d7b6dc186c6fcd60981f1135324e1'],8,94,102,22805705,2,0.156862745,0.725490196,0.823529412,24274
1a4e7a760ae2eadf3c6604a73cff6c06c89e6192,0,Matt,2016-05-22 13:25:22-07:00,['ac5215815958b912c5a4d4ec3c584bee14d4dec8'],8,70,78,22805783,4,0.389830508,0.949152542,0.983050847,24274
7b7973d3d6a9d98fff95cae3e48955c7960bd230,1,Pallav Kulshreshtha,2016-05-23 10:56:55+05:18,['1a4e7a760ae2eadf3c6604a73cff6c06c89e6192'],2,26,28,22805811,3,1,1,1,24274
d90fde6832db648ca2f143e213f51a680571df6b,1,Pallav Kulshreshtha,2016-05-23 13:02:22+05:18,['7b7973d3d6a9d98fff95cae3e48955c7960bd230'],90,250,340,22806151,3,0.106060606,1,1,24274
e4ee76111e91a27d55ed3ab3046dd38e6b1c3008,0,Gautam Borad,2016-05-23 15:36:11+05:18,['d90fde6832db648ca2f143e213f51a680571df6b'],0,14,14,22806165,1,,,,24274
56cdbddb65d73a0e552927b19ad390f30c5ed17e,1,oleewere,2016-05-23 12:20:07+02:00,['e4ee76111e91a27d55ed3ab3046dd38e6b1c3008'],153,154,307,22806472,23,,,,24274
d0e7e1639a3390d27c240a1d2ea75e03e658656c,1,Alex Antonenko,2016-05-23 15:22:54+03:00,['56cdbddb65d73a0e552927b19ad390f30c5ed17e'],4,43,47,22806519,2,1,1,1,24274
52e05e63c9299346b38932e7541eaca4c1d34743,0,Alex Antonenko,2016-05-23 15:22:54+03:00,['d0e7e1639a3390d27c240a1d2ea75e03e658656c'],0,2,2,22806521,1,,,,24274
5e98d0cbfc40b810f6eb6579f4875560c4c5e34a,1,Alex Antonenko,2016-05-23 15:22:54+03:00,['52e05e63c9299346b38932e7541eaca4c1d34743'],2,18,20,22806541,2,,,,24274
fff6514da3e4b4a560444ce1b9cbc8fb226741d1,1,Andrii Tkach,2016-05-23 16:27:50+03:00,['5e98d0cbfc40b810f6eb6579f4875560c4c5e34a'],1,110,111,22806652,109,,,,24274
1066f40ad8279160afecef4bee65ed9d33d6b5de,0,Andrew Onishuk,2016-05-23 17:39:18+03:00,['fff6514da3e4b4a560444ce1b9cbc8fb226741d1'],5,9,14,22806666,5,0.5,0,0,24274
79ec4ce20d51534e0b1f7f30fca1f3e0eca4f8f2,0,Andrew Onishuk,2016-05-23 17:40:55+03:00,['1066f40ad8279160afecef4bee65ed9d33d6b5de'],0,9,9,22806675,1,,,,24274
e3f2ddfc2be4c275f50f71c7df26657cca3aa2e4,1,Andrew Onishuk,2016-05-23 17:41:43+03:00,['79ec4ce20d51534e0b1f7f30fca1f3e0eca4f8f2'],21,38,59,22806734,2,0,0.923076923,1,24274
ab5b3ee62c1b725dfbb55d10e96b2a43abbba9be,1,Robert Levas,2016-05-23 11:00:26-04:00,['e3f2ddfc2be4c275f50f71c7df26657cca3aa2e4'],172,239,411,22807145,5,1,1,0.5,24274
79a8cb9d740527903c415b1eb1e5d1ae5f2b4917,1,Dmytro Sen,2016-05-23 18:26:58+03:00,['ab5b3ee62c1b725dfbb55d10e96b2a43abbba9be'],112,303,415,22807560,8,0.277227723,0.643564356,0.603960396,24275
3862519d11f5a9cd2b98170f0385b623bebd6a0f,1,Siddharth Wagle,2016-05-23 08:54:10-07:00,['79a8cb9d740527903c415b1eb1e5d1ae5f2b4917'],2,15,17,22807577,2,0.25,1,1,24275
095f220c4458f1421b046a6a9daa7435ec06e412,1,Gautam Borad,2016-05-23 21:35:02+05:18,['3862519d11f5a9cd2b98170f0385b623bebd6a0f'],5,5,10,22807587,2,,,,24275
b43edef52a519bf879b92c1c9f17776184af355b,1,Aravindan Vijayan,2016-05-23 10:37:49-07:00,['095f220c4458f1421b046a6a9daa7435ec06e412'],1,42,43,22807630,3,0.75,0.75,1,24275
060c0237b7ad51ff3b1426256d6b4aac63ba5ad1,0,Nahappan Somasundaram,2016-05-23 10:42:30-07:00,['b43edef52a519bf879b92c1c9f17776184af355b'],13,23,36,22807666,4,0,0,0.818181818,24275
5835a4299087943b7f561b6de9bbf2578328aecd,1,Swapan Shridhar,2016-05-23 12:00:08-07:00,['060c0237b7ad51ff3b1426256d6b4aac63ba5ad1'],49,32,81,22807747,2,0,0,0.285714286,24275
9b4e80cde2a4fe126751fd0d91f97a37f77955df,0,Nahappan Somasundaram,2016-05-23 13:20:37-07:00,['5835a4299087943b7f561b6de9bbf2578328aecd'],2,9,11,22807758,2,0.8,1,1,24275
82250aaa9f0250cf69747f5e15492b565d0dac7a,1,Yusaku Sako,2016-05-23 14:26:59-07:00,['9b4e80cde2a4fe126751fd0d91f97a37f77955df'],14,2962,2976,22810734,3,0.557692308,0.451923077,1,24277
e916d8c0b649aaca4f9384fd06d3daec6e2629a8,1,Ajit Kumar,2016-05-23 14:29:04-07:00,['82250aaa9f0250cf69747f5e15492b565d0dac7a'],0,10,10,22810744,1,1,1,0.111111111,24277
da5456bc414a9d37c78ef7c945f71b973eb45a27,0,Nahappan Somasundaram,2016-05-23 15:21:00-07:00,['e916d8c0b649aaca4f9384fd06d3daec6e2629a8'],1,2,3,22810747,1,0,1,1,24277
4d67a5834fd1914bac474ed7f6c42e1418e3c462,1,Sumit Mohanty,2016-05-23 17:57:29-07:00,['da5456bc414a9d37c78ef7c945f71b973eb45a27'],9,5,14,22810761,5,0.5,1,1,24277
e7b38ddd4f651eee59d43b297b854dcbf0412e02,1,Sumit Mohanty,2016-05-23 18:23:14-07:00,['4d67a5834fd1914bac474ed7f6c42e1418e3c462'],295,15,310,22811071,4,0.889502762,0.447513812,0,24277
047db3485bc6e0f408e69e20803a602f649ecaf1,1,Siddharth Wagle,2016-05-23 21:19:43-07:00,['e7b38ddd4f651eee59d43b297b854dcbf0412e02'],122,1159,1281,22812352,40,0.403755869,0.671361502,0.941314554,24284
3249bf6cfa4cc6becbd3dfeec83ac864894ca504,1,Pallav Kulshreshtha,2016-05-24 12:19:34+05:18,['047db3485bc6e0f408e69e20803a602f649ecaf1'],27,149,176,22812528,6,0.380952381,0.936507937,1,24284
8a99eb31f250b29933922e8efb3c1987e795a4f6,0,Matt,2016-05-24 00:19:29-07:00,['3249bf6cfa4cc6becbd3dfeec83ac864894ca504'],2,15,17,22812545,2,0.166666667,0.833333333,0.833333333,24284
4993ee48985ce29cd8b7d8001cef53329e16e45c,1,Andrew Onishuk,2016-05-24 11:27:19+03:00,['8a99eb31f250b29933922e8efb3c1987e795a4f6'],7,12,19,22812564,7,0.666666667,0,0,24284
c7b22ae9851c9ca9246dd5b7e98de98828bb84fb,1,oleewere,2016-05-24 10:38:41+02:00,['4993ee48985ce29cd8b7d8001cef53329e16e45c'],28,41,69,22812633,6,1,0,0,24284
7d4b6fd2baccb7e81f5b8a1e1658a531bfb9fa39,1,Dipayan Bhowmick,2016-05-24 14:11:58+05:18,['c7b22ae9851c9ca9246dd5b7e98de98828bb84fb'],1,1,2,22812635,1,,,,24284
b0b6cb4180900821830eb21e56f38cd185af499b,1,oleewere,2016-05-24 10:55:12+02:00,['7d4b6fd2baccb7e81f5b8a1e1658a531bfb9fa39'],7,18,25,22812660,3,0,1,0.333333333,24284
313605e105f9959d4e29d92b645d62c34c149457,1,Dipayan Bhowmick,2016-05-24 14:16:49+05:18,['b0b6cb4180900821830eb21e56f38cd185af499b'],2,2,4,22812664,1,,,,24284
e5474c2f75b294aee834e2746e2dba0784a1851b,1,Dipayan Bhowmick,2016-05-24 14:20:57+05:18,['313605e105f9959d4e29d92b645d62c34c149457'],75,228,303,22812967,36,0.367924528,0.924528302,0.990566038,24284
7e325f497e0a78a74426c2d5d335224e62688a92,0,Aleksandr Kovalenko,2016-05-24 12:23:04+03:00,['e5474c2f75b294aee834e2746e2dba0784a1851b'],1,1,2,22812969,1,,,,24284
c5509f0eb7d2dcb3ce0b582bba34501634c8c196,1,Andrew Onishuk,2016-05-24 12:32:43+03:00,['7e325f497e0a78a74426c2d5d335224e62688a92'],16,16,32,22813001,5,,,,24284
8bc59516b62946f68f234467c5f245d937812896,1,Pallav Kulshreshtha,2016-05-24 15:09:00+05:18,['c5509f0eb7d2dcb3ce0b582bba34501634c8c196'],53,86,139,22813140,5,1,1,1,24284
0965ddec865740b2ab8165981dbdc363e45177c3,0,"Toader, Sebastian",2016-05-24 14:20:47+02:00,['8bc59516b62946f68f234467c5f245d937812896'],1,39,40,22813180,2,0,1,1,24284
4e088662a932876c8da10838eb0a33c8471f1694,1,Andrew Onishuk,2016-05-24 15:49:26+03:00,['0965ddec865740b2ab8165981dbdc363e45177c3'],54,14,68,22813248,4,0,0.5,1,24284
60142307242637b3d266ffdd5860aa48fbccb3ef,1,Dmytro Sen,2016-05-24 16:45:44+03:00,['4e088662a932876c8da10838eb0a33c8471f1694'],1,1,2,22813250,1,,,,24284
21ded287fabd349b5457771f38bdca53542008d8,0,Alex Antonenko,2016-05-24 18:24:52+03:00,['60142307242637b3d266ffdd5860aa48fbccb3ef'],1,1,2,22813252,1,,,,24284
407ec1537f8c2b0a0fd253fb4d2c4b6209ffb413,1,Andrii Tkach,2016-05-24 18:31:38+03:00,['21ded287fabd349b5457771f38bdca53542008d8'],1,61,62,22813314,2,0.436363636,1,1,24284
c5e235b764c9d6658bf0ed9fb36cbb67746bc0cc,0,Alex Antonenko,2016-05-24 19:45:04+03:00,['407ec1537f8c2b0a0fd253fb4d2c4b6209ffb413'],1,8,9,22813323,1,1,1,1,24284
9b2ac8204570bb826857102c5ebaf7183b0e78d3,1,Vitaly Brodetskyi,2016-05-24 19:34:19+03:00,['c5e235b764c9d6658bf0ed9fb36cbb67746bc0cc'],18,63,81,22813404,13,1,1,1,24284
e14ee579587917e129a758316320783a0055228b,0,Robert Levas,2016-05-24 14:51:05-04:00,['9b2ac8204570bb826857102c5ebaf7183b0e78d3'],14,16,30,22813434,3,0.333333333,1,0.666666667,24284
b121d2adb36134624f73f7cee2c439bfd31e21a8,1,Richard Zang,2016-05-24 11:51:35-07:00,['e14ee579587917e129a758316320783a0055228b'],2,2,4,22813438,2,,,,24284
dd4172b9ee4a48e594640a846c3681af9ddf971b,0,Yusaku Sako,2016-05-24 12:51:46-07:00,['b121d2adb36134624f73f7cee2c439bfd31e21a8'],9,9,18,22813456,1,,,,24284
ab4d5dd1171c52b95b8ecc0794a8735bf855f1bf,0,Yusaku Sako,2016-05-24 15:59:03-07:00,['dd4172b9ee4a48e594640a846c3681af9ddf971b'],32,184,216,22813672,1,,,,24284
1a381dfa2d34439823edd9b8200616e51d851fcb,1,Jonathan Hurley,2016-05-24 20:49:21-05:00,['ab4d5dd1171c52b95b8ecc0794a8735bf855f1bf'],242,370,612,22814284,21,0,0.475,0.725,24284
d2f9cfa78d465d82b3d87b3310276903fc63c1c1,1,Sumit Mohanty,2016-05-24 20:42:53-07:00,['1a381dfa2d34439823edd9b8200616e51d851fcb'],3,3,6,22814290,1,,,,24284
b81fd1f60c0cdc74caf95861e2652dd355810956,1,Gautam Borad,2016-05-25 09:50:07+05:18,['d2f9cfa78d465d82b3d87b3310276903fc63c1c1'],4,202,206,22814496,14,0.026666667,0.333333333,0.306666667,24284
71a0689e726847f40222a211134c1a5003b9731d,0,Gautam Borad,2016-05-25 11:01:13+05:18,['b81fd1f60c0cdc74caf95861e2652dd355810956'],5,4,9,22814505,3,,,,24284
f199041091ef54b2d0deccd1a414b018a1420e1b,1,"Toader, Sebastian",2016-05-25 08:53:09+02:00,['71a0689e726847f40222a211134c1a5003b9731d'],3,7,10,22814515,3,,,,24284
27168a13f0aff9faa37d789ee5efb323c98e6856,1,Jayush Luniya,2016-05-25 01:55:06-07:00,['f199041091ef54b2d0deccd1a414b018a1420e1b'],0,1807,1807,22816322,20,0.455938697,0.398467433,0.229885057,24304
421f648f9c6dc6d5de9bd00468d0520759c73b13,1,Andrii Tkach,2016-05-25 12:19:01+03:00,['27168a13f0aff9faa37d789ee5efb323c98e6856'],35,67,102,22816424,2,1,1,1,24304
ad2e1a9b75f44d52cd7deaf9c53747d66b484912,1,Andrew Onishuk,2016-05-25 12:53:23+03:00,['421f648f9c6dc6d5de9bd00468d0520759c73b13'],232,328,560,22816984,11,0.227272727,1,0.954545455,24305
b052df6b94c8d7d60acd89c1085c0f3599155aa1,0,Andrew Onishuk,2016-05-25 13:10:44+03:00,['ad2e1a9b75f44d52cd7deaf9c53747d66b484912'],52,18,70,22817054,4,1,0,0,24305
763093b4bc2cc496c1f44056f67cd570f5aeb2f0,1,Pallav Kulshreshtha,2016-05-25 15:52:52+05:18,['b052df6b94c8d7d60acd89c1085c0f3599155aa1'],0,35,35,22817089,2,,,,24306
7fa34c7189dd14c410df162d9579934002b9ba84,1,"Toader, Sebastian",2016-05-25 12:37:51+02:00,['763093b4bc2cc496c1f44056f67cd570f5aeb2f0'],17,143,160,22817249,2,0,1,1,24306
2ca4b333d0777640e1907dc59a20daa147f69253,0,Pallav Kulshreshtha,2016-05-25 16:02:00+05:18,['7fa34c7189dd14c410df162d9579934002b9ba84'],0,24,24,22817273,3,0,1,1,24306
3f7b4a3743360a96d45373c91e04635985445de9,1,Pallav Kulshreshtha,2016-05-25 16:09:11+05:18,['2ca4b333d0777640e1907dc59a20daa147f69253'],42,23,65,22817338,1,0.153846154,0.153846154,0.846153846,24306
27d1777ecdd839f8d4d287d229a3f34332d0fa98,0,Andrew Onishuk,2016-05-25 14:10:49+03:00,['3f7b4a3743360a96d45373c91e04635985445de9'],4,0,4,22817342,1,1,1,1,24306
c8c31db11223804895485e4264c15fa0f819378f,1,ababiichuk,2016-05-25 15:07:08+03:00,['27d1777ecdd839f8d4d287d229a3f34332d0fa98'],2,157,159,22817501,3,,,,24308
3f19456edd388c29417c8d73bfe08ed0e64446df,1,Andrew Onishuk,2016-05-25 17:26:56+03:00,['c8c31db11223804895485e4264c15fa0f819378f'],1,1,2,22817503,1,,,,24308
4d638d08bef7179f2a2b9c4b496516ea988deb60,1,oleewere,2016-05-25 16:31:16+02:00,['3f19456edd388c29417c8d73bfe08ed0e64446df'],1,1,2,22817505,1,0,0,0,24308
6d15dc6cf1271977c7076d6c8244603819e082c0,1,Nate Cole,2016-05-25 11:04:16-04:00,['4d638d08bef7179f2a2b9c4b496516ea988deb60'],1,291,292,22817797,2,0,0.769633508,1,24308
4fce7d1de6dde408853f2c778a6899016f77e73c,1,Aravindan Vijayan,2016-05-25 08:46:58-07:00,['6d15dc6cf1271977c7076d6c8244603819e082c0'],6,6,12,22817809,3,,,,24308
102a71cd29ffa1a4efa5e7169742d6f9fe2b148a,0,Aravindan Vijayan,2016-05-25 08:47:29-07:00,['4fce7d1de6dde408853f2c778a6899016f77e73c'],8,42,50,22817859,2,0,0.892857143,1,24308
b5220e30db3195d619dd21ab9610bd7bda0b5220,1,Aravindan Vijayan,2016-05-25 08:49:04-07:00,['102a71cd29ffa1a4efa5e7169742d6f9fe2b148a'],42,8,50,22817909,2,1,0.107142857,0,24308
f4d9fdecbceff83d3d80f625f73ea444e3c69317,1,Aravindan Vijayan,2016-05-25 08:49:48-07:00,['b5220e30db3195d619dd21ab9610bd7bda0b5220'],8,42,50,22817959,2,0,0.892857143,1,24308
a198dced6316fbc79751c21cb9fee4f1147c45ed,1,Andrii Tkach,2016-05-25 19:11:48+03:00,['f4d9fdecbceff83d3d80f625f73ea444e3c69317'],15,137,152,22818111,4,0.661538462,1,0.846153846,24309
e7ae14918fe6f81288828855a584da5315743c71,0,Vitaly Brodetskyi,2016-05-25 21:47:12+03:00,['a198dced6316fbc79751c21cb9fee4f1147c45ed'],1,1,2,22818113,1,,,,24309
24c6d1f21e299a67a65b3390d8e659b60baa93e5,1,Matt,2016-05-25 14:00:20-07:00,['e7ae14918fe6f81288828855a584da5315743c71'],10,10,20,22818133,6,,,,24309
b86a136692ceaca7efa609a1904553cbaaf739e2,0,Richard Zang,2016-05-25 15:51:56-07:00,['24c6d1f21e299a67a65b3390d8e659b60baa93e5'],1,118,119,22818252,2,0.102564103,0.923076923,1,24309
8059a6392747292fd2b180577cd5cd93a9392b57,1,Srimanth Gunturi,2016-05-25 16:11:38-07:00,['b86a136692ceaca7efa609a1904553cbaaf739e2'],0,14,14,22818266,1,,,,24309
77213ab7dba15f9ec92b40cb2c5d77d52c636587,1,Swapan Shridhar,2016-05-25 18:39:10-07:00,['8059a6392747292fd2b180577cd5cd93a9392b57'],113,796,909,22819175,2,0.00676819,0.912013536,0.937394247,24309
9b406d6e23bdc81f8f524461d98de1d679db5bce,1,Jayush Luniya,2016-05-25 22:54:37-07:00,['77213ab7dba15f9ec92b40cb2c5d77d52c636587'],10,43,53,22819228,5,0,1,1,24309
055288a3bda6fc49e01187fb40551543233e2f78,1,Jayush Luniya,2016-05-25 23:09:50-07:00,['9b406d6e23bdc81f8f524461d98de1d679db5bce'],18,162,180,22819408,13,0.357142857,0.464285714,0.464285714,24309
3a671d884041135b774a803963c4f9b5dd2595b1,1,Pallav Kulshreshtha,2016-05-26 13:13:05+05:18,['055288a3bda6fc49e01187fb40551543233e2f78'],10,34,44,22819452,4,0.9,0.9,1,24309
f80107a7a604d85bcab9a7d99bfff24b938cdfee,1,Andrew Onishuk,2016-05-26 14:22:38+03:00,['3a671d884041135b774a803963c4f9b5dd2595b1'],14,63,77,22819529,6,0.066666667,0.066666667,0.066666667,24309
00a47c4c5dfadd804d32b3804d99b333c0e35fdf,1,oleewere,2016-05-26 15:42:42+02:00,['f80107a7a604d85bcab9a7d99bfff24b938cdfee'],9,12,21,22819550,4,,,,24309
30899abc069d6e9afcd92b2630d71d1f3fe5a4a3,0,Myroslav Papirkovskyi,2016-05-26 16:55:42+03:00,['00a47c4c5dfadd804d32b3804d99b333c0e35fdf'],3,3,6,22819556,2,,,,24309
7542916613ca2c900a89198b21266a37dfebc08f,0,Myroslav Papirkovskyi,2016-05-26 17:10:07+03:00,['30899abc069d6e9afcd92b2630d71d1f3fe5a4a3'],0,7,7,22819563,2,0,0,1,24309
14e4956f14d10b0ac37400b5d954ce08296df835,1,tbeerbower,2016-05-26 10:24:59-04:00,['7542916613ca2c900a89198b21266a37dfebc08f'],208,212,420,22819983,17,0.575757576,0.060606061,0,24309
322893abbe5b76f5e95d068c6f527967b303356d,1,Pallav Kulshreshtha,2016-05-26 21:22:52+05:18,['14e4956f14d10b0ac37400b5d954ce08296df835'],1,2,3,22819986,1,,,,24309
daf4480c435531dbc764fdd40ab054bd54b3e804,0,Pallav Kulshreshtha,2016-05-26 21:31:19+05:18,['322893abbe5b76f5e95d068c6f527967b303356d'],3,7,10,22819996,2,1,1,1,24309
a7a56bd7f74f47f4173cfeac35d7696264979159,1,Nate Cole,2016-05-26 12:19:15-04:00,['daf4480c435531dbc764fdd40ab054bd54b3e804'],4,79,83,22820079,4,0,0.866666667,1,24309
50f832aa3f4f10352f653d622c2a9910d65ad283,1,Pallav Kulshreshtha,2016-05-26 21:57:33+05:18,['a7a56bd7f74f47f4173cfeac35d7696264979159'],0,4,4,22820083,1,,,,24309
f948e3870083ac0f79237bfb5de1ef4077848b2c,1,Alex Antonenko,2016-05-26 19:48:36+03:00,['50f832aa3f4f10352f653d622c2a9910d65ad283'],5,9,14,22820097,1,0,0,1,24309
f96969a4543ef93e5c4e0c0e4f998c8f9ebd598c,1,Andrew Onishuk,2016-05-26 19:49:45+03:00,['f948e3870083ac0f79237bfb5de1ef4077848b2c'],0,22,22,22820119,5,0,0,1,24309
d51e752972ddfc0acfaeca1603a657fef7c8d5e8,1,Andrew Onishuk,2016-05-26 19:52:57+03:00,['f96969a4543ef93e5c4e0c0e4f998c8f9ebd598c'],1,1,2,22820121,1,,,,24309
30397cd89c653ca605c5b27fc1c76d0dc8b97740,0,Alex Antonenko,2016-05-26 20:18:34+03:00,['d51e752972ddfc0acfaeca1603a657fef7c8d5e8'],1,1,2,22820123,1,,,,24309
fe05d36717a9b6a9e58a5242e80c755e119a4a86,0,Alex Antonenko,2016-05-26 20:18:34+03:00,['30397cd89c653ca605c5b27fc1c76d0dc8b97740'],105,160,265,22820388,7,0.87755102,1,1,24309
ef4a3ee52f8a6aee6a6ff8c9510a6335616f3b8b,0,Nate Cole,2016-05-26 15:39:29-04:00,['fe05d36717a9b6a9e58a5242e80c755e119a4a86'],3,42,45,22820433,4,0.846153846,1,0.576923077,24309
c18bd403d3f3fb6bb37d35534505eef9f9dc920b,1,Alejandro Fernandez,2016-05-26 13:08:46-07:00,['ef4a3ee52f8a6aee6a6ff8c9510a6335616f3b8b'],31,236,267,22820700,8,,,,24309
c2e0ef76ef858c2c182ead04774ab0e30e307120,1,Bhuvnesh Chaudhary,2016-05-26 15:55:58-07:00,['c18bd403d3f3fb6bb37d35534505eef9f9dc920b'],32,87,119,22820819,5,0.379310345,0.793103448,0.413793103,24309
4acca94156b2b62c5108132b45f226716efd402b,1,Jaimin Jetly,2016-05-26 17:06:57-07:00,['c2e0ef76ef858c2c182ead04774ab0e30e307120'],8,53,61,22820880,7,1,1,1,24309
08d70f5939459493c480fa6d6736f4be7226bf73,0,Swapan Shridhar,2016-05-26 19:58:44-07:00,['4acca94156b2b62c5108132b45f226716efd402b'],18,25,43,22820923,2,0,0,0,24309
59364bc87d0ad3c6fa16918329d40230b34646c8,1,Swapan Shridhar,2016-05-26 19:58:44-07:00,['08d70f5939459493c480fa6d6736f4be7226bf73'],9,30,39,22820962,3,0,0,1,24309
e362aa994382f7af6382751192c27eb2c1d2d570,1,ababiichuk,2016-05-27 12:13:52+03:00,['59364bc87d0ad3c6fa16918329d40230b34646c8'],20,24,44,22821006,5,1,0,0,24309
99becb41819905db65245bd186481b3718c2f4af,0,Andrii Tkach,2016-05-27 12:18:16+03:00,['e362aa994382f7af6382751192c27eb2c1d2d570'],4,6,10,22821016,2,1,1,1,24309
553e6dfc783443daacbd6eba84c041c537b354aa,1,Aleksandr Kovalenko,2016-05-27 14:02:16+03:00,['99becb41819905db65245bd186481b3718c2f4af'],2,42,44,22821060,3,1,1,1,24309
fb509d480260c1372ba5cc7ac6426d5d3049ca84,0,Pallav Kulshreshtha,2016-05-27 17:07:20+05:18,['553e6dfc783443daacbd6eba84c041c537b354aa'],8,8,16,22821076,2,,,,24309
2a632995bcf3f4531e6abf320a21cd78ea71ea0b,1,Pallav Kulshreshtha,2016-05-27 17:13:08+05:18,['fb509d480260c1372ba5cc7ac6426d5d3049ca84'],14,14,28,22821104,1,,,,24309
37af1f039941c32b702fcdd02a3879dc4f37bf69,1,Pallav Kulshreshtha,2016-05-27 17:18:25+05:18,['2a632995bcf3f4531e6abf320a21cd78ea71ea0b'],0,109,109,22821213,2,0,1,1,24309
82ccf224f0142b0b63c13e6ac0d58d45f55dd5ab,1,Pallav Kulshreshtha,2016-05-27 17:22:02+05:18,['37af1f039941c32b702fcdd02a3879dc4f37bf69'],23,23,46,22821259,2,1,0,1,24309
2552fee8a9a205c059399ceed8a117ffdb962c6a,1,Pallav Kulshreshtha,2016-05-27 18:16:06+05:18,['82ccf224f0142b0b63c13e6ac0d58d45f55dd5ab'],98,128,226,22821485,3,0.472222222,0.277777778,0.694444444,24309
d720ada9cce0d1301598f84e5fb0c0337c6050cc,1,Andrew Onishuk,2016-05-27 18:27:23+03:00,['2552fee8a9a205c059399ceed8a117ffdb962c6a'],34,48,82,22821567,34,,,,24309
3add8e926d1621be3676730748cc8f7edd134699,1,Alex Antonenko,2016-05-27 19:04:56+03:00,['d720ada9cce0d1301598f84e5fb0c0337c6050cc'],12,25,37,22821604,6,1,1,1,24309
33c8feede6b9ce30839f5961685842f3ff327b73,1,Andrew Onishuk,2016-05-27 19:16:33+03:00,['3add8e926d1621be3676730748cc8f7edd134699'],25,119,144,22821748,12,0,1,0.944444444,24309
e40b8825ff1549891fdad99d035aa48f953f2f9d,1,Andrew Onishuk,2016-05-27 19:17:35+03:00,['33c8feede6b9ce30839f5961685842f3ff327b73'],3,189,192,22821940,3,0.588235294,0.598039216,0.87254902,24311
66c6b06c3124702bfcb3c1de4bb9b2defa1a9d14,1,Dmytro Sen,2016-05-27 19:46:12+03:00,['e40b8825ff1549891fdad99d035aa48f953f2f9d'],4,74,78,22822018,2,0,0.412698413,1,24311
78bde257f6f4a2fc48577a4b27c4b2aa70a339cd,1,Vitaly Brodetskyi,2016-05-27 20:07:33+03:00,['66c6b06c3124702bfcb3c1de4bb9b2defa1a9d14'],15,49,64,22822082,7,0.571428571,0.571428571,0.80952381,24311
4eab7d053e8f6fae2f9a2230e9ac0c273db8d232,1,Swapan Shridhar,2016-05-27 10:34:56-07:00,['78bde257f6f4a2fc48577a4b27c4b2aa70a339cd'],40,388,428,22822510,2,0,0.99375,0.99375,24311
055b63150cb934c11986c70850638064103ff7b0,1,Robert Levas,2016-05-27 13:45:03-04:00,['4eab7d053e8f6fae2f9a2230e9ac0c273db8d232'],67,333,400,22822910,21,0.488095238,0.845238095,0.672619048,24311
1529af0b5795ba9c6b9019b02fe08570b1857f1f,1,Robert Levas,2016-05-27 13:46:08-04:00,['055b63150cb934c11986c70850638064103ff7b0'],333,67,400,22823310,21,0.511904762,0.154761905,0.327380952,24311
87b0a24384fc592bd1c54b50e7095e849a6fc3a2,1,Robert Levas,2016-05-27 13:46:43-04:00,['1529af0b5795ba9c6b9019b02fe08570b1857f1f'],67,366,433,22823743,22,0.488095238,0.845238095,0.672619048,24312
a94a03f55605294e7aed061b9673c87c262d16f6,0,Di Li,2016-05-27 14:30:20-04:00,['87b0a24384fc592bd1c54b50e7095e849a6fc3a2'],2,2,4,22823747,1,,,,24312
b30a7b5614b136b4ca267b5fd1d6ab920332c0e3,1,oleewere,2016-05-27 20:54:47+02:00,['a94a03f55605294e7aed061b9673c87c262d16f6'],37,30,67,22823814,7,1,1,1,24312
489a9c4b0835558669ab30b0cfda68b60c8a238c,1,Aravindan Vijayan,2016-05-27 14:27:40-07:00,['b30a7b5614b136b4ca267b5fd1d6ab920332c0e3'],29,127,156,22823970,5,0.057692308,0.384615385,1,24312
048ef3fa61be82fdae795c6c466d60c053b1f8f2,1,Alejandro Fernandez,2016-05-27 14:51:36-07:00,['489a9c4b0835558669ab30b0cfda68b60c8a238c'],0,34,34,22824004,6,,,,24312
7d6c539c66fa96441aeafb8a70f9a6a255a9eb38,1,Srimanth Gunturi,2016-05-27 15:54:13-07:00,['048ef3fa61be82fdae795c6c466d60c053b1f8f2'],16,937,953,22824957,7,0.087186262,0.874504624,0.955085865,24312
c726fa5b649d4e0d3f0b00436d34bd19ea3e9a9e,1,Bhuvnesh Chaudhary,2016-05-27 16:18:07-07:00,['7d6c539c66fa96441aeafb8a70f9a6a255a9eb38'],3,6,9,22824966,4,,,,24312
c5526333d28fbdec006536b9815ff924096f9da6,0,Srimanth Gunturi,2016-05-27 16:25:32-07:00,['c726fa5b649d4e0d3f0b00436d34bd19ea3e9a9e'],3,19,22,22824988,2,0,1,1,24312
03600fa75274c82cc89b025c51bb5d622d474711,1,Jaimin Jetly,2016-05-27 17:33:03-07:00,['c5526333d28fbdec006536b9815ff924096f9da6'],1038,2468,3506,22828494,42,0.781456954,0.867549669,1,24319
d97f396d65f3eed069dc2e0d6ecdeee12aad8b78,1,tbeerbower,2016-05-27 20:45:54-04:00,['03600fa75274c82cc89b025c51bb5d622d474711'],4,16,20,22828514,5,,,,24319
7b60113d1c076e0eb905c443a61cd837e11e72c6,1,Swapan Shridhar,2016-05-27 19:11:43-07:00,['d97f396d65f3eed069dc2e0d6ecdeee12aad8b78'],121,537,658,22829172,2,0.038690476,0.824404762,0.824404762,24319
069cc49dae316f8bab776ad1e3acacd55d4a8cc1,1,Matt,2016-05-27 23:07:53-07:00,['7b60113d1c076e0eb905c443a61cd837e11e72c6'],64,79,143,22829315,2,0.461538462,0.769230769,0.692307692,24319
2fcc947530eb521bbcb3bdc941a5a680a4145140,1,Robert Levas,2016-05-28 08:02:05-04:00,['069cc49dae316f8bab776ad1e3acacd55d4a8cc1'],62,2152,2214,22831529,27,0.55526658,0.689206762,0.967490247,24338
eec799d16af778a816ffdf3a52bfee0a319c9103,1,Jonathan Hurley,2016-05-28 11:16:20-04:00,['2fcc947530eb521bbcb3bdc941a5a680a4145140'],313,1493,1806,22833335,21,0.576335878,0.904580153,0.961832061,24341
5a113c2dce7ee0df793761be62d0d77a7d933578,1,Jonathan Hurley,2016-05-28 17:12:12-04:00,['eec799d16af778a816ffdf3a52bfee0a319c9103'],29,53,82,22833417,5,,,,24341
8d208b67f0de52bce0724e2b4b414f49a6085213,1,Jonathan Hurley,2016-05-29 00:32:18-04:00,['5a113c2dce7ee0df793761be62d0d77a7d933578'],1,4,5,22833422,1,0,1,1,24341
008e4d1844f08373b5bf8ad58bf80d6613149b28,0,Gautam Borad,2016-05-30 10:48:15+05:18,['8d208b67f0de52bce0724e2b4b414f49a6085213'],2,3,5,22833427,1,0,0,0,24341
e12b8130def42684ae5bf84721b3e7fa8e7db644,1,Oleg Nechiporenko,2016-05-30 10:37:52+03:00,['008e4d1844f08373b5bf8ad58bf80d6613149b28'],56,56,112,22833539,10,0.5,0,0,24341
d581b4e552ad47d3dc9e96ed9919e87d5ae9babe,1,oleewere,2016-05-30 11:14:22+02:00,['e12b8130def42684ae5bf84721b3e7fa8e7db644'],2,196,198,22833737,4,0.341269841,0.484126984,1,24341
8e835618b7ca2318f12b0aee9e1e73dd92b4feb0,1,Gautam Borad,2016-05-30 14:37:33+05:18,['d581b4e552ad47d3dc9e96ed9919e87d5ae9babe'],2,2,4,22833741,1,,,,24341
853a0ec9d09cc7083dcfaa2a10d9512483fcba11,1,ababiichuk,2016-05-30 12:24:36+03:00,['8e835618b7ca2318f12b0aee9e1e73dd92b4feb0'],39,180,219,22833960,8,0.612068966,0.818965517,1,24341
d69dce93535f80d414f0fdd7ac98fb2a56863970,0,ababiichuk,2016-05-30 12:24:36+03:00,['853a0ec9d09cc7083dcfaa2a10d9512483fcba11'],0,1,1,22833961,1,1,1,1,24341
17f764c00c56c0e2ad12eb18ddb4af09511acbd7,0,ababiichuk,2016-05-30 12:24:36+03:00,['d69dce93535f80d414f0fdd7ac98fb2a56863970'],14,13,27,22833988,1,1,0,0,24341
1e0e6f36e4e4581db4efc0ddfe8b9340d8334eca,1,Pallav Kulshreshtha,2016-05-30 15:18:08+05:18,['17f764c00c56c0e2ad12eb18ddb4af09511acbd7'],2,5,7,22833995,1,0,0,1,24341
38ad356227074686de80fe51b960cc6709ca12f3,1,Andrii Tkach,2016-05-30 13:05:57+03:00,['1e0e6f36e4e4581db4efc0ddfe8b9340d8334eca'],6,6,12,22834007,4,,,,24341
9b8ca7e9fe3f8afbadf0cf61b071218e39eb2e3f,1,oleewere,2016-05-30 12:15:48+02:00,['38ad356227074686de80fe51b960cc6709ca12f3'],28,360,388,22834395,18,0,1,1,24341
677302795a77c680c82933148b229a18bdc21316,1,Vitaly Brodetskyi,2016-05-30 13:47:45+03:00,['9b8ca7e9fe3f8afbadf0cf61b071218e39eb2e3f'],7,9,16,22834411,4,,,,24341
a8655347a311a4b9506e5e67f8a37834f4130205,1,Alex Antonenko,2016-05-30 14:18:48+03:00,['677302795a77c680c82933148b229a18bdc21316'],2,56,58,22834469,2,1,1,1,24341
0926cdc6d5f2c79e8249d009adb6c8b9e4b4bbed,0,Alex Antonenko,2016-05-30 14:29:22+03:00,['a8655347a311a4b9506e5e67f8a37834f4130205'],8,0,8,22834477,1,0,0,0,24341
a79c98d485bfa08141c6c4457064c70d16f9c9e6,1,Lisnichenko Dmitro,2016-05-30 16:50:19+03:00,['0926cdc6d5f2c79e8249d009adb6c8b9e4b4bbed'],4,10,14,22834491,3,1,1,1,24341
baa8ae9168d7bf14d37f157a6338f4e75aab15d0,1,Sandor Magyari,2016-05-30 16:53:53+02:00,['a79c98d485bfa08141c6c4457064c70d16f9c9e6'],0,4,4,22834495,1,0,1,1,24341
46b2fcdef0b0fa9d741951cbb6f9c97b53d09be4,0,Dmytro Sen,2016-05-30 18:39:28+03:00,['baa8ae9168d7bf14d37f157a6338f4e75aab15d0'],122,98,220,22834715,4,0.888888889,0,0,24341
f8e83d365a87eb1651cfc7a5a1e48b7df6e5e6bf,0,Sumit Mohanty,2016-05-30 17:45:02-07:00,['46b2fcdef0b0fa9d741951cbb6f9c97b53d09be4'],0,69,69,22834784,6,,,,24342
f210586ad57ff60d467c3e84e7f4783d34435660,1,Dmytro Sen,2016-05-31 09:09:01+03:00,['f8e83d365a87eb1651cfc7a5a1e48b7df6e5e6bf'],98,122,220,22835004,4,0.111111111,1,1,24342
aec5194ebd3db652c7b19285031097842cffaa49,0,Andrew Onishuk,2016-05-31 13:49:42+03:00,['f210586ad57ff60d467c3e84e7f4783d34435660'],24,75,99,22835103,6,0.326086957,1,1,24342
6119a64570e7f2e81b3bd67280a0ee723591e9b9,1,Oleg Nechiporenko,2016-05-31 13:57:03+03:00,['aec5194ebd3db652c7b19285031097842cffaa49'],0,3,3,22835106,1,1,1,1,24342
4020d34dc10658d197a42ad21fc3667aed2dee90,1,Andrew Onishuk,2016-05-31 16:43:41+03:00,['6119a64570e7f2e81b3bd67280a0ee723591e9b9'],1,10,11,22835117,2,0,0,1,24342
b5793f687c1c4be3e36671f25d62249392de0aed,1,tbeerbower,2016-05-31 10:02:02-04:00,['4020d34dc10658d197a42ad21fc3667aed2dee90'],2,2,4,22835121,1,,,,24342
ec28eb83c15893ac5c047b6b29e75e6519fd6be5,0,Aleksandr Kovalenko,2016-05-31 18:05:19+03:00,['b5793f687c1c4be3e36671f25d62249392de0aed'],2,1,3,22835124,2,0,0,0,24342
795a3150ec24b8c5a7624e757e7b92ce901c2efb,0,oleewere,2016-05-31 18:07:53+02:00,['ec28eb83c15893ac5c047b6b29e75e6519fd6be5'],1,1,2,22835126,1,,,,24342
0b71a9e3e606395085115178ba3fa0479414650d,1,oleewere,2016-05-31 18:22:05+02:00,['795a3150ec24b8c5a7624e757e7b92ce901c2efb'],1,1,2,22835128,1,,,,24342
fde7ea0c108d3db57f9e2e41582b59fc4a744494,1,oleewere,2016-05-31 18:23:00+02:00,['0b71a9e3e606395085115178ba3fa0479414650d'],1,1,2,22835130,1,,,,24342
193333061150e6dfaa5cf21516ea6c54c7bc9c54,0,Jayush Luniya,2016-05-31 10:34:20-07:00,['fde7ea0c108d3db57f9e2e41582b59fc4a744494'],7,703,710,22835840,18,0.13592233,0.737864078,0.194174757,24350
7aa71ce6b75d688dbaa6f86929a31a0276a1f55d,1,Jayush Luniya,2016-05-31 10:43:21-07:00,['193333061150e6dfaa5cf21516ea6c54c7bc9c54'],75,24,99,22835939,6,0.673913043,0,0,24350
45987811c1c2f433df3d1bb650a93524822da080,0,Jayush Luniya,2016-05-31 10:56:12-07:00,['7aa71ce6b75d688dbaa6f86929a31a0276a1f55d'],69,0,69,22836008,6,,,,24350
66f2405682d3a20e0807e1ad62079d4ea86e8ac5,0,Yusaku Sako,2016-05-31 11:17:34-07:00,['45987811c1c2f433df3d1bb650a93524822da080'],0,36,36,22836044,1,,,,24350
2b8a5933227fd37010578a16c64c30344a13fefd,1,Xi Wang,2016-05-31 11:18:57-07:00,['66f2405682d3a20e0807e1ad62079d4ea86e8ac5'],4,10,14,22836058,4,1,1,1,24350
29fe46f55462bd3b2e9b2d91c69d706c48c632c3,0,Srimanth Gunturi,2016-05-31 12:08:29-07:00,['2b8a5933227fd37010578a16c64c30344a13fefd'],0,1,1,22836059,1,,,,24350
01a9225395a44dabf475018b48b91f56b13d8dcf,0,Bhuvnesh Chaudhary,2016-05-31 12:22:22-07:00,['29fe46f55462bd3b2e9b2d91c69d706c48c632c3'],1,2,3,22836062,1,,,,24350
9dc382a5b0a0f40b6891351058146e4f1062620c,1,Dipayan Bhowmick,2016-06-01 01:00:53+05:18,['01a9225395a44dabf475018b48b91f56b13d8dcf'],0,36116,36116,22872178,442,0.76420718,0.86309445,0.901973771,24790
48f2cef2d3ba0aae6d4640fd824744c1aaf010d0,1,Alejandro Fernandez,2016-05-31 12:57:36-07:00,['9dc382a5b0a0f40b6891351058146e4f1062620c'],0,67,67,22872245,6,,,,24791
bef695d3fc44528d94a0fa60a3f1b6c5db51f02d,0,Dmytro Sen,2016-05-31 23:04:10+03:00,['48f2cef2d3ba0aae6d4640fd824744c1aaf010d0'],127,103,230,22872475,6,0.888888889,0,0,24791
24cab91a991735ce1a893810d1a0cd9e4f926ba1,0,Dmytro Sen,2016-05-31 23:08:18+03:00,['bef695d3fc44528d94a0fa60a3f1b6c5db51f02d'],1,9,10,22872485,2,0,0,1,24791
ff9150ccaef70291d9cd0ccd79e72c32b8bee86d,1,Jaimin Jetly,2016-05-31 15:32:36-07:00,['24cab91a991735ce1a893810d1a0cd9e4f926ba1'],2,2,4,22872489,1,,,,24791
bc11f5f12e639fd76305b6d73cf6a1b0dd93faaf,1,Alejandro Fernandez,2016-05-31 15:40:32-07:00,['ff9150ccaef70291d9cd0ccd79e72c32b8bee86d'],1,2,3,22872492,1,0,1,1,24791
f852e3ca84c0214a90446127725a53ac9b590804,0,Ajit Kumar,2016-05-31 15:59:43-07:00,['bc11f5f12e639fd76305b6d73cf6a1b0dd93faaf'],824,48,872,22873364,13,0,1,1,24791
c2cd661fff83d923245a4a9d04ddb7206a684d00,1,Srimanth Gunturi,2016-05-31 16:10:09-07:00,['f852e3ca84c0214a90446127725a53ac9b590804'],0,596,596,22873960,8,0.434782609,0.594202899,0.594202899,24799
2491df2263c35f1a541b111a410f606a8d60a786,1,Srimanth Gunturi,2016-05-31 17:31:05-07:00,['c2cd661fff83d923245a4a9d04ddb7206a684d00'],2,3,5,22873965,1,0,0,0,24799
59b540ff5c8e703bbc797689bdd82d528f00b2af,0,Jaimin Jetly,2016-05-31 18:05:56-07:00,['2491df2263c35f1a541b111a410f606a8d60a786'],0,21,21,22873986,1,0.857142857,1,1,24799
44b3a205a0353c8a7674f9aa01f29b10c6e155d7,1,Jayush Luniya,2016-05-31 18:56:43-07:00,['59b540ff5c8e703bbc797689bdd82d528f00b2af'],6,7,13,22873999,3,,,,24799
aaf5b3b0c00f0a38a0ad7145063da6d3b0a5368d,1,Jayush Luniya,2016-05-31 19:04:13-07:00,['44b3a205a0353c8a7674f9aa01f29b10c6e155d7'],6,12,18,22874017,3,,,,24799
a294e8d41470c3aff67031004b47eb2e471ea039,0,Jayush Luniya,2016-05-31 19:31:15-07:00,['aaf5b3b0c00f0a38a0ad7145063da6d3b0a5368d'],14,15,29,22874046,6,,,,24799
bce5543570e0f70504a62d2d42dea8adab945a85,0,Jayush Luniya,2016-05-31 19:41:49-07:00,['a294e8d41470c3aff67031004b47eb2e471ea039'],2,12,14,22874060,2,,,,24799
687745ad5648a1bd2110b2d7eb9074ba133e9b58,0,Jayush Luniya,2016-05-31 19:44:43-07:00,['bce5543570e0f70504a62d2d42dea8adab945a85'],12,15,27,22874087,4,,,,24799
30f257750a14db3631e2ca69d8d80d8ea466b796,0,Jayush Luniya,2016-05-31 19:58:44-07:00,['687745ad5648a1bd2110b2d7eb9074ba133e9b58'],3,5,8,22874095,3,,,,24799
3e45c8fe24bda4c28fb4a8d981e874ab0b9e217d,0,Jayush Luniya,2016-05-31 20:05:11-07:00,['30f257750a14db3631e2ca69d8d80d8ea466b796'],29,42,71,22874166,12,,,,24799
10ad39cfd87a2f11bdfbc3470fdf112bf1d83c1c,0,Jayush Luniya,2016-05-31 20:07:39-07:00,['3e45c8fe24bda4c28fb4a8d981e874ab0b9e217d'],15,22,37,22874203,5,,,,24799
da039e13dd50d571d054307b113d29aaac6a07ac,0,Sumit Mohanty,2016-05-31 20:34:38-07:00,['10ad39cfd87a2f11bdfbc3470fdf112bf1d83c1c'],703,7,710,22874913,18,0.86407767,0.262135922,0.805825243,24799
1a9573586fae66ddd7324aada66be0e35d58816f,1,Sumit Mohanty,2016-05-31 21:27:55-07:00,['da039e13dd50d571d054307b113d29aaac6a07ac'],6,8,14,22874927,2,0,1,0,24799
ff0a69483ccb3358857e54e900acfe3ce79a0b3a,0,Alex Antonenko,2016-06-01 11:23:37+03:00,['1a9573586fae66ddd7324aada66be0e35d58816f'],0,21,21,22874948,1,0,1,0.857142857,24799
2426d02d0f41c84f626c496b3230ac45fc424399,1,Andrii Tkach,2016-06-01 12:35:18+03:00,['ff0a69483ccb3358857e54e900acfe3ce79a0b3a'],87,955,1042,22875990,4,0.828996283,1,0.990086741,24799
f1e7d1707b26b21e4def3ce19d5f235029a78783,1,Pallav Kulshreshtha,2016-06-01 16:18:57+05:18,['2426d02d0f41c84f626c496b3230ac45fc424399'],6,121,127,22876117,4,0.130434783,1,1,24800
6f855d53c9923182ee0647cc37d1856a5882b19a,1,Lisnichenko Dmitro,2016-06-01 18:20:58+03:00,['f1e7d1707b26b21e4def3ce19d5f235029a78783'],13410,23197,36607,22912724,601,1,1,1,24804
7033b1c5490a61756727a517fd4a02ecce0c11d9,1,Nate Cole,2016-06-01 11:39:12-04:00,['6f855d53c9923182ee0647cc37d1856a5882b19a'],28,124,152,22912876,8,0.378787879,0.136363636,1,24804
99a615566dc36c1b54e6c13a268149e49a952b50,1,Nate Cole,2016-06-01 11:42:56-04:00,['7033b1c5490a61756727a517fd4a02ecce0c11d9'],18,129,147,22913023,6,0.125,0,0.4375,24805
5027ab38fffe53eccfc1032ae9e577df7af2cca8,1,Aravindan Vijayan,2016-06-01 10:12:04-07:00,['99a615566dc36c1b54e6c13a268149e49a952b50'],20,107,127,22913150,4,0,0.454545455,0.909090909,24805
b1499e2fcb0ec7a2c26348bceadec4c1abc9b625,1,Alex Antonenko,2016-06-01 20:21:14+03:00,['5027ab38fffe53eccfc1032ae9e577df7af2cca8'],3,3,6,22913156,2,,,,24805
92dec5bd689b78cdb9a5a257ddecc02b2c664e66,0,Alex Antonenko,2016-06-01 20:21:14+03:00,['b1499e2fcb0ec7a2c26348bceadec4c1abc9b625'],4,10,14,22913170,1,0.833333333,1,1,24805
2327365b2e99179a0fb82b9284395cae0690001a,1,Alex Antonenko,2016-06-01 20:21:14+03:00,['92dec5bd689b78cdb9a5a257ddecc02b2c664e66'],20,199,219,22913389,3,0,0.989010989,0.895604396,24805
70aacc6dbcf762ce387ecca544977a2ace006c6d,0,Lisnichenko Dmitro,2016-06-01 20:22:39+03:00,['2327365b2e99179a0fb82b9284395cae0690001a'],16346,16349,32695,22946084,578,,,,24805
4d660f8f98ddc8f1ed969f3ff14d97492b26d8af,0,Lisnichenko Dmitro,2016-06-01 20:32:18+03:00,['70aacc6dbcf762ce387ecca544977a2ace006c6d'],4,27,31,22946115,1,,,,24805
70e90fa3a0769bb884c301f986fb3d8b6586768f,1,Yusaku Sako,2016-06-01 10:55:34-07:00,['4d660f8f98ddc8f1ed969f3ff14d97492b26d8af'],0,3536,3536,22949651,4,0.767857143,0.428571429,1,24808
761000633ef42899b7f983ddca9a78ea52816759,1,Bhuvnesh Chaudhary,2016-06-01 11:49:56-07:00,['70e90fa3a0769bb884c301f986fb3d8b6586768f'],17,14,31,22949682,4,1,0,0,24808
7d1223232221294b692e2ee1ac795c2a5b4e26f6,0,Zhe (Joe) Wang,2016-06-01 13:01:51-07:00,['761000633ef42899b7f983ddca9a78ea52816759'],2,9,11,22949693,1,1,1,1,24808
e2dd1261e99bc71306ad91aa7b1e75ce144af0bc,1,Zhe (Joe) Wang,2016-06-01 13:06:26-07:00,['7d1223232221294b692e2ee1ac795c2a5b4e26f6'],7,22,29,22949722,7,1,1,1,24808
3324fd64564538bfe1c07f9bda7ab7ddf9e8ffc9,1,Vitaly Brodetskyi,2016-06-01 06:21:25+03:00,['e2dd1261e99bc71306ad91aa7b1e75ce144af0bc'],21,21,42,22949764,1,1,1,1,24808
8d30f1a4d1da10225f66ecc02f757b4db904c5c0,1,Jonathan Hurley,2016-06-01 16:31:26-04:00,['3324fd64564538bfe1c07f9bda7ab7ddf9e8ffc9'],103,127,230,22949994,6,0.111111111,1,1,24808
29f9fa341ff795503ee5b782181179b50180850e,0,Jayush Luniya,2016-06-01 13:53:43-07:00,['8d30f1a4d1da10225f66ecc02f757b4db904c5c0'],0,1,1,22949995,1,,,,24808
2c51b64c63dc424f35a1849c9b4588a157d13218,1,Aleksandr Kovalenko,2016-06-01 23:56:20+03:00,['29f9fa341ff795503ee5b782181179b50180850e'],10,7,17,22950012,2,,,,24808
b4df6da51164b71543c764eb8e94cf7fa74da8ce,0,Bhuvnesh Chaudhary,2016-06-01 15:36:39-07:00,['2c51b64c63dc424f35a1849c9b4588a157d13218'],5,37,42,22950054,3,0,0.588235294,0.823529412,24808
2ff12b7e0ff3ff111f5f8b01e2a232b3109f4ab7,1,oleewere,2016-06-02 00:36:46+02:00,['b4df6da51164b71543c764eb8e94cf7fa74da8ce'],22,149,171,22950225,20,0.181818182,0.818181818,0.909090909,24808
f6cd388f221132828302269b50159c9d8475f1ed,0,Jaimin Jetly,2016-06-01 15:49:05-07:00,['2ff12b7e0ff3ff111f5f8b01e2a232b3109f4ab7'],2,6,8,22950233,3,1,1,1,24808
e803e960527c94dcf74b4e81aa836e3e70ac1e06,1,Srimanth Gunturi,2016-06-01 17:08:48-07:00,['f6cd388f221132828302269b50159c9d8475f1ed'],10,127,137,22950370,13,0,0,0,24808
f3e2768e7a8fbebfc9a234735bc3f7c863c7a7d8,1,oleewere,2016-06-02 02:19:47+02:00,['e803e960527c94dcf74b4e81aa836e3e70ac1e06'],49,176,225,22950595,14,0,1,0.571428571,24808
9c452bf9309d909e887f8dc7c1f878daedcb4dfd,0,Srimanth Gunturi,2016-06-01 18:36:31-07:00,['f3e2768e7a8fbebfc9a234735bc3f7c863c7a7d8'],27,4,31,22950626,1,,,,24808
55dd6c8a3648d30e1c54cf8786f9879fe9e3d0c7,0,Srimanth Gunturi,2016-06-01 18:41:57-07:00,['9c452bf9309d909e887f8dc7c1f878daedcb4dfd'],16349,16346,32695,22983321,578,,,,24808
0aeaa95656e02a422dbaf9a443d7d4d943f94b30,1,Srimanth Gunturi,2016-06-01 18:58:23-07:00,['55dd6c8a3648d30e1c54cf8786f9879fe9e3d0c7'],23195,13413,36608,23019929,601,0,0,0,24808
bd85c28158b8c1bd7dbea13ac25519a2551d917d,0,Matt,2016-06-01 20:34:08-07:00,['0aeaa95656e02a422dbaf9a443d7d4d943f94b30'],7,16,23,23019952,3,0,1,1,24808
03e41db82ba0c115b6c09ced768b78e7db9881ce,1,Oleg Nechiporenko,2016-06-02 09:01:49+03:00,['bd85c28158b8c1bd7dbea13ac25519a2551d917d'],344,537,881,23020833,39,1,1,1,24808
5416153e938c2f3a2eca16245e7f9739a079cb45,0,oleewere,2016-06-02 10:09:34+02:00,['03e41db82ba0c115b6c09ced768b78e7db9881ce'],7,6,13,23020846,2,,,,24808
b49b3545db453116b217856740995096d0165806,0,oleewere,2016-06-02 10:43:51+02:00,['5416153e938c2f3a2eca16245e7f9739a079cb45'],4,5,9,23020855,1,0,0,0,24808
269ba47542fb62d9ee94b904143ca816ad986040,1,oleewere,2016-06-02 11:02:50+02:00,['b49b3545db453116b217856740995096d0165806'],119,198,317,23021172,3,0.563636364,0.690909091,1,24808
aa083be7925abaa5490f174015a622cf37c3b9ff,1,oleewere,2016-06-02 11:39:17+02:00,['269ba47542fb62d9ee94b904143ca816ad986040'],18,31,49,23021221,7,0,0,,24808
046e0f6931bf9198b9379e9a627e9b6d911dee2a,1,Andrew Onishuk,2016-06-02 13:07:35+03:00,['aa083be7925abaa5490f174015a622cf37c3b9ff'],5,8,13,23021234,2,1,0,1,24808
affeb7f8aec8ced09b8025810218da43a9615dd5,1,Oleg Nechiporenko,2016-06-02 13:13:13+03:00,['046e0f6931bf9198b9379e9a627e9b6d911dee2a'],6,8,14,23021248,5,,,,24808
688e61ad3d28c998af848c8c1584ef4aaabd3e79,0,Nate Cole,2016-06-02 06:50:10-04:00,['affeb7f8aec8ced09b8025810218da43a9615dd5'],4,6,10,23021258,1,,,,24808
dac58716eb71877221a2d1435a3c55f406aba44f,1,Dipayan Bhowmick,2016-06-02 16:59:57+05:18,['688e61ad3d28c998af848c8c1584ef4aaabd3e79'],1,1,2,23021260,1,,,,24808
b1f0645c041e18c5c0af7063adbe2a0119f11663,1,Andrew Onishuk,2016-06-02 15:52:13+03:00,['dac58716eb71877221a2d1435a3c55f406aba44f'],32,75,107,23021367,7,0.394736842,1,1,24808
6f3b17313f47c966096fe29489d4a45efd7c816b,0,oleewere,2016-06-02 14:57:51+02:00,['b1f0645c041e18c5c0af7063adbe2a0119f11663'],6,0,6,23021373,1,,,,24808
1bd7f3482c230d44d90be58120afb89ecf8bd3af,0,Andrew Onishuk,2016-06-02 17:26:45+03:00,['6f3b17313f47c966096fe29489d4a45efd7c816b'],2,11,13,23021386,2,1,1,0,24808
09c3ad4ef1d378e133727c4cdf2e8e86211b89de,1,Pallav Kulshreshtha,2016-06-02 20:05:07+05:18,['1bd7f3482c230d44d90be58120afb89ecf8bd3af'],11,16,27,23021413,4,1,1,0,24808
e8fa1c28322d49060d792ed8a84894fa60f7c99b,1,Andrii Tkach,2016-06-02 18:00:25+03:00,['09c3ad4ef1d378e133727c4cdf2e8e86211b89de'],6,61,67,23021480,3,1,1,1,24808
ed7c64ad2d8bc9c3e5b20e61426472f50e011773,1,Lisnichenko Dmitro,2016-06-02 18:02:03+03:00,['e8fa1c28322d49060d792ed8a84894fa60f7c99b'],13402,23242,36644,23058124,601,1,1,1,24812
0df919ade14001a882cc6b7779e0f0f745de55fa,0,Pallav Kulshreshtha,2016-06-02 20:45:59+05:18,['ed7c64ad2d8bc9c3e5b20e61426472f50e011773'],2,2,4,23058128,1,,,,24812
57180810c5963c7f436370ac6e5983cf630e32ac,1,Lisnichenko Dmitro,2016-06-02 18:30:30+03:00,['0df919ade14001a882cc6b7779e0f0f745de55fa'],7,42,49,23058177,5,0.583333333,0.666666667,1,24812
5f704b1f512ab7ffe9ca4ab34f3cdd80fdb02756,1,Pallav Kulshreshtha,2016-06-02 20:51:14+05:18,['57180810c5963c7f436370ac6e5983cf630e32ac'],4,4,8,23058185,2,,,,24812
81842ee888e16b7c20e134c7e783f198c171cc58,1,Myroslav Papirkovskyi,2016-06-02 18:33:59+03:00,['5f704b1f512ab7ffe9ca4ab34f3cdd80fdb02756'],200,853,1053,23059238,33,0.447293447,0.794871795,0.891737892,24817
920f49c19798ab5d8b4c495fc17b7ee43299306b,0,Myroslav Papirkovskyi,2016-06-02 19:12:11+03:00,['81842ee888e16b7c20e134c7e783f198c171cc58'],0,31,31,23059269,2,0.111111111,1,1,24817
37cab36f0e40a7ca968ab915b47bb65cb98d0841,1,Jayush Luniya,2016-06-02 09:19:38-07:00,['920f49c19798ab5d8b4c495fc17b7ee43299306b'],23,21,44,23059313,7,,,,24817
f247b78a74e490660d3975de86098f65b6884736,1,Jayush Luniya,2016-06-02 09:39:04-07:00,['37cab36f0e40a7ca968ab915b47bb65cb98d0841'],10,11,21,23059334,3,,,,24817
638807ffdcd5357c2699c3301f78a88278e23205,1,Jayush Luniya,2016-06-02 10:39:06-07:00,['f247b78a74e490660d3975de86098f65b6884736'],6,703,709,23060043,18,0.13592233,0.737864078,0.194174757,24825
bd8c158a525027f9cb50208f2a4ab8d0b6aaf56c,1,Jayush Luniya,2016-06-02 11:39:33-07:00,['638807ffdcd5357c2699c3301f78a88278e23205'],261,127,388,23060431,9,0.2,0.844444444,0.688888889,24825
26609656f8d281e5f50d1a40c3a153ee22b59c7d,1,Dmytro Sen,2016-06-02 22:03:55+03:00,['bd8c158a525027f9cb50208f2a4ab8d0b6aaf56c'],1,21,22,23060453,2,0.916666667,1,1,24825
c583afb58b8ed97b95741cf5398e5da7d3950f7e,0,Dmytro Sen,2016-06-02 22:27:35+03:00,['26609656f8d281e5f50d1a40c3a153ee22b59c7d'],5,12,17,23060470,1,,,,24825
bd891629ea04de92a62424a1bc4ab1cb912770eb,1,Sandor Magyari,2016-06-02 21:38:00+02:00,['c583afb58b8ed97b95741cf5398e5da7d3950f7e'],3,172,175,23060645,15,0,0.962732919,1,24825
61ae693d1a209669e0eb64e50004f98c95a4366f,0,Aravindan Vijayan,2016-06-02 13:27:16-07:00,['bd891629ea04de92a62424a1bc4ab1cb912770eb'],1,4,5,23060650,1,0,0,1,24825
24bd485ab7504739c11558204d8d667ab76c3d09,1,Jaimin Jetly,2016-06-02 14:14:50-07:00,['61ae693d1a209669e0eb64e50004f98c95a4366f'],20,23,43,23060693,2,1,1,1,24825
1d3523a5fb02e8b6be1cca88c3bfae7be6c698f0,1,Zhe (Joe) Wang,2016-06-02 14:39:19-07:00,['24bd485ab7504739c11558204d8d667ab76c3d09'],10,22,32,23060725,2,1,1,0.181818182,24825
396adbedf0915ea4f12c0063f10bc5b46582b22d,1,Swapan Shridhar,2016-06-02 16:32:11-07:00,['1d3523a5fb02e8b6be1cca88c3bfae7be6c698f0'],44,48,92,23060817,5,1,1,1,24825
9bb8524b9c0a2241f266c53b4e57669d7efa4164,1,Xi Wang,2016-06-02 16:37:58-07:00,['396adbedf0915ea4f12c0063f10bc5b46582b22d'],8,23,31,23060848,3,1,1,1,24825
b8c1cb6990c61e4d17b6ce309a705ee103d35748,0,Zhe (Joe) Wang,2016-06-02 16:52:46-07:00,['9bb8524b9c0a2241f266c53b4e57669d7efa4164'],1,1,2,23060850,1,,,,24825
e663b5cf40dd88c0ba47df922fd7dc71083c3bfa,1,Dipayan Bhowmick,2016-06-03 08:37:28+05:18,['b8c1cb6990c61e4d17b6ce309a705ee103d35748'],633,15,648,23061498,11,0.041152263,0.131687243,0.028806584,24825
6fc67f80f11cdfd67ddaf1e8cab4fe518ad41609,1,Gautam Borad,2016-06-03 11:06:56+05:18,['e663b5cf40dd88c0ba47df922fd7dc71083c3bfa'],20,22,42,23061540,5,0,0,1,24825
da1a6497de609c4f7b168b781630991ce0fc5425,0,Pallav Kulshreshtha,2016-06-03 11:20:48+05:18,['6fc67f80f11cdfd67ddaf1e8cab4fe518ad41609'],31,0,31,23061571,1,,,,24825
3ed98f27b612d349ef6f53aa9d3a622f814d2170,0,Pallav Kulshreshtha,2016-06-03 11:24:40+05:18,['da1a6497de609c4f7b168b781630991ce0fc5425'],0,31,31,23061602,1,,,,24826
66815a1b33f50a4f457f7ff746ff30958eee590d,1,Mahadev Konar,2016-06-02 23:35:10-07:00,['3ed98f27b612d349ef6f53aa9d3a622f814d2170'],17,17,34,23061636,4,0,1,0.444444444,24826
1672cc9d5d48a9ebdd81078ea29020065cba566b,0,ababiichuk,2016-06-03 10:48:25+03:00,['66815a1b33f50a4f457f7ff746ff30958eee590d'],5,16,21,23061657,3,1,1,1,24826
7038957df73bcc239ad156a3041a009826bd9900,0,Andrii Tkach,2016-06-03 11:22:37+03:00,['1672cc9d5d48a9ebdd81078ea29020065cba566b'],3,10,13,23061670,4,,,,24826
e3f6ec7a1f2876007ecd6b4a30ba25c561e2729e,1,Lisnichenko Dmitro,2016-06-03 13:11:59+03:00,['7038957df73bcc239ad156a3041a009826bd9900'],3,34,37,23061707,2,1,1,1,24826
2f298b24edbedfbb9b76fe1f4621fcfd9f5f4164,1,Alex Antonenko,2016-06-03 13:16:38+03:00,['e3f6ec7a1f2876007ecd6b4a30ba25c561e2729e'],4,5,9,23061716,1,1,1,1,24826
e342bf9271af2495c3aca566bbd964d1d3289979,0,Dmytro Sen,2016-06-03 15:11:20+03:00,['2f298b24edbedfbb9b76fe1f4621fcfd9f5f4164'],3,3,6,23061722,3,,,,24826
0fc46d0298edea1dd6e0b6dbea305172aea232be,1,oleewere,2016-06-03 15:08:03+02:00,['e342bf9271af2495c3aca566bbd964d1d3289979'],2,4,6,23061728,3,,,,24826
041d89f2ee000d83f58df2addd1fae79145e217c,1,Vitaly Brodetskyi,2016-06-02 23:09:42+03:00,['0fc46d0298edea1dd6e0b6dbea305172aea232be'],28,45,73,23061801,6,0,1,1,24826
5aa9880b13f9e54d1a85b79b2eec4c6822699740,0,Robert Levas,2016-06-03 09:47:11-04:00,['041d89f2ee000d83f58df2addd1fae79145e217c'],0,22,22,23061823,2,0,0.952380952,1,24826
881edf302ccc74162a206b26d3d0ac90f29b420e,0,Nate Cole,2016-06-03 10:05:46-04:00,['5aa9880b13f9e54d1a85b79b2eec4c6822699740'],16,16,32,23061855,1,,,,24826
c126aa318234ca511ea23b6ddb31da41104e5bb5,0,Di Li,2016-06-03 12:11:59-04:00,['881edf302ccc74162a206b26d3d0ac90f29b420e'],3,10,13,23061868,2,0,0,1,24826
cd5f4dfc9299376c21e2f490c0a50c34dff05269,0,Bhuvnesh Chaudhary,2016-06-03 12:27:47-07:00,['c126aa318234ca511ea23b6ddb31da41104e5bb5'],2,2,4,23061872,1,,,,24826
7a030d752722d5af5256696df64c747a3979f84a,0,Sumit Mohanty,2016-06-03 14:58:32-07:00,['cd5f4dfc9299376c21e2f490c0a50c34dff05269'],1,1,2,23061874,1,,,,24826
2f7beef8296a3757c6dcc2b15ceaa0f31bf61cfe,1,Jaimin Jetly,2016-06-03 17:12:42-07:00,['7a030d752722d5af5256696df64c747a3979f84a'],4,13,17,23061891,2,,,,24826
3b8111f3aee10f069b5fc0e0e2c041c7fcfd671b,1,Alex Antonenko,2016-06-04 13:31:19+03:00,['2f7beef8296a3757c6dcc2b15ceaa0f31bf61cfe'],15,48,63,23061954,5,0,0,1,24826
2c08fa6b6db6fe18238311461ab928f7e8f23934,1,Robert Levas,2016-06-04 06:43:49-04:00,['3b8111f3aee10f069b5fc0e0e2c041c7fcfd671b'],16,250,266,23062220,6,0.790540541,0.993243243,1,24826
bc9097b146a77a833183cd3d560268644964e87f,1,Lisnichenko Dmitro,2016-06-06 16:50:41+03:00,['2c08fa6b6db6fe18238311461ab928f7e8f23934'],150,158,308,23062528,5,0,0,0.266666667,24826
83f8add98a1d6c4eb4f21069492f905f93c28f5b,0,Andrew Onishuk,2016-06-06 18:04:24+03:00,['bc9097b146a77a833183cd3d560268644964e87f'],4,7,11,23062539,1,0,0,1,24826
b0bc550c167ba6e6f0509c34c89f164a4f959fe7,0,Lisnichenko Dmitro,2016-06-06 18:26:21+03:00,['83f8add98a1d6c4eb4f21069492f905f93c28f5b'],8,8,16,23062555,3,,,,24826
7593acfdacf9ace292b1adb607eebbb15080469f,1,Jonathan Hurley,2016-06-06 11:52:53-04:00,['b0bc550c167ba6e6f0509c34c89f164a4f959fe7'],92,115,207,23062762,8,1,1,0.142857143,24826
4937b6ddde02d02d838c5f57755796b51b30d442,1,Dmytro Sen,2016-06-06 19:37:36+03:00,['7593acfdacf9ace292b1adb607eebbb15080469f'],0,5,5,23062767,1,,,,24826
11543ed4f7ad03bbbbae579183c1547a6ed828fa,1,Andrew Onishuk,2016-06-06 19:46:55+03:00,['4937b6ddde02d02d838c5f57755796b51b30d442'],4,29,33,23062800,4,0.181818182,0.363636364,0.818181818,24826
d5afa1b45b612fed601dfe41152194f6000bcfaa,0,Alex Antonenko,2016-06-06 21:26:29+03:00,['11543ed4f7ad03bbbbae579183c1547a6ed828fa'],1,1,2,23062802,1,,,,24826
d6ae8e3d4c04f3bd6a432965098105683fe50684,0,Alex Antonenko,2016-06-06 21:26:29+03:00,['d5afa1b45b612fed601dfe41152194f6000bcfaa'],1,3,4,23062806,1,,,,24826
66fd5920f47f756b469244b67b49fd0e7372a54f,0,Richard Zang,2016-06-06 11:48:37-07:00,['d6ae8e3d4c04f3bd6a432965098105683fe50684'],10,43,53,23062859,4,1,1,1,24827
f070a59109b84d351115671259c4fe78cd3f6096,1,Alejandro Fernandez,2016-06-06 13:06:09-07:00,['66fd5920f47f756b469244b67b49fd0e7372a54f'],4,64,68,23062927,7,0,0,0.041666667,24827
3b8da53d619e6ad2ef82c3a9f37dbb1471d2e7b4,1,Yusaku Sako,2016-06-06 13:11:35-07:00,['f070a59109b84d351115671259c4fe78cd3f6096'],0,315,315,23063242,2,0.692307692,0.5,1,24828
5fc282e95f3e142afe41902b21dc8c98b7145a27,1,Bhuvnesh Chaudhary,2016-06-06 15:15:42-07:00,['3b8da53d619e6ad2ef82c3a9f37dbb1471d2e7b4'],74,116,190,23063432,4,0,0.375,1,24828
cd93321095ed32b4242905033f5a0f3769935134,1,Jaimin Jetly,2016-06-06 16:33:45-07:00,['5fc282e95f3e142afe41902b21dc8c98b7145a27'],0,17,17,23063449,2,,,,24828
edc3ac53833a3e212b0567cc683353275667b9f6,1,Srimanth Gunturi,2016-06-06 16:47:27-07:00,['cd93321095ed32b4242905033f5a0f3769935134'],55,41,96,23063545,2,1,0,0,24828
13248dc109217be1f902b5bbeb3f228cf839c8ce,0,Matt,2016-06-06 20:53:42-07:00,['edc3ac53833a3e212b0567cc683353275667b9f6'],13,12,25,23063570,8,,,,24828
86bf4dcaac4c46dafe25c4db21cbecfbb3aeadbb,1,Swapan Shridhar,2016-06-07 00:08:19-07:00,['13248dc109217be1f902b5bbeb3f228cf839c8ce'],16,227,243,23063813,3,0.005649718,0.926553672,0.926553672,24828
cee5c421599a8e21bccd95f538186ee651d3b90d,1,Matt,2016-06-07 00:18:27-07:00,['86bf4dcaac4c46dafe25c4db21cbecfbb3aeadbb'],438,225,663,23064476,8,0.573913043,0.426086957,0.469565217,24828
4eea7ccdccbe60302a7e72177d575a9fc6eeb949,0,Lisnichenko Dmitro,2016-06-07 11:35:57+03:00,['cee5c421599a8e21bccd95f538186ee651d3b90d'],1,3,4,23064480,2,0,0,1,24828
62e2183db2315aae8dd75fe67b76a42bb7a2ee10,1,oleewere,2016-06-07 12:19:13+02:00,['4eea7ccdccbe60302a7e72177d575a9fc6eeb949'],7,9,16,23064496,4,0,0,0,24828
d2cad200f107947cfc77e550e8acd81c3418f438,1,Dmytro Sen,2016-06-07 14:17:48+03:00,['62e2183db2315aae8dd75fe67b76a42bb7a2ee10'],66,234,300,23064796,8,0.201388889,0.972222222,0.826388889,24828
87ff159bb513267e9629806c248084272e1a61b7,1,Lisnichenko Dmitro,2016-06-07 14:18:55+03:00,['d2cad200f107947cfc77e550e8acd81c3418f438'],0,24,24,23064820,4,,,,24828
bce6052c9f4ca30d86cba63e165a0bb7c839bd7f,1,Alex Antonenko,2016-06-07 14:33:45+03:00,['87ff159bb513267e9629806c248084272e1a61b7'],4,15,19,23064839,2,1,1,1,24828
a6574055a9f1da87b4d2c9ad320171f71f7d58f0,1,Pallav Kulshreshtha,2016-06-07 17:16:21+05:18,['bce6052c9f4ca30d86cba63e165a0bb7c839bd7f'],80,362,442,23065281,11,0.909090909,1,1,24828
308e458d3cd737cc776355b9e8ee6ca11d8f5283,0,ababiichuk,2016-06-07 15:58:29+03:00,['a6574055a9f1da87b4d2c9ad320171f71f7d58f0'],0,3,3,23065284,2,0,0,1,24828
e6643492d4dfc4acb42a68999e6dade219d8e99f,0,ababiichuk,2016-06-07 15:58:29+03:00,['308e458d3cd737cc776355b9e8ee6ca11d8f5283'],1,1,2,23065286,1,,,,24828
6554d77cfb18cd773dbbb0a41ab655365b84aa22,0,Alex Antonenko,2016-06-07 17:02:25+03:00,['e6643492d4dfc4acb42a68999e6dade219d8e99f'],0,1,1,23065287,1,,,,24828
8098350a43c3006825ee12bd8944bd9465196eed,1,Nate Cole,2016-06-07 11:34:37-04:00,['6554d77cfb18cd773dbbb0a41ab655365b84aa22'],2,22,24,23065311,2,0,0,1,24828
db7f25505349c3a12688fc893676f84c3d7c4d59,1,Dmytro Sen,2016-06-07 19:39:48+03:00,['8098350a43c3006825ee12bd8944bd9465196eed'],2,42,44,23065355,2,0,1,1,24828
4468e1624d83e9d7547f81d3ea9b1e6772ccae20,1,oleewere,2016-06-07 18:47:43+02:00,['db7f25505349c3a12688fc893676f84c3d7c4d59'],4,89,93,23065448,3,0.205882353,0,1,24828
237715f04d00e8fcf90bfbbc9ca19939b2457539,1,Zhe (Joe) Wang,2016-06-07 10:34:01-07:00,['4468e1624d83e9d7547f81d3ea9b1e6772ccae20'],6,7,13,23065461,4,,,,24828
4e2d4aff33ff466581b8da79ef9ce7175cc8d53f,1,Di Li,2016-06-07 13:54:57-04:00,['237715f04d00e8fcf90bfbbc9ca19939b2457539'],10967,18,10985,23076446,7,0.631807098,0.297344893,0.169330805,24830
4d622167d94779cb9fd291b12fc406378b06ef54,1,Dipayan Bhowmick,2016-06-07 23:37:10+05:18,['4e2d4aff33ff466581b8da79ef9ce7175cc8d53f'],46,37,83,23076529,6,0,0,0,24830
bd58a5038032445831996a33ae52a08f387a2335,1,Zhe (Joe) Wang,2016-06-07 11:24:41-07:00,['4d622167d94779cb9fd291b12fc406378b06ef54'],0,351,351,23076880,8,0.96,0.96,1,24833
9e15b2b652be4097e61b104bccea310b0e23196a,0,Richard Zang,2016-06-07 11:43:25-07:00,['bd58a5038032445831996a33ae52a08f387a2335'],9,6,15,23076895,1,1,1,0,24833
c85d0d15e5c015a069c888c25583e7bfe767acd8,1,Robert Levas,2016-06-07 15:08:03-04:00,['9e15b2b652be4097e61b104bccea310b0e23196a'],11,16,27,23076922,10,0.428571429,1,1,24833
8edd1869e89eb783c9349078031740f7e90ea80f,0,Swapan Shridhar,2016-06-07 12:38:26-07:00,['c85d0d15e5c015a069c888c25583e7bfe767acd8'],610,5,615,23077537,1,,,,24833
ea2cbfcf3957258501e04583776b346adc478d96,1,tbeerbower,2016-06-07 15:53:22-04:00,['8edd1869e89eb783c9349078031740f7e90ea80f'],64,435,499,23078036,6,0.009404389,0.504702194,0.721003135,24833
62e124c9817e6400c71c775a45f388a2c8c18cb0,1,tbeerbower,2016-06-07 16:04:54-04:00,['ea2cbfcf3957258501e04583776b346adc478d96'],91,328,419,23078455,8,0,0.489795918,1,24833
edf85a3837519b9c4e5704531627f4985a56b5ea,1,Xi Wang,2016-06-07 14:12:49-07:00,['62e124c9817e6400c71c775a45f388a2c8c18cb0'],1,14,15,23078470,3,,,,24833
b71109eeda4a892e8d41dad16cc6134f647d0ba7,0,tbeerbower,2016-06-07 17:58:33-04:00,['edf85a3837519b9c4e5704531627f4985a56b5ea'],326,0,326,23078796,1,1,0.431034483,0,24833
e70bd21bbce01370d43fdcb29c0167fc86bb08fb,1,Alejandro Fernandez,2016-06-07 15:08:35-07:00,['b71109eeda4a892e8d41dad16cc6134f647d0ba7'],1,91,92,23078888,8,,,,24833
b3241e3f03948f9e2de2acc8f01e1432640d1c1c,1,Swapan Shridhar,2016-06-07 16:48:50-07:00,['e70bd21bbce01370d43fdcb29c0167fc86bb08fb'],0,58,58,23078946,2,,,,24834
6fbb4c1830ced4c3f600aa4d7fdb510d2249ddfa,0,Alejandro Fernandez,2016-06-07 17:07:11-07:00,['b3241e3f03948f9e2de2acc8f01e1432640d1c1c'],0,4,4,23078950,2,,,,24834
49d5d587be687e1aef12bd39df777824b96e36c9,0,Matt,2016-06-07 21:47:51-07:00,['6fbb4c1830ced4c3f600aa4d7fdb510d2249ddfa'],1,1,2,23078952,1,,,,24834
ce9bc3f060fcfc316c1fc0242daa14347282dd5a,1,Oleg Nechiporenko,2016-06-08 11:07:22+03:00,['49d5d587be687e1aef12bd39df777824b96e36c9'],5,5,10,23078962,2,,,,24834
e2932d482ec7a5dd2f48961f65bfd4fc212f4443,1,Oleg Nechiporenko,2016-06-08 11:07:23+03:00,['ce9bc3f060fcfc316c1fc0242daa14347282dd5a'],4,4,8,23078970,2,1,1,1,24834
6e762a04df11c6c9344b2e61382b606af5caea78,0,Andrii Tkach,2016-06-08 12:51:34+03:00,['e2932d482ec7a5dd2f48961f65bfd4fc212f4443'],2,2,4,23078974,1,,,,24834
1067a831f9ce1932d848d4125214451e04f7a66a,1,Pallav Kulshreshtha,2016-06-08 15:31:27+05:18,['6e762a04df11c6c9344b2e61382b606af5caea78'],6,280,286,23079260,9,0.861111111,1,0.977777778,24836
210238c4f9e0be1b5d5bf7ded9de33bcda739751,0,Lisnichenko Dmitro,2016-06-08 13:17:00+03:00,['1067a831f9ce1932d848d4125214451e04f7a66a'],2,0,2,23079262,1,,,,24836
32890b5542dee84de30d127896fe2426af1926ee,0,oleewere,2016-06-08 12:32:28+02:00,['210238c4f9e0be1b5d5bf7ded9de33bcda739751'],23,33,56,23079318,8,0.2,1,1,24836
35ff7d79a8b8c2c74bf772efff295af1dc4091f8,0,Andrew Onishuk,2016-06-08 13:40:40+03:00,['32890b5542dee84de30d127896fe2426af1926ee'],9,167,176,23079494,4,0.08045977,0.517241379,0.770114943,24837
71cbc0254bcfa3f2d12a1a59ffbe1f4809f5a6d7,0,Andrew Onishuk,2016-06-08 13:52:08+03:00,['35ff7d79a8b8c2c74bf772efff295af1dc4091f8'],0,5,5,23079499,2,0,0.8,1,24837
de44995464af2901f214e74e730341b0c1aa61ac,0,oleewere,2016-06-08 12:58:15+02:00,['71cbc0254bcfa3f2d12a1a59ffbe1f4809f5a6d7'],1,101,102,23079601,2,,,,24838
fa2f440a5fc083a53ce88e94ca9c6542ac121eb6,0,Aleksandr Kovalenko,2016-06-08 14:04:32+03:00,['de44995464af2901f214e74e730341b0c1aa61ac'],13,38,51,23079652,2,0.44,1,1,24838
e18718a8cb8390b4d27cd986692afd3104a6c0bc,1,oleewere,2016-06-08 13:46:21+02:00,['fa2f440a5fc083a53ce88e94ca9c6542ac121eb6'],10,8,18,23079670,1,,,,24838
05c12d51f8d1ca2716cad60af5701f38321931e3,1,Andrew Onishuk,2016-06-08 15:23:38+03:00,['e18718a8cb8390b4d27cd986692afd3104a6c0bc'],7,13,20,23079690,7,0.5,1,1,24838
4bfeb41d1ef777f9f65fc6b65e21b9ab541a5264,0,Dmytro Sen,2016-06-08 15:46:06+03:00,['05c12d51f8d1ca2716cad60af5701f38321931e3'],0,23,23,23079713,1,,,,24838
5276ffef80676f54a8a82bce226004813ce4ad23,1,Pallav Kulshreshtha,2016-06-08 18:11:01+05:18,['4bfeb41d1ef777f9f65fc6b65e21b9ab541a5264'],12,11,23,23079736,3,1,1,1,24838
20b817f10ebc4b99093b4829534b6fc7d23e5ddc,0,Pallav Kulshreshtha,2016-06-08 18:17:21+05:18,['5276ffef80676f54a8a82bce226004813ce4ad23'],11,16,27,23079763,4,0,1,1,24838
b440ae7f524156fdb42c24d88a52b8fe17c8ab28,1,Andrew Onishuk,2016-06-08 16:19:01+03:00,['20b817f10ebc4b99093b4829534b6fc7d23e5ddc'],2,2,4,23079767,1,,,,24838
23aa6eacab0c19c689ee0888b3783bf16703309f,1,Jonathan Hurley,2016-06-08 11:01:45-04:00,['b440ae7f524156fdb42c24d88a52b8fe17c8ab28'],30,136,166,23079933,4,1,1,1,24838
671f3bde8da487f4d24f79ee8893a6fcf9635005,0,Aravindan Vijayan,2016-06-08 08:37:03-07:00,['23aa6eacab0c19c689ee0888b3783bf16703309f'],1,1,2,23079935,1,0,1,1,24838
8c1564e083169196cf53b8c1a570bcf3c5f65e68,1,Robert Levas,2016-06-08 11:52:01-04:00,['671f3bde8da487f4d24f79ee8893a6fcf9635005'],3,188,191,23080126,2,0.186666667,0.613333333,1,24839
0c10fb1909741aa9255978340be2c3656ded0d3b,1,Andrew Onishuk,2016-06-08 18:53:41+03:00,['8c1564e083169196cf53b8c1a570bcf3c5f65e68'],58,55,113,23080239,4,1,1,1,24839
963985e42691ab6a74fcad56c0aafd9ef6c309a3,0,Andrew Onishuk,2016-06-08 19:10:49+03:00,['0c10fb1909741aa9255978340be2c3656ded0d3b'],1,1,2,23080241,1,,,,24839
d2cbcd3cfd26a5848d5b183a653b3310b7538f3f,0,Srimanth Gunturi,2016-06-08 09:20:23-07:00,['963985e42691ab6a74fcad56c0aafd9ef6c309a3'],12,603,615,23080856,14,0,0.074626866,0.701492537,24844
be36f4856f75d9d2e7de2a6c28e5c79bcea6add3,0,oleewere,2016-06-08 18:21:59+02:00,['d2cbcd3cfd26a5848d5b183a653b3310b7538f3f'],1,3,4,23080860,1,,,,24844
74db7351782482eac93241213834c863f587560e,0,ababiichuk,2016-06-08 19:29:40+03:00,['be36f4856f75d9d2e7de2a6c28e5c79bcea6add3'],1,1,2,23080862,1,,,,24844
28dc0e163b33de679d00adbb2ca90edc18ac81b5,0,Sumit Mohanty,2016-06-08 10:02:40-07:00,['74db7351782482eac93241213834c863f587560e'],1,1,2,23080864,1,,,,24844
5754b682687425913af5119f27d41fc2f9dd3cfd,1,Aravindan Vijayan,2016-06-08 10:06:45-07:00,['28dc0e163b33de679d00adbb2ca90edc18ac81b5'],33,23,56,23080920,8,0.8,0,0,24844
6576c8460239824e948c099856eaa53007489796,0,Aravindan Vijayan,2016-06-08 10:21:47-07:00,['5754b682687425913af5119f27d41fc2f9dd3cfd'],23,33,56,23080976,8,0.2,1,1,24844
5eabceb825467dffdf36cf7861deb5d5d7db6487,1,Aravindan Vijayan,2016-06-08 10:33:55-07:00,['6576c8460239824e948c099856eaa53007489796'],603,12,615,23081591,14,1,0.925373134,0.298507463,24844
6a4cd477449a1d78c7863ccb6a27dbdbe40fe516,1,oleewere,2016-06-08 19:41:38+02:00,['5eabceb825467dffdf36cf7861deb5d5d7db6487'],101,1,102,23081693,2,,,,24844
1c8bfce485edf41ca04738b9898be469ca7f2fb0,1,oleewere,2016-06-08 19:55:49+02:00,['6a4cd477449a1d78c7863ccb6a27dbdbe40fe516'],2,102,104,23081797,3,,,,24845
e241afcf8697cb5beff243031381cee2b910fc8a,1,Zhe (Joe) Wang,2016-06-08 11:06:23-07:00,['1c8bfce485edf41ca04738b9898be469ca7f2fb0'],18,55,73,23081870,10,0,1,1,24845
56fc6ee143e45e4bd30dd9902f156e825d6fdd81,1,Aleksandr Kovalenko,2016-06-08 21:50:21+03:00,['e241afcf8697cb5beff243031381cee2b910fc8a'],183,91,274,23082144,7,0,0,0.21875,24846
60ad7b270b4ed37ff68513e4609a9467d2c50976,1,Nahappan Somasundaram,2016-06-08 12:21:52-07:00,['56fc6ee143e45e4bd30dd9902f156e825d6fdd81'],30,82,112,23082256,3,0,0.325581395,0.88372093,24846
5d0c42de4444a1a234fc7545d3e0787d8f6b7537,1,Jaimin Jetly,2016-06-08 16:52:42-07:00,['60ad7b270b4ed37ff68513e4609a9467d2c50976'],2,8,10,23082266,1,,,,24846
f9d9ff1b3808710b8a00f1a3b72f75418b2676eb,1,Richard Zang,2016-06-08 17:19:38-07:00,['5d0c42de4444a1a234fc7545d3e0787d8f6b7537'],130,181,311,23082577,3,0.941176471,1,1,24846
47c9b2160b0220bc4a5738d7e9d702189c5d5d2f,1,Vitaly Brodetskyi,2016-06-08 18:22:48+03:00,['f9d9ff1b3808710b8a00f1a3b72f75418b2676eb'],0,12,12,23082589,4,,,,24846
1671d615a7b4a88314bbcbaed860029fc20ffdb2,1,Andrii Tkach,2016-06-09 12:52:16+03:00,['47c9b2160b0220bc4a5738d7e9d702189c5d5d2f'],22,71,93,23082682,5,0.522727273,0.568181818,1,24846
31bc2d52952de42e9e3f7c98596e8750c7554a80,1,Andrew Onishuk,2016-06-09 14:15:48+03:00,['1671d615a7b4a88314bbcbaed860029fc20ffdb2'],11,174,185,23082867,1,0.243902439,0.008130081,0.585365854,24846
e88ca22cfb7f97c36886a925d8197f1fee477070,1,Dipayan Bhowmick,2016-06-09 17:37:07+05:18,['31bc2d52952de42e9e3f7c98596e8750c7554a80'],236,1049,1285,23084152,22,0.580717489,0.919282511,0.834080717,24848
ddb201f8ce8ecdc2a563a5ae69c071655e481b04,1,Dipayan Bhowmick,2016-06-09 17:42:14+05:18,['e88ca22cfb7f97c36886a925d8197f1fee477070'],339,658,997,23085149,10,0.337662338,0.227272727,0.655844156,24850
140c9f13d6b663847473d50ad3b3bed74c3de84f,0,Dipayan Bhowmick,2016-06-09 17:46:01+05:18,['ddb201f8ce8ecdc2a563a5ae69c071655e481b04'],2,1,3,23085152,1,,,,24850
9c6ab0be9f488f0d89d032c23af0138b729994f8,1,Dipayan Bhowmick,2016-06-09 17:50:54+05:18,['140c9f13d6b663847473d50ad3b3bed74c3de84f'],22,98,120,23085272,3,0.463414634,0.43902439,1,24851
f4dae12ebe27035c478f884a4d15012a12c0dd0d,1,Andrii Tkach,2016-06-09 16:50:40+03:00,['9c6ab0be9f488f0d89d032c23af0138b729994f8'],12,5,17,23085289,3,1,0,0,24851
b57a7cfa2ff4d2668dc421826ffaa84e8425d26a,1,Dmytro Sen,2016-06-09 16:52:47+03:00,['f4dae12ebe27035c478f884a4d15012a12c0dd0d'],5,11,16,23085305,6,1,1,0,24851
9699f57d55c3305de2ae01290836caf60c41683e,1,Lisnichenko Dmitro,2016-06-09 17:16:19+03:00,['b57a7cfa2ff4d2668dc421826ffaa84e8425d26a'],50,19,69,23085374,4,0.941176471,0,0,24851
4c5cf30eeea1d456f1cc79d888bc1b369ba5e683,1,Lisnichenko Dmitro,2016-06-09 17:16:29+03:00,['9699f57d55c3305de2ae01290836caf60c41683e'],16416,8250,24666,23110040,583,,,,24851
b599d192c12f9fbc57a686bc46228d1ca3aba506,1,Aleksandr Kovalenko,2016-06-09 17:19:29+03:00,['4c5cf30eeea1d456f1cc79d888bc1b369ba5e683'],4,24,28,23110068,2,1,1,1,24851
6d97cba03238509990e840a2709d985525158ab8,0,Aleksandr Kovalenko,2016-06-09 17:19:29+03:00,['b599d192c12f9fbc57a686bc46228d1ca3aba506'],1,1,2,23110070,1,,,,24851
fa1b536dac9e3c51e56a8b7f0482828cd3de4df9,1,Lisnichenko Dmitro,2016-06-09 17:56:11+03:00,['6d97cba03238509990e840a2709d985525158ab8'],8143,8140,16283,23126353,585,,,,24851
4878a881bb5201a90bff0c2822b9e95afb8626b4,1,Vitaly Brodetskyi,2016-06-09 01:23:55+03:00,['fa1b536dac9e3c51e56a8b7f0482828cd3de4df9'],26,40,66,23126419,10,0,0.296296296,1,24851
4aa1639b4892b0faeedb4b9df4c6c7ac2b20d299,1,Jonathan Hurley,2016-06-09 12:55:01-04:00,['4878a881bb5201a90bff0c2822b9e95afb8626b4'],50,276,326,23126745,5,0,0.648351648,1,24851
95426f795444df20fb4ee9ce087f9191f0a4868e,1,Aravindan Vijayan,2016-06-09 10:09:57-07:00,['4aa1639b4892b0faeedb4b9df4c6c7ac2b20d299'],16,104,120,23126865,2,0.132352941,0.676470588,0.911764706,24851
316a1811fe6b1374f7a7b2aa9d721f2366484b55,1,Aravindan Vijayan,2016-06-09 10:23:13-07:00,['95426f795444df20fb4ee9ce087f9191f0a4868e'],3,19,22,23126887,1,1,1,1,24851
f4fbab1353a739622dd89f6a4275b9dffcad9e9c,1,Jayush Luniya,2016-06-09 10:45:49-07:00,['316a1811fe6b1374f7a7b2aa9d721f2366484b55'],23,21,44,23126931,8,,,,24851
f42b258042dd51b030dcb7d21815234c37da9474,1,tbeerbower,2016-06-09 15:31:04-04:00,['f4fbab1353a739622dd89f6a4275b9dffcad9e9c'],4,93,97,23127028,2,,,,24852
4e2043de5e8f0661d9fda54e5fb16cd62d744cea,1,Richard Zang,2016-06-09 13:15:03-07:00,['f42b258042dd51b030dcb7d21815234c37da9474'],3,7,10,23127038,3,,,,24852
66decdeb25e0ca8666ba85a541c8a85b71fe4147,1,Swapan Shridhar,2016-06-09 14:07:03-07:00,['4e2043de5e8f0661d9fda54e5fb16cd62d744cea'],50,69,119,23127157,5,0,0.0625,0.6875,24852
3303cdce30259bb3b51d1c73c922721cd94308cb,1,Nate Cole,2016-06-09 17:13:43-04:00,['66decdeb25e0ca8666ba85a541c8a85b71fe4147'],16,146,162,23127319,3,0,0.677777778,0.944444444,24852
9b116fb28db774bb30a2d0c8e2f070e3b7c6d55d,0,Alejandro Fernandez,2016-06-09 15:22:20-07:00,['3303cdce30259bb3b51d1c73c922721cd94308cb'],2,2,4,23127323,2,,,,24852
8a4d7c0c8e3b90f83744f57847a85815a245d62e,0,Richard Zang,2016-06-09 16:31:42-07:00,['9b116fb28db774bb30a2d0c8e2f070e3b7c6d55d'],4,4,8,23127331,1,,,,24852
b233c4314f1405118e79fe78c9e15cc36416f57c,1,Nahappan Somasundaram,2016-06-09 17:02:21-07:00,['8a4d7c0c8e3b90f83744f57847a85815a245d62e'],26,27,53,23127384,2,0,1,0.5,24852
d169d8c5cbf3bfbd1ce9a9ab068548a3097974cb,1,Myroslav Papirkovskyi,2016-06-10 09:09:28+03:00,['b233c4314f1405118e79fe78c9e15cc36416f57c'],0,121,121,23127505,2,1,0.72,1,24853
9380b2931c1ecd45e6498c9d5acf2a1f297f8317,1,oleewere,2016-06-10 12:02:26+02:00,['d169d8c5cbf3bfbd1ce9a9ab068548a3097974cb'],17,10,27,23127532,4,0.25,0,0.375,24853
d58382a877ba1b6f5ca210c5cad961cd24586038,0,Andrew Onishuk,2016-06-10 15:17:35+03:00,['9380b2931c1ecd45e6498c9d5acf2a1f297f8317'],3,8,11,23127543,1,,,,24853
807b3b25c3453c445d3b15c0536bdda6e7c9dd2c,0,Pallav Kulshreshtha,2016-06-10 18:01:48+05:18,['d58382a877ba1b6f5ca210c5cad961cd24586038'],22,129,151,23127694,14,1,1,1,24853
adb1ca4509f6fe15ec3f8cbd04842ebb58aca5ff,0,Andrii Tkach,2016-06-10 17:17:55+03:00,['807b3b25c3453c445d3b15c0536bdda6e7c9dd2c'],4,38,42,23127736,3,1,0,0,24854
08f1365a470b1bf508c82fb6ec77641f5bbdcb7e,1,tbeerbower,2016-06-10 10:53:53-04:00,['adb1ca4509f6fe15ec3f8cbd04842ebb58aca5ff'],3,9,12,23127748,2,,,,24854
e9270ab75bc8b514703138b1d2ab70894de1905a,0,Dmytro Sen,2016-06-10 18:36:26+03:00,['08f1365a470b1bf508c82fb6ec77641f5bbdcb7e'],0,1,1,23127749,1,,,,24854
c1789e2553862463d8864912f64afad71f9d792a,0,Aravindan Vijayan,2016-06-10 09:46:30-07:00,['e9270ab75bc8b514703138b1d2ab70894de1905a'],1,9,10,23127759,1,1,1,1,24854
bf07707eac7a84aa7dcf833d94a11b865fb32e6e,1,Nate Cole,2016-06-10 15:15:19-04:00,['c1789e2553862463d8864912f64afad71f9d792a'],22,78,100,23127859,4,0.125,0,0.85,24854
6ddb04ecdf26126b8b85316488116f3f964a5cc8,1,Srimanth Gunturi,2016-06-10 13:20:00-07:00,['bf07707eac7a84aa7dcf833d94a11b865fb32e6e'],12,626,638,23128497,15,0,0.279069767,0.76744186,24859
07f94cb7ac9627cb114e3c41edb524664660ff87,1,Sumit Mohanty,2016-06-10 13:37:09-07:00,['6ddb04ecdf26126b8b85316488116f3f964a5cc8'],129,22,151,23128648,14,0,0,0,24859
e0dd3bf6218fc8c2733e936aa24bfc87fd60739e,0,Bob Nettleton,2016-06-10 17:16:17-04:00,['07f94cb7ac9627cb114e3c41edb524664660ff87'],1,59,60,23128708,2,0,0.780487805,0.780487805,24859
5f16380b60e3db39d20ad4ca924f041330a808b9,1,Srimanth Gunturi,2016-06-10 14:53:09-07:00,['e0dd3bf6218fc8c2733e936aa24bfc87fd60739e'],1,7,8,23128716,1,,,,24859
60a7054dd62764efefde81fc20f1790c443d4c58,0,Srimanth Gunturi,2016-06-10 15:01:11-07:00,['5f16380b60e3db39d20ad4ca924f041330a808b9'],16,81,97,23128813,17,0,0.789473684,0.368421053,24860
38bfa42e027a47a3ecbdb57d0453f8140ef7f92f,1,Alejandro Fernandez,2016-06-10 15:16:31-07:00,['60a7054dd62764efefde81fc20f1790c443d4c58'],18,11,29,23128842,3,1,1,1,24860
a4144d4e8dacb4b4d0ab08d2865a966b87dc25f9,1,Srimanth Gunturi,2016-06-10 15:39:12-07:00,['38bfa42e027a47a3ecbdb57d0453f8140ef7f92f'],0,658,658,23129500,8,0,0.479041916,0.943113772,24862
82abc9ea7886d746e9fea4e5710064e22a1c33cd,0,Jaimin Jetly,2016-06-10 17:29:25-07:00,['a4144d4e8dacb4b4d0ab08d2865a966b87dc25f9'],3,8,11,23129511,1,1,1,1,24862
5adc30d30337cd9be993ccb38fe7bc9a2c63350e,1,Jayush Luniya,2016-06-10 18:49:14-07:00,['82abc9ea7886d746e9fea4e5710064e22a1c33cd'],19,47,66,23129577,1,,,,24862
dc048aaa52cba4333ee0b350a900ba82302dedbc,1,Sumit Mohanty,2016-06-11 09:29:30-07:00,['5adc30d30337cd9be993ccb38fe7bc9a2c63350e'],81,16,97,23129674,17,1,0.210526316,0.631578947,24862
05f1f4aafa2eea4ae10e874df41502046ec6b304,1,oleewere,2016-06-12 14:15:15+02:00,['dc048aaa52cba4333ee0b350a900ba82302dedbc'],159,214,373,23130047,21,0,1,0.8625,24862
81b06bbb28dfc22e51cb521b2438cc690cb58061,0,Myroslav Papirkovskyi,2016-06-13 10:09:22+03:00,['05f1f4aafa2eea4ae10e874df41502046ec6b304'],49,265,314,23130361,51,0.958041958,0.958041958,0.734265734,24862
2ecf374c2526f18d40af5beba70c591840945c05,1,Aleksandr Kovalenko,2016-06-13 12:12:50+03:00,['81b06bbb28dfc22e51cb521b2438cc690cb58061'],6,28,34,23130395,2,1,1,1,24862
21bc7a3cea02fd5fa9af8362fe05ed33e5bdfe7c,1,Lisnichenko Dmitro,2016-06-13 12:31:11+03:00,['2ecf374c2526f18d40af5beba70c591840945c05'],1,30,31,23130426,6,,,,24862
d56f4391e3e5d906364b8a9d25e91f6f2591f543,1,oleewere,2016-06-13 11:53:29+02:00,['21bc7a3cea02fd5fa9af8362fe05ed33e5bdfe7c'],9,19,28,23130454,2,0,0,1,24862
18d24e55e2f9b48a6353113bda1a55cb71295651,0,Andrew Onishuk,2016-06-13 14:55:43+03:00,['d56f4391e3e5d906364b8a9d25e91f6f2591f543'],5,7,12,23130466,1,,,,24862
0821a3111e1e6e524328bb8a9e1c452f6127f00f,1,oleewere,2016-06-13 16:12:02+02:00,['18d24e55e2f9b48a6353113bda1a55cb71295651'],47,55,102,23130568,1,1,1,0,24862
e2dc31a1a4be99f397f05f493d0893b188263a3e,0,Andrii Tkach,2016-06-13 17:31:07+03:00,['0821a3111e1e6e524328bb8a9e1c452f6127f00f'],0,6,6,23130574,1,1,1,1,24862
bd71e62d3d5391e6413916da30fc1c309be3e607,1,oleewere,2016-06-13 16:54:49+02:00,['e2dc31a1a4be99f397f05f493d0893b188263a3e'],12,12,24,23130598,3,,,,24862
b220d26f7c158aa48338018ec281a3dab34929d5,1,Andrew Onishuk,2016-06-13 18:26:51+03:00,['bd71e62d3d5391e6413916da30fc1c309be3e607'],11,42,53,23130651,10,1,0.333333333,0,24862
c8b1c752c601b157af968b6b67d02e26b16af14a,1,oleewere,2016-06-13 17:32:24+02:00,['b220d26f7c158aa48338018ec281a3dab34929d5'],1,1,2,23130653,1,,,,24862
5a36877f996ac84c1b640a528456cff4bb58c38a,1,Swapan Shridhar,2016-06-13 09:23:41-07:00,['c8b1c752c601b157af968b6b67d02e26b16af14a'],179,1090,1269,23131922,8,0,0.901547117,0.900140647,24862
fed0aae1495a7a8a445758ae38ad2c77e3881c2f,0,Andrew Onishuk,2016-06-13 20:44:46+03:00,['5a36877f996ac84c1b640a528456cff4bb58c38a'],3,6,9,23131931,3,,,,24862
3935198af2493e1a00cb5598c2722125cbd146a6,0,Nate Cole,2016-06-13 13:51:59-04:00,['fed0aae1495a7a8a445758ae38ad2c77e3881c2f'],11,9,20,23131951,2,1,1,1,24862
98873150a97bd66a72905ba435f7d2420b2c763a,1,Srimanth Gunturi,2016-06-13 12:46:16-07:00,['3935198af2493e1a00cb5598c2722125cbd146a6'],5,6,11,23131962,2,,,,24862
accc96dba353a84ff4fbf835ae494a625a6541ce,1,Aravindan Vijayan,2016-06-13 13:40:43-07:00,['98873150a97bd66a72905ba435f7d2420b2c763a'],265,49,314,23132276,51,0.041958042,0.041958042,0.265734266,24862
bb87fe175aedb7c8eb6400a15b230abfae55da9d,1,Alejandro Fernandez,2016-06-13 13:49:38-07:00,['accc96dba353a84ff4fbf835ae494a625a6541ce'],0,237,237,23132513,2,,,,24864
8fbfdc218c6c7459174957123aa5f537bae4eb11,1,Zhe (Joe) Wang,2016-06-13 14:11:09-07:00,['bb87fe175aedb7c8eb6400a15b230abfae55da9d'],16,3,19,23132532,3,0,0,0,24864
e0c9dc1f41d47eca52b840456bf1e51763912a44,0,Andrew Onishuk,2016-06-14 01:12:43+03:00,['8fbfdc218c6c7459174957123aa5f537bae4eb11'],2,2,4,23132536,2,,,,24864
99b8be72e273dc4d2ebcb0803b1a25da9e60c8b2,1,Matt,2016-06-13 20:54:43-07:00,['e0c9dc1f41d47eca52b840456bf1e51763912a44'],17,30,47,23132583,6,0.75,1,0.916666667,24864
bc465f1b16b9efd74467eb1e6d17322a84e8f5a5,1,Sumit Mohanty,2016-06-13 21:30:54-07:00,['99b8be72e273dc4d2ebcb0803b1a25da9e60c8b2'],0,3,3,23132586,1,1,1,1,24864
0e426b0d9e2b4034fc1df64fd5c2a1769a235e7d,1,tbeerbower,2016-06-14 04:54:39-04:00,['bc465f1b16b9efd74467eb1e6d17322a84e8f5a5'],20,56,76,23132662,14,0.333333333,0.333333333,0.8,24864
46a87269b5fad7a67e82ec923841c40371fef527,0,Lisnichenko Dmitro,2016-06-14 11:56:04+03:00,['0e426b0d9e2b4034fc1df64fd5c2a1769a235e7d'],1,1,2,23132664,1,,,,24864
0b48b1fe8e8b5b91b8740ebb6c6319181a23313c,1,Lisnichenko Dmitro,2016-06-14 12:09:10+03:00,['46a87269b5fad7a67e82ec923841c40371fef527'],831,648,1479,23134143,98,0.355769231,0.788461538,0.865384615,24865
bfa6af8af52d0ff5d6bf203cc449ff9c74e6da1e,1,Sandor Magyari,2016-06-14 11:21:21+02:00,['0b48b1fe8e8b5b91b8740ebb6c6319181a23313c'],1,59,60,23134203,2,0,1,1,24865
08fcdab6d758c7e0cfebf026f0dab358f580232f,0,Dipayan Bhowmick,2016-06-14 15:10:45+05:18,['bfa6af8af52d0ff5d6bf203cc449ff9c74e6da1e'],8,8,16,23134219,1,,,,24865
7edd41855fe25d98bca90cc7ff2c605cd60039ac,1,Dipayan Bhowmick,2016-06-14 15:32:55+05:18,['08fcdab6d758c7e0cfebf026f0dab358f580232f'],42,110,152,23134371,4,0.2,0.466666667,0.833333333,24865
48205daaa03740744415e6c464cba7e6ec1d5214,0,Dipayan Bhowmick,2016-06-14 15:38:27+05:18,['7edd41855fe25d98bca90cc7ff2c605cd60039ac'],3,4,7,23134378,1,,,,24865
f65fb23b69e8670017a6635c8a54f98cc587f169,1,Dipayan Bhowmick,2016-06-14 15:42:55+05:18,['48205daaa03740744415e6c464cba7e6ec1d5214'],7,18,25,23134403,1,0,0,1,24865
8f52cff955d6f7738d6dc89593459a671b5cc74a,1,Dipayan Bhowmick,2016-06-14 15:49:51+05:18,['f65fb23b69e8670017a6635c8a54f98cc587f169'],2,5,7,23134410,2,0.5,1,1,24865
8029f0572eb8920cae433f10a6f604422a52b378,1,oleewere,2016-06-14 12:39:13+02:00,['8f52cff955d6f7738d6dc89593459a671b5cc74a'],405,453,858,23135268,1,,,,24865
a4a208a8cef230b07b8bc6908c33a0a19935138f,1,Aleksandr Kovalenko,2016-06-14 13:47:26+03:00,['8029f0572eb8920cae433f10a6f604422a52b378'],7,36,43,23135311,5,0,0.157894737,1,24865
c22a9ca5f0814d5ac31f7ca50b4550a2679c4cc3,0,Andrew Onishuk,2016-06-14 14:04:00+03:00,['a4a208a8cef230b07b8bc6908c33a0a19935138f'],3,5,8,23135319,1,1,1,1,24865
7c404df3f4dc540a56ea9fb094b96c86a1f1aef3,0,Dipayan Bhowmick,2016-06-14 16:47:41+05:18,['c22a9ca5f0814d5ac31f7ca50b4550a2679c4cc3'],1,1,2,23135321,1,,,,24865
96297658593f6dd283239198cfa0ef4c2f0f6dc5,1,oleewere,2016-06-14 14:12:09+02:00,['7c404df3f4dc540a56ea9fb094b96c86a1f1aef3'],89,199,288,23135609,18,0.068181818,0.045454545,0.454545455,24865
a44ca77356c19f37ceac27ae119cc1719973bdd3,1,Robert Levas,2016-06-14 08:23:33-04:00,['96297658593f6dd283239198cfa0ef4c2f0f6dc5'],122,251,373,23135982,15,0.622222222,0.6,0.155555556,24865
fc5870779dc13e4fd24c616ef8549149edf77358,1,Vitaly Brodetskyi,2016-06-13 23:32:53+03:00,['a44ca77356c19f37ceac27ae119cc1719973bdd3'],22,145,167,23136149,6,0,0.724137931,1,24865
e2d564cda15e1985fe50f58ea9ef5219c187edb6,0,Andrii Tkach,2016-06-14 16:46:35+03:00,['fc5870779dc13e4fd24c616ef8549149edf77358'],13,15,28,23136177,1,1,1,1,24865
03260b60a9ea8ada5d4a2ebf826208ea47edcbae,1,Aleksandr Kovalenko,2016-06-14 16:53:15+03:00,['e2d564cda15e1985fe50f58ea9ef5219c187edb6'],6,268,274,23136451,2,0.138655462,1,0.991596639,24866
ceb2a24c69a6a09abddfa51dbce06d6e1ded71d4,1,Zhe (Joe) Wang,2016-06-14 10:13:46-07:00,['03260b60a9ea8ada5d4a2ebf826208ea47edcbae'],165,201,366,23136817,4,0,0.75,1,24866
2555de727e7b69f76b319bb5ed45b306fed91b28,0,tbeerbower,2016-06-14 18:10:26-04:00,['ceb2a24c69a6a09abddfa51dbce06d6e1ded71d4'],2,2,4,23136821,1,,,,24866
dbf3c65c6a53fb7ad27b17de4ef94994e16f897b,0,Richard Zang,2016-06-14 15:54:02-07:00,['2555de727e7b69f76b319bb5ed45b306fed91b28'],6,15,21,23136842,2,0,0,1,24866
b13eca9a5405867045d91d34f661883fb50910f9,1,Swapan Shridhar,2016-06-14 16:05:01-07:00,['dbf3c65c6a53fb7ad27b17de4ef94994e16f897b'],2,32,34,23136876,2,,,,24866
b5f5ce510a86dc9bacba9700b3719d3b840f2c22,1,tbeerbower,2016-06-14 21:20:40-04:00,['b13eca9a5405867045d91d34f661883fb50910f9'],0,9,9,23136885,1,,,,24866
27bb5f2f31f83c678935bbaa0521d5b13fe93be8,1,Jayush Luniya,2016-06-14 21:26:00-07:00,['b5f5ce510a86dc9bacba9700b3719d3b840f2c22'],12,75,87,23136972,3,0.295454545,1,0.818181818,24866
c15a281e01af5dda2e7551dae29bc60a53ca11a7,1,Aravindan Vijayan,2016-06-14 21:58:29-07:00,['27bb5f2f31f83c678935bbaa0521d5b13fe93be8'],23,91,114,23137086,2,0,0.283018868,0.283018868,24866
ead2d1f6c2273f6748e413d560a63db1096d17b9,0,Aravindan Vijayan,2016-06-14 22:46:24-07:00,['c15a281e01af5dda2e7551dae29bc60a53ca11a7'],0,3,3,23137089,1,,,,24866
f7dc498470d0ff35f14957805e91206793e5a021,1,Dipayan Bhowmick,2016-06-15 11:23:05+05:18,['ead2d1f6c2273f6748e413d560a63db1096d17b9'],1585,1064,2649,23139738,43,1,0.4125,0,24871
1c7cbcdd54342ecc88a825e0eec70d50e88e4781,1,Gautam Borad,2016-06-15 11:55:45+05:18,['f7dc498470d0ff35f14957805e91206793e5a021'],18,116,134,23139872,20,0,0.85,0.675,24872
7fc33c1427d4ed35441627e78419b079513983ea,1,ababiichuk,2016-06-15 10:54:16+03:00,['1c7cbcdd54342ecc88a825e0eec70d50e88e4781'],1,4,5,23139877,1,1,1,1,24872
4edadd787f0c2eea9ea9f4553e87d7908a93343c,1,Vitaly Brodetskyi,2016-06-14 19:24:46+03:00,['7fc33c1427d4ed35441627e78419b079513983ea'],1,14,15,23139892,2,,,,24872
2de48e49ff4c4e33150b98cfb103828c8ae913f1,1,Lisnichenko Dmitro,2016-06-15 12:44:33+03:00,['4edadd787f0c2eea9ea9f4553e87d7908a93343c'],4,106,110,23140002,3,0.123076923,0.584615385,0.415384615,24872
f071fcca82d83b6b5f7276dbeed5637d39aca987,1,Aleksandr Kovalenko,2016-06-15 12:45:41+03:00,['2de48e49ff4c4e33150b98cfb103828c8ae913f1'],1,1,2,23140004,1,,,,24872
afb4b6dc942b8ffcf174c5a1f201e57d9e13a330,0,Andrew Onishuk,2016-06-15 13:44:42+03:00,['f071fcca82d83b6b5f7276dbeed5637d39aca987'],0,1,1,23140005,1,1,1,1,24872
4fe413e95063405b5d40a010b83b7559dc4eb0f1,1,"Toader, Sebastian",2016-06-15 14:16:10+02:00,['afb4b6dc942b8ffcf174c5a1f201e57d9e13a330'],35,77,112,23140117,2,0.379310345,1,1,24872
93a8c02fa8380217b3071dc368504def971fe850,0,Andrew Onishuk,2016-06-15 15:48:42+03:00,['4fe413e95063405b5d40a010b83b7559dc4eb0f1'],150,82,232,23140349,8,1,0.076923077,0,24872
cd47a9697e170b8919bb36a0cca4401158b1b1c5,0,Dipayan Bhowmick,2016-06-15 18:22:37+05:18,['93a8c02fa8380217b3071dc368504def971fe850'],38,7,45,23140394,5,0.25,0,0.75,24872
2bb19e9fa8d8138d532b1be668c9c902262bfc4e,0,Dipayan Bhowmick,2016-06-15 18:27:43+05:18,['cd47a9697e170b8919bb36a0cca4401158b1b1c5'],1,1,2,23140396,1,,,,24872
91be58862583047d74604f440d85a9fe64914169,1,Robert Levas,2016-06-15 09:10:19-04:00,['2bb19e9fa8d8138d532b1be668c9c902262bfc4e'],62,265,327,23140723,14,0.297029703,0.900990099,0.871287129,24872
b18ce3aefebdc96cbdd6e09270a75a7c2b54497a,1,Dipayan Bhowmick,2016-06-15 18:32:31+05:18,['91be58862583047d74604f440d85a9fe64914169'],67,42,109,23140832,6,0,1,1,24872
fd83a142e374f155f148db0947b245edfaeb0568,1,Jonathan Hurley,2016-06-15 10:20:07-04:00,['b18ce3aefebdc96cbdd6e09270a75a7c2b54497a'],52,78,130,23140962,3,0.2,1,1,24872
67ed487625307eac07cab9277cc3f86d2eef973b,1,Andrew Onishuk,2016-06-15 17:30:30+03:00,['fd83a142e374f155f148db0947b245edfaeb0568'],3,10,13,23140975,1,0,0,1,24872
757addd2bc1fa92ab8ccd33de57757d1a69ac642,0,Di Li,2016-06-15 10:41:43-04:00,['67ed487625307eac07cab9277cc3f86d2eef973b'],7,37,44,23141019,2,,,,24872
b03e8d8e7e178f1e03ccb21ba794fdb3f05db2d1,1,Gautam Borad,2016-06-15 21:04:41+05:18,['757addd2bc1fa92ab8ccd33de57757d1a69ac642'],1,195,196,23141215,8,0.580645161,1,1,24874
010d600d5cdd7e409fd62466498b35d6c33b811e,1,Gautam Borad,2016-06-15 21:14:53+05:18,['b03e8d8e7e178f1e03ccb21ba794fdb3f05db2d1'],1,6,7,23141222,1,,,,24874
ab23e0713b2573c6d231a08f1d5d466065c3f385,1,Jayush Luniya,2016-06-15 09:36:24-07:00,['010d600d5cdd7e409fd62466498b35d6c33b811e'],1,1,2,23141224,1,,,,24874
b9e51f564106d8b1f4f6bcf702099aaa2c2dc4ce,0,Jayush Luniya,2016-06-15 09:41:40-07:00,['ab23e0713b2573c6d231a08f1d5d466065c3f385'],2,2,4,23141228,1,,,,24874
1436c97741e10807da93b6f5b099d24a70ba9603,0,oleewere,2016-06-15 19:40:27+02:00,['b9e51f564106d8b1f4f6bcf702099aaa2c2dc4ce'],4,10,14,23141242,2,0,0,1,24874
be76a29e1054aca4e77e37ab31c5e18402633641,0,oleewere,2016-06-15 19:44:52+02:00,['1436c97741e10807da93b6f5b099d24a70ba9603'],10,4,14,23141256,2,1,1,0,24874
04511ceaebcac02f357c346e3242602e63b23526,1,oleewere,2016-06-15 19:49:49+02:00,['be76a29e1054aca4e77e37ab31c5e18402633641'],4,10,14,23141270,2,0,0,1,24874
2ab6d06326ed28ffb39cf0ab05f4154f763fc59c,1,oleewere,2016-06-15 19:57:33+02:00,['04511ceaebcac02f357c346e3242602e63b23526'],0,40,40,23141310,2,1,1,1,24875
f8d07ffac4590fc87b53d3cdc24d2608552ef8c4,0,Aravindan Vijayan,2016-06-15 12:07:00-07:00,['2ab6d06326ed28ffb39cf0ab05f4154f763fc59c'],3,0,3,23141313,1,,,,24875
de9a986bfbe8a0116ee32813a6843e2a7403268f,1,Swapan Shridhar,2016-06-15 12:26:20-07:00,['f8d07ffac4590fc87b53d3cdc24d2608552ef8c4'],8,22,30,23141343,5,0.125,0.25,0.25,24875
84d816b5773cc5ebd96cdb2bba58a97139bd31fd,1,Srimanth Gunturi,2016-06-15 12:40:00-07:00,['de9a986bfbe8a0116ee32813a6843e2a7403268f'],0,213,213,23141556,5,0,1,1,24880
515e1e99212b4c4473ba9ccca6ca34bad6d54e4c,1,Jayush Luniya,2016-06-15 12:52:42-07:00,['84d816b5773cc5ebd96cdb2bba58a97139bd31fd'],1,230,231,23141787,14,0,0.647887324,0.964788732,24881
1c8b3dec30e5058ae9bebf4947b37c555920035b,1,Jayush Luniya,2016-06-15 12:55:46-07:00,['515e1e99212b4c4473ba9ccca6ca34bad6d54e4c'],9,14,23,23141810,1,0,0,0,24881
ab4a5e2abaeac625d093cc39db5aa32b528fef38,0,Yusaku Sako,2016-06-15 13:09:34-07:00,['1c8b3dec30e5058ae9bebf4947b37c555920035b'],2,2,4,23141814,1,,,,24881
1468737b8980046a9e314cd1c65f010f50e0c8b6,1,Yusaku Sako,2016-06-15 13:11:50-07:00,['ab4a5e2abaeac625d093cc39db5aa32b528fef38'],0,940,940,23142754,1,,,,24882
9870d74fb8e8e16d9118d063fb04ae87a8d6de7d,1,Di Li,2016-06-15 17:13:44-04:00,['1468737b8980046a9e314cd1c65f010f50e0c8b6'],37,7,44,23142798,2,,,,24882
c9d2f30c653ee889f84eb5b6ffb13008a5b4f2bf,0,Ajit Kumar,2016-06-15 14:47:03-07:00,['9870d74fb8e8e16d9118d063fb04ae87a8d6de7d'],8,1,9,23142807,1,1,1,0,24882
db80f976dbe3dd105ac037fa5a33e92496e29586,1,Di Li,2016-06-15 18:06:22-04:00,['c9d2f30c653ee889f84eb5b6ffb13008a5b4f2bf'],18,47,65,23142872,3,1,0,0,24882
bc0be1443daaf7966174ba7daf0c2d07db8414be,1,Aravindan Vijayan,2016-06-15 15:15:02-07:00,['db80f976dbe3dd105ac037fa5a33e92496e29586'],24,5,29,23142901,2,,,,24882
714b9a5a17967935866aa8cfdbaead5d69da629c,1,Srimanth Gunturi,2016-06-15 15:30:58-07:00,['bc0be1443daaf7966174ba7daf0c2d07db8414be'],1,26,27,23142928,2,0,0,0,24882
d734489d56e08ce744c774a421f8ab2f2b18aee0,0,Yusaku Sako,2016-06-15 15:55:33-07:00,['714b9a5a17967935866aa8cfdbaead5d69da629c'],3,3,6,23142934,1,,,,24882
ccffce1ca6f9dd26b044c649fa356a2d660554ec,0,Ajit Kumar,2016-06-15 19:16:06-07:00,['d734489d56e08ce744c774a421f8ab2f2b18aee0'],1,1,2,23142936,1,,,,24882
bae4253444953960c7f2c99f49f6736389921569,1,Myroslav Papirkovskyi,2016-06-16 10:17:30+03:00,['ccffce1ca6f9dd26b044c649fa356a2d660554ec'],16,22,38,23142974,9,,,,24882
a301994f5a3015411ff27b12e12369820e551321,1,Andrii Tkach,2016-06-16 10:39:19+03:00,['bae4253444953960c7f2c99f49f6736389921569'],55,87,142,23143116,5,1,1,1,24882
5f1c6a58dc054d39f418f58c3b278abe20ef7c9e,1,ababiichuk,2016-06-16 12:08:27+03:00,['a301994f5a3015411ff27b12e12369820e551321'],1,7,8,23143124,3,1,1,1,24882
62010bcf687f61e61bf84068e127535d353402cf,0,Sandor Magyari,2016-06-16 11:47:32+02:00,['5f1c6a58dc054d39f418f58c3b278abe20ef7c9e'],18,494,512,23143636,6,0.136585366,0.946341463,0.965853659,24883
9973fc0d29b7cd017221104be3af504e4b938f0b,1,Lisnichenko Dmitro,2016-06-16 13:04:37+03:00,['62010bcf687f61e61bf84068e127535d353402cf'],18,15,33,23143669,2,1,1,0,24883
a644d11070160c98ce15e227c2d4e065505b8ebf,1,Aleksandr Kovalenko,2016-06-16 13:37:43+03:00,['9973fc0d29b7cd017221104be3af504e4b938f0b'],118,127,245,23143914,14,1,1,1,24883
c5d00cdaa3287768280d44a9d0bdf476473c9a31,1,Dipayan Bhowmick,2016-06-16 16:38:43+05:18,['a644d11070160c98ce15e227c2d4e065505b8ebf'],38,201,239,23144153,20,1,1,1,24883
adacd73155a8cea1e861d52e718b35b15dd66e5c,1,Sandor Magyari,2016-06-16 14:09:10+02:00,['c5d00cdaa3287768280d44a9d0bdf476473c9a31'],46,122,168,23144321,2,0,0.833333333,1,24883
cfcedaf3fac7a7cd7f20c01651ceedd4cc7cc72c,1,Sandor Magyari,2016-06-16 14:30:01+02:00,['adacd73155a8cea1e861d52e718b35b15dd66e5c'],0,8,8,23144329,1,0,1,1,24883
0fd22d8b1ebe9e9a7af27818bc9672cb32791cf9,0,Sandor Magyari,2016-06-16 14:40:15+02:00,['cfcedaf3fac7a7cd7f20c01651ceedd4cc7cc72c'],494,18,512,23144841,6,0.863414634,0.053658537,0.034146341,24883
1f71ea63af88f5c0b88869346928ffbd5440d44d,1,Sandor Magyari,2016-06-16 14:47:01+02:00,['0fd22d8b1ebe9e9a7af27818bc9672cb32791cf9'],24,496,520,23145361,5,0.13592233,0.941747573,0.961165049,24884
6bdc2b2476e46ee447fbdc360f8f873ab7a17973,0,Vitaly Brodetskyi,2016-06-16 00:04:09+03:00,['1f71ea63af88f5c0b88869346928ffbd5440d44d'],4,28,32,23145393,4,0,0,0.652173913,24884
870de578b81f22ca720518a70005541b1527a55d,1,Vitaly Brodetskyi,2016-06-16 00:13:17+03:00,['6bdc2b2476e46ee447fbdc360f8f873ab7a17973'],28,4,32,23145425,4,1,1,0.347826087,24884
c1156d22b6481c8df54fddbb36c33fcffb2be743,1,Andrii Tkach,2016-06-16 17:33:33+03:00,['870de578b81f22ca720518a70005541b1527a55d'],4,3,7,23145432,1,,,,24884
f674a56783708d09704863b3f18507037b1f02d2,1,Dmytro Sen,2016-06-16 17:40:11+03:00,['c1156d22b6481c8df54fddbb36c33fcffb2be743'],1,330,331,23145763,10,0.430555556,0.868055556,0.791666667,24890
eec84460f391ece3d9018ecf552ef66b6b270159,1,tbeerbower,2016-06-16 14:07:14-04:00,['f674a56783708d09704863b3f18507037b1f02d2'],45,24,69,23145832,4,1,0.935483871,0.935483871,24890
6950a8a942e47892bcf094df08d0f8d5aab9ae2b,1,tbeerbower,2016-06-16 14:21:55-04:00,['eec84460f391ece3d9018ecf552ef66b6b270159'],1,1,2,23145834,1,,,,24890
d4ded26d5a55ce36db281b2b32e831b936aefea0,1,Yusaku Sako,2016-06-16 12:56:15-07:00,['6950a8a942e47892bcf094df08d0f8d5aab9ae2b'],14,15,29,23145863,1,0,0.2,1,24890
fcb7e7d134fccfce693c51d629df760b14034fa1,0,Richard Zang,2016-06-16 13:29:50-07:00,['d4ded26d5a55ce36db281b2b32e831b936aefea0'],1,3,4,23145867,1,1,1,1,24890
a94ebcfb64c27fa668aa5527090cf9b0f35537e1,1,Nate Cole,2016-06-16 16:33:02-04:00,['fcb7e7d134fccfce693c51d629df760b14034fa1'],2,21,23,23145890,2,0,0.25,0.75,24890
89870f28a204b782f5d25eb09e6e3c5bfa496acc,1,Robert Levas,2016-06-16 17:36:48-04:00,['a94ebcfb64c27fa668aa5527090cf9b0f35537e1'],1,156,157,23146047,4,0,0.53125,1,24890
47b8173aeb913ebaa2459f1b28187b7ba7e88576,0,Yusaku Sako,2016-06-16 15:38:16-07:00,['89870f28a204b782f5d25eb09e6e3c5bfa496acc'],1,1,2,23146049,1,,,,24890
14df3d2bdcd71aba158ef5fa6753eabd679e77bf,0,Jaimin Jetly,2016-06-16 17:47:43-07:00,['47b8173aeb913ebaa2459f1b28187b7ba7e88576'],0,13,13,23146062,1,1,1,1,24890
5e50c84cc4fed6b594967fe573210a2f0d3f99fa,0,Zhe (Joe) Wang,2016-06-16 18:42:04-07:00,['14df3d2bdcd71aba158ef5fa6753eabd679e77bf'],3,0,3,23146065,1,,,,24890
511f9ccee06455b390912f1d669c2026d14b768d,1,Dipayan Bhowmick,2016-06-17 07:45:38+05:18,['5e50c84cc4fed6b594967fe573210a2f0d3f99fa'],60,58,118,23146183,8,0,1,1,24890
dbf0b16578637b9aa25756e46865c8861f6b41eb,1,Dipayan Bhowmick,2016-06-17 07:46:28+05:18,['511f9ccee06455b390912f1d669c2026d14b768d'],3,9,12,23146195,1,0,1,1,24890
aaa435c361741ac5e1ea20fc533641bde79b95f0,1,Dipayan Bhowmick,2016-06-17 07:54:09+05:18,['dbf0b16578637b9aa25756e46865c8861f6b41eb'],2,12,14,23146209,2,1,1,1,24890
75d44052aafd9ae913ac1f02f55a215bdb8709e5,0,Dipayan Bhowmick,2016-06-17 07:56:13+05:18,['aaa435c361741ac5e1ea20fc533641bde79b95f0'],47,63,110,23146319,5,0.25,1,1,24890
fac89e7400e2dc0a0673ffd4a86b413f99857b18,1,Jonathan Hurley,2016-06-16 23:15:39-04:00,['75d44052aafd9ae913ac1f02f55a215bdb8709e5'],176,174,350,23146669,10,,,,24890
d35eb2041ac99184b55dbbd33d6e4a0ca9b8c750,0,Bhuvnesh Chaudhary,2016-06-16 21:52:08-07:00,['fac89e7400e2dc0a0673ffd4a86b413f99857b18'],1,1,2,23146671,1,,,,24890
438a3cec25798a4e0565fe7914a440c306362ec6,1,"Toader, Sebastian",2016-06-17 07:01:38+02:00,['d35eb2041ac99184b55dbbd33d6e4a0ca9b8c750'],9,344,353,23147024,7,0.315,0.86,1,24891
979e17ddfaf6622e6540648b76ee31c0a1a70536,1,Swapan Shridhar,2016-06-17 01:26:44-07:00,['438a3cec25798a4e0565fe7914a440c306362ec6'],46,311,357,23147381,5,0,0.653846154,0.653846154,24891
f936de2f0b099f4a5a0514d94f401dc0c0d463bf,1,Dmytro Sen,2016-06-17 11:27:25+03:00,['979e17ddfaf6622e6540648b76ee31c0a1a70536'],36,74,110,23147491,4,0.033333333,0.866666667,0,24891
fc52d7158fc44651d8f00d64c351f2602cc6dbf2,1,Dipayan Bhowmick,2016-06-17 15:11:43+05:18,['f936de2f0b099f4a5a0514d94f401dc0c0d463bf'],1,1,2,23147493,1,,,,24891
c7cbaf22eae31c8dc1300bdcdfc09e6ede8f7ab1,1,Dipayan Bhowmick,2016-06-17 15:18:40+05:18,['fc52d7158fc44651d8f00d64c351f2602cc6dbf2'],11,56,67,23147560,6,0,0.705882353,1,24892
978cc64e237c48e7d6bb8eac012c9fe33c93805e,1,Dipayan Bhowmick,2016-06-17 15:21:51+05:18,['c7cbaf22eae31c8dc1300bdcdfc09e6ede8f7ab1'],1,14,15,23147575,2,0.7,0.7,1,24892
b6cb758b54c00986cd58d8e39ca594ab737c6fc1,1,Aleksandr Kovalenko,2016-06-17 13:35:35+03:00,['978cc64e237c48e7d6bb8eac012c9fe33c93805e'],111,49,160,23147735,4,0.507692308,0,0.276923077,24892
a6e2d9203092ef36d141c781938b086518db8385,1,Jayush Luniya,2016-06-17 07:48:09-07:00,['b6cb758b54c00986cd58d8e39ca594ab737c6fc1'],680,63,743,23148478,6,1,0,1,24892
5bd5e2da8b62a83c1275e0b7e484edd78577a34e,1,oleewere,2016-06-17 16:51:13+02:00,['a6e2d9203092ef36d141c781938b086518db8385'],13,20,33,23148511,1,0,0,1,24892
797a759a52f3da9838b1ee1bba5bf174c5aa0e63,1,oleewere,2016-06-17 17:05:54+02:00,['5bd5e2da8b62a83c1275e0b7e484edd78577a34e'],1,4,5,23148516,1,,,,24892
6708cf0b16502c87b691b9b2716bc524a9b20baf,0,Lisnichenko Dmitro,2016-06-17 18:53:32+03:00,['797a759a52f3da9838b1ee1bba5bf174c5aa0e63'],0,1,1,23148517,1,,,,24892
da8195fb839a3ba4090301551c15067cb50a9635,1,Dmytro Sen,2016-06-17 19:42:37+03:00,['6708cf0b16502c87b691b9b2716bc524a9b20baf'],0,6,6,23148523,1,,,,24892
ae9f76f1319300ec7486198f47f5dbeffba980c8,1,Aleksandr Kovalenko,2016-06-17 20:15:14+03:00,['da8195fb839a3ba4090301551c15067cb50a9635'],1,81,82,23148605,2,0.380952381,1,1,24892
35aee3cdcb6786f8a7b147f651fa7240e0934b8b,1,Aleksandr Kovalenko,2016-06-17 20:15:14+03:00,['ae9f76f1319300ec7486198f47f5dbeffba980c8'],31,59,90,23148695,18,0.933333333,1,0.933333333,24892
760ea9d3a4c2092c4099f26fcf65dc303b86ac01,1,Aleksandr Kovalenko,2016-06-17 20:15:14+03:00,['35aee3cdcb6786f8a7b147f651fa7240e0934b8b'],14,150,164,23148859,5,0.8,1,0.957894737,24892
e0fd753f3404ebb5b03da95b7f06e5f7ed3ada0a,1,Aravindan Vijayan,2016-06-17 13:46:47-07:00,['760ea9d3a4c2092c4099f26fcf65dc303b86ac01'],63,47,110,23148969,5,0.75,0,0,24893
54d76f5b8fe9d1b6fbcbab1732267b7e13413118,0,Zhe (Joe) Wang,2016-06-17 14:23:09-07:00,['e0fd753f3404ebb5b03da95b7f06e5f7ed3ada0a'],5,146,151,23149120,5,0,0.957446809,0.609929078,24893
92237462de2e5f4177113a07129b10834a9c5ca0,1,Alejandro Fernandez,2016-06-17 15:20:32-07:00,['54d76f5b8fe9d1b6fbcbab1732267b7e13413118'],9,708,717,23149837,9,0,1,1,24894
e960eb6b6c29b8697851d00c31b97415bb69730d,0,Yusaku Sako,2016-06-17 17:04:55-07:00,['92237462de2e5f4177113a07129b10834a9c5ca0'],2,698,700,23150537,8,,,,24894
4de9961707a2b977cecbd84e5f65570c16c71b52,1,Richard Zang,2016-06-17 17:16:30-07:00,['e960eb6b6c29b8697851d00c31b97415bb69730d'],5,1,6,23150543,2,,,,24894
3d13eb4f2344174e615fe1fa4f3a1f4adedbddaa,0,Aravindan Vijayan,2016-06-17 17:28:51-07:00,['4de9961707a2b977cecbd84e5f65570c16c71b52'],0,5,5,23150548,1,,,,24894
5cc4448dda5f13682e08ee136c363500938950ac,0,Swapan Shridhar,2016-06-19 23:15:56-07:00,['3d13eb4f2344174e615fe1fa4f3a1f4adedbddaa'],8,452,460,23151008,8,0.404411765,0.602941176,0.904411765,24899
33725d7eb2e9ae5acde94f01fcc21377f57ffa21,1,Dipayan Bhowmick,2016-06-20 11:42:04+05:18,['5cc4448dda5f13682e08ee136c363500938950ac'],53,162,215,23151223,13,0.928571429,0.928571429,0.714285714,24901
5dc6f640f87c98bef9db71caac61f7da038f9cff,1,Sandor Magyari,2016-06-20 11:42:11+02:00,['33725d7eb2e9ae5acde94f01fcc21377f57ffa21'],9,17,26,23151249,5,0.25,1,0.75,24901
8a4d959409d235ce2280ca84b3136fd3680c1bfd,1,Dipayan Bhowmick,2016-06-20 16:51:07+05:18,['5dc6f640f87c98bef9db71caac61f7da038f9cff'],7,38,45,23151294,5,0.75,1,0.25,24901
ac8adabb3d0f3b1663fd1d1491d609172f41549a,0,Dipayan Bhowmick,2016-06-20 16:54:08+05:18,['8a4d959409d235ce2280ca84b3136fd3680c1bfd'],20,11,31,23151325,4,0.25,0,0.75,24901
317f5c0be2d0f64ebc398d6b14ad8bf8a35e7c11,1,oleewere,2016-06-20 14:50:19+02:00,['ac8adabb3d0f3b1663fd1d1491d609172f41549a'],146,5,151,23151476,5,1,0.042553191,0.390070922,24901
2d772400aafc8f62dd798fb0eebe4f8897d9e12d,1,oleewere,2016-06-20 15:21:21+02:00,['317f5c0be2d0f64ebc398d6b14ad8bf8a35e7c11'],34,46,80,23151556,11,1,1,1,24901
c7489eaf0547f1b2d366f6d1afbfbdef1629403d,1,oleewere,2016-06-20 16:16:11+02:00,['2d772400aafc8f62dd798fb0eebe4f8897d9e12d'],452,8,460,23152016,8,0.595588235,0.397058824,0.095588235,24901
fdb558887ca46ffe212a203c6e9ee010dca21790,0,oleewere,2016-06-20 17:28:00+02:00,['c7489eaf0547f1b2d366f6d1afbfbdef1629403d'],1,53,54,23152070,4,1,1,1,24902
daa87ea4dc09af7182f50321a0bbe025d1a65dbb,0,Zhe (Joe) Wang,2016-06-20 08:33:59-07:00,['fdb558887ca46ffe212a203c6e9ee010dca21790'],3,144,147,23152217,4,0,0.957446809,0.609929078,24902
9825bc2140948ace88fa06a1b03bbab9f20f2a4d,1,oleewere,2016-06-20 18:15:31+02:00,['daa87ea4dc09af7182f50321a0bbe025d1a65dbb'],1,4,5,23152222,1,0,0,1,24902
450eb3e4fb9af66eb09def974e9ba7d6e7a9ccc8,1,oleewere,2016-06-20 18:31:24+02:00,['9825bc2140948ace88fa06a1b03bbab9f20f2a4d'],77,1697,1774,23153996,25,0.274944568,0.368070953,0.84368071,24912
dddad6101bea80a3347b72a3f2a3f5c35dff7645,0,Dipayan Bhowmick,2016-06-21 00:07:28+05:18,['450eb3e4fb9af66eb09def974e9ba7d6e7a9ccc8'],1,1,2,23153998,1,,,,24912
5b1f361c45980951868716d2aefbac42b525f197,1,Yusaku Sako,2016-06-20 12:08:18-07:00,['dddad6101bea80a3347b72a3f2a3f5c35dff7645'],6,6,12,23154010,1,1,1,1,24912
0868ef98bd0b5d6ecb8739dbf55eece5797ba59b,1,Zhe (Joe) Wang,2016-06-20 13:02:55-07:00,['5b1f361c45980951868716d2aefbac42b525f197'],8,10,18,23154028,2,,,,24912
57e3fea6ee05c0a59d8dded3df7fcfcf0419359f,0,Jayush Luniya,2016-06-20 13:43:01-07:00,['0868ef98bd0b5d6ecb8739dbf55eece5797ba59b'],0,6,6,23154034,1,,,,24912
31dfc5601ea3ca071fe44ba9b517df6f13bc85a0,1,Dipayan Bhowmick,2016-06-21 02:14:52+05:18,['57e3fea6ee05c0a59d8dded3df7fcfcf0419359f'],3,10,13,23154047,2,0.5,1,1,24912
300a7e21d109ef731af65dc8652e057065081bb2,1,Alejandro Fernandez,2016-06-20 14:36:26-07:00,['31dfc5601ea3ca071fe44ba9b517df6f13bc85a0'],203,7755,7958,23162005,102,0.570337079,0.691235955,0.798651685,24967
344542082b277ac5277cbad9ebee1b4cb0fbdd65,1,Jayush Luniya,2016-06-20 14:41:42-07:00,['300a7e21d109ef731af65dc8652e057065081bb2'],53,1,54,23162059,4,0,0,0,24967
1f2b64979e2a033a092e00cb5a22ba7b50ea08e9,1,oleewere,2016-06-21 01:22:46+02:00,['344542082b277ac5277cbad9ebee1b4cb0fbdd65'],1,57,58,23162117,5,1,1,1,24968
4ea41235353cbece75d9cbd6613ef6645d6bca3f,1,Swapan Shridhar,2016-06-20 17:37:06-07:00,['1f2b64979e2a033a092e00cb5a22ba7b50ea08e9'],12,455,467,23162584,11,0.404411765,0.602941176,0.904411765,24973
4c0779c8b548932dd6d96a0d2127d60c633c6b9b,0,Andrew Onishuk,2016-06-21 12:39:41+03:00,['4ea41235353cbece75d9cbd6613ef6645d6bca3f'],4,42,46,23162630,3,0.333333333,0.333333333,0.333333333,24973
876b53c63ec99850f7b484b4a72c139cbe443f0a,0,Andrew Onishuk,2016-06-21 12:58:52+03:00,['4c0779c8b548932dd6d96a0d2127d60c633c6b9b'],2,2,4,23162634,1,,,,24973
bd4d3b6ebc8c61e2bd4f3971512b0a64b0765aef,1,Vitaly Brodetskyi,2016-06-20 19:53:51+03:00,['876b53c63ec99850f7b484b4a72c139cbe443f0a'],6,77,83,23162717,3,0,1,1,24973
ff0325146bd4d45d6de25362ee580f564bfaa58e,0,Dmytro Sen,2016-06-21 13:05:14+03:00,['bd4d3b6ebc8c61e2bd4f3971512b0a64b0765aef'],0,29,29,23162746,2,,,,24973
6c2a175198af7f8d25e695e9d036fde88549ee43,1,Andrew Onishuk,2016-06-21 13:22:37+03:00,['ff0325146bd4d45d6de25362ee580f564bfaa58e'],3,6,9,23162755,5,,,,24973
cc0478f2b3bd0724afbabe0c139af8663e9a00d6,1,Lisnichenko Dmitro,2016-06-21 13:59:38+03:00,['6c2a175198af7f8d25e695e9d036fde88549ee43'],0,17,17,23162772,2,0,0.545454545,1,24973
c521847949aa5296dc5c18b52b99d02f1ab93297,1,Jonathan Hurley,2016-06-21 08:41:04-04:00,['cc0478f2b3bd0724afbabe0c139af8663e9a00d6'],171,375,546,23163318,13,0.404255319,0.893617021,0.893617021,24975
c7df1b5bb6daa7c023fc54a6f90ddd57b899c7ba,1,oleewere,2016-06-21 14:44:06+02:00,['c521847949aa5296dc5c18b52b99d02f1ab93297'],27,504,531,23163849,35,0.530864198,0,0.864197531,24978
ce695e8b059a90b1735524276c4218ffdc75f422,1,oleewere,2016-06-21 15:12:44+02:00,['c7df1b5bb6daa7c023fc54a6f90ddd57b899c7ba'],13761,23,13784,23177633,10,0.601540265,0.508287293,0.170266198,24978
29bd94bb3fe253ef1c8c81445ad41c5507094ceb,1,ababiichuk,2016-06-21 16:32:45+03:00,['ce695e8b059a90b1735524276c4218ffdc75f422'],2,64,66,23177699,6,0.936170213,0.936170213,1,24978
a6de04361600be152fda3629f27769a480f71073,1,Alex Antonenko,2016-06-21 16:56:15+03:00,['29bd94bb3fe253ef1c8c81445ad41c5507094ceb'],33,47,80,23177779,4,1,1,1,24978
4f78290a627f642b41e7ee1d75984f06eca90723,1,Andrew Onishuk,2016-06-21 17:29:03+03:00,['a6de04361600be152fda3629f27769a480f71073'],3,3,6,23177785,2,,,,24978
6a6bb7a87f01b125a0cba717f98e2c74af348d06,1,oleewere,2016-06-21 16:31:10+02:00,['4f78290a627f642b41e7ee1d75984f06eca90723'],28,64,92,23177877,8,0.148148148,0.962962963,0.814814815,24978
5eadd6c1529c651a6d1d2a9dbac374028e8e3b1d,1,Lisnichenko Dmitro,2016-06-21 17:59:44+03:00,['6a6bb7a87f01b125a0cba717f98e2c74af348d06'],113,471,584,23178461,14,0.145374449,0.700440529,0.850220264,24978
6c2736acdd4e8aaf19fec6a87bddffa562da45ab,0,Alex Antonenko,2016-06-21 18:08:05+03:00,['5eadd6c1529c651a6d1d2a9dbac374028e8e3b1d'],1,1,2,23178463,1,,,,24978
a2c23b213380cf7e8ccbf1db130a0925cc159516,1,oleewere,2016-06-21 19:11:23+02:00,['6c2736acdd4e8aaf19fec6a87bddffa562da45ab'],95,99,194,23178657,22,1,1,1,24978
78037086ee492e067380aba5113034f7312bdb5d,1,Zhe (Joe) Wang,2016-06-21 10:17:13-07:00,['a2c23b213380cf7e8ccbf1db130a0925cc159516'],1,3,4,23178661,2,,,,24978
4f0c4a9ea865fb75918023bed1c497ed054753d2,1,oleewere,2016-06-21 19:36:07+02:00,['78037086ee492e067380aba5113034f7312bdb5d'],54,17,71,23178732,3,,,,24978
5e243959be3f8e221517dbccd2c6f986bbed9a70,1,oleewere,2016-06-21 19:47:33+02:00,['4f0c4a9ea865fb75918023bed1c497ed054753d2'],4,9,13,23178745,2,,,,24978
9b034b23420fb46ffef1ecdd287d2576548f49b4,1,Dipayan Bhowmick,2016-06-22 00:22:10+05:18,['5e243959be3f8e221517dbccd2c6f986bbed9a70'],13,105,118,23178863,6,0.115384615,0,1,24978
50d794c7dff38a3613ca61bd8f112e6cef50ef1b,1,Richard Zang,2016-06-21 12:45:31-07:00,['9b034b23420fb46ffef1ecdd287d2576548f49b4'],0,2,2,23178865,2,0,1,1,24978
fb9e407cab7294b73fed413108ac103b343d7610,1,Dipayan Bhowmick,2016-06-22 01:16:19+05:18,['50d794c7dff38a3613ca61bd8f112e6cef50ef1b'],4,153,157,23179022,2,0.04,0.78,1,24978
ff0f5c008a190360c998ee2cca147dd6d0d51063,1,Swapan Shridhar,2016-06-21 12:59:31-07:00,['fb9e407cab7294b73fed413108ac103b343d7610'],34,88,122,23179144,3,0,0.684210526,1,24978
706946e84cf8c1b6e9121da3ed08516c9d1329c8,0,Srimanth Gunturi,2016-06-21 13:35:01-07:00,['ff0f5c008a190360c998ee2cca147dd6d0d51063'],0,15,15,23179159,2,,,,24978
58198f5339b221e6b3c6d8fb2d61523f2ac0e3bf,1,Alejandro Fernandez,2016-06-21 16:23:38-07:00,['706946e84cf8c1b6e9121da3ed08516c9d1329c8'],68,321,389,23179548,16,0.886792453,0.924528302,0.58490566,24978
97b14647cf02a252ff092652c298b23314df6ec5,1,Robert Levas,2016-06-21 19:44:20-04:00,['58198f5339b221e6b3c6d8fb2d61523f2ac0e3bf'],5,7,12,23179560,4,,,,24978
13fc644c65dc224259d555698663e51f2c77d293,1,Gautam Borad,2016-06-22 10:09:50+05:18,['97b14647cf02a252ff092652c298b23314df6ec5'],248,248,496,23180056,19,0.666666667,0.666666667,1,24978
b3370d96735b2e7691399af34e383dd10c143663,1,Dmytro Sen,2016-06-22 10:07:05+03:00,['13fc644c65dc224259d555698663e51f2c77d293'],0,6,6,23180062,2,0,0,1,24978
67395fad5a91ead40e368d492722977c2292a387,0,Vitaly Brodetskyi,2016-06-21 18:50:39+03:00,['b3370d96735b2e7691399af34e383dd10c143663'],4,6,10,23180072,2,0,0,1,24978
a6b2c8f2b6ce67dd4f88a99b7a868c5bfa2f4ad5,0,ababiichuk,2016-06-22 12:07:17+03:00,['67395fad5a91ead40e368d492722977c2292a387'],1,35,36,23180108,1,0.269230769,0.269230769,1,24978
fad241161603b87f0b2669870e8ec2effb841c60,1,Andrew Onishuk,2016-06-22 12:11:09+03:00,['a6b2c8f2b6ce67dd4f88a99b7a868c5bfa2f4ad5'],6,115,121,23180229,6,0,0,1,24978
15c4081fe3c8c844ae2f8c1aedac857c5d59bb2d,0,Andrew Onishuk,2016-06-22 12:19:05+03:00,['fad241161603b87f0b2669870e8ec2effb841c60'],54,22,76,23180305,2,,,,24978
6d41fd351f1e3c35884f81fd703134fd8734efce,1,oleewere,2016-06-22 11:29:40+02:00,['15c4081fe3c8c844ae2f8c1aedac857c5d59bb2d'],13,17,30,23180335,2,0,1,1,24978
67acdabbbc17acdb9457e1bdffe86fcb937346a5,0,Andrew Onishuk,2016-06-22 13:02:57+03:00,['6d41fd351f1e3c35884f81fd703134fd8734efce'],16,74,90,23180425,3,0,0.105263158,0.947368421,24978
b156a7d1bf6d689a9dfee85c07c5bd72496c158b,1,Dmytro Sen,2016-06-22 13:54:16+03:00,['67acdabbbc17acdb9457e1bdffe86fcb937346a5'],30,14,44,23180469,3,0,0.25,1,24978
22b98964426a244627433bc3592360070c6cd8f6,1,Aleksandr Kovalenko,2016-06-22 14:22:47+03:00,['b156a7d1bf6d689a9dfee85c07c5bd72496c158b'],3,5,8,23180477,1,,,,24978
4d461bf3d4449ad7fdf7fea0f9356beb81bf73b9,1,Andrew Onishuk,2016-06-22 15:46:28+03:00,['22b98964426a244627433bc3592360070c6cd8f6'],3,6,9,23180486,3,0,0,0,24978
9040c22f0b87f79f4794a134a08ee9a04d87999e,1,"Toader, Sebastian",2016-06-22 15:14:00+02:00,['4d461bf3d4449ad7fdf7fea0f9356beb81bf73b9'],25,218,243,23180729,17,0.48,0.12,0.826666667,24978
b21f958a427c3a38efef57e8fa99a2f1f4d5e7e2,0,Mahadev Konar,2016-06-22 08:34:45-07:00,['9040c22f0b87f79f4794a134a08ee9a04d87999e'],15,0,15,23180744,2,,,,24978
2e14098c19afd5d22d879e5ea31eb0c793abbccf,1,Myroslav Papirkovskyi,2016-06-22 18:47:27+03:00,['b21f958a427c3a38efef57e8fa99a2f1f4d5e7e2'],101,307,408,23181152,16,0.210526316,0.842105263,0.964912281,24979
584e627f682968ea7da802b71d9c8ec0561b0eb8,0,Andrii Tkach,2016-06-22 19:08:31+03:00,['2e14098c19afd5d22d879e5ea31eb0c793abbccf'],16,8,24,23181176,3,0.75,0,0,24979
cb5b1ea61722e8e79f647c369cc78b5b1fdc50f0,0,Myroslav Papirkovskyi,2016-06-22 19:20:08+03:00,['584e627f682968ea7da802b71d9c8ec0561b0eb8'],11,103,114,23181290,7,0.168674699,0.86746988,0.927710843,24979
afb6870da15b94de133fb6ff1e445d8abc8f98e2,1,Lisnichenko Dmitro,2016-06-22 21:26:08+03:00,['cb5b1ea61722e8e79f647c369cc78b5b1fdc50f0'],0,11,11,23181301,1,1,1,1,24979
dfde8ba4da5fcae4309f307160e9b33f69684cba,1,Jonathan Hurley,2016-06-22 15:59:50-04:00,['afb6870da15b94de133fb6ff1e445d8abc8f98e2'],3,101,104,23181405,9,0,1,0.5,24979
1d50bc7cde396ecfaca02eb0aa618d044a0e9d53,1,Alejandro Fernandez,2016-06-22 16:08:53-07:00,['dfde8ba4da5fcae4309f307160e9b33f69684cba'],0,34,34,23181439,1,,,,24980
8480ed7285d1dc17c119d1441fd4c7828083843f,0,Robert Levas,2016-06-22 19:59:09-04:00,['1d50bc7cde396ecfaca02eb0aa618d044a0e9d53'],0,5,5,23181444,1,,,,24980
91b39b0f3ceda382300aaa3271cf6d06593e3191,0,Richard Zang,2016-06-22 17:46:41-07:00,['8480ed7285d1dc17c119d1441fd4c7828083843f'],30,32,62,23181506,1,1,1,1,24980
e22b3d41f2be33057f5c1b06a9a23a65ba033bff,0,Jonathan Hurley,2016-06-22 22:08:24-04:00,['91b39b0f3ceda382300aaa3271cf6d06593e3191'],65,40,105,23181611,4,0.75,1,0,24980
193baea1774f1381e994dd8cf8d7d2eba4ec3fe2,1,Jonathan Hurley,2016-06-22 22:08:24-04:00,['e22b3d41f2be33057f5c1b06a9a23a65ba033bff'],19,56,75,23181686,2,0.923076923,0.923076923,0,24980
a6160b4e8897eee335b30706d15a297ffa8b298c,1,Swapan Shridhar,2016-06-22 20:30:24-07:00,['193baea1774f1381e994dd8cf8d7d2eba4ec3fe2'],8,14,22,23181708,3,0,0,1,24980
80defcd4feadbfa1b40d201bd022dd63a272956e,1,Swapan Shridhar,2016-06-22 20:30:24-07:00,['a6160b4e8897eee335b30706d15a297ffa8b298c'],74,90,164,23181872,2,0,0,0,24980
5d70458ea30784700cdea19facca146ef388f271,1,Dipayan Bhowmick,2016-06-23 10:49:52+05:18,['80defcd4feadbfa1b40d201bd022dd63a272956e'],0,16,16,23181888,2,1,1,1,24980
e5ff7fc7e93c55f4422ce36e79d238c71fa82a28,1,Gautam Borad,2016-06-23 11:05:53+05:18,['5d70458ea30784700cdea19facca146ef388f271'],13,23,36,23181924,4,1,1,0,24980
128f4e465ea4ad208b510d1b1d5ee01164499098,0,Dipayan Bhowmick,2016-06-23 12:50:26+05:18,['e5ff7fc7e93c55f4422ce36e79d238c71fa82a28'],11,48,59,23181983,5,0.666666667,0.851851852,0.962962963,24980
4531403f5d40e304cc1d50025dc7e8049aa96bea,1,Andrii Tkach,2016-06-23 10:33:34+03:00,['128f4e465ea4ad208b510d1b1d5ee01164499098'],21,152,173,23182156,4,0.296875,0.96875,1,24980
5885faff778503756e8971f933f5739593782d37,1,Andrii Tkach,2016-06-23 11:40:15+03:00,['4531403f5d40e304cc1d50025dc7e8049aa96bea'],1,2,3,23182159,2,,,,24980
04de79c0888f9f0fa6914f13a2d5a49be238d765,0,Andrew Onishuk,2016-06-23 13:32:43+03:00,['5885faff778503756e8971f933f5739593782d37'],1,28,29,23182188,2,,,,24981
4ed6a3d22f832e73941102a4eb4a64bb404e0746,1,Andrew Onishuk,2016-06-23 13:46:21+03:00,['04de79c0888f9f0fa6914f13a2d5a49be238d765'],96,61,157,23182345,10,1,1,0,24981
390e5613260b79be4f00529e100ba7c165eeee7c,0,Aleksandr Kovalenko,2016-06-23 14:03:22+03:00,['4ed6a3d22f832e73941102a4eb4a64bb404e0746'],27,17,44,23182389,3,0.181818182,0.090909091,0,24981
cd972f01a8ee49efbcf195fd42b2ccde51de7ce0,0,Pallav Kulshreshtha,2016-06-23 16:31:59+05:18,['390e5613260b79be4f00529e100ba7c165eeee7c'],1,1,2,23182391,1,,,,24981
49a10f14b5fee88dd60973a1c93521370a4a4e96,0,Andrew Onishuk,2016-06-23 15:04:54+03:00,['cd972f01a8ee49efbcf195fd42b2ccde51de7ce0'],1,1,2,23182393,1,,,,24981
b83b3e274850fefcba22f330c15617375b04a325,0,Alex Antonenko,2016-06-23 15:42:37+03:00,['49a10f14b5fee88dd60973a1c93521370a4a4e96'],52,29,81,23182474,5,0,0,0,24981
28ecf734ca1e8ac7e56801f4610956a2cd33b288,0,Alex Antonenko,2016-06-23 15:42:37+03:00,['b83b3e274850fefcba22f330c15617375b04a325'],1,9,10,23182484,1,0.7,0.7,1,24981
b6f022d80603567706c149b7c2b73c0bb0c23df6,0,Alex Antonenko,2016-06-23 15:42:37+03:00,['28ecf734ca1e8ac7e56801f4610956a2cd33b288'],17,19,36,23182520,1,,,,24981
1125bb8af8d29e677fdff741c6169f33637cd7be,1,Robert Levas,2016-06-23 09:55:52-04:00,['b6f022d80603567706c149b7c2b73c0bb0c23df6'],111,243,354,23182874,5,0.086956522,0.413043478,0.239130435,24981
5dab212708198c544725d3747d200e7c299d36f7,0,Robert Levas,2016-06-23 09:57:47-04:00,['1125bb8af8d29e677fdff741c6169f33637cd7be'],0,24,24,23182898,1,,,,24982
bfc904b204ea962392b2be19984a60661d0cd3a0,1,Andrew Onishuk,2016-06-23 17:04:17+03:00,['5dab212708198c544725d3747d200e7c299d36f7'],1,1,2,23182900,1,,,,24982
80abd6ca68977035d40f4dea942423223beecb9d,0,Robert Levas,2016-06-23 10:35:20-04:00,['bfc904b204ea962392b2be19984a60661d0cd3a0'],0,13,13,23182913,1,1,1,1,24982
5e11d0366747182987825ab5bfb3e68d5e2807d9,1,Sandor Magyari,2016-06-23 16:50:36+02:00,['80abd6ca68977035d40f4dea942423223beecb9d'],12,15,27,23182940,6,1,1,1,24982
7d317cc29dd4189dd19fdba3cbf44b70232d538e,1,Myroslav Papirkovskyi,2016-06-23 17:59:47+03:00,['5e11d0366747182987825ab5bfb3e68d5e2807d9'],3,127,130,23183070,13,0.223880597,1,1,24982
c4dcf6f6b1596710dce7ee3c97b9cba1915659de,1,Dmytro Sen,2016-06-23 18:31:16+03:00,['7d317cc29dd4189dd19fdba3cbf44b70232d538e'],1,70,71,23183141,3,0,0.811320755,1,24982
4a3fb6ef1db5ef15c0caca958a7a72786b0fafd3,0,Alejandro Fernandez,2016-06-23 11:19:52-07:00,['c4dcf6f6b1596710dce7ee3c97b9cba1915659de'],17,27,44,23183185,7,0,1,0,24982
8b0b903b2c7be50689e9bab30e118e9f61739306,1,Alejandro Fernandez,2016-06-23 11:25:27-07:00,['4a3fb6ef1db5ef15c0caca958a7a72786b0fafd3'],134,134,268,23183453,8,,0,,24982
628f81922cc099d5fa7ca8299d860176486f07c4,1,Robert Levas,2016-06-23 15:31:11-04:00,['8b0b903b2c7be50689e9bab30e118e9f61739306'],735,705,1440,23184893,16,1,1,1,24982
ffdc50da17c8290a1ac00e4106b02d4cf3cbeef8,1,Aleksandr Kovalenko,2016-06-23 22:38:07+03:00,['628f81922cc099d5fa7ca8299d860176486f07c4'],30,4,34,23184927,1,0,0,0,24982
9ae7d7caad4fbd7159f31d55e01008856d2a6e65,0,Srimanth Gunturi,2016-06-23 14:29:07-07:00,['ffdc50da17c8290a1ac00e4106b02d4cf3cbeef8'],1,1,2,23184929,1,,,,24982
769249325e5c3dcbc690bcc72f67ebd91bc7a1b2,0,Srimanth Gunturi,2016-06-23 14:34:06-07:00,['9ae7d7caad4fbd7159f31d55e01008856d2a6e65'],0,14,14,23184943,2,,,,24982
485a69dd80aaa21338552e2aaab7b4b42a013e73,1,Alex Antonenko,2016-06-24 00:39:27+03:00,['769249325e5c3dcbc690bcc72f67ebd91bc7a1b2'],2,6,8,23184951,1,1,1,1,24982
485d1cbb257e9250858fb2d74b728deb7ad767db,0,Ajit Kumar,2016-06-23 21:45:45-07:00,['485a69dd80aaa21338552e2aaab7b4b42a013e73'],0,5,5,23184956,1,,,,24982
cc9d625d712f4988911af1b821c76c4a40753f5d,1,Swapan Shridhar,2016-06-23 21:50:12-07:00,['485d1cbb257e9250858fb2d74b728deb7ad767db'],17,17,34,23184990,2,,,,24982
b79806ec23350ca5ce293e447cd14f7bba13d1a5,1,Swapan Shridhar,2016-06-23 23:13:15-07:00,['cc9d625d712f4988911af1b821c76c4a40753f5d'],455,228,683,23185673,5,1,0.125,0.125,24982
c98597fd1de21cd547c9fbdc809f136d398ce5db,1,oleewere,2016-06-24 14:28:26+02:00,['b79806ec23350ca5ce293e447cd14f7bba13d1a5'],10,82,92,23185765,6,0.149253731,1,1,24982
d4b4cc90a51cc7e085f30bf3a89c964a3421c7f9,0,Lisnichenko Dmitro,2016-06-24 16:50:15+03:00,['c98597fd1de21cd547c9fbdc809f136d398ce5db'],2,2,4,23185769,2,,,,24982
fe97cfd52c0e10bcf5e2af3cbf38d5ad3a67bd80,0,Dmytro Sen,2016-06-24 16:55:03+03:00,['d4b4cc90a51cc7e085f30bf3a89c964a3421c7f9'],4,62,66,23185835,6,1,0,1,24984
5efdce84d244e5031934d822355c5303a3e391e2,1,Andrew Onishuk,2016-06-24 17:15:16+03:00,['fe97cfd52c0e10bcf5e2af3cbf38d5ad3a67bd80'],1,4,5,23185840,1,1,1,1,24984
0cbc5fa385412dd7438f794a49c4ae584be54582,1,Nahappan Somasundaram,2016-06-24 07:55:11-07:00,['5efdce84d244e5031934d822355c5303a3e391e2'],65,64,129,23185969,11,1,1,1,24984
8b7902240d1ffc68e09bc22ed61f35311cd9cbbf,1,Hitesh Shah,2016-06-24 08:26:11-07:00,['0cbc5fa385412dd7438f794a49c4ae584be54582'],138,162,300,23186269,8,0.166666667,1,0.75,24985
8e7220315e8766d07d84d62ffbc7fcf5a3460734,0,Alex Antonenko,2016-06-24 19:40:56+03:00,['8b7902240d1ffc68e09bc22ed61f35311cd9cbbf'],0,1,1,23186270,1,1,1,1,24985
0fc5b8fd3c474881cff2eaf2ebdafa91068336ae,1,Jayush Luniya,2016-06-24 10:38:58-07:00,['8e7220315e8766d07d84d62ffbc7fcf5a3460734'],4,27,31,23186301,5,0,0.695652174,0.695652174,24985
3ae844f0a9439cb29945e16c8f9963d4261e7c40,0,Vitaly Brodetskyi,2016-06-24 04:17:08+03:00,['0fc5b8fd3c474881cff2eaf2ebdafa91068336ae'],11,15,26,23186327,1,0,0,1,24985
36d1f8659c5c14d65c623c982aabbf63066afc1c,1,Zhe (Joe) Wang,2016-06-24 13:42:34-07:00,['3ae844f0a9439cb29945e16c8f9963d4261e7c40'],5,18,23,23186350,5,0.538461538,1,1,24985
4207e60186c42215ead3283285b814af9fe37067,1,oleewere,2016-06-24 23:00:12+02:00,['36d1f8659c5c14d65c623c982aabbf63066afc1c'],4,230,234,23186584,11,,,,24987
128f77e2f12483890064f515ea7691037b520952,1,oleewere,2016-06-24 23:00:12+02:00,['4207e60186c42215ead3283285b814af9fe37067'],263,651,914,23187498,16,,,,24990
08f62c8688439db63240f213cf1d73c6875eb285,0,Swapan Shridhar,2016-06-24 17:18:16-07:00,['128f77e2f12483890064f515ea7691037b520952'],1,4,5,23187503,1,,,,24990
a286924dfcba17cb7ebceda65e1680c4880547e3,0,Jonathan Hurley,2016-06-25 21:53:11-04:00,['08f62c8688439db63240f213cf1d73c6875eb285'],2,7,9,23187512,1,,,,24990
e497f5581dd157f91cb5e5685d78f82dd7aff4e0,1,oleewere,2016-06-26 14:17:51+02:00,['a286924dfcba17cb7ebceda65e1680c4880547e3'],193,341,534,23188046,21,0.223300971,0.669902913,0.902912621,24990
e2b274128258c2567f2ae969b2e601928765a4aa,0,oleewere,2016-06-26 14:46:51+02:00,['e497f5581dd157f91cb5e5685d78f82dd7aff4e0'],3,3,6,23188052,3,,,,24990
f9617e1690d7aede267d3f0549a32ccb3015bce5,0,Alex Antonenko,2016-06-26 16:06:26+03:00,['e2b274128258c2567f2ae969b2e601928765a4aa'],1,1,2,23188054,1,,,,24990
f8b691cde45c4601ee6a463c5524640617e4af15,1,oleewere,2016-06-26 15:11:17+02:00,['f9617e1690d7aede267d3f0549a32ccb3015bce5'],0,1,1,23188055,1,,,,24990
0288d909475ee383396ad07844c3e9100a897f5a,1,Jonathan Hurley,2016-06-26 20:02:18-04:00,['f8b691cde45c4601ee6a463c5524640617e4af15'],103,11,114,23188169,7,0.831325301,0.13253012,0.072289157,24990
ea72aee930731ac7255641de0446fb7bd909c6f6,0,Sandor Magyari,2016-06-27 11:51:19+02:00,['0288d909475ee383396ad07844c3e9100a897f5a'],24,77,101,23188270,13,0.481481481,0.62962963,1,24990
3783cafce62768f3152c12d6f0ea2151fc460fd7,1,oleewere,2016-06-27 12:09:08+02:00,['ea72aee930731ac7255641de0446fb7bd909c6f6'],565,1547,2112,23190382,15,0.463298379,0.777883699,0.954242135,24995
4d94825658075a9db64f62fc821eca05fe968b0a,0,oleewere,2016-06-27 12:18:41+02:00,['3783cafce62768f3152c12d6f0ea2151fc460fd7'],539,23,562,23190944,42,0.375,0.375,0.208333333,24995
b54a5db302fd4d338f165e97ff826b71356ae97c,0,oleewere,2016-06-27 12:38:36+02:00,['4d94825658075a9db64f62fc821eca05fe968b0a'],23,539,562,23191506,42,0.625,0.625,0.791666667,24995
6c2d6a4b8e08827fe67a83266d8005f5f7e19bbc,1,oleewere,2016-06-27 12:45:22+02:00,['b54a5db302fd4d338f165e97ff826b71356ae97c'],2,2,4,23191510,2,,,,24995
85c55268605bc639ee54b3044942db9118ef06ff,1,oleewere,2016-06-27 13:06:34+02:00,['6c2d6a4b8e08827fe67a83266d8005f5f7e19bbc'],539,23,562,23192072,42,0.375,0.375,0.208333333,24995
b259c42df8c7ad79ce55f2937238c06c7c962576,1,Pallav Kulshreshtha,2016-06-27 16:49:24+05:18,['85c55268605bc639ee54b3044942db9118ef06ff'],55,244,299,23192371,13,0,0.712,0.712,24995
075eb17d0e1d9c1e1892f566ac7138cb5ba9a4fc,1,oleewere,2016-06-27 13:50:32+02:00,['b259c42df8c7ad79ce55f2937238c06c7c962576'],36,55,91,23192462,4,,,,24995
49fcedd73cd368d2045b66cb0f0a2437f4ed01e8,0,Andrew Onishuk,2016-06-27 15:45:19+03:00,['075eb17d0e1d9c1e1892f566ac7138cb5ba9a4fc'],3,11,14,23192476,1,0,1,1,24995
bf1955964ec5c4ee4be2e4a4ee5f0471182bbb54,0,Di Li,2016-06-27 10:24:41-04:00,['49fcedd73cd368d2045b66cb0f0a2437f4ed01e8'],1,1,2,23192478,1,,,,24995
dffff6ca8a64f76629dfd384c546dea38e8d0246,1,Alex Antonenko,2016-06-27 19:21:30+03:00,['bf1955964ec5c4ee4be2e4a4ee5f0471182bbb54'],1,3,4,23192482,1,1,1,1,24995
b206361d50e2ca950fb5c645fd961ba0f3e1ac77,0,Alex Antonenko,2016-06-27 21:49:14+03:00,['dffff6ca8a64f76629dfd384c546dea38e8d0246'],2,2,4,23192486,1,,,,24995
249567dde456afda90e517cfac1443d93131fff6,1,oleewere,2016-06-27 21:13:21+02:00,['b206361d50e2ca950fb5c645fd961ba0f3e1ac77'],12,15,27,23192513,3,,,,24995
535fd1fb92454dd1b759cbda1b4a135aa3c881e6,0,Siddharth Wagle,2016-06-27 12:34:57-07:00,['249567dde456afda90e517cfac1443d93131fff6'],1,1,2,23192515,1,,,,24995
a7386cc9015d4976db71ccbd8a81ecf7ec75ac8f,1,Srimanth Gunturi,2016-06-27 13:26:24-07:00,['535fd1fb92454dd1b759cbda1b4a135aa3c881e6'],11,2123,2134,23194649,18,0.220806794,0.966029724,0.974522293,25001
560d2d7f2475b1dfe150f9c2f4dfcc6da4a5f52e,1,Sumit Mohanty,2016-06-27 13:58:06-07:00,['a7386cc9015d4976db71ccbd8a81ecf7ec75ac8f'],77,24,101,23194750,13,0.518518519,0.37037037,0,25001
6c7e39a240c01f35788c9fd8f7037e05e971811a,0,Siddharth Wagle,2016-06-27 19:47:44-07:00,['560d2d7f2475b1dfe150f9c2f4dfcc6da4a5f52e'],0,2,2,23194752,1,0.5,1,1,25001
ff060c54d4c77c990d90acce715461997b367bf9,1,Sandor Magyari,2016-06-28 11:58:28+02:00,['6c7e39a240c01f35788c9fd8f7037e05e971811a'],11,28,39,23194791,3,1,1,1,25001
04e607301a1ee02d3b8a116e0c7afeea24862dc0,1,Di Li,2016-06-28 08:26:03-04:00,['ff060c54d4c77c990d90acce715461997b367bf9'],16,16,32,23194823,3,0,0,0,25001
56c8bf6616cf4989640977ab2fb756313014d9db,1,Gautam Borad,2016-06-28 18:05:52+05:18,['04e607301a1ee02d3b8a116e0c7afeea24862dc0'],40,457,497,23195320,14,0,0.986238532,1,25002
740c6caa9be975da87084f4c5b6d5ce4e4c9b543,1,oleewere,2016-06-28 15:11:51+02:00,['56c8bf6616cf4989640977ab2fb756313014d9db'],42,86,128,23195448,5,0.882352941,1,1,25002
8daa34ded1f6bc53bc61a4fc1108703eb4ceecf7,1,Gautam Borad,2016-06-28 19:07:08+05:18,['740c6caa9be975da87084f4c5b6d5ce4e4c9b543'],1,80,81,23195529,2,0.019607843,0.019607843,0.980392157,25003
cf880469a345ccf6d58d1e751349a8323754aa88,0,Aravindan Vijayan,2016-06-28 10:24:03-07:00,['8daa34ded1f6bc53bc61a4fc1108703eb4ceecf7'],3,9,12,23195541,3,,,,25003
29f4c492996e9ea03245a092fa89908f47c898fe,0,Pallav Kulshreshtha,2016-06-28 23:07:09+05:18,['cf880469a345ccf6d58d1e751349a8323754aa88'],7,3,10,23195551,2,0,0,0,25003
72085e90bf92cc33354f489d018cf53c75e07204,0,Nate Cole,2016-06-28 13:52:58-04:00,['29f4c492996e9ea03245a092fa89908f47c898fe'],5,5,10,23195561,5,,,,25003
bf5ca2f5e6714c8e0536504de9d54c8d6afc1425,1,Jonathan Hurley,2016-06-28 14:39:44-04:00,['72085e90bf92cc33354f489d018cf53c75e07204'],21,101,122,23195683,4,0.2,0.8,0,25003
124c9396078ebb52d5ab5a0196e021059f0ae849,1,Swapan Shridhar,2016-06-29 01:23:57-07:00,['bf5ca2f5e6714c8e0536504de9d54c8d6afc1425'],5,6,11,23195694,2,0,0,0,25003
259279cd67ba2626d68d3565982729769b9f5ea9,1,oleewere,2016-06-29 12:04:57+02:00,['124c9396078ebb52d5ab5a0196e021059f0ae849'],106,31,137,23195831,8,1,0,0.078431373,25003
6f4a9c288ad52f913ae7d2a9eef7fb7bc1bfa568,1,Dipayan Bhowmick,2016-06-29 16:53:08+05:18,['259279cd67ba2626d68d3565982729769b9f5ea9'],3405,10827,14232,23210063,204,0.854943274,0.97082658,0.717585089,25176
addc5d04626fdaf976df2a0427cb9cdb3c923c22,1,Sandor Magyari,2016-06-29 14:02:40+02:00,['6f4a9c288ad52f913ae7d2a9eef7fb7bc1bfa568'],24,80,104,23210167,16,0.481481481,0.62962963,1,25176
7474ec4e9c9bbefeeb09f701380cd7093eff28c6,1,Sandor Magyari,2016-06-29 14:04:02+02:00,['addc5d04626fdaf976df2a0427cb9cdb3c923c22'],6,6,12,23210179,2,,,,25176
530128d8058ebe1384426a6ebceef6076d47fafb,1,Sandor Magyari,2016-06-29 15:04:38+02:00,['7474ec4e9c9bbefeeb09f701380cd7093eff28c6'],164,168,332,23210511,3,0,0,0,25176
5352dac06d2936421c557993cad3460e2f2521fd,1,Nate Cole,2016-06-29 09:25:17-04:00,['530128d8058ebe1384426a6ebceef6076d47fafb'],77,363,440,23210951,17,0,0.730496454,0.957446809,25178
c40ec58203cd01d823734343c209322a6040cb60,1,Alex Antonenko,2016-06-29 17:37:44+03:00,['5352dac06d2936421c557993cad3460e2f2521fd'],10827,3405,14232,23225183,204,0.145056726,0.02917342,0.282414911,25195
2360560fb39d36888db6372dab678b1d501ebd18,1,Gautam Borad,2016-06-29 19:57:11+05:18,['c40ec58203cd01d823734343c209322a6040cb60'],22,2419,2441,23227624,7,0.012544803,0.992831541,0.815412186,25198
e63317d8acc010b47d36fb1c5caeb30f3782f993,1,Alex Antonenko,2016-06-29 17:39:47+03:00,['2360560fb39d36888db6372dab678b1d501ebd18'],9,9,18,23227642,6,,,,25198
f9c89885eae11163bcf471593bd35698f70eaeb0,1,Pallav Kulshreshtha,2016-06-29 20:25:37+05:18,['e63317d8acc010b47d36fb1c5caeb30f3782f993'],33,75,108,23227750,3,1,0.625,1,25198
7a43ef483f33bcf03debe52ca1b24076630c771d,0,Andrew Onishuk,2016-06-29 19:08:36+03:00,['f9c89885eae11163bcf471593bd35698f70eaeb0'],9,9,18,23227768,1,,,,25198
21a544891e7388c807ad8b88eb80afada9e31b19,1,Myroslav Papirkovskyi,2016-06-29 19:21:57+03:00,['7a43ef483f33bcf03debe52ca1b24076630c771d'],12,104,116,23227884,8,0.168674699,0.86746988,0.927710843,25198
917988f7668405299b0d59fe017c6b115716df8a,1,Myroslav Papirkovskyi,2016-06-29 19:21:57+03:00,['21a544891e7388c807ad8b88eb80afada9e31b19'],54,108,162,23228046,12,0.558823529,1,1,25199
15d7e20355f1f8428d1a776feef597fe0d1df694,1,Aleksandr Kovalenko,2016-06-29 20:58:21+03:00,['917988f7668405299b0d59fe017c6b115716df8a'],22,22,44,23228090,2,1,0,0,25199
b39ba60a5e4fd0e772e2015553ba993d1f21d180,0,"Toader, Sebastian",2016-06-29 11:37:00-07:00,['15d7e20355f1f8428d1a776feef597fe0d1df694'],0,16,16,23228106,2,,,,25199
e71b06383773993352b1222f2ec61af4e2dec987,0,Robert Levas,2016-06-29 14:47:09-04:00,['b39ba60a5e4fd0e772e2015553ba993d1f21d180'],5,5,10,23228116,1,,,,25199
1f73cbe50c88195e1cadce2250ef02e22653f3ec,1,Nate Cole,2016-06-29 15:15:47-04:00,['e71b06383773993352b1222f2ec61af4e2dec987'],1,55,56,23228172,4,1,1,1,25199
278e442adf07bed539c842945607cae0968f1afe,0,Alejandro Fernandez,2016-06-29 14:26:21-07:00,['1f73cbe50c88195e1cadce2250ef02e22653f3ec'],8,56,64,23228236,2,0,0,0,25200
2e8bfaa97a9d69cc55ebb10373f1efa941a7adac,1,Alejandro Fernandez,2016-06-29 14:56:26-07:00,['278e442adf07bed539c842945607cae0968f1afe'],10,838,848,23229084,6,0,0,0,25201
850a29593c6328d20d93fb143eb11ca207c05342,1,Yusaku Sako,2016-06-29 15:50:39-07:00,['2e8bfaa97a9d69cc55ebb10373f1efa941a7adac'],0,4541,4541,23233625,4,,,,25205
4db43122f20851bb59893b3575c3a590e6da8cc5,0,Sumit Mohanty,2016-06-29 17:10:06-07:00,['850a29593c6328d20d93fb143eb11ca207c05342'],1,55,56,23233681,3,0,0,0.720930233,25205
9e43840aeff2d0f13e3f61bb8dcb44046dd8877d,1,Nahappan Somasundaram,2016-06-29 21:27:10-07:00,['4db43122f20851bb59893b3575c3a590e6da8cc5'],0,196,196,23233877,3,0.359550562,0.662921348,1,25205
ef29683ce2cd49c0fc06baf4cba83ee39baf7997,1,Gautam Borad,2016-06-30 10:40:56+05:18,['9e43840aeff2d0f13e3f61bb8dcb44046dd8877d'],86,93,179,23234056,4,1,1,0,25205
c86672cb7f62dae2afdc291b7035e088784e3241,1,Dipayan Bhowmick,2016-06-30 11:23:54+05:18,['ef29683ce2cd49c0fc06baf4cba83ee39baf7997'],3405,10887,14292,23248348,205,0.854943274,0.97082658,0.717585089,25378
b618d22bd27ee24cad8855c5e8b6160307aa8ad9,1,ababiichuk,2016-06-30 10:20:02+03:00,['c86672cb7f62dae2afdc291b7035e088784e3241'],324,412,736,23249084,6,0.825,1,1,25380
4c0b1f430983efdf1b1d4bd886e8558144752ff4,1,Matt,2016-06-30 00:44:52-07:00,['b618d22bd27ee24cad8855c5e8b6160307aa8ad9'],13,341,354,23249438,5,0,0.75,0.75,25380
45338f5e838c3d99b54e7e08daeedfd3f6c71557,1,ababiichuk,2016-06-30 12:05:40+03:00,['4c0b1f430983efdf1b1d4bd886e8558144752ff4'],3,23,26,23249464,1,1,1,0.230769231,25380
ab362d0680532e2be430bde22a852292fae47a35,1,Pallav Kulshreshtha,2016-06-30 14:52:54+05:18,['45338f5e838c3d99b54e7e08daeedfd3f6c71557'],327,2068,2395,23251859,32,0.302094818,1,0.971334068,25390
d6327321cf8337412ed44598c4509668edad374f,1,Andrew Onishuk,2016-06-30 13:18:05+03:00,['ab362d0680532e2be430bde22a852292fae47a35'],21,28,49,23251908,2,1,1,1,25390
2fa027c1869467fe35ea8de5849abc68cf10dfd7,1,Pallav Kulshreshtha,2016-06-30 16:15:00+05:18,['d6327321cf8337412ed44598c4509668edad374f'],31,403,434,23252342,19,0.793859649,0.995614035,0.98245614,25392
8df1e8f015c480ca94dc37d580e7db49752705dc,1,Pallav Kulshreshtha,2016-06-30 16:55:12+05:18,['2fa027c1869467fe35ea8de5849abc68cf10dfd7'],68,119,187,23252529,5,0.851851852,0.851851852,1,25393
33d9050623e38349eb4bbe7f6f20104d6bc96b3f,1,Pallav Kulshreshtha,2016-06-30 17:02:41+05:18,['8df1e8f015c480ca94dc37d580e7db49752705dc'],359,1865,2224,23254753,34,0.546218487,0.884753902,0.913565426,25399
ebaed6ad69e2d6b506403f2f09d1c3b576be740b,1,Pallav Kulshreshtha,2016-06-30 17:15:28+05:18,['33d9050623e38349eb4bbe7f6f20104d6bc96b3f'],182,843,1025,23255778,19,0.653846154,0.841025641,0.848717949,25401
9550b870b10b2d42a0ec5c347cdab75ef4d03590,0,Dipayan Bhowmick,2016-06-30 17:38:45+05:18,['ebaed6ad69e2d6b506403f2f09d1c3b576be740b'],4,4,8,23255786,2,,,,25401
f8257e587368210edaff267e012ef2bd82e240c4,1,Dipayan Bhowmick,2016-06-30 17:49:04+05:18,['9550b870b10b2d42a0ec5c347cdab75ef4d03590'],78,182,260,23256046,8,0.488372093,0.465116279,1,25402
ce8e876169ea325a98192b71f5eafe1dc1de7ddb,1,Andrii Tkach,2016-06-30 15:55:36+03:00,['f8257e587368210edaff267e012ef2bd82e240c4'],0,4,4,23256050,2,1,1,1,25402
febdf21327ac676ff8aa8a1331ec82348317a0e1,1,Di Li,2016-06-30 09:59:46-04:00,['ce8e876169ea325a98192b71f5eafe1dc1de7ddb'],0,964,964,23257014,1,0.478138223,0.695345557,0.655853315,25403
db798a76cbf16ee1847481da181ff080a9d92f8d,1,Oleg Nechiporenko,2016-06-30 17:27:13+03:00,['febdf21327ac676ff8aa8a1331ec82348317a0e1'],16,40,56,23257070,9,1,1,1,25403
15ecedfdca4907166d9e07a1224271818bbdb8ba,1,Aleksandr Kovalenko,2016-06-30 17:46:06+03:00,['db798a76cbf16ee1847481da181ff080a9d92f8d'],1,41,42,23257112,4,1,1,1,25403
48a8a072dd9cff1513bc9cbd803b5219abfa9b83,1,Lisnichenko Dmitro,2016-06-30 19:19:34+03:00,['15ecedfdca4907166d9e07a1224271818bbdb8ba'],3,3,6,23257118,2,,,,25403
b29ad444d2c31df8e407120805fc9e937e0fb8d0,1,Dipayan Bhowmick,2016-06-30 21:46:02+05:18,['48a8a072dd9cff1513bc9cbd803b5219abfa9b83'],16,97,113,23257231,6,1,1,0.222222222,25404
4999e6cb9dcec78dd0ecc22e9e8a9c773e7e5ec1,1,Lisnichenko Dmitro,2016-06-30 19:58:25+03:00,['b29ad444d2c31df8e407120805fc9e937e0fb8d0'],4,64,68,23257299,2,0,1,0.913793103,25404
1be5dfd92a0b3aa085abb777d309312c324bb3e7,1,Aravindan Vijayan,2016-06-30 11:04:18-07:00,['4999e6cb9dcec78dd0ecc22e9e8a9c773e7e5ec1'],19,629,648,23257947,18,0.434306569,0.795620438,0.95620438,25413
3ff0ddc663c58ae044385ac18660478484ae4cb5,0,Aravindan Vijayan,2016-06-30 11:30:23-07:00,['1be5dfd92a0b3aa085abb777d309312c324bb3e7'],5,40,45,23257992,2,0.76,0.76,1,25413
7cb58ff2b18a628c2b4f5f24bdc558f3b5f60a20,0,Aravindan Vijayan,2016-06-30 11:36:14-07:00,['3ff0ddc663c58ae044385ac18660478484ae4cb5'],5,204,209,23258201,6,,,,25413
8b0cdcaacd197e6e4700ce0a5ed31c5e90f6c348,1,Vitaly Brodetskyi,2016-06-30 21:53:30+03:00,['7cb58ff2b18a628c2b4f5f24bdc558f3b5f60a20'],21,21,42,23258243,2,,,,25413
725c651305a467797129f1396264116b2e5af43a,0,Swapan Shridhar,2016-06-30 13:50:11-07:00,['8b0cdcaacd197e6e4700ce0a5ed31c5e90f6c348'],14,11,25,23258268,1,1,1,1,25413
7d7a6f7abe67d42139d5770ef12cbffd6a066b91,0,Richard Zang,2016-06-30 14:51:16-07:00,['725c651305a467797129f1396264116b2e5af43a'],3,6,9,23258277,1,1,1,0.5,25413
bb3b7525f4b73059d6d6fbc6655e61d8f54ea4b6,0,Srimanth Gunturi,2016-06-30 17:12:37-07:00,['7d7a6f7abe67d42139d5770ef12cbffd6a066b91'],2,2,4,23258281,2,,1,,25413
c5aafc8fb9f559d5771464f3fd2ec8cec570ba34,1,Pallav Kulshreshtha,2016-07-01 11:53:39+05:18,['bb3b7525f4b73059d6d6fbc6655e61d8f54ea4b6'],340,1851,2191,23260472,34,0.54784689,0.885167464,0.913875598,25419
7ab734f2311daf8022ba7780d19f3cadb94d5d45,1,oleewere,2016-07-01 10:05:18+02:00,['c5aafc8fb9f559d5771464f3fd2ec8cec570ba34'],5,5,10,23260482,1,,,,25419
ff296f9d03f51303db2de46426cf5bcf71949369,1,oleewere,2016-07-01 10:16:01+02:00,['7ab734f2311daf8022ba7780d19f3cadb94d5d45'],42,26,68,23260550,6,0,0,0,25419
b6ae19b259e370918202378421c9bf4c37e7be32,1,Pallav Kulshreshtha,2016-07-01 15:26:36+05:18,['ff296f9d03f51303db2de46426cf5bcf71949369'],4,10,14,23260564,5,0,1,1,25419
cccbc48a74920980b2761e3a7cf49edd97b66ed2,0,Alex Antonenko,2016-07-01 13:55:12+03:00,['b6ae19b259e370918202378421c9bf4c37e7be32'],0,3,3,23260567,1,0,0,1,25419
75eca8de4a92feb629f2905901cfa2d699381256,1,Alex Antonenko,2016-07-01 13:55:12+03:00,['cccbc48a74920980b2761e3a7cf49edd97b66ed2'],0,1,1,23260568,1,0,1,0,25419
1c09b40a5066857dd0eb2a7649fe081dc4a108c2,1,Vitaly Brodetskyi,2016-07-01 15:37:39+03:00,['75eca8de4a92feb629f2905901cfa2d699381256'],5,42,47,23260615,6,0,0.419354839,0.677419355,25419
92455c70258153019845908cb82e21e669c0e267,1,oleewere,2016-07-01 15:35:13+02:00,['1c09b40a5066857dd0eb2a7649fe081dc4a108c2'],7,6,13,23260628,3,1,1,1,25419
52d466bc284b84ad1294ac52ab772e84e120b379,1,Andrew Onishuk,2016-07-01 18:05:50+03:00,['92455c70258153019845908cb82e21e669c0e267'],2,11,13,23260641,2,0.285714286,0.428571429,0.285714286,25419
737e6051629a883259099faed68088a67e55b54e,1,Andrii Tkach,2016-07-01 18:58:06+03:00,['52d466bc284b84ad1294ac52ab772e84e120b379'],2,18,20,23260661,3,1,1,1,25419
dfd1ce49234b935cfb73f3a7c1b3fd558d2fe5b8,1,Andrew Onishuk,2016-07-01 19:02:42+03:00,['737e6051629a883259099faed68088a67e55b54e'],0,44,44,23260705,1,1,1,1,25419
48864260d27310bf88332c799c4b186105f47592,0,Myroslav Papirkovskyi,2016-07-01 19:13:04+03:00,['dfd1ce49234b935cfb73f3a7c1b3fd558d2fe5b8'],2,3,5,23260710,1,,,,25419
9c7e7615128652b5abb8216946007d59f9a2dced,1,Alex Antonenko,2016-07-01 19:45:12+03:00,['48864260d27310bf88332c799c4b186105f47592'],3,41,44,23260754,5,0.575,0.65,1,25419
90c9904fcdeaf5a970cdd837a79144c9d18fd4e9,1,Bob Nettleton,2016-07-01 14:00:49-04:00,['9c7e7615128652b5abb8216946007d59f9a2dced'],94,300,394,23261148,7,0.866666667,1,0.355555556,25420
ab364ec71f72ac460bee978a61bd0b127048fc7d,0,Yusaku Sako,2016-07-01 11:18:07-07:00,['90c9904fcdeaf5a970cdd837a79144c9d18fd4e9'],940,0,940,23262088,1,,,,25420
78898ebe510f170b3a12d08361231594d464f3ab,1,Jaimin Jetly,2016-07-01 11:45:48-07:00,['ab364ec71f72ac460bee978a61bd0b127048fc7d'],24,141,165,23262253,8,0.666666667,0.68115942,1,25420
148950a2216a84890c9c79d7f44b2436cc78ffc3,1,Andrew Onishuk,2016-07-01 21:44:23+03:00,['78898ebe510f170b3a12d08361231594d464f3ab'],5,18,23,23262276,9,0,0,0,25420
cf27e5db065c40289ef7b62c6835bfc902f07c92,1,Swapan Shridhar,2016-07-01 13:11:11-07:00,['148950a2216a84890c9c79d7f44b2436cc78ffc3'],9,11,20,23262296,6,0,0,0,25420
b9252454774d67dbdfb47487fde4e77574d8c0b0,1,Aleksandr Kovalenko,2016-07-02 00:53:03+03:00,['cf27e5db065c40289ef7b62c6835bfc902f07c92'],61,98,159,23262455,6,0.52,0.52,1,25420
8e0f00f73dc2b3ada946516bdf580a53b804dd18,1,Andrew Onishuk,2016-07-02 00:57:32+03:00,['b9252454774d67dbdfb47487fde4e77574d8c0b0'],0,19,19,23262474,1,1,1,1,25420
a3207df8bfb78d5938139f4524586ae3be52f37b,0,Sumit Mohanty,2016-07-01 17:17:52-07:00,['8e0f00f73dc2b3ada946516bdf580a53b804dd18'],8,0,8,23262482,1,,,,25420
1d8cc66ea6b4ec73b6369088a686f6f0e3ad5df0,0,Sumit Mohanty,2016-07-01 17:39:08-07:00,['a3207df8bfb78d5938139f4524586ae3be52f37b'],1,1,2,23262484,1,,,,25420
e0ef7b3e716582dc08fd93b75deb2014a28010d6,0,Xi Wang,2016-07-01 17:39:49-07:00,['1d8cc66ea6b4ec73b6369088a686f6f0e3ad5df0'],2,14,16,23262500,2,,,,25420
8d83ea62c689d556dd104fcb624ca4537a796b53,1,Sumit Mohanty,2016-07-01 22:51:41-07:00,['e0ef7b3e716582dc08fd93b75deb2014a28010d6'],15,92,107,23262607,5,0,0.787234043,0.14893617,25420
7117d092c9c9bbc68212366d6466d9fef2b18e35,0,Sumit Mohanty,2016-07-02 11:47:36-07:00,['8d83ea62c689d556dd104fcb624ca4537a796b53'],0,1,1,23262608,1,,,,25420
33423c71c68e46d171b1e602ca44e94745f39874,0,Vitaly Brodetskyi,2016-07-01 23:53:25+03:00,['7117d092c9c9bbc68212366d6466d9fef2b18e35'],5,39,44,23262652,2,0.423076923,0.653846154,0.653846154,25420
bd5822724e7ab2c79c437ce303cb8ecd232905ec,1,Sumit Mohanty,2016-07-02 15:12:08-07:00,['33423c71c68e46d171b1e602ca44e94745f39874'],0,32,32,23262684,1,,,,25421
da7c3ca84991eac0c1cf6248da72d40f2df3212b,1,Swapan Shridhar,2016-07-03 03:37:18-07:00,['bd5822724e7ab2c79c437ce303cb8ecd232905ec'],8,125,133,23262817,3,0,0.260416667,0.822916667,25421
4c97783511a5de2ed01d220999dd7a3029ad42fc,0,Alex Antonenko,2016-07-03 14:49:22+03:00,['da7c3ca84991eac0c1cf6248da72d40f2df3212b'],3,0,3,23262820,1,1,1,0,25421
1b17f36ee45450d21651347060079fee4430ca87,1,Dmytro Sen,2016-07-03 15:49:15+03:00,['4c97783511a5de2ed01d220999dd7a3029ad42fc'],1410,142,1552,23264372,6,0,0.677419355,1,25421
13e4c2aafc2df68e415a49efda82d53837d86621,1,Sumit Mohanty,2016-07-03 06:54:48-07:00,['1b17f36ee45450d21651347060079fee4430ca87'],26,23,49,23264421,3,1,1,1,25421
f657a4d6bd00eeede3153cbeb0a732736b29d0e8,0,Andrew Onishuk,2016-07-03 18:35:14+03:00,['13e4c2aafc2df68e415a49efda82d53837d86621'],1,6,7,23264428,3,0,0.8,1,25421
d2a008070d43425d78bd78fdd276c3f37c4f6070,0,Gautam Borad,2016-07-04 10:48:08+05:18,['f657a4d6bd00eeede3153cbeb0a732736b29d0e8'],11,21,32,23264460,2,0,0,0,25421
74a2afd2f383da8905a147e6992c1d1042a75fed,1,Dipayan Bhowmick,2016-07-04 11:36:31+05:18,['d2a008070d43425d78bd78fdd276c3f37c4f6070'],13,22,35,23264495,4,1,1,1,25421
d6abf7377b2c95bf8502e953c4935a3edc55b5a3,1,"Toader, Sebastian",2016-07-04 09:59:40+02:00,['74a2afd2f383da8905a147e6992c1d1042a75fed'],20,19,39,23264534,1,1,1,0,25421
196657bf37bfd462df11d092d831fbd975fdc777,1,oleewere,2016-07-04 11:50:06+02:00,['d6abf7377b2c95bf8502e953c4935a3edc55b5a3'],3,477,480,23265014,9,0.438202247,0.812734082,0.940074906,25425
ea07c34140d7394ec694bc71273a89c237e815de,1,oleewere,2016-07-04 12:06:56+02:00,['196657bf37bfd462df11d092d831fbd975fdc777'],1,116,117,23265131,2,0,0.104166667,1,25425
5295a0e5e8f74c0a7f0c2a1f11a72363b35ba23f,0,Dmytro Sen,2016-07-04 13:42:26+03:00,['ea07c34140d7394ec694bc71273a89c237e815de'],115,1103,1218,23266349,24,0.436657682,0.619946092,0.84097035,25431
57b795dbc0657d49237433d2c2c7cc9369bfa958,1,oleewere,2016-07-04 13:01:24+02:00,['5295a0e5e8f74c0a7f0c2a1f11a72363b35ba23f'],287,163,450,23266799,24,0.93902439,0.93902439,0.012195122,25431
cbe8882fc9e548b08d9985f39d75a83455fb9ab4,1,Dmytro Sen,2016-07-04 15:55:11+03:00,['57b795dbc0657d49237433d2c2c7cc9369bfa958'],4,57,61,23266860,4,,,,25432
7d2134bf9f579c6886b04e76b8fc55285c61d3c5,1,Aleksandr Kovalenko,2016-07-04 17:37:50+03:00,['cbe8882fc9e548b08d9985f39d75a83455fb9ab4'],4,15,19,23266879,2,1,1,1,25432
be9da0bff0372ce0a6acf3cc58c3b4a84be6558c,1,Alex Antonenko,2016-07-04 19:27:40+03:00,['7d2134bf9f579c6886b04e76b8fc55285c61d3c5'],25,52,77,23266956,4,0.428571429,0.428571429,1,25432
179df466eb35b99a73e0d031487c68347c8d67fe,1,Vitaly Brodetskyi,2016-07-04 02:51:15+03:00,['be9da0bff0372ce0a6acf3cc58c3b4a84be6558c'],16,33,49,23267005,1,1,1,1,25432
6aec65f7b59fb854787b4c4b23d893b5ea9a9768,1,Vitaly Brodetskyi,2016-07-04 02:53:02+03:00,['179df466eb35b99a73e0d031487c68347c8d67fe'],1,1,2,23267007,1,,,,25432
200a250a120981bbc28d96b41095e42f21279093,1,Aravindan Vijayan,2016-07-04 19:49:04-07:00,['6aec65f7b59fb854787b4c4b23d893b5ea9a9768'],1103,115,1218,23268225,24,0.563342318,0.380053908,0.15902965,25433
56773db8e9840ed92a90552cffe5204e8084d63a,1,Andrii Tkach,2016-07-05 11:56:18+03:00,['200a250a120981bbc28d96b41095e42f21279093'],1,2,3,23268228,1,,,,25433
a470afdf77e1f6384f8cdc8fcab40b655544e403,1,Dmytro Sen,2016-07-05 15:14:20+03:00,['56773db8e9840ed92a90552cffe5204e8084d63a'],1,6,7,23268235,2,,,,25433
4205ebc35952930262fc5122bb7db83e436fa04e,0,Dmytro Sen,2016-07-05 15:43:05+03:00,['a470afdf77e1f6384f8cdc8fcab40b655544e403'],4,4,8,23268243,2,,,,25433
32169fd2d781d29bca66da37388bd92bb1720a49,0,Alex Antonenko,2016-07-05 17:26:18+03:00,['4205ebc35952930262fc5122bb7db83e436fa04e'],4,4,8,23268251,2,,,,25433
f0fec408b69baf72922cf847df774f0938317947,0,Alex Antonenko,2016-07-05 18:34:43+03:00,['32169fd2d781d29bca66da37388bd92bb1720a49'],86,93,179,23268430,4,1,1,1,25433
92f12dd3143641c444ddda774901b8bdd94ac56a,0,Lisnichenko Dmitro,2016-07-05 19:30:52+03:00,['f0fec408b69baf72922cf847df774f0938317947'],65,65,130,23268560,18,,,,25433
6c329bf436db102c0adc19153cb3871f021b28fa,1,Lisnichenko Dmitro,2016-07-05 19:44:40+03:00,['92f12dd3143641c444ddda774901b8bdd94ac56a'],65,65,130,23268690,18,,,,25433
99b82a7b5801c0e2a78c7d6425239a13d68c5eb6,1,Lisnichenko Dmitro,2016-07-05 19:46:40+03:00,['6c329bf436db102c0adc19153cb3871f021b28fa'],333,662,995,23269685,67,0.875,0.875,1,25433
ef799757a1c85431d659fd7dc2ad39666a0ce681,1,Andrew Onishuk,2016-07-05 19:54:12+03:00,['99b82a7b5801c0e2a78c7d6425239a13d68c5eb6'],30,90,120,23269805,8,0.866666667,0.933333333,1,25434
ffc3c7111208c4446174328300a099971c294a1a,1,Jonathan Hurley,2016-07-05 13:49:39-04:00,['ef799757a1c85431d659fd7dc2ad39666a0ce681'],1,2,3,23269808,1,0,0,0,25434
859a3758bd48015b031f4eb7ca083a3f8706c10e,1,Jaimin Jetly,2016-07-05 11:58:05-07:00,['ffc3c7111208c4446174328300a099971c294a1a'],0,42,42,23269850,2,,,,25435
bd99d76d3bc78e680e426970714b9ec18340a085,0,Robert Levas,2016-07-05 14:58:34-04:00,['859a3758bd48015b031f4eb7ca083a3f8706c10e'],2,3,5,23269855,2,,,,25435
25ed05ce88d47c2ff184238be42abd5869514ced,0,Siddharth Wagle,2016-07-05 12:43:40-07:00,['bd99d76d3bc78e680e426970714b9ec18340a085'],2,11,13,23269868,2,,,,25435
57fccc039c00b301836cf74c15016734fedd64ca,1,Aravindan Vijayan,2016-07-05 14:38:55-07:00,['25ed05ce88d47c2ff184238be42abd5869514ced'],115,1103,1218,23271086,24,0.436657682,0.619946092,0.84097035,25441
878a6bb081f5a80ae2f80ff267d589bf1d45bc69,0,Richard Zang,2016-07-05 16:19:19-07:00,['57fccc039c00b301836cf74c15016734fedd64ca'],1,1,2,23271088,1,,,,25441
a709f607873af6061f8203eeded186e20e2dcc6f,1,Aravindan Vijayan,2016-07-05 17:31:33-07:00,['878a6bb081f5a80ae2f80ff267d589bf1d45bc69'],78,50,128,23271216,4,0.142857143,0.285714286,0,25441
c6d15394a3a5b8405e4ad212e7d1a3764994e236,0,Xi Wang,2016-07-05 18:18:51-07:00,['a709f607873af6061f8203eeded186e20e2dcc6f'],1,5,6,23271222,2,0,1,1,25441
36a3848c768a1638a6893bddd26390645bd9245f,0,Richard Zang,2016-07-05 18:26:12-07:00,['c6d15394a3a5b8405e4ad212e7d1a3764994e236'],1,2,3,23271225,2,,,,25441
97361d9ffc518b9f6b6b7c6b72c9b4f29f1db195,1,Sumit Mohanty,2016-07-05 21:26:01-07:00,['36a3848c768a1638a6893bddd26390645bd9245f'],0,1,1,23271226,1,,,,25441
6cb4008374b9d70741eceebfc31f729b70ca81fb,1,Sumit Mohanty,2016-07-05 22:55:46-07:00,['97361d9ffc518b9f6b6b7c6b72c9b4f29f1db195'],1,2,3,23271229,1,,,,25441
de5110ec4c93df14db973f054adbb98ef5220b71,1,Matt,2016-07-05 23:26:05-07:00,['6cb4008374b9d70741eceebfc31f729b70ca81fb'],26188,4902,31090,23302319,38,1,1,0.571428571,25452
c80ccd89c9d3087b215e2a2f6d9e72ddd4b0990f,1,oleewere,2016-07-06 12:13:16+02:00,['de5110ec4c93df14db973f054adbb98ef5220b71'],1,551,552,23302871,9,0.333333333,0.888888889,0.888888889,25453
c56844922cb958c2879c292b0b57d2e5edf4a8a4,1,oleewere,2016-07-06 12:23:57+02:00,['c80ccd89c9d3087b215e2a2f6d9e72ddd4b0990f'],53,231,284,23303155,3,0.989583333,0.989583333,1,25454
cfd9207938947f3522fe960be8738ea41e5ca290,1,Pallav Kulshreshtha,2016-07-06 17:02:24+05:18,['c56844922cb958c2879c292b0b57d2e5edf4a8a4'],206,1245,1451,23304606,40,0.994285714,1,1,25466
9c76341aa5ca9df7247c962fc2f6a93dfa257fab,1,Andrew Onishuk,2016-07-06 15:09:10+03:00,['cfd9207938947f3522fe960be8738ea41e5ca290'],12,11,23,23304629,2,,1,,25466
c65e53e1c503ca9e4e465d4529f6aabdab296f1c,0,Andrew Onishuk,2016-07-06 17:00:24+03:00,['9c76341aa5ca9df7247c962fc2f6a93dfa257fab'],4,8,12,23304641,1,1,1,1,25466
0caf76005b04b8fa90e3d76f295d5ad53323bab4,1,Andrew Onishuk,2016-07-06 17:22:03+03:00,['c65e53e1c503ca9e4e465d4529f6aabdab296f1c'],8,4,12,23304653,1,0,0,0,25466
e4571de18bc472fca44c8a14f25faf1a6c002eaf,1,oleewere,2016-07-06 16:25:03+02:00,['0caf76005b04b8fa90e3d76f295d5ad53323bab4'],43,129,172,23304825,11,0,1,0.741176471,25466
caa7b9c37f964fceddeb58e6cd650a3845df8560,1,oleewere,2016-07-06 16:25:03+02:00,['e4571de18bc472fca44c8a14f25faf1a6c002eaf'],2,12,14,23304839,2,,,,25466
bba526e3dbfbe47c34bfd5dbf4b1437ae51b0e56,1,oleewere,2016-07-06 16:25:03+02:00,['caa7b9c37f964fceddeb58e6cd650a3845df8560'],1,26,27,23304866,4,,,,25466
6d00d3988d37353e009cade9458c534b5e3d83d9,1,Andrew Onishuk,2016-07-06 17:58:17+03:00,['bba526e3dbfbe47c34bfd5dbf4b1437ae51b0e56'],1,1,2,23304868,1,,,,25466
445bf7aff5b955bcd6cd7571eba15e3250819e6c,0,Myroslav Papirkovskyi,2016-07-06 18:13:08+03:00,['6d00d3988d37353e009cade9458c534b5e3d83d9'],1,5,6,23304874,2,0.75,0.75,1,25466
c510a2db4faf50ebb942bba0491c53952b92958a,1,Alex Antonenko,2016-07-06 19:11:37+03:00,['445bf7aff5b955bcd6cd7571eba15e3250819e6c'],0,3,3,23304877,1,0,0,1,25466
a6644d2459b9c0579674956862ce35c1cd89241d,1,Alex Antonenko,2016-07-06 19:11:37+03:00,['c510a2db4faf50ebb942bba0491c53952b92958a'],1,1,2,23304879,1,,,,25466
26d2542d213a7d63d90d9296155039232c50c7c1,1,Alex Antonenko,2016-07-06 19:15:51+03:00,['a6644d2459b9c0579674956862ce35c1cd89241d'],3,46,49,23304928,2,0.41025641,1,1,25466
af546930f2b3e8c33d4e2fbcbf9bf054050b2763,1,Aleksandr Kovalenko,2016-07-06 19:41:06+03:00,['26d2542d213a7d63d90d9296155039232c50c7c1'],5,58,63,23304991,2,1,1,1,25466
eb05baed568bab4b0cf5f1b5e0bac0fff251a622,1,Alejandro Fernandez,2016-07-06 11:59:54-07:00,['af546930f2b3e8c33d4e2fbcbf9bf054050b2763'],284,424,708,23305699,24,1,0.761904762,0,25470
c5cd33747d666af037ea67ae03000d9501251aab,1,Dipayan Bhowmick,2016-07-07 01:34:57+05:18,['eb05baed568bab4b0cf5f1b5e0bac0fff251a622'],1,1,2,23305701,1,,,,25470
9ce097521ee724da5d83160a84829901c2facafe,0,Alejandro Fernandez,2016-07-06 13:29:01-07:00,['c5cd33747d666af037ea67ae03000d9501251aab'],16,2,18,23305719,4,,,,25470
73111e81dd7b78ab458ae8d147eeedce0cb61d1a,1,Alejandro Fernandez,2016-07-06 15:00:07-07:00,['9ce097521ee724da5d83160a84829901c2facafe'],1,2,3,23305722,1,,,,25470
9f3d1c9c122bc76a3f55d95b0841b1e13d7e9f9b,1,Sumit Mohanty,2016-07-06 15:09:06-07:00,['73111e81dd7b78ab458ae8d147eeedce0cb61d1a'],0,5,5,23305727,1,,,,25470
cdc7e0cc6349a6aecd06184fe66c1eb06f1c6176,0,Bhuvnesh Chaudhary,2016-07-06 15:38:26-07:00,['9f3d1c9c122bc76a3f55d95b0841b1e13d7e9f9b'],1,2,3,23305730,2,,,,25470
0df3f28577d0cb0ed36d923669ca2c1a16985601,0,Bhuvnesh Chaudhary,2016-07-06 16:02:34-07:00,['cdc7e0cc6349a6aecd06184fe66c1eb06f1c6176'],0,12,12,23305742,1,,,,25470
9c29d8495fb92806e85d95bc6d2a7e21f86e1b1c,0,Zhe (Joe) Wang,2016-07-06 17:37:25-07:00,['0df3f28577d0cb0ed36d923669ca2c1a16985601'],0,4,4,23305746,2,,,,25470
4c8a42b83a2abd19382d154838bb047f64694df3,1,Siddharth Wagle,2016-07-06 17:47:36-07:00,['9c29d8495fb92806e85d95bc6d2a7e21f86e1b1c'],1,5,6,23305752,1,0,0,1,25470
92943cf6d82f165d9651939c16ac1f70d97c75a9,0,Nahappan Somasundaram,2016-07-06 18:08:03-07:00,['4c8a42b83a2abd19382d154838bb047f64694df3'],1,2,3,23305755,1,,,,25470
5ce987a5c072eb93f78e36d6ac881b60e5c211ea,0,Jayush Luniya,2016-07-07 00:32:04-07:00,['92943cf6d82f165d9651939c16ac1f70d97c75a9'],20,168,188,23305943,8,0,0.404494382,0.573033708,25470
e0f3b534b180281842f9a141b13a4b4de7d90696,1,Andrew Onishuk,2016-07-07 12:45:09+03:00,['5ce987a5c072eb93f78e36d6ac881b60e5c211ea'],21,200,221,23306164,8,0.202898551,0.862318841,0.753623188,25470
d0d8c2b6a8fdc6c0524ee0dc766a28a06da00f3d,0,Andrew Onishuk,2016-07-07 15:14:50+03:00,['e0f3b534b180281842f9a141b13a4b4de7d90696'],13,13,26,23306190,3,,,,25470
da8f37d09768afb9ba92d747a7c3111c8229679e,1,Dipayan Bhowmick,2016-07-07 17:38:34+05:18,['d0d8c2b6a8fdc6c0524ee0dc766a28a06da00f3d'],4,732,736,23306926,11,0.389880952,1,1,25476
624c21bdf3d395ef2d4ccd5c75c0392add211033,1,Di Li,2016-07-07 10:24:09-04:00,['da8f37d09768afb9ba92d747a7c3111c8229679e'],2,2232,2234,23309160,24,0.539920949,0.939130435,1,25489
4eb2be46e21c9a4dd94785985acb8a9818ef246d,1,oleewere,2016-07-07 17:38:28+02:00,['624c21bdf3d395ef2d4ccd5c75c0392add211033'],1,2,3,23309163,1,1,1,1,25489
629a893aa287ab4fd9a33f69d9101e42e8d182b9,1,Andrii Tkach,2016-07-07 18:57:51+03:00,['4eb2be46e21c9a4dd94785985acb8a9818ef246d'],168,20,188,23309351,8,1,0.595505618,0.426966292,25489
2913de53c82524ae44270ce52b561f457f47a37c,1,Robert Levas,2016-07-07 12:01:13-04:00,['629a893aa287ab4fd9a33f69d9101e42e8d182b9'],43,106,149,23309500,3,0.1,0.5,0.5,25489
bba27c81351eaefe8b3e147936b72548eccfffbe,1,Alex Antonenko,2016-07-07 19:09:55+03:00,['2913de53c82524ae44270ce52b561f457f47a37c'],287,298,585,23310085,6,0,1,0.8,25489
1b4d0d5ff220fc341a1e2044444ba6632adb1cf9,1,Andrew Onishuk,2016-07-07 19:15:33+03:00,['bba27c81351eaefe8b3e147936b72548eccfffbe'],4,4,8,23310093,3,,,,25489
1d2e093cee8c5af3956b1bdd72ac5863ac336ca4,1,Andrew Onishuk,2016-07-07 19:18:31+03:00,['1b4d0d5ff220fc341a1e2044444ba6632adb1cf9'],48,47,95,23310188,2,,,,25489
862ba70b1fa8bc262f55147313ec13d7f9339294,1,Alex Antonenko,2016-07-07 19:23:02+03:00,['1d2e093cee8c5af3956b1bdd72ac5863ac336ca4'],3,187,190,23310378,6,0.392638037,1,1,25489
79d76898b9a880f20910770029747dc8fe3fbc09,0,Srimanth Gunturi,2016-07-07 10:37:34-07:00,['862ba70b1fa8bc262f55147313ec13d7f9339294'],4,4,8,23310386,3,,,,25489
b166a020d0784192d899ed333a0883176c8ef53e,0,Srimanth Gunturi,2016-07-07 10:50:34-07:00,['79d76898b9a880f20910770029747dc8fe3fbc09'],0,2,2,23310388,1,,,,25489
4331b29a7b2f36287369085ae50c5a0435fd13f3,0,Alejandro Fernandez,2016-07-07 11:08:36-07:00,['b166a020d0784192d899ed333a0883176c8ef53e'],1,1,2,23310390,1,,,,25489
5711f39c1a677647655c576101f9c33bac7732e2,0,Yusaku Sako,2016-07-07 12:39:45-07:00,['4331b29a7b2f36287369085ae50c5a0435fd13f3'],3,4,7,23310397,1,1,1,1,25489
5f715c881f15f70cedf8397625386ed020ea651e,1,Jayush Luniya,2016-07-07 13:00:14-07:00,['5711f39c1a677647655c576101f9c33bac7732e2'],0,5,5,23310402,1,0,1,0,25489
0696a804c12b2a0b88a1961853e58ba48fc34e86,1,Srimanth Gunturi,2016-07-07 13:34:21-07:00,['5f715c881f15f70cedf8397625386ed020ea651e'],2,25,27,23310429,5,1,1,1,25489
5e4faf1ea928695e6dc5e1ace3dd1a0f1636890e,0,Srimanth Gunturi,2016-07-07 14:25:13-07:00,['0696a804c12b2a0b88a1961853e58ba48fc34e86'],11,25,36,23310465,9,0.5,1,0,25489
d9d943e0218ab1508d0dc466a4c277bc3adf450c,1,Sumit Mohanty,2016-07-07 15:41:35-07:00,['5e4faf1ea928695e6dc5e1ace3dd1a0f1636890e'],29,168,197,23310662,8,0,0.404494382,0.573033708,25489
fb12a7793d1dac778b499b80481a9ef7bd741173,1,Sumit Mohanty,2016-07-07 22:02:43-07:00,['d9d943e0218ab1508d0dc466a4c277bc3adf450c'],0,69,69,23310731,1,,,,25489
e6b2f1ebee8d52aaa4b07478e2b525041c2ea487,1,Ajit Kumar,2016-07-07 23:46:31-07:00,['fb12a7793d1dac778b499b80481a9ef7bd741173'],310,212,522,23311253,18,1,0,0,25489
4804954a3afe259d96d8daa38f69c4d7b4b72e31,1,Dipayan Bhowmick,2016-07-08 14:32:58+05:18,['e6b2f1ebee8d52aaa4b07478e2b525041c2ea487'],2,26,28,23311281,2,0.954545455,1,1,25489
f544490966772c5ef0ae74c1307f4c3af76d4eda,1,Andrew Onishuk,2016-07-08 12:45:06+03:00,['4804954a3afe259d96d8daa38f69c4d7b4b72e31'],5,61,66,23311347,6,0,0.210526316,0.210526316,25489
fda5b78d8daf6994870c56ab35416dc2b6b9cbfd,1,Andrew Onishuk,2016-07-08 15:06:38+03:00,['f544490966772c5ef0ae74c1307f4c3af76d4eda'],1,8,9,23311356,2,,,,25489
7df5b8203c8bd598d8aaa751137917a380110d64,0,Andrew Onishuk,2016-07-08 18:52:03+03:00,['fda5b78d8daf6994870c56ab35416dc2b6b9cbfd'],3,2,5,23311361,1,1,1,0,25489
587050eacfca697eeecb55be238823f7843eb003,1,Jayush Luniya,2016-07-08 09:52:54-07:00,['7df5b8203c8bd598d8aaa751137917a380110d64'],40,258,298,23311659,8,0.19266055,0.577981651,0.146788991,25492
7ab2c06b98af0c3cae7bf77c1f17671b31d25f52,1,Alex Antonenko,2016-07-08 21:14:22+03:00,['587050eacfca697eeecb55be238823f7843eb003'],2,6,8,23311667,3,0.75,1,1,25492
5bd13d1a2f83422112243e3afc27aba7e66c831a,1,Xi Wang,2016-07-08 11:15:26-07:00,['7ab2c06b98af0c3cae7bf77c1f17671b31d25f52'],15,47,62,23311729,4,1,1,1,25492
97b8bb62922b91951bc4a487bd01c8da53288aa2,1,Alejandro Fernandez,2016-07-08 12:46:54-07:00,['5bd13d1a2f83422112243e3afc27aba7e66c831a'],299,848,1147,23312876,11,1,1,0,25494
93ee6e9af043c4bad4423d47bbed768d7304ef00,1,Jaimin Jetly,2016-07-08 13:34:28-07:00,['97b8bb62922b91951bc4a487bd01c8da53288aa2'],3,99,102,23312978,2,1,1,1,25494
134f370e3faf79604002f52c5408312b5e113bfd,0,Yusaku Sako,2016-07-08 16:08:30-07:00,['93ee6e9af043c4bad4423d47bbed768d7304ef00'],0,24,24,23313002,1,,,,25494
3f5578021d8a269f92724d1aafd910f8f9b9afb0,1,Gautam Borad,2016-07-09 13:40:50+05:18,['134f370e3faf79604002f52c5408312b5e113bfd'],8,8,16,23313018,1,,,,25494
278719378277201dbbf52c7c2a870042b2b8ea4a,1,Andrew Onishuk,2016-07-09 17:57:17+03:00,['3f5578021d8a269f92724d1aafd910f8f9b9afb0'],55,29,84,23313102,9,1,0,0,25494
ee05acaab71eb0caa2630bdbfe1aa9eae0582963,1,oleewere,2016-07-10 00:49:19+02:00,['278719378277201dbbf52c7c2a870042b2b8ea4a'],5,7,12,23313114,2,1,1,1,25494
5f28680069447046d5fb63e68d35a1ed7415e7e8,0,Andrew Onishuk,2016-07-10 15:44:47+03:00,['ee05acaab71eb0caa2630bdbfe1aa9eae0582963'],3,3,6,23313120,1,,,,25494
49396c4ed14ea0d507c60b7389a86fc55d68f74f,0,Sumit Mohanty,2016-07-10 16:56:58-07:00,['5f28680069447046d5fb63e68d35a1ed7415e7e8'],2,2,4,23313124,2,,,,25494
8858cb604a5488e84eb8fa68cf04d4790015394a,0,Sumit Mohanty,2016-07-10 20:50:45-07:00,['49396c4ed14ea0d507c60b7389a86fc55d68f74f'],8,345,353,23313477,6,0,0.392857143,0.607142857,25496
a92c126212d54cdeb304ae86e45bfbd7f6ea1031,0,Sumit Mohanty,2016-07-10 20:55:57-07:00,['8858cb604a5488e84eb8fa68cf04d4790015394a'],345,8,353,23313830,6,1,0.607142857,0.392857143,25496
0ab0a22bd7a3cbf261ccb73c74f89025dc6fbdd8,1,Sumit Mohanty,2016-07-10 20:57:43-07:00,['a92c126212d54cdeb304ae86e45bfbd7f6ea1031'],8,92,100,23313930,5,0,0.392857143,0.607142857,25497
2715ebacc014cddd57ac9bed0103b85a87bf0a81,1,Gautam Borad,2016-07-11 10:17:47+05:18,['0ab0a22bd7a3cbf261ccb73c74f89025dc6fbdd8'],8,8,16,23313946,1,,,,25497
8bafc4ec5b911c36484255e382084c757075f697,0,Dmytro Sen,2016-07-11 09:52:15+03:00,['2715ebacc014cddd57ac9bed0103b85a87bf0a81'],0,2,2,23313948,1,,,,25497
dcefe390236d583ce623739072cb41e709c24154,1,Andrew Onishuk,2016-07-11 13:02:11+03:00,['8bafc4ec5b911c36484255e382084c757075f697'],6,3,9,23313957,2,1,0.333333333,0,25497
a377f74f27c835eac0dc2f6ad5a8d0a6780fc9e9,1,ababiichuk,2016-07-11 13:35:43+03:00,['dcefe390236d583ce623739072cb41e709c24154'],6,47,53,23314010,4,0.848484848,0.424242424,0.515151515,25497
bc8791ef7cedd000b85888077cfa20b6c4ba1964,1,Robert Levas,2016-07-11 09:34:03-04:00,['a377f74f27c835eac0dc2f6ad5a8d0a6780fc9e9'],16,18,34,23314044,3,0,0,1,25497
17ae4230d01bfe89f78c1d6bef95d32d151b076e,0,Pallav Kulshreshtha,2016-07-11 19:39:46+05:18,['bc8791ef7cedd000b85888077cfa20b6c4ba1964'],4,18,22,23314066,1,0,0,1,25497
e5350040d4742cd1eaef62372a306f4c5d25403d,1,Pallav Kulshreshtha,2016-07-11 19:46:13+05:18,['17ae4230d01bfe89f78c1d6bef95d32d151b076e'],25,36,61,23314127,2,0,0,1,25497
8e3b1ff61f2c987fa740b74f8ef099303831379c,1,Pallav Kulshreshtha,2016-07-11 19:52:35+05:18,['e5350040d4742cd1eaef62372a306f4c5d25403d'],41,16,57,23314184,3,0,1,1,25497
15e58ecc283b32458920ed1c167e746ba335a05e,1,oleewere,2016-07-11 16:43:37+02:00,['8e3b1ff61f2c987fa740b74f8ef099303831379c'],4,4,8,23314192,2,,,,25497
e8bfdb9248d8b305650555c7a7d2b230a163639b,0,Sandor Magyari,2016-07-11 17:02:45+02:00,['15e58ecc283b32458920ed1c167e746ba335a05e'],3,7,10,23314202,2,,,,25497
6c03848a724ea3cf004f49f6ef09f0f0f164802c,0,Andrew Onishuk,2016-07-11 18:35:34+03:00,['e8bfdb9248d8b305650555c7a7d2b230a163639b'],8,34,42,23314244,2,1,0.368421053,0.368421053,25497
31e2c30b9cae7bdf4cc99bca27f759a66ae1738c,0,Lisnichenko Dmitro,2016-07-11 18:54:34+03:00,['6c03848a724ea3cf004f49f6ef09f0f0f164802c'],34,59,93,23314337,7,0.3,1,1,25497
8a2f5ccfebc59518a85c94f8a7e43009c1125e7d,1,Alex Antonenko,2016-07-11 19:07:31+03:00,['31e2c30b9cae7bdf4cc99bca27f759a66ae1738c'],1,1,2,23314339,1,,,,25497
70ac854c70b17d6b8de07fc3bacf46504ad0fe9a,1,Alex Antonenko,2016-07-11 19:07:31+03:00,['8a2f5ccfebc59518a85c94f8a7e43009c1125e7d'],2,2,4,23314343,1,,,,25497
ce2c123f9c7f4c64078a2aab0bfb27fd277bff65,1,Andrew Onishuk,2016-07-11 19:41:55+03:00,['70ac854c70b17d6b8de07fc3bacf46504ad0fe9a'],5,93,98,23314441,4,0,0,1,25497
376ac438988bc32451ed030601ab13524692dc53,0,Jayush Luniya,2016-07-11 10:24:35-07:00,['ce2c123f9c7f4c64078a2aab0bfb27fd277bff65'],161,29,190,23314631,3,1,1,0.916666667,25497
9e8d297348f11c54a68917ed452caadc656b43f2,1,Jayush Luniya,2016-07-11 16:37:48-07:00,['376ac438988bc32451ed030601ab13524692dc53'],4,4,8,23314639,3,,,,25497
624fb1c84d1be33b5c4c9d93293a7aa9717edfcc,0,Richard Zang,2016-07-11 17:55:18-07:00,['9e8d297348f11c54a68917ed452caadc656b43f2'],5,6,11,23314650,1,1,1,1,25497
29185fad2a3333fdadd6c42f6fbce434ee8a9393,0,Jonathan Hurley,2016-07-11 21:42:01-04:00,['624fb1c84d1be33b5c4c9d93293a7aa9717edfcc'],20,0,20,23314670,10,,,,25497
8be77911e3d8ab86304297c05e76970f148395d4,1,Jonathan Hurley,2016-07-11 22:11:25-04:00,['29185fad2a3333fdadd6c42f6fbce434ee8a9393'],59,34,93,23314763,7,0.7,0,0,25497
e724158430a00b52c8626fcceb9ce6b971bf4aed,0,Gautam Borad,2016-07-12 10:15:22+05:18,['8be77911e3d8ab86304297c05e76970f148395d4'],25,11,36,23314799,9,0.5,0,1,25497
b7d76567d08d8b7f484f8525cde8647059143950,1,Dipayan Bhowmick,2016-07-12 11:36:12+05:18,['e724158430a00b52c8626fcceb9ce6b971bf4aed'],11,1,12,23314811,2,,,,25497
d669b9608de31e8dfb0743945ef6fe23b2c1e136,1,Pallav Kulshreshtha,2016-07-12 12:37:14+05:18,['b7d76567d08d8b7f484f8525cde8647059143950'],1,10,11,23314822,1,0,0,1,25497
bafb1ff36fb1c1af5d4b2790e83c846006143e37,1,ababiichuk,2016-07-12 10:56:59+03:00,['d669b9608de31e8dfb0743945ef6fe23b2c1e136'],1,6,7,23314829,1,1,1,1,25497
942974b8fbfd2f66be18260b90e61f1a78c3f7a9,1,Andrew Onishuk,2016-07-12 11:01:08+03:00,['bafb1ff36fb1c1af5d4b2790e83c846006143e37'],4,16,20,23314849,2,0.272727273,1,0.272727273,25497
7b271f5c576e8186c91a230aac8f89f25a1d37f6,0,Andrew Onishuk,2016-07-12 12:19:15+03:00,['942974b8fbfd2f66be18260b90e61f1a78c3f7a9'],2,2,4,23314853,1,,,,25497
eab400bde7790e1aaafa9d56a2994de98e747f8c,1,oleewere,2016-07-12 11:51:44+02:00,['7b271f5c576e8186c91a230aac8f89f25a1d37f6'],8,8,16,23314869,1,,,,25497
401106bda3467241b3c8e37b690ce9ced2d91477,1,oleewere,2016-07-12 11:59:12+02:00,['eab400bde7790e1aaafa9d56a2994de98e747f8c'],0,339,339,23315208,1,,,,25498
e0b9e20b2e31a013d5bc9f06ebcd29851df42900,1,Aleksandr Kovalenko,2016-07-12 13:49:33+03:00,['401106bda3467241b3c8e37b690ce9ced2d91477'],114,182,296,23315504,7,0.323529412,1,1,25498
694435a30243763b2394b28a7a5893a175d753fa,1,Sandor Magyari,2016-07-12 15:45:08+02:00,['e0b9e20b2e31a013d5bc9f06ebcd29851df42900'],4,16,20,23315524,2,0,0.8,1,25498
b3226b35aec96ed3d0ed3d7c55bd02013b5975d2,1,oleewere,2016-07-12 16:18:24+02:00,['694435a30243763b2394b28a7a5893a175d753fa'],38,60,98,23315622,2,0.388888889,1,1,25498
0e73da6efddf15aaae724ac7665764a25a713497,1,oleewere,2016-07-12 17:22:25+02:00,['b3226b35aec96ed3d0ed3d7c55bd02013b5975d2'],5646,1214,6860,23322482,45,0.552264808,0.74912892,0.602787456,25511
bf0397d7feda5f5ef06192c2908d221a078fd9af,0,Alex Antonenko,2016-07-12 19:02:19+03:00,['0e73da6efddf15aaae724ac7665764a25a713497'],1,1,2,23322484,1,,,,25511
ffb1ae7acbef73ee3fdb7f5176131b8024bb45ce,1,Dmytro Sen,2016-07-12 19:16:52+03:00,['bf0397d7feda5f5ef06192c2908d221a078fd9af'],14,59,73,23322557,9,0.133333333,1,1,25511
f2cf759a5fd1162bc37570b48d2e67494fd070b5,1,Swapan Shridhar,2016-07-12 10:52:02-07:00,['ffb1ae7acbef73ee3fdb7f5176131b8024bb45ce'],8,12,20,23322577,3,0,0,0,25511
7a7d757721b277134f73f5664ec8ab909929c84d,1,Aravindan Vijayan,2016-07-12 13:20:40-07:00,['f2cf759a5fd1162bc37570b48d2e67494fd070b5'],77,121,198,23322775,6,0.083333333,0.75,0.75,25511
4a3caaabcce12876a2e6e08f6c80afcb64d4141f,1,Jonathan Hurley,2016-07-12 16:37:45-04:00,['7a7d757721b277134f73f5664ec8ab909929c84d'],73,405,478,23323253,9,0.31147541,1,1,25514
01043c0c459d197064f90280892267e191301735,1,Alejandro Fernandez,2016-07-12 13:48:08-07:00,['4a3caaabcce12876a2e6e08f6c80afcb64d4141f'],221,58,279,23323532,6,0.963855422,0.144578313,0.144578313,25514
9be254b714dfe6cdbe3baab1b7f0e6ac75f27dd6,0,Sumit Mohanty,2016-07-12 14:26:24-07:00,['01043c0c459d197064f90280892267e191301735'],2,2,4,23323536,1,,,,25514
287df64992ed34537fd9f2d1dad733714e54f925,0,Di Li,2016-07-12 17:31:43-04:00,['9be254b714dfe6cdbe3baab1b7f0e6ac75f27dd6'],3,6,9,23323545,1,0,0,1,25514
df8bc26aef0dde66c5fd1b18a6ce8fa7f3871453,0,Siddharth Wagle,2016-07-12 15:44:03-07:00,['287df64992ed34537fd9f2d1dad733714e54f925'],1,1,2,23323547,1,,,,25514
1cdbb353dda0c2100d84335a3cf99f0689eb516e,0,Sumit Mohanty,2016-07-12 16:04:03-07:00,['df8bc26aef0dde66c5fd1b18a6ce8fa7f3871453'],0,9,9,23323556,1,,,,25514
028607ac8fb8f435293529d6706ee2332edbf98a,1,Sumit Mohanty,2016-07-12 21:09:51-07:00,['1cdbb353dda0c2100d84335a3cf99f0689eb516e'],3,3,6,23323562,1,,,,25514
ef2860810c2368eb60f2245451c0e009efde7dab,0,Sumit Mohanty,2016-07-12 21:17:18-07:00,['028607ac8fb8f435293529d6706ee2332edbf98a'],0,1,1,23323563,1,,,,25514
4c686e1efdd62e83097b076cf42ba935e3b98445,0,Pallav Kulshreshtha,2016-07-13 11:28:42+05:18,['ef2860810c2368eb60f2245451c0e009efde7dab'],64,0,64,23323627,2,1,0,0,25514
3bcd1304b3da87c3b2d9635fd3ff968342dbffe5,0,Lisnichenko Dmitro,2016-07-13 10:34:01+03:00,['4c686e1efdd62e83097b076cf42ba935e3b98445'],1,1,2,23323629,1,,,,25514
07696c87dfe8e2cc816c0634f8c86cfdd2e54d9b,1,Dmytro Sen,2016-07-13 13:09:04+03:00,['3bcd1304b3da87c3b2d9635fd3ff968342dbffe5'],25,25,50,23323679,3,0.764705882,1,1,25514
a4a7a569f03ccfe1b9cee0b64231dcf20eb1c28e,1,Dmytro Sen,2016-07-13 13:12:51+03:00,['07696c87dfe8e2cc816c0634f8c86cfdd2e54d9b'],21,245,266,23323945,10,,,,25514
e23e922b9c73610b399ec687c1ed7d99646218f2,1,oleewere,2016-07-13 12:14:08+02:00,['a4a7a569f03ccfe1b9cee0b64231dcf20eb1c28e'],0,14,14,23323959,2,0.7,1,1,25514
0ecad6dfc09e6a9256f8ec97308bd26641d54b1d,1,Dipayan Bhowmick,2016-07-13 15:44:13+05:18,['e23e922b9c73610b399ec687c1ed7d99646218f2'],15,105,120,23324079,11,0.421052632,0.868421053,0.052631579,25514
a5ff53ce81b95324a773c493ef9e8ea20e5e332b,0,Andrew Onishuk,2016-07-13 14:38:25+03:00,['0ecad6dfc09e6a9256f8ec97308bd26641d54b1d'],1,1,2,23324081,1,,,,25514
99bb025ad4234c219e30f8c2c5d7695b5ff1768d,1,Andrew Onishuk,2016-07-13 15:53:23+03:00,['a5ff53ce81b95324a773c493ef9e8ea20e5e332b'],12,7,19,23324100,5,,,,25514
10a943687c7e9b2531a1d771099865b1c99f1636,0,Gautam Borad,2016-07-13 18:42:43+05:18,['99bb025ad4234c219e30f8c2c5d7695b5ff1768d'],4,4,8,23324108,3,,,,25514
0021fa886f02582aa0824d3d878913a956edfd85,1,Andrii Tkach,2016-07-13 20:09:38+03:00,['10a943687c7e9b2531a1d771099865b1c99f1636'],3,1,4,23324112,1,0,0,0,25514
2e0a543f0608e0cef2baf4e9ba7521267af3d8b9,1,Jayush Luniya,2016-07-13 10:39:01-07:00,['0021fa886f02582aa0824d3d878913a956edfd85'],22,257,279,23324391,11,0.016393443,0.508196721,0,25520
1f2f81baf82aa9b75005875c99227788622a6f6c,0,Nate Cole,2016-07-13 14:18:28-04:00,['2e0a543f0608e0cef2baf4e9ba7521267af3d8b9'],7,47,54,23324445,2,0,0.740740741,1,25520
ee36cfeb8da8b17565f7cdf30d92d2a9b37ebf91,1,Srimanth Gunturi,2016-07-13 13:30:36-07:00,['1f2f81baf82aa9b75005875c99227788622a6f6c'],372,780,1152,23325597,14,0.511002445,1,0.877750611,25522
6f7d69aee85c7efbed81ec8687d2e7b0ee1d9092,0,Aravindan Vijayan,2016-07-13 14:10:52-07:00,['ee36cfeb8da8b17565f7cdf30d92d2a9b37ebf91'],6,0,6,23325603,1,,,,25522
4426ebc54149319f2a8160435700e0a6666d8f65,0,Aravindan Vijayan,2016-07-13 14:25:28-07:00,['6f7d69aee85c7efbed81ec8687d2e7b0ee1d9092'],2,4,6,23325609,2,0,1,1,25522
b22ab8cd2e2b890c4c0266a1c41c0d664ce5d587,0,Siddharth Wagle,2016-07-13 14:31:52-07:00,['4426ebc54149319f2a8160435700e0a6666d8f65'],2,2,4,23325613,1,,,,25522
d18aebb5202ca05b2a67f3ff47e5197f48506052,0,Alejandro Fernandez,2016-07-13 14:41:31-07:00,['b22ab8cd2e2b890c4c0266a1c41c0d664ce5d587'],1,1,2,23325615,1,,,,25522
628a6e638ff0c24f78ed61ad21cf94521c5a2450,0,Siddharth Wagle,2016-07-13 14:40:35-07:00,['d18aebb5202ca05b2a67f3ff47e5197f48506052'],1,9,10,23325625,9,,,,25522
2b33241817dff5ac69529052ae3642227fab0855,1,Siddharth Wagle,2016-07-13 14:47:57-07:00,['628a6e638ff0c24f78ed61ad21cf94521c5a2450'],2,244,246,23325871,5,0.16097561,0.804878049,0.317073171,25522
d1207f5502cb75d29463c01ec9bb923010204381,1,Xi Wang,2016-07-13 14:54:05-07:00,['2b33241817dff5ac69529052ae3642227fab0855'],3,5,8,23325879,2,0,1,1,25522
3f37558bcea0e67e46dc3e075f41e45d15cf8f7a,1,Alejandro Fernandez,2016-07-13 15:32:45-07:00,['d1207f5502cb75d29463c01ec9bb923010204381'],40,95,135,23326014,13,0,1,1,25522
f0809e2a317996a7ccf5110b9b99775448ea6bfe,0,Sumit Mohanty,2016-07-13 15:44:16-07:00,['3f37558bcea0e67e46dc3e075f41e45d15cf8f7a'],6,40,46,23326060,2,,,,25522
1d050d21c9bbaf8e2a743c8b1bda3c5e3b5d5cd8,0,Alex Antonenko,2016-07-14 02:18:10+03:00,['f0809e2a317996a7ccf5110b9b99775448ea6bfe'],1,3,4,23326064,1,1,1,0,25522
1253e9be03572f27308e4c49ea65b89c2a2882d1,0,Srimanth Gunturi,2016-07-13 17:38:01-07:00,['1d050d21c9bbaf8e2a743c8b1bda3c5e3b5d5cd8'],1,3,4,23326068,1,,,,25522
c8e6754a3c40f4f158b6232b0fd9011065e38750,0,Srimanth Gunturi,2016-07-13 17:44:56-07:00,['1253e9be03572f27308e4c49ea65b89c2a2882d1'],2,2,4,23326072,2,,,,25522
38a6183b5c273c6b5ffe52fda40edf99ee7a57ba,1,Dipayan Bhowmick,2016-07-14 11:07:28+05:18,['c8e6754a3c40f4f158b6232b0fd9011065e38750'],1,13,14,23326086,1,,,,25522
011c7d53fd8af971820b5b2cfb6dc071a56e2a2f,0,ababiichuk,2016-07-14 12:03:00+03:00,['38a6183b5c273c6b5ffe52fda40edf99ee7a57ba'],1,1,2,23326088,1,,,,25522
19322e1151ebc71de96b47bd381e7420237c219e,0,Andrew Onishuk,2016-07-14 13:03:56+03:00,['011c7d53fd8af971820b5b2cfb6dc071a56e2a2f'],6,5,11,23326099,1,1,1,1,25522
b515ff95dc3ae7ec6d301606935b84ce5ad63b83,1,ababiichuk,2016-07-14 15:46:03+03:00,['19322e1151ebc71de96b47bd381e7420237c219e'],2,13,15,23326114,4,1,1,1,25522
33e1f301fc2d5eecd8357c341801ba7a41319948,1,Dipayan Bhowmick,2016-07-14 19:04:24+05:18,['b515ff95dc3ae7ec6d301606935b84ce5ad63b83'],16,55,71,23326185,4,0.944444444,0.944444444,0.944444444,25522
0dfe6ed1865d927816967a059f30683b15bf1461,1,Jonathan Hurley,2016-07-14 11:44:27-04:00,['33e1f301fc2d5eecd8357c341801ba7a41319948'],76,92,168,23326353,14,,,,25522
eeb6f4265f95c77822dc3ad2eda1f3b5f239be4d,1,Pallav Kulshreshtha,2016-07-14 21:30:26+05:18,['0dfe6ed1865d927816967a059f30683b15bf1461'],0,20,20,23326373,2,0.428571429,1,1,25522
0c29c334f0ad8dbf121f21b613a3b76ca4c9ed17,1,Jonathan Hurley,2016-07-14 12:25:53-04:00,['eeb6f4265f95c77822dc3ad2eda1f3b5f239be4d'],1,1,2,23326375,1,,,,25522
9d695478d898fcacd54c183bd7e4e5b03bc3e296,0,Yusaku Sako,2016-07-14 10:18:07-07:00,['0c29c334f0ad8dbf121f21b613a3b76ca4c9ed17'],144,183,327,23326702,22,,,,25522
1f628f8c3ca4854ad947560261f1ba8b0d97c0ca,0,Jaimin Jetly,2016-07-14 12:17:56-07:00,['9d695478d898fcacd54c183bd7e4e5b03bc3e296'],2,29,31,23326733,2,1,1,1,25522
df69808589928049e29f7a8a537734442bd7bee5,1,Swapan Shridhar,2016-07-14 12:56:35-07:00,['1f628f8c3ca4854ad947560261f1ba8b0d97c0ca'],17,53,70,23326803,3,0.909090909,0.909090909,0.136363636,25522
c09eeac1f1cfc87284a98f08d51b2d8457f56d0e,1,Myroslav Papirkovskyi,2016-07-14 23:00:11+03:00,['df69808589928049e29f7a8a537734442bd7bee5'],13,15,28,23326831,2,0,0,0,25522
7d3bec57ac072a9dd5a04d3cb08219193c484196,0,Richard Zang,2016-07-14 13:06:25-07:00,['c09eeac1f1cfc87284a98f08d51b2d8457f56d0e'],3,4,7,23326838,2,1,0.4,0,25522
b8c3c4d32c549bb4d3d22b4c62af98269c6526da,1,Sumit Mohanty,2016-07-14 14:03:06-07:00,['7d3bec57ac072a9dd5a04d3cb08219193c484196'],2,20,22,23326860,2,0,0,0,25522
85e6c37fdc2e2613218b3defdc1121b06cb3db2f,1,Mahadev Konar,2016-07-14 16:06:44-07:00,['b8c3c4d32c549bb4d3d22b4c62af98269c6526da'],1,1,2,23326862,1,,,,25522
885b7ae6b6eac555eb7ff8df1a159f8727d86866,1,Sumit Mohanty,2016-07-14 16:17:52-07:00,['85e6c37fdc2e2613218b3defdc1121b06cb3db2f'],0,2,2,23326864,1,,,,25522
18cfea6f869fccd7d029640265baeae63b10a51a,1,Siddharth Wagle,2016-07-14 16:38:34-07:00,['885b7ae6b6eac555eb7ff8df1a159f8727d86866'],37,54,91,23326955,6,0.636363636,1,0.545454545,25522
15fd5e43162c703d37451474a7a940957b7bb870,0,Siddharth Wagle,2016-07-14 16:38:34-07:00,['18cfea6f869fccd7d029640265baeae63b10a51a'],263,525,788,23327743,8,,,,25522
64b25304f65ba526e0837cc60e9683aac213228e,1,Nahappan Somasundaram,2016-07-14 16:47:38-07:00,['15fd5e43162c703d37451474a7a940957b7bb870'],28,28,56,23327799,1,,,,25522
c3d738c6aed3bad135ae4aecfdab94c9fb5d7f42,1,Robert Levas,2016-07-14 20:40:16-04:00,['64b25304f65ba526e0837cc60e9683aac213228e'],191,304,495,23328294,7,0,0.595744681,0.914893617,25522
433286dc662f1213cd5e40ba49d25cbe8c99e25a,0,Sumit Mohanty,2016-07-14 21:21:25-07:00,['c3d738c6aed3bad135ae4aecfdab94c9fb5d7f42'],8,7,15,23328309,1,,,,25522
f85e55c1812a1130f147e7ab7c128a026052e474,0,Alex Antonenko,2016-07-15 09:00:57+03:00,['433286dc662f1213cd5e40ba49d25cbe8c99e25a'],30,30,60,23328369,5,,,,25522
3c4595e7a8c2d29b2f661d03fd4bf586ea52a225,0,Alex Antonenko,2016-07-15 09:00:57+03:00,['f85e55c1812a1130f147e7ab7c128a026052e474'],4,49,53,23328422,2,0.409090909,1,1,25522
0c1830c2092e065f7d3c32399e16f50e5edefc32,1,Lisnichenko Dmitro,2016-07-15 12:49:30+03:00,['3c4595e7a8c2d29b2f661d03fd4bf586ea52a225'],17,17,34,23328456,11,,,,25522
706e3aa27a506d48fa5fff990ae5ea8ef0d33b7b,0,Andrew Onishuk,2016-07-15 13:14:56+03:00,['0c1830c2092e065f7d3c32399e16f50e5edefc32'],1,1,2,23328458,1,,,,25522
6be4f5aac1713c4837f91c197ba76986791fc833,0,Pallav Kulshreshtha,2016-07-15 16:55:41+05:18,['706e3aa27a506d48fa5fff990ae5ea8ef0d33b7b'],12,29,41,23328499,2,0,0,1,25522
e70586842cec2e65e32bf28b043f93ef257f78fd,1,Andrew Onishuk,2016-07-15 14:53:03+03:00,['6be4f5aac1713c4837f91c197ba76986791fc833'],22,183,205,23328704,12,0.333333333,0.552380952,0.819047619,25522
492497e9f745deab7bc266b63455f9fa5bfff7be,0,Andrew Onishuk,2016-07-15 15:13:03+03:00,['e70586842cec2e65e32bf28b043f93ef257f78fd'],16,18,34,23328738,1,0,0,0,25522
0458940b9308c2c95f14be59da974700894bf991,1,ababiichuk,2016-07-15 15:29:24+03:00,['492497e9f745deab7bc266b63455f9fa5bfff7be'],12,11,23,23328761,1,1,1,0,25522
a53b2c8d9caac0dbb2154c1e9da3c32587bae584,1,oleewere,2016-07-15 15:43:46+02:00,['0458940b9308c2c95f14be59da974700894bf991'],1036,2244,3280,23332041,11,0.785145889,0.888594164,0.968169761,25525
16342e0b8d59578eceb211a2c9873d9b0788e078,1,Sumit Mohanty,2016-07-15 08:11:54-07:00,['a53b2c8d9caac0dbb2154c1e9da3c32587bae584'],4,11,15,23332056,3,,,,25525
0eadaa6d8bbdb3b450c3e3f2ce5116a25ea940eb,0,Myroslav Papirkovskyi,2016-07-15 18:56:18+03:00,['16342e0b8d59578eceb211a2c9873d9b0788e078'],1,1,2,23332058,1,,,,25525
1cba6f4590cbc47233f902d946796aa29f7dd3cb,0,Andrii Tkach,2016-07-15 19:09:38+03:00,['0eadaa6d8bbdb3b450c3e3f2ce5116a25ea940eb'],0,26,26,23332084,1,1,1,1,25525
6e8ff42e8980420b6792e6fb00f3eb058d1d396c,0,Alex Antonenko,2016-07-15 20:16:07+03:00,['1cba6f4590cbc47233f902d946796aa29f7dd3cb'],0,3,3,23332087,2,1,1,1,25525
c37df2ef67b239fefcc464378b8eeb5123953780,0,Jayush Luniya,2016-07-15 10:18:29-07:00,['6e8ff42e8980420b6792e6fb00f3eb058d1d396c'],5,31,36,23332123,4,1,1,0.545454545,25525
ce4ac63b585ed3f8a3af069231aef4b324f41e65,1,Jayush Luniya,2016-07-15 10:27:24-07:00,['c37df2ef67b239fefcc464378b8eeb5123953780'],27,1499,1526,23333649,26,0.125,0.95,0.5,25525
5ab3cc02b2d2e03f9a9b8b4bbe4ca676bd620b57,1,Jayush Luniya,2016-07-15 10:53:21-07:00,['ce4ac63b585ed3f8a3af069231aef4b324f41e65'],33,51,84,23333733,12,,,,25525
e8bd12b19c580db0873aba1c70f00a59cac1f1c7,1,Jayush Luniya,2016-07-15 10:58:14-07:00,['5ab3cc02b2d2e03f9a9b8b4bbe4ca676bd620b57'],12,39,51,23333784,2,0.666666667,0.708333333,1,25525
27f6b17ca64645e7a922c56bdbad48cf77d964cc,1,Dipayan Bhowmick,2016-07-16 00:58:09+05:18,['e8bd12b19c580db0873aba1c70f00a59cac1f1c7'],2,40,42,23333826,2,0.933333333,0.933333333,1,25525
51870ae749910f8779a4af4ce235172059635203,1,Aleksandr Kovalenko,2016-07-15 22:45:12+03:00,['27f6b17ca64645e7a922c56bdbad48cf77d964cc'],3,67,70,23333896,3,1,1,1,25525
203e82b785d0024f230de31618e03975bb91be03,0,Dipayan Bhowmick,2016-07-16 01:11:36+05:18,['51870ae749910f8779a4af4ce235172059635203'],8,13,21,23333917,2,0.5,1,0.5,25525
4b5cb1c3b4d8b442fb6dc3e4a0747a7857834fdb,1,Aravindan Vijayan,2016-07-15 13:13:09-07:00,['203e82b785d0024f230de31618e03975bb91be03'],24,47,71,23333988,6,0,0.125,1,25525
f67c9cf3a776dd3a96bacfc44c722fbc44f2ab3e,1,Zhe (Joe) Wang,2016-07-15 13:18:28-07:00,['4b5cb1c3b4d8b442fb6dc3e4a0747a7857834fdb'],105,281,386,23334374,4,1,1,1,25526
bb40466259696aa187b7ddb0e65f7947c9f39c69,0,Jaimin Jetly,2016-07-15 13:25:59-07:00,['f67c9cf3a776dd3a96bacfc44c722fbc44f2ab3e'],1,2,3,23334377,2,,,,25526
da8b308ea85d1a9755274c2b377f601e7e2913e4,0,Siddharth Wagle,2016-07-15 13:22:30-07:00,['bb40466259696aa187b7ddb0e65f7947c9f39c69'],28,39,67,23334444,4,1,1,1,25526
ec851839838cf3705a147c39cc131ffc762db97d,1,Nate Cole,2016-07-15 17:05:51-04:00,['da8b308ea85d1a9755274c2b377f601e7e2913e4'],4,52,56,23334500,5,0,1,1,25526
bb40cfcd12598aa3bda8a4d457d0d51a4b1a7e35,1,Siddharth Wagle,2016-07-15 14:17:29-07:00,['ec851839838cf3705a147c39cc131ffc762db97d'],1,4,5,23334505,1,,,,25526
b8028eee35a124f6893809856f54666619a6962d,0,Jaimin Jetly,2016-07-15 14:55:31-07:00,['bb40cfcd12598aa3bda8a4d457d0d51a4b1a7e35'],1,1,2,23334507,1,,,,25526
6ec10706ecace3163f953ad521587c452f2416ef,0,Jaimin Jetly,2016-07-15 14:55:31-07:00,['b8028eee35a124f6893809856f54666619a6962d'],2,0,2,23334509,1,,,,25526
a18aa670003fc5e6e0f06d178a9251a4c896a23d,0,Alejandro Fernandez,2016-07-15 16:33:57-07:00,['6ec10706ecace3163f953ad521587c452f2416ef'],11,24,35,23334544,3,0,1,1,25526
93f5798e09e2065ebd27552eb8f2e88fb95e0390,1,Jonathan Hurley,2016-07-15 20:16:20-04:00,['a18aa670003fc5e6e0f06d178a9251a4c896a23d'],28,121,149,23334693,5,0.346153846,1,0.846153846,25526
2dd2ee8ea95deb70efc3b43ad076730aa36992a9,1,Sumit Mohanty,2016-07-15 18:24:04-07:00,['93f5798e09e2065ebd27552eb8f2e88fb95e0390'],0,5,5,23334698,1,,,,25526
1a95d7a4b39745f490ab89c064d72c18aa5c6367,1,Aleksandr Kovalenko,2016-07-16 18:57:10+03:00,['2dd2ee8ea95deb70efc3b43ad076730aa36992a9'],2,2,4,23334702,1,,,,25526
92225d61d9bbdb791ecc08a384579acbc3e2ff19,0,Andrew Onishuk,2016-07-16 19:38:00+03:00,['1a95d7a4b39745f490ab89c064d72c18aa5c6367'],0,6,6,23334708,1,,,,25526
aff27a73e5423ea1d1cbc0036ec704f4d2dabfce,0,Gautam Borad,2016-07-17 00:01:13+05:18,['92225d61d9bbdb791ecc08a384579acbc3e2ff19'],1,1,2,23334710,1,,,,25526
c767236380dc0cd1225297d14dda16045c5dc6aa,0,Nate Cole,2016-07-16 15:07:36-04:00,['aff27a73e5423ea1d1cbc0036ec704f4d2dabfce'],3,46,49,23334759,2,0,1,1,25526
bf61479312f966334bd58442f2e16d7bef1c1758,1,Andrew Onishuk,2016-07-17 01:28:31+03:00,['c767236380dc0cd1225297d14dda16045c5dc6aa'],1,1,2,23334761,1,,,,25526
200778b425563de6e4b5a88e7fb2614dbae8178d,1,Bob Nettleton,2016-07-16 20:52:28-04:00,['bf61479312f966334bd58442f2e16d7bef1c1758'],10,289,299,23335060,5,0.021126761,0.985915493,0.943661972,25527
6dbca3f34203dba5d9540622cc84a90e98521b6b,1,Swapan Shridhar,2016-07-17 12:43:00-07:00,['200778b425563de6e4b5a88e7fb2614dbae8178d'],45,106,151,23335211,3,0,0.590909091,0.045454545,25527
04676558de956d3cf7c619ceb09091595434db2b,0,Sumit Mohanty,2016-07-17 21:22:55-07:00,['6dbca3f34203dba5d9540622cc84a90e98521b6b'],0,2,2,23335213,1,,,,25527
492396bd325a1aa7a57f02489cbd12ce6e7cc33e,0,Oleg Nechiporenko,2016-07-18 11:39:26+03:00,['04676558de956d3cf7c619ceb09091595434db2b'],17,14,31,23335244,4,0,0,0,25527
24706f2e26c11c9b7a7af771fcb77fbcc81acdff,0,Dmytro Sen,2016-07-18 13:00:25+03:00,['492396bd325a1aa7a57f02489cbd12ce6e7cc33e'],25,36,61,23335305,4,0,0,0,25527
db7c31828f23b6a16f1d3784c1c7fcebdfde9567,1,oleewere,2016-07-18 12:23:08+02:00,['24706f2e26c11c9b7a7af771fcb77fbcc81acdff'],93,207,300,23335605,12,0.19047619,0.682539683,1,25527
a12032d7621a770c2f283e4f75d9a9e1e4a68fc2,1,Dmytro Sen,2016-07-18 14:20:22+03:00,['db7c31828f23b6a16f1d3784c1c7fcebdfde9567'],3,10,13,23335618,1,0,0,0,25527
7c0357c49273782933e6456d2f694bc1c114be58,1,Nitiraj Rathore,2016-07-18 17:09:03+05:18,['a12032d7621a770c2f283e4f75d9a9e1e4a68fc2'],16,64,80,23335698,4,0.705882353,0.705882353,1,25527
83cb06a76da7744f71dae1d3d50e6388b2e88121,1,Gaurav Nagar,2016-07-18 17:23:51+05:18,['7c0357c49273782933e6456d2f694bc1c114be58'],6,2,8,23335706,2,,,,25527
1b7cc137dc70f264be8dfe535014443ad2c56205,1,Dmytro Sen,2016-07-18 15:25:36+03:00,['83cb06a76da7744f71dae1d3d50e6388b2e88121'],11,42,53,23335759,2,0.625,0.875,0.625,25527
3572e5322cd2a07cfbde318921cec40625d92560,0,Alex Antonenko,2016-07-18 15:54:44+03:00,['1b7cc137dc70f264be8dfe535014443ad2c56205'],2,4,6,23335765,1,0,0,1,25527
b98393f3fcb9242e67ce7cdbcf9858d879aebbf3,0,Aleksandr Kovalenko,2016-07-18 16:27:29+03:00,['3572e5322cd2a07cfbde318921cec40625d92560'],1,1,2,23335767,1,,,,25527
330038d076b284226f5f889b5eda155f14421f0a,1,Lisnichenko Dmitro,2016-07-18 17:26:32+03:00,['b98393f3fcb9242e67ce7cdbcf9858d879aebbf3'],0,1,1,23335768,1,0,0,1,25527
9c6e02a256ceb1f8ba090fcbd7ac136e9a94b07a,0,Lisnichenko Dmitro,2016-07-18 17:26:44+03:00,['330038d076b284226f5f889b5eda155f14421f0a'],18,156,174,23335942,17,,,,25527
c7809d99db50e5a87e2656271ce82b793cdc024f,1,Myroslav Papirkovskyi,2016-07-18 17:34:33+03:00,['9c6e02a256ceb1f8ba090fcbd7ac136e9a94b07a'],8,43,51,23335993,5,0.125,0.6875,0.6875,25527
064be9fe538e5d7e7db3337d019df810ebdbcde4,1,Dmytro Sen,2016-07-18 18:53:22+03:00,['c7809d99db50e5a87e2656271ce82b793cdc024f'],8,37,45,23336038,1,1,1,0,25527
07d83b25518744d367719f52d8280780d7e9601f,1,Jaimin Jetly,2016-07-18 09:48:31-07:00,['064be9fe538e5d7e7db3337d019df810ebdbcde4'],6,37,43,23336081,2,0,0,0,25527
208e752780d2907bd9a02803f6127e45ed097b81,0,Sumit Mohanty,2016-07-18 10:46:05-07:00,['07d83b25518744d367719f52d8280780d7e9601f'],0,2,2,23336083,1,,,,25527
e47efc67dad09fc7fa3b73d2ac4b84bf77771cf6,1,Alejandro Fernandez,2016-07-18 11:13:18-07:00,['208e752780d2907bd9a02803f6127e45ed097b81'],319,266,585,23336668,13,,,,25527
4f26b575c6c31169b254e355bc801bd7781bbb69,1,Alexander Denissov,2016-07-18 12:26:30-07:00,['e47efc67dad09fc7fa3b73d2ac4b84bf77771cf6'],23,7,30,23336698,3,0,0,0,25527
2d6cb436a296baf0528f41dc5994453e17fa3d88,1,Jaimin Jetly,2016-07-18 12:59:48-07:00,['4f26b575c6c31169b254e355bc801bd7781bbb69'],1,9,10,23336708,3,0,1,1,25527
def14ebd67df58849ef055815d03f2d3358ba260,1,Jaimin Jetly,2016-07-18 13:06:42-07:00,['2d6cb436a296baf0528f41dc5994453e17fa3d88'],34,9,43,23336751,2,1,1,1,25527
b69c3008a69c4578d43c1c9835935a26156c859f,1,Jaimin Jetly,2016-07-18 13:42:22-07:00,['def14ebd67df58849ef055815d03f2d3358ba260'],1,42,43,23336794,3,1,1,0.090909091,25527
6168a47adec2970731778d28ca255978f1345a49,0,Jaimin Jetly,2016-07-18 14:40:11-07:00,['b69c3008a69c4578d43c1c9835935a26156c859f'],2,0,2,23336796,1,,,,25527
ef9a417fc7755dde7f3cd1986854df84b71a60ae,1,Alexander Denissov,2016-07-18 15:05:37-07:00,['6168a47adec2970731778d28ca255978f1345a49'],89,177,266,23337062,3,0,0.450704225,0.450704225,25527
eea47c1c13a5513a1902b2727cb74d59f9c48ff1,0,Yusaku Sako,2016-07-18 15:19:53-07:00,['ef9a417fc7755dde7f3cd1986854df84b71a60ae'],4,1,5,23337067,1,,,,25527
e405f5277a9fcf3c5d2c4844c7a43a5422052afb,0,Ajit Kumar,2016-07-18 16:15:02-07:00,['eea47c1c13a5513a1902b2727cb74d59f9c48ff1'],7,16,23,23337090,2,0,0.285714286,0.285714286,25527
2c676de097d041c48eaf5f7a2ac7e83843829158,0,Nate Cole,2016-07-18 20:30:04-04:00,['e405f5277a9fcf3c5d2c4844c7a43a5422052afb'],1,22,23,23337113,4,,,,25527
ea1a72bfa037bce7725809b595b05236fc4cde6b,0,Lisnichenko Dmitro,2016-07-19 12:12:29+03:00,['2c676de097d041c48eaf5f7a2ac7e83843829158'],1,0,1,23337114,1,,,,25527
0ad6daff6ed9b707367a5d59f123f6bc3f9c9df0,1,oleewere,2016-07-19 12:04:15+02:00,['ea1a72bfa037bce7725809b595b05236fc4cde6b'],21,18,39,23337153,1,,,,25527
03e9963296dbeaaacc3d71cc70beb99ca9ba7964,1,Nitiraj Rathore,2016-07-19 17:37:45+05:18,['0ad6daff6ed9b707367a5d59f123f6bc3f9c9df0'],54,10,64,23337217,6,0,0,0,25527
b92d5ac0712c8fef79c7dc82951ce0d27cfc86e4,0,Aleksandr Kovalenko,2016-07-19 15:30:12+03:00,['03e9963296dbeaaacc3d71cc70beb99ca9ba7964'],0,34,34,23337251,5,0.892857143,0.928571429,1,25527
cd9f7d254739553c048cd337e6e930c2a071ec12,1,Sumit Mohanty,2016-07-19 07:13:07-07:00,['b92d5ac0712c8fef79c7dc82951ce0d27cfc86e4'],1,10,11,23337262,2,,,,25527
9db1834941ee24cb7c23fc8254f023aa51433a96,1,Robert Levas,2016-07-19 10:21:45-04:00,['cd9f7d254739553c048cd337e6e930c2a071ec12'],57,95,152,23337414,1,0,0,0,25527
25389ebbc7b97ef8769b64d78e33e509a1bb67f8,1,Aravindan Vijayan,2016-07-19 07:59:12-07:00,['9db1834941ee24cb7c23fc8254f023aa51433a96'],16,20,36,23337450,5,0,0,1,25527
5768fa8d12e70ed0029c315290a7dd0cb03c45ea,1,oleewere,2016-07-19 17:00:07+02:00,['25389ebbc7b97ef8769b64d78e33e509a1bb67f8'],14,903,917,23338367,28,0.952380952,1,1,25549
6e9ac7b681bcfe8d3168ea3276430eb6a741e509,0,Sumit Mohanty,2016-07-19 08:22:33-07:00,['5768fa8d12e70ed0029c315290a7dd0cb03c45ea'],2,4,6,23338373,2,0,0.5,1,25549
ebc47ef9551629988a8ef09dc3d517abe5805763,1,Lisnichenko Dmitro,2016-07-19 19:09:45+03:00,['6e9ac7b681bcfe8d3168ea3276430eb6a741e509'],85,79,164,23338537,9,0.25,1,1,25549
060d175610e4eda822b3fbad992fd7e7f5fbbd62,1,Dmytro Sen,2016-07-19 19:54:53+03:00,['ebc47ef9551629988a8ef09dc3d517abe5805763'],7,15,22,23338559,3,0,0,1,25549
7c20a9368d3779b1638c14161d3ae949a3073832,1,Lisnichenko Dmitro,2016-07-19 21:00:16+03:00,['060d175610e4eda822b3fbad992fd7e7f5fbbd62'],1,3,4,23338563,1,,,,25549
99108e2d982e1247a23d5773503118223c4f3296,1,Myroslav Papirkovskyi,2016-07-19 21:05:03+03:00,['7c20a9368d3779b1638c14161d3ae949a3073832'],1,1,2,23338565,1,,,,25549
601cbefe199859b893897024afece3d7847f7254,0,Alex Antonenko,2016-07-19 21:25:47+03:00,['99108e2d982e1247a23d5773503118223c4f3296'],37,1,38,23338603,1,,,,25549
18182c54e13b62e2cb384f8cfa38bd5196dacff8,1,Alejandro Fernandez,2016-07-19 11:41:09-07:00,['601cbefe199859b893897024afece3d7847f7254'],5,106,111,23338714,11,,,,25550
e3385212aecc1f79d1292b2945533a4902f4c131,1,Richard Zang,2016-07-19 11:43:40-07:00,['18182c54e13b62e2cb384f8cfa38bd5196dacff8'],1,2,3,23338717,1,0,0,1,25550
38880143a9efcf524b3cf5454b59b32dfcacdb21,1,Robert Levas,2016-07-19 15:37:50-04:00,['e3385212aecc1f79d1292b2945533a4902f4c131'],26,105,131,23338848,2,0.867924528,1,1,25550
47f4e1c490f569ff93234b17a502331f2d5cae20,0,Zhe (Joe) Wang,2016-07-19 13:01:10-07:00,['38880143a9efcf524b3cf5454b59b32dfcacdb21'],2,4,6,23338854,2,1,1,1,25550
6ae30ad63893ed133819ee4907998fd27a62b71b,1,Jayush Luniya,2016-07-19 14:03:06-07:00,['47f4e1c490f569ff93234b17a502331f2d5cae20'],9,21,30,23338884,1,1,1,1,25550
9b54cbec4994d83cdefc63bf792cdb1a98aa5de4,0,Nate Cole,2016-07-19 17:03:44-04:00,['6ae30ad63893ed133819ee4907998fd27a62b71b'],0,16,16,23338900,1,,,,25550
1d6caa8740b0e4766e00f58d369144562a1e023f,1,Jonathan Hurley,2016-07-19 17:07:53-04:00,['9b54cbec4994d83cdefc63bf792cdb1a98aa5de4'],17,349,366,23339266,12,0.425,0.73125,1,25551
1ad5e59687232ae1491fd7bfa316030e347013e2,1,Alejandro Fernandez,2016-07-19 14:59:56-07:00,['1d6caa8740b0e4766e00f58d369144562a1e023f'],0,15,15,23339281,1,1,1,0,25551
9f79fa9f5ec5ccb50db7e6a28656f85bc2e3c3ff,0,Siddharth Wagle,2016-07-19 15:35:42-07:00,['1ad5e59687232ae1491fd7bfa316030e347013e2'],6,2,8,23339289,2,1,1,0,25551
417a1f03c3bf908265881313da835cad2dab3d4d,0,Jayush Luniya,2016-07-19 16:04:48-07:00,['9f79fa9f5ec5ccb50db7e6a28656f85bc2e3c3ff'],2,2,4,23339293,1,,,,25551
ac3d0fe7e97269577496dce4acc24cc6d80b6399,0,Ajit Kumar,2016-07-19 19:19:51-07:00,['417a1f03c3bf908265881313da835cad2dab3d4d'],0,1,1,23339294,1,,,,25551
ddd8d425e990bb0401c7497c4e73c7cd761c91d3,1,oleewere,2016-07-20 12:50:01+02:00,['ac3d0fe7e97269577496dce4acc24cc6d80b6399'],8,16,24,23339318,1,1,1,0,25551
12eb70e3d49ebe7f6a74be3be0b2a3a4f5e2b3a9,1,oleewere,2016-07-20 14:21:51+02:00,['ddd8d425e990bb0401c7497c4e73c7cd761c91d3'],1,1,2,23339320,1,,,,25551
617b719226e612b132e1041060f72e64b8fafd79,1,oleewere,2016-07-20 14:43:26+02:00,['12eb70e3d49ebe7f6a74be3be0b2a3a4f5e2b3a9'],2,1245,1247,23340567,7,0.415204678,0.589181287,0.634502924,25554
dd7f4c60c9c8c6b0cff8beb9913bbc0d7793f519,1,Lisnichenko Dmitro,2016-07-20 17:06:46+03:00,['617b719226e612b132e1041060f72e64b8fafd79'],13,18,31,23340598,5,,,,25554
7ff7ccdca65499cf7913c61c8715036de0707748,0,Dmytro Sen,2016-07-20 18:17:12+03:00,['dd7f4c60c9c8c6b0cff8beb9913bbc0d7793f519'],3,0,3,23340601,1,1,0,0,25554
c65169a0b7a53b7627404285f554aa337faf1480,0,Jayush Luniya,2016-07-20 08:57:19-07:00,['7ff7ccdca65499cf7913c61c8715036de0707748'],4,0,4,23340605,1,,,,25554
bb1b16910f77d65087f6b108355d159f857d255e,0,Lisnichenko Dmitro,2016-07-20 19:47:53+03:00,['c65169a0b7a53b7627404285f554aa337faf1480'],2,8,10,23340615,1,1,1,1,25554
63b18db043f479db8e24c7568108d7e1dcc1aceb,0,Dmytro Sen,2016-07-20 20:02:49+03:00,['bb1b16910f77d65087f6b108355d159f857d255e'],5,4,9,23340624,2,,,,25554
e2636c725b12f32ea929746a82e0ebaea8bf9bbe,1,Bob Nettleton,2016-07-20 13:35:55-04:00,['63b18db043f479db8e24c7568108d7e1dcc1aceb'],26,114,140,23340764,2,0,0.815789474,1,25555
8cd37908164875029c315cf7d549da83619c0f58,1,oleewere,2016-07-20 19:43:28+02:00,['e2636c725b12f32ea929746a82e0ebaea8bf9bbe'],1,1,2,23340766,1,,,,25555
70c3ef14b609ad609cff026a635c47b03f90d556,1,Aravindan Vijayan,2016-07-20 10:47:21-07:00,['8cd37908164875029c315cf7d549da83619c0f58'],1,1,2,23340768,1,,,,25555
da2e67710f8d39958a412a33f08a675b2d75863f,0,Aravindan Vijayan,2016-07-20 10:47:47-07:00,['70c3ef14b609ad609cff026a635c47b03f90d556'],14,46,60,23340828,4,0.9,1,0.9,25555
2e873b6c4a4a7dae9c33f8df3e5f97ac61f73499,0,Aravindan Vijayan,2016-07-20 10:48:09-07:00,['da2e67710f8d39958a412a33f08a675b2d75863f'],4,142,146,23340974,4,0.9,0.9,1,25555
0d54f17c296ba0fe265b90e3b91d4d2bc983e95d,1,Matt,2016-07-20 11:02:49-07:00,['2e873b6c4a4a7dae9c33f8df3e5f97ac61f73499'],14,128,142,23341116,5,0,0.780487805,0.780487805,25555
e79d388a864d680d0072bf591d8f4ff83a02f726,0,Alex Antonenko,2016-07-20 21:13:37+03:00,['0d54f17c296ba0fe265b90e3b91d4d2bc983e95d'],2,2,4,23341120,1,,,,25555
0079796ad541824db1cf9c72461da3e651cdd788,0,Aravindan Vijayan,2016-07-20 11:40:29-07:00,['e79d388a864d680d0072bf591d8f4ff83a02f726'],3,4,7,23341127,1,,,,25555
0d926322f9905b36c0b267e451958150c1954eed,1,Alejandro Fernandez,2016-07-20 11:49:59-07:00,['0079796ad541824db1cf9c72461da3e651cdd788'],76,142,218,23341345,3,1,1,1,25555
5324771272e15a7178ffef52e2dc70c4c2fbb4d3,1,Sumit Mohanty,2016-07-20 11:47:48-07:00,['0d926322f9905b36c0b267e451958150c1954eed'],2,15,17,23341362,2,1,1,0,25555
96a29c816e1a9b3a6096f5f24c94f5a3552b4a67,0,Robert Levas,2016-07-20 15:05:04-04:00,['5324771272e15a7178ffef52e2dc70c4c2fbb4d3'],226,0,226,23341588,5,0.409090909,0,0,25555
66a2b9761693399069488338f70f498641ee00cf,1,Alejandro Fernandez,2016-07-20 12:17:08-07:00,['96a29c816e1a9b3a6096f5f24c94f5a3552b4a67'],53,51,104,23341692,6,0,0,1,25555
1e252acf8d7e33bcb3cab83feedc2e6f3d1f1163,0,Jaimin Jetly,2016-07-20 13:13:31-07:00,['66a2b9761693399069488338f70f498641ee00cf'],1,2,3,23341695,1,1,1,1,25555
7ac9c5483123e76c767c18dc741f35bd60b3bb8c,1,Sumit Mohanty,2016-07-20 13:50:15-07:00,['1e252acf8d7e33bcb3cab83feedc2e6f3d1f1163'],2,2,4,23341699,2,,,,25555
5f079eb32cd752a260290310c74efe7a0d9592d7,1,Richard Zang,2016-07-20 16:35:56-07:00,['7ac9c5483123e76c767c18dc741f35bd60b3bb8c'],5,16,21,23341720,2,1,1,1,25555
e95259bb341e23a81474832798eff328076f6f7b,1,Jayush Luniya,2016-07-20 17:49:10-07:00,['5f079eb32cd752a260290310c74efe7a0d9592d7'],267,319,586,23342306,13,,,,25555
750be1b913bdf2cfb5da7128c8601c3200615fc2,0,Sumit Mohanty,2016-07-20 18:41:37-07:00,['e95259bb341e23a81474832798eff328076f6f7b'],0,5,5,23342311,1,,,,25555
22dad7dfef846f2c22a9caaf96ab75a09b6e2c79,1,Sumit Mohanty,2016-07-20 18:54:24-07:00,['750be1b913bdf2cfb5da7128c8601c3200615fc2'],1,2,3,23342314,2,,,,25555
f635d05d5150d28eed54076bddd57e6f03be16c3,0,Sumit Mohanty,2016-07-20 22:34:01-07:00,['22dad7dfef846f2c22a9caaf96ab75a09b6e2c79'],1,1,2,23342316,1,,,,25555
7acc909522ae996fcf5124ad339bad6a17d44fc5,1,Swapan Shridhar,2016-07-20 23:57:44-07:00,['f635d05d5150d28eed54076bddd57e6f03be16c3'],12,14,26,23342342,2,1,1,0,25555
07b423677ab3ab87debffdb732b5d95a7f9ae13c,1,Andrii Tkach,2016-07-21 14:09:11+03:00,['7acc909522ae996fcf5124ad339bad6a17d44fc5'],124,1212,1336,23343678,7,0.782833506,1,1,25556
de34d9965d385659bd139a74b19a04fb0d2dc219,0,Lisnichenko Dmitro,2016-07-21 16:10:30+03:00,['07b423677ab3ab87debffdb732b5d95a7f9ae13c'],0,63,63,23343741,2,0,0.836065574,0.836065574,25556
54d4048ea76842bedec5ac3d0ab2fcda90991a43,0,Dmytro Sen,2016-07-21 18:39:26+03:00,['de34d9965d385659bd139a74b19a04fb0d2dc219'],1,72,73,23343814,3,0.428571429,1,0.342857143,25556
934a16c00aeb11b4fa908fe447698df0348e2fce,0,Aleksandr Kovalenko,2016-07-21 19:44:10+03:00,['54d4048ea76842bedec5ac3d0ab2fcda90991a43'],13,11,24,23343838,1,1,,,25556
f4984f0364cb814e3c45a3646118c20b692c0935,1,Jayush Luniya,2016-07-21 09:56:29-07:00,['934a16c00aeb11b4fa908fe447698df0348e2fce'],43,72,115,23343953,11,,,,25556
b1454758d8f7be1be46585bc9550af2ab6b1d1ce,0,Myroslav Papirkovskyi,2016-07-21 20:05:23+03:00,['f4984f0364cb814e3c45a3646118c20b692c0935'],18,10,28,23343981,3,,,,25556
bd7f32229c604fad400bc7c7d37437d75e79ad98,1,Jayush Luniya,2016-07-21 10:32:44-07:00,['b1454758d8f7be1be46585bc9550af2ab6b1d1ce'],0,100,100,23344081,2,0,0.701149425,0.816091954,25556
c2ee8f35db88294341d3d263a96d470b3163bd15,1,Jayush Luniya,2016-07-21 10:46:17-07:00,['bd7f32229c604fad400bc7c7d37437d75e79ad98'],2,3,5,23344086,2,1,1,1,25556
fba45fe1372b81860d6e230dac396a93970a3ed3,1,Pallav Kulshreshtha,2016-07-21 23:58:37+05:18,['c2ee8f35db88294341d3d263a96d470b3163bd15'],24,41,65,23344151,4,1,1,0.75,25556
aff87ed68bcb19a4a1e5e64e0dfd3185177092f3,1,Alejandro Fernandez,2016-07-21 11:49:34-07:00,['fba45fe1372b81860d6e230dac396a93970a3ed3'],9,27,36,23344187,1,0,0,0,25556
18ba883b314f2b8259a648b4ab1fd36f4a5cfda0,1,Alejandro Fernandez,2016-07-21 13:44:47-07:00,['aff87ed68bcb19a4a1e5e64e0dfd3185177092f3'],18,287,305,23344492,7,0,0.637168142,0.955752212,25558
1e05dc2d092e0759fce60d9ad5eaaae04dc6988a,0,Jaimin Jetly,2016-07-21 13:47:15-07:00,['18ba883b314f2b8259a648b4ab1fd36f4a5cfda0'],51,34,85,23344577,4,1,0,0,25558
a30d1573850dcbc9abc2aef49c481b20f447fc07,1,Sriharsha Chintalapani,2016-07-21 13:49:40-07:00,['1e05dc2d092e0759fce60d9ad5eaaae04dc6988a'],48,193,241,23344818,13,1,0.367346939,0.816326531,25560
2516a059a7ca116d218bb6411fccd4ce11ad59ff,1,Swapan Shridhar,2016-07-21 14:37:36-07:00,['a30d1573850dcbc9abc2aef49c481b20f447fc07'],9,10,19,23344837,4,,,,25560
4d38f5fb40d2592504ffc7e9d7d7a27c1d2bf011,0,Swapan Shridhar,2016-07-21 15:39:22-07:00,['2516a059a7ca116d218bb6411fccd4ce11ad59ff'],0,34,34,23344871,1,,,,25561
43ad3d69a7f9dee1bd7c51b92ef1e4cc918c33da,0,Swapan Shridhar,2016-07-21 16:31:18-07:00,['4d38f5fb40d2592504ffc7e9d7d7a27c1d2bf011'],32,0,32,23344903,1,,,,25561
9d0d2a04ad63bfb4da309f5647c240f7eb46de1c,1,Sumit Mohanty,2016-07-21 16:38:35-07:00,['43ad3d69a7f9dee1bd7c51b92ef1e4cc918c33da'],72,1,73,23344976,3,0.571428571,0,0.657142857,25561
af9842245e3fda05a73cbd8e59f7dbe528bc7eab,1,Nahappan Somasundaram,2016-07-21 17:10:35-07:00,['9d0d2a04ad63bfb4da309f5647c240f7eb46de1c'],12,64,76,23345052,2,,,,25561
74d95794dd8b0b1331f6f32a182c9e6614c584a7,0,Jayush Luniya,2016-07-21 23:45:35-07:00,['af9842245e3fda05a73cbd8e59f7dbe528bc7eab'],0,6,6,23345058,1,,,,25561
e82e68c18baa81b5b892097bbfe1d75373aba628,1,Gaurav Nagar,2016-07-22 13:09:24+05:18,['74d95794dd8b0b1331f6f32a182c9e6614c584a7'],2,74,76,23345134,5,0,1,1,25561
988775704926370e5783a81ca1aefe07d45e95fa,0,Andrii Tkach,2016-07-22 11:56:33+03:00,['e82e68c18baa81b5b892097bbfe1d75373aba628'],15,2,17,23345151,1,0,0,0,25561
b5b9493ff7da82f342a7b39c2c8d273d763c8eae,0,Dmytro Sen,2016-07-22 15:14:13+03:00,['988775704926370e5783a81ca1aefe07d45e95fa'],24,71,95,23345246,5,0.655172414,0,0.517241379,25561
cabf6829989ee4f6cc1f9a0b2b3ab35d309c5149,0,Oleg Nechiporenko,2016-07-22 15:22:27+03:00,['b5b9493ff7da82f342a7b39c2c8d273d763c8eae'],2,1,3,23345249,1,,,,25561
3ac13b5c793a05da245722f122a6445af2ba1169,1,Jonathan Hurley,2016-07-22 09:29:57-04:00,['cabf6829989ee4f6cc1f9a0b2b3ab35d309c5149'],427,422,849,23346098,16,0.546875,0.203125,0,25561
30dae30e67219ad127114aa731bf490cfd78ec4a,0,Gautam Borad,2016-07-22 20:08:31+05:18,['3ac13b5c793a05da245722f122a6445af2ba1169'],4,1,5,23346103,2,,,,25561
28ad60ea5a6868b502f482f81dabf25525bcb51b,1,Dmytro Sen,2016-07-22 18:03:40+03:00,['30dae30e67219ad127114aa731bf490cfd78ec4a'],1,252,253,23346356,4,0.203252033,1,0.81300813,25562
8595774b59ba514213f2ccab20c6cb334ab3cdd6,0,ababiichuk,2016-07-22 18:36:14+03:00,['28ad60ea5a6868b502f482f81dabf25525bcb51b'],5,32,37,23346393,3,1,1,0.875,25562
c879e937341c427714a0dff5c4bc73f272d4d30e,0,Di Li,2016-07-22 11:56:10-04:00,['8595774b59ba514213f2ccab20c6cb334ab3cdd6'],30,27,57,23346450,3,1,0,0,25562
40bdcb6480abfe6393bac9be961ae53654c1cb2f,1,Dmytro Sen,2016-07-22 19:10:16+03:00,['c879e937341c427714a0dff5c4bc73f272d4d30e'],71,24,95,23346545,5,0.344827586,1,0.482758621,25562
bdcd39bfe5e1835ed19001e79e4cf2bcb3297fa4,0,Dmytro Sen,2016-07-22 19:43:08+03:00,['40bdcb6480abfe6393bac9be961ae53654c1cb2f'],1,33,34,23346579,2,0,0.903225806,0.903225806,25562
28d24abb161f40150c7a64d5adf3c18d1e444a26,0,Alejandro Fernandez,2016-07-22 11:14:32-07:00,['bdcd39bfe5e1835ed19001e79e4cf2bcb3297fa4'],0,11,11,23346590,3,,,,25562
6b5387363ec9b2c7403d244fd65cf58a1e9b38ce,1,Nate Cole,2016-07-22 15:27:11-04:00,['28d24abb161f40150c7a64d5adf3c18d1e444a26'],152,152,304,23346894,9,,,,25562
b267646365d108303e55c8988ccff2ea1cd045e3,1,Aleksandr Kovalenko,2016-07-22 22:35:11+03:00,['6b5387363ec9b2c7403d244fd65cf58a1e9b38ce'],8,13,21,23346915,3,1,1,1,25562
a484b2352b5c0d00b007bcdca241943909a5836a,1,Aravindan Vijayan,2016-07-22 14:56:13-07:00,['b267646365d108303e55c8988ccff2ea1cd045e3'],19,52,71,23346986,3,0.318181818,0,0.318181818,25562
1a415a66d569d0aa6e698564d54b446c921fa449,1,Aravindan Vijayan,2016-07-22 14:56:24-07:00,['a484b2352b5c0d00b007bcdca241943909a5836a'],2,219,221,23347207,2,0,0.918032787,0.918032787,25562
7155e8e7283eb837a6b6be648eb513cbcf7b1f26,1,Aravindan Vijayan,2016-07-22 15:08:55-07:00,['1a415a66d569d0aa6e698564d54b446c921fa449'],25,150,175,23347382,4,0.306451613,1,1,25563
7a1871865019d607a6a1219edbdd831500fe7c01,1,Sumit Mohanty,2016-07-22 17:42:52-07:00,['7155e8e7283eb837a6b6be648eb513cbcf7b1f26'],4,10,14,23347396,5,,,,25563
661ee4cd72c083814a727a8850f4ac151e07067b,1,Zhe (Joe) Wang,2016-07-22 18:08:27-07:00,['7a1871865019d607a6a1219edbdd831500fe7c01'],1,1,2,23347398,1,,,,25563
185ffb53d0d11597bcfdf2b6a4315bf6fae3ede8,0,Sumit Mohanty,2016-07-22 18:36:22-07:00,['661ee4cd72c083814a727a8850f4ac151e07067b'],0,2,2,23347400,1,,,,25563
5718670c2ae5794d77ccf079319d8a68b41a9e1d,0,Ajit Kumar,2016-07-23 10:24:16-07:00,['185ffb53d0d11597bcfdf2b6a4315bf6fae3ede8'],1,0,1,23347401,1,,,,25563
1f6a8f710bcc99f195475f1a85726e394bab766e,0,Sumit Mohanty,2016-07-23 16:08:12-07:00,['5718670c2ae5794d77ccf079319d8a68b41a9e1d'],3,3,6,23347407,1,,,,25563
842d382efc98bd1264b618cd42cad3c5f5b424c0,1,oleewere,2016-07-24 04:07:14+02:00,['1f6a8f710bcc99f195475f1a85726e394bab766e'],16,37,53,23347460,1,0,0.923076923,1,25563
5ca20c20c2882bbfbb4e290da62acc139175e9d3,1,Sumit Mohanty,2016-07-23 19:47:49-07:00,['842d382efc98bd1264b618cd42cad3c5f5b424c0'],26,10,36,23347496,1,,,,25563
85e21b1ffb03ded98036d0aaf161229f2fd75de5,1,Swapan Shridhar,2016-07-24 04:12:26-07:00,['5ca20c20c2882bbfbb4e290da62acc139175e9d3'],10,270,280,23347776,2,0,0.949790795,0.949790795,25563
9e13cd32b327e771c153bb25925fc3f493dcd419,0,Nate Cole,2016-07-24 08:16:49-04:00,['85e21b1ffb03ded98036d0aaf161229f2fd75de5'],14,18,32,23347808,2,,,,25563
6a10160d5658db518f77ccb89236c8e394db1eb2,0,Andrii Tkach,2016-07-25 11:54:56+03:00,['9e13cd32b327e771c153bb25925fc3f493dcd419'],0,61,61,23347869,4,0.58974359,1,1,25563
8aeaf468ed61e450897d193a6e1087480181e007,0,Gaurav Nagar,2016-07-25 15:07:33+05:18,['6a10160d5658db518f77ccb89236c8e394db1eb2'],3,3,6,23347875,1,,,,25563
4c1dfce223c71a1bdd3842df76595a17ad08345e,1,Oleg Nechiporenko,2016-07-25 12:59:14+03:00,['8aeaf468ed61e450897d193a6e1087480181e007'],4,11,15,23347890,3,0,0.625,0.625,25563
61c73dc0f9118f601ce0a2a2ff77f3ac240a0fd0,1,ababiichuk,2016-07-25 13:19:02+03:00,['4c1dfce223c71a1bdd3842df76595a17ad08345e'],9,29,38,23347928,2,0.833333333,1,0.222222222,25563
c0d4dba50b2d290e44a1532d309676013e195ee4,1,ababiichuk,2016-07-25 13:57:14+03:00,['61c73dc0f9118f601ce0a2a2ff77f3ac240a0fd0'],2,16,18,23347946,2,0.625,1,1,25563
51598d42cabe26b4280a3f076985d5b48c4f4e2a,0,Alex Antonenko,2016-07-25 14:23:22+03:00,['c0d4dba50b2d290e44a1532d309676013e195ee4'],2,3,5,23347951,2,0,0,1,25563
c39c687a49eb5435e164b4556c6a64843504c9bf,0,Robert Levas,2016-07-25 08:07:16-04:00,['51598d42cabe26b4280a3f076985d5b48c4f4e2a'],10,45,55,23348006,2,1,1,1,25563
e3fb0b02ea63d5b575a81f29b5ef9673edd37d60,1,Oleg Nechiporenko,2016-07-25 15:21:46+03:00,['c39c687a49eb5435e164b4556c6a64843504c9bf'],1,639,640,23348646,8,1,1,0.940149626,25567
c5b1285efd2902e1cff4775ba09d05cd10b44833,0,Di Li,2016-07-25 10:59:13-04:00,['e3fb0b02ea63d5b575a81f29b5ef9673edd37d60'],2,6,8,23348654,2,0,0,1,25567
8b041be4a1f38069b72bcd8269cec9b8e9cd6e3e,1,Lisnichenko Dmitro,2016-07-25 19:13:26+03:00,['c5b1285efd2902e1cff4775ba09d05cd10b44833'],18,56,74,23348728,3,0.074074074,0.925925926,1,25567
b19714343633d68b8461c5e1bae8c5cc990c2fb8,1,Lisnichenko Dmitro,2016-07-25 19:19:35+03:00,['8b041be4a1f38069b72bcd8269cec9b8e9cd6e3e'],4,202,206,23348934,8,0.328571429,1,0.692857143,25567
dbc1d261dfefb7dcb12e57b42230e2a0f898207b,0,Jaimin Jetly,2016-07-25 10:25:04-07:00,['b19714343633d68b8461c5e1bae8c5cc990c2fb8'],0,6,6,23348940,1,,,,25567
0a3a2322c3ef038a9414371370e1c87eb7bd8d0d,0,Sumit Mohanty,2016-07-25 12:02:52-07:00,['dbc1d261dfefb7dcb12e57b42230e2a0f898207b'],0,1,1,23348941,1,,,,25567
1cfb68b4fb7237738a7fb13a61802b4e1ccb8f36,1,Aravindan Vijayan,2016-07-25 13:26:53-07:00,['0a3a2322c3ef038a9414371370e1c87eb7bd8d0d'],0,4,4,23348945,1,,,,25567
97c8f920aa3a6f1ed6dffa9099ed6223dd775f2a,1,Sumit Mohanty,2016-07-25 14:14:10-07:00,['1cfb68b4fb7237738a7fb13a61802b4e1ccb8f36'],12,83,95,23349040,2,0,0.615384615,0.384615385,25567
a5d6985cf989067b2f69bbda3e891deba6de2732,0,Yusaku Sako,2016-07-25 14:43:05-07:00,['97c8f920aa3a6f1ed6dffa9099ed6223dd775f2a'],2,14,16,23349056,1,,,,25567
4c193da259395041883028f690b54dfe2edc0bd8,1,Sumit Mohanty,2016-07-25 16:50:35-07:00,['a5d6985cf989067b2f69bbda3e891deba6de2732'],1,2,3,23349059,1,,,,25567
3867d39559868403a4c41666f6cb27f4c769c599,1,Jaimin Jetly,2016-07-25 17:34:06-07:00,['4c193da259395041883028f690b54dfe2edc0bd8'],34,51,85,23349144,4,0,1,1,25567
b730907f5c2e8317eceb71af2538ecc53dcf07a9,0,Sumit Mohanty,2016-07-25 18:09:55-07:00,['3867d39559868403a4c41666f6cb27f4c769c599'],4,4,8,23349152,1,,,,25567
08644fa7cd043cb1f3ee6052b382f96d266b028e,1,Andrii Tkach,2016-07-26 11:21:48+03:00,['b730907f5c2e8317eceb71af2538ecc53dcf07a9'],39,685,724,23349876,3,0.376623377,0.965367965,1,25568
2fb19c7b1a0497a40df8d11e7d426190836d6a24,1,Alex Antonenko,2016-07-26 11:30:00+03:00,['08644fa7cd043cb1f3ee6052b382f96d266b028e'],15,149,164,23350040,10,0.275510204,0.336734694,0.826530612,25568
bcef91c8d985c134c04a923491d7ff3e2c6f915f,0,Vitaly Brodetskyi,2016-07-26 14:51:09+03:00,['2fb19c7b1a0497a40df8d11e7d426190836d6a24'],0,2,2,23350042,2,,,,25568
277f7d2e1e87e8471432c0d5a66a418487f2e026,0,Oleg Nechiporenko,2016-07-26 16:46:50+03:00,['bcef91c8d985c134c04a923491d7ff3e2c6f915f'],12,14,26,23350068,1,0,0,1,25568
a50a37333668185d2eadfbe08999235f4cbbe44b,0,Vitaly Brodetskyi,2016-07-26 16:56:01+03:00,['277f7d2e1e87e8471432c0d5a66a418487f2e026'],16,37,53,23350121,1,0,0,0,25568
0fb78858004e62f85694b8f0f68ede511c4c2026,1,Nate Cole,2016-07-26 10:40:06-04:00,['a50a37333668185d2eadfbe08999235f4cbbe44b'],0,37,37,23350158,2,0,0.769230769,1,25568
33c10efe45ec3488a804c7fb46170afad325cc46,0,Lisnichenko Dmitro,2016-07-26 19:09:03+03:00,['0fb78858004e62f85694b8f0f68ede511c4c2026'],5,4,9,23350167,1,1,1,1,25568
c52d3d64599dab97c9ac5d5e0fc917bc9cdc49a0,1,Robert Levas,2016-07-26 12:12:30-04:00,['33c10efe45ec3488a804c7fb46170afad325cc46'],2,3,5,23350172,1,0,1,1,25568
5ebb04a2e9da16c694622354dcb8a5a749f0b0f6,0,Gautam Borad,2016-07-26 22:39:24+05:18,['c52d3d64599dab97c9ac5d5e0fc917bc9cdc49a0'],2,369,371,23350543,8,0.078431373,1,1,25571
5261c76c62ec06af77d04bc5e0a9f128d3be12b2,1,Jonathan Hurley,2016-07-26 14:03:31-04:00,['5ebb04a2e9da16c694622354dcb8a5a749f0b0f6'],15,344,359,23350902,3,0.064516129,0.903225806,0.903225806,25572
e424b5b538537ea16f7d8cc24899c7a4ff5864a0,1,Alejandro Fernandez,2016-07-26 11:56:21-07:00,['5261c76c62ec06af77d04bc5e0a9f128d3be12b2'],503,513,1016,23351918,31,0.012345679,0.827160494,0.75308642,25574
85a685eefc4d6d3f29e24c7dd281529519157817,0,Sumit Mohanty,2016-07-26 12:49:30-07:00,['e424b5b538537ea16f7d8cc24899c7a4ff5864a0'],38,0,38,23351956,9,,,,25574
124f48ef899fddb6bdb96ebea9aa3a6a1a6adbca,0,Robert Levas,2016-07-26 16:25:30-04:00,['85a685eefc4d6d3f29e24c7dd281529519157817'],14,46,60,23352016,4,0.052631579,1,1,25574
3ef40a40869e747c4f34b713bc3f3c3b65ca46b1,1,Nate Cole,2016-07-26 18:02:40-04:00,['124f48ef899fddb6bdb96ebea9aa3a6a1a6adbca'],1,95,96,23352112,2,0,0.969230769,0.969230769,25574
22b0bd343b06f6d45763881406a404277cd5147f,0,Oleg Nechiporenko,2016-07-27 12:07:39+03:00,['3ef40a40869e747c4f34b713bc3f3c3b65ca46b1'],0,1,1,23352113,1,0,1,0,25574
751fbde7b9b8921a17d877d5ee8e8c8e0caf912b,1,Dmytro Sen,2016-07-27 14:18:41+03:00,['22b0bd343b06f6d45763881406a404277cd5147f'],1,111,112,23352225,4,0,0.697674419,0.965116279,25574
73f649a47b0a7887c83f0ca446560d895fcbc251,1,Dmytro Sen,2016-07-27 15:03:40+03:00,['751fbde7b9b8921a17d877d5ee8e8c8e0caf912b'],32,148,180,23352405,2,0,0.531914894,1,25574
4d5037e97b13d2e1de562e6360bafda1fa5e7d15,1,Gaurav Nagar,2016-07-27 17:57:42+05:18,['73f649a47b0a7887c83f0ca446560d895fcbc251'],11,6,17,23352422,1,0,0,0,25574
442f33978132721746bd504efbad2bc892f837fd,0,Alex Antonenko,2016-07-27 15:56:00+03:00,['4d5037e97b13d2e1de562e6360bafda1fa5e7d15'],1,0,1,23352423,1,,,,25574
0a846a7e8a747e9547ccf12d38a22ce827155635,0,Alex Antonenko,2016-07-27 15:56:00+03:00,['442f33978132721746bd504efbad2bc892f837fd'],1,1,2,23352425,1,,,,25574
b96213e507abe04bc129acde2ff682df2a38f94e,0,Alex Antonenko,2016-07-27 15:56:00+03:00,['0a846a7e8a747e9547ccf12d38a22ce827155635'],32,76,108,23352533,2,0,1,1,25574
17276363f978f15fdb2dc5d7370836d91ba64530,0,Alex Antonenko,2016-07-27 15:56:00+03:00,['b96213e507abe04bc129acde2ff682df2a38f94e'],2,20,22,23352555,4,,,,25574
25e6a1bf9839f1ba1e4e2d5049dced909550801b,0,ababiichuk,2016-07-27 16:28:30+03:00,['17276363f978f15fdb2dc5d7370836d91ba64530'],3,3,6,23352561,2,0,0,,25574
f01f86caa23262c642b716dc26c6fc7a9a74b7d8,0,ababiichuk,2016-07-27 16:43:49+03:00,['25e6a1bf9839f1ba1e4e2d5049dced909550801b'],0,1,1,23352562,1,0,0,1,25574
fcf60e74ea48fbb18f7ba2bbb21d29534fadeaf2,0,Aleksandr Kovalenko,2016-07-27 17:29:52+03:00,['f01f86caa23262c642b716dc26c6fc7a9a74b7d8'],45,136,181,23352743,4,0,1,1,25574
16f23d33158eb54d7812085cb5c4fbdd809f59e3,0,Dmytro Sen,2016-07-27 18:43:46+03:00,['fcf60e74ea48fbb18f7ba2bbb21d29534fadeaf2'],0,21,21,23352764,3,,,,25574
9109d42005b78ec90b5812f422892e4429157c1b,0,Gautam Borad,2016-07-27 21:10:39+05:18,['16f23d33158eb54d7812085cb5c4fbdd809f59e3'],3,3,6,23352770,2,,,,25574
55b95822476a0211feb06740b35ba13e0da37d8a,1,Aravindan Vijayan,2016-07-27 10:04:40-07:00,['9109d42005b78ec90b5812f422892e4429157c1b'],4,131,135,23352905,3,,,,25575
e7c31f7b0f362c8b70c27c05e688061ae7f341b2,1,Zhe (Joe) Wang,2016-07-27 11:16:02-07:00,['55b95822476a0211feb06740b35ba13e0da37d8a'],11,10,21,23352926,2,1,1,0,25575
e7c4d8d007be2a31d0447f785264c0c5f65b0644,0,Aleksandr Kovalenko,2016-07-27 21:27:09+03:00,['e7c31f7b0f362c8b70c27c05e688061ae7f341b2'],23,23,46,23352972,2,,,,25575
f428a6b97a52f6dee2e1cf7c78327770fd119ae6,1,Alejandro Fernandez,2016-07-27 11:43:31-07:00,['e7c4d8d007be2a31d0447f785264c0c5f65b0644'],5,19,24,23352996,3,0.5,0.5,0,25575
9056daefa67647bedac9d70e432e8585b83fabcb,0,Andrii Tkach,2016-07-27 22:03:16+03:00,['f428a6b97a52f6dee2e1cf7c78327770fd119ae6'],3,5,8,23353004,1,1,1,1,25575
cb1109d695a2409f78f830ef877526ba8db8aad1,1,Jaimin Jetly,2016-07-27 12:19:01-07:00,['9056daefa67647bedac9d70e432e8585b83fabcb'],185,179,364,23353368,10,0,1,1,25575
d6b8617167484d22ceccfc6f1eb71d0b246392f4,0,Vitaly Brodetskyi,2016-07-27 23:08:03+03:00,['cb1109d695a2409f78f830ef877526ba8db8aad1'],5,88,93,23353461,2,0,0.742857143,1,25575
567037bbfb20e9dfac5a8944fdda7229980ee335,1,Jayush Luniya,2016-07-27 13:20:56-07:00,['d6b8617167484d22ceccfc6f1eb71d0b246392f4'],1361,898,2259,23355720,33,0.743589744,0.743589744,0.974358974,25578
82e3d174d76787230eb87d6e8c2534b5fbd02203,0,Alejandro Fernandez,2016-07-27 14:11:39-07:00,['567037bbfb20e9dfac5a8944fdda7229980ee335'],15,0,15,23355735,1,,,,25578
d6a7856720c9ce7d5a54481daaa150c3571eeecd,0,Alex Antonenko,2016-07-28 00:39:20+03:00,['82e3d174d76787230eb87d6e8c2534b5fbd02203'],0,1,1,23355736,1,1,1,1,25578
c79ffa141fad48fe932f33c1741a4a5589479d7f,1,Swapan Shridhar,2016-07-27 14:51:45-07:00,['d6a7856720c9ce7d5a54481daaa150c3571eeecd'],14,21,35,23355771,2,,,,25578
3d4ab478c9e0d1ba918e5eb9054e825b70988493,1,Robert Levas,2016-07-27 18:13:04-04:00,['c79ffa141fad48fe932f33c1741a4a5589479d7f'],3,3,6,23355777,1,,,,25578
ba8b03d72468ea13e0ccfa83a314d39ffe31faf4,0,Xi Wang,2016-07-27 15:42:18-07:00,['3d4ab478c9e0d1ba918e5eb9054e825b70988493'],3,6,9,23355786,1,1,1,0,25578
c0225d0a648dfee2551674fc8ca1e9d8c1707225,0,Jonathan Hurley,2016-07-28 08:54:48-04:00,['ba8b03d72468ea13e0ccfa83a314d39ffe31faf4'],35,4,39,23355825,1,1,1,1,25578
7cff55c5f218988dd2067ca01445e9201d127fbf,1,Vitaly Brodetskyi,2016-07-28 17:04:24+03:00,['c0225d0a648dfee2551674fc8ca1e9d8c1707225'],97,243,340,23356165,11,0,0,0.86259542,25578
25c5f26b6be3bd939d05f9350984d5ad97d8941e,0,Gautam Borad,2016-07-28 20:34:06+05:18,['7cff55c5f218988dd2067ca01445e9201d127fbf'],1,11,12,23356177,2,0,0.444444444,0.444444444,25578
7586bdae28e68cd8fa17998c18d5c738c14cc804,1,Dmytro Sen,2016-07-28 19:16:36+03:00,['25c5f26b6be3bd939d05f9350984d5ad97d8941e'],1,72,73,23356250,2,0,0.9375,0.984375,25578
a1251ecc9afa7c8d313c5ec215ed8db96f510a7f,1,Sandor Magyari,2016-07-28 18:21:07+02:00,['7586bdae28e68cd8fa17998c18d5c738c14cc804'],3,9,12,23356262,2,1,1,1,25578
7ff7bcf3a2d40693cb0a5881661236e07335973a,1,Aravindan Vijayan,2016-07-28 09:56:29-07:00,['a1251ecc9afa7c8d313c5ec215ed8db96f510a7f'],7,181,188,23356450,3,0.772277228,0.930693069,1,25578
802a85c420ce00d1b7366c18c2e3ceddd8aafae9,1,Siddharth Wagle,2016-07-28 11:12:12-07:00,['7ff7bcf3a2d40693cb0a5881661236e07335973a'],67,136,203,23356653,9,0,0.574468085,0.531914894,25578
5936f050480a9dbf56120c6690ba10f654f1408d,1,Sumit Mohanty,2016-07-28 12:22:37-07:00,['802a85c420ce00d1b7366c18c2e3ceddd8aafae9'],88,5,93,23356746,2,1,0.257142857,0,25578
7f4703961ea82f14bf8d0a64326857850df2f78f,1,Sumit Mohanty,2016-07-28 12:22:54-07:00,['5936f050480a9dbf56120c6690ba10f654f1408d'],46,14,60,23356806,4,0.947368421,0,0,25578
cdc268f1b14e9f723a63a37e8949b0333c048529,1,Alex Antonenko,2016-07-28 22:43:21+03:00,['7f4703961ea82f14bf8d0a64326857850df2f78f'],7,58,65,23356871,3,0.666666667,1,1,25578
176690d9c1cea18d9097fd28d1a2038f1f6ac93f,0,Zhe (Joe) Wang,2016-07-28 13:03:34-07:00,['cdc268f1b14e9f723a63a37e8949b0333c048529'],7,8,15,23356886,2,1,1,1,25578
3feae3d62f7307520aa643d53972adf1ac87780c,1,Nahappan Somasundaram,2016-07-28 13:16:23-07:00,['176690d9c1cea18d9097fd28d1a2038f1f6ac93f'],291,268,559,23357445,13,,,,25578
295e8de48390a4c7f0d28dea732f3ebaacaaa750,1,Alejandro Fernandez,2016-07-28 14:06:30-07:00,['3feae3d62f7307520aa643d53972adf1ac87780c'],5,59,64,23357509,4,0,0,1,25579
77571252178955c7136d794ceefb5d7ec914b99c,0,Siddharth Wagle,2016-07-28 14:16:30-07:00,['295e8de48390a4c7f0d28dea732f3ebaacaaa750'],1,1,2,23357511,1,,,,25579
de5d68a0f3784a5133f1a80bb6b773d554eccb89,1,Yusaku Sako,2016-07-28 15:44:37-07:00,['77571252178955c7136d794ceefb5d7ec914b99c'],0,4052,4052,23361563,7,0.761904762,0.533333333,1,25585
940cbb8e5b883a898be28ed39212b25a40573635,1,Alexander Denissov,2016-07-28 16:20:19-07:00,['de5d68a0f3784a5133f1a80bb6b773d554eccb89'],162,158,320,23361883,4,1,1,1,25585
998246237016c72e592563b9d16aeb1cceff977f,1,Nitiraj Rathore,2016-07-29 12:20:01+05:18,['940cbb8e5b883a898be28ed39212b25a40573635'],1,2,3,23361886,1,0,0,1,25585
00f454d85f9ce091dccb897d91b3b6034a53119b,1,Dmytro Sen,2016-07-29 10:26:05+03:00,['998246237016c72e592563b9d16aeb1cceff977f'],23,11,34,23361920,2,1,0,0,25585
512ede2b83a3e0a6df235de445a45f05a318515f,1,Swapan Shridhar,2016-07-29 01:11:34-07:00,['00f454d85f9ce091dccb897d91b3b6034a53119b'],18,60,78,23361998,2,0,0.466666667,0.533333333,25585
296365a174ca958c32c6889e06a10ca83112ae2e,1,Dmytro Sen,2016-07-29 11:59:29+03:00,['512ede2b83a3e0a6df235de445a45f05a318515f'],7,93,100,23362098,5,0.263157895,0.035087719,0.964912281,25585
ad24dda214d189fd325f1c555b1b631c4b896ee8,1,Robert Levas,2016-07-29 08:04:39-04:00,['296365a174ca958c32c6889e06a10ca83112ae2e'],7,354,361,23362459,6,0.473333333,0.86,0.873333333,25588
3cbd29f919ee6657bdf0a16b01a85fc4aa6d785e,1,Jonathan Hurley,2016-07-29 09:14:19-04:00,['ad24dda214d189fd325f1c555b1b631c4b896ee8'],62,118,180,23362639,6,0.875,1,1,25588
80c53da582e27e86c0a192379caeb645a0280a67,0,Alex Antonenko,2016-07-29 17:13:45+03:00,['3cbd29f919ee6657bdf0a16b01a85fc4aa6d785e'],35,0,35,23362674,1,,,,25588
b8b29c525d602b12307617f001b97536c437719a,0,Aleksandr Kovalenko,2016-07-29 17:33:58+03:00,['80c53da582e27e86c0a192379caeb645a0280a67'],1,3,4,23362678,1,1,1,1,25588
b5f039d9775cce51e6008b345c7f2c0dc203adac,0,Dmytro Sen,2016-07-29 19:09:17+03:00,['b8b29c525d602b12307617f001b97536c437719a'],2,0,2,23362680,1,,,,25588
48c895ac69f5688969c8dff7b7808292a931dafe,0,ababiichuk,2016-07-29 20:25:02+03:00,['b5f039d9775cce51e6008b345c7f2c0dc203adac'],0,12,12,23362692,2,1,1,1,25588
957189c540fa5adbb72dec0d86b164f7ee1fef81,1,Lisnichenko Dmitro,2016-07-29 21:12:40+03:00,['48c895ac69f5688969c8dff7b7808292a931dafe'],23,113,136,23362828,3,0,0.962025316,1,25588
40e2680f324b187697fe5b1de21203b4d98ac14c,1,Jayush Luniya,2016-07-29 13:53:00-07:00,['957189c540fa5adbb72dec0d86b164f7ee1fef81'],1308,1354,2662,23365490,82,1,0.936507937,0,25599
4b34366e3d0d5c0cee071a87579209442c319131,0,Alex Antonenko,2016-07-30 02:22:51+03:00,['40e2680f324b187697fe5b1de21203b4d98ac14c'],4,0,4,23365494,1,0,0,0,25599
0abb6d100d9aba6b6e489a3618bfb6912ded2213,1,Jonathan Hurley,2016-07-29 19:26:29-04:00,['4b34366e3d0d5c0cee071a87579209442c319131'],6,55,61,23365555,10,0,0,0.272727273,25599
5d172a134e21f2daff36bedd6aacc564dcafd88f,1,Sumit Mohanty,2016-07-29 18:27:53-07:00,['0abb6d100d9aba6b6e489a3618bfb6912ded2213'],55,5,60,23365615,3,0.658536585,0.463414634,0.073170732,25599
8f15cd2675b6d1fe6f0b48a779bf6fa2301bbc0a,0,Sandor Magyari,2016-07-30 07:35:09+02:00,['5d172a134e21f2daff36bedd6aacc564dcafd88f'],0,9,9,23365624,1,,,,25599
0dd4b729ff0f5f688dd8978a0f01008154c75f58,0,Sumit Mohanty,2016-07-30 07:22:44-07:00,['8f15cd2675b6d1fe6f0b48a779bf6fa2301bbc0a'],1,319,320,23365944,9,0,0.721854305,1,25601
d8a30e2de5f4e0239a0b21415e62166269e6eaca,1,Alex Antonenko,2016-07-30 22:25:30+03:00,['0dd4b729ff0f5f688dd8978a0f01008154c75f58'],0,58,58,23366002,2,0,0.97826087,1,25601
a4be320b12cd9d98b8baa7e9ddf633c08607c854,0,Swapan Shridhar,2016-07-30 13:55:10-07:00,['d8a30e2de5f4e0239a0b21415e62166269e6eaca'],30,0,30,23366032,1,,,,25601
ecc19031952bf37829f07752f0563acb0eab52df,1,Jonathan Hurley,2016-08-01 00:45:41-04:00,['a4be320b12cd9d98b8baa7e9ddf633c08607c854'],206,898,1104,23367136,17,0.362068966,0.959770115,0.954022989,25606
deb0341474c8b81441cdc3be820889133393627a,1,oleewere,2016-08-01 09:51:45+02:00,['ecc19031952bf37829f07752f0563acb0eab52df'],28,154,182,23367318,11,0.34375,0.96875,1,25608
4ddf85836eedb34c4099235db416710873ed64de,1,Dmytro Sen,2016-08-01 12:06:08+03:00,['deb0341474c8b81441cdc3be820889133393627a'],14,4,18,23367336,8,0,0,1,25608
fc09b63b334f14cfa87309d318f96bfc5cc0f778,1,Vitaly Brodetskyi,2016-08-01 14:11:20+03:00,['4ddf85836eedb34c4099235db416710873ed64de'],0,7,7,23367343,1,0,0,1,25608
24dcece8e2677a4c3531293316b3cd8709a21dfd,1,Andrew Onishuk,2016-08-01 14:55:10+03:00,['fc09b63b334f14cfa87309d318f96bfc5cc0f778'],10,8,18,23367361,1,0.8,0.4,0,25608
730e9379d701029796b16faaba959fc130a4e4f3,0,Alex Antonenko,2016-08-01 15:42:06+03:00,['24dcece8e2677a4c3531293316b3cd8709a21dfd'],1,16,17,23367378,2,0,0.933333333,0.933333333,25608
017314e07ae0c32975936d266bae1f4c151eb6f5,0,Aleksandr Kovalenko,2016-08-01 17:37:42+03:00,['730e9379d701029796b16faaba959fc130a4e4f3'],28,32,60,23367438,2,1,1,1,25608
c5d32b81b4b83d39c9b96f5703e9b2e03b8bd1d4,1,Robert Levas,2016-08-01 11:13:15-04:00,['017314e07ae0c32975936d266bae1f4c151eb6f5'],8,59,67,23367505,3,0,1,1,25608
1744a9cc03f5182c93c382e8543f67ef403a0e1e,0,Alex Antonenko,2016-08-01 18:18:55+03:00,['c5d32b81b4b83d39c9b96f5703e9b2e03b8bd1d4'],73,163,236,23367741,2,0.45,0.3,1,25608
181f118517dd2993fa1da222b123279a03540950,1,Alejandro Fernandez,2016-08-01 10:49:32-07:00,['1744a9cc03f5182c93c382e8543f67ef403a0e1e'],14,156,170,23367911,4,0,0.974358974,0.974358974,25609
111b7e54b1911312209487ecc55fb40fb6255065,0,Robert Levas,2016-08-01 14:18:18-04:00,['181f118517dd2993fa1da222b123279a03540950'],2550,0,2550,23370461,15,0.43003413,0.218430034,0.324914676,25609
f135e9f7aa0d608dd711a842be7d12e2ad31c603,1,oleewere,2016-08-01 20:48:42+02:00,['111b7e54b1911312209487ecc55fb40fb6255065'],29,94,123,23370584,10,0,0,1,25610
0ec8a8be287e17b3377809c49b2b27a45816b8b1,1,Jayush Luniya,2016-08-01 13:34:15-07:00,['f135e9f7aa0d608dd711a842be7d12e2ad31c603'],1,2,3,23370587,1,,,,25610
b6b9f2c1a7711d7aca5205ee960d058c59666394,1,Alejandro Fernandez,2016-08-01 14:30:49-07:00,['0ec8a8be287e17b3377809c49b2b27a45816b8b1'],12,91,103,23370690,7,0.152173913,0.630434783,0.326086957,25610
ab940c3ac73cc7b1fd845952310a8d82f3788eca,0,Jayush Luniya,2016-08-01 16:09:28-07:00,['b6b9f2c1a7711d7aca5205ee960d058c59666394'],0,62,62,23370752,5,,,,25612
032a6edc747a5ac065540d880c02fabb26d3722c,1,Aravindan Vijayan,2016-08-01 20:40:10-07:00,['ab940c3ac73cc7b1fd845952310a8d82f3788eca'],138,1,139,23370891,2,,,,25612
5c478f26c9b14b30e2e4f04696e96b06267f4653,1,oleewere,2016-08-02 12:19:09+02:00,['032a6edc747a5ac065540d880c02fabb26d3722c'],14,77,91,23370982,8,0.75,1,1,25612
0a1242849cb044575101dcf3e986e8650b16f944,0,Andrew Onishuk,2016-08-02 15:39:32+03:00,['5c478f26c9b14b30e2e4f04696e96b06267f4653'],0,1,1,23370983,1,0,0,1,25612
a8c0432a9c69c26382fd5c56bc7b10f4451207d7,1,Dmytro Sen,2016-08-02 15:58:51+03:00,['0a1242849cb044575101dcf3e986e8650b16f944'],1,2,3,23370986,1,,,,25612
935266df3722a576a2596d724db9d12644e3a763,1,Vitaly Brodetskyi,2016-08-02 16:04:55+03:00,['a8c0432a9c69c26382fd5c56bc7b10f4451207d7'],375,48,423,23371409,10,0.761111111,0.394444444,0.011111111,25612
668f785c9480da60955e4ff9891b192d23edcdab,0,Aleksandr Kovalenko,2016-08-02 16:42:55+03:00,['935266df3722a576a2596d724db9d12644e3a763'],1,1,2,23371411,1,,,,25612
b38cdb9b77e489f28f656e89964c04e65f9b326f,1,Nahappan Somasundaram,2016-08-02 09:19:33-07:00,['668f785c9480da60955e4ff9891b192d23edcdab'],149,119,268,23371679,14,0,0,1,25612
81e2e12db7b26405e883e09a55d082ba73719b78,1,Sumit Mohanty,2016-08-02 18:46:39-07:00,['b38cdb9b77e489f28f656e89964c04e65f9b326f'],433,434,867,23372546,52,0,0,1,25612
51fc354f9aee00ac94974975c3bd0e26bba0e870,0,Sumit Mohanty,2016-08-02 22:29:24-07:00,['81e2e12db7b26405e883e09a55d082ba73719b78'],5,5,10,23372556,2,,,,25612
e9653052b8254f29a781021bf91e7bc2ea953c61,1,Dipayan Bhowmick,2016-08-03 11:08:40+05:18,['51fc354f9aee00ac94974975c3bd0e26bba0e870'],14,6,20,23372576,5,,,,25612
0272ace43cddc0c1d5126d9535f278aafea32f4d,1,Gaurav Nagar,2016-08-03 15:52:52+05:18,['e9653052b8254f29a781021bf91e7bc2ea953c61'],0,107,107,23372683,3,1,1,1,25613
e3fd2f0bd1586e697d2634efdbfda5be1ab1745d,1,Aleksandr Kovalenko,2016-08-03 15:01:16+03:00,['0272ace43cddc0c1d5126d9535f278aafea32f4d'],2,2,4,23372687,1,,,,25613
f5b9c9fcfc973db22b4624b87aa850b5ef0407ad,0,Andrew Onishuk,2016-08-03 17:39:38+03:00,['e3fd2f0bd1586e697d2634efdbfda5be1ab1745d'],2,2,4,23372691,1,,,,25613
5ddeb09897fbf015f2a63fe33c937a99e027bdbe,1,Robert Levas,2016-08-03 10:53:11-04:00,['f5b9c9fcfc973db22b4624b87aa850b5ef0407ad'],29,184,213,23372904,8,0.128205128,0.474358974,0.935897436,25613
15df9731741f64dd9a6857ec2edaf9aa197f7aaf,1,Aleksandr Kovalenko,2016-08-03 18:34:38+03:00,['5ddeb09897fbf015f2a63fe33c937a99e027bdbe'],1,3,4,23372908,1,,,,25613
9bb77239292f99b935634eafe5e807d61e1d8cb1,1,Jayush Luniya,2016-08-03 10:41:27-07:00,['15df9731741f64dd9a6857ec2edaf9aa197f7aaf'],55,181,236,23373144,16,0,0,0,25614
da1701de99e55997e39e0f644c14e7ff2f927fb7,0,Swapan Shridhar,2016-08-03 12:31:22-07:00,['9bb77239292f99b935634eafe5e807d61e1d8cb1'],161,6,167,23373311,11,0.308823529,0.308823529,0.073529412,25614
c2e9b465df3b3c175baf9048784f38dd486a14a6,0,ljainpivotalio,2016-08-03 13:54:39-07:00,['da1701de99e55997e39e0f644c14e7ff2f927fb7'],8,11,19,23373330,2,0.333333333,1,0,25614
a90b7f7ccd9131463dbc49691f1e26f187d0aa09,1,ljainpivotalio,2016-08-03 14:33:13-07:00,['c2e9b465df3b3c175baf9048784f38dd486a14a6'],19,29,48,23373378,1,0,0,0,25614
bfa24d139aa9d10925850165702024e7a094e473,1,oleewere,2016-08-04 00:08:29+02:00,['a90b7f7ccd9131463dbc49691f1e26f187d0aa09'],2,2,4,23373382,2,,,,25614
b477a192cca5b2748ab4a0e619844c46f9851042,0,Alejandro Fernandez,2016-08-03 19:18:47-07:00,['bfa24d139aa9d10925850165702024e7a094e473'],2,4,6,23373388,1,,,,25614
771d99e631b9b9aaa80b90b250d2cc5d8c2f76b2,1,Dipayan Bhowmick,2016-08-04 11:26:37+05:18,['b477a192cca5b2748ab4a0e619844c46f9851042'],0,24,24,23373412,3,0.588235294,0.823529412,0.941176471,25614
f8c77b06e758145331cb91d2e440419de36c5062,1,Andrew Onishuk,2016-08-04 13:15:33+03:00,['771d99e631b9b9aaa80b90b250d2cc5d8c2f76b2'],9,3,12,23373424,3,0,0,1,25614
96bdf2cb90d6d97c5da3d37ac78928ed319af997,0,"Toader, Sebastian",2016-08-04 15:21:34+02:00,['f8c77b06e758145331cb91d2e440419de36c5062'],0,1,1,23373425,1,,,,25614
c03b6d4b01fbc336c296c9a1a92ca1308cba6ffc,0,Dmytro Sen,2016-08-04 18:36:58+03:00,['96bdf2cb90d6d97c5da3d37ac78928ed319af997'],145,126,271,23373696,11,0.558823529,0.470588235,0,25614
ab9a67ad70fa4b34eabb1a35687f6e9e092c979c,0,Dmytro Sen,2016-08-04 19:21:45+03:00,['c03b6d4b01fbc336c296c9a1a92ca1308cba6ffc'],1,4,5,23373701,2,,,,25614
9bde387854976c76ec93cace59039e34c470b2c8,1,Lisnichenko Dmitro,2016-08-04 19:44:47+03:00,['ab9a67ad70fa4b34eabb1a35687f6e9e092c979c'],19,38,57,23373758,3,1,1,1,25614
564273cd5697961accf5612e902f63bc05891c8e,0,Jaimin Jetly,2016-08-04 10:10:42-07:00,['9bde387854976c76ec93cace59039e34c470b2c8'],1,2,3,23373761,1,,,,25614
97dd0815cfac17902b58ecbe9b5b4953c6921178,1,Nitiraj Rathore,2016-08-04 23:36:59+05:18,['564273cd5697961accf5612e902f63bc05891c8e'],12,12,24,23373785,2,,,,25614
d64868e725e7dd034f725dde062e0c0ac92c1f02,0,Matt,2016-08-04 11:30:51-07:00,['97dd0815cfac17902b58ecbe9b5b4953c6921178'],480,514,994,23374779,4,0.357142857,0,1,25614
10ebfde7ba45ab5018fd93590df4d8771483bdc1,1,Nitiraj Rathore,2016-08-05 00:14:04+05:18,['d64868e725e7dd034f725dde062e0c0ac92c1f02'],35,70,105,23374884,2,0,1,1,25614
eace569bd44f682e43446813f1835f2bcb7fd1f4,0,Zhe (Joe) Wang,2016-08-04 15:34:51-07:00,['10ebfde7ba45ab5018fd93590df4d8771483bdc1'],1,4,5,23374889,1,1,1,1,25614
d9167bdd68342f31482e5872e80cbf760db60085,1,Alexander Denissov,2016-08-04 16:03:43-07:00,['eace569bd44f682e43446813f1835f2bcb7fd1f4'],1,21,22,23374911,4,0,1,1,25614
e7e65cb1e70b3e9e3b927e8e68d405a7b7266894,0,Nahappan Somasundaram,2016-08-04 16:58:49-07:00,['d9167bdd68342f31482e5872e80cbf760db60085'],1,1,2,23374913,1,,,,25614
b55e8fc72370428b303166a83fb9fc8f75cdf737,1,Zhe (Joe) Wang,2016-08-04 17:31:42-07:00,['e7e65cb1e70b3e9e3b927e8e68d405a7b7266894'],2,3,5,23374918,2,,,,25614
851a5d2e0a526ead09d2aff393614eb8ecf69c9c,0,Gautam Borad,2016-08-05 11:58:08+05:18,['b55e8fc72370428b303166a83fb9fc8f75cdf737'],4,42,46,23374964,2,0,0,0,25614
d4a9a635ce6bd609ff2535d9c52c41b6168e643f,0,Lisnichenko Dmitro,2016-08-05 12:04:49+03:00,['851a5d2e0a526ead09d2aff393614eb8ecf69c9c'],14,22,36,23375000,3,0,0,1,25614
4b76d2eb756028746d1911c32d87bd4179bd484f,0,oleewere,2016-08-05 11:37:52+02:00,['d4a9a635ce6bd609ff2535d9c52c41b6168e643f'],1,1,2,23375002,1,,,,25614
dd5672446b4325e74a67e863ab981f9997fffb7c,0,Oleg Nechiporenko,2016-08-05 13:12:18+03:00,['4b76d2eb756028746d1911c32d87bd4179bd484f'],9,190,199,23375201,2,1,1,1,25614
fb2c12964ad26d6460b0d73a00a9750e0bf0442d,0,Robert Levas,2016-08-05 06:20:56-04:00,['dd5672446b4325e74a67e863ab981f9997fffb7c'],15,48,63,23375264,5,0.052631579,1,1,25614
94fb9b49f8ead6bb09ef6e06ee242d0d21247066,0,Mugdha Varadkar,2016-08-05 15:44:35+05:18,['fb2c12964ad26d6460b0d73a00a9750e0bf0442d'],5,28,33,23375297,2,,,,25614
5c5e368fe04b441daca1fbd51650be4f2ad4bfea,1,Andrew Onishuk,2016-08-05 14:37:33+03:00,['94fb9b49f8ead6bb09ef6e06ee242d0d21247066'],1,6,7,23375304,2,,,,25614
52d04b17318d95614a656801635f313b11575fc2,1,oleewere,2016-08-05 13:57:36+02:00,['5c5e368fe04b441daca1fbd51650be4f2ad4bfea'],56,98,154,23375458,19,0.9,0.1,0,25614
9a1719ee887a65b4a34c3f177c977a91ad19cb2d,1,oleewere,2016-08-05 13:57:36+02:00,['52d04b17318d95614a656801635f313b11575fc2'],133,215,348,23375806,17,0.465517241,0.637931034,0.982758621,25614
bac456060777d7fc9491ddc3005d63c4ed933171,1,oleewere,2016-08-05 13:57:37+02:00,['9a1719ee887a65b4a34c3f177c977a91ad19cb2d'],8,16,24,23375830,4,0,0,0.777777778,25614
c63b34cc2d02d58e4b76ac29c50e812a10eb3e6c,1,oleewere,2016-08-05 14:15:48+02:00,['bac456060777d7fc9491ddc3005d63c4ed933171'],99,640,739,23376569,7,0.492063492,0.957671958,0.957671958,25620
3e3285df29b17d467a73d5dfb143ad226f36c2f3,1,Lisnichenko Dmitro,2016-08-05 16:04:17+03:00,['c63b34cc2d02d58e4b76ac29c50e812a10eb3e6c'],1,1,2,23376571,1,,,,25620
8dcfa03df5e35266599da66df22568966441b529,1,Andrew Onishuk,2016-08-05 16:07:29+03:00,['3e3285df29b17d467a73d5dfb143ad226f36c2f3'],24,25,49,23376620,2,0,1,1,25620
15c0a7f2f305feb91e1f0d85da14b2e5664f97b9,0,Gautam Borad,2016-08-05 18:35:37+05:18,['8dcfa03df5e35266599da66df22568966441b529'],42,4,46,23376666,2,1,1,1,25620
8a72bff6d59c2779846846a31114437c63379dfb,1,Andrew Onishuk,2016-08-05 16:56:06+03:00,['15c0a7f2f305feb91e1f0d85da14b2e5664f97b9'],2,2,4,23376670,2,,,,25620
f5b797c16e7385614d8e8d86d5c311eade7612ef,1,Andrew Onishuk,2016-08-05 17:17:39+03:00,['8a72bff6d59c2779846846a31114437c63379dfb'],138,172,310,23376980,22,0.980769231,0,0.307692308,25620
fa0893684006ce083735552008770a6b62dc7a6c,1,"Toader, Sebastian",2016-08-05 16:35:10+02:00,['f5b797c16e7385614d8e8d86d5c311eade7612ef'],6,37,43,23377023,2,0,1,1,25620
dc0722265bb7f6438807bafa8c9edbb96ab50559,0,Robert Levas,2016-08-05 11:14:17-04:00,['fa0893684006ce083735552008770a6b62dc7a6c'],146,461,607,23377630,5,0.461956522,0.956521739,0.918478261,25620
2b7c97fc19a57bb28e8d850242d573fdf1915174,1,Lisnichenko Dmitro,2016-08-05 19:29:24+03:00,['dc0722265bb7f6438807bafa8c9edbb96ab50559'],252,80,332,23377962,20,1,0,0,25620
caa2d3e225881e9fdab82a234afb6f7a21eadd28,1,Jayush Luniya,2016-08-05 10:12:25-07:00,['2b7c97fc19a57bb28e8d850242d573fdf1915174'],3,3,6,23377968,2,,,,25620
e11aa3b9bdf00ffc344e72371d3ab8897cd377f3,1,Swapan Shridhar,2016-08-05 10:39:42-07:00,['caa2d3e225881e9fdab82a234afb6f7a21eadd28'],5,5,10,23377978,1,,,,25620
e0ee23f38b494bfa620fa1f78e493858371d431a,1,Jonathan Hurley,2016-08-05 14:18:53-04:00,['e11aa3b9bdf00ffc344e72371d3ab8897cd377f3'],126,145,271,23378249,11,0.441176471,0.529411765,1,25620
268f5cb65244fd0de540c676bfc135b661f5bb1a,1,Ajit Kumar,2016-08-05 12:14:22-07:00,['e0ee23f38b494bfa620fa1f78e493858371d431a'],121,146,267,23378516,6,0,0.476190476,0.80952381,25620
c0dd9681d0a9c8b204747bf50f08c791f8292c52,1,Alejandro Fernandez,2016-08-05 15:08:19-07:00,['268f5cb65244fd0de540c676bfc135b661f5bb1a'],3,48,51,23378567,7,0,0,0,25620
45c37ce338786bea0456e401be230f4d0579fceb,1,Sumit Mohanty,2016-08-05 16:29:07-07:00,['c0dd9681d0a9c8b204747bf50f08c791f8292c52'],4,8,12,23378579,2,0,0,0,25620
46964151f80adb17da92371b81d41f415a464073,0,Sumit Mohanty,2016-08-05 16:55:09-07:00,['45c37ce338786bea0456e401be230f4d0579fceb'],6,6,12,23378591,3,0,0,0,25620
bb5e116c237b9311320c3e9227b239edee04cade,0,Sumit Mohanty,2016-08-05 17:46:34-07:00,['46964151f80adb17da92371b81d41f415a464073'],7,14,21,23378612,6,0,0,0,25620
6ec6152b7b05481b4eab3076d17fada4c23f7333,1,Sumit Mohanty,2016-08-05 20:07:20-07:00,['bb5e116c237b9311320c3e9227b239edee04cade'],48,15,63,23378675,5,0.947368421,0,0,25620
580bb3dd6304ed26d94a400ddc003675f1c582a2,0,Sumit Mohanty,2016-08-05 23:35:38-07:00,['6ec6152b7b05481b4eab3076d17fada4c23f7333'],1,0,1,23378676,1,,,,25620
a9ab489ce789038a9d1a7bdddb23bc385eca34d5,0,Sumit Mohanty,2016-08-05 23:42:31-07:00,['580bb3dd6304ed26d94a400ddc003675f1c582a2'],1,1,2,23378678,1,,,,25620
61b37d815b77fa9d9946db62190e724ca6cdfbbd,0,Gaurav Nagar,2016-08-06 16:58:47+05:18,['a9ab489ce789038a9d1a7bdddb23bc385eca34d5'],1,185,186,23378864,3,0.660714286,1,0.892857143,25622
e5d35e752448a9c40e73bc0b7d21b3ccc1846da0,0,Gaurav Nagar,2016-08-06 18:09:07+05:18,['61b37d815b77fa9d9946db62190e724ca6cdfbbd'],185,1,186,23379050,3,0.339285714,0,0.107142857,25622
e6ed54e6e14b25420bd9461aa3bff647dc7fc6e9,0,Sumit Mohanty,2016-08-06 07:42:16-07:00,['e5d35e752448a9c40e73bc0b7d21b3ccc1846da0'],8,5,13,23379063,1,,,,25622
d0d6f885c62fcaa93c4ab3766d552384ee5af8ba,1,Jonathan Hurley,2016-08-06 15:32:25-04:00,['e6ed54e6e14b25420bd9461aa3bff647dc7fc6e9'],97,243,340,23379403,8,0,0.787878788,0.96969697,25622
f3e8023dca50a9bfa6aa88ea835ae54b465a70d5,0,Jonathan Hurley,2016-08-06 15:36:43-04:00,['d0d6f885c62fcaa93c4ab3766d552384ee5af8ba'],1,1,2,23379405,1,,,,25622
480bf5a73c2b12359c4d6666a540df863fac49df,1,Sumit Mohanty,2016-08-06 18:35:43-07:00,['f3e8023dca50a9bfa6aa88ea835ae54b465a70d5'],2,48,50,23379455,5,1,1,0,25622
93cb5885a038f4c9cd07dbee05fd624f6fba23c2,1,Sumit Mohanty,2016-08-07 09:07:13-07:00,['480bf5a73c2b12359c4d6666a540df863fac49df'],1,33,34,23379489,2,,,,25622
20821b832dea130da10172f1a787da977d6f44d4,1,Jonathan Hurley,2016-08-08 00:01:33-04:00,['93cb5885a038f4c9cd07dbee05fd624f6fba23c2'],45,241,286,23379775,7,0.12195122,0.304878049,1,25622
ac40623a4c572e9354c6a572d7a81867aa627c0f,0,Alex Antonenko,2016-08-08 14:20:17+03:00,['20821b832dea130da10172f1a787da977d6f44d4'],2,2,4,23379779,1,,,,25622
6257682660ff1f3979b388c83d49d327b24989b2,1,"Toader, Sebastian",2016-08-08 13:56:19+02:00,['ac40623a4c572e9354c6a572d7a81867aa627c0f'],2,7,9,23379788,1,0,1,1,25622
38d1e10fda1a0658ed5e5d2f6eb46de24b61e47d,1,Dipayan Bhowmick,2016-08-08 19:32:47+05:18,['6257682660ff1f3979b388c83d49d327b24989b2'],16,8,24,23379812,2,,,,25622
8c9ea651129a8c1d4bfdbe49bf6c56a1b416d1aa,0,Andrew Onishuk,2016-08-08 17:35:12+03:00,['38d1e10fda1a0658ed5e5d2f6eb46de24b61e47d'],45,0,45,23379857,1,0,0,0,25622
9dfc12c94b791b1e557d02be4f59fb1a6a5883b6,0,Gaurav Nagar,2016-08-08 20:09:59+05:18,['8c9ea651129a8c1d4bfdbe49bf6c56a1b416d1aa'],1,1,2,23379859,1,,,,25622
b5dbee8542a22d9aee1aa2f7fa2b755330cbd1e2,1,Andrew Onishuk,2016-08-08 18:36:36+03:00,['9dfc12c94b791b1e557d02be4f59fb1a6a5883b6'],10,42,52,23379911,6,0,0.461538462,0.769230769,25622
bdbf1835bf3a8f390495a3092779c4ed97abd9fc,1,Aravindan Vijayan,2016-08-08 09:49:59-07:00,['b5dbee8542a22d9aee1aa2f7fa2b755330cbd1e2'],0,345,345,23380256,5,0.045,0.75,0.96,25624
3644112666ed2ac695b9ddbcef6a3ea16e542fd7,0,Jayush Luniya,2016-08-08 13:49:15-07:00,['bdbf1835bf3a8f390495a3092779c4ed97abd9fc'],4,4,8,23380264,1,,,,25624
81797a69ffef80ba10a2aedbb494935c172eba1d,1,Sumit Mohanty,2016-08-08 15:32:00-07:00,['3644112666ed2ac695b9ddbcef6a3ea16e542fd7'],1,13,14,23380278,3,0,0.5,0.5,25624
12e20721897abcc7c5edc9bf1cf1b89eb4e64bb1,0,Oleg Nechiporenko,2016-08-09 11:12:13+03:00,['81797a69ffef80ba10a2aedbb494935c172eba1d'],0,313,313,23380591,1,0.719298246,1,1,25624
b86cf6e98fd6ccf25e1d776b10f168a73d5a4261,0,Alex Antonenko,2016-08-09 11:39:10+03:00,['12e20721897abcc7c5edc9bf1cf1b89eb4e64bb1'],1,1,2,23380593,1,,,,25624
f8511d4e560506ce49f14aed0dc253eba47876ea,1,Nate Cole,2016-08-09 08:28:58-04:00,['b86cf6e98fd6ccf25e1d776b10f168a73d5a4261'],1,1,2,23380595,1,,,,25624
6dcf638192e8abff967c405cc9ef01b4dfc3b764,1,oleewere,2016-08-09 15:08:13+02:00,['f8511d4e560506ce49f14aed0dc253eba47876ea'],130,1123,1253,23381848,11,0.389097744,0.894736842,0.922932331,25630
61b6a52833a5010483b526ced6f8cc6a93ece1f0,0,Aleksandr Kovalenko,2016-08-09 16:41:52+03:00,['6dcf638192e8abff967c405cc9ef01b4dfc3b764'],11,14,25,23381873,2,1,1,1,25630
a1b6d516c136147cb3acaf65dfe85c0abb9d5426,0,Alex Antonenko,2016-08-09 18:11:06+03:00,['61b6a52833a5010483b526ced6f8cc6a93ece1f0'],12,12,24,23381897,1,,,,25630
aa2930a4a696f721934e0608d1dccf206a2fad9f,0,Alejandro Fernandez,2016-08-09 10:54:47-07:00,['a1b6d516c136147cb3acaf65dfe85c0abb9d5426'],2,2,4,23381901,2,,,,25630
c2788a4bd0b075a3b9419ab5d44fdc6bd1ee5b9e,0,Sumit Mohanty,2016-08-09 12:00:53-07:00,['aa2930a4a696f721934e0608d1dccf206a2fad9f'],2,11,13,23381914,3,0,0,0,25630
0273c844d3df9a2dce2ba453e4ce2ebec325ff63,0,Sumit Mohanty,2016-08-09 12:46:42-07:00,['c2788a4bd0b075a3b9419ab5d44fdc6bd1ee5b9e'],21,11,32,23381946,2,,,,25630
2ae4e07af7675c9aa5eef83b5666d526defd45cc,0,Yusaku Sako,2016-08-09 12:59:04-07:00,['0273c844d3df9a2dce2ba453e4ce2ebec325ff63'],0,24,24,23381970,1,,,,25630
c7742e7f1e4435bd9d9395a3dce3b36a4bf21896,1,Yusaku Sako,2016-08-09 13:14:43-07:00,['2ae4e07af7675c9aa5eef83b5666d526defd45cc'],0,21748,21748,23403718,290,0.699223417,0.832735962,0.926523297,25918
a427863166da1be15ba39e40fa24db9c24fbb7b6,0,Mugdha Varadkar,2016-08-10 09:32:00+05:18,['c7742e7f1e4435bd9d9395a3dce3b36a4bf21896'],7,7,14,23403732,2,,,,25918
04975018021f6ecd4b6b87e6ca01fe5205479626,0,Oleg Nechiporenko,2016-08-10 10:35:59+03:00,['a427863166da1be15ba39e40fa24db9c24fbb7b6'],2,7,9,23403741,2,,,,25918
5198b80af4ca24111d1c76dd705bf0f1495d9a4c,1,Dmytro Sen,2016-08-10 11:37:04+03:00,['04975018021f6ecd4b6b87e6ca01fe5205479626'],145,124,269,23404010,10,0.571428571,0.457142857,0,25918
32ef4d4d05f0c3fe3ca060da39b93d3b0bd9b902,1,Andrii Tkach,2016-08-10 13:28:25+03:00,['5198b80af4ca24111d1c76dd705bf0f1495d9a4c'],286,3996,4282,23408292,11,0.783205619,1,0.975734355,25921
13ec2c6616790cb04e2081f983de0aa4b93bae1e,1,Gaurav Nagar,2016-08-10 16:19:39+05:18,['32ef4d4d05f0c3fe3ca060da39b93d3b0bd9b902'],78,144,222,23408514,2,0,0,1,25921
f0f3eab6bc2ae0ec3981395f0f3e6b400d3d5f2b,1,Gaurav Nagar,2016-08-10 16:31:14+05:18,['13ec2c6616790cb04e2081f983de0aa4b93bae1e'],3,3,6,23408520,1,,,,25921
d29b5b292823d50b10490a49a692d32dd011f1a0,0,Gaurav Nagar,2016-08-10 17:13:27+05:18,['f0f3eab6bc2ae0ec3981395f0f3e6b400d3d5f2b'],1,16,17,23408537,2,1,1,1,25921
37e1f5ab2e75c034d9f8b6ff1906f5842b142231,1,Jonathan Hurley,2016-08-10 09:17:42-04:00,['d29b5b292823d50b10490a49a692d32dd011f1a0'],45,30,75,23408612,10,,,,25921
84609068e03bf0d9a97be15dcc192d734970e512,1,Sumit Mohanty,2016-08-10 06:50:06-07:00,['37e1f5ab2e75c034d9f8b6ff1906f5842b142231'],2,8,10,23408622,1,0,0,0,25921
a7f1231fcdfb0c2529f479058851aa718411b25a,1,Andrew Onishuk,2016-08-10 17:47:28+03:00,['84609068e03bf0d9a97be15dcc192d734970e512'],1,3,4,23408626,1,,,,25921
cb1ab5d636f667db33f5861f4f73f8ae61b2bcc8,1,Oleg Nechiporenko,2016-08-10 18:39:59+03:00,['a7f1231fcdfb0c2529f479058851aa718411b25a'],102,105,207,23408833,1,,,,25921
4e41ec399fdf15da6879feda9cc124eec24f76ef,0,Jayush Luniya,2016-08-10 09:39:31-07:00,['cb1ab5d636f667db33f5861f4f73f8ae61b2bcc8'],1,6,7,23408840,2,1,1,1,25921
073b09f24b8aff610a23162b63d76b3cb659688d,1,Jaimin Jetly,2016-08-10 09:55:53-07:00,['4e41ec399fdf15da6879feda9cc124eec24f76ef'],46,140,186,23409026,9,0.573529412,1,0.720588235,25921
bb28c53260fac9be20cd9e99a8fdb6f1b29dff96,1,Lisnichenko Dmitro,2016-08-10 20:15:28+03:00,['073b09f24b8aff610a23162b63d76b3cb659688d'],0,88,88,23409114,20,,,,25921
e1fc6821ddb7dfe9961bb54015d53b619db3b1f2,1,Di Li,2016-08-10 13:41:26-04:00,['bb28c53260fac9be20cd9e99a8fdb6f1b29dff96'],13,225,238,23409352,7,0.169230769,0.769230769,1,25921
9fd39e3bc81ef672f4141c747f837bb27b7ea915,0,Yusaku Sako,2016-08-10 11:02:47-07:00,['e1fc6821ddb7dfe9961bb54015d53b619db3b1f2'],1,1,2,23409354,1,,,,25921
c59b056b657f2754d705db279b657dff4217ba09,1,Sumit Mohanty,2016-08-10 13:58:59-07:00,['9fd39e3bc81ef672f4141c747f837bb27b7ea915'],1,30,31,23409385,2,,,,25922
a4a0ca0b414fa9f30e1b3c4405d283c666c41010,1,Alejandro Fernandez,2016-08-10 15:50:20-07:00,['c59b056b657f2754d705db279b657dff4217ba09'],19,136,155,23409540,5,0.173076923,0.903846154,0.923076923,25922
487acd1474e283016c28f1fdca1202c2ecf9bbe7,0,Sumit Mohanty,2016-08-10 22:17:02-07:00,['a4a0ca0b414fa9f30e1b3c4405d283c666c41010'],1,10,11,23409551,1,,,,25922
5dca158ed803a8c32b9d3620112f3de8ab2e90e7,0,Oleg Nechiporenko,2016-08-11 14:11:50+03:00,['487acd1474e283016c28f1fdca1202c2ecf9bbe7'],2,4,6,23409557,2,1,1,1,25922
83432d70b9dd3bd8f68ba610a31a72dcde907529,0,Vitaly Brodetskyi,2016-08-11 14:46:06+03:00,['5dca158ed803a8c32b9d3620112f3de8ab2e90e7'],0,2,2,23409559,1,,,,25922
4001428d86fc9cd305d2bf14f29690f0b8b074c0,1,Oleg Nechiporenko,2016-08-11 16:01:11+03:00,['83432d70b9dd3bd8f68ba610a31a72dcde907529'],69,106,175,23409734,3,1,1,1,25922
281b2ca5cfc359f5a431280da53efacb57599486,1,Andrew Onishuk,2016-08-11 17:01:32+03:00,['4001428d86fc9cd305d2bf14f29690f0b8b074c0'],1,848,849,23410583,3,0.090909091,1,1,25924
033b1afbe09b16c448ebe244cc3369e9fddfc650,0,Sumit Mohanty,2016-08-11 07:16:27-07:00,['281b2ca5cfc359f5a431280da53efacb57599486'],1,8,9,23410592,1,,,,25924
b45690cd6a2724b6fc44cdef64783b210ea20994,1,Sumit Mohanty,2016-08-11 07:16:34-07:00,['033b1afbe09b16c448ebe244cc3369e9fddfc650'],1,2,3,23410595,2,,,,25924
9829b2defd19758165548fb76b3a8e21a5d36577,1,Lisnichenko Dmitro,2016-08-11 18:04:51+03:00,['b45690cd6a2724b6fc44cdef64783b210ea20994'],11,11,22,23410617,10,,,,25924
cb96d5389406d9bb435e465cc670d07e16aa9526,1,Alex Antonenko,2016-08-11 18:26:18+03:00,['9829b2defd19758165548fb76b3a8e21a5d36577'],6,5,11,23410628,2,0,0,0,25924
cf7ec1298c766a2e0a8dc66c28ea0d8179dae465,1,Oleg Nechiporenko,2016-08-11 19:13:32+03:00,['cb96d5389406d9bb435e465cc670d07e16aa9526'],14,12,26,23410654,3,,,,25924
51bad4583b8efd8e7d8e43bd566ae65393908077,0,Lisnichenko Dmitro,2016-08-11 19:26:10+03:00,['cf7ec1298c766a2e0a8dc66c28ea0d8179dae465'],36,10,46,23410700,2,1,1,0,25924
3cc479e300a95870980cbd5ade7896a2dabd9343,1,Dmytro Sen,2016-08-11 19:48:11+03:00,['51bad4583b8efd8e7d8e43bd566ae65393908077'],12,28,40,23410740,3,,,,25924
6ff0d5767d5ab67c2f1f906283fe520c32cdf401,1,Dmytro Sen,2016-08-11 19:51:11+03:00,['3cc479e300a95870980cbd5ade7896a2dabd9343'],2,47,49,23410789,2,0,0,0.947368421,25924
bf80a34ee1f5c8d4854053e29c6ebefa2f6a9fa5,0,Sumit Mohanty,2016-08-11 10:48:33-07:00,['6ff0d5767d5ab67c2f1f906283fe520c32cdf401'],1,1,2,23410791,1,,,,25924
677e684c59579086f66a6d2dfb2ac95b5bcd831b,1,Jaimin Jetly,2016-08-11 11:19:08-07:00,['bf80a34ee1f5c8d4854053e29c6ebefa2f6a9fa5'],19,105,124,23410915,11,0.408450704,1,1,25924
4fd01fd49830e83e03d9273c0255481b27c727bd,0,Siddharth Wagle,2016-08-11 12:59:31-07:00,['677e684c59579086f66a6d2dfb2ac95b5bcd831b'],2,2,4,23410919,1,0,1,1,25924
dc14815f13c465f6da7898c4b42a1fe63e8bb0ff,1,Robert Levas,2016-08-11 17:06:51-04:00,['4fd01fd49830e83e03d9273c0255481b27c727bd'],69,111,180,23411099,2,0,0,1,25924
c803237635c62aca5d4bfb6c736c6ad0b154e3f1,1,Robert Levas,2016-08-11 17:38:03-04:00,['dc14815f13c465f6da7898c4b42a1fe63e8bb0ff'],0,1583,1583,23412682,4,,,,25928
03457f1c9e261512fa5aa1e5fa59a402f5f2bc8c,0,Lisnichenko Dmitro,2016-08-12 13:14:27+03:00,['c803237635c62aca5d4bfb6c736c6ad0b154e3f1'],15,18,33,23412715,1,,,,25928
7ce06fc7ba4dccc4340db3cb986663a97b2b0c38,0,Andrew Onishuk,2016-08-12 16:32:16+03:00,['03457f1c9e261512fa5aa1e5fa59a402f5f2bc8c'],0,5,5,23412720,1,,,,25928
b1a63404a0efb7fabce77f7a87df1033f8cf2fe0,1,Jonathan Hurley,2016-08-12 09:40:48-04:00,['7ce06fc7ba4dccc4340db3cb986663a97b2b0c38'],1771,2725,4496,23417216,63,0.02247191,0.348314607,0.134831461,25929
b9d61f7d7e91a5d057d9bfa4a650d621cde8be00,1,ababiichuk,2016-08-12 16:52:59+03:00,['b1a63404a0efb7fabce77f7a87df1033f8cf2fe0'],16,575,591,23417807,8,0.71402214,0.963099631,1,25929
25506aeb53123cde7cca6f1aa1056ab9cdc06f8d,1,Aleksandr Kovalenko,2016-08-12 17:16:38+03:00,['b9d61f7d7e91a5d057d9bfa4a650d621cde8be00'],12,10,22,23417829,3,0,0,0,25929
fd7dbd3b26449182a37bea924b619cfa728452c8,1,Aravindan Vijayan,2016-08-12 07:57:35-07:00,['25506aeb53123cde7cca6f1aa1056ab9cdc06f8d'],7,22,29,23417858,5,0,0.4,1,25929
95754ab10e978bb74f3527f0d1a03b088dcc7a83,0,Aravindan Vijayan,2016-08-12 08:07:49-07:00,['fd7dbd3b26449182a37bea924b619cfa728452c8'],8,330,338,23418196,5,0.307142857,0.864285714,1,25931
9696b62afb98a7e94815e9aec26692d533cad12a,0,Aravindan Vijayan,2016-08-12 08:08:55-07:00,['95754ab10e978bb74f3527f0d1a03b088dcc7a83'],9,8,17,23418213,1,,1,,25931
212927a416c3edec6e20c25217b6f28fc1f7e55b,1,Aravindan Vijayan,2016-08-12 08:11:16-07:00,['9696b62afb98a7e94815e9aec26692d533cad12a'],8,9,17,23418230,1,,0,,25931
7a6f710e223a78d40a7bfa0c21d45686c8aa8fb5,0,Aravindan Vijayan,2016-08-12 08:11:23-07:00,['212927a416c3edec6e20c25217b6f28fc1f7e55b'],330,8,338,23418568,5,0.692857143,0.135714286,0,25931
755c5eabc8eee9f8bd051efa340d8b56789984e8,1,Lisnichenko Dmitro,2016-08-12 19:54:08+03:00,['7a6f710e223a78d40a7bfa0c21d45686c8aa8fb5'],3,3,6,23418574,3,,,,25931
c08cbff6ee1e734620472d8edc1c659e4938c01b,0,Alejandro Fernandez,2016-08-12 10:48:17-07:00,['755c5eabc8eee9f8bd051efa340d8b56789984e8'],8,11,19,23418593,3,0,0,0,25931
9a4d1b1076ec7adbddde6ad82062755b271df106,1,Dipayan Bhowmick,2016-08-12 23:54:22+05:18,['c08cbff6ee1e734620472d8edc1c659e4938c01b'],285,40,325,23418918,11,0,0,0.092307692,25931
ba6482fadb5dbb4d193a326e1a9ac3d8485b0d43,0,Sumit Mohanty,2016-08-12 11:41:48-07:00,['9a4d1b1076ec7adbddde6ad82062755b271df106'],0,7,7,23418925,1,,,,25931
5676cd0c946dc34468037b4996d5f1ce7fac20e0,1,ljainpivotalio,2016-08-12 14:36:04-07:00,['ba6482fadb5dbb4d193a326e1a9ac3d8485b0d43'],414,303,717,23419642,14,0.992063492,0,0,25932
8e875c427f7a0d58389db8ee37211752a697098b,1,Sumit Mohanty,2016-08-13 14:12:25-07:00,['5676cd0c946dc34468037b4996d5f1ce7fac20e0'],7,68,75,23419717,5,0.217391304,0.782608696,0.217391304,25932
0ed240673361e88745f4a7b82033c6490661828a,1,Andrew Onishuk,2016-08-14 15:50:33+03:00,['8e875c427f7a0d58389db8ee37211752a697098b'],0,9,9,23419726,1,,,,25932
43bc59665028cdab8a4895f478c5a75957064059,0,Alex Antonenko,2016-08-15 12:13:03+03:00,['0ed240673361e88745f4a7b82033c6490661828a'],1,1,2,23419728,1,,,,25932
e3f9dbd7ffb4b69b31e0fef01587fe02717e6cdb,1,Aleksandr Kovalenko,2016-08-15 13:48:01+03:00,['43bc59665028cdab8a4895f478c5a75957064059'],1,1,2,23419730,1,,,,25932
8ebdd91ba5c864eaa8d8aa7b2f0aaadab8d41818,0,Andrew Onishuk,2016-08-15 14:14:11+03:00,['e3f9dbd7ffb4b69b31e0fef01587fe02717e6cdb'],18,1,19,23419749,3,0,0,0,25932
2dd7510b5367c8f73f1bb15891f0d11c0eaaa4af,1,Di Li,2016-08-15 10:53:22-04:00,['8ebdd91ba5c864eaa8d8aa7b2f0aaadab8d41818'],0,128,128,23419877,7,0.936507937,1,0.857142857,25934
d50518c1e6dbbe0cc720123d541cc8ab4367fb13,1,Aleksandr Kovalenko,2016-08-15 20:11:33+03:00,['2dd7510b5367c8f73f1bb15891f0d11c0eaaa4af'],6,41,47,23419924,3,1,1,1,25934
d6f1720e86a9bf079c6b5a49066e030b3a499c51,0,Swapan Shridhar,2016-08-15 13:35:46-07:00,['d50518c1e6dbbe0cc720123d541cc8ab4367fb13'],1,11,12,23419936,1,,,,25934
3e3641d8ee3f71feef200802cc19adf2235c8fc6,0,Sumit Mohanty,2016-08-15 14:34:51-07:00,['d6f1720e86a9bf079c6b5a49066e030b3a499c51'],13,46,59,23419995,9,1,1,1,25934
2f3da5f0227f49dd52d33709ff69a6189989b4a2,1,Dipayan Bhowmick,2016-08-16 10:34:33+05:18,['3e3641d8ee3f71feef200802cc19adf2235c8fc6'],10,4,14,23420009,2,0,1,1,25934
b453b02702b3e1a335879eb5b357bc893ef8e3ed,0,ababiichuk,2016-08-16 10:02:51+03:00,['2f3da5f0227f49dd52d33709ff69a6189989b4a2'],4,18,22,23420031,1,,,,25934
a004067e603972639334f1649df043201e873c83,1,Alex Antonenko,2016-08-16 13:04:50+03:00,['b453b02702b3e1a335879eb5b357bc893ef8e3ed'],39,451,490,23420521,4,0.402088773,0.953002611,1,25935
e2fd231c0b4084bd4b152470dc472c541646e69b,1,ababiichuk,2016-08-16 16:34:35+03:00,['a004067e603972639334f1649df043201e873c83'],1,3,4,23420525,1,,,,25935
797752341c83b38cedfbad3b89c61736eac69772,1,Andrii Tkach,2016-08-16 17:37:03+03:00,['e2fd231c0b4084bd4b152470dc472c541646e69b'],16,1053,1069,23421594,9,0.607375271,1,1,25937
4a2ee5009c3246a89a37fcf837eafad289fb7892,0,Andrew Onishuk,2016-08-16 17:55:29+03:00,['797752341c83b38cedfbad3b89c61736eac69772'],1,16,17,23421611,2,0.727272727,0.727272727,0.636363636,25937
aa58a54b54adfed8893cf7cffe3286e9c2d1fec3,1,Di Li,2016-08-16 11:43:21-04:00,['4a2ee5009c3246a89a37fcf837eafad289fb7892'],1,17,18,23421629,2,0,1,1,25937
ba2aa091b166c77df02b37c4476cfa258f855178,0,Aleksandr Kovalenko,2016-08-16 19:44:35+03:00,['aa58a54b54adfed8893cf7cffe3286e9c2d1fec3'],3,6,9,23421638,2,0,1,1,25937
ff4b2c4bed5582b455f78055aec4f9e2a0284704,1,Nahappan Somasundaram,2016-08-16 10:21:59-07:00,['ba2aa091b166c77df02b37c4476cfa258f855178'],7,24,31,23421669,2,0,1,1,25937
28367d62b4d080d93b4941803612ea79cadf0f84,1,Dipayan Bhowmick,2016-08-16 23:42:03+05:18,['ff4b2c4bed5582b455f78055aec4f9e2a0284704'],38,245,283,23421952,9,0.646017699,0.601769912,0.575221239,25939
49cb0d1ac2ec9348d8c99d72500a0486e0c98614,0,Nahappan Somasundaram,2016-08-16 12:49:58-07:00,['28367d62b4d080d93b4941803612ea79cadf0f84'],0,143,143,23422095,1,,,,25940
43457696137486daa338f39cef5e899554f025b3,0,Jayush Luniya,2016-08-16 14:18:13-07:00,['49cb0d1ac2ec9348d8c99d72500a0486e0c98614'],12,2,14,23422109,2,,,,25940
1b5e1c01a97489db90cbcaeaff2876ffa8e454ea,1,Jaimin Jetly,2016-08-16 21:09:08-07:00,['43457696137486daa338f39cef5e899554f025b3'],3,3,6,23422115,2,,,,25940
7187592036110295285a09b93c7c4da35f53f677,1,Oleg Nechiporenko,2016-08-17 11:11:06+03:00,['1b5e1c01a97489db90cbcaeaff2876ffa8e454ea'],137,250,387,23422502,10,0.52238806,0,0.805970149,25940
639515be3e372d0cb4035e325465796fa89b1dd2,0,Myroslav Papirkovskyi,2016-08-17 12:56:19+03:00,['7187592036110295285a09b93c7c4da35f53f677'],6,10,16,23422518,1,1,1,1,25940
9911267f0727c99f5355a60df06584023dd49983,1,Jonathan Hurley,2016-08-17 08:21:17-04:00,['639515be3e372d0cb4035e325465796fa89b1dd2'],338,1573,1911,23424429,12,0.142857143,0.326530612,1,25942
42fd20de03c0c665b5659f47b758eabc7681e3bd,0,Oleg Nechiporenko,2016-08-17 16:10:04+03:00,['9911267f0727c99f5355a60df06584023dd49983'],2,95,97,23424526,3,0.58974359,0.230769231,0.666666667,25942
9ac9e9b8f2fff479918cbdcdd9b742cfd173dc22,1,Dmytro Sen,2016-08-17 17:05:32+03:00,['42fd20de03c0c665b5659f47b758eabc7681e3bd'],3,2,5,23424531,1,,,,25942
f16126ea649e368b9d3741aa2aeba36746ab2b7e,1,Andrew Onishuk,2016-08-17 17:23:24+03:00,['9ac9e9b8f2fff479918cbdcdd9b742cfd173dc22'],6,9,15,23424546,3,0,1,1,25942
793adfe46a02e0870ae8aa4f334818d5fa401965,0,Dmytro Sen,2016-08-17 19:17:48+03:00,['f16126ea649e368b9d3741aa2aeba36746ab2b7e'],9461,0,9461,23434007,12,0.63941871,0.371480472,0.35195277,25942
8d47d3825489e63d5e16e537257b02f8075dceab,0,Aravindan Vijayan,2016-08-17 10:55:03-07:00,['793adfe46a02e0870ae8aa4f334818d5fa401965'],9,8,17,23434024,1,,1,,25942
b45c5359ebdd6d2738a84f0ead2bad4224401a3b,0,Aravindan Vijayan,2016-08-17 10:55:13-07:00,['8d47d3825489e63d5e16e537257b02f8075dceab'],6,6,12,23434036,6,,,,25942
ad2da2908585dd094cd10782e368634bef339390,1,Aravindan Vijayan,2016-08-17 10:57:02-07:00,['b45c5359ebdd6d2738a84f0ead2bad4224401a3b'],19,20,39,23434075,8,1,1,0,25942
849e28e980951b72665677ddb25dcb02d44e4748,1,Zhe (Joe) Wang,2016-08-17 11:23:37-07:00,['ad2da2908585dd094cd10782e368634bef339390'],18,85,103,23434178,6,0.192307692,0.807692308,1,25943
a92932560a74ba70577c15fbbdc447ae1e4b997d,0,Gaurav Nagar,2016-08-17 23:53:05+05:18,['849e28e980951b72665677ddb25dcb02d44e4748'],5,5,10,23434188,2,,,,25943
aee400608f6d111b4c3f8913bc1a01d640a6f409,1,Alejandro Fernandez,2016-08-17 13:29:16-07:00,['a92932560a74ba70577c15fbbdc447ae1e4b997d'],4,201,205,23434393,7,0.109756098,0.109756098,1,25944
ac68843fcd75f5f1eae5238620e05a8212ba9e3e,0,Aravindan Vijayan,2016-08-17 14:46:07-07:00,['aee400608f6d111b4c3f8913bc1a01d640a6f409'],1,1,2,23434395,1,,,,25944
50d8928c747a35401cd31fc904ed38571dad581e,0,Alejandro Fernandez,2016-08-17 15:26:27-07:00,['ac68843fcd75f5f1eae5238620e05a8212ba9e3e'],3,5,8,23434403,2,0,0.5,0.5,25944
bc2d2d3784809b9167cdf8ddf1f2badebc7e2409,0,Alejandro Fernandez,2016-08-17 15:44:09-07:00,['50d8928c747a35401cd31fc904ed38571dad581e'],0,163,163,23434566,2,,,,25945
813938395f23ca1a70bf75b3bea3eeaa54ea1997,0,Jonathan Hurley,2016-08-18 09:34:36-04:00,['bc2d2d3784809b9167cdf8ddf1f2badebc7e2409'],2,12,14,23434580,2,,,,25945
c758b7ffe98f136590012867d4a2bba1484c051e,1,Sandor Magyari,2016-08-18 16:14:55+02:00,['813938395f23ca1a70bf75b3bea3eeaa54ea1997'],0,9461,9461,23444041,12,0.36058129,0.628519528,0.64804723,25957
2bc8690a33f48b61def8278dd8abba938456e5f2,0,Andrew Onishuk,2016-08-18 17:24:49+03:00,['c758b7ffe98f136590012867d4a2bba1484c051e'],2,5,7,23444048,2,,,,25957
d3bac1d45e9bf57d562b447d1d4540ac867ad602,1,Aleksandr Kovalenko,2016-08-18 19:02:31+03:00,['2bc8690a33f48b61def8278dd8abba938456e5f2'],11,27,38,23444086,4,1,1,1,25957
78886384b075f5e0108b587dbf1760d29848641d,0,Jonathan Hurley,2016-08-18 13:01:44-04:00,['d3bac1d45e9bf57d562b447d1d4540ac867ad602'],4,10,14,23444100,2,0,0,1,25957
1d3f8a4ce7b847ca150c7276fc8a417488290e0a,0,Alex Antonenko,2016-08-18 20:11:11+03:00,['78886384b075f5e0108b587dbf1760d29848641d'],1,1,2,23444102,1,,,,25957
712a12b6b3228d5bd532aa7a594544c8bd594d66,1,Robert Levas,2016-08-18 13:48:47-04:00,['1d3f8a4ce7b847ca150c7276fc8a417488290e0a'],1,1,2,23444104,1,,,,25957
fda22e2e626e655674d55a8f1e91c70bbdb7a8ae,1,Jonathan Hurley,2016-08-18 14:11:50-04:00,['712a12b6b3228d5bd532aa7a594544c8bd594d66'],30,2,32,23444136,3,,,,25957
0e5fb8ee8e205ccb9da889e44ba77ffbde3f86dd,0,Jayush Luniya,2016-08-18 12:01:35-07:00,['fda22e2e626e655674d55a8f1e91c70bbdb7a8ae'],1,163,164,23444300,3,0.93258427,0.674157303,0.674157303,25957
a57daad47194438f5df10414130aa18effc3446e,0,Sumit Mohanty,2016-08-18 13:29:19-07:00,['0e5fb8ee8e205ccb9da889e44ba77ffbde3f86dd'],0,10,10,23444310,2,0,0,0,25957
125be0469998b608d541e00e1e2ae8b05223ab6d,0,Alejandro Fernandez,2016-08-18 16:18:13-07:00,['a57daad47194438f5df10414130aa18effc3446e'],71,73,144,23444454,7,,,,25957
5a943f49046d3cb30aa3d74a066374aaf29cef05,1,Sumit Mohanty,2016-08-18 21:45:59-07:00,['125be0469998b608d541e00e1e2ae8b05223ab6d'],163,1,164,23444618,3,0.06741573,0.325842697,0.325842697,25957
356feed94f16b1cc78ca4f407cd54828effd3b53,0,Lisnichenko Dmitro,2016-08-19 11:33:12+03:00,['5a943f49046d3cb30aa3d74a066374aaf29cef05'],5,0,5,23444623,1,,,,25957
2ad7c8024403be251235e49898d0ef1203ad6563,1,Lisnichenko Dmitro,2016-08-19 11:33:37+03:00,['356feed94f16b1cc78ca4f407cd54828effd3b53'],1,250,251,23444874,4,0.512345679,0.820987654,0.820987654,25957
9ad19662817e2c24a4c3e72bb465b0a35e521bf2,1,Alex Antonenko,2016-08-19 15:29:17+03:00,['2ad7c8024403be251235e49898d0ef1203ad6563'],15,1036,1051,23445925,15,0.583333333,1,1,25965
407c452517f04d05ddeb0d290adb48b500a5ead4,0,Aleksandr Kovalenko,2016-08-19 17:23:12+03:00,['9ad19662817e2c24a4c3e72bb465b0a35e521bf2'],1,2,3,23445928,1,1,1,1,25965
e7c85c7dd67ed6633d78f5d427d5095d00a5447d,0,Dmytro Sen,2016-08-19 19:47:01+03:00,['407c452517f04d05ddeb0d290adb48b500a5ead4'],2,2,4,23445932,2,,,,25965
5f9c3ab1a3fbdb775f27adfac5d4cd43443018cd,1,Aravindan Vijayan,2016-08-19 09:49:32-07:00,['e7c85c7dd67ed6633d78f5d427d5095d00a5447d'],0,1362,1362,23447294,13,0.537444934,0.788546256,0.86784141,25975
4773c839965068bb2827b0d308c0bec9599b39c1,1,Nate Cole,2016-08-19 15:07:17-04:00,['5f9c3ab1a3fbdb775f27adfac5d4cd43443018cd'],9,101,110,23447404,4,0.06779661,0.847457627,0.881355932,25975
c17d98013cf3ae9649f85345c3dc16fae5d8e994,1,Alejandro Fernandez,2016-08-19 13:48:14-07:00,['4773c839965068bb2827b0d308c0bec9599b39c1'],83,268,351,23447755,12,0.043478261,1,0.836956522,25976
ae47ae96c70c4fbc672d1539a07999a2819ea998,0,Nate Cole,2016-08-19 16:58:23-04:00,['c17d98013cf3ae9649f85345c3dc16fae5d8e994'],0,156,156,23447911,5,0.138461538,0.4,1,25977
da07ea14a911837e709f330b33b205cb17f80f05,0,Vitaly Brodetskyi,2016-08-20 00:13:00+03:00,['ae47ae96c70c4fbc672d1539a07999a2819ea998'],1,2,3,23447914,1,,,,25977
48831ba56e8adaa1840eb9efa0651265883c712d,1,Alejandro Fernandez,2016-08-19 15:24:53-07:00,['da07ea14a911837e709f330b33b205cb17f80f05'],37,37,74,23447988,3,,,,25977
df1b77b620fc3acc2fe01188ff374c23450b703e,0,Yusaku Sako,2016-08-19 15:28:01-07:00,['48831ba56e8adaa1840eb9efa0651265883c712d'],1,1,2,23447990,1,,,,25977
4c37044902b57ed674e00ee93cba3e100d81518c,0,Yusaku Sako,2016-08-19 16:11:31-07:00,['df1b77b620fc3acc2fe01188ff374c23450b703e'],0,18,18,23448008,1,,,,25977
cfef220d92ed102cde2ed77fe6d12bd973a189a2,1,Sumit Mohanty,2016-08-20 12:11:10-07:00,['4c37044902b57ed674e00ee93cba3e100d81518c'],3,3,6,23448014,2,,,,25977
fe768ad8767fcd82ce13b8d762f987efa8557df2,1,Sumit Mohanty,2016-08-20 18:11:17-07:00,['cfef220d92ed102cde2ed77fe6d12bd973a189a2'],3,4,7,23448021,1,,,,25977
5eb69463ed475072ab4a0a038e6f35d5b9b70fe2,0,Jaimin Jetly,2016-08-20 19:21:46-07:00,['fe768ad8767fcd82ce13b8d762f987efa8557df2'],9,23,32,23448053,3,1,1,1,25977
967ce4be73bd3f1fe553e6930a70ddaf5e6acd2a,0,Sumit Mohanty,2016-08-20 21:21:05-07:00,['5eb69463ed475072ab4a0a038e6f35d5b9b70fe2'],3,3,6,23448059,2,,,,25977
74945492b2a6574eea7d3fb9e93f24c22b98b892,0,Gaurav Nagar,2016-08-21 15:43:12+05:18,['967ce4be73bd3f1fe553e6930a70ddaf5e6acd2a'],1,4,5,23448064,1,1,1,1,25977
7a34fe1d80897d5db7acb0ac276fb270b3baa3b9,1,Gaurav Nagar,2016-08-21 20:33:02+05:18,['74945492b2a6574eea7d3fb9e93f24c22b98b892'],298,735,1033,23449097,34,0.745980707,1,0,25977
e74ecc9a5a54eb1b3ff2604d2748ef3111856892,1,Alejandro Fernandez,2016-08-21 15:21:25-07:00,['7a34fe1d80897d5db7acb0ac276fb270b3baa3b9'],4,6,10,23449107,1,0,0,1,25977
56fe3368bcfee0fb58b1bd1635d0285d1274667f,1,oleewere,2016-08-22 12:37:31+02:00,['e74ecc9a5a54eb1b3ff2604d2748ef3111856892'],14,18,32,23449139,2,,,,25977
d054a473bedd0f4ba77fcb8508b883611d14b20c,1,Dipayan Bhowmick,2016-08-22 21:04:32+05:18,['56fe3368bcfee0fb58b1bd1635d0285d1274667f'],18,208,226,23449365,4,0.761363636,1,1,25978
169dd4b63664520d036b864af8096a83764487ca,0,Andrew Onishuk,2016-08-22 19:42:15+03:00,['d054a473bedd0f4ba77fcb8508b883611d14b20c'],0,1,1,23449366,1,,,,25978
4b9a816846d56dc027fd3492211ec9ec057c7890,1,Jonathan Hurley,2016-08-22 12:53:18-04:00,['169dd4b63664520d036b864af8096a83764487ca'],18,148,166,23449532,8,0,0.588235294,0.911764706,25978
a56891e781480993c92333006b6ccf5b22bb3e54,0,Jayush Luniya,2016-08-22 10:46:59-07:00,['4b9a816846d56dc027fd3492211ec9ec057c7890'],1,3,4,23449536,2,1,1,1,25978
d1df0800c4ec96f1f6121a62ae9c4a61f76d555f,1,Jaimin Jetly,2016-08-22 11:16:08-07:00,['a56891e781480993c92333006b6ccf5b22bb3e54'],0,28,28,23449564,1,,,,25978
9d789a374ff3e442a112449968f8e19730aa166b,0,Vitaly Brodetskyi,2016-08-22 23:32:12+03:00,['d1df0800c4ec96f1f6121a62ae9c4a61f76d555f'],1,3,4,23449568,2,,,,25978
3b600322937f3a0c95f3079c08bd3a9580f535c4,0,Sumit Mohanty,2016-08-22 14:17:28-07:00,['9d789a374ff3e442a112449968f8e19730aa166b'],2,34,36,23449604,4,,,,25978
79588cedb46e794158b1b2516477c12d3701c785,0,Alejandro Fernandez,2016-08-22 15:34:27-07:00,['3b600322937f3a0c95f3079c08bd3a9580f535c4'],0,19,19,23449623,6,0,0.8,1,25978
f4f685239b9eb1310bd272e841b4c238c7324b6f,1,Swapan Shridhar,2016-08-22 16:15:00-07:00,['79588cedb46e794158b1b2516477c12d3701c785'],8,11,19,23449642,3,0,1,1,25978
91cd8274ae299f4fd4e6553bbd7f58f54148b65e,0,Alejandro Fernandez,2016-08-22 16:54:05-07:00,['f4f685239b9eb1310bd272e841b4c238c7324b6f'],0,2,2,23449644,1,0,0,1,25978
7ffa7e6b297639f5e793eb1d2dc49ac1ffe85b83,0,Alejandro Fernandez,2016-08-22 16:58:55-07:00,['91cd8274ae299f4fd4e6553bbd7f58f54148b65e'],1,1,2,23449646,1,,,,25978
3be3c2e13d32d0f51dce0cad4cd53528d226a659,0,Vitaly Brodetskyi,2016-08-23 10:41:12+03:00,['7ffa7e6b297639f5e793eb1d2dc49ac1ffe85b83'],0,1,1,23449647,1,,,,25978
02f31bc2e4273c95ab85a9e61c948dd2674ff100,0,Lisnichenko Dmitro,2016-08-23 13:32:51+03:00,['3be3c2e13d32d0f51dce0cad4cd53528d226a659'],69,47,116,23449763,4,0.785714286,0.142857143,0.142857143,25978
288573dceaf6a82f3d671186e766688d53407028,0,Myroslav Papirkovskyi,2016-08-23 19:10:58+03:00,['02f31bc2e4273c95ab85a9e61c948dd2674ff100'],20,1,21,23449784,2,1,0,0,25978
bdae70187acac5de9890ee964357298121219487,1,Myroslav Papirkovskyi,2016-08-23 19:24:32+03:00,['288573dceaf6a82f3d671186e766688d53407028'],48,263,311,23450095,52,1,0.958041958,0.615384615,25978
e671d0fe7afa68de9d0a6b55e748b68d2272c70b,1,Lisnichenko Dmitro,2016-08-23 19:29:14+03:00,['bdae70187acac5de9890ee964357298121219487'],0,307,307,23450402,6,0,1,1,25980
527a118d5b5840be2bda74b41fefe7c56092a91c,0,Aravindan Vijayan,2016-08-23 09:54:34-07:00,['e671d0fe7afa68de9d0a6b55e748b68d2272c70b'],2,10,12,23450414,1,0,0,1,25980
2897071c10ef0476749162927189c42c5fd57f84,1,Aravindan Vijayan,2016-08-23 09:56:10-07:00,['527a118d5b5840be2bda74b41fefe7c56092a91c'],10,2,12,23450426,1,1,1,0,25980
cb0d4e1868d89f9d567b05ac8e0c6c7e33bc1f4a,0,Aravindan Vijayan,2016-08-23 10:16:52-07:00,['2897071c10ef0476749162927189c42c5fd57f84'],2,11,13,23450439,1,0,0,1,25980
2cee921c8572b85ab598448280d1a7be5bd50b4e,1,Siddharth Wagle,2016-08-23 10:17:47-07:00,['cb0d4e1868d89f9d567b05ac8e0c6c7e33bc1f4a'],4,95,99,23450538,2,0,0,1,25980
04a534ceacb1887c4666c97ea0d1a2670fe4a1cd,1,Jonathan Hurley,2016-08-23 17:01:44-04:00,['2cee921c8572b85ab598448280d1a7be5bd50b4e'],236,132,368,23450906,2,1,0.113333333,0,25980
7ee5242c6b58159c8f40267ae25eebce3295b45b,0,Yusaku Sako,2016-08-23 14:48:33-07:00,['04a534ceacb1887c4666c97ea0d1a2670fe4a1cd'],0,12,12,23450918,1,,,,25980
2a36fc5ec56c5b697d7c815d3b8147a1e9df41c8,1,Yusaku Sako,2016-08-23 16:05:59-07:00,['7ee5242c6b58159c8f40267ae25eebce3295b45b'],4,4,8,23450926,1,,,,25980
5b6971ae47a826f773b8ccd37dadc049e48a6a68,0,Alejandro Fernandez,2016-08-23 17:12:37-07:00,['2a36fc5ec56c5b697d7c815d3b8147a1e9df41c8'],0,6,6,23450932,1,,,,25980
6b969905215f32ef333ec9d7b01f43af9c55ba47,1,Jayush Luniya,2016-08-23 17:23:38-07:00,['5b6971ae47a826f773b8ccd37dadc049e48a6a68'],5,7,12,23450944,2,0,0,1,25980
e90fb2807d94d9d94ee095fc6625b5767a46d8da,0,"Toader, Sebastian",2016-08-24 14:08:41+02:00,['6b969905215f32ef333ec9d7b01f43af9c55ba47'],4,4,8,23450952,2,,,,25980
d90fd2b8b3c5c11b46423f4deef395a25d3e88a5,0,Di Li,2016-08-24 10:52:19-04:00,['e90fb2807d94d9d94ee095fc6625b5767a46d8da'],17,121,138,23451090,1,0.157303371,0.056179775,0.764044944,25980
e0e708f66fc46b514455d84552cb21670849491c,1,Alejandro Fernandez,2016-08-24 11:24:26-07:00,['d90fd2b8b3c5c11b46423f4deef395a25d3e88a5'],47,69,116,23451206,4,0.214285714,0.857142857,0.857142857,25980
11ecbdb2f5a97749b9070d02b2cda2d503c5656a,0,Jonathan Hurley,2016-08-24 14:41:53-04:00,['e0e708f66fc46b514455d84552cb21670849491c'],1,1,2,23451208,1,,,,25980
4ffb4929a2bb0b3260da2babcab815620090e076,0,Zhe (Joe) Wang,2016-08-24 17:32:22-07:00,['11ecbdb2f5a97749b9070d02b2cda2d503c5656a'],7,0,7,23451215,1,0,0,0,25980
5878c1af7f45262f3b21fec7e553b3ca380d3564,1,Pallav Kulshreshtha,2016-08-25 14:43:31+05:18,['4ffb4929a2bb0b3260da2babcab815620090e076'],144,877,1021,23452236,29,0.8575,0.875,1,25982
8242c7f06f2fdaf1efd623e2b6a545fec5582c6c,1,"Toader, Sebastian",2016-08-25 13:35:37+02:00,['5878c1af7f45262f3b21fec7e553b3ca380d3564'],2,99,101,23452337,2,0.06097561,1,1,25982
8a972c1cb0524a8c44a901eaf64ca31866f74bde,1,Vitaly Brodetskyi,2016-08-25 15:54:13+03:00,['8242c7f06f2fdaf1efd623e2b6a545fec5582c6c'],28,232,260,23452597,5,0.1,0.592857143,0.264285714,25982
37335be80c9247ca9fbbd5c1b95b3bcdee0c5014,1,Jonathan Hurley,2016-08-25 12:42:21-04:00,['8a972c1cb0524a8c44a901eaf64ca31866f74bde'],8,51,59,23452656,2,0.095238095,0.380952381,0.095238095,25982
bd8587849eb99baa187d5a84f4829e3f642104fc,1,Nate Cole,2016-08-25 13:28:37-04:00,['37335be80c9247ca9fbbd5c1b95b3bcdee0c5014'],12,262,274,23452930,14,0.550724638,0.913043478,0.869565217,25984
08763a77f1d030c7cf2648955fe7c1fab6abdb3b,0,Sumit Mohanty,2016-08-25 13:43:21-07:00,['bd8587849eb99baa187d5a84f4829e3f642104fc'],10,10,20,23452950,3,,,,25984
5dbb43e7ff9fedf9b35718a1980ec70fbf7b0cd2,1,Zhe (Joe) Wang,2016-08-25 15:00:21-07:00,['08763a77f1d030c7cf2648955fe7c1fab6abdb3b'],22,718,740,23453690,9,0.247240618,0.27593819,0.772626932,25987
2cbbe3817a8abaca646397e7d834632add3dd3bc,0,Aravindan Vijayan,2016-08-25 15:19:47-07:00,['5dbb43e7ff9fedf9b35718a1980ec70fbf7b0cd2'],6,12,18,23453708,1,1,1,1,25987
9230e3306680e57d814083a493d11011c8deccf6,0,Andrew Onishuk,2016-08-26 13:56:55+03:00,['2cbbe3817a8abaca646397e7d834632add3dd3bc'],1,4,5,23453713,1,1,1,1,25987
0d166da7838d28aae1a08de497d568d8b0823cb3,1,Sandor Magyari,2016-08-26 17:37:06+02:00,['9230e3306680e57d814083a493d11011c8deccf6'],55,112,167,23453880,11,0,0.425,0,25987
4fb4d677d73739fec927314799a5b02202e745bd,0,oleewere,2016-08-26 20:44:16+02:00,['0d166da7838d28aae1a08de497d568d8b0823cb3'],0,19,19,23453899,1,,,,25987
65f010567dd3dc211575a86754ad5b064041078f,1,Di Li,2016-08-26 14:57:52-04:00,['4fb4d677d73739fec927314799a5b02202e745bd'],6,59,65,23453964,2,0,0.9375,1,25987
799bc4af86bc08102b9114c53522b7373446a231,1,Di Li,2016-08-26 15:05:31-04:00,['65f010567dd3dc211575a86754ad5b064041078f'],30,27,57,23454021,1,1,0.666666667,0.666666667,25987
49e562109c0b15a801a91ff70a9d1cfe7ff86e11,1,Tim Thorpe,2016-08-26 13:34:14-07:00,['799bc4af86bc08102b9114c53522b7373446a231'],53,53,106,23454127,51,,,,25987
b956150659ba25dac9e8f5e388c3c3d84b858521,0,Richard Zang,2016-08-26 13:43:47-07:00,['49e562109c0b15a801a91ff70a9d1cfe7ff86e11'],1,4,5,23454132,1,0,0,1,25987
16e04b2ba3eaeedf6d6633b43c6e001593de9198,1,Zhe (Joe) Wang,2016-08-26 14:58:24-07:00,['b956150659ba25dac9e8f5e388c3c3d84b858521'],0,221,221,23454353,4,0.967741935,0.967741935,1,25987
2ef600f4d7d615d1f87534aa5f26104e1619b86b,1,Nate Cole,2016-08-26 22:41:01-04:00,['16e04b2ba3eaeedf6d6633b43c6e001593de9198'],855,1761,2616,23456969,46,0,0,0.514285714,25988
791b64c980fb2ccbd538110cc10fde18c7bcd6e0,0,Sandor Magyari,2016-08-29 17:35:06+02:00,['2ef600f4d7d615d1f87534aa5f26104e1619b86b'],1,1,2,23456971,1,,,,25988
31836801af975dc48abf219de449bb8572e37f1f,0,Nate Cole,2016-08-29 16:19:12-04:00,['791b64c980fb2ccbd538110cc10fde18c7bcd6e0'],5,0,5,23456976,1,,,,25988
1eba77a933cca38ec93560bdc74fbd0ab752f672,1,Sumit Mohanty,2016-08-29 19:01:37-07:00,['31836801af975dc48abf219de449bb8572e37f1f'],2,2,4,23456980,2,,,,25988
580e920a145cebf0e3899bc8ea4e3fc4b4d367dc,1,Jonathan Hurley,2016-08-29 23:35:47-04:00,['1eba77a933cca38ec93560bdc74fbd0ab752f672'],61,447,508,23457488,8,0,0.979865772,1,25991
04652804d70fef1e2ba515a375887b29d7d3143e,1,Aleksandr Kovalenko,2016-08-30 19:37:11+03:00,['580e920a145cebf0e3899bc8ea4e3fc4b4d367dc'],1,1,2,23457490,1,,,,25991
14639858d71d56ce0cd4d8a1bee23f792d8dbcc0,0,Sumit Mohanty,2016-08-30 16:33:22-07:00,['04652804d70fef1e2ba515a375887b29d7d3143e'],1,1,2,23457492,1,,,,25991
f45e9054d724e53f78cc3dd8768da6587909c8f4,1,Sumit Mohanty,2016-08-30 16:33:27-07:00,['14639858d71d56ce0cd4d8a1bee23f792d8dbcc0'],1,1,2,23457494,1,,,,25991
a6558f869d1a60a09d9729b39795e44f85e0cb09,1,Andrew Onishuk,2016-08-31 14:12:13+03:00,['f45e9054d724e53f78cc3dd8768da6587909c8f4'],0,27,27,23457521,1,,,,25991
9e71d6fb611250f22dbcd7cf0e18a9e2f78f8d90,1,Andrii Tkach,2016-08-31 20:34:11+03:00,['a6558f869d1a60a09d9729b39795e44f85e0cb09'],76,1563,1639,23459160,7,0.954513149,1,1,25992
ac551151f81d7a9c74ad29b0387c77951ae55c6c,0,Jayush Luniya,2016-08-31 13:35:32-07:00,['9e71d6fb611250f22dbcd7cf0e18a9e2f78f8d90'],9,21,30,23459190,4,,,,25992
352a4a83e71c4a0d4da4f894e42a3463d2ce4297,0,Yusaku Sako,2016-08-31 15:44:36-07:00,['ac551151f81d7a9c74ad29b0387c77951ae55c6c'],4,12,16,23459206,1,,,,25992
4f84718b691641a1293f677f3b1abc873f1dc07b,1,Zhe (Joe) Wang,2016-08-31 17:31:29-07:00,['352a4a83e71c4a0d4da4f894e42a3463d2ce4297'],20,122,142,23459348,8,1,0.657894737,1,25992
f4ce46f0bbe1ed78182b3f56a03f69a8c68af432,0,Zhe (Joe) Wang,2016-08-31 17:38:44-07:00,['4f84718b691641a1293f677f3b1abc873f1dc07b'],3,3,6,23459354,2,,,,25992
5c2a40e3e9bcb948e91cc7db2673cb4122da0d15,1,Andrew Onishuk,2016-09-01 12:22:46+03:00,['f4ce46f0bbe1ed78182b3f56a03f69a8c68af432'],4,20,24,23459378,2,1,1,1,25992
dd7424f34e37987f4dedaa7de753c7ead10de53e,1,Andrew Onishuk,2016-09-01 12:37:47+03:00,['5c2a40e3e9bcb948e91cc7db2673cb4122da0d15'],42,63,105,23459483,6,0,1,1,25992
169d8dbbfd7c0f0e21e3f99f3c6e52f622f87aac,1,Aleksandr Kovalenko,2016-09-01 15:38:57+03:00,['dd7424f34e37987f4dedaa7de753c7ead10de53e'],25,46,71,23459554,5,1,1,1,25993
2c40528d9ae1e36b7bab9b5f3dd51338dd8e7366,1,Vitaly Brodetskyi,2016-09-01 18:51:08+03:00,['169d8dbbfd7c0f0e21e3f99f3c6e52f622f87aac'],6,21,27,23459581,2,0,0.818181818,0.818181818,25993
8f7506c5aee1bba768f8f0c4fb929542308cfa63,1,Vitaly Brodetskyi,2016-09-01 19:10:23+03:00,['2c40528d9ae1e36b7bab9b5f3dd51338dd8e7366'],39,188,227,23459808,14,0,0.527777778,0.541666667,25993
1f18805d3022020525c2d4b6ef97b9c0ad818b72,1,Pallav Kulshreshtha,2016-09-02 13:34:40+05:18,['8f7506c5aee1bba768f8f0c4fb929542308cfa63'],115,452,567,23460375,27,0.903061224,0.821428571,1,25993
7c4fefe4ed2585bcace0ffe80ee62cc4f523a0fe,1,Vitaly Brodetskyi,2016-09-02 17:17:06+03:00,['1f18805d3022020525c2d4b6ef97b9c0ad818b72'],38,29,67,23460442,10,,,,25993
6e6ec3e2ebddb975431199fedd4160aa998b22fd,0,Andrew Onishuk,2016-09-02 17:26:32+03:00,['7c4fefe4ed2585bcace0ffe80ee62cc4f523a0fe'],8,16,24,23460466,4,,,,25993
b1c2edbe249387e488d8b14eb4efec2b22c05a66,0,Aleksandr Kovalenko,2016-09-02 18:19:11+03:00,['6e6ec3e2ebddb975431199fedd4160aa998b22fd'],1,0,1,23460467,1,,,,25993
24a50b7a26336c7d91a3623ce77d83e280f026a8,1,Di Li,2016-09-02 15:14:01-04:00,['b1c2edbe249387e488d8b14eb4efec2b22c05a66'],4,48,52,23460519,4,0.553191489,1,1,25993
58b48a17e953db4de7503e2917e17e9810382876,1,Siddharth Wagle,2016-09-02 15:56:51-07:00,['24a50b7a26336c7d91a3623ce77d83e280f026a8'],0,400,400,23460919,5,0.448,0.176,1,25996
a6b96f835db0326cb448f4b215074055ba93bfa5,1,Matt,2016-09-02 17:58:13-07:00,['58b48a17e953db4de7503e2917e17e9810382876'],0,2193,2193,23463112,51,0.517034068,0.885771543,0.95991984,26046
1aa13da878a0ccc6a0f40efae823ab767417462f,1,Vitaly Brodetskyi,2016-09-03 03:59:26+03:00,['a6b96f835db0326cb448f4b215074055ba93bfa5'],6,12,18,23463130,2,0,0,1,26046
32e02482d4e6dc7b66bafc6edecb84f0007f8a82,0,Lisnichenko Dmitro,2016-09-05 17:43:23+03:00,['1aa13da878a0ccc6a0f40efae823ab767417462f'],7,7,14,23463144,2,,,,26046
2a18fe4feaf3ff1c75c77c443f40f2cfc79a0677,1,Vitaly Brodetskyi,2016-09-05 22:21:44+03:00,['32e02482d4e6dc7b66bafc6edecb84f0007f8a82'],10,31,41,23463185,1,1,1,0,26046
151bde11f66882fbe67733edf287c31c7881d9c4,1,Andrii Tkach,2016-09-06 12:37:20+03:00,['2a18fe4feaf3ff1c75c77c443f40f2cfc79a0677'],34,859,893,23464078,5,0.792875989,1,1,26048
a787d7c6e31d3c7568c7971ed6796fa1b3ebdf49,0,Alex Antonenko,2016-09-06 17:53:56+03:00,['151bde11f66882fbe67733edf287c31c7881d9c4'],1,5,6,23464084,1,1,1,1,26048
2d27f547f0d73c4b9c04b80384af2e42b77b3dcb,1,Alex Antonenko,2016-09-06 17:57:23+03:00,['a787d7c6e31d3c7568c7971ed6796fa1b3ebdf49'],1,4,5,23464089,1,1,1,1,26048
1005843fea5c8dffecfde29c43c45031897d24af,1,Nahappan Somasundaram,2016-09-06 10:24:34-07:00,['2d27f547f0d73c4b9c04b80384af2e42b77b3dcb'],1,49,50,23464139,4,0.966666667,0.966666667,1,26048
485d73545c3ff9b058882a000ed5c323225ecf4a,1,Dipayan Bhowmick,2016-09-07 11:29:03+05:18,['1005843fea5c8dffecfde29c43c45031897d24af'],1,6,7,23464146,2,0,0.5,1,26048
8755bf91e2a728132262669b50713388cf08b8db,1,Lisnichenko Dmitro,2016-09-07 14:21:20+03:00,['485d73545c3ff9b058882a000ed5c323225ecf4a'],6,11,17,23464163,2,0,0.8,0.8,26048
3461a5c7c53115e95afc48f5ef963a3c51caaa69,0,Vitaly Brodetskyi,2016-09-07 14:25:22+03:00,['8755bf91e2a728132262669b50713388cf08b8db'],7,13,20,23464183,2,0,1,1,26048
6d13be5b9ab6aa129bc1a71fc2eb57ccf7bbe6cd,0,"Toader, Sebastian",2016-09-07 15:18:25+02:00,['3461a5c7c53115e95afc48f5ef963a3c51caaa69'],7,12,19,23464202,1,0,1,0,26048
56a6ff82304dd0267b4b901fdd53fed7ee4ccc85,1,Alex Antonenko,2016-09-07 16:24:52+03:00,['6d13be5b9ab6aa129bc1a71fc2eb57ccf7bbe6cd'],5,68,73,23464275,5,1,1,1,26049
60d96b15587642b561efc95c6c73277c5e90d534,0,"Toader, Sebastian",2016-09-07 16:45:06+02:00,['56a6ff82304dd0267b4b901fdd53fed7ee4ccc85'],6,6,12,23464287,1,,,,26049
6e60b469c5ff87a328f0849d08c21c0730d0649e,1,Lisnichenko Dmitro,2016-09-07 19:51:12+03:00,['60d96b15587642b561efc95c6c73277c5e90d534'],20,160,180,23464467,12,0.068965517,0.068965517,0.551724138,26051
73aa4d90e56941a4a6f7eb7ffa3127c5b4a82e45,1,Nahappan Somasundaram,2016-09-07 12:45:30-07:00,['6e60b469c5ff87a328f0849d08c21c0730d0649e'],10,40,50,23464517,2,0.107142857,0.964285714,1,26051
4d285cdddf3080718b48bcb35bfcdc41e7c664bf,0,Sumit Mohanty,2016-09-07 13:43:41-07:00,['73aa4d90e56941a4a6f7eb7ffa3127c5b4a82e45'],0,17,17,23464534,1,,,,26051
6180afee4680cba15fbfcd0d0e7d15cdbb3b1852,1,Vitaly Brodetskyi,2016-09-08 01:36:57+03:00,['4d285cdddf3080718b48bcb35bfcdc41e7c664bf'],5,23,28,23464562,3,0,0.076923077,1,26051
c1bfc6dd64acc64c9ddc839b39b0a89d0a871bb1,1,Dmytro Sen,2016-09-08 14:53:52+03:00,['6180afee4680cba15fbfcd0d0e7d15cdbb3b1852'],62,111,173,23464735,29,1,1,0.45,26052
c9a0d332e52d3abf3d8d1996187ae51c00978335,0,Jonathan Hurley,2016-09-08 08:25:15-04:00,['c1bfc6dd64acc64c9ddc839b39b0a89d0a871bb1'],1,37,38,23464773,2,0,0.956521739,1,26052
f188516987f1cbc891a267310cbd2af2f02b3a93,1,Dmytro Sen,2016-09-08 15:28:56+03:00,['c9a0d332e52d3abf3d8d1996187ae51c00978335'],53,199,252,23465025,12,0.690909091,1,0.781818182,26053
4e4f67ae87778ab487c766be9476e7a4445276ff,1,Alex Antonenko,2016-09-08 17:07:36+03:00,['f188516987f1cbc891a267310cbd2af2f02b3a93'],39,350,389,23465414,7,0.537878788,0.825757576,0.916666667,26054
8efbde8fd13be4278017345a4077bebb6f4f366e,0,Jonathan Hurley,2016-09-08 10:16:33-04:00,['4e4f67ae87778ab487c766be9476e7a4445276ff'],74,397,471,23465885,8,0.355140187,0.700934579,0.663551402,26055
f0e022d27d09fdcb5b7e513a42f08b3617bd6a53,1,Siddharth Wagle,2016-09-08 10:20:23-07:00,['8efbde8fd13be4278017345a4077bebb6f4f366e'],1,11,12,23465897,1,,,,26055
26b4299e7105c540fa2ab3dcf34e5abdc76025c6,1,Lisnichenko Dmitro,2016-09-08 20:24:08+03:00,['f0e022d27d09fdcb5b7e513a42f08b3617bd6a53'],75,216,291,23466188,18,0.2,0.705882353,0.776470588,26055
9a35900542fe88e764ecc5daf240d52c50f0b4b3,0,Nahappan Somasundaram,2016-09-08 11:43:40-07:00,['26b4299e7105c540fa2ab3dcf34e5abdc76025c6'],1,7,8,23466196,1,1,1,1,26055
146b2d72f28e1c9743bffba78e2b66ca4f08ccb5,0,Bob Nettleton,2016-09-08 15:46:46-04:00,['9a35900542fe88e764ecc5daf240d52c50f0b4b3'],6,49,55,23466251,2,0,1,1,26055
4abe73766c9e26365268e0cb409860f3745fd89f,1,Aravindan Vijayan,2016-09-08 13:35:16-07:00,['146b2d72f28e1c9743bffba78e2b66ca4f08ccb5'],16,25,41,23466292,2,0,0.882352941,0.882352941,26055
7091fc2d1eb374d8897516cbdd45f918ae997057,1,Swapan Shridhar,2016-09-08 13:47:12-07:00,['4abe73766c9e26365268e0cb409860f3745fd89f'],6,6,12,23466304,1,,,,26055
0090e3ac41034fb1bbd90436c1a286e084c31469,0,Andrew Onishuk,2016-09-09 01:17:01+03:00,['7091fc2d1eb374d8897516cbdd45f918ae997057'],6,3,9,23466313,1,,,,26055
c45b5497e4c63f223e7b5aadf245bf57838f8b7c,0,Andrew Onishuk,2016-09-09 14:10:10+03:00,['0090e3ac41034fb1bbd90436c1a286e084c31469'],0,21,21,23466334,1,0.909090909,1,1,26055
cb45ef92a7292115406c47eab6d5c5949621c368,1,Vitaly Brodetskyi,2016-09-09 14:27:37+03:00,['c45b5497e4c63f223e7b5aadf245bf57838f8b7c'],0,181,181,23466515,3,0.607843137,1,1,26057
2654247fff11c69d25cf01534d67a219922415ff,0,Jonathan Hurley,2016-09-09 08:32:37-04:00,['cb45ef92a7292115406c47eab6d5c5949621c368'],10,52,62,23466577,2,1,1,0.346153846,26057
172197d288cf373f2ce78cdd235c70be8856aa33,1,Sandor Magyari,2016-09-09 15:03:00+02:00,['2654247fff11c69d25cf01534d67a219922415ff'],4,418,422,23466999,3,0.073863636,0.982954545,1,26058
137d08e866b2ae9cbc6d4d936a9798fe063e69fd,0,Sumit Mohanty,2016-09-09 06:57:37-07:00,['172197d288cf373f2ce78cdd235c70be8856aa33'],14,31,45,23467044,3,1,1,0,26058
6b04d3e0efa6672b7f49db57914f6bda7071d49c,1,Di Li,2016-09-09 10:57:06-04:00,['137d08e866b2ae9cbc6d4d936a9798fe063e69fd'],1,45,46,23467090,2,0.75,0,1,26058
3512dbb816361d449455a2c195f309a2b63cd1eb,0,Sumit Mohanty,2016-09-09 11:38:44-07:00,['6b04d3e0efa6672b7f49db57914f6bda7071d49c'],2,2,4,23467094,2,,,,26058
f9abdafaf4b8bc31b6a6d8a8a95490cce5f7c3b3,1,Robert Levas,2016-09-09 14:51:35-04:00,['3512dbb816361d449455a2c195f309a2b63cd1eb'],446,3650,4096,23471190,26,0.016817594,0.855972402,0.867184131,26061
2ce9ab9308d31ed4f4d6df8dc7609d216f8473f2,1,Prajwal Rao,2016-09-09 14:14:15-07:00,['f9abdafaf4b8bc31b6a6d8a8a95490cce5f7c3b3'],0,1127,1127,23472317,1,,,,26062
2547d8f23356ac8aba168597f38c107b040d2bda,0,Jonathan Hurley,2016-09-09 17:20:14-04:00,['2ce9ab9308d31ed4f4d6df8dc7609d216f8473f2'],1,1,2,23472319,1,,,,26062
65530d315c79f1bd8f91c583b0c36ce4c18cc378,0,Jaimin Jetly,2016-09-10 10:29:19-07:00,['2547d8f23356ac8aba168597f38c107b040d2bda'],6,25,31,23472350,2,1,1,1,26062
4b141dd8842fe97d9cf8565af179ea2b68191729,0,Andrew Onishuk,2016-09-12 12:35:07+03:00,['65530d315c79f1bd8f91c583b0c36ce4c18cc378'],2,3,5,23472355,2,,,,26062
e9b4f5298123d98a062f458604a2ae322405a282,1,Andrew Onishuk,2016-09-12 12:49:21+03:00,['4b141dd8842fe97d9cf8565af179ea2b68191729'],0,6,6,23472361,1,,,,26062
1a279102ebf5ec99a772ff3ca2c889df31ce8c60,0,Andrew Onishuk,2016-09-12 12:58:43+03:00,['e9b4f5298123d98a062f458604a2ae322405a282'],45,36,81,23472442,5,1,0,0,26062
2205f9cbb6bec08f95735310c743e17267c3abec,1,Andrew Onishuk,2016-09-12 15:10:22+03:00,['1a279102ebf5ec99a772ff3ca2c889df31ce8c60'],0,13,13,23472455,1,1,1,1,26062
2961c480e05ff179abe96eee4e699662ed820c5c,1,Tim Thorpe,2016-09-12 05:35:48-07:00,['2205f9cbb6bec08f95735310c743e17267c3abec'],208,250,458,23472913,1,1,1,0.75,26062
623c36d2e0832d9a0bc60bc9ff19b302d5e3cefa,0,Di Li,2016-09-12 10:05:31-04:00,['2961c480e05ff179abe96eee4e699662ed820c5c'],2,58,60,23472973,3,0.903225806,0.903225806,0.903225806,26062
e4cb41e0ab469788180f3ac5741d331706b46ea0,0,Jayush Luniya,2016-09-12 09:50:49-07:00,['623c36d2e0832d9a0bc60bc9ff19b302d5e3cefa'],0,7,7,23472980,1,,,,26062
181de178b270fd111f395b951ded7ae670a7d9ce,1,Andrew Onishuk,2016-09-12 21:10:39+03:00,['e4cb41e0ab469788180f3ac5741d331706b46ea0'],3,2,5,23472985,2,,,,26062
b44078cc30ac3c5d4fa86efbcaa9e5d68a37bc04,0,Swapan Shridhar,2016-09-12 11:27:18-07:00,['181de178b270fd111f395b951ded7ae670a7d9ce'],3,3,6,23472991,2,,,,26062
2dd5ba37b74d98c6b0bd3a8fe3ea2725c06faee2,0,Jayush Luniya,2016-09-12 20:33:09-07:00,['b44078cc30ac3c5d4fa86efbcaa9e5d68a37bc04'],6,8,14,23473005,4,,,,26062
d8f3cf88f5c03e844c43af85b5eee69a1956eecb,1,Andrew Onishuk,2016-09-13 10:31:20+03:00,['2dd5ba37b74d98c6b0bd3a8fe3ea2725c06faee2'],38,159,197,23473202,8,0.92,0.92,0.8,26064
e16d916b1318d456b96cde658b5911853bfec32d,1,"Toader, Sebastian",2016-09-13 10:16:44+02:00,['d8f3cf88f5c03e844c43af85b5eee69a1956eecb'],9,12,21,23473223,4,1,1,1,26064
3638a5b42034a0d05f2496b683dd1eec25380eed,0,"Toader, Sebastian",2016-09-13 10:38:40+02:00,['e16d916b1318d456b96cde658b5911853bfec32d'],1,4,5,23473228,1,,,,26064
e82d03c8a66100ec9c2ceb91d4c5a9cc6e427847,0,Pallav Kulshreshtha,2016-09-13 14:02:57+05:18,['3638a5b42034a0d05f2496b683dd1eec25380eed'],2,2,4,23473232,1,,,,26064
d722e38114ae607d0d94d22c96330ae7fd4c1a4d,0,Alex Antonenko,2016-09-13 15:42:12+03:00,['e82d03c8a66100ec9c2ceb91d4c5a9cc6e427847'],0,1,1,23473233,1,,,,26064
2181d73c4a2dadd198597e03215ea5fc14151d13,1,Jonathan Hurley,2016-09-13 09:56:37-04:00,['d722e38114ae607d0d94d22c96330ae7fd4c1a4d'],12,73,85,23473318,2,0,0.964285714,1,26064
3d99106ac3b75508d4b645241ab9d32657adf0ac,0,Alex Antonenko,2016-09-13 17:50:03+03:00,['2181d73c4a2dadd198597e03215ea5fc14151d13'],7,0,7,23473325,1,,,,26064
0d84a7bf39f9127889f216ce4c882534aaaaa5af,1,Alex Antonenko,2016-09-13 20:22:15+03:00,['3d99106ac3b75508d4b645241ab9d32657adf0ac'],8,151,159,23473484,5,0.657142857,1,1,26064
9595706527b924cb273723fd1906c6a4b5d3d686,0,Zhe (Joe) Wang,2016-09-13 13:31:41-07:00,['0d84a7bf39f9127889f216ce4c882534aaaaa5af'],1,8,9,23473493,2,,,,26064
1b4a38dde7a683c7e1b282a14bf2f39afbfafed1,0,Jaimin Jetly,2016-09-13 13:56:49-07:00,['9595706527b924cb273723fd1906c6a4b5d3d686'],1,1,2,23473495,1,,,,26064
a33e2b628f5e6f40377c0c8c8cc348dcfb6d2a6f,0,Alejandro Fernandez,2016-09-13 15:23:23-07:00,['1b4a38dde7a683c7e1b282a14bf2f39afbfafed1'],1,14,15,23473510,1,0,0,1,26064
0855174b815987850d0022ff3c1619c3b2373921,1,Aravindan Vijayan,2016-09-13 15:22:38-07:00,['a33e2b628f5e6f40377c0c8c8cc348dcfb6d2a6f'],136,561,697,23474207,16,0.719298246,0.935672515,0.859649123,26068
1e21842e3ac9e2b6a4552cb0d58294a22d3c2e40,1,Aravindan Vijayan,2016-09-13 16:21:33-07:00,['0855174b815987850d0022ff3c1619c3b2373921'],3,62,65,23474272,2,0,0,1,26068
532b689f3158f8c90b9bc69e1d62d3816f3e81b1,0,Mugdha Varadkar,2016-09-14 10:29:51+05:18,['1e21842e3ac9e2b6a4552cb0d58294a22d3c2e40'],3,2,5,23474277,1,,,,26068
37e71db741cacb5acc4113131a27d2c1b7ac5791,1,Jayush Luniya,2016-09-13 22:26:38-07:00,['532b689f3158f8c90b9bc69e1d62d3816f3e81b1'],0,11337,11337,23485614,98,0.319111111,0.276,0.399555556,26164
580a35139ecd4ee8c47af948d1e4717533eac8f4,0,Lisnichenko Dmitro,2016-09-14 12:46:32+03:00,['37e71db741cacb5acc4113131a27d2c1b7ac5791'],160,0,160,23485774,5,0.861538462,0.6,0,26164
962e06aca097ec02ee52f2284fb804c0c60425ad,1,Lisnichenko Dmitro,2016-09-14 12:53:59+03:00,['580a35139ecd4ee8c47af948d1e4717533eac8f4'],58,2,60,23485834,3,0.096774194,0.096774194,0.096774194,26164
02256c3ff80a40440f06247732fbad70afe8e2eb,1,Lisnichenko Dmitro,2016-09-14 12:54:10+03:00,['962e06aca097ec02ee52f2284fb804c0c60425ad'],14,497,511,23486345,77,0.8125,0.125,1,26164
a54d60918b9df11cd0046d2d96203f60b1ecd546,1,"Toader, Sebastian",2016-09-14 13:52:52+02:00,['02256c3ff80a40440f06247732fbad70afe8e2eb'],1,49,50,23486395,4,0.238095238,0.523809524,0.142857143,26164
5beed88e1a7ab422d619a445f8f8e892844d5fa4,1,Robert Levas,2016-09-14 09:21:18-04:00,['a54d60918b9df11cd0046d2d96203f60b1ecd546'],1,561,562,23486957,4,0.591489362,0.659574468,1,26166
2ad42074f1633c5c6f56cf979bdaa49440457566,1,Andrii Tkach,2016-09-14 16:22:17+03:00,['5beed88e1a7ab422d619a445f8f8e892844d5fa4'],106,1942,2048,23489005,11,0.804130163,1,0.98310388,26169
0e4515c42ba950ee73bd6511b43cc8eec7481348,1,"Toader, Sebastian",2016-09-14 16:17:47+02:00,['2ad42074f1633c5c6f56cf979bdaa49440457566'],89,1412,1501,23490506,26,0.568518519,0.911111111,0.762962963,26181
752e7c46391e1a50f99ab5e3513dfdfc813f6228,0,Jayush Luniya,2016-09-14 10:03:07-07:00,['0e4515c42ba950ee73bd6511b43cc8eec7481348'],26,14,40,23490546,13,,,,26181
08e426ac790957e3fab3edeef128a331fd5860bc,1,Alex Antonenko,2016-09-14 21:40:26+03:00,['752e7c46391e1a50f99ab5e3513dfdfc813f6228'],7,576,583,23491129,12,0.328571429,1,0.964285714,26186
9496772d9f662daefcb78f971a201df0172c2430,0,Richard Zang,2016-09-14 13:50:08-07:00,['08e426ac790957e3fab3edeef128a331fd5860bc'],4,7,11,23491140,2,1,1,1,26186
1b89d6866e369906902f759a7a5d2ba865e8cbe0,0,Nahappan Somasundaram,2016-09-14 14:42:16-07:00,['9496772d9f662daefcb78f971a201df0172c2430'],0,135,135,23491275,2,0.14893617,0.978723404,1,26186
4a099342c1b5a8c1b7dbf77fda3ef0f24bfd26cd,1,Aravindan Vijayan,2016-09-14 15:03:33-07:00,['1b89d6866e369906902f759a7a5d2ba865e8cbe0'],1,2,3,23491278,1,0,0,0,26186
aa0528ecab47850f44dd5575ab7861083e67c6ea,0,Aravindan Vijayan,2016-09-14 15:03:34-07:00,['4a099342c1b5a8c1b7dbf77fda3ef0f24bfd26cd'],6,36,42,23491320,3,0.444444444,1,0.388888889,26186
9455b52dd3126248ccea0d077d5da4512f4e2f21,1,Aravindan Vijayan,2016-09-14 15:03:34-07:00,['aa0528ecab47850f44dd5575ab7861083e67c6ea'],8,46,54,23491374,6,0.090909091,0.090909091,1,26186
0e3435856a2aee7951f765e90e55e027b6455c1a,1,Aravindan Vijayan,2016-09-14 15:03:34-07:00,['9455b52dd3126248ccea0d077d5da4512f4e2f21'],9,171,180,23491554,4,0.111111111,0.824074074,1,26186
f5ad1de8689fc45980e5439d873a9331ea6f4723,1,Aravindan Vijayan,2016-09-14 15:03:34-07:00,['0e3435856a2aee7951f765e90e55e027b6455c1a'],79,340,419,23491973,16,0.055944056,0.51048951,0.944055944,26187
565685d326e5a877f8e4479736e75f59f728c9ec,1,Swapan Shridhar,2016-09-14 15:37:51-07:00,['f5ad1de8689fc45980e5439d873a9331ea6f4723'],1,24,25,23491998,2,0,0.7,0.3,26187
1123ba265592958f188eaf9b1eac843bcb4d3f1c,1,Vitaly Brodetskyi,2016-09-15 14:40:43+03:00,['565685d326e5a877f8e4479736e75f59f728c9ec'],326,419,745,23492743,5,0.578947368,0.543859649,1,26187
561dc8ee0f524744b92c19e860e923ed890c1a36,1,Richard Zang,2016-09-15 04:52:05-07:00,['1123ba265592958f188eaf9b1eac843bcb4d3f1c'],1,39,40,23492783,2,0.581395349,1,1,26187
cc684be15b1fa5404ed86918f8b13d8ae2b0f1ae,1,Sandor Magyari,2016-09-15 14:18:38+02:00,['561dc8ee0f524744b92c19e860e923ed890c1a36'],1,55,56,23492839,4,0,0,1,26188
41a9190fc011dcfd9bc4b99dcba90ad0397b9f94,0,Aleksandr Kovalenko,2016-09-15 15:22:16+03:00,['cc684be15b1fa5404ed86918f8b13d8ae2b0f1ae'],0,7,7,23492846,1,,,,26188
3c06ca3b654e0abd6fd4265fb16693e1d1f7f97f,0,Andrii Tkach,2016-09-15 17:28:59+03:00,['41a9190fc011dcfd9bc4b99dcba90ad0397b9f94'],3,5,8,23492854,2,,,,26188
513965f5850e4d3d900eb63d6b429d841498d529,0,Tim Thorpe,2016-09-15 09:19:40-07:00,['3c06ca3b654e0abd6fd4265fb16693e1d1f7f97f'],1,24,25,23492879,1,,,,26188
bead01cfe1a10be6a8dae0c9e681d4254b35db4e,0,Aravindan Vijayan,2016-09-15 09:25:50-07:00,['513965f5850e4d3d900eb63d6b429d841498d529'],38,38,76,23492955,1,,,,26188
edf1b9b9f2182de2e14a194c5ca243f6cf39170d,0,Jonathan Hurley,2016-09-15 12:37:27-04:00,['bead01cfe1a10be6a8dae0c9e681d4254b35db4e'],12,34,46,23493001,2,0,1,1,26188
d5cca62c85f97118ed9e2a3e14729d9e6cb6023d,1,Robert Levas,2016-09-15 13:19:40-04:00,['edf1b9b9f2182de2e14a194c5ca243f6cf39170d'],263,1212,1475,23494476,15,0.550561798,0.904494382,0.693820225,26194
1efc99c5adc536044425b9df45b72421c5a8323c,1,Alejandro Fernandez,2016-09-15 14:46:37-07:00,['d5cca62c85f97118ed9e2a3e14729d9e6cb6023d'],5,52,57,23494533,2,0,0.28125,0,26194
da5605706555d3aecca7a67fb399d9c501972ad4,1,Jonathan Hurley,2016-09-15 23:57:36-04:00,['1efc99c5adc536044425b9df45b72421c5a8323c'],21,82,103,23494636,5,0.777777778,1,1,26194
bdd261ef10eef1a5daa9d89f7b509bf6e23c370c,1,Mugdha Varadkar,2016-09-16 10:21:32+05:18,['da5605706555d3aecca7a67fb399d9c501972ad4'],2,16,18,23494654,3,,,,26194
9f9e89afb2fd927500718321dc658fb7e0292bad,1,Andrew Onishuk,2016-09-16 11:35:39+03:00,['bdd261ef10eef1a5daa9d89f7b509bf6e23c370c'],0,111,111,23494765,10,,,,26194
51cbf0df6b6ba6922b236c3a0a4cfa39e3d919e5,0,Andrii Tkach,2016-09-16 12:38:27+03:00,['9f9e89afb2fd927500718321dc658fb7e0292bad'],15,44,59,23494824,8,1,1,1,26194
9dbcac6d5c30cd30d90e5643d87c0010d91317be,1,Andrew Onishuk,2016-09-16 13:54:08+03:00,['51cbf0df6b6ba6922b236c3a0a4cfa39e3d919e5'],1863,192,2055,23496879,5,0.364864865,0.756756757,0.824324324,26194
9dbf079d957b2b449030a1efa95b77614a3f1ea2,0,Nate Cole,2016-09-16 11:04:09-04:00,['9dbcac6d5c30cd30d90e5643d87c0010d91317be'],2,2,4,23496883,1,,,,26194
a4185754b6720a313c7f9c5df8b6311d9e60fc84,0,Lisnichenko Dmitro,2016-09-16 19:10:45+03:00,['9dbf079d957b2b449030a1efa95b77614a3f1ea2'],7,13,20,23496903,3,0,0,0.4,26194
e2085dd6fdeb7add7eacbccc293fe4df7a617fe7,1,Nate Cole,2016-09-16 14:17:44-04:00,['9dbcac6d5c30cd30d90e5643d87c0010d91317be'],45,164,209,23497112,6,0,0.794520548,0.794520548,26194
54a6525f8c49759fe9a013b35ce476693d1e855f,1,Aravindan Vijayan,2016-09-16 13:23:21-07:00,['a4185754b6720a313c7f9c5df8b6311d9e60fc84'],2,11,13,23497125,2,1,1,1,26194
76ee1b114e233288ebb849820e707a6afefcd3cc,1,Nahappan Somasundaram,2016-09-16 14:36:24-07:00,['54a6525f8c49759fe9a013b35ce476693d1e855f'],6,12,18,23497143,1,0,0,1,26194
1fdda4913adb2318ddfc1406d39fe8d80837a37e,1,Dipayan Bhowmick,2016-09-19 11:11:12+05:18,['76ee1b114e233288ebb849820e707a6afefcd3cc'],9,14,23,23497166,1,1,1,1,26194
fd02688f27afa6e4607f3694dee5e5643e8e2b72,0,Sandor Magyari,2016-09-19 11:54:34+02:00,['1fdda4913adb2318ddfc1406d39fe8d80837a37e'],3,54,57,23497223,2,0.384615385,1,1,26194
8ce129becf35f7e64e3f2009028765a243f4a3fc,1,Andrew Onishuk,2016-09-19 13:27:37+03:00,['fd02688f27afa6e4607f3694dee5e5643e8e2b72'],2,128,130,23497353,3,,,,26195
335ef6e9a2c140f79e3ccc11dec703ef9e0afe50,1,"Toader, Sebastian",2016-09-19 15:02:13+02:00,['8ce129becf35f7e64e3f2009028765a243f4a3fc'],0,23,23,23497376,3,0.866666667,0.866666667,1,26196
64fc477df3305a5c09f6114c9b31b06dde600dc4,0,Andrew Onishuk,2016-09-19 16:50:20+03:00,['335ef6e9a2c140f79e3ccc11dec703ef9e0afe50'],4,10,14,23497390,3,,,,26196
d1ac8bd89403047a145b185b78c2073f09264472,0,Andrew Onishuk,2016-09-19 16:54:45+03:00,['64fc477df3305a5c09f6114c9b31b06dde600dc4'],6,14,20,23497410,3,0,0.714285714,0.714285714,26196
79e678653eff30ca07cc5c76ee6901d763a7566d,0,Nate Cole,2016-09-19 11:31:36-04:00,"['e2085dd6fdeb7add7eacbccc293fe4df7a617fe7', 'd1ac8bd89403047a145b185b78c2073f09264472']",41,281,322,23497732,21,,,,26196
0c6c141993740065892a608fc0a7cd5c197d3d85,1,Andrew Onishuk,2016-09-19 18:59:54+03:00,['d1ac8bd89403047a145b185b78c2073f09264472'],2,4,6,23497738,2,1,1,1,26196
536bf049a52a3433a2a990286d9e5c3d387c3224,1,Andrew Onishuk,2016-09-19 19:14:25+03:00,['0c6c141993740065892a608fc0a7cd5c197d3d85'],18,251,269,23498007,7,0.695652174,0.87826087,0.591304348,26197
468764ea289092f95d013a84496605a3a8fc10dc,1,Andrew Onishuk,2016-09-19 19:40:19+03:00,['536bf049a52a3433a2a990286d9e5c3d387c3224'],25,27,52,23498059,2,,,,26197
b4f3809e4c32e9c9aa8a6700608413fc89a23c63,1,Alex Antonenko,2016-09-19 21:26:08+03:00,['468764ea289092f95d013a84496605a3a8fc10dc'],2,18,20,23498079,2,0,1,1,26197
5d31b70cf76789e2744ada68a547f71d87addbb8,1,Alex Antonenko,2016-09-19 21:32:18+03:00,['b4f3809e4c32e9c9aa8a6700608413fc89a23c63'],2,85,87,23498166,6,0.101449275,1,0.985507246,26197
e54c31e8900773dc46a80b2f18e111798709d536,1,Zhe (Joe) Wang,2016-09-19 14:41:54-07:00,['5d31b70cf76789e2744ada68a547f71d87addbb8'],1,37,38,23498204,2,0,0,1,26197
f90b55a8bde1baa6cf2321d63596f3b8329292d9,0,Andrew Onishuk,2016-09-20 10:49:13+03:00,['e54c31e8900773dc46a80b2f18e111798709d536'],1,1,2,23498206,1,,,,26197
a9bbf4644890690c45e9879f7bda9ff9d0ec7000,1,ababiichuk,2016-09-20 11:19:32+03:00,['f90b55a8bde1baa6cf2321d63596f3b8329292d9'],53,66,119,23498325,3,0,0,0,26197
8425f1fa714718e32a05e8fcd005047c6de46451,1,Vitaly Brodetskyi,2016-09-20 17:44:21+03:00,['a9bbf4644890690c45e9879f7bda9ff9d0ec7000'],355,557,912,23499237,11,0.425925926,0.092592593,1,26197
b4320b5a8d29b812e9fe86da69a219a17d5e4ea7,0,Robert Levas,2016-09-20 14:45:23-04:00,['8425f1fa714718e32a05e8fcd005047c6de46451'],52,832,884,23500121,18,0.234693878,0.755102041,0.707482993,26203
382eba15e351df86da96e8d63cbdaf2fe8f4d867,1,Aravindan Vijayan,2016-09-20 13:56:57-07:00,['b4320b5a8d29b812e9fe86da69a219a17d5e4ea7'],25,81,106,23500227,1,0,0.423076923,0.538461538,26203
3b30de0a8ad939768e9194fb63ef19f07eaabaee,0,ljainpivotalio,2016-09-20 14:34:14-07:00,['382eba15e351df86da96e8d63cbdaf2fe8f4d867'],5,5,10,23500237,1,,,,26203
875f1efb63cbbe81259a79c0b1530eba7ef2a3ec,1,Aravindan Vijayan,2016-09-20 15:54:32-07:00,['3b30de0a8ad939768e9194fb63ef19f07eaabaee'],114,266,380,23500617,6,0.586206897,0.586206897,0,26204
e2e8c138649fca25a6c164c51bc439ef19219f43,0,Richard Zang,2016-09-20 17:21:04-07:00,['875f1efb63cbbe81259a79c0b1530eba7ef2a3ec'],26,49,75,23500692,2,0.36,1,0.64,26204
159546ad988f5ff3eab26256bcb36cc660d8a839,0,"Toader, Sebastian",2016-09-21 10:09:50+02:00,['e2e8c138649fca25a6c164c51bc439ef19219f43'],6,6,12,23500704,1,,,,26204
20997630d5be2a0d684a779b0daecb33ec54a4d6,0,"Toader, Sebastian",2016-09-21 11:26:49+02:00,['159546ad988f5ff3eab26256bcb36cc660d8a839'],1,2,3,23500707,1,,,,26204
04b4dc2a5d57f9b092ae336c2ba089c259b8a56e,1,Aleksandr Kovalenko,2016-09-21 13:33:23+03:00,['20997630d5be2a0d684a779b0daecb33ec54a4d6'],110,60,170,23500877,7,0,0,0,26204
0f774139ec6d4dd85075e0227b59c6ded75d262e,0,Gaurav Nagar,2016-09-21 16:29:45+05:18,['04b4dc2a5d57f9b092ae336c2ba089c259b8a56e'],0,5,5,23500882,1,1,1,1,26204
6038e0120989111fff2f8703216abffb96c93136,0,Gaurav Nagar,2016-09-21 18:04:22+05:18,['0f774139ec6d4dd85075e0227b59c6ded75d262e'],1,1,2,23500884,1,,,,26204
c8edd3c8aa061d7be3a11c76dd79e9e65801a72b,0,Nate Cole,2016-09-21 09:29:10-04:00,"['79e678653eff30ca07cc5c76ee6901d763a7566d', '6038e0120989111fff2f8703216abffb96c93136']",799,2353,3152,23504036,73,,,,26204
dcf779d28e511b07821e6f54702b918a87b22d02,0,Robert Levas,2016-09-21 10:42:54-04:00,['6038e0120989111fff2f8703216abffb96c93136'],832,52,884,23504920,18,0.765306122,0.244897959,0.292517007,26204
7e08470cfef5b9dd29724c318dd996d789e0414e,1,Robert Levas,2016-09-21 10:48:59-04:00,['dcf779d28e511b07821e6f54702b918a87b22d02'],52,837,889,23505809,18,0.233108108,0.756756757,0.709459459,26210
c0cee00e32a5c05431b5ba072859a540ef42dcc4,0,Nate Cole,2016-09-21 11:51:02-04:00,['c8edd3c8aa061d7be3a11c76dd79e9e65801a72b'],7,23,30,23505839,4,0,0,0.230769231,26210
3939afaf6e30d95186e5cce92712b4485c2013bf,0,Robert Levas,2016-09-21 13:07:44-04:00,['7e08470cfef5b9dd29724c318dd996d789e0414e'],5,9,14,23505853,1,1,1,1,26210
89eebb0f553e8667e0eb82c7f96d862b5a37faf8,0,Jaimin Jetly,2016-09-21 16:00:14-07:00,['3939afaf6e30d95186e5cce92712b4485c2013bf'],1,1,2,23505855,1,,,,26210
479ec12db0a84942489349b8fb99c68988954ee6,1,Swapan Shridhar,2016-09-21 17:19:20-07:00,['89eebb0f553e8667e0eb82c7f96d862b5a37faf8'],0,15,15,23505870,3,0,0,0,26210
07a3a3cff17d5df91e77fde0f6f5e0a9cac8aec5,0,Nahappan Somasundaram,2016-09-21 17:38:26-07:00,['479ec12db0a84942489349b8fb99c68988954ee6'],0,27,27,23505897,2,0.333333333,1,1,26210
169cb78912faaccd8807f44e87c05c79cc6844f8,1,Andrew Onishuk,2016-09-22 11:23:11+03:00,['07a3a3cff17d5df91e77fde0f6f5e0a9cac8aec5'],8,4,12,23505909,2,0,0,0,26210
f6769feb248608c0f9b3d8dee62c1943710ac4c7,0,Andrew Onishuk,2016-09-22 13:56:14+03:00,['169cb78912faaccd8807f44e87c05c79cc6844f8'],2,2,4,23505913,1,,,,26210
9b6bc2158d9dafcc836d5c301edc73602cc0edc0,1,Andrew Onishuk,2016-09-22 15:38:46+03:00,['f6769feb248608c0f9b3d8dee62c1943710ac4c7'],1,60,61,23505974,2,0,1,0,26210
2c7bd2f4984e4c08f8154c5a0bf4d2e6fac57c10,0,Andrew Onishuk,2016-09-22 16:57:35+03:00,['9b6bc2158d9dafcc836d5c301edc73602cc0edc0'],8,16,24,23505998,3,0.375,0.875,0.875,26210
533015b4f26fa24db392271ec07d16825a03030c,0,Andrew Onishuk,2016-09-22 17:40:45+03:00,['2c7bd2f4984e4c08f8154c5a0bf4d2e6fac57c10'],0,1,1,23505999,1,,,,26210
39ed8e4f621a8dcdc55dde8584029aa7a4636527,0,Andrew Onishuk,2016-09-22 17:43:09+03:00,['533015b4f26fa24db392271ec07d16825a03030c'],54,0,54,23506053,8,1,0,0.225806452,26210
ac0c66e986e14db6a746dfe1b84f36a662dacfbb,1,Robert Levas,2016-09-22 12:36:52-04:00,['39ed8e4f621a8dcdc55dde8584029aa7a4636527'],87,340,427,23506480,14,0.394557823,0.476190476,0.87755102,26210
33a573cdb54229cee37e1f49837be783de3cba7b,1,Robert Levas,2016-09-22 14:48:29-04:00,['ac0c66e986e14db6a746dfe1b84f36a662dacfbb'],2,6,8,23506488,1,0,0,0,26210
ed28ff483f8afb994932a62ea177f06b31fae36f,1,Alejandro Fernandez,2016-09-22 15:54:38-07:00,['33a573cdb54229cee37e1f49837be783de3cba7b'],80,141,221,23506709,45,0.875,0.875,1,26210
7cc1ac811823da7eb13869fda4ced3bb85a58787,1,Vitaly Brodetskyi,2016-09-23 08:54:25+03:00,['ed28ff483f8afb994932a62ea177f06b31fae36f'],14,36,50,23506759,2,0,1,1,26210
0bbdb4f3a17526202be41b546db22c8bbbf85968,0,Nate Cole,2016-09-23 09:17:50-04:00,"['c0cee00e32a5c05431b5ba072859a540ef42dcc4', 'ed28ff483f8afb994932a62ea177f06b31fae36f']",243,622,865,23507624,83,,,,26210
1fee5ed34c6c41c40b550b5961e8b37aef0599d1,0,Jayush Luniya,2016-09-23 19:56:53-07:00,['7cc1ac811823da7eb13869fda4ced3bb85a58787'],7,4,11,23507635,2,1,1,1,26210
d237c9ad36815756685b1384a43bbb90e3aa2117,1,Andrew Onishuk,2016-09-26 13:22:44+03:00,['1fee5ed34c6c41c40b550b5961e8b37aef0599d1'],41,87,128,23507763,5,0.736842105,0.736842105,1,26210
a5fa754e1fbf79716a864f795d3eb9806c84f862,1,Andrew Onishuk,2016-09-26 13:35:51+03:00,['d237c9ad36815756685b1384a43bbb90e3aa2117'],166,270,436,23508199,6,0.476923077,1,0.538461538,26210
18ad001b374f627139e4e7b4e46c056a1c94c2fc,1,Lisnichenko Dmitro,2016-09-26 14:07:31+03:00,['a5fa754e1fbf79716a864f795d3eb9806c84f862'],5,365,370,23508569,6,0.481203008,0.909774436,0.240601504,26213
7d37453ec413361a2b9ab362f6d771d79384bf62,0,"Toader, Sebastian",2016-09-26 13:28:55+02:00,['18ad001b374f627139e4e7b4e46c056a1c94c2fc'],47,4,51,23508620,3,,,,26213
5a29d4866e938015cd9d09763a37cc8f97a17f7d,0,Sandor Magyari,2016-09-26 14:06:45+02:00,['7d37453ec413361a2b9ab362f6d771d79384bf62'],31,10,41,23508661,2,,,,26213
75b656c73668edfaeaefd35a49bdd2a2a1337212,0,Nate Cole,2016-09-26 09:05:10-04:00,"['0bbdb4f3a17526202be41b546db22c8bbbf85968', '5a29d4866e938015cd9d09763a37cc8f97a17f7d']",311,776,1087,23509748,26,,,,26213
8192601dfa606e72084813969b7de5af39bd083d,0,Andrew Onishuk,2016-09-26 18:18:34+03:00,['5a29d4866e938015cd9d09763a37cc8f97a17f7d'],2,11,13,23509761,1,0,0,0,26213
ee4e63a9a75131119f3e157eeb1f8f1462a1798f,0,Andrew Onishuk,2016-09-26 19:09:52+03:00,['8192601dfa606e72084813969b7de5af39bd083d'],0,158,158,23509919,3,0.470588235,0.470588235,0.882352941,26215
69e8f6fa89b5b2a4e6246e0e32b23c314a12df5c,1,Zhe (Joe) Wang,2016-09-26 13:12:09-07:00,['ee4e63a9a75131119f3e157eeb1f8f1462a1798f'],7,61,68,23509987,6,0.076923077,0.076923077,1,26215
7c8ada187d9f80ecc93a901b403c4e13821888b5,1,Prajwal Rao,2016-09-26 13:54:08-07:00,['69e8f6fa89b5b2a4e6246e0e32b23c314a12df5c'],0,580,580,23510567,3,0.529411765,0.764705882,1,26217
5af6d547fa9c5d225e011e18297b2cef703237a9,0,Prajwal Rao,2016-09-26 14:12:46-07:00,['7c8ada187d9f80ecc93a901b403c4e13821888b5'],10,10,20,23510587,2,,,,26217
6d3522825b962e926fe5e244b706a619c74b0116,1,"Toader, Sebastian",2016-09-27 11:20:06+02:00,['5af6d547fa9c5d225e011e18297b2cef703237a9'],14,14,28,23510615,3,,,,26217
87423d64f54d896c62d1a9245eb03a97763e35a4,1,Tim Thorpe,2016-09-27 06:05:31-07:00,['6d3522825b962e926fe5e244b706a619c74b0116'],94,636,730,23511345,13,0.375,0.733333333,0.883333333,26219
53b4bd41518a5292d3c6c9cdafecee3898d046f3,0,Di Li,2016-09-27 10:58:59-04:00,['87423d64f54d896c62d1a9245eb03a97763e35a4'],4,37,41,23511386,2,0,0.038461538,0.961538462,26219
7b92434290f1e092e228bcc74584d4a4630ac392,0,Tim Thorpe,2016-09-27 08:21:56-07:00,['53b4bd41518a5292d3c6c9cdafecee3898d046f3'],0,17,17,23511403,1,,,,26219
c265ae6228342146dc99e9b5681d8a2645a220fa,0,Alex Antonenko,2016-09-27 21:52:49+03:00,['7b92434290f1e092e228bcc74584d4a4630ac392'],2,6,8,23511411,2,0.75,0.75,0.75,26219
561c6f2f38f9b262dda4acd7ff0526b7caf55bce,1,Jonathan Hurley,2016-09-27 15:34:40-04:00,['8192601dfa606e72084813969b7de5af39bd083d'],792,522,1314,23512725,13,1,0.019607843,0.047058824,26219
6fb1ceef66b8d63c66603eebf1cd9e6d91c815aa,1,Andrew Onishuk,2016-09-28 08:44:44+03:00,['c265ae6228342146dc99e9b5681d8a2645a220fa'],417,421,838,23513563,6,0,1,1,26219
20ce57b7bb578dd337007d4411c695c95d6bf287,1,Tim Thorpe,2016-09-28 09:28:06-07:00,['aad2133f857e6067f37a01cce8870f27a72d933b'],2,21,23,23513586,1,,,,26219
05e65e297a09e1498a8ee75fd55d059c00f99976,0,Vitaly Brodetskyi,2016-09-28 09:26:32+03:00,['20ce57b7bb578dd337007d4411c695c95d6bf287'],80,79,159,23513745,2,0,0,1,26219
a0fff8472a3e60972a0ae57d30c09e867d86ad0f,0,Aleksandr Kovalenko,2016-09-28 13:25:02+03:00,['6fb1ceef66b8d63c66603eebf1cd9e6d91c815aa'],1,1,2,23513747,1,,,,26219
84ecbb404280b541f15e2b23068ecd449bdd930c,1,Alejandro Fernandez,2016-09-28 10:55:19-07:00,['05e65e297a09e1498a8ee75fd55d059c00f99976'],9,11,20,23513767,2,1,1,0,26219
26425953175f1167a7040b5c37985eee8724bb28,0,Tim Thorpe,2016-09-28 11:33:21-07:00,['84ecbb404280b541f15e2b23068ecd449bdd930c'],1,3,4,23513771,1,,,,26219
98f0cfc3d9397c6c834291611a0655fc691b0ac2,1,Andrew Onishuk,2016-09-28 21:39:27+03:00,['26425953175f1167a7040b5c37985eee8724bb28'],8,8,16,23513787,2,,,,26219
06282e02bbf54df8cd5163a83a11637765be2ff1,0,Alejandro Fernandez,2016-09-28 13:10:52-07:00,['98f0cfc3d9397c6c834291611a0655fc691b0ac2'],1,1,2,23513789,1,,,,26219
392a752d27ce3d0dd7e044ce8c4ab5e9d10f6e74,1,Vitaly Brodetskyi,2016-09-28 14:03:08+03:00,['06282e02bbf54df8cd5163a83a11637765be2ff1'],1033,456,1489,23515278,11,0.250544662,0.328976035,0,26219
2700bd125f2f9bbae2ebfcc0831ec881097b4cff,0,"Toader, Sebastian",2016-09-28 13:42:59+02:00,['a0fff8472a3e60972a0ae57d30c09e867d86ad0f'],11,26,37,23515315,2,0.416666667,1,1,26219
39858ccafcee6c49bba21d7385d7129d71dc8851,0,"Toader, Sebastian",2016-09-28 13:58:32+02:00,['2700bd125f2f9bbae2ebfcc0831ec881097b4cff'],15,12,27,23515342,2,1,1,0.666666667,26219
e44b880514109011fadb9c274b3b8163f13390d8,1,Oleg Nechiporenko,2016-09-28 15:29:33+03:00,['39858ccafcee6c49bba21d7385d7129d71dc8851'],56,506,562,23515904,14,0.366242038,0.97133758,0.920382166,26220
aad2133f857e6067f37a01cce8870f27a72d933b,1,ababiichuk,2016-09-28 15:30:43+03:00,['e44b880514109011fadb9c274b3b8163f13390d8'],29,29,58,23515962,3,0,,,26220
f0da4fa49ec8ce420ce4f495855af9b3e3b8d975,0,Jonathan Hurley,2016-09-28 10:17:25-04:00,"['561c6f2f38f9b262dda4acd7ff0526b7caf55bce', 'aad2133f857e6067f37a01cce8870f27a72d933b']",660,2514,3174,23519136,59,,,,26220
2d60c52674f33e0ecd1a11e9b4a24e16978c8c14,0,Nate Cole,2016-09-28 13:27:48-04:00,"['75b656c73668edfaeaefd35a49bdd2a2a1337212', '05e65e297a09e1498a8ee75fd55d059c00f99976']",742,2623,3365,23522501,62,,,,26220
75a91e35a4435e2ce85076dff4e35f580425a666,1,Nate Cole,2016-09-28 13:28:48-04:00,['2d60c52674f33e0ecd1a11e9b4a24e16978c8c14'],76,193,269,23522770,7,0.211538462,0.807692308,0.807692308,26221
7ab438079f0e1a12fab52bc8abbdc73040473195,1,Sumit Mohanty,2016-09-28 22:55:50-07:00,['392a752d27ce3d0dd7e044ce8c4ab5e9d10f6e74'],34,219,253,23523023,4,0,0,0.108843537,26221
e1b1157748417c0fb23ef3b0cb1eddda601b9568,0,Andrew Onishuk,2016-09-29 10:24:16+03:00,['7ab438079f0e1a12fab52bc8abbdc73040473195'],0,5,5,23523028,1,,,,26221
481a542979ac523ee1a6c46a36a6213583cb0951,1,Dmytro Sen,2016-09-29 12:38:45+03:00,['e1b1157748417c0fb23ef3b0cb1eddda601b9568'],0,813,813,23523841,27,,,,26248
563124baeef663967ed214fb88f4f6006c5b2623,1,Andrew Onishuk,2016-09-29 12:55:25+03:00,['481a542979ac523ee1a6c46a36a6213583cb0951'],1,1,2,23523843,1,,,,26248
f503655e1fb94607c30f5bfe5b3c9a8636757424,0,Dmytro Sen,2016-09-29 17:25:26+03:00,['563124baeef663967ed214fb88f4f6006c5b2623'],1,16,17,23523860,1,,,,26248
71c4c17a110aa21b6e83f300ba8aa6af31116dc1,0,Nate Cole,2016-09-29 10:28:52-04:00,"['75a91e35a4435e2ce85076dff4e35f580425a666', 'f503655e1fb94607c30f5bfe5b3c9a8636757424']",1088,1533,2621,23526481,51,,,,26248
5fa2d9b22b0ae23b1c8b22a54c51fac76633045e,0,Robert Levas,2016-09-29 11:09:52-04:00,['f503655e1fb94607c30f5bfe5b3c9a8636757424'],117,112,229,23526710,1,0,,,26248
817aed4bdd800801cc9c21cc265ce577f4b16476,0,Jonathan Hurley,2016-09-29 13:21:14-04:00,"['f0da4fa49ec8ce420ce4f495855af9b3e3b8d975', '5fa2d9b22b0ae23b1c8b22a54c51fac76633045e']",1287,1745,3032,23529742,55,,,,26248
84c172cb84da6b3ad3c855bfdb94fc6ff528f191,0,Alex Antonenko,2016-09-29 22:38:47+03:00,['5fa2d9b22b0ae23b1c8b22a54c51fac76633045e'],1,1,2,23529744,1,,,,26248
b8e3c10abf1c49506481b35c2ecf2ed081289ecf,0,Prajwal Rao,2016-09-29 12:43:20-07:00,['84c172cb84da6b3ad3c855bfdb94fc6ff528f191'],9,9,18,23529762,1,,,,26248
d8cd374baa7afca9cdb9e682a28ac1563870baa6,1,Jaimin Jetly,2016-09-29 13:02:39-07:00,['b8e3c10abf1c49506481b35c2ecf2ed081289ecf'],231,311,542,23530304,2,1,0.970149254,1,26248
4170ff49f72eae596fe1e9f0a4afd03649b98e16,1,Prajwal Rao,2016-09-29 14:23:34-07:00,['d8cd374baa7afca9cdb9e682a28ac1563870baa6'],0,13301,13301,23543605,3,,,,26251
908f6e861ee242766a7bc1b3c09a3e9a0faeee87,0,Aravindan Vijayan,2016-09-29 14:47:12-07:00,['4170ff49f72eae596fe1e9f0a4afd03649b98e16'],1,1,2,23543607,1,,,,26251
32ab17b33bd9c75fada71f1e85871e55f287937e,0,Aravindan Vijayan,2016-09-29 14:47:26-07:00,['908f6e861ee242766a7bc1b3c09a3e9a0faeee87'],1,1,2,23543609,1,,,,26251
013b7bd08117abc082400279f7b24d33a9819e34,0,ababiichuk,2016-09-30 10:33:49+03:00,['32ab17b33bd9c75fada71f1e85871e55f287937e'],1,1,2,23543611,1,,,,26251
120505f9a2b4da35604564f0ab066ad67fecd86a,1,ababiichuk,2016-09-30 10:33:49+03:00,['013b7bd08117abc082400279f7b24d33a9819e34'],3,3,6,23543617,2,,,,26251
113d51e15ab0cbd6d342023a0a0d470e51dc1a62,1,Dmytro Sen,2016-09-30 12:47:19+03:00,['120505f9a2b4da35604564f0ab066ad67fecd86a'],174,257,431,23544048,38,0.733333333,1,1,26251
324107d1b5783ac971a14a8f1fe920a98aaff298,0,Dmytro Sen,2016-09-30 15:42:52+03:00,['113d51e15ab0cbd6d342023a0a0d470e51dc1a62'],1,59,60,23544108,2,1,1,1,26252
806723e0efdf8e2e677c18e0989e53e446a1669f,0,Nate Cole,2016-09-30 12:00:44-04:00,"['71c4c17a110aa21b6e83f300ba8aa6af31116dc1', '324107d1b5783ac971a14a8f1fe920a98aaff298']",537,14054,14591,23558699,51,,,,26252
dfa16136d0ceaba1e2fdb67fbc4d9dc3e3ec49f5,1,Andrew Onishuk,2016-10-03 12:28:46+03:00,['324107d1b5783ac971a14a8f1fe920a98aaff298'],8,43,51,23558750,4,0.259259259,0,0.777777778,26252
d6d5df5c47f28916fbeec1d019f07d615a4e8d4d,0,Andrew Onishuk,2016-10-03 12:39:28+03:00,['dfa16136d0ceaba1e2fdb67fbc4d9dc3e3ec49f5'],1,1,2,23558752,1,,,,26252
30eadbf07fe601931e9029c4a7007218b62194ad,0,Alex Antonenko,2016-10-03 15:22:57+03:00,['d6d5df5c47f28916fbeec1d019f07d615a4e8d4d'],2,2,4,23558756,1,,,,26252
7ac93f3a8aeeedb71d0feecc1f4ff99972f717f7,1,Swapan Shridhar,2016-10-03 12:39:50-07:00,['f2bcbbe70008303afdefd7c218b4954127ebe978'],1,33,34,23558790,2,1,0,0,26252
ee02ad9c984b5a15eea13a175e212c0e1f6ff1c2,0,Alejandro Fernandez,2016-10-03 13:30:19-07:00,['7ac93f3a8aeeedb71d0feecc1f4ff99972f717f7'],3,424,427,23559217,34,,,,26261
98ba7e075458404f63e2ca16c73068a6df32a800,1,Vitaly Brodetskyi,2016-10-03 15:26:52+03:00,['ee02ad9c984b5a15eea13a175e212c0e1f6ff1c2'],9,57,66,23559283,3,0,0,0,26261
7b15e388c37cd2cabf224568760ab127d07412ca,0,Di Li,2016-10-03 11:44:52-04:00,['30eadbf07fe601931e9029c4a7007218b62194ad'],3,3,6,23559289,1,,,,26261
d53c9e2ee99c046ae5b37b531419549397f4aea1,1,Jonathan Hurley,2016-10-03 13:03:59-04:00,['817aed4bdd800801cc9c21cc265ce577f4b16476'],1476,1058,2534,23561823,30,1,0.428921569,0.044117647,26261
f2bcbbe70008303afdefd7c218b4954127ebe978,0,Alex Antonenko,2016-10-03 20:20:56+03:00,['7b15e388c37cd2cabf224568760ab127d07412ca'],1,1,2,23561825,1,,,,26261
e6d8cd119f9aaecbc6de33b5784d4cf2906ad53b,0,Nate Cole,2016-10-03 13:51:21-04:00,"['806723e0efdf8e2e677c18e0989e53e446a1669f', 'f2bcbbe70008303afdefd7c218b4954127ebe978']",14,49,63,23561888,7,,,,26261
aee49b67f5daf558e0dfa2091bb97c2619e3c097,0,Jonathan Hurley,2016-10-03 14:04:20-04:00,"['d53c9e2ee99c046ae5b37b531419549397f4aea1', 'f2bcbbe70008303afdefd7c218b4954127ebe978']",434,13991,14425,23576313,57,,,,26261
23fbfe48021fdd739ecc882698bb70fcadb8423b,0,Jonathan Hurley,2016-10-04 09:42:38-04:00,"['aee49b67f5daf558e0dfa2091bb97c2619e3c097', '98ba7e075458404f63e2ca16c73068a6df32a800']",13,514,527,23576840,39,,,,26261
269494849cad6d0a56dddaf52316e1d84b08d49f,1,Andrii Tkach,2016-10-04 17:11:46+03:00,['98ba7e075458404f63e2ca16c73068a6df32a800'],22,223,245,23577085,13,0.865248227,1,0.978723404,26262
1bf206907ea26eeeada640406ae2c130aa4140c9,1,Robert Levas,2016-10-04 13:16:08-04:00,['269494849cad6d0a56dddaf52316e1d84b08d49f'],151,936,1087,23578172,8,0.15625,0.198660714,0.564732143,26263
06f3b8e9006ef6ad1533f33baa0c9544547bd244,1,Aravindan Vijayan,2016-10-04 11:10:20-07:00,['1bf206907ea26eeeada640406ae2c130aa4140c9'],1,90,91,23578263,2,0,0.720588235,1,26263
c10053b086ae1b4f41c3d4cdba18349144ef7ec4,1,Aravindan Vijayan,2016-10-04 11:10:52-07:00,['06f3b8e9006ef6ad1533f33baa0c9544547bd244'],53,122,175,23578438,5,0.745098039,0.823529412,0.588235294,26263
98efb571d63a17973bb62a510593c2041c14dcf6,0,Aravindan Vijayan,2016-10-04 11:23:32-07:00,['c10053b086ae1b4f41c3d4cdba18349144ef7ec4'],2,42,44,23578482,2,0,0,1,26263
a442efbde22ac635b60b5650df397fd06c147ae1,1,Richard Zang,2016-10-04 14:19:55-07:00,['98efb571d63a17973bb62a510593c2041c14dcf6'],7,35,42,23578524,2,1,1,1,26263
5467ad0737bdadf23e0cec752acdbdc1b250de3c,0,Jonathan Hurley,2016-10-04 19:59:16-04:00,"['23fbfe48021fdd739ecc882698bb70fcadb8423b', 'a442efbde22ac635b60b5650df397fd06c147ae1']",235,1447,1682,23580206,31,,,,26263
26660f20e071d2a01dd0d37414d556e34947018d,1,ababiichuk,2016-10-05 12:38:50+03:00,['a442efbde22ac635b60b5650df397fd06c147ae1'],106,45,151,23580357,4,1,1,1,26263
62dc775ee4156e1a43ce0b991f3f47f68155128d,1,Pallav Kulshreshtha,2016-10-05 15:20:19+05:18,['26660f20e071d2a01dd0d37414d556e34947018d'],111,1003,1114,23581471,32,0.815738964,0.994241843,1,26267
a901d8a7a8f21cf9e6055a6669883abe47d5e370,0,Andrew Onishuk,2016-10-05 14:46:46+03:00,['62dc775ee4156e1a43ce0b991f3f47f68155128d'],40,97,137,23581608,1,0.344827586,1,0.344827586,26267
42c6126332bc77dc8c0a5366f5e8cac8c7779df2,0,Jonathan Hurley,2016-10-05 08:33:46-04:00,"['5467ad0737bdadf23e0cec752acdbdc1b250de3c', 'a901d8a7a8f21cf9e6055a6669883abe47d5e370']",257,1145,1402,23583010,37,,,,26267
2fc9a477842ddd25057e07d084b31b7147c4f3bd,1,Andrew Onishuk,2016-10-05 15:55:42+03:00,['a901d8a7a8f21cf9e6055a6669883abe47d5e370'],23,25,48,23583058,3,1,1,1,26267
76ea14ed31b27204907010100705eeaa2922e00e,1,Nahappan Somasundaram,2016-10-05 08:45:00-07:00,['2fc9a477842ddd25057e07d084b31b7147c4f3bd'],86,65,151,23583209,10,1,0,1,26267
1f7edfba8358ad3f07b168ec5c7f2245e01016d8,0,Alejandro Fernandez,2016-10-05 12:53:55-07:00,['76ea14ed31b27204907010100705eeaa2922e00e'],8,33,41,23583250,3,,,,26267
713f413c35c15d08f91bea619ecd7e9d1e877b9b,0,Di Li,2016-10-05 16:19:10-04:00,['1f7edfba8358ad3f07b168ec5c7f2245e01016d8'],12,20,32,23583282,1,0,0,1,26267
d7a914b3ba72630e3301ce23a40d099ceffaf98b,0,Alejandro Fernandez,2016-10-05 14:50:34-07:00,['713f413c35c15d08f91bea619ecd7e9d1e877b9b'],449,3,452,23583734,34,,,,26267
8f8b26a1805e600bd0276733cf73aed9bc130b44,1,Alejandro Fernandez,2016-10-05 16:14:41-07:00,['d7a914b3ba72630e3301ce23a40d099ceffaf98b'],4,451,455,23584189,34,,,,26276
714d9b528e0c671d777452c31f8e79905a5801b0,1,Sumit Mohanty,2016-10-05 17:28:49-07:00,['8f8b26a1805e600bd0276733cf73aed9bc130b44'],9,9,18,23584207,1,,,,26276
8b6e45e6220bd0304f3ce1cda1b7245ebb322669,0,Andrew Onishuk,2016-10-06 07:34:17+03:00,['714d9b528e0c671d777452c31f8e79905a5801b0'],1,1,2,23584209,1,,,,26276
bce5dbe3eacda9d35e645a776f1f9aa3edf06e9c,0,Mugdha Varadkar,2016-10-06 11:28:02+05:18,['8b6e45e6220bd0304f3ce1cda1b7245ebb322669'],16,22,38,23584247,2,0,0,1,26276
46cb40233d3e9762c2b44c1b43f3a0c1cf5c96c2,0,Vitaly Brodetskyi,2016-10-06 04:12:58+03:00,['bce5dbe3eacda9d35e645a776f1f9aa3edf06e9c'],6,6,12,23584259,1,,,,26276
56e00acdc8d7357ba811fcd4dca4fbb23bad33be,0,Vitaly Brodetskyi,2016-10-06 04:59:49+03:00,['46cb40233d3e9762c2b44c1b43f3a0c1cf5c96c2'],4,101,105,23584364,7,0.467741935,0.951612903,0.951612903,26276
38700445bd793d27a8747d4c1d06b70f531ab677,1,Jonathan Hurley,2016-10-06 11:33:46-04:00,['42c6126332bc77dc8c0a5366f5e8cac8c7779df2'],960,510,1470,23585834,52,0.495454545,0.05,0.011363636,26276
78a875cf2774457e769d147d2e985de20f6e64b8,0,Jonathan Hurley,2016-10-06 12:00:10-04:00,"['38700445bd793d27a8747d4c1d06b70f531ab677', '56e00acdc8d7357ba811fcd4dca4fbb23bad33be']",166,284,450,23586284,29,,,,26276
49c9660c39c379b5568f9cff2d0fad44bde03222,0,Andrew Onishuk,2016-10-06 19:24:08+03:00,['56e00acdc8d7357ba811fcd4dca4fbb23bad33be'],0,13,13,23586297,2,0,0.666666667,1,26276
cceb7d2d3eb8359e3a25a7c9eec5c92516f28097,0,Lisnichenko Dmitro,2016-10-06 19:57:25+03:00,['49c9660c39c379b5568f9cff2d0fad44bde03222'],0,17,17,23586314,1,,,,26276
55c1dc5cb8015e3d114c186792dacd883b7aa820,1,Lisnichenko Dmitro,2016-10-06 20:01:13+03:00,['cceb7d2d3eb8359e3a25a7c9eec5c92516f28097'],106,495,601,23586915,5,0.353909465,1,0.934156379,26278
b81deb0e5dea0c4f1ed56567d03e0e04049372ba,1,Yusaku Sako,2016-10-06 15:32:28-07:00,['55c1dc5cb8015e3d114c186792dacd883b7aa820'],2,2,4,23586919,2,,,,26278
c153cfb635fc51096c1d350ec6e23e5d5162bef7,1,Sandor Magyari,2016-10-07 11:28:51+02:00,['b81deb0e5dea0c4f1ed56567d03e0e04049372ba'],7,7,14,23586933,13,,,,26278
f6124a056d2a8ed16bec917775b9d3554ab5d74d,0,Di Li,2016-10-07 13:34:54-04:00,['c153cfb635fc51096c1d350ec6e23e5d5162bef7'],2,268,270,23587203,5,0.262626263,0.888888889,0.95959596,26279
197a37f034b2bc10f483d558cde7ab0f874c8d4c,0,Jonathan Hurley,2016-10-07 14:21:34-04:00,"['78a875cf2774457e769d147d2e985de20f6e64b8', 'f6124a056d2a8ed16bec917775b9d3554ab5d74d']",117,802,919,23588122,28,,,,26279
964808275c3e792ca7927888b2b9bf84371716d8,0,Nate Cole,2016-10-07 15:13:42-04:00,"['e6d8cd119f9aaecbc6de33b5784d4cf2906ad53b', 'f6124a056d2a8ed16bec917775b9d3554ab5d74d']",781,4185,4966,23593088,161,,,,26279
e0d4a8713ed0ffe86acd18bd798c317d5e51a61c,0,Jonathan Hurley,2016-10-07 15:36:00-04:00,['f6124a056d2a8ed16bec917775b9d3554ab5d74d'],268,2,270,23593358,5,0.737373737,0.111111111,0.04040404,26279
e7074ecab2960ea3b8ab9396156413529cff3085,1,Dipayan Bhowmick,2016-10-08 00:55:32+05:18,['e0d4a8713ed0ffe86acd18bd798c317d5e51a61c'],12,42,54,23593412,3,0,0,0.625,26279
8813b1f9295f052a0f28ac622fdd214964cec7c6,1,Dipayan Bhowmick,2016-10-08 01:05:39+05:18,['e7074ecab2960ea3b8ab9396156413529cff3085'],18,149,167,23593579,7,0.2,0,1,26279
fbfcf98abd5b8ced11b9b5ef35f73a9d319d0c5e,0,Jonathan Hurley,2016-10-07 15:58:00-04:00,"['197a37f034b2bc10f483d558cde7ab0f874c8d4c', '8813b1f9295f052a0f28ac622fdd214964cec7c6']",298,193,491,23594070,15,,,,26279
569020caf1c6f39765d7da9efb8c57b66293844e,1,Nahappan Somasundaram,2016-10-07 14:22:27-07:00,['8813b1f9295f052a0f28ac622fdd214964cec7c6'],0,280,280,23594350,1,0.138211382,1,1,26280
72f1f6f635b74e4fe3f5e21fed2d3a60aa6de0ad,1,Alejandro Fernandez,2016-10-07 16:29:43-07:00,['569020caf1c6f39765d7da9efb8c57b66293844e'],1,26,27,23594377,3,0,0.545454545,0.272727273,26280
0de69e10b30a1dadf6f508170548cd347095193a,1,Jonathan Hurley,2016-10-08 21:19:35-04:00,['fbfcf98abd5b8ced11b9b5ef35f73a9d319d0c5e'],647,340,987,23595364,48,1,0.063348416,0,26280
5cf5c8349cef6e4605870ac59dd620db2053b02c,0,Jonathan Hurley,2016-10-08 23:10:24-04:00,"['0de69e10b30a1dadf6f508170548cd347095193a', '72f1f6f635b74e4fe3f5e21fed2d3a60aa6de0ad']",1,306,307,23595671,4,,,,26280
58afcf93d8445c3b1ffacdd33c1cb12a8e8414cb,1,Vitaly Brodetskyi,2016-10-10 00:22:49+03:00,['72f1f6f635b74e4fe3f5e21fed2d3a60aa6de0ad'],26,169,195,23595866,2,0.057377049,0.844262295,1,26280
2d1d5f9b00e39a137c5aea8341436f408975cf82,0,"Toader, Sebastian",2016-10-10 16:06:55+02:00,['58afcf93d8445c3b1ffacdd33c1cb12a8e8414cb'],23,27,50,23595916,3,1,1,0.666666667,26280
784c7e4565b5b36b03f88ee9a6a8484ad976b7bc,0,Nate Cole,2016-10-10 10:40:38-04:00,"['964808275c3e792ca7927888b2b9bf84371716d8', '2d1d5f9b00e39a137c5aea8341436f408975cf82']",348,695,1043,23596959,24,,,,26280
a80c5a2dbaa0c48f7df87dae6a23a027c2ab6022,1,Andrew Onishuk,2016-10-10 17:52:36+03:00,['2d1d5f9b00e39a137c5aea8341436f408975cf82'],1,4,5,23596964,2,,,,26280
34c5686c3a0f80a5c7b78ddf05bb41cb13202438,0,Robert Levas,2016-10-10 11:09:58-04:00,['a80c5a2dbaa0c48f7df87dae6a23a027c2ab6022'],1,246,247,23597211,9,0.243589744,0.884615385,1,26280
0a61db5666f3ee8b82cdab0d50a1c8450b177ae7,1,Robert Levas,2016-10-10 11:16:01-04:00,['34c5686c3a0f80a5c7b78ddf05bb41cb13202438'],3,9,12,23597223,2,,,,26280
24161edf9f8a81592b120640bfa75a6ef3b1e0a1,0,Sandor Magyari,2016-10-10 17:37:09+02:00,['0a61db5666f3ee8b82cdab0d50a1c8450b177ae7'],0,7,7,23597230,1,,,,26280
da7b2ae1f72dc3e264e2ad0919fe6204de9d9b97,0,Andrii Tkach,2016-10-10 18:42:54+03:00,['24161edf9f8a81592b120640bfa75a6ef3b1e0a1'],35,66,101,23597331,2,1,1,1,26280
0d7689d844c1099facc6f6c6c10ba19f786de28a,0,Sandor Magyari,2016-10-10 17:49:51+02:00,['da7b2ae1f72dc3e264e2ad0919fe6204de9d9b97'],10,20,30,23597361,2,0,0,0,26280
b31c6c28563096419ae53e1584c4aa103262e6de,1,Nate Cole,2016-10-10 14:26:41-04:00,['784c7e4565b5b36b03f88ee9a6a8484ad976b7bc'],15,553,568,23597929,13,0.291262136,0.936893204,0.95631068,26281
8f51c9324a407fa8ce8e92e2e77ee0a250c5cbc9,0,Zhe (Joe) Wang,2016-10-10 16:13:09-07:00,['0d7689d844c1099facc6f6c6c10ba19f786de28a'],2,10,12,23597941,1,0.75,0.75,1,26281
6587fda470bcf063027e55b315292018dc1e64b4,1,Zhe (Joe) Wang,2016-10-10 16:17:56-07:00,['8f51c9324a407fa8ce8e92e2e77ee0a250c5cbc9'],0,25,25,23597966,2,1,1,1,26281
ed2018bf06ec5ee18eb3c0c618f664db0d058025,0,Jonathan Hurley,2016-10-10 20:37:39-04:00,"['5cf5c8349cef6e4605870ac59dd620db2053b02c', '6587fda470bcf063027e55b315292018dc1e64b4']",101,583,684,23598650,26,,,,26281
3e4b368f9bde259b29d3a2e97fd84e773af434c3,0,Nahappan Somasundaram,2016-10-10 20:47:32-07:00,['6587fda470bcf063027e55b315292018dc1e64b4'],0,2,2,23598652,2,0,0,1,26281
f725e33ecee3374ea32bcc604f53756c9b39cddf,0,Sandor Magyari,2016-10-11 19:08:33+02:00,['3e4b368f9bde259b29d3a2e97fd84e773af434c3'],0,3,3,23598655,1,,,,26281
1d54fefbbf419d3fe6ebc9abd8257b854b7e0cf5,1,Alejandro Fernandez,2016-10-11 16:33:59-07:00,['f725e33ecee3374ea32bcc604f53756c9b39cddf'],15,54,69,23598724,9,1,1,0.125,26281
10f44bcadbac846e0719c8d91c81f18a16b2d764,0,Jonathan Hurley,2016-10-11 21:42:08-04:00,"['ed2018bf06ec5ee18eb3c0c618f664db0d058025', '1d54fefbbf419d3fe6ebc9abd8257b854b7e0cf5']",15,59,74,23598798,12,,,,26281
d2a926ee71f8a24a8d568fc977dc8ac06dc18493,1,Robert Levas,2016-10-12 05:01:14-04:00,['1d54fefbbf419d3fe6ebc9abd8257b854b7e0cf5'],139,196,335,23599133,6,0,1,1,26281
9511638609f756cc70eaf0cca32a1cc55b40424c,0,Andrii Tkach,2016-10-12 12:10:55+03:00,['d2a926ee71f8a24a8d568fc977dc8ac06dc18493'],6,6,12,23599145,1,,,,26281
82afd3a0ff4dac37a8c56b914b37c1c9476c30ee,0,Nate Cole,2016-10-12 10:36:03-04:00,['9511638609f756cc70eaf0cca32a1cc55b40424c'],1,1,2,23599147,1,,,,26281
18c74125a90169a88f712a7a48e15274e0fbb9e8,0,Jonathan Hurley,2016-10-12 10:41:42-04:00,"['10f44bcadbac846e0719c8d91c81f18a16b2d764', '9511638609f756cc70eaf0cca32a1cc55b40424c']",145,202,347,23599494,7,,,,26281
5d007e248e24e02d4d8c5c818a1125830370936c,0,Andrew Onishuk,2016-10-12 20:13:13+03:00,['82afd3a0ff4dac37a8c56b914b37c1c9476c30ee'],6,20,26,23599520,4,0.666666667,1,0.666666667,26281
60dc240216bf54f35dfb5d3fea823ccceee2c9a4,1,Siddharth Wagle,2016-10-12 11:04:54-07:00,['5d007e248e24e02d4d8c5c818a1125830370936c'],0,74,74,23599594,3,0,0.9,0.1,26281
911deb744485aa0366aad168c98566cf6381d4cc,1,Swapan Shridhar,2016-10-12 13:08:48-07:00,['60dc240216bf54f35dfb5d3fea823ccceee2c9a4'],63,69,132,23599726,2,,,,26281
2709304c50a934679069c2ac63e1dfe64e7dfc3c,1,Zhe (Joe) Wang,2016-10-12 13:51:34-07:00,['911deb744485aa0366aad168c98566cf6381d4cc'],1,10,11,23599737,2,,,,26281
2131466610b41af761fd1a105312c6553685c5ac,1,Alejandro Fernandez,2016-10-12 15:59:32-07:00,['2709304c50a934679069c2ac63e1dfe64e7dfc3c'],9,49,58,23599795,6,1,1,1,26281
d4f24d3313f850eeee597682c6f15bdf5106e297,1,Vitaly Brodetskyi,2016-10-13 04:11:14+03:00,['2131466610b41af761fd1a105312c6553685c5ac'],1,352,353,23600148,4,0.398550725,1,1,26283
a851d8f128b6ea5f1b247a931f48f35fdc35db2a,0,Jonathan Hurley,2016-10-13 08:31:03-04:00,"['18c74125a90169a88f712a7a48e15274e0fbb9e8', '2131466610b41af761fd1a105312c6553685c5ac']",80,223,303,23600451,18,,,,26283
1cc090d56d2666ec4d96c90509debc65156bce8e,0,Nate Cole,2016-10-13 08:43:02-04:00,"['b31c6c28563096419ae53e1584c4aa103262e6de', '2131466610b41af761fd1a105312c6553685c5ac']",292,871,1163,23601614,55,,,,26283
3622d7bbf47e37be249e1b4f63288cfdb5907744,1,Andrew Onishuk,2016-10-13 17:49:34+03:00,['d4f24d3313f850eeee597682c6f15bdf5106e297'],56,77,133,23601747,8,1,1,0.470588235,26283
08f1404fc573c0cd3969295a49f4682f51b5d251,1,Andrew Onishuk,2016-10-13 18:10:07+03:00,['3622d7bbf47e37be249e1b4f63288cfdb5907744'],1,1,2,23601749,1,,,,26283
f70722e1902bb9eace19e808f7dc0777c216be5a,0,Sandor Magyari,2016-10-13 17:31:17+02:00,['08f1404fc573c0cd3969295a49f4682f51b5d251'],1,1,2,23601751,1,,,,26283
00d2f1193e2d68b8ea4bc80eb09add91dd626c78,1,Andrew Onishuk,2016-10-13 19:42:54+03:00,['f70722e1902bb9eace19e808f7dc0777c216be5a'],1,1,2,23601753,1,,,,26283
4140cc78a0153799938c2dbe3f80c11ab3be2e30,0,Jonathan Hurley,2016-10-13 15:44:58-04:00,['00d2f1193e2d68b8ea4bc80eb09add91dd626c78'],5,43,48,23601801,1,0,0,0,26283
2b35c980c187b0b211c1b6cf875bc800a35b491a,1,Nate Cole,2016-10-13 17:11:31-04:00,['4140cc78a0153799938c2dbe3f80c11ab3be2e30'],47,543,590,23602391,18,0.319148936,0.930851064,0.95212766,26284
78f43507f883f527f41c6a3ab71ff40bbd433647,0,"Toader, Sebastian",2016-10-14 11:15:27+02:00,['2b35c980c187b0b211c1b6cf875bc800a35b491a'],1,11,12,23602403,2,1,1,0,26284
9b0f631765f1e1c5855b95943c5cfb8c9cfff879,1,Jonathan Hurley,2016-10-14 09:30:26-04:00,['78f43507f883f527f41c6a3ab71ff40bbd433647'],441,91,532,23602935,19,0,1,0.272727273,26284
20f297803161e7c927446283d1f81043d70055c8,0,Jonathan Hurley,2016-10-14 09:40:28-04:00,"['a851d8f128b6ea5f1b247a931f48f35fdc35db2a', '9b0f631765f1e1c5855b95943c5cfb8c9cfff879']",542,1106,1648,23604583,53,,,,26284
10c7595a4ac858ac5a095f2caf8770f1ea685c1c,1,Tim Thorpe,2016-10-14 08:39:17-07:00,['9b0f631765f1e1c5855b95943c5cfb8c9cfff879'],3,8,11,23604594,2,0,0,1,26284
9b9a2c07c7fa06f6575997b46583fc1dcafbfb08,1,Aravindan Vijayan,2016-10-14 11:28:22-07:00,['10c7595a4ac858ac5a095f2caf8770f1ea685c1c'],98,156,254,23604848,3,0,1,1,26284
6951da4d531f9f12f0a0e1e8668ab8f7ba0557d2,0,Alejandro Fernandez,2016-10-14 13:18:10-07:00,['9b9a2c07c7fa06f6575997b46583fc1dcafbfb08'],0,21,21,23604869,1,,,,26284
2a77e39ca78d157c3286a317325ac6cba03670cb,1,Aleksandr Kovalenko,2016-10-15 00:03:35+03:00,['6951da4d531f9f12f0a0e1e8668ab8f7ba0557d2'],11065,31468,42533,23647402,406,0.386264598,0.425309395,0.66724769,26305
96d66e0d41d49e67d11d5ea558c24d858f4b9577,1,Zhe (Joe) Wang,2016-10-14 17:58:59-07:00,['2a77e39ca78d157c3286a317325ac6cba03670cb'],0,11,11,23647413,1,1,1,1,26305
3417db944c909485ca0af54019b712cd509debc0,1,Jaimin Jetly,2016-10-14 18:09:56-07:00,['96d66e0d41d49e67d11d5ea558c24d858f4b9577'],1,1,2,23647415,1,,,,26305
e8544ba49be24774a40b4e95da05ab4d7daeccda,0,Gautam Borad,2016-10-15 10:13:37+05:18,['3417db944c909485ca0af54019b712cd509debc0'],3,1,4,23647419,1,,,,26305
d6a847154e80158a0be0a26ee7dfc0d6dccac686,1,Jonathan Hurley,2016-10-16 09:28:50-04:00,['20f297803161e7c927446283d1f81043d70055c8'],519,289,808,23648227,28,0.911949686,0.062893082,0,26305
5dff9acdc388d276129fcca80c493f8d56ef58e2,0,Jonathan Hurley,2016-10-16 09:29:21-04:00,"['d6a847154e80158a0be0a26ee7dfc0d6dccac686', 'e8544ba49be24774a40b4e95da05ab4d7daeccda']",11170,31666,42836,23691063,415,,,,26305
61442de4c6d8690595a5b331cda3890b9e26b5b9,0,"Toader, Sebastian",2016-10-17 10:59:39+02:00,['e8544ba49be24774a40b4e95da05ab4d7daeccda'],42,42,84,23691147,15,,,,26306
645b2fbe4be05a754618aa0a4790e351813b026e,1,Vitaly Brodetskyi,2016-10-17 00:36:44+03:00,['61442de4c6d8690595a5b331cda3890b9e26b5b9'],0,5,5,23691152,1,0,1,1,26306
9eb64a5e97cfc7d1ce67acd6cb4b4796c6ad3875,1,Andrew Onishuk,2016-10-17 16:01:35+03:00,['645b2fbe4be05a754618aa0a4790e351813b026e'],0,4,4,23691156,1,,,,26306
5c32fed74cce667bacffbe7f0d549ceed709e3fc,1,Alex Antonenko,2016-10-17 16:07:56+03:00,['9eb64a5e97cfc7d1ce67acd6cb4b4796c6ad3875'],174,136,310,23691466,33,,,,26306
41c49e162f156320a0c366f487beea0280b95e38,0,Andrew Onishuk,2016-10-17 16:18:52+03:00,['5c32fed74cce667bacffbe7f0d549ceed709e3fc'],1,8,9,23691475,1,0,1,1,26306
aa29f56cb8d5024602717716f6d218a695f92724,0,Jonathan Hurley,2016-10-17 10:16:43-04:00,"['5dff9acdc388d276129fcca80c493f8d56ef58e2', '41c49e162f156320a0c366f487beea0280b95e38']",217,195,412,23691887,51,,,,26306
73f1dea9674359ecbfd723917c83913b20986906,0,Di Li,2016-10-17 10:35:25-04:00,['41c49e162f156320a0c366f487beea0280b95e38'],2,7,9,23691896,2,0.5,0.5,0.5,26306
d132ca17354b867cb167f8800e868a27f0b6252d,0,Jayush Luniya,2016-10-17 13:06:51-07:00,['73f1dea9674359ecbfd723917c83913b20986906'],11,11,22,23691918,2,,,,26306
89d964e0e0e5b6285d82074207222220cd54888c,1,Zhe (Joe) Wang,2016-10-17 14:53:16-07:00,['d132ca17354b867cb167f8800e868a27f0b6252d'],22,44,66,23691984,3,0,0,0,26306
fdda172fed36ae3e156dc2757a09f85d0a379175,0,Zhe (Joe) Wang,2016-10-17 15:02:41-07:00,['89d964e0e0e5b6285d82074207222220cd54888c'],1,9,10,23691994,1,,,,26306
a93c0f4004a02b02c95e2057115c961c192662b8,1,Jaimin Jetly,2016-10-17 19:08:31-07:00,['fdda172fed36ae3e156dc2757a09f85d0a379175'],24,82,106,23692100,15,0,0.866666667,0.866666667,26306
2c6008293a664ab3b0f24a3f22be54fe0e5f1faf,1,Jonathan Hurley,2016-10-18 08:21:08-04:00,['aa29f56cb8d5024602717716f6d218a695f92724'],841,467,1308,23693408,22,1,0.022222222,0,26306
61cc3a9e6100216ccb114d07a64619d9191f17cd,0,ababiichuk,2016-10-18 15:43:13+03:00,['a93c0f4004a02b02c95e2057115c961c192662b8'],5,35,40,23693448,2,0.611111111,0.888888889,1,26306
3fc0b3e66b605bc628e9994be1c96c2c46396388,0,Andrew Onishuk,2016-10-18 17:54:51+03:00,['61cc3a9e6100216ccb114d07a64619d9191f17cd'],14,91,105,23693553,8,0.80952381,0.80952381,0,26307
ee2a12527864dd1238b18366badfec89465444b3,1,Alex Antonenko,2016-10-18 18:03:24+03:00,['3fc0b3e66b605bc628e9994be1c96c2c46396388'],34,156,190,23693743,4,0.214285714,1,1,26307
e68cc10dd9e0c0c012aa684a69f743fee41310d5,0,Andrew Onishuk,2016-10-18 18:35:15+03:00,['ee2a12527864dd1238b18366badfec89465444b3'],16,53,69,23693812,2,1,1,1,26308
83aebdaa577b526a8e123cfda53cea27d1138a1e,0,Dmytro Sen,2016-10-18 18:57:47+03:00,['e68cc10dd9e0c0c012aa684a69f743fee41310d5'],1,5,6,23693818,3,,,,26308
7ed5259d46ce0a0ace7b9d44d13fabe79b737346,1,Aravindan Vijayan,2016-10-18 09:44:18-07:00,['83aebdaa577b526a8e123cfda53cea27d1138a1e'],68,143,211,23694029,1,0,1,1,26308
532caef33fe65d6933e9797d3db12065555bd69b,0,Jonathan Hurley,2016-10-18 15:32:08-04:00,"['2c6008293a664ab3b0f24a3f22be54fe0e5f1faf', '7ed5259d46ce0a0ace7b9d44d13fabe79b737346']",199,635,834,23694863,43,,,,26308
c3b31d6f7461625d6a7fe533025c5f604c67ffb5,1,Andrew Onishuk,2016-10-19 01:52:05+03:00,['7ed5259d46ce0a0ace7b9d44d13fabe79b737346'],80,8,88,23694951,5,0.424242424,1,0.151515152,26308
7be041894a6384a211aee965be36b1d429103fb3,1,Zhe (Joe) Wang,2016-10-18 17:19:42-07:00,['c3b31d6f7461625d6a7fe533025c5f604c67ffb5'],44,75,119,23695070,20,,,,26308
159ad00328af9ed7a7b7130904d53210a7b41146,0,Jonathan Hurley,2016-10-18 23:02:47-04:00,"['532caef33fe65d6933e9797d3db12065555bd69b', '7be041894a6384a211aee965be36b1d429103fb3']",124,83,207,23695277,25,,,,26308
2a2c557f126e9cdf148e4ebf9c2b375c66c346df,1,pallavkul,2016-10-19 13:13:38+05:18,['7be041894a6384a211aee965be36b1d429103fb3'],4,4,8,23695285,2,,,,26308
3d6ddc2af5de4c489f651eb61984e44e0eb5d04d,0,Nate Cole,2016-10-19 09:48:55-04:00,['2a2c557f126e9cdf148e4ebf9c2b375c66c346df'],0,28,28,23695313,4,,,,26308
dedcdf9aff6da5d63debf82cb713eaa9eb268618,1,Alex Antonenko,2016-10-19 18:46:54+03:00,['3d6ddc2af5de4c489f651eb61984e44e0eb5d04d'],1246,1409,2655,23697968,7,0.671875,0.953125,1,26309
efe38bece39de0241c8656a4c77a733a3c878987,0,Jonathan Hurley,2016-10-19 12:06:10-04:00,"['dedcdf9aff6da5d63debf82cb713eaa9eb268618', '159ad00328af9ed7a7b7130904d53210a7b41146']",5011,2958,7969,23705937,102,,,,26309
b236ef4d7bdfb4dbc388eb9cdc87af846f9bc89e,0,Jonathan Hurley,2016-10-19 12:30:04-04:00,['efe38bece39de0241c8656a4c77a733a3c878987'],1,0,1,23705938,1,1,0,0,26309
a3d7aec0b0e284fdbd0afbc841ff8dcf8216e5cf,0,Nate Cole,2016-10-19 12:46:42-04:00,"['1cc090d56d2666ec4d96c90509debc65156bce8e', '3d6ddc2af5de4c489f651eb61984e44e0eb5d04d']",12214,33171,45385,23751323,540,,,,26309
8985231131061178103423c980c29caee45960c4,0,Nate Cole,2016-10-19 12:57:55-04:00,"['a3d7aec0b0e284fdbd0afbc841ff8dcf8216e5cf', 'b236ef4d7bdfb4dbc388eb9cdc87af846f9bc89e']",6258,4367,10625,23761948,110,,,,26309
365a5d638fb7edcd4ff5561b29f0efb66fa5b881,1,Alejandro Fernandez,2016-10-19 10:58:10-07:00,['b236ef4d7bdfb4dbc388eb9cdc87af846f9bc89e'],45,204,249,23762197,9,0.305555556,0.708333333,0.944444444,26309
a954d832ac353c1b43bb738bdf88c4105a066b92,1,Vitaly Brodetskyi,2016-10-20 01:10:49+03:00,['365a5d638fb7edcd4ff5561b29f0efb66fa5b881'],0,33,33,23762230,2,0,1,1,26309
febd71ea06932697c556b0f2b608ed967f403f90,0,Sandor Magyari,2016-10-20 15:51:47+02:00,['a954d832ac353c1b43bb738bdf88c4105a066b92'],2,44,46,23762276,3,0.857142857,0,0,26309
87cbaa550bb5bead401e1cc3872990ee63c665ad,1,Andrew Onishuk,2016-10-20 17:18:00+03:00,['febd71ea06932697c556b0f2b608ed967f403f90'],2,7,9,23762285,2,,,,26310
3e1de1af80e1906952bdfc6a8582d8389921d156,0,Andrew Onishuk,2016-10-20 17:18:32+03:00,['87cbaa550bb5bead401e1cc3872990ee63c665ad'],1,1,2,23762287,1,,,,26310
311124d2535897ae672a65e221f26d131ceaf3b4,0,Andrew Onishuk,2016-10-20 17:19:07+03:00,['3e1de1af80e1906952bdfc6a8582d8389921d156'],3,14,17,23762304,4,,,,26312
f55e9dbd5b79f0ce4e9702f87ba7a9380853f921,0,Andrew Onishuk,2016-10-20 17:19:46+03:00,['311124d2535897ae672a65e221f26d131ceaf3b4'],1,1,2,23762306,1,,,,26312
d9bc653a0ea8433ba53c60c223aa35cf2d8acade,1,ababiichuk,2016-10-20 18:00:58+03:00,['f55e9dbd5b79f0ce4e9702f87ba7a9380853f921'],2,3,5,23762311,1,1,1,1,26312
5fdc9f97e3ef98a88a56753708310384bfc6a1b5,1,Sandor Magyari,2016-10-20 18:06:13+02:00,['d9bc653a0ea8433ba53c60c223aa35cf2d8acade'],353,676,1029,23763340,30,0.439716312,1,0.865248227,26315
1d5178ce727c02d1eb064e210e421ed54428448e,1,Dipayan Bhowmick,2016-10-20 22:01:39+05:18,['5fdc9f97e3ef98a88a56753708310384bfc6a1b5'],9,8,17,23763357,2,0,1,1,26315
563b41def0995301f190a1c82c8190c3d7646d92,1,Andrew Onishuk,2016-10-20 21:16:36+03:00,['1d5178ce727c02d1eb064e210e421ed54428448e'],14,3,17,23763374,4,,,,26315
685e926db0d442411ab5bee50c1e189cfb0a261e,0,Swapan Shridhar,2016-10-20 12:04:24-07:00,['563b41def0995301f190a1c82c8190c3d7646d92'],1,4221,4222,23767596,31,0.296523517,0.88070893,0.895023858,26345
03f7b909517a4939199078911603ff6b2e4c99c8,1,Aravindan Vijayan,2016-10-20 14:00:14-07:00,['685e926db0d442411ab5bee50c1e189cfb0a261e'],22,561,583,23768179,10,0.270386266,0.729613734,0.772532189,26349
5256a78908ec9a635bf7e59480511d2ca0d33363,0,Xi Wang,2016-10-20 14:02:10-07:00,['03f7b909517a4939199078911603ff6b2e4c99c8'],1,1,2,23768181,1,,,,26349
dd0cc32b71988add58d6e796dc77722a937c28b1,0,Aravindan Vijayan,2016-10-20 16:29:35-07:00,['5256a78908ec9a635bf7e59480511d2ca0d33363'],6,1,7,23768188,1,1,1,0,26349
18a88ebb43260f01ff1b5370bc15fb7b6a64055c,0,Dmytro Sen,2016-10-21 13:38:14+03:00,['dd0cc32b71988add58d6e796dc77722a937c28b1'],20,329,349,23768537,11,0.52866242,0.681528662,0.47133758,26351
562bac816c90fcdecc11d6f6a4cc19cbe4e484a9,1,ababiichuk,2016-10-21 16:16:40+03:00,['18a88ebb43260f01ff1b5370bc15fb7b6a64055c'],138,338,476,23769013,19,1,0.854700855,0.811965812,26353
942b3dba72d946bbf82ea90d0f66b6d9c16c0eff,1,"Toader, Sebastian",2016-10-21 17:31:13+02:00,['562bac816c90fcdecc11d6f6a4cc19cbe4e484a9'],42,68,110,23769123,2,0.789473684,0.947368421,0.947368421,26353
3b159d27290a31df3c2269df1d0f6152d0dff780,1,Lisnichenko Dmitro,2016-10-21 19:38:15+03:00,['942b3dba72d946bbf82ea90d0f66b6d9c16c0eff'],4,117,121,23769244,25,,,,26353
462c8d9f61554f42704013d53b6376379dc408e0,0,"Toader, Sebastian",2016-10-21 18:53:11+02:00,['3b159d27290a31df3c2269df1d0f6152d0dff780'],4,974,978,23770222,10,0.9569161,1,0.943310658,26360
66259872fede7645be5c49391a3aa8bf13f4c8bf,1,Jonathan Hurley,2016-10-21 13:14:27-04:00,['462c8d9f61554f42704013d53b6376379dc408e0'],70,124,194,23770416,8,1,1,0,26360
5114bc9f7d4d8a246603e5d60dd528ab4cd312c7,1,Nate Cole,2016-10-21 13:37:43-04:00,['66259872fede7645be5c49391a3aa8bf13f4c8bf'],1,1,2,23770418,1,,,,26360
db8f3e3f8855fc3174fa6b41ed86c87b9263321a,0,Alex Antonenko,2016-10-21 21:53:10+03:00,['5114bc9f7d4d8a246603e5d60dd528ab4cd312c7'],93,36,129,23770547,6,1,0.20754717,0,26360
00f1e71b62f4133e70d7d8f9f2cd6fa0624ec40d,1,Alex Antonenko,2016-10-21 21:53:10+03:00,['db8f3e3f8855fc3174fa6b41ed86c87b9263321a'],7,32,39,23770586,4,1,0,0,26360
f37b518b5d29e227e56a9b2eef57673b164be22b,0,Swapan Shridhar,2016-10-21 12:03:16-07:00,['00f1e71b62f4133e70d7d8f9f2cd6fa0624ec40d'],4221,1,4222,23774808,31,0.703476483,0.11929107,0.104976142,26360
b3dda4ffe9c8bc47725fd9292dc621568df45610,0,Robert Levas,2016-10-21 15:18:41-04:00,['f37b518b5d29e227e56a9b2eef57673b164be22b'],716,857,1573,23776381,44,0,0.162162162,1,26361
0dd7770d9f3efd99e8bc9475d5f58422f4800fcd,0,Jaimin Jetly,2016-10-21 12:49:40-07:00,['b3dda4ffe9c8bc47725fd9292dc621568df45610'],14,26,40,23776421,3,0.666666667,1,1,26361
b90b286366e67b7b494b2f2cf886dc4eab4ff006,0,Robert Levas,2016-10-21 16:01:10-04:00,['0dd7770d9f3efd99e8bc9475d5f58422f4800fcd'],857,716,1573,23777994,44,1,0.837837838,0,26362
176c691eaed6dbf639617f6208f7fb117597c1ce,1,Robert Levas,2016-10-21 16:01:44-04:00,['b90b286366e67b7b494b2f2cf886dc4eab4ff006'],716,857,1573,23779567,44,0,0.162162162,1,26363
dbe77dda8a21dffa7edc8228a9e65d8b72492034,1,Vitaly Brodetskyi,2016-10-21 11:17:55+03:00,['176c691eaed6dbf639617f6208f7fb117597c1ce'],69,222,291,23779858,8,0.144230769,1,0.913461538,26363
96ef52f4b688d26e0236fc80213f19bd714aab6a,0,Alex Antonenko,2016-10-22 00:50:19+03:00,['dbe77dda8a21dffa7edc8228a9e65d8b72492034'],6,10,16,23779874,3,1,1,1,26363
3620a1af3905659cbfb0c4ac5ce7ccb2b192bd95,0,Dipayan Bhowmick,2016-10-24 12:34:09+05:18,['96ef52f4b688d26e0236fc80213f19bd714aab6a'],1,1,2,23779876,1,,,,26363
9689c9e209bc542af4d35f6196af79df756ceb9f,1,Dmytro Sen,2016-10-24 13:24:00+03:00,['3620a1af3905659cbfb0c4ac5ce7ccb2b192bd95'],87,309,396,23780272,8,0.962962963,1,1,26364
33b281e5fd6978ce0c92c647453e5a8c69c4e08c,0,Tim Thorpe,2016-10-24 04:50:34-07:00,['9689c9e209bc542af4d35f6196af79df756ceb9f'],7,61,68,23780340,2,0.097560976,0.951219512,1,26364
4e372b51439ef8d202d95c9f4513cd383ff9b7d4,1,Aleksandr Kovalenko,2016-10-24 15:06:32+03:00,['33b281e5fd6978ce0c92c647453e5a8c69c4e08c'],371,425,796,23781136,18,1,1,1,26364
2402ea13d7c268b06d8bf2b2d13126495fcd74e7,0,Alex Antonenko,2016-10-24 15:34:31+03:00,['4e372b51439ef8d202d95c9f4513cd383ff9b7d4'],0,3,3,23781139,1,0,1,1,26364
2cac6678d6908ca4824ad1f53dbf93d88c3251c6,1,Oleg Nechiporenko,2016-10-24 16:49:06+03:00,['2402ea13d7c268b06d8bf2b2d13126495fcd74e7'],31,34,65,23781204,3,0,0,1,26364
4caf4b56c941624fc08d1f4cab7c5abfb68668c9,0,Dmytro Sen,2016-10-24 17:20:50+03:00,['2cac6678d6908ca4824ad1f53dbf93d88c3251c6'],5,53,58,23781262,3,0.80952381,0.80952381,1,26364
ee7f08554a45a84863566d776b7e621d70095745,1,Dmytro Sen,2016-10-24 17:36:02+03:00,['4caf4b56c941624fc08d1f4cab7c5abfb68668c9'],0,1,1,23781263,1,,,,26364
0aed646447c66f3f4d650e822a354b3a04440f80,0,Robert Levas,2016-10-24 10:41:01-04:00,['ee7f08554a45a84863566d776b7e621d70095745'],45,0,45,23781308,6,,,,26364
65ef869102aa312595c8ab84e08aa0be64256da9,1,Andrew Onishuk,2016-10-24 18:30:42+03:00,['0aed646447c66f3f4d650e822a354b3a04440f80'],1,8,9,23781317,3,,,,26364
d31c6178bc7287ae6411e6d6ba6eda59726dfd08,1,Andrew Onishuk,2016-10-24 18:49:44+03:00,['65ef869102aa312595c8ab84e08aa0be64256da9'],84,158,242,23781559,9,1,0.75862069,1,26365
dcbd2c07c8fdb9db22d11ac94aea3df9bc27595c,1,Swapan Shridhar,2016-10-24 13:47:51-07:00,['d31c6178bc7287ae6411e6d6ba6eda59726dfd08'],1,4222,4223,23785782,31,0.296523517,0.88070893,0.895023858,26395
c3f87d4133b6ac8743ccd1eecd0ae07b98ce0189,1,Alex Antonenko,2016-10-25 00:18:54+03:00,['dcbd2c07c8fdb9db22d11ac94aea3df9bc27595c'],403,745,1148,23786930,52,0.967741935,1,1,26398
8356a4e5d64cf3b12a5dde332d3b6c0cac3d95f2,0,Alex Antonenko,2016-10-25 00:22:48+03:00,['c3f87d4133b6ac8743ccd1eecd0ae07b98ce0189'],1,1,2,23786932,1,,,,26398
1f6d95022006a98af15bc44ef5e0e8bd9e29e527,1,Alex Antonenko,2016-10-25 00:26:16+03:00,['8356a4e5d64cf3b12a5dde332d3b6c0cac3d95f2'],4,199,203,23787135,8,1,1,1,26400
e9f551113841ab3edaff55aa6b25c792e4e35fbd,1,Richard Zang,2016-10-24 14:32:21-07:00,['1f6d95022006a98af15bc44ef5e0e8bd9e29e527'],6,1487,1493,23788628,38,0.963249516,1,0.992263056,26425
0f35a2ada46c56156135918ca633f646a3a3efd9,0,Richard Zang,2016-10-24 16:11:04-07:00,['e9f551113841ab3edaff55aa6b25c792e4e35fbd'],0,35,35,23788663,2,,,,26425
32b28120dbca718e1a5b17c12b27c24eee321a45,0,Dmytro Sen,2016-10-25 14:47:11+03:00,['0f35a2ada46c56156135918ca633f646a3a3efd9'],53,5,58,23788721,3,0.19047619,0.19047619,0,26425
cc82fec863af4d8199ed6903772017d2a070f2b9,1,Jonathan Hurley,2016-10-25 08:04:58-04:00,['32b28120dbca718e1a5b17c12b27c24eee321a45'],31,31,62,23788783,2,1,0.368421053,0,26425
8eead14916ddd86658c488dd07f9432dadcc2331,1,Jayush Luniya,2016-10-25 22:20:45+09:00,['cc82fec863af4d8199ed6903772017d2a070f2b9'],9,522,531,23789314,4,0.148275862,0.668965517,0.710344828,26427
b67d8832108cf5874bddf1a6ccc186fa5ca69e85,1,Robert Levas,2016-10-25 12:00:01-04:00,['8eead14916ddd86658c488dd07f9432dadcc2331'],25,172,197,23789511,10,0.208791209,0.824175824,0.923076923,26427
70d8da7cda11e625269793cd05145c5ca83fec31,0,Alex Antonenko,2016-10-25 19:30:31+03:00,['b67d8832108cf5874bddf1a6ccc186fa5ca69e85'],2,2,4,23789515,1,,,,26427
a5b8230aef0f12a52d1bbcd1cb5cf72900476d6c,1,Lisnichenko Dmitro,2016-10-26 18:53:50+03:00,['70d8da7cda11e625269793cd05145c5ca83fec31'],49,384,433,23789948,14,0.852941176,0.985294118,1,26430
7b30be6dd49a61593c198306eb2feefbd85a680b,1,Jonathan Hurley,2016-10-26 12:44:12-04:00,['a5b8230aef0f12a52d1bbcd1cb5cf72900476d6c'],315,353,668,23790616,13,0,0,0,26431
aa588ca8667f5f67b6be2251a6dad37230172fb4,1,Andrew Onishuk,2016-10-26 20:08:46+03:00,['7b30be6dd49a61593c198306eb2feefbd85a680b'],13,33,46,23790662,3,1,1,1,26431
03f61bd6a10be892d67237c45f1db34830d4c5d8,1,Myroslav Papirkovskyi,2016-10-26 20:57:46+03:00,['aa588ca8667f5f67b6be2251a6dad37230172fb4'],9,109,118,23790780,2,0.615384615,0.91025641,1,26431
93a3fe1e88b7e7d7361ed7c5399ab41b985ea694,0,Matt,2016-10-26 11:29:17-07:00,['03f61bd6a10be892d67237c45f1db34830d4c5d8'],0,14,14,23790794,1,,,,26431
ae6e204732af54780f9177c840ef8649b48ba84a,0,Richard Zang,2016-10-26 14:10:00-07:00,['93a3fe1e88b7e7d7361ed7c5399ab41b985ea694'],1,1,2,23790796,1,,,,26431
039562ca1f7b76222b574062da9756bae72d9a15,0,Matt,2016-10-26 14:59:48-07:00,['ae6e204732af54780f9177c840ef8649b48ba84a'],8,18,26,23790822,3,,,,26433
00ce02a5f0786f827e308edc28b8aa3810ad7468,1,Alex Antonenko,2016-10-27 02:53:07+03:00,['039562ca1f7b76222b574062da9756bae72d9a15'],0,5,5,23790827,1,,,,26433
0c5bcbba5d44e915a5487a855f364bfe8cab6b72,1,Aravindan Vijayan,2016-10-26 16:57:34-07:00,['00ce02a5f0786f827e308edc28b8aa3810ad7468'],2,10,12,23790839,1,0,0,1,26433
d52154ee1e526efb78b1847106d0ea85462d596b,1,Richard Zang,2016-10-26 18:08:52-07:00,['0c5bcbba5d44e915a5487a855f364bfe8cab6b72'],22,15,37,23790876,2,,,,26433
4b09b63bfd2df05d901f40f2496d315f95f5df9e,0,Sumit Mohanty,2016-10-26 18:11:09-07:00,['d52154ee1e526efb78b1847106d0ea85462d596b'],0,2,2,23790878,1,0,0,0,26433
9c6809ff599c10f4e6d3311df9792580b74bf6c8,0,Oleg Nechiporenko,2016-10-27 13:55:13+03:00,['4b09b63bfd2df05d901f40f2496d315f95f5df9e'],1,1,2,23790880,1,,,,26433
6cc4431b8258fab1c5fbf614734e916b6dee2bad,1,Andrew Onishuk,2016-10-27 14:25:25+03:00,['9c6809ff599c10f4e6d3311df9792580b74bf6c8'],4,15,19,23790899,4,,,,26435
7e4f6209649e8f1ccb86e04ce1e2f54225e5375c,0,Andrew Onishuk,2016-10-27 16:36:11+03:00,['6cc4431b8258fab1c5fbf614734e916b6dee2bad'],0,3,3,23790902,1,0,1,1,26435
ba526d9a2cfbb84ce03787fde5e3cf740950dc18,1,Nate Cole,2016-10-27 10:02:21-04:00,['70d8da7cda11e625269793cd05145c5ca83fec31'],2,780,782,23791684,7,1,1,0.875,26438
91b7d221256943f0b000b31cab407557f15bc91c,0,Aleksandr Kovalenko,2016-10-27 17:10:27+03:00,['7e4f6209649e8f1ccb86e04ce1e2f54225e5375c'],2,2,4,23791688,1,,,,26438
6088e4f1c96c27ada12e1645db828a234efbe876,0,Nate Cole,2016-10-27 11:20:13-04:00,"['ba526d9a2cfbb84ce03787fde5e3cf740950dc18', '91b7d221256943f0b000b31cab407557f15bc91c']",426,965,1391,23793079,48,,,,26438
097de987bcdd10276693ef7713607b7f2926d7a6,0,ababiichuk,2016-10-27 18:59:11+03:00,['91b7d221256943f0b000b31cab407557f15bc91c'],1,1,2,23793081,1,,,,26438
03014f0cd8ce5105386ef35dce6a19924cf94875,1,Alex Antonenko,2016-10-27 19:32:04+03:00,['097de987bcdd10276693ef7713607b7f2926d7a6'],515,422,937,23794018,28,1,1,1,26438
a936542398d8f2cc516560353609d13a4b8a8fd3,1,Dipayan Bhowmick,2016-10-27 22:32:51+05:18,['03014f0cd8ce5105386ef35dce6a19924cf94875'],1,17,18,23794036,1,1,1,1,26438
d1b0bb9ebf97313195d7e95ebb475bdc51534b8c,1,Dipayan Bhowmick,2016-10-28 00:22:29+05:18,['a936542398d8f2cc516560353609d13a4b8a8fd3'],1980,13407,15387,23809423,259,0.765773552,0.952751368,0.912129069,26609
d93b723ae65d5f6dedf41672a4301fe1a823cde0,0,Dipayan Bhowmick,2016-10-28 00:27:55+05:18,['d1b0bb9ebf97313195d7e95ebb475bdc51534b8c'],1,1,2,23809425,1,,,,26609
6c222a5272ccf3ccd5e57233d823c6b24635b039,1,Richard Zang,2016-10-27 16:12:08-07:00,['d93b723ae65d5f6dedf41672a4301fe1a823cde0'],8,45,53,23809478,10,1,1,1,26609
edc74e6f2a6375064c5a49bef709c24546f09932,0,Nahappan Somasundaram,2016-10-27 20:59:49-07:00,['6c222a5272ccf3ccd5e57233d823c6b24635b039'],0,160,160,23809638,9,0.484848485,1,1,26609
3617fd933466365766a305022aeabeab65167ddf,0,Swapan Shridhar,2016-10-28 02:19:23-07:00,['edc74e6f2a6375064c5a49bef709c24546f09932'],0,4,4,23809642,1,,,,26609
b334d307ee8c3a41247bded9943e23ab6cb8530f,0,Jonathan Hurley,2016-10-28 08:21:44-04:00,['3617fd933466365766a305022aeabeab65167ddf'],18,8,26,23809668,3,,,,26609
4d8c1957de2b98c34670b66b2f374563d70a37db,1,Tim Thorpe,2016-10-28 05:44:44-07:00,['b334d307ee8c3a41247bded9943e23ab6cb8530f'],0,67,67,23809735,2,0.192982456,0.947368421,0.947368421,26609
61074c32d63617f8abdabaae2d910c561fd37373,0,Andrew Onishuk,2016-10-28 16:02:34+03:00,['4d8c1957de2b98c34670b66b2f374563d70a37db'],0,9080,9080,23818815,8,,,,26617
86d494b0e49d9621d9e2bb6a1046c67321bd677a,0,Andrew Onishuk,2016-10-28 17:09:40+03:00,['61074c32d63617f8abdabaae2d910c561fd37373'],9080,0,9080,23827895,8,,,,26617
57037feff9be4fb94808e0f01235df6bdf4fbf4c,0,Sandor Magyari,2016-10-28 17:47:24+03:00,['86d494b0e49d9621d9e2bb6a1046c67321bd677a'],20,26,46,23827941,7,,,,26617
a6ef6810053bdf9cc282ec49a76b8277e73f7035,0,Andrew Onishuk,2016-10-28 17:53:16+03:00,['57037feff9be4fb94808e0f01235df6bdf4fbf4c'],3,11,14,23827955,2,1,1,1,26617
637441f4b3437efc9474c221aea946e2ab175a91,0,Sandor Magyari,2016-10-28 17:56:42+03:00,['a6ef6810053bdf9cc282ec49a76b8277e73f7035'],1,1,2,23827957,1,,,,26617
52cceb73782b020d8a7f27b34d16d963b6202b0e,1,Andrew Onishuk,2016-10-28 18:21:29+03:00,['637441f4b3437efc9474c221aea946e2ab175a91'],1,9081,9082,23837039,9,,,,26625
0a41c86b4853d737b613273493fe95b785870819,1,Jonathan Hurley,2016-10-28 13:21:15-04:00,['52cceb73782b020d8a7f27b34d16d963b6202b0e'],88,563,651,23837690,50,0.282051282,0.897435897,1,26629
99c8216635d018ce50b91af121e196fdbf5cf541,0,Nate Cole,2016-10-28 13:45:29-04:00,"['6088e4f1c96c27ada12e1645db828a234efbe876', '52cceb73782b020d8a7f27b34d16d963b6202b0e']",2549,23251,25800,23863490,334,,,,26629
8194cfe87f53c6288a4db9a4dc89cd51814c1b67,1,Dipayan Bhowmick,2016-10-29 01:24:57+05:18,['0a41c86b4853d737b613273493fe95b785870819'],3,2,5,23863495,2,1,0,0,26629
f50ff49d901b6dba80cb58403dc7b5cc0929652b,0,Jaimin Jetly,2016-10-28 14:37:49-07:00,['8194cfe87f53c6288a4db9a4dc89cd51814c1b67'],14,14,28,23863523,12,,,,26629
af497bddf61c9099cf9d45a4f9f608ae74924479,1,Aleksandr Kovalenko,2016-10-29 09:30:31+03:00,['f50ff49d901b6dba80cb58403dc7b5cc0929652b'],21,21,42,23863565,19,,,,26629
8d5e76fe84ffdc7eee43b6a9a08c984a8bcf4c5b,0,Jonathan Hurley,2016-10-29 09:50:15-04:00,['af497bddf61c9099cf9d45a4f9f608ae74924479'],1,1,2,23863567,1,,,,26629
40637b16746ea4e2eb772e909cee83989ec08d7e,0,Andrew Onishuk,2016-10-31 14:23:27+02:00,['8d5e76fe84ffdc7eee43b6a9a08c984a8bcf4c5b'],0,10,10,23863577,1,0,0,0,26629
59430dccc51490d0868b87f6cc63e970947e182a,0,Nahappan Somasundaram,2016-10-31 08:18:59-07:00,['40637b16746ea4e2eb772e909cee83989ec08d7e'],160,0,160,23863737,9,0.515151515,0,0,26629
edd558874488d64814cbda44c3d1c25fb02d467e,1,Jonathan Hurley,2016-10-31 11:24:01-04:00,['59430dccc51490d0868b87f6cc63e970947e182a'],37,35,72,23863809,2,1,1,0.5,26629
0dfc3377d24a0aeea7d54c5a56b27cdcdbf0d326,1,ababiichuk,2016-10-31 17:57:05+02:00,['edd558874488d64814cbda44c3d1c25fb02d467e'],112,92,204,23864013,6,0.888888889,1,1,26629
166e87816e20399df14b36bc5c250f74996cba23,1,Alex Antonenko,2016-10-31 21:27:43+02:00,['0dfc3377d24a0aeea7d54c5a56b27cdcdbf0d326'],3,4,7,23864020,2,0,1,0,26629
4ffc8ffb4b92f7c78ad4edf27636555fcd1db2be,1,Jaimin Jetly,2016-10-31 13:55:20-07:00,['166e87816e20399df14b36bc5c250f74996cba23'],19,572,591,23864611,11,0,0.337078652,0.853932584,26629
917e4b8456f7c849914d0412457be0c86d031841,1,Vitaly Brodetskyi,2016-11-01 01:23:36+02:00,['754186f9ba4b3da0db14cace1e765707b6ceab64'],1,3,4,23864615,1,,,,26629
334d4ccd3d54035b5bc6bfc23ab4548366f37c0d,1,Xi Wang,2016-10-31 16:50:21-07:00,['4ffc8ffb4b92f7c78ad4edf27636555fcd1db2be'],1536,1660,3196,23867811,64,,,,26629
754186f9ba4b3da0db14cace1e765707b6ceab64,0,Andrii Tkach,2016-11-01 13:22:15+02:00,['334d4ccd3d54035b5bc6bfc23ab4548366f37c0d'],3,10,13,23867824,4,0.142857143,1,1,26629
2f57937ab43c564c5f1e0cc68fcb0373982f702f,0,Tim Thorpe,2016-11-01 05:37:52-07:00,['754186f9ba4b3da0db14cace1e765707b6ceab64'],0,0,0,23867824,1,,,,26630
99208e865b8596cbdb653b4979e068a0cdcd3da4,0,Tim Thorpe,2016-11-01 05:38:50-07:00,"['2f57937ab43c564c5f1e0cc68fcb0373982f702f', '917e4b8456f7c849914d0412457be0c86d031841']",1,3,4,23867828,1,,,,26630
4697e4709bab87e5631e1d5db65720cec01e455f,0,Andrii Tkach,2016-11-01 15:04:08+02:00,['99208e865b8596cbdb653b4979e068a0cdcd3da4'],4,4,8,23867836,3,,,,26630
b89b9e1540b0ec539f62ee00d8bf82f1184f8af4,1,Vitaly Brodetskyi,2016-11-01 01:54:00+02:00,['4697e4709bab87e5631e1d5db65720cec01e455f'],4,10,14,23867850,2,0,1,1,26630
1b46747d433672c1dc15e79548bbec76f1f0ad78,0,Nate Cole,2016-11-01 09:55:29-04:00,"['99c8216635d018ce50b91af121e196fdbf5cf541', 'b89b9e1540b0ec539f62ee00d8bf82f1184f8af4']",1926,2921,4847,23872697,184,,,,26630
c0c02d05ff184f89df8e152a63689318160efb18,1,Nahappan Somasundaram,2016-11-01 09:24:10-07:00,['b89b9e1540b0ec539f62ee00d8bf82f1184f8af4'],1,224,225,23872922,11,0.428571429,1,1,26630
38cbda8826c126ca50aff6928c437d59b0168c7d,0,Robert Levas,2016-11-01 12:36:02-04:00,['c0c02d05ff184f89df8e152a63689318160efb18'],1,1,2,23872924,1,,,,26630
c143be331f670da3aef2451ed6d3fe1b41c6d8c4,1,Dmytro Sen,2016-11-01 19:26:05+02:00,['38cbda8826c126ca50aff6928c437d59b0168c7d'],4,8,12,23872936,1,0.5,0.5,0.5,26630
cc14719c774097af24faa559000fb3b714266802,1,Jayush Luniya,2016-11-01 10:49:18-07:00,['c143be331f670da3aef2451ed6d3fe1b41c6d8c4'],1,1,2,23872938,1,,,,26630
0d90ba353d5df972ffddbc37b01ab350f1844c06,0,Nate Cole,2016-11-01 16:09:45-04:00,"['1b46747d433672c1dc15e79548bbec76f1f0ad78', 'cc14719c774097af24faa559000fb3b714266802']",7,234,241,23873179,13,,,,26630
9eed34e7b107aa24f7540f480426b72d528b0b6b,0,Nate Cole,2016-11-01 16:11:13-04:00,"['cc14719c774097af24faa559000fb3b714266802', '0d90ba353d5df972ffddbc37b01ab350f1844c06']",2,780,782,23873961,7,,,,26630
2a983d4e9da2472d47a6e52f391471c55bcf43d6,0,Nate Cole,2016-11-01 17:01:14-04:00,['9eed34e7b107aa24f7540f480426b72d528b0b6b'],2,2,4,23873965,1,,,,26630
464d3d5cecc3745155397e5c33a0a7cea7e44862,0,ababiichuk,2016-11-01 23:54:49+02:00,['2a983d4e9da2472d47a6e52f391471c55bcf43d6'],122,101,223,23874188,20,1,1,1,26630
43d4857155f59e30c967b96dcd91b0224c2f214b,0,Zhe (Joe) Wang,2016-11-01 17:38:50-07:00,['464d3d5cecc3745155397e5c33a0a7cea7e44862'],1,2,3,23874191,1,1,1,1,26630
72893f8435f97c5aa213a323b4674a0291918179,1,pallavkul,2016-11-02 10:37:34+05:18,['43d4857155f59e30c967b96dcd91b0224c2f214b'],55,172,227,23874418,16,0.873684211,1,1,26630
e7a27983b3c1365b72846cc2a26dda75aed34762,0,ababiichuk,2016-11-02 12:49:58+02:00,['72893f8435f97c5aa213a323b4674a0291918179'],0,4,4,23874422,1,1,1,1,26630
d2cc32e88d5519528b798d6037c1ca98ba4bd4ba,0,Dmytro Sen,2016-11-02 14:54:39+02:00,['e7a27983b3c1365b72846cc2a26dda75aed34762'],855,577,1432,23875854,15,0.961389961,0,0,26631
512905dc80170aa8d4b89d36c7d37dabed42a037,0,Oleg Nechiporenko,2016-11-02 15:15:01+02:00,['d2cc32e88d5519528b798d6037c1ca98ba4bd4ba'],1,3,4,23875858,1,1,1,1,26631
8d6924df2c59307da9e395b03a984c26a1e813d5,1,Andrii Tkach,2016-11-02 17:17:50+02:00,['512905dc80170aa8d4b89d36c7d37dabed42a037'],76,151,227,23876085,8,1,0.606060606,1,26631
3b2e103b7e36af9acd91fe3f6f057fb2163f7ef7,1,Robert Levas,2016-11-02 12:16:44-04:00,['8d6924df2c59307da9e395b03a984c26a1e813d5'],110,106,216,23876301,4,0,0,0,26631
d48b4639aa6a484353e01b43797c7e304c36857d,1,Di Li,2016-11-02 12:31:00-04:00,['3b2e103b7e36af9acd91fe3f6f057fb2163f7ef7'],1,2,3,23876304,1,,,,26631
e9b251210d2e3fb4265413229bc2dcd793f5bc3e,1,Dipayan Bhowmick,2016-11-03 00:11:43+05:18,['d48b4639aa6a484353e01b43797c7e304c36857d'],41,409,450,23876754,18,0.752688172,0.967741935,0.951612903,26633
a8727af88fd5f6ba5d889854589093e19efdf27a,1,Dipayan Bhowmick,2016-11-03 00:25:53+05:18,['e9b251210d2e3fb4265413229bc2dcd793f5bc3e'],1,12,13,23876767,2,1,1,1,26633
33a4119539107b781270a4347a5364e0f40652d7,1,Nahappan Somasundaram,2016-11-02 12:18:57-07:00,['a8727af88fd5f6ba5d889854589093e19efdf27a'],19,710,729,23877496,12,0.25,0.890957447,0.92287234,26634
cfe738d4bfeeb7a34681691b3f4ba13a4e29aa97,1,Jonathan Hurley,2016-11-02 15:25:41-04:00,['464d3d5cecc3745155397e5c33a0a7cea7e44862'],250,862,1112,23878608,11,0.400900901,0.599099099,1,26636
c9362c897e87c79aaba9f171717fe6a2dd63f4cc,1,Richard Zang,2016-11-02 12:55:27-07:00,['33a4119539107b781270a4347a5364e0f40652d7'],102,427,529,23879137,22,1,1,1,26642
fca6f1c3a56aa13c7fda385cba5fdae59dc990ed,1,Alejandro Fernandez,2016-11-02 14:52:26-07:00,['c9362c897e87c79aaba9f171717fe6a2dd63f4cc'],0,848,848,23879985,22,1,1,1,26664
4e96cf51c5a796c7efc8415c7106ca5d071678a2,1,Alejandro Fernandez,2016-11-02 14:59:39-07:00,['fca6f1c3a56aa13c7fda385cba5fdae59dc990ed'],41,116,157,23880142,11,0,0.684210526,0.631578947,26664
7f931ba896d7a1cfdc8c6d3e58b5e7db3241028e,1,Xi Wang,2016-11-02 14:48:15-07:00,['4e96cf51c5a796c7efc8415c7106ca5d071678a2'],5,12,17,23880159,1,,,,26664
780bf944aa02ef2c075ddcd3215ff9fb81ee025d,1,Zhe (Joe) Wang,2016-11-02 15:21:30-07:00,['7f931ba896d7a1cfdc8c6d3e58b5e7db3241028e'],9,1,10,23880169,1,,,,26664
950d1db879b203a9d8090f414cc75fb54a5deb55,1,Zhe (Joe) Wang,2016-11-02 15:28:39-07:00,['780bf944aa02ef2c075ddcd3215ff9fb81ee025d'],10,12,22,23880191,6,0,1,1,26664
47b926fae8206a76725304c5e4d19201869fdf9a,1,Richard Zang,2016-11-02 15:39:46-07:00,['950d1db879b203a9d8090f414cc75fb54a5deb55'],4,3,7,23880198,2,0,0.6,1,26664
94573ad709ffe62a3df2a2198edc2984eedd8442,1,Jaimin Jetly,2016-11-02 20:41:21-07:00,['47b926fae8206a76725304c5e4d19201869fdf9a'],8,4,12,23880210,2,0,0,0,26664
e5a6ee8add09a57320b6b419a706e51ea9a45332,1,Andrew Onishuk,2016-11-03 10:49:19+02:00,['94573ad709ffe62a3df2a2198edc2984eedd8442'],172,84,256,23880466,9,0,0.189189189,0,26664
f1117c25dcfe1e55e935cf641c1399b12e5846bc,0,Nitiraj Rathore,2016-11-03 15:10:54+05:18,['e5a6ee8add09a57320b6b419a706e51ea9a45332'],1,11,12,23880478,1,1,1,0,26664
be6b6b872861ee4b1daa8f755f175996c95334f5,1,"Toader, Sebastian",2016-11-03 11:55:03+01:00,['f1117c25dcfe1e55e935cf641c1399b12e5846bc'],5,23,28,23880506,2,0.352941176,0.941176471,0.941176471,26664
41442ce794a8199e58e68a97c89b619ef179fe80,1,Vitaly Brodetskyi,2016-11-03 00:23:47+02:00,['be6b6b872861ee4b1daa8f755f175996c95334f5'],6,17,23,23880529,4,0,0,0.777777778,26664
753b8d5a0fe4866cc3350fdcfdf9509a5a3fbf59,1,ababiichuk,2016-11-03 15:11:57+02:00,['41442ce794a8199e58e68a97c89b619ef179fe80'],45,94,139,23880668,4,0,1,0,26664
e719ea44d190cba118934e8f993cff8a8b8119cb,1,Oleg Nechiporenko,2016-11-03 15:43:10+02:00,['753b8d5a0fe4866cc3350fdcfdf9509a5a3fbf59'],87,153,240,23880908,18,0,0,0,26665
43a181ab35fb9f414b5b148aadf43b7199329953,0,Lisnichenko Dmitro,2016-11-03 16:29:48+02:00,['e719ea44d190cba118934e8f993cff8a8b8119cb'],6347,1,6348,23887256,7,,,,26665
f9814d2bfb4c77740da38223305c4c570dba8221,0,Nate Cole,2016-11-03 11:25:51-04:00,"['cfe738d4bfeeb7a34681691b3f4ba13a4e29aa97', '43a181ab35fb9f414b5b148aadf43b7199329953']",8002,3954,11956,23899212,182,,,,26665
ba5cbf428194733b93ff122dbe4b66706f75e676,1,Lisnichenko Dmitro,2016-11-03 17:32:52+02:00,['43a181ab35fb9f414b5b148aadf43b7199329953'],1,1,2,23899214,1,,,,26665
2ebc6ed957c468ef5b2e966094ad41b09ceb1fc5,0,Tim Thorpe,2016-11-03 09:40:42-07:00,['ba5cbf428194733b93ff122dbe4b66706f75e676'],3,45,48,23899262,6,0,1,1,26667
35cb39682551f05d100fdf4975a61eaf5cc58340,1,ababiichuk,2016-11-03 18:50:03+02:00,['2ebc6ed957c468ef5b2e966094ad41b09ceb1fc5'],4,8,12,23899274,3,0,1,1,26667
7394cef4bf0b949758d06470cefbf581a914967c,0,Jonathan Hurley,2016-11-03 13:14:30-04:00,['35cb39682551f05d100fdf4975a61eaf5cc58340'],2,2,4,23899278,1,,,,26667
574fd6435f1df87f632ea86287f26e8f1f7f1121,1,Di Li,2016-11-03 15:57:56-04:00,['7394cef4bf0b949758d06470cefbf581a914967c'],1,1,2,23899280,1,,,,26667
2da6fa789f6ac64c4e699469bde1185bb2ab126d,0,Jayush Luniya,2016-11-03 13:17:44-07:00,['574fd6435f1df87f632ea86287f26e8f1f7f1121'],29,67,96,23899376,5,0.162162162,1,1,26667
988140979d64b9a1d38fc266ca58e509b4cbcfa1,0,Nahappan Somasundaram,2016-11-03 15:37:36-07:00,['2da6fa789f6ac64c4e699469bde1185bb2ab126d'],1,82,83,23899459,5,0.882352941,0.941176471,1,26667
0c165e3368a9be1a4b023b129632bf4ba2b2b90e,1,Aleksandr Kovalenko,2016-11-04 01:13:09+02:00,['988140979d64b9a1d38fc266ca58e509b4cbcfa1'],37,92,129,23899588,5,1,1,1,26668
d348b65e023d17589767c7a2c45700bf4ad674ed,1,Oleg Nechiporenko,2016-11-04 12:01:28+02:00,['0c165e3368a9be1a4b023b129632bf4ba2b2b90e'],25,48,73,23899661,7,1,0,0,26668
0bdaff8022f368a9f993142db84ee932767ae23f,1,Dipayan Bhowmick,2016-11-04 17:13:47+05:18,['d348b65e023d17589767c7a2c45700bf4ad674ed'],20,179,199,23899860,7,0.075,0.3375,0.975,26669
1f4221cf71e2a2c216ad1017fd5d6a28d99dbc6a,0,Nate Cole,2016-11-04 09:26:37-04:00,"['f9814d2bfb4c77740da38223305c4c570dba8221', '0bdaff8022f368a9f993142db84ee932767ae23f']",123,525,648,23900508,41,,,,26669
343b4d8fec60d678349d9f1f68403d5063724ae6,1,Nate Cole,2016-11-04 09:32:47-04:00,['1f4221cf71e2a2c216ad1017fd5d6a28d99dbc6a'],39,307,346,23900854,8,0.131868132,0.263736264,1,26669
9cc1152f4864668d1192362e6187ec94d9f457c9,0,Nate Cole,2016-11-04 09:36:59-04:00,"['0bdaff8022f368a9f993142db84ee932767ae23f', '1f4221cf71e2a2c216ad1017fd5d6a28d99dbc6a']",250,862,1112,23901966,11,,,,26669
53a9250b7f246c152a17cf63f60587eeb6fe5852,0,Nate Cole,2016-11-04 09:39:57-04:00,"['9cc1152f4864668d1192362e6187ec94d9f457c9', '343b4d8fec60d678349d9f1f68403d5063724ae6']",39,307,346,23902312,8,,,,26669
1cba2f95cfefa924295862eae3e3037810e7012e,1,Oleg Nechiporenko,2016-11-04 16:04:06+02:00,['53a9250b7f246c152a17cf63f60587eeb6fe5852'],333,254,587,23902899,7,,,,26669
e6444733d11d18761f30003110dec8886654d279,1,Aleksandr Kovalenko,2016-11-04 17:32:21+02:00,['1cba2f95cfefa924295862eae3e3037810e7012e'],9,16,25,23902924,2,1,1,1,26669
2c9f0625718ad40361693bc377683af52c93feb0,1,Andrii Tkach,2016-11-04 18:31:15+02:00,['e6444733d11d18761f30003110dec8886654d279'],13,16,29,23902953,7,,,,26669
10cea2c7960beb8b7e92e288c5594eea7d4485bc,0,Nate Cole,2016-11-04 12:54:18-04:00,"['8985231131061178103423c980c29caee45960c4', '2c9f0625718ad40361693bc377683af52c93feb0']",10906,41646,52552,23955505,985,,,,26669
0272e8a43b2d9e2ff37697d379a0f7ad15679cff,1,ababiichuk,2016-11-04 18:56:55+02:00,['2c9f0625718ad40361693bc377683af52c93feb0'],494,476,970,23956475,28,1,1,0.444444444,26672
c4f6d464fe45944acaa025fba2a037214b8b205d,0,Nahappan Somasundaram,2016-11-04 10:56:35-07:00,['0272e8a43b2d9e2ff37697d379a0f7ad15679cff'],0,73,73,23956548,4,0.285714286,0.914285714,0.914285714,26672
a396b7c0c8f4fe27d757e5785010bf3ba21a4ced,1,Jonathan Hurley,2016-11-04 14:45:15-04:00,['343b4d8fec60d678349d9f1f68403d5063724ae6'],113,389,502,23957050,7,0,1,0.15625,26672
f29ab2bdf4b33702316018692179572d7fd1a077,0,Zhe (Joe) Wang,2016-11-04 13:51:49-07:00,['c4f6d464fe45944acaa025fba2a037214b8b205d'],0,1,1,23957051,1,1,1,1,26672
556b285e591211a2abf8a90830ee9d8bffc79562,0,Zhe (Joe) Wang,2016-11-04 13:56:49-07:00,['f29ab2bdf4b33702316018692179572d7fd1a077'],20,31,51,23957102,2,0,0,0,26672
d39abe619e9cfcdeecc59b6c0b1905d1e2c306e1,1,Richard Zang,2016-11-04 15:01:18-07:00,['556b285e591211a2abf8a90830ee9d8bffc79562'],14,8,22,23957124,2,1,0.363636364,0.045454545,26672
b5616fce0f00d3053ece9ddb636b97f01fa2e663,1,oleewere,2016-11-05 16:05:09+01:00,['d39abe619e9cfcdeecc59b6c0b1905d1e2c306e1'],1,658,659,23957783,10,0.364444444,1,0.924444444,26680
29f0a8e1112f5b41cb25e418e2710a1d2a2781d9,1,oleewere,2016-11-05 16:05:10+01:00,['b5616fce0f00d3053ece9ddb636b97f01fa2e663'],21,705,726,23958509,18,1,1,1,26681
90e792ef79e753e33cff9524add591fd01787339,1,oleewere,2016-11-05 16:05:10+01:00,['29f0a8e1112f5b41cb25e418e2710a1d2a2781d9'],410,736,1146,23959655,6,0.285714286,0.235714286,1,26681
ad2fad85a50fd5a8bcc05b16d0047d298dc9ea5b,1,oleewere,2016-11-05 16:05:10+01:00,['90e792ef79e753e33cff9524add591fd01787339'],3,3,6,23959661,2,,,,26681
99ad09450c2c95f4065d1d940f5848e2779de7d5,1,oleewere,2016-11-05 16:05:10+01:00,['ad2fad85a50fd5a8bcc05b16d0047d298dc9ea5b'],6,6,12,23959673,4,,,,26681
b40558310411e08bc9e88427256f8d1d6fef5a13,1,oleewere,2016-11-05 16:05:10+01:00,['99ad09450c2c95f4065d1d940f5848e2779de7d5'],185,117,302,23959975,6,0.096774194,0,0,26682
370a3e9dc5f999c048cc1609a3937b16ffbbf73e,1,oleewere,2016-11-05 16:05:11+01:00,['b40558310411e08bc9e88427256f8d1d6fef5a13'],326,290,616,23960591,45,0,0,0,26682
20ca45ae8d8680385e1eef2ad691175b7953ca73,1,oleewere,2016-11-05 16:05:11+01:00,['370a3e9dc5f999c048cc1609a3937b16ffbbf73e'],1,1,2,23960593,1,,,,26682
7bd6bc72cab3522d8d14bb434ad6a0da29c1b79a,1,oleewere,2016-11-05 16:05:11+01:00,['20ca45ae8d8680385e1eef2ad691175b7953ca73'],1,1,2,23960595,1,,,,26682
3fd1742b5d2e4ee901a210ff8b7ea1f0c5c5dc27,1,oleewere,2016-11-05 16:05:11+01:00,['7bd6bc72cab3522d8d14bb434ad6a0da29c1b79a'],123,87,210,23960805,17,0.870967742,0.870967742,0.209677419,26682
0f5803dac721f427abf9791d342240e7a6ce958b,1,oleewere,2016-11-05 16:05:11+01:00,['3fd1742b5d2e4ee901a210ff8b7ea1f0c5c5dc27'],98,243,341,23961146,11,0.268041237,0.443298969,0,26682
5abf203eb9c9bb61aa003bdaff03ad7f6d7fa40b,1,oleewere,2016-11-05 16:05:11+01:00,['0f5803dac721f427abf9791d342240e7a6ce958b'],2784,1879,4663,23965809,55,0.812589413,0.799713877,0.39055794,26692
c187d3951df047b4e88f58239b9ec730f8f94e94,1,oleewere,2016-11-05 16:05:12+01:00,['5abf203eb9c9bb61aa003bdaff03ad7f6d7fa40b'],77,92,169,23965978,47,,,,26692
3059fad3983b42fccb5f8344548f781f8172363f,1,oleewere,2016-11-05 16:05:12+01:00,['c187d3951df047b4e88f58239b9ec730f8f94e94'],172,85,257,23966235,3,0.722222222,0.244444444,0.155555556,26692
c5960279d2cf3fcb43578bc6c63ba06faac5fa2f,1,oleewere,2016-11-05 16:05:12+01:00,['3059fad3983b42fccb5f8344548f781f8172363f'],67,246,313,23966548,32,0,0,0.9375,26696
dfeea2de13aaa988337ec6fe666f9a277ba61f97,1,oleewere,2016-11-05 16:05:13+01:00,['c5960279d2cf3fcb43578bc6c63ba06faac5fa2f'],759,554,1313,23967861,43,1,1,0.25,26696
35a8c0e77ff5a6317e8eb11bf3dad4d0cb2f1498,1,oleewere,2016-11-05 16:05:13+01:00,['dfeea2de13aaa988337ec6fe666f9a277ba61f97'],76,76,152,23968013,1,,,,26696
cc429d48d9fde589266e462d37bdb9b6969308a0,1,oleewere,2016-11-05 16:05:13+01:00,['35a8c0e77ff5a6317e8eb11bf3dad4d0cb2f1498'],35573,8111,43684,24011697,192,0.575013219,0.504013844,0.156996587,26814
276cd5b0239c94cef0dff9fa46d0935376d33b6b,1,oleewere,2016-11-05 16:05:13+01:00,['cc429d48d9fde589266e462d37bdb9b6969308a0'],199,120,319,24012016,10,0,1,1,26814
51fdb2de5aad4c61593796a4edcdc4eda762289a,1,oleewere,2016-11-05 16:05:14+01:00,['276cd5b0239c94cef0dff9fa46d0935376d33b6b'],3655,3028,6683,24018699,81,1,1,0.079831933,26822
cbfa083d811452f385f2a9ea55e8aae967126f22,1,oleewere,2016-11-05 16:08:53+01:00,['51fdb2de5aad4c61593796a4edcdc4eda762289a'],1138,1392,2530,24021229,89,1,1,1,26832
61a3da6a4ee3e68ee95bbd20e2cb401da0780b9a,0,oleewere,2016-11-05 16:08:53+01:00,['cbfa083d811452f385f2a9ea55e8aae967126f22'],6,6,12,24021241,2,,,,26832
c15ed8b77f16736eb4748561ec9ccba024b3671c,1,oleewere,2016-11-05 16:08:54+01:00,['61a3da6a4ee3e68ee95bbd20e2cb401da0780b9a'],4824,2438,7262,24028503,104,0.639018692,0.162383178,0,26837
1a225bd2f2f578d7bc26b196f46c0fcd01002655,1,oleewere,2016-11-05 16:08:54+01:00,['c15ed8b77f16736eb4748561ec9ccba024b3671c'],6670,4503,11173,24039676,166,0.92542724,0.930088037,0.309684102,26882
ad5159014a3f30d931a5c67f3b1766dd71cc4002,1,oleewere,2016-11-05 16:08:54+01:00,['1a225bd2f2f578d7bc26b196f46c0fcd01002655'],1,9,10,24039686,2,,,,26882
8a1305325fe474ab7ee8e411440eef79031806aa,1,oleewere,2016-11-05 16:08:54+01:00,['ad5159014a3f30d931a5c67f3b1766dd71cc4002'],33,339,372,24040058,8,0.483870968,1,1,26882
762abbce729243856116e7a76332c7d4189fdbe4,1,oleewere,2016-11-05 16:08:55+01:00,['8a1305325fe474ab7ee8e411440eef79031806aa'],14,53,67,24040125,4,0.857142857,1,1,26882
fb70f1b93a7237f7d1e1a7889552fe9428fa0c7d,1,oleewere,2016-11-05 16:08:55+01:00,['762abbce729243856116e7a76332c7d4189fdbe4'],223,1256,1479,24041604,28,1,1,1,26890
f926bf31811d47390375def8e731660c40753c95,1,oleewere,2016-11-05 16:08:55+01:00,['fb70f1b93a7237f7d1e1a7889552fe9428fa0c7d'],14,18,32,24041636,6,1,1,1,26890
e124c6737b9907bf3a19a82f19d94b8799c9c63e,1,oleewere,2016-11-05 16:08:55+01:00,['f926bf31811d47390375def8e731660c40753c95'],26,39,65,24041701,12,0,1,1,26890
576940306a2453ca21a50afec8330ccf42ab8ca1,0,oleewere,2016-11-05 16:08:56+01:00,['e124c6737b9907bf3a19a82f19d94b8799c9c63e'],4,84,88,24041789,9,,,,26891
aaf802b3dd50b49554085c9b39f89f690fe68f4b,1,oleewere,2016-11-05 16:08:56+01:00,['576940306a2453ca21a50afec8330ccf42ab8ca1'],43,40,83,24041872,4,0,1,0,26891
98da69f4498cd7f9c0f80f637bf33f8d5bcfe087,1,oleewere,2016-11-05 16:08:56+01:00,['aaf802b3dd50b49554085c9b39f89f690fe68f4b'],170,1458,1628,24043500,28,1,0.055555556,1,26895
cf619372dc321026705b56a5be39325367042c83,1,oleewere,2016-11-05 16:08:56+01:00,['98da69f4498cd7f9c0f80f637bf33f8d5bcfe087'],149,175,324,24043824,6,1,1,1,26896
e734a7bf0989ef621065ef4ab83be1b3366c86bd,1,oleewere,2016-11-05 16:08:57+01:00,['cf619372dc321026705b56a5be39325367042c83'],2056,2313,4369,24048193,68,0.642857143,0.714285714,1,26919
3bb4ec107054aefecc7471d87521bb8efdd923a7,1,oleewere,2016-11-05 16:08:57+01:00,['e734a7bf0989ef621065ef4ab83be1b3366c86bd'],237,272,509,24048702,31,1,1,0,26919
520b34f2bcd6280544d5e71656242f6c8f0952f9,0,Yusaku Sako,2016-11-06 06:44:26-08:00,['3bb4ec107054aefecc7471d87521bb8efdd923a7'],0,12,12,24048714,1,,,,26919
cfe0fc70db8ef33c2b34bda01fe2240140870233,1,Lisnichenko Dmitro,2016-11-07 12:01:06+02:00,['520b34f2bcd6280544d5e71656242f6c8f0952f9'],9,9,18,24048732,1,1,0,0,26919
69c9690b86df5fff23a9d6f4f057f8f37b43bfe1,0,Andrew Onishuk,2016-11-07 14:01:47+02:00,['cfe0fc70db8ef33c2b34bda01fe2240140870233'],3,2,5,24048737,1,1,1,0,26919
02e2c483ea196adfc235f66a27b8be0b355240ed,1,Oleg Nechiporenko,2016-11-07 14:10:04+02:00,['69c9690b86df5fff23a9d6f4f057f8f37b43bfe1'],79,107,186,24048923,8,,,,26919
4024e1389064bc210e97f46285dd0a572bda2527,0,Jonathan Hurley,2016-11-07 07:51:55-05:00,"['a396b7c0c8f4fe27d757e5785010bf3ba21a4ced', '02e2c483ea196adfc235f66a27b8be0b355240ed']",54035,25354,79389,24128312,559,,,,26919
b5378332b5c3e836e9c4e54fe73884d61cd8c1b6,1,Nitiraj Rathore,2016-11-07 20:08:07+05:18,['02e2c483ea196adfc235f66a27b8be0b355240ed'],10,60,70,24128382,6,1,1,1,26919
5da18ae7896edfbcdabd6c140199e1139d414048,1,Nitiraj Rathore,2016-11-07 20:39:17+05:18,['b5378332b5c3e836e9c4e54fe73884d61cd8c1b6'],4,44,48,24128430,2,0.857142857,1,0.857142857,26919
f87ec899c3f7f55f6d4f133b2034ca125eec4b97,0,Aleksandr Kovalenko,2016-11-07 17:52:33+02:00,['5da18ae7896edfbcdabd6c140199e1139d414048'],0,3,3,24128433,1,0,1,1,26919
d99df76a8731662f89eb1668cf9144b9317cfd4a,1,"Toader, Sebastian",2016-11-07 17:02:37+01:00,['f87ec899c3f7f55f6d4f133b2034ca125eec4b97'],7,14,21,24128454,4,0.5,1,1,26919
a17c3ed2f285df3c974c6fc5002e5ad728e45a56,1,Robert Levas,2016-11-07 12:35:42-05:00,['d99df76a8731662f89eb1668cf9144b9317cfd4a'],11,15,26,24128480,2,0,0,1,26919
5494b6a82e36401d271fb2339101b7b5c46cb488,1,Zhe (Joe) Wang,2016-11-07 10:34:51-08:00,['a17c3ed2f285df3c974c6fc5002e5ad728e45a56'],2,3,5,24128485,1,1,1,1,26919
2f221bd784fee6f90e297b300a7e67900a20d915,0,Siddharth Wagle,2016-11-07 10:39:18-08:00,['5494b6a82e36401d271fb2339101b7b5c46cb488'],2,0,2,24128487,1,,,,26919
8f20af2867f39a9fd4943f98e5d62e17083732af,1,Siddharth Wagle,2016-11-07 10:58:36-08:00,['2f221bd784fee6f90e297b300a7e67900a20d915'],12,37,49,24128536,2,0.095238095,0,0.095238095,26919
4066b7ef524e8dd7dad03b510e0b4792695c2598,1,Bob Nettleton,2016-11-07 14:31:42-05:00,['8f20af2867f39a9fd4943f98e5d62e17083732af'],26,307,333,24128869,2,0.044585987,1,0.917197452,26919
83f54c2b9825ef0182328515878aceb98dfc10fc,0,Nate Cole,2016-11-07 15:50:49-05:00,"['10cea2c7960beb8b7e92e288c5594eea7d4485bc', '4066b7ef524e8dd7dad03b510e0b4792695c2598']",53863,25660,79523,24208392,572,,,,26919
8ac9fa10cf09b4d49efef7b4a9d6a244e86e9244,1,Matt,2016-11-07 13:27:41-08:00,['4066b7ef524e8dd7dad03b510e0b4792695c2598'],650,1598,2248,24210640,41,0.461126005,1,0.932975871,26927
922f87ab2d683d888564e68b1ee817e70aaeb4f3,1,Matt,2016-11-07 13:48:13-08:00,['8ac9fa10cf09b4d49efef7b4a9d6a244e86e9244'],2,2,4,24210644,1,,,,26927
3ec7df13485b629bcf08310f3916b6401f827dbe,0,Alejandro Fernandez,2016-11-07 14:04:11-08:00,['922f87ab2d683d888564e68b1ee817e70aaeb4f3'],0,31,31,24210675,2,0.875,0.875,1,26927
ffad4a36f1e8f9e43e28c92767acea88b3a926cc,1,Sumit Mohanty,2016-11-07 16:49:26-08:00,['3ec7df13485b629bcf08310f3916b6401f827dbe'],2,134,136,24210811,2,,,,26928
e158756e1c778a99e6f016fbd8bdcd7ce1033dec,1,Andrew Onishuk,2016-11-08 11:32:46+02:00,['ffad4a36f1e8f9e43e28c92767acea88b3a926cc'],84,175,259,24211070,9,1,0.825,1,26929
79de029b544f0f6aa7439b65c120b62da7053a5d,1,Andrii Tkach,2016-11-08 13:19:30+02:00,['e158756e1c778a99e6f016fbd8bdcd7ce1033dec'],26,63,89,24211159,4,1,1,1,26929
352fe85181d81cf23f82953f05bc66a7c88d639b,1,Di Li,2016-11-08 11:05:26-05:00,['79de029b544f0f6aa7439b65c120b62da7053a5d'],11,28,39,24211198,3,0.941176471,1,0.941176471,26929
12a6036ac21a539f18af48b7e4f000782ab7a54a,1,Nahappan Somasundaram,2016-11-08 10:18:31-08:00,['352fe85181d81cf23f82953f05bc66a7c88d639b'],2,22,24,24211222,5,,,,26929
8281cc140b50445c596d48e39edd8d759e4677ac,1,Richard Zang,2016-11-08 11:35:36-08:00,['12a6036ac21a539f18af48b7e4f000782ab7a54a'],7,30,37,24211259,6,0,0.368421053,1,26929
bc9f89eac29385b57099f03c50b757dcebd55d55,1,Vitaly Brodetskyi,2016-11-08 05:56:22+02:00,['8281cc140b50445c596d48e39edd8d759e4677ac'],6,9,15,24211274,2,0,1,1,26929
fa7704dfafa689250489fa8174103a904052457c,1,Alejandro Fernandez,2016-11-08 11:47:22-08:00,['bc9f89eac29385b57099f03c50b757dcebd55d55'],0,372,372,24211646,1,0.243243243,0.432432432,0.824324324,26930
3ce19737cdbc07428fbf33bbf3e48ea2579bbb7b,0,Nate Cole,2016-11-08 15:23:27-05:00,"['4024e1389064bc210e97f46285dd0a572bda2527', 'fa7704dfafa689250489fa8174103a904052457c']",861,2944,3805,24215451,96,,,,26930
46891797c648639447d5a5404deb999e3cebf996,0,Nate Cole,2016-11-08 15:26:16-05:00,['3ce19737cdbc07428fbf33bbf3e48ea2579bbb7b'],1,18,19,24215470,2,0,0,1,26930
d838763dcca7c5b3b65134dcbe6a0a8944020ace,0,Nate Cole,2016-11-08 15:35:04-05:00,"['fa7704dfafa689250489fa8174103a904052457c', '46891797c648639447d5a5404deb999e3cebf996']",114,407,521,24215991,9,,,,26930
eca41fad13dd0c5870c7467108f37090eec6598b,1,Jaimin Jetly,2016-11-08 13:45:53-08:00,['d838763dcca7c5b3b65134dcbe6a0a8944020ace'],9,31,40,24216031,3,1,1,1,26930
16060169d682d96fea3f32417b95bb82f0ba96ce,0,Jonathan Hurley,2016-11-08 17:29:57-05:00,['eca41fad13dd0c5870c7467108f37090eec6598b'],18,17,35,24216066,2,,,,26930
cea8602ad55b35579f6456272d4527d2cc4e581a,0,Jaimin Jetly,2016-11-08 14:45:34-08:00,['16060169d682d96fea3f32417b95bb82f0ba96ce'],5,27,32,24216098,3,1,1,1,26930
dbeb78d5d54f11e0277948f80279eeba5cc13f5a,0,Matt,2016-11-08 15:27:52-08:00,['cea8602ad55b35579f6456272d4527d2cc4e581a'],1,2,3,24216101,2,1,1,1,26930
a2d53ef06f07d680f3db9f3b0b8e86a8cbc71eae,1,Oleg Nechiporenko,2016-11-09 10:10:19+02:00,['dbeb78d5d54f11e0277948f80279eeba5cc13f5a'],113,135,248,24216349,4,,,,26930
ac7ff8bab30a0a694c277f55186713fe5ff7bcb4,1,Oleg Nechiporenko,2016-11-09 12:03:03+02:00,['a2d53ef06f07d680f3db9f3b0b8e86a8cbc71eae'],756,600,1356,24217705,19,0,0,0.075757576,26930
bfc33681e6d501272f1f5ebfee12589439641ab8,0,Alex Antonenko,2016-11-09 13:18:36+02:00,['ac7ff8bab30a0a694c277f55186713fe5ff7bcb4'],0,18,18,24217723,1,,,,26930
99f695616683b466f94ce42bce105834ac2a3ead,1,Andrew Onishuk,2016-11-09 14:25:38+02:00,['bfc33681e6d501272f1f5ebfee12589439641ab8'],31,75,106,24217829,4,0.818181818,0.045454545,1,26930
3bf40d0d4693ece985cbe050c3027e9272998c7c,1,Robert Levas,2016-11-09 15:00:16-05:00,['99f695616683b466f94ce42bce105834ac2a3ead'],4,65,69,24217898,5,0,0.851851852,1,26930
f33dd9e3821facb4094966d15c6c8549d5ec95a3,0,Matt,2016-11-09 13:01:11-08:00,['3bf40d0d4693ece985cbe050c3027e9272998c7c'],0,10,10,24217908,2,0,1,0,26930
5fc8a0e89b3e668950431412aa0afe4cd93f27b1,1,Jonathan Hurley,2016-11-09 16:05:53-05:00,['46891797c648639447d5a5404deb999e3cebf996'],96,79,175,24218083,28,1,1,0.466666667,26930
2a0c9414b4c1a6244ff3af29227072b6c9d6f43e,1,Sumit Mohanty,2016-11-09 13:09:18-08:00,['f33dd9e3821facb4094966d15c6c8549d5ec95a3'],36,164,200,24218283,5,0,0.495495495,0.531531532,26930
4c9aabc303232e50fddd7d47b6dfd0769f8a68ea,0,Jonathan Hurley,2016-11-09 16:49:22-05:00,"['5fc8a0e89b3e668950431412aa0afe4cd93f27b1', '2a0c9414b4c1a6244ff3af29227072b6c9d6f43e']",973,1144,2117,24220400,47,,,,26930
f052c2ab894219c36f28013590f4a01a2a1d84c0,0,Jonathan Hurley,2016-11-09 16:54:30-05:00,"['2a0c9414b4c1a6244ff3af29227072b6c9d6f43e', '4c9aabc303232e50fddd7d47b6dfd0769f8a68ea']",96,79,175,24220575,28,,,,26930
620329c5b272a17bdeb4495f46834c903d0b23d3,0,Siddharth Wagle,2016-11-09 14:19:10-08:00,['f052c2ab894219c36f28013590f4a01a2a1d84c0'],3,8,11,24220586,1,0,1,1,26930
2e3a29ef5aa4f3c74f358fe03ce9a12d83bd0c30,0,Xi Wang,2016-11-09 15:18:11-08:00,['620329c5b272a17bdeb4495f46834c903d0b23d3'],39,56,95,24220681,3,,,,26930
a30c6a13b2217cc773e29fc8161ef8a616e944ef,1,Richard Zang,2016-11-09 18:10:18-08:00,['2e3a29ef5aa4f3c74f358fe03ce9a12d83bd0c30'],2,3,5,24220686,2,0,0,1,26930
4163bcb13592119b52352d1e4fadd124b11c4267,0,Jaimin Jetly,2016-11-09 18:55:33-08:00,['a30c6a13b2217cc773e29fc8161ef8a616e944ef'],3,10,13,24220699,2,0,1,1,26930
22a4875cc1245297c90cc2c4c5e564efa3efd099,0,Sumit Mohanty,2016-11-09 19:10:50-08:00,['4163bcb13592119b52352d1e4fadd124b11c4267'],0,1,1,24220700,1,,,,26930
42646888197148f67ae339568cd7d1bf56000236,0,Andrew Onishuk,2016-11-10 10:53:44+02:00,['22a4875cc1245297c90cc2c4c5e564efa3efd099'],12,20,32,24220732,2,0,0,1,26930
03f6398fcfa7d2e8accd72013d834815ba8755c5,0,Swapan Shridhar,2016-11-10 02:06:37-08:00,['42646888197148f67ae339568cd7d1bf56000236'],10,161,171,24220903,3,0.025641026,0.025641026,1,26932
db2013a4750425fdbdfeb7b597350ea0b446e62d,1,Dmytro Sen,2016-11-10 12:33:59+02:00,['03f6398fcfa7d2e8accd72013d834815ba8755c5'],11,772,783,24221686,9,0.467741935,0.997983871,0.983870968,26934
56dc09ef789fff0ad32fe2a68224680518d73a94,1,Oleg Nechiporenko,2016-11-10 12:47:05+02:00,['db2013a4750425fdbdfeb7b597350ea0b446e62d'],23,58,81,24221767,1,,,,26934
be6cd59af60ea703c37cb7d7ca94728191a3cbce,1,Andrii Tkach,2016-11-10 14:32:19+02:00,['56dc09ef789fff0ad32fe2a68224680518d73a94'],16,116,132,24221899,11,0.891891892,0.918918919,1,26934
8335312d0527582bdb6701cfb1709a35b553b682,0,Dmytro Sen,2016-11-10 16:49:53+02:00,['be6cd59af60ea703c37cb7d7ca94728191a3cbce'],7,10,17,24221916,1,,,,26934
e55f8a8500de714b8cd6dd8bffac3685c1d49541,1,Sandor Magyari,2016-11-10 15:56:15+01:00,['8335312d0527582bdb6701cfb1709a35b553b682'],21,79,100,24222016,2,0.761904762,0.880952381,0,26934
6143203c0a147d0c8363c8709aaf7e35dea6928a,0,Nate Cole,2016-11-10 11:05:05-05:00,['4c9aabc303232e50fddd7d47b6dfd0769f8a68ea'],4,63,67,24222083,3,0,0.475,1,26934
075c11862faa0f89f507d79bc8d90b2e1f3a8f7b,0,Nate Cole,2016-11-10 11:09:15-05:00,"['6143203c0a147d0c8363c8709aaf7e35dea6928a', 'e55f8a8500de714b8cd6dd8bffac3685c1d49541']",147,1294,1441,24223524,38,,,,26934
b847a0c499dc29f99e6340c25afb4bb50c7cb7ff,0,Nate Cole,2016-11-10 11:10:37-05:00,"['e55f8a8500de714b8cd6dd8bffac3685c1d49541', '075c11862faa0f89f507d79bc8d90b2e1f3a8f7b']",4,63,67,24223591,3,,,,26934
cda44fe2fac7c16bf333ffcad405a856a630d7e2,1,Alex Antonenko,2016-11-10 18:33:13+02:00,['b847a0c499dc29f99e6340c25afb4bb50c7cb7ff'],305,876,1181,24224772,15,0.620805369,1,1,26938
24d64fc9b24099ba74630c20f7cf8a4414542786,1,Andrii Tkach,2016-11-10 19:18:26+02:00,['cda44fe2fac7c16bf333ffcad405a856a630d7e2'],30,38,68,24224840,8,,,,26938
7d1cb6ca64074ca5af34566cdc3364e213c96b0a,1,Vitaly Brodetskyi,2016-11-10 03:30:15+02:00,['24d64fc9b24099ba74630c20f7cf8a4414542786'],0,6,6,24224846,2,0,1,1,26938
2ddd7a33882008269cdd328831b0c5cb941558b8,1,Aravindan Vijayan,2016-11-10 09:36:56-08:00,['7d1cb6ca64074ca5af34566cdc3364e213c96b0a'],0,25,25,24224871,2,0,1,1,26938
5dea886efde58fb93033f705b5dd43b5ccd72ad6,1,"Toader, Sebastian",2016-11-11 12:22:04+01:00,['2ddd7a33882008269cdd328831b0c5cb941558b8'],66,143,209,24225080,11,0.475,0.95,0.35,26938
2d948db3195286d7ee9eb7fe610628c9993ed865,1,Oleg Nechiporenko,2016-11-11 13:50:24+02:00,['5dea886efde58fb93033f705b5dd43b5ccd72ad6'],1098,462,1560,24226640,25,,,,26938
9e82fd10ca2b1615e08520881ad45d3d01ec24e6,1,Aleksandr Kovalenko,2016-11-11 15:28:56+02:00,['2d948db3195286d7ee9eb7fe610628c9993ed865'],33,86,119,24226759,13,1,1,1,26939
bed231b9668ba7d71720ee3f4abae0a93f3a4991,0,Di Li,2016-11-11 11:08:13-05:00,['9e82fd10ca2b1615e08520881ad45d3d01ec24e6'],8,3,11,24226770,3,,,,26939
1807a4aaa0f0cb9344fc0e624e4ced68e89a430f,0,Lisnichenko Dmitro,2016-11-11 20:16:32+02:00,['bed231b9668ba7d71720ee3f4abae0a93f3a4991'],1,2,3,24226773,1,,,,26939
e569e9722a89d3205a03c43efedbc6cfb7fecde7,1,Jonathan Hurley,2016-11-11 13:27:03-05:00,['1807a4aaa0f0cb9344fc0e624e4ced68e89a430f'],4,11,15,24226788,2,0,0,0.666666667,26939
057755eeca0e4271418fbc4c846432a3932ba2ee,1,Swapan Shridhar,2016-11-11 11:08:00-08:00,['e569e9722a89d3205a03c43efedbc6cfb7fecde7'],161,10,171,24226959,3,0.974358974,0.974358974,0,26939
fb584530dd97f3897accfb197d574dfb4f6864e8,0,Yusaku Sako,2016-11-11 11:27:48-08:00,['057755eeca0e4271418fbc4c846432a3932ba2ee'],0,12,12,24226971,1,,,,26939
e256cfe49ac171e96cf8e8c755dfa1938e10d97a,0,Vitaly Brodetskyi,2016-11-11 06:41:08+02:00,['fb584530dd97f3897accfb197d574dfb4f6864e8'],7,19,26,24226997,1,0,0.5,1,26939
fa8f8405fd746a978523572a667cebd4a284f20b,0,Richard Zang,2016-11-11 16:04:31-08:00,['e256cfe49ac171e96cf8e8c755dfa1938e10d97a'],2,5,7,24227004,2,1,1,1,26939
8424364e74a0153d662f75356eef41ee80656c26,1,Dipayan Bhowmick,2016-11-12 23:43:56+05:18,['fa8f8405fd746a978523572a667cebd4a284f20b'],7,26,33,24227037,3,0,1,1,26939
24f1eb6dad2fc1d3f65849560a7d16e687acd8f8,1,Dipayan Bhowmick,2016-11-12 23:55:11+05:18,['8424364e74a0153d662f75356eef41ee80656c26'],13,6,19,24227056,3,0,0,0,26939
9dfb7e9231107d78503f7699ad8e49e549fbf81e,0,Lisnichenko Dmitro,2016-11-14 12:09:56+02:00,['24f1eb6dad2fc1d3f65849560a7d16e687acd8f8'],2,204,206,24227262,2,0.933333333,1,1,26940
f1200b729b2b055cb87a676dffb6dd8d68d9a865,1,Vitaly Brodetskyi,2016-11-13 21:42:16+02:00,['9dfb7e9231107d78503f7699ad8e49e549fbf81e'],0,3,3,24227265,1,0,0,1,26940
5d7824ea3e6689e910ebc03b9bfe408cd4d30a15,0,Vitaly Brodetskyi,2016-11-13 21:49:58+02:00,['f1200b729b2b055cb87a676dffb6dd8d68d9a865'],0,17,17,24227282,2,0.8,0.8,0.8,26940
4f1a7e403babb7129c9ca3b4c40a18c97dd6805e,0,Aleksandr Kovalenko,2016-11-14 16:51:31+02:00,['5d7824ea3e6689e910ebc03b9bfe408cd4d30a15'],3,5,8,24227290,4,,,,26940
fa23822bd185a94e241145b0c3cedd394aed99d8,0,Tim Thorpe,2016-11-14 08:34:39-08:00,['4f1a7e403babb7129c9ca3b4c40a18c97dd6805e'],22,93,115,24227405,11,0.395348837,0.558139535,0.837209302,26940
95233eb3aa57027601072440f6c7b9b757c28692,1,"Toader, Sebastian",2016-11-14 18:40:47+01:00,['fa23822bd185a94e241145b0c3cedd394aed99d8'],101,1887,1988,24229393,37,0.512875536,0.959227468,0.982832618,26958
863d995c1a7363b33e17b8e4d14970d09855a6bf,0,Nate Cole,2016-11-14 13:27:01-05:00,"['83f54c2b9825ef0182328515878aceb98dfc10fc', '95233eb3aa57027601072440f6c7b9b757c28692']",3782,9185,12967,24242360,319,,,,26958
4d7d3cdc6380db63bf9b1b221f548cd4470e2a51,1,Siddharth Wagle,2016-11-14 10:33:10-08:00,['95233eb3aa57027601072440f6c7b9b757c28692'],165,212,377,24242737,5,0.571428571,1,1,26958
3868cbe4d249a02d923f5502c9a9a24787550991,0,Tim Thorpe,2016-11-14 11:50:52-08:00,['4d7d3cdc6380db63bf9b1b221f548cd4470e2a51'],93,22,115,24242852,11,0.604651163,0.441860465,0.162790698,26958
a1906001cc17070068cf529ad70f5f9e34d56ff0,0,Tim Thorpe,2016-11-14 11:52:14-08:00,['3868cbe4d249a02d923f5502c9a9a24787550991'],23,94,117,24242969,11,0.395348837,0.279069767,0.837209302,26958
bc7a29f54046978b79f659d94a17f6335f693191,1,Di Li,2016-11-14 15:33:36-05:00,['a1906001cc17070068cf529ad70f5f9e34d56ff0'],48,270,318,24243287,6,0.647058824,0.823529412,1,26959
45adfdf778b44e28c607264f8026404e02633463,1,Jonathan Hurley,2016-11-14 16:44:30-05:00,['bc7a29f54046978b79f659d94a17f6335f693191'],9,46,55,24243342,3,0,1,1,26959
ce46060294b3ad33e3e32153277ca42c71aacc1a,0,Aravindan Vijayan,2016-11-14 14:49:29-08:00,['45adfdf778b44e28c607264f8026404e02633463'],0,10,10,24243352,1,1,1,1,26959
5a32eda86a01c558dc191d5516d4d7b4e8051d57,0,Sumit Mohanty,2016-11-14 21:05:32-08:00,['ce46060294b3ad33e3e32153277ca42c71aacc1a'],0,116,116,24243468,5,0,0,1,26961
07cde1d74d94bbcf380d195be271491ee5035746,1,Oleg Nechiporenko,2016-11-15 11:55:02+02:00,['5a32eda86a01c558dc191d5516d4d7b4e8051d57'],1028,476,1504,24244972,23,1,0,0,26961
4665c812f4d7b4ebd009db07beb76be1ec587fe7,1,Lisnichenko Dmitro,2016-11-15 13:10:59+02:00,['07cde1d74d94bbcf380d195be271491ee5035746'],6,27,33,24245005,2,0.888888889,0.888888889,0,26961
3c7d8bda6f0f481fbb7743aacddaf64d635ebd1f,0,Lisnichenko Dmitro,2016-11-15 13:13:34+02:00,['4665c812f4d7b4ebd009db07beb76be1ec587fe7'],1,1,2,24245007,1,,,,26961
3809ebc1f9413a12ed7ca6f67452208cd86f6331,0,Tim Thorpe,2016-11-15 04:44:24-08:00,['3c7d8bda6f0f481fbb7743aacddaf64d635ebd1f'],94,23,117,24245124,11,0.604651163,0.720930233,0.162790698,26961
fcd0d2adbfdce42fe63c4a1ad648595fd2f90bdb,1,Sandor Magyari,2016-11-15 13:48:56+01:00,['3809ebc1f9413a12ed7ca6f67452208cd86f6331'],8,15,23,24245147,4,1,1,0,26961
7df30b172d88271ffa5300149a73e86bf330a912,0,"Toader, Sebastian",2016-11-15 13:56:12+01:00,['fcd0d2adbfdce42fe63c4a1ad648595fd2f90bdb'],0,1,1,24245148,1,,,,26961
b5a2bb8ddbc7badcdd459b443077d429c5e8235d,1,Robert Levas,2016-11-15 09:20:22-05:00,['7df30b172d88271ffa5300149a73e86bf330a912'],18,686,704,24245852,32,0.543478261,0.858695652,0.898550725,26965
a201d092d1dc4ef32dcbf3ba37ee957f33418637,0,Dmytro Sen,2016-11-15 18:15:42+02:00,['b5a2bb8ddbc7badcdd459b443077d429c5e8235d'],329,20,349,24246201,11,0.47133758,0.318471338,0.52866242,26965
d2118f58c9cf36720710222deac2d06e8024af00,1,Jayush Luniya,2016-11-15 11:41:13-08:00,['a201d092d1dc4ef32dcbf3ba37ee957f33418637'],1,3,4,24246205,1,0,0,0,26965
b413d921cdeca51ad8d36088100ee13e853bb925,1,Tim Thorpe,2016-11-15 13:03:39-08:00,['d2118f58c9cf36720710222deac2d06e8024af00'],32,131,163,24246368,11,0.365079365,0.777777778,0.285714286,26965
0e8474fea1de0ed113b50bb89a18e8534f991db5,1,Di Li,2016-11-15 16:47:00-05:00,['b413d921cdeca51ad8d36088100ee13e853bb925'],12,93,105,24246473,2,0.080645161,0.096774194,0.709677419,26965
b395c5df5500678fcb36a5bd74c5fbfb1905c5fe,0,Nate Cole,2016-11-15 17:26:25-05:00,['95233eb3aa57027601072440f6c7b9b757c28692'],6,22,28,24246501,4,0,0,0,26965
b7ee658d0a7802eba00805658fd50f5e9d0023b3,0,Richard Zang,2016-11-15 16:04:18-08:00,['0e8474fea1de0ed113b50bb89a18e8534f991db5'],1,1,2,24246503,1,,,,26965
8c3ad1d6469fbe9c095fcc563f1c1a536892a727,0,Sumit Mohanty,2016-11-15 16:50:09-08:00,['b7ee658d0a7802eba00805658fd50f5e9d0023b3'],4,35,39,24246542,3,0,1,0.941176471,26965
5454bd612774d7f17704adaff24cbfa73c6a4f77,1,Mugdha Varadkar,2016-11-16 10:11:32+05:18,['8c3ad1d6469fbe9c095fcc563f1c1a536892a727'],183,1374,1557,24248099,7,0.140186916,0.869158879,0.869158879,26968
b5e6a88c6e1f060bfe8e064cdce808f28c121701,0,Oleg Nechiporenko,2016-11-16 15:55:46+02:00,['61942e55a8fd09b90f320fb2bf7dcc68eee0eeca'],0,1,1,24248100,1,0,1,1,26968
58ef394602fcae9a5cdea99db5146ed3206a74d6,0,Di Li,2016-11-16 09:02:11-05:00,['b5e6a88c6e1f060bfe8e064cdce808f28c121701'],1,1,2,24248102,1,,,,26968
f4c2dbff3117255ecdeebea0694aaf820823d7b6,0,Nate Cole,2016-11-16 09:39:16-05:00,"['b395c5df5500678fcb36a5bd74c5fbfb1905c5fe', '58ef394602fcae9a5cdea99db5146ed3206a74d6']",7100,3461,10561,24258663,133,,,,26968
d1d90db50f04e2797b3b20841f475664d631f916,0,Nate Cole,2016-11-16 09:40:27-05:00,"['58ef394602fcae9a5cdea99db5146ed3206a74d6', 'f4c2dbff3117255ecdeebea0694aaf820823d7b6']",6,22,28,24258691,4,,,,26968
eb71c65f73c2a1917b94ff6f727bbd3658de15ee,0,"Toader, Sebastian",2016-11-16 15:57:03+01:00,['d1d90db50f04e2797b3b20841f475664d631f916'],6,6,12,24258703,6,,,,26968
7b54b9aef9d7a9d881643a52619b0e31a0df55ee,0,Oleg Nechiporenko,2016-11-16 17:18:03+02:00,['eb71c65f73c2a1917b94ff6f727bbd3658de15ee'],6,6,12,24258715,1,,,,26968
7d2fa09ebea5eaf1617e2661ae5691fa3ba7cf76,1,oleewere,2016-11-16 16:48:10+01:00,['7b54b9aef9d7a9d881643a52619b0e31a0df55ee'],17,515,532,24259247,10,0.762195122,0.829268293,0.87195122,26970
50a36810bf9bfafb50f13f11bfe39d6b88972b74,1,oleewere,2016-11-16 16:48:11+01:00,['7d2fa09ebea5eaf1617e2661ae5691fa3ba7cf76'],10,69,79,24259326,6,0,0,1,26971
b70c78b2a2f4d1fa33aae180abea6724eca1b01a,1,oleewere,2016-11-16 16:48:11+01:00,['50a36810bf9bfafb50f13f11bfe39d6b88972b74'],3,1469,1472,24260798,4,,,,26972
7956950c69279350df0b5cb6c9228f6788cce4b0,0,Aleksandr Kovalenko,2016-11-16 18:28:39+02:00,['b70c78b2a2f4d1fa33aae180abea6724eca1b01a'],2,2,4,24260802,1,,,,26972
49d6d88dcf7ed8c15152cdca7bc1fbf2ba6c8d5a,0,Renjith Kamath,2016-11-16 22:44:03+05:18,['7956950c69279350df0b5cb6c9228f6788cce4b0'],6,9,15,24260817,3,1,1,1,26972
745d1057b04f1ecf8a089d437e49a1ef672c2090,1,Di Li,2016-11-16 13:03:29-05:00,['49d6d88dcf7ed8c15152cdca7bc1fbf2ba6c8d5a'],21,105,126,24260943,11,0.967741935,1,1,26973
430ecee6139c413faee7a8ed14a988181688cd54,0,Robert Levas,2016-11-16 14:42:23-05:00,['745d1057b04f1ecf8a089d437e49a1ef672c2090'],1,1,2,24260945,1,,,,26973
d92dc0ed47172f69293c1052ef2b7244462bb893,0,Siddharth Wagle,2016-11-16 11:56:26-08:00,['430ecee6139c413faee7a8ed14a988181688cd54'],13,8,21,24260966,1,1,1,0,26973
940143eea80270919f57fe197375b8691c10e3aa,1,Aravindan Vijayan,2016-11-16 12:56:17-08:00,['d92dc0ed47172f69293c1052ef2b7244462bb893'],12,117,129,24261095,3,0.975609756,1,1,26974
d1b777714bd0d8d843e8ac8bb39a8c2c6579f615,1,Tim Thorpe,2016-11-16 13:33:48-08:00,['940143eea80270919f57fe197375b8691c10e3aa'],2,19,21,24261116,2,0,0.75,0.25,26974
b5779fe6dca4db7df15abd905ef4b3dfae9d2c03,1,Vitaly Brodetskyi,2016-11-16 09:07:53+02:00,['d1b777714bd0d8d843e8ac8bb39a8c2c6579f615'],102,29,131,24261247,7,1,0,0,26974
56b4d57dcf747ee84b07a24a6f663254ab1eeaff,1,Jayush Luniya,2016-11-15 23:30:46-08:00,['5454bd612774d7f17704adaff24cbfa73c6a4f77'],3,3,6,24261253,1,,0,1,26974
f7b346b825056b27ce04957867ee3e073bccfed7,1,Vitaly Brodetskyi,2016-11-16 09:35:28+02:00,['b5779fe6dca4db7df15abd905ef4b3dfae9d2c03'],0,360,360,24261613,1,0.271551724,0.560344828,0.86637931,26975
7cf4d8662386475eddc405df7c84df7ea337686f,1,Andrew Onishuk,2016-11-16 12:57:46+02:00,['56b4d57dcf747ee84b07a24a6f663254ab1eeaff'],5250,9,5259,24266872,20,0.871884058,0.468985507,0.069275362,26975
61942e55a8fd09b90f320fb2bf7dcc68eee0eeca,0,Lisnichenko Dmitro,2016-11-16 13:24:15+02:00,['7cf4d8662386475eddc405df7c84df7ea337686f'],5,5,10,24266882,5,,,,26975
efcfced54da0d9f4ac9de0bdd3ac8c96369d1725,0,Nate Cole,2016-11-16 08:57:19-05:00,"['863d995c1a7363b33e17b8e4d14970d09855a6bf', '61942e55a8fd09b90f320fb2bf7dcc68eee0eeca']",7099,3459,10558,24277440,131,,,,26975
5db92d8c8fe8fe47f035d7ca0c194ae6038d8565,0,Yusaku Sako,2016-11-16 15:50:57-08:00,['f7b346b825056b27ce04957867ee3e073bccfed7'],0,12,12,24277452,1,,,,26975
ae1a98198c28ac8a3210fe21c0ce480095f21469,1,Sumit Mohanty,2016-11-16 16:54:32-08:00,['5db92d8c8fe8fe47f035d7ca0c194ae6038d8565'],7,10,17,24277469,1,,,,26975
82c13df406b3e4d28e2b6242d29113fa96f015fe,0,Nahappan Somasundaram,2016-11-16 17:34:58-08:00,['ae1a98198c28ac8a3210fe21c0ce480095f21469'],16,89,105,24277574,4,0,0,0.885714286,26975
dbf9e66b2f232083a01e22ecd283d385b76b1790,1,Richard Zang,2016-11-16 18:02:23-08:00,['82c13df406b3e4d28e2b6242d29113fa96f015fe'],7,7,14,24277588,2,,,,26975
33d8c56c5bd47e466e126079d457ae4bf4e904de,0,Xi Wang,2016-11-16 18:31:42-08:00,['dbf9e66b2f232083a01e22ecd283d385b76b1790'],2,2,4,24277592,1,,,,26975
07bdabdd021caa86e863b7b1ecf8543542ecf62e,0,Mugdha Varadkar,2016-11-17 10:53:29+05:18,['33d8c56c5bd47e466e126079d457ae4bf4e904de'],0,74,74,24277666,6,0,0.671875,1,26975
323628c9b118beda6591eedd89b15697da9cb036,1,oleewere,2016-11-17 11:37:35+01:00,['07bdabdd021caa86e863b7b1ecf8543542ecf62e'],3,131,134,24277800,3,0,1,1,26976
675086954cb53db8821ac44f2ae8ef122f5dfec8,0,Andrew Onishuk,2016-11-17 14:01:20+02:00,['323628c9b118beda6591eedd89b15697da9cb036'],2,2,4,24277804,2,,,,26976
46b44d2a7574b11415dfb88917a906b30624c666,0,Aleksandr Kovalenko,2016-11-17 15:52:10+02:00,['675086954cb53db8821ac44f2ae8ef122f5dfec8'],3,39,42,24277846,3,0.857142857,1,1,26976
2c884ab7b8fb935eb47f86d6b5a37c4dc6711252,1,Dmytro Sen,2016-11-17 17:38:25+02:00,['46b44d2a7574b11415dfb88917a906b30624c666'],5,9,14,24277860,2,0,0,0,26976
6c727311fb28b7035d57efb3a1591189ca07dd64,0,Andrii Tkach,2016-11-17 18:01:34+02:00,['2c884ab7b8fb935eb47f86d6b5a37c4dc6711252'],1,1,2,24277862,1,,,,26976
a6639a7c72043ff7bda03e6ba305913c7503193a,1,Jonathan Hurley,2016-11-17 11:20:55-05:00,['5d7824ea3e6689e910ebc03b9bfe408cd4d30a15'],1298,846,2144,24280006,52,0.898230088,0.265486726,0,26976
0a0e9a5005ef1c410938f6059c0d8f9cb0a16ba5,0,Jonathan Hurley,2016-11-17 11:26:54-05:00,"['a6639a7c72043ff7bda03e6ba305913c7503193a', '2c884ab7b8fb935eb47f86d6b5a37c4dc6711252']",7443,8523,15966,24295972,255,,,,26976
c97d785bfdb8f2c835a93fcea278429596ef407b,1,Dipayan Bhowmick,2016-11-18 00:33:08+05:18,['6c727311fb28b7035d57efb3a1591189ca07dd64'],26,30,56,24296028,1,1,1,1,26976
bd4c85718f07c07281ea93c83c67028a611e61b1,1,Aravindan Vijayan,2016-11-17 13:50:04-08:00,['c97d785bfdb8f2c835a93fcea278429596ef407b'],3,18,21,24296049,3,0,0.5,1,26976
b23623aa8c7dbd5f36892f86e0b1781f6bd87c8b,0,Yusaku Sako,2016-11-17 13:52:42-08:00,['bd4c85718f07c07281ea93c83c67028a611e61b1'],1,1,2,24296051,1,,,,26976
945e5d4dd8fa4b9ee3ed473a69d46695253e6285,1,Oleg Nechiporenko,2016-11-18 10:12:59+02:00,['b23623aa8c7dbd5f36892f86e0b1781f6bd87c8b'],2557,2552,5109,24301160,37,,,,26981
e83b06b27933d07998c6f693a94724b272ba7fae,0,Andrii Tkach,2016-11-18 11:25:02+02:00,['945e5d4dd8fa4b9ee3ed473a69d46695253e6285'],3,3,6,24301166,1,,,,26981
5766783a1f2d202bbfcd4857f2204f744c0fc0db,0,"Toader, Sebastian",2016-11-18 10:58:53+01:00,['e83b06b27933d07998c6f693a94724b272ba7fae'],6,6,12,24301178,6,,,,26981
eb1411d228f5fdcdfa59f0bba5a54af74f514f6c,0,Lisnichenko Dmitro,2016-11-18 12:53:21+02:00,['5766783a1f2d202bbfcd4857f2204f744c0fc0db'],14,16,30,24301208,1,,,,26981
e96c68fcb9804bec46380bca84c2f69b5aa3808a,1,"Toader, Sebastian",2016-11-18 12:03:23+01:00,['eb1411d228f5fdcdfa59f0bba5a54af74f514f6c'],61,61,122,24301330,2,,,,26981
8b0939355612f331da3d1b029dc2878f2267c1b2,0,Matt,2016-11-18 11:23:15-08:00,['e96c68fcb9804bec46380bca84c2f69b5aa3808a'],9,7,16,24301346,2,0,0,0,26981
23905571a809131343295f259483835a25e2c840,1,Aleksandr Kovalenko,2016-11-18 23:03:12+02:00,['8b0939355612f331da3d1b029dc2878f2267c1b2'],13,50,63,24301409,4,0.392857143,0,0.678571429,26981
08ca96e3259c8ba3e509d2e4d6a436a3d8890bc1,1,Alejandro Fernandez,2016-11-18 14:48:59-08:00,['23905571a809131343295f259483835a25e2c840'],0,35158,35158,24336567,96,1,1,0.668539326,27077
3b0c35b65c144acaaa2b677ee345c92348b4d6ec,1,Aleksandr Kovalenko,2016-11-19 00:57:48+02:00,['08ca96e3259c8ba3e509d2e4d6a436a3d8890bc1'],4,269,273,24336840,7,0.411764706,0.932773109,1,27077
ab1c1001688b333817ac20ec5c20b635f566c353,1,Jonathan Hurley,2016-11-18 18:36:41-05:00,['0a0e9a5005ef1c410938f6059c0d8f9cb0a16ba5'],411,342,753,24337593,13,0.480769231,0.990384615,0,27077
e1638ce7dfa9edd9ae025cd3d8ca37795dc6cd46,1,Sumit Mohanty,2016-11-20 15:30:13-08:00,['3b0c35b65c144acaaa2b677ee345c92348b4d6ec'],2,1387,1389,24338982,4,0,0.86,0.02,27078
c0bd9f83f80b554933e184a4faa922f9fe9fbfdd,1,Dmytro Sen,2016-11-21 12:01:31+02:00,['e1638ce7dfa9edd9ae025cd3d8ca37795dc6cd46'],8,22,30,24339012,3,0.125,0,0.5,27078
c9a4881d976f306f54d9b2323d68913dab02438a,0,Renjith Kamath,2016-11-21 17:11:46+05:18,['c0bd9f83f80b554933e184a4faa922f9fe9fbfdd'],93,73,166,24339178,2,0,1,1,27078
936626bdba424d3972704a68f98b34cc542f8a64,0,Jonathan Hurley,2016-11-21 11:08:19-05:00,"['ab1c1001688b333817ac20ec5c20b635f566c353', 'c9a4881d976f306f54d9b2323d68913dab02438a']",2803,39665,42468,24381646,172,,,,27078
cfc161299031e5485f8bb96457b1d06acb1bacdc,1,Andrew Onishuk,2016-11-21 18:28:55+02:00,['c9a4881d976f306f54d9b2323d68913dab02438a'],522,603,1125,24382771,4,0,1,0.075949367,27078
38076327525986b780942f33eff01d2de4a70ce2,0,Robert Levas,2016-11-21 14:03:48-05:00,['cfc161299031e5485f8bb96457b1d06acb1bacdc'],12,2,14,24382785,3,1,1,0,27078
be2628c99d29ebd740663e37bdc6d9476e5daced,0,Nate Cole,2016-11-21 14:06:13-05:00,['38076327525986b780942f33eff01d2de4a70ce2'],2092,0,2092,24384877,2,,,,27078
6e314a609791ff0f2adbe33b30f442bfcd23e530,1,Alejandro Fernandez,2016-11-21 12:05:50-08:00,['be2628c99d29ebd740663e37bdc6d9476e5daced'],85,145,230,24385107,1,0,1,1,27078
ef91365b7c1e294ac42006da71c647012679dbe6,1,Aravindan Vijayan,2016-11-21 13:01:24-08:00,['6e314a609791ff0f2adbe33b30f442bfcd23e530'],89,171,260,24385367,5,0.009803922,0.715686275,0.715686275,27078
7d07b71de7019efaaa04fe8c09548cdc604cea60,1,Nate Cole,2016-11-21 16:11:21-05:00,['ef91365b7c1e294ac42006da71c647012679dbe6'],20,168,188,24385555,9,0.163265306,0.510204082,1,27079
eb87df065d4f0f838e7335bc2cf47d06c9e5dd68,0,Aravindan Vijayan,2016-11-21 13:20:59-08:00,['7d07b71de7019efaaa04fe8c09548cdc604cea60'],12,13,25,24385580,3,,,,27079
0bbdb937ebed326bd667b985e48027bd1a23a110,0,Aravindan Vijayan,2016-11-21 14:13:01-08:00,['eb87df065d4f0f838e7335bc2cf47d06c9e5dd68'],13,12,25,24385605,3,,,,27079
2152c6a2d6c8aba1ee145f4f9d85e1de157c3caf,1,Richard Zang,2016-11-21 14:29:15-08:00,['0bbdb937ebed326bd667b985e48027bd1a23a110'],18,72,90,24385695,4,1,1,1,27079
74869f9803815d511ca7039e679a6787ae9cfe72,1,Nitiraj Rathore,2016-11-22 12:17:30+05:18,['2152c6a2d6c8aba1ee145f4f9d85e1de157c3caf'],0,394,394,24386089,16,,,,27081
a10cc80b3b75fa3bfa3d51d5e0382e1b56d61913,0,Mugdha Varadkar,2016-11-22 12:23:51+05:18,['74869f9803815d511ca7039e679a6787ae9cfe72'],1,66,67,24386156,5,0,0,1,27083
f13e0486ba22125c5b5338de26e353a21ce9f1a0,0,Mugdha Varadkar,2016-11-22 18:31:24+05:18,['a10cc80b3b75fa3bfa3d51d5e0382e1b56d61913'],22,25,47,24386203,5,0,0.333333333,0.333333333,27083
1ed941661bf6e4aa7e936034cdaf464a95ea7631,0,Tim Thorpe,2016-11-22 06:11:35-08:00,['f13e0486ba22125c5b5338de26e353a21ce9f1a0'],1,15,16,24386219,1,,,,27083
2ce9e3b671ad1687581113dd96fa38be7a0c51a3,1,Aleksandr Kovalenko,2016-11-22 17:48:27+02:00,['1ed941661bf6e4aa7e936034cdaf464a95ea7631'],3717,3892,7609,24393828,61,0,0,0,27103
4a7cbcb1b49d070f57c9d5ba9771ad72765693a4,1,Tim Thorpe,2016-11-22 07:52:49-08:00,['2ce9e3b671ad1687581113dd96fa38be7a0c51a3'],70,586,656,24394484,20,0,0.746478873,0.049295775,27119
48715331207b73978803aa666209b84c26224fde,1,Tim Thorpe,2016-11-22 08:56:34-08:00,['4a7cbcb1b49d070f57c9d5ba9771ad72765693a4'],1,24,25,24394509,2,0,0.941176471,0,27119
e73e783a8b5377b809a829c362900d3cad15d69f,1,Robert Levas,2016-11-22 15:28:12-05:00,['48715331207b73978803aa666209b84c26224fde'],128,354,482,24394991,3,0.017751479,0.272189349,0.609467456,27119
31ce5f7d3d087af5d0f03f295fe5d680a6ee453d,0,Xi Wang,2016-11-22 14:21:01-08:00,['e73e783a8b5377b809a829c362900d3cad15d69f'],83,186,269,24395260,8,0,0,0,27119
292d27987f7c0fa0265ba9d2f6c47f69cb9827c9,0,Andrew Onishuk,2016-11-23 11:08:31+02:00,['31ce5f7d3d087af5d0f03f295fe5d680a6ee453d'],0,24,24,24395284,3,,,,27119
6088c17906b784f57adca36af224d63135a49b9a,1,Oleg Nechiporenko,2016-11-23 12:49:38+02:00,['292d27987f7c0fa0265ba9d2f6c47f69cb9827c9'],369,213,582,24395866,19,0,0,1,27119
29db2273e77b8fd4f36c15a2001495a08099250a,1,Andrii Tkach,2016-11-23 15:25:58+02:00,['6088c17906b784f57adca36af224d63135a49b9a'],213,703,916,24396782,9,0.95640327,0.95640327,1,27122
4551c9f9cbc3e1723a331b038dfee954098f3b44,1,Robert Levas,2016-11-23 09:32:37-05:00,['29db2273e77b8fd4f36c15a2001495a08099250a'],2,12,14,24396796,3,0,0,1,27122
fbf636d3b2d06612ba5258f2587261cb7950e314,0,Dmytro Sen,2016-11-23 17:01:17+02:00,['4551c9f9cbc3e1723a331b038dfee954098f3b44'],62,0,62,24396858,1,,,,27122
90967bcd0df7a5ab089611ee5502bb90d0084a0a,1,Dmytro Sen,2016-11-23 18:47:20+02:00,['fbf636d3b2d06612ba5258f2587261cb7950e314'],577,855,1432,24398290,15,0.1003861,1,1,27123
a8d6f03f89ff610926f997d6f41f915052a17e88,0,Jaimin Jetly,2016-11-23 09:26:17-08:00,['90967bcd0df7a5ab089611ee5502bb90d0084a0a'],3,3,6,24398296,1,,,,27123
bd2cd4ab61798a44a670797a9348b6e818b7701b,1,Jayush Luniya,2016-11-23 10:30:00-08:00,['a8d6f03f89ff610926f997d6f41f915052a17e88'],39,177,216,24398512,5,0.448598131,0.813084112,0.925233645,27123
b59dc1dd0daff5da65622c8237cd9ecfba605734,1,Alejandro Fernandez,2016-11-23 10:42:28-08:00,['bd2cd4ab61798a44a670797a9348b6e818b7701b'],284,284,568,24399080,24,,,,27123
99cb9029a2845909e3351f5e6665a457d2c19e93,1,Sumit Mohanty,2016-11-23 11:42:14-08:00,['b59dc1dd0daff5da65622c8237cd9ecfba605734'],2,13,15,24399095,3,,,,27123
998baf64d2a6500fba91a1a8e035dcd9cf3a4373,0,Jayush Luniya,2016-11-23 11:59:54-08:00,['99cb9029a2845909e3351f5e6665a457d2c19e93'],4,6,10,24399105,4,,,,27123
cb1bce2f5af7f4fa6c55b819b23c53ce342d9a45,0,Mugdha Varadkar,2016-11-24 14:16:42+05:18,['998baf64d2a6500fba91a1a8e035dcd9cf3a4373'],4,22,26,24399131,1,,,,27123
c9f6944b038b73ce41aaa5fc9adb0aa2745e01e8,0,Lisnichenko Dmitro,2016-11-24 11:51:54+02:00,['cb1bce2f5af7f4fa6c55b819b23c53ce342d9a45'],0,4,4,24399135,2,0,1,1,27123
3081aec39c0f6dfc13545667ec1a1b2ef87d3b06,0,Aleksandr Kovalenko,2016-11-24 13:07:34+02:00,['c9f6944b038b73ce41aaa5fc9adb0aa2745e01e8'],1,3,4,24399139,2,,,,27123
14d63dd9b4241ef5cf6624c3ca3d5a1f303bc68c,1,ababiichuk,2016-11-24 13:20:26+02:00,['3081aec39c0f6dfc13545667ec1a1b2ef87d3b06'],507,414,921,24400060,24,0,0,0,27123
b7d55f0c9375686b8949ada3a4688eb936cf8404,0,Oleg Nechiporenko,2016-11-24 15:49:00+02:00,['14d63dd9b4241ef5cf6624c3ca3d5a1f303bc68c'],0,303,303,24400363,3,0.682008368,0.79916318,1,27124
fc46088d9a9943c8e6bd7ea9b29512064faf72c4,0,Sumit Mohanty,2016-11-24 10:16:11-08:00,['b7d55f0c9375686b8949ada3a4688eb936cf8404'],4,8,12,24400375,2,0,0.333333333,0,27124
c2555596e62a5ce592f7b02a9b2885bdef80af8d,0,Vitaly Brodetskyi,2016-11-25 14:13:46+02:00,['fc46088d9a9943c8e6bd7ea9b29512064faf72c4'],1,9,10,24400385,1,0,0,1,27124
549d7cc86e43664050546355d96ba457c06e7884,1,Sandor Magyari,2016-11-25 17:35:42+01:00,['c2555596e62a5ce592f7b02a9b2885bdef80af8d'],174,314,488,24400873,10,0.333333333,0.426666667,0.986666667,27125
5c002c6408d74b9d7c1a7693f3d01761ed64265a,0,ababiichuk,2016-11-25 19:00:10+02:00,['549d7cc86e43664050546355d96ba457c06e7884'],218,178,396,24401269,7,0,0,0,27125
9579275eb9cc4bd1896a86eb66f6e9fcb84d503e,0,Vitaly Brodetskyi,2016-11-27 19:16:22+02:00,['5c002c6408d74b9d7c1a7693f3d01761ed64265a'],2,12,14,24401283,1,0,0.25,1,27125
ece1de33af2edb765d81dcdc66445619c9d4a6d9,0,Andrew Onishuk,2016-11-28 12:37:39+02:00,['9579275eb9cc4bd1896a86eb66f6e9fcb84d503e'],7,8,15,24401298,3,1,1,1,27125
1f804d1392fc076542b9905766108d658258bcb4,0,Jonathan Hurley,2016-11-28 08:37:22-05:00,"['936626bdba424d3972704a68f98b34cc542f8a64', 'ece1de33af2edb765d81dcdc66445619c9d4a6d9']",9237,10171,19408,24420706,260,,,,27125
b1eaffc7065d60c03a022a2ae3e4afca9f7ebb62,0,Andrew Onishuk,2016-11-28 17:01:33+02:00,['ece1de33af2edb765d81dcdc66445619c9d4a6d9'],1,1,2,24420708,1,,,,27125
abf9882276d2ed73cd5dcf12a088d16492c9490d,1,Myroslav Papirkovskyi,2016-11-28 18:38:03+02:00,['b1eaffc7065d60c03a022a2ae3e4afca9f7ebb62'],46,67,113,24420821,9,1,0,0,27125
255725dfc07a4a4fd7fc8b3f6cdbd7cced1c375a,1,Myroslav Papirkovskyi,2016-11-28 18:46:01+02:00,['abf9882276d2ed73cd5dcf12a088d16492c9490d'],1,53,54,24420875,3,0.268292683,0,0.731707317,27125
cad0130d9d4a64a6bda1992758c5c7c05e06b39e,0,Robert Levas,2016-11-28 12:39:10-05:00,['255725dfc07a4a4fd7fc8b3f6cdbd7cced1c375a'],16,2,18,24420893,4,1,0.692307692,0,27125
cf82cf248a2e5178ea3fa35a76df338e7d258eb9,1,Alex Antonenko,2016-11-28 19:48:58+02:00,['cad0130d9d4a64a6bda1992758c5c7c05e06b39e'],13,456,469,24421362,12,0,0,0,27127
8de17fadfd00912b9bc7801011905f6c90bc8a97,1,Aravindan Vijayan,2016-11-28 10:08:33-08:00,['cf82cf248a2e5178ea3fa35a76df338e7d258eb9'],25,9,34,24421396,1,,,,27127
3c8b1582c2f0aa65289b762fd0162049916e9140,0,Andrii Tkach,2016-11-28 20:41:25+02:00,['8de17fadfd00912b9bc7801011905f6c90bc8a97'],2,2,4,24421400,2,,,,27127
80d09892d685a8179e6ece33a41f59de1b7d580b,0,Jonathan Hurley,2016-11-28 14:11:02-05:00,['3c8b1582c2f0aa65289b762fd0162049916e9140'],0,1,1,24421401,1,,,,27127
1f8b527f95a262ceb85c2f3436033f65a44860bf,0,Nate Cole,2016-11-28 14:22:41-05:00,"['efcfced54da0d9f4ac9de0bdd3ac8c96369d1725', '80d09892d685a8179e6ece33a41f59de1b7d580b']",11903,53038,64941,24486342,488,,,,27127
640d85a501e5dbc2b7422bf49f2f94a31aa391b6,0,Di Li,2016-11-28 15:09:54-05:00,['80d09892d685a8179e6ece33a41f59de1b7d580b'],1,1,2,24486344,1,,,,27127
bb803fb332d8d247e236b5e1b29fe97acfd7a7ec,1,Di Li,2016-11-28 15:51:11-05:00,['640d85a501e5dbc2b7422bf49f2f94a31aa391b6'],0,407,407,24486751,3,0.104545455,0.718181818,1,27129
b5b73d202333374a8bbffcebbd9f099e30949220,0,Mugdha Varadkar,2016-11-29 09:29:23+05:18,['bb803fb332d8d247e236b5e1b29fe97acfd7a7ec'],0,308,308,24487059,10,0,1,1,27131
69390ee4897699a94542e946e2f03d31ee4a626b,1,Renjith Kamath,2016-11-29 11:47:01+05:18,['b5b73d202333374a8bbffcebbd9f099e30949220'],12,31,43,24487102,2,0,1,1,27131
5f3b32347451dbaf3c7f980e8ef8dc0ec2aa254b,0,Andrii Tkach,2016-11-29 12:19:48+02:00,['69390ee4897699a94542e946e2f03d31ee4a626b'],3,31,34,24487136,3,0.85,0.95,1,27131
3c56dcce5b3c10d29b6b500ce749179eddbc4421,0,ababiichuk,2016-11-29 13:53:27+02:00,['5f3b32347451dbaf3c7f980e8ef8dc0ec2aa254b'],4,1,5,24487141,1,,,,27131
c705fa7fa995045ea27a36b5d457df0bae8106f1,1,oleewere,2016-11-29 15:06:36+01:00,['3c56dcce5b3c10d29b6b500ce749179eddbc4421'],164,202,366,24487507,23,0.233333333,0.233333333,0,27132
edd6b491fe3586b95297752085a72417b801daf8,1,oleewere,2016-11-29 15:39:11+01:00,['c705fa7fa995045ea27a36b5d457df0bae8106f1'],4,93,97,24487604,4,,,,27132
cfeb39176757aae6b5670bcff07f86992238cf3e,1,oleewere,2016-11-29 15:54:03+01:00,['edd6b491fe3586b95297752085a72417b801daf8'],10,118,128,24487732,9,0,1,1,27134
1b6a92d5527c68523be755f4e4ab9eb7a8f142e6,0,Aleksandr Kovalenko,2016-11-29 17:10:13+02:00,['cfeb39176757aae6b5670bcff07f86992238cf3e'],10,30,40,24487772,2,0.15,1,1,27134
4dda1d739c78f8feb130b1f12b1ba5709be9a1a1,0,Sandor Magyari,2016-11-29 16:19:02+01:00,['1b6a92d5527c68523be755f4e4ab9eb7a8f142e6'],1,1,2,24487774,1,,,,27134
a95284362adf794636c7437e6416ca4389046e63,1,Oleg Nechiporenko,2016-11-29 17:43:16+02:00,['4dda1d739c78f8feb130b1f12b1ba5709be9a1a1'],353,308,661,24488435,18,0,0,0,27134
f70591b13d3f037fac58d8da4476ba7305ffc887,0,Nate Cole,2016-11-29 11:24:09-05:00,"['1f8b527f95a262ceb85c2f3436033f65a44860bf', 'a95284362adf794636c7437e6416ca4389046e63']",562,1531,2093,24490528,77,,,,27134
f31f3f646610a2e480279989d6790437e5362cb8,1,oleewere,2016-11-29 18:03:42+01:00,['a95284362adf794636c7437e6416ca4389046e63'],2,10,12,24490540,1,0,1,0,27134
2c7c0a704f4230697b6757bdaad954d8c5d71c79,0,Nate Cole,2016-11-29 12:45:59-05:00,['f31f3f646610a2e480279989d6790437e5362cb8'],2,9,11,24490551,1,,,,27134
1a8a53828ad4f6214bbef7a96733361d1b05b598,0,Yusaku Sako,2016-11-29 10:28:53-08:00,['2c7c0a704f4230697b6757bdaad954d8c5d71c79'],2,2,4,24490555,1,,,,27134
85c9104ec14dc7b059d41f61dbbc6e57aec216d0,1,Alejandro Fernandez,2016-11-29 12:42:58-08:00,['1a8a53828ad4f6214bbef7a96733361d1b05b598'],74,169,243,24490798,1,0.773584906,1,0.660377358,27134
2cc4c9ed7009be2e894fec7d24c3cb4f0dd9f24c,0,Sangeeta Ravindran,2016-11-29 13:57:50-08:00,['85c9104ec14dc7b059d41f61dbbc6e57aec216d0'],10,87,97,24490895,7,0.34375,0.90625,1,27134
276d1244e1b1d8200cf644b7cccfaa0a757f8146,0,Jonathan Hurley,2016-11-29 17:00:59-05:00,"['1f804d1392fc076542b9905766108d658258bcb4', '85c9104ec14dc7b059d41f61dbbc6e57aec216d0']",746,2295,3041,24493936,114,,,,27134
ca7e071f044d70186c7bf9d18bf24c29f3767730,1,Sumit Mohanty,2016-11-29 15:28:46-08:00,['2cc4c9ed7009be2e894fec7d24c3cb4f0dd9f24c'],0,188,188,24494124,3,0.023809524,0.023809524,1,27136
1fb8d0799eb9117868eb2a5df2312569fd07ed43,0,Nahappan Somasundaram,2016-11-29 16:26:13-08:00,['ca7e071f044d70186c7bf9d18bf24c29f3767730'],4,0,4,24494128,1,,,,27136
d8ba7f1bad5f9bb96256a5ca64c0568d74b874f8,1,Dmytro Sen,2016-11-30 13:50:37+02:00,['1fb8d0799eb9117868eb2a5df2312569fd07ed43'],107,66,173,24494301,4,1,0.066666667,1,27136
d369809c96377fc06d33e1ef7bb1f53819e3f275,1,Oleg Nechiporenko,2016-11-30 13:58:05+02:00,['d8ba7f1bad5f9bb96256a5ca64c0568d74b874f8'],7,7,14,24494315,2,,,,27136
89780fabad715e971accb66c3c634cfe0030a91f,1,Andrii Tkach,2016-11-30 14:33:08+02:00,['d369809c96377fc06d33e1ef7bb1f53819e3f275'],12,21,33,24494348,4,1,1,1,27136
28d783486cb5f4f659126c77792fe44f39f43584,0,Alex Antonenko,2016-11-30 15:56:57+02:00,['89780fabad715e971accb66c3c634cfe0030a91f'],28,36,64,24494412,2,1,1,1,27136
e3b9a9f804537796fa46273b378935a14b75bb33,1,Andrew Onishuk,2016-11-30 17:07:22+02:00,['28d783486cb5f4f659126c77792fe44f39f43584'],1,22,23,24494435,2,0.545454545,1,1,27136
9559a1626ac5e6dd3f6ddf65b1fd450171bc4f26,1,Miklos Gergely,2016-11-30 16:24:04+01:00,['e3b9a9f804537796fa46273b378935a14b75bb33'],0,186,186,24494621,4,0.181818182,0.909090909,1,27138
10878592c2e2f5ac0412be8085c634d471f7358f,0,Di Li,2016-11-30 11:13:19-05:00,['9559a1626ac5e6dd3f6ddf65b1fd450171bc4f26'],7,10,17,24494638,2,1,1,1,27138
fff9980992ffcb40e643a4235a7cc36899f1fa5a,0,Di Li,2016-11-30 12:49:03-05:00,['10878592c2e2f5ac0412be8085c634d471f7358f'],38,57,95,24494733,9,1,0.666666667,0,27138
3a14b4afc9572b9aeb0310cdc0cd80700f27ee8d,0,Nate Cole,2016-11-30 12:53:00-05:00,['fff9980992ffcb40e643a4235a7cc36899f1fa5a'],0,13,13,24494746,1,,,,27138
0afdf6512b914b01417d0fecd2fba334e8dc0195,1,Sangeeta Ravindran,2016-11-30 11:16:31-08:00,['3a14b4afc9572b9aeb0310cdc0cd80700f27ee8d'],0,3,3,24494749,1,1,1,1,27138
4bfbf281ce17eacc2243962191dfb41c38c962b3,0,Nate Cole,2016-11-30 14:52:48-05:00,['0afdf6512b914b01417d0fecd2fba334e8dc0195'],13,0,13,24494762,1,,,,27138
72b940e725658599f055a1c1eaadaa2a9c65075b,1,Sumit Mohanty,2016-11-30 12:52:22-08:00,['4bfbf281ce17eacc2243962191dfb41c38c962b3'],0,37,37,24494799,3,0,0,1,27138
15f843bbb0679d93f836c0fa4a3b23370b1ae91c,0,Alejandro Fernandez,2016-11-30 13:48:07-08:00,['72b940e725658599f055a1c1eaadaa2a9c65075b'],1,22,23,24494822,2,0,1,0.166666667,27138
32c9f5a83bef6bca90ebecb7721de256c19061c7,1,Sumit Mohanty,2016-11-30 14:45:40-08:00,['15f843bbb0679d93f836c0fa4a3b23370b1ae91c'],10,10,20,24494842,5,,,,27138
1e65ba6943a10d04c38f780f476eca3806e2d9f3,1,Robert Levas,2016-11-30 19:16:53-05:00,['32c9f5a83bef6bca90ebecb7721de256c19061c7'],20,89,109,24494951,6,0.266666667,0.9,0.966666667,27138
7f04e79ab33dc173eb174fd9fcc60bbb54d2c947,1,Robert Levas,2016-11-30 20:38:34-05:00,['1e65ba6943a10d04c38f780f476eca3806e2d9f3'],0,5,5,24494956,1,0,1,1,27138
337c5f29fd31fa8b7f8391d81125dc1e5eef160c,1,Nahappan Somasundaram,2016-11-30 22:07:14-08:00,['7f04e79ab33dc173eb174fd9fcc60bbb54d2c947'],0,4,4,24494960,1,,,,27138
195b7456c0b4dc15833b502463daba7b29a51bee,1,oleewere,2016-12-01 11:37:16+01:00,['337c5f29fd31fa8b7f8391d81125dc1e5eef160c'],5,59,64,24495024,1,0.790697674,0.790697674,0.790697674,27138
dc5f4e259ce0f83a3a648de54468f6dadacd5291,0,Miklos Gergely,2016-12-01 11:43:28+01:00,['195b7456c0b4dc15833b502463daba7b29a51bee'],56,0,56,24495080,1,1,0,0,27138
4b387915117412b7153a7c36b3f26412538b756d,1,Andrii Tkach,2016-12-01 12:48:41+02:00,['dc5f4e259ce0f83a3a648de54468f6dadacd5291'],70,75,145,24495225,7,0,0,0,27138
7c07dd3595068b4e9a58db0fd2d6a8415898261c,0,Nitiraj Rathore,2016-12-01 17:34:00+05:18,['4b387915117412b7153a7c36b3f26412538b756d'],2,26,28,24495253,2,1,1,1,27138
9a72a6009c922f26ee47f2841a5ce89089a24883,1,Oleg Nechiporenko,2016-12-01 14:51:46+02:00,['7c07dd3595068b4e9a58db0fd2d6a8415898261c'],1,8,9,24495262,2,1,1,1,27138
ef63373ef2fa886d819589b8500e4c1c81390a87,0,Vitaly Brodetskyi,2016-12-01 16:38:58+02:00,['9a72a6009c922f26ee47f2841a5ce89089a24883'],2427,1464,3891,24499153,39,0,0,1,27160
9b21f30b5f081d7b313f9070ae125afc84db7647,1,ababiichuk,2016-12-01 17:07:49+02:00,['ef63373ef2fa886d819589b8500e4c1c81390a87'],22,74,96,24499249,6,0,1,1,27161
bb8be5ba6a950b64382fb1a44f04c1dbf24db382,1,Lisnichenko Dmitro,2016-12-01 17:36:15+02:00,['9b21f30b5f081d7b313f9070ae125afc84db7647'],851,562,1413,24500662,15,0.850364964,0,0,27162
6100be63867209de5dd5eaae6087aad850e25466,1,Sumit Mohanty,2016-12-01 07:46:45-08:00,['bb8be5ba6a950b64382fb1a44f04c1dbf24db382'],0,19,19,24500681,3,,,,27162
087de8b789d157aa8f4fd12963b0262ea6c40461,0,Jonathan Hurley,2016-12-01 10:57:35-05:00,"['276d1244e1b1d8200cf644b7cccfaa0a757f8146', '6100be63867209de5dd5eaae6087aad850e25466']",3679,3137,6816,24507497,133,,,,27162
88e0c29e0617f05c0ecb72a75e74b2bb3def6bac,1,Alejandro Fernandez,2016-12-01 09:45:56-08:00,['6100be63867209de5dd5eaae6087aad850e25466'],77,100,177,24507674,2,0,0.086956522,1,27162
63938e09ca9e79ee541dd51104964322192e293f,0,Alejandro Fernandez,2016-12-01 09:55:33-08:00,['88e0c29e0617f05c0ecb72a75e74b2bb3def6bac'],119,231,350,24508024,12,0,0,1,27162
63c0f2e58fc09b709e890923752c4ccb04181180,0,Aleksandr Kovalenko,2016-12-01 20:20:33+02:00,['63938e09ca9e79ee541dd51104964322192e293f'],65,23,88,24508112,3,0,1,1,27162
406b245ef9ed3a43fdf4d974dc1a7fc467c576a4,1,Dmytro Sen,2016-12-01 22:15:26+02:00,['63c0f2e58fc09b709e890923752c4ccb04181180'],53,51,104,24508216,17,0,0,0,27162
7577ebb264ae71f81e6572510500f1b87ac46a18,1,Aravindan Vijayan,2016-12-01 13:27:16-08:00,['406b245ef9ed3a43fdf4d974dc1a7fc467c576a4'],3,3,6,24508222,1,,,,27162
615438b272e6bd8efd37481ef684ae7d68921e64,0,Nahappan Somasundaram,2016-12-01 13:58:54-08:00,['7577ebb264ae71f81e6572510500f1b87ac46a18'],9,210,219,24508441,6,0.192307692,0.358974359,0.884615385,27162
d24beb17e238391b196a2bfae1217035678a0a14,1,Myroslav Papirkovskyi,2016-12-02 09:51:16+02:00,['615438b272e6bd8efd37481ef684ae7d68921e64'],0,59,59,24508500,2,0.14893617,0.808510638,0.936170213,27162
73d372b8db6b4809fac98338aef1c04ae4c95c92,0,Sandor Magyari,2016-12-02 09:43:24+01:00,['d24beb17e238391b196a2bfae1217035678a0a14'],2,162,164,24508664,2,0.951219512,0.951219512,0.951219512,27163
c2dc7538b65ab9f045010b7964ba00551b0ea099,1,Renjith Kamath,2016-12-02 14:40:51+05:18,['73d372b8db6b4809fac98338aef1c04ae4c95c92'],480,17,497,24509161,9,1,0,0,27163
2de7ee8d01ce850bbbf9844ad8789615b6570168,0,Andrew Onishuk,2016-12-02 11:45:57+02:00,['c2dc7538b65ab9f045010b7964ba00551b0ea099'],11,12,23,24509184,1,0,0,0,27163
e242fc091abe15bc59e8572c43d9227c97e7a247,1,Aleksandr Kovalenko,2016-12-02 15:44:42+02:00,['2de7ee8d01ce850bbbf9844ad8789615b6570168'],10,11,21,24509205,2,0,0,1,27163
80084a9d8de9110365c6f1ef68362b502e07cf28,0,Myroslav Papirkovskyi,2016-12-02 16:52:55+02:00,['e242fc091abe15bc59e8572c43d9227c97e7a247'],1,10,11,24509216,1,,,,27163
ae3ff2a09b6b36f8a456987c60fc695dd262b6bb,1,Jonathan Hurley,2016-12-02 10:13:45-05:00,['80084a9d8de9110365c6f1ef68362b502e07cf28'],9,15,24,24509240,1,0,0,1,27163
f4ea309196a2c02b88f5e5ce062200d50d888005,0,Jonathan Hurley,2016-12-02 10:19:41-05:00,['ae3ff2a09b6b36f8a456987c60fc695dd262b6bb'],0,28,28,24509268,2,0.111111111,1,1,27163
32840c1ed434ae4cc99e3ab6f7d3f2604fb69d06,1,Jonathan Hurley,2016-12-02 10:19:41-05:00,['f4ea309196a2c02b88f5e5ce062200d50d888005'],28,103,131,24509399,5,0.68,0.6,0.8,27163
60a6bd4575fb87fc26c4a277cbabf850ef2089e1,0,Jonathan Hurley,2016-12-02 10:50:50-05:00,['32840c1ed434ae4cc99e3ab6f7d3f2604fb69d06'],210,9,219,24509618,6,0.807692308,0.641025641,0.115384615,27163
232a9d87e72dfb87e0d25f6a4cba6738e27beb53,1,Tim Thorpe,2016-12-02 08:15:09-08:00,['60a6bd4575fb87fc26c4a277cbabf850ef2089e1'],83,150,233,24509851,14,0.275,0.75,0.4,27164
7eb2eaa73315189533e039b45cf90655adf25390,1,Nate Cole,2016-12-02 11:19:20-05:00,['232a9d87e72dfb87e0d25f6a4cba6738e27beb53'],6,22,28,24509879,2,0,0,1,27164
9348725b1067fab38907c8eebc172978729394ad,1,Andrii Tkach,2016-12-02 19:27:20+02:00,['7eb2eaa73315189533e039b45cf90655adf25390'],1317,813,2130,24512009,46,0.546689304,0.113752122,0.033955857,27164
def3b0ae85b968c7dd41307f4c671bf07d4fc826,1,Alex Antonenko,2016-12-02 20:13:17+02:00,['9348725b1067fab38907c8eebc172978729394ad'],21,31,52,24512061,2,1,1,1,27164
05fe42351131f77a6ee5d58da355b1c461562046,1,Nate Cole,2016-12-02 13:23:36-05:00,['def3b0ae85b968c7dd41307f4c671bf07d4fc826'],1,1,2,24512063,1,,,,27164
06327e65e9703830e003f3a6effdfe382e5c8de7,0,Nate Cole,2016-12-02 15:25:46-05:00,"['f70591b13d3f037fac58d8da4476ba7305ffc887', '05fe42351131f77a6ee5d58da355b1c461562046']",6043,5167,11210,24523273,252,,,,27164
0c837a60c6bbe7c6fb7c5586963520957bb4146f,1,Sumit Mohanty,2016-12-02 13:13:35-08:00,['05fe42351131f77a6ee5d58da355b1c461562046'],0,176,176,24523449,1,,,,27165
a58c39c9c177da52c32dd6f004cefa9658e9019d,0,Jonathan Hurley,2016-12-02 16:19:40-05:00,"['087de8b789d157aa8f4fd12963b0262ea6c40461', '0c837a60c6bbe7c6fb7c5586963520957bb4146f']",2285,2017,4302,24527751,126,,,,27165
5901b95bc3c4d718b7e7723baf403f3d5522647a,0,Jaimin Jetly,2016-12-02 14:04:05-08:00,['0c837a60c6bbe7c6fb7c5586963520957bb4146f'],1,1,2,24527753,1,,,,27165
e465c0e7a667e8c411a1ff38480bddd49e01427c,0,Jaimin Jetly,2016-12-02 14:39:39-08:00,['5901b95bc3c4d718b7e7723baf403f3d5522647a'],13,2,15,24527768,3,1,1,0,27165
db46822fbf50c5e5222bdec094b3a011584f8ee8,1,Nahappan Somasundaram,2016-12-02 15:39:25-08:00,['e465c0e7a667e8c411a1ff38480bddd49e01427c'],9,207,216,24527984,7,0.2,0.373333333,0.853333333,27165
6c411baa2f3d9bae5ba7e781ac3b4cddbf18ae82,0,Vitaly Brodetskyi,2016-12-03 01:53:32+02:00,['db46822fbf50c5e5222bdec094b3a011584f8ee8'],0,35,35,24528019,7,,,,27165
2f6942f5b6d09e07ed31e28ed70a741db899fbc7,1,Sumit Mohanty,2016-12-02 18:48:51-08:00,['6c411baa2f3d9bae5ba7e781ac3b4cddbf18ae82'],21,22,43,24528062,21,,,,27165
3096c79dfa666341154d70a7b5a0b61eb7696d52,0,Jonathan Hurley,2016-12-02 22:34:13-05:00,['2f6942f5b6d09e07ed31e28ed70a741db899fbc7'],2,2,4,24528066,1,,,,27165
3bbe75c3bd7b1a913905137465c19b2c7f7c9ba9,0,Jonathan Hurley,2016-12-02 22:40:18-05:00,"['a58c39c9c177da52c32dd6f004cefa9658e9019d', '3096c79dfa666341154d70a7b5a0b61eb7696d52']",46,269,315,24528381,40,,,,27165
5ec73bce006a659f33c09c57cb50f28037eca5d7,1,Jonathan Hurley,2016-12-03 08:22:31-05:00,['3096c79dfa666341154d70a7b5a0b61eb7696d52'],103,28,131,24528512,5,0.32,0.4,0.2,27165
12a3cd87184167cadf3cd12eb9b3c9d67dd3907a,1,Jonathan Hurley,2016-12-03 14:09:44-05:00,['5ec73bce006a659f33c09c57cb50f28037eca5d7'],29,121,150,24528662,6,0.586206897,0,0.827586207,27165
8ad494e97302d5da69224c7ce9e493d5f20797c1,1,Mugdha Varadkar,2016-12-05 10:01:09+05:18,['12a3cd87184167cadf3cd12eb9b3c9d67dd3907a'],51,339,390,24529052,25,0,0.867052023,0.439306358,27165
7f6ca9d07b2f2e389d9e887853238ca3969d99ce,1,Oleg Nechiporenko,2016-12-05 13:29:05+02:00,['8ad494e97302d5da69224c7ce9e493d5f20797c1'],36,18,54,24529106,5,0,0,0,27165
cac20e090151785edf2b8176d9ac0bddb1adc86f,0,Sandor Magyari,2016-12-05 14:07:33+01:00,['7f6ca9d07b2f2e389d9e887853238ca3969d99ce'],0,7,7,24529113,1,,,,27165
08342b3cb268481e5033c99cbf418f123e509327,1,Vitaly Brodetskyi,2016-12-05 15:12:32+02:00,['cac20e090151785edf2b8176d9ac0bddb1adc86f'],5,5,10,24529123,1,,,,27165
89b9cf5beb1304b0d90dad00b371947a3c467e8a,1,Andrew Onishuk,2016-12-05 15:23:58+02:00,['08342b3cb268481e5033c99cbf418f123e509327'],2,6,8,24529131,1,0,1,0,27165
431d2659c67f7c07fe704b67eded4f83fe30d25a,1,Dmytro Sen,2016-12-05 17:25:35+02:00,['89b9cf5beb1304b0d90dad00b371947a3c467e8a'],0,42,42,24529173,2,,,,27166
f5051dcb7f17f0e26fed9e70eef35a3758a35e60,1,Sandor Magyari,2016-12-05 16:39:13+01:00,['431d2659c67f7c07fe704b67eded4f83fe30d25a'],14,2010,2024,24531197,7,0,0.955445545,0.975247525,27169
b2d2ef1689d5434c20d6a791ace598f58742605a,1,Oleg Nechiporenko,2016-12-05 18:05:42+02:00,['f5051dcb7f17f0e26fed9e70eef35a3758a35e60'],6,23,29,24531226,3,1,1,1,27169
8fbc2718e65a3771a6af9acc48f1b06d13c32bd4,1,Dipayan Bhowmick,2016-12-06 00:51:08+05:18,['b2d2ef1689d5434c20d6a791ace598f58742605a'],10,34,44,24531270,4,,,,27169
803f44ba5f7411d9421b44dbacaa48f81ce3edc6,0,Jonathan Hurley,2016-12-05 15:21:25-05:00,"['3bbe75c3bd7b1a913905137465c19b2c7f7c9ba9', '8fbc2718e65a3771a6af9acc48f1b06d13c32bd4']",125,2502,2627,24533897,50,,,,27169
50ead4d237b0c03fee68192a5983044409e3e9db,0,Nate Cole,2016-12-05 15:27:19-05:00,['8fbc2718e65a3771a6af9acc48f1b06d13c32bd4'],22,36,58,24533955,2,0,0,1,27169
b5122e258bfe5a2e56511eb9dd29a70cf1260a9c,0,Di Li,2016-12-05 16:03:50-05:00,['50ead4d237b0c03fee68192a5983044409e3e9db'],2,2,4,24533959,2,,,,27169
a00ffffc54a8063c1728d2f3ba24db04504864da,0,Robert Levas,2016-12-05 16:42:14-05:00,['b5122e258bfe5a2e56511eb9dd29a70cf1260a9c'],9,9,18,24533977,3,1,1,1,27169
edf8ab2432af6b73f73c4ae386ff13c93c6c38c2,1,Vitaly Brodetskyi,2016-12-06 00:06:31+02:00,['a00ffffc54a8063c1728d2f3ba24db04504864da'],8,15,23,24534000,2,0,0,1,27169
c711850a8e53d3c838a4f7c5b9b81f7b133afbdf,0,Aravindan Vijayan,2016-12-05 14:30:16-08:00,['edf8ab2432af6b73f73c4ae386ff13c93c6c38c2'],2,9,11,24534011,2,1,1,0,27169
e88f84646d587549d00ef83496f4e9b61572d2cf,1,Aravindan Vijayan,2016-12-05 14:30:53-08:00,['c711850a8e53d3c838a4f7c5b9b81f7b133afbdf'],35,96,131,24534142,13,0.459459459,0.675675676,1,27169
353b2ac0064e0d014ace50acba12c523491782a8,1,Richard Zang,2016-12-05 18:11:12-08:00,['e88f84646d587549d00ef83496f4e9b61572d2cf'],25,30,55,24534197,5,1,1,1,27169
14c39691e06bde1d158c75e65251dc1dc1ba20e9,0,Oleg Nechiporenko,2016-12-06 12:14:55+02:00,['353b2ac0064e0d014ace50acba12c523491782a8'],1,3,4,24534201,1,,,,27169
a2f7a03088f553c51be40c16c1b56948a19a15b6,0,Andrii Tkach,2016-12-06 12:45:18+02:00,['14c39691e06bde1d158c75e65251dc1dc1ba20e9'],31,48,79,24534280,4,,,,27169
149104c2713f320116fc63daea0260f3eafca61b,0,Mugdha Varadkar,2016-12-06 18:22:48+05:18,['a2f7a03088f553c51be40c16c1b56948a19a15b6'],2,31,33,24534313,2,0,0.931034483,0.931034483,27169
2cd12ce4cebcf0a3a6fa58ff6f79a79b0a92f631,0,Alex Antonenko,2016-12-06 19:04:30+02:00,['149104c2713f320116fc63daea0260f3eafca61b'],32,7,39,24534352,4,0,1,1,27169
0f297510640f24db5c11bfbabaa390bb29e619a6,0,Alex Antonenko,2016-12-06 19:04:30+02:00,['2cd12ce4cebcf0a3a6fa58ff6f79a79b0a92f631'],2,26,28,24534380,1,0.947368421,1,1,27169
9b46fd2acd6a5d1bd8ce474315fb318f1cfe6a3a,0,Alex Antonenko,2016-12-06 19:18:34+02:00,['0f297510640f24db5c11bfbabaa390bb29e619a6'],2,75,77,24534457,2,1,1,1,27169
502d4447fa7f78421e606cff83661b41c4923a61,0,Aravindan Vijayan,2016-12-06 12:07:48-08:00,['9b46fd2acd6a5d1bd8ce474315fb318f1cfe6a3a'],4,5,9,24534466,2,,,,27169
641886160877e4bc4c38e9d461967285d77bd0c3,0,Siddharth Wagle,2016-12-06 12:50:18-08:00,['502d4447fa7f78421e606cff83661b41c4923a61'],6,6,12,24534478,1,,1,,27169
9a938e6cc27811057895d495f700a8e874c69a10,1,Aravindan Vijayan,2016-12-06 12:50:54-08:00,['641886160877e4bc4c38e9d461967285d77bd0c3'],16,16,32,24534510,4,,,,27169
757267fc6c62dff71aeb162976de39278d40aa04,1,Alejandro Fernandez,2016-12-06 16:51:28-08:00,['9a938e6cc27811057895d495f700a8e874c69a10'],0,3187,3187,24537697,33,0.443207127,0.425389755,0.926503341,27202
aed983973034114931aca387f92bae5ca0d4e169,1,Alejandro Fernandez,2016-12-06 16:52:32-08:00,['757267fc6c62dff71aeb162976de39278d40aa04'],0,54,54,24537751,1,,,,27203
2a710b3587965c09e7b034ea79a7eca31fc35c25,1,Alejandro Fernandez,2016-12-06 16:53:31-08:00,['aed983973034114931aca387f92bae5ca0d4e169'],0,2426,2426,24540177,13,,,,27216
a62119ab9f1abc355bc99ee0fc71afac6723d827,1,Alejandro Fernandez,2016-12-06 16:54:11-08:00,['2a710b3587965c09e7b034ea79a7eca31fc35c25'],0,3419,3419,24543596,17,,,,27233
1e261db06128143a4e631aff899704cf12709413,1,Xi Wang,2016-12-06 17:25:21-08:00,['a62119ab9f1abc355bc99ee0fc71afac6723d827'],14,26,40,24543636,3,,,,27233
9170b49933106a0af651530d827af4f4e73f1541,0,"Toader, Sebastian",2016-12-07 09:55:26+01:00,['1e261db06128143a4e631aff899704cf12709413'],14,35,49,24543685,12,,,,27234
6806edcd94dd5568b8a21ec757fa7fa668eec71c,0,"Toader, Sebastian",2016-12-07 10:44:23+01:00,['9170b49933106a0af651530d827af4f4e73f1541'],35,14,49,24543734,12,,,,27234
304a5bf6027efa9e70b1deaba325d54e586e4292,1,"Toader, Sebastian",2016-12-07 10:45:54+01:00,['6806edcd94dd5568b8a21ec757fa7fa668eec71c'],15,274,289,24544023,19,1,1,1,27239
165c4d692b4a76e2911027ac3f06d1948fb696e7,0,Andrii Tkach,2016-12-07 12:47:42+02:00,['304a5bf6027efa9e70b1deaba325d54e586e4292'],1,2,3,24544026,1,,,,27239
49d089586381f44882c57e0a5b8e029e775fe1de,0,Aleksandr Kovalenko,2016-12-07 13:01:58+02:00,['165c4d692b4a76e2911027ac3f06d1948fb696e7'],5,1,6,24544032,1,0,0,0,27239
69cdaa775f8c0990efa052c806d41db02c3acc52,1,oleewere,2016-12-07 12:28:59+01:00,['49d089586381f44882c57e0a5b8e029e775fe1de'],4,8,12,24544044,6,1,1,1,27239
234838f4b6651dbebf09d57910aea925c8247f1c,1,Oleg Nechiporenko,2016-12-07 15:01:08+02:00,['69cdaa775f8c0990efa052c806d41db02c3acc52'],5,7,12,24544056,2,,,,27239
90cb3a4ce92c4cfb57356073d1fa603e2403f632,0,Nate Cole,2016-12-07 09:59:40-05:00,"['06327e65e9703830e003f3a6effdfe382e5c8de7', '234838f4b6651dbebf09d57910aea925c8247f1c']",414,12765,13179,24557235,229,,,,27239
9e1318ecc2e95c72cc0980cd4d8da1c04210b46b,1,Miklos Gergely,2016-12-07 16:35:04+01:00,['234838f4b6651dbebf09d57910aea925c8247f1c'],76,73,149,24557384,2,1,0,0,27239
38827c0706f3463b912251908f786d3b67096ce1,0,Di Li,2016-12-07 11:22:05-05:00,['9e1318ecc2e95c72cc0980cd4d8da1c04210b46b'],20,23,43,24557427,2,1,0.666666667,1,27239
cebdb67c5eabc25a619e15288792bd7534ca330d,0,Di Li,2016-12-07 11:32:25-05:00,['38827c0706f3463b912251908f786d3b67096ce1'],2,2,4,24557431,1,,,,27239
4bc1a73f4c598b84b7a6ba368a5f7381abe5113b,0,Alex Antonenko,2016-12-07 19:01:03+02:00,['cebdb67c5eabc25a619e15288792bd7534ca330d'],0,1,1,24557432,1,1,1,1,27239
9fc7f0ae153ec90229fedc62d2fd35b3eb0c5843,0,Oleg Nechiporenko,2016-12-07 19:07:32+02:00,['4bc1a73f4c598b84b7a6ba368a5f7381abe5113b'],24,28,52,24557484,3,0,0,0,27239
99afb8bf67c8278d78f960ab2017a6e451cb58ae,0,Sandor Magyari,2016-12-07 18:19:43+01:00,['9fc7f0ae153ec90229fedc62d2fd35b3eb0c5843'],6,11,17,24557501,2,0,0,1,27239
d56576d78a3e83f7ee5550e81531d4b13d8fceeb,1,Sangeeta Ravindran,2016-12-07 10:28:27-08:00,['99afb8bf67c8278d78f960ab2017a6e451cb58ae'],1,1,2,24557503,1,,,,27239
51ec956b14378d8d0fdab03fa8d2e60559772d1f,1,Sumit Mohanty,2016-12-07 10:38:52-08:00,['d56576d78a3e83f7ee5550e81531d4b13d8fceeb'],5,122,127,24557630,4,0.269230769,0.846153846,0.256410256,27239
d1293e01841d0975d1a3d76dbf676ef27a4bace9,0,Siddharth Wagle,2016-12-07 12:22:55-08:00,['51ec956b14378d8d0fdab03fa8d2e60559772d1f'],0,1,1,24557631,1,0,0,1,27239
88c2892527b0a6ee97a3e237ebc76a896ce865e9,0,Jonathan Hurley,2016-12-07 16:16:53-05:00,"['803f44ba5f7411d9421b44dbacaa48f81ce3edc6', 'd1293e01841d0975d1a3d76dbf676ef27a4bace9']",377,10080,10457,24568088,159,,,,27239
96e69d58ee2b70123331a1b59450e1dfbeb4eccb,1,Jaimin Jetly,2016-12-07 13:40:03-08:00,['d1293e01841d0975d1a3d76dbf676ef27a4bace9'],194,142,336,24568424,12,1,0,0,27239
97e3de68f7f2d42a98802dde4bf91d154170f9f3,0,Jonathan Hurley,2016-12-07 16:49:43-05:00,"['96e69d58ee2b70123331a1b59450e1dfbeb4eccb', '88c2892527b0a6ee97a3e237ebc76a896ce865e9']",1726,1197,2923,24571347,57,,,,27239
0fa8238c7eda8a2b3fa826d8aafb97ee64f27e00,1,Richard Zang,2016-12-07 15:33:08-08:00,['97e3de68f7f2d42a98802dde4bf91d154170f9f3'],56,46,102,24571449,7,0.3,0.3,0,27239
9652b2313e52f724dbffd07bab54901c3b9b060c,1,Nahappan Somasundaram,2016-12-07 16:23:46-08:00,['0fa8238c7eda8a2b3fa826d8aafb97ee64f27e00'],44,218,262,24571711,5,0.076923077,0.076923077,0.415384615,27239
613110b4194ba13b012778c13ee9e350ec87b774,0,Sumit Mohanty,2016-12-07 16:43:01-08:00,['9652b2313e52f724dbffd07bab54901c3b9b060c'],0,125,125,24571836,2,,,,27241
938a533a382cee5e630dfedfea73af7612140a99,0,Sumit Mohanty,2016-12-07 23:02:07-08:00,['613110b4194ba13b012778c13ee9e350ec87b774'],125,0,125,24571961,2,,,,27241
33f74cd2001662972d6d37b17025faedf600cb0e,0,Sumit Mohanty,2016-12-07 23:02:18-08:00,['938a533a382cee5e630dfedfea73af7612140a99'],0,125,125,24572086,2,,,,27243
ba3e0869a17186f66ca28762faf60542b7f6a14f,1,Miklos Gergely,2016-12-08 10:38:51+01:00,['33f74cd2001662972d6d37b17025faedf600cb0e'],118,471,589,24572675,14,0,1,0,27243
a62a4f3b7e0ebb25931ad99815360b462d4f9f80,0,Aleksandr Kovalenko,2016-12-08 12:57:40+02:00,['ba3e0869a17186f66ca28762faf60542b7f6a14f'],10,16,26,24572701,1,1,1,1,27243
cdf65c3450c02f96760fab940a074eaa8583be70,1,Dmytro Sen,2016-12-08 13:55:33+02:00,['a62a4f3b7e0ebb25931ad99815360b462d4f9f80'],1,2180,2181,24574882,40,0.413716814,0.544247788,0.800884956,27260
c4728f2f71f899ca1be98da0a85bdfcb514e07c8,0,Andrew Onishuk,2016-12-08 14:00:50+02:00,['cdf65c3450c02f96760fab940a074eaa8583be70'],2,6,8,24574890,2,0,0,1,27260
75e182eb19d6c867dd16377c9c4e1c792c568395,1,Vitaly Brodetskyi,2016-12-08 14:07:42+02:00,['c4728f2f71f899ca1be98da0a85bdfcb514e07c8'],2,3,5,24574895,1,0,1,1,27260
18d1b0cd4acccf04de6f963274d6f4662f92a966,0,ababiichuk,2016-12-08 15:40:46+02:00,['75e182eb19d6c867dd16377c9c4e1c792c568395'],2,73,75,24574970,2,0.231884058,1,1,27260
3ffc95607adb2ecd1b2a3ccc84db475351e9a8d3,0,Sandor Magyari,2016-12-08 15:40:08+01:00,['18d1b0cd4acccf04de6f963274d6f4662f92a966'],11,6,17,24574987,2,1,1,0,27260
8fa1e8bab925bb438311143d710879ac29ea0706,1,oleewere,2016-12-08 16:29:07+01:00,['3ffc95607adb2ecd1b2a3ccc84db475351e9a8d3'],8,141,149,24575136,7,0.8125,1,1,27262
bd4a02fb432013147ae7182d6a8286f9c89845a9,0,Vitaly Brodetskyi,2016-12-08 17:35:25+02:00,['8fa1e8bab925bb438311143d710879ac29ea0706'],2,104,106,24575242,2,0.180555556,0.888888889,1,27262
a27c0dd34608cd99fc47d4a6b2e2ab532f0e03eb,0,Sandor Magyari,2016-12-08 18:34:06+01:00,['bd4a02fb432013147ae7182d6a8286f9c89845a9'],1,1,2,24575244,1,,,,27262
b2a8edf8edf77ae49d4b922590f6d4dcdedc5e4d,1,Aravindan Vijayan,2016-12-08 12:58:07-08:00,['a27c0dd34608cd99fc47d4a6b2e2ab532f0e03eb'],0,9,9,24575253,2,0.428571429,0,1,27262
72586a1ed95728dff642758545cc9676fb77aa9e,1,Jonathan Hurley,2016-12-08 17:34:49-05:00,['b2a8edf8edf77ae49d4b922590f6d4dcdedc5e4d'],110,253,363,24575616,4,0.508474576,1,1,27262
647c6f27e21c1f3ac620b039860cbb9c176acb2f,1,Alejandro Fernandez,2016-12-08 15:12:32-08:00,['72586a1ed95728dff642758545cc9676fb77aa9e'],1770,32674,34444,24610060,119,0.278015398,0.399272883,0.688836612,27350
da2228fb3fe10c485ba374030eef85151cf8565d,1,Sangeeta Ravindran,2016-12-08 15:32:40-08:00,['647c6f27e21c1f3ac620b039860cbb9c176acb2f'],2,6,8,24610068,2,1,1,1,27350
0e4cac685b90861a44837ca9100ef2468992d47b,0,Sumit Mohanty,2016-12-08 21:37:10-08:00,['da2228fb3fe10c485ba374030eef85151cf8565d'],2,2,4,24610072,1,,,,27350
6a55220d16f04ddb3e7fc03f17d73f468ccd77c4,0,oleewere,2016-12-09 11:53:20+01:00,['0e4cac685b90861a44837ca9100ef2468992d47b'],0,6,6,24610078,1,0,1,1,27350
66c6d5607867a95d29deee00407ef8b7ef22ee03,1,Andrii Tkach,2016-12-09 13:18:30+02:00,['6a55220d16f04ddb3e7fc03f17d73f468ccd77c4'],450,315,765,24610843,6,1,1,0,27350
a8222ae3b8dd909764f90083396045c4db7dcceb,1,Lisnichenko Dmitro,2016-12-09 16:43:20+02:00,['66c6d5607867a95d29deee00407ef8b7ef22ee03'],4,293,297,24611140,7,0.217821782,0.306930693,1,27350
c8ae4b4157df72e735457e0a62d9197742e7f150,0,Sumit Mohanty,2016-12-09 06:58:46-08:00,['a8222ae3b8dd909764f90083396045c4db7dcceb'],0,56,56,24611196,2,0,0.957446809,0.957446809,27350
d6c0587a317127b44f258b3f160284695e412f3e,0,Alex Antonenko,2016-12-09 20:15:01+02:00,['c8ae4b4157df72e735457e0a62d9197742e7f150'],2,2,4,24611200,1,,,,27350
09fba63242eeb3c2cd6a06d9b23e11fcea5dee30,1,Alejandro Fernandez,2016-12-09 11:38:08-08:00,['d6c0587a317127b44f258b3f160284695e412f3e'],0,2,2,24611202,1,,,,27350
646cfc681f9438ac56f4e3b864c0fd2402091082,1,Mugdha Varadkar,2016-12-10 18:51:37+05:18,['09fba63242eeb3c2cd6a06d9b23e11fcea5dee30'],35,789,824,24612026,17,0.114186851,1,1,27357
ab9acef421af40ddb88fe7589c16d1868fda55f3,1,Sumit Mohanty,2016-12-11 22:01:54-08:00,['646cfc681f9438ac56f4e3b864c0fd2402091082'],3349,1458,4807,24616833,24,1,0,0,27361
eae049976813c263201f042c124e004cefa80c42,1,Andrii Tkach,2016-12-12 13:00:48+02:00,['ab9acef421af40ddb88fe7589c16d1868fda55f3'],4,6,10,24616843,3,1,1,1,27361
63dc498c1d660277abd719ddfa9a256e36869718,1,oleewere,2016-12-12 13:11:01+01:00,['eae049976813c263201f042c124e004cefa80c42'],12,70,82,24616925,3,0.222222222,0.277777778,0.972222222,27361
c6f90cf6a37148b7de5b1d1d13aa62c807eaab79,1,Lisnichenko Dmitro,2016-12-12 15:51:05+02:00,['63dc498c1d660277abd719ddfa9a256e36869718'],1,6,7,24616932,1,0,0,0,27361
9ccd9979c72812d58e220158c2869a053883b392,0,Lisnichenko Dmitro,2016-12-12 16:47:36+02:00,['c6f90cf6a37148b7de5b1d1d13aa62c807eaab79'],12,16,28,24616960,1,0,0,0,27361
baad9b9cdd4783a889ce8dab5395ca9f2ad7533a,1,Andrew Onishuk,2016-12-12 17:34:09+02:00,['9ccd9979c72812d58e220158c2869a053883b392'],12,64,76,24617036,17,1,1,1,27362
cc5645831dfcb59b9318bd29eea5a741ba7097be,0,oleewere,2016-12-12 16:57:31+01:00,['baad9b9cdd4783a889ce8dab5395ca9f2ad7533a'],8,8,16,24617052,1,,,,27362
e990fb8fcb6b2678b0c0c32f2689065a3f6616b3,0,oleewere,2016-12-12 16:57:56+01:00,['cc5645831dfcb59b9318bd29eea5a741ba7097be'],0,19,19,24617071,1,,,,27363
076ed757b83a5d6907f7239f6de1334c81aeecc7,0,oleewere,2016-12-12 16:58:54+01:00,['e990fb8fcb6b2678b0c0c32f2689065a3f6616b3'],12,27,39,24617110,7,0,0,1,27363
66124ac8a31894637ed95094d1e40d9e7e86a791,1,oleewere,2016-12-12 17:22:30+01:00,['076ed757b83a5d6907f7239f6de1334c81aeecc7'],3,8,11,24617121,4,0,1,1,27363
e4db57093f4d17497366cdfbf02127f36399bf42,1,Jonathan Hurley,2016-12-12 12:24:40-05:00,['66124ac8a31894637ed95094d1e40d9e7e86a791'],6649,7197,13846,24630967,1184,,,,27363
b69bcc1f2d14bff050571bc165110a59e701dd83,1,Aleksandr Kovalenko,2016-12-12 19:57:21+02:00,['e4db57093f4d17497366cdfbf02127f36399bf42'],1,7,8,24630975,2,0.666666667,0.666666667,1,27363
79d743b9d14530106ef107611f58345fb7f2e93b,0,Jaimin Jetly,2016-12-12 18:11:17-08:00,['b69bcc1f2d14bff050571bc165110a59e701dd83'],26,31,57,24631032,8,0.5,1,1,27363
d3666b3ac0942b01e99526dea73bb7c799308bfe,1,Lisnichenko Dmitro,2016-12-13 12:52:16+02:00,['79d743b9d14530106ef107611f58345fb7f2e93b'],3,2,5,24631037,2,,,,27363
3eabb7c27a17fdb5012d87e6a30e53e00be4309d,1,oleewere,2016-12-13 12:01:29+01:00,['d3666b3ac0942b01e99526dea73bb7c799308bfe'],2,12,14,24631051,4,0,1,1,27363
9ff6b22e9953a654c2cff9562967ed5be015b6a8,1,Lisnichenko Dmitro,2016-12-13 13:03:18+02:00,['3eabb7c27a17fdb5012d87e6a30e53e00be4309d'],2,6,8,24631059,1,1,1,1,27363
d7ccc4c990291750cda968a8b65ee25a64f1220a,1,Andrii Tkach,2016-12-13 13:17:57+02:00,['9ff6b22e9953a654c2cff9562967ed5be015b6a8'],31,100,131,24631190,6,0.647058824,1,1,27363
aef605ebcc91ac048998aa7f585c0e34d2398c94,1,Robert Levas,2016-12-13 06:18:17-05:00,['d7ccc4c990291750cda968a8b65ee25a64f1220a'],40,230,270,24631460,4,0.122641509,0.443396226,0.08490566,27363
033a281571177db85305d182274f0f01e9c612e5,0,Vitaly Brodetskyi,2016-12-13 13:28:41+02:00,['aef605ebcc91ac048998aa7f585c0e34d2398c94'],2,19,21,24631481,1,0.571428571,0.642857143,0.428571429,27363
69825b9ff20dd8c394e14f5acf1faa4f58246843,1,Dmytro Sen,2016-12-13 14:30:54+02:00,['033a281571177db85305d182274f0f01e9c612e5'],74,2,76,24631557,4,0.962962963,0,0,27363
e148cb5a2ab5f1a64b0ba5c8c8ad01d396bd57ac,1,ababiichuk,2016-12-13 15:12:25+02:00,['69825b9ff20dd8c394e14f5acf1faa4f58246843'],105,296,401,24631958,6,0.446428571,1,0,27364
2f038b2709068c0237b80f0b176d39abb434f9b2,1,Miklos Gergely,2016-12-13 16:14:23+01:00,['e148cb5a2ab5f1a64b0ba5c8c8ad01d396bd57ac'],48,332,380,24632338,19,1,1,1,27369
70303d0c6526c92f53f95fa283f88de08b103559,0,Di Li,2016-12-13 11:53:56-05:00,['2f038b2709068c0237b80f0b176d39abb434f9b2'],7,7,14,24632352,3,,,,27369
e70985490ce387fdaea18f80cabead47d34a5e8c,1,Aleksandr Kovalenko,2016-12-13 19:18:33+02:00,['70303d0c6526c92f53f95fa283f88de08b103559'],1,2,3,24632355,1,,,,27369
bd308247344ea067bcf2f120c28e5bc0eb312c58,0,Jonathan Hurley,2016-12-13 13:12:12-05:00,['e70985490ce387fdaea18f80cabead47d34a5e8c'],2,0,2,24632357,1,,,,27369
176a1c6ba4187c24d7203a69c5ab257e778956a4,1,oleewere,2016-12-13 20:41:24+01:00,['bd308247344ea067bcf2f120c28e5bc0eb312c58'],23,218,241,24632598,7,0.552845528,0.691056911,0.666666667,27369
2fee4286b69153b6f7727bc96bfe13764bebaadc,0,Di Li,2016-12-13 16:20:27-05:00,['176a1c6ba4187c24d7203a69c5ab257e778956a4'],2,2,4,24632602,1,,,,27369
a7a53896ac50ccd035288cc0d94f0e879448d083,0,Mugdha Varadkar,2016-12-14 14:16:51+05:18,['2fee4286b69153b6f7727bc96bfe13764bebaadc'],0,27,27,24632629,9,,,,27369
c3669229ff0f6da6e8a96e239607a0782a5d2c75,1,Andrii Tkach,2016-12-14 12:24:46+02:00,['a7a53896ac50ccd035288cc0d94f0e879448d083'],44,2,46,24632675,4,0.258064516,0,0,27369
bc3c23a23aadd59971c6e14fe6cdf5990ac71a45,1,Andrii Tkach,2016-12-14 12:51:04+02:00,['c3669229ff0f6da6e8a96e239607a0782a5d2c75'],83,8,91,24632766,5,1,0.342857143,0.342857143,27369
1f38a7094da22846576f856233d4d17faa22144c,0,Vitaly Brodetskyi,2016-12-14 13:32:56+02:00,['bc3c23a23aadd59971c6e14fe6cdf5990ac71a45'],0,1,1,24632767,1,,,,27369
b50546e0cfa1fdb415d10d0e197c72fd7c9a195f,0,Dmytro Sen,2016-12-14 15:26:22+02:00,['1f38a7094da22846576f856233d4d17faa22144c'],1,0,1,24632768,1,1,1,1,27369
b0e4c938935b3eaee076b419d081439dec6c7812,1,Alex Antonenko,2016-12-14 15:47:04+02:00,['b50546e0cfa1fdb415d10d0e197c72fd7c9a195f'],9,7,16,24632784,1,,,,27369
6153b03725d41bbfbd7c801643ec808184817dc7,1,Oleg Nechiporenko,2016-12-14 15:50:37+02:00,['b0e4c938935b3eaee076b419d081439dec6c7812'],3,5,8,24632792,2,1,1,1,27369
b028fc86ab8898c9e9621bdd0907826431301e65,0,Andrii Tkach,2016-12-14 17:38:20+02:00,['6153b03725d41bbfbd7c801643ec808184817dc7'],10,9,19,24632811,2,1,1,0,27369
4910de95e36e3d15144b8e61f98499d117c6692d,1,Vitaly Brodetskyi,2016-12-14 18:17:18+02:00,['b028fc86ab8898c9e9621bdd0907826431301e65'],4,8,12,24632823,2,0,1,0,27369
30511fad8a454f57c90b5a0bcde9c6e188495f3b,1,Sumit Mohanty,2016-12-14 08:54:35-08:00,['4910de95e36e3d15144b8e61f98499d117c6692d'],2,27,29,24632852,2,,,,27369
db9dfd60a1930c3ee18322179a1ebe3d795263e8,1,Lisnichenko Dmitro,2016-12-14 19:10:56+02:00,['30511fad8a454f57c90b5a0bcde9c6e188495f3b'],32,66,98,24632950,13,0,0.85,0.8,27369
cb8182e9adaaa29427f4a8d95a04e50f55fde2e8,0,Andrew Onishuk,2016-12-14 20:04:42+02:00,['db9dfd60a1930c3ee18322179a1ebe3d795263e8'],2,0,2,24632952,2,,,,27369
7dcabf5656963a2b81dae13fa03ac51638b1eb26,0,Andrew Onishuk,2016-12-14 20:07:39+02:00,['cb8182e9adaaa29427f4a8d95a04e50f55fde2e8'],13,12,25,24632977,1,1,1,1,27369
162ee83c552e2c418cc2ee97dbb3687ffc8e1ae3,1,Di Li,2016-12-14 15:08:13-05:00,['7dcabf5656963a2b81dae13fa03ac51638b1eb26'],14,265,279,24633256,15,0.234375,0.875,0.609375,27374
f936fd04ddbffa0cd78e827d61c2a27c4be1270c,1,Yusaku Sako,2016-12-14 12:43:53-08:00,['162ee83c552e2c418cc2ee97dbb3687ffc8e1ae3'],13,101,114,24633370,3,1,1,1,27374
b77b2fac39bc06df1d5b6a59d1be4d6bdd8b0386,1,Renjith Kamath,2016-12-15 11:47:13+05:18,['f936fd04ddbffa0cd78e827d61c2a27c4be1270c'],45,133,178,24633548,4,0.222222222,0.222222222,1,27375
61255affedf34ea0c29bfe513945e81f4a1d6a74,1,Renjith Kamath,2016-12-15 11:56:47+05:18,['b77b2fac39bc06df1d5b6a59d1be4d6bdd8b0386'],75,88,163,24633711,1,,,,27375
060387783ba2aef22b5fa24e7322a37d5cc91332,1,Andrew Onishuk,2016-12-15 12:41:52+02:00,['61255affedf34ea0c29bfe513945e81f4a1d6a74'],8,45,53,24633764,6,,,,27375
3ad2ffb851831aa958b0f5a479e7f84d52c815a7,1,Aleksandr Kovalenko,2016-12-15 13:40:13+02:00,['060387783ba2aef22b5fa24e7322a37d5cc91332'],3,66,69,24633833,3,1,1,1,27375
c41208dc980a546dc058bf917650e3726dc0e682,1,Aleksandr Kovalenko,2016-12-15 15:30:41+02:00,['3ad2ffb851831aa958b0f5a479e7f84d52c815a7'],14,14,28,24633861,9,,,,27375
58443cb7b2ef4b958794e8f01cae9798ddba3393,1,Jonathan Hurley,2016-12-15 09:31:36-05:00,['c41208dc980a546dc058bf917650e3726dc0e682'],27,67,94,24633955,3,0.631578947,0.736842105,1,27375
a88c4e841ffa986fe01768e70904585b1e9670d4,0,Oleg Nechiporenko,2016-12-15 16:48:57+02:00,['58443cb7b2ef4b958794e8f01cae9798ddba3393'],2,2,4,24633959,1,,,,27375
e307b86c34c0ef945a154f99e322ffc6e9206841,0,Sumit Mohanty,2016-12-15 07:18:30-08:00,['a88c4e841ffa986fe01768e70904585b1e9670d4'],0,2,2,24633961,2,,,,27375
13dd1cf4753864525cfee2fdb7cb722aa3ff86c7,1,Andrii Tkach,2016-12-15 17:39:25+02:00,['e307b86c34c0ef945a154f99e322ffc6e9206841'],4,4,8,24633969,2,,,,27375
65fe71a1bc41da9e935dff75e92988d4a1c8bff9,1,Oleg Nechiporenko,2016-12-15 17:56:15+02:00,['13dd1cf4753864525cfee2fdb7cb722aa3ff86c7'],168,122,290,24634259,8,1,0,0,27375
f7399125edb9615ad7cb7842b084314307495a83,1,"Toader, Sebastian",2016-12-15 17:04:22+01:00,['65fe71a1bc41da9e935dff75e92988d4a1c8bff9'],300,416,716,24634975,21,0,0,0.538461538,27375
c74df6f574a5c209208428bf4afba9ba0a394d9c,1,Renjith Kamath,2016-12-15 22:51:54+05:18,['f7399125edb9615ad7cb7842b084314307495a83'],0,20,20,24634995,1,,,,27375
7bf3a098cb2e38692751fd51b5ebf7470b5c9cb9,0,Aravindan Vijayan,2016-12-15 10:11:20-08:00,['c74df6f574a5c209208428bf4afba9ba0a394d9c'],0,3,3,24634998,1,0,0,1,27375
af6aba67bbb26d4116532d45f3ea0117aa3cb6a8,1,Bob Nettleton,2016-12-15 15:26:41-05:00,['7bf3a098cb2e38692751fd51b5ebf7470b5c9cb9'],56,340,396,24635394,17,0.379310345,0.939655172,1,27375
8fc0ac7cca3a7df7aa16374508ab8467e6897a76,1,Sumit Mohanty,2016-12-15 18:29:52-08:00,['af6aba67bbb26d4116532d45f3ea0117aa3cb6a8'],68,146,214,24635608,9,0,0.657894737,0.828947368,27375
fb567758d71a4b90afa95d180f8340f6217f4f47,1,Nitiraj Rathore,2016-12-16 14:51:57+05:18,['8fc0ac7cca3a7df7aa16374508ab8467e6897a76'],635,3538,4173,24639781,92,0.781659389,0.934497817,0.905385735,27409
791a24cda09a2fb97e2a36fbb9653c6f9b487ec1,1,Andrii Tkach,2016-12-16 12:31:14+02:00,['fb567758d71a4b90afa95d180f8340f6217f4f47'],16,32,48,24639829,2,0.428571429,1,1,27409
aa16f5ed8836241e9187766b684c51ddcb5f0eeb,0,Vitaly Brodetskyi,2016-12-16 15:38:37+02:00,['791a24cda09a2fb97e2a36fbb9653c6f9b487ec1'],4,12,16,24639845,2,0,1,0.428571429,27409
4a5b2f6f5ad2315339ca4ccf26099968b76b16b9,1,Lisnichenko Dmitro,2016-12-16 16:41:43+02:00,['aa16f5ed8836241e9187766b684c51ddcb5f0eeb'],2,3,5,24639850,1,,,,27409
edce0b1173b6629e50b053be140490fa288ec361,1,Nate Cole,2016-12-16 11:18:40-05:00,['4a5b2f6f5ad2315339ca4ccf26099968b76b16b9'],699,746,1445,24641295,116,0,0,1,27409
ab4b864c4e3278e1c154bd294b993a7594255e5a,1,Alejandro Fernandez,2016-12-16 10:57:03-08:00,['edce0b1173b6629e50b053be140490fa288ec361'],4,4,8,24641303,108,,,,27409
44e60728fe74ce80026eb96a220172f4488d203a,1,Jonathan Hurley,2016-12-16 14:20:31-05:00,['ab4b864c4e3278e1c154bd294b993a7594255e5a'],3,34,37,24641340,3,0,0,1,27409
fd1ff56afba1cb84367947c7440371464ff594a5,1,Sandor Magyari,2016-12-16 21:42:35+01:00,['44e60728fe74ce80026eb96a220172f4488d203a'],3,7,10,24641350,1,1,1,1,27409
e8a6b85de5ead2b9feb8afd0c39fa57eeb5bcc4e,1,Alejandro Fernandez,2016-12-16 13:39:57-08:00,['fd1ff56afba1cb84367947c7440371464ff594a5'],2,2,4,24641354,1,,,,27409
e7399fe9c1f93129e46648ce3f76192bc7e7d3b0,1,Nate Cole,2016-12-16 17:01:37-05:00,"['90cb3a4ce92c4cfb57356073d1fa603e2403f632', 'e8a6b85de5ead2b9feb8afd0c39fa57eeb5bcc4e']",17349,55810,73159,24714513,1819,,,,27409
7ec550aaefc3eac236933e198994bbb3bc2d573a,0,Sumit Mohanty,2016-12-18 21:18:07-08:00,['e8a6b85de5ead2b9feb8afd0c39fa57eeb5bcc4e'],2,5,7,24714520,1,,,,27409
fce9d6e090c9433f5783871aab73cdb3e16c9335,0,Renjith Kamath,2016-12-19 12:29:13+05:18,['7ec550aaefc3eac236933e198994bbb3bc2d573a'],1,0,1,24714521,1,1,1,0,27409
61dcdc3f1db0f8091ab3314f6746dace68847178,1,"Toader, Sebastian",2016-12-19 10:47:47+01:00,['fce9d6e090c9433f5783871aab73cdb3e16c9335'],2,680,682,24715203,12,0.718918919,0.864864865,1,27420
195f3ce164e6654b77813c412fe70fe240bb58c1,1,ababiichuk,2016-12-19 12:13:32+02:00,['61dcdc3f1db0f8091ab3314f6746dace68847178'],450,287,737,24715940,7,0.232394366,0.063380282,0.323943662,27420
32896cb686599999b49ee30f56cc5efd9d642454,0,Andrew Onishuk,2016-12-19 15:06:57+02:00,['195f3ce164e6654b77813c412fe70fe240bb58c1'],0,8,8,24715948,1,1,1,1,27420
9cb96ad08fe2ff148a4fdb148fc6358ebb8155d0,0,Sumit Mohanty,2016-12-19 07:04:14-08:00,['32896cb686599999b49ee30f56cc5efd9d642454'],61,1,62,24716010,3,1,1,0,27420
a08bdc0618ca99d98ae6b93a0a15c278eeec5f75,1,Vitaly Brodetskyi,2016-12-19 17:42:57+02:00,['9cb96ad08fe2ff148a4fdb148fc6358ebb8155d0'],1,71,72,24716082,2,0.16,1,0.88,27420
f9d37dfbc9b23b92eb3fd2514611513066c3300d,0,Alex Antonenko,2016-12-19 18:18:12+02:00,['a08bdc0618ca99d98ae6b93a0a15c278eeec5f75'],1,1,2,24716084,1,,,,27420
f0544dfa9a1bf462451dbbaf688ceb22e5ceb773,1,Robert Levas,2016-12-19 12:40:53-05:00,['f9d37dfbc9b23b92eb3fd2514611513066c3300d'],4,83,87,24716171,3,0.553191489,0.893617021,0.468085106,27420
72e9d4a4fb6a09b436a363b7ba8cdf6f6fa17132,0,Andrii Tkach,2016-12-19 20:09:35+02:00,['f0544dfa9a1bf462451dbbaf688ceb22e5ceb773'],6,16,22,24716193,3,1,1,0,27420
8a125c57a383c926f4ae9961b8b1ef7941bad6f1,1,Sangeeta Ravindran,2016-12-19 10:33:00-08:00,['72e9d4a4fb6a09b436a363b7ba8cdf6f6fa17132'],0,6,6,24716199,1,,,,27420
6da5935bdffee119909741637f8404f7f807f7ec,0,Aravindan Vijayan,2016-12-19 13:16:54-08:00,['8a125c57a383c926f4ae9961b8b1ef7941bad6f1'],5,6,11,24716210,2,,,,27420
28f1f2e5e21583174be497eb1ad7c8f1a290332f,0,pallavkul,2016-12-20 17:22:44+05:18,['6da5935bdffee119909741637f8404f7f807f7ec'],8,25,33,24716243,7,1,1,1,27420
95e9804acdd7fa806357feb84d1e9c7f589dd8a0,1,Dmytro Sen,2016-12-20 15:12:46+02:00,['28f1f2e5e21583174be497eb1ad7c8f1a290332f'],0,74,74,24716317,2,0,0.795454545,0.204545455,27420
7a87817b8cd4730e2b648bb42e2e2a1b1661c775,0,Nate Cole,2016-12-20 09:34:42-05:00,"['e7399fe9c1f93129e46648ce3f76192bc7e7d3b0', '95e9804acdd7fa806357feb84d1e9c7f589dd8a0']",541,1263,1804,24718121,46,,,,27420
749a5b2dc583a5571b28e2710f0018abe7f12383,0,Nate Cole,2016-12-20 09:54:41-05:00,['95e9804acdd7fa806357feb84d1e9c7f589dd8a0'],125,232,357,24718478,23,1,1,1,27422
d1317dfba2ea3499c2bf4d42daf0f2a278d1227f,0,Nate Cole,2016-12-20 10:34:18-05:00,['749a5b2dc583a5571b28e2710f0018abe7f12383'],31,142,173,24718651,57,1,1,1,27423
64f3b39ba3bcef59cdca94b3b29dde37feb0e7f0,1,Di Li,2016-12-20 11:36:15-05:00,['d1317dfba2ea3499c2bf4d42daf0f2a278d1227f'],6,6,12,24718663,6,,,,27423
c01f4d809dfd4134fa789fd0496d73877117ba14,0,Di Li,2016-12-20 12:01:13-05:00,['64f3b39ba3bcef59cdca94b3b29dde37feb0e7f0'],1,12,13,24718676,1,0,0,0,27423
d48b8d9b0852d22af4f9bb2191c51c706e292460,1,Robert Levas,2016-12-20 12:55:46-05:00,['c01f4d809dfd4134fa789fd0496d73877117ba14'],109,426,535,24719211,15,0.23,0.84,0.32,27423
688830c63f784588aa4c0b47a68c884df5fd5516,1,Xi Wang,2016-12-20 10:31:10-08:00,['d48b8d9b0852d22af4f9bb2191c51c706e292460'],188,155,343,24719554,6,0,0,0,27423
51c4f92c12c876119cca0f0fc0269597c004dba1,1,Di Li,2016-12-20 15:41:29-05:00,['688830c63f784588aa4c0b47a68c884df5fd5516'],1,2,3,24719557,1,0,0,1,27423
4fc52a61f5515780a85d54051bfbb08ba7e530b1,1,Nate Cole,2016-12-20 16:02:37-05:00,['51c4f92c12c876119cca0f0fc0269597c004dba1'],391,263,654,24720211,20,1,0,0,27423
1584984e8836f6951794b3ac0309494cc9acb234,0,Jonathan Hurley,2016-12-20 16:08:28-05:00,['4fc52a61f5515780a85d54051bfbb08ba7e530b1'],22,87,109,24720320,3,0,0.815789474,1,27423
02f649fe0ed2e305fb44005e4f29527a5fd973f6,1,Aravindan Vijayan,2016-12-20 15:43:18-08:00,['1584984e8836f6951794b3ac0309494cc9acb234'],2,2,4,24720324,2,,,,27423
2b91ffda82194db5aa09f164c490e2d9767dc643,1,Aravindan Vijayan,2016-12-20 15:54:58-08:00,['02f649fe0ed2e305fb44005e4f29527a5fd973f6'],13,103,116,24720440,5,,,,27423
0f2ec4f45fd094397c5eeb5d6f84ce5ed4d3c2dc,0,Oleg Nechiporenko,2016-12-21 15:33:49+02:00,['2b91ffda82194db5aa09f164c490e2d9767dc643'],15,16,31,24720471,3,0,0,0,27423
79903685076122292f8773efa29ef2496fc3aeb8,1,Renjith Kamath,2016-12-21 21:00:52+05:18,['0f2ec4f45fd094397c5eeb5d6f84ce5ed4d3c2dc'],1,1,2,24720473,1,,,,27423
c08df0ef4aa67acba21c057e0b0ffd4cb6f0fde7,0,Lisnichenko Dmitro,2016-12-21 17:49:40+02:00,['79903685076122292f8773efa29ef2496fc3aeb8'],74,12,86,24720559,3,1,0,0,27423
ae14380074bcc626e0c24d13a92db7d31e04c5f5,1,Xi Wang,2016-12-21 10:59:32-08:00,['c08df0ef4aa67acba21c057e0b0ffd4cb6f0fde7'],18,26,44,24720603,5,,,,27423
52d7b7ef624b8866428f0b0b5f3f8f5157193350,1,"Toader, Sebastian",2016-12-21 20:30:42+01:00,['ae14380074bcc626e0c24d13a92db7d31e04c5f5'],3,117,120,24720723,4,0.368421053,0.49122807,0.877192982,27424
b9271c30824cadd70f4244367f8ea5f4b4e9db8d,0,Mugdha Varadkar,2016-12-22 10:24:17+05:18,['52d7b7ef624b8866428f0b0b5f3f8f5157193350'],2,9,11,24720734,3,,,,27424
170d3bef601da41952e466d49147e8772d5fa303,0,Renjith Kamath,2016-12-22 12:32:05+05:18,['b9271c30824cadd70f4244367f8ea5f4b4e9db8d'],3,0,3,24720737,1,1,0,0,27424
bd3df7db06d43c78067df43e53209fd8aa1fac87,0,Oleg Nechiporenko,2016-12-22 11:56:43+02:00,['170d3bef601da41952e466d49147e8772d5fa303'],26,30,56,24720793,1,,,,27424
0111c847ddc2367b8b1046f74d6ce65d6bbb331e,1,ababiichuk,2016-12-22 14:36:13+02:00,['bd3df7db06d43c78067df43e53209fd8aa1fac87'],302,108,410,24721203,3,0.588983051,0.563559322,0.300847458,27424
633ac3bd532654ea0eec9159d666f9cb43446b5d,1,Dmytro Sen,2016-12-22 15:37:47+02:00,['0111c847ddc2367b8b1046f74d6ce65d6bbb331e'],0,46,46,24721249,2,0.028571429,0.142857143,1,27424
98a83c5f909b5fe5b8debe249496978bd3c6c7d2,1,Andrii Tkach,2016-12-22 16:50:55+02:00,['633ac3bd532654ea0eec9159d666f9cb43446b5d'],146,1607,1753,24723002,11,0.810063785,1,1,27424
a100c0b3ee1f480f4721586084de8f8d0639b6c0,0,Andrew Onishuk,2016-12-22 18:37:57+02:00,['98a83c5f909b5fe5b8debe249496978bd3c6c7d2'],9,9,18,24723020,1,1,,,27424
bc1b7ab8c0f290879ce878a9c8cd028ecb51d45f,1,Andrew Onishuk,2016-12-22 18:44:30+02:00,['a100c0b3ee1f480f4721586084de8f8d0639b6c0'],4,4,8,24723028,4,,,,27424
48079281714604afd445e6c89de116e49bfab5c0,0,Nate Cole,2016-12-22 12:07:50-05:00,"['7a87817b8cd4730e2b648bb42e2e2a1b1661c775', 'bc1b7ab8c0f290879ce878a9c8cd028ecb51d45f']",1463,3386,4849,24727877,170,,,,27424
c695e50a71eb6afa2f4fbc4ed2ee65da8f276aed,0,"Toader, Sebastian",2016-12-22 18:26:55+01:00,['bc1b7ab8c0f290879ce878a9c8cd028ecb51d45f'],5,5,10,24727887,3,,,,27424
6d196db0d80a145bc323a03aff74533938836392,1,Aravindan Vijayan,2016-12-22 12:09:27-08:00,['c695e50a71eb6afa2f4fbc4ed2ee65da8f276aed'],241,664,905,24728792,20,0.647540984,0.745901639,1,27431
9e524d7e66fe6031cd20c54946ccfd91255e5961,1,Aravindan Vijayan,2016-12-22 12:44:16-08:00,['6d196db0d80a145bc323a03aff74533938836392'],88,1419,1507,24730299,22,0.324561404,1,0.894736842,27436
f77ba790cc7cbd4be9b33c23d1a85b0dd8638dd0,1,Mugdha Varadkar,2016-12-23 11:15:48+05:18,['9e524d7e66fe6031cd20c54946ccfd91255e5961'],24,2053,2077,24732376,10,0,1,1,27438
2f123f0ae969fc7304f04fc1f07abc3ff2498db2,0,"Toader, Sebastian",2016-12-23 09:28:26+01:00,['f77ba790cc7cbd4be9b33c23d1a85b0dd8638dd0'],3,3,6,24732382,1,,,,27438
e900093107475b765ac2d02edf1c28e61d6250bd,1,Nitiraj Rathore,2016-12-23 14:19:19+05:18,['2f123f0ae969fc7304f04fc1f07abc3ff2498db2'],21,86,107,24732489,8,1,1,1,27438
47a98824566ad3015b9c9655a53b34e171f43ae9,1,Nitiraj Rathore,2016-12-23 16:00:35+05:18,['e900093107475b765ac2d02edf1c28e61d6250bd'],1072,2006,3078,24735567,26,0.5374677,0.832041344,0.775193798,27452
564b8f775959670259693c064b6d9025aec40760,0,"Toader, Sebastian",2016-12-23 13:16:18+01:00,['47a98824566ad3015b9c9655a53b34e171f43ae9'],0,1,1,24735568,1,0,0,0,27452
83f3b6fb0fb98bc99e74b0d1f2c55e5229c697ac,0,"Toader, Sebastian",2016-12-23 13:27:56+01:00,['564b8f775959670259693c064b6d9025aec40760'],49,670,719,24736287,20,0.840136054,0.860544218,0.976190476,27456
a98bd6b791573da3dc73ec56ea07dc6de191fc0f,0,Andrew Onishuk,2016-12-23 15:02:35+02:00,['83f3b6fb0fb98bc99e74b0d1f2c55e5229c697ac'],0,28,28,24736315,1,0,1,1,27456
dc408b3552ef503c845d62759c27dd32c4f291e7,0,Alex Antonenko,2016-12-23 15:22:23+02:00,['a98bd6b791573da3dc73ec56ea07dc6de191fc0f'],3,3,6,24736321,3,,,,27456
2f311bedd9a7e03e220088a1a7b458f9107af56c,1,Vitaly Brodetskyi,2016-12-23 15:13:54+02:00,['dc408b3552ef503c845d62759c27dd32c4f291e7'],0,2,2,24736323,1,0,1,1,27456
2f2c9cc588fca9522a159902d3e7db560877ff98,1,"Toader, Sebastian",2016-12-23 16:03:51+01:00,['2f311bedd9a7e03e220088a1a7b458f9107af56c'],12,628,640,24736963,13,0.6816609,0.937716263,0.626297578,27461
163fa4c9c2e076ca16bf1a6f05d5e695af86b7d0,1,"Toader, Sebastian",2016-12-23 16:14:12+01:00,['2f2c9cc588fca9522a159902d3e7db560877ff98'],670,49,719,24737682,20,0.159863946,0.139455782,0.023809524,27463
2304971d09f3c525ebd2b1cf864d82ee9b858d5e,0,Jonathan Hurley,2016-12-23 10:50:25-05:00,['163fa4c9c2e076ca16bf1a6f05d5e695af86b7d0'],158,181,339,24738021,26,1,1,1,27463
a934c03153afe1cb1d464ad6e9c22107025935ca,1,Dmytro Sen,2016-12-23 18:16:11+02:00,['2304971d09f3c525ebd2b1cf864d82ee9b858d5e'],822,685,1507,24739528,3,1,1,0.847133758,27463
50c770ab9edeba6ad72881c4e3dd8d494828e7b4,0,Tim Thorpe,2016-12-23 08:40:25-08:00,['a934c03153afe1cb1d464ad6e9c22107025935ca'],2,413,415,24739943,8,0,1,0.833333333,27469
c4d8f2dc8d28fe6eb42b3bfa102383e089a502f3,1,Dmytro Sen,2016-12-23 18:55:17+02:00,['50c770ab9edeba6ad72881c4e3dd8d494828e7b4'],11,22,33,24739976,3,1,1,1,27469
b536a9cbcc92be34958b563b395b57ab2ff5ef4b,1,Tim Thorpe,2016-12-23 09:38:50-08:00,['c4d8f2dc8d28fe6eb42b3bfa102383e089a502f3'],51,99,150,24740126,6,0.047619048,0.80952381,0.785714286,27469
7c2c14d976b2099876f1e801a8ddd60c7549c0fc,1,Vitaly Brodetskyi,2016-12-23 19:39:22+02:00,['b536a9cbcc92be34958b563b395b57ab2ff5ef4b'],113,248,361,24740487,7,0,0.888888889,0.355555556,27469
2051d58a8e38b21f1b3e2ce49ca4475e22d89f9c,0,Aleksandr Kovalenko,2016-12-23 20:21:02+02:00,['7c2c14d976b2099876f1e801a8ddd60c7549c0fc'],6,6,12,24740499,2,,,,27469
68066119360dd34a9fc5b4bd52e708fbf7f6b081,1,"Toader, Sebastian",2016-12-23 20:11:03+01:00,['2051d58a8e38b21f1b3e2ce49ca4475e22d89f9c'],15,152,167,24740666,19,0.393939394,0.848484848,1,27471
0a1d7c2a947a143d94c7338b509809d261625217,1,"Toader, Sebastian",2016-12-23 22:15:18+01:00,['68066119360dd34a9fc5b4bd52e708fbf7f6b081'],47,670,717,24741383,18,0.840136054,0.860544218,0.976190476,27475
ecaf9b88d4c219e658aad95ec79d8294620ca145,0,Vitaly Brodetskyi,2016-12-24 00:13:49+02:00,['0a1d7c2a947a143d94c7338b509809d261625217'],7,11,18,24741401,2,0,0,1,27475
bff44261aa018e14521d3ad1b5fba72a9512bd3f,1,Aravindan Vijayan,2016-12-25 11:16:16-08:00,['ecaf9b88d4c219e658aad95ec79d8294620ca145'],35,200,235,24741636,17,,,,27475
ef79c6d83d7149eb8d214a173f6aca6c2472faa2,0,Renjith Kamath,2016-12-26 11:31:03+05:18,['bff44261aa018e14521d3ad1b5fba72a9512bd3f'],4,0,4,24741640,1,,,,27475
5822c2f512fab4aca1443ab04c7ceba4c272e5d1,0,Renjith Kamath,2016-12-26 11:39:57+05:18,['ef79c6d83d7149eb8d214a173f6aca6c2472faa2'],0,8,8,24741648,1,0,0,0,27475
4fa08766fcc7dbf842b6672fe838c8ad04520ec0,0,Renjith Kamath,2016-12-26 11:43:38+05:18,['5822c2f512fab4aca1443ab04c7ceba4c272e5d1'],8,0,8,24741656,1,1,1,1,27475
d0c5fe041335c40fcd38cd4cbeeda8aebf84b703,1,Renjith Kamath,2016-12-26 14:42:20+05:18,['4fa08766fcc7dbf842b6672fe838c8ad04520ec0'],0,7,7,24741663,1,0,0,1,27475
b69ef96b052f9970f7598831e1ccce4f0b0c745d,1,Andrew Onishuk,2016-12-27 12:38:41+02:00,['d0c5fe041335c40fcd38cd4cbeeda8aebf84b703'],51,48,99,24741762,1,1,1,0,27475
eca4e54ee88bccf2ea8342d421dac5362fc6c3a3,1,Dmytro Sen,2016-12-27 12:42:41+02:00,['b69ef96b052f9970f7598831e1ccce4f0b0c745d'],19,32,51,24741813,7,0,1,0,27475
7d3d71b977348afe745ed4b230c553cf8614cb0c,0,Andrew Onishuk,2016-12-27 15:54:59+02:00,['eca4e54ee88bccf2ea8342d421dac5362fc6c3a3'],0,2,2,24741815,1,1,1,1,27475
85738c17a417daccaabe509466e19cd6193996e5,0,Oleg Nechiporenko,2016-12-27 15:59:57+02:00,['7d3d71b977348afe745ed4b230c553cf8614cb0c'],4,2,6,24741821,1,0,0,0,27475
f36cf27b12c1c30b613fa99be04e0fcca9b461e0,0,Andrii Tkach,2016-12-27 18:00:06+02:00,['85738c17a417daccaabe509466e19cd6193996e5'],17,27,44,24741865,3,0,0.666666667,0.148148148,27475
20c7940a150c260535d34f70431db0633a628272,0,Dmytro Sen,2016-12-27 19:49:37+02:00,['f36cf27b12c1c30b613fa99be04e0fcca9b461e0'],23,21,44,24741909,5,,,,27475
0bade7ced6559b5524d58d63c9f7114534be4956,0,Aravindan Vijayan,2016-12-27 13:04:11-08:00,['20c7940a150c260535d34f70431db0633a628272'],1,1,2,24741911,1,,,,27475
e423a65e5deca78d8068216a273d9d89d37756c9,0,Nitiraj Rathore,2016-12-28 14:49:52+05:18,['0bade7ced6559b5524d58d63c9f7114534be4956'],39988,0,39988,24781899,415,0.288964548,0.12613489,0.089223952,27475
1bfffc0c8f231b583dc259c4d4e3fd91079aec0b,0,Oleg Nechiporenko,2016-12-28 12:36:40+02:00,['e423a65e5deca78d8068216a273d9d89d37756c9'],2,32,34,24781933,3,1,1,0.821428571,27475
d84aa3bcb184db60e8d1a68429e1c7abb3fa3646,1,Lisnichenko Dmitro,2016-12-28 16:58:27+02:00,['1bfffc0c8f231b583dc259c4d4e3fd91079aec0b'],50,43,93,24782026,4,0,1,0,27475
d1109a5ec1f761bc9cdc990f9c7c3804ff754c74,1,Aravindan Vijayan,2016-12-28 09:36:29-08:00,['d84aa3bcb184db60e8d1a68429e1c7abb3fa3646'],0,101,101,24782127,2,0,0.714285714,1,27475
69e973c41cb35541ee165372212947c0d8357d6f,0,Yusaku Sako,2016-12-28 10:05:24-08:00,['d1109a5ec1f761bc9cdc990f9c7c3804ff754c74'],13,181,194,24782321,4,0.051948052,1,1,27475
540f4ee9ac15d1d1794e8a57db043114dd441dc5,0,Sangeeta Ravindran,2016-12-28 11:51:06-08:00,['69e973c41cb35541ee165372212947c0d8357d6f'],8,27,35,24782356,4,0.764705882,0.764705882,1,27475
74d636392d4b82f6322af5a62a6dfe680743aaf4,1,ababiichuk,2016-12-28 23:26:31+02:00,['540f4ee9ac15d1d1794e8a57db043114dd441dc5'],192,383,575,24782931,6,0.473282443,0.977099237,1,27475
a2c907b2d9c2da58c7907e0ee9a3b5ad5376f361,0,Xi Wang,2016-12-28 13:52:53-08:00,['74d636392d4b82f6322af5a62a6dfe680743aaf4'],2,39,41,24782972,2,1,1,1,27475
6add93ea482555084e5d001c47bf1f86f2dfe99b,1,Xi Wang,2016-12-28 13:52:53-08:00,['a2c907b2d9c2da58c7907e0ee9a3b5ad5376f361'],3,17,20,24782992,2,,,,27475
6db03934bddb971de258a73150145f928e52c5cb,1,Jaimin Jetly,2016-12-28 16:10:28-08:00,['6add93ea482555084e5d001c47bf1f86f2dfe99b'],286,684,970,24783962,8,0.413265306,0.387755102,0.632653061,27475
a0dc96edc6d21bcdda0720257216647581e5dc80,0,Oleg Nechiporenko,2016-12-29 14:13:23+02:00,['6db03934bddb971de258a73150145f928e52c5cb'],30,26,56,24784018,4,0,0,0,27475
82d15b57f0639676c820d9b08606f4a265d8801a,1,ababiichuk,2016-12-29 18:12:17+02:00,['a0dc96edc6d21bcdda0720257216647581e5dc80'],17,12,29,24784047,2,1,0.2,0,27475
96f7f5f6ff75019a7f4a51a79cef6e087c99026a,0,Aravindan Vijayan,2016-12-29 13:23:45-08:00,['82d15b57f0639676c820d9b08606f4a265d8801a'],1,8,9,24784056,1,0,1,1,27475
3ab08abe4d84bb5dd9fb0a0966b582102510c0b8,1,Xi Wang,2016-12-29 17:51:30-08:00,['96f7f5f6ff75019a7f4a51a79cef6e087c99026a'],28,20,48,24784104,4,,,,27475
56bcfce3d1657c61cbd0ccf3a42cb6c2f349d531,1,Nitiraj Rathore,2016-12-30 13:26:41+05:18,['3ab08abe4d84bb5dd9fb0a0966b582102510c0b8'],64,73,137,24784241,1,0,0,0.076923077,27475
3b52cbc60830ebdefd24e823c9c8ff838e1fb858,0,Oleg Nechiporenko,2016-12-30 14:00:49+02:00,['56bcfce3d1657c61cbd0ccf3a42cb6c2f349d531'],0,27,27,24784268,2,1,1,1,27475
d110186e87e9ed5d62be0fbb273405c964cf87fd,0,Andrii Tkach,2016-12-30 15:57:48+02:00,['3b52cbc60830ebdefd24e823c9c8ff838e1fb858'],0,6,6,24784274,1,,,,27475
51a9b01e434b79bb2fa5cfce1e46ed569a03eaca,0,Aleksandr Kovalenko,2016-12-30 16:14:32+02:00,['d110186e87e9ed5d62be0fbb273405c964cf87fd'],4,16,20,24784294,3,1,0.285714286,1,27475
65fa6fdaaf5acd06005023e11736f0de6b1f2a50,1,Sumit Mohanty,2016-12-30 09:56:22-08:00,['51a9b01e434b79bb2fa5cfce1e46ed569a03eaca'],27,392,419,24784713,22,,,,27475
e97a6e47f8e374e296c0cdd3811677fd80fb8646,1,Sumit Mohanty,2016-12-30 14:15:16-08:00,['65fa6fdaaf5acd06005023e11736f0de6b1f2a50'],685,822,1507,24786220,3,0,0,0.152866242,27475
3ba3b8ed374b7b777bd36bf490c5aaef5f43de81,1,Miklos Gergely,2016-12-31 00:58:15+01:00,['e97a6e47f8e374e296c0cdd3811677fd80fb8646'],122,148,270,24786490,8,0,1,0,27476
cfa30ec70dac3d4b548fff3a17a6e0f4d9a6bd36,0,Sumit Mohanty,2016-12-30 16:52:12-08:00,['3ba3b8ed374b7b777bd36bf490c5aaef5f43de81'],1,1,2,24786492,1,,,,27476
49a6929b93a8505db3a33b8fb9c1653ae0716263,1,Nitiraj Rathore,2017-01-03 11:58:11+05:18,['cfa30ec70dac3d4b548fff3a17a6e0f4d9a6bd36'],205,146,351,24786843,5,0,0,1,27476
672fdf06b5c9f2b18bfca95c86b25251bd1ac98d,1,Gaurav Nagar,2017-01-03 13:56:03+05:18,['49a6929b93a8505db3a33b8fb9c1653ae0716263'],574,2349,2923,24789766,64,0.414814815,0.612698413,0.355555556,27490
853a1ce780e2e840903d440b0705b7c56f385db7,1,Nitiraj Rathore,2017-01-03 17:00:13+05:18,['672fdf06b5c9f2b18bfca95c86b25251bd1ac98d'],5,36270,36275,24826041,461,0.664564091,0.853495532,0.8753473,27948
106851bfc358ec417d590403407bb964d5c3c9f1,0,pallavkul,2017-01-03 17:12:08+05:18,['853a1ce780e2e840903d440b0705b7c56f385db7'],0,17,17,24826058,3,1,1,1,27948
4fc44e277ac396f6967402da767350a4ee2bf47d,0,Andrii Tkach,2017-01-03 14:05:34+02:00,['106851bfc358ec417d590403407bb964d5c3c9f1'],28,170,198,24826256,3,1,1,1,27948
22586153eca925d493e9ca97d7ad878977d7a20c,1,pallavkul,2017-01-03 18:39:22+05:18,['4fc44e277ac396f6967402da767350a4ee2bf47d'],28,90,118,24826374,5,1,1,1,27948
c4581345d6e6ff5fd7d367c0d6a8df0821648feb,1,Myroslav Papirkovskyi,2017-01-03 20:17:29+02:00,['22586153eca925d493e9ca97d7ad878977d7a20c'],152,209,361,24826735,24,0.325,0,1,27948
315691fc790a94e4830fac0ccbb92046bd9a3719,1,Myroslav Papirkovskyi,2017-01-03 20:18:35+02:00,['c4581345d6e6ff5fd7d367c0d6a8df0821648feb'],12,19,31,24826766,2,0,0.333333333,0.666666667,27948
20a50767cfb7c3923ce945bddbafe0573c692f05,0,Myroslav Papirkovskyi,2017-01-03 20:20:28+02:00,['315691fc790a94e4830fac0ccbb92046bd9a3719'],2,4,6,24826772,2,0,1,1,27948
d256e82e628a6ba86acd17a21c2b925a7b3ae9c5,0,Dmytro Sen,2017-01-03 20:24:35+02:00,['20a50767cfb7c3923ce945bddbafe0573c692f05'],58,98,156,24826928,6,0,0.948717949,0.923076923,27948
48d6a38482c132ce406178dcbef7c204e2fc6547,1,Nitiraj Rathore,2017-01-03 23:49:04+05:18,['d256e82e628a6ba86acd17a21c2b925a7b3ae9c5'],53,865,918,24827846,20,0.997142857,1,0.96,27959
702b92ae8f02745e12c09783eec37e22afe2ac0d,0,Myroslav Papirkovskyi,2017-01-03 20:34:41+02:00,['48d6a38482c132ce406178dcbef7c204e2fc6547'],0,1,1,24827847,1,,,,27959
dde269491ab0ddadc9fa77f88e62ac91a8b8b676,0,Sumit Mohanty,2017-01-03 10:39:09-08:00,['702b92ae8f02745e12c09783eec37e22afe2ac0d'],10,33,43,24827890,6,,,,27959
b9a2b62eca78830b2e6f94660ab647168f6986de,0,Myroslav Papirkovskyi,2017-01-03 20:48:57+02:00,['dde269491ab0ddadc9fa77f88e62ac91a8b8b676'],1,0,1,24827891,1,,,,27959
060e8424aa585580618dfb42b56bf830f7ed5479,1,Myroslav Papirkovskyi,2017-01-03 20:48:57+02:00,['b9a2b62eca78830b2e6f94660ab647168f6986de'],4,2,6,24827897,2,1,0,0,27959
cddd64a358832fcda8969e6ce95f1946748efb06,0,Myroslav Papirkovskyi,2017-01-03 20:58:43+02:00,['060e8424aa585580618dfb42b56bf830f7ed5479'],2,5,7,24827904,2,0,1,1,27959
160027748951429fe1d80bcd6f3de7332ae695b9,1,Myroslav Papirkovskyi,2017-01-03 21:10:22+02:00,['cddd64a358832fcda8969e6ce95f1946748efb06'],2,2,4,24827908,1,,,,27959
0ab25563f1689b919374659fe1652362ccb1886a,1,Richard Zang,2017-01-03 11:30:37-08:00,['160027748951429fe1d80bcd6f3de7332ae695b9'],3,24,27,24827935,4,1,1,0.666666667,27959
cab77052980ded1f751a54dd967730ec721549e4,1,Yusaku Sako,2017-01-03 11:56:12-08:00,['0ab25563f1689b919374659fe1652362ccb1886a'],0,1,1,24827936,1,,,,27959
976e40a670c2442cf3020de626d5262bd011c5e5,1,pallavkul,2017-01-04 11:59:54+05:18,['cab77052980ded1f751a54dd967730ec721549e4'],17,15,32,24827968,2,0,0,1,27959
34bc40ece5b0dc6eed311ecccf7a29f822db1879,1,Renjith Kamath,2017-01-04 12:41:42+05:18,['976e40a670c2442cf3020de626d5262bd011c5e5'],3,14,17,24827985,1,0,0,1,27959
4c12e5de8040d0a32f6d0b0eb8f574ba10d5144b,0,Renjith Kamath,2017-01-04 12:49:27+05:18,['34bc40ece5b0dc6eed311ecccf7a29f822db1879'],3,3,6,24827991,1,0,1,1,27959
ff222441e75c2feff3b93aee12560f1e624d3189,1,oleewere,2017-01-04 12:46:35+01:00,['4c12e5de8040d0a32f6d0b0eb8f574ba10d5144b'],9,18,27,24828018,4,0.833333333,1,0,27959
4bc2263fcef85643301e730032e7b7d4de342f6c,0,Aleksandr Kovalenko,2017-01-04 13:51:54+02:00,['ff222441e75c2feff3b93aee12560f1e624d3189'],0,26,26,24828044,2,,,,27960
4a4a16aa9bd0d07e20e683dd9d428227e23f076f,1,oleewere,2017-01-04 13:39:29+01:00,['4bc2263fcef85643301e730032e7b7d4de342f6c'],16,86,102,24828146,9,0.396551724,1,0.74137931,27960
8f16d643867772ba491f85477ee03454e7177b62,1,Andrii Tkach,2017-01-04 17:27:10+02:00,['4a4a16aa9bd0d07e20e683dd9d428227e23f076f'],62,1463,1525,24829671,17,0.914551607,1,1,27968
30b27b1c2744b8095970c59235ef31a4cea900c0,1,Dmytro Sen,2017-01-04 18:04:34+02:00,['8f16d643867772ba491f85477ee03454e7177b62'],1,352,353,24830024,2,0.005934718,0.991097923,0.985163205,27968
e96dee0fecfafeda637c339217b2746b337f729f,1,Robert Levas,2017-01-04 11:29:11-05:00,['30b27b1c2744b8095970c59235ef31a4cea900c0'],10,38,48,24830072,13,1,1,0.625,27968
4253a6173281ee896aa237b87904c64667878c2f,0,Jaimin Jetly,2017-01-04 11:48:17-08:00,['e96dee0fecfafeda637c339217b2746b337f729f'],21,84,105,24830177,10,0.361111111,0.361111111,0.611111111,27968
e3eef3ce3594d85378d56715f8d30ae5c19e8874,0,Richard Zang,2017-01-04 13:00:55-08:00,['4253a6173281ee896aa237b87904c64667878c2f'],2,2,4,24830181,1,,,,27968
f207b95f586a5d218d0059c767825d1baa6bd856,1,Jonathan Hurley,2017-01-04 16:18:05-05:00,['e3eef3ce3594d85378d56715f8d30ae5c19e8874'],225,625,850,24831031,8,1,0.473684211,0,27969
82a64e4985607a961857d74773362e6bf7eb9858,0,Jonathan Hurley,2017-01-04 16:18:19-05:00,['f207b95f586a5d218d0059c767825d1baa6bd856'],0,16,16,24831047,1,1,1,1,27969
7a7bc003f8d9f3eb1a84b66685e9036bcc92679a,0,Aravindan Vijayan,2017-01-04 15:31:05-08:00,['82a64e4985607a961857d74773362e6bf7eb9858'],2,5,7,24831054,1,,0,,27969
608f0b55ecfe96043ac3bd7bc41e4eb580691fe4,0,Nate Cole,2017-01-04 19:04:17-05:00,"['48079281714604afd445e6c89de116e49bfab5c0', '82a64e4985607a961857d74773362e6bf7eb9858']",28588,38532,67120,24898174,1119,,,,27969
dcffaeda04ff0348bcb1927f4e1de6a045ddf93a,1,pallavkul,2017-01-05 11:56:08+05:18,['7a7bc003f8d9f3eb1a84b66685e9036bcc92679a'],198,235,433,24898607,23,0.21875,1,0.84375,27969
567ce62ac51e82249f22f7c29a1593bc4c2ac5ca,1,pallavkul,2017-01-05 12:05:52+05:18,['dcffaeda04ff0348bcb1927f4e1de6a045ddf93a'],3,8,11,24898618,2,1,1,1,27969
1c1488941c4e260585a29203b3963d46eb4da36d,1,pallavkul,2017-01-05 12:10:37+05:18,['567ce62ac51e82249f22f7c29a1593bc4c2ac5ca'],0,6,6,24898624,1,,,,27969
0777ae5634c25e7b8bed03f872e17759e4e80f73,0,Oleg Nechiporenko,2017-01-05 10:32:12+02:00,['1c1488941c4e260585a29203b3963d46eb4da36d'],4,10,14,24898638,3,0.428571429,1,1,27969
1b3f039811c31cac667f6521c87644efbe99099b,1,Gaurav Nagar,2017-01-05 14:10:45+05:18,['0777ae5634c25e7b8bed03f872e17759e4e80f73'],3,3,6,24898644,1,,,,27969
25a596769c7c420dc28e3a7178bf7f02dca5880f,0,Renjith Kamath,2017-01-05 14:19:28+05:18,['1b3f039811c31cac667f6521c87644efbe99099b'],0,8,8,24898652,1,0.857142857,1,0.857142857,27969
176c3b0f1abf4368ba9d35cb83ab09160b642944,0,Gaurav Nagar,2017-01-05 14:36:00+05:18,['25a596769c7c420dc28e3a7178bf7f02dca5880f'],0,78,78,24898730,3,0,1,1,27971
2a2252cc94231e25e76b4362aff165f0f62ac829,0,Gaurav Nagar,2017-01-05 14:44:41+05:18,['176c3b0f1abf4368ba9d35cb83ab09160b642944'],78,0,78,24898808,3,1,0,0,27971
5e2b471516ae60ff2a14d3ed2f4cad3a3408aec2,0,Gaurav Nagar,2017-01-05 14:51:07+05:18,['2a2252cc94231e25e76b4362aff165f0f62ac829'],0,23,23,24898831,2,0,1,1,27972
ae7133674f5cdeefa55b4a938a227bec662170a8,1,Gaurav Nagar,2017-01-05 14:54:52+05:18,['5e2b471516ae60ff2a14d3ed2f4cad3a3408aec2'],0,3,3,24898834,1,,,,27972
773d155c86f65beaddfcc4950550555ad0ed9069,1,Gaurav Nagar,2017-01-05 16:50:50+05:18,['ae7133674f5cdeefa55b4a938a227bec662170a8'],42,20,62,24898896,3,1,0,0,27972
6b198cc71ffd5b1ee5332ee036eb1272ee767c8b,1,oleewere,2017-01-05 13:14:38+01:00,['773d155c86f65beaddfcc4950550555ad0ed9069'],10,24,34,24898930,5,,,,27972
1527bd15c6226fbb8e690c64f68b593ac5088c2b,1,ababiichuk,2017-01-05 14:34:46+02:00,['6b198cc71ffd5b1ee5332ee036eb1272ee767c8b'],58,244,302,24899232,6,0.011695906,0.684210526,0.923976608,27972
b1bb2890aa3bc0e6ad67375808e8b4028a74bedc,0,Nate Cole,2017-01-05 08:38:22-05:00,"['608f0b55ecfe96043ac3bd7bc41e4eb580691fe4', '1527bd15c6226fbb8e690c64f68b593ac5088c2b']",320,589,909,24900141,46,,,,27972
bca0346b9f3eb01cd90e00cfce366305fca7a38b,0,Oleg Nechiporenko,2017-01-05 15:44:17+02:00,['1527bd15c6226fbb8e690c64f68b593ac5088c2b'],23,12,35,24900176,4,0,0,0,27972
c76d6a1ec9306064e900687ec32ab926c89cd88a,0,ababiichuk,2017-01-05 16:54:01+02:00,['bca0346b9f3eb01cd90e00cfce366305fca7a38b'],11,47,58,24900234,5,1,1,1,27972
d5bb9b53559a18ce806be769e47a22aec4e6908c,1,Sumit Mohanty,2017-01-05 07:52:24-08:00,['c76d6a1ec9306064e900687ec32ab926c89cd88a'],0,10,10,24900244,2,0,0,1,27972
cd245c00abaa5720675324a383e691434eabcf32,1,Nate Cole,2017-01-05 11:49:52-05:00,['b1bb2890aa3bc0e6ad67375808e8b4028a74bedc'],87,443,530,24900774,28,0.344086022,0.704301075,0.870967742,27972
381b474d6ec2a77894329f8d16c74a793fdccec2,1,Sumit Mohanty,2017-01-05 09:15:13-08:00,['d5bb9b53559a18ce806be769e47a22aec4e6908c'],19,242,261,24901035,21,0,0.782608696,0.52173913,27972
5e72ee6f2c6ebcda105e521d819f95ffde1b245e,0,Robert Levas,2017-01-05 12:53:59-05:00,['381b474d6ec2a77894329f8d16c74a793fdccec2'],140,235,375,24901410,7,0.886363636,1,1,27973
3ce361049520098d9df9ec6aef8748aa1120cad3,0,Yusaku Sako,2017-01-05 11:03:10-08:00,['5e72ee6f2c6ebcda105e521d819f95ffde1b245e'],8,0,8,24901418,1,0.142857143,0,0.142857143,27973
4305a8603c5a9c5b1a60b4e2f91c5e6da2e443c8,0,Yusaku Sako,2017-01-05 11:13:55-08:00,['3ce361049520098d9df9ec6aef8748aa1120cad3'],0,12,12,24901430,1,,,,27973
9109d1c3b9c20c98310472c05b1572d744c58363,1,Robert Levas,2017-01-05 16:49:15-05:00,['4305a8603c5a9c5b1a60b4e2f91c5e6da2e443c8'],235,140,375,24901805,7,0.113636364,0,0,27973
bd1b744403bfa9c6e6aaf02e7c56062e7fdb21cd,1,Robert Levas,2017-01-05 17:33:03-05:00,['9109d1c3b9c20c98310472c05b1572d744c58363'],141,235,376,24902181,7,0.886363636,1,1,27974
33239523dcc0e226171fa7a699194e9bdb33ab4b,1,Richard Zang,2017-01-05 14:58:19-08:00,['bd1b744403bfa9c6e6aaf02e7c56062e7fdb21cd'],0,5,5,24902186,1,1,1,1,27974
b46a2f627e2137f2f361239f944869cf0e0dfd1d,1,Miklos Gergely,2017-01-06 01:10:46+01:00,['33239523dcc0e226171fa7a699194e9bdb33ab4b'],76,346,422,24902608,13,0.006896552,0.55862069,1,27974
cae80946c98cb4ad9a44f99f66132ed149add50f,0,Jaimin Jetly,2017-01-05 18:15:12-08:00,['b46a2f627e2137f2f361239f944869cf0e0dfd1d'],1,54,55,24902663,3,1,1,1,27974
d243fea753edb39155f003058ee2e87828aa1955,0,Xi Wang,2017-01-05 18:34:28-08:00,['cae80946c98cb4ad9a44f99f66132ed149add50f'],2,24,26,24902689,1,,,,27974
04f6da277a0077a4861b9705b0cb66838bee6df7,1,Gaurav Nagar,2017-01-06 12:49:42+05:18,['d243fea753edb39155f003058ee2e87828aa1955'],73,232,305,24902994,7,1,1,1,27974
4388baf10b97866bd18991db1d87be1cbf0b915c,1,Gaurav Nagar,2017-01-06 12:53:24+05:18,['04f6da277a0077a4861b9705b0cb66838bee6df7'],11,15,26,24903020,4,1,1,1,27974
b35cb993cd4f11e4d7de250e033b2dd279a19c26,1,Gaurav Nagar,2017-01-06 12:58:04+05:18,['4388baf10b97866bd18991db1d87be1cbf0b915c'],0,2,2,24903022,1,,,,27974
87876375e18027241c84c1636623abd8ba761cc9,1,Gaurav Nagar,2017-01-06 13:05:16+05:18,['b35cb993cd4f11e4d7de250e033b2dd279a19c26'],29,26,55,24903077,2,1,0,1,27974
d9b3d288e587eda1a2c8c180ca17c85878503fe1,1,ababiichuk,2017-01-06 12:49:32+02:00,['87876375e18027241c84c1636623abd8ba761cc9'],2,12,14,24903091,2,0.6,1,1,27974
67bf7a6aa26ce9b2ce34824f9b14ad8283b1dc75,1,Nitiraj Rathore,2017-01-06 18:15:11+05:18,['d9b3d288e587eda1a2c8c180ca17c85878503fe1'],11,28,39,24903130,3,0,1,0,27974
e79ff36d59f89f4f76b0484cf9965c6c52c4be83,0,Nitiraj Rathore,2017-01-06 18:23:52+05:18,['67bf7a6aa26ce9b2ce34824f9b14ad8283b1dc75'],2,2,4,24903134,2,,,,27974
21975c9caac148684cbf96a90753e2946e2a5263,1,Oleg Nechiporenko,2017-01-06 15:53:29+02:00,['e79ff36d59f89f4f76b0484cf9965c6c52c4be83'],57,159,216,24903350,10,0.527777778,1,0.833333333,27975
a5a105b40a4a18a8c6ca563ac3504f93987d94a2,1,Vitaly Brodetskyi,2017-01-06 16:11:05+02:00,['21975c9caac148684cbf96a90753e2946e2a5263'],9,10,19,24903369,9,,,,27975
2042657e3e2fefc132610391ad88f94cd6efe06e,1,Nitiraj Rathore,2017-01-06 19:32:23+05:18,['a5a105b40a4a18a8c6ca563ac3504f93987d94a2'],108,617,725,24904094,7,0.385542169,1,0.421686747,27979
3662056b61f8640b796011b04c684393a464688c,0,Gaurav Nagar,2017-01-06 20:22:13+05:18,['2042657e3e2fefc132610391ad88f94cd6efe06e'],5,0,5,24904099,1,,,,27979
ea4fbff7889cf1ee8f09365b750986c6b9a1dab5,0,Vitaly Brodetskyi,2017-01-06 17:14:55+02:00,['3662056b61f8640b796011b04c684393a464688c'],34,40,74,24904173,2,,,,27979
da6430abe317941433378d91333d39e17b91591c,1,Sumit Mohanty,2017-01-06 07:54:56-08:00,['ea4fbff7889cf1ee8f09365b750986c6b9a1dab5'],0,188,188,24904361,2,,,,27980
accf8f1d59e41d379a3cac4435a16a36ce0adf85,0,Dmytro Sen,2017-01-06 18:02:19+02:00,['da6430abe317941433378d91333d39e17b91591c'],10,40,50,24904411,2,0.470588235,1,0.529411765,27980
84cac5e4b01db4aeeb0f3cb26b2ea98ec4a74bc1,1,Dmytro Sen,2017-01-06 19:26:40+02:00,['accf8f1d59e41d379a3cac4435a16a36ce0adf85'],3,5,8,24904419,1,0,0,0,27980
ebabac06969a499efa0a76028bf7ffbb823c3a0e,1,Vitaly Brodetskyi,2017-01-06 19:42:10+02:00,['84cac5e4b01db4aeeb0f3cb26b2ea98ec4a74bc1'],3,4,7,24904426,1,,,,27980
9bcd3f3784d985da6b5515aa6ec7ece37a3329b0,1,Dmytro Sen,2017-01-06 19:56:27+02:00,['ebabac06969a499efa0a76028bf7ffbb823c3a0e'],19,83,102,24904528,4,0,1,1,27980
21d4aff0bb121e0092aee964e43ff4d8a0dbcde9,1,Jonathan Hurley,2017-01-06 15:42:13-05:00,['9bcd3f3784d985da6b5515aa6ec7ece37a3329b0'],85,71,156,24904684,7,0,0,1,27980
fc586a87aa466c2fda12ef36b0ddee1e63b9e174,0,Robert Levas,2017-01-06 16:25:23-05:00,['21d4aff0bb121e0092aee964e43ff4d8a0dbcde9'],6,95,101,24904785,3,0.384615385,1,1,27981
0ed40ae0f818cc083363d33c493ba13bb5ef2a05,0,Sumit Mohanty,2017-01-06 14:02:08-08:00,['fc586a87aa466c2fda12ef36b0ddee1e63b9e174'],37,87,124,24904909,6,0,1,1,27981
0909d7cdbf5290490c9908e43f34bf02f92e48c3,1,Yusaku Sako,2017-01-06 14:20:09-08:00,['0ed40ae0f818cc083363d33c493ba13bb5ef2a05'],2,880,882,24905791,2,0.290322581,0.290322581,1,27982
e7c027c96d0c319552e68008304777e2642b3f7a,1,"Toader, Sebastian",2017-01-06 23:45:31+01:00,['0909d7cdbf5290490c9908e43f34bf02f92e48c3'],4,13,17,24905808,2,0,0.285714286,1,27982
22187afc6074e4f21f43984f3f270474cf9200dc,1,Alejandro Fernandez,2017-01-06 14:54:36-08:00,['e7c027c96d0c319552e68008304777e2642b3f7a'],121,152,273,24906081,4,,,,27983
3da3b7f21d907fb4215b2c22f563589a78141b75,0,Alejandro Fernandez,2017-01-06 15:00:01-08:00,['22187afc6074e4f21f43984f3f270474cf9200dc'],2,5,7,24906088,1,0,1,1,27983
fbcad4fb4e22e88ff8e1487ea385911bfe41ad09,1,Yusaku Sako,2017-01-06 17:01:32-08:00,['3da3b7f21d907fb4215b2c22f563589a78141b75'],95,6,101,24906189,3,0.615384615,0,0,27983
688224127de729640904648907788b9f31c60a5c,1,Xi Wang,2017-01-06 17:05:13-08:00,['fbcad4fb4e22e88ff8e1487ea385911bfe41ad09'],3,8,11,24906200,1,1,1,1,27983
03cd5cedb76a49ebfe5c6e161080c48eeeb0efdc,0,Robert Levas,2017-01-06 20:43:44-05:00,['688224127de729640904648907788b9f31c60a5c'],6,113,119,24906319,3,0.384615385,1,1,27984
901b56df2900688b6d5993eca95c4efe3148635e,1,Dipayan Bhowmick,2017-01-09 11:33:04+05:18,['03cd5cedb76a49ebfe5c6e161080c48eeeb0efdc'],26,231,257,24906576,17,0.984848485,0.984848485,0.954545455,27985
8fa58061480e9f325e74d0637d6d9ac858955911,1,Renjith Kamath,2017-01-09 15:39:33+05:18,['901b56df2900688b6d5993eca95c4efe3148635e'],1,1,2,24906578,1,,,,27985
1535bc9823d7a9e58d1a3f195949a8c6d43b91d6,1,"Toader, Sebastian",2017-01-09 13:18:53+01:00,['8fa58061480e9f325e74d0637d6d9ac858955911'],5,28,33,24906611,5,0.777777778,0.888888889,0.777777778,27985
55747a5c2563c867e2a0d9418abfa2a792a92cb1,1,Xi Wang,2017-01-09 10:07:50-08:00,['1535bc9823d7a9e58d1a3f195949a8c6d43b91d6'],19,31,50,24906661,4,0,0,1,27985
87fa076ec017636a19ad209349c38708535f64f2,1,Sumit Mohanty,2017-01-09 11:06:30-08:00,['55747a5c2563c867e2a0d9418abfa2a792a92cb1'],98,58,156,24906817,6,1,0.051282051,0.076923077,27985
6e9b4be25ece4d9023c98283f9a88051bf8e81ea,0,Di Li,2017-01-09 14:45:36-05:00,['87fa076ec017636a19ad209349c38708535f64f2'],1,1,2,24906819,1,,,,27985
8258cf893175342142523ec0001b9f4d3f09ce3f,1,Alejandro Fernandez,2017-01-09 11:46:36-08:00,['6e9b4be25ece4d9023c98283f9a88051bf8e81ea'],262,965,1227,24908046,12,0.644670051,0.949238579,0.741116751,27986
c1acfac7e8b041cb9ddcb45c9a1115286b8a6b45,0,Di Li,2017-01-09 15:02:50-05:00,['8258cf893175342142523ec0001b9f4d3f09ce3f'],2,2,4,24908050,1,,,,27986
7ca559ccf12dacb1ee053e537868b915ba880647,1,Aravindan Vijayan,2017-01-09 15:15:59-08:00,['c1acfac7e8b041cb9ddcb45c9a1115286b8a6b45'],101,646,747,24908797,16,0.343612335,0.343612335,1,27988
3f886882b970854fce2b9e79234f4b3357b27719,1,Miklos Gergely,2017-01-10 00:25:30+01:00,['7ca559ccf12dacb1ee053e537868b915ba880647'],13,280,293,24909090,7,0.026490066,0.635761589,0.887417219,27989
96aaf1dbb1a1d8a1d416736e5ae7f5b4cf81bc1a,0,pallavkul,2017-01-10 10:24:23+05:18,['3f886882b970854fce2b9e79234f4b3357b27719'],0,32,32,24909122,1,1,1,1,27990
21697822f96c69b03eb6534b55f4fedabb311fd7,1,Nitiraj Rathore,2017-01-10 14:53:19+05:18,['96aaf1dbb1a1d8a1d416736e5ae7f5b4cf81bc1a'],8,631,639,24909761,24,0.85046729,1,1,28005
8e646eb2da863cca896b515b14e980c9c778ed05,1,Nitiraj Rathore,2017-01-10 15:36:51+05:18,['21697822f96c69b03eb6534b55f4fedabb311fd7'],0,238,238,24909999,5,0.529411765,1,1,28007
410f57e2a7bfdb80b9651bb37ba9d341c179137d,1,oleewere,2017-01-10 13:09:59+01:00,['8e646eb2da863cca896b515b14e980c9c778ed05'],181,199,380,24910379,9,0,0,0,28008
ba99a29445f0f9f1b5d9936aee9a219b58a7335f,1,Andrii Tkach,2017-01-10 15:33:32+02:00,['410f57e2a7bfdb80b9651bb37ba9d341c179137d'],47,129,176,24910555,8,1,1,0.906666667,28008
67d17f060e87530b1ad7ffe47bee9eba8ce43652,1,Oleg Nechiporenko,2017-01-10 16:38:12+02:00,['ba99a29445f0f9f1b5d9936aee9a219b58a7335f'],85,274,359,24910914,12,0.984615385,1,0.876923077,28010
d97b9d5f1c18c1467519490b42d8eceb05bba8b3,1,pallavkul,2017-01-10 20:16:05+05:18,['67d17f060e87530b1ad7ffe47bee9eba8ce43652'],36,605,641,24911555,15,0.792372881,1,1,28016
6b87b44de1e2b7aefec5c6d399b0a8615608a70b,0,pallavkul,2017-01-10 20:23:03+05:18,['d97b9d5f1c18c1467519490b42d8eceb05bba8b3'],21,36,57,24911612,6,0.6,0,1,28016
38b6f22eb42bf1b19c3553c2d1509b2b56983807,1,pallavkul,2017-01-10 20:30:21+05:18,['6b87b44de1e2b7aefec5c6d399b0a8615608a70b'],22,77,99,24911711,6,0.0625,0,1,28018
f5c573a367e280cb761cbc9003283c751aac5823,1,pallavkul,2017-01-10 20:36:09+05:18,['38b6f22eb42bf1b19c3553c2d1509b2b56983807'],4,26,30,24911741,3,1,1,1,28018
0b6b67024212dd559cd646b51e1cab27300e74d4,1,Renjith Kamath,2017-01-10 21:44:17+05:18,['f5c573a367e280cb761cbc9003283c751aac5823'],1,17,18,24911759,2,0.4,1,0.933333333,28018
5134c2dcc8d8034dea381051518e32e7936184d3,0,Sumit Mohanty,2017-01-10 08:31:40-08:00,['0b6b67024212dd559cd646b51e1cab27300e74d4'],11,24,35,24911794,2,0,1,1,28018
7244c701aff560fac24210c45b061b0c0b3ad83c,0,Renjith Kamath,2017-01-10 21:58:04+05:18,['5134c2dcc8d8034dea381051518e32e7936184d3'],89,320,409,24912203,7,,,,28022
e15531981541372de74f94b1588edd7398ce91f5,0,Renjith Kamath,2017-01-10 22:04:06+05:18,['7244c701aff560fac24210c45b061b0c0b3ad83c'],320,89,409,24912612,7,,,,28022
e10f6922eb972c581102b75d7fa50eabe0487fa2,1,Jonathan Hurley,2017-01-10 12:05:26-05:00,['e15531981541372de74f94b1588edd7398ce91f5'],55,553,608,24913220,20,0.206451613,0.529032258,1,28024
e65996f94d5c5d7d2b398f76fda18f4e01a4bf00,1,Nahappan Somasundaram,2017-01-10 09:44:03-08:00,['e10f6922eb972c581102b75d7fa50eabe0487fa2'],5,30,35,24913255,3,0.75,0.75,1,28024
8f8582bb81b18e703c83b7f634ee489fab8f1f71,1,ababiichuk,2017-01-10 20:52:20+02:00,['e65996f94d5c5d7d2b398f76fda18f4e01a4bf00'],8,57,65,24913320,2,0.956521739,0.956521739,1,28024
784cae2b01b0c5defcab1ea5219b3fdf2c6dac73,1,Xi Wang,2017-01-10 14:10:51-08:00,['8f8582bb81b18e703c83b7f634ee489fab8f1f71'],186,187,373,24913693,3,,,,28024
fecc9b80a83535734f1fbc9db8c35f48f6f7fc4b,1,Alejandro Fernandez,2017-01-10 16:44:44-08:00,['784cae2b01b0c5defcab1ea5219b3fdf2c6dac73'],11,1015,1026,24914719,17,0.21399177,0.87654321,0.563786008,28033
7f09e4c6a7751004132e41d1ccd9ec7e48998231,1,Miklos Gergely,2017-01-11 02:12:56+01:00,['fecc9b80a83535734f1fbc9db8c35f48f6f7fc4b'],5,27,32,24914751,2,,,,28033
ac66085b35b69264c6d161a00fc866b5e1a828da,1,Renjith Kamath,2017-01-11 07:01:40+05:18,['7f09e4c6a7751004132e41d1ccd9ec7e48998231'],115,354,469,24915220,10,,,,28037
c725d0f676686d97eb0cfdc8480a12dea7bfe7b9,1,Mugdha Varadkar,2017-01-11 14:43:12+05:18,['ac66085b35b69264c6d161a00fc866b5e1a828da'],3,75,78,24915298,11,,,,28038
d4c14e9a03c1af91514bae9268763868b603dfbe,1,Gaurav Nagar,2017-01-11 16:13:02+05:18,['c725d0f676686d97eb0cfdc8480a12dea7bfe7b9'],13,15,28,24915326,4,,,,28038
7b218f45978c215f599af9b83e519b548762fe60,0,Gaurav Nagar,2017-01-11 16:15:14+05:18,['d4c14e9a03c1af91514bae9268763868b603dfbe'],1,1,2,24915328,1,,,,28038
67b4bdd8e4561bc54e134f3e7075b1144b26b334,1,Miklos Gergely,2017-01-11 12:29:57+01:00,['7b218f45978c215f599af9b83e519b548762fe60'],22,256,278,24915606,5,0,0.698198198,0.995495495,28038
b7b21c24cebf7d8aa1bcd756b5b779db1f1a336a,0,Oleg Nechiporenko,2017-01-11 13:46:05+02:00,['67b4bdd8e4561bc54e134f3e7075b1144b26b334'],55,68,123,24915729,3,0.785714286,0.857142857,1,28038
5f62d3f56d1cfe618d1c6132f4a0186b28083426,0,Andrew Onishuk,2017-01-11 15:59:57+02:00,['b7b21c24cebf7d8aa1bcd756b5b779db1f1a336a'],0,2,2,24915731,2,,,,28038
9bf6bdfb14dc7c69f2a1ccb37ed71f68a1eefb78,1,Gaurav Nagar,2017-01-11 19:25:00+05:18,['5f62d3f56d1cfe618d1c6132f4a0186b28083426'],38,20,58,24915789,8,,,,28038
ce08967b97c58cc6760f7f5c0547cf24e2af4764,1,Oleg Nechiporenko,2017-01-11 16:40:08+02:00,['9bf6bdfb14dc7c69f2a1ccb37ed71f68a1eefb78'],4,5,9,24915798,1,1,1,1,28038
ca20cb82df7478a417f9205bcefcead067ff2b01,0,oleewere,2017-01-11 16:40:09+01:00,['ce08967b97c58cc6760f7f5c0547cf24e2af4764'],1,1,2,24915800,1,,,,28038
d8fccbbc8c531e9b38d689f11bbd4933a73694e0,0,oleewere,2017-01-11 16:50:32+01:00,['ca20cb82df7478a417f9205bcefcead067ff2b01'],0,2,2,24915802,1,,,,28038
dcf7c1971b41a4aa086894876500135a5dc1d439,0,Myroslav Papirkovskyi,2017-01-11 17:52:07+02:00,['d8fccbbc8c531e9b38d689f11bbd4933a73694e0'],0,4,4,24915806,4,,,,28038
3469c1fa3a7784117b57e678ff674f067831284a,0,oleewere,2017-01-11 16:54:23+01:00,['dcf7c1971b41a4aa086894876500135a5dc1d439'],1,1,2,24915808,1,,,,28038
2c48090005ee7e253170adff8fd35740b256dd52,1,Andrew Onishuk,2017-01-11 18:03:18+02:00,['3469c1fa3a7784117b57e678ff674f067831284a'],1,13,14,24915822,4,0.75,1,0.75,28038
d6b7c20be8a4077c66bf52f83c066f07914821fc,0,Andrew Onishuk,2017-01-11 18:06:44+02:00,['2c48090005ee7e253170adff8fd35740b256dd52'],0,5,5,24915827,1,0,0,0,28038
dda1657614ff13c50d3babe0e1044267ea574e39,1,Andrew Onishuk,2017-01-11 18:07:50+02:00,['d6b7c20be8a4077c66bf52f83c066f07914821fc'],822,682,1504,24917331,3,1,1,0.849056604,28038
e4158587315409c59f8afa7f6c872d420ae48b67,1,Nate Cole,2017-01-11 12:37:15-05:00,['dda1657614ff13c50d3babe0e1044267ea574e39'],22,207,229,24917560,4,0,0.330434783,0.982608696,28038
283ede623d7e3a6291b21165e996a0cd549bad6f,1,"Toader, Sebastian",2017-01-11 19:06:20+01:00,['e4158587315409c59f8afa7f6c872d420ae48b67'],10,256,266,24917826,13,0.536764706,0.808823529,0.919117647,28040
8152afcf06645de6dd0c6ccd0c5cccc25a765a71,0,Jonathan Hurley,2017-01-11 13:20:50-05:00,['283ede623d7e3a6291b21165e996a0cd549bad6f'],99,223,322,24918148,7,0,0.65625,0.96875,28040
6483710a28ec72ead21d44b13e02be268e229a16,1,Dipayan Bhowmick,2017-01-11 23:51:55+05:18,['8152afcf06645de6dd0c6ccd0c5cccc25a765a71'],45,152,197,24918345,10,1,1,1,28040
2643dd65348272f69b91160990d6e484289572ba,1,"Toader, Sebastian",2017-01-11 21:13:14+01:00,['6483710a28ec72ead21d44b13e02be268e229a16'],66,611,677,24919022,17,0.4375,0.994791667,1,28046
cb525062599d2014c9739da7a217b1b21808f188,0,Sumit Mohanty,2017-01-11 13:36:34-08:00,['2643dd65348272f69b91160990d6e484289572ba'],0,7,7,24919029,1,,,,28046
b2931c1a4adca28d263dfc88275d2bdea9187766,1,Jaimin Jetly,2017-01-11 14:02:57-08:00,['cb525062599d2014c9739da7a217b1b21808f188'],1,12,13,24919042,3,0,0,1,28046
0da2852f98640d262e06858fa6ee0c60dd75546a,0,Nahappan Somasundaram,2017-01-11 14:34:53-08:00,['b2931c1a4adca28d263dfc88275d2bdea9187766'],0,2,2,24919044,2,,,,28046
4975864796b9a301f4e0ee0b36673f41cb0f1b21,1,Mugdha Varadkar,2017-01-12 11:20:34+05:18,['0da2852f98640d262e06858fa6ee0c60dd75546a'],7,7,14,24919058,2,1,1,1,28046
5228e1847bd7b92d7a3379d26002879dbfeafffe,1,Tim Thorpe,2017-01-12 05:30:19-08:00,['4975864796b9a301f4e0ee0b36673f41cb0f1b21'],75,272,347,24919405,5,0.423423423,0.621621622,0.522522523,28047
384a7f0363a006f5050ec27646bdd7ae998d8232,0,Tim Thorpe,2017-01-12 06:10:46-08:00,['5228e1847bd7b92d7a3379d26002879dbfeafffe'],2,2,4,24919409,2,,,,28047
59a770f2edd5e2e40cff3221d9b972e97ba4afa5,1,Lisnichenko Dmitro,2017-01-12 16:24:30+02:00,['384a7f0363a006f5050ec27646bdd7ae998d8232'],33,302,335,24919744,3,0.184397163,0.985815603,0.730496454,28048
fdbe0939e9e42c54a1e0d4fbd953bc851eb46028,1,Lisnichenko Dmitro,2017-01-12 16:25:28+02:00,['59a770f2edd5e2e40cff3221d9b972e97ba4afa5'],26,37,63,24919807,5,0,0,0,28048
50cb77bb0b0e4b782107601497b083095fbd5221,1,Jonathan Hurley,2017-01-12 11:34:31-05:00,['fdbe0939e9e42c54a1e0d4fbd953bc851eb46028'],61,105,166,24919973,7,0,1,0.45,28048
06a60dedf3a6dcce82d92200d9a84147ccf34b37,1,Miklos Gergely,2017-01-12 17:57:38+01:00,['50cb77bb0b0e4b782107601497b083095fbd5221'],9,10,19,24919992,1,1,1,1,28048
e3587d555e0d6291dd5985c817fd7903ac801fe1,1,Miklos Gergely,2017-01-12 17:59:13+01:00,['06a60dedf3a6dcce82d92200d9a84147ccf34b37'],5,7,12,24920004,1,0,0,1,28048
a7280dd89298814925f7a7ad71225d2dee46dacb,1,Lisnichenko Dmitro,2017-01-12 19:14:17+02:00,['e3587d555e0d6291dd5985c817fd7903ac801fe1'],14,16,30,24920034,2,,,,28048
159e5beeba85f7a068999fe9ecde25b0e9bf0608,0,Lisnichenko Dmitro,2017-01-12 20:00:47+02:00,['a7280dd89298814925f7a7ad71225d2dee46dacb'],16,16,32,24920066,2,,,,28048
cc302f7d3c79d12fef8873acd76e962218aaac65,1,Alejandro Fernandez,2017-01-12 14:57:31-08:00,['159e5beeba85f7a068999fe9ecde25b0e9bf0608'],1,21,22,24920088,4,0,0,1,28048
36f8a762936e7d5c8b6319b5fade9e9f9b974733,1,Mugdha Varadkar,2017-01-13 10:36:46+05:18,['cc302f7d3c79d12fef8873acd76e962218aaac65'],13,31,44,24920132,1,0,0,0,28048
c63a4d7f6490c421cea3a9a2eb35f8c572f6bb9e,1,Mugdha Varadkar,2017-01-13 12:30:32+05:18,['36f8a762936e7d5c8b6319b5fade9e9f9b974733'],1,70,71,24920203,9,0.2,0.2,0.8,28048
2d40b127cd21c8467ec0b9d23251f469ba000ae6,0,Oleg Nechiporenko,2017-01-13 11:12:34+02:00,['c63a4d7f6490c421cea3a9a2eb35f8c572f6bb9e'],7,12,19,24920222,2,,,,28048
f0e829973158350b15f3be81944ba0a0e1ac0d25,1,Mugdha Varadkar,2017-01-13 15:31:01+05:18,['2d40b127cd21c8467ec0b9d23251f469ba000ae6'],4,11,15,24920237,3,0,0,0,28048
e5d17bc75c3d47b9f2979e26b4a011dd9e494398,1,Sandor Magyari,2017-01-13 13:46:06+01:00,['f0e829973158350b15f3be81944ba0a0e1ac0d25'],2,30,32,24920269,3,1,1,0.142857143,28048
0ee059dafef75a757c0fb4c97b14cb1f66e1d486,0,Di Li,2017-01-13 10:42:15-05:00,['e5d17bc75c3d47b9f2979e26b4a011dd9e494398'],1,4,5,24920274,2,,,,28048
fb50d88f182d02c36a27185142cab6c9e4b3659c,1,Di Li,2017-01-13 10:50:15-05:00,['0ee059dafef75a757c0fb4c97b14cb1f66e1d486'],26,38,64,24920338,3,1,0.428571429,0,28048
3283d9f20c35686d41edf7f9bb0430c8dd77eb24,1,Myroslav Papirkovskyi,2017-01-13 18:15:03+02:00,['fb50d88f182d02c36a27185142cab6c9e4b3659c'],8,46,54,24920392,3,0.722222222,0.777777778,0,28048
8c319269a5835c731bda182264688a7b670d3134,1,Siddharth Wagle,2017-01-13 09:07:56-08:00,['3283d9f20c35686d41edf7f9bb0430c8dd77eb24'],1,1,2,24920394,1,,,,28048
629cf68704c6b10aaa91a83fa93c992d2cf182f1,0,Nate Cole,2017-01-13 12:50:21-05:00,['8c319269a5835c731bda182264688a7b670d3134'],0,0,0,24920394,2,,,,28048
03f48a26e40fa526551e9597fe4feabb5023ba05,1,Xi Wang,2017-01-13 10:11:21-08:00,['629cf68704c6b10aaa91a83fa93c992d2cf182f1'],102,163,265,24920659,7,1,1,1,28048
62d657f2665cb169d0d235ab2ec244a49d0a538b,0,Nahappan Somasundaram,2017-01-13 11:22:50-08:00,['03f48a26e40fa526551e9597fe4feabb5023ba05'],0,8,8,24920667,1,,,,28048
5a7623a56c6e43eacdd44ec35bd62a2dfc11a2ed,1,Alejandro Fernandez,2017-01-13 11:57:56-08:00,['62d657f2665cb169d0d235ab2ec244a49d0a538b'],43,43,86,24920753,2,,,,28048
23893cc991c7e69c1685a1744a46a775633e52db,0,Aravindan Vijayan,2017-01-13 14:25:31-08:00,['5a7623a56c6e43eacdd44ec35bd62a2dfc11a2ed'],25,15,40,24920793,2,,,,28048
89452768c062b9d77b0f660845ebdb7d750694b5,1,Aravindan Vijayan,2017-01-13 14:38:08-08:00,['23893cc991c7e69c1685a1744a46a775633e52db'],3,13,16,24920809,5,,,,28048
86ed53e7427c58578bcbb2b894aa68d2f8c46698,1,Sumit Mohanty,2017-01-13 15:28:15-08:00,['89452768c062b9d77b0f660845ebdb7d750694b5'],81,529,610,24921419,7,0.014527845,0.88377724,0.89346247,28048
f5dafcfe218f55e197c90168ae6ac9738f1c99df,0,Sumit Mohanty,2017-01-13 15:43:01-08:00,['86ed53e7427c58578bcbb2b894aa68d2f8c46698'],2,5,7,24921426,2,,,,28048
39c8eed01133d459b483cc408bbe0c74c5c4a88a,1,Sumit Mohanty,2017-01-13 16:53:11-08:00,['f5dafcfe218f55e197c90168ae6ac9738f1c99df'],32,315,347,24921773,17,,,,28048
4b3dc9d41c1da885741c842245e6138ed7e67ba1,1,Yusaku Sako,2017-01-13 17:44:29-08:00,['39c8eed01133d459b483cc408bbe0c74c5c4a88a'],147,147,294,24922067,1,,,,28048
1b54f56d54ddc8a66293374b456c57136df1af60,1,Nate Cole,2017-01-13 21:54:38-05:00,['4b3dc9d41c1da885741c842245e6138ed7e67ba1'],78,652,730,24922797,43,0,0.714285714,0.952380952,28050
0a570c6713be7f9271b40657ee3b3aa01c26d887,0,Alex Antonenko,2017-01-14 08:05:36+02:00,['1b54f56d54ddc8a66293374b456c57136df1af60'],0,2,2,24922799,1,1,1,1,28050
ad574af9ca44d1760f0d45b25a98173c84dd4de4,0,Sumit Mohanty,2017-01-15 15:06:29-08:00,['0a570c6713be7f9271b40657ee3b3aa01c26d887'],3,3,6,24922805,2,,,,28050
ac843862d5e5ff322e005d32a9e1af4c905b596b,1,Mugdha Varadkar,2017-01-16 10:44:42+05:18,['ad574af9ca44d1760f0d45b25a98173c84dd4de4'],3,36,39,24922844,7,0.2,0.266666667,1,28050
56526a84f6db8158efef489f0bea38a5da3b83e1,0,Mugdha Varadkar,2017-01-16 10:50:28+05:18,['ac843862d5e5ff322e005d32a9e1af4c905b596b'],0,3,3,24922847,1,,,,28050
9cdd3e8a15f4aa6d1dd7b485ce6d530b06f0f7de,1,Nitiraj Rathore,2017-01-16 11:27:39+05:18,['56526a84f6db8158efef489f0bea38a5da3b83e1'],301,894,1195,24924042,40,0.117021277,0.893617021,1,28051
e17af8b29943afac66e3356ef876a925aca5fc4a,1,pallavkul,2017-01-16 14:09:43+05:18,['9cdd3e8a15f4aa6d1dd7b485ce6d530b06f0f7de'],43,577,620,24924662,18,0.961325967,1,1,28056
8b43080a0025f9146172005b20df3f3a170782fe,1,pallavkul,2017-01-16 14:36:19+05:18,['e17af8b29943afac66e3356ef876a925aca5fc4a'],5,108,113,24924775,9,0.543859649,0.947368421,0.807017544,28057
74a911fd264abe08a9d21ffea9f9958b2517bf0d,1,Miklos Gergely,2017-01-16 11:21:48+01:00,['8b43080a0025f9146172005b20df3f3a170782fe'],370,382,752,24925527,2,0,0,1,28057
e9c10b43e40f97d05921558e20108e0758f93f99,1,Miklos Gergely,2017-01-16 11:25:52+01:00,['74a911fd264abe08a9d21ffea9f9958b2517bf0d'],1126,1130,2256,24927783,1,0.8,1,1,28057
5f222d9ce040be3a84f937b514ec2dcf5aa2410e,0,Andrew Onishuk,2017-01-16 14:35:06+02:00,['e9c10b43e40f97d05921558e20108e0758f93f99'],30,46,76,24927859,2,,,,28057
8169394988ef1a06c2eb1013df46ee14445d49a9,1,"Toader, Sebastian",2017-01-16 13:43:01+01:00,['5f222d9ce040be3a84f937b514ec2dcf5aa2410e'],28,53,81,24927940,2,1,1,0.666666667,28057
bd02376367644a45e059e0b027f50cc09f4fb615,1,Gaurav Nagar,2017-01-16 18:24:28+05:18,['8169394988ef1a06c2eb1013df46ee14445d49a9'],13,16,29,24927969,1,1,0,0,28057
a4015da1be687b7a1c0e296c893356403d876127,0,Sandor Magyari,2017-01-16 15:51:26+01:00,['bd02376367644a45e059e0b027f50cc09f4fb615'],7,7,14,24927983,1,1,1,1,28057
1f55ea3b0f741521f55d737de2e535767fa2f2e0,1,Oleg Nechiporenko,2017-01-16 17:47:31+02:00,['a4015da1be687b7a1c0e296c893356403d876127'],2,2,4,24927987,1,,,,28057
69f0b6d7f1d5ade01b4d0876898ed8323862ae70,1,Jonathan Hurley,2017-01-16 10:53:49-05:00,['1f55ea3b0f741521f55d737de2e535767fa2f2e0'],9,15,24,24928011,4,,,,28057
0baa964398b0246e4fc2cb3f8c2d13640d6f5f66,0,"Toader, Sebastian",2017-01-16 17:52:54+01:00,['69f0b6d7f1d5ade01b4d0876898ed8323862ae70'],11,24,35,24928046,4,0,0.384615385,1,28057
79e92cf7004783bb9cbdad55d51ae791d0f019c3,0,Nitiraj Rathore,2017-01-16 22:13:52+05:18,['0baa964398b0246e4fc2cb3f8c2d13640d6f5f66'],18,20,38,24928084,2,,,,28057
3a489d012694e8622c9d80f2b6898bf6fc0a3cec,0,Andrew Onishuk,2017-01-16 19:21:50+02:00,['79e92cf7004783bb9cbdad55d51ae791d0f019c3'],0,3,3,24928087,1,,,,28057
70b6598d6106deb49ae6e659710797c2d627455f,0,Alex Antonenko,2017-01-16 20:28:57+02:00,['3a489d012694e8622c9d80f2b6898bf6fc0a3cec'],0,8,8,24928095,2,1,1,1,28057
2a006287f6a6646c02c146935655d30a3d37cd95,1,Alex Antonenko,2017-01-16 20:28:57+02:00,['70b6598d6106deb49ae6e659710797c2d627455f'],2,2,4,24928099,2,,,,28057
4393724735343f331c881dc5187ddb66d701b277,0,Alex Antonenko,2017-01-16 20:39:57+02:00,['2a006287f6a6646c02c146935655d30a3d37cd95'],1,0,1,24928100,1,,,,28057
e78b92b8da7e573848b26cae951195a46fed2cff,0,Di Li,2017-01-16 14:23:41-05:00,['4393724735343f331c881dc5187ddb66d701b277'],32,90,122,24928222,6,0.6,0,1,28058
7301a803190261608769e232d2da7505f20aa9ae,1,Di Li,2017-01-16 14:35:00-05:00,['e78b92b8da7e573848b26cae951195a46fed2cff'],2,2,4,24928226,2,,,,28058
54db4072e87e4efc09d68d9b4c53b6f562983d9f,0,Sangeeta Ravindran,2017-01-16 12:58:26-08:00,['7301a803190261608769e232d2da7505f20aa9ae'],3,3,6,24928232,1,1,1,1,28058
e0552d62e8229ee2cbbca216c491e3234b624d4d,0,Sangeeta Ravindran,2017-01-16 14:12:06-08:00,['54db4072e87e4efc09d68d9b4c53b6f562983d9f'],2,2,4,24928236,2,,,,28058
17db42826eb7f4c03f554fc7b2f5633d0a480934,1,Miklos Gergely,2017-01-16 23:57:10+01:00,['e0552d62e8229ee2cbbca216c491e3234b624d4d'],7,118,125,24928361,9,0.435483871,1,0.903225806,28059
abeb45e5648b29714182c80c9f8b98bf38120e34,0,Sumit Mohanty,2017-01-16 15:46:59-08:00,['17db42826eb7f4c03f554fc7b2f5633d0a480934'],24,11,35,24928396,4,1,0.615384615,0,28059
07430c4c41f53bfa95806e662efd64a61f66ed62,1,Swapan Shridhar,2017-01-16 16:51:51-08:00,['abeb45e5648b29714182c80c9f8b98bf38120e34'],20,134,154,24928550,6,0.052083333,0.020833333,0,28059
61aa4c52ddf45e5c0a3f731d3676e462260ffc7a,1,Siddharth Wagle,2017-01-16 17:01:14-08:00,['07430c4c41f53bfa95806e662efd64a61f66ed62'],1,3,4,24928554,1,,,,28059
733f2478ac964f9af33a6b82490062295c4a42b7,1,Sumit Mohanty,2017-01-16 17:09:51-08:00,['61aa4c52ddf45e5c0a3f731d3676e462260ffc7a'],11,24,35,24928589,4,0,0.384615385,1,28059
5bdd6cf7e24469da3d5bec987939b35fff263983,1,Siddharth Wagle,2017-01-16 17:20:18-08:00,['733f2478ac964f9af33a6b82490062295c4a42b7'],1,1,2,24928591,1,,,,28059
326cc1b2a1e05073050a38ea104d6d63ed76f373,1,Alejandro Fernandez,2017-01-16 17:47:16-08:00,['5bdd6cf7e24469da3d5bec987939b35fff263983'],645,1486,2131,24930722,12,0.36969697,0.349494949,0.129292929,28060
ded8ee71c1c50ac76bc70ad8df8c39c7654d3fe9,0,Nahappan Somasundaram,2017-01-16 20:03:15-08:00,['326cc1b2a1e05073050a38ea104d6d63ed76f373'],3,64,67,24930789,2,0,0.928571429,1,28060
badf9f7bb7037597e0887614ce68bfb800f7b705,0,Mugdha Varadkar,2017-01-17 09:43:37+05:18,['ded8ee71c1c50ac76bc70ad8df8c39c7654d3fe9'],3,11,14,24930803,1,0,0,1,28060
285666fac5a14f461950386d2687d172a3574283,1,Dipayan Bhowmick,2017-01-17 11:57:27+05:18,['badf9f7bb7037597e0887614ce68bfb800f7b705'],5,677,682,24931485,16,0.59765625,0.92578125,0.7109375,28067
aae7013f48983b093b31897997c9e725d8110f16,1,"Toader, Sebastian",2017-01-17 09:18:15+01:00,['285666fac5a14f461950386d2687d172a3574283'],17,63,80,24931565,9,0.352941176,0.647058824,1,28068
684c9e64641c71e1923315e743c236afb5a328fd,1,Gaurav Nagar,2017-01-17 14:41:58+05:18,['aae7013f48983b093b31897997c9e725d8110f16'],109,117,226,24931791,9,1,1,1,28068
b4bb42a7dbbe08287d09cec6cef64f43f0d43f2f,1,Gaurav Nagar,2017-01-17 14:43:45+05:18,['684c9e64641c71e1923315e743c236afb5a328fd'],22,52,74,24931865,5,0.291666667,0.291666667,1,28068
112cea4506ad18b49aa56989f1b1db786565ee50,0,Lisnichenko Dmitro,2017-01-17 12:06:14+02:00,['b4bb42a7dbbe08287d09cec6cef64f43f0d43f2f'],24,9,33,24931898,9,,,,28068
b7d8f5e9767e94516a6990ac09bbbfb6ddece2fd,1,Lisnichenko Dmitro,2017-01-17 12:06:41+02:00,['112cea4506ad18b49aa56989f1b1db786565ee50'],11,146,157,24932055,12,0.010989011,0.791208791,1,28068
cba69d93c0e062b37d89b75db00a16e0fa4369e2,1,ababiichuk,2017-01-17 12:19:40+02:00,['b7d8f5e9767e94516a6990ac09bbbfb6ddece2fd'],1288,1582,2870,24934925,14,0.563981043,0.938388626,0.962085308,28068
c326ce4e63ccc941df925198125ab42cc74f385b,0,Gaurav Nagar,2017-01-17 15:36:12+05:18,['cba69d93c0e062b37d89b75db00a16e0fa4369e2'],1,2,3,24934928,1,0,0,1,28068
8b22dd01811759bef9a325773fa9c95862bac57c,1,pallavkul,2017-01-17 16:08:02+05:18,['c326ce4e63ccc941df925198125ab42cc74f385b'],23,107,130,24935058,8,0.652173913,1,1,28068
1524fd775d4b25d0896c648cb1bbc8ed3644a73d,1,Mugdha Varadkar,2017-01-17 18:04:38+05:18,['8b22dd01811759bef9a325773fa9c95862bac57c'],946,1889,2835,24937893,102,0,0.714285714,0.651785714,28074
e3e9f70de671b0700153af8b0af0acd5bc5ae89e,1,Lisnichenko Dmitro,2017-01-17 15:47:50+02:00,['1524fd775d4b25d0896c648cb1bbc8ed3644a73d'],0,5,5,24937898,1,0,1,1,28074
71c5b1f342aefe156d0af19264da0d2f0184ed8f,1,ababiichuk,2017-01-17 17:00:09+02:00,['e3e9f70de671b0700153af8b0af0acd5bc5ae89e'],3,176,179,24938077,8,0.714285714,1,1,28075
83716672e99cbf012f9db1561c7d1d044459ae4f,1,ababiichuk,2017-01-17 18:35:37+02:00,['71c5b1f342aefe156d0af19264da0d2f0184ed8f'],8,10,18,24938095,2,,,,28075
e83837e1092f8eebc3e942a5d7f21e9749c0a12d,0,Aleksandr Kovalenko,2017-01-17 19:50:18+02:00,['83716672e99cbf012f9db1561c7d1d044459ae4f'],3,4,7,24938102,2,,,,28075
fecf197c710dcd99cc2c8d1189e393fc227e5fb3,1,Dipayan Bhowmick,2017-01-18 00:08:12+05:18,['e83837e1092f8eebc3e942a5d7f21e9749c0a12d'],7,61,68,24938170,6,0.384615385,1,1,28076
6fa54aeeb368c8f50803b615cc14b9bf94964205,1,Nahappan Somasundaram,2017-01-17 11:01:37-08:00,['fecf197c710dcd99cc2c8d1189e393fc227e5fb3'],64,3,67,24938237,2,1,0.071428571,0,28076
37baf9a1a96fe3d668666b12e9cc6f65e2f64439,0,Richard Zang,2017-01-17 11:50:33-08:00,['6fa54aeeb368c8f50803b615cc14b9bf94964205'],5,6,11,24938248,2,1,1,1,28076
c689096d13c62beafe1eb52a8aa9a4a8c4d9cd63,0,Sumit Mohanty,2017-01-17 12:18:06-08:00,['37baf9a1a96fe3d668666b12e9cc6f65e2f64439'],66,6924,6990,24945238,21,,,,28086
c916dda5d78ddb2f1e68ba7bfd359be5af7dcbc2,1,Sumit Mohanty,2017-01-17 13:28:43-08:00,['c689096d13c62beafe1eb52a8aa9a4a8c4d9cd63'],6924,66,6990,24952228,21,,,,28086
b8ef3ad1bb65b64feeea1d21491b1cd6506f20c1,1,Swapan Shridhar,2017-01-17 13:30:51-08:00,['c916dda5d78ddb2f1e68ba7bfd359be5af7dcbc2'],33,35,68,24952296,3,0,0,0,28086
4d44269f1aff07bc09cc0677bf9b626a62b93d61,1,Sumit Mohanty,2017-01-17 13:35:00-08:00,['b8ef3ad1bb65b64feeea1d21491b1cd6506f20c1'],66,66,132,24952428,11,,,,28086
b2ba7ddc8fe7380c49a39285f68918492cacf6f1,0,Nate Cole,2017-01-17 16:53:39-05:00,['4d44269f1aff07bc09cc0677bf9b626a62b93d61'],11,153,164,24952592,6,0,0.453125,0.5,28087
4dac27831c2498e12fff05d33a95444e3abffdff,1,Sumit Mohanty,2017-01-17 14:15:57-08:00,['b2ba7ddc8fe7380c49a39285f68918492cacf6f1'],15,1394,1409,24954001,17,0.41509434,0.41509434,1,28087
410f2943d5babf6b9bd3e2f225fbbe9ac5761ee2,1,Jonathan Hurley,2017-01-17 18:51:50-05:00,['4dac27831c2498e12fff05d33a95444e3abffdff'],149,455,604,24954605,8,0.113207547,0.5,1,28087
39174ea958150041957de9e7c65ba615da61483c,1,Sumit Mohanty,2017-01-17 18:08:13-08:00,['410f2943d5babf6b9bd3e2f225fbbe9ac5761ee2'],6,379,385,24954990,4,0,0.942857143,1,28087
6ccff934da9f5c387dd55e37d3d478037454b12c,1,Nahappan Somasundaram,2017-01-17 18:59:22-08:00,['39174ea958150041957de9e7c65ba615da61483c'],2,60,62,24955052,3,0,0.5,0.5,28087
e0d78edb94cbbfe56b075487d241143f337a0a87,0,Sumit Mohanty,2017-01-17 21:01:21-08:00,['6ccff934da9f5c387dd55e37d3d478037454b12c'],57,74,131,24955183,4,0,0,0,28087
7d2388b35b7c6b477244c7ed5e9a1f480e98ccf9,1,Gaurav Nagar,2017-01-18 12:34:56+05:18,['e0d78edb94cbbfe56b075487d241143f337a0a87'],24,39,63,24955246,7,1,1,1,28087
bc77c9ca0fa8843a7e2a592efcfbcff5655dbb90,0,Mugdha Varadkar,2017-01-18 12:39:22+05:18,['7d2388b35b7c6b477244c7ed5e9a1f480e98ccf9'],1,1,2,24955248,1,,,,28087
15233860e631e8db568e797b3d894c0da465bf72,1,Dipayan Bhowmick,2017-01-18 12:52:19+05:18,['bc77c9ca0fa8843a7e2a592efcfbcff5655dbb90'],0,2,2,24955250,1,0,1,1,28087
189fae52f11a975bb814884a844d55fedd23a51d,1,Nitiraj Rathore,2017-01-18 13:11:31+05:18,['15233860e631e8db568e797b3d894c0da465bf72'],166,920,1086,24956336,13,0.906705539,0.868804665,0.752186589,28091
ed93a5628453265943dcde5d1abbea1130376174,1,"Toader, Sebastian",2017-01-18 11:00:40+01:00,['189fae52f11a975bb814884a844d55fedd23a51d'],23,5,28,24956364,9,0,0,0,28091
f684c2b874c54108e8a313361a0ee8f856ff7dee,1,Sandor Magyari,2017-01-18 11:56:40+01:00,['ed93a5628453265943dcde5d1abbea1130376174'],35,211,246,24956610,3,0.033898305,0.957627119,0,28091
f7155d9c40362d084bae5e695b0af1fe8fd584c3,1,Gaurav Nagar,2017-01-18 16:48:01+05:18,['f684c2b874c54108e8a313361a0ee8f856ff7dee'],10,46,56,24956666,5,0.863636364,0.863636364,1,28091
61d0f640b0d647b9c196f60dcd09b41adba05504,1,Gaurav Nagar,2017-01-18 16:53:30+05:18,['f7155d9c40362d084bae5e695b0af1fe8fd584c3'],1,4,5,24956671,2,1,1,1,28091
d7f1e8c00e574e5612f40e286b9795bd1e531259,0,Oleg Nechiporenko,2017-01-18 15:35:20+02:00,['61d0f640b0d647b9c196f60dcd09b41adba05504'],201,313,514,24957185,13,1,1,0.962962963,28092
753a5b0362c53b1d8677ff5cf0806ac1058baf4b,1,Sandor Magyari,2017-01-18 16:42:44+01:00,['d7f1e8c00e574e5612f40e286b9795bd1e531259'],11,72,83,24957268,3,0,1,0.304347826,28092
eb2c904e1b526e1d581e8985e8e966e3d0ce1eb8,0,Nate Cole,2017-01-18 10:57:13-05:00,"['cd245c00abaa5720675324a383e691434eabcf32', 'd7f1e8c00e574e5612f40e286b9795bd1e531259']",9518,29608,39126,24996394,805,,,,28092
cf67fb9fe16157ce10c0d6118f1a22000104aa6f,1,Vitaly Brodetskyi,2017-01-18 21:08:23+02:00,['753a5b0362c53b1d8677ff5cf0806ac1058baf4b'],14,10,24,24996418,3,1,0,1,28092
52c86109cc4570cf121ae46a22e5ed48ed67f420,0,Alex Antonenko,2017-01-18 22:13:06+02:00,['cf67fb9fe16157ce10c0d6118f1a22000104aa6f'],1,4,5,24996423,1,1,1,1,28092
c27fdbc22ed021fc336328960f9215eb53cbb76c,0,Alejandro Fernandez,2017-01-18 13:40:42-08:00,['52c86109cc4570cf121ae46a22e5ed48ed67f420'],0,37,37,24996460,1,,,,28093
4982205059e3ee2b8e4423c9ee889bd81ac7ed61,1,Miklos Gergely,2017-01-19 00:36:48+01:00,['c27fdbc22ed021fc336328960f9215eb53cbb76c'],26,88,114,24996574,8,0.307692308,1,1,28093
77e8dee9c5110a53c642d697291b9e767e76138c,1,Miklos Gergely,2017-01-19 00:39:54+01:00,['4982205059e3ee2b8e4423c9ee889bd81ac7ed61'],2,8,10,24996584,1,,,,28093
348326af8374880be69870e16be19997053f2635,0,Alejandro Fernandez,2017-01-18 17:31:53-08:00,['77e8dee9c5110a53c642d697291b9e767e76138c'],0,114,114,24996698,4,,,,28094
990747fe7d16874ef9788b1859bd0bcc6f9e2676,0,Alejandro Fernandez,2017-01-18 17:36:03-08:00,['348326af8374880be69870e16be19997053f2635'],0,4,4,24996702,1,,,,28094
74faed7b58e2a894714c362d017303a36d2335ce,1,Gaurav Nagar,2017-01-19 10:51:42+05:18,['990747fe7d16874ef9788b1859bd0bcc6f9e2676'],1,6,7,24996709,3,0.8,1,1,28094
37e0d91044c89c49806de87e2e25a018c01d209e,1,Sumit Mohanty,2017-01-18 22:46:22-08:00,['74faed7b58e2a894714c362d017303a36d2335ce'],21,140,161,24996870,11,0.491803279,0.950819672,0.950819672,28094
f83881b45b205437779187df22e8fc33c75b68ff,1,Andrew Onishuk,2017-01-19 10:51:54+02:00,['37e0d91044c89c49806de87e2e25a018c01d209e'],9,9,18,24996888,7,,,,28094
87eef6e97cd3e39f928bf99cdd00079e2c89c6d6,1,Robert Levas,2017-01-19 05:04:24-05:00,['f83881b45b205437779187df22e8fc33c75b68ff'],70,75,145,24997033,38,0,0,1,28094
67c6f5561aec7e51472aee521ae5b84c82ae4353,1,Mugdha Varadkar,2017-01-19 15:30:23+05:18,['87eef6e97cd3e39f928bf99cdd00079e2c89c6d6'],204,220,424,24997457,5,1,0,0,28094
a26fefccdd6a5f10acd9f41d9f8bcf417d55bd8c,0,Andrii Tkach,2017-01-19 13:54:08+02:00,['67c6f5561aec7e51472aee521ae5b84c82ae4353'],6,47,53,24997510,12,1,1,1,28094
a06c44c6fee9b7555b713ec0b63880ebaafe889a,1,Andrew Onishuk,2017-01-19 14:29:30+02:00,['a26fefccdd6a5f10acd9f41d9f8bcf417d55bd8c'],1,1,2,24997512,1,,,,28094
ee8bbfb008c1d261bc726c17b7fcc917fbf5a862,1,Oleg Nechiporenko,2017-01-19 15:00:28+02:00,['a06c44c6fee9b7555b713ec0b63880ebaafe889a'],2,67,69,24997581,2,1,1,1,28094
556c62681025b1d6731710324dd1220e173f4bd2,1,Gaurav Nagar,2017-01-19 18:23:04+05:18,['ee8bbfb008c1d261bc726c17b7fcc917fbf5a862'],7,5,12,24997593,1,1,0,0,28094
5567b7f0d1ac57164ce851c4244573be2605bd06,1,oleewere,2017-01-19 14:13:37+01:00,['556c62681025b1d6731710324dd1220e173f4bd2'],559,1790,2349,24999942,59,0.735714286,0.795238095,0.785714286,28112
7df6416e47cdbfa08b28aa673c7a23d83f73aff0,1,Andrew Onishuk,2017-01-19 15:51:24+02:00,['5567b7f0d1ac57164ce851c4244573be2605bd06'],0,1,1,24999943,1,,,,28112
ab4bbb647a0298207b25393056d610136e3593b9,0,Di Li,2017-01-19 12:20:06-05:00,['7df6416e47cdbfa08b28aa673c7a23d83f73aff0'],1,4,5,24999948,1,0,0,1,28112
504b455282fc54a12d724879a83a346d41e3659b,0,Yusaku Sako,2017-01-19 10:42:35-08:00,['ab4bbb647a0298207b25393056d610136e3593b9'],6,1,7,24999955,1,,,,28112
de8bf601918efbeb66ef68d25364aaed4b672172,1,"Toader, Sebastian",2017-01-19 20:56:02+01:00,['504b455282fc54a12d724879a83a346d41e3659b'],23,632,655,25000610,16,0.719764012,0.587020649,0.852507375,28114
d540f943da59d196b377a9e15fcd2e6dcb50483b,1,Jonathan Hurley,2017-01-19 16:11:09-05:00,['de8bf601918efbeb66ef68d25364aaed4b672172'],519,694,1213,25001823,17,0.782608696,1,1,28114
2200dda431842c2efe5c27b7db1cf1bee43a289a,0,Aleksandr Kovalenko,2017-01-19 23:33:24+02:00,['d540f943da59d196b377a9e15fcd2e6dcb50483b'],0,2,2,25001825,1,,,,28114
4531f733742d933b85d9437b68cc2dc7b24befce,0,Sangeeta Ravindran,2017-01-19 14:55:53-08:00,['2200dda431842c2efe5c27b7db1cf1bee43a289a'],1,1,2,25001827,1,,,,28114
ddcc13b40902f7fc9144bcaa2af5b54d85442dfa,1,Siddharth Wagle,2017-01-19 16:11:19-08:00,['4531f733742d933b85d9437b68cc2dc7b24befce'],26,22,48,25001875,5,0.5,0.75,0,28114
bbacefd44a52bfd0a82c6067f9974944623cfdec,0,Alejandro Fernandez,2017-01-19 16:23:28-08:00,['ddcc13b40902f7fc9144bcaa2af5b54d85442dfa'],4,4,8,25001883,3,,,,28114
ac907ced86bbec35f3cf068b4764c23789cf3a17,1,Swapan Shridhar,2017-01-19 17:11:06-08:00,['bbacefd44a52bfd0a82c6067f9974944623cfdec'],17,17,34,25001917,4,1,0.5,0.5,28114
77b5776617bb448019250d7785c103dbde4ecd24,0,Jayush Luniya,2017-01-19 17:52:21-08:00,['ac907ced86bbec35f3cf068b4764c23789cf3a17'],0,92,92,25002009,2,,,,28114
53b3ecfd91eb2a4d21462c28e3df15f1fe18fbcb,1,Richard Zang,2017-01-19 18:02:32-08:00,['77b5776617bb448019250d7785c103dbde4ecd24'],32,14,46,25002055,3,0,1,0,28114
6ba9bd0a7d5534838a7c1679675cf1848806990f,1,"Toader, Sebastian",2017-01-20 06:55:14+01:00,['53b3ecfd91eb2a4d21462c28e3df15f1fe18fbcb'],39,46,85,25002140,4,1,1,0.5,28114
2c362fd0fedb63831ea890bfda984b1cde56d216,1,Lisnichenko Dmitro,2017-01-20 12:16:22+02:00,['6ba9bd0a7d5534838a7c1679675cf1848806990f'],1866,3088,4954,25007094,123,0.821656051,0.78343949,0.707006369,28125
a51532ac3c713906b956471bc54fd3d90df5ca7e,1,pallavkul,2017-01-20 15:39:25+05:18,['2c362fd0fedb63831ea890bfda984b1cde56d216'],56,245,301,25007395,8,0.961904762,1,1,28127
a382bed7f55be632fd03e1b02bb8a01151234b24,1,"Toader, Sebastian",2017-01-20 12:41:02+01:00,['a51532ac3c713906b956471bc54fd3d90df5ca7e'],11,170,181,25007576,18,0.823529412,1,1,28129
c55fa4e12f8e9148bf96c3cd7be9c2d834416970,1,oleewere,2017-01-20 12:46:49+01:00,['a382bed7f55be632fd03e1b02bb8a01151234b24'],397,425,822,25008398,1,0.166666667,0.5,1,28129
6e8c2263f36f9bdb59bf56a1879af93de9c91f39,0,Lisnichenko Dmitro,2017-01-20 14:00:23+02:00,['c55fa4e12f8e9148bf96c3cd7be9c2d834416970'],0,28,28,25008426,2,,,,28129
7131068df0cef726b9044e7b4ffe4977d86c6d88,1,Oleg Nechiporenko,2017-01-20 14:02:48+02:00,['6e8c2263f36f9bdb59bf56a1879af93de9c91f39'],12,40,52,25008478,4,1,1,1,28129
9da97be3d9099c8b31e2ee5e4f942f4dd801e3c2,1,ababiichuk,2017-01-20 15:01:52+02:00,['7131068df0cef726b9044e7b4ffe4977d86c6d88'],9,37,46,25008524,4,1,1,1,28129
ed157b19050d9c0dae4fad15d07c25f278de25d8,0,oleewere,2017-01-20 16:33:08+01:00,['9da97be3d9099c8b31e2ee5e4f942f4dd801e3c2'],104,0,104,25008628,2,,,,28129
8abda6ce1a75917f4db5df95f3485b17d71e84dd,1,Myroslav Papirkovskyi,2017-01-20 17:45:44+02:00,['ed157b19050d9c0dae4fad15d07c25f278de25d8'],0,74,74,25008702,3,0.2,0.92,0.92,28129
7e0097501daa5177ee38450b3a9f0e47d7ebf1a7,1,Robert Levas,2017-01-20 12:38:27-05:00,['8abda6ce1a75917f4db5df95f3485b17d71e84dd'],126,211,337,25009039,7,0.314285714,1,1,28129
c46ccc51b3fd06acf3a830f5306a482338ef5617,1,Swapan Shridhar,2017-01-20 10:45:15-08:00,['7e0097501daa5177ee38450b3a9f0e47d7ebf1a7'],17,33,50,25009089,5,0,0,0,28129
2b926001bf40cbd03037bb8614eaab75e4baecea,0,Sumit Mohanty,2017-01-20 10:55:41-08:00,['c46ccc51b3fd06acf3a830f5306a482338ef5617'],5,5,10,25009099,4,,,,28129
83cf094b570731920781192db4f4586a3056e382,1,Alejandro Fernandez,2017-01-20 12:12:14-08:00,['2b926001bf40cbd03037bb8614eaab75e4baecea'],6,53,59,25009158,29,1,1,0,28129
ec6ba0abbf2b1ce343f370f63512d45e7add9a40,0,"Toader, Sebastian",2017-01-20 23:18:13+01:00,['83cf094b570731920781192db4f4586a3056e382'],3,4,7,25009165,2,,,,28129
1bf025988d1bd1ca4bbce6ff8fb7dea21091a3c2,1,Sumit Mohanty,2017-01-20 15:20:01-08:00,['ec6ba0abbf2b1ce343f370f63512d45e7add9a40'],8,13,21,25009186,1,0,0,1,28129
a6ab3881c4cdfaff906e164bec56db82ef4aa8b8,1,Yusaku Sako,2017-01-21 09:45:04-08:00,['1bf025988d1bd1ca4bbce6ff8fb7dea21091a3c2'],18,1398,1416,25010602,4,0,0,1,28131
c4bbeeb29d8f9e3b04d20e38570769f3cc3fdec6,1,Yusaku Sako,2017-01-21 09:49:40-08:00,['a6ab3881c4cdfaff906e164bec56db82ef4aa8b8'],9,82,91,25010693,2,0.484848485,1,0.484848485,28131
75100cb4da9a4e523d726736267997ebf632639c,0,"Toader, Sebastian",2017-01-21 22:56:44+01:00,['c4bbeeb29d8f9e3b04d20e38570769f3cc3fdec6'],0,6,6,25010699,6,,,,28131
f98c2b4ed5189d9bf3048d4829e21569b447b12e,0,Miklos Gergely,2017-01-21 23:18:13+01:00,['75100cb4da9a4e523d726736267997ebf632639c'],38,46,84,25010783,2,0,1,1,28131
274969b4d927aa654b98e75d8277c76d102908a7,1,Robert Levas,2017-01-22 09:24:18-05:00,['f98c2b4ed5189d9bf3048d4829e21569b447b12e'],211,126,337,25011120,7,0.685714286,0,0,28131
593234b76ab8f9ec67f27f504b03285286120358,0,Robert Levas,2017-01-22 10:44:18-05:00,['274969b4d927aa654b98e75d8277c76d102908a7'],126,211,337,25011457,7,0.314285714,1,1,28131
2463b0a2632668c778293ffe352e928ff5ccf7b3,1,Renjith Kamath,2017-01-23 11:33:21+05:18,['593234b76ab8f9ec67f27f504b03285286120358'],11,5,16,25011473,1,0.111111111,0.111111111,0.111111111,28131
f4a3dbcbce0efe4b741a63277338b813ab52ae5c,1,Renjith Kamath,2017-01-23 11:41:43+05:18,['2463b0a2632668c778293ffe352e928ff5ccf7b3'],118,17,135,25011608,2,1,0,0,28131
9abe8da6e582f8a011bec1889d87f2186a79550f,1,pallavkul,2017-01-23 12:13:22+05:18,['f4a3dbcbce0efe4b741a63277338b813ab52ae5c'],4,3,7,25011615,2,,,,28131
3e5185acaea24bfeb28f4b10da6d3a94c90dcacd,1,pallavkul,2017-01-23 14:48:03+05:18,['9abe8da6e582f8a011bec1889d87f2186a79550f'],21,169,190,25011805,12,0.647727273,0.602272727,0.943181818,28131
8362dcefd6550323f94fabdf40dfcbedd2db4fc2,0,Lisnichenko Dmitro,2017-01-23 12:13:14+02:00,['3e5185acaea24bfeb28f4b10da6d3a94c90dcacd'],1,1,2,25011807,1,,,,28131
49ba635950d2632dcac406e242df94f8a131ce2f,0,Sandor Magyari,2017-01-23 12:55:15+01:00,['8362dcefd6550323f94fabdf40dfcbedd2db4fc2'],13,67,80,25011887,5,0.416666667,0.416666667,1,28132
09c1894f7544067e5ab53fedafabea030815be9e,1,Andrii Tkach,2017-01-23 14:30:09+02:00,['49ba635950d2632dcac406e242df94f8a131ce2f'],33,33,66,25011953,32,,,,28132
9bd8b7f2ff1c7d2ca2cfd4bf8b0833a1bec98bb9,1,oleewere,2017-01-23 13:33:53+01:00,['09c1894f7544067e5ab53fedafabea030815be9e'],16,154,170,25012123,4,1,1,0.785714286,28134
b6b43785ea2f335734a647771cb468ccf89da06b,1,oleewere,2017-01-23 13:33:54+01:00,['9bd8b7f2ff1c7d2ca2cfd4bf8b0833a1bec98bb9'],16,11,27,25012150,2,0,0,0,28134
a6fd5cb04e47d85a6de43b403276fd5992361745,1,pallavkul,2017-01-23 18:06:33+05:18,['b6b43785ea2f335734a647771cb468ccf89da06b'],1,25,26,25012176,3,0,0.076923077,0.538461538,28134
74aff7c645c987b692188e0a48e627896e6cf70a,1,pallavkul,2017-01-23 18:11:57+05:18,['a6fd5cb04e47d85a6de43b403276fd5992361745'],130,347,477,25012653,21,0.697986577,1,0.953020134,28134
cacb1cccf9eda0ff13890310dc1e99208287818a,0,pallavkul,2017-01-23 18:21:31+05:18,['74aff7c645c987b692188e0a48e627896e6cf70a'],19,17,36,25012689,4,0,0,0,28134
aaa99316f42b5f7633bb8b2ace3d2557c73a5500,0,Oleg Nechiporenko,2017-01-23 15:07:04+02:00,['cacb1cccf9eda0ff13890310dc1e99208287818a'],6,6,12,25012701,1,,,,28134
c32eb48ed8421d0445ae7cace9421b9eb1bcc41a,1,Gaurav Nagar,2017-01-23 19:26:01+05:18,['aaa99316f42b5f7633bb8b2ace3d2557c73a5500'],24,95,119,25012820,5,0,1,0,28134
203e9fab7b6c4ae1895a8c545991ada8b9e7503e,0,Lisnichenko Dmitro,2017-01-23 16:46:45+02:00,['c32eb48ed8421d0445ae7cace9421b9eb1bcc41a'],2,2,4,25012824,1,,,,28134
9bb27b42b85643b4fae89e54801171abbc3ec2ad,0,Lisnichenko Dmitro,2017-01-23 18:00:45+02:00,['203e9fab7b6c4ae1895a8c545991ada8b9e7503e'],4,11,15,25012839,1,1,1,1,28134
8a64be42043380ad5c35b0517a92e9c0239d2d4b,0,Robert Levas,2017-01-23 11:36:53-05:00,['9bb27b42b85643b4fae89e54801171abbc3ec2ad'],1,11,12,25012851,2,0,1,1,28134
918fd597bc19958ed16f45b8bfce63debd325fd4,1,Jonathan Hurley,2017-01-23 11:39:53-05:00,['8a64be42043380ad5c35b0517a92e9c0239d2d4b'],40,47,87,25012938,8,0,1,1,28134
b2d78ac5f3136bc9d55e3f8806726146278bd654,0,Di Li,2017-01-23 12:03:55-05:00,['918fd597bc19958ed16f45b8bfce63debd325fd4'],2,2,4,25012942,1,,,,28134
796658f679a8176a62445211234426f02172cdbd,1,Andrew Onishuk,2017-01-23 19:54:05+02:00,['b2d78ac5f3136bc9d55e3f8806726146278bd654'],3,3,6,25012948,3,,,,28134
3871f4a8d31aff1f61bad695ec5eb884820638c0,1,ababiichuk,2017-01-23 20:36:07+02:00,['796658f679a8176a62445211234426f02172cdbd'],154,317,471,25013419,5,0.547945205,0.979452055,0.856164384,28134
3ade321478499ba9eff7cb703b13760130a2cf60,1,Jaimin Jetly,2017-01-23 11:11:16-08:00,['3871f4a8d31aff1f61bad695ec5eb884820638c0'],5,79,84,25013503,2,0,0,0,28134
a51ede8480e22e21a738bfe9921eb49d7e10a3aa,0,Siddharth Wagle,2017-01-23 11:14:35-08:00,['3ade321478499ba9eff7cb703b13760130a2cf60'],2,3,5,25013508,1,0,0,0,28134
7b0ee28ef2a313335ff81ef62574c37ca6fe1347,0,Di Li,2017-01-23 15:26:52-05:00,['a51ede8480e22e21a738bfe9921eb49d7e10a3aa'],7,14,21,25013529,1,1,1,1,28134
9c952c300881623de5911dab06fa24f2a934b1a7,1,oleewere,2017-01-24 00:30:25+01:00,['7b0ee28ef2a313335ff81ef62574c37ca6fe1347'],60,135,195,25013724,3,1,1,1,28134
796f52a47acb8a04c4e8a7e225863cd848460ed7,0,Swapan Shridhar,2017-01-23 17:46:59-08:00,['9c952c300881623de5911dab06fa24f2a934b1a7'],1,3,4,25013728,1,,,,28134
c6c35555eb157f3cd80397db428d21441d3ec5e6,1,Vitaly Brodetskyi,2017-01-24 13:19:28+02:00,['796f52a47acb8a04c4e8a7e225863cd848460ed7'],3,79,82,25013810,5,0.916666667,0.916666667,1,28135
75b30a4e974bce0df3cd9d2d0efc428f101d8601,0,Gaurav Nagar,2017-01-24 20:17:12+05:18,['c6c35555eb157f3cd80397db428d21441d3ec5e6'],2,2,4,25013814,1,,,,28135
d0dc19e0c95000a87884029ddb6c7ab4f3f32fb7,1,"Toader, Sebastian",2017-01-24 16:04:24+01:00,['75b30a4e974bce0df3cd9d2d0efc428f101d8601'],55,874,929,25014743,34,1,1,1,28139
ad0f4ecc67e39d109449e945b5108440059b4240,1,Aravindan Vijayan,2017-01-24 10:52:56-08:00,['d0dc19e0c95000a87884029ddb6c7ab4f3f32fb7'],0,2822,2822,25017565,7,0.578947368,0.6,0.978947368,28142
d77f3a54fcbb79e9a2518a56bb78b0468a8a8b4f,1,Di Li,2017-01-24 15:19:41-05:00,['ad0f4ecc67e39d109449e945b5108440059b4240'],4,59,63,25017628,4,1,1,1,28143
f4f7571d8f9a7709f030cd2587052492e40e8527,1,Nahappan Somasundaram,2017-01-24 12:34:25-08:00,['d77f3a54fcbb79e9a2518a56bb78b0468a8a8b4f'],22,15,37,25017665,2,1,1,0.571428571,28143
2a2b4e94feacfff56097293810867ce627b1778a,0,Sumit Mohanty,2017-01-24 13:47:54-08:00,['f4f7571d8f9a7709f030cd2587052492e40e8527'],3,3,6,25017671,2,,,,28143
1b630ebc6406ac2d81b375d4b503e028f6609c0e,0,Sumit Mohanty,2017-01-24 14:00:24-08:00,['2a2b4e94feacfff56097293810867ce627b1778a'],14,14,28,25017699,6,,,,28143
78fefdd4c327390062d16a15594b32bb816f65cf,1,Sumit Mohanty,2017-01-24 14:08:16-08:00,['1b630ebc6406ac2d81b375d4b503e028f6609c0e'],7,384,391,25018090,15,,,,28143
604620021908995d7b4581176ceecf6c44ffea26,0,Bob Nettleton,2017-01-24 17:15:29-05:00,['78fefdd4c327390062d16a15594b32bb816f65cf'],5,76,81,25018171,3,0.346153846,1,1,28143
b3a070c0011a542504c9fd586b26bccfaf1568f1,1,Richard Zang,2017-01-24 15:28:38-08:00,['604620021908995d7b4581176ceecf6c44ffea26'],1,11,12,25018183,1,0.5,1,0.5,28143
bb8b44cff641c49397d1eb72481398036e90f459,0,Yusaku Sako,2017-01-24 17:05:15-08:00,['b3a070c0011a542504c9fd586b26bccfaf1568f1'],15,15,30,25018213,2,,,,28143
72e02ab089b07246b2c79eb5e94825f1c19ad3cf,1,pallavkul,2017-01-25 08:57:47+05:18,['bb8b44cff641c49397d1eb72481398036e90f459'],7,7,14,25018227,1,,,,28143
0de31d6a59c2ec847fc060dffb9e69431eee4ebc,0,pallavkul,2017-01-25 09:02:58+05:18,['72e02ab089b07246b2c79eb5e94825f1c19ad3cf'],0,19,19,25018246,4,1,1,1,28143
ff4babbb776b6f7f53003a499d8677c9d79b5404,1,Mugdha Varadkar,2017-01-25 12:12:41+05:18,['0de31d6a59c2ec847fc060dffb9e69431eee4ebc'],0,70,70,25018316,3,,,,28145
b9200e0e57111b33b7b998fa59a5d25c0b700869,1,oleewere,2017-01-25 11:03:58+01:00,['ff4babbb776b6f7f53003a499d8677c9d79b5404'],2,113,115,25018431,2,1,1,1,28146
dab389d94634e6c21935a7034a0389a70390176e,1,Andrii Tkach,2017-01-25 12:42:27+02:00,['b9200e0e57111b33b7b998fa59a5d25c0b700869'],21,92,113,25018544,3,1,1,1,28146
18e58ffb3759819155261f7e3e68491f330ecd02,0,oleewere,2017-01-25 12:07:36+01:00,['dab389d94634e6c21935a7034a0389a70390176e'],3,3,6,25018550,1,,,,28146
75bf160ce8dfd2fdd148f0dc7f857336c57a8b81,0,Andrii Tkach,2017-01-25 14:37:01+02:00,['18e58ffb3759819155261f7e3e68491f330ecd02'],0,6,6,25018556,1,1,1,1,28146
8642a4634b230755f5c285ed340a7636abe54b8f,0,Oleg Nechiporenko,2017-01-25 15:53:37+02:00,['75bf160ce8dfd2fdd148f0dc7f857336c57a8b81'],2,2,4,25018560,1,,,,28146
b60fabade46fc5f38c7a33a6ee0044ce1931756a,0,Sumit Mohanty,2017-01-25 06:47:12-08:00,['8642a4634b230755f5c285ed340a7636abe54b8f'],2,0,2,25018562,1,1,1,0,28146
1c115bc184d386f588f601d8f7f517c1fd09658d,0,Andrew Onishuk,2017-01-25 16:52:11+02:00,['b60fabade46fc5f38c7a33a6ee0044ce1931756a'],0,6,6,25018568,2,,,,28146
e55523012a47727116657ce61ec681260b282b7e,0,Lisnichenko Dmitro,2017-01-25 17:09:19+02:00,['1c115bc184d386f588f601d8f7f517c1fd09658d'],16,2,18,25018586,2,0.181818182,0.181818182,0,28146
6a8115572b328785532aed27c1dc44a1bac17a01,1,Jayush Luniya,2017-01-25 09:40:56-08:00,['e55523012a47727116657ce61ec681260b282b7e'],37,191,228,25018814,5,0.052238806,0.671641791,0.723880597,28146
5ddbb58ec44795314d3a0e539daf11ace87ae6f9,0,Sangeeta Ravindran,2017-01-25 10:37:21-08:00,['6a8115572b328785532aed27c1dc44a1bac17a01'],6,10,16,25018830,1,0.5,0.5,1,28146
6a2aca64e0d1eb789777e686829d7ec5babcd388,1,Yusaku Sako,2017-01-25 10:47:46-08:00,['5ddbb58ec44795314d3a0e539daf11ace87ae6f9'],1,21,22,25018852,1,0.857142857,0.857142857,1,28146
551f17b427465f1a3420a1158fa75f6498fd0fd2,1,Nate Cole,2017-01-25 13:56:33-05:00,"['eb2c904e1b526e1d581e8985e8e966e3d0ce1eb8', '6a8115572b328785532aed27c1dc44a1bac17a01']",5065,16504,21569,25040421,589,,,,28146
42b8dcf777ccdd72f84edccd16df78ac526bd218,0,Nate Cole,2017-01-25 14:13:25-05:00,['551f17b427465f1a3420a1158fa75f6498fd0fd2'],0,8,8,25040429,1,,,,28146
21c18a78beb397da324c80d6943d55038167d855,0,Di Li,2017-01-25 14:16:56-05:00,['6a2aca64e0d1eb789777e686829d7ec5babcd388'],3,44,47,25040476,3,0.303030303,0.96969697,0.272727273,28146
3217fbc06f9882e47e021472b819e1791b44e9a6,0,pallavkul,2017-01-26 00:46:36+05:18,['21c18a78beb397da324c80d6943d55038167d855'],19,0,19,25040495,4,0,0,0,28146
f571cebdb53666d54b3365307ef5da4af9eeb493,1,Jaimin Jetly,2017-01-25 12:09:07-08:00,['3217fbc06f9882e47e021472b819e1791b44e9a6'],44,3,47,25040542,3,0.696969697,0.03030303,0.727272727,28146
c00399c8505212086c8d7d2deffcc5df74d4e770,0,Jaimin Jetly,2017-01-25 12:23:36-08:00,['f571cebdb53666d54b3365307ef5da4af9eeb493'],194,466,660,25041202,16,0.100775194,0.84496124,1,28146
114f0e8ba660170d700ac3a5b47d6697f9ac90c5,0,Siddharth Wagle,2017-01-25 12:33:21-08:00,['c00399c8505212086c8d7d2deffcc5df74d4e770'],11,41,52,25041254,2,0,1,1,28146
fda3de6e892a8f19d363f49860122929b4589e3d,1,Sumit Mohanty,2017-01-25 13:49:56-08:00,['114f0e8ba660170d700ac3a5b47d6697f9ac90c5'],16,98,114,25041368,7,0.055555556,0.055555556,0.055555556,28146
e3a53ba398d675b62d5ebf8c5324fbce2f3b2f79,1,Vitaly Brodetskyi,2017-01-26 01:34:23+02:00,['fda3de6e892a8f19d363f49860122929b4589e3d'],10,17,27,25041395,2,0,0,0,28146
6f78e611cbe4f1de7fa77e8caa56b59559a5e12e,0,Vitaly Brodetskyi,2017-01-26 02:40:34+02:00,['e3a53ba398d675b62d5ebf8c5324fbce2f3b2f79'],1,2,3,25041398,1,,,,28146
5162a5931f7b29d4eb9b952fcebd8d7dc3b81273,0,Yusaku Sako,2017-01-25 16:45:35-08:00,['6f78e611cbe4f1de7fa77e8caa56b59559a5e12e'],10,10,20,25041418,1,,,,28146
71b743450442d62192c1aa25ebc0269c3cdd3d2b,0,Richard Zang,2017-01-25 16:59:33-08:00,['5162a5931f7b29d4eb9b952fcebd8d7dc3b81273'],4,4,8,25041426,1,,,,28146
5a02a2ad15b9e29e72b8ea55aa7bce4ea52c8aea,1,Sumit Mohanty,2017-01-25 17:05:05-08:00,['71b743450442d62192c1aa25ebc0269c3cdd3d2b'],1,1347,1348,25042774,4,0.044117647,1,0,28147
539a4149ae7cddfb4b30c2b1deed9fdd9517abaa,1,Alejandro Fernandez,2017-01-25 19:13:39-08:00,['5a02a2ad15b9e29e72b8ea55aa7bce4ea52c8aea'],449,2162,2611,25045385,11,0.282964389,0.287776708,0.032723773,28148
35d27739976ccce1c1211def122b3dc7f404662d,1,Sumit Mohanty,2017-01-25 19:53:16-08:00,['539a4149ae7cddfb4b30c2b1deed9fdd9517abaa'],122,413,535,25045920,3,0.927536232,0.956521739,0,28148
03d90ae876c405d702b08609765715713d08dc19,1,ababiichuk,2017-01-26 12:31:59+02:00,['35d27739976ccce1c1211def122b3dc7f404662d'],113,141,254,25046174,5,1,1,1,28149
b6a06bd06d644f3ccd0e8b815f434fefe5989346,1,Lisnichenko Dmitro,2017-01-26 14:35:29+02:00,['03d90ae876c405d702b08609765715713d08dc19'],0,48,48,25046222,2,0,0.6,1,28149
8d390fa18c4fe109934387762787cc1cf48a2bc2,1,Andrii Tkach,2017-01-26 17:01:04+02:00,['b6a06bd06d644f3ccd0e8b815f434fefe5989346'],1,4,5,25046227,1,1,1,1,28149
9bc765ab016d3cd0a2253ab6e28c9e27a6c77418,1,Di Li,2017-01-26 10:59:15-05:00,['8d390fa18c4fe109934387762787cc1cf48a2bc2'],1,47,48,25046275,2,0,1,1,28149
b92b5f576300d0ab36005f35d7e9d0547be7c2e8,1,Di Li,2017-01-26 11:05:55-05:00,['9bc765ab016d3cd0a2253ab6e28c9e27a6c77418'],3,44,47,25046322,3,0.303030303,0.96969697,0.272727273,28149
e7e4cb2064276756d4e9831c376e686a5d19eb09,1,Andrew Onishuk,2017-01-26 19:06:30+02:00,['b92b5f576300d0ab36005f35d7e9d0547be7c2e8'],1,1,2,25046324,1,,,,28149
cc9c92811b7371e73393dc7ba5099ea44a1959d8,0,"Toader, Sebastian",2017-01-26 19:00:25+01:00,['e7e4cb2064276756d4e9831c376e686a5d19eb09'],0,2,2,25046326,2,1,1,1,28149
e8dc698dc13875f9843962c7448d94cb4555348e,0,Swapan Shridhar,2017-01-26 11:23:41-08:00,['cc9c92811b7371e73393dc7ba5099ea44a1959d8'],1,1,2,25046328,1,,,,28149
828e24f063820b6366651410071701067338bc7d,0,Sangeeta Ravindran,2017-01-26 13:40:53-08:00,['e8dc698dc13875f9843962c7448d94cb4555348e'],3,1,4,25046332,1,0,0,0,28149
042f4279889b579bf09afd4f918e94b6598119d6,1,Siddharth Wagle,2017-01-26 14:03:10-08:00,['828e24f063820b6366651410071701067338bc7d'],5,22,27,25046359,5,0,0,0.875,28149
a5df408688faa4e748248339256c82cdf1462325,0,Alex Antonenko,2017-01-27 01:22:50+02:00,['042f4279889b579bf09afd4f918e94b6598119d6'],2,2,4,25046363,2,,,,28149
7e00f5859534e545eac7e052a5fd61dd18f3234e,1,Sriharsha Chintalapani,2017-01-26 21:16:43-08:00,['a5df408688faa4e748248339256c82cdf1462325'],197,223,420,25046783,6,0.972667295,0.883129123,0.691800189,28150
8b4dd3a4826c8b13aec9087de51fce7a856326c4,1,Gaurav Nagar,2017-01-27 11:11:55+05:18,['7e00f5859534e545eac7e052a5fd61dd18f3234e'],84,252,336,25047119,14,0.608,1,0.904,28150
d2862fc6513f6f9c1077c3a7de06ab698e29b22a,1,Gaurav Nagar,2017-01-27 11:15:31+05:18,['8b4dd3a4826c8b13aec9087de51fce7a856326c4'],2,201,203,25047322,4,1,1,1,28152
d38fed3d470e5a7e2cb36625bc7c9b3d568e6b5c,1,Gaurav Nagar,2017-01-27 11:16:47+05:18,['d2862fc6513f6f9c1077c3a7de06ab698e29b22a'],7,42,49,25047371,3,0.75,0,1,28152
f88aca8e1f97311d416da92ec43f9e19535cdf9e,1,Dipayan Bhowmick,2017-01-27 11:44:52+05:18,['d38fed3d470e5a7e2cb36625bc7c9b3d568e6b5c'],12,39,51,25047422,2,0.529411765,0,1,28152
22d4e18168935d9a9400591ebcd1a05c2b2ebf7d,1,Dipayan Bhowmick,2017-01-27 11:51:56+05:18,['f88aca8e1f97311d416da92ec43f9e19535cdf9e'],21,399,420,25047842,10,1,1,0.798507463,28155
a1f625f265b99634a4c18e7c7c69a88302b286a0,0,Oleg Nechiporenko,2017-01-27 10:07:11+02:00,['22d4e18168935d9a9400591ebcd1a05c2b2ebf7d'],0,1,1,25047843,1,1,1,1,28155
9ebe17013bab33eceec5ff2009a87da68c135ef2,1,Mugdha Varadkar,2017-01-27 15:07:19+05:18,['a1f625f265b99634a4c18e7c7c69a88302b286a0'],2,134,136,25047979,3,0.275862069,1,0.747126437,28155
2be01fbf1a22b8bf7bc5a8744196c0f8ed8bbd86,0,Mugdha Varadkar,2017-01-27 16:05:22+05:18,['9ebe17013bab33eceec5ff2009a87da68c135ef2'],3,3,6,25047985,1,,,,28155
16c0b68e6c60c84bef37ba566bce7a2ba349dbff,1,"Toader, Sebastian",2017-01-27 12:35:47+01:00,['2be01fbf1a22b8bf7bc5a8744196c0f8ed8bbd86'],1,113,114,25048099,3,1,1,1,28156
cc30798a6f1428fbe2a2dd6c64cac2c128cf9a23,0,Lisnichenko Dmitro,2017-01-27 14:06:49+02:00,['16c0b68e6c60c84bef37ba566bce7a2ba349dbff'],4,10,14,25048113,1,0,1,1,28156
fb951387706387651f3b31d34f4c16c9b4c9ec4a,1,Gaurav Nagar,2017-01-27 19:17:25+05:18,['cc30798a6f1428fbe2a2dd6c64cac2c128cf9a23'],67,207,274,25048387,7,1,1,1,28158
ad195c25df7360dde9d18348d3db0bb9e212a4b4,1,Bob Nettleton,2017-01-27 10:43:32-05:00,['fb951387706387651f3b31d34f4c16c9b4c9ec4a'],0,4,4,25048391,2,0,1,1,28158
34d029bf9cd665312de4c6d4c54a21bc9ea83858,0,Vitaly Brodetskyi,2017-01-27 17:56:00+02:00,['ad195c25df7360dde9d18348d3db0bb9e212a4b4'],4,4,8,25048399,2,,,,28158
77937e383d6ed0e582192e3a75913f60a32dc0eb,0,Di Li,2017-01-27 11:19:29-05:00,['34d029bf9cd665312de4c6d4c54a21bc9ea83858'],0,3,3,25048402,2,0,0.666666667,1,28158
7c7769b1a00ebeb9a7cf10ae5e7865f13ece7f5e,1,Dmytro Sen,2017-01-27 19:06:52+02:00,['77937e383d6ed0e582192e3a75913f60a32dc0eb'],2,7,9,25048411,1,1,1,1,28158
9963ac81963e01eec66467f0536b4ebdf058aa6e,0,Siddharth Wagle,2017-01-27 10:11:49-08:00,['7c7769b1a00ebeb9a7cf10ae5e7865f13ece7f5e'],2,2,4,25048415,1,,,,28158
535327d12f2b3b44553f0f1aec34b87515a0e20b,0,Nate Cole,2017-01-27 13:17:01-05:00,"['42b8dcf777ccdd72f84edccd16df78ac526bd218', '9963ac81963e01eec66467f0536b4ebdf058aa6e']",1370,6536,7906,25056321,125,,,,28158
dcdf95b28a98e47062727f270adf2b4c69816f93,0,Swapan Shridhar,2017-01-27 11:02:48-08:00,['9963ac81963e01eec66467f0536b4ebdf058aa6e'],9,37,46,25056367,4,0,0.92,0.92,28158
6d02a7a5b3415a87b0cbcf21d360942719efcb9d,1,Di Li,2017-01-27 14:13:55-05:00,['dcdf95b28a98e47062727f270adf2b4c69816f93'],12,56,68,25056435,2,0,1,1,28158
23522a28126bbb1216bb1b556fce1d24a7262d26,0,Swapan Shridhar,2017-01-27 11:18:30-08:00,['6d02a7a5b3415a87b0cbcf21d360942719efcb9d'],2,2,4,25056439,1,,,,28158
65eb886720c2ccff344fe99928fabc23bcc48738,1,Robert Levas,2017-01-27 15:09:57-05:00,['23522a28126bbb1216bb1b556fce1d24a7262d26'],10,4,14,25056453,1,1,0,0,28158
9d8a54c23146db595e81d72785c4f9779f3bee00,0,Nahappan Somasundaram,2017-01-27 12:32:59-08:00,['65eb886720c2ccff344fe99928fabc23bcc48738'],0,16,16,25056469,1,0,0,0,28158
b3391f0dd030130add23b9ffb09fb7a776dfe969,0,Xi Wang,2017-01-27 14:22:02-08:00,['9d8a54c23146db595e81d72785c4f9779f3bee00'],4,42,46,25056515,3,,,,28158
c60098536dcd7faf85e364fdcafed17cbba340a6,0,Sumit Mohanty,2017-01-27 16:02:46-08:00,['b3391f0dd030130add23b9ffb09fb7a776dfe969'],2,3,5,25056520,1,,,,28158
771c9c011b3ea00e4ad0171b04bd851c7ee74ee0,1,Sumit Mohanty,2017-01-27 17:53:04-08:00,['c60098536dcd7faf85e364fdcafed17cbba340a6'],3,3,6,25056526,1,,,,28158
0e8c966d20b895442ea461ce488dcb9aae4d8638,0,Sumit Mohanty,2017-01-27 18:19:36-08:00,['771c9c011b3ea00e4ad0171b04bd851c7ee74ee0'],2,1,3,25056529,1,0,0,0,28158
50403914c7a092f6e66726b3bf2331be13625f71,0,Siddharth Wagle,2017-01-27 18:42:47-08:00,['0e8c966d20b895442ea461ce488dcb9aae4d8638'],2,7,9,25056538,2,1,1,1,28158
c2907860e4fea65d272a680509ce656ac6e1f4f0,0,Sangeeta Ravindran,2017-01-28 00:23:56-08:00,['50403914c7a092f6e66726b3bf2331be13625f71'],0,3,3,25056541,1,1,1,1,28158
86fbb38108e2d9b87f22b1920cada3a655677285,0,"Toader, Sebastian",2017-01-28 18:27:31+01:00,['c2907860e4fea65d272a680509ce656ac6e1f4f0'],16,45,61,25056602,7,0.5,0,0.944444444,28158
015d404604da164aa939635b7835a9551321cc5e,1,Miklos Gergely,2017-01-29 13:24:00+01:00,['86fbb38108e2d9b87f22b1920cada3a655677285'],122,148,270,25056872,4,0,1,0.1,28158
e0765d9228aaa9ff3fba47249de67c85dd6eb945,1,oleewere,2017-01-29 16:43:27+01:00,['015d404604da164aa939635b7835a9551321cc5e'],11,128,139,25057011,12,0.375,0.575,0.975,28160
716b2fca38a9db43b3211b9380f18149a3342256,0,Robert Levas,2017-01-29 11:15:24-05:00,['e0765d9228aaa9ff3fba47249de67c85dd6eb945'],5,12,17,25057028,1,0,1,1,28160
1eb4ca50b5043ebd8326db90851520f3ea359731,1,Sumit Mohanty,2017-01-29 08:45:39-08:00,['716b2fca38a9db43b3211b9380f18149a3342256'],7,191,198,25057226,3,0.122699387,0.834355828,0.895705521,28160
c977113ccb18218befbb86479353f60bda4eb1d7,1,Sumit Mohanty,2017-01-29 22:48:19-08:00,['1eb4ca50b5043ebd8326db90851520f3ea359731'],9,266,275,25057501,20,,,,28160
ea1fbaa020907c7a433275447043b509f8868dcd,1,pallavkul,2017-01-30 14:09:16+05:18,['c977113ccb18218befbb86479353f60bda4eb1d7'],7,35,42,25057543,2,1,1,1,28160
985dafff5330b97e4b92f1c4cf67ee201a8e6edd,1,Dipayan Bhowmick,2017-01-30 14:16:04+05:18,['ea1fbaa020907c7a433275447043b509f8868dcd'],64,130,194,25057737,13,0.777777778,1,1,28163
abcd0637c6f3328d0a6345e0573c30615cdcde83,1,pallavkul,2017-01-30 14:17:15+05:18,['985dafff5330b97e4b92f1c4cf67ee201a8e6edd'],5,5,10,25057747,3,0,0,0.25,28163
37b414241b9b8a7b909278335037b7c0fe6fa441,1,Dipayan Bhowmick,2017-01-30 14:21:41+05:18,['abcd0637c6f3328d0a6345e0573c30615cdcde83'],0,26,26,25057773,1,1,1,1,28164
9f5a8bf6a7c670845adfa07369e9c56ff68e9798,1,Nitiraj Singh Rathore,2017-01-30 14:22:26+05:18,['37b414241b9b8a7b909278335037b7c0fe6fa441'],2,4,6,25057779,2,,,,28164
75c126e49231e3ed33e8cf7d6cd30747f7ef6db5,0,Gaurav Nagar,2017-01-30 14:37:28+05:18,['9f5a8bf6a7c670845adfa07369e9c56ff68e9798'],0,1,1,25057780,1,1,1,1,28164
589f567e37800ff606f5c40eca99508ce8910899,1,pallavkul,2017-01-30 15:12:03+05:18,['75c126e49231e3ed33e8cf7d6cd30747f7ef6db5'],8,9,17,25057797,3,,,,28164
ff34b053d047889d261524f4b676b915a9176934,1,Gaurav Nagar,2017-01-30 17:25:49+05:18,['589f567e37800ff606f5c40eca99508ce8910899'],5,8,13,25057810,2,1,1,1,28164
da7202d41cbf9042ac844ad408a08c348ec06e7f,0,Gaurav Nagar,2017-01-30 17:27:33+05:18,['ff34b053d047889d261524f4b676b915a9176934'],6,6,12,25057822,4,,,,28164
af6ba590d20b75e6a276a9e0a81f416fefc8cfd9,0,Gaurav Nagar,2017-01-30 17:30:54+05:18,['da7202d41cbf9042ac844ad408a08c348ec06e7f'],7,5,12,25057834,3,1,0,0,28164
b722ffa6f612685096c0c528264fdf1ae86b5d64,1,"Toader, Sebastian",2017-01-30 14:58:47+01:00,['af6ba590d20b75e6a276a9e0a81f416fefc8cfd9'],12,16,28,25057862,1,1,0,1,28164
d6d247983c5c66c11260a6d10e7b0e2746fa8146,1,"Toader, Sebastian",2017-01-30 15:54:20+01:00,['b722ffa6f612685096c0c528264fdf1ae86b5d64'],43,68,111,25057973,8,0,0.5,0.5,28164
e4d0fa156e6ac41bae7b7020f781d0dae1274894,1,Sandor Magyari,2017-01-30 16:39:58+01:00,['d6d247983c5c66c11260a6d10e7b0e2746fa8146'],1,56,57,25058030,2,0,0.9,0.1,28164
393ab3ee28a27c63084ee4700bf0386b6ceb4a9b,0,Nate Cole,2017-01-30 10:40:13-05:00,"['535327d12f2b3b44553f0f1aec34b87515a0e20b', 'd6d247983c5c66c11260a6d10e7b0e2746fa8146']",375,1277,1652,25059682,103,,,,28164
0cc0e5d43a49d75c300bdc190954e6639e6a50e1,1,Yusaku Sako,2017-01-30 10:05:44-08:00,['e4d0fa156e6ac41bae7b7020f781d0dae1274894'],2,20,22,25059704,2,0.769230769,0.769230769,1,28164
b87343e15f687778e721bad9483de1b3044fea0f,0,Sumit Mohanty,2017-01-30 10:19:08-08:00,['0cc0e5d43a49d75c300bdc190954e6639e6a50e1'],11,0,11,25059715,1,,,,28164
93d4ffeda4673adf20bcdde146372d5988b01531,0,Swapan Shridhar,2017-01-30 10:59:25-08:00,['b87343e15f687778e721bad9483de1b3044fea0f'],10,18,28,25059743,1,,,,28164
8d56db0efb9ea3bcb4cff968699c48065ddf1193,0,Yusaku Sako,2017-01-30 11:26:17-08:00,['93d4ffeda4673adf20bcdde146372d5988b01531'],5,13,18,25059761,1,0,1,1,28164
40319b38faa0a8c12fe80009d3571daae41545d4,0,Sumit Mohanty,2017-01-30 11:36:52-08:00,['8d56db0efb9ea3bcb4cff968699c48065ddf1193'],1,1,2,25059763,1,,,,28164
5cadb0636d5e16df6b041735caae9d2847dd690d,0,Siddharth Wagle,2017-01-30 13:29:22-08:00,['40319b38faa0a8c12fe80009d3571daae41545d4'],21,20,41,25059804,2,,,,28164
50b0d984ef186e18ebca3901f7f35d21f8294c81,0,Max Shepel,2017-01-31 00:03:34+02:00,['5cadb0636d5e16df6b041735caae9d2847dd690d'],16,36,52,25059856,5,0.818181818,0.818181818,1,28164
433ba384c7d1ac94d560ca4bd9d9c709dd98d1f7,1,Swapan Shridhar,2017-01-30 14:41:14-08:00,['50b0d984ef186e18ebca3901f7f35d21f8294c81'],20,34,54,25059910,2,0,0,0,28164
0b157069a6766bcc2b8cfe827f019cd4fc7c5127,0,Aravindan Vijayan,2017-01-30 16:09:08-08:00,['433ba384c7d1ac94d560ca4bd9d9c709dd98d1f7'],4,4,8,25059918,2,,,,28164
2f06c1cefac30e0a53d631cf2a2a6aef64a89e0c,1,Alejandro Fernandez,2017-01-30 19:26:18-08:00,['0b157069a6766bcc2b8cfe827f019cd4fc7c5127'],0,150,150,25060068,10,,,,28165
7617c4e1cddceed3e567385b40731a8b8c58d3bc,1,Mugdha Varadkar,2017-01-31 11:25:39+05:18,['2f06c1cefac30e0a53d631cf2a2a6aef64a89e0c'],33,32,65,25060133,1,1,0,0,28165
55e35a65da5cdf9804886106ce4135a123061ba3,0,Mugdha Varadkar,2017-01-31 11:32:17+05:18,['7617c4e1cddceed3e567385b40731a8b8c58d3bc'],1,33,34,25060167,10,,,,28165
b99bfe7a791aff2dc228c76af06ada488ec410ad,1,Dipayan Bhowmick,2017-01-31 15:56:51+05:18,['55e35a65da5cdf9804886106ce4135a123061ba3'],12,21,33,25060200,3,1,1,1,28165
1ecc19311c5c358db6810e3474c6cb13f9cb3d81,1,pallavkul,2017-01-31 16:15:21+05:18,['b99bfe7a791aff2dc228c76af06ada488ec410ad'],7,1,8,25060208,1,,,,28165
6f94ca691cf6e5854250f5542791edb49e50a669,1,Andrew Onishuk,2017-01-31 13:02:50+02:00,['1ecc19311c5c358db6810e3474c6cb13f9cb3d81'],0,16,16,25060224,1,1,1,1,28165
28cb0cf5048019f17bc85ff8c2d331a4acbac30e,0,Andrew Onishuk,2017-01-31 13:19:50+02:00,['6f94ca691cf6e5854250f5542791edb49e50a669'],0,2,2,25060226,1,,,,28165
a133aee9ab408a41493855fa701437d37a41ed32,0,Andrii Tkach,2017-01-31 13:39:38+02:00,['28cb0cf5048019f17bc85ff8c2d331a4acbac30e'],3,54,57,25060283,5,0.431818182,1,1,28165
b81d1df8739086db7ebc0b7602e996d0f01b63bf,0,Andrii Tkach,2017-01-31 13:44:08+02:00,['a133aee9ab408a41493855fa701437d37a41ed32'],170,28,198,25060481,3,0,0,0,28165
f1ce60295a82e28e18aaf5cc3816f072156668b5,1,pallavkul,2017-01-31 17:06:59+05:18,['b81d1df8739086db7ebc0b7602e996d0f01b63bf'],45,70,115,25060596,6,0.833333333,1,1,28165
207546fdb21fc5e882efbfb9c2a2366bdb392415,1,pallavkul,2017-01-31 18:16:29+05:18,['f1ce60295a82e28e18aaf5cc3816f072156668b5'],29,32,61,25060657,2,,,,28165
b53fa3c4755b7ae6af86cf893924d3e88d449401,1,Vitaly Brodetskyi,2017-01-31 19:01:32+02:00,['207546fdb21fc5e882efbfb9c2a2366bdb392415'],36,90,126,25060783,8,0.764705882,0.823529412,0,28165
772c093073b31fb0887d7072622e4c37c227e28d,0,Alejandro Fernandez,2017-01-31 10:35:12-08:00,['b53fa3c4755b7ae6af86cf893924d3e88d449401'],0,3,3,25060786,3,,,,28165
e5c5c6b111b3a1a215f5c457e0e1038d6d369a13,1,Jaimin Jetly,2017-01-31 11:53:48-08:00,['772c093073b31fb0887d7072622e4c37c227e28d'],12,59,71,25060857,3,0.22,0.58,1,28165
97119babf76ebb413d3ed0cf3236b8c71657410b,1,Jaimin Jetly,2017-01-31 12:03:25-08:00,['e5c5c6b111b3a1a215f5c457e0e1038d6d369a13'],0,6,6,25060863,1,,,,28165
099e34c60540079f86d353efa134ed059a3c3d27,0,Swapan Shridhar,2017-01-31 12:58:51-08:00,['97119babf76ebb413d3ed0cf3236b8c71657410b'],0,12,12,25060875,3,0,0,0,28165
a8b8b4155b6655ef407e2f0d623722047235fc6b,1,Sumit Mohanty,2017-01-31 13:11:13-08:00,['099e34c60540079f86d353efa134ed059a3c3d27'],9,23,32,25060907,2,0,0,1,28165
cc42c95db84ecb115393a0dec5390245f377d7d6,0,Sangeeta Ravindran,2017-01-31 15:33:07-08:00,['a8b8b4155b6655ef407e2f0d623722047235fc6b'],0,30,30,25060937,2,,,,28166
01f4a69e2ecc266d839713a53e428350cddcbc69,0,Vitaly Brodetskyi,2017-02-01 01:39:36+02:00,['cc42c95db84ecb115393a0dec5390245f377d7d6'],3,3,6,25060943,1,,,,28166
0dfe8b6c9792aa2d40d8ecaa75f0256e9820eb89,1,Gaurav Nagar,2017-02-01 12:25:21+05:18,['01f4a69e2ecc266d839713a53e428350cddcbc69'],20,55,75,25061018,6,1,1,1,28166
8ece8aa6cd91f3abad4f1ec3c72a5320fb1278cc,1,Renjith Kamath,2017-02-01 14:34:43+05:18,['0dfe8b6c9792aa2d40d8ecaa75f0256e9820eb89'],0,32,32,25061050,2,0,0.217391304,1,28166
c4f59ef71dad456538818f0392c229fd381e62b4,1,Miklos Gergely,2017-02-01 10:49:43+01:00,['8ece8aa6cd91f3abad4f1ec3c72a5320fb1278cc'],10,37,47,25061097,1,0.115384615,1,1,28166
4e689afe5a5bbc04d893b16f1d117988efa3ff3e,1,Miklos Gergely,2017-02-01 10:53:04+01:00,['c4f59ef71dad456538818f0392c229fd381e62b4'],96,36,132,25061229,3,1,1,0,28166
b55ba18edd107a9439e24aafbe2167a76916b07f,1,Oleg Nechiporenko,2017-02-01 13:15:45+02:00,['4e689afe5a5bbc04d893b16f1d117988efa3ff3e'],3,93,96,25061325,4,1,1,1,28167
727a31875d4b5a1f4473d1fb3f0292bc5ffb1e2f,1,Nitiraj Singh Rathore,2017-02-01 18:27:38+05:18,['b55ba18edd107a9439e24aafbe2167a76916b07f'],149,430,579,25061904,18,0.797619048,0.797619048,1,28170
3a7906c84737511475e718a0da50397b31ef7b52,1,Myroslav Papirkovskyi,2017-02-01 16:44:47+02:00,['727a31875d4b5a1f4473d1fb3f0292bc5ffb1e2f'],469,1029,1498,25063402,138,0.336734694,0.56122449,0.846938776,28172
144449cba7247d1b529e21b98c3fe9014c60b544,1,Myroslav Papirkovskyi,2017-02-01 19:07:45+02:00,['3a7906c84737511475e718a0da50397b31ef7b52'],3,6,9,25063411,2,,,,28172
0ec0597d37abb22f5a21408fe24af3c7b64b2c9d,1,ababiichuk,2017-02-01 19:41:10+02:00,['144449cba7247d1b529e21b98c3fe9014c60b544'],305,337,642,25064053,8,0.571428571,1,0.285714286,28172
2627380840c1ae57d21cc60b666b4a503863366e,1,"Toader, Sebastian",2017-02-01 19:06:29+01:00,['0ec0597d37abb22f5a21408fe24af3c7b64b2c9d'],18,34,52,25064105,2,0,0.066666667,1,28172
4026efacc398197ddb3b67230641efd7c850e2b8,1,Robert Levas,2017-02-01 13:14:07-05:00,['2627380840c1ae57d21cc60b666b4a503863366e'],3,20,23,25064128,6,0,1,1,28172
a8a43bcca718604c92be6a918ac2e08a0df55b00,1,Myroslav Papirkovskyi,2017-02-01 20:15:21+02:00,['4026efacc398197ddb3b67230641efd7c850e2b8'],7,7,14,25064142,2,,,,28172
0458addaaa3b99943e3e3ecf93483f4009b2c120,1,"Toader, Sebastian",2017-02-01 19:21:54+01:00,['a8a43bcca718604c92be6a918ac2e08a0df55b00'],74,68,142,25064284,6,1,0,1,28172
f36af3da4598db52b2e67fd22c85b5d5a436c00c,0,Sumit Mohanty,2017-02-01 13:56:13-08:00,['0458addaaa3b99943e3e3ecf93483f4009b2c120'],208,9,217,25064501,12,,,,28172
d340fe93b51b82dc380ad7783cd63b7e76b72224,1,Nahappan Somasundaram,2017-02-01 15:09:44-08:00,['f36af3da4598db52b2e67fd22c85b5d5a436c00c'],4,1292,1296,25065797,5,0.566666667,0.859259259,0.940740741,28174
c10fcc8f3682e7e4a2924e8a58fa895920fef908,1,Sumit Mohanty,2017-02-01 16:30:04-08:00,['d340fe93b51b82dc380ad7783cd63b7e76b72224'],50,44,94,25065891,2,1,0,1,28174
e406234a7dcc1f11f9f13c8e40fd64187e20eaf8,1,Swapan Shridhar,2017-02-01 17:08:41-08:00,['c10fcc8f3682e7e4a2924e8a58fa895920fef908'],20,20,40,25065931,2,,,,28174
c744cac60ebe0ae4046278f7ef78fe20d0872b0e,1,Alejandro Fernandez,2017-02-01 17:12:53-08:00,['e406234a7dcc1f11f9f13c8e40fd64187e20eaf8'],3,5,8,25065939,3,,,,28174
b01438c7dc82ec9f0263eed8b6c1575491e78f6b,1,Jayush Luniya,2017-02-01 21:54:08-08:00,['c744cac60ebe0ae4046278f7ef78fe20d0872b0e'],3,3,6,25065945,2,,,,28174
a9ddb2fd2014954cb35821f8ad1f33faa3ae1d95,1,pallavkul,2017-02-02 11:42:17+05:18,['b01438c7dc82ec9f0263eed8b6c1575491e78f6b'],137,207,344,25066289,40,0,0,1,28174
1d17baf9f8cb6f89cc3b2c316b4a5603f1b111d5,1,Dipayan Bhowmick,2017-02-02 11:50:55+05:18,['a9ddb2fd2014954cb35821f8ad1f33faa3ae1d95'],22,13,35,25066324,2,0,0,0,28174
318f352252d31e97d9110f0fb5013d006dd0adab,1,Dipayan Bhowmick,2017-02-02 11:53:46+05:18,['1d17baf9f8cb6f89cc3b2c316b4a5603f1b111d5'],28,20,48,25066372,6,1,1,1,28174
d1f26f98f5faf1d45035922c585c0c7bcebf154a,1,Dipayan Bhowmick,2017-02-02 11:56:25+05:18,['318f352252d31e97d9110f0fb5013d006dd0adab'],9,480,489,25066861,15,1,1,1,28183
325dc20537b3328ce9cc6e4a3f5d0b111e353d94,1,Sumit Mohanty,2017-02-01 22:45:45-08:00,['d1f26f98f5faf1d45035922c585c0c7bcebf154a'],0,27,27,25066888,2,,,,28184
db36bd92f6cf7d648d0a748cb9164185d12ee329,1,Lisnichenko Dmitro,2017-02-02 11:32:04+02:00,['325dc20537b3328ce9cc6e4a3f5d0b111e353d94'],3,6,9,25066897,1,1,1,1,28184
b5ee4c57a0d462e10a753b4613c5c8b118865b19,1,Gaurav Nagar,2017-02-02 18:02:10+05:18,['db36bd92f6cf7d648d0a748cb9164185d12ee329'],39,22,61,25066958,6,0,0,1,28184
0b472f2e2efbe1d1b2c2dc78c7442d59237edf2a,1,Gaurav Nagar,2017-02-02 18:03:52+05:18,['b5ee4c57a0d462e10a753b4613c5c8b118865b19'],1,2,3,25066961,1,0,1,0,28184
c8b347c9ebb4bf2c1d5b544911185c01436d1f9b,0,Andrew Onishuk,2017-02-02 16:20:30+02:00,['0b472f2e2efbe1d1b2c2dc78c7442d59237edf2a'],0,1,1,25066962,1,,,,28184
7c8931a5e5a6320145867ea3bcd48a379c1c87a8,0,Di Li,2017-02-02 10:57:39-05:00,['c8b347c9ebb4bf2c1d5b544911185c01436d1f9b'],1,1,2,25066964,1,,,,28184
ce822359b3199ac62cfb7b3fed00333ea780e734,0,pallavkul,2017-02-02 22:55:05+05:18,['7c8931a5e5a6320145867ea3bcd48a379c1c87a8'],8,19,27,25066991,3,,,,28184
98608ce71594a10338b42f41f127ac5e797876ca,0,pallavkul,2017-02-02 22:58:35+05:18,['ce822359b3199ac62cfb7b3fed00333ea780e734'],3,5,8,25066999,2,,,,28184
f297c48f016c9deab2cf423fab3a87948496682b,1,Nate Cole,2017-02-02 13:06:16-05:00,['98608ce71594a10338b42f41f127ac5e797876ca'],0,202,202,25067201,3,0.672413793,1,1,28186
5d4d99efbd1a7de059c1257c09b396b90bade83e,1,Dmytro Sen,2017-02-02 20:12:30+02:00,['f297c48f016c9deab2cf423fab3a87948496682b'],6,18,24,25067225,2,0.666666667,0.666666667,1,28186
9c1b153e21f04d96f0afa806436c8e4d702be0cc,0,Aravindan Vijayan,2017-02-02 10:29:14-08:00,['5d4d99efbd1a7de059c1257c09b396b90bade83e'],4,15,19,25067244,3,0,0,1,28186
69c8389ef8d76e8a7a41a8a796f51be044033026,0,Yusaku Sako,2017-02-02 10:36:48-08:00,['9c1b153e21f04d96f0afa806436c8e4d702be0cc'],9,24,33,25067277,5,1,1,1,28186
b457d7b874364b105d08a657e37721de973f9dca,0,Andrii Tkach,2017-02-02 21:06:55+02:00,['69c8389ef8d76e8a7a41a8a796f51be044033026'],0,2,2,25067279,2,,,,28186
ebc05a917597eaa0b9cba60bb205478143538a78,0,Yusaku Sako,2017-02-02 13:08:34-08:00,['b457d7b874364b105d08a657e37721de973f9dca'],3,272,275,25067554,6,,,,28186
975dd1d40c6136a61e7d014fb0dfc32e09863a2b,1,Swapan Shridhar,2017-02-02 14:57:04-08:00,['ebc05a917597eaa0b9cba60bb205478143538a78'],86,50,136,25067690,2,1,0.772727273,0,28186
14cd837ea5c33ca4ebf5daf9262fe40d1f5a9130,0,Oleksandr Diachenko,2017-02-02 15:58:28-08:00,['975dd1d40c6136a61e7d014fb0dfc32e09863a2b'],2,13,15,25067705,1,,,,28186
61f8f6d56937996ea7ca2f64b8961e83b72422fd,1,Miklos Gergely,2017-02-03 09:56:10+01:00,['14cd837ea5c33ca4ebf5daf9262fe40d1f5a9130'],20,44,64,25067769,2,1,1,0.35,28186
779995dd5b23c5505262463d50690079d502355e,1,"Toader, Sebastian",2017-02-03 11:46:17+01:00,['61f8f6d56937996ea7ca2f64b8961e83b72422fd'],12,176,188,25067957,9,1,0,0,28187
4ad3a2b3611a38aeea3d64411feec8776a6af554,1,Sandor Magyari,2017-02-03 13:47:01+02:00,['779995dd5b23c5505262463d50690079d502355e'],0,136,136,25068093,2,0.09,0.44,1,28187
f2561c48f71614d56fd747239cdd16bf5a6ef9ea,1,Andrew Onishuk,2017-02-03 15:03:40+02:00,['4ad3a2b3611a38aeea3d64411feec8776a6af554'],5,10,15,25068108,2,,,,28187
132e266521642d90908d3dd69446a701ca94c3db,1,Vitaly Brodetskyi,2017-02-03 16:04:21+02:00,['f2561c48f71614d56fd747239cdd16bf5a6ef9ea'],25,67,92,25068200,5,0.586206897,0.862068966,0,28187
d222f572ee2952add29e60afeb47a4da7ac98685,0,Nate Cole,2017-02-03 09:52:46-05:00,"['393ab3ee28a27c63084ee4700bf0386b6ceb4a9b', '132e266521642d90908d3dd69446a701ca94c3db']",2255,6192,8447,25076647,377,,,,28187
b51691b17db954d64e4dd52226aefb7d860428c2,1,Dmytro Sen,2017-02-03 17:14:17+02:00,['132e266521642d90908d3dd69446a701ca94c3db'],15,16,31,25076678,4,0,1,1,28187
20103709a2b2145323cf3bccb530da0a52db72e6,1,Myroslav Papirkovskyi,2017-02-03 19:51:18+02:00,['b51691b17db954d64e4dd52226aefb7d860428c2'],77,175,252,25076930,9,0,1,0.35,28187
e86dddad7da519558210ddf41621aad60af55c55,1,Myroslav Papirkovskyi,2017-02-03 20:32:56+02:00,['20103709a2b2145323cf3bccb530da0a52db72e6'],59,54,113,25077043,3,,,,28187
ecfc951b5c8589b9225684c3ad2660cdb4ef4445,0,Di Li,2017-02-03 14:15:19-05:00,['e86dddad7da519558210ddf41621aad60af55c55'],2,13,15,25077058,2,0,1,1,28187
4d800650279f65d1deb6f754f11235008f19ce47,0,Nahappan Somasundaram,2017-02-03 11:35:45-08:00,['ecfc951b5c8589b9225684c3ad2660cdb4ef4445'],0,10,10,25077068,2,,,,28187
dca9135af7702ec21f91859095ef34332cc6cc30,1,Sumit Mohanty,2017-02-03 13:30:43-08:00,['4d800650279f65d1deb6f754f11235008f19ce47'],3,34,37,25077105,6,0,1,1,28187
eba63884beeb7096834a374b710ea6e7f0d7b7f8,0,Yusaku Sako,2017-02-03 15:17:35-08:00,['dca9135af7702ec21f91859095ef34332cc6cc30'],4,4,8,25077113,2,,,,28187
e4bac844b33539b06e4208e058e7d89c7761eb99,1,Alejandro Fernandez,2017-02-03 15:47:13-08:00,['eba63884beeb7096834a374b710ea6e7f0d7b7f8'],16,106,122,25077235,5,0.369565217,0.369565217,0.369565217,28187
9a706402c71c2a9c948a3d675b892e93156d66a7,1,Xi Wang,2017-02-03 15:51:20-08:00,['eba63884beeb7096834a374b710ea6e7f0d7b7f8'],406,625,1031,25078266,16,1,1,1,28189
7691d94ec4092033346e41339dd2945cfbf0a588,1,Xi Wang,2017-02-03 15:51:20-08:00,['9a706402c71c2a9c948a3d675b892e93156d66a7'],8,39,47,25078313,4,,,,28189
b50fbdb48ba52d2eb83ce6e4b0939d84012239d6,1,Xi Wang,2017-02-03 15:51:20-08:00,['7691d94ec4092033346e41339dd2945cfbf0a588'],32,44,76,25078389,5,,,,28189
cc4c04e5b35e2cd798f38b0740214f96b128215e,1,Xi Wang,2017-02-03 15:51:20-08:00,['b50fbdb48ba52d2eb83ce6e4b0939d84012239d6'],3,127,130,25078519,5,1,1,1,28189
515c083e0536d84ef19b5a98d5087f8be1c5f809,1,Dipayan Bhowmick,2017-02-06 11:12:55+05:18,['e4bac844b33539b06e4208e058e7d89c7761eb99'],6,314,320,25078839,13,1,1,1,28194
e113777b9eb7cdd029ebc32fe520d8442e7a8e45,1,Dipayan Bhowmick,2017-02-06 11:31:33+05:18,['515c083e0536d84ef19b5a98d5087f8be1c5f809'],22,290,312,25079151,13,0.97752809,1,0.842696629,28198
113de54e21dc2832ffecb940d965f6c49a29e579,0,Mugdha Varadkar,2017-02-06 13:12:50+05:18,['e113777b9eb7cdd029ebc32fe520d8442e7a8e45'],376,421,797,25079948,46,,,,28200
e71f3a97af080a3b03335be5606aeaa1aa73085d,1,Oleg Nechiporenko,2017-02-06 11:32:12+02:00,['113de54e21dc2832ffecb940d965f6c49a29e579'],1,1,2,25079950,1,,,,28200
95693516ca5ea9f44b6c04e38b3024fce06050a8,0,Mugdha Varadkar,2017-02-06 17:02:05+05:18,['e71f3a97af080a3b03335be5606aeaa1aa73085d'],1,4,5,25079955,1,,,,28200
13f8f96b3e5fedf14fc1a2089abae33a0ee0e204,1,Gaurav Nagar,2017-02-06 18:20:12+05:18,['95693516ca5ea9f44b6c04e38b3024fce06050a8'],3,3,6,25079961,1,1,0,1,28200
9f2d1d9b6ef7019919e4a6fd1bd80569eaf4e97b,0,Oleg Nechiporenko,2017-02-06 15:37:57+02:00,['13f8f96b3e5fedf14fc1a2089abae33a0ee0e204'],7,62,69,25080030,2,0.36,1,1,28200
e05e5296c580b3b714f784f54754318bc09f67de,0,"Toader, Sebastian",2017-02-06 15:42:29+01:00,['9f2d1d9b6ef7019919e4a6fd1bd80569eaf4e97b'],0,2,2,25080032,2,0,0.5,1,28200
df8c06ca7cae9fe3af75e49d7a31e197d250ba9b,1,"Toader, Sebastian",2017-02-06 15:54:55+01:00,['e05e5296c580b3b714f784f54754318bc09f67de'],8,22,30,25080062,2,0.545454545,1,0.545454545,28200
e35bfd32b90282eae83fd14bbfaaf50e1bf47c87,1,Richard Zang,2017-02-06 11:31:15-08:00,['df8c06ca7cae9fe3af75e49d7a31e197d250ba9b'],13,3,16,25080078,1,0,0,0,28200
239d9c1ae8a1bec103c1b3590bf52011cb579a38,0,Yusaku Sako,2017-02-06 13:35:42-08:00,['e35bfd32b90282eae83fd14bbfaaf50e1bf47c87'],95,72,167,25080245,10,1,0,0,28200
536192bb601a426c473845dc10776946f456f220,1,Nitiraj Singh Rathore,2017-02-07 12:51:06+05:18,['239d9c1ae8a1bec103c1b3590bf52011cb579a38'],622,2249,2871,25083116,47,0.93019943,1,0.952991453,28219
e55a595ac10d9e822e1c8e27dc098f829ec2e2e7,1,Miklos Gergely,2017-02-07 10:01:12+01:00,['536192bb601a426c473845dc10776946f456f220'],1225,672,1897,25085013,17,0.167832168,0.171328671,0.101398601,28219
5c7997f59937040c6ed4d949e688bdf12a7219a3,1,Miklos Gergely,2017-02-07 10:11:32+01:00,['e55a595ac10d9e822e1c8e27dc098f829ec2e2e7'],3490,333,3823,25088836,7,0,0,1,28219
3348a049b06b11506bc426f43da75541037998c7,1,Miklos Gergely,2017-02-07 11:24:36+01:00,['5c7997f59937040c6ed4d949e688bdf12a7219a3'],10,1,11,25088847,1,0,0,0,28219
5ecc858fddfa26ef47129233f9fd5bbcb813ccfd,1,oleewere,2017-02-07 12:52:18+01:00,['3348a049b06b11506bc426f43da75541037998c7'],3,1296,1299,25090146,13,0.384210526,0.6,0.931578947,28226
d3ff926cca55a6f3de8fa7dd4e9840424852e0ab,1,pallavkul,2017-02-07 17:30:32+05:18,['5ecc858fddfa26ef47129233f9fd5bbcb813ccfd'],28,30,58,25090204,4,,,,28226
9b8055cc47135da590ccb969019a699f612e9b9c,1,pallavkul,2017-02-07 17:33:42+05:18,['d3ff926cca55a6f3de8fa7dd4e9840424852e0ab'],49,23,72,25090276,2,0.9,0.9,0,28226
3561cf7bef0c0ca55ca1b178168bf6a441a8f835,1,Sandor Magyari,2017-02-07 14:31:01+01:00,['9b8055cc47135da590ccb969019a699f612e9b9c'],2,72,74,25090350,11,1,1,1,28226
a6a7ba6d3defc89f9ef0433913581662b567b94a,1,ababiichuk,2017-02-07 18:09:05+02:00,['3561cf7bef0c0ca55ca1b178168bf6a441a8f835'],28,47,75,25090425,2,0,1,1,28226
7a072aafc8b21f0c516213532de60ba64b5a1142,1,Aravindan Vijayan,2017-02-07 10:04:25-08:00,['a6a7ba6d3defc89f9ef0433913581662b567b94a'],58,161,219,25090644,5,0.028985507,0,0.971014493,28226
1adf27d1866aac2293c6708d911c0124abe18f69,1,Sriharsha Chintalapani,2017-02-07 10:12:30-08:00,['7a072aafc8b21f0c516213532de60ba64b5a1142'],2,19,21,25090665,5,,,,28226
e9e1cac4fdf32f831cecd9b4f611a6e80ee24cac,1,Aravindan Vijayan,2017-02-07 10:17:26-08:00,['1adf27d1866aac2293c6708d911c0124abe18f69'],27,298,325,25090990,14,0.289156627,0.108433735,1,28231
01c4976182e18979629cdd2953c9239f15678fd6,0,Sumit Mohanty,2017-02-07 12:19:01-08:00,['e9e1cac4fdf32f831cecd9b4f611a6e80ee24cac'],3,3,6,25090996,2,,,,28231
14738859ccdffa64ba5d66a5cdf3757723826736,1,Swapan Shridhar,2017-02-07 14:21:07-08:00,['01c4976182e18979629cdd2953c9239f15678fd6'],4,1,5,25091001,1,1,1,0,28231
63b68260817214285267923ed08ee9970affad30,0,Swapan Shridhar,2017-02-07 15:11:59-08:00,['14738859ccdffa64ba5d66a5cdf3757723826736'],41,250,291,25091292,2,0,0.972375691,0.972375691,28231
fb4fb888e6345e7ab03ea0e85325c53f1ef560d9,0,Sumit Mohanty,2017-02-07 15:16:21-08:00,['63b68260817214285267923ed08ee9970affad30'],3,10,13,25091305,3,1,1,1,28231
de56092a4a46d88b0a785b0a27c74b563d9cd5a1,1,Swapan Shridhar,2017-02-07 15:33:35-08:00,['fb4fb888e6345e7ab03ea0e85325c53f1ef560d9'],1,1,2,25091307,1,,,,28231
c99ca1254fb48a207a6759b3ba113aa859a6b0ba,0,Swapan Shridhar,2017-02-07 15:40:50-08:00,['de56092a4a46d88b0a785b0a27c74b563d9cd5a1'],7,7,14,25091321,2,,,,28231
b3f63395b009f0d5c1b492ea666f61aad910da0f,0,Swapan Shridhar,2017-02-07 16:46:13-08:00,['c99ca1254fb48a207a6759b3ba113aa859a6b0ba'],0,16,16,25091337,1,,,,28231
b6d5c19892efbd63ce0bf2a2a3da906e41520342,1,Aravindan Vijayan,2017-02-07 18:30:17-08:00,['b3f63395b009f0d5c1b492ea666f61aad910da0f'],27,34,61,25091398,6,0,1,0.714285714,28231
1e583a8f458f961cd56c5a6d934c263bf33a098e,1,Gaurav Nagar,2017-02-08 08:46:01+05:18,['b6d5c19892efbd63ce0bf2a2a3da906e41520342'],10,11,21,25091419,2,,,,28231
2720b5c1f0deed57e294dbf06140eb40fdcf31b8,1,pallavkul,2017-02-08 14:39:25+05:18,['1e583a8f458f961cd56c5a6d934c263bf33a098e'],2,1174,1176,25092595,23,1,1,0.922535211,28248
df50b6c01a07685b5c5f446e334314b9620c5a99,1,pallavkul,2017-02-08 15:18:07+05:18,['2720b5c1f0deed57e294dbf06140eb40fdcf31b8'],26,922,948,25093543,12,0.501672241,0.849498328,0.829431438,28252
0eeecbbd16b7a95527ca4ee59c5460b2244127d3,0,pallavkul,2017-02-08 16:18:41+05:18,['df50b6c01a07685b5c5f446e334314b9620c5a99'],9,18,27,25093570,4,1,1,0,28252
af781d1acdcf8edbc9fe2f99803b54ef6d831f7e,1,pallavkul,2017-02-08 16:20:17+05:18,['0eeecbbd16b7a95527ca4ee59c5460b2244127d3'],18,9,27,25093597,4,0,0,1,28252
43f70c8d0af543adece7196118b1e65a404f470a,0,pallavkul,2017-02-08 16:21:19+05:18,['af781d1acdcf8edbc9fe2f99803b54ef6d831f7e'],9,18,27,25093624,4,1,1,0,28252
8fd6395b3b6a95e17065a7c6ae26e8432c635a8c,1,pallavkul,2017-02-08 16:44:49+05:18,['43f70c8d0af543adece7196118b1e65a404f470a'],419,4,423,25094047,4,0.239631336,0,0,28252
742225ab9b400b80dba6f878bedcfad1cd3534e6,1,Oleg Nechiporenko,2017-02-08 13:59:38+02:00,['8fd6395b3b6a95e17065a7c6ae26e8432c635a8c'],93,74,167,25094214,4,1,1,1,28252
f2329600c336ad3b51f13e00c5c439a5787f4b96,1,Nitiraj Singh Rathore,2017-02-08 17:45:06+05:18,['742225ab9b400b80dba6f878bedcfad1cd3534e6'],3,22,25,25094239,2,0,0,1,28252
e3eda328d42adcc69610bdb767cf1a66f944e1f2,1,Dipayan Bhowmick,2017-02-08 20:53:59+05:18,['f2329600c336ad3b51f13e00c5c439a5787f4b96'],282,911,1193,25095432,29,0.544159544,1,1,28257
37eb2dca7f56f4201f32ea1f142e04b31eb6d777,1,Andrew Onishuk,2017-02-08 17:41:18+02:00,['e3eda328d42adcc69610bdb767cf1a66f944e1f2'],14,7,21,25095453,3,0.75,0,0,28257
359ea90008e91d3837c1051d60c9f4d5e37736de,0,ababiichuk,2017-02-08 17:57:45+02:00,['37eb2dca7f56f4201f32ea1f142e04b31eb6d777'],114,101,215,25095668,6,0,1,1,28257
060b0a6daeb96763ae1e806d5773ee19cdab7040,1,Sumit Mohanty,2017-02-08 07:48:53-08:00,['359ea90008e91d3837c1051d60c9f4d5e37736de'],0,1,1,25095669,1,,,,28257
5c8aa25a48d8b89cc20faac3601ce9c6521b33c1,0,Richard Zang,2017-02-08 10:41:59-08:00,['060b0a6daeb96763ae1e806d5773ee19cdab7040'],1,7,8,25095677,1,,,,28257
3568864a83ce7683be83dd8fb46fd5e80c139bf6,1,Vitaly Brodetskyi,2017-02-08 22:37:39+02:00,['5c8aa25a48d8b89cc20faac3601ce9c6521b33c1'],0,24,24,25095701,2,,,,28257
dea78b9d77a3278c481677cbf5af10ce2bb754eb,1,Richard Zang,2017-02-08 13:24:52-08:00,['3568864a83ce7683be83dd8fb46fd5e80c139bf6'],5,7,12,25095713,2,1,1,1,28257
c219d357700a781777062442d7112088da1fe388,1,Swapan Shridhar,2017-02-08 13:38:09-08:00,['dea78b9d77a3278c481677cbf5af10ce2bb754eb'],250,41,291,25096004,2,1,0.027624309,0.027624309,28257
de420a88a7ab54a0a668054e6cf68521d27de0bf,1,Swapan Shridhar,2017-02-08 16:05:56-08:00,['c219d357700a781777062442d7112088da1fe388'],41,250,291,25096295,2,0,0.972375691,0.972375691,28257
61cebe7c4ff8f3312d74d3c1e8dce84ec4934d6b,1,Sandor Magyari,2017-02-09 08:27:32+01:00,['de420a88a7ab54a0a668054e6cf68521d27de0bf'],18,87,105,25096400,2,0,0.891304348,0.891304348,28257
7c3bcc9e88450323a60ae3e42ccec3e5bb57555f,1,pallavkul,2017-02-09 12:56:56+05:18,['61cebe7c4ff8f3312d74d3c1e8dce84ec4934d6b'],3,7,10,25096410,4,,,,28257
bb7ed895212845201cbc1a159a10b6395f48bf51,1,Oleg Nechiporenko,2017-02-09 11:22:45+02:00,['7c3bcc9e88450323a60ae3e42ccec3e5bb57555f'],98,221,319,25096729,5,0.656862745,1,0.901960784,28257
f14168330fecd0ff0d78b2d1d1af692feee83c92,1,Nitiraj Singh Rathore,2017-02-09 14:42:01+05:18,['bb7ed895212845201cbc1a159a10b6395f48bf51'],6,5,11,25096740,6,,,,28257
170497e92ff558f3505314153acf76954ba9ca3b,1,Nitiraj Singh Rathore,2017-02-09 15:00:34+05:18,['f14168330fecd0ff0d78b2d1d1af692feee83c92'],52,64,116,25096856,7,1,1,1,28257
e6dcc0920b053f6b294323575f2c28982af4e943,1,Dipayan Bhowmick,2017-02-09 15:32:01+05:18,['170497e92ff558f3505314153acf76954ba9ca3b'],1,1,2,25096858,1,,,,28257
9c07b8b54c52d332d3f0268e9cbf920e959af208,1,Dipayan Bhowmick,2017-02-09 15:42:38+05:18,['e6dcc0920b053f6b294323575f2c28982af4e943'],9,49,58,25096916,3,1,1,1,28257
af8b1cdfee14c11c2b37a0da6faa1aa3361ddf36,0,Gaurav Nagar,2017-02-09 15:47:35+05:18,['9c07b8b54c52d332d3f0268e9cbf920e959af208'],3,67,70,25096986,2,0.238095238,1,0.857142857,28257
7b40c5badbc262ced220d239d029423e4c48500b,1,Gaurav Nagar,2017-02-09 16:59:19+05:18,['af8b1cdfee14c11c2b37a0da6faa1aa3361ddf36'],0,1,1,25096987,1,0,1,0,28257
e9f07973f4c516590aca3e57e320a72a0bcedfe7,1,Oleg Nechiporenko,2017-02-09 14:29:53+02:00,['7b40c5badbc262ced220d239d029423e4c48500b'],18,20,38,25097025,3,1,1,1,28257
a1bd2987aad13f84cc0e93ae7f87c10d11b034d0,1,Miklos Gergely,2017-02-09 13:37:03+01:00,['e9f07973f4c516590aca3e57e320a72a0bcedfe7'],79,45,124,25097149,8,1,0,0,28257
8561542e6eda848ef4aef53a70c6e13dce01175b,0,Vitaly Brodetskyi,2017-02-09 15:11:51+02:00,['a1bd2987aad13f84cc0e93ae7f87c10d11b034d0'],3,48,51,25097200,1,0.772727273,0.772727273,0.772727273,28257
10a0ba464bf1575775b09c2b9e1f210c8dfaf549,0,Andrew Onishuk,2017-02-09 15:19:58+02:00,['8561542e6eda848ef4aef53a70c6e13dce01175b'],9,10,19,25097219,2,1,1,0,28257
a6de4ac27b7504cb03c4fee3affd6c3330589a60,1,Miklos Gergely,2017-02-09 14:38:34+01:00,['10a0ba464bf1575775b09c2b9e1f210c8dfaf549'],2,2,4,25097223,2,,,,28257
2d11e505939f172404b80d5950ac288c214fa503,0,Andrii Tkach,2017-02-09 15:41:06+02:00,['a6de4ac27b7504cb03c4fee3affd6c3330589a60'],0,12,12,25097235,1,1,1,1,28257
0458ec8513c85d23016ba5fdcc6e86fd78e5d4a4,0,Andrew Onishuk,2017-02-09 17:10:20+02:00,['2d11e505939f172404b80d5950ac288c214fa503'],3,3,6,25097241,1,,,,28257
ca09c208ea602e1f7b612d4e40b42b63861231a6,1,Dmytro Sen,2017-02-09 18:40:15+02:00,['0458ec8513c85d23016ba5fdcc6e86fd78e5d4a4'],110,292,402,25097643,11,0,0.756097561,0.951219512,28257
dbb3567740c9a2f5d48baab390c7f10711380f98,1,Denys Buzhor,2017-02-09 19:03:05+02:00,['ca09c208ea602e1f7b612d4e40b42b63861231a6'],15,148,163,25097806,8,0.819047619,1,0.99047619,28257
00e18721ee47ae227e848bf4e68d3e8a4a2c40e3,0,Andrii Tkach,2017-02-09 20:07:14+02:00,['dbb3567740c9a2f5d48baab390c7f10711380f98'],1,18,19,25097825,2,0,1,1,28257
43323f997b34a0bbb4ee9122734311e0b1205fcb,1,Alejandro Fernandez,2017-02-09 11:27:49-08:00,['00e18721ee47ae227e848bf4e68d3e8a4a2c40e3'],304,324,628,25098453,18,,,,28257
259f31ae11840c0b807e1aa9623df20d7b382da8,0,Jayush Luniya,2017-02-09 11:37:35-08:00,['43323f997b34a0bbb4ee9122734311e0b1205fcb'],1,1,2,25098455,1,,,,28257
6addaf50e27d42d0da119cd006ae28f3dd1e678f,1,Sumit Mohanty,2017-02-09 11:39:43-08:00,['259f31ae11840c0b807e1aa9623df20d7b382da8'],7,90,97,25098552,2,0,0.828125,1,28257
d5755ba15a979aa94fd53338be27d2206f108065,0,Yusaku Sako,2017-02-09 11:53:15-08:00,['6addaf50e27d42d0da119cd006ae28f3dd1e678f'],2,14,16,25098568,1,,,,28257
3c0f3c46b97f00a24cf0711c43bc24df3ed6df84,1,Sumit Mohanty,2017-02-09 12:32:17-08:00,['d5755ba15a979aa94fd53338be27d2206f108065'],16,759,775,25099343,14,0.539215686,0.931372549,0.911764706,28261
7abf4e63f093d55c793b451d0435fc485757e6c7,1,Aravindan Vijayan,2017-02-09 13:45:33-08:00,['3c0f3c46b97f00a24cf0711c43bc24df3ed6df84'],5,31,36,25099379,6,0,1,1,28261
05ce603a9fa5a6a72af4de70cbc21208f6749384,0,Aravindan Vijayan,2017-02-09 13:45:57-08:00,['7abf4e63f093d55c793b451d0435fc485757e6c7'],9,19,28,25099407,6,0,0,1,28261
00ed41594fdd03c7da715904efec522748c1e3bd,1,Yusaku Sako,2017-02-09 16:49:03-08:00,['05ce603a9fa5a6a72af4de70cbc21208f6749384'],0,3700,3700,25103107,2,,,,28263
bc806659971c05b873aa769007afa2916b2041dc,1,Sumit Mohanty,2017-02-09 18:58:34-08:00,['00ed41594fdd03c7da715904efec522748c1e3bd'],6,274,280,25103387,3,0,0.164772727,1,28263
2ce10423190f999b794140a270601a62dc6b7f95,1,Dipayan Bhowmick,2017-02-10 14:48:03+05:18,['bc806659971c05b873aa769007afa2916b2041dc'],26,47,73,25103460,2,0.75,0.75,1,28263
09e35e1e3de0206edbf139ed5cbf9a33b470c7f1,1,Dipayan Bhowmick,2017-02-10 14:54:46+05:18,['2ce10423190f999b794140a270601a62dc6b7f95'],16,16,32,25103492,12,,,,28263
232b585bdd0350f5b2fb8c2c7ebf200cd3286fa7,1,Dipayan Bhowmick,2017-02-10 14:58:17+05:18,['09e35e1e3de0206edbf139ed5cbf9a33b470c7f1'],0,2,2,25103494,1,,,,28263
92cf561520572ac65ca6e593729bb13a3edff8e1,1,Dipayan Bhowmick,2017-02-10 15:02:37+05:18,['232b585bdd0350f5b2fb8c2c7ebf200cd3286fa7'],1,6,7,25103501,2,,,,28263
97994e23f3b6ec71ff9911e43d9c4b135487acba,0,Gaurav Nagar,2017-02-10 15:34:59+05:18,['92cf561520572ac65ca6e593729bb13a3edff8e1'],14,171,185,25103686,6,0.771084337,0.771084337,1,28263
d7e11e9abfde98618ff90f96b8a0952c30c6bef1,1,Nitiraj Singh Rathore,2017-02-10 16:05:49+05:18,['97994e23f3b6ec71ff9911e43d9c4b135487acba'],175,49,224,25103910,5,0.375,0.1125,0,28263
1339d52bb1e685bb363157ac949e52da970113b8,1,Gaurav Nagar,2017-02-10 16:37:45+05:18,['d7e11e9abfde98618ff90f96b8a0952c30c6bef1'],21,49,70,25103980,5,1,1,1,28263
b15b60646c3d8a0b39579718f48e0076c26a6142,0,Gaurav Nagar,2017-02-10 16:38:55+05:18,['1339d52bb1e685bb363157ac949e52da970113b8'],9,34,43,25104023,1,0.388888889,0.388888889,1,28263
59545f7fde971c352c7f7f44a19f436887fcdfe7,1,Vitaly Brodetskyi,2017-02-10 14:41:12+02:00,['b15b60646c3d8a0b39579718f48e0076c26a6142'],1,51,52,25104075,4,1,1,0,28263
41034aa157cc7b36f1635064055b83deb5f542bc,1,Lisnichenko Dmitro,2017-02-10 15:15:20+02:00,['59545f7fde971c352c7f7f44a19f436887fcdfe7'],37,346,383,25104458,4,0.827777778,1,0.833333333,28265
fc9788af1d5c9533de5961e5bc97cf46b2a98b44,1,Lisnichenko Dmitro,2017-02-10 15:16:53+02:00,['41034aa157cc7b36f1635064055b83deb5f542bc'],0,44,44,25104502,9,,,,28265
c9bea4ab8f8a042e60103e8bb8880fc718fa3cf3,1,Myroslav Papirkovskyi,2017-02-10 16:00:21+02:00,['fc9788af1d5c9533de5961e5bc97cf46b2a98b44'],39,53,92,25104594,2,0.8,0,0,28265
eecb5a311626f2bab09688d37949f0ccedde86a8,0,ababiichuk,2017-02-10 18:22:30+02:00,['c9bea4ab8f8a042e60103e8bb8880fc718fa3cf3'],32,81,113,25104707,2,0.565217391,1,1,28265
a0ba7fbe7f80332bcff1cab9ea7dbe27ca59a003,1,Sumit Mohanty,2017-02-10 08:42:42-08:00,['eecb5a311626f2bab09688d37949f0ccedde86a8'],0,128,128,25104835,8,0,1,0.815789474,28265
33caec24a8742666a7190f38f5ebd71c54b2a405,0,"Toader, Sebastian",2017-02-10 18:38:37+01:00,['a0ba7fbe7f80332bcff1cab9ea7dbe27ca59a003'],25,66,91,25104926,4,0,0.047619048,1,28265
fe1704e12287685f8ca0fed179eb471556eee37b,1,Dmytro Sen,2017-02-10 19:52:40+02:00,['33caec24a8742666a7190f38f5ebd71c54b2a405'],9,27,36,25104962,6,0,0.2,0.2,28265
e8a9961841e0eaac2b471526068afabf37d10a35,1,Andrii Tkach,2017-02-10 21:37:29+02:00,['fe1704e12287685f8ca0fed179eb471556eee37b'],9,30,39,25105001,2,0.933333333,0.933333333,0.933333333,28265
4381561f92aeb91b1a2b3cafff4a860efde81dff,1,Alejandro Fernandez,2017-02-10 13:16:34-08:00,['e8a9961841e0eaac2b471526068afabf37d10a35'],2,2,4,25105005,1,,,,28265
38a17a7fb4a27c7ab2bd3d4e87d8ffd0f4150079,0,Siddharth Wagle,2017-02-10 13:31:39-08:00,['4381561f92aeb91b1a2b3cafff4a860efde81dff'],0,2,2,25105007,1,0,1,1,28265
f4c83843674764918bd50443705af1fce9852a2b,1,Swapan Shridhar,2017-02-10 15:13:48-08:00,['38a17a7fb4a27c7ab2bd3d4e87d8ffd0f4150079'],24,83,107,25105114,6,0,0.8,0.75,28265
e7d0e781b3506d20806f521b30ce4629e67641f5,0,Swapan Shridhar,2017-02-10 16:10:25-08:00,['f4c83843674764918bd50443705af1fce9852a2b'],6,45,51,25105165,2,0,0.722222222,0.722222222,28265
b00cf74f6cecb984381eeed9e464ad1db6461a18,0,Sumit Mohanty,2017-02-10 16:53:45-08:00,['e7d0e781b3506d20806f521b30ce4629e67641f5'],1,1,2,25105167,1,,,,28265
d96d209c1ad8aeefd9ab1c02fbe621c7dfd02ffa,1,pallavkul,2017-02-11 08:34:11+05:18,['b00cf74f6cecb984381eeed9e464ad1db6461a18'],0,20,20,25105187,4,0.777777778,1,1,28265
23642958208fe6b3148ac157753edb13b6d31347,1,pallavkul,2017-02-11 16:46:22+05:18,['d96d209c1ad8aeefd9ab1c02fbe621c7dfd02ffa'],27,75,102,25105289,8,1,0,0,28266
1d1253a6471113a78dd22faf453439ab13a19e48,1,pallavkul,2017-02-11 16:54:43+05:18,['23642958208fe6b3148ac157753edb13b6d31347'],5,148,153,25105442,6,1,1,1,28268
77b5b16e2bd68ed18e193104b56ad0bb434ee505,1,pallavkul,2017-02-11 17:05:12+05:18,['1d1253a6471113a78dd22faf453439ab13a19e48'],10,40,50,25105492,4,0,1,1,28268
6098d342c14ede52f2743274482ce3d37c0917b6,0,Andrew Onishuk,2017-02-11 18:16:48+02:00,['77b5b16e2bd68ed18e193104b56ad0bb434ee505'],2,2,4,25105496,1,,,,28268
d6e0b267a26ee5a1ca8a35b2cf682c860653eef8,1,Sumit Mohanty,2017-02-11 08:23:46-08:00,['6098d342c14ede52f2743274482ce3d37c0917b6'],26,432,458,25105954,18,0,0,1,28271
d5100632624a671512ea44e6ad8f6ee9df3dba24,1,Sumit Mohanty,2017-02-11 16:09:48-08:00,['d6e0b267a26ee5a1ca8a35b2cf682c860653eef8'],1,20,21,25105975,4,,,,28271
6eac0f57a61da4e76b175f0de43ab315a665b9c2,1,Aravindan Vijayan,2017-02-12 08:34:58-08:00,['d5100632624a671512ea44e6ad8f6ee9df3dba24'],107,4,111,25106086,3,,,,28271
5d695d83d8d5f2e8b622757b434133bfaa125dc8,0,Aravindan Vijayan,2017-02-12 08:37:22-08:00,['6eac0f57a61da4e76b175f0de43ab315a665b9c2'],4,0,4,25106090,1,,,,28271
3a9519279e3f3b9ba113fb1bc1d3241e6bd9f2a8,0,Aravindan Vijayan,2017-02-12 14:23:54-08:00,['5d695d83d8d5f2e8b622757b434133bfaa125dc8'],0,8,8,25106098,1,0,0,0,28271
b695bf2bfcb96b48e7896a6242d25cf786cb46df,0,Sumit Mohanty,2017-02-12 19:10:12-08:00,['3a9519279e3f3b9ba113fb1bc1d3241e6bd9f2a8'],5,4,9,25106107,1,,,,28271
a9060614ffe9cd6812eb8ff9cbb6fd81572f66e2,1,Renjith Kamath,2017-02-13 13:17:00+05:18,['b695bf2bfcb96b48e7896a6242d25cf786cb46df'],10,147,157,25106264,3,0.235294118,0.235294118,1,28272
b8176ff63c00115156062a2af9d2e2cae164e514,0,Dmytro Sen,2017-02-13 12:42:06+02:00,['a9060614ffe9cd6812eb8ff9cbb6fd81572f66e2'],7,152,159,25106423,1,0.189873418,1,1,28272
c7164d8eaaacc62e4d56f8f8ff03b74b1a0d46af,1,Oleg Nechiporenko,2017-02-13 13:47:47+02:00,['cc4c04e5b35e2cd798f38b0740214f96b128215e'],99,168,267,25106690,9,0,0.94,1,28274
a7eafd59db2f9771b9e2b08d6a71406e05309b5c,0,Vitaly Brodetskyi,2017-02-13 14:10:21+02:00,['b8176ff63c00115156062a2af9d2e2cae164e514'],2,5,7,25106697,2,0,1,1,28274
a6445ac838cc2b54e5ee5f943d4fa22a72fc7ad3,0,ababiichuk,2017-02-13 14:45:50+02:00,['a7eafd59db2f9771b9e2b08d6a71406e05309b5c'],94,1,95,25106792,2,1,0,0,28274
6c4cbc4f7efddd55e063dbff470fa04eee2e68bf,1,Dipayan Bhowmick,2017-02-13 18:47:54+05:18,['a6445ac838cc2b54e5ee5f943d4fa22a72fc7ad3'],66,387,453,25107245,27,1,1,1,28287
fa32fec6d891745885b976cc2dc13512706dfed9,0,Jonathan Hurley,2017-02-13 11:23:33-05:00,['6c4cbc4f7efddd55e063dbff470fa04eee2e68bf'],50,36,86,25107331,5,0,0,0,28287
d252665ce94f532b08efb9bc5f31f7b8f6cde97a,1,Dmytro Sen,2017-02-13 19:42:59+02:00,['fa32fec6d891745885b976cc2dc13512706dfed9'],123,90,213,25107544,17,0.952380952,0,0,28288
7cb9a6ad53a926f055c5bf78ac2a9a8bd1668d78,1,Aravindan Vijayan,2017-02-13 10:56:46-08:00,['d252665ce94f532b08efb9bc5f31f7b8f6cde97a'],0,4,4,25107548,1,,,,28288
341cb1247cbf67f5611766d8f5bf27bd878441e1,0,Nate Cole,2017-02-13 17:11:38-05:00,"['d222f572ee2952add29e60afeb47a4da7ac98685', '7cb9a6ad53a926f055c5bf78ac2a9a8bd1668d78']",8778,19328,28106,25135654,547,,,,28288
4deacdd7ba81ba4348d1929c09a66858dbd5ba6c,0,Vitaly Brodetskyi,2017-02-14 00:57:40+02:00,['7cb9a6ad53a926f055c5bf78ac2a9a8bd1668d78'],3,5,8,25135662,2,0,0,1,28288
b31bef74c7a1bf1407eb0f5b5c77c62c4a7d0704,1,Yusaku Sako,2017-02-13 15:44:31-08:00,['4deacdd7ba81ba4348d1929c09a66858dbd5ba6c'],387,66,453,25136115,27,0,0,0,28288
399b70835fa076377018e6aa40de762df0c1e5fc,0,Aravindan Vijayan,2017-02-13 17:50:47-08:00,['b31bef74c7a1bf1407eb0f5b5c77c62c4a7d0704'],0,4,4,25136119,4,,,,28288
31944e382019482ee40e8ec4c691b6aea7fce230,0,Mugdha Varadkar,2017-02-14 10:19:39+05:18,['399b70835fa076377018e6aa40de762df0c1e5fc'],0,244,244,25136363,9,0.431578947,1,1,28290
069ad4d7a239c356fb6cd35b45f80aa3ea36a296,1,Gaurav Nagar,2017-02-14 11:23:28+05:18,['31944e382019482ee40e8ec4c691b6aea7fce230'],0,1,1,25136364,1,1,1,1,28290
fcf396f3d9bf774c89af8d683e9e22fa1e9188c0,1,Gaurav Nagar,2017-02-14 11:34:36+05:18,['069ad4d7a239c356fb6cd35b45f80aa3ea36a296'],55,88,143,25136507,13,0,0,0,28290
d797c7eb250552e6655c96e68eba93961d3d70fb,1,Attila Doroszlai,2017-02-14 08:36:41+01:00,['fcf396f3d9bf774c89af8d683e9e22fa1e9188c0'],17,28,45,25136552,3,0,0.909090909,0.454545455,28290
6bb86b10360cfa1611a401f08f06b05c5a63a535,1,Dipayan Bhowmick,2017-02-14 13:15:48+05:18,['d797c7eb250552e6655c96e68eba93961d3d70fb'],66,405,471,25137023,27,1,1,1,28303
eb1b9cfaa869e25577b3502b68c08efbbf1cbaf5,1,Sandor Magyari,2017-02-14 09:30:29+01:00,['6bb86b10360cfa1611a401f08f06b05c5a63a535'],5,36,41,25137064,2,0.217391304,1,1,28303
e9e0a438a142ec9560ec9a5d8134d40a34efdacc,0,Oleg Nechiporenko,2017-02-14 10:54:05+02:00,['eb1b9cfaa869e25577b3502b68c08efbbf1cbaf5'],4,3,7,25137071,1,0,0,0,28303
0fdde6290b3f8dd3f6009f7dc8a6e68e5a00f9df,0,Oleg Nechiporenko,2017-02-14 13:02:44+02:00,['e9e0a438a142ec9560ec9a5d8134d40a34efdacc'],12,16,28,25137099,2,1,1,1,28303
0a86fc0838ef1bb56015229ba86e5fedf448decc,1,Gaurav Nagar,2017-02-14 17:54:53+05:18,['0fdde6290b3f8dd3f6009f7dc8a6e68e5a00f9df'],44,89,133,25137232,11,1,1,1,28303
f8c34a088180a40cb5b02f3b4a499252b80f96d3,0,Gaurav Nagar,2017-02-14 17:57:02+05:18,['0a86fc0838ef1bb56015229ba86e5fedf448decc'],4,13,17,25137249,5,1,1,1,28303
bda839e1f1452dc711f7e33888ffa90b79e7be27,1,Dmytro Sen,2017-02-14 18:10:00+02:00,['f8c34a088180a40cb5b02f3b4a499252b80f96d3'],0,42,42,25137291,2,0,1,1,28303
871d95c04fe64cfd5075dae60990fe6c23bc641d,0,Robert Levas,2017-02-14 11:25:46-05:00,['bda839e1f1452dc711f7e33888ffa90b79e7be27'],1,1,2,25137293,1,,,,28303
635f7f0f5eb799f3c57951ce9361bc66230084c0,1,Robert Levas,2017-02-14 11:30:40-05:00,['871d95c04fe64cfd5075dae60990fe6c23bc641d'],1,1,2,25137295,1,,,,28303
8efff7480283aa1a5e6aa917c0fa81f5da60c7c4,0,Robert Levas,2017-02-14 11:31:14-05:00,['635f7f0f5eb799f3c57951ce9361bc66230084c0'],1,1,2,25137297,1,,,,28303
9093621e6957f469cb74669130bd1a906649af79,0,Richard Zang,2017-02-14 11:37:44-08:00,['8efff7480283aa1a5e6aa917c0fa81f5da60c7c4'],9,12,21,25137318,2,1,0,1,28303
c058866e1a847c898592a4cc6ba6428409b9ea99,0,Sumit Mohanty,2017-02-14 16:54:19-08:00,['9093621e6957f469cb74669130bd1a906649af79'],4,4,8,25137326,4,,,,28303
5b53d848191679e070a06f6ef4d327c155b79a0d,1,Swapan Shridhar,2017-02-14 17:52:46-08:00,['c058866e1a847c898592a4cc6ba6428409b9ea99'],16,43,59,25137385,2,1,1,0.5,28303
39c0b92890c7ddd229187abc041f490effa86e7d,0,pallavkul,2017-02-15 08:14:50+05:18,['5b53d848191679e070a06f6ef4d327c155b79a0d'],0,7,7,25137392,1,1,1,1,28303
e52fbc3a88f814f9731cb6a4e404ed4ffd608897,0,Mugdha Varadkar,2017-02-15 10:26:16+05:18,['39c0b92890c7ddd229187abc041f490effa86e7d'],1,16,17,25137409,1,,,,28303
1a03354c9c44e85ae89fa7786eb61a1515f7cd41,0,Oleg Nechiporenko,2017-02-15 10:26:22+02:00,['e52fbc3a88f814f9731cb6a4e404ed4ffd608897'],2,1,3,25137412,1,0,0,0,28303
9a60b86f499fa55aa110d34a3c022b4707fbe4e6,0,Gaurav Nagar,2017-02-15 16:49:39+05:18,['1a03354c9c44e85ae89fa7786eb61a1515f7cd41'],1,3,4,25137416,1,0,1,1,28303
2ed71586a88f8fc5c9fc41790e9165ffd5e34cd6,1,Gaurav Nagar,2017-02-15 16:51:42+05:18,['9a60b86f499fa55aa110d34a3c022b4707fbe4e6'],38,62,100,25137516,4,0.125,0.625,1,28303
45ef011e455d92c23f66c8e9e18bcb8cc0fd742d,1,Gaurav Nagar,2017-02-15 16:53:49+05:18,['2ed71586a88f8fc5c9fc41790e9165ffd5e34cd6'],7,7,14,25137530,3,,,,28303
a8c101041ae50234ca72003d32bbd47001d8cbe8,1,Gaurav Nagar,2017-02-15 16:55:36+05:18,['45ef011e455d92c23f66c8e9e18bcb8cc0fd742d'],63,35,98,25137628,4,1,1,0,28303
2edfefccaa6188c87b98219e98c9626061399f7c,1,Miklos Gergely,2017-02-15 12:39:15+01:00,['a8c101041ae50234ca72003d32bbd47001d8cbe8'],61,72,133,25137761,10,1,0,0.076923077,28304
f91095b55e18c79a70ac58937b608f7d4cd5adeb,1,Gaurav Nagar,2017-02-15 16:58:02+05:18,['2edfefccaa6188c87b98219e98c9626061399f7c'],40,79,119,25137880,9,1,1,1,28304
11893d463f8001e97bfc71c18c7a650b19e969c0,1,Andrew Onishuk,2017-02-15 14:42:03+02:00,['f91095b55e18c79a70ac58937b608f7d4cd5adeb'],4,7,11,25137891,1,0,1,1,28304
513b527564cef89dff2154504ef4108d6eea5123,1,Sandor Magyari,2017-02-15 14:00:04+01:00,['11893d463f8001e97bfc71c18c7a650b19e969c0'],108,104,212,25138103,7,0,1,1,28304
141e88dd4f3e2e48b2bd40d205e6c9716aec2669,1,Nitiraj Singh Rathore,2017-02-15 18:24:10+05:18,['513b527564cef89dff2154504ef4108d6eea5123'],83,42,125,25138228,7,0.285714286,0,0,28304
a1f23ad4284cff716b890392c4c22a16229e16ad,1,Andrii Tkach,2017-02-15 16:35:38+02:00,['141e88dd4f3e2e48b2bd40d205e6c9716aec2669'],148,142,290,25138518,43,1,0,0.235294118,28304
45842645c546a176f1692d0d7be008e2d51c5086,0,Robert Levas,2017-02-15 11:20:03-05:00,['a1f23ad4284cff716b890392c4c22a16229e16ad'],2,2,4,25138522,2,,,,28304
d75756efa7bcecb09d0ee73db6c29b018ba964fc,1,ababiichuk,2017-02-15 18:41:52+02:00,['45842645c546a176f1692d0d7be008e2d51c5086'],33,76,109,25138631,3,0.139534884,0.186046512,1,28304
e890f01d0f562b81489c44fea9596f3455d8d9bc,0,Dmytro Sen,2017-02-15 19:05:00+02:00,['d75756efa7bcecb09d0ee73db6c29b018ba964fc'],5,0,5,25138636,1,1,1,0,28304
b36f00e2bafa4c65a20bfde57c0a60ff37a68cdb,0,ababiichuk,2017-02-15 20:28:42+02:00,['e890f01d0f562b81489c44fea9596f3455d8d9bc'],1,1,2,25138638,1,,,,28304
d8af6aba46fe3c62b9b5a4d42b2f716b649c20bd,1,Xi Wang,2017-02-15 10:39:41-08:00,['c7164d8eaaacc62e4d56f8f8ff03b74b1a0d46af'],212,480,692,25139330,10,0,1,1,28306
dd6fb57d1ab26dad7f13a371f187e7330c2f6450,1,Aravindan Vijayan,2017-02-15 11:06:44-08:00,['b36f00e2bafa4c65a20bfde57c0a60ff37a68cdb'],81,81,162,25139492,6,,,,28306
2db72cdf667a174d43eb7fa3c45166b1734948ae,0,Aravindan Vijayan,2017-02-15 11:06:44-08:00,['dd6fb57d1ab26dad7f13a371f187e7330c2f6450'],0,12,12,25139504,2,0,0.727272727,1,28306
0952b8ff89d871962da19918c00357e8565625c1,1,Denys Buzhor,2017-02-15 23:16:29+02:00,['2db72cdf667a174d43eb7fa3c45166b1734948ae'],2,7,9,25139513,3,1,1,0,28306
d8c8b4ec4e1a3467279c2b523516175662c03afe,0,Swapan Shridhar,2017-02-15 13:32:29-08:00,['0952b8ff89d871962da19918c00357e8565625c1'],5,8,13,25139526,1,0,0,0,28306
95d096dea461466ba2e22028620b9c2081558bc6,1,Swapan Shridhar,2017-02-15 13:36:56-08:00,['d8c8b4ec4e1a3467279c2b523516175662c03afe'],8,5,13,25139539,1,1,1,1,28306
90235286c8a4aebb1c5159be89509f6679a6e1da,1,Swapan Shridhar,2017-02-15 13:37:54-08:00,['95d096dea461466ba2e22028620b9c2081558bc6'],10,17,27,25139566,2,0,0,0,28306
11618bb6f65b9723c7198b6f59ef25515499739e,0,Swapan Shridhar,2017-02-15 13:44:28-08:00,['90235286c8a4aebb1c5159be89509f6679a6e1da'],5,7,12,25139578,1,,,,28306
4c08ceadac683aedf8e7feae077b3cf91724b8a3,1,Xi Wang,2017-02-15 18:30:39-08:00,['d8af6aba46fe3c62b9b5a4d42b2f716b649c20bd'],117,217,334,25139912,7,0.508196721,1,1,28306
d4c1ace80b46deb7982b1da28025927f00a4123e,0,Jonathan Hurley,2017-02-15 23:47:37-05:00,['11618bb6f65b9723c7198b6f59ef25515499739e'],0,6,6,25139918,3,,,,28306
4aa0f6234e42b2328e2b0b3f435a1b13d27412a9,1,Gaurav Nagar,2017-02-16 10:35:22+05:18,['d4c1ace80b46deb7982b1da28025927f00a4123e'],454,578,1032,25140950,22,0.022727273,0.340909091,0.340909091,28306
6d82e215e22f41012156dc610ee07a10996a34f7,0,Sumit Mohanty,2017-02-15 21:53:46-08:00,['4aa0f6234e42b2328e2b0b3f435a1b13d27412a9'],0,43,43,25140993,1,,,,28307
f75eebadf656bde4ceca469fcd8f05ae641efc78,1,Nitiraj Singh Rathore,2017-02-16 14:25:23+05:18,['6d82e215e22f41012156dc610ee07a10996a34f7'],117,30,147,25141140,8,,,,28307
52093d1518493bec21a5ea4662964dab5afbb50a,1,Oleg Nechiporenko,2017-02-16 12:45:45+02:00,['4c08ceadac683aedf8e7feae077b3cf91724b8a3'],54,55,109,25141249,6,1,1,0,28307
8448d5a18512565895fcf79f675437d9652a0d1d,0,Gaurav Nagar,2017-02-16 16:06:09+05:18,['f75eebadf656bde4ceca469fcd8f05ae641efc78'],2,2,4,25141253,2,,,,28307
fa527360b28e956e3e931449e8740ed07ed407ed,1,"Toader, Sebastian",2017-02-16 13:08:46+01:00,['8448d5a18512565895fcf79f675437d9652a0d1d'],185,379,564,25141817,6,0.863013699,1,0.547945205,28308
fb322e2763382eb7aa6ed54fabb508482dcaebb0,1,Gaurav Nagar,2017-02-16 18:19:00+05:18,['fa527360b28e956e3e931449e8740ed07ed407ed'],13,38,51,25141868,3,,,,28308
ea82a59de4b170a10178eb1cc6385a8010e774fc,1,Gaurav Nagar,2017-02-16 18:21:54+05:18,['fb322e2763382eb7aa6ed54fabb508482dcaebb0'],10,28,38,25141906,5,0.3,0.3,0,28308
b12ae51dd4a0c745827eea7ceb75c362e00d6f75,0,Dmytro Sen,2017-02-16 16:03:05+02:00,['ea82a59de4b170a10178eb1cc6385a8010e774fc'],59,64,123,25142029,2,0.333333333,1,1,28308
ab53946fa63ad209158300ca0907e5a67097e717,0,Alex Antonenko,2017-02-16 17:14:02+02:00,['b12ae51dd4a0c745827eea7ceb75c362e00d6f75'],44,47,91,25142120,9,0,0,1,28308
4eaec8eab5175303d8ba39439ac60f3deec25f19,1,Andrew Onishuk,2017-02-16 17:36:27+02:00,['ab53946fa63ad209158300ca0907e5a67097e717'],12,7,19,25142139,2,1,1,0,28308
1f1bfb8e7b847300f2ec8b10fc9e2269f042f18b,0,Dmytro Sen,2017-02-16 19:21:17+02:00,['4eaec8eab5175303d8ba39439ac60f3deec25f19'],0,4,4,25142143,1,,,,28308
bfaaba2fa2ce0c271c5fa3de3c4b1134715407df,1,Robert Levas,2017-02-16 13:44:43-05:00,['1f1bfb8e7b847300f2ec8b10fc9e2269f042f18b'],10,41,51,25142194,10,0.444444444,1,1,28308
347ba2a9983d400cddf4d888e7f8c15d72b71d5a,1,oleewere,2017-02-16 20:18:59+01:00,['bfaaba2fa2ce0c271c5fa3de3c4b1134715407df'],59,360,419,25142613,20,0.36196319,0.245398773,0.72392638,28308
18fc2586fa7410823b3d7a9354cf5b10be0dc2e0,0,Lisnichenko Dmitro,2017-02-16 23:17:09+02:00,['347ba2a9983d400cddf4d888e7f8c15d72b71d5a'],0,21,21,25142634,3,0,0,0,28308
a12c3efa95792b97ee85545e08b09f9e7c215baa,1,Xi Wang,2017-02-16 15:21:33-08:00,['52093d1518493bec21a5ea4662964dab5afbb50a'],72,86,158,25142792,5,1,1,1,28308
ce404d640e930b7326dc1857ac1ae6ce03b2884e,0,Aleksandr Kovalenko,2017-02-17 03:12:46+02:00,['18fc2586fa7410823b3d7a9354cf5b10be0dc2e0'],3,4,7,25142799,2,1,1,1,28308
984b35e9c1f3121f6688dc797e93b710db69d6b5,0,Denys Buzhor,2017-02-17 10:20:25+02:00,['ce404d640e930b7326dc1857ac1ae6ce03b2884e'],4,81,85,25142884,3,0.75,1,1,28308
05c76ed609dfcf75e0ff211aa8032834ef8e9f73,1,Oleg Nechiporenko,2017-02-17 10:26:47+02:00,['984b35e9c1f3121f6688dc797e93b710db69d6b5'],828,968,1796,25144680,17,1,0.434065934,0.126373626,28311
c395f6948a1aa8bb62f65b3b7a1fe4c72f662762,1,Mugdha Varadkar,2017-02-17 16:07:13+05:18,['05c76ed609dfcf75e0ff211aa8032834ef8e9f73'],27,302,329,25145009,15,0,0.5,0.868421053,28312
b5014253706c85cba77c781672443d94de3e5ef4,1,Mugdha Varadkar,2017-02-17 16:14:25+05:18,['c395f6948a1aa8bb62f65b3b7a1fe4c72f662762'],3,256,259,25145268,18,0.126126126,0.738738739,0.882882883,28313
c8c134ee7c51a18df4613539e3b424cf17138645,0,Andrew Onishuk,2017-02-17 13:36:12+02:00,['b5014253706c85cba77c781672443d94de3e5ef4'],0,19,19,25145287,1,0.769230769,0.769230769,1,28313
f4638d24dd5f9d320392ef8b7b064c73c50f649c,1,Jonathan Hurley,2017-02-17 08:07:19-05:00,['347ba2a9983d400cddf4d888e7f8c15d72b71d5a'],1280,563,1843,25147130,24,0.711711712,0.427927928,0.022522523,28313
bcf7289331765c6f67b99fd08a2674c90fa53589,0,Sandor Magyari,2017-02-17 17:35:42+01:00,['c8c134ee7c51a18df4613539e3b424cf17138645'],1,1,2,25147132,1,,,,28313
dd174f417cbfe4181e5503c57b4c273009c856ae,1,oleewere,2017-02-17 17:52:48+01:00,['bcf7289331765c6f67b99fd08a2674c90fa53589'],2,4,6,25147138,1,0,1,1,28313
0fc7a6671feb10dc0e8475dc4878942cf19f46cc,1,Jaimin Jetly,2017-02-17 09:31:10-08:00,['dd174f417cbfe4181e5503c57b4c273009c856ae'],119,1892,2011,25149149,34,0.399038462,0.707932692,0.900240385,28319
db51ba46dde65bc6034d7deb1e64b18d8a460185,0,Yusaku Sako,2017-02-17 10:27:26-08:00,['0fc7a6671feb10dc0e8475dc4878942cf19f46cc'],11,23,34,25149183,1,,,,28319
8dabd55a448120336309039a6eb9fae11295c6a0,0,Richard Zang,2017-02-17 11:54:23-08:00,['db51ba46dde65bc6034d7deb1e64b18d8a460185'],4,2,6,25149189,2,,,,28319
a5dc2d2cc98eb5b2f59cc7bc13b947e84c15479b,1,Jonathan Hurley,2017-02-17 15:18:27-05:00,['8dabd55a448120336309039a6eb9fae11295c6a0'],4,5,9,25149198,1,,,,28319
f2cb1b6ef495d0708024749dfe5b702d270952a2,0,Nate Cole,2017-02-17 15:52:15-05:00,['a5dc2d2cc98eb5b2f59cc7bc13b947e84c15479b'],33,88,121,25149319,2,0.083333333,0.416666667,1,28319
e8e2df21f7fe91fa8a028bb3043bed831093a090,0,Jonathan Hurley,2017-02-17 16:29:16-05:00,"['f4638d24dd5f9d320392ef8b7b064c73c50f649c', 'a5dc2d2cc98eb5b2f59cc7bc13b947e84c15479b']",1005,3577,4582,25153901,92,,,,28319
36620ba891066619b980814ab02a8de3e3abe5a3,0,Nate Cole,2017-02-17 17:05:46-05:00,"['341cb1247cbf67f5611766d8f5bf27bd878441e1', 'f2cb1b6ef495d0708024749dfe5b702d270952a2']",2866,6700,9566,25163467,326,,,,28319
7cde24ed7eb410073b1e76819c54e600e0e6317f,1,Swapan Shridhar,2017-02-17 16:35:09-08:00,['f2cb1b6ef495d0708024749dfe5b702d270952a2'],6,17,23,25163490,5,0,0,0,28319
ab7a6719979fe87695537a498f19619219f81e38,1,Xi Wang,2017-02-17 17:18:36-08:00,['a12c3efa95792b97ee85545e08b09f9e7c215baa'],17,55,72,25163562,6,,,,28319
bf85ccec17802d26137e2f98e85bd3bfb13ce711,1,Sumit Mohanty,2017-02-18 23:50:16-08:00,['7cde24ed7eb410073b1e76819c54e600e0e6317f'],1,14,15,25163577,4,,,,28319
c7bd689df4599829fe5e3212fe0baec230a2ddaa,0,Sumit Mohanty,2017-02-18 23:56:55-08:00,['bf85ccec17802d26137e2f98e85bd3bfb13ce711'],1,1,2,25163579,1,,,,28319
fad8f2745b8e39c51800fede563e170d30ddf9f3,1,Nitiraj Singh Rathore,2017-02-20 14:09:18+05:18,['c7bd689df4599829fe5e3212fe0baec230a2ddaa'],36,27,63,25163642,5,0,0,0,28319
316d33a9b7f95610dc2f603c3140e1dda695ed04,1,pallavkul,2017-02-20 14:18:52+05:18,['fad8f2745b8e39c51800fede563e170d30ddf9f3'],313,743,1056,25164698,21,0.467153285,1,1,28330
ac4f3d11f05637639638daf204cb9405ab9fe198,1,Attila Doroszlai,2017-02-20 10:40:26+01:00,['316d33a9b7f95610dc2f603c3140e1dda695ed04'],0,23,23,25164721,1,1,1,0.769230769,28330
07342bc6e4a0e9ba2b2f850f5d8cbf38a948b50c,1,Gaurav Nagar,2017-02-20 15:28:41+05:18,['ac4f3d11f05637639638daf204cb9405ab9fe198'],138,213,351,25165072,12,1,0,0.79245283,28330
812397d3a054f2be8bb7c7c172bf59255b95a341,1,pallavkul,2017-02-20 15:44:41+05:18,['07342bc6e4a0e9ba2b2f850f5d8cbf38a948b50c'],744,1519,2263,25167335,12,0.59168242,0.674858223,0.984877127,28337
2744ae82af2816222807b0066a4ae60771147e1c,0,Attila Doroszlai,2017-02-20 11:52:51+01:00,['812397d3a054f2be8bb7c7c172bf59255b95a341'],1,1,2,25167337,1,,,,28337
36a01d4b92ba0e8ecf4a24b55d533650d13fd97f,1,Oleg Nechiporenko,2017-02-20 13:24:48+02:00,['ab7a6719979fe87695537a498f19619219f81e38'],28,63,91,25167428,2,1,1,1,28337
709bf6ef3261e609bec1161d02ae6787911e2919,1,Andrew Onishuk,2017-02-20 14:45:43+02:00,['2744ae82af2816222807b0066a4ae60771147e1c'],0,7,7,25167435,2,0,0.5,0.5,28337
6feb46a33ee448d25a35616c39b85144908f4ced,1,oleewere,2017-02-20 14:33:17+01:00,['709bf6ef3261e609bec1161d02ae6787911e2919'],0,6,6,25167441,2,,,,28337
ece4d36cb32a0a4b60025e9d54ba4131105a794b,1,Aleksandr Kovalenko,2017-02-20 15:42:13+02:00,['6feb46a33ee448d25a35616c39b85144908f4ced'],7,133,140,25167581,7,1,1,1,28339
1ecdee0d559540204c66634871e6252d622552cd,0,Eugene Chekanskiy,2017-02-20 16:53:25+02:00,['ece4d36cb32a0a4b60025e9d54ba4131105a794b'],2,4,6,25167587,2,,,,28339
9386eed4073cb8b75800f516ddfe01c3f6528bb4,1,Jonathan Hurley,2017-02-20 16:49:10-05:00,['e8e2df21f7fe91fa8a028bb3043bed831093a090'],16,233,249,25167836,3,0.08,1,1,28339
60aaaeab5e2e9c7581f982525950bf6290db3018,0,Vitaly Brodetskyi,2017-02-21 02:15:11+02:00,['1ecdee0d559540204c66634871e6252d622552cd'],5,43,48,25167884,12,1,0,0,28339
fb01ba548464e87d3d7ec8b45eefc9e7378d4af6,1,Dipayan Bhowmick,2017-02-21 12:58:54+05:18,['60aaaeab5e2e9c7581f982525950bf6290db3018'],215,91,306,25168190,7,0,0,0,28340
e585eb6ee1aeff2e391aabae9789a0f85cb76728,1,Dipayan Bhowmick,2017-02-21 13:09:25+05:18,['fb01ba548464e87d3d7ec8b45eefc9e7378d4af6'],2,2,4,25168194,1,,,,28340
6a3d8fd75f9b5a15f9a27d2c1948e07691d16a98,1,Gaurav Nagar,2017-02-21 15:54:08+05:18,['e585eb6ee1aeff2e391aabae9789a0f85cb76728'],0,14,14,25168208,2,0.8,1,1,28340
74293edfe1d1903f8e96d5a7a3eac47c48d63061,0,Gaurav Nagar,2017-02-21 15:56:30+05:18,['6a3d8fd75f9b5a15f9a27d2c1948e07691d16a98'],1,1,2,25168210,1,,,,28340
6a7d919390310baaa7f3ca92d64cf97bc6eaa7ff,1,Gaurav Nagar,2017-02-21 15:59:05+05:18,['74293edfe1d1903f8e96d5a7a3eac47c48d63061'],4,30,34,25168244,3,0.952380952,0.952380952,1,28340
4719b242560326230dc1e10473ddcd535e29c0af,1,Gaurav Nagar,2017-02-21 16:00:08+05:18,['6a7d919390310baaa7f3ca92d64cf97bc6eaa7ff'],16,22,38,25168282,2,0,0,0,28340
818a64092b6d8fed6d233a2fd6fbda07c5f6800b,1,Gaurav Nagar,2017-02-21 16:02:40+05:18,['4719b242560326230dc1e10473ddcd535e29c0af'],40,19,59,25168341,5,1,1,0,28340
299b05033811d0149f2e474358b70e14d45ee9c3,1,pallavkul,2017-02-21 16:52:36+05:18,['818a64092b6d8fed6d233a2fd6fbda07c5f6800b'],31,40,71,25168412,1,1,1,1,28340
f1c96e5d095580183519afe04e42af6ad8c7c897,0,Renjith Kamath,2017-02-21 17:53:42+05:18,['299b05033811d0149f2e474358b70e14d45ee9c3'],0,27,27,25168439,3,,,,28340
4307f9bd7252b329d63fe3f52468890d057b94c9,0,Aleksandr Kovalenko,2017-02-21 17:59:09+02:00,['f1c96e5d095580183519afe04e42af6ad8c7c897'],0,1,1,25168440,1,1,1,1,28340
0c3478b1cc98a3738bca05d12a38be87e8711f5b,0,Nate Cole,2017-02-21 11:39:23-05:00,"['36620ba891066619b980814ab02a8de3e3abe5a3', '4307f9bd7252b329d63fe3f52468890d057b94c9']",1559,2994,4553,25172993,100,,,,28340
ebf81f6e7b7113da9af067be6c3ce2960432902a,1,pallavkul,2017-02-21 22:01:24+05:18,['4307f9bd7252b329d63fe3f52468890d057b94c9'],7,22,29,25173022,6,0,0,1,28340
600d0a1a0ff4c2d927296339c05d71ac67cd2332,1,pallavkul,2017-02-21 22:14:02+05:18,['ebf81f6e7b7113da9af067be6c3ce2960432902a'],5,36,41,25173063,2,0.928571429,1,0.928571429,28340
0c464b742f206b0e6cf0c5d425d17023b47b4d9e,0,Jonathan Hurley,2017-02-21 12:07:12-05:00,"['9386eed4073cb8b75800f516ddfe01c3f6528bb4', '600d0a1a0ff4c2d927296339c05d71ac67cd2332']",1581,3117,4698,25177761,102,,,,28340
bfaf6139c24c63fbec01c64078c8392c5fec6b27,0,Robert Levas,2017-02-21 12:09:38-05:00,['600d0a1a0ff4c2d927296339c05d71ac67cd2332'],7,216,223,25177984,3,0.287128713,0.98019802,1,28341
64389cca8c6ebb15a46874aab4efba7e6352f25c,0,Aravindan Vijayan,2017-02-21 10:28:39-08:00,['bfaf6139c24c63fbec01c64078c8392c5fec6b27'],10,23,33,25178017,2,0,0,1,28341
9e5c57e3e7ae4a8b3df51efcbddcdb97a1f7b398,1,Di Li,2017-02-21 13:40:26-05:00,['64389cca8c6ebb15a46874aab4efba7e6352f25c'],0,2,2,25178019,2,,,,28341
ce7c72709c5bc8588ddaf65e8e6b246ee5bb0380,1,Swapan Shridhar,2017-02-21 12:25:09-08:00,['9e5c57e3e7ae4a8b3df51efcbddcdb97a1f7b398'],1,1,2,25178021,1,,,,28341
59daf8b0ea0465b83dad45102105f498a9784912,0,Swapan Shridhar,2017-02-21 12:29:14-08:00,['ce7c72709c5bc8588ddaf65e8e6b246ee5bb0380'],1,1,2,25178023,1,,,,28341
6553ffaee57a0c2a3ccc2389cfe4ecffef791338,0,Jonathan Hurley,2017-02-21 17:35:37-05:00,"['0c464b742f206b0e6cf0c5d425d17023b47b4d9e', '59daf8b0ea0465b83dad45102105f498a9784912']",19,243,262,25178285,9,,,,28341
235f5264a723c4c289389f46e28ae9955e1a7491,1,Robert Levas,2017-02-21 17:44:57-05:00,['6553ffaee57a0c2a3ccc2389cfe4ecffef791338'],216,7,223,25178508,3,0.712871287,0.01980198,0,28341
d7e9ef21dfa7bca1b91d94398b615f41908983c7,1,Xi Wang,2017-02-21 14:53:52-08:00,['36a01d4b92ba0e8ecf4a24b55d533650d13fd97f'],41,59,100,25178608,4,0,1,1,28341
ef0ae8bfdbe515851ddcec3139db0250b1cc62df,0,Aravindan Vijayan,2017-02-21 16:06:55-08:00,['235f5264a723c4c289389f46e28ae9955e1a7491'],4,12,16,25178624,2,1,1,0,28341
b986a3c2db753a006718592c7689590bc842c6c6,1,Aravindan Vijayan,2017-02-21 16:17:13-08:00,['ef0ae8bfdbe515851ddcec3139db0250b1cc62df'],28,475,503,25179127,11,0,0.533333333,1,28343
65d901756c2b3bfb621bfd028094ffdbdcfca2fa,1,Xi Wang,2017-02-21 16:34:21-08:00,['d7e9ef21dfa7bca1b91d94398b615f41908983c7'],2,5,7,25179134,1,1,1,1,28343
4ff93b0a291745ce18d36a73b1698fdea55539a3,0,Xi Wang,2017-02-21 16:55:36-08:00,"['b986a3c2db753a006718592c7689590bc842c6c6', '65d901756c2b3bfb621bfd028094ffdbdcfca2fa']",760,1692,2452,25181586,32,,,,28343
d5cbe1940552c1ac6ed142b0d36bc84f45ba3c7f,1,Robert Levas,2017-02-21 21:16:44-05:00,['4ff93b0a291745ce18d36a73b1698fdea55539a3'],7,215,222,25181808,3,0.287128713,0.98019802,1,28344
bc4b8bcedb8f4de66c7e7ccf148653fcc53417f7,1,Alex Antonenko,2017-02-22 04:33:34+02:00,['d5cbe1940552c1ac6ed142b0d36bc84f45ba3c7f'],0,2,2,25181810,2,,,,28344
3e76e47c5430704723801819e7f5b59759242e61,1,Dipayan Bhowmick,2017-02-22 12:24:46+05:18,['bc4b8bcedb8f4de66c7e7ccf148653fcc53417f7'],1393,88,1481,25183291,23,0.271386431,0.078171091,0.212389381,28344
4e7bf34a7435148a8ab96fb9e46059189355edf8,1,Dipayan Bhowmick,2017-02-22 12:31:08+05:18,['3e76e47c5430704723801819e7f5b59759242e61'],2,7,9,25183300,3,1,1,1,28344
c655d7c08edd82fa5de1a009a7af399dd4b09eb7,1,Dipayan Bhowmick,2017-02-22 12:43:36+05:18,['4e7bf34a7435148a8ab96fb9e46059189355edf8'],1,4,5,25183305,1,1,1,1,28344
0ffa89532854e8760f543acd3434952eebc24f8c,1,pallavkul,2017-02-22 13:03:35+05:18,['c655d7c08edd82fa5de1a009a7af399dd4b09eb7'],12,15,27,25183332,4,0,0,1,28344
1a6267597d5c445dc9bb12e4cfead5073cf134cf,0,Oleg Nechiporenko,2017-02-22 10:23:00+02:00,['0ffa89532854e8760f543acd3434952eebc24f8c'],0,4,4,25183336,1,,,,28344
df227658c64ed9068abc4cd7af8c03aa74b5c60e,0,Miklos Gergely,2017-02-22 10:19:41+01:00,['1a6267597d5c445dc9bb12e4cfead5073cf134cf'],0,600,600,25183936,1,,,,28345
6baf387596906005391746bd41b60283b9aed980,0,Miklos Gergely,2017-02-22 10:22:03+01:00,['df227658c64ed9068abc4cd7af8c03aa74b5c60e'],14,74,88,25184024,4,0,0,1,28345
efbd66b56fa363462ff70660ec1d487457120337,0,Lisnichenko Dmitro,2017-02-22 12:54:55+02:00,['6baf387596906005391746bd41b60283b9aed980'],3,3,6,25184030,2,,,,28345
f080bd6cb25d33a76265ee7d21c6e98788ef7423,1,pallavkul,2017-02-22 16:58:07+05:18,['efbd66b56fa363462ff70660ec1d487457120337'],7,111,118,25184148,6,0.868852459,0.918032787,0.852459016,28346
813841f871525a5e78a4fd551ab77ddb8c67e5b2,0,Oleg Nechiporenko,2017-02-22 13:44:32+02:00,['f080bd6cb25d33a76265ee7d21c6e98788ef7423'],0,59,59,25184207,2,0.366666667,0.366666667,1,28346
309dbd7581bb7826f80a21e046721ee30acc27fb,1,oleewere,2017-02-22 12:45:56+01:00,['813841f871525a5e78a4fd551ab77ddb8c67e5b2'],7,58,65,25184272,1,0,0.897435897,0.564102564,28346
b789b7c102c164b3fab3275cebf33148a5755ee0,1,Lisnichenko Dmitro,2017-02-22 13:52:17+02:00,['309dbd7581bb7826f80a21e046721ee30acc27fb'],20,226,246,25184518,12,1,0,0,28346
45b423b7be199115f36cad828fd77a45fed21b63,1,Sandor Magyari,2017-02-22 13:03:24+01:00,['b789b7c102c164b3fab3275cebf33148a5755ee0'],0,3,3,25184521,1,0,1,1,28346
569f5661d4223f6eaf4d82f0771c9cac19883cfb,1,Miklos Gergely,2017-02-22 13:17:03+01:00,['45b423b7be199115f36cad828fd77a45fed21b63'],0,12,12,25184533,2,0,1,1,28346
7cc2a20525881b329abe50d98ce871b6c9753742,1,pallavkul,2017-02-22 18:59:22+05:18,['569f5661d4223f6eaf4d82f0771c9cac19883cfb'],15,29,44,25184577,2,0.058823529,1,1,28346
a6f3420e71d4c28a22023e7c3b009f0bc5503acc,1,pallavkul,2017-02-22 19:36:18+05:18,['7cc2a20525881b329abe50d98ce871b6c9753742'],2,2,4,25184581,2,,,,28346
0b6d1cd3b311389e8d385ab782ae78a65b14ef8b,1,ababiichuk,2017-02-22 20:19:25+02:00,['a6f3420e71d4c28a22023e7c3b009f0bc5503acc'],115,86,201,25184782,18,0,0,0,28346
f7acf8edd4566ddf9f34419a6b88cf06d9136668,1,Sumit Mohanty,2017-02-22 15:53:54-08:00,['0b6d1cd3b311389e8d385ab782ae78a65b14ef8b'],11,12,23,25184805,5,,,,28346
e9c943905721ef431dc09b45abaf4a05312d4fe5,1,Alejandro Fernandez,2017-02-22 17:21:13-08:00,['f7acf8edd4566ddf9f34419a6b88cf06d9136668'],4,4,8,25184813,1,,,,28346
f936bcfdb3cc6451bd1fa82e0d6e98f2aec285df,1,Richard Zang,2017-02-22 18:20:53-08:00,['e9c943905721ef431dc09b45abaf4a05312d4fe5'],4,8,12,25184825,1,1,1,1,28346
ba470c186875be371152e2a3ce37fb3c9a383f5a,1,Gaurav Nagar,2017-02-23 10:46:02+05:18,['f936bcfdb3cc6451bd1fa82e0d6e98f2aec285df'],9,36,45,25184870,2,1,1,1,28346
5186db06659916148229fbd02aa742b7caeaa2f9,0,Gaurav Nagar,2017-02-23 11:07:36+05:18,['ba470c186875be371152e2a3ce37fb3c9a383f5a'],2,10,12,25184882,3,1,1,1,28346
03d0587e2e29d7f9b28844b7dfe2042813947dd6,1,pallavkul,2017-02-23 11:28:28+05:18,['5186db06659916148229fbd02aa742b7caeaa2f9'],3,17,20,25184902,2,1,1,1,28346
82230d60a8d417809e967e55983c37a8553258a0,1,pallavkul,2017-02-23 12:19:10+05:18,['03d0587e2e29d7f9b28844b7dfe2042813947dd6'],3,6,9,25184911,2,0,0,0,28346
9c6c20f23dc077d52add8cef1ac70c6add89b3f7,0,pallavkul,2017-02-23 12:29:43+05:18,['82230d60a8d417809e967e55983c37a8553258a0'],5,6,11,25184922,3,0,0,0,28346
112873287bd386dca5c54f8559c7b8c8a2701471,1,oleewere,2017-02-23 10:37:32+01:00,['9c6c20f23dc077d52add8cef1ac70c6add89b3f7'],7,6,13,25184935,1,,,,28346
83cdcea5fb2c5bee698b2f070489a39ed4b3df40,0,Attila Doroszlai,2017-02-23 11:14:03+01:00,['112873287bd386dca5c54f8559c7b8c8a2701471'],4,19,23,25184958,4,1,1,1,28346
aeb5d4e550cecd7ee93aa968669c5e54ae2226dc,0,Andrew Onishuk,2017-02-23 13:37:50+02:00,['83cdcea5fb2c5bee698b2f070489a39ed4b3df40'],1,2,3,25184961,2,,,,28346
70f23c07058b700a37b046e8412217b11a661aa4,1,Lisnichenko Dmitro,2017-02-23 15:10:33+02:00,['aeb5d4e550cecd7ee93aa968669c5e54ae2226dc'],3,22,25,25184986,3,0.909090909,0.909090909,1,28346
6572b16e8f721cfabba4b6cdb10d52e6f4f9e382,1,Gaurav Nagar,2017-02-23 18:50:13+05:18,['70f23c07058b700a37b046e8412217b11a661aa4'],3,32,35,25185021,4,0.857142857,0.952380952,1,28346
98f40e324ed5594384efc8dc8e43fae9ff0a9d34,1,Aleksandr Kovalenko,2017-02-23 15:32:45+02:00,['6572b16e8f721cfabba4b6cdb10d52e6f4f9e382'],5,9,14,25185035,1,,,,28346
e1cb3b1e2a01c04bac96ea3b5b5957848eec721a,0,Gaurav Nagar,2017-02-23 19:00:34+05:18,['98f40e324ed5594384efc8dc8e43fae9ff0a9d34'],5,22,27,25185062,3,1,1,1,28346
890ad905df0ae35c4f3d7ea6c4335fefdb05190b,0,Gaurav Nagar,2017-02-23 19:02:35+05:18,['e1cb3b1e2a01c04bac96ea3b5b5957848eec721a'],378,330,708,25185770,13,1,0,1,28346
5efa6531d226fe80f717a8997b7a2970cda1ef7c,0,Jonathan Hurley,2017-02-23 08:48:46-05:00,['890ad905df0ae35c4f3d7ea6c4335fefdb05190b'],235,71,306,25186076,14,0,0,0.333333333,28346
986e7a9be5302ae557c0fc0e82027de4bad6fd43,1,Gaurav Nagar,2017-02-23 19:08:56+05:18,['5efa6531d226fe80f717a8997b7a2970cda1ef7c'],330,378,708,25186784,13,0,1,0,28346
bb7b83f2bb1b6af2dad38e98ffdcddda13e1cb2b,1,Dmytro Sen,2017-02-23 15:52:21+02:00,['986e7a9be5302ae557c0fc0e82027de4bad6fd43'],13,38,51,25186835,6,0.954545455,0.954545455,0.318181818,28346
9fdeec1afecf1983dfdb633bca0ab07b15c6d24c,1,Gaurav Nagar,2017-02-23 19:12:31+05:18,['bb7b83f2bb1b6af2dad38e98ffdcddda13e1cb2b'],378,648,1026,25187861,19,1,0.038461538,1,28352
b68bb74c47ee4a824d1b9d4fc243db31d185eb41,0,Miklos Gergely,2017-02-23 15:08:33+01:00,['9fdeec1afecf1983dfdb633bca0ab07b15c6d24c'],8,42,50,25187911,4,0.2,1,1,28352
307c8ad26cdefa08e0dfc9454655c16dc603d1ff,1,Denys Buzhor,2017-02-23 16:32:16+02:00,['b68bb74c47ee4a824d1b9d4fc243db31d185eb41'],50,213,263,25188174,19,0.578947368,0.447368421,0.973684211,28355
56eb5a7590499c6e02d2f0688ad85eff47fbcc96,0,ababiichuk,2017-02-23 18:08:11+02:00,['307c8ad26cdefa08e0dfc9454655c16dc603d1ff'],0,0,0,25188174,1,,,,28355
cb030a4e5b829d5adbfbffbb1c02aa94caa6d72b,1,Alex Antonenko,2017-02-23 19:14:49+02:00,['56eb5a7590499c6e02d2f0688ad85eff47fbcc96'],47,44,91,25188265,9,1,1,0,28355
fc37b7376bc65de3aec93accd0a57cf7807ef98f,1,Sumit Mohanty,2017-02-23 14:00:17-08:00,['cb030a4e5b829d5adbfbffbb1c02aa94caa6d72b'],1,4,5,25188270,1,,,,28355
c2c72b9da289bf0d172ee103eb0c337a9ffda1df,1,Aravindan Vijayan,2017-02-23 15:39:36-08:00,['fc37b7376bc65de3aec93accd0a57cf7807ef98f'],109,189,298,25188568,7,0.307692308,0,0.769230769,28355
3c939bd233439028e31e99daf0ed4141f81350af,1,Richard Zang,2017-02-23 15:58:36-08:00,['c2c72b9da289bf0d172ee103eb0c337a9ffda1df'],10,8,18,25188586,3,,,,28355
7bbc678c566f2e72d6c43b7602dd7abd48aedecb,1,Vitaly Brodetskyi,2017-02-24 01:04:32+02:00,['3c939bd233439028e31e99daf0ed4141f81350af'],0,23,23,25188609,7,,,,28355
1f41cc07b2f9ad2f40de37c3c73d9eff58a68fd7,0,Miklos Gergely,2017-02-24 01:16:05+01:00,['7bbc678c566f2e72d6c43b7602dd7abd48aedecb'],42,8,50,25188659,4,0.8,0,0,28355
fc5cbc6e3c806a3e7193dff17093db8d1367fb74,1,Miklos Gergely,2017-02-24 01:16:44+01:00,['1f41cc07b2f9ad2f40de37c3c73d9eff58a68fd7'],8,42,50,25188709,4,0.2,1,1,28355
ef355ae0d262dc16c8897d89110b3312653e0e68,1,Vitaly Brodetskyi,2017-02-24 01:24:24+02:00,['fc5cbc6e3c806a3e7193dff17093db8d1367fb74'],10,45,55,25188764,4,1,1,1,28356
cce9489c2ed551940c70e9003fa421d4c9880e38,0,Swapan Shridhar,2017-02-23 16:46:20-08:00,['ef355ae0d262dc16c8897d89110b3312653e0e68'],0,90,90,25188854,6,,,,28357
9c5f097a10c19e38fa4920067afb351449c1d5e4,1,Xi Wang,2017-02-23 17:29:31-08:00,['cce9489c2ed551940c70e9003fa421d4c9880e38'],21,13,34,25188888,5,,,,28357
7d1e04b39709df51a94343b1ee699a4b002ac3d3,1,Mugdha Varadkar,2017-02-24 10:04:24+05:18,['9c5f097a10c19e38fa4920067afb351449c1d5e4'],2,8,10,25188898,1,,,,28357
14a99627bae2eeb108cfd1b45b953d3c667e8006,1,Mugdha Varadkar,2017-02-24 10:10:24+05:18,['7d1e04b39709df51a94343b1ee699a4b002ac3d3'],7,867,874,25189772,14,0,0.7796875,0.8078125,28357
043d6c06ca558b2e6abeb100126c92535327ed84,0,Swapan Shridhar,2017-02-24 01:15:12-08:00,['14a99627bae2eeb108cfd1b45b953d3c667e8006'],90,0,90,25189862,6,,,,28357
19da5823c8adc8cd18048040c93f43941c0e568f,0,Eugene Chekanskiy,2017-02-24 11:18:33+02:00,['043d6c06ca558b2e6abeb100126c92535327ed84'],8,199,207,25190069,9,0,0,1,28357
daf876665a57966d58c1ed6aa0f53b14a81265c6,0,Attila Doroszlai,2017-02-24 10:24:08+01:00,['19da5823c8adc8cd18048040c93f43941c0e568f'],2,2,4,25190073,1,,,,28357
b82d5935957b975ffc301d0a11b1b992691a5db4,1,Gaurav Nagar,2017-02-24 16:42:28+05:18,['daf876665a57966d58c1ed6aa0f53b14a81265c6'],95,237,332,25190405,11,1,0.861111111,0.694444444,28358
a2ea1f9769f3c49652064b54b3e71084606a3bcd,1,Gaurav Nagar,2017-02-24 16:43:46+05:18,['b82d5935957b975ffc301d0a11b1b992691a5db4'],2,3,5,25190410,2,1,1,1,28358
3952c83ee1ae01e71d2f368df5a6ce7369af3bac,1,pallavkul,2017-02-24 17:29:58+05:18,['a2ea1f9769f3c49652064b54b3e71084606a3bcd'],1,1,2,25190412,1,,,,28358
d55dfc27f56a673364fa38e90c47d767f489dd72,0,Oleg Nechiporenko,2017-02-24 14:16:41+02:00,['3952c83ee1ae01e71d2f368df5a6ce7369af3bac'],0,4,4,25190416,1,1,1,1,28358
6277a648c44e8f5540adf569cff10d494d3c701c,1,Dmytro Sen,2017-02-24 14:39:27+02:00,['d55dfc27f56a673364fa38e90c47d767f489dd72'],11,57,68,25190484,2,0.555555556,0.888888889,0.444444444,28358
b511b5b22d02b056d98aac675c9e4fa67866cfa4,1,Andrii Tkach,2017-02-24 14:56:29+02:00,['6277a648c44e8f5540adf569cff10d494d3c701c'],104,2027,2131,25192615,17,0.861614498,1,1,28365
1d3dce26190cd9105e47d1c18472075fdda75ef6,1,Jonathan Hurley,2017-02-24 08:51:54-05:00,['b511b5b22d02b056d98aac675c9e4fa67866cfa4'],16,110,126,25192741,2,0.413043478,0.97826087,0.434782609,28365
da9086dcaaf161a15e58bfc5fe44c338da18078d,1,pallavkul,2017-02-24 19:22:17+05:18,['1d3dce26190cd9105e47d1c18472075fdda75ef6'],48,160,208,25192949,6,0.545454545,0.590909091,0.636363636,28365
353a076c8bf65a911f29b1f908e60d011459ffe0,1,Nate Cole,2017-02-24 09:18:46-05:00,"['0c3478b1cc98a3738bca05d12a38be87e8711f5b', 'cb030a4e5b829d5adbfbffbb1c02aa94caa6d72b']",4418,5837,10255,25203204,250,,,,28365
bc20fd1b5fd5df2bce3c7a8315d87d6fecf22f9e,0,Nate Cole,2017-02-24 09:24:40-05:00,['da9086dcaaf161a15e58bfc5fe44c338da18078d'],1,9,10,25203214,2,0,0.666666667,1,28365
0fd2f9f6fee9afd96769a62a3f8b3b798db3255a,0,Nitiraj Singh Rathore,2017-02-24 20:15:37+05:18,['bc20fd1b5fd5df2bce3c7a8315d87d6fecf22f9e'],8,19,27,25203241,3,,,,28365
d797d99f1edbdf01c82635128ce1ff1c2fa875f3,1,pallavkul,2017-02-24 20:20:44+05:18,['0fd2f9f6fee9afd96769a62a3f8b3b798db3255a'],55,59,114,25203355,7,0,0,0,28365
8e549208c56dcb2773330131ae656a309f95e9ef,0,Nate Cole,2017-02-24 11:11:40-05:00,['d797d99f1edbdf01c82635128ce1ff1c2fa875f3'],38,38,76,25203431,1,,,,28365
15f763e24ac46e6748d56bd422a5ee12f0f0874e,1,Dipayan Bhowmick,2017-02-24 21:59:21+05:18,['8e549208c56dcb2773330131ae656a309f95e9ef'],1,6,7,25203438,2,1,1,1,28365
42d3305db3fbf090eb19ab538a462305df88cbc2,1,Sumit Mohanty,2017-02-24 08:43:43-08:00,['15f763e24ac46e6748d56bd422a5ee12f0f0874e'],24,470,494,25203932,18,0.176744186,0.56744186,0.530232558,28367
869bc63861aa2beaf82b15aee447d104d0f3d213,1,Dipayan Bhowmick,2017-02-24 22:12:40+05:18,['42d3305db3fbf090eb19ab538a462305df88cbc2'],42,266,308,25204240,13,0.941176471,0.941176471,0.941176471,28376
2cd4a3f337fa51f0c55dbe76c9c39ae48a45a834,0,Gaurav Nagar,2017-02-24 22:25:35+05:18,['869bc63861aa2beaf82b15aee447d104d0f3d213'],18,48,66,25204306,4,0.222222222,0.222222222,1,28376
dfdd00fd0b073de7b7de6556a120ddc7f4103be3,0,Gaurav Nagar,2017-02-24 22:27:13+05:18,['2cd4a3f337fa51f0c55dbe76c9c39ae48a45a834'],51,30,81,25204387,4,1,1,1,28376
378a49e333a5aee9eae11814f05455105faa95e7,0,Dmytro Sen,2017-02-24 19:14:42+02:00,['dfdd00fd0b073de7b7de6556a120ddc7f4103be3'],2,2,4,25204391,1,,,,28376
f3877c13200e9f8000fe70d0b799112e205715bc,1,Gaurav Nagar,2017-02-24 22:33:30+05:18,['378a49e333a5aee9eae11814f05455105faa95e7'],4,24,28,25204419,2,1,1,1,28376
1d7ae2430a4ca9735336fb86318c23d1584d8f1c,1,Gaurav Nagar,2017-02-24 22:35:46+05:18,['f3877c13200e9f8000fe70d0b799112e205715bc'],18,127,145,25204564,6,1,1,0.857142857,28379
3809bdc6d5fe367c2c3207812ee42856214db8de,0,Jayush Luniya,2017-02-24 10:11:51-08:00,['1d7ae2430a4ca9735336fb86318c23d1584d8f1c'],2,2,4,25204568,1,,,,28379
628c20df61ec60c76a9b064c260d2411d1dade8b,0,Yusaku Sako,2017-02-24 12:22:09-08:00,['3809bdc6d5fe367c2c3207812ee42856214db8de'],0,12,12,25204580,1,,,,28379
e02969e17385dd5d53b0572a3eadac2cbfd24adb,1,Aravindan Vijayan,2017-02-24 12:55:49-08:00,['628c20df61ec60c76a9b064c260d2411d1dade8b'],2,12,14,25204594,1,0,0,1,28379
424cf658089646672ac0559ab045887f35a98205,1,Richard Zang,2017-02-24 14:07:58-08:00,['e02969e17385dd5d53b0572a3eadac2cbfd24adb'],1,1,2,25204596,1,,,,28379
f2e3b132ff72dece11766205cd32609397df8f7a,1,Yusaku Sako,2017-02-24 15:00:39-08:00,['424cf658089646672ac0559ab045887f35a98205'],2,3,5,25204601,1,,,,28379
424949b95cafead9754cd87ea1a379f21995b5af,1,Richard Zang,2017-02-24 15:22:27-08:00,['f2e3b132ff72dece11766205cd32609397df8f7a'],47,97,144,25204745,8,0,1,0.986111111,28379
15e3c48890413bcacbe17075782787ae8b754bad,0,Bob Nettleton,2017-02-24 19:32:54-05:00,['424949b95cafead9754cd87ea1a379f21995b5af'],2,22,24,25204769,2,0.666666667,0.666666667,0,28379
d31d1f9982e7da25bafabbf3dfae1aad63464974,1,Sumit Mohanty,2017-02-24 18:40:46-08:00,['15e3c48890413bcacbe17075782787ae8b754bad'],105,331,436,25205205,19,0.18705036,0.676258993,0.892086331,28379
e7961091f4bbcb10f4cfb675786c9bcb6e768ca8,1,"Toader, Sebastian",2017-02-25 10:23:37+01:00,['d31d1f9982e7da25bafabbf3dfae1aad63464974'],0,12,12,25205217,2,,,,28379
11a7651c8f06c05155ae0a5de249f0906bf370a4,0,"Toader, Sebastian",2017-02-25 12:42:31+01:00,['e7961091f4bbcb10f4cfb675786c9bcb6e768ca8'],46,98,144,25205361,3,1,1,0.285714286,28379
fb1c95f71db72e2f093157748d0a3cc8caf9ccd4,0,ababiichuk,2017-02-25 14:22:54+02:00,['11a7651c8f06c05155ae0a5de249f0906bf370a4'],2,1,3,25205364,1,,,,28379
341ff3ec678e68115643570c5ce1bd086782d431,0,Vitaly Brodetskyi,2017-02-25 13:56:48+02:00,['fb1c95f71db72e2f093157748d0a3cc8caf9ccd4'],1,1,2,25205366,1,,,,28379
0beb353a01931306081b6566f98421c55f116c17,0,ababiichuk,2017-02-25 15:13:59+02:00,['341ff3ec678e68115643570c5ce1bd086782d431'],4,2,6,25205372,3,,,,28379
a8d1efc76d799ff32304164406023efc3fc209f5,1,oleewere,2017-02-25 20:54:08+01:00,['0beb353a01931306081b6566f98421c55f116c17'],5,404,409,25205781,8,0,0.605042017,0.857142857,28380
eb00261b807ec32e8a11d28f1deb282a2faf7ddb,0,Myroslav Papirkovskyi,2017-02-26 14:04:07+02:00,['a8d1efc76d799ff32304164406023efc3fc209f5'],2,4,6,25205787,1,,,,28380
2fc354e5cb0606622b869317ac98babc13d91fd4,0,Aleksandr Kovalenko,2017-02-27 00:27:13+02:00,['eb00261b807ec32e8a11d28f1deb282a2faf7ddb'],1,4,5,25205792,1,1,1,1,28380
eb784aaa1f21f98982a405ab2da5f0e659f96102,1,Miklos Gergely,2017-02-27 10:30:21+01:00,['2fc354e5cb0606622b869317ac98babc13d91fd4'],10,15,25,25205817,4,0,1,0,28380
3a7e5a2f694c8c7375a50ca05832aabb17136b33,0,Oleg Nechiporenko,2017-02-27 12:28:40+02:00,['eb784aaa1f21f98982a405ab2da5f0e659f96102'],3,9,12,25205829,4,1,1,0,28380
4b75171643ac5690c582edbf8a3123b8635f8644,0,Renjith Kamath,2017-02-27 15:53:47+05:18,['3a7e5a2f694c8c7375a50ca05832aabb17136b33'],0,4,4,25205833,1,,,,28380
454e5a1edd4ea34edc730fcb4865538b00311707,1,Attila Doroszlai,2017-02-27 13:20:27+01:00,['4b75171643ac5690c582edbf8a3123b8635f8644'],1,1,2,25205835,1,,,,28380
d4c668c7bb182b8e5e2e826b0864c80d092330c5,0,Oleg Nechiporenko,2017-02-27 14:34:08+02:00,['454e5a1edd4ea34edc730fcb4865538b00311707'],8,17,25,25205860,2,0,1,1,28380
336e8e0a705f8c36219c3dc03ff255a677c17601,1,Gaurav Nagar,2017-02-27 18:22:08+05:18,['d4c668c7bb182b8e5e2e826b0864c80d092330c5'],61,59,120,25205980,21,1,0.461538462,0.538461538,28380
9ef9bd501a13d32b7033803ad3dca433e1fa98a0,0,Andrew Onishuk,2017-02-27 16:49:09+02:00,['336e8e0a705f8c36219c3dc03ff255a677c17601'],1,10,11,25205991,2,0,0,0,28380
87d629b5343d23890662ea6813c6be393d3c65fd,0,ababiichuk,2017-02-27 18:00:47+02:00,['9ef9bd501a13d32b7033803ad3dca433e1fa98a0'],19,326,345,25206336,2,0.655737705,0.93442623,1,28380
10c099c17a031e3e0b9f65a4dcc506daf123efdd,0,Alex Antonenko,2017-02-27 20:06:59+02:00,['87d629b5343d23890662ea6813c6be393d3c65fd'],5,14,19,25206355,4,,,,28380
8b4073f53e54f738d944e05c386905f50faaae7f,1,Aleksandr Kovalenko,2017-02-27 21:43:37+02:00,['10c099c17a031e3e0b9f65a4dcc506daf123efdd'],3,6,9,25206364,2,,,,28380
ee3d1a092872f5f1e7c45135003dd149e28d6905,1,Sumit Mohanty,2017-02-27 11:44:46-08:00,['8b4073f53e54f738d944e05c386905f50faaae7f'],3,7,10,25206374,2,,,,28380
236ae87a1f7ddad969a00900864395edf57b732f,1,Sumit Mohanty,2017-02-27 11:47:54-08:00,['ee3d1a092872f5f1e7c45135003dd149e28d6905'],0,5,5,25206379,1,,,,28380
9112148e597baedaab1dea15c8da299dee6f63c7,1,Robert Levas,2017-02-27 14:51:54-05:00,['236ae87a1f7ddad969a00900864395edf57b732f'],91,554,645,25207024,23,0.39869281,0.503267974,0.908496732,28383
f5f9b760be9c37c4bac4758afedd101cddcd00ca,0,Aravindan Vijayan,2017-02-27 17:26:28-08:00,['9112148e597baedaab1dea15c8da299dee6f63c7'],6,21,27,25207051,2,0,0,1,28383
4fff6497087e8bc137c44c866c790c9f92a4fbc1,0,Richard Zang,2017-02-27 18:01:57-08:00,['f5f9b760be9c37c4bac4758afedd101cddcd00ca'],12,14,26,25207077,1,,,,28383
cbfd78cdb7b6534a62e2dff0a5f5ffd4726c82ff,0,Jayush Luniya,2017-02-27 18:07:17-08:00,['4fff6497087e8bc137c44c866c790c9f92a4fbc1'],0,1,1,25207078,1,,,,28383
d7c8aeaab81a8a9cad5911ef0e859f0b5d681e8e,1,Gaurav Nagar,2017-02-28 11:25:20+05:18,['cbfd78cdb7b6534a62e2dff0a5f5ffd4726c82ff'],49,41,90,25207168,4,1,0,0,28383
560b27e9026c1f4149decfc6de4a51733b759401,1,Nitiraj Singh Rathore,2017-02-28 14:54:01+05:18,['d7c8aeaab81a8a9cad5911ef0e859f0b5d681e8e'],134,46,180,25207348,6,,,,28383
924749be0670ffedad0dcdab00166aa80958c141,1,pallavkul,2017-02-28 14:56:16+05:18,['560b27e9026c1f4149decfc6de4a51733b759401'],15,87,102,25207450,3,0.712121212,1,1,28383
b280e846f2d509595c1dbb89f72c95053833220c,1,Attila Doroszlai,2017-02-28 11:24:53+01:00,['924749be0670ffedad0dcdab00166aa80958c141'],2,2,4,25207454,1,,,,28383
44e44ba60de01ea45e88af5386ee84f74478b00e,1,pallavkul,2017-02-28 16:53:21+05:18,['b280e846f2d509595c1dbb89f72c95053833220c'],54,103,157,25207611,5,0.902439024,1,1,28383
a23467bf03ca2fd10aa9183038b59bcd7ad841e0,0,Oleg Nechiporenko,2017-02-28 13:53:34+02:00,['44e44ba60de01ea45e88af5386ee84f74478b00e'],14,6,20,25207631,8,0,0,0,28383
5cf5e31d9e3409d1ed8b71e5573a520ece816cdb,1,pallavkul,2017-02-28 18:15:28+05:18,['a23467bf03ca2fd10aa9183038b59bcd7ad841e0'],8,80,88,25207719,8,1,1,1,28383
d5efb77276443257ef49baaed1994e2204c623bd,1,Andrew Onishuk,2017-02-28 15:07:11+02:00,['5cf5e31d9e3409d1ed8b71e5573a520ece816cdb'],1,8,9,25207728,1,0,0,0,28383
910da3d5d1e3ccff19ba2bb18095e8afa9026ce7,1,Denys Buzhor,2017-02-28 15:23:02+02:00,['d5efb77276443257ef49baaed1994e2204c623bd'],4,72,76,25207804,2,,,,28383
2a4bc9d2e1053c91be732c913bc3020be9a871e7,1,Gaurav Nagar,2017-02-28 18:44:22+05:18,['910da3d5d1e3ccff19ba2bb18095e8afa9026ce7'],10,10,20,25207824,7,,,,28383
ba786d7f07d4b056ffa74b0071eb061c1f7fef5c,1,Gaurav Nagar,2017-02-28 18:45:50+05:18,['2a4bc9d2e1053c91be732c913bc3020be9a871e7'],1,1,2,25207826,1,,,,28383
c405aacf59e242faa3d3941448aeef7da6f94bbc,1,Gaurav Nagar,2017-02-28 18:48:13+05:18,['ba786d7f07d4b056ffa74b0071eb061c1f7fef5c'],0,24,24,25207850,3,0,0.882352941,1,28383
76c1fc2473b311ea25512cbde7019b28f0b47ad9,1,Jonathan Hurley,2017-02-28 08:56:34-05:00,['c405aacf59e242faa3d3941448aeef7da6f94bbc'],20,77,97,25207947,5,0.958333333,0.958333333,1,28383
c5df14f5ea5f1fe9f227131329335488af5f3168,1,Vitaly Brodetskyi,2017-02-28 15:21:09+02:00,['76c1fc2473b311ea25512cbde7019b28f0b47ad9'],18,69,87,25208034,9,0,1,1,28383
be644c57a13a2a8e701d1b1009be2d0decfa08cd,0,Robert Levas,2017-02-28 09:46:12-05:00,['c5df14f5ea5f1fe9f227131329335488af5f3168'],0,1,1,25208035,1,0,1,0,28383
a940b17a57d044b49a3f3b77d4e3b056edf7a28d,1,pallavkul,2017-02-28 21:27:32+05:18,['be644c57a13a2a8e701d1b1009be2d0decfa08cd'],1,1,2,25208037,2,0,1,1,28383
377776813fe448669aaa1274faa61373e96d2d29,1,ababiichuk,2017-02-28 19:07:01+02:00,['a940b17a57d044b49a3f3b77d4e3b056edf7a28d'],1,3,4,25208041,1,,,,28383
eebca68f7f96714d7e0bf160bb789256b1612a18,0,pallavkul,2017-02-28 22:16:48+05:18,['377776813fe448669aaa1274faa61373e96d2d29'],1,1,2,25208043,1,,,,28383
aeb5076ad66692a43af531c7c5377bdb72dc0f37,1,Di Li,2017-02-28 14:55:26-05:00,['eebca68f7f96714d7e0bf160bb789256b1612a18'],2,50,52,25208095,2,0,0.974358974,0.974358974,28383
aa057cb42b08676fac4d4ef75d1b77ad3b6da893,0,Richard Zang,2017-02-28 12:52:12-08:00,['aeb5076ad66692a43af531c7c5377bdb72dc0f37'],27,7,34,25208129,5,0,0,0,28383
7808134f56ccd832b6b3f6bad575671eb0f4bb5b,1,Sumit Mohanty,2017-02-28 16:50:58-08:00,['aa057cb42b08676fac4d4ef75d1b77ad3b6da893'],2,8,10,25208139,1,,,,28383
0ffa4789ad2372859287b8c0264e8b080fd1d8df,1,Dipayan Bhowmick,2017-03-01 11:32:59+05:18,['7808134f56ccd832b6b3f6bad575671eb0f4bb5b'],9,29,38,25208177,2,0.055555556,1,1,28383
4c0690ac5460d64c09bc0799d1a11b02520a0cba,1,Dipayan Bhowmick,2017-03-01 11:41:03+05:18,['0ffa4789ad2372859287b8c0264e8b080fd1d8df'],3,12,15,25208192,1,1,1,1,28383
561f65d573b568db09b842e4c9bb70fc77ae7723,1,Dipayan Bhowmick,2017-03-01 11:49:01+05:18,['4c0690ac5460d64c09bc0799d1a11b02520a0cba'],4,38,42,25208234,6,0.666666667,0.666666667,1,28383
0712ef69fd81611e80273259660ef23d49187334,1,Dipayan Bhowmick,2017-03-01 11:53:37+05:18,['561f65d573b568db09b842e4c9bb70fc77ae7723'],1,8,9,25208243,1,0,1,1,28383
4fb86de568347276c99a5cab739b4cab60f49b24,1,Dipayan Bhowmick,2017-03-01 11:58:14+05:18,['0712ef69fd81611e80273259660ef23d49187334'],12,45,57,25208300,2,0,1,1,28383
04039a6542c6f9cd4d44ead1107aac69dec1e8ff,1,Dipayan Bhowmick,2017-03-01 12:06:11+05:18,['4fb86de568347276c99a5cab739b4cab60f49b24'],3,3,6,25208306,3,,,,28383
df60905a5508036e821deab4b6cd96a038a042ae,1,Renjith Kamath,2017-03-01 12:22:57+05:18,['04039a6542c6f9cd4d44ead1107aac69dec1e8ff'],0,114,114,25208420,3,,,,28385
5f5762c6b57b125868e885c2ce59ca815b6ae44d,1,Gaurav Nagar,2017-03-01 12:50:44+05:18,['df60905a5508036e821deab4b6cd96a038a042ae'],41,46,87,25208507,12,1,1,1,28385
aaec58b73a2a06b748e87e2fff1b5e6bfd9177da,0,Mugdha Varadkar,2017-03-01 13:37:04+05:18,['5f5762c6b57b125868e885c2ce59ca815b6ae44d'],29,6,35,25208542,7,,,,28385
728c0daa656a976b9e16985280fb0d822380342e,1,Gaurav Nagar,2017-03-01 13:56:21+05:18,['aaec58b73a2a06b748e87e2fff1b5e6bfd9177da'],21,143,164,25208706,6,0.16,1,1,28387
890996fa23fc18524a122132f3f90326755acdb7,1,Nitiraj Singh Rathore,2017-03-01 14:37:06+05:18,['728c0daa656a976b9e16985280fb0d822380342e'],2,3,5,25208711,1,0,0,1,28387
bcbc597b7bfa79ae884e2f82eab1f6f6fce022be,0,Oleg Nechiporenko,2017-03-01 12:13:56+02:00,['890996fa23fc18524a122132f3f90326755acdb7'],0,217,217,25208928,2,0.464646465,0.767676768,1,28387
0e3ced141ff9969d0da33c53827b72cfff543f65,0,Gaurav Nagar,2017-03-01 17:05:09+05:18,['bcbc597b7bfa79ae884e2f82eab1f6f6fce022be'],31,43,74,25209002,5,0.6,1,1,28387
99df82fa47df7a7bc55dead563943071adf37a48,1,Gaurav Nagar,2017-03-01 17:07:56+05:18,['0e3ced141ff9969d0da33c53827b72cfff543f65'],40,59,99,25209101,6,0.875,0,0.5,28387
f79a48b2e02e4c5bdfb771bb3fbe32b4fc9e82d5,0,Gaurav Nagar,2017-03-01 17:10:16+05:18,['99df82fa47df7a7bc55dead563943071adf37a48'],2,13,15,25209116,3,1,1,0,28387
266d81c44d2a01600ee2235091c85bee204efa23,0,Attila Doroszlai,2017-03-01 15:35:08+01:00,['f79a48b2e02e4c5bdfb771bb3fbe32b4fc9e82d5'],2,2,4,25209120,2,,,,28387
760be48e9bd21e215f3e0a3a004ae9bd5a383124,1,pallavkul,2017-03-01 21:14:29+05:18,['266d81c44d2a01600ee2235091c85bee204efa23'],30,64,94,25209214,7,1,0.84,0,28387
630ecd58219136a220aeca7901c047fcbd236d04,1,Andrii Tkach,2017-03-01 18:00:02+02:00,['760be48e9bd21e215f3e0a3a004ae9bd5a383124'],15,81,96,25209310,8,0.95,0.6,1,28387
09b97ae696373167c2254b79303dc6ca7be8f106,1,pallavkul,2017-03-01 21:33:09+05:18,['630ecd58219136a220aeca7901c047fcbd236d04'],1,6,7,25209317,1,,,,28387
340d36706f76fe73d02f1cd984a46b8cc955c2be,0,Myroslav Papirkovskyi,2017-03-01 18:34:33+02:00,['09b97ae696373167c2254b79303dc6ca7be8f106'],4,7,11,25209328,1,0,0,0,28387
a72f3dda7992aeb717fbf71401b6f60253054c41,0,Nitiraj Singh Rathore,2017-03-01 22:53:22+05:18,['340d36706f76fe73d02f1cd984a46b8cc955c2be'],11,241,252,25209580,4,0,1,1,28388
8bcc953df901af5926d05c4d901a716c3246937e,1,Nitiraj Singh Rathore,2017-03-01 23:14:14+05:18,['a72f3dda7992aeb717fbf71401b6f60253054c41'],241,11,252,25209832,4,1,0,0,28388
a749f97abbc44217fbb6f8e4868deaf6c4811fab,1,Nitiraj Singh Rathore,2017-03-01 23:18:35+05:18,['8bcc953df901af5926d05c4d901a716c3246937e'],11,242,253,25210085,4,0,1,1,28389
d562216ed7784fd5898668b17ddf80abdbf642b1,1,Nitiraj Singh Rathore,2017-03-01 23:27:55+05:18,['a749f97abbc44217fbb6f8e4868deaf6c4811fab'],12,99,111,25210196,5,0.352941176,0.823529412,0.588235294,28390
8c74cc4d5f7ff8a4bfab6eca55993f53d0aedf4d,0,Sumit Mohanty,2017-03-01 11:07:05-08:00,['d562216ed7784fd5898668b17ddf80abdbf642b1'],2,20,22,25210218,3,,,,28390
2072511fdddeec369dc8ae517c848e9954b8400a,0,Aravindan Vijayan,2017-03-01 11:16:34-08:00,['8c74cc4d5f7ff8a4bfab6eca55993f53d0aedf4d'],13,0,13,25210231,11,,,,28390
baefbcca0b60caac801f3addf0d015df23a5e96d,1,Swapan Shridhar,2017-03-01 12:24:06-08:00,['2072511fdddeec369dc8ae517c848e9954b8400a'],50,117,167,25210398,8,0,0,0.272727273,28390
f6bc79797ee3f10fc3c9fbda51fee1c54bab04cd,0,Nate Cole,2017-03-01 15:38:06-05:00,"['353a076c8bf65a911f29b1f908e60d011459ffe0', 'baefbcca0b60caac801f3addf0d015df23a5e96d']",1804,9186,10990,25221388,396,,,,28390
a17e6d4405d8405bc602cdfa9d3a4b2e6da86a58,0,Denys Buzhor,2017-03-01 23:25:09+02:00,['baefbcca0b60caac801f3addf0d015df23a5e96d'],13,12,25,25221413,1,0,1,1,28390
54374e9781e3d8cda52f36ecf328546f9fc9c69d,0,Jayush Luniya,2017-03-01 14:41:18-08:00,['a17e6d4405d8405bc602cdfa9d3a4b2e6da86a58'],1,1,2,25221415,1,,,,28390
2ceeae8503a6e051f9e7e69801ad4bd9d229ea78,1,Swapan Shridhar,2017-03-01 15:07:38-08:00,['54374e9781e3d8cda52f36ecf328546f9fc9c69d'],0,3,3,25221418,1,,,,28390
74233a1bf29418e820bcccc0b85b70c8b024dfd9,1,Sumit Mohanty,2017-03-01 16:56:55-08:00,['2ceeae8503a6e051f9e7e69801ad4bd9d229ea78'],20,2,22,25221440,3,,,,28390
1e8b7748323a43abd4e743dedd2708ceecb40386,1,Sumit Mohanty,2017-03-01 16:57:35-08:00,['74233a1bf29418e820bcccc0b85b70c8b024dfd9'],2,20,22,25221462,3,,,,28390
e90f7edf2e019b86ef194399115a33ab70c9643a,1,Nitiraj Singh Rathore,2017-03-02 09:43:41+05:18,['1e8b7748323a43abd4e743dedd2708ceecb40386'],24,29,53,25221515,2,1,1,1,28390
7cf7fcf556bed2ecc765828a9e2954908fdaf8a8,0,Jayush Luniya,2017-03-01 22:52:51-08:00,['e90f7edf2e019b86ef194399115a33ab70c9643a'],4,4,8,25221523,2,,,,28390
ac323d0dc742cf5b0abd60ab3d66a8cab29d848e,0,Gaurav Nagar,2017-03-02 19:12:44+05:18,['7cf7fcf556bed2ecc765828a9e2954908fdaf8a8'],2,2,4,25221527,1,,,,28390
453a594f0140e62dee338ad87bce3e81ba25c8bf,0,Gaurav Nagar,2017-03-02 19:13:53+05:18,['ac323d0dc742cf5b0abd60ab3d66a8cab29d848e'],1,1,2,25221529,1,,,,28390
e1e28c6beb474a0a66a478c50d95889206929c20,0,Jonathan Hurley,2017-03-02 10:58:13-05:00,['453a594f0140e62dee338ad87bce3e81ba25c8bf'],124,105,229,25221758,8,1,0,0,28390
843c5f97c16a0adbca9ec2ce9c5d112acce89334,1,Andrii Tkach,2017-03-02 18:18:49+02:00,['e1e28c6beb474a0a66a478c50d95889206929c20'],1,5,6,25221764,2,1,1,0,28390
f8fe522b95166f18b93135a7b8cd7ff24d1f0fd9,0,Jonathan Hurley,2017-03-02 11:54:40-05:00,['843c5f97c16a0adbca9ec2ce9c5d112acce89334'],6,5,11,25221775,1,,,,28390
d481b788b6f819280b849c015eb42acc2e3d16b3,1,Eugene Chekanskiy,2017-03-02 19:35:45+02:00,['f8fe522b95166f18b93135a7b8cd7ff24d1f0fd9'],10,226,236,25222011,3,0,0.1875,1,28390
5ab46f0cca5cb2dc6250f44ebe2a3603435706fe,1,Sandor Magyari,2017-03-02 18:58:01+01:00,['d481b788b6f819280b849c015eb42acc2e3d16b3'],266,616,882,25222893,25,1,0.923076923,0.576923077,28399
3e648bb07b58216a8ddf2f2a41980b294cdc2c9d,1,pallavkul,2017-03-02 23:32:23+05:18,['5ab46f0cca5cb2dc6250f44ebe2a3603435706fe'],8,6,14,25222907,1,,,,28399
ef96465fa51f7cdf469cc1411bcf92250017145a,0,Nate Cole,2017-03-02 13:41:37-05:00,"['f6bc79797ee3f10fc3c9fbda51fee1c54bab04cd', '3e648bb07b58216a8ddf2f2a41980b294cdc2c9d']",461,1016,1477,25224384,50,,,,28399
f00d413e7328492c47ded23535d3e9d37cb1f839,0,Sumit Mohanty,2017-03-02 10:49:28-08:00,['3e648bb07b58216a8ddf2f2a41980b294cdc2c9d'],2,0,2,25224386,2,0,0,0,28399
c957cd2651e0ffd731e2d1d86395dcb79beef659,0,Andrii Tkach,2017-03-02 21:19:07+02:00,['f00d413e7328492c47ded23535d3e9d37cb1f839'],1,1,2,25224388,1,,,,28399
8e6c3212a4f1c874083c6c803afe253eaa4a07e1,0,Sumit Mohanty,2017-03-02 12:32:27-08:00,['c957cd2651e0ffd731e2d1d86395dcb79beef659'],2,3,5,25224393,3,,,,28399
fc8128b0de0a97c3c8ef9e7064776a5f0030ae6a,1,Swapan Shridhar,2017-03-02 13:26:38-08:00,['8e6c3212a4f1c874083c6c803afe253eaa4a07e1'],35,55,90,25224483,1,0,0,0,28399
74d33276c9e1672b70edd2ba18bfaa668ba2c88d,0,Nate Cole,2017-03-02 16:56:36-05:00,['fc8128b0de0a97c3c8ef9e7064776a5f0030ae6a'],1,9,10,25224493,2,1,1,1,28399
7e2eb293def46ee172c05471bc7fc6954eafd98b,1,Miklos Gergely,2017-03-03 01:38:11+01:00,['74d33276c9e1672b70edd2ba18bfaa668ba2c88d'],6,9,15,25224508,2,0,0,1,28399
1142b526195feced7b42c82119220e065d56e24b,1,Swapan Shridhar,2017-03-02 17:19:33-08:00,['7e2eb293def46ee172c05471bc7fc6954eafd98b'],17,45,62,25224570,3,0,0.75,0.5,28399
5aae5d0276a7d4d54922794acaed2828049a446c,1,Sumit Mohanty,2017-03-02 17:48:26-08:00,['1142b526195feced7b42c82119220e065d56e24b'],1,8,9,25224579,1,,,,28399
4667e5fde179719e336ef68cd9283425cf0cea85,0,Sumit Mohanty,2017-03-02 19:30:03-08:00,['5aae5d0276a7d4d54922794acaed2828049a446c'],0,8,8,25224587,1,,,,28399
69816f91037d4bc0d8e369e3a943340128df6e01,0,Jonathan Hurley,2017-03-02 23:20:24-05:00,['4667e5fde179719e336ef68cd9283425cf0cea85'],1,1,2,25224589,1,,,,28399
56af5741fa0fb7398438fe5bac2cb207c0f93df5,0,Mugdha Varadkar,2017-03-03 10:38:24+05:18,['69816f91037d4bc0d8e369e3a943340128df6e01'],5,52,57,25224646,3,0,0.56097561,0.56097561,28399
aebe216d0dd54a1104337bbdd93495bef9a9a461,1,"Toader, Sebastian",2017-03-03 10:26:44+01:00,['56af5741fa0fb7398438fe5bac2cb207c0f93df5'],2,125,127,25224773,2,0,1,1,28399
0e4819ae7b45fc659067b83d1cba0f97435528bd,1,Myroslav Papirkovskyi,2017-03-03 11:45:25+02:00,['aebe216d0dd54a1104337bbdd93495bef9a9a461'],59,37,96,25224869,4,1,1,0.823529412,28399
07076bd769c0ce73430af9b79f77b0d021648046,1,Attila Doroszlai,2017-03-03 11:12:41+01:00,['0e4819ae7b45fc659067b83d1cba0f97435528bd'],0,2,2,25224871,1,1,1,1,28399
b624ed6d4002c79143a4c34fc18bed9df965d3c7,1,Oleg Nechiporenko,2017-03-03 13:32:59+02:00,['07076bd769c0ce73430af9b79f77b0d021648046'],7,23,30,25224901,5,0,0,0.5,28399
59504528b771932f6008be57cc6c74f772d52be7,0,Myroslav Papirkovskyi,2017-03-03 15:23:47+02:00,['b624ed6d4002c79143a4c34fc18bed9df965d3c7'],2,9,11,25224912,1,0,1,1,28399
83dec0c17893b1c8b0d493152417e5766b3bc658,1,pallavkul,2017-03-03 19:00:12+05:18,['59504528b771932f6008be57cc6c74f772d52be7'],13,13,26,25224938,1,,,,28399
8f5f3845c244ffba186c734806ad24ba828a9dc7,0,pallavkul,2017-03-03 19:05:39+05:18,['83dec0c17893b1c8b0d493152417e5766b3bc658'],22,2,24,25224962,1,,,,28399
d51150d02aa527e887ccb91c5231d9911dd04699,0,Oleg Nechiporenko,2017-03-03 16:47:18+02:00,['8f5f3845c244ffba186c734806ad24ba828a9dc7'],0,3,3,25224965,1,0,0,1,28399
4d92ae8c5e6b9a0876fa9fe2c7210d65f9fee264,1,Gaurav Nagar,2017-03-03 20:40:11+05:18,['d51150d02aa527e887ccb91c5231d9911dd04699'],31,68,99,25225064,8,0.115384615,0.115384615,0.846153846,28399
b065b37339ec21a22c969b44bff70e172b3f84f6,1,Gaurav Nagar,2017-03-03 20:41:52+05:18,['4d92ae8c5e6b9a0876fa9fe2c7210d65f9fee264'],7,74,81,25225145,9,1,1,0,28399
1d7498f11a9c73e95b1514a121732f65f307fe4f,0,Sumit Mohanty,2017-03-03 07:26:23-08:00,['b065b37339ec21a22c969b44bff70e172b3f84f6'],1,1,2,25225147,1,,,,28399
1766ebfc4af4d2f5786f6a8e448bb2228201b651,0,Gaurav Nagar,2017-03-03 20:47:47+05:18,['1d7498f11a9c73e95b1514a121732f65f307fe4f'],23,67,90,25225237,4,0.307692308,0.564102564,0.717948718,28399
f7472a09a650c76ea84c4e98492e7aa081887443,1,Gaurav Nagar,2017-03-03 20:50:56+05:18,['1766ebfc4af4d2f5786f6a8e448bb2228201b651'],38,126,164,25225401,13,0.62745098,0.62745098,0.862745098,28400
135c0cbfbe7eb976926f8b30db36493bca94fa1c,1,Gaurav Nagar,2017-03-03 20:55:35+05:18,['f7472a09a650c76ea84c4e98492e7aa081887443'],174,172,346,25225747,4,0,0,0,28400
2572469f537f0400cab1377940dc90cbac497e6e,0,Aleksandr Kovalenko,2017-03-03 17:39:27+02:00,['135c0cbfbe7eb976926f8b30db36493bca94fa1c'],2,91,93,25225840,2,0.544117647,1,1,28400
a28e0ca13beabde2531cb997f35841e7c2498ad0,1,Alex Antonenko,2017-03-03 19:40:38+02:00,['2572469f537f0400cab1377940dc90cbac497e6e'],0,2,2,25225842,1,0,1,1,28400
4527aa15d2b7f184072d4da4402fd487a6d75c13,0,Nate Cole,2017-03-03 13:03:40-05:00,"['ef96465fa51f7cdf469cc1411bcf92250017145a', 'a28e0ca13beabde2531cb997f35841e7c2498ad0']",449,1003,1452,25227294,74,,,,28400
f896b84116573c5432b60bdf90315edad20e61de,1,"Toader, Sebastian",2017-03-03 20:51:16+01:00,['a28e0ca13beabde2531cb997f35841e7c2498ad0'],16,91,107,25227401,5,0.136363636,0,0.704545455,28400
dc899c918ec6ab6b698972dfb9b0d632b8fe2d7b,1,ababiichuk,2017-03-03 22:06:44+02:00,['f896b84116573c5432b60bdf90315edad20e61de'],25,20,45,25227446,5,1,1,0,28400
5e9a59fe4c0b1c03dde2b6cc19019b408b4727bc,1,Sumit Mohanty,2017-03-03 13:23:45-08:00,['dc899c918ec6ab6b698972dfb9b0d632b8fe2d7b'],0,64,64,25227510,10,,,,28400
496101d68fc1e4c1499c0265e7993370bdadd64e,1,Sumit Mohanty,2017-03-03 16:01:15-08:00,['5e9a59fe4c0b1c03dde2b6cc19019b408b4727bc'],2,2,4,25227514,2,,,,28400
543dd463a8ad8a742793c2accb2211efd388aa8f,0,Alejandro Fernandez,2017-03-03 16:27:18-08:00,['496101d68fc1e4c1499c0265e7993370bdadd64e'],0,8,8,25227522,1,,,,28400
2450dde8a28f2b02e928640b2171e129852258f5,0,Sumit Mohanty,2017-03-03 19:11:05-08:00,['543dd463a8ad8a742793c2accb2211efd388aa8f'],9,45,54,25227576,2,0.21875,0.78125,1,28400
de6d54c903ff0975ad46f6dd6b8e2f8813738aa1,1,Aravindan Vijayan,2017-03-03 19:48:29-08:00,['2450dde8a28f2b02e928640b2171e129852258f5'],597,2741,3338,25230914,26,0.267857143,0.303571429,0.982142857,28403
74b18023c900507898155f776795c07fca43e838,1,pallavkul,2017-03-04 14:38:21+05:18,['de6d54c903ff0975ad46f6dd6b8e2f8813738aa1'],34,80,114,25231028,7,0.416666667,1,0.888888889,28403
9a7ea1d2edd6db4ce0703817cb1a27f2d6a1333c,1,Sumit Mohanty,2017-03-04 08:39:13-08:00,['74b18023c900507898155f776795c07fca43e838'],3,2,5,25231033,3,,,,28403
3d42351ea781729b5538fc50a2c5f0a1c494942c,0,Sumit Mohanty,2017-03-05 08:42:10-08:00,['9a7ea1d2edd6db4ce0703817cb1a27f2d6a1333c'],2,2,4,25231037,1,,,,28403
584fdac8b6e1a7a970e0c39386687fdc4859aaef,0,Sumit Mohanty,2017-03-05 10:44:09-08:00,['3d42351ea781729b5538fc50a2c5f0a1c494942c'],5,23,28,25231065,6,0,0.6,0.4,28403
109bba17ec9d48a5061f2c261325a5b8c445f423,1,Sumit Mohanty,2017-03-05 13:57:40-08:00,['584fdac8b6e1a7a970e0c39386687fdc4859aaef'],80,8,88,25231153,8,0,0,0,28403
6025d413da204a4cf5cf69fe90a413b905ac9344,1,Renjith Kamath,2017-03-06 15:44:19+05:18,['109bba17ec9d48a5061f2c261325a5b8c445f423'],23,49,72,25231225,4,0.35,1,1,28403
dbc12f24b7e05bbcce8c69a09ceae97b7bcb0fec,1,Andrii Tkach,2017-03-06 12:39:32+02:00,['6025d413da204a4cf5cf69fe90a413b905ac9344'],31,11,42,25231267,3,,,,28403
3d95dd6bf22f32dac55b72b639edf2709e253c9b,0,Andrew Onishuk,2017-03-06 16:13:50+02:00,['dbc12f24b7e05bbcce8c69a09ceae97b7bcb0fec'],0,21,21,25231288,3,0,0.666666667,1,28403
f7e7c8bb331d92997d547e6717ee1f3fdbefc6a8,1,Oleg Nechiporenko,2017-03-06 16:30:14+02:00,['3d95dd6bf22f32dac55b72b639edf2709e253c9b'],117,359,476,25231764,11,0.727272727,1,1,28406
41906e593cca9ea5a9fa6d413d2ca1f5a5dcbd32,0,Jonathan Hurley,2017-03-06 11:58:30-05:00,['f7e7c8bb331d92997d547e6717ee1f3fdbefc6a8'],3,40,43,25231807,3,0.115384615,1,1,28406
801cd6147ffd5cf1aff067a3970f341df2f6eead,0,Lisnichenko Dmitro,2017-03-06 18:59:16+02:00,['41906e593cca9ea5a9fa6d413d2ca1f5a5dcbd32'],8,8,16,25231823,8,,,,28406
6cfcc90acfaced9cbcefe8abaa1a5d98a2db20ad,1,Robert Levas,2017-03-06 12:27:29-05:00,['801cd6147ffd5cf1aff067a3970f341df2f6eead'],511,627,1138,25232961,3,0.205479452,0.534246575,0.794520548,28406
9d38b66d1bc015896b82ea6e6e89e1f9bfee79ac,1,Jonathan Hurley,2017-03-06 12:38:04-05:00,['6cfcc90acfaced9cbcefe8abaa1a5d98a2db20ad'],2,67,69,25233030,7,,,,28407
353cd9dfd0132356305902fa0d58980eb4749a84,0,Jonathan Hurley,2017-03-06 13:36:01-05:00,"['4527aa15d2b7f184072d4da4402fd487a6d75c13', '9d38b66d1bc015896b82ea6e6e89e1f9bfee79ac']",1463,4263,5726,25238756,109,,,,28407
649ca2b825b235660c36015b51d136dca5d564a5,0,Alex Antonenko,2017-03-06 20:58:05+02:00,['9d38b66d1bc015896b82ea6e6e89e1f9bfee79ac'],0,5,5,25238761,1,1,0,0,28407
cf3321b4e43f3fd31239c27d763415271627687a,0,Jaimin Jetly,2017-03-06 11:41:27-08:00,['649ca2b825b235660c36015b51d136dca5d564a5'],3,4,7,25238768,2,0,0,1,28407
f60c4ccfa841457bb6e253b478e3b0d51b48e131,0,Sumit Mohanty,2017-03-06 11:53:52-08:00,['cf3321b4e43f3fd31239c27d763415271627687a'],16,19,35,25238803,2,,,,28407
34df7650207e957a38a5067f1553b753a00297e3,0,Andrii Tkach,2017-03-06 22:26:40+02:00,['f60c4ccfa841457bb6e253b478e3b0d51b48e131'],27,1,28,25238831,3,0,0,0,28407
281875354c94c3bdeeb616c75ecc1bc9d83ed521,1,pallavkul,2017-03-07 14:13:58+05:18,['34df7650207e957a38a5067f1553b753a00297e3'],11,140,151,25238982,7,0.584269663,1,1,28407
e6dcdf633f3949f8a59203185c8fb65874932e67,0,Oleg Nechiporenko,2017-03-07 13:01:38+02:00,['281875354c94c3bdeeb616c75ecc1bc9d83ed521'],2,23,25,25239007,3,1,1,1,28407
c21f77dfb6ca4fdd012af4313696eabcc11c1fbc,0,lpuskas,2017-03-07 12:04:04+01:00,['e6dcdf633f3949f8a59203185c8fb65874932e67'],14,32,46,25239053,3,0,0.555555556,0,28407
fddf8fd006296642d7444f3318bef564f95b0ffe,1,Robert Levas,2017-03-07 09:37:14-05:00,['c21f77dfb6ca4fdd012af4313696eabcc11c1fbc'],44,238,282,25239335,5,0.576923077,0.5,0.346153846,28407
137613da0acc109ebd6d69e51013a0b8212040b2,0,Andrii Tkach,2017-03-07 17:02:55+02:00,['fddf8fd006296642d7444f3318bef564f95b0ffe'],5,11,16,25239351,2,1,1,1,28407
98f35228f1438b07076ffb33bfa61ea36011d403,1,pallavkul,2017-03-07 20:24:25+05:18,['137613da0acc109ebd6d69e51013a0b8212040b2'],185,176,361,25239712,51,1,1,1,28407
245fda34c2b61cff267f024551fe3dc52c2bb1a0,1,Lisnichenko Dmitro,2017-03-07 18:02:47+02:00,['98f35228f1438b07076ffb33bfa61ea36011d403'],2,7,9,25239721,2,0,1,1,28407
434ff1f25fa62e26709a500d70bf8012e531d5bb,1,Jonathan Hurley,2017-03-07 12:53:46-05:00,['245fda34c2b61cff267f024551fe3dc52c2bb1a0'],20,87,107,25239828,6,0,1,1,28407
d62755233ccb489cbca1ec78ae2b7e86857d6efe,1,Dipayan Bhowmick,2017-03-08 00:48:10+05:18,['434ff1f25fa62e26709a500d70bf8012e531d5bb'],0,7,7,25239835,1,,,,28407
a6dac1fdf6728c7dfb1d14a072052ebe47df83bd,1,Dipayan Bhowmick,2017-03-08 00:50:45+05:18,['d62755233ccb489cbca1ec78ae2b7e86857d6efe'],14,289,303,25240138,7,0.893939394,1,0.823232323,28409
995b5e0538333b4f06146dc6a15074f97ba3f200,0,Sumit Mohanty,2017-03-07 13:14:23-08:00,['a6dac1fdf6728c7dfb1d14a072052ebe47df83bd'],2,2,4,25240142,1,,,,28409
4b884e30bf40614a2721bbc5e6969a6767e2d02e,0,ababiichuk,2017-03-08 00:13:32+02:00,['995b5e0538333b4f06146dc6a15074f97ba3f200'],1,33,34,25240176,2,0.4375,1,1,28409
a5b7e900b2ad02588a0be79e3134dd277f21406a,1,Sumit Mohanty,2017-03-07 16:52:55-08:00,['4b884e30bf40614a2721bbc5e6969a6767e2d02e'],0,36,36,25240212,12,,,,28409
769fb723a86971c2b825e42f19e31e71a51e0b6b,0,Nitiraj Singh Rathore,2017-03-08 14:42:39+05:18,['a5b7e900b2ad02588a0be79e3134dd277f21406a'],8,8,16,25240228,2,,,,28409
0e56ae78e768a6d54392fc9d8c91f4c46c4645ea,1,Gaurav Nagar,2017-03-08 16:14:45+05:18,['769fb723a86971c2b825e42f19e31e71a51e0b6b'],32,45,77,25240305,2,0,1,1,28409
fdb12d4800a620c44940b72c43dd4c499e80d829,0,Gaurav Nagar,2017-03-08 16:45:57+05:18,['0e56ae78e768a6d54392fc9d8c91f4c46c4645ea'],31,59,90,25240395,4,0.882352941,1,1,28409
78e038a8098200c58b425c7cd6b5e87e75da0ea8,1,Gaurav Nagar,2017-03-08 16:48:23+05:18,['fdb12d4800a620c44940b72c43dd4c499e80d829'],38,34,72,25240467,2,1,0,1,28409
17323e0d73d11eb27f3203ae6f2319e43e6ef9cd,0,Gaurav Nagar,2017-03-08 17:13:25+05:18,['78e038a8098200c58b425c7cd6b5e87e75da0ea8'],7,30,37,25240504,3,0,1,1,28409
f39207a53df94433ca0ac39ffde6f5fb9f7994c6,1,Robert Levas,2017-03-08 07:49:32-05:00,['17323e0d73d11eb27f3203ae6f2319e43e6ef9cd'],27,70,97,25240601,2,0,0.71875,1,28409
ece0736c095d98c97e4cde7d5384af3d46a921dd,0,Jonathan Hurley,2017-03-08 07:52:43-05:00,['f39207a53df94433ca0ac39ffde6f5fb9f7994c6'],2,0,2,25240603,1,,,,28409
fd07c16dcab7f89cadae19b9df72da174ffe89d5,1,pallavkul,2017-03-08 20:38:09+05:18,['ece0736c095d98c97e4cde7d5384af3d46a921dd'],118,221,339,25240942,7,1,1,0.947368421,28409
5700ecca4ac86ac66691929624d2cd4a6056b3aa,1,Miklos Gergely,2017-03-08 16:31:26+01:00,['fd07c16dcab7f89cadae19b9df72da174ffe89d5'],6,19,25,25240967,3,0,0.5,1,28409
697777451e7cbd41c9552d59a5857a16083af7c9,1,pallavkul,2017-03-08 22:02:01+05:18,['5700ecca4ac86ac66691929624d2cd4a6056b3aa'],221,118,339,25241306,7,0,0,0.052631579,28409
197cc2e1c3f9b58498f3fc70e8a00ab326e983d9,1,pallavkul,2017-03-08 22:45:02+05:18,['697777451e7cbd41c9552d59a5857a16083af7c9'],120,207,327,25241633,6,1,1,0.942307692,28409
8b7c661e714fa221447e3461325811ca3f0821c0,0,Jonathan Hurley,2017-03-08 13:31:03-05:00,['197cc2e1c3f9b58498f3fc70e8a00ab326e983d9'],2,4,6,25241639,2,,,,28409
66c94e9937343be0c1db9f51fad22556c18fb77e,1,Yusaku Sako,2017-03-08 11:29:39-08:00,['8b7c661e714fa221447e3461325811ca3f0821c0'],37,43,80,25241719,4,1,1,1,28409
621ff153389d756001b09f30186c28e20178116a,0,Di Li,2017-03-08 14:37:46-05:00,['66c94e9937343be0c1db9f51fad22556c18fb77e'],28,30,58,25241777,7,,,,28409
8d3d07a9c9a07617ea4785038be962eee6be1a5a,0,Aravindan Vijayan,2017-03-08 12:43:44-08:00,['621ff153389d756001b09f30186c28e20178116a'],2,2,4,25241781,1,,,,28409
dd0bf23f1c12624f378ad25be6f74d2d1ad2dee8,0,Alejandro Fernandez,2017-03-08 16:56:31-08:00,['8d3d07a9c9a07617ea4785038be962eee6be1a5a'],3,12,15,25241796,2,0.111111111,1,0.888888889,28409
011df3482d661722cf1dedb194a3db2f1b233ff4,0,Mugdha Varadkar,2017-03-09 10:45:44+05:18,['dd0bf23f1c12624f378ad25be6f74d2d1ad2dee8'],0,6,6,25241802,1,0,0,1,28409
47c0c582b2fb59d567257d7c6784793fd0d0c06f,1,Renjith Kamath,2017-03-09 12:36:53+05:18,['011df3482d661722cf1dedb194a3db2f1b233ff4'],4,35,39,25241841,2,0,0,1,28409
a3f593d8f83560b3496c87a08c9908fa6b0348d6,0,pallavkul,2017-03-09 19:15:22+05:18,['47c0c582b2fb59d567257d7c6784793fd0d0c06f'],130,195,325,25242166,7,0.111111111,0.111111111,1,28409
0ff34acb3cd9f71a82e8175a4d0086d16ddf01d0,1,pallavkul,2017-03-09 19:16:19+05:18,['a3f593d8f83560b3496c87a08c9908fa6b0348d6'],195,130,325,25242491,7,0.888888889,0.888888889,0,28409
625dc70b8c6803536f2a5b0f87904d26f8daae2c,1,pallavkul,2017-03-09 19:16:52+05:18,['0ff34acb3cd9f71a82e8175a4d0086d16ddf01d0'],130,195,325,25242816,7,0.111111111,0.111111111,1,28409
d3f7c8fb3d518580c56d4247dbcf4d3293c04139,0,Lisnichenko Dmitro,2017-03-09 16:18:15+02:00,['625dc70b8c6803536f2a5b0f87904d26f8daae2c'],2,0,2,25242818,1,1,0,0,28409
0ca474786dcbdf8cf249f4b04c0ee106ee61cc9a,0,Aleksandr Kovalenko,2017-03-09 16:26:17+02:00,['d3f7c8fb3d518580c56d4247dbcf4d3293c04139'],20,13,33,25242851,1,0,0,0,28409
573907754e6743729f4788187850ef844a95aaf7,1,Renjith Kamath,2017-03-09 19:46:23+05:18,['0ca474786dcbdf8cf249f4b04c0ee106ee61cc9a'],1,1,2,25242853,1,,,,28409
af69dcc43a33682b393cd488458f9b3244b1a6db,0,Andrew Onishuk,2017-03-09 16:30:56+02:00,['573907754e6743729f4788187850ef844a95aaf7'],9,9,18,25242871,2,,,,28409
c3c3422e51c58c6e9ec3affd492f28a26499dc1e,0,Oleg Nechiporenko,2017-03-09 16:41:51+02:00,['af69dcc43a33682b393cd488458f9b3244b1a6db'],119,38,157,25243028,2,0,0,0,28409
fbcf24f71a1ec1ea21cc236bab36b205822ec4e6,1,pallavkul,2017-03-09 20:13:50+05:18,['c3c3422e51c58c6e9ec3affd492f28a26499dc1e'],1,1,2,25243030,1,,,,28409
647ff84b0b85b04bd350ddb268fde56b0778cf2b,0,Alex Antonenko,2017-03-09 17:11:37+02:00,['fbcf24f71a1ec1ea21cc236bab36b205822ec4e6'],3,13,16,25243046,3,1,1,1,28409
7ff9bd429a1273074d6b8c1edf8b170d3f77ee0d,0,Alex Antonenko,2017-03-09 17:11:37+02:00,['647ff84b0b85b04bd350ddb268fde56b0778cf2b'],83,40,123,25243169,6,0,0,0,28409
3db5addb9322b944ed8cc33264ffb505241ba281,0,Renjith Kamath,2017-03-09 20:30:28+05:18,['7ff9bd429a1273074d6b8c1edf8b170d3f77ee0d'],22,49,71,25243240,1,,,,28409
a1012057452fde3f4b488dd1e0ebb83069fb29da,0,Robert Levas,2017-03-09 10:25:14-05:00,['3db5addb9322b944ed8cc33264ffb505241ba281'],11,25,36,25243276,1,0.444444444,0.444444444,0,28409
8ce47e0cbd5caaaee7f444ddca1afefafceede1d,0,Aleksandr Kovalenko,2017-03-09 17:59:16+02:00,['a1012057452fde3f4b488dd1e0ebb83069fb29da'],10,26,36,25243312,2,1,1,1,28409
da0b7ad8f8974dfdeaf0e99d86339c7562cdd9f2,1,Eugene Chekanskiy,2017-03-09 18:31:49+02:00,['8ce47e0cbd5caaaee7f444ddca1afefafceede1d'],161,280,441,25243753,7,0,0.576923077,0.948717949,28409
e3405474324d021223c3e6bb8353a50528cc0c48,0,Dmytro Sen,2017-03-09 18:36:18+02:00,['da0b7ad8f8974dfdeaf0e99d86339c7562cdd9f2'],0,133,133,25243886,1,1,1,0.387096774,28410
e2220ea8ae60eb02e76761772b9d0144871d24ad,0,Alex Antonenko,2017-03-09 18:37:45+02:00,['e3405474324d021223c3e6bb8353a50528cc0c48'],1,0,1,25243887,1,1,0,0,28410
c4ca3b8908c9b71a88de47400aebb874e66e17b6,0,Robert Levas,2017-03-09 12:58:10-05:00,['e2220ea8ae60eb02e76761772b9d0144871d24ad'],55,6,61,25243948,3,,,,28410
53e77ef5e19ddfd11630323d7e94edf448c27f50,0,Richard Zang,2017-03-09 11:51:45-08:00,['c4ca3b8908c9b71a88de47400aebb874e66e17b6'],10,46,56,25244004,4,1,1,1,28410
6cfad94cc20631960b50454cc95b7e5f71ca461b,0,Sumit Mohanty,2017-03-09 13:02:38-08:00,['53e77ef5e19ddfd11630323d7e94edf448c27f50'],3,3,6,25244010,1,,,,28410
4e864047de5028b634ace49de59579bed2a5212e,0,Jonathan Hurley,2017-03-09 16:44:22-05:00,['6cfad94cc20631960b50454cc95b7e5f71ca461b'],133,0,133,25244143,1,0,0,0.612903226,28410
5f3038138f8431350ff3a8fe45fffd6c7e331983,0,Alejandro Fernandez,2017-03-09 14:02:02-08:00,['4e864047de5028b634ace49de59579bed2a5212e'],1,1,2,25244145,1,,,,28410
dde6583030ddf3b28d543942b8df0216f3bec826,1,Aravindan Vijayan,2017-03-09 14:14:16-08:00,['5f3038138f8431350ff3a8fe45fffd6c7e331983'],2,154,156,25244301,5,0.070866142,0.937007874,1,28410
b4da19ea0b1bf87d5b91ad0520b822f00da26ab8,1,Mugdha Varadkar,2017-03-10 10:46:24+05:18,['dde6583030ddf3b28d543942b8df0216f3bec826'],3,47,50,25244351,4,0,0.257142857,0.914285714,28410
b0fc5da42da8698a300d07a614298f1e9e3f94f1,0,Andrii Tkach,2017-03-10 11:39:42+02:00,['b4da19ea0b1bf87d5b91ad0520b822f00da26ab8'],1,1,2,25244353,1,,,,28410
aa974b0a72a07898c2762587738c7e497e0ac433,0,Dipayan Bhowmick,2017-03-10 15:12:41+05:18,['b0fc5da42da8698a300d07a614298f1e9e3f94f1'],24,27,51,25244404,1,0,1,1,28410
389308e5caafe6fcee0e3ff78b02ecad2e7d635a,0,Lisnichenko Dmitro,2017-03-10 12:09:43+02:00,['aa974b0a72a07898c2762587738c7e497e0ac433'],14,14,28,25244432,2,,,,28410
03a832e6d409802f3ae248799fa448b8f1a307d5,1,oleewere,2017-03-10 12:10:18+01:00,['389308e5caafe6fcee0e3ff78b02ecad2e7d635a'],0,2,2,25244434,1,,,,28410
7f3bee58260080c786bd8882663c9daa67c81d81,0,Dipayan Bhowmick,2017-03-10 17:15:56+05:18,['03a832e6d409802f3ae248799fa448b8f1a307d5'],23,76,99,25244533,8,0.59375,0,0.84375,28410
0da5fc02193809487d3de7373bdfd466d561464b,0,oleewere,2017-03-10 14:11:15+01:00,['7f3bee58260080c786bd8882663c9daa67c81d81'],1,1,2,25244535,1,,,,28410
eb41a375ba4acdd01bdd37fca8a28746144a9c32,0,Andrii Tkach,2017-03-10 15:42:26+02:00,['0da5fc02193809487d3de7373bdfd466d561464b'],1,3,4,25244539,1,1,0,1,28410
d4839a9bc2942cb5aca7659b95f59d6bcb9ff95d,0,Jonathan Hurley,2017-03-10 08:44:44-05:00,['eb41a375ba4acdd01bdd37fca8a28746144a9c32'],16,24,40,25244579,2,1,1,0,28410
1bc0f0a02049fd31d128eb1fd8d41c8d4483ff36,0,Aravindan Vijayan,2017-03-10 07:18:10-08:00,['d4839a9bc2942cb5aca7659b95f59d6bcb9ff95d'],1,3,4,25244583,1,0,1,0,28410
0d2f2c2be5b41265c7769518ee8306a445b332b1,1,Sumit Mohanty,2017-03-10 07:24:39-08:00,['1bc0f0a02049fd31d128eb1fd8d41c8d4483ff36'],1,1,2,25244585,1,,,,28410
528ac5c33d0549f18c5d4518478d274ce1551a15,1,Dmytro Sen,2017-03-10 18:46:49+02:00,['0d2f2c2be5b41265c7769518ee8306a445b332b1'],0,871,871,25245456,15,0.6,0.6,0.915789474,28425
971eaff1d16949a38112eeb9d1869dec45affc44,0,Di Li,2017-03-10 12:50:50-05:00,['528ac5c33d0549f18c5d4518478d274ce1551a15'],35,33,68,25245524,7,,,,28425
e6fc6f47b9cf0eed4b7ac25b011a8aa7876cad7a,1,oleewere,2017-03-10 21:18:13+01:00,['971eaff1d16949a38112eeb9d1869dec45affc44'],0,71,71,25245595,2,0,1,1,28425
0471b0c373dbc7757115cccc20e20ff260b690c0,1,Jonathan Hurley,2017-03-10 16:08:20-05:00,['e6fc6f47b9cf0eed4b7ac25b011a8aa7876cad7a'],0,59,59,25245654,4,0.279069767,1,1,28425
b69ac43a6a7aa5c7810bca0bc1204e6641634c35,1,Eugene Chekanskiy,2017-03-11 00:08:27+02:00,['0471b0c373dbc7757115cccc20e20ff260b690c0'],10,35,45,25245699,4,0.785714286,1,0,28425
01ef69524317f87b4223f9b0c9b26058ae6a73bd,1,Xi Wang,2017-03-10 16:27:47-08:00,['b69ac43a6a7aa5c7810bca0bc1204e6641634c35'],1,2,3,25245702,2,,,,28425
fd257ec2ab0aa88f9971c7f4a330b19b6cefd751,1,Jonathan Hurley,2017-03-10 20:30:21-05:00,['01ef69524317f87b4223f9b0c9b26058ae6a73bd'],5,64,69,25245771,2,0,0.918918919,1,28425
ebd13828f5057f8ac3813e61d6a22d706e331887,0,Sumit Mohanty,2017-03-10 17:32:14-08:00,['fd257ec2ab0aa88f9971c7f4a330b19b6cefd751'],10,48,58,25245829,5,0.05,0.95,0.9,28425
1cb3da802d6407ac6a5218662b7218367a2a91d2,0,Sumit Mohanty,2017-03-11 08:48:06-08:00,['ebd13828f5057f8ac3813e61d6a22d706e331887'],0,12,12,25245841,2,,,,28425
ff235b4904fc4a3334e841ea06b65df17109f5f6,0,Aleksandr Kovalenko,2017-03-12 03:40:01+02:00,['1cb3da802d6407ac6a5218662b7218367a2a91d2'],0,2,2,25245843,1,1,1,1,28425
b13467fb470ec4c1caf64fad4a5a88f779a14b5e,1,Eugene Chekanskiy,2017-03-12 16:17:04+02:00,['ff235b4904fc4a3334e841ea06b65df17109f5f6'],0,28,28,25245871,1,,,,28426
c4fce5383b650dc6e2480b554cb6832876ced311,0,Aravindan Vijayan,2017-03-12 16:11:02-07:00,['b13467fb470ec4c1caf64fad4a5a88f779a14b5e'],15,20,35,25245906,4,1,1,1,28426
3d4a836443f156180362ca3b3b1f73f2142d6f69,1,Dmytro Sen,2017-03-13 13:24:09+02:00,['c4fce5383b650dc6e2480b554cb6832876ced311'],0,133,133,25246039,1,1,1,0.387096774,28427
8f579c122876d00ebad034a2cc12ccfa5daa8869,0,Dipayan Bhowmick,2017-03-13 18:17:17+05:18,['3d4a836443f156180362ca3b3b1f73f2142d6f69'],6,5,11,25246050,1,,,,28427
73a8633db300c352228c363364b7795d3ad47543,0,pallavkul,2017-03-13 18:26:23+05:18,['8f579c122876d00ebad034a2cc12ccfa5daa8869'],4,17,21,25246071,3,,,,28427
938fed1f3b2b96ae8da174f9bd2133ca064197af,1,Andrew Onishuk,2017-03-13 16:32:30+02:00,['73a8633db300c352228c363364b7795d3ad47543'],22,83,105,25246176,5,0.926829268,1,0.780487805,28427
bc28cd782d1d7cd92c693e3a4884b0ea66ef3484,0,Oleg Nechiporenko,2017-03-13 16:40:38+02:00,['938fed1f3b2b96ae8da174f9bd2133ca064197af'],1,12,13,25246189,3,1,1,1,28427
0c010b3177fcc2d03688ba035139e0f86d9f581d,1,Yusaku Sako,2017-03-13 07:58:57-07:00,['bc28cd782d1d7cd92c693e3a4884b0ea66ef3484'],21,24,45,25246234,1,0.666666667,0.666666667,1,28427
1cffdcdce072a23303c56fb3c830a04ab386441f,0,Andrew Onishuk,2017-03-13 17:31:02+02:00,['0c010b3177fcc2d03688ba035139e0f86d9f581d'],0,2,2,25246236,1,0,0,0,28427
db3c09bb6f64c8ad46301b8828f62a130d56dd52,0,Myroslav Papirkovskyi,2017-03-13 18:38:49+02:00,['1cffdcdce072a23303c56fb3c830a04ab386441f'],26,212,238,25246474,7,0.264150943,0.839622642,0.783018868,28427
9b52ce58270eeda1021bf515a91898ade1920477,1,Alex Antonenko,2017-03-13 18:56:31+02:00,['db3c09bb6f64c8ad46301b8828f62a130d56dd52'],2,12,14,25246488,2,0.833333333,1,1,28427
369057a8b890cd320c0b9394f6168f9d58df5c20,1,Alex Antonenko,2017-03-13 18:56:31+02:00,['9b52ce58270eeda1021bf515a91898ade1920477'],1,55,56,25246544,3,0.55,1,1,28427
592c1a90c66b621cada4c6f335196dce2121814a,0,ababiichuk,2017-03-13 19:51:42+02:00,['369057a8b890cd320c0b9394f6168f9d58df5c20'],11,40,51,25246595,3,0,0,1,28427
eadbd1d4eaca52948748f559dd7f3d8a29430fef,0,Alejandro Fernandez,2017-03-13 10:55:44-07:00,['592c1a90c66b621cada4c6f335196dce2121814a'],0,4,4,25246599,1,,,,28427
991c35b6e9c65b1f9953472bfb78a54cd556983a,1,Sumit Mohanty,2017-03-13 11:21:57-07:00,['eadbd1d4eaca52948748f559dd7f3d8a29430fef'],1,8,9,25246608,3,0,0.333333333,0.166666667,28427
9446252fa2324e74d594febd913a7e4e056f7644,1,Yusaku Sako,2017-03-13 14:06:59-07:00,['991c35b6e9c65b1f9953472bfb78a54cd556983a'],1,1,2,25246610,1,,,,28427
19c9e25587316bceb46c1585fce712fdf5056e39,0,Attila Doroszlai,2017-03-13 22:21:59+01:00,['9446252fa2324e74d594febd913a7e4e056f7644'],6,15,21,25246631,1,1,1,0.571428571,28427
f92e8c916fe1850487a5969f7c1b97ea7eaf9c64,1,Sumit Mohanty,2017-03-13 16:24:28-07:00,['19c9e25587316bceb46c1585fce712fdf5056e39'],11,11,22,25246653,2,,,,28427
72b3084834e03e883079c4253b6d27653603156e,1,Swapan Shridhar,2017-03-13 16:39:47-07:00,['f92e8c916fe1850487a5969f7c1b97ea7eaf9c64'],4,4,8,25246661,1,,,,28427
785d7dac9f4cf685eeba0ee4447da9f50ebbc0d1,0,Jaimin Jetly,2017-03-13 17:53:04-07:00,['72b3084834e03e883079c4253b6d27653603156e'],2,6,8,25246669,1,1,1,1,28427
9c7b290dd89aa6ea95ce47496f56f21a9fb40231,1,Nitiraj Singh Rathore,2017-03-14 07:14:20+05:18,['785d7dac9f4cf685eeba0ee4447da9f50ebbc0d1'],182,103,285,25246954,8,1,0,0.113207547,28427
efd3b5847fbfec1ba38cdfa52ffb70e80d385a21,1,Nitiraj Singh Rathore,2017-03-14 11:32:10+05:18,['9c7b290dd89aa6ea95ce47496f56f21a9fb40231'],1,1,2,25246956,1,,,,28427
645407b65558110a5fa6306c034d73c09ba2bfe6,1,Renjith Kamath,2017-03-14 14:25:15+05:18,['efd3b5847fbfec1ba38cdfa52ffb70e80d385a21'],2,2,4,25246960,1,,,,28427
e2818c61c15ec703e15581ca149c27bbfb7c1909,0,Oleg Nechiporenko,2017-03-14 11:32:45+02:00,['645407b65558110a5fa6306c034d73c09ba2bfe6'],2,10,12,25246972,3,1,1,1,28427
c3b5615cdf38d9edc3aafd63808ccefa7901cb61,1,Dipayan Bhowmick,2017-03-14 16:54:55+05:18,['e2818c61c15ec703e15581ca149c27bbfb7c1909'],2,2,4,25246976,2,,,,28427
87e82c7c0dfa2c26560a1bdbc743b360eb787a3a,1,pallavkul,2017-03-14 17:04:14+05:18,['c3b5615cdf38d9edc3aafd63808ccefa7901cb61'],5,24,29,25247005,7,1,1,1,28427
0c76e2f837dcc02b72cf76e08583dbd09c2cbd6e,1,Andrii Tkach,2017-03-14 15:43:35+02:00,['87e82c7c0dfa2c26560a1bdbc743b360eb787a3a'],2,13,15,25247020,4,,,,28427
9dc4a3dfd25f160ab7014bf78e98efa9237a0ebf,1,Robert Levas,2017-03-14 10:42:43-04:00,['0c76e2f837dcc02b72cf76e08583dbd09c2cbd6e'],371,257,628,25247648,7,1,0.987654321,0.320987654,28427
ece203b295bbacd7d069e74201381a5f07280d1e,1,ababiichuk,2017-03-14 17:22:15+02:00,['9dc4a3dfd25f160ab7014bf78e98efa9237a0ebf'],13,11,24,25247672,2,0.1,0,0,28427
1fc41441f16a40950af9cc0530bb416ac6519ab7,1,Alex Antonenko,2017-03-14 17:36:48+02:00,['ece203b295bbacd7d069e74201381a5f07280d1e'],37,193,230,25247902,9,0.3,0.98,1,28429
75f1a29e6c99cdbaf39a9e6afa6ba97fc81b1209,0,ababiichuk,2017-03-14 18:49:01+02:00,['1fc41441f16a40950af9cc0530bb416ac6519ab7'],10,10,20,25247922,1,,,,28429
eb568132bd58fd734985c1aea57221b5afe247d8,0,Nate Cole,2017-03-14 14:41:32-04:00,"['353cd9dfd0132356305902fa0d58980eb4749a84', '75f1a29e6c99cdbaf39a9e6afa6ba97fc81b1209']",2175,5259,7434,25255356,294,,,,28429
02eae2e710a95fd31718f79bdffb37535cf0b485,1,Sumit Mohanty,2017-03-14 15:09:48-07:00,['75f1a29e6c99cdbaf39a9e6afa6ba97fc81b1209'],0,6,6,25255362,1,0,1,1,28429
7e624b55ccac6c04fa9caf5eddbb4aa9282fd473,0,Sumit Mohanty,2017-03-14 15:37:52-07:00,['02eae2e710a95fd31718f79bdffb37535cf0b485'],2,7,9,25255371,2,,,,28429
3c9ebb685ba4e129943f5851db10a9b2680cf1ee,1,Sriharsha Chintalapani,2017-03-14 16:40:46-07:00,['7e624b55ccac6c04fa9caf5eddbb4aa9282fd473'],1,8,9,25255380,2,,,,28429
5fb35c94b643a24d63df278ac4b7ad50e44b0545,0,pallavkul,2017-03-15 16:40:10+05:18,['3c9ebb685ba4e129943f5851db10a9b2680cf1ee'],0,25,25,25255405,1,,,,28429
5d20ccd2392798c6f2b772b569606723b2342f8b,0,Renjith Kamath,2017-03-15 16:46:05+05:18,['5fb35c94b643a24d63df278ac4b7ad50e44b0545'],0,1,1,25255406,1,,,,28429
e34f41ab5054f480de3fd2610441ebc0dbb92142,1,Oleg Nechiporenko,2017-03-15 13:28:42+02:00,['5d20ccd2392798c6f2b772b569606723b2342f8b'],33,196,229,25255635,16,1,1,1,28429
87d47f923505dd399f94c4bb97ed02c775bc0593,0,Oleg Nechiporenko,2017-03-15 14:18:35+02:00,['e34f41ab5054f480de3fd2610441ebc0dbb92142'],52,2,54,25255689,2,,,,28429
3f8ce108ee7a369f0f61ba56c5ab3ce1cd04747b,0,Sumit Mohanty,2017-03-15 08:40:55-07:00,['87d47f923505dd399f94c4bb97ed02c775bc0593'],2,8,10,25255699,1,0,0,0,28429
d16d18d456e562feb6099df0c6528ed61e88fdd0,0,ababiichuk,2017-03-15 18:21:43+02:00,['3f8ce108ee7a369f0f61ba56c5ab3ce1cd04747b'],3,2,5,25255704,1,,,,28429
8b2565ae872ed16da3f36d7f620ae7c2c128695f,0,Andrii Tkach,2017-03-15 19:25:25+02:00,['d16d18d456e562feb6099df0c6528ed61e88fdd0'],33,123,156,25255860,7,0,1,1,28430
19e7c65ba2dcf09010aeeb3e3c39c78b410c7a84,1,Alejandro Fernandez,2017-03-15 10:43:54-07:00,['8b2565ae872ed16da3f36d7f620ae7c2c128695f'],6,16,22,25255882,6,1,0,1,28430
dca46a9a5fcbfd7f57b0de3a231e6c976c6d5779,0,Yusaku Sako,2017-03-15 13:11:18-07:00,['19e7c65ba2dcf09010aeeb3e3c39c78b410c7a84'],1850,0,1850,25257732,2,,,,28430
f6e88e0871d429b5e5b8530d545578ee96025a99,0,Sangeeta Ravindran,2017-03-15 13:58:24-07:00,['dca46a9a5fcbfd7f57b0de3a231e6c976c6d5779'],2,2,4,25257736,1,,0,,28430
df4c44a04dece13565927f34e14766876826accf,0,Sangeeta Ravindran,2017-03-15 15:36:51-07:00,['f6e88e0871d429b5e5b8530d545578ee96025a99'],1,63,64,25257800,2,0.519230769,0.269230769,1,28430
63ab0ab91058ffe8fb4dafa9f7eb96f5b1c8ec05,0,Jaimin Jetly,2017-03-15 16:34:44-07:00,['df4c44a04dece13565927f34e14766876826accf'],0,4,4,25257804,1,,,,28430
55dc8ac9224366c0fd08d03da42176652a146ce0,1,Sangeeta Ravindran,2017-03-15 16:50:11-07:00,['63ab0ab91058ffe8fb4dafa9f7eb96f5b1c8ec05'],1,14,15,25257819,1,1,1,1,28430
8ca09f9fc80a62d332c100e721b4cc2d2a16ceb3,1,Sumit Mohanty,2017-03-15 19:27:26-07:00,['55dc8ac9224366c0fd08d03da42176652a146ce0'],7,58,65,25257884,3,0.592592593,0.592592593,0.037037037,28430
b37f6f37d0c32bde531c03467c6682af679e7fd6,0,Jaimin Jetly,2017-03-15 23:40:08-07:00,['8ca09f9fc80a62d332c100e721b4cc2d2a16ceb3'],4,0,4,25257888,1,,,,28430
167e111bd443d27dad940c0db54245d5835e1daf,0,Attila Doroszlai,2017-03-16 10:26:24+01:00,['b37f6f37d0c32bde531c03467c6682af679e7fd6'],0,24,24,25257912,2,1,1,1,28430
96009189cbc5b21d4279c9d7d59a110315b688fd,0,Renjith Kamath,2017-03-16 14:56:15+05:18,['167e111bd443d27dad940c0db54245d5835e1daf'],0,2,2,25257914,1,,,,28430
b7d5e013ec24a3fad2c086bf3cdd960220685966,0,ababiichuk,2017-03-16 12:17:46+02:00,['96009189cbc5b21d4279c9d7d59a110315b688fd'],2,34,36,25257950,2,1,1,1,28430
1c616b2975b6a442e15ada772cc274342c229948,1,pallavkul,2017-03-16 16:58:53+05:18,['b7d5e013ec24a3fad2c086bf3cdd960220685966'],10,14,24,25257974,3,1,1,1,28430
a9db60beb5a90201749a134e2d61e4e16e10a5fb,0,pallavkul,2017-03-16 17:20:22+05:18,['1c616b2975b6a442e15ada772cc274342c229948'],2,2,4,25257978,1,,,,28430
a57bfacfc1acd138325563340ecee5d9d3140c49,0,Attila Doroszlai,2017-03-16 13:05:42+01:00,['a9db60beb5a90201749a134e2d61e4e16e10a5fb'],2,2,4,25257982,1,,,,28430
b5b5ac46aed06427868183a9cef57ef1a4071d6c,0,Sandor Magyari,2017-03-16 14:17:32+01:00,['a57bfacfc1acd138325563340ecee5d9d3140c49'],0,1,1,25257983,1,,,,28430
5f530545c0aa81b6a9409384de82c5a016883256,0,Andrew Onishuk,2017-03-16 15:23:27+02:00,['b5b5ac46aed06427868183a9cef57ef1a4071d6c'],3,8,11,25257994,1,0,0,1,28430
6eb02d0b23c03b1fcebd0fa8d23cc476b3a8bdfa,0,Andrew Onishuk,2017-03-16 15:25:40+02:00,['5f530545c0aa81b6a9409384de82c5a016883256'],0,7,7,25258001,1,,,,28430
22cef4fd6fa209f2df699e744aa0975720472032,1,Lisnichenko Dmitro,2017-03-16 16:45:52+02:00,['6eb02d0b23c03b1fcebd0fa8d23cc476b3a8bdfa'],3,9,12,25258013,4,,,,28430
ddeb17a12bd5f3edd394ef05e483b888d16d4972,0,Vitaly Brodetskyi,2017-03-16 14:37:56+02:00,['22cef4fd6fa209f2df699e744aa0975720472032'],38,47,85,25258098,2,,,,28430
52186645d66f1cec42a2e16d1c0177f47d0cd585,1,pallavkul,2017-03-16 22:42:13+05:18,['ddeb17a12bd5f3edd394ef05e483b888d16d4972'],29,51,80,25258178,5,,,,28430
5d629dc1eb9a04c551787e9d538376ff0aa8d434,1,ababiichuk,2017-03-16 19:35:10+02:00,['52186645d66f1cec42a2e16d1c0177f47d0cd585'],1,13,14,25258192,1,1,0,0,28430
9ed8c72f758380003853ba477f623c192b806896,1,Xi Wang,2017-03-16 14:25:41-07:00,['5d629dc1eb9a04c551787e9d538376ff0aa8d434'],2,31,33,25258225,2,0.272727273,1,1,28430
d28036e123ea129672ab9029cf32de9b4f234d5c,1,Sumit Mohanty,2017-03-16 14:47:06-07:00,['9ed8c72f758380003853ba477f623c192b806896'],3,6,9,25258234,3,0,1,1,28430
bcd17da52ffc3bb6a6db0b97b1d28b96ef12b9e4,1,Vitaly Brodetskyi,2017-03-16 21:36:25+02:00,['d28036e123ea129672ab9029cf32de9b4f234d5c'],3,269,272,25258506,6,0.454545455,0.475524476,0.776223776,28431
df9c2378a9d35c131163c409d4705c2bcfa05d97,0,Nate Cole,2017-03-16 16:01:28-04:00,"['eb568132bd58fd734985c1aea57221b5afe247d8', '5d629dc1eb9a04c551787e9d538376ff0aa8d434']",2083,745,2828,25261334,70,,,,28431
14e961353bd161b49447e4a928ce3d1fefa6272b,1,Alejandro Fernandez,2017-03-16 16:03:20-07:00,['bcd17da52ffc3bb6a6db0b97b1d28b96ef12b9e4'],0,15,15,25261349,3,,,,28431
96b074049a032891c18697b832479e9d25f46784,1,Vitaly Brodetskyi,2017-03-16 22:37:43+02:00,['14e961353bd161b49447e4a928ce3d1fefa6272b'],1,8,9,25261358,2,,,,28431
9919961cc1da5c2f6c28f78e2a240bca1ac6fc34,0,Alejandro Fernandez,2017-03-16 17:29:48-07:00,['96b074049a032891c18697b832479e9d25f46784'],2,2,4,25261362,2,,,,28431
12008010a2ec12d87190c7b97f63459d97f9ea96,1,Alejandro Fernandez,2017-03-16 17:34:36-07:00,['9919961cc1da5c2f6c28f78e2a240bca1ac6fc34'],0,56,56,25261418,2,0.484848485,0.484848485,0,28431
bcad0bdd37836c05248df21a04bacd1db849a721,0,Alejandro Fernandez,2017-03-16 17:37:59-07:00,['12008010a2ec12d87190c7b97f63459d97f9ea96'],1,1,2,25261420,1,,,,28431
2ef90316516e305ead42b8b851916f41f1502e60,0,Oleg Nechiporenko,2017-03-17 10:03:42+02:00,['bcad0bdd37836c05248df21a04bacd1db849a721'],0,18,18,25261438,2,1,1,0.923076923,28431
0c627bc98d3d2098df0908b2342f6546e7702f3b,0,Andrew Onishuk,2017-03-17 13:30:25+02:00,['2ef90316516e305ead42b8b851916f41f1502e60'],2,2,4,25261442,2,,,,28431
85a2728a2190414975487b05d556d1fec89243c0,1,"Toader, Sebastian",2017-03-17 17:07:56+01:00,['0c627bc98d3d2098df0908b2342f6546e7702f3b'],39,207,246,25261688,7,0.58,0.76,0.99,28431
64b493c49bc7c6eac766e4194683441683f75d75,1,Robert Levas,2017-03-17 13:59:34-04:00,['85a2728a2190414975487b05d556d1fec89243c0'],62,145,207,25261895,7,0,1,0.78,28431
1335fa957c3072315f1c6ed9a7da6728cd81af5a,1,Alejandro Fernandez,2017-03-17 11:17:11-07:00,['64b493c49bc7c6eac766e4194683441683f75d75'],7,7,14,25261909,2,,,,28431
5bd6fd16f02b04c55984c08a8e5c980adc76ecfd,0,Alex Antonenko,2017-03-17 20:47:59+02:00,['1335fa957c3072315f1c6ed9a7da6728cd81af5a'],8,34,42,25261951,4,0,0.882352941,1,28431
8d462419e5d5c37b5d8f85c41b49479d34bc2a6c,0,Yusaku Sako,2017-03-17 12:05:07-07:00,['5bd6fd16f02b04c55984c08a8e5c980adc76ecfd'],0,12,12,25261963,1,,,,28431
566db4afd1e06538cf6eb427f45a4c0c6661468e,1,Vitaly Brodetskyi,2017-03-17 21:13:21+02:00,['8d462419e5d5c37b5d8f85c41b49479d34bc2a6c'],0,1354,1354,25263317,12,0.481012658,1,0.886075949,28443
55e2af58678dd83162a1d63a6d22211ae48f2356,0,Sangeeta Ravindran,2017-03-17 17:17:58-07:00,['566db4afd1e06538cf6eb427f45a4c0c6661468e'],1,1,2,25263319,1,,,,28443
6964bff88d8dcb020027ce852687e3147ae724e4,0,Sumit Mohanty,2017-03-17 18:57:11-07:00,['55e2af58678dd83162a1d63a6d22211ae48f2356'],2,4,6,25263325,2,0,1,1,28443
b24836681a1fb355b94621472fa43dd51a71fc3f,0,Sumit Mohanty,2017-03-17 19:04:04-07:00,['6964bff88d8dcb020027ce852687e3147ae724e4'],2,5,7,25263332,1,0,0,0,28443
044c5eb29f5670cf8a3e8a8d1847bb5a3d090816,1,Gaurav Nagar,2017-03-20 11:38:17+05:18,['b24836681a1fb355b94621472fa43dd51a71fc3f'],2,3,5,25263337,2,,,,28443
9ce0a12e1c3858a7a91fcae30a42e416dab9edd1,0,Andrew Onishuk,2017-03-20 11:14:54+02:00,['044c5eb29f5670cf8a3e8a8d1847bb5a3d090816'],37,12,49,25263386,2,,,,28443
6b4f406958d2bbfdfbd597bfe97befc8cba66d76,0,Andrew Onishuk,2017-03-20 14:03:29+02:00,['9ce0a12e1c3858a7a91fcae30a42e416dab9edd1'],3,3,6,25263392,3,,,,28443
3a7a2d1b025b4ba234e2f066481dbe4991496f25,0,Robert Levas,2017-03-20 10:07:27-04:00,['6b4f406958d2bbfdfbd597bfe97befc8cba66d76'],8,21,29,25263421,2,0,0.416666667,0.416666667,28443
395adf5af992fb43c13d1aa6092cca23c133ec66,1,Di Li,2017-03-20 11:17:15-04:00,['3a7a2d1b025b4ba234e2f066481dbe4991496f25'],3,5,8,25263429,3,0,0,1,28443
fd75adfad6575810a540a1c2e2778ef1c16a695d,0,Andrew Onishuk,2017-03-20 17:20:53+02:00,['395adf5af992fb43c13d1aa6092cca23c133ec66'],2,3,5,25263434,1,0,1,0,28443
0c7dd9383038b53cfe65c21b885fd6e901834821,0,lpuskas,2017-03-20 17:15:59+01:00,['fd75adfad6575810a540a1c2e2778ef1c16a695d'],1,33,34,25263468,3,0,0,0,28443
f1113a26136a9349cb50aed80de3fe74819ee8b7,0,lpuskas,2017-03-20 17:20:30+01:00,['0c7dd9383038b53cfe65c21b885fd6e901834821'],33,1,34,25263502,3,1,1,1,28443
403d59324b8a537337f83274274610963241cf33,1,lpuskas,2017-03-20 17:23:57+01:00,['f1113a26136a9349cb50aed80de3fe74819ee8b7'],40,231,271,25263773,6,0.471698113,0.471698113,1,28445
5a7adeb0efb20b23e9c92bbeac6a26a5a7076f08,0,Aleksandr Kovalenko,2017-03-20 18:54:49+02:00,['403d59324b8a537337f83274274610963241cf33'],0,1,1,25263774,1,1,1,1,28445
97d9b05956a74a34710a9e2fe77f545e636e7c35,0,Eugene Chekanskiy,2017-03-20 20:16:31+02:00,['5a7adeb0efb20b23e9c92bbeac6a26a5a7076f08'],2,10,12,25263786,1,1,1,0,28445
ef823d6a83e0502c0a885945538fb17ac3e0503e,0,Jonathan Hurley,2017-03-20 14:53:41-04:00,['97d9b05956a74a34710a9e2fe77f545e636e7c35'],4,8,12,25263798,2,0,0,1,28445
0a8584f9e0b9fd487508eceae9d1f215f17a5dd1,0,Vitaly Brodetskyi,2017-03-20 19:46:15+02:00,['ef823d6a83e0502c0a885945538fb17ac3e0503e'],1,7,8,25263806,2,0,1,1,28445
b00cd99515aa2e9a3601827496fa4cb2672b2ca9,1,pallavkul,2017-03-21 01:39:42+05:18,['0a8584f9e0b9fd487508eceae9d1f215f17a5dd1'],4,6,10,25263816,6,1,1,1,28445
50d684a95f1ee107d9a6bc1772750ea74fee39bb,0,Sumit Mohanty,2017-03-20 13:44:17-07:00,['b00cd99515aa2e9a3601827496fa4cb2672b2ca9'],1,1,2,25263818,1,,,,28445
fb86fb3bafa1479651836db3197f1b2023b08a2f,1,Jaimin Jetly,2017-03-20 14:26:55-07:00,['785d7dac9f4cf685eeba0ee4447da9f50ebbc0d1'],1625,59245,60870,25324688,115,0.535470123,0.562771908,0.730222854,28514
4d0a5cf6591e5990183d9860a648267d84e87005,1,Alejandro Fernandez,2017-03-20 17:01:50-07:00,['50d684a95f1ee107d9a6bc1772750ea74fee39bb'],2,6,8,25324696,2,0,0,1,28514
0a4e4169c96714207eafb8dce1398096c0188e25,0,Jaimin Jetly,2017-03-20 17:47:23-07:00,['fb86fb3bafa1479651836db3197f1b2023b08a2f'],6,5,11,25324707,2,,,,28514
76eabf2ddc4548cde07696e850ba45a9a5df739b,1,Jaimin Jetly,2017-03-20 17:54:50-07:00,['0a4e4169c96714207eafb8dce1398096c0188e25'],10,5,15,25324722,5,,,,28514
a13e96e755f5daf692375b15bd32767eda987b6d,1,Alex Antonenko,2017-03-21 02:55:15+02:00,['4d0a5cf6591e5990183d9860a648267d84e87005'],7,297,304,25325026,10,1,1,1,28516
917c79151f8eaec23b6258bcf90bdaad8926d251,1,Andrii Tkach,2017-03-21 11:36:33+02:00,['a13e96e755f5daf692375b15bd32767eda987b6d'],496,906,1402,25326428,6,0.639506173,0.990123457,1,28516
6c540fd0720d2702e3572a20501eea3bcc941e47,1,ababiichuk,2017-03-21 13:01:16+02:00,['917c79151f8eaec23b6258bcf90bdaad8926d251'],8,37,45,25326473,2,0.818181818,1,1,28516
3c514cb7d8af7a33702f7f7dc9764cde3851c630,0,Dmytro Sen,2017-03-21 19:53:47+02:00,['6c540fd0720d2702e3572a20501eea3bcc941e47'],1,1,2,25326475,1,,,,28516
f64eff6799a8539e78ef1491e81dad74d8ad0254,1,Miklos Gergely,2017-03-21 19:52:09+01:00,['3c514cb7d8af7a33702f7f7dc9764cde3851c630'],21,24,45,25326520,2,0,0,1,28516
de8e3c57449bb95c5b8039da48ef2166621fe800,0,Jayush Luniya,2017-03-21 11:55:14-07:00,['f64eff6799a8539e78ef1491e81dad74d8ad0254'],1,1,2,25326522,1,,,,28516
fa754d60c38007d98acecbc394fd069695debf57,1,Vitaly Brodetskyi,2017-03-22 01:04:19+02:00,['de8e3c57449bb95c5b8039da48ef2166621fe800'],24,413,437,25326959,3,0.349282297,0.387559809,0.057416268,28517
a8a1ee8b36cd7e66a5c1bc56d743e77de2d423d3,0,Miklos Gergely,2017-03-22 12:03:30+01:00,['fa754d60c38007d98acecbc394fd069695debf57'],26,27,53,25327012,2,1,0,,28517
1310bf3b9e7e21ec8ba534bd765ddb63bbe27eb8,1,oleewere,2017-03-22 13:47:07+01:00,['a8a1ee8b36cd7e66a5c1bc56d743e77de2d423d3'],9,111,120,25327132,8,0.745098039,1,0.862745098,28518
7c14a4dba3c2e87ae0a414a966384607595c4f72,1,oleewere,2017-03-22 13:47:19+01:00,['1310bf3b9e7e21ec8ba534bd765ddb63bbe27eb8'],64,170,234,25327366,32,1,1,0,28519
630ffb3f35a71723a318554c621edcf742bcfbde,1,oleewere,2017-03-22 13:47:37+01:00,['7c14a4dba3c2e87ae0a414a966384607595c4f72'],28,46,74,25327440,3,0,0,0,28519
9f7ad270b51d97da7eee5d59367bbe82093b562f,1,oleewere,2017-03-22 13:47:57+01:00,['630ffb3f35a71723a318554c621edcf742bcfbde'],17,64,81,25327521,6,0,0,1,28519
f8931a925f18dccdfe617641ae912fd93cf5f3e1,1,oleewere,2017-03-22 13:48:24+01:00,['9f7ad270b51d97da7eee5d59367bbe82093b562f'],5,603,608,25328129,15,0.799242424,0.814393939,0.935606061,28523
b8d5dd87a7bd854081d1db0ab7f054a05a5db7e1,0,Andrii Tkach,2017-03-22 15:57:04+02:00,['f8931a925f18dccdfe617641ae912fd93cf5f3e1'],4,24,28,25328157,2,0.259259259,1,1,28523
075cecbff95842b86cb2420318742a7345da6ad1,1,Jayush Luniya,2017-03-22 08:48:55-07:00,['b8d5dd87a7bd854081d1db0ab7f054a05a5db7e1'],0,38992,38992,25367149,156,0.212399541,0.28456618,0.58717402,28679
1aba730c672ca6728e676ca259ca6ddfb1ac5ae3,1,Dmytro Sen,2017-03-22 18:32:06+02:00,['075cecbff95842b86cb2420318742a7345da6ad1'],0,2804,2804,25369953,28,0.389908257,0.561926606,0.27293578,28707
845e921534b69ed4464f0304e0a639ce84084953,1,Dmytro Sen,2017-03-22 18:34:04+02:00,['1aba730c672ca6728e676ca259ca6ddfb1ac5ae3'],0,202,202,25370155,1,1,1,0.225352113,28708
0f5d55077570821c7759a298d05a13104662b390,1,pallavkul,2017-03-22 22:19:47+05:18,['845e921534b69ed4464f0304e0a639ce84084953'],15,154,169,25370324,2,0.698275862,0.862068966,0.698275862,28708
73ecc31b96df5f391d64a52bbe88cb93bd64d15b,1,pallavkul,2017-03-22 22:23:55+05:18,['0f5d55077570821c7759a298d05a13104662b390'],0,1,1,25370325,1,,,,28708
c0783ee71a7c98fc1b92c6063f0d744873e58439,1,pallavkul,2017-03-22 22:30:51+05:18,['73ecc31b96df5f391d64a52bbe88cb93bd64d15b'],12,286,298,25370623,7,0.630136986,0.815068493,0.95890411,28711
e6be2263a27366aa4b99f5a8fff9d8d7fcd583ff,1,pallavkul,2017-03-22 22:35:05+05:18,['c0783ee71a7c98fc1b92c6063f0d744873e58439'],31,290,321,25370944,10,0.737864078,0.737864078,0.941747573,28713
fbb0af384bab5a52ed6ddb6577f313166059a56d,0,Aravindan Vijayan,2017-03-22 10:50:45-07:00,['e6be2263a27366aa4b99f5a8fff9d8d7fcd583ff'],0,34,34,25370978,1,,,,28713
e0be5f6d4520c76d14ed5883fc402ec380e1bb11,1,Nate Cole,2017-03-22 16:50:45-04:00,['fbb0af384bab5a52ed6ddb6577f313166059a56d'],15,215,230,25371208,7,1,1,0,28713
936d8591e4b738456ca054572e1c01d206303820,0,Yusaku Sako,2017-03-22 14:07:16-07:00,['e0be5f6d4520c76d14ed5883fc402ec380e1bb11'],0,37,37,25371245,1,,,,28713
8fc7db16bb825242200e51008dfb02af7be1959c,0,Sumit Mohanty,2017-03-22 14:41:35-07:00,['936d8591e4b738456ca054572e1c01d206303820'],1,1,2,25371247,1,,,,28713
4a9dee6102d2989bf0e023c5d5c2c5b1b2d56958,0,Sumit Mohanty,2017-03-22 14:41:57-07:00,['8fc7db16bb825242200e51008dfb02af7be1959c'],7,2,9,25371256,2,,,,28713
ca2c83582e135bb5410b62775292a780e68757eb,1,Alejandro Fernandez,2017-03-22 17:20:53-07:00,['4a9dee6102d2989bf0e023c5d5c2c5b1b2d56958'],1,22,23,25371279,5,,,,28713
64fc0e23c599682d53e337a58dd573825d551504,0,Sandor Magyari,2017-03-23 08:24:31+01:00,['ca2c83582e135bb5410b62775292a780e68757eb'],2,13,15,25371294,3,0,1,1,28713
da814785ddea9b86384188f4d01c987f1154e896,0,Oleg Nechiporenko,2017-03-23 10:13:23+02:00,['64fc0e23c599682d53e337a58dd573825d551504'],6,21,27,25371321,4,1,1,0.142857143,28713
4779515ac6180a659522c795f5eda3082eaaa4b0,0,oleewere,2017-03-23 13:09:25+01:00,['da814785ddea9b86384188f4d01c987f1154e896'],2,2,4,25371325,1,,,,28713
3f0752ec09ab7df1831458e26f99a793e433514d,0,Nate Cole,2017-03-23 09:23:35-04:00,"['df9c2378a9d35c131163c409d4705c2bcfa05d97', '4779515ac6180a659522c795f5eda3082eaaa4b0']",1010,48257,49267,25420592,394,,,,28713
e2e4ddf44c64c4f15d846c0ed587148299c08ab3,1,pallavkul,2017-03-23 19:10:49+05:18,['4779515ac6180a659522c795f5eda3082eaaa4b0'],22,261,283,25420875,8,0.531746032,0.785714286,0.952380952,28715
fbd6d520dc95a733237087674257de1be2812d09,1,Andrew Onishuk,2017-03-23 17:02:56+02:00,['e2e4ddf44c64c4f15d846c0ed587148299c08ab3'],4,4,8,25420883,4,,,,28715
ad8767063ab188078d2c57dda3d6596624e02df2,1,Lisnichenko Dmitro,2017-03-23 17:58:16+02:00,['fbd6d520dc95a733237087674257de1be2812d09'],5,99,104,25420987,10,0.642857143,0.714285714,0.714285714,28715
549783cde2ce8abb3aca055eb2de5da28e92f344,1,lpuskas,2017-03-23 17:01:27+01:00,['ad8767063ab188078d2c57dda3d6596624e02df2'],16,34,50,25421037,2,1,1,1,28715
f9696fe8baedd9b9f318e0bcf0181dd050cf1c0a,1,Aleksandr Kovalenko,2017-03-23 18:38:32+02:00,['549783cde2ce8abb3aca055eb2de5da28e92f344'],536,603,1139,25422176,16,0,0,0,28715
3758ac7d48b7fc8a962a5cbe9210198b3f00dcb8,1,ababiichuk,2017-03-23 19:53:35+02:00,['f9696fe8baedd9b9f318e0bcf0181dd050cf1c0a'],24,174,198,25422374,6,1,1,1,28715
69071b861a825507cfd90dd09148c6de60aa9111,0,Jaimin Jetly,2017-03-23 18:04:36-07:00,['3758ac7d48b7fc8a962a5cbe9210198b3f00dcb8'],12,25,37,25422411,12,,,,28715
e0c35f088804e6dcf3ee9ad44150e2a4d311ce51,0,Sumit Mohanty,2017-03-23 18:11:55-07:00,['69071b861a825507cfd90dd09148c6de60aa9111'],2,7,9,25422420,3,,,,28715
bbe5918256b18ac22955316daa546e662a2510a0,1,Swapan Shridhar,2017-03-23 19:17:36-07:00,['e0c35f088804e6dcf3ee9ad44150e2a4d311ce51'],21,17,38,25422458,3,0,0,0,28715
e5bb3afbac724dcbdb4306a4cc256b8baf473985,0,Renjith Kamath,2017-03-24 09:36:35+05:18,['bbe5918256b18ac22955316daa546e662a2510a0'],8,0,8,25422466,1,1,0,0,28715
5d3e68deb1c495d5418270701e59b92a77608929,1,pallavkul,2017-03-24 13:55:00+05:18,['e5bb3afbac724dcbdb4306a4cc256b8baf473985'],21,107,128,25422594,4,0.470588235,0.658823529,1,28715
39df32e2265991766c0c3121dfd83ad10a96da0d,1,Andrew Onishuk,2017-03-24 12:02:32+02:00,['5d3e68deb1c495d5418270701e59b92a77608929'],1,1,2,25422596,1,,,,28715
a00e7eb246c6063bfd6664781306a5c0b15438e8,1,ababiichuk,2017-03-24 13:47:24+02:00,['39df32e2265991766c0c3121dfd83ad10a96da0d'],27,99,126,25422722,2,1,1,1,28715
80b874004c745c11fed682583a27136cb5f154c0,1,Vitaly Brodetskyi,2017-03-24 12:25:42+02:00,['a00e7eb246c6063bfd6664781306a5c0b15438e8'],0,21150,21150,25443872,91,0.158436945,0.286323268,0.630550622,28806
7fc539ffda2158850c7f1c70987e15dbd48162c0,1,Sumit Mohanty,2017-03-24 06:53:28-07:00,['80b874004c745c11fed682583a27136cb5f154c0'],1,13,14,25443886,2,,,,28806
b54eba9eb306a0b45fe75dd0b8d80626f240ce6a,1,Gaurav Nagar,2017-03-24 19:38:59+05:18,['7fc539ffda2158850c7f1c70987e15dbd48162c0'],1,15,16,25443902,4,0,0,1,28806
25f355baf8e7de16bb3f704ba9b318ade7c4f428,0,Jaimin Jetly,2017-03-24 11:15:47-07:00,['b54eba9eb306a0b45fe75dd0b8d80626f240ce6a'],25,12,37,25443939,12,,,,28806
2c828321b99d9e914cc92306a228d7790a94353c,1,Jaimin Jetly,2017-03-24 11:17:47-07:00,['25f355baf8e7de16bb3f704ba9b318ade7c4f428'],2,4,6,25443945,2,,,,28806
4b7b7fd26c1dda7fae66429d925ef156682747a4,1,Richard Zang,2017-03-24 11:52:22-07:00,['2c828321b99d9e914cc92306a228d7790a94353c'],6,78,84,25444029,4,1,0.951612903,0.85483871,28806
9bb5e4aa41526b078b494bab8ba2a7edb61d78a6,1,Vitaly Brodetskyi,2017-03-24 19:30:27+02:00,['4b7b7fd26c1dda7fae66429d925ef156682747a4'],55,1208,1263,25445292,4,0.159509202,0.142331288,0.073619632,28807
fc6bab15def8f485496deaea2e7e5725c8d5a895,0,Alejandro Fernandez,2017-03-24 15:49:11-07:00,['9bb5e4aa41526b078b494bab8ba2a7edb61d78a6'],0,9,9,25445301,3,,,,28807
82d81ea9d55a9e777091100bf84d1b162dbf528e,1,Sumit Mohanty,2017-03-24 16:05:12-07:00,['fc6bab15def8f485496deaea2e7e5725c8d5a895'],0,33,33,25445334,4,,,,28807
b96b81525d72dd61a4865ef0e9ae7361b557ccd0,0,Sumit Mohanty,2017-03-24 20:31:18-07:00,['82d81ea9d55a9e777091100bf84d1b162dbf528e'],11,5,16,25445350,2,,,,28807
800aea7136a8ba6ef9eb4d95592a837f6e6c4ed1,1,Gaurav Nagar,2017-03-26 00:53:05+05:18,['b96b81525d72dd61a4865ef0e9ae7361b557ccd0'],1,1,2,25445352,1,,,,28807
69779be78af3379a1a03e59e201c7f8eee4d4fbd,1,Gaurav Nagar,2017-03-26 01:15:03+05:18,['800aea7136a8ba6ef9eb4d95592a837f6e6c4ed1'],8,8,16,25445368,6,,,,28807
87e6c2c066c308724704d81365a5928a5d15c063,0,pallavkul,2017-03-26 08:45:42+05:18,['69779be78af3379a1a03e59e201c7f8eee4d4fbd'],1,2,3,25445371,2,,,,28807
deff9f41906488e74fae9ba4d952ef38da53dbe9,1,Gaurav Nagar,2017-03-26 21:53:18+05:18,['87e6c2c066c308724704d81365a5928a5d15c063'],1,1,2,25445373,1,,,,28807
27110aecc998108da56a9e0068c160b874092855,1,pallavkul,2017-03-27 00:33:41+05:18,['deff9f41906488e74fae9ba4d952ef38da53dbe9'],12,23,35,25445408,12,,,,28807
8648139f9dd932133d103cdf1d0ad07caaa89338,0,Yusaku Sako,2017-03-26 14:09:17-07:00,['27110aecc998108da56a9e0068c160b874092855'],0,11,11,25445419,1,,,,28807
55fdd7d988f01eb022b28f2a80963256644b1d4e,0,Sumit Mohanty,2017-03-26 16:56:41-07:00,['8648139f9dd932133d103cdf1d0ad07caaa89338'],0,3,3,25445422,1,,,,28807
3cfc047e65ab2d23d5ffd59d9da521bdfd71f963,1,Renjith Kamath,2017-03-27 10:57:53+05:18,['55fdd7d988f01eb022b28f2a80963256644b1d4e'],2,17,19,25445441,1,0,1,1,28807
d8693986ae5e8389ccd7faab6b49e2b3b31b3baa,1,pallavkul,2017-03-27 12:12:41+05:18,['3cfc047e65ab2d23d5ffd59d9da521bdfd71f963'],1,1,2,25445443,1,,,,28807
b7d5ef70afec253f4269ac8a6073c1d5a4164968,0,Renjith Kamath,2017-03-27 15:04:00+05:18,['d8693986ae5e8389ccd7faab6b49e2b3b31b3baa'],7,14,21,25445464,2,0,0,1,28807
447485daa73e21497fdc745b8cdcc6b5dab5bf5f,1,Andrew Onishuk,2017-03-27 13:38:27+03:00,['b7d5ef70afec253f4269ac8a6073c1d5a4164968'],179,191,370,25445834,8,1,0.857142857,0.571428571,28809
fb153e3e9ea9cafafb2c793d6ca2fa56da0a8533,0,lpuskas,2017-03-27 13:03:29+02:00,['b7d5ef70afec253f4269ac8a6073c1d5a4164968'],32,52,84,25445918,2,1,1,1,28809
cfff00c330e9c914c9db352edc0c909a61efdb4a,1,Oleg Nechiporenko,2017-03-27 15:07:56+03:00,['fb153e3e9ea9cafafb2c793d6ca2fa56da0a8533'],18,14,32,25445950,3,1,1,1,28809
b8884677da5cc4c8cfc9fb0246d8a8598af765aa,0,pallavkul,2017-03-27 18:38:50+05:18,['cfff00c330e9c914c9db352edc0c909a61efdb4a'],5,5,10,25445960,2,,,,28809
8d32894181f5dc13bef7c2a517a26b4c3ca711b4,1,pallavkul,2017-03-27 18:43:14+05:18,['b8884677da5cc4c8cfc9fb0246d8a8598af765aa'],5,5,10,25445970,2,,,,28809
dc34ee92d72d245997b372083c8dd92bb8733cee,0,pallavkul,2017-03-27 18:44:16+05:18,['8d32894181f5dc13bef7c2a517a26b4c3ca711b4'],5,5,10,25445980,2,,,,28809
cd751ef1afa3f9eb91a2e641f57e428997a0a562,1,pallavkul,2017-03-27 18:46:04+05:18,['dc34ee92d72d245997b372083c8dd92bb8733cee'],5,5,10,25445990,2,,,,28809
550752deb2d6508f5aa97c9270a0bb9785104b2c,1,Attila Doroszlai,2017-03-27 15:29:51+02:00,['cd751ef1afa3f9eb91a2e641f57e428997a0a562'],21,45,66,25446056,13,0.692307692,0.923076923,1,28809
d69b58234358f017e48bde170cf2a045360fa9a4,0,Alex Antonenko,2017-03-27 17:24:39+03:00,['550752deb2d6508f5aa97c9270a0bb9785104b2c'],0,5,5,25446061,2,1,1,1,28809
db9e72912e6948352bc15f3e146f96631e1157c8,1,Eugene Chekanskiy,2017-03-27 18:24:44+03:00,['d69b58234358f017e48bde170cf2a045360fa9a4'],2,5,7,25446068,1,1,1,1,28809
955bc660706475603aaaa6dc8beb149088dc3c1c,1,oleewere,2017-03-27 18:10:26+02:00,['db9e72912e6948352bc15f3e146f96631e1157c8'],195556,726,196282,25642350,907,0.622682605,0.246836688,0.107097329,28820
9067dfafb8f68e1fe9a975e142b873f0eb9cc950,1,Andrii Tkach,2017-03-27 19:49:04+03:00,['955bc660706475603aaaa6dc8beb149088dc3c1c'],459,30,489,25642839,7,0.191011236,0,0,28820
51e6a82dfb47f4b1946aaa14391e5323ac69c99d,0,Jayush Luniya,2017-03-27 10:56:20-07:00,['9067dfafb8f68e1fe9a975e142b873f0eb9cc950'],3,8,11,25642850,2,1,0.5,1,28820
b0f1e3408810349f8cc8ec524d0ae9e0700c4a6d,1,oleewere,2017-03-27 21:12:55+02:00,['51e6a82dfb47f4b1946aaa14391e5323ac69c99d'],21,21,42,25642892,276,,,,28820
c5ccb1ab7f09762db0e9a812770e3c3fbe1e848d,1,oleewere,2017-03-27 21:13:39+02:00,['b0f1e3408810349f8cc8ec524d0ae9e0700c4a6d'],91,87,178,25643070,37,,,,28820
3ab4c8d2ae0a7f28bc73d8438f79d2f18f96cc01,0,Di Li,2017-03-27 15:39:33-04:00,['c5ccb1ab7f09762db0e9a812770e3c3fbe1e848d'],1,48,49,25643119,2,0,0,0,28820
fe4b87c7fa325efc72afddff6a864882f76976d1,1,ababiichuk,2017-03-27 23:32:16+03:00,['3ab4c8d2ae0a7f28bc73d8438f79d2f18f96cc01'],572,515,1087,25644206,27,0.921348315,0,0.011235955,28820
1e9cebbed3d3e766ecb5624c7f68763169130640,0,Xi Wang,2017-03-27 13:34:47-07:00,['fe4b87c7fa325efc72afddff6a864882f76976d1'],8,67,75,25644281,5,1,1,1,28820
54a823f502a2ecf144ccaeee5725a8288104c944,0,Jonathan Hurley,2017-03-27 19:01:24-04:00,['1e9cebbed3d3e766ecb5624c7f68763169130640'],14,14,28,25644309,3,,,,28820
accbb0048435de2d08e3d1b8771d966a94b98707,0,Oleksandr Diachenko,2017-03-27 17:27:07-07:00,['54a823f502a2ecf144ccaeee5725a8288104c944'],3,1,4,25644313,1,,,,28820
1c79ca6bb687332a01fe0ad48eff8d9d2be65bf5,1,Dipayan Bhowmick,2017-03-28 11:18:36+05:18,['accbb0048435de2d08e3d1b8771d966a94b98707'],21,322,343,25644656,20,0.629213483,0.865168539,1,28826
5269052eb3d55e66bed3963325cba3796ab96a41,1,Vitaly Brodetskyi,2017-03-28 10:59:00+03:00,['1c79ca6bb687332a01fe0ad48eff8d9d2be65bf5'],0,1,1,25644657,1,1,1,0,28826
c77f4ce8bbf140efcae48128ec01391c908c4f46,1,Nitiraj Singh Rathore,2017-03-28 16:38:47+05:18,['5269052eb3d55e66bed3963325cba3796ab96a41'],57,372,429,25645086,19,0.708860759,0.835443038,0.651898734,28829
d14dba6fabd948290403a7857f75da174d0ef1d9,0,Oleg Nechiporenko,2017-03-28 14:43:44+03:00,['c77f4ce8bbf140efcae48128ec01391c908c4f46'],12,26,38,25645124,3,1,1,1,28829
993cd02a9ad5b9610e8007885b582668066de429,1,Aleksandr Kovalenko,2017-03-28 14:57:16+03:00,['d14dba6fabd948290403a7857f75da174d0ef1d9'],3,3,6,25645130,2,,0,,28829
fa6aa0782e973ff975c7a6b69b410d7a3c5204d4,1,lpuskas,2017-03-28 16:23:40+02:00,['993cd02a9ad5b9610e8007885b582668066de429'],6,236,242,25645372,4,0.697368421,0.986842105,1,28831
8842be0c836fa431da08962b20fed0e10d1ac8c8,1,oleewere,2017-03-28 18:45:11+02:00,['fa6aa0782e973ff975c7a6b69b410d7a3c5204d4'],213,534,747,25646119,58,,,,28833
165ec700f0f4e5c83a30bb7591df0fa1a8cfec9a,0,Sandor Magyari,2017-03-28 19:10:40+02:00,['8842be0c836fa431da08962b20fed0e10d1ac8c8'],0,45,45,25646164,4,0.96,0.96,1,28833
4690fe7c655ade9af91cfea7189e2efd98885149,1,Alejandro Fernandez,2017-03-28 10:15:44-07:00,['165ec700f0f4e5c83a30bb7591df0fa1a8cfec9a'],20,74,94,25646258,3,0.04,0.04,1,28833
53f5b63c70f5667732c83853e7d4bffd841aac9f,0,Sandor Magyari,2017-03-28 19:17:53+02:00,['4690fe7c655ade9af91cfea7189e2efd98885149'],0,9,9,25646267,1,,,,28833
fe029913c51e5e1287e3a4e014c685f3a6bbf682,1,Di Li,2017-03-28 14:54:00-04:00,['53f5b63c70f5667732c83853e7d4bffd841aac9f'],1,163,164,25646431,2,0.040650407,0.967479675,1,28833
742fdff6b74d6324c2cc29d700ce96cbaa42786c,1,Di Li,2017-03-28 15:13:40-04:00,['fe029913c51e5e1287e3a4e014c685f3a6bbf682'],48,1,49,25646480,2,1,1,1,28833
ea3aa22aec0ff875d2127da86701e8caccd78be0,0,Aleksandr Kovalenko,2017-03-29 00:09:16+03:00,['742fdff6b74d6324c2cc29d700ce96cbaa42786c'],1,23,24,25646504,2,1,1,1,28833
e250b9012d712209cca28be6ca75e5040499fabe,0,Jaimin Jetly,2017-03-28 15:13:56-07:00,"['76eabf2ddc4548cde07696e850ba45a9a5df739b', 'ea3aa22aec0ff875d2127da86701e8caccd78be0']",201532,76910,278442,25924946,1949,,,,28833
fa2beead902a95ba4db3332f6e24c77e929062cf,0,Richard Zang,2017-03-28 15:27:44-07:00,['ea3aa22aec0ff875d2127da86701e8caccd78be0'],1,1,2,25924948,1,,,,28833
e3d9ff6f6fd44f1933f92c4ed34dbaa88fd5eeaf,0,Yusaku Sako,2017-03-28 16:34:16-07:00,['fa2beead902a95ba4db3332f6e24c77e929062cf'],0,12,12,25924960,1,,,,28833
f18fad36821e148b69138ec2be6b5cd70ba207cc,1,Alejandro Fernandez,2017-03-28 17:26:15-07:00,['e3d9ff6f6fd44f1933f92c4ed34dbaa88fd5eeaf'],11,141,152,25925112,6,0.227272727,0.227272727,0.227272727,28834
0903309437b9ddea06244bd2836e071b74b56176,0,Sumit Mohanty,2017-03-28 21:40:37-07:00,['f18fad36821e148b69138ec2be6b5cd70ba207cc'],0,446,446,25925558,8,0.050251256,0.809045226,1,28836
f6972cbde880213496dee6a6d3cfcd8c6396cc19,1,oleewere,2017-03-29 12:26:36+02:00,['0903309437b9ddea06244bd2836e071b74b56176'],1,74,75,25925633,4,0.5,0.5,0.791666667,28837
ec1505f215c718f54d59cf0ba2e60f37b6515b86,0,Oleg Nechiporenko,2017-03-29 14:25:44+03:00,['f6972cbde880213496dee6a6d3cfcd8c6396cc19'],2,1,3,25925636,1,0,0,0,28837
b69d52e81152c0c0a195df890d16eaa1f5c216e8,0,Andrew Onishuk,2017-03-29 14:55:56+03:00,['447485daa73e21497fdc745b8cdcc6b5dab5bf5f'],32,52,84,25925720,2,1,1,1,28837
faf09cd50f52c8da12e6e77ae91d2412b8930303,0,Andrew Onishuk,2017-03-29 14:55:56+03:00,['b69d52e81152c0c0a195df890d16eaa1f5c216e8'],18,14,32,25925752,3,1,1,1,28837
901a39e229766703d0209d5f4bd6462af53f673f,0,Andrew Onishuk,2017-03-29 14:55:56+03:00,['faf09cd50f52c8da12e6e77ae91d2412b8930303'],5,5,10,25925762,2,,,,28837
0adacbf02f0195d672c1c3c1097c2825e6597928,1,Andrew Onishuk,2017-03-29 14:55:56+03:00,['901a39e229766703d0209d5f4bd6462af53f673f'],5,5,10,25925772,2,,,,28837
08523c62ada2d899ba9a080acef779a59c6292a5,0,Andrew Onishuk,2017-03-29 14:55:56+03:00,['0adacbf02f0195d672c1c3c1097c2825e6597928'],5,5,10,25925782,2,,,,28837
daf6071bd1082f213ca46023bd6ef83d067de97a,0,Andrew Onishuk,2017-03-29 14:55:56+03:00,['08523c62ada2d899ba9a080acef779a59c6292a5'],5,5,10,25925792,2,,,,28837
3b27cf10310dc84314a4a24faf4f75b134c4c8d8,1,Andrew Onishuk,2017-03-29 14:55:56+03:00,['daf6071bd1082f213ca46023bd6ef83d067de97a'],21,45,66,25925858,13,0.692307692,0.923076923,1,28837
5e84dc7e77a892f9a4cb399b76b55e9d88b22078,0,Andrew Onishuk,2017-03-29 14:55:56+03:00,['3b27cf10310dc84314a4a24faf4f75b134c4c8d8'],0,5,5,25925863,2,1,1,1,28837
ad08d0a9fea477a1409c3eebc9a4ae2e97fa086d,0,Andrew Onishuk,2017-03-29 14:55:56+03:00,['5e84dc7e77a892f9a4cb399b76b55e9d88b22078'],2,5,7,25925870,1,1,1,1,28837
8526f86154725564eaa6da0f32893398bda4588f,1,Andrew Onishuk,2017-03-29 14:55:56+03:00,['ad08d0a9fea477a1409c3eebc9a4ae2e97fa086d'],195556,726,196282,26122152,907,0.622682605,0.246836688,0.107097329,28848
f7abfb229eff3483970e44bfaef5f040bef05ba1,1,Andrew Onishuk,2017-03-29 14:55:56+03:00,['8526f86154725564eaa6da0f32893398bda4588f'],459,30,489,26122641,7,0.191011236,0,0,28848
7f7938dcb6aee1ebfb80f85d258ea001b12deee0,0,Andrew Onishuk,2017-03-29 14:55:56+03:00,['f7abfb229eff3483970e44bfaef5f040bef05ba1'],3,8,11,26122652,2,1,0.5,1,28848
1219c61d74d210477fb0cec568a3bbef9f3f938e,0,Andrew Onishuk,2017-03-29 14:55:56+03:00,['7f7938dcb6aee1ebfb80f85d258ea001b12deee0'],21,21,42,26122694,276,,,,28848
dc9cd35ea45f741b2d11cd298691e500a8be727e,1,Andrew Onishuk,2017-03-29 14:55:56+03:00,['1219c61d74d210477fb0cec568a3bbef9f3f938e'],91,87,178,26122872,37,,,,28848
bc01e50bf96a8722c4c5a99a7fa617f168438c57,0,Andrew Onishuk,2017-03-29 14:55:56+03:00,['dc9cd35ea45f741b2d11cd298691e500a8be727e'],1,48,49,26122921,2,0,0,0,28848
b1c885221f85831f3ac7bd386550836e6d16f2af,0,Andrew Onishuk,2017-03-29 14:55:56+03:00,['bc01e50bf96a8722c4c5a99a7fa617f168438c57'],572,515,1087,26124008,27,0.921348315,0,0.011235955,28848
7bb3d8e560e6e9b70438915ab598cb6b87ec8995,0,Andrew Onishuk,2017-03-29 14:55:56+03:00,['b1c885221f85831f3ac7bd386550836e6d16f2af'],8,67,75,26124083,5,1,1,1,28848
82e31c129c0645140443a4b693a9b182daed378e,0,Andrew Onishuk,2017-03-29 14:55:56+03:00,['7bb3d8e560e6e9b70438915ab598cb6b87ec8995'],14,14,28,26124111,3,,,,28848
fcb9d2232c352fe0bba77a0763e27c36740ac0e0,0,Andrew Onishuk,2017-03-29 14:55:56+03:00,['82e31c129c0645140443a4b693a9b182daed378e'],3,1,4,26124115,1,,,,28848
494c26a517a4b1b014860e9b7bb9a11a411161d5,0,Andrew Onishuk,2017-03-29 14:55:56+03:00,['fcb9d2232c352fe0bba77a0763e27c36740ac0e0'],21,322,343,26124458,20,0.629213483,0.865168539,1,28854
f14ede83322fb6a43a565ef4de81adbaab40f3a3,0,Andrew Onishuk,2017-03-29 14:55:56+03:00,['494c26a517a4b1b014860e9b7bb9a11a411161d5'],0,1,1,26124459,1,1,1,0,28854
61a884ca02b289d27a22716d442787fba75bfd65,0,Andrew Onishuk,2017-03-29 14:55:56+03:00,['f14ede83322fb6a43a565ef4de81adbaab40f3a3'],57,372,429,26124888,19,0.708860759,0.835443038,0.651898734,28857
3cf12c932770c6029e839b0959f1c23a7f8f1b81,0,Andrew Onishuk,2017-03-29 14:55:56+03:00,['61a884ca02b289d27a22716d442787fba75bfd65'],12,26,38,26124926,3,1,1,1,28857
b65cc4705eb8514a2479b991eac0ae70f3ec1283,0,Andrew Onishuk,2017-03-29 14:55:56+03:00,['3cf12c932770c6029e839b0959f1c23a7f8f1b81'],3,3,6,26124932,2,,0,,28857
f48f5de079b98068fe7609faef87102d2ab8b7ef,1,Andrew Onishuk,2017-03-29 14:55:56+03:00,['b65cc4705eb8514a2479b991eac0ae70f3ec1283'],6,236,242,26125174,4,0.697368421,0.986842105,1,28859
61deee90ba2e632d90b55e1596a1d4cb19c90baf,0,Andrew Onishuk,2017-03-29 14:55:56+03:00,['f48f5de079b98068fe7609faef87102d2ab8b7ef'],213,534,747,26125921,58,,,,28861
e751030110bc07d671599e941915e8bff5dce812,0,Andrew Onishuk,2017-03-29 14:55:56+03:00,['61deee90ba2e632d90b55e1596a1d4cb19c90baf'],0,45,45,26125966,4,0.96,0.96,1,28861
7766742fee7468f31bd3d9a3e9099d0325291394,0,Andrew Onishuk,2017-03-29 14:55:56+03:00,['e751030110bc07d671599e941915e8bff5dce812'],20,74,94,26126060,3,0.04,0.04,1,28861
f6078ea37fcbd567f49f9bc83feeef55122c2282,0,Andrew Onishuk,2017-03-29 14:55:56+03:00,['7766742fee7468f31bd3d9a3e9099d0325291394'],0,9,9,26126069,1,,,,28861
64b132bd4e9f51a97dffa7c5df842a7a81f99402,1,Andrew Onishuk,2017-03-29 14:55:56+03:00,['f6078ea37fcbd567f49f9bc83feeef55122c2282'],1,163,164,26126233,2,0.040650407,0.967479675,1,28861
3e559d7e531c4b022a3bd6ab8861403ed52a8285,1,Andrew Onishuk,2017-03-29 14:55:56+03:00,['64b132bd4e9f51a97dffa7c5df842a7a81f99402'],48,1,49,26126282,2,1,1,1,28861
c34f768dcff37aeefdd96670758925d3abfb059d,0,Andrew Onishuk,2017-03-29 14:55:56+03:00,['3e559d7e531c4b022a3bd6ab8861403ed52a8285'],1,23,24,26126306,2,1,1,1,28861
b56eb95153d009e3f97e2814414f192b5c9560b3,0,Andrew Onishuk,2017-03-29 14:55:56+03:00,['c34f768dcff37aeefdd96670758925d3abfb059d'],1,1,2,26126308,1,,,,28861
210b70d6e8090f1bebee2b3e1e7eebd02b5dbb65,0,Andrew Onishuk,2017-03-29 14:55:56+03:00,['b56eb95153d009e3f97e2814414f192b5c9560b3'],0,12,12,26126320,1,,,,28861
be9df631100276c8ea5469137e4a1d0cdc05941a,1,Andrew Onishuk,2017-03-29 14:55:56+03:00,['210b70d6e8090f1bebee2b3e1e7eebd02b5dbb65'],11,141,152,26126472,6,0.227272727,0.227272727,0.227272727,28862
1246ee20c62eedeffaa4eb8e12ba8f4dd27d246b,0,Andrew Onishuk,2017-03-29 14:55:56+03:00,['be9df631100276c8ea5469137e4a1d0cdc05941a'],0,446,446,26126918,8,0.050251256,0.809045226,1,28864
3bcf2ad89dd355321995410f4120527e94b1aecf,0,Andrew Onishuk,2017-03-29 14:55:56+03:00,['1246ee20c62eedeffaa4eb8e12ba8f4dd27d246b'],1,74,75,26126993,4,0.5,0.5,0.791666667,28865
df752f86e5e887e67016e81125702192a97f46a7,1,Andrew Onishuk,2017-03-29 14:56:00+03:00,['3bcf2ad89dd355321995410f4120527e94b1aecf'],23,186,209,26127202,6,0.76,0.76,1,28868
edbb549206a0a48b9e6619fa702fd7f5a8d451aa,1,Attila Doroszlai,2017-03-29 14:42:14+02:00,['ec1505f215c718f54d59cf0ba2e60f37b6515b86'],5832,5822,11654,26138856,926,0.9,1,0.1,28868
4d6c80febe439377d3753867196b0499d2ed4ba3,1,Oleg Nechiporenko,2017-03-29 15:59:54+03:00,['edbb549206a0a48b9e6619fa702fd7f5a8d451aa'],42,57,99,26138955,14,0,0,0,28868
f44d9d22b2c03797cf76c8fefd4e919f2d5b3c77,1,ababiichuk,2017-03-29 18:31:14+03:00,['4d6c80febe439377d3753867196b0499d2ed4ba3'],1,15,16,26138971,1,1,1,1,28868
5a78a93fba4336c128b1315bc4463f61e6f6c981,0,Aravindan Vijayan,2017-03-29 14:13:42-07:00,['f44d9d22b2c03797cf76c8fefd4e919f2d5b3c77'],2,27,29,26139000,4,0,0,1,28868
efa0b5dabb07dbd1d917877c945306f60e370dcb,0,Aravindan Vijayan,2017-03-29 14:20:17-07:00,['5a78a93fba4336c128b1315bc4463f61e6f6c981'],4,18,22,26139022,4,,,,28868
77dd10c29b72a9690df1bf09c5ef33b6b3a41977,1,Nate Cole,2017-03-29 18:19:20-04:00,['efa0b5dabb07dbd1d917877c945306f60e370dcb'],1,279,280,26139302,8,0.112359551,0.539325843,1,28870
70c23bcd18502095acaa3d0794f877b24a7cab8b,0,Nate Cole,2017-03-29 18:39:48-04:00,"['3f0752ec09ab7df1831458e26f99a793e433514d', '77dd10c29b72a9690df1bf09c5ef33b6b3a41977']",203778,34245,238023,26377325,2493,,,,28870
8d075c6a1ae8c6b1d2c8e64b717dac464496f415,1,Xi Wang,2017-03-29 18:11:39-07:00,['77dd10c29b72a9690df1bf09c5ef33b6b3a41977'],9,26,35,26377360,2,0.928571429,1,1,28870
6ea7b42a1409bb438e8dd0c4da2898032ca339e8,0,Xi Wang,2017-03-29 18:11:39-07:00,['8d075c6a1ae8c6b1d2c8e64b717dac464496f415'],0,1,1,26377361,1,,,,28870
a2f6d8c091eab2d8f2ad97aa051f4d56f72b56be,0,Andrew Onishuk,2017-03-30 10:21:32+03:00,['6ea7b42a1409bb438e8dd0c4da2898032ca339e8'],0,62,62,26377423,4,,,,28874
7fc77d832c614bfba894a9cc2d1d01d7683a3062,1,Andrew Onishuk,2017-03-30 10:24:00+03:00,['a2f6d8c091eab2d8f2ad97aa051f4d56f72b56be'],0,86,86,26377509,11,,,,28885
1e46bf5d6219df934d83df3b77255c40be0066ac,0,Andrew Onishuk,2017-03-30 10:24:48+03:00,['7fc77d832c614bfba894a9cc2d1d01d7683a3062'],0,92,92,26377601,12,,,,28897
fb8d4634807b05d0ec79af70d533c15d6e229ad9,0,Attila Doroszlai,2017-03-30 09:49:43+02:00,['1e46bf5d6219df934d83df3b77255c40be0066ac'],64,12,76,26377677,1,,,,28897
9feb5d0f9a4d2d287d6724896668fc297aa0a778,1,Lisnichenko Dmitro,2017-03-30 15:48:24+03:00,['fb8d4634807b05d0ec79af70d533c15d6e229ad9'],390,404,794,26378471,19,1,1,0.047619048,28897
904370a6069d6281a90232692b42e86bdbf45882,0,Robert Levas,2017-03-30 09:16:55-04:00,['9feb5d0f9a4d2d287d6724896668fc297aa0a778'],1,9,10,26378481,1,,,,28897
43f02f903202761c0ba8b226e7fe7ca89dcd96bf,1,Dipayan Bhowmick,2017-03-30 21:51:14+05:18,['904370a6069d6281a90232692b42e86bdbf45882'],0,4,4,26378485,2,1,1,1,28897
982f9c626b50d671b0a8a01997bb96e8bc22648e,1,Alex Antonenko,2017-03-30 19:40:06+03:00,['43f02f903202761c0ba8b226e7fe7ca89dcd96bf'],14,14,28,26378513,5,,,,28897
be83a39eb9f5c91e1032e3d50c02c07543bcb84c,1,Di Li,2017-03-30 15:24:02-04:00,['982f9c626b50d671b0a8a01997bb96e8bc22648e'],1,47,48,26378561,2,0,0,0,28897
8113f04a0db63db003986a8a7f7a830279e0d458,0,Attila Doroszlai,2017-03-30 21:30:35+02:00,['be83a39eb9f5c91e1032e3d50c02c07543bcb84c'],4,4,8,26378569,1,,,,28897
25bfb9ec62a44d525a19340d25276f3358f672e5,0,Di Li,2017-03-30 15:35:20-04:00,['8113f04a0db63db003986a8a7f7a830279e0d458'],8,361,369,26378938,12,0.723076923,0.892307692,0.923076923,28900
651310663d99ea8513d105f5af707097c31b9fa4,1,oleewere,2017-03-30 21:47:58+02:00,['25bfb9ec62a44d525a19340d25276f3358f672e5'],26,165,191,26379129,10,1,1,1,28903
f1f4739893800ab674372d7aa3cd487d2797d6e2,0,Aravindan Vijayan,2017-03-30 13:07:55-07:00,['651310663d99ea8513d105f5af707097c31b9fa4'],15,15,30,26379159,4,,,,28903
9f03180cb458b7224350e8b40ac3dba93b0fed1d,0,Yusaku Sako,2017-03-30 13:41:33-07:00,['f1f4739893800ab674372d7aa3cd487d2797d6e2'],0,1,1,26379160,1,,,,28903
ee24a25d161453d7f42348f8ddfbe81459ac7665,1,Sumit Mohanty,2017-03-30 14:38:39-07:00,['9f03180cb458b7224350e8b40ac3dba93b0fed1d'],7,7,14,26379174,7,,,,28903
13423dc0727d6129cea39d1ef7be7f4e4402be3c,0,Andrew Onishuk,2017-03-31 10:21:45+03:00,['df752f86e5e887e67016e81125702192a97f46a7'],2,1,3,26379177,1,0,0,0,28903
e8080350f531f30abc129545e5ade90550d45bff,1,Andrew Onishuk,2017-03-31 10:21:45+03:00,['13423dc0727d6129cea39d1ef7be7f4e4402be3c'],5832,5822,11654,26390831,926,0.9,1,0.1,28903
27af648e30affd57191c3fff62760cc0ee9c6ea1,0,Andrew Onishuk,2017-03-31 10:21:45+03:00,['e8080350f531f30abc129545e5ade90550d45bff'],42,57,99,26390930,14,0,0,0,28903
455870b1d1532e3719d67c65bf429af14f456558,1,Andrew Onishuk,2017-03-31 10:21:45+03:00,['27af648e30affd57191c3fff62760cc0ee9c6ea1'],1,15,16,26390946,1,1,1,1,28903
102dcde8cfc3b4b189b26a081bf922d9ad0ac34c,0,Andrew Onishuk,2017-03-31 10:21:45+03:00,['455870b1d1532e3719d67c65bf429af14f456558'],2,27,29,26390975,4,0,0,1,28903
179b3565aafee3a340875380c6ae10aad0cd7534,0,Andrew Onishuk,2017-03-31 10:21:45+03:00,['102dcde8cfc3b4b189b26a081bf922d9ad0ac34c'],4,18,22,26390997,4,,,,28903
5b71200e23caad1fbe6b1ec093fa347b9d47e08a,0,Andrew Onishuk,2017-03-31 10:21:45+03:00,['179b3565aafee3a340875380c6ae10aad0cd7534'],1,279,280,26391277,8,0.112359551,0.539325843,1,28905
16b158c3cb6c94cb6eca5d3434b835d1399bfd33,0,Andrew Onishuk,2017-03-31 10:21:45+03:00,['5b71200e23caad1fbe6b1ec093fa347b9d47e08a'],9,26,35,26391312,2,0.928571429,1,1,28905
8d35583dcade309564fa1b5c317b3ebfe0f399f2,0,Andrew Onishuk,2017-03-31 10:21:45+03:00,['16b158c3cb6c94cb6eca5d3434b835d1399bfd33'],0,1,1,26391313,1,,,,28905
02e38ad1b5becb7290c821ebf5303dfcefb01f2d,0,Andrew Onishuk,2017-03-31 10:21:45+03:00,['8d35583dcade309564fa1b5c317b3ebfe0f399f2'],0,62,62,26391375,4,,,,28909
441aaa407a5016cb59231893198762779acdf230,0,Andrew Onishuk,2017-03-31 10:21:45+03:00,['02e38ad1b5becb7290c821ebf5303dfcefb01f2d'],0,86,86,26391461,11,,,,28920
47a9421ac9434383fa97a422eeca2347f976dde6,0,Andrew Onishuk,2017-03-31 10:21:45+03:00,['441aaa407a5016cb59231893198762779acdf230'],0,92,92,26391553,12,,,,28932
623c12cd56c3794adc0b5873ecc5e5406b07d73a,0,Andrew Onishuk,2017-03-31 10:21:45+03:00,['47a9421ac9434383fa97a422eeca2347f976dde6'],64,12,76,26391629,1,,,,28932
0ef14f56ac6fb7b7d3b12383a15f9810fab56887,0,Andrew Onishuk,2017-03-31 10:21:45+03:00,['623c12cd56c3794adc0b5873ecc5e5406b07d73a'],390,404,794,26392423,19,1,1,0.047619048,28932
192a30fbaf7969cdb6b541724b65b17a6ab00f80,0,Andrew Onishuk,2017-03-31 10:21:45+03:00,['0ef14f56ac6fb7b7d3b12383a15f9810fab56887'],1,9,10,26392433,1,,,,28932
f6917a9b8e4946b71b8d4964d56df640e1283bea,0,Andrew Onishuk,2017-03-31 10:21:45+03:00,['192a30fbaf7969cdb6b541724b65b17a6ab00f80'],0,4,4,26392437,2,1,1,1,28932
c614fb71059f9c57ad91f2b5842c9c140d29b9ac,0,Andrew Onishuk,2017-03-31 10:21:45+03:00,['f6917a9b8e4946b71b8d4964d56df640e1283bea'],14,14,28,26392465,5,,,,28932
77fab90cb4fe5e25e3ecbbe8b3ba4d8fc0570f19,0,Andrew Onishuk,2017-03-31 10:21:45+03:00,['c614fb71059f9c57ad91f2b5842c9c140d29b9ac'],1,47,48,26392513,2,0,0,0,28932
841e5b8699802e6b9f74f94833e5dafca6b27e6a,0,Andrew Onishuk,2017-03-31 10:21:45+03:00,['77fab90cb4fe5e25e3ecbbe8b3ba4d8fc0570f19'],4,4,8,26392521,1,,,,28932
9433038b1446c66c0ae704657c62b97839c3877a,0,Andrew Onishuk,2017-03-31 10:21:45+03:00,['841e5b8699802e6b9f74f94833e5dafca6b27e6a'],8,361,369,26392890,12,0.723076923,0.892307692,0.923076923,28935
14c2b80f3a220ce21eaa9f3edf73fd57a1217090,0,Andrew Onishuk,2017-03-31 10:21:45+03:00,['9433038b1446c66c0ae704657c62b97839c3877a'],26,165,191,26393081,10,1,1,1,28938
44ceae6d22fcee6b3bdac8352d6c73983b961209,0,Andrew Onishuk,2017-03-31 10:21:45+03:00,['14c2b80f3a220ce21eaa9f3edf73fd57a1217090'],15,15,30,26393111,4,,,,28938
d477af578b1c4b6e57f1cddebd5c3f6913025a7f,0,Andrew Onishuk,2017-03-31 10:21:45+03:00,['44ceae6d22fcee6b3bdac8352d6c73983b961209'],0,1,1,26393112,1,,,,28938
fc6ab248b8a4cf1852c6e040d53b8c970e63a549,1,Andrew Onishuk,2017-03-31 10:21:45+03:00,['d477af578b1c4b6e57f1cddebd5c3f6913025a7f'],7,7,14,26393126,7,,,,28938
72b784249cc30da875393a411b9a78242256298c,1,Andrew Onishuk,2017-03-31 10:21:49+03:00,['fc6ab248b8a4cf1852c6e040d53b8c970e63a549'],0,3439,3439,26396565,22,0.579656863,0.630514706,0.582720588,28956
388c6c102a346b7d0859f9f30fcd3c99164d0a63,0,Oleg Nechiporenko,2017-03-31 11:50:22+03:00,['ee24a25d161453d7f42348f8ddfbe81459ac7665'],4,4,8,26396573,1,,,,28956
f37a342a040a1a9b4ae951c2dfabbf43b3bb1173,1,ababiichuk,2017-03-31 15:08:53+03:00,['388c6c102a346b7d0859f9f30fcd3c99164d0a63'],257,279,536,26397109,26,1,1,1,28956
9741236f3c8b4a8a293fa0b7db5c64c0e7aa704d,0,Sandor Magyari,2017-03-31 14:52:03+02:00,['f37a342a040a1a9b4ae951c2dfabbf43b3bb1173'],4,8,12,26397121,2,0,1,0,28956
f615c6760211f3d23625c4c952d47ce5db85af2a,1,Andrii Tkach,2017-03-31 16:16:16+03:00,['9741236f3c8b4a8a293fa0b7db5c64c0e7aa704d'],94,1001,1095,26398216,11,0.989349112,1,1,28960
d245d1ee3f992a64cb086a6e3692ad8712814845,0,Renjith Kamath,2017-03-31 19:55:09+05:18,['f615c6760211f3d23625c4c952d47ce5db85af2a'],9,1,10,26398226,1,1,1,0,28960
8342abd210dff3cce7982ea91d17379f0b6270fe,0,Alex Antonenko,2017-03-31 18:55:48+03:00,['d245d1ee3f992a64cb086a6e3692ad8712814845'],1,1,2,26398228,1,,,,28960
3dcfe53f378101998d822168f153649355e9714f,1,Aleksandr Kovalenko,2017-03-31 19:07:47+03:00,['8342abd210dff3cce7982ea91d17379f0b6270fe'],21,24,45,26398273,7,1,1,1,28960
52bca5cc6d93f139326a53953d4e73f9a9c29fad,0,Attila Doroszlai,2017-03-31 19:37:50+02:00,['3dcfe53f378101998d822168f153649355e9714f'],2,136,138,26398411,4,0.894736842,0.894736842,1,28961
e14cc6059e1d85819c8ef6d241fb57708256603f,1,ababiichuk,2017-03-31 20:53:37+03:00,['52bca5cc6d93f139326a53953d4e73f9a9c29fad'],26,26,52,26398463,4,1,1,1,28961
cd92d2df89b3166c82fbd95fca1b605574b27bcd,1,Attila Doroszlai,2017-03-31 19:58:48+02:00,['e14cc6059e1d85819c8ef6d241fb57708256603f'],91,66,157,26398620,14,1,0,0,28961
8959f366ec7490800525447409ade29e25d285aa,1,oleewere,2017-03-31 22:31:33+02:00,['cd92d2df89b3166c82fbd95fca1b605574b27bcd'],8,9,17,26398637,1,,,,28961
7b8ca7f690d835a6845dbd57e7aaf366951876a1,0,Swapan Shridhar,2017-03-31 14:57:03-07:00,['8959f366ec7490800525447409ade29e25d285aa'],1,1,2,26398639,1,,,,28961
320a8f5b4ee9581663836d05489eabb9cf195c52,0,Sumit Mohanty,2017-03-31 16:41:24-07:00,['7b8ca7f690d835a6845dbd57e7aaf366951876a1'],8,8,16,26398655,1,,,,28961
1a08c4980295ebda1b71db17eb6389fb71f928fd,1,Jonathan Hurley,2017-03-31 21:14:45-04:00,['320a8f5b4ee9581663836d05489eabb9cf195c52'],196,227,423,26399078,11,0,0.368421053,1,28961
b88512e719f894d9ab3d5cb956a29f21e44fc29a,0,Gaurav Nagar,2017-04-01 08:47:53+05:18,['1a08c4980295ebda1b71db17eb6389fb71f928fd'],8,11,19,26399097,1,1,1,1,28961
daad28f49a7525229e4759bb4e0c3fc6c6c3907d,0,Andrew Onishuk,2017-04-01 10:07:36+03:00,['72b784249cc30da875393a411b9a78242256298c'],4,4,8,26399105,1,,,,28961
ae647a2a4f58534cf18a3be7d4ca383a9c1f4e51,1,Andrew Onishuk,2017-04-01 10:07:36+03:00,['daad28f49a7525229e4759bb4e0c3fc6c6c3907d'],257,279,536,26399641,26,1,1,1,28961
ebfc8486463004714d69cf985f37ea6c02ed8bb9,0,Andrew Onishuk,2017-04-01 10:07:36+03:00,['ae647a2a4f58534cf18a3be7d4ca383a9c1f4e51'],4,8,12,26399653,2,0,1,0,28961
89feb0a7f32c2373cac1058d2fa604522344990b,1,Andrew Onishuk,2017-04-01 10:07:36+03:00,['ebfc8486463004714d69cf985f37ea6c02ed8bb9'],94,1001,1095,26400748,11,0.989349112,1,1,28965
34c428bf1a5421e4cc99b59610a016b272f81696,0,Andrew Onishuk,2017-04-01 10:07:36+03:00,['89feb0a7f32c2373cac1058d2fa604522344990b'],9,1,10,26400758,1,1,1,0,28965
b9d9612786eda9ebe88123e73bac277a9d7c07db,0,Andrew Onishuk,2017-04-01 10:07:36+03:00,['34c428bf1a5421e4cc99b59610a016b272f81696'],1,1,2,26400760,1,,,,28965
d13e6fa3e7fa59073d4cc222477d48d8d9073aa2,0,Andrew Onishuk,2017-04-01 10:07:36+03:00,['b9d9612786eda9ebe88123e73bac277a9d7c07db'],21,24,45,26400805,7,1,1,1,28965
dc05119956a0001001d3edde443612bf42eb9ee0,1,Andrew Onishuk,2017-04-01 10:07:36+03:00,['d13e6fa3e7fa59073d4cc222477d48d8d9073aa2'],2,136,138,26400943,4,0.894736842,0.894736842,1,28966
00f269b2e60e41573c80f244f9a3376f94cc36f5,1,Andrew Onishuk,2017-04-01 10:07:36+03:00,['dc05119956a0001001d3edde443612bf42eb9ee0'],26,26,52,26400995,4,1,1,1,28966
c17979cb734779f0a8511e5c852399f56cbcfa97,1,Andrew Onishuk,2017-04-01 10:07:36+03:00,['00f269b2e60e41573c80f244f9a3376f94cc36f5'],91,66,157,26401152,14,1,0,0,28966
51143f312fb86f6ce66bdbb844daff6de255ee89,0,Andrew Onishuk,2017-04-01 10:07:36+03:00,['c17979cb734779f0a8511e5c852399f56cbcfa97'],8,9,17,26401169,1,,,,28966
55992e507f18136013a342231d782156b925a3c3,0,Andrew Onishuk,2017-04-01 10:07:36+03:00,['51143f312fb86f6ce66bdbb844daff6de255ee89'],1,1,2,26401171,1,,,,28966
805af82db50c1dc12182ac705116ea1e57509ca9,0,Andrew Onishuk,2017-04-01 10:07:36+03:00,['55992e507f18136013a342231d782156b925a3c3'],8,8,16,26401187,1,,,,28966
aba473e84a5a24d12b29a2bf9e858019c023f6fd,1,Andrew Onishuk,2017-04-01 10:07:36+03:00,['805af82db50c1dc12182ac705116ea1e57509ca9'],196,227,423,26401610,11,0,0.368421053,1,28966
b4e15b70c5b7b3144926c30ca1a396161f08aabd,0,Andrew Onishuk,2017-04-01 10:07:36+03:00,['aba473e84a5a24d12b29a2bf9e858019c023f6fd'],8,11,19,26401629,1,1,1,1,28966
c7612bcf9b3e91e75416b484ea03bfc2169e1c29,1,Andrew Onishuk,2017-04-01 10:07:38+03:00,['b4e15b70c5b7b3144926c30ca1a396161f08aabd'],3,3636,3639,26405268,30,0.776672694,0.867992767,0.634719711,28994
3cb45e849a45b71142eb294a6625d9ec2d5c050a,1,Jaimin Jetly,2017-04-02 22:11:51-07:00,['e250b9012d712209cca28be6ca75e5040499fabe'],1660,19816,21476,26426744,19,,,,28996
3bab2125fc9570398ed1514aa11d9b1d910ecde1,1,Mugdha Varadkar,2017-04-03 11:28:04+05:18,['b88512e719f894d9ab3d5cb956a29f21e44fc29a'],13,75,88,26426832,13,1,1,1,28996
fc36391cf6e2b6aec04476af46eceaf91ceed01b,1,Attila Doroszlai,2017-04-03 12:05:16+02:00,['3bab2125fc9570398ed1514aa11d9b1d910ecde1'],21,44,65,26426897,4,0,0.1,1,28996
0ffb42b5e52176cd55f14f7303e34483c608cbfa,0,Attila Doroszlai,2017-04-03 14:05:05+02:00,['fc36391cf6e2b6aec04476af46eceaf91ceed01b'],1,0,1,26426898,1,,,,28996
419513504e801e86509a7126f08dfcb551f0aad6,0,Andrew Onishuk,2017-04-03 15:06:08+03:00,['c7612bcf9b3e91e75416b484ea03bfc2169e1c29'],13,75,88,26426986,13,1,1,1,28996
a022ea95a483046bbcd88c47310d191f776dd4dc,1,Andrew Onishuk,2017-04-03 15:06:08+03:00,['419513504e801e86509a7126f08dfcb551f0aad6'],21,44,65,26427051,4,0,0.1,1,28996
8bef3b489ce70a8e45b3e25f940fed84b0c7e960,1,Andrew Onishuk,2017-04-03 15:06:09+03:00,['a022ea95a483046bbcd88c47310d191f776dd4dc'],8,508,516,26427567,10,0,0,0,29004
9fec5ac5ae9208f18d9e4180d8482dc14f05c8b3,1,Vitaly Brodetskyi,2017-04-03 15:38:44+03:00,['0ffb42b5e52176cd55f14f7303e34483c608cbfa'],0,1006,1006,26428573,14,0.420765027,1,0.836065574,29018
6892e43522e40722a62d142eed8c2dfd14ac68f2,0,padmapriyanitt,2017-04-03 18:09:47+05:18,['9fec5ac5ae9208f18d9e4180d8482dc14f05c8b3'],1,9,10,26428583,3,1,1,1,29018
09b0b46cc66169b9741c9833cdb42196690b5fd3,0,Andrew Onishuk,2017-04-03 16:18:23+03:00,['6892e43522e40722a62d142eed8c2dfd14ac68f2'],0,64,64,26428647,15,,,,29018
f389293bfb3c9aa1594d3853bf127a1e521e2587,1,Attila Doroszlai,2017-04-03 15:28:21+02:00,['09b0b46cc66169b9741c9833cdb42196690b5fd3'],3,3,6,26428653,3,,,,29018
f8827fea405482289a8849ebe2a7dcf2fee11294,1,Eugene Chekanskiy,2017-04-03 16:46:27+03:00,['f389293bfb3c9aa1594d3853bf127a1e521e2587'],116,98,214,26428867,2,1,0.666666667,0,29018
ad118045afd5381b7d028294faaa1b8fc3c41b8e,1,Nate Cole,2017-04-03 10:25:43-04:00,['f8827fea405482289a8849ebe2a7dcf2fee11294'],16,352,368,26429235,5,0.065789474,0.921052632,0.651315789,29019
d5249c6113cb005796bd4b1db7687e6f67cdc9cf,0,Andrew Onishuk,2017-04-03 17:33:11+03:00,['ad118045afd5381b7d028294faaa1b8fc3c41b8e'],2,2,4,26429239,1,,,,29019
a1cbf83ea9923d1ad7c98111a4382ef87feb4bae,1,Vitaly Brodetskyi,2017-04-03 19:28:26+03:00,['d5249c6113cb005796bd4b1db7687e6f67cdc9cf'],1,1,2,26429241,1,,,,29019
c5e5999ee7adf765b043911c574884fc016364ad,1,Andrii Tkach,2017-04-03 21:17:07+03:00,['a1cbf83ea9923d1ad7c98111a4382ef87feb4bae'],200,209,409,26429650,24,1,1,1,29020
8f95262d43726e80a2922313d97c68db1ae4c2f4,0,Attila Doroszlai,2017-04-03 20:26:04+02:00,['c5e5999ee7adf765b043911c574884fc016364ad'],4,4,8,26429658,1,,,,29020
48af3ee8dbe221872abd8ac4fc736acfa30f78ba,0,Lisnichenko Dmitro,2017-04-03 21:36:20+03:00,['8f95262d43726e80a2922313d97c68db1ae4c2f4'],0,220,220,26429878,22,,,,29020
ba63ea303870b3091d2a512883bb0105c46dbc75,1,Attila Doroszlai,2017-04-03 23:04:05+02:00,['48af3ee8dbe221872abd8ac4fc736acfa30f78ba'],75,77,152,26430030,17,0,1,1,29020
dca1ebd6be1c3843afb074e6d03bdd53508e08a5,1,Alejandro Fernandez,2017-04-03 16:19:44-07:00,['ba63ea303870b3091d2a512883bb0105c46dbc75'],5,5,10,26430040,1,,,,29020
e945bb1869dd8abb71cfd1285b6a23a0df5e39f0,0,padmapriyanitt,2017-04-04 11:35:45+05:18,['dca1ebd6be1c3843afb074e6d03bdd53508e08a5'],15,19,34,26430074,1,,,,29020
8f8fc11d34bd2a72cff194e22e176913d874fc10,0,padmapriyanitt,2017-04-04 11:43:13+05:18,['e945bb1869dd8abb71cfd1285b6a23a0df5e39f0'],10,10,20,26430094,4,,,,29020
900070d8e4ed7bfae200831bd5d4adb58efcc715,0,padmapriyanitt,2017-04-04 11:48:04+05:18,['8f8fc11d34bd2a72cff194e22e176913d874fc10'],2,4,6,26430100,4,,,,29020
40a2065581b338cb4789521a91c45f6a21a677d1,1,padmapriyanitt,2017-04-04 11:54:36+05:18,['900070d8e4ed7bfae200831bd5d4adb58efcc715'],2,5,7,26430107,2,0,1,1,29020
a1d58c1652920a7ab0cd7cee15c7aea79d2febb1,0,Nitiraj Singh Rathore,2017-04-04 12:27:08+05:18,['40a2065581b338cb4789521a91c45f6a21a677d1'],0,1,1,26430108,1,1,1,1,29020
1022fdbc5a98b6f17d7a2745d2ca55c4b1fdba6d,0,Nitiraj Singh Rathore,2017-04-04 12:31:23+05:18,['a1d58c1652920a7ab0cd7cee15c7aea79d2febb1'],3,48,51,26430159,1,0.033333333,0.033333333,0.966666667,29020
19848685efdac9731c820b0c7902725e5eafa829,1,Andrew Onishuk,2017-04-04 11:41:31+03:00,['1022fdbc5a98b6f17d7a2745d2ca55c4b1fdba6d'],7,11,18,26430177,10,,,,29020
92e5b590c99daf71996f95e2a8c45a76fd20df82,1,padmapriyanitt,2017-04-04 14:57:30+05:18,['19848685efdac9731c820b0c7902725e5eafa829'],5,15,20,26430197,2,,,,29020
4004ee89c989241ac5c6d439f02a06ee0dd61f03,1,padmapriyanitt,2017-04-04 16:09:27+05:18,['92e5b590c99daf71996f95e2a8c45a76fd20df82'],1,3,4,26430201,1,0,0,1,29020
e0e8a041be2fa8896ba429ad481be3935efe1e1e,1,padmapriyanitt,2017-04-04 16:14:18+05:18,['4004ee89c989241ac5c6d439f02a06ee0dd61f03'],2,9,11,26430212,1,1,1,1,29020
d711d7a1f90074ab65431e6f58c6551e224df43b,1,Mugdha Varadkar,2017-04-04 18:03:09+05:18,['e0e8a041be2fa8896ba429ad481be3935efe1e1e'],6,540,546,26430758,23,,,,29029
dd2c2d0f0a64d8c64c74d370b4b7b0524d0f78d1,0,Aleksandr Kovalenko,2017-04-04 17:27:31+03:00,['d711d7a1f90074ab65431e6f58c6551e224df43b'],1,1,2,26430760,1,,,,29029
36629d52bc5ed552f30a47bac625305db88aba57,0,ababiichuk,2017-04-04 18:12:35+03:00,['dd2c2d0f0a64d8c64c74d370b4b7b0524d0f78d1'],18,42,60,26430820,1,0,0.148148148,1,29029
6ee881bcf22016fa0213a11a13fc3b93356caabf,0,ababiichuk,2017-04-04 19:22:31+03:00,['36629d52bc5ed552f30a47bac625305db88aba57'],105,24,129,26430949,4,1,0.24137931,1,29029
3ca41f26205de3ac6c316dde749abcedf4082509,1,Di Li,2017-04-04 13:58:58-04:00,['6ee881bcf22016fa0213a11a13fc3b93356caabf'],15,83,98,26431047,3,0.311111111,0.8,1,29029
fe0aa448bd16a225ccb0bab8315fd2b8b34fba75,1,Jonathan Hurley,2017-04-04 16:52:10-04:00,['3ca41f26205de3ac6c316dde749abcedf4082509'],142,141,283,26431330,17,0,0.642857143,0.857142857,29029
8c2ff91c7c632d01c35dec160b0debdab730ca82,0,Jonathan Hurley,2017-04-04 17:14:33-04:00,['fe0aa448bd16a225ccb0bab8315fd2b8b34fba75'],1,1,2,26431332,1,,,,29029
b491509ab65353494d8660e2954c87c3a6f1abf4,0,Richard Zang,2017-04-04 15:19:12-07:00,['8c2ff91c7c632d01c35dec160b0debdab730ca82'],4,4,8,26431340,1,,,,29029
b4fc47f5ea849a5e8fafea0842397fbb1d73272c,1,pallavkul,2017-04-05 11:05:27+05:18,['b491509ab65353494d8660e2954c87c3a6f1abf4'],23,27,50,26431390,3,,,,29029
3b25533430a181b6b83f4f1cf665c8f9aceafd4e,1,pallavkul,2017-04-05 11:21:30+05:18,['b4fc47f5ea849a5e8fafea0842397fbb1d73272c'],0,4,4,26431394,1,,,,29029
6c0b38e00b49eb1f7ac879053ee161496c971a3f,0,ababiichuk,2017-04-05 15:05:29+03:00,['3b25533430a181b6b83f4f1cf665c8f9aceafd4e'],2,5,7,26431401,1,1,1,1,29029
7d0baec7d7ddad29a6955f3af2ff6f020136abcd,1,Andrii Tkach,2017-04-05 16:25:23+03:00,['6c0b38e00b49eb1f7ac879053ee161496c971a3f'],113,176,289,26431690,10,0,0,1,29029
e61d111245fd7631a4fd0a2d572d88b3f86a4b5f,0,Vivek Ratnavel Subramanian,2017-04-05 15:43:26-07:00,['7d0baec7d7ddad29a6955f3af2ff6f020136abcd'],82,231,313,26432003,1,,,,29029
2ee12f4c4af62d5ce004e869f5a248e982a4245f,0,padmapriyanitt,2017-04-06 12:00:24+05:18,['e61d111245fd7631a4fd0a2d572d88b3f86a4b5f'],11,72,83,26432086,4,0.857142857,0.857142857,1,29031
8e15ba6ad3ee9e8ce653ca717f4fa97e2d09889a,0,padmapriyanitt,2017-04-06 12:04:39+05:18,['2ee12f4c4af62d5ce004e869f5a248e982a4245f'],3,14,17,26432103,3,1,1,1,29031
e0412e86af1f5f395b525621ee60bb725aeef980,0,Andrew Onishuk,2017-04-06 12:32:56+03:00,['8bef3b489ce70a8e45b3e25f940fed84b0c7e960'],1,0,1,26432104,1,,,,29031
27da4c8f2ac1d6b5ae93091bbdc04603bb8d4244,1,Andrew Onishuk,2017-04-06 12:32:56+03:00,['e0412e86af1f5f395b525621ee60bb725aeef980'],0,1006,1006,26433110,14,0.420765027,1,0.836065574,29045
5c91e4003c75d6c71f58c18501791dbeba91418f,0,Andrew Onishuk,2017-04-06 12:32:56+03:00,['27da4c8f2ac1d6b5ae93091bbdc04603bb8d4244'],1,9,10,26433120,3,1,1,1,29045
97338089198e62a558cadc2b2c2414ba424d9346,0,Andrew Onishuk,2017-04-06 12:32:56+03:00,['5c91e4003c75d6c71f58c18501791dbeba91418f'],0,64,64,26433184,15,,,,29045
4f5ac0961ab7cec4c765299e9a7f90107ac85119,0,Andrew Onishuk,2017-04-06 12:32:56+03:00,['97338089198e62a558cadc2b2c2414ba424d9346'],3,3,6,26433190,3,,,,29045
ccf9edbc14d9d38f1924ab1defa8ca8b6f73f3f9,1,Andrew Onishuk,2017-04-06 12:32:56+03:00,['4f5ac0961ab7cec4c765299e9a7f90107ac85119'],116,98,214,26433404,2,1,0.666666667,0,29045
d972592bb863bf31c45c9bfa844958d7e83af668,0,Andrew Onishuk,2017-04-06 12:32:56+03:00,['ccf9edbc14d9d38f1924ab1defa8ca8b6f73f3f9'],16,352,368,26433772,5,0.065789474,0.921052632,0.651315789,29046
314e41ebe06b70c4bf99eb70f383f81d6e5e2ea2,0,Andrew Onishuk,2017-04-06 12:32:56+03:00,['d972592bb863bf31c45c9bfa844958d7e83af668'],2,2,4,26433776,1,,,,29046
88b82fe127539091aca0c28ebad2b8e00c30f1e5,0,Andrew Onishuk,2017-04-06 12:32:56+03:00,['314e41ebe06b70c4bf99eb70f383f81d6e5e2ea2'],1,1,2,26433778,1,,,,29046
1352fa908c5b07d5a8e44fa0b67da2beb382ba90,0,Andrew Onishuk,2017-04-06 12:32:56+03:00,['88b82fe127539091aca0c28ebad2b8e00c30f1e5'],200,209,409,26434187,24,1,1,1,29047
50a41a8426686d7a904fb15926c5a4b95d335c17,0,Andrew Onishuk,2017-04-06 12:32:56+03:00,['1352fa908c5b07d5a8e44fa0b67da2beb382ba90'],4,4,8,26434195,1,,,,29047
1b663da93662ecda43e116a201a8527d35bb4e5b,0,Andrew Onishuk,2017-04-06 12:32:56+03:00,['50a41a8426686d7a904fb15926c5a4b95d335c17'],0,220,220,26434415,22,,,,29047
038f637ec16b41ea726a58211bb4cf672d234570,0,Andrew Onishuk,2017-04-06 12:32:56+03:00,['1b663da93662ecda43e116a201a8527d35bb4e5b'],75,77,152,26434567,17,0,1,1,29047
6e5c12f670fb372d699af8b96ebd7cda77c20334,0,Andrew Onishuk,2017-04-06 12:32:56+03:00,['038f637ec16b41ea726a58211bb4cf672d234570'],5,5,10,26434577,1,,,,29047
632ba71fd66967a538bb9469707f94762f7602ae,0,Andrew Onishuk,2017-04-06 12:32:56+03:00,['6e5c12f670fb372d699af8b96ebd7cda77c20334'],15,19,34,26434611,1,,,,29047
13729ed2c6918e1d183dcf779e6b55c7123c1325,0,Andrew Onishuk,2017-04-06 12:32:56+03:00,['632ba71fd66967a538bb9469707f94762f7602ae'],10,10,20,26434631,4,,,,29047
caf6a254aa9577e4c596d898c930f7535c08dc48,0,Andrew Onishuk,2017-04-06 12:32:56+03:00,['13729ed2c6918e1d183dcf779e6b55c7123c1325'],2,4,6,26434637,4,,,,29047
aeb6707f61ae441e77ac443a9f3ce2e81fb208fb,0,Andrew Onishuk,2017-04-06 12:32:56+03:00,['caf6a254aa9577e4c596d898c930f7535c08dc48'],2,5,7,26434644,2,0,1,1,29047
8c10a07a4ad2e1825392ff99d4cc4c64620b69b7,0,Andrew Onishuk,2017-04-06 12:32:56+03:00,['aeb6707f61ae441e77ac443a9f3ce2e81fb208fb'],0,1,1,26434645,1,1,1,1,29047
7d4df5b30819384e7b72fca852b1319244bdab09,0,Andrew Onishuk,2017-04-06 12:32:56+03:00,['8c10a07a4ad2e1825392ff99d4cc4c64620b69b7'],3,48,51,26434696,1,0.033333333,0.033333333,0.966666667,29047
27105de959cac3c3b0e4b806dd341a7c4417bc41,0,Andrew Onishuk,2017-04-06 12:32:56+03:00,['7d4df5b30819384e7b72fca852b1319244bdab09'],7,11,18,26434714,10,,,,29047
0472e5f1ecf59ea5320b3544c259b95642548c59,0,Andrew Onishuk,2017-04-06 12:32:56+03:00,['27105de959cac3c3b0e4b806dd341a7c4417bc41'],5,15,20,26434734,2,,,,29047
cc88312e095ae6c025661b82cfb0207ebaceb5de,1,Andrew Onishuk,2017-04-06 12:32:56+03:00,['0472e5f1ecf59ea5320b3544c259b95642548c59'],1,3,4,26434738,1,0,0,1,29047
be2303927e30ccab0ec70ff5823a17204eaf2644,1,Andrew Onishuk,2017-04-06 12:32:56+03:00,['cc88312e095ae6c025661b82cfb0207ebaceb5de'],2,9,11,26434749,1,1,1,1,29047
112f7d4e79bd5d4e69d51cd95f7450981eaf18eb,1,Andrew Onishuk,2017-04-06 12:32:56+03:00,['be2303927e30ccab0ec70ff5823a17204eaf2644'],6,540,546,26435295,23,,,,29056
14d2581d8423db699a283c7cfd26dbce9db8b628,0,Andrew Onishuk,2017-04-06 12:32:56+03:00,['112f7d4e79bd5d4e69d51cd95f7450981eaf18eb'],1,1,2,26435297,1,,,,29056
b38ba2277f77c18bdee4e94eb1ed3ff7ad7e0cb7,0,Andrew Onishuk,2017-04-06 12:32:56+03:00,['14d2581d8423db699a283c7cfd26dbce9db8b628'],18,42,60,26435357,1,0,0.148148148,1,29056
01e0c695812a4e1d8c3a3d44829fdbc9b853ec63,0,Andrew Onishuk,2017-04-06 12:32:56+03:00,['b38ba2277f77c18bdee4e94eb1ed3ff7ad7e0cb7'],105,24,129,26435486,4,1,0.24137931,1,29056
45d8baf1ab64c42bba012fef95a74e64063e78f6,0,Andrew Onishuk,2017-04-06 12:32:56+03:00,['01e0c695812a4e1d8c3a3d44829fdbc9b853ec63'],15,83,98,26435584,3,0.311111111,0.8,1,29056
64447e524b077e11cce8dd4b76e6f7dffd047f09,1,Andrew Onishuk,2017-04-06 12:32:56+03:00,['45d8baf1ab64c42bba012fef95a74e64063e78f6'],142,141,283,26435867,17,0,0.642857143,0.857142857,29056
259dc90fc2851e9ebce02b3efc255eb69268324c,0,Andrew Onishuk,2017-04-06 12:32:56+03:00,['64447e524b077e11cce8dd4b76e6f7dffd047f09'],1,1,2,26435869,1,,,,29056
8a2dfa4e74784be9c8b11450589573708b17b276,0,Andrew Onishuk,2017-04-06 12:32:56+03:00,['259dc90fc2851e9ebce02b3efc255eb69268324c'],4,4,8,26435877,1,,,,29056
f6fbe4ba3660eb3659245cfb16f509f65a86b2aa,0,Andrew Onishuk,2017-04-06 12:32:56+03:00,['8a2dfa4e74784be9c8b11450589573708b17b276'],23,27,50,26435927,3,,,,29056
c3361d90718cb3d6879f830132a67e3f0afa010c,0,Andrew Onishuk,2017-04-06 12:32:56+03:00,['f6fbe4ba3660eb3659245cfb16f509f65a86b2aa'],0,4,4,26435931,1,,,,29056
5f99b1a53d9b5862c26f6ef92e7af1141df59249,0,Andrew Onishuk,2017-04-06 12:32:56+03:00,['c3361d90718cb3d6879f830132a67e3f0afa010c'],2,5,7,26435938,1,1,1,1,29056
426e895527d6567708316e840bd17a278139484e,0,Andrew Onishuk,2017-04-06 12:32:56+03:00,['5f99b1a53d9b5862c26f6ef92e7af1141df59249'],113,176,289,26436227,10,0,0,1,29056
c7021a60432a79d37e6b1fbf5106b444edec56f6,0,Andrew Onishuk,2017-04-06 12:32:56+03:00,['426e895527d6567708316e840bd17a278139484e'],82,231,313,26436540,1,,,,29056
8c58e67be8c3273e2b158e157fafaaa94e3f3190,0,Andrew Onishuk,2017-04-06 12:32:56+03:00,['c7021a60432a79d37e6b1fbf5106b444edec56f6'],11,72,83,26436623,4,0.857142857,0.857142857,1,29058
fb4637b33df2c511b1d5be17ef63fdeb887e7ee9,0,Andrew Onishuk,2017-04-06 12:32:56+03:00,['8c58e67be8c3273e2b158e157fafaaa94e3f3190'],3,14,17,26436640,3,1,1,1,29058
8de3961b62dcf23826e16134b9dd5c5c461ab50c,1,Andrew Onishuk,2017-04-06 12:33:00+03:00,['fb4637b33df2c511b1d5be17ef63fdeb887e7ee9'],5,3009,3014,26439654,23,0.521311475,0.604098361,0.745081967,29073
c11d0045214249e16ba1564c94e6fc6ec4e04d83,0,Dmytro Sen,2017-04-06 15:13:52+03:00,['8e15ba6ad3ee9e8ce653ca717f4fa97e2d09889a'],1,91,92,26439746,2,0.125,0.375,1,29073
28238ae84e24aa72613e59b6af341f1c2452a0aa,1,Dmytro Sen,2017-04-06 15:22:10+03:00,['c11d0045214249e16ba1564c94e6fc6ec4e04d83'],24,159,183,26439929,5,0.538461538,0.307692308,0.769230769,29074
e8c506f2cd137e7eae2745db987675074208681f,1,Lisnichenko Dmitro,2017-04-06 17:58:37+03:00,['28238ae84e24aa72613e59b6af341f1c2452a0aa'],18,18,36,26439965,18,,,,29074
92894811ec18ce5eae9aa10071f3bad022d4bcf5,0,Jonathan Hurley,2017-04-06 11:41:58-04:00,['e8c506f2cd137e7eae2745db987675074208681f'],112,55,167,26440132,5,1,0.461538462,0.961538462,29074
65d2f3f6d29f05213b2e6469f360f8fc3ff3f397,0,Aleksandr Kovalenko,2017-04-06 20:17:55+03:00,['92894811ec18ce5eae9aa10071f3bad022d4bcf5'],1,6,7,26440139,2,,,,29074
01e372770fb19ed50324846ce0e9ae080ae8fc01,1,Alex Antonenko,2017-04-06 20:59:54+03:00,['65d2f3f6d29f05213b2e6469f360f8fc3ff3f397'],39,22,61,26440200,4,0,0,0,29074
f650e351ce50ab2ed7852cf764b6a5074d7873ac,0,Jonathan Hurley,2017-04-06 14:57:29-04:00,"['70c23bcd18502095acaa3d0794f877b24a7cab8b', '01e372770fb19ed50324846ce0e9ae080ae8fc01']",2445,7072,9517,26449717,381,,,,29074
301896a12d7bb3b3a1402138ebf10667fc54a369,0,Di Li,2017-04-06 16:58:57-04:00,['01e372770fb19ed50324846ce0e9ae080ae8fc01'],2,109,111,26449828,12,0.287671233,0.931506849,0.95890411,29074
bb614a0ff7cf933e513fec5a6ed7b55c5c89cb9f,0,Alejandro Fernandez,2017-04-06 16:33:01-07:00,['301896a12d7bb3b3a1402138ebf10667fc54a369'],0,9,9,26449837,1,0,1,1,29074
97812020b8a116694bff56e724a496bb9faf5bcf,0,Xi Wang,2017-04-06 19:32:00-07:00,['bb614a0ff7cf933e513fec5a6ed7b55c5c89cb9f'],21,15,36,26449873,1,,,,29074
b0ac313e31bdd663ca5b8e3ba2f0c36060a7ce5d,1,Vitaly Brodetskyi,2017-04-07 14:28:33+03:00,['97812020b8a116694bff56e724a496bb9faf5bcf'],0,3,3,26449876,1,0,1,1,29074
91028d1e93e5e211a9cb8c7c99a96c9ee83a25c1,0,ababiichuk,2017-04-07 19:15:34+03:00,['b0ac313e31bdd663ca5b8e3ba2f0c36060a7ce5d'],20,46,66,26449942,5,1,1,1,29074
28eff65eea321cc8f7fe6c783460f0d710708bf8,1,Jonathan Hurley,2017-04-08 21:32:08-04:00,['91028d1e93e5e211a9cb8c7c99a96c9ee83a25c1'],110,204,314,26450256,12,1,1,0.777777778,29074
9405e241d3080c4192b130f00292ca44ab018f67,0,padmapriyanitt,2017-04-10 12:24:38+05:18,['28eff65eea321cc8f7fe6c783460f0d710708bf8'],1,1,2,26450258,1,,,,29074
5377e66448aea708d42751704e69bb15418c5a3e,0,Andrew Onishuk,2017-04-10 12:43:28+03:00,['9405e241d3080c4192b130f00292ca44ab018f67'],0,1,1,26450259,1,,,,29074
753b38c74723e2ef24ead5112dacb54b127c0d1a,0,Eugene Chekanskiy,2017-04-10 17:08:50+03:00,['5377e66448aea708d42751704e69bb15418c5a3e'],4,2,6,26450265,1,1,0,0,29074
bab55aac66e06be0bc99a6ac2e75b86b0c2c5b48,0,ababiichuk,2017-04-10 17:29:15+03:00,['753b38c74723e2ef24ead5112dacb54b127c0d1a'],232,0,232,26450497,14,0.016949153,0,0,29074
735cbda86216204e6a8db2da7b7bae46c847931d,0,Andrii Tkach,2017-04-10 17:52:43+03:00,['bab55aac66e06be0bc99a6ac2e75b86b0c2c5b48'],185,45,230,26450727,5,0.021276596,0,0,29074
e64bff0d99f9f159863598d00992d86b0f3c04fd,0,padmapriyanitt,2017-04-11 11:38:56+05:18,['735cbda86216204e6a8db2da7b7bae46c847931d'],1,23,24,26450751,16,1,1,1,29088
eff2b435a08858be6229d4d712c4f9bf3a212be1,1,padmapriyanitt,2017-04-11 11:52:35+05:18,['e64bff0d99f9f159863598d00992d86b0f3c04fd'],15,25,40,26450791,1,0,0,0.5,29088
953cc9c741bf5354de6010b84bb8a59aaaa305c8,0,padmapriyanitt,2017-04-11 15:23:26+05:18,['eff2b435a08858be6229d4d712c4f9bf3a212be1'],1,5,6,26450797,1,,,,29088
c0cef762666dab2619d4b4b511ed828e29325201,0,padmapriyanitt,2017-04-11 15:28:47+05:18,['953cc9c741bf5354de6010b84bb8a59aaaa305c8'],4,3,7,26450804,1,,,,29088
b2bcc38ed917f3b43fa21133f64cdb4642e3c2e1,0,Andrew Onishuk,2017-04-11 14:14:12+03:00,['8de3961b62dcf23826e16134b9dd5c5c461ab50c'],1,91,92,26450896,2,0.125,0.375,1,29088
ecc3fdf68bd436d562a622255597229d2f7b4134,0,Andrew Onishuk,2017-04-11 14:14:12+03:00,['b2bcc38ed917f3b43fa21133f64cdb4642e3c2e1'],24,159,183,26451079,5,0.538461538,0.307692308,0.769230769,29089
9fecba83295c26fa4c4327a7175dfe85815731d1,0,Andrew Onishuk,2017-04-11 14:14:12+03:00,['ecc3fdf68bd436d562a622255597229d2f7b4134'],18,18,36,26451115,18,,,,29089
6ec4bdbd0595791051759bd6bdb61c381e64ebea,0,Andrew Onishuk,2017-04-11 14:14:12+03:00,['9fecba83295c26fa4c4327a7175dfe85815731d1'],112,55,167,26451282,5,1,0.461538462,0.961538462,29089
0f406c5e6f7b908b363c17bce96955be8eb27d88,0,Andrew Onishuk,2017-04-11 14:14:12+03:00,['6ec4bdbd0595791051759bd6bdb61c381e64ebea'],1,6,7,26451289,2,,,,29089
532ab597b439be54cde5de21ea35340dee0e3587,1,Andrew Onishuk,2017-04-11 14:14:12+03:00,['0f406c5e6f7b908b363c17bce96955be8eb27d88'],39,22,61,26451350,4,0,0,0,29089
784ceeaaffeca873be49ee80e38c7de3cdaea2dd,0,Andrew Onishuk,2017-04-11 14:14:12+03:00,['532ab597b439be54cde5de21ea35340dee0e3587'],2,109,111,26451461,12,0.287671233,0.931506849,0.95890411,29089
6dba326c1202cc7e3ac6175b53591474c12f88e9,0,Andrew Onishuk,2017-04-11 14:14:12+03:00,['784ceeaaffeca873be49ee80e38c7de3cdaea2dd'],0,9,9,26451470,1,0,1,1,29089
24c038c0284627fbe9a2f2f152e6d397a161640f,0,Andrew Onishuk,2017-04-11 14:14:12+03:00,['6dba326c1202cc7e3ac6175b53591474c12f88e9'],21,15,36,26451506,1,,,,29089
9ca337ca944b26d53ec7b40fd7f5b0ce8789158e,0,Andrew Onishuk,2017-04-11 14:14:12+03:00,['24c038c0284627fbe9a2f2f152e6d397a161640f'],0,3,3,26451509,1,0,1,1,29089
827cc03b5c8c85d6e33491ce73e0bbfda2d4b436,0,Andrew Onishuk,2017-04-11 14:14:12+03:00,['9ca337ca944b26d53ec7b40fd7f5b0ce8789158e'],20,46,66,26451575,5,1,1,1,29089
6b9a59753a924c6e07a68a0de61f0fb2792df102,1,Andrew Onishuk,2017-04-11 14:14:12+03:00,['827cc03b5c8c85d6e33491ce73e0bbfda2d4b436'],110,204,314,26451889,12,1,1,0.777777778,29089
78715789f774a3ca376b13a78c8719f359d994fc,0,Andrew Onishuk,2017-04-11 14:14:12+03:00,['6b9a59753a924c6e07a68a0de61f0fb2792df102'],1,1,2,26451891,1,,,,29089
40ab38e9984e3ff8f55748c4560b7105ec9c181b,0,Andrew Onishuk,2017-04-11 14:14:12+03:00,['78715789f774a3ca376b13a78c8719f359d994fc'],0,1,1,26451892,1,,,,29089
22e1e7ebc1b6cc5af75b9e552d39c79936d89316,0,Andrew Onishuk,2017-04-11 14:14:12+03:00,['40ab38e9984e3ff8f55748c4560b7105ec9c181b'],4,2,6,26451898,1,1,0,0,29089
4bc494245b8c6be05de83bd18b088c2223cc8eb4,0,Andrew Onishuk,2017-04-11 14:14:12+03:00,['22e1e7ebc1b6cc5af75b9e552d39c79936d89316'],232,0,232,26452130,14,0.016949153,0,0,29089
e3794a3a5d02367b0b3d0a052b29a861196f602c,0,Andrew Onishuk,2017-04-11 14:14:12+03:00,['4bc494245b8c6be05de83bd18b088c2223cc8eb4'],185,45,230,26452360,5,0.021276596,0,0,29089
119ad10e7680e60d90117130384db79a2d38c13e,0,Andrew Onishuk,2017-04-11 14:14:12+03:00,['e3794a3a5d02367b0b3d0a052b29a861196f602c'],1,23,24,26452384,16,1,1,1,29103
d8dc982ad9bd9ddfca19b1993167e6d10c0e5863,1,Andrew Onishuk,2017-04-11 14:14:12+03:00,['119ad10e7680e60d90117130384db79a2d38c13e'],15,25,40,26452424,1,0,0,0.5,29103
36e456bce2d92fcf6e9f43f7cdfa711782aa1147,0,Andrew Onishuk,2017-04-11 14:14:12+03:00,['d8dc982ad9bd9ddfca19b1993167e6d10c0e5863'],1,5,6,26452430,1,,,,29103
73eff1215c6d99b618dfdd545a039aeab63135ff,0,Andrew Onishuk,2017-04-11 14:14:12+03:00,['36e456bce2d92fcf6e9f43f7cdfa711782aa1147'],4,3,7,26452437,1,,,,29103
2f20b2ed2e6663037b3301f52c2a92cd98d526fe,1,Andrew Onishuk,2017-04-11 14:14:14+03:00,['73eff1215c6d99b618dfdd545a039aeab63135ff'],6,317,323,26452760,10,0.866141732,0.992125984,0.834645669,29108
a214d800f6c75c34c22b7685c93c19be1c06d5c2,0,oleewere,2017-04-11 13:18:03+02:00,['c0cef762666dab2619d4b4b511ed828e29325201'],14,15,29,26452789,4,0,0,0,29108
d3036fdaaf8b28f062a3f8fa4527a9bccf3df927,0,Venkata Sairam,2017-04-11 16:50:08+05:18,['a214d800f6c75c34c22b7685c93c19be1c06d5c2'],1,6,7,26452796,2,1,1,1,29108
c093c5f8a2de76ac9b448ae282da8648b297b2ed,1,Andrii Tkach,2017-04-11 18:01:50+03:00,['2f20b2ed2e6663037b3301f52c2a92cd98d526fe'],0,386,386,26453182,7,1,0.934210526,0.847953216,29112
2760cda04c2222a7fd8fa85cf643444acbb735eb,1,Oleg Nechiporenko,2017-04-11 18:55:03+03:00,['d3036fdaaf8b28f062a3f8fa4527a9bccf3df927'],2,3,5,26453187,3,,,,29112
91aa3c8e4f845a0b106d8b07e500d51ae5e08496,1,ababiichuk,2017-04-11 19:03:18+03:00,['2760cda04c2222a7fd8fa85cf643444acbb735eb'],1,1,2,26453189,1,,,,29112
69c55935a57252e3490bfed6905b1bb2fb8ce86d,0,Alejandro Fernandez,2017-04-11 10:47:24-07:00,['91aa3c8e4f845a0b106d8b07e500d51ae5e08496'],1,3,4,26453193,2,,,,29112
3acd2e6da46494c175250e4f3a9ec074456b12b9,0,Jaimin Jetly,2017-04-11 11:20:34-07:00,"['3cb45e849a45b71142eb294a6625d9ec2d5c050a', '69c55935a57252e3490bfed6905b1bb2fb8ce86d']",8892,14419,23311,26476504,1348,,,,29112
48ff4c19b2260dd924d8502292e99e1819c3ee23,0,Yusaku Sako,2017-04-11 11:42:17-07:00,['69c55935a57252e3490bfed6905b1bb2fb8ce86d'],0,12,12,26476516,1,,,,29112
c0424b9f621266cd765cbfa2a36d50a9fb502b21,0,Richard Zang,2017-04-11 13:10:28-07:00,['48ff4c19b2260dd924d8502292e99e1819c3ee23'],12,2,14,26476530,1,0.4,0,0.4,29112
504e0b03d6d7c19f201379d0ae326a76c85e2bd1,0,Mugdha Varadkar,2017-04-12 10:53:56+05:18,['c0424b9f621266cd765cbfa2a36d50a9fb502b21'],1,1,2,26476532,1,,,,29112
8b508a6b7722d3356a082fa70290f9c2a152ebd4,0,Andrew Onishuk,2017-04-12 12:14:25+03:00,['c093c5f8a2de76ac9b448ae282da8648b297b2ed'],14,15,29,26476561,4,0,0,0,29112
964a1fb803ace27223232ed10ae7d57431e20448,0,Andrew Onishuk,2017-04-12 12:14:25+03:00,['8b508a6b7722d3356a082fa70290f9c2a152ebd4'],1,6,7,26476568,2,1,1,1,29112
4589f42bfd7c180aa207b709e2e14fca5307018e,0,Andrew Onishuk,2017-04-12 12:14:25+03:00,['964a1fb803ace27223232ed10ae7d57431e20448'],2,3,5,26476573,3,,,,29112
3dbb2016e1bc87091a070014492b6ce0d7efa419,0,Andrew Onishuk,2017-04-12 12:14:25+03:00,['4589f42bfd7c180aa207b709e2e14fca5307018e'],1,1,2,26476575,1,,,,29112
f0f0e0190acaa89e6fd5d728888172cc2fc1b46d,0,Andrew Onishuk,2017-04-12 12:14:25+03:00,['3dbb2016e1bc87091a070014492b6ce0d7efa419'],1,3,4,26476579,2,,,,29112
ab4935bb14289a89f96a4b833b4eb313a5dc2d23,0,Andrew Onishuk,2017-04-12 12:14:25+03:00,['f0f0e0190acaa89e6fd5d728888172cc2fc1b46d'],0,12,12,26476591,1,,,,29112
908c44e8b60c59af75d8a0a7ad0cc6b96c383808,0,Andrew Onishuk,2017-04-12 12:14:25+03:00,['ab4935bb14289a89f96a4b833b4eb313a5dc2d23'],12,2,14,26476605,1,0.4,0,0.4,29112
69344755c1e974606b5c86aae7ba5eea727c53e1,0,Andrew Onishuk,2017-04-12 12:14:25+03:00,['908c44e8b60c59af75d8a0a7ad0cc6b96c383808'],1,1,2,26476607,1,,,,29112
6b76fc9026725d0981e1fdc539301e58249c9612,1,Andrew Onishuk,2017-04-12 12:14:26+03:00,['69344755c1e974606b5c86aae7ba5eea727c53e1'],180,399,579,26477186,16,0.330275229,1,0.816513761,29115
4d297f5aa013eb518a7eb70c71c02f202db2868b,0,padmapriyanitt,2017-04-12 17:06:56+05:18,['504e0b03d6d7c19f201379d0ae326a76c85e2bd1'],31,43,74,26477260,3,,,,29115
dc180f693f13113fc2d27c5587fa12fe1f2e5044,0,Attila Doroszlai,2017-04-12 14:17:20+02:00,['4d297f5aa013eb518a7eb70c71c02f202db2868b'],2,2,4,26477264,1,,,,29115
754d6c8723e577ded6adc2448730a3c7ead8f7a2,1,Attila Doroszlai,2017-04-12 14:17:48+02:00,['dc180f693f13113fc2d27c5587fa12fe1f2e5044'],433,433,866,26478130,101,,,,29115
0ac0ba424e31db38704d8e7a59ac60b853094cda,1,Miklos Gergely,2017-04-12 15:02:14+02:00,['754d6c8723e577ded6adc2448730a3c7ead8f7a2'],2840,3873,6713,26484843,96,0.535885167,0.968899522,0.889952153,29153
273653b5a6057951f9df6ab7781e9ddcbd3c448c,1,Attila Doroszlai,2017-04-12 15:22:46+02:00,['0ac0ba424e31db38704d8e7a59ac60b853094cda'],3,1,4,26484847,2,,,,29153
11ab63f7ffa99a7d381b86282846fa7c80ddc88e,1,Vitaly Brodetskyi,2017-04-12 16:30:34+03:00,['273653b5a6057951f9df6ab7781e9ddcbd3c448c'],35,620,655,26485502,24,0.240853659,0.472560976,0.881097561,29153
9f63871575c5742643035139e1e8a23181ede083,0,Nate Cole,2017-04-12 09:48:35-04:00,"['f650e351ce50ab2ed7852cf764b6a5074d7873ac', '11ab63f7ffa99a7d381b86282846fa7c80ddc88e']",3962,5496,9458,26494960,305,,,,29153
310c5544155e75879c78f9e7ceef8f35cf3da587,0,Venkata Sairam,2017-04-12 19:11:18+05:18,['11ab63f7ffa99a7d381b86282846fa7c80ddc88e'],24,26,50,26495010,4,,,,29153
64e88e05d264e4d5a12122b48b724aca48c87d8f,0,Miklos Gergely,2017-04-12 17:41:01+02:00,['310c5544155e75879c78f9e7ceef8f35cf3da587'],0,5,5,26495015,1,0,1,1,29153
ef34cb4ee57c58687ba7db7adfbb5960c0b267da,1,Sandor Magyari,2017-04-12 20:24:53+02:00,['64e88e05d264e4d5a12122b48b724aca48c87d8f'],8,4,12,26495027,2,1,0,1,29153
5ef0c99a9d477b63f4e7213d058c9ab2d3ac2feb,1,Sumit Mohanty,2017-04-12 12:35:15-07:00,['ef34cb4ee57c58687ba7db7adfbb5960c0b267da'],277,2,279,26495306,1,0.574850299,0.215568862,0.413173653,29153
68b7b56479dbc22d16e96570e27616a59c96a98a,0,Richard Zang,2017-04-12 14:32:53-07:00,['5ef0c99a9d477b63f4e7213d058c9ab2d3ac2feb'],6,200,206,26495512,4,0.030674847,0.791411043,1,29153
aca12b7a3387211a51718026215a30877960035d,1,Miklos Gergely,2017-04-13 01:28:25+02:00,['68b7b56479dbc22d16e96570e27616a59c96a98a'],2,25,27,26495539,2,0,1,0.25,29153
4f2523e7f08fd81859831353a18ffb52ab0af8e9,0,Jayush Luniya,2017-04-12 23:42:17-07:00,['aca12b7a3387211a51718026215a30877960035d'],7,81,88,26495627,10,0,0.020408163,0.959183673,29153
04f8c53fec3febab19a68f80bd22a5ae7a312346,1,Myroslav Papirkovskyi,2017-04-13 12:18:36+03:00,['6b76fc9026725d0981e1fdc539301e58249c9612'],303,944,1247,26496874,35,0.548780488,0.776422764,0.589430894,29162
52203c3ea2d5f04d3803b11e61aaa1eafd72b64a,1,oleewere,2017-04-13 12:31:23+02:00,['4f2523e7f08fd81859831353a18ffb52ab0af8e9'],0,63,63,26496937,6,0.387096774,1,0.387096774,29162
3e01abd19f8a3d9538ab38d35786c3b6fae33fc5,1,oleewere,2017-04-13 12:41:41+02:00,['52203c3ea2d5f04d3803b11e61aaa1eafd72b64a'],2,2,4,26496941,1,,,,29162
a5dc75ecee205c5cb8a1600c0e00232426256209,0,Venkata Sairam,2017-04-13 16:46:13+05:18,['3e01abd19f8a3d9538ab38d35786c3b6fae33fc5'],1,35,36,26496977,2,1,1,1,29162
4f419689503fb634f402e0b4c5d697b8d382006b,0,Jonathan Hurley,2017-04-13 08:45:14-04:00,['a5dc75ecee205c5cb8a1600c0e00232426256209'],7,255,262,26497239,10,0.5,1,1,29164
ac75f1daccc2c1117e175f95cd9642e85b4fd366,1,Nate Cole,2017-04-13 08:53:50-04:00,['4f419689503fb634f402e0b4c5d697b8d382006b'],30,218,248,26497487,23,0,0.404494382,0.91011236,29164
273dfcac0296ebfaebd21484ea887acfe2a02067,1,Lisnichenko Dmitro,2017-04-13 17:36:19+03:00,['ac75f1daccc2c1117e175f95cd9642e85b4fd366'],61,164,225,26497712,7,0.0125,0.4875,0,29164
b9c82add7fbe5ef652da1a47a0276b63a279470c,1,Di Li,2017-04-13 13:15:56-04:00,['273dfcac0296ebfaebd21484ea887acfe2a02067'],1,9,10,26497722,3,0,0,0,29164
269ac0a1f28d26180a1f684869a884d18f96d086,1,Tim Thorpe,2017-04-13 10:51:36-07:00,['b9c82add7fbe5ef652da1a47a0276b63a279470c'],4,4,8,26497730,2,,,,29164
7e46412dc694fc78713be079e56d7347a6f2f60c,0,Tim Thorpe,2017-04-13 11:30:41-07:00,['269ac0a1f28d26180a1f684869a884d18f96d086'],3,8,11,26497741,2,,,,29164
0c778e77ac05caf24e1a0a1028533ec42ff35da2,0,Xi Wang,2017-04-13 13:42:29-07:00,['7e46412dc694fc78713be079e56d7347a6f2f60c'],12,8,20,26497761,1,,,,29164
14c1ffd3288742354f17cbf49b6cebfee913a16f,1,Di Li,2017-04-13 16:54:34-04:00,['0c778e77ac05caf24e1a0a1028533ec42ff35da2'],0,6,6,26497767,1,0,0,0,29164
cfde36c077de31dda0802f983602f680afcbce29,0,Di Li,2017-04-13 17:00:56-04:00,['14c1ffd3288742354f17cbf49b6cebfee913a16f'],3,3,6,26497773,1,,,,29164
f894e486a6f8eab31aec5add517a35ec9a11b655,0,Sangeeta Ravindran,2017-04-13 15:08:47-07:00,['cfde36c077de31dda0802f983602f680afcbce29'],0,1,1,26497774,1,0,0,1,29164
38f84bf12d04981017bbcfc3d44c243f062ed055,1,Swapan Shridhar,2017-04-13 15:57:10-07:00,['f894e486a6f8eab31aec5add517a35ec9a11b655'],6,627,633,26498407,5,0.108216433,0.907815631,0.879759519,29164
c57300a359bfdb3225e2660a661733fc58daac2c,1,Xi Wang,2017-04-13 16:11:44-07:00,['38f84bf12d04981017bbcfc3d44c243f062ed055'],1,32,33,26498440,1,0.958333333,0.375,0.375,29164
bf637950901f2b0f213c1cc149f5e49b8a8d0968,1,Sandor Magyari,2017-04-14 10:20:09+02:00,['c57300a359bfdb3225e2660a661733fc58daac2c'],49,16,65,26498505,3,1,0.923076923,0.038461538,29164
e9cf9dd17a7fcf170bb253a8d0b037910299b38c,1,Lisnichenko Dmitro,2017-04-14 11:35:20+03:00,['bf637950901f2b0f213c1cc149f5e49b8a8d0968'],1,1,2,26498507,1,,,,29164
86c305897b054a50a36e63a5c98ea5d2c47890be,1,oleewere,2017-04-14 13:05:12+02:00,['e9cf9dd17a7fcf170bb253a8d0b037910299b38c'],6,8,14,26498521,1,0,1,1,29164
103e49a899b57ff286889b8840e758c53bdaf1e8,1,lpuskas,2017-04-14 16:01:10+02:00,['86c305897b054a50a36e63a5c98ea5d2c47890be'],604,850,1454,26499975,25,1,0,0.36,29169
dd3fdc220d9ad3b2b723a201ce7aa5d767850a58,0,Di Li,2017-04-17 11:27:32-04:00,['103e49a899b57ff286889b8840e758c53bdaf1e8'],2,1,3,26499978,1,,,,29169
22b114defc43858798f6f20211c0d04b440ee7ce,1,Di Li,2017-04-17 11:36:19-04:00,['dd3fdc220d9ad3b2b723a201ce7aa5d767850a58'],6,7,13,26499991,2,0,0,0,29169
1941eedb5236013c7ce5477466bb42b837b7be3b,1,Di Li,2017-04-17 12:17:27-04:00,['22b114defc43858798f6f20211c0d04b440ee7ce'],3,38,41,26500032,5,0.875,0.916666667,0.958333333,29169
6806d38b8526f5229a6ed4a56a4492f2b2ab27c2,0,Alejandro Fernandez,2017-04-17 10:51:40-07:00,['1941eedb5236013c7ce5477466bb42b837b7be3b'],0,9,9,26500041,1,,,,29169
358a58871745fb65e93f1e968c03141ee9c6368a,1,Alejandro Fernandez,2017-04-17 11:47:26-07:00,['6806d38b8526f5229a6ed4a56a4492f2b2ab27c2'],2,9,11,26500052,1,,,,29169
b013be0b97c140b47d77149dcce93ee4f4d90b74,0,Nate Cole,2017-04-17 16:17:45-04:00,"['9f63871575c5742643035139e1e8a23181ede083', '358a58871745fb65e93f1e968c03141ee9c6368a']",1128,2717,3845,26503897,124,,,,29169
44b1f69d2e0ea75b7d9ed2af7ab7a4900cbeb32a,0,Aravindan Vijayan,2017-04-17 13:55:52-07:00,['358a58871745fb65e93f1e968c03141ee9c6368a'],1,1,2,26503899,1,,,,29169
7bb94a010dddb0574f5dad4f3a44fb503bc3a2fb,0,Richard Zang,2017-04-17 15:05:15-07:00,['44b1f69d2e0ea75b7d9ed2af7ab7a4900cbeb32a'],82,20,102,26504001,1,0.434782609,0.043478261,0,29169
8e2abf97bd2f10bad978d176a53bffd0ad2c7b67,0,Attila Doroszlai,2017-04-18 14:45:38+02:00,['7bb94a010dddb0574f5dad4f3a44fb503bc3a2fb'],159,43,202,26504203,46,,,,29169
56f838b5b0a5681dffb703f503fcf443cb3b6dbd,1,Jonathan Hurley,2017-04-18 14:13:21-04:00,['b013be0b97c140b47d77149dcce93ee4f4d90b74'],325,413,738,26504941,9,0,0,0,29169
323da508944626c8ee82118ce67a000b8e5a511c,1,Aravindan Vijayan,2017-04-18 13:16:09-07:00,['8e2abf97bd2f10bad978d176a53bffd0ad2c7b67'],0,272,272,26505213,12,0.175257732,0.417525773,0.994845361,29169
f516b6c5ad384ceb52181bee6b1553089563182e,1,Swapan Shridhar,2017-04-18 18:01:35-07:00,['323da508944626c8ee82118ce67a000b8e5a511c'],13,36,49,26505262,3,,,,29169
3bd91a2f7968cb182d005a3b45879261297b4495,0,Jonathan Hurley,2017-04-19 11:04:49-04:00,"['56f838b5b0a5681dffb703f503fcf443cb3b6dbd', 'f516b6c5ad384ceb52181bee6b1553089563182e']",254,371,625,26505887,62,,,,29169
998e7644433fec0b7cd5356e8ee1ee052551cec4,0,Jayush Luniya,2017-04-19 08:55:58-07:00,['f516b6c5ad384ceb52181bee6b1553089563182e'],81,7,88,26505975,10,1,0.979591837,0.040816327,29169
91d438697c902a2284e7e9c78e14995cead910e8,0,Jayush Luniya,2017-04-19 09:06:33-07:00,['998e7644433fec0b7cd5356e8ee1ee052551cec4'],0,40,40,26506015,1,0,0,1,29169
c651d6d36928580c6e13309d2754b76ecb58ee29,0,Jaimin Jetly,2017-04-19 10:09:09-07:00,['91d438697c902a2284e7e9c78e14995cead910e8'],1,4,5,26506020,2,,,,29169
f92e5f2e38e1b4ad0e0fc8dd6728d9cbcbc0dcc2,0,Tim Thorpe,2017-04-19 11:15:09-07:00,['c651d6d36928580c6e13309d2754b76ecb58ee29'],10,50,60,26506080,5,0.214285714,0.785714286,1,29169
e55893549c2aa2c46b5b1df3c2bf54db2b21350c,1,Madhuvanthi Radhakrishnan,2017-04-19 13:51:27-07:00,['f92e5f2e38e1b4ad0e0fc8dd6728d9cbcbc0dcc2'],0,11,11,26506091,1,,,,29169
4ede671514563a3cc116bc2059d6d8b878a5a784,0,Attila Doroszlai,2017-04-20 09:55:17+02:00,['3acd2e6da46494c175250e4f3a9ec074456b12b9'],5,343,348,26506439,10,1,1,1,29174
1c37ffc435995fc898941837a2cdcdffd51d06bc,1,oleewere,2017-04-20 13:36:36+02:00,['e55893549c2aa2c46b5b1df3c2bf54db2b21350c'],2,3,5,26506444,1,0,0,1,29174
cebbff057baf9b30359aea108533feb8d9cce9ed,1,Andrii Tkach,2017-04-20 16:36:53+03:00,['1c37ffc435995fc898941837a2cdcdffd51d06bc'],215,840,1055,26507499,2,0.5968,1,1,29174
f020edc85ad7cb71d47a7eaabc2bc7361dee5d1f,1,Di Li,2017-04-20 11:00:13-04:00,['cebbff057baf9b30359aea108533feb8d9cce9ed'],3,14,17,26507516,5,,,,29174
f012848130e6f3ae7c8121a781ec851885185327,1,Jonathan Hurley,2017-04-20 12:09:44-04:00,['f020edc85ad7cb71d47a7eaabc2bc7361dee5d1f'],35,18,53,26507569,4,1,0,0,29174
6c8458f860e89635ea0060950c7886048d858d07,0,Attila Doroszlai,2017-04-20 18:27:31+02:00,['f012848130e6f3ae7c8121a781ec851885185327'],3,2,5,26507574,1,,,,29174
d5e444fbb984ef58b5b8f28e354a95d063bfb89d,1,Alejandro Fernandez,2017-04-20 10:59:55-07:00,['6c8458f860e89635ea0060950c7886048d858d07'],369,385,754,26508328,19,,,,29174
346df9260b61bf7e2528289767693211fa4a8f92,0,Sangeeta Ravindran,2017-04-20 12:28:30-07:00,['d5e444fbb984ef58b5b8f28e354a95d063bfb89d'],0,2,2,26508330,1,1,0,1,29174
bff50bd3258112b3f5815af3a8ba50da70da07d2,1,oleewere,2017-04-20 21:34:39+02:00,['346df9260b61bf7e2528289767693211fa4a8f92'],102,293,395,26508725,4,0.513157895,1,0.223684211,29176
4a8d3be91c29660b134c6b1583ff5fce607da915,1,Yusaku Sako,2017-04-20 17:56:09-07:00,['bff50bd3258112b3f5815af3a8ba50da70da07d2'],6,13,19,26508744,1,,,,29176
2075f52e327e6bc624ec043dc87ea74672bcc7f5,1,Yusaku Sako,2017-04-20 17:57:30-07:00,['4a8d3be91c29660b134c6b1583ff5fce607da915'],0,4170,4170,26512914,1,,,,29177
ad4e11cc0cdfe33bdb33008b4b7586e55b9cd715,1,"Toader, Sebastian",2017-04-21 08:11:31+02:00,['2075f52e327e6bc624ec043dc87ea74672bcc7f5'],0,10,10,26512924,2,0.25,0.25,1,29177
d98db012578a2ab01430d21ac4c8ef52342e0298,0,Alex Antonenko,2017-04-21 09:23:13+03:00,['ad4e11cc0cdfe33bdb33008b4b7586e55b9cd715'],0,1,1,26512925,1,,,,29177
836c789956b4087f5f6cf30c3dc0d333e702c72a,1,Alex Antonenko,2017-04-21 09:23:13+03:00,['d98db012578a2ab01430d21ac4c8ef52342e0298'],7,9,16,26512941,1,,,,29177
3d5da62cbbc673034f8db54fbad8d6a83afe57cb,1,Mugdha Varadkar,2017-04-21 15:55:03+05:18,['836c789956b4087f5f6cf30c3dc0d333e702c72a'],2,56,58,26512999,3,0,0,1,29178
d499c8a68229fe44b3909b51a2cf3b90b7e92b9a,1,Miklos Gergely,2017-04-21 13:10:08+02:00,['3d5da62cbbc673034f8db54fbad8d6a83afe57cb'],3,35,38,26513037,5,0,1,1,29179
a630dd8c4961b132350fa1b25ee09cc3328fc7d1,0,Venkata Sairam,2017-04-21 16:40:40+05:18,['d499c8a68229fe44b3909b51a2cf3b90b7e92b9a'],1,1,2,26513039,1,,,,29179
aa3deac3bfd9ab98c7224025abfbade5bb459639,0,oleewere,2017-04-21 13:29:22+02:00,['a630dd8c4961b132350fa1b25ee09cc3328fc7d1'],1,1,2,26513041,1,,,,29179
b66d4b17e9fa03e1117b954ab41ff8bf9d6c18f6,0,Venkata Sairam,2017-04-21 16:49:08+05:18,['aa3deac3bfd9ab98c7224025abfbade5bb459639'],2,4,6,26513047,2,,,,29179
bbd86dd2bf7707485c91461eb118cf808ebef7f8,0,Oleg Nechiporenko,2017-04-21 14:33:19+03:00,['b66d4b17e9fa03e1117b954ab41ff8bf9d6c18f6'],10,10,20,26513067,6,,,,29179
a94abb109bfb590fe3f38b0f8efcd57c84fa4173,0,Miklos Gergely,2017-04-21 13:39:14+02:00,['bbd86dd2bf7707485c91461eb118cf808ebef7f8'],3,6,9,26513076,1,1,1,1,29179
04f31104bd481426823204468ea02f0fe8c33c48,0,Lisnichenko Dmitro,2017-04-21 16:09:47+03:00,['a94abb109bfb590fe3f38b0f8efcd57c84fa4173'],1,9,10,26513086,2,0.5,0.5,1,29179
84d2b3a0ac3256d7d10c550d94814db3602f9ed7,0,Jonathan Hurley,2017-04-21 09:22:51-04:00,['04f31104bd481426823204468ea02f0fe8c33c48'],124,220,344,26513430,24,,,,29179
b299641a076266e8f2a19f55068c89d56bc602b7,0,Eugene Chekanskiy,2017-04-21 17:54:13+03:00,['84d2b3a0ac3256d7d10c550d94814db3602f9ed7'],5211,13,5224,26518654,81,0.992218816,0.516623438,0.458146664,29179
8d3cc471e2ac460bc64bbbb22b079f873d9f5e66,1,Vitaly Brodetskyi,2017-04-21 18:15:30+03:00,['b299641a076266e8f2a19f55068c89d56bc602b7'],45,76,121,26518775,8,0,0,0.75,29179
84a8b76282fd1791b6ca70da6425a4bf8e2d8a12,1,pallavkul,2017-04-21 21:05:37+05:18,['8d3cc471e2ac460bc64bbbb22b079f873d9f5e66'],3,10,13,26518788,3,1,1,1,29179
99f16607f804992b4c06ea3f0e9295399604e7f6,1,Vitaly Brodetskyi,2017-04-21 18:53:58+03:00,['84a8b76282fd1791b6ca70da6425a4bf8e2d8a12'],0,36,36,26518824,5,0,0.428571429,0.428571429,29179
df4706e73953e3c24e76878bc7590c175200cf78,1,Miklos Gergely,2017-04-21 18:21:32+02:00,['99f16607f804992b4c06ea3f0e9295399604e7f6'],1,1,2,26518826,1,,,,29179
a33040afcd6cf963b3b3e2e9770ef051999776ff,0,Jonathan Hurley,2017-04-21 12:35:21-04:00,"['3bd91a2f7968cb182d005a3b45879261297b4495', '84d2b3a0ac3256d7d10c550d94814db3602f9ed7']",941,6174,7115,26525941,101,,,,29179
12ee39f340e1ca8d7ef285b21a19d28f1f9e17ae,0,Nate Cole,2017-04-21 16:52:34-04:00,['df4706e73953e3c24e76878bc7590c175200cf78'],0,16,16,26525957,3,,,,29179
e5fff5825563bee0b0af7a0fd790731989b9ce0b,1,Alejandro Fernandez,2017-04-23 15:21:53-07:00,['12ee39f340e1ca8d7ef285b21a19d28f1f9e17ae'],0,10489,10489,26536446,47,0.391033624,0.484433375,0.889165629,29226
c8858af27daa31bcfc1bef92f6630483c6a1dc41,0,Jonathan Hurley,2017-04-23 22:19:59-04:00,"['a33040afcd6cf963b3b3e2e9770ef051999776ff', 'e5fff5825563bee0b0af7a0fd790731989b9ce0b']",5260,10641,15901,26552347,146,,,,29226
150ab25eb18fa031658bfdb698929bc5bff88926,1,Mugdha Varadkar,2017-04-24 11:30:18+05:18,['e5fff5825563bee0b0af7a0fd790731989b9ce0b'],0,136,136,26552483,6,0.022222222,0.022222222,0.977777778,29226
7f4f421ae8ef06c5d0100ee3f2fea15c45094454,1,pallavkul,2017-04-24 11:45:32+05:18,['150ab25eb18fa031658bfdb698929bc5bff88926'],3,38,41,26552524,2,1,1,1,29226
e8fd10cf6de7cc20662ab7d609ac8e105326ab6a,1,Attila Doroszlai,2017-04-24 09:51:19+02:00,['7f4f421ae8ef06c5d0100ee3f2fea15c45094454'],14,166,180,26552704,13,1,1,1,29228
6a407f9d5ea53066bcd3f0fe777ca84b11644e4e,0,Andrew Onishuk,2017-04-24 14:59:17+03:00,['04f8c53fec3febab19a68f80bd22a5ae7a312346'],31,43,74,26552778,3,,,,29228
649d08e2849a408002f2392379541846d995887d,0,Andrew Onishuk,2017-04-24 14:59:17+03:00,['6a407f9d5ea53066bcd3f0fe777ca84b11644e4e'],2,2,4,26552782,1,,,,29228
7310e039bce4a3e8ffc2ef7653143a985521f22b,1,Andrew Onishuk,2017-04-24 14:59:17+03:00,['649d08e2849a408002f2392379541846d995887d'],433,433,866,26553648,101,,,,29228
a1f4057d784df5593f0b2e0d0512b3a7ad8af021,1,Andrew Onishuk,2017-04-24 14:59:17+03:00,['7310e039bce4a3e8ffc2ef7653143a985521f22b'],2840,3873,6713,26560361,96,0.535885167,0.968899522,0.889952153,29266
d1d2e129222746b56d413bc2f3cdc5abcbd19bc1,0,Andrew Onishuk,2017-04-24 14:59:17+03:00,['a1f4057d784df5593f0b2e0d0512b3a7ad8af021'],3,1,4,26560365,2,,,,29266
5d6d3599172be85304e4c9e6b6628a10aa5b2aea,1,Andrew Onishuk,2017-04-24 14:59:17+03:00,['d1d2e129222746b56d413bc2f3cdc5abcbd19bc1'],35,620,655,26561020,24,0.240853659,0.472560976,0.881097561,29266
67dddcf17a2fcc419bf0927ebf3ef755d7e07e86,0,Andrew Onishuk,2017-04-24 14:59:17+03:00,['5d6d3599172be85304e4c9e6b6628a10aa5b2aea'],24,26,50,26561070,4,,,,29266
160ed9701c5bc8bbf680a38b04be30d0101c3e33,1,Andrew Onishuk,2017-04-24 14:59:17+03:00,['67dddcf17a2fcc419bf0927ebf3ef755d7e07e86'],0,5,5,26561075,1,0,1,1,29266
d7eadd078c68bf0b4ccb3c54eaba47400f41280a,1,Andrew Onishuk,2017-04-24 14:59:17+03:00,['160ed9701c5bc8bbf680a38b04be30d0101c3e33'],8,4,12,26561087,2,1,0,1,29266
45b6df2770ea5d98b361dd9d793d789a9780ac83,0,Andrew Onishuk,2017-04-24 14:59:17+03:00,['d7eadd078c68bf0b4ccb3c54eaba47400f41280a'],277,2,279,26561366,1,0.574850299,0.215568862,0.413173653,29266
cf43cde21d7f6169880df5e074fafcea6de6b9d4,0,Andrew Onishuk,2017-04-24 14:59:17+03:00,['45b6df2770ea5d98b361dd9d793d789a9780ac83'],6,200,206,26561572,4,0.030674847,0.791411043,1,29266
6b5697c5bf825ed878df28ac763a5665cde6a144,0,Andrew Onishuk,2017-04-24 14:59:17+03:00,['cf43cde21d7f6169880df5e074fafcea6de6b9d4'],2,25,27,26561599,2,0,1,0.25,29266
222aeb6d82d48076ac85757da70f1d7aca17ef69,0,Andrew Onishuk,2017-04-24 14:59:17+03:00,['6b5697c5bf825ed878df28ac763a5665cde6a144'],7,81,88,26561687,10,0,0.020408163,0.959183673,29266
1e13f7c7f9fbcfca343b28d269ce67057f76896d,0,Andrew Onishuk,2017-04-24 14:59:17+03:00,['222aeb6d82d48076ac85757da70f1d7aca17ef69'],0,63,63,26561750,6,0.387096774,1,0.387096774,29266
d6b5f8e961ffd9477cb5d58be19e0bd3495f4d87,0,Andrew Onishuk,2017-04-24 14:59:17+03:00,['1e13f7c7f9fbcfca343b28d269ce67057f76896d'],2,2,4,26561754,1,,,,29266
b9439352d988870d64cfa19b26445c0d82d14e7d,0,Andrew Onishuk,2017-04-24 14:59:17+03:00,['d6b5f8e961ffd9477cb5d58be19e0bd3495f4d87'],1,35,36,26561790,2,1,1,1,29266
151aab1951b9d0d5604e0bd4824cb7679d2e0a2f,0,Andrew Onishuk,2017-04-24 14:59:17+03:00,['b9439352d988870d64cfa19b26445c0d82d14e7d'],7,255,262,26562052,10,0.5,1,1,29268
6407ddd256fc98e5e97b68806fd9a8c823eff805,1,Andrew Onishuk,2017-04-24 14:59:17+03:00,['151aab1951b9d0d5604e0bd4824cb7679d2e0a2f'],30,218,248,26562300,23,0,0.404494382,0.91011236,29268
c4bd3b9e46675ad411e9454c399d5e6a3fbcf156,0,Andrew Onishuk,2017-04-24 14:59:17+03:00,['6407ddd256fc98e5e97b68806fd9a8c823eff805'],61,164,225,26562525,7,0.0125,0.4875,0,29268
4132e649cdc3462881e1b60be75705f281610817,0,Andrew Onishuk,2017-04-24 14:59:17+03:00,['c4bd3b9e46675ad411e9454c399d5e6a3fbcf156'],1,9,10,26562535,3,0,0,0,29268
401373381ce14965cb06e8d0e8dcbc8cc8855bb7,0,Andrew Onishuk,2017-04-24 14:59:17+03:00,['4132e649cdc3462881e1b60be75705f281610817'],4,4,8,26562543,2,,,,29268
5abf8da8f78f8254e1691b778370f616dc3fd695,0,Andrew Onishuk,2017-04-24 14:59:17+03:00,['401373381ce14965cb06e8d0e8dcbc8cc8855bb7'],3,8,11,26562554,2,,,,29268
2d3e625dc3a3b22ea0f1048e0034f004648bccda,0,Andrew Onishuk,2017-04-24 14:59:17+03:00,['5abf8da8f78f8254e1691b778370f616dc3fd695'],12,8,20,26562574,1,,,,29268
a86b267196183f97bf18aa1f7bddaaa891462651,0,Andrew Onishuk,2017-04-24 14:59:17+03:00,['2d3e625dc3a3b22ea0f1048e0034f004648bccda'],0,6,6,26562580,1,0,0,0,29268
02b911dfc48b93d61086fd3306faa55599c76daa,0,Andrew Onishuk,2017-04-24 14:59:17+03:00,['a86b267196183f97bf18aa1f7bddaaa891462651'],3,3,6,26562586,1,,,,29268
78378cf32bb7a9d6d76d7ccba92742b498412b91,0,Andrew Onishuk,2017-04-24 14:59:56+03:00,['02b911dfc48b93d61086fd3306faa55599c76daa'],1,2,3,26562589,1,,,,29268
38043ae8a724320287df5b648a9f8d82aba41543,0,Andrew Onishuk,2017-04-24 14:59:56+03:00,['78378cf32bb7a9d6d76d7ccba92742b498412b91'],6,627,633,26563222,5,0.108216433,0.907815631,0.879759519,29268
ea120109d35083af049a368eef5719dadbffd6b8,0,Andrew Onishuk,2017-04-24 14:59:56+03:00,['38043ae8a724320287df5b648a9f8d82aba41543'],1,32,33,26563255,1,0.958333333,0.375,0.375,29268
9c4bb4cb319f001615a2c97da52dcb1e3e34c1bf,0,Andrew Onishuk,2017-04-24 14:59:56+03:00,['ea120109d35083af049a368eef5719dadbffd6b8'],49,16,65,26563320,3,1,0.923076923,0.038461538,29268
6474b32da2bf1d98d9ab4e0c254eee0ecc2b70f4,1,Andrew Onishuk,2017-04-24 14:59:56+03:00,['9c4bb4cb319f001615a2c97da52dcb1e3e34c1bf'],1,1,2,26563322,1,,,,29268
6db5719a6324b770d11f5f84d44c4ffcdbd777e7,0,Andrew Onishuk,2017-04-24 14:59:56+03:00,['6474b32da2bf1d98d9ab4e0c254eee0ecc2b70f4'],6,8,14,26563336,1,0,1,1,29268
3c146f8758fe0079865febf78328ffbb95fc8e74,0,Andrew Onishuk,2017-04-24 14:59:56+03:00,['6db5719a6324b770d11f5f84d44c4ffcdbd777e7'],604,850,1454,26564790,25,1,0,0.36,29273
f08d487be627f14fce19dc5b726957f49c772a2d,0,Andrew Onishuk,2017-04-24 14:59:56+03:00,['3c146f8758fe0079865febf78328ffbb95fc8e74'],2,1,3,26564793,1,,,,29273
b64e856720a814fbc8c23370e0e89bc2a5716800,0,Andrew Onishuk,2017-04-24 14:59:56+03:00,['f08d487be627f14fce19dc5b726957f49c772a2d'],6,7,13,26564806,2,0,0,0,29273
1f4a72fd0cca8d822ea8ebb7368452c54d53f8bb,0,Andrew Onishuk,2017-04-24 14:59:56+03:00,['b64e856720a814fbc8c23370e0e89bc2a5716800'],3,38,41,26564847,5,0.875,0.916666667,0.958333333,29273
422c30f0ed6c2448e929b72a6d4e7a89afa32fe9,0,Andrew Onishuk,2017-04-24 14:59:56+03:00,['1f4a72fd0cca8d822ea8ebb7368452c54d53f8bb'],0,9,9,26564856,1,,,,29273
5ab5de4ba46a25c309540524a1881d08385e3623,0,Andrew Onishuk,2017-04-24 14:59:56+03:00,['422c30f0ed6c2448e929b72a6d4e7a89afa32fe9'],2,9,11,26564867,1,,,,29273
13dd115fd7e913d59b249672257705df55a67502,0,Andrew Onishuk,2017-04-24 14:59:56+03:00,['5ab5de4ba46a25c309540524a1881d08385e3623'],1,1,2,26564869,1,,,,29273
b95dcc3b5940ba9edba5dd57db66a3a30a1cc1fb,0,Andrew Onishuk,2017-04-24 14:59:56+03:00,['13dd115fd7e913d59b249672257705df55a67502'],82,20,102,26564971,1,0.434782609,0.043478261,0,29273
893f97e437990a154229d7545c2a6797defd714c,0,Andrew Onishuk,2017-04-24 14:59:56+03:00,['b95dcc3b5940ba9edba5dd57db66a3a30a1cc1fb'],159,43,202,26565173,46,,,,29273
6326589b5af88fc72eddbfc6c33e1898e986b938,0,Andrew Onishuk,2017-04-24 14:59:56+03:00,['893f97e437990a154229d7545c2a6797defd714c'],0,272,272,26565445,12,0.175257732,0.417525773,0.994845361,29273
611aaa51dd0697f675f1dfbb7b555e9336c96ba9,0,Andrew Onishuk,2017-04-24 14:59:56+03:00,['6326589b5af88fc72eddbfc6c33e1898e986b938'],13,36,49,26565494,3,,,,29273
a6bba6929556b8138099270bcc40f309ee4cd0dd,0,Andrew Onishuk,2017-04-24 14:59:56+03:00,['611aaa51dd0697f675f1dfbb7b555e9336c96ba9'],81,7,88,26565582,10,1,0.979591837,0.040816327,29273
ebb24be9ab15fa36b4c81865afd3b188eea2911d,0,Andrew Onishuk,2017-04-24 14:59:56+03:00,['a6bba6929556b8138099270bcc40f309ee4cd0dd'],0,40,40,26565622,1,0,0,1,29273
92ac66ff26a5f07c37895e04c4f78066b1cdd75e,0,Andrew Onishuk,2017-04-24 14:59:56+03:00,['ebb24be9ab15fa36b4c81865afd3b188eea2911d'],1,4,5,26565627,2,,,,29273
8d0ec0847abb12cd0be7cb457711733f27b4d168,0,Andrew Onishuk,2017-04-24 14:59:56+03:00,['92ac66ff26a5f07c37895e04c4f78066b1cdd75e'],10,50,60,26565687,5,0.214285714,0.785714286,1,29273
d853ad8366ee150aca0a7ee883b01edf98724cd4,0,Andrew Onishuk,2017-04-24 14:59:56+03:00,['8d0ec0847abb12cd0be7cb457711733f27b4d168'],0,11,11,26565698,1,,,,29273
c8de2d07191c014504111a1d55db259d250fbef5,0,Andrew Onishuk,2017-04-24 14:59:56+03:00,['d853ad8366ee150aca0a7ee883b01edf98724cd4'],2,3,5,26565703,1,0,0,1,29273
be2510f7d46dc99170514a7e8a04f7dd8c43c05d,1,Andrew Onishuk,2017-04-24 14:59:56+03:00,['c8de2d07191c014504111a1d55db259d250fbef5'],215,840,1055,26566758,2,0.5968,1,1,29273
4d4e767d22b3b562c1c975bdf65f1a4b5db38fdb,0,Andrew Onishuk,2017-04-24 14:59:56+03:00,['be2510f7d46dc99170514a7e8a04f7dd8c43c05d'],3,14,17,26566775,5,,,,29273
c77e4d2255c35afa002e5adc3298d6e81ccd742b,0,Andrew Onishuk,2017-04-24 14:59:56+03:00,['4d4e767d22b3b562c1c975bdf65f1a4b5db38fdb'],35,18,53,26566828,4,1,0,0,29273
1cd9d1e0fa4357c2c073d6430809095344d5480e,0,Andrew Onishuk,2017-04-24 14:59:56+03:00,['c77e4d2255c35afa002e5adc3298d6e81ccd742b'],3,2,5,26566833,1,,,,29273
c1f9aba75829c7a877988ab7894b1880513fa10d,0,Andrew Onishuk,2017-04-24 14:59:56+03:00,['1cd9d1e0fa4357c2c073d6430809095344d5480e'],369,385,754,26567587,19,,,,29273
ae5c17eddac8f0ac9f14ef76704c790712383bb1,0,Andrew Onishuk,2017-04-24 14:59:56+03:00,['c1f9aba75829c7a877988ab7894b1880513fa10d'],0,2,2,26567589,1,1,0,1,29273
dfb34498bdda159b6cbc86064a612439d49a75ea,0,Andrew Onishuk,2017-04-24 14:59:56+03:00,['ae5c17eddac8f0ac9f14ef76704c790712383bb1'],102,293,395,26567984,4,0.513157895,1,0.223684211,29275
78048fcfa9a1dd1cf5a98cf773d51ef69eff6db0,1,Andrew Onishuk,2017-04-24 14:59:56+03:00,['dfb34498bdda159b6cbc86064a612439d49a75ea'],6,13,19,26568003,1,,,,29275
8ead1899099b9125133ee1d33921be14382ca73a,0,Andrew Onishuk,2017-04-24 14:59:56+03:00,['78048fcfa9a1dd1cf5a98cf773d51ef69eff6db0'],0,4170,4170,26572173,1,,,,29276
53dcaa8d2c3b401f47a258c73398ef8746a230f6,0,Andrew Onishuk,2017-04-24 14:59:56+03:00,['8ead1899099b9125133ee1d33921be14382ca73a'],0,10,10,26572183,2,0.25,0.25,1,29276
c306a2b7c7dab94cffaeb56224af9c0308068f29,0,Andrew Onishuk,2017-04-24 14:59:56+03:00,['53dcaa8d2c3b401f47a258c73398ef8746a230f6'],0,1,1,26572184,1,,,,29276
8322ed571e2b9b235154dea7393593b6f8401370,0,Andrew Onishuk,2017-04-24 14:59:56+03:00,['c306a2b7c7dab94cffaeb56224af9c0308068f29'],7,9,16,26572200,1,,,,29276
2049199b59a6d0581ace945c986580621ee33696,0,Andrew Onishuk,2017-04-24 14:59:56+03:00,['8322ed571e2b9b235154dea7393593b6f8401370'],2,56,58,26572258,3,0,0,1,29277
22fda0accc034414fe0078036408668001b699c1,0,Andrew Onishuk,2017-04-24 14:59:56+03:00,['2049199b59a6d0581ace945c986580621ee33696'],3,35,38,26572296,5,0,1,1,29278
2c5522404a08eb9b399b70dad503725290dd78bc,0,Andrew Onishuk,2017-04-24 14:59:56+03:00,['22fda0accc034414fe0078036408668001b699c1'],1,1,2,26572298,1,,,,29278
abe5e5565387e0d1e86e879ff15c7b6f7c94bc37,0,Andrew Onishuk,2017-04-24 14:59:56+03:00,['2c5522404a08eb9b399b70dad503725290dd78bc'],1,1,2,26572300,1,,,,29278
c53b68ea200ca85b3aa3148f84e616981c6c72d2,0,Andrew Onishuk,2017-04-24 14:59:56+03:00,['abe5e5565387e0d1e86e879ff15c7b6f7c94bc37'],2,4,6,26572306,2,,,,29278
7b61d0ce0a15bb2ba59c0a32400e8f13f6c9e12d,0,Andrew Onishuk,2017-04-24 14:59:56+03:00,['c53b68ea200ca85b3aa3148f84e616981c6c72d2'],10,10,20,26572326,6,,,,29278
9f113f96cedabc49d51be62f90460a91fb57d1c6,0,Andrew Onishuk,2017-04-24 14:59:56+03:00,['7b61d0ce0a15bb2ba59c0a32400e8f13f6c9e12d'],3,6,9,26572335,1,1,1,1,29278
6b549d36fb196a423cfa2ba83971e9f1fa39b220,0,Andrew Onishuk,2017-04-24 14:59:56+03:00,['9f113f96cedabc49d51be62f90460a91fb57d1c6'],1,9,10,26572345,2,0.5,0.5,1,29278
665a2cd9b1747f87204f0406b029fd8186919c9a,1,Andrew Onishuk,2017-04-24 14:59:56+03:00,['6b549d36fb196a423cfa2ba83971e9f1fa39b220'],124,220,344,26572689,24,,,,29278
2a00812a66fb6bd1e92f857ed0ecd4cb5f91a615,1,Andrew Onishuk,2017-04-24 14:59:56+03:00,['665a2cd9b1747f87204f0406b029fd8186919c9a'],5211,13,5224,26577913,81,0.992218816,0.516623438,0.458146664,29278
4b27feb7fdc3adcefed6c89dd5ba9c357c5b6944,0,Andrew Onishuk,2017-04-24 14:59:56+03:00,['2a00812a66fb6bd1e92f857ed0ecd4cb5f91a615'],45,76,121,26578034,8,0,0,0.75,29278
978c9d7e894d6017fb5bc6f65fd8bf12d1264cd5,0,Andrew Onishuk,2017-04-24 14:59:56+03:00,['4b27feb7fdc3adcefed6c89dd5ba9c357c5b6944'],3,10,13,26578047,3,1,1,1,29278
d1dce4c8077e38bc8c67ccae4934819ebb869876,0,Andrew Onishuk,2017-04-24 14:59:56+03:00,['978c9d7e894d6017fb5bc6f65fd8bf12d1264cd5'],0,36,36,26578083,5,0,0.428571429,0.428571429,29278
6b399e4c5582ab1c9a80c5436596000f231e0a4f,0,Andrew Onishuk,2017-04-24 14:59:56+03:00,['d1dce4c8077e38bc8c67ccae4934819ebb869876'],1,1,2,26578085,1,,,,29278
e87944093260a9463b1db539c14b2e8bf0a08229,1,Andrew Onishuk,2017-04-24 14:59:56+03:00,['6b399e4c5582ab1c9a80c5436596000f231e0a4f'],0,16,16,26578101,3,,,,29278
41006ebebb81d6e2aefda4efb51401ecb810fa2e,1,Andrew Onishuk,2017-04-24 14:59:56+03:00,['e87944093260a9463b1db539c14b2e8bf0a08229'],0,10489,10489,26588590,47,0.391033624,0.484433375,0.889165629,29325
61e363bc691f6ffe8ce469abf4a06ae20af1b98a,0,Andrew Onishuk,2017-04-24 14:59:56+03:00,['41006ebebb81d6e2aefda4efb51401ecb810fa2e'],0,136,136,26588726,6,0.022222222,0.022222222,0.977777778,29325
f622e3ae589f5212f88fe3f6050c5846e6cdf653,0,Andrew Onishuk,2017-04-24 14:59:56+03:00,['61e363bc691f6ffe8ce469abf4a06ae20af1b98a'],3,38,41,26588767,2,1,1,1,29325
fb2ba4945eed30e63e82d4508039e35ae6a851f6,0,Andrew Onishuk,2017-04-24 14:59:56+03:00,['f622e3ae589f5212f88fe3f6050c5846e6cdf653'],14,166,180,26588947,13,1,1,1,29327
8cc384cae0eba1705a7de77eb5747b96c0bc0b21,0,Andrew Onishuk,2017-04-24 15:00:48+03:00,['fb2ba4945eed30e63e82d4508039e35ae6a851f6'],2,1,3,26588950,1,,,,29327
2a493704fdf16e8cc38f27c062c9c9bbf374734a,1,Andrew Onishuk,2017-04-24 15:02:08+03:00,['8cc384cae0eba1705a7de77eb5747b96c0bc0b21'],158,234,392,26589342,11,1,1,1,29328
8c039bbc20d7a66fc46f62e5c1d2d690171b667e,1,Bob Nettleton,2017-04-24 10:55:15-04:00,['e8fd10cf6de7cc20662ab7d609ac8e105326ab6a'],20,304,324,26589666,2,0.030674847,1,0.963190184,29328
2958fbefb069be22a2e6140a102ec87e6b7e1ad5,1,Jonathan Hurley,2017-04-24 13:04:00-04:00,['8c039bbc20d7a66fc46f62e5c1d2d690171b667e'],21,60,81,26589747,4,0.230769231,0.615384615,1,29328
0197813e05baa711f4dd215f407b2e29442318e6,0,Richard Zang,2017-04-24 13:52:50-07:00,['2958fbefb069be22a2e6140a102ec87e6b7e1ad5'],12,6,18,26589765,2,1,1,0,29328
4b672348dacb96466275b8bfa2c41b62885f993c,0,Nate Cole,2017-04-24 17:09:13-04:00,['0197813e05baa711f4dd215f407b2e29442318e6'],8,53,61,26589826,6,0.652173913,0.652173913,1,29328
acde08995f46b67f0acd656f6a52889385317217,0,Juanjo Marron,2017-04-24 14:42:29-07:00,['4b672348dacb96466275b8bfa2c41b62885f993c'],4,8,12,26589838,1,0,0,1,29328
ed612008ab664f59a06a5c609dfbe317c6a59948,0,Attila Doroszlai,2017-04-25 09:11:19+02:00,['acde08995f46b67f0acd656f6a52889385317217'],3,6,9,26589847,2,0,1,1,29328
c3206b859fb82bad8c08f126ffa613b2314e6967,0,Venkata Sairam,2017-04-25 12:34:00+05:18,['ed612008ab664f59a06a5c609dfbe317c6a59948'],4,8,12,26589859,2,1,1,1,29328
96d7bd02d6a6902bf8cf72cdbecf95b8605402a5,0,Venkata Sairam,2017-04-25 14:05:20+05:18,['c3206b859fb82bad8c08f126ffa613b2314e6967'],2,9,11,26589870,3,,,,29328
7f53d181909f805792ef35053606cafe3ff2c462,1,oleewere,2017-04-25 11:12:08+02:00,['96d7bd02d6a6902bf8cf72cdbecf95b8605402a5'],1,1,2,26589872,1,,,,29328
381a4b1a751bd6428af919f78e33bb63a0b62c25,1,Vitaly Brodetskyi,2017-04-25 14:11:41+03:00,['7f53d181909f805792ef35053606cafe3ff2c462'],0,675,675,26590547,1,0.196936543,0.179431072,0.059080963,29329
fa54474740cc859ad3b2b4236e18161a6e43fd20,1,Nitiraj Singh Rathore,2017-04-25 16:45:17+05:18,['381a4b1a751bd6428af919f78e33bb63a0b62c25'],51,31,82,26590629,6,0,0,0,29329
64c9ef8a58717f00251e57ebc61870b39d63c692,0,Sandor Magyari,2017-04-25 13:38:32+02:00,['fa54474740cc859ad3b2b4236e18161a6e43fd20'],93,119,212,26590841,11,0,0.777777778,0.722222222,29329
1b7c023d09827692c47d25bcdecb37669d342035,1,Nitiraj Singh Rathore,2017-04-25 17:04:20+05:18,['64c9ef8a58717f00251e57ebc61870b39d63c692'],15,66,81,26590922,3,0.555555556,0.555555556,0.972222222,29329
e8e997a36e38a38ac7ca4695377ba800a8427f87,1,Miklos Gergely,2017-04-25 15:53:37+02:00,['1b7c023d09827692c47d25bcdecb37669d342035'],102,121,223,26591145,7,0.090909091,1,0,29330
26484a8f72ab4f895e472e11fa69330ccaf6f5af,1,Alex Antonenko,2017-04-25 18:13:00+03:00,['e8e997a36e38a38ac7ca4695377ba800a8427f87'],9,20,29,26591174,3,,,,29330
04a5392791548a5341b705f869094adc0b5f58fa,1,Di Li,2017-04-25 12:01:01-04:00,['26484a8f72ab4f895e472e11fa69330ccaf6f5af'],4,28,32,26591206,2,0.913043478,1,1,29330
1f68c6e845a5f9b9909e539c6c3ffc4fda198c35,0,Bob Nettleton,2017-04-25 13:11:50-04:00,['04a5392791548a5341b705f869094adc0b5f58fa'],0,15,15,26591221,2,0.1,1,1,29330
37ba33ffd62b60959d0d880d599d6af33e10dde6,0,Alex Antonenko,2017-04-25 20:55:07+03:00,['1f68c6e845a5f9b9909e539c6c3ffc4fda198c35'],1,1,2,26591223,1,,,,29330
ec51e16630debc6595d92a29690ce62fd719e2ca,0,Attila Doroszlai,2017-04-25 21:36:13+02:00,['37ba33ffd62b60959d0d880d599d6af33e10dde6'],3,2,5,26591228,2,,1,,29330
35d7220afb894565134dd1503d8f2dc08d7be59c,1,Sangeeta Ravindran,2017-04-25 12:58:22-07:00,['ec51e16630debc6595d92a29690ce62fd719e2ca'],8,141,149,26591377,22,0.630769231,0.861538462,0.169230769,29331
09ca4857986eb734b93b5862620a85c8bff7b691,0,Jonathan Hurley,2017-04-25 17:31:00-04:00,['35d7220afb894565134dd1503d8f2dc08d7be59c'],27,5,32,26591409,2,0,0,0,29331
2ff8c0116a044d4b028e3835025c9b116f7c1021,0,padmapriyanitt,2017-04-26 14:53:00+05:18,['09ca4857986eb734b93b5862620a85c8bff7b691'],2,2,4,26591413,1,,,,29331
4d8c8e3757e774cf7b6ad544ebbd93c744632ea9,1,oleewere,2017-04-26 12:44:11+02:00,['2ff8c0116a044d4b028e3835025c9b116f7c1021'],168,103,271,26591684,6,1,0,0,29331
28c9d18213ac4adeb6a2829998bc7de75701468a,1,oleewere,2017-04-26 12:53:09+02:00,['4d8c8e3757e774cf7b6ad544ebbd93c744632ea9'],0,933,933,26592617,12,0.283464567,1,1,29342
9c0162ccdb77b9994607dcc9226c9ac2be043995,1,oleewere,2017-04-26 15:07:06+02:00,['28c9d18213ac4adeb6a2829998bc7de75701468a'],2,2,4,26592621,1,,,,29342
6bd1addfbbf81287e6d36a5cad7422b518228cb5,0,Alex Antonenko,2017-04-26 17:14:28+03:00,['9c0162ccdb77b9994607dcc9226c9ac2be043995'],2,2,4,26592625,2,,,,29342
e759b788992631796eec5414049d014e6c70400b,0,Dmytro Sen,2017-04-26 17:52:29+03:00,['6bd1addfbbf81287e6d36a5cad7422b518228cb5'],2,4,6,26592631,2,0,1,0,29342
54ac5a7695e944b7fcebafa0e5bab458cbf9f3a1,0,Vitaly Brodetskyi,2017-04-26 18:30:50+03:00,['e759b788992631796eec5414049d014e6c70400b'],1,1,2,26592633,1,,,,29342
bd1b2c9ff89468ef4b55f86cd5c2fafbf1dd2332,0,ababiichuk,2017-04-26 19:22:40+03:00,['54ac5a7695e944b7fcebafa0e5bab458cbf9f3a1'],2,14,16,26592649,2,1,1,1,29342
6a0b2a0e2be6901b13db0787fa70ff98905b19da,0,Jonathan Hurley,2017-04-26 13:21:01-04:00,['bd1b2c9ff89468ef4b55f86cd5c2fafbf1dd2332'],8,604,612,26593261,6,0.107883817,0.709543568,0.958506224,29344
e3d5344a6cf0e22455580cd9a63f8e30256c7097,0,Jonathan Hurley,2017-04-26 13:59:54-04:00,"['c8858af27daa31bcfc1bef92f6630483c6a1dc41', '6a0b2a0e2be6901b13db0787fa70ff98905b19da']",588,3679,4267,26597528,137,,,,29344
8a73145839f4b34c2231faac04ad10e64c096a87,1,Aravindan Vijayan,2017-04-26 11:15:02-07:00,['6a0b2a0e2be6901b13db0787fa70ff98905b19da'],8,56,64,26597592,5,0,0,0.625,29344
362d6ecaba8e1909e26b79928be91ae8a8103461,1,Dmytro Sen,2017-04-26 21:35:45+03:00,['8a73145839f4b34c2231faac04ad10e64c096a87'],69,278,347,26597939,46,0.13559322,0.745762712,0.474576271,29344
1069844bc9858155f2732cb14e2a38e3342dea01,0,Jaimin Jetly,2017-04-26 16:34:28-07:00,['362d6ecaba8e1909e26b79928be91ae8a8103461'],7,13,20,26597959,1,0,0,1,29344
4712bf54a03b20ca11f79884facb1e25ed50d403,1,pallavkul,2017-04-27 11:42:56+05:18,['1069844bc9858155f2732cb14e2a38e3342dea01'],132,206,338,26598297,13,1,1,1,29344
b11a1f0bae798462d7029e8d0c2662c7383da4ca,1,pallavkul,2017-04-27 11:49:29+05:18,['4712bf54a03b20ca11f79884facb1e25ed50d403'],1,2,3,26598300,1,0.5,1,1,29344
f4877c8be7dfc456c1126123dfe3a8e064670d65,1,oleewere,2017-04-27 13:20:13+02:00,['b11a1f0bae798462d7029e8d0c2662c7383da4ca'],19,59,78,26598378,6,1,1,0.148148148,29344
32552c9b4ab5f08e6a6a3d853b5602885dce244f,1,Andrew Onishuk,2017-04-27 15:07:27+03:00,['2a493704fdf16e8cc38f27c062c9c9bbf374734a'],34,183,217,26598595,7,0.426666667,0.546666667,1,29345
101942df479c7e572eb3c5c984eef0903b44d05c,0,Andrew Onishuk,2017-04-27 15:11:59+03:00,['f4877c8be7dfc456c1126123dfe3a8e064670d65'],29,28,57,26598652,3,1,1,1,29345
e2f7301c611ac190de524a504590d3cd811b0480,0,Venkata Sairam,2017-04-27 17:39:40+05:18,['101942df479c7e572eb3c5c984eef0903b44d05c'],3,3,6,26598658,2,,,,29345
dd572397c1cb87bb03816bb654ff8b8cc48a9cef,0,lpuskas,2017-04-27 15:34:24+02:00,['e2f7301c611ac190de524a504590d3cd811b0480'],1,1,2,26598660,1,,,,29345
30eb73a7627512f421d7e17e16846abee5033e84,0,Miklos Gergely,2017-04-27 17:00:25+02:00,['dd572397c1cb87bb03816bb654ff8b8cc48a9cef'],3,13,16,26598676,4,,,,29345
59f9ab216591983cc4dc1054e5a073cb9ccf91c9,0,Sangeeta Ravindran,2017-04-27 10:18:38-07:00,['30eb73a7627512f421d7e17e16846abee5033e84'],1,2,3,26598679,1,1,1,1,29345
8ed8f41a04e203a2ced17b024ae74da61f173b39,0,Myroslav Papirkovskyi,2017-04-27 20:46:36+03:00,['59f9ab216591983cc4dc1054e5a073cb9ccf91c9'],3,6,9,26598688,1,0,0,1,29345
94795d9e48de1a9ef0f4de7337182bdd22af7983,1,Yusaku Sako,2017-04-27 12:03:47-07:00,['8ed8f41a04e203a2ced17b024ae74da61f173b39'],41,24,65,26598753,1,,,,29345
13d806b85d50f10f00140aea5c590f9b86832cfc,0,Jonathan Hurley,2017-04-27 15:15:35-04:00,"['e3d5344a6cf0e22455580cd9a63f8e30256c7097', '94795d9e48de1a9ef0f4de7337182bdd22af7983']",317,691,1008,26599761,85,,,,29345
36fd8c7cb1b3e828a1411ede0c0dcbbacb33b208,1,Yusaku Sako,2017-04-27 12:17:41-07:00,['94795d9e48de1a9ef0f4de7337182bdd22af7983'],2,1,3,26599764,1,,,,29345
57a9af3248d194e589e1c3db7e6c71c31f331119,0,Nate Cole,2017-04-27 15:42:06-04:00,"['36fd8c7cb1b3e828a1411ede0c0dcbbacb33b208', '13d806b85d50f10f00140aea5c590f9b86832cfc']",455,1215,1670,26601434,43,,,,29345
b68662490a64277f4d5eb7ae18b54850678deff2,1,Nate Cole,2017-04-27 16:11:15-04:00,['13d806b85d50f10f00140aea5c590f9b86832cfc'],333,2293,2626,26604060,24,0.185022026,0.898678414,0.986784141,29349
8e61c55ed315cdda60ea1ea3ca2e38b755b010de,0,padmapriyanitt,2017-04-28 07:08:10+05:18,['57a9af3248d194e589e1c3db7e6c71c31f331119'],371,0,371,26604431,5,0.376996805,0.153354633,0.28115016,29349
7fe8fbc960313ba019ce2f60320bd789ebb7c77f,0,padmapriyanitt,2017-04-28 10:38:21+05:18,['8e61c55ed315cdda60ea1ea3ca2e38b755b010de'],2,20,22,26604453,2,1,1,1,29349
9631cbde402eb68ee0c38e4f84261c580c5e69fd,0,padmapriyanitt,2017-04-28 10:48:31+05:18,['7fe8fbc960313ba019ce2f60320bd789ebb7c77f'],1,4,5,26604458,1,1,1,1,29349
704072cb01c2e84708c1fd259ab8a01a728ea904,0,Attila Doroszlai,2017-04-28 14:08:53+02:00,['9631cbde402eb68ee0c38e4f84261c580c5e69fd'],3,3,6,26604464,2,,,,29349
0d2ac4f1b294662917b8a50a7cb5c895d7049c03,1,Vitaly Brodetskyi,2017-04-28 15:11:09+03:00,['704072cb01c2e84708c1fd259ab8a01a728ea904'],24,40,64,26604528,8,0,1,1,29349
7a0c9e469596046f8c71bd790c67851429b77e26,1,Jonathan Hurley,2017-04-28 08:46:30-04:00,['0d2ac4f1b294662917b8a50a7cb5c895d7049c03'],0,340,340,26604868,4,0.033898305,0.033898305,0.033898305,29351
92726b9548006a8069914fead05d2974f31efb8c,1,Jonathan Hurley,2017-04-28 08:54:25-04:00,['7a0c9e469596046f8c71bd790c67851429b77e26'],0,351,351,26605219,4,0.05,0.05,0.05,29353
19f9c983e3279dcb57e05c1395da64014e1c9181,0,Venkata Sairam,2017-04-28 20:35:22+05:18,['92726b9548006a8069914fead05d2974f31efb8c'],1,1,2,26605221,1,1,0,0,29353
79cca1c7184f1661236971dac70d85a83fab6c11,1,Sandor Magyari,2017-04-28 23:20:35+02:00,['19f9c983e3279dcb57e05c1395da64014e1c9181'],76,308,384,26605605,12,0.006535948,0.477124183,0.954248366,29353
d51655a83d6c6dd15864e7c4268f8ec9c002cf68,0,Madhuvanthi Radhakrishnan,2017-04-28 16:21:13-07:00,['79cca1c7184f1661236971dac70d85a83fab6c11'],43,59,102,26605707,14,1,1,0,29353
a55af8122b4c742f5edf9c31c50a56fd07ff17a3,1,Swapan Shridhar,2017-04-28 16:33:07-07:00,['d51655a83d6c6dd15864e7c4268f8ec9c002cf68'],0,464,464,26606171,3,0,0.90052356,0.90052356,29353
85ef37064ec53a2eb117a3f603e39c2a56ccc17c,1,Richard Zang,2017-04-28 16:36:18-07:00,['a55af8122b4c742f5edf9c31c50a56fd07ff17a3'],119,441,560,26606731,24,0.214285714,0.142857143,0,29353
7f10e446c75516087432768605a9ce25f4b82a67,1,pallavkul,2017-04-29 12:31:27+05:18,['85ef37064ec53a2eb117a3f603e39c2a56ccc17c'],15,64,79,26606810,4,0.8,1,0.8,29353
aa5a9d997301da465bc916ef799414d4d7dc9ba2,1,pallavkul,2017-04-29 12:35:17+05:18,['7f10e446c75516087432768605a9ce25f4b82a67'],0,10,10,26606820,2,,,,29353
4d59c595a35de1ed954183177ba2fc877adba246,0,Jonathan Hurley,2017-04-29 10:10:14-04:00,['aa5a9d997301da465bc916ef799414d4d7dc9ba2'],1,1,2,26606822,1,,,,29353
7d3435e36724adba270e222d074ca273e43d66b1,1,Dipayan Bhowmick,2017-04-29 23:04:12+05:18,['4d59c595a35de1ed954183177ba2fc877adba246'],3,6,9,26606831,1,0,0,1,29353
f5b11e75c9951cc4bc10c511ec3c015a7f00cdb9,1,Venkata Sairam,2017-04-30 00:14:17+05:18,['7d3435e36724adba270e222d074ca273e43d66b1'],0,1,1,26606832,1,1,1,0,29353
714d04eb31d0e44f9e60666ce951a7466a4ee7bd,1,Venkata Sairam,2017-04-30 11:32:08+05:18,['f5b11e75c9951cc4bc10c511ec3c015a7f00cdb9'],6,140,146,26606978,1,0.063291139,0.417721519,0.886075949,29353
21c3c7cd6f3e1c8a067f2915408454c05a228c86,0,Venkata Sairam,2017-04-30 14:34:11+05:18,['714d04eb31d0e44f9e60666ce951a7466a4ee7bd'],80,41418,41498,26648476,23,,,,29362
dd8ab0e61514f02f0832ef0c8e626d9a552b11fd,1,Nitiraj Singh Rathore,2017-04-30 18:51:49+05:18,['21c3c7cd6f3e1c8a067f2915408454c05a228c86'],1,1,2,26648478,1,,,,29362
880b655fe0b8d7b16f83bccb2f33116b4f1b7fcb,0,pallavkul,2017-04-30 19:31:15+05:18,['dd8ab0e61514f02f0832ef0c8e626d9a552b11fd'],2,3,5,26648483,2,,,,29362
d1a32019c70e8358aba5ba6c0967caa0661e6310,0,Venkata Sairam,2017-04-30 19:57:08+05:18,['880b655fe0b8d7b16f83bccb2f33116b4f1b7fcb'],33,155,188,26648671,10,1,1,0.225806452,29362
5254914af580af6d6dcf0abc92592420726e88da,1,Venkata Sairam,2017-04-30 21:09:05+05:18,['d1a32019c70e8358aba5ba6c0967caa0661e6310'],155,33,188,26648859,10,0,0,0.774193548,29362
38998e8c991bf81c9315e45c8c6ec6a905a73d3f,1,Venkata Sairam,2017-04-30 21:16:11+05:18,['5254914af580af6d6dcf0abc92592420726e88da'],33,179,212,26649071,11,1,1,0.225806452,29363
60f6c4db49bfe1fd3e5323db9a9b8049b68d5bf9,1,Venkata Sairam,2017-04-30 21:40:20+05:18,['38998e8c991bf81c9315e45c8c6ec6a905a73d3f'],41418,80,41498,26690569,23,,,,29363
4857a6e48181b48434cac0b4fe2e57918ff5eca0,0,Gautam Borad,2017-04-30 22:56:36+05:18,['60f6c4db49bfe1fd3e5323db9a9b8049b68d5bf9'],1,28,29,26690598,9,,,,29363
9dd542be2c7bb3b12ea50c8902f3d8e1413eebf3,1,Gautam Borad,2017-04-30 23:11:08+05:18,['4857a6e48181b48434cac0b4fe2e57918ff5eca0'],6,165,171,26690769,8,0,0.836363636,0.581818182,29363
d293ec1d87c50e9c797193e7af3022bdc0e30041,1,Venkata Sairam,2017-04-30 23:50:22+05:18,['9dd542be2c7bb3b12ea50c8902f3d8e1413eebf3'],80,41394,41474,26732243,24,,,,29372
9eddcc21dce8939ad5fa6e3507f88b3a912e89e4,1,Dipayan Bhowmick,2017-05-01 00:22:05+05:18,['d293ec1d87c50e9c797193e7af3022bdc0e30041'],0,17,17,26732260,1,0,1,1,29372
bfcc42dcc76aabe9e00c123b92ea9d40d643c713,1,Dipayan Bhowmick,2017-05-01 14:26:30+05:18,['9eddcc21dce8939ad5fa6e3507f88b3a912e89e4'],15,26,41,26732301,3,0.923076923,0.923076923,1,29372
8549682b546b07f15cba4bf48737b3f751f90fb0,0,Venkata Sairam,2017-05-01 18:27:56+05:18,['bfcc42dcc76aabe9e00c123b92ea9d40d643c713'],0,1,1,26732302,1,,,,29372
f167236c24501a0d14afccfbc53a2c648cb21731,1,Robert Levas,2017-05-01 16:33:59-04:00,['8549682b546b07f15cba4bf48737b3f751f90fb0'],20,43,63,26732365,2,0.333333333,1,1,29372
aef60264f105a3b060a91dea1d637638384f0289,1,Alejandro Fernandez,2017-05-01 15:04:14-07:00,['f167236c24501a0d14afccfbc53a2c648cb21731'],557,555,1112,26733477,9,,,,29372
26d28efabecf225c255d6850b266ba2b22a5c6a3,0,Nitiraj Singh Rathore,2017-05-02 14:12:55+05:18,['aef60264f105a3b060a91dea1d637638384f0289'],2,22,24,26733501,3,0.5,0.5,1,29372
13a981c1a32e788c41657c9d2e0089cc0b86986c,1,pallavkul,2017-05-02 16:53:50+05:18,['26d28efabecf225c255d6850b266ba2b22a5c6a3'],2,2,4,26733505,1,,,,29372
34761fcdcec142d1d6e1dcf76febb9ce526ae927,0,Robert Levas,2017-05-02 10:52:18-04:00,['13a981c1a32e788c41657c9d2e0089cc0b86986c'],1,46,47,26733552,2,0,0.823529412,0.823529412,29372
2b146d9c421b12d2b11def840aca69d1dead4428,0,Attila Doroszlai,2017-05-02 17:34:26+02:00,['34761fcdcec142d1d6e1dcf76febb9ce526ae927'],489,0,489,26734041,1,0.748427673,0.393081761,0.352201258,29372
6e2d32196b065530263b1468d50d710db8b8eca5,0,Di Li,2017-05-02 14:25:18-04:00,['2b146d9c421b12d2b11def840aca69d1dead4428'],2,2,4,26734045,1,1,1,1,29372
b3f7d9e4211a3378c99538f606b27c30a33a34be,1,Alejandro Fernandez,2017-05-02 11:43:07-07:00,['6e2d32196b065530263b1468d50d710db8b8eca5'],1,3,4,26734049,2,,,,29372
4b588a9237a72465f3ca83c207a8d4234d9c4c12,0,Alejandro Fernandez,2017-05-02 13:51:13-07:00,['b3f7d9e4211a3378c99538f606b27c30a33a34be'],0,0,0,26734049,11,,,,29372
f4243c3d3535311fa7de6790b0fe430ab8deffa7,0,Aravindan Vijayan,2017-05-02 15:14:22-07:00,['4b588a9237a72465f3ca83c207a8d4234d9c4c12'],6,13,19,26734068,2,0,1,1,29372
331aad44e29e481f9e727eae9922bbfbc91872de,0,Aravindan Vijayan,2017-05-02 15:37:17-07:00,['f4243c3d3535311fa7de6790b0fe430ab8deffa7'],1,1,2,26734070,1,,,,29372
05cf0dd72707b8bc05c8462f35ddaf992e271b9d,0,Mugdha Varadkar,2017-05-03 10:30:11+05:18,['331aad44e29e481f9e727eae9922bbfbc91872de'],1,1,2,26734072,1,,,,29372
4134bbfb0a2c02b81f66dbed954fb9495ef969f2,0,Gaurav Nagar,2017-05-03 11:37:23+05:18,['05cf0dd72707b8bc05c8462f35ddaf992e271b9d'],0,6,6,26734078,1,0,0,1,29372
2e579f11c25953e777abcfaf11facd0157635be3,1,Andrew Onishuk,2017-05-03 12:12:28+03:00,['32552c9b4ab5f08e6a6a3d853b5602885dce244f'],296,288,584,26734662,15,,,,29372
b733e70fd3aecb05e7817dcbd5e118a37381ace6,1,Eugene Chekanskiy,2017-05-03 13:19:35+03:00,['4134bbfb0a2c02b81f66dbed954fb9495ef969f2'],65,122,187,26734849,13,0,0.464285714,0.535714286,29372
ff1de98075c9d980c8db2c50d1f27a520c944c5a,0,Aleksandr Kovalenko,2017-05-03 14:07:07+03:00,['b733e70fd3aecb05e7817dcbd5e118a37381ace6'],0,3,3,26734852,1,1,1,1,29372
b061b1be2dca70d73ff82b873a83aad003c18a1a,0,Lisnichenko Dmitro,2017-05-03 15:23:41+03:00,['ff1de98075c9d980c8db2c50d1f27a520c944c5a'],3,26,29,26734881,10,0.846153846,1,1,29372
7d24bfc7814a5750cfa3abdce17f0ce4046c4821,1,Lisnichenko Dmitro,2017-05-03 16:17:41+03:00,['b061b1be2dca70d73ff82b873a83aad003c18a1a'],26,3,29,26734910,10,0.153846154,0,0,29372
f942bb22e30133c2fefd7a32cf981b7c088e9db7,1,Lisnichenko Dmitro,2017-05-03 16:32:18+03:00,['7d24bfc7814a5750cfa3abdce17f0ce4046c4821'],3,286,289,26735199,12,0.594202899,1,1,29374
35c90c996726fb1ae9fdf46f3a8da93f47914770,1,Attila Doroszlai,2017-05-03 15:44:53+02:00,['f942bb22e30133c2fefd7a32cf981b7c088e9db7'],0,126,126,26735325,5,,,,29377
8d6a9cc030fb908a002121267ce59ee419ac4b40,0,Lisnichenko Dmitro,2017-05-03 17:59:02+03:00,['35c90c996726fb1ae9fdf46f3a8da93f47914770'],2,2,4,26735329,1,,,,29377
dcbd826c96b91c718caa519f44663b9a73f17da6,1,Jonathan Hurley,2017-05-03 11:13:19-04:00,['b68662490a64277f4d5eb7ae18b54850678deff2'],3966,2148,6114,26741443,108,0.854375418,0.445557782,0.416833667,29377
6a148b76c615a040787377120cb03fdf222b468b,0,Lisnichenko Dmitro,2017-05-03 19:06:05+03:00,['8d6a9cc030fb908a002121267ce59ee419ac4b40'],9,9,18,26741461,1,,,,29377
d84abbfd303b8860c6f5f241d9c5e993b864c188,0,Jonathan Hurley,2017-05-03 12:45:42-04:00,"['dcbd826c96b91c718caa519f44663b9a73f17da6', '8d6a9cc030fb908a002121267ce59ee419ac4b40']",1949,45293,47242,26788703,201,,,,29377
154f678d8f92cc7fb7213f9dae5e3d20d66be44c,1,Sriharsha Chintalapani,2017-05-03 10:42:46-07:00,['6a148b76c615a040787377120cb03fdf222b468b'],34,17,51,26788754,4,0,0,0.043478261,29377
8782cf69160dae3d3894d7d93a6eb3f2c384e237,1,Nate Cole,2017-05-03 15:28:40-04:00,['d84abbfd303b8860c6f5f241d9c5e993b864c188'],86,249,335,26789089,10,0.076190476,0.80952381,0,29377
da9185ce3c32b95e2d38e67d65e54172d556157a,0,Vitaly Brodetskyi,2017-05-04 00:22:34+03:00,['154f678d8f92cc7fb7213f9dae5e3d20d66be44c'],1,14,15,26789104,1,0,0,0,29377
b0d7f001646fb2fcc502e0d980e20f4a8c6612d9,1,Jonathan Hurley,2017-05-03 17:46:35-04:00,['da9185ce3c32b95e2d38e67d65e54172d556157a'],18,47,65,26789169,3,0.285714286,0.892857143,0.928571429,29377
0971f413934a1acc38266f7fcf4c34554a6ac1d8,1,Xi Wang,2017-05-03 17:41:40-07:00,['b0d7f001646fb2fcc502e0d980e20f4a8c6612d9'],2,7,9,26789178,2,0,0,0,29377
25499636535a658499460deb968981d55797d7df,0,Mugdha Varadkar,2017-05-04 10:28:51+05:18,['0971f413934a1acc38266f7fcf4c34554a6ac1d8'],1,1,2,26789180,1,,,,29377
fa8322994385081187e285e43fe36d4575743ed4,0,Attila Doroszlai,2017-05-04 08:22:47+02:00,['25499636535a658499460deb968981d55797d7df'],9,13,22,26789202,1,,,,29377
37960b421d9e559f54ac1b1614e861d14f7cd389,0,Attila Doroszlai,2017-05-04 10:16:53+02:00,['fa8322994385081187e285e43fe36d4575743ed4'],1,6,7,26789209,2,1,1,1,29377
423d836d0e2024f6d0c7adaea074982cfdf88a2f,1,Mugdha Varadkar,2017-05-04 19:31:00+05:18,['37960b421d9e559f54ac1b1614e861d14f7cd389'],67,65,132,26789341,3,0.4,0,0.6,29377
7cc5e9e220b82052256a352f0e65323f2b1bc962,1,Robert Levas,2017-05-04 15:43:33-04:00,['423d836d0e2024f6d0c7adaea074982cfdf88a2f'],0,10,10,26789351,2,0,1,1,29377
4b48b80c0aa47bf01dd885d08a9f3cb55d716ae9,0,Attila Doroszlai,2017-05-04 23:10:34+02:00,['7cc5e9e220b82052256a352f0e65323f2b1bc962'],1,1,2,26789353,1,,,,29377
1aad067cff1601d3c0ddd1f019df0fa9eb442199,1,Sandor Magyari,2017-05-05 15:48:35+02:00,['4b48b80c0aa47bf01dd885d08a9f3cb55d716ae9'],17,133,150,26789503,3,0.095238095,0.476190476,0.952380952,29377
3817ad5da2076a274ca9fa4674b6d9d704610cb2,1,Vitaly Brodetskyi,2017-05-05 17:09:30+03:00,['1aad067cff1601d3c0ddd1f019df0fa9eb442199'],0,3313,3313,26792816,29,0.202469136,0.296296296,0.859259259,29406
57359c930fb3efea0e319f208b6784e1377ba8f3,0,ababiichuk,2017-05-05 17:38:36+03:00,['3817ad5da2076a274ca9fa4674b6d9d704610cb2'],1,23,24,26792840,2,0.590909091,0.590909091,1,29406
2b676c1829560c91ccafd8510a3202e61730ff66,0,Sangeeta Ravindran,2017-05-05 10:21:11-07:00,['57359c930fb3efea0e319f208b6784e1377ba8f3'],3,3,6,26792846,3,,,,29406
f65692a32d95e200624fa9d7dfb9ee7a1b00cb29,1,Jonathan Hurley,2017-05-05 13:34:59-04:00,['8782cf69160dae3d3894d7d93a6eb3f2c384e237'],352,417,769,26793615,33,1,0,1,29406
0abfb352596b1650647c33d929b04210481453bd,1,Vitaly Brodetskyi,2017-05-05 21:27:03+03:00,['2b676c1829560c91ccafd8510a3202e61730ff66'],0,363,363,26793978,1,0.239130435,0.239130435,0.065217391,29407
569a1bbb6dd7753133c933e684759b5a9e535289,0,Swapan Shridhar,2017-05-06 00:59:44-07:00,['0abfb352596b1650647c33d929b04210481453bd'],7,4,11,26793989,2,0,0,0,29407
2cd5a439533e636522b3dc0c6a088a76f856590d,0,Mugdha Varadkar,2017-05-08 10:17:35+05:18,['569a1bbb6dd7753133c933e684759b5a9e535289'],389,387,776,26794765,12,,,,29407
f9f44b7e2b9a576816e2062cfe307f3687f99de8,1,Mugdha Varadkar,2017-05-08 10:46:30+05:18,['2cd5a439533e636522b3dc0c6a088a76f856590d'],2,32,34,26794799,2,0.2,0,0,29407
e74d4f3fa505385a68cfec38bccc7ca4dc33c92d,0,Mugdha Varadkar,2017-05-08 10:56:14+05:18,['f9f44b7e2b9a576816e2062cfe307f3687f99de8'],10,64,74,26794873,3,0,0.75,0,29407
15c04ed5360e542e1f7c059e28a544f18ded3ae6,0,Jonathan Hurley,2017-05-08 10:02:22-04:00,"['f65692a32d95e200624fa9d7dfb9ee7a1b00cb29', 'e74d4f3fa505385a68cfec38bccc7ca4dc33c92d']",572,4505,5077,26799950,77,,,,29407
8a69951030d62479ddb2d6b3fbd310dcf77e55f5,0,Andrii Tkach,2017-05-08 17:49:02+03:00,['e74d4f3fa505385a68cfec38bccc7ca4dc33c92d'],190,5,195,26800145,3,0.93956044,0,0,29407
3dd206ccf4bd3dfeee128581e3641dedca86a842,0,Attila Doroszlai,2017-05-08 20:35:35+02:00,['8a69951030d62479ddb2d6b3fbd310dcf77e55f5'],4,22,26,26800171,4,1,1,1,29407
0e13b01849f1b13010a83b01861102a5febb5e7c,1,Attila Doroszlai,2017-05-08 20:52:42+02:00,['4ede671514563a3cc116bc2059d6d8b878a5a784'],532,434,966,26801137,22,0.65060241,0.373493976,0,29407
e20305bc4264de2d7b6d45d44575edeeeed14c6e,0,Tim Thorpe,2017-05-08 12:31:19-07:00,['3dd206ccf4bd3dfeee128581e3641dedca86a842'],6,34,40,26801177,2,0.166666667,0.833333333,0.166666667,29407
84586cc07860b9bf3434c07b427e3c8a067a6351,1,Eugene Chekanskiy,2017-05-08 22:33:17+03:00,['e20305bc4264de2d7b6d45d44575edeeeed14c6e'],49,114,163,26801340,8,0.575757576,0.606060606,0.666666667,29407
42a542a59f3fb2a73273f9d6dc84ead8c647d776,1,Vitaly Brodetskyi,2017-05-08 23:45:41+03:00,['84586cc07860b9bf3434c07b427e3c8a067a6351'],0,5112,5112,26806452,28,0.240932642,0.284974093,0.694300518,29435
6bae2b607b5ed95beba55975d2ff5b23b7a3f090,1,Vitaly Brodetskyi,2017-05-08 23:47:24+03:00,['42a542a59f3fb2a73273f9d6dc84ead8c647d776'],0,441,441,26806893,1,0.199203187,0.147410359,0.047808765,29436
94ddad50eeeba8dbbc329012cb9f80c79bcb31c9,1,Nitiraj Singh Rathore,2017-05-09 02:45:30+05:18,['6bae2b607b5ed95beba55975d2ff5b23b7a3f090'],73,281,354,26807247,9,0.695121951,1,0.987804878,29438
11e2563f7cbf0d9031399ff94e4723f999584213,1,Swapan Shridhar,2017-05-08 14:54:06-07:00,['94ddad50eeeba8dbbc329012cb9f80c79bcb31c9'],4,7,11,26807258,2,1,1,1,29438
aecc890eec3e1e075f1a8b42aeda4efa0e250da5,1,pallavkul,2017-05-09 16:15:49+05:18,['11e2563f7cbf0d9031399ff94e4723f999584213'],13,21,34,26807292,3,0.923076923,0,0.769230769,29438
8dae74cc26c8b60d082076e9852f06a399e009c4,1,Nitiraj Singh Rathore,2017-05-09 17:19:36+05:18,['aecc890eec3e1e075f1a8b42aeda4efa0e250da5'],20,9,29,26807321,4,1,1,1,29438
3153b9bc2f3ea9b3330e84aa34c34fc9457f01ad,1,oleewere,2017-05-09 14:05:50+02:00,['8dae74cc26c8b60d082076e9852f06a399e009c4'],179,788,967,26808288,17,0.98019802,1,1,29443
aaa821cc2455a29b1e83caf5eab98272053d5aa5,1,Nate Cole,2017-05-09 10:31:50-04:00,['15c04ed5360e542e1f7c059e28a544f18ded3ae6'],4051,704,4755,26813043,88,0.891877353,0.46422808,0.174287251,29443
a92fe1b1f2fa07e5c5f47dd5f484a45ae64a7bbd,1,Venkata Sairam,2017-05-09 19:55:46+05:18,['3153b9bc2f3ea9b3330e84aa34c34fc9457f01ad'],3,4,7,26813050,2,0,1,1,29443
aa78a1724feca81e75b5a0f82cf7b048dd2b938e,1,Tim Thorpe,2017-05-09 07:53:39-07:00,['a92fe1b1f2fa07e5c5f47dd5f484a45ae64a7bbd'],113,1917,2030,26815080,33,0.50295858,0.656804734,0.786982249,29460
436c912844657347b5a80f89dedd6d537db82867,0,Sumit Mohanty,2017-05-09 12:06:46-07:00,['aa78a1724feca81e75b5a0f82cf7b048dd2b938e'],2,2,4,26815084,2,,,,29460
6e1367d0b0fe44a26f772218de19e92154597e7b,0,Yusaku Sako,2017-05-09 12:26:27-07:00,['436c912844657347b5a80f89dedd6d537db82867'],2,4,6,26815090,1,,,,29460
a2632675a37223d66dc2cb2edb3138467d74fb5b,1,Jonathan Hurley,2017-05-09 16:49:23-04:00,['aaa821cc2455a29b1e83caf5eab98272053d5aa5'],680,436,1116,26816206,28,0.74691358,0.574074074,0.37654321,29460
b1f704dfb9b54a57b14ecb5314b65bee7288eeb1,0,Jonathan Hurley,2017-05-09 17:05:09-04:00,['a2632675a37223d66dc2cb2edb3138467d74fb5b'],25,65,90,26816296,6,0,0,0,29460
4dd94e17203b5c4a52991a23724cebb45f98852a,1,Madhuvanthi Radhakrishnan,2017-05-09 22:29:18-07:00,['6e1367d0b0fe44a26f772218de19e92154597e7b'],7,49,56,26816352,2,0,0,0,29460
9abfcf2586c50a69b1c80c8c91469c867e6e89ee,1,Madhuvanthi Radhakrishnan,2017-05-09 22:34:56-07:00,['4dd94e17203b5c4a52991a23724cebb45f98852a'],0,10,10,26816362,1,,,,29460
80ef77299855f4f1c6a0aceed9cee9ee93c22da1,0,Lisnichenko Dmitro,2017-05-10 14:34:05+03:00,['9abfcf2586c50a69b1c80c8c91469c867e6e89ee'],6,11,17,26816379,2,0,1,1,29460
8938ea219436d78c31934faeeb2c03bdd9f6f415,0,Jonathan Hurley,2017-05-10 09:36:26-04:00,"['b1f704dfb9b54a57b14ecb5314b65bee7288eeb1', '80ef77299855f4f1c6a0aceed9cee9ee93c22da1']",671,8831,9502,26825881,122,,,,29460
4595f00b0ec6bfd86eb8270d3af2f6876080a84f,0,Aleksandr Kovalenko,2017-05-10 16:49:25+03:00,['80ef77299855f4f1c6a0aceed9cee9ee93c22da1'],12,27,39,26825920,4,,,,29460
cef3f245eed01c36a7e3a9c628040a7b4e7ee1d0,1,Andrew Onishuk,2017-05-10 17:34:14+03:00,['2e579f11c25953e777abcfaf11facd0157635be3'],29,39,68,26825988,4,1,0,1,29460
506b84768581311d944b57cbd270ee3b96613b65,0,Andrii Tkach,2017-05-10 17:44:35+03:00,['4595f00b0ec6bfd86eb8270d3af2f6876080a84f'],17,42,59,26826047,2,,,,29460
54983ee3b8980e3f1e35a7859d4e759eb17fac87,1,Attila Doroszlai,2017-05-10 17:14:08+02:00,['0e13b01849f1b13010a83b01861102a5febb5e7c'],300,1397,1697,26827744,34,1,1,0.103448276,29465
c12c320f81de6cfed34b5d913384fc3851b71f4a,0,Vitaly Brodetskyi,2017-05-10 20:55:26+03:00,['506b84768581311d944b57cbd270ee3b96613b65'],5,26,31,26827775,1,0,1,0,29465
a60f1328bfcf3cfa8ae90ecc59bdc8b51e6daa65,1,Jonathan Hurley,2017-05-10 17:04:33-04:00,['c12c320f81de6cfed34b5d913384fc3851b71f4a'],8,60,68,26827843,3,0,0,0,29465
09ca0316d42240ea375e83b901ad3a4b0f55b37a,0,Madhuvanthi Radhakrishnan,2017-05-10 14:26:55-07:00,['a60f1328bfcf3cfa8ae90ecc59bdc8b51e6daa65'],4,5,9,26827852,1,0,0,0,29465
242d9e76f93d17532a60296d86d4e42f7299e039,1,Swapan Shridhar,2017-05-10 17:02:42-07:00,['09ca0316d42240ea375e83b901ad3a4b0f55b37a'],14,8,22,26827874,6,0,0,0,29465
4b3cbef39edb37b8b393dd5b19c968223a282281,1,Lisnichenko Dmitro,2017-05-11 13:27:06+03:00,['242d9e76f93d17532a60296d86d4e42f7299e039'],6,11,17,26827891,2,0,1,1,29465
55750b92a4f7ad00d2a63211f8b34364b47df289,0,Andrii Tkach,2017-05-11 13:49:12+03:00,['4b3cbef39edb37b8b393dd5b19c968223a282281'],6,2,8,26827899,2,,,,29465
3edbc2c41d489c20d1f503723491461eaa328fab,1,lpuskas,2017-05-11 13:35:40+02:00,['55750b92a4f7ad00d2a63211f8b34364b47df289'],82,512,594,26828493,5,0.286666667,0.793333333,0.913333333,29467
7e2dd63b7a3b7509a28b12641de87122eda0e33e,1,Lisnichenko Dmitro,2017-05-11 17:31:58+03:00,['3edbc2c41d489c20d1f503723491461eaa328fab'],3,3,6,26828499,3,,,,29467
b8cb5d4863c73a1cd76a4b47fe792e650c2f67a2,0,Jonathan Hurley,2017-05-11 11:32:39-04:00,['8938ea219436d78c31934faeeb2c03bdd9f6f415'],29,9,38,26828537,1,1,1,0,29467
1d46f23f743bf64a3d086863af02d15aeb36f484,1,Tim Thorpe,2017-05-11 10:27:07-07:00,['7e2dd63b7a3b7509a28b12641de87122eda0e33e'],6,6,12,26828549,2,,,,29467
7b0ccdae5572e4e96795f29f16dddb92c7e0128a,1,Jonathan Hurley,2017-05-11 15:04:23-04:00,['b8cb5d4863c73a1cd76a4b47fe792e650c2f67a2'],17,41,58,26828607,5,0.4375,0,0.875,29467
023c819a3d05c5bd8fbf1933930fbc5ddfda6e16,1,Alejandro Fernandez,2017-05-11 15:21:45-07:00,['1d46f23f743bf64a3d086863af02d15aeb36f484'],0,4,4,26828611,1,,,,29467
f7e9af87c75d8641a96b8b097b7b44f0a9f13538,1,Sumit Mohanty,2017-05-11 17:10:35-07:00,['023c819a3d05c5bd8fbf1933930fbc5ddfda6e16'],96,52,148,26828759,7,1,0.766233766,0,29467
461209a9050566117f7b7342be875d5cec7e94d8,1,Nitiraj Singh Rathore,2017-05-12 08:33:45+05:18,['f7e9af87c75d8641a96b8b097b7b44f0a9f13538'],16,16,32,26828791,2,,,,29467
fffd07c75ba1af09b0ba3fec347bd7a6fff87807,1,Nitiraj Singh Rathore,2017-05-12 08:41:38+05:18,['461209a9050566117f7b7342be875d5cec7e94d8'],4,4,8,26828799,1,,,,29467
4e6babdf1569f83c188b817c0aff5c4535b4d015,1,oleewere,2017-05-12 11:57:49+02:00,['fffd07c75ba1af09b0ba3fec347bd7a6fff87807'],5,409,414,26829213,9,1,1,0.952,29473
260ee2efc131c8dd0d5e4d9aa960eafb6b3d62ce,1,Vitaly Brodetskyi,2017-05-12 13:47:33+03:00,['4e6babdf1569f83c188b817c0aff5c4535b4d015'],0,10646,10646,26839859,40,0.246231156,0.443048576,0.804857621,29513
08dd15bd32323fd579e1c677ca4868c17f44d8dd,1,Vitaly Brodetskyi,2017-05-12 14:06:46+03:00,['260ee2efc131c8dd0d5e4d9aa960eafb6b3d62ce'],0,793,793,26840652,1,0.228200371,0.163265306,0.022263451,29514
48c9b3402610614603ae9aefa034a08a9a90c75b,0,Lisnichenko Dmitro,2017-05-12 16:53:56+03:00,['08dd15bd32323fd579e1c677ca4868c17f44d8dd'],2,7,9,26840661,1,1,1,0,29514
8f9786ba77670276d78d76b6a5d7dc2029a67a29,1,Lisnichenko Dmitro,2017-05-12 16:56:34+03:00,['48c9b3402610614603ae9aefa034a08a9a90c75b'],7,2,9,26840670,1,0,0,1,29514
87e8bdf1a0833897c98faeccfbf268017ed27c49,0,Jonathan Hurley,2017-05-12 10:32:12-04:00,"['7b0ccdae5572e4e96795f29f16dddb92c7e0128a', '8f9786ba77670276d78d76b6a5d7dc2029a67a29']",278,12620,12898,26853568,88,,,,29514
fb20c7c522a2afbb8ef25743ba770b574bb36ab8,0,Lisnichenko Dmitro,2017-05-12 17:41:21+03:00,['8f9786ba77670276d78d76b6a5d7dc2029a67a29'],2039,0,2039,26855607,18,0.308411215,0.090787717,0.076101469,29514
ec6e940602608666b90d51714f5040d6eb805216,0,Sumit Mohanty,2017-05-12 17:57:04-07:00,['fb20c7c522a2afbb8ef25743ba770b574bb36ab8'],0,1,1,26855608,1,,,,29514
6e4331e92f6b42fab3d36ea64df42019ae73e715,0,Swapan Shridhar,2017-05-12 19:27:52-07:00,['ec6e940602608666b90d51714f5040d6eb805216'],0,9,9,26855617,1,,,,29514
d0a5cd4a6b22f0c8e02bb7ceb2d5de11314f542a,0,Swapan Shridhar,2017-05-12 22:13:21-07:00,['6e4331e92f6b42fab3d36ea64df42019ae73e715'],1,64,65,26855682,12,,,,29514
822d54577677384f5a31eef90e2a345378fbcaf4,0,Sumit Mohanty,2017-05-12 22:30:38-07:00,['d0a5cd4a6b22f0c8e02bb7ceb2d5de11314f542a'],1,15,16,26855698,2,,,,29514
d83f733b054e9f2ed898093012af856835d6ae1a,0,Sumit Mohanty,2017-05-13 00:17:00-07:00,['822d54577677384f5a31eef90e2a345378fbcaf4'],0,8,8,26855706,1,,,,29514
7ccb6dcafe3c24bd80be84cf9aa0f30353c889f4,1,oleewere,2017-05-13 14:09:25+02:00,['d83f733b054e9f2ed898093012af856835d6ae1a'],6,8,14,26855720,6,,,,29514
ad09bb66e17783ea5fa10f873b325c6bdfb5e91f,1,Vitaly Brodetskyi,2017-05-15 14:19:01+03:00,['7ccb6dcafe3c24bd80be84cf9aa0f30353c889f4'],0,3131,3131,26858851,24,0.137030995,0.275693312,0.815660685,29538
e12652628102bf08b23e58b1954929b102c688df,1,Vitaly Brodetskyi,2017-05-15 14:51:05+03:00,['ad09bb66e17783ea5fa10f873b325c6bdfb5e91f'],0,281,281,26859132,1,0.474576271,0.372881356,0.101694915,29539
38cc334e035f588d1077962b597d77c068c31326,1,Alex Antonenko,2017-05-15 17:10:48+03:00,['e12652628102bf08b23e58b1954929b102c688df'],17,34,51,26859183,4,1,1,1,29539
fea1aaec8a5ff5b6c2fae8cf38f9ca3b789e1ab9,1,Attila Doroszlai,2017-05-16 09:09:07+02:00,['54983ee3b8980e3f1e35a7859d4e759eb17fac87'],33,394,427,26859610,7,,,,29542
580067f9965060a80ed99fb9f803ff5aae504fc0,0,Attila Doroszlai,2017-05-16 09:11:01+02:00,['fea1aaec8a5ff5b6c2fae8cf38f9ca3b789e1ab9'],10,159,169,26859779,5,,,,29543
228b9289755c33342586d8cbe209b5341d7380d0,1,Attila Doroszlai,2017-05-16 11:02:06+02:00,['580067f9965060a80ed99fb9f803ff5aae504fc0'],298,456,754,26860533,14,0.875,0.28125,0,29543
e54252c829f674919d51d38c33689cce7a17e075,1,oleewere,2017-05-16 11:46:18+02:00,['38cc334e035f588d1077962b597d77c068c31326'],19,114,133,26860666,5,1,1,0.743589744,29544
b97d268a1920c833fd8c7e94921a9148f7d2c398,1,oleewere,2017-05-16 11:46:18+02:00,['e54252c829f674919d51d38c33689cce7a17e075'],3,287,290,26860956,11,,,,29551
8cebc18b82e3e9df0c440675f26f8e6be32ebf06,0,Sandor Magyari,2017-05-16 13:59:08+02:00,['b97d268a1920c833fd8c7e94921a9148f7d2c398'],71,10,81,26861037,1,1,1,0,29551
47b845fb9acf2cdfe196731f05ec1395142a1fb5,0,Lisnichenko Dmitro,2017-05-16 18:46:27+03:00,['8cebc18b82e3e9df0c440675f26f8e6be32ebf06'],0,2,2,26861039,1,1,1,1,29551
522039ebd3f259c2a54db5102108209b94d5d004,1,Jonathan Hurley,2017-05-16 12:45:14-04:00,['87e8bdf1a0833897c98faeccfbf268017ed27c49'],2160,2012,4172,26865211,47,0.865546218,0.621848739,0,29552
1427d818b41a987767c3261e586368e47c43822c,0,Jonathan Hurley,2017-05-16 13:14:41-04:00,"['522039ebd3f259c2a54db5102108209b94d5d004', '47b845fb9acf2cdfe196731f05ec1395142a1fb5']",2157,3964,6121,26871332,84,,,,29552
b33391236b385e2e4620031b9773261bce8efdf6,1,Vitaly Brodetskyi,2017-05-16 22:16:59+03:00,['47b845fb9acf2cdfe196731f05ec1395142a1fb5'],0,803,803,26872135,14,0.451327434,0.761061947,0.946902655,29566
7799fb76c892c793803233a859f2b94b0b46d9e8,0,Alex Antonenko,2017-05-16 23:53:37+03:00,['b33391236b385e2e4620031b9773261bce8efdf6'],12,40,52,26872187,2,,,,29566
81416654126fe044d1d36af87f40d5a4151f4bd0,1,Vitaly Brodetskyi,2017-05-17 00:00:18+03:00,['7799fb76c892c793803233a859f2b94b0b46d9e8'],0,197,197,26872384,1,0.610169492,0.610169492,0.203389831,29567
9adffcf7a93d40ad727796a8a1686da0e6408893,1,Vitaly Brodetskyi,2017-05-17 00:16:45+03:00,['81416654126fe044d1d36af87f40d5a4151f4bd0'],0,3099,3099,26875483,30,0.36043956,0.571428571,0.846153846,29597
704eb5254545bcdb8b7a9a60b2518124e7e4b265,0,Sumit Mohanty,2017-05-16 19:15:45-07:00,['9adffcf7a93d40ad727796a8a1686da0e6408893'],2,2,4,26875487,2,,,,29597
350dace643e3edad2407c80f38edad5847b47706,0,Sumit Mohanty,2017-05-16 19:20:24-07:00,['704eb5254545bcdb8b7a9a60b2518124e7e4b265'],6,12,18,26875505,6,0,0,0,29597
275525b212d8f9ae306d83417b8f94d035a67474,1,Attila Doroszlai,2017-05-17 10:17:12+02:00,['228b9289755c33342586d8cbe209b5341d7380d0'],425,591,1016,26876521,20,1,0.322580645,0,29599
f18a822c8bae1d77db7a3b033a84d979b5bf0392,1,Vitaly Brodetskyi,2017-05-17 13:54:48+03:00,['350dace643e3edad2407c80f38edad5847b47706'],0,253,253,26876774,1,0.485436893,0.359223301,0.116504854,29600
3b94d3cff380bf3557af57c6ecd9005ab46b8916,1,Miklos Gergely,2017-05-17 14:47:40+02:00,['f18a822c8bae1d77db7a3b033a84d979b5bf0392'],877,760,1637,26878411,36,1,0.585858586,0,29603
99d4ca1e7171648086a3c0536cd6badbac172707,1,Alex Antonenko,2017-05-17 15:51:50+03:00,['3b94d3cff380bf3557af57c6ecd9005ab46b8916'],1,8,9,26878420,2,,,,29603
4427a3365732dd971dc294f4feda75e247be4605,1,Alex Antonenko,2017-05-17 15:51:50+03:00,['99d4ca1e7171648086a3c0536cd6badbac172707'],51,254,305,26878725,4,0.741258741,1,1,29603
950298bcd67114c6b4f0f81e2b6aea2155b358e8,0,Attila Doroszlai,2017-05-17 15:14:59+02:00,['275525b212d8f9ae306d83417b8f94d035a67474'],0,1,1,26878726,1,0,1,1,29603
735c4137cb2cbb95c6da44809a447c148c7c6f9d,1,Andrii Tkach,2017-05-17 18:15:20+03:00,['4427a3365732dd971dc294f4feda75e247be4605'],13,39,52,26878778,4,1,1,1,29603
772be786d930322e4a95e4755c36ffece24d30e4,1,Dmytro Sen,2017-05-17 19:07:44+03:00,['735c4137cb2cbb95c6da44809a447c148c7c6f9d'],326,389,715,26879493,3,1,0.962962963,0.740740741,29603
041d353b0d75b20b0322097e13a1701226e6fc97,1,Dmytro Sen,2017-05-17 19:38:29+03:00,['772be786d930322e4a95e4755c36ffece24d30e4'],47,1594,1641,26881134,96,0.607679466,0.796327212,0.893155259,29615
1568f800764a6b20f2f09330f112070ebc0f7f86,1,Alex Antonenko,2017-05-17 19:56:45+03:00,['041d353b0d75b20b0322097e13a1701226e6fc97'],4,13,17,26881151,3,0,1,1,29615
9763993c75e4b50aeb82da24657c082f8bc01922,0,Attila Doroszlai,2017-05-17 19:27:16+02:00,['950298bcd67114c6b4f0f81e2b6aea2155b358e8'],4,3,7,26881158,1,1,0,0,29615
8bf136a4b78b495de849565400f24a7cc2cbd834,1,oleewere,2017-05-17 19:35:46+02:00,['1568f800764a6b20f2f09330f112070ebc0f7f86'],3,188,191,26881349,8,,,,29619
bba703bc600555e596c49aef8749df65c9ac918c,1,Robert Levas,2017-05-17 14:33:03-04:00,['8bf136a4b78b495de849565400f24a7cc2cbd834'],2,139,141,26881490,3,0.179487179,0.692307692,1,29619
292db86f02e236615dc67576f66b856657898f17,1,ababiichuk,2017-05-18 00:21:20+03:00,['bba703bc600555e596c49aef8749df65c9ac918c'],237,236,473,26881963,19,1,0,0.071428571,29619
dad74757d7ab067d5ecfb00665a496332da4ece5,1,Sangeeta Ravindran,2017-05-17 22:46:00-07:00,['292db86f02e236615dc67576f66b856657898f17'],1,1,2,26881965,1,,,,29619
f678794617f6e221bd63b8abd9b1c54618680831,0,Attila Doroszlai,2017-05-18 11:42:38+02:00,['9763993c75e4b50aeb82da24657c082f8bc01922'],12,188,200,26882165,3,,,,29620
2e27f661947cb72f4004eb17903caf1f76012468,0,Dmytro Sen,2017-05-18 13:47:53+03:00,['dad74757d7ab067d5ecfb00665a496332da4ece5'],2,2,4,26882169,1,,,,29620
c4132783225b541f0425526f7d1edaa822553229,1,Jonathan Hurley,2017-05-18 09:45:03-04:00,['1427d818b41a987767c3261e586368e47c43822c'],458,248,706,26882875,23,1,1,0,29620
ace89b7bbe39cf18f4ee7540acb6258833d54b76,0,Jonathan Hurley,2017-05-18 09:51:09-04:00,"['c4132783225b541f0425526f7d1edaa822553229', '2e27f661947cb72f4004eb17903caf1f76012468']",1582,8027,9609,26892484,229,,,,29620
9cb87011c716e6fc8eeec0b2ca57a75fa9c7d2d9,1,Alejandro Fernandez,2017-05-18 12:16:33-04:00,['2e27f661947cb72f4004eb17903caf1f76012468'],4,9,13,26892497,1,0,0,0,29620
0e5f24700afad30b5f0ac0512442019dedf392cb,0,Alex Antonenko,2017-05-18 19:41:47+03:00,['9cb87011c716e6fc8eeec0b2ca57a75fa9c7d2d9'],13,4,17,26892514,3,1,0,0,29620
2eb7844b7025d52a641c61cccb3ad9f835de45f4,1,Andrii Tkach,2017-05-18 19:54:10+03:00,['cef3f245eed01c36a7e3a9c628040a7b4e7ee1d0'],62,56,118,26892632,8,1,1,0,29620
6ab4d28a6973cec9a2d04592bfa6fcdfcf081988,1,Vitaly Brodetskyi,2017-05-18 20:33:43+03:00,['0e5f24700afad30b5f0ac0512442019dedf392cb'],0,6320,6320,26898952,45,0.54691689,0.576407507,0.801608579,29665
7dc2ddc72bce3dc944191c7797d2672c1f3b4fcb,1,Vitaly Brodetskyi,2017-05-18 20:39:00+03:00,['6ab4d28a6973cec9a2d04592bfa6fcdfcf081988'],0,387,387,26899339,1,0.363636364,0.291866029,0.057416268,29666
3499004cc6c692c142ba4f6ad857ba67ea81d254,1,Sriharsha Chintalapani,2017-05-18 13:34:29-07:00,['7dc2ddc72bce3dc944191c7797d2672c1f3b4fcb'],0,241,241,26899580,5,,,,29669
71ed28140cd5d91fedb4e1403a8fa9aa3482ccf0,1,Sriharsha Chintalapani,2017-05-18 14:04:38-07:00,['3499004cc6c692c142ba4f6ad857ba67ea81d254'],17,110,127,26899707,3,1,1,0.678571429,29670
f7a1d4e7e7445eb49cfefabaf92ec518fc44d8ba,1,Sumit Mohanty,2017-05-18 22:32:31-07:00,['71ed28140cd5d91fedb4e1403a8fa9aa3482ccf0'],0,23,23,26899730,4,,,,29670
f2bbe4781841b871993b3e8dd88e5f56169cf1b8,1,Lisnichenko Dmitro,2017-05-19 11:52:12+03:00,['f7a1d4e7e7445eb49cfefabaf92ec518fc44d8ba'],196,493,689,26900419,55,0.273972603,0.863013699,0.321917808,29670
c4c2ec79b69a5474ef262ba90ba427baacd80ae7,1,Andrew Onishuk,2017-05-19 13:22:40+03:00,['2eb7844b7025d52a641c61cccb3ad9f835de45f4'],79,2402,2481,26902900,18,0.459459459,1,1,29673
1e2ccbf0869283aafcdab8d37ee3fc36e4b41179,1,Alex Antonenko,2017-05-19 15:52:06+03:00,['ace89b7bbe39cf18f4ee7540acb6258833d54b76'],49,62,111,26903011,10,1,0,0,29673
b094c753e9652c7bf866bec18caf41de90c4a8d8,0,Andrii Tkach,2017-05-19 16:38:14+03:00,['c4c2ec79b69a5474ef262ba90ba427baacd80ae7'],0,51,51,26903062,2,0.925925926,1,1,29673
f952c9eecdc8cba07117ecb39265f05e6ef47341,0,Jonathan Hurley,2017-05-19 10:19:49-04:00,['f2bbe4781841b871993b3e8dd88e5f56169cf1b8'],2,2,4,26903066,1,,,,29673
ae40bed9fc99965babaf3457bbd04758bba99023,0,Jaimin Jetly,2017-05-19 10:20:48-07:00,['f952c9eecdc8cba07117ecb39265f05e6ef47341'],8,2,10,26903076,2,,,,29673
c9f705de801aac16f7da4550bcd180ff56b8c685,1,Aravindan Vijayan,2017-05-19 16:39:55-07:00,['ae40bed9fc99965babaf3457bbd04758bba99023'],0,6,6,26903082,2,0,1,1,29673
d740384e8059d9d7b12d7ae99e7423a92c4df4bf,0,Aravindan Vijayan,2017-05-19 16:40:30-07:00,['c9f705de801aac16f7da4550bcd180ff56b8c685'],73,10,83,26903165,29,0,0,1,29673
0a61f9857ec95162801fc2c8aae05fef67fbbd52,0,Swapan Shridhar,2017-05-20 00:29:40-07:00,['d740384e8059d9d7b12d7ae99e7423a92c4df4bf'],66,1,67,26903232,12,,,,29673
55af3363582162487eef3363f5ae5c4a16872652,0,Swapan Shridhar,2017-05-20 00:34:37-07:00,['0a61f9857ec95162801fc2c8aae05fef67fbbd52'],9,0,9,26903241,1,,,,29673
c23602c9f0412bba8375e7f8f28f05c970e04159,0,Swapan Shridhar,2017-05-20 01:01:07-07:00,['55af3363582162487eef3363f5ae5c4a16872652'],0,14,14,26903255,2,,,,29673
9ffef7fc58b4313dfdf8d96badce5198855934a7,1,oleewere,2017-05-20 12:51:51+02:00,['c23602c9f0412bba8375e7f8f28f05c970e04159'],20,1748,1768,26905023,23,0.871257485,0.952095808,0.928143713,29693
ccd6b25ed2f053a9b1b2045fd0cf41f4472e657e,0,Swapan Shridhar,2017-05-22 01:11:15-07:00,['9ffef7fc58b4313dfdf8d96badce5198855934a7'],1,66,67,26905090,12,,,,29693
1603cd6840852b69567523f74a4b708aa4bd6d73,0,Swapan Shridhar,2017-05-22 01:26:22-07:00,['ccd6b25ed2f053a9b1b2045fd0cf41f4472e657e'],57,1,58,26905148,12,,,,29693
cbb1e9059669b2af7d63323321980d8cc0f9203f,0,Andrew Onishuk,2017-05-22 12:03:00+03:00,['1603cd6840852b69567523f74a4b708aa4bd6d73'],11,2,13,26905161,10,,,,29693
fd4a7a46a2db9869dca28294660ca40e693504ea,1,Miklos Gergely,2017-05-22 12:49:50+02:00,['cbb1e9059669b2af7d63323321980d8cc0f9203f'],621,3460,4081,26909242,103,1,1,0.968181818,29749
74972de559b21633288c03785dc672e792a172bb,0,Sandor Magyari,2017-05-22 14:27:38+02:00,['fd4a7a46a2db9869dca28294660ca40e693504ea'],5,5,10,26909252,1,,,,29749
cdc18ecb9d06ef6810962fb3742d75781ff8e831,1,Vitaly Brodetskyi,2017-05-22 15:42:16+03:00,['74972de559b21633288c03785dc672e792a172bb'],0,3676,3676,26912928,30,0.195544554,0.371287129,0.827970297,29779
5ea441aa7b4080a7a1eb07a4a1e01a2aa8d0d92e,0,Lisnichenko Dmitro,2017-05-22 18:48:32+03:00,['cdc18ecb9d06ef6810962fb3742d75781ff8e831'],0,154,154,26913082,1,0.268817204,0.268817204,0.677419355,29780
11325b7c92f2d0603013fef13b623ca126b69f7c,0,Lisnichenko Dmitro,2017-05-22 20:00:28+03:00,['1e2ccbf0869283aafcdab8d37ee3fc36e4b41179'],1,0,1,26913083,1,1,0,0,29780
6c68321448099167748efc8981103934a617dc11,0,Aravindan Vijayan,2017-05-22 10:31:50-07:00,['5ea441aa7b4080a7a1eb07a4a1e01a2aa8d0d92e'],4,4,8,26913091,1,,,,29780
0626b789ba477c494dc5a260b2bca61e3d906690,1,oleewere,2017-05-22 20:31:24+02:00,['6c68321448099167748efc8981103934a617dc11'],8,8,16,26913107,1,1,1,1,29780
9415478dca03caf7f55ba21e8f00d954dc117757,0,Richard Zang,2017-05-22 19:29:03-07:00,['0626b789ba477c494dc5a260b2bca61e3d906690'],10,24,34,26913141,3,1,1,1,29780
201677be8deec6e3d898126fbc23b2114be2fa4c,0,Venkata Sairam,2017-05-23 08:30:36+05:18,['9415478dca03caf7f55ba21e8f00d954dc117757'],1,15,16,26913157,2,1,1,1,29780
32501f68e6ecda58bf3a6eef4be10264d0bd0669,1,pallavkul,2017-05-23 12:15:34+05:18,['201677be8deec6e3d898126fbc23b2114be2fa4c'],0,214,214,26913371,2,0.430463576,0.370860927,1,29781
f2cad775e98e6478fcc4282a8eff1014cc00414d,0,Attila Doroszlai,2017-05-23 10:55:13+02:00,['f678794617f6e221bd63b8abd9b1c54618680831'],11,64,75,26913446,3,,,,29782
7c9295395923a95ada6e51100b14d1e535590caa,0,Venkata Sairam,2017-05-23 14:14:15+05:18,['32501f68e6ecda58bf3a6eef4be10264d0bd0669'],2,2,4,26913450,1,,,,29782
017726319c77c4bc6cae86f1f1e42b1b6d4f1ce0,1,Attila Doroszlai,2017-05-23 10:58:03+02:00,['f2cad775e98e6478fcc4282a8eff1014cc00414d'],43,409,452,26913902,8,,,,29786
51fc3cf77302c7bc04ffb9fdbd53f053b053514f,1,Attila Doroszlai,2017-05-23 11:35:31+02:00,['017726319c77c4bc6cae86f1f1e42b1b6d4f1ce0'],44,337,381,26914283,6,1,0.746478873,0.718309859,29789
651bdcbdf86c8addace33b1f9bac066633296106,0,Attila Doroszlai,2017-05-23 11:52:00+02:00,"['51fc3cf77302c7bc04ffb9fdbd53f053b053514f', '7c9295395923a95ada6e51100b14d1e535590caa']",19731,129818,149549,27063832,1571,,,,29789
0d688106a59a6d96d5ca6d7e50146d4c9418f5b1,0,Attila Doroszlai,2017-05-23 11:56:59+02:00,"['7c9295395923a95ada6e51100b14d1e535590caa', '651bdcbdf86c8addace33b1f9bac066633296106']",3239,82068,85307,27149139,226,,,,29789
4fcdaae4ce7788620d9b6146dfaef10ad1e7c60e,1,oleewere,2017-05-23 12:49:25+02:00,['0d688106a59a6d96d5ca6d7e50146d4c9418f5b1'],3,28,31,27149170,2,0,1,1,29789
a436eb2f6f5b7c36d370bcc24de6edafd35ab72a,0,Alex Antonenko,2017-05-23 17:08:03+03:00,['11325b7c92f2d0603013fef13b623ca126b69f7c'],4,0,4,27149174,3,0,0,1,29789
cd769e2e79de11519b333aa86c4c54e68be40996,1,Di Li,2017-05-23 12:03:53-04:00,['4fcdaae4ce7788620d9b6146dfaef10ad1e7c60e'],14,250,264,27149438,11,0.545454545,0.712121212,0.863636364,29790
a45f5427b08fc354e8b54481e7da3d6083112345,1,Nate Cole,2017-05-23 15:38:59-04:00,['a436eb2f6f5b7c36d370bcc24de6edafd35ab72a'],1357,1811,3168,27152606,114,0,0.036809816,1,29790
b5fdb57c5173cbf241782e9daa6dee4f4dc63c3c,1,Sangeeta Ravindran,2017-05-23 14:02:10-07:00,['cd769e2e79de11519b333aa86c4c54e68be40996'],8,37,45,27152651,5,0,1,1,29790
c4148d805c4145d545712bbce6127e7518a7b7ce,1,Jonathan Hurley,2017-05-23 17:35:11-04:00,['a45f5427b08fc354e8b54481e7da3d6083112345'],866,1030,1896,27154547,47,0.764705882,0,1,29790
a2eefe849062266fa41edd7466bb395954c06ff0,1,Vitaly Brodetskyi,2017-05-24 01:05:48+03:00,['b5fdb57c5173cbf241782e9daa6dee4f4dc63c3c'],0,1782,1782,27156329,18,0.342391304,0.573369565,0.869565217,29808
1c19200cd446159fba94395867184d2d144c48c7,1,Vitaly Brodetskyi,2017-05-24 01:10:29+03:00,['a2eefe849062266fa41edd7466bb395954c06ff0'],0,314,314,27156643,1,0.509803922,0.509803922,0.307189542,29809
0f266ed6a7b1df2c3d3b18aa49649e12d01b1a4b,1,Jonathan Hurley,2017-05-23 19:58:42-04:00,"['c4148d805c4145d545712bbce6127e7518a7b7ce', '1c19200cd446159fba94395867184d2d144c48c7']",4296,101378,105674,27262317,588,,,,29809
560b0d1946cfd7d26419e995f9138a3a281b6602,0,Jonathan Hurley,2017-05-23 22:54:35-04:00,['0f266ed6a7b1df2c3d3b18aa49649e12d01b1a4b'],3,12,15,27262332,3,0,1,1,29809
ca54b9607c0b8c43d8880fbc1531d3098c9fcb95,0,Attila Doroszlai,2017-05-24 09:33:37+02:00,['1c19200cd446159fba94395867184d2d144c48c7'],13,13,26,27262358,1,,,,29809
5b44fa44e0e08f8fed5482a8ae54827ac0f49eeb,1,Attila Doroszlai,2017-05-24 10:37:41+02:00,['ca54b9607c0b8c43d8880fbc1531d3098c9fcb95'],0,1,1,27262359,1,,,,29809
90abffd706448786cc02257abd76a22b4f96fcd3,1,Alex Antonenko,2017-05-24 12:02:52+03:00,['5b44fa44e0e08f8fed5482a8ae54827ac0f49eeb'],58,178,236,27262595,2,0.240384615,0.471153846,0.971153846,29809
2cfc8d22dc1ccc180c376b40ea6a96967d9bf6a4,0,Jonathan Hurley,2017-05-24 09:57:57-04:00,"['560b0d1946cfd7d26419e995f9138a3a281b6602', '90abffd706448786cc02257abd76a22b4f96fcd3']",70,192,262,27262857,4,,,,29809
7bb2aba5cc67e65e586352efdf307cf67dbfd416,1,Eugene Chekanskiy,2017-05-24 18:25:32+03:00,['90abffd706448786cc02257abd76a22b4f96fcd3'],1,1,2,27262859,1,,,,29809
ff0c5253e9554af52517303a5775e16d7836a246,1,Eugene Chekanskiy,2017-05-24 20:34:51+03:00,['7bb2aba5cc67e65e586352efdf307cf67dbfd416'],23,20,43,27262902,6,1,1,1,29809
b9ecb1fa5c5e602d2ea1ae70be2dbbca8368a59f,0,Andrew Onishuk,2017-05-24 21:52:17+03:00,['ff0c5253e9554af52517303a5775e16d7836a246'],14,25,39,27262941,2,1,1,0,29809
4405d4982842a729ebfbd4c000c5ffb023abbbb5,0,Andrew Onishuk,2017-05-24 22:00:21+03:00,['b9ecb1fa5c5e602d2ea1ae70be2dbbca8368a59f'],2,0,2,27262943,2,1,0,0,29809
56f019081b7de00504c87c8c075524a656466487,1,Vitaly Brodetskyi,2017-05-24 22:17:04+03:00,['4405d4982842a729ebfbd4c000c5ffb023abbbb5'],0,167,167,27263110,1,1,1,0.342857143,29810
770c519a9f6c9647c812837c61662e42af5e37d5,1,Jonathan Hurley,2017-05-24 16:11:04-04:00,['2cfc8d22dc1ccc180c376b40ea6a96967d9bf6a4'],3295,48934,52229,27315339,7,0.978723404,0,0,29810
42be8ce798172757b8b0967b309baf73fe0a5212,1,Sangeeta Ravindran,2017-05-24 15:51:55-07:00,['56f019081b7de00504c87c8c075524a656466487'],14,20,34,27315373,6,1,1,1,29810
2f73315356551224b69bf7e9d1c9c914107ac6df,1,Miklos Gergely,2017-05-25 02:52:29+02:00,['42be8ce798172757b8b0967b309baf73fe0a5212'],0,31,31,27315404,2,0,0,1,29810
c2409e740f84d6f051659b3b36d853902e698a60,0,Attila Doroszlai,2017-05-25 09:37:42+02:00,['2f73315356551224b69bf7e9d1c9c914107ac6df'],2179,2104,4283,27319687,1908,,,,29810
1adb70d53041e64ac7e844592453cd3085704105,0,Attila Doroszlai,2017-05-25 09:46:04+02:00,['c2409e740f84d6f051659b3b36d853902e698a60'],129,23,152,27319839,20,1,1,0.074468085,29810
91d10fdc849f884f7e215a4006a843f2f91b9ea3,0,Alex Antonenko,2017-05-25 13:00:46+03:00,['1adb70d53041e64ac7e844592453cd3085704105'],46,27,73,27319912,5,0.052631579,0,0,29810
cd68c61617724891aaaa1d7cba085cc584e76e7e,1,Andrii Tkach,2017-05-25 13:04:18+03:00,['91d10fdc849f884f7e215a4006a843f2f91b9ea3'],37,35,72,27319984,10,0,0,0,29810
7a7f489bc51a0351f9e2c0c1fbb79180319f1d80,1,Alex Antonenko,2017-05-25 14:07:13+03:00,['770c519a9f6c9647c812837c61662e42af5e37d5'],36,107,143,27320127,5,1,1,1,29810
9dbf8f15e659a19e3b4d8a6cdd7530160089c1dd,0,Andrew Onishuk,2017-05-25 15:02:57+03:00,['cd68c61617724891aaaa1d7cba085cc584e76e7e'],2,0,2,27320129,1,1,0,0,29810
14acc0ae32a274184830a8e7bf847f5ede8ac953,0,lpuskas,2017-05-25 16:42:20+02:00,['9dbf8f15e659a19e3b4d8a6cdd7530160089c1dd'],20,25,45,27320174,2,,,,29810
245afc1b4fa87b6d5ce30f403c15858f90d2ce86,0,Jonathan Hurley,2017-05-25 12:57:50-04:00,"['7a7f489bc51a0351f9e2c0c1fbb79180319f1d80', '14acc0ae32a274184830a8e7bf847f5ede8ac953']",2450,2468,4918,27325092,1940,,,,29810
1e3d64bfeaa59ac471c013cac1a96b1df14921f0,1,Jayush Luniya,2017-05-25 10:00:14-07:00,['14acc0ae32a274184830a8e7bf847f5ede8ac953'],0,61,61,27325153,1,,,,29811
ad6a78eeed591cf5b6ea481161194c05eaa5e4b7,0,Robert Levas,2017-05-25 15:59:49-04:00,['1e3d64bfeaa59ac471c013cac1a96b1df14921f0'],2,8,10,27325163,2,0,0,0,29811
a4482bba2c7f0d1bb3dfb79df45cd01909dd35ee,0,Sangeeta Ravindran,2017-05-25 14:04:09-07:00,['ad6a78eeed591cf5b6ea481161194c05eaa5e4b7'],1,13,14,27325177,3,1,1,1,29811
f7c04148c1214277cf39479d9a0306850c034ef9,0,Alejandro Fernandez,2017-05-25 17:24:05-07:00,['a4482bba2c7f0d1bb3dfb79df45cd01909dd35ee'],17,25,42,27325219,2,,,,29811
145a80294706f22914c043ebbb8a8d0b5d7d52ee,1,Jayush Luniya,2017-05-25 17:51:16-07:00,['f7c04148c1214277cf39479d9a0306850c034ef9'],1,5,6,27325225,1,,,,29811
9ff0a785235ce9c70ca265d3d02edce2dea7f6ea,0,Sangeeta Ravindran,2017-05-26 11:37:47-07:00,['145a80294706f22914c043ebbb8a8d0b5d7d52ee'],0,3,3,27325228,1,1,1,1,29811
617a6b4a9bbd59bff3bcab17c466f4871ada8f6a,0,Aravindan Vijayan,2017-05-26 12:45:33-07:00,['9ff0a785235ce9c70ca265d3d02edce2dea7f6ea'],4,8,12,27325240,4,,,,29811
7c1cb60bcd4cfd027bf66b640f6e3425cff1b555,0,Robert Levas,2017-05-26 16:37:10-04:00,['617a6b4a9bbd59bff3bcab17c466f4871ada8f6a'],5,1,6,27325246,1,,,,29811
9f5f7656c18f722df175dc54cdf6aafdca940ee9,0,Attila Doroszlai,2017-05-29 07:59:01+02:00,['7c1cb60bcd4cfd027bf66b640f6e3425cff1b555'],2,2,4,27325250,2,,,,29811
6bad191bb3cf009cbe7d1d7a92942d47770ab31d,1,Andrew Onishuk,2017-05-29 11:28:44+03:00,['b094c753e9652c7bf866bec18caf41de90c4a8d8'],108,169,277,27325527,13,0,0.617647059,0.558823529,29811
93130e6bf83dc656ecb486a8f5fbabcb97a694f1,1,Miklos Gergely,2017-05-29 12:07:01+02:00,['9f5f7656c18f722df175dc54cdf6aafdca940ee9'],62,441,503,27326030,26,0.435897436,0.418803419,0.965811966,29815
64238cb9162f5098d2bafaa79999606f6c7abac3,0,Andrii Tkach,2017-05-29 20:24:25+03:00,['93130e6bf83dc656ecb486a8f5fbabcb97a694f1'],1,1,2,27326032,1,,,,29815
5845d546392f199d425aee8a2418f791c21da3a5,1,Miklos Gergely,2017-05-29 22:36:38+02:00,['64238cb9162f5098d2bafaa79999606f6c7abac3'],0,1,1,27326033,1,,,,29815
6303e9358db26640ab2c6161111f2d7f527c965c,1,Andrew Onishuk,2017-05-30 10:12:35+03:00,['6bad191bb3cf009cbe7d1d7a92942d47770ab31d'],159,714,873,27326906,24,0.881355932,0.033898305,0.542372881,29824
7460cebf90e8f77b3b14457a64423ebc3ba028cc,0,Robert Levas,2017-05-30 14:29:02-04:00,['041d353b0d75b20b0322097e13a1701226e6fc97'],44,155,199,27327105,6,,,,29824
2892aee53e63077c422c4c68dd565e786d83a71d,1,Jonathan Hurley,2017-05-30 16:28:05-04:00,['245afc1b4fa87b6d5ce30f403c15858f90d2ce86'],388,480,868,27327973,16,1,0.677419355,0.35483871,29824
f0d970b5b93a40c2e0830d5eaf3039c81ada2290,1,Miklos Gergely,2017-05-31 09:10:00+02:00,['5845d546392f199d425aee8a2418f791c21da3a5'],251,442,693,27328666,17,0.4375,1,0,29828
4f36e1454dd37396782ef6497629192c603d5baf,1,oleewere,2017-05-31 11:29:08+02:00,['f0d970b5b93a40c2e0830d5eaf3039c81ada2290'],19,20,39,27328705,5,,,,29828
b1f9717173086a8a6aef59def8a9f4b9ab01a412,1,Miklos Gergely,2017-05-31 11:51:09+02:00,['4f36e1454dd37396782ef6497629192c603d5baf'],161,218,379,27329084,18,0.444444444,0.622222222,1,29828
753f8aacc5bf42d7a22ff702b52865d6e14a9792,0,Miklos Gergely,2017-05-31 15:42:00+02:00,['b1f9717173086a8a6aef59def8a9f4b9ab01a412'],1,1,2,27329086,1,,,,29828
138aa48f5f6e21ab7c7ec0636fe12e71a88281b0,0,Jonathan Hurley,2017-05-31 10:37:02-04:00,"['2892aee53e63077c422c4c68dd565e786d83a71d', '753f8aacc5bf42d7a22ff702b52865d6e14a9792']",511,1234,1745,27330831,77,,,,29828
23e23afd884449812d05c490804dc4845b01ac21,1,oleewere,2017-05-31 20:03:27+02:00,['753f8aacc5bf42d7a22ff702b52865d6e14a9792'],14,1002,1016,27331847,13,0.214285714,1,1,29835
69e73baa8812a1196d225af7c41cc8ddcfe457d0,0,oleewere,2017-05-31 20:12:27+02:00,['23e23afd884449812d05c490804dc4845b01ac21'],5,5,10,27331857,1,,,,29835
dc30b4e366f12ce7baa05a2c3dec096175c22f9d,1,Jonathan Hurley,2017-05-31 15:18:49-04:00,['69e73baa8812a1196d225af7c41cc8ddcfe457d0'],2,7,9,27331866,1,1,1,0,29835
fb2076c718c5bcafb1e83c35a841111d30c6204d,1,Jonathan Hurley,2017-05-31 15:23:58-04:00,"['138aa48f5f6e21ab7c7ec0636fe12e71a88281b0', 'dc30b4e366f12ce7baa05a2c3dec096175c22f9d']",15,1009,1024,27332890,14,,,,29835
8b986caec0406663746f1e075b65bde13a2f2ff9,1,Miklos Gergely,2017-05-31 23:25:26+02:00,['fb2076c718c5bcafb1e83c35a841111d30c6204d'],1,1,2,27332892,1,,,,29835
db700d595c91f54dbeeb07b1d199b3316a8e4b5d,0,Alex Antonenko,2017-06-01 14:21:03+03:00,['8b986caec0406663746f1e075b65bde13a2f2ff9'],1,1,2,27332894,1,,,,29835
7bb3fdd8464ee3e26d2cfbb75a7bb1d1b2b8759e,1,oleewere,2017-06-01 13:55:11+02:00,['db700d595c91f54dbeeb07b1d199b3316a8e4b5d'],8,29,37,27332931,2,0,1,1,29835
81f64bfc7eaf846631a851d9a0111e1b53ddcc5e,1,Andrii Tkach,2017-06-01 15:02:35+03:00,['7bb3fdd8464ee3e26d2cfbb75a7bb1d1b2b8759e'],31,65,96,27333027,6,1,1,1,29835
5d0962421397d64b5e7a383eb23fb6ae22028b0b,1,Andrew Onishuk,2017-06-01 15:05:03+03:00,['6303e9358db26640ab2c6161111f2d7f527c965c'],249,293,542,27333569,18,0.235714286,0.985714286,1,29835
391206809621eee49edfc45dc2b5bb5b4d9daea0,1,Nate Cole,2017-06-01 08:46:03-04:00,['fb2076c718c5bcafb1e83c35a841111d30c6204d'],9,18,27,27333596,3,0.6,0.4,0.2,29835
36cc11b3aa68fc93901ac6ed2fa2c838b3ee6400,1,Jonathan Hurley,2017-06-01 09:24:56-04:00,['391206809621eee49edfc45dc2b5bb5b4d9daea0'],11,121,132,27333728,6,0,0.888888889,0.888888889,29836
9a42d4003934046b74fdf6b5754d1a55b30b2bb3,0,Jonathan Hurley,2017-06-01 09:27:25-04:00,"['36cc11b3aa68fc93901ac6ed2fa2c838b3ee6400', '81f64bfc7eaf846631a851d9a0111e1b53ddcc5e']",41,96,137,27333865,10,,,,29836
851c85718b8a239392d51c937f51b3c070b27356,0,Jonathan Hurley,2017-06-01 09:31:13-04:00,"['81f64bfc7eaf846631a851d9a0111e1b53ddcc5e', '9a42d4003934046b74fdf6b5754d1a55b30b2bb3']",20,139,159,27334024,9,,,,29836
4767389b655cba8e6062f06d8390a1a22bf60e41,0,Alex Antonenko,2017-06-01 17:04:36+03:00,['9a42d4003934046b74fdf6b5754d1a55b30b2bb3'],2,2,4,27334028,1,,,,29836
7a0eda7ec99882fd40bdd6b036e2301f6e0486da,0,Sangeeta Ravindran,2017-06-01 10:47:29-07:00,['851c85718b8a239392d51c937f51b3c070b27356'],4,4,8,27334036,2,,,,29836
dfb5d392067a581df27b59c0f5077729f483e1db,0,Sangeeta Ravindran,2017-06-01 11:17:31-07:00,['7a0eda7ec99882fd40bdd6b036e2301f6e0486da'],1,2,3,27334039,1,,,,29836
49605daef3f5404b6be59a051c268b56cb81b291,0,Di Li,2017-06-01 16:14:27-04:00,['dfb5d392067a581df27b59c0f5077729f483e1db'],1,17,18,27334057,2,0.923076923,0.923076923,1,29836
cb9196f8ed2c269fe8bc6798832556aeadb6dd96,0,Andrii Tkach,2017-06-02 15:22:38+03:00,['49605daef3f5404b6be59a051c268b56cb81b291'],17,1,18,27334075,1,,,,29836
71e384dbbdecd66f75c48f0fae375d7bdac39b11,0,Jonathan Hurley,2017-06-02 10:28:20-04:00,['cb9196f8ed2c269fe8bc6798832556aeadb6dd96'],2,2,4,27334079,2,,,,29836
7847e4b6cf65b777e516a4806cbf5f45cdd207ee,1,Jonathan Hurley,2017-06-02 10:30:06-04:00,['4767389b655cba8e6062f06d8390a1a22bf60e41'],23,164,187,27334266,4,0,0.316455696,0.860759494,29836
4283211592c6813e02d74b7ef801da39711042cb,0,Siddharth Wagle,2017-06-02 10:47:09-07:00,['71e384dbbdecd66f75c48f0fae375d7bdac39b11'],0,13,13,27334279,2,0.6,1,1,29836
28e20a16879a6db4b48107738891d714cd2217b9,0,Aleksandr Kovalenko,2017-06-02 20:56:38+03:00,['4283211592c6813e02d74b7ef801da39711042cb'],0,1,1,27334280,1,,,,29836
201c6d01bad70aec8ebee1e2a6633bcd0062c1c6,0,Aravindan Vijayan,2017-06-02 11:55:09-07:00,['28e20a16879a6db4b48107738891d714cd2217b9'],1,1,2,27334282,1,,,,29836
9acb7a64444d5cc1e0ebc648f0e6413f6f949ac1,1,Vitaly Brodetskyi,2017-06-02 22:03:22+03:00,['201c6d01bad70aec8ebee1e2a6633bcd0062c1c6'],14,4,18,27334300,2,1,1,0,29836
c3c06ea9889e0a462d67e8a765b41d0a4aead9b2,1,Robert Levas,2017-06-02 15:43:43-04:00,['9acb7a64444d5cc1e0ebc648f0e6413f6f949ac1'],30,316,346,27334646,10,0.395604396,0.824175824,1,29839
b7101f782be9a1291de589262f01083c70dfc935,1,"Toader, Sebastian",2017-06-02 23:12:46+02:00,['c3c06ea9889e0a462d67e8a765b41d0a4aead9b2'],5,19,24,27334670,2,0,0,1,29839
57f4461bd002d998796168a00e51113927262ab8,1,Alejandro Fernandez,2017-06-02 14:53:54-07:00,['b7101f782be9a1291de589262f01083c70dfc935'],27,155,182,27334852,4,0.170454545,0.386363636,1,29839
3f9088524e276671fb0ea8252ce7c1f7ea149cda,0,Alejandro Fernandez,2017-06-02 15:33:09-07:00,['57f4461bd002d998796168a00e51113927262ab8'],6,53,59,27334911,3,0.029411765,0.147058824,1,29839
3b5f07f43f7c8914b3ff9aaa1b5504273f1ae59c,1,Nitiraj Singh Rathore,2017-06-05 12:22:26+05:18,['3f9088524e276671fb0ea8252ce7c1f7ea149cda'],9,11,20,27334931,4,1,1,0,29839
601a7cdcf5a9a8c524565c54a9a36826776ab1f6,0,Nitiraj Singh Rathore,2017-06-05 12:28:02+05:18,['3b5f07f43f7c8914b3ff9aaa1b5504273f1ae59c'],5,4,9,27334940,1,1,1,0,29839
cd3fb85953c01f8049950f140215de4e2257d139,0,Jonathan Hurley,2017-06-05 14:31:43-04:00,['7847e4b6cf65b777e516a4806cbf5f45cdd207ee'],30,30,60,27335000,10,1,1,1,29839
64e3ad77685dd934324947225889e76429ad5813,0,Jonathan Hurley,2017-06-05 15:43:28-04:00,"['cd3fb85953c01f8049950f140215de4e2257d139', '601a7cdcf5a9a8c524565c54a9a36826776ab1f6']",122,603,725,27335725,37,,,,29839
b916e372227f0859edcc51340f902886aaad0fd0,0,Sumit Mohanty,2017-06-05 14:56:35-07:00,['601a7cdcf5a9a8c524565c54a9a36826776ab1f6'],2,2,4,27335729,2,,,,29839
499814af75d3adfa7c5afcd1564ed79e16cb30a0,0,Sumit Mohanty,2017-06-05 15:57:09-07:00,['b916e372227f0859edcc51340f902886aaad0fd0'],1,1,2,27335731,1,,,,29839
b3425c9841b4153b1cf3b15dc6f55e67f1754f3b,1,Andrew Onishuk,2017-06-06 13:39:20+03:00,['499814af75d3adfa7c5afcd1564ed79e16cb30a0'],49,104,153,27335884,8,0,1,0.088235294,29839
4dba161a6fbeab2ab5507c9ff50f524242b7f450,1,Andrew Onishuk,2017-06-06 13:57:00+03:00,['b3425c9841b4153b1cf3b15dc6f55e67f1754f3b'],7,22,29,27335913,1,0,0,1,29839
119d2624f96d66c9a4d5d559ca436de73adae444,1,Andrew Onishuk,2017-06-06 13:57:52+03:00,['4dba161a6fbeab2ab5507c9ff50f524242b7f450'],14,8,22,27335935,1,0,0,1,29839
bc90de2e9843f41229d86f4dad6accbb66163500,1,Andrew Onishuk,2017-06-06 13:58:40+03:00,['119d2624f96d66c9a4d5d559ca436de73adae444'],13,67,80,27336015,7,0.043478261,0.652173913,0.739130435,29839
0dd9fbf34764de407d9605f4472da03bf466cad6,1,Andrew Onishuk,2017-06-06 13:59:28+03:00,['bc90de2e9843f41229d86f4dad6accbb66163500'],2,32,34,27336049,4,0,0.75862069,1,29839
d8d586888d415d1c429ff6514e5b8435f6cb7e47,1,Sandor Magyari,2017-06-06 13:08:33+02:00,['0dd9fbf34764de407d9605f4472da03bf466cad6'],0,5,5,27336054,1,,,,29839
e61fea51b5ffb9c74f746810713a7d9f1f27184f,0,Attila Doroszlai,2017-06-06 13:09:50+02:00,['d8d586888d415d1c429ff6514e5b8435f6cb7e47'],3,5,8,27336062,3,,,,29839
12202a2fd303e0d557a987f77f33387e17c9fb81,1,Alex Antonenko,2017-06-06 17:12:42+03:00,['64e3ad77685dd934324947225889e76429ad5813'],48,48,96,27336158,13,,,,29839
4247f6919c329fc3da9e4ea8a0aa62aacd4793e3,0,Jonathan Hurley,2017-06-06 10:22:45-04:00,['e61fea51b5ffb9c74f746810713a7d9f1f27184f'],2,127,129,27336287,3,0.288135593,0.440677966,1,29839
5a1bd715e11b2e3a79b139118a90b66eca32f025,1,Nate Cole,2017-06-06 10:33:14-04:00,['12202a2fd303e0d557a987f77f33387e17c9fb81'],59,84,143,27336430,7,0,1,1,29839
7750c9a4672e692f6389698698335596d8bf4925,0,Jonathan Hurley,2017-06-06 14:42:20-04:00,['5a1bd715e11b2e3a79b139118a90b66eca32f025'],13,5,18,27336448,2,1,1,1,29839
84c4e0d652db5b06f830073e9a8dc899c38daef6,1,pallavkul,2017-06-07 12:10:57+05:18,['4247f6919c329fc3da9e4ea8a0aa62aacd4793e3'],0,214,214,27336662,2,0.427631579,0.375,1,29840
1586a1a9253e5c456161331a5766ed52e250ad99,0,Attila Doroszlai,2017-06-07 15:34:35+02:00,['84c4e0d652db5b06f830073e9a8dc899c38daef6'],2,1,3,27336665,1,,,,29840
c2ab4a3ce19fba934f3766f30a4738d8ebbb061e,1,Myroslav Papirkovskyi,2017-06-07 18:50:54+03:00,['5d0962421397d64b5e7a383eb23fb6ae22028b0b'],134,2036,2170,27338835,59,0.639344262,0.824355972,0.795081967,29861
b1d357ad11c7e4ac23aa61e7a446bd94030b8f44,1,Andrii Tkach,2017-06-07 19:03:50+03:00,['c2ab4a3ce19fba934f3766f30a4738d8ebbb061e'],262,437,699,27339534,7,0.674418605,1,1,29861
acb2f9896e55db202f5b054565d09c0e598011ed,0,Di Li,2017-06-07 12:26:47-04:00,['1586a1a9253e5c456161331a5766ed52e250ad99'],106,241,347,27339881,3,0,0.97005988,1,29861
3b575fb917a559ffcbde3bb6ae114c71aa9f2b4f,1,Jaimin Jetly,2017-06-07 10:01:31-07:00,['acb2f9896e55db202f5b054565d09c0e598011ed'],115,241,356,27340237,17,0,0,0,29861
b772b4d625b9de6eaa46926ccbe3244811c9865f,1,oleewere,2017-06-07 19:35:08+02:00,['3b575fb917a559ffcbde3bb6ae114c71aa9f2b4f'],3,3,6,27340243,1,,,,29861
e801b4199dd8a38ea50dd5b172fa85f49ee56966,0,Sumit Mohanty,2017-06-07 12:50:27-07:00,['b772b4d625b9de6eaa46926ccbe3244811c9865f'],2,2,4,27340247,1,,,,29861
bdadb704b8982915575ea65d3c42447abcb75d6e,0,Alejandro Fernandez,2017-06-07 15:15:38-07:00,['e801b4199dd8a38ea50dd5b172fa85f49ee56966'],2,6,8,27340255,2,0,0,1,29861
9b44b62f638c56c913b3977683a19ea89e39b4ec,0,Attila Doroszlai,2017-06-08 11:09:29+02:00,['bdadb704b8982915575ea65d3c42447abcb75d6e'],0,25,25,27340280,2,,,,29861
e71f49e4ef30ff720ad4f8b7fb3823d68acd48cc,1,Attila Doroszlai,2017-06-08 11:23:29+02:00,['9b44b62f638c56c913b3977683a19ea89e39b4ec'],12,6,18,27340298,2,,,,29861
2ff48a00b155a65ac0daa55ac8f8be00774b158f,0,Attila Doroszlai,2017-06-08 11:35:49+02:00,['e71f49e4ef30ff720ad4f8b7fb3823d68acd48cc'],63,12,75,27340373,19,,,,29861
c8aecb7721b574f0cc4604abcf93456ca4de93d6,1,Andrew Onishuk,2017-06-08 13:43:14+03:00,['b1d357ad11c7e4ac23aa61e7a446bd94030b8f44'],334,319,653,27341026,17,0.306451613,1,0.870967742,29861
3146a1970f356427010a2275462a6ad93c9ce126,0,oleewere,2017-06-08 13:29:46+02:00,['2ff48a00b155a65ac0daa55ac8f8be00774b158f'],0,0,0,27341026,3,,,,29861
d21d434a16ec3078f9c2098327b559476bab8bb1,1,Andrew Onishuk,2017-06-08 15:14:17+03:00,['3146a1970f356427010a2275462a6ad93c9ce126'],6,6,12,27341038,1,,,,29861
e2fbd0f0675d68e54765d83a07a2ea825e2d3821,1,Andrew Onishuk,2017-06-08 15:23:29+03:00,['d21d434a16ec3078f9c2098327b559476bab8bb1'],2,5,7,27341045,1,1,1,1,29861
89797ea2c56ae0387899890756527e1019ffd3f3,1,"Toader, Sebastian",2017-06-08 15:46:51+02:00,['e2fbd0f0675d68e54765d83a07a2ea825e2d3821'],132,242,374,27341419,9,1,0.866666667,0.6,29861
aa6b3308c44b1e0e74edc41e96e078e3597bed75,0,Andrew Onishuk,2017-06-08 17:11:42+03:00,['89797ea2c56ae0387899890756527e1019ffd3f3'],9,11,20,27341439,2,0,1,0.5,29861
7dc91c5a8e75966f642a4890ed7a5750687b5928,0,Tim Thorpe,2017-06-08 08:49:32-07:00,['aa6b3308c44b1e0e74edc41e96e078e3597bed75'],2,2,4,27341443,1,,,,29861
0b6d0dcef10ec60c83ad055567b487104573ae62,0,Tim Thorpe,2017-06-08 08:51:30-07:00,['7dc91c5a8e75966f642a4890ed7a5750687b5928'],5,263,268,27341711,2,0.175531915,0.765957447,0.70212766,29861
12df64fe339473f04b9afa14ad08100fd2c60cd6,1,Andrii Tkach,2017-06-08 19:01:32+03:00,['c8aecb7721b574f0cc4604abcf93456ca4de93d6'],50,138,188,27341899,9,0.5,1,1,29863
7e3641eba8ce974c7768a85f65b5910bd5ff55ca,0,Alex Antonenko,2017-06-08 19:03:18+03:00,['0b6d0dcef10ec60c83ad055567b487104573ae62'],2,2,4,27341903,2,,,,29863
9c302dcd237af0ba9b5099ddc3bf7b94e29496cd,0,Di Li,2017-06-08 13:21:06-04:00,['7e3641eba8ce974c7768a85f65b5910bd5ff55ca'],1,6,7,27341910,2,,,,29863
b98f07f9093a0b9635443f317e96768b2d8b8ef7,0,Alejandro Fernandez,2017-06-08 10:33:06-07:00,['9c302dcd237af0ba9b5099ddc3bf7b94e29496cd'],1,21,22,27341932,2,0.428571429,0.857142857,1,29863
103dfffe772b24226d0faa0037edae6971389e73,0,Robert Levas,2017-06-08 15:21:19-04:00,"['7460cebf90e8f77b3b14457a64423ebc3ba028cc', 'b98f07f9093a0b9635443f317e96768b2d8b8ef7']",22346,166289,188635,27530567,2646,,,,29863
4aaf259e191344076a88391f5853da4bf85b8a80,1,Robert Levas,2017-06-08 16:23:34-04:00,['b98f07f9093a0b9635443f317e96768b2d8b8ef7'],47,1084,1131,27531698,57,0.131805158,0.478510029,0.962750716,29877
eb7fbbdc6ecdc6a0b1af26ddfd66d4b30d528a4f,0,Yusaku Sako,2017-06-08 15:22:11-07:00,['4aaf259e191344076a88391f5853da4bf85b8a80'],1,1,2,27531700,1,,,,29877
57bb1365e414c1f110d2d142fa198fb8e043af95,0,Richard Zang,2017-06-08 16:16:02-07:00,['eb7fbbdc6ecdc6a0b1af26ddfd66d4b30d528a4f'],36,49,85,27531785,10,1,1,1,29877
215bd7aaa3cdefe1bdc9242c4fa8e9d0106d8740,1,Nitiraj Singh Rathore,2017-06-09 14:08:37+05:18,['57bb1365e414c1f110d2d142fa198fb8e043af95'],1,3,4,27531789,1,0,0,1,29877
190ecad0063340d163d220baddbb6b40b6d7ab83,1,Lisnichenko Dmitro,2017-06-09 12:54:05+03:00,['215bd7aaa3cdefe1bdc9242c4fa8e9d0106d8740'],6,6,12,27531801,1,,,,29877
29f750894754ed2112fcedaa0b2f5ec693b5cd0e,1,Dmytro Sen,2017-06-09 14:36:11+03:00,['190ecad0063340d163d220baddbb6b40b6d7ab83'],212,994,1206,27533007,17,0.387654321,1,0.965432099,29884
ebe3939006a3080870355be39a9d3841908718bd,0,Robert Levas,2017-06-09 14:46:19-04:00,"['103dfffe772b24226d0faa0037edae6971389e73', '29f750894754ed2112fcedaa0b2f5ec693b5cd0e']",303,2137,2440,27535447,86,,,,29884
d97aa1dfc5c238544b65fcd67534de64aff556a2,1,Di Li,2017-06-09 15:43:57-04:00,['29f750894754ed2112fcedaa0b2f5ec693b5cd0e'],10,7,17,27535464,8,,,,29884
2bea1205e213db7fc35fc9a0aac0453bbdeaa417,0,Di Li,2017-06-09 16:37:40-04:00,['d97aa1dfc5c238544b65fcd67534de64aff556a2'],1,1,2,27535466,1,,,,29884
eaa2e0f45b86d223c779739ee78e5d184062177e,0,Robert Levas,2017-06-09 17:08:27-04:00,"['ebe3939006a3080870355be39a9d3841908718bd', '2bea1205e213db7fc35fc9a0aac0453bbdeaa417']",11,8,19,27535485,9,,,,29884
62f4432cc35e39a8fdd7540e6cfc4f5edbac19cb,0,Richard Zang,2017-06-11 04:25:11-07:00,['2bea1205e213db7fc35fc9a0aac0453bbdeaa417'],4,93,97,27535582,5,0.288461538,0.980769231,1,29884
13798c27a4787886816aaac1a688cdb208d864b4,0,Sumit Mohanty,2017-06-11 08:12:56-07:00,['62f4432cc35e39a8fdd7540e6cfc4f5edbac19cb'],1,1,2,27535584,1,,,,29884
d5105226bcfcb97d938e92d40914ef3a083c2d77,1,pallavkul,2017-06-12 14:35:02+05:18,['13798c27a4787886816aaac1a688cdb208d864b4'],71,74,145,27535729,7,0,1,1,29884
219f22345e6f7b7ad38cdaac02e9bbe8c8ad7254,1,Attila Doroszlai,2017-06-12 11:30:03+02:00,['d5105226bcfcb97d938e92d40914ef3a083c2d77'],765,555,1320,27537049,189,1,0.548543689,0.325242718,29884
c7b77436477117050103b35d1e579d02a096d341,1,Vitaly Brodetskyi,2017-06-12 14:05:12+03:00,['219f22345e6f7b7ad38cdaac02e9bbe8c8ad7254'],2,34,36,27537085,2,0,0,0,29884
d0eaaae8e4bbfe3c1ae0e692aeeb64e04ca29bfe,0,Attila Doroszlai,2017-06-12 13:40:29+02:00,['c7b77436477117050103b35d1e579d02a096d341'],0,1,1,27537086,1,0,1,1,29884
8d129d414a9e33975620d5b0c430a7fba6d914b3,1,Dmytro Sen,2017-06-12 18:04:27+03:00,['d0eaaae8e4bbfe3c1ae0e692aeeb64e04ca29bfe'],8,117,125,27537211,5,0.942528736,0.83908046,0.908045977,29884
f09670d945737431849c3a852e9bc58f6dd4fe94,0,Robert Levas,2017-06-12 12:34:01-04:00,"['eaa2e0f45b86d223c779739ee78e5d184062177e', '8d129d414a9e33975620d5b0c430a7fba6d914b3']",851,875,1726,27538937,209,,,,29884
871f85b34e5d0586dd21ed332a16abd012a72eef,1,Lisnichenko Dmitro,2017-06-12 19:38:34+03:00,['7750c9a4672e692f6389698698335596d8bf4925'],144,322,466,27539403,12,0.393258427,0.561797753,0.539325843,29884
382da97990dfe673bb6d4d69590444ddbbb455eb,0,Nate Cole,2017-06-12 12:44:40-04:00,"['871f85b34e5d0586dd21ed332a16abd012a72eef', '8d129d414a9e33975620d5b0c430a7fba6d914b3']",1713,4690,6403,27545806,387,,,,29884
acc12fb7232c8bcd007fe38a942209b853ce3618,0,Nate Cole,2017-06-12 12:48:52-04:00,"['8d129d414a9e33975620d5b0c430a7fba6d914b3', '382da97990dfe673bb6d4d69590444ddbbb455eb']",316,650,966,27546772,45,,,,29884
f1ca09c03a2fe316129aa5623c675b62d3177112,1,Alejandro Fernandez,2017-06-12 13:02:59-07:00,['acc12fb7232c8bcd007fe38a942209b853ce3618'],176,756,932,27547704,37,0.138755981,1,0.631578947,29887
75152614e84299d16f36a6c6d7387b77a172eb96,0,Jaimin Jetly,2017-06-12 15:46:51-07:00,['f1ca09c03a2fe316129aa5623c675b62d3177112'],263,5,268,27547972,2,0.824468085,0.234042553,0.29787234,29887
8cdf232bde26fb3a0cd46fb178be7c517d068a0c,1,Jaimin Jetly,2017-06-12 15:46:51-07:00,['75152614e84299d16f36a6c6d7387b77a172eb96'],2,2,4,27547976,1,,,,29887
1f19461f10a2c54d3ed81efedc3f9d3d64397700,1,Mugdha Varadkar,2017-06-13 10:06:23+05:18,['8cdf232bde26fb3a0cd46fb178be7c517d068a0c'],4,85,89,27548065,9,0,0.936507937,0.904761905,29887
27a99389e3c3566b6fc58b17cb06510ab9bffa13,0,Andrew Onishuk,2017-06-13 14:44:05+03:00,['1f19461f10a2c54d3ed81efedc3f9d3d64397700'],1,1,2,27548067,1,,,,29887
fc00b2caf927d083c70812bf1552aafa68958d1f,1,oleewere,2017-06-13 13:47:23+02:00,['27a99389e3c3566b6fc58b17cb06510ab9bffa13'],214,214,428,27548495,23,,,,29888
f80c6ee45b5c6708aa9db98b9afe7ebbeba2afe7,0,Alex Antonenko,2017-06-13 15:33:14+03:00,['fc00b2caf927d083c70812bf1552aafa68958d1f'],8,11,19,27548514,7,1,1,1,29888
31ac3c21b71868df4f4e2ac82e72defa79767bd6,0,Andrew Onishuk,2017-06-13 17:01:06+03:00,['f80c6ee45b5c6708aa9db98b9afe7ebbeba2afe7'],4,15,19,27548533,2,0,0.8,0.8,29888
df685b92d9c99f55757dc36858653130eaddf30c,0,Yusaku Sako,2017-06-13 13:36:33-07:00,['31ac3c21b71868df4f4e2ac82e72defa79767bd6'],0,12,12,27548545,1,,,,29888
24e2cacb8ede081824b9162ba124acdffa33e0ec,0,Sumit Mohanty,2017-06-13 19:57:12-07:00,['df685b92d9c99f55757dc36858653130eaddf30c'],20,142,162,27548707,5,,,,29890
03812cba4fff24093cf10035667d1a99d71e9a80,1,Attila Doroszlai,2017-06-14 14:38:24+02:00,['24e2cacb8ede081824b9162ba124acdffa33e0ec'],24,499,523,27549230,8,0.420731707,0.573170732,0.731707317,29893
f1e89e4d2cc81d8ba14d465fd5badfe77f329a69,1,Eugene Chekanskiy,2017-06-14 16:31:28+03:00,['03812cba4fff24093cf10035667d1a99d71e9a80'],2,20,22,27549252,5,0,0,0,29893
192162e05b7036c5dbbe120c447d7b5ac7ea5b13,1,Tim Thorpe,2017-06-14 09:33:36-07:00,['f1e89e4d2cc81d8ba14d465fd5badfe77f329a69'],2,2,4,27549256,1,,,,29893
e2b8764cda8e51e06654e51debe46e47354a61aa,1,Nate Cole,2017-06-14 12:33:49-04:00,['382da97990dfe673bb6d4d69590444ddbbb455eb'],115,374,489,27549745,18,0.142857143,0.601503759,0.676691729,29893
5b9454ef4cd7483872938b01872ad0646c242571,0,Robert Levas,2017-06-14 17:19:17-04:00,"['f09670d945737431849c3a852e9bc58f6dd4fe94', '192162e05b7036c5dbbe120c447d7b5ac7ea5b13']",1022,2400,3422,27553167,142,,,,29893
49f6b80051ac3b2cf7e4b18b0b2c454f2f9a6da9,0,Attila Doroszlai,2017-06-15 11:35:03+02:00,['192162e05b7036c5dbbe120c447d7b5ac7ea5b13'],7,5,12,27553179,2,0,0,1,29893
d06fba3506c1e60cbf8a0e737f65c7f842f8402f,0,Attila Doroszlai,2017-06-15 11:53:57+02:00,['49f6b80051ac3b2cf7e4b18b0b2c454f2f9a6da9'],2,2,4,27553183,2,,,,29893
a06b6e1d287ca7ed5e63bf74f2c955aa2ec1dbc9,0,Venkata Sairam,2017-06-15 16:24:34+05:18,['d06fba3506c1e60cbf8a0e737f65c7f842f8402f'],110,562,672,27553855,7,1,0.516129032,1,29894
874b1f8334ba214b4be1eb4ad7394e5ce6abdd73,1,Vitaly Brodetskyi,2017-06-15 14:15:34+03:00,['a06b6e1d287ca7ed5e63bf74f2c955aa2ec1dbc9'],2,40,42,27553897,2,0,0,0,29894
f99e7763ed23dde574ce5f9569e90da293c8f366,1,oleewere,2017-06-15 14:02:22+02:00,['874b1f8334ba214b4be1eb4ad7394e5ce6abdd73'],3,30,33,27553930,3,1,1,1,29894
58d77239b70d2295da23d476e5010bb60d4f1c88,0,Andrii Tkach,2017-06-15 16:00:42+03:00,['f99e7763ed23dde574ce5f9569e90da293c8f366'],1,7,8,27553938,1,0,0,0,29894
70f9bd6201ba2c3f406d414d52e40c6534abe870,1,Alex Antonenko,2017-06-15 16:30:07+03:00,['58d77239b70d2295da23d476e5010bb60d4f1c88'],19,128,147,27554085,2,0.414634146,1,0.926829268,29894
d7bc588a14170ab0f15fd0f414f27a53fb69fc4a,0,Robert Levas,2017-06-15 10:20:05-04:00,"['5b9454ef4cd7483872938b01872ad0646c242571', '70f9bd6201ba2c3f406d414d52e40c6534abe870']",144,774,918,27555003,19,,,,29894
f76c87a699dad1b5a85f6fc13fd76b82818c6e58,1,Robert Levas,2017-06-15 11:04:49-04:00,['d7bc588a14170ab0f15fd0f414f27a53fb69fc4a'],11058,13027,24085,27579088,64,0.293296089,0.824022346,0.879888268,29897
7302da4e557f7a3b6a1d069c1858e5ac4d2d2bf6,0,Aravindan Vijayan,2017-06-15 08:55:34-07:00,['70f9bd6201ba2c3f406d414d52e40c6534abe870'],0,29,29,27579117,2,0,0.842105263,0.842105263,29897
834cb6655b4b56846f41141c5c55aa70c1eb5cf4,1,"Toader, Sebastian",2017-06-15 18:07:47+02:00,['7302da4e557f7a3b6a1d069c1858e5ac4d2d2bf6'],70,162,232,27579349,17,1,1,1,29897
bd918763c277b6c026648de0d0ec703aa6dc104d,0,Dmytro Grinenko,2017-06-15 19:19:12+03:00,['834cb6655b4b56846f41141c5c55aa70c1eb5cf4'],0,21,21,27579370,1,,,,29897
8873e99288bfb929a0e279b8366e1bfb135a5f91,1,Vitaly Brodetskyi,2017-06-16 00:32:13+03:00,['bd918763c277b6c026648de0d0ec703aa6dc104d'],24,74,98,27579468,12,1,0,0.2,29897
43a88e79aca9a4dfa708aaae0797a8fb8bf297c3,1,Venkata Sairam,2017-06-16 11:36:09+05:18,['8873e99288bfb929a0e279b8366e1bfb135a5f91'],10,368,378,27579846,2,0.666666667,0.666666667,0.666666667,29898
c52faea36d7eca29cab23a3fccd1afdf00b4c85d,1,Venkata Sairam,2017-06-16 11:40:26+05:18,['43a88e79aca9a4dfa708aaae0797a8fb8bf297c3'],2,2,4,27579850,2,,,,29898
94fed550380c51fb8baf672919985bcbf14143c4,1,Andrew Onishuk,2017-06-16 11:27:36+03:00,['12df64fe339473f04b9afa14ad08100fd2c60cd6'],30,151,181,27580031,13,0.836065574,0.524590164,0.721311475,29899
1fbb933ef91d5a1ccf704e8d043c0ab0f6c30df7,1,oleewere,2017-06-16 13:10:17+02:00,['c52faea36d7eca29cab23a3fccd1afdf00b4c85d'],35,35,70,27580101,32,,,,29899
fe02e386526adfa19ea6a4abad34043d40822a6f,1,Jonathan Hurley,2017-06-16 08:52:12-04:00,['1fbb933ef91d5a1ccf704e8d043c0ab0f6c30df7'],24,265,289,27580390,7,0,0,1,29901
eb17e4c6983fab93b5c1db8ff6868286b0f09f31,1,Lisnichenko Dmitro,2017-06-16 19:19:51+03:00,['fe02e386526adfa19ea6a4abad34043d40822a6f'],809,9,818,27581208,16,0.89292196,0.557168784,0.136116152,29901
8f2663b2e6d543c75433359cb800a565e90f492e,1,Sandor Magyari,2017-06-16 22:02:09+02:00,['eb17e4c6983fab93b5c1db8ff6868286b0f09f31'],9,16,25,27581233,3,0,1,1,29901
e8908501b27c650f39cbe1386427581a65f8c6e1,0,Jaimin Jetly,2017-06-16 14:03:17-07:00,['8f2663b2e6d543c75433359cb800a565e90f492e'],22,39,61,27581294,1,,,,29901
f8b32404003e7af2ab384e8c49b2821e0ce73b81,0,Attila Doroszlai,2017-06-19 09:37:11+02:00,['e8908501b27c650f39cbe1386427581a65f8c6e1'],50,170,220,27581514,8,0.474358974,1,1,29901
9bf9bbc849f4c615be855b2be741cd7d7875755a,0,Attila Doroszlai,2017-06-19 09:43:27+02:00,['f8b32404003e7af2ab384e8c49b2821e0ce73b81'],7,0,7,27581521,2,,,,29901
2a844d706bb6c76812edee3cb0e57bad2f9c5776,0,Dmytro Sen,2017-06-19 12:13:02+03:00,['9bf9bbc849f4c615be855b2be741cd7d7875755a'],2,13,15,27581536,1,,,,29901
b7d422526326fea373a5e9b067df8ce0b05867f6,0,Miklos Gergely,2017-06-19 12:25:19+02:00,['2a844d706bb6c76812edee3cb0e57bad2f9c5776'],104,0,104,27581640,3,,,,29901
49da047ecd0effd228c413425c73432f40073ac3,1,Miklos Gergely,2017-06-19 12:36:31+02:00,['b7d422526326fea373a5e9b067df8ce0b05867f6'],69,458,527,27582167,22,0.624203822,0.624203822,0.929936306,29906
d986503ca0fb4301e5b01595299162da3453f41c,1,Andrii Tkach,2017-06-19 15:25:44+03:00,['94fed550380c51fb8baf672919985bcbf14143c4'],64,391,455,27582622,14,0.984375,1,0.921875,29908
cedb428812c0e3acc4dc33d6b56eee750c1b05d4,1,Miklos Gergely,2017-06-19 15:01:26+02:00,['49da047ecd0effd228c413425c73432f40073ac3'],3,3,6,27582628,1,,,,29908
e8e9781a8e98a5afdc31becc419e3792ba0a8515,0,Attila Doroszlai,2017-06-19 15:12:06+02:00,['cedb428812c0e3acc4dc33d6b56eee750c1b05d4'],2,16,18,27582646,2,0.6,0.6,1,29908
927d5c8340e5a22cd2fb8b8a2d14956b19810b93,1,Tim Thorpe,2017-06-19 09:00:20-07:00,['e8e9781a8e98a5afdc31becc419e3792ba0a8515'],5,264,269,27582915,2,0.095238095,0.761904762,0.698412698,29908
95877641588a50c20d8b97e8ce749addc37fc0a2,0,Dmytro Sen,2017-06-19 19:19:14+03:00,['927d5c8340e5a22cd2fb8b8a2d14956b19810b93'],41,68,109,27583024,2,0.764705882,0.764705882,1,29908
cd8fb1b04823aa5a072889b7445525e00291baa3,0,Robert Levas,2017-06-19 12:21:04-04:00,['95877641588a50c20d8b97e8ce749addc37fc0a2'],29,67,96,27583120,5,0,1,0,29909
2b46cb429919f3d4186e30eb7f0d0f6fc3873b74,0,Tim Thorpe,2017-06-19 10:57:08-07:00,['cd8fb1b04823aa5a072889b7445525e00291baa3'],8,2,10,27583130,4,,,,29909
df21f9c4b2577a1d801145b131b8a065c8d02a7e,0,Alejandro Fernandez,2017-06-19 11:33:58-07:00,['2b46cb429919f3d4186e30eb7f0d0f6fc3873b74'],2,98,100,27583230,2,,,,29910
f5ca1145153a936501ba887d743ce3639a7b8a1a,0,Robert Levas,2017-06-19 16:16:05-04:00,"['f76c87a699dad1b5a85f6fc13fd76b82818c6e58', 'df21f9c4b2577a1d801145b131b8a065c8d02a7e']",1324,2176,3500,27586730,141,,,,29910
8df01a8f84f9b404be9248f36484baebc7de582f,1,Mugdha Varadkar,2017-06-20 10:26:08+05:18,['df21f9c4b2577a1d801145b131b8a065c8d02a7e'],3,13,16,27586746,2,0,0,1,29910
380fa6985399fbeb3fc6da9ffaeeebd2f7652c1f,1,Mugdha Varadkar,2017-06-20 10:28:49+05:18,['8df01a8f84f9b404be9248f36484baebc7de582f'],0,58,58,27586804,7,,,,29911
597d003d43c9ab43cca381810462e0803962a4fa,1,Attila Doroszlai,2017-06-20 08:47:21+02:00,['380fa6985399fbeb3fc6da9ffaeeebd2f7652c1f'],139,121,260,27587064,6,,,,29911
11f16c83ac8f2ebbf4609240a895a4a3d078b946,1,Andrii Tkach,2017-06-20 13:08:27+03:00,['d986503ca0fb4301e5b01595299162da3453f41c'],31,163,194,27587258,7,0.983050847,1,0.898305085,29911
670a08eed3c8b45b58ab729c8592d6f46af3d4f2,1,Andrew Onishuk,2017-06-20 15:25:47+03:00,['11f16c83ac8f2ebbf4609240a895a4a3d078b946'],348,176,524,27587782,10,0.960264901,0.900662252,0,29911
34b1e5f4bb1a3aee03cee31dfd51f57e6480b4ce,0,Di Li,2017-06-20 08:56:23-04:00,['597d003d43c9ab43cca381810462e0803962a4fa'],8,8,16,27587798,6,,,,29911
242d79b8f5a2ced87a5d86b0caf5b7efa3678c89,0,Attila Doroszlai,2017-06-20 16:14:04+02:00,['34b1e5f4bb1a3aee03cee31dfd51f57e6480b4ce'],98,2,100,27587898,2,,,,29911
d693273dd2ddaa0532dccbf5b709d377122a209d,0,Andrew Onishuk,2017-06-20 17:35:29+03:00,['242d79b8f5a2ced87a5d86b0caf5b7efa3678c89'],2,7,9,27587907,1,0,0,0,29911
4dac1b196e24c67243387c124f2c3109cbb3eee0,1,Lisnichenko Dmitro,2017-06-20 18:21:21+03:00,['d693273dd2ddaa0532dccbf5b709d377122a209d'],0,10,10,27587917,2,1,0,1,29911
aa33c1b5bb1fc1a4742ce98ad7e9ade06212ab20,0,Alejandro Fernandez,2017-06-20 11:01:37-07:00,['4dac1b196e24c67243387c124f2c3109cbb3eee0'],2,98,100,27588017,2,,,,29912
31058596b4ed0cf5b78c464fec2585940051c597,1,Vitaly Brodetskyi,2017-06-20 22:21:01+03:00,['aa33c1b5bb1fc1a4742ce98ad7e9ade06212ab20'],5,52,57,27588074,2,0.517241379,0.517241379,0,29912
7a050b0521db706d2e5622a611718c283c5331fc,0,Aravindan Vijayan,2017-06-20 17:16:57-07:00,['31058596b4ed0cf5b78c464fec2585940051c597'],1,1,2,27588076,1,,,,29912
134406a652e249001ef353d5a55b24d5dd53e811,0,Attila Doroszlai,2017-06-21 10:01:06+02:00,['7a050b0521db706d2e5622a611718c283c5331fc'],5,5,10,27588086,1,,,,29912
e7fc3a6481a66b7b81afd7c728ace895e1763c3c,1,Dipayan Bhowmick,2017-06-21 16:30:20+05:18,['134406a652e249001ef353d5a55b24d5dd53e811'],1,14,15,27588101,3,,,,29912
43a867206432319fea28417b3687069cc4f9305d,1,Nate Cole,2017-06-21 11:35:40-04:00,['e2b8764cda8e51e06654e51debe46e47354a61aa'],287,211,498,27588599,19,1,0.916666667,0,29912
8f03fd044b805f350ca9ace6683a969a82b6c8f8,0,Robert Levas,2017-06-21 14:05:43-04:00,"['f5ca1145153a936501ba887d743ce3639a7b8a1a', 'e7fc3a6481a66b7b81afd7c728ace895e1763c3c']",169,294,463,27589062,31,,,,29912
23760e71a573da20d83e026d4a2e46177cada15b,1,Jayush Luniya,2017-06-21 12:17:13-07:00,['e7fc3a6481a66b7b81afd7c728ace895e1763c3c'],0,6,6,27589068,1,0,0,0,29912
6cda103e26885233f27b82ab3af8ef099428c53f,1,Venkata Sairam,2017-06-22 09:04:58+05:18,['23760e71a573da20d83e026d4a2e46177cada15b'],9,10,19,27589087,1,,,,29912
1f70d06277cb68a87ef861e48f7f2d0b0bbf7e03,0,Venkata Sairam,2017-06-22 09:09:36+05:18,['6cda103e26885233f27b82ab3af8ef099428c53f'],0,1,1,27589088,1,,,,29912
9c6932286fd3860627a6c41ab997293b0caef5a1,0,Venkata Sairam,2017-06-22 09:13:17+05:18,['1f70d06277cb68a87ef861e48f7f2d0b0bbf7e03'],0,3,3,27589091,1,0,0,0,29912
7335bf7e2e08da032524009ce3ad2a6b1c2430aa,0,Venkata Sairam,2017-06-22 09:17:01+05:18,['9c6932286fd3860627a6c41ab997293b0caef5a1'],3,45,48,27589139,5,1,1,1,29912
b53cf918fc27d55a11fae25af9c4eba6dcee26fb,1,Venkata Sairam,2017-06-22 09:23:30+05:18,['7335bf7e2e08da032524009ce3ad2a6b1c2430aa'],129,582,711,27589850,14,1,1,1,29913
e0d5f40942575b14a3e70aec1f8c09290f86ee21,0,Attila Doroszlai,2017-06-22 08:24:14+02:00,['b53cf918fc27d55a11fae25af9c4eba6dcee26fb'],0,1,1,27589851,1,,,,29913
965e4bd0f834f009988f771a85e81dca55f0d235,0,Attila Doroszlai,2017-06-22 08:29:25+02:00,['e0d5f40942575b14a3e70aec1f8c09290f86ee21'],299,301,600,27590451,71,,,,29913
5fc8ccc9655e702c20f0a4ff569610afe5d08f45,0,Andrii Tkach,2017-06-22 14:24:23+03:00,['965e4bd0f834f009988f771a85e81dca55f0d235'],1,4,5,27590456,2,0,1,1,29913
da6ea9f54adc2b274d87d3e38bc8bec737378ea0,1,ababiichuk,2017-06-22 14:51:28+03:00,['5fc8ccc9655e702c20f0a4ff569610afe5d08f45'],0,672,672,27591128,29,0.640449438,1,1,29942
4ce2f2c528c62a7f2651381df17630a86e104c1b,1,ababiichuk,2017-06-22 14:53:24+03:00,['da6ea9f54adc2b274d87d3e38bc8bec737378ea0'],14,184,198,27591326,11,1,1,1,29943
70633c5f26a918f98693a69c007fa17df2619f2e,1,ababiichuk,2017-06-22 14:54:55+03:00,['4ce2f2c528c62a7f2651381df17630a86e104c1b'],0,161,161,27591487,9,,,,29943
607c918595ce85e23adbe4ea2a9b79cb6b8492fa,1,ababiichuk,2017-06-22 15:17:33+03:00,['70633c5f26a918f98693a69c007fa17df2619f2e'],21,8043,8064,27599551,18,0.902857143,1,1,29954
72c7400dcfed179524eed0a19747bb409130aaa8,1,ababiichuk,2017-06-22 15:23:30+03:00,['607c918595ce85e23adbe4ea2a9b79cb6b8492fa'],18,42,60,27599611,6,1,1,1,29955
8aa761f9661fd07a3b75ca6b53a8a5fa9cbe4d51,1,ababiichuk,2017-06-22 15:24:50+03:00,['72c7400dcfed179524eed0a19747bb409130aaa8'],10,28,38,27599649,2,1,1,1,29955
e71ad9666728cd20c99c5528cdbd5b238d41f438,1,ababiichuk,2017-06-22 15:28:31+03:00,['8aa761f9661fd07a3b75ca6b53a8a5fa9cbe4d51'],24,546,570,27600219,23,0.838709677,1,1,29965
84a59d71183edfbb85de1090a5aa1092d60621cf,1,ababiichuk,2017-06-22 15:32:08+03:00,['e71ad9666728cd20c99c5528cdbd5b238d41f438'],21,5357,5378,27605597,4,0,0,0,29966
603297ae862b633b5e562fe73860674cab2cfe94,1,ababiichuk,2017-06-22 15:35:04+03:00,['84a59d71183edfbb85de1090a5aa1092d60621cf'],20,1427,1447,27607044,29,0.069008783,1,1,29985
c57329cd4dafc71507ef88cd2b20ae9d0e02d66d,1,ababiichuk,2017-06-22 15:36:00+03:00,['603297ae862b633b5e562fe73860674cab2cfe94'],8,22,30,27607074,3,,,,29985
ae40a5f16f5992a9b9751edd22188cb70c9ffec2,1,ababiichuk,2017-06-22 15:38:35+03:00,['c57329cd4dafc71507ef88cd2b20ae9d0e02d66d'],3,3,6,27607080,1,,,,29985
6fc2fef6e0f3480551bbd18a888ad44b0005fade,1,ababiichuk,2017-06-22 15:40:37+03:00,['ae40a5f16f5992a9b9751edd22188cb70c9ffec2'],65,1194,1259,27608339,40,0.842293907,1,1,30006
a0e713dfd719daba1dff3de041b47e5f2c9d57b6,0,ababiichuk,2017-06-22 15:42:28+03:00,['6fc2fef6e0f3480551bbd18a888ad44b0005fade'],1,5,6,27608345,2,0,0,0,30006
c3d8e31112105898ee0183cb3233fa8057bd5ab8,1,ababiichuk,2017-06-22 15:43:34+03:00,['a0e713dfd719daba1dff3de041b47e5f2c9d57b6'],55,565,620,27608965,22,1,1,1,30015
56681d79f25cbd98f70be8d23f3ae46619a90707,1,ababiichuk,2017-06-22 15:44:46+03:00,['c3d8e31112105898ee0183cb3233fa8057bd5ab8'],627,788,1415,27610380,20,1,0,0,30016
1a2d6cedc162c7b71b93d5f5c3272aed30bc4fc2,1,ababiichuk,2017-06-22 15:45:53+03:00,['56681d79f25cbd98f70be8d23f3ae46619a90707'],888,1379,2267,27612647,27,0.435643564,0.524752475,0.831683168,30021
4bfc6f13e578e1c2d257df2f4180769068edb1d8,1,ababiichuk,2017-06-22 16:16:26+03:00,['1a2d6cedc162c7b71b93d5f5c3272aed30bc4fc2'],0,8,8,27612655,1,,,,30021
b5333870a70948cf821f8a3e617b5efd3984de5e,0,Robert Levas,2017-06-22 10:37:55-04:00,"['8f03fd044b805f350ca9ace6683a969a82b6c8f8', '5fc8ccc9655e702c20f0a4ff569610afe5d08f45']",441,953,1394,27614049,96,,,,30021
45a29900bf849678347e33c14587f8ffca855383,0,Attila Doroszlai,2017-06-22 16:37:58+02:00,['5fc8ccc9655e702c20f0a4ff569610afe5d08f45'],12,22,34,27614083,1,0.333333333,1,0.888888889,30021
1e64135c1c692870f8e831f5d5d2a3ff739627ba,1,Myroslav Papirkovskyi,2017-06-22 18:25:50+03:00,['670a08eed3c8b45b58ab729c8592d6f46af3d4f2'],41,180,221,27614304,11,0.333333333,0.952380952,0.968253968,30022
421ac277649f697f022501b17d767c27c83d946e,1,Myroslav Papirkovskyi,2017-06-22 18:25:50+03:00,['1e64135c1c692870f8e831f5d5d2a3ff739627ba'],376,2108,2484,27616788,63,0.518939394,0.832070707,0.699494949,30032
ac5008dac895e39f0257659a270d3b231c0aee9c,0,Robert Levas,2017-06-22 13:27:41-04:00,"['b5333870a70948cf821f8a3e617b5efd3984de5e', '45a29900bf849678347e33c14587f8ffca855383']",12,22,34,27616822,1,,,,30032
f760516c24478b19d4e579cb67702d9d43251eaa,1,Robert Levas,2017-06-22 13:29:51-04:00,['ac5008dac895e39f0257659a270d3b231c0aee9c'],348,951,1299,27618121,32,0.388127854,0.657534247,0.707762557,30035
6305fb6ab9839f20eb871eca5d933e6590f20981,1,Richard Zang,2017-06-22 12:30:06-07:00,['45a29900bf849678347e33c14587f8ffca855383'],591,937,1528,27619649,32,0.408163265,0.102040816,0.87755102,30035
845eb86c24a5b4a7d4735d50715522bd8795eff4,0,Vivek Ratnavel Subramanian,2017-06-22 12:57:27-07:00,['6305fb6ab9839f20eb871eca5d933e6590f20981'],2,3,5,27619654,1,1,0,1,30035
6fe7cc283957de8e13d1073322a6176895ff289b,1,Venkata Sairam,2017-06-23 08:04:21+05:18,['845eb86c24a5b4a7d4735d50715522bd8795eff4'],0,1,1,27619655,1,,,,30035
8f06a5b01719b825e8bcee2a2a56545a1c3052a9,1,Dmytro Grinenko,2017-06-23 08:13:54+03:00,['6fe7cc283957de8e13d1073322a6176895ff289b'],19,232,251,27619906,7,0.07079646,0.539823009,0.415929204,30035
ec8deeba201bfceb646d6d4a6e0e6fb97e9bc102,0,Venkata Sairam,2017-06-23 12:19:45+05:18,['8f06a5b01719b825e8bcee2a2a56545a1c3052a9'],185176,0,185176,27805082,260,0.401106416,0.266394744,0.177759324,30035
0dbc7976d95dd0bb25232a4fc4d204e55929eb9a,0,Lisnichenko Dmitro,2017-06-23 11:24:36+03:00,['ec8deeba201bfceb646d6d4a6e0e6fb97e9bc102'],0,17,17,27805099,1,0,1,1,30035
51b1a14d7318391572e9059f1e7615be12577199,0,Andrii Tkach,2017-06-23 16:09:35+03:00,['421ac277649f697f022501b17d767c27c83d946e'],46,215,261,27805360,12,0.738461538,1,0.846153846,30039
fd3220099abd7e990dc18fa9ff9b2758554bb2cf,0,Robert Levas,2017-06-23 09:28:38-04:00,"['f760516c24478b19d4e579cb67702d9d43251eaa', '0dbc7976d95dd0bb25232a4fc4d204e55929eb9a']",185788,1190,186978,27992338,302,,,,30039
943c1b0d375a2d92b75be1be7158e8643692b1df,1,Miklos Gergely,2017-06-23 16:03:51+02:00,['0dbc7976d95dd0bb25232a4fc4d204e55929eb9a'],68,479,547,27992885,23,0.397058824,1,0.735294118,30041
8f80fe733dc3a69a83abad2cb8f2ee499cab7da3,0,Attila Doroszlai,2017-06-23 17:47:07+02:00,['943c1b0d375a2d92b75be1be7158e8643692b1df'],1,0,1,27992886,1,,,,30041
8b90145caadf73c550c2d209eec4044ba924de9a,0,Aravindan Vijayan,2017-06-23 14:27:08-07:00,['8f80fe733dc3a69a83abad2cb8f2ee499cab7da3'],18,133,151,27993037,8,0.581081081,0.216216216,1,30041
34e790099f60f5604fb02c70457c9c97e1b690b4,0,Yusaku Sako,2017-06-23 14:57:28-07:00,['8b90145caadf73c550c2d209eec4044ba924de9a'],0,12,12,27993049,1,,,,30041
3acf9082c4dccc06e5131496f36213e8728e2260,0,Sumit Mohanty,2017-06-23 18:34:55-07:00,['34e790099f60f5604fb02c70457c9c97e1b690b4'],0,4,4,27993053,1,,,,30041
af1bf85c6801293fce732e17c13bb4fd5377f0b1,1,Dmytro Grinenko,2017-06-25 12:59:06+03:00,['3acf9082c4dccc06e5131496f36213e8728e2260'],32097,11,32108,28025161,40,0.848934911,0.334852071,0.051775148,30041
16dc4056296615a7e6ecb5509a31ab11c95ac4ac,0,Alex Antonenko,2017-06-26 02:14:16+03:00,['af1bf85c6801293fce732e17c13bb4fd5377f0b1'],6,5,11,28025172,3,0,0,0,30041
8da634c70042e6bbd99a93dd08211021798875a7,1,Venkata Sairam,2017-06-26 12:11:43+05:18,['16dc4056296615a7e6ecb5509a31ab11c95ac4ac'],0,42,42,28025214,2,0,0,1,30041
23cc628f4827913869da4917a9bd7b9c0c1abf73,0,Venkata Sairam,2017-06-26 12:19:26+05:18,['8da634c70042e6bbd99a93dd08211021798875a7'],1,1,2,28025216,1,,,,30041
ed660940aaa2ad3a37bb2713c515db775c3a7ed3,1,ababiichuk,2017-06-26 15:57:20+03:00,['4bfc6f13e578e1c2d257df2f4180769068edb1d8'],30,42,72,28025288,45,1,1,1,30041
12ae2591574c811311b24e2158261a0980548f68,0,Robert Levas,2017-06-26 09:57:20-04:00,"['fd3220099abd7e990dc18fa9ff9b2758554bb2cf', '23cc628f4827913869da4917a9bd7b9c0c1abf73']",32191,687,32878,28058166,79,,,,30041
a2464b9045637c1d5014db4aff7d83a0bc573fc0,1,Tim Thorpe,2017-06-26 07:58:15-07:00,['23cc628f4827913869da4917a9bd7b9c0c1abf73'],14,289,303,28058469,6,0.004950495,0.628712871,0.623762376,30041
6eaabc120a2604b3e15c41f77dd88da52b3f6dd0,0,Dmytro Sen,2017-06-26 19:52:14+03:00,['a2464b9045637c1d5014db4aff7d83a0bc573fc0'],1,20,21,28058490,3,0.916666667,0.916666667,1,30041
4522cf5a6a9389dbb7867938ce72cd2d734dc20d,0,Attila Doroszlai,2017-06-27 09:03:02+02:00,['6eaabc120a2604b3e15c41f77dd88da52b3f6dd0'],1028,0,1028,28059518,1,0.856767411,0,0.361366623,30041
08dd492e5fb801355be8e2dcd895d9cb09d3dd3c,0,Alex Antonenko,2017-06-27 11:05:14+03:00,['4522cf5a6a9389dbb7867938ce72cd2d734dc20d'],11,9,20,28059538,2,0,0,0,30041
9833bc182d9b44a69bb766de77311d4a3a50fa5e,0,Sandor Magyari,2017-06-27 11:15:03+02:00,['08dd492e5fb801355be8e2dcd895d9cb09d3dd3c'],1,11,12,28059550,1,0,0,0,30041
b1a154358078b02a4d84bbf865ff0209c1912e87,0,Venkata Sairam,2017-06-27 14:47:25+05:18,['9833bc182d9b44a69bb766de77311d4a3a50fa5e'],19,54,73,28059623,3,,,,30041
1e2959086fa2151888f7c1cfddaf3c6a2cedb25f,1,Venkata Sairam,2017-06-27 15:41:12+05:18,['b1a154358078b02a4d84bbf865ff0209c1912e87'],2,2,4,28059627,1,,,,30041
535660bb75efefd21692b0558dc7d74e420903f2,1,oleewere,2017-06-27 13:21:40+02:00,['1e2959086fa2151888f7c1cfddaf3c6a2cedb25f'],0,4,4,28059631,1,,,,30041
ebd79e989984ee1fd55ebe6cdb4e8469874bd8b7,1,Tim Thorpe,2017-06-27 04:53:36-07:00,['535660bb75efefd21692b0558dc7d74e420903f2'],289,14,303,28059934,6,0.995049505,0.371287129,0.376237624,30041
c1eeafbfebd089496153d5f3e3665e6a3302bd4a,1,Lisnichenko Dmitro,2017-06-27 15:57:41+03:00,['ebd79e989984ee1fd55ebe6cdb4e8469874bd8b7'],7,8,15,28059949,1,,,,30041
3529d053dae7381f098d6998280ab7f152e86843,0,Yusaku Sako,2017-06-27 10:19:26-07:00,['c1eeafbfebd089496153d5f3e3665e6a3302bd4a'],0,12,12,28059961,1,,,,30041
86347182a99209dcd767240ae475a03549acd989,0,Sangeeta Ravindran,2017-06-27 10:49:43-07:00,['3529d053dae7381f098d6998280ab7f152e86843'],2,20,22,28059983,2,1,1,1,30041
40e6352b0e704ca1af7b0e88a267b03bde5cea59,0,Vitaly Brodetskyi,2017-06-27 22:44:28+03:00,['86347182a99209dcd767240ae475a03549acd989'],10,85,95,28060078,7,0,0.66,1,30041
2f402505060354e8c71d24879c47a3850cc04009,1,Di Li,2017-06-27 15:56:53-04:00,['40e6352b0e704ca1af7b0e88a267b03bde5cea59'],2,9,11,28060089,1,0,0,1,30041
9aa786f7ea4c21159e6a014b4cbb6a6de155b22c,1,Mugdha Varadkar,2017-06-28 11:20:26+05:18,['2f402505060354e8c71d24879c47a3850cc04009'],36,165,201,28060290,9,0,0.626373626,0.626373626,30041
39efba35980642b832f79c6afb332716045d859f,0,Mugdha Varadkar,2017-06-28 13:20:37+05:18,['9aa786f7ea4c21159e6a014b4cbb6a6de155b22c'],3,2,5,28060295,2,,,,30041
4c1ea4c46c71bcae5d054eb7465283bca85cc9e8,1,Mugdha Varadkar,2017-06-28 13:46:10+05:18,['39efba35980642b832f79c6afb332716045d859f'],2,3,5,28060300,2,,,,30041
5e50042a78e4ddcb8e50bb28289ba67c50fb502c,1,Mugdha Varadkar,2017-06-28 13:48:01+05:18,['4c1ea4c46c71bcae5d054eb7465283bca85cc9e8'],3,2,5,28060305,2,,,,30041
aac9fe6e2e358b4ad1a1cfb0b86c3231897e38f1,0,Venkata Sairam,2017-06-28 14:44:09+05:18,['5e50042a78e4ddcb8e50bb28289ba67c50fb502c'],1,1,2,28060307,1,,,,30041
34462831450c3f592b3343940c2c623f9bb7489b,0,Sangeeta Ravindran,2017-06-28 09:16:48-07:00,['aac9fe6e2e358b4ad1a1cfb0b86c3231897e38f1'],4,4,8,28060315,4,,,,30041
a3681c0199f31511170770d454697206cbeeeda3,0,Sangeeta Ravindran,2017-06-28 09:29:57-07:00,['34462831450c3f592b3343940c2c623f9bb7489b'],0,68,68,28060383,3,1,1,1,30042
5c874ccb40b282e5074588906cb7de1f7eeae614,0,Attila Doroszlai,2017-06-28 18:31:49+02:00,['a3681c0199f31511170770d454697206cbeeeda3'],1,33,34,28060417,2,0,0,0.869565217,30042
f4fb1742b1ba29247da897f4ca1dd67a82a34c1b,0,Sangeeta Ravindran,2017-06-28 10:49:31-07:00,['5c874ccb40b282e5074588906cb7de1f7eeae614'],45,0,45,28060462,1,,,,30042
2f0de6919ba8bb43ae156d66b39335f9860d26b9,1,oleewere,2017-06-28 21:16:11+02:00,['f4fb1742b1ba29247da897f4ca1dd67a82a34c1b'],90,524,614,28061076,32,0.369649805,0.700389105,0.412451362,30042
9d224f73b68279bcec834a28c35dd76122d9e73d,0,Richard Zang,2017-06-28 13:50:38-07:00,['2f0de6919ba8bb43ae156d66b39335f9860d26b9'],1,2,3,28061079,1,0,1,0,30042
8b5c7db602a0e1e2dfb214ec1d51884c16219467,1,Attila Magyar,2017-06-29 11:05:25+02:00,['9d224f73b68279bcec834a28c35dd76122d9e73d'],38,894,932,28062011,17,0.571150097,0.994152047,0.559454191,30047
09e5d41c5d52339a0edea97886acf0fd38ee8a91,0,Attila Magyar,2017-06-29 12:14:54+02:00,['8b5c7db602a0e1e2dfb214ec1d51884c16219467'],0,17,17,28062028,1,,,,30047
4cd3150111560a43dd8028e6f14b2abf753e3d8b,0,Dmytro Grinenko,2017-06-29 15:17:29+03:00,['09e5d41c5d52339a0edea97886acf0fd38ee8a91'],20,25,45,28062073,2,1,1,1,30047
4d7cc7f392a6c4b52d39456504ad490d74fd019a,1,Jayush Luniya,2017-06-29 07:17:24-07:00,['4cd3150111560a43dd8028e6f14b2abf753e3d8b'],83,224,307,28062380,20,0.555555556,0.617283951,0.061728395,30047
aa7a8c657f07caa0be3db89d1e8146978d7d438c,0,Attila Doroszlai,2017-06-29 19:02:45+02:00,['4d7cc7f392a6c4b52d39456504ad490d74fd019a'],4,1,5,28062385,2,,,,30047
7554509f5ab1ddf262746ddab3c74f88c9f8154a,0,Andrew Onishuk,2017-06-29 20:44:11+03:00,['aa7a8c657f07caa0be3db89d1e8146978d7d438c'],0,1,1,28062386,1,0,0,0,30047
d7c59fca19770a8fb0e488371d2f460673f7e3d4,1,oleewere,2017-06-30 11:35:08+02:00,['7554509f5ab1ddf262746ddab3c74f88c9f8154a'],14,14,28,28062414,6,,,,30047
0945f28e65e7627b9a7f85c00027795f7c772b32,0,Robert Levas,2017-06-30 05:45:59-04:00,"['12ae2591574c811311b24e2158261a0980548f68', 'd7c59fca19770a8fb0e488371d2f460673f7e3d4']",1373,2159,3532,28065946,119,,,,30047
ae6b74f38885967bde2ec3c4eca911cadcdcb295,1,Andrew Onishuk,2017-06-30 14:51:42+03:00,['d7c59fca19770a8fb0e488371d2f460673f7e3d4'],33,10,43,28065989,4,,,,30047
b7edc6cf8db108aa5b703817870a8d077c2e7180,1,ababiichuk,2017-06-30 16:29:49+03:00,['ed660940aaa2ad3a37bb2713c515db775c3a7ed3'],194,658,852,28066841,34,0.962264151,1,1,30051
0b6679afc5c5852077d7b470b4e73585a3e6b1a7,0,ababiichuk,2017-06-30 16:35:46+03:00,"['b7edc6cf8db108aa5b703817870a8d077c2e7180', 'ae6b74f38885967bde2ec3c4eca911cadcdcb295']",219376,4047,223423,28290264,495,,,,30051
d0f12bff5eaeac764ec9ddf282d6e9e96001dc41,1,Nitiraj Singh Rathore,2017-06-30 19:15:28+05:18,['ae6b74f38885967bde2ec3c4eca911cadcdcb295'],2,2,4,28290268,1,,,,30051
9a17ca78d9c4e4e09123f1640b8f521f246a8b5f,0,lavjain,2017-06-30 12:34:45-07:00,['d0f12bff5eaeac764ec9ddf282d6e9e96001dc41'],0,25,25,28290293,1,,,,30051
979a07b5c82aa831405768019253e8292c9f771e,0,Venkata Sairam,2017-07-03 12:43:08+05:18,['9a17ca78d9c4e4e09123f1640b8f521f246a8b5f'],0,5,5,28290298,1,,,,30051
b5e40f9b22b30fdd21911cd7aef7ed2d09846de8,1,oleewere,2017-07-03 11:31:47+02:00,['979a07b5c82aa831405768019253e8292c9f771e'],104,943,1047,28291345,30,0.673267327,0.97029703,0.930693069,30056
8e9df940fcc045c7b22cc571cd58d0a1e82dd530,0,Eugene Chekanskiy,2017-07-03 13:15:56+03:00,['b5e40f9b22b30fdd21911cd7aef7ed2d09846de8'],16,1,17,28291362,2,1,0.333333333,0.666666667,30056
5f04b300ebcbc3d0c5ec4b38fe94710cbb7caed1,0,Attila Magyar,2017-07-03 13:21:11+02:00,['8e9df940fcc045c7b22cc571cd58d0a1e82dd530'],1,1,2,28291364,1,,,,30056
a740b50fd2866a317840f09859cc703ebdd4a26b,0,oleewere,2017-07-03 14:13:32+02:00,['5f04b300ebcbc3d0c5ec4b38fe94710cbb7caed1'],0,3,3,28291367,1,,,,30056
ec0d01fcb4c9cf839de24cfa8e9c7f611be24d6e,1,oleewere,2017-07-03 15:30:53+02:00,['a740b50fd2866a317840f09859cc703ebdd4a26b'],0,4,4,28291371,1,,,,30056
15342be3c1a30739f62402aeb6ad6c4a06ceb4f0,0,oleewere,2017-07-03 16:24:51+02:00,['ec0d01fcb4c9cf839de24cfa8e9c7f611be24d6e'],3,0,3,28291374,1,,,,30056
137ad20b0d055b9dff38674e6230450bf84a9305,0,Andrew Onishuk,2017-07-03 17:55:42+03:00,['15342be3c1a30739f62402aeb6ad6c4a06ceb4f0'],0,7,7,28291381,1,,,,30056
917898cdbed3bd37e1bbfa813b115f93dfb6dcaf,1,Andrew Onishuk,2017-07-04 11:29:31+03:00,['51b1a14d7318391572e9059f1e7615be12577199'],62,187,249,28291630,14,0.72,1,0.84,30059
aba2db1f5351296af8fae627a22858b907a1c90f,0,oleewere,2017-07-04 13:55:01+02:00,['137ad20b0d055b9dff38674e6230450bf84a9305'],4,7,11,28291641,3,,,,30059
8ba5c3e3ae582820828b345bb85da7aa935f637e,1,Miklos Gergely,2017-07-04 15:20:52+02:00,['aba2db1f5351296af8fae627a22858b907a1c90f'],189,485,674,28292315,5,1,1,0.481481481,30062
d4cd914367bf2e1716454d5dd5775ddb989f0382,1,Andrew Onishuk,2017-07-05 11:52:45+03:00,['917898cdbed3bd37e1bbfa813b115f93dfb6dcaf'],53,101,154,28292469,12,1,1,0.5625,30062
9a45ef6ceb51f5c1ddcc106a54ddb9ae256f2622,1,ababiichuk,2017-07-05 13:59:09+03:00,['0b6679afc5c5852077d7b470b4e73585a3e6b1a7'],153,301,454,28292923,39,0,1,0.625,30064
80cdcf251b8b36da73dee0dd126adecdded7e7d5,0,ababiichuk,2017-07-05 14:07:08+03:00,"['9a45ef6ceb51f5c1ddcc106a54ddb9ae256f2622', '8ba5c3e3ae582820828b345bb85da7aa935f637e']",316,1480,1796,28294719,45,,,,30064
29203a15d7ca0a6e65eca8e1d641f49974e55cb8,0,Andrew Onishuk,2017-07-05 14:25:48+03:00,['8ba5c3e3ae582820828b345bb85da7aa935f637e'],1,1,2,28294721,1,,,,30064
f2643679847f9123b3b522651987ef12f3e96aad,1,Andrii Tkach,2017-07-05 14:55:04+03:00,['d4cd914367bf2e1716454d5dd5775ddb989f0382'],27,166,193,28294914,15,0.807692308,1,1,30066
19d4200e719854b0d304e0d7be5e20f33cda46ff,1,Dmytro Grinenko,2017-07-05 16:16:49+03:00,['29203a15d7ca0a6e65eca8e1d641f49974e55cb8'],2,35,37,28294951,4,0.35,0.4,1,30066
9951e8fa36c16052463ab8802f366fa2da2ceaff,0,Robert Levas,2017-07-05 11:54:31-04:00,"['0945f28e65e7627b9a7f85c00027795f7c772b32', '19d4200e719854b0d304e0d7be5e20f33cda46ff']",351,1525,1876,28296827,53,,,,30066
3dc51b0c93bf13089dddd0f0f937b44d84f5017a,1,Mugdha Varadkar,2017-07-06 09:36:45+05:18,['19d4200e719854b0d304e0d7be5e20f33cda46ff'],2054,735,2789,28299616,67,1,0,0,30066
78ebbef3db12b1261d71db361bc480a374f62e92,1,Mugdha Varadkar,2017-07-06 10:32:50+05:18,['3dc51b0c93bf13089dddd0f0f937b44d84f5017a'],2,18,20,28299636,4,,,,30066
8d9fd451d5ad348d073d4adbe73970586ab71c37,1,Miklos Gergely,2017-07-06 10:17:52+02:00,['78ebbef3db12b1261d71db361bc480a374f62e92'],117,152,269,28299905,7,0.608695652,1,1,30066
5c9bdbfeff7b5b78adf4d840fbd93c504f129830,1,Miklos Gergely,2017-07-06 11:08:48+02:00,['8d9fd451d5ad348d073d4adbe73970586ab71c37'],238,398,636,28300541,33,0.85,0.7875,0,30066
e666e9b44c98b7d06b8cbe48d70b5e3c924302c7,0,Miklos Gergely,2017-07-06 12:12:05+02:00,['5c9bdbfeff7b5b78adf4d840fbd93c504f129830'],0,7,7,28300548,1,,,,30066
068f86a1c751a501acd78572a25c1d6e223e70e6,0,Dmytro Grinenko,2017-07-06 15:42:55+03:00,['e666e9b44c98b7d06b8cbe48d70b5e3c924302c7'],9,11,20,28300568,2,1,1,1,30066
406abf48d39b343294f6073c7097b734598394a7,0,Nate Cole,2017-07-06 09:09:43-04:00,"['43a867206432319fea28417b3687069cc4f9305d', '068f86a1c751a501acd78572a25c1d6e223e70e6']",224454,12386,236840,28537408,944,,,,30066
02fe5fa62e9561b17cdfd3876794faff884ccd05,0,Alex Antonenko,2017-07-06 16:25:05+03:00,['406abf48d39b343294f6073c7097b734598394a7'],11,9,20,28537428,2,0,0,0,30066
88cba7fbd1842c6e87eec010a00653bcedbfac65,0,Andrii Tkach,2017-07-06 18:10:22+03:00,['068f86a1c751a501acd78572a25c1d6e223e70e6'],9,60,69,28537497,4,1,1,0.811320755,30066
425606769e15589a9a51ab2fc89e56bbf158d638,0,Jayush Luniya,2017-07-06 12:33:47-07:00,['88cba7fbd1842c6e87eec010a00653bcedbfac65'],0,2,2,28537499,1,0,0,1,30066
8e719f79402c10d529d2006702148acb085bccfe,1,Miklos Gergely,2017-07-07 01:54:18+02:00,['425606769e15589a9a51ab2fc89e56bbf158d638'],20,19,39,28537538,1,,,,30066
f17d317b725012ccc687ee070b1e1dbc604e8d12,1,Alex Antonenko,2017-07-07 10:38:45+03:00,['8e719f79402c10d529d2006702148acb085bccfe'],4,4,8,28537546,2,0,0,0,30066
ac5eaae59673740a43b56b54978948e73cd71a54,1,Alex Antonenko,2017-07-07 10:38:45+03:00,['f17d317b725012ccc687ee070b1e1dbc604e8d12'],15,26,41,28537587,6,1,1,1,30066
7029e7fa0c3e2ebd8e6eea7eef1f965234018586,1,Alex Antonenko,2017-07-07 10:38:45+03:00,['ac5eaae59673740a43b56b54978948e73cd71a54'],12,15,27,28537614,3,1,1,1,30066
6832ed93a156b33178e62d6f8279faea8e414cba,0,Andrew Onishuk,2017-07-07 11:04:22+03:00,['7029e7fa0c3e2ebd8e6eea7eef1f965234018586'],1,2,3,28537617,1,,,,30066
1939dabcd7f6eeff3bb93e4d6f718b8a32351bd2,0,lpuskas,2017-07-07 11:23:12+02:00,['6832ed93a156b33178e62d6f8279faea8e414cba'],4,119,123,28537740,6,0.066666667,1,0.933333333,30066
e5c1b247efa133dcbfa04857ea10bb28f41cde04,0,Robert Levas,2017-07-07 07:17:15-04:00,"['9951e8fa36c16052463ab8802f366fa2da2ceaff', '6832ed93a156b33178e62d6f8279faea8e414cba']",2475,1443,3918,28541658,123,,,,30066
a795f38cd49c2c55c837b0daecaa63a67015d0eb,1,oleewere,2017-07-07 14:25:24+02:00,['1939dabcd7f6eeff3bb93e4d6f718b8a32351bd2'],180,836,1016,28542674,22,0.385416667,0.677083333,0.802083333,30067
063877e47763f1426cfc2ef734584ae4565e3a26,1,Andrew Onishuk,2017-07-07 16:56:17+03:00,['f2643679847f9123b3b522651987ef12f3e96aad'],80,297,377,28543051,11,0.379310345,0,1,30067
39e1922b23811943a25a4afdcba5021987aaee98,1,ababiichuk,2017-07-07 17:53:27+03:00,['80cdcf251b8b36da73dee0dd126adecdded7e7d5'],182,364,546,28543597,24,0,1,0,30070
e5ac65e0415aa9a2a4beee92b6e477ac8d50fb62,0,ababiichuk,2017-07-07 17:57:33+03:00,"['39e1922b23811943a25a4afdcba5021987aaee98', 'a795f38cd49c2c55c837b0daecaa63a67015d0eb']",2662,2434,5096,28548693,156,,,,30070
f33a250c0e7624b6cbc0a11ffce12506eaa95d9a,1,Jonathan Hurley,2017-07-07 23:00:23-04:00,['a795f38cd49c2c55c837b0daecaa63a67015d0eb'],3852,4353,8205,28556898,34,0.153110048,0.291866029,0.889952153,30070
d0f7a51537469740e5397486b1e2c19862c26c01,0,Attila Doroszlai,2017-07-09 12:16:54+02:00,['f33a250c0e7624b6cbc0a11ffce12506eaa95d9a'],1,1,2,28556900,1,,,,30070
7f3d3b21a961581678cb7c072ec71e5eb15d7da9,0,Andrew Onishuk,2017-07-10 12:58:10+03:00,['d0f7a51537469740e5397486b1e2c19862c26c01'],5,10,15,28556915,2,0,0,1,30070
3c9f125cc08269558f35a971c321777d331de1ca,0,"Toader, Sebastian",2017-07-10 13:02:45+02:00,['7f3d3b21a961581678cb7c072ec71e5eb15d7da9'],4,24,28,28556943,1,0,1,0,30070
c0201e2485009873ec1bb88772aee05ea1c06240,0,Alex Antonenko,2017-07-10 15:21:14+03:00,['02fe5fa62e9561b17cdfd3876794faff884ccd05'],1,1,2,28556945,1,,,,30070
c0882898deed4b6f0ecbd6f12cd935dc6b75cfdf,1,Miklos Gergely,2017-07-10 14:45:41+02:00,['3c9f125cc08269558f35a971c321777d331de1ca'],1,1,2,28556947,1,,,,30070
15dd999fff99fb80bc65ddfc94513e890a6efdef,1,Miklos Gergely,2017-07-10 14:51:23+02:00,['c0882898deed4b6f0ecbd6f12cd935dc6b75cfdf'],19,667,686,28557633,27,1,1,0.875,30075
2d5b75618c36a29792a312ba7c3ccdd01a454220,1,ababiichuk,2017-07-10 20:58:26+03:00,['e5ac65e0415aa9a2a4beee92b6e477ac8d50fb62'],178,542,720,28558353,32,0.520833333,1,1,30080
70cf77e4087840e89fab50a741d36bf8747ba416,1,Vitaly Brodetskyi,2017-07-10 23:19:34+03:00,['15dd999fff99fb80bc65ddfc94513e890a6efdef'],62,19,81,28558434,1,0.636363636,0.090909091,1,30080
07e50d869fd901fdd5c9a1c866ec2e566dbf4e4e,0,Robert Levas,2017-07-10 16:58:31-04:00,"['e5c1b247efa133dcbfa04857ea10bb28f41cde04', '70cf77e4087840e89fab50a741d36bf8747ba416']",4081,5983,10064,28568498,92,,,,30080
639f4523fdf49c8e0dddf79074cdb7eb4e43940c,0,Vitaly Brodetskyi,2017-07-11 00:55:59+03:00,['70cf77e4087840e89fab50a741d36bf8747ba416'],19,62,81,28568579,1,0.363636364,0.909090909,0,30080
d57bab51c7b7cdd5dd9abe6289e27eeaf21930fc,0,Robert Levas,2017-07-11 05:05:59-04:00,"['07e50d869fd901fdd5c9a1c866ec2e566dbf4e4e', '639f4523fdf49c8e0dddf79074cdb7eb4e43940c']",19,62,81,28568660,1,,,,30080
51e62ad578ab1f21a163c08c2bff6dec3fb24f7c,1,Andrew Onishuk,2017-07-11 13:24:19+03:00,['639f4523fdf49c8e0dddf79074cdb7eb4e43940c'],3,3,6,28568666,1,,,,30080
ca8e9eea70fc926e82dece26e49ae008262bde13,0,Robert Levas,2017-07-11 08:11:41-04:00,"['d57bab51c7b7cdd5dd9abe6289e27eeaf21930fc', '51e62ad578ab1f21a163c08c2bff6dec3fb24f7c']",3,3,6,28568672,1,,,,30080
880853a665dc07c68ec5f05975e01eba7bb561ee,1,Jonathan Hurley,2017-07-11 10:31:12-04:00,['51e62ad578ab1f21a163c08c2bff6dec3fb24f7c'],85,15,100,28568772,3,0.735849057,0.41509434,0,30080
0b397cdff959e04947fd6b15ada7a7c6a06aa55b,0,Aleksandr Kovalenko,2017-07-11 19:39:22+03:00,['880853a665dc07c68ec5f05975e01eba7bb561ee'],3,36,39,28568811,3,1,1,1,30080
709710915c93266f295fe9630e29480ff4648857,0,Robert Levas,2017-07-11 13:12:26-04:00,"['ca8e9eea70fc926e82dece26e49ae008262bde13', '0b397cdff959e04947fd6b15ada7a7c6a06aa55b']",88,51,139,28568950,6,,,,30080
e767aa44d872bab9ac0c416684f80b2b662347e5,1,Attila Magyar,2017-07-11 20:10:12+02:00,['0b397cdff959e04947fd6b15ada7a7c6a06aa55b'],136,520,656,28569606,18,0.736040609,1,0.675126904,30082
383b8c7d83545bc4cb21058794e91b5a4aece425,0,Miklos Gergely,2017-07-12 13:22:33+02:00,['e767aa44d872bab9ac0c416684f80b2b662347e5'],0,44,44,28569650,1,0,1,1,30083
31b9d7774b22f59a4d7120c9836c73a5216fd529,0,Vitaly Brodetskyi,2017-07-12 15:35:53+03:00,['383b8c7d83545bc4cb21058794e91b5a4aece425'],1,41,42,28569692,4,0,0.666666667,0.666666667,30084
9f788c386667bfeb82fff7c35287a5fdb175c349,1,Miklos Gergely,2017-07-12 16:55:48+02:00,['31b9d7774b22f59a4d7120c9836c73a5216fd529'],14,28,42,28569734,1,0,1,1,30084
650e23df8aaa464204b6e72b849b4da699cebd66,1,Andrew Onishuk,2017-07-12 18:48:16+03:00,['063877e47763f1426cfc2ef734584ae4565e3a26'],14,54,68,28569802,8,0.652173913,0,0.782608696,30084
eb3d3ea6e5eb9464a135f851658d4aa5b3988efa,1,Swapan Shridhar,2017-07-12 11:55:44-07:00,['9f788c386667bfeb82fff7c35287a5fdb175c349'],72,228,300,28570102,6,0,0,0,30085
7a0850b49577dea155ab76b4e7a13b3bb2d5291c,0,Robert Levas,2017-07-12 17:00:45-04:00,"['709710915c93266f295fe9630e29480ff4648857', 'eb3d3ea6e5eb9464a135f851658d4aa5b3988efa']",223,861,1084,28571186,29,,,,30085
f27f3affbb4c7f49944dcefc7581ac228b103e3f,1,Jonathan Hurley,2017-07-12 19:26:37-04:00,['eb3d3ea6e5eb9464a135f851658d4aa5b3988efa'],168,199,367,28571553,15,0,1,1,30085
eb1adcbff32fb9440f288ccaddc997297eb8e4fb,1,Sumit Mohanty,2017-07-12 16:30:49-07:00,['f27f3affbb4c7f49944dcefc7581ac228b103e3f'],0,2,2,28571555,2,,,,30085
853a5d4a2eda1afb5ee4578cf99d0757abc5f95d,1,Sumit Mohanty,2017-07-13 22:38:40-07:00,['eb1adcbff32fb9440f288ccaddc997297eb8e4fb'],69,105,174,28571729,3,0.357142857,1,1,30085
63186bf3eb1bf0501e0c2450f85467a0bc6adf12,0,Venkata Sairam,2017-07-14 12:23:52+05:18,['853a5d4a2eda1afb5ee4578cf99d0757abc5f95d'],1,1,2,28571731,1,,,,30085
3adbbadc3ecefee51a3bdc72ff6db1b0dbaa5a75,0,Robert Levas,2017-07-14 06:41:33-04:00,"['7a0850b49577dea155ab76b4e7a13b3bb2d5291c', '63186bf3eb1bf0501e0c2450f85467a0bc6adf12']",238,307,545,28572276,21,,,,30085
c9338e6186dcab80536e8edc48974329b9831100,1,ababiichuk,2017-07-14 15:21:38+03:00,['2d5b75618c36a29792a312ba7c3ccdd01a454220'],205,609,814,28573090,40,1,1,1,30094
0256fb7f76635d10d56020ae9bf30680795fe2fd,0,ababiichuk,2017-07-14 15:28:54+03:00,"['c9338e6186dcab80536e8edc48974329b9831100', '63186bf3eb1bf0501e0c2450f85467a0bc6adf12']",4411,6255,10666,28583756,117,,,,30094
f22256e73af4e4cb27d3aaf47ba58a8864e37873,1,"Toader, Sebastian",2017-07-14 16:04:17+02:00,['63186bf3eb1bf0501e0c2450f85467a0bc6adf12'],0,30,30,28583786,6,0,0,1,30094
f7fac03778fda337bc96ed49ed7507e1af118b7d,1,Robert Levas,2017-07-14 10:47:17-04:00,['f22256e73af4e4cb27d3aaf47ba58a8864e37873'],24,198,222,28584008,8,0.344827586,0.114942529,0.988505747,30095
9bfea6530bc9759f518fd616e15bb08244152ab1,0,Aravindan Vijayan,2017-07-14 09:47:47-07:00,['f7fac03778fda337bc96ed49ed7507e1af118b7d'],3,5,8,28584016,2,1,1,0,30095
4e1da58a9479889f1624e9887bb681a54e2ae6ae,1,Dmytro Grinenko,2017-07-14 20:26:52+03:00,['9bfea6530bc9759f518fd616e15bb08244152ab1'],379,391,770,28584786,3,,,,30095
0a8c397bd1944b8787befdff08bf6b95b9afb225,0,Robert Levas,2017-07-14 16:42:16-04:00,['4e1da58a9479889f1624e9887bb681a54e2ae6ae'],2,77,79,28584865,2,0,1,1,30095
c7f42285a2bd36a215b6c8988cfd7fd025461285,0,Sumit Mohanty,2017-07-14 15:44:25-07:00,['0a8c397bd1944b8787befdff08bf6b95b9afb225'],1,36,37,28584902,7,,,,30095
e799f52268db9330a84b1e982b3b88e591b04649,0,Swapan Shridhar,2017-07-14 22:27:56-07:00,['c7f42285a2bd36a215b6c8988cfd7fd025461285'],2,4,6,28584908,1,0,0,0,30095
f072dd2156e83d8a487ce0c3229c1ae22788c6be,1,oleewere,2017-07-15 19:04:53+02:00,['e799f52268db9330a84b1e982b3b88e591b04649'],0,167,167,28585075,3,,,,30096
56462b222f528fd076e64da608d67ea39dab4580,0,Attila Doroszlai,2017-07-15 20:54:32+02:00,['f072dd2156e83d8a487ce0c3229c1ae22788c6be'],2,2,4,28585079,1,,,,30096
f92d12193b30d53dc06ab9642ef4b9d61b5bac1c,1,Eugene Chekanskiy,2017-07-16 20:22:34+03:00,['56462b222f528fd076e64da608d67ea39dab4580'],133,392,525,28585604,11,0.225165563,0.536423841,0.61589404,30097
93fe8487a16fd2fe4f0c6a19bdc5d8a7c7b304a7,0,Attila Magyar,2017-07-17 10:19:38+02:00,['f92d12193b30d53dc06ab9642ef4b9d61b5bac1c'],49,571,620,28586224,8,0.870445344,1,0.785425101,30102
cc412e66156d5a887a725015537dcb75b0caf986,1,Dmytro Sen,2017-07-17 13:36:58+03:00,['93fe8487a16fd2fe4f0c6a19bdc5d8a7c7b304a7'],92,638,730,28586954,69,0,0.75625,0.775,30112
ba2a29fd1da5aa264e7873e306c9320e0d3b2a45,0,Andrii Tkach,2017-07-17 16:05:39+03:00,['cc412e66156d5a887a725015537dcb75b0caf986'],2,1,3,28586957,1,0,0,0,30112
e41dcd30df69ec7522332eb1f38e24d33d11c002,1,Andrew Onishuk,2017-07-17 16:52:58+03:00,['650e23df8aaa464204b6e72b849b4da699cebd66'],112,114,226,28587183,22,0,1,1,30112
01d60f4f8b8c32238ba840e109e7b7e8b9de1774,0,Alex Antonenko,2017-07-17 18:24:07+03:00,['ba2a29fd1da5aa264e7873e306c9320e0d3b2a45'],1,1,2,28587185,1,,,,30112
f450eba5c23c0d35ab9181d531d9e1ef84cbf3e8,1,Swapan Shridhar,2017-07-17 15:04:37-07:00,['01d60f4f8b8c32238ba840e109e7b7e8b9de1774'],152,1,153,28587338,2,,,,30112
274a9951c34721a867e8e541b4fa73bdf03aa5d0,1,Vitaly Brodetskyi,2017-07-18 17:14:10+03:00,['f450eba5c23c0d35ab9181d531d9e1ef84cbf3e8'],5,67,72,28587410,8,0.34,0.6,0.88,30112
016df4e9f795ff3b05e27dd49d8e81bd4e9dc28e,1,Swapan Shridhar,2017-07-18 15:24:23-07:00,['274a9951c34721a867e8e541b4fa73bdf03aa5d0'],10,8,18,28587428,3,1,1,1,30112
8de651738a8338e4744b0a2a661577b08ae01778,0,Sumit Mohanty,2017-07-18 22:07:22-07:00,['016df4e9f795ff3b05e27dd49d8e81bd4e9dc28e'],3,4,7,28587435,2,1,1,1,30113
56f05f099aae18d11f849266d14bccf36ae79ad0,0,Venkata Sairam,2017-07-19 14:15:31+05:18,['8de651738a8338e4744b0a2a661577b08ae01778'],0,1,1,28587436,1,0,0,1,30113
ba977e5a95a0a579507259ba2ea114594c5345b8,0,Aleksandr Kovalenko,2017-07-19 15:02:41+03:00,['56f05f099aae18d11f849266d14bccf36ae79ad0'],9,2,11,28587447,2,1,0,0,30113
9d6c7c81d143e41a4ab2592d13010a477a251659,1,Andrew Onishuk,2017-07-19 15:22:26+03:00,['e41dcd30df69ec7522332eb1f38e24d33d11c002'],478,476,954,28588401,119,,,,30113
903cd1a06c9016efeb3be29c7a323746960ab2e5,0,Robert Levas,2017-07-19 08:38:25-04:00,"['3adbbadc3ecefee51a3bdc72ff6db1b0dbaa5a75', '56f05f099aae18d11f849266d14bccf36ae79ad0']",860,2590,3450,28591851,135,,,,30113
317905e40e0b4b384809ad7d900a09d97827f599,1,Robert Levas,2017-07-19 08:41:36-04:00,['903cd1a06c9016efeb3be29c7a323746960ab2e5'],2534,9413,11947,28603798,46,0.403027436,0.550614948,0.76064333,30135
4b189a1131a387f1a74e45624af95525e984d30a,0,Sumit Mohanty,2017-07-19 07:15:05-07:00,['ba977e5a95a0a579507259ba2ea114594c5345b8'],0,0,0,28603798,1,,,,30135
30cd715793183e0c00ea7fdb900482cfcdc13a8a,0,Vitaly Brodetskyi,2017-07-19 17:19:11+03:00,['4b189a1131a387f1a74e45624af95525e984d30a'],2,30,32,28603830,2,0,0.772727273,0.772727273,30135
0a42f535447b8a09f57bac3fc354feebeb1750c8,0,Dmytro Sen,2017-07-19 18:38:00+03:00,['30cd715793183e0c00ea7fdb900482cfcdc13a8a'],3,13,16,28603846,2,1,1,0,30135
b55e4578e529f247ba878803742540320ae9d6e4,0,Jayush Luniya,2017-07-19 12:23:49-07:00,['0a42f535447b8a09f57bac3fc354feebeb1750c8'],2,37,39,28603885,3,0,0,0.28125,30135
da8165851c5e81433ba843375bfee25c794ef6a4,0,Swapan Shridhar,2017-07-19 14:57:40-07:00,['b55e4578e529f247ba878803742540320ae9d6e4'],1,1,2,28603887,1,,,,30135
6b4d0930ae2acf09c9933f35f7dcf007b6ee0f19,0,Jonathan Hurley,2017-07-19 20:16:47-04:00,['da8165851c5e81433ba843375bfee25c794ef6a4'],1,3,4,28603891,2,,,,30135
4fdca575bcf61e5d8d85a4ff6b7fc08d61dfb5e4,0,Jonathan Hurley,2017-07-19 20:30:27-04:00,['6b4d0930ae2acf09c9933f35f7dcf007b6ee0f19'],36,65,101,28603992,4,0,0.5,1,30135
587c42d79da4b384ab18d7078c6d045a807a7bb5,1,Miklos Gergely,2017-07-20 12:16:31+02:00,['4fdca575bcf61e5d8d85a4ff6b7fc08d61dfb5e4'],1,21,22,28604014,1,,,,30135
8c15965e090c1666702d08b860a796015c79f679,1,Andrew Onishuk,2017-07-20 13:27:40+03:00,['587c42d79da4b384ab18d7078c6d045a807a7bb5'],25,55,80,28604094,6,0.296296296,0.851851852,0.444444444,30135
d999343f97fe4a92625327b6f6e48c0c7c3f3ecf,0,Lisnichenko Dmitro,2017-07-20 13:35:19+03:00,['8c15965e090c1666702d08b860a796015c79f679'],0,1,1,28604095,1,1,1,1,30135
9c451107f316dbfcc45f99d536d2a6d4a4d99249,0,Andrew Onishuk,2017-07-20 16:21:20+03:00,['d999343f97fe4a92625327b6f6e48c0c7c3f3ecf'],13,8,21,28604116,2,1,1,0,30135
e87a3e31a9a18c5178f1170cef15c4de47f6808e,1,Jonathan Hurley,2017-07-20 17:15:21-04:00,['9c451107f316dbfcc45f99d536d2a6d4a4d99249'],45,174,219,28604335,8,0.259259259,1,0.962962963,30135
2a298a3f707c4a3702d0f70e927946540661c916,0,Alejandro Fernandez,2017-07-20 14:24:18-07:00,['e87a3e31a9a18c5178f1170cef15c4de47f6808e'],1,4,5,28604340,1,,,,30135
da21afc7d9019454f872cff09fe91e8889fca54d,1,Mugdha Varadkar,2017-07-21 12:36:50+05:18,['2a298a3f707c4a3702d0f70e927946540661c916'],32,1,33,28604373,1,0.041666667,0.625,0.625,30135
cfd7bb4cbe4b0af23d92dc64b81ec1cdedc4241d,1,Andrew Onishuk,2017-07-21 12:39:01+03:00,['da21afc7d9019454f872cff09fe91e8889fca54d'],2,46,48,28604421,1,0.25,0.25,0.142857143,30135
eca55998d38f6a8edbb156d84c6cc963c68e85a9,1,Sumit Mohanty,2017-07-21 12:10:28-07:00,['cfd7bb4cbe4b0af23d92dc64b81ec1cdedc4241d'],26,84,110,28604531,3,0,0.56,0,30135
d77bde7fde932529dca524bf7112dd64f5c56b4d,1,Jonathan Hurley,2017-07-21 23:44:39-04:00,['eca55998d38f6a8edbb156d84c6cc963c68e85a9'],149,349,498,28605029,24,0,0.974025974,1,30135
495a3f467edc4e19e9da76db10a1499e514c80a5,0,Sumit Mohanty,2017-07-22 18:10:42-07:00,['d77bde7fde932529dca524bf7112dd64f5c56b4d'],1,5,6,28605035,1,0,1,1,30135
95e7719b17d3672e86af13e07041ddbb902fc922,0,Jonathan Hurley,2017-07-22 22:40:12-04:00,['495a3f467edc4e19e9da76db10a1499e514c80a5'],22,35,57,28605092,9,0.6,0.6,1,30135
bfe772be2858dbf488aa940b0e513141fb018dc1,0,Attila Magyar,2017-07-24 14:55:50+02:00,['95e7719b17d3672e86af13e07041ddbb902fc922'],132,241,373,28605465,2,1,1,0.90990991,30135
f500c9e48d8b9ed7b3aebe547720da9dc9fc10e5,1,Lisnichenko Dmitro,2017-07-24 16:59:26+03:00,['bfe772be2858dbf488aa940b0e513141fb018dc1'],1,30,31,28605496,5,0.823529412,0.823529412,0.823529412,30135
6283ae4f688fbbe04cbb904d4469d3b0f9203335,0,Nate Cole,2017-07-24 11:23:33-04:00,"['c0201e2485009873ec1bb88772aee05ea1c06240', 'f500c9e48d8b9ed7b3aebe547720da9dc9fc10e5']",5823,10994,16817,28622313,345,,,,30135
81f3d20c1782e68c872bceaa8ab6c20e4a17daf3,1,Dmytro Sen,2017-07-24 19:51:36+03:00,['f500c9e48d8b9ed7b3aebe547720da9dc9fc10e5'],8,34,42,28622355,2,0,0.3,0,30135
04562def2aff000c412f5c179ec0e45591aab297,0,Andrew Onishuk,2017-07-24 20:58:38+03:00,['81f3d20c1782e68c872bceaa8ab6c20e4a17daf3'],1,1,2,28622357,1,,,,30135
cdefd5825b627aa7c64e5f565b4c19fa3b0db7d3,0,Nate Cole,2017-07-24 16:07:15-04:00,"['04562def2aff000c412f5c179ec0e45591aab297', '6283ae4f688fbbe04cbb904d4469d3b0f9203335']",357,594,951,28623308,38,,,,30135
a4ce7b86577d0c1a985d2018f7a1876fa6058009,1,Andrii Tkach,2017-07-25 12:44:21+03:00,['cdefd5825b627aa7c64e5f565b4c19fa3b0db7d3'],3,49,52,28623360,2,1,1,1,30135
54cdd41f529b080f07a7e838d6e786eef26b15b9,1,Andrii Tkach,2017-07-25 17:22:02+03:00,['a4ce7b86577d0c1a985d2018f7a1876fa6058009'],28,77,105,28623465,4,0.888888889,1,1,30135
d188fc3cd9db8be23942289cd67f3cbafb1685d0,1,Andrew Onishuk,2017-07-25 17:26:37+03:00,['9d6c7c81d143e41a4ab2592d13010a477a251659'],3,4,7,28623472,1,1,1,0,30135
6aca7feaca55929b64725e44a3bbf123d6adfcfb,0,Andrii Tkach,2017-07-25 17:42:21+03:00,['54cdd41f529b080f07a7e838d6e786eef26b15b9'],12,16,28,28623500,2,,,,30135
f58abd48173725abd1d68dd58d0348f7db6d5194,0,Dmytro Sen,2017-07-25 18:25:48+03:00,['6aca7feaca55929b64725e44a3bbf123d6adfcfb'],4,17,21,28623521,3,0,0.3,1,30135
a19cac7536e8e9f10d7a207559794c289d01485d,0,Andrii Tkach,2017-07-26 12:12:59+03:00,['f58abd48173725abd1d68dd58d0348f7db6d5194'],5,66,71,28623592,2,1,1,1,30135
6d0708bed6bf5233b556dd7955f4e49c2544c4e1,0,Andrii Tkach,2017-07-26 13:15:06+03:00,['a19cac7536e8e9f10d7a207559794c289d01485d'],2,11,13,28623605,2,0.111111111,0.111111111,1,30135
137f7f08b4de94d0d700c6e1652d6f7d6b6577ba,0,Attila Doroszlai,2017-07-26 18:59:09+02:00,['6d0708bed6bf5233b556dd7955f4e49c2544c4e1'],1,1,2,28623607,1,,,,30135
1e6e73f30e32e7e54519db4cb5ed034b984fd570,0,Jonathan Hurley,2017-07-26 16:45:04-04:00,['137f7f08b4de94d0d700c6e1652d6f7d6b6577ba'],1,5,6,28623613,2,0,1,1,30135
f55b115afe533faa7d41cff2c8b6c252ed6e498a,0,Robert Levas,2017-07-27 06:57:15-04:00,['1e6e73f30e32e7e54519db4cb5ed034b984fd570'],65,87,152,28623765,3,0,1,1,30135
9d605cd1845d528894c02d3d276002179780348f,1,Robert Levas,2017-07-27 07:00:30-04:00,['f55b115afe533faa7d41cff2c8b6c252ed6e498a'],87,65,152,28623917,3,1,0,0,30135
c516b3107860c0078d96ca29faca9396e8498b5a,0,Robert Levas,2017-07-27 07:00:56-04:00,['9d605cd1845d528894c02d3d276002179780348f'],65,122,187,28624104,4,0,1,1,30136
b1c67d97e23ded0de663fec066c1ec4e2fd1fbad,0,Lisnichenko Dmitro,2017-07-27 16:00:07+03:00,['c516b3107860c0078d96ca29faca9396e8498b5a'],0,17,17,28624121,2,1,1,0,30136
e3a50d9464479d59b5899eef6c7e0c80a2785bce,0,Jonathan Hurley,2017-07-27 10:18:01-04:00,['b1c67d97e23ded0de663fec066c1ec4e2fd1fbad'],0,7,7,28624128,1,1,1,1,30136
dc85e67d7d1f1287398824541c99b7f3872796a0,1,Miklos Gergely,2017-07-27 16:53:34+02:00,['e3a50d9464479d59b5899eef6c7e0c80a2785bce'],192,625,817,28624945,33,0.570652174,0.77173913,1,30140
e6983857be6fe1fdfd4c393fec27b08aa3e2ce45,1,"Toader, Sebastian",2017-07-27 17:31:13+02:00,['dc85e67d7d1f1287398824541c99b7f3872796a0'],17,100,117,28625062,4,0.4,1,0.6,30140
8ce722c82c4886862466cb897301633d146d1fce,1,Miklos Gergely,2017-07-27 19:12:42+02:00,['e6983857be6fe1fdfd4c393fec27b08aa3e2ce45'],26,4,30,28625092,1,1,0,0,30140
218829f93b87408f0f33637fce8caca5edaa9ac6,1,Eugene Chekanskiy,2017-07-27 20:13:53+03:00,['8ce722c82c4886862466cb897301633d146d1fce'],0,3,3,28625095,1,0,1,1,30140
ad593b4edba46f75e8b8c0afd8856abc7005aedc,1,Dmytro Sen,2017-07-27 20:15:15+03:00,['218829f93b87408f0f33637fce8caca5edaa9ac6'],34,73,107,28625202,2,0,1,1,30140
eb272515826f46620d1e24b1250605b614fe424d,1,Sumit Mohanty,2017-07-27 13:14:41-07:00,['ad593b4edba46f75e8b8c0afd8856abc7005aedc'],1,25,26,28625228,5,0,0,1,30140
ae1369742081df3b99cf3ef678b24afc20b062fb,1,Alejandro Fernandez,2017-07-27 15:06:38-07:00,['eb272515826f46620d1e24b1250605b614fe424d'],4,4,8,28625236,2,,,,30140
8d3570f8aba559741d4e45da425eda3613c8d405,0,Alejandro Fernandez,2017-07-27 15:16:25-07:00,['ae1369742081df3b99cf3ef678b24afc20b062fb'],5,5,10,28625246,2,,,,30140
4759196f37a1e83cc732c44f901b647280c6b8b5,1,Mugdha Varadkar,2017-07-28 12:46:34+05:18,['8d3570f8aba559741d4e45da425eda3613c8d405'],2,42,44,28625290,5,0,0.692307692,0.692307692,30140
0a14f07c842e8afd0c51359e1bfd9c8fe18d607f,1,Dmytro Sen,2017-07-28 12:13:13+03:00,['4759196f37a1e83cc732c44f901b647280c6b8b5'],1,5,6,28625296,1,0,1,1,30140
112885beffcc1e50d396651517b384387caae4e0,1,Miklos Gergely,2017-07-28 14:16:41+02:00,['0a14f07c842e8afd0c51359e1bfd9c8fe18d607f'],2,5,7,28625303,1,1,1,1,30140
d9c300bc1989ca42d38a01dff1e2c0a8be206ae0,1,Balazs Bence Sari,2017-07-28 14:38:29+02:00,['112885beffcc1e50d396651517b384387caae4e0'],16,106,122,28625425,9,0.232876712,0.890410959,0.917808219,30140
2bd4803c45588dbf7ba4f2483c72fcea1b3b6e50,1,Vitaly Brodetskyi,2017-07-28 17:45:10+03:00,['d9c300bc1989ca42d38a01dff1e2c0a8be206ae0'],16,402,418,28625843,27,0.450980392,1,0.656862745,30142
5a99ce77179a8c0ed3c34166798537901fea3f1e,0,Mugdha Varadkar,2017-07-28 20:14:36+05:18,['2bd4803c45588dbf7ba4f2483c72fcea1b3b6e50'],4,10,14,28625857,3,0,0.444444444,1,30142
3009a4aa10fc59bdd10c7b3db08b67cdde370110,1,Alex Antonenko,2017-07-28 19:03:31+03:00,['5a99ce77179a8c0ed3c34166798537901fea3f1e'],8,8,16,28625873,3,,,,30142
70baac3b42bf0cf3286cb5d926475d4f9de78d77,0,Sumit Mohanty,2017-07-28 17:29:43-07:00,['3009a4aa10fc59bdd10c7b3db08b67cdde370110'],3,3,6,28625879,1,,,,30142
4d7148a85ffb8f3c27ca70d79350823aaa563a2f,0,Andrew Onishuk,2017-07-31 15:33:16+03:00,['d188fc3cd9db8be23942289cd67f3cbafb1685d0'],0,22,22,28625901,2,1,1,1,30142
e0e882506437d83cda6b50861a4290afe09def17,1,Andrew Onishuk,2017-07-31 16:15:11+03:00,['4d7148a85ffb8f3c27ca70d79350823aaa563a2f'],14,43,57,28625958,4,0.260869565,1,0.695652174,30142
2bab2159ba9f17a0fcdefd20c8ab401c0042fdb9,1,Jonathan Hurley,2017-07-31 12:12:06-04:00,['70baac3b42bf0cf3286cb5d926475d4f9de78d77'],702,2436,3138,28629096,186,0,0,0,30144
c7b350b678b82bae1c0834744249cb534fed18f1,1,Aravindan Vijayan,2017-07-31 14:30:27-07:00,['2bab2159ba9f17a0fcdefd20c8ab401c0042fdb9'],10,32,42,28629138,1,0,0,1,30144
11aadf532f3ecdfcfed727346ea4f3418aa1deb2,1,Andrew Onishuk,2017-08-01 12:45:49+03:00,['c7b350b678b82bae1c0834744249cb534fed18f1'],3,30,33,28629171,3,0,0,0,30144
0eee38e7cd612cb6d57352b32074beed9b115b39,0,Attila Doroszlai,2017-08-01 14:22:37+02:00,['11aadf532f3ecdfcfed727346ea4f3418aa1deb2'],21,31,52,28629223,2,0,1,1,30144
3ac9f5590ab60c105de806cbb5ca875fc43ee13f,0,Andrii Tkach,2017-08-01 16:45:16+03:00,['0eee38e7cd612cb6d57352b32074beed9b115b39'],4,3,7,28629230,2,1,1,1,30144
ed08865c4da057fc5e051da5375ad7ca5c494203,1,Miklos Gergely,2017-08-02 06:11:23+02:00,['3ac9f5590ab60c105de806cbb5ca875fc43ee13f'],45,44,89,28629319,8,1,0,1,30144
c4a474a5c4912bec226b56c62c80b6d77ebb497b,1,ababiichuk,2017-08-02 12:16:54+03:00,['ed08865c4da057fc5e051da5375ad7ca5c494203'],2,72,74,28629393,2,0.540540541,1,1,30144
0a9f6fa943e07164be0166981d0d65814068d34e,1,Nate Cole,2017-08-02 07:57:22-04:00,['c4a474a5c4912bec226b56c62c80b6d77ebb497b'],75,482,557,28629950,13,0,0.640776699,1,30145
97ccf3bff96f8717c185776c7c000496df90daa0,1,Jonathan Hurley,2017-08-02 08:45:31-04:00,['0a9f6fa943e07164be0166981d0d65814068d34e'],1108,548,1656,28631606,171,0.854237288,0,0.408474576,30145
ea57a6bab346eb18eeb538bd86ac580ff7f07afc,0,Jonathan Hurley,2017-08-02 11:41:55-04:00,['97ccf3bff96f8717c185776c7c000496df90daa0'],11,9,20,28631626,4,1,1,0,30145
9e91639ba3579e3f0d9e74b8c9c42990ef59b553,0,Nate Cole,2017-08-02 15:40:10-04:00,['ea57a6bab346eb18eeb538bd86ac580ff7f07afc'],4,255,259,28631885,2,0,0.869565217,0.881987578,30145
b17225df413ee0f6e562769963df864c69a02821,1,Andrii Tkach,2017-08-03 11:35:30+03:00,['9e91639ba3579e3f0d9e74b8c9c42990ef59b553'],3,56,59,28631944,4,1,0.727272727,1,30145
a45e8f4f5e6a214cab98896092bc7d7d588a518b,1,Attila Magyar,2017-08-03 12:01:04+02:00,['b17225df413ee0f6e562769963df864c69a02821'],15,290,305,28632249,13,0.56,0.893333333,0.753333333,30146
4a122a220d28da86da7cafdf89d00b5c09ae4193,1,Dmytro Sen,2017-08-03 14:46:51+03:00,['a45e8f4f5e6a214cab98896092bc7d7d588a518b'],7,7,14,28632263,7,,,,30146
db83ccd8224289e80ca2da5dc95c613ccbaf2492,1,Andrew Onishuk,2017-08-03 14:48:20+03:00,['e0e882506437d83cda6b50861a4290afe09def17'],11,14,25,28632288,2,1,1,1,30146
44c1cb51236886bbb968946b6718cbac64d1a984,1,Myroslav Papirkovskyi,2017-08-03 19:06:41+03:00,['db83ccd8224289e80ca2da5dc95c613ccbaf2492'],947,4192,5139,28637427,110,0.790233838,0.613480055,0.731086657,30169
07d6ec308dd2d54c0af720a181759391ffc22192,0,Aravindan Vijayan,2017-08-03 09:40:48-07:00,['4a122a220d28da86da7cafdf89d00b5c09ae4193'],11,41,52,28637479,2,0.5,0,1,30169
66410e5e9a977142756c0189d4582f101a8808af,1,Nate Cole,2017-08-03 12:54:07-04:00,['07d6ec308dd2d54c0af720a181759391ffc22192'],22,222,244,28637723,11,0.157303371,0.438202247,0.93258427,30170
b487b450ac9ff00a3be3b61a1399b710aa21a5d6,1,Jonathan Hurley,2017-08-03 13:37:53-04:00,['66410e5e9a977142756c0189d4582f101a8808af'],53,60,113,28637836,25,0,0,1,30170
a5b8045dfbc7e8c30fc8b0d23d38ef86243c016a,0,Mugdha Varadkar,2017-08-04 11:28:15+05:18,['b487b450ac9ff00a3be3b61a1399b710aa21a5d6'],0,6,6,28637842,1,0,0,1,30170
98f15c94ee73c7d7ef938108772d3495e1d13e43,0,"Toader, Sebastian",2017-08-04 10:04:51+02:00,['a5b8045dfbc7e8c30fc8b0d23d38ef86243c016a'],1,1,2,28637844,1,,,,30170
27386c3d9eae250a72f3b23308c752e5e32765c1,1,Miklos Gergely,2017-08-04 11:03:51+02:00,['98f15c94ee73c7d7ef938108772d3495e1d13e43'],462,575,1037,28638881,17,1,0.986666667,1,30171
2d1ac668b6ae272481668d08f4b7bd1c1b99fc45,1,Miklos Gergely,2017-08-04 11:27:57+02:00,['27386c3d9eae250a72f3b23308c752e5e32765c1'],531,824,1355,28640236,23,1,0.983050847,1,30177
4cd96576ed5cab53a271b4892d548002c33fb2e7,1,ababiichuk,2017-08-04 15:05:39+03:00,['2d1ac668b6ae272481668d08f4b7bd1c1b99fc45'],156,182,338,28640574,6,1,1,1,30177
e89e9505b1d509eda027cfe8bd7784976c6c0434,1,Jonathan Hurley,2017-08-04 10:01:04-04:00,['4cd96576ed5cab53a271b4892d548002c33fb2e7'],8,208,216,28640790,4,0,0.795454545,0.977272727,30178
2258b10639d510f879953b41dc4709b9e12ed05a,1,Attila Magyar,2017-08-04 16:09:32+02:00,['e89e9505b1d509eda027cfe8bd7784976c6c0434'],646,25,671,28641461,26,0.622580645,0.390322581,0.170967742,30178
b175d8f697c8690e719c8a3f8dbcd20df073d2a6,0,ababiichuk,2017-08-04 18:12:04+03:00,['2258b10639d510f879953b41dc4709b9e12ed05a'],1,1,2,28641463,1,,,,30178
aa9e16d8928b95c555a1e5b966fe1cf86c15cf82,0,Sumit Mohanty,2017-08-04 15:11:22-07:00,['b175d8f697c8690e719c8a3f8dbcd20df073d2a6'],1,1,2,28641465,1,,,,30178
afa1b488c1118b7f54da97cd611a317c3d385a3a,1,Miklos Gergely,2017-08-06 14:23:46+02:00,['aa9e16d8928b95c555a1e5b966fe1cf86c15cf82'],4,2,6,28641471,5,0,0,0,30178
58827ad307f68e2db6f649987a4feae7885944d5,1,Andrii Tkach,2017-08-07 14:40:57+03:00,['afa1b488c1118b7f54da97cd611a317c3d385a3a'],0,69,69,28641540,1,0.511627907,1,1,30178
153e03aa024ffa483ad2f905151f1dcb8911b520,0,Andrii Tkach,2017-08-07 17:24:41+03:00,['58827ad307f68e2db6f649987a4feae7885944d5'],3,13,16,28641556,2,0,0.545454545,0.909090909,30178
f01c32ed4c9e7ef0068aec741de5371e280ebccb,1,Nate Cole,2017-08-07 11:11:48-04:00,['153e03aa024ffa483ad2f905151f1dcb8911b520'],36,371,407,28641963,9,0.375,0.692307692,0.971153846,30181
555f241cf0cf4e8830ce78f069ecca152802410f,1,oleewere,2017-08-07 21:28:42+02:00,['f01c32ed4c9e7ef0068aec741de5371e280ebccb'],2178,1015,3193,28645156,57,0.698818898,0.496062992,0,30188
7a90a260497fccafcefaca209bd9bbd1f07a948a,1,Siddharth Wagle,2017-08-07 15:57:36-07:00,['555f241cf0cf4e8830ce78f069ecca152802410f'],5,18,23,28645179,2,,,,30188
e88b61e6c7831a569876dcbac524fbe2b465c967,1,Alejandro Fernandez,2017-08-07 17:10:05-07:00,['7a90a260497fccafcefaca209bd9bbd1f07a948a'],0,12,12,28645191,1,,,,30188
6578b5a28516e8afa66c2f302cfe7abfdbc31472,1,Andrew Onishuk,2017-08-08 12:11:28+03:00,['44c1cb51236886bbb968946b6718cbac64d1a984'],68,2902,2970,28648161,19,1,1,0.777777778,30191
cfec01d69ffedfef23890c09b540e596a229bded,1,Andrew Onishuk,2017-08-08 12:48:32+03:00,['6578b5a28516e8afa66c2f302cfe7abfdbc31472'],34,36,70,28648231,5,0,0,1,30191
2d69fc7e043c47fb115bee03c55792f5e575e597,0,Andrii Tkach,2017-08-08 14:06:46+03:00,['e88b61e6c7831a569876dcbac524fbe2b465c967'],1,1,2,28648233,1,,,,30191
3155a43e591499e9501ee3b2f6e5f095a9883177,0,Jonathan Hurley,2017-08-08 10:11:53-04:00,['2d69fc7e043c47fb115bee03c55792f5e575e597'],77,309,386,28648619,2,0,0.897727273,1,30191
4dee0f0e838265d124dd3066b27760acb57c4cb5,0,Jonathan Hurley,2017-08-08 10:21:23-04:00,['3155a43e591499e9501ee3b2f6e5f095a9883177'],1,1,2,28648621,1,,,,30191
64cae8e0e17d146ebc1d9f85b13b0ba137f2484b,0,Dmytro Sen,2017-08-08 18:36:16+03:00,['4dee0f0e838265d124dd3066b27760acb57c4cb5'],7,12,19,28648640,3,0,1,0,30191
ea2c432fcff5807b3cffc5cb94e0764cb8f94aa7,1,Alejandro Fernandez,2017-08-08 13:41:28-07:00,['64cae8e0e17d146ebc1d9f85b13b0ba137f2484b'],3,3,6,28648646,1,,,,30191
5442231e4e8e517f1e47f4c177cbe5799e8f96b8,0,Swapan Shridhar,2017-08-08 16:14:31-07:00,['ea2c432fcff5807b3cffc5cb94e0764cb8f94aa7'],0,19,19,28648665,2,0,0,1,30191
c9ced876800a36ba09959370d17a228f31d1018d,0,Andrii Tkach,2017-08-09 16:16:08+03:00,['5442231e4e8e517f1e47f4c177cbe5799e8f96b8'],1,1,2,28648667,1,,,,30191
b23464936abad71f07e632ab6b0472b60a9ab0e3,1,Nate Cole,2017-08-09 11:12:15-04:00,['c9ced876800a36ba09959370d17a228f31d1018d'],13,217,230,28648897,6,0.298076923,0.865384615,0.932692308,30191
78778ad5709ccee4cd4171fbe358373ed88e4fca,0,Nate Cole,2017-08-09 11:55:40-04:00,['b23464936abad71f07e632ab6b0472b60a9ab0e3'],1,3,4,28648901,1,0,1,1,30191
b4de62079ae9c0533f85b34d7d49589e62119759,0,Swapan Shridhar,2017-08-09 10:32:40-07:00,['78778ad5709ccee4cd4171fbe358373ed88e4fca'],19,0,19,28648920,2,1,1,0,30191
108ad9b4a0d154abcfff9e4fe5fd965ae81d62e5,1,Jonathan Hurley,2017-08-09 14:01:29-04:00,['b4de62079ae9c0533f85b34d7d49589e62119759'],901,1960,2861,28651781,64,0.703862661,0.987124464,1,30193
3136abed153856c1672e502d71a407abe211828f,1,Siddharth Wagle,2017-08-09 15:49:15-07:00,['108ad9b4a0d154abcfff9e4fe5fd965ae81d62e5'],1,25,26,28651807,2,0.272727273,0.272727273,1,30193
655c3c6aa1ece4b16e2bc6ae6bcee3061252747d,1,Siddharth Wagle,2017-08-09 20:07:24-07:00,['3136abed153856c1672e502d71a407abe211828f'],14,13,27,28651834,3,1,0,0,30193
1433ecff108df159f71961e23a34d248e1684c85,0,Attila Doroszlai,2017-08-10 11:56:16+02:00,['655c3c6aa1ece4b16e2bc6ae6bcee3061252747d'],2,2,4,28651838,1,,,,30193
af5f5d23d29f97344cb44085d649a702d02f1882,1,ababiichuk,2017-08-10 13:22:25+03:00,['0256fb7f76635d10d56020ae9bf30680795fe2fd'],236,1161,1397,28653235,23,1,1,0.747572816,30202
f50c17b985e25fcb0559741e2c34423aaf79e60b,0,ababiichuk,2017-08-10 13:26:29+03:00,"['af5f5d23d29f97344cb44085d649a702d02f1882', '1433ecff108df159f71961e23a34d248e1684c85']",8812,16204,25016,28678251,727,,,,30202
7a3ffea9e4236c2ad58b05ff7af8a31691c96ce6,1,Nate Cole,2017-08-10 07:42:00-04:00,['1433ecff108df159f71961e23a34d248e1684c85'],23,238,261,28678512,4,0.116788321,0.832116788,0.919708029,30202
8895386bcc7b122788ae2af42031ff0e786c7733,0,Attila Doroszlai,2017-08-10 16:50:45+02:00,['7a3ffea9e4236c2ad58b05ff7af8a31691c96ce6'],1,3,4,28678516,1,,,,30202
64a3926fb430a128fbda63a3477f8330e2562c58,1,Siddharth Wagle,2017-08-10 08:52:02-07:00,['8895386bcc7b122788ae2af42031ff0e786c7733'],2,8,10,28678526,2,,,,30202
d2ac184c3de509d2fb6f6b46f6f0119b4f1a121d,0,Siddharth Wagle,2017-08-10 09:49:14-07:00,['64a3926fb430a128fbda63a3477f8330e2562c58'],1,1,2,28678528,1,,,,30202
24d8802d6369244a666044397ff29c3775a44dcd,0,"Toader, Sebastian",2017-08-10 21:48:09+02:00,['d2ac184c3de509d2fb6f6b46f6f0119b4f1a121d'],2,2,4,28678532,2,,,,30202
d0168787ed617b381b0a41c0e72abfbcc7f4c859,0,Aravindan Vijayan,2017-08-10 16:32:51-07:00,['24d8802d6369244a666044397ff29c3775a44dcd'],1,1,2,28678534,1,,,,30202
86c7f92c31fda6b89eb7c9389072a94abe35d917,1,Vitaly Brodetskyi,2017-08-11 03:04:36+03:00,['d0168787ed617b381b0a41c0e72abfbcc7f4c859'],1,7,8,28678542,1,0,0,0,30202
faf5d90799deee6509b1398f762616219e241f68,1,Mugdha Varadkar,2017-08-11 10:12:42+05:18,['86c7f92c31fda6b89eb7c9389072a94abe35d917'],6,27,33,28678575,8,,,,30202
10b1efbc40b5d7dcd3d26e153f8e17125be747e8,1,Dmytro Sen,2017-08-11 13:36:46+03:00,['faf5d90799deee6509b1398f762616219e241f68'],73,20,93,28678668,8,0,0,0,30202
bc6cbf3596247c79c6a2aad9047ebe6a2d1cf27b,1,Aravindan Vijayan,2017-08-11 12:03:54-07:00,['10b1efbc40b5d7dcd3d26e153f8e17125be747e8'],5,64,69,28678737,5,0,0,1,30202
d9c271ae61c285e3b4e066616f057d857797fec9,0,Sumit Mohanty,2017-08-11 16:36:41-07:00,['bc6cbf3596247c79c6a2aad9047ebe6a2d1cf27b'],1,1,2,28678739,1,,,,30202
4e3f7ebe06b146c5e676e3a81f1f159f26e74252,0,Attila Doroszlai,2017-08-14 09:20:47+02:00,['d9c271ae61c285e3b4e066616f057d857797fec9'],1,3,4,28678743,2,0,1,1,30202
f134cee07e9685a5a86fe73162b9a00bf60a9fef,0,Attila Doroszlai,2017-08-14 13:04:10+02:00,['4e3f7ebe06b146c5e676e3a81f1f159f26e74252'],8,4,12,28678755,1,1,0,0,30202
57b79f937af5d046ef420b8dc839fad92a24c64a,1,Andrew Onishuk,2017-08-14 14:24:30+03:00,['cfec01d69ffedfef23890c09b540e596a229bded'],57,114,171,28678926,9,1,1,1,30202
f206e95711ab3d117cfc26587c9d09c52c86c16f,1,Nate Cole,2017-08-14 15:25:11-04:00,['f134cee07e9685a5a86fe73162b9a00bf60a9fef'],250,163,413,28679339,9,0.675675676,1,0.972972973,30202
12b6caad612b6389aeef256b5bbbaae6d65cc588,1,Dmytro Grinenko,2017-08-15 14:51:21+03:00,['f206e95711ab3d117cfc26587c9d09c52c86c16f'],7,9,16,28679355,3,1,0,1,30202
c802a29814e9911b337c1dbb8804839575b0a838,0,Nate Cole,2017-08-15 08:35:17-04:00,['12b6caad612b6389aeef256b5bbbaae6d65cc588'],10,122,132,28679487,2,0,1,0.708860759,30202
f4bb14c19cc943c7a46dc5cc336851cc54d9592c,1,ababiichuk,2017-08-15 17:21:49+03:00,['f50c17b985e25fcb0559741e2c34423aaf79e60b'],71,790,861,28680348,27,0.388888889,0.694444444,0.847222222,30207
309ba3b4016dfd769e0fcd242d261d93e04cd3b4,0,ababiichuk,2017-08-15 17:27:46+03:00,"['f4bb14c19cc943c7a46dc5cc336851cc54d9592c', 'c802a29814e9911b337c1dbb8804839575b0a838']",392,673,1065,28681413,50,,,,30207
01bcae93a7c9dc0f05301ddd8fed73c83d660a1b,0,ababiichuk,2017-08-15 17:33:18+03:00,['309ba3b4016dfd769e0fcd242d261d93e04cd3b4'],33,33,66,28681479,33,,,,30207
78793366447c59db8c6deac3c1ce3b69da8ed268,1,Aravindan Vijayan,2017-08-15 14:27:13-07:00,['c802a29814e9911b337c1dbb8804839575b0a838'],1,1,2,28681481,1,,,,30207
ab8d58ba4464791b95b56be75fd44ce9c20349c6,1,Attila Doroszlai,2017-08-16 10:42:11+02:00,['78793366447c59db8c6deac3c1ce3b69da8ed268'],1791,1690,3481,28684962,353,1,0.425,0.2,30207
9b9402e9305a879f83a0d0182c70b73e166a68e8,0,Andrew Onishuk,2017-08-16 12:00:00+03:00,['57b79f937af5d046ef420b8dc839fad92a24c64a'],25,16,41,28685003,11,,,,30207
5c78bd752aa5a064966ecee9fcee374cf12eb7a8,1,Dmytro Sen,2017-08-16 12:34:02+03:00,['ab8d58ba4464791b95b56be75fd44ce9c20349c6'],15,4880,4895,28689898,11,0.211111111,0.533333333,0,30211
a9774d6648474911716d9abc278272437ba56d11,1,Andrew Onishuk,2017-08-16 13:36:34+03:00,['9b9402e9305a879f83a0d0182c70b73e166a68e8'],5,74,79,28689977,8,0.3,0.5,0.933333333,30212
fc8dd78e145c45db1128b49f66be5aa1919b852f,1,Dmytro Grinenko,2017-08-16 14:34:29+03:00,['5c78bd752aa5a064966ecee9fcee374cf12eb7a8'],4,4,8,28689985,1,,,,30212
f2379a4468de071c3fc1dea2de58f53e4a86913f,0,Andrii Tkach,2017-08-16 15:39:10+03:00,['fc8dd78e145c45db1128b49f66be5aa1919b852f'],0,14,14,28689999,3,0.75,0.75,1,30212
12c05880d4a5fa13f37b58f537bebb292a064d20,1,Eugene Chekanskiy,2017-08-16 19:15:26+03:00,['f2379a4468de071c3fc1dea2de58f53e4a86913f'],5,48,53,28690052,4,0.230769231,0.038461538,1,30212
330a61cdbe34f97559359c67c5039623d9fc6e69,1,Jonathan Hurley,2017-08-16 13:26:44-04:00,['12c05880d4a5fa13f37b58f537bebb292a064d20'],1013,1578,2591,28692643,73,0.479087452,1,0.74904943,30216
3f6c4ca0731d45ca0a23a5d6a4cfa2e47c85ea37,1,Dmytro Grinenko,2017-08-17 12:58:40+03:00,['330a61cdbe34f97559359c67c5039623d9fc6e69'],1669,2006,3675,28696318,18,1,0,0.945945946,30216
b00da9b5e9e5a178b1c91af1c6a6855b42cbbf3a,1,ababiichuk,2017-08-17 13:11:00+03:00,['01bcae93a7c9dc0f05301ddd8fed73c83d660a1b'],71,203,274,28696592,23,0.104166667,1,0.958333333,30216
6f103543447da87cc1d9b334783c192865efa8c8,0,ababiichuk,2017-08-17 13:17:24+03:00,"['b00da9b5e9e5a178b1c91af1c6a6855b42cbbf3a', '3f6c4ca0731d45ca0a23a5d6a4cfa2e47c85ea37']",4486,10209,14695,28711287,458,,,,30216
8c5b03b6e51b0fd2db8a237c60d24673cc66a1cd,0,Andrii Tkach,2017-08-17 17:42:31+03:00,['3f6c4ca0731d45ca0a23a5d6a4cfa2e47c85ea37'],3,0,3,28711290,1,0,0,0,30216
f2cc609b0033d59130cb00d14ff8d2c8db6e1392,0,Lisnichenko Dmitro,2017-08-17 18:05:12+03:00,['8c5b03b6e51b0fd2db8a237c60d24673cc66a1cd'],0,1,1,28711291,1,1,1,0,30216
320b0e0c62497e46bb6b2a976d18b01636eb622b,1,ababiichuk,2017-08-17 18:34:16+03:00,['6f103543447da87cc1d9b334783c192865efa8c8'],6,242,248,28711539,2,0.027272727,0.813636364,1,30217
b428fb9be84af73e5931d6d81908c3372b711420,0,Jonathan Hurley,2017-08-17 11:40:20-04:00,['f2cc609b0033d59130cb00d14ff8d2c8db6e1392'],26,27,53,28711592,11,0,0,1,30217
f3c1039269c61ca43b35374f65aa1eff78a27c60,1,ababiichuk,2017-08-17 19:52:44+03:00,['320b0e0c62497e46bb6b2a976d18b01636eb622b'],2,8,10,28711602,3,,,,30217
7fb94cb814050534571e375c7ce368b080decc3c,1,Andrew Onishuk,2017-08-18 10:54:33+03:00,['a9774d6648474911716d9abc278272437ba56d11'],81,482,563,28712165,12,0.447368421,1,0.815789474,30222
9a08bce35082f7e9ada7022c9e6bbf1b769348c4,0,Andrii Tkach,2017-08-18 12:14:53+03:00,['b428fb9be84af73e5931d6d81908c3372b711420'],2,6,8,28712173,1,1,1,1,30222
7ffda34d6120c65c2a546f0208c1d495e52aa666,0,Andrii Tkach,2017-08-18 13:52:21+03:00,['9a08bce35082f7e9ada7022c9e6bbf1b769348c4'],4,8,12,28712185,1,1,1,1,30222
09fed274ba869e7fb38a91d2795d54f08c132ca5,0,Vitaly Brodetskyi,2017-08-18 14:21:56+03:00,['7ffda34d6120c65c2a546f0208c1d495e52aa666'],650,131,781,28712966,6,0,0.849557522,0,30222
1dba7786f7bb8f99251fd5c74a3ddeb0bf2fb118,0,Andrew Onishuk,2017-08-18 16:40:56+03:00,['09fed274ba869e7fb38a91d2795d54f08c132ca5'],2,2,4,28712970,1,1,1,0,30222
5f6ce4ea53bcaaec35040c08600d606d7d194460,0,Sandor Magyari,2017-08-18 15:45:14+02:00,['1dba7786f7bb8f99251fd5c74a3ddeb0bf2fb118'],135,13,148,28713118,3,0.909090909,0.454545455,0,30222
ca8ae51afeff209657c19182d77e59a34cf6c0ae,0,Lisnichenko Dmitro,2017-08-18 18:16:12+03:00,['5f6ce4ea53bcaaec35040c08600d606d7d194460'],1,0,1,28713119,1,0,0,1,30222
bbec0d3751b9aad709d8fbf86c2744b4bb412e2d,0,Swapan Shridhar,2017-08-18 14:10:55-07:00,['ca8ae51afeff209657c19182d77e59a34cf6c0ae'],8,41,49,28713168,3,0.333333333,0,1,30222
b0f21da12b6266191fc0669d4dc69ff945a9b785,0,Swapan Shridhar,2017-08-18 14:56:00-07:00,['bbec0d3751b9aad709d8fbf86c2744b4bb412e2d'],41,8,49,28713217,3,0.666666667,1,0,30222
e99f8e86fd41ccf88a1c50b6cf603f03b9006bc6,1,Swapan Shridhar,2017-08-18 14:56:42-07:00,['b0f21da12b6266191fc0669d4dc69ff945a9b785'],8,41,49,28713266,3,0.333333333,0,1,30222
79ff23fac2aa08f151781565a59fcbf80061b9f0,1,Swapan Shridhar,2017-08-18 15:06:29-07:00,['e99f8e86fd41ccf88a1c50b6cf603f03b9006bc6'],16,371,387,28713653,8,0.01,0.61,0.62,30222
a0ae01d883eaaecb4542e990389ea9483c63eac9,1,Dmytro Grinenko,2017-08-19 05:47:22+03:00,['79ff23fac2aa08f151781565a59fcbf80061b9f0'],29,3,32,28713685,1,1,1,0,30222
705a62be23e9388e602319056b83d86282b520c9,0,Nate Cole,2017-08-19 08:04:00-04:00,['a0ae01d883eaaecb4542e990389ea9483c63eac9'],0,2,2,28713687,1,,,,30222
6fb371957ad5612e3a6b2c639dec559aacf5a15d,1,Venkata Sairam,2017-08-21 13:51:58+05:18,['705a62be23e9388e602319056b83d86282b520c9'],0,6,6,28713693,1,,,,30222
13589bbdf9c22f91740519ef63fcfbf9c2aacc4b,0,Vitaly Brodetskyi,2017-08-21 14:21:45+03:00,['6fb371957ad5612e3a6b2c639dec559aacf5a15d'],2,105,107,28713800,1,0,1,1,30222
3cefb74cdae3a836ee1896a30dca713e44b95f98,0,Attila Magyar,2017-08-21 13:37:28+02:00,['317905e40e0b4b384809ad7d900a09d97827f599'],6,123,129,28713929,13,0.741935484,0.838709677,0.983870968,30223
f901e15bac6728215ab5adea54775565bb8bdd46,0,Andrii Tkach,2017-08-21 15:17:50+03:00,['13589bbdf9c22f91740519ef63fcfbf9c2aacc4b'],6,78,84,28714013,4,0.753846154,1,0.953846154,30223
28a42236a1dfc924fed73edfaf4ea6d896f16f02,1,Jonathan Hurley,2017-08-21 09:31:10-04:00,['f901e15bac6728215ab5adea54775565bb8bdd46'],14,29,43,28714056,5,0,0,0.777777778,30223
15aa0375e8c79bbaab237a28c1f0b78275f551f6,1,Nate Cole,2017-08-21 13:01:34-04:00,['28a42236a1dfc924fed73edfaf4ea6d896f16f02'],46,418,464,28714520,18,0.237623762,0.574257426,0.702970297,30228
d69084461998ad33c233bb33734b7935681df086,1,Jaimin Jetly,2017-08-21 12:14:13-07:00,['15aa0375e8c79bbaab237a28c1f0b78275f551f6'],26,69,95,28714615,3,0.526315789,0.184210526,1,30228
5895040c8a3374012c11f0e351c8ba631a689ae7,0,Vitaly Brodetskyi,2017-08-21 23:57:12+03:00,['d69084461998ad33c233bb33734b7935681df086'],6,13,19,28714634,1,0,0,0,30228
c129baa1f6e4438b7af9e7a01735d8ead05df1be,1,Robert Levas,2017-08-21 17:00:52-04:00,['5895040c8a3374012c11f0e351c8ba631a689ae7'],18,1545,1563,28716197,14,0.01141925,0.874388254,0.888254486,30229
8e33d8864aa0d1cb5be00241be5900d9fa9310dd,1,Sumit Mohanty,2017-08-21 14:01:19-07:00,['c129baa1f6e4438b7af9e7a01735d8ead05df1be'],0,53,53,28716250,2,,,,30229
d5904b9a956026b9a0dcb9d5acfd6af22d3dcb67,1,Aravindan Vijayan,2017-08-21 14:05:10-07:00,['8e33d8864aa0d1cb5be00241be5900d9fa9310dd'],1,4,5,28716255,2,,,,30229
6de8094a45c536340b56d73d4b0116c68349096c,0,Dmytro Grinenko,2017-08-22 06:14:31+03:00,['d5904b9a956026b9a0dcb9d5acfd6af22d3dcb67'],7,20,27,28716282,2,1,1,1,30229
d260c89263ee0471514b4cfb8ce938134eceea12,1,Eric Yang,2017-08-21 20:57:34-07:00,['6de8094a45c536340b56d73d4b0116c68349096c'],14,360,374,28716656,11,0.535911602,0.624309392,0.541436464,30231
194e391cbfe811075664481d9a9f13e62cc83413,1,Andrew Onishuk,2017-08-22 13:37:15+03:00,['7fb94cb814050534571e375c7ce368b080decc3c'],54,61,115,28716771,15,0,0,0,30231
8dfdf5ec275849597884508ad1bc1b5846d007cf,0,Venkata Sairam,2017-08-22 16:36:39+05:18,['d260c89263ee0471514b4cfb8ce938134eceea12'],9,2,11,28716782,2,,,,30231
6f9f87c663e1d5bd7cef5078e2a222700873c195,0,Venkata Sairam,2017-08-22 16:49:24+05:18,['8dfdf5ec275849597884508ad1bc1b5846d007cf'],1,6,7,28716789,1,,,,30231
d2e0c42a1d6f67ade14e867d069d73b2567d685b,0,Jonathan Hurley,2017-08-22 11:34:06-04:00,['6f9f87c663e1d5bd7cef5078e2a222700873c195'],1,38,39,28716828,4,0.9375,0.9375,1,30231
dee7317e000879313da9d7a08614331daae57e3a,1,Lisnichenko Dmitro,2017-08-22 19:26:30+03:00,['d2e0c42a1d6f67ade14e867d069d73b2567d685b'],170,1212,1382,28718210,15,0.474609375,0.7734375,0.580078125,30233
01a3bc7af63178af3032d868d80794fda0a0185e,1,ababiichuk,2017-08-22 20:46:01+03:00,['f3c1039269c61ca43b35374f65aa1eff78a27c60'],40,539,579,28718789,26,1,0.971428571,0.99047619,30243
0e5bf39010f5cb6258d91526e6cf5bc58295110a,0,ababiichuk,2017-08-22 20:49:15+03:00,"['01a3bc7af63178af3032d868d80794fda0a0185e', 'dee7317e000879313da9d7a08614331daae57e3a']",1196,4562,5758,28724547,110,,,,30243
18b44d414f8f5b0e2e47092312473be58848d5d3,0,Attila Doroszlai,2017-08-22 21:44:24+02:00,['dee7317e000879313da9d7a08614331daae57e3a'],6,0,6,28724553,1,,,,30243
d804f4451fcd9bb0692d3ec5754ba407c1f83784,0,Andrew Onishuk,2017-08-23 11:45:21+03:00,['18b44d414f8f5b0e2e47092312473be58848d5d3'],1,6,7,28724560,2,0.2,1,1,30243
0a2eccd09aa7ec6bc4389603a2668f27d2d79900,0,Venkata Sairam,2017-08-23 15:47:02+05:18,['d804f4451fcd9bb0692d3ec5754ba407c1f83784'],9,34,43,28724603,3,0,0,0.285714286,30243
b155c1a770fad1c268166be0bd5f34f589319d83,1,Eugene Chekanskiy,2017-08-23 15:48:29+03:00,['0a2eccd09aa7ec6bc4389603a2668f27d2d79900'],1,86,87,28724690,4,0.166666667,0.958333333,0.958333333,30243
2e5139ab162865eecb173f9d73760979a5e32b00,0,Sumit Mohanty,2017-08-23 07:51:38-07:00,['b155c1a770fad1c268166be0bd5f34f589319d83'],8,22,30,28724720,5,,,,30243
54513bf0fc4a08552b326f9d4482c1bcd350ee7b,1,Madhuvanthi Radhakrishnan,2017-08-23 13:19:22-07:00,['2e5139ab162865eecb173f9d73760979a5e32b00'],2,43,45,28724765,8,0.75,0.916666667,1,30243
65ddaed63e427d404f90d74afaea8537ce5cb51c,1,oleewere,2017-08-24 11:58:48+02:00,['54513bf0fc4a08552b326f9d4482c1bcd350ee7b'],1,1,2,28724767,1,,,,30243
60632536aa6fbcee96580c24d6e2d7f67dd184fa,0,Robert Levas,2017-08-24 09:06:06-04:00,['65ddaed63e427d404f90d74afaea8537ce5cb51c'],15,129,144,28724911,2,0,0.419354839,1,30243
76f0dafbd561f3052bc0d90045fcfdcba93beb3a,0,Jonathan Hurley,2017-08-24 12:38:02-04:00,['60632536aa6fbcee96580c24d6e2d7f67dd184fa'],3,5,8,28724919,2,0,0,0,30243
b96c77a8f9dfd021aa4a0b2f825dc2e270f79050,1,Swapan Shridhar,2017-08-24 12:13:21-07:00,['76f0dafbd561f3052bc0d90045fcfdcba93beb3a'],194,602,796,28725715,23,0.303797468,1,0.974683544,30252
f5f9a7581df7e4eb880f3da7f6248a29d332b3b7,0,Jaimin Jetly,2017-08-24 12:59:39-07:00,['b96c77a8f9dfd021aa4a0b2f825dc2e270f79050'],4,9,13,28725728,1,1,1,1,30252
4bce57823da7d972df9e422e3f920ebbc60362f3,1,Robert Levas,2017-08-24 17:01:12-04:00,['f5f9a7581df7e4eb880f3da7f6248a29d332b3b7'],716,1780,2496,28728224,45,0.077702703,0.185810811,0.631756757,30255
b290ce068a14b153449840f00ba809ee256c22e2,1,Aravindan Vijayan,2017-08-24 15:28:25-07:00,['4bce57823da7d972df9e422e3f920ebbc60362f3'],1,13,14,28728238,1,0,1,0.1,30255
787fe0f7e56cd56d3daf5e40e56647f06b3fe890,1,Sumit Mohanty,2017-08-24 16:55:14-07:00,['b290ce068a14b153449840f00ba809ee256c22e2'],9,173,182,28728420,2,,,,30255
68b95cf818fb0d0f24d6e66873ab081e9165048d,0,Gaurav Nagar,2017-08-25 12:10:37+05:18,['787fe0f7e56cd56d3daf5e40e56647f06b3fe890'],1,9,10,28728430,2,,,,30255
f7d10f437535aebcef05cbbbe458fb7e8264ade5,1,oleewere,2017-08-25 12:30:53+02:00,['68b95cf818fb0d0f24d6e66873ab081e9165048d'],3,259,262,28728692,12,0.441860465,0.441860465,1,30260
8b133e499ebf9b1596ac835a1250ff8c4e904b0e,1,Jonathan Hurley,2017-08-25 08:55:47-04:00,['f7d10f437535aebcef05cbbbe458fb7e8264ade5'],7,77,84,28728776,10,0.75,0.857142857,1,30260
733c78b9da84d72c847ed54515c99425ac4ca6b6,1,Nate Cole,2017-08-25 10:51:52-04:00,['8b133e499ebf9b1596ac835a1250ff8c4e904b0e'],6,217,223,28728999,3,0,1,1,30260
8e64bac3e767f09adbc69526c3552a6f23dcfbfb,1,Andrii Tkach,2017-08-25 18:35:06+03:00,['733c78b9da84d72c847ed54515c99425ac4ca6b6'],29,37,66,28729065,9,1,0.235294118,1,30260
f59305e387b561f7903b4ec6e1729b300021af54,1,Andrii Tkach,2017-08-25 18:39:26+03:00,['8e64bac3e767f09adbc69526c3552a6f23dcfbfb'],5,67,72,28729137,5,1,1,1,30261
eb9cce7e01f3ed3ea910f32bec0a241e56c82c20,1,Andrii Tkach,2017-08-25 18:44:03+03:00,['f59305e387b561f7903b4ec6e1729b300021af54'],14,29,43,28729180,6,0.777777778,0.777777778,1,30261
698293d2d70d19f833e064dcb9c2c1775ce36d50,1,Dmytro Grinenko,2017-08-25 19:31:02+03:00,['eb9cce7e01f3ed3ea910f32bec0a241e56c82c20'],18,48,66,28729246,9,0.235294118,0.235294118,0.470588235,30261
ca5fd78778345d74d885cd547c44917cf0feb03f,1,Vitaly Brodetskyi,2017-08-25 22:54:13+03:00,['698293d2d70d19f833e064dcb9c2c1775ce36d50'],15,62,77,28729323,11,0.366666667,1,1,30261
e399cb4a9d3169f40eb98c1bd193597ca75f05ba,0,Sumit Mohanty,2017-08-25 14:00:45-07:00,['ca5fd78778345d74d885cd547c44917cf0feb03f'],0,11,11,28729334,1,,,,30261
cad25398cadc94e19cbdc4e7751d6030a4e733e3,1,Andrii Tkach,2017-08-28 12:44:09+03:00,['e399cb4a9d3169f40eb98c1bd193597ca75f05ba'],1,2,3,28729337,1,,,,30261
8f0bcc0197a5aee36aa0a38b8e8b16dbda1182f0,1,Andrii Tkach,2017-08-28 13:03:00+03:00,['cad25398cadc94e19cbdc4e7751d6030a4e733e3'],4,273,277,28729614,13,0.8125,0.9921875,1,30262
6b5232088c87d07eaa8b740d12a35c3d1b171590,1,Andrii Tkach,2017-08-28 13:10:39+03:00,['8f0bcc0197a5aee36aa0a38b8e8b16dbda1182f0'],40,86,126,28729740,6,1,1,0.763157895,30262
b4f0c5abe323f93aab29c814b1a05d9368342a2e,0,Andrii Tkach,2017-08-28 13:14:30+03:00,['6b5232088c87d07eaa8b740d12a35c3d1b171590'],28,33,61,28729801,2,,,,30262
2a57959f5b8ddaa545dba1b5496f82902fa0e75c,0,Andrii Tkach,2017-08-28 13:17:24+03:00,['b4f0c5abe323f93aab29c814b1a05d9368342a2e'],1,23,24,28729825,3,1,1,1,30262
be5fbff6e4d68c26feca188eaad1e7a0d3aaebf2,1,oleewere,2017-08-28 13:57:03+02:00,['0e5bf39010f5cb6258d91526e6cf5bc58295110a'],1,6,7,28729832,1,,,,30262
1fcf4a7590d72617524132de7abae94adf5b4f9e,1,Andrew Onishuk,2017-08-28 16:12:52+03:00,['194e391cbfe811075664481d9a9f13e62cc83413'],7,7,14,28729846,2,,,,30262
21e590b811bac086d045add4e0dd3334f72240bc,0,Andrew Onishuk,2017-08-28 16:23:42+03:00,['1fcf4a7590d72617524132de7abae94adf5b4f9e'],9,9,18,28729864,8,,,,30262
0bd85d754512f220be307b0baa6e7f26d208d45a,1,Alex Antonenko,2017-08-28 16:53:25+03:00,['2a57959f5b8ddaa545dba1b5496f82902fa0e75c'],3,32,35,28729899,4,1,1,1,30262
91155b152625cafb296b62961cf70c6f3fb6d72c,1,Alex Antonenko,2017-08-28 17:11:31+03:00,['0bd85d754512f220be307b0baa6e7f26d208d45a'],1,3,4,28729903,2,1,1,1,30262
2d56dcb6c06cce42e5f50427a51c551f7dc667a1,1,Attila Magyar,2017-08-29 09:33:07+02:00,['91155b152625cafb296b62961cf70c6f3fb6d72c'],14,10,24,28729927,1,0,1,0,30262
5388ae6d10eb84dd90174223668284690b665b0b,1,Andrii Tkach,2017-08-29 12:30:51+03:00,['2d56dcb6c06cce42e5f50427a51c551f7dc667a1'],37,186,223,28730150,9,0.661016949,0.983050847,1,30262
41656481b231244b9bfe86ba24a6a3f258b9d17d,1,Eugene Chekanskiy,2017-08-29 15:46:35+03:00,['5388ae6d10eb84dd90174223668284690b665b0b'],0,1710,1710,28731860,12,0.452196382,0.38501292,0.759689922,30274
e16da830042e1fea011733da45b24fe6648ee7c2,1,Nate Cole,2017-08-29 09:25:05-04:00,['41656481b231244b9bfe86ba24a6a3f258b9d17d'],5,129,134,28731994,2,0,0.901234568,1,30274
ff3a095bc98c7abff4b706e780c9b31d7519fa8e,0,Andrii Tkach,2017-08-29 17:11:14+03:00,['e16da830042e1fea011733da45b24fe6648ee7c2'],2,3,5,28731999,1,,,,30274
6f713da58b2ddf4c9a988648503df99293dde477,0,Dmytro Grinenko,2017-08-29 17:25:45+03:00,['ff3a095bc98c7abff4b706e780c9b31d7519fa8e'],0,1,1,28732000,1,0,0,0,30274
00479043de7cacd82aae571ff89e1364fcc13623,1,Aleksandr Kovalenko,2017-08-29 18:54:06+03:00,['6f713da58b2ddf4c9a988648503df99293dde477'],1,1,2,28732002,1,,,,30274
5f1b98589c68e0dcc069372a1b25b83506d5f120,1,ababiichuk,2017-08-29 19:09:58+03:00,['be5fbff6e4d68c26feca188eaad1e7a0d3aaebf2'],229,846,1075,28733077,35,0.361256545,1,0.340314136,30282
b300f504c4e39b5eff1df85255b238517f1d6f49,1,Jonathan Hurley,2017-08-29 12:54:39-04:00,['00479043de7cacd82aae571ff89e1364fcc13623'],1,221,222,28733299,2,0.083969466,0.870229008,1,30283
6848c8f4f1a162cbc99b632a4285fc5b579bab40,1,Sumit Mohanty,2017-08-29 15:38:18-07:00,['b300f504c4e39b5eff1df85255b238517f1d6f49'],34,9,43,28733342,3,1,1,0.714285714,30283
5c3c6280d1905231abca47689e46c38216c1e909,0,Aravindan Vijayan,2017-08-29 15:48:24-07:00,['6848c8f4f1a162cbc99b632a4285fc5b579bab40'],3,9,12,28733354,4,,,,30283
1c506ff7da1dc1763bc24a7665077cf920b4a2bc,0,Vitaly Brodetskyi,2017-08-30 02:21:05+03:00,['5c3c6280d1905231abca47689e46c38216c1e909'],7,7,14,28733368,1,,,,30283
0ee7e07502e4ec336433af1d48925373299b16bd,0,GitHub,2017-08-30 13:50:33+12:00,['1c506ff7da1dc1763bc24a7665077cf920b4a2bc'],4,4,8,28733376,1,,,,30283
ae80b6e7c6027ed90e27c94922e4faa9ed0dca9e,0,Gaurav Nagar,2017-08-30 11:09:01+05:18,['1c506ff7da1dc1763bc24a7665077cf920b4a2bc'],3,15,18,28733394,2,,,,30283
6b052390c3398c6f7fa1a706c3802ce7adf28cb9,1,Gaurav Nagar,2017-08-30 11:11:31+05:18,['ae80b6e7c6027ed90e27c94922e4faa9ed0dca9e'],1,40,41,28733435,4,0.846153846,0.846153846,1,30283
58c6848a78e0ce59e79d4f6924c8ceb925ccee91,0,Gaurav Nagar,2017-08-30 11:24:57+05:18,['6b052390c3398c6f7fa1a706c3802ce7adf28cb9'],40,1,41,28733476,4,0.153846154,0.153846154,0,30283
4b04a325eea0f7fa0193a375a10bb168546aa63d,0,Gaurav Nagar,2017-08-30 11:25:48+05:18,['58c6848a78e0ce59e79d4f6924c8ceb925ccee91'],1,41,42,28733518,4,0.785714286,0.785714286,0.857142857,30283
138caea7bed0e35cb2ad1d83ef53d2b982210171,1,Alex Antonenko,2017-08-30 12:19:25+03:00,['4b04a325eea0f7fa0193a375a10bb168546aa63d'],13,150,163,28733681,4,1,1,1,30284
418be516334aaebf0d83f8c074fef9fec4a2c2e3,1,Alex Antonenko,2017-08-30 12:30:03+03:00,['138caea7bed0e35cb2ad1d83ef53d2b982210171'],4,25,29,28733710,8,0,0,1,30284
4238781810d8c8236626b204a39353f1f33e8e49,1,Andrii Tkach,2017-08-30 12:46:50+03:00,['418be516334aaebf0d83f8c074fef9fec4a2c2e3'],74,354,428,28734138,2,0.833333333,1,1,30284
5e399daeb36615a3434785ebe8afefd2e506f41f,1,Lisnichenko Dmitro,2017-08-30 14:00:12+03:00,['4238781810d8c8236626b204a39353f1f33e8e49'],17,16,33,28734171,2,1,,,30284
45105787b118df2549ab1a99fea38776401ce173,0,ababiichuk,2017-08-30 14:13:23+03:00,"['5e399daeb36615a3434785ebe8afefd2e506f41f', '5f1b98589c68e0dcc069372a1b25b83506d5f120']",1,23363,23364,28757535,163,,,,30284
a92d868b7f1e1bf4415e40db08e120f98d40a6f3,1,Alex Antonenko,2017-08-30 14:14:31+03:00,['5e399daeb36615a3434785ebe8afefd2e506f41f'],19,37,56,28757591,14,0.833333333,0,0.75,30284
d22a671170fa3da68ca284db46c9f9c37321bfed,0,ababiichuk,2017-08-30 15:16:46+03:00,"['45105787b118df2549ab1a99fea38776401ce173', 'a92d868b7f1e1bf4415e40db08e120f98d40a6f3']",19,37,56,28757647,14,,,,30284
960373587b8ace28277ef15edcdda72d9b62f71f,1,Jonathan Hurley,2017-08-30 10:21:36-04:00,['d22a671170fa3da68ca284db46c9f9c37321bfed'],1,41,42,28757689,2,0.05,0.05,1,30284
3f08324907e70a4b6d09cd4d6aa0d35c9dfbb9e3,0,Aleksandr Kovalenko,2017-08-30 18:03:40+03:00,['960373587b8ace28277ef15edcdda72d9b62f71f'],5,28,33,28757722,5,0.5,1,1,30284
eef7b7308e33a9da3639611d2e4d47e52f25671c,0,Swapan Shridhar,2017-08-30 12:31:29-07:00,['3f08324907e70a4b6d09cd4d6aa0d35c9dfbb9e3'],0,0,0,28757722,4,,,,30284
d4ba96481c76487bc1fdd7fbde8392bc97c3226d,0,Swapan Shridhar,2017-08-30 12:38:46-07:00,['eef7b7308e33a9da3639611d2e4d47e52f25671c'],6,0,6,28757728,2,1,0,0,30284
ec0f3f7c0616cbd09cef7014b39b4178034f02b6,1,Swapan Shridhar,2017-08-30 12:49:38-07:00,['d4ba96481c76487bc1fdd7fbde8392bc97c3226d'],0,23,23,28757751,1,,,,30284
528ad8fee4cc9b8ec9a7f4302f21eba5836a1b5b,0,Swapan Shridhar,2017-08-30 12:54:55-07:00,['ec0f3f7c0616cbd09cef7014b39b4178034f02b6'],1,1,2,28757753,1,,,,30284
7758a5147e641f9e0f7aff0938cdc30361026e0f,0,Swapan Shridhar,2017-08-30 13:16:47-07:00,['528ad8fee4cc9b8ec9a7f4302f21eba5836a1b5b'],0,18,18,28757771,1,,,,30284
2fc74535d79e4f677233f6caf12166bc7f837c2a,1,Alex Antonenko,2017-08-31 11:56:35+03:00,['7758a5147e641f9e0f7aff0938cdc30361026e0f'],0,21,21,28757792,3,0.952380952,1,1,30284
9f1331a7dfc8d7f38ea1cc872afb68ccf84dbc48,0,Dmytro Sen,2017-08-31 12:31:43+03:00,['2fc74535d79e4f677233f6caf12166bc7f837c2a'],6,9,15,28757807,1,,,,30284
12c22edb569cfa1bba59dc2720c6fc25c1ea4b44,1,oleewere,2017-08-31 12:21:01+02:00,['9f1331a7dfc8d7f38ea1cc872afb68ccf84dbc48'],0,172,172,28757979,2,,,,30285
d1d6df9030efa316fa6ccc227ed3148899a7760c,0,Andrii Tkach,2017-08-31 14:09:28+03:00,['12c22edb569cfa1bba59dc2720c6fc25c1ea4b44'],38,22,60,28758039,9,0,0,0,30285
a66c01d3d0873598851fa8016788525fcbb53c16,0,Alex Antonenko,2017-08-31 15:20:59+03:00,['d1d6df9030efa316fa6ccc227ed3148899a7760c'],8,2,10,28758049,2,0,0,0,30285
ff23a2e325cdf42c9736be29ded262831f1c2a68,0,Alex Antonenko,2017-08-31 16:25:09+03:00,['a66c01d3d0873598851fa8016788525fcbb53c16'],1,1,2,28758051,1,,,,30285
638fc708c81a61db3fc5a870c7c55b0e3d8232b3,1,Alex Antonenko,2017-08-31 16:59:51+03:00,['ff23a2e325cdf42c9736be29ded262831f1c2a68'],14,87,101,28758152,7,1,1,1,30285
3fd40043f1b68e9b29d046cfc8b3285d4ef7ee35,0,Aleksandr Kovalenko,2017-08-31 18:05:20+03:00,['638fc708c81a61db3fc5a870c7c55b0e3d8232b3'],9,58,67,28758219,2,0.692307692,1,1,30285
84ab2eb406159609ea10c7279d7f268163ecf527,1,Alex Antonenko,2017-08-31 19:04:39+03:00,['3fd40043f1b68e9b29d046cfc8b3285d4ef7ee35'],112,216,328,28758547,7,0.515151515,1,0.666666667,30285
e20c06400bd175a72b54374f7548daf342839f69,1,Andrew Onishuk,2017-09-01 14:44:51+03:00,['84ab2eb406159609ea10c7279d7f268163ecf527'],1,10,11,28758558,2,0.333333333,0.333333333,1,30285
5230d93545c30ab06d49f9cbac25974b1462f914,1,Robert Levas,2017-09-01 12:31:23-04:00,['e20c06400bd175a72b54374f7548daf342839f69'],76,2920,2996,28761554,13,0.244755245,0.60979021,0.593006993,30290
7e222173b74a8d8c5e69e9cbbd3bae05c67aca1f,0,Alex Antonenko,2017-09-04 11:52:17+03:00,['5230d93545c30ab06d49f9cbac25974b1462f914'],18,19,37,28761591,2,1,1,1,30290
a679281f7abe6768e0896e32df7c298b59877064,1,Venkata Sairam,2017-09-04 14:33:22+05:18,['7e222173b74a8d8c5e69e9cbbd3bae05c67aca1f'],10,55,65,28761656,4,0,0.903225806,0.903225806,30290
18a16cbe476a7cad89fdd2605e114d8919a175ea,0,Alex Antonenko,2017-09-04 13:55:48+03:00,['a679281f7abe6768e0896e32df7c298b59877064'],2,14,16,28761672,3,0.2,0,1,30290
c51540dee89d90bb488c2b1a1269ae7d40d5d509,0,Eugene Chekanskiy,2017-09-04 14:53:51+03:00,['18a16cbe476a7cad89fdd2605e114d8919a175ea'],3,7,10,28761682,2,0,0,1,30290
c091ebe8afa1d83384d5607fb4ee52eb018772b0,1,Lisnichenko Dmitro,2017-09-04 19:33:11+03:00,['c51540dee89d90bb488c2b1a1269ae7d40d5d509'],3,136,139,28761821,2,0,1,0.743902439,30290
cf264c6c86e1275c6af8daafb13f1ace862af41d,0,lpuskas,2017-09-05 11:14:53+02:00,['c091ebe8afa1d83384d5607fb4ee52eb018772b0'],12,50,62,28761883,1,0,0,1,30290
af647f81cb4eca5022c81fd31bdd14e7ba75185c,0,Attila Doroszlai,2017-09-05 12:18:36+02:00,['cf264c6c86e1275c6af8daafb13f1ace862af41d'],2,2,4,28761887,1,,,,30290
c774475b9281b4b04a1135e46e576896c3992e46,1,Sandor Magyari,2017-09-05 14:10:07+02:00,['af647f81cb4eca5022c81fd31bdd14e7ba75185c'],4,141,145,28762032,2,0.127906977,1,0.848837209,30290
7b67b01cb7d6321debf0f67e4715418c021c0d62,1,Robert Levas,2017-09-05 09:01:01-04:00,['c774475b9281b4b04a1135e46e576896c3992e46'],12,141,153,28762185,6,0.012195122,0.536585366,1,30290
d95e484b18768e61108cfc0cc690879d69334821,1,Alex Antonenko,2017-09-05 17:15:33+03:00,['7b67b01cb7d6321debf0f67e4715418c021c0d62'],56,42,98,28762283,2,,,,30290
93011b2600d0e5f3d05f1b8d317239c0e34662f5,1,Andrew Onishuk,2017-09-05 18:41:35+03:00,['d95e484b18768e61108cfc0cc690879d69334821'],16,16,32,28762315,1,,,,30290
02360dd5d788fd2ad7b0edd2f706051c1cc690e8,1,oleewere,2017-09-05 21:32:02+02:00,['93011b2600d0e5f3d05f1b8d317239c0e34662f5'],82513,412,82925,28845240,487,0.419422043,0.267002688,0.099697581,30291
6e69f214c8e45926cdf6757848f0bc42dc9b4917,0,Miklos Gergely,2017-09-06 10:46:26+02:00,['02360dd5d788fd2ad7b0edd2f706051c1cc690e8'],17,16,33,28845273,1,,,,30291
0034da609c3587df662278d2bf613b3ca92c276e,1,Miklos Gergely,2017-09-06 10:52:41+02:00,['6e69f214c8e45926cdf6757848f0bc42dc9b4917'],33,25,58,28845331,2,1,0,0,30291
e1f4d2e658d64dbdfc185dc8bdf33675289e2c1b,1,Alex Antonenko,2017-09-06 13:06:05+03:00,['0034da609c3587df662278d2bf613b3ca92c276e'],10,11,21,28845352,4,0.777777778,1,1,30291
202eaed6fb98da59d17d4f41d35ce8c576baf48a,0,Vitaly Brodetskyi,2017-09-06 13:15:05+03:00,['e1f4d2e658d64dbdfc185dc8bdf33675289e2c1b'],10,1,11,28845363,2,0,0,0,30291
680f1148e8e0dac064b7b77f9fba77d7d5a3c448,1,"Toader, Sebastian",2017-09-06 15:07:49+02:00,['202eaed6fb98da59d17d4f41d35ce8c576baf48a'],0,5742,5742,28851105,23,0.827586207,0.986206897,0.834482759,30303
8de9b06d93765f81487f5dc27f2b175bf475b0cb,0,Aleksandr Kovalenko,2017-09-06 17:26:32+03:00,['680f1148e8e0dac064b7b77f9fba77d7d5a3c448'],1,1,2,28851107,1,,,,30303
f3232d20436bf3944ae0b8359e71d840a6d132ac,0,Vitaly Brodetskyi,2017-09-06 17:29:02+03:00,['8de9b06d93765f81487f5dc27f2b175bf475b0cb'],1,1,2,28851109,1,,,,30303
249bb97a864c0f18278d37d87c2c3117809e5ca4,1,Nate Cole,2017-09-06 11:44:40-04:00,['f3232d20436bf3944ae0b8359e71d840a6d132ac'],84,175,259,28851368,10,0.216666667,0,1,30303
54d4d5e62d836d926bca79fea6b48503803db8fb,0,Aravindan Vijayan,2017-09-06 10:03:11-07:00,['249bb97a864c0f18278d37d87c2c3117809e5ca4'],32,1728,1760,28853128,3,,,,30303
0c45d48f5d82edbe096461c51832aa90d97593a4,0,Lisnichenko Dmitro,2017-09-06 20:06:05+03:00,['54d4d5e62d836d926bca79fea6b48503803db8fb'],2,9,11,28853139,2,1,1,1,30303
98b00094c458c904b500919d4ab08190ff4c5155,0,Jayush Luniya,2017-09-06 14:48:02-07:00,['0c45d48f5d82edbe096461c51832aa90d97593a4'],21,32,53,28853192,4,0,1,1,30303
8cb942393ce15efb5f6fbc9f594287c30971c296,0,Siddharth Wagle,2017-09-06 18:45:06-07:00,['98b00094c458c904b500919d4ab08190ff4c5155'],60,51,111,28853303,3,1,1,0.0625,30303
8b5d697c0adb5ae92b16f1df2e2d6d75b066fce5,1,Jonathan Hurley,2017-09-07 00:06:08-04:00,['8cb942393ce15efb5f6fbc9f594287c30971c296'],35,489,524,28853827,19,0,0.84375,0.71875,30303
24464d9b494c5c0ce94c4a82a02bcd6a2ff01a3e,0,Andrew Onishuk,2017-09-07 11:28:15+03:00,['21e590b811bac086d045add4e0dd3334f72240bc'],0,1,1,28853828,1,0,0,1,30303
a5d85a89949f127d0d3906224aa410c075e0b738,0,Andrew Onishuk,2017-09-07 12:51:55+03:00,['24464d9b494c5c0ce94c4a82a02bcd6a2ff01a3e'],0,15,15,28853843,2,0.5,0.5,1,30303
ab06654a4cb8de34b8135b7cc5ee2f7ede593a1d,1,Alex Antonenko,2017-09-07 17:09:02+03:00,['8b5d697c0adb5ae92b16f1df2e2d6d75b066fce5'],4,14,18,28853861,3,1,1,1,30303
a10e3887c714e6bdeb83c21b2d8ecfbba438639e,1,ababiichuk,2017-09-07 18:13:39+03:00,['ab06654a4cb8de34b8135b7cc5ee2f7ede593a1d'],255,533,788,28854649,22,0.628099174,0.67768595,0.900826446,30307
a5291abd9717aa0c97562c264effc1d330a4e129,1,Jonathan Hurley,2017-09-07 12:34:55-04:00,['a10e3887c714e6bdeb83c21b2d8ecfbba438639e'],51,60,111,28854760,3,0,0,0.9375,30307
d7a787bb2fb643bc1cae193f491196c181ae5f40,0,Swapan Shridhar,2017-09-07 10:55:01-07:00,['a5291abd9717aa0c97562c264effc1d330a4e129'],8,0,8,28854768,4,,,,30307
5e242c9ce099e7a72934974052ad56dc25cdb7ae,0,Siddharth Wagle,2017-09-07 11:58:47-07:00,['d7a787bb2fb643bc1cae193f491196c181ae5f40'],67,58,125,28854893,3,1,1,0.076923077,30307
5b1a63b7168296aab5a56744edd14dc1cc199425,0,Siddharth Wagle,2017-09-07 13:50:43-07:00,['5e242c9ce099e7a72934974052ad56dc25cdb7ae'],6,21,27,28854920,4,0.875,0.875,0.875,30307
f6ecbd1d7fa5f90ec020e64dbb403b3c3c2bdeb3,0,Venkata Sairam,2017-09-08 08:26:54+05:18,['5b1a63b7168296aab5a56744edd14dc1cc199425'],43,557,600,28855520,12,0.407017544,0.852631579,0.789473684,30310
2ece0b3317766fa7f89b80c64cd3ae5adfa8cbde,1,Swapan Shridhar,2017-09-07 22:44:57-07:00,['f6ecbd1d7fa5f90ec020e64dbb403b3c3c2bdeb3'],0,10,10,28855530,2,0,0,0,30310
b7f53dc8c516ba148cdb59577baf3db9b29d538b,0,Mugdha Varadkar,2017-09-08 14:11:12+05:18,['2ece0b3317766fa7f89b80c64cd3ae5adfa8cbde'],35,16,51,28855581,11,,,,30310
a05947873b39d646575e6568e9b7cd086a10fac3,1,Mugdha Varadkar,2017-09-08 14:12:18+05:18,['b7f53dc8c516ba148cdb59577baf3db9b29d538b'],18,201,219,28855800,6,0.017857143,0.535714286,1,30311
2ab8b39c17da02d4c06b22d12b9fa041c7407540,1,ababiichuk,2017-09-08 14:44:20+03:00,['a05947873b39d646575e6568e9b7cd086a10fac3'],668,1409,2077,28857877,20,0.388888889,0,0,30312
2170ce0321b8ea2c772c5dcdce38c4d94bea8175,0,Dmytro Grinenko,2017-09-08 15:29:45+03:00,['2ab8b39c17da02d4c06b22d12b9fa041c7407540'],20,54,74,28857951,2,0,0.727272727,0.863636364,30312
de94def937a531b2775aee419a09d3831c2d012e,0,Aleksandr Kovalenko,2017-09-08 16:20:44+03:00,['2170ce0321b8ea2c772c5dcdce38c4d94bea8175'],0,3,3,28857954,2,,,,30312
e142dcb6ca4f19fa986208dd69acde5a6e50cc67,0,Jonathan Hurley,2017-09-08 09:22:50-04:00,['de94def937a531b2775aee419a09d3831c2d012e'],4,10,14,28857968,3,0.25,0.5,1,30312
4fa4f806751b267983d24769b04b06dd153273a5,1,Dmytro Sen,2017-09-08 16:52:22+03:00,['e142dcb6ca4f19fa986208dd69acde5a6e50cc67'],0,20,20,28857988,1,,,,30312
a9d622edb4daf207c225c3da017ad0912ce7cf81,0,Nate Cole,2017-09-08 10:11:40-04:00,['4fa4f806751b267983d24769b04b06dd153273a5'],5,456,461,28858449,8,0,0.011363636,0.909090909,30314
75c8f5ef2374f8d5af01d0e6212053437d3d9f6e,0,Swapan Shridhar,2017-09-08 10:26:06-07:00,['a9d622edb4daf207c225c3da017ad0912ce7cf81'],0,2,2,28858451,1,1,1,0,30314
ad1264127c78c44eb05de15ffdbf6875e934f9bc,1,Attila Doroszlai,2017-09-08 20:10:02+02:00,['a5d85a89949f127d0d3906224aa410c075e0b738'],228,130,358,28858809,16,0.636363636,1,0,30314
c7a3bcd9cd9b4c92990405c6826140dee9ddd46e,1,Siddharth Wagle,2017-09-08 13:53:18-07:00,['75c8f5ef2374f8d5af01d0e6212053437d3d9f6e'],42,72,114,28858923,18,0.19047619,0.285714286,0.142857143,30314
acde502817ed185921a5b56a75af4fb814d3c353,0,Swapan Shridhar,2017-09-08 16:54:09-07:00,['c7a3bcd9cd9b4c92990405c6826140dee9ddd46e'],13,28,41,28858964,4,,,,30314
285cbafe31df4dd574e6a9828934b49269b169c3,0,Eric Yang,2017-09-10 08:46:49-07:00,['acde502817ed185921a5b56a75af4fb814d3c353'],52,151,203,28859167,2,0.105882353,0.023529412,0.082352941,30314
4bbbe1f66075e1898ab814c27676439123ba0288,1,Alex Antonenko,2017-09-11 13:49:25+03:00,['285cbafe31df4dd574e6a9828934b49269b169c3'],63,80,143,28859310,11,0,0,0,30314
3ac4340e6a14610bb7687c91a01362ec10837488,0,Andrew Onishuk,2017-09-11 14:59:24+03:00,['4bbbe1f66075e1898ab814c27676439123ba0288'],3,5,8,28859318,3,,,,30314
4f23c1ec5ee5630b6bff48317247d83dc6fd9b65,0,Alex Antonenko,2017-09-11 16:08:40+03:00,['3ac4340e6a14610bb7687c91a01362ec10837488'],0,1,1,28859319,1,,,,30314
26b9f4f13c141434ab51a945ebc50b56b82e41b9,0,Eugene Chekanskiy,2017-09-11 17:50:19+03:00,['4f23c1ec5ee5630b6bff48317247d83dc6fd9b65'],1,1,2,28859321,1,0,0,0,30314
92bd10d65f92f95c55bd2bc84a75244f2748ed09,0,Aleksandr Kovalenko,2017-09-11 19:53:52+03:00,['26b9f4f13c141434ab51a945ebc50b56b82e41b9'],3,13,16,28859337,1,0.3,1,1,30314
ca87e8ddef14c02b5fbabc26e5672a157a6dbaec,1,Jaimin Jetly,2017-09-11 11:08:23-07:00,['92bd10d65f92f95c55bd2bc84a75244f2748ed09'],18,50,68,28859405,7,0.137931034,0,0,30314
c241b9a02d253269067a90c71a8fbc2260cb0645,0,Madhuvanthi Radhakrishnan,2017-09-11 19:34:27-07:00,['ca87e8ddef14c02b5fbabc26e5672a157a6dbaec'],5,9,14,28859419,1,1,1,1,30314
252e9898c7e68a94924f63549b45af528d15ad14,0,Attila Magyar,2017-09-12 13:13:51+02:00,['c241b9a02d253269067a90c71a8fbc2260cb0645'],18,25,43,28859462,4,1,1,1,30314
001f290be2622375786f27cc054727adb7be8905,1,Dmytro Grinenko,2017-09-12 15:12:44+03:00,['252e9898c7e68a94924f63549b45af528d15ad14'],50,42,92,28859554,5,0.875,0.875,0,30314
02bea547cd71e6aff173f04d0154b25ebe85432a,0,Alex Antonenko,2017-09-12 16:26:12+03:00,['001f290be2622375786f27cc054727adb7be8905'],1,25,26,28859580,4,1,1,1,30314
f89dcd7d03d18a57543f2a86653345ad3ab00095,0,Nate Cole,2017-09-12 10:19:41-04:00,['02bea547cd71e6aff173f04d0154b25ebe85432a'],29,21,50,28859630,2,1,0,1,30314
5113e995f27b4b357ca99650cee5c95a7881c619,0,"Toader, Sebastian",2017-09-12 18:04:40+02:00,['f89dcd7d03d18a57543f2a86653345ad3ab00095'],12,19,31,28859661,2,0,0,1,30314
321f9cfeb42006ce309d09dbd7af1e6601c90ba5,1,Jonathan Hurley,2017-09-12 12:29:31-04:00,['5113e995f27b4b357ca99650cee5c95a7881c619'],56,222,278,28859939,6,0.417910448,0.776119403,0.134328358,30314
aaf6f0ae0f69ed80c1f8ec9ffaf81cf3a358900a,0,Vitaly Brodetskyi,2017-09-12 20:31:56+03:00,['321f9cfeb42006ce309d09dbd7af1e6601c90ba5'],3,0,3,28859942,1,,,,30314
9316ea858991552a13481f9d2dab3273e73565f2,0,Jaimin Jetly,2017-09-12 11:02:12-07:00,['aaf6f0ae0f69ed80c1f8ec9ffaf81cf3a358900a'],1,2,3,28859945,1,1,1,1,30314
bb4645f7c0e8242a397b192cabd326bef0d99700,1,Jaimin Jetly,2017-09-12 11:13:39-07:00,['9316ea858991552a13481f9d2dab3273e73565f2'],0,199,199,28860144,5,1,1,1,30316
7fa7a6c17607341e8a6888f3dd8b938dce7425ff,1,Aravindan Vijayan,2017-09-12 17:01:51-07:00,['bb4645f7c0e8242a397b192cabd326bef0d99700'],19,110,129,28860273,5,0.015384615,0.707692308,1,30316
a49121b9af276f45ef26e0b320de48d6ef6e7563,1,Aravindan Vijayan,2017-09-12 17:07:14-07:00,['7fa7a6c17607341e8a6888f3dd8b938dce7425ff'],24,127,151,28860424,3,0.146666667,1,1,30316
4f6ef91f33cefeea97629dd4dc45ec993b27b4f6,0,Aravindan Vijayan,2017-09-12 19:54:01-07:00,['a49121b9af276f45ef26e0b320de48d6ef6e7563'],6,5,11,28860435,1,1,0,0,30316
c6e19b765e80ad7e22ec63cdd4e8004960683466,0,Attila Magyar,2017-09-13 09:12:40+02:00,['4f6ef91f33cefeea97629dd4dc45ec993b27b4f6'],3,2,5,28860440,2,,,,30316
fa0ecc48ac68335fcce06bd41d473cfcfcfd475e,0,Aleksandr Kovalenko,2017-09-13 14:15:05+03:00,['c6e19b765e80ad7e22ec63cdd4e8004960683466'],5,4,9,28860449,2,0,0,0,30316
18ae06d3e49c98f919b666deca7c42b460ee204f,0,Andrew Onishuk,2017-09-13 14:27:24+03:00,['fa0ecc48ac68335fcce06bd41d473cfcfcfd475e'],0,13,13,28860462,3,0,0,1,30316
2a6dd58f506b5e9fcaf7b435e645c2397fe35855,1,ababiichuk,2017-09-13 16:56:56+03:00,['18ae06d3e49c98f919b666deca7c42b460ee204f'],40,571,611,28861073,6,1,1,1,30317
153d0da771d1ad523ad90b487fa185aa2bf0d52d,1,Miklos Gergely,2017-09-13 16:46:02+02:00,['2a6dd58f506b5e9fcaf7b435e645c2397fe35855'],0,785,785,28861858,4,0.143859649,0.415789474,0.377192982,30319
2c10dc92047017771e6fca8d9d76d6d6b00df372,0,Alex Antonenko,2017-09-13 18:40:22+03:00,['153d0da771d1ad523ad90b487fa185aa2bf0d52d'],26,35,61,28861919,7,0,1,1,30319
16cc3a6ed6c5bd07c613433309322835e378d559,1,Nate Cole,2017-09-13 12:25:50-04:00,['2c10dc92047017771e6fca8d9d76d6d6b00df372'],40,510,550,28862469,6,0.354700855,0.405982906,0.794871795,30321
7a7d2320a1ebf37e44b487dbf04de2a1c16761cd,1,Siddharth Wagle,2017-09-13 10:19:10-07:00,['16cc3a6ed6c5bd07c613433309322835e378d559'],11,28,39,28862508,9,1,1,1,30321
6c40fdf48e21db493d3449ba59e652f90e264ec3,1,Aravindan Vijayan,2017-09-13 15:14:12-07:00,['7a7d2320a1ebf37e44b487dbf04de2a1c16761cd'],60,257,317,28862825,3,0,0.005376344,1,30321
df3a66d9767646f6a38b3c64a587a4ab647bf868,0,Swapan Shridhar,2017-09-13 15:52:49-07:00,['6c40fdf48e21db493d3449ba59e652f90e264ec3'],0,26,26,28862851,4,,,,30321
03edb8e780f12c83ba918b9bc2b1b4cf06057ea6,0,Aleksandr Kovalenko,2017-09-14 13:40:29+03:00,['df3a66d9767646f6a38b3c64a587a4ab647bf868'],1,1,2,28862853,1,,,,30321
38604db2f17eb7eac3b4fe5bf308842d5018ee00,1,Jonathan Hurley,2017-09-14 10:23:32-04:00,['03edb8e780f12c83ba918b9bc2b1b4cf06057ea6'],405,805,1210,28864063,14,0.542168675,1,0.987951807,30321
1f6b9daf2f7e559705c00d2ac8428af1337f5e4d,0,Nate Cole,2017-09-14 10:44:35-04:00,['38604db2f17eb7eac3b4fe5bf308842d5018ee00'],4,9,13,28864076,2,0,1,1,30321
6b19bc46f7c2b8cb7bd8803c213fc3b13fde6418,1,Jonathan Hurley,2017-09-14 12:26:36-04:00,['1f6b9daf2f7e559705c00d2ac8428af1337f5e4d'],5,43,48,28864124,4,0,1,1,30322
3affda38defa4f74ae981e78b6c85c0048635fb2,0,Nate Cole,2017-09-14 12:30:12-04:00,['6b19bc46f7c2b8cb7bd8803c213fc3b13fde6418'],8,1,9,28864133,2,1,0.75,0,30322
95d6ff0b03582b0c4132ee8575d8f688e033c9ee,0,Alex Antonenko,2017-09-14 22:14:00+03:00,['3affda38defa4f74ae981e78b6c85c0048635fb2'],7,19,26,28864159,2,0,0,0,30322
6cee80b1894276608e53f3b0f4711acf23b1a975,1,Jonathan Hurley,2017-09-14 15:35:31-04:00,['95d6ff0b03582b0c4132ee8575d8f688e033c9ee'],109,180,289,28864448,4,1,1,1,30322
54435dbb29f4e07a16cc9c032c444c7028461986,1,Alex Antonenko,2017-09-14 22:45:20+03:00,['6cee80b1894276608e53f3b0f4711acf23b1a975'],20,26,46,28864494,5,1,1,1,30322
c2c0bc0f9f7c738d12fa863502d4771c1705f057,0,Andrii Tkach,2017-09-15 13:05:26+03:00,['54435dbb29f4e07a16cc9c032c444c7028461986'],7,19,26,28864520,2,1,1,1,30322
b46cc4f858e5c6fa400ea8587c0c3aee44a52887,1,Aleksandr Kovalenko,2017-09-15 13:14:32+03:00,['c2c0bc0f9f7c738d12fa863502d4771c1705f057'],2,2,4,28864524,1,,,,30322
e53cc68d48d3c2f8a10b4f66d802a5ecf7efd5a4,0,Vitaly Brodetskyi,2017-09-15 14:49:02+03:00,['b46cc4f858e5c6fa400ea8587c0c3aee44a52887'],2,2,4,28864528,2,,,1,30322
26427cd9a8fb8cb76a7dc60e48dade3720392d4f,0,Aleksandr Kovalenko,2017-09-15 15:47:16+03:00,['e53cc68d48d3c2f8a10b4f66d802a5ecf7efd5a4'],11,12,23,28864551,1,1,1,1,30322
2de51400d289519df15a2eee88af2059a510903c,0,Andrii Tkach,2017-09-15 16:04:37+03:00,['26427cd9a8fb8cb76a7dc60e48dade3720392d4f'],20,45,65,28864616,5,0.7,0.7,0.6,30322
fed32b85a6c1f8fc28036f02df39fe8fa6a3bfb5,0,Nate Cole,2017-09-15 11:05:21-04:00,['2de51400d289519df15a2eee88af2059a510903c'],6,64,70,28864686,3,0,0.317073171,1,30322
d8e621e5ed292f3fb644f8f93f22695540278e08,0,Lisnichenko Dmitro,2017-09-15 20:05:59+03:00,['fed32b85a6c1f8fc28036f02df39fe8fa6a3bfb5'],16,221,237,28864923,4,0.113636364,0.560606061,1,30322
f8b29df9685b443d4a5c06c6e1725e4428c95b49,1,Vitaly Brodetskyi,2017-09-15 20:41:41+03:00,['d8e621e5ed292f3fb644f8f93f22695540278e08'],19,189,208,28865131,19,0.390625,0.5078125,0.96875,30322
cb46f39eee877a530f175d86ca1ac85d70c8df82,1,Miklos Gergely,2017-09-15 23:33:22+02:00,['f8b29df9685b443d4a5c06c6e1725e4428c95b49'],1,1,2,28865133,1,,,,30322
8c104df93ae5d3732c6bfd3657b803985f2c0553,0,Venkata Sairam,2017-09-18 12:10:05+05:18,['cb46f39eee877a530f175d86ca1ac85d70c8df82'],2,35,37,28865170,5,,,,30322
190094ba26b24e1f0dd7b39b0b39721d95bfd874,1,Venkata Sairam,2017-09-18 12:14:33+05:18,['8c104df93ae5d3732c6bfd3657b803985f2c0553'],47,525,572,28865742,40,0.158730159,0.603174603,0.952380952,30323
9420b6f70be0ca15b8974f8e1872c754b387976c,0,Oliver Szabo,2017-09-18 12:13:45+02:00,['190094ba26b24e1f0dd7b39b0b39721d95bfd874'],9,0,9,28865751,1,1,0,0,30323
6cbb3a84042cfafded0d1570247c1fdd17d5302f,0,Oliver Szabo,2017-09-18 12:13:46+02:00,['9420b6f70be0ca15b8974f8e1872c754b387976c'],2,2,4,28865755,1,,,,30323
7e61e3a90f7990db8e166fab3d1a336a5ff5e8cc,1,Oliver Szabo,2017-09-18 12:13:46+02:00,['6cbb3a84042cfafded0d1570247c1fdd17d5302f'],1,1,2,28865757,1,,,,30323
fca80cbe0a19fdb3bfae1240ecb715bd3059e02b,1,Andrii Tkach,2017-09-18 13:42:39+03:00,['7e61e3a90f7990db8e166fab3d1a336a5ff5e8cc'],7,144,151,28865908,4,0.386363636,1,1,30323
8574cc06968fd8ddb8d6a640731acaa439dfaf53,0,Andrii Tkach,2017-09-18 13:51:11+03:00,['fca80cbe0a19fdb3bfae1240ecb715bd3059e02b'],0,1,1,28865909,1,1,1,1,30323
e87da0862abb712ab7e5ba9d2e7dbbf682647a99,1,Alex Antonenko,2017-09-18 16:49:48+03:00,['8574cc06968fd8ddb8d6a640731acaa439dfaf53'],0,6,6,28865915,1,1,1,1,30323
10a960f7041f662bbc50733cca60c8f8731ccca8,1,Alex Antonenko,2017-09-18 18:03:03+03:00,['e87da0862abb712ab7e5ba9d2e7dbbf682647a99'],4,22,26,28865941,3,,,,30323
350257637d21189f0ba0810e609578ca81a43122,0,Andrii Tkach,2017-09-18 18:15:24+03:00,['10a960f7041f662bbc50733cca60c8f8731ccca8'],3,7,10,28865951,2,1,1,1,30323
a9e558d89962b9b5e2ff38092d79cf68b6744e79,1,ababiichuk,2017-09-18 19:35:24+03:00,['350257637d21189f0ba0810e609578ca81a43122'],97,717,814,28866765,18,0.893536122,0.859315589,0.91634981,30332
cf98c01f49796839a83557bfe76336f10f710501,0,Siddharth Wagle,2017-09-18 10:44:18-07:00,['a9e558d89962b9b5e2ff38092d79cf68b6744e79'],11,2,13,28866778,1,0,0,0,30332
c52ddc9d70ce9389d6cb6a827e2313bca99bc9be,0,Robert Levas,2017-09-18 13:45:49-04:00,['cf98c01f49796839a83557bfe76336f10f710501'],308,255,563,28867341,19,0.08,0,0,30332
3cdac5f907b6a244ff439b674c7a3005a425a97d,0,Robert Levas,2017-09-18 13:47:30-04:00,['c52ddc9d70ce9389d6cb6a827e2313bca99bc9be'],255,308,563,28867904,19,0.92,1,1,30332
dd6cc606b3918f339037a66b54f6debb8ea10586,0,Robert Levas,2017-09-18 13:48:23-04:00,['3cdac5f907b6a244ff439b674c7a3005a425a97d'],0,193,193,28868097,1,,,,30333
660581985a01be7650a843a3f7a1fd4bf889c5a8,0,Robert Levas,2017-09-18 13:50:19-04:00,['dd6cc606b3918f339037a66b54f6debb8ea10586'],193,0,193,28868290,1,,,,30333
13bc582160a4f802bd21964bd06814d05fd47f0b,1,Robert Levas,2017-09-18 13:50:50-04:00,['660581985a01be7650a843a3f7a1fd4bf889c5a8'],308,448,756,28869046,20,0.08,0,0,30334
941bc1685417eb82dd6186ed713250c153b55bcd,0,Jaimin Jetly,2017-09-18 11:00:00-07:00,['13bc582160a4f802bd21964bd06814d05fd47f0b'],23,78,101,28869147,7,0.358974359,1,0.974358974,30334
bb6f0d2c89adf17894caa995da65e7e09f714434,1,Vitaly Brodetskyi,2017-09-18 21:09:06+03:00,['941bc1685417eb82dd6186ed713250c153b55bcd'],0,52,52,28869199,9,,,,30334
f0b51a8275c8c3d1e25118f9debca319b4f63589,0,Swapan Shridhar,2017-09-18 11:26:17-07:00,['bb6f0d2c89adf17894caa995da65e7e09f714434'],3,2,5,28869204,2,,,,30334
c2f676c639a707c8ea22b40a968c03a3604c9d0b,0,Jaimin Jetly,2017-09-18 11:45:28-07:00,['f0b51a8275c8c3d1e25118f9debca319b4f63589'],10,28,38,28869242,5,0.428571429,1,1,30334
4c858d018765ac78fff9d395271ad470a96936da,0,Swapan Shridhar,2017-09-18 11:58:14-07:00,['c2f676c639a707c8ea22b40a968c03a3604c9d0b'],0,311,311,28869553,5,0.102362205,1,1,30336
010f6d7a1b0c68f37d39f8fbc2a09030809b7841,0,Tim Thorpe,2017-09-18 13:06:45-07:00,['4c858d018765ac78fff9d395271ad470a96936da'],1,82,83,28869636,2,1,1,1,30337
26965b3eb45dff17628686fc28e12d8531f404e3,0,Yusaku Sako,2017-09-18 15:35:18-07:00,['010f6d7a1b0c68f37d39f8fbc2a09030809b7841'],0,12,12,28869648,1,,,,30337
1f321e35693a1c8fe2c6c5a4ac3e1f454bf847e1,1,Mugdha Varadkar,2017-09-19 12:04:16+05:18,['26965b3eb45dff17628686fc28e12d8531f404e3'],2,23,25,28869673,7,,,,30337
79a37e51088d84bd09857b02e2d9500be5ffbe73,1,Andrew Onishuk,2017-09-19 10:59:13+03:00,['ad1264127c78c44eb05de15ffdbf6875e934f9bc'],12,33,45,28869718,7,0,0.733333333,0.6,30337
ea49b33c143fb0e00f16594fdb7dbf396f374981,1,Alex Antonenko,2017-09-19 12:51:38+03:00,['1f321e35693a1c8fe2c6c5a4ac3e1f454bf847e1'],15,34,49,28869767,4,1,1,1,30337
f6c1e47332482bfa9faeec67402bda58770aa6e9,0,Andrii Tkach,2017-09-19 13:17:17+03:00,['ea49b33c143fb0e00f16594fdb7dbf396f374981'],1,3,4,28869771,1,1,1,1,30337
8961a93c49b444b6c6ddc5e657e22540c39c13db,0,Miklos Gergely,2017-09-19 12:32:13+02:00,['f6c1e47332482bfa9faeec67402bda58770aa6e9'],1,1,2,28869773,1,,,,30337
d0e44a15466548e06b977c9d514b4a4ff4f52296,0,Alex Antonenko,2017-09-19 15:09:12+03:00,['8961a93c49b444b6c6ddc5e657e22540c39c13db'],1,1,2,28869775,1,,,,30337
271fbc7ca83cfb67f7b4d2adec61000c571e8aff,1,Alex Antonenko,2017-09-19 16:15:16+03:00,['d0e44a15466548e06b977c9d514b4a4ff4f52296'],3,48,51,28869826,2,1,1,1,30337
7cebdebbdfb6c249945c03e12f203b3fc05fe926,0,Alex Antonenko,2017-09-19 16:48:59+03:00,['271fbc7ca83cfb67f7b4d2adec61000c571e8aff'],7,1,8,28869834,2,,,,30337
b9652bd7b1ea4d5e04a06f8924399ea8a1c64ea2,0,Andrii Tkach,2017-09-19 17:14:00+03:00,['7cebdebbdfb6c249945c03e12f203b3fc05fe926'],1,1,2,28869836,1,,,,30337
cc70c2b5bdf7f889fe2c24fcbbe11945ee2e3a33,0,Nate Cole,2017-09-19 11:40:33-04:00,['b9652bd7b1ea4d5e04a06f8924399ea8a1c64ea2'],1,2,3,28869839,1,1,0,1,30337
f7c9e1ee5799632ce8ce2d68a56dbdb2aabf29d4,0,Nishant,2017-09-19 21:46:01+05:18,['cc70c2b5bdf7f889fe2c24fcbbe11945ee2e3a33'],2,2,4,28869843,2,,,,30337
9be7569b96a99932758065ff2289399eecadf024,0,Robert Levas,2017-09-19 12:45:16-04:00,['f7c9e1ee5799632ce8ce2d68a56dbdb2aabf29d4'],1,1,2,28869845,1,,,,30337
baa16567244e7246f5cc7cd964b1fba81bc21447,0,Nishant,2017-09-19 22:51:04+05:18,['9be7569b96a99932758065ff2289399eecadf024'],2,2,4,28869849,2,,,,30337
23e080aba77ecddf69a16b973764f3bcb4b15607,0,Siddharth Wagle,2017-09-19 15:07:50-07:00,['baa16567244e7246f5cc7cd964b1fba81bc21447'],0,2,2,28869851,1,,,,30337
878dc6ac72b9d5d87a5f6c21991290886459eede,0,Jaimin Jetly,2017-09-19 18:54:00-07:00,['23e080aba77ecddf69a16b973764f3bcb4b15607'],4,34,38,28869889,6,1,1,1,30337
87c4205c21489cfe8bab160fb82e3429c4fb832e,0,Jaimin Jetly,2017-09-19 19:18:48-07:00,['878dc6ac72b9d5d87a5f6c21991290886459eede'],0,1,1,28869890,1,1,1,1,30337
a90f3b36c878e30b9eeeeecab678b9736f83254b,1,Venkata Sairam,2017-09-20 11:48:54+05:18,['87c4205c21489cfe8bab160fb82e3429c4fb832e'],119,524,643,28870533,10,0.047923323,0.92971246,1,30339
c8832728ad0ebb545bd8795de23d0b859af23d1a,0,Andrew Onishuk,2017-09-20 11:19:09+03:00,['a90f3b36c878e30b9eeeeecab678b9736f83254b'],0,4,4,28870537,1,0,0,1,30339
8467a2048300ac54caf84ad785a8cc0a96f3cb65,1,Venkata Sairam,2017-09-20 15:09:27+05:18,['c8832728ad0ebb545bd8795de23d0b859af23d1a'],10,125,135,28870672,1,0,1,1,30339
260c75fc81891d9df219e64ed9dbd3cc8bc5e140,1,ababiichuk,2017-09-20 13:11:48+03:00,['8467a2048300ac54caf84ad785a8cc0a96f3cb65'],29,161,190,28870862,16,0,1,0,30339
8b9370a55207ecb6baccfd02337afe7c75532f7b,0,Eugene Chekanskiy,2017-09-20 16:28:11+03:00,['260c75fc81891d9df219e64ed9dbd3cc8bc5e140'],1,1,2,28870864,1,,,,30339
56c3da7846cf2b30e5860cb5bc32d3c9ecb93424,0,Jonathan Hurley,2017-09-20 10:17:31-04:00,['8b9370a55207ecb6baccfd02337afe7c75532f7b'],12,208,220,28871084,2,0.008333333,0.741666667,1,30339
0f1099b9a9887c3a6b05753a00ce88c9d9c4f497,1,ababiichuk,2017-09-20 17:37:42+03:00,['56c3da7846cf2b30e5860cb5bc32d3c9ecb93424'],59,46,105,28871189,7,,,,30339
73bd428de74c3a97fbcdc53e160a1d6346528ba2,1,Aleksandr Kovalenko,2017-09-20 18:06:03+03:00,['0f1099b9a9887c3a6b05753a00ce88c9d9c4f497'],1,27,28,28871217,2,1,1,1,30339
25c1f211ef165611fcf52bd75b7a851c857f04a9,1,Jonathan Hurley,2017-09-20 16:24:30-04:00,['73bd428de74c3a97fbcdc53e160a1d6346528ba2'],0,4,4,28871221,2,,,,30339
5c0a3546e70e71366c51ef4e3b3ef9f2319865d8,1,Jonathan Hurley,2017-09-20 17:02:39-04:00,['25c1f211ef165611fcf52bd75b7a851c857f04a9'],17,133,150,28871371,17,0.789473684,0.921052632,0.947368421,30339
1a5b4943cbfa42d66d61e5cb29a09e1d3ad9acb7,1,Oliver Szabo,2017-09-21 12:27:13+02:00,['5c0a3546e70e71366c51ef4e3b3ef9f2319865d8'],14,38,52,28871423,6,,,,30339
3e5f60ab9d30761df08923c4e56dd518fc71d271,1,Sandor Magyari,2017-09-21 15:44:54+02:00,['1a5b4943cbfa42d66d61e5cb29a09e1d3ad9acb7'],4,6,10,28871433,1,0,1,0,30339
001c77f5773e3ca778ee6ff78ba8c616f0e3007c,1,Nate Cole,2017-09-21 09:56:46-04:00,['3e5f60ab9d30761df08923c4e56dd518fc71d271'],26,157,183,28871616,3,0,0,0.833333333,30340
37b847069f1d2a07ed9deb5e580ba23e90b77ade,0,Andrii Tkach,2017-09-21 17:54:24+03:00,['001c77f5773e3ca778ee6ff78ba8c616f0e3007c'],1,16,17,28871633,2,0.866666667,1,1,30340
2e170e4801794ddbbcd331585782a5f5b7e897a1,1,Alex Antonenko,2017-09-21 18:42:05+03:00,['37b847069f1d2a07ed9deb5e580ba23e90b77ade'],8,9,17,28871650,3,,,,30340
2a0602104f719d8dec7cc34f9a10fe885d55a551,1,Robert Levas,2017-09-21 12:01:29-04:00,['2e170e4801794ddbbcd331585782a5f5b7e897a1'],468,1039,1507,28873157,96,0.251908397,0.923664122,0.839694656,30340
f1b53000c65a97ac7784d51c9a648e7e135acaab,0,Eugene Chekanskiy,2017-09-21 21:07:03+03:00,['2a0602104f719d8dec7cc34f9a10fe885d55a551'],78,36,114,28873271,2,1,0,1,30340
f095b9590afe5657b560defb3e3d5e9294c1e65d,0,Siddharth Wagle,2017-09-21 13:03:21-07:00,['f1b53000c65a97ac7784d51c9a648e7e135acaab'],26,423,449,28873720,9,0.75,1,1,30341
f9c0c909be405ecfe3607ad4e07d3aa6eb6cf3df,0,Nate Cole,2017-09-21 17:13:27-04:00,['f095b9590afe5657b560defb3e3d5e9294c1e65d'],2,98,100,28873820,3,0.176470588,1,0.176470588,30341
7c687bbc226b19f85a6f6f292537760e5d6d8048,1,Attila Doroszlai,2017-09-21 23:22:19+02:00,['f9c0c909be405ecfe3607ad4e07d3aa6eb6cf3df'],63,87,150,28873970,3,0.125,0.6875,0.9375,30341
5d5f9749e82bf815a1c8f82f090b769421d39949,0,Nate Cole,2017-09-21 18:07:57-04:00,['7c687bbc226b19f85a6f6f292537760e5d6d8048'],78,0,78,28874048,1,,,,30341
d221ab786277abf6d8e9e8dbc9442e37423484a4,1,Venkata Sairam,2017-09-22 12:34:55+05:18,['5d5f9749e82bf815a1c8f82f090b769421d39949'],2,12,14,28874062,2,,,,30341
d9662987483c8e0d347c59f02e8e459427a90749,1,ababiichuk,2017-09-22 12:00:33+03:00,['d221ab786277abf6d8e9e8dbc9442e37423484a4'],13,3,16,28874078,7,,,,30341
e4cadbb15876e635b6831d2a488edda80d2d0554,1,Andrew Onishuk,2017-09-22 13:42:26+03:00,['d9662987483c8e0d347c59f02e8e459427a90749'],2,2,4,28874082,1,,,,30341
9e93c476ddd8d4397f550062fd1645ac5422ed2e,1,Andrew Onishuk,2017-09-22 14:06:17+03:00,['e4cadbb15876e635b6831d2a488edda80d2d0554'],323,168,491,28874573,2,0,0,0.870588235,30341
40f705a6654907014eae6a1981622ae404fda1e8,1,Oliver Szabo,2017-09-22 13:11:15+02:00,['9e93c476ddd8d4397f550062fd1645ac5422ed2e'],2,1,3,28874576,1,,,,30341
eead09bebb0c1887c8dd8fe90aa8a6d50009e897,1,Andrii Tkach,2017-09-22 14:48:47+03:00,['40f705a6654907014eae6a1981622ae404fda1e8'],102,186,288,28874864,10,0,0.625,1,30341
f067ec8c3aaeb596760db4c2bcb98ce81f75769a,1,ababiichuk,2017-09-22 15:20:02+03:00,['eead09bebb0c1887c8dd8fe90aa8a6d50009e897'],29,173,202,28875066,17,0.684210526,1,1,30342
ea892443513fa730dad2ef3af06069ef618e0225,1,Mugdha Varadkar,2017-09-22 18:02:00+05:18,['f067ec8c3aaeb596760db4c2bcb98ce81f75769a'],0,377,377,28875443,10,0,1,1,30344
19b16073c50556de666c17b3749ff6a0c1dae398,0,Alex Antonenko,2017-09-22 19:25:38+03:00,['ea892443513fa730dad2ef3af06069ef618e0225'],2,2,4,28875447,2,,,,30344
5d5cc4ff024965210aaa4fcccb17d694b69c9927,0,Siddharth Wagle,2017-09-22 14:19:31-07:00,['19b16073c50556de666c17b3749ff6a0c1dae398'],2,0,2,28875449,1,,,,30344
6fb05cb0f089ef0fee7fcc462efda967b814b668,1,Oliver Szabo,2017-09-27 11:26:23+02:00,['9d802b7c11a62336fd4de8aa2695af02b061c625'],3,78,81,28875530,7,,,,30346
3e1a5cb7c1e7034d82aa8acfe3b1fd33e11cdb04,1,Oliver Szabo,2017-09-27 11:26:23+02:00,['6fb05cb0f089ef0fee7fcc462efda967b814b668'],1,3,4,28875534,1,,,,30346
b027837fab2f6552c64aadb41ffb5667a2acdd26,0,Robert Levas,2017-09-27 08:05:45-04:00,['3e1a5cb7c1e7034d82aa8acfe3b1fd33e11cdb04'],2,33,35,28875569,1,0,1,1,30346
81354ffd2b32f22178f98c8588974faa98a136dd,0,Alex Antonenko,2017-09-27 16:28:08+03:00,['b027837fab2f6552c64aadb41ffb5667a2acdd26'],1,7,8,28875577,2,1,1,1,30346
407eb543577f460f319822504d8cc9558ae5aabc,0,Andrii Tkach,2017-09-27 16:47:23+03:00,['81354ffd2b32f22178f98c8588974faa98a136dd'],6,9,15,28875592,1,0,0,1,30346
f4e4fae8ef085a7e646ea0c5f986b00f10cfdfdc,1,Venkata Sairam,2017-09-27 19:34:56+05:18,['407eb543577f460f319822504d8cc9558ae5aabc'],3,16,19,28875611,2,0,0,1,30346
40e712a187bf36f49dfed584c923df271cca522d,0,Swapan Shridhar,2017-09-27 10:10:40-07:00,['f4e4fae8ef085a7e646ea0c5f986b00f10cfdfdc'],0,6,6,28875617,1,,,,30346
4da28dffffa7b2fe362d52de34ec3f0ec47bfb30,1,Jonathan Hurley,2017-09-27 14:04:40-04:00,['40e712a187bf36f49dfed584c923df271cca522d'],13,22,35,28875652,3,0,0,1,30346
9b259142f47d1ebe55e26fbfdb0494cb825f8b2c,1,Miklos Gergely,2017-09-27 21:18:03+02:00,['4da28dffffa7b2fe362d52de34ec3f0ec47bfb30'],2,13,15,28875667,4,,,,30346
add33d4f1905b91b21db4b4af1b857374fbac5f8,0,Andrii Tkach,2017-09-28 13:49:27+03:00,['9b259142f47d1ebe55e26fbfdb0494cb825f8b2c'],87,18,105,28875772,13,0.428571429,0.047619048,0.142857143,30346
d198dd3c43d491b8fb0689546522351bb9b303de,0,Nitiraj Singh Rathore,2017-09-28 17:02:27+05:18,['add33d4f1905b91b21db4b4af1b857374fbac5f8'],1,1,2,28875774,1,,0,,30346
b10b6fd4887f5e153f2abfb2dd804f9604273be8,1,Vitaly Brodetskyi,2017-09-23 11:47:07+03:00,['d198dd3c43d491b8fb0689546522351bb9b303de'],36,421,457,28876231,55,,,,30346
c7c62c0974331790ad380799f2f59cd2d92ccd0a,0,Alex Antonenko,2017-09-28 15:18:19+03:00,['b10b6fd4887f5e153f2abfb2dd804f9604273be8'],1,1,2,28876233,1,,,,30346
b660bf1a30fd324d099f0cb3af1e525b4364a2d7,1,Dmytro Sen,2017-09-28 17:17:32+03:00,['c7c62c0974331790ad380799f2f59cd2d92ccd0a'],28,8,36,28876269,1,1,1,1,30346
63733bf29d19cef8a8e8f54fcfb151e4be04bdf5,1,Andrew Onishuk,2017-09-28 19:07:46+03:00,['b660bf1a30fd324d099f0cb3af1e525b4364a2d7'],10,29,39,28876308,4,1,1,0,30349
fb4115e27eda3591d944bd7adb6c0fb449538a2a,1,Andrew Onishuk,2017-09-28 19:50:57+03:00,['63733bf29d19cef8a8e8f54fcfb151e4be04bdf5'],135,105,240,28876548,4,1,0,0,30349
8e0f782efd4694028b598106e68ebe2a1c7c0a2e,1,Eugene Chekanskiy,2017-09-28 19:58:58+03:00,['fb4115e27eda3591d944bd7adb6c0fb449538a2a'],0,10,10,28876558,4,,,,30349
f744a36d378765f50d4ab808065604f64c7ffb1d,0,Alex Antonenko,2017-09-28 21:23:14+03:00,['8e0f782efd4694028b598106e68ebe2a1c7c0a2e'],3,11,14,28876572,1,1,1,1,30349
7950e3c1166d51501c3baf7b0cd1d363f2426703,1,Robert Levas,2017-09-28 16:36:43-04:00,['f744a36d378765f50d4ab808065604f64c7ffb1d'],2,83,85,28876657,3,0.516129032,0,0.967741935,30349
8852edd2f5458a22109bc0931fd6e91341d0523f,1,ababiichuk,2017-09-29 15:45:40+03:00,['7950e3c1166d51501c3baf7b0cd1d363f2426703'],102,908,1010,28877667,50,0.614213198,0.989847716,0.588832487,30361
504094e5bc697373b233683e0697de63872ce101,1,Oliver Szabo,2017-09-29 15:50:20+02:00,['8852edd2f5458a22109bc0931fd6e91341d0523f'],76,235,311,28877978,3,,,,30361
f5f888cd7e7297e514537ce4754397590a0dc62f,1,Andrii Tkach,2017-09-29 17:44:37+03:00,['504094e5bc697373b233683e0697de63872ce101'],17,30,47,28878025,3,1,1,1,30361
d3b67eeab455b01f8f921039b50818a6ded32839,1,pallavkul,2017-09-29 20:38:43+05:18,['f5f888cd7e7297e514537ce4754397590a0dc62f'],21,61,82,28878107,3,1,1,0.833333333,30361
045fc072588632429bc53f6b6a1ee0e0a83179d0,1,pallavkul,2017-09-29 20:39:41+05:18,['d3b67eeab455b01f8f921039b50818a6ded32839'],1,1,2,28878109,1,,,,30361
510a2620db12e47741e7a00022d66d6bceb283b5,0,Alex Antonenko,2017-09-29 21:18:00+03:00,['045fc072588632429bc53f6b6a1ee0e0a83179d0'],1,1,2,28878111,1,,,,30361
f69ccd890bdfd0e4df78fc8c52f8799d7a61b03b,1,Alex Antonenko,2017-09-29 21:40:02+03:00,['510a2620db12e47741e7a00022d66d6bceb283b5'],0,11,11,28878122,1,,,,30361
18fd04f2e3c59b3c741ac0d32083a70739203f70,1,Vitaly Brodetskyi,2017-09-24 12:21:24+03:00,['f69ccd890bdfd0e4df78fc8c52f8799d7a61b03b'],0,1,1,28878123,1,,,,30361
50b64758091a0df76419cbced4044e2689b5d4d1,1,Andrew Onishuk,2017-09-25 12:27:24+03:00,['5d5cc4ff024965210aaa4fcccb17d694b69c9927'],6,12,18,28878141,1,0,1,1,30361
12abba0b743ec198067001a64608ccbcc904a869,0,Andrew Onishuk,2017-09-25 12:38:39+03:00,['50b64758091a0df76419cbced4044e2689b5d4d1'],6,60,66,28878207,2,0,1,0,30362
06d21bb3850d2f8257c08064ab9d695d2a4c07c1,0,Alex Antonenko,2017-09-25 13:55:39+03:00,['12abba0b743ec198067001a64608ccbcc904a869'],4,22,26,28878233,2,1,1,1,30362
eb5bcef3d4382ae059e572c45c799969c6cb7dde,0,Andrii Tkach,2017-09-25 13:57:17+03:00,['06d21bb3850d2f8257c08064ab9d695d2a4c07c1'],1,2,3,28878236,1,1,1,1,30362
311c7bbd8ee94b8964a7f1769b41efc40ecdcdc6,1,Jonathan Hurley,2017-09-25 08:51:38-04:00,['eb5bcef3d4382ae059e572c45c799969c6cb7dde'],12,35,47,28878283,3,0,0,1,30362
986a65dbf4fbf36dac7073418ef368c2c207b123,0,Dmytro Sen,2017-09-25 16:32:46+03:00,['311c7bbd8ee94b8964a7f1769b41efc40ecdcdc6'],3,53,56,28878339,4,0.416666667,1,1,30362
999daefe0f09b92f42e50ff12f66dd95a112a003,0,Dmytro Sen,2017-09-25 16:39:09+03:00,['986a65dbf4fbf36dac7073418ef368c2c207b123'],0,32,32,28878371,2,0.045454545,1,1,30362
0393451c43fe06b7cac72afebd2109d9298197a8,1,Myroslav Papirkovskyi,2017-09-25 19:10:24+03:00,['999daefe0f09b92f42e50ff12f66dd95a112a003'],6,10,16,28878387,1,0,0,0,30362
4b59ba8203abf46d2c5bfa766bbf968ab964cff4,0,Myroslav Papirkovskyi,2017-09-25 19:10:33+03:00,['0393451c43fe06b7cac72afebd2109d9298197a8'],0,4,4,28878391,2,0,0,1,30362
08da9611188d9c4c246ee6d77894da5edf317860,0,Jonathan Hurley,2017-09-25 12:36:44-04:00,['4b59ba8203abf46d2c5bfa766bbf968ab964cff4'],0,55,55,28878446,3,0,0.677419355,1,30362
653d2f260c05ea0e8efa4400b9d5accb5e5b39b7,1,ababiichuk,2017-09-25 20:00:41+03:00,['08da9611188d9c4c246ee6d77894da5edf317860'],71,328,399,28878845,32,0.278350515,1,0.072164948,30364
520d8fcce38e9c2edf8d972625d5a9aa4663c04b,1,Oliver Szabo,2017-09-25 20:18:02+02:00,['653d2f260c05ea0e8efa4400b9d5accb5e5b39b7'],12,32,44,28878889,5,,,,30364
6633a7bd44fcbc660956a7e188e2ac63472c6de3,1,Oliver Szabo,2017-09-25 20:18:03+02:00,['520d8fcce38e9c2edf8d972625d5a9aa4663c04b'],342,512,854,28879743,16,1,0,0,30371
b653ee0a5967a8255f087f43a1cb6a878e765833,1,Sandor Magyari,2017-09-25 21:19:53+02:00,['6633a7bd44fcbc660956a7e188e2ac63472c6de3'],41,236,277,28880020,10,0.933333333,1,0.933333333,30373
4c49b4bd006cdd3929f5e341552b200af608bc32,1,Nate Cole,2017-09-25 16:14:35-04:00,['b653ee0a5967a8255f087f43a1cb6a878e765833'],157,87,244,28880264,6,0.942857143,0.157142857,0,30373
12c9ca7e2fafd092149081971bcfcbbb1e49adf4,0,Swapan Shridhar,2017-09-25 15:37:41-07:00,['4c49b4bd006cdd3929f5e341552b200af608bc32'],0,7,7,28880271,1,0,0,0,30373
84fed85ac9019a9b72d3db1619c7dbdf18e1d078,0,Aravindan Vijayan,2017-09-25 16:26:28-07:00,['12c9ca7e2fafd092149081971bcfcbbb1e49adf4'],0,27,27,28880298,1,,,,30373
ced70f7db01384e11b1a7f52fa0f64924eea0ab8,0,Aravindan Vijayan,2017-09-25 22:16:20-07:00,['84fed85ac9019a9b72d3db1619c7dbdf18e1d078'],18,26,44,28880342,2,0,1,1,30373
a670750c39b55178eb9971a24128d5f0e72534c2,1,Andrew Onishuk,2017-09-26 11:42:33+03:00,['79a37e51088d84bd09857b02e2d9500be5ffbe73'],64,103,167,28880509,15,1,0.826086957,1,30373
398690ac1c3cf283035e6a804d99536596c3bf6a,0,Dmytro Sen,2017-09-26 11:48:22+03:00,['ced70f7db01384e11b1a7f52fa0f64924eea0ab8'],2,2,4,28880513,1,,,,30373
af0db3509add0c4df4d6d2f70a4b70af9fcfa484,1,Miklos Gergely,2017-09-26 11:16:00+02:00,['398690ac1c3cf283035e6a804d99536596c3bf6a'],86,108,194,28880707,2,,,,30374
ee618e12490a20ab2f4f478700dbf929f7cbe6b6,1,Miklos Gergely,2017-09-26 11:22:27+02:00,['af0db3509add0c4df4d6d2f70a4b70af9fcfa484'],22,21,43,28880750,1,1,0,1,30374
6a99bd8b9723b806c6b099fc3c6836bf96f66a43,1,Venkata Sairam,2017-09-26 15:53:03+05:18,['ee618e12490a20ab2f4f478700dbf929f7cbe6b6'],3,4,7,28880757,2,0,1,1,30374
fe7a8e4bb681720021c3d4dc60f02ef422aaf3f7,1,Oliver Szabo,2017-09-26 13:51:01+02:00,['6a99bd8b9723b806c6b099fc3c6836bf96f66a43'],5,3,8,28880765,2,,,,30374
7af3152c5baf440bfc6d48f783e7133b41d434f9,1,Dmytro Sen,2017-09-26 17:13:55+03:00,['fe7a8e4bb681720021c3d4dc60f02ef422aaf3f7'],0,114,114,28880879,3,0,0,1,30375
a8736260897c937bab1318ea4991d1edd1aae1eb,1,Miklos Gergely,2017-09-26 16:41:59+02:00,['7af3152c5baf440bfc6d48f783e7133b41d434f9'],12,23,35,28880914,1,0,0,0,30375
439a9ad09d360d806befc386c5717ca576c3f221,0,Lisnichenko Dmitro,2017-09-26 18:58:52+03:00,['a8736260897c937bab1318ea4991d1edd1aae1eb'],0,39,39,28880953,2,0.1,1,1,30375
1a90a5221f0af01160d1d3fe5986d4e76977fb7d,0,Lisnichenko Dmitro,2017-09-26 19:00:33+03:00,['439a9ad09d360d806befc386c5717ca576c3f221'],1,6,7,28880960,2,0,0,1,30375
cb27cee531f9321e87e2a32fcfa9879a1439340a,0,Jonathan Hurley,2017-09-26 14:52:41-04:00,['1a90a5221f0af01160d1d3fe5986d4e76977fb7d'],4,2,6,28880966,2,1,0,0,30375
dc419b4a3940d514d714b27c06e641e69b586760,0,Nate Cole,2017-09-26 15:20:02-04:00,['cb27cee531f9321e87e2a32fcfa9879a1439340a'],4,13,17,28880983,2,0,0,1,30375
9d802b7c11a62336fd4de8aa2695af02b061c625,0,Miklos Gergely,2017-09-27 11:15:11+02:00,['dc419b4a3940d514d714b27c06e641e69b586760'],33,43,76,28881059,1,0,0,0,30375
be73d167a1c3da3053059727e1f6f88d8d624744,1,Andrew Onishuk,2017-09-28 16:23:29+03:00,"['a670750c39b55178eb9971a24128d5f0e72534c2', '9d802b7c11a62336fd4de8aa2695af02b061c625']",355177,355231,710408,29591467,5193,,,,30375
d04ce2e87442534bb27aff4ff0f5647b36945a72,0,Andrew Onishuk,2017-09-29 12:37:19+03:00,['be73d167a1c3da3053059727e1f6f88d8d624744'],266,193,459,29591926,25,1,0.75,0,30375
31344fff2ddd94923f053d6c9c6b945c299bd5d5,1,Jonathan Hurley,2017-09-29 15:40:38-04:00,['18fd04f2e3c59b3c741ac0d32083a70739203f70'],467,472,939,29592865,42,1,1,1,30375
d19f0bb7661404ccc72099621e9c2d7c97609d2a,0,Jonathan Hurley,2017-09-29 15:55:26-04:00,['31344fff2ddd94923f053d6c9c6b945c299bd5d5'],1,1,2,29592867,1,,,,30375
b84cbbe7e9a3afffab07da534541b4eb6076d50c,1,Jonathan Hurley,2017-09-29 16:01:56-04:00,['d19f0bb7661404ccc72099621e9c2d7c97609d2a'],5,5,10,29592877,3,,,,30375
d4378aacbd5bd95c0367f5b8a6865ee3bbe6de04,1,Venkata Sairam,2017-09-30 08:53:59+05:18,['b84cbbe7e9a3afffab07da534541b4eb6076d50c'],65,177,242,29593119,9,0.450980392,0.901960784,1,30375
7e6910f74b58795fc10de908eaf1103541342ac6,1,Venkata Sairam,2017-09-30 17:18:20+05:18,['d4378aacbd5bd95c0367f5b8a6865ee3bbe6de04'],4,25,29,29593148,3,0.882352941,1,1,30375
a66e2deba88aeaa33af868551b31128bcc2b4ce8,1,Venkata Sairam,2017-09-30 17:55:30+05:18,['7e6910f74b58795fc10de908eaf1103541342ac6'],6,38,44,29593192,2,1,1,1,30375
ff9ae55cd4b1728e21cf0e30e6a8040ce4e3cdab,1,Attila Doroszlai,2017-09-30 19:22:42+02:00,['a66e2deba88aeaa33af868551b31128bcc2b4ce8'],250,195,445,29593637,9,0.857142857,0,0,30375
29ea0ffb9dca3330b016c6abdb2812151641cd7e,1,Jaimin Jetly,2017-10-01 23:10:52-07:00,['ff9ae55cd4b1728e21cf0e30e6a8040ce4e3cdab'],2,10,12,29593649,2,1,1,1,30375
3889ddfca272dc4380f60fb1c7f8915998dc7603,0,Vitaly Brodetskyi,2017-10-02 11:17:33+03:00,['29ea0ffb9dca3330b016c6abdb2812151641cd7e'],1,1,2,29593651,1,,,,30375
f92da65f7d643d40e7cde0113b1f34c608fb7827,1,ababiichuk,2017-10-02 11:48:37+03:00,['3889ddfca272dc4380f60fb1c7f8915998dc7603'],10,11,21,29593672,1,,,,30375
19fe4cf1e7450c7230031c660295ec6e04958519,0,Vitaly Brodetskyi,2017-10-02 13:38:41+03:00,['f92da65f7d643d40e7cde0113b1f34c608fb7827'],0,18,18,29593690,1,,,,30375
51baa64c8a06641d3430da4e2efbcab7c5426fa2,0,Andrii Tkach,2017-10-02 15:41:11+03:00,['19fe4cf1e7450c7230031c660295ec6e04958519'],10,12,22,29593712,1,0,0,1,30375
d632c016104caf4146df32d9ea762bb81e134381,1,Andrew Onishuk,2017-10-02 15:47:34+03:00,['d04ce2e87442534bb27aff4ff0f5647b36945a72'],13,52,65,29593777,4,1,1,1,30375
9039f103da033d14efcb82684f4194d896ceef9e,0,Madhuvanthi Radhakrishnan,2017-10-02 09:37:10-07:00,['51baa64c8a06641d3430da4e2efbcab7c5426fa2'],1,5,6,29593783,1,0,0,1,30375
86afb7c1d8ad2f8367d12616abb06455c6449a2d,0,Swapan Shridhar,2017-10-02 10:27:14-07:00,['9039f103da033d14efcb82684f4194d896ceef9e'],1,1,2,29593785,1,,,,30375
60620144aabb6315c9906a46a793132f12bda15a,1,Alex Antonenko,2017-10-02 21:48:47+03:00,['86afb7c1d8ad2f8367d12616abb06455c6449a2d'],6,12,18,29593803,2,0,0,0,30375
6d51e01f48d5a588c41b47a15c88fe100d2dbf58,0,Jonathan Hurley,2017-10-02 14:56:12-04:00,['60620144aabb6315c9906a46a793132f12bda15a'],150,185,335,29594138,9,0.128205128,0,1,30375
17243c68ed31bcc1abd618bffe0426d96da897b7,0,Robert Levas,2017-10-02 16:38:32-04:00,"['3cefb74cdae3a836ee1896a30dca713e44b95f98', '19fe4cf1e7450c7230031c660295ec6e04958519']",101727,89059,190786,29784924,2192,,,,30375
11163157134c5e805923a1677c1489783bff0419,0,Nate Cole,2017-10-02 16:43:21-04:00,['6d51e01f48d5a588c41b47a15c88fe100d2dbf58'],71,101,172,29785096,7,1,1,0.555555556,30375
f36413f8bbde11f3ffbb22e969e5ff248cd7fc0a,0,Robert Levas,2017-10-02 16:44:48-04:00,"['17243c68ed31bcc1abd618bffe0426d96da897b7', '6d51e01f48d5a588c41b47a15c88fe100d2dbf58']",168,215,383,29785479,14,,,,30375
969ecfc9200efec6e4e6e45f397e0af0786c3003,1,Jaimin Jetly,2017-10-02 22:27:02-07:00,['11163157134c5e805923a1677c1489783bff0419'],25,48,73,29785552,12,1,1,1,30375
03696f16607dc84723b608a66c476ea0706bf525,1,Mugdha Varadkar,2017-10-03 11:17:00+05:18,['969ecfc9200efec6e4e6e45f397e0af0786c3003'],2,4,6,29785558,2,1,1,0,30375
f0def7cec51bbfc9ad6ded071e1b481b49b6fee2,1,Attila Doroszlai,2017-10-03 08:34:37+02:00,['d632c016104caf4146df32d9ea762bb81e134381'],1138,1007,2145,29787703,49,1,1,0.070539419,30378
b4c8e8409edcd01c70c15453a03d59248382f515,1,Attila Doroszlai,2017-10-03 11:48:55+02:00,['03696f16607dc84723b608a66c476ea0706bf525'],38,76,114,29787817,8,1,1,1,30378
05c7067a3560eebc257213691c0a947c9626f8f5,1,Alex Antonenko,2017-10-03 15:03:08+03:00,['b4c8e8409edcd01c70c15453a03d59248382f515'],1,35,36,29787853,3,1,0.75862069,1,30378
5b36cdfd87b756eba922dfd1ac5419552f4d375f,1,Dmytro Sen,2017-10-03 15:45:22+03:00,['05c7067a3560eebc257213691c0a947c9626f8f5'],2522,107,2629,29790482,79,0.578217822,0.742574257,0.104950495,30378
c28b797d2723ee11725db2b68c7ae0cabda5bc25,0,Andrew Onishuk,2017-10-03 16:14:20+03:00,['5b36cdfd87b756eba922dfd1ac5419552f4d375f'],543,14,557,29791039,7,0.488479263,0.202764977,0.207373272,30378
1f00c19d09ffe9889a6fe59df28c2905a09c1333,1,ababiichuk,2017-10-03 16:35:56+03:00,['c28b797d2723ee11725db2b68c7ae0cabda5bc25'],38,154,192,29791231,6,1,1,1,30379
1032bc5d38b518429d953049fc043da3d6ddfc9d,1,Lisnichenko Dmitro,2017-10-03 17:37:02+03:00,['1f00c19d09ffe9889a6fe59df28c2905a09c1333'],209,87,296,29791527,40,0.384615385,1,1,30379
11707ba5d40c5cab170c14cfbc5ef955ff89656a,1,Alex Antonenko,2017-10-03 18:08:30+03:00,['1032bc5d38b518429d953049fc043da3d6ddfc9d'],26,5,31,29791558,2,,,,30379
67396ba0404319c11094b7376956ab19cfe36341,0,Lisnichenko Dmitro,2017-10-03 20:47:36+03:00,['11707ba5d40c5cab170c14cfbc5ef955ff89656a'],3,0,3,29791561,1,,,,30379
45ca79b38e65756dad1095d49670d5b972e060c8,0,Robert Levas,2017-10-03 16:15:29-04:00,"['f36413f8bbde11f3ffbb22e969e5ff248cd7fc0a', '67396ba0404319c11094b7376956ab19cfe36341']",3475,628,4103,29795664,165,,,,30379
15cd1c598ba1285dcde8df47f72647f5c7fc29e7,1,ababiichuk,2017-10-04 14:08:37+03:00,['67396ba0404319c11094b7376956ab19cfe36341'],23,90,113,29795777,7,1,1,0.904761905,30379
de981ca006eba891868d97983c03a3cb019e23ef,0,Andrew Onishuk,2017-10-04 15:57:54+03:00,['15cd1c598ba1285dcde8df47f72647f5c7fc29e7'],8,3,11,29795788,3,1,0,1,30379
b4966c10b3369264c07a1daa934a4f872379cdb7,1,ababiichuk,2017-10-04 17:09:13+03:00,['de981ca006eba891868d97983c03a3cb019e23ef'],70,70,140,29795928,57,,,,30379
9eb26a0d81a4d244e150b25cdba94c5892256e6d,0,Robert Levas,2017-10-04 10:56:23-04:00,"['45ca79b38e65756dad1095d49670d5b972e060c8', 'b4966c10b3369264c07a1daa934a4f872379cdb7']",98,160,258,29796186,62,,,,30379
e1699b09265e54392ec246a17deec5043f76f54a,0,Robert Levas,2017-10-04 11:03:06-04:00,['9eb26a0d81a4d244e150b25cdba94c5892256e6d'],429,566,995,29797181,13,0,0,0.259259259,30384
8e7654a7a338ed0151db2ee0b7827495f146e90b,0,Jonathan Hurley,2017-10-04 11:23:57-04:00,['b4966c10b3369264c07a1daa934a4f872379cdb7'],0,6,6,29797187,1,1,1,1,30384
3e6aa87887932dbfe71dc24a1255320f1ab7bbd8,1,Andrii Tkach,2017-10-04 19:27:17+03:00,['8e7654a7a338ed0151db2ee0b7827495f146e90b'],15,24,39,29797226,4,,,,30384
158bd656dfe973d7aa487ae90735b315778c5463,1,Jonathan Hurley,2017-10-04 13:52:48-04:00,['3e6aa87887932dbfe71dc24a1255320f1ab7bbd8'],252,139,391,29797617,18,1,0.784810127,1,30384
d1ba22989ad81b252f2103f3ae3e674ce56bc2ea,1,Alex Antonenko,2017-10-04 21:19:52+03:00,['158bd656dfe973d7aa487ae90735b315778c5463'],47,72,119,29797736,2,1,1,1,30384
d86f76497e20b17c7ca381b3941d3fd0f82aeebf,0,Alex Antonenko,2017-10-04 21:25:08+03:00,['d1ba22989ad81b252f2103f3ae3e674ce56bc2ea'],1,3,4,29797740,1,1,1,1,30384
1da77356b0de98df51f48bedc087daf01aedbd7c,1,Nishant,2017-10-05 01:09:00+05:18,['d86f76497e20b17c7ca381b3941d3fd0f82aeebf'],11,219,230,29797970,4,0.059782609,0.972826087,0.972826087,30384
fc58250f7b0b551e0077a047a79813ea3f9bd4e1,0,Myroslav Papirkovskyi,2017-10-04 23:36:11+03:00,['1da77356b0de98df51f48bedc087daf01aedbd7c'],4,5,9,29797979,1,,,,30384
b0421821ea66d5cfda7a5f628890350218595986,1,ababiichuk,2017-10-05 12:32:50+03:00,['fc58250f7b0b551e0077a047a79813ea3f9bd4e1'],3,18,21,29798000,2,1,1,1,30384
6ecac18cb5668ec3b74fe69751dc54d65f33f698,1,Myroslav Papirkovskyi,2017-10-05 13:45:13+03:00,['f0def7cec51bbfc9ad6ded071e1b481b49b6fee2'],661,2066,2727,29800727,83,0.531944444,0.825,0.884722222,30391
cc835ae54a065051da319d96b17fe457cccbb818,0,Myroslav Papirkovskyi,2017-10-05 15:11:59+03:00,['6ecac18cb5668ec3b74fe69751dc54d65f33f698'],39,91,130,29800857,6,1,0.857142857,1,30392
2512dc83c497b96511c1faf901753ad3d9f59877,1,Attila Doroszlai,2017-10-05 16:16:25+02:00,['b0421821ea66d5cfda7a5f628890350218595986'],54,96,150,29801007,10,0.04,0.52,0.36,30392
ed378b76498e17d752353153b2596bbb0eb810d9,1,Attila Magyar,2017-10-05 17:19:31+02:00,['2512dc83c497b96511c1faf901753ad3d9f59877'],7,9,16,29801023,1,0,1,0,30392
5370297d982330cd43673afbc9a0cb341ea027f4,0,Nate Cole,2017-10-05 12:03:00-04:00,['ed378b76498e17d752353153b2596bbb0eb810d9'],3,102,105,29801128,2,0,0.357142857,1,30392
0ed128fb6403f061e376050fae7ab41e621659f2,0,Attila Doroszlai,2017-10-05 19:03:32+02:00,['5370297d982330cd43673afbc9a0cb341ea027f4'],26,40,66,29801194,1,1,1,0.333333333,30392
d5dd19389bd4b43c587f72dd8ab8230e34b98bfc,0,Di Li,2017-10-05 13:53:46-04:00,['0ed128fb6403f061e376050fae7ab41e621659f2'],1,69,70,29801264,5,0.75,0.75,0.75,30393
9adfcdcbd9b0f01b1576254bc209b1ce64b7d63f,0,Alex Antonenko,2017-10-05 21:56:31+03:00,['d5dd19389bd4b43c587f72dd8ab8230e34b98bfc'],4,10,14,29801278,2,1,1,1,30393
0f32765dc2250044c7925f4e68e6f61b7a77d8f8,1,Vitaly Brodetskyi,2017-10-06 10:40:33+03:00,['9adfcdcbd9b0f01b1576254bc209b1ce64b7d63f'],1630,1388,3018,29804296,7,1,1,0,30395
3f00252534e2dd4b08bd5d308757070fe849cba2,1,Andrii Tkach,2017-10-06 12:50:49+03:00,['0f32765dc2250044c7925f4e68e6f61b7a77d8f8'],21,51,72,29804368,6,1,1,1,30395
b609fb43fe6d77adb7606436d9772414bf002b6b,0,Dmytro Sen,2017-10-06 13:57:14+03:00,['3f00252534e2dd4b08bd5d308757070fe849cba2'],174,34,208,29804576,12,0.59375,0.3125,0.09375,30395
32bf39e7d276d825b5874e6a55a54bc69e24e294,1,Dmytro Sen,2017-10-06 16:27:13+03:00,['b609fb43fe6d77adb7606436d9772414bf002b6b'],34,174,208,29804784,12,0.40625,0.6875,0.90625,30396
7172655ff269fbb7e0d29ba93197aa5a804749c0,0,Dmytro Sen,2017-10-06 16:33:57+03:00,['32bf39e7d276d825b5874e6a55a54bc69e24e294'],364,34,398,29805182,14,0.59375,0.3125,0.09375,30396
fab2aa3c62e3dbe5cce795ca50c4b61baee1d19e,0,Alex Antonenko,2017-10-06 16:35:29+03:00,['7172655ff269fbb7e0d29ba93197aa5a804749c0'],8,49,57,29805239,2,0.243902439,0.609756098,1,30396
b358ee20e857d31017e54c1bde6f3c1aac084030,1,Dmytro Sen,2017-10-06 16:44:59+03:00,['fab2aa3c62e3dbe5cce795ca50c4b61baee1d19e'],34,364,398,29805637,14,0.40625,0.6875,0.90625,30399
f44c86690a64523aed04bfd76e5c38e194e731ba,0,Lisnichenko Dmitro,2017-10-06 17:03:10+03:00,['b358ee20e857d31017e54c1bde6f3c1aac084030'],0,6,6,29805643,1,1,1,1,30399
388cb4180b3ea08e25d95aaf67bac68e8283a518,0,Dmytro Sen,2017-10-06 17:07:41+03:00,['f44c86690a64523aed04bfd76e5c38e194e731ba'],174,34,208,29805851,14,0.59375,0.3125,0.09375,30399
a9d26986d615cee43de6bddca12fd0a23b6526b8,0,Alex Antonenko,2017-10-06 17:10:48+03:00,['388cb4180b3ea08e25d95aaf67bac68e8283a518'],7,23,30,29805881,2,1,1,1,30399
8b83a0a538358e54c5aa7f3c4eccc4a458296f9a,0,Jonathan Hurley,2017-10-06 10:38:29-04:00,['a9d26986d615cee43de6bddca12fd0a23b6526b8'],15,110,125,29806006,5,0.461538462,0.461538462,1,30399
01b79aae5553dcd89464d8f6558bdba031417a3f,0,Robert Levas,2017-10-06 12:26:16-04:00,['8b83a0a538358e54c5aa7f3c4eccc4a458296f9a'],0,9,9,29806015,1,,,,30399
2fb4649e2a9381b98c4867ac4a550f7c3ff7ed23,1,Dmytro Sen,2017-10-06 19:39:24+03:00,['01b79aae5553dcd89464d8f6558bdba031417a3f'],219,49,268,29806283,14,1,1,0,30399
e61556cc28c593ce9ab58274302b5de4982601d1,0,Swapan Shridhar,2017-10-06 11:05:04-07:00,['2fb4649e2a9381b98c4867ac4a550f7c3ff7ed23'],6,5,11,29806294,27,,,,30399
84e616da753224c43d62ddaeb8f1ef935c62d876,1,Venkata Sairam,2017-10-09 11:52:32+05:18,['e61556cc28c593ce9ab58274302b5de4982601d1'],89,45,134,29806428,2,1,0,0,30399
ce2a0a00921bde8d780c82561902773f76431fce,0,Swapan Shridhar,2017-10-09 02:41:52-07:00,['84e616da753224c43d62ddaeb8f1ef935c62d876'],234,241,475,29806903,4,,,,30399
e83c86dc310e4878f57f2cec9e32e8dc83394913,1,pallavkul,2017-10-09 16:35:14+05:18,['ce2a0a00921bde8d780c82561902773f76431fce'],61,21,82,29806985,3,0,0,0.166666667,30399
6eb273e19a81773c27f235631c54a3e142277f08,1,Andrii Tkach,2017-10-09 15:01:28+03:00,['e83c86dc310e4878f57f2cec9e32e8dc83394913'],1162,1400,2562,29809547,19,0.928571429,0.726190476,1,30404
fc80a1837cc613160e3c60cc3290b7e517b5cd45,1,Andrew Onishuk,2017-10-09 16:06:47+03:00,['6eb273e19a81773c27f235631c54a3e142277f08'],15,2190,2205,29811752,5,0.875,0.9375,0.5,30406
857bef7cdd360c8d3862024138bf99a9942fec93,0,Andrew Onishuk,2017-10-09 16:12:07+03:00,['cc835ae54a065051da319d96b17fe457cccbb818'],9,14,23,29811775,1,0,1,1,30406
beef96d413d4986cb0cc11c317d11d5a181da14c,1,pallavkul,2017-10-09 21:05:35+05:18,['fc80a1837cc613160e3c60cc3290b7e517b5cd45'],48,98,146,29811921,5,1,1,0.925,30406
f1c4626b9b4a6aafc48b71bd7d4e892362af1843,1,Jonathan Hurley,2017-10-09 12:22:35-04:00,['beef96d413d4986cb0cc11c317d11d5a181da14c'],2190,15,2205,29814126,5,0.125,0.0625,0.5,30406
75465a83bd743bb3a2fa74acf30cfca4d0a2287c,0,Attila Doroszlai,2017-10-09 18:39:22+02:00,['f1c4626b9b4a6aafc48b71bd7d4e892362af1843'],21,92,113,29814239,2,0.255813953,1,0.534883721,30406
b0c24a5153949e4c0cbf70d217276416515c1211,0,Attila Doroszlai,2017-10-09 18:57:08+02:00,['75465a83bd743bb3a2fa74acf30cfca4d0a2287c'],10,17,27,29814266,1,0,1,1,30406
5af1e539cce928b32fc5aca67c7bf8dbc2bd3c2e,1,Robert Levas,2017-10-09 13:06:19-04:00,['b0c24a5153949e4c0cbf70d217276416515c1211'],182,665,847,29815113,15,0.174672489,0.248908297,0.816593886,30406
7e0fe2913619f4b70097e3ebcd7fb89e84eee62d,0,Jaimin Jetly,2017-10-09 11:26:04-07:00,['5af1e539cce928b32fc5aca67c7bf8dbc2bd3c2e'],49,36,85,29815198,10,0,0,0,30406
0ca85137fdf1667e3fddb28c220a6e1f6e88a2ee,1,Oliver Szabo,2017-10-09 21:21:52+02:00,['7e0fe2913619f4b70097e3ebcd7fb89e84eee62d'],4,7,11,29815209,1,,,,30406
4242225ca6aa89512886bcc74eb5c49e65bd259c,1,Jaimin Jetly,2017-10-09 13:04:36-07:00,['0ca85137fdf1667e3fddb28c220a6e1f6e88a2ee'],36,49,85,29815294,10,1,1,1,30406
8cffd72227c22da2bc3bad30f1c3e877bd26cad4,0,Jonathan Hurley,2017-10-09 16:40:45-04:00,['4242225ca6aa89512886bcc74eb5c49e65bd259c'],8,76,84,29815378,2,0,0.789473684,0.789473684,30406
3b8e807100a988fafc4d55e7a0ad7644fac6cef2,1,Jonathan Hurley,2017-10-09 16:59:04-04:00,['8cffd72227c22da2bc3bad30f1c3e877bd26cad4'],241,234,475,29815853,4,,,,30406
e037a8d7194ac97da9f746e52eb53cf15ba2415f,1,Andrew Onishuk,2017-10-10 14:30:13+03:00,['3b8e807100a988fafc4d55e7a0ad7644fac6cef2'],14,37,51,29815904,3,0.785714286,0.857142857,0.357142857,30406
e19db403e8a3320a5b47503e43e2a35277149a3f,0,Andrew Onishuk,2017-10-10 15:32:10+03:00,['e037a8d7194ac97da9f746e52eb53cf15ba2415f'],36,21,57,29815961,11,0,0,1,30406
cec9f73008bb1ec101450e2915fa06c81fe64e56,1,Andrew Onishuk,2017-10-10 16:08:14+03:00,['e19db403e8a3320a5b47503e43e2a35277149a3f'],56,48,104,29816065,13,0.388888889,0.333333333,0.5,30406
b1295362b9e702dd37bbb3995437d0c4e311ce9f,1,Andrew Onishuk,2017-10-10 16:09:28+03:00,['cec9f73008bb1ec101450e2915fa06c81fe64e56'],48,56,104,29816169,13,0.611111111,0.666666667,0.5,30406
8908d3e05a546cd3dea4bf84d54f087d64ce8b88,0,Nate Cole,2017-10-10 10:18:06-04:00,['b1295362b9e702dd37bbb3995437d0c4e311ce9f'],7,18,25,29816194,2,0,0,1,30406
57682942b7368a8de3f0a76f65e45b13c1626deb,1,Sandor Magyari,2017-10-10 16:46:30+02:00,['8908d3e05a546cd3dea4bf84d54f087d64ce8b88'],21,835,856,29817050,36,0.55106383,0.719148936,0.810638298,30408
2d23e123fd9b514b8c21d973cb0237e8c3dd6b42,1,Andrii Tkach,2017-10-10 18:00:24+03:00,['57682942b7368a8de3f0a76f65e45b13c1626deb'],32,96,128,29817178,5,,,,30408
24c35893b0be52146bc821b6d44eece8fd49c50a,0,Sandor Magyari,2017-10-10 17:10:40+02:00,['2d23e123fd9b514b8c21d973cb0237e8c3dd6b42'],1,1,2,29817180,1,,,,30408
3051fa9e7b1da1c3012af85729c9bde11c9013b3,0,Myroslav Papirkovskyi,2017-10-10 18:32:59+03:00,['857bef7cdd360c8d3862024138bf99a9942fec93'],3,1,4,29817184,1,,,,30408
5ae98dbeb1ad7752d02235a61d2869be2e284f55,1,Myroslav Papirkovskyi,2017-10-10 18:37:06+03:00,['3051fa9e7b1da1c3012af85729c9bde11c9013b3'],1053,3948,5001,29822185,135,0.225763612,0.646746348,0.908366534,30417
a3a8afcd62e4c32b9972b2fcdd4744f7d6728e2a,0,Robert Levas,2017-10-10 13:14:19-04:00,['24c35893b0be52146bc821b6d44eece8fd49c50a'],30,0,30,29822215,1,,,,30417
03273bdce970a1282d89056aa48dc2ffe3b7b712,1,Tim Thorpe,2017-10-10 13:54:01-07:00,['a3a8afcd62e4c32b9972b2fcdd4744f7d6728e2a'],9,1425,1434,29823649,19,0.515625,0.53125,0,30430
7e885a390888a5cddc4cf448af3cfd225f59cf3d,0,Swapan Shridhar,2017-10-11 00:57:13-07:00,['03273bdce970a1282d89056aa48dc2ffe3b7b712'],243,250,493,29824142,5,,1,1,30430
33d67f3ead24fcda4fcdb7d5920ccc76d1743657,1,Venkata Sairam,2017-10-11 14:34:39+05:18,['7e885a390888a5cddc4cf448af3cfd225f59cf3d'],41,147,188,29824330,2,0.02,1,1,30430
aeb1865c95b86980ac31bc9362203f4bd84a027d,0,Sandor Magyari,2017-10-11 12:59:55+02:00,['33d67f3ead24fcda4fcdb7d5920ccc76d1743657'],34,0,34,29824364,2,1,0,0,30430
8ec33db0803a7c7a7ef51b87e98bc610c9c72196,1,Andrew Onishuk,2017-10-11 15:57:51+03:00,['aeb1865c95b86980ac31bc9362203f4bd84a027d'],1,2,3,29824367,1,,,,30430
c19f363c877776623fd42d285717e6e95b9036ad,1,Jonathan Hurley,2017-10-11 09:08:27-04:00,['8ec33db0803a7c7a7ef51b87e98bc610c9c72196'],11,588,599,29824966,38,0.407216495,0.659793814,0.958762887,30433
08bdd803c51b6a1c7c16d7aa04b6207538f2fd9c,0,Jonathan Hurley,2017-10-11 10:25:25-04:00,['c19f363c877776623fd42d285717e6e95b9036ad'],1,0,1,29824967,1,,,,30433
734156756c1f8b35f6af0a4c8d9669e61daa8042,0,Alex Antonenko,2017-10-11 19:02:28+03:00,['08bdd803c51b6a1c7c16d7aa04b6207538f2fd9c'],3,1,4,29824971,1,0,0,0,30433
4a47e792ae6e4fe4fb67ca80c96c5e2054f7a9cd,1,Eugene Chekanskiy,2017-10-11 19:38:41+03:00,['734156756c1f8b35f6af0a4c8d9669e61daa8042'],1,168,169,29825140,6,0,0,1,30433
6f598067f7f10b0543a3239884d380546fcdec56,1,ababiichuk,2017-10-11 20:07:35+03:00,['4a47e792ae6e4fe4fb67ca80c96c5e2054f7a9cd'],140,591,731,29825871,30,0.830188679,1,1,30439
323974e19d469313c9bafa1bda3000ea62f85bc8,0,Jonathan Hurley,2017-10-11 15:02:13-04:00,['6f598067f7f10b0543a3239884d380546fcdec56'],2,3,5,29825876,1,0,0,1,30439
c10019736972825c8b60a82c42cfe5713ddbe073,0,Nate Cole,2017-10-11 15:44:03-04:00,['323974e19d469313c9bafa1bda3000ea62f85bc8'],4,4,8,29825884,1,,,,30439
85fb356ccd13669359810e767da14d014018bac9,0,Nishant,2017-10-12 02:46:58+05:18,['c10019736972825c8b60a82c42cfe5713ddbe073'],7,7,14,29825898,2,,,,30439
5de82da3b293a0306d796d79960af45bc7c88372,1,Nitiraj Singh Rathore,2017-10-12 12:35:12+05:18,['85fb356ccd13669359810e767da14d014018bac9'],51,140,191,29826089,4,0.386666667,0.653333333,0.586666667,30439
3acfa5c12708ff00c896943cd44e81b0a9ec85d1,1,Mugdha Varadkar,2017-10-12 14:23:59+05:18,['5de82da3b293a0306d796d79960af45bc7c88372'],18,75,93,29826182,4,0,0,1,30439
c3f6ba7621963b1086b7d9754d49b8663c7892b5,0,Dmytro Sen,2017-10-12 13:52:31+03:00,['3acfa5c12708ff00c896943cd44e81b0a9ec85d1'],0,5,5,29826187,1,,,,30439
a8caac375a66911ffb13f38093731158238177ec,0,Dmytro Sen,2017-10-12 13:54:07+03:00,['c3f6ba7621963b1086b7d9754d49b8663c7892b5'],0,5,5,29826192,1,,,,30439
b86f53fbe1c940811c3e49d658aad870d1dd53da,0,Lisnichenko Dmitro,2017-10-12 13:58:23+03:00,['a8caac375a66911ffb13f38093731158238177ec'],4,12,16,29826208,1,1,1,0.5,30439
3c3b1b810ee05490fe2fe370de6132ba31bf8b72,0,Venkata Sairam,2017-10-12 16:53:12+05:18,['b86f53fbe1c940811c3e49d658aad870d1dd53da'],2,10,12,29826220,2,0,0,1,30439
be605cbfdc977ff927df89fc772b8fbb1f589fce,1,Venkata Sairam,2017-10-12 17:05:07+05:18,['3c3b1b810ee05490fe2fe370de6132ba31bf8b72'],82,44,126,29826346,3,1,0,0,30439
68df85d402b047c54f9d0324e7f94b970c5282ee,0,Alex Antonenko,2017-10-12 15:53:00+03:00,['be605cbfdc977ff927df89fc772b8fbb1f589fce'],9,19,28,29826374,4,1,1,1,30439
527e45d50f2a6faebd7cf842297aa37ef53f8b16,1,ababiichuk,2017-10-12 17:15:32+03:00,['68df85d402b047c54f9d0324e7f94b970c5282ee'],1,4,5,29826379,2,,,,30439
d88d3cc06f5355802a95db35c26e383502b658c7,0,Nishant,2017-10-12 22:25:26+05:18,['527e45d50f2a6faebd7cf842297aa37ef53f8b16'],0,1,1,29826380,1,1,1,1,30439
0f76c7f9d642bced5c89e0a25986c12c89213912,1,Robert Levas,2017-10-12 15:49:57-04:00,['d88d3cc06f5355802a95db35c26e383502b658c7'],1,33,34,29826414,4,0,0.1,0.1,30439
a8ba5e61c50ac92b787d3b2de4cec8d29da92d74,0,Venkata Sairam,2017-10-13 15:10:33+05:18,['0f76c7f9d642bced5c89e0a25986c12c89213912'],5,6,11,29826425,2,,,,30439
8f53bc453c47a4f95d5e58825feb77d69e6a6a22,1,Andrii Tkach,2017-10-13 13:45:06+03:00,['a8ba5e61c50ac92b787d3b2de4cec8d29da92d74'],77,93,170,29826595,13,1,1,1,30439
3a0d168c08edf559bc91f3eb76485797f83a6e48,1,Dmytro Sen,2017-10-13 15:53:09+03:00,['8f53bc453c47a4f95d5e58825feb77d69e6a6a22'],1,1,2,29826597,1,,,,30439
20faae7a3647943b61e46f41ce27da81e91dc519,0,Nate Cole,2017-10-13 09:19:08-04:00,['3a0d168c08edf559bc91f3eb76485797f83a6e48'],11,10,21,29826618,1,,,,30439
77d40577b11aad4fff56db206897c6ef4c39b1ed,0,Robert Levas,2017-10-13 11:10:03-04:00,"['e1699b09265e54392ec246a17deec5043f76f54a', '20faae7a3647943b61e46f41ce27da81e91dc519']",4849,9465,14314,29840932,333,,,,30439
c8c1812b07ba0f64093190519cf829df8ea639d0,0,Nishant,2017-10-13 21:54:41+05:18,['20faae7a3647943b61e46f41ce27da81e91dc519'],44,11,55,29840987,2,,,,30439
6e1cac85e33132c93fd843e402e3702ee584b947,1,Siddharth Wagle,2017-10-13 20:55:22-07:00,['c8c1812b07ba0f64093190519cf829df8ea639d0'],0,2,2,29840989,2,,,,30439
62a0a18ce57c7290989ab3ff5ffb08e88225570e,0,Siddharth Wagle,2017-10-13 20:55:36-07:00,['6e1cac85e33132c93fd843e402e3702ee584b947'],6,6,12,29841001,3,,,0,30439
329067797ecf70b765f6cd5a9febf89dcfbac0a5,0,Jayush Luniya,2017-10-13 21:15:50-07:00,['62a0a18ce57c7290989ab3ff5ffb08e88225570e'],0,1,1,29841002,1,1,1,1,30439
8c017c1fdebdbd0261749df0434dc86744dcf986,0,Nate Cole,2017-10-14 14:53:14-04:00,['329067797ecf70b765f6cd5a9febf89dcfbac0a5'],1,1,2,29841004,1,,,,30439
43fb59761595431b2a8832bafe1bfcb2fa85a1fa,1,"Toader, Sebastian",2017-10-15 07:43:51+02:00,['8c017c1fdebdbd0261749df0434dc86744dcf986'],0,42,42,29841046,3,0,0,0.571428571,30439
499fec3c1ec7ddd18fae3a415da7e4d5de82d63b,1,Aravindan Vijayan,2017-10-15 09:41:13-07:00,['43fb59761595431b2a8832bafe1bfcb2fa85a1fa'],1,39,40,29841086,8,,,,30439
df1081378e51c309589540673e140faaf9329ee4,1,Mugdha Varadkar,2017-10-16 11:03:23+05:18,['499fec3c1ec7ddd18fae3a415da7e4d5de82d63b'],1,194,195,29841281,9,0,0.925925926,0.925925926,30441
e219186ea68a869ee0b7929dfd6c5322cf8c1e7b,0,Lisnichenko Dmitro,2017-10-16 12:13:47+03:00,['df1081378e51c309589540673e140faaf9329ee4'],0,19,19,29841300,1,0.857142857,1,1,30441
d4458daa9bf5209eb2f86409185221cdbd749b13,0,Mugdha Varadkar,2017-10-16 15:23:35+05:18,['e219186ea68a869ee0b7929dfd6c5322cf8c1e7b'],0,34,34,29841334,2,,,,30441
2a8ac0ded9a9916dd71b84ac21a2a6165db60284,0,Venkata Sairam,2017-10-16 18:03:58+05:18,['d4458daa9bf5209eb2f86409185221cdbd749b13'],10,17,27,29841361,2,0,0,1,30441
0317cf7163165f4a6f90b2337bf97382679dfee4,0,Venkata Sairam,2017-10-16 18:08:06+05:18,['2a8ac0ded9a9916dd71b84ac21a2a6165db60284'],6,37,43,29841404,2,0.789473684,1,0.210526316,30441
5f86f159fae5f65b25ef77b5c9eb9cb7d1179834,0,Tim Thorpe,2017-10-16 06:16:35-07:00,['0317cf7163165f4a6f90b2337bf97382679dfee4'],34,273,307,29841711,10,0.013333333,0.693333333,0.44,30444
523f505dca99d1a8b9dd07ffabc1bad110910566,0,Jonathan Hurley,2017-10-16 12:58:02-04:00,['5f86f159fae5f65b25ef77b5c9eb9cb7d1179834'],17,16,33,29841744,2,,,,30444
4a2235037e2306ac8197f8d1bf917f5402f248bb,1,Jonathan Hurley,2017-10-16 16:13:00-04:00,['523f505dca99d1a8b9dd07ffabc1bad110910566'],86,124,210,29841954,9,,,,30444
7bb4de14443e1d80ad0c9fd7e01075acae854cb0,0,Robert Levas,2017-10-16 16:22:38-04:00,"['77d40577b11aad4fff56db206897c6ef4c39b1ed', '523f505dca99d1a8b9dd07ffabc1bad110910566']",103,675,778,29842732,43,,,,30444
75102dc4c8eb08772568cfd085682fe30f8289c6,1,Aravindan Vijayan,2017-10-16 15:58:47-07:00,['4a2235037e2306ac8197f8d1bf917f5402f248bb'],2,2,4,29842736,1,,,,30444
79d4ac220d41a6bd7c5e77b34ecc230f439cd968,1,Jonathan Hurley,2017-10-16 20:06:59-04:00,['75102dc4c8eb08772568cfd085682fe30f8289c6'],5,5,10,29842746,1,,,,30444
e19029cbd419fc6512350c365e43faff60d4acc9,0,Siddharth Wagle,2017-10-16 17:57:42-07:00,['79d4ac220d41a6bd7c5e77b34ecc230f439cd968'],8,9,17,29842763,1,,,,30444
d6cd303d0207ac6ffcdbc16d129758bba9494423,1,Mugdha Varadkar,2017-10-17 11:12:13+05:18,['e19029cbd419fc6512350c365e43faff60d4acc9'],19,21,40,29842803,2,,,,30444
dddce4dd39eef43c804a611c6623a36a9fe2dc06,1,Andrew Onishuk,2017-10-17 10:59:12+03:00,['5ae98dbeb1ad7752d02235a61d2869be2e284f55'],24,29,53,29842856,22,0,0.25,1,30444
ce29f8ce7762ed6c6d5c2f50d882b6e03b23acfc,0,Dmytro Grinenko,2017-10-17 16:53:47+03:00,['d6cd303d0207ac6ffcdbc16d129758bba9494423'],18,75,93,29842949,2,0,1,1,30444
553e4f9d25573c54860d08b0494caefd77398977,1,Robert Levas,2017-10-17 11:58:06-04:00,['7bb4de14443e1d80ad0c9fd7e01075acae854cb0'],945,898,1843,29844792,30,0,0,1,30447
448d6a8b235583a20206b790bee8170de32f27b7,0,Alex Antonenko,2017-10-17 20:26:49+03:00,['ce29f8ce7762ed6c6d5c2f50d882b6e03b23acfc'],7,29,36,29844828,7,0,,,30447
53f028e92a6a783a161b4540e48484c7ecfaaf44,0,Siddharth Wagle,2017-10-17 10:47:43-07:00,['448d6a8b235583a20206b790bee8170de32f27b7'],1,1,2,29844830,1,,,,30447
c924ebdb6da802ab70f95c6f974087645a600b78,0,Nate Cole,2017-10-17 14:18:24-04:00,['53f028e92a6a783a161b4540e48484c7ecfaaf44'],1,86,87,29844917,6,0.365853659,0.365853659,1,30447
b9f26708dd19c444918ea9b21150f66236fcdf2d,0,Swapan Shridhar,2017-10-17 13:04:52-07:00,['c924ebdb6da802ab70f95c6f974087645a600b78'],2,6,8,29844925,2,0,0.75,0.75,30447
881e15d8d5c0ad3718e50e4427b8948c723ac255,0,Yusaku Sako,2017-10-17 14:35:15-07:00,['b9f26708dd19c444918ea9b21150f66236fcdf2d'],1,48,49,29844974,1,,,,30447
ee509e08fa25545953d78450997b3a47bf68f904,0,Yusaku Sako,2017-10-17 15:41:20-07:00,['881e15d8d5c0ad3718e50e4427b8948c723ac255'],2,2,4,29844978,1,,,,30447
80354430213e6a55e2a3aa88aec4593f3fe83691,1,Myroslav Papirkovskyi,2017-10-18 13:56:26+03:00,['dddce4dd39eef43c804a611c6623a36a9fe2dc06'],17,117,134,29845112,8,0.854166667,1,1,30448
62319963b02d2cc88326ae28944b48a5869040aa,1,Myroslav Papirkovskyi,2017-10-18 16:39:58+03:00,['80354430213e6a55e2a3aa88aec4593f3fe83691'],8,19,27,29845139,3,0,0.142857143,0.857142857,30448
06676d66ee97312bedfe7894a8a5dc8eafe3eef6,0,Robert Levas,2017-10-18 10:18:07-04:00,"['553e4f9d25573c54860d08b0494caefd77398977', 'ee509e08fa25545953d78450997b3a47bf68f904']",147,403,550,29845689,33,,,,30448
f3e98bf7d3e807af6bb26e43c17322d9928fbe18,1,Myroslav Papirkovskyi,2017-10-18 17:48:56+03:00,['62319963b02d2cc88326ae28944b48a5869040aa'],18,30,48,29845737,5,0.666666667,0.833333333,0.75,30448
84342f6a851daa12ef612a96e0076ea893fd12f2,1,Alex Antonenko,2017-10-18 18:26:08+03:00,['ee509e08fa25545953d78450997b3a47bf68f904'],192,224,416,29846153,17,1,1,1,30448
29d1139235ddfa9e21909aa188ef2dcb30014bfb,1,Nate Cole,2017-10-18 13:34:43-04:00,['84342f6a851daa12ef612a96e0076ea893fd12f2'],1,2,3,29846156,1,,,,30448
c9c96cdb881e59d8a3dfe19e32069adf05fdf445,0,Yusaku Sako,2017-10-18 11:08:50-07:00,['29d1139235ddfa9e21909aa188ef2dcb30014bfb'],0,12,12,29846168,1,,,,30448
37d59f281e682c17e0a34aa7e6d9a09c927febca,1,Swapan Shridhar,2017-10-18 11:15:12-07:00,['c9c96cdb881e59d8a3dfe19e32069adf05fdf445'],6,2,8,29846176,2,1,0.25,0.25,30448
3b5cbed0983ef3e47b6a948dcbeeef0ac5d6a604,1,Swapan Shridhar,2017-10-18 13:05:40-07:00,['37d59f281e682c17e0a34aa7e6d9a09c927febca'],3,8,11,29846187,3,0,0.6,0.6,30448
8852f33b90d4983dd9927184f0c20153eaf3b065,1,Jonathan Hurley,2017-10-18 17:27:11-04:00,['3b5cbed0983ef3e47b6a948dcbeeef0ac5d6a604'],3,43,46,29846233,13,,,,30448
2ae81d99a55756bd5240a90d550d34ec2ff73927,0,Yusaku Sako,2017-10-18 15:12:07-07:00,['8852f33b90d4983dd9927184f0c20153eaf3b065'],1,1,2,29846235,1,,,,30448
b4eddc9770eda0e47fe025254ba6143a581a7855,0,Jonathan Hurley,2017-10-18 19:41:23-04:00,['2ae81d99a55756bd5240a90d550d34ec2ff73927'],7,4,11,29846246,2,,,,30448
7da02bb9ff07b5934c7a474ce3b4eb5870d0e1a8,1,Andrew Onishuk,2017-10-19 14:25:18+03:00,['f3e98bf7d3e807af6bb26e43c17322d9928fbe18'],89,100,189,29846435,40,0.3,0.3,0.9,30448
15cec1cb7d6a43361c82e2de31bf320a33005b37,1,ababiichuk,2017-10-19 15:11:48+03:00,['b4eddc9770eda0e47fe025254ba6143a581a7855'],565,1080,1645,29848080,45,0.636029412,0.919117647,0.852941176,30455
af30ab40972022ce4bff6a32b4ebdd29a33ef95d,0,Andrew Onishuk,2017-10-19 15:54:09+03:00,"['7da02bb9ff07b5934c7a474ce3b4eb5870d0e1a8', 'b4eddc9770eda0e47fe025254ba6143a581a7855']",10040,14561,24601,29872681,775,,,,30455
e76b5636ffd345f13ed7a98f7ee8f5fd5d9eb2d6,0,Lisnichenko Dmitro,2017-10-19 18:58:03+03:00,['15cec1cb7d6a43361c82e2de31bf320a33005b37'],2,12,14,29872695,2,1,1,1,30455
d57ebbc2d28ad2b9ff1697125426798d7fb7a624,0,Robert Levas,2017-10-19 16:10:14-04:00,"['06676d66ee97312bedfe7894a8a5dc8eafe3eef6', 'e76b5636ffd345f13ed7a98f7ee8f5fd5d9eb2d6']",772,1380,2152,29874847,83,,,,30455
9ac8e534d2a4bbac672ecfed447b6213aa9954ca,0,Nishant,2017-10-20 01:32:03+05:18,['e76b5636ffd345f13ed7a98f7ee8f5fd5d9eb2d6'],24,24,48,29874895,2,,,,30455
edd5ce9b78ee5d4d369936a33e4f0ca75474f1c9,0,Dmytro Sen,2017-10-20 16:26:16+03:00,['9ac8e534d2a4bbac672ecfed447b6213aa9954ca'],4,0,4,29874899,1,1,0,1,30455
d6b271e6bbcafbe57831890c9f8aa5386a57c8c3,1,Robert Levas,2017-10-20 10:03:32-04:00,['d57ebbc2d28ad2b9ff1697125426798d7fb7a624'],546,736,1282,29876181,22,0,0.52173913,0.630434783,30457
698465d5af12f2c4586d8ece3b92947f2dbf34e6,0,Robert Levas,2017-10-20 10:06:31-04:00,"['d6b271e6bbcafbe57831890c9f8aa5386a57c8c3', 'edd5ce9b78ee5d4d369936a33e4f0ca75474f1c9']",28,24,52,29876233,3,,,,30457
6df6cbe93aadac9f5c3a8b6aef695a6dab46a151,0,Alex Antonenko,2017-10-20 18:38:07+03:00,['edd5ce9b78ee5d4d369936a33e4f0ca75474f1c9'],24,8,32,29876265,2,0,0,0,30457
0c188aeae7343c76c2c0471c0b271237d0995d09,0,Yusaku Sako,2017-10-20 12:42:13-07:00,['6df6cbe93aadac9f5c3a8b6aef695a6dab46a151'],48365,7336,55701,29931966,109,0.4834655,0.341186535,0.361324076,30492
371f1f327d2b7b57df09cdf196e803213f59d993,0,Yusaku Sako,2017-10-20 12:52:03-07:00,['0c188aeae7343c76c2c0471c0b271237d0995d09'],0,1,1,29931967,1,,,,30492
5ebc2ac8d12747df1023f878a30074565c28770b,0,Yusaku Sako,2017-10-20 13:59:54-07:00,['371f1f327d2b7b57df09cdf196e803213f59d993'],1,0,1,29931968,1,,,,30492
cf5c068c781e5e488da32db58a5503d5cc9d6e0f,1,Yusaku Sako,2017-10-20 14:00:09-07:00,['5ebc2ac8d12747df1023f878a30074565c28770b'],7336,48365,55701,29987669,109,0.5165345,0.658813465,0.638675924,30550
daac7df8aa9cf412bf22de82cc2fc21b9ffaa699,1,Andrii Tkach,2017-10-23 14:56:45+03:00,['cf5c068c781e5e488da32db58a5503d5cc9d6e0f'],497,764,1261,29988930,18,0.877659574,0.877659574,0.877659574,30553
512c941b7bd2122d5078aa54b1fa9acb0fec5239,0,Jonathan Hurley,2017-10-23 09:36:04-04:00,['daac7df8aa9cf412bf22de82cc2fc21b9ffaa699'],1,1,2,29988932,1,,,,30553
cfd0f090b3a6f448fe3f07d583693aac4af1194b,0,Jonathan Hurley,2017-10-23 10:08:47-04:00,['512c941b7bd2122d5078aa54b1fa9acb0fec5239'],4,12,16,29988948,4,,,,30553
160a6ec231e4052c3b7e22d7e03de859cde7ac31,0,Robert Levas,2017-10-23 11:19:18-04:00,"['698465d5af12f2c4586d8ece3b92947f2dbf34e6', 'cfd0f090b3a6f448fe3f07d583693aac4af1194b']",526,785,1311,29990259,25,,,,30553
5ad8869a5f2a9d9d693494dc03381ffd5968fc40,0,Jonathan Hurley,2017-10-23 11:22:46-04:00,['cfd0f090b3a6f448fe3f07d583693aac4af1194b'],1,1,2,29990261,1,,,,30553
f537fe599bc5aecac10ee011601e9836b14a6fa3,0,Alex Antonenko,2017-10-23 18:28:46+03:00,['5ad8869a5f2a9d9d693494dc03381ffd5968fc40'],0,1,1,29990262,1,,,,30553
5bdede509609a53284462612262ca579686b87dc,1,Yusaku Sako,2017-10-23 10:26:19-07:00,['f537fe599bc5aecac10ee011601e9836b14a6fa3'],48401,7372,55773,30046035,128,0.4834655,0.341186535,0.361324076,30593
ceead22412dc4385fe837884594e5aad57b884d7,1,Robert Levas,2017-10-23 14:22:26-04:00,['160a6ec231e4052c3b7e22d7e03de859cde7ac31'],188,161,349,30046384,18,1,0.571428571,0,30593
467e34487f56cc8ad700a11e1a4d5a0385b2be6a,1,Dmytro Grinenko,2017-10-23 21:55:29+03:00,['5bdede509609a53284462612262ca579686b87dc'],80,337,417,30046801,24,0.321100917,0.110091743,0.605504587,30593
2ee64af51b642262f494d523060fd7cfa8471f89,0,Yusaku Sako,2017-10-23 13:30:27-07:00,['467e34487f56cc8ad700a11e1a4d5a0385b2be6a'],4,4,8,30046809,1,,,,30593
baa1fe6e6cb2368627a4968ddc55106640df3aef,1,Miklos Gergely,2017-10-24 09:00:09+02:00,['2ee64af51b642262f494d523060fd7cfa8471f89'],1,3,4,30046813,1,0,1,1,30593
655e0a7c38b45b64c210c7fa7eba1db72c5e0506,1,Yusaku Sako,2017-10-24 13:01:50-07:00,['baa1fe6e6cb2368627a4968ddc55106640df3aef'],1,1,2,30046815,1,,,,30593
479cf86ac3c17c8dcaba89280fb2dc5c9012523b,1,Andrii Tkach,2017-10-25 15:40:59+03:00,['655e0a7c38b45b64c210c7fa7eba1db72c5e0506'],688,908,1596,30048411,18,0.865384615,0.836538462,0.711538462,30597
d1d118d07b8be849e827a826a687e86f44736a59,0,Yusaku Sako,2017-10-25 15:14:52-07:00,['479cf86ac3c17c8dcaba89280fb2dc5c9012523b'],1,13,14,30048425,1,,,,30597
83e8b67223cc35134476adf7c79e365c74b808d4,0,Jonathan Hurley,2017-10-25 20:06:55-04:00,['d1d118d07b8be849e827a826a687e86f44736a59'],31,36,67,30048492,2,0,0,1,30597
42bf78b20190092ee328730974f89a1f47bda9ec,1,Andrew Onishuk,2017-10-26 10:05:01+03:00,['af30ab40972022ce4bff6a32b4ebdd29a33ef95d'],2,4,6,30048498,1,0,0,1,30597
6ff8a53768d6084066e1d5a72be894b20e61960c,0,Andrew Onishuk,2017-10-26 10:09:03+03:00,['42bf78b20190092ee328730974f89a1f47bda9ec'],1,1,2,30048500,1,,,,30597
4d3abafffc349cabcd048d4a2ad90acbc2f5b669,1,Oliver Szabo,2017-10-26 11:14:32+02:00,['83e8b67223cc35134476adf7c79e365c74b808d4'],3,3,6,30048506,3,,,,30597
7e6036c3ee7e16384df8ca372e1fa56f1d5e9e46,1,Oliver Szabo,2017-10-26 11:20:14+02:00,['4d3abafffc349cabcd048d4a2ad90acbc2f5b669'],16,7,23,30048529,4,1,0,0,30597
ada8f83b7efe874e5354111458715c8a14a94e7b,0,Myroslav Papirkovskyi,2017-10-26 19:13:56+03:00,['6ff8a53768d6084066e1d5a72be894b20e61960c'],2,16,18,30048547,2,1,1,1,30597
793ffebc8a4287b642c0f9a043c7b85493568e3d,0,Alex Antonenko,2017-10-27 13:22:04+03:00,['7e6036c3ee7e16384df8ca372e1fa56f1d5e9e46'],1,0,1,30048548,1,0,0,0,30597
08ff5a22bb20e29bc03653922b792db240fd8b55,0,Andrii Tkach,2017-10-27 14:26:41+03:00,['ada8f83b7efe874e5354111458715c8a14a94e7b'],18,37,55,30048603,5,1,1,1,30597
4103b87e9d854311827f49525c7b1076771e2aa9,1,Oliver Szabo,2017-10-27 15:10:41+02:00,['793ffebc8a4287b642c0f9a043c7b85493568e3d'],0,40,40,30048643,1,,,,30598
e455a642dd6f3b54354482b9b9cdef6f59af11b7,0,Attila Doroszlai,2017-10-27 16:40:00+02:00,['4103b87e9d854311827f49525c7b1076771e2aa9'],3,3,6,30048649,3,,,,30598
a386b35d8c32500b7942083cd1048238d816b536,0,Dmytro Grinenko,2017-10-27 20:04:06+03:00,['e455a642dd6f3b54354482b9b9cdef6f59af11b7'],0,1,1,30048650,1,,,,30598
600b06cad1213c5b117fba5032770c7468115168,1,Oliver Szabo,2017-10-28 01:57:13+02:00,['a386b35d8c32500b7942083cd1048238d816b536'],3,89,92,30048742,3,,,,30600
45be766921cd05468fd0cd8bd3923f6d91e243af,1,Oliver Szabo,2017-10-29 03:46:03+01:00,['600b06cad1213c5b117fba5032770c7468115168'],68,300,368,30049110,10,,,,30603
4be5b8d0139545e7872f3b4e1c51235c5bb5ad18,1,Oliver Szabo,2017-10-30 12:46:21+01:00,['45be766921cd05468fd0cd8bd3923f6d91e243af'],1,1,2,30049112,1,,,,30603
0041ab2540f2ad99481d8e1708e12adbee3aa404,1,Andrii Tkach,2017-10-30 14:42:43+02:00,['4be5b8d0139545e7872f3b4e1c51235c5bb5ad18'],121,253,374,30049486,6,0.047619048,0,0,30603
9d6ac96b5abf157ee813c6c6193650ac61a1590c,0,Sandor Magyari,2017-10-30 15:08:54+01:00,['0041ab2540f2ad99481d8e1708e12adbee3aa404'],1,5,6,30049492,2,0,0,1,30603
6b7a7a706d6e4d8c4a5e0300666e56f6704eb00a,1,lpuskas,2017-10-30 16:33:57+02:00,['9d6ac96b5abf157ee813c6c6193650ac61a1590c'],355,5409,5764,30055256,78,0.66875,0.953977273,0.971022727,30648
9fde9d79fcfd7f4d4c0b6068f0cb07fbe17c1cc4,1,Oliver Szabo,2017-10-30 17:03:09+01:00,['6b7a7a706d6e4d8c4a5e0300666e56f6704eb00a'],8,3,11,30055267,3,,,,30648
f95296f78c6175d62d63ccad3b9b3cc16a4c1b5b,1,Miklos Gergely,2017-10-30 17:53:07+01:00,['9fde9d79fcfd7f4d4c0b6068f0cb07fbe17c1cc4'],2,4,6,30055273,1,,,,30648
6d676a931a0311cdaf3fc5fbaf12fcbe7686001f,1,Andrew Onishuk,2017-10-30 19:02:11+02:00,['f95296f78c6175d62d63ccad3b9b3cc16a4c1b5b'],0,173,173,30055446,6,,,,30652
bd1188fdbdbc25f8def737bd403a244a324fecb1,0,Andrew Onishuk,2017-10-30 19:03:06+02:00,['08ff5a22bb20e29bc03653922b792db240fd8b55'],12,33,45,30055491,7,0,0,0,30652
a1da9934f65031e8be1dbb7216cfdac438e972c8,1,Oliver Szabo,2017-10-30 20:56:05+01:00,['6d676a931a0311cdaf3fc5fbaf12fcbe7686001f'],5,17,22,30055513,1,,,,30652
9d99c44335bea1a6847c76f55432f0a72f193e7a,1,Andrew Onishuk,2017-10-31 14:10:25+02:00,['bd1188fdbdbc25f8def737bd403a244a324fecb1'],33,12,45,30055558,7,1,1,1,30652
05c5bf798c2b69d41f3ddfa340cffc7c447ea9fb,0,Andrew Onishuk,2017-10-31 14:13:18+02:00,['9d99c44335bea1a6847c76f55432f0a72f193e7a'],12,33,45,30055603,7,0,0,0,30652
442509a80204b9d48c87a6e095dc3155aa3e140d,0,Andrew Onishuk,2017-10-31 15:01:43+02:00,['05c5bf798c2b69d41f3ddfa340cffc7c447ea9fb'],33,12,45,30055648,7,1,1,1,30652
a3745d2044a00d1758d7bd34f1bf7ab6739d0860,0,Andrew Onishuk,2017-10-31 15:04:13+02:00,['442509a80204b9d48c87a6e095dc3155aa3e140d'],0,22,22,30055670,1,0,0,0,30652
8a8d48fde61b3f4fbfc623dfb72d5c3ab5a7950a,1,Ishan Bhatt,2017-10-31 15:20:42-07:00,['a1da9934f65031e8be1dbb7216cfdac438e972c8'],3,12,15,30055685,2,,,,30652
d03c24b9f21cd91af78e0bfca2a1ce1e0de51bdf,1,Eugene Chekanskiy,2017-11-01 17:52:04+02:00,['8a8d48fde61b3f4fbfc623dfb72d5c3ab5a7950a'],216,1097,1313,30056998,48,0.694594595,0.662162162,0.656756757,30655
9095c910d8ca42023887779b59c9cfc5f49f9ea0,1,Andrew Onishuk,2017-11-02 15:42:09+02:00,['a3745d2044a00d1758d7bd34f1bf7ab6739d0860'],1,6,7,30057005,1,0,0,1,30655
a7f0f45521879d59efd1774b23711eb2d6fd27c2,1,Ishan Bhatt,2017-11-02 09:02:32-07:00,['d03c24b9f21cd91af78e0bfca2a1ce1e0de51bdf'],15,51,66,30057071,5,1,0,0,30655
f844e5f3f952b57d790a238f0bafaf7d5ba1ddca,1,Robert Levas,2017-11-02 12:37:36-04:00,['a7f0f45521879d59efd1774b23711eb2d6fd27c2'],2142,1623,3765,30060836,25,1,0.982817869,0,30657
fe02abf62b1aaee7d48d5ea36eeadfe782294aa4,0,Madhuvanthi Radhakrishnan,2017-11-02 14:51:11-07:00,['f844e5f3f952b57d790a238f0bafaf7d5ba1ddca'],1,2,3,30060839,2,0,1,1,30657
b8f7369bf31ee0186db50816206068cf8bc890df,1,Andrii Tkach,2017-11-03 12:39:30+02:00,['fe02abf62b1aaee7d48d5ea36eeadfe782294aa4'],916,10128,11044,30071883,28,0.688405797,1,1,30667
1b020cd98e8aca05097a8a829927e2d0415d480c,0,Andrii Tkach,2017-11-03 12:48:55+02:00,['b8f7369bf31ee0186db50816206068cf8bc890df'],16,28,44,30071927,3,0.125,0,0,30667
c0a57a724adc42fd33aa2d87f988d94149285817,0,Andrew Onishuk,2017-11-03 12:49:31+02:00,['9095c910d8ca42023887779b59c9cfc5f49f9ea0'],1,1,2,30071929,1,,,,30667
68bc38eb241b9f8bd3a31b81f8db0ada5e5229f7,1,Oliver Szabo,2017-11-03 14:36:06+01:00,['1b020cd98e8aca05097a8a829927e2d0415d480c'],69,36,105,30072034,5,,,,30667
65ea560d712df357722d811984069cad2f3540e0,1,Nate Cole,2017-11-03 10:10:26-04:00,['68bc38eb241b9f8bd3a31b81f8db0ada5e5229f7'],39,95,134,30072168,5,0,0.771428571,0.4,30667
afb9a66e24d718a17be87af412a44d4def7273a3,1,Jonathan Hurley,2017-11-03 14:25:36-04:00,['65ea560d712df357722d811984069cad2f3540e0'],55,26,81,30072249,12,1,0.4,0.68,30667
0c6cf8147d657923fec1c4f5fe8a234117689052,1,Nate Cole,2017-11-03 16:18:45-04:00,['afb9a66e24d718a17be87af412a44d4def7273a3'],2,10,12,30072261,2,0,1,1,30667
1fefbbacedaefe342577246f1bbb7bf3fe9c2bc1,0,Nate Cole,2017-11-04 07:25:31-04:00,['0c6cf8147d657923fec1c4f5fe8a234117689052'],3,15,18,30072279,2,0,0.6,1,30667
4656f1d4e9f3d8ee7ebbce7606fa45e3231e3aa6,1,Andrew Onishuk,2017-11-06 14:00:36+02:00,['c0a57a724adc42fd33aa2d87f988d94149285817'],165,216,381,30072660,11,1,1,0,30668
1afee6096639b26ed74178bcdd2b6984fda42b32,1,Nate Cole,2017-11-06 12:16:26-05:00,['1fefbbacedaefe342577246f1bbb7bf3fe9c2bc1'],15,600,615,30073275,13,0.053941909,0,0.900414938,30668
976153f96bc333ad6f50196edba0ce2edb8e9078,1,ababiichuk,2017-11-06 19:19:15+02:00,['1afee6096639b26ed74178bcdd2b6984fda42b32'],114,261,375,30073650,15,1,1,1,30672
ec3f1e4dcf4d0e53f10b7f7fe913b1bfdbcab82a,1,Dmytro Grinenko,2017-11-07 08:13:08+02:00,['976153f96bc333ad6f50196edba0ce2edb8e9078'],2,2,4,30073654,1,,,,30672
f74b2f873b147e7c5639e2a342fc0627b8335f47,1,ababiichuk,2017-11-07 15:27:38+02:00,['ec3f1e4dcf4d0e53f10b7f7fe913b1bfdbcab82a'],29,154,183,30073837,3,1,1,1,30672
cbce5e87971264819e4e7d62621c5463947fd863,0,Nate Cole,2017-11-07 09:23:03-05:00,['f74b2f873b147e7c5639e2a342fc0627b8335f47'],147,1,148,30073985,22,0,0,0,30672
38f6740cdacc0c18e87f1b5b979e1ddb9519dcd8,1,ababiichuk,2017-11-07 17:33:35+02:00,['cbce5e87971264819e4e7d62621c5463947fd863'],10,177,187,30074172,3,0.819047619,1,1,30672
063ba36ef5d2ae2f407b46aae3f993ab81eae310,0,Di Li,2017-11-07 10:51:48-05:00,['38f6740cdacc0c18e87f1b5b979e1ddb9519dcd8'],14,232,246,30074418,7,0.335714286,0.557142857,0.878571429,30672
654404dc8c545f47bafd8a446b99ecb251d83982,1,Oliver Szabo,2017-11-07 17:08:04+01:00,['063ba36ef5d2ae2f407b46aae3f993ab81eae310'],25,113,138,30074556,9,,,,30677
dd0421a214f2f9b6c2546bad6d2bc5d743094a40,1,Andrii Tkach,2017-11-07 19:52:10+02:00,['654404dc8c545f47bafd8a446b99ecb251d83982'],994,917,1911,30076467,17,0.393939394,0.868686869,0.646464646,30680
b8004df033be9b7ace43bf2d28820cf93e8bc4db,0,Ishan Bhatt,2017-11-07 10:56:05-08:00,['dd0421a214f2f9b6c2546bad6d2bc5d743094a40'],0,38,38,30076505,1,,,,30680
30a43c9f3e376343ebeb087e57acb0c6a5211d5a,1,Oliver Szabo,2017-11-08 11:55:04+01:00,['b8004df033be9b7ace43bf2d28820cf93e8bc4db'],3,23,26,30076531,3,1,1,1,30680
0f67d1c690f019ef5289e9bbb4aa93abb607b40b,1,Lisnichenko Dmitro,2017-11-08 13:28:03+02:00,['30a43c9f3e376343ebeb087e57acb0c6a5211d5a'],1,1,2,30076533,1,,,,30680
1577f2f0624f26377137be1924ddbba011f3ae35,0,Andrii Tkach,2017-11-08 14:42:37+02:00,['4656f1d4e9f3d8ee7ebbce7606fa45e3231e3aa6'],12,30,42,30076575,2,0,1,1,30680
08d382652052172aeb15082a919a18666de93eb7,0,Robert Levas,2017-11-08 12:26:00-05:00,['0f67d1c690f019ef5289e9bbb4aa93abb607b40b'],6,22,28,30076603,2,1,1,1,30680
b04e142b3f80d4713ed154e17c0ab877d46500a4,1,Aravindan Vijayan,2017-11-08 11:14:54-08:00,['08d382652052172aeb15082a919a18666de93eb7'],1,11,12,30076615,1,1,1,0,30680
5adcea78792cf227f15e7c08f5bb3fe2c48883d3,0,Nate Cole,2017-11-08 14:51:48-05:00,['b04e142b3f80d4713ed154e17c0ab877d46500a4'],339,20,359,30076974,29,0.465909091,0.431818182,0.159090909,30680
7074e6e8a736fbdc1bb3afb86480c6cd349611b0,0,Siddharth Wagle,2017-11-08 13:07:11-08:00,['5adcea78792cf227f15e7c08f5bb3fe2c48883d3'],1,1,2,30076976,1,,,,30680
5f714cee399a1671f73abd8d405049a45d4c743c,1,Venkata Sairam,2017-11-09 11:38:06+05:18,['7074e6e8a736fbdc1bb3afb86480c6cd349611b0'],1,10,11,30076987,1,0,1,1,30680
38476f7a1a7a371fd0f57af2f931427f1e276d27,1,ababiichuk,2017-11-09 13:24:16+02:00,['5f714cee399a1671f73abd8d405049a45d4c743c'],120,550,670,30077657,11,0.825688073,1,1,30687
444718a10479c02dc6251ab8dc56eae70723f7bb,1,Oliver Szabo,2017-11-09 14:19:17+01:00,['38476f7a1a7a371fd0f57af2f931427f1e276d27'],2,2,4,30077661,2,,,,30687
780e91e6124f39fcd67e58369ed2a42da2a6f247,1,Jonathan Hurley,2017-11-09 08:23:15-05:00,['444718a10479c02dc6251ab8dc56eae70723f7bb'],89,38,127,30077788,21,0.825,0.45,0.35,30687
eb156a92dd7317609e6a895db9bbd9b56f5a1a3f,1,Andrew Onishuk,2017-11-09 16:00:24+02:00,['1577f2f0624f26377137be1924ddbba011f3ae35'],4,21,25,30077813,4,1,0.888888889,1,30687
e968b12186848edd7b4e8b7103e8283b61f59c50,0,Andrew Onishuk,2017-11-09 16:37:58+02:00,['780e91e6124f39fcd67e58369ed2a42da2a6f247'],3,0,3,30077816,1,1,1,0,30687
430dcbf1224996c76276a8c40fb58eb54addd10a,1,Andrii Tkach,2017-11-09 16:53:02+02:00,['e968b12186848edd7b4e8b7103e8283b61f59c50'],323,173,496,30078312,16,1,1,0.25,30688
c693de3650d9b115a3da7639dbd97931c6ebb61b,1,Madhuvanthi Radhakrishnan,2017-11-09 11:09:32-08:00,['430dcbf1224996c76276a8c40fb58eb54addd10a'],0,5,5,30078317,1,,,,30688
feccebcb9b4cf56d8ea0cc021d5250a711f37596,1,Jonathan Hurley,2017-11-09 16:36:49-05:00,['c693de3650d9b115a3da7639dbd97931c6ebb61b'],8,44,52,30078369,10,,,,30688
46ad6c6878b00f7791845ecf7c2b3fef7244faad,0,Andrew Onishuk,2017-11-10 12:53:06+02:00,['feccebcb9b4cf56d8ea0cc021d5250a711f37596'],12,24,36,30078405,5,0,0.833333333,0.833333333,30688
98915a114769c7ddd590854ccf0ab33beabddcf3,0,Andrew Onishuk,2017-11-10 13:28:27+02:00,['46ad6c6878b00f7791845ecf7c2b3fef7244faad'],3,16,19,30078424,3,0,0,0,30688
22b2d55f646ebd965834e43536056c5f229e236e,1,Robert Levas,2017-11-10 10:46:01-05:00,['98915a114769c7ddd590854ccf0ab33beabddcf3'],49,23,72,30078496,4,0,0,0,30688
ec02a14c02529ec7fec647e6fed7c8c401f10e6d,1,Eugene Chekanskiy,2017-11-10 18:29:43+02:00,['22b2d55f646ebd965834e43536056c5f229e236e'],4,5,9,30078505,1,,,,30688
068d82f700432cf5cfa75d20924443e998d8fe87,1,Nate Cole,2017-11-10 12:00:14-05:00,['ec02a14c02529ec7fec647e6fed7c8c401f10e6d'],71,25,96,30078601,5,0.916666667,1,0.027777778,30688
7c4a7e4c52e00282e5b8b901cef14c143fd3da2b,1,ababiichuk,2017-11-10 23:53:24+02:00,['068d82f700432cf5cfa75d20924443e998d8fe87'],964,1229,2193,30080794,45,0.895833333,0.041666667,1,30688
5122671d0076612f4b39f4ae51c2ad627544d768,0,Robert Levas,2017-11-13 05:20:25-05:00,['7c4a7e4c52e00282e5b8b901cef14c143fd3da2b'],15,7,22,30080816,1,,,,30688
76349ac20d8955b3f25383b6f4f209a690b38bef,1,Lisnichenko Dmitro,2017-11-13 13:30:26+02:00,['5122671d0076612f4b39f4ae51c2ad627544d768'],0,239,239,30081055,11,0.325301205,1,1,30690
6e706d427f1f9bcfc61f986ea1a1d5f5a28d500f,0,Lisnichenko Dmitro,2017-11-13 16:35:23+02:00,['76349ac20d8955b3f25383b6f4f209a690b38bef'],1,0,1,30081056,1,,,,30690
18e549034e893aac4ade80e49bda70604d5147f3,1,Eugene Chekanskiy,2017-11-13 17:01:29+02:00,['6e706d427f1f9bcfc61f986ea1a1d5f5a28d500f'],43,82,125,30081181,5,0.205882353,0.205882353,0.264705882,30690
05cd35982b30f424cec0b5b9d93bc4709880a3bc,1,Andrii Tkach,2017-11-13 19:00:16+02:00,['eb156a92dd7317609e6a895db9bbd9b56f5a1a3f'],18,146,164,30081345,10,0.247058824,1,1,30692
4fa9ac5505d6604f1d74def8fc1ea6eeb3ea3fda,1,Robert Levas,2017-11-13 13:12:11-05:00,['18e549034e893aac4ade80e49bda70604d5147f3'],808,1195,2003,30083348,26,0.284313725,0.68627451,0.761437908,30694
7428e51d8e3759edf5248762f0a257a46cc053a5,1,ababiichuk,2017-11-14 00:31:01+02:00,['4fa9ac5505d6604f1d74def8fc1ea6eeb3ea3fda'],31,328,359,30083707,17,0.696078431,1,0.921568627,30696
d11faab139761a3e32da773e190951d10d1166f1,1,Andrii Tkach,2017-11-14 11:21:46+02:00,['7428e51d8e3759edf5248762f0a257a46cc053a5'],70,65,135,30083842,8,,,,30696
d0ef1449af23e22ee6b95726ce4ca0b1f3544cc4,0,Andrii Tkach,2017-11-14 18:11:56+02:00,['d11faab139761a3e32da773e190951d10d1166f1'],2,4,6,30083848,1,,,,30696
ed7e121f3aee519ee18e53b4d0b05661cca4b48a,0,Attila Doroszlai,2017-11-14 18:30:01+01:00,['d0ef1449af23e22ee6b95726ce4ca0b1f3544cc4'],56,212,268,30084116,83,,,,30696
3297dfa6542f9cffef2ae36ef0e777fe4c3e829c,1,Dmytro Grinenko,2017-11-14 20:12:47+02:00,['ed7e121f3aee519ee18e53b4d0b05661cca4b48a'],2,2,4,30084120,1,,,,30696
869e1aaeaaf8a03a374bfe8d7fd992e1a048aaad,0,Madhuvanthi Radhakrishnan,2017-11-14 11:57:05-08:00,['3297dfa6542f9cffef2ae36ef0e777fe4c3e829c'],1,16,17,30084137,1,,,,30696
ba00ed956706cc80deff58f22799ed54a8bcadd8,1,Nate Cole,2017-11-14 18:39:14-05:00,['869e1aaeaaf8a03a374bfe8d7fd992e1a048aaad'],20,339,359,30084496,29,0.534090909,0.568181818,0.840909091,30697
eec5936bd4819ca83f65c2456c71f83ca59b4f2d,1,Andrii Tkach,2017-11-15 11:32:58+02:00,['05cd35982b30f424cec0b5b9d93bc4709880a3bc'],67,156,223,30084719,11,0.447368421,1,1,30699
2b917f491f5577a85ec88380d7f3f93397cececf,1,Oliver Szabo,2017-11-15 11:43:00+01:00,['ba00ed956706cc80deff58f22799ed54a8bcadd8'],5,16,21,30084740,3,0,1,1,30699
a4e7bf379dc2392253bd9bad3ab42ab9c2d9552e,1,Attila Doroszlai,2017-11-15 12:56:23+01:00,['2b917f491f5577a85ec88380d7f3f93397cececf'],3,1,4,30084744,1,1,0,1,30699
54e84d4036f737916dadc7c3231ffc3773795219,0,Andrii Tkach,2017-11-15 15:36:41+02:00,['eec5936bd4819ca83f65c2456c71f83ca59b4f2d'],139,171,310,30085054,14,0.952380952,1,1,30699
1a99da4470d3ce1d928ab56f1a4c2845f940ef53,1,Oliver Szabo,2017-11-15 16:13:53+01:00,['a4e7bf379dc2392253bd9bad3ab42ab9c2d9552e'],0,1,1,30085055,1,,,,30699
2d81d49fb3cc5fefbed079e7994cea7b41c5a125,1,ababiichuk,2017-11-15 18:16:16+02:00,['1a99da4470d3ce1d928ab56f1a4c2845f940ef53'],61,62,123,30085178,1,0.142857143,0,0,30699
3f2743b58ba65c4bdc7d37df5348d17124bf305a,1,Robert Levas,2017-11-15 12:11:34-05:00,['2d81d49fb3cc5fefbed079e7994cea7b41c5a125'],734,1036,1770,30086948,50,1,1,0.265957447,30703
99152d3257a0eb4180283fa882f8283a3eaba196,1,Nate Cole,2017-11-15 12:52:50-05:00,['3f2743b58ba65c4bdc7d37df5348d17124bf305a'],4,5,9,30086957,2,,,,30703
c67a3246e2121c6977094e10cdb1414f45cf1482,1,Jonathan Hurley,2017-11-15 15:30:36-05:00,['99152d3257a0eb4180283fa882f8283a3eaba196'],14,80,94,30087051,3,0.03125,0.84375,0.625,30703
8fe6ac4bd03739202a35f8862270be7dcec95421,0,Vivek Ratnavel Subramanian,2017-11-15 14:28:22-08:00,['c67a3246e2121c6977094e10cdb1414f45cf1482'],3,8,11,30087062,2,,,,30703
0936f463042cf5ba195b0461479d8c29c88330dd,0,Jonathan Hurley,2017-11-15 17:40:29-05:00,['8fe6ac4bd03739202a35f8862270be7dcec95421'],1,9,10,30087072,1,0,1,1,30703
4042f9fde14548be77a5ed5daf45364df307c08a,0,Swapan Shridhar,2017-11-15 16:21:31-08:00,['0936f463042cf5ba195b0461479d8c29c88330dd'],25,122,147,30087219,4,,,,30704
f087874e7b0bc1e5b5a2398c7571264aaec15fa5,0,Andrew Onishuk,2017-11-16 12:26:56+02:00,['4042f9fde14548be77a5ed5daf45364df307c08a'],0,1,1,30087220,1,,,,30704
a393926c5cdae85b567349c89098712d21a5e1ec,0,Jonathan Hurley,2017-11-16 11:46:27-05:00,['f087874e7b0bc1e5b5a2398c7571264aaec15fa5'],0,9,9,30087229,1,0,1,1,30704
f51b1ccabbd952316979a35f398561e962164aab,0,Di Li,2017-11-16 13:47:56-05:00,['a393926c5cdae85b567349c89098712d21a5e1ec'],2,632,634,30087863,8,0.269387755,0.669387755,0.742857143,30707
365c91e92698f6a566b8503486f80c736af79e70,0,Jonathan Hurley,2017-11-16 14:12:32-05:00,['f51b1ccabbd952316979a35f398561e962164aab'],0,3,3,30087866,1,0,1,1,30707
d173011c8b52d99708c842a6d6263b09695b128c,0,Robert Levas,2017-11-16 14:45:02-05:00,"['ceead22412dc4385fe837884594e5aad57b884d7', '365c91e92698f6a566b8503486f80c736af79e70']",56420,35194,91614,30179480,736,,,,30707
18c4af48c8f409fa083172df6b04e94d010d8410,1,Dmytro Grinenko,2017-11-17 10:23:55+02:00,['365c91e92698f6a566b8503486f80c736af79e70'],444,530,974,30180454,14,0.363636364,0.113636364,1,30707
1d1c55644d77ea0e63683001cdb7303c4d379d8b,0,Dmytro Grinenko,2017-11-17 11:25:15+02:00,['18c4af48c8f409fa083172df6b04e94d010d8410'],4,0,4,30180458,2,,,,30707
e95d34300225b57bdba141ec085173c4e8f41314,0,Vitaly Brodetskyi,2017-11-17 15:15:48+02:00,['1d1c55644d77ea0e63683001cdb7303c4d379d8b'],3,3,6,30180464,3,,,,30707
430127b4b03513931d3d240d958516e412ed05de,0,Andrii Tkach,2017-11-17 16:30:34+02:00,['e95d34300225b57bdba141ec085173c4e8f41314'],817,391,1208,30181672,15,0.69379845,0.093023256,0.023255814,30707
5f8dcda67122dae7a7792a808d8548230c12af94,1,Nate Cole,2017-11-17 15:14:09-05:00,['430127b4b03513931d3d240d958516e412ed05de'],30,334,364,30182036,16,0.223684211,0.789473684,0.907894737,30709
2d9fd418abee49b4c5410cc85b8e8520e3702c39,0,Attila Doroszlai,2017-11-18 20:42:12+01:00,['5f8dcda67122dae7a7792a808d8548230c12af94'],12,0,12,30182048,4,,,,30709
8b820346ca2902016ee2d5d7d5d3ff5d60126933,0,Mugdha Varadkar,2017-11-20 10:45:23+05:18,['2d9fd418abee49b4c5410cc85b8e8520e3702c39'],52,0,52,30182100,2,,,,30709
786d4b63349d2c0f18d8a06a29fe1cc5598cf8fc,1,Dmytro Grinenko,2017-11-20 07:37:02+02:00,['8b820346ca2902016ee2d5d7d5d3ff5d60126933'],17,32,49,30182149,8,0,0,1,30709
cc535c841f28ea50cf659ada8e573e84141146ac,1,ababiichuk,2017-11-20 13:33:47+02:00,['786d4b63349d2c0f18d8a06a29fe1cc5598cf8fc'],243,710,953,30183102,20,0.253424658,1,0.732876712,30716
af8c40178f4caf56404d688ec56c252e25de3aef,1,Andrii Tkach,2017-11-20 16:18:27+02:00,['cc535c841f28ea50cf659ada8e573e84141146ac'],13,176,189,30183291,4,1,1,0.842519685,30717
9910c49716d3d31eae665ab1ba0f8fbafd33c1bf,0,Aravindan Vijayan,2017-11-20 10:44:50-08:00,['af8c40178f4caf56404d688ec56c252e25de3aef'],1,0,1,30183292,1,,,,30717
3f836c0a5dc97d47a4bdb6192a4cc3cdeea643ac,1,Alex Antonenko,2017-11-21 20:07:03+03:00,['9910c49716d3d31eae665ab1ba0f8fbafd33c1bf'],5,19,24,30183316,3,0,1,1,30717
f331f86d1b3d4414d3ccfe4102c1fde31b517830,1,Andrew Onishuk,2017-11-22 13:11:10+02:00,['3f836c0a5dc97d47a4bdb6192a4cc3cdeea643ac'],1520,45,1565,30184881,10,0.601359003,0.359003398,0.141562854,30717
930c7d5004cb03e28de4cd24b15c2aaabb66b1ce,1,Andrew Onishuk,2017-11-22 13:15:29+02:00,['f331f86d1b3d4414d3ccfe4102c1fde31b517830'],19,181,200,30185081,7,0.25,0.553571429,1,30718
135d88bc1c9e650a6ff969bb1468cdd3a386a011,1,Andrew Onishuk,2017-11-22 13:31:36+02:00,['930c7d5004cb03e28de4cd24b15c2aaabb66b1ce'],2,1535,1537,30186618,2,0.410228509,0.650707291,0.86289445,30719
7eb14a0a563eb478d3e47d910c4dbf66b05fdfdf,1,Andrew Onishuk,2017-11-22 13:45:30+02:00,['135d88bc1c9e650a6ff969bb1468cdd3a386a011'],230,96,326,30186944,23,1,1,1,30719
8dd9acc64f4411db96ed0582433e0d44f012c916,0,Andrii Tkach,2017-11-22 14:18:39+02:00,['7eb14a0a563eb478d3e47d910c4dbf66b05fdfdf'],1,1,2,30186946,1,0,0,0,30719
b902c133035cc952a9081f5c0ffc8e967c2e6f44,0,Andrew Onishuk,2017-11-22 14:52:43+02:00,['8dd9acc64f4411db96ed0582433e0d44f012c916'],3,12,15,30186961,4,,,,30719
9572882fdd345ac35a2b509d7e616579734d4fde,1,Dmytro Grinenko,2017-11-22 15:55:56+02:00,['b902c133035cc952a9081f5c0ffc8e967c2e6f44'],117,165,282,30187243,5,1,1,0.090909091,30719
5dd334c513435717a7264f2092f5b281f5d2ce8f,0,Andrew Onishuk,2017-11-22 16:37:06+02:00,['9572882fdd345ac35a2b509d7e616579734d4fde'],5,3,8,30187251,2,1,1,0,30719
b1acd1dfe214f1d381af6cdb54300daa78cbd37f,0,Lisnichenko Dmitro,2017-11-22 17:06:30+02:00,['5dd334c513435717a7264f2092f5b281f5d2ce8f'],10,31,41,30187292,1,1,1,1,30719
cadbf3542ce9e8ffad2aa32668518cb07464234d,0,Lisnichenko Dmitro,2017-11-22 17:44:36+02:00,['b1acd1dfe214f1d381af6cdb54300daa78cbd37f'],4,15,19,30187311,2,0,0,1,30719
f343e8c0f596d9bd3610c23b387c370dbf6f6028,0,Alex Antonenko,2017-11-22 21:19:23+03:00,['cadbf3542ce9e8ffad2aa32668518cb07464234d'],0,7,7,30187318,1,1,1,1,30719
65ca08455f05b7c7e9352723f2bea21e86bc43e8,1,Swapan Shridhar,2017-11-22 10:20:02-08:00,['f343e8c0f596d9bd3610c23b387c370dbf6f6028'],36,564,600,30187918,5,0.040816327,0.540816327,1,30719
9d3eeaaa9eca4cda1b3c675da9341516d9d19706,0,Swapan Shridhar,2017-11-22 10:24:38-08:00,['65ca08455f05b7c7e9352723f2bea21e86bc43e8'],3,84,87,30188005,3,0.5,0.5,1,30720
2c46bb3ea9b7868ddc087acc320e624cfa601436,1,Jonathan Hurley,2017-11-22 14:31:38-05:00,['9d3eeaaa9eca4cda1b3c675da9341516d9d19706'],15,113,128,30188133,9,0,0,1,30720
5d421b7abd557a0ab915e03cee8df59cd4760178,0,Myroslav Papirkovskyi,2017-11-22 22:14:39+02:00,['2c46bb3ea9b7868ddc087acc320e624cfa601436'],13,12,25,30188158,6,,,,30720
bce0bd8f9424828d0d43ad5e427dff7259496e64,1,ababiichuk,2017-11-23 00:47:34+02:00,['5d421b7abd557a0ab915e03cee8df59cd4760178'],18,61,79,30188237,6,0,0,0,30720
1d4cbc8aca2eddd0294b27755ec5769c66bf6b80,0,"Doroszlai, Attila",2017-11-23 00:35:09+01:00,['bce0bd8f9424828d0d43ad5e427dff7259496e64'],14,61,75,30188312,2,1,1,1,30720
9fc7223df9a50fe69f4d8884939718b3f3bcf31b,1,Vivek Ratnavel Subramanian,2017-11-22 17:01:15-08:00,['1d4cbc8aca2eddd0294b27755ec5769c66bf6b80'],14,55,69,30188381,3,1,0.947368421,1,30720
6b17d0142266f714807bd06e3ce1afbe535a0a73,1,Vivek Ratnavel Subramanian,2017-11-22 18:00:32-08:00,['9fc7223df9a50fe69f4d8884939718b3f3bcf31b'],38,103,141,30188522,8,0.846153846,1,1,30720
20dee7f817d412088e1ba41a341a9fb5bbf33080,0,Andrew Onishuk,2017-11-23 10:38:35+02:00,['6b17d0142266f714807bd06e3ce1afbe535a0a73'],2,0,2,30188524,2,1,1,0,30720
51360219866386d8103326def2a1d412348414ed,0,Venkata Sairam,2017-11-23 15:24:57+05:18,['20dee7f817d412088e1ba41a341a9fb5bbf33080'],1,2,3,30188527,1,1,1,1,30720
8e36662ae1dffe7cb637b3d1edb38278f0111012,0,Venkata Sairam,2017-11-23 15:36:52+05:18,['51360219866386d8103326def2a1d412348414ed'],6,27,33,30188560,2,0,0.888888889,0.444444444,30720
99b19e5805cf3ac291eca9c8e6a1290637b08ab6,1,Andrii Tkach,2017-11-23 14:02:00+02:00,['8e36662ae1dffe7cb637b3d1edb38278f0111012'],2196,1105,3301,30191861,42,0.767123288,0.091675448,0.012644889,30729
0249073469de5cd11f032705d609f8cb19ff28c0,0,Dmytro Grinenko,2017-11-24 16:41:12+02:00,['99b19e5805cf3ac291eca9c8e6a1290637b08ab6'],8,8,16,30191877,2,,,,30729
c5fe6cb96a6530d0fc44c4ffced2ec46db97233b,1,Aleksandr Kovalenko,2017-11-24 17:59:19+02:00,['0249073469de5cd11f032705d609f8cb19ff28c0'],61,112,173,30192050,6,0,0,1,30729
c9936ad349e3e703dcbf6f2a1644f8a3e45a23d0,0,Swapan Shridhar,2017-11-27 00:47:57-08:00,['c5fe6cb96a6530d0fc44c4ffced2ec46db97233b'],18,20,38,30192088,1,0,0,1,30729
3dca5607d736f5d70ef0a48898c2e009fd60b50a,0,Andrew Onishuk,2017-11-27 15:06:24+02:00,['c9936ad349e3e703dcbf6f2a1644f8a3e45a23d0'],11,15,26,30192114,6,0,1,1,30729
45d9ca6717c636f67ce024f1586a0f77413c17a2,1,Andrew Onishuk,2017-11-27 15:24:28+02:00,['54e84d4036f737916dadc7c3231ffc3773795219'],17,90,107,30192221,14,0.930232558,0.953488372,0.88372093,30729
32e25b80c43158bd7114f11825eaa590c9b7e8b0,1,Andrii Tkach,2017-11-27 15:41:01+02:00,['3dca5607d736f5d70ef0a48898c2e009fd60b50a'],518,647,1165,30193386,24,0.311594203,0.862318841,0.47826087,30729
1d9985cf5727bd4b8085ee0afe477b759875b348,1,Jonathan Hurley,2017-11-27 12:04:02-05:00,['32e25b80c43158bd7114f11825eaa590c9b7e8b0'],2,2,4,30193390,2,,,,30729
74bc7401cdeeec5fed8f0ba28f68d4e05d83af62,1,Oliver Szabo,2017-11-27 18:06:16+01:00,['1d9985cf5727bd4b8085ee0afe477b759875b348'],0,20,20,30193410,3,1,1,1,30729
0b98ccd75c54c147638c7380d59a067afbea8145,1,Aravindan Vijayan,2017-11-27 11:45:40-08:00,['74bc7401cdeeec5fed8f0ba28f68d4e05d83af62'],14,16,30,30193440,3,,,,30729
167b4829413d5119f11fd0bb12c8db340a78b540,0,Robert Levas,2017-11-27 15:23:58-05:00,"['d173011c8b52d99708c842a6d6263b09695b128c', '0b98ccd75c54c147638c7380d59a067afbea8145']",5053,5807,10860,30204300,229,,,,30729
b832f70620f9f018421479efbf056d8e4c014339,0,Andrew Onishuk,2017-11-28 12:16:04+02:00,['0b98ccd75c54c147638c7380d59a067afbea8145'],0,34,34,30204334,2,,,,30730
530f1d5e34eb5eb5e3e509bd9934a590bed64ac9,0,Andrew Onishuk,2017-11-28 15:30:10+02:00,['b832f70620f9f018421479efbf056d8e4c014339'],1,8,9,30204343,2,0,1,1,30730
33ee1a7381237a6cd4a5159d0f8ddc601f342529,1,Oliver Szabo,2017-11-28 15:17:31+01:00,['530f1d5e34eb5eb5e3e509bd9934a590bed64ac9'],2,2,4,30204347,1,,,,30730
2bf3c8edb26a6f0aac43699483e5ebee89dcc533,1,ababiichuk,2017-11-28 16:49:30+02:00,['33ee1a7381237a6cd4a5159d0f8ddc601f342529'],132,303,435,30204782,21,0,0,0.6,30731
393fdb8048ff579e8a55cd1b477a23d1bf105576,1,Oliver Szabo,2017-11-28 15:47:59+01:00,['2bf3c8edb26a6f0aac43699483e5ebee89dcc533'],10,1940,1950,30206732,30,0.713541667,0.903645833,0.979166667,30756
3fa1289eaaf9c30985bcf5a50725080a9eb9b368,1,Jonathan Hurley,2017-11-28 10:24:31-05:00,['393fdb8048ff579e8a55cd1b477a23d1bf105576'],16,49,65,30206797,11,,,0,30756
73d99d8c3f7f0067f06b1a0c04eccbcf9554c0bd,0,Jonathan Hurley,2017-11-28 10:30:41-05:00,['3fa1289eaaf9c30985bcf5a50725080a9eb9b368'],1,10,11,30206808,1,0,1,1,30756
020e15281e6466ae436d228dcc7428c86560882a,0,Myroslav Papirkovskyi,2017-11-28 18:31:29+02:00,['73d99d8c3f7f0067f06b1a0c04eccbcf9554c0bd'],0,14,14,30206822,2,0,0.727272727,0.727272727,30756
82af6fb6d3f11476df203d9871cc978091891cfe,0,Dmytro Grinenko,2017-11-28 19:25:28+02:00,['020e15281e6466ae436d228dcc7428c86560882a'],13,6,19,30206841,3,1,0.333333333,1,30756
aa652afe18c26ebbb52ffa1d8ecfad4270a093d7,0,Jonathan Hurley,2017-11-28 12:31:13-05:00,['82af6fb6d3f11476df203d9871cc978091891cfe'],17,59,76,30206917,2,0,0.705882353,1,30756
11d7a6ad7a1c7070e87069d5183acfeb68fe6ab9,1,Madhuvanthi Radhakrishnan,2017-11-28 10:34:26-08:00,['aa652afe18c26ebbb52ffa1d8ecfad4270a093d7'],11,11,22,30206939,2,,,,30756
31a0f1971a2be44c5322e7817a57d9e8aa1b606c,1,Jonathan Hurley,2017-11-28 15:27:27-05:00,['11d7a6ad7a1c7070e87069d5183acfeb68fe6ab9'],7,39,46,30206985,2,,,,30756
7fd404add302aed0c3d2fe52a6ddacb957a992b6,0,"Doroszlai, Attila",2017-11-28 22:37:33+01:00,['31a0f1971a2be44c5322e7817a57d9e8aa1b606c'],4,3,7,30206992,1,,,,30756
0cf82767c8f90ff858b678dde98c3eaba7d1fad4,1,Dmytro Grinenko,2017-11-29 11:07:26+02:00,['7fd404add302aed0c3d2fe52a6ddacb957a992b6'],2,28,30,30207022,2,,,,30756
eaf1fd5cee81bc8a021e2dd01ee4fc604c0ee3b0,1,Andrii Tkach,2017-11-29 13:45:32+02:00,['45d9ca6717c636f67ce024f1586a0f77413c17a2'],253,211,464,30207486,14,1,0,0,30758
ff3eca0ef9f33c45c162669a94a61a6a172ece3a,1,Jonathan Hurley,2017-11-29 10:59:02-05:00,['0cf82767c8f90ff858b678dde98c3eaba7d1fad4'],2,6,8,30207494,2,,,,30758
7750398508b7e4dc223379be107610b5a0e792fd,1,pallavkul,2017-11-29 21:41:49+05:18,['ff3eca0ef9f33c45c162669a94a61a6a172ece3a'],4,4,8,30207502,2,,,,30758
41853a1041a848b69384592c49f8f5b539a5c4f9,1,Myroslav Papirkovskyi,2017-11-29 18:30:08+02:00,['7750398508b7e4dc223379be107610b5a0e792fd'],9,116,125,30207627,8,0.590909091,0.954545455,0.681818182,30759
9bbc0ef720bc91ff39701955984bb9635d811c59,1,Myroslav Papirkovskyi,2017-11-29 18:30:08+02:00,['41853a1041a848b69384592c49f8f5b539a5c4f9'],14,95,109,30207736,7,0.764705882,0.882352941,1,30759
82692bd29d6cbc4f1eba0ae4e442e1d691843cb2,0,Myroslav Papirkovskyi,2017-11-29 18:30:08+02:00,['9bbc0ef720bc91ff39701955984bb9635d811c59'],0,2,2,30207738,2,,,,30759
e12efe38a0cdc6a0e1554026949bfeef60673a5a,0,Myroslav Papirkovskyi,2017-11-29 18:30:08+02:00,['82692bd29d6cbc4f1eba0ae4e442e1d691843cb2'],12,55,67,30207805,4,0.428571429,1,0.714285714,30759
f6fd9b5c5e04998ed0b0631c87c2d4b521e99a44,1,Myroslav Papirkovskyi,2017-11-29 18:30:08+02:00,['e12efe38a0cdc6a0e1554026949bfeef60673a5a'],2,22,24,30207829,2,0.933333333,0.933333333,1,30759
0d7f60961fba7c5706ef3d79a7d9507d097fab6e,1,Oliver Szabo,2017-11-29 17:38:35+01:00,['f6fd9b5c5e04998ed0b0631c87c2d4b521e99a44'],10,5,15,30207844,1,0,0,1,30759
deb18003619a3aade99dc6fa39e4da57762f2d60,0,Robert Levas,2017-11-29 11:58:04-05:00,"['167b4829413d5119f11fd0bb12c8db340a78b540', '0d7f60961fba7c5706ef3d79a7d9507d097fab6e']",251,2793,3044,30210888,102,,,,30759
d459d1304e5efd1c9d64a65342ecf0696b9d329f,1,Robert Levas,2017-11-29 14:41:56-05:00,['deb18003619a3aade99dc6fa39e4da57762f2d60'],266,376,642,30211530,7,0,1,0,30759
323ce7a797a65f795382c815a4068ae4b1e94bbb,1,Jonathan Hurley,2017-11-29 16:18:57-05:00,['0d7f60961fba7c5706ef3d79a7d9507d097fab6e'],6,12,18,30211548,3,0,0,1,30759
44ed90e216a02f6e0aab618359aa64275ae61dff,0,Robert Levas,2017-11-29 16:32:03-05:00,"['d459d1304e5efd1c9d64a65342ecf0696b9d329f', '323ce7a797a65f795382c815a4068ae4b1e94bbb']",6,12,18,30211566,3,,,,30759
ca174fb32a0e34582776b0607b6a2d14dc72c20d,0,Vivek Ratnavel Subramanian,2017-11-29 16:22:20-08:00,['323ce7a797a65f795382c815a4068ae4b1e94bbb'],2,6,8,30211574,2,0,1,1,30759
ff08592a32d3b8bf4c2ba2c674b73233c775f424,0,pallavkul,2017-11-30 07:04:47+05:18,['ca174fb32a0e34582776b0607b6a2d14dc72c20d'],19,19,38,30211612,1,,,,30759
19e6518d42170a33ca2e0161ec2d3abb5190f976,0,"Doroszlai, Attila",2017-11-30 09:02:46+01:00,['ff08592a32d3b8bf4c2ba2c674b73233c775f424'],2,18,20,30211632,2,0,0.888888889,1,30759
1f7bd75e0e8514539ca27fe53b7a39a01a11c285,1,Dmytro Sen,2017-11-30 10:45:18+02:00,['19e6518d42170a33ca2e0161ec2d3abb5190f976'],81,30,111,30211743,4,1,0.829268293,1,30759
c3150a4652d8b129383a9a49fc3fd78991b224b7,1,Andrii Tkach,2017-11-30 12:40:00+02:00,['1f7bd75e0e8514539ca27fe53b7a39a01a11c285'],15,104,119,30211862,8,,,,30760
4240f8496175bf9fb369b9411e71ad1127e356ad,1,Robert Levas,2017-11-30 12:04:12-05:00,['c3150a4652d8b129383a9a49fc3fd78991b224b7'],812,1105,1917,30213779,40,0.3125,0.165178571,0.495535714,30766
1a803ccab0eeaa9bd6cf45d1be1139b7a240df1e,0,Siddharth Wagle,2017-11-30 09:47:46-08:00,['4240f8496175bf9fb369b9411e71ad1127e356ad'],19,18,37,30213816,4,,,,30766
63a15872fec4ffec793878258b13b356e74528fa,1,ababiichuk,2017-11-30 20:39:06+02:00,['1a803ccab0eeaa9bd6cf45d1be1139b7a240df1e'],96,225,321,30214137,25,0.166666667,1,0.166666667,30766
d3429491a231f921ca3960ac0363c52690fb9dfa,1,Madhuvanthi Radhakrishnan,2017-11-30 11:24:44-08:00,['63a15872fec4ffec793878258b13b356e74528fa'],14,77,91,30214228,10,,,,30766
21e37b164f87edeb21b7533af1558e4758d5ee60,0,Madhuvanthi Radhakrishnan,2017-11-30 11:31:51-08:00,['d3429491a231f921ca3960ac0363c52690fb9dfa'],4,11,15,30214243,1,0,1,1,30766
4aef8fe07fdabc684e2a25c4a4b78073710a5f77,0,Siddharth Wagle,2017-11-30 11:41:48-08:00,['21e37b164f87edeb21b7533af1558e4758d5ee60'],6,5,11,30214254,3,1,1,0,30766
f8227780834f1b795a815380c8d2951fed1ea9ca,1,Madhuvanthi Radhakrishnan,2017-11-30 11:56:43-08:00,['4aef8fe07fdabc684e2a25c4a4b78073710a5f77'],0,2819,2819,30217073,8,0.666666667,1,1,30774
195195fac3fc625c21e5229af8130a854998f99b,0,Myroslav Papirkovskyi,2017-11-30 22:10:32+02:00,['f8227780834f1b795a815380c8d2951fed1ea9ca'],0,8,8,30217081,2,0,1,0.25,30774
58868f7f3352b501466c8087c68cfd420bf83abf,0,Myroslav Papirkovskyi,2017-11-30 22:35:35+02:00,['195195fac3fc625c21e5229af8130a854998f99b'],14,31,45,30217126,5,1,0.571428571,0.857142857,30774
f43277ebbe6e675c842be00ff318c966901d4a6f,0,Alex Antonenko,2017-11-30 23:03:22+02:00,['58868f7f3352b501466c8087c68cfd420bf83abf'],7,7,14,30217140,4,,,,30774
b2655aa664bf77c015b9cf320d456c850613a809,0,Aravindan Vijayan,2017-11-30 13:15:08-08:00,['f43277ebbe6e675c842be00ff318c966901d4a6f'],2,2,4,30217144,1,,,,30774
7b6fef189b7fa3090b7a10efcdf5e2427e2e0eac,1,Vivek Ratnavel Subramanian,2017-11-30 16:32:17-08:00,['b2655aa664bf77c015b9cf320d456c850613a809'],1,27,28,30217172,1,0.761904762,1,1,30774
3a802ae3ee9ee8dd944328344c4cfe19c5aaae02,0,Madhuvanthi Radhakrishnan,2017-11-30 20:28:48-08:00,['7b6fef189b7fa3090b7a10efcdf5e2427e2e0eac'],2,2,4,30217176,2,,,,30774
d95d3ebeaf9e5334828ebc5d16fa223895f49f36,0,Jayush Luniya,2017-12-14 16:41:43-08:00,['dc31e516d95a6636a27d5fbadb9b5529983587c2'],1,9,10,30217186,2,0,1,1,30774
f1f730229fe559439189726c0cd40cd58cbf0135,0,Vishal Suvagia,2017-12-15 11:08:31+05:18,['d95d3ebeaf9e5334828ebc5d16fa223895f49f36'],1,1,2,30217188,1,,,,30774
3ab1045c1f95a90159e69fbd934953927947c754,1,Dmytro Grinenko,2017-12-15 17:50:01+02:00,['f1f730229fe559439189726c0cd40cd58cbf0135'],2,4,6,30217194,2,,,,30774
856d9a53d39b1658a846311d672ba54699b73f90,0,Myroslav Papirkovskyi,2017-12-15 18:46:35+02:00,['3ab1045c1f95a90159e69fbd934953927947c754'],0,42,42,30217236,4,1,1,1,30774
ab342d77fab0baca7baabc23af8a6f86422c0642,0,Dmytro Grinenko,2017-12-16 19:27:19+02:00,['856d9a53d39b1658a846311d672ba54699b73f90'],8,3,11,30217247,1,1,0,0,30774
f9ad13d0a304414b7e37b6a61afac876912e74ce,1,ababiichuk,2017-12-18 13:30:27+02:00,['ab342d77fab0baca7baabc23af8a6f86422c0642'],1,3,4,30217251,1,,,,30774
562795c4d35bf3b45d196856e9d66e5dfdd0a17b,1,Oliver Szabo,2017-12-18 16:28:38+01:00,['f9ad13d0a304414b7e37b6a61afac876912e74ce'],657,1022,1679,30218930,61,0.604651163,0,0.604651163,30779
eab6722f705f24a1d731fa39b5e220578e231478,1,Jonathan Hurley,2017-12-18 14:34:52-05:00,['562795c4d35bf3b45d196856e9d66e5dfdd0a17b'],24,41,65,30218995,2,0,0,1,30779
1d87b21cf34c51bc19f80199e2b8641474fe098a,1,Jonathan Hurley,2017-12-18 15:10:43-05:00,['eab6722f705f24a1d731fa39b5e220578e231478'],21,28,49,30219044,5,,,,30779
fded8228015231afcae0900502db27ddc863773a,1,Jonathan Hurley,2017-12-18 15:47:45-05:00,['1d87b21cf34c51bc19f80199e2b8641474fe098a'],44,60,104,30219148,8,1,0,1,30779
2817ad481507033bccd1732943c305108585dc4b,1,Jonathan Hurley,2017-12-18 15:53:16-05:00,['fded8228015231afcae0900502db27ddc863773a'],1,36,37,30219185,1,0.846153846,0.846153846,0.153846154,30779
5c95c4a7a9c75f0b0932b3accf4fb536a3175c0e,1,Jonathan Hurley,2017-12-18 15:53:26-05:00,['2817ad481507033bccd1732943c305108585dc4b'],2,9,11,30219196,2,0,0,0,30779
afe469c98564aa7face62fe185eeb50b9b322e5f,1,Oliver Szabo,2017-12-18 22:01:44+01:00,['5c95c4a7a9c75f0b0932b3accf4fb536a3175c0e'],26,22,48,30219244,4,,,,30779
be0e87bef52458955eddf1b824e6c5ddc6f31de6,1,Robert Levas,2017-12-18 23:38:29-05:00,['afe469c98564aa7face62fe185eeb50b9b322e5f'],118,473,591,30219835,11,0.717105263,0.835526316,0.782894737,30782
90554f3810c140787cf4550358952c4438ca78e0,0,Swapan Shridhar,2017-12-18 22:40:15-08:00,['be0e87bef52458955eddf1b824e6c5ddc6f31de6'],3,19,22,30219857,4,,,,30782
30d89a3306dddf24fb2206ff22bc85c40458debd,1,Andrii Tkach,2017-12-19 14:53:08+02:00,['90554f3810c140787cf4550358952c4438ca78e0'],84,1201,1285,30221142,13,0.592777086,0.849315068,0.945205479,30787
9bb0980da1261f3be769ba26db9adb5ebaa74a55,0,Alex Antonenko,2017-12-19 16:42:37+03:00,['30d89a3306dddf24fb2206ff22bc85c40458debd'],1,1,2,30221144,1,,,,30787
f3dc1ca399c25c3f875bf52e75948839ce5d0b11,1,ababiichuk,2017-12-19 19:14:17+02:00,['9bb0980da1261f3be769ba26db9adb5ebaa74a55'],25,63,88,30221232,9,,,,30787
4e731d31f7c59bceab3c91565686384645251546,1,Attila Magyar,2017-12-20 14:16:36+01:00,['f3dc1ca399c25c3f875bf52e75948839ce5d0b11'],59,66,125,30221357,14,1,0,0.5,30787
9ea3fa154adb1328000bfb8170ea93b7faa66783,1,Attila Magyar,2017-12-20 17:34:45+01:00,['4e731d31f7c59bceab3c91565686384645251546'],4,2,6,30221363,1,1,1,0,30787
81c045452e37adc6e68379a125026ac98f8ed103,1,Andrii Tkach,2017-12-21 15:24:55+02:00,['9ea3fa154adb1328000bfb8170ea93b7faa66783'],1064,805,1869,30223232,28,0.788961039,0.107142857,0.006493506,30791
67fc4a3785da0a7c39dcb27f220c8573a59ab63d,1,Eugene Chekanskiy,2017-12-21 11:00:37-05:00,['81c045452e37adc6e68379a125026ac98f8ed103'],1935,2618,4553,30227785,47,0.698969072,0.835051546,0.853608247,30796
26bcc97bcb4016948fd28d76943eb9ad23c7a4e6,0,Di Li,2017-12-21 11:45:33-05:00,['67fc4a3785da0a7c39dcb27f220c8573a59ab63d'],1,3,4,30227789,2,1,1,1,30796
6a37985bcdab81a9c5f48b7275b951662856fa91,0,Nishant,2017-12-22 00:27:52+05:18,['26bcc97bcb4016948fd28d76943eb9ad23c7a4e6'],1,15,16,30227805,2,,,,30796
a15fc7fc1ac70d3399a1b4046c3124dcc8cdbb11,0,Di Li,2017-12-21 15:44:22-05:00,['6a37985bcdab81a9c5f48b7275b951662856fa91'],2,14,16,30227821,2,0,1,1,30796
36d0271f74a70f5cfeca0e5ca0ebeb795fab6138,1,Siddharth Wagle,2017-12-21 13:24:03-08:00,['a15fc7fc1ac70d3399a1b4046c3124dcc8cdbb11'],209,1532,1741,30229562,39,0.729910714,0.966517857,0.758928571,30811
e404100b99ffac8f14e36b46770466deeb5760d7,0,Siddharth Wagle,2017-12-21 13:30:14-08:00,['36d0271f74a70f5cfeca0e5ca0ebeb795fab6138'],12,37,49,30229611,3,0,1,1,30811
98356b36b5556735b99248d89b907d957ebef5db,0,Nate Cole,2017-12-21 20:19:34-05:00,['e404100b99ffac8f14e36b46770466deeb5760d7'],1,1,2,30229613,1,,,,30811
8ea7b198f3e998bc41b196a4c7befe9d6f92fd94,0,Andrii Tkach,2017-12-22 14:10:26+02:00,['98356b36b5556735b99248d89b907d957ebef5db'],1,1,2,30229615,1,,,,30811
32092da8377d7437d5b38e58ae58a9bebe05281a,0,Di Li,2017-12-22 11:52:46-05:00,['8ea7b198f3e998bc41b196a4c7befe9d6f92fd94'],20,24,44,30229659,2,1,1,1,30811
55f095abb3d910b8e41b4c8054143c1d6d64fdf2,1,Lisnichenko Dmitro,2017-12-22 19:27:12+02:00,['32092da8377d7437d5b38e58ae58a9bebe05281a'],19,68,87,30229746,3,0,0.423076923,1,30811
4a68e4e879ee418c61882c24f5511281740b94d1,1,Ishan Bhatt,2017-12-22 11:21:32-08:00,['55f095abb3d910b8e41b4c8054143c1d6d64fdf2'],276,240,516,30230262,8,0,0,0,30811
d74134c2eb95e89544dd02d1f19ff10faeebfec5,0,Nate Cole,2017-12-22 16:52:22-05:00,['4a68e4e879ee418c61882c24f5511281740b94d1'],7,7,14,30230276,4,,,,30811
f7ffdcb089019193c254c4fe88227dd9e90c6697,0,Yusaku Sako,2017-12-22 15:12:42-08:00,['d74134c2eb95e89544dd02d1f19ff10faeebfec5'],7,7,14,30230290,1,,,,30811
f6ee120e4f9a6b56502fef2676719fb56c143673,0,"Doroszlai, Attila",2017-12-23 10:36:21+01:00,['f7ffdcb089019193c254c4fe88227dd9e90c6697'],0,4,4,30230294,1,,,,30811
cfed3fb9d6a5a8e5bde03d655a526ad18f1e32ec,0,"Doroszlai, Attila",2017-12-23 12:31:35+01:00,['f6ee120e4f9a6b56502fef2676719fb56c143673'],1,0,1,30230295,1,,,,30811
9c7f1b7aa9d04bea2f7e68a64fd242f20c86b521,0,Mugdha Varadkar,2017-12-26 10:04:52+05:18,['cfed3fb9d6a5a8e5bde03d655a526ad18f1e32ec'],35,27,62,30230357,6,1,0.857142857,0,30811
e04b57b7e04e542764c38d54da1ef80a7eb1679d,0,Andrii Tkach,2017-12-26 12:45:24+02:00,['9c7f1b7aa9d04bea2f7e68a64fd242f20c86b521'],30,184,214,30230571,2,0,1,1,30811
415875b696f6799a7b5d4653557dca6377c4eb77,0,Dmytro Sen,2017-12-26 16:25:06+02:00,['e04b57b7e04e542764c38d54da1ef80a7eb1679d'],1,3,4,30230575,1,1,1,0,30811
935ea92aba62ec8f69be6c568b397608ef08b91f,1,Oliver Szabo,2017-12-27 11:23:11+01:00,['415875b696f6799a7b5d4653557dca6377c4eb77'],2,2,4,30230579,3,,,,30811
02887284a1d19666e52b61884ad9daf8db040e68,1,Andrii Tkach,2017-12-27 18:18:09+02:00,['935ea92aba62ec8f69be6c568b397608ef08b91f'],72,116,188,30230767,11,1,1,1,30811
c1b8cda9608180cd00384a8453e3e5f78a865cb2,0,Venkata Sairam,2017-12-28 11:55:19+05:18,['02887284a1d19666e52b61884ad9daf8db040e68'],3,8,11,30230778,1,0,0,1,30811
6db30d89fd0098bec0dacf74b085ccc4ace56947,1,Andrii Tkach,2017-12-29 15:56:19+02:00,['c1b8cda9608180cd00384a8453e3e5f78a865cb2'],11,55,66,30230844,13,1,1,1,30811
e0b085afdbcfd85e80be314a7effdb562a52951a,1,"Doroszlai, Attila",2017-12-31 23:34:01+01:00,['6db30d89fd0098bec0dacf74b085ccc4ace56947'],8,8,16,30230860,3,,,,30811
69bc10db6ed93319d4dd0be2dd7a3e85665ebeb8,0,Aleksandr Kovalenko,2017-12-01 13:29:47+02:00,['e0b085afdbcfd85e80be314a7effdb562a52951a'],112,111,223,30231083,30,1,0,0,30811
da8f54e0da11c4b5c5d6669484d30bb4b2e9dfae,1,Jonathan Hurley,2017-12-01 08:51:24-05:00,['3a802ae3ee9ee8dd944328344c4cfe19c5aaae02'],26,95,121,30231204,6,0.08,0.52,0.56,30811
a873684b829e60352b47df003cbf217e10712c6d,0,Jonathan Hurley,2017-12-01 09:05:08-05:00,['da8f54e0da11c4b5c5d6669484d30bb4b2e9dfae'],4,2,6,30231210,1,1,1,0,30811
943aa715d81301077b469c64551231169b525f50,0,Robert Levas,2017-12-01 12:14:28-05:00,['a873684b829e60352b47df003cbf217e10712c6d'],97,14,111,30231321,2,1,0.94,0,30811
88b59a6641a0b177f39e32c725acf04d85477c01,0,Alex Antonenko,2017-12-01 20:33:50+03:00,['943aa715d81301077b469c64551231169b525f50'],0,3,3,30231324,1,,,,30811
158c94ae32d31d65c2141acd4cb26ed765a181e1,0,Jonathan Hurley,2017-12-01 16:35:13-05:00,['88b59a6641a0b177f39e32c725acf04d85477c01'],2,2,4,30231328,2,,,,30811
959ad900e40c0d04c57145cd84414983175a629a,0,Nate Cole,2017-12-01 16:39:01-05:00,['158c94ae32d31d65c2141acd4cb26ed765a181e1'],2,133,135,30231463,3,0.609375,0.609375,0.9375,30811
b6cf4325ef29a7928131d415432c9bb7271621d5,0,Robert Levas,2017-12-01 16:40:26-05:00,"['44ed90e216a02f6e0aab618359aa64275ae61dff', '959ad900e40c0d04c57145cd84414983175a629a']",1224,4760,5984,30237447,129,,,,30811
47be7edce686354c11b38d32f6bff3b4318bc611,0,Madhuvanthi Radhakrishnan,2017-12-01 13:45:46-08:00,['959ad900e40c0d04c57145cd84414983175a629a'],1,1,2,30237449,1,,,,30811
5caac19def93748874f50661aabd87f5135d2a0f,0,Vivek Ratnavel Subramanian,2017-12-01 16:34:33-08:00,['47be7edce686354c11b38d32f6bff3b4318bc611'],33,36,69,30237518,4,1,1,1,30811
24c64b44d9b26e41cd1e30c93b993784008892f5,0,Yusaku Sako,2017-12-04 08:08:55-08:00,['5caac19def93748874f50661aabd87f5135d2a0f'],0,8,8,30237526,1,,,,30811
e77a31ab0aa7edbabba29ba8e4d40becf122deef,1,Lisnichenko Dmitro,2017-12-04 18:21:17+02:00,['24c64b44d9b26e41cd1e30c93b993784008892f5'],1925,1480,3405,30240931,143,0.849315068,0.043378995,0.801369863,30811
2e9c964650665028caa6351eebebe5f55e6d28ca,1,Andrii Tkach,2017-12-04 18:41:04+02:00,['e77a31ab0aa7edbabba29ba8e4d40becf122deef'],2060,896,2956,30243887,23,0.233628319,0.031858407,0,30817
0afe0c00d797f22efc94c394de86af2bec94b448,0,Jonathan Hurley,2017-12-04 14:52:43-05:00,['2e9c964650665028caa6351eebebe5f55e6d28ca'],18,0,18,30243905,2,,,,30817
c7cc5607e78991726753ef5d968d6cf2378c5f5b,0,Nate Cole,2017-12-04 14:58:25-05:00,['0afe0c00d797f22efc94c394de86af2bec94b448'],0,1,1,30243906,1,,,,30817
de4deaf0b04f69692c5226c31ad11deb228b367c,0,Robert Levas,2017-12-04 18:23:25-05:00,"['b6cf4325ef29a7928131d415432c9bb7271621d5', 'c7cc5607e78991726753ef5d968d6cf2378c5f5b']",4025,2407,6432,30250338,171,,,,30817
ddcebe23c1736a4cf2fc212fb419e6b248da4a5c,0,Robert Levas,2017-12-04 18:26:49-05:00,['c7cc5607e78991726753ef5d968d6cf2378c5f5b'],4,4,8,30250346,1,,,,30817
6613d45b7735b8b6d53eab3f450b36959c7aaee5,0,Vivek Ratnavel Subramanian,2017-12-04 16:44:01-08:00,['ddcebe23c1736a4cf2fc212fb419e6b248da4a5c'],3,0,3,30250349,1,,,,30817
1c9aa9d32804abce454c82ce4d75bfac87182b49,1,Vivek Ratnavel Subramanian,2017-12-04 16:44:29-08:00,['6613d45b7735b8b6d53eab3f450b36959c7aaee5'],7,7,14,30250363,4,,,,30817
a7ac44525d430a1f5b5144f1699fac99abf67ebf,1,Alex Antonenko,2017-12-05 17:59:12+03:00,['1c9aa9d32804abce454c82ce4d75bfac87182b49'],40,43,83,30250446,17,,,,30817
620543c6c20307b35bd3ff433edf5b5dfdc33599,1,Jonathan Hurley,2017-12-05 11:51:05-05:00,['a7ac44525d430a1f5b5144f1699fac99abf67ebf'],32,120,152,30250598,5,0,0.632653061,0.571428571,30817
86a99f202614ef9e2022528f011fcd12442e751b,1,Lisnichenko Dmitro,2017-12-05 19:32:39+02:00,['620543c6c20307b35bd3ff433edf5b5dfdc33599'],13,35,48,30250646,6,0,1,0,30817
0fe2f8fa67595c27368acd0c122e04ed11870e4a,0,Jonathan Hurley,2017-12-05 13:19:37-05:00,['86a99f202614ef9e2022528f011fcd12442e751b'],1,1,2,30250648,1,,,,30817
97ceed034a8d23f5caf6276fa48c02332d58c234,1,Venkata Sairam,2017-12-06 14:44:14+05:18,['0fe2f8fa67595c27368acd0c122e04ed11870e4a'],5,5,10,30250658,2,,,,30817
508eba0c62aa42cea5bcc660a4661ff373a5af91,1,Jonathan Hurley,2017-12-06 08:59:14-05:00,['97ceed034a8d23f5caf6276fa48c02332d58c234'],46,65,111,30250769,6,0,0.428571429,0.428571429,30817
e973986e2292323e18282ce2fc6e75fdcdcb718f,0,Robert Levas,2017-12-06 09:20:29-05:00,['508eba0c62aa42cea5bcc660a4661ff373a5af91'],6,3,9,30250778,3,,,,30817
637c521972cb3a064bd108e97a1007be10d7ef09,0,Robert Levas,2017-12-06 10:00:48-05:00,['de4deaf0b04f69692c5226c31ad11deb228b367c'],690,305,995,30251773,15,0,0,0.015625,30817
3c129fca785a671a29cd23b03903163fdd2f8390,0,Robert Levas,2017-12-06 10:05:48-05:00,['637c521972cb3a064bd108e97a1007be10d7ef09'],4,4,8,30251781,1,,,,30817
a8a7c1d35e5f1ea580620125637fc7c3a3e675f2,0,Robert Levas,2017-12-06 10:05:48-05:00,['3c129fca785a671a29cd23b03903163fdd2f8390'],3,0,3,30251784,1,,,,30817
c2e5d091319fc51b7e95ddd14befe778ac70a2c0,1,Robert Levas,2017-12-06 10:05:48-05:00,['a8a7c1d35e5f1ea580620125637fc7c3a3e675f2'],7,7,14,30251798,4,,,,30817
6484948a26629431b877c039aed6988c5be68867,0,Robert Levas,2017-12-06 10:06:07-05:00,"['c2e5d091319fc51b7e95ddd14befe778ac70a2c0', 'e973986e2292323e18282ce2fc6e75fdcdcb718f']",135,261,396,30252194,35,,,,30817
cfb2321f8769bdc92a1c08ad354e604f104ac629,0,Myroslav Papirkovskyi,2017-12-06 19:23:12+02:00,['e973986e2292323e18282ce2fc6e75fdcdcb718f'],0,6,6,30252200,1,0.666666667,0.666666667,1,30817
9f93a0186c54d66d6da28edf1eeae4a554f8d28d,0,Robert Levas,2017-12-06 12:43:19-05:00,['cfb2321f8769bdc92a1c08ad354e604f104ac629'],0,3,3,30252203,3,,,,30817
76c4fa1cabfb1b68d9cfe1599b874bf764130957,0,Robert Levas,2017-12-06 12:46:06-05:00,['9f93a0186c54d66d6da28edf1eeae4a554f8d28d'],3,0,3,30252206,3,,,,30817
9b1fde342378c91859bc60bb442b6f5ae682bec4,1,Robert Levas,2017-12-06 12:46:30-05:00,['76c4fa1cabfb1b68d9cfe1599b874bf764130957'],3,6,9,30252215,3,,,,30817
814f5b456814ca278a02c06b5df3eba009c5caca,0,Robert Levas,2017-12-06 12:49:01-05:00,['9b1fde342378c91859bc60bb442b6f5ae682bec4'],6,6,12,30252227,3,,,,30817
420385362200f3f5f714db50a20d3af727767513,1,Attila Magyar,2017-12-06 22:15:49+01:00,['814f5b456814ca278a02c06b5df3eba009c5caca'],8,10,18,30252245,3,0,0,0,30817
466379c2f8a9d0a724166bc4b3f3d9ef50bfc877,0,Aleksandr Kovalenko,2017-12-06 23:58:13+02:00,['420385362200f3f5f714db50a20d3af727767513'],1,3,4,30252249,1,1,1,1,30817
fcc92aaeea346ebef13a70ed0cfaa686785c6a0d,1,Swapan Shridhar,2017-12-06 17:54:40-08:00,['466379c2f8a9d0a724166bc4b3f3d9ef50bfc877'],1,1,2,30252251,1,,,,30817
825b97c50ab124a962c731ba0c4113a1b912aaff,0,Attila Magyar,2017-12-07 11:34:43+01:00,['fcc92aaeea346ebef13a70ed0cfaa686785c6a0d'],2,2,4,30252255,1,,,,30817
2460ea1c9ccd609375f774c32283debfd1a91cb5,1,Oliver Szabo,2017-12-07 14:28:15+01:00,['825b97c50ab124a962c731ba0c4113a1b912aaff'],1,1,2,30252257,1,,,,30817
366f6ca9bd8eec1dd03a735a67158956c2426a31,1,Andrew Onishuk,2017-12-07 16:02:06+02:00,"['eaf1fd5cee81bc8a021e2dd01ee4fc604c0ee3b0', 'c3150a4652d8b129383a9a49fc3fd78991b224b7']",61413,44589,106002,30358259,986,,,,30817
a9c3bf56a64448708dde677d063619d4c71e3492,0,Myroslav Papirkovskyi,2017-12-07 17:37:33+02:00,['2460ea1c9ccd609375f774c32283debfd1a91cb5'],0,30,30,30358289,2,0,0.291666667,0.791666667,30817
862b7d7b17e8e2ad165f548c4f9c328dd9151607,1,ababiichuk,2017-12-07 19:21:59+02:00,['a9c3bf56a64448708dde677d063619d4c71e3492'],211,259,470,30358759,14,0,1,1,30817
f4d27390f0de5a0e85c143e783312d03f24adf54,1,Di Li,2017-12-07 14:05:45-05:00,['862b7d7b17e8e2ad165f548c4f9c328dd9151607'],1,10,11,30358770,1,1,1,1,30817
367dd174a5b84eb1764d148da3b29c6c55c58a94,0,Swapan Shridhar,2017-12-07 14:02:58-08:00,['f4d27390f0de5a0e85c143e783312d03f24adf54'],1,1,2,30358772,1,,,,30817
2b285dac1667e80b89c8719f1746cb433bf0d4dc,1,ababiichuk,2017-12-08 12:33:10+02:00,['367dd174a5b84eb1764d148da3b29c6c55c58a94'],2,5,7,30358779,2,,,,30817
ed327bd53eb140789b548044ebd207b3c47ccf3b,0,Alex Antonenko,2017-12-08 14:37:44+03:00,['2b285dac1667e80b89c8719f1746cb433bf0d4dc'],1,2,3,30358782,1,1,1,1,30817
348bdd668ecf6964e2c021aeddf547b3f9bb23bf,1,Jonathan Hurley,2017-12-08 07:17:51-05:00,['ed327bd53eb140789b548044ebd207b3c47ccf3b'],3,6,9,30358791,5,,,,30817
1ed7c086e4d417b47de8a2a7b80e28956cf01d47,0,Dmytro Grinenko,2017-12-08 16:30:46+02:00,['348bdd668ecf6964e2c021aeddf547b3f9bb23bf'],3,10,13,30358804,1,0,0,0,30817
ee506295d3d911c4bc9b00233481a1db97cd9289,1,Aleksandr Kovalenko,2017-12-08 17:41:13+02:00,['1ed7c086e4d417b47de8a2a7b80e28956cf01d47'],9,10,19,30358823,4,,,,30817
b1fd131f78feda8f9fef6f33dbc8c67e3fdf539f,1,ababiichuk,2017-12-08 19:00:36+02:00,['ee506295d3d911c4bc9b00233481a1db97cd9289'],75,669,744,30359567,8,0.375,1,0.8125,30817
4f75eced9c3f6cba8fe388c934cb15d575af0c90,0,Robert Levas,2017-12-08 14:22:07-05:00,"['6484948a26629431b877c039aed6988c5be68867', 'b1fd131f78feda8f9fef6f33dbc8c67e3fdf539f']",319,1028,1347,30360914,47,,,,30817
45f2a6e44c1b92b1f841fbe5fde762783e41be35,1,Andrii Tkach,2017-12-11 14:23:44+02:00,['b1fd131f78feda8f9fef6f33dbc8c67e3fdf539f'],358,699,1057,30361971,33,0,0,0,30822
096726416556baedbc53f74ee60ea2056df90380,1,Andrew Onishuk,2017-12-11 16:15:01+02:00,['45f2a6e44c1b92b1f841fbe5fde762783e41be35'],1,1,2,30361973,1,,,,30822
f51351e5437d676ba4c0c7ccf70e91faac004e26,1,Andrew Onishuk,2017-12-11 16:18:24+02:00,['366f6ca9bd8eec1dd03a735a67158956c2426a31'],610,1493,2103,30364076,102,1,1,1,30822
4be18df873a055f343c3d3cdf6355e33c090c67f,0,Andrii Tkach,2017-12-11 17:50:21+02:00,['096726416556baedbc53f74ee60ea2056df90380'],243,8,251,30364327,3,1,1,1,30822
636a2a96cc19e7a588f70c9b91735af3008ed0e0,0,"Doroszlai, Attila",2017-12-11 20:14:07+01:00,['4be18df873a055f343c3d3cdf6355e33c090c67f'],26,31,57,30364384,3,1,1,1,30822
364e39eab44417dab72affef56e5b296bbda1604,0,Robert Levas,2017-12-11 17:02:28-05:00,"['4f75eced9c3f6cba8fe388c934cb15d575af0c90', '636a2a96cc19e7a588f70c9b91735af3008ed0e0']",626,737,1363,30365747,37,,,,30822
8e90d59c0852ad89391577207989c0f186265701,0,Yusaku Sako,2017-12-12 08:15:08-08:00,['636a2a96cc19e7a588f70c9b91735af3008ed0e0'],219,153,372,30366119,5,0.5,0.5,0,30822
8e23fa28ca33e57855301ad0255af44dc6068d0b,1,Alex Antonenko,2017-12-12 20:13:43+03:00,['8e90d59c0852ad89391577207989c0f186265701'],6,34,40,30366159,4,,,,30822
a928a9cd8f0c995e0aa5b9bc52c6b975d7f87edb,1,Jonathan Hurley,2017-12-13 13:26:56-05:00,['8e23fa28ca33e57855301ad0255af44dc6068d0b'],32,183,215,30366374,9,0.428571429,0.682539683,0.619047619,30822
068b2fe22054b47474245790a88f87e0848f7e4c,0,Robert Levas,2017-12-13 13:51:13-05:00,"['364e39eab44417dab72affef56e5b296bbda1604', '8e23fa28ca33e57855301ad0255af44dc6068d0b']",225,187,412,30366786,9,,,,30822
e46575a17d4b9877aa5a67aa87ee690c326f6a64,1,"Doroszlai, Attila",2017-12-13 21:22:08+01:00,['a928a9cd8f0c995e0aa5b9bc52c6b975d7f87edb'],2,2,4,30366790,1,,,,30822
a3d4c3da56eeec22e864978a7a8be39586948ff5,1,Siddharth Wagle,2017-12-13 13:41:33-08:00,['e46575a17d4b9877aa5a67aa87ee690c326f6a64'],27,78,105,30366895,7,0,0,1,30822
31e8e55a900e0dd4915810302da22991e7cc54e4,1,Oliver Szabo,2017-12-13 22:44:51+01:00,['a3d4c3da56eeec22e864978a7a8be39586948ff5'],1162,1445,2607,30369502,50,1,0,0,30829
dc31e516d95a6636a27d5fbadb9b5529983587c2,0,Andrii Tkach,2017-12-14 12:45:24+02:00,['31e8e55a900e0dd4915810302da22991e7cc54e4'],4,5,9,30369511,4,,,,30829
66a5083c5e9434586ef53af647081670596d982c,0,Andrew Onishuk,2017-12-14 16:59:02+02:00,"['f51351e5437d676ba4c0c7ccf70e91faac004e26', 'dc31e516d95a6636a27d5fbadb9b5529983587c2']",7595,10855,18450,30387961,449,,,,30829
1e5a47e927a137ffb7b5dc48920862dfef6927c0,1,Andrew Onishuk,2017-12-18 15:38:58+02:00,['66a5083c5e9434586ef53af647081670596d982c'],655,4313,4968,30392929,108,0,1,1,30829
fc76993b1cb45d6652a1cbe11dba2e41bd024880,1,Andrew Onishuk,2017-12-19 14:33:27+02:00,['1e5a47e927a137ffb7b5dc48920862dfef6927c0'],1095,7462,8557,30401486,92,,,,30829
e63562095812a1dcd850cff467a4fd275771ca08,1,Andrew Onishuk,2017-12-28 14:35:35+02:00,['fc76993b1cb45d6652a1cbe11dba2e41bd024880'],257,913,1170,30402656,77,0,1,0.916666667,30829
1c602b011b6230efc5240fac904f1f3eb54a296f,0,Aleksandr Kovalenko,2018-01-02 15:15:37+02:00,['69bc10db6ed93319d4dd0be2dd7a3e85665ebeb8'],111,112,223,30402879,30,0,1,1,30830
aa5b0fe7625249d497a8b50e4fe95ed0583b45b7,1,ababiichuk,2018-01-02 15:43:32+02:00,['1c602b011b6230efc5240fac904f1f3eb54a296f'],604,1918,2522,30405401,67,0.562189055,0.97761194,0.905472637,30853
a95759d2fe16ec1bc9ea38c3c06e56a354d92e82,0,Dmytro Grinenko,2018-01-02 17:25:08+02:00,['aa5b0fe7625249d497a8b50e4fe95ed0583b45b7'],1,6,7,30405408,2,1,1,1,30853
c813e055a5c7db127e67185194b07b2b415f1ec6,1,Aleksandr Kovalenko,2018-01-02 17:27:04+02:00,['a95759d2fe16ec1bc9ea38c3c06e56a354d92e82'],112,111,223,30405631,30,1,0,0,30853
a85ff23bd8737a17544983c44752a9fd602d864a,1,Oliver Szabo,2018-01-03 11:38:43+01:00,['c813e055a5c7db127e67185194b07b2b415f1ec6'],266,1322,1588,30407219,43,0.840336134,1,0.885154062,30870
13056cf2b0bf4ff20192860e2bfee556c1c57b4a,0,"Doroszlai, Attila",2018-01-04 12:53:04+01:00,['a85ff23bd8737a17544983c44752a9fd602d864a'],2,652,654,30407873,3,1,1,1,30871
e2be62d598054c822ecc0c7039ed8a433e1212d9,0,"Doroszlai, Attila",2018-01-04 12:53:12+01:00,['13056cf2b0bf4ff20192860e2bfee556c1c57b4a'],1,25,26,30407899,2,0,0.722222222,0.722222222,30871
217620b0a2d13e1ac8432d6dcb38ae27316d1aab,1,"Doroszlai, Attila",2018-01-04 15:59:59+01:00,['e2be62d598054c822ecc0c7039ed8a433e1212d9'],44,168,212,30408111,9,0.916666667,0.583333333,1,30873
c088e59ebcf099b01603d883dce7700d44cabc68,1,Alex Antonenko,2018-01-04 19:04:40+03:00,['217620b0a2d13e1ac8432d6dcb38ae27316d1aab'],2,105,107,30408218,8,0.953846154,0.953846154,1,30873
dfb97855196ff3e40ae4b6742eabe31082560fe6,0,Lisnichenko Dmitro,2018-01-04 18:36:34+02:00,['c088e59ebcf099b01603d883dce7700d44cabc68'],0,7,7,30408225,3,0,0.571428571,0.428571429,30873
72812bd2bdd496056407d930c4c7e232bd487703,0,Lisnichenko Dmitro,2018-01-04 18:42:11+02:00,['dfb97855196ff3e40ae4b6742eabe31082560fe6'],52,92,144,30408369,4,0,0,1,30873
d6f26fb1c7d79fa6ba9a289daf51f6151c6bb3de,0,Dmytro Grinenko,2018-01-05 10:01:16+02:00,['72812bd2bdd496056407d930c4c7e232bd487703'],44,89,133,30408502,2,0.48,1,0.52,30873
e13bfb95ce15cfe38e9d9d5409cbe44de59d44b8,0,Andrii Tkach,2018-01-05 15:49:59+02:00,['d6f26fb1c7d79fa6ba9a289daf51f6151c6bb3de'],1,4,5,30408507,1,,,,30873
cd5c1cad8f62c45de62094de2b5e442d161c9b34,0,Vitaly Brodetskyi,2018-01-05 16:32:21+02:00,['e13bfb95ce15cfe38e9d9d5409cbe44de59d44b8'],2,5,7,30408514,1,1,1,1,30873
2b9a34b0fae681ed3d20459538f2c7711a314b51,0,Andrii Tkach,2018-01-05 18:26:14+02:00,['cd5c1cad8f62c45de62094de2b5e442d161c9b34'],1,84,85,30408599,3,1,1,1,30874
086bad4bc74f85b3288d1bf03c3a8a3bfcc60de0,1,Myroslav Papirkovskyi,2018-01-05 19:12:52+02:00,['e63562095812a1dcd850cff467a4fd275771ca08'],30,65,95,30408694,4,0.060606061,0.060606061,0.818181818,30874
57a0e5c91618e2d03d9a1f41cb423c609d8029e3,1,Myroslav Papirkovskyi,2018-01-05 19:13:14+02:00,['086bad4bc74f85b3288d1bf03c3a8a3bfcc60de0'],238,256,494,30409188,9,0.168831169,0.506493506,0.155844156,30878
0045c04b42e6ddccffb39b22508853fdb7266b7a,1,Myroslav Papirkovskyi,2018-01-05 19:13:28+02:00,['57a0e5c91618e2d03d9a1f41cb423c609d8029e3'],2,8,10,30409198,3,1,0,1,30878
9bda5e2dcf7572e1b6777dc504f6de209000ec61,1,Myroslav Papirkovskyi,2018-01-05 20:12:01+02:00,['0045c04b42e6ddccffb39b22508853fdb7266b7a'],155,296,451,30409649,14,0.95,0.825,0.675,30881
d1a11a312d852964821bf4cb66682b6bd3bc5ffb,1,Myroslav Papirkovskyi,2018-01-05 20:12:28+02:00,['9bda5e2dcf7572e1b6777dc504f6de209000ec61'],1,35,36,30409685,2,1,1,1,30881
eaa7e7e9b6a38510fc5eed66c42b517703ca70b1,1,Myroslav Papirkovskyi,2018-01-05 20:40:22+02:00,['d1a11a312d852964821bf4cb66682b6bd3bc5ffb'],178,494,672,30410357,14,0.581395349,0.604651163,0.279069767,30883
011e448e22acf6b5f677aaab0c41d064e4d66577,1,ababiichuk,2018-01-05 21:37:12+02:00,['2b9a34b0fae681ed3d20459538f2c7711a314b51'],424,964,1388,30411745,48,0.753968254,1,0.753968254,30891
15d8d1a1485ec5e5441c31566ef8a16632d6046f,1,Robert Levas,2018-01-05 17:54:16-05:00,['068b2fe22054b47474245790a88f87e0848f7e4c'],32,183,215,30411960,9,0.428571429,0.682539683,0.619047619,30891
da6a201058b9c94aaf413621d615483ae177c36e,0,Robert Levas,2018-01-05 17:54:16-05:00,['15d8d1a1485ec5e5441c31566ef8a16632d6046f'],2,2,4,30411964,1,,,,30891
e99867a0b4efb2955b82b9116dd3720a3ea8507a,1,Robert Levas,2018-01-05 17:54:16-05:00,['da6a201058b9c94aaf413621d615483ae177c36e'],27,78,105,30412069,7,0,0,1,30891
4a668f0b69426f7a2c4379e0930fea739a1b6c0b,1,Robert Levas,2018-01-05 17:54:16-05:00,['e99867a0b4efb2955b82b9116dd3720a3ea8507a'],1162,1445,2607,30414676,50,1,0,0,30898
ada1ea543059521b1e93abd208583ae85affd162,0,Robert Levas,2018-01-05 17:54:16-05:00,['4a668f0b69426f7a2c4379e0930fea739a1b6c0b'],4,5,9,30414685,4,,,,30898
67b06423b8872e67c7ec75b73f2ac415f55914ca,0,Robert Levas,2018-01-05 17:54:16-05:00,['ada1ea543059521b1e93abd208583ae85affd162'],1,9,10,30414695,2,0,1,1,30898
35247b1f4cbcf7bbe06b419494e82c8ad15e8fbf,0,Robert Levas,2018-01-05 17:54:16-05:00,['67b06423b8872e67c7ec75b73f2ac415f55914ca'],1,1,2,30414697,1,,,,30898
bb218447638066e2329be8ef437d603cede63ca5,0,Robert Levas,2018-01-05 17:54:16-05:00,['35247b1f4cbcf7bbe06b419494e82c8ad15e8fbf'],2,4,6,30414703,2,,,,30898
72035ef381603119398c0b02e0eb71f1e497fe7d,0,Robert Levas,2018-01-05 17:54:16-05:00,['bb218447638066e2329be8ef437d603cede63ca5'],0,42,42,30414745,4,1,1,1,30898
d5120aab0f3a13769b8f8e366b689169872a2ec4,0,Robert Levas,2018-01-05 17:54:16-05:00,['72035ef381603119398c0b02e0eb71f1e497fe7d'],8,3,11,30414756,1,1,0,0,30898
2244d973833ba1ce12bb73dc861ced618f3b9344,0,Robert Levas,2018-01-05 17:54:16-05:00,['d5120aab0f3a13769b8f8e366b689169872a2ec4'],1,3,4,30414760,1,,,,30898
26a33e545b89243daecef21bdf0e2798412e49e8,1,Robert Levas,2018-01-05 17:54:16-05:00,['2244d973833ba1ce12bb73dc861ced618f3b9344'],657,1022,1679,30416439,61,0.604651163,0,0.604651163,30903
10711361ba2d158500b82b30662f2c062da1fee2,0,Robert Levas,2018-01-05 17:54:16-05:00,['26a33e545b89243daecef21bdf0e2798412e49e8'],24,41,65,30416504,2,0,0,1,30903
7749e655e74c7bb4e3ada6b92943730c5e1b6e76,0,Robert Levas,2018-01-05 17:54:16-05:00,['10711361ba2d158500b82b30662f2c062da1fee2'],21,28,49,30416553,5,,,,30903
f4e1a2bff9b93f28ddc5fa958739a81fe3148aa5,0,Robert Levas,2018-01-05 17:54:16-05:00,['7749e655e74c7bb4e3ada6b92943730c5e1b6e76'],44,60,104,30416657,8,1,0,1,30903
9e9f68f2835d702b0c297b8a9c700f49b05f8475,1,Robert Levas,2018-01-05 17:54:16-05:00,['f4e1a2bff9b93f28ddc5fa958739a81fe3148aa5'],1,36,37,30416694,1,0.846153846,0.846153846,0.153846154,30903
df19a69364b470b063e0790847af640c99262daa,0,Robert Levas,2018-01-05 17:54:16-05:00,['9e9f68f2835d702b0c297b8a9c700f49b05f8475'],2,9,11,30416705,2,0,0,0,30903
85ef6119d808563adcc5989a245242368bc220de,0,Robert Levas,2018-01-05 17:54:16-05:00,['df19a69364b470b063e0790847af640c99262daa'],26,22,48,30416753,4,,,,30903
297e5b9f81e64dcd46f736f3f10609ecbc1cd7d6,0,Robert Levas,2018-01-05 17:54:17-05:00,['85ef6119d808563adcc5989a245242368bc220de'],118,473,591,30417344,11,0.717105263,0.835526316,0.782894737,30906
b171ae33e0b450a40297857a03cf67522e7a7605,0,Robert Levas,2018-01-05 17:54:17-05:00,['297e5b9f81e64dcd46f736f3f10609ecbc1cd7d6'],3,19,22,30417366,4,,,,30906
72657b6f3888654266a4359089bf9ea8b6c97b6b,0,Robert Levas,2018-01-05 17:54:17-05:00,['b171ae33e0b450a40297857a03cf67522e7a7605'],84,1201,1285,30418651,13,0.592777086,0.849315068,0.945205479,30911
e077bd2793826205eb5a300dde25eb75569c3cfd,0,Robert Levas,2018-01-05 17:54:17-05:00,['72657b6f3888654266a4359089bf9ea8b6c97b6b'],1,1,2,30418653,1,,,,30911
b74b05c22f4dec6791e53944a0f6385625e33362,0,Robert Levas,2018-01-05 17:54:17-05:00,['e077bd2793826205eb5a300dde25eb75569c3cfd'],25,63,88,30418741,9,,,,30911
7ff4a96ca958e0d4b2a41fea5ad7754c5ac4712c,1,Robert Levas,2018-01-05 18:03:38-05:00,"['b74b05c22f4dec6791e53944a0f6385625e33362', '2b9a34b0fae681ed3d20459538f2c7711a314b51']",4809,10580,15389,30434130,330,,,,30911
0eddba5456a6e49120cb07bda6a23f5d0944a3c6,0,Robert Levas,2018-01-08 18:58:11-05:00,"['7ff4a96ca958e0d4b2a41fea5ad7754c5ac4712c', '011e448e22acf6b5f677aaab0c41d064e4d66577']",424,964,1388,30435518,48,,,,30911
579cec8cf5bcfe1a1a0feacf055ed6569f674e6a,0,Vivek Ratnavel Subramanian,2018-01-08 20:58:46-08:00,['011e448e22acf6b5f677aaab0c41d064e4d66577'],0,10,10,30435528,1,,,,30912
1bb2355a7b42992fb16ac156a366368b133372d8,0,Vivek Ratnavel Subramanian,2018-01-08 21:04:17-08:00,['579cec8cf5bcfe1a1a0feacf055ed6569f674e6a'],1,1,2,30435530,1,,,,30912
3b8213a18fd80f38ce44c8218f0c2d28c3ab5d65,0,Andrew Onishuk,2018-01-09 12:40:35+02:00,['eaa7e7e9b6a38510fc5eed66c42b517703ca70b1'],0,60,60,30435590,1,,,,30913
1137a217f9e19134674cca00956be1cfcc6db44b,0,GitHub,2018-01-09 14:12:18+02:00,"['eaa7e7e9b6a38510fc5eed66c42b517703ca70b1', '3b8213a18fd80f38ce44c8218f0c2d28c3ab5d65']",0,60,60,30435650,1,,,,30913
e04649b4c760630f397c530731ac05ee531a07fd,1,GitHub,2018-01-09 14:44:04+02:00,['1137a217f9e19134674cca00956be1cfcc6db44b'],2,366,368,30436018,9,0.813953488,0.968992248,1,30917
1ca8f99494f8c20849f1d0c081de68a050b92553,1,kkasa,2018-01-09 14:44:23+01:00,['011e448e22acf6b5f677aaab0c41d064e4d66577'],63,496,559,30436577,22,0.36196319,0.564417178,0.717791411,30920
070fe1793f9c1120da8bf53cd7d3757c163fb7a3,0,Myroslav Papirkovskyi,2018-01-09 15:46:13+02:00,['e04649b4c760630f397c530731ac05ee531a07fd'],5,9,14,30436591,2,,,,30920
30f3a043c4dec865655a26625c09d8db0ef5abba,0,GitHub,2018-01-09 15:37:46+01:00,"['011e448e22acf6b5f677aaab0c41d064e4d66577', '1ca8f99494f8c20849f1d0c081de68a050b92553']",63,496,559,30437150,22,,,,30920
2fc4855cda19acd0b4f9f9f45a7edc3a9620a09a,1,Myroslav Papirkovskyi,2018-01-09 20:47:52+02:00,['070fe1793f9c1120da8bf53cd7d3757c163fb7a3'],5,363,368,30437518,6,0.641975309,0.987654321,0.641975309,30922
f11859e3d27960c4106ae283733ac388488877e4,1,Myroslav Papirkovskyi,2018-01-09 20:51:47+02:00,['2fc4855cda19acd0b4f9f9f45a7edc3a9620a09a'],2,38,40,30437558,2,1,1,1,30922
493612494740ab9b6a7b1e470951baf5cfbee78e,0,GitHub,2018-01-09 13:00:09-08:00,"['30f3a043c4dec865655a26625c09d8db0ef5abba', '1bb2355a7b42992fb16ac156a366368b133372d8']",0,10,10,30437568,1,,,,30922
df9a638c8bc210f9c0a5494d66b17a6e98c3d7a7,1,Attila Magyar,2018-01-10 11:57:41+01:00,['493612494740ab9b6a7b1e470951baf5cfbee78e'],0,1418,1418,30438986,18,0.063063063,0.423423423,1,30940
f1758bc9f931b578bb63b345542551ef6be32427,1,Attila Magyar,2018-01-10 11:57:42+01:00,['df9a638c8bc210f9c0a5494d66b17a6e98c3d7a7'],1,541,542,30439528,15,0.931174089,0.935222672,0.882591093,30945
64bc95ca3142ceb05eae00f39566da04be21208b,1,Attila Magyar,2018-01-10 11:57:42+01:00,['f1758bc9f931b578bb63b345542551ef6be32427'],40,162,202,30439730,6,1,1,1,30946
b57715386cfba47be094e1cc13b31747ed51d3fa,0,Attila Magyar,2018-01-10 11:57:42+01:00,['64bc95ca3142ceb05eae00f39566da04be21208b'],93,565,658,30440388,9,0.472222222,1,0.861111111,30946
8fbaf8dc5683c8f882968add77c5f5025af226ce,0,Attila Magyar,2018-01-10 11:57:42+01:00,['b57715386cfba47be094e1cc13b31747ed51d3fa'],61,58,119,30440507,7,1,1,1,30946
0b69fefd9a5fda0f91b916a45e140820e50d1345,0,Attila Magyar,2018-01-10 11:57:42+01:00,['8fbaf8dc5683c8f882968add77c5f5025af226ce'],56,254,310,30440817,9,0.979166667,0.979166667,0.927083333,30948
3c90642d312f1943870ec517d515b9744ddd69ba,1,Attila Magyar,2018-01-10 11:57:42+01:00,['0b69fefd9a5fda0f91b916a45e140820e50d1345'],15,197,212,30441029,8,0.826666667,0.706666667,0.693333333,30950
e1c9e86d51d8a2da3f39f2e9eea7be8f3dabd26e,0,Attila Magyar,2018-01-10 11:57:42+01:00,['3c90642d312f1943870ec517d515b9744ddd69ba'],61,155,216,30441245,4,1,1,0.571428571,30950
145ebc0e447003cf3e5bc5dcb8508ef9cd979d89,0,Attila Magyar,2018-01-10 11:57:42+01:00,['e1c9e86d51d8a2da3f39f2e9eea7be8f3dabd26e'],16,21,37,30441282,3,1,1,1,30950
cbfcbd6c6981c93942b95da4eac720fe7b7c1e16,1,Attila Magyar,2018-01-10 11:57:42+01:00,['145ebc0e447003cf3e5bc5dcb8508ef9cd979d89'],15,107,122,30441404,6,0.933333333,1,1,30950
f55b56940a76395ead5af82f601324f810bff533,1,Attila Magyar,2018-01-10 11:57:43+01:00,['cbfcbd6c6981c93942b95da4eac720fe7b7c1e16'],147,138,285,30441689,6,1,1,0,30951
89f3bba6b100288f736a73096ea3578153b20b1c,1,Attila Magyar,2018-01-10 11:57:43+01:00,['f55b56940a76395ead5af82f601324f810bff533'],78,529,607,30442296,16,0.522727273,0.619318182,0.823863636,30956
ebf3630e5759d39bdc9e4ea0dd3b97217b5248b2,1,Attila Magyar,2018-01-10 11:57:43+01:00,['89f3bba6b100288f736a73096ea3578153b20b1c'],33,117,150,30442446,11,0.927272727,1,1,30956
97bd0d8623620f8689923b3732b642f2baea477b,0,Attila Magyar,2018-01-10 11:57:43+01:00,['ebf3630e5759d39bdc9e4ea0dd3b97217b5248b2'],1,10,11,30442457,3,0,1,1,30956
859d0503aa1ee829455c70e9eb475be75783a366,0,Attila Magyar,2018-01-10 11:57:43+01:00,['97bd0d8623620f8689923b3732b642f2baea477b'],47,24,71,30442528,2,,,,30956
db0a15a8237370d14f22beace7609c1ff4c427dc,0,Andrii Tkach,2018-01-10 14:17:25+02:00,['859d0503aa1ee829455c70e9eb475be75783a366'],5,22,27,30442555,4,1,1,1,30956
a94ca6b3afb369a76734d4390dca42906f0ca329,0,GitHub,2018-01-10 14:39:56+02:00,"['859d0503aa1ee829455c70e9eb475be75783a366', 'db0a15a8237370d14f22beace7609c1ff4c427dc']",5,22,27,30442582,4,,,,30956
d7463e649adfa9454e2af525cf5b2e1e445ed28a,0,Attila Magyar,2018-01-10 14:59:40+01:00,['a94ca6b3afb369a76734d4390dca42906f0ca329'],0,17,17,30442599,1,,,,30956
635ee1d9898e1bf6f9335c123ccef62fd9a6ce31,1,Olivér Szabó,2018-01-10 15:22:00+01:00,['d7463e649adfa9454e2af525cf5b2e1e445ed28a'],6,250,256,30442855,9,0.891891892,0.891891892,0.945945946,30961
0aaf8c85347869efce154fc6686837027aa92cbc,1,Sandor Molnar,2018-01-10 15:41:56+01:00,['635ee1d9898e1bf6f9335c123ccef62fd9a6ce31'],926,988,1914,30444769,33,1,1,0.290909091,30966
0341a36a5688ae680e85f437d5bfc1c2d5e95b0f,0,GitHub,2018-01-10 12:21:41-05:00,"['635ee1d9898e1bf6f9335c123ccef62fd9a6ce31', '0aaf8c85347869efce154fc6686837027aa92cbc']",926,988,1914,30446683,33,,,,30966
5a370c904f5adf8fd2c41a36e0401d828b17ca06,1,ababiichuk,2018-01-10 20:53:45+02:00,['0341a36a5688ae680e85f437d5bfc1c2d5e95b0f'],46,400,446,30447129,13,0.421052632,1,0.421052632,30970
e078138804e361d0fa056965f3a351d40f385398,0,GitHub,2018-01-10 20:54:46+02:00,"['0341a36a5688ae680e85f437d5bfc1c2d5e95b0f', '5a370c904f5adf8fd2c41a36e0401d828b17ca06']",46,400,446,30447575,13,,,,30970
14e8c22f34f152b9b99f18636410542d77e4e4ea,0,Robert Levas,2018-01-10 15:05:03-05:00,"['0eddba5456a6e49120cb07bda6a23f5d0944a3c6', '0341a36a5688ae680e85f437d5bfc1c2d5e95b0f']",1285,5726,7011,30454586,153,,,,30970
bf2f09e8279d81b833d59595c74542a0da0a7d14,0,GitHub,2018-01-10 15:07:43-05:00,"['7ff4a96ca958e0d4b2a41fea5ad7754c5ac4712c', '14e8c22f34f152b9b99f18636410542d77e4e4ea']",1709,6690,8399,30462985,201,,,,30970
1eead54f467c7ff6abafa908abf5b66a7278a45a,0,Vivek Ratnavel Subramanian,2018-01-10 12:13:12-08:00,['e078138804e361d0fa056965f3a351d40f385398'],0,1,1,30462986,1,,,,30970
724637cb146696d9e7d4358b8779ea616fb73de4,1,kkasa,2018-01-11 10:12:35+01:00,['1eead54f467c7ff6abafa908abf5b66a7278a45a'],65,338,403,30463389,11,,,,30971
417547afc6b455164c0fb72379992528501e993b,0,Andrii Tkach,2018-01-11 13:30:24+02:00,['1eead54f467c7ff6abafa908abf5b66a7278a45a'],2,2,4,30463393,2,,0,,30971
e5bd153d9741a50dafa0db1ff7bb9145add8e7fa,0,GitHub,2018-01-11 13:34:57+01:00,"['1eead54f467c7ff6abafa908abf5b66a7278a45a', '724637cb146696d9e7d4358b8779ea616fb73de4']",65,338,403,30463796,11,,,,30971
6aeb7f45ee696341e2cbd02c09ad59211e608184,0,GitHub,2018-01-11 14:40:27+02:00,"['e5bd153d9741a50dafa0db1ff7bb9145add8e7fa', '417547afc6b455164c0fb72379992528501e993b']",2,2,4,30463800,2,,,,30971
47c8d290968589754393b8ffa85a7acb0e3eabf6,0,Alex Antonenko,2018-01-11 18:43:16+03:00,['6aeb7f45ee696341e2cbd02c09ad59211e608184'],4,18,22,30463822,3,0.5,0,0.5,30971
c432dde8c20977709d729655cf562dfb898ae760,0,aonishuk,2018-01-11 19:00:00+02:00,['f11859e3d27960c4106ae283733ac388488877e4'],330,1329,1659,30465481,25,,,,30971
40825494c10f6ecfa5d9516659c303b3864e9c16,1,Dmytro Grinenko,2018-01-11 21:30:28+02:00,['6aeb7f45ee696341e2cbd02c09ad59211e608184'],9,19,28,30465509,2,,,,30971
8e59a86edfbd0ac0b56934f34755e43cc61546e8,0,Aleksandr Kovalenko,2018-01-12 01:27:51+02:00,['40825494c10f6ecfa5d9516659c303b3864e9c16'],7,58,65,30465574,3,,,,30972
e6d8deb32b59cfe287335244ab39640d9c605af0,1,Myroslav Papirkovskyi,2018-01-12 15:49:43+02:00,['c432dde8c20977709d729655cf562dfb898ae760'],5,11,16,30465590,5,0.857142857,1,1,30972
e782b721adbd115e599c715f7d3fe462734b10a6,1,Myroslav Papirkovskyi,2018-01-12 15:49:43+02:00,['e6d8deb32b59cfe287335244ab39640d9c605af0'],5,5,10,30465600,2,,,,30972
f8327e30daeac4e59d29af2cdf275ee8f8b49224,0,Myroslav Papirkovskyi,2018-01-12 15:49:43+02:00,['e782b721adbd115e599c715f7d3fe462734b10a6'],36,7,43,30465643,1,0,0,0,30972
8e6bb54cd7f98123f56361e9a7d395056221309c,1,"Doroszlai, Attila",2018-01-12 14:52:32+01:00,['f8327e30daeac4e59d29af2cdf275ee8f8b49224'],0,10,10,30465653,2,,,,30972
1066ad3ae53ec727b15c1ce9f0139a8bd3f9f0e8,0,"Doroszlai, Attila",2018-01-12 14:52:32+01:00,['8e6bb54cd7f98123f56361e9a7d395056221309c'],0,2,2,30465655,1,,,,30972
fa403a6edb62eaf4f927f733457d96bac15336eb,1,Olivér Szabó,2018-01-12 17:16:34+01:00,['8e59a86edfbd0ac0b56934f34755e43cc61546e8'],6,16,22,30465677,4,,,,30972
b8cfbc49e8a70efd917debb04111ffa3fbead7ed,0,"Doroszlai, Attila",2018-01-12 19:06:39+01:00,['fa403a6edb62eaf4f927f733457d96bac15336eb'],2,11,13,30465690,3,1,1,1,30972
c1320ab9db69b4bfeeaf2892b6c716e793cba05a,0,GitHub,2018-01-12 10:21:55-08:00,['b8cfbc49e8a70efd917debb04111ffa3fbead7ed'],0,58,58,30465748,1,,,,30973
47c78e9a0d535c41af1c970697b695070fddf0b7,0,GitHub,2018-01-12 20:56:55+01:00,"['c1320ab9db69b4bfeeaf2892b6c716e793cba05a', '0ee7e07502e4ec336433af1d48925373299b16bd']",4,4,8,30465756,1,,,,30973
4169f4def3f7765a71da79dd81505324d7e62afd,0,Robert Levas,2018-01-14 08:28:48-05:00,"['14e8c22f34f152b9b99f18636410542d77e4e4ea', 'e078138804e361d0fa056965f3a351d40f385398']",46,400,446,30466202,13,,,,30973
6714768019dfde02952bc166da6304cdc4437601,0,GitHub,2018-01-14 08:36:57-05:00,"['bf2f09e8279d81b833d59595c74542a0da0a7d14', '4169f4def3f7765a71da79dd81505324d7e62afd']",46,400,446,30466648,13,,,,30973
05200deac86b6690ef05cc167ae488352f253d1e,0,GitHub,2018-01-14 09:39:28-05:00,"['e078138804e361d0fa056965f3a351d40f385398', '47c78e9a0d535c41af1c970697b695070fddf0b7']",95,507,602,30467250,28,,,,30973
84434f9de9f379c72c932671dcb80d5ff2d80107,0,Robert Levas,2018-01-14 09:40:47-05:00,"['4169f4def3f7765a71da79dd81505324d7e62afd', '05200deac86b6690ef05cc167ae488352f253d1e']",95,507,602,30467852,28,,,,30973
6737bbab869d82d0f1e39bfcbf93f07d50abbddf,0,GitHub,2018-01-14 09:41:53-05:00,"['6714768019dfde02952bc166da6304cdc4437601', '84434f9de9f379c72c932671dcb80d5ff2d80107']",95,507,602,30468454,28,,,,30973
008a3c1ef08b7fa39668b3e563cb88d5b414bec9,1,aonishuk,2018-01-15 10:31:40+02:00,['47c78e9a0d535c41af1c970697b695070fddf0b7'],6,6,12,30468466,3,,,,30973
0e321500a17d454e978e1e59c74453e02a22d3a3,0,"Doroszlai, Attila",2018-01-15 15:10:27+01:00,['008a3c1ef08b7fa39668b3e563cb88d5b414bec9'],76,69,145,30468611,1,1,1,0,30973
b2a61ecaa3c982cbe098607e2d6fc78ebd3ede47,0,Sandor Molnar,2018-01-15 15:31:06+01:00,['0e321500a17d454e978e1e59c74453e02a22d3a3'],11,252,263,30468874,7,0.422857143,0.868571429,0.902857143,30973
0c61412a4e9976ddb2ff449bfe859113de366c68,1,Sandor Molnar,2018-01-15 15:31:06+01:00,['b2a61ecaa3c982cbe098607e2d6fc78ebd3ede47'],40,28,68,30468942,2,0,0,1,30973
1e5d726a6983fa2e8f249354a5df08e5fede44dc,0,Sandor Molnar,2018-01-15 15:31:06+01:00,['0c61412a4e9976ddb2ff449bfe859113de366c68'],39,39,78,30469020,3,1,0.090909091,0,30973
71620783bd7e3ad780c42fa5960f4a99e7c1534b,1,aonishuk,2018-01-15 16:45:00+02:00,['1066ad3ae53ec727b15c1ce9f0139a8bd3f9f0e8'],141,120,261,30469281,23,1,0,0,30973
04a71b9606c7d8f18b480fe0d84453b2ddf3f996,1,aonishuk,2018-01-15 16:45:00+02:00,['71620783bd7e3ad780c42fa5960f4a99e7c1534b'],25,3,28,30469309,2,0.65,0.65,0.1,30973
b6b29fd0fdcf00676f92bf8fe29d97471ce45daa,1,aonishuk,2018-01-15 16:45:00+02:00,['04a71b9606c7d8f18b480fe0d84453b2ddf3f996'],94,512,606,30469915,14,0,1,0,30973
8928d17f659729162535bb6cc0e1a42983d6743e,1,aonishuk,2018-01-15 16:50:57+02:00,['b6b29fd0fdcf00676f92bf8fe29d97471ce45daa'],3,25,28,30469943,2,0.35,0.35,0.9,30973
4b99764fd471c6387bbf688195cf3b0c78d44820,1,aonishuk,2018-01-15 16:50:57+02:00,['8928d17f659729162535bb6cc0e1a42983d6743e'],25,3,28,30469971,2,0.65,0.65,0.1,30973
98627078a5c9bd58027ebec6b5e2c61ca3bb8d9d,0,Andrii Tkach,2018-01-15 17:46:51+02:00,['0e321500a17d454e978e1e59c74453e02a22d3a3'],57,80,137,30470108,2,,,,30973
2c9fd2d0425e7333367594cc7d00be33613c109b,0,Robert Levas,2018-01-15 11:51:58-05:00,"['05200deac86b6690ef05cc167ae488352f253d1e', '98627078a5c9bd58027ebec6b5e2c61ca3bb8d9d']",139,155,294,30470402,6,,,,30973
f6d569bdf4863e3f0fe75f0a5eef5f208d558e70,0,Robert Levas,2018-01-15 11:53:13-05:00,"['6737bbab869d82d0f1e39bfcbf93f07d50abbddf', '2c9fd2d0425e7333367594cc7d00be33613c109b']",139,155,294,30470696,6,,,,30973
473df03dd38d00af6b129c266959bc65595dc274,0,GitHub,2018-01-15 11:55:06-05:00,"['6737bbab869d82d0f1e39bfcbf93f07d50abbddf', 'f6d569bdf4863e3f0fe75f0a5eef5f208d558e70']",139,155,294,30470990,6,,,,30973
23e51faec5b619e38da6648f6bdbf3d175f5494e,0,GitHub,2018-01-15 13:24:24-05:00,"['98627078a5c9bd58027ebec6b5e2c61ca3bb8d9d', '1e5d726a6983fa2e8f249354a5df08e5fede44dc']",11,240,251,30471241,6,,,,30973
7be21c9148fa0a1cb088d13407974b60dac68b36,0,"Doroszlai, Attila",2018-01-15 21:26:05+01:00,['23e51faec5b619e38da6648f6bdbf3d175f5494e'],1,4,5,30471246,1,0,1,1,30973
79704f5f948e738a01965959e6be171506be85f8,1,Olivér Szabó,2018-01-15 21:31:11+01:00,['7be21c9148fa0a1cb088d13407974b60dac68b36'],21,21,42,30471288,5,,,,30973
2dbb4550334e5f949d5af22f7e79cb01a516bdd0,1,kkasa,2018-01-16 06:36:28+01:00,['79704f5f948e738a01965959e6be171506be85f8'],76,82,158,30471446,9,,,,30973
b8c039351eebca27e0f9fcec5b246daf7c4b7223,0,GitHub,2018-01-16 12:24:44+01:00,"['79704f5f948e738a01965959e6be171506be85f8', '2dbb4550334e5f949d5af22f7e79cb01a516bdd0']",76,82,158,30471604,9,,,,30973
4653253df149f3d479a5831f00af2eb2c55f5f09,0,Alex Antonenko,2018-01-16 15:26:51+03:00,['79704f5f948e738a01965959e6be171506be85f8'],15,19,34,30471638,2,,,,30973
90b1438d2908d784ace4064b2a5b340798bf8663,0,Sandor Molnar,2018-01-16 14:05:42+01:00,['b8c039351eebca27e0f9fcec5b246daf7c4b7223'],0,48,48,30471686,9,,,,30973
5627a3f9851dba1b7b1ed331f824b05d9fd02fd2,1,Alex Antonenko,2018-01-16 18:00:56+03:00,['79704f5f948e738a01965959e6be171506be85f8'],0,3,3,30471689,1,,,,30973
7235069133c6fe469e84571579e4b7a7e3a67ac2,0,"Doroszlai, Attila",2018-01-16 16:10:24+01:00,['b8c039351eebca27e0f9fcec5b246daf7c4b7223'],2,1,3,30471692,2,,,,30973
199e8664a977a9e9b91ff80861885c448beb0735,0,GitHub,2018-01-16 18:16:45+03:00,"['7235069133c6fe469e84571579e4b7a7e3a67ac2', '47c8d290968589754393b8ffa85a7acb0e3eabf6']",4,18,22,30471714,3,,,,30973
9804cb20289fd9ca073e3f35e2afcc050a566511,0,GitHub,2018-01-16 19:50:47+03:00,"['199e8664a977a9e9b91ff80861885c448beb0735', '4653253df149f3d479a5831f00af2eb2c55f5f09']",15,19,34,30471748,2,,,,30973
a2a45aa3e10d95a55114b18dbf7b2e49300dd151,1,aBabiichuk,2018-01-16 19:08:46+02:00,['9804cb20289fd9ca073e3f35e2afcc050a566511'],1,2,3,30471751,1,,,,30973
ad9bcb645dd5c743924d548b889e12185345b523,0,GitHub,2018-01-17 09:23:18-05:00,"['a2a45aa3e10d95a55114b18dbf7b2e49300dd151', '90b1438d2908d784ace4064b2a5b340798bf8663']",0,48,48,30471799,9,,,,30973
90b7c1417484ad8c4792b3996603a326ae9618a4,0,"Doroszlai, Attila",2018-01-17 20:42:37+01:00,['ad9bcb645dd5c743924d548b889e12185345b523'],13,13,26,30471825,1,0.333333333,0,0,30973
6f4063b878ddc12a541a9ff2e36f48509c70e919,0,Robert Levas,2018-01-17 15:59:35-05:00,"['f6d569bdf4863e3f0fe75f0a5eef5f208d558e70', '90b7c1417484ad8c4792b3996603a326ae9618a4']",144,448,592,30472417,39,,,,30973
5582d291986a6eb4c0c984760c01669c4bbb9b03,0,Robert Levas,2018-01-17 16:46:36-05:00,['6f4063b878ddc12a541a9ff2e36f48509c70e919'],0,1,1,30472418,1,,,,30973
5ba3cd3a599bf01676b49d048fdae2889bbb0e03,1,Robert Levas,2018-01-17 16:46:53-05:00,['5582d291986a6eb4c0c984760c01669c4bbb9b03'],36,727,763,30473181,15,0.23923445,1,0.954545455,30973
9d3309656e7c1aa9fb00a732149a251f69eda51d,0,GitHub,2018-01-17 16:48:11-05:00,"['473df03dd38d00af6b129c266959bc65595dc274', '5582d291986a6eb4c0c984760c01669c4bbb9b03']",144,449,593,30473774,39,,,,30973
505dd217aecb1c761ebdb97b87cc82403e3dce20,0,Venkata Sairam,2018-01-18 09:21:22+05:18,['90b7c1417484ad8c4792b3996603a326ae9618a4'],3,3,6,30473780,2,,,,30973
1a6548a69970446bda994e89b76cc9cee92860c6,1,Eugene Chekanskiy,2018-01-18 12:10:38+02:00,['90b7c1417484ad8c4792b3996603a326ae9618a4'],1152,334,1486,30475266,15,0.64516129,0.75,0.219758065,30975
a73d58b153a09646aa4e629cbae4f213894ec7fb,0,Alex Antonenko,2018-01-18 14:36:44+03:00,['1a6548a69970446bda994e89b76cc9cee92860c6'],3,3,6,30475272,1,,,,30975
b0f03b2e68a821cb617cc55ce033b2b419d0e3f0,1,Alex Antonenko,2018-01-18 15:50:14+03:00,['1a6548a69970446bda994e89b76cc9cee92860c6'],2,6,8,30475280,3,1,1,1,30975
347f6fefd41f05cec9d03facfb94cd9734631a2d,1,Alex Antonenko,2018-01-18 16:13:59+03:00,['5627a3f9851dba1b7b1ed331f824b05d9fd02fd2'],6,3,9,30475289,3,,,,30975
74389dd6e1f55168205df52bb74507aebb801a04,0,Eugene Chekanskiy,2018-01-18 17:12:03+02:00,['1a6548a69970446bda994e89b76cc9cee92860c6'],1,0,1,30475290,1,,,,30975
6ecbcbe02cd43e87e3c3d1ec62d5380b234eebab,0,GitHub,2018-01-18 12:40:08-05:00,"['9d3309656e7c1aa9fb00a732149a251f69eda51d', '5ba3cd3a599bf01676b49d048fdae2889bbb0e03']",36,727,763,30476053,15,,,,30975
1eca6769fec9474b072502c41e8033fc3d6a4777,0,GitHub,2018-01-18 12:48:27-05:00,"['1a6548a69970446bda994e89b76cc9cee92860c6', '6ecbcbe02cd43e87e3c3d1ec62d5380b234eebab']",19893,30521,50414,30526467,156,,,,30975
cd5fdaa4be9108800c9eea7cf1a1c715bfefb192,0,"Doroszlai, Attila",2018-01-18 20:13:19+01:00,['1eca6769fec9474b072502c41e8033fc3d6a4777'],1,42,43,30526510,1,,,,30975
7e0eaa09bafa45842cea436e5f5aac4b383f1ae9,0,GitHub,2018-01-18 15:16:03-05:00,"['cd5fdaa4be9108800c9eea7cf1a1c715bfefb192', '74389dd6e1f55168205df52bb74507aebb801a04']",1,0,1,30526511,1,,,,30975
76d9a324e7473719d5ae6a9f5ee5244e9b07a1be,1,Jonathan Hurley,2018-01-18 16:41:32-05:00,['0341a36a5688ae680e85f437d5bfc1c2d5e95b0f'],13,101,114,30526625,7,0,0.15,0.45,30975
b0b61061b661739b13f0ed729b8dcdc23ec3de04,1,aBabiichuk,2018-01-19 11:12:38+02:00,['7e0eaa09bafa45842cea436e5f5aac4b383f1ae9'],110,591,701,30527326,13,0.777777778,1,1,30975
8c870c39f7dd175989b24a01abb28fb8ab37e2a4,0,Andrii Tkach,2018-01-19 14:20:01+02:00,['b0b61061b661739b13f0ed729b8dcdc23ec3de04'],72,69,141,30527467,4,1,1,1,30975
881b464983d84b795737413e137922dca6c3f06f,0,Andrii Tkach,2018-01-19 15:07:24+02:00,['8c870c39f7dd175989b24a01abb28fb8ab37e2a4'],4,13,17,30527484,3,,,,30975
5cd72cead5b2d892e97b705403155be5f16abab6,0,GitHub,2018-01-19 09:30:01-05:00,"['881b464983d84b795737413e137922dca6c3f06f', '76d9a324e7473719d5ae6a9f5ee5244e9b07a1be']",13,101,114,30527598,7,,,,30975
b434663cc8f15852b11b8e8607b105f71c360832,0,Robert Levas,2018-01-19 09:52:39-05:00,['5cd72cead5b2d892e97b705403155be5f16abab6'],2,18,20,30527618,2,1,1,1,30975
cdf3f623831d45b30525635982612e96622c9671,1,Robert Levas,2018-01-19 10:19:35-05:00,['b434663cc8f15852b11b8e8607b105f71c360832'],0,12,12,30527630,2,0.6,1,1,30975
a3f26e5e35c10c834312430cd0626a38406e7459,1,Olivér Szabó,2018-01-20 10:03:38+01:00,['cdf3f623831d45b30525635982612e96622c9671'],1827,2179,4006,30531636,74,1,1,0,30985
d54d3404110e0a16545b5978e38b41b5a35aa017,0,"Doroszlai, Attila",2018-01-20 22:48:04+01:00,['a3f26e5e35c10c834312430cd0626a38406e7459'],25,38,63,30531699,4,0,0,0,30985
f837a6cead0fa27118ab37da3eadf40338af0537,1,"Doroszlai, Attila",2018-01-21 17:23:29+01:00,['d54d3404110e0a16545b5978e38b41b5a35aa017'],209,464,673,30532372,25,0.720588235,0.955882353,0.801470588,30986
c70de92823baa5504c80763148b91142b70105d9,0,Prabhjyot Singh,2018-01-22 09:15:40+05:18,['f837a6cead0fa27118ab37da3eadf40338af0537'],0,53,53,30532425,2,0,1,1,30986
e1ff339b8d76cf67c742f07ac1fa536929fcba33,0,Prabhjyot Singh,2018-01-22 09:19:46+05:18,['f837a6cead0fa27118ab37da3eadf40338af0537'],26,34,60,30532485,1,0.833333333,1,1,30986
bf1e2ca448aff79d3d29866d53e6d2cb70fd9a11,0,GitHub,2018-01-22 12:34:31+05:18,"['f837a6cead0fa27118ab37da3eadf40338af0537', 'c70de92823baa5504c80763148b91142b70105d9']",0,53,53,30532538,2,,,,30986
a027d91554a87638a3a9295ecbbb5a74e7a93093,0,GitHub,2018-01-22 12:35:17+05:18,"['bf1e2ca448aff79d3d29866d53e6d2cb70fd9a11', 'e1ff339b8d76cf67c742f07ac1fa536929fcba33']",26,34,60,30532598,1,,,,30986
980bf24a709dc636e56533ebd491a47204c2c3fc,0,GitHub,2018-01-22 12:45:34+05:18,"['a027d91554a87638a3a9295ecbbb5a74e7a93093', '505dd217aecb1c761ebdb97b87cc82403e3dce20']",3,3,6,30532604,2,,,,30986
51b7443756a58d8306ecfbd8572d82e8ed186df4,1,aonishuk,2018-01-22 18:12:28+02:00,['4b99764fd471c6387bbf688195cf3b0c78d44820'],3,25,28,30532632,2,0.35,0.35,0.9,30986
814146b3ba0b340ccdd3bfb80523abedcd1b766e,1,aonishuk,2018-01-22 18:12:28+02:00,['51b7443756a58d8306ecfbd8572d82e8ed186df4'],25,3,28,30532660,2,0.65,0.65,0.1,30986
de56e9bb5f07ad8f7eca198beaa689c367b98a5a,1,aonishuk,2018-01-22 18:12:28+02:00,['814146b3ba0b340ccdd3bfb80523abedcd1b766e'],475,413,888,30533548,2,0.352941176,0.941176471,1,30986
18ee0b73ebd063afa73681e87b61e2416ff980a3,0,aonishuk,2018-01-22 18:12:28+02:00,['de56e9bb5f07ad8f7eca198beaa689c367b98a5a'],114,70,184,30533732,6,0,0,0,30986
3b8a006911091e4c351d14c181bfd51187727c09,1,aonishuk,2018-01-22 18:41:14+02:00,['18ee0b73ebd063afa73681e87b61e2416ff980a3'],3,25,28,30533760,2,0.35,0.35,0.9,30986
c4934b54d73406a97a15f2ee619d3f7b9f22dfe3,1,aonishuk,2018-01-22 18:41:14+02:00,['3b8a006911091e4c351d14c181bfd51187727c09'],25,3,28,30533788,2,0.65,0.65,0.1,30986
30b6f5b61400efda3bff9a64b06ba57938433df3,1,Myroslav Papirkovskyi,2018-01-22 19:19:38+02:00,['c4934b54d73406a97a15f2ee619d3f7b9f22dfe3'],1557,2021,3578,30537366,91,0.15,1,0.575,30987
b275722355c7e67af918a18a8b90c684e5837af0,1,Siddharth,2018-01-22 13:10:08-08:00,['980bf24a709dc636e56533ebd491a47204c2c3fc'],2,5,7,30537373,5,0,0.333333333,0.333333333,30987
367b7cbad1b03ba4eb2742f3dface10ef84308f5,0,GitHub,2018-01-23 13:49:40+02:00,"['b275722355c7e67af918a18a8b90c684e5837af0', 'b0f03b2e68a821cb617cc55ce033b2b419d0e3f0']",2,6,8,30537381,3,,,,30987
eed3a36c77bedd245c504dc5afcc2eabed65105e,0,GitHub,2018-01-23 14:43:54+02:00,"['367b7cbad1b03ba4eb2742f3dface10ef84308f5', 'a73d58b153a09646aa4e629cbae4f213894ec7fb']",3,3,6,30537387,1,,,,30987
2de95435560f52d97e55f6234d0464d02a42b879,0,GitHub,2018-01-23 15:15:26+02:00,"['eed3a36c77bedd245c504dc5afcc2eabed65105e', '347f6fefd41f05cec9d03facfb94cd9734631a2d']",3,3,6,30537393,2,,,,30987
858fbd239369274def05a0846e8fa63ee53a8ad9,1,Akhil Subhash Naik,2018-01-23 22:50:27+05:18,['2de95435560f52d97e55f6234d0464d02a42b879'],6,4,10,30537403,1,0,0,0,30987
118591cd046fb51ae81953ddfeb99b8696b4cb0a,1,aonishuk,2018-01-24 13:33:25+02:00,['30b6f5b61400efda3bff9a64b06ba57938433df3'],3,25,28,30537431,2,0.35,0.35,0.9,30987
256578bf1a9d73dd1dbd0df0332bce5264246264,0,aonishuk,2018-01-24 13:33:25+02:00,['118591cd046fb51ae81953ddfeb99b8696b4cb0a'],25,3,28,30537459,2,0.65,0.65,0.1,30987
c066c972c622070f643a387bd467f75676e1732a,1,aonishuk,2018-01-24 13:33:25+02:00,['256578bf1a9d73dd1dbd0df0332bce5264246264'],251,67,318,30537777,4,0.85,0,0,30987
c4f81c0519dc3d6b0099bc86d75b3af5f4cf0846,1,Robert Levas,2018-01-24 08:20:09-05:00,['2de95435560f52d97e55f6234d0464d02a42b879'],199,356,555,30538332,7,0.133333333,0.822222222,0.585185185,30987
28c5e6b72a7459a353fe22521668ba6b5dfe66b4,0,Robert Levas,2018-01-24 08:20:09-05:00,['c4f81c0519dc3d6b0099bc86d75b3af5f4cf0846'],2,0,2,30538334,1,1,0,0,30987
f3906f6fa8b31c125ad4a5388b6fc25b90d3049c,1,Robert Levas,2018-01-24 08:20:09-05:00,['28c5e6b72a7459a353fe22521668ba6b5dfe66b4'],29,3,32,30538366,2,0.315789474,0.210526316,0.789473684,30987
0b70e3c67ddd5ba7bcc8f1f4e7b2ee68cc492b63,1,Robert Levas,2018-01-24 08:20:09-05:00,['f3906f6fa8b31c125ad4a5388b6fc25b90d3049c'],14,14,28,30538394,3,,,,30987
663599a3005bada9891f23e8aa92069c74b5a4f0,1,Robert Levas,2018-01-24 08:20:09-05:00,['0b70e3c67ddd5ba7bcc8f1f4e7b2ee68cc492b63'],1,1,2,30538396,1,,,,30987
14a42ad8745f414cc7220304a50d2c1485408dc8,1,Robert Levas,2018-01-24 08:20:09-05:00,['663599a3005bada9891f23e8aa92069c74b5a4f0'],3,6,9,30538405,1,,,,30987
640408b68dfd6e0f718abe883cdc9cdbc25f5046,0,Robert Levas,2018-01-24 08:20:09-05:00,['14a42ad8745f414cc7220304a50d2c1485408dc8'],4,5,9,30538414,2,0,0,1,30987
9d07d74708b98154014a42b06830a6f2e00dd609,0,Robert Levas,2018-01-24 08:20:09-05:00,['640408b68dfd6e0f718abe883cdc9cdbc25f5046'],2,1,3,30538417,1,,,,30987
4d67e34a33d8f5b16a1469440706b567ca2e19c3,1,Robert Levas,2018-01-24 08:20:09-05:00,['9d07d74708b98154014a42b06830a6f2e00dd609'],4,4,8,30538425,1,,,,30987
a7dd2be26997202d62a1aec77093b6a79ddee110,1,Aleksandr Kovalenko,2018-01-24 21:45:53+02:00,['4d67e34a33d8f5b16a1469440706b567ca2e19c3'],47,695,742,30539167,14,,,,30991
947d7e74c732e67c01d245f030b9af2d871c2c0b,0,GitHub,2018-01-25 08:25:29+01:00,['a7dd2be26997202d62a1aec77093b6a79ddee110'],6,45,51,30539218,3,0.259259259,0.925925926,1,30991
1805903cdd06395342747c424ce2cbb115c36a9d,1,Alex Antonenko,2018-01-25 14:18:43+03:00,['947d7e74c732e67c01d245f030b9af2d871c2c0b'],0,3,3,30539221,1,,,,30991
17c245fb74f3ee1b9086ac3676966a8b605717d1,1,Alex Antonenko,2018-01-25 14:34:50+03:00,['1805903cdd06395342747c424ce2cbb115c36a9d'],5,5,10,30539231,2,,,,30991
a50d926533fe9df7a8473d48eed82db6edd0b43e,0,GitHub,2018-01-25 15:27:34+02:00,"['947d7e74c732e67c01d245f030b9af2d871c2c0b', '17c245fb74f3ee1b9086ac3676966a8b605717d1']",5,8,13,30539244,2,,,,30991
e8366084456b652adb83a33bf56a56d17681bf98,1,GitHub,2018-01-25 15:12:56+01:00,['a50d926533fe9df7a8473d48eed82db6edd0b43e'],14,25,39,30539283,3,0,1,0.181818182,30991
1d531ce0658b9f2c0daf20ad1ac3fc04834463de,1,Oliver Szabo,2018-01-25 15:58:53+01:00,['e8366084456b652adb83a33bf56a56d17681bf98'],167,5,172,30539455,2,0.75,0,0.088235294,30991
c5db4ab0e28feeb9aa2e1492dffeeabf50c4e99f,0,GitHub,2018-01-26 10:18:35+01:00,"['e8366084456b652adb83a33bf56a56d17681bf98', '1d531ce0658b9f2c0daf20ad1ac3fc04834463de']",167,5,172,30539627,2,,,,30991
19a8e75d3887d9354a3b14a36c362f73d962e9bf,1,Olivér Szabó,2018-01-26 11:22:13+01:00,['c5db4ab0e28feeb9aa2e1492dffeeabf50c4e99f'],208,970,1178,30540805,32,0.859531773,0.963210702,0.802675585,31001
d7ddb30a5e3dd77a15da4f10b29d849233f0df74,1,Andrii Tkach,2018-01-26 12:58:52+02:00,['19a8e75d3887d9354a3b14a36c362f73d962e9bf'],473,151,624,30541429,17,0.476470588,0.370588235,0,31001
649771469b811f292a7a310b3a48c8ad302b4a5d,0,aonishuk,2018-01-26 16:01:54+02:00,['d7ddb30a5e3dd77a15da4f10b29d849233f0df74'],6,8,14,30541443,1,,,,31001
ddf96188e9ca5ce8980fc54ada48f6d5e4d7c787,1,aonishuk,2018-01-26 16:01:54+02:00,['649771469b811f292a7a310b3a48c8ad302b4a5d'],1,19,20,30541463,13,,,,31001
26f178ca2b50ccd80e8d97808578e39b4be0e0f2,1,Andrii Tkach,2018-01-26 17:27:09+02:00,['ddf96188e9ca5ce8980fc54ada48f6d5e4d7c787'],891,381,1272,30542735,14,0.31598513,0.007434944,0,31001
0d00922aa963ebb00d8da1db34c45aea0eb7c5bd,1,hiveww,2018-01-28 04:40:02+02:00,['947d7e74c732e67c01d245f030b9af2d871c2c0b'],1,2,3,30542738,1,,,,31001
d19d5cb518adf7017455dc961b29f282125c0e74,0,hiveww,2018-01-28 04:54:54+02:00,['947d7e74c732e67c01d245f030b9af2d871c2c0b'],1,1,2,30542740,1,,,,31001
3a08e39f0fe20271fee7e6cc51f43a2da2911419,0,hiveww,2018-01-28 05:33:07+02:00,['0d00922aa963ebb00d8da1db34c45aea0eb7c5bd'],1,0,1,30542741,1,,,,31001
e3b401c38267d6749f16911fec8362b59575c102,0,GitHub,2018-01-28 13:46:09+02:00,"['26f178ca2b50ccd80e8d97808578e39b4be0e0f2', '3a08e39f0fe20271fee7e6cc51f43a2da2911419']",1,1,2,30542743,1,,,,31001
97b3be0f47bf48969ae6a0deda58b1c047f1e975,0,GitHub,2018-01-28 18:39:49+02:00,"['e3b401c38267d6749f16911fec8362b59575c102', 'd19d5cb518adf7017455dc961b29f282125c0e74']",1,1,2,30542745,1,,,,31001
d4467fb18448d4b10d12692217ba1c57a00b37b0,1,aonishuk,2018-01-29 11:59:44+02:00,['97b3be0f47bf48969ae6a0deda58b1c047f1e975'],53,283,336,30543081,9,0.127819549,0.962406015,0.090225564,31001
b3395b43878ab9ee274f39d06d48c98a32f0a1e2,1,Olivér Szabó,2018-01-29 11:46:42+01:00,['d4467fb18448d4b10d12692217ba1c57a00b37b0'],22,117,139,30543220,11,0.833333333,1,0.8,31002
4a9e13c7040761785c7d09e312f37cae590f2221,1,Eugene Chekanskiy,2018-01-29 13:46:05+02:00,['b3395b43878ab9ee274f39d06d48c98a32f0a1e2'],2,10,12,30543232,3,,,,31002
c37068ae4f700dc96900adf5b0e8bc36b8cd2fd3,1,Eugene Chekanskiy,2018-01-29 13:46:44+02:00,['4a9e13c7040761785c7d09e312f37cae590f2221'],1,4,5,30543237,2,,,,31002
8ec17e315a6d0c662c26f0a3e58cf32c7e14a5c0,1,Oliver Szabo,2018-01-29 13:20:27+01:00,['c37068ae4f700dc96900adf5b0e8bc36b8cd2fd3'],51,132,183,30543420,13,0.428571429,0.428571429,0,31002
6f6625f1f5cad74a90adc4b5953dcd5690a3e20d,0,GitHub,2018-01-29 13:31:06+01:00,"['c37068ae4f700dc96900adf5b0e8bc36b8cd2fd3', '8ec17e315a6d0c662c26f0a3e58cf32c7e14a5c0']",51,132,183,30543603,13,,,,31002
9d80433e98b6767de55f7397e22ad039810f1d38,1,Oliver Szabo,2018-01-29 14:58:09+01:00,['6f6625f1f5cad74a90adc4b5953dcd5690a3e20d'],11,240,251,30543854,21,1,1,0.88172043,31003
50208d37a17dacd191518140e3f6f1def685ffb7,0,GitHub,2018-01-29 17:50:43+01:00,"['6f6625f1f5cad74a90adc4b5953dcd5690a3e20d', '9d80433e98b6767de55f7397e22ad039810f1d38']",11,240,251,30544105,21,,,,31003
8b5cf83842f2f1297795b2ec2aa9e834b5d5ef0b,0,Andrii Tkach,2018-01-29 19:49:27+02:00,['50208d37a17dacd191518140e3f6f1def685ffb7'],433,252,685,30544790,11,0.865853659,0,0.073170732,31003
9274e17124e6cf97a21f252e9fb8c456e395daf3,1,Lisnichenko Dmitro,2018-01-29 20:24:47+02:00,['8b5cf83842f2f1297795b2ec2aa9e834b5d5ef0b'],379,586,965,30545755,20,0.816326531,1,0.93877551,31006
9916dcdda3a8707f3310b95811c348be05fbdccb,0,Aleksandr Kovalenko,2018-01-29 20:30:59+02:00,['8b5cf83842f2f1297795b2ec2aa9e834b5d5ef0b'],14,23,37,30545792,3,,,,31006
2b513fa0f1e51347f4d863ad95db2649b924247b,0,Robert Levas,2018-01-29 13:31:30-05:00,['9916dcdda3a8707f3310b95811c348be05fbdccb'],1,1,2,30545794,1,,,,31006
f93067aa5962df4ac20278ed7c497e42125035ad,0,Jayush Luniya,2018-01-29 13:46:17-08:00,['8b5cf83842f2f1297795b2ec2aa9e834b5d5ef0b'],120542,0,120542,30666336,593,0.721126912,0.611560009,0.456798104,31006
f9245e2dc3b85b9048d97ac2a245a27f70eefc0c,0,GitHub,2018-01-29 14:02:02-08:00,"['2b513fa0f1e51347f4d863ad95db2649b924247b', 'f93067aa5962df4ac20278ed7c497e42125035ad']",120542,0,120542,30786878,593,,,,31006
2e8153727cb4c2812fe1cb20bfc5326eb5dabb7c,0,Robert Levas,2018-01-29 20:00:15-05:00,['f9245e2dc3b85b9048d97ac2a245a27f70eefc0c'],49,48,97,30786975,2,,,,31006
86beb8ed1d8a8ff9bba6cd5c93f2747e8e7b0dd7,1,Olivér Szabó,2018-01-30 11:55:55+01:00,['2e8153727cb4c2812fe1cb20bfc5326eb5dabb7c'],2,12,14,30786989,3,,,,31006
82e8f088f9eac87dc644ffaf87b48aa928880171,1,Oliver Szabo,2018-01-30 13:09:28+01:00,['86beb8ed1d8a8ff9bba6cd5c93f2747e8e7b0dd7'],15,125,140,30787129,5,0.894736842,1,1,31008
dd1494291b6276c99d0cf577f23ef45e5dc9656d,0,GitHub,2018-01-30 15:41:37+01:00,"['86beb8ed1d8a8ff9bba6cd5c93f2747e8e7b0dd7', '82e8f088f9eac87dc644ffaf87b48aa928880171']",15,125,140,30787269,5,,,,31008
5a17cb680e980035632647094a698963154533fa,1,Andrii Tkach,2018-01-30 17:28:51+02:00,['dd1494291b6276c99d0cf577f23ef45e5dc9656d'],44,25,69,30787338,2,0,0,0,31008
feb6f7d9096ffc284bdc89f09035d289a1d73d48,0,Madhuvanthi Radhakrishnan,2018-01-30 11:49:59-08:00,['5a17cb680e980035632647094a698963154533fa'],5,1,6,30787344,1,1,1,0,31008
130fbbfeba64cd33e037485041f8fb963c32c036,0,Robert Levas,2018-01-30 18:13:56-05:00,['feb6f7d9096ffc284bdc89f09035d289a1d73d48'],7,36,43,30787387,4,0,1,1,31008
e40e7e5bfcfffac78351278d74e1310a8aa35cc5,0,Robert Levas,2018-01-31 05:14:47-05:00,['130fbbfeba64cd33e037485041f8fb963c32c036'],2,19,21,30787408,2,1,1,1,31008
02105de7cf16e7fe8f7e4f71b99f6606824799fa,0,GitHub,2018-01-31 19:02:37+05:18,"['e40e7e5bfcfffac78351278d74e1310a8aa35cc5', '858fbd239369274def05a0846e8fa63ee53a8ad9']",6,4,10,30787418,1,,,,31008
a69872e24d08000da1bd53b7b7316a33f8118b03,1,Eugene Chekanskiy,2018-01-31 19:47:33+02:00,['02105de7cf16e7fe8f7e4f71b99f6606824799fa'],135,363,498,30787916,6,0.059322034,0.720338983,1,31008
cf58132f747828071fd7d418b607f8d85a3dd747,0,Robert Levas,2018-01-31 14:32:11-05:00,['a69872e24d08000da1bd53b7b7316a33f8118b03'],0,34,34,30787950,3,0.789473684,1,1,31008
0bc48df2015432a0232db3bfdbcc2f139b187ae2,1,aonishuk,2018-01-31 22:18:05+02:00,['cf58132f747828071fd7d418b607f8d85a3dd747'],146,68,214,30788164,19,,,,31008
b2e792e2b1e92dee00e9a55e06674b1beedf39e3,0,Jayush Luniya,2018-01-31 18:54:45-08:00,['0bc48df2015432a0232db3bfdbcc2f139b187ae2'],10,4,14,30788178,1,,,,31008
bee9c2b115345f174a50d8f72033539a1a3ca12d,0,aonishuk,2018-02-01 07:50:51+02:00,['0bc48df2015432a0232db3bfdbcc2f139b187ae2'],5,4,9,30788187,1,1,1,0,31008
4dca5a7969d24b1e742445dd306ffb6d1cfe936b,0,Myroslav Papirkovskyi,2018-02-01 11:52:22+02:00,['c066c972c622070f643a387bd467f75676e1732a'],0,9,9,30788196,1,0,1,1,31008
b9e101b9177465e85e36c1b4055c3e2b4c4a7232,1,GitHub,2018-02-01 16:52:44+02:00,['bee9c2b115345f174a50d8f72033539a1a3ca12d'],7,11,18,30788214,3,,,,31008
9e40dcbe01ac369b0678eb5ebba9f4ba35e0c3ed,1,Oliver Szabo,2018-02-01 15:56:42+01:00,['b9e101b9177465e85e36c1b4055c3e2b4c4a7232'],61,135,196,30788410,7,0,0,1,31009
448923b648eefec732677754f21d024df814b97f,0,GitHub,2018-02-01 15:59:39+01:00,"['b9e101b9177465e85e36c1b4055c3e2b4c4a7232', '9e40dcbe01ac369b0678eb5ebba9f4ba35e0c3ed']",61,135,196,30788606,7,,,,31009
d9e90e907d5cd6c970940e3a5c7ea9e1c9d966a8,0,Dmytro Grinenko,2018-02-01 17:32:16+02:00,['448923b648eefec732677754f21d024df814b97f'],403,280,683,30789289,4,0.06,0,0,31009
ab05dde4511f2a6b0f80d8c469446d31a6f97dd0,0,Oliver Szabo,2018-02-01 16:41:29+01:00,['448923b648eefec732677754f21d024df814b97f'],78,148,226,30789515,7,0.059701493,0.52238806,0.985074627,31009
c79bd217d8e3e1353962f0a2609a2d9a147c9333,0,GitHub,2018-02-01 18:22:46+01:00,"['d9e90e907d5cd6c970940e3a5c7ea9e1c9d966a8', 'ab05dde4511f2a6b0f80d8c469446d31a6f97dd0']",78,148,226,30789741,7,,,,31009
ce5309a7983675fc86c4f87d1dfb68c4d3d5b088,0,GitHub,2018-02-01 10:06:22-08:00,"['c79bd217d8e3e1353962f0a2609a2d9a147c9333', 'b2e792e2b1e92dee00e9a55e06674b1beedf39e3']",10,4,14,30789755,1,,,,31009
13a2ef976db165c7feb18e16d20e36c5a872db13,1,aonishuk,2018-02-02 10:36:06+02:00,['4dca5a7969d24b1e742445dd306ffb6d1cfe936b'],216,389,605,30790360,4,0,1,0,31010
c88e0a1c833bdb4015f721df8985a84077af06b5,1,Robert Levas,2018-02-02 05:40:08-05:00,['ce5309a7983675fc86c4f87d1dfb68c4d3d5b088'],87,84,171,30790531,2,0,0,0,31010
3869055ed2cf643271b103fe85c161940c7196a0,1,GitHub,2018-02-02 14:21:16+02:00,['c88e0a1c833bdb4015f721df8985a84077af06b5'],499,1059,1558,30792089,53,0.509225092,1,0.856088561,31015
40549ef9ae0b16b292c8b462acdbb52306acb2d6,0,Robert Levas,2018-02-02 10:41:31-05:00,['3869055ed2cf643271b103fe85c161940c7196a0'],136,324,460,30792549,8,0.076923077,1,0.990384615,31015
c086dd1dcf3d7dd30de07e09277e78f48307d160,1,Lisnichenko Dmitro,2018-02-02 20:22:54+02:00,['9274e17124e6cf97a21f252e9fb8c456e395daf3'],264,499,763,30793312,27,0,0.930232558,0.837209302,31015
79504f74e83164a9c70713ea54cfc2f257d5be04,1,GitHub,2018-02-03 13:46:48+02:00,['40549ef9ae0b16b292c8b462acdbb52306acb2d6'],209,2418,2627,30795939,34,0.584070796,1,0.522123894,31022
05ad34b181db640f7d1540eaa705cee7c93461b3,1,Sandor Molnar,2018-02-05 10:39:53+01:00,['79504f74e83164a9c70713ea54cfc2f257d5be04'],12,98,110,30796049,3,0.4,0.584615385,0.461538462,31022
fee42d5ce53ce4426cd25f58ff93d65cd92f6f03,1,aBabiichuk,2018-02-05 13:32:20+02:00,['79504f74e83164a9c70713ea54cfc2f257d5be04'],80,321,401,30796450,13,0.24691358,0.981481481,1,31023
42fedc2d5e9ccd00c5345e62174cf141c0a65a30,1,Myroslav Papirkovskyi,2018-02-05 14:57:12+02:00,['13a2ef976db165c7feb18e16d20e36c5a872db13'],50,446,496,30796946,44,0.087209302,0.860465116,0.965116279,31025
591bd9c1140dd76889682ac423b1c0cd96f14b6c,0,Myroslav Papirkovskyi,2018-02-05 14:57:12+02:00,['42fedc2d5e9ccd00c5345e62174cf141c0a65a30'],14,9,23,30796969,2,0,0,0,31025
746a0b8428662a8494f1aceac74c617d98bddc5e,0,GitHub,2018-02-05 14:35:17+01:00,"['fee42d5ce53ce4426cd25f58ff93d65cd92f6f03', '05ad34b181db640f7d1540eaa705cee7c93461b3']",12,98,110,30797079,3,,,,31025
505a1ec7842fa13511d34d26e33b468c9e70d698,1,Aleksandr Kovalenko,2018-02-05 17:00:13+02:00,['746a0b8428662a8494f1aceac74c617d98bddc5e'],2,2,4,30797083,2,,,,31025
1321b423a7d99a0d06c888eb1f0339d54f722507,0,Lisnichenko Dmitro,2018-02-05 17:00:27+02:00,['c086dd1dcf3d7dd30de07e09277e78f48307d160'],104,113,217,30797300,13,1,1,1,31025
271a10b0c241c08ba3d823a7df8d7255d18107d2,0,Lisnichenko Dmitro,2018-02-05 17:08:15+02:00,"['1321b423a7d99a0d06c888eb1f0339d54f722507', '505a1ec7842fa13511d34d26e33b468c9e70d698']",122474,5564,128038,30925338,745,,,,31025
ef801acbb290657760ced9917055fbb6250c95d4,1,aBabiichuk,2018-02-05 17:43:23+02:00,['505a1ec7842fa13511d34d26e33b468c9e70d698'],24,25,49,30925387,8,0,1,0,31025
74122060ad2601cac05e83496d4922b40b6936a9,1,Andrii Tkach,2018-02-05 19:50:22+02:00,['ef801acbb290657760ced9917055fbb6250c95d4'],493,667,1160,30926547,5,1,1,0.944444444,31025
8c153a1587622e5eb602263e5c5a2ad92162be57,0,Robert Levas,2018-02-05 14:53:57-05:00,['74122060ad2601cac05e83496d4922b40b6936a9'],1,1,2,30926549,1,,,,31025
9ff12ff20cbe34b50d807e13b556e4115ea54fa8,1,Lisnichenko Dmitro,2018-02-06 12:48:56+02:00,['271a10b0c241c08ba3d823a7df8d7255d18107d2'],61,110,171,30926720,9,0,0,1,31025
9a3a920e49bb0c21f083cef0eaaf2c1d5c597273,1,Olivér Szabó,2018-02-06 13:16:07+01:00,['8c153a1587622e5eb602263e5c5a2ad92162be57'],78,510,588,30927308,16,0.666666667,0.990740741,0.981481481,31035
d785ac0470d67e62e6bf75082fca5e4fbe0bf644,0,Lisnichenko Dmitro,2018-02-06 14:28:23+02:00,['9ff12ff20cbe34b50d807e13b556e4115ea54fa8'],13,13,26,30927334,6,,,,31035
ccd98369cc5dd42fea053fcf79be85e743143736,1,Andrii Tkach,2018-02-06 15:57:16+02:00,['9a3a920e49bb0c21f083cef0eaaf2c1d5c597273'],5,26,31,30927365,3,,,,31035
eec361b98162dbbcf2d8080170d4245e2a5a52bd,0,Lisnichenko Dmitro,2018-02-06 16:49:56+02:00,['d785ac0470d67e62e6bf75082fca5e4fbe0bf644'],142,0,142,30927507,2,0.425,0,0,31035
3c3b7d1c71770545cbbee9e9b5d329ef9173a7be,0,Alex Antonenko,2018-02-06 18:09:29+03:00,['8c153a1587622e5eb602263e5c5a2ad92162be57'],0,141,141,30927648,2,0.781512605,1,1,31036
7ee8c6177a412875c0712df991a19aec1c73515d,1,Robert Levas,2018-02-06 10:30:03-05:00,['ccd98369cc5dd42fea053fcf79be85e743143736'],4,67,71,30927719,3,0.130434783,0.630434783,0,31036
f751357889eb9b8ff22031f6e83019aeedc90450,1,Olivér Szabó,2018-02-06 16:36:45+01:00,['7ee8c6177a412875c0712df991a19aec1c73515d'],20,97,117,30927836,4,,,,31036
dd164b816d4ffc63958272e70b41017907974c71,1,GitHub,2018-02-06 17:16:34+01:00,['f751357889eb9b8ff22031f6e83019aeedc90450'],10,697,707,30928543,20,0.976744186,1,0.720930233,31047
f881d413ba097d8f26812f87fe925d8c83e133ad,0,GitHub,2018-02-06 22:04:18+05:18,['dd164b816d4ffc63958272e70b41017907974c71'],0,5,5,30928548,1,,,,31047
3fa3965073c282c42fe909379b1c9d4cf7abf038,0,aonishuk,2018-02-06 19:17:00+02:00,['f881d413ba097d8f26812f87fe925d8c83e133ad'],1,2,3,30928551,1,0,0,0,31047
376f94da22280a6fdcfd6f809608dd329817c19f,0,GitHub,2018-02-06 18:39:09+01:00,['3fa3965073c282c42fe909379b1c9d4cf7abf038'],233,761,994,30929545,15,1,1,0.8,31051
c9d614e74ebfd53e699b1985ec8abe1078ad228e,0,Robert Levas,2018-02-06 13:07:28-05:00,['376f94da22280a6fdcfd6f809608dd329817c19f'],2,2,4,30929549,2,,,,31051
ca8934d0e6dbe595ba1ca8b5c3f22bb254ae8e2c,0,GitHub,2018-02-06 21:03:23+02:00,"['c9d614e74ebfd53e699b1985ec8abe1078ad228e', 'eec361b98162dbbcf2d8080170d4245e2a5a52bd']",682,1040,1722,30931271,44,,,,31051
e24f05a0089cd1da05914a48a14639639c3a80d6,0,Yusaku Sako,2018-02-06 11:34:27-08:00,['ca8934d0e6dbe595ba1ca8b5c3f22bb254ae8e2c'],1,13,14,30931285,1,,,,31051
a3672157c24e6cd1bf8d7dc816c5290f386b2969,0,Yusaku Sako,2018-02-06 11:36:20-08:00,['e24f05a0089cd1da05914a48a14639639c3a80d6'],1,1,2,30931287,1,,,,31051
90dd1890c3bf2ee47c7ce360ecd07951b3d97b7a,1,GitHub,2018-02-06 23:16:32+01:00,['a3672157c24e6cd1bf8d7dc816c5290f386b2969'],18,109,127,30931414,3,,,,31051
1899e8f58a0bdcab646b8e73328aa2c5a05e0326,0,GitHub,2018-02-07 12:16:44+02:00,"['90dd1890c3bf2ee47c7ce360ecd07951b3d97b7a', '3c3b7d1c71770545cbbee9e9b5d329ef9173a7be']",0,141,141,30931555,2,,,,31051
f52709f1669f894f21dd6c72288f23fd7f10ebe8,0,Andrii Tkach,2018-02-07 15:26:11+02:00,['1899e8f58a0bdcab646b8e73328aa2c5a05e0326'],108,121,229,30931784,9,,,,31051
5430d488df19e6d94b1d764fee24edf74f49ee90,0,Alex Antonenko,2018-02-07 20:36:12+03:00,['f52709f1669f894f21dd6c72288f23fd7f10ebe8'],4,3,7,30931791,2,1,1,1,31051
cd57dacb003cd38743d6321e1dfc4e4f172a2fbf,0,GitHub,2018-02-07 22:12:23+02:00,"['f52709f1669f894f21dd6c72288f23fd7f10ebe8', '5430d488df19e6d94b1d764fee24edf74f49ee90']",4,3,7,30931798,2,,,,31051
c7159a7acc77f3d417c6ff5b817aa04ebbcd68f3,0,GitHub,2018-02-07 13:44:41-08:00,['cd57dacb003cd38743d6321e1dfc4e4f172a2fbf'],57,25,82,30931880,3,0,0,0,31051
c52806a4e88aca976ae0ff89909e4fa7d010bb2a,1,Olivér Szabó,2018-02-08 13:30:47+01:00,['c7159a7acc77f3d417c6ff5b817aa04ebbcd68f3'],0,6,6,30931886,1,,,,31051
1eeedb51130e8b46be41d90b68912dae5d4e48d3,1,Robert Levas,2018-02-08 08:17:24-05:00,['c52806a4e88aca976ae0ff89909e4fa7d010bb2a'],108,108,216,30932102,4,,,,31051
ab93e78b5c468836dfcdfb1bff743e815cb6e455,1,Myroslav Papirkovskyi,2018-02-08 16:35:38+02:00,"['591bd9c1140dd76889682ac423b1c0cd96f14b6c', 'c7159a7acc77f3d417c6ff5b817aa04ebbcd68f3']",156047,67694,223741,31155843,1731,,,,31051
1318fdb8d14cff96d2ef923b5ed38104ee91ff60,0,GitHub,2018-02-08 11:26:14-05:00,['1eeedb51130e8b46be41d90b68912dae5d4e48d3'],638,8,646,31156489,8,0.89456869,0.364217252,0.268370607,31051
f62e103ceda822b5a461f58402b817af965c7776,1,Myroslav Papirkovskyi,2018-02-08 19:27:36+02:00,['ab93e78b5c468836dfcdfb1bff743e815cb6e455'],421,227,648,31157137,22,0.752808989,0.224719101,1,31051
c3a05fe8872398c9362f7e3323f47cdce9a0a471,1,GitHub,2018-02-08 13:06:15-05:00,['1318fdb8d14cff96d2ef923b5ed38104ee91ff60'],149,441,590,31157727,28,0.569620253,0.664556962,0.930379747,31051
26bf7a2d24f2489fbf6c3df50b32f4ce70dff183,1,GitHub,2018-02-08 10:18:04-08:00,['c3a05fe8872398c9362f7e3323f47cdce9a0a471'],244,263,507,31158234,2,,,,31051
03b30150b70c6bae047ec1556308d20943d6b393,0,aonishuk,2018-02-09 14:17:41+02:00,['26bf7a2d24f2489fbf6c3df50b32f4ce70dff183'],0,4,4,31158238,1,,,,31051
48582d17adf826b1144b3c3ab9ee3c826a866344,0,aonishuk,2018-02-09 14:17:41+02:00,['03b30150b70c6bae047ec1556308d20943d6b393'],18,11,29,31158267,1,,,,31051
2160d7a0d0255adbe79ab776030654140285114e,0,Myroslav Papirkovskyi,2018-02-09 16:25:53+02:00,['f62e103ceda822b5a461f58402b817af965c7776'],0,8,8,31158275,2,0.75,1,1,31051
be703e8a70e63a78a58f5867287c47a380fddda5,0,Robert Levas,2018-02-09 09:40:51-05:00,['48582d17adf826b1144b3c3ab9ee3c826a866344'],1,1,2,31158277,1,,,,31051
929ac2eaf4261bf61d0d4ad9c1bbd8794808bd33,1,GitHub,2018-02-09 22:13:42+01:00,['be703e8a70e63a78a58f5867287c47a380fddda5'],34,14,48,31158325,9,,,,31051
21c5c8a0d74b878bfe313a4f3efbf33677b59a24,0,Myroslav Papirkovskyi,2018-02-10 00:24:55+02:00,"['2160d7a0d0255adbe79ab776030654140285114e', 'be703e8a70e63a78a58f5867287c47a380fddda5']",1149,836,1985,31160310,44,,,,31051
fc4db6110b0b9b2606737cfb27db11a53ab5e097,1,Myroslav Papirkovskyi,2018-02-10 01:30:39+02:00,['21c5c8a0d74b878bfe313a4f3efbf33677b59a24'],2183,4,2187,31162497,3,,,,31051
e4b51f939418e0669bf363b38f48f4d5f1169935,0,Myroslav Papirkovskyi,2018-02-10 02:10:53+02:00,"['fc4db6110b0b9b2606737cfb27db11a53ab5e097', '929ac2eaf4261bf61d0d4ad9c1bbd8794808bd33']",13,15,28,31162525,9,,,,31051
2421d981baab8552b15319550d9fe46ca569e27d,1,GitHub,2018-02-10 01:16:38+01:00,['929ac2eaf4261bf61d0d4ad9c1bbd8794808bd33'],2110,738,2848,31165373,29,0.834394904,0.707006369,0.076433121,31052
e70a76c3da18bb0bca8bcaacb35a34eadfeaf077,0,GitHub,2018-02-10 02:18:09+02:00,"['591bd9c1140dd76889682ac423b1c0cd96f14b6c', 'e4b51f939418e0669bf363b38f48f4d5f1169935']",159994,68965,228959,31394332,1774,,,,31052
e7bae5b3e2286cda53acac65f1c2d1b508414395,1,"Doroszlai, Attila",2018-02-10 09:29:19+01:00,['2421d981baab8552b15319550d9fe46ca569e27d'],322,2057,2379,31396711,86,0.225311601,0.279002876,0.272291467,31054
19a73f0b08a099283f642db719b6a2b5f3f431d2,1,"Doroszlai, Attila",2018-02-11 20:02:37+01:00,['e7bae5b3e2286cda53acac65f1c2d1b508414395'],56,30,86,31396797,9,,,,31054
b2f99fb6f8baee3725218d7b243d98419a86161e,1,Olivér Szabó,2018-02-12 10:37:00+01:00,['19a73f0b08a099283f642db719b6a2b5f3f431d2'],13,18,31,31396828,4,0,1,1,31054
413d3d960ec5101abfaf1023e13337399a3240bf,0,aonishuk,2018-02-12 14:06:03+02:00,['b2f99fb6f8baee3725218d7b243d98419a86161e'],13,8,21,31396849,2,1,1,0.25,31054
c414b2554ac47a2327f62da37ab2637ad128219b,0,aonishuk,2018-02-12 14:06:16+02:00,['413d3d960ec5101abfaf1023e13337399a3240bf'],2,193,195,31397044,5,0.198347107,0.619834711,0.975206612,31055
cf2d6e18e7f947334556f4531f07bd6b8759fd40,1,Andrii Tkach,2018-02-12 19:50:58+02:00,['c414b2554ac47a2327f62da37ab2637ad128219b'],32,73,105,31397149,6,1,1,1,31055
e2ddcbbec50ba07b585a532a92dde0ac18f87e50,1,Dmytro Grinenko,2018-02-12 21:18:46+02:00,['cf2d6e18e7f947334556f4531f07bd6b8759fd40'],1,1,2,31397151,1,,,,31055
2b7371963ce943140ec36b5f5ad87b04a9d18fbc,1,Oliver Szabo,2018-02-13 03:00:38+01:00,['e2ddcbbec50ba07b585a532a92dde0ac18f87e50'],3,11,14,31397165,3,,,,31055
9720c68060aaf3189ef4f3ea358f1eec6bfce1d2,0,aonishuk,2018-02-13 10:51:58+02:00,['2b7371963ce943140ec36b5f5ad87b04a9d18fbc'],5,17,22,31397187,2,1,1,0,31055
3af5a0712e957b3a639666380719f51fa4d4b815,1,Aleksandr Kovalenko,2018-02-13 11:11:38+02:00,['9720c68060aaf3189ef4f3ea358f1eec6bfce1d2'],2,688,690,31397877,26,0.888297872,1,1,31070
15ec6f5e084f81a21b3a3545dbdf4ed33492bc0f,1,Andrii Tkach,2018-02-13 11:37:50+02:00,['3af5a0712e957b3a639666380719f51fa4d4b815'],667,528,1195,31399072,17,0,0.210526316,0,31071
db4b701799d039e362572c72ffc1a4d124421b0d,0,Andrii Tkach,2018-02-13 13:26:01+02:00,['15ec6f5e084f81a21b3a3545dbdf4ed33492bc0f'],0,3,3,31399075,1,1,1,1,31071
6686d11b114f32e999df25deda5a890b1f0bd1c5,0,hiveww,2018-02-13 15:09:04+02:00,['db4b701799d039e362572c72ffc1a4d124421b0d'],1,1,2,31399077,1,,,,31071
dff583c4f30e2b2d40490b631b2b1c0daaeda7a1,1,aBabiichuk,2018-02-13 15:57:09+02:00,['db4b701799d039e362572c72ffc1a4d124421b0d'],352,473,825,31399902,19,0,1,1,31071
d49fb1b96e9701c989d2eff13d0a0b3fcc092662,1,Olivér Szabó,2018-02-13 15:42:19+01:00,['dff583c4f30e2b2d40490b631b2b1c0daaeda7a1'],5,5,10,31399912,5,,,,31071
628cd06ebe421397622953cc79809232df0a0363,1,Olivér Szabó,2018-02-13 15:53:43+01:00,['d49fb1b96e9701c989d2eff13d0a0b3fcc092662'],12,48,60,31399972,2,,,,31071
f430ba7c67d7ccda76c18cdd386d67cf746eebe9,0,"Doroszlai, Attila",2018-02-13 16:09:34+01:00,['628cd06ebe421397622953cc79809232df0a0363'],15,15,30,31400002,1,,,,31071
3de2f9d44578e3844416915ac45bbed8b80b8c26,0,GitHub,2018-02-13 18:32:50+01:00,['f430ba7c67d7ccda76c18cdd386d67cf746eebe9'],54,54,108,31400110,16,,,,31071
d7dda67fb341346001f90b84ea939a0504426d5f,0,GitHub,2018-02-13 21:27:47+03:00,"['3de2f9d44578e3844416915ac45bbed8b80b8c26', '6686d11b114f32e999df25deda5a890b1f0bd1c5']",1,1,2,31400112,1,,,,31071
6d1dc6c4e5baa5b8044806ef0c29f6d15050d70e,0,Siddharth,2018-02-13 11:06:08-08:00,['d7dda67fb341346001f90b84ea939a0504426d5f'],0,1,1,31400113,1,0,1,1,31071
fd46cc507d93a7f069df523997c16f7336b45302,0,Siddharth,2018-02-13 11:16:09-08:00,['6d1dc6c4e5baa5b8044806ef0c29f6d15050d70e'],3,3,6,31400119,1,,,,31071
4243e3367df2c9826bc94b8584ec0f12d6f6c4be,1,Attila Magyar,2018-02-13 20:39:24+01:00,['fd46cc507d93a7f069df523997c16f7336b45302'],2,6,8,31400127,1,0,0,0,31071
74b04bc4318383dbae3c7bfc40247cf32616edeb,1,Prabhjyot,2018-02-14 14:57:29+05:18,['4243e3367df2c9826bc94b8584ec0f12d6f6c4be'],1,22,23,31400150,1,0,0.05,1,31071
3c8187716ed6d454a1d7b4f173c5d6e047d6c99a,1,aonishuk,2018-02-14 16:09:25+02:00,['e70a76c3da18bb0bca8bcaacb35a34eadfeaf077'],12,20,32,31400182,6,0,1,1,31071
8c91055596d26cab6838f86f86ff031d2f1a21f3,0,aonishuk,2018-02-14 16:10:24+02:00,['74b04bc4318383dbae3c7bfc40247cf32616edeb'],0,1,1,31400183,1,0,0,1,31071
4af9d720967bb90842bc91533b22611ba21bacdb,1,Lisnichenko Dmitro,2018-02-14 16:57:44+02:00,['8c91055596d26cab6838f86f86ff031d2f1a21f3'],0,39,39,31400222,2,0.037037037,0.037037037,1,31071
1cc31ff19c440d02ec23d45b630b2c01b43a512e,0,hiveww,2018-02-14 17:24:42+02:00,['8c91055596d26cab6838f86f86ff031d2f1a21f3'],2,1,3,31400225,1,,,,31071
dc697410dd7e48e4e3705b81e8342a4b0f812769,0,Eugene Chekanskiy,2018-02-14 18:02:39+02:00,['8c91055596d26cab6838f86f86ff031d2f1a21f3'],0,4,4,31400229,1,0,0,1,31071
fa7c3952d7464c7dbd778baa2b8ea2f4470d2f3d,0,Lisnichenko Dmitro,2018-02-14 18:28:34+02:00,['4af9d720967bb90842bc91533b22611ba21bacdb'],3,2,5,31400234,2,1,1,0,31071
619ecf6a6ab197eafcc985b3ec7d808623594442,0,Robert Levas,2018-02-14 13:04:30-05:00,['dc697410dd7e48e4e3705b81e8342a4b0f812769'],0,3,3,31400237,1,0,1,1,31071
b4b8e16c75538f412f74a344e096d9bd0721312c,0,GitHub,2018-02-14 19:27:20+01:00,['dc697410dd7e48e4e3705b81e8342a4b0f812769'],37,32,69,31400306,6,1,0,0,31071
6d2c6bab0ba57c362bc06871f866b1d6a914e5eb,1,Siddharth,2018-02-14 10:36:21-08:00,['b4b8e16c75538f412f74a344e096d9bd0721312c'],43,81,124,31400430,2,0.772727273,0.863636364,0.409090909,31071
7d441cc4587c42a9cc73160a92681152ca1c67fa,0,Siddharth,2018-02-14 10:36:21-08:00,['6d2c6bab0ba57c362bc06871f866b1d6a914e5eb'],0,1,1,31400431,1,0,1,1,31071
bbb590026b788eaefc63962277621fa487a4e615,0,Lisnichenko Dmitro,2018-02-14 20:45:51+02:00,['fa7c3952d7464c7dbd778baa2b8ea2f4470d2f3d'],2,11,13,31400444,1,0,0.666666667,1,31071
869e4cdeeb318ca86991a95fa8ad90b42686b998,0,Aravindan Vijayan,2018-02-14 11:07:09-08:00,['b4b8e16c75538f412f74a344e096d9bd0721312c'],2,2,4,31400448,2,,,,31071
af893a625ad5897b2703fd1d7038caaac33bee27,0,GitHub,2018-02-14 12:49:21-08:00,"['7d441cc4587c42a9cc73160a92681152ca1c67fa', '869e4cdeeb318ca86991a95fa8ad90b42686b998']",2,2,4,31400452,2,,,,31071
67cfb927161ab9f5f6b40922fbdb5843dff2112f,0,GitHub,2018-02-14 14:02:45-08:00,"['af893a625ad5897b2703fd1d7038caaac33bee27', '619ecf6a6ab197eafcc985b3ec7d808623594442']",0,3,3,31400455,1,,,,31071
b7e060603feba217b4a0c5cbb32b6d97987f60fe,1,Robert Levas,2018-02-14 18:25:39-05:00,['67cfb927161ab9f5f6b40922fbdb5843dff2112f'],0,6,6,31400461,1,1,1,1,31071
91462df2291e0cccccb5a1b66d006b9101307e9c,0,Robert Levas,2018-02-14 18:25:39-05:00,['b7e060603feba217b4a0c5cbb32b6d97987f60fe'],11,3,14,31400475,1,0.25,0.25,0.25,31071
d07395a246d56153df44876dcc2cc2110e43297e,0,Jonathan Hurley,2018-02-15 00:34:25-05:00,['91462df2291e0cccccb5a1b66d006b9101307e9c'],0,10,10,31400485,1,,,,31071
79c1a134c1af2b17c1a16fda4ca1c9771b779e53,0,GitHub,2018-02-15 13:17:26+02:00,"['d07395a246d56153df44876dcc2cc2110e43297e', 'bbb590026b788eaefc63962277621fa487a4e615']",2,49,51,31400536,3,,,,31071
f9707fde1b2547e367388088c8e62a97e29b3e5c,1,aBabiichuk,2018-02-15 15:11:48+02:00,['79c1a134c1af2b17c1a16fda4ca1c9771b779e53'],44,104,148,31400684,7,0.952380952,0.952380952,1,31071
c5111096eb5a5716317f3453c886356a020171a1,0,Robert Levas,2018-02-15 08:24:52-05:00,['f9707fde1b2547e367388088c8e62a97e29b3e5c'],7,7,14,31400698,1,,,,31071
91e428686dabe3e3bf177629eaa9f36bac786c03,0,Alex Antonenko,2018-02-15 17:10:00+03:00,"['1cc31ff19c440d02ec23d45b630b2c01b43a512e', 'c5111096eb5a5716317f3453c886356a020171a1']",140,296,436,31401134,25,,,,31071
d117ce855b5f68a63e25ba426d055dae3ba32777,1,Alex Antonenko,2018-02-15 17:19:29+03:00,['91e428686dabe3e3bf177629eaa9f36bac786c03'],0,4,4,31401138,1,0,1,1,31071
91aa6dc130e99dbacc77627a186f6fe9233a847b,1,Akhil Subhash Naik,2018-02-15 19:42:09+05:18,['c5111096eb5a5716317f3453c886356a020171a1'],0,3,3,31401141,1,1,1,1,31071
4cf5be31c81eb002ee84cbb1818c35627a4815b7,0,GitHub,2018-02-15 17:44:28+03:00,"['c5111096eb5a5716317f3453c886356a020171a1', 'd117ce855b5f68a63e25ba426d055dae3ba32777']",2,5,7,31401148,2,,,,31071
6c3d925abecfdc4e7de6ec25512c2cc765660e4c,0,GitHub,2018-02-15 07:46:07-08:00,['4cf5be31c81eb002ee84cbb1818c35627a4815b7'],5,16,21,31401169,2,,,,31071
8ac7440bd7ce0f65532985f3d68e1583fc40d5b8,0,GitHub,2018-02-15 18:30:10+01:00,['6c3d925abecfdc4e7de6ec25512c2cc765660e4c'],2105,4,2109,31403278,5,1,1,0,31071
0a33a07be6dd1e598c2ba928e460fe93ce80a501,0,GitHub,2018-02-15 13:38:27-05:00,['8ac7440bd7ce0f65532985f3d68e1583fc40d5b8'],2,2,4,31403282,1,,,,31071
236ca47828a7f64d792980d7e088891ba06306e1,0,Siddharth,2018-02-15 12:24:22-08:00,['8ac7440bd7ce0f65532985f3d68e1583fc40d5b8'],0,5,5,31403287,1,,,,31071
c13b57986bf3803c2d99a2ad06d78b5e00750339,0,Robert Levas,2018-02-15 15:43:51-05:00,['236ca47828a7f64d792980d7e088891ba06306e1'],4,6,10,31403297,4,,,,31071
61b61067d143a92cd82212447a5ec4b9e3f0c296,0,Robert Levas,2018-02-15 15:43:51-05:00,['c13b57986bf3803c2d99a2ad06d78b5e00750339'],2,2,4,31403301,2,,,,31071
f0e05da42df55151ec745ecf445dc7ee941c0379,1,Aravindan Vijayan,2018-02-15 14:16:47-08:00,['61b61067d143a92cd82212447a5ec4b9e3f0c296'],19,180,199,31403500,11,0.718309859,0.985915493,0.450704225,31072
30e179fba6e8c5f38a917ec128e6ed58fe3556fb,1,aonishuk,2018-02-16 10:13:41+02:00,['3c8187716ed6d454a1d7b4f173c5d6e047d6c99a'],0,46,46,31403546,1,0,0.96,1,31072
0aa22ea8d1482415c85178118d54081dc9e0a0c6,1,aonishuk,2018-02-16 11:04:20+02:00,['30e179fba6e8c5f38a917ec128e6ed58fe3556fb'],10,10,20,31403566,10,,,,31072
903a3dee897a6c9f121429a0db9c0db79b0f0ee5,1,Aleksandr Kovalenko,2018-02-16 12:55:50+02:00,['61b61067d143a92cd82212447a5ec4b9e3f0c296'],5,98,103,31403669,9,1,1,1,31072
8c6590b61927ae7ff858d4c3691032e26de13dd9,0,GitHub,2018-02-16 14:51:30+02:00,"['903a3dee897a6c9f121429a0db9c0db79b0f0ee5', '0aa22ea8d1482415c85178118d54081dc9e0a0c6']",11060,52771,63831,31467500,943,,,,31072
92dd24e7a51f4a6305f787968f7fa23431fa8af2,0,Aleksandr Kovalenko,2018-02-16 16:20:46+02:00,['8c6590b61927ae7ff858d4c3691032e26de13dd9'],0,92,92,31467592,2,1,1,1,31072
de767ee85775df433e90dd023660fd23dae1b40e,1,Aleksandr Kovalenko,2018-02-16 17:04:19+02:00,['92dd24e7a51f4a6305f787968f7fa23431fa8af2'],294,5821,6115,31473707,236,0.795275591,0.887795276,0.962598425,31115
286b7bf052027caad11d71789b2b263ac1ac917c,0,Aleksandr Kovalenko,2018-02-16 17:04:19+02:00,['de767ee85775df433e90dd023660fd23dae1b40e'],17,1,18,31473725,2,0.666666667,0.25,0.333333333,31115
837b42ea477949af3104165ec1f0e0051e9da8c3,1,Eugene Chekanskiy,2018-02-16 17:12:37+02:00,['286b7bf052027caad11d71789b2b263ac1ac917c'],41,117,158,31473883,8,0.025,0.025,0,31116
c1e87ac1e8db91fd332693d829f4536acef54393,0,Eugene Chekanskiy,2018-02-16 17:20:46+02:00,['837b42ea477949af3104165ec1f0e0051e9da8c3'],6,2,8,31473891,1,0,0,0,31116
a59d3401bd12ee257f54933e9a1f1b13d36e78d3,0,GitHub,2018-02-16 17:27:42+01:00,['c1e87ac1e8db91fd332693d829f4536acef54393'],0,220,220,31474111,6,,,,31122
8cb349f9c09b3ba676d9fd8ea72ce8f3bd83b570,1,GitHub,2018-02-16 20:47:33+01:00,['a59d3401bd12ee257f54933e9a1f1b13d36e78d3'],23,11,34,31474145,2,,,,31122
1846978a7289afc12375a025b3b023b5978f893b,0,GitHub,2018-02-16 15:29:19-05:00,"['8cb349f9c09b3ba676d9fd8ea72ce8f3bd83b570', '0a33a07be6dd1e598c2ba928e460fe93ce80a501']",2,2,4,31474149,1,,,,31122
3a52f278961406d198f4e89c30e49f989f26c143,0,Siddharth,2018-02-16 13:05:55-08:00,['1846978a7289afc12375a025b3b023b5978f893b'],0,38,38,31474187,2,0.043478261,1,1,31122
57aa2073d31c9f096ac31172adb48e0240875981,1,GitHub,2018-02-17 19:06:39+01:00,['3a52f278961406d198f4e89c30e49f989f26c143'],59,76,135,31474322,1,,,,31122
83e883cfa15ea57e96b07f68c26a66db7056d453,0,GitHub,2018-02-18 09:02:15+01:00,['57aa2073d31c9f096ac31172adb48e0240875981'],5,5,10,31474332,5,,,,31122
794bc557e4910815a51b27c8dab015beda6ea4db,1,Oliver Szabo,2018-02-19 11:13:46+01:00,['83e883cfa15ea57e96b07f68c26a66db7056d453'],643,1493,2136,31476468,40,0.704950495,0.738613861,0.677227723,31137
7883bc522eac3da3f998258f91851693913d08ef,1,Oliver Szabo,2018-02-19 11:13:46+01:00,['794bc557e4910815a51b27c8dab015beda6ea4db'],15,97,112,31476580,8,1,1,1,31139
4df8e38835e08fd42d8958a59f33d1d22c11aae1,1,Oliver Szabo,2018-02-19 11:13:46+01:00,['7883bc522eac3da3f998258f91851693913d08ef'],3168,2441,5609,31482189,36,0,0,1,31140
7bf9227e1070eec526152cc040535950083e712f,0,GitHub,2018-02-19 11:16:04+01:00,"['83e883cfa15ea57e96b07f68c26a66db7056d453', '4df8e38835e08fd42d8958a59f33d1d22c11aae1']",3802,4007,7809,31489998,81,,,,31140
eebcfed45af037df7223945909b115737cd722da,0,Sandor Molnar,2018-02-19 14:02:17+01:00,['7bf9227e1070eec526152cc040535950083e712f'],1,1,2,31490000,1,,,,31140
95fe6549e09b15a5872c4a79ce027c5cef2ff190,0,Aravindan Vijayan,2018-02-19 06:31:16-08:00,['7bf9227e1070eec526152cc040535950083e712f'],39,42,81,31490081,1,,,,31140
55b300170ec83e03fb08c4edb8821b9054d60682,0,Sandor Molnar,2018-02-19 15:36:02+01:00,['7bf9227e1070eec526152cc040535950083e712f'],1,1,2,31490083,1,,,,31140
595e852d2f5de7c88ba7d565634876d6376ca988,0,GitHub,2018-02-19 06:36:14-08:00,"['7bf9227e1070eec526152cc040535950083e712f', '95fe6549e09b15a5872c4a79ce027c5cef2ff190']",39,42,81,31490164,1,,,,31140
2644a3947c66cd13473a24f1bf8c6b161f56ca17,1,GitHub,2018-02-19 16:16:05+01:00,['595e852d2f5de7c88ba7d565634876d6376ca988'],5,5,10,31490174,2,,,,31140
147330c6c4cbe73fd3212150ad48282846fc83ee,1,Olivér Szabó,2018-02-19 17:54:03+01:00,['2644a3947c66cd13473a24f1bf8c6b161f56ca17'],47,2908,2955,31493129,35,0.189393939,0.212121212,1,31142
ee603f27c81b447e16112a7190e8c0d996680cd4,0,Oliver Szabo,2018-02-20 07:47:14+01:00,['147330c6c4cbe73fd3212150ad48282846fc83ee'],1,1,2,31493131,1,,,,31142
83c0e67dff5e2a2f91c04ddb09a689df94c1f592,1,aonishuk,2018-02-20 09:36:48+02:00,['ee603f27c81b447e16112a7190e8c0d996680cd4'],20,283,303,31493434,11,,,,31146
07287c5da0d246ace9243b1804afbdd5a33a5d7d,1,Oliver Szabo,2018-02-20 09:11:30+01:00,['83c0e67dff5e2a2f91c04ddb09a689df94c1f592'],51,50,101,31493535,12,,,,31146
34cb92e0ba0252f97ad3228e51f27cfb4fb6a50a,1,Akhil Subhash Naik,2018-02-20 16:05:27+05:18,['07287c5da0d246ace9243b1804afbdd5a33a5d7d'],494,106,600,31494135,17,0.101910828,0,0,31146
874abb60ca406aae55ad2ed0de3c36cd8f2b1b71,0,Akhil Subhash Naik,2018-02-20 16:07:44+05:18,['34cb92e0ba0252f97ad3228e51f27cfb4fb6a50a'],0,540,540,31494675,10,0.92195122,1,1,31156
7eb382862ae8c0f3f32dd8d1139029889ed43bbc,0,Alex Antonenko,2018-02-20 16:51:12+03:00,['07287c5da0d246ace9243b1804afbdd5a33a5d7d'],2,2,4,31494679,1,,,,31156
18e4da86ee35f8a57d819a39ab06b07beedd1649,0,Lisnichenko Dmitro,2018-02-20 18:02:24+02:00,['07287c5da0d246ace9243b1804afbdd5a33a5d7d'],0,1343,1343,31496022,2,,,,31157
ce485b7f5d233da6fa6e7a371ec3c57f4c7bda5f,0,GitHub,2018-02-20 19:54:14+03:00,"['07287c5da0d246ace9243b1804afbdd5a33a5d7d', '7eb382862ae8c0f3f32dd8d1139029889ed43bbc']",2,2,4,31496026,1,,,,31157
003102bf65e9bf835bda88c862580832e1704748,0,Lisnichenko Dmitro,2018-02-20 19:05:41+02:00,['18e4da86ee35f8a57d819a39ab06b07beedd1649'],0,11,11,31496037,1,,,,31157
c339e6f778a74e2281b8a629632830087991f899,0,GitHub,2018-02-20 19:11:30+02:00,"['ce485b7f5d233da6fa6e7a371ec3c57f4c7bda5f', '003102bf65e9bf835bda88c862580832e1704748']",0,1354,1354,31497391,2,,,,31157
a3b7e7cfa1d04df4eb212743f53c2c626e13976f,0,GitHub,2018-02-20 09:14:00-08:00,"['c339e6f778a74e2281b8a629632830087991f899', 'f0e05da42df55151ec745ecf445dc7ee941c0379']",19,180,199,31497590,11,,,,31157
dec0cb49ea5468c983bca5d78d64769ae619e5f3,1,Andrii Tkach,2018-02-20 20:02:49+02:00,['a3b7e7cfa1d04df4eb212743f53c2c626e13976f'],32,28,60,31497650,6,0,0,0.142857143,31157
a4b3d658ffbef0bbb80212d6080e12c601d98596,0,GitHub,2018-02-20 20:01:41+01:00,['dec0cb49ea5468c983bca5d78d64769ae619e5f3'],5,5,10,31497660,5,,,,31157
78df59c1380d770dbc053063b0368ce89b8907ea,0,"Doroszlai, Attila",2018-02-20 23:26:47+01:00,['a4b3d658ffbef0bbb80212d6080e12c601d98596'],12,3,15,31497675,3,1,1,1,31157
ca2064e267752e5e20e52b585abce916268bfdf3,1,GitHub,2018-02-21 11:16:09+01:00,['78df59c1380d770dbc053063b0368ce89b8907ea'],10,136,146,31497821,4,0.520547945,0.561643836,0.849315068,31158
1495e513af4b28c2289b69dac079512ea2f086ae,0,Andrii Tkach,2018-02-21 12:35:03+02:00,['ca2064e267752e5e20e52b585abce916268bfdf3'],3,4,7,31497828,2,0,1,1,31158
1ee683b272ea3c6b81f659a3fa4e5d599859aed4,1,Oliver Szabo,2018-02-21 12:06:00+01:00,['1495e513af4b28c2289b69dac079512ea2f086ae'],1,1,2,31497830,1,,,,31158
957dd89cbc4910386a803a4faf512ceac3407291,0,Aleksandr Kovalenko,2018-02-21 13:21:03+02:00,['1ee683b272ea3c6b81f659a3fa4e5d599859aed4'],1,24,25,31497855,2,1,1,1,31158
ef35fb0da672e53a03038581af7ac6d0f73048bb,0,GitHub,2018-02-21 15:25:19+02:00,"['957dd89cbc4910386a803a4faf512ceac3407291', 'eebcfed45af037df7223945909b115737cd722da']",1,1,2,31497857,1,,,,31158
80d3dca600253820468d0d940bdd95ba76ef88d2,0,GitHub,2018-02-21 15:26:09+02:00,"['ef35fb0da672e53a03038581af7ac6d0f73048bb', '55b300170ec83e03fb08c4edb8821b9054d60682']",1,1,2,31497859,1,,,,31158
03de6ee318a303c02e3ca5d48f4c600605e94831,0,Robert Levas,2018-02-21 09:10:23-05:00,['80d3dca600253820468d0d940bdd95ba76ef88d2'],57,15,72,31497931,5,,,,31158
713e6de022aef58c96184ab50382d64d410eef4d,0,aonishuk,2018-02-21 17:44:28+02:00,['03de6ee318a303c02e3ca5d48f4c600605e94831'],1,0,1,31497932,1,1,1,1,31158
e0c066ee1270a0482dfc613e3f7a45c80797a657,0,GitHub,2018-02-21 21:21:29+02:00,['713e6de022aef58c96184ab50382d64d410eef4d'],15,1,16,31497948,2,,,,31158
9be99cec9b0ad7aaa0290309ba9c56927498c8f6,0,GitHub,2018-02-21 21:43:37+02:00,['e0c066ee1270a0482dfc613e3f7a45c80797a657'],0,33,33,31497981,1,0,0,1,31158
9d646a4d9252d79e9cdeda21a208eaaafabf1707,1,Andrii Tkach,2018-02-22 11:48:30+02:00,['9be99cec9b0ad7aaa0290309ba9c56927498c8f6'],11,14,25,31498006,3,1,1,1,31158
02a21e7f70915d0242593420587956eed6fa5c53,0,GitHub,2018-02-22 14:03:31+01:00,['9d646a4d9252d79e9cdeda21a208eaaafabf1707'],2,0,2,31498008,1,,,,31158
344ceebc7268a32f3fc26037eb6a176c26af2389,0,aonishuk,2018-02-22 15:26:33+02:00,['02a21e7f70915d0242593420587956eed6fa5c53'],2,2,4,31498012,2,,,,31158
a76eb18d940367a9376f317b11133a4eaf668e1c,0,aonishuk,2018-02-22 15:26:33+02:00,['344ceebc7268a32f3fc26037eb6a176c26af2389'],4,20,24,31498036,2,1,1,0.545454545,31158
463602a2e65da8e038306de25aebd6ca556f9b8c,0,Aravindan Vijayan,2018-02-22 15:10:22-08:00,['a76eb18d940367a9376f317b11133a4eaf668e1c'],13,47,60,31498096,5,,,,31158
6e6b4a1d74b46b501c9b071aae1f849502871b3f,1,aonishuk,2018-02-23 12:14:03+02:00,['a76eb18d940367a9376f317b11133a4eaf668e1c'],294,1011,1305,31499401,25,0.267062315,0.774480712,0.943620178,31162
b78b61b1f092d5e68fc3f08396d533cd1d99d67a,1,GitHub,2018-02-23 08:59:08-08:00,['6e6b4a1d74b46b501c9b071aae1f849502871b3f'],195,2,197,31499598,5,0.801652893,0.380165289,0.024793388,31162
f0d9323928003c71455667a32bef3e127909a062,0,GitHub,2018-02-23 09:27:14-08:00,"['b78b61b1f092d5e68fc3f08396d533cd1d99d67a', '463602a2e65da8e038306de25aebd6ca556f9b8c']",13,47,60,31499658,5,,,,31162
3c4f83048bd35e5b11838dfbdc11eb765f208cfc,1,GitHub,2018-02-23 19:49:13+02:00,['f0d9323928003c71455667a32bef3e127909a062'],361,641,1002,31500660,14,0.913793103,0.818965517,0.887931034,31162
5a6285ab2707a4173183baf0eb5e99a9c8fc5c1b,1,GitHub,2018-02-23 21:04:29+01:00,['3c4f83048bd35e5b11838dfbdc11eb765f208cfc'],221,127,348,31501008,13,0.712328767,0.232876712,0.424657534,31162
7c1f557827332c340ce5161083ade8654bcd6c38,0,GitHub,2018-02-24 00:43:33+01:00,['5a6285ab2707a4173183baf0eb5e99a9c8fc5c1b'],9,9,18,31501026,8,,,,31162
8b8c832d8edff102407ff4273eca28053ed1d750,1,GitHub,2018-02-23 15:54:43-08:00,['7c1f557827332c340ce5161083ade8654bcd6c38'],5,29,34,31501060,4,1,1,1,31162
2cbb34854ef4fdd7fdacfd105ce830008cdd8d66,0,GitHub,2018-02-24 02:15:47+02:00,['8b8c832d8edff102407ff4273eca28053ed1d750'],1,1,2,31501062,1,,,,31162
95a203b84657d2cdfd5aa51379ecd20348ed8748,0,aonishuk,2018-02-25 00:21:29+02:00,['2cbb34854ef4fdd7fdacfd105ce830008cdd8d66'],8,8,16,31501078,3,,,,31162
f95d62ae28d33349018f53db87ab71dedc5240b2,0,aonishuk,2018-02-25 00:21:29+02:00,['95a203b84657d2cdfd5aa51379ecd20348ed8748'],6,32,38,31501116,6,0,1,0.576923077,31162
5a982c29311336380cc27c8a752820f4ad55ffb4,0,aonishuk,2018-02-25 00:21:29+02:00,['f95d62ae28d33349018f53db87ab71dedc5240b2'],16,15,31,31501147,15,,,,31162
a1211c964c6477a1401fa0e6b67f9ef9a19772c9,0,Attila Magyar,2018-02-26 11:53:33+01:00,['5a982c29311336380cc27c8a752820f4ad55ffb4'],2,2,4,31501151,1,,,,31162
af9fa8a06c20cdd9d65e4681b5708680c386ee4e,0,hiveww,2018-02-27 11:58:50+02:00,['a1211c964c6477a1401fa0e6b67f9ef9a19772c9'],1,1,2,31501153,1,,0,,31162
c9e7b4a9448f610fb31d646094a93debe7eb27a4,1,hiveww,2018-02-27 12:44:42+02:00,['a1211c964c6477a1401fa0e6b67f9ef9a19772c9'],1,1,2,31501155,1,,,,31162
2e4ed3bb6c7098808ad8fa567a69d97439949d6a,1,hiveww,2018-02-27 13:05:31+02:00,['a1211c964c6477a1401fa0e6b67f9ef9a19772c9'],1,1,2,31501157,1,,,,31162
723210ca5e1af42eeea7c69f914db6b391c16f0f,0,Siddharth,2018-02-27 08:22:45-08:00,['a1211c964c6477a1401fa0e6b67f9ef9a19772c9'],1,71,72,31501229,14,0.548387097,0.838709677,0.935483871,31162
69c9fc16e665826240e49d46ad2210d2d9619513,0,aonishuk,2018-02-27 19:20:03+02:00,['723210ca5e1af42eeea7c69f914db6b391c16f0f'],1,1,2,31501231,1,,,,31162
a05762d212300684c0c4e6f0436b23bd32958ea8,0,Mugdha Varadkar,2018-02-28 12:08:28+05:18,['69c9fc16e665826240e49d46ad2210d2d9619513'],0,1,1,31501232,1,,,,31162
ef894f36b9b28e58547d1bf3417b645f455bf40d,0,GitHub,2018-02-28 12:38:15+05:18,"['69c9fc16e665826240e49d46ad2210d2d9619513', '91aa6dc130e99dbacc77627a186f6fe9233a847b']",0,3,3,31501235,1,,,,31162
ab97b5f6907ce4f8437d4ece455e7ee20d1096b1,1,aonishuk,2018-02-28 11:25:27+02:00,['ef894f36b9b28e58547d1bf3417b645f455bf40d'],2,2,4,31501239,2,,,,31162
21a174d61e34374217a29ebe36e6c5f9830342de,0,Lisnichenko Dmitro,2018-02-28 18:47:08+02:00,['ab97b5f6907ce4f8437d4ece455e7ee20d1096b1'],3,6,9,31501248,1,,,,31162
979bd2600d5e60a58bbfbe22f988553081169846,1,Lisnichenko Dmitro,2018-02-28 22:31:32+02:00,['ab97b5f6907ce4f8437d4ece455e7ee20d1096b1'],0,12,12,31501260,3,,,,31162
6eaf62f42eb0947c3394220620933459be632eaf,0,aonishuk,2018-02-28 23:29:31+02:00,['ab97b5f6907ce4f8437d4ece455e7ee20d1096b1'],1,1,2,31501262,1,,,,31162
ec25803b63b8a989af0020ab7f63cbddfa35da43,1,Oliver Szabo,2018-03-01 01:57:33+01:00,['6eaf62f42eb0947c3394220620933459be632eaf'],2,1,3,31501265,1,,,,31162
a91dba006fea2035197e8e48b548714842fafec3,1,Lisnichenko Dmitro,2018-03-01 14:36:27+02:00,['979bd2600d5e60a58bbfbe22f988553081169846'],0,17,17,31501282,3,,,,31162
4ffb34821b3d3e6510413a804a727fca7198278a,1,Myroslav Papirkovskyi,2018-03-01 16:09:24+02:00,['ec25803b63b8a989af0020ab7f63cbddfa35da43'],0,17,17,31501299,3,1,1,1,31162
db8a5561f3d9dd324c866343245a1769313ee8ef,0,Alex Antonenko,2018-03-01 17:49:04+03:00,['4ffb34821b3d3e6510413a804a727fca7198278a'],66,10,76,31501375,2,0.34,0.34,0,31162
e50b82c235e19b1267998a68eb26ff33fd4aaadd,1,GitHub,2018-03-01 20:52:40+02:00,['4ffb34821b3d3e6510413a804a727fca7198278a'],18,432,450,31501825,7,0.86013986,1,1,31163
b3955de6f298901e52843ead51951220b8f401d8,1,GitHub,2018-03-01 12:01:51-08:00,['e50b82c235e19b1267998a68eb26ff33fd4aaadd'],2,22,24,31501849,8,0,0.727272727,0.909090909,31163
2c58ee20d02e9695c52d8c5b347c5cccfb5cfcc0,0,GitHub,2018-03-01 21:27:03+01:00,['b3955de6f298901e52843ead51951220b8f401d8'],3,5,8,31501857,1,,,,31163
c635b09e8ce153b3d50f1c929575b2f0910ed7ca,1,aBabiichuk,2018-03-02 00:31:07+02:00,['2c58ee20d02e9695c52d8c5b347c5cccfb5cfcc0'],264,333,597,31502454,32,0.473684211,1,1,31163
910d3d667b25f3ac650288ff561f6b00174e76b6,0,Robert Levas,2018-03-01 17:32:31-05:00,['c635b09e8ce153b3d50f1c929575b2f0910ed7ca'],3,3,6,31502460,3,,,,31163
7345490d8992da2e8ae0ea7efcc654d4d6dac15d,0,GitHub,2018-03-01 16:06:09-08:00,['910d3d667b25f3ac650288ff561f6b00174e76b6'],4,47,51,31502511,6,0.6,0.6,0.6,31163
991a219fe55c1ac6081269a10fbd3598130321d4,0,GitHub,2018-03-02 08:33:57+01:00,['7345490d8992da2e8ae0ea7efcc654d4d6dac15d'],22,104,126,31502637,9,0.913043478,0.934782609,0.934782609,31163
5ef745f4cd94085053ed04a6a5f43967555a00a2,0,Andrii Tkach,2018-03-02 12:02:19+02:00,['991a219fe55c1ac6081269a10fbd3598130321d4'],1,2,3,31502640,1,1,1,1,31163
6b5853bef11d575400e6a05d5f517291c5776481,0,Andrii Tkach,2018-03-02 12:07:00+02:00,['5ef745f4cd94085053ed04a6a5f43967555a00a2'],2,8,10,31502650,3,0.333333333,0.333333333,1,31163
de5083c76cdc9e8938c58c1a75bb719e46091751,0,Andrii Tkach,2018-03-02 12:08:36+02:00,['6b5853bef11d575400e6a05d5f517291c5776481'],0,1,1,31502651,1,1,1,1,31163
2b0164ac8910e4b46c4f97d90b9e5370c150bb09,0,Andrii Tkach,2018-03-02 12:10:02+02:00,['de5083c76cdc9e8938c58c1a75bb719e46091751'],6,7,13,31502664,2,1,1,1,31163
ea556ed03589666761043397adddabb514062fd5,0,GitHub,2018-03-02 13:15:56+02:00,"['2b0164ac8910e4b46c4f97d90b9e5370c150bb09', '21a174d61e34374217a29ebe36e6c5f9830342de']",3,6,9,31502673,1,,,,31163
377308d4a772e2ca20aa7507ef40025d59546390,1,Andrii Tkach,2018-03-02 13:21:50+02:00,['ea556ed03589666761043397adddabb514062fd5'],0,9,9,31502682,1,1,1,1,31163
084aa6b1fe25bb78d8705216f33c380ae929e17f,1,GitHub,2018-03-02 14:18:13+01:00,['377308d4a772e2ca20aa7507ef40025d59546390'],0,134,134,31502816,2,,,,31164
b665ea877191b54a21ae2f025bc67faaa377f84c,0,Robert Levas,2018-03-02 14:19:11-05:00,['084aa6b1fe25bb78d8705216f33c380ae929e17f'],0,2,2,31502818,1,,,,31164
5964c7f4d1fefa06ce06e08cb21f10770bbead09,0,GitHub,2018-03-02 22:09:32+02:00,['b665ea877191b54a21ae2f025bc67faaa377f84c'],0,24,24,31502842,2,,,,31164
56be3a747dee7ce1bf2169e654e75ceaef4a5b7c,0,Eugene Chekanskiy,2018-03-03 02:04:41+02:00,['5964c7f4d1fefa06ce06e08cb21f10770bbead09'],8,8,16,31502858,1,1,1,1,31164
123e3308c02f0fd64bf0912b1b32b8f48438f034,1,GitHub,2018-03-05 12:59:03+05:18,['56be3a747dee7ce1bf2169e654e75ceaef4a5b7c'],8,98,106,31502964,4,0.95,1,0.95,31165
e0ba356293c05716694acfb4d704ace5cf0b6f35,1,Lisnichenko Dmitro,2018-03-05 15:18:34+02:00,['a91dba006fea2035197e8e48b548714842fafec3'],21,96,117,31503081,8,0,1,1,31166
4396e09843bb52d8ebf59b77a81dccc470a851e2,0,"Doroszlai, Attila",2018-03-05 14:20:23+01:00,['123e3308c02f0fd64bf0912b1b32b8f48438f034'],1,1,2,31503083,1,,,,31166
31c95060afd0e45c3c23ea6e6b65bdffec225042,1,Andrii Tkach,2018-03-05 17:12:57+02:00,['4396e09843bb52d8ebf59b77a81dccc470a851e2'],42,427,469,31503552,11,0.840840841,0.981981982,1,31167
ccde6cb4799468bb5177061339930697ea3ae4b3,1,Andrii Tkach,2018-03-05 17:16:03+02:00,['31c95060afd0e45c3c23ea6e6b65bdffec225042'],63,7,70,31503622,6,0.385964912,0,0,31167
e7b90f854a82052c645f933930203c9cd2a6473a,1,Robert Levas,2018-03-05 10:17:02-05:00,['ccde6cb4799468bb5177061339930697ea3ae4b3'],1,38,39,31503661,4,,,,31168
b28d4b9f559fe4f0126e360e5e0d3f4af7912fc5,0,Robert Levas,2018-03-05 10:17:02-05:00,['e7b90f854a82052c645f933930203c9cd2a6473a'],16,41,57,31503718,16,,,,31168
9ae20534cdf631e9794e27588b962b81ae31bc4b,1,Robert Levas,2018-03-05 10:17:02-05:00,['b28d4b9f559fe4f0126e360e5e0d3f4af7912fc5'],1,1,2,31503720,1,,,,31168
5e086e1025aff606a0d5063d5faa1ce0ffae2159,1,Robert Levas,2018-03-05 10:41:28-05:00,['9ae20534cdf631e9794e27588b962b81ae31bc4b'],13,144,157,31503877,4,,,,31168
f1259a67fa1124ad256a23fc0f500d917ae166fe,1,Lisnichenko Dmitro,2018-03-05 18:33:01+02:00,['e0ba356293c05716694acfb4d704ace5cf0b6f35'],3,4,7,31503884,1,0,1,1,31168
f2b006cce249eb0f62ff9928937605eaa2bb8e46,1,Siddharth,2018-03-05 11:24:04-08:00,['5e086e1025aff606a0d5063d5faa1ce0ffae2159'],11,29,40,31503924,7,0.7,1,1,31168
cc4a4d6e2806f53b6aca190cd6cf3c734a995cc5,0,GitHub,2018-03-05 12:16:21-08:00,['f2b006cce249eb0f62ff9928937605eaa2bb8e46'],2,10,12,31503936,4,1,1,1,31168
4b6d1efa8f60e75abfc8eb1ee33a6981973f442e,0,Attila Magyar,2018-03-06 08:45:49+01:00,['cc4a4d6e2806f53b6aca190cd6cf3c734a995cc5'],17,18,35,31503971,2,1,1,1,31168
cee8debe6c1f60ad47676a97267b2070c6d0818f,0,GitHub,2018-03-06 12:37:12+02:00,"['4b6d1efa8f60e75abfc8eb1ee33a6981973f442e', 'c9e7b4a9448f610fb31d646094a93debe7eb27a4']",1,1,2,31503973,1,,,,31168
d7e76cdf76d548beb6778cd62336f30f4e239d8b,0,GitHub,2018-03-06 12:38:52+02:00,"['cee8debe6c1f60ad47676a97267b2070c6d0818f', 'f1259a67fa1124ad256a23fc0f500d917ae166fe']",1,106,107,31504080,6,,,,31168
671b1cb83110a8e2ae4dcffd4aa504d6e6b1503f,0,GitHub,2018-03-06 12:41:00+02:00,"['d7e76cdf76d548beb6778cd62336f30f4e239d8b', 'db8a5561f3d9dd324c866343245a1769313ee8ef']",66,10,76,31504156,2,,,,31168
7455837fe35ea6ea39a8f5b19ebf5d67f3206e68,0,GitHub,2018-03-06 12:41:33+02:00,"['671b1cb83110a8e2ae4dcffd4aa504d6e6b1503f', 'af9fa8a06c20cdd9d65e4681b5708680c386ee4e']",1,1,2,31504158,1,,,,31168
c5bddcb26148b60328cd60dc4c467d132776e8e3,0,"Doroszlai, Attila",2018-03-06 11:43:02+01:00,['7455837fe35ea6ea39a8f5b19ebf5d67f3206e68'],1,6,7,31504165,1,,,,31168
220b892c8dffa9027687ab0db25714a2df9d6467,0,Andrii Tkach,2018-03-06 13:13:00+02:00,['c5bddcb26148b60328cd60dc4c467d132776e8e3'],1,6,7,31504172,1,,,,31168
ba1c673c23f41d1e7494e85a873f1105148c6d0b,0,GitHub,2018-03-06 15:13:48+02:00,"['220b892c8dffa9027687ab0db25714a2df9d6467', '2e4ed3bb6c7098808ad8fa567a69d97439949d6a']",1,1,2,31504174,1,,,,31168
5d467c86fc32cb9dc0b2df73bbac51ba506629a1,0,Jonathan Hurley,2018-03-06 08:51:16-05:00,['ba1c673c23f41d1e7494e85a873f1105148c6d0b'],0,1,1,31504175,1,,,,31168
8cd0a62612bcdc5f5b6ec239817f799f07c7ae09,0,Eugene Chekanskiy,2018-03-06 16:27:33+02:00,['5d467c86fc32cb9dc0b2df73bbac51ba506629a1'],1,2,3,31504178,1,,,,31168
4b5a010d6984d9f2b1acd9aa75ec0f10ddbcae12,0,GitHub,2018-03-06 09:29:39-05:00,['5d467c86fc32cb9dc0b2df73bbac51ba506629a1'],2,0,2,31504180,1,,,,31168
ac7dee0a3f4efa72203d04b4ce814e4d1112e9b7,0,aonishuk,2018-03-06 17:34:56+02:00,['8cd0a62612bcdc5f5b6ec239817f799f07c7ae09'],35,12,47,31504227,7,1,1,1,31168
7cea81a625611e1488ee2777e5e139161db0f76a,0,Robert Levas,2018-03-06 11:18:45-05:00,['ac7dee0a3f4efa72203d04b4ce814e4d1112e9b7'],21012,0,21012,31525239,199,0.326403326,0.174174174,0.24994225,31168
5d7756873b51c66d3333383208f1d55b8c25e464,0,GitHub,2018-03-06 13:35:45-05:00,"['7cea81a625611e1488ee2777e5e139161db0f76a', '4b5a010d6984d9f2b1acd9aa75ec0f10ddbcae12']",2,0,2,31525241,1,,,,31168
9f6612cb190196ed8d646781bb3d5e0c836fe9d2,0,"Doroszlai, Attila",2018-03-06 21:38:28+01:00,['5d7756873b51c66d3333383208f1d55b8c25e464'],1,1,2,31525243,1,,,,31168
7d388adad9bc4736a711c5e7fefeca525f78dcff,1,Myroslav Papirkovskyi,2018-03-07 16:02:53+02:00,['9f6612cb190196ed8d646781bb3d5e0c836fe9d2'],2,2,4,31525247,2,0,1,1,31168
cf3da47e07cd178fd4f606ee6d0c4522e21c142c,0,Andrii Tkach,2018-03-07 16:43:12+02:00,['7d388adad9bc4736a711c5e7fefeca525f78dcff'],1,2,3,31525250,1,1,1,1,31168
23c48c5c83549319bb33a99480fa7b70ff01270b,0,Alex Antonenko,2018-03-07 19:03:31+03:00,['2421d981baab8552b15319550d9fe46ca569e27d'],1,3,4,31525254,1,1,1,1,31168
ce7237cc4a2f1dd78b929c83a6db5ef62018bd84,0,Robert Levas,2018-03-07 11:20:03-05:00,['cf3da47e07cd178fd4f606ee6d0c4522e21c142c'],11,22,33,31525287,3,,,,31168
13c818e6336c00a8ea5295c6a7b67441eff2b7da,0,Lisnichenko Dmitro,2018-03-07 19:08:56+02:00,['ce7237cc4a2f1dd78b929c83a6db5ef62018bd84'],0,1,1,31525288,1,,,,31168
a57d6ccef6b8d45ba51a322808d51e43dd966642,0,GitHub,2018-03-07 11:29:28-08:00,['ce7237cc4a2f1dd78b929c83a6db5ef62018bd84'],4797,0,4797,31530085,5,,,,31168
e5e10cd81fcf48cbcee82456769145ad8c954e1e,0,GitHub,2018-03-07 12:55:54-08:00,['a57d6ccef6b8d45ba51a322808d51e43dd966642'],0,17,17,31530102,1,,,,31168
0bbb154fbc8ccd32c2846d93009dd1df0be348b1,1,Akhil Subhash Naik,2018-03-08 12:27:56+05:18,['34cb92e0ba0252f97ad3228e51f27cfb4fb6a50a'],0,557,557,31530659,10,0.92195122,1,1,31178
f230fa5c7d2c2a34b584828507c77990c6e15b17,0,Akhil Subhash Naik,2018-03-08 12:46:05+05:18,"['0bbb154fbc8ccd32c2846d93009dd1df0be348b1', '874abb60ca406aae55ad2ed0de3c36cd8f2b1b71']",0,0,0,31530659,0,,,,31178
a425ed4f5deb7b11b34a6f6e180684b54bed111f,1,Akhil Subhash Naik,2018-03-08 15:30:29+05:18,['f230fa5c7d2c2a34b584828507c77990c6e15b17'],19,15,34,31530693,4,0,0,0,31178
973d875a1c1489218d2b4901411c37db792d3f10,0,GitHub,2018-03-08 16:01:05+05:18,"['e5e10cd81fcf48cbcee82456769145ad8c954e1e', 'a425ed4f5deb7b11b34a6f6e180684b54bed111f']",99,264,363,31531056,22,,,,31178
31bdda57f59a4b1b6ea0502a7e980a04fa3993b5,0,"Doroszlai, Attila",2018-03-08 18:45:54+01:00,['973d875a1c1489218d2b4901411c37db792d3f10'],3,7,10,31531066,2,0,0.75,0.25,31178
a9a8a59bb817d1c74ff1b0fc40bc4b18bf69dcdb,1,GitHub,2018-03-08 10:04:04-08:00,['31bdda57f59a4b1b6ea0502a7e980a04fa3993b5'],1,7,8,31531074,2,,,,31178
4d7d91f23d11d7917de3f4313714bbbec19a6427,0,Andrii Tkach,2018-03-09 12:30:53+02:00,['a9a8a59bb817d1c74ff1b0fc40bc4b18bf69dcdb'],2,12,14,31531088,4,1,1,1,31178
fa474891e47777d85e432bc5144b1253f9bdb53f,0,Andrii Tkach,2018-03-09 12:40:13+02:00,['4d7d91f23d11d7917de3f4313714bbbec19a6427'],20,4,24,31531112,3,0,0,0,31178
60fc46a0afb3b4042e65f1b93ec9eb9d131aafff,1,aonishuk,2018-03-09 14:33:16+02:00,['fa474891e47777d85e432bc5144b1253f9bdb53f'],2,22,24,31531136,2,0,1,0.466666667,31178
626ff95751ea84d1a4e22f23c1dd14158cf87b8e,0,aonishuk,2018-03-09 14:33:16+02:00,['60fc46a0afb3b4042e65f1b93ec9eb9d131aafff'],2,2,4,31531140,1,,,,31178
27e7f200c686d788a892098d35ee8a4a5a264154,0,GitHub,2018-03-09 15:19:31+02:00,"['626ff95751ea84d1a4e22f23c1dd14158cf87b8e', '13c818e6336c00a8ea5295c6a7b67441eff2b7da']",0,1,1,31531141,1,,,,31178
048bfd54d025bb9651c4067e357f3ffe031970eb,0,GitHub,2018-03-09 20:24:53+01:00,['27e7f200c686d788a892098d35ee8a4a5a264154'],1,1,2,31531143,1,,,,31178
64ee6e5d453e884e8f509e4b6297925764d5cda7,0,GitHub,2018-03-10 02:01:48+01:00,['048bfd54d025bb9651c4067e357f3ffe031970eb'],2,34,36,31531179,5,,,,31178
e46d8edc39ea5949756b641ab8881d726c1861e1,0,"Doroszlai, Attila",2018-03-10 09:34:04+01:00,['64ee6e5d453e884e8f509e4b6297925764d5cda7'],1,10,11,31531190,1,1,1,1,31178
c3363500db5a4d28490d5429832c3bfe0b55cf79,0,"Doroszlai, Attila",2018-03-10 11:25:45+01:00,['e46d8edc39ea5949756b641ab8881d726c1861e1'],1,2,3,31531193,1,,,,31178
aaa7e5fa6990f7eabe5fab5e9bac8fbe9f96124c,0,Attila Magyar,2018-03-10 18:32:31+01:00,['c3363500db5a4d28490d5429832c3bfe0b55cf79'],0,5,5,31531198,1,,,,31178
249af2b0cc03d57b05ce3a259524b16e870363e3,1,GitHub,2018-03-10 16:35:14-05:00,['aaa7e5fa6990f7eabe5fab5e9bac8fbe9f96124c'],112,853,965,31532163,12,0.407008086,0.614555256,0.660377358,31178
8adcdd89c1c3757ea16ce03ef18f1b6b091262e6,1,GitHub,2018-03-11 23:23:57+01:00,['249af2b0cc03d57b05ce3a259524b16e870363e3'],1,268,269,31532432,6,0.718309859,0.718309859,1,31181
35fe83c4f720348dee3d00af53ce263686fd792e,1,Aleksandr Kovalenko,2018-03-12 00:39:45+02:00,['8adcdd89c1c3757ea16ce03ef18f1b6b091262e6'],40,241,281,31532713,9,0.989247312,1,1,31181
227da417a811abba6116802081d6cc05b8e521a5,0,Andrii Tkach,2018-03-12 13:43:32+02:00,['35fe83c4f720348dee3d00af53ce263686fd792e'],18,24,42,31532755,2,,,,31181
8c052818edb63c44cb00e1a2661031af204381a0,1,Andrii Tkach,2018-03-12 14:25:21+02:00,['227da417a811abba6116802081d6cc05b8e521a5'],8,12,20,31532775,2,,,,31181
23743c99fd7caee522c6ec740749d11b11472380,1,Myroslav Papirkovskyi,2018-03-12 16:39:40+02:00,['8c052818edb63c44cb00e1a2661031af204381a0'],1,41,42,31532817,4,0,0,1,31182
f554d975c56416f5f54052e98a14aa39d4b80c73,0,aonishuk,2018-03-12 20:02:10+02:00,['23743c99fd7caee522c6ec740749d11b11472380'],0,1,1,31532818,1,1,1,0,31182
55ae952958c9cd7bc526f2e0d5fa859a667dc8f2,1,Robert Levas,2018-03-12 14:42:26-04:00,['f554d975c56416f5f54052e98a14aa39d4b80c73'],10,72,82,31532900,3,0.108695652,0.565217391,0.586956522,31182
cb013822f6f93548bab0734a7660a361e5a4f725,0,Attila Magyar,2018-03-12 21:15:01+01:00,['55ae952958c9cd7bc526f2e0d5fa859a667dc8f2'],135,461,596,31533496,21,0.438356164,0.616438356,0.808219178,31185
0c142208035d3d5f7837a5d3f16cd2c52fc7708f,0,Attila Magyar,2018-03-12 21:15:01+01:00,['cb013822f6f93548bab0734a7660a361e5a4f725'],3,3,6,31533502,3,,,,31185
a6dd77afacbbc348aaa0f6c3b2c666f40269f3fe,0,Attila Magyar,2018-03-12 21:15:01+01:00,['0c142208035d3d5f7837a5d3f16cd2c52fc7708f'],30,30,60,31533562,10,,,,31185
b614378a9c6edc23ab628f2acf8af5ef11ba68d5,0,Attila Magyar,2018-03-12 21:15:01+01:00,['a6dd77afacbbc348aaa0f6c3b2c666f40269f3fe'],7,14,21,31533583,10,,,,31185
a6fecc5f2cb53608fc92d496870c16bc45484493,1,GitHub,2018-03-13 05:48:39+01:00,['b614378a9c6edc23ab628f2acf8af5ef11ba68d5'],8,178,186,31533769,3,0,0.496124031,0.527131783,31185
577bf7d08257300d96d6bc05178d6af065fa3afb,1,GitHub,2018-03-13 10:09:06+05:18,['a6fecc5f2cb53608fc92d496870c16bc45484493'],22,43,65,31533834,1,1,0,1,31185
8bdef4281a818597cf75f9f8360748fef892b4b4,0,Attila Magyar,2018-03-13 08:40:35+01:00,['577bf7d08257300d96d6bc05178d6af065fa3afb'],3,2,5,31533839,2,,,,31185
eb2361376144e445e6fe461773b474f0bc30f8c0,1,Aleksandr Kovalenko,2018-03-13 12:07:34+02:00,['8bdef4281a818597cf75f9f8360748fef892b4b4'],3,16,19,31533858,5,1,1,1,31185
965fca05028a1f4e88480710b48354ab5ebfcd61,0,GitHub,2018-03-13 13:55:12+02:00,"['eb2361376144e445e6fe461773b474f0bc30f8c0', '23c48c5c83549319bb33a99480fa7b70ff01270b']",1,3,4,31533862,1,,,,31185
ccc5a662accae926f57581cb9842e310dd560d5a,1,Alex Antonenko,2018-03-13 15:48:04+03:00,['7ee8c6177a412875c0712df991a19aec1c73515d'],22,28,50,31533912,3,1,1,1,31185
7b3d7a96cf838777475b870978d84197cefdc770,0,Alex Antonenko,2018-03-13 15:52:53+03:00,['ccc5a662accae926f57581cb9842e310dd560d5a'],1,1,2,31533914,1,,,,31185
8eb901f8540fdfdf4dcd65b0039c3fae4afe75cc,0,GitHub,2018-03-13 15:20:19+01:00,['965fca05028a1f4e88480710b48354ab5ebfcd61'],23,1,24,31533938,2,0,0,0,31185
508a609c064da59f037489f7e35980f3e315a293,0,Andrii Tkach,2018-03-13 16:20:35+02:00,['8eb901f8540fdfdf4dcd65b0039c3fae4afe75cc'],0,11,11,31533949,2,,,,31185
cdab82b29c184763b7c41ba881cdfc3230016a9a,0,GitHub,2018-03-13 18:16:34+02:00,"['508a609c064da59f037489f7e35980f3e315a293', '7b3d7a96cf838777475b870978d84197cefdc770']",22,28,50,31533999,3,,,,31185
a55fbba2fc984ffbfec65c016ad2e6d215435fa9,1,aonishuk,2018-03-13 21:00:18+02:00,['cdab82b29c184763b7c41ba881cdfc3230016a9a'],3,84,87,31534086,6,0.861111111,1,1,31185
8e6172a5281b739542e8bd94065c278ef2d6e9a2,0,Oliver Szabo,2018-03-13 20:27:52+01:00,['a55fbba2fc984ffbfec65c016ad2e6d215435fa9'],1,1,2,31534088,1,,,,31185
04b2b60cc34fb2214a254e932176feaeea47b102,0,Oliver Szabo,2018-03-13 20:29:33+01:00,['8e6172a5281b739542e8bd94065c278ef2d6e9a2'],3,0,3,31534091,1,0,0,0,31185
7a267d21eb1dd636be0e4563bba3046ca0d89dd3,0,GitHub,2018-03-14 01:28:03+02:00,['04b2b60cc34fb2214a254e932176feaeea47b102'],0,11,11,31534102,1,1,0,0,31185
54ba89133f61b8ad013d96f4f8d881844229abd9,1,aonishuk,2018-03-14 07:41:02+02:00,['7a267d21eb1dd636be0e4563bba3046ca0d89dd3'],118,40,158,31534260,4,0.206896552,0,0.327586207,31185
2cb384f3946870bcd982329ca2f67db0600a3ff5,1,GitHub,2018-03-14 10:02:13+01:00,['54ba89133f61b8ad013d96f4f8d881844229abd9'],0,236,236,31534496,2,0.714285714,1,0.428571429,31186
3057f1ba121925fc0c5de8b908caa0849d7d68be,0,GitHub,2018-03-14 10:02:47+01:00,['2cb384f3946870bcd982329ca2f67db0600a3ff5'],0,3,3,31534499,1,,,,31186
0db7c19b1246f2ae90b855b4649105ec1d1b62ff,1,Oliver Szabo,2018-03-14 11:12:36+01:00,['3057f1ba121925fc0c5de8b908caa0849d7d68be'],2,2,4,31534503,1,,,,31186
820e327c818dafc8194e378b58823cd35bf68262,0,Andrii Tkach,2018-03-14 13:00:24+02:00,['0db7c19b1246f2ae90b855b4649105ec1d1b62ff'],5,4,9,31534512,2,,,,31186
9f97125e612267ecd1e8b5e4aa2f454a5674d653,0,Andrii Tkach,2018-03-14 13:06:03+02:00,['820e327c818dafc8194e378b58823cd35bf68262'],4,10,14,31534526,2,1,0.166666667,0.666666667,31186
70e7ed6654aa1722d1771778df44637d5f2adca5,0,Andrii Tkach,2018-03-14 13:12:01+02:00,['9f97125e612267ecd1e8b5e4aa2f454a5674d653'],6,6,12,31534538,1,,,,31186
1d9c16ea595ce89f0800f2ca6bcf1937742b76d3,1,Andrii Tkach,2018-03-14 13:13:57+02:00,['70e7ed6654aa1722d1771778df44637d5f2adca5'],1,1,2,31534540,1,,,,31186
ec5d2f8f1d0f26fbdb23ca6e36cc8da9ca5737e9,1,Andrii Tkach,2018-03-14 13:13:57+02:00,['1d9c16ea595ce89f0800f2ca6bcf1937742b76d3'],2,2,4,31534544,2,,,,31186
afb6491e97772e54a4bab6eb9a73b9f3f75dda4b,1,Andrii Tkach,2018-03-14 13:13:57+02:00,['ec5d2f8f1d0f26fbdb23ca6e36cc8da9ca5737e9'],7,7,14,31534558,3,,,,31186
091abfdea3b16a6b6c9841cea8376573975072fc,1,Oliver Szabo,2018-03-14 13:55:44+01:00,['afb6491e97772e54a4bab6eb9a73b9f3f75dda4b'],0,15,15,31534573,1,0,0,1,31186
ec62c4d5ff271000303d1268e38f51a43e335670,1,Siddharth,2018-03-14 07:02:21-07:00,['091abfdea3b16a6b6c9841cea8376573975072fc'],1,1,2,31534575,1,,,,31186
e189c487e17d795e3f1265eab86ec5765b16e9a6,0,Eugene Chekanskiy,2018-03-14 16:35:22+02:00,['ec62c4d5ff271000303d1268e38f51a43e335670'],1,1,2,31534577,1,,,,31186
988ec0a50345dddccb713c6adeeb4e20cadbceaf,0,GitHub,2018-03-14 15:36:45+01:00,['e189c487e17d795e3f1265eab86ec5765b16e9a6'],1,8,9,31534586,1,0,0,1,31186
5d721d946c1983d9b04b768c02995b9be94f1b23,1,Lisnichenko Dmitro,2018-03-14 18:11:44+02:00,['988ec0a50345dddccb713c6adeeb4e20cadbceaf'],2,6,8,31534594,1,0,1,1,31186
522607f6d11ca0ae303fd29344d09ea356fe71df,0,GitHub,2018-03-14 21:12:12+01:00,['988ec0a50345dddccb713c6adeeb4e20cadbceaf'],4,4,8,31534602,1,,,,31186
f55e7277fb2f78e02f6df8a68c063206862ef3a6,1,Myroslav Papirkovskyi,2018-03-15 12:37:48+02:00,['522607f6d11ca0ae303fd29344d09ea356fe71df'],10,53,63,31534665,10,0.9,1,0.9,31186
2c0b96f9b246669e7e6a6d4703ea1f1b919afd66,0,Lisnichenko Dmitro,2018-03-15 13:41:21+02:00,['5d721d946c1983d9b04b768c02995b9be94f1b23'],9,17,26,31534691,1,0,0,1,31186
0f4a99022d12eee85db064f7f902c315b06abbeb,0,Venkata Sairam,2018-03-15 20:12:04+05:18,['f55e7277fb2f78e02f6df8a68c063206862ef3a6'],2,33,35,31534726,4,0.4,1,1,31186
799711ce0c77bbb61ba8a04273ce1ac8e2de5b2f,0,GitHub,2018-03-15 23:41:21+02:00,['f55e7277fb2f78e02f6df8a68c063206862ef3a6'],10,9,19,31534745,2,1,0,0,31186
1c9bc55b6c70ac24ce4e251ea3c6cfc9f1b3b0f0,1,GitHub,2018-03-16 00:51:36+02:00,['799711ce0c77bbb61ba8a04273ce1ac8e2de5b2f'],21,87,108,31534853,9,0.650793651,0.650793651,1,31186
8de19afc997beb1de4bbb004451a5e7a77ef9ecc,1,aBabiichuk,2018-03-16 01:21:44+02:00,['1c9bc55b6c70ac24ce4e251ea3c6cfc9f1b3b0f0'],2452,5729,8181,31543034,146,0.677862595,0.977099237,0.775572519,31242
cd914c5e320c0af79d8c7765936e45d859ca608a,0,GitHub,2018-03-16 08:43:15+02:00,"['8de19afc997beb1de4bbb004451a5e7a77ef9ecc', '2c0b96f9b246669e7e6a6d4703ea1f1b919afd66']",7,19,26,31543060,1,,,,31242
668e397993bfe08314b731dcd5affcca5d398d7f,0,aonishuk,2018-03-16 15:11:12+02:00,['cd914c5e320c0af79d8c7765936e45d859ca608a'],35,158,193,31543253,21,1,0.367647059,0.338235294,31242
82f192516fad8cc72dda2c5d2d92363ded8003ea,1,aonishuk,2018-03-16 15:14:14+02:00,['668e397993bfe08314b731dcd5affcca5d398d7f'],158,35,193,31543446,21,0,0.632352941,0.661764706,31242
844024779ccc2c4f31d4bf76bbc7fc113a212490,0,Eugene Chekanskiy,2018-03-16 20:57:17+02:00,['82f192516fad8cc72dda2c5d2d92363ded8003ea'],7,26,33,31543479,2,0,1,0.833333333,31242
0907d6119f4e1a0f0ae1add6302cd2ad8fe4d149,1,aonishuk,2018-03-16 21:32:16+02:00,['844024779ccc2c4f31d4bf76bbc7fc113a212490'],35,157,192,31543671,20,1,0.367647059,0.338235294,31242
1f8c8737ce2528a49632a9fa76ad82324d830a68,1,aBabiichuk,2018-03-17 11:22:46+02:00,['0907d6119f4e1a0f0ae1add6302cd2ad8fe4d149'],620,873,1493,31545164,43,1,0.6,0,31245
c897c680d0e137c19931def70d3051dcaafe8749,1,GitHub,2018-03-17 10:38:28-04:00,['1f8c8737ce2528a49632a9fa76ad82324d830a68'],364,708,1072,31546236,5,0.274390244,0.932926829,0.981707317,31246
10a1e8b692ecd3de8b79bda1abc6fd6b0a8547ce,0,Robert Levas,2018-03-17 10:41:02-04:00,['c897c680d0e137c19931def70d3051dcaafe8749'],2,3,5,31546241,1,,,,31246
408a436944c37ff480526f00185653b8c6328c53,0,Robert Levas,2018-03-17 11:28:37-04:00,['10a1e8b692ecd3de8b79bda1abc6fd6b0a8547ce'],1,1,2,31546243,1,,,,31246
6f223af4b1cfe73b57041453e998a70619c394d0,0,Robert Levas,2018-03-17 15:11:58-04:00,['408a436944c37ff480526f00185653b8c6328c53'],1,3,4,31546247,1,0,0,0,31246
6ff45aff59a1977afa330ca0f43339c2a517c403,0,GitHub,2018-03-19 12:11:36+05:18,"['6f223af4b1cfe73b57041453e998a70619c394d0', '0f4a99022d12eee85db064f7f902c315b06abbeb']",2,33,35,31546282,4,,,,31246
e44d5ac104f183372f43701716aaa7f5623fe28e,0,GitHub,2018-03-19 10:14:10+01:00,['6ff45aff59a1977afa330ca0f43339c2a517c403'],365,13,378,31546660,9,,,,31246
6a10b043bc37cb3790854af967066c1a26e93065,1,aonishuk,2018-03-19 11:59:58+02:00,['e44d5ac104f183372f43701716aaa7f5623fe28e'],12,41,53,31546713,4,1,0,0.125,31246
844b8ca4fa2e4cabf8d61c1aa9000fecebdfdef1,1,Andrii Tkach,2018-03-19 13:01:56+02:00,['6a10b043bc37cb3790854af967066c1a26e93065'],10,28,38,31546751,2,1,1,1,31246
e1b9530070c7fd1e40e9f933fb3b7e57818441e2,0,Attila Magyar,2018-03-19 14:05:19+01:00,['844b8ca4fa2e4cabf8d61c1aa9000fecebdfdef1'],63,382,445,31547196,3,0.589473684,1,0.284210526,31247
f5569daec76e3e089f88ef659bc2804cc398d32f,1,Robert Levas,2018-03-19 10:57:44-04:00,['e1b9530070c7fd1e40e9f933fb3b7e57818441e2'],439,468,907,31548103,33,0.571428571,0.785714286,0.928571429,31248
611c60d3adf4fa6affd76b1368650ebf009b6ae0,0,Andrii Tkach,2018-03-19 17:22:01+02:00,['f5569daec76e3e089f88ef659bc2804cc398d32f'],5,19,24,31548127,3,,,,31248
702b5b6b10c70516d1f51da0c4cdb44f68991a45,0,Myroslav Papirkovskyi,2018-03-19 18:41:06+02:00,['611c60d3adf4fa6affd76b1368650ebf009b6ae0'],0,13,13,31548140,2,0,0.333333333,1,31248
471602e2be29cc55ddbba19cc600dd7c18a7eb30,1,Myroslav Papirkovskyi,2018-03-19 23:31:04+02:00,['702b5b6b10c70516d1f51da0c4cdb44f68991a45'],2,20,22,31548162,5,0,1,1,31248
576449879d7f39c267eb80edf4a3644d4bbfcc1e,1,Myroslav Papirkovskyi,2018-03-20 00:21:25+02:00,['471602e2be29cc55ddbba19cc600dd7c18a7eb30'],108,287,395,31548557,18,0.651785714,0.580357143,0.723214286,31249
6f7682697fa9e9f43d04840ca45e5dcdee10ebed,0,Alex Antonenko,2018-03-20 15:23:05+03:00,['522607f6d11ca0ae303fd29344d09ea356fe71df'],1,1,2,31548559,1,,,,31249
ee0784a9b3393eb0c76f0ce0bd7ed4ea775864df,0,"Doroszlai, Attila",2018-03-20 13:43:55+01:00,['576449879d7f39c267eb80edf4a3644d4bbfcc1e'],28,258,286,31548845,5,,,,31250
8e63fd451a9bce18c245051fb8b0c500c190929e,1,Alex Antonenko,2018-03-20 16:45:35+03:00,['522607f6d11ca0ae303fd29344d09ea356fe71df'],1,1,2,31548847,1,,,,31250
d7b93999d7891f830193e2f85230af4f8645d14e,1,aonishuk,2018-03-20 16:47:23+02:00,['ee0784a9b3393eb0c76f0ce0bd7ed4ea775864df'],5,11,16,31548863,2,0,0,1,31250
b3f77793cd5b45fc4f01c937ca19bf4387018de7,0,GitHub,2018-03-20 18:03:35+02:00,['d7b93999d7891f830193e2f85230af4f8645d14e'],0,19,19,31548882,1,0,0,0,31250
b71c9ae963a6aeb54cfd8ea672f9e9894d1a7a09,0,Jonathan Hurley,2018-03-20 14:32:17-04:00,['b3f77793cd5b45fc4f01c937ca19bf4387018de7'],63,63,126,31549008,10,,,,31250
ef2b0ae16fb3975888962d0e2615678d7bdc7fd5,1,aonishuk,2018-03-20 21:32:21+02:00,['b71c9ae963a6aeb54cfd8ea672f9e9894d1a7a09'],11,24,35,31549043,2,0.181818182,1,0,31250
d1c547dba32475ff2bdecd68ed434edc93cc3d0a,1,Olivér Szabó,2018-03-21 07:39:10+01:00,['ef2b0ae16fb3975888962d0e2615678d7bdc7fd5'],126,2065,2191,31551234,16,0.836734694,1,0.897959184,31251
62d14a016156719c1c873809adc2ca2601a0d10c,0,Attila Magyar,2018-03-21 12:18:08+01:00,['d1c547dba32475ff2bdecd68ed434edc93cc3d0a'],128,30,158,31551392,2,1,0.043478261,0,31251
b149d123531909db322c5cc12dd545199585211d,1,GitHub,2018-03-21 15:17:08+01:00,['62d14a016156719c1c873809adc2ca2601a0d10c'],29,104,133,31551525,6,0.125,1,0.916666667,31251
77f358a76ee3b2fdfcc5a24ec5fde3a9d49b35a9,1,GitHub,2018-03-21 15:26:16+01:00,['b149d123531909db322c5cc12dd545199585211d'],1,1,2,31551527,1,,,,31251
e751205fb089deffd7fb0253752f140891213f43,0,Miklos Gergely,2018-03-21 17:42:47+01:00,['77f358a76ee3b2fdfcc5a24ec5fde3a9d49b35a9'],0,28,28,31551555,1,,,,31251
2caa282fdd0ed47167a459b86d1358ef0d26c39f,0,Myroslav Papirkovskyi,2018-03-21 21:38:43+02:00,['e751205fb089deffd7fb0253752f140891213f43'],7,45,52,31551607,5,0.642857143,0.642857143,1,31251
34cea575a07424b7d709323c85f74dca33853dc6,1,GitHub,2018-03-22 08:06:52+01:00,['2caa282fdd0ed47167a459b86d1358ef0d26c39f'],5,6,11,31551618,1,,,,31251
1b1cc6d1ccfcfb89594206ca7283db05b852bf89,0,"Doroszlai, Attila",2018-03-22 08:59:13+01:00,['34cea575a07424b7d709323c85f74dca33853dc6'],4,4,8,31551626,3,,,,31251
1ffa7d76bf0b26e9dce092d5889d3665b1d45e66,0,GitHub,2018-03-22 12:09:34+02:00,"['1b1cc6d1ccfcfb89594206ca7283db05b852bf89', '6f7682697fa9e9f43d04840ca45e5dcdee10ebed']",1,1,2,31551628,1,,,,31251
0a726e4cb3a6ed7e6399178da30c47f49fd784a3,0,GitHub,2018-03-22 12:11:53+02:00,"['1ffa7d76bf0b26e9dce092d5889d3665b1d45e66', '8e63fd451a9bce18c245051fb8b0c500c190929e']",1,1,2,31551630,1,,,,31251
22adaedc021218c2af91ee9b40aec7eb4483b140,1,aBabiichuk,2018-03-22 12:22:43+02:00,['0a726e4cb3a6ed7e6399178da30c47f49fd784a3'],4,6,10,31551640,5,1,1,1,31251
316322666ae32a5f9a20ab205817931d906ed71b,0,Alex Antonenko,2018-03-22 13:43:19+03:00,['22adaedc021218c2af91ee9b40aec7eb4483b140'],2,12,14,31551654,2,0,1,1,31251
21f72d447e2b2aa01e0aeecb594493d8cdc6cded,1,GitHub,2018-03-22 12:14:44+01:00,['22adaedc021218c2af91ee9b40aec7eb4483b140'],51,48,99,31551753,2,0,1,1,31251
466b7aa5b3e7284f752fe2e9b546b3feceef2902,0,Olivér Szabó,2018-03-22 13:05:30+01:00,['21f72d447e2b2aa01e0aeecb594493d8cdc6cded'],9,9,18,31551771,3,,,,31251
64ae9e854b38c43d4442e5bef827c5fca814e334,0,aonishuk,2018-03-22 14:53:40+02:00,['466b7aa5b3e7284f752fe2e9b546b3feceef2902'],23,0,23,31551794,1,0,0,1,31251
e7c4ed761072256dabd881242a0eea40d94cf8af,1,Dmytro Grinenko,2018-03-22 15:58:47+02:00,['64ae9e854b38c43d4442e5bef827c5fca814e334'],1958,2679,4637,31556431,27,0.509677419,0.070967742,0,31261
c838077d22f994ec7be5dd84dcbe0a2d1d8078d7,1,Olivér Szabó,2018-03-22 15:22:50+01:00,['e7c4ed761072256dabd881242a0eea40d94cf8af'],151,151,302,31556733,2,,,,31261
71915a45bde4b4f91654f692dc855c7885fac740,0,Jonathan Hurley,2018-03-22 15:30:07-04:00,['c838077d22f994ec7be5dd84dcbe0a2d1d8078d7'],2,2,4,31556737,2,,,,31261
5a75b79709e92a08ea0f64e35d33b499a3a236e9,1,aonishuk,2018-03-23 00:29:15+02:00,['71915a45bde4b4f91654f692dc855c7885fac740'],46,1231,1277,31558014,17,0.475633528,0.547758285,0.674463938,31268
75670a8b895319d7f0d4b7db95f870778af6d3c6,0,"Doroszlai, Attila",2018-03-23 07:40:21+01:00,['5a75b79709e92a08ea0f64e35d33b499a3a236e9'],1,1,2,31558016,1,,,,31268
8b7422c10f1478b57519642296ffa3aa60a3258b,1,Attila Magyar,2018-03-23 09:20:04+01:00,['75670a8b895319d7f0d4b7db95f870778af6d3c6'],1,42,43,31558059,4,1,1,0.285714286,31268
79f0cc36923fa214cf6017d3b0d261f6d4ee2b2d,0,aonishuk,2018-03-23 12:09:27+02:00,['8b7422c10f1478b57519642296ffa3aa60a3258b'],350,0,350,31558409,2,0.401197605,0.401197605,0.011976048,31268
ae674b3a74a80e7d9b8ba33672b3bdc8758307c2,0,Di Li,2018-03-23 10:37:38-07:00,['79f0cc36923fa214cf6017d3b0d261f6d4ee2b2d'],12,21,33,31558442,2,0.666666667,0.666666667,0,31268
4109c0e3b9c7a91a51fc3692dec68b76250a59bb,1,GitHub,2018-03-24 06:32:39-04:00,['79f0cc36923fa214cf6017d3b0d261f6d4ee2b2d'],71,1053,1124,31559566,27,0.292433538,0.844580777,0.799591002,31271
786253f22e9e5762e86a4c0ccea3e4f90ce58546,0,Attila Magyar,2018-03-24 11:39:53+01:00,['4109c0e3b9c7a91a51fc3692dec68b76250a59bb'],0,37,37,31559603,2,0.973684211,0.973684211,0.763157895,31271
a8c2d0de1b17ae5804e1819e1b7c94e560930a00,1,Attila Magyar,2018-03-24 18:10:11+01:00,['786253f22e9e5762e86a4c0ccea3e4f90ce58546'],7,211,218,31559821,8,0.65060241,1,0.915662651,31272
eee18a53a3e79179505d27b04b10a1ef7e3c5fab,1,GitHub,2018-03-24 18:11:07+01:00,['a8c2d0de1b17ae5804e1819e1b7c94e560930a00'],139,94,233,31560054,11,1,0.820512821,0,31272
414db932f0f0b9413df1e65577cafcaf9aa692ec,0,"Doroszlai, Attila",2018-03-25 17:16:57+02:00,['eee18a53a3e79179505d27b04b10a1ef7e3c5fab'],1,1,2,31560056,1,,,,31272
ef1b77663f706640b4ee58f2167ad46750adf8b5,0,"Doroszlai, Attila",2018-03-25 20:56:07+02:00,['414db932f0f0b9413df1e65577cafcaf9aa692ec'],9,10,19,31560075,1,,,,31272
9455ae097236c306c28c46f3c426c2893051962f,0,"Doroszlai, Attila",2018-03-26 09:58:32+02:00,['ef1b77663f706640b4ee58f2167ad46750adf8b5'],8,2,10,31560085,1,0,0,0,31272
48edfbf5bc2ef620ae465c8b863067886ea92d8d,0,"Doroszlai, Attila",2018-03-26 09:58:32+02:00,['9455ae097236c306c28c46f3c426c2893051962f'],1,1,2,31560087,1,,,,31272
db5cff35eb94ee7295405b4e8b3d0d87c6ad37e3,0,"Doroszlai, Attila",2018-03-26 09:58:32+02:00,['48edfbf5bc2ef620ae465c8b863067886ea92d8d'],0,1,1,31560088,1,,,,31272
4d86ea1a3c1895b808417e0e24ca61be871c26cd,0,Dmitry Sen,2018-03-26 14:18:31+03:00,['db5cff35eb94ee7295405b4e8b3d0d87c6ad37e3'],10,0,10,31560098,2,1,1,0.428571429,31272
68fdbef30bfbc39b6e07f4302effc66aa08e1b12,0,Di Li,2018-03-26 08:30:35-07:00,['ae674b3a74a80e7d9b8ba33672b3bdc8758307c2'],1,1,2,31560100,1,,,,31272
9aa2c6bd36b64be3168aed5824441d61f628eb54,0,avijayanhwx,2018-03-26 09:23:56-07:00,['4d86ea1a3c1895b808417e0e24ca61be871c26cd'],2,2,4,31560104,1,,,,31272
0ed348523be783fe52bd4e2ee54dbb297619a6f1,0,aonishuk,2018-03-26 23:51:39+03:00,['9aa2c6bd36b64be3168aed5824441d61f628eb54'],1,1,2,31560106,1,,,,31272
93b09490e1f0a300ee2ed2d73f7859e390f2438b,1,GitHub,2018-03-27 02:53:00-07:00,['0ed348523be783fe52bd4e2ee54dbb297619a6f1'],2,12,14,31560120,2,,,,31272
504434e672f803e4fdeb9548abbac221ab6bde5f,1,GitHub,2018-03-27 04:02:21-07:00,['93b09490e1f0a300ee2ed2d73f7859e390f2438b'],11,31,42,31560162,6,0.75,1,1,31272
dd5b34d524387a359d654de6f8efe31d3f22bea6,0,Alex Antonenko,2018-03-27 14:05:45+03:00,['93b09490e1f0a300ee2ed2d73f7859e390f2438b'],1,1,2,31560164,1,,0,,31272
2efd134576df4865a8badd1aeb9b99aaeb4e33d3,0,GitHub,2018-03-27 14:44:58+02:00,['504434e672f803e4fdeb9548abbac221ab6bde5f'],63,114,177,31560341,5,0.208333333,1,0.958333333,31272
1f8fdf1599f72a99eaf20743ae47c5bb0a899e11,0,Andrii Tkach,2018-03-27 16:14:33+03:00,['2efd134576df4865a8badd1aeb9b99aaeb4e33d3'],0,38,38,31560379,2,1,1,0.620689655,31272
b40a1af2d3ed7df250613eda09a33ff5162002d5,0,Andrii Tkach,2018-03-27 16:24:15+03:00,['1f8fdf1599f72a99eaf20743ae47c5bb0a899e11'],3,53,56,31560435,3,0,1,1,31272
bd4c7e98e4e7593ae7ffbfd6b03f4a72a3a445cd,0,Andrii Tkach,2018-03-27 16:34:36+03:00,['b40a1af2d3ed7df250613eda09a33ff5162002d5'],58,26,84,31560519,1,,,,31272
c2510323bcc2e09c56831c224cd1075d7f7de728,1,Andrii Tkach,2018-03-27 16:40:22+03:00,['bd4c7e98e4e7593ae7ffbfd6b03f4a72a3a445cd'],12,18,30,31560549,4,1,1,1,31272
83620136ae4462979343b153a0f4d4e52c317e9c,0,Robert Levas,2018-03-27 11:17:35-04:00,['c2510323bcc2e09c56831c224cd1075d7f7de728'],2,2,4,31560553,1,,,,31272
2712c2c274e069da02defc0e9b55fc12caece397,0,aBabiichuk,2018-03-27 19:13:37+03:00,['83620136ae4462979343b153a0f4d4e52c317e9c'],2,6,8,31560561,1,0,1,1,31272
731852b899a68b202bb87469c32ffab721471895,1,aBabiichuk,2018-03-27 19:15:03+03:00,['2712c2c274e069da02defc0e9b55fc12caece397'],16,36,52,31560613,4,0.105263158,1,1,31272
fbc785ab3556aa554357787411c61e567147c2af,1,Aleksandr Kovalenko,2018-03-27 19:16:15+03:00,['731852b899a68b202bb87469c32ffab721471895'],26,298,324,31560937,10,0.928888889,1,1,31272
77a758723d9e6902da34120e77b054c169b2b403,1,GitHub,2018-03-27 19:16:46+03:00,['fbc785ab3556aa554357787411c61e567147c2af'],447,623,1070,31562007,25,0.041666667,1,1,31272
147b36a16370df8ef3a73656df6ef06470c2b591,0,"Doroszlai, Attila",2018-03-27 22:23:44+02:00,['77a758723d9e6902da34120e77b054c169b2b403'],2,5,7,31562014,1,0,0,1,31272
f4445807a805fd4f98ad48c2b1c9f1599e73fa6a,0,"Doroszlai, Attila",2018-03-27 22:25:30+02:00,['147b36a16370df8ef3a73656df6ef06470c2b591'],63,25,88,31562102,48,,,,31272
20deb54b0dbb759144f804213ef722024b7a0968,0,Robert Levas,2018-03-27 16:34:00-04:00,['f4445807a805fd4f98ad48c2b1c9f1599e73fa6a'],2,8,10,31562112,2,0,0,0,31272
be7b4d15549b7cfb5d10a76187045f455fbe893d,0,Robert Levas,2018-03-27 23:15:15-04:00,['20deb54b0dbb759144f804213ef722024b7a0968'],2,7,9,31562121,1,1,0,0,31272
a8c5ce20444d4cfc88419b84b328ef2f298e3aed,1,Attila Magyar,2018-03-28 09:47:25+02:00,['be7b4d15549b7cfb5d10a76187045f455fbe893d'],66,482,548,31562669,7,0.28802589,0.537216828,0.129449838,31272
14c2a126a474275ddb84b5cbeda2dcfbea3b2fd6,1,aBabiichuk,2018-03-28 12:20:20+03:00,['a8c5ce20444d4cfc88419b84b328ef2f298e3aed'],650,1837,2487,31565156,59,0.566552901,1,0.498293515,31281
193dc1d8af65b8dff152a70f20b6033ea55ff8ed,1,aonishuk,2018-03-28 13:10:37+03:00,['14c2a126a474275ddb84b5cbeda2dcfbea3b2fd6'],6,71,77,31565233,3,0.916666667,1,0.5,31282
c1faa6f681e19f1f5dbd62427d369620525d7b9f,1,aonishuk,2018-03-28 13:10:37+03:00,['193dc1d8af65b8dff152a70f20b6033ea55ff8ed'],18,80,98,31565331,6,0.6875,0.6875,1,31283
e5c11fa0d65ef570bf8d619bab7209efb34b2430,0,aonishuk,2018-03-28 13:10:37+03:00,['c1faa6f681e19f1f5dbd62427d369620525d7b9f'],9,8,17,31565348,4,,,,31283
ffeda8c3ce9912a740f4bf11cfeebae77d48018a,1,Alex Antonenko,2018-03-28 13:32:45+03:00,['93b09490e1f0a300ee2ed2d73f7859e390f2438b'],2,2,4,31565352,2,,,,31283
9a1e90b6f0e3d977e792401ccdfd9115e4fc15c9,0,GitHub,2018-03-28 13:49:57+03:00,"['e5c11fa0d65ef570bf8d619bab7209efb34b2430', '316322666ae32a5f9a20ab205817931d906ed71b']",2,12,14,31565366,2,,,,31283
5c2f4fbb383453d81574b8e2c081a3c3a279ca60,1,Aleksandr Kovalenko,2018-03-28 14:18:41+03:00,['9a1e90b6f0e3d977e792401ccdfd9115e4fc15c9'],4,5,9,31565375,3,,,,31283
3b643bc591973920cec390a3018fecee55761dee,0,aBabiichuk,2018-03-28 16:19:36+03:00,['5c2f4fbb383453d81574b8e2c081a3c3a279ca60'],1,1,2,31565377,1,,,,31283
508769f5cbfe67842396d2a0761eeb9a4fa8585a,0,Andrii Tkach,2018-03-28 17:37:10+03:00,['3b643bc591973920cec390a3018fecee55761dee'],8,6,14,31565391,1,,,,31283
3c63a2779c3f02a4197a17e88be713f50cf4b6f1,0,GitHub,2018-03-28 17:45:40+03:00,"['508769f5cbfe67842396d2a0761eeb9a4fa8585a', 'dd5b34d524387a359d654de6f8efe31d3f22bea6']",1,1,2,31565393,1,,,,31283
7a318d95d7c142dbfd10eb4c26c2cb2d8ad89c1f,0,Attila Magyar,2018-03-28 18:32:37+02:00,['3c63a2779c3f02a4197a17e88be713f50cf4b6f1'],5,23,28,31565421,2,0,1,0,31283
074c01ffbdec8b11ddfac78cfa41ee4f86ac60a0,1,Miklos Gergely,2018-03-28 19:17:50+02:00,['7a318d95d7c142dbfd10eb4c26c2cb2d8ad89c1f'],8,12,20,31565441,2,,,0,31283
c6ef58d46e9b563f8f9e261107e242f018418f70,1,avijayanhwx,2018-03-28 10:18:13-07:00,['074c01ffbdec8b11ddfac78cfa41ee4f86ac60a0'],25,63,88,31565529,48,,,,31283
d1df5d3781b21a915ec2113069d46c98ff2908ab,0,GitHub,2018-03-29 08:32:44+02:00,['c6ef58d46e9b563f8f9e261107e242f018418f70'],0,10,10,31565539,2,0.6,0.6,0.6,31283
4b247f2db3a45c1f6ec59fb768167d2291115fe5,0,GitHub,2018-03-29 08:33:19+02:00,['d1df5d3781b21a915ec2113069d46c98ff2908ab'],1,6,7,31565546,2,1,1,1,31283
d3b2cedd8a619ce80e8e067f4b8ee1fb4dfd06f3,0,GitHub,2018-03-29 11:28:58+03:00,"['4b247f2db3a45c1f6ec59fb768167d2291115fe5', 'ffeda8c3ce9912a740f4bf11cfeebae77d48018a']",2,2,4,31565550,2,,,,31283
4727a7445138cac216442424b73ad0d490cbaed2,0,benyoka,2018-03-29 10:35:29+02:00,['d3b2cedd8a619ce80e8e067f4b8ee1fb4dfd06f3'],933,1298,2231,31567781,43,1,1,0,31285
0f569fb1f2f2eff7691a785bded7c904a979eaf8,1,aBabiichuk,2018-03-29 13:09:04+03:00,['4727a7445138cac216442424b73ad0d490cbaed2'],47,228,275,31568056,12,1,1,1,31285
2525a2af01d9e44694ee5aa5fb24c6ad8e15db7d,0,Andrii Tkach,2018-03-29 13:38:57+03:00,['0f569fb1f2f2eff7691a785bded7c904a979eaf8'],31,35,66,31568122,4,0,0,0.5,31285
533073b4a690c5db81125bc30247eef0c4985331,1,Andrii Tkach,2018-03-29 13:40:33+03:00,['2525a2af01d9e44694ee5aa5fb24c6ad8e15db7d'],2,3,5,31568127,1,1,1,1,31285
fd4176e7d698d6ec31ae91ac9a266643b16ac670,0,Andrii Tkach,2018-03-29 13:41:46+03:00,['533073b4a690c5db81125bc30247eef0c4985331'],98,161,259,31568386,9,1,1,1,31285
7df55eec8e5b41dbaac2341c40a4ed31eb5b56c8,1,Andrii Tkach,2018-03-29 13:43:24+03:00,['fd4176e7d698d6ec31ae91ac9a266643b16ac670'],39,114,153,31568539,20,1,1,1,31286
8a1f8e41098a692f52e71e2509c6a425c2516a3f,0,Andrii Tkach,2018-03-29 13:44:38+03:00,['7df55eec8e5b41dbaac2341c40a4ed31eb5b56c8'],147,104,251,31568790,13,0,0,0,31287
ff05ef6236a3d3bf517eb9c452f4eb24c73ca034,0,Andrii Tkach,2018-03-29 13:45:48+03:00,['8a1f8e41098a692f52e71e2509c6a425c2516a3f'],86,76,162,31568952,13,,,,31287
264bfa80056feb25a55afabcddd633465cf2f433,0,GitHub,2018-03-29 09:05:15-04:00,"['ff05ef6236a3d3bf517eb9c452f4eb24c73ca034', '68fdbef30bfbc39b6e07f4302effc66aa08e1b12']",12,21,33,31568985,2,,,,31287
ed7d2ace071fe0c6dc7ffa831dbb9faee4086980,0,Lisnichenko Dmitro,2018-03-29 16:44:35+03:00,['264bfa80056feb25a55afabcddd633465cf2f433'],0,3,3,31568988,1,0,0,1,31287
8c14b778387b0682982d5e16567e70ad82111664,0,Alex Antonenko,2018-03-29 16:45:11+03:00,['93b09490e1f0a300ee2ed2d73f7859e390f2438b'],69,109,178,31569166,4,0.4,1,1,31288
b6290bab17a3857ff6a9b9b3444467234e4f284b,1,GitHub,2018-03-29 16:30:58+02:00,['264bfa80056feb25a55afabcddd633465cf2f433'],1,47,48,31569214,5,0,1,1,31289
fbc59ede2538f66f55d9d6914d51a84635ba7ac2,1,Robert Levas,2018-03-29 10:45:53-04:00,['b6290bab17a3857ff6a9b9b3444467234e4f284b'],160,809,969,31570183,13,0.065281899,0.807121662,0.786350148,31291
8d1f100212de5d49ee848577391a7a1f25e8dadb,1,GitHub,2018-03-29 10:53:26-04:00,['fbc59ede2538f66f55d9d6914d51a84635ba7ac2'],5,138,143,31570326,3,0,1,1,31291
5b25bcdb8fd3710c676bb314db7e905f7e9bbc33,0,GitHub,2018-03-29 17:31:21+02:00,['8d1f100212de5d49ee848577391a7a1f25e8dadb'],1,20,21,31570347,2,1,1,1,31291
4fb18c778f0adc0a7c318a9b557010c41b64287e,0,Andrii Tkach,2018-03-29 18:35:43+03:00,['5b25bcdb8fd3710c676bb314db7e905f7e9bbc33'],6,16,22,31570369,2,1,1,1,31291
bafa18256652258df3d19dd48ff101829e53580c,0,Myroslav Papirkovskyi,2018-03-29 19:23:46+03:00,['4fb18c778f0adc0a7c318a9b557010c41b64287e'],6,79,85,31570454,5,0.9,1,1,31293
6f79c888aed062ef60d40bbd647d43f5629b0b2d,0,Siddharth,2018-03-29 11:55:37-07:00,['bafa18256652258df3d19dd48ff101829e53580c'],118,45,163,31570617,6,1,0.823529412,0.588235294,31293
696083e0ce406fea1eccc7a9dbbca8b7d3700d66,0,ncole,2018-03-29 16:10:18-04:00,['6f79c888aed062ef60d40bbd647d43f5629b0b2d'],0,109,109,31570726,22,,,,31293
cd7814aa3d6db1f6db0a49a5a07cb809d92018d0,1,aonishuk,2018-03-30 11:37:39+03:00,['696083e0ce406fea1eccc7a9dbbca8b7d3700d66'],13,10,23,31570749,1,0,0,0,31293
f1afadc6b29b668f0210d96314b65df8d4554b07,0,aonishuk,2018-03-30 11:37:39+03:00,['cd7814aa3d6db1f6db0a49a5a07cb809d92018d0'],1,1,2,31570751,1,,,,31293
6329754e6f7746a3f070f71f77c9126c13263c34,0,GitHub,2018-03-30 13:13:48+03:00,"['f1afadc6b29b668f0210d96314b65df8d4554b07', '8c14b778387b0682982d5e16567e70ad82111664']",69,109,178,31570929,4,,,,31293
169e27889dbeea3ec7e50fe94f552f5b9547ee61,0,GitHub,2018-03-30 13:18:48+03:00,"['6329754e6f7746a3f070f71f77c9126c13263c34', 'ed7d2ace071fe0c6dc7ffa831dbb9faee4086980']",0,3,3,31570932,1,,,,31293
100fd036a6b4f1ee00fca3d4ea442f06ca8ca0c6,1,Oliver Szabo,2018-03-30 14:18:10+02:00,['169e27889dbeea3ec7e50fe94f552f5b9547ee61'],92,102,194,31571126,1,0,0,0,31293
9a8b959781a1ccbc50403eef9d6779b944da579c,1,Aleksandr Kovalenko,2018-03-30 17:26:45+03:00,['100fd036a6b4f1ee00fca3d4ea442f06ca8ca0c6'],20,35,55,31571181,3,1,1,1,31293
926274db8c19ccdbf94e0a0db7799e8a27461e94,0,aonishuk,2018-03-31 11:36:06+03:00,['9a8b959781a1ccbc50403eef9d6779b944da579c'],2,2,4,31571185,1,,,,31293
08807911bcc092d17d1312467026ce002f3451f8,0,Robert Levas,2018-03-31 06:50:11-04:00,['926274db8c19ccdbf94e0a0db7799e8a27461e94'],143,66,209,31571394,3,1,0,0,31293
bf7ce08399c07ac60c43f9d66f9f8f69719dfccc,0,Robert Levas,2018-03-31 15:27:20-04:00,['08807911bcc092d17d1312467026ce002f3451f8'],17,62,79,31571473,5,0.631578947,0.210526316,0.421052632,31293
e60b1068f738934e7e321548f42d8909fbd2f133,1,avijayanhwx,2018-04-01 12:13:52-07:00,['bf7ce08399c07ac60c43f9d66f9f8f69719dfccc'],476,1945,2421,31573894,33,0.468454259,0.6829653,0.963722397,31308
e10b5da6638fbccab6a1330047babfb234913679,1,avijayanhwx,2018-04-01 12:13:52-07:00,['e60b1068f738934e7e321548f42d8909fbd2f133'],4,2029,2033,31575927,26,0.470531401,0.809661836,0.818357488,31331
485cdf4f632cdcc4bb3f5fc53f525c6686d33b14,1,avijayanhwx,2018-04-01 12:13:52-07:00,['e10b5da6638fbccab6a1330047babfb234913679'],4,4,8,31575935,2,,,,31331
b1ec22e38d60ffdda5cb7a65f9779da9de8b8a3c,1,avijayanhwx,2018-04-01 12:13:52-07:00,['485cdf4f632cdcc4bb3f5fc53f525c6686d33b14'],10,312,322,31576257,8,1,0,1,31338
58e8d4ba9f2e42bc21a713597c994a3c345bc721,0,avijayanhwx,2018-04-01 12:13:52-07:00,['b1ec22e38d60ffdda5cb7a65f9779da9de8b8a3c'],0,0,0,31576257,1,,,,31338
d81c072ca7413d92ed6db83edfe83f4d75b41a0a,1,avijayanhwx,2018-04-01 12:13:52-07:00,['58e8d4ba9f2e42bc21a713597c994a3c345bc721'],67,566,633,31576890,34,0.605263158,0.078947368,0.552631579,31338
13dee7c1a3cc1ec0abdc64813b5dc1f6a67813fd,1,avijayanhwx,2018-04-01 12:13:52-07:00,['d81c072ca7413d92ed6db83edfe83f4d75b41a0a'],59,53,112,31577002,4,0.095238095,1,1,31338
46c0af89a17021b45b14bc4b6c184d58f05405cf,1,avijayanhwx,2018-04-01 12:13:52-07:00,['13dee7c1a3cc1ec0abdc64813b5dc1f6a67813fd'],872,4068,4940,31581942,49,0.423255814,0.518604651,0.8,31346
1e43864585259e1a3b2d4835256200d2d3448c1f,1,avijayanhwx,2018-04-01 12:13:52-07:00,['46c0af89a17021b45b14bc4b6c184d58f05405cf'],160,656,816,31582758,63,0.182222222,0.271111111,0.928888889,31347
935f3329574d712dd1d976fb3ad5b154ca82ccb1,1,avijayanhwx,2018-04-01 12:13:52-07:00,['1e43864585259e1a3b2d4835256200d2d3448c1f'],143,66,209,31582967,30,0.704918033,0.442622951,0.049180328,31347
4efcf9d9f22131e0afcd1e46de14660f18d2f00e,1,avijayanhwx,2018-04-01 12:13:52-07:00,['935f3329574d712dd1d976fb3ad5b154ca82ccb1'],225,608,833,31583800,12,0,0.852589641,0.569721116,31349
54e4a978240100cd760b993eb9569a1e9b314ab8,1,avijayanhwx,2018-04-01 12:13:52-07:00,['4efcf9d9f22131e0afcd1e46de14660f18d2f00e'],303,1382,1685,31585485,27,0.182624113,0.634751773,0.838652482,31354
e466cc4fd06a30c9fd62eb99923576664233f06e,1,avijayanhwx,2018-04-01 12:13:52-07:00,['54e4a978240100cd760b993eb9569a1e9b314ab8'],1716,3794,5510,31590995,56,0.287694974,0.572790295,0.568457539,31379
2fdf774dd655ef950e52dcc871b080fc00e65555,1,avijayanhwx,2018-04-01 12:13:52-07:00,['e466cc4fd06a30c9fd62eb99923576664233f06e'],107,1234,1341,31592336,27,0.227642276,0.37804878,0.445121951,31385
73aee5c3d4100ad7379af265cc6351666932d2ae,0,avijayanhwx,2018-04-01 12:13:52-07:00,['2fdf774dd655ef950e52dcc871b080fc00e65555'],1,1,2,31592338,1,,,,31385
6830f00de4de3977e9a57d56378fb1864f1868ca,0,avijayanhwx,2018-04-01 12:13:52-07:00,['73aee5c3d4100ad7379af265cc6351666932d2ae'],1,6,7,31592345,2,1,1,1,31385
2eb160ce8713fd12e9cfc3eeba26b9b051258ba6,0,avijayanhwx,2018-04-01 12:13:52-07:00,['6830f00de4de3977e9a57d56378fb1864f1868ca'],0,18,18,31592363,1,,,,31385
d991f3c4d68fe1da7797c5593ee32595edd89fa4,1,avijayanhwx,2018-04-01 12:13:52-07:00,['2eb160ce8713fd12e9cfc3eeba26b9b051258ba6'],483,301,784,31593147,51,0.671875,0,0.171875,31387
fb75e61f60bd9925a127510ef53f92834631fc74,1,avijayanhwx,2018-04-01 12:13:52-07:00,['d991f3c4d68fe1da7797c5593ee32595edd89fa4'],255,246,501,31593648,46,0.801980198,0.801980198,0.267326733,31388
4d629372eb7ca7be9e55777db3be261b2dafa802,1,avijayanhwx,2018-04-01 12:13:52-07:00,['fb75e61f60bd9925a127510ef53f92834631fc74'],80,454,534,31594182,16,0.166666667,0,1,31393
166fff69c2b3414bbb9e907e4d049342779ff3f2,0,avijayanhwx,2018-04-01 12:13:52-07:00,['4d629372eb7ca7be9e55777db3be261b2dafa802'],295,437,732,31594914,15,0.204545455,0.522727273,0.340909091,31394
0c0c6279426a24ce411769268fff493a3e3b4fb0,1,avijayanhwx,2018-04-01 12:13:52-07:00,['166fff69c2b3414bbb9e907e4d049342779ff3f2'],212,857,1069,31595983,19,1,1,1,31407
6ffb35b1676edf1b84d707c582c78b92aba3fcc1,1,avijayanhwx,2018-04-01 12:13:52-07:00,['0c0c6279426a24ce411769268fff493a3e3b4fb0'],20,94,114,31596097,5,0.5,1,1,31407
64dcc02abc94859f9df316767b7f4589ea0b1502,1,avijayanhwx,2018-04-01 12:13:52-07:00,['6ffb35b1676edf1b84d707c582c78b92aba3fcc1'],115,619,734,31596831,21,0.704347826,0.608695652,0.965217391,31412
d580f272c39ee83d4212e0ae5080342ea3753372,1,avijayanhwx,2018-04-01 12:13:52-07:00,['64dcc02abc94859f9df316767b7f4589ea0b1502'],208,2272,2480,31599311,62,0.656126482,0.830039526,0.588932806,31444
afa154ba10a1e02956efe31238cc96a7cd032c8e,1,avijayanhwx,2018-04-01 12:13:52-07:00,['d580f272c39ee83d4212e0ae5080342ea3753372'],101,126,227,31599538,15,0,0.424242424,0.545454545,31444
cc510d67ea7d6e1ba25cd229807528fd8d13c8a6,1,avijayanhwx,2018-04-01 12:13:52-07:00,['afa154ba10a1e02956efe31238cc96a7cd032c8e'],6,306,312,31599850,8,1,1,1,31448
940b23a8080acda0ea268f3a1d8826822fdd63a8,1,avijayanhwx,2018-04-01 12:13:52-07:00,['cc510d67ea7d6e1ba25cd229807528fd8d13c8a6'],63,751,814,31600664,30,0.268518519,0.861111111,0.824074074,31453
8357de8ad1c56abb0daff44c4905301cd69ff1a3,1,avijayanhwx,2018-04-01 12:13:52-07:00,['940b23a8080acda0ea268f3a1d8826822fdd63a8'],368,1246,1614,31602278,50,0,0.826086957,0.811594203,31461
d46abc7ac19c4316463214022b28c95d63058764,0,avijayanhwx,2018-04-01 12:13:52-07:00,['8357de8ad1c56abb0daff44c4905301cd69ff1a3'],84,645,729,31603007,32,0,0,1,31467
61772212a0c9502e95c06d957d9df9326178b2d5,1,avijayanhwx,2018-04-01 12:13:52-07:00,['d46abc7ac19c4316463214022b28c95d63058764'],8019,241,8260,31611267,45,0.659978881,0.280253432,0.221330517,31467
541e2a5eca2e019607923c8a641dbb74bebe0258,0,avijayanhwx,2018-04-01 12:13:52-07:00,['61772212a0c9502e95c06d957d9df9326178b2d5'],11728,1,11729,31622996,139,0.60327381,0.31577381,0.327678571,31467
84f939d9f9448aab3e9250f6953996fb3dcb67e4,1,avijayanhwx,2018-04-01 12:13:52-07:00,['541e2a5eca2e019607923c8a641dbb74bebe0258'],328,306,634,31623630,53,,,,31467
a0b8d064e7981a8118818d7e5fbec5f49c4fee6a,0,avijayanhwx,2018-04-01 12:13:52-07:00,['84f939d9f9448aab3e9250f6953996fb3dcb67e4'],1,3,4,31623634,1,,,,31467
003c522a277e4f29f803a5fbd57d71b3f60ad67b,1,avijayanhwx,2018-04-01 12:13:52-07:00,['a0b8d064e7981a8118818d7e5fbec5f49c4fee6a'],10,10,20,31623654,2,,,,31467
ca62ed06b27baa1ec06578a2e455500bf5785639,1,avijayanhwx,2018-04-01 12:13:52-07:00,['003c522a277e4f29f803a5fbd57d71b3f60ad67b'],1,1,2,31623656,1,,,,31467
01243e2b639c08a4172b378dbcac96bb2de3fe67,0,avijayanhwx,2018-04-01 12:13:52-07:00,['ca62ed06b27baa1ec06578a2e455500bf5785639'],8,77,85,31623741,1,0.307692308,0.307692308,0.615384615,31467
c5c9d03328bd1dbf7ad86434d209709592b0ac27,1,avijayanhwx,2018-04-01 12:13:52-07:00,['01243e2b639c08a4172b378dbcac96bb2de3fe67'],46,90,136,31623877,4,1,1,0,31467
ba21ebe111ab119ccd4ca3305dc5267c5b4f0725,0,avijayanhwx,2018-04-01 12:13:52-07:00,['c5c9d03328bd1dbf7ad86434d209709592b0ac27'],0,18,18,31623895,3,0,0,0,31467
d1e4c4d8b871bc7d19c04c12ffa7f0ee3d3931ba,1,GitHub,2018-04-02 13:23:43+03:00,['ba21ebe111ab119ccd4ca3305dc5267c5b4f0725'],17,42,59,31623954,1,0,0,1,31467
10731ea3566a599da16941a02042f6c4c066121e,0,ncole,2018-04-02 13:05:02-04:00,['d1e4c4d8b871bc7d19c04c12ffa7f0ee3d3931ba'],45,118,163,31624117,6,0,0.176470588,0.411764706,31467
eaeef19fa09297d2be70bb2732c196d9e79654fc,1,ncole,2018-04-02 13:05:02-04:00,['10731ea3566a599da16941a02042f6c4c066121e'],66,143,209,31624326,3,0,1,1,31467
e02a6208920a2d4470558fec8cf22556343f84fe,0,avijayanhwx,2018-04-02 14:32:50-07:00,['eaeef19fa09297d2be70bb2732c196d9e79654fc'],7,7,14,31624340,1,,,,31467
3c4209ed6f7dc073c0e06c6587ca506a97bac4cb,1,Oliver Szabo,2018-04-03 00:03:35+02:00,['e02a6208920a2d4470558fec8cf22556343f84fe'],501,1209,1710,31626050,31,0.498905908,0.658643326,0.90809628,31474
29dd2302e6a7045503e149b8d945e4d21905432e,1,GitHub,2018-04-03 00:07:05+02:00,['3c4209ed6f7dc073c0e06c6587ca506a97bac4cb'],37,78,115,31626165,1,0.25,0,0.194444444,31474
95f9e81cd5f4d9882f8b63316336c31ed8896d6a,1,Aleksandr Kovalenko,2018-04-03 11:56:13+03:00,['29dd2302e6a7045503e149b8d945e4d21905432e'],12,60,72,31626237,4,0,1,1,31474
a7a34e40399d482edcc06fbb64e932519db0daeb,1,GitHub,2018-04-03 13:21:39+03:00,['95f9e81cd5f4d9882f8b63316336c31ed8896d6a'],75,159,234,31626471,10,0.709090909,0.927272727,1,31474
f7a57625d0c448479a02f8e4f4674df626fed4b4,0,Andrii Tkach,2018-04-03 13:43:35+03:00,['a7a34e40399d482edcc06fbb64e932519db0daeb'],6,2,8,31626479,1,0,1,0,31474
c5596a8c2ab086faa4d970188531128fdff392d3,1,GitHub,2018-04-03 13:30:08+02:00,['f7a57625d0c448479a02f8e4f4674df626fed4b4'],11,12,23,31626502,4,,,,31474
0824ed2c7b8699f561ff18ce0d5c4508cfe65791,0,aonishuk,2018-04-03 15:29:10+03:00,['c5596a8c2ab086faa4d970188531128fdff392d3'],44,98,142,31626644,10,0.03030303,0.515151515,0.818181818,31474
eef8f141d6111b5dbf2ea8ee445b2f7070a98fb3,0,GitHub,2018-04-03 15:08:31+02:00,['0824ed2c7b8699f561ff18ce0d5c4508cfe65791'],6,6,12,31626656,3,,,,31474
7dcff39b83f208b75e01ef8948e08682281ba457,0,avijayanhwx,2018-04-03 08:51:45-07:00,['eef8f141d6111b5dbf2ea8ee445b2f7070a98fb3'],7,7,14,31626670,1,,,,31474
4291cb410680ee7c74174d54f9a2424091a9428b,1,GitHub,2018-04-03 13:14:58-07:00,['7dcff39b83f208b75e01ef8948e08682281ba457'],3,6,9,31626679,1,,,,31474
4a0a28d0efd458a6f5b6e060dc0f7b8466e0935a,1,avijayanhwx,2018-04-03 20:20:54-07:00,['4291cb410680ee7c74174d54f9a2424091a9428b'],14,32,46,31626725,8,1,1,0,31474
d948ff082cced05695a2d8dbed2c15c5e19556de,0,aonishuk,2018-04-04 12:50:29+03:00,['4a0a28d0efd458a6f5b6e060dc0f7b8466e0935a'],16,34,50,31626775,1,0.2,0.5,0,31474
e2832d0879a5007a4dac6e99cd15f5e727430769,1,GitHub,2018-04-04 12:57:47+02:00,['d948ff082cced05695a2d8dbed2c15c5e19556de'],8,101,109,31626884,9,0.739130435,0.739130435,1,31474
31deb40bd71dcf39e8beb40923f7cde001cf9747,0,"Doroszlai, Attila",2018-04-04 13:29:56+02:00,['e2832d0879a5007a4dac6e99cd15f5e727430769'],173,513,686,31627570,5,,,,31476
5df06c19d6bcb5ceb398d5aa9f040567c466790d,1,"Doroszlai, Attila",2018-04-04 13:31:50+02:00,['31deb40bd71dcf39e8beb40923f7cde001cf9747'],411,875,1286,31628856,19,0.721311475,0.721311475,1,31478
729279088dcf138f3b3141517ce56b949b0497d9,1,Oliver Szabo,2018-04-04 13:50:16+02:00,['5df06c19d6bcb5ceb398d5aa9f040567c466790d'],2,2,4,31628860,2,,,,31478
d57e4de64613a006f393969c10491ba11924225f,0,Alex Antonenko,2018-04-04 15:00:51+03:00,['95f9e81cd5f4d9882f8b63316336c31ed8896d6a'],1,6,7,31628867,1,1,1,0,31478
5d29248131c3482efa4d09a9327a9ef02b68fc9c,0,Andrii Tkach,2018-04-04 16:00:32+03:00,['729279088dcf138f3b3141517ce56b949b0497d9'],28,15,43,31628910,2,0,0,0,31478
a6900dca0187f2ffef731162c5efc7183d723471,0,Andrii Tkach,2018-04-04 16:05:28+03:00,['5d29248131c3482efa4d09a9327a9ef02b68fc9c'],60,56,116,31629026,6,,,,31478
9e6add980ad0c09acf76f08b607c178f90776695,0,Andrii Tkach,2018-04-04 16:07:40+03:00,['a6900dca0187f2ffef731162c5efc7183d723471'],1,1,2,31629028,1,,,,31478
d000a5933dd88d9ee719029281ce6eb0b19e0623,0,Siddharth,2018-04-04 07:54:29-07:00,['9e6add980ad0c09acf76f08b607c178f90776695'],0,58,58,31629086,11,0.035714286,0.75,1,31478
ed95d9a4d4698bddc579dbee035527d58edf68de,1,Dmitry Sen,2018-04-04 18:15:25+03:00,['d000a5933dd88d9ee719029281ce6eb0b19e0623'],25,9,34,31629120,4,0,0,0,31478
62cbf6817b4a37fcff85fed38c684317dd8e37a8,0,Alex Antonenko,2018-04-04 18:16:14+03:00,['95f9e81cd5f4d9882f8b63316336c31ed8896d6a'],89,110,199,31629319,5,1,1,1,31478
541953e11830f61ab59b253d3738b017bb505e6f,1,Aleksandr Kovalenko,2018-04-04 19:07:27+03:00,['ed95d9a4d4698bddc579dbee035527d58edf68de'],9,12,21,31629340,1,0,0,1,31478
e1d45a0884d9fd7ff5a82fc5ac48f7df1a027410,0,Robert Levas,2018-04-04 12:34:20-04:00,['541953e11830f61ab59b253d3738b017bb505e6f'],15,53,68,31629408,2,0,0.863636364,0,31478
768ee9a2035d8ba6061e16c44b371afbf9209276,0,Robert Levas,2018-04-04 14:16:32-04:00,['e1d45a0884d9fd7ff5a82fc5ac48f7df1a027410'],1,0,1,31629409,1,0,1,1,31478
726080bd4fc195c245939e2bfa0f84e0f6126b65,0,Robert Levas,2018-04-04 15:33:20-04:00,['768ee9a2035d8ba6061e16c44b371afbf9209276'],2,1,3,31629412,1,,,,31478
45076eb19e373cd18f48372e68833c70f40a728d,0,Robert Levas,2018-04-04 15:51:36-04:00,['726080bd4fc195c245939e2bfa0f84e0f6126b65'],0,1,1,31629413,1,,,,31478
af8d02c6c5c6a3c429f9e3a4e68b10586b574bcf,1,avijayanhwx,2018-04-04 20:07:16-07:00,['45076eb19e373cd18f48372e68833c70f40a728d'],79,89,168,31629581,8,0,0.857142857,1,31480
f2839ad00e79ecc3fcd74405432f7b4573d0b5de,0,avijayanhwx,2018-04-04 20:07:16-07:00,['af8d02c6c5c6a3c429f9e3a4e68b10586b574bcf'],1,5,6,31629587,1,0,0,1,31480
f95bb41621580311b305feab8af66d9393517c2d,0,"Doroszlai, Attila",2018-04-05 08:27:48+02:00,['f2839ad00e79ecc3fcd74405432f7b4573d0b5de'],64,139,203,31629790,8,1,0.5,0,31480
3e02f274bc08567ff834a9c40d113f3a615525a1,0,GitHub,2018-04-05 10:38:50+03:00,"['f95bb41621580311b305feab8af66d9393517c2d', '62cbf6817b4a37fcff85fed38c684317dd8e37a8']",89,110,199,31629989,5,,,,31480
000333c5ec2f3a9568a8b56020faf81421c4a515,1,GitHub,2018-04-05 12:40:14+03:00,['3e02f274bc08567ff834a9c40d113f3a615525a1'],108,151,259,31630248,14,1,1,1,31480
189e1c26a84e8545bdcf5764e1f88a05676e51a7,0,Attila Magyar,2018-04-05 12:31:32+02:00,['000333c5ec2f3a9568a8b56020faf81421c4a515'],2,4,6,31630254,3,,,,31480
d8f673f29d727c0d3daad0363068229486e64bdd,1,Olivér Szabó,2018-04-05 13:04:46+02:00,['189e1c26a84e8545bdcf5764e1f88a05676e51a7'],143,4987,5130,31635384,34,0.754347826,0.943478261,0.82826087,31502
e463122db4e53cf83952ac77be0a64381c5df814,0,Robert Levas,2018-04-05 08:49:46-04:00,['d8f673f29d727c0d3daad0363068229486e64bdd'],0,2,2,31635386,1,,,,31502
7aa1cb5c75f83faeada03db3b9fb29c9afb2e5ba,0,GitHub,2018-04-05 16:33:55+03:00,"['e463122db4e53cf83952ac77be0a64381c5df814', 'd57e4de64613a006f393969c10491ba11924225f']",1,6,7,31635393,1,,,,31502
0f73761e28a51d84bc84f6f6a6451fdc3df06c19,0,Oliver Szabo,2018-04-05 15:38:53+02:00,['7aa1cb5c75f83faeada03db3b9fb29c9afb2e5ba'],2,2,4,31635397,1,,,,31502
5f9eb7c0e1d9da7f574122f606d15cf91d7ec0af,0,Andrii Tkach,2018-04-05 17:05:04+03:00,['0f73761e28a51d84bc84f6f6a6451fdc3df06c19'],7,7,14,31635411,4,,,,31502
c656a232210b97fa7df6c6d9d519bdf74855614a,0,Andrii Tkach,2018-04-05 17:07:40+03:00,['5f9eb7c0e1d9da7f574122f606d15cf91d7ec0af'],6,9,15,31635426,1,,,,31502
d42c1391f13049e78fa9e64c9693551ec1c2cc66,0,Robert Levas,2018-04-05 11:55:38-04:00,['c656a232210b97fa7df6c6d9d519bdf74855614a'],3,7,10,31635436,1,0,1,1,31502
c649e512b76834916ba583c28c6bad8a3c5738c4,0,Dmytro Grinenko,2018-04-05 20:48:17+03:00,['d42c1391f13049e78fa9e64c9693551ec1c2cc66'],1,6,7,31635443,1,0,0,0,31502
1bcbcd4ec3a20e387994c849f73defcc20659e0e,1,Ishan Bhatt,2018-04-05 11:47:51-07:00,['c649e512b76834916ba583c28c6bad8a3c5738c4'],0,2,2,31635445,1,1,1,1,31502
01ed6310f6c38c49ce31894f886422e513b82c49,0,Vishal Suvagia,2018-04-06 00:49:48+05:18,['c649e512b76834916ba583c28c6bad8a3c5738c4'],1,1,2,31635447,1,,,,31502
3305199bb58931474c2f2dfb2a1bac30f7b38cd4,1,GitHub,2018-04-05 16:35:27-04:00,['c649e512b76834916ba583c28c6bad8a3c5738c4'],26,561,587,31636034,2,0.008287293,0.889502762,0.991712707,31502
05d08e04ac4999add83f122f84d0283292c79e8f,0,Ishan Bhatt,2018-04-05 13:35:50-07:00,['1bcbcd4ec3a20e387994c849f73defcc20659e0e'],1,11,12,31636046,3,1,1,1,31502
bd1b4e6fb817b78f4378d59fa6b2c9c5a3b98222,0,"Doroszlai, Attila",2018-04-05 22:38:57+02:00,['3305199bb58931474c2f2dfb2a1bac30f7b38cd4'],138,246,384,31636430,5,,,,31502
b6b293ab0c1ac078da0017be4a957ef4da4c2cff,0,GitHub,2018-04-05 23:41:51+02:00,['bd1b4e6fb817b78f4378d59fa6b2c9c5a3b98222'],3,42,45,31636475,2,1,1,1,31502
4a587b9e476e013268df7485c5c6d601a8e1b06f,1,Oliver Szabo,2018-04-06 02:24:40+02:00,['b6b293ab0c1ac078da0017be4a957ef4da4c2cff'],1,3,4,31636479,1,0,0,0,31502
e5eb05b75c7a862c56a586d8deb6ab96dac69ddb,1,Oliver Szabo,2018-04-06 02:27:26+02:00,['4a587b9e476e013268df7485c5c6d601a8e1b06f'],5,9,14,31636493,3,1,1,1,31502
23f47a3bad70e0799a826ca2f11480b3c0544cbe,1,aonishuk,2018-04-06 11:41:29+03:00,['e5eb05b75c7a862c56a586d8deb6ab96dac69ddb'],2,28,30,31636523,2,0.117647059,0.176470588,0.411764706,31502
5b75125878fb2f0bec24853f6fbf702a021c7827,1,aBabiichuk,2018-04-06 12:04:10+03:00,['23f47a3bad70e0799a826ca2f11480b3c0544cbe'],1,1,2,31636525,1,,,,31502
3f6726f5a44cc5289b141c2cad7c4f35fef6bdc7,1,Aleksandr Kovalenko,2018-04-06 12:09:36+03:00,['5b75125878fb2f0bec24853f6fbf702a021c7827'],72,158,230,31636755,9,0,0,1,31503
8df2fc78fbd5c6618f4e6e37e6fe5b2200e8c7c9,0,Alex Antonenko,2018-04-06 14:11:14+03:00,['e5eb05b75c7a862c56a586d8deb6ab96dac69ddb'],63,1,64,31636819,1,0.857142857,0,0,31503
49f93b17903d803d8df430e50d8f2cd7604361ad,1,Andrii Tkach,2018-04-06 14:38:03+03:00,['3f6726f5a44cc5289b141c2cad7c4f35fef6bdc7'],10,38,48,31636867,2,1,1,1,31503
56c5d3af2691756e4bebcd5eef9516c2ebea3bd3,0,Andrii Tkach,2018-04-06 14:43:25+03:00,['49f93b17903d803d8df430e50d8f2cd7604361ad'],1,4,5,31636872,2,,,,31503
7e1c33a681c79bdbe786ecf10fb5bf050ccc6188,0,Mugdha Varadkar,2018-04-06 20:29:40+05:18,"['a05762d212300684c0c4e6f0436b23bd32958ea8', '56c5d3af2691756e4bebcd5eef9516c2ebea3bd3']",49256,48042,97298,31734170,1435,,,,31503
d50333d021a3118b7cc86c708cd817448e8add2f,1,Myroslav Papirkovskyi,2018-04-06 18:15:55+03:00,['56c5d3af2691756e4bebcd5eef9516c2ebea3bd3'],206,226,432,31734602,60,0.5,0.5,0.5,31503
91fb8b684fe9312cab0f033ea6ad263fd5e536d8,1,GitHub,2018-04-06 17:23:00+02:00,['d50333d021a3118b7cc86c708cd817448e8add2f'],93,125,218,31734820,3,,,,31503
d693edc7502280043e76ddc348752a0758950218,0,Aleksandr Kovalenko,2018-04-06 18:47:18+03:00,['91fb8b684fe9312cab0f033ea6ad263fd5e536d8'],7,13,20,31734840,1,1,1,1,31503
8c9b19848174dfc529d55b6864cfeb8fe0f9a8ff,1,Myroslav Papirkovskyi,2018-04-06 18:49:00+03:00,['d693edc7502280043e76ddc348752a0758950218'],4,70,74,31734914,2,0.942857143,1,0.971428571,31503
6fce9b1ed5686814aa13454144e4b3ce89ad9b31,0,Robert Levas,2018-04-06 12:11:45-04:00,['8c9b19848174dfc529d55b6864cfeb8fe0f9a8ff'],54,140,194,31735108,2,,,,31503
bbb1cdf2b493e2297381116f4147622a0cbb0d61,0,GitHub,2018-04-06 19:05:49+02:00,['6fce9b1ed5686814aa13454144e4b3ce89ad9b31'],2,2,4,31735112,1,,,,31503
c48fb74402cef258aa8adec9dcd00e97cd71887b,1,Myroslav Papirkovskyi,2018-04-06 20:06:06+03:00,['bbb1cdf2b493e2297381116f4147622a0cbb0d61'],4,34,38,31735150,5,0.095238095,0.952380952,0.952380952,31503
a0a09471e15ebc4c2ee3ec959fa263499b4afa61,0,GitHub,2018-04-06 20:12:19+02:00,['c48fb74402cef258aa8adec9dcd00e97cd71887b'],1,1,2,31735152,1,,,,31503
70d0c088a4f0dbe232b926e9a48393d2a9cf059d,0,Siddharth,2018-04-06 12:15:38-07:00,['a0a09471e15ebc4c2ee3ec959fa263499b4afa61'],22,48,70,31735222,2,0.705882353,0.705882353,1,31503
e9bb069e29b9c6f3ccc59a3c4526fbc7c0c11634,0,Siddharth,2018-04-06 12:24:49-07:00,['70d0c088a4f0dbe232b926e9a48393d2a9cf059d'],0,4,4,31735226,1,,,,31503
d29656be4d83c430c5f9518f5f408ffe99cb80c1,0,Alex Antonenko,2018-04-06 23:49:37+03:00,['8df2fc78fbd5c6618f4e6e37e6fe5b2200e8c7c9'],95,6,101,31735327,1,0.306451613,0,0,31503
580c9faf8e11bfc6e4c2470ea96c0ebe65f7217b,0,Aleksandr Kovalenko,2018-04-07 01:15:47+03:00,['e9bb069e29b9c6f3ccc59a3c4526fbc7c0c11634'],1,1,2,31735329,1,,,,31503
784089d4dac5c4aa58037e0aecfe61c93ba6675a,1,GitHub,2018-04-07 01:31:55+03:00,['580c9faf8e11bfc6e4c2470ea96c0ebe65f7217b'],7,9,16,31735345,2,0,0,1,31503
66c008b30f8982f36b9e22dcff816da49b05306c,1,aBabiichuk,2018-04-07 02:41:10+03:00,['784089d4dac5c4aa58037e0aecfe61c93ba6675a'],101,235,336,31735681,7,1,0.796610169,0.745762712,31503
1fcd7daed0fdfaf3776f498a7646a0c5f3786d3a,0,GitHub,2018-04-07 13:27:41+03:00,"['66c008b30f8982f36b9e22dcff816da49b05306c', 'd29656be4d83c430c5f9518f5f408ffe99cb80c1']",158,7,165,31735846,2,,,,31503
464ce88e85f4374e3f369d179b1a5505b3e48327,0,Attila Magyar,2018-04-07 16:58:55+02:00,['1fcd7daed0fdfaf3776f498a7646a0c5f3786d3a'],0,1,1,31735847,1,0,0,0,31503
31952818f88a4e3ba30171124b7c2f40f71fa400,1,aonishuk,2018-04-07 18:30:53+03:00,['464ce88e85f4374e3f369d179b1a5505b3e48327'],6,38,44,31735891,1,,,,31503
0958fca84eb96a32c223b43ef6d2a230addb066f,0,avijayanhwx,2018-04-07 12:03:22-07:00,['31952818f88a4e3ba30171124b7c2f40f71fa400'],4,14,18,31735909,3,1,1,1,31503
e88c3847aa1d5133c29b5941c38a964bdfd5f45f,0,"Doroszlai, Attila",2018-04-09 13:08:28+02:00,['0958fca84eb96a32c223b43ef6d2a230addb066f'],9,10,19,31735928,5,,,,31503
86735210772b858654fb47becac5cb99af4c64bc,1,"Doroszlai, Attila",2018-04-09 13:08:28+02:00,['e88c3847aa1d5133c29b5941c38a964bdfd5f45f'],7,143,150,31736078,3,0.264705882,0.676470588,0.588235294,31504
ab99b71c30fc9a3a82ae15bba267957483d8da42,0,"Doroszlai, Attila",2018-04-09 13:08:28+02:00,['86735210772b858654fb47becac5cb99af4c64bc'],57,131,188,31736266,6,,,,31504
e3b3971e35d055a05bcf541dc42cf4e17417794b,1,Olivér Szabó,2018-04-09 16:03:46+02:00,['ab99b71c30fc9a3a82ae15bba267957483d8da42'],81,74,155,31736421,9,1,1,1,31504
aea0869c766050690e1c02037edbc5c4f6800700,0,GitHub,2018-04-09 10:50:06-04:00,['e3b3971e35d055a05bcf541dc42cf4e17417794b'],24,45,69,31736490,4,0,0.285714286,0.714285714,31504
fe17881b9cfc03f817a5652c92ef70e2e12fb807,0,GitHub,2018-04-09 17:11:52+02:00,['aea0869c766050690e1c02037edbc5c4f6800700'],1,1,2,31736492,1,,,,31504
5a294a0e45b67130eaf97914f1815aa6f5a0d6e0,0,GitHub,2018-04-09 13:09:05-04:00,['fe17881b9cfc03f817a5652c92ef70e2e12fb807'],3,5,8,31736500,2,1,1,1,31504
674807e82eb1ee2187a28947f007d8afabf373c6,0,Robert Levas,2018-04-09 13:22:05-04:00,['5a294a0e45b67130eaf97914f1815aa6f5a0d6e0'],4,12,16,31736516,3,0,0.5,1,31504
14aacbb8d9bbb8f75d69d3b33e22844c5a0751ea,1,Oliver Szabo,2018-04-09 19:22:27+02:00,['674807e82eb1ee2187a28947f007d8afabf373c6'],1,1,2,31736518,1,,,,31504
e3e56219bb5d79e6b59e436f8e623d54037e45b8,0,Siddharth,2018-04-09 11:29:13-07:00,['14aacbb8d9bbb8f75d69d3b33e22844c5a0751ea'],257,106,363,31736881,8,1,0.308510638,0.212765957,31504
4b760174dfabf1e2594b045c3669e65cca5ef3fb,0,GitHub,2018-04-09 12:02:26-07:00,"['e3e56219bb5d79e6b59e436f8e623d54037e45b8', '01ed6310f6c38c49ce31894f886422e513b82c49']",1,1,2,31736883,1,,,,31504
c6b01c9182732175fa1b6c28387db0f8421ae56a,0,avijayanhwx,2018-04-09 15:56:51-07:00,['4b760174dfabf1e2594b045c3669e65cca5ef3fb'],68,72,140,31737023,1,0,0,1,31504
29abee987321ed6c89cec18f309c44898b415e66,0,Alex Antonenko,2018-04-10 10:53:43+03:00,['c6b01c9182732175fa1b6c28387db0f8421ae56a'],2,2,4,31737027,2,,,,31504
09c959dba7622d0428931e87262f35a580fa3c14,1,"Doroszlai, Attila",2018-04-10 10:29:12+02:00,['c6b01c9182732175fa1b6c28387db0f8421ae56a'],12,150,162,31737189,3,0.110091743,0.834862385,0.981651376,31504
de12df0e5d895cb27b3b79d040a37c455d91f12f,0,GitHub,2018-04-10 11:45:26+03:00,"['09c959dba7622d0428931e87262f35a580fa3c14', '29abee987321ed6c89cec18f309c44898b415e66']",2,2,4,31737193,2,,,,31504
15cdec0a2b5be1d28a02de819ddd421f5a5d3653,1,Attila Magyar,2018-04-10 11:45:09+02:00,['de12df0e5d895cb27b3b79d040a37c455d91f12f'],9,13,22,31737215,1,0,0.333333333,0.666666667,31504
081dc848a84d54c52842f7c1f286b7203a749b57,0,Attila Magyar,2018-04-10 11:45:09+02:00,['15cdec0a2b5be1d28a02de819ddd421f5a5d3653'],1,1,2,31737217,1,,,,31504
2d125c91254b81475cf1b429031b6b66c75808e7,0,Attila Magyar,2018-04-10 11:45:09+02:00,['081dc848a84d54c52842f7c1f286b7203a749b57'],11,11,22,31737239,1,,,,31504
1017292cf344183ec1dc9733df53d1549f5d520a,0,Andrii Tkach,2018-04-10 12:49:16+03:00,['2d125c91254b81475cf1b429031b6b66c75808e7'],4,7,11,31737250,3,1,0,1,31504
42ceadd4cb947672c5d46b0f899aa8c4af2e29c3,0,Andrii Tkach,2018-04-10 13:27:28+03:00,['1017292cf344183ec1dc9733df53d1549f5d520a'],1,1,2,31737252,1,,,,31504
7e57944baeaf31a530afe1f0946791a48fc3a8cb,0,Andrii Tkach,2018-04-10 13:35:36+03:00,['42ceadd4cb947672c5d46b0f899aa8c4af2e29c3'],0,1,1,31737253,1,1,1,0,31504
fc2a1b4acec27c9a6bc6c8334a69562600f015e2,1,Andrii Tkach,2018-04-10 13:37:07+03:00,['7e57944baeaf31a530afe1f0946791a48fc3a8cb'],6,107,113,31737366,6,1,1,1,31505
865af311a2887b92cfb88e663c78efcb6a1f0569,0,Miklos Gergely,2018-04-10 13:01:12+02:00,['fc2a1b4acec27c9a6bc6c8334a69562600f015e2'],0,9,9,31737375,1,1,1,1,31505
115def9d4ed4fdd950f52d78518d14ec2552af03,0,Alex Antonenko,2018-04-10 15:41:27+03:00,['c6b01c9182732175fa1b6c28387db0f8421ae56a'],1,1,2,31737377,1,,,,31505
e53f6af17ff175107cda922b7781a3fbbf5ddb5c,0,GitHub,2018-04-10 12:59:00-04:00,"['865af311a2887b92cfb88e663c78efcb6a1f0569', '05d08e04ac4999add83f122f84d0283292c79e8f']",1,13,14,31737391,3,,,,31505
d49f54d9773f6b0e1243008a1b08fad35ab5c65e,1,GitHub,2018-04-10 12:59:30-04:00,['e53f6af17ff175107cda922b7781a3fbbf5ddb5c'],1,14,15,31737406,5,1,1,1,31505
9b084bd1c14b9560b8db5bc6263021a974934361,0,Robert Levas,2018-04-10 13:02:04-04:00,['d49f54d9773f6b0e1243008a1b08fad35ab5c65e'],9,5,14,31737420,1,1,1,1,31505
82c9e3f30e3e3846d874a8c310cb112caeda58ce,1,Miklos Gergely,2018-04-10 19:22:43+02:00,['9b084bd1c14b9560b8db5bc6263021a974934361'],1,1,2,31737422,1,,,,31505
686e506befd99cd4f761759f63afde9693b488d3,0,Attila Magyar,2018-04-10 22:03:20+02:00,['82c9e3f30e3e3846d874a8c310cb112caeda58ce'],7,10,17,31737439,1,1,1,0,31505
04db2b44b4c0870959ef79af927fa89d84ff678b,1,Aleksandr Kovalenko,2018-04-10 23:15:49+03:00,['686e506befd99cd4f761759f63afde9693b488d3'],2,5,7,31737446,1,1,1,1,31505
85e71227e5fa6043a0477c7a96998a21e7355860,1,Siddharth,2018-04-10 13:42:23-07:00,['04db2b44b4c0870959ef79af927fa89d84ff678b'],8,24,32,31737478,1,0,1,1,31505
9d7e373c34bacaf2897287907cc3c81d0d14c7bc,1,GitHub,2018-04-11 05:04:42-04:00,['85e71227e5fa6043a0477c7a96998a21e7355860'],848,996,1844,31739322,27,0.782608696,1,0.855072464,31506
5db10483fa282d63e30c1acd2fc3af59bc635fda,0,GitHub,2018-04-11 11:29:16+02:00,['9d7e373c34bacaf2897287907cc3c81d0d14c7bc'],9,16,25,31739347,2,1,0,1,31506
70edbb5cbfcd6c4ff83589650f715ae9c1b92790,0,Myroslav Papirkovskyi,2018-04-11 20:52:04+03:00,['5db10483fa282d63e30c1acd2fc3af59bc635fda'],30,31,61,31739408,1,1,1,0,31506
fcdc4da582d74f6aaed3839e2f7aa0373d1913f3,0,GitHub,2018-04-12 12:04:02+03:00,"['70edbb5cbfcd6c4ff83589650f715ae9c1b92790', '115def9d4ed4fdd950f52d78518d14ec2552af03']",1,1,2,31739410,1,,,,31506
52a527e6fd70c14cf8f9af75ce1edc550da0f89b,0,GitHub,2018-04-12 11:13:16+02:00,['fcdc4da582d74f6aaed3839e2f7aa0373d1913f3'],5,4,9,31739419,1,,,,31506
1ad21eecb127af9776f0fb50ee905f3d6b1d74ea,1,aBabiichuk,2018-04-12 12:13:57+03:00,['52a527e6fd70c14cf8f9af75ce1edc550da0f89b'],10,11,21,31739440,3,0,0,1,31506
cf86bfd5f9a0225d55fbb3b4e20d363b34ac7e8f,1,aBabiichuk,2018-04-12 12:19:02+03:00,['1ad21eecb127af9776f0fb50ee905f3d6b1d74ea'],90,117,207,31739647,4,1,1,0.78125,31506
4f93c3c793da419b684a56b6e282947d7b974316,1,aBabiichuk,2018-04-12 13:17:28+03:00,['cf86bfd5f9a0225d55fbb3b4e20d363b34ac7e8f'],86,389,475,31740122,15,1,1,1,31506
e16bdec9b875213dedca1556d22fb1a6b602a95e,1,aBabiichuk,2018-04-12 13:38:15+03:00,['4f93c3c793da419b684a56b6e282947d7b974316'],24,69,93,31740215,5,1,1,1,31506
675ca9a64f70fae517aeefcadcbab137a239922a,0,Dmitry Sen,2018-04-12 13:41:07+03:00,['e16bdec9b875213dedca1556d22fb1a6b602a95e'],34,33,67,31740282,6,1,1,0.6,31506
6885d877de9b64304ecd3479257982a6f4fc354c,0,GitHub,2018-04-12 15:42:22+03:00,['675ca9a64f70fae517aeefcadcbab137a239922a'],3,5,8,31740290,2,,,,31506
b6a3bbc5627ecd4077330f9aff9d2be3d559b937,0,Alex Antonenko,2018-04-12 16:30:17+03:00,['70edbb5cbfcd6c4ff83589650f715ae9c1b92790'],0,7,7,31740297,2,,,,31506
f913ba37919d40a135a15e43ac0be104eb94a53f,0,Andrii Tkach,2018-04-12 18:31:26+03:00,['6885d877de9b64304ecd3479257982a6f4fc354c'],1,3,4,31740301,3,0.5,0.5,0.5,31506
06424bd6c6003145f48378d09714db3f1fff5a6a,0,Andrii Tkach,2018-04-12 18:31:26+03:00,['f913ba37919d40a135a15e43ac0be104eb94a53f'],5,6,11,31740312,1,1,1,1,31506
c7a83ae3ffbe8d7d573639fae0d6f3f6be3dea65,0,Andrii Tkach,2018-04-12 18:32:58+03:00,['06424bd6c6003145f48378d09714db3f1fff5a6a'],201,91,292,31740604,17,0.078431373,0,0,31506
4a344dba2c4ae7ae6ded5f3b28c37a43081df1c7,1,Andrii Tkach,2018-04-12 18:34:14+03:00,['c7a83ae3ffbe8d7d573639fae0d6f3f6be3dea65'],14,10,24,31740628,4,,,,31506
7e174817e8edc3e9c48893c010928814a7a47b24,0,GitHub,2018-04-12 18:54:19+03:00,"['4a344dba2c4ae7ae6ded5f3b28c37a43081df1c7', 'b6a3bbc5627ecd4077330f9aff9d2be3d559b937']",0,7,7,31740635,2,,,,31506
b7f48618c055963891b608bd73799870b095df10,1,GitHub,2018-04-12 18:03:03+02:00,['7e174817e8edc3e9c48893c010928814a7a47b24'],10,12,22,31740657,3,1,1,1,31506
ad6c7b0ee632d8d5d78150aaea8bb738065aba12,0,Siddharth,2018-04-12 09:03:45-07:00,['b7f48618c055963891b608bd73799870b095df10'],281,2550,2831,31743488,4,0.754385965,0.543859649,1,31507
59eeafe28eaeff7f07b84e8f3957ebb3780e9d13,0,Robert Levas,2018-04-12 12:30:21-04:00,['ad6c7b0ee632d8d5d78150aaea8bb738065aba12'],16,55,71,31743559,5,0.904761905,1,1,31507
81a6957a7a48f1d664e357142e82708d5a745e8e,1,Aleksandr Kovalenko,2018-04-12 19:32:30+03:00,['59eeafe28eaeff7f07b84e8f3957ebb3780e9d13'],10,40,50,31743609,2,0,1,1,31507
81224a3608e1f6db1138992d9c16ba9ebda5975b,0,aonishuk,2018-04-12 20:12:21+03:00,['81a6957a7a48f1d664e357142e82708d5a745e8e'],20,31,51,31743660,1,0,0,0,31507
9c5e834303ea28a12cbe1c7238148b402a74811e,1,GitHub,2018-04-12 20:20:54+02:00,['81224a3608e1f6db1138992d9c16ba9ebda5975b'],1,2,3,31743663,1,,,,31507
5ab00009037ff820d312a747547226225d6b5911,0,avijayanhwx,2018-04-12 12:43:22-07:00,['9c5e834303ea28a12cbe1c7238148b402a74811e'],33,34,67,31743730,6,0,0,0.4,31507
6804d3558a149c94a3ce796fccf02a181cac7cf6,0,avijayanhwx,2018-04-12 12:43:22-07:00,['5ab00009037ff820d312a747547226225d6b5911'],106,257,363,31744093,8,0,0.691489362,0.787234043,31507
70c42f560032bf9f7f03c3ee74194c4b1f99a5c5,0,Siddharth,2018-04-12 15:44:58-07:00,['6804d3558a149c94a3ce796fccf02a181cac7cf6'],0,28,28,31744121,1,0,0,0,31507
73e7362ce6bf0eb58b27a06a998e625b1e85ac55,0,Eugene Chekanskiy,2018-04-13 13:18:01+03:00,['70c42f560032bf9f7f03c3ee74194c4b1f99a5c5'],1,2,3,31744124,1,,,,31507
fff9b2b2dc801a24135ba8ee2bbf5a988949aba6,0,Miklos Gergely,2018-04-13 14:30:47+02:00,['73e7362ce6bf0eb58b27a06a998e625b1e85ac55'],1,1,2,31744126,1,,,,31507
7a7ecdd901a9fae81d8c706ba37738743ae8f3fe,1,GitHub,2018-04-13 15:17:05+02:00,['fff9b2b2dc801a24135ba8ee2bbf5a988949aba6'],18,60,78,31744204,10,0.642857143,1,1,31507
3461d5c3e571b0f9c87f2dfbcdb68323fe2f0a1f,1,GitHub,2018-04-13 18:16:55+02:00,['7a7ecdd901a9fae81d8c706ba37738743ae8f3fe'],162,12,174,31744378,10,,,,31507
306aa18076268593177877ede7c4871ac923b663,0,GitHub,2018-04-13 23:27:00+02:00,['3461d5c3e571b0f9c87f2dfbcdb68323fe2f0a1f'],1,1,2,31744380,1,,,,31507
009972da577413fcca336354b7ed96b27c72f8cc,1,GitHub,2018-04-13 23:32:03+02:00,['306aa18076268593177877ede7c4871ac923b663'],4,4,8,31744388,2,,,,31507
d0dd4b31a0a0b2f59ebcca410f4220620cf2bd74,0,GitHub,2018-04-15 22:36:40+02:00,['009972da577413fcca336354b7ed96b27c72f8cc'],0,1,1,31744389,1,1,1,1,31507
a244d6af84340d038029405466f9c4e3c65f1afd,0,Myroslav Papirkovskyi,2018-04-16 11:57:37+03:00,['d0dd4b31a0a0b2f59ebcca410f4220620cf2bd74'],40,1,41,31744430,1,0.066666667,0.066666667,0.066666667,31507
73871e999c08831a50da9e1e937a5b85472f8daa,0,Myroslav Papirkovskyi,2018-04-16 12:17:18+03:00,['a244d6af84340d038029405466f9c4e3c65f1afd'],0,80,80,31744510,2,0,0.912280702,0.912280702,31507
26cd3cba0880d070a329d9c87345ba160363acfa,1,aBabiichuk,2018-04-16 12:52:13+03:00,['73871e999c08831a50da9e1e937a5b85472f8daa'],12,43,55,31744565,9,,,,31507
22f92e3bfda82826275d266d3f4cb919c00f13e2,1,aBabiichuk,2018-04-16 12:53:50+03:00,['26cd3cba0880d070a329d9c87345ba160363acfa'],38,105,143,31744708,14,0.105263158,1,1,31507
a61386c9acaa0485567be5c3fe17d697c4ee04af,1,aBabiichuk,2018-04-16 12:54:29+03:00,['22f92e3bfda82826275d266d3f4cb919c00f13e2'],0,2,2,31744710,1,,,,31507
8f889e9a0fdf5435408bc9ebea9a280bdd806f15,1,aonishuk,2018-04-16 12:59:54+03:00,['a61386c9acaa0485567be5c3fe17d697c4ee04af'],161,79,240,31744950,4,1,0,0.440677966,31507
4dd0e5292254d10ac4fa00e173771e29d72878a4,1,aonishuk,2018-04-16 12:59:54+03:00,['8f889e9a0fdf5435408bc9ebea9a280bdd806f15'],94,13,107,31745057,2,0.865671642,0.014925373,0.507462687,31507
4123c810df9571c9f9f997940f386b59004ad0fd,1,aonishuk,2018-04-16 12:59:54+03:00,['4dd0e5292254d10ac4fa00e173771e29d72878a4'],110,4,114,31745171,3,1,0,1,31507
867b3b9d989e0c8e385fd35eabb245aff20527cb,0,aonishuk,2018-04-16 12:59:54+03:00,['4123c810df9571c9f9f997940f386b59004ad0fd'],5,17,22,31745193,1,0,1,0,31507
e42b01af51c0816b91a7335e5c849b731fa71bd5,0,aonishuk,2018-04-16 12:59:54+03:00,['867b3b9d989e0c8e385fd35eabb245aff20527cb'],17,5,22,31745215,1,1,0,1,31507
589bc8bb7bb4d30bc86ba8298940ff747faa8a35,0,aonishuk,2018-04-16 12:59:54+03:00,['e42b01af51c0816b91a7335e5c849b731fa71bd5'],1,1,2,31745217,1,,,,31507
9f5a8e888b8e06b93730bb630d1f36e7eb275804,1,Aleksandr Kovalenko,2018-04-16 13:05:41+03:00,['589bc8bb7bb4d30bc86ba8298940ff747faa8a35'],41,22,63,31745280,2,1,0,0,31507
867f4dc61831a328272781444d83628b5ded0566,0,aBabiichuk,2018-04-16 13:30:50+03:00,['9f5a8e888b8e06b93730bb630d1f36e7eb275804'],3,10,13,31745293,2,0,0.857142857,1,31507
08092add65e0e4fe731bc1ad41be3dfffb5fec08,0,Andrii Tkach,2018-04-16 13:38:57+03:00,['867f4dc61831a328272781444d83628b5ded0566'],62,1,63,31745356,2,0.016393443,0,0,31507
113d4fdf1ea8b10aa46c81e05c3e7525503ed4ec,1,Andrii Tkach,2018-04-16 13:40:26+03:00,['08092add65e0e4fe731bc1ad41be3dfffb5fec08'],14,21,35,31745391,4,,,,31507
80fd0a3d18d280c8f8f9a2245676e15b0d103535,0,Andrii Tkach,2018-04-16 13:43:39+03:00,['113d4fdf1ea8b10aa46c81e05c3e7525503ed4ec'],8,56,64,31745455,5,0.994382022,0.938202247,0.797752809,31508
54d0f68c053e8e5efd67721a79a2f47262e3e7b0,0,Andrii Tkach,2018-04-16 13:45:34+03:00,['80fd0a3d18d280c8f8f9a2245676e15b0d103535'],4,7,11,31745466,2,0.333333333,1,1,31508
869f51a6b190e86d1c65324b9c8be9b1ff8de4c0,0,aonishuk,2018-04-16 14:25:29+03:00,['54d0f68c053e8e5efd67721a79a2f47262e3e7b0'],0,1,1,31745467,1,,,,31508
ba2d0287401352982f1e8493f8276a9f9d2c481c,0,"Doroszlai, Attila",2018-04-16 13:40:17+02:00,['869f51a6b190e86d1c65324b9c8be9b1ff8de4c0'],2,4,6,31745473,2,,,,31508
4f514e8361e813ae50a1e9503753650b14d0b8b1,1,aBabiichuk,2018-04-16 15:38:57+03:00,['ba2d0287401352982f1e8493f8276a9f9d2c481c'],45,190,235,31745708,13,0.466666667,1,1,31509
a044354cb7a0523b3d7e5d082411425b4bbbe70f,1,avijayanhwx,2018-04-16 05:43:54-07:00,['4f514e8361e813ae50a1e9503753650b14d0b8b1'],19,29,48,31745756,5,0,0,1,31509
1586c740503b1d57e939937ea6a492052a260987,0,avijayanhwx,2018-04-16 05:44:58-07:00,['a044354cb7a0523b3d7e5d082411425b4bbbe70f'],4,14,18,31745774,2,,,,31509
27a6dc676d57f59fc204da0c8be0e236e115fb9e,0,avijayanhwx,2018-04-16 05:49:23-07:00,['1586c740503b1d57e939937ea6a492052a260987'],1,1,2,31745776,1,,,,31509
4f0fbd200796ce521499bd89b3bfb0c6470bb80c,1,GitHub,2018-04-16 10:08:21-04:00,['27a6dc676d57f59fc204da0c8be0e236e115fb9e'],16,227,243,31746019,2,0.118518519,0.955555556,0.948148148,31509
629e79d72594d3fb46a9667955e6d0d85facf210,0,GitHub,2018-04-16 20:40:38+05:18,['4f0fbd200796ce521499bd89b3bfb0c6470bb80c'],4,24,28,31746047,2,1,1,1,31509
2eea69aca7015cf1c5361aaa66994bbb93eb3583,0,avijayanhwx,2018-04-16 15:37:50-07:00,['629e79d72594d3fb46a9667955e6d0d85facf210'],184,159,343,31746390,8,0,0,1,31509
f24f152782c31b8c5757cbd88ce4d317dad7069d,1,GitHub,2018-04-16 22:57:38-04:00,['2eea69aca7015cf1c5361aaa66994bbb93eb3583'],110,240,350,31746740,3,1,0,0.020833333,31509
c37a7399c2b5d873af3dff56ecf8cd416a4684ec,0,avijayanhwx,2018-04-16 20:29:58-07:00,['f24f152782c31b8c5757cbd88ce4d317dad7069d'],36,34,70,31746810,6,1,1,0.6,31509
cc50a36f70030d70bb9ed43163d5b9e33fda465d,0,Robert Levas,2018-04-17 08:22:39-04:00,['c37a7399c2b5d873af3dff56ecf8cd416a4684ec'],1,2,3,31746813,1,,,,31509
7b6e6977116bb4fa0bfb5500fcaf4802569c3355,1,aBabiichuk,2018-04-17 16:42:36+03:00,['cc50a36f70030d70bb9ed43163d5b9e33fda465d'],31,33,64,31746877,6,0,0,0,31509
8d5fa7e5a7bac225262ca42ec23d56c01fa8d3da,0,Alex Antonenko,2018-04-17 17:08:44+03:00,['c37a7399c2b5d873af3dff56ecf8cd416a4684ec'],0,2,2,31746879,1,1,1,1,31509
7c288ec29fc75abe510f989c178007ad5ade38b2,1,Alex Antonenko,2018-04-17 17:24:57+03:00,['c37a7399c2b5d873af3dff56ecf8cd416a4684ec'],2,1,3,31746882,1,,,,31509
7195242738c5d55a1632a11a46ee7f126147148a,0,GitHub,2018-04-17 16:54:06+02:00,['7b6e6977116bb4fa0bfb5500fcaf4802569c3355'],60,107,167,31747049,4,1,1,1,31509
54b3106d0b30e97c7c12c592f428be0ac7e7928a,0,Aleksandr Kovalenko,2018-04-17 18:59:34+03:00,['7195242738c5d55a1632a11a46ee7f126147148a'],12,9,21,31747070,3,0,0,0,31509
dcf5b849e3845d7b161791db31908b9d1bb7cadf,0,aBabiichuk,2018-04-18 00:37:09+03:00,['54b3106d0b30e97c7c12c592f428be0ac7e7928a'],34,43,77,31747147,10,1,0,0,31509
ae2e31ea221f68c971bce0d5c467ab8a9b038b59,1,Aleksandr Kovalenko,2018-04-18 01:13:56+03:00,['dcf5b849e3845d7b161791db31908b9d1bb7cadf'],10,16,26,31747173,2,1,1,1,31509
f3fcffbf47749d20b9071fddc37faff5d1281e83,1,Jonathan Hurley,2018-04-17 20:05:38-04:00,['ae2e31ea221f68c971bce0d5c467ab8a9b038b59'],95,71,166,31747339,9,1,1,1,31509
c8679192b71f86604bd029eb22bedea6eeabb8df,0,Myroslav Papirkovskyi,2018-04-18 13:24:19+03:00,['f3fcffbf47749d20b9071fddc37faff5d1281e83'],4,13,17,31747356,2,0.2,1,1,31509
3768684499a58b2f9d2be3738a7c4782a8d4b0f2,1,aonishuk,2018-04-18 14:48:36+03:00,['c8679192b71f86604bd029eb22bedea6eeabb8df'],87,80,167,31747523,55,1,0,1,31509
5f6c403e9bd4203175b45d1702d640b78604b02d,0,aBabiichuk,2018-04-18 15:04:56+03:00,['3768684499a58b2f9d2be3738a7c4782a8d4b0f2'],1,1,2,31747525,1,,,,31509
415232a37120e40df29ed2f39ef16b06e122fb16,0,GitHub,2018-04-18 15:07:04+03:00,"['5f6c403e9bd4203175b45d1702d640b78604b02d', '7c288ec29fc75abe510f989c178007ad5ade38b2']",2,1,3,31747528,1,,,,31509
efa3ed3855158de066859d66e53d51bd22048f7f,0,GitHub,2018-04-18 15:10:01+03:00,"['415232a37120e40df29ed2f39ef16b06e122fb16', '8d5fa7e5a7bac225262ca42ec23d56c01fa8d3da']",0,2,2,31747530,1,,,,31509
725d35d21e47222bfdbb357fe2b42e02ce75a580,1,avijayanhwx,2018-04-18 10:02:07-07:00,['efa3ed3855158de066859d66e53d51bd22048f7f'],1108,1120,2228,31749758,161,0.029411765,0.514705882,1,31509
c29159a97646cc0a6019bbf2b3a3620c76da5789,1,avijayanhwx,2018-04-18 10:02:07-07:00,['725d35d21e47222bfdbb357fe2b42e02ce75a580'],35,69,104,31749862,10,,,,31509
cb8e8d5a8f6025f940db03b47cec502a7b9cb1a5,0,GitHub,2018-04-18 20:32:10+02:00,['c29159a97646cc0a6019bbf2b3a3620c76da5789'],1,35,36,31749898,2,1,1,1,31510
a105455bef20098f6d6e0eb5a7ee84ed4ce1d3a8,0,Siddharth,2018-04-18 14:04:35-07:00,['cb8e8d5a8f6025f940db03b47cec502a7b9cb1a5'],0,3,3,31749901,1,,,,31510
d34a5a72b5b42b0f643cf2077c82120df7a988a6,1,aBabiichuk,2018-04-19 00:32:11+03:00,['a105455bef20098f6d6e0eb5a7ee84ed4ce1d3a8'],2,16,18,31749919,1,0,1,1,31510
71816bcb82a09e548436425c5f4e48941975d355,1,avijayanhwx,2018-04-18 19:57:59-07:00,['d34a5a72b5b42b0f643cf2077c82120df7a988a6'],242,141,383,31750302,8,1,0.234567901,0.24691358,31510
e6cd5b11e6bfd0f25571495820b8eeabddccd642,1,avijayanhwx,2018-04-18 21:20:29-07:00,['71816bcb82a09e548436425c5f4e48941975d355'],16,21,37,31750339,4,0,0.8,0.8,31510
e9373fb73cffc683e5b896b2620318896e154aa5,1,Dmitry Sen,2018-04-19 10:58:15+03:00,['e6cd5b11e6bfd0f25571495820b8eeabddccd642'],6,129,135,31750474,7,0.431034483,0.793103448,0.879310345,31511
edc9e341b324e8c5ff6b58c40ada098265e819cf,0,aonishuk,2018-04-19 14:47:46+03:00,['e9373fb73cffc683e5b896b2620318896e154aa5'],5,9,14,31750488,1,0,0,1,31511
2df67cca2a8193b346e08ae24b7ebbfcac1faae0,1,Andrii Tkach,2018-04-19 15:15:15+03:00,['edc9e341b324e8c5ff6b58c40ada098265e819cf'],382,273,655,31751143,19,0.03030303,0,0.363636364,31511
e5fbff1ca1759303350cb099c0e08dbfc9ad2694,0,Andrii Tkach,2018-04-19 15:15:15+03:00,['2df67cca2a8193b346e08ae24b7ebbfcac1faae0'],1,13,14,31751157,2,1,1,1,31511
ec2c4d8410e571181930fb6d421ecc0723882057,0,Andrii Tkach,2018-04-19 15:17:00+03:00,['e5fbff1ca1759303350cb099c0e08dbfc9ad2694'],3,29,32,31751189,3,1,1,1,31511
3ecdc55e9031e3c7a22e5c8479dd0d976e6d0f86,1,GitHub,2018-04-19 10:01:23-04:00,['ec2c4d8410e571181930fb6d421ecc0723882057'],2,4,6,31751195,2,,,,31511
ba010cfa0c7813a6bf2730b95192d6d705e171b8,1,GitHub,2018-04-19 16:14:28+02:00,['3ecdc55e9031e3c7a22e5c8479dd0d976e6d0f86'],408,491,899,31752094,12,1,1,0,31514
8c034016d87135602dfc29e8139334cc4b20ee92,0,aBabiichuk,2018-04-19 17:50:48+03:00,['ba010cfa0c7813a6bf2730b95192d6d705e171b8'],1,17,18,31752112,1,1,1,0.066666667,31514
7887a2f11312c9ac796c4a0c1946a2e89deeedab,0,Robert Levas,2018-04-19 12:44:42-04:00,['8c034016d87135602dfc29e8139334cc4b20ee92'],7,8,15,31752127,2,,,,31514
5a6ef2404fa4d08bc389209f6d2a2120f1ec56e1,1,Myroslav Papirkovskyi,2018-04-19 20:23:19+03:00,['7887a2f11312c9ac796c4a0c1946a2e89deeedab'],6,6,12,31752139,6,,,,31514
ee8322485add35d97335ae4c9235d2c177d5af31,0,Ishan Bhatt,2018-04-19 14:57:59-04:00,['5a6ef2404fa4d08bc389209f6d2a2120f1ec56e1'],1,1,2,31752141,1,,,,31514
62941f89e34ca639f882ab6466174d2cc213d391,1,"Doroszlai, Attila",2018-04-19 21:16:13+02:00,['ee8322485add35d97335ae4c9235d2c177d5af31'],8,16,24,31752165,3,0.5,1,1,31514
94872baffa4861453a8ac68dd9591f47994a944b,0,aBabiichuk,2018-04-19 23:24:52+03:00,['62941f89e34ca639f882ab6466174d2cc213d391'],0,3,3,31752168,2,,,,31514
391de63db4e9e35f857bee77de0a17d4a7c3d898,0,Siddharth,2018-04-19 23:52:38-07:00,['94872baffa4861453a8ac68dd9591f47994a944b'],31,26,57,31752225,4,1,1,0,31514
55faaed088a02740c692e3d4357deeef87f8790c,0,Andrii Tkach,2018-04-20 12:35:16+03:00,['391de63db4e9e35f857bee77de0a17d4a7c3d898'],8,41,49,31752274,3,1,1,1,31514
0ad7020642873208d4569b62d9e90a120ba6675a,1,aonishuk,2018-04-20 13:05:50+03:00,['55faaed088a02740c692e3d4357deeef87f8790c'],6,25,31,31752305,4,1,1,1,31514
82243a300ad3e1ae911d8333bbc354c53bb00e08,1,aBabiichuk,2018-04-20 15:25:03+03:00,['0ad7020642873208d4569b62d9e90a120ba6675a'],20,33,53,31752358,4,1,1,1,31514
034199d2d3fc8a838e33091cdae4a338f590bfd0,0,Robert Levas,2018-04-20 09:56:04-04:00,['82243a300ad3e1ae911d8333bbc354c53bb00e08'],61,131,192,31752550,3,0,0.216666667,0.333333333,31514
658c93dc66f2d91d7b701ae92ca1cc8ff48395e7,1,Aleksandr Kovalenko,2018-04-20 19:15:54+03:00,['034199d2d3fc8a838e33091cdae4a338f590bfd0'],131,138,269,31752819,3,0.84,1,1,31514
dcdcb03d765e33855034da2e40134f991788c162,1,GitHub,2018-04-21 14:06:16+02:00,['658c93dc66f2d91d7b701ae92ca1cc8ff48395e7'],0,2,2,31752821,1,,,,31514
86078c0d43bec5a28d13f632aabdd0b6aa4de347,1,Oliver Szabo,2018-04-21 15:42:26+02:00,['dcdcb03d765e33855034da2e40134f991788c162'],25,25,50,31752871,20,,,,31514
1bf6771ff81830322f809d4462370c3a353d35ee,1,Oliver Szabo,2018-04-21 15:42:52+02:00,['86078c0d43bec5a28d13f632aabdd0b6aa4de347'],17,17,34,31752905,4,,,,31514
87e8daa4b7df3b0b5fb25b0cf55a8fdc33e22685,1,Oliver Szabo,2018-04-21 15:45:31+02:00,['1bf6771ff81830322f809d4462370c3a353d35ee'],2,2,4,31752909,2,,,,31514
873c84b12ac4a2d3b98b5d083219e05b39018559,0,GitHub,2018-04-21 18:37:43+02:00,"['dcdcb03d765e33855034da2e40134f991788c162', '87e8daa4b7df3b0b5fb25b0cf55a8fdc33e22685']",44,44,88,31752997,24,,,,31514
baff299f3902b8e9e160616d2a935bed11f0b04d,1,GitHub,2018-04-23 11:20:41+02:00,['873c84b12ac4a2d3b98b5d083219e05b39018559'],3,3,6,31753003,3,,,,31514
92630b7dfdc50f243da8db2184e372b6a0a0ec5f,0,GitHub,2018-04-23 12:42:22+02:00,['baff299f3902b8e9e160616d2a935bed11f0b04d'],2,2,4,31753007,2,,,,31514
abb0a05a104ceb534b2866c508dee38b7caf2737,0,aBabiichuk,2018-04-23 13:55:12+03:00,['92630b7dfdc50f243da8db2184e372b6a0a0ec5f'],2,2,4,31753011,2,,,,31514
4b22a9b1642097bcaec1f69b1d7cc30fcea7f508,0,aBabiichuk,2018-04-23 14:35:55+03:00,['abb0a05a104ceb534b2866c508dee38b7caf2737'],0,4,4,31753015,1,0,1,1,31514
f9429ae6868beb3cd51659cda4ce5c1f5741fea4,1,aBabiichuk,2018-04-23 14:47:17+03:00,['4b22a9b1642097bcaec1f69b1d7cc30fcea7f508'],33,138,171,31753186,13,1,0.657142857,0.828571429,31515
b22d22c556f50d58ac597a7636f4d3dd9bd192aa,1,aonishuk,2018-04-23 14:51:23+03:00,['f9429ae6868beb3cd51659cda4ce5c1f5741fea4'],24,60,84,31753270,7,0,0.346153846,0.538461538,31515
18704c5ed953aed118b2958879ae16775df59522,0,GitHub,2018-04-24 14:34:59+02:00,['b22d22c556f50d58ac597a7636f4d3dd9bd192aa'],3,134,137,31753407,3,1,1,0.595744681,31517
c9d9f03493a81572d7234447d10f57815d4fc870,0,Attila Magyar,2018-04-24 15:04:45+02:00,['18704c5ed953aed118b2958879ae16775df59522'],0,48,48,31753455,1,1,1,1,31517
7c3ccc146f096a641de5487d3e319ff845b17d56,1,Alex Antonenko,2018-04-24 17:45:26+03:00,['b22d22c556f50d58ac597a7636f4d3dd9bd192aa'],12,18,30,31753485,2,0,1,0,31517
c34212027a41f01e4e292d4c742053c663176639,1,GitHub,2018-04-24 18:11:17+03:00,['c9d9f03493a81572d7234447d10f57815d4fc870'],88,130,218,31753703,7,1,1,1,31517
906196b2568f21eb0ad18cc51f71f9c3006627bf,0,GitHub,2018-04-24 12:34:10-04:00,['c34212027a41f01e4e292d4c742053c663176639'],469,492,961,31754664,159,1,1,1,31517
a0643687a337925f991a1a6c5933b93513373244,1,GitHub,2018-04-24 22:18:25+03:00,['906196b2568f21eb0ad18cc51f71f9c3006627bf'],1,45,46,31754710,2,0,0.296296296,0.925925926,31517
eecb012d618fb2865977cfff385be6218f633b17,0,Vivek Ratnavel Subramanian,2018-04-24 23:19:17-07:00,['a0643687a337925f991a1a6c5933b93513373244'],6,8,14,31754724,1,1,1,1,31517
f34c285755419d1b93ee5959299b3babdd45eb09,1,GitHub,2018-04-25 11:51:24+02:00,['eecb012d618fb2865977cfff385be6218f633b17'],2,12,14,31754738,3,,,,31517
36fbc78de9a10810dca37ba4594d3ced2f7f6773,1,Oliver Szabo,2018-04-25 13:07:51+02:00,['f34c285755419d1b93ee5959299b3babdd45eb09'],2,2,4,31754742,1,,,,31517
b859302c4d895253de8eef7ae5d9940d81824a7b,1,GitHub,2018-04-25 13:19:28+02:00,['36fbc78de9a10810dca37ba4594d3ced2f7f6773'],4,42,46,31754788,2,,,,31517
f5de3f2a0d5d683e63d64ee3fa7abb61b74428c6,0,aonishuk,2018-04-25 14:25:08+03:00,['b859302c4d895253de8eef7ae5d9940d81824a7b'],2,2,4,31754792,2,,,,31517
33e536d0763d37656ab99ff81b2709df86572c1a,0,Andrii Tkach,2018-04-25 15:22:50+03:00,['f5de3f2a0d5d683e63d64ee3fa7abb61b74428c6'],83,77,160,31754952,7,1,1,1,31517
aea4d7a0244a38ca978a39642e3ffec8679c8049,1,Andrii Tkach,2018-04-25 15:24:11+03:00,['33e536d0763d37656ab99ff81b2709df86572c1a'],0,1,1,31754953,1,,,,31517
8d455f495d6f7d36e6d4485fa2199967bf9a145f,1,Andrii Tkach,2018-04-25 15:27:16+03:00,['aea4d7a0244a38ca978a39642e3ffec8679c8049'],16,7,23,31754976,2,0,0,0,31517
30b0db04da6769b2a96c4b9c1c6cc3725ed4da26,0,Dmytro Grinenko,2018-04-25 15:47:11+03:00,['8d455f495d6f7d36e6d4485fa2199967bf9a145f'],2,5,7,31754983,1,1,0.5,0,31517
094a06e77420097bc6927e7e3a85c2fe25c5e9f5,0,"Doroszlai, Attila",2018-04-25 14:57:03+02:00,['30b0db04da6769b2a96c4b9c1c6cc3725ed4da26'],4,4,8,31754991,4,,,,31517
5014752a75661946919f89479e3d62f9031d4ebe,1,Oliver Szabo,2018-04-25 15:00:26+02:00,['094a06e77420097bc6927e7e3a85c2fe25c5e9f5'],87,97,184,31755175,3,,,,31517
720aced49ab71ed7e3337aff25a63275a6d82e6a,1,Oliver Szabo,2018-04-25 16:14:22+02:00,['5014752a75661946919f89479e3d62f9031d4ebe'],0,32,32,31755207,2,,,,31517
b6b13615d0de44bb08fba2cab21836844edc036f,1,aBabiichuk,2018-04-25 19:15:01+03:00,['720aced49ab71ed7e3337aff25a63275a6d82e6a'],71,141,212,31755419,16,0.56097561,0.365853659,0.804878049,31517
a9c8b07181811395abda05cd1ecb523a9ced45ee,1,aBabiichuk,2018-04-25 19:46:01+03:00,['b6b13615d0de44bb08fba2cab21836844edc036f'],9,20,29,31755448,2,,,,31517
b7ce02fde87206d1562ab3d1243f7bf3e7dbb3fe,0,GitHub,2018-04-25 21:55:07+03:00,['a9c8b07181811395abda05cd1ecb523a9ced45ee'],1,5,6,31755454,2,1,1,1,31517
25c83cd577b20ff86725941cd7af870c61949e92,0,GitHub,2018-04-25 23:10:27+02:00,['b7ce02fde87206d1562ab3d1243f7bf3e7dbb3fe'],29,39,68,31755522,3,0.25,1,1,31517
5cc76a8604c6ef8edb1c2c5f42b139d65913a0e7,0,Siddharth,2018-04-25 22:35:03-07:00,['25c83cd577b20ff86725941cd7af870c61949e92'],6,14,20,31755542,5,,,,31517
7135087c0fc07233fdd50d48529b9cf65b0b8e49,0,GitHub,2018-04-26 09:54:05+03:00,"['5cc76a8604c6ef8edb1c2c5f42b139d65913a0e7', '7c3ccc146f096a641de5487d3e319ff845b17d56']",12,18,30,31755572,2,,,,31517
55506302cf524b8a38ae91802564293abe85a1e9,0,hiveww,2018-04-26 10:58:50+03:00,['7135087c0fc07233fdd50d48529b9cf65b0b8e49'],7,13,20,31755592,1,,,,31517
7c36855d73cf6c7ee46bdd2c4df883b6012695d0,0,aonishuk,2018-04-26 13:53:04+03:00,['7135087c0fc07233fdd50d48529b9cf65b0b8e49'],14,42,56,31755648,6,0,0.8,0.7,31517
3f155ae9fc9386923a95dc09e128d324daa3df19,1,hiveww,2018-04-26 15:03:12+03:00,['7135087c0fc07233fdd50d48529b9cf65b0b8e49'],6,15,21,31755669,4,1,1,1,31517
fd3784a5ddff6e2e2d3557a0b02cc64406e3205a,0,GitHub,2018-04-26 15:07:03+03:00,"['7c36855d73cf6c7ee46bdd2c4df883b6012695d0', '55506302cf524b8a38ae91802564293abe85a1e9']",7,13,20,31755689,1,,,,31517
9d2f3c6ac80cecc3cf2a93730932db1eb8b7b005,0,GitHub,2018-04-26 15:42:53+02:00,['fd3784a5ddff6e2e2d3557a0b02cc64406e3205a'],3,3,6,31755695,1,,,,31517
1e15cda11647e2a6cce062654f9aede35d1782ca,0,GitHub,2018-04-26 15:43:52+02:00,['9d2f3c6ac80cecc3cf2a93730932db1eb8b7b005'],99,262,361,31756056,15,0.393442623,0.344262295,0.786885246,31518
cbf69a8b3066c0a4ecbdf21e753ed1eb22494a3e,0,aBabiichuk,2018-04-26 17:47:38+03:00,['1e15cda11647e2a6cce062654f9aede35d1782ca'],12,14,26,31756082,2,,,,31518
f269232151bccfe4a25db879a83cb3a8533fc5f1,1,Siddharth,2018-04-26 11:12:24-07:00,['cbf69a8b3066c0a4ecbdf21e753ed1eb22494a3e'],0,1,1,31756083,1,,,,31518
2aa5e0798696f60317354c6b0414cf7dfa14d537,1,Attila Magyar,2018-04-26 20:14:31+02:00,['f269232151bccfe4a25db879a83cb3a8533fc5f1'],1,22,23,31756106,2,,,,31518
1f9c546e4aea8b6d22ea2569b3767ac6f77421df,0,avijayanhwx,2018-04-26 14:28:29-07:00,['2aa5e0798696f60317354c6b0414cf7dfa14d537'],1,1,2,31756108,1,,,,31518
103a11f936f53206a858911a7732045953e243cb,1,Oliver Szabo,2018-04-27 10:05:03+02:00,['1f9c546e4aea8b6d22ea2569b3767ac6f77421df'],0,5,5,31756113,1,,,,31518
0e111d8c91a5c620a09724108ac43fedd634e8bb,1,Oliver Szabo,2018-04-27 10:13:18+02:00,['103a11f936f53206a858911a7732045953e243cb'],1,1,2,31756115,1,,,,31518
ebb00c40d53f358f14f6bfa801169148fd079453,0,GitHub,2018-04-27 10:28:31+02:00,['0e111d8c91a5c620a09724108ac43fedd634e8bb'],2,6,8,31756123,1,0,1,1,31518
5f1ad26a7f987fa12f72c7750c78697157e8cbb4,0,GitHub,2018-04-27 12:28:29+03:00,"['ebb00c40d53f358f14f6bfa801169148fd079453', '3f155ae9fc9386923a95dc09e128d324daa3df19']",6,15,21,31756144,4,,,,31518
bab87d1e010bdc1e196ef23c4dd006c4c79fb767,1,Aleksandr Kovalenko,2018-04-27 13:34:04+03:00,['5f1ad26a7f987fa12f72c7750c78697157e8cbb4'],159,159,318,31756462,4,1,1,1,31518
a890b8ce28c736410225349c25ec8f613929b6dc,1,Andrii Tkach,2018-04-27 14:03:01+03:00,['bab87d1e010bdc1e196ef23c4dd006c4c79fb767'],6,76,82,31756544,3,0.309859155,1,1,31518
984bd4e2b603a8acf928b2c6359bb702b9f93cc8,0,Andrii Tkach,2018-04-27 14:04:35+03:00,['a890b8ce28c736410225349c25ec8f613929b6dc'],3,6,9,31756553,1,0,0,0,31518
14c55d316969e4777730b9bfcfa8f9b8e17032d7,0,aBabiichuk,2018-04-27 14:45:04+03:00,['984bd4e2b603a8acf928b2c6359bb702b9f93cc8'],15,18,33,31756586,2,0,0,0,31518
7765c69ea225b23a152928150e39825a57cabcef,0,Andrii Tkach,2018-04-27 15:22:30+03:00,['14c55d316969e4777730b9bfcfa8f9b8e17032d7'],25,31,56,31756642,8,,,,31518
04a3e0989c0cf02312a6503be079019d785b8be2,1,GitHub,2018-04-27 15:52:57+02:00,['7765c69ea225b23a152928150e39825a57cabcef'],2,2,4,31756646,1,,,,31518
a9d17d69415953a061fa4a10be63eda1e8ba1c52,1,GitHub,2018-04-27 15:56:45+02:00,['04a3e0989c0cf02312a6503be079019d785b8be2'],5,5,10,31756656,1,,,,31518
76d4e315158f144ff6bf138d8056aed59363d4c6,0,Dmytro Grinenko,2018-04-27 16:59:04+03:00,['a9d17d69415953a061fa4a10be63eda1e8ba1c52'],7,13,20,31756676,2,0,0,0.75,31518
9072284052f9906b3f719c4fa669ea32e48c1228,1,Dmitry Sen,2018-04-27 17:29:19+03:00,['76d4e315158f144ff6bf138d8056aed59363d4c6'],3,81,84,31756760,3,0.609756098,0.609756098,1,31518
9732d6d1180bc012473fee55b2126dbc74763109,0,aonishuk,2018-04-27 17:32:20+03:00,['9072284052f9906b3f719c4fa669ea32e48c1228'],25,75,100,31756860,6,0,0.734693878,0.591836735,31518
981f6274197afcd8c524dd755151176816a4548a,0,Yusaku Sako,2018-04-27 08:58:58-07:00,['9732d6d1180bc012473fee55b2126dbc74763109'],0,24,24,31756884,1,,,,31518
1912a19ef0f01fe219c97511798a8aa13034e2c2,0,GitHub,2018-04-27 18:41:42+02:00,['981f6274197afcd8c524dd755151176816a4548a'],3,0,3,31756887,1,,,,31518
f35b1506691ea16fb20350577d6430459d10a9fc,1,GitHub,2018-04-27 21:44:40+02:00,['1912a19ef0f01fe219c97511798a8aa13034e2c2'],13,41,54,31756941,2,0.285714286,1,0.380952381,31518
43cff24fc62604dee9726349e34ff72f83c43cc4,0,GitHub,2018-04-27 23:38:21+03:00,['f35b1506691ea16fb20350577d6430459d10a9fc'],71,212,283,31757224,14,0.182795699,0,1,31518
350086f0889561ab3ae41bc4ca0ebee758db506b,0,GitHub,2018-04-28 08:20:44+02:00,['43cff24fc62604dee9726349e34ff72f83c43cc4'],1,1,2,31757226,1,,,,31518
4851864539833cf07e3bee4cdc554992296aa293,1,GitHub,2018-04-28 08:21:17+02:00,['350086f0889561ab3ae41bc4ca0ebee758db506b'],946,3006,3952,31761178,93,1,1,1,31563
dd046007be89c1c7ad8ccda9e2621ed4fa6bd070,0,aBabiichuk,2018-04-28 10:24:20+03:00,['4851864539833cf07e3bee4cdc554992296aa293'],9,57,66,31761244,2,0.068181818,1,1,31563
2ba8e952e7096f4b004838fe231f095e3a1582aa,0,GitHub,2018-04-28 13:52:58+02:00,['dd046007be89c1c7ad8ccda9e2621ed4fa6bd070'],6,7,13,31761257,1,,,,31563
0fb38a0312d485ccad2ec065c72e69a08c4083ff,0,Aleksandr Kovalenko,2018-04-30 12:33:05+03:00,['2ba8e952e7096f4b004838fe231f095e3a1582aa'],13,16,29,31761286,4,1,1,1,31563
67ff53b6daeeac41476567d1084ac90223999fc7,0,Andrii Tkach,2018-04-30 14:13:31+03:00,['0fb38a0312d485ccad2ec065c72e69a08c4083ff'],12,21,33,31761319,2,1,1,1,31563
12501aab230ecb3d72a5ab1c26f2ebdf3aafd988,0,Andrii Tkach,2018-04-30 14:14:52+03:00,['67ff53b6daeeac41476567d1084ac90223999fc7'],3,29,32,31761351,3,,,,31563
9ccad6359549f03f9e2f4e0b1ca244aaac88e3f6,1,Aleksandr Kovalenko,2018-04-30 19:15:14+03:00,['12501aab230ecb3d72a5ab1c26f2ebdf3aafd988'],11,36,47,31761398,3,1,1,1,31563
b90128bca4e8c47101c95541b500e3753f5b70a5,0,Robert Levas,2018-04-30 12:52:58-04:00,['9ccad6359549f03f9e2f4e0b1ca244aaac88e3f6'],0,541,541,31761939,1,,,,31564
cab73841d296042d549509b419de83ed1d4358fe,0,aBabiichuk,2018-04-30 19:53:15+03:00,['b90128bca4e8c47101c95541b500e3753f5b70a5'],1,5,6,31761945,1,1,0,1,31564
05bc12d4590970017575bb1b51f144219fd055bd,1,GitHub,2018-04-30 12:55:07-04:00,['cab73841d296042d549509b419de83ed1d4358fe'],14,89,103,31762048,9,0.5,1,1,31564
145ff84abf6ea04ff6a6a9596573522f81a4afcd,0,GitHub,2018-04-30 21:33:50+03:00,['05bc12d4590970017575bb1b51f144219fd055bd'],1,11,12,31762060,2,,,,31564
bf55629ce21a7da27778e252e67fd0a3841adc27,1,avijayanhwx,2018-04-30 11:43:03-07:00,['145ff84abf6ea04ff6a6a9596573522f81a4afcd'],212,71,283,31762343,14,0.817204301,1,0,31564
154b3610f75013350990ff4543900a1a19977854,0,GitHub,2018-04-30 12:18:18-07:00,['bf55629ce21a7da27778e252e67fd0a3841adc27'],42,50,92,31762435,2,0,1,1,31564
1834e7a02503d9d47d205726ccac6dacc1a8dfb8,0,GitHub,2018-05-01 13:17:35+02:00,['154b3610f75013350990ff4543900a1a19977854'],0,18,18,31762453,4,,,,31564
5c28f9106cb9e2a88bd9e65ddf75e2aaa7e77ab0,1,GitHub,2018-05-01 11:49:22-04:00,['1834e7a02503d9d47d205726ccac6dacc1a8dfb8'],1,3,4,31762457,3,,,,31564
491a3a07257c97457ed5c05ddbe99bb3788ffcf8,0,"Doroszlai, Attila",2018-05-01 20:35:59+02:00,['5c28f9106cb9e2a88bd9e65ddf75e2aaa7e77ab0'],1301,0,1301,31763758,12,0.565714286,0,0.08,31564
23febb1e9cfa10e26c657f09265ac9bf32e6a4a4,0,GitHub,2018-05-01 15:04:52-04:00,['491a3a07257c97457ed5c05ddbe99bb3788ffcf8'],1,2,3,31763761,1,1,0,1,31564
c49e7704b69b758ec315748b39307fec426f593d,1,Aleksandr Kovalenko,2018-05-02 01:10:58+03:00,['23febb1e9cfa10e26c657f09265ac9bf32e6a4a4'],2,28,30,31763791,2,1,1,1,31564
b99f6655c12a2fe2ef86d29cdf106b4cd5b74e19,0,Swapan Shridhar,2018-05-01 18:50:37-07:00,['c49e7704b69b758ec315748b39307fec426f593d'],25,11,36,31763827,4,,,,31564
fb178d2fa3cdf6f2586648264a1888357dd95a3f,1,Dmytro Grinenko,2018-05-02 09:36:30+03:00,['b99f6655c12a2fe2ef86d29cdf106b4cd5b74e19'],0,9,9,31763836,3,1,1,1,31564
010e4a77ddd640201f01a3f5335acf2ca32e9367,0,Dmytro Grinenko,2018-05-02 09:36:30+03:00,['fb178d2fa3cdf6f2586648264a1888357dd95a3f'],18,63,81,31763917,5,0,0,1,31564
a9ed08134716a41a4feee07f50c8954c306f3117,0,Dmytro Grinenko,2018-05-02 09:36:30+03:00,['010e4a77ddd640201f01a3f5335acf2ca32e9367'],22,23,45,31763962,5,1,,1,31564
1b9055ba05cb9791c8f9239fb442b180c4b8099c,1,Dmytro Grinenko,2018-05-02 09:41:48+03:00,['a9ed08134716a41a4feee07f50c8954c306f3117'],23,22,45,31764007,5,0,,0,31564
caab48040855fa3db8dc2a02a1896b9617266b4f,1,Dmytro Grinenko,2018-05-02 09:41:48+03:00,['1b9055ba05cb9791c8f9239fb442b180c4b8099c'],63,18,81,31764088,5,1,1,0,31564
737dfc7781d06df9072be3f1559229b21c38a1c8,0,Dmytro Grinenko,2018-05-02 09:41:48+03:00,['caab48040855fa3db8dc2a02a1896b9617266b4f'],9,0,9,31764097,3,0,0,0,31564
10e2c58c47b4880c61df46c91ba9fc46a75f4374,0,Dmytro Grinenko,2018-05-02 16:30:00+03:00,['737dfc7781d06df9072be3f1559229b21c38a1c8'],33,88,121,31764218,6,0.090909091,0,1,31564
1ab8001adf30a50bfe76c661d2ae0a66780285cd,1,aBabiichuk,2018-05-02 19:16:33+03:00,['10e2c58c47b4880c61df46c91ba9fc46a75f4374'],205,311,516,31764734,13,1,1,1,31567
ff50198ec18e0be15f2fc2f595a864e2d7cb07a1,0,GitHub,2018-05-02 18:32:25+02:00,['1ab8001adf30a50bfe76c661d2ae0a66780285cd'],4,0,4,31764738,1,,,,31567
751df8dc973f8359e2b77265243e8c5dadeaf88e,0,aBabiichuk,2018-05-02 20:16:36+03:00,['ff50198ec18e0be15f2fc2f595a864e2d7cb07a1'],8,10,18,31764756,2,,,,31567
525923fc7dfd09fae0864a4876b8ca21e2dcaafe,1,avijayanhwx,2018-05-02 16:02:48-07:00,['751df8dc973f8359e2b77265243e8c5dadeaf88e'],830,157547,158377,31923133,51,0.46728972,0.705607477,0.741433022,31572
e6a1dcfa6649ba65a0fe00d7af145be098f8151a,0,avijayanhwx,2018-05-02 16:02:48-07:00,['525923fc7dfd09fae0864a4876b8ca21e2dcaafe'],155553,2,155555,32078688,2,,,,31572
c1a9c7a8eccc896aee005bfc21877d2d4f7d631e,0,avijayanhwx,2018-05-02 16:02:48-07:00,['e6a1dcfa6649ba65a0fe00d7af145be098f8151a'],2,2,4,32078692,1,,,,31572
0b4c4867658a13d722eea849c783d6f761c34fdb,0,avijayanhwx,2018-05-02 16:02:48-07:00,['c1a9c7a8eccc896aee005bfc21877d2d4f7d631e'],0,6,6,32078698,1,0,1,1,31572
ceb3e2503d8f7c4c852d536760232c8440f9d4c2,0,"Doroszlai, Attila",2018-05-03 13:19:23+02:00,['0b4c4867658a13d722eea849c783d6f761c34fdb'],0,5,5,32078703,1,1,1,1,31572
43825aa05c586d3b9fcb8aca695f8c7f6072e5fc,1,Alex Antonenko,2018-05-03 15:05:11+03:00,['0b4c4867658a13d722eea849c783d6f761c34fdb'],13,8,21,32078724,2,0.058823529,0.058823529,0,31572
c640ee6a7059a2cd801ae5a806eacde6982f83f3,0,GitHub,2018-05-03 15:13:31+03:00,['ceb3e2503d8f7c4c852d536760232c8440f9d4c2'],69,199,268,32078992,14,0.197530864,0,1,31572
9b03e87129441b1b2e7d3545f84dd56edbf672c0,1,Alex Antonenko,2018-05-03 15:33:25+03:00,['43825aa05c586d3b9fcb8aca695f8c7f6072e5fc'],3,4,7,32078999,1,,,,31572
2ed2417a5fd800e6e3ddd3e1f98d804c9732b5c7,1,GitHub,2018-05-03 14:37:28+02:00,['c640ee6a7059a2cd801ae5a806eacde6982f83f3'],9,144,153,32079152,3,1,1,1,31573
05bb574fabb1f4ea7ed89584516653a66398f762,0,GitHub,2018-05-03 17:28:27+03:00,"['2ed2417a5fd800e6e3ddd3e1f98d804c9732b5c7', '9b03e87129441b1b2e7d3545f84dd56edbf672c0']",13,9,22,32079174,2,,,,31573
cc72705de9b6274d3043c81285ff6357d9f61509,1,GitHub,2018-05-03 16:57:26+02:00,['05bb574fabb1f4ea7ed89584516653a66398f762'],20,55,75,32079249,3,0,0.769230769,1,31573
dabd25d68f576c3f7d7d8a668a390a7f3f330deb,1,Andrii Tkach,2018-05-03 18:31:24+03:00,['cc72705de9b6274d3043c81285ff6357d9f61509'],223,170,393,32079642,11,0.545454545,0,0,31573
a163bc2216654e95c090a3e4599fa77149884374,0,Andrii Tkach,2018-05-03 18:33:23+03:00,['dabd25d68f576c3f7d7d8a668a390a7f3f330deb'],0,41,41,32079683,3,1,1,1,31573
e7e44aa6e788486f71b371a751cd383966adb109,1,Andrii Tkach,2018-05-03 18:34:38+03:00,['a163bc2216654e95c090a3e4599fa77149884374'],0,15,15,32079698,1,1,1,1,31573
27d5a866d03a87c200d8dc999c87d219e50bf6d8,0,GitHub,2018-05-03 11:59:02-04:00,['e7e44aa6e788486f71b371a751cd383966adb109'],27,140,167,32079865,6,0,0.757142857,1,31573
bd071a0fa4bcb876bf6f4260ef8e5c8666a057d8,1,GitHub,2018-05-03 12:21:19-04:00,['27d5a866d03a87c200d8dc999c87d219e50bf6d8'],12,15,27,32079892,4,0,0,0,31573
eb73b74fa1a23543d33d2405693c0a06cedac2ea,0,Lisnichenko Dmitro,2018-05-03 20:25:49+03:00,['bd071a0fa4bcb876bf6f4260ef8e5c8666a057d8'],7,5,12,32079904,1,1,1,0,31573
2df421a77e66610387db57e6c64136d4f2228725,1,GitHub,2018-05-03 21:28:15+03:00,['bd071a0fa4bcb876bf6f4260ef8e5c8666a057d8'],65,82,147,32080051,7,,,,31573
1beb0c432885dc45e7ac4cef01876f8c04a5a72a,1,Myroslav Papirkovskyi,2018-05-03 22:53:56+03:00,['2df421a77e66610387db57e6c64136d4f2228725'],199,69,268,32080319,14,0.802469136,1,0,31573
8dfe69e9b43ec0d6cf4ad39e1143c120e1402380,1,Olivér Szabó,2018-05-04 12:40:32+02:00,['1beb0c432885dc45e7ac4cef01876f8c04a5a72a'],26,2260,2286,32082605,34,0.649805447,1,0.967574578,31599
6bcefac7720077204057f97bd5571db7529292da,1,GitHub,2018-05-04 14:04:17+03:00,['8dfe69e9b43ec0d6cf4ad39e1143c120e1402380'],12,68,80,32082685,6,0,0.757575758,0.393939394,31599
c07c2caa47d1ec9859fddca086841a5117ba617a,0,Mugdha Varadkar,2018-05-04 17:23:46+05:18,"['7e1c33a681c79bdbe786ecf10fb5bf050ccc6188', '6bcefac7720077204057f97bd5571db7529292da']",11335,22180,33515,32116200,1112,,,,31599
6d547f59c97e5b5e2e50f4c4012c954ecddfcef5,0,Mugdha Varadkar,2018-05-04 17:25:48+05:18,['c07c2caa47d1ec9859fddca086841a5117ba617a'],28,97,125,32116325,2,0,0,0,31599
3eaed629249d11a7d914689c4ffd3a7c3a9917e3,1,GitHub,2018-05-04 15:21:06+03:00,['6bcefac7720077204057f97bd5571db7529292da'],69,202,271,32116596,14,0.19047619,0,1,31599
f6fbad8c79b24f321a224320df31ead500608dd6,1,GitHub,2018-05-04 14:47:33+02:00,['3eaed629249d11a7d914689c4ffd3a7c3a9917e3'],0,33,33,32116629,2,,,,31599
b674486ef961243530bccc549ec16a8329a6c3f5,1,aBabiichuk,2018-05-04 17:36:57+03:00,['f6fbad8c79b24f321a224320df31ead500608dd6'],6,66,72,32116701,6,1,0,1,31600
115f746034ce598757721285e776f82ab0b56324,0,aBabiichuk,2018-05-04 20:29:31+03:00,['b674486ef961243530bccc549ec16a8329a6c3f5'],2,2,4,32116705,2,,,,31600
fcc41f685e7f1ee7aae31e31208e222eaf75bcd0,1,Oliver Szabo,2018-05-04 20:26:59+02:00,['115f746034ce598757721285e776f82ab0b56324'],1,1,2,32116707,1,,,,31600
b0e5419778b3dd95f1f81ca2da1b297e0ad12ef9,1,Robert Levas,2018-05-04 15:21:45-04:00,['fcc41f685e7f1ee7aae31e31208e222eaf75bcd0'],0,22,22,32116729,3,0.8,0.8,1,31600
f5d914501e99d890bc02489e0515cdcc159744f9,1,Oliver Szabo,2018-05-04 22:08:00+02:00,['b0e5419778b3dd95f1f81ca2da1b297e0ad12ef9'],2,2,4,32116733,1,,,,31600
2365c1f290613fb9ccb76ac4b9dd9bcbdc0f8d43,0,GitHub,2018-05-05 00:23:13+02:00,['f5d914501e99d890bc02489e0515cdcc159744f9'],29,97,126,32116859,3,1,1,0.730769231,31601
4c494147b60a36cec1b75c1c77b0e0a03d4450ee,1,Oliver Szabo,2018-05-05 12:14:55+02:00,['2365c1f290613fb9ccb76ac4b9dd9bcbdc0f8d43'],40,43,83,32116942,13,1,1,0.666666667,31601
eec1244109e88fb280f1bd05989ed6edb5198e6a,0,GitHub,2018-05-05 14:42:04-04:00,['4c494147b60a36cec1b75c1c77b0e0a03d4450ee'],6,6,12,32116954,1,,,,31601
004fd249aaa8e52f5659e7cffece61261238ebf3,0,GitHub,2018-05-07 09:50:57+02:00,['eec1244109e88fb280f1bd05989ed6edb5198e6a'],31,70,101,32117055,2,1,1,1,31601
ded5af32d569dbb46ed40d50e1d1313a0078b447,0,GitHub,2018-05-07 09:52:17+02:00,['004fd249aaa8e52f5659e7cffece61261238ebf3'],0,29,29,32117084,2,,,,31602
63979c7423851cf2dacf5d338bb8096a270ebeb5,1,aBabiichuk,2018-05-07 11:14:37+03:00,['ded5af32d569dbb46ed40d50e1d1313a0078b447'],91,134,225,32117309,9,0.333333333,0.777777778,1,31602
b207020be6c5a5bfb2e699606487f6c66b489579,0,GitHub,2018-05-07 10:45:49+02:00,['63979c7423851cf2dacf5d338bb8096a270ebeb5'],4,6,10,32117319,1,0,1,1,31602
01bdcc0a8a90c777598cfca24ff0d3da88f135a6,0,GitHub,2018-05-07 10:58:40+02:00,['b207020be6c5a5bfb2e699606487f6c66b489579'],425,872,1297,32118616,2,0.185185185,1,0.420875421,31602
a72903188ceef841745a15c3085e29ea9397b081,0,Andrii Tkach,2018-05-07 12:48:35+03:00,['01bdcc0a8a90c777598cfca24ff0d3da88f135a6'],5,2,7,32118623,1,,,,31602
12084e810d9b829a32c1bdec625321852bd52257,0,Andrii Tkach,2018-05-07 12:51:24+03:00,['a72903188ceef841745a15c3085e29ea9397b081'],11,14,25,32118648,3,1,1,1,31602
dc078be307e91271d44e29382015b3644ddf1b8f,0,Andrii Tkach,2018-05-07 12:53:58+03:00,['12084e810d9b829a32c1bdec625321852bd52257'],48,84,132,32118780,15,1,1,1,31602
b5659b4b94f8f0b17c0c5debfc9754e417dc253a,0,GitHub,2018-05-07 13:23:23+03:00,"['dc078be307e91271d44e29382015b3644ddf1b8f', 'eb73b74fa1a23543d33d2405693c0a06cedac2ea']",7,5,12,32118792,1,,,,31602
92649ee3783d462e4db714c56cd59d2436dac902,0,GitHub,2018-05-07 16:17:29+03:00,['b5659b4b94f8f0b17c0c5debfc9754e417dc253a'],3,3,6,32118798,1,,,,31602
d3399bdc68b2b124e7ecf29bb1621153e8a1b957,0,GitHub,2018-05-07 16:03:07+02:00,['92649ee3783d462e4db714c56cd59d2436dac902'],1,41,42,32118840,2,,,,31602
e950f088f3d4869d87f538f211a06402895e3fce,1,Aleksandr Kovalenko,2018-05-07 18:19:48+03:00,['d3399bdc68b2b124e7ecf29bb1621153e8a1b957'],9,15,24,32118864,2,1,1,1,31602
3593017e1c34411bbf3971afa047012dd51ddaa3,0,Dmytro Grinenko,2018-05-07 18:48:12+03:00,['e950f088f3d4869d87f538f211a06402895e3fce'],59,279,338,32119202,5,0.124137931,0.95862069,0.931034483,31602
1dea1945b910230c462a04ef9c8eeb166b5ad588,0,Ishan Bhatt,2018-05-07 12:10:39-04:00,['3593017e1c34411bbf3971afa047012dd51ddaa3'],47,38,85,32119287,10,1,0,0,31602
c77399a4f85a2ba7cd525ff8ff6783df65375f86,1,aBabiichuk,2018-05-07 21:43:24+03:00,['1dea1945b910230c462a04ef9c8eeb166b5ad588'],30,619,649,32119936,12,,0,,31607
c4a125d645431bcfdabf7960cbe9e0d1736d3166,1,GitHub,2018-05-07 22:49:08+02:00,['c77399a4f85a2ba7cd525ff8ff6783df65375f86'],1,1,2,32119938,1,,,,31607
d70dc6c5dc2420383c4987567dfcca559abf9652,0,GitHub,2018-05-08 14:07:47+05:18,"['c4a125d645431bcfdabf7960cbe9e0d1736d3166', '6d547f59c97e5b5e2e50f4c4012c954ecddfcef5']",28,97,125,32120063,2,,,,31607
3304b8df9b7a19a628f57eb5c67b2d1dbc42e578,0,Dmytro Grinenko,2018-05-08 13:04:11+03:00,['d70dc6c5dc2420383c4987567dfcca559abf9652'],1,25,26,32120089,2,,,,31607
77cb8c3085fd3014a06c29d66919310f8a76ff66,1,aonishuk,2018-05-08 13:51:21+03:00,['3304b8df9b7a19a628f57eb5c67b2d1dbc42e578'],1,1,2,32120091,1,,,,31607
bca92e3fc7a1f84990fe6ee280726b55f044b587,1,Oliver Szabo,2018-05-08 13:21:30+02:00,['77cb8c3085fd3014a06c29d66919310f8a76ff66'],17,1,18,32120109,2,0,0,0,31607
e54a87a65d0cf62a5535f13cab8c8ec3b9beb599,0,aBabiichuk,2018-05-08 15:37:41+03:00,['bca92e3fc7a1f84990fe6ee280726b55f044b587'],2,3,5,32120114,2,,,,31607
f7904ec65c4d57cf8db2f090a1d2e8e6b5546504,0,Robert Levas,2018-05-08 10:56:58-04:00,['e54a87a65d0cf62a5535f13cab8c8ec3b9beb599'],5,14,19,32120133,1,0,0,1,31607
88f5dc389e86218fab04069932d334ecb490a3cb,1,Andrii Tkach,2018-05-08 18:26:16+03:00,['f7904ec65c4d57cf8db2f090a1d2e8e6b5546504'],27,10,37,32120170,6,,,,31607
2d4131613d37cec2e1795a8addd6422ee7fb3d0f,1,Andrii Tkach,2018-05-08 18:27:44+03:00,['88f5dc389e86218fab04069932d334ecb490a3cb'],59,98,157,32120327,12,1,1,1,31608
88e1f324f9c7ddf771e74fb38f7f6605cad42674,0,Siddharth,2018-05-08 08:38:33-07:00,['2d4131613d37cec2e1795a8addd6422ee7fb3d0f'],8,13,21,32120348,1,1,0,0,31608
653f32a7f0d44f34ffc250db90de4702ac81d60a,1,Aleksandr Kovalenko,2018-05-08 21:08:13+03:00,['88e1f324f9c7ddf771e74fb38f7f6605cad42674'],16,23,39,32120387,2,1,1,1,31608
a1b30c9340e084bbebfd9ec9e09b1a1808aa6097,0,Siddharth,2018-05-08 12:13:21-07:00,['653f32a7f0d44f34ffc250db90de4702ac81d60a'],2,3,5,32120392,3,,,,31608
bc38be0fae82e444152c63d6f466c4e81a3dd64c,0,GitHub,2018-05-08 15:15:58-07:00,['a1b30c9340e084bbebfd9ec9e09b1a1808aa6097'],13,8,21,32120413,1,0,1,1,31608
ab5da5298bf24992e1ecadbabd96a9fb91616a1d,0,GitHub,2018-05-09 00:16:51+02:00,['bc38be0fae82e444152c63d6f466c4e81a3dd64c'],0,68,68,32120481,2,,,,31608
a83a4df65207cbb3af93c789e81c15937a0feffd,0,Siddharth,2018-05-09 11:15:55-07:00,['ab5da5298bf24992e1ecadbabd96a9fb91616a1d'],2,2,4,32120485,1,1,1,1,31608
fef6634106429d1715c2e137cbd5e5ab9b0f8262,0,GitHub,2018-05-09 12:37:16-07:00,['a83a4df65207cbb3af93c789e81c15937a0feffd'],8,13,21,32120506,1,1,0,0,31608
5fea707389964c0625e5c8d2369aab409131a343,0,Ishan Bhatt,2018-05-09 18:01:12-04:00,['fef6634106429d1715c2e137cbd5e5ab9b0f8262'],4,4,8,32120514,2,,,,31608
1b6a473241a9648664f550233b3c3e2d43d0a300,1,aBabiichuk,2018-05-10 13:06:14+03:00,['5fea707389964c0625e5c8d2369aab409131a343'],109,1806,1915,32122429,5,0.494117647,0.941176471,0.905882353,31608
5969d60ac9c91503469f3640ec72de139ff8387c,0,Alex Antonenko,2018-05-10 13:09:03+03:00,['5fea707389964c0625e5c8d2369aab409131a343'],8,11,19,32122448,1,1,1,1,31608
1faa987ff1c324791c1c49a7cbc9cff4ffebf6fc,0,GitHub,2018-05-10 14:17:48+03:00,"['1b6a473241a9648664f550233b3c3e2d43d0a300', '5969d60ac9c91503469f3640ec72de139ff8387c']",8,11,19,32122467,1,,,,31608
94573842ed1985b8036df990963f98e7b448cb1a,1,aBabiichuk,2018-05-10 14:41:49+03:00,['1faa987ff1c324791c1c49a7cbc9cff4ffebf6fc'],34,121,155,32122622,18,0.0625,1,0.0625,31608
28d120fd1012f9b16208b05504a051bcb20187e5,0,GitHub,2018-05-10 16:34:48+03:00,['94573842ed1985b8036df990963f98e7b448cb1a'],154,79,233,32122855,16,1,0.222222222,0.323232323,31608
c9d506450d6b89fe9cf49bc0d6fba4770991daa7,1,Dmytro Grinenko,2018-05-10 16:40:10+03:00,['28d120fd1012f9b16208b05504a051bcb20187e5'],4,4,8,32122863,3,,,,31608
cd82331950dee0a3a8eba8cbdae5abcdfaca2f82,1,aonishuk,2018-05-10 16:47:37+03:00,['c9d506450d6b89fe9cf49bc0d6fba4770991daa7'],25,65,90,32122953,7,0.928571429,0.928571429,0.464285714,31608
aefd00ac5c1e119afee6ccd39a5284600e794b98,0,aBabiichuk,2018-05-10 17:44:28+03:00,['cd82331950dee0a3a8eba8cbdae5abcdfaca2f82'],0,3,3,32122956,1,0,0,1,31608
3d95ddd1a160715145434230ab5793999131aa0a,1,aBabiichuk,2018-05-10 18:54:23+03:00,['aefd00ac5c1e119afee6ccd39a5284600e794b98'],7,21,28,32122984,5,,,,31608
5b0e11a8cffd3abffb018d7d8c31bd38da2d496f,0,Robert Levas,2018-05-10 12:22:35-04:00,['3d95ddd1a160715145434230ab5793999131aa0a'],4,8,12,32122996,3,0,1,1,31608
c1552d0e159041b6edc8f6e642a1866ad5ccecd1,0,Siddharth,2018-05-10 11:43:39-07:00,['5b0e11a8cffd3abffb018d7d8c31bd38da2d496f'],21,14,35,32123031,1,0,0,1,31608
4f7b60d8fd45b089ba5e8cf13c0486a4cfc56456,0,GitHub,2018-05-10 21:15:44+02:00,['c1552d0e159041b6edc8f6e642a1866ad5ccecd1'],8,9,17,32123048,1,1,,,31608
8419a1a4bb75e24896ed16c0763a84d4b5832a90,0,GitHub,2018-05-10 22:51:28+02:00,['4f7b60d8fd45b089ba5e8cf13c0486a4cfc56456'],1,2,3,32123051,1,,,,31608
8bb3bcab2bbb2a582ed0db25c86881a9e07803b7,1,avijayanhwx,2018-05-10 14:12:32-07:00,['8419a1a4bb75e24896ed16c0763a84d4b5832a90'],402,870,1272,32124323,32,0.357638889,0.336805556,0.791666667,31614
5bae5c66268591f999e639ca32a50931d803f9f2,0,avijayanhwx,2018-05-10 14:12:32-07:00,['8bb3bcab2bbb2a582ed0db25c86881a9e07803b7'],2,8,10,32124333,3,0,0,1,31614
d4d2767ae0d9c8e3043144df52bd5d6094b61171,0,avijayanhwx,2018-05-10 14:12:32-07:00,['5bae5c66268591f999e639ca32a50931d803f9f2'],38,36,74,32124407,5,1,0.866666667,1,31614
ad366eb2787e9c404f1c29bef5233af2f0154069,0,GitHub,2018-05-11 09:28:12+02:00,['d4d2767ae0d9c8e3043144df52bd5d6094b61171'],3,248,251,32124658,9,0.988372093,1,1,31617
ee18bba42bac9422c09ffe0d4aff8d6e1f44c23e,0,aonishuk,2018-05-11 12:43:21+03:00,['ad366eb2787e9c404f1c29bef5233af2f0154069'],3,3,6,32124664,1,1,1,0,31617
e0b682420559de568275e382bbd70d60f3c3f7f1,1,aBabiichuk,2018-05-11 12:46:32+03:00,['ee18bba42bac9422c09ffe0d4aff8d6e1f44c23e'],51,96,147,32124811,5,1,1,1,31617
3bd2ff7ab12e65f1573f58ac886e7cafdc5efcbf,0,Andrii Tkach,2018-05-11 15:26:39+03:00,['e0b682420559de568275e382bbd70d60f3c3f7f1'],32,19,51,32124862,6,0.454545455,0,0,31617
aef1c5029b5363fc1f369bfc0418f04f67071586,0,Andrii Tkach,2018-05-11 15:29:02+03:00,['3bd2ff7ab12e65f1573f58ac886e7cafdc5efcbf'],86,170,256,32125118,16,1,1,1,31618
9abe1a9e6b1578f1e924fea62c28323a689d2931,1,Alex Antonenko,2018-05-11 15:29:40+03:00,['5fea707389964c0625e5c8d2369aab409131a343'],5,8,13,32125131,2,,,,31618
475b113c7b4eca19cd4f03feb13f13531c8f25c0,0,aBabiichuk,2018-05-11 16:15:49+03:00,['aef1c5029b5363fc1f369bfc0418f04f67071586'],38,117,155,32125286,2,0.284210526,1,0.736842105,31618
2e47da73f1798eadbb86b134e16b5ab982c3885f,0,GitHub,2018-05-11 16:52:34+03:00,"['475b113c7b4eca19cd4f03feb13f13531c8f25c0', '9abe1a9e6b1578f1e924fea62c28323a689d2931']",5,8,13,32125299,2,,,,31618
7d215e0bdc519f450a127b6adbf11438c23136ad,1,avijayanhwx,2018-05-11 07:06:10-07:00,['2e47da73f1798eadbb86b134e16b5ab982c3885f'],36,38,74,32125373,5,0,0.133333333,0,31618
dd249318ee0373117d8e1e8dee4543847d5d4d52,0,avijayanhwx,2018-05-11 07:06:10-07:00,['7d215e0bdc519f450a127b6adbf11438c23136ad'],8,2,10,32125383,3,1,1,0,31618
4b8a6b2e99971ac4970612fef391d6f237ae3e03,1,avijayanhwx,2018-05-11 07:06:10-07:00,['dd249318ee0373117d8e1e8dee4543847d5d4d52'],870,402,1272,32126655,32,0.642361111,0.663194444,0.208333333,31618
ef1103dae2782f1e61121cd2d15d715d659d88ec,0,Siddharth,2018-05-11 08:30:34-07:00,['4b8a6b2e99971ac4970612fef391d6f237ae3e03'],16,25,41,32126696,3,1,1,1,31618
aa59d053189a39b1fef0c7be635567b049aedc56,1,Aleksandr Kovalenko,2018-05-11 19:18:50+03:00,['ef1103dae2782f1e61121cd2d15d715d659d88ec'],33,111,144,32126840,13,0.95,1,0.783333333,31618
1988821d27c3050e24ad952c024acf8d6327c298,1,Olivér Szabó,2018-05-11 18:32:24+02:00,['aa59d053189a39b1fef0c7be635567b049aedc56'],145,325,470,32127310,17,0,1,1,31620
d15e9e0964dd7e025be116e361a1c25308192cfc,0,Siddharth,2018-05-11 10:17:49-07:00,['1988821d27c3050e24ad952c024acf8d6327c298'],2,2,4,32127314,1,,,,31620
7bedbef675c2268d034622f11af48db829059e2e,1,Aleksandr Kovalenko,2018-05-12 00:06:57+03:00,['d15e9e0964dd7e025be116e361a1c25308192cfc'],21,19,40,32127354,1,0,0,0,31620
a3c06c4495f40783b3630f8c5aa5f85137646001,1,Olivér Szabó,2018-05-13 20:20:48+02:00,['7bedbef675c2268d034622f11af48db829059e2e'],125,342,467,32127821,6,0.141104294,0,0.883435583,31620
c17b9f8d093447274ac2a9b90f705f3b5a943b17,1,Olivér Szabó,2018-05-13 20:20:48+02:00,['a3c06c4495f40783b3630f8c5aa5f85137646001'],33,194,227,32128048,4,0.244444444,0.244444444,1,31620
de78779996b6f3fe4222abdc3a4d345845f44b88,1,Oliver Szabo,2018-05-13 21:06:16+02:00,['c17b9f8d093447274ac2a9b90f705f3b5a943b17'],2,3,5,32128053,2,,,,31620
1f6ebfedf2ba167c00c44ba2d8fdf1c6e08717b5,1,GitHub,2018-05-14 11:48:43+05:18,['de78779996b6f3fe4222abdc3a4d345845f44b88'],44,334,378,32128431,24,0.705128205,1,1,31622
5bdad16355d4c12f078ec09f0e5f18f7759c683c,0,Andrii Tkach,2018-05-14 13:25:39+03:00,['1f6ebfedf2ba167c00c44ba2d8fdf1c6e08717b5'],76,11,87,32128518,5,0,0,0,31622
b623f07013199c03481cf758d3a1c10899f89946,0,Miklos Gergely,2018-05-14 12:51:44+02:00,['5bdad16355d4c12f078ec09f0e5f18f7759c683c'],103981,0,103981,32232499,1101,0.303304806,0.134983542,0.104595128,31622
ef86b0a3a590950bcf5090499a34b911b8677852,0,Miklos Gergely,2018-05-14 13:29:41+02:00,['b623f07013199c03481cf758d3a1c10899f89946'],1522,0,1522,32234021,5,0.321167883,0.394160584,0,31622
e1f74d683a9fd56642c7faa9c3f6c3587617d839,0,GitHub,2018-05-14 16:36:13+03:00,['ef86b0a3a590950bcf5090499a34b911b8677852'],0,2,2,32234023,1,1,1,0,31622
f4721990ab03f6ccb282576bed188836d7d36951,0,Oliver Szabo,2018-05-14 15:57:23+02:00,['e1f74d683a9fd56642c7faa9c3f6c3587617d839'],3,3,6,32234029,2,0,0,1,31622
397d5d3984e4a379f352a810cd7b3b9896f4a34d,1,Oliver Szabo,2018-05-14 16:38:19+02:00,['f4721990ab03f6ccb282576bed188836d7d36951'],0,375,375,32234404,1,,,,31623
9d7df89092366d9885efd1f10e92d29887ea9e1e,0,Siddharth,2018-05-14 10:35:45-07:00,['397d5d3984e4a379f352a810cd7b3b9896f4a34d'],1,2,3,32234407,2,,,,31623
f5cbc45d048354084388a89ab5d027a61a2b382e,1,Oliver Szabo,2018-05-14 19:42:07+02:00,['9d7df89092366d9885efd1f10e92d29887ea9e1e'],0,19,19,32234426,1,,,,31623
8dde33057bb8d094523cb33fcca57ca433f44d16,1,Oliver Szabo,2018-05-15 03:08:56+02:00,['f5cbc45d048354084388a89ab5d027a61a2b382e'],84,366,450,32234876,1,,,,31623
8142e2c76807a68120c235294e1dd4bd8f64ff55,1,avijayanhwx,2018-05-14 20:50:16-07:00,['8dde33057bb8d094523cb33fcca57ca433f44d16'],412,998,1410,32236286,32,0.309392265,0.425414365,0.96961326,31629
f1d63e6e5321b9db2688283694bb73c9096b90b9,0,GitHub,2018-05-15 11:41:46+03:00,['8142e2c76807a68120c235294e1dd4bd8f64ff55'],0,68,68,32236354,1,,,,31629
4c903848e54134a9c011f1b13b248057864e0902,1,Miklos Gergely,2018-05-15 12:37:31+02:00,['f1d63e6e5321b9db2688283694bb73c9096b90b9'],328,33,361,32236715,19,0.294871795,0,0,31629
b9c2fbb65a0fa844a0f68f7cd0c74a7eb0c6417e,1,GitHub,2018-05-15 13:59:57+03:00,['4c903848e54134a9c011f1b13b248057864e0902'],2,626,628,32237343,5,0.376175549,0.504702194,0.862068966,31633
43a12704fb6c524faa76d04898edb875ec27dc2c,0,aonishuk,2018-05-15 14:03:50+03:00,['b9c2fbb65a0fa844a0f68f7cd0c74a7eb0c6417e'],2,62,64,32237407,6,,,,31637
11105485308d2a6d96c537df08a711285f6b1cb4,0,aonishuk,2018-05-15 14:03:50+03:00,['43a12704fb6c524faa76d04898edb875ec27dc2c'],0,0,0,32237407,1,,,,31637
5bc3f1df1b6bd7a3afb99405369509f1ddab860c,0,aonishuk,2018-05-15 14:27:58+03:00,['11105485308d2a6d96c537df08a711285f6b1cb4'],1,2,3,32237410,1,0,0,0,31637
ea67ea5ea68539346f528a034e09a7592f1a4289,1,Oliver Szabo,2018-05-15 13:32:10+02:00,['5bc3f1df1b6bd7a3afb99405369509f1ddab860c'],26,42,68,32237478,1,,,,31637
1890f5f1011dd0c4b98c0d2ef1a9a361de66a315,0,Oliver Szabo,2018-05-15 13:32:10+02:00,['ea67ea5ea68539346f528a034e09a7592f1a4289'],0,6,6,32237484,1,,,,31637
d1cb6f066da447eda8049455a52a741ebbafdf7e,0,aBabiichuk,2018-05-15 15:30:05+03:00,['1890f5f1011dd0c4b98c0d2ef1a9a361de66a315'],0,6,6,32237490,1,,,,31637
14b9f6b4a569751e793327239dcf3eb0e72080dc,0,Alex Antonenko,2018-05-15 15:44:50+03:00,['9abe1a9e6b1578f1e924fea62c28323a689d2931'],2,5,7,32237497,3,1,0.333333333,1,31637
368831b609c2a2f3389ae1d27ef807a3175413a5,0,GitHub,2018-05-15 15:00:50+02:00,['d1cb6f066da447eda8049455a52a741ebbafdf7e'],12,28,40,32237537,4,0,0,0.2,31637
5b357875d1d19bea2f06191f78cf71503cf6d8ee,0,GitHub,2018-05-15 18:40:45+05:18,['368831b609c2a2f3389ae1d27ef807a3175413a5'],1,224,225,32237762,3,0.583333333,1,1,31639
aab2b7749236d2157ab31669ae86bfe6658d37bd,1,Alex Antonenko,2018-05-15 17:01:23+03:00,['5b357875d1d19bea2f06191f78cf71503cf6d8ee'],1,1,2,32237764,1,,,,31639
b8af6d0224bcf4bb89d856239ab216b745e1c33b,0,Alex Antonenko,2018-05-15 17:11:12+03:00,['aab2b7749236d2157ab31669ae86bfe6658d37bd'],1,1,2,32237766,1,,,,31639
95e86e1c3e7cb34a5a2e8dce39f3b6715381bdd0,0,GitHub,2018-05-15 17:28:08+03:00,['5b357875d1d19bea2f06191f78cf71503cf6d8ee'],2,13,15,32237781,1,0,1,0,31639
c26a425aa92416410fa4d60da8dfc25e758c8148,0,GitHub,2018-05-15 17:34:20+03:00,"['95e86e1c3e7cb34a5a2e8dce39f3b6715381bdd0', '14b9f6b4a569751e793327239dcf3eb0e72080dc']",2,5,7,32237788,3,,,,31639
4c09f532d421fdf15d2ba872cea49bfff3bbd577,0,Ishan Bhatt,2018-05-15 11:05:54-04:00,['c26a425aa92416410fa4d60da8dfc25e758c8148'],23,62,85,32237873,4,0.333333333,1,1,31640
a8d48299aed34e45dc42bc9638e305c7684d32a2,0,Ishan Bhatt,2018-05-15 11:13:24-04:00,['4c09f532d421fdf15d2ba872cea49bfff3bbd577'],1,29,30,32237903,1,0.80952381,0.285714286,1,31640
dbf99ff467c49fcbc344010e9b3ba2db6a498320,1,Miklos Gergely,2018-05-15 17:32:23+02:00,['a8d48299aed34e45dc42bc9638e305c7684d32a2'],1,1,2,32237905,1,,,,31640
1b96587e570e4bb8d4fee531271a6f2fd39d33de,0,Miklos Gergely,2018-05-15 17:32:23+02:00,['dbf99ff467c49fcbc344010e9b3ba2db6a498320'],0,13,13,32237918,1,0,0,1,31640
1b900a0cce34fb8788de39558a924f563bae05ab,0,Miklos Gergely,2018-05-15 17:32:23+02:00,['1b96587e570e4bb8d4fee531271a6f2fd39d33de'],3,4,7,32237925,1,,,,31640
3e3223134877829ebb323b49a7c1943bffedb96e,0,aBabiichuk,2018-05-15 18:41:09+03:00,['1b900a0cce34fb8788de39558a924f563bae05ab'],1,1,2,32237927,1,,,,31640
a949b8aa2b1daebf9a11760b597c581ebdcbd66a,1,GitHub,2018-05-15 19:36:10+03:00,['3e3223134877829ebb323b49a7c1943bffedb96e'],119,290,409,32238336,27,0.085470085,0.461538462,0.811965812,31640
7c26eb609db14c04f8842d6929e90bef37460b5a,0,aBabiichuk,2018-05-15 21:17:09+03:00,['a949b8aa2b1daebf9a11760b597c581ebdcbd66a'],3,3,6,32238342,1,1,,,31640
025c18d62e877d70b8b4009d0baba56948965714,1,Oliver Szabo,2018-05-15 22:17:12+02:00,['7c26eb609db14c04f8842d6929e90bef37460b5a'],0,3,3,32238345,1,0,1,0,31640
429f7bf7b1d4ac2fe7a5979c86dcac5f4c4e36fc,0,Miklos Gergely,2018-05-16 11:12:11+02:00,['025c18d62e877d70b8b4009d0baba56948965714'],1,1,2,32238347,1,,,,31640
7b1f403aba69a9a5266d670d596768654b3cf31f,1,GitHub,2018-05-16 13:08:19+02:00,['429f7bf7b1d4ac2fe7a5979c86dcac5f4c4e36fc'],6,6,12,32238359,3,,,,31640
81ed7f46af3b34a44e1837ab19a8c733f7335ffc,0,Andrii Tkach,2018-05-16 14:18:21+03:00,['7b1f403aba69a9a5266d670d596768654b3cf31f'],15,34,49,32238408,7,1,1,1,31640
06025fe351ad0c26b4b7e6d32524794633a97524,0,Andrii Tkach,2018-05-16 14:19:55+03:00,['81ed7f46af3b34a44e1837ab19a8c733f7335ffc'],9,0,9,32238417,1,,,,31640
6bf1db2438776fd9a17d9287c0acac6a428d07da,0,GitHub,2018-05-16 14:31:28+03:00,['06025fe351ad0c26b4b7e6d32524794633a97524'],9,22,31,32238448,2,0.8,1,1,31640
d66b2ee66ea9b7376f2e782564c643c0db28bf63,1,Oliver Szabo,2018-05-16 13:59:38+02:00,['6bf1db2438776fd9a17d9287c0acac6a428d07da'],1,14,15,32238463,2,0,0,1,31640
442573e2b5421548a638234089b6e090158316c5,0,GitHub,2018-05-16 17:23:35+03:00,"['d66b2ee66ea9b7376f2e782564c643c0db28bf63', 'b8af6d0224bcf4bb89d856239ab216b745e1c33b']",2,2,4,32238467,2,,,,31640
af16f6a801f37f7e9f616a664322434422006cf6,1,GitHub,2018-05-16 09:02:10-07:00,['442573e2b5421548a638234089b6e090158316c5'],17,12,29,32238496,3,0,0,0,31640
f429f27948c94035d0d7e375d00069829f32f19f,0,avijayanhwx,2018-05-16 15:25:44-07:00,['af16f6a801f37f7e9f616a664322434422006cf6'],59,77,136,32238632,5,0.071428571,0,0,31640
817cc6f2a40390d77488a1b00b9414736a7b03ce,1,GitHub,2018-05-17 00:51:15+02:00,['f429f27948c94035d0d7e375d00069829f32f19f'],52,51,103,32238735,21,,,,31640
2458939c5522aa82e4ed2a72b14f2cd72507eb86,0,avijayanhwx,2018-05-16 16:16:12-07:00,['817cc6f2a40390d77488a1b00b9414736a7b03ce'],0,6,6,32238741,1,,,,31640
fb242abe846f970fd5f086348d823c793e9b1e84,0,GitHub,2018-05-17 02:15:12+02:00,['2458939c5522aa82e4ed2a72b14f2cd72507eb86'],3,3,6,32238747,2,,,,31640
fc5aee4f70d5051183417942cf306b45a3fc82b7,1,Oliver Szabo,2018-05-17 03:07:36+02:00,['fb242abe846f970fd5f086348d823c793e9b1e84'],14,15,29,32238776,1,,,,31640
d8e400c9250b081f19b4f694ab33b61d17a368f7,0,aonishuk,2018-05-17 11:27:30+03:00,['fc5aee4f70d5051183417942cf306b45a3fc82b7'],0,2,2,32238778,1,,,,31640
da4733d5df8b3b9bea1aa37a6f92431211fe41ed,1,hiveww,2018-05-17 11:54:30+03:00,['fc5aee4f70d5051183417942cf306b45a3fc82b7'],1,5,6,32238784,2,,,,31640
ee2aa4ff995ea54acd5af9869bca8520ed45d42e,1,hiveww,2018-05-17 12:40:52+03:00,['fc5aee4f70d5051183417942cf306b45a3fc82b7'],13,17,30,32238814,1,1,1,1,31640
41167742b6f597b1db205e97dfc238f573dd6dc8,0,hiveww,2018-05-17 12:47:58+03:00,['ee2aa4ff995ea54acd5af9869bca8520ed45d42e'],1,1,2,32238816,1,,,,31640
1c563071dea922e9d6bd6c54608bfa351e5312c7,0,hiveww,2018-05-17 13:03:46+03:00,['da4733d5df8b3b9bea1aa37a6f92431211fe41ed'],6,2,8,32238824,3,,,,31640
ec93d95fdeaa6a529aee944b90fd15a42072300e,1,hiveww,2018-05-17 15:02:54+03:00,['fc5aee4f70d5051183417942cf306b45a3fc82b7'],3,23,26,32238850,2,1,1,0.166666667,31640
15909dea795dcdcb19049f07f35d04d9c56ccd0c,0,GitHub,2018-05-17 15:07:04+03:00,"['d8e400c9250b081f19b4f694ab33b61d17a368f7', '41167742b6f597b1db205e97dfc238f573dd6dc8']",13,17,30,32238880,1,,,,31640
ea078dd7d1c674143326d9a6c98439cbf81342ce,0,GitHub,2018-05-17 15:07:16+03:00,"['15909dea795dcdcb19049f07f35d04d9c56ccd0c', '1c563071dea922e9d6bd6c54608bfa351e5312c7']",1,1,2,32238882,1,,,,31640
fe6aa87ba5159a1ac5242b16ba0e1119a0dcca5d,0,hiveww,2018-05-17 15:51:25+03:00,['ec93d95fdeaa6a529aee944b90fd15a42072300e'],6,8,14,32238896,1,0,1,1,31640
6d413e39ca4ab43f48feba785f08c1638b847b62,1,GitHub,2018-05-17 15:58:32+03:00,['ea078dd7d1c674143326d9a6c98439cbf81342ce'],11,89,100,32238996,3,0.019230769,0.769230769,0.846153846,31640
9671dd17d83d39589cb05e830ecaffcf2a025086,0,GitHub,2018-05-17 17:38:09+03:00,['6d413e39ca4ab43f48feba785f08c1638b847b62'],339,107,446,32239442,24,0,0,0,31640
d9bfcac2c53fc44ffb9a45c5ea29c592153ad069,0,"Doroszlai, Attila",2018-05-17 17:59:42+02:00,['9671dd17d83d39589cb05e830ecaffcf2a025086'],4,10,14,32239456,1,0,0,1,31640
69150f7ff7ae90cfb220624b7a72777fdac2fc32,1,Andrii Tkach,2018-05-17 19:13:18+03:00,['d9bfcac2c53fc44ffb9a45c5ea29c592153ad069'],55,123,178,32239634,12,1,1,1,31640
0460f442618255d057627e9595d7561cd30af15b,0,aBabiichuk,2018-05-17 19:24:14+03:00,['69150f7ff7ae90cfb220624b7a72777fdac2fc32'],174,290,464,32240098,1,0.267676768,0.166666667,0.893939394,31640
63688f93ca82a545a071b2d475054e631b061fe8,0,Robert Levas,2018-05-17 10:00:47-07:00,['0460f442618255d057627e9595d7561cd30af15b'],0,8,8,32240106,2,,,,31640
5e6705292e55f80fea054b341ce6c76adfebc0bb,0,GitHub,2018-05-18 00:27:20+02:00,['63688f93ca82a545a071b2d475054e631b061fe8'],1,92,93,32240199,9,0.325581395,1,0.976744186,31641
d11c2b6c36bb1b45cc1aebf43faa3aab41dd9bf4,0,Ishan Bhatt,2018-05-17 17:57:38-07:00,['5e6705292e55f80fea054b341ce6c76adfebc0bb'],5,3,8,32240207,2,,,,31641
c2239a1fa5a9193df61c4fb062355870b4f4fb4b,0,GitHub,2018-05-17 22:18:21-07:00,['d11c2b6c36bb1b45cc1aebf43faa3aab41dd9bf4'],30,273,303,32240510,29,0.351648352,0,0.912087912,31641
75e0c4a6e5f2c30483bf2f783c1af0c38f3b2623,0,Lisnichenko Dmitro,2018-05-18 12:40:50+03:00,['c2239a1fa5a9193df61c4fb062355870b4f4fb4b'],4,14,18,32240528,1,0,0.857142857,0.142857143,31641
c4c31492ecd78316d7e8fb372eef41ca4d3fbb87,0,GitHub,2018-05-18 12:59:59+03:00,['c2239a1fa5a9193df61c4fb062355870b4f4fb4b'],2,8,10,32240538,1,0,0,0,31641
3f95121d5cca024843ed7e40e97ed12c65d7aae2,1,Andrii Tkach,2018-05-18 13:26:49+03:00,['c4c31492ecd78316d7e8fb372eef41ca4d3fbb87'],28,51,79,32240617,4,1,1,1,31641
b349c77f794e39aea8ba27d216e347ab17bfa2b1,0,Andrii Tkach,2018-05-18 13:26:49+03:00,['3f95121d5cca024843ed7e40e97ed12c65d7aae2'],1,1,2,32240619,1,,,,31641
2c57b457caee50e67c747dfd4ae6d5a2d83e9dac,0,aonishuk,2018-05-18 14:24:10+03:00,['b349c77f794e39aea8ba27d216e347ab17bfa2b1'],62,100,162,32240781,6,0.347826087,0.130434783,0,31641
eef11c3f37dd5ee2f4c74ce422b28f90f41cbd40,0,Alex Antonenko,2018-05-18 14:33:30+03:00,['b349c77f794e39aea8ba27d216e347ab17bfa2b1'],3,1,4,32240785,1,0,0,0,31641
4d34aff228ca928fa714501c077974394749da59,0,Alex Antonenko,2018-05-18 15:09:16+03:00,['fe6aa87ba5159a1ac5242b16ba0e1119a0dcca5d'],2,6,8,32240793,1,0,1,1,31641
a1bc9ca09cfd835bda9d288191ce34cc6a88a3d4,0,GitHub,2018-05-18 14:19:28+02:00,['2c57b457caee50e67c747dfd4ae6d5a2d83e9dac'],75,35,110,32240903,10,0,0,0,31641
ced86774a99bb6168c2cd745aa9aeec50a89b074,0,GitHub,2018-05-18 15:53:49+03:00,"['a1bc9ca09cfd835bda9d288191ce34cc6a88a3d4', 'eef11c3f37dd5ee2f4c74ce422b28f90f41cbd40']",3,1,4,32240907,1,,,,31641
4b80887ef9f081a011032662d0c5625e335d7024,0,GitHub,2018-05-18 15:59:30+03:00,"['ced86774a99bb6168c2cd745aa9aeec50a89b074', '4d34aff228ca928fa714501c077974394749da59']",6,32,38,32240945,3,,,,31641
0bae7049abf2dc3f4e870846eef8d82b235f5a05,0,Andrii Tkach,2018-05-18 16:59:48+03:00,['4b80887ef9f081a011032662d0c5625e335d7024'],4,8,12,32240957,1,1,1,1,31641
087d0356887a44bbe9361f2b5e6219dd681268db,0,GitHub,2018-05-18 17:29:28+03:00,"['0bae7049abf2dc3f4e870846eef8d82b235f5a05', '75e0c4a6e5f2c30483bf2f783c1af0c38f3b2623']",4,14,18,32240975,1,,,,31641
0d9fb4dad7c3ced0129fd08579e2a57818cc04bc,1,GitHub,2018-05-18 17:32:21+02:00,['087d0356887a44bbe9361f2b5e6219dd681268db'],15,386,401,32241376,10,1,1,0.935483871,31643
021462339cc4eb4b6c49e7dfbdba29ce77f94a6d,1,GitHub,2018-05-18 13:23:40-04:00,['0d9fb4dad7c3ced0129fd08579e2a57818cc04bc'],117,694,811,32242187,20,0.233160622,0.378238342,0.829015544,31645
e4bc80afe44ba067a460acd32e02728244607b14,1,GitHub,2018-05-18 21:20:54+03:00,['021462339cc4eb4b6c49e7dfbdba29ce77f94a6d'],53,112,165,32242352,8,0.912280702,0.070175439,1,31645
37475b1ad3eb9a8f97da15012819fa8c564d6f79,0,Olivér Szabó,2018-05-19 00:08:02+02:00,['e4bc80afe44ba067a460acd32e02728244607b14'],13,34,47,32242399,3,0.5,0.5,0.5,31645
f26fa2521c0c0a9aeecb24873accfbdd588fe4e9,0,ncole,2018-05-18 21:37:40-04:00,['37475b1ad3eb9a8f97da15012819fa8c564d6f79'],14,46,60,32242459,6,0,0,0.764705882,31645
537986c32e679adb58cbbdffb41461dad4621798,0,GitHub,2018-05-19 00:32:33-04:00,['f26fa2521c0c0a9aeecb24873accfbdd588fe4e9'],37,48,85,32242544,8,0.428571429,0,0.857142857,31645
9cecfae1e05e47927a28bb99698c3e9a073584f4,0,aonishuk,2018-05-21 11:01:24+03:00,['537986c32e679adb58cbbdffb41461dad4621798'],12,180,192,32242736,6,,,,31645
10664e3b66516cfc04ac124ee00362b1705a6781,0,aBabiichuk,2018-05-21 12:44:31+03:00,['9cecfae1e05e47927a28bb99698c3e9a073584f4'],4,5,9,32242745,2,,,,31645
d4f3ab839d8d165e2609367fcb86602bbeb48567,0,Andrii Tkach,2018-05-21 13:27:02+03:00,['10664e3b66516cfc04ac124ee00362b1705a6781'],2,2,4,32242749,1,,,,31645
73a8c8ae99d44bf48109ab31bf1d252b10daad02,1,aBabiichuk,2018-05-21 13:29:00+03:00,['d4f3ab839d8d165e2609367fcb86602bbeb48567'],349,209,558,32243307,9,0.956521739,0.173913043,1,31645
8b0f254eb3dfaedea76540cac3cacc7c6dcd1fb0,0,GitHub,2018-05-21 13:40:41+02:00,['73a8c8ae99d44bf48109ab31bf1d252b10daad02'],19,0,19,32243326,1,,,,31645
30d9ce0c5871d50f671722f1351d2377fd4b28db,1,aBabiichuk,2018-05-21 15:13:30+03:00,['8b0f254eb3dfaedea76540cac3cacc7c6dcd1fb0'],6,28,34,32243360,5,1,1,1,31645
69b039932b091e5742e2a2f3ae84ad1491c6fbc5,1,Robert Levas,2018-05-21 09:32:37-04:00,['30d9ce0c5871d50f671722f1351d2377fd4b28db'],11,9,20,32243380,8,,,,31645
905c68f8753218dac264f1096e3795099b717498,0,Robert Levas,2018-05-21 10:03:01-04:00,['69b039932b091e5742e2a2f3ae84ad1491c6fbc5'],1,3,4,32243384,1,,,,31645
fe26d92b77b568744b0d4e8f48852132fbdba62e,1,Alex Antonenko,2018-05-21 17:31:33+03:00,['8b0f254eb3dfaedea76540cac3cacc7c6dcd1fb0'],1,86,87,32243471,2,0.6875,0.9625,1,31645
d5ccac02415794c7bb58ce09bc3871789147f488,0,GitHub,2018-05-21 18:23:57+03:00,['905c68f8753218dac264f1096e3795099b717498'],1,1,2,32243473,1,,,,31645
1b7034eb9f45ee313cf440641ac393fdf76dfc34,0,Robert Levas,2018-05-21 11:38:52-04:00,['d5ccac02415794c7bb58ce09bc3871789147f488'],2,8,10,32243483,2,0,0,1,31645
06e4a3a93809a08b1c158f25872532a13fe1e9f3,0,Ishan Bhatt,2018-05-21 10:05:50-07:00,['1b7034eb9f45ee313cf440641ac393fdf76dfc34'],3,11,14,32243497,6,,,,31645
4b48c058ffdd2c8453f5ef5aecb84c156ed6ce12,1,Alex Antonenko,2018-05-21 20:49:00+03:00,['fe26d92b77b568744b0d4e8f48852132fbdba62e'],0,106,106,32243603,1,1,1,1,31645
488a8c165ad6c5cb8ad8d3a81ed21c0fea85d30f,1,aBabiichuk,2018-05-21 20:55:56+03:00,['06e4a3a93809a08b1c158f25872532a13fe1e9f3'],7,2,9,32243612,2,0,0,0,31645
533229c0283c5159a9db77692f260e8196e96512,0,Alex Antonenko,2018-05-21 21:03:54+03:00,['4b48c058ffdd2c8453f5ef5aecb84c156ed6ce12'],8,2,10,32243622,1,0,0,0,31645
940268fea4385d684c378843750dd82e7da0770b,1,aBabiichuk,2018-05-21 21:04:15+03:00,['488a8c165ad6c5cb8ad8d3a81ed21c0fea85d30f'],1,1,2,32243624,1,,,,31645
80c4f8977f14fe901b9c62ca22a944294fa9f37e,0,GitHub,2018-05-21 21:22:09+03:00,['940268fea4385d684c378843750dd82e7da0770b'],6,10,16,32243640,1,0.5,1,1,31645
1718ddcaf18d8041d79816664036f5b8f22c391f,0,Jonathan Hurley,2018-05-21 16:42:14-04:00,['80c4f8977f14fe901b9c62ca22a944294fa9f37e'],0,18,18,32243658,1,0,1,0,31645
50f116950b2bc289d28a53bad3b0c0f4f1070900,1,Oliver Szabo,2018-05-21 22:49:27+02:00,['1718ddcaf18d8041d79816664036f5b8f22c391f'],1,24,25,32243683,4,0.454545455,0.454545455,1,31645
ec030bcadd013ca7bd6da46c1b5acef4954e2cff,0,GitHub,2018-05-22 08:18:14+02:00,['50f116950b2bc289d28a53bad3b0c0f4f1070900'],1,1,2,32243685,1,,,,31645
2fd0d503de923d7049d462d935977497549ea2dd,0,Andrii Tkach,2018-05-22 12:47:03+03:00,['ec030bcadd013ca7bd6da46c1b5acef4954e2cff'],29,6,35,32243720,2,0,0,0,31645
5a1c1aaa1ad524465dfa3d6987749228ae4c64c7,0,GitHub,2018-05-22 13:31:08+03:00,"['2fd0d503de923d7049d462d935977497549ea2dd', '533229c0283c5159a9db77692f260e8196e96512']",1,186,187,32243907,3,,,,31645
64838b886b44693ef117575ceeb8cc69ee453c47,1,GitHub,2018-05-22 13:17:56+02:00,['5a1c1aaa1ad524465dfa3d6987749228ae4c64c7'],6,11,17,32243924,1,0,1,0,31645
ceaf5cfb1b79a973724bbe13596213555c5c1893,1,Robert Levas,2018-05-22 08:28:06-04:00,['64838b886b44693ef117575ceeb8cc69ee453c47'],0,346,346,32244270,3,0.335877863,1,0.740458015,31647
223cabc5684ce7ee29a410ec3ac5ac987f9bae96,0,aonishuk,2018-05-22 17:17:04+03:00,['ceaf5cfb1b79a973724bbe13596213555c5c1893'],4,11,15,32244285,3,1,1,1,31647
36c59558924c267f166016a113f89e1e06461bbd,0,GitHub,2018-05-22 18:01:08+03:00,['223cabc5684ce7ee29a410ec3ac5ac987f9bae96'],1,3,4,32244289,1,,,,31647
7b89c5a69f8a0c0cf53085058957f5e69debafd9,0,Andrii Tkach,2018-05-22 18:05:57+03:00,['36c59558924c267f166016a113f89e1e06461bbd'],1,3,4,32244293,2,,,,31647
571dfe62627e786efad31fa35702c61785004dab,1,Dmytro Grinenko,2018-05-22 19:04:20+03:00,['7b89c5a69f8a0c0cf53085058957f5e69debafd9'],317,392,709,32245002,10,0,1,1,31648
84643629d209f973c24a7113c535bc28a5017f53,0,Robert Levas,2018-05-22 12:41:23-04:00,['571dfe62627e786efad31fa35702c61785004dab'],1,1,2,32245004,1,,,,31648
bc6bc7c316d3b58a9cbe30262a8fc6ba1d562029,0,Robert Levas,2018-05-22 19:32:07-04:00,['84643629d209f973c24a7113c535bc28a5017f53'],3,1,4,32245008,1,,,,31648
8a5d25212ada2ab0890dc1c3feb9440fcf402963,0,Yusaku Sako,2018-05-22 19:20:23-07:00,['bc6bc7c316d3b58a9cbe30262a8fc6ba1d562029'],1,0,1,32245009,1,,,,31648
9e07d7460642b36b0d3dd195920ab6aa2a0dd608,1,aBabiichuk,2018-05-23 14:10:44+03:00,['8a5d25212ada2ab0890dc1c3feb9440fcf402963'],33,86,119,32245128,5,0.567567568,1,0.837837838,31648
abb5295f4ae0f1b0f98f4078dfb7bec9718986f6,1,aBabiichuk,2018-05-23 14:10:44+03:00,['9e07d7460642b36b0d3dd195920ab6aa2a0dd608'],13,8,21,32245149,5,0,0,0,31648
a031dba6e3bf355786a2ed70904d8eda6b883cce,0,Andrii Tkach,2018-05-23 16:10:09+03:00,['abb5295f4ae0f1b0f98f4078dfb7bec9718986f6'],1,9,10,32245159,3,1,1,1,31648
7b3aca83483cbc3cad777ba2eadf7015c1234d0d,1,GitHub,2018-05-23 15:45:14-04:00,['a031dba6e3bf355786a2ed70904d8eda6b883cce'],100,558,658,32245817,19,0.496503497,0.692307692,0.846153846,31652
e2ce601032d2dd1f047793aa51d749749017774b,0,GitHub,2018-05-24 11:39:08+05:18,['7b3aca83483cbc3cad777ba2eadf7015c1234d0d'],1,774,775,32246592,2,0,0.905555556,0.905555556,31652
419bfc3b6e372e530f5e2d1ff4c6deec214e5b93,1,aBabiichuk,2018-05-24 11:41:34+03:00,['e2ce601032d2dd1f047793aa51d749749017774b'],4,2,6,32246598,2,,,,31652
8453f1d4078fda328d9e346456018368b62a0511,0,aBabiichuk,2018-05-24 11:41:53+03:00,['419bfc3b6e372e530f5e2d1ff4c6deec214e5b93'],2,31,33,32246631,2,1,1,1,31652
66badb99b71c0c0d89b6f28d7893cab1c009dd33,1,aonishuk,2018-05-24 13:33:37+03:00,['8453f1d4078fda328d9e346456018368b62a0511'],47,147,194,32246825,12,0,0.319444444,0.708333333,31652
e4c790095d7e1940c4b59079999a3f430b9ff592,1,Alex Antonenko,2018-05-24 17:03:44+03:00,['8453f1d4078fda328d9e346456018368b62a0511'],4,11,15,32246840,1,1,1,1,31652
f6d71c7eed083ca0a24a33261dcad05a51e0dadb,0,GitHub,2018-05-24 18:45:19+03:00,"['66badb99b71c0c0d89b6f28d7893cab1c009dd33', 'e4c790095d7e1940c4b59079999a3f430b9ff592']",4,11,15,32246855,1,,,,31652
b93bee5beaa3b095b11700a70290ea415b895ec4,0,avijayanhwx,2018-05-24 09:23:47-07:00,['f6d71c7eed083ca0a24a33261dcad05a51e0dadb'],7,28,35,32246890,3,0.571428571,0.571428571,0,31652
44ddda469fb605ae82dd062cdc17efbc0323a738,0,ncole,2018-05-24 13:13:48-04:00,['b93bee5beaa3b095b11700a70290ea415b895ec4'],44,86,130,32247020,9,0.470588235,0.470588235,0,31652
6880f7d92296d69644a97b0f328904fa12c48eb7,1,GitHub,2018-05-24 19:32:49+02:00,['44ddda469fb605ae82dd062cdc17efbc0323a738'],3,7,10,32247030,2,1,1,1,31652
a7ac282e4c6b26cad34eae7ccff4cf67260e407e,0,GitHub,2018-05-24 10:47:45-07:00,['6880f7d92296d69644a97b0f328904fa12c48eb7'],13,16,29,32247059,2,0,1,1,31652
e9374c954c38d911c6ec1802c8d8452aa20b9fcd,1,GitHub,2018-05-24 14:49:35-04:00,['a7ac282e4c6b26cad34eae7ccff4cf67260e407e'],147,47,194,32247253,12,1,0.680555556,0.291666667,31652
3ea0ad173855ff8a2b37c588261f5ac91e0bf2f2,1,aonishuk,2018-05-25 10:37:01+03:00,['e9374c954c38d911c6ec1802c8d8452aa20b9fcd'],47,147,194,32247447,12,0,0.319444444,0.708333333,31652
34afc06f27382bc7bcf4eb974e071d2533320fbc,0,GitHub,2018-05-25 12:46:44+03:00,['3ea0ad173855ff8a2b37c588261f5ac91e0bf2f2'],1,2,3,32247450,1,1,1,1,31652
9734170d80d4219335c276a84fbf72a33c18fdc9,0,Robert Levas,2018-05-25 07:54:24-04:00,['34afc06f27382bc7bcf4eb974e071d2533320fbc'],34,13,47,32247497,3,0.5,0.5,0.5,31652
e5e29cd8e00042f4dc4e97a6a698311d53e7ce70,0,hiveww,2018-05-25 15:18:40+03:00,['34afc06f27382bc7bcf4eb974e071d2533320fbc'],2,2,4,32247501,1,,,,31652
5f31c16fb3d16c1b0670267d14a8d715699166d0,0,GitHub,2018-05-25 17:40:53+03:00,"['9734170d80d4219335c276a84fbf72a33c18fdc9', 'e5e29cd8e00042f4dc4e97a6a698311d53e7ce70']",2,2,4,32247505,1,,,,31652
28e0fc62635b8eaee681103a896734bddcd61c3d,1,GitHub,2018-05-25 16:52:44+02:00,['5f31c16fb3d16c1b0670267d14a8d715699166d0'],0,455,455,32247960,2,0.486666667,0.51,0.373333333,31653
dd2b807314298bd0915267e9fbf7bcc346ed6f13,0,Siddharth,2018-05-25 08:23:47-07:00,['28e0fc62635b8eaee681103a896734bddcd61c3d'],2,15,17,32247977,1,,,,31653
7b7d47c1925288d3de7cb3833e3bda409102a61f,0,aBabiichuk,2018-05-25 19:17:53+03:00,['dd2b807314298bd0915267e9fbf7bcc346ed6f13'],1,1,2,32247979,1,,,,31653
1af8731d61f24456466478b4428c316e98dc5570,0,aBabiichuk,2018-05-25 19:18:11+03:00,['7b7d47c1925288d3de7cb3833e3bda409102a61f'],10,6,16,32247995,3,0,0,0,31653
a7af9d7ec827e14c6f354dcbd62c57c2252dde70,1,Oliver Szabo,2018-05-25 18:47:35+02:00,['1af8731d61f24456466478b4428c316e98dc5570'],1,20,21,32248016,1,0,0,0,31653
a7a2bd7cd0417eff5809c7f2fadbf31260d25a74,1,Oliver Szabo,2018-05-25 18:47:42+02:00,['a7af9d7ec827e14c6f354dcbd62c57c2252dde70'],0,9,9,32248025,1,0,0,0,31653
fdf9a1cb9898626196701194dc2aa3c08f374e8c,1,GitHub,2018-05-25 12:55:20-04:00,['a7a2bd7cd0417eff5809c7f2fadbf31260d25a74'],147,47,194,32248219,12,1,0.680555556,0.291666667,31653
d9a0929063eea2b57efa09f3e2b153c0c2a293ea,0,Robert Levas,2018-05-25 16:54:33-04:00,['fdf9a1cb9898626196701194dc2aa3c08f374e8c'],7,90,97,32248316,2,0,0.6,1,31653
91009d3ec77c05479ffdfaff7b1fe3a9f94c0332,1,aonishuk,2018-05-27 14:48:45+03:00,['d9a0929063eea2b57efa09f3e2b153c0c2a293ea'],47,147,194,32248510,12,0,0.319444444,0.708333333,31653
b953a6518d0f3e7ddc27e1c01970dd3d0bdae91c,1,Oliver Szabo,2018-05-27 16:23:48+02:00,['91009d3ec77c05479ffdfaff7b1fe3a9f94c0332'],2,62,64,32248574,3,0.454545455,0.454545455,0.818181818,31654
5ef331ae8764b10888dc2db27d85151ac601d477,1,Oliver Szabo,2018-05-27 16:23:48+02:00,['b953a6518d0f3e7ddc27e1c01970dd3d0bdae91c'],0,94,94,32248668,2,,,,31655
4773eb0696468da5f15908580224a13c01f2d799,0,Oliver Szabo,2018-05-27 16:28:09+02:00,['5ef331ae8764b10888dc2db27d85151ac601d477'],0,1,1,32248669,1,0,0,1,31655
59855d15ae93cbb8d5fba3b0498b614d49218314,1,Oliver Szabo,2018-05-28 00:00:44+02:00,['4773eb0696468da5f15908580224a13c01f2d799'],78,749,827,32249496,2,0.345744681,0.406028369,0,31655
cfb9efec4f1728e8744a449652e23ce5656b61b0,1,Oliver Szabo,2018-05-28 13:01:49+02:00,['59855d15ae93cbb8d5fba3b0498b614d49218314'],3,64,67,32249563,1,0.163265306,1,0,31655
d41819dc1ac0bfaee72a8e683e0bbf34416ed1a1,1,Oliver Szabo,2018-05-28 13:55:54+02:00,['cfb9efec4f1728e8744a449652e23ce5656b61b0'],11,41,52,32249615,1,0,0,0.625,31655
9b94c2f3c18d5506b098511697e4062db953bd76,1,Oliver Szabo,2018-05-28 15:37:43+02:00,['d41819dc1ac0bfaee72a8e683e0bbf34416ed1a1'],22,69,91,32249706,2,0.236842105,0.236842105,0.236842105,31655
51927ccd5192ab0883aa450e0736e116ebd8777b,1,Oliver Szabo,2018-05-29 02:53:52+02:00,['9b94c2f3c18d5506b098511697e4062db953bd76'],287,393,680,32250386,3,0.666666667,1,1,31655
70f95fa544211d7e87b8910e8f099540f02f491b,1,GitHub,2018-05-29 14:11:38+03:00,['51927ccd5192ab0883aa450e0736e116ebd8777b'],23,73,96,32250482,16,0,1,0.785714286,31655
40eae549c564d9fbc632bfd4bb6d2dfa5541d3b0,0,GitHub,2018-05-29 14:02:16+02:00,['70f95fa544211d7e87b8910e8f099540f02f491b'],1,1,2,32250484,1,,,,31655
1af26043d8de792bc4b5f588944776e6e9cf7911,0,Alex Antonenko,2018-05-29 15:03:26+03:00,['e4c790095d7e1940c4b59079999a3f430b9ff592'],1,9,10,32250494,2,,,,31655
e410e8c8370430e82105dd371038b77078af8d91,1,GitHub,2018-05-29 14:29:48+02:00,['40eae549c564d9fbc632bfd4bb6d2dfa5541d3b0'],11,17,28,32250522,1,1,1,1,31655
36e41b962c08173227bdc6e140228cb9eef72981,0,Robert Levas,2018-05-29 08:46:38-04:00,['e410e8c8370430e82105dd371038b77078af8d91'],15,79,94,32250616,4,0,0.970588235,1,31655
9a728ffb083ee7de6dd46a8973df5517cd241d18,0,Attila Magyar,2018-05-29 16:57:29+02:00,['36e41b962c08173227bdc6e140228cb9eef72981'],4,43,47,32250663,1,1,1,0.52173913,31655
79b25736b37225f14090daad389538da067d3504,0,GitHub,2018-05-29 18:30:54+03:00,"['9a728ffb083ee7de6dd46a8973df5517cd241d18', '1af26043d8de792bc4b5f588944776e6e9cf7911']",1,9,10,32250673,2,,,,31655
7b893f083bf476c5179d182b034fed59192ed53a,0,Aleksandr Kovalenko,2018-05-29 19:01:59+03:00,['79b25736b37225f14090daad389538da067d3504'],1,3,4,32250677,1,0,0,1,31655
575f126295177297ff43e4d602d5efb4e8fed5d9,1,GitHub,2018-05-29 20:56:19+02:00,['7b893f083bf476c5179d182b034fed59192ed53a'],34,40,74,32250751,2,1,0,0,31655
1fc1a554841e837cad6a70cf030a0849302d7f44,0,GitHub,2018-05-29 12:39:37-07:00,['575f126295177297ff43e4d602d5efb4e8fed5d9'],21273,40259,61532,32312283,8,0,1,0,31655
8a92f3726c8d6d29e84bce97c3489b66f6c52138,0,GitHub,2018-05-29 22:41:14+03:00,['1fc1a554841e837cad6a70cf030a0849302d7f44'],0,90,90,32312373,1,0,1,1,31656
453ac8c6621d1bbad6391f14284714925ee9037e,0,Yusaku Sako,2018-05-29 14:11:07-07:00,['8a92f3726c8d6d29e84bce97c3489b66f6c52138'],0,12,12,32312385,1,,,,31656
2c25deca9b77d14d31019c74c6ef2966740d2548,1,aonishuk,2018-05-30 11:25:13+03:00,['453ac8c6621d1bbad6391f14284714925ee9037e'],413,520,933,32313318,17,1,1,1,31656
f3d627d9de9710e121393f6bd10d8047dfacccae,0,aonishuk,2018-05-30 12:04:49+03:00,['2c25deca9b77d14d31019c74c6ef2966740d2548'],0,9,9,32313327,2,0,0,0,31656
d447ea5195832b3d94ca1c22fade8753b8c096e4,1,GitHub,2018-05-30 14:37:51+03:00,['f3d627d9de9710e121393f6bd10d8047dfacccae'],5,79,84,32313411,8,0,0.068965517,0.068965517,31657
cb94997ea93d5872eb9fcf806b8561f19d0b7f93,0,aonishuk,2018-05-30 15:12:54+03:00,['d447ea5195832b3d94ca1c22fade8753b8c096e4'],3,0,3,32313414,1,1,0,0,31657
8ad4557682389ca84b32f1234f5d685cc1db9787,0,GitHub,2018-05-30 15:44:09+02:00,['cb94997ea93d5872eb9fcf806b8561f19d0b7f93'],1,2,3,32313417,1,,,,31657
e9ef947772feb3c0191c1e36e89d20e31c76f349,1,Andrii Tkach,2018-05-30 17:22:25+03:00,['8ad4557682389ca84b32f1234f5d685cc1db9787'],9,183,192,32313609,9,0.96460177,1,0.973451327,31657
02da908795aa0ba3ee151352b4346911d1a5481e,0,GitHub,2018-05-30 17:02:47+02:00,['e9ef947772feb3c0191c1e36e89d20e31c76f349'],85,225,310,32313919,5,0.802197802,0.802197802,0.736263736,31658
d1744d40f40d393d21fb85ceb084c65bff5733c0,1,Oliver Szabo,2018-05-30 17:06:21+02:00,['02da908795aa0ba3ee151352b4346911d1a5481e'],7,266,273,32314192,7,0.366666667,1,0.24,31658
1909c7b55d859200589c94d6f26d090d0c7deed5,0,Aleksandr Kovalenko,2018-05-30 19:32:01+03:00,['d1744d40f40d393d21fb85ceb084c65bff5733c0'],30,14,44,32314236,2,0,0,0,31658
8d724d7d90c40504ce91b5f09de35e2467e082f9,0,GitHub,2018-05-30 14:25:10-04:00,['1909c7b55d859200589c94d6f26d090d0c7deed5'],11,227,238,32314474,5,0.287671233,0.931506849,1,31659
395714e693eacf4881d8c89d537067c55db99791,0,GitHub,2018-05-30 21:54:36+03:00,['8d724d7d90c40504ce91b5f09de35e2467e082f9'],29,195,224,32314698,10,0.598425197,0.992125984,0.724409449,31659
c935be32ee6ba30e035ade787ba885a14d366a3a,0,GitHub,2018-05-30 21:52:14+02:00,['395714e693eacf4881d8c89d537067c55db99791'],6,6,12,32314710,3,,,,31659
b337817798dadc4b516b71c04775174fbdbf9b9a,0,aBabiichuk,2018-05-30 23:54:06+03:00,['c935be32ee6ba30e035ade787ba885a14d366a3a'],89,109,198,32314908,4,1,1,0.038461538,31659
4292cabf5634ddf94786d43ebdecbd1a45b20e33,0,ncole,2018-05-30 18:28:53-04:00,['b337817798dadc4b516b71c04775174fbdbf9b9a'],10,36,46,32314954,6,0,1,1,31659
c8ab37d040abc1a397d73cb41e0d5e576bacf8bd,0,Robert Levas,2018-05-30 19:51:17-04:00,['4292cabf5634ddf94786d43ebdecbd1a45b20e33'],1,1,2,32314956,1,,,,31659
f2b946adfd21edc9b0ab07d6e6961fa2199cfb19,0,GitHub,2018-05-31 13:49:42+05:18,['c8ab37d040abc1a397d73cb41e0d5e576bacf8bd'],62,189,251,32315207,9,0.097087379,1,0.708737864,31659
4faec13f9b866b94671106c566b2775ae6bbd6e8,1,GitHub,2018-05-31 13:12:31+02:00,['f2b946adfd21edc9b0ab07d6e6961fa2199cfb19'],1,217,218,32315425,2,,,,31659
6bf12068ca0e9bc6c1c997a9261359e6b374f305,1,GitHub,2018-05-31 13:13:54+02:00,['4faec13f9b866b94671106c566b2775ae6bbd6e8'],3,3,6,32315431,3,,,,31659
c5ee7e5838667049b0d5f2c4e4b9b0fe34750c11,1,Oliver Szabo,2018-05-31 13:36:13+02:00,['6bf12068ca0e9bc6c1c997a9261359e6b374f305'],5,5,10,32315441,1,,,,31659
ed1f013086b227471dcb1a17f56c644814fb7706,0,GitHub,2018-05-31 15:35:36+02:00,['c5ee7e5838667049b0d5f2c4e4b9b0fe34750c11'],14,66,80,32315521,6,0.571428571,0,0.80952381,31659
17d5bd4e6f31370e38ed614a76a5c878fb20eb56,0,GitHub,2018-05-31 18:09:52+03:00,['ed1f013086b227471dcb1a17f56c644814fb7706'],5,661,666,32316187,6,,,,31660
c345720106b2894276cd3dbc90500588cb989064,0,GitHub,2018-05-31 17:25:36+02:00,['17d5bd4e6f31370e38ed614a76a5c878fb20eb56'],44,31,75,32316262,1,1,1,1,31660
8d36d51ccd90eb13fa0ef1f1ae4b97a24acfd863,1,GitHub,2018-05-31 19:03:48+03:00,['c345720106b2894276cd3dbc90500588cb989064'],1,11,12,32316274,2,1,1,1,31660
b3f356d013f6bc3cb983dae0266464b1b91db382,0,Aleksandr Kovalenko,2018-05-31 21:54:40+03:00,['8d36d51ccd90eb13fa0ef1f1ae4b97a24acfd863'],13,58,71,32316345,4,1,1,1,31660
7700ee84c0019a8ba0f7c07f57d1009509819cdd,0,GitHub,2018-05-31 15:58:31-04:00,['b3f356d013f6bc3cb983dae0266464b1b91db382'],428,204,632,32316977,34,1,0,1,31660
2d82dd89d6352b7fe3aaae7b6abdde55eeea9bdc,0,Yusaku Sako,2018-05-31 13:49:15-07:00,['7700ee84c0019a8ba0f7c07f57d1009509819cdd'],357,358,715,32317692,1,,,,31660
f20beb60ebed026e0c9e7764fedcd90aeb43bcab,0,aBabiichuk,2018-06-01 00:41:49+03:00,['2d82dd89d6352b7fe3aaae7b6abdde55eeea9bdc'],122,205,327,32318019,18,,,,31663
607fe42f121e9453de3938fcff3f850c89866e0a,0,GitHub,2018-05-31 18:43:44-07:00,['f20beb60ebed026e0c9e7764fedcd90aeb43bcab'],5,587,592,32318611,9,0.109848485,0.712121212,1,31665
c043401740470f6930c230e66780ba2b30432b1b,1,"Doroszlai, Attila",2018-06-01 14:05:46+02:00,['607fe42f121e9453de3938fcff3f850c89866e0a'],15,28,43,32318654,3,1,1,0.888888889,31665
b79e4be51bdf8067958e17998f4e61c92ed98556,0,Eugene Chekanskiy,2018-06-01 16:28:54+03:00,['c043401740470f6930c230e66780ba2b30432b1b'],1,1,2,32318656,1,,,,31665
7b40c1c38c395d4048dd6e7ec967d72c0e86fe8b,1,Oliver Szabo,2018-06-01 16:39:51+02:00,['b79e4be51bdf8067958e17998f4e61c92ed98556'],4,20,24,32318680,2,0,1,0,31665
cd9f0e338ab96dcfe3c88a553718fda79c0011d0,1,Olivér Szabó,2018-06-01 17:14:41+02:00,['7b40c1c38c395d4048dd6e7ec967d72c0e86fe8b'],18,33,51,32318731,4,,,,31665
c9da7e2886ac9388d3d8a2e217643136388b9c9b,1,Siddharth,2018-06-01 09:09:50-07:00,['cd9f0e338ab96dcfe3c88a553718fda79c0011d0'],54,44,98,32318829,3,0.857142857,0.071428571,0.214285714,31665
a6819a872a0ce77b74ced35b091f96668f0e0db1,1,GitHub,2018-06-01 18:57:50+02:00,['c9da7e2886ac9388d3d8a2e217643136388b9c9b'],9,9,18,32318847,2,,,,31665
b75a1648f3f67bd956af742d5f828f19fbf3be1a,0,GitHub,2018-06-01 23:56:30+02:00,['a6819a872a0ce77b74ced35b091f96668f0e0db1'],49,46,95,32318942,7,0.833333333,0,1,31665
be65753b8c9f38cd43570cc17343da7b83602ae7,0,GitHub,2018-06-02 15:14:37+02:00,['b75a1648f3f67bd956af742d5f828f19fbf3be1a'],1,1,2,32318944,1,,,,31665
00ffdc7fce764143369543842749b6b12647d9e5,1,GitHub,2018-06-03 19:45:15+02:00,['be65753b8c9f38cd43570cc17343da7b83602ae7'],1,1,2,32318946,1,,,,31665
d34884e51922f0e394ad50578be2283cf1d2361d,1,Oliver Szabo,2018-06-04 02:54:24+02:00,['00ffdc7fce764143369543842749b6b12647d9e5'],1,1,2,32318948,1,,,,31665
952a474ee6b9e7af06b360928dab5d01b51256a5,0,GitHub,2018-06-04 13:11:11+02:00,['d34884e51922f0e394ad50578be2283cf1d2361d'],1,1,2,32318950,1,,,,31665
c4b8db50c54581fe93fb089f1e62990cfc5435c8,0,aBabiichuk,2018-06-04 15:41:38+03:00,['952a474ee6b9e7af06b360928dab5d01b51256a5'],12,2,14,32318964,2,,,,31665
5cdd641bf2426c241eb737c624c0b5b6acfdfa5f,0,GitHub,2018-06-04 16:34:19+03:00,['c4b8db50c54581fe93fb089f1e62990cfc5435c8'],1,9,10,32318974,1,,,,31665
a9800b0e0d0abd393a05ce7c37d1a3d66bbdff0e,0,Andrii Tkach,2018-06-04 17:23:11+03:00,['5cdd641bf2426c241eb737c624c0b5b6acfdfa5f'],2,86,88,32319062,2,0.672131148,1,0.950819672,31665
f5af2b4946e8104e885799fa978b83975a159bbf,0,GitHub,2018-06-04 16:40:55+02:00,['a9800b0e0d0abd393a05ce7c37d1a3d66bbdff0e'],0,10,10,32319072,1,,,,31665
06089994a73a7b07b266887788546b1153494d10,1,aonishuk,2018-06-04 19:53:46+03:00,['f5af2b4946e8104e885799fa978b83975a159bbf'],30,43,73,32319145,32,0,1,1,31665
68fd2c9fc3e94df6952432941da0bd679ef1c3f5,0,GitHub,2018-06-04 13:32:40-07:00,['06089994a73a7b07b266887788546b1153494d10'],2,2,4,32319149,2,1,1,0,31665
aa134dbd418e3f7e7df858726772605bf073f940,0,aonishuk,2018-06-05 12:04:43+03:00,['68fd2c9fc3e94df6952432941da0bd679ef1c3f5'],5,1,6,32319155,2,0,0,1,31665
9c908b528bece876e8fb291fda2585fdcb20e24b,0,Olivér Szabó,2018-06-05 12:45:34+02:00,['aa134dbd418e3f7e7df858726772605bf073f940'],61,100,161,32319316,2,0.238095238,1,1,31665
fb30561976adbacec740dd8603a9c500b5cea4dd,0,GitHub,2018-06-05 13:56:09+02:00,['9c908b528bece876e8fb291fda2585fdcb20e24b'],3,6,9,32319325,1,1,1,1,31665
5f113f2bea9cad7d8f0ed8d308e5f73ad673b102,0,Aleksandr Kovalenko,2018-06-05 15:55:31+03:00,['fb30561976adbacec740dd8603a9c500b5cea4dd'],0,2,2,32319327,2,,,,31665
3876e39fbd8fca4f2d346b8f5ca419fc82b1c592,0,GitHub,2018-06-05 15:29:08+02:00,['5f113f2bea9cad7d8f0ed8d308e5f73ad673b102'],66,172,238,32319565,17,0.346666667,1,0.706666667,31665
cc7fb90dfc8485afdf71fa95df453247979698b9,0,Siddharth,2018-06-05 11:24:18-07:00,['3876e39fbd8fca4f2d346b8f5ca419fc82b1c592'],10,31,41,32319606,1,1,0.235294118,0.529411765,31665
856a2fc73922d18f530526d61c518ecc29784075,0,GitHub,2018-06-05 16:01:07-04:00,['cc7fb90dfc8485afdf71fa95df453247979698b9'],4,68,72,32319678,5,0,1,1,31665
f7d398f594535ad6e90af93610f94f40eb205a1c,0,Siddharth,2018-06-05 14:30:45-07:00,['856a2fc73922d18f530526d61c518ecc29784075'],41,0,41,32319719,2,1,1,1,31665
ba46c8d4138ba9b35f4f12f10f74994dec0fae7d,0,GitHub,2018-06-05 18:56:21-07:00,['f7d398f594535ad6e90af93610f94f40eb205a1c'],0,22,22,32319741,4,0,0.4,1,31665
009cd2bf675f0ea567a84db2ab681d990f748ffa,0,aBabiichuk,2018-06-06 12:42:36+03:00,['ba46c8d4138ba9b35f4f12f10f74994dec0fae7d'],1,1,2,32319743,1,,,,31665
2727730f243895762d51a35c09846b612bdd646b,0,GitHub,2018-06-06 11:44:32+02:00,['009cd2bf675f0ea567a84db2ab681d990f748ffa'],1,16,17,32319760,1,0,1,0.9,31665
3bffd3c2c6902481b36ff9d15fb3bd2d0710ea64,0,aBabiichuk,2018-06-06 12:45:22+03:00,['2727730f243895762d51a35c09846b612bdd646b'],1,1,2,32319762,1,,,,31665
6482518c1a204f1d6f06b760a29a546bca40447e,0,Robert Levas,2018-06-06 09:37:23-04:00,['3bffd3c2c6902481b36ff9d15fb3bd2d0710ea64'],2,2,4,32319766,1,,,,31665
7ff9098f78aabbac8915c394a10eb0168813217b,1,GitHub,2018-06-06 15:41:09+02:00,['6482518c1a204f1d6f06b760a29a546bca40447e'],1,1,2,32319768,1,,,,31665
1bd7cdb96df0db47c9ce94732051e32fdaa9435b,0,GitHub,2018-06-06 16:15:12+02:00,['7ff9098f78aabbac8915c394a10eb0168813217b'],0,5,5,32319773,2,0,1,1,31665
17d1d4fb6db27520487fb2de49bd6e34cde2b1bb,1,GitHub,2018-06-06 18:57:01+03:00,['1bd7cdb96df0db47c9ce94732051e32fdaa9435b'],8,23,31,32319804,2,1,1,1,31665
269db6f5f44545225addd1a05fb7985378e4087c,0,Aleksandr Kovalenko,2018-06-06 20:54:50+03:00,['17d1d4fb6db27520487fb2de49bd6e34cde2b1bb'],35,71,106,32319910,2,1,1,1,31665
d08278dde2e5fc6bc779fe8e9ecbb32c94284bd2,1,aonishuk,2018-06-07 16:05:11+03:00,['269db6f5f44545225addd1a05fb7985378e4087c'],34,92,126,32320036,15,0.8,0.971428571,0.714285714,31665
d743faf5f1233dac1cf596058f4e054bb4444d47,0,aonishuk,2018-06-07 16:05:11+03:00,['d08278dde2e5fc6bc779fe8e9ecbb32c94284bd2'],2,0,2,32320038,1,1,0,0,31665
78730df4677532a5c9fbba37a301cae588c718a2,0,aBabiichuk,2018-06-07 16:51:02+03:00,['d743faf5f1233dac1cf596058f4e054bb4444d47'],154,172,326,32320364,5,0.80952381,0.80952381,1,31665
8c0452e100c2d5eea043bf9afdecb7693722c3df,0,GitHub,2018-06-07 23:16:32+02:00,['78730df4677532a5c9fbba37a301cae588c718a2'],2,2,4,32320368,1,,,,31665
d27b4454544e98227219e1b7fc0a6c91d905f005,1,GitHub,2018-06-08 06:49:36-04:00,['8c0452e100c2d5eea043bf9afdecb7693722c3df'],163,205,368,32320736,14,0.291666667,0,0,31665
0d2c63bae2aa9baa7440046a3090205f5585095f,1,Olivér Szabó,2018-06-08 13:18:00+02:00,['d27b4454544e98227219e1b7fc0a6c91d905f005'],6,6,12,32320748,1,,,,31665
c48a231302495cbe55a29a0cc44ad53d1debe38b,1,Olivér Szabó,2018-06-08 14:15:39+02:00,['0d2c63bae2aa9baa7440046a3090205f5585095f'],19,20,39,32320787,3,,,,31665
b794b9400db4e79fe8ae3a8ebc5fe0041674f0dc,1,aonishuk,2018-06-08 15:31:13+03:00,['c48a231302495cbe55a29a0cc44ad53d1debe38b'],8,10,18,32320805,3,0,0,0,31665
43a777a368bbddb29e15aa7650cced077b5a7fb4,0,aonishuk,2018-06-08 15:31:13+03:00,['b794b9400db4e79fe8ae3a8ebc5fe0041674f0dc'],1,1,2,32320807,1,,,,31665
f996c0670b8d4eabbe8d5cfdbd2a8fb8fc923a81,0,Andrii Tkach,2018-06-08 16:57:21+03:00,['43a777a368bbddb29e15aa7650cced077b5a7fb4'],19,12,31,32320838,3,0,0,0,31665
39f60f8cc564fb2ae836839af8fa3e417f47e8c6,1,Aleksandr Kovalenko,2018-06-08 18:58:13+03:00,['f996c0670b8d4eabbe8d5cfdbd2a8fb8fc923a81'],1,8,9,32320847,1,1,1,1,31665
60cf7c038773bc3a676070757567039d2100157a,1,Lisnichenko Dmitro,2018-06-08 20:40:37+03:00,['39f60f8cc564fb2ae836839af8fa3e417f47e8c6'],1,2,3,32320850,1,,,,31665
58a676001e582201d0fa4648dd3d29106c80a879,0,GitHub,2018-06-08 19:56:18+02:00,['39f60f8cc564fb2ae836839af8fa3e417f47e8c6'],0,2,2,32320852,1,0,1,0,31665
5529b29b0ba8e20bac7a69ef541539cc9085e709,1,Oliver Szabo,2018-06-08 20:37:30+02:00,['58a676001e582201d0fa4648dd3d29106c80a879'],27,203,230,32321082,6,0.130081301,0.130081301,0.18699187,31666
c314c5b674e44a5a9b883c12f71edeb09f4f8085,0,Ishan Bhatt,2018-06-08 11:45:17-07:00,['5529b29b0ba8e20bac7a69ef541539cc9085e709'],0,1,1,32321083,1,,,,31666
19b8f1c27abe55aeaa007a240121deca49e37a48,0,GitHub,2018-06-08 14:51:36-04:00,['c314c5b674e44a5a9b883c12f71edeb09f4f8085'],4,82,86,32321169,3,0,0.822222222,0.422222222,31666
ad4a3d85250f032305316535831e4f7f08f5c900,0,GitHub,2018-06-11 11:03:48+03:00,"['19b8f1c27abe55aeaa007a240121deca49e37a48', '60cf7c038773bc3a676070757567039d2100157a']",1,2,3,32321172,1,,,,31666
f154f687efafcce6def24d63b6cb764cdd257c5e,1,GitHub,2018-06-11 11:47:06+02:00,['ad4a3d85250f032305316535831e4f7f08f5c900'],0,1,1,32321173,1,,,,31666
1662396ace59fdd8ae8e882308e76013c2fe7677,1,GitHub,2018-06-11 13:25:44+03:00,['f154f687efafcce6def24d63b6cb764cdd257c5e'],73,546,619,32321792,22,0.765306122,0.959183673,0,31668
9462805e5103674a60eb13a5d6730421748f4650,1,Olivér Szabó,2018-06-11 12:48:28+02:00,['1662396ace59fdd8ae8e882308e76013c2fe7677'],1,1,2,32321794,1,,,,31668
fc2537ae8091124ad2d2866f10e0916ae8f10628,1,aonishuk,2018-06-11 15:28:36+03:00,['9462805e5103674a60eb13a5d6730421748f4650'],2,24,26,32321820,3,0,0.8,1,31668
fd81b0b67eaa020c5b7b2fc3d860a0e9969517bf,0,Andrii Tkach,2018-06-11 16:34:09+03:00,['fc2537ae8091124ad2d2866f10e0916ae8f10628'],2,9,11,32321831,4,,,,31668
1ab3bec90b4ff292a801b7fdcf7c12ecf89c2342,1,aBabiichuk,2018-06-11 18:04:33+03:00,['fd81b0b67eaa020c5b7b2fc3d860a0e9969517bf'],2,14,16,32321847,2,0,1,1,31668
d450d69dd00ee0932d17a6e91b8293ad23f6cdf1,1,GitHub,2018-06-11 08:40:11-07:00,['1ab3bec90b4ff292a801b7fdcf7c12ecf89c2342'],67,172,239,32322086,12,0.083333333,0.726190476,0.035714286,31669
6fb7289a0f6e0e732f6bd647493f264ed8969d72,0,GitHub,2018-06-11 19:44:26+03:00,['d450d69dd00ee0932d17a6e91b8293ad23f6cdf1'],13,248,261,32322347,3,0,0.790697674,1,31669
e53435573a78726c7276919581e8ea8feb2b3c1f,0,Aleksandr Kovalenko,2018-06-11 20:38:51+03:00,['6fb7289a0f6e0e732f6bd647493f264ed8969d72'],1,3,4,32322351,1,1,1,1,31669
ab70364cf6432f71952f36d012e16cb2373f9a94,0,GitHub,2018-06-11 14:08:52-04:00,['e53435573a78726c7276919581e8ea8feb2b3c1f'],6,35,41,32322392,2,0.666666667,0.666666667,0.666666667,31669
ed0c26bb555a12ba9d8083e33306dcfeb92fce68,0,Oliver Szabo,2018-06-11 22:23:05+02:00,['ab70364cf6432f71952f36d012e16cb2373f9a94'],2,0,2,32322394,1,,,,31669
6107459bb6960d3315e508ff63ea573be4c93cc9,0,Ishan Bhatt,2018-06-11 13:31:30-07:00,['ed0c26bb555a12ba9d8083e33306dcfeb92fce68'],1,2,3,32322397,1,,,,31669
5cda3d3cd683063c77e0374b6bc50a398cf70097,1,aonishuk,2018-06-12 10:51:39+03:00,['6107459bb6960d3315e508ff63ea573be4c93cc9'],2,19,21,32322418,1,0,1,1,31669
44748d9513a3bd57e620b9087b393e28a54d5445,1,aonishuk,2018-06-12 10:51:39+03:00,['5cda3d3cd683063c77e0374b6bc50a398cf70097'],1,1,2,32322420,1,,,,31669
f7fe7f9d186c3299b38e1917bb5834d921616405,0,aonishuk,2018-06-12 10:51:39+03:00,['44748d9513a3bd57e620b9087b393e28a54d5445'],2,2,4,32322424,1,,,,31669
1f4cbb161db8acb9f095ff2078a4d1ac99d64260,0,Aleksandr Kovalenko,2018-06-12 15:57:13+03:00,['f7fe7f9d186c3299b38e1917bb5834d921616405'],11,10,21,32322445,3,1,1,1,31669
709b43baacb9df32268d586f3c8682e7215141cf,0,GitHub,2018-06-12 09:49:29-04:00,['1f4cbb161db8acb9f095ff2078a4d1ac99d64260'],41,150,191,32322636,3,0,0.740740741,1,31670
62cf44218f8139c720b78f2ac3920ae4f8180118,0,GitHub,2018-06-12 13:33:02-04:00,['709b43baacb9df32268d586f3c8682e7215141cf'],6,0,6,32322642,1,,,,31670
1bc74fae3879cef6f57a73b23dbe4cec98df0de3,0,aBabiichuk,2018-06-12 23:56:54+03:00,['62cf44218f8139c720b78f2ac3920ae4f8180118'],423,63,486,32323128,4,0,1,1,31670
3fbc357f3a972e2e987c56af17e1aac64d91c828,0,aBabiichuk,2018-06-13 01:03:02+03:00,['1bc74fae3879cef6f57a73b23dbe4cec98df0de3'],1,21,22,32323150,1,0.916666667,0.958333333,1,31670
92a3cc61865365eb4ae1d35fc8adf0866258c282,0,aonishuk,2018-06-13 09:56:27+03:00,['3fbc357f3a972e2e987c56af17e1aac64d91c828'],2,1,3,32323153,2,,,,31670
d623dd530d9ba3ebc05211ac982093c0c7f5bcdf,1,GitHub,2018-06-13 13:53:29+03:00,['92a3cc61865365eb4ae1d35fc8adf0866258c282'],13,26,39,32323192,1,1,0,1,31670
4c877c8f7e57b68068a41dff38c5b7cab3fbb8ce,1,GitHub,2018-06-13 15:02:09+03:00,['d623dd530d9ba3ebc05211ac982093c0c7f5bcdf'],29,186,215,32323407,6,0,1,1,31673
dd2f43574aaeea0d05e42d81348eb34077fb08e1,0,GitHub,2018-06-13 15:14:27+02:00,['4c877c8f7e57b68068a41dff38c5b7cab3fbb8ce'],6,13,19,32323426,2,0,0,0,31673
5a02c139cb792696358413091b7df73694495a6a,0,Andrii Tkach,2018-06-13 16:45:09+03:00,['dd2f43574aaeea0d05e42d81348eb34077fb08e1'],4,5,9,32323435,2,1,1,1,31673
58fdcab8d348b7fa6ad7624bafc9da89429350ce,0,GitHub,2018-06-13 12:15:28-04:00,['5a02c139cb792696358413091b7df73694495a6a'],7,54,61,32323496,2,0,0,1,31673
dbfc6a045856ce1050f434c0f72810258c7075f5,0,Robert Levas,2018-06-13 12:18:08-04:00,['58fdcab8d348b7fa6ad7624bafc9da89429350ce'],15,116,131,32323627,5,0.622641509,0.924528302,1,31673
85c544c118d6fd5b08aad5b826c2e224fd5c026d,0,Ishan Bhatt,2018-06-13 10:21:14-07:00,['dbfc6a045856ce1050f434c0f72810258c7075f5'],1,5,6,32323633,1,1,0,1,31673
8d2336edfb8f94aa69f4d67233523e0d852a109f,1,Miklos Gergely,2018-06-13 19:26:48+02:00,['85c544c118d6fd5b08aad5b826c2e224fd5c026d'],0,96,96,32323729,2,1,1,0.744680851,31674
390697530ddd2995e9bcaa06e8fcfeecbc191e15,1,Siddharth,2018-06-13 17:27:59-07:00,['8d2336edfb8f94aa69f4d67233523e0d852a109f'],6,48,54,32323783,1,1,1,1,31674
5de78a9546e5cb9c0d9f5f33b46a113181e377a7,1,Andrii Tkach,2018-06-14 12:46:48+03:00,['390697530ddd2995e9bcaa06e8fcfeecbc191e15'],1,1,2,32323785,1,,,,31674
69f7bae42103f716d381a14357696569d394dda6,0,Aleksandr Kovalenko,2018-06-14 13:43:50+03:00,['5de78a9546e5cb9c0d9f5f33b46a113181e377a7'],1,1,2,32323787,1,,,,31674
b67a455f1441b8569e1c563285d59d58efb7c07c,1,Lisnichenko Dmitro,2018-06-14 14:32:54+03:00,['69f7bae42103f716d381a14357696569d394dda6'],2,5,7,32323794,1,0,1,0,31674
e11bab6b4247d3e957f1104679ccb9f6d98a7ef9,1,GitHub,2018-06-14 13:46:03+02:00,['69f7bae42103f716d381a14357696569d394dda6'],0,2,2,32323796,1,,,,31674
f1334dcdee050598019af49c4aef90c6d3f85871,0,aBabiichuk,2018-06-14 15:40:59+03:00,['e11bab6b4247d3e957f1104679ccb9f6d98a7ef9'],28,180,208,32324004,6,0.411764706,1,1,31674
2d925a47011283d25bb31fd7c16dce21defb7356,1,GitHub,2018-06-14 16:06:16+02:00,['f1334dcdee050598019af49c4aef90c6d3f85871'],0,6,6,32324010,1,,,,31674
81e51d37f68b66f52314aa1bdb7d516d201e91a1,0,Alex Antonenko,2018-06-14 17:11:22+03:00,['5de78a9546e5cb9c0d9f5f33b46a113181e377a7'],19,43,62,32324072,2,1,1,1,31674
451cdacb6bd6549de297ef4c995111a6e01832f6,0,aonishuk,2018-06-14 19:08:49+03:00,['2d925a47011283d25bb31fd7c16dce21defb7356'],1,13,14,32324086,1,0,0.4,1,31674
484cd10cf4066926cd8715821d9f5eb29e1c273b,1,aonishuk,2018-06-14 19:08:49+03:00,['451cdacb6bd6549de297ef4c995111a6e01832f6'],0,3,3,32324089,1,0,0,1,31674
0536321d662e6ac247b43788bada7a01c466bb43,0,GitHub,2018-06-14 13:12:31-07:00,['484cd10cf4066926cd8715821d9f5eb29e1c273b'],1,5,6,32324095,1,,,,31674
c2276076a93cd5238922be5ea9ab6901bf524afa,0,GitHub,2018-06-15 11:01:32+03:00,"['0536321d662e6ac247b43788bada7a01c466bb43', '81e51d37f68b66f52314aa1bdb7d516d201e91a1']",19,43,62,32324157,2,,,,31674
2eb647ae4bdee823e1839b8ded83afb004b58960,0,GitHub,2018-06-15 11:53:25+03:00,['c2276076a93cd5238922be5ea9ab6901bf524afa'],0,16,16,32324173,2,0,0.769230769,1,31674
6176223dd88dca457178abb0296c6d2eb6e704a4,0,Lisnichenko Dmitro,2018-06-15 14:03:46+03:00,['b67a455f1441b8569e1c563285d59d58efb7c07c'],5,44,49,32324222,2,0.433333333,1,1,31674
3b9a4cf19330e04b55914f1ead858a1b4257f52a,0,Alex Antonenko,2018-06-15 16:45:18+03:00,['c2276076a93cd5238922be5ea9ab6901bf524afa'],0,24,24,32324246,1,,,,31674
7690892bdbe405e5d39c063b716aa3d3ccf65ab7,0,Alex Antonenko,2018-06-15 17:08:23+03:00,['c2276076a93cd5238922be5ea9ab6901bf524afa'],1,1,2,32324248,1,,,,31674
9e1d6d677d7bec17e9834704ef8e8f5ecea9660c,0,Alex Antonenko,2018-06-15 17:12:57+03:00,['7690892bdbe405e5d39c063b716aa3d3ccf65ab7'],1,1,2,32324250,1,,,,31674
2e31e81b3df1aa5ff746d8550fdfc302341c101e,0,GitHub,2018-06-15 17:31:49+03:00,"['2eb647ae4bdee823e1839b8ded83afb004b58960', '6176223dd88dca457178abb0296c6d2eb6e704a4']",0,42,42,32324292,2,,,,31674
ae72be150e1d5e270405109e53b7c57d1e3c705c,0,Andrii Tkach,2018-06-15 17:58:21+03:00,['2e31e81b3df1aa5ff746d8550fdfc302341c101e'],4,4,8,32324300,1,,,,31674
14e8bcd5d7c8bfb2c5568372a2af5ff763b61af4,0,aBabiichuk,2018-06-15 18:08:16+03:00,['ae72be150e1d5e270405109e53b7c57d1e3c705c'],1,23,24,32324324,1,0.045454545,0.272727273,1,31674
92044950c04d617ffa51645ab7bf64255f4060ce,0,GitHub,2018-06-15 18:36:14+03:00,"['14e8bcd5d7c8bfb2c5568372a2af5ff763b61af4', '3b9a4cf19330e04b55914f1ead858a1b4257f52a']",0,24,24,32324348,1,,,,31674
264347cdaf5a23ecb32a30f16f5fda25f9152fb5,0,Ishan Bhatt,2018-06-15 09:00:50-07:00,['92044950c04d617ffa51645ab7bf64255f4060ce'],7,25,32,32324380,4,0.416666667,0.583333333,1,31674
acffdfcadf7c6da900f1adc5b1d059010904ebe0,1,GitHub,2018-06-15 20:18:24+03:00,['264347cdaf5a23ecb32a30f16f5fda25f9152fb5'],27,22,49,32324429,4,1,0,0,31674
623834fa0527fb4534cd2ee84270c43d42996447,1,Sandor Molnar,2018-06-15 21:58:37+02:00,['acffdfcadf7c6da900f1adc5b1d059010904ebe0'],2,2,4,32324433,1,,,,31674
e691c7bcde8fd36b343b274da7b4ca41068296fa,1,Oliver Szabo,2018-06-16 02:22:39+02:00,['623834fa0527fb4534cd2ee84270c43d42996447'],187,562,749,32325182,11,0.46,0.575,0.235,31678
16a19c9a16bc25917479533fbc6e222c7f4be1bd,1,Oliver Szabo,2018-06-16 02:24:34+02:00,['e691c7bcde8fd36b343b274da7b4ca41068296fa'],2,2,4,32325186,1,,,,31678
b1be2036a206aec2b06fbb305104fee2bc455258,0,Aleksandr Kovalenko,2018-06-16 13:33:05+03:00,['16a19c9a16bc25917479533fbc6e222c7f4be1bd'],2,2,4,32325190,1,,,,31678
9675d3ccb353bd127f125ccc0b63c26bcdedf01a,0,GitHub,2018-06-16 15:27:01+03:00,"['b1be2036a206aec2b06fbb305104fee2bc455258', '9e1d6d677d7bec17e9834704ef8e8f5ecea9660c']",2,2,4,32325194,2,,,,31678
e57478e712a58813e992f96cfe7c6a04835daab1,0,GitHub,2018-06-16 15:05:30+02:00,['9675d3ccb353bd127f125ccc0b63c26bcdedf01a'],0,4,4,32325198,1,0,1,1,31678
5f6def16da9c036b49e21b7f6065c0aedadb818f,0,Aleksandr Kovalenko,2018-06-16 16:11:57+03:00,['e57478e712a58813e992f96cfe7c6a04835daab1'],0,3,3,32325201,1,,,,31678
5cd6b30b53f43fc9f24e96c85ae2e1367864c949,0,aBabiichuk,2018-06-16 19:19:20+03:00,['5f6def16da9c036b49e21b7f6065c0aedadb818f'],6,18,24,32325225,3,0.625,0,1,31678
172f6731ee804d846b450bd1d462eddb9a8b45a7,0,Oliver Szabo,2018-06-16 18:52:16+02:00,['5cd6b30b53f43fc9f24e96c85ae2e1367864c949'],16,0,16,32325241,4,0,0,0,31678
d5e8fbe11c2e4c3615bd2553f94e2dc577c515fe,1,GitHub,2018-06-17 00:44:35+02:00,['172f6731ee804d846b450bd1d462eddb9a8b45a7'],5,63,68,32325309,5,0,0.654545455,0.654545455,31678
648fdaa217b7483e89fb482ef436bd88978825d3,0,GitHub,2018-06-17 00:45:52+02:00,['d5e8fbe11c2e4c3615bd2553f94e2dc577c515fe'],0,127,127,32325436,2,1,0.416666667,0.416666667,31679
cd9816860b04115449dd9cd530f382e6c5acc905,1,GitHub,2018-06-17 16:26:54+03:00,['648fdaa217b7483e89fb482ef436bd88978825d3'],24,53,77,32325513,3,0,1,1,31679
331d7d9c096e1357395a30a10a584f177218498a,1,Oliver Szabo,2018-06-17 17:55:40+02:00,['cd9816860b04115449dd9cd530f382e6c5acc905'],16,25,41,32325554,4,1,0,0,31680
9f9042c17e3edbac68df2b6ba48b4b980e92b858,1,Oliver Szabo,2018-06-17 17:55:40+02:00,['331d7d9c096e1357395a30a10a584f177218498a'],8,53,61,32325615,1,0,0,0,31680
c28a1cab692dcac77c9abf2547c7cecc7b30bc85,1,Oliver Szabo,2018-06-18 00:39:43+02:00,['9f9042c17e3edbac68df2b6ba48b4b980e92b858'],2,53,55,32325670,1,0,0,0.479166667,31680
d9b7a28430cddc2f0388301a18843fb8f89f622b,0,Andrii Tkach,2018-06-18 10:39:52+03:00,['c28a1cab692dcac77c9abf2547c7cecc7b30bc85'],36,36,72,32325742,5,1,1,1,31680
f066336aab2dba4e26fc5076ef1977a7723838e4,0,Alex Antonenko,2018-06-18 12:17:17+03:00,['d9b7a28430cddc2f0388301a18843fb8f89f622b'],0,8,8,32325750,1,,,,31680
543dc9fea00f3f1dd7196bec6b6c1c458039fa21,0,GitHub,2018-06-18 12:16:03+02:00,['d9b7a28430cddc2f0388301a18843fb8f89f622b'],0,16,16,32325766,3,,,,31680
0f7994c1ac0d173eae672db55e68581e7d519451,0,Lisnichenko Dmitro,2018-06-18 13:58:39+03:00,['543dc9fea00f3f1dd7196bec6b6c1c458039fa21'],1,1,2,32325768,1,,,,31680
3eeeaa586d58c980a3de5a338771bb3f545a6db1,0,GitHub,2018-06-18 14:01:23+03:00,"['543dc9fea00f3f1dd7196bec6b6c1c458039fa21', 'f066336aab2dba4e26fc5076ef1977a7723838e4']",0,8,8,32325776,1,,,,31680
de66866348fad4a3864825635d21771a83a252d4,0,Aleksandr Kovalenko,2018-06-18 14:12:36+03:00,['3eeeaa586d58c980a3de5a338771bb3f545a6db1'],7,3,10,32325786,1,0,0,0,31680
a5d4deab194c8372419e671ef2ceef6ccb8b7567,0,GitHub,2018-06-18 15:01:35+03:00,"['de66866348fad4a3864825635d21771a83a252d4', '0f7994c1ac0d173eae672db55e68581e7d519451']",1,1,2,32325788,1,,,,31680
8c78a1c1009d10e5b4e9036a09a4256202cb4439,0,Andrii Tkach,2018-06-18 16:15:57+03:00,['a5d4deab194c8372419e671ef2ceef6ccb8b7567'],2,4,6,32325794,1,1,1,1,31680
8a80ada9d2bff6ae54a523805e4f3d1c569bb738,0,Oliver Szabo,2018-06-18 15:46:27+02:00,['8c78a1c1009d10e5b4e9036a09a4256202cb4439'],2,2,4,32325798,1,,,,31680
4cbd9696aafa7bab9466cfd38b1e8b83691dfc3a,1,Oliver Szabo,2018-06-18 16:56:01+02:00,['8a80ada9d2bff6ae54a523805e4f3d1c569bb738'],11,10,21,32325819,1,1,1,1,31680
4635cbbccfc1da3ca373324880d14f103201813e,0,GitHub,2018-06-18 11:07:00-04:00,['4cbd9696aafa7bab9466cfd38b1e8b83691dfc3a'],3,2,5,32325824,3,,,,31680
d22f30e5fa9ab4da7976665566fbb4dd6cc4da17,0,aBabiichuk,2018-06-19 00:04:51+03:00,['4635cbbccfc1da3ca373324880d14f103201813e'],38,20,58,32325882,1,1,0,0,31680
34919e23e829fd83e92b7b57cd740a6f6a8fd169,0,GitHub,2018-06-19 09:18:19+05:18,['d22f30e5fa9ab4da7976665566fbb4dd6cc4da17'],59176,1,59177,32385059,411,0.46137614,0.213957344,0.26535534,31680
3ba2ce3e2b7b708687a1f4fb37e5e44c333cc646,0,Andrii Tkach,2018-06-19 14:53:43+03:00,['34919e23e829fd83e92b7b57cd740a6f6a8fd169'],1,2,3,32385062,1,1,1,1,31680
7b6c3bcf7950dcb5f6deaae6c72c1ba78b47b540,0,Aleksandr Kovalenko,2018-06-19 17:05:53+03:00,['3ba2ce3e2b7b708687a1f4fb37e5e44c333cc646'],0,6,6,32385068,1,,,,31680
24244f68b138638c58ad9d180eea449a5ff99178,1,GitHub,2018-06-19 07:35:21-07:00,['7b6c3bcf7950dcb5f6deaae6c72c1ba78b47b540'],130,27,157,32385225,4,0.546391753,0,0,31680
166d3a69cf27f62a8e9cce9d820b6a319e6f5f2c,1,Oliver Szabo,2018-06-19 16:49:23+02:00,['24244f68b138638c58ad9d180eea449a5ff99178'],10,54,64,32385289,2,,,,31680
9ff13b2d7c080ccd81ace1e70bd9a941032d8c55,0,GitHub,2018-06-19 08:33:36-07:00,['166d3a69cf27f62a8e9cce9d820b6a319e6f5f2c'],9,30,39,32385328,5,0.769230769,1,1,31680
5273ffcb3c81334500ef063224681a3ddb3ddd21,0,Oliver Szabo,2018-06-20 02:26:07+02:00,['9ff13b2d7c080ccd81ace1e70bd9a941032d8c55'],5,0,5,32385333,2,1,1,1,31680
f7cafb81a29106e2397c720a4cea2ae645089356,1,Oliver Szabo,2018-06-20 02:26:07+02:00,['5273ffcb3c81334500ef063224681a3ddb3ddd21'],12,27,39,32385372,1,0,0,0,31680
690295bb867e3f357cd438e3d72f75a856032902,1,Oliver Szabo,2018-06-20 02:26:07+02:00,['f7cafb81a29106e2397c720a4cea2ae645089356'],1,8,9,32385381,1,,,,31680
35f6d16fccce5eebac5a1dfbc1147b84ffa5cec7,1,Oliver Szabo,2018-06-20 12:46:55+02:00,['690295bb867e3f357cd438e3d72f75a856032902'],1,1,2,32385383,1,,,,31680
b2db89c3800caf0248ea61a392a0671201bcf26f,1,Olivér Szabó,2018-06-20 15:02:17+02:00,['35f6d16fccce5eebac5a1dfbc1147b84ffa5cec7'],24,107,131,32385514,6,0.923076923,1,1,31680
f8585251be9bfe478ae63522829be766456e7e8c,0,Ishan Bhatt,2018-06-20 08:47:51-07:00,['b2db89c3800caf0248ea61a392a0671201bcf26f'],14,24,38,32385552,4,0,1,0,31680
087d4db9b05dc1d4d24acd548c498ee797ec3068,0,GitHub,2018-06-20 15:14:13-04:00,['f8585251be9bfe478ae63522829be766456e7e8c'],171,200,371,32385923,17,1,1,0,31681
5ec93487c1f7f38e34a50192aa8ffea2f7e93601,1,GitHub,2018-06-20 21:16:47+02:00,['087d4db9b05dc1d4d24acd548c498ee797ec3068'],2,3,5,32385928,1,0,1,1,31681
6cef8cba5ba10eda7cbc042ece75f31506c902ca,0,Yusaku Sako,2018-06-20 12:32:55-07:00,['5ec93487c1f7f38e34a50192aa8ffea2f7e93601'],0,1,1,32385929,1,1,1,1,31681
7aba3bfb3ad67a85a6b35a8145fb437d0f8cebbd,1,Yusaku Sako,2018-06-20 12:33:44-07:00,['6cef8cba5ba10eda7cbc042ece75f31506c902ca'],0,47,47,32385976,1,0.973684211,1,1,31681
804bfa0ed580e7447d922f69d4a0d5d729f2ef8b,0,Yusaku Sako,2018-06-20 12:33:44-07:00,['7aba3bfb3ad67a85a6b35a8145fb437d0f8cebbd'],3,3,6,32385982,1,0,0,0,31681
b72fc2f8bbfd17c340f9c94023a83435d73167c5,1,Yusaku Sako,2018-06-20 12:35:25-07:00,['804bfa0ed580e7447d922f69d4a0d5d729f2ef8b'],7,43,50,32386032,4,1,1,1,31681
8f7bffc6a930154f6e5bf49e3761ce078f69de6a,0,Yusaku Sako,2018-06-20 12:35:25-07:00,['b72fc2f8bbfd17c340f9c94023a83435d73167c5'],2,7,9,32386041,1,,,,31681
c3ccc4eb89370ef0f1983dd07dc1601d18d53d20,1,Oliver Szabo,2018-06-21 01:17:55+02:00,['8f7bffc6a930154f6e5bf49e3761ce078f69de6a'],1,43,44,32386085,5,0.59375,0.625,0.84375,31681
5960d2a219b5a2bf464c6021a90886b8decf956d,1,Oliver Szabo,2018-06-21 01:17:55+02:00,['c3ccc4eb89370ef0f1983dd07dc1601d18d53d20'],69,126,195,32386280,1,0.301886792,0.301886792,0.301886792,31681
303ba2e18eebcb3aa7d89104a1b2ecff702b44b4,0,Dmytro Grinenko,2018-06-21 16:05:41+03:00,['5960d2a219b5a2bf464c6021a90886b8decf956d'],16,13,29,32386309,1,1,1,0,31681
736722dfd28e2acb480ad45d2d4b3ba8b8f609bb,1,GitHub,2018-06-21 16:49:03+03:00,['303ba2e18eebcb3aa7d89104a1b2ecff702b44b4'],6,146,152,32386461,5,0.203883495,0.203883495,1,31681
fa1542dd7f703bace1b3642f500ee2b241cdd46d,1,Miklos Gergely,2018-06-21 16:56:49+02:00,['736722dfd28e2acb480ad45d2d4b3ba8b8f609bb'],6,6,12,32386473,1,,,,31681
9ce3191371701ebdc4cafd830b8b2712dc293d25,1,Oliver Szabo,2018-06-22 03:38:43+02:00,['fa1542dd7f703bace1b3642f500ee2b241cdd46d'],1,12,13,32386486,1,1,1,0,31681
c492689e54a5258a7464584965e443fc430bb017,1,GitHub,2018-06-22 11:21:55+03:00,['9ce3191371701ebdc4cafd830b8b2712dc293d25'],192,491,683,32387169,24,0.216374269,0.421052632,0.888888889,31684
368a42b2ae2d894983e3158ff1faed6e2197b9eb,0,pallavkul,2018-06-22 14:20:29+05:18,['9ce3191371701ebdc4cafd830b8b2712dc293d25'],0,3,3,32387172,1,,,,31684
939a33c5590f5e26b7fa9940737dd419ae076db4,1,GitHub,2018-06-22 12:09:32+02:00,['c492689e54a5258a7464584965e443fc430bb017'],36,68,104,32387276,1,0.09375,0.125,0.25,31684
e6b407efeba08811d154bcdfad4476881a55020e,0,GitHub,2018-06-22 15:52:58+05:18,"['939a33c5590f5e26b7fa9940737dd419ae076db4', '368a42b2ae2d894983e3158ff1faed6e2197b9eb']",0,3,3,32387279,1,,,,31684
00207e32533fa5baa7babef8f64f465ad50cb109,1,Oliver Szabo,2018-06-22 13:14:27+02:00,['e6b407efeba08811d154bcdfad4476881a55020e'],6,23,29,32387308,1,,,,31684
e72db1d82867abb30819793defc05cae96f67aec,1,GitHub,2018-06-22 15:29:55+02:00,['00207e32533fa5baa7babef8f64f465ad50cb109'],35,105,140,32387448,1,,,,31684
00274d4e25bbffbd21d4eb8fdecf47b70c68c7da,0,GitHub,2018-06-22 16:58:14+03:00,['e72db1d82867abb30819793defc05cae96f67aec'],379,131,510,32387958,11,0.675324675,0.149350649,0.071428571,31684
9de13143c39224476526429e3a296dd970a28228,0,Miklos Gergely,2018-06-22 17:01:43+02:00,['00274d4e25bbffbd21d4eb8fdecf47b70c68c7da'],1,5,6,32387964,1,1,1,1,31684
b3fc86d3b7dbca42839109ab507ee21d308a66fe,0,Andrii Tkach,2018-06-22 18:34:08+03:00,['9de13143c39224476526429e3a296dd970a28228'],1,1,2,32387966,1,,,,31684
55679e53f1b464f1e17c8695deda01ba7352de04,1,GitHub,2018-06-22 18:26:37+02:00,['b3fc86d3b7dbca42839109ab507ee21d308a66fe'],3,26,29,32387995,1,,,,31684
30b66022f2dd307f421bdb7e0b250c5755940492,1,GitHub,2018-06-22 18:30:54+02:00,['55679e53f1b464f1e17c8695deda01ba7352de04'],1,1,2,32387997,1,,,,31684
2357dd2537e246c858c599332e7b3830d0701610,1,avijayanhwx,2018-06-22 13:35:51-07:00,['30b66022f2dd307f421bdb7e0b250c5755940492'],469,154,623,32388620,23,0.74301676,0.553072626,0.055865922,31684
f439ce837b18966e29f200c646af1ca48875dabe,0,aonishuk,2018-06-23 13:20:51+03:00,['2357dd2537e246c858c599332e7b3830d0701610'],1,3,4,32388624,1,0,0,1,31684
a45643d03bdbc1a88cbe871d74cc9eb6e8c97222,1,Oliver Szabo,2018-06-23 16:09:41+02:00,['f439ce837b18966e29f200c646af1ca48875dabe'],35,314,349,32388973,4,0,0,0,31685
97e5134e28ea7990a7a665edd90e2bbe7fcaa817,1,Oliver Szabo,2018-06-24 19:11:53+02:00,['a45643d03bdbc1a88cbe871d74cc9eb6e8c97222'],49,276,325,32389298,3,0.163636364,0.309090909,0,31685
b71d73fe8dd8ab07b0dc6d2520722b6423fdf45e,1,Oliver Szabo,2018-06-25 02:51:47+02:00,['97e5134e28ea7990a7a665edd90e2bbe7fcaa817'],28,125,153,32389451,2,0.202531646,0.493670886,0.202531646,31685
99c74ef0608f2f27d0c524ea6379658f479af982,1,Oliver Szabo,2018-06-25 03:56:49+02:00,['b71d73fe8dd8ab07b0dc6d2520722b6423fdf45e'],2,30,32,32389483,1,0.956521739,0.304347826,0.304347826,31685
6e849e91e751439c79bd44a614ded9aaf43ce094,0,GitHub,2018-06-25 12:03:25+02:00,['99c74ef0608f2f27d0c524ea6379658f479af982'],1,1,2,32389485,1,,,,31685
0396923c0a97cd63fec7b5e8d9f2cc0ddde54005,1,Oliver Szabo,2018-06-25 13:58:04+02:00,['6e849e91e751439c79bd44a614ded9aaf43ce094'],1,1,2,32389487,1,,,,31685
ea9eb5b4a023ce1afdfc80376bfa2d85f828b4eb,1,GitHub,2018-06-25 06:31:33-07:00,['0396923c0a97cd63fec7b5e8d9f2cc0ddde54005'],20,164,184,32389671,6,0,0.361904762,1,31685
305a1c056e93a2250008f6aebeb708c83889100c,0,GitHub,2018-06-25 15:54:41+02:00,['ea9eb5b4a023ce1afdfc80376bfa2d85f828b4eb'],22,42,64,32389735,1,1,1,1,31685
934a18d65559cde7255fd8c49079e325f67fb3fd,1,Oliver Szabo,2018-06-25 16:20:31+02:00,['305a1c056e93a2250008f6aebeb708c83889100c'],22,55,77,32389812,3,,,,31685
60e080f37be6ec801e10ef44a3e8de667bd99634,1,Oliver Szabo,2018-06-25 16:39:07+02:00,['934a18d65559cde7255fd8c49079e325f67fb3fd'],3,3,6,32389818,1,,,,31685
e6460b106f3688a8598087eaacee5489bb36703f,0,Andrii Tkach,2018-06-25 18:41:01+03:00,['60e080f37be6ec801e10ef44a3e8de667bd99634'],2,2,4,32389822,1,,,,31685
2c7fa515ec5e79fe818d4dfd641622d3c1dee2b6,1,GitHub,2018-06-25 19:25:24+02:00,['e6460b106f3688a8598087eaacee5489bb36703f'],1,6,7,32389829,2,,,,31685
5460e8952729854f1c032a781c9a8de608ba4475,1,GitHub,2018-06-25 22:10:56+03:00,['2c7fa515ec5e79fe818d4dfd641622d3c1dee2b6'],145,262,407,32390236,5,0,0.5,0.759259259,31686
8fb5e54776062c52b847fb01b0d7690b794c04d4,0,GitHub,2018-06-25 21:22:39+02:00,['5460e8952729854f1c032a781c9a8de608ba4475'],2,3,5,32390241,1,,,,31686
fbc0b10ab8331396fffb5fd18f9fc68e16452a69,1,Lisnichenko Dmitro,2018-06-25 23:26:55+03:00,['8fb5e54776062c52b847fb01b0d7690b794c04d4'],5,67,72,32390313,6,0.113207547,0.113207547,0.113207547,31686
8b2484efa3b4ea6c678a036c4f01fea86772aa08,0,Yusaku Sako,2018-06-25 14:04:17-07:00,['8fb5e54776062c52b847fb01b0d7690b794c04d4'],2,19,21,32390334,5,,,,31689
c7ca22ac90008814b1f1dfeaa51f2e670f183a41,0,Miklos Gergely,2018-06-26 11:34:22+02:00,['8b2484efa3b4ea6c678a036c4f01fea86772aa08'],1,1,2,32390336,1,,,,31689
df5bc5cd12302afdbaf3f6a3fd5db3fb71851be3,0,aonishuk,2018-06-26 13:11:49+03:00,['c7ca22ac90008814b1f1dfeaa51f2e670f183a41'],8,1,9,32390345,1,,,,31689
4992284e956be47272c4a5305ce0bba98b86dd37,0,GitHub,2018-06-26 11:24:35-04:00,['df5bc5cd12302afdbaf3f6a3fd5db3fb71851be3'],1,79,80,32390425,3,0,1,1,31690
9fabbe90896ddaa7560add6cbc21b4777990ddad,1,GitHub,2018-06-26 17:27:28+02:00,['4992284e956be47272c4a5305ce0bba98b86dd37'],7,7,14,32390439,1,,,,31690
dc97711c2c5ac93ce19cee40db149a755f6a393c,0,Aleksandr Kovalenko,2018-06-26 18:31:50+03:00,['9fabbe90896ddaa7560add6cbc21b4777990ddad'],2,2,4,32390443,2,,,,31690
5b08b29802d334cc921d81ffe7b60456de497271,0,GitHub,2018-06-26 18:12:06+02:00,['dc97711c2c5ac93ce19cee40db149a755f6a393c'],1,251,252,32390695,3,1,1,1,31692
ac0e2ac9bd68a54d86de3de6552d717d57dcbacd,0,Lisnichenko Dmitro,2018-06-26 22:38:49+03:00,['fbc0b10ab8331396fffb5fd18f9fc68e16452a69'],1,2959,2960,32393655,4,0.296296296,0.925925926,0.925925926,31695
6da4163e1ab6e5d431a3a8393ab6f58abf166910,0,GitHub,2018-06-26 13:17:08-07:00,['5b08b29802d334cc921d81ffe7b60456de497271'],9,53,62,32393717,11,0.466666667,0,0.766666667,31695
cf172934898929be9aa3839da820580af7b36715,1,Oliver Szabo,2018-06-26 22:25:13+02:00,['6da4163e1ab6e5d431a3a8393ab6f58abf166910'],1,6,7,32393724,1,0,0,0,31695
ef128df09e1de986238b2ec1e54d707fe82575da,0,GitHub,2018-06-27 08:34:35+03:00,"['cf172934898929be9aa3839da820580af7b36715', 'ac0e2ac9bd68a54d86de3de6552d717d57dcbacd']",5,3025,3030,32396754,9,,,,31695
781b4bfe9879ce56837b913a7ad6db46908bb684,0,aonishuk,2018-06-27 16:19:48+03:00,['ef128df09e1de986238b2ec1e54d707fe82575da'],0,2,2,32396756,1,0,0,1,31695
d10f8cc061ee1206983ef1a4ac6ec657a568067e,1,Oliver Szabo,2018-06-27 15:39:38+02:00,['781b4bfe9879ce56837b913a7ad6db46908bb684'],33,146,179,32396935,3,0.602409639,0.831325301,0.43373494,31695
e5560114e6c3283ca167409087a14ed8682fc5c8,1,Oliver Szabo,2018-06-27 15:39:38+02:00,['d10f8cc061ee1206983ef1a4ac6ec657a568067e'],12,39,51,32396986,1,,,,31695
c4b06db1a4c1dbfe5283038867da1f1239820a39,0,Andrii Tkach,2018-06-27 18:56:32+03:00,['e5560114e6c3283ca167409087a14ed8682fc5c8'],3,1,4,32396990,1,0,0,0,31695
d6d38ba241434ce3c6facf7034cdc91e82eb1ae6,0,Yusaku Sako,2018-06-27 09:19:30-07:00,['c4b06db1a4c1dbfe5283038867da1f1239820a39'],11,12,23,32397013,6,,,,31695
a8184e8b7f6d8d247ee2ef77303c6bce55ebca39,0,Yusaku Sako,2018-06-27 10:11:09-07:00,['d6d38ba241434ce3c6facf7034cdc91e82eb1ae6'],1,2,3,32397016,1,1,1,1,31695
896c86e7afcaeeac12c0e59359082c5782dff6e2,1,Andrii Tkach,2018-06-28 12:13:14+03:00,['a8184e8b7f6d8d247ee2ef77303c6bce55ebca39'],0,2,2,32397018,1,,,,31695
d6e74e58d0501c4d81807f7c01a40d34158de9f5,1,Andrii Tkach,2018-06-28 12:13:14+03:00,['896c86e7afcaeeac12c0e59359082c5782dff6e2'],2,2,4,32397022,2,,,,31695
497ec4d525ee84ba999246ef961b535d6d94048d,0,Andrii Tkach,2018-06-28 12:13:14+03:00,['d6e74e58d0501c4d81807f7c01a40d34158de9f5'],1,1,2,32397024,1,,,,31695
c2400f824209d0c5f54e095cf41738bae089d999,0,GitHub,2018-06-28 07:36:14-04:00,['497ec4d525ee84ba999246ef961b535d6d94048d'],109,355,464,32397488,15,0.166666667,0.404761905,0.904761905,31696
f5b53c60279426c9d4ea26ab658e124e3284d30b,0,Andrii Tkach,2018-06-28 15:39:30+03:00,['c2400f824209d0c5f54e095cf41738bae089d999'],0,6,6,32397494,2,,,,31696
40da07e13e0e560489de5d0e2b217eaeccabd956,0,GitHub,2018-06-28 15:30:06+02:00,['f5b53c60279426c9d4ea26ab658e124e3284d30b'],5,2,7,32397501,1,1,0,0,31696
cc5e30c6350446c323fe5595691289b1af8332d0,1,GitHub,2018-06-28 15:32:33+02:00,['40da07e13e0e560489de5d0e2b217eaeccabd956'],304,933,1237,32398738,51,0.534161491,0.894409938,0.956521739,31703
98da21fabbc78a63047b7cbadfd7c7b80e7c1d5e,0,GitHub,2018-06-28 13:21:56-07:00,['cc5e30c6350446c323fe5595691289b1af8332d0'],33,178,211,32398949,7,0,0.762295082,1,31703
5919d5d7de287a2b0ea1fa3b4a64c759d6f9b7a8,0,GitHub,2018-06-28 15:12:45-07:00,['98da21fabbc78a63047b7cbadfd7c7b80e7c1d5e'],23,42,65,32399014,2,1,1,1,31703
e07b99f999154fb9ccdeae3e2875fcd79fbe04dc,0,GitHub,2018-06-29 02:51:15+02:00,['5919d5d7de287a2b0ea1fa3b4a64c759d6f9b7a8'],1,0,1,32399015,1,,,,31703
bbcc1b80cadde59bd114bc37caf51b0387ef8343,0,GitHub,2018-06-29 18:18:16+05:18,['e07b99f999154fb9ccdeae3e2875fcd79fbe04dc'],2,2,4,32399019,2,,,,31703
effd430630d247285175952bd34bbb76d9410975,0,aBabiichuk,2018-06-29 17:26:13+03:00,['bbcc1b80cadde59bd114bc37caf51b0387ef8343'],14,25,39,32399058,2,,,,31703
7b268e0c56bdef2b55c450fd5492c4c7689e0db3,1,GitHub,2018-06-29 19:16:39+02:00,['effd430630d247285175952bd34bbb76d9410975'],18,21,39,32399097,1,1,1,0,31703
6bf4a5a6caf805e3cfdf3134d95580ce6cae953a,0,aonishuk,2018-06-29 21:02:35+03:00,['7b268e0c56bdef2b55c450fd5492c4c7689e0db3'],0,9,9,32399106,2,0.428571429,0.428571429,0.714285714,31703
83f7227d54654f6b8f43103ff4e6fb150cd3fc31,0,GitHub,2018-06-29 21:21:05+02:00,['6bf4a5a6caf805e3cfdf3134d95580ce6cae953a'],4,29,33,32399139,4,0.684210526,0.947368421,0,31703
2a3e49b57c3a328c2c220eec92593c53b9c8f6e7,1,Sandor Molnar,2018-06-29 23:38:32+02:00,['83f7227d54654f6b8f43103ff4e6fb150cd3fc31'],2,2,4,32399143,2,,,,31703
80d511b17d77de9a6e715049ac955d37030296ca,1,GitHub,2018-07-01 08:58:44+02:00,['2a3e49b57c3a328c2c220eec92593c53b9c8f6e7'],9,9,18,32399161,2,,,,31703
fb6bde26d2a874e6d04b5ced5d421fba8d9eb951,1,GitHub,2018-07-01 08:28:01-04:00,['80d511b17d77de9a6e715049ac955d37030296ca'],0,140,140,32399301,3,0.157894737,0.434210526,0.434210526,31703
789e4ec474ef3267f2fc27925b5c44f1cc11f6a0,1,Aleksandr Kovalenko,2018-07-01 20:18:27+03:00,['fb6bde26d2a874e6d04b5ced5d421fba8d9eb951'],0,5,5,32399306,2,0,1,1,31703
dfbf724865216f5de40a618f1c725e9d64003c97,0,Aleksandr Kovalenko,2018-07-01 20:18:27+03:00,['789e4ec474ef3267f2fc27925b5c44f1cc11f6a0'],1,1,2,32399308,1,,,,31703
f8f46deea10e18597f8d1c2e3a703c480970e12b,1,Dmytro Grinenko,2018-07-02 19:54:44+03:00,['dfbf724865216f5de40a618f1c725e9d64003c97'],37,54,91,32399399,3,0,1,1,31703
273795277e507b802ab6bbaae9731b55b8d61bb4,0,Miklos Gergely,2018-07-02 19:28:43+02:00,['f8f46deea10e18597f8d1c2e3a703c480970e12b'],4,12,16,32399415,1,0,1,0,31703
60e547502b49f07c1c29077e71eb5a231baddc9f,0,Attila Magyar,2018-07-02 20:43:49+02:00,['273795277e507b802ab6bbaae9731b55b8d61bb4'],13,15,28,32399443,1,0,0,1,31703
8a3071654659bf16f47d558fc9ebe0e9b9133d90,0,GitHub,2018-07-02 22:35:30-07:00,['60e547502b49f07c1c29077e71eb5a231baddc9f'],1,23,24,32399467,2,0.263157895,1,1,31703
0cf3f67f33692182e4c4ff93634488aa0158c63c,1,"Doroszlai, Attila",2018-07-03 09:56:36+02:00,['8a3071654659bf16f47d558fc9ebe0e9b9133d90'],435,597,1032,32400499,26,1,1,0.680851064,31706
ad8e8128f9c8fe5d5b5ff7f892444443331afac0,0,Andrii Tkach,2018-07-03 15:32:15+03:00,['0cf3f67f33692182e4c4ff93634488aa0158c63c'],3,3,6,32400505,1,,,,31706
30b776f3df2a15476322dba7aa39dc388082954b,0,GitHub,2018-07-03 15:16:15+02:00,['ad8e8128f9c8fe5d5b5ff7f892444443331afac0'],32,49,81,32400586,7,0,0,1,31706
eca6abf931c697b201aaae102579121481309adc,0,Alex Antonenko,2018-07-03 17:30:06+03:00,['ad8e8128f9c8fe5d5b5ff7f892444443331afac0'],0,143,143,32400729,2,1,1,1,31707
aef0c47d9e8369b52b5e271d390071d3f193e37b,1,GitHub,2018-07-03 18:05:33+03:00,['30b776f3df2a15476322dba7aa39dc388082954b'],156,480,636,32401365,24,0.244680851,0.425531915,0.914893617,31710
5b99aeacfef1630b758654c98a651ac6959c6c83,1,Andrii Tkach,2018-07-04 15:35:13+03:00,['aef0c47d9e8369b52b5e271d390071d3f193e37b'],31,33,64,32401429,7,0,0,0,31710
32759cbedd7b1c50f638bb0e77d3467db04784a1,1,Andrii Tkach,2018-07-04 15:37:25+03:00,['5b99aeacfef1630b758654c98a651ac6959c6c83'],1,1,2,32401431,1,,,,31710
41469ac2a8f5ee43ec1b849e17714fcfd76ce26d,0,Andrii Tkach,2018-07-04 17:14:21+03:00,['32759cbedd7b1c50f638bb0e77d3467db04784a1'],3,15,18,32401449,2,,,,31710
3f8d63e4dc2795e08acf75858f460d56f788e780,0,GitHub,2018-07-05 12:12:36+03:00,"['41469ac2a8f5ee43ec1b849e17714fcfd76ce26d', 'eca6abf931c697b201aaae102579121481309adc']",0,143,143,32401592,2,,,,31710
38528da1cd6129dae154dba303a6afc9f1669bf6,0,Alex Antonenko,2018-07-05 12:18:54+03:00,['41469ac2a8f5ee43ec1b849e17714fcfd76ce26d'],0,7,7,32401599,1,1,1,1,31710
5c78b422bb0b5e7fe67f018421c93613108915bd,1,GitHub,2018-07-05 14:07:38+02:00,['3f8d63e4dc2795e08acf75858f460d56f788e780'],0,21,21,32401620,1,,,,31710
3b0ce61f8f1e09b1286aa807280681aa9dc506f3,0,aonishuk,2018-07-05 16:20:56+03:00,['5c78b422bb0b5e7fe67f018421c93613108915bd'],4,10,14,32401634,1,1,0,0,31710
59f326ca15952b025db7c0938583c62dd749a1b3,0,Lisnichenko Dmitro,2018-07-05 19:09:36+03:00,['3b0ce61f8f1e09b1286aa807280681aa9dc506f3'],0,24,24,32401658,2,0.5,1,1,31710
a100a99037d26cdf4e262eaf3ee03dd6581027f0,0,GitHub,2018-07-05 12:40:30-04:00,['3b0ce61f8f1e09b1286aa807280681aa9dc506f3'],148,811,959,32402617,12,0.172638436,0.540716612,0.771986971,31711
2e7715872fd6224a42a7cec2bdcf63dca570e642,0,GitHub,2018-07-05 23:17:22+03:00,"['a100a99037d26cdf4e262eaf3ee03dd6581027f0', '59f326ca15952b025db7c0938583c62dd749a1b3']",0,24,24,32402641,2,,,,31711
7b7c1aad1a78d51f39dbb5f5f04eb2d8e1b48c00,0,Andrii Tkach,2018-07-06 14:54:59+03:00,['2e7715872fd6224a42a7cec2bdcf63dca570e642'],1,1,2,32402643,1,,,,31711
5e8310102fa805624806df298b38377ac54da0ac,1,GitHub,2018-07-06 14:41:53+02:00,['7b7c1aad1a78d51f39dbb5f5f04eb2d8e1b48c00'],32,29,61,32402704,1,,1,,31711
e55846957e3c17d4157b1d81e26cb030d940daaf,1,Robert Levas,2018-07-06 09:46:43-04:00,['5e8310102fa805624806df298b38377ac54da0ac'],11,67,78,32402782,3,0.138888889,0.388888889,0.972222222,31711
54cc2c3e9cd7c4f24e63ba93c4758047cc83fa54,0,aonishuk,2018-07-06 19:14:33+03:00,['e55846957e3c17d4157b1d81e26cb030d940daaf'],2,3,5,32402787,1,0,0,0,31711
7964cc45e014c51161cb48333c023ddce30b187c,0,GitHub,2018-07-06 18:26:17+02:00,['54cc2c3e9cd7c4f24e63ba93c4758047cc83fa54'],28,81,109,32402896,1,0,0,1,31711
b2118321036d706a41586891ff5b38e110d22148,1,GitHub,2018-07-07 01:09:37+02:00,['7964cc45e014c51161cb48333c023ddce30b187c'],25,28,53,32402949,1,0,0,1,31711
61cde328a47a4c8b02c6a83b09472d1178da5c27,0,GitHub,2018-07-07 11:14:17-04:00,['b2118321036d706a41586891ff5b38e110d22148'],1,1,2,32402951,1,,,,31711
d7d0eabd75acd9b189a220f9229d94bfdb43e844,0,Oliver Szabo,2018-07-08 17:17:05+02:00,['61cde328a47a4c8b02c6a83b09472d1178da5c27'],3,112,115,32403066,5,0,1,1,31713
7d80d348b3b21bdde83e1f85153cb4d4a6e8971c,1,Oliver Szabo,2018-07-08 17:18:24+02:00,['d7d0eabd75acd9b189a220f9229d94bfdb43e844'],6,16,22,32403088,2,,,,31713
90e3471227fb660122333070c78237657746abd6,0,GitHub,2018-07-08 19:38:06+02:00,"['61cde328a47a4c8b02c6a83b09472d1178da5c27', '7d80d348b3b21bdde83e1f85153cb4d4a6e8971c']",9,128,137,32403225,7,,,,31713
ef43f3d451c4a0e8221c0a1202b0d8f114d01cf9,0,GitHub,2018-07-08 20:26:51+02:00,['90e3471227fb660122333070c78237657746abd6'],1,1,2,32403227,1,,,,31713
36feaebd46e444aaf78e40b93525b48dd11f0fd1,0,Robert Levas,2018-07-08 17:38:18-04:00,['ef43f3d451c4a0e8221c0a1202b0d8f114d01cf9'],2,2,4,32403231,1,,,,31713
119f8bbeb01c6f80c356769650d7b1a93be5f52e,0,GitHub,2018-07-09 12:09:17+05:18,['36feaebd46e444aaf78e40b93525b48dd11f0fd1'],8,19,27,32403258,4,1,1,1,31713
8649d57f72fa41ba1a6fd925b06ab523997ed52e,1,GitHub,2018-07-09 11:18:05+02:00,['119f8bbeb01c6f80c356769650d7b1a93be5f52e'],1,2,3,32403261,1,,,,31713
d1947a60bb9f304356bfaa78cf5391a8bc40d6f0,0,Robert Levas,2018-07-09 08:20:51-04:00,['8649d57f72fa41ba1a6fd925b06ab523997ed52e'],2,2,4,32403265,1,,,,31713
6a4f98201d58d6dfe662d980e21978b5f37d2d2e,0,Robert Levas,2018-07-09 11:56:07-04:00,['d1947a60bb9f304356bfaa78cf5391a8bc40d6f0'],2,2,4,32403269,1,,,,31713
8d096706bb37dbd693501a68ce07fbe1373324f0,0,GitHub,2018-07-09 18:08:03+02:00,['6a4f98201d58d6dfe662d980e21978b5f37d2d2e'],1,148,149,32403418,2,0.96,0.96,1,31714
eb5e074f1bc6cd2df4aec44a75fce6f96730ef2e,0,GitHub,2018-07-09 19:33:07+03:00,['8d096706bb37dbd693501a68ce07fbe1373324f0'],17,228,245,32403663,26,0,0.666666667,1,31716
eca3633d0ef1d7a1f464d14d3729a3ae11abe420,0,avijayanhwx,2018-07-09 13:42:26-07:00,['eb5e074f1bc6cd2df4aec44a75fce6f96730ef2e'],3,24,27,32403690,3,0.1875,0.4375,0.125,31716
28e2ca5038a67864cfe3587418721450fdc6342a,1,Oliver Szabo,2018-07-09 22:44:23+02:00,['eca3633d0ef1d7a1f464d14d3729a3ae11abe420'],13,102,115,32403805,2,0,0.308641975,0,31716
c50056ae612164ff5cf3773128411b371229ff77,0,Ishan Bhatt,2018-07-09 14:20:12-07:00,['28e2ca5038a67864cfe3587418721450fdc6342a'],0,35,35,32403840,1,,,,31716
fa8f96c864566fdc411068059f24338895bbe571,0,GitHub,2018-07-09 15:42:44-07:00,['c50056ae612164ff5cf3773128411b371229ff77'],24,3,27,32403867,3,0.8125,0.5625,0.875,31716
95bed16dd0252b9882185c6ab01dcb1af5535d54,0,GitHub,2018-07-10 02:22:05+03:00,['fa8f96c864566fdc411068059f24338895bbe571'],0,79,79,32403946,1,0,1,1,31717
6c46a0b54d300e4036737fcb6bc4f099b173acfd,0,"Doroszlai, Attila",2018-07-10 08:55:23+02:00,['95bed16dd0252b9882185c6ab01dcb1af5535d54'],19,15,34,32403980,1,1,1,1,31717
68188d2a6353cfcf82855250d83a48dd1423dfca,1,GitHub,2018-07-10 16:33:03+02:00,['6c46a0b54d300e4036737fcb6bc4f099b173acfd'],1,1,2,32403982,1,,,,31717
5662c2c966d6123ced7d59a4eed903e1b0ec13b6,1,Alex Antonenko,2018-07-10 18:02:43+03:00,['6c46a0b54d300e4036737fcb6bc4f099b173acfd'],0,353,353,32404335,2,0.657971014,1,1,31718
a4febe5c24885c19836e851a21335857a27a0176,0,"Doroszlai, Attila",2018-07-10 17:21:21+02:00,['68188d2a6353cfcf82855250d83a48dd1423dfca'],31,32,63,32404398,1,,,,31718
eaca4342450f4edafa6f9f7b4118f070b970fac4,0,GitHub,2018-07-10 19:25:11+02:00,['a4febe5c24885c19836e851a21335857a27a0176'],0,3,3,32404401,1,0,0,1,31718
55829654b1d7199488d81c781feff75a67ccf423,0,GitHub,2018-07-10 21:04:29+03:00,"['eaca4342450f4edafa6f9f7b4118f070b970fac4', '5662c2c966d6123ced7d59a4eed903e1b0ec13b6']",0,353,353,32404754,2,,,,31718
0781b30762c1df19b9eb2b875b892bfbe81818bb,0,GitHub,2018-07-10 16:36:21-04:00,['55829654b1d7199488d81c781feff75a67ccf423'],3,3,6,32404760,2,,,1,31718
d3cf7ac2c137189bea82d77d20ebf2dc891e7e71,1,aonishuk,2018-07-11 07:21:12+03:00,['0781b30762c1df19b9eb2b875b892bfbe81818bb'],12,18,30,32404790,1,0,1,1,31718
11ea165b7c6d8da5462011fff10b6420b4f410c1,1,aonishuk,2018-07-11 11:02:24+03:00,['d3cf7ac2c137189bea82d77d20ebf2dc891e7e71'],4,9,13,32404803,1,0,0.142857143,0,31718
b9841739ea31feebd589f68ceac5de0831acc8de,0,GitHub,2018-07-11 16:41:21+02:00,['11ea165b7c6d8da5462011fff10b6420b4f410c1'],7,7,14,32404817,1,0,1,1,31718
c9596bd632a70714d9384f0bc9525f4554a13964,0,GitHub,2018-07-11 12:19:58-04:00,['b9841739ea31feebd589f68ceac5de0831acc8de'],4,12,16,32404833,2,0,1,1,31718
3f0fbbd8295760090e6f293db1c8acfa0f518cff,1,GitHub,2018-07-11 22:19:04+02:00,['c9596bd632a70714d9384f0bc9525f4554a13964'],1,9,10,32404843,2,0,0,0,31718
81f20cc0b30d35de6db52238c8b1ca143d63983f,0,Yusaku Sako,2018-07-11 14:48:36-07:00,['3f0fbbd8295760090e6f293db1c8acfa0f518cff'],0,11,11,32404854,1,,,,31718
aee0d379d52635435adce86de48b18ba4348495c,0,hiveww,2018-07-12 10:56:38+03:00,"['6c46a0b54d300e4036737fcb6bc4f099b173acfd', '38528da1cd6129dae154dba303a6afc9f1669bf6']",0,7,7,32404861,1,,,,31718
322ce542cade1ccf22a45313e038533dc3ec205b,0,hiveww,2018-07-12 11:01:01+03:00,"['aee0d379d52635435adce86de48b18ba4348495c', '81f20cc0b30d35de6db52238c8b1ca143d63983f']",63,458,521,32405382,13,,,,31718
abe50a80147c58a83864d04bf9892d802e41a49f,0,hiveww,2018-07-12 13:49:18+03:00,['322ce542cade1ccf22a45313e038533dc3ec205b'],11,6,17,32405399,2,0,0,0,31718
b02751f75ddd701f5351fe6c9eb72046a7102f3c,0,hiveww,2018-07-12 13:53:58+03:00,['abe50a80147c58a83864d04bf9892d802e41a49f'],1,1,2,32405401,1,,,,31718
9e1fd104e49b8e5cca97582f1a1e1bc69f6f0ecf,0,hiveww,2018-07-12 13:55:39+03:00,['b02751f75ddd701f5351fe6c9eb72046a7102f3c'],1,0,1,32405402,1,1,1,1,31718
47260ab3935b8db0231964fda3e3b662189fa7c1,0,Alex Antonenko,2018-07-12 15:01:13+03:00,['9e1fd104e49b8e5cca97582f1a1e1bc69f6f0ecf'],1,1,2,32405404,1,,,,31718
4f19784c160949bbda6a2aebc490bc1a0fef3bca,0,Alex Antonenko,2018-07-12 15:05:49+03:00,['9e1fd104e49b8e5cca97582f1a1e1bc69f6f0ecf'],1,1,2,32405406,1,,,,31718
8c150b4f2348b2fe371d80fd7606c6220698ccd0,1,GitHub,2018-07-12 18:55:23+03:00,['81f20cc0b30d35de6db52238c8b1ca143d63983f'],38,57,95,32405501,11,0,1,0,31718
38ad1c5a0e3cb39e03cc2e8919d770153ed3ed47,0,Alex Antonenko,2018-07-12 22:19:51+03:00,['4f19784c160949bbda6a2aebc490bc1a0fef3bca'],11,22,33,32405534,2,1,0.272727273,1,31718
05cb1ee70eeced04fccca46a2893b46250e4ece2,0,GitHub,2018-07-12 23:14:45+03:00,"['8c150b4f2348b2fe371d80fd7606c6220698ccd0', '38ad1c5a0e3cb39e03cc2e8919d770153ed3ed47']",15,27,42,32405576,4,,,,31718
297a9315939fb9a4e05d2ff529d611173b4c1ad2,0,Ishan Bhatt,2018-07-13 12:56:14-07:00,['05cb1ee70eeced04fccca46a2893b46250e4ece2'],10,41,51,32405627,4,,,,31718
5bc1428481ba35b270da42694a1047ba14735006,0,Robert Levas,2018-07-16 09:52:26-04:00,['297a9315939fb9a4e05d2ff529d611173b4c1ad2'],0,4,4,32405631,1,,,,31718
c0460952992610d6f38a86828f44a9aaf9a5a222,1,GitHub,2018-07-16 18:10:10+02:00,['5bc1428481ba35b270da42694a1047ba14735006'],32,1151,1183,32406814,30,0.501246883,0.593516209,0.945137157,31733
2c269346da779b4dbd04bdb0091d60de6828fbed,0,Alex Antonenko,2018-07-17 15:38:28+03:00,['47260ab3935b8db0231964fda3e3b662189fa7c1'],45,14,59,32406873,3,0,0,0,31733
7972155db741151c75e004e1fac360a20e737617,1,GitHub,2018-07-18 12:49:35+02:00,['c0460952992610d6f38a86828f44a9aaf9a5a222'],141,138,279,32407152,11,0,0,0.205128205,31733
def026cb4dabba76273aea12a1a22a905ddf4053,0,Olivér Szabó,2018-07-18 17:06:07+02:00,['7972155db741151c75e004e1fac360a20e737617'],1,1,2,32407154,1,,,,31733
5737d1befe927ffa347e40f732b71ff30dd1ed39,1,GitHub,2018-07-18 17:45:41+02:00,['def026cb4dabba76273aea12a1a22a905ddf4053'],4,16,20,32407174,4,,,,31733
c78fc940e2dbcc1299953812668d5a2e8efb0f34,0,Ishan Bhatt,2018-07-18 12:14:25-07:00,['5737d1befe927ffa347e40f732b71ff30dd1ed39'],6,8,14,32407188,1,,,,31733
8706e65ad8db91ab3ccc61272154bcf6b61ca54e,0,Lisnichenko Dmitro,2018-07-18 23:08:35+03:00,['c78fc940e2dbcc1299953812668d5a2e8efb0f34'],2,0,2,32407190,1,,,,31733
d71c9a621dae5a4f9fae010e89440abee05dfca2,0,GitHub,2018-07-18 23:19:14+02:00,['c78fc940e2dbcc1299953812668d5a2e8efb0f34'],1,1,2,32407192,1,,,,31733
32d88a874b9de7208de68f998df5979e2544966d,0,GitHub,2018-07-18 23:19:33+02:00,['d71c9a621dae5a4f9fae010e89440abee05dfca2'],1,1,2,32407194,1,,,,31733
e6061fd4bc3ca87cd09cfad08b1233afd9779982,0,GitHub,2018-07-18 23:19:57+02:00,['32d88a874b9de7208de68f998df5979e2544966d'],6,6,12,32407206,1,0,1,1,31733
eeedb39173de8371d34ec9c8572e4a7e919978d6,0,GitHub,2018-07-19 12:22:25+03:00,"['e6061fd4bc3ca87cd09cfad08b1233afd9779982', '8706e65ad8db91ab3ccc61272154bcf6b61ca54e']",2,0,2,32407208,1,,,,31733
a934c2ae88437eed4cfa7bc9a7abb5771583550d,0,Miklos Gergely,2018-07-19 11:46:02+02:00,['eeedb39173de8371d34ec9c8572e4a7e919978d6'],1,1,2,32407210,1,,,,31733
4f66c7448aadaffd8b6474694ebb428c272d46c7,1,GitHub,2018-07-19 12:57:55+02:00,['a934c2ae88437eed4cfa7bc9a7abb5771583550d'],18,20,38,32407248,2,,,,31733
1c78b305570a19ba41d7135699d22f162c8eea77,0,Miklos Gergely,2018-07-19 13:24:54+02:00,['4f66c7448aadaffd8b6474694ebb428c272d46c7'],1,5,6,32407254,1,0,1,1,31733
d531263b3955014acefd11820e7aee15b78a3115,1,GitHub,2018-07-19 14:39:45+02:00,['1c78b305570a19ba41d7135699d22f162c8eea77'],534,1919,2453,32409707,107,0.533962264,0.667924528,0.747169811,31749
697b1a402c0b3b4f97cd031ccf8da311903c1eeb,0,Alex Antonenko,2018-07-19 15:49:11+03:00,"['47260ab3935b8db0231964fda3e3b662189fa7c1', 'd531263b3955014acefd11820e7aee15b78a3115']",786,3370,4156,32413863,167,,,,31749
583fc0ca640351d8153e8c29e67ab1b938f28a95,1,GitHub,2018-07-19 14:52:37+02:00,['d531263b3955014acefd11820e7aee15b78a3115'],34,52,86,32413949,3,,,,31749
9eccc67e20edfe387c75804dbf7564d22b49326a,0,aBabiichuk,2018-07-19 16:20:40+03:00,['583fc0ca640351d8153e8c29e67ab1b938f28a95'],2,3,5,32413954,2,1,1,1,31749
b1763a3580e9d8421b4a11ae1691b5b6a7e9200b,1,aonishuk,2018-07-19 16:28:22+03:00,['9eccc67e20edfe387c75804dbf7564d22b49326a'],2,4,6,32413960,1,0,0,0,31749
8bbd90cc2e0b53ef40fc75f5c9623eb15df43f04,0,aBabiichuk,2018-07-19 16:54:49+03:00,['b1763a3580e9d8421b4a11ae1691b5b6a7e9200b'],3,3,6,32413966,1,,,,31749
e53aaf66a651f18fe2e7f4d83a180ec3f726652e,0,aBabiichuk,2018-07-19 17:10:32+03:00,['8bbd90cc2e0b53ef40fc75f5c9623eb15df43f04'],1,1,2,32413968,1,,,,31749
00fbca662d4e7727da738831e9cf66ad17736149,0,Andrii Tkach,2018-07-19 18:05:05+03:00,['e53aaf66a651f18fe2e7f4d83a180ec3f726652e'],7,48,55,32414023,3,1,1,1,31749
d356ab5377a654e0d24d4c95080afd13aa39e542,0,Andrii Tkach,2018-07-19 18:07:22+03:00,['00fbca662d4e7727da738831e9cf66ad17736149'],61,15,76,32414099,4,0.75,0,0,31749
d5bcc180423e8a08f183733412e0608c593f0865,0,Andrii Tkach,2018-07-20 11:48:38+03:00,['d356ab5377a654e0d24d4c95080afd13aa39e542'],0,1,1,32414100,1,0,0,1,31749
bd40ee0af1b56555eae31bb24832725785f757d5,0,Andrii Tkach,2018-07-20 11:51:49+03:00,['d5bcc180423e8a08f183733412e0608c593f0865'],4,25,29,32414129,5,1,1,1,31749
f443a5b2ef9709e6d4cead8e97631a60e103d469,0,Andrii Tkach,2018-07-20 14:21:54+03:00,['bd40ee0af1b56555eae31bb24832725785f757d5'],103,108,211,32414340,2,,,,31749
8102517131cf019e8111f3332a209468a88a0a3a,0,aonishuk,2018-07-20 16:38:19+03:00,['f443a5b2ef9709e6d4cead8e97631a60e103d469'],1,3,4,32414344,1,0,0,0,31749
6d106605782466eaa03a613bd3ca28d0c20463f3,1,Aleksandr Kovalenko,2018-07-20 16:45:38+03:00,['8102517131cf019e8111f3332a209468a88a0a3a'],0,4,4,32414348,1,1,1,1,31749
5fb83e5a9e1e542444b6da045b93f6ea33a080d7,0,GitHub,2018-07-20 17:39:17+02:00,['6d106605782466eaa03a613bd3ca28d0c20463f3'],26,30,56,32414404,2,1,1,0,31749
48c92cdf6acca316e6a88a3966915cb2a920fcb5,0,Lisnichenko Dmitro,2018-07-20 18:46:36+03:00,['6d106605782466eaa03a613bd3ca28d0c20463f3'],33,43,76,32414480,3,,,,31749
13f96c6287677b867f550af48d013250cdbe8a2d,0,GitHub,2018-07-21 09:01:09+02:00,['5fb83e5a9e1e542444b6da045b93f6ea33a080d7'],1,1,2,32414482,1,,,,31749
d2f43fbc8b3cf6acf52e3ef189cbd39cd4a33afb,1,GitHub,2018-07-22 15:15:23+02:00,['13f96c6287677b867f550af48d013250cdbe8a2d'],0,1,1,32414483,1,1,1,1,31749
a1a66eeb3328a1497b611ce6f3a937be12f57f63,1,GitHub,2018-07-22 15:17:20+02:00,['d2f43fbc8b3cf6acf52e3ef189cbd39cd4a33afb'],0,2,2,32414485,1,,,,31749
69a64a068911504db944d284b2ccf9f5db4462a3,1,GitHub,2018-07-23 09:33:46+02:00,['a1a66eeb3328a1497b611ce6f3a937be12f57f63'],36,132,168,32414653,8,0.432432432,0.891891892,0.513513514,31750
36b9cdcb0335bf1477d75850caeb94de7b9f4f93,0,Alex Antonenko,2018-07-23 11:02:46+03:00,"['697b1a402c0b3b4f97cd031ccf8da311903c1eeb', '69a64a068911504db944d284b2ccf9f5db4462a3']",280,432,712,32415365,37,,,,31750
1070b65c2c2479a5687a5a70a9443e154d627ec2,1,GitHub,2018-07-23 10:45:57+02:00,['69a64a068911504db944d284b2ccf9f5db4462a3'],15,65,80,32415445,7,0.826086957,0.956521739,0.304347826,31750
c86ec61fd963855084ae5ab328e3830a59aca872,0,Alex Antonenko,2018-07-23 12:47:05+03:00,"['36b9cdcb0335bf1477d75850caeb94de7b9f4f93', '1070b65c2c2479a5687a5a70a9443e154d627ec2']",15,65,80,32415525,7,,,,31750
31150b68a4f827aa20f64b95ac2726f521b26aa9,0,GitHub,2018-07-23 12:49:40+03:00,"['1070b65c2c2479a5687a5a70a9443e154d627ec2', '2c269346da779b4dbd04bdb0091d60de6828fbed']",45,14,59,32415584,3,,,,31750
5fa81ce899319710e99d4f33309201641f20f6b2,0,GitHub,2018-07-23 14:57:23+03:00,['31150b68a4f827aa20f64b95ac2726f521b26aa9'],2,110,112,32415696,5,0.066666667,0.066666667,0.066666667,31751
5ecf5e8c4ecbd1cbd21699e53e27786729df8dbb,0,aonishuk,2018-07-23 17:11:20+03:00,['5fa81ce899319710e99d4f33309201641f20f6b2'],5,6,11,32415707,1,1,0,0.5,31751
57b7d5adc6bcf7683363f3431c446a092876ea07,1,GitHub,2018-07-23 16:14:14+02:00,['5ecf5e8c4ecbd1cbd21699e53e27786729df8dbb'],16,40,56,32415763,2,0.884615385,0.884615385,1,31751
e374842ba7a9dda0a44c274dba77fbb9bd59efa1,0,GitHub,2018-07-23 19:58:08+02:00,['57b7d5adc6bcf7683363f3431c446a092876ea07'],17,64,81,32415844,4,0.230769231,0.974358974,1,31751
1b32b2972a8422e7b0f69ee04843e7e15d8dfbb0,0,Aleksandr Kovalenko,2018-07-24 01:06:37+02:00,['e374842ba7a9dda0a44c274dba77fbb9bd59efa1'],2,3,5,32415849,1,,,,31751
6ebc94242ff6d5dfdbca4b887442f6e2aa67ea58,0,Andrii Tkach,2018-07-24 13:35:05+03:00,['1b32b2972a8422e7b0f69ee04843e7e15d8dfbb0'],9,8,17,32415866,3,1,0,0,31751
aee53c14b814c447cb4270c12fc121a4cf9db299,0,Andrii Tkach,2018-07-24 13:36:55+03:00,['6ebc94242ff6d5dfdbca4b887442f6e2aa67ea58'],2,7,9,32415875,2,1,1,1,31751
acd44ce10b822c8934309fb67d133e865c6f0df9,1,Alex Antonenko,2018-07-24 13:37:58+03:00,"['47260ab3935b8db0231964fda3e3b662189fa7c1', 'd531263b3955014acefd11820e7aee15b78a3115']",1078,3829,4907,32420782,200,,,,31751
6810e6e32a290386ae864435fb80acbb4ddabe36,0,Alex Antonenko,2018-07-24 13:39:41+03:00,"['c86ec61fd963855084ae5ab328e3830a59aca872', 'aee53c14b814c447cb4270c12fc121a4cf9db299']",98,252,350,32421132,21,,,,31751
a5d4ea1c7e9bfbd83a446bebc9c761aa69919af5,0,Alex Antonenko,2018-07-24 13:41:34+03:00,"['6810e6e32a290386ae864435fb80acbb4ddabe36', 'acd44ce10b822c8934309fb67d133e865c6f0df9']",25,40,65,32421197,2,,,,31751
29930071d444e5a16e5fc2b41903dc355afc0d83,0,GitHub,2018-07-24 16:04:35+03:00,"['aee53c14b814c447cb4270c12fc121a4cf9db299', 'a5d4ea1c7e9bfbd83a446bebc9c761aa69919af5']",25,40,65,32421262,2,,,,31751
844348a748169ff63c8f1c4b4a5372b3588c8695,1,GitHub,2018-07-24 15:59:14+02:00,['29930071d444e5a16e5fc2b41903dc355afc0d83'],0,169,169,32421431,1,,,,31751
123208dae29ee8bb1e6f5220f102527660f6a022,0,GitHub,2018-07-24 16:40:49+02:00,['844348a748169ff63c8f1c4b4a5372b3588c8695'],3,14,17,32421448,2,0.777777778,0.777777778,1,31751
81dc48f3773fec784aa18a6cf1730d2bdf3d8ab2,0,Alex Antonenko,2018-07-24 18:12:17+03:00,['844348a748169ff63c8f1c4b4a5372b3588c8695'],0,1,1,32421449,1,,,,31751
8c6e39565e56aede07700294c989fa4646924d0a,0,Andrii Tkach,2018-07-24 18:35:17+03:00,['123208dae29ee8bb1e6f5220f102527660f6a022'],1,16,17,32421466,2,,,,31751
b57a763a001efc77449dafe934412c81e4304ab6,1,GitHub,2018-07-24 12:40:55-07:00,['8c6e39565e56aede07700294c989fa4646924d0a'],126,287,413,32421879,36,0.860759494,0.860759494,0.873417722,31752
0dd8ffcdbc71f9363e809f53d0adba0fd08372e6,0,GitHub,2018-07-24 13:44:41-07:00,['b57a763a001efc77449dafe934412c81e4304ab6'],4,1,5,32421884,1,1,1,1,31752
5bd906b741d9247b2bea6ac2d9de57b5209dba1e,1,GitHub,2018-07-25 15:56:12+02:00,['0dd8ffcdbc71f9363e809f53d0adba0fd08372e6'],10,183,193,32422077,5,0.716216216,0.986486486,1,31754
37e7352c442eebf25e3d249e40a36400f9182eaa,0,Attila Magyar,2018-07-25 17:16:13+02:00,['5bd906b741d9247b2bea6ac2d9de57b5209dba1e'],2,2,4,32422081,1,,,,31754
24c1a6eab620445266fa2af3737f081fbebe7959,0,GitHub,2018-07-25 19:44:51+03:00,['37e7352c442eebf25e3d249e40a36400f9182eaa'],9,270,279,32422360,3,0.22265625,0.91015625,0.8984375,31754
e5160dfc2201d104f84e59edced76c9b0575527b,1,GitHub,2018-07-25 22:27:13+02:00,['24c1a6eab620445266fa2af3737f081fbebe7959'],2,6,8,32422368,1,0,0,1,31754
0b7e8d0b0c9fc0e24e21a8de61ea1eb6e682092f,0,GitHub,2018-07-26 00:01:32+02:00,['e5160dfc2201d104f84e59edced76c9b0575527b'],7,84,91,32422459,9,0.555555556,1,0.75,31754
0588f4ec720a53e6ea07683222bcaa07bcbf6985,0,GitHub,2018-07-26 12:00:33+03:00,"['0b7e8d0b0c9fc0e24e21a8de61ea1eb6e682092f', '81dc48f3773fec784aa18a6cf1730d2bdf3d8ab2']",0,1,1,32422460,1,,,,31754
044d6ab064ce12e63d0f54906c5dc6e1c7ffa114,0,Andrii Tkach,2018-07-26 18:02:25+03:00,['0588f4ec720a53e6ea07683222bcaa07bcbf6985'],1,3,4,32422464,1,1,1,1,31754
f12f5e2135ed65aaa0fb009aff84cd4bdb80d81f,1,GitHub,2018-07-26 21:02:21+03:00,['044d6ab064ce12e63d0f54906c5dc6e1c7ffa114'],614,843,1457,32423921,29,1,1,1,31759
fd408fcdbb0a86a030e21e61d42db8698cc1cf88,0,GitHub,2018-07-27 10:08:25+05:18,['f12f5e2135ed65aaa0fb009aff84cd4bdb80d81f'],23,552,575,32424496,18,0.076628352,0.620689655,0.942528736,31761
052f28ca9ab14318ef3c4590e3cc79209e9e0ed9,0,GitHub,2018-07-27 08:52:55+02:00,['fd408fcdbb0a86a030e21e61d42db8698cc1cf88'],40,16,56,32424552,2,0.115384615,0.115384615,0,31761
1350b291b624da307fb271ac62475c84090a7846,0,Andrii Tkach,2018-07-27 14:52:45+03:00,['052f28ca9ab14318ef3c4590e3cc79209e9e0ed9'],0,2,2,32424554,2,,,,31761
b7d81b2c523a052b776df28a8d387230c3371f68,1,aBabiichuk,2018-07-27 14:59:46+03:00,['1350b291b624da307fb271ac62475c84090a7846'],156,269,425,32424979,17,1,1,0,31761
8395a5b757beddfe5178ef805be122dfb014fcce,1,Robert Levas,2018-07-27 08:32:16-04:00,['b7d81b2c523a052b776df28a8d387230c3371f68'],0,39,39,32425018,2,0,1,1,31761
c43f3c6b93666876874479dce0b98cd93a8dfc28,0,GitHub,2018-07-27 19:26:28+02:00,['8395a5b757beddfe5178ef805be122dfb014fcce'],58,144,202,32425220,6,1,1,0.269230769,31761
7171b964194263e20309d7c016b096079cc9037f,1,Andrii Tkach,2018-07-27 20:27:00+03:00,['c43f3c6b93666876874479dce0b98cd93a8dfc28'],137,343,480,32425700,26,0,0,0,31764
62a218559af8f993c407f64fb2ed27c93734970f,0,GitHub,2018-07-27 22:33:06+02:00,['7171b964194263e20309d7c016b096079cc9037f'],5,8,13,32425713,1,1,0,0,31764
95455a424d0892aa1859c5f0a190b383d7d3a810,0,aonishuk,2018-07-29 11:01:14+03:00,['62a218559af8f993c407f64fb2ed27c93734970f'],7,8,15,32425728,1,0,0,0,31764
02ba3c4be31fc0364811dd1a8a87fa031768368f,0,aonishuk,2018-07-30 15:53:23+03:00,['95455a424d0892aa1859c5f0a190b383d7d3a810'],4,7,11,32425739,2,0.666666667,0.666666667,1,31764
cabb20bf4a52d155ada3a5c2b42b5696f2cdd96e,1,Robert Levas,2018-07-30 10:04:14-04:00,['02ba3c4be31fc0364811dd1a8a87fa031768368f'],26,87,113,32425852,14,0.585365854,0.609756098,0.634146341,31764
58595617f6e4042107e95d81221df14fc8fe9a49,0,Venkata Sairam Lanka,2018-07-30 20:08:11+05:18,['cabb20bf4a52d155ada3a5c2b42b5696f2cdd96e'],1,65,66,32425918,3,0,0,1,31764
c03d33d9f7e5791e02186564b4c3e00182218387,0,Robert Levas,2018-07-30 18:21:02-04:00,['58595617f6e4042107e95d81221df14fc8fe9a49'],69,319,388,32426306,8,0.130081301,0.593495935,0.869918699,31764
b38bb9f6ecb9116a251d17c083d286a63d3f47ec,0,GitHub,2018-07-31 11:09:42+05:18,['c03d33d9f7e5791e02186564b4c3e00182218387'],45,8,53,32426359,2,,,,31764
b69df91e999f2900f0876ee6a535a4bbdb8a6555,1,GitHub,2018-07-31 11:47:34+02:00,['b38bb9f6ecb9116a251d17c083d286a63d3f47ec'],2,10,12,32426371,1,0,1,1,31764
2eaeeebefdff3b2d5da51ea2ca2cba3507dae771,1,Alex Antonenko,2018-07-31 14:02:07+03:00,['95455a424d0892aa1859c5f0a190b383d7d3a810'],6,56,62,32426433,4,1,0.95,1,31765
0a9a15a2a19856ccd7abe49c529fe9603b124f56,0,Lisnichenko Dmitro,2018-07-31 14:43:37+03:00,"['48c92cdf6acca316e6a88a3966915cb2a920fcb5', '58595617f6e4042107e95d81221df14fc8fe9a49']",1379,3883,5262,32431695,204,,,,31765
a091011d02211f74ba01247931ed9833446f9a1e,0,Lisnichenko Dmitro,2018-07-31 14:45:03+03:00,['0a9a15a2a19856ccd7abe49c529fe9603b124f56'],1,6,7,32431702,4,0,0.666666667,0.666666667,31765
048b0d49b173d02cc0bad89135e3100b6e1df3f1,1,GitHub,2018-07-31 15:44:52+02:00,['b69df91e999f2900f0876ee6a535a4bbdb8a6555'],1,553,554,32432256,4,0.026252983,0.639618138,1,31765
307a8cf1ab32309eac72551bffe15872b2b94789,0,GitHub,2018-07-31 17:01:31+03:00,"['048b0d49b173d02cc0bad89135e3100b6e1df3f1', '2eaeeebefdff3b2d5da51ea2ca2cba3507dae771']",6,56,62,32432318,4,,,,31765
034f55afda5dac7bf5df72ebbb8a6ff6970dd25f,0,GitHub,2018-07-31 17:06:16+03:00,"['307a8cf1ab32309eac72551bffe15872b2b94789', 'a091011d02211f74ba01247931ed9833446f9a1e']",32,46,78,32432396,5,,,,31765
23a87a2092afdb01367f88add11ed0dc1a5327f6,0,GitHub,2018-07-31 11:22:15-07:00,['034f55afda5dac7bf5df72ebbb8a6ff6970dd25f'],9,9,18,32432414,2,,,,31765
4348275a08d036a9b1cded285b685ae6e4ee7c3c,0,GitHub,2018-07-31 22:03:11+02:00,['23a87a2092afdb01367f88add11ed0dc1a5327f6'],3,5,8,32432422,1,0,0,0,31765
731f7bfdb5d1fcc8e84defec41af0f6fc6bd11d7,0,Aleksandr Kovalenko,2018-07-31 23:34:36+03:00,['4348275a08d036a9b1cded285b685ae6e4ee7c3c'],23,25,48,32432470,1,,,,31765
aaebbe8c528667e70219545582dfddbe36fe6b9e,1,Aleksandr Kovalenko,2018-07-31 23:35:14+03:00,['731f7bfdb5d1fcc8e84defec41af0f6fc6bd11d7'],0,4,4,32432474,1,,,,31765
e7771e0039618a8b779d2e22f910617f6d8c9dec,1,Andrii Tkach,2018-08-01 15:28:52+03:00,['aaebbe8c528667e70219545582dfddbe36fe6b9e'],33,299,332,32432806,11,0.992647059,0.992647059,1,31765
ac9777a96cb547b3d862038e3d077e5359fef6bc,0,GitHub,2018-08-01 13:05:18-04:00,['e7771e0039618a8b779d2e22f910617f6d8c9dec'],8,69,77,32432883,1,,,,31765
d8004b05060a71623b849df2c4c2ad8351a5e6eb,1,GitHub,2018-08-01 19:26:57-04:00,['ac9777a96cb547b3d862038e3d077e5359fef6bc'],151,220,371,32433254,7,0,0,1,31765
9ecc11e99b717bf061474c7af44ee4ba7ece0964,0,GitHub,2018-08-02 11:03:16+02:00,['d8004b05060a71623b849df2c4c2ad8351a5e6eb'],9,21,30,32433284,2,1,1,0.25,31765
e458b0b3e408608328e42055c33630018cbd265f,0,GitHub,2018-08-02 11:11:57-07:00,['9ecc11e99b717bf061474c7af44ee4ba7ece0964'],0,1,1,32433285,1,0,1,1,31765
1a2b115b8f693dcda4df3e6d97d67547e801baa3,1,GitHub,2018-08-03 14:12:09+02:00,['e458b0b3e408608328e42055c33630018cbd265f'],1,200,201,32433486,3,0.459459459,1,0.756756757,31767
d066e970207c9e3774b15df448b30291625bde7e,1,GitHub,2018-08-03 14:33:20+02:00,['1a2b115b8f693dcda4df3e6d97d67547e801baa3'],153,172,325,32433811,3,0.681818182,0.636363636,0,31767
06266815fe8b18ac72a2b63d042d8ad603d9f40d,0,avijayanhwx,2018-08-03 09:45:31-07:00,['d066e970207c9e3774b15df448b30291625bde7e'],1,1,2,32433813,1,0,1,1,31767
e15850f8b21ff0eab3439488171d04424a5a0936,0,Robert Levas,2018-08-03 13:22:10-04:00,['06266815fe8b18ac72a2b63d042d8ad603d9f40d'],2,6,8,32433821,3,0,1,1,31767
1db1dd06be5d55f83427bbb1f6c152ecde90ed11,0,Aleksandr Kovalenko,2018-08-06 13:06:28+03:00,['e15850f8b21ff0eab3439488171d04424a5a0936'],73,14,87,32433908,2,,,,31767
0b40da3954893592da02f6e421b5caa873f40212,0,Aleksandr Kovalenko,2018-08-06 13:06:56+03:00,['1db1dd06be5d55f83427bbb1f6c152ecde90ed11'],1,1,2,32433910,1,,,,31767
04c53e35cf05de6e055604a26f57a1f9bf6683f3,1,aonishuk,2018-08-06 14:19:41+03:00,['0b40da3954893592da02f6e421b5caa873f40212'],5,23,28,32433938,1,0.5,0.5,0.5,31767
c952a9090d1cbc3e18a6608f7e4db7791c7d83e8,0,GitHub,2018-08-06 17:49:43+02:00,['04c53e35cf05de6e055604a26f57a1f9bf6683f3'],0,51,51,32433989,2,0.875,1,1,31767
836ea4c9135b138fda3b348c2e3dbbfa9fbd3d4c,1,Robert Levas,2018-08-06 13:49:44-04:00,['c952a9090d1cbc3e18a6608f7e4db7791c7d83e8'],6,6,12,32434001,2,,,,31767
d3b47d0fe8bd0ecfabba1b472d99def263310fdf,0,GitHub,2018-08-06 22:41:44+02:00,['836ea4c9135b138fda3b348c2e3dbbfa9fbd3d4c'],5,3,8,32434009,1,1,0,0,31767
ab1dbe0b665e864d16bf184f10aabca2c6d90799,1,GitHub,2018-08-07 13:29:34+02:00,['d3b47d0fe8bd0ecfabba1b472d99def263310fdf'],19,70,89,32434098,7,0.483870968,1,1,31767
db8dcb48854e1c789ba706b68e4a199f41189aa1,0,GitHub,2018-08-07 14:08:03+02:00,['ab1dbe0b665e864d16bf184f10aabca2c6d90799'],2,2,4,32434102,2,,,,31767
853ac1441573715ab955f51b0dace3f569200d34,0,Alex Antonenko,2018-08-07 15:57:27+03:00,['d3b47d0fe8bd0ecfabba1b472d99def263310fdf'],0,260,260,32434362,2,0.930131004,1,1,31768
7a45a541b96177a0b4f037520bcd40016a9c54fe,0,GitHub,2018-08-07 12:31:42-04:00,['db8dcb48854e1c789ba706b68e4a199f41189aa1'],10,0,10,32434372,1,1,1,1,31768
49125564ffb60e1568a8eee19e07a431036f2a7d,0,Venkata Sairam Lanka,2018-08-08 13:53:17+05:18,['7a45a541b96177a0b4f037520bcd40016a9c54fe'],2,86,88,32434460,3,0.6,0.6,1,31768
50a83500dca8494ae35751c4c94970b8ac5c249e,0,aonishuk,2018-08-08 14:05:19+03:00,['49125564ffb60e1568a8eee19e07a431036f2a7d'],63,496,559,32435019,17,0.548022599,0.593220339,0.677966102,31775
4d929b23bb243eeff57349d2e2ff10d200eb771d,0,GitHub,2018-08-08 14:03:47+02:00,['50a83500dca8494ae35751c4c94970b8ac5c249e'],2,72,74,32435093,2,0,1,1,31775
d0ab7977181a17b0ef85502f4ed20a34b504fe81,0,aonishuk,2018-08-08 15:04:24+03:00,['4d929b23bb243eeff57349d2e2ff10d200eb771d'],4,2,6,32435099,1,,,,31775
2a05a8a10f1c5477bed1f2ca27823f27116df5d6,1,GitHub,2018-08-08 14:44:25+02:00,['d0ab7977181a17b0ef85502f4ed20a34b504fe81'],3,3,6,32435105,3,,,,31775
853a9e2c5365912acc55cd05f1ee903255523346,0,Robert Levas,2018-08-08 10:24:05-04:00,['2a05a8a10f1c5477bed1f2ca27823f27116df5d6'],19,0,19,32435124,1,1,1,1,31775
06a15f593ae6bbe387c007321731f643e5acadcc,1,Robert Levas,2018-08-08 13:14:35-04:00,['853a9e2c5365912acc55cd05f1ee903255523346'],7,8,15,32435139,2,,,,31775
06a98537d6f03c2f534b1b8b7c7b391a38073bf0,0,GitHub,2018-08-08 13:15:32-04:00,['06a15f593ae6bbe387c007321731f643e5acadcc'],108,0,108,32435247,1,0.933333333,0.933333333,0.933333333,31775
642fd44dc2f3462b9b98fce41495b1a83a280ef1,0,GitHub,2018-08-08 10:30:13-07:00,['06a98537d6f03c2f534b1b8b7c7b391a38073bf0'],0,8,8,32435255,1,,,,31775
8a740f229b4857efb88acaf6732b3d1bbb561589,1,GitHub,2018-08-08 23:25:06+02:00,['642fd44dc2f3462b9b98fce41495b1a83a280ef1'],2,2,4,32435259,2,,,,31775
7c6b099eb70528db5f765da5478e8933ecea17e1,0,Alex Antonenko,2018-08-09 10:01:21+03:00,"['853ac1441573715ab955f51b0dace3f569200d34', '8a740f229b4857efb88acaf6732b3d1bbb561589']",241,749,990,32436249,42,,,,31775
f3ee18e32276f7d4c9d196741b975ad501e3d1b8,0,GitHub,2018-08-09 10:01:45+03:00,"['8a740f229b4857efb88acaf6732b3d1bbb561589', '853ac1441573715ab955f51b0dace3f569200d34']",0,260,260,32436509,2,,,,31775
1ca963c14c4a70f221e5cd5b4675bca6e82d4bb4,0,Alex Antonenko,2018-08-09 11:09:18+03:00,['7c6b099eb70528db5f765da5478e8933ecea17e1'],0,121,121,32436630,2,1,1,1,31776
312f617da8ca3cad8f8bed9a76c2a6952beda70f,0,Alex Antonenko,2018-08-09 11:11:05+03:00,"['7c6b099eb70528db5f765da5478e8933ecea17e1', 'f3ee18e32276f7d4c9d196741b975ad501e3d1b8']",0,0,0,32436630,0,,,,31776
b1c243f852035980b57c44d39ac4bb7f3b40b252,0,GitHub,2018-08-09 11:20:15+03:00,"['1ca963c14c4a70f221e5cd5b4675bca6e82d4bb4', 'f3ee18e32276f7d4c9d196741b975ad501e3d1b8']",0,0,0,32436630,0,,,,31776
514db78c27a70c2883392b9c26728fd3eb341b06,0,Aleksandr Kovalenko,2018-08-09 15:28:22+03:00,['f3ee18e32276f7d4c9d196741b975ad501e3d1b8'],0,7,7,32436637,1,,,,31776
c9965c0667f1c8a8f03ff209d6b91a065d32bf9a,0,Robert Levas,2018-08-09 10:02:55-04:00,['514db78c27a70c2883392b9c26728fd3eb341b06'],5,0,5,32436642,1,,,,31776
2ad598f300ababc6728a595434b181c8cdb5dc7f,0,GitHub,2018-08-09 17:29:01+03:00,"['c9965c0667f1c8a8f03ff209d6b91a065d32bf9a', 'b1c243f852035980b57c44d39ac4bb7f3b40b252']",0,121,121,32436763,2,,,,31776
1b20bcd902f57041b2a20925a713817737ef7547,0,Aleksandr Kovalenko,2018-08-09 17:47:55+03:00,['2ad598f300ababc6728a595434b181c8cdb5dc7f'],0,1,1,32436764,1,,,,31776
918795a3d91d001b8cd8e1ef48c5b1480beedd8b,0,GitHub,2018-08-09 10:05:43-07:00,['1b20bcd902f57041b2a20925a713817737ef7547'],110,307,417,32437181,9,0.424242424,0,0.916666667,31777
d99ae01a7144773537739cc540e0f56f4b93be39,0,Lisnichenko Dmitro,2018-08-09 20:39:05+03:00,['918795a3d91d001b8cd8e1ef48c5b1480beedd8b'],1,31,32,32437213,1,,,,31777
12278d8f59d0042b6e9ab6ecbbc971a4af52c3f7,0,Yusaku Sako,2018-08-09 11:49:30-07:00,['918795a3d91d001b8cd8e1ef48c5b1480beedd8b'],0,28,28,32437241,1,,,,31777
48a5c91183739713660eb6ecd9386b60ae173c2d,0,Yusaku Sako,2018-08-09 11:58:50-07:00,['12278d8f59d0042b6e9ab6ecbbc971a4af52c3f7'],0,4,4,32437245,1,,,,31777
fc6e964f5e447b1368569e455a545b8c8350cbd0,0,Robert Levas,2018-08-09 15:02:53-04:00,['48a5c91183739713660eb6ecd9386b60ae173c2d'],2,24,26,32437271,1,1,1,0,31777
40aac8240bb516cf1048afd0642e1e7d6dc2027f,0,GitHub,2018-08-09 17:12:07-07:00,['fc6e964f5e447b1368569e455a545b8c8350cbd0'],0,45,45,32437316,1,0,0,0.884615385,31777
7301ffc6506025495b6d59b5190dede336cd8404,0,aonishuk,2018-08-10 14:59:39+03:00,['40aac8240bb516cf1048afd0642e1e7d6dc2027f'],6,9,15,32437331,1,1,1,1,31777
4feee50df3524ffab261375771fcb8c0151ef334,0,GitHub,2018-08-10 15:51:15+03:00,"['7301ffc6506025495b6d59b5190dede336cd8404', 'd99ae01a7144773537739cc540e0f56f4b93be39']",1,31,32,32437363,1,,,,31777
f333ab7590c97cfcffe4cd5209ebda075ec4d04a,0,GitHub,2018-08-10 15:18:55+02:00,['4feee50df3524ffab261375771fcb8c0151ef334'],0,1,1,32437364,1,1,1,0,31777
ec55beefd4cc16eb0242eb0de1326faac2b39e6d,0,GitHub,2018-08-10 15:52:31+02:00,['f333ab7590c97cfcffe4cd5209ebda075ec4d04a'],3,11,14,32437378,3,0,0,1,31777
d680af8057a40ab38ab2866799eb9150283c6a4c,0,GitHub,2018-08-10 11:30:10-04:00,['ec55beefd4cc16eb0242eb0de1326faac2b39e6d'],680914,44,680958,33118336,2676,0.820864535,0.250132008,0.23719518,31777
c37b7ff02798e49fad2eba51d51450b9da704193,0,GitHub,2018-08-10 23:17:59+02:00,['d680af8057a40ab38ab2866799eb9150283c6a4c'],6,6,12,33118348,1,1,1,1,31777
73719b530c21677ae18f29529efec94100f9e1d6,1,GitHub,2018-08-13 11:03:30+02:00,['c37b7ff02798e49fad2eba51d51450b9da704193'],324,528,852,33119200,20,0.674418605,1,0.709302326,31779
121ea17f0b1fdd54259c94ad6de64c3aafda36bd,0,GitHub,2018-08-13 14:16:49+02:00,['73719b530c21677ae18f29529efec94100f9e1d6'],2,2,4,33119204,1,,,,31779
c5b67de1106ecbb64032d24abf73fb2946772e83,0,Yusaku Sako,2018-08-13 15:35:34-07:00,['121ea17f0b1fdd54259c94ad6de64c3aafda36bd'],2,14,16,33119220,1,,,,31779
d15a7bd3602478c7207614f68fe13e7e8c7f1872,1,GitHub,2018-08-14 10:38:15+02:00,['c5b67de1106ecbb64032d24abf73fb2946772e83'],2,6,8,33119228,3,1,1,1,31779
ad0f3585c7cc74bd4f68e420a37b973f605bb312,1,GitHub,2018-08-14 10:41:21+02:00,['d15a7bd3602478c7207614f68fe13e7e8c7f1872'],2,2,4,33119232,2,,,,31779
2ccf01b25e9a9418a1c1243840fc433f76104b09,1,GitHub,2018-08-14 10:52:43+02:00,['ad0f3585c7cc74bd4f68e420a37b973f605bb312'],27,5,32,33119264,2,1,0,1,31779
ee1076d5e358d4ecf2fb407400b566692352bbff,0,Alex Antonenko,2018-08-14 14:26:37+03:00,"['312f617da8ca3cad8f8bed9a76c2a6952beda70f', '2ccf01b25e9a9418a1c1243840fc433f76104b09']",681379,1169,682548,33801812,2724,,,,31779
89514bd49a1dba1f535d11fc920b9219afac48dc,0,Alex Antonenko,2018-08-14 16:09:35+03:00,['ee1076d5e358d4ecf2fb407400b566692352bbff'],0,129,129,33801941,2,0.738095238,1,1,31780
a4d1d48f71fc64b2d152f0d2736980c6540c8cd5,1,GitHub,2018-08-14 15:34:03+02:00,['2ccf01b25e9a9418a1c1243840fc433f76104b09'],2,2,4,33801945,1,,,,31780
6d8c53b8429de2f4c77e4cf00c06f884575e18b6,1,Dmytro Grinenko,2018-08-14 16:53:20+03:00,['a4d1d48f71fc64b2d152f0d2736980c6540c8cd5'],548,670,1218,33803163,18,,,,31782
04b738ed019a26a5295340a3e4ebbe5ba2be9c81,1,GitHub,2018-08-14 16:22:49+02:00,['6d8c53b8429de2f4c77e4cf00c06f884575e18b6'],30,57,87,33803250,3,1,1,1,31782
2e64484a1b7f7be20dab1d25924f6aa368012d1d,1,GitHub,2018-08-14 16:23:24+02:00,['04b738ed019a26a5295340a3e4ebbe5ba2be9c81'],3,9,12,33803262,3,,,,31782
a1487417ccd917642a99ec73aeecf30478a4da52,0,Aleksandr Kovalenko,2018-08-14 18:13:34+03:00,['2e64484a1b7f7be20dab1d25924f6aa368012d1d'],3,0,3,33803265,1,1,0,0,31782
df5845afbbbbf89755fbda809f8742633a6d220f,0,GitHub,2018-08-14 09:47:22-07:00,['a1487417ccd917642a99ec73aeecf30478a4da52'],8,32,40,33803305,3,0.428571429,0.428571429,1,31782
ca178909c01802893cffaa278f7e33796b4452cb,0,aonishuk,2018-08-14 22:51:25+03:00,['df5845afbbbbf89755fbda809f8742633a6d220f'],0,1,1,33803306,1,0,1,0,31782
271e63ba2da27dc8ea6bfdeab4562e6d63f59e48,0,Robert Levas,2018-08-14 17:57:49-04:00,['ca178909c01802893cffaa278f7e33796b4452cb'],8,89,97,33803403,2,0,0.823529412,1,31782
7f91e82369a4c599c05f4953bce9514fcd4b4846,1,GitHub,2018-08-15 10:18:23+02:00,['271e63ba2da27dc8ea6bfdeab4562e6d63f59e48'],4,4,8,33803411,2,,,,31782
47aa2562fee6d16e8cd4e38fd701d577b2e77bc2,1,GitHub,2018-08-15 11:37:44+02:00,['7f91e82369a4c599c05f4953bce9514fcd4b4846'],0,1,1,33803412,1,,,,31782
ad6d3eb653993faaed21f75fce8fe37575be624a,1,GitHub,2018-08-15 12:40:33+03:00,['47aa2562fee6d16e8cd4e38fd701d577b2e77bc2'],15,234,249,33803661,25,0.670731707,0.987804878,0.951219512,31784
55351b80b39920c74fddfc47be6e400d69c53d87,0,aBabiichuk,2018-08-15 17:15:18+03:00,['ad6d3eb653993faaed21f75fce8fe37575be624a'],3,5,8,33803669,1,,,,31784
db2c3c7e497e73a5d573afc92b19d7463be2dd66,0,GitHub,2018-08-15 17:27:37+03:00,"['55351b80b39920c74fddfc47be6e400d69c53d87', '89514bd49a1dba1f535d11fc920b9219afac48dc']",0,129,129,33803798,2,,,,31784
b73f84c9c32cfca28ad012960d0049af98ce65ed,0,GitHub,2018-08-15 19:14:35+02:00,['db2c3c7e497e73a5d573afc92b19d7463be2dd66'],2,4,6,33803804,1,0,1,1,31784
3f9d414fc6b2efe7f0772fcf1c5f93768b5b6245,1,GitHub,2018-08-15 21:49:00+03:00,['b73f84c9c32cfca28ad012960d0049af98ce65ed'],0,10,10,33803814,2,0,0,1,31784
49e8ee3b82a4133aa5e3b4647c423200c8df1b20,1,GitHub,2018-08-16 11:58:07+02:00,['3f9d414fc6b2efe7f0772fcf1c5f93768b5b6245'],22,185,207,33804021,18,0.371794872,1,0.871794872,31784
a7cfe50429e2f359a51e4e1a37ccb95922413866,0,GitHub,2018-08-16 11:58:30+02:00,['49e8ee3b82a4133aa5e3b4647c423200c8df1b20'],6,23,29,33804050,2,1,1,0.466666667,31784
7ccfd1ecce0dad1b7b74812d4626cb189f12ca82,0,Alex Antonenko,2018-08-16 13:02:11+03:00,['3f9d414fc6b2efe7f0772fcf1c5f93768b5b6245'],0,174,174,33804224,2,0.64,1,1,31785
0daa5f1e30dca18835e877c5051a183d0bb3178e,0,aonishuk,2018-08-16 13:13:29+03:00,['a7cfe50429e2f359a51e4e1a37ccb95922413866'],8,8,16,33804240,5,,,,31785
96335baaaf29757594bd719ca3adb76ff0eae27b,1,GitHub,2018-08-16 13:24:18+02:00,['0daa5f1e30dca18835e877c5051a183d0bb3178e'],2,2,4,33804244,1,,,,31785
60d4951e39ca1960741b9e7577a0b6b9aeb48d51,1,GitHub,2018-08-16 13:25:04+02:00,['96335baaaf29757594bd719ca3adb76ff0eae27b'],3,2,5,33804249,3,,,,31785
93c5f8e9d8194dbfed9dffef7e650bc7d6182132,0,GitHub,2018-08-16 16:41:20+03:00,"['60d4951e39ca1960741b9e7577a0b6b9aeb48d51', '7ccfd1ecce0dad1b7b74812d4626cb189f12ca82']",0,174,174,33804423,2,,,,31785
56441eb7679cd5ca15411d0c0c35f6d658187460,1,GitHub,2018-08-16 15:57:39+02:00,['93c5f8e9d8194dbfed9dffef7e650bc7d6182132'],32,102,134,33804557,7,0,0,0,31785
99c9070b2ac2774da5e1b41f46a15e0ffd1cd9fb,0,"Doroszlai, Attila",2018-08-16 18:04:55+02:00,['56441eb7679cd5ca15411d0c0c35f6d658187460'],1,1,2,33804559,1,,,,31785
9d525af84f38d0791e32fe1f04c747c284785932,0,Ishan Bhatt,2018-08-16 10:39:36-07:00,['99c9070b2ac2774da5e1b41f46a15e0ffd1cd9fb'],45,2,47,33804606,1,1,1,0.115384615,31785
bff6d0e86a29a2a57b7f6903778012cff079c2b4,0,GitHub,2018-08-16 11:04:31-07:00,['9d525af84f38d0791e32fe1f04c747c284785932'],0,1,1,33804607,1,0,1,1,31785
0d3cf9c38cf6ba4c0ed943af7df7b57619e1f0c2,0,aonishuk,2018-08-17 12:55:58+03:00,['bff6d0e86a29a2a57b7f6903778012cff079c2b4'],1,16,17,33804624,1,,,,31785
ba20a5913be26e826a99ce80a8d07d727cbe8feb,0,GitHub,2018-08-17 15:48:04+02:00,['0d3cf9c38cf6ba4c0ed943af7df7b57619e1f0c2'],9,10,19,33804643,3,1,1,0,31785
6f60dc224412321345db81fea35a2e4a23474834,1,GitHub,2018-08-17 22:01:47+02:00,['ba20a5913be26e826a99ce80a8d07d727cbe8feb'],1,4,5,33804648,2,,,,31785
e7a37c60b0d408ff756caa9d76e38405964a3e64,0,aBabiichuk,2018-08-18 00:20:35+03:00,['6f60dc224412321345db81fea35a2e4a23474834'],356,386,742,33805390,6,1,1,1,31785
9070ae9e1c5ca346e434820397c10d95caa5a81d,0,GitHub,2018-08-18 22:06:44-07:00,['e7a37c60b0d408ff756caa9d76e38405964a3e64'],129,129,258,33805648,16,,,,31785
154b36fde0c996b3806610f0f3d8cfdfb121766a,0,Andrii Tkach,2018-08-20 17:39:42+03:00,['9070ae9e1c5ca346e434820397c10d95caa5a81d'],1,27,28,33805676,2,,,,31785
005e50f97550264cafd4087166e696ce72196266,0,GitHub,2018-08-20 12:17:41-07:00,['154b36fde0c996b3806610f0f3d8cfdfb121766a'],2,4,6,33805682,1,1,1,1,31785
4c8f6f8f3035d5c0f875c8765c3970fc964ed1bc,1,GitHub,2018-08-21 01:03:23+02:00,['005e50f97550264cafd4087166e696ce72196266'],4,13,17,33805699,2,0,1,1,31785
dfaaf33a9e8d01390a7ecefd5b14ea740f5ee6e7,1,jayush,2018-08-21 00:18:54-07:00,['4c8f6f8f3035d5c0f875c8765c3970fc964ed1bc'],0,105,105,33805804,5,,,,31785
9491f1fd0232597c2e400b6b73ba1afb2dea50cc,0,aonishuk,2018-08-21 12:02:35+03:00,['dfaaf33a9e8d01390a7ecefd5b14ea740f5ee6e7'],2,2,4,33805808,2,,,,31785
17f6792e61b8e5b8ad0181858f3d730ed17e9f93,0,Robert Levas,2018-08-21 05:14:08-04:00,['9491f1fd0232597c2e400b6b73ba1afb2dea50cc'],615,94,709,33806517,7,0.14375,0,0,31785
431b3999e1a3d08b2c41e6acd7d06196a0cb39ad,0,Alex Antonenko,2018-08-21 14:37:57+03:00,['17f6792e61b8e5b8ad0181858f3d730ed17e9f93'],0,109,109,33806626,2,0.659090909,1,1,31786
719595427f10579e994f242b888035e9e36ce49d,1,Andrii Tkach,2018-08-21 15:12:19+03:00,['17f6792e61b8e5b8ad0181858f3d730ed17e9f93'],3,3,6,33806632,3,1,0.6,1,31787
93818f3412267ddd21ac2e5193240b71e201d2b9,0,Olivér Szabó,2018-08-21 15:02:55+02:00,['719595427f10579e994f242b888035e9e36ce49d'],3,3,6,33806638,2,,,,31787
d98d367afa7508d0c2499cbed9c5f95c94840d52,0,Alex Antonenko,2018-08-21 17:08:00+03:00,['17f6792e61b8e5b8ad0181858f3d730ed17e9f93'],0,93,93,33806731,2,0.528571429,1,1,31788
539d8ee66eafa2e8a0fa920319afb3bc2be23954,0,Olivér Szabó,2018-08-21 17:51:22+02:00,['93818f3412267ddd21ac2e5193240b71e201d2b9'],6,6,12,33806743,1,,,,31788
5a2d63e2cc887dae8af56c97c4673e7113f7c91c,0,Olivér Szabó,2018-08-21 18:34:20+02:00,['539d8ee66eafa2e8a0fa920319afb3bc2be23954'],3,3,6,33806749,1,,,,31788
7c73d98bb0c3d9fb57b328f436de888705f8ddce,0,Oliver Szabo,2018-08-21 18:46:35+02:00,['5a2d63e2cc887dae8af56c97c4673e7113f7c91c'],0,35,35,33806784,1,,,,31788
bff429caaaa98325e97fd32868fc92b8c7a0dfa5,0,Robert Levas,2018-08-21 16:38:32-04:00,['7c73d98bb0c3d9fb57b328f436de888705f8ddce'],1,1,2,33806786,1,,,,31788
31ebcd2548337621921e0606a26130c7d2f6f554,0,GitHub,2018-08-22 09:57:30+05:18,['bff429caaaa98325e97fd32868fc92b8c7a0dfa5'],26,324,350,33807136,16,0.705128205,1,1,31790
d497004d39639102d4092509ef8d955840bf3ecc,0,GitHub,2018-08-22 14:23:37+03:00,['31ebcd2548337621921e0606a26130c7d2f6f554'],13,47,60,33807196,2,0,0.310344828,0.931034483,31790
a8e90227a630dec4e48afa55630957a911641f1b,0,Robert Levas,2018-08-22 13:01:56-04:00,['d497004d39639102d4092509ef8d955840bf3ecc'],7,127,134,33807330,5,0,1,0.873015873,31790
500a00b92c76f7444665865a42f26fe356cb28a9,1,aonishuk,2018-08-23 09:00:36+03:00,['a8e90227a630dec4e48afa55630957a911641f1b'],1,5,6,33807336,1,0,0.5,0.5,31790
64cf74a241c1c40a0ea96e2e2f1acd2b66668920,0,GitHub,2018-08-23 11:53:27+03:00,"['500a00b92c76f7444665865a42f26fe356cb28a9', '431b3999e1a3d08b2c41e6acd7d06196a0cb39ad']",0,109,109,33807445,2,,,,31790
db5be4917fcf69951d48aae0311b85573481656a,0,Alex Antonenko,2018-08-23 12:08:32+03:00,['d98d367afa7508d0c2499cbed9c5f95c94840d52'],12,0,12,33807457,1,0,0,0,31790
dda8b504ab2b62b28964a7ca6220b4fbe060f2ce,0,Andrii Tkach,2018-08-23 15:05:31+03:00,['64cf74a241c1c40a0ea96e2e2f1acd2b66668920'],15,13,28,33807485,5,0,0,0,31790
79ed22126f1ae203d70375bd17088f7c0a2e9645,0,Ishan Bhatt,2018-08-23 09:46:24-07:00,['dda8b504ab2b62b28964a7ca6220b4fbe060f2ce'],6,24,30,33807515,4,0.722222222,0.722222222,0.722222222,31790
0543c9c9d6e7dbcd860fd46fefcf40cf4607ab46,1,Olivér Szabó,2018-08-23 21:00:48+02:00,['79ed22126f1ae203d70375bd17088f7c0a2e9645'],0,44,44,33807559,2,,,,31790
7053df76887100e732f7ac4e1962bcad15d968c7,1,Aleksandr Kovalenko,2018-08-23 22:28:04+03:00,['0543c9c9d6e7dbcd860fd46fefcf40cf4607ab46'],0,317,317,33807876,1,0.848979592,1,0.791836735,31790
7a4aa72b026372ba62b22dbad79c6cc57fe66f8e,0,GitHub,2018-08-24 23:57:06+02:00,['7053df76887100e732f7ac4e1962bcad15d968c7'],3,4,7,33807883,4,,,,31790
f025066d04db58d0b34ee4f97f19bd4eb09db5b3,0,Oliver Szabo,2018-08-25 13:04:59+02:00,['7a4aa72b026372ba62b22dbad79c6cc57fe66f8e'],1,1,2,33807885,1,,,,31790
93375b8c0bb7f590940d73c3e73ada7cecbdf6d5,1,GitHub,2018-08-27 14:30:55+02:00,['f025066d04db58d0b34ee4f97f19bd4eb09db5b3'],0,7,7,33807892,1,,,,31790
872494eade848cad09eef7c81997a43bdce9b34c,1,GitHub,2018-08-27 14:36:53+02:00,['93375b8c0bb7f590940d73c3e73ada7cecbdf6d5'],9,19,28,33807920,5,0.857142857,1,0.857142857,31790
9e746aff0eb59aff57053463edbec1405a9d6a48,0,Andrii Tkach,2018-08-27 17:10:26+03:00,['872494eade848cad09eef7c81997a43bdce9b34c'],0,69,69,33807989,1,,,,31790
448756230b4679644425af34728a41af6987e4c0,1,GitHub,2018-08-27 19:49:54+02:00,['9e746aff0eb59aff57053463edbec1405a9d6a48'],4,35,39,33808028,7,0.409090909,0,1,31790
17caa686539f164622db7243a503db7fe4349a65,1,GitHub,2018-08-28 07:37:08+02:00,['448756230b4679644425af34728a41af6987e4c0'],8,185,193,33808221,6,0.733333333,1,1,31792
914985e406be9c4fb6a728a72b0b4644c98879da,0,Attila Magyar,2018-08-28 13:15:42+02:00,['17caa686539f164622db7243a503db7fe4349a65'],12,0,12,33808233,1,,,,31792
251aec097c805f672ca1d411ff58bb37a2cb060e,0,Attila Magyar,2018-08-28 13:16:03+02:00,['914985e406be9c4fb6a728a72b0b4644c98879da'],3,14,17,33808250,1,,,,31792
93e177c81a1cc438b80d5eddbbb3afe0549a79ee,0,GitHub,2018-08-28 16:10:49+02:00,['251aec097c805f672ca1d411ff58bb37a2cb060e'],0,54,54,33808304,2,0.9,0.65,0.475,31792
6f64d635c474012e60806f1f9aff6b0c2a09021f,0,GitHub,2018-08-28 13:33:14-07:00,['93e177c81a1cc438b80d5eddbbb3afe0549a79ee'],11,1,12,33808316,2,,,,31792
1edde0cfd7b91a76b306688252d41914979942e9,1,GitHub,2018-08-29 09:11:05+02:00,['6f64d635c474012e60806f1f9aff6b0c2a09021f'],101,247,348,33808664,3,0.864864865,0.945945946,1,31792
e7c69231d682fcc99d85239e2a2e037ec300fecd,1,aonishuk,2018-08-29 14:02:50+03:00,['1edde0cfd7b91a76b306688252d41914979942e9'],138,153,291,33808955,10,1,1,0,31792
78f54fe3dbc0f59dbdf514fa9174549c89195be5,0,aonishuk,2018-08-29 14:02:50+03:00,['e7c69231d682fcc99d85239e2a2e037ec300fecd'],10,14,24,33808979,2,0,1,1,31792
5bd37c7cadcef0aaeccb48cdda0ac5043518231b,0,Robert Levas,2018-08-29 08:36:33-04:00,['78f54fe3dbc0f59dbdf514fa9174549c89195be5'],2,22,24,33809003,3,,,,31792
08f0071c6455b419543a3ec635b4b0a681d98b58,0,GitHub,2018-08-29 12:09:53-07:00,['5bd37c7cadcef0aaeccb48cdda0ac5043518231b'],975,0,975,33809978,9,0.542787286,0.35207824,0.17603912,31792
06fd55b88751e81a8b970bde3c815b90f04ccedd,0,GitHub,2018-08-29 21:24:53+02:00,['08f0071c6455b419543a3ec635b4b0a681d98b58'],1,1,2,33809980,1,,,,31792
6fc2418860e00565a1b5f447287451990ef55820,0,Robert Levas,2018-08-30 08:43:21-04:00,['06fd55b88751e81a8b970bde3c815b90f04ccedd'],142,241,383,33810363,4,0.896551724,1,1,31792
a4af8ed297a00b367f5948941b6cd92943d00b13,0,aonishuk,2018-08-30 16:44:06+03:00,['6fc2418860e00565a1b5f447287451990ef55820'],1,4,5,33810368,1,0,1,1,31792
c4f79dd0d678847f1a5ed9ea4b9a9d2b6dd72331,0,GitHub,2018-08-30 17:49:20+03:00,['a4af8ed297a00b367f5948941b6cd92943d00b13'],5,123,128,33810496,2,0.227848101,0.721518987,1,31792
0d85927147d9763df98a2c49e269dea36e42a8e7,0,Alex Antonenko,2018-08-30 17:58:02+03:00,['6fc2418860e00565a1b5f447287451990ef55820'],0,117,117,33810613,2,1,1,1,31793
d06469a094c9e76c0e9cc6dd490198e24d4965f9,1,GitHub,2018-08-30 19:12:13+02:00,['c4f79dd0d678847f1a5ed9ea4b9a9d2b6dd72331'],0,98,98,33810711,4,1,1,1,31795
47a9fe42d5d47bf86673284b976b4f2fd11d03f7,0,GitHub,2018-08-31 09:10:53+05:18,['d06469a094c9e76c0e9cc6dd490198e24d4965f9'],15,105,120,33810831,6,0.551020408,1,0.489795918,31795
8a79291ff36b23014a14261c703658437db9acc3,0,GitHub,2018-08-31 10:01:25+02:00,['47a9fe42d5d47bf86673284b976b4f2fd11d03f7'],3,88,91,33810922,5,0.725490196,0.666666667,1,31795
e6f1d35bf630ca3f7f5f479978baf3430a10089d,0,GitHub,2018-08-31 13:31:44+03:00,['8a79291ff36b23014a14261c703658437db9acc3'],15,80,95,33811017,4,0.431034483,0.120689655,1,31795
14811e4ff0049382e8f9496e9f3742ca0e141873,0,aBabiichuk,2018-08-31 13:32:12+03:00,['e6f1d35bf630ca3f7f5f479978baf3430a10089d'],1,7,8,33811025,2,0,1,1,31795
6451f81783a11b9e159763d98df8a9691062ddc9,0,aBabiichuk,2018-08-31 14:07:31+03:00,['14811e4ff0049382e8f9496e9f3742ca0e141873'],104,90,194,33811219,8,,,,31795
e3db41df1888d1b7f0e524760700cd94ee106d66,0,Andrii Tkach,2018-08-31 18:58:20+03:00,['6451f81783a11b9e159763d98df8a9691062ddc9'],0,3,3,33811222,1,,,,31795
dd5c769e516b9bd25c6c40db6bef16ca8ee16df7,0,Ishan Bhatt,2018-08-31 10:58:30-07:00,['e3db41df1888d1b7f0e524760700cd94ee106d66'],9,119,128,33811350,2,1,0.875,1,31795
a4b2901a9a16e356c230fb647471e099b2d965ba,0,Jonathan Hurley,2018-08-31 16:05:54-04:00,['dd5c769e516b9bd25c6c40db6bef16ca8ee16df7'],4,7,11,33811361,1,0,0,0,31795
4df6c5171a9b5c567feb95188152567889414d9f,0,Oliver Szabo,2018-09-01 00:58:58+02:00,['a4b2901a9a16e356c230fb647471e099b2d965ba'],1,13,14,33811375,1,1,1,1,31795
8ae34e9af9c3abbc311660c2ec391aa6614d4044,1,GitHub,2018-09-03 11:45:26+02:00,['4df6c5171a9b5c567feb95188152567889414d9f'],1172,1056,2228,33813603,36,1,0.652173913,0.906832298,31808
085208a7050eb9d4b1d1f30f7949d2982568a0ea,0,GitHub,2018-09-03 23:46:30+03:00,"['8ae34e9af9c3abbc311660c2ec391aa6614d4044', '0d85927147d9763df98a2c49e269dea36e42a8e7']",0,117,117,33813720,2,,,,31808
58c6aa25ea42311501eaad3075acb89959ddc78d,0,Alex Antonenko,2018-09-04 01:15:55+03:00,['085208a7050eb9d4b1d1f30f7949d2982568a0ea'],0,10,10,33813730,2,0,0,0,31808
92bf920e1032266cbc101651f6153c95a2d6472a,0,Alex Antonenko,2018-09-04 11:40:25+03:00,['58c6aa25ea42311501eaad3075acb89959ddc78d'],3,17,20,33813750,3,0,0,0,31808
2b52c9a93c1ad6c7654736faf7eb3559075d3ccf,0,Aleksandr Kovalenko,2018-09-04 13:02:50+03:00,['085208a7050eb9d4b1d1f30f7949d2982568a0ea'],13,29,42,33813792,3,0.928571429,1,0.714285714,31808
29ea5bdb7cf9f4a8f24b437fef6c9659b9549ab1,0,Andrii Tkach,2018-09-04 13:17:55+03:00,['2b52c9a93c1ad6c7654736faf7eb3559075d3ccf'],1,2,3,33813795,2,0,0,1,31808
64442589e41cbecce49376e73a28972c3b88eb4e,1,aonishuk,2018-09-04 17:37:50+03:00,['29ea5bdb7cf9f4a8f24b437fef6c9659b9549ab1'],4,9,13,33813808,1,0,0,0,31808
a41262e2fa1728f665bc16a4aaf00e389b000f11,0,aonishuk,2018-09-04 17:39:01+03:00,['64442589e41cbecce49376e73a28972c3b88eb4e'],0,35,35,33813843,1,0.772727273,0.090909091,0.909090909,31808
51e5eab48ca0b468020a5cb714116d04970e9db7,1,Alex Antonenko,2018-09-04 17:47:01+03:00,['92bf920e1032266cbc101651f6153c95a2d6472a'],14,80,94,33813937,2,0.149253731,1,1,31808
160b6a043bdb918560fc7475d3f0ab97d7abf6e5,0,Aleksandr Kovalenko,2018-09-04 18:16:36+03:00,['a41262e2fa1728f665bc16a4aaf00e389b000f11'],5,5,10,33813947,1,,,,31808
a3d548a089cff5a57d1333955b996929186cb68e,0,GitHub,2018-09-04 18:59:32+03:00,"['160b6a043bdb918560fc7475d3f0ab97d7abf6e5', '51e5eab48ca0b468020a5cb714116d04970e9db7']",1,91,92,33814039,4,,,,31808
b84ad9f03af89b7adabb22e14b429728246bf544,0,GitHub,2018-09-04 20:28:00+02:00,['a3d548a089cff5a57d1333955b996929186cb68e'],9,115,124,33814163,2,0.684931507,1,0.821917808,31808
85a0e3203034aeba9ad5923d068382e160701355,1,GitHub,2018-09-05 13:03:06+02:00,['b84ad9f03af89b7adabb22e14b429728246bf544'],197,604,801,33814964,16,0.305699482,0,0.70984456,31812
f3f64528b5583234e58b5ff205d1cb063ce1c97f,0,GitHub,2018-09-05 15:14:28+02:00,['85a0e3203034aeba9ad5923d068382e160701355'],0,2,2,33814966,1,0,0,1,31812
4b5aafcf9cce58f56b28b5758fc0890874e26b50,1,GitHub,2018-09-05 18:31:10+03:00,['f3f64528b5583234e58b5ff205d1cb063ce1c97f'],76,242,318,33815284,23,0.240384615,0.490384615,0.923076923,31812
8055899fa892c0e6425cb70d97088491a0398267,0,GitHub,2018-09-06 12:31:59+03:00,['4b5aafcf9cce58f56b28b5758fc0890874e26b50'],1,1,2,33815286,1,,,,31812
014d379cc91f7555b3353bcb1838786a6ca76ef3,0,GitHub,2018-09-06 15:57:53+03:00,['8055899fa892c0e6425cb70d97088491a0398267'],3,3,6,33815292,1,,,,31812
7ce6e4e983fb98b3152116bbcfc2db375c344539,0,GitHub,2018-09-06 16:15:04+02:00,['014d379cc91f7555b3353bcb1838786a6ca76ef3'],2,5,7,33815299,1,1,1,0,31812
96faa4efbf438d1e224583767bab42a0bf1ba5de,0,Aleksandr Kovalenko,2018-09-06 17:18:38+03:00,['7ce6e4e983fb98b3152116bbcfc2db375c344539'],3,8,11,33815310,2,,,,31812
991e107030ff7e0fbbf220a02abdde906ad0a526,0,GitHub,2018-09-06 16:53:07+02:00,['96faa4efbf438d1e224583767bab42a0bf1ba5de'],0,12,12,33815322,6,,,,31812
e8f7413cb646d5f9062eb2d929ebc02810dc4d72,1,GitHub,2018-09-07 10:46:09+02:00,['991e107030ff7e0fbbf220a02abdde906ad0a526'],21,515,536,33815858,14,0.788888889,0.966666667,0.927777778,31817
8289c7f79a4a20332c7a62e96871f31b54157662,1,GitHub,2018-09-07 18:26:32+02:00,['e8f7413cb646d5f9062eb2d929ebc02810dc4d72'],179,792,971,33816829,34,0.912,0.88,0.952,31827
4b60f5ce03a44f320a252dbb8ab88c078d54a345,0,Aleksandr Kovalenko,2018-09-10 13:01:49+03:00,['8289c7f79a4a20332c7a62e96871f31b54157662'],1,1,2,33816831,1,,,,31827
ab3a2449432a23cb9c050d0876717e9f581dd767,0,GitHub,2018-09-10 13:46:17+03:00,['4b60f5ce03a44f320a252dbb8ab88c078d54a345'],0,4,4,33816835,1,0,0,0,31827
d9ab7ba8cc9f8b3ee4a7d888945d474c187ddb38,0,GitHub,2018-09-10 14:21:40+02:00,['ab3a2449432a23cb9c050d0876717e9f581dd767'],28,40,68,33816903,10,1,1,0,31827
70b0579d1a66adc9299e3cd9aa44c920406a0da9,0,Andrii Tkach,2018-09-10 16:58:18+03:00,['d9ab7ba8cc9f8b3ee4a7d888945d474c187ddb38'],3,2,5,33816908,1,0,0,0,31827
7cc5c9d3c49740fabdece358429dd5b7fad4f007,1,aonishuk,2018-09-10 17:12:29+03:00,['70b0579d1a66adc9299e3cd9aa44c920406a0da9'],7,9,16,33816924,1,0.5,1,1,31827
68d0b6430c5c2fbb72e7e4b52f1b60bccb07e773,0,GitHub,2018-09-10 16:13:26+02:00,['7cc5c9d3c49740fabdece358429dd5b7fad4f007'],7,211,218,33817142,2,0,0,1,31828
c17762bdd91fddc0cca87d3aa24e4121c7b5e675,1,GitHub,2018-09-11 00:08:28+02:00,['68d0b6430c5c2fbb72e7e4b52f1b60bccb07e773'],3,16,19,33817161,2,1,1,1,31828
b2f3690375e96fb00ab07701d4984c7e0306904b,0,hiveww,2018-09-11 13:12:47+03:00,['c17762bdd91fddc0cca87d3aa24e4121c7b5e675'],1,2,3,33817164,1,1,1,1,31828
6645b45e9bb680e41255671d3e742fe097018de6,0,aBabiichuk,2018-09-11 17:48:08+03:00,['c17762bdd91fddc0cca87d3aa24e4121c7b5e675'],106,176,282,33817446,5,0,1,1,31828
3ed311faaf9aab6c10480942f16e996181156951,1,GitHub,2018-09-12 13:45:22+02:00,['6645b45e9bb680e41255671d3e742fe097018de6'],2,2,4,33817450,1,,,,31828
218f99d44f5209b93c5150ff81c99f11e7b750b7,0,Andrii Tkach,2018-09-12 16:05:42+03:00,['3ed311faaf9aab6c10480942f16e996181156951'],1,4,5,33817455,1,1,1,1,31828
d5a1acc87a61b3ee1987f9dd04af78e5d767f060,0,Alex Antonenko,2018-09-12 16:13:20+03:00,['b2f3690375e96fb00ab07701d4984c7e0306904b'],3,8,11,33817466,1,0.8,1,1,31828
ff3952f66ba3aa400c68a07635926cb4ecbe68c7,0,GitHub,2018-09-12 17:13:13+03:00,"['218f99d44f5209b93c5150ff81c99f11e7b750b7', 'd5a1acc87a61b3ee1987f9dd04af78e5d767f060']",4,10,14,33817480,2,,,,31828
c683a6b7c26591a7f6c1e6a2a3e3c89bacd9654c,0,GitHub,2018-09-12 17:33:22+03:00,['ff3952f66ba3aa400c68a07635926cb4ecbe68c7'],1,1,2,33817482,1,,,,31828
6cd99d29eacc42b610557edd30585eff3b445203,0,GitHub,2018-09-12 21:18:33+03:00,['c683a6b7c26591a7f6c1e6a2a3e3c89bacd9654c'],4,57,61,33817543,7,0.64,0.68,0.76,31828
c3758530a7762821ffcc21cf3197091dfeb68875,1,GitHub,2018-09-12 23:42:26+02:00,['6cd99d29eacc42b610557edd30585eff3b445203'],0,90,90,33817633,4,0.305555556,0.305555556,1,31828
281d1ae8f268e875032a3b2e58297884f9142c6b,0,Alex Antonenko,2018-09-13 12:35:00+03:00,['c3758530a7762821ffcc21cf3197091dfeb68875'],4,5,9,33817642,3,,,,31828
98dc82b7af40948efa73cc205758c7aeaa4a2521,0,Andrii Tkach,2018-09-13 15:08:22+03:00,['c3758530a7762821ffcc21cf3197091dfeb68875'],10,40,50,33817692,4,1,1,1,31828
3edb35c368912eaaeb547e36e4672b4862777cfd,0,aonishuk,2018-09-13 15:23:10+03:00,['98dc82b7af40948efa73cc205758c7aeaa4a2521'],1,1,2,33817694,1,,,,31828
ffeaf06c625046a554ca7e0f422dae3a9c109100,0,Aleksandr Kovalenko,2018-09-13 16:15:56+03:00,['3edb35c368912eaaeb547e36e4672b4862777cfd'],3,3,6,33817700,2,,,,31828
8c9b50cdd4e091312277067bf4c142deb23c8f16,1,Aleksandr Kovalenko,2018-09-13 16:16:10+03:00,['ffeaf06c625046a554ca7e0f422dae3a9c109100'],15,15,30,33817730,9,,,,31828
e3c3e34b317009d39a1e795c1c5c01767e69bbfb,0,Aleksandr Kovalenko,2018-09-13 16:16:10+03:00,['8c9b50cdd4e091312277067bf4c142deb23c8f16'],1,1,2,33817732,1,,,,31828
9457e43c313c57813e90972034fb423a5d6fa6c1,0,GitHub,2018-09-13 17:06:01+03:00,"['e3c3e34b317009d39a1e795c1c5c01767e69bbfb', '281d1ae8f268e875032a3b2e58297884f9142c6b']",4,5,9,33817741,3,,,,31828
443a473fec9f30bcfa9ecd0f52d8b1d86b487cb2,0,Ishan Bhatt,2018-09-13 20:48:41-07:00,['9457e43c313c57813e90972034fb423a5d6fa6c1'],16,19,35,33817776,2,0,1,1,31828
c03f4b061f17f4088667e857557d535166031352,0,GitHub,2018-09-13 21:22:02-07:00,['443a473fec9f30bcfa9ecd0f52d8b1d86b487cb2'],2,2,4,33817780,1,,,,31828
8add52c94b204eba6931a379602ff39c94cd9592,1,GitHub,2018-09-14 14:28:46+02:00,['c03f4b061f17f4088667e857557d535166031352'],17,82,99,33817879,6,0.363636364,0.727272727,0.757575758,31828
6d7ef715d06fb5a8b7e2ba78d20e881de4227d1b,0,Andrii Tkach,2018-09-14 16:45:27+03:00,['8add52c94b204eba6931a379602ff39c94cd9592'],1,2,3,33817882,1,0,0,1,31828
9a81c820816df788493cc43e37de4d33e01ddc3a,0,aBabiichuk,2018-09-14 20:13:04+03:00,['6d7ef715d06fb5a8b7e2ba78d20e881de4227d1b'],4,5,9,33817891,3,0.666666667,1,1,31828
611337c928c99222133effb3ad8dc708cdfb8da3,1,Madhuvanthi Radhakrishnan,2018-09-14 14:26:42-07:00,['9a81c820816df788493cc43e37de4d33e01ddc3a'],2,964,966,33818857,6,0.6,0.657142857,0.942857143,31832
cbb50ad120ac05f89b19cfe1f1bc819860dfd1bb,0,GitHub,2018-09-17 13:01:24+02:00,['611337c928c99222133effb3ad8dc708cdfb8da3'],5,14,19,33818876,5,0,0,0,31832
10706cb851cba628f3fd415620e82dce955a66b9,0,aonishuk,2018-09-17 15:11:17+03:00,['cbb50ad120ac05f89b19cfe1f1bc819860dfd1bb'],3,24,27,33818903,2,1,1,1,31833
4db8904e67cd814bd775243717e049d95e2f92e1,0,aonishuk,2018-09-17 15:11:47+03:00,['10706cb851cba628f3fd415620e82dce955a66b9'],1,2,3,33818906,1,0,0,1,31833
9d307c8758088cde7e7fb9a960525c9e6bc7f799,1,GitHub,2018-09-17 14:51:40+02:00,['4db8904e67cd814bd775243717e049d95e2f92e1'],3,294,297,33819203,5,0.589041096,0.595890411,0.863013699,31834
60f0b5edb2e5d53e47b008148678c56d5ff47b0e,0,Aleksandr Kovalenko,2018-09-17 17:08:03+03:00,['9d307c8758088cde7e7fb9a960525c9e6bc7f799'],3,3,6,33819209,2,,,,31834
f4417ffa9b81c0072181295a6738129cf6a61bd8,0,Aleksandr Kovalenko,2018-09-17 17:08:03+03:00,['60f0b5edb2e5d53e47b008148678c56d5ff47b0e'],6,6,12,33819221,1,1,1,1,31834
7289a4faa8389b112abfd318133bf2c53ae2cba8,1,Oliver Szabo,2018-09-17 22:09:19+02:00,['f4417ffa9b81c0072181295a6738129cf6a61bd8'],1,1,2,33819223,1,,,,31834
e1bce35bcee9ea5e331f21cff73e684175f2b2a4,1,GitHub,2018-09-18 12:56:24+02:00,['7289a4faa8389b112abfd318133bf2c53ae2cba8'],38,263,301,33819524,12,0.701298701,0.714285714,0.935064935,31837
b1a677d81fa3160ba71afc782621c87e062451e6,0,GitHub,2018-09-18 15:30:13+03:00,"['e1bce35bcee9ea5e331f21cff73e684175f2b2a4', 'db5be4917fcf69951d48aae0311b85573481656a']",0,81,81,33819605,2,,,,31837
45ffbb1af74d9c7df47fe2132fd5decd719a3634,0,aonishuk,2018-09-18 18:13:34+03:00,['b1a677d81fa3160ba71afc782621c87e062451e6'],2,24,26,33819631,2,1,1,1,31837
620539fa490b05ce0b4e93911423fd10e1267053,1,GitHub,2018-09-18 11:24:00-04:00,['45ffbb1af74d9c7df47fe2132fd5decd719a3634'],311,907,1218,33820849,21,0.320945946,0.668918919,0.905405405,31837
544b07e74938584571c51ac0a109b2e6d4c33d78,1,GitHub,2018-09-19 14:06:44+02:00,['620539fa490b05ce0b4e93911423fd10e1267053'],148,557,705,33821554,32,0.882352941,0.725490196,1,31841
990724ccde27574e2c87e852a3d4b6fb95d056bb,1,GitHub,2018-09-19 21:35:43+02:00,['544b07e74938584571c51ac0a109b2e6d4c33d78'],21,659,680,33822234,14,0.720472441,0.921259843,1,31845
1c7f58956d84e2a2d792cde87e69bf24a82fcdc2,0,Alex Antonenko,2018-09-20 16:03:07+03:00,['990724ccde27574e2c87e852a3d4b6fb95d056bb'],0,173,173,33822407,4,1,1,1,31848
f45cfa1d6afebd7cac75f1086adb218071999fe7,0,aBabiichuk,2018-09-20 16:58:24+03:00,['990724ccde27574e2c87e852a3d4b6fb95d056bb'],62,89,151,33822558,18,0,0,0,31850
5f6e50203f745891d7685bac027279083b5b640a,0,GitHub,2018-09-20 18:33:35+03:00,['f45cfa1d6afebd7cac75f1086adb218071999fe7'],17,27,44,33822602,1,0,0,1,31850
a06742b217874289de907f845266c4d63d7f2f81,1,Oliver Szabo,2018-09-21 00:20:57+02:00,['5f6e50203f745891d7685bac027279083b5b640a'],5,5,10,33822612,1,,,,31850
3231893f6488bafed5d5c0d87d0aeaccb8d24498,0,Andrii Tkach,2018-09-21 14:47:34+03:00,['a06742b217874289de907f845266c4d63d7f2f81'],1,15,16,33822628,2,1,1,1,31850
ef774a4f8c283040bcdbcdd5570a9155deef3997,0,GitHub,2018-09-22 21:08:15+02:00,['3231893f6488bafed5d5c0d87d0aeaccb8d24498'],38,35,73,33822701,20,1,1,1,31850
40a3040aab66a05cc2dec198cbc9cee3cdc7a7b2,0,GitHub,2018-09-22 21:09:08+02:00,['ef774a4f8c283040bcdbcdd5570a9155deef3997'],0,35,35,33822736,1,,,,31850
b1966bd200225389c5a3cbc29d46892712d19fbe,0,GitHub,2018-09-22 21:10:02+02:00,['40a3040aab66a05cc2dec198cbc9cee3cdc7a7b2'],0,11,11,33822747,1,1,1,1,31850
aca66a0175881e0a4739c8a52ed0e6e015e3376b,0,Aleksandr Kovalenko,2018-09-24 14:18:01+03:00,['b1966bd200225389c5a3cbc29d46892712d19fbe'],16,81,97,33822844,2,0.672131148,1,1,31850
eadc7df973f5e0fe6389e24aa4d8e10302e3ced5,0,aonishuk,2018-09-24 15:24:53+03:00,['aca66a0175881e0a4739c8a52ed0e6e015e3376b'],8,17,25,33822869,2,0.125,0,0.625,31850
c7309337719d418490df9397698c68aebe739686,0,Andrii Tkach,2018-09-24 17:16:06+03:00,['eadc7df973f5e0fe6389e24aa4d8e10302e3ced5'],1,2,3,33822872,1,1,1,1,31850
1aed5cec814d8733c9e7f4d2bfc8626d8942c345,0,GitHub,2018-09-24 18:40:49+03:00,"['c7309337719d418490df9397698c68aebe739686', '1c7f58956d84e2a2d792cde87e69bf24a82fcdc2']",0,173,173,33823045,4,,,,31850
89b882b4321e6d2184fa2dd209d0e4e5f67853d8,0,GitHub,2018-09-24 10:32:51-07:00,['1aed5cec814d8733c9e7f4d2bfc8626d8942c345'],10,18,28,33823073,2,0,0,1,31850
7e29cd223e4efdf0f4e1c78bc74d8533b7103c76,0,GitHub,2018-09-24 14:01:57-07:00,['89b882b4321e6d2184fa2dd209d0e4e5f67853d8'],0,1,1,33823074,1,0,1,1,31850
5a9b6e03bc27493f427043b0ae735b20815cfd1e,1,GitHub,2018-09-24 15:15:39-07:00,['7e29cd223e4efdf0f4e1c78bc74d8533b7103c76'],4,40,44,33823118,2,0.035714286,0.714285714,0.714285714,31850
8b6d9001784dcaef282ebc159c37e78eece15c2e,0,GitHub,2018-09-25 15:18:45+02:00,['5a9b6e03bc27493f427043b0ae735b20815cfd1e'],0,67,67,33823185,2,1,1,1,31851
f26bad435c6b9914e400472ec923e2fddf39ea22,0,GitHub,2018-09-26 10:12:02+05:18,['8b6d9001784dcaef282ebc159c37e78eece15c2e'],183,228,411,33823596,4,0.25,0.270833333,1,31851
1aae0de04bb29b9e14603722be18fe8393c4fbd8,1,aonishuk,2018-09-26 12:29:38+03:00,['f26bad435c6b9914e400472ec923e2fddf39ea22'],12,43,55,33823651,3,0.260869565,1,1,31851
204e7770ace9b017fb3d6be127d5e3f3938ea01b,0,aonishuk,2018-09-26 12:29:38+03:00,['1aae0de04bb29b9e14603722be18fe8393c4fbd8'],1,1,2,33823653,1,,,,31851
50d955084256a79c2b03599cfc0e3658779057d5,0,aonishuk,2018-09-26 12:46:25+03:00,['204e7770ace9b017fb3d6be127d5e3f3938ea01b'],7,21,28,33823681,3,0.4,0.4,1,31851
e64f3dfb2365cfdfa14db553b0d9b55a3e80f6e2,0,aonishuk,2018-09-26 12:46:25+03:00,['50d955084256a79c2b03599cfc0e3658779057d5'],1,1,2,33823683,1,,,,31851
46711f8259e388868ce2a58845e7edc92c199b1a,0,GitHub,2018-09-26 13:53:58+03:00,['e64f3dfb2365cfdfa14db553b0d9b55a3e80f6e2'],6,256,262,33823945,18,0.348214286,0.767857143,0.928571429,31853
3a5177f1c11e980f752ec7444eb98d24d178e1f6,0,GitHub,2018-09-26 08:01:38-04:00,['46711f8259e388868ce2a58845e7edc92c199b1a'],8,257,265,33824210,3,1,1,1,31854
ec097f6563b85b49e06c4d41053e101d2c6c8656,1,GitHub,2018-09-26 08:16:42-04:00,['3a5177f1c11e980f752ec7444eb98d24d178e1f6'],0,1126,1126,33825336,17,1,1,0.881118881,31868
1bc2c69747b9c8be6cfb22d4325d4014a1452970,0,GitHub,2018-09-26 15:56:44+02:00,['ec097f6563b85b49e06c4d41053e101d2c6c8656'],27,27,54,33825390,1,,,,31868
b145740dced09143d6cbeae5c52a8ec99a30f234,0,GitHub,2018-09-26 12:37:08-04:00,['1bc2c69747b9c8be6cfb22d4325d4014a1452970'],712,920,1632,33827022,182,,,,31873
1ff788b72617b46757923e059f8809d18c90063c,0,GitHub,2018-09-26 21:39:02+02:00,['b145740dced09143d6cbeae5c52a8ec99a30f234'],138246,0,138246,33965268,1352,0.403822151,0.20250742,0.193409702,31873
f277631dec36a442999327026a030e463e4c67e1,0,GitHub,2018-09-27 12:00:07+03:00,['1ff788b72617b46757923e059f8809d18c90063c'],26,79,105,33965373,7,0.171428571,0.914285714,0.171428571,31873
ea728ace0a0054359c54476a986fdda15433e1af,0,Olivér Szabó,2018-09-27 11:28:32+02:00,['f277631dec36a442999327026a030e463e4c67e1'],83943,3,83946,34049319,487,0.636547184,0.40962692,0.124213606,31873
91f19026d1dd999e03cd5f09d13fbd8cb5aad43d,0,GitHub,2018-09-27 14:28:24+02:00,['ea728ace0a0054359c54476a986fdda15433e1af'],27,68,95,34049414,7,0.851851852,0.925925926,0.851851852,31873
88f1d461df878065333b9766039eb31783b63ebb,0,GitHub,2018-09-27 15:52:11+02:00,['91f19026d1dd999e03cd5f09d13fbd8cb5aad43d'],0,43,43,34049457,1,,,,31874
10de300e4c33a298f2aacee078ddbaabb83956e6,0,Alex Antonenko,2018-09-27 17:24:26+03:00,['ea728ace0a0054359c54476a986fdda15433e1af'],0,145,145,34049602,2,0.826446281,1,1,31875
0a271d4a6ed22120b3a841b5c2ca800fcd8952cc,0,GitHub,2018-09-27 09:54:43-07:00,['88f1d461df878065333b9766039eb31783b63ebb'],1,2505,2506,34052108,12,1,1,1,31878
f7008b3dfe9f05ab50a8e25113f465e800d35886,0,GitHub,2018-09-27 20:57:48+03:00,['0a271d4a6ed22120b3a841b5c2ca800fcd8952cc'],104,14,118,34052226,9,0.688311688,0.337662338,0,31878
ece44a9a217423f54f8eb01a3fd17dbe53c1ee93,0,GitHub,2018-09-27 12:11:59-07:00,['f7008b3dfe9f05ab50a8e25113f465e800d35886'],3,5,8,34052234,2,1,1,1,31878
06ea8398cb82975f14524e323614ac0812b2357c,0,GitHub,2018-09-28 07:51:36+02:00,['ece44a9a217423f54f8eb01a3fd17dbe53c1ee93'],0,5,5,34052239,1,,,,31878
d3e45e90dc1954c214b44e7539928a2ade69a35e,1,Madhuvanthi Radhakrishnan,2018-09-28 09:57:14-07:00,['06ea8398cb82975f14524e323614ac0812b2357c'],8,1805,1813,34054052,31,0.75528169,0.836267606,0.968309859,31890
cf2b52a10f0988602cfc331ee5bc2a3f4fab1593,1,Madhuvanthi Radhakrishnan,2018-09-28 09:57:14-07:00,['d3e45e90dc1954c214b44e7539928a2ade69a35e'],122,1335,1457,34055509,20,0.238239757,0.811836115,0.998482549,31898
9106dccb0cc93497253ba57a215c00238dc300ff,1,Madhuvanthi Radhakrishnan,2018-09-28 09:57:14-07:00,['cf2b52a10f0988602cfc331ee5bc2a3f4fab1593'],339,658,997,34056506,20,0.404624277,0.289017341,0.849710983,31899
f9d70515bad9e8d5f582e99409969f4cc2839587,1,Madhuvanthi Radhakrishnan,2018-09-28 09:57:14-07:00,['9106dccb0cc93497253ba57a215c00238dc300ff'],16,219,235,34056741,6,0.515151515,1,0.96969697,31901
ab5721cc761c2992c8c238d20b3b48b60ae8437e,1,Madhuvanthi Radhakrishnan,2018-09-28 09:57:14-07:00,['f9d70515bad9e8d5f582e99409969f4cc2839587'],7,207,214,34056955,12,0.144230769,0.298076923,0.961538462,31901
32023fb66ab0e0b163bf4c4d4937e0d846d3b2ca,1,Madhuvanthi Radhakrishnan,2018-09-28 09:57:14-07:00,['ab5721cc761c2992c8c238d20b3b48b60ae8437e'],2,100,102,34057057,2,0.253968254,0.984126984,1,31902
4ae922209f7173f492aa4a58b9e9c5c3fc34437b,1,Madhuvanthi Radhakrishnan,2018-09-28 09:57:14-07:00,['32023fb66ab0e0b163bf4c4d4937e0d846d3b2ca'],33,104,137,34057194,4,0.266666667,0.966666667,1,31902
4cfd7a9815afea337fd757bd7d12b2d3e9eb1164,0,Madhuvanthi Radhakrishnan,2018-09-28 09:57:14-07:00,['4ae922209f7173f492aa4a58b9e9c5c3fc34437b'],5,6,11,34057205,3,1,1,1,31902
a82e169c7ed66c4a38795f0617711c784bb224a3,1,Madhuvanthi Radhakrishnan,2018-09-28 09:57:14-07:00,['4cfd7a9815afea337fd757bd7d12b2d3e9eb1164'],82,161,243,34057448,5,0.679245283,0.264150943,0.603773585,31902
3959182fddd84e55ee5cb48249c583f77d21fe06,1,Madhuvanthi Radhakrishnan,2018-09-28 09:57:14-07:00,['a82e169c7ed66c4a38795f0617711c784bb224a3'],3,11,14,34057462,1,0,0.333333333,1,31902
aaa56f26c351df0170d4931c21f3ac80aa37f414,0,Madhuvanthi Radhakrishnan,2018-09-28 09:57:14-07:00,['3959182fddd84e55ee5cb48249c583f77d21fe06'],52,152,204,34057666,5,0.666666667,1,0.577777778,31902
562e52bde1d7a85acec5be10eb4419997fa42e76,0,Madhuvanthi Radhakrishnan,2018-09-28 09:57:14-07:00,['aaa56f26c351df0170d4931c21f3ac80aa37f414'],14,2,16,34057682,3,1,0.666666667,0,31902
10bf7bae99e6c76e8cd8902b597e16ce70573114,1,Madhuvanthi Radhakrishnan,2018-09-28 09:57:14-07:00,['562e52bde1d7a85acec5be10eb4419997fa42e76'],539,1004,1543,34059225,17,0.84,1,0.973333333,31905
29aa64d6ea9015a395a4410cf90f445c79dd7d45,1,Madhuvanthi Radhakrishnan,2018-09-28 09:57:14-07:00,['10bf7bae99e6c76e8cd8902b597e16ce70573114'],31,96,127,34059352,12,,,,31905
27f19ade679570881b6fa13e4dcaa82bcf764531,1,Madhuvanthi Radhakrishnan,2018-09-28 09:57:14-07:00,['29aa64d6ea9015a395a4410cf90f445c79dd7d45'],39,25,64,34059416,2,1,0,0,31905
a77b2f93bc260e1513cd247079c6bcec70ed0382,1,Madhuvanthi Radhakrishnan,2018-09-28 09:57:14-07:00,['27f19ade679570881b6fa13e4dcaa82bcf764531'],255,309,564,34059980,19,0.514285714,1,1,31905
ffe161fcdff875b5b6ec1828659ff77ad17c0ecf,0,Madhuvanthi Radhakrishnan,2018-09-28 09:57:14-07:00,['a77b2f93bc260e1513cd247079c6bcec70ed0382'],48,60,108,34060088,3,0,0.6,1,31905
9360b63c8f12a969f1131268c225d5890bee36cf,0,Madhuvanthi Radhakrishnan,2018-09-28 09:57:14-07:00,['ffe161fcdff875b5b6ec1828659ff77ad17c0ecf'],21,108,129,34060217,3,0.14893617,0.893617021,1,31905
fab74c2c5410aea5985e34b24155a9e75d5f80b8,0,Madhuvanthi Radhakrishnan,2018-09-28 09:57:14-07:00,['9360b63c8f12a969f1131268c225d5890bee36cf'],26,19,45,34060262,1,1,1,0,31905
a6536f3c6fb0fa5415b42b63ff994fd2bc78c621,0,Madhuvanthi Radhakrishnan,2018-09-28 09:57:14-07:00,['fab74c2c5410aea5985e34b24155a9e75d5f80b8'],757,151,908,34061170,29,0.382513661,0,0.005464481,31905
3d782a04ade55a7f0de5581de48cd75e6da67f71,1,GitHub,2018-09-29 08:40:57+02:00,['06ea8398cb82975f14524e323614ac0812b2357c'],822,669,1491,34062661,157,0.671568627,0.284313725,0.058823529,31905
1f1f890c65aa45243f76efac2fec741fea28a35b,0,GitHub,2018-10-01 11:30:28+02:00,['3d782a04ade55a7f0de5581de48cd75e6da67f71'],1,1,2,34062663,1,,,,31905
726d1d016ec8eae1056a1412f8b857927dfc32ad,1,GitHub,2018-10-01 13:40:54+02:00,['1f1f890c65aa45243f76efac2fec741fea28a35b'],0,531,531,34063194,1,0.957446809,0.97606383,0.744680851,31906
33a42c32bc45fc0ea5732819214d7b891c3c829f,0,aonishuk,2018-10-01 15:15:30+03:00,['726d1d016ec8eae1056a1412f8b857927dfc32ad'],4,14,18,34063212,7,0.857142857,0,0.571428571,31906
b497744c3fd5db56c0c70954b1f8f96c244bbe8b,0,aonishuk,2018-10-01 15:41:13+03:00,['33a42c32bc45fc0ea5732819214d7b891c3c829f'],14,24,38,34063250,5,1,1,0.428571429,31906
7b5fd0abe81a4e3fe06b607c132fb2c1e8611823,0,Aleksandr Kovalenko,2018-10-01 19:01:58+03:00,['b497744c3fd5db56c0c70954b1f8f96c244bbe8b'],5,6,11,34063261,1,1,1,1,31906
69762201ee278a4be486a1656f3c56a775c24518,0,GitHub,2018-10-01 23:18:51+03:00,['7b5fd0abe81a4e3fe06b607c132fb2c1e8611823'],0,87,87,34063348,1,0,0,1,31907
2b89b14b22b5829cc25333396c70c61f6cf542d2,0,GitHub,2018-10-01 15:51:02-07:00,"['a6536f3c6fb0fa5415b42b63ff994fd2bc78c621', '69762201ee278a4be486a1656f3c56a775c24518']",844,1331,2175,34065523,172,,,,31907
5badc121ab128a536f0967e606259d0026ecc9af,1,Alex Antonenko,2018-10-02 15:05:21+03:00,['69762201ee278a4be486a1656f3c56a775c24518'],4,4,8,34065531,2,,,,31907
0bad9fdf5590d70e93d7474ded8a886d74215deb,0,GitHub,2018-10-02 15:51:35+03:00,"['69762201ee278a4be486a1656f3c56a775c24518', '10de300e4c33a298f2aacee078ddbaabb83956e6']",0,145,145,34065676,2,,,,31907
5853953471077b47bcdb8d3a8e2d9a49cb44deac,0,GitHub,2018-10-02 17:01:34+03:00,"['0bad9fdf5590d70e93d7474ded8a886d74215deb', '5badc121ab128a536f0967e606259d0026ecc9af']",4,4,8,34065684,2,,,,31907
2c18ebe5b45910cadb76ab4f6eae75d7067f7eda,0,Ishan Bhatt,2018-10-02 11:25:40-07:00,['5853953471077b47bcdb8d3a8e2d9a49cb44deac'],30,178,208,34065892,4,0.272727273,1,1,31907
44436e1d5e0d28e07285c7b506cf596748ce85fc,0,Aleksandr Kovalenko,2018-10-03 13:25:39+03:00,['2c18ebe5b45910cadb76ab4f6eae75d7067f7eda'],0,1,1,34065893,1,,,,31907
ce9cdfa2845208cdc3c210318907b636cc99b15a,0,GitHub,2018-10-03 16:14:08-04:00,['44436e1d5e0d28e07285c7b506cf596748ce85fc'],93,511,604,34066497,27,0.549019608,1,0.921568627,31908
27d3abace07c8cdd209b918a8981a4e08618d7dd,0,GitHub,2018-10-04 06:47:58+02:00,['ce9cdfa2845208cdc3c210318907b636cc99b15a'],1,162,163,34066660,1,0.131578947,0.131578947,0.070175439,31908
af3f9ff0b367340c432431384d5d805a72f8495a,0,GitHub,2018-10-04 07:07:46+02:00,['27d3abace07c8cdd209b918a8981a4e08618d7dd'],68,103,171,34066831,1,0.633333333,1,1,31908
d1e72414da007f5360615e84b294670e79a6100b,0,GitHub,2018-10-04 13:44:46+03:00,['af3f9ff0b367340c432431384d5d805a72f8495a'],238,15,253,34067084,4,0.915966387,0.176470588,0.823529412,31908
ade6c79af62dffe22af2535631db689b709cbfef,0,Alex Antonenko,2018-10-04 14:59:01+03:00,['af3f9ff0b367340c432431384d5d805a72f8495a'],0,109,109,34067193,2,1,1,1,31909
62476c095729665d4079f6bfc6b89aa5ca1a0941,0,Olivér Szabó,2018-10-04 14:40:50+02:00,['d1e72414da007f5360615e84b294670e79a6100b'],7,13,20,34067213,1,1,1,0,31909
7177f043bebe244298b2a0762920a3a8ac930b26,0,GitHub,2018-10-04 15:42:26+03:00,"['62476c095729665d4079f6bfc6b89aa5ca1a0941', 'ade6c79af62dffe22af2535631db689b709cbfef']",0,109,109,34067322,2,,,,31909
d4b97b0831fc59cd95cada70277628520a904d4d,1,GitHub,2018-10-04 18:40:12+03:00,['7177f043bebe244298b2a0762920a3a8ac930b26'],250,165,415,34067737,19,1,1,0,31909
e02749c00ab9928f7e272c234101d3c96fb77b68,0,Swapan Shridhar,2018-10-04 23:53:57-07:00,['d4b97b0831fc59cd95cada70277628520a904d4d'],4,1706,1710,34069447,11,0.64,0.931111111,0.828888889,31916
21b054917c5fcbfa02809fa889661368195e4127,0,Swapan Shridhar,2018-10-05 00:01:24-07:00,['e02749c00ab9928f7e272c234101d3c96fb77b68'],8,8,16,34069463,1,,,,31916
9204bb59abaf4df097130f737d8c5c1c54f1c66c,0,aonishuk,2018-10-05 10:58:08+03:00,['d4b97b0831fc59cd95cada70277628520a904d4d'],0,3,3,34069466,1,1,1,1,31916
e175b935e481ba8d14c46da4d65838738d3b8fd3,0,GitHub,2018-10-05 14:17:40+03:00,['9204bb59abaf4df097130f737d8c5c1c54f1c66c'],280,95,375,34069841,21,1,0.830645161,0.540322581,31916
afabe008c296206d19d3b94e3154660f624d2271,0,GitHub,2018-10-05 10:00:07-07:00,"['e175b935e481ba8d14c46da4d65838738d3b8fd3', '21b054917c5fcbfa02809fa889661368195e4127']",4,1706,1710,34071551,11,,,,31916
25f6e0cdf8535a1491b2efe97c5ed0b524226b6b,0,GitHub,2018-10-08 08:07:50-04:00,['afabe008c296206d19d3b94e3154660f624d2271'],8681,2714,11395,34082946,178,0.658892128,0.13577676,0.027072053,31920
cf74bb1b22677bd4886748a75d003033b2cbcf74,1,GitHub,2018-10-08 22:20:40+02:00,['25f6e0cdf8535a1491b2efe97c5ed0b524226b6b'],50,413,463,34083409,11,1,1,0.746478873,31924
09c3720380ff196a0dad4fe84389cd434bd17079,0,Alex Antonenko,2018-10-09 14:58:07+03:00,['cf74bb1b22677bd4886748a75d003033b2cbcf74'],0,116,116,34083525,3,1,1,1,31926
a0197938047d63a77c793ca85b7f35cd89ebbd60,0,Madhuvanthi Radhakrishnan,2018-10-10 12:37:44-07:00,['2b89b14b22b5829cc25333396c70c61f6cf542d2'],155,2989,3144,34086669,46,0.301492537,0.644776119,0.874626866,31933
6adc889221b5919aa96e415e4c60a803c95aa3f8,0,GitHub,2018-10-10 13:28:01-07:00,"['cf74bb1b22677bd4886748a75d003033b2cbcf74', 'a0197938047d63a77c793ca85b7f35cd89ebbd60']",112,7080,7192,34093861,95,,,,31933
2415a03b24dab92e703f71e7bca0a502a66bb402,0,aonishuk,2018-10-11 08:59:25+03:00,['6adc889221b5919aa96e415e4c60a803c95aa3f8'],4,5,9,34093870,2,0,0,0,31933
87d652f0e17702697c53c2c8b496f21890d23fe8,0,GitHub,2018-10-11 13:12:20+03:00,"['2415a03b24dab92e703f71e7bca0a502a66bb402', '09c3720380ff196a0dad4fe84389cd434bd17079']",0,116,116,34093986,3,,,,31933
9103295a7a8a8da3efe0f1b96cf6d915bb8cbb1d,0,aonishuk,2018-10-12 10:57:01+03:00,['87d652f0e17702697c53c2c8b496f21890d23fe8'],24,38,62,34094048,10,0,,,31933
39aedf67d94931a077d067b28dc8bef25546fab0,0,aonishuk,2018-10-12 10:57:01+03:00,['9103295a7a8a8da3efe0f1b96cf6d915bb8cbb1d'],2,0,2,34094050,1,1,0,0,31933
cd9d442b60521dc73363f1588f6715f17754367c,0,aonishuk,2018-10-12 10:57:01+03:00,['39aedf67d94931a077d067b28dc8bef25546fab0'],1,1,2,34094052,1,,,,31933
8b3af69c1710fb27114fa31acff10c8fc96c0b52,0,GitHub,2018-10-12 13:14:00+03:00,['cd9d442b60521dc73363f1588f6715f17754367c'],28,65,93,34094145,10,1,0,1,31933
c629c633e073316a7de83596935f3416890c3bc9,0,GitHub,2018-10-12 14:34:42+02:00,['8b3af69c1710fb27114fa31acff10c8fc96c0b52'],1,11,12,34094157,2,,,,31933
4fde749d3f8ff9ab37ec40a487ddc47cb9ab8ce3,0,GitHub,2018-10-12 23:30:44+03:00,['c629c633e073316a7de83596935f3416890c3bc9'],18,468,486,34094643,9,0.123778502,0.534201954,0.941368078,31933
343ccdb7bd1c4afa721bc9d0f1634e91ed47c5a3,0,Ishan Bhatt,2018-10-15 11:11:15-07:00,['4fde749d3f8ff9ab37ec40a487ddc47cb9ab8ce3'],1,2,3,34094646,1,1,1,1,31933
3b50cb6a1a2cfb2bfc45869d4c9609b3ef87932b,1,GitHub,2018-10-16 09:28:33+02:00,['343ccdb7bd1c4afa721bc9d0f1634e91ed47c5a3'],5,8,13,34094659,4,0,0.234042553,0.234042553,31934
3adfe2e72e5dda0bbfd7e27e6aadd537f3efff3d,0,aonishuk,2018-10-16 14:13:26+03:00,['3b50cb6a1a2cfb2bfc45869d4c9609b3ef87932b'],0,4,4,34094663,1,0,0,1,31934
ecaba72046455efae8ac99a8c8eed723b614e3e9,0,aonishuk,2018-10-16 15:11:51+03:00,['3adfe2e72e5dda0bbfd7e27e6aadd537f3efff3d'],17,86,103,34094766,7,0,0,1,31935
f4a520f25d6cb3e06b93634e37d9a6798c038094,0,aonishuk,2018-10-16 15:11:51+03:00,['ecaba72046455efae8ac99a8c8eed723b614e3e9'],45,0,45,34094811,1,,,,31935
c6f36e1240f8f7d81b925c14114a75e8af941e73,0,Alex Antonenko,2018-10-16 16:52:26+03:00,['f4a520f25d6cb3e06b93634e37d9a6798c038094'],0,200,200,34095011,4,1,1,1,31938
6f2622c76d63a49f9bf06cb062b939836a8a96b7,0,GitHub,2018-10-16 10:24:21-04:00,['f4a520f25d6cb3e06b93634e37d9a6798c038094'],346,821,1167,34096178,24,0.260869565,0.92173913,0.956521739,31941
345da1abed7c55b6b26c921a0a2ab6b92b37db8d,0,aonishuk,2018-10-16 18:36:19+03:00,['6f2622c76d63a49f9bf06cb062b939836a8a96b7'],2,4,6,34096184,1,0,0,0,31941
26bb2ebc342c9f9b56088280e2f852eb1cfa1fa4,0,GitHub,2018-10-16 12:31:32-04:00,['345da1abed7c55b6b26c921a0a2ab6b92b37db8d'],118,422,540,34096724,33,0.284313725,0.901960784,0.941176471,31944
42c8385734fc943e8db3f19b208b3a08e0c09e94,0,GitHub,2018-10-16 19:57:28+02:00,['26bb2ebc342c9f9b56088280e2f852eb1cfa1fa4'],1,1,2,34096726,1,,,,31944
b2bbc8536b2fd5f3f8a211c53f42b46467810229,0,Ishan Bhatt,2018-10-16 12:29:40-07:00,['42c8385734fc943e8db3f19b208b3a08e0c09e94'],5,122,127,34096853,3,0.485981308,0.738317757,1,31944
7110d4d965767e1bc98eb79bb12d1d42f65676d4,0,Ishan Bhatt,2018-10-16 15:53:53-07:00,['b2bbc8536b2fd5f3f8a211c53f42b46467810229'],1,27,28,34096881,4,1,0,1,31944
2fa4bf30b0324c3ac844f5a6ec54c82413c54422,0,GitHub,2018-10-17 08:14:28+02:00,['7110d4d965767e1bc98eb79bb12d1d42f65676d4'],6,7,13,34096894,3,0.5,1,0.5,31944
78bd9ccd523af5ba2a7f1f9b4b00e578c46c69a3,0,GitHub,2018-10-17 12:53:51+02:00,['2fa4bf30b0324c3ac844f5a6ec54c82413c54422'],13,12,25,34096919,2,1,0,0,31944
bf9b58a9a5b3f81c8035b3aca17a2dba4a69bfe3,0,GitHub,2018-10-17 16:20:31+03:00,['78bd9ccd523af5ba2a7f1f9b4b00e578c46c69a3'],475,4850,5325,34102244,25,0.102941176,0.167236662,0.296169631,31960
5a8af96159fe1fe43d2569d847a88de44dcf59c6,0,GitHub,2018-10-17 15:53:35+02:00,['bf9b58a9a5b3f81c8035b3aca17a2dba4a69bfe3'],295,227,522,34102766,2,1,1,0,31960
e138e0eb23cdf9f55814659c28fb3aa83eb7f02d,0,Aleksandr Kovalenko,2018-10-17 18:38:01+03:00,['5a8af96159fe1fe43d2569d847a88de44dcf59c6'],0,515,515,34103281,5,0.958549223,1,1,31964
a8200b9bc31224190f8985a6ac8a9e910ac263e7,0,GitHub,2018-10-17 18:34:46+02:00,['e138e0eb23cdf9f55814659c28fb3aa83eb7f02d'],13,13,26,34103307,3,,,,31964
76401ba4be712a49cda2bab691cd57f778517edc,0,GitHub,2018-10-18 12:06:36+05:18,['a8200b9bc31224190f8985a6ac8a9e910ac263e7'],0,4,4,34103311,1,,,,31964
72a6079f23d330de07f3c5a044c686dd9a7a8366,0,Alex Antonenko,2018-10-18 14:32:15+03:00,['76401ba4be712a49cda2bab691cd57f778517edc'],0,123,123,34103434,2,0.307692308,1,1,31965
6ea9747908c20d9fcdbacbc7151fbbf4d1788683,0,Ishan Bhatt,2018-10-18 08:09:57-07:00,['76401ba4be712a49cda2bab691cd57f778517edc'],78,151,229,34103663,6,1,1,1,31965
91247455a30f4de0a5af8bcfba92302360a47bff,0,GitHub,2018-10-18 18:22:51+03:00,['6ea9747908c20d9fcdbacbc7151fbbf4d1788683'],2,3,5,34103668,1,0,0,0,31965
246e9603a319b21e23f5e5a0f757b78b351ea546,0,GitHub,2018-10-18 19:10:42+03:00,['91247455a30f4de0a5af8bcfba92302360a47bff'],144,120,264,34103932,7,0,1,0,31965
5fcb0cab0247159ebc42dc30e7ebdbbe1b1af3f2,0,Madhuvanthi Radhakrishnan,2018-10-18 15:40:22-07:00,['246e9603a319b21e23f5e5a0f757b78b351ea546'],0,31,31,34103963,4,0.666666667,0.833333333,0.833333333,31965
1db69d3c7ca0ae52d243350391b64dea37246a81,0,GitHub,2018-10-19 10:18:16+05:18,['246e9603a319b21e23f5e5a0f757b78b351ea546'],2,16,18,34103981,1,,,,31965
9ba56220980ff7e76a41465ca63b092bb54c6f78,0,Attila Magyar,2018-10-19 09:44:33+02:00,['1db69d3c7ca0ae52d243350391b64dea37246a81'],3,3,6,34103987,1,,,,31965
5b012a776bef5f8b5abd18017c59fe9dbbb5d9bd,0,GitHub,2018-10-19 08:33:52-04:00,['9ba56220980ff7e76a41465ca63b092bb54c6f78'],143,164,307,34104294,37,,,,31965
1ac3444e9755113df2cb9db6b5fa24bdd88925cc,0,GitHub,2018-10-19 15:18:50+02:00,['5b012a776bef5f8b5abd18017c59fe9dbbb5d9bd'],1,1,2,34104296,1,,,,31965
9c61584bba46820f506b8cecd480da912df2fa90,0,GitHub,2018-10-19 17:52:36+02:00,['1ac3444e9755113df2cb9db6b5fa24bdd88925cc'],20,279,299,34104595,19,0.669902913,0.815533981,0.883495146,31967
a153e5e5e3389846c8724a4a90dd21cc4f004316,0,GitHub,2018-10-21 15:44:17+05:18,['9c61584bba46820f506b8cecd480da912df2fa90'],19,74,93,34104688,5,,,,31967
18f6d37037eb6b5d8209c0a90444c08785a8dde8,0,aonishuk,2018-10-22 15:08:54+03:00,['a153e5e5e3389846c8724a4a90dd21cc4f004316'],2166,2,2168,34106856,11,0.743950039,0.270882123,0.457455113,31967
5b99d0c0e21b79442c092c378d3cf2a0d4d07f2f,0,GitHub,2018-10-22 11:31:40-07:00,"['18f6d37037eb6b5d8209c0a90444c08785a8dde8', '5fcb0cab0247159ebc42dc30e7ebdbbe1b1af3f2']",0,31,31,34106887,4,,,,31967
88af062a0a3d0b1c98f3fafbc9c1144f296c8cff,0,GitHub,2018-10-23 09:34:25+02:00,['5b99d0c0e21b79442c092c378d3cf2a0d4d07f2f'],36,18,54,34106941,18,,,,31967
470f80a16f765d2ade957a381b607aea5b81c8d5,0,GitHub,2018-10-23 13:09:25+03:00,"['88af062a0a3d0b1c98f3fafbc9c1144f296c8cff', '72a6079f23d330de07f3c5a044c686dd9a7a8366']",0,123,123,34107064,2,,,,31967
b66008cedb82d531aa4132283fadeadb3aab9c30,0,GitHub,2018-10-23 13:10:22+03:00,"['470f80a16f765d2ade957a381b607aea5b81c8d5', 'c6f36e1240f8f7d81b925c14114a75e8af941e73']",0,200,200,34107264,4,,,,31967
22f6a504dee9d98eca3c5eb9fcc90bbe1d12f716,0,Andrii Tkach,2018-10-23 15:08:40+03:00,['b66008cedb82d531aa4132283fadeadb3aab9c30'],5,21,26,34107290,3,1,1,1,31967
d681b9f6a5d2df46fad8f28bda6459f52de38245,0,Alex Antonenko,2018-10-23 16:49:26+03:00,['b66008cedb82d531aa4132283fadeadb3aab9c30'],0,353,353,34107643,7,1,1,1,31973
464a5e887397232195536ed8fb180ad5a86a9ab5,0,Jonathan Hurley,2018-10-23 12:02:34-04:00,['22f6a504dee9d98eca3c5eb9fcc90bbe1d12f716'],1,2,3,34107646,1,1,1,1,31973
aac386e6b42cd75b3d15ed42c47c5595d80916a4,0,Jonathan Hurley,2018-10-23 12:15:16-04:00,['464a5e887397232195536ed8fb180ad5a86a9ab5'],2,2,4,34107650,1,,,,31973
c540bb2d0ccca61f1ae689e189e7b3d5c0caece5,0,Jonathan Hurley,2018-10-23 12:17:38-04:00,['aac386e6b42cd75b3d15ed42c47c5595d80916a4'],2,3,5,34107655,1,,,,31973
cd397373e6d7a0d976ee50e61466cfe184cfb6a7,1,GitHub,2018-10-23 14:22:01-04:00,['c540bb2d0ccca61f1ae689e189e7b3d5c0caece5'],8,335,343,34107998,4,0.79,0.99,1,31975
e602c70c7d61d2e1be136cf4f1a06f0de70228c5,0,GitHub,2018-10-23 17:24:12-04:00,['cd397373e6d7a0d976ee50e61466cfe184cfb6a7'],0,59,59,34108057,1,,,,31975
29450c4ebb99cd6fd9b7fc90c2bc15a1daa2bac8,0,GitHub,2018-10-24 15:24:28+05:18,['e602c70c7d61d2e1be136cf4f1a06f0de70228c5'],1,1,2,34108059,1,,,,31975
f9d0d137661586f01fa8fa18f34fa5f0d89a6867,0,GitHub,2018-10-24 13:47:01+03:00,"['29450c4ebb99cd6fd9b7fc90c2bc15a1daa2bac8', 'd681b9f6a5d2df46fad8f28bda6459f52de38245']",0,353,353,34108412,7,,,,31975
18eefee38e7731176937d255ad4130221b19a0dc,0,aonishuk,2018-10-24 13:49:35+03:00,['f9d0d137661586f01fa8fa18f34fa5f0d89a6867'],0,9,9,34108421,1,0,0,1,31975
1a8b193fbc8da67597044cb26ee1a8cabcc86cd8,0,GitHub,2018-10-24 15:09:56+02:00,['18eefee38e7731176937d255ad4130221b19a0dc'],205,516,721,34109142,11,0.298507463,0.587064677,0.835820896,31976
816e24cf69f5752e773e2d76677e4da80f011700,0,GitHub,2018-10-24 20:38:23+02:00,['1a8b193fbc8da67597044cb26ee1a8cabcc86cd8'],142,51,193,34109335,6,0,0,0,31976
1e5a6cad60fc127fcc3808d71d52a94b29a659f4,0,Aleksandr Kovalenko,2018-10-25 18:46:04+03:00,['816e24cf69f5752e773e2d76677e4da80f011700'],20,42,62,34109397,5,0.941176471,1,1,31976
c2680d47ccb2355ff39743ba1af4476111fac18f,0,Aleksandr Kovalenko,2018-10-25 18:46:04+03:00,['1e5a6cad60fc127fcc3808d71d52a94b29a659f4'],0,1,1,34109398,1,,,,31976
9183c07cedecccebd940725b504715f4fd5b745d,0,GitHub,2018-10-26 10:20:44-04:00,['c2680d47ccb2355ff39743ba1af4476111fac18f'],15,21,36,34109434,7,,,,31976
2f81272700b241a430ceb226dab4209c66a8dae7,0,Robert Levas,2018-10-26 13:13:41-04:00,['9183c07cedecccebd940725b504715f4fd5b745d'],1,13,14,34109448,2,0,0,1,31976
5311ecbfef9de3828c4a9b20700a6819f98297bc,0,GitHub,2018-10-26 21:38:58+02:00,['9183c07cedecccebd940725b504715f4fd5b745d'],13,8,21,34109469,2,,,,31976
06c6c200632f2b7d842b69a9545c2c80219df2cd,0,GitHub,2018-10-26 15:57:09-04:00,"['5311ecbfef9de3828c4a9b20700a6819f98297bc', '2f81272700b241a430ceb226dab4209c66a8dae7']",1,13,14,34109483,2,,,,31976
e6c7522ef7528ae3fa97a4a9c1d97da54bfdaab5,0,GitHub,2018-10-26 22:57:56+02:00,['06c6c200632f2b7d842b69a9545c2c80219df2cd'],16,18,34,34109517,1,1,1,0,31976
2dea9fb811a66dcf25b2b1f526560c16d0aeb2fd,0,"Doroszlai, Attila",2018-10-29 07:53:47+01:00,['e6c7522ef7528ae3fa97a4a9c1d97da54bfdaab5'],12,27,39,34109556,3,,,,31976
89de44acf2106c4c70631db4dc253b940539f6dc,0,GitHub,2018-10-30 18:10:20+02:00,['2dea9fb811a66dcf25b2b1f526560c16d0aeb2fd'],5,6,11,34109567,2,,,,31976
99e14e98ec5d3744f6ea8dba6a4ba2a9f7d26d63,0,Ishan Bhatt,2018-10-30 13:29:52-07:00,['89de44acf2106c4c70631db4dc253b940539f6dc'],39,109,148,34109715,3,0.421052632,0.684210526,1,31976
d7ce1ef3668d551061fa0539fda7befdb6cb1b43,0,GitHub,2018-10-30 16:51:25-04:00,['99e14e98ec5d3744f6ea8dba6a4ba2a9f7d26d63'],148,260,408,34110123,36,0.466666667,0.488888889,0.777777778,31976
0f0bc6b39eda33e3990b1c34a272dbad80f37784,0,aonishuk,2018-10-31 09:08:20+02:00,['d7ce1ef3668d551061fa0539fda7befdb6cb1b43'],1,1,2,34110125,1,,,,31976
a2c6fd99a41a3f2a3f88ca72fb71eddf86babf1f,0,GitHub,2018-10-31 14:03:50+02:00,['0f0bc6b39eda33e3990b1c34a272dbad80f37784'],1,85,86,34110211,4,0.218181818,1,1,31976
3287fe267eebe49b8611a9a77ea33263262f2a2d,0,GitHub,2018-10-31 14:04:10+02:00,['a2c6fd99a41a3f2a3f88ca72fb71eddf86babf1f'],8,96,104,34110315,15,0.290909091,0.454545455,0.636363636,31976
cce16fb367cc1d0184ab0561750fc8f7757f5021,0,GitHub,2018-10-31 13:28:55+01:00,['3287fe267eebe49b8611a9a77ea33263262f2a2d'],60,67,127,34110442,1,1,1,1,31976
ffaeaed70dceaf0803a039664601275a8020682c,0,aonishuk,2018-10-31 14:30:25+02:00,['cce16fb367cc1d0184ab0561750fc8f7757f5021'],7,14,21,34110463,1,0.666666667,0.666666667,1,31976
4160fed72536384a6fd250afa108c0338ea5f485,0,Andrii Tkach,2018-11-01 15:35:53+02:00,['ffaeaed70dceaf0803a039664601275a8020682c'],2,3,5,34110468,1,1,1,1,31976
ac89512b6ad6e1e6b47c80e2d7edff9672624fd7,0,GitHub,2018-11-01 10:34:10-04:00,['4160fed72536384a6fd250afa108c0338ea5f485'],8,16,24,34110492,1,,,,31976
4945cd0acf89d286abbe326191ce352d3ae08516,0,GitHub,2018-11-01 18:34:51+02:00,['ac89512b6ad6e1e6b47c80e2d7edff9672624fd7'],0,2,2,34110494,1,0,1,1,31976
2574ed43e4cb52807d9d4b0e35257fcfbb7815ad,0,GitHub,2018-11-02 20:39:16+01:00,['4945cd0acf89d286abbe326191ce352d3ae08516'],0,14,14,34110508,2,0.363636364,1,0.272727273,31976
7e39765aec2df9030d3a970f58b0d53c6c2d0254,0,GitHub,2018-11-05 07:56:43-08:00,['2574ed43e4cb52807d9d4b0e35257fcfbb7815ad'],10,56,66,34110574,4,0.944444444,0.222222222,1,31976
7eee67dd3850a560cd63410b7ed0a6dc79f07baf,0,GitHub,2018-11-05 20:24:13+01:00,['7e39765aec2df9030d3a970f58b0d53c6c2d0254'],3,8,11,34110585,1,,,,31976
6a2ddb7d91c1f723140a5e6b6830667fef4aa5ca,1,aonishuk,2018-11-05 21:47:44+02:00,['7eee67dd3850a560cd63410b7ed0a6dc79f07baf'],0,7,7,34110592,1,1,0,1,31976
6a72c47003da9992833445a45da03541ecdc561d,1,Alex Antonenko,2018-11-06 15:34:21+03:00,['6a2ddb7d91c1f723140a5e6b6830667fef4aa5ca'],48,855,903,34111495,26,0.988636364,1,1,31993
c18b078995d3f325b0c60c7fd76449e060a71541,0,Alex Antonenko,2018-11-06 16:02:00+03:00,['6a72c47003da9992833445a45da03541ecdc561d'],3,7,10,34111505,2,1,1,1,31993
f162a08f49da23c2c938e8122e7100b6b1ca30e4,0,Alex Antonenko,2018-11-06 16:36:49+03:00,['c18b078995d3f325b0c60c7fd76449e060a71541'],53,48,101,34111606,15,0,0,0,31993
2487f9249e0be05275397952d55b2aea7d08a4b0,0,GitHub,2018-11-06 09:12:01-08:00,['6a2ddb7d91c1f723140a5e6b6830667fef4aa5ca'],0,1,1,34111607,1,,,,31993
bec3828fea53c5a822fa5760ac0d8f7a546d2b0b,0,GitHub,2018-11-06 09:13:15-08:00,['2487f9249e0be05275397952d55b2aea7d08a4b0'],6,6,12,34111619,6,,,,31994
66a3bf93adbecdda74b1ea76cde4f39c49b9beaa,0,GitHub,2018-11-06 19:08:46+01:00,['bec3828fea53c5a822fa5760ac0d8f7a546d2b0b'],1,354,355,34111974,3,0.403061224,1,1,31994
42a6363c229a6fda95aa4e3f32567fc8196287d5,1,GitHub,2018-11-07 12:22:01+02:00,['66a3bf93adbecdda74b1ea76cde4f39c49b9beaa'],2,2,4,34111978,1,,,,31994
b86d32c6d0851a9828e9b6f70a9df0ac943be3e0,0,Alex Antonenko,2018-11-07 14:54:17+03:00,['f162a08f49da23c2c938e8122e7100b6b1ca30e4'],13,29,42,34112020,3,1,1,1,31994
e817ddce61675b2c78a642ed30df02c94f709437,0,Alex Antonenko,2018-11-07 15:15:59+03:00,['b86d32c6d0851a9828e9b6f70a9df0ac943be3e0'],2,2,4,34112024,1,,,,31994
5f76c77edf6082f6a14a0e02d98e9d53809ba8e9,0,Alex Antonenko,2018-11-07 15:17:07+03:00,['e817ddce61675b2c78a642ed30df02c94f709437'],1,1,2,34112026,1,,,,31994
697250782673f04201610ee3502e9d573d28b5d6,0,GitHub,2018-11-07 13:20:35+01:00,['42a6363c229a6fda95aa4e3f32567fc8196287d5'],1,1,2,34112028,1,,,,31994
1027a16a5aa4afacb7a4d5c7c544959c351cfe87,0,Alex Antonenko,2018-11-07 18:40:14+03:00,['5f76c77edf6082f6a14a0e02d98e9d53809ba8e9'],1,11,12,34112040,1,,,,31994
ad3658288c795a49bef612059e7fa8b5bcd1245f,0,Ishan Bhatt,2018-11-07 17:29:58-08:00,['697250782673f04201610ee3502e9d573d28b5d6'],6,15,21,34112061,2,1,1,1,31994
e5af93940963a151e038b0746b0e8bb34c4135cf,0,Alex Antonenko,2018-11-08 14:03:20+03:00,['1027a16a5aa4afacb7a4d5c7c544959c351cfe87'],4,4,8,34112069,1,,,,31994
a46fd29294a64a8672d7e091ea4fb459e7299328,0,Andrii Tkach,2018-11-08 15:08:29+02:00,['ad3658288c795a49bef612059e7fa8b5bcd1245f'],58,52,110,34112179,4,1,0,0,31994
caf6efdbb77764c32c774b070f7070a9af35889a,0,GitHub,2018-11-08 16:26:34+03:00,"['e5af93940963a151e038b0746b0e8bb34c4135cf', 'a46fd29294a64a8672d7e091ea4fb459e7299328']",76,432,508,34112687,16,,,,31994
b88e72a8ba8040fd3b8f85f37cd9c0f1d4681fb1,0,Andrii Tkach,2018-11-08 16:24:15+02:00,['a46fd29294a64a8672d7e091ea4fb459e7299328'],50,16,66,34112753,3,0.78125,0,0,31994
5a1162d3ddcfd05a58edca93437040ee1e858c22,0,GitHub,2018-11-08 17:27:21+03:00,"['b88e72a8ba8040fd3b8f85f37cd9c0f1d4681fb1', 'caf6efdbb77764c32c774b070f7070a9af35889a']",57,888,945,34113698,27,,,,31994
9f25b46514c790109cb99db0d5abc09b8e52ea3d,0,GitHub,2018-11-08 13:56:56-05:00,['5a1162d3ddcfd05a58edca93437040ee1e858c22'],25,62,87,34113785,4,0,0.40625,1,31994
791631eea7e05e33ae754d404da24bb91f47b88d,0,GitHub,2018-11-09 11:38:31-05:00,['9f25b46514c790109cb99db0d5abc09b8e52ea3d'],4,543,547,34114332,8,0.097345133,0.831858407,0.619469027,31997
e440c50d73c96c9772f2594a23de061f9786d586,0,GitHub,2018-11-09 19:10:23+01:00,['791631eea7e05e33ae754d404da24bb91f47b88d'],24,15,39,34114371,2,1,0,0,31997
4eee0f56d2fbfdfb0caace955339bc0c46a85a3c,1,GitHub,2018-11-10 12:34:02+01:00,['e440c50d73c96c9772f2594a23de061f9786d586'],192,401,593,34114964,15,0.666666667,0.623188406,0.492753623,31998
c17ecd1b2d5e41e66533266c9f4d5880ef5bd948,0,GitHub,2018-11-12 19:51:17+01:00,['4eee0f56d2fbfdfb0caace955339bc0c46a85a3c'],14,60,74,34115038,7,0.782608696,1,0.47826087,31998
9979fa81bc563f93d1c314a49539ef7de366580b,0,Akhil Subhash Naik,2018-11-13 11:20:06+05:18,['c17ecd1b2d5e41e66533266c9f4d5880ef5bd948'],1,1,2,34115040,1,,0,,31998
a22df8ad540fa9fbe7034d6d7ef87beec29414a4,0,aBabiichuk,2018-11-13 14:03:43+02:00,['c17ecd1b2d5e41e66533266c9f4d5880ef5bd948'],0,2,2,34115042,1,,,,31998
ccdac060f9b0e3e8a17d58b30f4aca9c9362741c,0,aBabiichuk,2018-11-13 14:05:22+02:00,['a22df8ad540fa9fbe7034d6d7ef87beec29414a4'],1,1,2,34115044,1,,,,31998
664d14dae54655a092a304400944bae7e24d1275,0,GitHub,2018-11-13 13:45:28+01:00,['ccdac060f9b0e3e8a17d58b30f4aca9c9362741c'],0,927,927,34115971,12,0.654434251,0.813455657,0.911314985,32010
65bcbf7412805e68faa273d85b9d3b5e7472a6ed,0,Alex Antonenko,2018-11-13 16:10:49+03:00,['c17ecd1b2d5e41e66533266c9f4d5880ef5bd948'],1,66,67,34116038,3,1,1,1,32012
5f7ab52acc19a73fec5fa65ab3993ba3acd8c3bd,0,Andrii Tkach,2018-11-13 15:41:09+02:00,['664d14dae54655a092a304400944bae7e24d1275'],10,34,44,34116082,4,1,1,1,32012
a348fa257e7c188c63d1038fa92a1aae8c4902b2,0,Andrii Tkach,2018-11-13 17:00:24+02:00,['5f7ab52acc19a73fec5fa65ab3993ba3acd8c3bd'],1,8,9,34116091,2,1,1,1,32012
b3b274d68ff936ecbe64bada6529dcd8232023be,0,GitHub,2018-11-13 19:34:36+03:00,"['a348fa257e7c188c63d1038fa92a1aae8c4902b2', '65bcbf7412805e68faa273d85b9d3b5e7472a6ed']",1,66,67,34116158,3,,,,32012
7caa2a54a5943b200765171edf32ea0337425b7a,0,GitHub,2018-11-13 13:38:58-05:00,['b3b274d68ff936ecbe64bada6529dcd8232023be'],7,8,15,34116173,2,0,1,1,32012
6395167a5a74d44b9d86dabeb2c0860df450ec67,0,GitHub,2018-11-14 12:10:15+01:00,['7caa2a54a5943b200765171edf32ea0337425b7a'],60,56,116,34116289,2,0.571428571,1,1,32012
e6e749d86210ebf0366e2cbb86d5daa0691a477b,0,GitHub,2018-11-14 13:30:00-05:00,['6395167a5a74d44b9d86dabeb2c0860df450ec67'],9,16,25,34116314,2,,,,32012
8fee8ce8429229b587e2227f3fd73db474432459,0,GitHub,2018-11-14 11:14:44-08:00,['e6e749d86210ebf0366e2cbb86d5daa0691a477b'],1,3,4,34116318,1,1,1,1,32012
2b7366441b37ddf0a2cb7acb41fa196553c27115,0,GitHub,2018-11-15 11:17:18+02:00,['8fee8ce8429229b587e2227f3fd73db474432459'],9,12,21,34116339,2,1,1,1,32012
f231e836afbd05d4ffd961226d1f6e5996b43816,1,GitHub,2018-11-15 11:48:30+02:00,['2b7366441b37ddf0a2cb7acb41fa196553c27115'],62,108,170,34116509,7,0,0.285714286,0.942857143,32012
17c47cff1ae2b5b0c0901fbdeea6e914ecebc575,1,aonishuk,2018-11-15 12:51:50+02:00,['f231e836afbd05d4ffd961226d1f6e5996b43816'],28,25,53,34116562,2,0,0,0,32012
3d215524b279bf106a6950e36808f392cc2567b4,1,aonishuk,2018-11-15 14:43:40+02:00,['17c47cff1ae2b5b0c0901fbdeea6e914ecebc575'],3,3,6,34116568,1,,,,32012
1fae6cf19dfc4f1bfb428eb34480e7382c460db8,0,Andrii Tkach,2018-11-15 16:02:06+02:00,['3d215524b279bf106a6950e36808f392cc2567b4'],10,22,32,34116600,5,1,1,1,32012
2bfbef2cab3cac2c4720dca0942fed8d3efd9bc9,1,GitHub,2018-11-15 19:36:30+02:00,['1fae6cf19dfc4f1bfb428eb34480e7382c460db8'],84,422,506,34117106,16,0.283783784,0.790540541,1,32014
09f376681cd8043ce63aee0bc40cfb919bdfe991,0,GitHub,2018-11-15 21:35:57+01:00,['2bfbef2cab3cac2c4720dca0942fed8d3efd9bc9'],1,0,1,34117107,1,,,,32014
1d87a0a1ee8d5202ed1894bc2917fc8ab7d569fa,0,GitHub,2018-11-15 21:38:53+01:00,['09f376681cd8043ce63aee0bc40cfb919bdfe991'],9,339,348,34117455,8,0.703125,0.9921875,1,32017
60d313463ce52c8df5c2268491a70c8cd38eb6a8,0,GitHub,2018-11-15 15:47:28-05:00,['1d87a0a1ee8d5202ed1894bc2917fc8ab7d569fa'],36,102,138,34117593,2,0,0.909090909,0,32017
6f7b0a9542a3f4c013faa90a4303a31238cc5c78,0,GitHub,2018-11-15 22:15:12+01:00,['60d313463ce52c8df5c2268491a70c8cd38eb6a8'],114,509,623,34118216,8,0.329113924,0.848101266,0.898734177,32020
52384fb8e703f7c1c99cc64a3e8e3526cca56b6d,0,GitHub,2018-11-16 13:45:07+05:18,['6f7b0a9542a3f4c013faa90a4303a31238cc5c78'],0,1,1,34118217,1,,,,32020
9419944925f3b210ce429ba147e1462478259261,0,GitHub,2018-11-16 09:55:36+01:00,['52384fb8e703f7c1c99cc64a3e8e3526cca56b6d'],3,335,338,34118555,7,0.385185185,0.955555556,0.955555556,32021
8f6cb89431e6c0df8f91a6b8c6483bdbed30d053,0,Oliver Szabo,2018-11-16 19:18:31+01:00,['9419944925f3b210ce429ba147e1462478259261'],5,7,12,34118567,4,,,,32021
ccadc292693caf6db17fd3379f2745e356837bca,0,Attila Magyar,2018-11-18 20:31:15+01:00,['8f6cb89431e6c0df8f91a6b8c6483bdbed30d053'],0,7,7,34118574,1,,,,32021
72213a6452550921485e26f2e64230ad26cf8a16,0,Andrii Tkach,2018-11-19 11:38:31+02:00,['ccadc292693caf6db17fd3379f2745e356837bca'],6,18,24,34118598,2,1,1,1,32021
3da344ab8e7d878868998ee514dd0dbc99a2be55,1,aonishuk,2018-11-19 13:17:24+02:00,['72213a6452550921485e26f2e64230ad26cf8a16'],17,43,60,34118658,2,0.1,0.2,0,32022
5bc2e578942ef3af46c7be86d11803a58fbb126c,0,aonishuk,2018-11-19 13:17:24+02:00,['3da344ab8e7d878868998ee514dd0dbc99a2be55'],11,0,11,34118669,1,,,,32022
9e6965d0bff7d31fc188d9b5be42aac80f94e286,1,aonishuk,2018-11-19 13:17:37+02:00,['5bc2e578942ef3af46c7be86d11803a58fbb126c'],1,1,2,34118671,1,,,,32022
f4bd455ed5eb67df592169201455e95c614a69d6,0,Andrii Tkach,2018-11-19 15:59:10+02:00,['9e6965d0bff7d31fc188d9b5be42aac80f94e286'],1,3,4,34118675,2,0,1,0,32022
153d5f96cf1c1c68084d308bb98314b3d5231153,0,GitHub,2018-11-19 15:54:41+01:00,['f4bd455ed5eb67df592169201455e95c614a69d6'],1,186,187,34118862,7,0.230769231,0.948717949,1,32022
93576b7c9bc25361ba1e43c9dfb08fc136667520,1,GitHub,2018-11-19 16:50:28+01:00,['153d5f96cf1c1c68084d308bb98314b3d5231153'],77,649,726,34119588,8,0.418367347,0.942176871,0.921768707,32024
94d18601e8adef6bd43d2ce1e70d3c1e4f14ae3c,0,GitHub,2018-11-20 08:14:45+01:00,['93576b7c9bc25361ba1e43c9dfb08fc136667520'],37,312,349,34119937,8,0.74566474,0.786127168,0.699421965,32024
f8a019926fdca0073f08de54c5e9720260beef52,1,GitHub,2018-11-20 10:22:26+01:00,['94d18601e8adef6bd43d2ce1e70d3c1e4f14ae3c'],262,2423,2685,34122622,55,0.698872786,0.677938808,0.677938808,32040
8754c01492e623c6296085b952b8028f677eaaec,1,aonishuk,2018-11-20 12:01:42+02:00,['f8a019926fdca0073f08de54c5e9720260beef52'],1,1,2,34122624,1,,,,32040
4dde32c21251ad9485869f2976f0f4a95aa0e43d,1,GitHub,2018-11-20 13:54:04+02:00,['8754c01492e623c6296085b952b8028f677eaaec'],312,1450,1762,34124386,39,0.281200632,0.714060032,0.853080569,32043
72f6f094ed05fa2e302ceb80a66880e555239907,0,Alex Antonenko,2018-11-20 17:39:44+03:00,['4dde32c21251ad9485869f2976f0f4a95aa0e43d'],0,531,531,34124917,10,0.881918819,1,1,32052
f15a271c71137b11368cdc0fa6319b685d85edef,0,GitHub,2018-11-20 19:09:43+02:00,['4dde32c21251ad9485869f2976f0f4a95aa0e43d'],15,79,94,34125011,2,0.857142857,1,1,32052
ae3d9aa3abfa589a568a77e4c7cf0c7656bdfc65,0,GitHub,2018-11-21 07:36:49+01:00,['f15a271c71137b11368cdc0fa6319b685d85edef'],36,46,82,34125093,5,1,1,1,32052
fe80b390b03a47bda87dde95bc9feb11a49818a0,1,GitHub,2018-11-21 17:34:28+01:00,['ae3d9aa3abfa589a568a77e4c7cf0c7656bdfc65'],38,149,187,34125280,2,0.460674157,0.988764045,0.438202247,32052
e62cc462fb5d2ac0f2c90912d044db352c477c74,0,GitHub,2018-11-21 17:34:49+01:00,['fe80b390b03a47bda87dde95bc9feb11a49818a0'],40,63,103,34125383,3,0.461538462,0.461538462,1,32053
296484db88ec8cb8b4753f6e69e23db3975dfc1b,1,GitHub,2018-11-21 20:17:58+01:00,['e62cc462fb5d2ac0f2c90912d044db352c477c74'],44,107,151,34125534,33,0.75,1,0.5,32053
50ea4200d389a5ddb41f15484cdddf0ae072e3e3,0,GitHub,2018-11-22 11:33:50+02:00,['296484db88ec8cb8b4753f6e69e23db3975dfc1b'],38,243,281,34125815,9,0.065217391,0.543478261,0.992753623,32053
1cd9e6ffac280afaa7a7387fec47091bf17627fb,0,Lisnichenko Dmitro,2018-11-22 11:47:59+02:00,['50ea4200d389a5ddb41f15484cdddf0ae072e3e3'],16,12,28,34125843,15,0.5,0,0.75,32053
c36b478ab31ef6c6d9ac1194b1fe5c6a231f50ea,0,Lisnichenko Dmitro,2018-11-22 11:47:59+02:00,['1cd9e6ffac280afaa7a7387fec47091bf17627fb'],2,2,4,34125847,1,,,,32053
5c7f4c1bf419b004503425504b94b44d9ca985e0,1,aonishuk,2018-11-22 13:18:56+02:00,['c36b478ab31ef6c6d9ac1194b1fe5c6a231f50ea'],16,17,33,34125880,1,1,1,1,32053
8079522317ed9e1f37b913946b97f239ae965ab7,0,GitHub,2018-11-22 12:21:01+01:00,['5c7f4c1bf419b004503425504b94b44d9ca985e0'],197,501,698,34126578,23,0.274074074,0.644444444,0.807407407,32056
fb70eddf5000e9b86302f67404c68385eb1010bb,1,GitHub,2018-11-22 06:50:11-05:00,['8079522317ed9e1f37b913946b97f239ae965ab7'],88,409,497,34127075,10,0.282894737,0.776315789,0.953947368,32058
0a2fde5bbaab3328521cbffaaa94019adc24a4e9,0,GitHub,2018-11-22 16:01:40+03:00,"['fb70eddf5000e9b86302f67404c68385eb1010bb', '72f6f094ed05fa2e302ceb80a66880e555239907']",0,531,531,34127606,10,,,,32058
72e40d43f2b2eb08ea2732f2ec118668de1998b4,0,Alex Antonenko,2018-11-22 16:40:37+03:00,['0a2fde5bbaab3328521cbffaaa94019adc24a4e9'],0,63,63,34127669,2,1,1,1,32059
e60c0263a8dd4bd2fb181ad51ea910c744d3b054,0,GitHub,2018-11-22 19:03:51+02:00,['0a2fde5bbaab3328521cbffaaa94019adc24a4e9'],1,1,2,34127671,1,,,,32059
7202e06e85e57e79149dd94b6c8fb1130dcde580,0,Lisnichenko Dmitro,2018-11-23 11:50:07+02:00,['e60c0263a8dd4bd2fb181ad51ea910c744d3b054'],11,88,99,34127770,2,0.382352941,0.970588235,0.970588235,32059
3a6e5ed0ac584946a732cf482d22fb65fbb3c12b,0,Lisnichenko Dmitro,2018-11-23 11:50:07+02:00,['7202e06e85e57e79149dd94b6c8fb1130dcde580'],2,2,4,34127774,1,0,0,0,32059
fd346f5fc28c1dfe605c3e53cb039c657ac2a2ab,0,GitHub,2018-11-23 22:47:59+01:00,['3a6e5ed0ac584946a732cf482d22fb65fbb3c12b'],7,7,14,34127788,1,,,,32059
d10ef61fbda48b63fff724f93645f082b37af0af,0,Andrii Tkach,2018-11-26 19:01:01+02:00,['fd346f5fc28c1dfe605c3e53cb039c657ac2a2ab'],30,19,49,34127837,2,1,1,1,32059
93bfa6646545226c80eb149c10e20ece7b95fab9,0,GitHub,2018-11-26 21:52:26+01:00,['d10ef61fbda48b63fff724f93645f082b37af0af'],9,12,21,34127858,4,,,,32059
04012a1733a1378f3662a8d4a681fdff11adb6c4,0,GitHub,2018-11-27 05:45:32+01:00,['93bfa6646545226c80eb149c10e20ece7b95fab9'],0,4,4,34127862,2,,,,32059
4d245a1196bbcf6e2ca9b77901bf3942f3ac60f8,0,GitHub,2018-11-27 10:26:53+01:00,['04012a1733a1378f3662a8d4a681fdff11adb6c4'],48,149,197,34128059,6,0,0.473684211,0.434210526,32059
02dd59b6319a8f1ad15ad1c36dfb74aa7f74f3c4,0,GitHub,2018-11-27 14:23:39+02:00,['4d245a1196bbcf6e2ca9b77901bf3942f3ac60f8'],2,10,12,34128071,1,0,0,1,32059
8878e71616483895f2e05f3bdcd58d96c0cb6dec,0,Andrii Tkach,2018-11-27 14:51:22+02:00,['02dd59b6319a8f1ad15ad1c36dfb74aa7f74f3c4'],3,3,6,34128077,1,,,,32059
e93ff79790776e44948842f78eb3bb22784b378f,0,GitHub,2018-11-27 16:06:56+03:00,"['8878e71616483895f2e05f3bdcd58d96c0cb6dec', '72e40d43f2b2eb08ea2732f2ec118668de1998b4']",0,63,63,34128140,2,,,,32059
f3e627666a6c9c6eda73d5ee8977e7d941c104a7,0,GitHub,2018-11-27 15:10:07+01:00,['e93ff79790776e44948842f78eb3bb22784b378f'],5,11,16,34128156,4,0,1,1,32059
eaae0af01789cab9e169221ec21e80b472aa2938,0,GitHub,2018-11-27 16:44:14+02:00,['f3e627666a6c9c6eda73d5ee8977e7d941c104a7'],159,160,319,34128475,15,1,0.588235294,1,32059
fbc821def75909d9b621f47c6ec64da54d26ddac,0,GitHub,2018-11-27 20:23:09+01:00,['eaae0af01789cab9e169221ec21e80b472aa2938'],6,2,8,34128483,2,,,,32059
a6250a91fcb69af5baa14ea38ed835effc653a89,1,GitHub,2018-11-28 08:17:07+01:00,['fbc821def75909d9b621f47c6ec64da54d26ddac'],214,545,759,34129242,19,0.703703704,1,0.469135802,32059
97c7f8c08977160ae4df710f3f4c06602562e058,1,Andrii Tkach,2018-11-28 15:41:38+02:00,['a6250a91fcb69af5baa14ea38ed835effc653a89'],56,102,158,34129400,6,1,1,1,32059
48bedc1c1878f853f8660106559fb92ff3dfefdd,0,GitHub,2018-11-28 16:45:46+02:00,['97c7f8c08977160ae4df710f3f4c06602562e058'],3,45,48,34129448,1,0,1,1,32059
7d89f2c05a2457347da0db6af02fba7e134cc1ad,0,Andrii Tkach,2018-11-28 23:13:12+02:00,['48bedc1c1878f853f8660106559fb92ff3dfefdd'],16,37,53,34129501,3,1,1,1,32059
dc2d8dfada006549cc94d9a929d92b5c21c655d3,0,GitHub,2018-11-29 13:58:39+02:00,['48bedc1c1878f853f8660106559fb92ff3dfefdd'],0,7,7,34129508,1,,,,32059
799e487c960a567bd541322f5d544e3548eab0c9,0,GitHub,2018-11-29 13:18:41+01:00,['dc2d8dfada006549cc94d9a929d92b5c21c655d3'],16,974,990,34130498,17,0.604591837,1,0.903061224,32067
0888d9ec6c3f76e01704d1c2dbb704b6ff330955,0,GitHub,2018-11-29 14:39:52+02:00,"['799e487c960a567bd541322f5d544e3548eab0c9', '7d89f2c05a2457347da0db6af02fba7e134cc1ad']",16,37,53,34130551,3,,,,32067
50f80b27ae1816afc2dcd892f40372b5e08808ae,0,GitHub,2018-11-29 09:53:06-05:00,['0888d9ec6c3f76e01704d1c2dbb704b6ff330955'],5162,874,6036,34136587,51,0.997536946,0.24679803,0,32072
e30d582d3e01efb1453e35f8eed042bb0360403d,0,Alex Antonenko,2018-11-29 19:04:23+03:00,['48bedc1c1878f853f8660106559fb92ff3dfefdd'],0,221,221,34136808,2,0.689873418,1,1,32073
3b5343e14a9f9b5c103f4f2280ea735670dc8fd8,1,GitHub,2018-11-29 14:52:57-05:00,['50f80b27ae1816afc2dcd892f40372b5e08808ae'],308,984,1292,34138100,38,0.539906103,0.995305164,0.915492958,32081
8e4cf26424185445697460c947209933d6412883,0,GitHub,2018-11-30 13:50:35+02:00,"['3b5343e14a9f9b5c103f4f2280ea735670dc8fd8', '9979fa81bc563f93d1c314a49539ef7de366580b']",1,1,2,34138102,1,,,,32081
34b637906c1650a9f49b82482eb07b1a4b7fec2c,0,Andrii Tkach,2018-11-30 17:49:15+02:00,['8e4cf26424185445697460c947209933d6412883'],15,20,35,34138137,3,1,1,1,32081
b2fd171b82f7fa610cd9e951c8b10dbbb2f6fd0b,1,GitHub,2018-11-30 18:49:42+01:00,['8e4cf26424185445697460c947209933d6412883'],0,561,561,34138698,1,,,,32082
d4599975382e053b7a614fa2aa5531383f8ee98f,0,GitHub,2018-12-01 00:26:32+01:00,['b2fd171b82f7fa610cd9e951c8b10dbbb2f6fd0b'],129,862,991,34139689,14,0.8359375,1,0.872395833,32087
0ce508d9f4dd093cd2d0462149e30896f2fbfe6b,0,GitHub,2018-12-03 13:40:35+02:00,"['d4599975382e053b7a614fa2aa5531383f8ee98f', '34b637906c1650a9f49b82482eb07b1a4b7fec2c']",15,20,35,34139724,3,,,,32087
b6a33413e518a20e186609996b34671d33573c51,0,GitHub,2018-12-03 12:17:10-05:00,['0ce508d9f4dd093cd2d0462149e30896f2fbfe6b'],124,1524,1648,34141372,29,0.348511384,0.823117338,0.784588441,32098
1bc9d76c17082c17dd721f50986f77da1ae49834,0,GitHub,2018-12-04 13:33:34+03:00,"['b6a33413e518a20e186609996b34671d33573c51', 'e30d582d3e01efb1453e35f8eed042bb0360403d']",0,221,221,34141593,2,,,,32098
237e0c8632b06282044a83429119c250fc3c652f,0,Alex Antonenko,2018-12-04 15:05:44+03:00,['1bc9d76c17082c17dd721f50986f77da1ae49834'],0,130,130,34141723,2,1,1,1,32099
26e3c4942ce9fd883060fbe4ebb5c40d36fccb6f,0,Andrii Tkach,2018-12-04 14:08:01+02:00,['1bc9d76c17082c17dd721f50986f77da1ae49834'],3,3,6,34141729,3,,,,32099
17f90987b1aa2b0fbb0bf787200d9148f0d6e785,0,aonishuk,2018-12-04 15:17:28+02:00,['1bc9d76c17082c17dd721f50986f77da1ae49834'],2,2,4,34141733,1,,,,32099
958db3ff83b5d7622a5fc632e8ae888c3324f479,0,GitHub,2018-12-04 15:36:44+02:00,"['17f90987b1aa2b0fbb0bf787200d9148f0d6e785', '26e3c4942ce9fd883060fbe4ebb5c40d36fccb6f']",3,3,6,34141739,3,,,,32099
f6202221457b0f560872c76b2e4b54e92bd352e3,0,GitHub,2018-12-04 20:03:44+03:00,"['958db3ff83b5d7622a5fc632e8ae888c3324f479', '237e0c8632b06282044a83429119c250fc3c652f']",0,130,130,34141869,2,,,,32099
4c70e1a7ec5609992fa06fca9618f5b112f941a5,0,GitHub,2018-12-04 16:11:58-05:00,['f6202221457b0f560872c76b2e4b54e92bd352e3'],64,519,583,34142452,10,0.467532468,0.727272727,0.649350649,32100
c1dca2715258d385b8946f5fc537392c668b30ae,0,GitHub,2018-12-04 23:21:37+01:00,['4c70e1a7ec5609992fa06fca9618f5b112f941a5'],1,1,2,34142454,1,,,,32100
02e7b56aff1acee1f1acb5647be48f7566bd89d0,0,GitHub,2018-12-05 07:49:29+01:00,['c1dca2715258d385b8946f5fc537392c668b30ae'],4,523,527,34142981,5,0.423076923,0.811188811,0.367132867,32102
f4be4bb1e573c2a8376fa2aa9a17d340d906b99d,0,Andrii Tkach,2018-12-05 13:19:14+02:00,['02e7b56aff1acee1f1acb5647be48f7566bd89d0'],9,21,30,34143011,3,0.666666667,1,0.666666667,32102
f45acba63f25a3ec92532e037406b656bf227a8e,0,GitHub,2018-12-05 14:09:04+02:00,"['02e7b56aff1acee1f1acb5647be48f7566bd89d0', 'f4be4bb1e573c2a8376fa2aa9a17d340d906b99d']",9,21,30,34143041,3,,,,32102
b268518b25ee9f78d00926b27516a773ea58967c,1,GitHub,2018-12-05 18:00:47+01:00,['f45acba63f25a3ec92532e037406b656bf227a8e'],33,79,112,34143153,5,0.923076923,1,1,32102
e70dd4e7434bc3828629d329684a12b574dfd9d3,0,GitHub,2018-12-05 18:11:40+01:00,['b268518b25ee9f78d00926b27516a773ea58967c'],2,28,30,34143183,2,1,1,1,32102
129632c94aa339571d0fa278a2259157b5244fcb,0,GitHub,2018-12-05 22:43:53+01:00,['e70dd4e7434bc3828629d329684a12b574dfd9d3'],5,25,30,34143213,7,0.384615385,1,1,32102
e1ceec262ddcc02c095941024507048fbccbc255,0,aonishuk,2018-12-06 15:06:34+02:00,['129632c94aa339571d0fa278a2259157b5244fcb'],1,1,2,34143215,1,,,,32102
fcd53d1383c5d66cca173eeb8f83986b7a921901,0,aonishuk,2018-12-06 15:09:13+02:00,['e1ceec262ddcc02c095941024507048fbccbc255'],3,3,6,34143221,1,1,1,0,32102
642220e874991f41f78f545a12ad85a654e4bd97,0,GitHub,2018-12-06 15:17:06+02:00,['fcd53d1383c5d66cca173eeb8f83986b7a921901'],33,39,72,34143293,2,1,1,0,32102
9460e3d768851c474ba8891f95c9e2434574d057,0,Alex Antonenko,2018-12-06 18:28:02+03:00,['642220e874991f41f78f545a12ad85a654e4bd97'],0,128,128,34143421,2,1,1,1,32103
2eade4e1ae1333b78ca729d16e7b4fb71a3d9ad2,0,Alex Antonenko,2018-12-06 20:19:43+03:00,['642220e874991f41f78f545a12ad85a654e4bd97'],0,88,88,34143509,2,0.76119403,1,1,32104
c0e396f9fcb98fcb6931be748e2187aa3352565c,0,GitHub,2018-12-06 18:23:04+01:00,['642220e874991f41f78f545a12ad85a654e4bd97'],1,1,2,34143511,1,,,,32104
1e51e6b89e7da26ae9ecdf5d7228d20d1dfe61b4,1,GitHub,2018-12-06 13:43:05-05:00,['c0e396f9fcb98fcb6931be748e2187aa3352565c'],103,324,427,34143938,8,0.26744186,0.825581395,0.76744186,32105
60a05a806fc3203cda35cc3a6be3a5c713d18be3,0,Robert Levas,2018-12-06 15:24:09-05:00,['1e51e6b89e7da26ae9ecdf5d7228d20d1dfe61b4'],53,106,159,34144097,11,1,1,1,32106
8c0220908f01c71aab28ca9f1788ab0869e6c3cb,0,GitHub,2018-12-10 07:58:27-05:00,['60a05a806fc3203cda35cc3a6be3a5c713d18be3'],45,53,98,34144195,2,0.8,0,0,32106
38b2e5046441c879b31734bb3b3c231c3a451212,0,GitHub,2018-12-10 16:25:01+01:00,['8c0220908f01c71aab28ca9f1788ab0869e6c3cb'],14,25,39,34144234,2,0.625,0.625,0.25,32106
7e5cf0afbded4326883d9779b85024f476bfb62a,0,GitHub,2018-12-10 21:46:07+01:00,['38b2e5046441c879b31734bb3b3c231c3a451212'],132,186,318,34144552,3,1,1,0.868421053,32106
aedbcb7100588d7a78ae04241a0b61ee64f6fe3b,0,GitHub,2018-12-10 22:51:50+01:00,['7e5cf0afbded4326883d9779b85024f476bfb62a'],161,631,792,34145344,20,0.738675958,0.822299652,0.839721254,32107
e2f9318474d876252e606ac637fe2b2cd146a096,0,aonishuk,2018-12-11 13:57:24+02:00,['aedbcb7100588d7a78ae04241a0b61ee64f6fe3b'],1,1,2,34145346,1,,,,32107
7aa6fdbc4b8f8cf6098c4574269b2af295bb3eb3,0,GitHub,2018-12-11 14:58:47+03:00,"['e2f9318474d876252e606ac637fe2b2cd146a096', '9460e3d768851c474ba8891f95c9e2434574d057']",0,128,128,34145474,2,,,,32107
86936b917b265f0956c634b5dd428b7ba90cafe6,1,Andrii Tkach,2018-12-11 14:12:21+02:00,['e2f9318474d876252e606ac637fe2b2cd146a096'],187,1062,1249,34146723,4,0.981961669,1,1,32107
47882ab36800c2b54e1a53798ff9eb7a6f75eac5,0,GitHub,2018-12-11 16:32:34+03:00,"['7aa6fdbc4b8f8cf6098c4574269b2af295bb3eb3', '2eade4e1ae1333b78ca729d16e7b4fb71a3d9ad2']",0,88,88,34146811,2,,,,32107
a9153f1c7edee8622a2b0b3095bf2aaef9259c87,0,GitHub,2018-12-11 16:44:41+02:00,"['47882ab36800c2b54e1a53798ff9eb7a6f75eac5', '86936b917b265f0956c634b5dd428b7ba90cafe6']",187,1062,1249,34148060,4,,,,32107
7ea401f16a416fbfb3620d47adcac603cf29bec6,0,Alex Antonenko,2018-12-11 18:37:10+03:00,['7aa6fdbc4b8f8cf6098c4574269b2af295bb3eb3'],0,292,292,34148352,2,0.795774648,1,1,32108
a420f4a9a958607a8ad99442262020fe93b82560,0,Alex Antonenko,2018-12-11 18:37:39+03:00,"['7ea401f16a416fbfb3620d47adcac603cf29bec6', 'a9153f1c7edee8622a2b0b3095bf2aaef9259c87']",187,1150,1337,34149689,6,,,,32108
f4b8e4bc093f1b25ee748e6dce8f0b1e7b80cdee,0,GitHub,2018-12-11 18:00:17+01:00,['a9153f1c7edee8622a2b0b3095bf2aaef9259c87'],0,9,9,34149698,2,1,1,1,32108
6231892fdc052016eba183935d69277b56a73917,0,GitHub,2018-12-11 18:04:53+01:00,['f4b8e4bc093f1b25ee748e6dce8f0b1e7b80cdee'],132,188,320,34150018,7,1,0,1,32108
2ae3987d2b2b443036f4ee5119ff6152340cf468,0,GitHub,2018-12-11 20:06:26+01:00,['6231892fdc052016eba183935d69277b56a73917'],21,127,148,34150166,5,1,1,0.90625,32108
0c8286a5d39c95022c1857090b175efb5e81098a,0,GitHub,2018-12-11 16:35:22-05:00,['2ae3987d2b2b443036f4ee5119ff6152340cf468'],30,52,82,34150248,6,1,1,0,32108
6c9c06c34bd31562962e5e956c201db3990fc8db,0,GitHub,2018-12-12 20:20:31+01:00,['0c8286a5d39c95022c1857090b175efb5e81098a'],40,136,176,34150424,4,0.946428571,0.803571429,0.571428571,32109
bab7cf52c4d08526fc1b95bac042abcfd96aa646,0,Andrii Tkach,2018-12-13 14:36:31+02:00,['e2f9318474d876252e606ac637fe2b2cd146a096'],13,114,127,34150551,2,1,1,1,32109
eb226e1b9700661156d7b98abb6aeab9be28e6bb,0,GitHub,2018-12-13 16:08:22+02:00,"['6c9c06c34bd31562962e5e956c201db3990fc8db', 'bab7cf52c4d08526fc1b95bac042abcfd96aa646']",13,114,127,34150678,2,,,,32109
2411ccf6d633aa97cf48d181b6254f3ac36d5f89,0,GitHub,2018-12-13 16:06:59+01:00,['eb226e1b9700661156d7b98abb6aeab9be28e6bb'],49,142,191,34150869,5,0.814814815,0.87037037,0.685185185,32109
66b6f7f7f061b8d19589378e7d0876a1495bfb62,0,GitHub,2018-12-13 16:07:36+01:00,['2411ccf6d633aa97cf48d181b6254f3ac36d5f89'],1,8,9,34150878,1,1,1,1,32109
ab3e2b6f17057cbe78d5e3f9385b83394c2aca6a,0,GitHub,2018-12-13 16:37:12+01:00,['66b6f7f7f061b8d19589378e7d0876a1495bfb62'],1,26,27,34150905,2,0.75,1,0.75,32109
26575d3df20503f798f5be390442dd6a3201f182,0,GitHub,2018-12-13 18:53:27+01:00,['ab3e2b6f17057cbe78d5e3f9385b83394c2aca6a'],1,138,139,34151044,3,0,0.990740741,0.990740741,32109
f3aa02f7bb4c765885af9d740c7661dd1cdbca80,1,GitHub,2018-12-14 00:59:39+01:00,['26575d3df20503f798f5be390442dd6a3201f182'],104,998,1102,34152146,23,0.426751592,0.992038217,1,32111
0bf2c54835e8441d18fd8955cc9d0e8c751d97b0,0,Andrii Tkach,2018-12-17 16:35:28+02:00,['f3aa02f7bb4c765885af9d740c7661dd1cdbca80'],7,25,32,34152178,5,0.85,0.85,1,32111
067024fd5f04f211489f93e8553394699a1af635,0,GitHub,2018-12-18 12:55:19+02:00,"['f3aa02f7bb4c765885af9d740c7661dd1cdbca80', '0bf2c54835e8441d18fd8955cc9d0e8c751d97b0']",7,25,32,34152210,5,,,,32111
28e43c854dbf0366fdb5fd0fbe1dc2f64d8880f1,0,GitHub,2018-12-18 14:38:08+03:00,"['067024fd5f04f211489f93e8553394699a1af635', 'a420f4a9a958607a8ad99442262020fe93b82560']",0,292,292,34152502,2,,,,32111
963eaf495b684079aedeb32f2589da4c96aa2cca,0,Andrii Tkach,2018-12-18 14:36:59+02:00,['28e43c854dbf0366fdb5fd0fbe1dc2f64d8880f1'],3,2,5,34152507,1,1,0,0.777777778,32111
4eae8c271e996a2afe51ec2118afdd1ade30de20,0,Alex Antonenko,2018-12-18 15:47:20+03:00,['28e43c854dbf0366fdb5fd0fbe1dc2f64d8880f1'],0,60,60,34152567,2,1,1,1,32112
156cc3f04332d008bb8018e5885ab7204bf946cc,0,GitHub,2018-12-18 16:54:20+02:00,"['28e43c854dbf0366fdb5fd0fbe1dc2f64d8880f1', '963eaf495b684079aedeb32f2589da4c96aa2cca']",3,2,5,34152572,1,,,,32112
40f99c56d5896044d1075966377b1e434d777cb7,0,GitHub,2018-12-18 17:09:16-05:00,['156cc3f04332d008bb8018e5885ab7204bf946cc'],1,25,26,34152598,4,0,1,1,32112
556e91e3fac5c5b45356fb99c680786c603cc632,0,Andrii Tkach,2018-12-19 10:40:23+02:00,['40f99c56d5896044d1075966377b1e434d777cb7'],1,1,2,34152600,1,,,,32112
596a40a73e91d5cd0d74bd57b221bbdc14e4a4b1,0,GitHub,2018-12-19 12:32:20+02:00,"['40f99c56d5896044d1075966377b1e434d777cb7', '556e91e3fac5c5b45356fb99c680786c603cc632']",1,1,2,34152602,1,,,,32112
34a4c61f4480d59db764ff503e108919da540c58,0,Andrii Tkach,2018-12-19 15:43:29+02:00,['596a40a73e91d5cd0d74bd57b221bbdc14e4a4b1'],10,2,12,34152614,1,0,0,0,32112
e86cafb8ddaa4b128243baf4a606d49061a945f6,0,GitHub,2018-12-19 16:36:27+02:00,"['596a40a73e91d5cd0d74bd57b221bbdc14e4a4b1', '34a4c61f4480d59db764ff503e108919da540c58']",10,2,12,34152626,1,,,,32112
3c28378fa4e6f4299e7df01c47359b4c8643ef63,0,GitHub,2018-12-19 19:53:26+01:00,['e86cafb8ddaa4b128243baf4a606d49061a945f6'],34,212,246,34152872,7,0.296296296,1,1,32113
c8e80ce05751291c135c3014d536b8162686ca58,0,Sandor Molnar,2018-12-20 11:27:02+01:00,['3c28378fa4e6f4299e7df01c47359b4c8643ef63'],2,2,4,34152876,1,,,,32113
3fc52fcbe3e8fa221abf22aee6acb69211fb337c,0,aBabiichuk,2018-12-20 16:36:18+02:00,['c8e80ce05751291c135c3014d536b8162686ca58'],22,14,36,34152912,2,0,0,0,32113
1431ab44887c2ff7f9e94f8fcb42e24e3ce33800,1,GitHub,2018-12-20 15:56:46+01:00,['3fc52fcbe3e8fa221abf22aee6acb69211fb337c'],280,1137,1417,34154329,23,0.561797753,0.966292135,0.780898876,32120
7f9d14bb4a36a58eed1c478d903a2c591a3bcd61,0,GitHub,2018-12-20 21:03:03+02:00,['1431ab44887c2ff7f9e94f8fcb42e24e3ce33800'],28,86,114,34154443,5,1,1,1,32120
fa3c6850f2426b01d2fa5e1fb2876cf901fddadb,0,GitHub,2018-12-21 05:16:37-05:00,['7f9d14bb4a36a58eed1c478d903a2c591a3bcd61'],99,471,570,34155013,16,0.067961165,0.810679612,0.150485437,32120
0e97706c7b5b4f9b43d9bee961ce7b4a735eb638,0,GitHub,2018-12-21 09:08:33-05:00,['fa3c6850f2426b01d2fa5e1fb2876cf901fddadb'],87,303,390,34155403,46,0.276595745,0,0.957446809,32122
7e15bff1e725e07195ba4ede3cf723edb473da2c,0,GitHub,2018-12-21 17:45:42+03:00,"['0e97706c7b5b4f9b43d9bee961ce7b4a735eb638', '4eae8c271e996a2afe51ec2118afdd1ade30de20']",0,60,60,34155463,2,,,,32122
563d508f6eedf730e9d15183afb50790c4ffb52f,0,GitHub,2018-12-22 08:47:15+01:00,['7e15bff1e725e07195ba4ede3cf723edb473da2c'],390,345,735,34156198,41,0.830357143,0.482142857,0.401785714,32123
a030fe12d62f7a74c4602b2110c5df438dc82403,1,Andrii Tkach,2018-12-26 08:58:28+02:00,['563d508f6eedf730e9d15183afb50790c4ffb52f'],184,145,329,34156527,26,0,0,0.692307692,32123
d069e15a5f6b76362e7c2657617c9c2270e69a9a,0,Andrii Tkach,2018-12-26 08:58:28+02:00,['a030fe12d62f7a74c4602b2110c5df438dc82403'],7,9,16,34156543,5,0.714285714,1,0,32123
cd2e55adb6d85a74d68d061ea4937cb69264d11d,0,Myroslav Papirkovskyi,2018-12-26 19:56:08+02:00,['d069e15a5f6b76362e7c2657617c9c2270e69a9a'],3,9,12,34156555,3,1,1,1,32123
63df198782b4caba069efd0cee35ef875ab550b8,1,GitHub,2018-12-27 20:53:34+02:00,['d069e15a5f6b76362e7c2657617c9c2270e69a9a'],5,693,698,34157253,10,0.551898734,0.929113924,0.883544304,32127
cc295697d8cedefeab682128360f019406832361,0,GitHub,2018-12-27 21:08:47+02:00,"['63df198782b4caba069efd0cee35ef875ab550b8', 'cd2e55adb6d85a74d68d061ea4937cb69264d11d']",3,9,12,34157265,3,,,,32127
5c735930ede8298f0aa81f78641bf8b2f3efac36,0,Andrii Tkach,2018-12-28 11:24:51+02:00,['cc295697d8cedefeab682128360f019406832361'],3,16,19,34157284,1,0,1,1,32127
bde5e12fbff3343e4b2775e8df32c0c397b89c48,0,GitHub,2018-12-31 14:47:04+02:00,['5c735930ede8298f0aa81f78641bf8b2f3efac36'],16,18,34,34157318,2,1,1,1,32127
0717fb84a2034b2204b346edcc86d94796f67395,0,GitHub,2018-12-31 20:14:24+02:00,['bde5e12fbff3343e4b2775e8df32c0c397b89c48'],39,227,266,34157584,14,0,0.958333333,0.941666667,32127
78ad4f572b631797d0675d3cef753b5237521188,0,Andrii Tkach,2019-01-02 12:50:26+02:00,['0717fb84a2034b2204b346edcc86d94796f67395'],23,12,35,34157619,5,1,0,0,32127
445d018cb235c110a8697f79855d2fbc841b2632,0,GitHub,2019-01-02 16:47:21-05:00,['78ad4f572b631797d0675d3cef753b5237521188'],2,0,2,34157621,1,,,,32127
1b58df7829ad92fdb81042f29d97a07257d90705,0,Andrii Tkach,2019-01-03 14:41:34+02:00,['445d018cb235c110a8697f79855d2fbc841b2632'],3,311,314,34157935,4,1,1,1,32128
ee933be77ab0541fa009bae6326cf9f8b8574501,0,Alex Antonenko,2019-01-03 19:21:11+03:00,['1b58df7829ad92fdb81042f29d97a07257d90705'],0,77,77,34158012,2,1,1,1,32129
ecce21178c9f3612dca8354b9874e16ec7702078,0,GitHub,2019-01-04 09:58:28+01:00,['1b58df7829ad92fdb81042f29d97a07257d90705'],0,7,7,34158019,2,1,1,0.4,32129
c20e418a2c0d278db6dea9caa5fd45cf6c80723d,0,GitHub,2019-01-04 08:37:00-05:00,['ecce21178c9f3612dca8354b9874e16ec7702078'],17,105,122,34158141,3,0.268292683,1,1,32129
77b5319381fd083f4f9774581b1fad082bb71e4a,0,Robert Levas,2019-01-04 09:36:35-05:00,['c20e418a2c0d278db6dea9caa5fd45cf6c80723d'],9,11,20,34158161,1,0,0,0,32129
883d95f7a93ed53e637b617acd86cd2bf9b5c3fd,1,GitHub,2019-01-07 20:48:20+01:00,['77b5319381fd083f4f9774581b1fad082bb71e4a'],33,136,169,34158330,4,0.171052632,1,1,32129
313178dc562cb8c2fc341b788a6da50b4274a869,0,Andrii Tkach,2019-01-08 17:23:30+02:00,['883d95f7a93ed53e637b617acd86cd2bf9b5c3fd'],3,185,188,34158518,4,0.630769231,1,1,32131
a1f21c924fc82d698d51c235555381e4b8cf9562,0,GitHub,2019-01-10 14:05:35+03:00,"['313178dc562cb8c2fc341b788a6da50b4274a869', 'ee933be77ab0541fa009bae6326cf9f8b8574501']",0,77,77,34158595,2,,,,32131
04e120a9334f21773cf0ce3fc94c84ff4c0da11f,0,aBabiichuk,2019-01-10 13:51:18+02:00,['a1f21c924fc82d698d51c235555381e4b8cf9562'],1,7,8,34158603,1,1,1,1,32131
7c3275fde332585b5b3ce7c93afec7a84177498a,0,aonishuk,2019-01-10 13:57:10+02:00,['04e120a9334f21773cf0ce3fc94c84ff4c0da11f'],5,97,102,34158705,4,,,,32134
acfb45bafbb57e7c37eb02e6f139ff7fceee221d,0,aonishuk,2019-01-10 13:57:10+02:00,['7c3275fde332585b5b3ce7c93afec7a84177498a'],12,0,12,34158717,1,,,,32134
b3be244b0d6b68cffd128c7db43830cae8077a51,0,aonishuk,2019-01-10 13:57:10+02:00,['acfb45bafbb57e7c37eb02e6f139ff7fceee221d'],27,0,27,34158744,1,,,,32134
e8af38203520ddff14bcc8c8ea2b5c5c010fb642,0,aonishuk,2019-01-10 13:57:10+02:00,['b3be244b0d6b68cffd128c7db43830cae8077a51'],52,0,52,34158796,1,,,,32134
5f329b9f858c292f7b6aeae4d93b434489278c1b,0,Andrii Tkach,2019-01-10 18:23:21+02:00,['e8af38203520ddff14bcc8c8ea2b5c5c010fb642'],29,549,578,34159374,9,0.553299492,0.997461929,1,32139
5cd1e7b17e31a10dc8cee29d52c89388001d68ec,0,Andrii Tkach,2019-01-14 17:18:17+02:00,['5f329b9f858c292f7b6aeae4d93b434489278c1b'],1,10,11,34159385,1,1,1,0.428571429,32139
a6aefd1cc942096aa6d212d598618563f6025457,0,GitHub,2019-01-14 17:08:08+01:00,['5cd1e7b17e31a10dc8cee29d52c89388001d68ec'],11,27,38,34159423,2,1,1,1,32139
8245597fb1d4ec62e1e9648900f0a01f5f0d66b3,0,Robert Levas,2019-01-14 11:19:37-05:00,['a6aefd1cc942096aa6d212d598618563f6025457'],2,1,3,34159426,2,0,0,0,32139
0fdfa1afa534c022d6546aac9da6ff9bfc3b6302,0,aBabiichuk,2019-01-15 13:21:54+02:00,['8245597fb1d4ec62e1e9648900f0a01f5f0d66b3'],19,21,40,34159466,9,,,,32139
818b21f211bfc27f5152749f2e445c63de98c78f,0,Robert Levas,2019-01-15 11:49:29-05:00,['0fdfa1afa534c022d6546aac9da6ff9bfc3b6302'],6,8,14,34159480,1,1,1,1,32139
615a86ca86d725beaa9744afb82b595247409bc6,0,Aleksandr Kovalenko,2019-01-16 18:17:27+02:00,['818b21f211bfc27f5152749f2e445c63de98c78f'],0,423,423,34159903,5,0.735384615,1,1,32143
8f670c780c9c16efed9d966d1f0f6e71837c465d,0,aonishuk,2019-01-17 09:28:47+02:00,['615a86ca86d725beaa9744afb82b595247409bc6'],0,2,2,34159905,1,,,,32143
aac5619a5053d8d759e8bc32cb5d0777d6ce67d4,0,Alex Antonenko,2019-01-17 16:11:49+03:00,['8f670c780c9c16efed9d966d1f0f6e71837c465d'],0,244,244,34160149,2,0.913419913,1,1,32144
b992966e3af3a76cab571194b977c921894826ee,0,Andrii Tkach,2019-01-17 16:46:02+02:00,['8f670c780c9c16efed9d966d1f0f6e71837c465d'],83,671,754,34160903,10,0.808510638,0.978723404,0.993617021,32147
c50dc8d8ad7c559bf7baf93e49616135685b9c85,0,GitHub,2019-01-17 19:53:30+03:00,"['b992966e3af3a76cab571194b977c921894826ee', 'aac5619a5053d8d759e8bc32cb5d0777d6ce67d4']",0,244,244,34161147,2,,,,32147
97a6bc8b389fa5cfb73c87392af91e2d4d405ae3,1,GitHub,2019-01-18 17:07:53+02:00,['c50dc8d8ad7c559bf7baf93e49616135685b9c85'],339,802,1141,34162288,5,0.332155477,0.939929329,0.024734982,32148
94067cb8bbeee702113273aab2757ad17f863d91,0,"Doroszlai, Attila",2019-01-21 11:49:50+01:00,['97a6bc8b389fa5cfb73c87392af91e2d4d405ae3'],1,1,2,34162290,1,,,,32148
10f955b8da9283a41deceb34387dbb7b71bc46e2,0,GitHub,2019-01-22 17:43:34+02:00,['94067cb8bbeee702113273aab2757ad17f863d91'],15,15,30,34162320,2,,,,32148
3ad2ab8fb49e4f330fa4b4a2e23c8c68de27f161,0,GitHub,2019-01-22 18:38:40+02:00,['10f955b8da9283a41deceb34387dbb7b71bc46e2'],0,783,783,34163103,3,0.832167832,1,1,32150
7adae86c9c63ffad4c98c93862737bfbb06aa912,0,Alex Antonenko,2019-01-23 15:25:44+03:00,['aac5619a5053d8d759e8bc32cb5d0777d6ce67d4'],0,250,250,34163353,2,0.92173913,1,1,32151
3096cecc48af9fffbcc1b8ef40f1ae6f6b0ee73c,0,Alex Antonenko,2019-01-23 16:03:06+03:00,['aac5619a5053d8d759e8bc32cb5d0777d6ce67d4'],0,0,0,34163353,1,,,,32152
e2f70050086e3ae54c8ad6ff67b58d9e161a9e31,0,Alex Antonenko,2019-01-23 16:03:36+03:00,['3096cecc48af9fffbcc1b8ef40f1ae6f6b0ee73c'],0,111,111,34163464,2,1,1,1,32152
6f856eee063bd91de5eff0e025af36fa15e9e821,0,aBabiichuk,2019-01-23 20:13:45+02:00,['3ad2ab8fb49e4f330fa4b4a2e23c8c68de27f161'],220,11,231,34163695,24,0.005076142,0,0,32152
06c4f06cb4226053ea4c712a1e3f5548488043cd,0,GitHub,2019-01-23 21:28:32+02:00,['6f856eee063bd91de5eff0e025af36fa15e9e821'],104,131,235,34163930,1,0.25,0,1,32152
8bc86792ea24162a9f366926d660ce9d251db0da,0,aonishuk,2019-01-24 09:55:32+02:00,['06c4f06cb4226053ea4c712a1e3f5548488043cd'],0,1,1,34163931,1,0,0,0,32152
9e22cc9087c91f9cc8f6968c68c2744d8a8bc4d6,0,Andrii Tkach,2019-01-25 15:16:03+02:00,['8bc86792ea24162a9f366926d660ce9d251db0da'],124,1003,1127,34165058,3,0.665088757,1,0.979881657,32152
845f7773f85b93b16cf6fd547b171c1474e8e5f9,0,GitHub,2019-01-25 20:57:08+02:00,['9e22cc9087c91f9cc8f6968c68c2744d8a8bc4d6'],12,223,235,34165293,9,0.182539683,0.992063492,1,32152
630fdd359a5ff16f6cbd2405f4befb4be97972b0,0,GitHub,2019-01-29 10:42:21+01:00,['845f7773f85b93b16cf6fd547b171c1474e8e5f9'],1,1,2,34165295,1,,,,32152
0041d61cd3bc206a0f40dcdc955498869207ca49,0,GitHub,2019-01-29 15:00:55+03:00,"['630fdd359a5ff16f6cbd2405f4befb4be97972b0', 'e2f70050086e3ae54c8ad6ff67b58d9e161a9e31']",0,111,111,34165406,2,,,,32152
402bf1509ca55be42a48009680234f1ba7e997d5,0,GitHub,2019-01-29 15:01:07+03:00,"['0041d61cd3bc206a0f40dcdc955498869207ca49', '7adae86c9c63ffad4c98c93862737bfbb06aa912']",0,250,250,34165656,2,,,,32152
176b6d285cb2f82590d6178aff3a8f1b24a82a3e,0,Alex Antonenko,2019-01-29 16:33:22+03:00,['402bf1509ca55be42a48009680234f1ba7e997d5'],0,78,78,34165734,2,1,1,1,32153
cf82327ca1f3819ea251e38d4b9ed30e8c2e9923,0,GitHub,2019-01-29 19:59:53+01:00,['402bf1509ca55be42a48009680234f1ba7e997d5'],59,59,118,34165852,1,,,,32153
cbd628460a186991f8cf2c391657eb5891c2ab82,0,GitHub,2019-01-30 16:46:05+02:00,['cf82327ca1f3819ea251e38d4b9ed30e8c2e9923'],305,208,513,34166365,65,1,1,0.230769231,32153
1a711038698490b1f6423e3e4801ae98598d0366,0,GitHub,2019-01-31 14:54:24+07:00,['cbd628460a186991f8cf2c391657eb5891c2ab82'],3,61,64,34166429,2,0,0.902439024,1,32153
98457d182d11948820cde1d5c1b47b4ee3bb60d7,0,Andrii Tkach,2019-02-04 14:38:23+02:00,['1a711038698490b1f6423e3e4801ae98598d0366'],43,498,541,34166970,2,0.758186398,1,1,32153
b2a0297051a9603ab695b640ba37bc13e90877a1,0,GitHub,2019-02-04 15:22:13+01:00,['98457d182d11948820cde1d5c1b47b4ee3bb60d7'],3,4,7,34166977,1,0,0,0,32153
100fa13734d223cb0ddd9a3dbae3ec8dc24f7cb1,0,aBabiichuk,2019-02-04 18:36:11+02:00,['b2a0297051a9603ab695b640ba37bc13e90877a1'],23,1038,1061,34168038,10,0.132034632,1,1,32157
1a30286e82e1c6a59c36c5009001763de6decd14,0,Robert Levas,2019-02-04 12:37:31-05:00,['100fa13734d223cb0ddd9a3dbae3ec8dc24f7cb1'],1,3,4,34168042,1,,,,32157
0b2dd280910351ced5d468b5707525f837762b4f,0,GitHub,2019-02-05 14:57:33+02:00,"['1a30286e82e1c6a59c36c5009001763de6decd14', '176b6d285cb2f82590d6178aff3a8f1b24a82a3e']",0,78,78,34168120,2,,,,32157
78c9b13cfc4e1f0bc481b61892aa0d871b6399e7,0,aBabiichuk,2019-02-05 15:19:49+02:00,['0b2dd280910351ced5d468b5707525f837762b4f'],1294,0,1294,34169414,26,0.08974359,0.076923077,0,32157
d44c1b118f8e17c1af83dbd71a06f1be2e82c4c3,0,Robert Levas,2019-02-05 09:19:26-05:00,['78c9b13cfc4e1f0bc481b61892aa0d871b6399e7'],1,1,2,34169416,1,,,,32157
8613d58c347cc21961726811ac8d7bf43389ee6f,0,GitHub,2019-02-05 15:48:25+01:00,['d44c1b118f8e17c1af83dbd71a06f1be2e82c4c3'],151,158,309,34169725,9,1,0,1,32157
dfdb8bf7a6768ca773e57eac8f903a28a60e4b03,0,Aleksandr Kovalenko,2019-02-05 19:18:51+02:00,['8613d58c347cc21961726811ac8d7bf43389ee6f'],0,141,141,34169866,2,1,1,1,32158
9256fa11b2829f5f3cf2be8d0da9ed45d77505bd,0,Aleksandr Kovalenko,2019-02-05 19:19:14+02:00,['dfdb8bf7a6768ca773e57eac8f903a28a60e4b03'],0,175,175,34170041,3,1,1,1,32160
d17de751d44e5819f1bc30bc82f06db059588561,0,Aleksandr Kovalenko,2019-02-06 12:59:09+02:00,['9256fa11b2829f5f3cf2be8d0da9ed45d77505bd'],4,101,105,34170146,2,0.353535354,1,1,32160
813f9386eeefe8ecb57672cc850c76a70193ec6c,0,Aleksandr Kovalenko,2019-02-06 12:59:18+02:00,['d17de751d44e5819f1bc30bc82f06db059588561'],6,458,464,34170610,4,1,1,1,32162
2c0687ab1cb8a4ecb35715c8b632a764003c070b,0,Attila Magyar,2019-02-07 11:01:20+01:00,['813f9386eeefe8ecb57672cc850c76a70193ec6c'],1,1,2,34170612,1,,,,32162
157eed41d264922dd0e6335dc4b54c53859a83a4,0,Attila Magyar,2019-02-07 11:15:33+01:00,['2c0687ab1cb8a4ecb35715c8b632a764003c070b'],1,2,3,34170615,1,,,,32162
bd1bd59bd9ede7d1e833072b8ddf256887bf803a,1,Alex Antonenko,2019-02-07 14:57:57+03:00,['0b2dd280910351ced5d468b5707525f837762b4f'],1,607,608,34171223,6,0.867030965,1,1,32166
57d61373038796ef319d2a48e837ee29d0bafd4c,0,Alex Antonenko,2019-02-07 15:12:47+03:00,"['bd1bd59bd9ede7d1e833072b8ddf256887bf803a', '157eed41d264922dd0e6335dc4b54c53859a83a4']",1458,1037,2495,34173718,46,,,,32166
1c9d0d34fe2835551cd07b71ee7921a3612a7ece,0,Andrii Tkach,2019-02-07 19:00:15+02:00,['157eed41d264922dd0e6335dc4b54c53859a83a4'],45,499,544,34174262,3,0.606965174,1,1,32166
2bd65e811d26210a507ee92a2da421756ebffe1b,0,aBabiichuk,2019-02-08 14:42:36+02:00,['1c9d0d34fe2835551cd07b71ee7921a3612a7ece'],1,7,8,34174270,1,1,1,1,32166
a26febf601e9393ead35920fbfff2da7112130bb,0,Alex Antonenko,2019-02-14 16:41:45+03:00,['57d61373038796ef319d2a48e837ee29d0bafd4c'],69,0,69,34174339,1,0.555555556,0,0,32166
3dbaabab627f2b04c6165b1a8ce3572d2482a144,0,GitHub,2019-02-19 13:40:40+02:00,"['2bd65e811d26210a507ee92a2da421756ebffe1b', 'a26febf601e9393ead35920fbfff2da7112130bb']",1,538,539,34174878,6,,,,32166
5f86977297dfe7a17cc64c7bfacd7fa3d5725b4e,0,"Doroszlai, Attila",2019-02-28 08:27:34+01:00,['3dbaabab627f2b04c6165b1a8ce3572d2482a144'],0,1,1,34174879,1,,,,32166
b9e1ed503756f45e93ad3a23fb38b48a3e137289,0,Robert Levas,2019-03-06 08:33:08-05:00,['5f86977297dfe7a17cc64c7bfacd7fa3d5725b4e'],0,1,1,34174880,1,,,,32166
5cc3594560d60792c390e141227c8112a5212d4b,0,GitHub,2019-03-08 10:55:51+05:18,['b9e1ed503756f45e93ad3a23fb38b48a3e137289'],0,1,1,34174881,1,,,,32166
e366b43f499812df6005bb51f295bfd6a5f642fa,0,GitHub,2019-03-13 10:38:44+05:18,['5cc3594560d60792c390e141227c8112a5212d4b'],0,37,37,34174918,4,0.272727273,0.272727273,0.272727273,32166
eb73c4866a0048c858e022a3fd27670e30df94a5,0,Robert Levas,2019-03-15 11:30:58-04:00,['e366b43f499812df6005bb51f295bfd6a5f642fa'],2,2,4,34174922,1,,,,32166
2bc4779a1e6aabe638101fc8b0e28cd1963d6b13,0,ncole,2019-03-20 08:42:22-04:00,['eb73c4866a0048c858e022a3fd27670e30df94a5'],4,9,13,34174935,1,0,0,1,32166
180a7a3c1604e36e1b9f869fb42f4863d8f37926,0,Jay SenSharma,2019-03-26 13:01:43+11:00,['2bc4779a1e6aabe638101fc8b0e28cd1963d6b13'],1,2,3,34174938,1,,,,32166
b99bb28bcf6c3adb3a1f557d8217ef8624b422b4,0,Robert Levas,2019-04-02 10:53:50-04:00,['2bc4779a1e6aabe638101fc8b0e28cd1963d6b13'],4,4,8,34174946,1,,,,32166
604c82e3cd49e71643a870dd9ca77576cc2268c9,0,Siddharth,2019-04-03 10:51:08-07:00,['b99bb28bcf6c3adb3a1f557d8217ef8624b422b4'],1,153,154,34175100,2,0.008196721,0.336065574,1,32166
1b3fa75130c8a85a652ca69c5df4a850f0ca65b4,0,Ishan Bhatt,2019-04-03 13:10:24-07:00,['604c82e3cd49e71643a870dd9ca77576cc2268c9'],1,1,2,34175102,1,,,,32166
23aab4c58aa5a66163e08f073be0e54e75b64579,0,GitHub,2019-04-05 15:22:52+11:00,"['1b3fa75130c8a85a652ca69c5df4a850f0ca65b4', '180a7a3c1604e36e1b9f869fb42f4863d8f37926']",1,2,3,34175105,1,,,,32166
f44e648f2fb096d5fd910ddd610ecd4f74d41e11,0,GitHub,2019-04-05 15:43:11+05:18,['23aab4c58aa5a66163e08f073be0e54e75b64579'],1,8,9,34175114,1,1,1,1,32166
e694998eca8657e3c85016a2fb6e875bc5b973e5,0,GitHub,2019-04-11 12:14:15+03:00,['f44e648f2fb096d5fd910ddd610ecd4f74d41e11'],1,15,16,34175130,1,1,1,1,32166
9236f4ab966f40d93e27c44f9078bb204a6c591a,0,GitHub,2019-04-18 12:09:04+02:00,['e694998eca8657e3c85016a2fb6e875bc5b973e5'],4,3,7,34175137,1,0,0,1,32166
15fc310803d6206869c5af1d439a8d13176c7230,0,GitHub,2019-04-21 05:14:28+02:00,['9236f4ab966f40d93e27c44f9078bb204a6c591a'],1,12,13,34175150,2,0,1,1,32166
4dbba02f9aa24e4e6459d97402cdc764ebe73d8c,0,Attila Magyar,2019-04-25 15:41:15+02:00,['15fc310803d6206869c5af1d439a8d13176c7230'],1,1,2,34175152,1,,,,32166
b8a7605b2fb2f68fde7fc2c9d0262bb7dda119a9,1,Attila Magyar,2019-04-25 15:41:35+02:00,['4dbba02f9aa24e4e6459d97402cdc764ebe73d8c'],1,2,3,34175155,1,,,,32166
23bd6a0f99df2467889c206f059354ca5e79a60e,0,Attila Magyar,2019-04-25 15:41:46+02:00,['b8a7605b2fb2f68fde7fc2c9d0262bb7dda119a9'],1,1,2,34175157,1,,,,32166
d57de4c872c07d82d32facf30e03daa0bfbe3394,1,Attila Magyar,2019-05-24 08:57:20+02:00,['23bd6a0f99df2467889c206f059354ca5e79a60e'],1,1,2,34175159,1,,,,32166
c89bb07059e6e8704ade78018c6dae472020f5b7,0,Attila Magyar,2019-05-30 09:57:42+02:00,['d57de4c872c07d82d32facf30e03daa0bfbe3394'],1,2,3,34175162,1,,,,32166
91f80c3bce37d78dee64142544b2ab1ea5962bfb,0,Attila Magyar,2019-05-30 11:46:03+02:00,['c89bb07059e6e8704ade78018c6dae472020f5b7'],0,18,18,34175180,2,1,1,1,32166
c7ac862a4c335c4e05dfb9ad20b09e6ce3f8e097,0,Attila Magyar,2019-06-05 17:08:55+02:00,['91f80c3bce37d78dee64142544b2ab1ea5962bfb'],22,15,37,34175217,1,,,,32166
99b2bee07a6359857a6e03396d2884425f57f6f0,0,Attila Magyar,2019-06-06 10:18:49+02:00,['c7ac862a4c335c4e05dfb9ad20b09e6ce3f8e097'],10,341,351,34175568,4,0,0.719101124,0.286516854,32167
75f37d9bbd6315ef3d1decac1ed411046598c6b2,0,Attila Magyar,2019-06-12 12:42:16+02:00,['99b2bee07a6359857a6e03396d2884425f57f6f0'],56,11,67,34175635,4,1,0.577777778,0,32167
076279cc91d7b2851c67ac6b8979e4eda4e28fc4,0,Akhil S Naik,2019-06-19 12:59:58+05:18,['75f37d9bbd6315ef3d1decac1ed411046598c6b2'],0,47,47,34175682,3,0.875,0.875,1,32167
c6db11c87f1cfd5bc9ace42de3616ea545490a9e,0,Akhil S Naik,2019-06-19 14:45:55+05:18,['076279cc91d7b2851c67ac6b8979e4eda4e28fc4'],76,83,159,34175841,17,0,0.666666667,1,32167
9cae3c4f5a5884956630f128cef786d15ccb9610,0,Lisnichenko Dmitro,2019-06-25 14:27:04+03:00,['c6db11c87f1cfd5bc9ace42de3616ea545490a9e'],6,6,12,34175853,5,,,,32167
7ec7ec3baa8c8690e2cc2f1e86ee1c85b4552846,0,Jonathan Hurley,2019-07-08 19:35:02-04:00,['9cae3c4f5a5884956630f128cef786d15ccb9610'],9,13,22,34175875,1,1,1,1,32167
e932c88a8142cc2b3e1d7514049d78b7bf80bbf7,0,GitHub,2019-07-10 11:36:49+03:00,['7ec7ec3baa8c8690e2cc2f1e86ee1c85b4552846'],85,67,152,34176027,45,,,,32167
616d19716a999312d6d4a47bcfc9935f4e9e6efe,0,Jonathan Hurley,2019-07-15 17:07:26-04:00,['e932c88a8142cc2b3e1d7514049d78b7bf80bbf7'],45,24,69,34176096,8,0.444444444,0.111111111,0.111111111,32167
72d203f26bfeecde9b4bb9ce81dbe95b6111e0f2,0,Dmytro Grinenko,2019-07-17 12:12:16+03:00,['616d19716a999312d6d4a47bcfc9935f4e9e6efe'],2,2,4,34176100,1,,,,32167
f8560b655cd03a30d99fd7ebb873dbe2f02a914e,0,Jonathan Hurley,2019-07-22 13:37:23-04:00,['72d203f26bfeecde9b4bb9ce81dbe95b6111e0f2'],4,6,10,34176110,1,0,0,0,32167
03d57843fe4fecac9950e0831ebc9fc45b6ae2b4,0,Jonathan Hurley,2019-08-13 11:35:49-04:00,['f8560b655cd03a30d99fd7ebb873dbe2f02a914e'],2,3,5,34176115,1,,,,32167
8eda334c2bbedfc91f4ef2b4be64e389fba3af26,0,GitHub,2019-09-20 17:03:27+05:18,['03d57843fe4fecac9950e0831ebc9fc45b6ae2b4'],3,0,3,34176118,1,0,1,0,32167
b066df1d3e2683251dc588cddd94fcdcfeaa1178,0,Asnaik HWX,2019-10-01 12:03:02+05:18,['8eda334c2bbedfc91f4ef2b4be64e389fba3af26'],3,3,6,34176124,3,,,,32167
f6aec3286da30d42c7faef2e84e88b968bcdf040,0,Asnaik HWX,2019-10-16 12:53:11+05:18,['b066df1d3e2683251dc588cddd94fcdcfeaa1178'],25,40,65,34176189,2,0,0,1,32167
2cf36ba9605c9302f04e63848b609249d036fbe3,0,Dmytro Grinenko,2019-12-17 18:08:49+02:00,['f6aec3286da30d42c7faef2e84e88b968bcdf040'],13,14,27,34176216,6,0.75,1,1,32167
c575567b8bc95044860011287001bf7b75a1fcbf,0,GitHub,2020-05-25 10:09:36+03:00,['2cf36ba9605c9302f04e63848b609249d036fbe3'],1,1,2,34176218,1,,,,32167
77b5af4ae591f15f00807c3a939f78393d32d034,0,GitHub,2020-06-09 12:45:45+03:00,['c575567b8bc95044860011287001bf7b75a1fcbf'],14,8,22,34176240,1,0,1,0,32167
a42d52f7999592c96f67ad114d27f7b8a2a92e66,0,GitHub,2020-06-19 17:00:42+03:00,['77b5af4ae591f15f00807c3a939f78393d32d034'],5,433,438,34176678,10,0.550295858,0.911242604,1,32168
24dbed27b97f4c82835273758f0bceb3334b4ef2,0,GitHub,2020-06-30 18:55:00+03:00,['a42d52f7999592c96f67ad114d27f7b8a2a92e66'],61,132,193,34176871,49,1,0,0.818181818,32168
8e663b2679d7cd44615ecf44fe349e1eb93a4f43,0,liusheng,2021-03-11 16:46:56+08:00,['24dbed27b97f4c82835273758f0bceb3334b4ef2'],2,2,4,34176875,1,,,,32168
33e93671568fdc76d6103ef60006a45965534aa7,0,GitHub,2021-11-16 13:06:39+01:00,['24dbed27b97f4c82835273758f0bceb3334b4ef2'],0,56,56,34176931,1,,,,32168
6c0aa136db32695583ce4df0ebd6f83539b7fa1b,0,GitHub,2021-11-16 15:49:51+01:00,['33e93671568fdc76d6103ef60006a45965534aa7'],37,99,136,34177067,4,,,,32168
