sha,is_bug,committer_name,commit_time,parents,all_del,all_add,all_change_lines,all_lines,files_change_nums,dmm_unit_size,dmm_unit_complexity,dmm_unit_interfacing,file_nums
a4f5145540d4133e8327c449453fe3d75b6f1f8f,0,Arun C. Murthy,2014-11-19 23:08:27-08:00,[],0,201,201,201,1,,,,1
1a3dc0e263702288d1c07117617b8318e9720beb,1,Harish Butani,2014-12-07 09:06:20-08:00,['a4f5145540d4133e8327c449453fe3d75b6f1f8f'],0,2408,2408,2609,29,0.480035492,0.63797693,0.856255546,30
c8aabc11f13e2225334b0022efe5e198615dc285,1,Venkatesh Seetharam,2014-12-08 11:54:51-08:00,['a4f5145540d4133e8327c449453fe3d75b6f1f8f'],0,4642,4642,7251,73,0.684719536,0.883945841,0.905222437,103
e1df983cac89e612db7192a718cc819816bf95b1,1,Harish Butani,2014-12-08 12:13:26-08:00,['1a3dc0e263702288d1c07117617b8318e9720beb'],307,385,692,7943,13,0.065217391,0.913043478,0.043478261,106
52460fa99bbd5b40dd2718ee1b20fde6584b21aa,0,Harish Butani,2014-12-08 12:27:32-08:00,['e1df983cac89e612db7192a718cc819816bf95b1'],9,495,504,8447,28,,,,106
7a33946d5c3f13eaefca2dbf66aa3739ea602229,1,Harish Butani,2014-12-09 19:44:38-08:00,['52460fa99bbd5b40dd2718ee1b20fde6584b21aa'],29,848,877,9324,11,0.367816092,0.51954023,0.885057471,112
4c1f4c8f97e04ca9bfa00c361f86ed568f443e92,1,Harish Butani,2014-12-10 17:24:36-08:00,['7a33946d5c3f13eaefca2dbf66aa3739ea602229'],407,718,1125,10449,19,0.964285714,0.964285714,0.482142857,120
4128b89eb1e1f48cc3b1e50241b2a131548bc795,0,Harish Butani,2014-12-10 19:05:27-08:00,['4c1f4c8f97e04ca9bfa00c361f86ed568f443e92'],31,103,134,10583,5,0,1,1,120
5273b41f502ea19b9b049e190810e46cd3f4ac13,0,Venkatesh Seetharam,2014-12-11 11:32:31-08:00,['c8aabc11f13e2225334b0022efe5e198615dc285'],57,151,208,10791,6,0.349206349,1,0.857142857,121
040ee99cb74645fc570747c68c22c91a91358d83,1,Harish Butani,2014-12-11 18:45:47-08:00,['4128b89eb1e1f48cc3b1e50241b2a131548bc795'],66,616,682,11473,26,0.399350649,0.61038961,0.727272727,125
8936008d41a09cb9f9d665fb00e61b9f3a065651,0,Venkatesh Seetharam,2014-12-11 20:01:56-08:00,['5273b41f502ea19b9b049e190810e46cd3f4ac13'],127,31,158,11631,5,0.612903226,0,0.35483871,125
5279a71cc0b4baa145b7896fe90edf1b26bcf1c8,0,Venkatesh Seetharam,2014-12-11 21:17:32-08:00,['8936008d41a09cb9f9d665fb00e61b9f3a065651'],12,432,444,12075,9,0.895348837,1,1,131
b8feeebf7a191601d05fd2a44961f230fc47b5eb,1,Harish Butani,2014-12-12 12:36:29-08:00,['040ee99cb74645fc570747c68c22c91a91358d83'],226,353,579,12654,10,0.486238532,1,0.926605505,132
37ec473dd22b2f945183c034ab96183cece49b32,1,Harish Butani,2014-12-12 14:24:42-08:00,['b8feeebf7a191601d05fd2a44961f230fc47b5eb'],33,112,145,12799,3,0.119402985,0.746268657,1,132
f09a14be116ed1a1e7320d0424baa4e97b91a993,1,Harish Butani,2014-12-12 19:31:09-08:00,['37ec473dd22b2f945183c034ab96183cece49b32'],151,262,413,13212,10,0.627906977,0.813953488,0.872093023,132
71ac0a94ece496b07d7f5600f8c1677df8618e29,1,Venkatesh Seetharam,2014-12-15 23:24:01-08:00,['5279a71cc0b4baa145b7896fe90edf1b26bcf1c8'],117,344,461,13673,16,0.787878788,1,1,136
978acb672d22592c664a982c9f60b1bed8b34284,0,Dennis,2014-12-16 14:19:59-05:00,['f09a14be116ed1a1e7320d0424baa4e97b91a993'],0,306,306,13979,8,0.260869565,1,1,143
806b9aed7e89708412cba246553d199439642205,0,Dan Markwat,2014-12-16 14:30:43-05:00,['71ac0a94ece496b07d7f5600f8c1677df8618e29'],275,271,546,14525,2,,,,143
2d335d555ee950f1725c4948c66fa87aca802ffd,0,Harish Butani,2014-12-16 14:12:59-08:00,['978acb672d22592c664a982c9f60b1bed8b34284'],0,282,282,14807,2,,,,145
d3e60d7148e583e310b69415161e657fa84143d9,1,Harish Butani,2014-12-16 14:12:59-08:00,['2d335d555ee950f1725c4948c66fa87aca802ffd'],126,541,667,15474,15,0.68902439,1,1,150
ec4e5b67adfcbc613ab33eb23b5252dfa776c3f2,0,Harish Butani,2014-12-16 14:16:30-08:00,['d3e60d7148e583e310b69415161e657fa84143d9'],0,7,7,15481,1,,,,150
14281eea1d8a409c74a2ce41a51b3d375ba7f3f3,0,Harish Butani,2014-12-16 14:31:50-08:00,['ec4e5b67adfcbc613ab33eb23b5252dfa776c3f2'],4,1,5,15486,1,,,,150
232a95c6465a0003d482563c971b8346f683cde0,1,Harish Butani,2014-12-17 09:09:26-08:00,['14281eea1d8a409c74a2ce41a51b3d375ba7f3f3'],11,466,477,15963,8,0.360424028,0.416961131,0.71024735,153
e05c8845b67b782806730c47bc2bfbff986df16e,0,Harish Butani,2014-12-17 13:33:40-08:00,['232a95c6465a0003d482563c971b8346f683cde0'],26,367,393,16356,13,0.141975309,0.141975309,0.654320988,154
4d6019076c91b0922410bfdafa238fd4115bec10,0,Harish Butani,2014-12-18 11:36:37-08:00,['e05c8845b67b782806730c47bc2bfbff986df16e'],59,238,297,16653,4,0.47761194,0.492537313,1,154
745db5cba5d63053ea4415da61c6c73a81ac9806,0,Harish Butani,2014-12-18 13:58:20-08:00,['4d6019076c91b0922410bfdafa238fd4115bec10'],0,0,0,16653,68,,,,154
6d1cb9821a1ba58dac6ac673428764caa172e3cd,0,Harish Butani,2014-12-18 13:59:21-08:00,"['745db5cba5d63053ea4415da61c6c73a81ac9806', '806b9aed7e89708412cba246553d199439642205']",0,5283,5283,21936,83,,,,154
34941a4f55f975f2548414699189d3bf492caa2d,0,Harish Butani,2014-12-18 14:58:35-08:00,['6d1cb9821a1ba58dac6ac673428764caa172e3cd'],82,28,110,22046,2,,,,154
4139050e2bd02f9a16c69422c3b8c72a76c7ca71,0,Dan Markwat,2014-12-19 09:21:53-05:00,['34941a4f55f975f2548414699189d3bf492caa2d'],0,15,15,22061,4,,,,154
77030a8c5a2d163b4c3f6f2028d5f1f8aa2c2add,0,Harish Butani,2014-12-19 09:31:47-08:00,['4139050e2bd02f9a16c69422c3b8c72a76c7ca71'],243,303,546,22607,63,,,,155
0a208d18895103e434d7059921fb9d66ed6d6b83,0,Harish Butani,2014-12-19 09:55:45-08:00,['77030a8c5a2d163b4c3f6f2028d5f1f8aa2c2add'],2,148,150,22757,2,0.178571429,1,1,156
6c00ad96958046b505e865b8b99fc5451618e16d,1,Harish Butani,2014-12-22 14:04:00-08:00,['0a208d18895103e434d7059921fb9d66ed6d6b83'],27,1055,1082,23839,6,0.702432046,0.954220315,0.772532189,156
bf00ea9141f018831d516684ddf53978184fe3e9,0,Harish Butani,2014-12-22 20:27:12-08:00,['6c00ad96958046b505e865b8b99fc5451618e16d'],28,166,194,24033,5,1,0.952380952,0.702380952,156
2810310f2c4d7752fbb37a83b274726a39ca5ed2,1,Harish Butani,2014-12-22 21:21:08-08:00,['bf00ea9141f018831d516684ddf53978184fe3e9'],65,236,301,24334,8,0.398148148,0.722222222,0.888888889,157
546efae9625889c67293a3759ccc5156df6ffd63,0,Harish Butani,2014-12-23 12:29:28-08:00,['2810310f2c4d7752fbb37a83b274726a39ca5ed2'],37,57,94,24428,7,0.5,0.65,0.9,157
82209db0f4d9b8f711f24be35b9ff34eb9367fdf,0,Harish Butani,2014-12-23 13:02:27-08:00,['546efae9625889c67293a3759ccc5156df6ffd63'],11,113,124,24552,4,0.971428571,0.971428571,1,159
9cdc25eefacd64f63e1a8190e1db5c23582e594c,0,a760104,2014-12-23 23:08:54-05:00,['82209db0f4d9b8f711f24be35b9ff34eb9367fdf'],0,1078,1078,25630,9,0.389587074,0.452423698,0.771992819,167
7dc5d3f0cd8ac47a2086c49fe589c18085feecf0,0,gss2002,2014-12-23 23:16:32-05:00,['9cdc25eefacd64f63e1a8190e1db5c23582e594c'],6,0,6,25636,1,,,,167
1bb33f9724394552432b2ef8e716b658cedc68a1,0,gss2002,2014-12-23 23:25:29-05:00,['7dc5d3f0cd8ac47a2086c49fe589c18085feecf0'],6,0,6,25642,1,,,,167
0c46cbad4f524114b6dcea7bb0795870602a2d6e,0,gss2002,2014-12-23 23:25:47-05:00,['1bb33f9724394552432b2ef8e716b658cedc68a1'],6,0,6,25648,1,,,,167
b5bd9d1aa1db5ac9b582468f8bd3f4fa2ca80285,0,Harish Butani,2014-12-26 12:06:03-08:00,['0c46cbad4f524114b6dcea7bb0795870602a2d6e'],10,352,362,26010,10,0.474789916,0.68907563,0.798319328,168
733101c8046db808873f483835b09daf8618feb2,1,Harish Butani,2014-12-26 16:31:55-08:00,['b5bd9d1aa1db5ac9b582468f8bd3f4fa2ca80285'],2,436,438,26448,10,0.172638436,0.86970684,0.960912052,171
3fe82d569651c95e21d069c267c67448bbce916a,0,Christopher Hyzer,2014-12-28 16:16:36-05:00,['733101c8046db808873f483835b09daf8618feb2'],0,51,51,26499,1,0,1,1,171
de47ef0217f8aae7676385f2b0f7011f10e14669,0,Christopher Hyzer,2014-12-28 19:20:23-05:00,['3fe82d569651c95e21d069c267c67448bbce916a'],0,3,3,26502,1,0,1,1,171
16cd0767cbb7821348fceca942b837fd74f98fc6,0,Harish Butani,2014-12-29 21:10:00-08:00,['de47ef0217f8aae7676385f2b0f7011f10e14669'],0,2192,2192,28694,4,0.835051546,0.855670103,1,175
f98781732d235f639c2e689bdecf7cdb40a31273,0,Christopher Hyzer,2014-12-30 10:24:47-05:00,['de47ef0217f8aae7676385f2b0f7011f10e14669'],2,2,4,28698,1,,,,175
b06c7fe991136dc296abdf8eb6ca23b19ba4cdc4,0,Christopher Hyzer,2014-12-30 10:31:17-05:00,['f98781732d235f639c2e689bdecf7cdb40a31273'],0,1,1,28699,1,,,,175
c28f14942087e933ba84b6af7e8133e4c1917bc3,0,Christopher Hyzer,2014-12-30 10:33:00-05:00,['b06c7fe991136dc296abdf8eb6ca23b19ba4cdc4'],1,0,1,28700,1,,,,175
cbecec830ca474e40eb85403955337a890a5a031,0,Christopher Hyzer,2014-12-30 10:34:12-05:00,"['c28f14942087e933ba84b6af7e8133e4c1917bc3', '16cd0767cbb7821348fceca942b837fd74f98fc6']",0,2192,2192,30892,4,,,,175
b8eecb202363ddbdac38e5f5bf1535297188bb24,0,Harish Butani,2014-12-30 16:28:22-08:00,['cbecec830ca474e40eb85403955337a890a5a031'],90,671,761,31653,4,1,1,1,175
f8356cb5b095aed1180f3f7bba42d96f860b20a8,0,Harish Butani,2014-12-30 17:37:05-08:00,['b8eecb202363ddbdac38e5f5bf1535297188bb24'],395,658,1053,32706,2,1,1,1,175
1143f69df5bd1ca2ac24175644cd4e044d1e9014,0,Dan Markwat,2015-01-02 14:07:15-05:00,['f8356cb5b095aed1180f3f7bba42d96f860b20a8'],41,171,212,32918,4,0.926829268,1,1,178
112dffb023693252f6a9c342a57616602fae2de9,0,Harish Butani,2015-01-02 15:19:22-08:00,['1143f69df5bd1ca2ac24175644cd4e044d1e9014'],10,583,593,33511,8,0.911894273,0.744493392,0.969162996,181
d14e0e10ef7876179689450ef6106c97540a971d,0,Dennis Fusaro,2015-01-05 10:43:50-05:00,['112dffb023693252f6a9c342a57616602fae2de9'],0,11,11,33522,3,,,,183
b8308a31ee67b567644d469d3b8e359b878b0a34,0,Dennis Fusaro,2015-01-05 11:43:16-05:00,['d14e0e10ef7876179689450ef6106c97540a971d'],1,19,20,33542,7,,,,183
98d436c214e599f1bdd6c0c3b51f8244a119f6fc,0,Dennis Fusaro,2015-01-05 13:02:23-05:00,['b8308a31ee67b567644d469d3b8e359b878b0a34'],300,41,341,33883,12,0.85,0,0,187
7f08d5549441d5d135530ff2a9befbb2d89be205,0,Dan Markwat,2015-01-05 13:56:56-05:00,['b8308a31ee67b567644d469d3b8e359b878b0a34'],42,0,42,33925,1,0,0,0,187
003b5a52e14b237d6ce13d53c8f3f1f0795f45e1,0,Harish Butani,2015-01-05 12:51:36-08:00,['7f08d5549441d5d135530ff2a9befbb2d89be205'],11,888,899,34824,6,1,1,1,191
c1995379fb6905d3c1bd4bc0179775e68cb3c917,0,Harish Butani,2015-01-05 17:30:10-08:00,['003b5a52e14b237d6ce13d53c8f3f1f0795f45e1'],121,276,397,35221,8,0,0,1,193
d1335fc9f9fb85462d5111e46c0deafefdadc992,0,A195882,2015-01-06 11:54:22-05:00,['c1995379fb6905d3c1bd4bc0179775e68cb3c917'],53,116,169,35390,2,0.555555556,0,1,194
21197b678f3be35c2228c12b814b8f2fbc9a9780,0,a760104,2015-01-06 12:13:42-05:00,['b8308a31ee67b567644d469d3b8e359b878b0a34'],10,115,125,35515,2,0.275862069,0.275862069,1,194
d12cca6d04007c7f91aa457149dba3acb962b640,0,a760104,2015-01-06 12:14:03-05:00,"['21197b678f3be35c2228c12b814b8f2fbc9a9780', 'd1335fc9f9fb85462d5111e46c0deafefdadc992']",138,1191,1329,36844,13,,,,194
b9cae771802d84b8fa41e3f823848f19e947d529,0,Dennis Fusaro,2015-01-06 13:02:46-05:00,['98d436c214e599f1bdd6c0c3b51f8244a119f6fc'],2,290,292,37136,7,0.190751445,0.74566474,0.878612717,198
1643827eb003ac199cf0bb4e525e039abffc50e3,0,Dennis Fusaro,2015-01-06 13:03:40-05:00,"['b9cae771802d84b8fa41e3f823848f19e947d529', 'd1335fc9f9fb85462d5111e46c0deafefdadc992']",138,1191,1329,38465,13,,,,198
82aa80c04445f8abefa12a6adaf0eead74381585,0,a760104,2015-01-06 13:13:58-05:00,"['d12cca6d04007c7f91aa457149dba3acb962b640', '1643827eb003ac199cf0bb4e525e039abffc50e3']",300,329,629,39094,16,,,,198
ba14612a2dfc66087d7febeed616b28444106dcd,0,a760104,2015-01-06 13:25:34-05:00,['82aa80c04445f8abefa12a6adaf0eead74381585'],0,3,3,39097,3,,,,198
13aa58b66d596587ced3efde6132e2c0ba0f89dc,0,gss2002,2015-01-06 13:51:32-05:00,['ba14612a2dfc66087d7febeed616b28444106dcd'],8,1,9,39106,1,1,1,0,198
798860f4dc2f539974587008a2ed0c640a6d4891,0,Dan Markwat,2015-01-06 13:58:20-05:00,['13aa58b66d596587ced3efde6132e2c0ba0f89dc'],0,0,0,39106,1,,,,198
a3ac80fefaf517625ae37fff8329c5a69c163575,0,Dan Markwat,2015-01-06 14:36:44-05:00,['798860f4dc2f539974587008a2ed0c640a6d4891'],0,1,1,39107,1,,,,198
3291e928450b96e72392967b0fc6b06aaff557e5,0,Dan Markwat,2015-01-06 14:42:30-05:00,['a3ac80fefaf517625ae37fff8329c5a69c163575'],0,0,0,39107,1,,,,198
385adc5f892ef33813597452eacc15b5b3ff6fcc,1,Harish Butani,2015-01-06 17:48:09-05:00,['3291e928450b96e72392967b0fc6b06aaff557e5'],12,25,37,39144,7,1,1,0,198
46e6d18dd45cc2802001cd163d788d3b2f58dd25,0,Dan Markwat,2015-01-07 10:54:10-05:00,['385adc5f892ef33813597452eacc15b5b3ff6fcc'],0,62,62,39206,1,,,,199
959bb8087fb1cf14bdb429e9f1fa81c309a54ab8,0,Harish Butani,2015-01-07 08:48:15-08:00,['46e6d18dd45cc2802001cd163d788d3b2f58dd25'],8,30,38,39244,4,,,,200
0afaaa5eb8404051ff7b41efd1e72b67b110f06d,0,Dan Markwat,2015-01-07 11:53:22-05:00,['46e6d18dd45cc2802001cd163d788d3b2f58dd25'],17,41,58,39302,1,0,0,0,200
402e36803228a2c88abde3a4cdf9478904eb0f6c,0,Dan Markwat,2015-01-07 11:53:40-05:00,"['0afaaa5eb8404051ff7b41efd1e72b67b110f06d', '959bb8087fb1cf14bdb429e9f1fa81c309a54ab8']",8,30,38,39340,4,,,,200
34e7f58ac4bfe2454603d477778fabc9da8f32d0,0,Harish Butani,2015-01-08 17:36:59-08:00,['402e36803228a2c88abde3a4cdf9478904eb0f6c'],0,323,323,39663,2,0.470588235,0.539215686,1,201
e0423116dd67d2d417a17d8acfa9b3289341521f,0,Dan Markwat,2015-01-09 11:56:08-05:00,['402e36803228a2c88abde3a4cdf9478904eb0f6c'],130,0,130,39793,2,0.698630137,0,0,201
3c3507801dacf8096fe1fab5adf1d29da63f6d99,0,Harish Butani,2015-01-09 10:56:51-08:00,['34e7f58ac4bfe2454603d477778fabc9da8f32d0'],13,28,41,39834,3,0.785714286,0.785714286,0.785714286,201
639671ca5def707ea40539b0fc3c91480a87871f,1,Venkatesh Seetharam,2015-01-09 11:25:30-08:00,['3c3507801dacf8096fe1fab5adf1d29da63f6d99'],98,1034,1132,40966,21,0.374005305,0.74270557,0.644562334,206
7b20569753a425a33c272a8d5ac566e42f481869,0,Harish Butani,2015-01-09 12:17:31-08:00,['639671ca5def707ea40539b0fc3c91480a87871f'],4,4,8,40974,1,,,,206
c1af145602d97c724645f69a6d64dbbf11532f57,1,Dan Markwat,2015-01-09 16:06:28-05:00,['e0423116dd67d2d417a17d8acfa9b3289341521f'],510,936,1446,42420,27,0.714285714,0.89010989,0.802197802,220
36e8243a1710adbcd1f51d009499715ac8c4376a,0,Harish Butani,2015-01-09 14:22:09-08:00,['7b20569753a425a33c272a8d5ac566e42f481869'],1,39,40,42460,2,1,1,1,220
fb2207c0ee46f343bb553b7372dd8aff63025cb2,0,Harish Butani,2015-01-09 17:21:03-08:00,['36e8243a1710adbcd1f51d009499715ac8c4376a'],0,4,4,42464,1,1,1,1,220
935d30f7321a5a86b17348d09b10e32599357686,1,Dan Markwat,2015-01-11 15:53:09-05:00,['c1af145602d97c724645f69a6d64dbbf11532f57'],11,26,37,42501,2,0,1,1,220
e3073d897b7536709a07e90eb05c302ecf00db9a,0,Dan Markwat,2015-01-11 18:49:26-05:00,['935d30f7321a5a86b17348d09b10e32599357686'],16,2,18,42519,1,,,,220
5db2e582b56d66ae58b5f0541498c0f839031dad,0,Dan Markwat,2015-01-11 18:50:32-05:00,['e3073d897b7536709a07e90eb05c302ecf00db9a'],16,2,18,42537,1,,,,220
a56bf342f8c76db5ae9076b642e9c4c578eedc42,0,Dan Markwat,2015-01-11 18:51:45-05:00,['5db2e582b56d66ae58b5f0541498c0f839031dad'],4,4,8,42545,3,,,,220
caac858f4218a9b2c3e9e742c3dd2ff5268eb233,1,Dan Markwat,2015-01-11 18:56:33-05:00,['a56bf342f8c76db5ae9076b642e9c4c578eedc42'],638,108,746,43291,18,0.106741573,0,0,220
faf0b48b3b33f78b86fd9cbe4edf7e173d89e81a,0,A744013,2015-01-12 09:24:37-05:00,['fb2207c0ee46f343bb553b7372dd8aff63025cb2'],19,19,38,43329,5,,,,220
96350bdabe43867bc7a76d215ef7dd3865eee78d,0,A744013,2015-01-12 09:29:14-05:00,['caac858f4218a9b2c3e9e742c3dd2ff5268eb233'],1,1,2,43331,1,,,,220
34cdef44d8e58bc646f6ce97469d0a8e5c7f6732,1,Dan Markwat,2015-01-12 12:22:39-05:00,"['faf0b48b3b33f78b86fd9cbe4edf7e173d89e81a', '96350bdabe43867bc7a76d215ef7dd3865eee78d']",2742,2369,5111,48442,54,,,,220
42dee9f32a961730aedd42af149ad3928f400a47,0,a760104,2015-01-12 20:27:48-05:00,['34cdef44d8e58bc646f6ce97469d0a8e5c7f6732'],10,10,20,48462,3,,,,220
29d3299db147d5c72a8316daa7cc9ff1ad3bcee7,0,Harish Butani,2015-01-13 18:40:19-08:00,['42dee9f32a961730aedd42af149ad3928f400a47'],0,104,104,48566,3,,,,223
255fa079e138602cdc5ea63395de106a5d76cc17,1,Venkatesh Seetharam,2015-01-14 14:02:12-08:00,['29d3299db147d5c72a8316daa7cc9ff1ad3bcee7'],155,507,662,49228,19,0.373134328,1,1,226
ed517933752e98e2aeb906de300ab601a32e41f5,1,Venkatesh Seetharam,2015-01-14 14:47:55-08:00,['255fa079e138602cdc5ea63395de106a5d76cc17'],3,43,46,49274,1,0.258064516,1,1,226
0ed96321b2c1acf21bde8d9fe1b626dd84af5a72,1,Venkatesh Seetharam,2015-01-14 14:48:13-08:00,['ed517933752e98e2aeb906de300ab601a32e41f5'],3,9,12,49286,1,0,1,1,226
cd448abe9da7520776c5ccecb000b29e60cc7113,1,Venkatesh Seetharam,2015-01-14 14:57:57-08:00,['0ed96321b2c1acf21bde8d9fe1b626dd84af5a72'],1,18,19,49305,1,1,1,1,226
e3a2173c9ea40f0b6e7bfb1b6f99d5b5b4b851df,0,Venkat Ranganathan,2015-01-14 15:22:07-08:00,['cd448abe9da7520776c5ccecb000b29e60cc7113'],1,1,2,49307,1,,,,226
b1b89a3cb0a0fdf8d50aabb81586a5d17ceb6094,0,Dan Markwat,2015-01-15 11:47:33-05:00,['e3a2173c9ea40f0b6e7bfb1b6f99d5b5b4b851df'],13,82,95,49402,17,,,,230
0c54f27e9d3bc2cecc8e3293616d210531452e7b,0,A744013,2015-01-15 12:00:50-05:00,['b1b89a3cb0a0fdf8d50aabb81586a5d17ceb6094'],4,2,6,49408,1,,,,230
bcfd2e7b381412436c3992b5ac111aa79236b7b3,1,Venkatesh Seetharam,2015-01-15 14:59:44-08:00,['0c54f27e9d3bc2cecc8e3293616d210531452e7b'],85,136,221,49629,21,1,0,1,230
3d274303cac9baa211b0036ef269924f77158bde,0,Venkatesh Seetharam,2015-01-15 19:57:21-08:00,['bcfd2e7b381412436c3992b5ac111aa79236b7b3'],5,15,20,49649,4,,,,231
ce7d8e79a05b4dab04860528ceaf4946bfad0af8,0,A744013,2015-01-16 11:10:25-05:00,['0c54f27e9d3bc2cecc8e3293616d210531452e7b'],24,76,100,49749,4,0.151515152,1,1,232
f16be50f3a05d60144f3c2eb2a954ce4d429d22b,0,A744013,2015-01-16 11:10:47-05:00,"['ce7d8e79a05b4dab04860528ceaf4946bfad0af8', '3d274303cac9baa211b0036ef269924f77158bde']",90,151,241,49990,25,,,,232
3b68cbdaadc8900ccc9aa061bd9baa193150b6cf,0,Harish Butani,2015-01-16 13:16:19-08:00,['f16be50f3a05d60144f3c2eb2a954ce4d429d22b'],0,5,5,49995,1,1,1,1,232
76fcba1a59223f762eddab9d722f369949e9be17,0,Harish Butani,2015-01-16 14:58:17-08:00,['3b68cbdaadc8900ccc9aa061bd9baa193150b6cf'],14,14,28,50023,2,,,,232
8285e3b99319394675038b753745c0fcd9cf05fd,0,Harish Butani,2015-01-16 15:28:33-08:00,['76fcba1a59223f762eddab9d722f369949e9be17'],141,174,315,50338,19,0.314285714,1,1,233
386d8d3862c7275ae26c82b1bdf3835b49389ca1,1,Venkatesh Seetharam,2015-01-16 22:47:17-08:00,['8285e3b99319394675038b753745c0fcd9cf05fd'],300,564,864,51202,8,0.16751269,0.482233503,0.47715736,233
ea38da100488af30296212dbd9b0dfa603f2aa23,1,Venkatesh Seetharam,2015-01-17 00:46:07-08:00,['386d8d3862c7275ae26c82b1bdf3835b49389ca1'],200,307,507,51709,23,0,0.666666667,0.708333333,236
1d1531ef67885da8f168f67bc1fb3576de11820c,0,Harish Butani,2015-01-19 13:50:46-08:00,['ea38da100488af30296212dbd9b0dfa603f2aa23'],0,89,89,51798,3,0.176470588,0.176470588,1,236
be7c4cb6a024cd159a611cd74d79a75fc411644a,0,Venkatesh Seetharam,2015-01-19 22:17:31-08:00,['1d1531ef67885da8f168f67bc1fb3576de11820c'],165,268,433,52231,3,0,1,0.236842105,236
7da5e03f87a848303dd332784386d816d6159820,1,Venkatesh Seetharam,2015-01-19 23:17:31-08:00,['be7c4cb6a024cd159a611cd74d79a75fc411644a'],48,141,189,52420,6,0.523809524,1,0.777777778,236
6e506d7316bcc04cdcab04f20e40323bc3675399,0,Dan Markwat,2015-01-20 13:36:53-05:00,['7da5e03f87a848303dd332784386d816d6159820'],0,0,0,52420,2,,,,236
898e73178b025cbb5ffe7fa42a638b113514a7e9,0,Venkat,2015-01-21 09:33:15-08:00,['6e506d7316bcc04cdcab04f20e40323bc3675399'],1,1244,1245,53665,8,0.386694387,0.869022869,0.96049896,242
760b3b9666a8f4ba00613864543fb4bcdee31145,0,Venkat,2015-01-21 09:40:40-08:00,['898e73178b025cbb5ffe7fa42a638b113514a7e9'],542,542,1084,54749,2,,,,242
1f7fe9415cf06f79fb2866c40f96f2043c8df3a5,1,Venkatesh Seetharam,2015-01-21 11:17:51-08:00,['760b3b9666a8f4ba00613864543fb4bcdee31145'],26,196,222,54971,10,0.272727273,1,1,244
882c40fa6a08260285919b1cfd15eb61bfd9ef13,0,Harish Butani,2015-01-21 11:54:09-08:00,['1f7fe9415cf06f79fb2866c40f96f2043c8df3a5'],5,6,11,54982,2,1,,,244
61079cac67247d56c9ac90fc04d9804d72f07049,1,Venkatesh Seetharam,2015-01-21 16:02:41-08:00,['882c40fa6a08260285919b1cfd15eb61bfd9ef13'],151,375,526,55508,14,,,,249
d3db08d22514b91df4318f54683549ce5aea2151,0,Venkat Ranganathan,2015-01-21 17:52:30-08:00,['61079cac67247d56c9ac90fc04d9804d72f07049'],14,51,65,55573,4,0.107142857,1,0.892857143,249
f5c4dc4cb926a47fdcf2cfdb3d4c06a8168da4b8,1,Venkatesh Seetharam,2015-01-21 17:55:47-08:00,['d3db08d22514b91df4318f54683549ce5aea2151'],2,336,338,55911,3,0.614379085,1,0.777777778,251
e0699c8f560f68871827193bbfe36f555a23d36a,0,Venkat Ranganathan,2015-01-21 19:51:57-08:00,['f5c4dc4cb926a47fdcf2cfdb3d4c06a8168da4b8'],1,6,7,55918,2,0,0.666666667,1,251
0e9af0174d2aeaa2a1c6b4c94a6b7db1032a1201,0,Harish Butani,2015-01-22 11:06:14-08:00,['e0699c8f560f68871827193bbfe36f555a23d36a'],2,2,4,55922,1,,,,251
4266430110364d772328f255090c355f78b3e93b,1,Vishal Kadam,2015-01-22 23:41:15-05:00,[],0,664,664,56586,27,0.536290323,0.943548387,0.870967742,278
ec724d2c3a02ca42403a3e244fe69b70bd9367a8,1,Vishal Kadam,2015-01-23 00:23:23-05:00,['4266430110364d772328f255090c355f78b3e93b'],0,0,0,56586,1,,,,278
20a27148ac08d95706702d3b43c7f6698caf3e30,1,Vishal Kadam,2015-01-23 00:34:33-05:00,['ec724d2c3a02ca42403a3e244fe69b70bd9367a8'],1,12,13,56599,3,0,1,1,278
2d27fa85fb91ef136d404373d1c7b245c94cf923,1,Vishal Kadam,2015-01-23 00:47:54-05:00,['20a27148ac08d95706702d3b43c7f6698caf3e30'],2,7,9,56608,1,,,,278
1089e0363ad330a5273b53db1038b506b1f07d22,0,Venkat Ranganathan,2015-01-22 22:04:07-08:00,['0e9af0174d2aeaa2a1c6b4c94a6b7db1032a1201'],62,261,323,56931,11,0.436619718,1,0.971830986,281
54ccb87fb2e66d2454ea5314aa74191dbb80f31e,0,Dan Markwat,2015-01-23 10:40:32-05:00,['1089e0363ad330a5273b53db1038b506b1f07d22'],36,274,310,57241,7,1,1,1,285
bc7bf44afe8d98e93228a4a8419067bc7d08c781,0,Dan Markwat,2015-01-23 11:03:26-05:00,['54ccb87fb2e66d2454ea5314aa74191dbb80f31e'],5,13,18,57259,5,,,,286
04997e4c3081232cc620a2690437b4a2350b7381,0,Ballistar13,2015-01-23 12:18:10-05:00,['e0699c8f560f68871827193bbfe36f555a23d36a'],35,296,331,57590,13,0.782051282,0.782051282,1,292
555960a5e46e03b1375d5a24787e9238c594ba48,0,Ballistar13,2015-01-23 12:43:02-05:00,"['04997e4c3081232cc620a2690437b4a2350b7381', 'bc7bf44afe8d98e93228a4a8419067bc7d08c781']",162,518,680,58270,24,,,,292
2bd124a01396d3a6de6cf581005a61d940b9c700,0,Ballistar13,2015-01-23 13:02:29-05:00,['555960a5e46e03b1375d5a24787e9238c594ba48'],20,360,380,58650,10,1,1,1,293
0f4abad7f3ce12929082a7af1caefc02af0d031a,0,Ballistar13,2015-01-23 13:03:10-05:00,['2bd124a01396d3a6de6cf581005a61d940b9c700'],4,0,4,58654,1,,,,293
f5eef50515c3fb2493df0da20acb33d69e5033cf,1,TJBChris,2015-01-23 14:10:51-05:00,['bc7bf44afe8d98e93228a4a8419067bc7d08c781'],4,253,257,58911,2,0.555555556,1,0.555555556,294
55febc443871bb101e5c47341e1a6d5628020d25,0,Ballistar13,2015-01-23 14:24:45-05:00,"['0f4abad7f3ce12929082a7af1caefc02af0d031a', 'f5eef50515c3fb2493df0da20acb33d69e5033cf']",4,253,257,59168,2,,,,294
cdb6c314bcdc8ab9891f0da9c42e39255224a30c,0,Dan Markwat,2015-01-23 15:02:01-05:00,['f5eef50515c3fb2493df0da20acb33d69e5033cf'],47,27,74,59242,5,0,0,0,294
9ec7ad376ce3675c9526af9e7e949dd1af6353cd,0,Dan Markwat,2015-01-23 15:11:08-05:00,['cdb6c314bcdc8ab9891f0da9c42e39255224a30c'],5,12,17,59259,2,,,,294
b0d8bb9048545ed8a4d343bf52fe953ba2b67894,0,Ballistar13,2015-01-23 15:41:57-05:00,"['55febc443871bb101e5c47341e1a6d5628020d25', '9ec7ad376ce3675c9526af9e7e949dd1af6353cd']",52,39,91,59350,5,,,,294
46667712854d4fbf6f2e397c548ba618a6f42940,0,TJBChris,2015-01-23 16:05:37-05:00,['f5eef50515c3fb2493df0da20acb33d69e5033cf'],3,3,6,59356,1,,,,294
b6d4e0941b76d9f0d0b6321398ccc6e765d370af,0,TJBChris,2015-01-23 16:06:37-05:00,"['46667712854d4fbf6f2e397c548ba618a6f42940', '9ec7ad376ce3675c9526af9e7e949dd1af6353cd']",52,39,91,59447,5,,,,294
adca9c0ca61b4bdd17bb8db6f77c780b7dc85759,0,Ballistar13,2015-01-23 20:31:04-05:00,"['b0d8bb9048545ed8a4d343bf52fe953ba2b67894', 'b6d4e0941b76d9f0d0b6321398ccc6e765d370af']",3,3,6,59453,1,,,,294
953ceabb498ba201f2683c8145e92a62127a8fb2,0,Ballistar13,2015-01-23 20:32:26-05:00,['adca9c0ca61b4bdd17bb8db6f77c780b7dc85759'],93,143,236,59689,15,0,1,1,298
15f6114077c34661c7f4f322da59c05557f421a9,1,Vishal Kadam,2015-01-24 03:01:18-05:00,['2d27fa85fb91ef136d404373d1c7b245c94cf923'],48,94,142,59831,13,1,1,1,304
6418f2c2f51d29b8e2d18574ed4b4e9fbdd7bc88,0,Venkatesh Seetharam,2015-01-24 14:00:16-08:00,['953ceabb498ba201f2683c8145e92a62127a8fb2'],1,8,9,59840,1,1,1,1,304
dde33712a1fce906b4a6094e3941f2955ae47850,1,Venkatesh Seetharam,2015-01-24 14:00:16-08:00,['6418f2c2f51d29b8e2d18574ed4b4e9fbdd7bc88'],2,23,25,59865,2,1,0.866666667,0.533333333,304
5ffad3285785d131a1d9b0d81ea982ce191e85b5,1,Venkatesh Seetharam,2015-01-24 14:10:05-08:00,['dde33712a1fce906b4a6094e3941f2955ae47850'],212,645,857,60722,19,0.474654378,0.917050691,0.866359447,306
a92298c5fb260b777f6108c8376f7f457fe358c7,0,Venkatesh Seetharam,2015-01-24 14:11:13-08:00,['5ffad3285785d131a1d9b0d81ea982ce191e85b5'],1,1,2,60724,1,0,0,0,306
9638120668c8875c11ec0bf28b01a439a2820c92,0,Venkatesh Seetharam,2015-01-24 14:28:26-08:00,['a92298c5fb260b777f6108c8376f7f457fe358c7'],72,63,135,60859,6,0,0,0,306
915b4ac6c527d77c85383af928b6bca058a89382,1,Vishal Kadam,2015-01-24 19:57:01-05:00,['15f6114077c34661c7f4f322da59c05557f421a9'],101,216,317,61176,23,0.737704918,0.967213115,0.754098361,314
22e8a75057c58e7accbb3e9aaa6dfb5ee22ad86a,0,TJBChris,2015-01-26 16:50:49-05:00,['9638120668c8875c11ec0bf28b01a439a2820c92'],14,93,107,61283,2,0.243902439,0.048780488,0.243902439,314
d8d9da299c4e0a91be90798ddd6e0457ef76ce84,0,Venkatesh Seetharam,2015-01-26 17:20:41-08:00,['22e8a75057c58e7accbb3e9aaa6dfb5ee22ad86a'],68,319,387,61670,3,0.015075377,0.64321608,0.366834171,314
dec14a89fc17f0d53a7f45bdc726eac92f0b14b1,0,TJBChris,2015-01-27 09:40:03-05:00,['d8d9da299c4e0a91be90798ddd6e0457ef76ce84'],17,20,37,61707,2,0,,0,314
7828bdf5e75e2fa50d4fcf547beb0ac81854eb82,0,TJBChris,2015-01-27 10:15:58-05:00,['dec14a89fc17f0d53a7f45bdc726eac92f0b14b1'],7,6,13,61720,2,0,1,0,314
c721804684333433427fb9e007fd5bd9afec72e7,0,Dan Markwat,2015-01-27 10:46:53-05:00,['d8d9da299c4e0a91be90798ddd6e0457ef76ce84'],16,21,37,61757,7,,,,314
d97a7236249897e1561687f6ecefdb17fa83bea2,0,Dan Markwat,2015-01-27 10:47:07-05:00,"['c721804684333433427fb9e007fd5bd9afec72e7', '7828bdf5e75e2fa50d4fcf547beb0ac81854eb82']",21,23,44,61801,2,,,,314
de243153c68abb6d3529a821fa00e4ce4191012a,0,Venkatesh Seetharam,2015-01-27 13:53:35-08:00,['d97a7236249897e1561687f6ecefdb17fa83bea2'],70,151,221,62022,1,0.26,1,0.02,314
c1e20f8d3cef0c1db413bdeb2338377959db7b4b,1,Venkatesh Seetharam,2015-01-27 15:16:38-08:00,['de243153c68abb6d3529a821fa00e4ce4191012a'],104,1094,1198,63220,91,,,,314
3ba61b9e7d7427068f766a4e6d5ee5bf82206778,0,Venkatesh Seetharam,2015-01-27 17:22:10-08:00,['c1e20f8d3cef0c1db413bdeb2338377959db7b4b'],6,3,9,63229,2,,,,314
ec8177bb70cba2000c2036f35dd24936e56e9cb2,0,TJBChris,2015-01-27 21:30:33-05:00,['c1e20f8d3cef0c1db413bdeb2338377959db7b4b'],134,189,323,63552,5,1,1,0,314
b3d8e037e9047ebb4b942368c03cf533b2429113,0,TJBChris,2015-01-27 21:32:28-05:00,"['ec8177bb70cba2000c2036f35dd24936e56e9cb2', '3ba61b9e7d7427068f766a4e6d5ee5bf82206778']",6,3,9,63561,2,,,,314
b10f93a22f387b7c9ae6337264696ccabaf06971,0,TJBChris,2015-01-27 21:37:57-05:00,['b3d8e037e9047ebb4b942368c03cf533b2429113'],14,14,28,63589,2,,,,314
0adfeb180fd35f7332d009cbf30a0041eba195f7,0,Venkat Ranganathan,2015-01-27 23:58:19-08:00,['b10f93a22f387b7c9ae6337264696ccabaf06971'],60,139,199,63788,6,0,0,0.75,314
2679dab3f02506f8e5116d54d970141516285ffc,0,TJBChris,2015-01-28 09:13:21-05:00,['0adfeb180fd35f7332d009cbf30a0041eba195f7'],1,29,30,63818,3,,,,314
2769809de7e6d6084bb9237b74f6d09ae1958160,0,TJBChris,2015-01-28 11:17:11-05:00,['2679dab3f02506f8e5116d54d970141516285ffc'],0,46,46,63864,1,,,,314
ee060fcccbb37d1500d1966ed0f6ca4913d4be89,0,Dan Markwat,2015-01-28 15:43:34-05:00,['2769809de7e6d6084bb9237b74f6d09ae1958160'],52,300,352,64216,11,0.529411765,1,1,317
7edf5221eb94f15a80d65418f940991b37f97de3,0,Venkat Ranganathan,2015-01-28 16:00:10-08:00,['ee060fcccbb37d1500d1966ed0f6ca4913d4be89'],3,91,94,64310,4,0.112676056,0,1,317
10e7dba68e8b2abec827c26e610d117166747ecc,0,Ballistar13,2015-01-29 09:40:55-05:00,['7edf5221eb94f15a80d65418f940991b37f97de3'],0,366,366,64676,1,0.295275591,0.874015748,0.720472441,318
83e593ad6119d7f4c5b795565e5b21c88698b7d2,0,Ballistar13,2015-01-29 11:16:13-05:00,['10e7dba68e8b2abec827c26e610d117166747ecc'],1,1,2,64678,1,,,,318
5ffae6ae5a621fa82b6388cd95a82246d1c5cc34,0,Dan Markwat,2015-01-29 11:45:17-05:00,['83e593ad6119d7f4c5b795565e5b21c88698b7d2'],3,9,12,64690,2,0.228571429,0,0,318
ebcb1392c3dab35664f6f9fe7725c76910b57426,0,Ballistar13,2015-01-29 11:54:13-05:00,['5ffae6ae5a621fa82b6388cd95a82246d1c5cc34'],1,2,3,64693,1,1,1,1,318
4978a9be90527096a1c4dc7ff188c1d8b63ce502,0,TJBChris,2015-01-29 13:37:31-05:00,['ebcb1392c3dab35664f6f9fe7725c76910b57426'],19,23,42,64735,5,,,,318
c4f8a6d9228bc06e06b08376f40687b1ba904f13,0,TJBChris,2015-01-29 13:48:21-05:00,['4978a9be90527096a1c4dc7ff188c1d8b63ce502'],2,2,4,64739,1,,,,318
657b74a40511bd79d526948598f2967f532279c8,0,Harish Butani,2015-01-29 11:28:10-08:00,['c4f8a6d9228bc06e06b08376f40687b1ba904f13'],0,354,354,65093,3,0.706666667,0.706666667,1,319
06ade6c4423e61f8a0e9211e086ba768e8079be3,0,Harish Butani,2015-01-29 11:30:53-08:00,['657b74a40511bd79d526948598f2967f532279c8'],0,1248,1248,66341,6,0.523255814,0.48255814,0.912790698,325
5b413d3da25f5d8554e981e3a86352dce79ef2c9,0,Harish Butani,2015-01-29 11:32:01-08:00,['06ade6c4423e61f8a0e9211e086ba768e8079be3'],0,19,19,66360,1,1,1,1,325
004301b29995e44713df4f1081c7322f5de99d5c,0,Ballistar13,2015-01-29 14:52:45-05:00,['c4f8a6d9228bc06e06b08376f40687b1ba904f13'],14,98,112,66472,2,1,0,0,326
9822e9c787c683c31c6179379c47f0a009998791,0,Ballistar13,2015-01-29 14:53:02-05:00,"['004301b29995e44713df4f1081c7322f5de99d5c', '5b413d3da25f5d8554e981e3a86352dce79ef2c9']",0,1621,1621,68093,10,,,,326
8cff958950109bcb8510f9c76ff4aa06335769a4,1,Venkatesh Seetharam,2015-01-29 11:59:26-08:00,['9822e9c787c683c31c6179379c47f0a009998791'],145,352,497,68590,11,0.276119403,0.537313433,0.470149254,328
b5539fc143f8e99af00683e2ec27939467f02a41,0,TJBChris,2015-01-29 15:09:34-05:00,['9822e9c787c683c31c6179379c47f0a009998791'],1,1,2,68592,1,,,,328
072aee8d870d26b86e6770d342e7f883165630e4,0,TJBChris,2015-01-29 15:10:40-05:00,"['b5539fc143f8e99af00683e2ec27939467f02a41', '8cff958950109bcb8510f9c76ff4aa06335769a4']",145,352,497,69089,11,,,,328
db6dffc9748d2016ec69c7da868625a41102ca45,0,Harish Butani,2015-01-29 13:01:18-08:00,['072aee8d870d26b86e6770d342e7f883165630e4'],7,69,76,69165,2,1,1,1,328
51d00a853b4c3b028b7baaab3370ed72c8bec4cc,0,Venkat Ranganathan,2015-01-29 13:12:26-08:00,['db6dffc9748d2016ec69c7da868625a41102ca45'],1,6,7,69172,2,,,,328
25ff452be1ea3e69b63394c1ac7387329ac55496,1,Venkatesh Seetharam,2015-01-29 17:29:31-08:00,['51d00a853b4c3b028b7baaab3370ed72c8bec4cc'],130,137,267,69439,6,1,0,0,328
f02580f0c71d4f02f12738d7eeac30ac22f62708,0,Harish Butani,2015-01-29 17:32:27-08:00,['25ff452be1ea3e69b63394c1ac7387329ac55496'],90,290,380,69819,7,1,1,1,332
ffed01af15393ec120033a31ed0532dae3305fac,1,Vishal Kadam,2015-01-30 00:51:18-05:00,['915b4ac6c527d77c85383af928b6bca058a89382'],31,38,69,69888,10,1,1,0.875,334
98d4baceb30d6b271c371a7a35d3b7a16d36d002,0,TJBChris,2015-01-30 16:24:30-05:00,['f02580f0c71d4f02f12738d7eeac30ac22f62708'],2,9,11,69899,2,0,1,0,334
b72cc325f4b53e6679e2ac570c92048471b40d3f,1,Vishal Kadam,2015-01-31 01:46:11-05:00,['ffed01af15393ec120033a31ed0532dae3305fac'],45,57,102,70001,10,1,0,0,334
7aece73b8daded697836c538733241efe2ec23c9,0,Harish Butani,2015-01-30 22:46:34-08:00,['98d4baceb30d6b271c371a7a35d3b7a16d36d002'],23,298,321,70322,7,0.488188976,0.409448819,1,334
de69ff95fa273cf745e26bef98d3e7ca059b1fc2,1,Vishal Kadam,2015-01-31 01:49:47-05:00,['b72cc325f4b53e6679e2ac570c92048471b40d3f'],5,5,10,70332,1,,,,334
91f6c78448bf8215e15835132afb1513b6fed757,1,Vishal Kadam,2015-01-31 14:59:38-05:00,['de69ff95fa273cf745e26bef98d3e7ca059b1fc2'],5,10,15,70347,2,0,1,1,334
b03dd70ad99af2d5c5907debd129cfa97ffbb0e9,0,Vishal Kadam,2015-01-31 15:01:23-05:00,['91f6c78448bf8215e15835132afb1513b6fed757'],1,2,3,70350,1,,,,334
31e21002a91d490a0bd98182cdc5c734f8f71aee,1,Vishal Kadam,2015-01-31 17:24:52-05:00,['b03dd70ad99af2d5c5907debd129cfa97ffbb0e9'],12,15,27,70377,7,1,1,0.75,335
adbcbd58a4ae869a2496402e487f52f8d03ba530,1,Vishal Kadam,2015-02-01 01:35:07-05:00,['31e21002a91d490a0bd98182cdc5c734f8f71aee'],7,172,179,70556,12,0.636363636,1,0.818181818,340
b08a3d91624c4635b7bd3619a4d0d01d74127b8e,0,Vishal Kadam,2015-02-02 00:05:04-05:00,['adbcbd58a4ae869a2496402e487f52f8d03ba530'],18,22,40,70596,9,1,1,1,340
cd6625a8f6a9f103efdfda12a8c3a59b1a8d71c1,1,Vishal Kadam,2015-02-02 01:25:24-05:00,['b08a3d91624c4635b7bd3619a4d0d01d74127b8e'],6,21,27,70623,3,0.916666667,1,1,340
189811684fc77a8f5332c08ca7609455316f6d96,0,TJBChris,2015-02-02 09:58:10-05:00,['7aece73b8daded697836c538733241efe2ec23c9'],0,73,73,70696,6,1,1,1,340
39c84bd68e729def17da7a4994e48f5bc0381291,1,Venkatesh Seetharam,2015-02-02 14:19:55-08:00,['189811684fc77a8f5332c08ca7609455316f6d96'],420,438,858,71554,6,1,0,1,342
a8ef4901f7f095c4425abfe16e8e7f8e26519cc1,0,Harish Butani,2015-02-02 15:09:09-08:00,['39c84bd68e729def17da7a4994e48f5bc0381291'],89,292,381,71935,6,0.512605042,0.638655462,0.470588235,343
b699d54d11ded07481d9d3e4466e294626932fbe,0,Vishal Kadam,2015-02-02 22:10:56-05:00,['cd6625a8f6a9f103efdfda12a8c3a59b1a8d71c1'],3,11,14,71949,1,0.777777778,1,0.888888889,343
92c4723980db71c761ac64bf7ccc086d7a6684a5,1,Vishal Kadam,2015-02-03 00:31:08-05:00,['b699d54d11ded07481d9d3e4466e294626932fbe'],8,64,72,72021,8,0.571428571,1,0.642857143,344
4301264e7298552a20135cb1da6993b984e6c088,0,Ballistar13,2015-02-03 16:51:42-05:00,['a8ef4901f7f095c4425abfe16e8e7f8e26519cc1'],23,75,98,72119,2,0.5,0,1,344
f0f2276583f7a9dac7d46fe4c6b0fc5e967181a4,1,Venkatesh Seetharam,2015-02-03 13:55:11-08:00,['4301264e7298552a20135cb1da6993b984e6c088'],67,357,424,72543,5,0.458563536,1,1,345
0494a5267807b968316eaa65930f66c2f09f5dba,0,Venkatesh Seetharam,2015-02-03 13:55:45-08:00,['f0f2276583f7a9dac7d46fe4c6b0fc5e967181a4'],3,3,6,72549,1,,,,345
2e5646016a497119bc777a552ce04ee23267ca38,1,Venkatesh Seetharam,2015-02-03 14:44:50-08:00,['0494a5267807b968316eaa65930f66c2f09f5dba'],215,67,282,72831,8,,,,345
8f5a2a29ad00bbe94284733fee166c4f29f322ad,0,Harish Butani,2015-02-03 15:04:15-08:00,['2e5646016a497119bc777a552ce04ee23267ca38'],0,18,18,72849,1,0,0,1,345
9853d9d139a0b8469323da21056fb1740e19ac9d,0,Harish Butani,2015-02-03 15:04:15-08:00,['8f5a2a29ad00bbe94284733fee166c4f29f322ad'],38,143,181,73030,5,0.490196078,1,1,345
38c6eb041f2544e2552e61779703f6956412dd62,0,Vishal Kadam,2015-02-03 18:13:38-05:00,['92c4723980db71c761ac64bf7ccc086d7a6684a5'],5,14,19,73049,1,0,1,1,345
57a100731896a2a406b7c2cfd6c3b92a5f23c424,0,Harish Butani,2015-02-03 15:22:01-08:00,['9853d9d139a0b8469323da21056fb1740e19ac9d'],4,5,9,73058,1,1,1,1,345
d06dd15b54368c4f201920f10a66a514a492cbe0,1,Vishal Kadam,2015-02-03 21:07:37-05:00,['38c6eb041f2544e2552e61779703f6956412dd62'],6,30,36,73094,10,,,,349
c58482d7ec0da9a0c9f0d04e0408a5fad43dd27c,1,Vishal Kadam,2015-02-03 22:51:01-05:00,['d06dd15b54368c4f201920f10a66a514a492cbe0'],20,24,44,73138,4,,,,349
537cc23c18721187f2d73c562ef694c087ebb73b,0,Harish Butani,2015-02-03 20:07:32-08:00,['57a100731896a2a406b7c2cfd6c3b92a5f23c424'],4,36,40,73178,2,0.681818182,0.681818182,1,349
d7c7467814cb2d277fc8571c89b2cd33d0cf9a50,0,Harish Butani,2015-02-03 20:09:32-08:00,['537cc23c18721187f2d73c562ef694c087ebb73b'],2,72,74,73252,5,0.555555556,0.138888889,1,349
475949233c97f42c7f4c92aaa84413b3b8b53890,0,Harish Butani,2015-02-03 21:42:03-08:00,['d7c7467814cb2d277fc8571c89b2cd33d0cf9a50'],23,36,59,73311,6,1,1,1,349
674d8073d35e008e6f8e1ed7b8baab3d49fb0e67,0,Vishal Kadam,2015-02-04 00:58:22-05:00,['c58482d7ec0da9a0c9f0d04e0408a5fad43dd27c'],139,158,297,73608,3,0.208333333,1,0,350
b81d3832a45532cebbf8fd349af630c06b0fc5e8,0,Vishal Kadam,2015-02-04 12:20:19-05:00,['674d8073d35e008e6f8e1ed7b8baab3d49fb0e67'],2,2,4,73612,2,,,,350
2d1c36b94d0f824a02e4c89d92dc87ea2e506c7a,0,Vishal Kadam,2015-02-04 12:22:37-05:00,['b81d3832a45532cebbf8fd349af630c06b0fc5e8'],1,1,2,73614,1,,,,350
b06e45b894f92c81dfac5929955bb68e67858a87,1,Harish Butani,2015-02-04 14:53:25-08:00,['475949233c97f42c7f4c92aaa84413b3b8b53890'],18,490,508,74122,7,0.413333333,0.613333333,1,351
fca624df517f0b02c987f3787b82ba4996105e2d,1,Harish Butani,2015-02-04 15:14:12-08:00,['b06e45b894f92c81dfac5929955bb68e67858a87'],2,116,118,74240,2,,,,351
7f8d9f0298f0c16499305e2dde32096c4afe214d,0,Harish Butani,2015-02-09 12:49:41-08:00,['fca624df517f0b02c987f3787b82ba4996105e2d'],0,457,457,74697,3,1,0.791044776,1,354
58b527385228d5b6f2ac9adc76acbf3a8c7b0672,0,Harish Butani,2015-02-10 14:19:03-08:00,['7f8d9f0298f0c16499305e2dde32096c4afe214d'],2,7,9,74706,2,1,1,1,354
0619a480c43573cddb00b007a290d36560692148,0,rohitmpr,2015-02-10 17:31:50-05:00,['2d1c36b94d0f824a02e4c89d92dc87ea2e506c7a'],2,2,4,74710,1,,,,354
4b8751cb7ca7dcc9a19ca9cad065b57c0e23a27e,0,TJBChris,2015-02-12 15:32:07-05:00,['58b527385228d5b6f2ac9adc76acbf3a8c7b0672'],30,32,62,74772,1,0,0,0,354
5801ba4d6149c797620ba74b900c25a766bff509,0,baban,2015-02-14 01:21:34+05:18,[],0,12383,12383,87155,64,0.709903593,0.756938358,0.902424774,418
a12a15f53e989686b178e7d17f34e27ff1132dae,0,Vishal Kadam,2015-02-14 13:20:19-05:00,['0619a480c43573cddb00b007a290d36560692148'],0,0,0,87155,55,,,,418
6b7162cfeda6320a6b0b872a34220835d1b444ac,0,Vishal Kadam,2015-02-14 13:42:46-05:00,"['a12a15f53e989686b178e7d17f34e27ff1132dae', '4b8751cb7ca7dcc9a19ca9cad065b57c0e23a27e']",0,33708,33708,120863,256,,,,418
3e9bb4c29847168447c7108f4f536af3cfb9cf73,1,Vishal Kadam,2015-02-14 14:34:29-05:00,['6b7162cfeda6320a6b0b872a34220835d1b444ac'],16,97,113,120976,3,0.857142857,1,1,419
7053d0e7ae9e4a219997e6311b93ae69925c3531,0,baban,2015-02-15 01:09:57+05:18,['5801ba4d6149c797620ba74b900c25a766bff509'],556,0,556,121532,64,,,,419
e2f143016e1e30d29244a70a4d2c5403ebe151a8,0,baban,2015-02-15 01:16:30+05:18,"['7053d0e7ae9e4a219997e6311b93ae69925c3531', '3e9bb4c29847168447c7108f4f536af3cfb9cf73']",0,34975,34975,156507,312,,,,419
1d850208ec9295c89576a87af6908ff447e5a920,0,Harish Butani,2015-02-14 12:09:56-08:00,['e2f143016e1e30d29244a70a4d2c5403ebe151a8'],4,4,8,156515,1,,,,419
7a8e847a51ba5fc8fde005a1458632e07625f995,1,Venkat Ranganathan,2015-02-20 15:28:26-08:00,['1d850208ec9295c89576a87af6908ff447e5a920'],273,2351,2624,159139,14,0.305851064,0.526595745,0.510638298,426
2181803a3b92e438ed1bb7d5a0567b95a34d1b0f,0,gss2002,2015-02-26 17:03:23-05:00,['7a8e847a51ba5fc8fde005a1458632e07625f995'],3,55,58,159197,1,1,1,1,426
fad5c8e6c32a16bfc9a4ed2304e5d64ad5aa2b37,0,gss2002,2015-02-27 00:31:03-05:00,['2181803a3b92e438ed1bb7d5a0567b95a34d1b0f'],111,276,387,159584,3,0,0,1,426
2412d7cc45e1dbadbe03ef9e69e6967f2acb0918,0,Shwetha GS,2015-02-27 12:47:54+05:18,['fad5c8e6c32a16bfc9a4ed2304e5d64ad5aa2b37'],310,463,773,160357,10,0.466666667,0.709090909,0.96969697,429
36c2d35d385ef3f7ed05c525d718e5b5a8ccbf40,0,a760104,2015-02-27 02:33:13-05:00,['fad5c8e6c32a16bfc9a4ed2304e5d64ad5aa2b37'],0,52,52,160409,1,,,,429
99cfa510d7c9e5e1f23ec26d129c792967322497,0,a760104,2015-02-27 10:46:28-05:00,"['36c2d35d385ef3f7ed05c525d718e5b5a8ccbf40', '2412d7cc45e1dbadbe03ef9e69e6967f2acb0918']",310,463,773,161182,10,,,,429
0e07ef0af27d0e82537e6eb98b50598fab14fd46,0,a760104,2015-02-27 10:47:56-05:00,['99cfa510d7c9e5e1f23ec26d129c792967322497'],1,1,2,161184,1,,,,429
f6e02d431c4cd406e899c7e5b38132538bbecf58,0,a760104,2015-02-27 10:48:54-05:00,['0e07ef0af27d0e82537e6eb98b50598fab14fd46'],0,101,101,161285,2,,,,431
3982b85773e1d6daa411265c04c52b076f7564ec,0,a760104,2015-02-27 11:09:04-05:00,['f6e02d431c4cd406e899c7e5b38132538bbecf58'],105,3,108,161393,4,,,,431
0b11134fbbfdec782ceb0c8e0e9c59f4d0876d3e,0,a760104,2015-02-27 11:19:34-05:00,['3982b85773e1d6daa411265c04c52b076f7564ec'],1,1,2,161395,1,,,,431
8e5d48275c54d21dfd0af4279cec9b762453bb38,1,Shwetha GS,2015-03-03 17:08:12+05:18,['0b11134fbbfdec782ceb0c8e0e9c59f4d0876d3e'],64,576,640,162035,20,0.666666667,1,1,438
9d01934b5abdd5a10a1387b55d7a438fd9f8b6e3,1,Venkatesh Seetharam,2015-03-03 14:27:35-08:00,['8e5d48275c54d21dfd0af4279cec9b762453bb38'],273,639,912,162947,13,0.651162791,0.662790698,0.924418605,440
88391aa85d03bfae62100194ee53636a761089d5,1,Venkatesh Seetharam,2015-03-03 14:28:50-08:00,['9d01934b5abdd5a10a1387b55d7a438fd9f8b6e3'],57,316,373,163320,3,0.26984127,1,0.978835979,440
14ea109819b9de5c56b172716f3c8b1d5e31f96d,0,Venkatesh Seetharam,2015-03-03 14:43:16-08:00,['88391aa85d03bfae62100194ee53636a761089d5'],1,1,2,163322,1,1,1,1,440
72fee44b55397573bb74cef8225d9602d3070018,1,Venkatesh Seetharam,2015-03-03 22:32:05-08:00,['14ea109819b9de5c56b172716f3c8b1d5e31f96d'],8136,8145,16281,179603,109,,,,440
582c2294da85dc91ea3fc22ba001ec672c484759,0,Shwetha GS,2015-03-04 16:31:31+05:18,['72fee44b55397573bb74cef8225d9602d3070018'],95,174,269,179872,7,0,0.690909091,1,440
b6e5ab468a41055a0c973e026938087d89983746,1,Vishal Kadam,2015-03-04 23:23:38-05:00,['582c2294da85dc91ea3fc22ba001ec672c484759'],16,18,34,179906,3,1,1,1,440
a4a576445fbb416df5429380c2db76e790b98e0e,1,Venkatesh Seetharam,2015-03-06 12:19:35-08:00,['b6e5ab468a41055a0c973e026938087d89983746'],14963,17503,32466,212372,406,0,0.905960265,0.950993377,524
ac67d212d1001e915a3c36324dc6c5cf6415607d,1,Venkatesh Seetharam,2015-03-06 12:19:35-08:00,['a4a576445fbb416df5429380c2db76e790b98e0e'],196,328,524,212896,10,,,,525
87e36721796d051d7e9f7ec9333d563629fe9147,0,Venkatesh Seetharam,2015-03-06 12:21:53-08:00,['ac67d212d1001e915a3c36324dc6c5cf6415607d'],33,34,67,212963,3,1,0,0,525
d3a275c38c57a759809ebb110a4814ef7ca3450d,1,Venkatesh Seetharam,2015-03-06 12:40:53-08:00,['87e36721796d051d7e9f7ec9333d563629fe9147'],10,7,17,212980,4,,,,525
e79ca3ca2e27f176567079d65b9078290e7c8b35,1,Venkatesh Seetharam,2015-03-09 12:36:38-07:00,['d3a275c38c57a759809ebb110a4814ef7ca3450d'],19,225,244,213224,7,0,0.992647059,1,525
7a63f7ea9c7d9e55244551bb768e0faaf2a0a8a0,0,Venkatesh Seetharam,2015-03-09 12:41:10-07:00,['e79ca3ca2e27f176567079d65b9078290e7c8b35'],0,2,2,213226,1,,,,525
2f231bef8635db6e6f75cf9074fa302caae3ca2b,0,Harish Butani,2015-03-09 18:10:28-07:00,['7a63f7ea9c7d9e55244551bb768e0faaf2a0a8a0'],1,182,183,213409,3,1,1,1,525
48a088fcd5e5efc1be09dca8ef626e17f32d1a38,1,Harish Butani,2015-03-11 09:20:49-07:00,['2f231bef8635db6e6f75cf9074fa302caae3ca2b'],2,9,11,213420,3,,,,525
6ea66f7acbe383f0fe1e8fd85c9787d275421631,1,Venkatesh Seetharam,2015-03-11 15:22:00-07:00,['48a088fcd5e5efc1be09dca8ef626e17f32d1a38'],12,45,57,213477,1,0.043478261,0.913043478,0,525
82c06b747a4b14dbc09578985284c60a1ab4eb58,1,Venkatesh Seetharam,2015-03-11 15:22:00-07:00,['6ea66f7acbe383f0fe1e8fd85c9787d275421631'],412,839,1251,214728,13,0.882716049,1,0.808641975,525
3d9862e9fbaa609d6e4f436ec498ec5a820f8627,1,Harish Butani,2015-03-12 09:58:12-07:00,['82c06b747a4b14dbc09578985284c60a1ab4eb58'],10,48,58,214786,4,,,,526
767611af80d833d5c0bb950aeea2f044c5ecc272,0,Harish Butani,2015-03-12 10:00:01-07:00,['3d9862e9fbaa609d6e4f436ec498ec5a820f8627'],0,36,36,214822,5,,,,526
ca9fd2f5f07b615dfb9d878b19e1b40354c686ba,0,Harish Butani,2015-03-12 15:33:02-07:00,['767611af80d833d5c0bb950aeea2f044c5ecc272'],3,40,43,214865,2,0.4,1,1,526
65b613b8aeb78d95ff1a0275a171415b5c7cd286,1,Venkatesh Seetharam,2015-03-12 22:34:00-07:00,['ca9fd2f5f07b615dfb9d878b19e1b40354c686ba'],53,297,350,215215,11,0.116959064,1,1,526
665165eddfd3dfe366e0387810f36016852e3366,0,Harish Butani,2015-03-14 20:41:20-07:00,['65b613b8aeb78d95ff1a0275a171415b5c7cd286'],3,11,14,215229,2,,,,526
543f3a72419432cdd5ea739e25867103701b5bda,0,Harish Butani,2015-03-14 20:41:20-07:00,['665165eddfd3dfe366e0387810f36016852e3366'],6,101,107,215336,7,0.526315789,0.631578947,1,527
305d16a1877b9ad4f3fcdc902634f8f95d02ba67,0,Harish Butani,2015-03-15 18:17:23-07:00,['543f3a72419432cdd5ea739e25867103701b5bda'],2,60,62,215398,4,0.533333333,0.533333333,1,527
3718af6b429003963496f4454fdc9399caf856c1,1,Harish Butani,2015-03-15 18:18:01-07:00,['305d16a1877b9ad4f3fcdc902634f8f95d02ba67'],29,108,137,215535,5,0.076923077,0.269230769,1,527
398286a9005ad7ccf3a56f83989661dd86a1a1d8,1,Harish Butani,2015-03-16 17:07:10-07:00,['3718af6b429003963496f4454fdc9399caf856c1'],26,89,115,215650,6,0.540540541,0.972972973,1,527
c7b8238781c15f710031079ec1e6396311a20aff,1,Venkatesh Seetharam,2015-03-16 22:02:52-07:00,['398286a9005ad7ccf3a56f83989661dd86a1a1d8'],24,408,432,216082,10,0,1,1,531
77b11f26a2b753065cd872c8efe1f47654a4f66f,1,Venkatesh Seetharam,2015-03-16 22:10:45-07:00,['c7b8238781c15f710031079ec1e6396311a20aff'],150,350,500,216582,24,0.302816901,0.992957746,0.823943662,532
9648a823c62dd1abb0d9cdc380043a939ecb9e16,1,Jon Maron,2015-03-17 19:56:31-04:00,['77b11f26a2b753065cd872c8efe1f47654a4f66f'],43,868,911,217493,9,0.222811671,0.798408488,1,536
82aeb21d42a6ff607dc3a05b5950e96d4ce2dca8,0,Harish Butani,2015-03-18 07:58:39-07:00,['77b11f26a2b753065cd872c8efe1f47654a4f66f'],16,89,105,217598,7,0.333333333,0.9375,0.5625,536
ee143338492ebcbe615bfdddca511cb771bb6881,1,Shwetha GS,2015-03-18 16:24:13-07:00,['82aeb21d42a6ff607dc3a05b5950e96d4ce2dca8'],510,1130,1640,219238,37,0.659340659,0.373626374,0.468864469,540
2ee66639540e8c187dd46620b27215831e120636,0,Venkatesh Seetharam,2015-03-18 17:33:17-07:00,['ee143338492ebcbe615bfdddca511cb771bb6881'],844,1040,1884,221122,58,,,,542
6d3693283e5c002c134dab027b0c8bc1190e5fcd,0,Harish Butani,2015-03-19 08:42:54-07:00,['2ee66639540e8c187dd46620b27215831e120636'],7,8,15,221137,4,,,,542
a2e16bb9e1be53fefec64ab3f88818f98fa7f5b7,1,Shwetha GS,2015-03-19 20:06:45-07:00,['6d3693283e5c002c134dab027b0c8bc1190e5fcd'],100,310,410,221547,19,0.577777778,1,0.577777778,545
858348b09bc5072687692d7c4013d831cfb3af93,1,Venkatesh Seetharam,2015-03-20 11:52:27-07:00,['a2e16bb9e1be53fefec64ab3f88818f98fa7f5b7'],19,1514,1533,223080,10,0.388020833,1,1,548
643b648939e67c862fa9c4e7651172dc719c7168,1,Harish Butani,2015-03-20 15:24:58-07:00,['858348b09bc5072687692d7c4013d831cfb3af93'],9,172,181,223261,7,0.773913043,0.713043478,0.930434783,548
9a4a353d482e888ee3bfa5a170435b36fc24c405,0,Harish Butani,2015-03-20 15:58:35-07:00,['643b648939e67c862fa9c4e7651172dc719c7168'],3,2,5,223266,2,1,1,1,548
8900b0aeb42f494714d65b810235e1746b949f68,1,Harish Butani,2015-03-23 14:55:22-07:00,['9a4a353d482e888ee3bfa5a170435b36fc24c405'],8,39,47,223313,3,1,1,1,548
35adfb8e68bfa79e1f316d1ee1949cc7bd36c141,0,Venkatesh Seetharam,2015-03-23 16:19:13-07:00,['8900b0aeb42f494714d65b810235e1746b949f68'],16,77,93,223406,7,1,1,0.75,549
e747e2ae77b98ede07d712c34ee6954c0e281909,1,Venkatesh Seetharam,2015-03-23 16:19:48-07:00,['35adfb8e68bfa79e1f316d1ee1949cc7bd36c141'],500,427,927,224333,14,0.723404255,0.361702128,0,549
a86f0f3e10a5c96d5f384cb1ee65a7b313c0e5f2,1,Venkatesh Seetharam,2015-03-23 16:22:46-07:00,['e747e2ae77b98ede07d712c34ee6954c0e281909'],346,700,1046,225379,6,0.419191919,1,0.53030303,550
4f928a8dc63de7858ecb42fdec18e3a8b0a7a500,0,Venkatesh Seetharam,2015-03-23 18:15:15-07:00,['a86f0f3e10a5c96d5f384cb1ee65a7b313c0e5f2'],47,21,68,225447,7,1,0,0,550
73748b46457b2ae990498619439810a29ac670aa,0,David Kaspar,2015-03-24 16:00:21+01:00,['4f928a8dc63de7858ecb42fdec18e3a8b0a7a500'],5,3,8,225455,2,0,0,0,550
cbdbed1d227396b6d372f6c23adcc4a3d17c19ae,1,Venkatesh Seetharam,2015-03-24 09:10:31-07:00,['73748b46457b2ae990498619439810a29ac670aa'],1112,450,1562,227017,12,0.488,0.696,0,551
7f4227e2d24403e19d0eea82267a557e2f8ade8f,1,Venkatesh Seetharam,2015-03-24 16:43:12-07:00,['cbdbed1d227396b6d372f6c23adcc4a3d17c19ae'],1125,143,1268,228285,36,0.376657825,0.114058355,0.384615385,551
e5feaabfd814d09f448d075bc4e6a77e48039a5e,1,Shwetha GS,2015-03-24 18:38:54-07:00,['7f4227e2d24403e19d0eea82267a557e2f8ade8f'],3585,542,4127,232412,19,0.700621118,0.262111801,0.269565217,552
1d0dcc02e7ea212a6bce7d4bafd224d23d5d851c,1,Harish Butani,2015-03-25 13:02:52-07:00,['e5feaabfd814d09f448d075bc4e6a77e48039a5e'],81,381,462,232874,3,0,0,1,553
8612a451ea0e44ed00838aad7c63e1dfb8ac34fd,1,Harish Butani,2015-03-25 13:44:00-07:00,['1d0dcc02e7ea212a6bce7d4bafd224d23d5d851c'],2,4,6,232880,1,0,0,1,553
571fd25b9f709673b72f3d1d1332394eda268f26,1,Harish Butani,2015-03-25 15:52:15-07:00,['8612a451ea0e44ed00838aad7c63e1dfb8ac34fd'],2,2,4,232884,1,,,,553
0d38165dd1eeb7d756c40ad89c290390195f64cc,1,Shwetha GS,2015-03-25 17:26:22-07:00,['571fd25b9f709673b72f3d1d1332394eda268f26'],100,119,219,233103,6,1,1,0,553
309af260a30252b176dcb4381abd393dc9f6dbb4,1,Venkatesh Seetharam,2015-03-25 22:45:21-07:00,['0d38165dd1eeb7d756c40ad89c290390195f64cc'],71,226,297,233400,7,0.06122449,0.989795918,0.948979592,553
6e212def4135a0af004b0ad1ead9b29fc96995b9,1,Harish Butani,2015-03-26 20:46:10-07:00,['309af260a30252b176dcb4381abd393dc9f6dbb4'],0,168,168,233568,1,1,1,1,554
fb3f6b46d53d273a6e91ab8687e33dfd4408c26a,1,Shwetha GS,2015-03-27 11:53:20-07:00,['6e212def4135a0af004b0ad1ead9b29fc96995b9'],69,209,278,233846,6,1,1,0,555
af99895b253951ec94e0f26733ffbc2ee10675f6,1,Harish Butani,2015-03-27 12:54:01-07:00,['fb3f6b46d53d273a6e91ab8687e33dfd4408c26a'],19,109,128,233974,3,1,1,0.125,555
49828added781fc8efb38247da3b62e39c443a6d,1,Jon Maron,2015-03-27 16:42:53-04:00,['6e212def4135a0af004b0ad1ead9b29fc96995b9'],117,870,987,234961,11,0.230971129,0.800524934,1,560
92a68d05a4b174f124ea94b9c86b7dc2cfdc9602,0,Jon Maron,2015-03-27 17:05:10-04:00,"['49828added781fc8efb38247da3b62e39c443a6d', '9648a823c62dd1abb0d9cdc380043a939ecb9e16']",13,157,170,235131,4,,,,560
b91dcefd6b418c94eb5c142d0ba6580f15ecebc6,0,Jon Maron,2015-03-27 17:12:47-04:00,['92a68d05a4b174f124ea94b9c86b7dc2cfdc9602'],148,0,148,235279,2,0.615384615,0.307692308,0,560
cb5ceb132c430afb33e891d826dbf09a671104a0,0,Jon Maron,2015-03-27 17:27:33-04:00,"['af99895b253951ec94e0f26733ffbc2ee10675f6', 'b91dcefd6b418c94eb5c142d0ba6580f15ecebc6']",130,879,1009,236288,11,,,,560
95675ad478af5532e8d1bc28546839fbcf6b4592,1,Harish Butani,2015-03-27 16:16:56-07:00,['cb5ceb132c430afb33e891d826dbf09a671104a0'],20,41,61,236349,4,0,0,1,560
0e5555b7f1d4a8672ffbac295013866a71535755,1,Shwetha GS,2015-03-30 17:51:43+05:18,['95675ad478af5532e8d1bc28546839fbcf6b4592'],8,117,125,236474,6,0,1,1,561
12beefbb437fd7fe0902e29d62ac6afa38c9374d,0,Shwetha GS,2015-03-31 11:56:41+05:18,['0e5555b7f1d4a8672ffbac295013866a71535755'],1,7,8,236482,1,,,,561
4e8718a6008011c483a9c239d3141bc99a51b2b0,0,rohitmpr,2015-03-31 03:49:28-04:00,['95675ad478af5532e8d1bc28546839fbcf6b4592'],0,0,0,236482,391,,,,561
403c04b38d96acbfebe11dbc6e3bd5b02d0ade4f,1,Jon Maron,2015-03-31 09:03:24-04:00,['12beefbb437fd7fe0902e29d62ac6afa38c9374d'],0,343,343,236825,4,0.426666667,0.753333333,0.853333333,563
da7a6a88c912f8536d4cf9d84d2d6f339c5e8282,1,Jon Maron,2015-03-31 09:03:25-04:00,['403c04b38d96acbfebe11dbc6e3bd5b02d0ade4f'],37,38,75,236900,4,1,1,1,563
e51d3d6bd546cbfd12f6155ded72f5425cc82f00,1,Harish Butani,2015-03-31 10:37:23-07:00,['12beefbb437fd7fe0902e29d62ac6afa38c9374d'],0,268,268,237168,2,1,1,0.962264151,565
c1c6510bed16f47fc242917d35a4e076d30f8014,0,Jon Maron,2015-03-31 16:12:20-04:00,"['da7a6a88c912f8536d4cf9d84d2d6f339c5e8282', 'e51d3d6bd546cbfd12f6155ded72f5425cc82f00']",0,268,268,237436,2,,,,565
fcbce418eb986ccc219dfd976b78acde79fc0860,1,Venkatesh Seetharam,2015-03-31 17:09:00-07:00,['c1c6510bed16f47fc242917d35a4e076d30f8014'],119,152,271,237707,11,1,0.210526316,1,568
c87130eb2173217c37b406471095c93ed44a0764,1,Jon Maron,2015-04-01 16:50:46-04:00,['4e8718a6008011c483a9c239d3141bc99a51b2b0'],79,824,903,238610,10,0.485549133,0.875722543,0.947976879,574
aeada976f9459fe1d9cb783697e8cff70b150b95,0,Harish Butani,2015-04-01 18:53:33-07:00,['c87130eb2173217c37b406471095c93ed44a0764'],2,117,119,238729,6,0,1,1,575
87ccb77e676b1cc7ed878de9e7366b18433ba971,0,Harish Butani,2015-04-01 18:53:33-07:00,['aeada976f9459fe1d9cb783697e8cff70b150b95'],1,7,8,238737,1,,,,575
5324e905590a4e6f753a476fa8e0ee467a1d5074,0,Harish Butani,2015-04-01 18:53:34-07:00,['87ccb77e676b1cc7ed878de9e7366b18433ba971'],0,268,268,239005,2,1,1,0.962264151,577
a15b6ef19d9bbbdf4b1479d7894f6f3233ff4264,1,Shwetha GS,2015-04-02 23:54:41+05:18,['5324e905590a4e6f753a476fa8e0ee467a1d5074'],76,308,384,239389,22,0.477941176,0.742647059,0.941176471,577
1380771dc71acf3a7d4794a076b35daa70c3a4a6,0,Venkatesh Seetharam,2015-04-02 23:11:05-07:00,"['fcbce418eb986ccc219dfd976b78acde79fc0860', 'a15b6ef19d9bbbdf4b1479d7894f6f3233ff4264']",230,870,1100,240489,397,,,,577
f592043c4e0047acaf1277c48a1f896b7eb88d2d,1,Venkatesh Seetharam,2015-04-02 23:13:51-07:00,['1380771dc71acf3a7d4794a076b35daa70c3a4a6'],93,716,809,241298,15,0.093851133,0.970873786,0.702265372,581
ed06c79199c4bf31523dc30699e2359c669a5b9e,0,Venkatesh Seetharam,2015-04-02 23:14:08-07:00,['f592043c4e0047acaf1277c48a1f896b7eb88d2d'],84,56,140,241438,1,0.85,0,0.55,581
9670a3d77a75e01fb4669d9264fca93a91afacf7,0,Venkatesh Seetharam,2015-04-03 00:31:01-07:00,['ed06c79199c4bf31523dc30699e2359c669a5b9e'],12,50,62,241500,3,0.388888889,1,1,581
84a28168f99f5fd902ec33351b7f01f09f2cad5e,1,Venkatesh Seetharam,2015-04-03 00:57:37-07:00,['9670a3d77a75e01fb4669d9264fca93a91afacf7'],14,22,36,241536,2,1,1,1,581
8a0c08f75ba2a8ef4933c5d022709d5c855bf63e,1,Shwetha GS,2015-04-03 21:58:23+05:18,['84a28168f99f5fd902ec33351b7f01f09f2cad5e'],7,72,79,241615,3,0.307692308,0.128205128,1,581
b195719e29d590587e0e80d6ec4255584f6f2808,1,Jon Maron,2015-04-03 17:49:31-04:00,['8a0c08f75ba2a8ef4933c5d022709d5c855bf63e'],39,111,150,241765,2,0,1,1,582
6edfdb77ceda00404a8abe6e16743c463d896663,1,Venkatesh Seetharam,2015-04-06 14:13:05-07:00,['b195719e29d590587e0e80d6ec4255584f6f2808'],9,13,22,241787,3,0,1,1,582
b1e6c379577a9b6d1e69ad56526fdc9332474984,1,Venkatesh Seetharam,2015-04-07 17:25:25-07:00,['6edfdb77ceda00404a8abe6e16743c463d896663'],4,433,437,242224,4,0.315789474,0.996240602,0.763157895,583
879eda63480a49fccf684a9d17a8daf006d03dd5,1,Venkatesh Seetharam,2015-04-08 21:01:42-07:00,['b1e6c379577a9b6d1e69ad56526fdc9332474984'],189,497,686,242910,15,0.38547486,0.994413408,0.770949721,583
4719701ce0dbb4c28bb4b65df2f865cf91e4497f,0,Venkatesh Seetharam,2015-04-10 14:03:12-07:00,['879eda63480a49fccf684a9d17a8daf006d03dd5'],39,16,55,242965,5,0,1,0,583
86fe0801e394cc37d16a60f4e21a1b770d09134f,1,Shwetha GS,2015-04-15 15:15:38+05:18,['4719701ce0dbb4c28bb4b65df2f865cf91e4497f'],239,145,384,243349,12,1,1,1,584
29c930bba4f273cc1103cfc5f805f7668d9e2f2d,1,Jon Maron,2015-04-16 14:46:10-04:00,['86fe0801e394cc37d16a60f4e21a1b770d09134f'],0,14628,14628,257977,43,0.595993953,0.867913832,0.873960695,625
26e699dce4e5be67db76deb1ddd49a4420128891,0,Jon Maron,2015-04-16 14:50:28-04:00,['29c930bba4f273cc1103cfc5f805f7668d9e2f2d'],32,0,32,258009,2,,,,625
c41930f5d1aaa5a23a1cabac00d39d435ef80c2d,0,Aaron Dossett,2015-04-20 10:13:13-05:00,['86fe0801e394cc37d16a60f4e21a1b770d09134f'],1,1,2,258011,1,,,,625
bb64966dd552c51cd5acba8aedf0cf5f51997a69,1,Shwetha GS,2015-04-20 23:44:03+05:18,['86fe0801e394cc37d16a60f4e21a1b770d09134f'],138,341,479,258490,25,0.380952381,0.825396825,0.206349206,626
42578cccfad66a23ac7ae3f6eb258138b0e854a9,1,Shwetha GS,2015-04-21 16:11:18+05:18,['bb64966dd552c51cd5acba8aedf0cf5f51997a69'],207,280,487,258977,6,1,1,1,628
5828806956e5beb03a75a837d73622ba00c0d9a7,0,Jon Maron,2015-04-21 11:38:04-04:00,"['26e699dce4e5be67db76deb1ddd49a4420128891', '42578cccfad66a23ac7ae3f6eb258138b0e854a9']",351,627,978,259955,30,,,,628
816486c483c7648aab0cbc2abfd4de6baad42b09,0,Jon Maron,2015-04-21 13:17:58-04:00,['5828806956e5beb03a75a837d73622ba00c0d9a7'],0,0,0,259955,5,,,,628
300dc52754165b82e3ae5e65ad5739fc2ef5019c,0,Jon Maron,2015-04-21 13:52:48-04:00,['816486c483c7648aab0cbc2abfd4de6baad42b09'],1,2,3,259958,1,1,1,1,628
7622c3e1c539d94afda331fd3ea80389822b7180,0,Aaron Dossett,2015-04-21 16:04:12-05:00,['42578cccfad66a23ac7ae3f6eb258138b0e854a9'],0,5,5,259963,1,0,1,1,628
827cc3fb8d70fd61f97211f716b09dcc5d057afb,0,Raja Aluri,2015-04-21 14:22:17-07:00,['300dc52754165b82e3ae5e65ad5739fc2ef5019c'],0,1,1,259964,1,,,,628
d2add35e33066591ee4656d3a8a2fa0f24154327,0,Jon Maron,2015-04-22 16:07:37-04:00,['827cc3fb8d70fd61f97211f716b09dcc5d057afb'],27,41,68,260032,6,1,1,1,628
1e835435c6b1472e9b689294ac45b99b2a433dd7,1,Raja Aluri,2015-04-22 14:47:13-07:00,['d2add35e33066591ee4656d3a8a2fa0f24154327'],1,19,20,260052,1,,,,628
f999c67a45bb9f9a925f4da249ae0dbc3a9fe6a7,1,Aaron Dossett,2015-04-23 08:51:26-05:00,['c41930f5d1aaa5a23a1cabac00d39d435ef80c2d'],1,14,15,260067,1,,,,628
589c2a653b67d9ae5303e960e037f37d8f077dd7,0,Aaron Dossett,2015-04-23 10:07:28-05:00,['1e835435c6b1472e9b689294ac45b99b2a433dd7'],0,5,5,260072,1,0,1,1,628
58dce4c6649c4da65279b12f060ba4cb01348452,0,Aaron Dossett,2015-04-23 10:07:28-05:00,['589c2a653b67d9ae5303e960e037f37d8f077dd7'],4,5,9,260081,1,0,1,1,628
28139b40482379c7aee4a7fac2edffe37e32cf1e,0,Aaron Dossett,2015-04-23 10:14:37-05:00,"['58dce4c6649c4da65279b12f060ba4cb01348452', '7622c3e1c539d94afda331fd3ea80389822b7180']",1,1,2,260083,1,,,,628
a4af9e31fd3b534a2ca0717f59bda43b7b2a9353,1,Shwetha GS,2015-04-24 13:12:23+05:18,['1e835435c6b1472e9b689294ac45b99b2a433dd7'],30,47,77,260160,5,0.857142857,0.857142857,1,628
dcfc483f2ee89d0d8cab84bfbd684b9c9aa1be6f,1,Aaron Dossett,2015-04-24 05:55:02-05:00,['f999c67a45bb9f9a925f4da249ae0dbc3a9fe6a7'],1,1,2,260162,1,,,,628
db8ac80d04ba10d9e2429ede0e4eb7b5114597e9,0,Aaron Niskode-Dossett,2015-04-24 05:57:24-05:00,"['a4af9e31fd3b534a2ca0717f59bda43b7b2a9353', 'dcfc483f2ee89d0d8cab84bfbd684b9c9aa1be6f']",1,14,15,260177,1,,,,628
8cac97e57c777a72fe997cc6975f6a6d2b21b001,0,Aaron Dossett,2015-04-24 07:58:46-05:00,['28139b40482379c7aee4a7fac2edffe37e32cf1e'],1,5,6,260183,2,1,1,1,628
e4d54817af3a6fdc47c36d50662bb6e11c8a4979,0,Shwetha G S,2015-04-27 10:28:14+05:18,"['db8ac80d04ba10d9e2429ede0e4eb7b5114597e9', '8cac97e57c777a72fe997cc6975f6a6d2b21b001']",0,10,10,260193,2,,,,628
abf35d6238c8739003643f5aca1f5574e95a5993,0,Shwetha GS,2015-04-27 13:07:44+05:18,['e4d54817af3a6fdc47c36d50662bb6e11c8a4979'],3,10,13,260206,1,,,,628
e02cfc05de0f3b9fab628d142b84ed7fab527672,0,Aaron Dossett,2015-04-27 12:38:21-05:00,['abf35d6238c8739003643f5aca1f5574e95a5993'],1,17,18,260224,2,,,,628
172f3c8cb5b06fae4e398f78781d776e70ebe871,1,Aaron Dossett,2015-04-27 15:34:12-05:00,['abf35d6238c8739003643f5aca1f5574e95a5993'],17,2,19,260243,3,,,,628
27eb676c70d0dfeb3170df1100878cf1afa702bf,0,Aaron Dossett,2015-04-27 17:01:12-05:00,['172f3c8cb5b06fae4e398f78781d776e70ebe871'],1,1,2,260245,1,,,,628
f1eb7ced356a0247fd275312cb3c5f6254a0197b,0,Aaron Dossett,2015-04-28 06:28:23-05:00,['27eb676c70d0dfeb3170df1100878cf1afa702bf'],1,1,2,260247,1,,,,628
1a13eea3bb838400d44b77928737ad6d5ed803df,0,Aaron Niskode-Dossett,2015-04-28 06:29:46-05:00,"['abf35d6238c8739003643f5aca1f5574e95a5993', 'f1eb7ced356a0247fd275312cb3c5f6254a0197b']",19,4,23,260270,4,,,,628
ee6126ff0d833c5e23c6cf283c08a2d9dd10a20b,0,Harish Butani,2015-04-28 17:51:43-07:00,['1a13eea3bb838400d44b77928737ad6d5ed803df'],50,409,459,260729,4,1,0.910569106,0.983739837,631
356fde94ba784cc7cb3344ab80eccf8ef4845115,0,Harish Butani,2015-04-28 17:57:00-07:00,['abf35d6238c8739003643f5aca1f5574e95a5993'],17,2,19,260748,3,,,,631
683625ff6ba19bf8d460bf6d13df28b261ff3270,0,Harish Butani,2015-04-28 17:57:00-07:00,['356fde94ba784cc7cb3344ab80eccf8ef4845115'],1,1,2,260750,1,,,,631
9ce130b0ee8f7f0f6d6993369a76bae3d2dfcb5e,0,Harish Butani,2015-04-28 17:57:00-07:00,['683625ff6ba19bf8d460bf6d13df28b261ff3270'],1,1,2,260752,1,,,,631
0cdacb1d9dccebb4848aae002b359c4a12b9cac3,0,Harish Butani,2015-04-28 17:57:00-07:00,['9ce130b0ee8f7f0f6d6993369a76bae3d2dfcb5e'],50,409,459,261211,4,1,0.910569106,0.983739837,634
1361d0cba3027c45ce111786a39a714ecae387fc,0,Shwetha GS,2015-04-29 12:38:34+05:18,['0cdacb1d9dccebb4848aae002b359c4a12b9cac3'],11,26,37,261248,5,1,1,1,634
e631ed0a1390e04341c11e49d09ee0f29737aaf3,1,Shwetha GS,2015-04-29 12:40:03+05:18,['ee6126ff0d833c5e23c6cf283c08a2d9dd10a20b'],11,26,37,261285,5,1,1,1,634
b2ec0c35c602b09583dea61744a1375aecc08119,0,Aaron Niskode-Dossett,2015-04-29 08:08:40-05:00,"['e631ed0a1390e04341c11e49d09ee0f29737aaf3', 'e02cfc05de0f3b9fab628d142b84ed7fab527672']",1,17,18,261303,2,,,,634
2fa785cc94d8c8e4735a124e68fd3391a1b6f0bc,0,Jon Maron,2015-04-29 20:13:57-04:00,['b2ec0c35c602b09583dea61744a1375aecc08119'],1,1,2,261305,1,,,,634
aea795d531d0aab526cd399d214e6ab1e829c103,0,Jon Maron,2015-04-29 20:14:57-04:00,['1361d0cba3027c45ce111786a39a714ecae387fc'],1,1,2,261307,1,,,,634
fc4dfcfe0ac0b071a714fc154716320ad06f4347,0,Jon Maron,2015-04-30 16:19:43-04:00,['2fa785cc94d8c8e4735a124e68fd3391a1b6f0bc'],3,8,11,261318,3,1,1,1,634
5ed7b7fff0d08beca847ef30505cb6617dc33504,0,Jon Maron,2015-04-30 16:20:08-04:00,['aea795d531d0aab526cd399d214e6ab1e829c103'],3,8,11,261329,3,1,1,1,634
e79fed42f421f7ca23290db74630ebdb272fc87d,0,Jon Maron,2015-05-01 09:49:35-04:00,['fc4dfcfe0ac0b071a714fc154716320ad06f4347'],0,1,1,261330,1,,,,634
be8ba79589171d90b2d8e4579baa6d3a611a4f2e,0,Jon Maron,2015-05-01 09:49:57-04:00,['5ed7b7fff0d08beca847ef30505cb6617dc33504'],0,1,1,261331,1,,,,634
5fda7b705872b86190916ad158fbb8c27ff4b4ce,1,Harish Butani,2015-05-01 08:48:05-07:00,['e79fed42f421f7ca23290db74630ebdb272fc87d'],3,62,65,261396,3,0.540540541,0.918918919,0.918918919,634
63fb91a327f55b6db1f00ed69c2bcab7465e2572,0,Harish Butani,2015-05-01 08:48:41-07:00,['be8ba79589171d90b2d8e4579baa6d3a611a4f2e'],1,17,18,261414,2,,,,634
f82182e4be157c05c9c9c86dc0e70732384d7f2e,0,Harish Butani,2015-05-01 08:48:41-07:00,['63fb91a327f55b6db1f00ed69c2bcab7465e2572'],3,62,65,261479,3,0.540540541,0.918918919,0.918918919,634
a0d7b9986238c556743e97d42e256029c5414236,1,Venkatesh Seetharam,2015-05-01 13:55:26-07:00,['5fda7b705872b86190916ad158fbb8c27ff4b4ce'],78,487,565,262044,15,0.121212121,1,0.939393939,635
8ee845beba04e41c19af60ee0b03d79f1b74acd3,1,Aaron Dossett,2015-05-01 16:17:28-05:00,['5fda7b705872b86190916ad158fbb8c27ff4b4ce'],5,8,13,262057,2,1,1,1,635
a9d61e1b8b4621b6500c7664f8c437310c6c0401,1,Venkatesh Seetharam,2015-05-01 14:25:41-07:00,['a0d7b9986238c556743e97d42e256029c5414236'],9,53286,53295,315352,61,0.627561546,0.686838124,0.77921423,694
8ba831bcb81c356c0aee0bdb478423a4419355ef,0,Venkatesh Seetharam,2015-05-01 16:10:17-07:00,['a9d61e1b8b4621b6500c7664f8c437310c6c0401'],22782,19,22801,338153,19,0.395063036,0.326729526,0.225871385,694
8e73ed24df3c6e5eca2bc8dfce5c539cc5d44194,0,Shwetha G S,2015-05-04 11:34:53+05:18,"['8ba831bcb81c356c0aee0bdb478423a4419355ef', '8ee845beba04e41c19af60ee0b03d79f1b74acd3']",5,8,13,338166,2,,,,694
4b2a4caed572fb358cddb37ce1b183072e08a0a6,1,Shwetha GS,2015-05-04 14:47:22+05:18,['8e73ed24df3c6e5eca2bc8dfce5c539cc5d44194'],55,44,99,338265,6,1,1,0.5,694
dd9a76b025a598d7d6c3789697be9738328db302,0,Shwetha GS,2015-05-04 14:47:49+05:18,"['f82182e4be157c05c9c9c86dc0e70732384d7f2e', '4b2a4caed572fb358cddb37ce1b183072e08a0a6']",133,31048,31181,369446,70,,,,694
64c784428b7c87aab5e6a8311c9121de48e9183e,1,Shwetha GS,2015-05-04 17:52:38+05:18,['4b2a4caed572fb358cddb37ce1b183072e08a0a6'],28,28,56,369502,4,0.666666667,0.666666667,0.333333333,694
4112fbf5dca1d21331a5551a00eaac7b58d7b6cc,0,Aaron Niskode-Dossett,2015-05-04 13:30:11-05:00,['64c784428b7c87aab5e6a8311c9121de48e9183e'],2,1,3,369505,1,1,0,0,694
786b1f3b63157e7d8cf09b1bd5ef862729bab29c,0,Aaron Dossett,2015-05-04 14:39:25-05:00,['64c784428b7c87aab5e6a8311c9121de48e9183e'],4,1,5,369510,1,0,0,1,694
9b02a58ff68e0c39dc110dc1e5b8316481eb118a,0,Shwetha G S,2015-05-05 15:25:34+05:18,"['64c784428b7c87aab5e6a8311c9121de48e9183e', '786b1f3b63157e7d8cf09b1bd5ef862729bab29c']",4,1,5,369515,1,,,,694
d7807410d653760e347809d6c6f9c99d6793611a,0,Suma Shivaprasad,2015-05-05 15:29:02+05:18,['64c784428b7c87aab5e6a8311c9121de48e9183e'],56,57,113,369628,5,0,1,1,694
ab91112a91e870e7c9eb06dd076f9d468abb5e16,0,Aaron Niskode-Dossett,2015-05-05 12:49:50-05:00,"['9b02a58ff68e0c39dc110dc1e5b8316481eb118a', '4112fbf5dca1d21331a5551a00eaac7b58d7b6cc']",2,1,3,369631,1,,,,694
bbc46662255208dcded3d6b1cdc8a62bc7004618,0,Suma Shivaprasad,2015-05-06 12:41:36+05:18,['d7807410d653760e347809d6c6f9c99d6793611a'],48,32,80,369711,6,0,0,0,694
074211dbd0db37cefa4d40203241b6399b2d5f4d,0,Suma Shivaprasad,2015-05-06 16:32:38+05:18,['bbc46662255208dcded3d6b1cdc8a62bc7004618'],24,33,57,369768,4,0,1,1,694
01ee72a3ccef99323c73d1796087f84080995a66,1,Shwetha GS,2015-05-06 16:32:39+05:18,['ab91112a91e870e7c9eb06dd076f9d468abb5e16'],149,208,357,370125,9,0,0,1,694
91cfa6a6f4a15f3f95c1d01bd836510a63b6802e,0,Shwetha GS,2015-05-06 17:21:55+05:18,"['dd9a76b025a598d7d6c3789697be9738328db302', '01ee72a3ccef99323c73d1796087f84080995a66']",174,229,403,370528,11,,,,694
5a86e50e268702ed0327ee37b6a5a4337c905beb,0,Suma Shivaprasad,2015-05-06 21:51:02+05:18,['074211dbd0db37cefa4d40203241b6399b2d5f4d'],2,0,2,370530,1,,,,694
6b744bc26018362b0f5c43c21a6c28e55d23fd5a,1,Suma Shivaprasad,2015-05-07 10:51:40+05:18,['5a86e50e268702ed0327ee37b6a5a4337c905beb'],10,15,25,370555,1,0.333333333,0.333333333,1,694
cb5f3d407029f2c4b146e2386ef2c4596776e0df,0,Suma Shivaprasad,2015-05-07 10:55:09+05:18,['6b744bc26018362b0f5c43c21a6c28e55d23fd5a'],9,6,15,370570,3,,,,694
7d9294076b80f5e1915bd9d78d87c302abf03e94,1,Suma Shivaprasad,2015-05-07 13:53:06+05:18,['cb5f3d407029f2c4b146e2386ef2c4596776e0df'],38,37,75,370645,4,1,1,0,694
635c51d68c5c84c29e7bb80fe1c95f3aaba1e27c,0,Suma Shivaprasad,2015-05-07 14:02:13+05:18,['7d9294076b80f5e1915bd9d78d87c302abf03e94'],3,3,6,370651,2,,,,694
2c65ac46bb19dc873d1e616d96a4a6e9feaa930a,1,Shwetha GS,2015-05-07 16:56:45+05:18,['01ee72a3ccef99323c73d1796087f84080995a66'],6,16,22,370673,4,0,1,1,694
bb3022b8e2cbbcedfec9796180241e4e531ae9f1,0,Suma S,2015-05-07 17:11:24+05:18,"['01ee72a3ccef99323c73d1796087f84080995a66', '2c65ac46bb19dc873d1e616d96a4a6e9feaa930a']",6,16,22,370695,4,,,,694
438688121370628ea0879bae748048867e44c05c,1,Jon Maron,2015-05-08 18:07:13-04:00,['bb3022b8e2cbbcedfec9796180241e4e531ae9f1'],64,1257,1321,372016,24,0.355285962,0.781629116,0.975736568,700
18f6aefd6be7fed41709b301dba341050c3c5a67,0,jmaron,2015-05-11 15:10:36-04:00,"['bb3022b8e2cbbcedfec9796180241e4e531ae9f1', '438688121370628ea0879bae748048867e44c05c']",64,1257,1321,373337,24,,,,700
bbf98001ac1e732e31bddd4e629cf0a32be1b73d,0,Jon Maron,2015-05-11 15:14:08-04:00,['18f6aefd6be7fed41709b301dba341050c3c5a67'],7,1,8,373345,2,,,,700
7b29331ef451988d6e8c567c133b4a0dc782fdb9,0,Jon Maron,2015-05-11 15:56:53-04:00,['91cfa6a6f4a15f3f95c1d01bd836510a63b6802e'],63,1250,1313,374658,24,0.355285962,0.781629116,0.975736568,706
6a0004ddb0479cacb6ffecffebd7002c7b39fbef,0,Suma Shivaprasad,2015-05-12 11:31:49+05:18,['635c51d68c5c84c29e7bb80fe1c95f3aaba1e27c'],1,1,2,374660,1,,,,706
b5bf5cd907b6c463995957f9ec92c52b325e6a4a,0,Suma Shivaprasad,2015-05-12 11:44:12+05:18,['6a0004ddb0479cacb6ffecffebd7002c7b39fbef'],2,2,4,374664,1,,,,706
0b13234217ffec5a7f2dce62c02e106911f93855,0,Aaron Niskode-Dossett,2015-05-12 11:39:28-05:00,['bbf98001ac1e732e31bddd4e629cf0a32be1b73d'],0,1,1,374665,1,,,,706
215d7400d20edf2807e809296d7149bb934c2073,0,Aaron Niskode-Dossett,2015-05-12 12:11:09-05:00,"['bbf98001ac1e732e31bddd4e629cf0a32be1b73d', '0b13234217ffec5a7f2dce62c02e106911f93855']",0,1,1,374666,1,,,,706
ed7d2bf06484c4bc3473eefae3b493da96515077,1,Harish Butani,2015-05-12 20:38:35-07:00,['215d7400d20edf2807e809296d7149bb934c2073'],70,109,179,374845,7,0.293103448,1,1,706
4e7d2b9b8b66e163c8d825d440afac92fa2d45c3,0,Harish Butani,2015-05-12 20:58:03-07:00,['7b29331ef451988d6e8c567c133b4a0dc782fdb9'],70,109,179,375024,7,0.293103448,1,1,706
d88cdbb25fb7f9cef1d3d9da1ca0a6216dfa4f74,0,Jon Maron,2015-05-13 10:12:57-04:00,['ed7d2bf06484c4bc3473eefae3b493da96515077'],3,7,10,375034,2,0,1,1,706
14089ea875fbedf363ad4bb6b54ce62d6e7316a3,0,Jon Maron,2015-05-13 10:13:26-04:00,['4e7d2b9b8b66e163c8d825d440afac92fa2d45c3'],3,7,10,375044,2,0,1,1,706
f3b8232db0653bba5f6421da881f9acc76e79783,0,Jon Maron,2015-05-13 13:59:50-04:00,['d88cdbb25fb7f9cef1d3d9da1ca0a6216dfa4f74'],2,2,4,375048,1,,,,706
c8115932644abf53e6f6f34bd5180a1e6dfb090e,0,Jon Maron,2015-05-13 14:00:16-04:00,['14089ea875fbedf363ad4bb6b54ce62d6e7316a3'],2,2,4,375052,1,,,,706
4543c8371e4cf70be7b4f54ff938fbb6a342cb49,1,Jon Maron,2015-05-13 17:38:49-04:00,['f3b8232db0653bba5f6421da881f9acc76e79783'],1,7,8,375060,1,1,1,1,706
75dad3000f9e41359955c11e33a239a801666c59,0,Jon Maron,2015-05-13 17:39:11-04:00,['c8115932644abf53e6f6f34bd5180a1e6dfb090e'],1,7,8,375068,1,1,1,1,706
8aeb64e32cf475e041b75084439944a323c3f69b,0,arpitgupta,2015-05-13 20:18:25-07:00,['c8115932644abf53e6f6f34bd5180a1e6dfb090e'],0,3,3,375071,1,,,,706
2bda3511bb2557fd31449cbf2593c15a0f0aa173,0,Suma Shivaprasad,2015-05-14 12:27:15+05:18,['4543c8371e4cf70be7b4f54ff938fbb6a342cb49'],2,4,6,375077,1,0.090909091,0.090909091,0,706
f73dab3e3f28fc6b7c20ceeea662cb61fcbb7abb,1,Shwetha GS,2015-05-14 15:02:06+05:18,['4543c8371e4cf70be7b4f54ff938fbb6a342cb49'],14,17,31,375108,5,1,1,1,706
6e0ae677131357cbfcd5cd4106e406e65d2d4828,0,Shwetha GS,2015-05-14 17:45:37+05:18,['4543c8371e4cf70be7b4f54ff938fbb6a342cb49'],45,55,100,375208,3,0.857142857,1,1,706
de1744606c0d7c9760c172d2e5fe87271993c868,0,Shwetha GS,2015-05-14 17:49:15+05:18,['f73dab3e3f28fc6b7c20ceeea662cb61fcbb7abb'],2,7,9,375217,1,1,1,1,706
0438f50d58f506a39d3048a67b2cd1d963a34b02,0,arpitgupta,2015-05-14 08:25:09-07:00,['8aeb64e32cf475e041b75084439944a323c3f69b'],1,2,3,375220,1,,,,706
5233657476570c7604c7252f4ca7542d9cf31655,0,arpitgupta,2015-05-14 08:25:24-07:00,['0438f50d58f506a39d3048a67b2cd1d963a34b02'],0,501,501,375721,7,0.467153285,0.605839416,0.897810219,713
104e71e8ee4b632ce0dbe737573d05f09673a066,0,arpitgupta,2015-05-14 08:29:48-07:00,['5233657476570c7604c7252f4ca7542d9cf31655'],1,0,1,375722,1,,,,713
b4b8079d599dd06241c804906d0e0bbcf081a0c5,0,arpitgupta,2015-05-14 09:03:34-07:00,['104e71e8ee4b632ce0dbe737573d05f09673a066'],1,2,3,375725,1,,,,713
0c3c5f4071769161279da1496cc0ed7b8ffcf3ea,0,arpitgupta,2015-05-14 09:39:30-07:00,['b4b8079d599dd06241c804906d0e0bbcf081a0c5'],3,63,66,375791,3,1,1,0.545454545,714
55e893d56215ad0be4565317828c4b339f2d005f,0,arpitgupta,2015-05-14 09:43:27-07:00,['0c3c5f4071769161279da1496cc0ed7b8ffcf3ea'],0,17,17,375808,1,,,,714
ac594b24814d1dd872cd703fd2d991185a40aacc,1,Aaron Dossett,2015-05-14 12:50:11-05:00,['4543c8371e4cf70be7b4f54ff938fbb6a342cb49'],20,27,47,375855,5,0.142857143,0.571428571,0.571428571,714
1cf48c3e1df9e2d257e46fdfc225d67fa93ef84a,1,Aaron Dossett,2015-05-14 12:50:11-05:00,['ac594b24814d1dd872cd703fd2d991185a40aacc'],19,21,40,375895,4,1,1,1,714
dfadd1a699802fccca649e3377467e3524c41431,0,Aaron Dossett,2015-05-14 12:50:11-05:00,['1cf48c3e1df9e2d257e46fdfc225d67fa93ef84a'],2,2,4,375899,1,,,,714
167671feb0333b7ddc431382b7be8c9506f27bc4,0,Aaron Dossett,2015-05-14 12:50:11-05:00,['dfadd1a699802fccca649e3377467e3524c41431'],2,2,4,375903,1,,,,714
c183b38cdecff45b0c820db4a1c7ce6478060b7e,0,Aaron Dossett,2015-05-14 12:50:11-05:00,['167671feb0333b7ddc431382b7be8c9506f27bc4'],1,1,2,375905,1,,,,714
e8fd5f7c3b9a45d5eb3820e2827860bc5ea4abed,0,Aaron Dossett,2015-05-14 12:50:11-05:00,['c183b38cdecff45b0c820db4a1c7ce6478060b7e'],1,1,2,375907,1,,,,714
3e0fa2dad38507221e0c3ad415f0901e32e520ee,0,Aaron Dossett,2015-05-14 12:50:11-05:00,['e8fd5f7c3b9a45d5eb3820e2827860bc5ea4abed'],2,2,4,375911,2,,,,714
71fc73fc1aeb6b82de93bef9d32d6a4377b061be,0,Aaron Dossett,2015-05-14 13:44:34-05:00,['3e0fa2dad38507221e0c3ad415f0901e32e520ee'],4,0,4,375915,1,,,,714
ca905722f1f74cf5aa7bdaef7d9bdf23a9e6127d,0,Aaron Niskode-Dossett,2015-05-14 13:49:09-05:00,"['4543c8371e4cf70be7b4f54ff938fbb6a342cb49', '71fc73fc1aeb6b82de93bef9d32d6a4377b061be']",45,50,95,376010,9,,,,714
f526e359a3e8d71ab62fb868923ca17c2fef1b4f,0,arpitgupta,2015-05-14 14:07:48-07:00,['55e893d56215ad0be4565317828c4b339f2d005f'],3,6,9,376019,1,1,1,1,714
eddb4480b259a1986d6c522cb30c1f978ce6e31d,0,Shwetha G S,2015-05-15 11:18:46+05:18,"['ca905722f1f74cf5aa7bdaef7d9bdf23a9e6127d', 'de1744606c0d7c9760c172d2e5fe87271993c868']",14,22,36,376055,5,,,,714
40e160bbc95f7d5ec2ad2beb88cd430b4f1c72a6,0,Suma S,2015-05-15 11:50:10+05:18,"['eddb4480b259a1986d6c522cb30c1f978ce6e31d', '6e0ae677131357cbfcd5cd4106e406e65d2d4828']",45,55,100,376155,3,,,,714
e4385af664d11e5896019f510e1d77eb866159fa,0,Shwetha G S,2015-05-15 11:53:16+05:18,"['40e160bbc95f7d5ec2ad2beb88cd430b4f1c72a6', '2bda3511bb2557fd31449cbf2593c15a0f0aa173']",2,4,6,376161,1,,,,714
dccadff34784576df3f1797faca648ff69d3ce83,1,Shwetha GS,2015-05-15 14:14:47+05:18,['de1744606c0d7c9760c172d2e5fe87271993c868'],22,59,81,376242,2,,,,714
0cf80d27c11cf7771412df2011a079b2fa6cb2ec,0,Shwetha GS,2015-05-15 14:26:20+05:18,['dccadff34784576df3f1797faca648ff69d3ce83'],8,9,17,376259,2,,,,714
4dbe5820040a80a19ca33c6ba2092b0790610b3e,0,Suma S,2015-05-15 14:27:23+05:18,"['e4385af664d11e5896019f510e1d77eb866159fa', '0cf80d27c11cf7771412df2011a079b2fa6cb2ec']",23,61,84,376343,3,,,,714
6a9193c79b137cfa76db5080fa69424594b8d2cf,0,Suma Shivaprasad,2015-05-15 14:27:54+05:18,"['b5bf5cd907b6c463995957f9ec92c52b325e6a4a', 'e4385af664d11e5896019f510e1d77eb866159fa']",391,1716,2107,378450,53,,,,714
f4547da345d2da3799c974b37f89e696b68d93bc,0,Suma S,2015-05-15 14:38:02+05:18,"['4dbe5820040a80a19ca33c6ba2092b0790610b3e', '6a9193c79b137cfa76db5080fa69424594b8d2cf']",130,121,251,378701,13,,,,714
252acd01cdd38976f2a28725564514257097e4c0,0,arpitgupta,2015-05-15 11:19:42-07:00,['f526e359a3e8d71ab62fb868923ca17c2fef1b4f'],33,201,234,378935,6,0.511363636,0.795454545,0.522727273,716
ae227ea93707f7e9934ccb4285260291da32bd62,0,arpitgupta,2015-05-15 11:25:47-07:00,['252acd01cdd38976f2a28725564514257097e4c0'],1,2,3,378938,1,,,,716
a98af5ecdb44a6be8430fc80338682699ad7cb02,0,Arpit Gupta,2015-05-15 17:16:22-07:00,"['75dad3000f9e41359955c11e33a239a801666c59', 'ae227ea93707f7e9934ccb4285260291da32bd62']",0,754,754,379692,11,,,,716
b82f8f92c751f422a0fa2c3d894b9321c1b5d8f0,0,arpitgupta,2015-05-16 10:04:58-07:00,['a98af5ecdb44a6be8430fc80338682699ad7cb02'],2,36,38,379730,3,,,,716
b2e0fe35559ba249222b4ee3f6b32dd58c93b913,0,arpitgupta,2015-05-18 16:18:03-07:00,['b82f8f92c751f422a0fa2c3d894b9321c1b5d8f0'],784,0,784,380514,10,0.457831325,0.289156627,0.265060241,716
54c3c7f055e84b3da571cf6446a00f76c5ac3cfd,1,Harish Butani,2015-05-18 18:17:25-07:00,['f4547da345d2da3799c974b37f89e696b68d93bc'],5,177,182,380696,5,0.619047619,1,0.761904762,716
26f3b76b8db68e8f414b6ccb5f6e25e9d219e092,0,Harish Butani,2015-05-18 18:28:34-07:00,['b2e0fe35559ba249222b4ee3f6b32dd58c93b913'],5,177,182,380878,5,0.619047619,1,0.761904762,716
1776b1f11876e6c1b2e891fcb667b42f52131ae6,1,Suma Shivaprasad,2015-05-19 15:47:25+05:18,['f4547da345d2da3799c974b37f89e696b68d93bc'],76,138,214,381092,10,0,1,0.870967742,716
1a536c2a4cbb72f074115b7a2be95aca5f4d478d,0,Suma Shivaprasad,2015-05-19 15:48:12+05:18,"['1776b1f11876e6c1b2e891fcb667b42f52131ae6', '54c3c7f055e84b3da571cf6446a00f76c5ac3cfd']",5,177,182,381274,5,,,,716
2f8fc054ae9016d1656c943132ec8d6c3b58f65b,1,Shwetha GS,2015-05-19 17:59:27+05:18,['54c3c7f055e84b3da571cf6446a00f76c5ac3cfd'],54,70,124,381398,4,0,0,0.8,716
9d2ce09bfeb3cee270bcbf95d15777f4dc49c6f6,0,Jon Maron,2015-05-19 15:00:52-04:00,['2f8fc054ae9016d1656c943132ec8d6c3b58f65b'],1,1,2,381400,1,,,,716
777978924ca5e30c6696d56292ad80e45e51e1ea,0,Jon Maron,2015-05-19 15:01:41-04:00,['26f3b76b8db68e8f414b6ccb5f6e25e9d219e092'],1,1,2,381402,1,,,,716
dec21146f46dd1f452e31b5660ddf1b530b6db72,1,Venkatesh Seetharam,2015-05-19 13:48:49-07:00,['9d2ce09bfeb3cee270bcbf95d15777f4dc49c6f6'],0,60,60,381462,1,,,,717
5becd8a5b2eb9d11f41152f50af40ec6233e007e,1,Venkatesh Seetharam,2015-05-19 16:13:43-07:00,['dec21146f46dd1f452e31b5660ddf1b530b6db72'],3,122,125,381587,3,0.3,1,1,717
5e815267a8e28ca014b576ebb5b9e1477cf172ff,0,Shwetha GS,2015-05-20 12:08:13+05:18,"['777978924ca5e30c6696d56292ad80e45e51e1ea', '2f8fc054ae9016d1656c943132ec8d6c3b58f65b']",319,400,719,382306,33,,,,717
5bc3501a1c89764c30adf6382dd34e9932bfc3d9,0,Shwetha GS,2015-05-20 13:30:26+05:18,"['5e815267a8e28ca014b576ebb5b9e1477cf172ff', '5becd8a5b2eb9d11f41152f50af40ec6233e007e']",3,182,185,382491,4,,,,717
9d50a245c0d1409c035ace09c5e13ae10b15e033,1,Suma Shivaprasad,2015-05-20 14:37:48+05:18,['54c3c7f055e84b3da571cf6446a00f76c5ac3cfd'],70,176,246,382737,6,1,1,1,717
93fed80a3b5d288e55b9787dea144a2726c0a18a,0,Suma Shivaprasad,2015-05-20 14:38:09+05:18,"['9d50a245c0d1409c035ace09c5e13ae10b15e033', '5becd8a5b2eb9d11f41152f50af40ec6233e007e']",58,253,311,383048,9,,,,717
e013e656165349cd5bacdff2b0a4b9a0c2c55a59,1,Suma Shivaprasad,2015-05-20 15:06:50+05:18,['1a536c2a4cbb72f074115b7a2be95aca5f4d478d'],17,16,33,383081,4,1,0,1,717
002a43ec9adc20d51024daeda749f2395c4f7b42,0,Suma Shivaprasad,2015-05-20 15:06:57+05:18,"['e013e656165349cd5bacdff2b0a4b9a0c2c55a59', '5becd8a5b2eb9d11f41152f50af40ec6233e007e']",58,253,311,383392,9,,,,717
c6a0787eabce902be1a099aafc95134fa7798283,0,Suma S,2015-05-20 15:09:46+05:18,"['5becd8a5b2eb9d11f41152f50af40ec6233e007e', '93fed80a3b5d288e55b9787dea144a2726c0a18a']",70,176,246,383638,6,,,,717
6ec3972ad0a6b784d25d7327930cefd105c1f02f,0,Suma Shivaprasad,2015-05-20 15:12:22+05:18,['002a43ec9adc20d51024daeda749f2395c4f7b42'],1,0,1,383639,1,1,0,1,717
a91e147b35696c8cc88706ba30a86c18e26678ad,1,Suma Shivaprasad,2015-05-20 15:14:51+05:18,['6ec3972ad0a6b784d25d7327930cefd105c1f02f'],1,1,2,383641,1,,,,717
6be1655023590a48edb105cac2dd6e9e801eb6d8,0,Suma Shivaprasad,2015-05-20 15:17:04+05:18,"['a91e147b35696c8cc88706ba30a86c18e26678ad', 'c6a0787eabce902be1a099aafc95134fa7798283']",75,181,256,383897,6,,,,717
fe107bbf56a4f5ae444bd7d9c32701a5fe9db65f,1,Suma Shivaprasad,2015-05-20 15:19:42+05:18,['6be1655023590a48edb105cac2dd6e9e801eb6d8'],7,7,14,383911,1,,,,717
9310e0bcc5480361829b48ce85f0c99295a1a754,1,Suma Shivaprasad,2015-05-20 15:37:56+05:18,['fe107bbf56a4f5ae444bd7d9c32701a5fe9db65f'],18,16,34,383945,2,,,,717
fc19d8bad38dd6f9446e5c500f9521a9e9878fe1,0,Suma Shivaprasad,2015-05-20 15:39:36+05:18,['9310e0bcc5480361829b48ce85f0c99295a1a754'],2,0,2,383947,1,,,,717
7794686b33d3ca506a0e0ea902664faf90f9d261,0,Suma Shivaprasad,2015-05-20 15:40:23+05:18,['fc19d8bad38dd6f9446e5c500f9521a9e9878fe1'],0,2,2,383949,1,,,,717
ac4c3080796e5ea74be7e4b9385e68cdca0f9317,0,Suma Shivaprasad,2015-05-20 16:46:14+05:18,['7794686b33d3ca506a0e0ea902664faf90f9d261'],18,11,29,383978,4,1,0,0,717
bd1567a768d7ee4bfd4c25e48f972140672ca6e4,0,Suma S,2015-05-20 16:48:45+05:18,"['c6a0787eabce902be1a099aafc95134fa7798283', 'ac4c3080796e5ea74be7e4b9385e68cdca0f9317']",79,130,209,384187,11,,,,717
be0ddddcae0b56e3623a07de3685f3104c6f998f,0,Jon Maron,2015-05-20 16:04:37-04:00,['bd1567a768d7ee4bfd4c25e48f972140672ca6e4'],7,13,20,384207,3,1,1,1,717
a7483feeed6cad17c28f386f0ae2d53698029436,0,Jon Maron,2015-05-20 16:05:04-04:00,['5bc3501a1c89764c30adf6382dd34e9932bfc3d9'],7,13,20,384227,3,1,1,1,717
58b6280eb7aa8e5f6d09209291643358d0a72116,0,rohitmpr,2015-05-21 08:39:08+05:18,['5becd8a5b2eb9d11f41152f50af40ec6233e007e'],2,2,4,384231,1,,,,717
223840c6a03cf184bb69bc7bcdf4eadd9f78ecac,0,Suma S,2015-05-21 12:24:59+05:18,"['a7483feeed6cad17c28f386f0ae2d53698029436', 'be0ddddcae0b56e3623a07de3685f3104c6f998f']",143,300,443,384674,13,,,,717
cd96e3ad38ab301aa6cd87bef5ba8bb01cb891c2,0,Shwetha GS,2015-05-21 16:59:04+05:18,['5becd8a5b2eb9d11f41152f50af40ec6233e007e'],7,46,53,384727,7,0.133333333,0.8,1,717
0893e742b38a31d3705d918c03aae69a13dec310,0,Shwetha GS,2015-05-21 17:02:30+05:18,['cd96e3ad38ab301aa6cd87bef5ba8bb01cb891c2'],2,2,4,384731,1,,,,717
01eaf5003498117d0b394c9ed661d5adfc56db51,1,Jon Maron,2015-05-21 13:31:18-04:00,['be0ddddcae0b56e3623a07de3685f3104c6f998f'],7,24,31,384762,3,0.923076923,1,1,717
6e9dbbe8a1b9509168107302eca4896aeeeb8b60,0,Jon Maron,2015-05-21 13:31:51-04:00,['223840c6a03cf184bb69bc7bcdf4eadd9f78ecac'],7,24,31,384793,3,0.923076923,1,1,717
a4d62eb70ce7a65f41f30d9a5656af2d038ce063,0,Vishal Kadam,2015-05-21 16:34:46-04:00,['58b6280eb7aa8e5f6d09209291643358d0a72116'],1,1,2,384795,1,,,,717
30ba5a0a060794df61d2c92a043bc9708e8d6b10,1,Suma Shivaprasad,2015-05-22 16:05:35+05:18,['be0ddddcae0b56e3623a07de3685f3104c6f998f'],15,24,39,384834,4,,,,717
01953121fc135eeec325222c7598d5cb5bb342f9,0,Suma Shivaprasad,2015-05-22 16:05:50+05:18,"['30ba5a0a060794df61d2c92a043bc9708e8d6b10', '01eaf5003498117d0b394c9ed661d5adfc56db51']",7,24,31,384865,3,,,,717
c58bdf36020e219d7175624abab108a1b85be02b,0,Suma Shivaprasad,2015-05-22 16:13:22+05:18,['01953121fc135eeec325222c7598d5cb5bb342f9'],3,3,6,384871,1,,,,717
9df2a228c8dcd828f92753834a69acfef45aa101,0,Suma Shivaprasad,2015-05-22 16:33:53+05:18,['c58bdf36020e219d7175624abab108a1b85be02b'],1,1,2,384873,1,,,,717
8954844c2bd1080833fa509387dfeb206aa938e5,0,Shwetha G S,2015-05-22 16:57:58+05:18,"['01eaf5003498117d0b394c9ed661d5adfc56db51', '9df2a228c8dcd828f92753834a69acfef45aa101']",11,20,31,384904,3,,,,717
c00f8de6e57e3b3432c2dbcd55ebb7328528dd70,0,Shwetha G S,2015-05-23 07:39:44+05:18,"['8954844c2bd1080833fa509387dfeb206aa938e5', '0893e742b38a31d3705d918c03aae69a13dec310']",7,46,53,384957,7,,,,717
529ebcf82e57b56942c1d4b5e7be90dccac1d11d,0,Suma S,2015-05-23 10:20:12+05:18,"['6e9dbbe8a1b9509168107302eca4896aeeeb8b60', 'c00f8de6e57e3b3432c2dbcd55ebb7328528dd70']",18,66,84,385041,9,,,,717
6e9be90b5f3a6267b2a06c1fe84ae972c4dd5c5f,0,Jon Maron,2015-05-23 06:23:04-04:00,['c00f8de6e57e3b3432c2dbcd55ebb7328528dd70'],1,1,2,385043,1,,,,717
c0106166c564382daef3e45c991601a9ca878c60,0,Jon Maron,2015-05-23 06:23:34-04:00,['529ebcf82e57b56942c1d4b5e7be90dccac1d11d'],1,1,2,385045,1,,,,717
114fa269faba2afc0d57a21b70e55594f6a1967a,0,Venkatesh Seetharam,2015-05-23 12:40:59-07:00,['6e9be90b5f3a6267b2a06c1fe84ae972c4dd5c5f'],17,19,36,385081,6,,,,717
36c73675e78ffac36c2ddece36f39a8d514b0e97,0,Venkatesh Seetharam,2015-05-23 21:04:37-07:00,['c0106166c564382daef3e45c991601a9ca878c60'],0,0,0,385081,1,,,,718
cee73f6ca9bee30ad8b29c9214edc7ffc1959659,0,Venkatesh Seetharam,2015-05-23 21:13:51-07:00,['36c73675e78ffac36c2ddece36f39a8d514b0e97'],17,19,36,385117,7,,,,718
40826d1466e39bd991caf7d1d4f0e2bd7a77c4d4,1,Shwetha GS,2015-05-24 13:20:57+05:18,['114fa269faba2afc0d57a21b70e55594f6a1967a'],435,143,578,385695,9,0.698198198,0.743243243,0.22972973,718
92ff97c6b1d92ba8dbe805fa6519180babb75120,0,Suma Shivaprasad,2015-05-24 16:09:27+05:18,['40826d1466e39bd991caf7d1d4f0e2bd7a77c4d4'],2,2,4,385699,1,,,,718
ba98137930b38d61a581ee1fe7ca09d7044dbdcf,0,Suma S,2015-05-25 09:38:00+05:18,"['40826d1466e39bd991caf7d1d4f0e2bd7a77c4d4', '92ff97c6b1d92ba8dbe805fa6519180babb75120']",2,2,4,385703,1,,,,718
93a16d2b466499bbb2d56fac13b83eb7dc317488,1,DarshanKumar,2015-05-25 13:54:48+05:18,['a4d62eb70ce7a65f41f30d9a5656af2d038ce063'],9,73,82,385785,7,1,1,0,719
58e013fc1cc89f6e93524df0627e62380f5a8623,0,Suma Shivaprasad,2015-05-25 14:31:17+05:18,['92ff97c6b1d92ba8dbe805fa6519180babb75120'],1,1,2,385787,1,,,,719
44c4519c72d43de888f73663b9b7aac5dc13d0c1,0,Suma S,2015-05-25 14:43:59+05:18,"['ba98137930b38d61a581ee1fe7ca09d7044dbdcf', '58e013fc1cc89f6e93524df0627e62380f5a8623']",1,1,2,385789,1,,,,719
e2392607f9f2be2915694bb41f10b2c4f4a0634d,1,Suma Shivaprasad,2015-05-25 17:58:09+05:18,['58e013fc1cc89f6e93524df0627e62380f5a8623'],3,21,24,385813,4,0.933333333,1,1,719
63fd0a25af40ecb7a9cb01e9dafe66129ad6c721,0,Suma S,2015-05-26 14:32:14+05:18,"['44c4519c72d43de888f73663b9b7aac5dc13d0c1', 'e2392607f9f2be2915694bb41f10b2c4f4a0634d']",3,21,24,385837,4,,,,719
113313e2b2f8a8a4f008a597481dc426ec5b9897,0,Suma S,2015-05-26 14:35:01+05:18,"['cee73f6ca9bee30ad8b29c9214edc7ffc1959659', '63fd0a25af40ecb7a9cb01e9dafe66129ad6c721']",441,167,608,386445,14,,,,719
c95c71b4a46ce8a57e6a52675dea71560837f06f,1,Suma Shivaprasad,2015-05-26 16:28:38+05:18,['e2392607f9f2be2915694bb41f10b2c4f4a0634d'],5,17,22,386467,1,0,1,1,719
1abeba456d1ff976f31aaf055c46445815f6bf4f,0,Shwetha G S,2015-05-26 16:41:43+05:18,"['63fd0a25af40ecb7a9cb01e9dafe66129ad6c721', 'c95c71b4a46ce8a57e6a52675dea71560837f06f']",5,17,22,386489,1,,,,719
3e695bade0a5daedb3812cd967f1f5182385dffc,1,Shwetha GS,2015-05-26 17:36:15+05:18,['1abeba456d1ff976f31aaf055c46445815f6bf4f'],153,316,469,386958,10,1,1,0.837837838,719
fa81143d993bc6b8714aecbc76806914e9ecc1fb,0,Shwetha G S,2015-05-26 17:37:16+05:18,"['1abeba456d1ff976f31aaf055c46445815f6bf4f', '3e695bade0a5daedb3812cd967f1f5182385dffc']",153,316,469,387427,10,,,,719
f7da366d3d2d25646c4f3f86a0b661455d893d93,1,Shwetha GS,2015-05-26 18:37:43+05:18,['fa81143d993bc6b8714aecbc76806914e9ecc1fb'],11,73,84,387511,7,0.407407407,1,1,719
f7d633de7cbfeb16ff63333240c7448f271a7c2d,0,Shwetha G S,2015-05-26 18:39:01+05:18,"['fa81143d993bc6b8714aecbc76806914e9ecc1fb', 'f7da366d3d2d25646c4f3f86a0b661455d893d93']",11,73,84,387595,7,,,,719
aa27c1bf339c1e480902770cfea283ff377c8cb2,1,Shwetha GS,2015-05-26 20:52:56+05:18,['f7d633de7cbfeb16ff63333240c7448f271a7c2d'],15,275,290,387885,9,1,1,0.807692308,721
43081eeeb3507c2f60c84188e795508eaa8defd8,0,Shwetha G S,2015-05-26 20:55:41+05:18,"['f7d633de7cbfeb16ff63333240c7448f271a7c2d', 'aa27c1bf339c1e480902770cfea283ff377c8cb2']",15,275,290,388175,9,,,,721
9728c6adad8fa21c24765abcfb33005b80cdaa0d,0,Jon Maron,2015-05-26 11:46:05-04:00,['43081eeeb3507c2f60c84188e795508eaa8defd8'],278,0,278,388453,5,,,,721
466338d98f3012619206a364d757028095cb3831,0,Jon Maron,2015-05-26 11:46:35-04:00,['113313e2b2f8a8a4f008a597481dc426ec5b9897'],278,0,278,388731,5,,,,721
d85002a2acd154ec0446e68da3d970fe70deb926,0,Suma S,2015-05-26 21:57:05+05:18,"['466338d98f3012619206a364d757028095cb3831', '9728c6adad8fa21c24765abcfb33005b80cdaa0d']",183,680,863,389594,24,,,,721
e74de9c769c8244b1d474740eb1c97bf9901191e,1,Suma Shivaprasad,2015-05-26 22:19:18+05:18,['c95c71b4a46ce8a57e6a52675dea71560837f06f'],26,37,63,389657,12,0.083333333,0.416666667,0.583333333,721
32fcfddc038fa80fe4eeeb1bc7371b0a56ad6c5e,0,Venkatesh Seetharam,2015-05-26 10:39:06-07:00,['d85002a2acd154ec0446e68da3d970fe70deb926'],0,5,5,389662,1,,,,721
d1a20a45085f693b3bb265490b1c9371bf58fb24,0,Venkatesh Seetharam,2015-05-26 10:39:58-07:00,['9728c6adad8fa21c24765abcfb33005b80cdaa0d'],0,5,5,389667,1,,,,721
9f28c42287c9d9b7d9ce4b7db611a07266230ab5,0,Jon Maron,2015-05-26 15:13:57-04:00,['d1a20a45085f693b3bb265490b1c9371bf58fb24'],1,1,2,389669,1,,,,721
247a4d0907f2a686bf787ded439345f8ad9c69ee,0,Jon Maron,2015-05-26 15:14:51-04:00,['32fcfddc038fa80fe4eeeb1bc7371b0a56ad6c5e'],1,1,2,389671,1,,,,721
cf0342a4ba407e618673fa83afdebd5d16da61ba,0,arpitgupta,2015-05-26 13:35:59-07:00,['247a4d0907f2a686bf787ded439345f8ad9c69ee'],4,10,14,389685,3,1,1,0.5,721
bb9c1e108b2f1751a9e8f50457edd4379407c69f,0,Venkatesh Seetharam,2015-05-26 13:45:05-07:00,['9f28c42287c9d9b7d9ce4b7db611a07266230ab5'],11,7,18,389703,1,1,0,1,721
fe30c2c07f896739e11eb7e47d08da99de2ead54,0,Venkatesh Seetharam,2015-05-26 13:45:32-07:00,['247a4d0907f2a686bf787ded439345f8ad9c69ee'],11,7,18,389721,1,1,0,1,721
ef9a07ab3aca424294c08798a76e7c187f15e3fa,0,Jon Maron,2015-05-26 16:46:25-04:00,['bb9c1e108b2f1751a9e8f50457edd4379407c69f'],3,3,6,389727,3,,,,721
b3ef6f22e7fcb7bfaf470521399443ac03478d4c,0,Jon Maron,2015-05-26 16:47:05-04:00,['fe30c2c07f896739e11eb7e47d08da99de2ead54'],3,3,6,389733,3,,,,721
0ee43c5e9f3c98fb7679c53d7e5f8ed7867a4283,0,Arpit Gupta,2015-05-26 13:53:32-07:00,"['b3ef6f22e7fcb7bfaf470521399443ac03478d4c', 'cf0342a4ba407e618673fa83afdebd5d16da61ba']",4,10,14,389747,3,,,,721
28d8ab4bef5e0e6b7f59e4fb12c528df81b99bd1,1,arpitgupta,2015-05-26 13:54:07-07:00,['ef9a07ab3aca424294c08798a76e7c187f15e3fa'],4,10,14,389761,3,1,1,0.5,721
c33e5acdffe317b56fb375aa4e19fd683c3f0afc,0,Harish Butani,2015-05-26 14:21:55-07:00,['0ee43c5e9f3c98fb7679c53d7e5f8ed7867a4283'],2,117,119,389880,4,0,0.867924528,1,722
7bf187a8e51943bef64017a5adc34befbb92fd62,0,Harish Butani,2015-05-26 14:30:40-07:00,['28d8ab4bef5e0e6b7f59e4fb12c528df81b99bd1'],2,117,119,389999,4,0,0.867924528,1,723
6fd729f44cf3dcc39ee503137c5679ebb95655d6,0,Venkatesh Seetharam,2015-05-26 16:50:03-07:00,['7bf187a8e51943bef64017a5adc34befbb92fd62'],7,101,108,390107,3,,,,724
3938e4dee639eb08aaba06f4334bca6bca04a38b,0,Venkatesh Seetharam,2015-05-26 16:51:31-07:00,['c33e5acdffe317b56fb375aa4e19fd683c3f0afc'],7,101,108,390215,3,,,,725
43759e75621c224627a93a8c71971fe6c4f6df5a,0,Harish Butani,2015-05-26 18:12:55-07:00,['3938e4dee639eb08aaba06f4334bca6bca04a38b'],0,18,18,390233,1,,,,725
59b4c32d80a9f6d4781872604b98333cd16c1926,0,Harish Butani,2015-05-26 18:13:44-07:00,['6fd729f44cf3dcc39ee503137c5679ebb95655d6'],0,18,18,390251,1,,,,725
b9e4d865712ddb3590e7cfacc1fb0bb13311d209,0,Suma S,2015-05-27 11:47:35+05:18,"['59b4c32d80a9f6d4781872604b98333cd16c1926', 'e74de9c769c8244b1d474740eb1c97bf9901191e']",26,37,63,390314,12,,,,725
1bc9ad9ce9d8a78dd99651f83d3dc486a5f1896f,0,Suma S,2015-05-27 11:50:33+05:18,"['43759e75621c224627a93a8c71971fe6c4f6df5a', 'b9e4d865712ddb3590e7cfacc1fb0bb13311d209']",26,37,63,390377,12,,,,725
1b5d4260249c7e421835d6de4c276c087102c8b4,1,Shwetha GS,2015-05-27 14:04:58+05:18,['aa27c1bf339c1e480902770cfea283ff377c8cb2'],6,36,42,390419,2,0.227272727,1,1,725
5e78203da5b1e98885d61cdc0c1bc9e78054706b,0,Suma S,2015-05-27 14:08:27+05:18,"['b9e4d865712ddb3590e7cfacc1fb0bb13311d209', '1b5d4260249c7e421835d6de4c276c087102c8b4']",6,36,42,390461,2,,,,725
fbf782a2f81838334c08c9fe6afd1cb5c3030cac,0,Suma Shivaprasad,2015-05-27 15:32:21+05:18,['b9e4d865712ddb3590e7cfacc1fb0bb13311d209'],10,31,41,390502,7,0.888888889,1,1,725
27fb8eebc33e40dc60c1b331c69225aaa9207290,1,Suma Shivaprasad,2015-05-27 15:33:25+05:18,['b9e4d865712ddb3590e7cfacc1fb0bb13311d209'],10,26,36,390538,7,0.8,1,1,725
6ba3c963da8e14b4b19b59a91095465403c00453,0,Suma Shivaprasad,2015-05-27 15:33:53+05:18,"['27fb8eebc33e40dc60c1b331c69225aaa9207290', '5e78203da5b1e98885d61cdc0c1bc9e78054706b']",6,36,42,390580,2,,,,725
2a436f2378bc84870231458a6d9fdb8cf5c91ad4,0,Suma Shivaprasad,2015-05-27 15:35:32+05:18,"['6ba3c963da8e14b4b19b59a91095465403c00453', 'fbf782a2f81838334c08c9fe6afd1cb5c3030cac']",0,0,0,390580,0,,,,725
0b880eb4d694a0a8fbc9ea7560adac3174383a8c,0,Shwetha G S,2015-05-27 15:47:09+05:18,"['5e78203da5b1e98885d61cdc0c1bc9e78054706b', '2a436f2378bc84870231458a6d9fdb8cf5c91ad4']",10,26,36,390616,7,,,,725
fed7af934d3a307a64df7a61b6252c150ed8937d,0,Harish Butani,2015-05-27 09:15:31-07:00,['1bc9ad9ce9d8a78dd99651f83d3dc486a5f1896f'],0,7,7,390623,1,,,,725
f2b81b65c30f09a14a4896e830bc00332d8147ef,1,Harish Butani,2015-05-27 09:16:29-07:00,['0b880eb4d694a0a8fbc9ea7560adac3174383a8c'],0,7,7,390630,1,,,,725
8242de3084c10cb90b7c9d347c82e9b26c46bfee,1,Shwetha GS,2015-05-27 23:08:30+05:18,['f2b81b65c30f09a14a4896e830bc00332d8147ef'],8,9,17,390647,2,0.5,1,1,725
a2a739a5a1a07c3353f0e0f24bb1abcbf45cca45,0,Shwetha GS,2015-05-27 23:08:53+05:18,['fed7af934d3a307a64df7a61b6252c150ed8937d'],8,9,17,390664,2,0.5,1,1,725
900b3a51326c192ad82109bc8f07bcd5cf3a3f22,1,Venkatesh Seetharam,2015-05-27 11:02:54-07:00,['8242de3084c10cb90b7c9d347c82e9b26c46bfee'],1,102,103,390767,3,0.315068493,1,1,725
58e1d1886cd1a1525499f244f2638ef56aa1f26e,0,Venkatesh Seetharam,2015-05-27 11:03:55-07:00,['a2a739a5a1a07c3353f0e0f24bb1abcbf45cca45'],1,102,103,390870,3,0.315068493,1,1,725
3b9e1b2fb2d70ac9fbe44e80ece509f59868dede,0,Jon Maron,2015-05-27 15:17:56-04:00,['900b3a51326c192ad82109bc8f07bcd5cf3a3f22'],0,36,36,390906,1,,,,726
d3c05341d9f3741ee0f06e924643a9ff633f7cab,0,Jon Maron,2015-05-27 15:18:27-04:00,['58e1d1886cd1a1525499f244f2638ef56aa1f26e'],0,36,36,390942,1,,,,727
58ea465064622cb163746759f65a31c304b82eb6,0,Suma S,2015-05-28 12:26:00+05:18,"['d3c05341d9f3741ee0f06e924643a9ff633f7cab', '3b9e1b2fb2d70ac9fbe44e80ece509f59868dede']",16,62,78,391020,8,,,,727
fbf32c033097146d1ccb0cb5db889bdd0b9f8064,1,Suma Shivaprasad,2015-05-28 15:16:35+05:18,['0b880eb4d694a0a8fbc9ea7560adac3174383a8c'],40,48,88,391108,4,0,0,1,727
08af18addf0d6d550b526c9019abf02a9e7bd549,0,Suma Shivaprasad,2015-05-28 15:16:42+05:18,"['fbf32c033097146d1ccb0cb5db889bdd0b9f8064', '3b9e1b2fb2d70ac9fbe44e80ece509f59868dede']",9,154,163,391271,7,,,,727
d2fba3b42cb14eb5e6d9962ce145c4577e59b211,1,Suma Shivaprasad,2015-05-28 15:33:53+05:18,['08af18addf0d6d550b526c9019abf02a9e7bd549'],12,14,26,391297,1,,,,727
087a715605965a7e48364e03a719213564b4a4ba,1,Venkatesh Seetharam,2015-05-28 14:38:45-07:00,['3b9e1b2fb2d70ac9fbe44e80ece509f59868dede'],30,59,89,391386,5,1,1,0.777777778,727
0d74787e484091ca683209dd9a9a735289b6bb8d,0,Venkatesh Seetharam,2015-05-28 14:39:54-07:00,['58ea465064622cb163746759f65a31c304b82eb6'],30,59,89,391475,5,1,1,0.777777778,727
456a80961163a42229090e126d3face87fca6a51,0,Harish Butani,2015-05-28 15:24:06-07:00,['0d74787e484091ca683209dd9a9a735289b6bb8d'],0,24,24,391499,1,0,1,1,727
479b58a9f38c082b89f2db3bf38a3c16edcd6d05,0,Harish Butani,2015-05-28 15:24:59-07:00,['087a715605965a7e48364e03a719213564b4a4ba'],0,24,24,391523,1,0,1,1,727
cb6583e6972af3ae4cd502285333f5424b405451,0,Harish Butani,2015-05-28 17:29:31-07:00,['479b58a9f38c082b89f2db3bf38a3c16edcd6d05'],30,22,52,391575,3,1,1,0,727
1c90177fa71e4b892834f950d9eee5801d765c7d,0,Harish Butani,2015-05-28 17:30:10-07:00,['456a80961163a42229090e126d3face87fca6a51'],30,22,52,391627,3,1,1,0,727
a992f12e1d345f6f4c7a0a5dd6a7b80ccf640b70,1,Vishal Kadam,2015-05-29 00:35:46-04:00,['cb6583e6972af3ae4cd502285333f5424b405451'],2,2,4,391631,1,,,,727
c0e1e99a3c9a0d7c06a313285388f49ae95a94e3,1,Vishal Kadam,2015-05-29 00:35:46-04:00,['a992f12e1d345f6f4c7a0a5dd6a7b80ccf640b70'],1,1,2,391633,1,,,,727
ccccd8611098fe2afa0d470995849456ef2516af,0,Vishal Kadam,2015-05-29 00:35:46-04:00,['c0e1e99a3c9a0d7c06a313285388f49ae95a94e3'],9,73,82,391715,7,1,1,0,728
208b2bf1fcfc81122f9582dcf0298cc7bcfc6281,1,Vishal Kadam,2015-05-29 00:35:46-04:00,['ccccd8611098fe2afa0d470995849456ef2516af'],50,280,330,392045,25,1,1,1,738
94ed0809a7e0e3b7486672da26115f741650f82a,0,Vishal Kadam,2015-05-29 00:35:46-04:00,['208b2bf1fcfc81122f9582dcf0298cc7bcfc6281'],2,36,38,392083,3,1,1,0.9,738
0f1c94d00c79759bb3ba5af9d06d4de015dcdd04,0,Vishal Kadam,2015-05-29 00:42:20-04:00,['94ed0809a7e0e3b7486672da26115f741650f82a'],5,26,31,392114,2,,,,738
a10b34d1b1096cc94707e271f68e17c78bfae225,0,Vishal Kadam,2015-05-29 00:42:20-04:00,['0f1c94d00c79759bb3ba5af9d06d4de015dcdd04'],8,39,47,392161,3,1,1,0.5,738
333a141e061769f374e21ec10f55c3624249bfb2,1,Vishal Kadam,2015-05-29 00:42:20-04:00,['a10b34d1b1096cc94707e271f68e17c78bfae225'],11,27,38,392199,4,0,1,0.6,738
1541ec7ff1d3f58405e13481d516740704f3c830,0,Vishal Kadam,2015-05-29 00:42:20-04:00,['333a141e061769f374e21ec10f55c3624249bfb2'],171,204,375,392574,5,0,1,0,739
8c9d1a5af9f2374d18203a0bd21f45211a945f1e,0,Vishal Kadam,2015-05-29 00:44:42-04:00,['1541ec7ff1d3f58405e13481d516740704f3c830'],0,17,17,392591,1,1,1,0.692307692,740
75447595938a4048453c7f1e5ab2ff8f8aedae7f,0,Vishal Kadam,2015-05-29 00:44:43-04:00,['8c9d1a5af9f2374d18203a0bd21f45211a945f1e'],6,33,39,392630,2,,,,740
abbec78416bfca914e33035f2534c07c72f86249,0,Vishal Kadam,2015-05-29 00:44:43-04:00,['75447595938a4048453c7f1e5ab2ff8f8aedae7f'],21,2,23,392653,2,0,0,0.285714286,740
5b415fe0e5e6e3e1908314b9a859e99d87f0deed,1,Vishal Kadam,2015-05-29 00:44:43-04:00,['abbec78416bfca914e33035f2534c07c72f86249'],2,25,27,392680,2,,,,740
e8276c192f027d46a02131b881f0298bd65ae15c,0,Shwetha GS,2015-05-29 11:23:15+05:18,['1c90177fa71e4b892834f950d9eee5801d765c7d'],0,4,4,392684,1,1,1,1,740
a107508929fd1eb013ebf16f1b35fc8d4e6fc487,1,Shwetha GS,2015-05-29 11:24:11+05:18,['cb6583e6972af3ae4cd502285333f5424b405451'],0,4,4,392688,1,1,1,1,740
d0ce7d60d82532f40dfea33506b635ff3017fc25,1,Venkatesh Seetharam,2015-05-28 23:22:20-07:00,['a107508929fd1eb013ebf16f1b35fc8d4e6fc487'],44,91,135,392823,4,,,,740
c4a7d6f7baa9c3f144bbdc4385dabc13fe629113,0,Venkatesh Seetharam,2015-05-28 23:23:49-07:00,['e8276c192f027d46a02131b881f0298bd65ae15c'],44,91,135,392958,4,,,,740
84c8636d03cc9d8bd3e90e34a25597e43e31f9c8,0,Shwetha G S,2015-05-29 11:51:03+05:18,"['d0ce7d60d82532f40dfea33506b635ff3017fc25', 'd2fba3b42cb14eb5e6d9962ce145c4577e59b211']",52,62,114,393072,4,,,,740
e3935d5f8f0b878143b968fb53845515a2d68fd0,1,Shwetha GS,2015-05-29 16:33:14+05:18,['84c8636d03cc9d8bd3e90e34a25597e43e31f9c8'],128,179,307,393379,9,0.375,1,0.25,742
b90fbdd95967c13edfcf0123fa0a3f4a5267250b,0,Shwetha GS,2015-05-29 16:45:09+05:18,['e3935d5f8f0b878143b968fb53845515a2d68fd0'],1,1,2,393381,1,,,,742
4e1e84b162178cd6e5c286da12228e027f3cf491,0,Shwetha G S,2015-05-29 16:46:27+05:18,"['84c8636d03cc9d8bd3e90e34a25597e43e31f9c8', 'b90fbdd95967c13edfcf0123fa0a3f4a5267250b']",128,179,307,393688,9,,,,742
deaf31640a7f0c6b42ccc10bad1bd1cdd955220e,1,Suma Shivaprasad,2015-05-29 16:56:34+05:18,['d2fba3b42cb14eb5e6d9962ce145c4577e59b211'],24,64,88,393776,5,0,1,1,742
25a68075029cd6c7a7b7ca01ded80d171f3cba1b,0,Shwetha G S,2015-05-29 16:59:38+05:18,"['4e1e84b162178cd6e5c286da12228e027f3cf491', 'deaf31640a7f0c6b42ccc10bad1bd1cdd955220e']",24,64,88,393864,5,,,,742
018bbd626df3d2faa464ab9ab5d0399033196185,1,Suma Shivaprasad,2015-05-29 17:00:56+05:18,['deaf31640a7f0c6b42ccc10bad1bd1cdd955220e'],29,35,64,393928,1,0.2,0,0,742
80674f0a2a25060897b0315fb9bf3649550a87cc,0,Suma Shivaprasad,2015-05-29 17:11:54+05:18,"['018bbd626df3d2faa464ab9ab5d0399033196185', '25a68075029cd6c7a7b7ca01ded80d171f3cba1b']",232,379,611,394539,23,,,,742
b4f4221bc9aca711cf49d1f76e5c8bdb74b047a1,0,Suma Shivaprasad,2015-05-29 17:14:13+05:18,['80674f0a2a25060897b0315fb9bf3649550a87cc'],6,0,6,394545,1,,,,742
ca728273eaab402833ebd9f37061cb5f3e1c6c2d,0,Shwetha G S,2015-05-29 17:23:25+05:18,"['25a68075029cd6c7a7b7ca01ded80d171f3cba1b', 'b4f4221bc9aca711cf49d1f76e5c8bdb74b047a1']",29,29,58,394603,1,,,,742
e6c741b4c1c089005bccad67c8fdde3fcf1d33f9,1,Shwetha GS,2015-05-29 19:18:43+05:18,['4e1e84b162178cd6e5c286da12228e027f3cf491'],16,19,35,394638,2,0,1,0,742
d86caa89c2286b7a3c8e696c099be2cfbd40ba51,0,Suma S,2015-05-29 19:31:16+05:18,"['ca728273eaab402833ebd9f37061cb5f3e1c6c2d', 'e6c741b4c1c089005bccad67c8fdde3fcf1d33f9']",16,19,35,394673,2,,,,742
7cf0db5bd0154589e4fd9a4a8d7858bbd49cab9b,0,Shwetha GS,2015-05-29 19:54:26+05:18,"['c4a7d6f7baa9c3f144bbdc4385dabc13fe629113', 'd86caa89c2286b7a3c8e696c099be2cfbd40ba51']",249,353,602,395275,17,,,,742
7843e2aee2d8222063f5c843e17d65b859ad7cb8,0,Venkatesh Seetharam,2015-05-29 11:50:14-07:00,['d86caa89c2286b7a3c8e696c099be2cfbd40ba51'],5,17,22,395297,1,,,,742
6b38df1c932b7c6cea68dea86fd32602e8186622,0,Venkatesh Seetharam,2015-05-29 11:50:38-07:00,['7cf0db5bd0154589e4fd9a4a8d7858bbd49cab9b'],5,17,22,395319,1,,,,742
4de5cfd04b71e1caac250b2f298333b75b7702ec,0,Venkatesh Seetharam,2015-05-29 15:28:01-07:00,['7843e2aee2d8222063f5c843e17d65b859ad7cb8'],19,103,122,395441,3,0.016949153,1,1,742
378ec6e668431ae55004d9d03049825732a7c357,0,Venkatesh Seetharam,2015-05-29 15:30:18-07:00,['6b38df1c932b7c6cea68dea86fd32602e8186622'],19,103,122,395563,3,0.016949153,1,1,742
5299b83750e243b22c40c39f431bfb4f66e055e6,1,babanb,2015-05-30 06:58:25+05:18,['93a16d2b466499bbb2d56fac13b83eb7dc317488'],252,609,861,396424,34,1,0,1,755
de0371f8e96936a374beffd81fcaf9bebf24b073,0,babanb,2015-05-30 07:01:13+05:18,['5299b83750e243b22c40c39f431bfb4f66e055e6'],6,6,12,396436,1,,,,755
dd61e708cba4be7a86e6563c7a7d84fa8f7df98c,1,babanb,2015-05-30 10:32:16+05:18,['de0371f8e96936a374beffd81fcaf9bebf24b073'],68,101,169,396605,12,0.612903226,1,0.903225806,755
1da516d2cef292682248d49d22612d9f1c48c8d8,1,Shwetha GS,2015-05-30 12:35:42+05:18,['4de5cfd04b71e1caac250b2f298333b75b7702ec'],40,64,104,396709,5,0.461538462,0.923076923,0.769230769,755
455abf46d49b763532d598102e9c2bd75fa981bd,0,Shwetha G S,2015-05-30 13:15:30+05:18,"['4de5cfd04b71e1caac250b2f298333b75b7702ec', '1da516d2cef292682248d49d22612d9f1c48c8d8']",40,64,104,396813,5,,,,755
6bc7f5c75c74d195f996b2f0d66715fc21b7d6d6,1,Shwetha GS,2015-05-30 15:21:41+05:18,['1da516d2cef292682248d49d22612d9f1c48c8d8'],16,24,40,396853,2,0,1,1,755
36a1f612329ccfd0a742d0cf61a48fb094025a5c,0,Suma S,2015-05-30 15:26:11+05:18,"['455abf46d49b763532d598102e9c2bd75fa981bd', '6bc7f5c75c74d195f996b2f0d66715fc21b7d6d6']",16,24,40,396893,2,,,,755
e4991a542b44af63b70ca64acee9b38516250570,1,Shwetha GS,2015-05-30 16:04:35+05:18,['6bc7f5c75c74d195f996b2f0d66715fc21b7d6d6'],53,165,218,397111,3,0.573033708,0.573033708,0.876404494,755
4789407518ae3aa923a379bfe358221f9193ac30,0,Suma S,2015-05-30 16:32:08+05:18,"['36a1f612329ccfd0a742d0cf61a48fb094025a5c', 'e4991a542b44af63b70ca64acee9b38516250570']",53,165,218,397329,3,,,,755
f7a24adbb253b6c32d64dc817d4ea2f4fe463132,1,Shwetha GS,2015-05-30 16:48:18+05:18,['e4991a542b44af63b70ca64acee9b38516250570'],15,23,38,397367,3,0.666666667,0.666666667,0.5,755
971ea90faea3812fd38875c24d35e756209fe57a,0,Suma S,2015-05-30 16:56:44+05:18,"['4789407518ae3aa923a379bfe358221f9193ac30', 'f7a24adbb253b6c32d64dc817d4ea2f4fe463132']",15,23,38,397405,3,,,,755
9e79cd945b25a18b175f290a8a258a501c292cff,0,Shwetha GS,2015-05-30 17:10:15+05:18,['378ec6e668431ae55004d9d03049825732a7c357'],40,64,104,397509,5,0.461538462,0.923076923,0.769230769,755
381bc538d771d7cf31ac0faca13a5f318770b116,0,Shwetha GS,2015-05-30 17:10:15+05:18,['9e79cd945b25a18b175f290a8a258a501c292cff'],16,24,40,397549,2,0,1,1,755
45c2251405b7a58410369107b0f41eadadd3adf9,1,Shwetha GS,2015-05-30 17:10:15+05:18,['381bc538d771d7cf31ac0faca13a5f318770b116'],53,165,218,397767,3,0.573033708,0.573033708,0.876404494,755
fee7c5cc2ec4f514d686a16be59c3057d22b27c5,0,Shwetha GS,2015-05-30 17:10:16+05:18,['45c2251405b7a58410369107b0f41eadadd3adf9'],15,23,38,397805,3,0.666666667,0.666666667,0.5,755
6b9acc52a335b523a50e9ab5ebdf8ca6d2766ad2,1,dileep bhimineni,2015-05-30 16:04:43-04:00,['5b415fe0e5e6e3e1908314b9a859e99d87f0deed'],34,65,99,397904,4,0.178571429,1,0.964285714,755
4f38b829b6ed2545ea89c04b64c1f350341578c4,1,dileep bhimineni,2015-05-30 16:26:16-04:00,['6b9acc52a335b523a50e9ab5ebdf8ca6d2766ad2'],6,14,20,397924,1,0.714285714,1,0.571428571,755
cbf662db026a9a85994006a5e3c6812bb2682ffc,1,dileep bhimineni,2015-05-30 22:23:02-04:00,['4f38b829b6ed2545ea89c04b64c1f350341578c4'],8,1,9,397933,1,0.5,0,0.166666667,755
9cea4f64a8a13147daea83df927520ba474cbfec,0,dileep bhimineni,2015-05-30 23:52:23-04:00,"['dd61e708cba4be7a86e6563c7a7d84fa8f7df98c', 'cbf662db026a9a85994006a5e3c6812bb2682ffc']",1252,1974,3226,401159,102,,,,755
41c81145e03b18e4085ee097f8fc155fbb5df15a,0,dileep8014,2015-05-31 09:58:55+05:18,"['cbf662db026a9a85994006a5e3c6812bb2682ffc', '9cea4f64a8a13147daea83df927520ba474cbfec']",251,262,513,401672,22,,,,755
6740d6bb668686d16759bc1be7a40ad1303d4fbd,0,dileep bhimineni,2015-05-31 12:45:15-04:00,['9cea4f64a8a13147daea83df927520ba474cbfec'],12,8,20,401692,7,0,0,0,755
017c0f72a20f103fa2a2383a5e19bfbe65db48fc,0,dileep8014,2015-05-31 22:48:09+05:18,"['41c81145e03b18e4085ee097f8fc155fbb5df15a', '6740d6bb668686d16759bc1be7a40ad1303d4fbd']",12,8,20,401712,7,,,,755
3bf027b7aabad8cc09273444f82480b6a9013174,0,dileep bhimineni,2015-05-31 12:59:22-04:00,['017c0f72a20f103fa2a2383a5e19bfbe65db48fc'],1,1,2,401714,1,,,,755
1f03b1ae0dd207c031f492958f3cd5cd82f4f8be,1,Vishal Kadam,2015-05-31 23:21:48-04:00,['3bf027b7aabad8cc09273444f82480b6a9013174'],22,26,48,401762,7,1,1,1,755
365f6e26e3e171e3ba15ad6b5749e88974e3d6f1,1,Vishal Kadam,2015-06-01 02:05:42-04:00,['1f03b1ae0dd207c031f492958f3cd5cd82f4f8be'],153,117,270,402032,14,0.878787879,1,1,756
fbb7582c411cd0b72e779eebfeaafdfed4ca5300,1,dileep bhimineni,2015-06-01 02:20:02-04:00,['365f6e26e3e171e3ba15ad6b5749e88974e3d6f1'],8,22,30,402062,7,0.916666667,1,0.916666667,756
3f08d7e2f713f92da8cd7ef5b052433f5865823a,1,Shwetha GS,2015-06-01 14:16:15+05:18,['971ea90faea3812fd38875c24d35e756209fe57a'],2,5,7,402069,2,1,1,1,756
40e0d41ea99f90b31cbad715b9aa684069fd7263,0,Shwetha GS,2015-06-01 14:27:19+05:18,['3f08d7e2f713f92da8cd7ef5b052433f5865823a'],1,4,5,402074,1,,,,756
812ee5baf6e73be202b48ef1ba6509bde5410c4f,0,Shwetha GS,2015-06-01 15:14:45+05:18,['40e0d41ea99f90b31cbad715b9aa684069fd7263'],14,2,16,402090,1,1,1,1,756
f7ce5a27154e155279faa3b16af9023807179ba4,1,dileep bhimineni,2015-06-01 11:31:18-04:00,['fbb7582c411cd0b72e779eebfeaafdfed4ca5300'],26,40,66,402156,5,0.133333333,0,0.133333333,756
fe28c00531b05f2e5c387e4f6ab1fb435c0b0514,1,Vishal Kadam,2015-06-01 13:30:00-04:00,['f7ce5a27154e155279faa3b16af9023807179ba4'],13,16,29,402185,5,1,1,1,756
4982dfeb9133b31a3e95b5e4335ba449d524f53b,0,Venkatesh Seetharam,2015-06-01 14:38:09-07:00,['812ee5baf6e73be202b48ef1ba6509bde5410c4f'],11,15,26,402211,1,0,1,1,756
a687d7666fa790ed93dc440e6a1b6d865235b71e,0,Venkatesh Seetharam,2015-06-01 14:39:53-07:00,['fee7c5cc2ec4f514d686a16be59c3057d22b27c5'],11,15,26,402237,1,0,1,1,756
3ccee8562740c2dfc6141f01202c9bc26d277568,0,Venkatesh Seetharam,2015-06-01 15:04:15-07:00,['a687d7666fa790ed93dc440e6a1b6d865235b71e'],3,8,11,402248,1,1,1,1,756
7de696cc1ff1348ce24581f5d7709538f75a8624,0,Venkatesh Seetharam,2015-06-01 15:04:41-07:00,['4982dfeb9133b31a3e95b5e4335ba449d524f53b'],3,8,11,402259,1,1,1,1,756
cd0e3950dcf391c0654a74e4359fcc727b17ae92,0,Shwetha GS,2015-06-02 11:46:01+05:18,"['3ccee8562740c2dfc6141f01202c9bc26d277568', '7de696cc1ff1348ce24581f5d7709538f75a8624']",17,11,28,402287,3,,,,756
9a32f180ccbe3dc958725b8dbd89e0c3990919a5,1,Shwetha GS,2015-06-02 14:08:41+05:18,['7de696cc1ff1348ce24581f5d7709538f75a8624'],10,28,38,402325,2,0.538461538,0,1,756
6dd20ef7de537aebac29f4bd52d6dadbd0f16209,0,Suma S,2015-06-02 14:14:22+05:18,"['7de696cc1ff1348ce24581f5d7709538f75a8624', '9a32f180ccbe3dc958725b8dbd89e0c3990919a5']",10,28,38,402363,2,,,,756
44c4a289e78416155bdbdfd5f0b8376100210a89,1,Suma Shivaprasad,2015-06-02 19:27:01+05:18,['6dd20ef7de537aebac29f4bd52d6dadbd0f16209'],20,29,49,402412,6,0.166666667,0.666666667,0.833333333,756
4f7e672cd828502c10821d18d2543f6685d9de1d,0,Suma Shivaprasad,2015-06-02 20:50:45+05:18,['44c4a289e78416155bdbdfd5f0b8376100210a89'],0,5,5,402417,1,0,1,1,756
74c54aa9bc9c614fa7c166c6e35c73ffeb4676f3,0,Arpit Gupta,2015-06-02 13:22:53-07:00,"['6dd20ef7de537aebac29f4bd52d6dadbd0f16209', '4f7e672cd828502c10821d18d2543f6685d9de1d']",20,34,54,402471,6,,,,756
5506e778f17a8bab28821d585b118e24b27dd1d8,0,arpitgupta,2015-06-02 13:23:33-07:00,"['cd0e3950dcf391c0654a74e4359fcc727b17ae92', '74c54aa9bc9c614fa7c166c6e35c73ffeb4676f3']",30,62,92,402563,6,,,,756
a94aa21a2773c9981aa4a30493fd0c1b01f55a5b,0,Venkatesh Seetharam,2015-06-02 16:02:19-07:00,['74c54aa9bc9c614fa7c166c6e35c73ffeb4676f3'],21,2,23,402586,5,,,,756
b4d8ae344530cacf65d6de02fab396472cdae762,0,Venkatesh Seetharam,2015-06-02 16:03:24-07:00,['5506e778f17a8bab28821d585b118e24b27dd1d8'],21,2,23,402609,5,,,,756
8f64e6afc8fadda9eb25696b90088faeae724462,1,dileep bhimineni,2015-06-03 14:04:51-04:00,['fe28c00531b05f2e5c387e4f6ab1fb435c0b0514'],37,44,81,402690,2,0.9,1,1,756
bde6316c2d345813c02ba69446f4b40a07cb1079,1,Venkatesh Seetharam,2015-06-03 14:24:02-07:00,['a94aa21a2773c9981aa4a30493fd0c1b01f55a5b'],111,112,223,402913,15,0.1875,0,0,756
e643d510db9a4376a1e5341825225406eb28e0ba,0,Venkatesh Seetharam,2015-06-03 14:26:44-07:00,['bde6316c2d345813c02ba69446f4b40a07cb1079'],11,10,21,402934,2,,,,756
79f92b61c6571e22d11fc74e7f961beead64ada2,0,Venkatesh Seetharam,2015-06-03 14:30:06-07:00,['b4d8ae344530cacf65d6de02fab396472cdae762'],111,112,223,403157,15,0.1875,0,0,756
e1f5cb67bc48471d9aa1f9adff1accc388e4abef,0,Venkatesh Seetharam,2015-06-03 14:30:44-07:00,['79f92b61c6571e22d11fc74e7f961beead64ada2'],11,10,21,403178,2,,,,756
24c9b7b562a3fbe65f2f78f21316858df8c02d64,1,babanb,2015-06-04 09:00:13+05:18,['8f64e6afc8fadda9eb25696b90088faeae724462'],16,16,32,403210,2,,,,756
aea51890bf380cdaf904c69e967c5f784df8e7a9,0,Vishal Kadam,2015-06-04 00:04:50-04:00,"['8f64e6afc8fadda9eb25696b90088faeae724462', '24c9b7b562a3fbe65f2f78f21316858df8c02d64']",16,16,32,403242,2,,,,756
4942ebec35ae86aa27da0ec14311f275d72f2aa0,0,Venkatesh Seetharam,2015-06-03 21:41:25-07:00,['e643d510db9a4376a1e5341825225406eb28e0ba'],135,0,135,403377,2,1,0,0,756
9c96922ec4debe7b1cd847f47a18a26944887f4b,1,Venkatesh Seetharam,2015-06-03 21:41:46-07:00,['4942ebec35ae86aa27da0ec14311f275d72f2aa0'],6,122,128,403505,4,0.585365854,1,1,756
5b40e65445cd676d646321accfd69de9624cde16,0,Venkatesh Seetharam,2015-06-03 21:43:41-07:00,['e1f5cb67bc48471d9aa1f9adff1accc388e4abef'],135,0,135,403640,2,1,0,0,756
1ed4dee64a41cf1d37bd5cbcd89d012d74b79a7f,0,Venkatesh Seetharam,2015-06-03 21:44:24-07:00,['5b40e65445cd676d646321accfd69de9624cde16'],6,122,128,403768,4,0.585365854,1,1,756
2b4ffc4e358ddc306566c05f47cc41a3509b3251,0,Vishal Kadam,2015-06-04 01:14:56-04:00,['aea51890bf380cdaf904c69e967c5f784df8e7a9'],90,129,219,403987,3,1,1,1,756
8305460a2d5df4d5b8358dde3ac13c5f5e5f93c9,0,Suma Shivaprasad,2015-06-04 14:18:21+05:18,['4f7e672cd828502c10821d18d2543f6685d9de1d'],3,9,12,403999,5,1,0,0,756
ed6b9bf4532e276f3299c021168f90771109c003,0,Suma Shivaprasad,2015-06-04 14:18:51+05:18,"['8305460a2d5df4d5b8358dde3ac13c5f5e5f93c9', '9c96922ec4debe7b1cd847f47a18a26944887f4b']",280,242,522,404521,18,,,,756
2270d05fb0d1a6cb927f187b0fd9e338ced2c585,0,Shwetha G S,2015-06-04 14:30:02+05:18,"['9c96922ec4debe7b1cd847f47a18a26944887f4b', 'ed6b9bf4532e276f3299c021168f90771109c003']",3,9,12,404533,5,,,,756
21109f1e36c977d48143ce286df38710ad330c16,1,Shwetha GS,2015-06-04 16:27:27+05:18,['2270d05fb0d1a6cb927f187b0fd9e338ced2c585'],46,98,144,404677,4,0.848484848,0.848484848,1,756
6e9d6948e811485d4347b5d8dadd660724962941,0,Suma S,2015-06-04 16:33:32+05:18,"['2270d05fb0d1a6cb927f187b0fd9e338ced2c585', '21109f1e36c977d48143ce286df38710ad330c16']",46,98,144,404821,4,,,,756
5ff1cb16b173b82a634a187351426db0838f6974,0,Shwetha GS,2015-06-04 16:49:33+05:18,"['1ed4dee64a41cf1d37bd5cbcd89d012d74b79a7f', '6e9d6948e811485d4347b5d8dadd660724962941']",66,107,173,404994,8,,,,756
747266684ed5f495c861617399d73b337431c754,0,Suma Shivaprasad,2015-06-04 17:02:22+05:18,['ed6b9bf4532e276f3299c021168f90771109c003'],2,1,3,404997,1,,,,756
eff6c6ef498a38485ba7ac481fe371de81ee35e1,0,Suma Shivaprasad,2015-06-04 17:15:59+05:18,['747266684ed5f495c861617399d73b337431c754'],7,2,9,405006,2,0,0,0.333333333,756
3033474253097bea98917d348e60b9b0bd89f479,0,Venkatesh Seetharam,2015-06-04 11:47:12-07:00,['6e9d6948e811485d4347b5d8dadd660724962941'],3,4,7,405013,1,,,,756
17e473eb06f38607c0e414c252fdee374d924155,0,Venkatesh Seetharam,2015-06-04 11:47:45-07:00,['5ff1cb16b173b82a634a187351426db0838f6974'],5,6,11,405024,1,,,,756
5fce46d4e5c118d8150842336e151944c4aeaf58,0,arpitgupta,2015-06-04 12:10:10-07:00,['3033474253097bea98917d348e60b9b0bd89f479'],1,1,2,405026,1,,,,756
e142b83d8fa23474b41a2fbbd1cfd1e8f5545fad,1,DarshanKumar,2015-06-05 09:04:35+05:18,['2b4ffc4e358ddc306566c05f47cc41a3509b3251'],48,64,112,405138,7,0,0,0,757
6eb60f1e3fcb53022b1a97e73c67ba90557b1c2e,1,Vishal Kadam,2015-06-05 00:36:12-04:00,['e142b83d8fa23474b41a2fbbd1cfd1e8f5545fad'],103,84,187,405325,9,,,,757
57fa7b9a97e8be69aba9b64f762da1699f06c640,0,Vishal Kadam,2015-06-05 00:44:10-04:00,"['aea51890bf380cdaf904c69e967c5f784df8e7a9', '6eb60f1e3fcb53022b1a97e73c67ba90557b1c2e']",208,244,452,405777,14,,,,757
4d5970880775120ad2bf03b4856bb17e15611741,1,Vishal Kadam,2015-06-05 00:51:51-04:00,['57fa7b9a97e8be69aba9b64f762da1699f06c640'],4,12,16,405793,2,1,1,0.75,757
6272aa5c9373232e7c5fe0011c55123a0086d6cc,0,Vishal Kadam,2015-06-05 00:54:05-04:00,"['57fa7b9a97e8be69aba9b64f762da1699f06c640', '4d5970880775120ad2bf03b4856bb17e15611741']",4,12,16,405809,2,,,,757
ef2332efec48f8172a4d9c4a632b1033acef28de,1,Shwetha GS,2015-06-05 11:08:31+05:18,['5fce46d4e5c118d8150842336e151944c4aeaf58'],31,38,69,405878,7,1,1,1,757
3f6490c8bbeacdd6300de9456b465d6f48918597,0,Shwetha G S,2015-06-05 11:09:01+05:18,"['5fce46d4e5c118d8150842336e151944c4aeaf58', 'ef2332efec48f8172a4d9c4a632b1033acef28de']",31,38,69,405947,7,,,,757
93f34483973e5b8cf7b0eb08852c2f69eb3f1da6,0,Shwetha GS,2015-06-05 11:58:50+05:18,['ef2332efec48f8172a4d9c4a632b1033acef28de'],9,12,21,405968,2,0,1,1,757
f0682e416947d069e6aa9df70f4dac1a78b95e79,1,Venkatesh Seetharam,2015-06-04 23:43:51-07:00,['3f6490c8bbeacdd6300de9456b465d6f48918597'],39,146,185,406153,11,0.74137931,1,0.896551724,758
5f42bfcbcc02802a27126f632a01707e9bfd87bc,0,Venkatesh Seetharam,2015-06-04 23:45:07-07:00,['17e473eb06f38607c0e414c252fdee374d924155'],39,146,185,406338,11,0.74137931,1,0.896551724,759
ce61caae71a9456d4e48cbc5c151c3b019dd4796,0,Shwetha G S,2015-06-05 12:14:11+05:18,"['f0682e416947d069e6aa9df70f4dac1a78b95e79', '93f34483973e5b8cf7b0eb08852c2f69eb3f1da6']",9,12,21,406359,2,,,,759
271efbb9c6e28ecedd2d2c2871adcf5182d1f096,0,Venkatesh Seetharam,2015-06-04 23:58:29-07:00,['5f42bfcbcc02802a27126f632a01707e9bfd87bc'],0,3,3,406362,1,1,1,1,759
ec046d195ae2e96a078430bf69f0a795cbfdf41b,0,Venkatesh Seetharam,2015-06-04 23:59:07-07:00,['ce61caae71a9456d4e48cbc5c151c3b019dd4796'],0,3,3,406365,1,1,1,1,759
0dd414f29563b6151407a9a6fa6198eb410002b1,1,Shwetha GS,2015-06-05 15:04:42+05:18,['ec046d195ae2e96a078430bf69f0a795cbfdf41b'],150,91,241,406606,6,1,0.045454545,0.318181818,759
57c17116ba2ef026aa5eb7b936e904aa9bef0e71,0,Shwetha GS,2015-06-05 21:09:26+05:18,['271efbb9c6e28ecedd2d2c2871adcf5182d1f096'],8,12,20,406626,2,1,1,1,759
666d92e9192166bc20f1aa4f2594af4961be2ebc,0,Shwetha GS,2015-06-05 21:10:03+05:18,['ec046d195ae2e96a078430bf69f0a795cbfdf41b'],8,12,20,406646,2,1,1,1,759
5c3180ad80987aca04f4bb3b53506d79a66d851c,0,Shwetha GS,2015-06-05 21:21:15+05:18,"['57c17116ba2ef026aa5eb7b936e904aa9bef0e71', '666d92e9192166bc20f1aa4f2594af4961be2ebc']",41,51,92,406738,10,,,,759
3943a6402cf1d220c25b50db809caf371e1d9147,0,Venkatesh Seetharam,2015-06-05 11:44:41-07:00,['666d92e9192166bc20f1aa4f2594af4961be2ebc'],81,90,171,406909,10,,,,759
e688ca0fd32559d44e6c72daf64d6dda4d545e5f,0,Venkatesh Seetharam,2015-06-05 11:45:40-07:00,['5c3180ad80987aca04f4bb3b53506d79a66d851c'],82,91,173,407082,10,,,,759
6310fed15f90ddb620c41f9ef9f06c212442943c,1,Venkatesh Seetharam,2015-06-05 13:57:37-07:00,['3943a6402cf1d220c25b50db809caf371e1d9147'],12,30,42,407124,8,0,1,0.619047619,759
6de1b8454468f0b219408752f161ad56ac6e736c,0,Venkatesh Seetharam,2015-06-05 13:59:10-07:00,['e688ca0fd32559d44e6c72daf64d6dda4d545e5f'],13,31,44,407168,8,0,1,0.619047619,759
f8099e4856a37dd0d3a8e334b823e02e9444b429,0,DarshanKumar,2015-06-06 16:48:06+05:18,['6eb60f1e3fcb53022b1a97e73c67ba90557b1c2e'],5,5,10,407178,1,,,,759
e24e0265145bf985a24b8679ff59e217e354f31c,1,Jon Maron,2015-06-06 12:50:38-04:00,['6310fed15f90ddb620c41f9ef9f06c212442943c'],0,21,21,407199,1,,,,759
19630615a750a0e0111fcfb9d3135a7879923f42,0,Jon Maron,2015-06-06 12:51:08-04:00,['6de1b8454468f0b219408752f161ad56ac6e736c'],0,21,21,407220,1,,,,759
161939b75ec2736fbcdfd7856168b770058c99c8,1,Vishal Kadam,2015-06-07 00:39:43-04:00,['6272aa5c9373232e7c5fe0011c55123a0086d6cc'],32,1,33,407253,2,0,0,0,759
52227873746303961537c91e32bc2884af2d7d6b,1,Vishal Kadam,2015-06-07 00:40:13-04:00,['161939b75ec2736fbcdfd7856168b770058c99c8'],4,4,8,407261,2,1,,1,759
f65c378fa1cc21f04174afb95a03b2bb2881a264,0,DarshanKumar,2015-06-07 10:14:33+05:18,['f8099e4856a37dd0d3a8e334b823e02e9444b429'],5,5,10,407271,3,,,,760
370e1618f0fb08d84d02ce89fdad9536eeaa7008,0,Vishal Kadam,2015-06-07 00:57:41-04:00,"['52227873746303961537c91e32bc2884af2d7d6b', 'f65c378fa1cc21f04174afb95a03b2bb2881a264']",8,8,16,407287,3,,,,760
d1a7872f076c6283e7c61f90a6a00ca2bf7d21ab,1,dileep8014,2015-06-07 01:34:50-04:00,['370e1618f0fb08d84d02ce89fdad9536eeaa7008'],3,3,6,407293,1,,,,760
eb8111532e1c3f8d9ca693e3f32f955f9d47d596,1,dileep bhimineni,2015-06-07 22:17:53-04:00,['d1a7872f076c6283e7c61f90a6a00ca2bf7d21ab'],2,3,5,407298,1,1,1,1,760
0702815a513e0651232b5feab3615c2798489799,1,Vishal Kadam,2015-06-07 23:13:51-04:00,['eb8111532e1c3f8d9ca693e3f32f955f9d47d596'],4,206,210,407508,4,0.545454545,1,1,762
668d886e06382e46cd512a8d719d7cd66967b3d6,1,Vishal Kadam,2015-06-07 23:13:51-04:00,['0702815a513e0651232b5feab3615c2798489799'],542,105,647,408155,10,0.452380952,0,0.166666667,762
16b81ab73f4d70e85872907fff10b01f7ab229ac,1,Vishal Kadam,2015-06-07 23:13:51-04:00,['668d886e06382e46cd512a8d719d7cd66967b3d6'],38,32,70,408225,3,0,1,1,762
b1363ee2fe93bba97bc8b5ad3496e4f46ca9471e,1,Vishal Kadam,2015-06-07 23:13:51-04:00,['16b81ab73f4d70e85872907fff10b01f7ab229ac'],5,5,10,408235,2,,,,762
2e4d18b1117d284f1924594cd5b38d224a17de17,0,Vishal Kadam,2015-06-07 23:13:51-04:00,['b1363ee2fe93bba97bc8b5ad3496e4f46ca9471e'],4,4,8,408243,1,,,,762
6076a8cbf66d49518b1ee2e679bf20c97d879819,1,Vishal Kadam,2015-06-07 23:13:51-04:00,['2e4d18b1117d284f1924594cd5b38d224a17de17'],10,8,18,408261,1,1,0,0,762
3e0cadf0ec628773afa095d1d3af367e2be7cdb8,1,Vishal Kadam,2015-06-07 23:13:51-04:00,['6076a8cbf66d49518b1ee2e679bf20c97d879819'],1,1,2,408263,1,,,,762
6b8c1312410401212af058ea1417e3bdf106503d,0,Vishal Kadam,2015-06-07 23:13:52-04:00,['3e0cadf0ec628773afa095d1d3af367e2be7cdb8'],3,5,8,408271,1,0,1,1,762
9dfa18244a4363d6c2497cb3554055e32f40cd64,1,Vishal Kadam,2015-06-07 23:13:52-04:00,['6b8c1312410401212af058ea1417e3bdf106503d'],6,2,8,408279,1,0,0,0,762
beb788a8f9a4df5bc53df2db1ffaf10d5f9845c8,1,Vishal Kadam,2015-06-07 23:13:52-04:00,['9dfa18244a4363d6c2497cb3554055e32f40cd64'],2,46,48,408327,2,,,,762
d9498da1b8b8d11ace8bea8a8036f5b57d6de5c0,1,Vishal Kadam,2015-06-07 23:25:25-04:00,['beb788a8f9a4df5bc53df2db1ffaf10d5f9845c8'],94,94,188,408515,5,1,1,0,762
727e6843ef9af2de0333a2a1ed8a755ce50bc9fc,1,Vishal Kadam,2015-06-08 00:58:22-04:00,['d9498da1b8b8d11ace8bea8a8036f5b57d6de5c0'],1,1,2,408517,1,,,,762
7fa04b10893651df7ddcb73c483a667dff2b68bd,1,DarshanKumar,2015-06-08 11:25:09+05:18,['727e6843ef9af2de0333a2a1ed8a755ce50bc9fc'],1,1,2,408519,1,,,,762
6369ab28e02e2bfe54fdc7476320bbdd5c7a5ca0,1,Shwetha GS,2015-06-08 14:48:47+05:18,['0dd414f29563b6151407a9a6fa6198eb410002b1'],55,91,146,408665,7,0.275862069,1,0.75862069,762
01224ddd1ed119d655da8ae61e4b77ce41fa6fd7,1,Shwetha GS,2015-06-08 16:26:41+05:18,['e24e0265145bf985a24b8679ff59e217e354f31c'],1,23,24,408689,2,1,1,1,762
c073f640e20f74dd37542db324f20a77566bb8fb,1,Shwetha GS,2015-06-08 17:15:51+05:18,['e24e0265145bf985a24b8679ff59e217e354f31c'],6,6,12,408701,1,1,0,0,762
3520666435d73d5bb581a5e46c2dd696f700a0b9,0,Suma S,2015-06-08 17:19:00+05:18,"['e24e0265145bf985a24b8679ff59e217e354f31c', 'c073f640e20f74dd37542db324f20a77566bb8fb']",6,6,12,408713,1,,,,762
189a7d4b7b546ab4c183968ba2062da26d6f3d02,0,Suma S,2015-06-08 17:20:12+05:18,"['3520666435d73d5bb581a5e46c2dd696f700a0b9', '01224ddd1ed119d655da8ae61e4b77ce41fa6fd7']",1,23,24,408737,2,,,,762
25066cd87bcb105742657828cc57970e56dd28cb,1,Shwetha GS,2015-06-08 17:23:48+05:18,['c073f640e20f74dd37542db324f20a77566bb8fb'],1,3,4,408741,1,0,1,1,762
2d636736dd483af91f3792d38bc30bf35af7f9fc,0,Shwetha G S,2015-06-08 17:24:55+05:18,"['189a7d4b7b546ab4c183968ba2062da26d6f3d02', '25066cd87bcb105742657828cc57970e56dd28cb']",1,3,4,408745,1,,,,762
3d9b865d6d1e497892d2a17fdfa386daa2eaadaf,0,Suma S,2015-06-08 21:25:59+05:18,"['2d636736dd483af91f3792d38bc30bf35af7f9fc', '6369ab28e02e2bfe54fdc7476320bbdd5c7a5ca0']",191,168,359,409104,10,,,,762
e1bdafa20076b9a1c972f05fba5e333a8948be9c,0,Suma S,2015-06-08 21:26:46+05:18,"['19630615a750a0e0111fcfb9d3135a7879923f42', '3d9b865d6d1e497892d2a17fdfa386daa2eaadaf']",199,200,399,409503,14,,,,762
b5eaf350900fe0c78d078a2e74097d9140dd75b3,1,dileep8014,2015-06-08 14:06:29-04:00,['7fa04b10893651df7ddcb73c483a667dff2b68bd'],3,6,9,409512,1,,,,762
c8fe5a4a4ea3787bd0cd9095b3e37fd2ba3578cb,1,dileep8014,2015-06-08 14:07:48-04:00,['b5eaf350900fe0c78d078a2e74097d9140dd75b3'],2,2,4,409516,1,,,,762
4497f83c08ecd93c721d596e5375aacc01dfe0e7,1,dileep8014,2015-06-08 14:08:36-04:00,['c8fe5a4a4ea3787bd0cd9095b3e37fd2ba3578cb'],1,4,5,409521,1,,,,762
8e5fc82f5e59be96bc52b3291959ab47b85e7958,0,DarshanKumar,2015-06-08 23:28:20+05:18,['4497f83c08ecd93c721d596e5375aacc01dfe0e7'],0,0,0,409521,1,,,,763
f7fe3750c8da64b124dccf2b63c59af68fc85e10,1,Suma Shivaprasad,2015-06-09 00:45:39+05:18,['ed6b9bf4532e276f3299c021168f90771109c003'],62,269,331,409852,14,0.684210526,1,0.936842105,765
3ecb6d114145762aa220839f778b55d5f7f14a05,0,Suma Shivaprasad,2015-06-09 00:51:37+05:18,"['f7fe3750c8da64b124dccf2b63c59af68fc85e10', 'eff6c6ef498a38485ba7ac481fe371de81ee35e1']",7,6,13,409865,3,,,,765
e8fca05bd1dbc3051df28ca2746eee9e6451b2f7,0,Suma Shivaprasad,2015-06-09 00:53:54+05:18,"['3ecb6d114145762aa220839f778b55d5f7f14a05', '3d9b865d6d1e497892d2a17fdfa386daa2eaadaf']",422,641,1063,410928,36,,,,765
b14d7ef3c8624e013d15b5c21f8f1df1fc2305b5,0,Suma Shivaprasad,2015-06-09 00:55:48+05:18,['e8fca05bd1dbc3051df28ca2746eee9e6451b2f7'],4,4,8,410936,1,,,,765
2cbd25ccad3e699d6c8fadb75c3c820bbbfd043e,0,Suma Shivaprasad,2015-06-09 00:57:36+05:18,['b14d7ef3c8624e013d15b5c21f8f1df1fc2305b5'],2,1,3,410939,1,,,,765
c71b5b3167120e8a7326d77fdbb353a5243463a1,0,Harish Butani,2015-06-08 13:52:38-07:00,['e1bdafa20076b9a1c972f05fba5e333a8948be9c'],14,104,118,411057,3,1,1,1,765
8b4bc508653aa2036f779f9a28b679f531b5f355,1,Harish Butani,2015-06-08 13:57:19-07:00,['3d9b865d6d1e497892d2a17fdfa386daa2eaadaf'],14,104,118,411175,3,1,1,1,765
414beba57944d1952075edbe2ac366cf10e1fdae,1,Venkatesh Seetharam,2015-06-08 17:42:18-07:00,['8b4bc508653aa2036f779f9a28b679f531b5f355'],1838,1842,3680,414855,262,0.25,0,0,767
8e0521daa91840a7ad4c5eb629ed16c787be67ce,0,Venkatesh Seetharam,2015-06-08 17:44:34-07:00,['414beba57944d1952075edbe2ac366cf10e1fdae'],1,1,2,414857,1,,,,767
1a7dba9f73600f3daac1ef60413e9b8e455173e2,1,Venkatesh Seetharam,2015-06-08 20:23:01-07:00,['8e0521daa91840a7ad4c5eb629ed16c787be67ce'],21,70,91,414948,7,,,,768
260481095a603943c1715a36a7b6ed2788229d7d,0,Venkatesh Seetharam,2015-06-08 20:33:35-07:00,['c71b5b3167120e8a7326d77fdbb353a5243463a1'],477,477,954,415902,66,,,,770
811058e17712746b63c71007f2501133a54472ea,0,DarshanKumar,2015-06-09 08:57:38+05:18,['8e5fc82f5e59be96bc52b3291959ab47b85e7958'],0,954,954,416856,53,,,,770
307119733894a5bb9b121b32f75f469c4c2ddf16,1,Venkatesh Seetharam,2015-06-08 20:43:10-07:00,['260481095a603943c1715a36a7b6ed2788229d7d'],1361,1365,2726,419582,196,0.25,0,0,770
4ad5c42dd948ad7a81872855f5d8e3eb562ac054,0,Venkatesh Seetharam,2015-06-08 21:15:31-07:00,['307119733894a5bb9b121b32f75f469c4c2ddf16'],1,1,2,419584,1,,,,770
b286488cbfa9c31bf57545b3df794a3169d02734,0,Venkatesh Seetharam,2015-06-08 21:16:57-07:00,"['4ad5c42dd948ad7a81872855f5d8e3eb562ac054', '1a7dba9f73600f3daac1ef60413e9b8e455173e2']",21,70,91,419675,7,,,,770
8d8b0b718e81d898a3537b50b4d6b68ea6aa13e8,0,Suma Shivaprasad,2015-06-09 12:00:39+05:18,['2cbd25ccad3e699d6c8fadb75c3c820bbbfd043e'],17,80,97,419772,7,0,0,0.8,771
db437bcb5c2c2adca54c55b4e2d6b250781bfad7,0,Suma Shivaprasad,2015-06-09 12:41:18+05:18,"['8d8b0b718e81d898a3537b50b4d6b68ea6aa13e8', '1a7dba9f73600f3daac1ef60413e9b8e455173e2']",1884,2029,3913,423685,266,,,,771
33e4de48a6d3c1c882c1bdb4494eab60d9ca65bc,0,Suma Shivaprasad,2015-06-09 15:57:08+05:18,['db437bcb5c2c2adca54c55b4e2d6b250781bfad7'],1,1,2,423687,1,,,,771
70344bb52e002cbce5583d5f71430a349f317f07,1,Shwetha GS,2015-06-09 16:04:19+05:18,['1a7dba9f73600f3daac1ef60413e9b8e455173e2'],1,2,3,423690,2,,,,771
189ba064bd83a2d9f6d4fb8246db5e312f5244aa,0,Shwetha G S,2015-06-09 16:11:34+05:18,"['1a7dba9f73600f3daac1ef60413e9b8e455173e2', '70344bb52e002cbce5583d5f71430a349f317f07']",1,2,3,423693,2,,,,771
8e4ddf42cbc42141fefcb0ded442dffb5a9ec56c,1,Suma Shivaprasad,2015-06-09 16:58:37+05:18,['33e4de48a6d3c1c882c1bdb4494eab60d9ca65bc'],17,13,30,423723,2,,,,771
0ed1a1d0c927d5f00149f3970387dbbd90497c35,0,Shwetha GS,2015-06-09 17:03:25+05:18,"['b286488cbfa9c31bf57545b3df794a3169d02734', '189ba064bd83a2d9f6d4fb8246db5e312f5244aa']",1,2,3,423726,2,,,,771
1ff82a7e14ae663639aec0f6e30a655174b1931c,0,Suma Shivaprasad,2015-06-09 22:36:49+05:18,['8e4ddf42cbc42141fefcb0ded442dffb5a9ec56c'],17,27,44,423770,2,0,1,1,771
ee3af4a5bde30c7e81b4d3d1b9837a53dc9b1207,0,sanjay-patel-1991,2015-06-09 23:21:27+05:18,['811058e17712746b63c71007f2501133a54472ea'],35,0,35,423805,2,,,,771
92afb649a164b3060234acc5153424d3d2556ca5,0,Suma Shivaprasad,2015-06-10 16:19:46+05:18,['1ff82a7e14ae663639aec0f6e30a655174b1931c'],3,0,3,423808,2,,,,771
b10b34e09e7ac374563103b757203d1e94f82f73,0,Shwetha G S,2015-06-10 16:29:55+05:18,"['189ba064bd83a2d9f6d4fb8246db5e312f5244aa', '92afb649a164b3060234acc5153424d3d2556ca5']",92,357,449,424257,19,,,,771
fc19063959b75c7dca565f84704c5eafda38b702,0,Shwetha GS,2015-06-10 16:45:00+05:18,"['0ed1a1d0c927d5f00149f3970387dbbd90497c35', 'b10b34e09e7ac374563103b757203d1e94f82f73']",89,354,443,424700,19,,,,771
21986cd60a27d9760b76a602ea5327cda507bc5f,1,Jon Maron,2015-06-10 13:54:04-07:00,['b10b34e09e7ac374563103b757203d1e94f82f73'],4,4,8,424708,2,,,,771
e9dacce053e6820faf92a2cb2b4f2450505d3845,1,Jon Maron,2015-06-10 13:54:32-07:00,['fc19063959b75c7dca565f84704c5eafda38b702'],4,4,8,424716,2,,,,771
11fd359a23b16a968ffbb9e04592dbd6dc70201f,1,Shwetha GS,2015-06-11 11:51:09+05:18,['21986cd60a27d9760b76a602ea5327cda507bc5f'],930,919,1849,426565,102,1,0,0,771
8c5428613802b5362cebd2d8b193a11aaba0524a,0,Suma S,2015-06-11 13:08:39+05:18,"['21986cd60a27d9760b76a602ea5327cda507bc5f', '11fd359a23b16a968ffbb9e04592dbd6dc70201f']",930,919,1849,428414,102,,,,771
8f9dec9d5338d337db106e12afc92a9b8a1e7fba,1,Suma Shivaprasad,2015-06-11 13:29:18+05:18,['92afb649a164b3060234acc5153424d3d2556ca5'],38,57,95,428509,7,1,,,771
13aae4bf9135743badad8a78d2537d2668a8631a,1,Shwetha GS,2015-06-11 15:25:19+05:18,['8c5428613802b5362cebd2d8b193a11aaba0524a'],1,1,2,428511,1,,,,771
3e1637a48acfde2fb6100ebe7d4d8394852e91c6,1,Shwetha GS,2015-06-11 21:04:36+05:18,['13aae4bf9135743badad8a78d2537d2668a8631a'],36,40,76,428587,5,0,1,0,771
f4579b6b50b51399cd76261ab48051d5ebe92d93,0,Shwetha GS,2015-06-11 21:15:11+05:18,"['e9dacce053e6820faf92a2cb2b4f2450505d3845', '3e1637a48acfde2fb6100ebe7d4d8394852e91c6']",967,960,1927,430514,104,,,,771
720957e8508a6ba50db67657a28e3f7ebfa82b03,1,Suma Shivaprasad,2015-06-11 21:37:50+05:18,['8f9dec9d5338d337db106e12afc92a9b8a1e7fba'],14,15,29,430543,3,1,1,1,771
d75aeb5d7998edfe82dffd81610728cd04d02731,1,Suma Shivaprasad,2015-06-11 22:31:32+05:18,"['720957e8508a6ba50db67657a28e3f7ebfa82b03', '3e1637a48acfde2fb6100ebe7d4d8394852e91c6']",992,975,1967,432510,109,,,,771
b1099dffe3998a59078b0b7758deb8f902f0101d,0,DarshanKumar,2015-06-12 08:42:21+05:18,['ee3af4a5bde30c7e81b4d3d1b9837a53dc9b1207'],26,9,35,432545,8,,,,771
fdd841ddd98958f6a7bb45473278f5a9d81a1cf4,0,Shwetha G S,2015-06-12 10:36:42+05:18,"['3e1637a48acfde2fb6100ebe7d4d8394852e91c6', 'd75aeb5d7998edfe82dffd81610728cd04d02731']",58,68,126,432671,8,,,,771
22624786ee4fe86c94d94fee4bcf4c0855919901,0,Shwetha GS,2015-06-12 11:13:41+05:18,['fdd841ddd98958f6a7bb45473278f5a9d81a1cf4'],5896,0,5896,438567,21,0.584251969,0.491338583,0.103937008,771
fef50cee33d3cb8becb79de754950ad363c6adc4,1,Shwetha GS,2015-06-12 13:46:50+05:18,['22624786ee4fe86c94d94fee4bcf4c0855919901'],3832,2713,6545,445112,131,1,0.047016275,0.214285714,771
24eb03b79c06aa0c6aa483ae7b44e68db7df398f,1,DarshanKumar,2015-06-12 18:03:51+05:18,['b1099dffe3998a59078b0b7758deb8f902f0101d'],1,1,2,445114,2,,,,771
054dfb763ef6b945060f0a4e005cd55d1733c62b,0,Venkatesh Seetharam,2015-06-12 11:23:23-07:00,['fef50cee33d3cb8becb79de754950ad363c6adc4'],2419,0,2419,447533,30,0.448351648,0.156043956,0.034065934,771
ee049a606c3778198a785e065d9ca3fbd91c753e,0,Venkatesh Seetharam,2015-06-12 11:57:15-07:00,"['054dfb763ef6b945060f0a4e005cd55d1733c62b', '24eb03b79c06aa0c6aa483ae7b44e68db7df398f']",611,1854,2465,449998,100,,,,771
341d95e575a345c4af299094eb3837f699cc0762,1,Venkatesh Seetharam,2015-06-12 13:01:58-07:00,['ee049a606c3778198a785e065d9ca3fbd91c753e'],1,11,12,450010,2,,,,771
214d82d58f35f9c5417d775f6f3a34e0b0fd5d45,1,Venkatesh Seetharam,2015-06-12 13:02:27-07:00,['341d95e575a345c4af299094eb3837f699cc0762'],10,17,27,450037,4,,,,771
869e6cf81c063d4d7585c1be51ca34e2f56e07a3,0,Venkatesh Seetharam,2015-06-12 13:03:50-07:00,['214d82d58f35f9c5417d775f6f3a34e0b0fd5d45'],42910,0,42910,492947,101,0.34107742,0.289865164,0.191048933,771
3d025dc6766eed1f9e8f848d9ab82b56d3e46189,1,Venkatesh Seetharam,2015-06-12 13:51:19-07:00,['869e6cf81c063d4d7585c1be51ca34e2f56e07a3'],31,31,62,493009,12,,,,771
18aab0ae5bebaf785fa947d119986e796e38286f,0,Venkatesh Seetharam,2015-06-12 16:01:19-07:00,['3d025dc6766eed1f9e8f848d9ab82b56d3e46189'],2,295,297,493306,9,,,,779
2febe216db3a0c00ca4164a898e5bd9a30a047c9,1,Venkatesh Seetharam,2015-06-12 16:03:39-07:00,['18aab0ae5bebaf785fa947d119986e796e38286f'],343,177,520,493826,11,,,,779
2fbe8d9b233b05fd61e46186025851ea3a7a0841,0,Venkatesh Seetharam,2015-06-12 17:08:17-07:00,"['f4579b6b50b51399cd76261ab48051d5ebe92d93', '2febe216db3a0c00ca4164a898e5bd9a30a047c9']",54749,3803,58552,552378,331,,,,779
09693bfbeb2e4761e2ec149c346a268e363fa6d3,1,Jon Maron,2015-06-14 13:23:35-04:00,['2febe216db3a0c00ca4164a898e5bd9a30a047c9'],3,3,6,552384,2,,,,779
0e18270bdeb1ca32d6ec0a9211841d1a19feebc4,0,Jon Maron,2015-06-14 13:51:58-04:00,['2fbe8d9b233b05fd61e46186025851ea3a7a0841'],3,3,6,552390,2,,,,779
f6d57f72606df9d1466f35f90df006b389070ae3,1,Venkatesh Seetharam,2015-06-15 16:42:23-07:00,['09693bfbeb2e4761e2ec149c346a268e363fa6d3'],6,6,12,552402,2,,,,779
d54a5981f6bb40cc992ec71b52f841621e26c5c2,1,Vishal Kadam,2015-06-16 00:08:08-04:00,['0e18270bdeb1ca32d6ec0a9211841d1a19feebc4'],8,7,15,552417,3,,,1,779
1efb57bc453206b8377bb63e6f659d2861212697,0,Vishal Kadam,2015-06-16 00:08:19-04:00,['d54a5981f6bb40cc992ec71b52f841621e26c5c2'],9,57,66,552483,1,0.583333333,1,0.816666667,779
63c86bff05c420001cc1e6b1b7baacb8e41c937c,0,Vishal Kadam,2015-06-16 00:14:14-04:00,['1efb57bc453206b8377bb63e6f659d2861212697'],2,2,4,552487,1,,,,779
6c896a7af360c21dec207fc0cad92a715264f116,1,Vishal Kadam,2015-06-16 00:39:10-04:00,['63c86bff05c420001cc1e6b1b7baacb8e41c937c'],1,1,2,552489,1,,,,779
eb9eb4cf43b2a748cedbd168836f6354e6164272,1,Vishal Kadam,2015-06-16 00:41:31-04:00,['6c896a7af360c21dec207fc0cad92a715264f116'],5,28,33,552522,2,0.636363636,1,1,779
2fa32eca1774e51264266ea0143a291624e2bc06,0,Mouly Kumar,2015-06-15 21:50:23-07:00,['0e18270bdeb1ca32d6ec0a9211841d1a19feebc4'],1,20,21,552543,1,0,1,1,779
da9f12a334b2a5a00fee6675ecabc6763b309e52,0,mouly,2015-06-15 21:56:12-07:00,"['eb9eb4cf43b2a748cedbd168836f6354e6164272', '2fa32eca1774e51264266ea0143a291624e2bc06']",1,20,21,552564,1,,,,779
474bf7a89dc73169f8f33d034b80a2f1042287dc,0,Shwetha GS,2015-06-16 11:23:01+05:18,['f6d57f72606df9d1466f35f90df006b389070ae3'],1,15,16,552580,2,,,,780
aefca9a358dc4316495a2a765e031dd559eb2c8e,1,Shwetha GS,2015-06-16 14:00:44+05:18,['474bf7a89dc73169f8f33d034b80a2f1042287dc'],12,13,25,552605,12,,,,780
ed9b669f967132230ab3a58502d822014e89b79f,0,Jon Maron,2015-06-16 12:41:29-04:00,['aefca9a358dc4316495a2a765e031dd559eb2c8e'],5905,0,5905,558510,12,,,,780
f4e4396deb826d60a1a669ba13e3df0f744b0fb8,1,Jon Maron,2015-06-16 13:19:10-04:00,['ed9b669f967132230ab3a58502d822014e89b79f'],4,4,8,558518,4,,,,780
e426db2ddafda5071a6174f411323e37dbda1fd6,0,DarshanKumar,2015-06-17 00:21:21+05:18,['da9f12a334b2a5a00fee6675ecabc6763b309e52'],1,1,2,558520,1,,,,780
d55f4b0f32a75dae195ffc94aca7681d3f9ef288,1,Venkatesh Seetharam,2015-06-16 14:37:53-07:00,['f4e4396deb826d60a1a669ba13e3df0f744b0fb8'],148,405,553,559073,5,,,,781
caff3c20be2e22bdee20bf33c7fdaf81586e864d,1,Venkatesh Seetharam,2015-06-16 14:39:49-07:00,['d55f4b0f32a75dae195ffc94aca7681d3f9ef288'],21,580,601,559674,9,,,,783
9071ce2a3317b8e1906151c33cd70ddff78c1f42,1,Venkatesh Seetharam,2015-06-16 16:01:08-07:00,['caff3c20be2e22bdee20bf33c7fdaf81586e864d'],2,2,4,559678,2,,,,783
7f2b49ba82347a7efd2a782b65d132831458017d,0,Venkatesh Seetharam,2015-06-16 16:03:08-07:00,"['9071ce2a3317b8e1906151c33cd70ddff78c1f42', 'e426db2ddafda5071a6174f411323e37dbda1fd6']",45,122,167,559845,10,,,,783
32a794db747e6697094409f2ab4e5b0ad95edcaf,1,Shwetha GS,2015-06-17 13:54:30+05:18,['7f2b49ba82347a7efd2a782b65d132831458017d'],18,25,43,559888,5,1,1,1,783
0cffbff03f07384cb1059264408d84f0b412880d,0,Shwetha GS,2015-06-17 13:55:58+05:18,['32a794db747e6697094409f2ab4e5b0ad95edcaf'],1,1,2,559890,1,,,,783
d813519fd81c2699ed096fbe1072aa689edfca67,1,Venkatesh Seetharam,2015-06-17 12:40:46-07:00,['0cffbff03f07384cb1059264408d84f0b412880d'],15,49,64,559954,7,,,,783
155554e66600cf6d7598c30bf7051e4c5946f529,0,Jon Maron,2015-06-18 14:06:36-04:00,['d813519fd81c2699ed096fbe1072aa689edfca67'],3,3,6,559960,1,,,,783
970115d0862943a228f94477f24d8ac6f206e97e,0,Vishal Kadam,2015-06-18 19:09:56-04:00,['e426db2ddafda5071a6174f411323e37dbda1fd6'],15,15,30,559990,1,,,,783
5da401828aa983e84e99bec06075934e45046d9e,1,Vishal Kadam,2015-06-18 19:10:19-04:00,['970115d0862943a228f94477f24d8ac6f206e97e'],5,17,22,560012,2,1,1,1,783
4cce8b267193cf3a42223363c9036616811a0569,1,Vishal Kadam,2015-06-18 19:20:13-04:00,['970115d0862943a228f94477f24d8ac6f206e97e'],64,7,71,560083,5,1,0,0,783
ad65f51b332a0c062d57ef7319979866b4393782,1,Vishal Kadam,2015-06-18 19:21:47-04:00,['970115d0862943a228f94477f24d8ac6f206e97e'],4,5,9,560092,3,,,,783
989176218aa194cdc4e445a53cd20ad9abfe4d66,0,Vishal Kadam,2015-06-19 13:50:24-04:00,"['970115d0862943a228f94477f24d8ac6f206e97e', '5da401828aa983e84e99bec06075934e45046d9e']",5,17,22,560114,2,,,,783
240d7c4830b9ee161a3266fc20f5c7f30b1e3650,0,Vishal Kadam,2015-06-19 13:50:40-04:00,"['989176218aa194cdc4e445a53cd20ad9abfe4d66', '4cce8b267193cf3a42223363c9036616811a0569']",64,7,71,560185,5,,,,783
11b78ad5a37e3bbf4af875751bf415e9aff77d95,0,Vishal Kadam,2015-06-19 13:50:47-04:00,"['240d7c4830b9ee161a3266fc20f5c7f30b1e3650', 'ad65f51b332a0c062d57ef7319979866b4393782']",4,5,9,560194,3,,,,783
883251c0da0c27d179c837bcb891bd0f0dbaf11c,1,Shwetha GS,2015-06-22 13:47:00+05:18,['155554e66600cf6d7598c30bf7051e4c5946f529'],7,31,38,560232,3,1,1,1,783
901aca9d804e7175b8fb9e6191048f7719a9ceed,1,Shwetha GS,2015-06-22 14:17:02+05:18,['883251c0da0c27d179c837bcb891bd0f0dbaf11c'],7,1,8,560240,2,,,,783
6b33bcf647264131cf5b37838485675d2ed9c017,1,Shwetha GS,2015-06-22 16:40:15+05:18,['901aca9d804e7175b8fb9e6191048f7719a9ceed'],419,901,1320,561560,15,0.15625,0.3125,0.375,783
d6f5d9da692c54464c0e25abb82e841a9cd849a1,0,Venkatesh Seetharam,2015-06-22 14:44:23-07:00,"['6b33bcf647264131cf5b37838485675d2ed9c017', '11b78ad5a37e3bbf4af875751bf415e9aff77d95']",88,44,132,561692,11,,,,783
15639ee996f6a6b09f3d328b8a1a876385c6f373,1,Jon Maron,2015-06-24 15:24:52-04:00,['d6f5d9da692c54464c0e25abb82e841a9cd849a1'],22,86,108,561800,5,0.254545455,0,0,783
b273520e086616c32fc8bcfc9fef3bd0e72eea95,0,Jon Maron,2015-06-24 17:28:46-04:00,['15639ee996f6a6b09f3d328b8a1a876385c6f373'],1,1,2,561802,1,,,,783
864cc5bc30a03eaef6ffc4f3f93e40c42b30af3d,1,Shwetha GS,2015-07-08 12:11:33+05:18,['b273520e086616c32fc8bcfc9fef3bd0e72eea95'],39,31,70,561872,7,0,0,0,783
b178df2ea87ff83997e6eb002b3e4d1ecbe8e8c7,1,Jon Maron,2015-07-14 13:03:55-04:00,['864cc5bc30a03eaef6ffc4f3f93e40c42b30af3d'],4,78,82,561954,3,0.3125,1,0.65625,784
7653e5063abff114c2b1c668d5cca2a9ecfaf98c,0,Jon Maron,2015-07-15 09:50:12-04:00,['b178df2ea87ff83997e6eb002b3e4d1ecbe8e8c7'],1,1,2,561956,1,,,,784
b582b0cf5baff9b93b6411885e8e5d4628b3f985,0,Shwetha GS,2015-07-20 15:38:41+05:18,['7653e5063abff114c2b1c668d5cca2a9ecfaf98c'],0,4,4,561960,2,,,,784
97219f6aeef8edabbb3d2ff957b139868ac213de,0,Shwetha GS,2015-07-20 15:46:08+05:18,['b582b0cf5baff9b93b6411885e8e5d4628b3f985'],1,4,5,561965,1,,,,784
414816720e1284b0fd2434c78b1c1e89b5b5fb82,1,Shwetha GS,2015-07-21 11:41:11+05:18,['97219f6aeef8edabbb3d2ff957b139868ac213de'],119,8,127,562092,5,0,1,1,784
5e00edea2967ce944ad025211aacc531f451729d,1,Shwetha GS,2015-07-21 12:49:05+05:18,['414816720e1284b0fd2434c78b1c1e89b5b5fb82'],3,12,15,562107,3,1,1,1,784
b832faf0c7982af4ad6cf776fb153614b5578383,1,Shwetha GS,2015-07-21 13:00:21+05:18,['5e00edea2967ce944ad025211aacc531f451729d'],0,30,30,562137,3,1,1,0.578947368,784
266d7cc00bef49356bcdb1290930e05748182b12,1,Shwetha GS,2015-07-22 14:10:03+05:18,['b832faf0c7982af4ad6cf776fb153614b5578383'],268,780,1048,563185,33,0.280898876,1,1,786
9d303743382549b46aad56f78c650b466efa69f1,1,Shwetha GS,2015-07-27 12:09:45+05:18,['266d7cc00bef49356bcdb1290930e05748182b12'],213,281,494,563679,23,0.447368421,0.421052632,1,789
b93fe4a466058597d3c49e1bedf51f13356d2aae,1,Shwetha GS,2015-07-31 09:10:55+05:18,['9d303743382549b46aad56f78c650b466efa69f1'],429,187,616,564295,16,0.862318841,1,0.137681159,790
96059e0a9cd1ae7cd25e4e9a365bdde3633228ff,1,Shwetha GS,2015-08-03 11:41:30+05:18,['b93fe4a466058597d3c49e1bedf51f13356d2aae'],41,74,115,564410,10,1,1,0,790
39c52b2b7b1b27cd52dbba00599f74b7cf8c635e,1,Shwetha GS,2015-08-03 15:37:18+05:18,['96059e0a9cd1ae7cd25e4e9a365bdde3633228ff'],64,89,153,564563,4,0.206896552,0,0.827586207,790
7fc68497caac671427cc3032f5e8834b1dc22f69,1,Shwetha GS,2015-08-04 09:37:37+05:18,['39c52b2b7b1b27cd52dbba00599f74b7cf8c635e'],76,42,118,564681,9,1,1,1,790
256b259913284650647ab331d67d3a31e5333e34,1,Shwetha GS,2015-08-05 11:37:07+05:18,['7fc68497caac671427cc3032f5e8834b1dc22f69'],0,5,5,564686,2,,,,790
751b4c876464e9cb2e4a90244a9698f9a96bd0f4,1,Shwetha GS,2015-08-05 11:56:58+05:18,['256b259913284650647ab331d67d3a31e5333e34'],1,2,3,564689,2,,,,790
b627a681edc795c71ccf13e75a79ef102e75a916,1,Shwetha GS,2015-08-05 15:09:00+05:18,['751b4c876464e9cb2e4a90244a9698f9a96bd0f4'],280,906,1186,565875,28,0.680672269,0.928571429,1,800
147242e17a9e40d4b69b95df6a3879a66877b73c,0,Shwetha GS,2015-08-06 10:45:18+05:18,['b627a681edc795c71ccf13e75a79ef102e75a916'],1,2,3,565878,2,,,,800
48343db999b495458409644c8b9d2fd0bd9fa99d,1,Shwetha GS,2015-08-12 11:03:02+05:18,['147242e17a9e40d4b69b95df6a3879a66877b73c'],4,2466,2470,568348,14,0.167449139,0.300469484,0.672926448,808
5b2aa81fa118c94a6d2595bbd0d779c9ae64b603,0,Jon Maron,2015-08-20 11:21:42-04:00,['48343db999b495458409644c8b9d2fd0bd9fa99d'],6,6,12,568360,6,,,,808
113feb3af4d8b2eed2a8c7b67d4a55b336470119,0,Jon Maron,2015-08-24 11:29:35-04:00,['5b2aa81fa118c94a6d2595bbd0d779c9ae64b603'],4,3,7,568367,1,,,,808
2ed767c21cde5de256b914655d16e2dd4b15ab6a,1,Jon Maron,2015-08-26 15:36:46-04:00,['113feb3af4d8b2eed2a8c7b67d4a55b336470119'],1,3,4,568371,2,0,1,1,808
133690f759f13901c6161666df951134fdf9d519,1,Jon Maron,2015-08-26 16:08:45-04:00,['2ed767c21cde5de256b914655d16e2dd4b15ab6a'],54,10,64,568435,2,,,,808
e77d3d336649560c70d574964a79be837e342bdb,1,Shwetha GS,2015-09-10 12:43:24+05:18,['133690f759f13901c6161666df951134fdf9d519'],86,138,224,568659,46,,,,809
367f5f8ee73bf0c64dd849683c9ce908bade9775,0,Shwetha GS,2015-09-11 10:49:37+05:18,['e77d3d336649560c70d574964a79be837e342bdb'],0,16,16,568675,3,,,,809
e4c5648b642851519d7877945545fe7183234050,1,Venkatesh Seetharam,2015-09-11 14:51:18-07:00,['367f5f8ee73bf0c64dd849683c9ce908bade9775'],2,5,7,568682,2,,,,809
fd4ff8eca8e37a5d19fbf67ccb2f71ce5339b6f6,1,Venkatesh Seetharam,2015-09-11 14:51:57-07:00,['e4c5648b642851519d7877945545fe7183234050'],67,165,232,568914,6,0,1,1,809
37db995596f5a571a148e584eaf4242381b19450,1,Venkatesh Seetharam,2015-09-11 15:07:22-07:00,['fd4ff8eca8e37a5d19fbf67ccb2f71ce5339b6f6'],17,18,35,568949,58,,,,809
15ba43c661029534048d47b8e8a0da7250668a17,1,Venkatesh Seetharam,2015-09-11 15:11:19-07:00,['37db995596f5a571a148e584eaf4242381b19450'],1,124,125,569074,8,1,1,1,813
d1eef49e2607b98e2cfd66a24d236a7634192a15,1,Venkatesh Seetharam,2015-09-11 15:12:39-07:00,['15ba43c661029534048d47b8e8a0da7250668a17'],1,8,9,569083,3,,,,813
ff5b1f172b18442c404db949f657e3f8e1317327,1,Venkatesh Seetharam,2015-09-11 15:14:24-07:00,['d1eef49e2607b98e2cfd66a24d236a7634192a15'],6,9,15,569098,3,1,1,0,813
1e1ed482cebff075664577d383d5e7a3bc6d12c3,1,Venkatesh Seetharam,2015-09-11 15:16:37-07:00,['ff5b1f172b18442c404db949f657e3f8e1317327'],122,482,604,569702,4,0.561461794,0.877076412,0.953488372,813
c4d4797445d0e80a6badbd0834239477512c52a6,0,Venkatesh Seetharam,2015-09-11 15:17:45-07:00,['1e1ed482cebff075664577d383d5e7a3bc6d12c3'],0,6,6,569708,2,1,1,1,813
016e36c007f05dbba0071b1d21d9b26fa8fe0b01,0,Venkatesh Seetharam,2015-09-11 15:54:41-07:00,['c4d4797445d0e80a6badbd0834239477512c52a6'],1,1,2,569710,11,,,,813
1bfda02a11762cee733bf5c5b1b82e1e256acda0,1,Shwetha GS,2015-09-22 14:32:42+05:18,['016e36c007f05dbba0071b1d21d9b26fa8fe0b01'],2723,2657,5380,575090,109,1,0.051118211,0,825
c3453f60af575c7ec8e830b629280931b5e72e2d,1,Shwetha GS,2015-09-22 15:28:26+05:18,['1bfda02a11762cee733bf5c5b1b82e1e256acda0'],7,42,49,575139,3,0,1,1,825
9ebfd1b1bccde5e1877231c0f13905ca5325daad,1,Shwetha GS,2015-09-28 11:46:44+05:18,['c3453f60af575c7ec8e830b629280931b5e72e2d'],74,99,173,575312,9,,,,825
57a7d1bc6185a01a689908d7929bd767f82c209e,1,Shwetha GS,2015-09-28 11:50:33+05:18,['9ebfd1b1bccde5e1877231c0f13905ca5325daad'],33,32,65,575377,2,1,0,0,825
5611f149ea6dee3a91a73f23fb267096fb960438,1,Shwetha GS,2015-09-28 13:36:26+05:18,['57a7d1bc6185a01a689908d7929bd767f82c209e'],38,21,59,575436,4,1,1,1,825
c12ac955a789366d3f32a8d1706792ee315ba91c,1,Shwetha GS,2015-09-28 13:38:14+05:18,['5611f149ea6dee3a91a73f23fb267096fb960438'],0,16,16,575452,2,,,,825
9828c973b50a270e6c325b6e79293d47c8a7a136,1,Shwetha GS,2015-09-28 15:07:39+05:18,['c12ac955a789366d3f32a8d1706792ee315ba91c'],2,11,13,575465,3,,,,825
983e5baab2d893f6219b9aceefc0bf62fb02e83f,1,Shwetha GS,2015-09-29 10:46:28+05:18,['9828c973b50a270e6c325b6e79293d47c8a7a136'],6,7,13,575478,5,,,,825
c76bcb20a60af14c675d5a993ab5a693417694b5,0,Shwetha GS,2015-09-29 11:50:25+05:18,['983e5baab2d893f6219b9aceefc0bf62fb02e83f'],0,1,1,575479,10,,,,834
7ade9fe52eab4f767877fb4fad8a48ca7db3e0db,0,Shwetha GS,2015-09-29 11:52:40+05:18,['c76bcb20a60af14c675d5a993ab5a693417694b5'],21,5,26,575505,2,,,,834
539f243141d12873aff214942cbb9ddff3fc3af6,1,Shwetha GS,2015-09-29 13:35:16+05:18,['7ade9fe52eab4f767877fb4fad8a48ca7db3e0db'],0,21,21,575526,1,,,,834
7660c9b2921df6baacf88791077424a374f4aae9,1,Shwetha GS,2015-10-05 21:06:21+05:18,['539f243141d12873aff214942cbb9ddff3fc3af6'],1039,1861,2900,578426,23,0.327380952,0.571428571,0.845238095,835
23151244777d917bb0178dabb297287a2fd5b342,1,Shwetha GS,2015-10-05 21:12:50+05:18,['7660c9b2921df6baacf88791077424a374f4aae9'],2,2,4,578430,1,,,,835
cf2c8bc0c2821b9672761c6cf551783613f003ab,1,Suma Shivaprasad,2015-10-06 11:30:15+05:18,['23151244777d917bb0178dabb297287a2fd5b342'],2,858,860,579290,9,0.559241706,0.933649289,0.95892575,840
ebd6d9e3c754535d834cf262db2968d07547272a,1,Suma Shivaprasad,2015-10-06 11:37:47+05:18,['cf2c8bc0c2821b9672761c6cf551783613f003ab'],93,20,113,579403,9,0,0,0,840
8fce71f17352064702c0fb7919f68e5e901d20b3,1,Suma Shivaprasad,2015-10-06 11:59:03+05:18,['ebd6d9e3c754535d834cf262db2968d07547272a'],13,14,27,579430,2,,,,840
69e33ad6c9bf2239deb04871009cfa577b5aa6ef,1,Suma Shivaprasad,2015-10-08 21:27:02+05:18,['8fce71f17352064702c0fb7919f68e5e901d20b3'],1,1,2,579432,1,,,,840
538fa496eed1f76a0dfaab8ee313ea3be51f21d3,1,Suma Shivaprasad,2015-10-08 21:35:14+05:18,['69e33ad6c9bf2239deb04871009cfa577b5aa6ef'],3,410,413,579845,11,1,1,0.921985816,847
461a2a4e322ffcccf00886413c5c2e227801f33b,1,Shwetha GS,2015-10-09 01:03:49+05:18,['538fa496eed1f76a0dfaab8ee313ea3be51f21d3'],169,119,288,580133,25,1,0,0,847
4f61fff2b7467d9fa82c2dd7f81624b2ab885281,1,Suma Shivaprasad,2015-10-10 09:52:01+05:18,['461a2a4e322ffcccf00886413c5c2e227801f33b'],10,319,329,580462,19,0.814814815,1,0.75,854
e39c595988d52e44f847d7ab661cbc8f20b44646,1,Suma Shivaprasad,2015-10-10 20:38:28+05:18,['4f61fff2b7467d9fa82c2dd7f81624b2ab885281'],153,260,413,580875,7,,,,855
0a875627898b852be8a9947664192c7593706f24,1,Suma Shivaprasad,2015-10-11 08:46:39+05:18,['e39c595988d52e44f847d7ab661cbc8f20b44646'],0,3,3,580878,1,,,,855
04d1c1327bf877bd979e79352995114f6fc01a77,0,Shwetha GS,2015-10-12 13:20:43-07:00,['0a875627898b852be8a9947664192c7593706f24'],1,1,2,580880,2,0,0,0,855
fdafb3598b077d72b48380d1b4839f30b3469602,1,Shwetha GS,2015-10-12 16:27:32-07:00,['04d1c1327bf877bd979e79352995114f6fc01a77'],111,121,232,581112,8,0.058823529,0.117647059,0,856
b37c030d70c5cc4fe7b17fa860536a089b30035d,1,Shwetha GS,2015-10-14 10:02:56-07:00,['fdafb3598b077d72b48380d1b4839f30b3469602'],16,17,33,581145,5,,,,856
23ce5c9693e0fdefd27a8be6b4e64f6d2568678d,0,Suma Shivaprasad,2015-10-17 08:38:00+05:18,['b37c030d70c5cc4fe7b17fa860536a089b30035d'],2,0,2,581147,1,1,0,0,856
c794588d15a4ffdd697d50174cd3b78d6b6ae03a,1,Suma Shivaprasad,2015-10-19 23:10:17+05:18,['23ce5c9693e0fdefd27a8be6b4e64f6d2568678d'],15,15,30,581177,2,,,,856
bbf48d90a9ac0ebd0a3771f0fc8049fa25766c69,1,Suma Shivaprasad,2015-10-26 10:00:42+05:18,['c794588d15a4ffdd697d50174cd3b78d6b6ae03a'],10,2,12,581189,1,,,,856
143f21039f264d523b9dc6bc88bca44e3ef6dc41,1,Suma Shivaprasad,2015-10-26 10:04:47+05:18,['bbf48d90a9ac0ebd0a3771f0fc8049fa25766c69'],145,128,273,581462,5,0.8,0,0.766666667,856
ad7c221d59327380d9ed296adefcf4427a6c349a,0,Suma Shivaprasad,2015-10-28 10:00:16+05:18,['143f21039f264d523b9dc6bc88bca44e3ef6dc41'],5,6,11,581473,2,,,,856
3b6a2c8d392813fe64a34aed3333966e5534c81d,1,Suma Shivaprasad,2015-10-29 10:00:00+05:18,['ad7c221d59327380d9ed296adefcf4427a6c349a'],0,14,14,581487,3,,,,856
92490b9e20abb1b5689238701a21ed32882e8988,1,Suma Shivaprasad,2015-10-31 11:01:04+05:18,['3b6a2c8d392813fe64a34aed3333966e5534c81d'],15,17,32,581519,4,,,,856
177011cf78cdb6ddc434051fee2adac6a20cbb1c,1,Shwetha GS,2015-11-01 08:04:54+05:18,['92490b9e20abb1b5689238701a21ed32882e8988'],4,5,9,581528,3,,,,856
d9f2bf5072e28c442e519dcd6687bccfacfff826,0,Suma Shivaprasad,2015-11-06 13:59:05+05:18,['177011cf78cdb6ddc434051fee2adac6a20cbb1c'],2,2,4,581532,2,,,,856
aafc06c4c477158b6dfbf46c2d8c164a46ad85d5,1,Suma Shivaprasad,2015-11-06 14:01:46+05:18,['d9f2bf5072e28c442e519dcd6687bccfacfff826'],9,9,18,581550,6,,,,856
27a39063d17ceaa32b602f2661d7a7ffb6dbf3ab,1,Suma Shivaprasad,2015-11-06 14:19:57+05:18,['aafc06c4c477158b6dfbf46c2d8c164a46ad85d5'],14,33,47,581597,2,,,,856
0fad1ed2c88679a1e5afc95feb5c719508ba4b80,1,Suma Shivaprasad,2015-11-06 14:25:41+05:18,['27a39063d17ceaa32b602f2661d7a7ffb6dbf3ab'],241,784,1025,582622,24,0.973333333,1,1,858
e4543de6762064d364876de3dd5ee8fcf9dc61c5,1,Suma Shivaprasad,2015-11-06 14:40:03+05:18,['0fad1ed2c88679a1e5afc95feb5c719508ba4b80'],1,1,2,582624,1,,,,858
800df29a9f6b87784c2ef412bb476b6ae21ddab2,0,Suma Shivaprasad,2015-11-06 15:08:17+05:18,['e4543de6762064d364876de3dd5ee8fcf9dc61c5'],3,3,6,582630,1,,,,858
32913f31b609fb305fa77baae011df539e12a40d,1,Shwetha GS,2015-11-09 10:18:40+05:18,['800df29a9f6b87784c2ef412bb476b6ae21ddab2'],4,11,15,582645,3,,,,858
e48dbc9d62e075a53bb74598a4b72313a2b8358f,1,Shwetha GS,2015-11-09 10:56:20+05:18,['32913f31b609fb305fa77baae011df539e12a40d'],17,18,35,582680,4,,,,858
c93e0972a1201dcd0d5ce8a9286a4c96348c6b44,1,Suma Shivaprasad,2015-11-09 17:41:24+05:18,['e48dbc9d62e075a53bb74598a4b72313a2b8358f'],9,84,93,582773,4,0.55,0,0.9,858
6f421e9977f0a1f34af145c991b44662cfd53e45,1,Shwetha GS,2015-11-10 21:10:35+05:18,['c93e0972a1201dcd0d5ce8a9286a4c96348c6b44'],195,1315,1510,584283,29,0.767857143,0.976190476,0.720238095,866
5bc6f6bdba7d904db371b28f542c75d8f2e5c544,1,Shwetha GS,2015-11-11 17:19:16+05:18,['6f421e9977f0a1f34af145c991b44662cfd53e45'],14,38,52,584335,3,1,1,0,866
ebc4502a815189848daadb9be3288d6e76bcd3e7,1,Suma Shivaprasad,2015-11-11 21:48:49+05:18,['5bc6f6bdba7d904db371b28f542c75d8f2e5c544'],23,2374,2397,586732,28,0.476041667,0.632291667,0.794791667,883
f6592123ed5939bbe60a8a08500da246ac6b8707,0,Shwetha GS,2015-11-13 11:07:36+05:18,['ebc4502a815189848daadb9be3288d6e76bcd3e7'],2,3,5,586737,2,,,,883
35d42ad1976ed17853044fcc1877db0ef7ece056,0,Suma Shivaprasad,2015-11-17 10:06:36+05:18,['f6592123ed5939bbe60a8a08500da246ac6b8707'],2,3,5,586742,2,,,,883
c0b4975bcbaeb195703241bc37796624aed8d04d,1,Shwetha GS,2015-11-17 15:28:57+05:18,['35d42ad1976ed17853044fcc1877db0ef7ece056'],121,331,452,587194,3,0.723214286,1,1,883
43639766001c0fe0e067eb50f0125e3489dc41d7,1,Shwetha GS,2015-11-17 15:58:38+05:18,['c0b4975bcbaeb195703241bc37796624aed8d04d'],7,75,82,587276,4,0.22,0.98,0.76,883
9370d4a89af9fdbdb58de1f9b769248f55ed5cea,0,Suma Shivaprasad,2015-11-18 17:15:48+05:18,['43639766001c0fe0e067eb50f0125e3489dc41d7'],1,3,4,587280,2,,,,883
eec811ea3bee97312f3367071bc25c4605efc28b,1,Shwetha GS,2015-11-19 14:19:12+05:18,['9370d4a89af9fdbdb58de1f9b769248f55ed5cea'],23,37,60,587340,8,1,1,1,883
ad36c887df65765ee41e99752ad95f5e8e59719f,1,Suma Shivaprasad,2015-11-20 10:23:54+05:18,['eec811ea3bee97312f3367071bc25c4605efc28b'],20,21,41,587381,5,0,1,1,883
f671d3ad71cf00f275427bac79c3064deeab7be0,1,Shwetha GS,2015-11-23 12:05:27+05:18,['ad36c887df65765ee41e99752ad95f5e8e59719f'],5,9,14,587395,2,,,,883
4f3512192d35b0209f00a2389074d399e34b920c,1,Suma Shivaprasad,2015-11-25 15:57:16+05:18,['f671d3ad71cf00f275427bac79c3064deeab7be0'],2,32,34,587429,3,0,0.761904762,1,883
9710cff0bc0c44375081a5e33e816d8744775764,0,Suma Shivaprasad,2015-11-25 16:07:04+05:18,['4f3512192d35b0209f00a2389074d399e34b920c'],1,13,14,587443,2,0,0,1,883
c9176273bd57870733a9642e1efeeb5fd2921cca,0,Shwetha GS,2015-11-26 17:30:11+05:18,['9710cff0bc0c44375081a5e33e816d8744775764'],5,7,12,587455,2,0,,,883
238ca11cd5aa65f40616bc347b4b6d4e5964e98a,1,Shwetha GS,2015-12-01 12:04:02+05:18,['c9176273bd57870733a9642e1efeeb5fd2921cca'],1,17,18,587473,4,,,,883
91ad0218f4ad1babe26d2024861002a4f352c27e,1,Shwetha GS,2015-12-02 10:50:54+05:18,['238ca11cd5aa65f40616bc347b4b6d4e5964e98a'],0,22,22,587495,2,,,,883
919120f65f551f80a02d2782cb4e01f87202f7a5,1,Suma Shivaprasad,2015-12-03 10:55:25+05:18,['91ad0218f4ad1babe26d2024861002a4f352c27e'],176,717,893,588388,31,0.517857143,0.619047619,0.696428571,887
bf5672c545ff2e076c0d1e0eac20526626478155,1,Suma Shivaprasad,2015-12-03 11:07:45+05:18,['919120f65f551f80a02d2782cb4e01f87202f7a5'],136,936,1072,589460,35,0.32112069,0.732758621,1,890
fd468f4557a743cf7dd1f72fce2f9678bcd40e7f,1,Suma Shivaprasad,2015-12-07 12:18:09+05:18,['bf5672c545ff2e076c0d1e0eac20526626478155'],5,73,78,589538,5,0.9375,1,1,890
4aef164cf81e37a9857007a570e03f15779aa76e,1,Shwetha GS,2015-12-07 14:04:15+05:18,['fd468f4557a743cf7dd1f72fce2f9678bcd40e7f'],26,37,63,589601,4,0.636363636,1,1,890
cc2d886022dd314ae951e0e1dc44a808e6bc31c9,1,Shwetha GS,2015-12-08 10:04:40+05:18,['4aef164cf81e37a9857007a570e03f15779aa76e'],261,476,737,590338,21,0.610810811,0.481081081,0.702702703,890
6c3f0964b039d60517c6aa2ea90ab0583e0f28c2,1,Shwetha GS,2015-12-08 10:33:42+05:18,['cc2d886022dd314ae951e0e1dc44a808e6bc31c9'],6,15,21,590359,3,0,1,1,890
51656991fc008e57936bfc12afa51b9e372ae6a5,1,Shwetha GS,2015-12-08 11:57:57+05:18,['6c3f0964b039d60517c6aa2ea90ab0583e0f28c2'],1353,3135,4488,594847,80,0.468688845,0.688845401,0.842465753,896
b82ff048496f416e2ea794a1054e2a9f57667005,1,Shwetha GS,2015-12-08 12:29:26+05:18,['51656991fc008e57936bfc12afa51b9e372ae6a5'],39,44,83,594930,8,1,1,1,896
adb6c76db6c262fd538cb81be2e0538ab24ae4ce,0,Suma Shivaprasad,2015-12-08 14:39:34+05:18,['b82ff048496f416e2ea794a1054e2a9f57667005'],0,78,78,595008,1,1,1,1,897
323b9005841cc59590c26e4deaf7f76974fc1617,1,Suma Shivaprasad,2015-12-09 13:38:42+05:18,['adb6c76db6c262fd538cb81be2e0538ab24ae4ce'],1,79,80,595088,3,,,,897
532d6cec5c0c947f706668355f81c116732a62a9,1,Suma Shivaprasad,2015-12-11 10:47:13+05:18,['323b9005841cc59590c26e4deaf7f76974fc1617'],115,200,315,595403,13,1,0,0,897
001f074b5d4d32317ed7b1e55145b0076bfe5b92,1,Suma Shivaprasad,2015-12-11 16:56:51+05:18,['532d6cec5c0c947f706668355f81c116732a62a9'],2,10,12,595415,4,,,,897
6dfbda1145d1fc74c14985e190d1767a4178ff58,0,Suma Shivaprasad,2015-12-12 12:42:17+05:18,['001f074b5d4d32317ed7b1e55145b0076bfe5b92'],7,7,14,595429,2,,,,897
f8dd5dcb358b0328d34f57d5b1c6fcd730fb48e1,0,Suma Shivaprasad,2015-12-14 16:17:47+05:18,['6dfbda1145d1fc74c14985e190d1767a4178ff58'],3,72,75,595504,6,0.5,1,1,897
afb9e618a290fcc79f59600418cbf68f1356fd30,1,Suma Shivaprasad,2015-12-14 16:22:26+05:18,['6dfbda1145d1fc74c14985e190d1767a4178ff58'],3,221,224,595728,8,0.8,1,1,899
1d859f0393c2ceb5c196858e882302888bf83551,0,Suma Shivaprasad,2015-12-14 16:23:58+05:18,"['afb9e618a290fcc79f59600418cbf68f1356fd30', 'f8dd5dcb358b0328d34f57d5b1c6fcd730fb48e1']",0,0,0,595728,0,,,,899
90692af5bf0a08b95a1e205ffcba28af64956e69,1,Suma Shivaprasad,2015-12-14 16:47:11+05:18,['1d859f0393c2ceb5c196858e882302888bf83551'],1,107,108,595836,5,,,,900
dce31ab89be353e8e1e23a2ce1e1e903745db084,1,Shwetha GS,2015-12-15 14:56:44+05:18,['90692af5bf0a08b95a1e205ffcba28af64956e69'],201,600,801,596637,29,0.36199095,0.728506787,0.841628959,902
8cbb2c13bbe71957daf0de9222daaf4dd01199d3,1,Shwetha GS,2015-12-15 15:38:33+05:18,['dce31ab89be353e8e1e23a2ce1e1e903745db084'],189,268,457,597094,16,0.291666667,0.770833333,1,902
ae1d636fbb48346f4cfc926be469a6bfc884f71e,1,Suma Shivaprasad,2015-12-17 21:44:03+05:18,['8cbb2c13bbe71957daf0de9222daaf4dd01199d3'],80,254,334,597428,6,0.301886792,1,0.981132075,903
fa502b21700fb3c05c0ee8df1ed0f7525b7d3030,0,Suma Shivaprasad,2015-12-17 22:29:38+05:18,['ae1d636fbb48346f4cfc926be469a6bfc884f71e'],189,0,189,597617,1,0.304347826,0,0,903
2cae42c08a4122db672f3188a46b8385992ddc02,1,Suma Shivaprasad,2015-12-18 15:55:57+05:18,['fa502b21700fb3c05c0ee8df1ed0f7525b7d3030'],174,144,318,597935,13,0,0,0,903
125cdf5af9d34eaf8ada5f1b8d7fd587da483ecb,1,Suma Shivaprasad,2015-12-19 08:34:46+05:18,['2cae42c08a4122db672f3188a46b8385992ddc02'],2,23,25,597960,2,,,,903
ab6e64202727034425ba6a4165990d06be94d1e4,1,Suma Shivaprasad,2015-12-20 07:46:35+05:18,['125cdf5af9d34eaf8ada5f1b8d7fd587da483ecb'],26,30,56,598016,6,1,1,0,903
a230f4ffdf6317020c977e6ed59aadae8404a0ab,1,Suma Shivaprasad,2015-12-20 18:03:17+05:18,['ab6e64202727034425ba6a4165990d06be94d1e4'],8,12,20,598036,2,0.75,0,1,903
30a2ec1fa450664d6ae90f70a71fde80f8882b68,1,Shwetha GS,2015-12-22 15:34:00+05:18,['a230f4ffdf6317020c977e6ed59aadae8404a0ab'],17,59,76,598112,5,0,1,1,903
aeec7618a8505f75715f74530ea900cf65bc847d,1,Shwetha GS,2015-12-22 15:40:25+05:18,['30a2ec1fa450664d6ae90f70a71fde80f8882b68'],21,85,106,598218,5,0.3125,1,1,903
6a9078e1fa4c81b6a6e6f695284cce5e267d116a,1,Shwetha GS,2015-12-22 15:44:38+05:18,['aeec7618a8505f75715f74530ea900cf65bc847d'],14,15,29,598247,14,,,,903
611ac3028ea5ba3c44434dec9cdcf193912cfa07,1,Shwetha GS,2015-12-22 15:52:40+05:18,['6a9078e1fa4c81b6a6e6f695284cce5e267d116a'],25,141,166,598413,3,,,,903
be6971f2dc82c90761635dda197d7819729311d9,1,Shwetha GS,2015-12-22 15:58:23+05:18,['611ac3028ea5ba3c44434dec9cdcf193912cfa07'],210,213,423,598836,18,,,,903
34857de8cf23a0ed69614e7098a4bac0ade712b6,1,Shwetha GS,2015-12-22 16:16:50+05:18,['be6971f2dc82c90761635dda197d7819729311d9'],0,7,7,598843,2,,,,903
cd139e501f5502c1155d67d32d0b74d751fbd761,1,Shwetha GS,2015-12-22 16:56:53+05:18,['34857de8cf23a0ed69614e7098a4bac0ade712b6'],20,27,47,598890,18,0.333333333,1,1,903
70d54988288e7545848a5992af0806708d8b840f,0,Shwetha GS,2015-12-22 17:28:12+05:18,['cd139e501f5502c1155d67d32d0b74d751fbd761'],0,12,12,598902,1,,,,903
086b4a3ee0480d37f9aa66fb878c9dc978aaa043,1,Shwetha GS,2015-12-23 14:29:00+05:18,['70d54988288e7545848a5992af0806708d8b840f'],11,2818,2829,601731,34,0.607042254,0.936619718,0.850704225,926
c0cf21291c048f6e57d257aa9ce185ef4e3e7045,0,Shwetha GS,2016-01-05 12:14:08+05:18,['086b4a3ee0480d37f9aa66fb878c9dc978aaa043'],0,4,4,601735,2,,,,926
4e1cc7625fa2564b0de1887030d2dbfb81c648b2,0,Shwetha GS,2016-01-05 13:09:00+05:18,['c0cf21291c048f6e57d257aa9ce185ef4e3e7045'],1,2,3,601738,2,,,,926
90a3a9e708077304bb2fac90c3b13ce9359edd8c,1,Shwetha GS,2016-01-05 13:26:36+05:18,['4e1cc7625fa2564b0de1887030d2dbfb81c648b2'],17,569,586,602324,5,1,1,1,929
4bd2df49e4495c95ef115ffc070b20d61b37b0c6,0,Shwetha GS,2016-01-06 12:04:46+05:18,['90a3a9e708077304bb2fac90c3b13ce9359edd8c'],3,6,9,602333,2,1,0,0,929
646f29c37deb394cdcce71a3c7499e19367eba0c,0,Shwetha GS,2016-01-07 12:17:56+05:18,['4bd2df49e4495c95ef115ffc070b20d61b37b0c6'],1,2,3,602336,2,,,,929
0e81ceb4adc732b9a8f9a5075d5f9c57654d412a,1,Shwetha GS,2016-01-13 16:13:40+05:18,['646f29c37deb394cdcce71a3c7499e19367eba0c'],36,202,238,602574,5,0.804878049,1,1,930
c4eebe0ed4a8489d92a9f75edef4819dc3fcde32,1,Shwetha GS,2016-01-13 19:55:34+05:18,['0e81ceb4adc732b9a8f9a5075d5f9c57654d412a'],698,104,802,603376,9,0.477777778,0.068518519,0.075925926,930
a46711c54a4d24e2ddc5ffe9d557e08e336dd626,1,Shwetha GS,2016-01-18 12:03:36+05:18,['c4eebe0ed4a8489d92a9f75edef4819dc3fcde32'],21,375,396,603772,7,0.467032967,0.983516484,0.89010989,931
b77d7c7bc7cb11a047808c95b051eb2fbd2c813c,1,Shwetha GS,2016-01-18 16:50:32+05:18,['a46711c54a4d24e2ddc5ffe9d557e08e336dd626'],42,1114,1156,604928,12,0.502683363,0.652951699,0.722719141,938
fd070cb80dcf08582f1e02486b10b95d124f4039,0,Shwetha GS,2016-01-19 10:46:52+05:18,['b77d7c7bc7cb11a047808c95b051eb2fbd2c813c'],1,2,3,604931,2,,,,938
d519ae8cfe458c637c837d1f029bcb5c5522e0a6,1,Shwetha GS,2016-01-19 11:55:00+05:18,['fd070cb80dcf08582f1e02486b10b95d124f4039'],291,408,699,605630,32,0.863636364,0.727272727,0.954545455,939
64de5233600b2f4a837415d148a3c3aa7234c7a4,1,Shwetha GS,2016-01-20 12:28:51+05:18,['d519ae8cfe458c637c837d1f029bcb5c5522e0a6'],19,106,125,605755,7,0,1,1,939
b93e9f3561c77449431c5d4243b37379c4dae626,1,Shwetha GS,2016-01-20 12:32:00+05:18,['64de5233600b2f4a837415d148a3c3aa7234c7a4'],96,126,222,605977,7,1,1,0.65,939
0003160b08bd55b32eae0049048a6164d5b02d32,0,Shwetha GS,2016-01-20 12:59:37+05:18,['b93e9f3561c77449431c5d4243b37379c4dae626'],0,0,0,605977,1,,,,940
f3ac2c0f1e2b9e7db2aa867b2a05a68dfee75f1b,1,Shwetha GS,2016-01-20 13:00:49+05:18,['0003160b08bd55b32eae0049048a6164d5b02d32'],1,117,118,606095,4,,,,941
dbe1061538abdd50462cc04f6606d7b5942f27f6,1,Shwetha GS,2016-01-22 12:06:06+05:18,['f3ac2c0f1e2b9e7db2aa867b2a05a68dfee75f1b'],18,43,61,606156,4,1,1,1,941
9f28540b5f2eab79fed7159b9f0610b5af53a227,1,Shwetha GS,2016-01-25 10:44:54+05:18,['dbe1061538abdd50462cc04f6606d7b5942f27f6'],8,41,49,606205,3,0,0.5,1,941
a1fb9edae97c199670291c6c383b14bdeeb00ff5,1,Shwetha GS,2016-01-25 12:07:47+05:18,['9f28540b5f2eab79fed7159b9f0610b5af53a227'],4,6,10,606215,2,0,1,1,941
19f24d50de1dff153b5d22d44208eab04b6fd76c,1,Shwetha GS,2016-01-27 11:52:32+05:18,['a1fb9edae97c199670291c6c383b14bdeeb00ff5'],23,24,47,606262,8,,,,941
7b07a222c14c9093abbee587131402c783c45e6e,0,Shwetha GS,2016-01-28 11:26:45+05:18,['19f24d50de1dff153b5d22d44208eab04b6fd76c'],2,12,14,606276,2,0,1,1,941
8c4a7faef286a5ae5cf6f986f6796da60f0251ab,1,Shwetha GS,2016-01-29 11:23:29+05:18,['7b07a222c14c9093abbee587131402c783c45e6e'],69,388,457,606733,5,0.668831169,1,0.590909091,942
6c06fd0a72e94d9575ea14c9e4bf662f00592590,1,Shwetha GS,2016-01-29 11:44:14+05:18,['8c4a7faef286a5ae5cf6f986f6796da60f0251ab'],148,81,229,606962,2,,,,942
6ec94374a907a033b36a8af297be054b79ee8fa4,1,Shwetha GS,2016-02-01 11:41:55+05:18,['6c06fd0a72e94d9575ea14c9e4bf662f00592590'],5,17,22,606984,5,0,1,0.75,942
d2b9b99f4b21129667f1a12d3564fb950d42d07c,1,Shwetha GS,2016-02-02 13:14:16+05:18,['6ec94374a907a033b36a8af297be054b79ee8fa4'],5,49,54,607038,5,1,0.916666667,0.75,943
20608f0221108c2495820c3b098494dd66fe0854,1,Shwetha GS,2016-02-04 15:06:16+05:18,['d2b9b99f4b21129667f1a12d3564fb950d42d07c'],26,360,386,607424,15,0.309178744,0.700483092,1,943
bd47628fef161af96462c25a3f382002c9cb8c34,0,Shwetha GS,2016-02-04 15:10:08+05:18,['20608f0221108c2495820c3b098494dd66fe0854'],1,1025,1026,608450,4,,,,946
21b403bb72ceaaa11ad1d46b103d13de18e4ab80,1,Suma Shivaprasad,2016-02-04 13:46:22-08:00,['bd47628fef161af96462c25a3f382002c9cb8c34'],125,201,326,608776,4,0.36,0.733333333,0.986666667,946
e06b1ee29220923e33080a0b0fbcc53c8c77fed7,1,Shwetha GS,2016-02-17 15:55:20+05:18,['21b403bb72ceaaa11ad1d46b103d13de18e4ab80'],10,93,103,608879,7,0.416666667,1,0.805555556,947
ddb14b54cd7994a1bc5afe0155a95ef10f101124,0,Shwetha GS,2016-02-17 16:17:16+05:18,['e06b1ee29220923e33080a0b0fbcc53c8c77fed7'],3,16,19,608898,4,1,1,1,947
60ebe8bea73058f180e7ef08dc55a616aec4b525,1,Suma Shivaprasad,2016-02-17 14:14:10-08:00,['ddb14b54cd7994a1bc5afe0155a95ef10f101124'],5,6,11,608909,1,,,,947
64bda5a419cf43c2cdac08d54eee24610b8ad002,0,Suma Shivaprasad,2016-02-17 17:22:14-08:00,['60ebe8bea73058f180e7ef08dc55a616aec4b525'],44,29,73,608982,6,0,0,0,947
cdb3c0bb8f1e6f85116f4e4652cc653930bac4b7,1,Suma Shivaprasad,2016-02-19 10:33:33-08:00,['64bda5a419cf43c2cdac08d54eee24610b8ad002'],27,65,92,609074,12,,,,948
648c8d8f6b5eadb6c736974fbb16ef5120da4716,1,Suma Shivaprasad,2016-02-19 10:38:36-08:00,['cdb3c0bb8f1e6f85116f4e4652cc653930bac4b7'],0,4,4,609078,1,,,,948
95590d23017523cc006359fe5b5be389c7aa0c0b,1,Shwetha GS,2016-02-22 11:42:35+05:18,['648c8d8f6b5eadb6c736974fbb16ef5120da4716'],2,17,19,609097,4,0,1,1,948
e181131d35e92de4fa074ffe0a2f71ed95f49a72,1,Suma Shivaprasad,2016-02-22 15:21:35-08:00,['648c8d8f6b5eadb6c736974fbb16ef5120da4716'],3,15,18,609115,3,1,1,1,948
3869b8a2f6e1351e0b259f1c7ad08940a3c07d20,0,Suma Shivaprasad,2016-02-22 15:22:12-08:00,"['e181131d35e92de4fa074ffe0a2f71ed95f49a72', '95590d23017523cc006359fe5b5be389c7aa0c0b']",2,17,19,609134,4,,,,948
999219300cf594a0a7fe4b92725e84aa85abe8d9,1,Shwetha GS,2016-02-23 11:57:08+05:18,['3869b8a2f6e1351e0b259f1c7ad08940a3c07d20'],102,35,137,609271,15,0,1,1,948
ecd0f610555b8a5598c5a725d851e83a4cf959cc,1,Shwetha GS,2016-02-24 09:57:29+05:18,['999219300cf594a0a7fe4b92725e84aa85abe8d9'],371,285,656,609927,44,0.5,1,1,948
6a63f7154720a8670064c5b6f5feb82dbb216489,1,Shwetha GS,2016-02-25 13:56:00+05:18,['ecd0f610555b8a5598c5a725d851e83a4cf959cc'],5,37,42,609969,4,1,1,0.636363636,948
92574b57484684da3fd62d9e21cf7f3841dc2ff7,1,Shwetha GS,2016-03-01 12:08:21+05:18,['6a63f7154720a8670064c5b6f5feb82dbb216489'],1,5,6,609975,2,,,,948
de9b890dd05816cf3d71da7250e59ba760a9116f,1,Suma Shivaprasad,2016-03-01 14:08:33-08:00,['92574b57484684da3fd62d9e21cf7f3841dc2ff7'],15,64,79,610054,5,,,,948
cda983f34b004ccc3e849cfedae9578a9c5e8637,0,Shwetha GS,2016-03-02 10:37:30+05:18,['de9b890dd05816cf3d71da7250e59ba760a9116f'],1,1,2,610056,1,,,,948
b9575f29df3cc014f1b076abf52d88249bf4d0ef,0,Shwetha GS,2016-03-03 10:50:54+05:18,['cda983f34b004ccc3e849cfedae9578a9c5e8637'],2,9,11,610067,3,0,1,1,948
b6fb1f1ac27f19e1b077f14d47c88548ae2df106,1,Shwetha GS,2016-03-07 12:01:51+05:18,['b9575f29df3cc014f1b076abf52d88249bf4d0ef'],236,382,618,610685,30,0.410714286,0.991071429,0.401785714,948
a77d1ab535c8d8bc81fcd96cd5c9defa81a5c7a1,1,Shwetha GS,2016-03-07 12:08:05+05:18,['b6fb1f1ac27f19e1b077f14d47c88548ae2df106'],41,116,157,610842,10,0,0.857142857,0.821428571,949
7ebb20136cefb6efe325ee1f30455abd9a3d57da,1,Suma Shivaprasad,2016-03-07 15:21:20-08:00,['a77d1ab535c8d8bc81fcd96cd5c9defa81a5c7a1'],47,811,858,611700,7,0.040307102,0.854126679,0.842610365,950
5b748aa47b970298a3c6b0c03495b3299079cd3e,1,Shwetha GS,2016-03-08 12:37:00+05:18,['7ebb20136cefb6efe325ee1f30455abd9a3d57da'],100,128,228,611928,7,1,0.888888889,1,950
0defc6e80a2d816f8a25a11cd44b1cb89e2f610a,1,Shwetha GS,2016-03-09 11:15:27+05:18,['5b748aa47b970298a3c6b0c03495b3299079cd3e'],38,151,189,612117,8,0.684210526,1,1,950
161079155c403b86f4318e683ae46356017c7624,1,Suma Shivaprasad,2016-03-09 11:33:18-08:00,['0defc6e80a2d816f8a25a11cd44b1cb89e2f610a'],20,113,133,612250,4,0.475,0.9,0.9,951
98fdc6d85d8e3da7b2ac434d4a4d1d102a017a53,1,Suma Shivaprasad,2016-03-10 12:23:48-08:00,['161079155c403b86f4318e683ae46356017c7624'],22,544,566,612816,26,0.679104478,0.641791045,0.694029851,958
125dc976bf901693d9cc688cb7c10d7e3c65b5d9,1,Shwetha GS,2016-03-11 10:33:11+05:18,['98fdc6d85d8e3da7b2ac434d4a4d1d102a017a53'],24,235,259,613075,5,0.80620155,0.930232558,0.751937984,958
046ff52b02636e80aca33976457b74c73d79813b,1,Shwetha GS,2016-03-11 10:34:49+05:18,['125dc976bf901693d9cc688cb7c10d7e3c65b5d9'],0,3,3,613078,3,0.5,1,0.5,958
3cdd9f57d8b3cb31e407f2ac237676f34a7d08af,1,Shwetha GS,2016-03-11 10:56:06+05:18,['046ff52b02636e80aca33976457b74c73d79813b'],210,345,555,613633,37,0.314814815,1,0.888888889,958
44dbfe576d0f627255b81be6bd8422e5ae845cf4,0,Shwetha GS,2016-03-11 11:17:22+05:18,['3cdd9f57d8b3cb31e407f2ac237676f34a7d08af'],2,2,4,613637,1,,,,958
ad7604fcf4bf4f84a66b339b8ea1f4473cd9f84a,1,Suma Shivaprasad,2016-03-14 10:53:00-07:00,['44dbfe576d0f627255b81be6bd8422e5ae845cf4'],32,99,131,613768,3,0,0.685185185,0.685185185,958
ad0d764dde83e7159a862fef4ec9d97aa0766cbb,1,Shwetha GS,2016-03-16 13:56:55+05:18,['ad7604fcf4bf4f84a66b339b8ea1f4473cd9f84a'],76,527,603,614371,12,0.502183406,0.943231441,0.807860262,961
cd392fd7488b6e49484f98b6c729e25ce34b07e4,1,Suma Shivaprasad,2016-03-16 10:11:40-07:00,['ad0d764dde83e7159a862fef4ec9d97aa0766cbb'],44,89,133,614504,6,1,0.945945946,0.243243243,961
382a4c8f59578312609310f68d123e88eee17486,1,Shwetha GS,2016-03-21 10:04:52+05:18,['cd392fd7488b6e49484f98b6c729e25ce34b07e4'],1,4,5,614509,2,,,,961
b2efaf76d409e31d580f0d12458a82f1430490e2,0,Shwetha GS,2016-03-21 10:23:27+05:18,['382a4c8f59578312609310f68d123e88eee17486'],1,2,3,614512,2,,,,961
4285526e52d57f85f4e1ec02273ca9f0dbb75a12,1,Shwetha GS,2016-03-22 15:27:20+05:18,['b2efaf76d409e31d580f0d12458a82f1430490e2'],2,1,3,614515,2,,,,961
dd66e15806c8e9678521f92c152b2998a37ef0f2,0,Shwetha GS,2016-03-23 10:18:55+05:18,['4285526e52d57f85f4e1ec02273ca9f0dbb75a12'],0,8,8,614523,7,,,,961
985465fc73be355986e326ee3d491d3b6a077e05,1,Shwetha GS,2016-03-24 11:22:16+05:18,['dd66e15806c8e9678521f92c152b2998a37ef0f2'],1,38,39,614562,3,0.16,1,0.84,961
bca454e16f0b289b39ab75986e6acdca49488d04,1,Shwetha GS,2016-03-31 14:37:12+05:18,['985465fc73be355986e326ee3d491d3b6a077e05'],681,1294,1975,616537,60,0.576388889,1,0.489583333,969
8bde666ba1986f5b6c9e20cad82d6037a6739db9,1,Shwetha GS,2016-04-01 10:56:39+05:18,['bca454e16f0b289b39ab75986e6acdca49488d04'],70,2530,2600,619137,38,0.738970588,0.908088235,0.935661765,984
0fc2071960f11b237b3d7c510b1d6fed6be7ee63,1,Suma Shivaprasad,2016-04-01 11:13:19-07:00,['8bde666ba1986f5b6c9e20cad82d6037a6739db9'],52,437,489,619626,14,0.953488372,1,0.88372093,988
6b0f7d82db762858249e276bf9fd6d06e869f949,1,Suma Shivaprasad,2016-04-01 11:37:49-07:00,['0fc2071960f11b237b3d7c510b1d6fed6be7ee63'],150,285,435,620061,5,0.445783133,0.915662651,0.493975904,988
faad323e2fbeb4a92904946d3efe219caa44887c,1,Suma Shivaprasad,2016-04-01 12:05:50-07:00,['6b0f7d82db762858249e276bf9fd6d06e869f949'],14,399,413,620474,10,0.930232558,0.930232558,0.930232558,992
5a0be80579c5f5dce7be6ab4105ee299ef5a642f,1,Suma Shivaprasad,2016-04-01 13:18:08-07:00,['faad323e2fbeb4a92904946d3efe219caa44887c'],336,232,568,621042,9,0.818181818,0.045454545,0.829545455,992
e4aa387fb497285097e09ee6bac156ba2331f854,1,Suma Shivaprasad,2016-04-01 15:33:51-07:00,['5a0be80579c5f5dce7be6ab4105ee299ef5a642f'],65,201,266,621308,7,0.260869565,1,0.782608696,994
ce73ec3527f05fca35ce4e720dd0bad414523c8f,1,Suma Shivaprasad,2016-04-01 21:59:23-07:00,['e4aa387fb497285097e09ee6bac156ba2331f854'],3,28,31,621339,7,0,0,0,994
c1d4e7c9cd030e5625fee9fe33c89e3fbfd2dbfa,0,Shwetha GS,2016-04-02 21:34:44+05:18,['ce73ec3527f05fca35ce4e720dd0bad414523c8f'],21,22,43,621382,5,0,0,0,994
98f4d40a17668c8ee65b58fcbcb6d09ea6a682e5,1,Suma Shivaprasad,2016-04-04 17:15:46-07:00,['c1d4e7c9cd030e5625fee9fe33c89e3fbfd2dbfa'],268,984,1252,622634,19,0.177985948,0.976580796,0.819672131,999
ef9ef3c10e8caf0ecf0cf729fe19809d5c4fff09,1,Suma Shivaprasad,2016-04-04 17:51:32-07:00,['98f4d40a17668c8ee65b58fcbcb6d09ea6a682e5'],21,180,201,622835,8,0.205882353,0.656862745,0.480392157,999
47619ee69422f13bdf73d1586bfa8d54dac61599,1,Suma Shivaprasad,2016-04-05 12:20:15-07:00,['ef9ef3c10e8caf0ecf0cf729fe19809d5c4fff09'],2,92,94,622929,6,0.566666667,0.85,0.8,999
009330de2cd5503c06a26bd0dcf21dec377d8935,1,Suma Shivaprasad,2016-04-05 17:23:41-07:00,['47619ee69422f13bdf73d1586bfa8d54dac61599'],49,574,623,623552,12,0.21875,0.927083333,0.947916667,1002
46365f8c484b06fe4f2ef681d0f8533c698820ff,1,Suma Shivaprasad,2016-04-07 09:00:47-07:00,['009330de2cd5503c06a26bd0dcf21dec377d8935'],201,540,741,624293,9,0.536363636,1,0.472727273,1002
fe6e696d9aaf03e3032ca737f40bef0350ecb718,1,Suma Shivaprasad,2016-04-07 22:08:13-07:00,['46365f8c484b06fe4f2ef681d0f8533c698820ff'],91,202,293,624586,11,0.256410256,0.743589744,0.205128205,1002
a908001970c1b760fdac0f3c00869a5b4ef742fc,1,Suma Shivaprasad,2016-04-07 22:57:13-07:00,['fe6e696d9aaf03e3032ca737f40bef0350ecb718'],0,44,44,624630,1,,,,1003
b8f4ffb68cf6adab4015d545715d1370a1ee57b9,1,Suma Shivaprasad,2016-04-08 10:35:49-07:00,['a908001970c1b760fdac0f3c00869a5b4ef742fc'],17,182,199,624829,3,,,,1003
755e59c08dbbc3b03fc2f6fc4908396433b97e88,1,Suma Shivaprasad,2016-04-09 09:53:58-07:00,['b8f4ffb68cf6adab4015d545715d1370a1ee57b9'],8,115,123,624952,4,0.913580247,0.913580247,1,1003
1a390f011236b645404e025aa0f6134c4cb60994,1,Suma Shivaprasad,2016-04-09 10:28:34-07:00,['755e59c08dbbc3b03fc2f6fc4908396433b97e88'],7,102,109,625061,3,0.471428571,0.957142857,0.871428571,1003
85afbefc0c9a90f5f2366e626557e7f6425a0d27,1,Shwetha GS,2016-04-10 12:36:27+05:18,['1a390f011236b645404e025aa0f6134c4cb60994'],60,145,205,625266,15,0.75,0.95,0.525,1003
c2356f8efdbb8a14ee79d773bacc23b7eb743615,1,Shwetha GS,2016-04-11 16:51:33+05:18,['85afbefc0c9a90f5f2366e626557e7f6425a0d27'],292,647,939,626205,32,0.741573034,0.58988764,0.662921348,1005
a5f8c5aa068141bf85411d9e78c4085f54fd1477,1,Shwetha GS,2016-04-11 16:52:24+05:18,['c2356f8efdbb8a14ee79d773bacc23b7eb743615'],0,12178,12178,638383,91,0.566322902,0.782361309,0.791963016,1093
2824f15a0a58afebff940e4026dd07338974b959,1,Shwetha GS,2016-04-11 17:03:29+05:18,['a5f8c5aa068141bf85411d9e78c4085f54fd1477'],13,49,62,638445,3,0.2,1,1,1093
f7146ede45f13e6d4e27e43c272884b39e0e26ab,1,Shwetha GS,2016-04-14 16:42:12+05:18,['2824f15a0a58afebff940e4026dd07338974b959'],3,2067,2070,640515,26,0.550748752,0.730449251,0.981697171,1113
daf812aadf0179682ff0a1947cf93811e10b9460,1,Suma Shivaprasad,2016-04-14 11:16:02-07:00,['f7146ede45f13e6d4e27e43c272884b39e0e26ab'],7,12,19,640534,3,1,1,1,1113
40ee9492192f8ea3afc4be7f6fa55803214e8247,1,Shwetha GS,2016-04-16 09:03:15+05:18,['daf812aadf0179682ff0a1947cf93811e10b9460'],1500,2198,3698,644232,44,0.78807947,0.983443709,0.870860927,1118
922a83c9a10e857d54855463225e9a5c375bc2b9,1,Suma Shivaprasad,2016-04-18 11:57:22-07:00,['40ee9492192f8ea3afc4be7f6fa55803214e8247'],12,63,75,644307,5,0.448275862,0,0.310344828,1118
81a0c6ffe76ef0bd4eeaf93b2dfb36c56cae9976,1,Suma Shivaprasad,2016-04-20 12:05:15-07:00,['922a83c9a10e857d54855463225e9a5c375bc2b9'],25,750,775,645082,17,0.434250765,0.981651376,0.981651376,1125
f147d3fff28e6a26395de48c6a0b964e79fc7d48,1,Suma Shivaprasad,2016-04-21 17:22:58-07:00,['81a0c6ffe76ef0bd4eeaf93b2dfb36c56cae9976'],59,245,304,645386,6,0.576086957,1,0.467391304,1125
25c2adf36bfa3d16aa78c041348217239393c2db,1,Suma Shivaprasad,2016-04-21 18:17:22-07:00,['f147d3fff28e6a26395de48c6a0b964e79fc7d48'],26,43,69,645455,5,0.222222222,1,0,1125
f312a577df7a7bb12bc1774f10e0b92b377a53b7,1,Suma Shivaprasad,2016-04-22 17:27:21-07:00,['25c2adf36bfa3d16aa78c041348217239393c2db'],4,45,49,645504,5,0,0,1,1125
2e90ff1f6627a17c3a96ec444bc85e8cd730ea7a,0,Shwetha GS,2016-04-23 18:04:41+05:18,['f312a577df7a7bb12bc1774f10e0b92b377a53b7'],4,30,34,645538,2,,,,1125
53574720c79cc99dddf5d3dbbe5cae61748eeee4,1,Shwetha GS,2016-04-25 09:32:59+05:18,['2e90ff1f6627a17c3a96ec444bc85e8cd730ea7a'],8,111,119,645657,3,0,0,1,1126
574da752d81a49c3200ef66e2b71c560f06b33c7,1,Suma Shivaprasad,2016-04-28 21:30:11-07:00,['53574720c79cc99dddf5d3dbbe5cae61748eeee4'],36,513,549,646206,8,0.039735099,0.71192053,0.831125828,1126
7d040c52ffa2daa467e4de3243a94bf655f79693,0,Hemanth Yamijala,2016-04-29 16:14:56+05:18,['574da752d81a49c3200ef66e2b71c560f06b33c7'],2,4,6,646212,2,,,,1126
c69df40f7c069646b613ebb58739f6be47ea0f89,1,Hemanth Yamijala,2016-05-02 10:18:14+05:18,['7d040c52ffa2daa467e4de3243a94bf655f79693'],13,14,27,646239,3,,,,1126
73640cc68a2045fe10a2508fac51701d62629f4f,1,Shwetha GS,2016-05-03 09:52:36+05:18,['c69df40f7c069646b613ebb58739f6be47ea0f89'],7,72,79,646318,3,,,,1126
b2ae1371be24cfcb13f12dcb4ebad6920b9bfd80,1,Shwetha GS,2016-05-04 11:26:06+05:18,['73640cc68a2045fe10a2508fac51701d62629f4f'],198,1758,1956,648274,24,0.435018051,0.981949458,0.944043321,1141
f8748ccec4a53a7a8d6d4560850122de29aef862,0,Shwetha GS,2016-05-04 11:38:44+05:18,['b2ae1371be24cfcb13f12dcb4ebad6920b9bfd80'],0,1,1,648275,1,,,,1141
5c16d42a014426a926250aafc0987d3413933839,1,Shwetha GS,2016-05-04 12:13:24+05:18,['f8748ccec4a53a7a8d6d4560850122de29aef862'],0,46,46,648321,3,0.9,1,1,1142
feff0cf71e2971524a4de3263de11b2df1c0adbe,1,Hemanth Yamijala,2016-05-04 14:21:32+05:18,['5c16d42a014426a926250aafc0987d3413933839'],1,2,3,648324,2,,,,1142
dab9cb7ca3068dfb13a1682233467d78109112fe,1,Shwetha GS,2016-05-05 16:39:42+05:18,['feff0cf71e2971524a4de3263de11b2df1c0adbe'],15,38,53,648377,6,0,0.95,0.3,1142
33354e328dcb56f27cded6ed4bb57a402ae9eb85,1,Hemanth Yamijala,2016-05-06 09:43:12+05:18,['dab9cb7ca3068dfb13a1682233467d78109112fe'],2,7,9,648386,3,,,,1142
334429a83cdc5052b0ec6f050df804b0bf75bba5,0,Hemanth Yamijala,2016-05-06 12:43:25+05:18,['33354e328dcb56f27cded6ed4bb57a402ae9eb85'],1,2,3,648389,2,,,,1142
1e3029bc7283e233dc816de7d83b28eddd4f4b36,1,Shwetha GS,2016-05-06 12:56:48+05:18,['334429a83cdc5052b0ec6f050df804b0bf75bba5'],274,1138,1412,649801,37,0.783057851,1,0.909090909,1145
2c0dc4068eac70a18f7cfa430b7e0bc7d84f7524,1,Shwetha GS,2016-05-06 15:49:40+05:18,['1e3029bc7283e233dc816de7d83b28eddd4f4b36'],100,285,385,650186,7,0.693877551,1,0.795918367,1146
53bbebcba6f26aeffea857d9fd87b7d9eaddad65,1,Hemanth Yamijala,2016-05-09 10:11:26+05:18,['2c0dc4068eac70a18f7cfa430b7e0bc7d84f7524'],10,19,29,650215,2,1,1,1,1146
1ddf3137b969749980076ec8948630848eb4b06d,1,Shwetha GS,2016-05-09 13:34:45+05:18,['53bbebcba6f26aeffea857d9fd87b7d9eaddad65'],6,11,17,650232,4,1,1,1,1146
34f51a2a233c43e797a4d355e82f86b1e8332cc9,1,Hemanth Yamijala,2016-05-09 14:36:44+05:18,['1ddf3137b969749980076ec8948630848eb4b06d'],200,424,624,650856,24,0.72972973,0.581081081,0.885135135,1147
a963e9806c7dd85b50d6957ec915233865c6216b,1,Hemanth Yamijala,2016-05-09 22:27:11+05:18,['34f51a2a233c43e797a4d355e82f86b1e8332cc9'],4,1947,1951,652807,22,0.182745826,0.466604824,0.798701299,1164
856ee6b5d7f7dd32c8e34c500c055bbb5db9f3cc,1,Suma Shivaprasad,2016-05-09 14:27:11-07:00,['a963e9806c7dd85b50d6957ec915233865c6216b'],45,96,141,652948,5,0.739130435,0,0,1164
4f9cba4b031fe25d394f61d4a43283dadc0856f9,0,Suma Shivaprasad,2016-05-09 16:07:38-07:00,['856ee6b5d7f7dd32c8e34c500c055bbb5db9f3cc'],80,82,162,653110,3,,,,1164
5e724675bf0560a77b6b84bc19cb3015445ee297,0,Hemanth Yamijala,2016-05-11 14:34:43+05:18,['4f9cba4b031fe25d394f61d4a43283dadc0856f9'],22,24,46,653156,6,1,1,0,1164
9155957803b8b0d5030e5fd988ba8679185da489,1,Hemanth Yamijala,2016-05-11 17:13:18+05:18,['5e724675bf0560a77b6b84bc19cb3015445ee297'],0,977,977,654133,17,1,1,1,1178
bfd5f5caa609b9084ec816deb4c6bf11eec18bab,1,Shwetha GS,2016-05-12 11:50:46+05:18,['9155957803b8b0d5030e5fd988ba8679185da489'],34,106,140,654273,7,0.47826087,0.913043478,1,1178
54dc670af7f9b90206879a0212487c5076062f41,1,Suma Shivaprasad,2016-05-12 20:29:37-07:00,['bfd5f5caa609b9084ec816deb4c6bf11eec18bab'],84,346,430,654703,8,0.277419355,0.870967742,0.851612903,1179
07b8b4d3c9673f231f1c9dab175ed3fbb2a98267,1,Suma Shivaprasad,2016-05-12 20:38:36-07:00,['54dc670af7f9b90206879a0212487c5076062f41'],23,30,53,654756,5,0,1,1,1179
98769871e56d9a97792e2dba52345e876908ac63,1,Hemanth Yamijala,2016-05-13 09:36:20+05:18,['07b8b4d3c9673f231f1c9dab175ed3fbb2a98267'],146,397,543,655299,14,0.869565217,1,0.746376812,1180
af63bb887e817a64d55f75a37e815cecc4fe0c26,1,Suma Shivaprasad,2016-05-12 22:56:30-07:00,['98769871e56d9a97792e2dba52345e876908ac63'],22,210,232,655531,12,0.666666667,0.84,0.573333333,1180
454feb47a1de4da727ab963a8a927996bdcf4965,0,Hemanth Yamijala,2016-05-13 11:30:41+05:18,['af63bb887e817a64d55f75a37e815cecc4fe0c26'],7,33,40,655571,2,0.384615385,0.384615385,1,1180
28991c52b3e74278bd49c1d79674ff3f9b49a4f7,1,Shwetha GS,2016-05-13 15:09:34+05:18,['454feb47a1de4da727ab963a8a927996bdcf4965'],70,408,478,656049,15,0.085106383,0.590425532,0.968085106,1181
b6a0eee7f70ea841e8c3fdd0c507de1e0db73e5a,0,Hemanth Yamijala,2016-05-13 16:31:13+05:18,['28991c52b3e74278bd49c1d79674ff3f9b49a4f7'],1,3,4,656053,2,,,,1181
9e1f366374827d5471a84c9ece438e89e814b7f8,1,Suma Shivaprasad,2016-05-13 09:41:14-07:00,['b6a0eee7f70ea841e8c3fdd0c507de1e0db73e5a'],226,719,945,656998,24,0.438297872,0.863829787,0.821276596,1187
857561a392543a7ff8a422b3ace413690abadf3d,1,Hemanth Yamijala,2016-05-17 18:58:04+05:18,['9e1f366374827d5471a84c9ece438e89e814b7f8'],158,149,307,657305,9,0,0,0,1188
b65dd91c3587d35abafc4ec136e162f9a5c92ac1,1,Shwetha GS,2016-05-18 17:43:24+05:18,['857561a392543a7ff8a422b3ace413690abadf3d'],585,993,1578,658883,22,0.496,1,0.908,1191
aaf2971ad16ccd9c37040f593121695cd8c9cacb,1,Hemanth Yamijala,2016-05-18 18:21:39+05:18,['b65dd91c3587d35abafc4ec136e162f9a5c92ac1'],27,8500,8527,667410,92,0.529602595,0.951067856,0.916193566,1274
a05107a07a0e1415915c87228fd7c65dd3b23e42,1,Hemanth Yamijala,2016-05-19 09:12:07+05:18,['aaf2971ad16ccd9c37040f593121695cd8c9cacb'],134,286,420,667830,24,0.747474747,0.96969697,1,1276
440bd2ae42c4f2ef02df7387392a1a29d98f3bc9,1,Hemanth Yamijala,2016-05-19 23:03:39+05:18,['a05107a07a0e1415915c87228fd7c65dd3b23e42'],2102,5137,7239,675069,88,0.543938422,0.944836434,0.861449647,1319
5f248157bcb7daec1db66afe8d05f52f791296bc,1,Shwetha GS,2016-05-20 11:35:18+05:18,['440bd2ae42c4f2ef02df7387392a1a29d98f3bc9'],84,912,996,676065,11,0.668789809,0.834394904,0.926751592,1322
7c73f0c4a5d8cfff96987c915e749ba9dff5057d,1,Shwetha GS,2016-05-20 15:18:58+05:18,['5f248157bcb7daec1db66afe8d05f52f791296bc'],58,146,204,676269,5,1,1,0,1324
19751c60b284346884e84ce8a38d7712750435a5,0,Shwetha GS,2016-05-20 20:27:58+05:18,['7c73f0c4a5d8cfff96987c915e749ba9dff5057d'],9,197,206,676475,3,0.295918367,1,0.887755102,1325
353ea964e594cb33096263791fae95720203d2cc,1,Shwetha GS,2016-05-20 23:13:31+05:18,['19751c60b284346884e84ce8a38d7712750435a5'],396,541,937,677412,31,0,0,0.87037037,1327
74eafd3e6758d41fc9e67d2ef6d9c72274aa740b,1,Hemanth Yamijala,2016-05-23 21:03:41+05:18,['353ea964e594cb33096263791fae95720203d2cc'],106,233,339,677751,31,1,0.710526316,0.631578947,1327
74d9b3fb0ea6ced1468c57c11ef3885c1107f86b,1,Shwetha GS,2016-05-24 11:57:10+05:18,['74eafd3e6758d41fc9e67d2ef6d9c72274aa740b'],13,598,611,678362,10,0.313901345,0.385650224,1,1330
153fc362325b6934bef27872e9753fcd13a9c030,1,Hemanth Yamijala,2016-05-25 22:55:37+05:18,['74d9b3fb0ea6ced1468c57c11ef3885c1107f86b'],119,507,626,678988,20,0.592465753,0.849315068,0.873287671,1332
705014eb3352180ff8f2cac05dbbc0809b421d8c,1,Shwetha GS,2016-05-25 23:52:22+05:18,['153fc362325b6934bef27872e9753fcd13a9c030'],645,1340,1985,680973,40,0.525380711,0.781725888,0.670050761,1334
70f715705bc4dfd5bc7ab4728388ed0d340c2413,1,Hemanth Yamijala,2016-05-27 09:25:02+05:18,['705014eb3352180ff8f2cac05dbbc0809b421d8c'],207,134,341,681314,6,0,0.267605634,0.352112676,1334
2e02ae62850eef6b9fd65fb0c796748d0d348044,1,Shwetha GS,2016-05-27 14:52:39+05:18,['70f715705bc4dfd5bc7ab4728388ed0d340c2413'],14,121,135,681449,3,0.179775281,0.674157303,0.921348315,1334
0143486ad2024f14f9f8fb2f03c4013f1462c2ce,1,Shwetha GS,2016-05-27 16:55:51+05:18,['2e02ae62850eef6b9fd65fb0c796748d0d348044'],60,105,165,681614,9,1,1,0,1334
56c13aa366027c3eb1d4527bfb9286ddc3d61ffb,1,Suma Shivaprasad,2016-05-27 13:36:18-07:00,['0143486ad2024f14f9f8fb2f03c4013f1462c2ce'],3,24,27,681641,5,0.882352941,1,0.823529412,1334
65d95ebe23744f72c0ed40b9a171d3c42cd2906c,1,Suma Shivaprasad,2016-05-28 06:26:09-07:00,['56c13aa366027c3eb1d4527bfb9286ddc3d61ffb'],29,33,62,681703,2,0,1,1,1334
42d5e37e3b1c03738787746587dd357330c72296,1,Hemanth Yamijala,2016-05-31 21:58:37+05:18,['65d95ebe23744f72c0ed40b9a171d3c42cd2906c'],1,74,75,681778,2,0,1,0,1334
208e90b1ae33074aeb89c79e48a0a3489d5cc415,1,Hemanth Yamijala,2016-05-31 22:51:14+05:18,['42d5e37e3b1c03738787746587dd357330c72296'],42,103,145,681923,6,,,,1334
b15aa4007efbf4cf5d74a68175b85cfab8d4b7c1,1,Hemanth Yamijala,2016-06-01 17:02:49+05:18,['208e90b1ae33074aeb89c79e48a0a3489d5cc415'],188,220,408,682331,16,0,1,0,1334
a05f752d251544be8f06adffc5ae8f6f551ee18d,0,Suma Shivaprasad,2016-06-01 13:00:53-07:00,['b15aa4007efbf4cf5d74a68175b85cfab8d4b7c1'],5410,2,5412,687743,94,0.339750849,0.125707814,0.108720272,1334
6148b22acd479f83335b5f272981f04771f86158,1,Suma Shivaprasad,2016-06-01 15:09:29-07:00,['a05f752d251544be8f06adffc5ae8f6f551ee18d'],31,90,121,687864,4,0.737704918,0.06557377,0.868852459,1334
59268875d256c92f748198cea999ed5057c6bf18,0,Suma Shivaprasad,2016-06-01 15:19:06-07:00,['6148b22acd479f83335b5f272981f04771f86158'],1,2,3,687867,2,,,,1334
83d053978873e988604de2f07021878b5b987764,1,Hemanth Yamijala,2016-06-02 14:53:56+05:18,['59268875d256c92f748198cea999ed5057c6bf18'],8,194,202,688069,5,0.08974359,1,0.679487179,1335
b8a5d4d616e5d12b635fbea071eb36bba2598209,1,Hemanth Yamijala,2016-06-02 18:23:17+05:18,['83d053978873e988604de2f07021878b5b987764'],98,111,209,688278,7,1,1,1,1335
d41e549f2857e954f5e72971d3e8acfc151f7c7e,1,Hemanth Yamijala,2016-06-02 21:46:03+05:18,['b8a5d4d616e5d12b635fbea071eb36bba2598209'],68,782,850,689128,27,0.560747664,0.913551402,0.89953271,1337
86494ffd7c79e8c2b3f7a90abd10085002cbf5f7,1,Suma Shivaprasad,2016-06-03 12:32:25-07:00,['d41e549f2857e954f5e72971d3e8acfc151f7c7e'],17,26,43,689171,4,0.692307692,1,1,1337
db0d3f9b7b935ce6b36c14c8dbc11c1bc270e608,1,Suma Shivaprasad,2016-06-03 12:56:27-07:00,['86494ffd7c79e8c2b3f7a90abd10085002cbf5f7'],35,80,115,689286,5,1,1,0.795918367,1337
9e23fdc1bf456c049c66cddf1b8035d99044afd9,1,Suma Shivaprasad,2016-06-03 12:59:54-07:00,['db0d3f9b7b935ce6b36c14c8dbc11c1bc270e608'],1,66,67,689353,1,0.709090909,1,0.890909091,1337
d661964c2c049820958678a17218b33b3128fd6a,1,Suma Shivaprasad,2016-06-03 17:37:30-07:00,['9e23fdc1bf456c049c66cddf1b8035d99044afd9'],37,628,665,690018,6,0.114503817,1,0.946564885,1338
b66f05729d11327ac5945032f5f6376255983266,1,Hemanth Yamijala,2016-06-07 11:45:52+05:18,['d661964c2c049820958678a17218b33b3128fd6a'],6,18,24,690042,5,0.75,1,1,1338
395296ce3985c5dfd37151de59a90c2112a06821,1,Hemanth Yamijala,2016-06-08 13:33:58+05:18,['b66f05729d11327ac5945032f5f6376255983266'],94,728,822,690864,17,0.40302267,0.450881612,0.607052897,1339
0901714a6f7cd9acedaa2c23129f4bba340c58df,1,Hemanth Yamijala,2016-06-08 14:02:19+05:18,['395296ce3985c5dfd37151de59a90c2112a06821'],92,217,309,691173,24,0.939759036,1,0.722891566,1340
a1d54d6560c0fc79276ae9739f8ce5e699e46412,1,Hemanth Yamijala,2016-06-08 14:42:24+05:18,['0901714a6f7cd9acedaa2c23129f4bba340c58df'],4,14,18,691191,3,1,1,1,1340
606690c49c5417c0755b3cfd3def67180a6692f2,0,Suma Shivaprasad,2016-06-08 16:20:38-07:00,['a1d54d6560c0fc79276ae9739f8ce5e699e46412'],3,4,7,691198,2,,,,1340
6eaeaaa334ede5f52410e60ae0248494ec34d314,1,Shwetha GS,2016-06-09 14:28:06+05:18,['606690c49c5417c0755b3cfd3def67180a6692f2'],17,102,119,691317,10,0.485714286,0.414285714,0.642857143,1340
94a8db33ac61770624c328cf6cd0a118de3cec62,1,Shwetha GS,2016-06-09 14:29:05+05:18,['6eaeaaa334ede5f52410e60ae0248494ec34d314'],67,137,204,691521,13,0.355932203,0.406779661,0.949152542,1340
5ab199511898ab195892152e00679ebe560dae17,0,Hemanth Yamijala,2016-06-09 16:27:44+05:18,['94a8db33ac61770624c328cf6cd0a118de3cec62'],3,24,27,691548,5,0,0,1,1340
868cd831b8add7a2353a1447aaf41666e402b677,1,Shwetha GS,2016-06-10 14:08:39+05:18,['5ab199511898ab195892152e00679ebe560dae17'],18,122,140,691688,9,0.909090909,0.909090909,0.818181818,1341
7e3830a739c6a0168ab1cfe7e63fed35f4ef917f,1,Suma Shivaprasad,2016-06-10 12:04:29-07:00,['868cd831b8add7a2353a1447aaf41666e402b677'],1,9,10,691698,3,,,,1341
67a1133a3ba14b5a89d90c1447607d066ab6be30,1,Hemanth Yamijala,2016-06-13 20:07:34+05:18,['7e3830a739c6a0168ab1cfe7e63fed35f4ef917f'],180,73,253,691951,6,0.333333333,1,1,1341
5b627b5a1e3103f750fd4ba981ef569ad2377bd1,1,Shwetha GS,2016-06-13 22:22:28+05:18,['67a1133a3ba14b5a89d90c1447607d066ab6be30'],5,31,36,691987,3,0.772727273,1,0.772727273,1341
056044a9f98e8ca4c95d091867bc0009384ca3e7,1,Hemanth Yamijala,2016-06-14 10:24:45+05:18,['5b627b5a1e3103f750fd4ba981ef569ad2377bd1'],166,636,802,692789,39,0.268656716,1,0.853731343,1341
f47cea3f84c816787b3d147d4adde1ebf5e4f9df,1,Hemanth Yamijala,2016-06-14 11:27:12+05:18,['056044a9f98e8ca4c95d091867bc0009384ca3e7'],65,158,223,693012,11,1,1,0.8,1341
0a44790e7866e92b6591d442f140705a079fef30,1,Hemanth Yamijala,2016-06-14 14:30:58+05:18,['f47cea3f84c816787b3d147d4adde1ebf5e4f9df'],9,721,730,693742,14,0.199335548,0.920265781,0.976744186,1345
e0536224a0a0b66c6f3416b1d798798139b7aad2,1,Hemanth Yamijala,2016-06-14 16:55:53+05:18,['0a44790e7866e92b6591d442f140705a079fef30'],82,84,166,693908,23,0,0.714285714,0,1345
8fefd165586f5fd8acd5c3a5786d6012dda68a5b,1,Suma Shivaprasad,2016-06-14 16:33:05-07:00,['e0536224a0a0b66c6f3416b1d798798139b7aad2'],59,148,207,694115,3,0,0.903225806,0.887096774,1345
aad34ae00fb0d39d292dff9743fce1ceb3eaa270,1,Shwetha GS,2016-06-15 11:41:03+05:18,['8fefd165586f5fd8acd5c3a5786d6012dda68a5b'],17,60,77,694192,4,1,1,1,1345
39eb9f1eea636c0cf823570aed5f7dc5e8141bc5,1,Hemanth Yamijala,2016-06-15 23:38:50+05:18,['aad34ae00fb0d39d292dff9743fce1ceb3eaa270'],38,76,114,694306,3,0.692307692,0.884615385,0.923076923,1345
c9ee6d3f759437ca14d711d312b79dbf2e89983a,1,Hemanth Yamijala,2016-06-16 18:48:47+05:18,['39eb9f1eea636c0cf823570aed5f7dc5e8141bc5'],16,18,34,694340,2,,,,1345
86dd72aff5eabb8b73722388bce82ad713181400,1,Shwetha GS,2016-06-17 10:56:29+05:18,['c9ee6d3f759437ca14d711d312b79dbf2e89983a'],17,65,82,694422,7,0.297297297,1,0.945945946,1345
a2e7738aa25bba20bafa5f42ee1d628807a26b52,1,Hemanth Yamijala,2016-06-17 14:46:33+05:18,['86dd72aff5eabb8b73722388bce82ad713181400'],15,362,377,694799,8,0.605263158,0.857894737,0.721052632,1346
4f6816572cbcdbe7bbd0cf84ac21f799d51acde3,1,Hemanth Yamijala,2016-06-17 23:00:03+05:18,['a2e7738aa25bba20bafa5f42ee1d628807a26b52'],5,8,13,694812,5,1,1,1,1346
9d1040b7cf8e19728ad4c8d12ee24da28fb05ff8,1,Suma Shivaprasad,2016-06-17 10:57:44-07:00,['4f6816572cbcdbe7bbd0cf84ac21f799d51acde3'],5,78,83,694895,5,0.014705882,1,0.941176471,1346
6f241db4aeeba896c00f0b447fd269f0cee804da,1,Suma Shivaprasad,2016-06-17 11:08:50-07:00,['9d1040b7cf8e19728ad4c8d12ee24da28fb05ff8'],6,12,18,694913,3,0,0.8,0.8,1346
8c1c969fc7dc9205ed4ed2000c43093653afc2d7,1,Suma Shivaprasad,2016-06-17 11:27:05-07:00,['6f241db4aeeba896c00f0b447fd269f0cee804da'],20,17,37,694950,3,,,,1346
59bd56c8ef8f8794f8e1dd8785d8f78363c91da5,1,Suma Shivaprasad,2016-06-17 18:17:36-07:00,['8c1c969fc7dc9205ed4ed2000c43093653afc2d7'],762,1072,1834,696784,22,0.524390244,0.945121951,1,1348
c0cd9f0ac8e4417ae47b5ce98f0d20ae2fb910c3,1,Suma Shivaprasad,2016-06-17 18:18:23-07:00,['59bd56c8ef8f8794f8e1dd8785d8f78363c91da5'],119,332,451,697235,17,0.884057971,1,1,1348
9dd0f5c63dfa8ecb19544843d0a74368fe8bf52d,1,Suma Shivaprasad,2016-06-17 18:19:14-07:00,['c0cd9f0ac8e4417ae47b5ce98f0d20ae2fb910c3'],29,154,183,697418,9,0.426229508,0,0.754098361,1350
436a524518e9b36ac8865a51e80e53606d099f28,1,Suma Shivaprasad,2016-06-17 18:21:17-07:00,['9dd0f5c63dfa8ecb19544843d0a74368fe8bf52d'],0,3,3,697421,1,,,,1350
e30ab3d8d78cfe3dae70babff9d3c6bcf9065f20,1,Shwetha GS,2016-06-20 12:09:55+05:18,['436a524518e9b36ac8865a51e80e53606d099f28'],371,935,1306,698727,20,0.12244898,0.673469388,0.551020408,1352
f4670dd3a1bc8f767ad027c349d25244e2e61187,1,Suma Shivaprasad,2016-06-20 11:33:10-07:00,['e30ab3d8d78cfe3dae70babff9d3c6bcf9065f20'],11,19,30,698757,2,,,,1352
d838cf3852c1229dc4f70ef41588e8387fbf780a,1,Shwetha GS,2016-06-21 10:01:49+05:18,['f4670dd3a1bc8f767ad027c349d25244e2e61187'],239,200,439,699196,25,0.928571429,0.071428571,1,1352
f4ca40e239a76d103b4a7584ca72359b70b832b9,1,Shwetha GS,2016-06-21 10:01:49+05:18,['d838cf3852c1229dc4f70ef41588e8387fbf780a'],3,43,46,699242,3,,,,1352
7b3ace5e5ea5101631309af405109be7dda9a593,1,Hemanth Yamijala,2016-06-21 12:27:28+05:18,['f4ca40e239a76d103b4a7584ca72359b70b832b9'],112,256,368,699610,16,0,1,1,1352
1c3b2befbefacf57ab75d277de8206d08e0818b6,0,Shwetha GS,2016-06-21 14:28:57+05:18,['7b3ace5e5ea5101631309af405109be7dda9a593'],107,67,174,699784,22,,,,1352
814f066d99eab276bf4cec44e9bd2d3839b95f7b,1,Shwetha GS,2016-06-21 15:53:15+05:18,['1c3b2befbefacf57ab75d277de8206d08e0818b6'],4,11,15,699799,3,0,1,1,1352
32a5b761078f7ba2c31815b1ccf6b35e3692d535,1,Shwetha GS,2016-06-21 16:55:02+05:18,['814f066d99eab276bf4cec44e9bd2d3839b95f7b'],478,5,483,700282,6,0.520833333,0.366666667,0,1352
5b4cf4402b895464fb90b477514b8359b6f51c30,1,Hemanth Yamijala,2016-06-21 21:54:01+05:18,['32a5b761078f7ba2c31815b1ccf6b35e3692d535'],196,303,499,700781,4,0.163636364,0.618181818,0.763636364,1352
dfd9c96bab0252800f56c5419d7f005e55d3fc47,0,Shwetha GS,2016-06-21 22:07:35+05:18,['5b4cf4402b895464fb90b477514b8359b6f51c30'],0,4,4,700785,2,,,,1352
b25d198ca8b0f9d572ce46681a05f9c418cb745d,1,Hemanth Yamijala,2016-06-21 22:34:38+05:18,['dfd9c96bab0252800f56c5419d7f005e55d3fc47'],0,167,167,700952,3,,,,1353
3a68ea85e10c191a7fa6143ef5770f5bc08b9efa,1,Suma Shivaprasad,2016-06-21 10:17:57-07:00,['b25d198ca8b0f9d572ce46681a05f9c418cb745d'],115,66,181,701133,17,1,0,0,1353
c4650913edfa2b3d25cc7eaec443cd0fab1fbed3,0,Suma Shivaprasad,2016-06-21 10:42:29-07:00,['3a68ea85e10c191a7fa6143ef5770f5bc08b9efa'],0,1,1,701134,1,,,,1353
014abba5ea0d2cafe900adc6f16ce7b48eab0b55,0,Suma Shivaprasad,2016-06-21 14:42:11-07:00,['c4650913edfa2b3d25cc7eaec443cd0fab1fbed3'],0,14,14,701148,2,0,1,1,1353
3a1fe600f770ae8d239f8a5a4ee21a881419bcf5,0,Suma Shivaprasad,2016-06-21 16:20:39-07:00,['014abba5ea0d2cafe900adc6f16ce7b48eab0b55'],1,1,2,701150,1,,,,1353
7666ae996db5b888b3976d45b8a45ffe5ec02d94,0,Suma Shivaprasad,2016-06-21 16:24:27-07:00,['3a1fe600f770ae8d239f8a5a4ee21a881419bcf5'],0,1,1,701151,1,,,,1353
a7869beebf5cd32caebf86a24fd2661f6229c45a,1,Suma Shivaprasad,2016-06-21 17:48:34-07:00,['7666ae996db5b888b3976d45b8a45ffe5ec02d94'],3,75,78,701229,3,1,1,1,1354
9b00a9ddce40150fd66d87ddaae65250247bf196,1,Shwetha GS,2016-06-22 10:44:54+05:18,['a7869beebf5cd32caebf86a24fd2661f6229c45a'],174,859,1033,702262,19,0.696296296,0.811111111,1,1359
ce7d83c19ffda8df550ec0a5b2e1362aec5b2ba7,1,Shwetha GS,2016-06-22 11:17:18+05:18,['9b00a9ddce40150fd66d87ddaae65250247bf196'],9,5,14,702276,2,1,0,0,1359
89175edcf8f19f3d1ac4b57a8e7d992996034d24,0,Shwetha GS,2016-06-22 12:24:47+05:18,['ce7d83c19ffda8df550ec0a5b2e1362aec5b2ba7'],0,5,5,702281,2,,,,1359
fec431774556868ee926b0ed4bf713807c82bc16,0,Suma Shivaprasad,2016-06-22 13:06:58-07:00,['89175edcf8f19f3d1ac4b57a8e7d992996034d24'],5,6,11,702292,2,,,,1359
8cce9a9fc9d1dbeaa028aa42476c7b9d54cb7efa,1,Suma Shivaprasad,2016-06-22 14:12:47-07:00,['fec431774556868ee926b0ed4bf713807c82bc16'],1,6,7,702299,2,1,1,0,1359
78d787fec222f3b6e8b26596cf566eaba8ee4b79,0,Shwetha GS,2016-06-23 14:24:39+05:18,['8cce9a9fc9d1dbeaa028aa42476c7b9d54cb7efa'],3,6,9,702308,3,,,,1359
7993de0effee55a87f8366881656b9f109111bc2,1,Hemanth Yamijala,2016-06-24 10:41:00+05:18,['78d787fec222f3b6e8b26596cf566eaba8ee4b79'],38,251,289,702597,4,0.131034483,0.786206897,1,1359
202893a99f0e704554dc39973daea2fc8150cd73,1,Shwetha GS,2016-06-27 10:58:45+05:18,['7993de0effee55a87f8366881656b9f109111bc2'],57,105,162,702759,13,0.5,0.961538462,1,1359
2692f4768fe1bcfc07e7c69ed026089d5e8d3563,0,Hemanth Yamijala,2016-06-27 11:08:37+05:18,['202893a99f0e704554dc39973daea2fc8150cd73'],8,13,21,702780,4,0,1,1,1359
607e7de266234c19dbb7d86d0210735ed1efce5f,1,Hemanth Yamijala,2016-06-27 16:57:14+05:18,['2692f4768fe1bcfc07e7c69ed026089d5e8d3563'],7,9,16,702796,3,1,1,1,1359
0bf878de6f9b6c6d9000343690e25c4569cc062c,1,Hemanth Yamijala,2016-06-27 19:13:15+05:18,['607e7de266234c19dbb7d86d0210735ed1efce5f'],11,83,94,702890,7,0.636363636,1,0.340909091,1360
2b28ce4d02714dcea7234bb2d1355781989ebbb4,1,Suma Shivaprasad,2016-06-28 10:27:31-07:00,['0bf878de6f9b6c6d9000343690e25c4569cc062c'],27,100,127,703017,5,0,0,1,1360
377bc63519dba0b6408af86e6d567a5c8d1f48e6,0,Suma Shivaprasad,2016-06-28 10:31:41-07:00,['2b28ce4d02714dcea7234bb2d1355781989ebbb4'],0,4,4,703021,2,,,,1360
76b0560384f53ecb68b1b7e3e702bfde7e88e59b,1,Suma Shivaprasad,2016-06-28 10:34:33-07:00,['377bc63519dba0b6408af86e6d567a5c8d1f48e6'],54,143,197,703218,3,0,0.176470588,0.117647059,1360
6908b8426cf291adc7059869dcff18f5951162b6,1,Shwetha GS,2016-06-29 10:55:00+05:18,['76b0560384f53ecb68b1b7e3e702bfde7e88e59b'],335,90,425,703643,11,,,,1362
7403ebff168790bccc02732e6b7beb0829d0676a,0,Shwetha GS,2016-06-29 13:56:39+05:18,['6908b8426cf291adc7059869dcff18f5951162b6'],16,16,32,703675,1,,,,1362
95f4f2f021bf1388766b007fc869f52fb17d2aa8,1,Shwetha GS,2016-06-29 22:11:16+05:18,['7403ebff168790bccc02732e6b7beb0829d0676a'],1206,630,1836,705511,44,0,1,1,1367
727b27fbd212e5bf77f1ba7f77104b757523dded,0,Shwetha GS,2016-06-29 22:16:22+05:18,['95f4f2f021bf1388766b007fc869f52fb17d2aa8'],0,9,9,705520,2,,,,1367
c438e51149924c4ec88eac67140ae430994841d2,1,Shwetha GS,2016-06-30 11:36:59+05:18,['727b27fbd212e5bf77f1ba7f77104b757523dded'],37,11,48,705568,3,,,,1367
f370386c69bcf31f3124b31e8bf0e8e4afbf35c9,0,Hemanth Yamijala,2016-06-30 16:36:38+05:18,['c438e51149924c4ec88eac67140ae430994841d2'],56,2,58,705626,6,0,0,0,1367
07cf4a3e3189eedd95309e72777a6734b8465e5e,0,Suma Shivaprasad,2016-06-30 11:05:53-07:00,['f370386c69bcf31f3124b31e8bf0e8e4afbf35c9'],1,0,1,705627,1,,,,1367
14863225da35327a625998aa7638f3f0a3354e2e,0,Suma Shivaprasad,2016-06-30 11:06:38-07:00,['07cf4a3e3189eedd95309e72777a6734b8465e5e'],0,1,1,705628,1,,,,1367
f623bddf80265f0a4874b2305d198a6cf399e469,1,Suma Shivaprasad,2016-07-01 11:08:32-07:00,['14863225da35327a625998aa7638f3f0a3354e2e'],5,12,17,705645,2,,,,1367
f51c886158c9c0f7dc115f0c6f0aa0e08772e0b9,1,Suma Shivaprasad,2016-07-01 12:09:32-07:00,['f623bddf80265f0a4874b2305d198a6cf399e469'],199,473,672,706317,5,0,0.495238095,0.685714286,1367
d381f3d58aae758162e1aa9d49566d4a5f2a59c0,1,Shwetha GS,2016-07-05 11:05:16+05:18,['f51c886158c9c0f7dc115f0c6f0aa0e08772e0b9'],10,4,14,706331,4,,,,1367
8056a8d543ef71a15c07e090fd7dfd59497d98bf,1,Shwetha GS,2016-07-05 11:08:05+05:18,['d381f3d58aae758162e1aa9d49566d4a5f2a59c0'],1,2,3,706334,2,,,,1367
b731f64aef7426d3d17689affb5178eede4db0d9,1,Shwetha GS,2016-07-05 16:14:26+05:18,['8056a8d543ef71a15c07e090fd7dfd59497d98bf'],0,6,6,706340,2,,,,1367
33fdad76d1cda550c6abfe6eb39da40a9274410b,1,Shwetha GS,2016-07-07 10:17:39+05:18,['b731f64aef7426d3d17689affb5178eede4db0d9'],12,29,41,706381,2,0.411764706,0.411764706,1,1367
dda382f491f1bb26bdeb31620092a11ce9fdb710,1,Shwetha GS,2016-07-07 10:19:02+05:18,['33fdad76d1cda550c6abfe6eb39da40a9274410b'],28,492,520,706901,12,0.878504673,0.897196262,0.887850467,1369
ed07049a0e4296e55e88b875adaea21129af6f8f,1,Shwetha GS,2016-07-07 10:20:50+05:18,['dda382f491f1bb26bdeb31620092a11ce9fdb710'],0,48,48,706949,5,0,0.837837838,1,1369
b9ce7a11162466654ae9d8d5b84c2b592b6bfef8,1,Shwetha GS,2016-07-07 10:27:07+05:18,['ed07049a0e4296e55e88b875adaea21129af6f8f'],17,19,36,706985,3,1,1,1,1369
043d2aa642e695c7c61c0b771d978fc352caf203,1,Shwetha GS,2016-07-08 11:19:10+05:18,['b9ce7a11162466654ae9d8d5b84c2b592b6bfef8'],42,1489,1531,708516,18,0.5,0.735815603,0.973404255,1381
7fc276f609280ea51b782426a72d979613ae6707,1,Shwetha GS,2016-07-08 11:20:13+05:18,['043d2aa642e695c7c61c0b771d978fc352caf203'],8,56,64,708580,6,0.647058824,0.794117647,1,1381
1ee2c1bc45599a19f6a9546ca2718366f46f47b5,1,Shwetha GS,2016-07-08 11:21:02+05:18,['7fc276f609280ea51b782426a72d979613ae6707'],24,17,41,708621,3,0.5,0.5,0,1381
2ad344f02db95a7ff4af83fd1de9bfb17ded650e,1,Shwetha GS,2016-07-11 15:36:11+05:18,['1ee2c1bc45599a19f6a9546ca2718366f46f47b5'],1,22,23,708644,4,,,,1381
072a73e00d091232133006289d412a2f3a2a14b3,1,Shwetha GS,2016-07-12 11:03:03+05:18,['2ad344f02db95a7ff4af83fd1de9bfb17ded650e'],172,265,437,709081,22,0,0.928571429,1,1381
e13fa5ecd20dc877be6c6be2179f194255e69200,1,Shwetha GS,2016-07-12 11:06:37+05:18,['072a73e00d091232133006289d412a2f3a2a14b3'],0,3,3,709084,3,,,,1381
80051c9e846101130f29956db459d8d4243e2bd4,0,Shwetha GS,2016-07-13 10:07:25+05:18,['e13fa5ecd20dc877be6c6be2179f194255e69200'],4,44,48,709132,5,1,1,1,1381
079ce35ef2604a8f6eff35c698a38052009792df,1,Shwetha GS,2016-07-13 10:09:46+05:18,['80051c9e846101130f29956db459d8d4243e2bd4'],118,177,295,709427,19,0,1,0.905660377,1381
fa9fbbd7c74c2ff9e1e897258f6a102755ad4b4f,1,Shwetha GS,2016-07-13 15:11:09+05:18,['079ce35ef2604a8f6eff35c698a38052009792df'],40,147,187,709614,9,0.615384615,0.666666667,0.974358974,1381
99d51436752489cc9da440b8876a61ab26a8c68a,1,Shwetha GS,2016-07-13 15:22:10+05:18,['fa9fbbd7c74c2ff9e1e897258f6a102755ad4b4f'],25,16,41,709655,3,,,,1381
34f67ae0e75b61a12f5c261b358a64478ec37f07,0,Shwetha GS,2016-07-14 15:55:48+05:18,['99d51436752489cc9da440b8876a61ab26a8c68a'],2,7,9,709664,2,,,,1381
de0bf1db9f1116b02ef30d72cbfc157649a5010a,1,Shwetha GS,2016-07-14 15:57:54+05:18,['34f67ae0e75b61a12f5c261b358a64478ec37f07'],22,160,182,709846,19,0.590163934,0.68852459,0.885245902,1381
ab624ddabba53772ca72a5cb717baa22712ab27d,0,Shwetha GS,2016-07-15 17:14:57+05:18,['de0bf1db9f1116b02ef30d72cbfc157649a5010a'],32,88,120,709966,10,0,1,1,1381
8f229628f96bcc283e9d05f1fdf615f5cfd93b52,1,Shwetha GS,2016-07-15 17:22:10+05:18,['ab624ddabba53772ca72a5cb717baa22712ab27d'],14,53,67,710033,4,0.137931034,0.172413793,1,1381
b28ab21ee543c9f75df4f00a8d14f770277dbd4c,1,Shwetha GS,2016-07-15 19:22:47+05:18,['8f229628f96bcc283e9d05f1fdf615f5cfd93b52'],28,63,91,710124,8,1,1,1,1381
1b1f9d2aa945cdbc3a58da67090a67add1d2dae4,1,Shwetha GS,2016-07-15 19:32:39+05:18,['b28ab21ee543c9f75df4f00a8d14f770277dbd4c'],185,300,485,710609,7,0.510869565,0.608695652,1,1381
e895819fec853d86ed5f8a4ee7fb7a7f1bd5aa1a,1,Shwetha GS,2016-07-15 19:33:05+05:18,['1b1f9d2aa945cdbc3a58da67090a67add1d2dae4'],59,218,277,710886,6,0.008264463,0.867768595,1,1381
bff013f04759df3b1ce84184e1d3222ce7aef756,1,Suma Shivaprasad,2016-07-18 16:09:21-07:00,['e895819fec853d86ed5f8a4ee7fb7a7f1bd5aa1a'],217,736,953,711839,11,0,0.543589744,0.505128205,1382
3f47408e72fe717ad63e7b8464c6ef6fd4ae59b5,0,Suma Shivaprasad,2016-07-18 17:26:17-07:00,['bff013f04759df3b1ce84184e1d3222ce7aef756'],0,1,1,711840,1,,,,1382
038b6b315d8353e75fe3fd663ac034e025e541d2,1,Suma Shivaprasad,2016-07-18 17:32:54-07:00,['3f47408e72fe717ad63e7b8464c6ef6fd4ae59b5'],34,15,49,711889,11,0,0,0,1382
7cc347134a0084d45c740c42bb2760c7c3ac01cf,0,Suma Shivaprasad,2016-07-18 22:02:11-07:00,['038b6b315d8353e75fe3fd663ac034e025e541d2'],15,1,16,711905,3,,,,1382
d64112d6a95e6279fd54f2164e89857124450b67,1,Shwetha GS,2016-07-19 11:39:28+05:18,['7cc347134a0084d45c740c42bb2760c7c3ac01cf'],155,312,467,712372,14,0.486842105,0.986842105,1,1383
0cf25009940f222e0abdf823db539f2e5218e3e5,1,Suma Shivaprasad,2016-07-19 13:41:49-07:00,['d64112d6a95e6279fd54f2164e89857124450b67'],21,74,95,712467,4,,,,1383
f672aaeffdad9539b52d0122cc2593e7352d6329,1,Shwetha GS,2016-07-20 11:58:10+05:18,['0cf25009940f222e0abdf823db539f2e5218e3e5'],70,197,267,712734,4,,,,1383
67acb9d6edf3c62ddc63299bb7bb304b950b7f7d,1,Shwetha GS,2016-07-20 11:59:08+05:18,['f672aaeffdad9539b52d0122cc2593e7352d6329'],54,82,136,712870,6,0.611111111,0.944444444,1,1383
085d5c8642f6a47f25cf7ed6d6e3526dbbdc625f,1,Shwetha GS,2016-07-20 18:01:58+05:18,['67acb9d6edf3c62ddc63299bb7bb304b950b7f7d'],324,534,858,713728,30,0.513513514,0.612612613,0,1384
8e8b51b8ed4e3e62eadaa806c19d5981421111f7,0,Shwetha GS,2016-07-20 18:02:10+05:18,['085d5c8642f6a47f25cf7ed6d6e3526dbbdc625f'],1,2,3,713731,2,,,,1384
b7f5995aa815fa203617d70a23ce34022e57afa9,0,Suma Shivaprasad,2016-07-20 09:16:28-07:00,['8e8b51b8ed4e3e62eadaa806c19d5981421111f7'],1,2,3,713734,2,,,,1384
e15629c2eb10265676c8fae6b1444a07c005e1aa,1,Suma Shivaprasad,2016-07-20 10:39:41-07:00,['b7f5995aa815fa203617d70a23ce34022e57afa9'],254,326,580,714314,30,0,0,0.49122807,1384
b73e62ba3cb58df422246bfad880657b982f1bc5,1,Suma Shivaprasad,2016-07-20 17:32:15-07:00,['e15629c2eb10265676c8fae6b1444a07c005e1aa'],7,17,24,714338,2,0,1,1,1384
a10444d3939c93a6ab8b21c0f03a97e295190bc4,1,Shwetha GS,2016-07-22 12:29:45+05:18,['b73e62ba3cb58df422246bfad880657b982f1bc5'],10,498,508,714846,6,0.399339934,0.514851485,0.643564356,1385
65b1dee9f430719d9cfde696bd263e91ad866df4,1,Suma Shivaprasad,2016-07-22 17:34:35-07:00,['a10444d3939c93a6ab8b21c0f03a97e295190bc4'],11,76,87,714933,5,0.769230769,1,1,1385
fa47dd2d5daa3e1add9223727e8895abb9ce7c52,0,Suma Shivaprasad,2016-07-22 22:18:19-07:00,['65b1dee9f430719d9cfde696bd263e91ad866df4'],10,1,11,714944,2,,,,1385
d934645b294e390ad4690791e55932d71ea41391,1,Suma Shivaprasad,2016-07-25 12:45:29-07:00,['fa47dd2d5daa3e1add9223727e8895abb9ce7c52'],160,352,512,715456,11,0.270676692,0.744360902,0.631578947,1385
46ec799cc53af51806722e2e7ad7d5ef61e02df6,1,Suma Shivaprasad,2016-07-25 14:22:14-07:00,['d934645b294e390ad4690791e55932d71ea41391'],1,7,8,715464,3,,,,1385
56e97e225e65b50d15e6f59211f796788dd97446,1,Suma Shivaprasad,2016-07-25 14:24:26-07:00,['46ec799cc53af51806722e2e7ad7d5ef61e02df6'],1,2,3,715467,2,,,,1385
d0a9b99999a8d51a6612da62d025fbb48c471bc6,1,Suma Shivaprasad,2016-07-26 11:32:24-07:00,['56e97e225e65b50d15e6f59211f796788dd97446'],8,18,26,715493,3,0.666666667,0.666666667,0.666666667,1385
2dba5feabd6ab1821546888c607bb3e8d032de61,0,Suma Shivaprasad,2016-07-26 17:30:58-07:00,['d0a9b99999a8d51a6612da62d025fbb48c471bc6'],17,15,32,715525,3,1,0,0,1385
5de10081cdd2092ebba54700091db2a04fbdb711,1,Suma Shivaprasad,2016-07-26 17:32:35-07:00,['2dba5feabd6ab1821546888c607bb3e8d032de61'],6,5,11,715536,4,,,,1385
425237d59cc0344abfa74819f6e16f7214a59945,1,Suma Shivaprasad,2016-07-26 17:44:57-07:00,['5de10081cdd2092ebba54700091db2a04fbdb711'],136,166,302,715838,18,1,0.787878788,0.03030303,1385
9ab13a315bca318eb63a98ea50e2305f6362b8dd,1,Suma Shivaprasad,2016-07-27 14:08:03-07:00,['425237d59cc0344abfa74819f6e16f7214a59945'],42,123,165,716003,10,0,0.017241379,0.948275862,1385
4bc3e738eb692cdf141263e92b9b9785ff99da5c,1,Shwetha GS,2016-07-28 15:50:50+05:18,['9ab13a315bca318eb63a98ea50e2305f6362b8dd'],6,54,60,716063,6,0,0,1,1385
05277c27db46dec01727be798f99a7964cdba15f,1,Shwetha GS,2016-07-28 16:16:06+05:18,['4bc3e738eb692cdf141263e92b9b9785ff99da5c'],29,13,42,716105,4,0.421052632,0.052631579,0,1385
2b14ec1022f442576c996a5ec20e9a2a3803f011,0,Shwetha GS,2016-07-29 14:29:34+05:18,['05277c27db46dec01727be798f99a7964cdba15f'],4,9,13,716118,4,,,,1385
28c9efb1dea7b9c6aff026aa93584858201606fb,0,Shwetha GS,2016-07-29 17:20:28+05:18,['2b14ec1022f442576c996a5ec20e9a2a3803f011'],86,44,130,716248,2,0.214285714,0.214285714,0.571428571,1385
a4ceec90cc32a09d8035fe07e7377ee0f71923a7,0,Keval Bhatt,2016-07-29 18:03:37+05:18,['28c9efb1dea7b9c6aff026aa93584858201606fb'],0,11,11,716259,1,,,,1385
1c9b8b4191390b5024596bbe15d657b3bf84eb78,0,Shwetha GS,2016-08-01 09:22:48+05:18,['a4ceec90cc32a09d8035fe07e7377ee0f71923a7'],5,31,36,716295,3,1,1,1,1385
96a11675d83a0afc36e6893b6750abbb61a7c0fd,1,Shwetha GS,2016-08-01 22:43:43+05:18,['1c9b8b4191390b5024596bbe15d657b3bf84eb78'],63,106,169,716464,7,0.666666667,0.666666667,1,1385
69f6adfbc78e13485db0e20a7b8b2add431333d2,1,Shwetha GS,2016-08-01 22:45:27+05:18,['96a11675d83a0afc36e6893b6750abbb61a7c0fd'],2,3,5,716469,2,,,,1385
8a3c167ab3587ef1316fcfea445530974076daba,0,Dave Kantor,2016-08-01 19:51:48-04:00,['69f6adfbc78e13485db0e20a7b8b2add431333d2'],0,11,11,716480,1,,,,1385
838a0d4594385b2106867ee7fcd31982c448cd0b,1,Suma Shivaprasad,2016-08-02 13:18:27-07:00,['8a3c167ab3587ef1316fcfea445530974076daba'],262,444,706,717186,9,0.32,1,0.72,1387
6078c9aecce94e0a5e74711531e96fccf7ef6b84,0,Dave Kantor,2016-08-03 00:58:51+01:00,['838a0d4594385b2106867ee7fcd31982c448cd0b'],1,1,2,717188,1,,,,1387
bb78955020044d111589b24c96df9d755657853c,1,Suma Shivaprasad,2016-08-03 11:46:16-07:00,['6078c9aecce94e0a5e74711531e96fccf7ef6b84'],19,26,45,717233,8,0,1,1,1387
a165234cd373a2fbbcea23ca2a4d6936c907519f,1,Suma Shivaprasad,2016-08-03 12:10:15-07:00,['bb78955020044d111589b24c96df9d755657853c'],30,201,231,717464,13,0.288288288,0.963963964,0.963963964,1387
dd030ecaa06e1514d5c80aa816cd206f0bf16d68,1,Suma Shivaprasad,2016-08-03 18:00:41-07:00,['a165234cd373a2fbbcea23ca2a4d6936c907519f'],2,34,36,717500,3,0,1,0.565217391,1387
9eafb165addfe6d919c5179412cea5e34b3003e3,1,Suma Shivaprasad,2016-08-03 20:10:28-07:00,['dd030ecaa06e1514d5c80aa816cd206f0bf16d68'],4,26,30,717530,5,0.75,1,1,1387
a2801f0eaff29a834915f243245e2d28b86a2bc3,1,Suma Shivaprasad,2016-08-03 23:11:40-07:00,['9eafb165addfe6d919c5179412cea5e34b3003e3'],63,73,136,717666,3,0.142857143,0.142857143,0,1387
81ceabbdf6f817c1a25f439073941d5e19b88c9c,1,Keval Bhatt,2016-08-04 14:35:35+05:18,['a2801f0eaff29a834915f243245e2d28b86a2bc3'],51,84,135,717801,2,0,0,0,1387
38fd4f35845400f454b24cdd1db8e28ad3f84f21,1,Keval Bhatt,2016-08-05 14:28:23+05:18,['81ceabbdf6f817c1a25f439073941d5e19b88c9c'],144,257,401,718202,12,0.133333333,0,0.99047619,1387
3f51160f4a89536fa95cc167abbae4fab362e127,1,Shwetha GS,2016-08-05 16:09:19+05:18,['38fd4f35845400f454b24cdd1db8e28ad3f84f21'],74,69,143,718345,4,0,0,1,1387
d1940ba75df69cada0dea11708fc9052071bd41e,1,Shwetha GS,2016-08-05 16:09:19+05:18,['3f51160f4a89536fa95cc167abbae4fab362e127'],15,44,59,718404,4,0.192307692,0.615384615,0.423076923,1387
d671b12768b19d9d2b4e84c3528db1bec43388de,1,Keval Bhatt,2016-08-05 16:22:40+05:18,['d1940ba75df69cada0dea11708fc9052071bd41e'],69,143,212,718616,8,0.278688525,0.245901639,0.950819672,1387
89f25d411897dbd35a2baf7a96a0cf137c273f4a,1,Shwetha GS,2016-08-05 18:27:07+05:18,['d671b12768b19d9d2b4e84c3528db1bec43388de'],4,9,13,718629,2,0,1,0,1387
91072c10669c390338e39a9b705ffdd3bb5a3868,1,Shwetha GS,2016-08-05 18:27:07+05:18,['89f25d411897dbd35a2baf7a96a0cf137c273f4a'],124,158,282,718911,14,0.076923077,1,0.384615385,1387
1abd5a248ef424642aef2c40ce0bb7abbbc900ce,0,Suma Shivaprasad,2016-08-05 11:33:25-07:00,['91072c10669c390338e39a9b705ffdd3bb5a3868'],7,39,46,718957,4,0.611111111,0.722222222,0.722222222,1387
2ef0fc46d0e32c636da369911a1527e849f09049,1,Suma Shivaprasad,2016-08-05 14:10:25-07:00,['1abd5a248ef424642aef2c40ce0bb7abbbc900ce'],18,43,61,719018,10,0.7,1,1,1387
4fa10b6aecb248d09ee2a58b289a1d47f7d24419,1,Dave Kantor,2016-08-05 23:22:41+01:00,['2ef0fc46d0e32c636da369911a1527e849f09049'],610,4656,5266,724284,83,0.650174216,1,0.929616725,1419
beb5a09976f943c4a4943f04d8bc58b36dba3771,1,Suma Shivaprasad,2016-08-08 14:02:00-07:00,['4fa10b6aecb248d09ee2a58b289a1d47f7d24419'],55,62,117,724401,8,0,0,1,1419
2a7c4326cd6160b3e54c53b34399f96a4db8723f,1,Suma Shivaprasad,2016-08-08 14:13:45-07:00,['beb5a09976f943c4a4943f04d8bc58b36dba3771'],2,4,6,724407,2,,,,1419
7826a1ab5adb7a20f9b01e27f34451252369240f,0,Suma Shivaprasad,2016-08-08 16:53:12-07:00,['2a7c4326cd6160b3e54c53b34399f96a4db8723f'],1,2,3,724410,2,,,,1419
127b378df5ff2712754abf32e86bdc279d7a29e2,1,Shwetha GS,2016-08-09 12:28:50+05:18,['7826a1ab5adb7a20f9b01e27f34451252369240f'],9,168,177,724587,7,0.090909091,0.590909091,0.672727273,1419
d06b8229ab0a08b52c9bac87056c30a5b9ad02ac,1,Dave Kantor,2016-08-09 22:21:25+01:00,['127b378df5ff2712754abf32e86bdc279d7a29e2'],69,497,566,725153,8,0.335766423,0.594890511,0.981751825,1419
a07f3cc041813e5431bfc5e1b43f0d466756ca70,1,Suma Shivaprasad,2016-08-10 15:02:59-07:00,['d06b8229ab0a08b52c9bac87056c30a5b9ad02ac'],3,7,10,725163,3,0,1,1,1419
bf2e60917b7f202ccfa45accbdd836c7513427f2,0,Suma Shivaprasad,2016-08-11 11:21:38-07:00,['a07f3cc041813e5431bfc5e1b43f0d466756ca70'],1,16,17,725180,2,1,1,1,1419
c1efcf061d39d46ae184cd180455b001e0a33b75,1,Suma Shivaprasad,2016-08-11 11:34:20-07:00,['bf2e60917b7f202ccfa45accbdd836c7513427f2'],13,17,30,725210,4,1,1,1,1419
531a9684f57836a600e7172d7b6d089cef19f7ca,1,Dave Kantor,2016-08-11 15:05:29-04:00,['c1efcf061d39d46ae184cd180455b001e0a33b75'],2,4,6,725216,2,,,,1419
7f2a40864df223cde3b1292961b40ebbeaec4267,1,Suma Shivaprasad,2016-08-11 22:00:14-07:00,['531a9684f57836a600e7172d7b6d089cef19f7ca'],37,45,82,725298,10,0,1,1,1419
30893c5e5be5a1c3a2f104d554cc3772a6ef7b81,1,Suma Shivaprasad,2016-08-12 14:03:55-07:00,['7f2a40864df223cde3b1292961b40ebbeaec4267'],254,444,698,725996,18,0.372093023,0.848837209,1,1420
bed2a70d6302325ec909ff119694784618d5bda4,0,Darshan,2016-08-14 23:20:36+05:18,['30893c5e5be5a1c3a2f104d554cc3772a6ef7b81'],0,11,11,726007,1,,,,1420
ab95c1a7bbf1209c22aaf661a69bd007c5277bc8,1,Shwetha GS,2016-08-16 15:02:59+05:18,['bed2a70d6302325ec909ff119694784618d5bda4'],56,232,288,726295,10,0.136363636,0.7,0.818181818,1421
6fddccd6a28d7cf194926c3d44debeb1b49cd434,0,Suma Shivaprasad,2016-08-16 11:37:27-07:00,['ab95c1a7bbf1209c22aaf661a69bd007c5277bc8'],59,66,125,726420,2,0,0,0,1421
eb98bfe78942caf1fa630e35f619f3a4f2f61856,1,Suma Shivaprasad,2016-08-17 09:29:26-07:00,['6fddccd6a28d7cf194926c3d44debeb1b49cd434'],29,34,63,726483,5,0,1,1,1421
8cdc8981d7d6f71b5de506b3ba390763e9e7e80b,0,Suma Shivaprasad,2016-08-17 09:37:12-07:00,['eb98bfe78942caf1fa630e35f619f3a4f2f61856'],0,7,7,726490,2,0,1,1,1421
1a405f9c18f9570886ffb56f3bf008b2cc4adc0c,1,Suma Shivaprasad,2016-08-18 08:26:12-07:00,['8cdc8981d7d6f71b5de506b3ba390763e9e7e80b'],4,6,10,726500,3,,,,1421
7b7f4e0b68637fec82af4443aedcecc63cf10747,0,Suma Shivaprasad,2016-08-18 08:35:43-07:00,['1a405f9c18f9570886ffb56f3bf008b2cc4adc0c'],8,4,12,726512,3,0,0,0.25,1421
64f017a7079d547ebd9b972b4a115ce807855e33,1,Suma Shivaprasad,2016-08-18 11:29:08-07:00,['7b7f4e0b68637fec82af4443aedcecc63cf10747'],28,111,139,726651,12,0.840909091,0.363636364,0.909090909,1422
ec94d2ad169f92feb9005ca1dc06845216c77055,1,Suma Shivaprasad,2016-08-18 15:46:00-07:00,['64f017a7079d547ebd9b972b4a115ce807855e33'],2,42,44,726695,4,0,1,1,1422
f408e93eebfd870f7eef547438c41260f729fdd9,1,Suma Shivaprasad,2016-08-19 11:02:39-07:00,['ec94d2ad169f92feb9005ca1dc06845216c77055'],3,26,29,726724,5,0.083333333,0,0.583333333,1422
0023236fbaee47e6c80852943d253b3ff641f823,1,Keval Bhatt,2016-08-31 13:40:02+05:18,['f408e93eebfd870f7eef547438c41260f729fdd9'],10,14,24,726748,4,0,1,1,1422
a2c3faad143a284dd22557b289efa8190688abf1,1,Keval Bhatt,2016-08-31 13:44:04+05:18,['0023236fbaee47e6c80852943d253b3ff641f823'],18,60,78,726826,4,0.153846154,0.980769231,1,1422
e817b214387525def94930a7375b297157037155,1,Keval Bhatt,2016-09-01 12:24:30+05:18,['a2c3faad143a284dd22557b289efa8190688abf1'],2,7,9,726835,3,0.333333333,1,1,1422
f54325f1c99fec1a9d06a1fab7893b7656a8398f,1,Keval Bhatt,2016-09-01 12:29:22+05:18,['e817b214387525def94930a7375b297157037155'],67,126,193,727028,2,0.27027027,0,0.405405405,1422
4b2e6ba9e81bc5d1c1c2e12d1a6bedb27bdf2f0e,0,Dave Kantor,2016-09-07 02:53:56+01:00,['f54325f1c99fec1a9d06a1fab7893b7656a8398f'],14,15,29,727057,3,,,,1422
0596c9fc3edcd4fbf9dae5a0bedf31e99cabc930,1,kevalbhatt,2016-09-09 22:03:05+05:18,['4b2e6ba9e81bc5d1c1c2e12d1a6bedb27bdf2f0e'],24,28,52,727109,2,0,1,1,1422
96f2306f9dfc133f9e7d79421dc97eee0a4d671e,1,kevalbhatt,2016-09-09 22:21:57+05:18,['0596c9fc3edcd4fbf9dae5a0bedf31e99cabc930'],0,57,57,727166,2,0,0.025641026,1,1422
8044ca48d041f59a66ccd597a1cf7e9832a60146,1,Suma Shivaprasad,2016-09-12 20:08:10-07:00,['96f2306f9dfc133f9e7d79421dc97eee0a4d671e'],9,27,36,727202,6,0,1,1,1422
5ca1ed3f0e1fd3b896a4b7160b960d40864dfd89,1,kevalbhatt,2016-09-13 10:56:07+05:18,['8044ca48d041f59a66ccd597a1cf7e9832a60146'],3,20,23,727225,4,0.894736842,1,0.894736842,1422
165efca69939577f56526d7df48b07ec4509c8e0,0,kevalbhatt,2016-09-13 11:09:45+05:18,['5ca1ed3f0e1fd3b896a4b7160b960d40864dfd89'],2,30,32,727257,5,0,0.875,1,1422
2f195e7f275839436c49bfee4de4afa4f586d736,0,Shwetha GS,2016-09-15 11:41:28+05:18,['165efca69939577f56526d7df48b07ec4509c8e0'],28,36,64,727321,2,,,,1422
b856269e98f6e094f2bea775afb97ad2c4d9d9c7,0,Shwetha GS,2016-09-15 11:43:47+05:18,['2f195e7f275839436c49bfee4de4afa4f586d736'],1,2,3,727324,2,,,,1422
b6e0d60fd5f18171397bc2a9c160614149515ae5,0,kevalbhatt,2016-09-15 20:05:09+05:18,['b856269e98f6e094f2bea775afb97ad2c4d9d9c7'],0,140,140,727464,4,0.133333333,0.655555556,1,1422
e8a148497192863d8ad019474faddb74974d4e2c,0,kevalbhatt,2016-09-16 10:54:21+05:18,['b6e0d60fd5f18171397bc2a9c160614149515ae5'],140,0,140,727604,4,0.866666667,0.344444444,0,1422
dd0b051ec58ca292fca1862701e1089ad408e18d,1,Shwetha GS,2016-09-19 10:34:34+05:18,['e8a148497192863d8ad019474faddb74974d4e2c'],10,162,172,727776,7,0.183673469,0.673469388,1,1422
7bb2709d16694fb7957e2018532121474a810f14,1,Shwetha GS,2016-09-19 10:40:53+05:18,['dd0b051ec58ca292fca1862701e1089ad408e18d'],10,102,112,727888,14,0.776315789,0.756578947,0.907894737,1425
c1081a49da3553f55b33edecb416de99c90d10b4,0,Shwetha GS,2016-09-19 11:01:08+05:18,['7bb2709d16694fb7957e2018532121474a810f14'],59,16,75,727963,6,1,1,0,1425
71e0e09b9d7c9f999741a71b4e779eb89a051760,1,Shwetha GS,2016-09-19 11:35:22+05:18,['c1081a49da3553f55b33edecb416de99c90d10b4'],3,7,10,727973,4,1,1,1,1425
180c6e571efed300e067bfa0cd009f7ce55d2ee5,1,Shwetha GS,2016-09-28 12:25:17+05:18,['71e0e09b9d7c9f999741a71b4e779eb89a051760'],65,813,878,728851,22,0.483333333,0.652380952,0.666666667,1428
100749b49a394f928cebd24ba085a5120066dcad,1,Shwetha GS,2016-09-29 11:31:54+05:18,['180c6e571efed300e067bfa0cd009f7ce55d2ee5'],40,25,65,728916,6,0,1,1,1428
4c56c61f85c4c38a1d2bec3088130f2ea5f1e8fe,1,Shwetha GS,2016-09-29 11:38:47+05:18,['100749b49a394f928cebd24ba085a5120066dcad'],25,112,137,729053,4,0.047619048,0.285714286,0.571428571,1428
a52112d8633c2eb5dea0c3a6ffd3f308594a3996,1,Shwetha GS,2016-09-30 12:39:29+05:18,['4c56c61f85c4c38a1d2bec3088130f2ea5f1e8fe'],26,313,339,729392,6,0.411764706,0.852941176,0.799019608,1429
698a56526ce5704e49054b8f8e40ab173a9a3166,1,Shwetha GS,2016-10-02 18:11:33+05:18,['a52112d8633c2eb5dea0c3a6ffd3f308594a3996'],1,8316,8317,737709,53,0.729145978,0.846077458,0.935203575,1478
2a441bec1f4d0ae2621e4b878f4738c032392e0a,0,Shwetha GS,2016-10-02 18:13:30+05:18,['698a56526ce5704e49054b8f8e40ab173a9a3166'],5,11,16,737725,2,0,0.6,0,1478
630a562b2d0adf6178f29cb802d6179c074c213e,1,Shwetha GS,2016-10-04 14:57:06+05:18,['2a441bec1f4d0ae2621e4b878f4738c032392e0a'],690,904,1594,739319,12,,,,1478
adfdef023b3dbdf7c03b4039a814d47a50ef41e3,1,Suma Shivaprasad,2016-10-04 11:27:11-07:00,['630a562b2d0adf6178f29cb802d6179c074c213e'],22,65,87,739406,2,0.6,0.6,0.742857143,1478
1d84cbbdc3d8acc0a02c94b8c8076500acf6c93c,1,Suma Shivaprasad,2016-10-04 14:42:13-07:00,['adfdef023b3dbdf7c03b4039a814d47a50ef41e3'],30,312,342,739748,15,1,1,0.594936709,1478
3e4f28f50c03035915187f624a41064a82d2af37,0,kevalbhatt,2016-10-06 18:11:03+05:18,['1d84cbbdc3d8acc0a02c94b8c8076500acf6c93c'],2,3,5,739753,2,,,,1478
d2d6ff7d18bf6f6165feaa440359b5a7fc5c2723,1,Suma Shivaprasad,2016-10-10 15:37:30-07:00,['3e4f28f50c03035915187f624a41064a82d2af37'],2878,3851,6729,746482,111,0.478359909,0.740318907,0.676537585,1483
0d01f356c93d4a06fb907a2de3401c4f11dd1d13,0,Suma Shivaprasad,2016-10-11 13:32:35-07:00,['d2d6ff7d18bf6f6165feaa440359b5a7fc5c2723'],3,12,15,746497,5,0,0,0,1484
f8fe0945c9c99a6979c3acfa463e0796db50b42f,1,Suma Shivaprasad,2016-10-12 16:21:19-07:00,['0d01f356c93d4a06fb907a2de3401c4f11dd1d13'],132,3517,3649,750146,37,0.64573991,0.831278027,0.92264574,1500
7d9f22c2dd30013e05105f238e052e5c2f2d2a48,0,Suma Shivaprasad,2016-10-12 17:46:12-07:00,['f8fe0945c9c99a6979c3acfa463e0796db50b42f'],4,0,4,750150,1,,,,1500
5b7945eebd283c535992476b12c341ff5c8d5f99,1,Suma Shivaprasad,2016-10-14 11:27:31-07:00,['7d9f22c2dd30013e05105f238e052e5c2f2d2a48'],3,4,7,750157,3,,,,1500
a2eca47e3b0cb7deb25e0d182582d9ad906a83b8,1,Shwetha GS,2016-10-17 12:04:24+05:18,['5b7945eebd283c535992476b12c341ff5c8d5f99'],8,20,28,750185,3,0,0,1,1500
51d24ae3b9da0996d9d2d1bcb1496c810d27e287,0,Shwetha GS,2016-10-17 12:09:54+05:18,['a2eca47e3b0cb7deb25e0d182582d9ad906a83b8'],1,2,3,750188,2,,,,1500
e5fe91a44bff992e571d3ff5811113068d635e36,1,Suma Shivaprasad,2016-10-17 11:54:30-07:00,['51d24ae3b9da0996d9d2d1bcb1496c810d27e287'],314,609,923,751111,16,0.365168539,0.050561798,0.91011236,1500
92dc6faa0c6d9f80340e27dfdea76b1a6a6c2d3c,0,Madhan Neethiraj,2016-10-17 12:04:01-07:00,['e5fe91a44bff992e571d3ff5811113068d635e36'],0,10,10,751121,1,,,,1500
d185522b52767e2468e8d0a5ebd375a8827b0fa8,1,Madhan Neethiraj,2016-10-18 14:07:15-07:00,['92dc6faa0c6d9f80340e27dfdea76b1a6a6c2d3c'],65,584,649,751770,8,0.460227273,0.568181818,0.5,1500
4d9cf4564baa5aac6a1e123d8670fc1c13034668,0,Suma Shivaprasad,2016-10-18 16:13:48-07:00,['d185522b52767e2468e8d0a5ebd375a8827b0fa8'],25,47,72,751842,9,1,1,1,1500
eb6e656be868fba22aaa330d98137be78e30bdcb,1,Madhan Neethiraj,2016-10-18 18:33:36-07:00,['4d9cf4564baa5aac6a1e123d8670fc1c13034668'],836,1038,1874,753716,20,1,1,1,1501
3cc1bd5b837c944c8af1d50451ef89a1d3f15ee6,1,Shwetha GS,2016-10-19 15:09:51+05:18,['eb6e656be868fba22aaa330d98137be78e30bdcb'],0,38,38,753754,3,,,,1502
b6acff6d5ba1cdde8ddde96fe55071732fb83da0,0,Shwetha GS,2016-10-19 15:22:12+05:18,['3cc1bd5b837c944c8af1d50451ef89a1d3f15ee6'],2,3,5,753759,3,,,,1502
08f56903929861a4c81445646be07fb18d099b5b,1,Madhan Neethiraj,2016-10-19 16:54:13-07:00,['b6acff6d5ba1cdde8ddde96fe55071732fb83da0'],420,753,1173,754932,15,0,0.147058824,0.860294118,1502
a96424a1ad566b8d13c18bd1d1694ffd0d33844c,1,Shwetha GS,2016-10-21 11:25:37+05:18,['08f56903929861a4c81445646be07fb18d099b5b'],66,78,144,755076,4,1,1,1,1502
5a4dd2e724bdca8db02dd4b9b6d59eb19296de95,1,Madhan Neethiraj,2016-10-22 11:17:13-07:00,['a96424a1ad566b8d13c18bd1d1694ffd0d33844c'],45,482,527,755603,7,0.284132841,0.874538745,0.656826568,1503
fdf97ae4d0caf4b10c8f3f6562132a0cdac76c38,1,Suma Shivaprasad,2016-10-24 15:22:48-07:00,['5a4dd2e724bdca8db02dd4b9b6d59eb19296de95'],212,413,625,756228,16,0.892307692,0.076923077,0.907692308,1506
aa15cd0aec15000a225f2a32477c4158d224b24e,1,Suma Shivaprasad,2016-10-24 15:26:10-07:00,['fdf97ae4d0caf4b10c8f3f6562132a0cdac76c38'],7,11,18,756246,6,1,1,0.5,1506
69af0ae77a389afffa5dcfedd6297528628b12f8,1,Dave Kantor,2016-10-27 14:52:18-04:00,['aa15cd0aec15000a225f2a32477c4158d224b24e'],475,2340,2815,759061,29,0.697022767,1,0.322241681,1529
d3bca39fd90b77b28902fbdc5a9050a204ec8898,1,Suma Shivaprasad,2016-10-28 16:46:54-07:00,['69af0ae77a389afffa5dcfedd6297528628b12f8'],76,96,172,759233,8,1,0,1,1529
9dc4cfbcb10f38cbf8fa331fe76093d9791d6204,1,Suma Shivaprasad,2016-10-31 14:42:13-07:00,['d3bca39fd90b77b28902fbdc5a9050a204ec8898'],0,3,3,759236,2,0,0,1,1529
0b85d5a0cac7b0d9ca9e3548538051f8b332bc25,1,Suma Shivaprasad,2016-10-31 15:20:04-07:00,['9dc4cfbcb10f38cbf8fa331fe76093d9791d6204'],204,732,936,760172,27,0.554421769,0.62244898,0.816326531,1531
c9e58e0aa31fa833981a8c069e23a4ca3e07b293,1,Suma Shivaprasad,2016-11-01 12:08:35-07:00,['0b85d5a0cac7b0d9ca9e3548538051f8b332bc25'],10,1206,1216,761388,7,0.251190476,0.892857143,0.955952381,1533
29880e77c953cf4ddc8e9733b5d71c6dd75a328c,0,Suma Shivaprasad,2016-11-01 14:11:58-07:00,['c9e58e0aa31fa833981a8c069e23a4ca3e07b293'],9,4,13,761401,2,1,1,1,1533
315b5d184b4d0dda414693573c8f5e7e880c19f9,1,Suma Shivaprasad,2016-11-01 14:18:17-07:00,['29880e77c953cf4ddc8e9733b5d71c6dd75a328c'],2,12,14,761415,2,0,0,1,1533
9f643b5b916a97b8d39626d2d50aba4953a542fa,0,Suma Shivaprasad,2016-11-01 18:40:20-07:00,['315b5d184b4d0dda414693573c8f5e7e880c19f9'],2,11,13,761428,3,0,1,1,1533
0c7468954f5cf9f85fd066397707e3528ee89da8,1,Suma Shivaprasad,2016-11-01 20:49:47-07:00,['9f643b5b916a97b8d39626d2d50aba4953a542fa'],27,1305,1332,762760,14,0.893782383,0.82642487,0.909326425,1541
6a24cad180b071290211c2695c567e83c13e9f97,1,Madhan Neethiraj,2016-11-03 13:17:54-07:00,['0c7468954f5cf9f85fd066397707e3528ee89da8'],46,179,225,762985,3,0.02,0.48,0.4,1541
f3bbdc151d3aed6c8843f763c06d12c81033de7b,1,Madhan Neethiraj,2016-11-03 13:40:17-07:00,['6a24cad180b071290211c2695c567e83c13e9f97'],198,249,447,763432,6,0.428571429,0.4,1,1541
2ea3a455ecc9ba7add35b76c15b7d3089e52f070,0,Shwetha GS,2016-11-07 16:32:34+05:18,['f3bbdc151d3aed6c8843f763c06d12c81033de7b'],0,3,3,763435,2,1,1,1,1541
def9e385cc17c2bceb9450c82947370fadc09c3c,1,Madhan Neethiraj,2016-11-07 14:06:57-08:00,['2ea3a455ecc9ba7add35b76c15b7d3089e52f070'],2616,1917,4533,767968,57,0.545997611,0.106332139,0.029868578,1551
c3bf72cd0bf40db688b425d6db9f6f58c73e34a9,0,Shwetha GS,2016-11-08 14:19:11+05:18,['def9e385cc17c2bceb9450c82947370fadc09c3c'],2,9,11,767979,2,0,1,1,1551
7fca22fff296bc63d049b36cf95a95f985435a02,1,kevalbhatt,2016-11-08 14:25:13+05:18,['c3bf72cd0bf40db688b425d6db9f6f58c73e34a9'],220,744,964,768943,44,0.889655172,0.772413793,0.972413793,1561
bf5f53a7f9f32ff3ff98742536f14f665611d48b,1,Shwetha GS,2016-11-09 11:51:17+05:18,['7fca22fff296bc63d049b36cf95a95f985435a02'],162,315,477,769420,18,,,,1563
ee5b03cabcf20cbe72094f84d687252b17cf395d,1,Madhan Neethiraj,2016-11-08 23:13:33-08:00,['bf5f53a7f9f32ff3ff98742536f14f665611d48b'],16,222,238,769658,16,0.742268041,0.649484536,0.948453608,1565
ed2632c87c42b4e942f0d14ea19a8ccf3c81b5e9,0,Vimal Sharma,2016-11-09 15:50:15+05:18,['ee5b03cabcf20cbe72094f84d687252b17cf395d'],0,10,10,769668,1,,,,1565
cd342783a65b56040a77f615c94a0f443a8c1d40,0,Jeff Hagelberg,2016-11-09 10:22:20-05:00,['ed2632c87c42b4e942f0d14ea19a8ccf3c81b5e9'],0,11,11,769679,1,,,,1565
ed3c32c125cc77c74d18d5053a38278f43e3d77b,0,Madhan Neethiraj,2016-11-09 20:21:49-08:00,['cd342783a65b56040a77f615c94a0f443a8c1d40'],4,2,6,769685,2,0,0,1,1565
46f9f0f8e27632213f89c30f92c93cd04ecaef84,0,Madhan Neethiraj,2016-11-10 13:28:27-08:00,['ed3c32c125cc77c74d18d5053a38278f43e3d77b'],1,24,25,769710,2,,,,1565
e20d76e3bcbc8fd743f96bf64fc2d1526a1dc885,1,Madhan Neethiraj,2016-11-10 13:30:12-08:00,['46f9f0f8e27632213f89c30f92c93cd04ecaef84'],90,190,280,769990,15,0.066666667,0.366666667,0.933333333,1565
71714d20f1e3d5e4e30332ca3c692e186f90c220,1,Suma Shivaprasad,2016-11-10 14:42:51-08:00,['e20d76e3bcbc8fd743f96bf64fc2d1526a1dc885'],315,162,477,770467,18,,,,1565
2119666fd0d224c8d6f0d9c139ad11749e58bf73,0,Madhan Neethiraj,2016-11-10 14:50:31-08:00,['71714d20f1e3d5e4e30332ca3c692e186f90c220'],6,8,14,770481,2,0,1,1,1565
ea6c3cb5a0c69ae76fe6a6d337080fe87c48aa5b,1,Madhan Neethiraj,2016-11-11 16:43:23-08:00,['2119666fd0d224c8d6f0d9c139ad11749e58bf73'],0,1134,1134,771615,10,0.545132743,0.87079646,0.679646018,1571
f6388234b8f1fac00e83df08614c346957107573,1,Vimal Sharma,2016-11-14 13:51:01+05:18,['ea6c3cb5a0c69ae76fe6a6d337080fe87c48aa5b'],22,2,24,771639,2,0.055555556,0,0,1571
758b3d4df5033d60b5fa42a15d5bc4ee196c89bc,1,Madhan Neethiraj,2016-11-14 01:44:02-08:00,['f6388234b8f1fac00e83df08614c346957107573'],451,1355,1806,773445,12,0.59375,0.7109375,0.8359375,1575
33d60746ab6be129251dabae7a3b104c8533e095,1,Suma Shivaprasad,2016-11-14 13:01:39-08:00,['758b3d4df5033d60b5fa42a15d5bc4ee196c89bc'],59,1956,2015,775460,32,0.610552764,0.850502513,0.797738693,1591
d95775161d1b51cff7bfc8756c0a72f639667cec,0,Suma Shivaprasad,2016-11-14 13:32:47-08:00,['33d60746ab6be129251dabae7a3b104c8533e095'],0,0,0,775460,1,,,,1591
43a1e25bdd1d3f7700c905a29c21dcd601591872,1,Shwetha GS,2016-11-15 13:42:16+05:18,['d95775161d1b51cff7bfc8756c0a72f639667cec'],93,112,205,775665,9,1,1,1,1592
ae92406d993c0f9be7fd90deb0647f3845f5ba0a,1,Suma Shivaprasad,2016-11-15 14:08:38-08:00,['43a1e25bdd1d3f7700c905a29c21dcd601591872'],4,5,9,775674,2,,,,1592
854b792802f9a56a47bb7bb461077921867bd967,1,Madhan Neethiraj,2016-11-15 17:46:47-08:00,['ae92406d993c0f9be7fd90deb0647f3845f5ba0a'],17,680,697,776371,13,0.33836858,0.516616314,0.803625378,1595
1821667e7e666e89e7440ca22e34a5bbd665d700,1,Shwetha GS,2016-11-16 13:34:10+05:18,['854b792802f9a56a47bb7bb461077921867bd967'],164,324,488,776859,18,,,,1597
1b066acb0cd8dd334b3e0ba3d7cb05e3d30aa47e,0,Shwetha GS,2016-11-17 16:19:59+05:18,['1821667e7e666e89e7440ca22e34a5bbd665d700'],0,3,3,776862,3,,,,1597
710c17f5505d99429d76ae16479f31d6c09dbd81,0,Madhan Neethiraj,2016-11-17 22:49:17-08:00,['1b066acb0cd8dd334b3e0ba3d7cb05e3d30aa47e'],2,2,4,776866,2,,,,1597
95083cb01fd2daeded1d55f6a2ce4791a933c974,1,Madhan Neethiraj,2016-11-18 00:23:07-08:00,['710c17f5505d99429d76ae16479f31d6c09dbd81'],45,600,645,777511,7,0.280991736,0.435261708,1,1598
774975c970cc2613a9f955c35f8eead16ad1d9bf,1,Madhan Neethiraj,2016-11-18 16:21:55-08:00,['95083cb01fd2daeded1d55f6a2ce4791a933c974'],22,367,389,777900,20,0.405263158,0.763157895,0.757894737,1599
9dc96c467a6315c6713ec76d8afe32dbe46271a1,1,Madhan Neethiraj,2016-11-19 14:30:26-08:00,['774975c970cc2613a9f955c35f8eead16ad1d9bf'],124,139,263,778163,6,0,1,1,1599
4db76f9594f442045990bfb4f055868b959aaafc,1,Madhan Neethiraj,2016-11-20 11:26:45-08:00,['9dc96c467a6315c6713ec76d8afe32dbe46271a1'],0,50,50,778213,1,,,,1599
94a827220cc02b722607adbb40f2060809a12ab9,0,Madhan Neethiraj,2016-11-20 21:24:38-08:00,['4db76f9594f442045990bfb4f055868b959aaafc'],5,13,18,778231,2,1,1,1,1599
1fa05264311fbdbaf7f4cb63bb7b3e09628f80f8,1,Shwetha GS,2016-11-21 16:24:45+05:18,['94a827220cc02b722607adbb40f2060809a12ab9'],383,638,1021,779252,27,1,1,0.512396694,1604
699498d70efa0aedf3370abe44ffceffa41e7df6,0,svimal2106,2016-11-21 18:58:37+05:18,['1fa05264311fbdbaf7f4cb63bb7b3e09628f80f8'],0,23,23,779275,4,0.692307692,1,1,1604
c1b57d5648a1707528908b1ad70bdc7c7cf6ddeb,1,Madhan Neethiraj,2016-11-21 21:57:43-08:00,['699498d70efa0aedf3370abe44ffceffa41e7df6'],28,201,229,779504,11,0.082568807,0.431192661,0.798165138,1605
cea70bc6f94c61607b8fc7406bf15ff0f4b3df90,0,Madhan Neethiraj,2016-11-22 12:51:21-08:00,['c1b57d5648a1707528908b1ad70bdc7c7cf6ddeb'],0,7,7,779511,1,,,,1605
f694a910b8743c197b6c33c3513558fd940e3478,1,Vimal Sharma,2016-11-23 11:56:41+05:18,['cea70bc6f94c61607b8fc7406bf15ff0f4b3df90'],85,188,273,779784,4,0.275862069,1,0.436781609,1605
d4efc378437f690669a382bdd413ef9371fac568,1,Madhan Neethiraj,2016-11-23 17:51:28-08:00,['f694a910b8743c197b6c33c3513558fd940e3478'],780,600,1380,781164,23,0,0,1,1609
b9525a576d1f4149883fad494f4d4e8310cc7f85,1,Vimal Sharma,2016-11-24 15:54:05+05:18,['d4efc378437f690669a382bdd413ef9371fac568'],51,88,139,781303,7,0,1,1,1609
52a8805e92ce41e87e542b42ea6d1b73206d2af4,0,Vimal Sharma,2016-11-24 17:40:08+05:18,['b9525a576d1f4149883fad494f4d4e8310cc7f85'],1,2,3,781306,2,,,,1609
db359532ac32130ce1af044784b6d746fdafc70a,0,Vimal Sharma,2016-11-24 17:46:05+05:18,['52a8805e92ce41e87e542b42ea6d1b73206d2af4'],8,46,54,781360,4,,,,1609
86740c148b16940930bdbfe88998b31046d781f6,1,Vimal Sharma,2016-11-24 18:58:37+05:18,['db359532ac32130ce1af044784b6d746fdafc70a'],46,8,54,781414,4,,,,1609
b688f80e9072d6c7c9bc46d441b8ce87318bcdd5,1,Madhan Neethiraj,2016-11-26 00:37:37-08:00,['86740c148b16940930bdbfe88998b31046d781f6'],9,11,20,781434,1,0,0,1,1609
6600335558587d3446124a155a9753c26670858e,1,Madhan Neethiraj,2016-11-26 01:22:45-08:00,['b688f80e9072d6c7c9bc46d441b8ce87318bcdd5'],958,50,1008,782442,21,,,,1610
94478b4928fbfdc8af95e3e0491a6d9fcdcd85fc,0,Vimal Sharma,2016-11-28 11:06:00+05:18,['6600335558587d3446124a155a9753c26670858e'],0,2,2,782444,2,,,,1610
e8ab914274f7f108eced0f6c35bd4607c2287850,0,Vimal Sharma,2016-11-28 11:11:46+05:18,['94478b4928fbfdc8af95e3e0491a6d9fcdcd85fc'],0,34,34,782478,2,,,,1610
5d8c80a75484b228e5bbbc0f849f4a01e2d08821,0,Vimal Sharma,2016-11-28 11:18:45+05:18,['e8ab914274f7f108eced0f6c35bd4607c2287850'],20,1,21,782499,2,,,,1610
20aa6cf2536b4ca7c8fbf3fde285bb545898659c,1,Madhan Neethiraj,2016-11-28 10:00:27-08:00,['5d8c80a75484b228e5bbbc0f849f4a01e2d08821'],11,47,58,782557,5,0,1,1,1610
3d212311ccc45eb48d3e9b36cb2f472ece2a0846,0,Madhan Neethiraj,2016-11-28 23:13:23-08:00,['20aa6cf2536b4ca7c8fbf3fde285bb545898659c'],0,29,29,782586,2,,,,1610
7a1b8c15f95b05fedbbf2393f39bf769e7d885e2,1,Madhan Neethiraj,2016-11-29 01:24:10-08:00,['3d212311ccc45eb48d3e9b36cb2f472ece2a0846'],11,37,48,782634,4,,,,1610
eec1201c9ff604b0697af2def66ade6d02ab0603,1,Vimal Sharma,2016-11-29 15:24:23+05:18,['7a1b8c15f95b05fedbbf2393f39bf769e7d885e2'],23,158,181,782815,3,0.867924528,0.150943396,0.905660377,1611
389ec561475350ae6ff0d2994b7dbf9445dd63db,0,Madhan Neethiraj,2016-11-29 22:43:55-08:00,['eec1201c9ff604b0697af2def66ade6d02ab0603'],0,28,28,782843,2,,,,1611
be9c264824a5e5860c2dd2b44f70cb38f7c628f0,0,Madhan Neethiraj,2016-11-29 23:27:29-08:00,['389ec561475350ae6ff0d2994b7dbf9445dd63db'],0,29,29,782872,2,,,,1611
74a8de1a99cc3b511dfe7f7a233e5adb8f7a9e75,1,Vimal Sharma,2016-12-01 17:02:26+05:18,['be9c264824a5e5860c2dd2b44f70cb38f7c628f0'],1,2,3,782875,2,,,,1611
c413975aa9a10b2e3f576c68fefeffe11229b693,1,Vimal Sharma,2016-12-05 14:49:23+05:18,['74a8de1a99cc3b511dfe7f7a233e5adb8f7a9e75'],49,119,168,783043,10,0.666666667,0.666666667,0.80952381,1613
6fb7b82a8fb2442f6ffb08c9946fc446c34b6707,1,Suma Shivaprasad,2016-12-05 18:38:36-08:00,['c413975aa9a10b2e3f576c68fefeffe11229b693'],2,3,5,783048,3,,,,1613
3567060906bcd329cfbb8461bd59aba75b9fecde,1,Dave Kantor,2016-12-06 15:59:57-05:00,['6fb7b82a8fb2442f6ffb08c9946fc446c34b6707'],193,885,1078,784126,13,0.372750643,0.652956298,0.763496144,1613
e8a438ca69da3843fe1aaad64b141160e4d7fa0a,1,Suma Shivaprasad,2016-12-06 14:13:19-08:00,['3567060906bcd329cfbb8461bd59aba75b9fecde'],18,20,38,784164,3,,,,1613
a1f9008b8c1184dc3c0ab2d6a7beaa7c0fd558fc,1,Suma Shivaprasad,2016-12-06 21:23:02-08:00,['e8a438ca69da3843fe1aaad64b141160e4d7fa0a'],2,9,11,784175,2,0,1,1,1613
c91f582a787a6ea88c4b8d2e4828e85f708ce7f0,1,Suma Shivaprasad,2016-12-06 21:27:35-08:00,['a1f9008b8c1184dc3c0ab2d6a7beaa7c0fd558fc'],1,28,29,784204,7,0.2,1,1,1613
78c835edf1597c7d0082790c248235f08fb8474a,1,Suma Shivaprasad,2016-12-07 09:27:07-08:00,['c91f582a787a6ea88c4b8d2e4828e85f708ce7f0'],1,8,9,784213,2,1,1,1,1613
de6122fa31998bf591b48c73c325fc502a1b1837,1,Suma Shivaprasad,2016-12-07 14:39:01-08:00,['78c835edf1597c7d0082790c248235f08fb8474a'],5,10,15,784228,3,0,0,1,1613
2c881a4668de7c077c01df886158423d20d65b8a,1,Suma Shivaprasad,2016-12-07 18:45:06-08:00,['de6122fa31998bf591b48c73c325fc502a1b1837'],483,241,724,784952,13,0.827586207,0,0.097701149,1613
28410df5f40cdfd2cb09c9fe99cbfb615b2038c0,1,Suma Shivaprasad,2016-12-08 00:50:04-08:00,['2c881a4668de7c077c01df886158423d20d65b8a'],140,170,310,785262,11,0.307692308,0.538461538,0.5,1613
d9d487bc33b4711d483490ccaaf17aabf5c480aa,0,Suma Shivaprasad,2016-12-08 15:51:45-08:00,['28410df5f40cdfd2cb09c9fe99cbfb615b2038c0'],9,16,25,785287,4,1,1,1,1613
d612d75f48d7fb8742d4d78de64b3161708f37e1,0,Suma Shivaprasad,2016-12-09 11:48:51-08:00,['d9d487bc33b4711d483490ccaaf17aabf5c480aa'],1,2,3,785290,2,,,,1613
765ce51c3713ed18ff644949760cc42b891dd2b0,0,Vimal Sharma,2016-12-12 12:25:34+05:18,['d612d75f48d7fb8742d4d78de64b3161708f37e1'],14,7,21,785311,3,1,0,0,1613
ed4ae0e3ea7ef5646e8ecc30143929e21b8aaab4,1,Suma Shivaprasad,2016-12-12 15:28:27-08:00,['765ce51c3713ed18ff644949760cc42b891dd2b0'],14,48,62,785373,3,0,0,1,1613
3bffc0dcc525d456d84011170ffe9f62885cb6c8,1,Vimal Sharma,2016-12-13 14:21:18+05:18,['ed4ae0e3ea7ef5646e8ecc30143929e21b8aaab4'],612,319,931,786304,30,1,1,0,1613
efc8d09c8664f2105b15519d52c79c3b1fb425df,1,kevalbhatt,2016-12-14 10:57:11+05:18,['3bffc0dcc525d456d84011170ffe9f62885cb6c8'],761,794,1555,787859,38,1,1,1,1615
f6e27b59c8e1c4a322853f0820d68d75985b166d,1,Suma Shivaprasad,2016-12-14 20:18:17-08:00,['efc8d09c8664f2105b15519d52c79c3b1fb425df'],71,199,270,788129,7,0.288461538,0.221153846,1,1615
1620284e4c5d81a8722746d93fc32482bf41583a,1,Madhan Neethiraj,2016-12-15 19:30:16-08:00,['f6e27b59c8e1c4a322853f0820d68d75985b166d'],813,619,1432,789561,173,1,0.816091954,0.24137931,1615
edc4786b957988f8029a652ce7cf1c97d0e40711,1,Madhan Neethiraj,2016-12-16 06:32:45-08:00,['1620284e4c5d81a8722746d93fc32482bf41583a'],26,3303,3329,792890,20,0.41336739,0.553852703,0.997871435,1619
b305ba5059997f043a47a7a8e802e6355bb5e31f,1,Madhan Neethiraj,2016-12-16 06:50:25-08:00,['edc4786b957988f8029a652ce7cf1c97d0e40711'],14,12,26,792916,2,1,1,0,1619
b3efebc9690774750d7bfa5fe43d27328746f75a,1,Madhan Neethiraj,2016-12-16 07:10:35-08:00,['b305ba5059997f043a47a7a8e802e6355bb5e31f'],56,299,355,793271,11,0.901960784,0.764705882,0.901960784,1621
05bdbc621f5312e001c428fbd4abe4dc1341a7c0,0,Madhan Neethiraj,2016-12-16 16:15:05-08:00,['b3efebc9690774750d7bfa5fe43d27328746f75a'],1,13,14,793285,4,,,,1621
3b1a7d09c9f54a816b6e3a2c5b8f942b6052e3af,0,Madhan Neethiraj,2016-12-19 09:53:36-08:00,['05bdbc621f5312e001c428fbd4abe4dc1341a7c0'],32,62,94,793379,3,0,1,1,1621
ec1b160ac10cf6e35d764a6c33f337e173f9466f,1,Madhan Neethiraj,2016-12-21 08:56:57-08:00,['3b1a7d09c9f54a816b6e3a2c5b8f942b6052e3af'],389,1376,1765,795144,33,0.410852713,0.939534884,0.928682171,1622
3725dcf113056c47184e4a5ba95aeb7d57e61de0,1,Madhan Neethiraj,2016-12-21 12:03:56-08:00,['ec1b160ac10cf6e35d764a6c33f337e173f9466f'],20,20,40,795184,3,1,1,0,1622
40e639eddf377e683ff4a1ba88fb6c120eb36ab3,1,Madhan Neethiraj,2016-12-21 15:47:34-08:00,['3725dcf113056c47184e4a5ba95aeb7d57e61de0'],217,193,410,795594,42,0.96,0.92,0.32,1622
590b38ac59dfcd94c3b31e93aa5e4f8143792216,1,Madhan Neethiraj,2016-12-22 17:47:40-08:00,['40e639eddf377e683ff4a1ba88fb6c120eb36ab3'],145,129,274,795868,20,1,0.076086957,0.043478261,1622
0e7ef3af9e59584bd9ea87b10d6264a97ba4b41e,0,Madhan Neethiraj,2016-12-23 07:38:17-08:00,['590b38ac59dfcd94c3b31e93aa5e4f8143792216'],54,0,54,795922,1,,,,1622
c3318467eb3954b7fc6490312bee4ce0d36cf081,1,Madhan Neethiraj,2016-12-25 00:12:35-08:00,['0e7ef3af9e59584bd9ea87b10d6264a97ba4b41e'],3,13,16,795938,2,0,1,1,1622
ac80b8b61b122abe57a644cbfe3868f07c301914,0,Madhan Neethiraj,2017-01-03 09:21:33-08:00,['c3318467eb3954b7fc6490312bee4ce0d36cf081'],15,1,16,795954,2,0,0,0,1622
6145bf481c2244e6b505086f41c3a5d58519d303,1,Madhan Neethiraj,2017-01-03 16:47:39-08:00,['ac80b8b61b122abe57a644cbfe3868f07c301914'],6,187,193,796147,4,0.726315789,0.726315789,0.821052632,1623
c99117308509efac5bc937f1de102d65de27db2b,1,Madhan Neethiraj,2017-01-04 01:46:58-08:00,['6145bf481c2244e6b505086f41c3a5d58519d303'],17,23,40,796187,1,0,1,1,1623
e5b6438f2af3193edd7567af013eb23261d3ef45,1,Madhan Neethiraj,2017-01-04 12:08:23-08:00,['c99117308509efac5bc937f1de102d65de27db2b'],21,30,51,796238,6,0,0,1,1623
cae6522da3a209c0bb32492293553fc6bd23c313,1,Madhan Neethiraj,2017-01-04 14:46:59-08:00,['e5b6438f2af3193edd7567af013eb23261d3ef45'],34,13,47,796285,3,0.157894737,1,0,1623
ffcdbb17689ed325715a43dc407ca20348277a5a,1,Madhan Neethiraj,2017-01-04 22:35:44-08:00,['cae6522da3a209c0bb32492293553fc6bd23c313'],33,20,53,796338,7,0.533333333,1,0.066666667,1623
90efc4afb6cac6be09f28afd1aaf467ae05b64b5,0,Madhan Neethiraj,2017-01-04 23:19:07-08:00,['ffcdbb17689ed325715a43dc407ca20348277a5a'],50,157,207,796545,13,0,0.887323944,1,1623
b72a4c44a107e9640838730fe5ac66e38c65f21e,1,Dave Kantor,2017-01-05 08:26:29-05:00,['90efc4afb6cac6be09f28afd1aaf467ae05b64b5'],21,127,148,796693,14,0.820895522,0.656716418,1,1623
6e5863e867791c65916b63e08905a4a04de0beaf,0,Madhan Neethiraj,2017-01-05 08:52:41-08:00,['b72a4c44a107e9640838730fe5ac66e38c65f21e'],0,12,12,796705,2,0,1,1,1623
03857baa6a895147ce2cdffb214bf77b3f72704b,0,Suma Shivaprasad,2017-01-05 11:29:16-08:00,['6e5863e867791c65916b63e08905a4a04de0beaf'],1,8,9,796714,3,,,,1623
407ff00c1b51cf164dffc356526e8966acee5dc8,1,Madhan Neethiraj,2017-01-05 13:02:48-08:00,['03857baa6a895147ce2cdffb214bf77b3f72704b'],3,103,106,796820,9,0.254545455,0.472727273,1,1623
6c3b981ad055fa17cae818c8f0f79ff49416de11,1,Madhan Neethiraj,2017-01-05 17:10:48-08:00,['407ff00c1b51cf164dffc356526e8966acee5dc8'],2,2,4,796824,1,,,,1623
46f539e1535986b0e3992da7fe6e1c7f6f01a69c,1,Madhan Neethiraj,2017-01-05 23:37:19-08:00,['6c3b981ad055fa17cae818c8f0f79ff49416de11'],9,944,953,797777,16,0.692840647,0.82448037,0.819861432,1629
22650d6eb49d3ffb0c33dd1d7d63b4c22c680ff7,0,Madhan Neethiraj,2017-01-08 23:26:32-08:00,['46f539e1535986b0e3992da7fe6e1c7f6f01a69c'],0,5,5,797782,2,1,1,1,1629
d8db43100cc182ecb59a75236b810ca45c19e725,1,Madhan Neethiraj,2017-01-09 10:42:31-08:00,['22650d6eb49d3ffb0c33dd1d7d63b4c22c680ff7'],0,32,32,797814,2,0.653846154,0.653846154,1,1629
e92502ddffe6632af515468b60c6b52add8d50e1,1,Madhan Neethiraj,2017-01-11 00:05:03-08:00,['d8db43100cc182ecb59a75236b810ca45c19e725'],13,42,55,797869,3,0.6875,0.6875,0,1629
cc503701d4b91d6d2cfe9f5a909343bc87805c3e,1,Madhan Neethiraj,2017-01-11 09:31:18-08:00,['e92502ddffe6632af515468b60c6b52add8d50e1'],218,198,416,798285,18,0.055555556,0.833333333,0.574074074,1630
384c33585e549dbd9f729e3bb61c6fda2448016d,0,Vimal Sharma,2017-01-12 12:09:23+05:18,['cc503701d4b91d6d2cfe9f5a909343bc87805c3e'],7,47,54,798339,1,0,0.142857143,1,1630
9683c1170e4455eb69ace90d3d92bc57e65eea60,0,Vimal Sharma,2017-01-12 13:17:39+05:18,['384c33585e549dbd9f729e3bb61c6fda2448016d'],5,21,26,798365,4,0.9,0.9,0.6,1630
b725caaa879240f3012e85bf888072a42f2d4308,0,Vimal Sharma,2017-01-12 13:20:26+05:18,['9683c1170e4455eb69ace90d3d92bc57e65eea60'],3,9,12,798377,1,0,0,1,1630
53f88222a70c9afbb367758d810b5590d9b72bf7,0,Madhan Neethiraj,2017-01-13 17:25:35-08:00,['b725caaa879240f3012e85bf888072a42f2d4308'],3,4,7,798384,3,,,,1630
e0c6b98ef274e984ae3b1a61bddf79c5e21aa17c,1,Madhan Neethiraj,2017-01-16 19:51:30-08:00,['53f88222a70c9afbb367758d810b5590d9b72bf7'],92,231,323,798707,5,0.153846154,0.884615385,0.519230769,1631
9c0c46dbcb4687b0db199248610da327273cab1d,1,Madhan Neethiraj,2017-01-16 22:59:31-08:00,['e0c6b98ef274e984ae3b1a61bddf79c5e21aa17c'],3,54,57,798764,2,0.387096774,0.387096774,1,1631
34d235f393c9d5e83b47c19b846cd7c96f10577d,1,Madhan Neethiraj,2017-01-17 21:04:05-08:00,['9c0c46dbcb4687b0db199248610da327273cab1d'],133,365,498,799262,7,0,0,0.491017964,1631
10e82ff47c915bb7f3d750b9fbc398b2dd04f88d,1,Madhan Neethiraj,2017-01-18 18:35:40-08:00,['34d235f393c9d5e83b47c19b846cd7c96f10577d'],152,571,723,799985,11,0,0,0.634615385,1631
100fee3dfde04415dd5d7f1aa6110e52aee74b44,1,Madhan Neethiraj,2017-01-19 07:40:31-08:00,['10e82ff47c915bb7f3d750b9fbc398b2dd04f88d'],1,94,95,800080,2,,,,1632
2139e2879852d3c4a9551c83e0d84df515ffca14,1,Madhan Neethiraj,2017-01-19 07:40:40-08:00,['100fee3dfde04415dd5d7f1aa6110e52aee74b44'],4,20,24,800104,1,,,,1632
b6c408b372c57da90faf348f0f9d804fd8274b9f,0,Madhan Neethiraj,2017-01-19 07:52:35-08:00,['2139e2879852d3c4a9551c83e0d84df515ffca14'],3,4,7,800111,1,,,,1632
75bcccd1d12e01f749b223bdc894fc2f3ca988f2,1,Jeff Hagelberg,2017-01-19 15:50:53-05:00,['b6c408b372c57da90faf348f0f9d804fd8274b9f'],56,335,391,800502,13,0.988095238,1,1,1633
511c88670d6b0a9b668fec8a1d9513709b4dc2e4,1,Madhan Neethiraj,2017-01-19 15:28:45-08:00,['75bcccd1d12e01f749b223bdc894fc2f3ca988f2'],21,300,321,800823,6,0.327868852,0.426229508,0.978142077,1633
2f1cb57a757e15c97a2b1437e282be48c553d4e8,1,Madhan Neethiraj,2017-01-19 17:51:04-08:00,['511c88670d6b0a9b668fec8a1d9513709b4dc2e4'],270,3450,3720,804543,51,0.509305211,0.574441687,0.691066998,1651
cc08c517e2e3d5e45e8ea6d8ed7a0ff07dc4d412,1,Madhan Neethiraj,2017-01-20 08:24:22-08:00,['2f1cb57a757e15c97a2b1437e282be48c553d4e8'],16,56,72,804615,3,0.21875,0.84375,1,1651
49453f280bcf221cbe35ee018c26b6be61ad6443,1,Madhan Neethiraj,2017-01-20 08:56:56-08:00,['cc08c517e2e3d5e45e8ea6d8ed7a0ff07dc4d412'],92,84,176,804791,21,0,0,1,1651
bda289ef7e001c2831a219c527ae102ebab8d104,1,Madhan Neethiraj,2017-01-20 11:45:22-08:00,['49453f280bcf221cbe35ee018c26b6be61ad6443'],103,237,340,805131,9,0.677419355,0.903225806,0.849462366,1651
7f914ab9eb3c4cb0ceccea090bed47db220c3780,1,Madhan Neethiraj,2017-01-20 17:13:39-08:00,['bda289ef7e001c2831a219c527ae102ebab8d104'],2,236,238,805369,9,0.642857143,0.816326531,1,1652
c8f3184fccd5236e9f2b5366c301fd3b286f6ef2,1,kevalbhatt,2017-01-23 15:06:39+05:18,['7f914ab9eb3c4cb0ceccea090bed47db220c3780'],14,66,80,805449,9,0,0.333333333,0.555555556,1652
143c0f813527c85edc30d3d589837fc20bf9bb04,1,Madhan Neethiraj,2017-01-23 19:52:58-08:00,['c8f3184fccd5236e9f2b5366c301fd3b286f6ef2'],5,288,293,805742,8,0.727272727,0.818181818,0.736363636,1654
6679c8eed29d9850a43b682970084e197ad16dc7,1,Madhan Neethiraj,2017-01-24 09:18:00-08:00,['143c0f813527c85edc30d3d589837fc20bf9bb04'],139,81,220,805962,31,0.130434783,0,0.739130435,1654
c9c26d74187532f6f6922443f52ffa2739e81c86,1,Madhan Neethiraj,2017-01-25 07:26:42-08:00,['6679c8eed29d9850a43b682970084e197ad16dc7'],471,530,1001,806963,23,1,1,0.384615385,1657
bf377abbba2e8f855636c2bb897e9c80f8a20d1d,0,Madhan Neethiraj,2017-01-25 10:10:00-08:00,['c9c26d74187532f6f6922443f52ffa2739e81c86'],76,125,201,807164,13,0,0.96,1,1657
92d02817846d9431042923182f7feeb1a3a2a7d2,1,Madhan Neethiraj,2017-01-26 02:20:47-08:00,['bf377abbba2e8f855636c2bb897e9c80f8a20d1d'],47,229,276,807440,4,0.422680412,0.917525773,0.721649485,1658
6cd68119412dc6458947557f47debe253bd8abf3,1,Jeff Hagelberg,2017-01-26 15:58:20-05:00,['92d02817846d9431042923182f7feeb1a3a2a7d2'],0,1,1,807441,1,,,,1658
89f70609645fa53cb5492035c49c2aa4b99031e9,1,Jeff Hagelberg,2017-01-26 16:04:51-05:00,['6cd68119412dc6458947557f47debe253bd8abf3'],357,997,1354,808795,21,0.454248366,0.660130719,0.95751634,1661
19a5f65c9bcafc77df164c4dd75c89782b4f4076,0,Madhan Neethiraj,2017-01-26 14:12:57-08:00,['89f70609645fa53cb5492035c49c2aa4b99031e9'],0,28,28,808823,1,0,1,1,1661
6ccba52c293d4c7e419a63326665faee7db9f231,1,Madhan Neethiraj,2017-01-26 16:04:19-08:00,['19a5f65c9bcafc77df164c4dd75c89782b4f4076'],225,812,1037,809860,26,0.219251337,0.868983957,0.85828877,1661
57f4f79d6f8c39ee2504b23e27b1082b667e8cb1,1,Madhan Neethiraj,2017-01-26 16:39:52-08:00,['6ccba52c293d4c7e419a63326665faee7db9f231'],7,908,915,810775,10,0.516898608,0.96222664,0.811133201,1665
4b8b9e22f8e279f739899bc50e20ffdae6142586,1,Madhan Neethiraj,2017-01-28 17:47:43-08:00,['57f4f79d6f8c39ee2504b23e27b1082b667e8cb1'],217,450,667,811442,9,0,0.430939227,1,1665
f83e8ee863d1657be652130024f3e7c99a2482f1,1,Madhan Neethiraj,2017-01-29 01:55:54-08:00,['4b8b9e22f8e279f739899bc50e20ffdae6142586'],31,61,92,811534,13,0,0,0.384615385,1665
d204df78e4babb3fe3c515c00596a03cd40c4794,1,Madhan Neethiraj,2017-01-29 13:10:54-08:00,['f83e8ee863d1657be652130024f3e7c99a2482f1'],2,5,7,811541,2,,,,1665
37c8a4d1a57aabec88d5ecee60df6f562caaf8b8,1,Vimal Sharma,2017-01-30 14:21:28+05:18,['d204df78e4babb3fe3c515c00596a03cd40c4794'],48,686,734,812275,11,0.470175439,0.933333333,0.961403509,1670
804de951d20d3b0f694f122b0841c1d86e10c7e0,0,Dave Kantor,2017-01-30 09:12:29-05:00,['37c8a4d1a57aabec88d5ecee60df6f562caaf8b8'],0,2,2,812277,2,1,1,1,1670
f74bd951b038588017cbff173b945e548c8e6d06,0,Dave Kantor,2017-01-30 16:11:58-05:00,['804de951d20d3b0f694f122b0841c1d86e10c7e0'],0,5,5,812282,2,,,,1670
2763ff3038d167bdf971fca3c5d18e378911b09e,0,Madhan Neethiraj,2017-01-30 19:50:22-08:00,['f74bd951b038588017cbff173b945e548c8e6d06'],2,18,20,812302,2,1,1,0,1670
224eaffe78d0e5844755f0015eee35732eeb5028,1,Madhan Neethiraj,2017-01-30 22:26:13-08:00,['2763ff3038d167bdf971fca3c5d18e378911b09e'],30,100,130,812432,3,0.461538462,0.128205128,0.871794872,1670
c8f9f363bf67a4a464510fdd2831d8b3162dba24,1,Madhan Neethiraj,2017-01-30 23:59:20-08:00,['224eaffe78d0e5844755f0015eee35732eeb5028'],3,8,11,812443,2,,,,1670
a7870cdede63eca6a11e1fd5d42824d0efd63186,1,Madhan Neethiraj,2017-01-31 12:26:44-08:00,['c8f9f363bf67a4a464510fdd2831d8b3162dba24'],152,276,428,812871,16,0.204301075,0,1,1670
5d8fae555492cb53fc9ce33974184e471103b39c,1,kevalbhatt,2017-02-01 18:20:31+05:18,['a7870cdede63eca6a11e1fd5d42824d0efd63186'],302,454,756,813627,22,0.626373626,0.637362637,1,1670
f640da72112cd2647b6dee5a5ac498b360a83ee3,0,Madhan Neethiraj,2017-02-01 09:50:54-08:00,['5d8fae555492cb53fc9ce33974184e471103b39c'],3,3,6,813633,2,,,,1670
aa74c73d0e9fbfd9c51de9f6cdcdea6141575e8e,0,Jeff Hagelberg,2017-02-01 16:04:39-05:00,['f640da72112cd2647b6dee5a5ac498b360a83ee3'],235,5123,5358,818991,58,0.786877617,0.942298744,0.93997208,1694
4367c491579e4de90770d95e4c746e289a6cf930,1,Madhan Neethiraj,2017-02-01 13:43:02-08:00,['aa74c73d0e9fbfd9c51de9f6cdcdea6141575e8e'],81,170,251,819242,12,0.090909091,0.181818182,0.872727273,1694
a810f15648e764d1e15f1e810718da8eba7758f6,1,Dave Kantor,2017-02-01 17:45:57-05:00,['4367c491579e4de90770d95e4c746e289a6cf930'],2,116,118,819360,6,0.337662338,1,1,1694
ebf23779428421255fb5f18bc1199d0ae18c301b,0,Jeff Hagelberg,2017-02-01 18:22:40-05:00,['a810f15648e764d1e15f1e810718da8eba7758f6'],4,5,9,819369,4,,,,1694
352f4397e9430d1ca25dc0fa334a8405a8d63e7f,0,Madhan Neethiraj,2017-02-01 18:42:24-08:00,['ebf23779428421255fb5f18bc1199d0ae18c301b'],5,4,9,819378,4,,,,1694
5adca84101913a4f9f2ae87d13fa759089407019,0,Madhan Neethiraj,2017-02-01 18:43:30-08:00,['352f4397e9430d1ca25dc0fa334a8405a8d63e7f'],5121,233,5354,824732,58,0.213122383,0.057701256,0.06002792,1694
e5e324ceef430218b7912512dd2f76858397a425,1,Madhan Neethiraj,2017-02-01 19:47:18-08:00,['5adca84101913a4f9f2ae87d13fa759089407019'],4,10,14,824746,3,0,1,1,1694
62a05c97c0bcc33bc28ed1141cc8f742776677a4,1,Jeff Hagelberg,2017-02-02 16:10:09-05:00,['e5e324ceef430218b7912512dd2f76858397a425'],255,5167,5422,830168,62,0.786877617,0.942298744,0.93997208,1718
09089e09f80c1f10123d4132438f7c426087acb1,1,Jeff Hagelberg,2017-02-02 17:35:25-05:00,['62a05c97c0bcc33bc28ed1141cc8f742776677a4'],141,273,414,830582,13,0.180555556,0.708333333,0.888888889,1718
02cf8c4884eb346f7b993bd46d6e789bd73f006d,1,Jeff Hagelberg,2017-02-03 12:00:09-05:00,['09089e09f80c1f10123d4132438f7c426087acb1'],54,520,574,831156,8,0.867647059,1,0.838235294,1722
d8c2a10e080eb79ba23f646270313089b2afdfda,1,Madhan Neethiraj,2017-02-03 15:18:05-08:00,['02cf8c4884eb346f7b993bd46d6e789bd73f006d'],740,1189,1929,833085,36,0.204633205,0.486486486,0,1725
4f4ab9b98d2f0cfa9b6e9fddac0e993c2b1203c1,1,Madhan Neethiraj,2017-02-03 20:58:50-08:00,['d8c2a10e080eb79ba23f646270313089b2afdfda'],81,69,150,833235,5,0.384615385,1,0.384615385,1725
acfe9a48fa3b1a4f75f52b6d43d0bd6ee964c441,1,Madhan Neethiraj,2017-02-05 17:34:04-08:00,['4f4ab9b98d2f0cfa9b6e9fddac0e993c2b1203c1'],245,271,516,833751,12,1,1,0,1725
5f508c97c7ea9436e16dbacb6770f14d0114eca3,1,Jeff Hagelberg,2017-02-07 15:31:02-05:00,['acfe9a48fa3b1a4f75f52b6d43d0bd6ee964c441'],336,1448,1784,835535,36,0.288743883,0.820554649,0.941272431,1728
48477e20816b9cb890e65da0b6ed289e51f3bb69,1,Madhan Neethiraj,2017-02-07 14:58:34-08:00,['5f508c97c7ea9436e16dbacb6770f14d0114eca3'],680,385,1065,836600,16,0.731707317,0.717073171,0.229268293,1728
808eb1d1c314ae0445f05afa90ca90490e2723e8,1,Madhan Neethiraj,2017-02-07 19:36:38-08:00,['48477e20816b9cb890e65da0b6ed289e51f3bb69'],546,1158,1704,838304,26,0.44989339,0.665245203,0.545842217,1729
dd7447658e4d917eb9a25aec6412b0a96016cc5c,1,Madhan Neethiraj,2017-02-07 19:40:09-08:00,['808eb1d1c314ae0445f05afa90ca90490e2723e8'],338,292,630,838934,22,0.573529412,0.838235294,0,1729
15baa4da02290f6a7bb257b9ee6c619581746568,1,Madhan Neethiraj,2017-02-07 23:08:17-08:00,['dd7447658e4d917eb9a25aec6412b0a96016cc5c'],10,15,25,838959,5,0,0,1,1729
7ed6b02c4351ed9094d29842998db2927d83fd0c,0,Madhan Neethiraj,2017-02-08 00:15:46-08:00,['15baa4da02290f6a7bb257b9ee6c619581746568'],1,1,2,838961,1,,,,1729
03684a0568f8569eca44573c791fc090d9a9a8b5,1,Madhan Neethiraj,2017-02-08 10:14:27-08:00,['7ed6b02c4351ed9094d29842998db2927d83fd0c'],28,36,64,839025,2,0.6,1,1,1729
db18c82409dc2c2dadba4a19aea44a97a7e64776,1,Jeff Hagelberg,2017-02-08 14:31:29-05:00,['03684a0568f8569eca44573c791fc090d9a9a8b5'],1,25,26,839051,4,1,1,1,1729
a67e896253e3af4631cfbe40c77e14221f06f278,1,Madhan Neethiraj,2017-02-08 17:48:04-08:00,['db18c82409dc2c2dadba4a19aea44a97a7e64776'],80,89,169,839220,3,1,1,1,1729
1e105174cfc0ba82ad254efaeb666ba880956dea,1,Jeff Hagelberg,2017-02-09 09:23:38-05:00,['a67e896253e3af4631cfbe40c77e14221f06f278'],15,77,92,839312,5,0,0,1,1729
141b78c16ef5df9e16ec57c73ea730bda3fa2eee,1,Dave Kantor,2017-02-09 14:28:45-05:00,['1e105174cfc0ba82ad254efaeb666ba880956dea'],0,110,110,839422,3,,,,1730
b63d6316e3b3b9ad7bd96d49914ffc724c0b80fa,0,Jeff Hagelberg,2017-02-09 18:17:30-05:00,['141b78c16ef5df9e16ec57c73ea730bda3fa2eee'],41,108,149,839571,5,0,0,0,1731
9cb56c541e26eb35ff3ab486de31cb20076fe1fe,1,Madhan Neethiraj,2017-02-09 18:34:20-08:00,['b63d6316e3b3b9ad7bd96d49914ffc724c0b80fa'],56,922,978,840549,13,0.701327434,1,0.871681416,1736
0fe4d8854c3c263327b8f3b9120bd826cb2c1f11,1,Madhan Neethiraj,2017-02-09 22:33:21-08:00,['9cb56c541e26eb35ff3ab486de31cb20076fe1fe'],566,167,733,841282,8,0,0,0,1736
30a8e228119ee0141ad5d8fd9912f9ea5b4be0a2,1,Vimal Sharma,2017-02-10 14:18:35+05:18,['0fe4d8854c3c263327b8f3b9120bd826cb2c1f11'],4,9,13,841295,2,0,0,1,1736
9e7e5f05aaf526406f65feaba64e5fdb4d2c7776,1,Madhan Neethiraj,2017-02-10 01:22:00-08:00,['30a8e228119ee0141ad5d8fd9912f9ea5b4be0a2'],303,375,678,841973,6,1,0.967213115,1,1736
3b4ccb7f9bb8f0796c9a7bc71857a56ae615b0a2,1,Madhan Neethiraj,2017-02-10 01:22:23-08:00,['9e7e5f05aaf526406f65feaba64e5fdb4d2c7776'],57,52,109,842082,8,1,1,0,1736
938af9ee854c0c63b6de59d5ac1f4ddf7ad45eac,0,Madhan Neethiraj,2017-02-10 09:15:49-08:00,['3b4ccb7f9bb8f0796c9a7bc71857a56ae615b0a2'],13,50,63,842145,2,0.483870968,0.483870968,1,1736
414b7bbc9fcc523e45846533b4b8eae247eee13c,1,Madhan Neethiraj,2017-02-10 14:51:24-08:00,['938af9ee854c0c63b6de59d5ac1f4ddf7ad45eac'],35,20,55,842200,5,0.071428571,0,0,1736
ce20d6f59da89b245c8e4d393dd87ff62f95847f,1,Madhan Neethiraj,2017-02-12 23:40:27-08:00,['414b7bbc9fcc523e45846533b4b8eae247eee13c'],2493,2344,4837,847037,48,0,1,1,1738
9db4d26191b4250b714fa3a9cd6d708cca172b83,1,Madhan Neethiraj,2017-02-13 00:02:02-08:00,['ce20d6f59da89b245c8e4d393dd87ff62f95847f'],70,26,96,847133,3,1,0,0,1738
997abdb0ac68d2296a43ff66dba0c4169c85390a,1,Dave Kantor,2017-02-13 13:44:36-05:00,['9db4d26191b4250b714fa3a9cd6d708cca172b83'],45,211,256,847389,11,0,0.703703704,0.395061728,1742
c6ace7afd203fb08ce13f41bf87dca36f3117c93,0,Madhan Neethiraj,2017-02-13 13:00:43-08:00,['997abdb0ac68d2296a43ff66dba0c4169c85390a'],1,18,19,847408,1,,,,1742
a3f365dc089d718a6fbd55a935fa4876d97b69fd,0,Madhan Neethiraj,2017-02-13 14:32:33-08:00,['c6ace7afd203fb08ce13f41bf87dca36f3117c93'],1,19,20,847428,1,,,,1742
29396c9df695c881a2498fba972a2bb6ee293fd9,1,Madhan Neethiraj,2017-02-13 15:04:53-08:00,['a3f365dc089d718a6fbd55a935fa4876d97b69fd'],28,36,64,847492,5,0,0,0,1742
169ab553c6aa5af753f6be6142d29e78c701cf05,1,Madhan Neethiraj,2017-02-13 16:15:33-08:00,['29396c9df695c881a2498fba972a2bb6ee293fd9'],7,145,152,847644,5,0.756756757,0.540540541,1,1743
8be1be6779a112818d0e5704e6ae78904fcf6969,1,Madhan Neethiraj,2017-02-13 18:12:06-08:00,['169ab553c6aa5af753f6be6142d29e78c701cf05'],116,137,253,847897,17,1,1,0.75,1743
b2ec89d59cd997ec3c12b9442112428c4a02e2b5,1,kevalbhatt,2017-02-14 14:17:05+05:18,['8be1be6779a112818d0e5704e6ae78904fcf6969'],57,65,122,848019,6,0,0,0,1743
2a93a6aa4090612c5c013037b40dfd687fc7f399,1,Vimal Sharma,2017-02-14 14:37:15+05:18,['b2ec89d59cd997ec3c12b9442112428c4a02e2b5'],117,35,152,848171,5,0,0,1,1743
c7540b38f50718e0f8d488b25defa47c9c34f3c2,1,Madhan Neethiraj,2017-02-14 11:29:02-08:00,['2a93a6aa4090612c5c013037b40dfd687fc7f399'],167,190,357,848528,11,0.260869565,0,1,1743
aa67f8aee8eac8effbe2e9f4a27a28a4a32b8285,1,Suma Shivaprasad,2017-02-14 14:06:24-08:00,['c7540b38f50718e0f8d488b25defa47c9c34f3c2'],122,1312,1434,849962,16,0.325108853,0.940493469,0.965166909,1745
42de5913256e7e40c2833de6ee76d7a3eea698b1,1,Madhan Neethiraj,2017-02-14 21:53:24-08:00,['aa67f8aee8eac8effbe2e9f4a27a28a4a32b8285'],10,75,85,850047,2,0.132075472,0,1,1745
58bbee4ce1083c63a1f263b38daa0d5be776fa83,1,kevalbhatt,2017-02-15 17:21:31+05:18,['42de5913256e7e40c2833de6ee76d7a3eea698b1'],16,31,47,850094,4,1,0.133333333,1,1745
9b8a5ddcb1582140ba9722a6dcfba8dffbe82e1f,1,kevalbhatt,2017-02-15 17:54:14+05:18,['58bbee4ce1083c63a1f263b38daa0d5be776fa83'],13,34,47,850141,4,0,0,0.96,1745
c5ea4f0e1aa96add052adb63d41fa8c3bf2a18ec,1,Madhan Neethiraj,2017-02-15 13:26:09-08:00,['9b8a5ddcb1582140ba9722a6dcfba8dffbe82e1f'],29,35,64,850205,1,,,,1745
68c559254336b8c6d7dbd6537b064d4d31d0529d,1,Madhan Neethiraj,2017-02-16 00:17:42-08:00,['c5ea4f0e1aa96add052adb63d41fa8c3bf2a18ec'],199,997,1196,851401,17,0.451114923,0.559176672,0.759862779,1745
6170063c877870856e21ab9b6fa1bdf638860421,1,Madhan Neethiraj,2017-02-16 01:39:13-08:00,['68c559254336b8c6d7dbd6537b064d4d31d0529d'],119,899,1018,852419,17,0.592875318,0.839694656,0.860050891,1751
20fb5894d8be8551d0f2cf325d32f062f866832a,1,kevalbhatt,2017-02-16 16:52:48+05:18,['6170063c877870856e21ab9b6fa1bdf638860421'],23,28,51,852470,3,,,,1751
90f1566afabaec8aca5d87050eab43f56f911644,0,Dave Kantor,2017-02-16 13:00:38-05:00,['20fb5894d8be8551d0f2cf325d32f062f866832a'],10,52,62,852532,1,0,0,1,1751
68a324e395b55dcff1fd9a2f185e1ac742df8d1f,1,Suma Shivaprasad,2017-02-16 12:16:34-08:00,['90f1566afabaec8aca5d87050eab43f56f911644'],57,51,108,852640,6,1,1,1,1751
69db4a8283c55c83fd36439af9601a70b88e177c,0,Suma Shivaprasad,2017-02-16 12:19:42-08:00,['68a324e395b55dcff1fd9a2f185e1ac742df8d1f'],0,162,162,852802,1,1,1,1,1752
e4cc16ac7bd133964bf02eda360fe660d9225484,1,Vimal Sharma,2017-02-17 16:08:19+05:18,['69db4a8283c55c83fd36439af9601a70b88e177c'],108,74,182,852984,4,0,0,0,1752
3a0865ad03b9f576f1a32dca7ef238f461ea1801,1,Madhan Neethiraj,2017-02-17 07:27:23-08:00,['e4cc16ac7bd133964bf02eda360fe660d9225484'],640,370,1010,853994,24,0.187919463,0.181208054,0.248322148,1752
852a711831c2de2f2c9a469f01a872131649b38c,1,Dave Kantor,2017-02-17 15:49:55-05:00,['3a0865ad03b9f576f1a32dca7ef238f461ea1801'],29,560,589,854583,7,0.136054422,0.782312925,0.734693878,1755
1d85e95fa06a98d70417c9671cd4d0a0b33a9ed1,1,Madhan Neethiraj,2017-02-17 14:38:53-08:00,['852a711831c2de2f2c9a469f01a872131649b38c'],154,290,444,855027,14,0.557377049,0.459016393,0.93442623,1756
ce54e8a4de04f410c3129ebe1dafc6864e1aa98c,1,Madhan Neethiraj,2017-02-17 16:13:48-08:00,['1d85e95fa06a98d70417c9671cd4d0a0b33a9ed1'],18,32,50,855077,6,0.571428571,0.571428571,1,1756
b6b6f9450885cb21b395b19f37d6639c86ff2a52,1,Madhan Neethiraj,2017-02-17 20:59:48-08:00,['ce54e8a4de04f410c3129ebe1dafc6864e1aa98c'],92,206,298,855375,9,,,,1756
ea38942baa73774f35004d36fc1805a2368c2ace,1,Madhan Neethiraj,2017-02-17 23:58:25-08:00,['b6b6f9450885cb21b395b19f37d6639c86ff2a52'],24,185,209,855584,7,0.111111111,0.347222222,0.930555556,1757
8cd6a6445ff59d1345985581e229adc13bc0c7b0,1,Madhan Neethiraj,2017-02-18 20:03:41-08:00,['ea38942baa73774f35004d36fc1805a2368c2ace'],14,53,67,855651,4,1,1,1,1757
7303a412ef4812dec9bb0f3b65a10146ccfd8330,1,Madhan Neethiraj,2017-02-19 07:00:56-08:00,['8cd6a6445ff59d1345985581e229adc13bc0c7b0'],162,166,328,855979,25,0.538461538,1,1,1757
343d0b1f6b6efcfbc93de814dda145e404b7cc5c,0,Madhan Neethiraj,2017-02-19 14:05:42-08:00,['7303a412ef4812dec9bb0f3b65a10146ccfd8330'],28,1,29,856008,1,0.8,0,0,1757
bb1c386a7c6c2d649f09b103105712a78ec32507,1,Madhan Neethiraj,2017-02-19 20:43:40-08:00,['343d0b1f6b6efcfbc93de814dda145e404b7cc5c'],27,40,67,856075,3,0,0.666666667,0,1757
2fb3057b1b2d77b78c2a47ac40cdf13dec3f3fef,1,kevalbhatt,2017-02-20 17:45:57+05:18,['bb1c386a7c6c2d649f09b103105712a78ec32507'],3,6,9,856084,2,,,,1757
b4a694154de8372b405ed3eca6f0254753e146e5,1,Madhan Neethiraj,2017-02-21 11:32:21-08:00,['2fb3057b1b2d77b78c2a47ac40cdf13dec3f3fef'],19,20,39,856123,4,0,0,1,1757
485573fcab1c7cd263289ccc4da40357607dce82,0,Madhan Neethiraj,2017-02-21 14:32:07-08:00,['b4a694154de8372b405ed3eca6f0254753e146e5'],14,14,28,856151,1,0,1,0,1757
2904f4c425d414293e6910bba7f1bac0bca4ab55,0,Madhan Neethiraj,2017-02-21 16:20:29-08:00,['485573fcab1c7cd263289ccc4da40357607dce82'],2,82,84,856235,2,0.4,0.4,0.290909091,1757
e7eaa9966ccb330d5aa50aafc08cd1107ae30ce6,1,Madhan Neethiraj,2017-02-21 17:05:56-08:00,['2904f4c425d414293e6910bba7f1bac0bca4ab55'],1,5,6,856241,2,1,1,0,1757
f5f9fa09948b2e5ade1a084b8063cd2bbe6e80a0,0,Madhan Neethiraj,2017-02-21 22:27:04-08:00,['e7eaa9966ccb330d5aa50aafc08cd1107ae30ce6'],228,21,249,856490,10,1,0.5625,0,1757
dbfca6224965574b5c6e9be0ebc846cb0439e944,1,kevalbhatt,2017-02-22 18:18:24+05:18,['f5f9fa09948b2e5ade1a084b8063cd2bbe6e80a0'],8,28,36,856526,2,0.6,0.6,1,1757
b7d880ddea3745d97b8173818c012f5ff275f47d,0,Madhan Neethiraj,2017-02-22 09:45:56-08:00,['dbfca6224965574b5c6e9be0ebc846cb0439e944'],5,0,5,856531,1,,,,1757
c74ba142adf99fff7a17026e179b799ec315ff93,1,Madhan Neethiraj,2017-02-22 09:49:16-08:00,['b7d880ddea3745d97b8173818c012f5ff275f47d'],8,19,27,856558,1,0.4,0.3,1,1757
17a9aad063c0905f9e15cfa650a92ac26f2c46ba,1,Madhan Neethiraj,2017-02-22 10:21:28-08:00,['c74ba142adf99fff7a17026e179b799ec315ff93'],21,43,64,856622,5,1,1,0,1757
4ed4ba15ad230bdb0134bcc37eaa6a199d81f26b,1,Madhan Neethiraj,2017-02-22 14:49:05-08:00,['17a9aad063c0905f9e15cfa650a92ac26f2c46ba'],5,48,53,856675,2,0.16,0.88,1,1757
fa0d6dbef00f9307578162bc8ccc883cb0c2fc4c,1,kevalbhatt,2017-02-23 20:17:01+05:18,['4ed4ba15ad230bdb0134bcc37eaa6a199d81f26b'],118,210,328,857003,17,0.152542373,0.949152542,0.881355932,1758
e1524d3b434bf22985fb1ed4d7bef6827dc8375e,0,kevalbhatt,2017-02-23 20:24:47+05:18,['fa0d6dbef00f9307578162bc8ccc883cb0c2fc4c'],8,14,22,857025,2,,,,1758
69c4806ac04362e4a70f4fd0755f42606020f9d8,1,Jeff Hagelberg,2017-02-23 13:22:14-05:00,['e1524d3b434bf22985fb1ed4d7bef6827dc8375e'],3,113,116,857141,8,0.607843137,0.882352941,0.941176471,1759
c7900f25540ad5b522e5d3eb1c93a14cbce578d1,1,Madhan Neethiraj,2017-02-24 09:54:16-08:00,['69c4806ac04362e4a70f4fd0755f42606020f9d8'],10,26,36,857177,5,0,0,0,1759
765d556cce4f276d295d06cdb513fc3b9b00dc51,1,Madhan Neethiraj,2017-02-24 16:21:19-08:00,['c7900f25540ad5b522e5d3eb1c93a14cbce578d1'],67,377,444,857621,11,0.278106509,0.384615385,0.562130178,1759
08944c54de13054b4b7a76dbcba79218779f02d3,1,Madhan Neethiraj,2017-02-24 16:22:15-08:00,['765d556cce4f276d295d06cdb513fc3b9b00dc51'],11,88,99,857720,2,0,1,1,1759
0c1d599ddca7ad9e4c677c77908e96dd492a8f90,1,Madhan Neethiraj,2017-02-26 00:31:17-08:00,['08944c54de13054b4b7a76dbcba79218779f02d3'],15,23,38,857758,2,0,0.875,1,1759
515130ccd09003dbc0bbfd9436629c7d5648b15c,1,Madhan Neethiraj,2017-02-26 20:13:46-08:00,['0c1d599ddca7ad9e4c677c77908e96dd492a8f90'],57,161,218,857976,6,0.112676056,0,0.830985915,1759
4503955e12dc46e8cce9f28e300b060f271f4a2a,1,Madhan Neethiraj,2017-02-27 08:53:37-08:00,['515130ccd09003dbc0bbfd9436629c7d5648b15c'],1,1,2,857978,1,,,,1759
9e16600c41deefdb616db5c790848f7874010d36,0,Madhan Neethiraj,2017-02-27 09:56:33-08:00,['4503955e12dc46e8cce9f28e300b060f271f4a2a'],0,6,6,857984,1,1,1,1,1759
8244f8bf9a3a9e2bd51889cac708ef57c3188e53,0,Madhan Neethiraj,2017-02-27 10:39:33-08:00,['9e16600c41deefdb616db5c790848f7874010d36'],8,12,20,858004,1,0,1,0,1759
101abe6eedb18a0ef3e30c6ad7926b02fb89605a,1,Suma Shivaprasad,2017-02-28 13:11:47-08:00,['8244f8bf9a3a9e2bd51889cac708ef57c3188e53'],138,359,497,858501,9,0.834437086,0.642384106,0.529801325,1759
8bb31fdf98d214063b63ee8d730828e04c534fdc,1,Suma Shivaprasad,2017-02-28 16:36:45-08:00,['101abe6eedb18a0ef3e30c6ad7926b02fb89605a'],38,439,477,858978,9,0.125412541,0.99009901,0.96369637,1759
b1717f2e8f721765ad0ff5b9cce08cc6de999807,1,Madhan Neethiraj,2017-02-28 16:38:35-08:00,['8bb31fdf98d214063b63ee8d730828e04c534fdc'],84,199,283,859261,13,0.045454545,0,0.654545455,1759
48c10133e1b67ac727b0a858aa51801150ddb35e,1,Madhan Neethiraj,2017-02-28 17:31:01-08:00,['b1717f2e8f721765ad0ff5b9cce08cc6de999807'],84,236,320,859581,7,0.456140351,0.157894737,1,1762
0feb60a2f1e70fbc32f765fc67ffeaad6618c997,1,Madhan Neethiraj,2017-02-28 22:42:27-08:00,['48c10133e1b67ac727b0a858aa51801150ddb35e'],23,103,126,859707,7,0.716666667,1,1,1762
88ca02c623345890e42bab300602f8f733949012,1,kevalbhatt,2017-03-01 15:39:19+05:18,['0feb60a2f1e70fbc32f765fc67ffeaad6618c997'],9,40,49,859756,3,0.736842105,0.736842105,1,1762
214c1572adf71ec5565db29036d7ec3d0dd6354b,0,Madhan Neethiraj,2017-03-01 02:37:58-08:00,['88ca02c623345890e42bab300602f8f733949012'],8,23,31,859787,2,0,1,1,1762
3860c95d35d0052eebc48e1ef6afce8b8d437576,1,Dave Kantor,2017-03-01 10:10:37-05:00,['214c1572adf71ec5565db29036d7ec3d0dd6354b'],32,723,755,860542,11,0.226463104,0.819338422,0.72264631,1765
84f6923e12d91307af59c98a9bc6a25fbc9708b6,1,Madhan Neethiraj,2017-03-01 10:10:04-08:00,['3860c95d35d0052eebc48e1ef6afce8b8d437576'],72,73,145,860687,4,0,0,0,1765
46b1b36e97b7d405d023b7594e679b65b0226c8a,1,Madhan Neethiraj,2017-03-01 11:12:40-08:00,['84f6923e12d91307af59c98a9bc6a25fbc9708b6'],737,545,1282,861969,14,0.086206897,0,0.137931034,1766
6fd04d9a8c56610a855b3950040ace9b6699c38b,1,Jeff Hagelberg,2017-03-01 16:13:54-05:00,['46b1b36e97b7d405d023b7594e679b65b0226c8a'],141,4711,4852,866821,46,0.49842437,0.859243697,0.837710084,1796
44df46cf14c216021d80c1a49c62bd0e48f6844a,0,Madhan Neethiraj,2017-03-01 18:17:28-08:00,['6fd04d9a8c56610a855b3950040ace9b6699c38b'],4,23,27,866848,4,0,1,1,1796
48b05f364201b01cf04fd6492a375cc154bd2536,1,Madhan Neethiraj,2017-03-01 19:34:06-08:00,['44df46cf14c216021d80c1a49c62bd0e48f6844a'],3,7,10,866858,2,0,0,1,1796
11e220223d86250f132e267e694430fc5a096334,0,Madhan Neethiraj,2017-03-02 00:10:14-08:00,['48b05f364201b01cf04fd6492a375cc154bd2536'],5,14,19,866877,2,0,0,1,1796
82142995fbdd946109a54af612555679ab60043a,1,Madhan Neethiraj,2017-03-02 12:26:50-08:00,['11e220223d86250f132e267e694430fc5a096334'],71,70,141,867018,2,1,1,1,1796
98990b8d0cf6b90916c300e31b6aa4ad8e7f0d4c,1,Madhan Neethiraj,2017-03-02 17:57:18-08:00,['82142995fbdd946109a54af612555679ab60043a'],26,223,249,867267,7,0.446601942,0.446601942,0.427184466,1797
9bddaeb3ccfa089d8b7ac3b77b47cd8e99e9af07,1,Madhan Neethiraj,2017-03-02 20:16:02-08:00,['98990b8d0cf6b90916c300e31b6aa4ad8e7f0d4c'],107,141,248,867515,10,0,0.25,0.85,1797
525082baa6f48085c5f436e7b193d3f2c4f58fed,1,Madhan Neethiraj,2017-03-02 20:17:39-08:00,['9bddaeb3ccfa089d8b7ac3b77b47cd8e99e9af07'],122,336,458,867973,12,0.703448276,0.703448276,0.413793103,1797
9e578251af355481dbb1f75a358cb3e36f365ea6,0,kevalbhatt,2017-03-03 17:44:21+05:18,['525082baa6f48085c5f436e7b193d3f2c4f58fed'],1,10,11,867984,2,,,,1797
7753f2e869b32104cf992722b11fef82fe5b5655,1,kevalbhatt,2017-03-03 18:40:06+05:18,['9e578251af355481dbb1f75a358cb3e36f365ea6'],5,10,15,867999,2,0.25,0.25,1,1797
a4b16bbabadb59ae071ff472d95df822ced71e43,1,kevalbhatt,2017-03-03 19:02:26+05:18,['7753f2e869b32104cf992722b11fef82fe5b5655'],13,122,135,868134,3,0,0,1,1797
b99151fb83d39ff3bfbad503acae65ac7dd6dbec,1,kevalbhatt,2017-03-03 19:13:26+05:18,['a4b16bbabadb59ae071ff472d95df822ced71e43'],2,9,11,868145,2,1,1,1,1797
9ba2ff0d0fcae86095a0ded78e3d415b80572fb4,0,Madhan Neethiraj,2017-03-03 08:12:14-08:00,['b99151fb83d39ff3bfbad503acae65ac7dd6dbec'],2,89,91,868236,1,0.338235294,0.352941176,1,1797
e841619c384b5358c96b3362ffcb042dededfd40,1,Madhan Neethiraj,2017-03-03 08:49:16-08:00,['9ba2ff0d0fcae86095a0ded78e3d415b80572fb4'],43,43,86,868322,2,1,1,0,1797
98f02ff79b32b6dbc3a26036823f3376a26ceb8f,0,Madhan Neethiraj,2017-03-03 08:49:35-08:00,['e841619c384b5358c96b3362ffcb042dededfd40'],2,2,4,868326,1,,,,1797
2bbbd1a5adc7e2856d16c5b53833480c7f950e8c,1,Madhan Neethiraj,2017-03-03 22:49:45-08:00,['98f02ff79b32b6dbc3a26036823f3376a26ceb8f'],27,188,215,868541,8,0.265060241,0.289156627,0.313253012,1797
670a4c00158bcde1e99986a719c84cebcf6336c9,1,Madhan Neethiraj,2017-03-04 01:16:59-08:00,['2bbbd1a5adc7e2856d16c5b53833480c7f950e8c'],3,29,32,868573,3,0,0.823529412,0.176470588,1797
b9779eca9c5bbc36e6c36e8ef6bcfb4979e07f10,1,kevalbhatt,2017-03-04 17:00:15+05:18,['670a4c00158bcde1e99986a719c84cebcf6336c9'],231,325,556,869129,18,1,0.1,0.35,1799
72641fb78215140b6f89c59d4f543512ffea9d18,1,Madhan Neethiraj,2017-03-04 03:46:28-08:00,['b9779eca9c5bbc36e6c36e8ef6bcfb4979e07f10'],133,195,328,869457,7,1,0.777777778,1,1799
571f8d4e5e2291c435ef1ad7b86db7752eb55d3c,1,Madhan Neethiraj,2017-03-04 10:29:09-08:00,['72641fb78215140b6f89c59d4f543512ffea9d18'],29,59,88,869545,1,0,0,0,1799
df7d76896cd59e30acca611a708facf4356c6902,1,Madhan Neethiraj,2017-03-04 15:50:26-08:00,['571f8d4e5e2291c435ef1ad7b86db7752eb55d3c'],94,346,440,869985,5,0.536585366,0.83902439,0.765853659,1799
bcc138ac693b3927b26d5dbfe8020b4cedfff66d,1,Madhan Neethiraj,2017-03-04 20:04:44-08:00,['df7d76896cd59e30acca611a708facf4356c6902'],0,2,2,869987,1,1,1,1,1799
c572e54120b79bd362d6d4e78490277ce2741b8e,1,Madhan Neethiraj,2017-03-04 23:08:45-08:00,['bcc138ac693b3927b26d5dbfe8020b4cedfff66d'],12,12,24,870011,2,,,,1799
40e2e37d4fafe34ea58149a549f2106b6bf617a3,1,Madhan Neethiraj,2017-03-05 12:10:27-08:00,['c572e54120b79bd362d6d4e78490277ce2741b8e'],36,86,122,870133,3,0,0,0,1799
e54fe04d7a87d7d3ebaf780dd0f7b388e030d91a,0,Madhan Neethiraj,2017-03-05 22:36:26-08:00,['40e2e37d4fafe34ea58149a549f2106b6bf617a3'],4,4,8,870141,1,,,,1799
543a85d7c0f8f07c2e38be260e56e4e48a6e48f5,1,Madhan Neethiraj,2017-03-05 22:52:26-08:00,['e54fe04d7a87d7d3ebaf780dd0f7b388e030d91a'],0,32,32,870173,32,,,,1799
42a441aa63d2015e75ddc783167aa1b817c5e829,1,Madhan Neethiraj,2017-03-05 23:27:35-08:00,['543a85d7c0f8f07c2e38be260e56e4e48a6e48f5'],3,6,9,870182,2,0,0,0,1799
fe86177a1d55b18b9b1a205fcd1cae83c6b85606,1,Madhan Neethiraj,2017-03-06 00:38:41-08:00,['42a441aa63d2015e75ddc783167aa1b817c5e829'],6,15,21,870203,2,0,0,1,1799
dc89e7f44699d2bd8e08b7d50fbac493cba3ca2e,0,Madhan Neethiraj,2017-03-06 16:21:44-08:00,['fe86177a1d55b18b9b1a205fcd1cae83c6b85606'],0,85,85,870288,2,0.272727273,0.272727273,0.977272727,1800
6a4fcb95dc1b6479cde4d0e29442b98564c219d0,0,Madhan Neethiraj,2017-03-06 18:08:10-08:00,['dc89e7f44699d2bd8e08b7d50fbac493cba3ca2e'],9,38,47,870335,3,0.052631579,0,1,1800
f673eba408f25be7574391254f91dc7522c44d75,0,Madhan Neethiraj,2017-03-06 18:23:06-08:00,['6a4fcb95dc1b6479cde4d0e29442b98564c219d0'],5,46,51,870386,5,0.033333333,1,1,1800
232e59629b9bdeb27d384474dd33b0a59c5e2b90,0,Madhan Neethiraj,2017-03-06 19:31:06-08:00,['f673eba408f25be7574391254f91dc7522c44d75'],1,2,3,870389,1,,,,1800
d0e9d48b101f475bb9cb6b441d4082fde3843287,0,Madhan Neethiraj,2017-03-07 00:01:04-08:00,['232e59629b9bdeb27d384474dd33b0a59c5e2b90'],33,33,66,870455,33,,,,1800
f87f5f22b8de37c8b08dfeaf0b2c5ca289675c84,1,Madhan Neethiraj,2017-03-07 14:12:19-08:00,['d0e9d48b101f475bb9cb6b441d4082fde3843287'],8,54,62,870517,4,0,0,1,1800
7d622bdfae11d535d184497e0221584a59f73e49,0,Madhan Neethiraj,2017-03-07 16:09:37-08:00,['f87f5f22b8de37c8b08dfeaf0b2c5ca289675c84'],7,7,14,870531,1,,,,1800
0ed5e0aa5a0afb1cef8031e274645a8398d2a7f0,0,Madhan Neethiraj,2017-03-07 17:38:38-08:00,['7d622bdfae11d535d184497e0221584a59f73e49'],6,22,28,870559,2,1,1,1,1800
d0f2ce5e9aa61b5fc8b3949d41cd2af902b39a12,1,Suma Shivaprasad,2017-03-07 21:15:31-08:00,['0ed5e0aa5a0afb1cef8031e274645a8398d2a7f0'],95,128,223,870782,8,0.185185185,1,0.592592593,1800
9ca6136e2e6e431b0f463344e7e3a731af69646b,1,Madhan Neethiraj,2017-03-07 23:31:11-08:00,['d0f2ce5e9aa61b5fc8b3949d41cd2af902b39a12'],8,17,25,870807,3,1,1,1,1800
ab43b2808bf15e9d667d7cadfaa518baf9d47308,1,apoorvnaik,2017-03-14 11:33:35-07:00,['9ca6136e2e6e431b0f463344e7e3a731af69646b'],0,10,10,870817,1,,,,1800
3fee23c8c7fa4955c4be36104744ab3711d9f55e,1,Madhan Neethiraj,2017-03-16 22:39:58-07:00,['ab43b2808bf15e9d667d7cadfaa518baf9d47308'],1,4,5,870822,1,,,,1800
de7ae290a11876809ab509a4e64921bc77272f5b,0,Madhan Neethiraj,2017-03-16 23:12:48-07:00,['3fee23c8c7fa4955c4be36104744ab3711d9f55e'],0,1,1,870823,1,,,,1800
89a387279d9d0cae66f8e0a75a9ee3610da8c173,0,Madhan Neethiraj,2017-03-17 00:13:26-07:00,['de7ae290a11876809ab509a4e64921bc77272f5b'],4,11,15,870838,2,1,0,1,1800
7154e12d13fe4ccba4207bbf6f411353411f06b2,1,Madhan Neethiraj,2017-03-17 00:13:26-07:00,['89a387279d9d0cae66f8e0a75a9ee3610da8c173'],36,74,110,870948,4,0.942857143,1,0.942857143,1800
0c9790289cf707a35b09c92edcd1484de8523c82,0,Madhan Neethiraj,2017-03-17 00:13:26-07:00,['7154e12d13fe4ccba4207bbf6f411353411f06b2'],6,6,12,870960,1,,,,1800
1612b3058a0bc8317dd6f3ff4980fead0d36df28,1,apoorvnaik,2017-03-17 16:12:29-07:00,['0c9790289cf707a35b09c92edcd1484de8523c82'],1,40,41,871001,2,0.913043478,1,1,1800
f379c9ffd08dbdafd27d163cd155f9b9f5c2a695,1,Madhan Neethiraj,2017-03-17 17:26:47-07:00,['1612b3058a0bc8317dd6f3ff4980fead0d36df28'],357,510,867,871868,16,0.363636364,0.161616162,0.575757576,1801
2d68d4cefd6a2f38d51b4856fab8d7b3bd2fb774,0,Madhan Neethiraj,2017-03-17 17:58:40-07:00,['f379c9ffd08dbdafd27d163cd155f9b9f5c2a695'],1,5,6,871874,1,0,0,1,1801
e0145ffd40c08054cea7073239541879447794b4,1,Madhan Neethiraj,2017-03-17 18:25:47-07:00,['2d68d4cefd6a2f38d51b4856fab8d7b3bd2fb774'],18,27,45,871919,7,1,1,1,1801
919503968f81dc46e93bc73ba3da84a10cbcee7c,0,Madhan Neethiraj,2017-03-17 18:34:07-07:00,['e0145ffd40c08054cea7073239541879447794b4'],137,0,137,872056,2,0.711111111,0.711111111,0,1801
23c8f71dad17476d38363c58341627b1159c6197,1,Madhan Neethiraj,2017-03-17 18:45:38-07:00,['919503968f81dc46e93bc73ba3da84a10cbcee7c'],28,66,94,872150,5,0.763157895,0.921052632,1,1801
9e5ef85cab47ce01e8d7be946283726336e101a0,1,Madhan Neethiraj,2017-03-17 19:10:42-07:00,['23c8f71dad17476d38363c58341627b1159c6197'],2,18,20,872170,4,,,,1801
bec9370e5807f73e7dfc8e72da42d06557a745b4,1,Madhan Neethiraj,2017-03-17 19:10:49-07:00,['9e5ef85cab47ce01e8d7be946283726336e101a0'],11,88,99,872269,2,0.68,1,1,1801
537f6e31f00f3406a6eb1a03a0f1223ce74ba9a4,0,Madhan Neethiraj,2017-03-18 09:21:21-07:00,['bec9370e5807f73e7dfc8e72da42d06557a745b4'],4,4,8,872277,1,,,,1801
160b28740b0689d7892299fd246394508c28d2dd,1,Madhan Neethiraj,2017-03-18 14:48:28-07:00,['537f6e31f00f3406a6eb1a03a0f1223ce74ba9a4'],131,236,367,872644,12,0.864864865,0.648648649,1,1801
94158e16e74c2bc5104b5a6018b221cb1de6e2ca,0,Madhan Neethiraj,2017-03-20 00:02:07-07:00,['160b28740b0689d7892299fd246394508c28d2dd'],1,0,1,872645,1,0,0,0,1801
b86e8591a96740d638f548e52fd18fdad34da781,1,Madhan Neethiraj,2017-03-20 09:39:38-07:00,['94158e16e74c2bc5104b5a6018b221cb1de6e2ca'],2,9,11,872656,2,0.2,0.2,1,1801
d6e40806f8133db38996d93ac0da3161c39865fa,1,Madhan Neethiraj,2017-03-20 10:27:29-07:00,['b86e8591a96740d638f548e52fd18fdad34da781'],43,42,85,872741,5,,,,1801
a127e26be618eeabcebdc0d4d3574da64b4bb745,1,Madhan Neethiraj,2017-03-20 23:55:59-07:00,['d6e40806f8133db38996d93ac0da3161c39865fa'],0,1,1,872742,1,1,1,1,1801
1cc40fd9eff4827aa4507e78b274829511a2acb7,0,Madhan Neethiraj,2017-03-21 01:39:30-07:00,['a127e26be618eeabcebdc0d4d3574da64b4bb745'],0,33,33,872775,2,1,1,1,1801
ae6fd0a183b42ca7bbeea1a574da0d1d48b51b76,0,Madhan Neethiraj,2017-03-23 17:54:25-07:00,['1cc40fd9eff4827aa4507e78b274829511a2acb7'],1,1,2,872777,1,,,,1801
220213dba5c6a9766efe33723f873143c09a8a77,1,Madhan Neethiraj,2017-03-23 17:56:16-07:00,['ae6fd0a183b42ca7bbeea1a574da0d1d48b51b76'],2,4,6,872783,2,1,1,1,1801
1aa38090ac8f667c2d357c005370cad214591e3b,1,Madhan Neethiraj,2017-03-24 08:49:11-07:00,['220213dba5c6a9766efe33723f873143c09a8a77'],150,236,386,873169,26,0.722222222,0,0.777777778,1801
41839141b30ca0bd258c4b7a15fde99593636efe,0,apoorvnaik,2017-03-25 15:42:11-07:00,['1aa38090ac8f667c2d357c005370cad214591e3b'],21,31,52,873221,5,0,0,0.333333333,1801
2dd0f0709cbfb4dd9fbd8421640ee4067b730629,1,Madhan Neethiraj,2017-03-26 18:21:38-07:00,['41839141b30ca0bd258c4b7a15fde99593636efe'],26,173,199,873420,5,0.434343434,0.161616162,0.797979798,1801
a9f3da62d4c131c837a908c27555fb66bcdcdd05,1,Madhan Neethiraj,2017-03-27 22:46:31-07:00,['2dd0f0709cbfb4dd9fbd8421640ee4067b730629'],1,1,2,873422,1,,,,1801
d5a5238b2671ce6d903c560c56fd4ef96217662a,1,Madhan Neethiraj,2017-03-27 23:05:15-07:00,['a9f3da62d4c131c837a908c27555fb66bcdcdd05'],101,277,378,873800,5,0.221374046,0.526717557,0.992366412,1801
30284c9a8ff1b1c6d1a66e84b4e7cff9d18e5b60,1,Madhan Neethiraj,2017-03-28 00:29:14-07:00,['d5a5238b2671ce6d903c560c56fd4ef96217662a'],88,86,174,873974,10,1,1,1,1801
65581a31e63dc5d359ba7394e7f8b3890613cac9,1,Sarath Subramanian,2017-03-30 13:59:22-07:00,['30284c9a8ff1b1c6d1a66e84b4e7cff9d18e5b60'],0,10,10,873984,1,,,,1801
401d39af229c245316d83605e90c4fcedab343ac,1,ayubpathan,2017-03-31 21:40:23+05:18,['65581a31e63dc5d359ba7394e7f8b3890613cac9'],0,10,10,873994,1,,,,1801
d0cb5c37df9a99f79f2be23c40f693417ae2a26a,1,Madhan Neethiraj,2017-04-03 06:56:12-07:00,['401d39af229c245316d83605e90c4fcedab343ac'],147,383,530,874524,12,0.121621622,0.668918919,0.851351351,1801
2720af61499db1f4bd42d1dfa2cec766aeabd702,1,Madhan Neethiraj,2017-04-03 07:28:05-07:00,['d0cb5c37df9a99f79f2be23c40f693417ae2a26a'],16,110,126,874650,7,0,0.988235294,1,1801
8cc5e510fdc3c505c41b3ad50ad4fc3d429f3379,1,Madhan Neethiraj,2017-04-10 19:33:39-07:00,['2720af61499db1f4bd42d1dfa2cec766aeabd702'],1,61,62,874712,2,,,,1802
97209e817a73ab34093687a059c45f3ee5e95027,1,kevalbhatt,2017-04-11 18:30:52+05:18,['8cc5e510fdc3c505c41b3ad50ad4fc3d429f3379'],15,20,35,874747,1,0.2,0.2,1,1802
c9a9126491bef62daa91e30a8e8ff0051dc4e8ba,0,kevalbhatt,2017-04-11 19:10:38+05:18,['97209e817a73ab34093687a059c45f3ee5e95027'],17,147,164,874911,6,0.364864865,1,1,1802
81d3184dbceb1e10042e2bbf3cd2130282508b36,1,nixonrodrigues,2017-04-12 16:19:12+05:18,['c9a9126491bef62daa91e30a8e8ff0051dc4e8ba'],8,4,12,874923,1,0,0,0,1802
b1fd699549c280e5fd29b8dd522ecc7fd0660f9d,0,nixonrodrigues,2017-04-12 16:54:47+05:18,['81d3184dbceb1e10042e2bbf3cd2130282508b36'],0,10,10,874933,1,,,,1802
c3813d298ef1606afb0d003127143f260c1c675f,0,Nixon,2017-04-12 18:30:44+05:18,['b1fd699549c280e5fd29b8dd522ecc7fd0660f9d'],1,2,3,874936,2,0,1,1,1802
cb554197785dd012f919321c41b69c166a6dc840,1,Madhan Neethiraj,2017-04-12 11:28:44-07:00,['c3813d298ef1606afb0d003127143f260c1c675f'],39,55,94,875030,9,0,0.25,0,1802
ceea868de288de8541b67738b7bdf4b9f8b602ac,1,apoorvnaik,2017-04-12 11:49:49-07:00,['cb554197785dd012f919321c41b69c166a6dc840'],0,372,372,875402,5,,,,1806
7f03fc8e746ddba868f5520edbca4850c540b5df,1,Madhan Neethiraj,2017-04-12 13:33:17-07:00,['ceea868de288de8541b67738b7bdf4b9f8b602ac'],8,50,58,875460,5,0.484848485,1,0.96969697,1806
42426a1b7f7418aa16c427130a767a73629fbda6,1,Madhan Neethiraj,2017-04-12 13:34:44-07:00,['7f03fc8e746ddba868f5520edbca4850c540b5df'],18,49,67,875527,2,1,1,1,1806
8a32ccaae6ce24f52371a2802c29973db59244d3,1,Sarath Subramanian,2017-04-12 14:32:29-07:00,['42426a1b7f7418aa16c427130a767a73629fbda6'],16,881,897,876424,17,0.95320197,0.92364532,0.886699507,1817
5dfe20232548079cc716d4cd532507351e7a078e,1,Madhan Neethiraj,2017-04-12 17:27:46-07:00,['8a32ccaae6ce24f52371a2802c29973db59244d3'],9,98,107,876531,4,0,0.408163265,0,1817
be93da8b83d0b19e4d015ab31190a0922ca48a2c,1,Madhan Neethiraj,2017-04-12 17:54:19-07:00,['5dfe20232548079cc716d4cd532507351e7a078e'],14,14,28,876559,3,,,,1817
29524aa06de730ce80b2a42672e46d1f5492d4cd,1,apoorvnaik,2017-04-19 07:35:32-07:00,['be93da8b83d0b19e4d015ab31190a0922ca48a2c'],1,15,16,876575,3,0,1,1,1817
0fc1c116127fbfb2416f619b9ade55a22d0594d5,1,apoorvnaik,2017-04-19 07:35:42-07:00,['29524aa06de730ce80b2a42672e46d1f5492d4cd'],1,41,42,876617,4,,,,1820
928bbc5dcad5ca770d451e17ba685cd6e199217a,0,Sarath Subramanian,2017-04-21 11:29:50-07:00,['0fc1c116127fbfb2416f619b9ade55a22d0594d5'],0,94,94,876711,2,,,,1821
e92593e9462c6b5593109ad13bc761e04ac6d93f,0,Sarath Subramanian,2017-04-25 13:08:18-07:00,['928bbc5dcad5ca770d451e17ba685cd6e199217a'],1,13,14,876725,1,1,1,1,1821
bcc89f3c459d6f02b24eae245f88f27bdbd9a65e,1,nixonrodrigues,2017-04-26 12:50:41+05:18,['e92593e9462c6b5593109ad13bc761e04ac6d93f'],19,20,39,876764,1,,,1,1821
466372ef838e03e6bd393e495e174cfcc8ce192c,1,nixonrodrigues,2017-04-26 12:51:21+05:18,['bcc89f3c459d6f02b24eae245f88f27bdbd9a65e'],6,2,8,876772,1,1,1,1,1821
2615b308e62e617c6e979b91533fefb2bbfc7d01,1,Suma Shivaprasad,2017-04-26 15:12:48-07:00,['466372ef838e03e6bd393e495e174cfcc8ce192c'],28,178,206,876978,11,0.666666667,0.684210526,1,1822
4feee3bf61a032f742c0c4738e6ffdb423cdd14d,1,Sarath Subramanian,2017-04-26 16:04:09-07:00,['2615b308e62e617c6e979b91533fefb2bbfc7d01'],5,247,252,877230,14,0.370860927,0.781456954,0.874172185,1822
3a70d11d3c1a5d51e2c783ec28d9693b61bea71b,0,Sarath Subramanian,2017-04-27 17:00:58-07:00,['4feee3bf61a032f742c0c4738e6ffdb423cdd14d'],2,8,10,877240,1,1,1,1,1822
19d344cd87eeee19b011f181f88ee5696470138d,1,kevalbhatt,2017-04-28 19:49:29+05:18,['3a70d11d3c1a5d51e2c783ec28d9693b61bea71b'],16,88,104,877344,5,0.632653061,1,1,1822
ca64ef4e80fe621435b93888abb2feee712a6283,1,Sarath Subramanian,2017-04-28 17:42:02-07:00,['19d344cd87eeee19b011f181f88ee5696470138d'],21,46,67,877411,3,0,0,0,1822
c4fc5b4f557e9a23cd717f885beca3bdb4acf7e5,0,Madhan Neethiraj,2017-04-29 15:24:07-07:00,['ca64ef4e80fe621435b93888abb2feee712a6283'],6,11,17,877428,3,0,0,,1822
d30fa2c2624038026e690eabb90f7f6436d626d8,1,Madhan Neethiraj,2017-04-30 17:47:52-07:00,['c4fc5b4f557e9a23cd717f885beca3bdb4acf7e5'],18,47,65,877493,4,0,0,0.111111111,1822
c3b1bcb1c4240027b2fa613bf32b7dd7a3a3d205,1,Madhan Neethiraj,2017-04-30 18:29:58-07:00,['d30fa2c2624038026e690eabb90f7f6436d626d8'],16,24,40,877533,2,1,1,1,1822
e8a73821793c11e3ec3501eff88903d270f1a843,1,Madhan Neethiraj,2017-05-01 00:19:57-07:00,['c3b1bcb1c4240027b2fa613bf32b7dd7a3a3d205'],323,303,626,878159,7,1,1,1,1822
f6ea040aced9fe2f76785dc2e6cb171f33b10aec,1,Madhan Neethiraj,2017-05-01 00:20:19-07:00,['e8a73821793c11e3ec3501eff88903d270f1a843'],101,87,188,878347,5,1,1,0,1822
09425abc7ca92c5ec84480c4d39451fa175f2f8c,1,Madhan Neethiraj,2017-05-01 17:11:37-07:00,['f6ea040aced9fe2f76785dc2e6cb171f33b10aec'],68,168,236,878583,3,0.625,1,1,1822
3a9594e1811e7c860f265fea0ef79713612ed0f5,0,Madhan Neethiraj,2017-05-01 17:18:14-07:00,['09425abc7ca92c5ec84480c4d39451fa175f2f8c'],64,77,141,878724,3,0,0.137931034,0.827586207,1822
b2951a9297896df8bada1bb61f9c31645bf5a9e6,0,Madhan Neethiraj,2017-05-01 17:41:49-07:00,['3a9594e1811e7c860f265fea0ef79713612ed0f5'],12,61,73,878797,1,0.80952381,1,0.476190476,1822
70931e197b2d4a3637c2c0d42ab4d465b5ba893c,0,nixonrodrigues,2017-05-02 16:10:39+05:18,['b2951a9297896df8bada1bb61f9c31645bf5a9e6'],0,0,0,878797,1,,,,1823
b6eef8c2b732d49d9cd1c7b18d23aeed388cc395,1,Sarath Subramanian,2017-05-08 22:06:06-07:00,['70931e197b2d4a3637c2c0d42ab4d465b5ba893c'],12,5,17,878814,2,1,1,1,1823
235f4e9e2d761812976515a0853169d5cb934494,1,apoorvnaik,2017-05-09 14:35:23-07:00,['b6eef8c2b732d49d9cd1c7b18d23aeed388cc395'],471,519,990,879804,61,0.322580645,1,1,1826
96d9a0ec283aacaf05ddbfa504ef4f06d133d92e,0,Sarath Subramanian,2017-05-09 14:53:27-07:00,['235f4e9e2d761812976515a0853169d5cb934494'],0,7,7,879811,1,1,1,1,1826
1decc731684ca6f2eb72d7f7c9cc3aa223f7a957,1,nixonrodrigues,2017-05-10 19:15:17+05:18,['96d9a0ec283aacaf05ddbfa504ef4f06d133d92e'],20,60,80,879891,2,0.114285714,0.571428571,0.942857143,1826
2fd87e2a3acdb2c86040c893872bdb2a54ee512b,0,apoorvnaik,2017-05-10 14:16:44-07:00,['1decc731684ca6f2eb72d7f7c9cc3aa223f7a957'],1,2,3,879894,1,,,,1826
b2bee2cca2a7e4a7080693552f96f45a074efe66,1,Kalyani,2017-05-11 16:11:18+05:18,['2fd87e2a3acdb2c86040c893872bdb2a54ee512b'],16,25,41,879935,3,0,0,1,1826
fc7d300943b40c2aeb56162d047ef0cca9b4ed7d,1,Madhan Neethiraj,2017-05-11 14:54:02-07:00,['b2bee2cca2a7e4a7080693552f96f45a074efe66'],156,255,411,880346,12,0.756097561,1,0.609756098,1826
30ec76c8533f79d2b10da5937ea21fbb3b8f0b54,1,apoorvnaik,2017-05-11 23:21:45-07:00,['fc7d300943b40c2aeb56162d047ef0cca9b4ed7d'],31,230,261,880607,9,0.185430464,0.688741722,0.867549669,1826
a0bb463879614abca5f86634096f3f2ed6779e33,0,Madhan Neethiraj,2017-05-12 13:56:22-07:00,['30ec76c8533f79d2b10da5937ea21fbb3b8f0b54'],60,69,129,880736,10,1,1,0.943396226,1827
d7a139e11edd415786208f3c920da8a2f34d26c2,1,Madhan Neethiraj,2017-05-15 18:00:44-07:00,['a0bb463879614abca5f86634096f3f2ed6779e33'],7,18,25,880761,1,0,0.571428571,0,1827
cf64a03e05c64ce25777bd478d4dda888f3e6a9c,0,nixonrodrigues,2017-05-16 18:27:36+05:18,['d7a139e11edd415786208f3c920da8a2f34d26c2'],3,3,6,880767,1,,1,,1827
f2255da116af44da4c1c86c585fe7428d218691a,1,Sarath Subramanian,2017-05-16 17:33:02-07:00,['cf64a03e05c64ce25777bd478d4dda888f3e6a9c'],2,107,109,880876,7,0.928571429,0.957142857,0.728571429,1827
bbf93327bb6377793aecb4f9ede3d75e1c59b636,0,Madhan Neethiraj,2017-05-17 08:23:34-07:00,['f2255da116af44da4c1c86c585fe7428d218691a'],4,2,6,880882,1,0,0,1,1827
0cccec93f60bd8dd530b924dced3d8de5dcccf3a,0,Sarath Subramanian,2017-05-18 15:07:30-07:00,['bbf93327bb6377793aecb4f9ede3d75e1c59b636'],3,9,12,880894,3,0,0,0.666666667,1827
f0f7fe2cf1dd775bbea64fe7df5fa864ffbd446b,1,Madhan Neethiraj,2017-05-19 09:23:24-07:00,['0cccec93f60bd8dd530b924dced3d8de5dcccf3a'],57,46,103,880997,1,1,1,0,1827
138bc6f1bddb1e376277d6544534b4d5419d1fdd,1,Madhan Neethiraj,2017-05-19 09:35:54-07:00,['f0f7fe2cf1dd775bbea64fe7df5fa864ffbd446b'],47,67,114,881111,7,0.470588235,0,0.411764706,1827
04451449dd18f6c5df93fb4517c3d7fbdc122da7,1,Madhan Neethiraj,2017-05-19 12:12:27-07:00,['138bc6f1bddb1e376277d6544534b4d5419d1fdd'],113,337,450,881561,9,0.542056075,0.700934579,0.476635514,1828
35c776448cb932723e64fda6b642f65659e83879,0,Madhan Neethiraj,2017-05-22 13:03:48-07:00,['04451449dd18f6c5df93fb4517c3d7fbdc122da7'],1,153,154,881715,2,1,1,1,1829
35e5828fb8649d14cfe4b1079237562f31186ad4,1,apoorvnaik,2017-05-23 10:20:20-07:00,['35c776448cb932723e64fda6b642f65659e83879'],2909,2733,5642,887357,200,0,1,1,1836
cfc3436be1c821273759f52aa4bfb12f0e229717,0,apoorvnaik,2017-05-25 11:29:22-07:00,['35e5828fb8649d14cfe4b1079237562f31186ad4'],0,0,0,887357,1,,,,1836
b557b98c0110f2042571b72d41676229766719c5,1,Sarath Subramanian,2017-05-25 15:16:55-07:00,['cfc3436be1c821273759f52aa4bfb12f0e229717'],8,35,43,887400,2,1,1,1,1836
bbdc31476332b5cf06c54d5db27afff0a3c62b93,0,Sarath Subramanian,2017-05-25 16:12:54-07:00,['b557b98c0110f2042571b72d41676229766719c5'],147,0,147,887547,1,,,,1836
d0e48cfd44393c97c0627ff710a82c71da548e7f,0,Kalyani,2017-05-26 14:56:45+05:18,['bbdc31476332b5cf06c54d5db27afff0a3c62b93'],0,10,10,887557,1,,,,1836
e483712bd5964493f94a3dc0f679f250da740d64,1,nixonrodrigues,2017-05-26 15:33:09+05:18,['d0e48cfd44393c97c0627ff710a82c71da548e7f'],86,119,205,887762,5,0,0.027777778,1,1836
363b88cf806be8be362a6234c1bc3f292c72ff70,0,nixonrodrigues,2017-05-26 15:34:25+05:18,['e483712bd5964493f94a3dc0f679f250da740d64'],5,7,12,887774,1,0,0,1,1836
bd69a4f1c6012c4b1a61594b91458990d5b9a26a,1,nixonrodrigues,2017-05-26 15:35:47+05:18,['363b88cf806be8be362a6234c1bc3f292c72ff70'],12,25,37,887811,2,1,1,1,1836
64988b8a36258541b2131ad32cbdadc80e4faadd,1,nixonrodrigues,2017-05-26 15:36:21+05:18,['bd69a4f1c6012c4b1a61594b91458990d5b9a26a'],8,18,26,887837,1,0,0.363636364,1,1836
e75984c483501f5c6325a1da91750c0f45d6c6fe,1,nixonrodrigues,2017-05-26 15:36:48+05:18,['64988b8a36258541b2131ad32cbdadc80e4faadd'],2,7,9,887846,1,0,0,1,1836
1c3dcc07e6d042a04cb34d06204c5aa511bfb83b,0,apoorvnaik,2017-05-26 08:50:22-07:00,['e75984c483501f5c6325a1da91750c0f45d6c6fe'],22,24,46,887892,5,,,,1836
9d6ad848abcf6cfd8bb9a2d2b790d45db1dcf9b0,1,Kalyani,2017-05-30 17:52:17+05:18,['1c3dcc07e6d042a04cb34d06204c5aa511bfb83b'],1,1,2,887894,1,,,,1836
bc1576da487bb948e8fac5858846e2ae146eb1b2,0,apoorvnaik,2017-05-30 11:21:48-07:00,['9d6ad848abcf6cfd8bb9a2d2b790d45db1dcf9b0'],4,9,13,887907,2,1,1,1,1836
d2198bb4130e2e625f0e8ed573e537da04319034,0,Madhan Neethiraj,2017-05-30 11:33:43-07:00,['bc1576da487bb948e8fac5858846e2ae146eb1b2'],358,3,361,888268,4,0.817204301,0.543010753,0.112903226,1836
4c9c3bb592a43cb24fb2113d4f9ab5db2116f3db,1,Madhan Neethiraj,2017-06-02 10:35:03-07:00,['d2198bb4130e2e625f0e8ed573e537da04319034'],94,828,922,889190,15,0.685785536,0.820448878,0.950124688,1842
e19495ad2743af1557395248a29be7c960af4059,1,Sarath Subramanian,2017-06-02 12:33:51-07:00,['4c9c3bb592a43cb24fb2113d4f9ab5db2116f3db'],0,9,9,889199,1,1,0,0,1842
4eb8bf23be13d44b6d0d2441d6fef19b5f8f3b88,0,Sarath Subramanian,2017-06-02 13:51:40-07:00,['e19495ad2743af1557395248a29be7c960af4059'],13,5,18,889217,2,0,1,1,1842
f5e0d528be7129c02e19cfdccf8afa6c6520a918,1,Madhan Neethiraj,2017-06-05 21:41:53-07:00,['4eb8bf23be13d44b6d0d2441d6fef19b5f8f3b88'],14,336,350,889567,8,1,1,0.832432432,1843
edd4aa9ad8f4a27ece75fe0d110b6b740ccd2005,0,kevalbhatt,2017-06-07 11:27:48+05:18,['f5e0d528be7129c02e19cfdccf8afa6c6520a918'],1,1,2,889569,1,,,,1843
aa6d87e1c8f373f6c2ef0ca5586d03f64339c236,1,nixonrodrigues,2017-06-08 18:14:36+05:18,['edd4aa9ad8f4a27ece75fe0d110b6b740ccd2005'],2,523,525,890094,6,0.517985612,0.845323741,0.971223022,1847
e0072e5ff293adee07554174b0318f0b70027072,0,nixonrodrigues,2017-06-09 00:35:22+05:18,['aa6d87e1c8f373f6c2ef0ca5586d03f64339c236'],0,2,2,890096,1,,,,1847
6b9399e00dcd2fb2b231c91064dfe15f46feaf1d,1,Madhan Neethiraj,2017-06-11 12:26:19-07:00,['e0072e5ff293adee07554174b0318f0b70027072'],143,1923,2066,892162,23,0.477324263,0.662131519,0.943310658,1856
82b6f727ca272b1e86625bfaa89bb5d638a0805c,0,apoorvnaik,2017-06-12 16:26:44-07:00,['6b9399e00dcd2fb2b231c91064dfe15f46feaf1d'],7,36,43,892205,5,1,1,1,1857
894a91f6097969073c8356fd6aac6490b6b619d9,1,nixonrodrigues,2017-06-13 11:52:13+05:18,['82b6f727ca272b1e86625bfaa89bb5d638a0805c'],10,10,20,892225,4,,,,1857
c2c05d673071073f036d18a2d82460f3025310cf,1,nixonrodrigues,2017-06-13 12:41:11+05:18,['894a91f6097969073c8356fd6aac6490b6b619d9'],3,8,11,892236,2,1,1,0,1857
1de6016df57c13100e18f7278c560fb3f4e50500,1,Madhan Neethiraj,2017-06-14 22:29:05-07:00,['c2c05d673071073f036d18a2d82460f3025310cf'],120,121,241,892477,8,,,,1857
d9f62cb5a97d033448567688bd21e7a4ea25d65a,0,Madhan Neethiraj,2017-06-16 08:14:14-07:00,['1de6016df57c13100e18f7278c560fb3f4e50500'],9,158,167,892644,11,0.194174757,0.912621359,0.893203883,1857
c6081ddcfdb4c8100a4b099405ac8d397fbf9583,0,Madhan Neethiraj,2017-06-17 10:29:19-07:00,['d9f62cb5a97d033448567688bd21e7a4ea25d65a'],5,48,53,892697,2,0.933333333,0.933333333,1,1857
906f36517bd13cb3f5318e7843ebfd0276a2975f,0,nixonrodrigues,2017-06-18 20:00:23+05:18,['c6081ddcfdb4c8100a4b099405ac8d397fbf9583'],0,5,5,892702,1,0,0,1,1857
c2d52759ff7ce70f0a17e6f7f2ac46f7e160b647,0,Madhan Neethiraj,2017-06-18 17:30:51-07:00,['906f36517bd13cb3f5318e7843ebfd0276a2975f'],5,5,10,892712,3,1,1,1,1857
242b5585c97a9565ac35641d8a1ed8ee3a8fd883,1,Madhan Neethiraj,2017-06-19 20:38:53-07:00,['c2d52759ff7ce70f0a17e6f7f2ac46f7e160b647'],50,1001,1051,893763,23,0.725910064,0.743040685,0.871520343,1861
f053fd59b5337429d96d441a07ad3d44eac65a5d,1,Madhan Neethiraj,2017-06-20 21:13:13-07:00,['242b5585c97a9565ac35641d8a1ed8ee3a8fd883'],27,103,130,893893,6,0.390243902,0,1,1863
e0abdb3c35221c81b293399b2bb454a3c8127cdb,1,Madhan Neethiraj,2017-06-21 13:28:31-07:00,['f053fd59b5337429d96d441a07ad3d44eac65a5d'],10,13,23,893916,1,1,1,0,1863
bcb128af3283432a1da3ab4a524cd200f647f862,1,Madhan Neethiraj,2017-06-22 10:20:14-07:00,['e0abdb3c35221c81b293399b2bb454a3c8127cdb'],9,364,373,894289,4,0.910313901,0.99103139,1,1864
4f16db450921fb90b02e0103392669a389ef9745,1,Madhan Neethiraj,2017-06-22 21:42:01-07:00,['bcb128af3283432a1da3ab4a524cd200f647f862'],37,265,302,894591,11,0.507575758,0.96969697,0.871212121,1864
5bb2dcbeb366a2e09423811506078b8e5ddf19f3,1,Madhan Neethiraj,2017-06-26 07:49:31-07:00,['4f16db450921fb90b02e0103392669a389ef9745'],256,552,808,895399,11,0.151394422,0.657370518,0.908366534,1865
0e7f8ea4603c858cc295259bbd1a22314b732f62,1,Madhan Neethiraj,2017-06-26 08:07:12-07:00,['5bb2dcbeb366a2e09423811506078b8e5ddf19f3'],570,415,985,896384,20,1,0,0.017094017,1867
8101883cce0698a59f9f43fb67c94543585127d0,1,Madhan Neethiraj,2017-06-27 00:20:47-07:00,['0e7f8ea4603c858cc295259bbd1a22314b732f62'],61,677,738,897122,13,0.939759036,0.96686747,0.945783133,1874
7c262b40ba4bbf6946c2423f36ddb0f3ee12c8f8,1,Madhan Neethiraj,2017-06-30 01:49:08-07:00,['8101883cce0698a59f9f43fb67c94543585127d0'],124,2381,2505,899627,37,0.409127954,0.484922575,0.824775876,1879
9a4ed469cc64cf107b98fba1851525017fec2024,1,Madhan Neethiraj,2017-06-30 01:49:15-07:00,['7c262b40ba4bbf6946c2423f36ddb0f3ee12c8f8'],2621,955,3576,903203,35,0.62406015,0.503759398,0.019214703,1884
958c48c2c1807e68dd8cceda6857ec065c083a4b,1,Madhan Neethiraj,2017-06-30 22:42:40-07:00,['9a4ed469cc64cf107b98fba1851525017fec2024'],11,138,149,903352,5,,,,1885
617bc25ecc89f0bb38098faafc8fc1e4e1afb4de,0,Madhan Neethiraj,2017-07-01 00:59:08-07:00,['958c48c2c1807e68dd8cceda6857ec065c083a4b'],9,9,18,903370,1,0,0,1,1885
d22fa7eba93d3a97800f4a5f2b5c3935223f7625,0,apoorvnaik,2017-07-03 09:29:05-07:00,['617bc25ecc89f0bb38098faafc8fc1e4e1afb4de'],0,1,1,903371,1,0,0,0,1885
45d0930b270caa10434f3d97dbea0224bc68740c,0,apoorvnaik,2017-07-03 13:51:27-07:00,['d22fa7eba93d3a97800f4a5f2b5c3935223f7625'],28,32,60,903431,3,0,0,1,1885
c4fd42b86bfe1f4654460ba621714bcea3336fbb,1,Kalyani,2017-07-04 18:03:58+05:18,['45d0930b270caa10434f3d97dbea0224bc68740c'],4,38,42,903473,1,1,0.657142857,1,1885
497dcc079eb5240c366b378d4e0776294ba3f810,1,apoorvnaik,2017-07-06 09:31:13-07:00,['c4fd42b86bfe1f4654460ba621714bcea3336fbb'],18,84,102,903575,5,0.8,1,0.5,1885
1c4e8b7ffa34a9194d2a6d060c1f335a52c6dce0,0,Madhan Neethiraj,2017-07-07 16:49:39-07:00,['497dcc079eb5240c366b378d4e0776294ba3f810'],9,1,10,903585,1,,,,1885
ee8c81df45801fa3798c19f3999b635140e835f7,0,Madhan Neethiraj,2017-07-07 20:57:37-07:00,['1c4e8b7ffa34a9194d2a6d060c1f335a52c6dce0'],9,18,27,903612,2,0,0,1,1885
b13501825028ea6c8ede8f6eacdf97bf58feacb8,1,Madhan Neethiraj,2017-07-10 06:35:29-07:00,['ee8c81df45801fa3798c19f3999b635140e835f7'],1,3,4,903616,1,1,1,1,1885
8fe110c3f3c4902d17b082f8431de190fecb0f6f,1,Madhan Neethiraj,2017-07-11 05:34:02-07:00,['b13501825028ea6c8ede8f6eacdf97bf58feacb8'],158,1031,1189,904805,21,0.32967033,0.384615385,0.752747253,1886
ad398393f712fdbb689a33883182f65f8ef58ac7,0,Madhan Neethiraj,2017-07-11 09:26:45-07:00,['8fe110c3f3c4902d17b082f8431de190fecb0f6f'],5,22,27,904832,1,0,0,1,1886
ea1c3b68ee8882f46cec1f9394b2aadad1f80f7a,1,Madhan Neethiraj,2017-07-12 03:10:06-07:00,['ad398393f712fdbb689a33883182f65f8ef58ac7'],28,26,54,904886,1,,,,1886
4e62a0626c5946c7b81943669e859033884f919b,1,Madhan Neethiraj,2017-07-12 03:11:21-07:00,['ea1c3b68ee8882f46cec1f9394b2aadad1f80f7a'],36,206,242,905128,14,0.375,0.836538462,0.865384615,1886
40d909ef8726b807a263ff8f8be57150e51f910d,1,nixonrodrigues,2017-07-12 16:37:40+05:18,['4e62a0626c5946c7b81943669e859033884f919b'],31,55,86,905214,7,0.133333333,0.666666667,0.6,1886
b0470f50e10837d052db8e0fe74847b0559bfabf,0,Madhan Neethiraj,2017-07-12 14:35:18-07:00,['40d909ef8726b807a263ff8f8be57150e51f910d'],5,39,44,905258,3,0.9375,0.9375,1,1886
18745cf4b98af9c45e853daa280342dde8da1300,1,Madhan Neethiraj,2017-07-13 13:25:15-07:00,['b0470f50e10837d052db8e0fe74847b0559bfabf'],25,31,56,905314,1,0.428571429,0.428571429,1,1886
c3808cf1f9010467801a0a1567d60a407fed4f79,0,Madhan Neethiraj,2017-07-13 13:29:14-07:00,['18745cf4b98af9c45e853daa280342dde8da1300'],11,25,36,905350,4,0,0,0,1886
de91608446514df864995d1e50a8db4276b08ad8,0,Madhan Neethiraj,2017-07-14 14:53:37-07:00,['c3808cf1f9010467801a0a1567d60a407fed4f79'],0,17,17,905367,1,0.769230769,0.769230769,1,1886
0d8f9f8d2d3902471dc246bd51d3eb7512021f74,1,Madhan Neethiraj,2017-07-14 15:28:58-07:00,['de91608446514df864995d1e50a8db4276b08ad8'],27,35,62,905429,10,0,1,0.8,1886
bcec42e3306c9517c1ded5e7ed538c76cfd29c33,1,Madhan Neethiraj,2017-07-14 16:02:38-07:00,['0d8f9f8d2d3902471dc246bd51d3eb7512021f74'],1387,1216,2603,908032,17,0.875,0.808333333,0.1,1891
84c6d52d266c6aa2039e7e8cb9a7edb8f4bb8a93,1,Madhan Neethiraj,2017-07-14 16:08:31-07:00,['bcec42e3306c9517c1ded5e7ed538c76cfd29c33'],21,28,49,908081,5,0.8,0.8,0.8,1891
eddab3b12a1318f6e787d062816e28479715f077,0,Madhan Neethiraj,2017-07-15 14:22:41-07:00,['84c6d52d266c6aa2039e7e8cb9a7edb8f4bb8a93'],0,4,4,908085,1,0,1,1,1891
bcabde9bbe8361bc7b4461b395dd2ffcb0906962,0,Madhan Neethiraj,2017-07-15 14:50:04-07:00,['eddab3b12a1318f6e787d062816e28479715f077'],1,22,23,908108,3,1,1,1,1891
3962057c640e1fbecb4cfb6a785475e441a7de1d,1,Madhan Neethiraj,2017-07-17 10:12:18-07:00,['bcabde9bbe8361bc7b4461b395dd2ffcb0906962'],11,93,104,908212,3,1,1,1,1891
abc4856e94e24837eee0dc5efc1763a5ceba6fc9,1,Madhan Neethiraj,2017-07-17 17:07:53-07:00,['3962057c640e1fbecb4cfb6a785475e441a7de1d'],60,82,142,908354,2,0,0.470588235,0.470588235,1891
d7ce0a535621e2cd1176ff3e069ce60b27b04c17,0,Madhan Neethiraj,2017-07-17 18:07:15-07:00,['abc4856e94e24837eee0dc5efc1763a5ceba6fc9'],0,14,14,908368,3,0.125,0.25,0.5,1891
71f9c065225405d188c622a6898686ee5a73817f,1,Madhan Neethiraj,2017-07-18 08:01:20-07:00,['d7ce0a535621e2cd1176ff3e069ce60b27b04c17'],22,67,89,908457,4,0,1,0,1891
377fe19f023a4036f9fa1503dec6ea698fdb214b,1,Madhan Neethiraj,2017-07-18 08:05:53-07:00,['71f9c065225405d188c622a6898686ee5a73817f'],39,50,89,908546,3,0,0,0.4,1891
cfb6b84f41b05275db826bbd43e4c39145b6d2d5,1,Madhan Neethiraj,2017-07-18 16:59:02-07:00,['377fe19f023a4036f9fa1503dec6ea698fdb214b'],18,61,79,908625,4,0,0.714285714,1,1891
24a106b4e1a1581b266a453cc6c920bcd06d7a9b,1,Madhan Neethiraj,2017-07-19 00:50:14-07:00,['cfb6b84f41b05275db826bbd43e4c39145b6d2d5'],43,124,167,908792,5,0.830508475,0.830508475,0.86440678,1892
cda7f56d5a71970c21de4e2c49771dc85c4a47f0,0,Madhan Neethiraj,2017-07-19 09:39:51-07:00,['24a106b4e1a1581b266a453cc6c920bcd06d7a9b'],1,6,7,908799,1,1,1,1,1892
5527afb0d4cdf4414f2e95e0d419392dc78c9d9a,1,Madhan Neethiraj,2017-07-19 10:02:26-07:00,['cda7f56d5a71970c21de4e2c49771dc85c4a47f0'],47,88,135,908934,5,0,0.25,1,1892
f74e43c2bc3fde30cb1d707f1e7c08b8770ec67e,1,Madhan Neethiraj,2017-07-19 17:42:30-07:00,['5527afb0d4cdf4414f2e95e0d419392dc78c9d9a'],95,145,240,909174,5,0.486486486,0.513513514,0.810810811,1892
02e4e86b5adeb52044ba09a978c8ccbb2200d67d,1,Madhan Neethiraj,2017-07-19 18:39:14-07:00,['f74e43c2bc3fde30cb1d707f1e7c08b8770ec67e'],329,1489,1818,910992,26,0.347181009,0.989614243,0.784866469,1895
3d3be40848775b43c97f4f94df47591762e78d0b,1,Madhan Neethiraj,2017-07-20 10:41:27-07:00,['02e4e86b5adeb52044ba09a978c8ccbb2200d67d'],7,41,48,911040,4,1,1,1,1895
e0fb7dc17000724fada89cb573db9b4fa1654a2e,0,Madhan Neethiraj,2017-07-20 14:23:18-07:00,['3d3be40848775b43c97f4f94df47591762e78d0b'],38,68,106,911146,4,1,0,1,1895
13ba156f1d76caaa969e2f6fd93e2387307ae7c7,1,Madhan Neethiraj,2017-07-20 19:03:40-07:00,['e0fb7dc17000724fada89cb573db9b4fa1654a2e'],6,16,22,911168,4,0.571428571,1,0.428571429,1895
62d85a4caebeb8f459c0a1774fade83cd49b9c35,0,Madhan Neethiraj,2017-07-20 21:28:13-07:00,['13ba156f1d76caaa969e2f6fd93e2387307ae7c7'],18,19,37,911205,3,1,1,1,1895
f511f27267adbd5c602e9c2089aba3cac3a314fa,1,Madhan Neethiraj,2017-07-21 07:18:21-07:00,['62d85a4caebeb8f459c0a1774fade83cd49b9c35'],300,240,540,911745,14,1,1,0.126436782,1895
e0d2cdc27c32742ebecd24db4cca62dc04dcdf4b,1,Madhan Neethiraj,2017-07-21 09:28:44-07:00,['f511f27267adbd5c602e9c2089aba3cac3a314fa'],102,131,233,911978,10,0.9375,0.875,1,1895
d23d61b2a88a472978dcd15428a61dfa48d31215,1,Madhan Neethiraj,2017-07-21 19:24:42-07:00,['e0d2cdc27c32742ebecd24db4cca62dc04dcdf4b'],8,42,50,912028,2,1,1,1,1895
de251913cdcfade1e77c826072d6869f78dfc91d,1,Madhan Neethiraj,2017-07-23 21:43:48-07:00,['d23d61b2a88a472978dcd15428a61dfa48d31215'],284,273,557,912585,42,,,,1895
7fb09b0f964f4b4373c885b427359ccf58dfff26,1,Madhan Neethiraj,2017-07-24 00:48:25-07:00,['de251913cdcfade1e77c826072d6869f78dfc91d'],10,19,29,912614,2,1,1,1,1895
2e8f6013fa1dedcf7902be425b7bbada1f6b24b9,0,Madhan Neethiraj,2017-07-24 22:34:32-07:00,['7fb09b0f964f4b4373c885b427359ccf58dfff26'],0,20,20,912634,4,,,,1895
6547af2d035fae7402d7a4d77e640e0599fb1075,1,Madhan Neethiraj,2017-07-25 07:09:42-07:00,['2e8f6013fa1dedcf7902be425b7bbada1f6b24b9'],6,30,36,912670,2,0.846153846,0,0.846153846,1895
c97275ca3b09195f4d37a5d6e7f5a3245ddf4d4e,0,apoorvnaik,2017-07-26 21:48:36-07:00,['6547af2d035fae7402d7a4d77e640e0599fb1075'],4,5,9,912679,1,,,,1895
8931d475829da92bae9787811ce4dfa774812215,1,Madhan Neethiraj,2017-07-27 15:21:44-07:00,['c97275ca3b09195f4d37a5d6e7f5a3245ddf4d4e'],1,71,72,912751,2,0,0.363636364,1,1895
d8b868339ef2233620db3318f8667f0653873ee1,0,Madhan Neethiraj,2017-07-28 17:15:30-07:00,['8931d475829da92bae9787811ce4dfa774812215'],0,70,70,912821,2,,,,1896
6fb2a0388a89369ceec57a74954d129df600e163,1,Madhan Neethiraj,2017-07-28 18:18:19-07:00,['d8b868339ef2233620db3318f8667f0653873ee1'],91,221,312,913133,8,0,0.426829268,0.573170732,1896
9b72de98072f4b4adcc3179399342fd63494043b,1,Madhan Neethiraj,2017-07-30 02:22:16-07:00,['6fb2a0388a89369ceec57a74954d129df600e163'],28,227,255,913388,7,0,0,0.378787879,1896
e75473a3babb61cf7530fd42ed4ff6fd133c574c,1,Madhan Neethiraj,2017-07-30 11:46:01-07:00,['9b72de98072f4b4adcc3179399342fd63494043b'],88,92,180,913568,3,0,0,0,1896
9eb8134a113bd018f9467284d45f499c26423d3c,0,Sarath Subramanian,2017-07-31 14:25:30-07:00,['e75473a3babb61cf7530fd42ed4ff6fd133c574c'],1,1,2,913570,1,,,,1896
668b4347b97998ed9e66ffaedd54ca20919e3b76,1,ashutoshm,2017-08-01 14:00:00-07:00,['9eb8134a113bd018f9467284d45f499c26423d3c'],18,32,50,913620,1,,,,1896
eb82ef9b76012fbcdad17543d2478ec70fbf00e6,0,apoorvnaik,2017-08-01 15:26:12-07:00,['668b4347b97998ed9e66ffaedd54ca20919e3b76'],2,2,4,913624,1,0,0,0,1896
52489d6003ac8c227e048d808175024dc9fe6724,1,Madhan Neethiraj,2017-08-01 23:41:49-07:00,['eb82ef9b76012fbcdad17543d2478ec70fbf00e6'],15,151,166,913790,11,0.642857143,0.976190476,1,1896
b59460ffa93f2544aaa0d35488a69474f4a95ca0,0,Sarath Subramanian,2017-08-02 11:37:55-07:00,['52489d6003ac8c227e048d808175024dc9fe6724'],18,8,26,913816,6,,,,1896
0267eecd831c4927cac7aa460a548f8628fb31f8,1,Madhan Neethiraj,2017-08-02 13:20:11-07:00,['b59460ffa93f2544aaa0d35488a69474f4a95ca0'],10,50,60,913876,4,0.541666667,0,1,1896
eb5d6fcdcbbfb6d6a69f2c78ef64a7c5a47425ec,0,ashutoshm,2017-08-02 13:40:08-07:00,['0267eecd831c4927cac7aa460a548f8628fb31f8'],17,14,31,913907,2,,,,1896
38297a8441e7d32d41e717fd6efc415804e640af,1,Madhan Neethiraj,2017-08-02 18:14:52-07:00,['eb5d6fcdcbbfb6d6a69f2c78ef64a7c5a47425ec'],7,9,16,913923,1,0,0,1,1896
dd00c8596625703dd3c18474fb9700a07d08f9d8,1,Madhan Neethiraj,2017-08-02 19:51:13-07:00,['38297a8441e7d32d41e717fd6efc415804e640af'],12,33,45,913968,5,1,1,0.363636364,1896
ecd053685e547ac86dbfaed290cd3063955ce94a,0,Madhan Neethiraj,2017-08-03 00:02:59-07:00,['dd00c8596625703dd3c18474fb9700a07d08f9d8'],3,5,8,913976,1,,,,1896
daf6c0267a41670a5191fef1bd7741f492678970,1,kevalbhatt,2017-08-03 15:41:58+05:18,['ecd053685e547ac86dbfaed290cd3063955ce94a'],1,4,5,913981,1,1,0,1,1896
c585b60de737a4c8e8974f2752a92ec1f659d6e3,1,kevalbhatt,2017-08-04 17:55:10+05:18,['daf6c0267a41670a5191fef1bd7741f492678970'],1,1,2,913983,1,,,,1896
e0bd96b73d4330e221e65aae0ecb25c9fd9fdc26,0,apoorvnaik,2017-08-04 07:24:54-07:00,['c585b60de737a4c8e8974f2752a92ec1f659d6e3'],0,3,3,913986,1,0,0,1,1896
87a421ac1d659c9111b8743df26f57e97cb640b3,1,Sarath Subramanian,2017-08-08 12:07:36-07:00,['e0bd96b73d4330e221e65aae0ecb25c9fd9fdc26'],96,441,537,914523,7,0.683962264,0.66509434,0.773584906,1897
3f2d191507fcef46957fce10ebdb06b93c43f303,1,Sarath Subramanian,2017-08-08 16:25:45-07:00,['87a421ac1d659c9111b8743df26f57e97cb640b3'],22,50,72,914595,2,0,0,0.88,1897
1298c83deba4269d4cf9fb9c525d4987f10d7fa3,1,nixonrodrigues,2017-08-09 13:43:26+05:18,['3f2d191507fcef46957fce10ebdb06b93c43f303'],6,6,12,914607,1,,,,1897
fb28760a37aaec81df69b05936cc4234e20380ec,0,nixonrodrigues,2017-08-09 13:45:21+05:18,['1298c83deba4269d4cf9fb9c525d4987f10d7fa3'],23,188,211,914818,1,,,,1897
e1a142b5a783f2a3fc083b40c9ad4d6bca3d5dd9,0,ashutoshm,2017-08-09 09:44:26-07:00,['fb28760a37aaec81df69b05936cc4234e20380ec'],1,1,2,914820,1,,,,1897
d0beadf2e4a83bce17b8c42e7a584a035cf416c2,1,apoorvnaik,2017-08-09 11:21:31-07:00,['e1a142b5a783f2a3fc083b40c9ad4d6bca3d5dd9'],272,385,657,915477,18,0,0,0.416666667,1897
02a6e4771598ce418f6081966b50008a7be195a4,0,David Radley,2017-08-10 10:35:16+01:00,['d0beadf2e4a83bce17b8c42e7a584a035cf416c2'],0,11,11,915488,1,,,,1897
6f9684b4fb0a1c96993df900305d0c45c9a4e32f,1,ashutoshm,2017-08-10 09:54:38-07:00,['02a6e4771598ce418f6081966b50008a7be195a4'],14,57,71,915559,2,0,1,1,1897
5d26d6649b2281e802d142ce10f246aaddd41b74,0,nixonrodrigues,2017-08-11 21:46:44+05:18,['6f9684b4fb0a1c96993df900305d0c45c9a4e32f'],1,1,2,915561,1,,,,1897
d86be7a3b5db557a4650e4b57f726e42eb87b721,0,nixonrodrigues,2017-08-11 21:50:32+05:18,['5d26d6649b2281e802d142ce10f246aaddd41b74'],2,2,4,915565,1,,,,1897
cd49be50a2fc351f50165f6bd0573db561612699,1,Madhan Neethiraj,2017-08-12 22:41:03-07:00,['d86be7a3b5db557a4650e4b57f726e42eb87b721'],89,97,186,915751,2,1,1,1,1898
b714fe00656f529cec8e4b467322a41729f0ddc5,0,Madhan Neethiraj,2017-08-13 00:53:38-07:00,['cd49be50a2fc351f50165f6bd0573db561612699'],23,49,72,915823,4,0,0,0.5,1898
856a0c61b273dd9b4a70c69bd743c51e2425a568,0,David Radley,2017-08-15 16:52:35+01:00,['b714fe00656f529cec8e4b467322a41729f0ddc5'],76,93,169,915992,6,,,,1898
376298540ceca9315d3726c9dbaab619d33ea4f7,1,David Radley,2017-08-16 10:36:00+01:00,['856a0c61b273dd9b4a70c69bd743c51e2425a568'],2,2,4,915996,1,,,,1898
fa11d13a5c431fe3c46a7ad2b267bea1f61da3e9,0,Madhan Neethiraj,2017-08-16 10:32:50-07:00,['376298540ceca9315d3726c9dbaab619d33ea4f7'],38,38,76,916072,1,,,,1898
fae00825291dd79b54867b7b7d0c2a233ce163fd,1,Madhan Neethiraj,2017-08-16 17:53:05-07:00,['fa11d13a5c431fe3c46a7ad2b267bea1f61da3e9'],48,1218,1266,917338,5,0.543307087,0.543307087,0.394825647,1899
56374ff7e3a6faa3e444db1ba3fa14905f356dc9,0,Madhan Neethiraj,2017-08-16 18:30:48-07:00,['fae00825291dd79b54867b7b7d0c2a233ce163fd'],1,31,32,917370,2,,,,1899
63ed2a5dac174d0fc241e9ae2d8dc5b97408c826,0,David Radley,2017-08-17 17:29:44+01:00,['56374ff7e3a6faa3e444db1ba3fa14905f356dc9'],1,1,2,917372,8,,,,1899
f2a49beadd0d8aab16dfc0f53fd2795278bf2e48,1,Sarath Subramanian,2017-08-17 14:30:57-07:00,['63ed2a5dac174d0fc241e9ae2d8dc5b97408c826'],6,248,254,917626,10,0.180451128,0.428571429,0.345864662,1900
bb9384ca32b2d4773fa3985851f3d5edf861dc13,1,Sarath Subramanian,2017-08-17 14:33:16-07:00,['f2a49beadd0d8aab16dfc0f53fd2795278bf2e48'],38,54,92,917718,6,0,0,0,1900
b23dc8584a9d798e83d982ea5264de1e8025288b,1,Sarath Subramanian,2017-08-17 15:08:54-07:00,['bb9384ca32b2d4773fa3985851f3d5edf861dc13'],145,1268,1413,919131,21,0.536661466,0.789391576,0.725429017,1909
a9514d4b1c22b653b8d3fa1d83204ab91dbefedd,0,Sarath Subramanian,2017-08-17 15:16:31-07:00,['b23dc8584a9d798e83d982ea5264de1e8025288b'],0,38,38,919169,1,0.238095238,0.238095238,1,1909
e80b6c360c3a5b255d822d0dc006d89a5eba530d,0,Sarath Subramanian,2017-08-17 18:01:26-07:00,['a9514d4b1c22b653b8d3fa1d83204ab91dbefedd'],24,2,26,919195,1,1,0,0,1909
a7e2f50b0afd64cb951b13fdccbdea5197c406ee,0,Madhan Neethiraj,2017-08-17 18:54:01-07:00,['e80b6c360c3a5b255d822d0dc006d89a5eba530d'],16,0,16,919211,3,,,,1909
86fb9da494f23ed7689e67b131e736344afa1811,0,Sarath Subramanian,2017-08-18 11:41:54-07:00,['a7e2f50b0afd64cb951b13fdccbdea5197c406ee'],38,77,115,919326,4,0,1,1,1909
6d8c50cca95a51db509c87c73c735ea1445c3fa3,1,Madhan Neethiraj,2017-08-18 15:05:09-07:00,['86fb9da494f23ed7689e67b131e736344afa1811'],42,64,106,919432,6,1,0,1,1909
2c84d7029808c090489b7a8cecdf691ffed71a93,1,Sarath Subramanian,2017-08-18 16:51:50-07:00,['6d8c50cca95a51db509c87c73c735ea1445c3fa3'],2,18,20,919452,2,0.4,0.4,1,1909
ce8f65c9c5f7f2cff3934829258ce3d2ebe84b60,0,Madhan Neethiraj,2017-08-18 17:18:58-07:00,['2c84d7029808c090489b7a8cecdf691ffed71a93'],4,11,15,919467,1,0,0,0,1909
2841b85ec5039170d39ec8252724f74e4362112f,1,Madhan Neethiraj,2017-08-21 10:11:02-07:00,['ce8f65c9c5f7f2cff3934829258ce3d2ebe84b60'],21,29,50,919517,2,0.25,0.25,1,1909
1496257312abf06a471efc54c844634d7200b9dd,0,ashutoshm,2017-08-21 11:41:44-07:00,['2841b85ec5039170d39ec8252724f74e4362112f'],6,5,11,919528,1,,,,1909
b54f4b87659dec53d57c55c77799367d5f0fe399,0,Sarath Subramanian,2017-08-21 11:56:41-07:00,['1496257312abf06a471efc54c844634d7200b9dd'],16,16,32,919560,8,,,,1909
88eadb9bfa74b17dfff26dcbad0617d240d856e9,1,Sarath Subramanian,2017-08-22 23:05:10-07:00,['b54f4b87659dec53d57c55c77799367d5f0fe399'],3,20,23,919583,3,1,1,0.166666667,1909
024fd221043ae745921d9bfa9e6e689507972f1a,1,Sarath Subramanian,2017-08-22 23:06:31-07:00,['88eadb9bfa74b17dfff26dcbad0617d240d856e9'],35,90,125,919708,7,0.384615385,1,1,1909
97ae3a3c819a371d9af39cd4de28e4f8b28e19a6,1,Madhan Neethiraj,2017-08-23 09:18:53-07:00,['024fd221043ae745921d9bfa9e6e689507972f1a'],34,38,72,919780,3,0.2,0.2,1,1909
bb1897663b43feb79faf6e2fc2818380fd16b9dd,1,Sarath Subramanian,2017-08-23 10:19:22-07:00,['97ae3a3c819a371d9af39cd4de28e4f8b28e19a6'],7,7,14,919794,6,,,,1909
64c9bde668b52c6f621c19110f2da0a0907704d8,0,Madhan Neethiraj,2017-08-23 10:59:23-07:00,['bb1897663b43feb79faf6e2fc2818380fd16b9dd'],20,31,51,919845,2,0,0.375,1,1909
2f6d7b2491140a5efd5a9fae5b8aaf3ccee5b514,1,Madhan Neethiraj,2017-08-24 11:43:51-07:00,['64c9bde668b52c6f621c19110f2da0a0907704d8'],100,103,203,920048,7,0,0,0,1909
b445a1d2ba49764e3f9c898d0a6bb8b5faaddc80,1,Sarath Subramanian,2017-08-24 17:32:03-07:00,['2f6d7b2491140a5efd5a9fae5b8aaf3ccee5b514'],38,148,186,920234,6,0.285714286,0.324675325,0,1909
a6c0793feaa6871d69fda24189f35b244e606e0e,0,Madhan Neethiraj,2017-08-25 00:58:23-07:00,['b445a1d2ba49764e3f9c898d0a6bb8b5faaddc80'],0,5,5,920239,2,0,0,1,1909
8686333985311f3ed907ffc71942eb7e92896808,0,Madhan Neethiraj,2017-08-25 01:29:03-07:00,['a6c0793feaa6871d69fda24189f35b244e606e0e'],2,2,4,920243,2,,,,1909
c6155816c51ebdbce8bef0069a8bccca1418c7d0,1,Madhan Neethiraj,2017-08-25 12:03:54-07:00,['8686333985311f3ed907ffc71942eb7e92896808'],0,99,99,920342,2,,,,1911
cba5f7622b0724b158e93ac3d9cd7bd8de6d4c2b,1,Madhan Neethiraj,2017-08-26 02:06:59-07:00,['c6155816c51ebdbce8bef0069a8bccca1418c7d0'],2,53,55,920397,2,0.447368421,0.947368421,0.894736842,1911
a32e2b2e7f043740f2a282607ef356f8fea38bbf,1,kevalbhatt,2017-08-28 11:25:56+05:18,['cba5f7622b0724b158e93ac3d9cd7bd8de6d4c2b'],13,22,35,920432,4,0,1,1,1911
4820a20b1a0df96054ca210aaa0a89bfa48704e1,0,Madhan Neethiraj,2017-08-27 23:57:52-07:00,['a32e2b2e7f043740f2a282607ef356f8fea38bbf'],0,1791,1791,922223,37,,,,1948
15d67e52f118ce689724f62ac3c83cfd3128e34f,1,Madhan Neethiraj,2017-08-28 13:25:45-07:00,['4820a20b1a0df96054ca210aaa0a89bfa48704e1'],554,165,719,922942,17,0.60483871,0.161290323,0,1949
1b7e41f1adbfea4f046ff66b904d22ee839e095b,1,Sarath Subramanian,2017-08-29 14:41:18-07:00,['15d67e52f118ce689724f62ac3c83cfd3128e34f'],1,4,5,922947,1,,,,1949
f59284adbb3f0231fe6cc0da3a521c29f0210dba,1,Sarath Subramanian,2017-08-29 17:01:00-07:00,['1b7e41f1adbfea4f046ff66b904d22ee839e095b'],113,481,594,923541,10,0.145228216,0.7593361,0.506224066,1949
42ccc44a9289274133528324eab02cff15ffb955,0,Madhan Neethiraj,2017-08-29 17:46:04-07:00,['f59284adbb3f0231fe6cc0da3a521c29f0210dba'],17,54,71,923612,8,0.48,1,0.28,1949
20742f1e685a9a58b9c5ef4ba0ac9fbaadf9f8e6,0,Madhan Neethiraj,2017-08-29 19:22:55-07:00,['42ccc44a9289274133528324eab02cff15ffb955'],1,1,2,923614,1,,,,1949
58794583a1977a684ed5f5567d7376806b262090,0,Sarath Subramanian,2017-08-30 11:27:11-07:00,['20742f1e685a9a58b9c5ef4ba0ac9fbaadf9f8e6'],1,1,2,923616,1,,,,1949
68f66e92acfed5d8fdd5652245bd989aa6bbfb94,1,Sarath Subramanian,2017-08-30 11:41:10-07:00,['58794583a1977a684ed5f5567d7376806b262090'],12,51,63,923679,1,0.181818182,1,0.863636364,1949
ef300f15a500948b983b8a49c5828e5f39dcd35d,1,Sarath Subramanian,2017-08-30 16:22:02-07:00,['68f66e92acfed5d8fdd5652245bd989aa6bbfb94'],2,14,16,923695,2,0.875,1,1,1949
b837c0ee304174a100fc2f4507cbdd7e9a4195b9,1,ashutoshm,2017-08-30 22:20:17-07:00,['ef300f15a500948b983b8a49c5828e5f39dcd35d'],5,188,193,923888,3,0.953271028,0.953271028,0.906542056,1950
9d38c6a94f1962a55efb8e047428c2be1e61ad25,0,ashutoshm,2017-09-01 17:27:31-07:00,['b837c0ee304174a100fc2f4507cbdd7e9a4195b9'],4,4,8,923896,1,,,,1950
1dcc3073abe7b920c9a0fb1fd3055b8daa22cf1e,1,Madhan Neethiraj,2017-09-04 21:50:25-07:00,['9d38c6a94f1962a55efb8e047428c2be1e61ad25'],91,127,218,924114,18,0,0,1,1950
7eff37a6f4e23f75b4fce75bbc3c77e3258a6c6d,0,ashutoshm,2017-09-05 10:20:27-07:00,['1dcc3073abe7b920c9a0fb1fd3055b8daa22cf1e'],0,259,259,924373,1,0.4,0.848275862,0.827586207,1951
a5d52418d26be3de93f95f8811b9a73a74623b1e,1,Sarath Subramanian,2017-09-06 17:28:37-07:00,['7eff37a6f4e23f75b4fce75bbc3c77e3258a6c6d'],14,20,34,924407,2,1,1,0,1951
4deee50c2eb405934ab06e0ae2d8eb478dcd2574,0,ashutoshm,2017-09-08 10:02:19-07:00,['a5d52418d26be3de93f95f8811b9a73a74623b1e'],9,20,29,924436,3,,,,1951
d603afa2708948d6d33478baf05b5adca2089149,1,nixonrodrigues,2017-09-12 19:02:46+05:18,['4deee50c2eb405934ab06e0ae2d8eb478dcd2574'],11,11,22,924458,1,1,1,0,1951
2acf41fd1e5e3c86a9b377c407f8aee2b7be53a0,1,nixonrodrigues,2017-09-12 19:02:54+05:18,['d603afa2708948d6d33478baf05b5adca2089149'],3,15,18,924476,2,1,1,1,1951
636a6213745f3abf039253b9ff96d6b5a9461dbf,1,ashutoshm,2017-09-12 20:26:29-07:00,['2acf41fd1e5e3c86a9b377c407f8aee2b7be53a0'],2,6,8,924484,1,1,1,1,1951
8348f2212187750a20fee7bb4ebe0c1d739d6cc0,1,Madhan Neethiraj,2017-09-13 01:26:07-07:00,['636a6213745f3abf039253b9ff96d6b5a9461dbf'],28,143,171,924655,7,1,1,0.54,1953
1dc7f54999952d18a677a3bc60f437071764cc16,1,Madhan Neethiraj,2017-09-13 11:39:50-07:00,['8348f2212187750a20fee7bb4ebe0c1d739d6cc0'],98,280,378,925033,5,0.131386861,0.131386861,0.846715328,1953
8eb9c95677c0466835fc5aa6cbcfa630616cbd3b,1,ashutoshm,2017-09-13 19:06:04-07:00,['1dc7f54999952d18a677a3bc60f437071764cc16'],8,13,21,925054,3,0,0,0,1953
13fed7a9d746a7f28d6ed6f930b4e6497f9317c1,1,Madhan Neethiraj,2017-09-13 22:34:40-07:00,['8eb9c95677c0466835fc5aa6cbcfa630616cbd3b'],8,23,31,925085,1,1,1,1,1953
a785e935dc77234f783013f51ff23d8c9f0eca59,0,Madhan Neethiraj,2017-09-14 12:07:04-07:00,['13fed7a9d746a7f28d6ed6f930b4e6497f9317c1'],1,29,30,925115,1,0,0,1,1953
d1c585a22c4c1abd866e553480efbd21f9cffcd0,1,Madhan Neethiraj,2017-09-14 12:51:55-07:00,['a785e935dc77234f783013f51ff23d8c9f0eca59'],33,96,129,925244,1,0.125,0.125,1,1953
6e56185209297e20169520f076f9eb3581abad89,0,Madhan Neethiraj,2017-09-14 13:45:07-07:00,['d1c585a22c4c1abd866e553480efbd21f9cffcd0'],0,25,25,925269,1,0.882352941,0,0.882352941,1953
586b5eb209d146397dc05b5af44716c877d56c2a,0,David Radley,2017-09-15 09:29:45+01:00,['6e56185209297e20169520f076f9eb3581abad89'],22,603,625,925894,14,0.256637168,0.867256637,0.973451327,1953
979200e7b7ed29d66b43d071d8df0c803e0edf27,0,David Radley,2017-09-15 10:32:46+01:00,['586b5eb209d146397dc05b5af44716c877d56c2a'],6,68,74,925968,3,0.24,0.84,0.76,1953
3440240e51a5e4105021ea741be8af15cd1dce88,1,kevalbhatt,2017-09-15 19:46:00+05:18,['979200e7b7ed29d66b43d071d8df0c803e0edf27'],29,53,82,926050,4,0,1,1,1953
f1c464663ff86a4b7913d4e8a8d1547602d44b76,1,Madhan Neethiraj,2017-09-15 08:16:04-07:00,['3440240e51a5e4105021ea741be8af15cd1dce88'],1489,1712,3201,929251,61,0,0.953488372,1,1955
c623835f5376bdb04797ba9cb886da70fbef0f8c,1,Madhan Neethiraj,2017-09-15 08:17:40-07:00,['f1c464663ff86a4b7913d4e8a8d1547602d44b76'],178,258,436,929687,7,0,0,1,1957
45b84fa201bdd63cc36094613d33b16741e4fb7a,1,Madhan Neethiraj,2017-09-15 10:39:42-07:00,['c623835f5376bdb04797ba9cb886da70fbef0f8c'],4,4,8,929695,2,0,0,1,1957
d67b0498edf907ea7370247447b7e86d46645c2a,1,Madhan Neethiraj,2017-09-17 11:24:26-07:00,['45b84fa201bdd63cc36094613d33b16741e4fb7a'],46,50,96,929791,7,1,0.666666667,0.333333333,1957
ccd121e74204e1d85001be62abf09446d879889d,1,Madhan Neethiraj,2017-09-17 14:47:29-07:00,['d67b0498edf907ea7370247447b7e86d46645c2a'],88,1579,1667,931458,28,0.884808013,0.851419032,0.976627713,1968
c1f4007a9d9f85f888a5c9164e11937025157edb,1,Madhan Neethiraj,2017-09-17 14:51:49-07:00,['ccd121e74204e1d85001be62abf09446d879889d'],13,10,23,931481,3,1,1,0,1968
2bcbd259e6f01ba0cde9852f251b70a4805d19ba,0,Sarath Subramanian,2017-09-18 11:57:29-07:00,['c1f4007a9d9f85f888a5c9164e11937025157edb'],1,2,3,931484,1,,,,1968
1dee77afc5262755880d80e0c82c5fa9dce2f2ff,0,Madhan Neethiraj,2017-09-18 17:43:33-07:00,['2bcbd259e6f01ba0cde9852f251b70a4805d19ba'],38,25,63,931547,7,1,0,0,1968
67c04c63e1126791ab8537e2a8e8411f0b9e6897,1,Madhan Neethiraj,2017-09-18 22:22:15-07:00,['1dee77afc5262755880d80e0c82c5fa9dce2f2ff'],10,53,63,931610,2,0.3,0.9,0.9,1968
400477c419eb87c1f4678f7aa3dc1b4d4bda6b2f,1,Madhan Neethiraj,2017-09-19 17:44:07-07:00,['67c04c63e1126791ab8537e2a8e8411f0b9e6897'],69,215,284,931894,9,0.579545455,0.772727273,0.579545455,1968
c0f0abc13037a9d05499dbce2d0e1b65beb9d656,1,Madhan Neethiraj,2017-09-19 21:13:40-07:00,['400477c419eb87c1f4678f7aa3dc1b4d4bda6b2f'],9,18,27,931921,2,0,0,1,1968
ae576650c7af86ca8489a077596d3388d5ea2558,1,Madhan Neethiraj,2017-09-20 12:45:43-07:00,['c0f0abc13037a9d05499dbce2d0e1b65beb9d656'],52,778,830,932751,20,0.651340996,0.852490421,1,1974
baccd1d8d768cc9e4650c3b39383c304e936e503,1,Madhan Neethiraj,2017-09-21 13:38:22-07:00,['ae576650c7af86ca8489a077596d3388d5ea2558'],30,63,93,932844,1,0.347826087,0.347826087,0,1974
9d01689d326f938443de715a090afe26f6df1300,1,Sarath Subramanian,2017-09-21 16:58:17-07:00,['baccd1d8d768cc9e4650c3b39383c304e936e503'],1,1,2,932846,1,,,,1974
f90cca9dac46fbfb4486b735818c36d13895cdb9,1,kevalbhatt,2017-09-22 18:40:24+05:18,['9d01689d326f938443de715a090afe26f6df1300'],2,6,8,932854,1,0,0,1,1974
f75871f4563fa91e74863602786b9669a8aff495,0,kevalbhatt,2017-09-22 18:40:43+05:18,['f90cca9dac46fbfb4486b735818c36d13895cdb9'],2,6,8,932862,2,,,,1974
30138316734373b83f9fb1cdb59857bbfa6bb9fa,1,kevalbhatt,2017-09-22 18:40:56+05:18,['f75871f4563fa91e74863602786b9669a8aff495'],3,21,24,932886,3,0.333333333,0.333333333,1,1974
454eb66a3a5d877ca495a5b048d1f5d064c1f6b3,0,kevalbhatt,2017-09-22 18:47:29+05:18,['30138316734373b83f9fb1cdb59857bbfa6bb9fa'],1,1,2,932888,1,,,,1974
20f2fba7e3a79e1d3baacdb1b97d1b37acc39c95,1,Madhan Neethiraj,2017-09-22 07:13:06-07:00,['454eb66a3a5d877ca495a5b048d1f5d064c1f6b3'],166,201,367,933255,9,0,0.869565217,1,1975
d6d349e5e11d5dad4c888dc182fbf1daddf80761,1,Madhan Neethiraj,2017-09-22 15:16:25-07:00,['20f2fba7e3a79e1d3baacdb1b97d1b37acc39c95'],28,376,404,933659,18,0.642424242,0.957575758,0.915151515,1978
a9ca60e3854ab0f07d744560dd7cd8d3a39589ac,0,Madhan Neethiraj,2017-09-22 15:56:31-07:00,['d6d349e5e11d5dad4c888dc182fbf1daddf80761'],1,1,2,933661,1,,,,1978
7cce1c4af84001c79b7e0d9ad2e566b8cbaf7ccb,0,Madhan Neethiraj,2017-09-22 16:37:52-07:00,['a9ca60e3854ab0f07d744560dd7cd8d3a39589ac'],82,193,275,933936,7,1,1,1,1978
944a99b550091f2b09fab163b1a42133f1b9ce33,1,Madhan Neethiraj,2017-09-22 18:11:39-07:00,['7cce1c4af84001c79b7e0d9ad2e566b8cbaf7ccb'],5,121,126,934062,2,0.081395349,0,1,1978
6a64cd9c284d3bdf5bdd9100c3d6580e74187c41,0,Madhan Neethiraj,2017-09-22 18:18:42-07:00,['944a99b550091f2b09fab163b1a42133f1b9ce33'],5,10,15,934077,1,0,0,0,1978
40666d181853f752f2cd4e010104962129369a42,0,Madhan Neethiraj,2017-09-24 14:45:57-07:00,['6a64cd9c284d3bdf5bdd9100c3d6580e74187c41'],16,22,38,934115,1,0.5,0.5,0.625,1978
b78cbe9be55e7df8eec472611659855f22dd4f89,1,Sarath Subramanian,2017-09-25 22:44:52-07:00,['40666d181853f752f2cd4e010104962129369a42'],33,33,66,934181,33,,,,1978
24d8d186251780b4e13607047098c678426c84ea,1,kevalbhatt,2017-09-26 18:14:17+05:18,['b78cbe9be55e7df8eec472611659855f22dd4f89'],10,11,21,934202,1,0,0,1,1978
6426e9df2742e4670a47e087b1a418efdb2e8994,0,kevalbhatt,2017-09-26 18:14:21+05:18,['24d8d186251780b4e13607047098c678426c84ea'],8,12,20,934222,1,,,,1978
234b3005abc1876e4eb03ff767601f9097d14a22,1,kevalbhatt,2017-09-26 18:14:25+05:18,['6426e9df2742e4670a47e087b1a418efdb2e8994'],7,15,22,934244,4,0,0,0,1978
9e59fabe39368414517c82cdc5da78772f1d97af,0,Madhan Neethiraj,2017-09-26 13:32:39-07:00,['234b3005abc1876e4eb03ff767601f9097d14a22'],10,12,22,934266,1,0,0,1,1978
aaeddd38730ed0ddb69b8ea4712082994a86e403,0,Madhan Neethiraj,2017-09-26 13:36:27-07:00,['9e59fabe39368414517c82cdc5da78772f1d97af'],4,5,9,934275,2,0,1,1,1978
049c5120e19bd12ff16142da2d0c6fd609e492d7,1,Madhan Neethiraj,2017-09-26 16:11:12-07:00,['aaeddd38730ed0ddb69b8ea4712082994a86e403'],1,136,137,934412,8,0,0.987804878,0.792682927,1978
187730dd745f5f558e00393e28b919963c24bf08,1,Madhan Neethiraj,2017-09-26 18:25:59-07:00,['049c5120e19bd12ff16142da2d0c6fd609e492d7'],678,903,1581,935993,60,0,0.2,0,1984
5746ec9d0b91287328b349ad675092b52a125629,0,apoorvnaik,2017-09-27 09:13:27-07:00,['187730dd745f5f558e00393e28b919963c24bf08'],0,45,45,936038,4,,,,1984
f5508315a6b7758fd994eb0766fc11b89db2d715,1,Madhan Neethiraj,2017-09-29 00:02:50-07:00,['5746ec9d0b91287328b349ad675092b52a125629'],48,113,161,936199,2,0.5,0.517857143,0.517857143,1984
d7acdba7c949c08b2320be95de97d9c35d41a386,0,Madhan Neethiraj,2017-09-29 00:10:41-07:00,['f5508315a6b7758fd994eb0766fc11b89db2d715'],6,8,14,936213,2,,,,1984
f18555cdd579857e679e158adfc922cb2c16af26,0,Sarath Subramanian,2017-09-29 15:36:12-07:00,['d7acdba7c949c08b2320be95de97d9c35d41a386'],3,4,7,936220,1,,,,1984
57fbb9cea1592a85b59a02b6a672bab43092f1d3,1,Sarath Subramanian,2017-09-29 16:53:38-07:00,['f18555cdd579857e679e158adfc922cb2c16af26'],135,222,357,936577,3,0.079365079,0.650793651,0.80952381,1984
3af543640c944dc98cdc3334588a2ffc5a12e34c,0,apoorvnaik,2017-09-29 18:37:04-07:00,['57fbb9cea1592a85b59a02b6a672bab43092f1d3'],10,27,37,936614,3,0.230769231,0.230769231,0.538461538,1984
d541a378678c1fc2b9640a65d38f5d9bec20cf14,0,Madhan Neethiraj,2017-09-30 04:57:34-07:00,['3af543640c944dc98cdc3334588a2ffc5a12e34c'],238,803,1041,937655,19,0.575851393,0.575851393,0.922600619,1987
05514255c6fcb988b68976b2d2d8be95ac80376e,0,Madhan Neethiraj,2017-09-30 15:12:30-07:00,['d541a378678c1fc2b9640a65d38f5d9bec20cf14'],12,11,23,937678,2,,,,1987
657e0f1272d1361dacee61f3bf328f8a3185cfab,1,apoorvnaik,2017-10-02 09:06:14-07:00,['05514255c6fcb988b68976b2d2d8be95ac80376e'],25,51,76,937754,9,0.571428571,1,0.571428571,1987
70f2ee3a153906aa71e297fb76737dc20ae3ce73,1,kevalbhatt,2017-10-03 19:30:21+05:18,['657e0f1272d1361dacee61f3bf328f8a3185cfab'],28,26,54,937808,2,,,,1987
52848ab63449608d05367f959da007f562bccd5b,1,Madhan Neethiraj,2017-10-03 08:34:47-07:00,['70f2ee3a153906aa71e297fb76737dc20ae3ce73'],17,30,47,937855,7,1,0,1,1987
fe05e15751dca5dc4b84bccfdb0b1a236f1d65a4,0,Madhan Neethiraj,2017-10-03 08:37:11-07:00,['52848ab63449608d05367f959da007f562bccd5b'],2,10,12,937867,1,0,0.625,1,1987
dd7eb14e47ae999464a4ab07d4e62be6f634e5ae,0,Madhan Neethiraj,2017-10-03 14:47:58-07:00,['fe05e15751dca5dc4b84bccfdb0b1a236f1d65a4'],9,9,18,937885,1,,,,1987
4fe70de83dcbca883b119dc6a7d08ede4dede2d6,1,kevalbhatt,2017-10-04 17:12:14+05:18,['dd7eb14e47ae999464a4ab07d4e62be6f634e5ae'],5,12,17,937902,3,0,0,1,1987
9a8c71254c70a0e70241c8b9c8892603ecb03e7c,1,Madhan Neethiraj,2017-10-06 17:53:16-07:00,['4fe70de83dcbca883b119dc6a7d08ede4dede2d6'],26,342,368,938270,11,0.777777778,0.790123457,0.716049383,1989
6a18b5c65257a7905b4a50612e9e2c8978bfaa6d,0,Madhan Neethiraj,2017-10-07 09:28:51-07:00,['9a8c71254c70a0e70241c8b9c8892603ecb03e7c'],1,10,11,938281,1,1,1,1,1989
29465efb337fe3c47131a0853b50650356f01903,1,David Radley,2017-10-09 09:49:42+01:00,['6a18b5c65257a7905b4a50612e9e2c8978bfaa6d'],0,1160,1160,939441,9,,,,1998
e406603a1612eb09806ee1a643032baff465f1bc,1,Madhan Neethiraj,2017-10-09 09:51:34-07:00,['29465efb337fe3c47131a0853b50650356f01903'],3,3,6,939447,1,0,0,1,1998
2ed39cce31358876b1da8ceb9915c9c471c6f401,0,Madhan Neethiraj,2017-10-09 09:56:42-07:00,['e406603a1612eb09806ee1a643032baff465f1bc'],20,34,54,939501,7,1,1,1,1998
943eb2bb01d8a2b7c59eef49ea7559b176102087,1,Madhan Neethiraj,2017-10-10 16:43:16-07:00,['2ed39cce31358876b1da8ceb9915c9c471c6f401'],2,12,14,939515,1,1,1,1,1998
701b011228fa6fc45cc3d06458f028660b9012d7,1,David Radley,2017-10-11 11:09:30+02:00,['943eb2bb01d8a2b7c59eef49ea7559b176102087'],0,1433,1433,940948,8,,,,2006
4bf2ebb4b4e8d982739d5f6f1f087989104f00c9,0,David Radley,2017-10-11 13:25:49+02:00,['701b011228fa6fc45cc3d06458f028660b9012d7'],1,1,2,940950,1,,,,2006
f5dd2f07893918a601c58e114f91bc0aac709fb3,1,kevalbhatt,2017-10-12 18:43:51+05:18,['4bf2ebb4b4e8d982739d5f6f1f087989104f00c9'],346,1321,1667,942617,41,1,0.058823529,1,2022
ea1b981e631e1d093f0df3294d9c4484873ca890,0,apoorvnaik,2017-10-12 10:21:41-07:00,['f5dd2f07893918a601c58e114f91bc0aac709fb3'],3,3,6,942623,1,,,,2022
48feaa3529cdcc29434d6f769c0247cc7d2de7b1,0,Madhan Neethiraj,2017-10-12 17:15:50-07:00,['ea1b981e631e1d093f0df3294d9c4484873ca890'],1,2,3,942626,1,,,,2022
27918145448a3b6bb7b2c7af0add7a875d684d11,1,Madhan Neethiraj,2017-10-13 08:46:00-07:00,['48feaa3529cdcc29434d6f769c0247cc7d2de7b1'],11,36,47,942673,1,0,0,0.416666667,2022
a3bafb1e75a55e894cefc3f995e21ee2ffcb749b,0,apoorvnaik,2017-10-13 13:42:42-07:00,['27918145448a3b6bb7b2c7af0add7a875d684d11'],0,2,2,942675,1,,,,2022
59f83fc0633f52179a48f0cbe70cbab079c63b72,1,apoorvnaik,2017-10-13 13:57:13-07:00,['a3bafb1e75a55e894cefc3f995e21ee2ffcb749b'],130,118,248,942923,5,0,0,0,2022
8663eb1dedfc9f3136ea44460055f7e332e3212c,0,Madhan Neethiraj,2017-10-13 19:35:52-07:00,['59f83fc0633f52179a48f0cbe70cbab079c63b72'],11,21,32,942955,1,0,0,1,2022
32fa4be52b0459209525ab4e7ecc8469f44fb07f,1,Madhan Neethiraj,2017-10-16 08:38:32-07:00,['8663eb1dedfc9f3136ea44460055f7e332e3212c'],4,13,17,942972,2,0.9,0.1,1,2022
96d4d31d0216061846d1fc894763fc50a1aaf8c7,1,Madhan Neethiraj,2017-10-16 09:55:36-07:00,['32fa4be52b0459209525ab4e7ecc8469f44fb07f'],15,8,23,942995,1,0,0,0,2022
a9928f90e14877c1cee81a47e32fb8ff016480f3,0,Madhan Neethiraj,2017-10-17 15:19:05-07:00,['96d4d31d0216061846d1fc894763fc50a1aaf8c7'],0,134,134,943129,1,0.615384615,0.492307692,0.830769231,2023
96da2306df01023ba8bf202368a482ffa59dc4cb,1,Madhan Neethiraj,2017-10-18 12:49:33-07:00,['a9928f90e14877c1cee81a47e32fb8ff016480f3'],10889,11,10900,954029,98,0.58692337,0.051658406,0.115325963,2023
5add1aeb7695436e9039b7628cc6767d70ceb662,0,apoorvnaik,2017-10-19 12:24:58-07:00,['96da2306df01023ba8bf202368a482ffa59dc4cb'],2,2,4,954033,1,,,,2023
3959b318e4cc1e8df26f03a4632cfb6ecd8cb357,1,Madhan Neethiraj,2017-10-20 16:54:11-07:00,['5add1aeb7695436e9039b7628cc6767d70ceb662'],4,67,71,954104,7,1,1,1,2023
c08bac80a8aae344874e7393dd94fa7efece752b,1,apoorvnaik,2017-10-23 12:21:11-07:00,['3959b318e4cc1e8df26f03a4632cfb6ecd8cb357'],27,41,68,954172,1,1,1,1,2023
bd513f259a8b6fbf4191c4245e7dff8107adf7c2,1,apoorvnaik,2017-10-23 16:53:34-07:00,['c08bac80a8aae344874e7393dd94fa7efece752b'],28,792,820,954992,13,0.567567568,0.689189189,0.777027027,2030
749d8bcc21f12793c2686fd3fcb047a694693d45,1,apoorvnaik,2017-10-23 17:42:01-07:00,['bd513f259a8b6fbf4191c4245e7dff8107adf7c2'],157,236,393,955385,1,0.180327869,1,0.147540984,2030
d9b2bd06fb32bc631168a09bac983866564e8dd7,0,apoorvnaik,2017-10-24 00:56:42-07:00,['749d8bcc21f12793c2686fd3fcb047a694693d45'],14,45,59,955444,1,,,,2030
b05b855622166bf98ef6a18198ae94a9414bf21d,1,apoorvnaik,2017-10-24 09:30:32-07:00,['d9b2bd06fb32bc631168a09bac983866564e8dd7'],1,6772,6773,962217,14,0.729387962,0.934749621,0.460546282,2041
a9f4c21ce2f893045f242b2e19dcb82ddecf6c28,1,Sarath Subramanian,2017-10-24 16:34:40-07:00,['b05b855622166bf98ef6a18198ae94a9414bf21d'],2,5,7,962224,3,,,,2042
9370bf75e12a01b0fab13ed843988ff6675be751,1,Sarath Subramanian,2017-10-24 16:35:28-07:00,['a9f4c21ce2f893045f242b2e19dcb82ddecf6c28'],4,4,8,962232,2,,,,2042
ea52e1f33910d687a316cb2f6feaa7e966812393,0,Sarath Subramanian,2017-10-24 16:45:55-07:00,['9370bf75e12a01b0fab13ed843988ff6675be751'],3,0,3,962235,1,,,,2042
5d1868bbfac1fb9abbd6436dcb68d5f75e2cfeeb,1,Madhan Neethiraj,2017-10-25 14:22:31-07:00,['ea52e1f33910d687a316cb2f6feaa7e966812393'],3,13,16,962251,2,0,0.1,1,2042
503dddb8c820ae0dba62d200052262144409d3cf,1,Sarath Subramanian,2017-10-27 14:15:44-07:00,['5d1868bbfac1fb9abbd6436dcb68d5f75e2cfeeb'],483,5030,5513,967764,74,0.533138402,0.840643275,0.846003899,2074
81296b5e7da4cf69b2181a6ad90f0228ae269861,0,Sarath Subramanian,2017-10-27 15:09:37-07:00,['503dddb8c820ae0dba62d200052262144409d3cf'],6,0,6,967770,1,,,,2074
eaad45bda51e1461998a3e9fc015084277e09ec8,1,kevalbhatt,2017-10-30 19:22:32+05:18,['81296b5e7da4cf69b2181a6ad90f0228ae269861'],24,36,60,967830,6,0.75,0.5,1,2074
1e01c01afc8281e5b3f2abacd590c546e169a753,1,kevalbhatt,2017-10-30 19:23:32+05:18,['eaad45bda51e1461998a3e9fc015084277e09ec8'],1,3,4,967834,1,,,,2074
3b597fb5e2a48823ff5bc1e7469de534629c52c5,0,Sarath Subramanian,2017-10-30 17:21:54-07:00,['1e01c01afc8281e5b3f2abacd590c546e169a753'],3,3,6,967840,1,,,,2074
8e40ab15d83c09e3496d5740c31deffdd5c6471f,0,Sarath Subramanian,2017-10-30 17:24:41-07:00,['3b597fb5e2a48823ff5bc1e7469de534629c52c5'],6,6,12,967852,2,1,1,1,2074
091347707eca26213754b7c2e3e4560300ffb825,0,Sarath Subramanian,2017-10-31 15:33:58-07:00,['8e40ab15d83c09e3496d5740c31deffdd5c6471f'],38,50,88,967940,3,,,,2074
c7a61629dd03775804dd7fd62a6a2e0419b4aaf8,0,Sarath Subramanian,2017-10-31 15:37:22-07:00,['091347707eca26213754b7c2e3e4560300ffb825'],20,19,39,967979,3,,,,2074
1869aee3dcf1d5a073c79292fa2442d3f829774c,1,David Radley,2017-11-01 10:44:46+00:00,['c7a61629dd03775804dd7fd62a6a2e0419b4aaf8'],23,11,34,968013,13,,,,2074
3b9ea1dd7e34c3c294c9f03ed7652d137d96096e,1,nixonrodrigues,2017-11-01 18:34:52+05:18,['1869aee3dcf1d5a073c79292fa2442d3f829774c'],2,2,4,968017,1,,,,2074
e9b9513143ee489b0521bf58c42b25d6cbc6866e,1,kevalbhatt,2017-11-01 19:31:20+05:18,['3b9ea1dd7e34c3c294c9f03ed7652d137d96096e'],13,19,32,968049,2,1,1,1,2074
37be53bbb7eec13f8ce57377c8653f482216553f,1,kevalbhatt,2017-11-01 19:31:33+05:18,['e9b9513143ee489b0521bf58c42b25d6cbc6866e'],2660,157,2817,970866,51,0.404160475,0.176077266,0.093610698,2074
af51fbcf2d8c94659ed454d78f1b5551c56d052a,1,kevalbhatt,2017-11-07 16:59:49+05:18,['37be53bbb7eec13f8ce57377c8653f482216553f'],167,1276,1443,972309,8,0.564681725,0.741273101,0.917864476,2077
549310e3fbb73fdd969fe771821ef857246cc385,0,Sarath Subramanian,2017-11-07 11:57:35-08:00,['af51fbcf2d8c94659ed454d78f1b5551c56d052a'],51,0,51,972360,1,1,0,0,2077
c5da0fa1efcfc46775ff7d238154ae71bf05a974,0,Sarath Subramanian,2017-11-08 17:28:20-08:00,['549310e3fbb73fdd969fe771821ef857246cc385'],48,14,62,972422,4,,,,2077
0abf84caaf0b8dd0b4a6e40d3f589a4d05683e57,0,Sarath Subramanian,2017-11-09 13:51:38-08:00,['c5da0fa1efcfc46775ff7d238154ae71bf05a974'],7,7,14,972436,5,,,,2077
435fe3fbad0dbb41297cc7af7986d3062704d7ee,1,Madhan Neethiraj,2017-11-12 10:08:25-08:00,['0abf84caaf0b8dd0b4a6e40d3f589a4d05683e57'],50561,6559,57120,1029556,385,0.573965661,0.217100408,0.164559453,2101
41e5404f96395c8fc3f1f8045ba921f283a49cce,0,Madhan Neethiraj,2017-11-12 14:37:40-08:00,['435fe3fbad0dbb41297cc7af7986d3062704d7ee'],1,2,3,1029559,1,,,,2101
6a1c4f4df2b906673a8cedd6abbd20761fcfb183,0,Madhan Neethiraj,2017-11-12 14:39:13-08:00,['41e5404f96395c8fc3f1f8045ba921f283a49cce'],4,8,12,1029571,1,0,0,0,2101
2b43fd0064e1cf7b4f2b8724e2a502106a567999,1,Sarath Subramanian,2017-11-14 15:43:10-08:00,['6a1c4f4df2b906673a8cedd6abbd20761fcfb183'],163,259,422,1029993,21,0,0,0.7,2101
2bc6f9076e91143975051c31ddcb5b44a656674a,1,Madhan Neethiraj,2017-11-17 08:43:11-08:00,['2b43fd0064e1cf7b4f2b8724e2a502106a567999'],66,3811,3877,1033870,61,0.709876543,1,1,2124
b57d16ca2d6648384c2057649eb7173d2be2bb64,0,Madhan Neethiraj,2017-11-17 08:44:10-08:00,['2bc6f9076e91143975051c31ddcb5b44a656674a'],2,0,2,1033872,1,,,,2124
a5dbd157e9450e98abd93892258860b0e3a73c83,0,Madhan Neethiraj,2017-11-17 09:03:10-08:00,['b57d16ca2d6648384c2057649eb7173d2be2bb64'],5,5,10,1033882,1,,,,2124
a74f1b335a638ed2262aeb7b3279f62b79ca6d51,1,Madhan Neethiraj,2017-11-17 11:43:03-08:00,['a5dbd157e9450e98abd93892258860b0e3a73c83'],387,457,844,1034726,74,,,,2124
12d83b5bd52fe1314004188475b59cc945bcd6d1,0,Madhan Neethiraj,2017-11-17 13:54:45-08:00,['a74f1b335a638ed2262aeb7b3279f62b79ca6d51'],3,7,10,1034736,2,,,,2124
6dea2e4f6318911328ff5d1edc52f66521826d6f,0,Madhan Neethiraj,2017-11-17 16:35:49-08:00,['12d83b5bd52fe1314004188475b59cc945bcd6d1'],1,1,2,1034738,1,,,,2124
0765d57966ddc5a9f5876b1dae039a8584e7c2fa,1,Sarath Subramanian,2017-11-17 18:18:42-08:00,['6dea2e4f6318911328ff5d1edc52f66521826d6f'],16,83,99,1034837,6,0.65,0.675,0.95,2124
4a8777b40e641584c088e6e9bc14145f72f681c0,0,Madhan Neethiraj,2017-11-20 09:58:29-08:00,['0765d57966ddc5a9f5876b1dae039a8584e7c2fa'],6,3,9,1034846,5,,,,2124
f5c5971032143f864268b8476b528ce89abf1b98,0,Sarath Subramanian,2017-11-20 19:43:11-08:00,['4a8777b40e641584c088e6e9bc14145f72f681c0'],0,41,41,1034887,4,,,,2124
a7e89196fe7f084cdc5a6e57916bb64ef1d6b466,1,Madhan Neethiraj,2017-11-25 23:02:38-08:00,['f5c5971032143f864268b8476b528ce89abf1b98'],6,24,30,1034917,2,0,0,1,2124
9bf0d12ebce3489e08c5d18c6df678dd09fc5d4d,0,Madhan Neethiraj,2017-11-28 07:07:16-08:00,['a7e89196fe7f084cdc5a6e57916bb64ef1d6b466'],0,5,5,1034922,1,,,,2124
92f3d4498c9f8d2825ab358f48b6cee9b7cdde8b,1,Madhan Neethiraj,2017-11-28 12:02:43-08:00,['9bf0d12ebce3489e08c5d18c6df678dd09fc5d4d'],9,20,29,1034951,2,1,0,0.428571429,2124
dae1dd9d3be500a95d694d7f3c26d0f743e4e199,0,Madhan Neethiraj,2017-11-28 17:17:37-08:00,['92f3d4498c9f8d2825ab358f48b6cee9b7cdde8b'],2,2,4,1034955,1,,,,2124
0ddc022fe95eca6dbb411b81ed19cc9100c00e00,0,Madhan Neethiraj,2017-11-30 09:35:39-08:00,['dae1dd9d3be500a95d694d7f3c26d0f743e4e199'],0,8,8,1034963,1,0,0,1,2124
3205ca4af5f067e6d7bf1fc166f10d204b750e23,0,Sarath Subramanian,2017-11-30 13:25:09-08:00,['0ddc022fe95eca6dbb411b81ed19cc9100c00e00'],53,11,64,1035027,6,,,,2124
3ee4f25355be771e70fe714a519c375f5e676a60,1,Madhan Neethiraj,2017-11-30 19:26:33-08:00,['3205ca4af5f067e6d7bf1fc166f10d204b750e23'],303,404,707,1035734,10,1,0.363636364,1,2125
d991222dc0517791df5a7e21a3193496895769db,1,Madhan Neethiraj,2017-11-30 22:45:00-08:00,['3ee4f25355be771e70fe714a519c375f5e676a60'],1,1,2,1035736,1,,,,2125
12622e020c8c486ef5b927aa32be9e897966b166,1,Madhan Neethiraj,2017-11-30 23:09:10-08:00,['d991222dc0517791df5a7e21a3193496895769db'],0,13,13,1035749,1,,,,2125
1e75da0d2787b032390360acf05fdbb5af97e2fc,1,Madhan Neethiraj,2017-12-01 08:21:11-08:00,['12622e020c8c486ef5b927aa32be9e897966b166'],30,122,152,1035901,5,0.419354839,0.935483871,0.741935484,2125
d1aa36c46dded79be0197a5c961e393547b1cc68,0,Madhan Neethiraj,2017-12-01 11:31:51-08:00,['1e75da0d2787b032390360acf05fdbb5af97e2fc'],0,4,4,1035905,3,,,,2125
1f8e2146e890fa81235235b9f6e496ce0741aa61,1,Madhan Neethiraj,2017-12-03 00:12:47-08:00,['d1aa36c46dded79be0197a5c961e393547b1cc68'],740,787,1527,1037432,34,1,1,0.409090909,2127
914da6ee8b3cc506e50e52ffd1d8be31ba88ff87,0,Madhan Neethiraj,2017-12-04 07:06:51-08:00,['1f8e2146e890fa81235235b9f6e496ce0741aa61'],2,2,4,1037436,2,,,,2127
eef3c08985ac684746050353de62b72231aee4cd,1,Sarath Subramanian,2017-12-04 08:07:58-08:00,['914da6ee8b3cc506e50e52ffd1d8be31ba88ff87'],0,26,26,1037462,2,,,,2127
d569e538089c37ccd218e975a5c75cc1648212c7,1,kevalbhatt,2017-12-05 14:16:26+05:18,['eef3c08985ac684746050353de62b72231aee4cd'],8,43,51,1037513,6,0.714285714,0.928571429,0.785714286,2127
a6fdfbb75c088d61d4044288e8a9b8f8b03bb94d,1,Madhan Neethiraj,2017-12-05 12:31:44-08:00,['d569e538089c37ccd218e975a5c75cc1648212c7'],20,22,42,1037555,3,0,0,0,2127
1c58f3aae4bef0406c2415a8fc148b3558e02cae,1,Madhan Neethiraj,2017-12-05 15:05:17-08:00,['a6fdfbb75c088d61d4044288e8a9b8f8b03bb94d'],21,91,112,1037667,5,0.418604651,0.418604651,1,2127
7892a331cd665f81ee782d90638cf66ca5bf8617,1,Sarath Subramanian,2017-12-05 19:13:05-08:00,['1c58f3aae4bef0406c2415a8fc148b3558e02cae'],0,4,4,1037671,1,1,1,1,2127
a78b9c0046cd13ac276113e41cbaf70f488e9aa2,0,nixonrodrigues,2017-12-06 18:01:13+05:18,['7892a331cd665f81ee782d90638cf66ca5bf8617'],2,3,5,1037676,1,0,0,0,2127
2b5c0047fbbc7e573f4fdf8b74dccfac231918b2,1,nixonrodrigues,2017-12-06 19:28:50+05:18,['a78b9c0046cd13ac276113e41cbaf70f488e9aa2'],0,5,5,1037681,1,,,,2127
ca04aead3220da83f22c08fab16db9276b3574c0,1,Sarath Subramanian,2017-12-06 10:18:56-08:00,['2b5c0047fbbc7e573f4fdf8b74dccfac231918b2'],1,1,2,1037683,1,,,,2127
69330a5d33c4d0007c4aaa47800f0a9a03427fbb,1,Madhan Neethiraj,2017-12-06 12:46:15-08:00,['ca04aead3220da83f22c08fab16db9276b3574c0'],249,528,777,1038460,33,0.6875,0.696428571,1,2127
f87072f3d2345d28b47878f9fdd69c899568108d,0,Sarath Subramanian,2017-12-06 16:39:04-08:00,['69330a5d33c4d0007c4aaa47800f0a9a03427fbb'],4,9,13,1038473,2,1,1,1,2127
4e1ed9aee42a56349e767b39a77c4c2b4777e6a1,0,Sarath Subramanian,2017-12-06 17:08:40-08:00,['f87072f3d2345d28b47878f9fdd69c899568108d'],113,0,113,1038586,2,0,0,0,2127
1d0a1356500bca57abe5bdf150413b5e556cf614,0,Madhan Neethiraj,2017-12-07 09:24:15-08:00,['4e1ed9aee42a56349e767b39a77c4c2b4777e6a1'],8,8,16,1038602,4,,,,2127
28fb3cc6ec7d6481652eff11d96e271bfbfefed9,0,Madhan Neethiraj,2017-12-07 16:14:40-08:00,['1d0a1356500bca57abe5bdf150413b5e556cf614'],32,7,39,1038641,3,0.047619048,0.047619048,0,2127
667abe4aa04af375e8ebd33e660c6319886ff07f,1,Madhan Neethiraj,2017-12-07 23:06:58-08:00,['28fb3cc6ec7d6481652eff11d96e271bfbfefed9'],2,16,18,1038659,2,0,0,1,2127
b9b3810e99bc2e3123522828a3169b8dc18575d0,1,Madhan Neethiraj,2017-12-08 09:06:48-08:00,['667abe4aa04af375e8ebd33e660c6319886ff07f'],1,1,2,1038661,1,,,,2127
acb34ca7bca092fc6a26b5f516ae66ae0896b24f,1,Madhan Neethiraj,2017-12-11 08:46:03-08:00,['b9b3810e99bc2e3123522828a3169b8dc18575d0'],12,92,104,1038765,6,,,,2128
5ba64a8b34cb5cffb2fdeb76c25f26cf65efb24c,1,Madhan Neethiraj,2017-12-11 17:00:21-08:00,['acb34ca7bca092fc6a26b5f516ae66ae0896b24f'],4644,19,4663,1043428,34,0.449427005,0.142501246,0.158445441,2128
71a30876d74b9e286dc207f1b5c1f70d96a782c2,1,nixonrodrigues,2017-12-12 19:16:08+05:18,['5ba64a8b34cb5cffb2fdeb76c25f26cf65efb24c'],9,16,25,1043453,3,0,1,1,2128
5bd5327c40e6dfc4454c2311165d5ee6b75f109a,1,Madhan Neethiraj,2017-12-12 10:38:36-08:00,['71a30876d74b9e286dc207f1b5c1f70d96a782c2'],128,5993,6121,1049574,24,0.404453807,0.84802889,0.960878724,2142
d1e79fa06c455f161b6dc3bd2c4ffee577e98b37,1,Madhan Neethiraj,2017-12-15 15:02:23-08:00,['5bd5327c40e6dfc4454c2311165d5ee6b75f109a'],1,668,669,1050243,6,0.612,0.84,0.724,2145
f89fa44156d64e86920d66ba776852fc55297e12,1,Madhan Neethiraj,2017-12-17 16:50:16-08:00,['d1e79fa06c455f161b6dc3bd2c4ffee577e98b37'],1,1154,1155,1051398,7,1,1,1,2151
a40f3c2c5234acec5e4566394e748620697ba119,1,Madhan Neethiraj,2017-12-18 09:49:25-08:00,['f89fa44156d64e86920d66ba776852fc55297e12'],10,28,38,1051436,7,1,1,1,2151
728aac65f9e6427d0dc66ec32e197720e5d1d686,0,David Radley,2017-12-19 14:10:10+00:00,['a40f3c2c5234acec5e4566394e748620697ba119'],24,38,62,1051498,2,,,,2151
ac0764beeabb3d7e7f93231c73095c867fb0ec13,1,Madhan Neethiraj,2017-12-19 14:40:57-08:00,['728aac65f9e6427d0dc66ec32e197720e5d1d686'],1307,1450,2757,1054255,15,0.876190476,0.8,0.89047619,2153
faeecf10130bb2745dd41a74feb8709752d15951,1,Madhan Neethiraj,2017-12-20 22:41:36-08:00,['ac0764beeabb3d7e7f93231c73095c867fb0ec13'],5,124,129,1054384,3,0,0,0.079365079,2154
5614bf0d6da416455c366cf44bbaace72b0893b2,1,Madhan Neethiraj,2017-12-20 23:48:55-08:00,['faeecf10130bb2745dd41a74feb8709752d15951'],149,331,480,1054864,5,0.466666667,0.333333333,0.925,2154
db77c65becac07ed0674fa4e6bc050a846991718,1,Madhan Neethiraj,2017-12-21 01:28:46-08:00,['5614bf0d6da416455c366cf44bbaace72b0893b2'],7,245,252,1055116,4,,,,2156
14df38de4a53baa063cdcaf0e299d5fb46dfb7f5,1,Madhan Neethiraj,2017-12-21 10:39:16-08:00,['db77c65becac07ed0674fa4e6bc050a846991718'],3,48,51,1055167,4,0,0,1,2156
247ad8b2620b92d7ca9c99d3f82082e3f60f17d5,1,Madhan Neethiraj,2017-12-21 17:18:09-08:00,['14df38de4a53baa063cdcaf0e299d5fb46dfb7f5'],1,2,3,1055170,1,,,,2156
1e64199b2ca8229f2eab54e37d59d49c1c7d5a1f,1,Madhan Neethiraj,2017-12-21 17:39:42-08:00,['247ad8b2620b92d7ca9c99d3f82082e3f60f17d5'],51,74,125,1055295,6,0,0,1,2156
2a2b07e983851c08f792b72cd5518cb455f59971,0,Madhan Neethiraj,2017-12-22 09:29:08-08:00,['1e64199b2ca8229f2eab54e37d59d49c1c7d5a1f'],6,0,6,1055301,1,,,,2156
5384a74274b435118e0c4d4c521557df0b0f7eef,1,Madhan Neethiraj,2017-12-22 13:52:14-08:00,['2a2b07e983851c08f792b72cd5518cb455f59971'],47,64,111,1055412,4,0.416666667,1,0.5,2156
8db8b5c7c199c25c6d83074940fc3020cd3815d0,1,Madhan Neethiraj,2017-12-23 21:51:34-08:00,['5384a74274b435118e0c4d4c521557df0b0f7eef'],499,435,934,1056346,18,0.081632653,0.428571429,0.897959184,2157
d2244dcb2f116d681c4f97b8b6d1d260cc9d40cc,0,Madhan Neethiraj,2017-12-24 08:36:48-08:00,['8db8b5c7c199c25c6d83074940fc3020cd3815d0'],0,1,1,1056347,1,1,1,1,2157
15c5434d97da13808771d222d7d3c01d63a49f3f,0,Madhan Neethiraj,2017-12-24 08:36:52-08:00,['d2244dcb2f116d681c4f97b8b6d1d260cc9d40cc'],2,2,4,1056351,1,,,,2157
6eff6b67b768e03e6c0a598ba49ab987b9de0db2,1,Madhan Neethiraj,2017-12-30 10:45:21-08:00,['15c5434d97da13808771d222d7d3c01d63a49f3f'],12,16,28,1056379,1,0,0,1,2157
4516418b5c9cd36d1096f1186d43e18746dcc4fe,1,nixonrodrigues,2018-01-03 18:37:34+05:18,['6eff6b67b768e03e6c0a598ba49ab987b9de0db2'],0,29,29,1056408,3,1,1,0.692307692,2157
9abc89bf8f55e073b43b86a7ba5ce6917e2f7a6d,1,nixonrodrigues,2018-01-03 18:37:49+05:18,['4516418b5c9cd36d1096f1186d43e18746dcc4fe'],74,116,190,1056598,6,1,1,0.6,2157
02a618afd16e7b7959140d48e2a12390aa043171,0,nixonrodrigues,2018-01-03 18:38:27+05:18,['9abc89bf8f55e073b43b86a7ba5ce6917e2f7a6d'],0,2,2,1056600,1,1,1,1,2157
716afc53b35624027a1f6788b0d56e6d813012ef,1,Sarath Subramanian,2018-01-03 23:02:38-08:00,['02a618afd16e7b7959140d48e2a12390aa043171'],186,309,495,1057095,22,0.027777778,0.472222222,1,2159
1ff791cfca9c8167db92bbde0ce02969620cdd60,0,Sarath Subramanian,2018-01-04 10:41:57-08:00,['716afc53b35624027a1f6788b0d56e6d813012ef'],21,20,41,1057136,2,0,0,1,2159
38159334645dfcd8b3c948aea18e71cc0d7dfcbc,0,Madhan Neethiraj,2018-01-04 14:15:43-08:00,['1ff791cfca9c8167db92bbde0ce02969620cdd60'],62,188,250,1057386,8,0.014705882,1,0.970588235,2159
3f330194c765cd0fef7e894397ebe9bd2aa5b247,1,Madhan Neethiraj,2018-01-04 14:15:43-08:00,['38159334645dfcd8b3c948aea18e71cc0d7dfcbc'],15,4,19,1057405,1,0.333333333,0.333333333,0.333333333,2159
4353aa919635568e2dceaada12331df6e07b90c8,0,Sarath Subramanian,2018-01-05 13:47:43-08:00,['3f330194c765cd0fef7e894397ebe9bd2aa5b247'],6,26,32,1057437,1,0.857142857,1,1,2159
413aa88e61b899792678135a3c66754be4d93583,0,Sarath Subramanian,2018-01-05 13:49:08-08:00,['4353aa919635568e2dceaada12331df6e07b90c8'],1,1,2,1057439,1,,,,2159
08ac11c091f62ab7e006a0b4491959ebb2949df7,1,Madhan Neethiraj,2018-01-05 23:03:45-08:00,['413aa88e61b899792678135a3c66754be4d93583'],5,38,43,1057482,3,0.333333333,0.333333333,1,2159
df9f5d276286c0b510591e39fb8af2cbdc2ebfbb,1,Madhan Neethiraj,2018-01-07 23:43:39-08:00,['08ac11c091f62ab7e006a0b4491959ebb2949df7'],7,12,19,1057501,2,0,1,0,2159
ab316c9b375931306111c7d075b99ecd50c81803,1,Madhan Neethiraj,2018-01-07 23:54:53-08:00,['df9f5d276286c0b510591e39fb8af2cbdc2ebfbb'],1,1,2,1057503,1,,,,2159
b5989c84435ed6829c2cf48fbcc3efba4814628e,1,apoorvnaik,2018-01-08 11:42:33-08:00,['ab316c9b375931306111c7d075b99ecd50c81803'],632,1224,1856,1059359,17,0.633484163,1,0.925339367,2162
7f7af565eb673486c1a2d0e7b1eb5fb1bb3923ab,0,Madhan Neethiraj,2018-01-08 14:51:41-08:00,['b5989c84435ed6829c2cf48fbcc3efba4814628e'],3,203,206,1059565,8,0.220472441,0.220472441,1,2162
4dc953395abbe6b1b884f5190c5a0c2369377516,0,nixonrodrigues,2018-01-09 14:23:34+05:18,['7f7af565eb673486c1a2d0e7b1eb5fb1bb3923ab'],4,4,8,1059573,2,,,,2162
b51a32db9202873a7c635f7b318ca9718159beee,0,Sarath Subramanian,2018-01-09 09:26:39-08:00,['4dc953395abbe6b1b884f5190c5a0c2369377516'],1,1,2,1059575,1,,,,2162
212417c966ea1812ee80d898ed08dd5c2ee53a49,1,Ashutosh Mestry,2018-01-09 12:47:53-08:00,['b51a32db9202873a7c635f7b318ca9718159beee'],1,1,2,1059577,2,,,,2162
c9303742fad6749803dfc85c5e2a7edbd6250944,1,Ashutosh Mestry,2018-01-09 12:52:06-08:00,['212417c966ea1812ee80d898ed08dd5c2ee53a49'],302,44,346,1059923,4,0.49,0,0,2162
cef91eb84e2952182e211cdd7a368411a8d313af,1,Madhan Neethiraj,2018-01-09 13:22:22-08:00,['c9303742fad6749803dfc85c5e2a7edbd6250944'],132,576,708,1060631,5,0.726457399,0.591928251,0.515695067,2164
74e565446b48b3a87ea9b51096265b00ea5f890b,1,Madhan Neethiraj,2018-01-10 10:08:52-08:00,['cef91eb84e2952182e211cdd7a368411a8d313af'],35,84,119,1060750,11,0.947368421,1,1,2164
f2342f595f7f0d78e28a2ceb97734b40c0b95ef4,0,Sarath Subramanian,2018-01-10 11:04:04-08:00,['74e565446b48b3a87ea9b51096265b00ea5f890b'],4,4,8,1060758,2,,,,2164
5c9259209acc5227762de45014edf27bf8f4097d,0,apoorvnaik,2018-01-10 14:21:02-08:00,['f2342f595f7f0d78e28a2ceb97734b40c0b95ef4'],0,3,3,1060761,1,0,0,1,2164
c6cc3314f234c87f856f928f2bdf1e2a935df5a2,1,apoorvnaik,2018-01-10 14:21:38-08:00,['5c9259209acc5227762de45014edf27bf8f4097d'],19,17,36,1060797,3,1,1,1,2164
9f0866c8a758319bff96b7b281ee05eb31a88d41,1,Madhan Neethiraj,2018-01-10 16:52:11-08:00,['c6cc3314f234c87f856f928f2bdf1e2a935df5a2'],13,8,21,1060818,1,1,1,0,2164
8535e88cd538c8b5ee2e7dbf803358654391d25d,1,Madhan Neethiraj,2018-01-10 17:00:34-08:00,['9f0866c8a758319bff96b7b281ee05eb31a88d41'],103,119,222,1061040,5,1,1,1,2164
b17d0e970b61950d2738ec721fa3a4d5a1e3f3c9,0,Madhan Neethiraj,2018-01-11 07:30:02-08:00,['8535e88cd538c8b5ee2e7dbf803358654391d25d'],0,64,64,1061104,7,,,,2164
a7f3e1ad3c0a452a25ef886c7e259497147c3b2f,0,Madhan Neethiraj,2018-01-11 08:29:40-08:00,['b17d0e970b61950d2738ec721fa3a4d5a1e3f3c9'],46,10,56,1061160,3,,,,2164
c746a0505722adc46c19def24f2fb9c6b76fb367,1,Ashutosh Mestry,2018-01-11 09:39:29-08:00,['a7f3e1ad3c0a452a25ef886c7e259497147c3b2f'],1,7,8,1061168,1,1,1,1,2164
8253653bcadd52e2658749df362cf78616a546e1,1,Ashutosh Mestry,2018-01-11 14:03:30-08:00,['c746a0505722adc46c19def24f2fb9c6b76fb367'],68,128,196,1061364,7,0.68627451,0.705882353,0.294117647,2164
ecf8095ff92252f252e14292bb5d82d7b6aa1951,1,Sarath Subramanian,2018-01-11 14:47:50-08:00,['8253653bcadd52e2658749df362cf78616a546e1'],66,138,204,1061568,10,0,0.571428571,0.857142857,2164
f28d0f54d74a0c6c715d79070986547e6d03d269,1,apoorvnaik,2018-01-11 20:45:32-08:00,['ecf8095ff92252f252e14292bb5d82d7b6aa1951'],176,238,414,1061982,8,1,1,1,2164
8c9d3da2cecccd043dd8257c4102b8b147e4f6b7,1,Sarath Subramanian,2018-01-12 11:18:06-08:00,['f28d0f54d74a0c6c715d79070986547e6d03d269'],44,528,572,1062554,15,,,,2171
d5b438b5db08cc4ecff69912b425104cd7ecd924,0,Madhan Neethiraj,2018-01-12 16:01:11-08:00,['8c9d3da2cecccd043dd8257c4102b8b147e4f6b7'],2,9,11,1062565,1,0,0,1,2171
59c676961bf8aeb31ca2704463ae966665800e6f,0,Madhan Neethiraj,2018-01-12 16:31:22-08:00,['d5b438b5db08cc4ecff69912b425104cd7ecd924'],0,246,246,1062811,6,,,,2176
ba9566e974f6eaf5ad075b6682b54e10902ed0c9,0,Madhan Neethiraj,2018-01-12 17:32:55-08:00,['59c676961bf8aeb31ca2704463ae966665800e6f'],1,1,2,1062813,1,,,,2176
0345cd41a80f45e6b7330749b79a0e4c379768b3,0,Sarath Subramanian,2018-01-12 18:01:06-08:00,['ba9566e974f6eaf5ad075b6682b54e10902ed0c9'],50,630,680,1063493,13,0,0,0,2179
6b4c3aa7eb1a8af53ba910d23784da2d04308398,1,Madhan Neethiraj,2018-01-13 09:08:59-08:00,['0345cd41a80f45e6b7330749b79a0e4c379768b3'],12,56,68,1063561,3,0,0.848484848,1,2179
4c9a3bf7f885bba275d9bef6fc36999fa95705e6,1,Madhan Neethiraj,2018-01-13 12:21:24-08:00,['6b4c3aa7eb1a8af53ba910d23784da2d04308398'],181,318,499,1064060,9,0.460869565,0.226086957,0.756521739,2179
511370530ff34affe9be48466be835c914fc84a8,1,Madhan Neethiraj,2018-01-13 22:01:50-08:00,['4c9a3bf7f885bba275d9bef6fc36999fa95705e6'],318,365,683,1064743,7,0.894736842,0.894736842,1,2180
97e47d24d99456b621b7f8962c47c5e16a5559b1,0,Madhan Neethiraj,2018-01-13 22:47:00-08:00,['511370530ff34affe9be48466be835c914fc84a8'],1,1,2,1064745,1,,,,2180
bbdeaee3f1b0d1adfe00ba7c9832e559192407cf,1,Madhan Neethiraj,2018-01-13 23:50:18-08:00,['97e47d24d99456b621b7f8962c47c5e16a5559b1'],4,3,7,1064752,2,,,,2180
9050e74df13ed4b4c6c7842fa92210b5c1262ee5,1,kevalbhatt,2018-01-15 19:46:05+05:18,['bbdeaee3f1b0d1adfe00ba7c9832e559192407cf'],11,9,20,1064772,2,,,,2180
3689a358292ce6d854b19056bede958d247ce8d3,1,apoorvnaik,2018-01-16 10:42:29-08:00,['9050e74df13ed4b4c6c7842fa92210b5c1262ee5'],221,846,1067,1065839,26,,,,2193
72030ad1bde9e7d00084e9811b6a2051068e0ed2,0,Sarath Subramanian,2018-01-16 13:38:58-08:00,['3689a358292ce6d854b19056bede958d247ce8d3'],30,6,36,1065875,1,,,,2193
7c80aba28bedd2a53aeb7a2f8a4e5ad47b31d06d,0,Sarath Subramanian,2018-01-17 21:28:28-08:00,['72030ad1bde9e7d00084e9811b6a2051068e0ed2'],9,16,25,1065900,1,1,1,1,2193
f1f828fdc58b87cd4fcf51c3c10e9c5a34216a5a,1,Madhan Neethiraj,2018-01-17 21:51:50-08:00,['7c80aba28bedd2a53aeb7a2f8a4e5ad47b31d06d'],0,10,10,1065910,1,1,1,1,2193
74d4827943a3b4e4003f14653c78e487387fa595,0,Sarath Subramanian,2018-01-17 21:56:53-08:00,['f1f828fdc58b87cd4fcf51c3c10e9c5a34216a5a'],0,3,3,1065913,1,0,0,1,2193
bd87c3f624d45e9d6d2080c28197e3e1ab9a4ebc,0,Sarath Subramanian,2018-01-17 21:57:37-08:00,['74d4827943a3b4e4003f14653c78e487387fa595'],2,2,4,1065917,1,,,,2193
39be2ccfdf5ec3edb59d7779e7b3f7d95413b632,1,nixonrodrigues,2018-01-18 18:28:55+05:18,['bd87c3f624d45e9d6d2080c28197e3e1ab9a4ebc'],4,8,12,1065929,1,1,1,1,2193
5c2f7a0c85f8f501a21e70b303ddf0c9d0ee14c8,1,kevalbhatt,2018-01-19 15:43:56+05:18,['39be2ccfdf5ec3edb59d7779e7b3f7d95413b632'],652,464,1116,1067045,14,,,,2193
4c2f7bf203d2e688e4ef80570657ce5a979cf93d,1,Sarath Subramanian,2018-01-19 15:10:23-08:00,['5c2f7a0c85f8f501a21e70b303ddf0c9d0ee14c8'],27,38,65,1067110,5,1,1,0,2193
84f4f1035c25a5adcd9742b3c67cf60062adf8bb,1,Sarath Subramanian,2018-01-22 21:45:22-08:00,['4c2f7bf203d2e688e4ef80570657ce5a979cf93d'],34,80,114,1067224,7,1,1,0.913043478,2193
5900fcb001a9a757dc853eb786638601276b7b99,1,Sarath Subramanian,2018-01-24 16:59:06-08:00,['84f4f1035c25a5adcd9742b3c67cf60062adf8bb'],65,186,251,1067475,8,0.22972973,0.72972973,0.77027027,2193
b7b462e391f18eb8c8326d660bc10ad85dd989af,0,Sarath Subramanian,2018-01-25 10:59:45-08:00,['5900fcb001a9a757dc853eb786638601276b7b99'],1,1,2,1067477,1,,,,2193
5447608bf3fe491fc0219d6731ec55ac0062a176,1,Madhan Neethiraj,2018-01-25 14:36:46-08:00,['b7b462e391f18eb8c8326d660bc10ad85dd989af'],19,70,89,1067566,11,,,,2193
4c4981855aa1c579790a552f6e93f2a0de27cdc3,0,Ashutosh Mestry,2018-01-25 15:12:02-08:00,['5447608bf3fe491fc0219d6731ec55ac0062a176'],2,2,4,1067570,1,,,,2193
1fee4a5b61e219c974deaab15254e41e3fa92624,0,Madhan Neethiraj,2018-01-25 19:21:18-08:00,['4c4981855aa1c579790a552f6e93f2a0de27cdc3'],7,8,15,1067585,1,,,,2193
c35f82ca1a3af5bbb1565afe6b9ff7358ed5c243,1,apoorvnaik,2018-01-25 19:26:09-08:00,['1fee4a5b61e219c974deaab15254e41e3fa92624'],453,686,1139,1068724,12,0.624203822,0.598726115,0.579617834,2194
77dd50c6403cfbf197ee12aaf91e8419bfd528f3,1,Madhan Neethiraj,2018-01-25 20:59:43-08:00,['c35f82ca1a3af5bbb1565afe6b9ff7358ed5c243'],0,18,18,1068742,2,0,0,1,2194
9c8492cb17a50025c8c1239525e9e1ea6a735feb,1,Madhan Neethiraj,2018-01-26 08:07:43-08:00,['77dd50c6403cfbf197ee12aaf91e8419bfd528f3'],214,129,343,1069085,9,0,0,1,2194
809cf0a746e7d3bed1f47ba2580fa6c718b108ff,1,Madhan Neethiraj,2018-01-26 13:49:30-08:00,['9c8492cb17a50025c8c1239525e9e1ea6a735feb'],1,1,2,1069087,1,,,,2194
804c4635e66e05fae627ad1e9344c1b11251ad35,1,apoorvnaik,2018-01-26 15:33:56-08:00,['809cf0a746e7d3bed1f47ba2580fa6c718b108ff'],11,76,87,1069174,4,0.852941176,0.470588235,0.970588235,2194
cbfdd7fcc2ccb011c6f3000e3cb7a9de79268445,0,David Radley,2018-01-27 00:40:56+00:00,['804c4635e66e05fae627ad1e9344c1b11251ad35'],0,14367,14367,1083541,89,0.632956449,0.896566164,0.744556114,2282
d7ac76c481b78730e088f982fd07bb7d22424b64,0,Madhan Neethiraj,2018-01-27 11:51:34-08:00,['cbfdd7fcc2ccb011c6f3000e3cb7a9de79268445'],1,22,23,1083564,1,1,1,1,2282
37b2710725e8744e1af4cfcab33cdd1dd448b67d,1,Sarath Subramanian,2018-01-28 15:45:52-08:00,['d7ac76c481b78730e088f982fd07bb7d22424b64'],239,316,555,1084119,11,0.021276596,0,0,2282
dcdd3d6864479930f3ed9cc471961579d189c940,1,Madhan Neethiraj,2018-01-29 09:44:27-08:00,['37b2710725e8744e1af4cfcab33cdd1dd448b67d'],92,128,220,1084339,5,0.555555556,0,1,2282
a02be15d490939b6a411fede89cd1b1f44696404,1,Madhan Neethiraj,2018-01-29 15:02:23-08:00,['dcdd3d6864479930f3ed9cc471961579d189c940'],223,765,988,1085327,11,0.267123288,0.712328767,0.852739726,2282
76fbe643e50d7adc8d6c21dc7e920a58bfd47488,0,nixonrodrigues,2018-01-30 14:48:54+05:18,['a02be15d490939b6a411fede89cd1b1f44696404'],2,2,4,1085331,1,,,,2282
0a876f933b0463409936e45b25508405ef4c7e02,1,apoorvnaik,2018-01-30 09:41:01-08:00,['76fbe643e50d7adc8d6c21dc7e920a58bfd47488'],198,210,408,1085739,6,1,1,1,2282
bd4a7be91b8c72180551eddc012d57cb040e2469,1,apoorvnaik,2018-01-30 09:41:01-08:00,['0a876f933b0463409936e45b25508405ef4c7e02'],22,32,54,1085793,3,1,1,1,2282
134d60fb2b9ea44accdce685b5051fc54e15a31c,0,apoorvnaik,2018-01-31 13:08:38-08:00,['bd4a7be91b8c72180551eddc012d57cb040e2469'],55,89,144,1085937,1,,,,2282
ba4df832e96f75459a137f83a75d821701b857e6,1,apoorvnaik,2018-01-31 22:15:56-08:00,['134d60fb2b9ea44accdce685b5051fc54e15a31c'],56,62,118,1086055,4,0.833333333,1,1,2282
4e8e9ca87b32986e7a6940d53e49714918320d2f,1,Madhan Neethiraj,2018-02-05 08:34:17-08:00,['ba4df832e96f75459a137f83a75d821701b857e6'],0,3,3,1086058,1,,,,2282
92cdc6a9c2e29c6cdb6ae75614cf13b3fac390e0,1,Ashutosh Mestry,2018-02-05 16:19:15-08:00,['4e8e9ca87b32986e7a6940d53e49714918320d2f'],305,522,827,1086885,5,,,,2284
4582d4a455984962bf46dfbac3e5006172403c05,1,Ashutosh Mestry,2018-02-07 09:42:11-08:00,['92cdc6a9c2e29c6cdb6ae75614cf13b3fac390e0'],7,71,78,1086963,6,0.368421053,0.736842105,0.868421053,2284
ad4db42ef409d4283741906e22b657bab59f3d58,1,Madhan Neethiraj,2018-02-07 20:57:48-08:00,['4582d4a455984962bf46dfbac3e5006172403c05'],2,6,8,1086971,3,0,0,1,2284
e545c9ffdda84f566981e069f84bc4c47f4c3b51,0,Ashutosh Mestry,2018-02-08 11:39:29-08:00,['ad4db42ef409d4283741906e22b657bab59f3d58'],0,0,0,1086971,1,,,,2285
ad6b07a981510408d0627a7260a6de2aae771f57,1,Madhan Neethiraj,2018-02-09 19:18:42-08:00,['e545c9ffdda84f566981e069f84bc4c47f4c3b51'],173,820,993,1087964,20,0.18697479,0.237394958,0.968487395,2285
154dda0e5b03020b405faed8fd37f15654f492f4,1,Madhan Neethiraj,2018-02-11 22:31:36-08:00,['ad6b07a981510408d0627a7260a6de2aae771f57'],375,452,827,1088791,8,0,0.523809524,0.952380952,2285
9cd28bbedd2726187b02c7199ecc0f315f0f7afa,0,Madhan Neethiraj,2018-02-12 20:43:55-08:00,['154dda0e5b03020b405faed8fd37f15654f492f4'],5,11,16,1088807,2,,,,2285
5618ad4ce3b608a5c6ab98dc794d231fb7a3673e,1,Madhan Neethiraj,2018-02-13 14:31:29-08:00,['9cd28bbedd2726187b02c7199ecc0f315f0f7afa'],99,113,212,1089019,1,0.4,0,1,2285
a69496427df2da9f66392b115b8a938fe26f4bf1,1,Madhan Neethiraj,2018-02-13 23:16:47-08:00,['5618ad4ce3b608a5c6ab98dc794d231fb7a3673e'],4,4,8,1089027,1,,,,2285
3635e8e245cfa4a5b74ebdd2d986b45fb96a5680,1,kevalbhatt,2018-02-14 17:55:37+05:18,['a69496427df2da9f66392b115b8a938fe26f4bf1'],4,5,9,1089036,2,0,0,,2285
a0c85e5aa0966303a3dda250956f2528af83678e,1,Madhan Neethiraj,2018-02-14 09:53:09-08:00,['3635e8e245cfa4a5b74ebdd2d986b45fb96a5680'],0,2,2,1089038,1,0,0,1,2285
4119f431ebb7c948fbe6ea031338d918acb30919,0,Madhan Neethiraj,2018-02-14 11:36:42-08:00,['a0c85e5aa0966303a3dda250956f2528af83678e'],0,25,25,1089063,1,1,1,0,2285
3ec37cae8d8297258334f4489605ff44bffd6f5c,1,Madhan Neethiraj,2018-02-14 14:18:06-08:00,['4119f431ebb7c948fbe6ea031338d918acb30919'],11,818,829,1089892,9,0.128378378,0.385135135,0.939189189,2289
a2ccdf12c2b901744aa8b54fe08654d72490b23c,1,Madhan Neethiraj,2018-02-14 15:45:15-08:00,['3ec37cae8d8297258334f4489605ff44bffd6f5c'],69,93,162,1090054,5,0,1,1,2289
19d67a13206a68c49ce92926f9513e833c423c83,1,Madhan Neethiraj,2018-02-14 16:25:04-08:00,['a2ccdf12c2b901744aa8b54fe08654d72490b23c'],0,239,239,1090293,2,0,0,0.4,2290
340f8637ded4789be2620d7fdbfde7edf6ffcee2,0,nixonrodrigues,2018-02-15 12:26:38+05:18,['19d67a13206a68c49ce92926f9513e833c423c83'],3,8,11,1090304,2,0,0,1,2290
4152bc6d5247e6abf11d9e5d7b34e26f6da3511e,1,Madhan Neethiraj,2018-02-14 23:27:09-08:00,['340f8637ded4789be2620d7fdbfde7edf6ffcee2'],3,77,80,1090384,2,0.957446809,1,1,2290
c2be0646d95b7b38ea3b06382091e0e5bcf9988a,1,Madhan Neethiraj,2018-02-15 16:23:24-08:00,['4152bc6d5247e6abf11d9e5d7b34e26f6da3511e'],9,22,31,1090415,4,0.6,1,0.9,2290
8a57e6571c0079c25c147732ad3a6994be8e14ea,1,David Radley,2018-02-16 09:39:05+00:00,['c2be0646d95b7b38ea3b06382091e0e5bcf9988a'],14,54323,54337,1144752,215,0.454501098,0.820346426,0.624542571,2501
c3a684fd5f5486772ad918e5896a2e27fc8cffb2,0,Madhan Neethiraj,2018-02-16 08:22:49-08:00,['8a57e6571c0079c25c147732ad3a6994be8e14ea'],1,1,2,1144754,1,,,,2501
745b520b25e0f733a7a7c6d8fea49b2a7b1573b8,0,Madhan Neethiraj,2018-02-16 08:27:45-08:00,['c3a684fd5f5486772ad918e5896a2e27fc8cffb2'],1,1,2,1144756,1,,,,2501
3fd57d75309c8dffb070fa5be8ed06932596d6b6,0,Madhan Neethiraj,2018-02-17 12:01:26-08:00,['745b520b25e0f733a7a7c6d8fea49b2a7b1573b8'],1,1,2,1144758,1,,,,2501
92b966573227e85a7739afc6d707d88c1b428607,0,Madhan Neethiraj,2018-02-17 14:49:54-08:00,['3fd57d75309c8dffb070fa5be8ed06932596d6b6'],14,38,52,1144810,2,0,0,0.636363636,2501
9c58d30c7d9ff48307e097bf57cb75d614ab214a,1,Madhan Neethiraj,2018-02-17 15:26:33-08:00,['92b966573227e85a7739afc6d707d88c1b428607'],2,45,47,1144857,1,0,0,0,2501
a3374c747fb900ed44358b8b2c643e439820d2e6,1,Madhan Neethiraj,2018-02-20 15:01:32-08:00,['9c58d30c7d9ff48307e097bf57cb75d614ab214a'],343,2637,2980,1147837,42,0.43956044,0.471062271,0.706959707,2506
48b2eaa99f91ec615f67fcde3183b262c765d698,1,Madhan Neethiraj,2018-02-21 18:04:59-08:00,['a3374c747fb900ed44358b8b2c643e439820d2e6'],10,202,212,1148049,6,0.711340206,0.907216495,0.907216495,2507
d74f0ce9da0960192c9a7bae9e2e42f82a038a76,0,Madhan Neethiraj,2018-02-21 19:44:37-08:00,['48b2eaa99f91ec615f67fcde3183b262c765d698'],50,54,104,1148153,3,0,1,1,2507
5e496e5e1daab6e25c0208dbcd17f784cd54e63a,0,Madhan Neethiraj,2018-02-21 20:55:39-08:00,['d74f0ce9da0960192c9a7bae9e2e42f82a038a76'],1,1,2,1148155,1,,,,2507
8d86dd2c61af199045289b6f94ff794ded16d5d3,1,Madhan Neethiraj,2018-02-22 11:45:05-08:00,['5e496e5e1daab6e25c0208dbcd17f784cd54e63a'],27,44,71,1148226,5,0,1,0.888888889,2507
bf4bf7fea74e429473b3f2104f2327d5c93cf414,0,Madhan Neethiraj,2018-02-22 23:59:52-08:00,['8d86dd2c61af199045289b6f94ff794ded16d5d3'],0,5,5,1148231,1,0,0,1,2507
be9b39bf53f0f3951c5c69a8d124c6727573b568,1,Madhan Neethiraj,2018-02-23 15:27:33-08:00,['bf4bf7fea74e429473b3f2104f2327d5c93cf414'],26,80,106,1148337,4,0,0,1,2507
afbc6975b3eb0ece492f26f508792cf363ad2211,1,Madhan Neethiraj,2018-02-26 10:37:47-08:00,['be9b39bf53f0f3951c5c69a8d124c6727573b568'],2599,2101,4700,1153037,72,1,0.532319392,0.33460076,2516
860258d383fd0ef3799b75aa4c9f5c141d25c492,0,apoorvnaik,2018-03-01 06:47:56-08:00,['afbc6975b3eb0ece492f26f508792cf363ad2211'],13,3,16,1153053,2,,,,2516
ff605a20ac61ec987b6f8cfcf3ec2224620faa2b,0,apoorvnaik,2018-03-01 06:47:57-08:00,['860258d383fd0ef3799b75aa4c9f5c141d25c492'],2,42,44,1153097,2,,,,2516
45e38e8526eafe08e4450c4dc07e5be732123670,0,kevalbhatt,2018-03-03 12:26:02+05:18,['ff605a20ac61ec987b6f8cfcf3ec2224620faa2b'],1,1,2,1153099,1,,,,2516
eecff698c04e52387a6e53d90b0c7de43397c6f3,1,Madhan Neethiraj,2018-03-05 07:57:18-08:00,['45e38e8526eafe08e4450c4dc07e5be732123670'],85,470,555,1153654,25,0.695402299,1,0.977011494,2518
6770091aa172576d398e4980f0dacbea65f733ea,1,Madhan Neethiraj,2018-03-05 09:40:23-08:00,['eecff698c04e52387a6e53d90b0c7de43397c6f3'],25,54,79,1153733,7,0.285714286,0.285714286,1,2518
ef36a262a17d7cdc3b255ebb257e61d7726f014c,1,Sarath Subramanian,2018-03-07 21:29:21-08:00,['6770091aa172576d398e4980f0dacbea65f733ea'],45,61,106,1153839,3,0,1,0.5,2518
c8bf6907396c6a95d2879d7b85a19b57c5b6de35,1,nixonrodrigues,2018-03-08 12:08:01+05:18,['ef36a262a17d7cdc3b255ebb257e61d7726f014c'],1,1,2,1153841,1,,,,2518
a6b3521e04c9d65b148500c5858e74027df289c1,0,kevalbhatt,2018-03-08 17:00:53+05:18,['c8bf6907396c6a95d2879d7b85a19b57c5b6de35'],1,2,3,1153844,1,1,1,1,2518
e96b1accc2d2de4c00edb78afefcc66862f48790,1,kevalbhatt,2018-03-08 17:03:09+05:18,['a6b3521e04c9d65b148500c5858e74027df289c1'],9,61,70,1153914,2,,,,2519
8b6715be66e6786b503806a27bfb08c2603c6fb4,0,kevalbhatt,2018-03-08 18:21:36+05:18,['e96b1accc2d2de4c00edb78afefcc66862f48790'],2,4,6,1153920,1,0,0,1,2519
02f382a27c31dd6556dd8dcfe71f5a9ebe92d7ba,1,kevalbhatt,2018-03-08 18:28:12+05:18,['8b6715be66e6786b503806a27bfb08c2603c6fb4'],21,3,24,1153944,1,0,0,0,2519
ec00aed1ee08fc7e0b430a8964b6afa1f86b4d84,1,Madhan Neethiraj,2018-03-09 08:44:42-08:00,['02f382a27c31dd6556dd8dcfe71f5a9ebe92d7ba'],419,730,1149,1155093,23,0.361290323,0.851612903,0.341935484,2519
5ebd7070ec767c0f27ae4240bfd1481190f38d0d,1,Madhan Neethiraj,2018-03-09 15:29:55-08:00,['ec00aed1ee08fc7e0b430a8964b6afa1f86b4d84'],11,29,40,1155133,3,0,0,0,2519
b32e547e4ae5825bcbe31aefa5e87cd9622a7054,0,Madhan Neethiraj,2018-03-11 14:46:06-07:00,['5ebd7070ec767c0f27ae4240bfd1481190f38d0d'],43,73,116,1155249,3,0.409090909,1,0,2519
ebe99f1d210f3cf4fb95d99dbb77ed09fdca782e,0,Madhan Neethiraj,2018-03-11 15:52:38-07:00,['b32e547e4ae5825bcbe31aefa5e87cd9622a7054'],1,1,2,1155251,1,,,,2519
0120003a039b9007b8802432342efd8b6dc1ff60,0,nixonrodrigues,2018-03-12 17:16:22+05:18,['ebe99f1d210f3cf4fb95d99dbb77ed09fdca782e'],12,12,24,1155275,1,,,,2519
2735f96fc70f06eba4672538376c6df8f0dc30dd,1,Madhan Neethiraj,2018-03-12 11:26:28-07:00,['0120003a039b9007b8802432342efd8b6dc1ff60'],178,721,899,1156174,23,0.700315457,0.958990536,0.987381703,2522
8120947b4e0081ae09b5da0fb4732630a6501441,0,nixonrodrigues,2018-03-13 16:46:32+05:18,['2735f96fc70f06eba4672538376c6df8f0dc30dd'],0,6,6,1156180,1,,,,2522
ac2c1a779b24aca4c6cfacbb854cc35219013cbe,1,Madhan Neethiraj,2018-03-13 08:43:59-07:00,['8120947b4e0081ae09b5da0fb4732630a6501441'],19,99,118,1156298,8,0.333333333,0.84057971,1,2522
60789da3b95366a256ae1020241bb9a9ec0817de,0,Madhan Neethiraj,2018-03-13 17:40:40-07:00,['ac2c1a779b24aca4c6cfacbb854cc35219013cbe'],6,26,32,1156330,14,0,1,1,2522
c8b96d339f4d04f6add7cddb5a3e319b762219f5,1,kevalbhatt,2018-03-14 12:19:56+05:18,['60789da3b95366a256ae1020241bb9a9ec0817de'],1,1,2,1156332,1,,,,2522
3b074d9ceb20d512edb04569d9ae54215b94134d,0,Madhan Neethiraj,2018-03-14 00:22:51-07:00,['c8b96d339f4d04f6add7cddb5a3e319b762219f5'],42,6,48,1156380,9,,,,2522
5f71cad0d19dfdaff5ddbaf1d9b29ff32ed60f3e,1,nixonrodrigues,2018-03-16 18:39:07+05:18,['3b074d9ceb20d512edb04569d9ae54215b94134d'],52,45,97,1156477,4,0.727272727,1,1,2522
242733c0b292f729269fe43d26e3189472d04545,1,nixonrodrigues,2018-03-16 18:39:21+05:18,['5f71cad0d19dfdaff5ddbaf1d9b29ff32ed60f3e'],3,15,18,1156495,3,0,1,1,2522
809a99c8a7601b7ede3f6d5da4bfd68d970a38e6,1,nixonrodrigues,2018-03-16 18:39:36+05:18,['242733c0b292f729269fe43d26e3189472d04545'],1,2,3,1156498,2,0,0,0,2522
1927b32b95017ee49629978c85523bd02a0085f9,1,Madhan Neethiraj,2018-03-17 10:21:03-07:00,['809a99c8a7601b7ede3f6d5da4bfd68d970a38e6'],0,7,7,1156505,2,0,0,0,2522
b161859ee9edaf5336a632a5455c933e514b2189,0,Madhan Neethiraj,2018-03-17 10:53:05-07:00,['1927b32b95017ee49629978c85523bd02a0085f9'],0,10,10,1156515,1,1,1,1,2522
dee8a2da438963c4ed535cb3c207165277bb1e4e,1,Madhan Neethiraj,2018-03-17 11:09:04-07:00,['b161859ee9edaf5336a632a5455c933e514b2189'],2,42,44,1156559,2,0.333333333,0,1,2522
6e02ec5b3a97ee2bfaf16ef5e875c14e383d5823,1,Madhan Neethiraj,2018-03-19 12:20:10-07:00,['dee8a2da438963c4ed535cb3c207165277bb1e4e'],2632,3922,6554,1163113,28,0.665835411,0.566084788,1,2533
6ad7a5a86b9877d8f5958d3a6b696b2f07a9282d,0,nixonrodrigues,2018-03-21 20:01:20+05:18,['6e02ec5b3a97ee2bfaf16ef5e875c14e383d5823'],6,8,14,1163127,1,1,1,1,2533
65c6f9c8ed36d77c9a1e673da6e07a066414a1e5,0,nixonrodrigues,2018-03-21 20:01:28+05:18,['6ad7a5a86b9877d8f5958d3a6b696b2f07a9282d'],4,16,20,1163147,1,0.846153846,0.846153846,1,2533
60c05eb753b0437679de3996e512f7378e4d78f1,0,kevalbhatt,2018-03-21 20:17:47+05:18,['65c6f9c8ed36d77c9a1e673da6e07a066414a1e5'],1,1,2,1163149,1,,,,2533
ae23e78369ce765c5353923754374bbd74c1bd47,0,Madhan Neethiraj,2018-03-23 08:33:52-07:00,['60c05eb753b0437679de3996e512f7378e4d78f1'],19,57,76,1163225,8,0.954545455,0.954545455,1,2533
729d92386ed833ef743f1cee707a473fffdcf6c0,1,Madhan Neethiraj,2018-03-23 16:00:39-07:00,['ae23e78369ce765c5353923754374bbd74c1bd47'],23,39,62,1163287,1,0,1,0.846153846,2533
31eb3664ce8722f4323fa4a5369ebec26959aa1f,1,Madhan Neethiraj,2018-03-25 01:24:11-07:00,['729d92386ed833ef743f1cee707a473fffdcf6c0'],5,20,25,1163312,4,0.6,1,0.9,2533
bd39a509a20ff7860fdfdcab67e46cc503038f1e,1,Madhan Neethiraj,2018-03-25 23:37:11-07:00,['31eb3664ce8722f4323fa4a5369ebec26959aa1f'],119,179,298,1163610,4,0.081632653,0.204081633,0.346938776,2533
59673d48ccbaa224fc6129016ed3235f8ea341c5,0,Madhan Neethiraj,2018-03-26 00:17:21-07:00,['bd39a509a20ff7860fdfdcab67e46cc503038f1e'],1,1,2,1163612,1,,,,2533
45d3872b6d5cb58615894541f3ad7f6aa01480b3,1,Sarath Subramanian,2018-03-26 09:19:27-07:00,['59673d48ccbaa224fc6129016ed3235f8ea341c5'],11,33,44,1163656,2,0.083333333,0.083333333,0.083333333,2533
c26e9bcd7427dfb0e7b14714d394de7b4667ace2,1,Madhan Neethiraj,2018-03-26 12:00:54-07:00,['45d3872b6d5cb58615894541f3ad7f6aa01480b3'],8,14,22,1163678,2,,,,2533
14d5a8e6ad7f0dd7edb4f8d95866916abbc6a99d,1,Madhan Neethiraj,2018-03-26 12:02:31-07:00,['c26e9bcd7427dfb0e7b14714d394de7b4667ace2'],31,13,44,1163722,1,1,1,1,2533
67d489530a59e9c55a72621ea0c3a4dfbeac2c8e,0,Sarath Subramanian,2018-03-26 14:55:33-07:00,['14d5a8e6ad7f0dd7edb4f8d95866916abbc6a99d'],24,61,85,1163807,3,0.32,1,1,2533
9931803090d187cb2a92cf88e4d111329121c503,1,Madhan Neethiraj,2018-03-26 17:28:23-07:00,['67d489530a59e9c55a72621ea0c3a4dfbeac2c8e'],0,748,748,1164555,11,0.395,0.68,0.855,2542
0f689faaa5ef6433ecb39d9f0ee8c4cf8a48b8eb,1,Sarath Subramanian,2018-03-26 22:28:39-07:00,['9931803090d187cb2a92cf88e4d111329121c503'],112,306,418,1164973,13,0,0.224806202,0.472868217,2542
295595db4828f4f85977fa809ba53d723d18c668,0,Sarath Subramanian,2018-03-27 10:13:30-07:00,['0f689faaa5ef6433ecb39d9f0ee8c4cf8a48b8eb'],2,4,6,1164979,1,1,1,1,2542
9ffaaabaaf692a07ea74f929515659fa425feff8,0,Madhan Neethiraj,2018-03-28 11:17:22-07:00,['295595db4828f4f85977fa809ba53d723d18c668'],2,15,17,1164996,1,1,1,1,2542
f42c1d9ff3b8bba53431520845ae371361b7e735,1,Madhan Neethiraj,2018-03-29 17:15:48-07:00,['9ffaaabaaf692a07ea74f929515659fa425feff8'],29,69,98,1165094,3,0.291666667,0.291666667,0.958333333,2542
7f5a665e4d93322511813e58fde6175af27834f2,1,Madhan Neethiraj,2018-04-03 18:29:12-07:00,['f42c1d9ff3b8bba53431520845ae371361b7e735'],522,705,1227,1166321,5,0,0.493589744,0.852564103,2543
3ded3ee2f96d4bd44755792436e6c43865821e87,1,Madhan Neethiraj,2018-04-04 17:55:50-07:00,['7f5a665e4d93322511813e58fde6175af27834f2'],134,8008,8142,1174463,47,0.604182226,0.767737117,0.772964899,2567
9368c8a05f34d9bbe4a34cd8aa531bfb36a70a44,1,Madhan Neethiraj,2018-04-05 00:03:36-07:00,['3ded3ee2f96d4bd44755792436e6c43865821e87'],88,7229,7317,1181780,5,1,0,0,2569
da8581e90aca74d1b3b04ee2efd5901b87b8d77d,1,David Radley,2018-04-05 12:17:37+01:00,['9368c8a05f34d9bbe4a34cd8aa531bfb36a70a44'],125,2381,2506,1184286,24,0.539473684,0.964912281,0.754385965,2576
e86fc944edff263c38b17741a68b9966050030af,1,Madhan Neethiraj,2018-04-05 15:14:31-07:00,['da8581e90aca74d1b3b04ee2efd5901b87b8d77d'],1,26,27,1184313,2,1,1,1,2576
519314f0a1911cfd5fc46196e5f031a83c5bb09e,0,Madhan Neethiraj,2018-04-05 16:55:56-07:00,['e86fc944edff263c38b17741a68b9966050030af'],2,6,8,1184321,1,1,1,1,2576
5bccaa64da045bc576d47a1d89ef7c1766128f5f,0,Madhan Neethiraj,2018-04-05 21:33:54-07:00,['519314f0a1911cfd5fc46196e5f031a83c5bb09e'],13,1,14,1184335,2,0.666666667,0.666666667,0.666666667,2576
a70d73f83e38a76e393ab12ab12553159fd9d729,1,nixonrodrigues,2018-04-06 10:43:57+05:18,['5bccaa64da045bc576d47a1d89ef7c1766128f5f'],20,66,86,1184421,2,0,0,1,2576
354162d4e35a69d870a3394f8cc0162d18130efe,0,nixonrodrigues,2018-04-06 10:47:00+05:18,['a70d73f83e38a76e393ab12ab12553159fd9d729'],3,3,6,1184427,1,,,,2576
a1fd406821e1178a7937641386684c46d16ce63e,1,David Radley,2018-04-06 08:56:05+01:00,['354162d4e35a69d870a3394f8cc0162d18130efe'],7724,50304,58028,1242455,210,0.116689223,0.813144984,0.650101506,2628
37d7b8b8f72b906cb2c133f9b3d843009c92e408,0,Madhan Neethiraj,2018-04-06 10:06:23-07:00,['a1fd406821e1178a7937641386684c46d16ce63e'],10,51,61,1242516,1,1,1,1,2628
dc71d3d42fec60c5bd763054591a6c25a1d01862,0,Madhan Neethiraj,2018-04-08 23:44:07-07:00,['37d7b8b8f72b906cb2c133f9b3d843009c92e408'],0,28,28,1242544,1,1,1,1,2628
cd686f6fc97cf2de4fe0c152476444d3544e4dd1,1,kevalbhatt,2018-04-09 14:52:47+05:18,['dc71d3d42fec60c5bd763054591a6c25a1d01862'],6,10,16,1242560,1,1,1,1,2628
d093ed399b2728b8f3fb2c07e63e828d3fd5ea68,0,Ashutosh Mestry,2018-04-09 09:57:50-07:00,['cd686f6fc97cf2de4fe0c152476444d3544e4dd1'],0,1,1,1242561,1,,,,2628
8ef6a4364d51597a0f4e0d36f6713291cc3ce733,0,Ashutosh Mestry,2018-04-09 11:05:27-07:00,['d093ed399b2728b8f3fb2c07e63e828d3fd5ea68'],1,1,2,1242563,1,,,,2628
bc57e15e548af88987ab7d3870aa5ae874c09830,0,Sarath Subramanian,2018-04-09 13:48:02-07:00,['8ef6a4364d51597a0f4e0d36f6713291cc3ce733'],31,25,56,1242619,1,1,1,0,2628
8d1e72234bdf24ba5fef9921dd827823b59884ad,1,Ashutosh Mestry,2018-04-09 14:57:17-07:00,['bc57e15e548af88987ab7d3870aa5ae874c09830'],23,37,60,1242679,4,1,1,1,2628
0cde9f92136979c58ebb0bc282e9f74a247f4b50,1,Sarath Subramanian,2018-04-09 15:10:54-07:00,['8d1e72234bdf24ba5fef9921dd827823b59884ad'],0,5,5,1242684,1,1,1,1,2628
0dcd68906fcdfc9d55069d37800353c497faed7e,1,apoorvnaik,2018-04-09 15:39:32-07:00,['0cde9f92136979c58ebb0bc282e9f74a247f4b50'],7,23,30,1242714,2,0.923076923,0.923076923,0.692307692,2628
6812a7d577556d6b73bfc2d275bc3736d07ecd0d,0,Madhan Neethiraj,2018-04-09 15:45:39-07:00,['0dcd68906fcdfc9d55069d37800353c497faed7e'],4014,0,4014,1246728,26,,,,2628
75415862cc2708ee866d2d29ca603a4e6306f408,1,Madhan Neethiraj,2018-04-09 23:06:36-07:00,['6812a7d577556d6b73bfc2d275bc3736d07ecd0d'],174,6519,6693,1253421,47,0.525903614,0.736445783,0.875,2650
54c31d5c8e601757e19e26d3c30f2414532e2f8f,1,Madhan Neethiraj,2018-04-10 13:48:27-07:00,['75415862cc2708ee866d2d29ca603a4e6306f408'],197,247,444,1253865,3,1,0.933333333,0.7,2650
bf5f8ef05c650f49061d391c5f2606a394370f19,0,apoorvnaik,2018-04-11 13:47:18-07:00,['54c31d5c8e601757e19e26d3c30f2414532e2f8f'],14,1,15,1253880,2,1,1,0,2650
15534f235dea3cc5e993b461b8ee72f3efabee55,0,Ashutosh Mestry,2018-04-11 17:01:59-07:00,['bf5f8ef05c650f49061d391c5f2606a394370f19'],17,50,67,1253947,1,0.130434783,1,1,2650
71965e31a2d50fcddb04e36fd473cc199baa875f,0,Ashutosh Mestry,2018-04-11 17:07:53-07:00,['15534f235dea3cc5e993b461b8ee72f3efabee55'],12,8,20,1253967,1,0,0,0,2650
8ae61e0f5f66a33f1226913d1782413fb9a0bbae,1,Sarath Subramanian,2018-04-11 23:48:22-07:00,['71965e31a2d50fcddb04e36fd473cc199baa875f'],28,203,231,1254198,6,0.445378151,0.680672269,0.966386555,2650
96a348a9a0e43112ca90661baf4b29d5af335506,0,Madhan Neethiraj,2018-04-12 10:00:40-07:00,['8ae61e0f5f66a33f1226913d1782413fb9a0bbae'],0,22,22,1254220,1,0.5,0,0.5,2650
0adfa8f459453b789e55071db2da1758aebd4c0e,1,Madhan Neethiraj,2018-04-12 10:33:31-07:00,['96a348a9a0e43112ca90661baf4b29d5af335506'],1,8,9,1254229,1,0,1,1,2650
79eed8c23ee123f95b596d3ea93ed607a8c450d5,1,Madhan Neethiraj,2018-04-12 10:38:29-07:00,['0adfa8f459453b789e55071db2da1758aebd4c0e'],1,6,7,1254236,1,1,1,1,2650
b7f623663b2d9299956d1a699b16ea38f965d0ff,1,Madhan Neethiraj,2018-04-12 12:33:15-07:00,['79eed8c23ee123f95b596d3ea93ed607a8c450d5'],12,21,33,1254269,3,0.142857143,0,0.571428571,2650
d88223bc1ac62ef29ff4d056ce91aae3215f5ac8,1,Sarath Subramanian,2018-04-12 13:10:08-07:00,['b7f623663b2d9299956d1a699b16ea38f965d0ff'],2,2,4,1254273,1,,,,2650
b1907a332e3cd0eeab0520e1d93cf8605eae4f8c,0,Ashutosh Mestry,2018-04-12 15:40:04-07:00,['d88223bc1ac62ef29ff4d056ce91aae3215f5ac8'],8,12,20,1254293,1,1,1,1,2650
7515915f6b52cdfd0f7e5e32a17f6f6cfae6b37d,1,Madhan Neethiraj,2018-04-13 09:04:56-07:00,['b1907a332e3cd0eeab0520e1d93cf8605eae4f8c'],14,51,65,1254358,2,0.5,0.5,1,2650
15967a9309b1fe8ca3645d82abd4749017c5553a,1,Ashutosh Mestry,2018-04-13 10:28:26-07:00,['7515915f6b52cdfd0f7e5e32a17f6f6cfae6b37d'],155,11104,11259,1265617,39,0.885135135,1,0.936936937,2668
0dad95296daa5ee4ae38904eb211af0165503fb0,1,Madhan Neethiraj,2018-04-15 01:24:45-07:00,['15967a9309b1fe8ca3645d82abd4749017c5553a'],690,1467,2157,1267774,15,0.158181818,0.116363636,0.423636364,2671
f622751dbbc01aab5f0398bfd65674e9bcb92e72,1,Madhan Neethiraj,2018-04-15 01:48:48-07:00,['0dad95296daa5ee4ae38904eb211af0165503fb0'],3,202,205,1267979,5,0.235294118,0.637254902,0.931372549,2672
8063de4ad4d5cc70d15a648080bdc9e5004a1446,1,Sarath Subramanian,2018-04-15 23:33:38-07:00,['f622751dbbc01aab5f0398bfd65674e9bcb92e72'],148,339,487,1268466,7,0.689655172,0.862068966,1,2672
7f20ffbaf4bad3245a547714a8f355f730363cc1,0,Sarath Subramanian,2018-04-16 10:10:43-07:00,['8063de4ad4d5cc70d15a648080bdc9e5004a1446'],4,5,9,1268475,1,,,,2672
4ba39dcad7c9d46f9838aa5aa75162cddc5f2b6a,1,Madhan Neethiraj,2018-04-16 14:18:04-07:00,['7f20ffbaf4bad3245a547714a8f355f730363cc1'],68,587,655,1269130,11,0.870813397,0.866028708,0.928229665,2676
3709842a0711b9aef51c0c6c6727015c63379931,1,Madhan Neethiraj,2018-04-16 14:18:42-07:00,['4ba39dcad7c9d46f9838aa5aa75162cddc5f2b6a'],76,2151,2227,1271357,34,0.665390505,0.881316998,0.941807044,2689
19abdf68ea227cb329ed90228d990cee5a5c16c3,1,Madhan Neethiraj,2018-04-16 14:19:57-07:00,['3709842a0711b9aef51c0c6c6727015c63379931'],4,19,23,1271380,1,1,1,0,2689
8a3795b8297566fd4429a6522379b0a92aae0a90,1,Ashutosh Mestry,2018-04-16 15:41:04-07:00,['19abdf68ea227cb329ed90228d990cee5a5c16c3'],4,23,27,1271407,3,0.642857143,0.642857143,1,2690
9a4ca16d77aabdccc4988146f062933249d6d529,1,Ashutosh Mestry,2018-04-16 21:30:57-07:00,['8a3795b8297566fd4429a6522379b0a92aae0a90'],51,115,166,1271573,6,0.769230769,0.769230769,0.807692308,2690
f57fd7f0f0b5cd5617a897b950030e92b2beb746,1,David Radley,2018-04-17 11:38:31+01:00,['9a4ca16d77aabdccc4988146f062933249d6d529'],3919,30837,34756,1306329,191,0.237232445,0.704280886,0.520277882,2793
710a507de38b4dead7042ac42ec9ef0299ef9959,0,Sarath Subramanian,2018-04-17 14:05:56-07:00,['f57fd7f0f0b5cd5617a897b950030e92b2beb746'],0,0,0,1306329,1,,,,2794
fc17b38eef28afef41d9f5bf87130b79eaec3898,1,Sarath Subramanian,2018-04-17 16:16:03-07:00,['710a507de38b4dead7042ac42ec9ef0299ef9959'],0,594,594,1306923,1,0.510638298,0.951367781,1,2795
6d999b0aa6ded46d678b5880da05b80e37d4b124,1,kevalbhatt,2018-04-18 12:36:12+05:18,['fc17b38eef28afef41d9f5bf87130b79eaec3898'],4,6,10,1306933,2,1,1,1,2795
85aef3c0543632358cb1b01085369bbf31b6404a,1,kevalbhatt,2018-04-18 15:22:19+05:18,['6d999b0aa6ded46d678b5880da05b80e37d4b124'],1,1,2,1306935,1,0,0,0,2795
4a938d873d63280d06678596af0a4f6c3f0a8255,1,apoorvnaik,2018-04-18 07:54:04-07:00,['85aef3c0543632358cb1b01085369bbf31b6404a'],177,201,378,1307313,7,0,0,1,2795
cabc1e55059b70cfab49e1ca960d2cdee6a3828f,1,apoorvnaik,2018-04-18 07:54:58-07:00,['4a938d873d63280d06678596af0a4f6c3f0a8255'],138,278,416,1307729,8,0.5625,1,0.8125,2795
6c49542b8e95b248c4a4062f13e499e2ebea93bf,1,Madhan Neethiraj,2018-04-18 09:43:44-07:00,['cabc1e55059b70cfab49e1ca960d2cdee6a3828f'],20,35,55,1307784,2,0.888888889,0.888888889,0.888888889,2795
d55405955d58417c263d964238c79c981d7fa9fe,1,Ashutosh Mestry,2018-04-18 13:36:58-07:00,['6c49542b8e95b248c4a4062f13e499e2ebea93bf'],1,1,2,1307786,1,,,,2795
b03c248405b51a905a117ab60ab533c3ce892539,0,nixonrodrigues,2018-04-20 00:07:35+05:18,['d55405955d58417c263d964238c79c981d7fa9fe'],5,19,24,1307810,2,0,1,1,2795
fa98991998efa9e18628c76a58ed37f6abbf2e99,1,Sarath Subramanian,2018-04-20 15:14:30-07:00,['b03c248405b51a905a117ab60ab533c3ce892539'],9,16,25,1307835,3,0,0.5,0.166666667,2795
f11c180169b0da1015176126eae6977e9f7cc423,0,Sarath Subramanian,2018-04-20 15:15:58-07:00,['fa98991998efa9e18628c76a58ed37f6abbf2e99'],6,6,12,1307847,1,0,0,1,2795
801aea9a8173a4856ce7f812d6790475d99a3b94,1,Madhan Neethiraj,2018-04-20 16:29:24-07:00,['f11c180169b0da1015176126eae6977e9f7cc423'],1,1077,1078,1308925,10,0.412621359,0.669902913,1,2802
c76afbe26283a887bbec230c17ba12c54480d36f,1,apoorvnaik,2018-04-20 21:09:10-07:00,['801aea9a8173a4856ce7f812d6790475d99a3b94'],136,173,309,1309234,12,0.2,0,0.36,2802
7b14cfac504e2bd0de3ceae6454894e221ccfb97,1,Ashutosh Mestry,2018-04-21 13:56:26-07:00,['c76afbe26283a887bbec230c17ba12c54480d36f'],68,110,178,1309412,12,0.875,0.875,0.625,2802
45bf48e6e549c6f8a377512aa32607021cf927e0,1,Sarath Subramanian,2018-04-23 10:34:51-07:00,['7b14cfac504e2bd0de3ceae6454894e221ccfb97'],48,257,305,1309717,6,0.857894737,1,0.984210526,2802
57c7e85ec126f7f4cb6df0edcd6076dd2266667a,0,apoorvnaik,2018-04-23 12:55:08-07:00,['45bf48e6e549c6f8a377512aa32607021cf927e0'],11,18,29,1309746,1,0,0,0,2802
fe1c7a3b48a751c20e51ee7d97c30da84af21b85,0,Madhan Neethiraj,2018-04-23 17:28:56-07:00,['57c7e85ec126f7f4cb6df0edcd6076dd2266667a'],25,36,61,1309807,1,0,0,0,2802
db6d783a80c2d85597043fcca0f751091c7d52a1,0,apoorvnaik,2018-04-23 23:05:46-07:00,['fe1c7a3b48a751c20e51ee7d97c30da84af21b85'],1,31,32,1309839,3,0,0.75,1,2802
e6625a6c3af827435a786ba3ce8b6ee03ad7a71c,1,Sarath Subramanian,2018-04-24 14:27:10-07:00,['db6d783a80c2d85597043fcca0f751091c7d52a1'],10,29,39,1309878,2,,,,2802
620943ed86bf787a3aa5421809276ba2fac689da,0,Ashutosh Mestry,2018-04-24 23:10:16-07:00,['e6625a6c3af827435a786ba3ce8b6ee03ad7a71c'],1,1,2,1309880,1,,,,2802
c9924fdc7bc9717455e8fb484332a24af062c302,0,Madhan Neethiraj,2018-04-25 10:33:09-07:00,['620943ed86bf787a3aa5421809276ba2fac689da'],0,34,34,1309914,1,,,,2803
540129f5c39181d347a3f85d85715186c8a8f066,0,Madhan Neethiraj,2018-04-25 10:40:36-07:00,['c9924fdc7bc9717455e8fb484332a24af062c302'],5,69,74,1309988,2,,,,2804
65f7da17e444dff86ecbcbcab17251b66c067aa2,1,Ashutosh Mestry,2018-04-25 10:50:20-07:00,['540129f5c39181d347a3f85d85715186c8a8f066'],14,57,71,1310059,4,1,1,0.884615385,2805
30dd2f5b80cab252a217d486558d9384ba3bfeb6,1,Ashutosh Mestry,2018-04-25 16:43:54-07:00,['65f7da17e444dff86ecbcbcab17251b66c067aa2'],11,119,130,1310189,3,0.649350649,0.883116883,0.688311688,2805
2237a895bb259a10440829bd348460b6eb5b7b59,1,Sarath Subramanian,2018-04-25 21:39:19-07:00,['30dd2f5b80cab252a217d486558d9384ba3bfeb6'],253,461,714,1310903,20,0.445255474,0.489051095,1,2805
6d51ddec5b413ec46e45a7fe7e154a4e4db4fb09,1,Madhan Neethiraj,2018-04-26 11:09:03-07:00,['2237a895bb259a10440829bd348460b6eb5b7b59'],403,760,1163,1312066,24,0.327526132,0.407665505,0.979094077,2805
b93c29c39bba308962332a0729494442f3b269f8,1,Sarath Subramanian,2018-04-26 16:33:09-07:00,['6d51ddec5b413ec46e45a7fe7e154a4e4db4fb09'],29,201,230,1312296,5,0.660194175,0.922330097,0.45631068,2805
3f7c5811faa9c9c9b61f9e6760904aeafb221224,0,Madhan Neethiraj,2018-04-26 18:24:08-07:00,['b93c29c39bba308962332a0729494442f3b269f8'],5,46,51,1312347,1,0.038461538,0,0,2805
810aceb5dc212ec68b598227677aa9c5683db8e9,0,Madhan Neethiraj,2018-04-28 12:06:37-07:00,['3f7c5811faa9c9c9b61f9e6760904aeafb221224'],1,30,31,1312378,1,0,1,1,2805
5cfb0228eceae7b626c7ff14d9580d5067056274,0,David Radley,2018-04-30 15:44:14+01:00,['810aceb5dc212ec68b598227677aa9c5683db8e9'],1287,1523,2810,1315188,21,0.576388889,0.597222222,0,2805
b243a3637a460b273d31037cb6f703b2172748dc,0,apoorvnaik,2018-04-30 09:35:27-07:00,['5cfb0228eceae7b626c7ff14d9580d5067056274'],34,81,115,1315303,2,0.111111111,0.888888889,0.666666667,2805
814c1fdb051323fd1c4efaa66c851b3e46b7ef91,0,Sarath Subramanian,2018-04-30 14:27:01-07:00,['b243a3637a460b273d31037cb6f703b2172748dc'],1,1,2,1315305,1,,,,2805
e4205b3b8047ee084419419a6c0b37a3ae9acad3,1,Ashutosh Mestry,2018-04-30 15:20:04-07:00,['814c1fdb051323fd1c4efaa66c851b3e46b7ef91'],19,49,68,1315373,3,0.75862069,0.75862069,0.689655172,2806
e7aec3354168de2720f2435bee3febe002cef5f2,1,Sarath Subramanian,2018-04-30 21:33:51-07:00,['e4205b3b8047ee084419419a6c0b37a3ae9acad3'],3,14,17,1315390,1,1,1,1,2806
20d4f4d8b3089be1922d15a4254ef6ce502cb384,0,Graham Wallis,2018-05-01 14:40:24+01:00,['e7aec3354168de2720f2435bee3febe002cef5f2'],26,718,744,1316134,6,0.047619048,0.557539683,0.966269841,2808
145ba98979f8e6201b83a19283c91c9484d9fb01,0,Graham Wallis,2018-05-01 15:40:03+01:00,['20d4f4d8b3089be1922d15a4254ef6ce502cb384'],1,1,2,1316136,1,,,,2808
efe0935eb2affc2358f4298d20b7c3952cdba20c,0,Graham Wallis,2018-05-01 15:57:37+01:00,['145ba98979f8e6201b83a19283c91c9484d9fb01'],43,4,47,1316183,7,,,,2808
b6bbe7d8a57ded52e9116730d10bb2c1453d413e,0,Sarath Subramanian,2018-05-01 12:30:47-07:00,['efe0935eb2affc2358f4298d20b7c3952cdba20c'],1,9,10,1316193,1,1,1,1,2808
db0f67667c61337d1d34c8d613bce09d0fe9d584,0,Sarath Subramanian,2018-05-01 15:22:39-07:00,['b6bbe7d8a57ded52e9116730d10bb2c1453d413e'],0,6,6,1316199,1,,,,2808
d8d9b127042c67e89b04656574badcf9f7800672,1,apoorvnaik,2018-05-01 15:42:04-07:00,['db0f67667c61337d1d34c8d613bce09d0fe9d584'],151,473,624,1316823,18,0.378109453,0.407960199,0.676616915,2808
57c0cffae9eb918d5ae851f155585085c100b104,0,Ashutosh Mestry,2018-05-01 15:47:16-07:00,['d8d9b127042c67e89b04656574badcf9f7800672'],474,0,474,1317297,3,0.561752988,0,0,2808
11c540d2495e4d7e241341ad17d6c602d01143f4,0,Ashutosh Mestry,2018-05-01 21:22:59-07:00,['57c0cffae9eb918d5ae851f155585085c100b104'],4,2,6,1317303,1,,,,2808
7b694adc15a0446b60e740dbef7d65c6420d938a,1,Sarath Subramanian,2018-05-02 11:20:31-07:00,['11c540d2495e4d7e241341ad17d6c602d01143f4'],75,89,164,1317467,3,0,0,0,2808
e311bdc2a03d4726a303e1c4c2d59b6901b2b469,0,Sarath Subramanian,2018-05-02 13:45:59-07:00,['7b694adc15a0446b60e740dbef7d65c6420d938a'],2,2,4,1317471,1,,,,2808
1e60ca4d98d174e5f000ef9ace38fb32238dd742,1,Ashutosh Mestry,2018-05-02 21:50:46-07:00,['e311bdc2a03d4726a303e1c4c2d59b6901b2b469'],36,126,162,1317633,4,0.507246377,0.985507246,0.623188406,2808
3a002db4df348393aacbf5d49077ede37a6b1095,1,Madhan Neethiraj,2018-05-03 08:22:05-07:00,['1e60ca4d98d174e5f000ef9ace38fb32238dd742'],1,199,200,1317833,4,0.209090909,1,0.5,2808
08c49867480f189d9518e2d90300a36dbd62b7bc,1,Madhan Neethiraj,2018-05-03 09:15:10-07:00,['3a002db4df348393aacbf5d49077ede37a6b1095'],29,67,96,1317929,10,0.483870968,0.225806452,1,2808
4c9d8cba8ce680f7c4f69ad67e56390f33880729,0,Madhan Neethiraj,2018-05-03 09:16:17-07:00,['08c49867480f189d9518e2d90300a36dbd62b7bc'],9,7,16,1317945,1,0,0,1,2808
b7f353b2a458984de30bf8e8cda89427cb524586,0,Ashutosh Mestry,2018-05-03 12:56:14-07:00,['4c9d8cba8ce680f7c4f69ad67e56390f33880729'],0,10,10,1317955,1,,,,2808
8b65aed037d7df30f96151af459f370d6b166c7f,0,Madhan Neethiraj,2018-05-03 14:07:54-07:00,['b7f353b2a458984de30bf8e8cda89427cb524586'],4,4,8,1317963,1,,,,2808
effb7537f06883a868734dd4d25ec97410af60be,0,Sarath Subramanian,2018-05-03 15:24:14-07:00,['8b65aed037d7df30f96151af459f370d6b166c7f'],8697,31,8728,1326691,82,0.524359618,0.268206931,0.186840784,2808
bdf16a5f8fd2daa9084ad0f7b83a9acf414c19fc,0,Sarath Subramanian,2018-05-03 16:13:24-07:00,['effb7537f06883a868734dd4d25ec97410af60be'],2,1,3,1326694,1,,,,2808
967bf67eb6858c91c97b13e2b1c60caa1d51299c,1,Sarath Subramanian,2018-05-04 01:03:44-07:00,['bdf16a5f8fd2daa9084ad0f7b83a9acf414c19fc'],33,97,130,1326824,7,0.041666667,0,0.458333333,2808
015b8bf38f04fdab91afcafb402a68a1a8ff1230,1,Sarath Subramanian,2018-05-04 15:47:46-07:00,['967bf67eb6858c91c97b13e2b1c60caa1d51299c'],1,1,2,1326826,1,,,,2808
f29a2b7bb2b555e68d7f5e2b43221f85877aa39c,1,Ashutosh Mestry,2018-05-04 15:54:17-07:00,['015b8bf38f04fdab91afcafb402a68a1a8ff1230'],5,109,114,1326940,3,0.611940299,0.940298507,0.925373134,2808
1617b6716d66f0876b8c013fddb43abc2c2a91d5,1,Madhan Neethiraj,2018-05-05 11:23:34-07:00,['f29a2b7bb2b555e68d7f5e2b43221f85877aa39c'],35,390,425,1327365,11,1,0.852272727,0.920454545,2811
94d0c0ab21aa139e8c984e7f652f31b141fdbd45,0,apoorvnaik,2018-05-05 13:02:44-07:00,['1617b6716d66f0876b8c013fddb43abc2c2a91d5'],2,2,4,1327369,1,,,,2811
1fc88ce30110729a6a5ad34aaf0c043b5c5969f7,1,apoorvnaik,2018-05-06 16:52:00-07:00,['94d0c0ab21aa139e8c984e7f652f31b141fdbd45'],106,102,208,1327577,18,0,0,1,2811
880ea4b693d79be6072da5e64153e4c97f21ea02,1,Madhan Neethiraj,2018-05-07 10:02:13-07:00,['1fc88ce30110729a6a5ad34aaf0c043b5c5969f7'],365,446,811,1328388,35,,,,2819
bb82e0df3e6aa613b4ded0f6802880f6dfdd4eda,0,Sarath Subramanian,2018-05-07 12:20:17-07:00,['880ea4b693d79be6072da5e64153e4c97f21ea02'],169,6,175,1328563,9,0.96039604,0.514851485,0.702970297,2819
c0bf0b8afa08b73f5052f4a78b0964caac065878,0,Sarath Subramanian,2018-05-07 13:53:27-07:00,['bb82e0df3e6aa613b4ded0f6802880f6dfdd4eda'],2,2,4,1328567,1,,,,2819
3f9fc5c919afde048e32a9b6fbcfe3f61a0d1346,1,apoorvnaik,2018-05-07 18:12:00-07:00,['c0bf0b8afa08b73f5052f4a78b0964caac065878'],20,45,65,1328632,3,0.8,0.8,0.133333333,2819
9e3af41bf87f4c1b1c6181fd28ac219edbf49883,0,apoorvnaik,2018-05-07 18:14:27-07:00,['3f9fc5c919afde048e32a9b6fbcfe3f61a0d1346'],14,31,45,1328677,5,0,0.111111111,0,2819
5fed48d969764ae72e8b87c204a2f481cb089716,0,apoorvnaik,2018-05-08 10:50:44-07:00,['9e3af41bf87f4c1b1c6181fd28ac219edbf49883'],12,35,47,1328724,1,0.666666667,0,0.666666667,2819
570f24231b69b119fd79b8481d65e3e122cdc51f,0,Madhan Neethiraj,2018-05-08 17:03:15-07:00,['5fed48d969764ae72e8b87c204a2f481cb089716'],285,266,551,1329275,19,0,0,1,2819
a8fab3e77fd9374595b08f72d21a06b6543ba28d,1,Madhan Neethiraj,2018-05-09 07:29:00-07:00,['570f24231b69b119fd79b8481d65e3e122cdc51f'],73,254,327,1329602,16,0.669064748,0.834532374,0.928057554,2819
6e7aa6ed312f381c478c9f5e535a7c86ae80d51e,1,Sarath Subramanian,2018-05-09 17:44:47-07:00,['a8fab3e77fd9374595b08f72d21a06b6543ba28d'],720,1281,2001,1331603,13,0.137323944,0.933098592,1,2821
479b9ab1c0d461e89d14d2d3426af64f3cb9acb9,1,apoorvnaik,2018-05-10 07:58:06-07:00,['6e7aa6ed312f381c478c9f5e535a7c86ae80d51e'],19,83,102,1331705,1,0.510638298,0.510638298,1,2821
f85ff28e05f92e75be3d663dd1a8c1c75f6130dd,1,Madhan Neethiraj,2018-05-10 09:16:28-07:00,['479b9ab1c0d461e89d14d2d3426af64f3cb9acb9'],37,453,490,1332195,11,0,0.959459459,0.878378378,2822
f15995cc8471e498e2a86c3e4790889ccccac84e,1,apoorvnaik,2018-05-10 12:10:38-07:00,['f85ff28e05f92e75be3d663dd1a8c1c75f6130dd'],2,20,22,1332217,2,0.2,0.2,1,2822
f62ed0926dc5a116729d4cb4d2f6d97fac3e8232,1,Madhan Neethiraj,2018-05-10 22:54:03-07:00,['f15995cc8471e498e2a86c3e4790889ccccac84e'],7,122,129,1332346,3,0.328767123,0.821917808,0.95890411,2822
b7641e74239f8fcd339b8226f0f40f6d69502b69,0,David Radley,2018-05-14 09:14:07+01:00,['f62ed0926dc5a116729d4cb4d2f6d97fac3e8232'],4,82,86,1332432,4,,,,2824
cbca591dea186b88f752f4b66b7fb27f06477f7e,1,Sarath Subramanian,2018-05-14 08:52:24-07:00,['b7641e74239f8fcd339b8226f0f40f6d69502b69'],140,287,427,1332859,10,0.090909091,1,1,2824
3b75d56d9e151f9ad946da0ff1bb081a784703b7,0,Madhan Neethiraj,2018-05-14 10:04:52-07:00,['cbca591dea186b88f752f4b66b7fb27f06477f7e'],55,69,124,1332983,7,0.066666667,0.266666667,1,2824
fccfe919d49ca39d111ade8bb2f2688db5e854e7,0,Madhan Neethiraj,2018-05-14 18:02:18-07:00,['3b75d56d9e151f9ad946da0ff1bb081a784703b7'],2,5,7,1332990,1,1,1,1,2824
f756e9b36fa27ce6a01e081636884106990e936a,1,Madhan Neethiraj,2018-05-15 08:05:08-07:00,['fccfe919d49ca39d111ade8bb2f2688db5e854e7'],55,255,310,1333300,4,,,,2826
fa712590e929d0c8c3ee7c048687bd1fe4ddd59e,1,Madhan Neethiraj,2018-05-15 08:09:47-07:00,['f756e9b36fa27ce6a01e081636884106990e936a'],11,23,34,1333334,9,0.769230769,0.846153846,1,2826
a6f9b9beda46b388742971ab39e609c18e88e948,0,Sarath Subramanian,2018-05-15 11:07:44-07:00,['fa712590e929d0c8c3ee7c048687bd1fe4ddd59e'],2,2,4,1333338,2,,,,2826
0eaefe38f2c650d098e943dd1614c633f16e7481,1,Sarath Subramanian,2018-05-15 14:16:18-07:00,['a6f9b9beda46b388742971ab39e609c18e88e948'],1,1,2,1333340,1,,,,2826
801db28bf772b111b776a0dda0d305344c2eef4d,0,Sarath Subramanian,2018-05-15 14:24:55-07:00,['0eaefe38f2c650d098e943dd1614c633f16e7481'],26,29,55,1333395,4,,,,2826
66f8ae16045b79d8839ee2088fc5cc64ffa2fa5d,1,apoorvnaik,2018-05-15 21:07:26-07:00,['801db28bf772b111b776a0dda0d305344c2eef4d'],249,522,771,1334166,11,0,0,0.428571429,2826
f65aeceeb97156ff9e26f1352a6da4100845cb7a,0,apoorvnaik,2018-05-15 22:09:51-07:00,['66f8ae16045b79d8839ee2088fc5cc64ffa2fa5d'],6,35,41,1334207,4,,,,2826
024484407290ad664141c1a8c52012c3e7708c3c,0,Sarath Subramanian,2018-05-15 22:34:03-07:00,['f65aeceeb97156ff9e26f1352a6da4100845cb7a'],0,87,87,1334294,10,,,,2835
2ff71e308ed86c44830f9f5dd48bf5450815abc6,1,apoorvnaik,2018-05-15 23:15:58-07:00,['024484407290ad664141c1a8c52012c3e7708c3c'],2,6,8,1334302,2,0,1,1,2835
e48a4864ac3a3f52191a0f3c14e4151e31e75665,1,apoorvnaik,2018-05-15 23:16:51-07:00,['2ff71e308ed86c44830f9f5dd48bf5450815abc6'],1,29,30,1334332,3,0.15,0.15,1,2835
8119492fc6b6475bdb6e09a2e04572c6e185f5f0,0,apoorvnaik,2018-05-15 23:43:01-07:00,['e48a4864ac3a3f52191a0f3c14e4151e31e75665'],16,21,37,1334369,2,0,0,1,2835
4d28dc241568010192f55a3d34cb7f7f1f88a9b2,1,Madhan Neethiraj,2018-05-16 08:36:25-07:00,['8119492fc6b6475bdb6e09a2e04572c6e185f5f0'],3,39,42,1334411,3,0.95,0.35,1,2835
2798234dfb8e7a6781b28cc1dbb8d3547591e336,0,Madhan Neethiraj,2018-05-16 17:11:53-07:00,['4d28dc241568010192f55a3d34cb7f7f1f88a9b2'],52,410,462,1334873,11,1,1,0.822222222,2839
c2d927e0b1a5fb8203d6fea4ded653060cd8acf3,1,Sarath Subramanian,2018-05-16 22:28:40-07:00,['2798234dfb8e7a6781b28cc1dbb8d3547591e336'],24,39,63,1334936,1,0,1,1,2839
8f9813307c79ff27113dca6adb3bf47c51a23fc1,0,Madhan Neethiraj,2018-05-17 07:30:11-07:00,['c2d927e0b1a5fb8203d6fea4ded653060cd8acf3'],1,4,5,1334941,1,0,0,0,2839
e4ffcf248ee066f0c823bca2a65f00bdc3836411,1,Madhan Neethiraj,2018-05-17 09:24:27-07:00,['8f9813307c79ff27113dca6adb3bf47c51a23fc1'],20,221,241,1335182,13,0.5,0.5,0.846153846,2839
6bacbe946bbc5ca72118304770d5ad920695bd52,1,Madhan Neethiraj,2018-05-17 13:14:45-07:00,['e4ffcf248ee066f0c823bca2a65f00bdc3836411'],0,19,19,1335201,3,0.538461538,0.846153846,0.923076923,2839
9044e0375cea58641b0f54c1732980f1401fd845,1,apoorvnaik,2018-05-18 09:48:17-07:00,['6bacbe946bbc5ca72118304770d5ad920695bd52'],9,22,31,1335232,4,0,0.083333333,1,2839
63a0be2621c3bc77ac879f8545e9bc0f3c53bb89,1,Madhan Neethiraj,2018-05-18 10:15:44-07:00,['9044e0375cea58641b0f54c1732980f1401fd845'],10,9,19,1335251,3,1,1,0,2839
4dc6284eb63eb68e3985d1d34542a5ff9818c38b,0,Madhan Neethiraj,2018-05-18 15:20:53-07:00,['63a0be2621c3bc77ac879f8545e9bc0f3c53bb89'],2,2,4,1335255,1,,,,2839
0b9d7113cb83af04f0c093e428494771b1e895b8,0,apoorvnaik,2018-05-18 17:05:07-07:00,['4dc6284eb63eb68e3985d1d34542a5ff9818c38b'],1,5,6,1335261,1,0,0,1,2839
eaf067bc1bfb5797c0396143995b58f959472a41,0,apoorvnaik,2018-05-18 17:14:55-07:00,['0b9d7113cb83af04f0c093e428494771b1e895b8'],16,16,32,1335293,2,0,1,1,2839
026595501fc3de37f3993d4bb9c0e52f0f23c8d9,0,Madhan Neethiraj,2018-05-21 07:02:38-07:00,['eaf067bc1bfb5797c0396143995b58f959472a41'],6,6,12,1335305,2,,,,2839
65338c4ded5fbfe43e7e645b62010b8c4218b8f6,1,Madhan Neethiraj,2018-05-21 07:34:47-07:00,['026595501fc3de37f3993d4bb9c0e52f0f23c8d9'],2,6,8,1335313,2,0,0,1,2839
541c11020c628763b4b2770eb4c1cf0268a783b0,0,Madhan Neethiraj,2018-05-21 15:50:59-07:00,['65338c4ded5fbfe43e7e645b62010b8c4218b8f6'],4,0,4,1335317,1,0,0,0,2839
d218fb4f2fe1551f8f9eb5fba69e38e0d25b10dc,1,apoorvnaik,2018-05-21 18:32:45-07:00,['541c11020c628763b4b2770eb4c1cf0268a783b0'],0,403,403,1335720,28,,,,2865
96e5f1cbda1ce2d645cf4159d0f02051005437a9,1,apoorvnaik,2018-05-22 09:22:22-07:00,['d218fb4f2fe1551f8f9eb5fba69e38e0d25b10dc'],21,42,63,1335783,1,0,0,1,2865
a0269b9ce8c1ebbe056b786f4bc1e3a522ca0e50,0,apoorvnaik,2018-05-22 14:11:26-07:00,['96e5f1cbda1ce2d645cf4159d0f02051005437a9'],41,35,76,1335859,5,1,1,1,2865
47ec9f7a8cc02346ac167849374bf088f55be74a,1,Madhan Neethiraj,2018-05-22 23:04:32-07:00,['a0269b9ce8c1ebbe056b786f4bc1e3a522ca0e50'],737,14029,14766,1350625,46,0.611313869,0.864963504,0.857664234,2884
d343a4860df49e767eeefd46ab5fa2b147cc5cd3,0,Madhan Neethiraj,2018-05-22 23:05:07-07:00,['47ec9f7a8cc02346ac167849374bf088f55be74a'],87,300,387,1351012,9,0.386666667,0.2,0.98,2884
2bb7f778443d3a0fdceb4e5bb7a434f1fd3cdc45,0,Madhan Neethiraj,2018-05-23 00:29:08-07:00,['d343a4860df49e767eeefd46ab5fa2b147cc5cd3'],4,2,6,1351018,1,1,0,0,2884
1616b3f9ea5f22968cf195b3327a59be8d26db64,1,Madhan Neethiraj,2018-05-23 13:27:17-07:00,['2bb7f778443d3a0fdceb4e5bb7a434f1fd3cdc45'],39,58,97,1351115,7,,,,2884
c950c9bdefc258d83dfbaed2087fb3e3cc062e62,0,Madhan Neethiraj,2018-05-23 17:16:21-07:00,['1616b3f9ea5f22968cf195b3327a59be8d26db64'],2,13,15,1351130,2,0.625,0.625,1,2884
bcd5bb60732833f000e8e50f1f16b2cf3dbc32c7,1,apoorvnaik,2018-05-23 19:13:45-07:00,['c950c9bdefc258d83dfbaed2087fb3e3cc062e62'],86,84,170,1351300,5,1,0,0,2884
1deb8c16ec8eca68962eff7f8e4d6dac81fd37aa,1,Sarath Subramanian,2018-05-23 21:38:03-07:00,['bcd5bb60732833f000e8e50f1f16b2cf3dbc32c7'],34,294,328,1351628,14,0.521126761,0.563380282,0.950704225,2884
4c121c4dc6a49a93f3946785da917d4691841136,0,Madhan Neethiraj,2018-05-24 07:46:04-07:00,['1deb8c16ec8eca68962eff7f8e4d6dac81fd37aa'],3,4,7,1351635,3,,0,,2884
633f37b68e0f39a06a4de6b8619d56eb18e32fb1,0,Madhan Neethiraj,2018-05-24 13:43:12-07:00,['4c121c4dc6a49a93f3946785da917d4691841136'],3,67,70,1351705,8,,,,2889
6820cb7859da7ae4d9583de68e5d2df2eb757442,0,Sarath Subramanian,2018-05-24 15:03:13-07:00,['633f37b68e0f39a06a4de6b8619d56eb18e32fb1'],1,23,24,1351729,5,,,,2893
85e08c28b460b2439ef2fe06ee6cfb24d2307b2e,0,Madhan Neethiraj,2018-05-24 16:04:07-07:00,['6820cb7859da7ae4d9583de68e5d2df2eb757442'],0,74,74,1351803,2,,,,2894
3d5b4880f3e3a35e9c441010096ede729204af43,1,apoorvnaik,2018-05-24 20:51:46-07:00,['85e08c28b460b2439ef2fe06ee6cfb24d2307b2e'],484,483,967,1352770,84,,,,2894
84196cfc5cf9ef18db52caa16ebca8542da89acf,1,Ashutosh Mestry,2018-05-24 21:52:40-07:00,['3d5b4880f3e3a35e9c441010096ede729204af43'],0,134,134,1352904,2,,,,2895
54f5e16a74ed83e841c0eb573c79ec5a190e3676,1,Madhan Neethiraj,2018-05-25 07:24:54-07:00,['84196cfc5cf9ef18db52caa16ebca8542da89acf'],110,134,244,1353148,25,0,0,1,2895
9aca852b0b05d7792b420143f64b29c6418e4034,0,Madhan Neethiraj,2018-05-25 08:28:08-07:00,['54f5e16a74ed83e841c0eb573c79ec5a190e3676'],0,0,0,1353148,1,,,,2895
5dfbd08ba60cc191da5adc941f2001fb7d68e30f,1,Madhan Neethiraj,2018-05-25 14:21:17-07:00,['9aca852b0b05d7792b420143f64b29c6418e4034'],0,220,220,1353368,1,,,,2896
76a201708127de1e13d536fe9fba1208dde00ba2,0,Madhan Neethiraj,2018-05-25 18:00:28-07:00,['5dfbd08ba60cc191da5adc941f2001fb7d68e30f'],140,1187,1327,1354695,26,0.574898785,0.886639676,0.842105263,2905
5f503c157cb626b24be99e87648f7efd0d50d2e5,0,Madhan Neethiraj,2018-05-25 23:20:31-07:00,['76a201708127de1e13d536fe9fba1208dde00ba2'],0,597,597,1355292,1,,,,2906
c2df13c5947787f8642c03a1ac3b3d35749adb78,0,Madhan Neethiraj,2018-05-25 23:21:55-07:00,['5f503c157cb626b24be99e87648f7efd0d50d2e5'],0,59,59,1355351,1,,,,2906
82bf78ccacfe10e11b191f225bd184872820b455,0,Madhan Neethiraj,2018-05-25 23:22:30-07:00,['c2df13c5947787f8642c03a1ac3b3d35749adb78'],0,165,165,1355516,1,,,,2906
bb2e57379bd7bfefbecca3b81c72552a49ed1f69,1,Madhan Neethiraj,2018-05-26 17:33:18-07:00,['82bf78ccacfe10e11b191f225bd184872820b455'],104,107,211,1355727,3,,,,2906
f1bfe5644e18ffb54571de3603fc580491a14dd2,1,Madhan Neethiraj,2018-05-29 08:49:40-07:00,['bb2e57379bd7bfefbecca3b81c72552a49ed1f69'],37,107,144,1355871,6,0.065217391,0.065217391,0.97826087,2906
cb2e23b649f2449b19be5c0e7cb5e00452fc9fd6,0,Madhan Neethiraj,2018-05-29 13:08:54-07:00,['f1bfe5644e18ffb54571de3603fc580491a14dd2'],0,205,205,1356076,2,,,,2907
69ea3348670e4f1710dc3661fa24ba072ac272ba,0,Madhan Neethiraj,2018-05-29 23:11:35-07:00,['cb2e23b649f2449b19be5c0e7cb5e00452fc9fd6'],0,2,2,1356078,1,0,1,0,2907
72cc566a7f23bef86c00afb6c7ef136c1d01b424,0,David Radley,2018-05-31 10:09:13+01:00,['69ea3348670e4f1710dc3661fa24ba072ac272ba'],15,87,102,1356180,9,0,0.580645161,0.935483871,2907
52d5e474214041993db50818a8fb3609adf486fb,0,Madhan Neethiraj,2018-05-31 16:23:54-07:00,['72cc566a7f23bef86c00afb6c7ef136c1d01b424'],7,1,8,1356188,1,1,1,0,2907
92f3a91ec56538305043ba0980d3f7a8b477ec96,0,Madhan Neethiraj,2018-05-31 16:32:23-07:00,['52d5e474214041993db50818a8fb3609adf486fb'],1,35,36,1356224,2,0,0,1,2907
870259f42a21a15e48d225f16836fc2e8c30883e,1,Madhan Neethiraj,2018-06-03 19:40:50-07:00,['92f3a91ec56538305043ba0980d3f7a8b477ec96'],3,3,6,1356230,1,,,,2907
c8058eee21d05303b7db061d462d669b7ada416b,1,Madhan Neethiraj,2018-06-03 19:41:00-07:00,['870259f42a21a15e48d225f16836fc2e8c30883e'],7,62,69,1356299,3,,,,2908
78a3cd0a27b36d9fcfc6adbe7e9e5cbf4a92975b,0,Madhan Neethiraj,2018-06-03 19:42:04-07:00,['c8058eee21d05303b7db061d462d669b7ada416b'],5,5,10,1356309,1,,,,2908
c1f56324c34cf77e8a311577e4c1ed3b77164f80,0,Madhan Neethiraj,2018-06-03 23:13:26-07:00,['78a3cd0a27b36d9fcfc6adbe7e9e5cbf4a92975b'],66,66,132,1356441,44,,,,2908
86af9e3b79a261332f6fd6ec47d464e71ffc3ffe,1,Madhan Neethiraj,2018-06-04 17:01:13-07:00,['c1f56324c34cf77e8a311577e4c1ed3b77164f80'],3,4,7,1356448,1,,,,2908
e73a80998ee39aab54eee637aee7ccb99e4156c1,1,Madhan Neethiraj,2018-06-05 07:27:09-07:00,['86af9e3b79a261332f6fd6ec47d464e71ffc3ffe'],3,131,134,1356582,6,0.208955224,0,0.970149254,2908
b57420cd0f4af242caed81d8b69c2438794f1fd9,1,Madhan Neethiraj,2018-06-05 07:28:50-07:00,['e73a80998ee39aab54eee637aee7ccb99e4156c1'],10,21,31,1356613,3,0.416666667,0.416666667,1,2908
f93da20b3fc8a4853c4c7d991cac375cb3a6ad6a,0,Madhan Neethiraj,2018-06-05 07:34:35-07:00,['b57420cd0f4af242caed81d8b69c2438794f1fd9'],13,40,53,1356666,2,,,,2908
595c87808a737374236bc63e0e5ed3c907969f7d,0,Sarath Subramanian,2018-06-05 14:41:48-07:00,['f93da20b3fc8a4853c4c7d991cac375cb3a6ad6a'],1,1,2,1356668,1,,,,2908
ef4044273b28855d1fcd2e67afb50d5dc3c7be34,0,Sarath Subramanian,2018-06-05 19:05:56-07:00,['595c87808a737374236bc63e0e5ed3c907969f7d'],6,6,12,1356680,1,,,,2908
ecc4e4d2ed6442c16fba9598ef2a733113dc247d,0,nixonrodrigues,2018-06-07 18:53:53+05:18,['ef4044273b28855d1fcd2e67afb50d5dc3c7be34'],3,4,7,1356687,1,0,0,1,2908
7a1d3dc5e315d5c82a58bdc67533e7deb324db07,0,apoorvnaik,2018-06-08 09:03:17-07:00,['ecc4e4d2ed6442c16fba9598ef2a733113dc247d'],44,29,73,1356760,3,1,1,0.846153846,2908
9e762c095f00e0d281ebc6f47b951856f3c097b8,0,Sarath Subramanian,2018-06-08 10:40:57-07:00,['7a1d3dc5e315d5c82a58bdc67533e7deb324db07'],2,93,95,1356855,3,0.266666667,0.911111111,1,2908
7174257bf131f531a5f86ccb574ddb512af69623,1,Ashutosh Mestry,2018-06-08 15:01:35-07:00,['9e762c095f00e0d281ebc6f47b951856f3c097b8'],28,62,90,1356945,5,1,,,2909
ce5ffeb710721b78135e8b3c3ebe593bd70d2cdf,0,David Radley,2018-06-09 17:22:19+01:00,['7174257bf131f531a5f86ccb574ddb512af69623'],17,25,42,1356987,1,0,0.6,0.4,2909
fff94633dcd4b80f903fdee0fb86ef021bbb5f5a,0,Sarath Subramanian,2018-06-10 16:55:10-07:00,['ce5ffeb710721b78135e8b3c3ebe593bd70d2cdf'],3,22,25,1357012,1,0.916666667,1,1,2909
cbc4b8a3fea2529c79f3a6addd273feae6c41433,1,nixonrodrigues,2018-06-11 17:28:11+05:18,['fff94633dcd4b80f903fdee0fb86ef021bbb5f5a'],2,13,15,1357027,3,0,0.5,1,2909
d7b4d5852afd7279b9fd3d1ce5aba073680b909b,1,nixonrodrigues,2018-06-13 16:14:57+05:18,['cbc4b8a3fea2529c79f3a6addd273feae6c41433'],1,8,9,1357036,1,0,0,1,2909
399468e6d758550d1af1ad329e9a2bc38a8b17b3,0,Madhan Neethiraj,2018-06-14 10:08:48-07:00,['d7b4d5852afd7279b9fd3d1ce5aba073680b909b'],15,105,120,1357156,2,,,,2909
75da039043f61c33330686e362de5c8c35996906,0,Madhan Neethiraj,2018-06-14 15:21:19-07:00,['399468e6d758550d1af1ad329e9a2bc38a8b17b3'],3,10,13,1357169,1,0,0,1,2909
f787bcc2b00224db35667d77de77d1f7b220631d,0,Madhan Neethiraj,2018-06-18 17:19:07-07:00,['75da039043f61c33330686e362de5c8c35996906'],0,453,453,1357622,2,,,,2911
88ac0fa62186a59ed08a950385c5a1e3c84e517e,1,Madhan Neethiraj,2018-06-19 23:26:04-07:00,['f787bcc2b00224db35667d77de77d1f7b220631d'],17,64,81,1357703,2,0.111111111,0,1,2911
f3f4fbfa4e869424560193a26709c8c6beafbedf,1,kevalbhatt,2018-06-21 18:38:12+05:18,['88ac0fa62186a59ed08a950385c5a1e3c84e517e'],56,80,136,1357839,6,1,1,0.909090909,2911
f37f3de7531d6ea3dcb4a5853ae7d12b5dfd8237,1,nixonrodrigues,2018-06-22 16:56:03+05:18,['f3f4fbfa4e869424560193a26709c8c6beafbedf'],2,6,8,1357847,2,0,0.076923077,1,2911
80f556a704ee21b78598e87de36777f03ebe7368,0,Madhan Neethiraj,2018-06-22 20:21:26-07:00,['f37f3de7531d6ea3dcb4a5853ae7d12b5dfd8237'],0,4,4,1357851,1,0,0,1,2911
eb895a62fde263ecf84da3a476594ca75a23022b,1,Madhan Neethiraj,2018-06-23 21:02:09-07:00,['80f556a704ee21b78598e87de36777f03ebe7368'],3,186,189,1358040,8,0.505154639,0.505154639,0.907216495,2912
bae327559d12f94b617e7321c7e334152e5388ce,0,nixonrodrigues,2018-06-26 19:06:33+05:18,['eb895a62fde263ecf84da3a476594ca75a23022b'],1,11,12,1358052,1,0.6,0,0.6,2912
78cfd718444e81426334ef2e3fdae9b467e60cd1,1,Sarath Subramanian,2018-06-28 15:04:13-07:00,['bae327559d12f94b617e7321c7e334152e5388ce'],3,67,70,1358122,1,0.552631579,1,1,2912
eb22be8c36769d88c7ec342bf7f6195849dc13b2,1,Madhan Neethiraj,2018-07-01 15:29:35-07:00,['78cfd718444e81426334ef2e3fdae9b467e60cd1'],9,24,33,1358155,1,0,0,1,2912
25bae4fe321194d27d205aa01ac49ab7a014013c,0,Madhan Neethiraj,2018-07-02 00:54:30-07:00,['eb22be8c36769d88c7ec342bf7f6195849dc13b2'],5,12,17,1358172,1,1,1,1,2912
74dc605d453697c3830a726498eff3232dbba60f,1,Madhan Neethiraj,2018-07-02 15:36:09-07:00,['25bae4fe321194d27d205aa01ac49ab7a014013c'],1,5,6,1358178,2,1,1,1,2912
15388229741b19c4567527da11bbb1daf2f9399f,1,Sarath Subramanian,2018-07-03 14:44:37-07:00,['74dc605d453697c3830a726498eff3232dbba60f'],26,73,99,1358277,5,0.2,0.2,1,2912
a2c26bfc2dd46e7fe6666231eabaed8976a916ab,0,Sarath Subramanian,2018-07-04 13:13:41-07:00,['15388229741b19c4567527da11bbb1daf2f9399f'],2,2,4,1358281,1,,,,2912
9d4678e41502c23abb3ad1d5e2cd0c9760679034,0,Sarath Subramanian,2018-07-05 09:35:19-07:00,['a2c26bfc2dd46e7fe6666231eabaed8976a916ab'],4,48,52,1358333,3,0.689655172,0,1,2912
cc629d7091468d1857c4ebbbf70a5b7a00d6ff36,1,Sarath Subramanian,2018-07-05 10:42:41-07:00,['9d4678e41502c23abb3ad1d5e2cd0c9760679034'],4,9,13,1358346,3,0.8,1,1,2912
ec396b931b21df05ce52d4b323370ac9e64b426b,0,apoorvnaik,2018-07-05 22:19:50-07:00,['cc629d7091468d1857c4ebbbf70a5b7a00d6ff36'],18,57,75,1358421,2,1,1,1,2912
59ae59dbaf8ce4a35886d5a9e5af7020666b1763,0,Sarath Subramanian,2018-07-06 15:24:41-07:00,['ec396b931b21df05ce52d4b323370ac9e64b426b'],0,7,7,1358428,1,0,0,1,2912
12ca5c97aa3d8ef0b35fb32e4f7f44cedaf1d620,0,Sarath Subramanian,2018-07-10 15:25:17-07:00,['59ae59dbaf8ce4a35886d5a9e5af7020666b1763'],2,24,26,1358454,1,0.388888889,0,0.388888889,2912
89fc835764c28e2f1e6e60ec9337e175bc0c0707,0,apoorvnaik,2018-07-13 18:12:54-07:00,['12ca5c97aa3d8ef0b35fb32e4f7f44cedaf1d620'],4,10,14,1358468,1,0,1,1,2912
d1b3f21c1c788c00edb75d7b092d08aeb936876c,0,nixonrodrigues,2018-07-23 18:27:36+05:18,['89fc835764c28e2f1e6e60ec9337e175bc0c0707'],3,6,9,1358477,3,,,,2912
50c3adf1519cb3d4d01ea86c2e90e1bba4df3c46,0,Madhan Neethiraj,2018-07-26 22:50:12-07:00,['d1b3f21c1c788c00edb75d7b092d08aeb936876c'],0,2,2,1358479,1,0,1,0,2912
b02238491e451bda71e399725ea4a4d021ec766f,0,Madhan Neethiraj,2018-07-29 08:39:15-07:00,['50c3adf1519cb3d4d01ea86c2e90e1bba4df3c46'],5,18,23,1358502,2,0.857142857,1,0.857142857,2912
a7119179e7972b799b476b1866e3fe23f64be42e,0,Graham Wallis,2018-08-02 16:22:14+01:00,['d1b3f21c1c788c00edb75d7b092d08aeb936876c'],2,15,17,1358519,2,0.230769231,1,1,2912
d5ecfee50037cbfccaf7ad708af7f73902600887,0,Graham Wallis,2018-08-02 16:27:27+01:00,"['a7119179e7972b799b476b1866e3fe23f64be42e', 'b02238491e451bda71e399725ea4a4d021ec766f']",5,20,25,1358544,2,,,,2912
da967ea8be923102c3485a4cbf55c958f57e23fd,1,Madhan Neethiraj,2018-08-04 11:58:07-07:00,['d5ecfee50037cbfccaf7ad708af7f73902600887'],72,498,570,1359114,13,0.679824561,0.780701754,0.925438596,2913
651ecd9e857660801e16edc1bea80109a671a378,1,Sarath Subramanian,2018-08-06 12:04:51-07:00,['da967ea8be923102c3485a4cbf55c958f57e23fd'],6,172,178,1359292,8,,,,2914
fbb244c2e4feb90949c7e3c1cbbf4bd2fe729a68,1,apoorvnaik,2018-08-07 19:34:23-07:00,['651ecd9e857660801e16edc1bea80109a671a378'],193,381,574,1359866,14,0.678571429,0.446428571,0.553571429,2914
68b47923e2567bd1451fb5b05a559bd8080c697c,0,Graham Wallis,2018-08-08 08:48:01+01:00,['fbb244c2e4feb90949c7e3c1cbbf4bd2fe729a68'],139168,0,139168,1499034,460,0.705538487,0.199701071,0.375670514,2914
7bf4bf4902b72b42ed4ee22da43890e7cee2a85a,0,nixonrodrigues,2018-08-08 19:03:57+05:18,['68b47923e2567bd1451fb5b05a559bd8080c697c'],6,6,12,1499046,1,,,,2914
e8a777807bebe6e35bbbbd67285408f6533dd024,1,Ashutosh Mestry,2018-08-08 15:27:15-07:00,['7bf4bf4902b72b42ed4ee22da43890e7cee2a85a'],0,11,11,1499057,1,,,,2914
42d801f756da0c3ff1bd4c433a15ff28373b9ea7,1,apoorvnaik,2018-08-08 16:42:55-07:00,['e8a777807bebe6e35bbbbd67285408f6533dd024'],0,6,6,1499063,2,0,1,0,2914
2f5eac0b234bbbba14c42880eeb10090067b5541,1,apoorvnaik,2018-08-09 09:24:05-07:00,['42d801f756da0c3ff1bd4c433a15ff28373b9ea7'],0,14,14,1499077,1,0,1,0.888888889,2914
e0ac86961146af217696493f170b4b20836cd6ce,0,Sarath Subramanian,2018-08-10 14:29:32-07:00,['2f5eac0b234bbbba14c42880eeb10090067b5541'],0,11,11,1499088,2,,,,2914
54d623c31f5d3fb8ff40b6ef8f25b99449aecb63,1,Sarath Subramanian,2018-08-10 14:51:48-07:00,['e0ac86961146af217696493f170b4b20836cd6ce'],81,302,383,1499471,17,0.695035461,0.85106383,0.404255319,2915
4c901bd07e6dae969b152f885ff2d6211c4b3e84,0,apoorvnaik,2018-08-13 07:18:32-07:00,['54d623c31f5d3fb8ff40b6ef8f25b99449aecb63'],5,49,54,1499525,1,0.115384615,0.115384615,0,2915
1099f1ba1169ce670fbdcf29803f8169f2ca9df4,0,Sarath Subramanian,2018-08-13 12:24:54-07:00,['4c901bd07e6dae969b152f885ff2d6211c4b3e84'],13,15,28,1499553,4,0,0,0,2915
4ddceacb0dc4add848a97a445a3091624aaaff7e,0,apoorvnaik,2018-08-13 20:30:09-07:00,['1099f1ba1169ce670fbdcf29803f8169f2ca9df4'],18,13,31,1499584,2,0,0,0,2915
f022990949e60e3b82e867bfc3845b3bb80859ca,1,Ashutosh Mestry,2018-08-14 11:05:03-07:00,['4ddceacb0dc4add848a97a445a3091624aaaff7e'],26,4,30,1499614,1,,,,2915
bc093ca893eea6a84fceba1588fa48842cbe69e5,1,Sarath Subramanian,2018-08-14 22:11:27-07:00,['f022990949e60e3b82e867bfc3845b3bb80859ca'],13,121,134,1499748,10,0.230769231,0.830769231,0.784615385,2915
1179aff80497d971b578b1b143789b2bb8c869a2,1,apoorvnaik,2018-08-14 22:42:41-07:00,['bc093ca893eea6a84fceba1588fa48842cbe69e5'],119,136,255,1500003,2,,,,2915
52ef9e7f3962da2bf77a15ab1a1bcef8d47b2877,1,Madhan Neethiraj,2018-08-15 13:39:37-07:00,['1179aff80497d971b578b1b143789b2bb8c869a2'],401,180,581,1500584,7,1,1,0.681034483,2915
24830e6bc8624ae6d4abbe4f9037f0de8ad57cd0,0,apoorvnaik,2018-08-15 20:20:27-07:00,['52ef9e7f3962da2bf77a15ab1a1bcef8d47b2877'],16,27,43,1500627,2,0.666666667,0,0.666666667,2915
5332f2e591d45c5e37492e7b4a441a0578446069,1,Madhan Neethiraj,2018-08-16 04:41:26-07:00,['24830e6bc8624ae6d4abbe4f9037f0de8ad57cd0'],44,77,121,1500748,6,0.136363636,0,0.954545455,2915
02ec8b99199569676f69ee1f723ab137307e03b4,1,nixonrodrigues,2018-08-16 19:13:19+05:18,['5332f2e591d45c5e37492e7b4a441a0578446069'],0,190,190,1500938,2,0.404761905,0.404761905,1,2917
5b9348f9e9b150592c2a7e41079700672fd53b06,1,Sarath Subramanian,2018-08-16 13:24:01-07:00,['02ec8b99199569676f69ee1f723ab137307e03b4'],2,10,12,1500950,3,0.333333333,1,1,2917
064c5767c8436cd9c16446f7ae7bbb1e6ca1d082,0,Sarath Subramanian,2018-08-16 13:25:12-07:00,['5b9348f9e9b150592c2a7e41079700672fd53b06'],50,79,129,1501079,4,0.933333333,0,1,2917
69fe4ab73bcab9ee118f1575ee476dd55fb44319,0,apoorvnaik,2018-08-16 22:22:24-07:00,['064c5767c8436cd9c16446f7ae7bbb1e6ca1d082'],23,24,47,1501126,1,1,1,1,2917
5b406348cb51a871fdf388f676c68102f647afac,0,Graham Wallis,2018-08-17 16:45:54+01:00,['69fe4ab73bcab9ee118f1575ee476dd55fb44319'],10,50,60,1501186,5,0,0.541666667,1,2917
27e8b2a40c718314aa0d8f114f5f7170e6c2a2dc,1,apoorvnaik,2018-08-20 15:46:51-07:00,['5b406348cb51a871fdf388f676c68102f647afac'],1,12,13,1501199,1,0,0,1,2917
4b2324f360b212d7495ce72e1b24075d04d05f6b,1,Sarath Subramanian,2018-08-21 12:14:05-07:00,['27e8b2a40c718314aa0d8f114f5f7170e6c2a2dc'],16,28,44,1501243,2,0.333333333,0.333333333,0.333333333,2917
a7cd9ac38dd5dcd105a7d5a28c50e851ee0d29a0,0,Madhan Neethiraj,2018-08-22 04:27:25-07:00,['4b2324f360b212d7495ce72e1b24075d04d05f6b'],2,2,4,1501247,1,,,,2917
be05196b317227d7032cd7295060ca1985056acc,0,nixonrodrigues,2018-08-22 18:58:51+05:18,['a7cd9ac38dd5dcd105a7d5a28c50e851ee0d29a0'],0,0,0,1501247,1,,,,2917
36080c33790c3d363212c374d4e6e88c5c1cf98f,0,apoorvnaik,2018-08-22 12:23:20-07:00,['be05196b317227d7032cd7295060ca1985056acc'],2,1,3,1501250,1,,,,2917
35561d4ec0c92b5976b0cd4b241962833c96587b,0,Sarath Subramanian,2018-08-22 16:22:08-07:00,['36080c33790c3d363212c374d4e6e88c5c1cf98f'],0,3,3,1501253,1,1,0,1,2917
70e10cc049f82243be0a3ace452c19b42476af6c,0,apoorvnaik,2018-08-22 17:21:43-07:00,['35561d4ec0c92b5976b0cd4b241962833c96587b'],0,6,6,1501259,1,1,1,1,2917
b6a664df305d18918ea84ec1351307fcefeec53c,1,Sarath Subramanian,2018-08-24 14:58:48-07:00,['70e10cc049f82243be0a3ace452c19b42476af6c'],188,239,427,1501686,15,1,0.961538462,0.192307692,2917
0ed9f0e25d2b064bb7728b2d8481968ba4375ba2,1,Sarath Subramanian,2018-08-25 12:06:50-07:00,['b6a664df305d18918ea84ec1351307fcefeec53c'],45,43,88,1501774,5,0,0,0,2917
9c45d2e8e88b8845330632ad2a164448c13840fd,1,Madhan Neethiraj,2018-08-26 16:20:06-07:00,['0ed9f0e25d2b064bb7728b2d8481968ba4375ba2'],139,33,172,1501946,5,0.367647059,0.367647059,0.573529412,2917
b9637b9a87376353c821606b5d3894a0fc1c7993,0,Sarath Subramanian,2018-08-26 23:54:17-07:00,['9c45d2e8e88b8845330632ad2a164448c13840fd'],2,11,13,1501959,2,0.428571429,0.428571429,1,2917
6de9428f447b669d44874a951faa9081bb4b3fda,0,Sarath Subramanian,2018-08-26 23:54:32-07:00,['b9637b9a87376353c821606b5d3894a0fc1c7993'],2,2,4,1501963,1,,,,2917
37c753bdde22b6d9307855a13ad79d8deeece936,1,kevalbhatt,2018-08-27 14:07:45+05:18,['6de9428f447b669d44874a951faa9081bb4b3fda'],26,145,171,1502134,4,0,0.8,0,2917
65d42c16fa910bb0d98a743937d823821b5baf99,0,Sarath Subramanian,2018-08-27 10:14:28-07:00,['37c753bdde22b6d9307855a13ad79d8deeece936'],2,2,4,1502138,1,,,,2917
b14736c907b63905b51153b241f5a8262be1f94a,0,kevalbhatt,2018-08-29 19:12:52+05:18,['65d42c16fa910bb0d98a743937d823821b5baf99'],0,6,6,1502144,1,,,,2917
f86603a8a93dea35bd22bdd1824db8cd7feb50c1,0,apoorvnaik,2018-08-29 13:02:08-07:00,['b14736c907b63905b51153b241f5a8262be1f94a'],1,1,2,1502146,1,,,,2917
3654f9fc36dee5355b7aa46d07adaef0abcc4f4f,0,Sarath Subramanian,2018-08-29 16:41:37-07:00,['f86603a8a93dea35bd22bdd1824db8cd7feb50c1'],1,4,5,1502151,1,0,0,1,2917
01b195a9607d0134bb114ab5427097ccb5dd56ef,0,Ashutosh Mestry,2018-08-30 22:37:47-07:00,['3654f9fc36dee5355b7aa46d07adaef0abcc4f4f'],1,1,2,1502153,1,,,,2917
56eefb2a9806265df997dda2ef70274eede72675,1,Madhan Neethiraj,2018-08-31 09:07:26-07:00,['01b195a9607d0134bb114ab5427097ccb5dd56ef'],45,165,210,1502363,4,0.673469388,1,0.87755102,2918
96f2c2996e6e3ccfd26e0297be5f29640a2ec781,0,Madhan Neethiraj,2018-08-31 09:45:07-07:00,['56eefb2a9806265df997dda2ef70274eede72675'],2,17,19,1502382,2,0.909090909,1,0.454545455,2918
f31a7c6310c68a76916cea0e1dc735f5bfb4e305,0,nixonrodrigues,2018-09-05 12:10:34+05:18,['96f2c2996e6e3ccfd26e0297be5f29640a2ec781'],1,2,3,1502385,2,0,1,1,2918
5496b7af9aa1a106f475457181d4fdc355b64e0b,0,GitHub,2018-09-05 16:33:20+08:00,['f31a7c6310c68a76916cea0e1dc735f5bfb4e305'],1,1,2,1502387,1,,,,2918
4c6f1d167e4b41dab62f2f0fa9e153e6ceac8621,1,Madhan Neethiraj,2018-09-06 12:59:29-07:00,['f31a7c6310c68a76916cea0e1dc735f5bfb4e305'],8,52,60,1502447,4,0,0,1,2918
eae9761871af9aeecc0fdc2248b7c8555407d0a6,1,Madhan Neethiraj,2018-09-06 23:44:49-07:00,['4c6f1d167e4b41dab62f2f0fa9e153e6ceac8621'],33,46,79,1502526,5,0.793103448,0.793103448,0.896551724,2918
3176d1a1e4eab9916b7fa0498d8c5a99a7a1382d,1,Madhan Neethiraj,2018-09-17 14:57:35-07:00,['eae9761871af9aeecc0fdc2248b7c8555407d0a6'],9,18,27,1502553,4,1,1,1,2918
48e522497f960ac9cc54853c3cb0e9af3e0111f3,0,Madhan Neethiraj,2018-09-18 09:10:59-07:00,['3176d1a1e4eab9916b7fa0498d8c5a99a7a1382d'],14,17,31,1502584,1,0,0,1,2918
a064e09242a0b1259d7b1227913786d2fb98f695,1,Madhan Neethiraj,2018-09-18 11:35:24-07:00,['48e522497f960ac9cc54853c3cb0e9af3e0111f3'],38,90,128,1502712,6,1,1,1,2918
ece78ba0933e9f868647689a888b3080568d015c,0,Madhan Neethiraj,2018-09-22 03:40:42-07:00,['a064e09242a0b1259d7b1227913786d2fb98f695'],65,113,178,1502890,2,0.727272727,1,0.454545455,2918
4128f5d2aa1462b5462a94886fbd26c24cbb5a91,0,Sarath Subramanian,2018-09-25 11:19:02-07:00,['ece78ba0933e9f868647689a888b3080568d015c'],9,33,42,1502932,1,1,1,1,2918
d5f46e3f51753dfd85ddc76ffb6f227eb83285fc,1,Madhan Neethiraj,2018-10-01 08:44:27-07:00,['4128f5d2aa1462b5462a94886fbd26c24cbb5a91'],5,155,160,1503092,5,0,0.195876289,0.958762887,2918
8cc12be185d388798a9de4e1d798e69de9795374,0,Sarath Subramanian,2018-10-02 15:37:45-07:00,['d5f46e3f51753dfd85ddc76ffb6f227eb83285fc'],35,60,95,1503187,5,0,0,0,2918
7f3da2c9e01a3946f91a42bfdf2fea3e4fb785e5,0,Madhan Neethiraj,2018-10-02 22:17:59-07:00,['8cc12be185d388798a9de4e1d798e69de9795374'],7,20,27,1503214,2,1,1,1,2918
5a96f057c594a7362923bc92f40c24c935dae548,0,kevalbhatt,2018-10-04 19:56:38+05:18,['7f3da2c9e01a3946f91a42bfdf2fea3e4fb785e5'],1,9,10,1503224,1,1,1,1,2918
6d0c5c8c7162f720aabe4c57e1d4bbaf8ddb4d9a,1,Ashutosh Mestry,2018-10-08 12:29:51-07:00,['5a96f057c594a7362923bc92f40c24c935dae548'],2,90,92,1503316,4,1,1,1,2918
871f02bb3f1d5e74788066fc0bb6644eff2ef0c2,1,Ashutosh Mestry,2018-10-08 14:16:23-07:00,['6d0c5c8c7162f720aabe4c57e1d4bbaf8ddb4d9a'],7,500,507,1503823,8,0.81773399,1,0.911330049,2922
06ff0752f8ea447b4c1f04a1461f6cd61b758b90,1,Ashutosh Mestry,2018-10-08 15:08:05-07:00,['871f02bb3f1d5e74788066fc0bb6644eff2ef0c2'],18,601,619,1504442,16,0.857740586,1,0.677824268,2926
41997f648b27aa523bcf6c30b2184041e02898b4,1,Ashutosh Mestry,2018-10-08 15:47:11-07:00,['06ff0752f8ea447b4c1f04a1461f6cd61b758b90'],4,164,168,1504610,4,0.652777778,0.944444444,0.930555556,2929
90958e83d93a59eb71eb633b5625960f04b9402e,1,Ashutosh Mestry,2018-10-08 21:45:39-07:00,['41997f648b27aa523bcf6c30b2184041e02898b4'],40,302,342,1504952,16,0.843478261,1,0.52173913,2931
1d8b81d88f48d1ddc3362784353a885c95c89b76,0,Ashutosh Mestry,2018-10-08 22:03:56-07:00,['90958e83d93a59eb71eb633b5625960f04b9402e'],0,2,2,1504954,1,0,0,0,2931
831ad014210484341a9bdea0c26a2e066586e988,1,Ashutosh Mestry,2018-10-09 10:23:05-07:00,['1d8b81d88f48d1ddc3362784353a885c95c89b76'],190,1784,1974,1506928,25,1,0.911764706,0.694117647,2945
4ff572815318772be6842ec93331f07c7e006bbd,1,Ashutosh Mestry,2018-10-09 10:48:52-07:00,['831ad014210484341a9bdea0c26a2e066586e988'],90,445,535,1507463,10,0.843137255,0.849673203,0.875816993,2948
b37154f87cebd630060760df1042a80489255020,1,Ashutosh Mestry,2018-10-09 12:06:35-07:00,['4ff572815318772be6842ec93331f07c7e006bbd'],9,10,19,1507482,4,0,0,0,2948
a2397c152af066a2769b84bd3225661cadbf405f,1,Ashutosh Mestry,2018-10-09 12:32:41-07:00,['b37154f87cebd630060760df1042a80489255020'],23,302,325,1507807,8,0.496503497,0.839160839,0.965034965,2950
21fcc7e12b954680c95e5685d1646a7fd16f9dbe,1,rmani,2018-10-10 01:37:42-07:00,['a2397c152af066a2769b84bd3225661cadbf405f'],0,11,11,1507818,1,,,,2950
ab2043a8005f6b4048f825bdae75a140c17d6a3e,1,kevalbhatt,2018-10-10 19:29:42+05:18,['21fcc7e12b954680c95e5685d1646a7fd16f9dbe'],25,582,607,1508425,10,0.442105263,0.723684211,0.947368421,2952
44763bf9d29772a4ffde5e8e8b1850b719c87e81,1,Ashutosh Mestry,2018-10-10 14:21:17-07:00,['ab2043a8005f6b4048f825bdae75a140c17d6a3e'],48,581,629,1509054,8,0.67699115,0.814159292,0.827433628,2955
c8439f4c3d45caac0232765267c224fcfa694faa,0,Ashutosh Mestry,2018-10-10 14:44:53-07:00,['44763bf9d29772a4ffde5e8e8b1850b719c87e81'],0,0,0,1509054,0,,,,2955
561cdc91ad0b721e0fae2900d6c621ddcfeab156,0,Ashutosh Mestry,2018-10-10 14:45:23-07:00,['c8439f4c3d45caac0232765267c224fcfa694faa'],2,2,4,1509058,2,,,,2955
03f2754d158e445faafe253bf232057a0c591c82,1,Ashutosh Mestry,2018-10-10 22:16:32-07:00,['561cdc91ad0b721e0fae2900d6c621ddcfeab156'],270,815,1085,1510143,27,0.810495627,0.839650146,0.962099125,2955
ca33b1bf9805ea72f13ce86d92a90b7b4dbe14a9,0,Ashutosh Mestry,2018-10-10 22:24:40-07:00,['03f2754d158e445faafe253bf232057a0c591c82'],2,2,4,1510147,1,,,,2955
0c3080152d64062306349cc5007daf4d09d8b8b4,1,Ashutosh Mestry,2018-10-10 22:49:38-07:00,['ca33b1bf9805ea72f13ce86d92a90b7b4dbe14a9'],58,351,409,1510556,9,0.643356643,0.979020979,0.881118881,2957
c0a91c7e1859c62b6fcb7eced5aed9679df12323,1,Ashutosh Mestry,2018-10-10 22:54:09-07:00,['0c3080152d64062306349cc5007daf4d09d8b8b4'],90,134,224,1510780,4,1,1,0.787878788,2957
116fb62c9a26efeff389d280f26e3c172ef98cf8,1,Ashutosh Mestry,2018-10-11 14:05:48-07:00,['c0a91c7e1859c62b6fcb7eced5aed9679df12323'],227,277,504,1511284,18,1,1,0.620689655,2957
708e4865ca51dd11bc8163c81a730773b5f84cb0,0,Ashutosh Mestry,2018-10-11 14:05:56-07:00,['116fb62c9a26efeff389d280f26e3c172ef98cf8'],1,47,48,1511332,2,0.4,1,1,2957
8903c9a642001b8aa75e744c741415beb735f241,1,Ashutosh Mestry,2018-10-11 14:25:28-07:00,['708e4865ca51dd11bc8163c81a730773b5f84cb0'],113,99,212,1511544,11,0,0,0,2957
b08b7b49a23db9c60ccb7f1bfe657c5ffdb12f6d,0,Ashutosh Mestry,2018-10-11 14:25:39-07:00,['8903c9a642001b8aa75e744c741415beb735f241'],8,97,105,1511649,4,0.379310345,0.379310345,1,2957
c6466004619f4e84a2940b0e55022f888fa030b2,1,Ashutosh Mestry,2018-10-11 14:26:18-07:00,['b08b7b49a23db9c60ccb7f1bfe657c5ffdb12f6d'],3,221,224,1511873,3,0.963855422,0.963855422,0.795180723,2959
dc6be8e29353d454732f571a0d410b7871eaff4b,1,Ashutosh Mestry,2018-10-11 15:14:17-07:00,['c6466004619f4e84a2940b0e55022f888fa030b2'],89,350,439,1512312,7,0.834782609,1,0.347826087,2961
8746b306358637c2a81bb66a8c0d8d82b031286d,1,Ashutosh Mestry,2018-10-11 15:21:14-07:00,['dc6be8e29353d454732f571a0d410b7871eaff4b'],1,1816,1817,1514129,13,0.557794274,0.786850477,0.966065748,2973
4b3c078c0efe41d8a5a3fe073bd24c87622a409a,1,Ashutosh Mestry,2018-10-11 15:38:23-07:00,['8746b306358637c2a81bb66a8c0d8d82b031286d'],13,89,102,1514231,3,0.48,0,0.96,2973
afa314cb520774e6417339f3180d292a6b0c13d6,0,Ashutosh Mestry,2018-10-11 15:40:21-07:00,['4b3c078c0efe41d8a5a3fe073bd24c87622a409a'],0,147,147,1514378,4,0.230769231,0.901098901,0.978021978,2973
9d4f972892cc4248e4e1b0cb5f2933806a4e0fbc,1,Ashutosh Mestry,2018-10-11 15:40:34-07:00,['afa314cb520774e6417339f3180d292a6b0c13d6'],74,424,498,1514876,9,0.711340206,0.804123711,0.943298969,2975
31c3bea1316d49fe233a061965cef248a97f1168,1,Ashutosh Mestry,2018-10-11 17:21:25-07:00,['9d4f972892cc4248e4e1b0cb5f2933806a4e0fbc'],378,470,848,1515724,13,0,0.475,0,2976
8639ada6a74cdaa32b0b493aaff1168733487eef,1,Ashutosh Mestry,2018-10-11 17:21:25-07:00,['31c3bea1316d49fe233a061965cef248a97f1168'],26,377,403,1516127,8,1,1,0.307692308,2977
b04c5bd28c9a1685d42bd2294478ab0f350ac608,1,Ashutosh Mestry,2018-10-11 17:21:25-07:00,['8639ada6a74cdaa32b0b493aaff1168733487eef'],28,10,38,1516165,1,0,0,0,2977
f4dac18468b94f56fbe482853982d064fc561cd2,1,Ashutosh Mestry,2018-10-11 17:21:26-07:00,['b04c5bd28c9a1685d42bd2294478ab0f350ac608'],6,134,140,1516305,7,0.526315789,0.526315789,1,2978
84c6fb2bc3c6ec68315ed522027a566bfed8f678,1,Ashutosh Mestry,2018-10-11 17:21:27-07:00,['f4dac18468b94f56fbe482853982d064fc561cd2'],8,29,37,1516342,3,1,0.235294118,1,2978
5fe6d8306da60bc20dbd8c6e51a9040ea32e9ebb,1,Ashutosh Mestry,2018-10-11 17:21:27-07:00,['84c6fb2bc3c6ec68315ed522027a566bfed8f678'],20,40,60,1516402,6,1,1,1,2979
678714134342f749465c61ec70a4c3ba672e7379,0,Ashutosh Mestry,2018-10-11 17:21:27-07:00,['5fe6d8306da60bc20dbd8c6e51a9040ea32e9ebb'],1,1,2,1516404,1,,,,2979
6f74720332d1dfb98c2b3da79516a17a37b5db1c,0,Ashutosh Mestry,2018-10-11 17:21:28-07:00,['678714134342f749465c61ec70a4c3ba672e7379'],12,6,18,1516422,2,0,0,0,2979
f6acb086146976ea2a63d93648be8a39d7acbc53,1,Ashutosh Mestry,2018-10-11 17:21:28-07:00,['6f74720332d1dfb98c2b3da79516a17a37b5db1c'],14,18,32,1516454,4,1,1,1,2979
7763fd0d329e5995ff9dc4c1f7bf73099eb85c27,0,Ashutosh Mestry,2018-10-11 17:21:29-07:00,['f6acb086146976ea2a63d93648be8a39d7acbc53'],22,37,59,1516513,4,0,0,1,2979
8a26c79e2f9ecfc14052c0954cb6e66308af09c6,0,Ashutosh Mestry,2018-10-11 17:21:29-07:00,['7763fd0d329e5995ff9dc4c1f7bf73099eb85c27'],1,9,10,1516523,2,0.4,1,1,2979
016eaffae5518b86bba7bfdda4fc720749362a93,0,Ashutosh Mestry,2018-10-11 17:21:29-07:00,['8a26c79e2f9ecfc14052c0954cb6e66308af09c6'],5,8,13,1516536,2,1,1,1,2979
7ffbec1a2a16f5288fff27d5bb81254d3280a900,0,Ashutosh Mestry,2018-10-11 17:21:30-07:00,['016eaffae5518b86bba7bfdda4fc720749362a93'],11,4,15,1516551,1,0,0,0,2979
1eb995434cb00d228eb403f47799fadc8dd58c08,1,Ashutosh Mestry,2018-10-11 17:21:31-07:00,['7ffbec1a2a16f5288fff27d5bb81254d3280a900'],11,9,20,1516571,4,0,0,0,2979
614415e0a7941e70cc4211ed2213b19057f02ec7,0,Ashutosh Mestry,2018-10-11 22:36:01-07:00,['1eb995434cb00d228eb403f47799fadc8dd58c08'],5,16,21,1516592,2,1,1,1,2979
ab801ff27101c80a553e58a1209b14b492b7435f,0,Sarath Subramanian,2018-10-11 22:55:35-07:00,['614415e0a7941e70cc4211ed2213b19057f02ec7'],1,2,3,1516595,3,,,,2979
2036751244aa2c0c79275022e7f0a32c3206a617,1,Madhan Neethiraj,2018-10-11 23:05:40-07:00,['ab801ff27101c80a553e58a1209b14b492b7435f'],1,1,2,1516597,1,,,,2979
e9869cfe669e39962dd52061004689562e7af082,0,Ashutosh Mestry,2018-10-12 13:30:23-07:00,['2036751244aa2c0c79275022e7f0a32c3206a617'],2,0,2,1516599,2,,,,2979
105d6b7f8e03ff5cc7d1c7c62baa352f856cf8d4,1,nixonrodrigues,2018-10-13 02:50:18+05:18,['e9869cfe669e39962dd52061004689562e7af082'],12,10,22,1516621,3,0,0,0,2979
82e04037220a82ab985928221bc72ade80fc3be2,1,Madhan Neethiraj,2018-10-12 14:34:12-07:00,['105d6b7f8e03ff5cc7d1c7c62baa352f856cf8d4'],26,17,43,1516664,3,1,1,0,2979
9e9f024b4cda210d407bbde43071546d31ca969b,1,Sarath Subramanian,2018-10-14 12:07:23-07:00,['82e04037220a82ab985928221bc72ade80fc3be2'],28,115,143,1516807,3,1,1,0.775862069,2979
a98d1bf0b3c6a354535dc4900869bcb1b2dd90ca,0,Sarath Subramanian,2018-10-14 12:55:51-07:00,['9e9f024b4cda210d407bbde43071546d31ca969b'],6,1233,1239,1518046,2,0.176056338,0.427230047,0.653755869,2980
85a01e180528ab18b31f633aa27932cf748e6ef9,0,Sarath Subramanian,2018-10-14 14:01:08-07:00,['a98d1bf0b3c6a354535dc4900869bcb1b2dd90ca'],4,0,4,1518050,1,,,,2980
3b2924096c1349da4ca1a942f4c136499ac2f110,0,Madhan Neethiraj,2018-10-15 17:55:12-07:00,['85a01e180528ab18b31f633aa27932cf748e6ef9'],1,1,2,1518052,1,,,,2980
c6aaef08efbbcf97c49ac08d85560b5798e16ae0,1,Ashutosh Mestry,2018-10-15 20:22:00-07:00,['3b2924096c1349da4ca1a942f4c136499ac2f110'],346,29,375,1518427,5,0.866666667,0.866666667,0.8,2980
2fbea9f2b52283a82a2769e8e389db4729317e78,0,Ashutosh Mestry,2018-10-16 10:12:36-07:00,['c6aaef08efbbcf97c49ac08d85560b5798e16ae0'],41,76,117,1518544,5,1,1,0,2981
fdab2efd718573a014f445cd54f7d8c477407958,0,Sarath Subramanian,2018-10-16 12:59:13-07:00,['2fbea9f2b52283a82a2769e8e389db4729317e78'],2,6,8,1518552,1,0,0,0,2981
7217f6781dfe74d49531cd16a4d80285a8552dac,0,rmani,2018-10-16 14:06:20-07:00,['fdab2efd718573a014f445cd54f7d8c477407958'],1,9,10,1518562,3,,,,2981
78e41ac25d6dba65a52d61c43f4f98c5956d1e7d,1,Ashutosh Mestry,2018-10-19 11:05:12-07:00,['7217f6781dfe74d49531cd16a4d80285a8552dac'],2,63,65,1518627,2,1,1,0.418604651,2981
f5fd57475d8aec1a41d694f9f8bd6337ab9a8560,0,Madhan Neethiraj,2018-10-21 10:18:59-07:00,['78e41ac25d6dba65a52d61c43f4f98c5956d1e7d'],1,1,2,1518629,1,,,,2981
3b8a34c51eeadb54adeed78bea1e1ec3b03e279f,0,apoorvnaik,2018-10-21 10:46:08-07:00,['f5fd57475d8aec1a41d694f9f8bd6337ab9a8560'],0,20,20,1518649,2,,,,2981
46b9b7c85835b1c4285eddce6c9773024a1b2114,0,Sarath Subramanian,2018-10-21 22:22:38-07:00,['3b8a34c51eeadb54adeed78bea1e1ec3b03e279f'],27,49,76,1518725,2,0,0,0.631578947,2981
93bd535eb66562ea8aadf5219d09a7893fff724e,0,kevalbhatt,2018-10-24 18:36:15+05:18,['46b9b7c85835b1c4285eddce6c9773024a1b2114'],4,7,11,1518736,1,0.666666667,0.666666667,1,2981
756c272ef0db175b3b6aca09d86b8a4acafd27ca,1,apoorvnaik,2018-10-24 21:49:59-07:00,['93bd535eb66562ea8aadf5219d09a7893fff724e'],120,32,152,1518888,8,,,,2981
927753159b12d7415bd891a67b94c39cbc133689,1,nixonrodrigues,2018-10-25 12:44:14+05:18,['756c272ef0db175b3b6aca09d86b8a4acafd27ca'],6,7381,7387,1526275,4,,,,2982
0cf62fd8002b68d0e11479752d3d2630a4bdfd38,1,apoorvnaik,2018-10-25 14:58:40-07:00,['927753159b12d7415bd891a67b94c39cbc133689'],17,409,426,1526701,7,0.595092025,0.595092025,1,2985
572c5d6480ed4e4d3b8da4084798c7740acd0ae3,1,Ashutosh Mestry,2018-10-26 13:45:52-07:00,['0cf62fd8002b68d0e11479752d3d2630a4bdfd38'],14,53,67,1526768,5,1,1,1,2986
da78c48314c67f2998eab2190324ca3786b3bafc,0,Sarath Subramanian,2018-10-26 16:02:55-07:00,['572c5d6480ed4e4d3b8da4084798c7740acd0ae3'],3,4,7,1526775,2,0,0,0,2986
7d27b68537a315e409c5e63d8b35de66a9087a34,1,nixonrodrigues,2018-10-29 14:32:23+05:18,['da78c48314c67f2998eab2190324ca3786b3bafc'],9,59,68,1526843,4,0,1,0,2986
3051df25409401db304f3e042db295b7a402619d,1,nixonrodrigues,2018-10-31 19:20:48+05:18,['7d27b68537a315e409c5e63d8b35de66a9087a34'],1,2,3,1526846,1,0,0,1,2986
2f896628645b584f6e70651facb54ee5dc985fb6,1,Ashutosh Mestry,2018-10-31 09:46:47-07:00,['3051df25409401db304f3e042db295b7a402619d'],17,30,47,1526893,3,1,1,1,2986
9eedb2d1dcdd661fe8f16c2a4519a65a17033982,1,Madhan Neethiraj,2018-10-31 15:31:50-07:00,['2f896628645b584f6e70651facb54ee5dc985fb6'],14,810,824,1527717,8,0.397674419,0.541860465,0.718604651,2989
e8f5c4d942c15bf440d2a5adfcde963f8a9b8749,0,kevalbhatt,2018-11-01 10:23:39+05:18,['9eedb2d1dcdd661fe8f16c2a4519a65a17033982'],0,22,22,1527739,1,,,,2990
75947444baceff7ed84baee10da7b56c86f86ab9,0,kevalbhatt,2018-11-01 15:48:55+05:18,['e8f5c4d942c15bf440d2a5adfcde963f8a9b8749'],1,2,3,1527742,1,1,1,1,2990
7e4788ed00c6a0ef4e8c89f0486b8073a56409e4,0,grahamwallis,2018-11-01 11:17:45+00:00,['75947444baceff7ed84baee10da7b56c86f86ab9'],72,134,206,1527948,7,0,0,0.815789474,2990
fb7e9eaf9c4453a1dcba9f7597b6ab67d3637a0e,0,grahamwallis,2018-11-01 12:08:04+00:00,['7e4788ed00c6a0ef4e8c89f0486b8073a56409e4'],0,4,4,1527952,1,0,0,1,2990
ba2b1449195cb79e464e14e6fedca4a8df50fa6b,0,Madhan Neethiraj,2018-11-01 08:08:02-07:00,['fb7e9eaf9c4453a1dcba9f7597b6ab67d3637a0e'],30,43,73,1528025,6,,,,2990
a2dc0ba871d2d0504309630130ce3583f93c87b4,1,Ashutosh Mestry,2018-11-02 15:31:34-07:00,['ba2b1449195cb79e464e14e6fedca4a8df50fa6b'],1,445,446,1528471,12,,,,2998
e7b9131dbfb143cc9690d0952c21134c79a43bfb,0,nixonrodrigues,2018-11-05 14:17:39+05:18,['a2dc0ba871d2d0504309630130ce3583f93c87b4'],0,1,1,1528472,1,,,,2998
243a43218fa8a72ff653bf0b61af9ac1c5b1ef85,0,Sarath Subramanian,2018-11-06 15:35:35-08:00,['e7b9131dbfb143cc9690d0952c21134c79a43bfb'],9,14,23,1528495,3,,,,2998
e272a28e861ee3926266e018b388ac6798dcd306,0,Madhan Neethiraj,2018-11-08 14:18:58-08:00,['243a43218fa8a72ff653bf0b61af9ac1c5b1ef85'],8,9,17,1528512,1,0,0,0,2998
85280ddf073a6e930b7b076730c362271437429a,1,Sarath Subramanian,2018-11-09 15:45:30-08:00,['e272a28e861ee3926266e018b388ac6798dcd306'],250,206,456,1528968,5,1,0.709090909,0.418181818,2999
854208c1ebc2a8a643dfaef190c76a13041cc1ad,1,Madhan Neethiraj,2018-11-10 14:56:33-08:00,['85280ddf073a6e930b7b076730c362271437429a'],6,33,39,1529007,4,0.5625,0.5625,1,2999
62cdbdc6d45c32fc3b135b4c6100f1ed02c6390a,1,nixonrodrigues,2018-11-14 16:39:42+05:18,['854208c1ebc2a8a643dfaef190c76a13041cc1ad'],133,243,376,1529383,3,0.433333333,0.4,1,2999
d003ddb33b16a0a67e6b7f7eae29c1638a4d0971,1,Madhan Neethiraj,2018-11-14 17:57:13-08:00,['62cdbdc6d45c32fc3b135b4c6100f1ed02c6390a'],138,479,617,1530000,24,1,1,0.951807229,3002
40329046a1d67059409c02396d696153bb2de653,1,Sarath Subramanian,2018-11-15 15:42:19-08:00,['d003ddb33b16a0a67e6b7f7eae29c1638a4d0971'],5,124,129,1530129,5,0.602409639,0.987951807,0.987951807,3002
b96c6b7a9127021c5e3624048bc0d21b0e1e24e3,0,Sarath Subramanian,2018-11-15 23:35:27-08:00,['40329046a1d67059409c02396d696153bb2de653'],3,1,4,1530133,1,,,,3002
945de013f5466ffcf71d16c6ec1772fdee83e2f6,0,Sarath Subramanian,2018-11-16 14:16:03-08:00,['b96c6b7a9127021c5e3624048bc0d21b0e1e24e3'],7,7,14,1530147,1,0,0,1,3002
8129bade53d1f2ad7a5de07c8254612b5c7a1f1f,0,grahamwallis,2018-11-19 11:41:10+00:00,['945de013f5466ffcf71d16c6ec1772fdee83e2f6'],1,4,5,1530152,2,0,0.5,0,3002
36656ea75eb2f3ad43a7bdf78f8ba9a471fce1b6,1,Sarath Subramanian,2018-11-19 10:50:57-08:00,['8129bade53d1f2ad7a5de07c8254612b5c7a1f1f'],96,1052,1148,1531300,30,0.806451613,1,0.806451613,3006
84371bccc6bcfe8dec61508b4d52e28796d85370,0,Madhan Neethiraj,2018-11-19 15:27:08-08:00,['36656ea75eb2f3ad43a7bdf78f8ba9a471fce1b6'],1,5,6,1531306,1,0,0,1,3006
ed795dc4c10ef56999ff57fa67739a1e126a2ccb,0,Madhan Neethiraj,2018-11-19 15:28:39-08:00,['84371bccc6bcfe8dec61508b4d52e28796d85370'],9,39,48,1531354,2,0,0,1,3006
2b9aa84d627ffec63a36ba345244703a8f4d557a,1,Sarath Subramanian,2018-11-21 12:36:40-08:00,['ed795dc4c10ef56999ff57fa67739a1e126a2ccb'],19,45,64,1531418,4,0.619047619,0.476190476,1,3006
618cf361201828faba3b7cf1f47dad2e348db634,0,Madhan Neethiraj,2018-11-25 16:30:59-08:00,['2b9aa84d627ffec63a36ba345244703a8f4d557a'],2,2,4,1531422,2,,,,3006
5da376483b37ffe56bc23f5db54149e1e0534a36,0,Madhan Neethiraj,2018-11-27 07:19:52-08:00,['618cf361201828faba3b7cf1f47dad2e348db634'],2,19,21,1531443,1,1,0.928571429,0.714285714,3006
18350777ed1137412609ceb420d8e6fa342737fc,0,nixonrodrigues,2018-11-27 23:44:34+05:18,['5da376483b37ffe56bc23f5db54149e1e0534a36'],1,1,2,1531445,1,,,,3006
5ebb16901040c22a717de29f962ca53941ba4078,1,Madhan Neethiraj,2018-11-28 21:01:24-08:00,['18350777ed1137412609ceb420d8e6fa342737fc'],21,28,49,1531494,7,1,1,1,3006
18a4984a4f6d28cd03c0e2fed194b1f129a5a9ec,0,rmani,2018-11-29 17:14:21-08:00,['5ebb16901040c22a717de29f962ca53941ba4078'],6,7,13,1531507,2,,,,3006
9a5553731b3ace19b2bca05f91676ec61b33f338,0,Madhan Neethiraj,2018-11-29 17:32:47-08:00,['18a4984a4f6d28cd03c0e2fed194b1f129a5a9ec'],2,4,6,1531513,1,0,0,0,3006
e4921452ebea5b338c07bbc6f886c44c8843f64b,1,Madhan Neethiraj,2018-11-29 17:33:45-08:00,['9a5553731b3ace19b2bca05f91676ec61b33f338'],0,55,55,1531568,3,0.804878049,0.341463415,1,3006
b919d3d0964efbe1eda40724545d5fa506100a02,0,Madhan Neethiraj,2018-11-30 15:43:50-08:00,['e4921452ebea5b338c07bbc6f886c44c8843f64b'],2,3,5,1531573,1,,,,3006
a5e5cec61e0af17710da229073a033e7b9cae4a9,1,Sarath Subramanian,2018-12-03 13:32:21-08:00,['b919d3d0964efbe1eda40724545d5fa506100a02'],124,463,587,1532160,84,0.635294118,0.729411765,0.976470588,3069
97e131a58849d17145d9ccc0997c050866e532c3,1,Madhan Neethiraj,2018-12-04 08:26:39-08:00,['a5e5cec61e0af17710da229073a033e7b9cae4a9'],42,49,91,1532251,71,1,1,1,3075
2068d7ddc08c66307a90a6a925d131fe19ce3756,1,Ashutosh Mestry,2018-12-10 11:36:29-08:00,['97e131a58849d17145d9ccc0997c050866e532c3'],5,20,25,1532276,3,0.888888889,0.888888889,1,3076
5307e498a3ecef5d4d24ad7ad9518052b212914a,0,Ashutosh Mestry,2018-12-17 15:40:18-08:00,['2068d7ddc08c66307a90a6a925d131fe19ce3756'],1,9,10,1532286,1,0.833333333,1,0.833333333,3076
bd0c5a8a8895b0ab52222e47beeefaab994a1099,0,Ashutosh Mestry,2018-12-18 13:13:49-08:00,['5307e498a3ecef5d4d24ad7ad9518052b212914a'],2,13,15,1532301,1,0,1,1,3076
beb34506a15379af4a306902da049f37b445a2f5,1,Madhan Neethiraj,2018-12-18 15:02:13-08:00,['bd0c5a8a8895b0ab52222e47beeefaab994a1099'],27,378,405,1532706,17,0.394285714,0.657142857,0.828571429,3077
9300924fd4de98e3400105e78ddb18111c065702,0,nixonrodrigues,2018-12-20 19:12:06+05:18,['beb34506a15379af4a306902da049f37b445a2f5'],5,27,32,1532738,2,1,1,1,3077
6ed883b3dfc74fd86b81f1bb0325a05a88e9e5b2,1,Sarath Subramanian,2018-12-21 11:43:31-08:00,['9300924fd4de98e3400105e78ddb18111c065702'],18,227,245,1532983,3,1,1,0.742857143,3077
e04c857d4da79eade201ea07a287bb2fef19bea2,0,kevalbhatt,2018-12-24 10:48:21+05:18,['6ed883b3dfc74fd86b81f1bb0325a05a88e9e5b2'],0,0,0,1532983,8,,,,3083
2a3b8830241a6bec7093bacfd91de44655adc28f,1,kevalbhatt,2019-01-03 15:19:06+05:18,['e04c857d4da79eade201ea07a287bb2fef19bea2'],102,98,200,1533183,11,1,0,1,3083
83fbe467bf5d80032ee3b5f1279589a3710f45e3,1,kevalbhatt,2019-01-03 15:20:13+05:18,['2a3b8830241a6bec7093bacfd91de44655adc28f'],46,98,144,1533327,5,0.5,0.888888889,0.777777778,3083
22041f51ce9a52f2c7b2634024e20765347a794a,1,kevalbhatt,2019-01-03 16:28:47+05:18,['83fbe467bf5d80032ee3b5f1279589a3710f45e3'],3,185,188,1533515,6,0.711864407,1,0.711864407,3085
a5f971a322b75a7cc2bd9e8bdf021be46e03b63d,0,nixonrodrigues,2019-01-04 12:32:18+05:18,['22041f51ce9a52f2c7b2634024e20765347a794a'],24,34,58,1533573,2,0,1,1,3085
4003858919bfff58d55479cbb2f2a79b5f4e9826,1,kevalbhatt,2019-01-04 17:17:21+05:18,['a5f971a322b75a7cc2bd9e8bdf021be46e03b63d'],2,4,6,1533579,2,0,0,0,3085
1123f512cd4ba98f8e1cfecb7f9deff23cbb4949,1,Sarath Subramanian,2019-01-04 14:00:51-08:00,['4003858919bfff58d55479cbb2f2a79b5f4e9826'],107,957,1064,1534643,9,0.5,0.496015936,0.884462151,3088
e05ed85fece9c6c3956a0e3f666f59e01a7b668c,0,nixonrodrigues,2019-01-08 17:42:57+05:18,['1123f512cd4ba98f8e1cfecb7f9deff23cbb4949'],1,1,2,1534645,1,,,,3088
3871be8b1e5496214b6d6adf1ee4c334d54f54b6,1,kevalbhatt,2019-01-10 19:12:42+05:18,['e05ed85fece9c6c3956a0e3f666f59e01a7b668c'],0,3,3,1534648,1,0,0,1,3088
665f8311e45477ffdf951b7f9d9eb304badfaab8,0,kevalbhatt,2019-01-10 19:13:22+05:18,['3871be8b1e5496214b6d6adf1ee4c334d54f54b6'],0,0,0,1534648,1,,,,3088
e8b32778cad16a61bcb6341b32fee90301028f71,1,kevalbhatt,2019-01-10 19:13:48+05:18,['665f8311e45477ffdf951b7f9d9eb304badfaab8'],16,61,77,1534725,6,0,0,0.866666667,3089
b455040d06be2c6330dfb0b11e34c6ea480a0b7c,0,kevalbhatt,2019-01-10 19:14:35+05:18,['e8b32778cad16a61bcb6341b32fee90301028f71'],0,8,8,1534733,1,0,0,1,3089
b7d113dc8eb1525e03e4497346db5da54350370b,0,GitHub,2019-01-10 16:05:01-08:00,"['b455040d06be2c6330dfb0b11e34c6ea480a0b7c', '5496b7af9aa1a106f475457181d4fdc355b64e0b']",1,1,2,1534735,1,,,,3089
96bdc802cc0b94819f1c02b9ed4b911ce05c947d,1,kevalbhatt,2019-01-14 14:23:33+05:18,['b7d113dc8eb1525e03e4497346db5da54350370b'],13,32,45,1534780,1,1,1,0,3089
6435f75db312e2944e8eaf72537e87491cd7af1a,0,Sarath Subramanian,2019-01-21 13:08:20-08:00,['96bdc802cc0b94819f1c02b9ed4b911ce05c947d'],1,1,2,1534782,1,,,,3089
cb2421bc0eb4f6a9c2d9f6dadf3b9ba0080e3e82,1,Ashutosh Mestry,2019-01-21 20:34:50-08:00,['96bdc802cc0b94819f1c02b9ed4b911ce05c947d'],6,1081,1087,1535869,24,0.710955711,0.918414918,0.671328671,3103
cd51cefb56d481db136237143f87f43c6df46229,0,Ashutosh Mestry,2019-01-21 20:37:09-08:00,"['cb2421bc0eb4f6a9c2d9f6dadf3b9ba0080e3e82', '6435f75db312e2944e8eaf72537e87491cd7af1a']",1,1,2,1535871,1,,,,3103
fa7d167537dfcdc48401e810519615723a4c664e,0,Ashutosh Mestry,2019-01-21 21:32:42-08:00,['cd51cefb56d481db136237143f87f43c6df46229'],7,7,14,1535885,1,,,,3103
de7fe47a2b714a023c5aa3d4f3b5648306ae7af1,0,Ashutosh Mestry,2019-01-21 22:31:13-08:00,['fa7d167537dfcdc48401e810519615723a4c664e'],1,78,79,1535964,4,1,1,1,3105
a9aa5b0e1b0a7c2867aef16358e3c3c1977bb140,1,Sarath Subramanian,2019-01-23 10:35:35-08:00,['de7fe47a2b714a023c5aa3d4f3b5648306ae7af1'],84,78,162,1536126,3,1,0,0.5,3105
4985b9f2a64a0f16f323bcbac600457215636852,1,Ashutosh Mestry,2019-01-23 13:38:50-08:00,['a9aa5b0e1b0a7c2867aef16358e3c3c1977bb140'],0,756,756,1536882,4,0.537142857,0.782857143,0.768571429,3109
2341d58a6ef14de410b75abdbc1378c6f81db6fa,0,Madhan Neethiraj,2019-01-23 15:11:39-08:00,['4985b9f2a64a0f16f323bcbac600457215636852'],83,214,297,1537179,4,0.760869565,0.358695652,0.391304348,3109
05e845f5b5178849f6fd53e589f9deaebd498f85,1,nixonrodrigues,2019-01-25 11:05:26+05:18,['2341d58a6ef14de410b75abdbc1378c6f81db6fa'],7,186,193,1537372,3,0.38961039,0.636363636,0.935064935,3109
b84ed999303abdeb8615393bb807f062cce76424,1,Madhan Neethiraj,2019-01-25 23:15:14-08:00,['05e845f5b5178849f6fd53e589f9deaebd498f85'],78,167,245,1537617,15,0.13559322,0.389830508,0,3109
7527ca06db3f82c981d61df855fd2ebe0ac96094,1,nixonrodrigues,2019-01-29 17:13:43+05:18,['b84ed999303abdeb8615393bb807f062cce76424'],18,398,416,1538033,9,0.927884615,0.783653846,0.778846154,3110
0e0f217af2b7c142ebc1445b86ba5570a3b69684,1,Madhan Neethiraj,2019-01-31 17:26:20-08:00,['7527ca06db3f82c981d61df855fd2ebe0ac96094'],71,149,220,1538253,5,0.428571429,0.408163265,0.408163265,3110
a9a095e1d87ee515b85ba281c96dabb78e2c415f,1,Madhan Neethiraj,2019-02-02 23:54:57-08:00,['0e0f217af2b7c142ebc1445b86ba5570a3b69684'],140,227,367,1538620,12,0.816666667,0.616666667,0.6,3110
d561404b0a93282a4dd9b0296f5c91b4230146a3,1,nixonrodrigues,2019-02-08 14:17:49+05:18,['a9a095e1d87ee515b85ba281c96dabb78e2c415f'],23,61,84,1538704,3,0.052631579,0,1,3110
b7dcfc60db30ed7a8d6e8e490e2b4936d8fd8412,0,Ashutosh Mestry,2019-02-08 12:34:19-08:00,['d561404b0a93282a4dd9b0296f5c91b4230146a3'],4,167,171,1538875,4,0.928571429,1,1,3112
9735643c6965accf367c1b8e8c39e6fae83da6b6,1,Ashutosh Mestry,2019-02-08 12:35:39-08:00,['b7dcfc60db30ed7a8d6e8e490e2b4936d8fd8412'],28,71,99,1538974,1,0.685714286,1,0.571428571,3112
d24929978f987fffc68199b83829a9b18f6f821e,0,Ashutosh Mestry,2019-02-11 16:16:12-08:00,['9735643c6965accf367c1b8e8c39e6fae83da6b6'],1,8,9,1538983,1,0,1,1,3112
ef752a1825a26cc9cf443489beca75ab2de88deb,0,nixonrodrigues,2019-02-12 18:26:56+05:18,['d24929978f987fffc68199b83829a9b18f6f821e'],5,1,6,1538989,1,1,1,0,3112
a0e4cd1aacb2047ff5af075a43ff9e38c49e2b85,1,Madhan Neethiraj,2019-02-20 07:37:54-08:00,['ef752a1825a26cc9cf443489beca75ab2de88deb'],22,86,108,1539097,8,0.209302326,0.255813953,0.395348837,3112
ee99930f5203ac321a5da41b9e3ab63df98e2faf,1,Madhan Neethiraj,2019-02-20 13:40:04-08:00,['a0e4cd1aacb2047ff5af075a43ff9e38c49e2b85'],82,57,139,1539236,3,0.285714286,0.285714286,0.357142857,3112
fe1c299ce4387138ec82b0824415949daa93fa6f,0,Madhan Neethiraj,2019-02-20 13:59:28-08:00,['ee99930f5203ac321a5da41b9e3ab63df98e2faf'],1,18,19,1539255,3,0.636363636,0.636363636,0.727272727,3112
74b32a17f1b2449c841da3eaf482b6272ffcc6d7,0,kevalbhatt,2019-02-21 15:33:16+05:18,['fe1c299ce4387138ec82b0824415949daa93fa6f'],28,28,56,1539311,3,,,,3112
3841a1bfd41b485f3cdeaad05abba2b14289c9d6,0,Madhan Neethiraj,2019-02-21 12:45:22-08:00,['74b32a17f1b2449c841da3eaf482b6272ffcc6d7'],25,77,102,1539413,3,0,0.542857143,0.971428571,3112
18019733f28448458e2cad94f5e67aabd18316be,1,Madhan Neethiraj,2019-02-21 12:52:26-08:00,['3841a1bfd41b485f3cdeaad05abba2b14289c9d6'],49,138,187,1539600,7,0.06779661,0.288135593,0.711864407,3112
f103e1438bbfc0c61912ded3551e22578876fbbe,1,Madhan Neethiraj,2019-02-22 10:46:04-08:00,['18019733f28448458e2cad94f5e67aabd18316be'],164,215,379,1539979,4,0.8,0.8,0.988235294,3113
b9642b62bca574bda897b199c5beb722238f3201,1,Sarath Subramanian,2019-02-25 11:04:21-08:00,['f103e1438bbfc0c61912ded3551e22578876fbbe'],261,436,697,1540676,18,0.64957265,1,1,3120
fe22a652c1a29c6df24bd906f6f62c9a76c2ddc0,0,Madhan Neethiraj,2019-02-26 21:54:51-08:00,['b9642b62bca574bda897b199c5beb722238f3201'],1,6,7,1540683,2,0,1,1,3120
1cb155a2548f7f415132d229043f9f6bdce755c2,1,Sarath Subramanian,2019-02-27 12:54:42-08:00,['fe22a652c1a29c6df24bd906f6f62c9a76c2ddc0'],199,385,584,1541267,4,0.843283582,0.925373134,1,3120
d030b525fa280eac9355302e9996d2a534769a47,0,kevalbhatt,2019-02-28 18:27:53+05:18,['1cb155a2548f7f415132d229043f9f6bdce755c2'],7,10,17,1541284,1,0,0,1,3120
546bc22f211351e479a65cfc401254ead2d86889,1,kevalbhatt,2019-02-28 18:28:36+05:18,['d030b525fa280eac9355302e9996d2a534769a47'],70,285,355,1541639,2,0.922155689,0.700598802,1,3121
786a0eaab8053693d16f731d09e7667de5d697df,1,kevalbhatt,2019-02-28 18:41:22+05:18,['546bc22f211351e479a65cfc401254ead2d86889'],356,233,589,1542228,8,1,0.9,0.066666667,3121
be84c4d8332e8f779516c61527a6de776a8a6897,0,Sarath Subramanian,2019-02-28 12:37:05-08:00,['786a0eaab8053693d16f731d09e7667de5d697df'],0,0,0,1542228,4,,,,3125
efb6a36563103f6908c0e16c87990412b4d869ac,1,Sarath Subramanian,2019-03-04 09:54:13-08:00,['be84c4d8332e8f779516c61527a6de776a8a6897'],6,49,55,1542283,3,0,1,1,3125
5c8445627891f67c806d7dbdd26e8f856c87a106,1,Madhan Neethiraj,2019-03-04 22:14:01-08:00,['efb6a36563103f6908c0e16c87990412b4d869ac'],15,168,183,1542466,6,0.254716981,0.273584906,0.849056604,3125
18ac31dbd2e5ab546f04281fa9a754e253618553,1,nixonrodrigues,2019-03-05 19:53:05+05:18,['5c8445627891f67c806d7dbdd26e8f856c87a106'],8,8,16,1542482,4,,0,,3125
ffa96f75355466d0daf14f9ebf3e5563ca40f1c6,0,Madhan Neethiraj,2019-03-05 11:15:48-08:00,['18ac31dbd2e5ab546f04281fa9a754e253618553'],2,16,18,1542500,3,0.142857143,0.714285714,0.428571429,3125
5651f934f42c40933d668b2d6f00fb9f8d9d1d89,1,Madhan Neethiraj,2019-03-06 07:18:37-08:00,['ffa96f75355466d0daf14f9ebf3e5563ca40f1c6'],206,300,506,1543006,18,0.101265823,0.506329114,0.860759494,3125
5d99c40a51d910d3858d4d25e321afad5f12996d,0,Madhan Neethiraj,2019-03-06 14:13:52-08:00,['5651f934f42c40933d668b2d6f00fb9f8d9d1d89'],65,350,415,1543421,8,0.69047619,0,0.976190476,3126
24715256558bed6f89d4bec25c6eada0c9db2075,1,Madhan Neethiraj,2019-03-08 17:25:33-08:00,['5d99c40a51d910d3858d4d25e321afad5f12996d'],67,223,290,1543711,8,0.220588235,0.294117647,0.573529412,3127
10f34ed8adc41929dcdcbaf8ac5fc23e712ae46d,1,Madhan Neethiraj,2019-03-11 00:35:32-07:00,['24715256558bed6f89d4bec25c6eada0c9db2075'],218,358,576,1544287,26,0.021126761,0,0,3127
0f79c344adc6d56e509c486e384dd380180e6cf0,0,Madhan Neethiraj,2019-03-11 12:35:10-07:00,['10f34ed8adc41929dcdcbaf8ac5fc23e712ae46d'],4,4,8,1544295,2,,,,3127
df44a5cb2a48eae7bdb79d27f45f10aeb8c97d0c,1,Sarath Subramanian,2019-03-12 11:15:12-07:00,['0f79c344adc6d56e509c486e384dd380180e6cf0'],41,35,76,1544371,2,1,1,1,3127
50ff27c7e687670893f4f0320908de4c60d54adc,0,Madhan Neethiraj,2019-03-12 11:59:49-07:00,['df44a5cb2a48eae7bdb79d27f45f10aeb8c97d0c'],1,62,63,1544434,3,0,0.75,1,3127
fc2a926cc7d0f0070c25f9afc68bf6a5a1bb6df2,1,Madhan Neethiraj,2019-03-12 13:58:36-07:00,['50ff27c7e687670893f4f0320908de4c60d54adc'],61,305,366,1544800,13,0,0.026490066,0.880794702,3127
4493653e07cb5a2ed6e564ea817c82ade2d95995,1,nixonrodrigues,2019-03-13 10:44:21+05:18,['fc2a926cc7d0f0070c25f9afc68bf6a5a1bb6df2'],6,8,14,1544814,2,1,1,0,3127
2e1c563418afbe4c1ac61b44b18d02c02c17235d,1,Sarath Subramanian,2019-03-13 01:41:28-07:00,['4493653e07cb5a2ed6e564ea817c82ade2d95995'],5722,3548,9270,1554084,86,0,0,0.730173627,3144
4925ec35933b8be6a75e758654629f55bb12ee60,1,Sarath Subramanian,2019-03-13 01:43:59-07:00,['2e1c563418afbe4c1ac61b44b18d02c02c17235d'],49,819,868,1554952,22,0.722627737,0.828467153,0.894160584,3145
3ed1f5a082ed665ce54f7dffc683b0f7b191e44d,0,nixonrodrigues,2019-03-13 14:07:37+05:18,['4925ec35933b8be6a75e758654629f55bb12ee60'],0,566,566,1555518,6,0.473451327,0.734513274,0.814159292,3150
ca22400ebf425088097b20b33873c15a71d5f908,0,Madhan Neethiraj,2019-03-13 12:29:01-07:00,['3ed1f5a082ed665ce54f7dffc683b0f7b191e44d'],6,18,24,1555542,2,1,1,0.125,3150
9e2d326688a093c7d361063f24fc7bd5affd4e01,0,Ashutosh Mestry,2019-03-13 18:21:06-07:00,['ca22400ebf425088097b20b33873c15a71d5f908'],2,3,5,1555547,2,,,,3150
debbc0ae8c012482e1401ab5699acf448d0205e2,0,Madhan Neethiraj,2019-03-13 23:51:01-07:00,['9e2d326688a093c7d361063f24fc7bd5affd4e01'],1,5,6,1555553,1,0,0,1,3150
770b82746fafcc4455eb52db3e0cdc4f2ff8236d,0,nixonrodrigues,2019-03-15 18:49:33+05:18,['debbc0ae8c012482e1401ab5699acf448d0205e2'],14,17,31,1555584,3,0,0,1,3150
3d266b08c10139652e76daae603c4a44a7b08eeb,1,Sarath Subramanian,2019-03-15 19:35:17-07:00,['770b82746fafcc4455eb52db3e0cdc4f2ff8236d'],13,13,26,1555610,2,,,,3150
8fc70a32303def4d85755cbf6466ab6e4c0e72e6,1,Madhan Neethiraj,2019-03-18 04:14:43-07:00,['3d266b08c10139652e76daae603c4a44a7b08eeb'],13,17,30,1555640,3,0.6,0,0.8,3150
3addc237de36c9319577bba339138aadd8570d72,0,kevalbhatt,2019-03-20 11:03:29+05:18,['8fc70a32303def4d85755cbf6466ab6e4c0e72e6'],5,5,10,1555650,5,,,,3150
fa2c3e2cc6afc8d06a943a589502d0e1004cdd62,0,Sarath Subramanian,2019-03-20 00:38:04-07:00,['3addc237de36c9319577bba339138aadd8570d72'],12,20,32,1555682,1,0,1,1,3150
4c7c911c3d64ede6bbb2d8cafb9cbc50c399cbc1,0,nixonrodrigues,2019-03-20 15:25:44+05:18,['fa2c3e2cc6afc8d06a943a589502d0e1004cdd62'],11,10,21,1555703,3,,,,3150
f92e06cda0833d5840015a18ec8f5c5f30b582a3,1,nixonrodrigues,2019-03-20 18:42:29+05:18,['4c7c911c3d64ede6bbb2d8cafb9cbc50c399cbc1'],61,50,111,1555814,6,1,1,0,3150
27916dd49f854678b84bde8023aee6e47cbeb7ce,1,Sarath Subramanian,2019-03-20 12:21:06-07:00,['f92e06cda0833d5840015a18ec8f5c5f30b582a3'],13,157,170,1555984,3,0.048387097,1,1,3150
2c0a8bcc1afe1588a1ffc3ea175bb29055c55894,0,Sarath Subramanian,2019-03-20 14:16:19-07:00,['27916dd49f854678b84bde8023aee6e47cbeb7ce'],3,22,25,1556009,1,0.857142857,1,1,3150
67a681f2b36637ce691f2bec9d4296b674c6c92e,0,Sarath Subramanian,2019-03-21 14:47:22-07:00,['2c0a8bcc1afe1588a1ffc3ea175bb29055c55894'],3,13,16,1556025,1,1,1,1,3150
c7e42427f0320a2874ceee8eb4859cdd140f7b33,1,nixonrodrigues,2019-03-22 12:02:16+05:18,['67a681f2b36637ce691f2bec9d4296b674c6c92e'],4,4,8,1556033,1,,,,3150
cd15f768d6c0378925457f4447386a341c84f171,1,Sarath Subramanian,2019-03-21 23:59:35-07:00,['c7e42427f0320a2874ceee8eb4859cdd140f7b33'],69,475,544,1556577,8,0.470588235,0.663101604,0.893048128,3153
b2a77d0f657e321c6e2d54f73ac9b6a0fec59cad,0,Diego Marino Monetti,2019-03-22 12:48:06+01:00,['2c0a8bcc1afe1588a1ffc3ea175bb29055c55894'],6,33,39,1556616,1,1,1,0,3153
d5f7cc46cdae050db5d1ee810a2a2ed10c52c15f,1,Sarath Subramanian,2019-03-22 16:15:50-07:00,['cd15f768d6c0378925457f4447386a341c84f171'],5,5,10,1556626,5,,,,3153
6aaab22160a214b303f2f2d9ff1b2e5be48db8b3,0,Madhan Neethiraj,2019-03-22 19:24:32-07:00,['d5f7cc46cdae050db5d1ee810a2a2ed10c52c15f'],9,8,17,1556643,1,,,1,3153
5b9430daa7463a6328ba7a0175c8e15b5378131f,0,Madhan Neethiraj,2019-03-24 08:33:36-07:00,['6aaab22160a214b303f2f2d9ff1b2e5be48db8b3'],2,2,4,1556647,1,,,,3153
af1719a3472d1d436d0fc685fe9f88d8a754ef94,0,Madhan Neethiraj,2019-03-24 08:46:18-07:00,['5b9430daa7463a6328ba7a0175c8e15b5378131f'],2,131,133,1556780,2,1,1,1,3154
dcf0404e0efaa710bb5c0bd649cde57b8edca706,0,GitHub,2019-03-25 08:27:14-07:00,"['af1719a3472d1d436d0fc685fe9f88d8a754ef94', 'b2a77d0f657e321c6e2d54f73ac9b6a0fec59cad']",6,33,39,1556819,1,,,,3154
3ba4a3fe670c36b71f42d3579264a0f060af1090,0,Ashutosh Mestry,2019-03-25 09:28:16-07:00,['dcf0404e0efaa710bb5c0bd649cde57b8edca706'],23,18,41,1556860,7,,,,3154
01ea65c2153c6541f479c6f4f527aa4883e9fbe2,1,Sarath Subramanian,2019-03-25 13:54:09-07:00,['3ba4a3fe670c36b71f42d3579264a0f060af1090'],242,389,631,1557491,5,0.538461538,1,0.538461538,3154
ee4189124cb647dce8afadb3e3ec1a7c959f5554,0,Sarath Subramanian,2019-03-26 00:08:02-07:00,['01ea65c2153c6541f479c6f4f527aa4883e9fbe2'],41,27,68,1557559,1,1,1,0,3154
9b6a1e6c6e3c8ad68aba2270f1eaef7f7b72364e,1,Madhan Neethiraj,2019-03-26 07:30:15-07:00,['ee4189124cb647dce8afadb3e3ec1a7c959f5554'],4,72,76,1557635,1,1,1,0,3154
92c0c3e52967d4c9139a87b01c7e5b812d2894cf,0,kevalbhatt,2019-03-26 19:51:14+05:18,['9b6a1e6c6e3c8ad68aba2270f1eaef7f7b72364e'],1,1,2,1557637,1,,,,3154
727e6e0312f99c2ca91d3909ece47ae2604acd08,0,Madhan Neethiraj,2019-03-27 07:15:58-07:00,['92c0c3e52967d4c9139a87b01c7e5b812d2894cf'],1,3,4,1557641,2,0,1,1,3154
ba5e6b244cec8601403b3a96e3ac3391e1c282f5,0,rmani,2019-03-27 17:15:08-07:00,['727e6e0312f99c2ca91d3909ece47ae2604acd08'],3,16,19,1557660,1,0,0,1,3154
4551dcd7af36662c4df8a83af9f599ed1a3a39d4,0,kevalbhatt,2019-03-28 17:39:11+05:18,['ba5e6b244cec8601403b3a96e3ac3391e1c282f5'],3,16,19,1557679,3,0.4,0.4,1,3154
a9fc73a45903aac0e04793a4e9681159ee0a0b03,1,kevalbhatt,2019-03-28 17:40:48+05:18,['4551dcd7af36662c4df8a83af9f599ed1a3a39d4'],2,4,6,1557685,1,0,1,1,3154
8dc4041c69083292d7d5f9996b10f42e33874077,1,Sarath Subramanian,2019-03-28 14:00:12-07:00,['a9fc73a45903aac0e04793a4e9681159ee0a0b03'],10,28,38,1557723,5,1,1,1,3154
14037eed5c380006b0d622842677e362057a433a,1,Sarath Subramanian,2019-03-28 16:53:11-07:00,['8dc4041c69083292d7d5f9996b10f42e33874077'],78,177,255,1557978,8,0,1,0.9875,3154
07192bc82c213896dec29d219056633ef56c13f8,0,Madhan Neethiraj,2019-03-29 21:07:38-07:00,['14037eed5c380006b0d622842677e362057a433a'],2,126,128,1558106,4,0.52,0.733333333,0.906666667,3154
2b29e4a4460eb6de86904ff2517ee572cd88d3ee,1,Madhan Neethiraj,2019-03-31 13:59:08-07:00,['07192bc82c213896dec29d219056633ef56c13f8'],29,51,80,1558186,8,1,1,0,3154
66f57da82afd1d348eca4e0c9deccc3838ebe114,0,Sarath Subramanian,2019-04-03 05:06:18-07:00,['2b29e4a4460eb6de86904ff2517ee572cd88d3ee'],13,26,39,1558225,2,0.714285714,0.714285714,1,3154
984445e9111c743f3f255fc4653fc02555a8f095,1,Sarath Subramanian,2019-04-03 05:31:16-07:00,['66f57da82afd1d348eca4e0c9deccc3838ebe114'],49,446,495,1558720,10,0.553299492,0.837563452,0.812182741,3156
d234de2d7ef4a935db313a852ce80b8aab126c3b,0,Sarath Subramanian,2019-04-03 10:13:03-07:00,['984445e9111c743f3f255fc4653fc02555a8f095'],34,70,104,1558824,8,0.954545455,0.954545455,0,3156
3e4fb5cd84262c6c675e434628e607d7afd518f4,0,Madhan Neethiraj,2019-04-05 00:06:35-07:00,['d234de2d7ef4a935db313a852ce80b8aab126c3b'],327,549,876,1559700,13,0,0,0.49044586,3156
d6fe41d4c6e014de1fb1eb7a2a618c0d93be6c48,0,Sarath Subramanian,2019-04-05 11:23:53-07:00,['3e4fb5cd84262c6c675e434628e607d7afd518f4'],15,36,51,1559751,2,0.583333333,0.583333333,1,3156
37eb276563fc69ae532acdc63845d20990e2de3f,1,Sarath Subramanian,2019-04-07 15:02:33-07:00,['d6fe41d4c6e014de1fb1eb7a2a618c0d93be6c48'],70,34,104,1559855,8,0.045454545,0.045454545,1,3156
f029a4e024aab36cac60f32c75079357376918ef,0,Ashutosh Mestry,2019-04-07 23:39:00-07:00,['37eb276563fc69ae532acdc63845d20990e2de3f'],2,75,77,1559932,6,1,0.454545455,1,3157
572c0b80da5a2290b3e1f2614e348b0d1d158990,1,Sarath Subramanian,2019-04-08 13:09:33-07:00,['f029a4e024aab36cac60f32c75079357376918ef'],34,382,416,1560348,6,0.792746114,1,0.92746114,3159
c477a6f6d1899211e7a7d9b67090b20757e28578,0,nixonrodrigues,2019-04-09 13:51:50+05:18,['572c0b80da5a2290b3e1f2614e348b0d1d158990'],0,2,2,1560350,1,,,,3159
f1071310cbb941a420d4c819c49ed4004e488372,1,nixonrodrigues,2019-04-09 18:38:01+05:18,['c477a6f6d1899211e7a7d9b67090b20757e28578'],24,30,54,1560404,13,1,1,0,3159
fbabb8ba324e573cdcc5b914b1631417a6256283,1,Sarath Subramanian,2019-04-09 13:39:45-07:00,['f1071310cbb941a420d4c819c49ed4004e488372'],3,10,13,1560417,1,0,0,1,3159
1a5009ea7ec589e5809aae5ead8fac2467394f25,1,Madhan Neethiraj,2019-04-10 09:29:40-07:00,['fbabb8ba324e573cdcc5b914b1631417a6256283'],536,866,1402,1561819,12,1,1,0.818181818,3161
39b059e03d3cc728745e7b1c90a7be774ebca0fa,1,Sarath Subramanian,2019-04-10 14:10:10-07:00,['1a5009ea7ec589e5809aae5ead8fac2467394f25'],71,385,456,1562275,7,0.187817259,0.411167513,1,3161
f070d924ddee55259ea1d74c7a0b8e87cea2a75d,0,Madhan Neethiraj,2019-04-10 14:56:20-07:00,['39b059e03d3cc728745e7b1c90a7be774ebca0fa'],1,11,12,1562287,1,0,0,1,3161
9d4380e0f32ab47ba51eba89d514be3968a3bd86,0,Madhan Neethiraj,2019-04-11 01:01:18-07:00,['f070d924ddee55259ea1d74c7a0b8e87cea2a75d'],26,220,246,1562533,6,0.314049587,0.479338843,0.479338843,3161
e6deb3378dfb19371f42077c7520187f75e61564,0,Madhan Neethiraj,2019-04-11 17:42:24-07:00,['9d4380e0f32ab47ba51eba89d514be3968a3bd86'],6,7,13,1562546,2,,,,3161
d61bfcfb03a116203df6280924eb9df94194026a,1,Madhan Neethiraj,2019-04-12 10:19:25-07:00,['e6deb3378dfb19371f42077c7520187f75e61564'],31,360,391,1562937,6,0.585365854,0.845528455,1,3162
06a3fd3f8beb50e10db11edd1c8607b3bbe977a3,0,Madhan Neethiraj,2019-04-13 21:27:23-07:00,['d61bfcfb03a116203df6280924eb9df94194026a'],183,23,206,1563143,1,,,,3162
a910609d43b252526cf15337f891fc04c6dc4154,0,Madhan Neethiraj,2019-04-14 18:02:37-07:00,['06a3fd3f8beb50e10db11edd1c8607b3bbe977a3'],10,23,33,1563176,2,0,0,0,3162
9c9eed274532391ceb57a0e17d0b2f8611530f8a,0,Madhan Neethiraj,2019-04-14 23:43:52-07:00,['a910609d43b252526cf15337f891fc04c6dc4154'],4,18,22,1563198,3,0,0,0.7,3162
2af5eedeee0a53422b9652eb44f9d7315a79f6aa,1,Madhan Neethiraj,2019-04-15 11:49:02-07:00,['9c9eed274532391ceb57a0e17d0b2f8611530f8a'],216,314,530,1563728,10,1,1,1,3164
011e854660a08a6eed014d4fc5b56f55d8ca6cdd,1,Madhan Neethiraj,2019-04-15 11:49:06-07:00,['2af5eedeee0a53422b9652eb44f9d7315a79f6aa'],25,69,94,1563822,5,1,1,1,3164
93e629fa839f30f2641b284c874485fbe3505b27,1,kevalbhatt,2019-04-16 12:40:02+05:18,['011e854660a08a6eed014d4fc5b56f55d8ca6cdd'],9,8,17,1563839,1,1,1,1,3164
efc4bebc1623c9d00fe4fdf0df424918654a73df,1,Madhan Neethiraj,2019-04-16 02:20:33-07:00,['93e629fa839f30f2641b284c874485fbe3505b27'],579,944,1523,1565362,19,0.919708029,1,0.802919708,3170
0bb18f08e6b63ce344d6b01b744d6ce492e16f50,1,Ashutosh Mestry,2019-04-17 15:15:37-07:00,['efc4bebc1623c9d00fe4fdf0df424918654a73df'],168,293,461,1565823,10,0.507462687,1,0.656716418,3170
0174bac0b3fc6547441fbb6a8e64a8e8ae990050,1,Sarath Subramanian,2019-04-17 16:20:46-07:00,['0bb18f08e6b63ce344d6b01b744d6ce492e16f50'],161,957,1118,1566941,15,0.769547325,0.895061728,0.87654321,3173
5389b9bd3c9dd4bfbd1fbd881a6b4fc5fd7788cc,0,Sarath Subramanian,2019-04-17 17:05:05-07:00,['0174bac0b3fc6547441fbb6a8e64a8e8ae990050'],26,45,71,1567012,2,0.545454545,0.545454545,1,3173
24c9556c969eaa294e5c8537d98227c6bd6978e0,1,kevalbhatt,2019-04-18 19:02:20+05:18,['5389b9bd3c9dd4bfbd1fbd881a6b4fc5fd7788cc'],16,96,112,1567124,8,0.078947368,0.947368421,0.315789474,3173
3def7682de67e1a37c9fa34b3232ded56f7583ed,1,Ashutosh Mestry,2019-04-18 13:39:43-07:00,['24c9556c969eaa294e5c8537d98227c6bd6978e0'],7,7,14,1567138,6,,,,3173
f234ed1d4958c247dfeb99c996bbbea746ad83b1,1,Sarath Subramanian,2019-04-18 18:30:59-07:00,['3def7682de67e1a37c9fa34b3232ded56f7583ed'],2,2,4,1567142,2,,,,3173
2c9376f8cbc15c20b02bfd6b227e7063d29b23bd,0,Madhan Neethiraj,2019-04-19 12:05:40-07:00,['f234ed1d4958c247dfeb99c996bbbea746ad83b1'],2,11,13,1567155,1,1,1,1,3173
75bdf79100e5ae75cbb8150547dc48e35902970a,1,kevalbhatt,2019-04-24 11:24:44+05:18,['2c9376f8cbc15c20b02bfd6b227e7063d29b23bd'],21,111,132,1567287,3,0.243243243,0.594594595,1,3173
c756690365053037fad0afd794523162c9508a8a,0,kevalbhatt,2019-04-24 17:00:58+05:18,['75bdf79100e5ae75cbb8150547dc48e35902970a'],2,3,5,1567292,1,,,,3173
1c6201559f3575f8f023b7a760259ebc4ef43ddd,1,kevalbhatt,2019-04-24 17:45:30+05:18,['c756690365053037fad0afd794523162c9508a8a'],13,14,27,1567319,3,1,0,0,3173
4d6169f51e024645fca2213e21c1398c99420b4e,1,kevalbhatt,2019-04-24 18:57:08+05:18,['1c6201559f3575f8f023b7a760259ebc4ef43ddd'],9,28,37,1567356,2,1,1,1,3173
0a81c2505d91156742050f45634d9a72c0d7d7a2,0,nixonrodrigues,2019-04-24 19:33:04+05:18,['4d6169f51e024645fca2213e21c1398c99420b4e'],42,99,141,1567497,7,0.06,0.76,0.98,3173
5c9a699ab2afa4de9dddc53e3b50407635e6fc79,1,Sarath Subramanian,2019-04-24 16:25:40-07:00,['0a81c2505d91156742050f45634d9a72c0d7d7a2'],83,595,678,1568175,11,0,0.981762918,0.933130699,3173
fea30b881330c4be59cfea4192081779ba805117,1,Sarath Subramanian,2019-04-24 20:13:11-07:00,['5c9a699ab2afa4de9dddc53e3b50407635e6fc79'],25,60,85,1568260,6,0.9375,0.9375,1,3173
982123e46f88b6777ba07bc9d6b21068f9495863,0,Ashutosh Mestry,2019-04-24 22:52:59-07:00,['fea30b881330c4be59cfea4192081779ba805117'],43,51,94,1568354,5,1,1,1,3173
04bd64be7bbb0c97939629edaf8f827ce1a40b4b,0,nixonrodrigues,2019-04-25 15:41:16+05:18,['982123e46f88b6777ba07bc9d6b21068f9495863'],3,86,89,1568443,4,,,,3174
2cb36b90d0c1fa550e5459e1f87294ecd5a505be,1,nixonrodrigues,2019-04-25 20:35:26+05:18,['04bd64be7bbb0c97939629edaf8f827ce1a40b4b'],59,69,128,1568571,11,0,0,0,3174
eaee02fef4d2fa6186af5e3d754886507b5fada3,0,Sarath Subramanian,2019-04-25 11:09:32-07:00,['2cb36b90d0c1fa550e5459e1f87294ecd5a505be'],86,3,89,1568660,4,,,,3174
e050bc06b43909aaf5bcf001d4b0d922487b89ab,1,kevalbhatt,2019-04-26 15:24:52+05:18,['eaee02fef4d2fa6186af5e3d754886507b5fada3'],24,31,55,1568715,1,0.666666667,0,1,3174
c37656cc64b1c41c8188ec92c24907e84ae05a06,1,Sarath Subramanian,2019-04-27 10:24:33-07:00,['e050bc06b43909aaf5bcf001d4b0d922487b89ab'],51,453,504,1569219,4,0.458874459,1,1,3175
0a5eb916e48d514fadd802bf5c4ed671d4de91cc,0,Madhan Neethiraj,2019-04-27 10:26:58-07:00,['c37656cc64b1c41c8188ec92c24907e84ae05a06'],11,4,15,1569234,1,0,0,1,3175
b7af1096af451aa640315d0139897bff627eff72,0,Sarath Subramanian,2019-04-27 16:09:58-07:00,['0a5eb916e48d514fadd802bf5c4ed671d4de91cc'],0,6,6,1569240,1,,,,3175
ed288a759c556c704c824eb921c81b563a32f3e9,0,Sarath Subramanian,2019-04-28 23:49:34-07:00,['b7af1096af451aa640315d0139897bff627eff72'],1,26,27,1569267,1,0,1,1,3175
aaf0ba23b418d1b5b128ec4b8854287e878e2b4e,1,Madhan Neethiraj,2019-05-02 11:20:48-07:00,['ed288a759c556c704c824eb921c81b563a32f3e9'],25,43,68,1569335,1,1,1,1,3175
0323ce3825c63b06d7b0032edd10b73b84078a4a,0,Madhan Neethiraj,2019-05-02 20:48:54-07:00,['aaf0ba23b418d1b5b128ec4b8854287e878e2b4e'],4,54,58,1569393,3,0.714285714,0.714285714,0.8,3175
8b58a326197e897a937d28f53076f385bb6710a7,0,Ashutosh Mestry,2019-05-02 21:13:39-07:00,['0323ce3825c63b06d7b0032edd10b73b84078a4a'],33,139,172,1569565,4,0.5,1,1,3177
fcca791b60364eb0fd5ca3b74c0f52f8f781cf64,0,Sarath Subramanian,2019-05-02 21:35:52-07:00,['8b58a326197e897a937d28f53076f385bb6710a7'],9,45,54,1569619,3,0.696969697,0.696969697,1,3177
bd7f5eecf8cadae392adb948e3492ce6c1c97bbf,1,Madhan Neethiraj,2019-05-02 22:12:32-07:00,['fcca791b60364eb0fd5ca3b74c0f52f8f781cf64'],15,13,28,1569647,4,1,0,0,3177
dfc346d3b87d1dce2268904fec6c26a36be7f2f0,1,Sarath Subramanian,2019-05-06 10:55:02-07:00,['bd7f5eecf8cadae392adb948e3492ce6c1c97bbf'],15,73,88,1569735,7,0.394736842,1,1,3177
5892de67cc9a0419bd8b6ccf72a0f67278c810f1,0,nixonrodrigues,2019-05-08 12:11:07+05:18,['dfc346d3b87d1dce2268904fec6c26a36be7f2f0'],1,76,77,1569812,4,,,,3178
fad2822fdf2ff20673bd587866f187184e46bffb,1,Ashutosh Mestry,2019-05-08 08:22:07-07:00,['5892de67cc9a0419bd8b6ccf72a0f67278c810f1'],124,467,591,1570403,10,0.902777778,1,1,3180
55ef909cbc132945f9de65a6d00e22a1dead8ee1,0,Madhan Neethiraj,2019-05-08 17:27:58-07:00,['fad2822fdf2ff20673bd587866f187184e46bffb'],30,30,60,1570463,1,,,,3180
d5437734fa15de763dc33bcd83e22f61ae172d51,1,Madhan Neethiraj,2019-05-08 17:38:59-07:00,['55ef909cbc132945f9de65a6d00e22a1dead8ee1'],7,203,210,1570673,6,0.180555556,0.625,0.944444444,3180
3137bb2151abcc362008d7449f1e9a80d57b17a7,1,Sarath Subramanian,2019-05-08 18:38:29-07:00,['d5437734fa15de763dc33bcd83e22f61ae172d51'],0,4400,4400,1575073,31,0.395417591,0.823355506,0.888396157,3210
2d23b037be339748e82b895075d22d93fdc22e0b,0,Sarath Subramanian,2019-05-08 23:22:54-07:00,['3137bb2151abcc362008d7449f1e9a80d57b17a7'],5,0,5,1575078,1,,,,3210
73d2134ac773c6428e0d59647fb7721fbc014f31,0,nixonrodrigues,2019-05-09 14:16:35+05:18,['2d23b037be339748e82b895075d22d93fdc22e0b'],0,4,4,1575082,1,,,,3210
49db4cacbb07dd018876e77b872f483ef941a152,1,Ashutosh Mestry,2019-05-10 15:35:57-07:00,['73d2134ac773c6428e0d59647fb7721fbc014f31'],175,23,198,1575280,4,0.362068966,0.206896552,0.034482759,3210
f75d7f409f3323e799bb33e6ae1da89526fc475c,0,Sarath Subramanian,2019-05-11 16:21:38-07:00,['49db4cacbb07dd018876e77b872f483ef941a152'],26,28,54,1575334,1,0,1,0,3210
4e6339d8721e23bec7aabaafd28412497df2bb17,1,Sarath Subramanian,2019-05-13 11:59:37-07:00,['f75d7f409f3323e799bb33e6ae1da89526fc475c'],33,98,131,1575465,5,0,0.869565217,0.956521739,3210
b445dd1bc071bc5fbbe2addbc909f83770ecc6dc,1,Sarath Subramanian,2019-05-14 15:56:46-07:00,['4e6339d8721e23bec7aabaafd28412497df2bb17'],1,96,97,1575562,4,,,,3211
8fef5353cf533531ce9d66f7ab525beea80fcc5f,0,Madhan Neethiraj,2019-05-14 17:00:11-07:00,['b445dd1bc071bc5fbbe2addbc909f83770ecc6dc'],39,39,78,1575640,39,,,,3211
b0063fa54e59088a5ef72604113c55c6284ab337,1,Sarath Subramanian,2019-05-15 11:27:22-07:00,['8fef5353cf533531ce9d66f7ab525beea80fcc5f'],131,1647,1778,1577418,30,0.4,0.632911392,0.744303797,3221
f4574531cd950001966f245ebe4fd96b54bbd6e2,1,Ashutosh Mestry,2019-05-16 21:04:31-07:00,['b0063fa54e59088a5ef72604113c55c6284ab337'],69,76,145,1577563,4,0,0,1,3221
ff7415d8e45e5955764e522c28d9a914dfcc35f3,1,Sarath Subramanian,2019-05-17 12:12:49-07:00,['f4574531cd950001966f245ebe4fd96b54bbd6e2'],2,2,4,1577567,1,,,,3221
0c9bb699110386174deaa0c63d83efd4f609617e,1,kevalbhatt,2019-05-20 20:35:18+05:18,['ff7415d8e45e5955764e522c28d9a914dfcc35f3'],124,232,356,1577923,10,0.142857143,1,0.535714286,3221
8d30f75b0785a2704fe20dd8be5ff3afb8752ceb,1,kevalbhatt,2019-05-20 20:35:52+05:18,['0c9bb699110386174deaa0c63d83efd4f609617e'],50,141,191,1578114,2,0,1,1,3221
fce87e338ad3d7a9425f41c09f73968308e8ce83,0,Sarath Subramanian,2019-05-20 10:15:41-07:00,['8d30f75b0785a2704fe20dd8be5ff3afb8752ceb'],0,477,477,1578591,1,,,,3222
732b730c9e6242f7713af630269390171d169a28,0,Sarath Subramanian,2019-05-20 11:14:35-07:00,['fce87e338ad3d7a9425f41c09f73968308e8ce83'],12,12,24,1578615,1,,,,3222
4e4038f6e1dff1e5900a14cf306ea64817647b0a,0,Sarath Subramanian,2019-05-20 11:45:33-07:00,['732b730c9e6242f7713af630269390171d169a28'],5,38,43,1578658,3,1,0,1,3222
1ca6ee125529a033252bf74baafcf49685fc20ae,1,Sarath Subramanian,2019-05-20 15:08:31-07:00,['4e4038f6e1dff1e5900a14cf306ea64817647b0a'],13,467,480,1579138,8,0,0.369127517,0.724832215,3225
25c3bf9abc4ac893e67318855387be7c15a33fcc,1,Sarath Subramanian,2019-05-21 14:00:00-07:00,['1ca6ee125529a033252bf74baafcf49685fc20ae'],1,1,2,1579140,1,,,,3225
045c0c07180f320223ccf60caf7249fbe6d824bf,0,Sarath Subramanian,2019-05-22 13:35:24-07:00,['25c3bf9abc4ac893e67318855387be7c15a33fcc'],507,818,1325,1580465,23,0.414746544,0.976958525,0.912442396,3233
37b489ffc0e7af98cf478cf064243f11bef8ae8c,0,Sarath Subramanian,2019-05-22 15:55:01-07:00,['045c0c07180f320223ccf60caf7249fbe6d824bf'],0,0,0,1580465,17,,,,3233
da13d53a049eebd6de2fa34283f5ac01f184708d,1,nixonrodrigues,2019-05-23 17:05:49+05:18,['37b489ffc0e7af98cf478cf064243f11bef8ae8c'],31,29,60,1580525,3,0.928571429,1,1,3233
cc7d72dff2501589e3fb3619c0e84e69871a0452,1,nixonrodrigues,2019-05-23 17:06:01+05:18,['da13d53a049eebd6de2fa34283f5ac01f184708d'],0,2,2,1580527,1,,,,3233
51c377da6d8d51b7ccfc6f524ebfca1be4c93709,0,Sarath Subramanian,2019-05-23 12:06:44-07:00,['cc7d72dff2501589e3fb3619c0e84e69871a0452'],2,2,4,1580531,1,,,,3233
75ee78bfe66c8d2d64fd062bfe3db3629ae2fe53,1,Sarath Subramanian,2019-05-23 14:21:19-07:00,['51c377da6d8d51b7ccfc6f524ebfca1be4c93709'],12,12,24,1580555,1,,,,3233
512906934b1907441e1648f36d18d87f91d6db82,0,nixonrodrigues,2019-05-24 16:38:41+05:18,['75ee78bfe66c8d2d64fd062bfe3db3629ae2fe53'],1,3,4,1580559,1,1,1,1,3233
5196fd7122d09ccc3b0b65fb7bd0aab99379bf76,0,Sarath Subramanian,2019-05-24 14:08:12-07:00,['512906934b1907441e1648f36d18d87f91d6db82'],117,174,291,1580850,12,0,0,0,3234
14eb91a7d9638d6659d801e702b3f277cec2427d,0,Sarath Subramanian,2019-05-28 11:05:15-07:00,['5196fd7122d09ccc3b0b65fb7bd0aab99379bf76'],0,6,6,1580856,1,,,,3234
10e7be0fca1be50d750f484ecb0e23a35bcdf24b,0,Sarath Subramanian,2019-05-28 23:25:34-07:00,['14eb91a7d9638d6659d801e702b3f277cec2427d'],0,46,46,1580902,3,,,,3235
87075f8af69bb32a3521e6b8fad58dea05df76b2,1,nixonrodrigues,2019-05-29 18:55:49+05:18,['10e7be0fca1be50d750f484ecb0e23a35bcdf24b'],87,87,174,1581076,42,,,,3235
60b44a93c4033991d160b8d4ac1af7723b10d564,1,Sarath Subramanian,2019-05-29 12:46:09-07:00,['87075f8af69bb32a3521e6b8fad58dea05df76b2'],30,493,523,1581599,11,0.194444444,0.930555556,1,3237
93d51399a00759a4c225f06448c1211807afd9cf,0,Sarath Subramanian,2019-05-29 12:55:29-07:00,['60b44a93c4033991d160b8d4ac1af7723b10d564'],5,5,10,1581609,2,,,,3237
356017ef7da13daf64f2fb20e779d3862e9fe608,0,Sarath Subramanian,2019-05-29 19:04:34-07:00,['93d51399a00759a4c225f06448c1211807afd9cf'],1,1,2,1581611,1,,,,3237
4b6380feb454b0cc2f0186820b6f10f42b47e119,0,nixonrodrigues,2019-05-30 17:18:58+05:18,['356017ef7da13daf64f2fb20e779d3862e9fe608'],1,1,2,1581613,1,,,,3237
64c7a3befcc90566f59cb805d51df34bdc7edc74,1,Ashutosh Mestry,2019-05-31 10:52:42-07:00,['4b6380feb454b0cc2f0186820b6f10f42b47e119'],176,371,547,1582160,7,1,1,0.761904762,3239
e21f569f21736237dab8cb2bc8e34a232ee5fa9d,0,Sarath Subramanian,2019-05-31 11:01:03-07:00,['64c7a3befcc90566f59cb805d51df34bdc7edc74'],2,70,72,1582232,3,1,1,1,3240
be9df1c3f8895bdcc9949c97ab032b0051edd612,1,Sarath Subramanian,2019-05-31 11:23:55-07:00,['e21f569f21736237dab8cb2bc8e34a232ee5fa9d'],9,98,107,1582339,2,0.333333333,1,1,3240
a92ddec05d0ae0d2fe87d931e3dcfa287c60e7f6,0,Madhan Neethiraj,2019-06-01 10:14:47-07:00,['be9df1c3f8895bdcc9949c97ab032b0051edd612'],10,42,52,1582391,2,0.578947368,0.578947368,1,3240
e4f0b09e216360022f004126efcc2670c1038136,0,Madhan Neethiraj,2019-06-01 13:17:29-07:00,['a92ddec05d0ae0d2fe87d931e3dcfa287c60e7f6'],56,36,92,1582483,1,1,1,0.473684211,3240
2f461b4217df7e1f6fcded17c83fc9ff7670a6d5,1,Sarath Subramanian,2019-06-03 13:20:10-07:00,['e4f0b09e216360022f004126efcc2670c1038136'],51,197,248,1582731,9,0.333333333,0.9375,0.875,3240
eced9a6945934a9930de137976b744ca2aeacec3,0,nixonrodrigues,2019-06-04 11:19:13+05:18,['2f461b4217df7e1f6fcded17c83fc9ff7670a6d5'],3,5,8,1582739,2,0.5,0.5,1,3240
af25456d7a2110d27295c1249cec3795bfb5b51e,1,nixonrodrigues,2019-06-04 11:20:07+05:18,['eced9a6945934a9930de137976b744ca2aeacec3'],1,8,9,1582748,1,,,,3240
2968ad86de1de9e70c9c852ab55935129d38ab40,0,Sarath Subramanian,2019-06-04 00:15:32-07:00,['af25456d7a2110d27295c1249cec3795bfb5b51e'],2,3,5,1582753,1,0,1,1,3240
c34e2411e9341871405f1520df99e88616362372,0,Sarath Subramanian,2019-06-04 07:59:11-07:00,['2968ad86de1de9e70c9c852ab55935129d38ab40'],1,1,2,1582755,1,,,,3240
8b722eb87128660d3810535e206b693fc8f9419f,0,Sarath Subramanian,2019-06-04 08:01:05-07:00,['c34e2411e9341871405f1520df99e88616362372'],0,0,0,1582755,1,,,,3240
17803eed8adfaa3c68b7de806085797b751eeec9,1,Madhan Neethiraj,2019-06-05 17:45:14-07:00,['8b722eb87128660d3810535e206b693fc8f9419f'],131,319,450,1583205,11,0.989795918,1,0.93877551,3242
ebeb0c9882b844c71382f2a1193dbf0e10c876db,0,nixonrodrigues,2019-06-06 11:48:04+05:18,['17803eed8adfaa3c68b7de806085797b751eeec9'],2,4,6,1583211,1,0,0,0,3242
ab8b75640d5a7c28b1d048a569c43d9192a024de,1,nixonrodrigues,2019-06-06 17:28:25+05:18,['ebeb0c9882b844c71382f2a1193dbf0e10c876db'],1,23,24,1583235,2,0.5,0,1,3242
40081d4853ae9923e601f62c150c165f1cea902d,1,Madhan Neethiraj,2019-06-07 10:30:02-07:00,['ab8b75640d5a7c28b1d048a569c43d9192a024de'],4,48,52,1583287,3,0,0,1,3242
b9481410bb667c0297ec9fe84c4693f7aec8c4be,1,Madhan Neethiraj,2019-06-07 15:18:50-07:00,['40081d4853ae9923e601f62c150c165f1cea902d'],236,381,617,1583904,18,0.471428571,0.242857143,0.457142857,3243
5d77aba316842976da13290431592fea249b7151,0,Madhan Neethiraj,2019-06-08 07:00:35-07:00,['b9481410bb667c0297ec9fe84c4693f7aec8c4be'],6,6,12,1583916,1,,,,3243
cad4f87f60cae95623cf1805d5f3cc24f9850a06,0,kevalbhatt,2019-06-10 16:07:42+05:18,['5d77aba316842976da13290431592fea249b7151'],0,0,0,1583916,44,,,,3249
c24029bfba137503bbe19c0a3d79446709ceecb8,1,kevalbhatt,2019-06-10 16:08:25+05:18,['cad4f87f60cae95623cf1805d5f3cc24f9850a06'],7,14,21,1583937,1,0,1,1,3249
c8f525bf1b1d2dfbab6ddd9afbb19015e175aa34,1,Sarath Subramanian,2019-06-10 10:44:43-07:00,['c24029bfba137503bbe19c0a3d79446709ceecb8'],104,358,462,1584399,20,0.92,0.89,1,3249
e230aad8736ffed966915403821d7c3d2f29cc9b,0,Sarath Subramanian,2019-06-10 15:46:25-07:00,['c8f525bf1b1d2dfbab6ddd9afbb19015e175aa34'],2,2,4,1584403,1,,,,3249
f2cb641e36678c508ed2e952f9d35040b80ec12b,0,Sarath Subramanian,2019-06-11 15:52:36-07:00,['e230aad8736ffed966915403821d7c3d2f29cc9b'],16,73,89,1584492,2,0.320754717,0.981132075,1,3249
13675409773a666cd04047e0be6dc4759db4a6c0,1,Madhan Neethiraj,2019-06-12 02:19:25-07:00,['f2cb641e36678c508ed2e952f9d35040b80ec12b'],103,1130,1233,1585725,18,0.409292035,0.595132743,0.966814159,3257
6e5bbc5090fdc2831ab2b7e37a39cf9fc9122850,0,nixonrodrigues,2019-06-12 16:30:02+05:18,['13675409773a666cd04047e0be6dc4759db4a6c0'],0,18,18,1585743,2,,,,3257
6e2d15d963b434426b62ac371fc25bdfcfffece2,0,kevalbhatt,2019-06-13 15:16:04+05:18,['6e5bbc5090fdc2831ab2b7e37a39cf9fc9122850'],0,0,0,1585743,2,,,,3257
a097bed3f927d040cbdc9327511b8b1c5d9c7a9b,1,Madhan Neethiraj,2019-06-13 11:20:50-07:00,['6e2d15d963b434426b62ac371fc25bdfcfffece2'],1,75,76,1585819,3,0.9375,1,1,3258
2bd6f4691dd733b4c204f3f1df4e3de0e31fdb42,0,Sarath Subramanian,2019-06-13 14:06:17-07:00,['a097bed3f927d040cbdc9327511b8b1c5d9c7a9b'],23,83,106,1585925,3,0,0.977777778,1,3258
9f71b529f0c600374bf4b3590ebf87cafec2fd31,0,nixonrodrigues,2019-06-14 15:14:59+05:18,['2bd6f4691dd733b4c204f3f1df4e3de0e31fdb42'],0,0,0,1585925,1,,,,3259
66c2964e05f8421d8dfb395f1f0cf61d1f33a8e4,1,Madhan Neethiraj,2019-06-16 12:58:05-07:00,['9f71b529f0c600374bf4b3590ebf87cafec2fd31'],24,76,100,1586025,2,0.375,0.375,0.15,3259
3f67eb3cd73d445b5d35b29df697564ecf32a345,0,kevalbhatt,2019-06-17 18:00:53+05:18,['66c2964e05f8421d8dfb395f1f0cf61d1f33a8e4'],0,2,2,1586027,1,1,1,1,3259
4e1eeb4cdcd8bc0601564434176eb200b2811c2e,0,Sarath Subramanian,2019-06-17 11:32:10-07:00,['3f67eb3cd73d445b5d35b29df697564ecf32a345'],19,10,29,1586056,3,1,0,0,3259
9062e2c861628d227f0c2616c5c84f2f90af9214,1,Sarath Subramanian,2019-06-17 13:28:33-07:00,['4e1eeb4cdcd8bc0601564434176eb200b2811c2e'],134,242,376,1586432,8,0.633027523,1,1,3259
59648d289ee8a8c36c1f8e4ba7f3807418a64639,0,Madhan Neethiraj,2019-06-17 16:06:00-07:00,['9062e2c861628d227f0c2616c5c84f2f90af9214'],77,90,167,1586599,2,0.538461538,0,0.692307692,3259
63779893e14f71233eb3d1f1ebec40db5ee33319,0,Sarath Subramanian,2019-06-18 11:59:17-07:00,['59648d289ee8a8c36c1f8e4ba7f3807418a64639'],1,18,19,1586618,4,,,,3259
1c399cc7121fc2f68f50675f804e6cc21b7a5bf5,0,Sarath Subramanian,2019-06-18 23:57:27-07:00,['63779893e14f71233eb3d1f1ebec40db5ee33319'],2,164,166,1586784,5,0,0.543859649,1,3260
08b76391cfb8fd231218e5788261e5f2310703cc,1,nixonrodrigues,2019-06-20 15:18:28+05:18,['1c399cc7121fc2f68f50675f804e6cc21b7a5bf5'],197,821,1018,1587802,8,0.824742268,0.821305842,1,3265
8cd7496566ddbeb843018a039e46e4de38402f7d,0,nixonrodrigues,2019-06-20 15:18:58+05:18,['08b76391cfb8fd231218e5788261e5f2310703cc'],16,17,33,1587835,6,1,,,3265
ea0f6d275a8b35a5d37c297653fc2d8d7ae3c24b,0,Nixon Rodrigues,2019-06-21 11:10:39+05:18,['8cd7496566ddbeb843018a039e46e4de38402f7d'],1,1,2,1587837,1,,,,3265
37e441c11ba55b4c71650ade63d996334b3c8d37,1,kevalbhatt,2019-06-21 14:35:15+05:18,['ea0f6d275a8b35a5d37c297653fc2d8d7ae3c24b'],5,39,44,1587881,3,0.233333333,0.266666667,0.733333333,3265
4ce1e370d3ac07f24e956e15ac140a49cae499ad,0,Madhan Neethiraj,2019-06-21 14:39:33-07:00,['37e441c11ba55b4c71650ade63d996334b3c8d37'],229,226,455,1588336,12,,,,3271
1d2aad52f1053ac03edad78f9568d62010617a97,0,Madhan Neethiraj,2019-06-22 11:46:09-07:00,['4ce1e370d3ac07f24e956e15ac140a49cae499ad'],2,7,9,1588345,1,0,0,0,3271
c5b06aaa4207dd4337a7d9fb56352602b71c611d,0,Nixon Rodrigues,2019-06-24 11:47:11+05:18,['1d2aad52f1053ac03edad78f9568d62010617a97'],2,1,3,1588348,1,0,0,0,3271
bf1fa0a13b0e6e637a4224e541bca75aa0bb5b78,1,Nixon Rodrigues,2019-06-24 14:01:49+05:18,['c5b06aaa4207dd4337a7d9fb56352602b71c611d'],7,9,16,1588364,1,,,,3271
eb205d2798b24ffd3056b691f2ffb27d1eb50967,0,kevalbhatt,2019-06-24 17:03:55+05:18,['bf1fa0a13b0e6e637a4224e541bca75aa0bb5b78'],1,1,2,1588366,1,,,,3271
569d55968ec3f31bfa32fcd4492fbb201aa8e35d,1,Sarath Subramanian,2019-06-24 12:16:20-07:00,['eb205d2798b24ffd3056b691f2ffb27d1eb50967'],1,1,2,1588368,1,,,,3271
66390fe8467b1c199d3769800703fb99f676cf22,1,kevalbhatt,2019-06-25 10:55:03+05:18,['569d55968ec3f31bfa32fcd4492fbb201aa8e35d'],117,207,324,1588692,8,1,1,1,3271
f82e42f011be43b57e8980f5870af785b4c51307,0,kevalbhatt,2019-06-25 16:44:02+05:18,['66390fe8467b1c199d3769800703fb99f676cf22'],0,44,44,1588736,2,,,,3271
ab7c8cd514bf3f911113d20b8b45dc4609401435,0,Nixon Rodrigues,2019-06-26 18:08:56+05:18,['f82e42f011be43b57e8980f5870af785b4c51307'],3,3,6,1588742,1,,,,3271
004b7e784f5a1bb3bbad0a86cb557b766287288f,0,kevalbhatt,2019-06-27 14:58:28+05:18,['ab7c8cd514bf3f911113d20b8b45dc4609401435'],31,6,37,1588779,2,,,,3271
2a2c4a5e3e83bf0eaae1d82e1746fc5c8b0b78b3,0,kevalbhatt,2019-06-28 16:19:20+05:18,['004b7e784f5a1bb3bbad0a86cb557b766287288f'],1,1,2,1588781,1,,,,3271
2c375b08a52ac8d1039abb4b612a41cb9d89b420,0,Sarath Subramanian,2019-07-02 21:48:29-07:00,['2a2c4a5e3e83bf0eaae1d82e1746fc5c8b0b78b3'],4,2,6,1588787,1,,,,3271
645bc94e59969d08b81e7af7a5a2db78207ab3fe,1,nixonrodrigues,2019-07-04 19:13:31+05:18,['2c375b08a52ac8d1039abb4b612a41cb9d89b420'],15,298,313,1589100,6,0.368852459,0.950819672,0.975409836,3272
e7071476aaba064d0967531cda6d9221f918db4e,0,nixonrodrigues,2019-07-05 14:46:51+05:18,['645bc94e59969d08b81e7af7a5a2db78207ab3fe'],0,2,2,1589102,1,,,,3272
eb513c315607946825831f2f80542b02b9476213,1,nixonrodrigues,2019-07-05 14:52:02+05:18,['e7071476aaba064d0967531cda6d9221f918db4e'],0,4,4,1589106,1,0,1,1,3272
ce5b6d7fea167b880b279076b2498c0786a5b4fd,1,Sarath Subramanian,2019-07-05 15:18:04-07:00,['eb513c315607946825831f2f80542b02b9476213'],0,3,3,1589109,1,0,0,1,3272
a7d8044920a81f3dbb0b8e688ddecf68505998f8,1,Madhan Neethiraj,2019-07-05 16:27:21-07:00,['ce5b6d7fea167b880b279076b2498c0786a5b4fd'],290,1793,2083,1591192,37,0.545586107,0.752532562,0.798842258,3287
d17307e431d4644cbb9a7770bc2faeca5d131714,0,Madhan Neethiraj,2019-07-05 21:45:56-07:00,['a7d8044920a81f3dbb0b8e688ddecf68505998f8'],0,0,0,1591192,6,,,,3287
4749e7a1c04ab08ffc5f8d582ca5de3c35b81ecb,0,nixonrodrigues,2019-07-09 14:38:05+05:18,['d17307e431d4644cbb9a7770bc2faeca5d131714'],0,4,4,1591196,1,,,,3287
d1262e995190834cca069ea365472fc61f17494f,0,Madhan Neethiraj,2019-07-10 07:06:03-07:00,['4749e7a1c04ab08ffc5f8d582ca5de3c35b81ecb'],51,51,102,1591298,8,,,,3287
5c0025177e6520564921c46d9a442e7da6f162c5,1,nixonrodrigues,2019-07-10 19:46:50+05:18,['d1262e995190834cca069ea365472fc61f17494f'],48,89,137,1591435,5,0.555555556,0.888888889,0.944444444,3287
8188a96e2aa3114502098eced91edfe3b1fb3674,0,Ashutosh Mestry,2019-07-10 09:00:59-07:00,['5c0025177e6520564921c46d9a442e7da6f162c5'],14,54,68,1591503,2,0.636363636,1,1,3287
d59c0d08fbc1f815608807d8dc76dbf8c8b3372d,0,kevalbhatt,2019-07-11 14:26:24+05:18,['8188a96e2aa3114502098eced91edfe3b1fb3674'],7,1,8,1591511,1,1,1,1,3287
47d4d588f2ed70396bb64b80c6362d8115350339,1,Madhan Neethiraj,2019-07-11 17:15:21-07:00,['d59c0d08fbc1f815608807d8dc76dbf8c8b3372d'],158,372,530,1592041,14,0.666666667,0.689922481,0.604651163,3287
5a443e17fb81def5dd41eaf62ab0f0ee9676cc14,1,kevalbhatt,2019-07-12 12:35:02+05:18,['47d4d588f2ed70396bb64b80c6362d8115350339'],10,18,28,1592069,3,0,0,0,3287
25e2e461a663418fa97aa3413fd4efdf798b1acc,0,kevalbhatt,2019-07-12 14:10:19+05:18,['5a443e17fb81def5dd41eaf62ab0f0ee9676cc14'],1,1,2,1592071,1,,,,3287
ef4025160dd456f3ac67ef39551ba280925a6a94,1,Sarath Subramanian,2019-07-12 14:22:55-07:00,['25e2e461a663418fa97aa3413fd4efdf798b1acc'],318,336,654,1592725,22,0.952380952,1,0.904761905,3287
519fc2bf495c89fef7d2eb20403c436456e1cbc3,0,Madhan Neethiraj,2019-07-13 00:31:43-07:00,['ef4025160dd456f3ac67ef39551ba280925a6a94'],3,76,79,1592804,4,0.928571429,1,1,3288
49aa29d54a3475c6ab26fe6254268c7138daaa7b,0,Madhan Neethiraj,2019-07-13 01:12:38-07:00,['519fc2bf495c89fef7d2eb20403c436456e1cbc3'],76,76,152,1592956,4,,,,3288
549dee6b6a488da4e5aa75b0927855889e1eb59f,1,Madhan Neethiraj,2019-07-13 10:26:44-07:00,['49aa29d54a3475c6ab26fe6254268c7138daaa7b'],22,24,46,1593002,3,1,1,0,3288
ad7e0401277bcd3f0126a15bc2593d56fd8683e2,0,Sarath Subramanian,2019-07-14 22:37:11-07:00,['549dee6b6a488da4e5aa75b0927855889e1eb59f'],3,7,10,1593012,1,,,,3288
2c612bb8bebf5fd5f5e574385336d45acb17a154,0,Sarath Subramanian,2019-07-14 22:42:34-07:00,['ad7e0401277bcd3f0126a15bc2593d56fd8683e2'],2,2,4,1593016,1,,,,3288
3ad9016cd6f8fba0426262c90e5a97fe795d3843,1,nixonrodrigues,2019-07-15 15:45:32+05:18,['2c612bb8bebf5fd5f5e574385336d45acb17a154'],10,11,21,1593037,2,,,,3288
c1f95d172db383c865a6d70bb5d1d1af3f329c50,1,Sarath Subramanian,2019-07-15 16:42:42-07:00,['3ad9016cd6f8fba0426262c90e5a97fe795d3843'],2,2,4,1593041,1,,,,3288
23eacbafcea2e58378271fa6dc7b56be08b7cac7,0,Madhan Neethiraj,2019-07-15 17:58:06-07:00,['c1f95d172db383c865a6d70bb5d1d1af3f329c50'],23,219,242,1593283,4,0.393939394,0.234848485,0.765151515,3288
85f9b502e883d3d4870dd201c98aee257a3efa1a,0,Sarath Subramanian,2019-07-15 20:34:24-07:00,['23eacbafcea2e58378271fa6dc7b56be08b7cac7'],48,466,514,1593797,10,0.130232558,0.451162791,1,3292
36459c7829c02d92a2af76bc1ea7de31e34bbd67,1,Madhan Neethiraj,2019-07-16 23:43:50-07:00,['85f9b502e883d3d4870dd201c98aee257a3efa1a'],13,18,31,1593828,1,0,0,1,3292
d52369ef11adce09a2585777cdda39dca447d202,0,Madhan Neethiraj,2019-07-17 00:47:29-07:00,['36459c7829c02d92a2af76bc1ea7de31e34bbd67'],7,8,15,1593843,1,0,1,1,3292
8ada5d400ea994a0ffd3c67fa0f66719de1e4138,1,nixonrodrigues,2019-07-17 13:58:59+05:18,['d52369ef11adce09a2585777cdda39dca447d202'],2,118,120,1593963,4,0.955223881,0.955223881,0.776119403,3292
9f2e57f0d2717c8fd5e32fceab3edf64ce921fa8,0,Sarath Subramanian,2019-07-17 12:36:09-07:00,['8ada5d400ea994a0ffd3c67fa0f66719de1e4138'],0,5,5,1593968,1,,,,3292
93addf064bf1bbfc1c847b7801845a9c7e39bc7c,0,Sarath Subramanian,2019-07-17 12:37:24-07:00,['9f2e57f0d2717c8fd5e32fceab3edf64ce921fa8'],4,4,8,1593976,2,,,,3292
7fcf04159887d4719631e8e3d54f4297e17f4c4d,0,Sarath Subramanian,2019-07-17 13:48:34-07:00,['93addf064bf1bbfc1c847b7801845a9c7e39bc7c'],8,35,43,1594019,2,0.428571429,0,1,3292
ca62d8659db632954ed28e35f3a5e7d27d3fe8b4,0,nixonrodrigues,2019-07-18 18:36:38+05:18,['7fcf04159887d4719631e8e3d54f4297e17f4c4d'],61,80,141,1594160,7,1,1,1,3292
bd31c50539c7b4df5fb43065844a007ce68a0106,0,Madhan Neethiraj,2019-07-18 06:48:04-07:00,['ca62d8659db632954ed28e35f3a5e7d27d3fe8b4'],19,16,35,1594195,1,1,0,0,3292
709db096badfad3c17cf3adf9d65585bf1c0bc04,0,Madhan Neethiraj,2019-07-18 18:15:25-07:00,['bd31c50539c7b4df5fb43065844a007ce68a0106'],5,29,34,1594229,2,1,1,1,3292
74bfe9478ed26d917d5da77e02309d8b7b4299f9,0,Sarath Subramanian,2019-07-19 11:18:34-07:00,['709db096badfad3c17cf3adf9d65585bf1c0bc04'],9,17,26,1594255,2,,,,3292
c9becac21d60b0056dbebc4a1335151619be6d81,1,Sarath Subramanian,2019-07-22 16:31:23-07:00,['74bfe9478ed26d917d5da77e02309d8b7b4299f9'],0,2,2,1594257,1,0,0,1,3292
243e1562d2e695d7ff7614d1e5e4af4b6c6734ed,0,Sarath Subramanian,2019-07-23 15:12:50-07:00,['c9becac21d60b0056dbebc4a1335151619be6d81'],0,8,8,1594265,1,,,,3292
c9af474a4d141c4214e1d7bf4b891b033890bb98,0,nixonrodrigues,2019-07-24 17:38:36+05:18,['243e1562d2e695d7ff7614d1e5e4af4b6c6734ed'],2,2,4,1594269,1,,,,3292
a876e697c3c0c936e7efc33cecbe1e1c32a6be20,0,Sarath Subramanian,2019-07-24 14:26:53-07:00,['c9af474a4d141c4214e1d7bf4b891b033890bb98'],2,2,4,1594273,1,,,,3292
6d71f14a6e099ce8f4e2a2f16d8e5d5bc4579995,0,nixonrodrigues,2019-07-25 17:31:01+05:18,['a876e697c3c0c936e7efc33cecbe1e1c32a6be20'],43,49,92,1594365,6,0.277777778,0,0.722222222,3292
f54cff2fddd4ea24547ded204f80ce4af49bca3b,0,Sarath Subramanian,2019-07-28 17:09:41-07:00,['6d71f14a6e099ce8f4e2a2f16d8e5d5bc4579995'],39,45,84,1594449,7,0,1,1,3292
7054e2b1adb928ee9180a71990f1e33a11c77883,0,Sarath Subramanian,2019-07-28 23:39:58-07:00,['f54cff2fddd4ea24547ded204f80ce4af49bca3b'],2,4,6,1594455,2,0,1,1,3292
854a8a012fac73b68c2458cd92ca7026aef1f03d,0,Sarath Subramanian,2019-07-29 16:34:14-07:00,['7054e2b1adb928ee9180a71990f1e33a11c77883'],35,113,148,1594603,6,0,1,0.979591837,3292
620861e313478faa9966fbbd89ff26b3fdd41deb,0,nixonrodrigues,2019-07-30 14:14:44+05:18,['854a8a012fac73b68c2458cd92ca7026aef1f03d'],2,95,97,1594700,2,0.622222222,0.688888889,0.488888889,3292
6598c749f18a7bcd40d1c0a434d8c06a68deaa72,0,Madhan Neethiraj,2019-07-31 10:51:29-07:00,['620861e313478faa9966fbbd89ff26b3fdd41deb'],38,510,548,1595248,8,0.06744868,0,1,3292
7b0a0e1294f9ee91e269aa4bd970e54ab42df779,1,Ashutosh Mestry,2019-07-31 15:59:16-07:00,['6598c749f18a7bcd40d1c0a434d8c06a68deaa72'],0,17,17,1595265,2,0,0,1,3292
b5189194952c73ce77d4c935b4d00a9a2d16684d,0,Ashutosh Mestry,2019-07-31 16:05:19-07:00,['7b0a0e1294f9ee91e269aa4bd970e54ab42df779'],0,3,3,1595268,1,0,0.666666667,1,3292
84be259863b4447f2bb898cc431bfb55e059b805,0,Ashutosh Mestry,2019-08-01 08:58:49-07:00,['b5189194952c73ce77d4c935b4d00a9a2d16684d'],4,4,8,1595276,1,,,,3292
f0b0b951059c7ea792060498e3933852ac2094ab,0,Sarath Subramanian,2019-08-03 10:41:43-07:00,['84be259863b4447f2bb898cc431bfb55e059b805'],5,7,12,1595288,1,0,1,1,3292
fb54a29db5a3a454f237341e7be60fb2f12de5fc,0,Sarath Subramanian,2019-08-04 23:54:43-07:00,['f0b0b951059c7ea792060498e3933852ac2094ab'],2,27,29,1595317,1,0,1,1,3292
f912aa89901d748df0f31d5c7d411b69a709670d,0,Ashutosh Mestry,2019-08-05 11:28:49-07:00,['fb54a29db5a3a454f237341e7be60fb2f12de5fc'],8,1,9,1595326,1,0.5,0,0,3292
8127189c4eff04fb9ffcf96c0e2989b51052fa0b,1,Sarath Subramanian,2019-08-05 14:35:44-07:00,['f912aa89901d748df0f31d5c7d411b69a709670d'],49,113,162,1595488,8,0.418604651,0.906976744,0.930232558,3292
5b8b16eb78a79e53450fc88d04a40530d2fd8731,0,nixonrodrigues,2019-08-08 14:17:24+05:18,['8127189c4eff04fb9ffcf96c0e2989b51052fa0b'],19,130,149,1595637,6,0.6,0.733333333,1,3293
add9fac419addf164fcfe1a35535080ca8b67543,0,Sarath Subramanian,2019-08-08 11:25:22-07:00,['5b8b16eb78a79e53450fc88d04a40530d2fd8731'],6,132,138,1595775,2,0.247191011,0.797752809,0.898876404,3293
9afe462295b4cfb246d3dea19d4b7837ac09fe5d,0,nixonrodrigues,2019-08-12 14:23:57+05:18,['add9fac419addf164fcfe1a35535080ca8b67543'],2,7,9,1595784,2,1,1,1,3293
ae4305d624ba82d7cd2af607c1c229177ededfc2,0,Sarath Subramanian,2019-08-12 17:51:18-07:00,['9afe462295b4cfb246d3dea19d4b7837ac09fe5d'],3,2,5,1595789,2,,,,3293
b8af8c90abe96e5921f0c54ac383a0cb448b1426,0,Sarath Subramanian,2019-08-12 23:21:15-07:00,['ae4305d624ba82d7cd2af607c1c229177ededfc2'],9,9,18,1595807,1,0,1,0,3293
921f487b043f801e70427e98e2d4ae9a8ff877dd,0,nixonrodrigues,2019-08-13 12:36:33+05:18,['b8af8c90abe96e5921f0c54ac383a0cb448b1426'],6,68,74,1595881,2,1,1,0.157894737,3293
5ee49fde2a1ec31e587c2123b823e3464bbada5e,0,Sarath Subramanian,2019-08-14 12:01:49-07:00,['921f487b043f801e70427e98e2d4ae9a8ff877dd'],0,4,4,1595885,1,0,0,1,3293
0a6d098c8f88bc6e51632901674b4d45dd472d5d,1,Sarath Subramanian,2019-08-14 14:12:48-07:00,['5ee49fde2a1ec31e587c2123b823e3464bbada5e'],0,12,12,1595897,2,0.625,0.625,0.625,3293
4b7b1a998085303a98cde198476679f5b27b0917,1,Madhan Neethiraj,2019-08-15 09:37:05-07:00,['0a6d098c8f88bc6e51632901674b4d45dd472d5d'],32,68,100,1595997,4,0.222222222,0,1,3293
2223c82c60b791ae2b66f6d78e1289ebe519cfa4,1,Ashutosh Mestry,2019-08-16 10:28:14-07:00,['4b7b1a998085303a98cde198476679f5b27b0917'],551,720,1271,1597268,22,0.227272727,0.734848485,0.325757576,3293
d1109efefd062613556d8bac47498ad0925b01b0,0,Sarath Subramanian,2019-08-16 17:45:12-07:00,['2223c82c60b791ae2b66f6d78e1289ebe519cfa4'],44,42,86,1597354,1,0,1,0,3293
8c136a86fc125672e054bc5bcfdd65f8230ae07c,1,Ashutosh Mestry,2019-08-19 12:24:20-07:00,['d1109efefd062613556d8bac47498ad0925b01b0'],3,4,7,1597361,1,,,,3293
b96ce272d42283a3ee67e984d919c21bb65b587d,0,Sarath Subramanian,2019-08-19 14:52:20-07:00,['8c136a86fc125672e054bc5bcfdd65f8230ae07c'],1,4,5,1597366,2,0,1,1,3293
6fbda5bcee4d9a06fc83cd80533a9971b88bb417,1,nixonrodrigues,2019-08-21 11:03:51+05:18,['b96ce272d42283a3ee67e984d919c21bb65b587d'],5,7,12,1597378,2,0,0.666666667,1,3293
fdbc36e803cd85bfcb987991654351d76071a273,1,kevalbhatt,2019-08-21 15:58:25+05:18,['6fbda5bcee4d9a06fc83cd80533a9971b88bb417'],41,123,164,1597542,7,0.1875,1,1,3293
6677c80d71c1fedda535e5e6cd8f11b31126d2ff,1,kevalbhatt,2019-08-21 16:07:52+05:18,['fdbc36e803cd85bfcb987991654351d76071a273'],11,7,18,1597560,1,1,0,0,3293
a310bc2984b40acede1b8c346da0098591f7a61c,0,kevalbhatt,2019-08-21 20:19:11+05:18,['6677c80d71c1fedda535e5e6cd8f11b31126d2ff'],326,288,614,1598174,19,,,,3293
952d069645342cbde63a66eaafd34af59dd9420f,1,kevalbhatt,2019-08-21 20:19:28+05:18,['a310bc2984b40acede1b8c346da0098591f7a61c'],25,43,68,1598242,5,1,0.571428571,1,3293
0d5c22298cacdf95531757048fd4b1596ed3b044,0,Sarath Subramanian,2019-08-21 20:24:35-07:00,['952d069645342cbde63a66eaafd34af59dd9420f'],1,3,4,1598246,1,0,1,1,3293
7cf19213f9faf208dae7320f9c54012dcc6caeec,0,Sarath Subramanian,2019-08-22 21:52:11-07:00,['0d5c22298cacdf95531757048fd4b1596ed3b044'],1,5,6,1598252,1,0,1,1,3293
235acae0a040dac438c77e137f6f3e62b2e7e49e,0,Sarath Subramanian,2019-09-04 20:36:27-07:00,['7cf19213f9faf208dae7320f9c54012dcc6caeec'],1,1,2,1598254,1,,,,3293
ec7b8245c14654c5f1dc4e6f412564d3b527c3e0,0,kevalbhatt,2019-09-05 11:16:55+05:18,['235acae0a040dac438c77e137f6f3e62b2e7e49e'],23,44,67,1598321,1,,,,3293
b24f88ecd70d73a8ca8752417317537eb3207343,1,Sarath Subramanian,2019-09-08 16:11:03-07:00,['ec7b8245c14654c5f1dc4e6f412564d3b527c3e0'],87,176,263,1598584,16,0.438202247,0.550561798,0.865168539,3293
f36fecdfb0d3f40c6863068237e2812f15a5b23f,1,kevalbhatt,2019-09-09 10:47:17+05:18,['b24f88ecd70d73a8ca8752417317537eb3207343'],5059,43104,48163,1646747,315,0.590515619,0.778039142,0.905297328,3591
331fb430e86d27e30f8640f54e9774f6600761c9,0,nixonrodrigues,2019-09-09 14:00:15+05:18,['f36fecdfb0d3f40c6863068237e2812f15a5b23f'],14,87,101,1646848,9,0.823529412,1,0.862745098,3591
b823084aadd870f8f14df8f01838fac8347e72bb,0,Sarath Subramanian,2019-09-09 10:34:06-07:00,['331fb430e86d27e30f8640f54e9774f6600761c9'],1,1,2,1646850,1,,,,3591
c9446eec8ca3d048682703a2980504e66160a47f,0,kevalbhatt,2019-09-10 14:05:38+05:18,['b823084aadd870f8f14df8f01838fac8347e72bb'],0,2,2,1646852,2,,,,3591
8bad6b0b6724f15ec6173769bccd33184d842f8e,1,Ashutosh Mestry,2019-09-10 15:10:00-07:00,['c9446eec8ca3d048682703a2980504e66160a47f'],119,670,789,1647641,20,0.692307692,1,0.989966555,3592
e6b9e9ad25b3b0538c0f864ab534cd16e9dd91b9,0,Ashutosh Mestry,2019-09-12 13:46:12-07:00,['8bad6b0b6724f15ec6173769bccd33184d842f8e'],1,2,3,1647644,1,,,,3592
8792f162dfea3d471c7a0f5672984462ee434fba,1,Ashutosh Mestry,2019-09-12 13:48:53-07:00,['e6b9e9ad25b3b0538c0f864ab534cd16e9dd91b9'],4,36,40,1647684,3,0,0.666666667,1,3592
314f49372d913532e29d8a3ec0494bb1f2f2d2fc,0,Sarath Subramanian,2019-09-13 16:32:35-07:00,['8792f162dfea3d471c7a0f5672984462ee434fba'],7,40,47,1647731,12,,,,3592
3eadf7e875f810713b3a11a8e49ab2054128ac93,0,Madhan Neethiraj,2019-09-14 09:24:06-07:00,['314f49372d913532e29d8a3ec0494bb1f2f2d2fc'],3,10,13,1647744,3,,,,3592
5ab09475e097af72f70694518bb65bb6ac0d868d,1,Madhan Neethiraj,2019-09-15 11:54:33-07:00,['3eadf7e875f810713b3a11a8e49ab2054128ac93'],2,41,43,1647787,8,0.791666667,0.791666667,0.791666667,3592
660b91af5854ea09582a56662e0361f5af6ab759,1,Sarath Subramanian,2019-09-16 11:57:08-07:00,['5ab09475e097af72f70694518bb65bb6ac0d868d'],6,35,41,1647828,1,0,0.956521739,1,3592
71d9c6f35a69a0b3752ce5ca04edb588ec3d319e,0,nixonrodrigues,2019-09-18 18:20:21+05:18,['660b91af5854ea09582a56662e0361f5af6ab759'],5,5,10,1647838,2,0,0,0,3592
43a5068429ae7da48f09ba1f124b4acbb53e3901,0,nixonrodrigues,2019-09-18 18:24:52+05:18,['71d9c6f35a69a0b3752ce5ca04edb588ec3d319e'],4,4,8,1647846,2,0,0,0,3592
b6f35bf9151bbd92c3c47679945e4d1628220af0,0,Sarath Subramanian,2019-09-18 14:39:42-07:00,['43a5068429ae7da48f09ba1f124b4acbb53e3901'],10,28,38,1647884,4,0.8,0.9,1,3592
d16e960bea9cd17b3fe45231bec82cdaf023912e,0,nixonrodrigues,2019-09-19 15:11:11+05:18,['b6f35bf9151bbd92c3c47679945e4d1628220af0'],0,0,0,1647884,2,,,,3594
b98aa7338b96ce0b37be310c345ef2cfc3aca86d,0,nixonrodrigues,2019-09-19 16:40:17+05:18,['d16e960bea9cd17b3fe45231bec82cdaf023912e'],0,0,0,1647884,2,,,,3594
94118657d697b36a69a1f40c919f6f05b8631d8c,0,nixonrodrigues,2019-09-19 16:43:01+05:18,['b98aa7338b96ce0b37be310c345ef2cfc3aca86d'],0,0,0,1647884,2,,,,3596
15e5bedbe470677ab8a8de4ecfa76c55f852c4e7,1,Sarath Subramanian,2019-09-19 18:07:36-07:00,['94118657d697b36a69a1f40c919f6f05b8631d8c'],39,74,113,1647997,2,0,0.379310345,1,3596
6b1004105c29717cca1d1f38fd77d2e28ceff24c,1,Sarath Subramanian,2019-09-20 07:07:24-07:00,['15e5bedbe470677ab8a8de4ecfa76c55f852c4e7'],73,251,324,1648321,12,0.479452055,0.863013699,1,3597
1c781deb40c23c79c2cf201b70b79a34b0b2acbe,1,nixonrodrigues,2019-09-20 19:30:01+05:18,['6b1004105c29717cca1d1f38fd77d2e28ceff24c'],12,461,473,1648794,6,0.714953271,0.803738318,0.686915888,3599
c31f14408a614d85eb381ad7eea0458d7747de35,1,Madhan Neethiraj,2019-09-20 09:45:30-07:00,['1c781deb40c23c79c2cf201b70b79a34b0b2acbe'],14,191,205,1648999,11,0.246753247,0.519480519,0.727272727,3599
91134031c5024527a1f4e975f1e24ef6da245fe6,1,Sarath Subramanian,2019-09-20 10:43:15-07:00,['c31f14408a614d85eb381ad7eea0458d7747de35'],0,184,184,1649183,1,0.176470588,0.344537815,1,3599
53e8825096394572aa41c9b40a4ccdd2a4e981ea,0,Sarath Subramanian,2019-09-21 22:26:42-07:00,['91134031c5024527a1f4e975f1e24ef6da245fe6'],18,17,35,1649218,2,0,1,1,3599
5bffc7cfb4fe322b7ef9275906bc24cd61a2c759,1,Sarath Subramanian,2019-09-24 13:00:23-07:00,['53e8825096394572aa41c9b40a4ccdd2a4e981ea'],35,100,135,1649353,20,,,,3606
05130e83a1f376e72ab565dcf3748dae0658483b,0,kevalbhatt,2019-09-25 13:04:04+05:18,['5bffc7cfb4fe322b7ef9275906bc24cd61a2c759'],14,17,31,1649384,10,,,,3608
f31db4c397ea035259a21666551a381ef747ba1d,1,nixonrodrigues,2019-09-25 15:02:52+05:18,['05130e83a1f376e72ab565dcf3748dae0658483b'],2706,26045,28751,1678135,260,0.777504778,0.935298935,0.98034398,3761
9d432d5db2ce2e3469b0e00bfb5685982ef59f85,1,Sarath Subramanian,2019-09-26 13:38:56-07:00,['f31db4c397ea035259a21666551a381ef747ba1d'],212,522,734,1678869,12,0.354066986,0.827751196,1,3762
ea02e10c2f025510158d13e1ab68b5581abaae80,1,Sarath Subramanian,2019-09-27 13:03:35-07:00,['9d432d5db2ce2e3469b0e00bfb5685982ef59f85'],8,9,17,1678886,7,,,,3762
6d907bd0094d7637a72479bb6fabfe2c0650109d,1,kevalbhatt,2019-09-30 16:34:50+05:18,['ea02e10c2f025510158d13e1ab68b5581abaae80'],92,113,205,1679091,42,,,,3764
a6552f2100f402669fc9ae965bb9d66a8e828324,0,kevalbhatt,2019-09-30 17:02:47+05:18,['6d907bd0094d7637a72479bb6fabfe2c0650109d'],1,4,5,1679096,1,,,,3764
74bf4cdaae598bebd3f7956495b93d4e0b1242f6,0,Ashutosh Mestry,2019-10-01 10:32:42-07:00,['a6552f2100f402669fc9ae965bb9d66a8e828324'],3,242,245,1679341,3,0.560344828,0.698275862,0.99137931,3765
bebe746bab27fb53ac2785720965ce897f6ecb62,1,Sarath Subramanian,2019-10-02 12:03:35-07:00,['74bf4cdaae598bebd3f7956495b93d4e0b1242f6'],11,243,254,1679595,11,0.376712329,0.787671233,0.945205479,3765
cc6c2668992a92ef03a20a85ae74d441c1eff3be,0,Sarath Subramanian,2019-10-02 12:33:09-07:00,['bebe746bab27fb53ac2785720965ce897f6ecb62'],1,1,2,1679597,1,,,,3765
929e505a8c2292d82f303e33561360c75a94c5d3,1,Sarath Subramanian,2019-10-02 12:48:31-07:00,['cc6c2668992a92ef03a20a85ae74d441c1eff3be'],3,9,12,1679609,1,0,1,1,3765
ddd0c9ca3f97e8eecc3d0cdf259ddc13a1daf8ed,1,Nixon Rodrigues,2019-10-03 20:33:52+05:18,['929e505a8c2292d82f303e33561360c75a94c5d3'],1,1,2,1679611,1,,,,3765
b0ab2ffeb43a3e3c4aa66bf8fecd6ee836e6d359,1,Sarath Subramanian,2019-10-03 11:42:57-07:00,['ddd0c9ca3f97e8eecc3d0cdf259ddc13a1daf8ed'],0,108,108,1679719,6,0,1,1,3765
4b8db750d10dd9145912de71f5a31a08c85ebe4b,1,Sarath Subramanian,2019-10-06 23:08:57-07:00,['b0ab2ffeb43a3e3c4aa66bf8fecd6ee836e6d359'],55,159,214,1679933,4,0.607142857,0.25,1,3765
678043f80e064248352cb073fd7385a82deebe9a,0,Sarath Subramanian,2019-10-07 11:17:51-07:00,['4b8db750d10dd9145912de71f5a31a08c85ebe4b'],3,37,40,1679973,4,0,0,1,3765
cacf361ebd5a79d2c3609da8e5a69e9428fe5af2,1,Sarath Subramanian,2019-10-08 22:13:58-07:00,['678043f80e064248352cb073fd7385a82deebe9a'],7,262,269,1680242,14,0.503225806,0.987096774,0.993548387,3765
bdcb82077f9ad09d5632c411260eae310245d4b4,0,nixonrodrigues,2019-10-09 16:35:26+05:18,['cacf361ebd5a79d2c3609da8e5a69e9428fe5af2'],2,2,4,1680246,2,,,,3765
f9463baf0c0106ce23f8fbfffbd09893b54d4cac,0,nixonrodrigues,2019-10-09 16:36:45+05:18,['bdcb82077f9ad09d5632c411260eae310245d4b4'],0,1,1,1680247,1,,,,3765
4767af19731412e4bbc630bae1706eab320d167a,0,kevalbhatt,2019-10-09 17:42:11+05:18,['f9463baf0c0106ce23f8fbfffbd09893b54d4cac'],0,2,2,1680249,4,,,,3767
7ba3213eca2ad9be9dde97502c2d56896870d9d6,1,kevalbhatt,2019-10-09 19:49:36+05:18,['4767af19731412e4bbc630bae1706eab320d167a'],4,4,8,1680257,2,,,,3767
adfc526e386128dc8f572aae6093720d7954bd31,1,kevalbhatt,2019-10-09 19:49:57+05:18,['7ba3213eca2ad9be9dde97502c2d56896870d9d6'],66,52,118,1680375,1,1,0,0,3767
5dffddd005827137e35b72d837fdd51cd1ce4d5b,1,kevalbhatt,2019-10-09 19:50:52+05:18,['adfc526e386128dc8f572aae6093720d7954bd31'],0,118,118,1680493,2,0.930232558,0.930232558,1,3768
7435801a5043fcf4b1f80dfc4bef6ae554e0e711,0,kevalbhatt,2019-10-09 20:48:09+05:18,['5dffddd005827137e35b72d837fdd51cd1ce4d5b'],33,43,76,1680569,1,0,0,1,3768
503a572d8d4fce5866100fb38ed51fbd0f90ba71,1,Sarath Subramanian,2019-10-09 10:29:28-07:00,['7435801a5043fcf4b1f80dfc4bef6ae554e0e711'],54,2468,2522,1683091,24,0.734782609,0.830434783,0.904347826,3777
4952a560ccb84278cc3b6b03cfd52deebfcdc304,1,Sarath Subramanian,2019-10-09 10:37:44-07:00,['503a572d8d4fce5866100fb38ed51fbd0f90ba71'],6,62,68,1683159,6,,,,3777
715845523fed2e96bdbeba31a8f68db1d80c79f1,1,Sarath Subramanian,2019-10-10 11:38:28-07:00,['4952a560ccb84278cc3b6b03cfd52deebfcdc304'],41,533,574,1683733,22,0.990825688,1,1,3781
a2de206015949b9b19e38058234a42d42ff0f0a1,1,Sarath Subramanian,2019-10-10 11:38:38-07:00,['715845523fed2e96bdbeba31a8f68db1d80c79f1'],94,250,344,1684077,12,1,1,1,3781
2c3b41f4b2c027f5553f5c248df13c8ecd9d2005,0,kevalbhatt,2019-10-11 10:06:08+05:18,['a2de206015949b9b19e38058234a42d42ff0f0a1'],0,32,32,1684109,2,,,,3781
75858947f5a26f8760872dc7449724c12f750671,1,Sarath Subramanian,2019-10-11 08:22:59-07:00,['2c3b41f4b2c027f5553f5c248df13c8ecd9d2005'],452,556,1008,1685117,22,0.703703704,0.925925926,0.777777778,3781
289c87a67a2307ea3d1b3bdceee7bc322f35a291,0,nixonrodrigues,2019-10-14 18:26:41+05:18,['75858947f5a26f8760872dc7449724c12f750671'],30,1049,1079,1686196,8,0.536585366,0.536585366,0.390243902,3787
596b74b0a8cad4d7aad473e0e6e502c3fbce150f,0,Sarath Subramanian,2019-10-14 20:49:46-07:00,['289c87a67a2307ea3d1b3bdceee7bc322f35a291'],1401,0,1401,1687597,1,,,,3787
c3da6d5ff3519f3f39cd34d578b91341a417d402,1,Sarath Subramanian,2019-10-15 16:26:12-07:00,['596b74b0a8cad4d7aad473e0e6e502c3fbce150f'],27,269,296,1687893,6,0.319148936,0.319148936,0.893617021,3787
57b52a2921f5d8fc06a4d4ac27eaf2259fc96df8,1,Sarath Subramanian,2019-10-16 14:44:03-07:00,['c3da6d5ff3519f3f39cd34d578b91341a417d402'],30,137,167,1688060,10,0,0,1,3787
e04acda4868a8db9b41f6b55d33b25c66bccebe3,1,Sarath Subramanian,2019-10-17 05:55:39-07:00,['57b52a2921f5d8fc06a4d4ac27eaf2259fc96df8'],64,375,439,1688499,7,0.280701754,0.526315789,0.701754386,3787
9ba321760e03148bcf59049888a42b69a3286541,1,Sarath Subramanian,2019-10-17 05:57:32-07:00,['e04acda4868a8db9b41f6b55d33b25c66bccebe3'],42,16,58,1688557,2,1,1,0,3787
b064d8c3aad588c4975ddd0ad5bc24e12806e171,1,Sarath Subramanian,2019-10-17 13:55:48-07:00,['9ba321760e03148bcf59049888a42b69a3286541'],6,49,55,1688612,2,0,0.733333333,1,3787
f9b483175a0a54c2cde417cde42a04f0e4e4cf44,0,Sarath Subramanian,2019-10-17 16:24:22-07:00,['b064d8c3aad588c4975ddd0ad5bc24e12806e171'],9,14,23,1688635,1,1,1,1,3787
d57f5d8a43395767c03a086907a63aedef3c3e29,1,Sarath Subramanian,2019-10-18 11:33:42-07:00,['f9b483175a0a54c2cde417cde42a04f0e4e4cf44'],30,47,77,1688712,11,1,0,0,3787
e0afb12d49a65d38d340a283a20c0657729c8f48,1,nixonrodrigues,2019-10-21 19:19:46+05:18,['d57f5d8a43395767c03a086907a63aedef3c3e29'],20,157,177,1688889,7,1,1,0.352941176,3790
85a5eeba1701abf6ff8f852174194307f4a892ae,1,Sarath Subramanian,2019-10-21 08:55:28-07:00,['e0afb12d49a65d38d340a283a20c0657729c8f48'],31,85,116,1689005,3,0,1,1,3791
c88ea51103367ee28c0bb03ce1aac04dfaaf2df5,0,Sarath Subramanian,2019-10-21 11:12:59-07:00,['85a5eeba1701abf6ff8f852174194307f4a892ae'],12,50,62,1689067,3,0,1,1,3791
848c799e31591e1ac82471fc564689173b6bb522,1,Sarath Subramanian,2019-10-23 12:16:46-07:00,['c88ea51103367ee28c0bb03ce1aac04dfaaf2df5'],269,179,448,1689515,18,1,1,0.06122449,3791
f7df0f1b8173a509c0342928710ad2036759fe5c,0,Sarath Subramanian,2019-10-23 13:50:58-07:00,['848c799e31591e1ac82471fc564689173b6bb522'],13,398,411,1689926,5,0.166666667,1,1,3794
14a6b65d8160e278c4c5d6822025eceafa99663a,0,Ashutosh Mestry,2019-10-23 15:15:33-07:00,['f7df0f1b8173a509c0342928710ad2036759fe5c'],0,368,368,1690294,1,,,,3795
6ad08536043d6192de3b91b7799efbc60461222f,0,Sarath Subramanian,2019-10-23 16:06:59-07:00,['14a6b65d8160e278c4c5d6822025eceafa99663a'],11,53,64,1690358,3,0.9375,0.4375,0.96875,3795
c04c0ab3e8e8147226337990f73f147d89cdf5a8,1,Madhan Neethiraj,2019-10-24 16:18:01-07:00,['6ad08536043d6192de3b91b7799efbc60461222f'],16,27,43,1690401,3,0,0.833333333,1,3795
f687fb7d12d5ed752b85f813fbd550e26105daeb,1,Madhan Neethiraj,2019-10-24 22:09:21-07:00,['c04c0ab3e8e8147226337990f73f147d89cdf5a8'],10,91,101,1690502,2,0.387096774,0.387096774,1,3795
8f80735197915e4e49eba2798ee595e530067468,1,kevalbhatt,2019-10-26 11:28:47+05:18,['f687fb7d12d5ed752b85f813fbd550e26105daeb'],254,308,562,1691064,53,0,1,1,3795
c6ee27790db7905f8d9b5b02f2961d59cc76b5cb,0,Ashutosh Mestry,2019-10-28 09:16:06-07:00,['8f80735197915e4e49eba2798ee595e530067468'],1,36,37,1691101,3,0.12,1,1,3796
f8cb6f76cc8851848225ea35417bebdbc85ad6f7,0,Madhan Neethiraj,2019-10-28 10:31:12-07:00,['c6ee27790db7905f8d9b5b02f2961d59cc76b5cb'],26,48,74,1691175,1,0.105263158,0.105263158,1,3796
7aca24fb75beb48e9682cdc4988e5b6ac2ea1e90,0,Sarath Subramanian,2019-10-29 17:24:05-07:00,['f8cb6f76cc8851848225ea35417bebdbc85ad6f7'],1,1,2,1691177,1,,,,3796
25044cee5d945985aaadfc68e3da992eb4cc688e,0,nixonrodrigues,2019-10-30 15:03:20+05:18,['7aca24fb75beb48e9682cdc4988e5b6ac2ea1e90'],29,106,135,1691312,14,0.48,0.48,1,3796
0ce149e877ed17a4b3876bf9012071ccf3e5f603,1,nixonrodrigues,2019-10-31 19:08:52+05:18,['25044cee5d945985aaadfc68e3da992eb4cc688e'],5,54,59,1691371,4,0.756097561,0.756097561,0.756097561,3796
f93b37025e656a098e01bcf3e50647f0ca50fb80,1,Sarath Subramanian,2019-10-31 13:35:58-07:00,['0ce149e877ed17a4b3876bf9012071ccf3e5f603'],4,268,272,1691643,6,0.354651163,1,0.668604651,3796
94933c432f9562ab97f15d509fcd810f0514a890,0,Sarath Subramanian,2019-10-31 14:50:59-07:00,['f93b37025e656a098e01bcf3e50647f0ca50fb80'],0,80,80,1691723,1,,,,3797
5ae7fbecb3b02abe9aaa07e25e3b06073fd0c306,0,nixonrodrigues,2019-11-03 22:58:21+05:18,['94933c432f9562ab97f15d509fcd810f0514a890'],5,9,14,1691737,1,0.2,0.2,1,3797
15d5b34305eb5b048316f1c658b8b910e2a0a188,0,kevalbhatt,2019-11-04 17:28:04+05:18,['5ae7fbecb3b02abe9aaa07e25e3b06073fd0c306'],38,154,192,1691929,10,0.433333333,1,1,3797
9115e7d2da68a4d05d63415c6e691740c1cabed3,0,kevalbhatt,2019-11-05 13:17:34+05:18,['15d5b34305eb5b048316f1c658b8b910e2a0a188'],24,145,169,1692098,7,1,1,0.827586207,3799
f6e252f8bba84da7f46f69c5fe264e6d48eec017,0,Ashutosh Mestry,2019-11-05 11:52:50-08:00,['9115e7d2da68a4d05d63415c6e691740c1cabed3'],0,15,15,1692113,2,0,0.636363636,1,3799
dca71ddfba883b57718c344cb97d45c52fe9482a,0,Ashutosh Mestry,2019-11-05 11:56:51-08:00,['f6e252f8bba84da7f46f69c5fe264e6d48eec017'],1,2,3,1692116,1,0,0,0,3799
d528d27574ee1affbf615f7a537b160459297458,0,Sarath Subramanian,2019-11-05 23:03:31-08:00,['dca71ddfba883b57718c344cb97d45c52fe9482a'],1,8,9,1692125,2,0,0.666666667,1,3799
10a1105351b03decf532255c84e6fbf7b166a14f,1,kevalbhatt,2019-11-06 16:55:35+05:18,['d528d27574ee1affbf615f7a537b160459297458'],64,90,154,1692279,21,1,0.305555556,0,3799
6050a8e6f7d572174d36946b9bee6968777e2850,1,Sarath Subramanian,2019-11-06 05:23:20-08:00,['10a1105351b03decf532255c84e6fbf7b166a14f'],30,148,178,1692457,12,0.303030303,0.818181818,0.848484848,3799
d5c8bf40dc92ff538daf7da1ad9bac0dbb7a26fd,1,kevalbhatt,2019-11-07 15:07:28+05:18,['6050a8e6f7d572174d36946b9bee6968777e2850'],435,685,1120,1693577,32,0.795081967,0.926229508,0.721311475,3799
98163440590852fa9d142c23e596e8975a322349,0,Ashutosh Mestry,2019-11-07 15:45:30-08:00,['d5c8bf40dc92ff538daf7da1ad9bac0dbb7a26fd'],19,19,38,1693615,2,1,1,1,3799
24fb2b066bcff11a8b667b0f90d43cb482fb0e81,0,nixonrodrigues,2019-11-08 12:08:24+05:18,['98163440590852fa9d142c23e596e8975a322349'],1,1,2,1693617,1,,,,3799
1b5ca4c5346c1b2fad0d276b509a56f78489755d,0,Sarath Subramanian,2019-11-08 09:54:58-08:00,['24fb2b066bcff11a8b667b0f90d43cb482fb0e81'],21,41,62,1693679,8,0.75,0.75,1,3799
72243644900495436975161bf797bc53f4cf0d0e,1,nixonrodrigues,2019-11-14 14:06:44+05:18,['1b5ca4c5346c1b2fad0d276b509a56f78489755d'],15,69,84,1693763,2,1,1,1,3799
a9672da056cfda5bda29fb9589498d652aad46d9,1,nixonrodrigues,2019-11-14 14:06:54+05:18,['72243644900495436975161bf797bc53f4cf0d0e'],11,11,22,1693785,5,0,1,0,3799
714423c9135653fd3351cfe9282f05ae1fa0870b,1,nixonrodrigues,2019-11-14 18:04:39+05:18,['a9672da056cfda5bda29fb9589498d652aad46d9'],14,28,42,1693827,8,0.909090909,0.909090909,0.909090909,3799
09118ca750208afc8f01638531555aada33e9648,1,Sarath Subramanian,2019-11-14 15:29:22-08:00,['714423c9135653fd3351cfe9282f05ae1fa0870b'],34,319,353,1694180,16,0.560240964,0.644578313,0.951807229,3799
e3e7f2e070674d00eba8171123ffe0b7d58751b1,1,nixonrodrigues,2019-11-15 16:48:32+05:18,['09118ca750208afc8f01638531555aada33e9648'],7,13,20,1694200,3,0.2,0.2,1,3799
5932b1af358288b07f382b40939b48150f844fd6,1,Sarath Subramanian,2019-11-19 13:12:27-08:00,['e3e7f2e070674d00eba8171123ffe0b7d58751b1'],270,542,812,1695012,17,0.64084507,1,0.964788732,3800
bdd110dfe7481815d3a19ebc6acb4fdefacc93ed,0,Sarath Subramanian,2019-11-21 11:43:48-08:00,['5932b1af358288b07f382b40939b48150f844fd6'],8,9,17,1695029,1,0,0,0,3800
d1f341864ee026c0ea30c7f76f1fa5acad25dc09,0,Sarath Subramanian,2019-11-21 14:59:01-08:00,['bdd110dfe7481815d3a19ebc6acb4fdefacc93ed'],3,16,19,1695048,3,1,1,1,3800
df85aa7a6efbadf5fba73655b6ab36327d8770da,1,Sarath Subramanian,2019-11-21 15:38:15-08:00,['d1f341864ee026c0ea30c7f76f1fa5acad25dc09'],72,239,311,1695359,11,0.265306122,0.948979592,0.948979592,3800
7be3a6f7499970dbb026cbe1bd92e04c1865ebf0,1,Ashutosh Mestry,2019-11-21 21:08:08-08:00,['df85aa7a6efbadf5fba73655b6ab36327d8770da'],3,14,17,1695376,3,0,1,1,3800
e607ba1a8bc45d671fb76bf0c9c4059cda99d36d,1,Ashutosh Mestry,2019-11-25 08:22:14-08:00,['7be3a6f7499970dbb026cbe1bd92e04c1865ebf0'],1,1,2,1695378,1,,,,3800
d0c1b30c05a587839015db1c3ff1dafc959294fd,1,Madhan Neethiraj,2019-11-27 15:51:09-08:00,['e607ba1a8bc45d671fb76bf0c9c4059cda99d36d'],20,150,170,1695548,7,0.551282051,1,1,3800
af203374232bc1ba6f7c42731619416b40b1db1c,0,Madhan Neethiraj,2019-11-27 16:08:14-08:00,['d0c1b30c05a587839015db1c3ff1dafc959294fd'],4,6,10,1695558,2,,,,3800
c6661ff15c15856ae030c95ffbbf808ff0850d5a,0,Madhan Neethiraj,2019-11-28 10:27:35-08:00,['af203374232bc1ba6f7c42731619416b40b1db1c'],1,9,10,1695568,2,0,1,1,3800
9f5b7861e6bf4975b84cd9db0f3397d128cb3157,1,Madhan Neethiraj,2019-11-29 10:44:32-08:00,['c6661ff15c15856ae030c95ffbbf808ff0850d5a'],1,17,18,1695586,1,1,1,1,3800
d9ebc242be55be0d898d95e02283a84cc887807b,0,Madhan Neethiraj,2019-11-30 10:13:04-08:00,['9f5b7861e6bf4975b84cd9db0f3397d128cb3157'],33,40,73,1695659,1,0,0,0.428571429,3800
48df6544f92df81dc49820b8cd2900666cb14e0a,0,Madhan Neethiraj,2019-12-01 06:28:46-08:00,['d9ebc242be55be0d898d95e02283a84cc887807b'],0,69,69,1695728,3,0.8125,0.8125,0.90625,3800
5955fcd1390910b714b13716b8c2ffc8fc5932d8,0,Ashutosh Mestry,2019-12-02 13:35:25-08:00,['48df6544f92df81dc49820b8cd2900666cb14e0a'],2,5,7,1695735,3,1,1,1,3800
8ca94c8de23c2453385656862244b268ea6482fe,0,kevalbhatt,2019-12-03 16:03:06+05:18,['5955fcd1390910b714b13716b8c2ffc8fc5932d8'],46,123,169,1695904,7,0.189873418,1,1,3800
c95aba218b9318ce44abf574faff62908f24916d,0,Sarath Subramanian,2019-12-04 20:57:07-08:00,['8ca94c8de23c2453385656862244b268ea6482fe'],18,41,59,1695963,2,0,0.684210526,0.736842105,3800
1e0962d70008cccfb9d4f1db624963faa74d0c19,0,Sarath Subramanian,2019-12-05 12:58:05-08:00,['c95aba218b9318ce44abf574faff62908f24916d'],0,120,120,1696083,4,0.476190476,1,1,3800
65a62b05369a2dbb75d26971dc071b28b1119331,0,nixonrodrigues,2019-12-06 14:50:46+05:18,['1e0962d70008cccfb9d4f1db624963faa74d0c19'],0,4,4,1696087,1,0.5,0.5,0,3800
e202e9e483e41b00dc5309395e5daaa710fb6765,1,kevalbhatt,2019-12-06 17:15:15+05:18,['65a62b05369a2dbb75d26971dc071b28b1119331'],105,455,560,1696647,21,0.419230769,0.65,1,3800
6435223d8687423d8e6ff1c35248a368c9720879,0,kevalbhatt,2019-12-06 17:17:15+05:18,['e202e9e483e41b00dc5309395e5daaa710fb6765'],17,28,45,1696692,4,1,0,1,3800
cf455a527d6df8c98e788073628fc35fcd46758a,0,Sarath Subramanian,2019-12-13 21:38:50-08:00,['6435223d8687423d8e6ff1c35248a368c9720879'],17,144,161,1696853,2,0.477272727,0.568181818,0.284090909,3800
7423addb220330cceadbf690d3bf4e4e5fcde99f,1,Sarath Subramanian,2019-12-17 20:23:13-08:00,['cf455a527d6df8c98e788073628fc35fcd46758a'],251,286,537,1697390,12,0.25,0,0,3800
67a7367a786b93e596ab64b6036b6be21a11b459,0,Sarath Subramanian,2019-12-18 20:27:23-08:00,['7423addb220330cceadbf690d3bf4e4e5fcde99f'],4,8,12,1697402,1,,,,3800
c789f2d7e5efa3d7c85829016541097319006651,0,Sarath Subramanian,2019-12-19 14:22:15-08:00,['67a7367a786b93e596ab64b6036b6be21a11b459'],2,16,18,1697420,2,0,0,1,3800
e2ba3051d6c18d84b79d803490227d612e0e7858,1,Sarath Subramanian,2019-12-19 18:49:50-08:00,['c789f2d7e5efa3d7c85829016541097319006651'],85,120,205,1697625,3,0.708333333,1,1,3800
343b7832fcb1ce201f0000339cd5b63ac1f6f54b,0,Nixon Rodrigues,2019-12-20 19:24:11+05:18,['e2ba3051d6c18d84b79d803490227d612e0e7858'],0,4,4,1697629,1,,,,3800
fb9f1e96e2dbd1588b2be4f8a63854a2e913dc1e,1,Sarath Subramanian,2019-12-20 10:49:07-08:00,['343b7832fcb1ce201f0000339cd5b63ac1f6f54b'],52,222,274,1697903,6,0.271028037,0.429906542,1,3800
f5dcc7b7036414f3e382d172dbe10ed83be90bda,1,Sarath Subramanian,2019-12-20 15:38:14-08:00,['fb9f1e96e2dbd1588b2be4f8a63854a2e913dc1e'],6,7,13,1697916,1,,,,3800
bb10c16ffe1b3911af3161c74b45069fa8add94d,0,Sarath Subramanian,2019-12-23 07:15:59-08:00,['f5dcc7b7036414f3e382d172dbe10ed83be90bda'],0,5,5,1697921,1,0,0,0,3800
72389767ab1094e96e07f284be3bb0f3199e3e2a,0,kevalbhatt,2020-01-06 19:12:46+05:18,['bb10c16ffe1b3911af3161c74b45069fa8add94d'],8,4,12,1697933,2,,,,3800
b5fe0896d630dbdf5a48452930ad1023f3a0d2cb,1,Madhan Neethiraj,2020-01-09 13:06:36-08:00,['72389767ab1094e96e07f284be3bb0f3199e3e2a'],1,31,32,1697965,2,0,1,1,3800
6d94f39cf3b6207bc095310eebbe3292071be68b,1,Sarath Subramanian,2020-01-10 11:43:01-08:00,['b5fe0896d630dbdf5a48452930ad1023f3a0d2cb'],67,1486,1553,1699518,24,0.539855072,0.765700483,0.904589372,3805
7be35c3fff13a6ed9996860c081d9760bfa07e4d,1,kevalbhatt,2020-01-13 12:01:10+05:18,['6d94f39cf3b6207bc095310eebbe3292071be68b'],2,24,26,1699544,4,0,0,1,3805
7526a69d5a62e7b7839576c757ff00cfb8a8748e,1,kevalbhatt,2020-01-13 12:10:34+05:18,['7be35c3fff13a6ed9996860c081d9760bfa07e4d'],822,1091,1913,1701457,165,0,0,1,3805
bbbadeaaabf46270f5f3d3185752280a65955ee7,1,Ashutosh Mestry,2020-01-13 16:30:38-08:00,['7526a69d5a62e7b7839576c757ff00cfb8a8748e'],0,279,279,1701736,1,,,,3806
2d4edf87728b45b6498e2d7772d87829d7079ef8,0,Ramesh Mani,2020-01-14 14:30:02-08:00,['bbbadeaaabf46270f5f3d3185752280a65955ee7'],8,8,16,1701752,2,,,,3806
f484b205013f6e256a45a55c5a2b2b54efcc0769,0,Ashutosh Mestry,2020-01-16 21:22:35-08:00,['2d4edf87728b45b6498e2d7772d87829d7079ef8'],0,51,51,1701803,2,,,,3807
eed7817efc9fb961379a8f47d76a78a3bd201848,1,Ashutosh Mestry,2020-01-16 21:35:07-08:00,['f484b205013f6e256a45a55c5a2b2b54efcc0769'],11,22,33,1701836,2,,,,3807
ea653e0388aa45a1eeeb016592ca155cda8eb480,1,Sarath Subramanian,2020-01-20 21:13:23-08:00,['eed7817efc9fb961379a8f47d76a78a3bd201848'],11,37,48,1701884,2,0.0625,0.125,0.75,3807
cb0fe79e3f41e1b7bf9a52202f71b23fe1326800,0,nixonrodrigues,2020-01-21 11:23:29+05:18,['ea653e0388aa45a1eeeb016592ca155cda8eb480'],0,2,2,1701886,1,0,0,1,3807
0ac9534915e55f21bb44e7a4da2439055d0620a8,0,Sarath Subramanian,2020-01-21 08:34:51-08:00,['cb0fe79e3f41e1b7bf9a52202f71b23fe1326800'],2,2,4,1701890,1,,,,3807
47f2e77bf798547e652e16cf10adaa818ded1e3e,0,Sarath Subramanian,2020-01-21 08:36:36-08:00,['0ac9534915e55f21bb44e7a4da2439055d0620a8'],7,14,21,1701911,3,0.25,0.25,0,3807
4d44690a79478e6a0eb5793a815215c131e4f896,1,nixonrodrigues,2020-01-22 17:26:09+05:18,['47f2e77bf798547e652e16cf10adaa818ded1e3e'],2,2,4,1701915,2,,,,3807
e04c4f5c332322e191e1d8abdadc250bf03e2840,1,kevalbhatt,2020-01-29 15:03:24+05:18,['4d44690a79478e6a0eb5793a815215c131e4f896'],103,800,903,1702818,16,0.703804348,0.456521739,0.864130435,3809
b3563fd319fa530021cb7358c1cc232f06bda24a,1,kevalbhatt,2020-01-29 15:04:23+05:18,['e04c4f5c332322e191e1d8abdadc250bf03e2840'],9,19,28,1702846,1,0,0,1,3809
121ccbd8549a0ead4ab8e0258024317ba8b75a14,0,Sarath Subramanian,2020-01-31 20:39:48-08:00,['b3563fd319fa530021cb7358c1cc232f06bda24a'],1,8,9,1702855,1,0,1,1,3809
a6cdb608b21d8c4d1c843ca7d2d974fc2b65b93c,1,Sarath Subramanian,2020-02-03 15:22:48-08:00,['121ccbd8549a0ead4ab8e0258024317ba8b75a14'],8,21,29,1702884,3,0,1,1,3809
984b359cf9cf0e951af274c8319ace2f4e2a3a74,0,Ashutosh Mestry,2020-02-06 14:05:02-08:00,['a6cdb608b21d8c4d1c843ca7d2d974fc2b65b93c'],4,5,9,1702893,1,1,1,1,3809
d3a08b6eabcc50536c468db2d1328df54ee27fce,1,Madhan Neethiraj,2020-02-06 21:48:48-08:00,['984b359cf9cf0e951af274c8319ace2f4e2a3a74'],44,455,499,1703392,10,0.25,0.334558824,0.231617647,3809
4229cb3c7a9e7109c883431bc5fb502339d077ec,0,kevalbhatt,2020-02-07 11:55:15+05:18,['d3a08b6eabcc50536c468db2d1328df54ee27fce'],2,2,4,1703396,2,,,,3809
cc2e6af70586ade872181e51792577934a2141eb,0,Madhan Neethiraj,2020-02-09 13:51:07-08:00,['4229cb3c7a9e7109c883431bc5fb502339d077ec'],5,95,100,1703496,2,0.171875,0,1,3809
98b54160c5d2fd308a2f2be9269695a675a287f8,1,kevalbhatt,2020-02-12 11:53:43+05:18,['cc2e6af70586ade872181e51792577934a2141eb'],5,22,27,1703523,3,0.461538462,0,1,3809
015577ecf4976a4b15e0e86d57b786cd21b2e86b,1,Ashutosh Mestry,2020-02-13 15:34:11-08:00,['98b54160c5d2fd308a2f2be9269695a675a287f8'],105,470,575,1704098,9,0.426086957,0.973913043,0.756521739,3813
3e035c45a9dd695471d0927bbcdd72108094c828,1,Ashutosh Mestry,2020-02-14 09:07:42-08:00,['015577ecf4976a4b15e0e86d57b786cd21b2e86b'],6,271,277,1704375,4,0.774647887,1,0.971830986,3815
5e7f8949fd220533510c7ef92e38ac204612a509,0,Madhan Neethiraj,2020-02-15 11:16:13-08:00,['3e035c45a9dd695471d0927bbcdd72108094c828'],35,5,40,1704415,3,0.421052632,0.421052632,0,3815
10bcaa8091b548efd82e993d6844623f93f1e1f8,1,Madhan Neethiraj,2020-02-15 21:06:22-08:00,['5e7f8949fd220533510c7ef92e38ac204612a509'],19,75,94,1704509,6,0.205128205,0.205128205,0.923076923,3815
ac808af07c69191e34a279be169b8f01e5d35240,0,Madhan Neethiraj,2020-02-16 16:56:58-08:00,['10bcaa8091b548efd82e993d6844623f93f1e1f8'],133,199,332,1704841,10,0.378378378,0.783783784,1,3815
695480e9367ef6cb86fb18cb552e94b82f106b45,0,kevalbhatt,2020-02-17 10:58:57+05:18,['ac808af07c69191e34a279be169b8f01e5d35240'],4,18,22,1704863,2,1,1,1,3815
8f6cb0e9afa07feb0fe615663650c4ee580fd657,1,kevalbhatt,2020-02-17 10:59:26+05:18,['695480e9367ef6cb86fb18cb552e94b82f106b45'],9,18,27,1704890,1,1,1,1,3815
bcb9ea240614299280d8051b6b43a9927dcbb2de,1,kevalbhatt,2020-02-17 19:09:34+05:18,['8f6cb0e9afa07feb0fe615663650c4ee580fd657'],219,4238,4457,1709347,48,0.622107969,0.884318766,0.949014567,3836
9b89a3fda36af8b78146cc4dd914c7985739e10b,1,kevalbhatt,2020-02-17 19:10:22+05:18,['bcb9ea240614299280d8051b6b43a9927dcbb2de'],2,2,4,1709351,2,,,,3836
8fe3edd2a7d480408ec3d43762cfb43887d5fa19,1,Madhan Neethiraj,2020-02-17 07:09:52-08:00,['9b89a3fda36af8b78146cc4dd914c7985739e10b'],41,366,407,1709758,10,0.457286432,0.216080402,0.809045226,3836
47ccfaf7cf2301f65ff1bcf1121bb0b232bc9692,0,kevalbhatt,2020-02-18 11:23:22+05:18,['8fe3edd2a7d480408ec3d43762cfb43887d5fa19'],1,1,2,1709760,1,,,,3836
70ebb22829a4dae8f06031b045f4848a4c22fc05,1,kevalbhatt,2020-02-18 18:03:10+05:18,['47ccfaf7cf2301f65ff1bcf1121bb0b232bc9692'],5,667,672,1710432,12,0.70242915,0.777327935,0.969635628,3840
3680ab428969bcc23606537d1dab49171bcc37ab,1,kevalbhatt,2020-02-20 19:55:23+05:18,['70ebb22829a4dae8f06031b045f4848a4c22fc05'],41,129,170,1710602,4,0.955882353,1,1,3840
fd1aad38fb762b07ee225ffae002e980658e85fd,0,kevalbhatt,2020-02-20 19:55:32+05:18,['3680ab428969bcc23606537d1dab49171bcc37ab'],2,2,4,1710606,2,,,,3840
cd177f83d24dbce0a992e3c2cf7c2f3001f0f806,1,kevalbhatt,2020-02-20 19:55:59+05:18,['fd1aad38fb762b07ee225ffae002e980658e85fd'],5,67,72,1710678,3,0.910714286,0.660714286,0.767857143,3840
b0c85dd99aaabe296875847fdab0e0d5fe6cd846,0,kevalbhatt,2020-02-20 19:56:09+05:18,['cd177f83d24dbce0a992e3c2cf7c2f3001f0f806'],151,85,236,1710914,25,0.431372549,0.039215686,0,3840
e159f767820b3e25a5cf9f351586126201cda387,1,kevalbhatt,2020-02-20 20:43:21+05:18,['b0c85dd99aaabe296875847fdab0e0d5fe6cd846'],15,9,24,1710938,2,0,0,0.428571429,3840
a2ccfb9f3577e911103041d8d4b91c169697f6a1,0,Ashutosh Mestry,2020-02-20 11:46:49-08:00,['e159f767820b3e25a5cf9f351586126201cda387'],227,1690,1917,1712855,31,0.778393352,0.943213296,0.862880886,3853
54042d35b29f91b46fd033a6378dedf1ff47c5d9,0,Ashutosh Mestry,2020-02-20 17:04:49-08:00,['a2ccfb9f3577e911103041d8d4b91c169697f6a1'],24,404,428,1713283,9,0.785234899,0.88590604,0.77852349,3856
c652dd4d926e6dfbb4b0cd5c75e66fc76f1558ac,1,kevalbhatt,2020-02-21 15:22:06+05:18,['54042d35b29f91b46fd033a6378dedf1ff47c5d9'],12263,352,12615,1725898,9,0,1,1,3856
6eb72fa456e527baeb144245421e29bffa98592b,0,Madhan Neethiraj,2020-02-21 22:12:01-08:00,['c652dd4d926e6dfbb4b0cd5c75e66fc76f1558ac'],4,8,12,1725910,1,0,0,1,3856
624583882eddc1a8a5adf2fb674b31dcfe468333,0,kevalbhatt,2020-02-25 14:17:02+05:18,['6eb72fa456e527baeb144245421e29bffa98592b'],16,61,77,1725987,3,0,1,1,3856
6b503eeb8866b67d0cb09d60c389230a28c1efbc,0,kevalbhatt,2020-02-26 11:12:46+05:18,['624583882eddc1a8a5adf2fb674b31dcfe468333'],35,99,134,1726121,5,0,0,0.351351351,3856
75e678da7595420a729226e9ce2b575facb7bbb5,1,nixonrodrigues,2020-02-26 14:14:12+05:18,['6b503eeb8866b67d0cb09d60c389230a28c1efbc'],13,20,33,1726154,5,0,0,1,3856
c99e15b3711e0aebb4c1db086553f915ecd471d1,0,nixonrodrigues,2020-02-26 14:21:21+05:18,['75e678da7595420a729226e9ce2b575facb7bbb5'],1,1,2,1726156,1,,,,3856
b02443ec117458254f919ec60d2dee5fdf3ef058,0,nixonrodrigues,2020-02-26 14:39:18+05:18,['c99e15b3711e0aebb4c1db086553f915ecd471d1'],404,24,428,1726584,9,0.214765101,0.11409396,0.22147651,3856
024f5d52d0a972616362ac9b15ed7a417384026f,1,nixonrodrigues,2020-02-26 14:39:37+05:18,['b02443ec117458254f919ec60d2dee5fdf3ef058'],1690,227,1917,1728501,31,0.221606648,0.056786704,0.137119114,3856
3c9a437094f800467fa80cdccefefb6538839496,0,kevalbhatt,2020-02-27 18:36:30+05:18,['024f5d52d0a972616362ac9b15ed7a417384026f'],99,35,134,1728635,5,1,1,0.648648649,3856
ec3c6dba44edc353adddb4f2d30decff2446e401,1,kevalbhatt,2020-02-28 12:24:38+05:18,['3c9a437094f800467fa80cdccefefb6538839496'],10,80,90,1728725,4,0.304347826,1,0.304347826,3857
91d2b8ea5b7b968d243717205903f31e3a2d574f,0,kevalbhatt,2020-02-28 12:25:07+05:18,['ec3c6dba44edc353adddb4f2d30decff2446e401'],0,18,18,1728743,4,0.3,0.4,1,3857
58a58956e30c2d0699ead083aca6f27803394555,1,kevalbhatt,2020-02-29 09:05:41+05:18,['91d2b8ea5b7b968d243717205903f31e3a2d574f'],191,233,424,1729167,22,0.238095238,0.142857143,1,3857
43c134ddf859d7c06be18937d9daf3b26089968f,1,kevalbhatt,2020-02-29 09:05:54+05:18,['58a58956e30c2d0699ead083aca6f27803394555'],41,92,133,1729300,12,0.391304348,1,1,3857
69d403e8ca6b22648457e1df51b7e549b6882f3e,0,kevalbhatt,2020-02-29 09:06:04+05:18,['43c134ddf859d7c06be18937d9daf3b26089968f'],280,295,575,1729875,11,0.638888889,1,0.833333333,3857
6a49d94faf9613d3b10c33373500ca5e09b8dc7f,0,Ashutosh Mestry,2020-03-02 08:03:08-08:00,['69d403e8ca6b22648457e1df51b7e549b6882f3e'],0,0,0,1729875,3,,,,3860
ed2755dcce37318ffce21e5ecd7692416aa49a1d,1,Ashutosh Mestry,2020-03-02 08:05:55-08:00,['6a49d94faf9613d3b10c33373500ca5e09b8dc7f'],0,169,169,1730044,2,1,1,1,3862
30a099551210b7f5ec6d5cffa39561439278afea,1,nixonrodrigues,2020-03-02 22:49:27+05:18,['ed2755dcce37318ffce21e5ecd7692416aa49a1d'],2,5,7,1730051,2,,,,3862
e8661ecbc49e750b3e962aa999f11b2a94d8fe27,1,Ashutosh Mestry,2020-03-02 10:20:48-08:00,['30a099551210b7f5ec6d5cffa39561439278afea'],10,474,484,1730535,8,0.878326996,1,0.946768061,3864
cc601d7371fae1dbc16b55d1ca84f06b745700dc,0,Ashutosh Mestry,2020-03-02 10:20:48-08:00,['e8661ecbc49e750b3e962aa999f11b2a94d8fe27'],11,9,20,1730555,2,0,0,0,3864
371f967f605ec72e1d1a4fc2030d008cbede27fa,1,Sarath Subramanian,2020-03-02 15:54:52-08:00,['cc601d7371fae1dbc16b55d1ca84f06b745700dc'],345,1499,1844,1732399,46,0.704697987,0.908277405,0.937360179,3874
668addac196bafcea7f10f19ef74428f74f778fd,0,Ashutosh Mestry,2020-03-04 12:23:11-08:00,['371f967f605ec72e1d1a4fc2030d008cbede27fa'],5,13,18,1732417,1,0,0,0,3874
e50372820f146636ba606695ea4bd8ae91d82e55,1,kevalbhatt,2020-03-05 18:43:53+05:18,['668addac196bafcea7f10f19ef74428f74f778fd'],5,123,128,1732545,4,0,0.076086957,0.402173913,3874
0e947170b60b2903a4217216a65edded07b90c52,1,Madhan Neethiraj,2020-03-06 07:15:33-08:00,['e50372820f146636ba606695ea4bd8ae91d82e55'],1284,1282,2566,1735111,40,0,0,0,3876
7de3579343aecff08a8507cb7a131855929ca828,0,Madhan Neethiraj,2020-03-08 09:50:18-07:00,['0e947170b60b2903a4217216a65edded07b90c52'],2,2,4,1735115,1,,,,3876
30a275d4704ec82a3a860fd239274972ecec41af,0,Madhan Neethiraj,2020-03-08 20:53:02-07:00,['7de3579343aecff08a8507cb7a131855929ca828'],27,125,152,1735267,3,0.058823529,0.411764706,0,3876
aa4bbb08f0b18cfbfc7e0f54e5021bf702445bec,1,kevalbhatt,2020-03-09 23:13:19+05:18,['30a275d4704ec82a3a860fd239274972ecec41af'],156,241,397,1735664,19,0.405063291,0.392405063,0.898734177,3876
3d0fcedb025b5a2669fa7f32af826323a3c1d58f,1,Sarath Subramanian,2020-03-09 13:55:53-07:00,['aa4bbb08f0b18cfbfc7e0f54e5021bf702445bec'],1316,1144,2460,1738124,41,0.25,0,0,3879
765ea583b23d25ecc919d520092747c4158466a5,1,Ashutosh Mestry,2020-03-09 14:12:21-07:00,['3d0fcedb025b5a2669fa7f32af826323a3c1d58f'],200,1224,1424,1739548,24,0.797560976,0.926829268,0.831707317,3889
6ecad6e57be5f880c98fc7fa7179fe3e61226382,1,nixonrodrigues,2020-03-11 11:39:14+05:18,['765ea583b23d25ecc919d520092747c4158466a5'],7,58,65,1739613,3,0.72,0.72,1,3889
c6cac0301707e0d5ac983902a0c2aeefb148c872,0,nixonrodrigues,2020-03-11 11:48:09+05:18,['6ecad6e57be5f880c98fc7fa7179fe3e61226382'],2,36,38,1739651,1,0,0,0,3889
ba5b2dba53387b11707a073538e7b804be19e0b3,0,Madhan Neethiraj,2020-03-11 11:29:56-07:00,['c6cac0301707e0d5ac983902a0c2aeefb148c872'],2,10,12,1739663,3,1,1,1,3889
e1b205c61583e0624286d83e539d9b06702a4388,0,Madhan Neethiraj,2020-03-11 14:42:41-07:00,['ba5b2dba53387b11707a073538e7b804be19e0b3'],0,436,436,1740099,1,,,,3890
72910c4f98fcc2d9a315aaea909196e30b55e821,0,nixonrodrigues,2020-03-12 14:29:25+05:18,['e1b205c61583e0624286d83e539d9b06702a4388'],52,81,133,1740232,1,0.571428571,0,1,3890
2e69f922364285eda332b2da208ce1adb7fa8281,0,nixonrodrigues,2020-03-13 12:27:27+05:18,['72910c4f98fcc2d9a315aaea909196e30b55e821'],3,53,56,1740288,4,0,1,1,3890
506ffc97ca641f86da4e90b821061162f15c0fef,1,nixonrodrigues,2020-03-13 13:11:19+05:18,['2e69f922364285eda332b2da208ce1adb7fa8281'],376,180,556,1740844,12,0.690140845,0.112676056,0.126760563,3890
ffd2e2b5df934f5266e362e6b8ad1a6d4dfa6501,1,nixonrodrigues,2020-03-13 13:11:33+05:18,['506ffc97ca641f86da4e90b821061162f15c0fef'],707,569,1276,1742120,16,0.934782609,0.652173913,0.02173913,3892
1ccb7c715cb0ff0f60f27d21c77a810e6640e01c,1,nixonrodrigues,2020-03-13 13:11:44+05:18,['ffd2e2b5df934f5266e362e6b8ad1a6d4dfa6501'],41,49,90,1742210,3,0,0,1,3892
14b57dbdff26005af674d331d86604c2999c32e5,1,nixonrodrigues,2020-03-13 14:24:08+05:18,['1ccb7c715cb0ff0f60f27d21c77a810e6640e01c'],4,4,8,1742218,2,,,,3892
f1df13dc72501d5e4001c72aca2ee2733a047347,1,nixonrodrigues,2020-03-13 17:55:23+05:18,['14b57dbdff26005af674d331d86604c2999c32e5'],25,28,53,1742271,3,1,1,1,3892
5783b701c16df944c7472380828db4e643e6a3b6,0,Madhan Neethiraj,2020-03-15 13:29:31-07:00,['f1df13dc72501d5e4001c72aca2ee2733a047347'],95,194,289,1742560,4,0.886792453,1,0.528301887,3892
9d6f1f6baec75a393d2effa7359ae7ac028fa6b5,0,GitHub,2020-03-16 12:28:12+05:18,['5783b701c16df944c7472380828db4e643e6a3b6'],0,27,27,1742587,1,,,,3892
721fcb413ce7720772c4b14d5cdf07bfd0537c57,0,GitHub,2020-03-16 14:30:35+05:18,['9d6f1f6baec75a393d2effa7359ae7ac028fa6b5'],0,47,47,1742634,1,,,,3892
60f878e599a37a4befaa21b89fa8982a8d1ace90,1,kevalbhatt,2020-03-16 19:44:45+05:18,['721fcb413ce7720772c4b14d5cdf07bfd0537c57'],20,8,28,1742662,2,0,0,0.9,3892
3d0c98779f16c7f0c6faa2b441877458ea152675,1,Ashutosh Mestry,2020-03-16 10:02:31-07:00,['60f878e599a37a4befaa21b89fa8982a8d1ace90'],27,548,575,1743237,12,0.671328671,0.937062937,0.86013986,3895
2c86bcac2acbde694d1f98e47eb7a3c7bbd0dbce,0,Madhan Neethiraj,2020-03-16 12:21:32-07:00,['3d0c98779f16c7f0c6faa2b441877458ea152675'],10,5,15,1743252,1,1,1,0,3895
97ecfc7eb2b78d19fc125076e1e3961be230f83f,0,GitHub,2020-03-17 20:40:42+05:18,['2c86bcac2acbde694d1f98e47eb7a3c7bbd0dbce'],1,34,35,1743287,1,,,,3895
9647c913c1ae7c175c45933a51fd96c0fb168897,1,kevalbhatt,2020-03-19 17:40:52+05:18,['97ecfc7eb2b78d19fc125076e1e3961be230f83f'],32,92,124,1743411,10,1,1,0.428571429,3895
a30c6d4e9c3855c15978bf1e50f287831bbae8bc,0,GitHub,2020-03-20 21:49:16+05:18,['9647c913c1ae7c175c45933a51fd96c0fb168897'],0,23,23,1743434,1,,,,3896
784b606ddfa2149535b437483051a68859689a9d,1,Sarath Subramanian,2020-03-20 23:40:51-07:00,['a30c6d4e9c3855c15978bf1e50f287831bbae8bc'],14,567,581,1744015,15,0.430379747,0.705696203,0.787974684,3901
dff690a00e3ef690ffd584b07d243586d64b31b7,0,Ashutosh Mestry,2020-03-22 21:52:04-07:00,['784b606ddfa2149535b437483051a68859689a9d'],26,23,49,1744064,5,0,0,0,3901
df8502ea4962e95ad02a7e05b5bb1ae50ccd0bcb,1,Sarath Subramanian,2020-03-22 22:22:22-07:00,['dff690a00e3ef690ffd584b07d243586d64b31b7'],2,51,53,1744117,3,0.891891892,0.405405405,1,3901
cfee9cefab5b97696449ad6c2977b1f379fdae2f,0,nixonrodrigues,2020-03-24 12:36:17+05:18,['df8502ea4962e95ad02a7e05b5bb1ae50ccd0bcb'],2,2,4,1744121,1,,,,3901
a78e208ddaf249134a6e3ab0df14cb9f609b40c2,1,nixonrodrigues,2020-03-24 12:38:12+05:18,['cfee9cefab5b97696449ad6c2977b1f379fdae2f'],445,1021,1466,1745587,23,0.807174888,0.99103139,0.946188341,3905
2a9b1ff1740ff18aa7dc53d434e5576ee8101d6c,0,nixonrodrigues,2020-03-24 14:21:50+05:18,['a78e208ddaf249134a6e3ab0df14cb9f609b40c2'],5,54,59,1745646,2,0.046511628,0.069767442,1,3905
27dc446db963dea71d7db559646d3a7385b83a6f,0,nixonrodrigues,2020-03-24 18:09:35+05:18,['2a9b1ff1740ff18aa7dc53d434e5576ee8101d6c'],54,5,59,1745705,2,0.953488372,0.930232558,0,3905
f30fd67f053e62035a7edc3a1126c369850c3bfa,1,nixonrodrigues,2020-03-24 18:12:39+05:18,['27dc446db963dea71d7db559646d3a7385b83a6f'],4,53,57,1745762,2,0.046511628,0.069767442,1,3905
76011077145d0eb6c8d683ffc7ceee6614ba2573,0,Madhan Neethiraj,2020-03-24 12:47:55-07:00,['f30fd67f053e62035a7edc3a1126c369850c3bfa'],1,1,2,1745764,1,,,,3905
00fb162d880489dfdd744c136d128bfaeaadde24,0,nixonrodrigues,2020-03-25 11:24:34+05:18,['76011077145d0eb6c8d683ffc7ceee6614ba2573'],9,633,642,1746406,7,0.552419355,0.955645161,0.943548387,3905
0d0a3899443f7e701aa4c5c152ad601e9f913e52,0,Madhan Neethiraj,2020-03-25 15:54:03-07:00,['00fb162d880489dfdd744c136d128bfaeaadde24'],81,0,81,1746487,8,,,,3905
5c9cb78154da808debd1fa9d8d4cacbcc4a3f7bf,1,nixonrodrigues,2020-03-26 17:37:29+05:18,['0d0a3899443f7e701aa4c5c152ad601e9f913e52'],57,79,136,1746623,5,1,1,1,3905
60b7d2ac75828a806b64322599e09fe3376ce7b6,1,kevalbhatt,2020-03-26 18:14:39+05:18,['5c9cb78154da808debd1fa9d8d4cacbcc4a3f7bf'],91,366,457,1747080,27,0.865030675,0.957055215,0.865030675,3905
c06221ae636babeabdeff042853286051f46cf07,0,nixonrodrigues,2020-03-26 19:11:27+05:18,['60b7d2ac75828a806b64322599e09fe3376ce7b6'],1,1,2,1747082,1,,,,3905
d0147981ceb9a0afdef58ee53fea6c5d2379b0f3,1,kevalbhatt,2020-03-27 15:29:44+05:18,['c06221ae636babeabdeff042853286051f46cf07'],8,39,47,1747129,11,0.941176471,0.941176471,1,3905
22ca98b04cb8c66c60ca1f688029d2fe9682e7af,1,kevalbhatt,2020-03-28 12:01:19+05:18,['d0147981ceb9a0afdef58ee53fea6c5d2379b0f3'],1,4,5,1747134,1,1,1,1,3905
ef20f8ff337519166ae837d8a884ef5f875ea84b,0,Madhan Neethiraj,2020-03-28 14:01:49-07:00,['22ca98b04cb8c66c60ca1f688029d2fe9682e7af'],1,2,3,1747137,1,,,,3905
e58e7d42b47326feb97779f4e4147c78cefc866c,0,kevalbhatt,2020-03-30 14:52:38+05:18,['ef20f8ff337519166ae837d8a884ef5f875ea84b'],23,69,92,1747229,7,0.692307692,1,1,3906
9e2a49bcce4bedf0fcf932e05917b205ea569b92,0,kevalbhatt,2020-03-30 14:52:47+05:18,['e58e7d42b47326feb97779f4e4147c78cefc866c'],6,6,12,1747241,5,,,,3906
d727cef743bf78293c3affed5f003fab3d1b02de,1,Ashutosh Mestry,2020-03-30 09:09:43-07:00,['9e2a49bcce4bedf0fcf932e05917b205ea569b92'],7,24,31,1747272,3,0.692307692,1,1,3906
fc0ae7713acfe0b24e0c56325a0e9b92283ea3a5,1,Madhan Neethiraj,2020-03-30 11:56:53-07:00,['d727cef743bf78293c3affed5f003fab3d1b02de'],16,20,36,1747308,1,0,0,1,3906
61c2fe3ebeb7a71620bc9d0a231710d2b42aa800,1,nixonrodrigues,2020-03-31 16:20:11+05:18,['fc0ae7713acfe0b24e0c56325a0e9b92283ea3a5'],35,67,102,1747410,2,0,0,1,3906
4d0f5ce213a49fcd8509a2ea5f6a0bb733c0c186,0,nixonrodrigues,2020-03-31 16:20:26+05:18,['61c2fe3ebeb7a71620bc9d0a231710d2b42aa800'],46,42,88,1747498,1,1,1,1,3906
37d64be5c3f88de935919b806baafa5d8e250f5b,0,nixonrodrigues,2020-03-31 16:55:25+05:18,['4d0f5ce213a49fcd8509a2ea5f6a0bb733c0c186'],3,3,6,1747504,2,0,0,0,3906
521118c82585d959cd22262d0012eb8c6b17c05a,0,Madhan Neethiraj,2020-03-31 10:48:47-07:00,['37d64be5c3f88de935919b806baafa5d8e250f5b'],1,18,19,1747523,2,0.777777778,0.777777778,0.555555556,3906
f5cd728d561a3e58a6b69c8b635e04769103a67f,1,Madhan Neethiraj,2020-03-31 10:53:43-07:00,['521118c82585d959cd22262d0012eb8c6b17c05a'],21,168,189,1747712,5,0.086538462,0.875,1,3906
6b7837028c671334dd2e44f03e6d464b9812778b,0,Ashutosh Mestry,2020-03-31 13:16:18-07:00,['f5cd728d561a3e58a6b69c8b635e04769103a67f'],3,12,15,1747727,1,,,,3906
36956bc0c4747c93d1b0c6e234168f18bdbaebb2,0,Madhan Neethiraj,2020-03-31 14:25:43-07:00,['6b7837028c671334dd2e44f03e6d464b9812778b'],29,21,50,1747777,1,1,1,0,3906
2ac034253386ca8d173f67317505076783cedbf7,1,kevalbhatt,2020-04-01 14:49:21+05:18,['36956bc0c4747c93d1b0c6e234168f18bdbaebb2'],80,136,216,1747993,10,0.96969697,0.96969697,1,3906
6ece28fd957ca2e90936914bdfd26c7c35c1f306,0,kevalbhatt,2020-04-01 14:49:35+05:18,['2ac034253386ca8d173f67317505076783cedbf7'],2,6,8,1748001,2,1,1,1,3906
2fbfb5572e3ae7e71e71b70e391844d98293599a,0,kevalbhatt,2020-04-01 18:11:03+05:18,['6ece28fd957ca2e90936914bdfd26c7c35c1f306'],12,83,95,1748096,5,0.361111111,0.5,0.416666667,3906
95923fba04e99c9bcf4af70fe8faf834c802fdf9,1,kevalbhatt,2020-04-01 18:11:37+05:18,['2fbfb5572e3ae7e71e71b70e391844d98293599a'],136,188,324,1748420,13,0.418604651,0.395348837,1,3906
e0eb318c247ba68e3b570feb7298f488bcaf8bf3,0,Madhan Neethiraj,2020-04-02 08:56:06-07:00,['95923fba04e99c9bcf4af70fe8faf834c802fdf9'],5,5,10,1748430,2,,,,3906
159afa8044fac64436268e1f64bfe43beff65096,0,Ashutosh Mestry,2020-04-02 11:14:41-07:00,['e0eb318c247ba68e3b570feb7298f488bcaf8bf3'],33,11,44,1748474,1,1,1,1,3906
076d83c3face54b53159faa066e398f622d836b0,0,Madhan Neethiraj,2020-04-02 23:52:24-07:00,['159afa8044fac64436268e1f64bfe43beff65096'],15,138,153,1748627,8,0.189189189,0.391891892,0.878378378,3907
73bf850fd77ef550aaffaa6c034c4fe4dc29b7af,0,kevalbhatt,2020-04-03 12:51:58+05:18,['076d83c3face54b53159faa066e398f622d836b0'],26,28,54,1748681,4,0,1,0,3907
64b24351c6fb45d04f927b6cfd6f61e486e7fe23,0,kevalbhatt,2020-04-03 12:59:49+05:18,['73bf850fd77ef550aaffaa6c034c4fe4dc29b7af'],20,10,30,1748711,4,0,0,1,3907
d485860937e0fb40dfd69566754a637fb1c0c132,0,Sarath Subramanian,2020-04-06 17:52:15-07:00,['64b24351c6fb45d04f927b6cfd6f61e486e7fe23'],19,154,173,1748884,1,0.130952381,0.130952381,0.154761905,3907
683e267bdf2e9461fbfdefe514e1856e32ce8e4b,0,Ashutosh Mestry,2020-04-06 21:32:16-07:00,['d485860937e0fb40dfd69566754a637fb1c0c132'],1,1,2,1748886,1,,,,3907
ec48c09a847db001fba6f2ef909d4f5d20ff25b9,0,kevalbhatt,2020-04-09 20:34:21+05:18,['683e267bdf2e9461fbfdefe514e1856e32ce8e4b'],0,0,0,1748886,4,,,,3911
3ff785a8950303cc9c33ff20c1caffecc5b464e5,1,Sarath Subramanian,2020-04-09 22:13:15-07:00,['ec48c09a847db001fba6f2ef909d4f5d20ff25b9'],11,33,44,1748930,6,0.9,1,0.9,3911
1e8fa7e59b332e3543d797618879510f70ff8fe4,1,Sarath Subramanian,2020-04-10 13:18:31-07:00,['3ff785a8950303cc9c33ff20c1caffecc5b464e5'],57,52,109,1749039,4,0,1,0,3911
fa2e5b49aa0d71464e850d631bef2640b2e4ef55,1,Sarath Subramanian,2020-04-10 13:46:05-07:00,['1e8fa7e59b332e3543d797618879510f70ff8fe4'],47,752,799,1749838,13,0.692144374,0.751592357,0.535031847,3914
c135962b8340444943223a33fce67a06fda55b5b,0,Sarath Subramanian,2020-04-10 15:23:00-07:00,['fa2e5b49aa0d71464e850d631bef2640b2e4ef55'],2,4,6,1749844,1,0,0,0,3914
80135a8dbedfbaff444267681aa13d958e867c7e,1,Madhan Neethiraj,2020-04-12 10:50:23-07:00,['c135962b8340444943223a33fce67a06fda55b5b'],57,163,220,1750064,10,0.6,0.6,0.55,3914
eef89a77f8400f32009c226021ec869f427066b6,0,Sarath Subramanian,2020-04-14 15:07:09-07:00,['80135a8dbedfbaff444267681aa13d958e867c7e'],2,5,7,1750071,2,0,0,0,3914
490e37ec35fe6671396029a40a006a0be521eaf8,0,Madhan Neethiraj,2020-04-15 08:59:29-07:00,['eef89a77f8400f32009c226021ec869f427066b6'],10,15,25,1750096,2,0,0,1,3914
ad226ddd9c4c13b0f9e5a3e3d8fe6de2299957aa,0,kevalbhatt,2020-04-17 15:16:32+05:18,['490e37ec35fe6671396029a40a006a0be521eaf8'],8,4,12,1750108,2,1,1,1,3914
ff1a9dc2fcc6d45e2965848379bdca8e605cdd12,0,kevalbhatt,2020-04-17 18:10:48+05:18,['ad226ddd9c4c13b0f9e5a3e3d8fe6de2299957aa'],1115,1713,2828,1752936,14,1,1,0.898989899,3914
c1779231cfff4a6f6d934a38a5094defed1e07e6,0,Sarath Subramanian,2020-04-17 16:12:01-07:00,['ff1a9dc2fcc6d45e2965848379bdca8e605cdd12'],10,14,24,1752960,1,0,1,1,3914
b866e48f1ecd3d66d5383585a6c88093a374c065,1,Sarath Subramanian,2020-04-17 16:25:22-07:00,['c1779231cfff4a6f6d934a38a5094defed1e07e6'],48,185,233,1753193,14,0.483516484,0.494505495,0.483516484,3914
750646e75f870be1f5d1c67aa23933c6bb453c40,0,Madhan Neethiraj,2020-04-17 16:31:19-07:00,['b866e48f1ecd3d66d5383585a6c88093a374c065'],138,140,278,1753471,5,1,0,0.076923077,3914
e6de42b7a3da6ebc6326813108d2b0cbcacac0f1,1,Sarath Subramanian,2020-04-17 16:44:43-07:00,['750646e75f870be1f5d1c67aa23933c6bb453c40'],2,17,19,1753490,2,1,1,1,3914
318c645fb555b17b9fdd8c2f1b642a3065e337fc,0,Ashutosh Mestry,2020-04-20 17:49:29-07:00,['e6de42b7a3da6ebc6326813108d2b0cbcacac0f1'],0,8,8,1753498,2,0,0,1,3914
8ed641a785d42ea4d7fa2872486a6bac08b473a3,0,Madhan Neethiraj,2020-04-21 08:49:13-07:00,['318c645fb555b17b9fdd8c2f1b642a3065e337fc'],1,1,2,1753500,1,,,,3914
5afa572376ec0204371903263ba43073ee12ea1b,0,Sarath Subramanian,2020-04-21 15:24:04-07:00,['8ed641a785d42ea4d7fa2872486a6bac08b473a3'],2,3,5,1753505,2,,,,3914
7b650f7ab8c67a34c4f577dbd8ead6fcf78d13a6,1,kevalbhatt,2020-04-22 21:12:22+05:18,['5afa572376ec0204371903263ba43073ee12ea1b'],8,23,31,1753536,4,1,1,0,3914
21e9f2f9f43edfdbb3ce1b550a81e721f6453ccd,1,kevalbhatt,2020-04-22 21:12:34+05:18,['7b650f7ab8c67a34c4f577dbd8ead6fcf78d13a6'],56,46,102,1753638,9,0,0.285714286,1,3914
c5464da3d53a8ad9cc73dd83bf27240cecedd4f1,0,kevalbhatt,2020-04-22 21:12:46+05:18,['21e9f2f9f43edfdbb3ce1b550a81e721f6453ccd'],40,36,76,1753714,4,0,0,0,3914
8baade2486b5ee5d41f8a00c19011a9484bf63be,1,kevalbhatt,2020-04-22 21:13:21+05:18,['c5464da3d53a8ad9cc73dd83bf27240cecedd4f1'],35,64,99,1753813,9,0.903225806,1,1,3914
16621dfc0ba93ab0b5e59d88b01165fab321834d,0,kevalbhatt,2020-04-22 21:13:31+05:18,['8baade2486b5ee5d41f8a00c19011a9484bf63be'],3,3,6,1753819,2,,,,3914
862ba9baed7af208456e59a42466aa0894cd8a6d,1,nixonrodrigues,2020-04-23 11:27:51+05:18,['16621dfc0ba93ab0b5e59d88b01165fab321834d'],5,50,55,1753874,2,0.352941176,0.352941176,0.735294118,3914
1f871efb128e2e4ff2927f0196617bb278049a70,0,nixonrodrigues,2020-04-23 13:41:42+05:18,['862ba9baed7af208456e59a42466aa0894cd8a6d'],1,1,2,1753876,1,,,,3914
718b42d9b351dfecdbb62d06ab8a47e5b9697a40,1,kevalbhatt,2020-04-24 22:17:35+05:18,['1f871efb128e2e4ff2927f0196617bb278049a70'],332,4435,4767,1758643,66,0.636696501,0.851912124,0.945890968,3937
40fa099cc52eb7e5646be43986da5ed2b4d08a99,1,kevalbhatt,2020-04-24 22:17:58+05:18,['718b42d9b351dfecdbb62d06ab8a47e5b9697a40'],375,160,535,1759178,22,0.3,0,0.05,3937
2b38550b88ea201a3bd9169c44c0ede900ec1dd8,1,Ashutosh Mestry,2020-04-24 15:04:08-07:00,['40fa099cc52eb7e5646be43986da5ed2b4d08a99'],353,544,897,1760075,36,0.470149254,0.805970149,0,3937
f304f59f6a9b57d93af27d76c9d3875c5efac09a,1,kevalbhatt,2020-04-27 20:37:46+05:18,['2b38550b88ea201a3bd9169c44c0ede900ec1dd8'],55,126,181,1760256,11,0.301886792,0.396226415,0.396226415,3937
b4246817251429ec986e9f4a37adca7cf334a2a4,1,kevalbhatt,2020-04-29 10:45:46+05:18,['f304f59f6a9b57d93af27d76c9d3875c5efac09a'],101,256,357,1760613,9,0.785714286,0.595238095,1,3938
204275cc2d7fc520e1f9ea2b0f2ad6161af706c5,0,Madhan Neethiraj,2020-04-29 08:01:46-07:00,['b4246817251429ec986e9f4a37adca7cf334a2a4'],7,4,11,1760624,1,1,1,0,3938
25f3002e0e84927eb39cebb5708d77ef81755d79,0,Ashutosh Mestry,2020-04-29 16:32:29-07:00,['204275cc2d7fc520e1f9ea2b0f2ad6161af706c5'],20,111,131,1760755,5,0.638297872,1,0.446808511,3938
861f8f23bc086fa8be0ebee82848dd2c883acdb0,0,nixonrodrigues,2020-04-30 11:32:54+05:18,['25f3002e0e84927eb39cebb5708d77ef81755d79'],0,9,9,1760764,1,0,0,1,3938
dfd3ff643916c4a5ab27b45177009aee62b80bc1,0,GitHub,2020-05-01 19:12:29+05:18,['861f8f23bc086fa8be0ebee82848dd2c883acdb0'],1,1,2,1760766,1,,,,3938
a43b5488fbd10c874d181bf27e076fd502693a93,1,Ashutosh Mestry,2020-05-01 11:03:07-07:00,['dfd3ff643916c4a5ab27b45177009aee62b80bc1'],6,37,43,1760809,1,0.285714286,0.238095238,0,3938
1c07f93b577d156ccf7c9adb75c447359002ed38,1,kevalbhatt,2020-05-02 10:57:33+05:18,['a43b5488fbd10c874d181bf27e076fd502693a93'],587,331,918,1761727,25,0.561085973,0,0.542986425,3938
0e53c3ee3a135f86641e5ba6d4bf64502b1645ed,0,Sarath Subramanian,2020-05-03 17:01:08-07:00,['1c07f93b577d156ccf7c9adb75c447359002ed38'],44,78,122,1761849,4,0.875,0.875,1,3938
de6965341d357fde05c002572cdde6115888f7cc,0,kevalbhatt,2020-05-04 11:55:55+05:18,['0e53c3ee3a135f86641e5ba6d4bf64502b1645ed'],97,92,189,1762038,4,0,0,0,3938
f467229294baa5550f4101d1e8ea59e82fdf3e3b,0,Ashutosh Mestry,2020-05-05 08:42:56-07:00,['de6965341d357fde05c002572cdde6115888f7cc'],31,18,49,1762087,3,1,1,0,3938
23aea76fff6c8f530816319649218583f4dfd091,0,Ashutosh Mestry,2020-05-05 08:42:56-07:00,['f467229294baa5550f4101d1e8ea59e82fdf3e3b'],35,34,69,1762156,4,1,0,1,3938
f20f8bae023360f0f577342f8aea5ff0026b87e8,1,kevalbhatt,2020-05-07 18:38:33+05:18,['23aea76fff6c8f530816319649218583f4dfd091'],11,68,79,1762235,8,0,0,1,3938
b7b7c840c033d7d2553e804d0388e63d9cbc8e0f,0,Sarath Subramanian,2020-05-07 08:48:53-07:00,['f20f8bae023360f0f577342f8aea5ff0026b87e8'],2,2,4,1762239,1,,,,3938
9bddab89e1e06fc4f6955afbf1b10b6f8bb0e7ac,0,Madhan Neethiraj,2020-05-07 11:57:46-07:00,['b7b7c840c033d7d2553e804d0388e63d9cbc8e0f'],9,151,160,1762399,5,0.627118644,0.949152542,1,3939
103e867cc126ddb84e64bf262791a01a55bee6e5,1,Madhan Neethiraj,2020-05-13 22:33:11-07:00,['9bddab89e1e06fc4f6955afbf1b10b6f8bb0e7ac'],9,185,194,1762593,5,0.808219178,1,0.890410959,3940
1c034cbaaeeda50224b77fae63ca617221b49f6c,1,nixonrodrigues,2020-05-14 15:30:09+05:18,['103e867cc126ddb84e64bf262791a01a55bee6e5'],37,272,309,1762902,3,0.869230769,0.992307692,0.9,3941
c08c9f382b88570d3bea1fb66937142b2f719f56,1,nixonrodrigues,2020-05-14 15:30:38+05:18,['1c034cbaaeeda50224b77fae63ca617221b49f6c'],5,62,67,1762969,7,0.774193548,0.838709677,1,3941
d8cb94ac65dde5e1585ffe6d547450f647b65d76,0,Sarath Subramanian,2020-05-15 10:11:13-07:00,['c08c9f382b88570d3bea1fb66937142b2f719f56'],0,9,9,1762978,1,,,,3941
935d0ab6465775e16db62896375d96f6a567b884,0,Ashutosh Mestry,2020-05-15 11:49:51-07:00,['d8cb94ac65dde5e1585ffe6d547450f647b65d76'],1,12,13,1762991,2,0,1,1,3941
214f2a760a1a4c8c3a83b5afaa42fdc36055ff98,0,Ashutosh Mestry,2020-05-15 11:50:33-07:00,['935d0ab6465775e16db62896375d96f6a567b884'],5,14,19,1763010,2,1,1,1,3941
3de30f55d808df6245f60fe01fed4b6cf894a31d,0,Ashutosh Mestry,2020-05-15 11:56:23-07:00,['214f2a760a1a4c8c3a83b5afaa42fdc36055ff98'],20,5,25,1763035,1,0,0,0,3941
0571fa42897e33a29baf4d1bd10ee04ae222dc70,0,Ashutosh Mestry,2020-05-15 12:04:34-07:00,['3de30f55d808df6245f60fe01fed4b6cf894a31d'],14,27,41,1763076,2,1,1,1,3941
574e20a0cbc5a34c53e08fd43052ee539404af24,0,nixonrodrigues,2020-05-18 10:40:18+05:18,['0571fa42897e33a29baf4d1bd10ee04ae222dc70'],1,2,3,1763079,1,0,0,1,3941
e29abf1294c241c96645781645caf4fff89c6180,0,Madhan Neethiraj,2020-05-17 22:53:53-07:00,['574e20a0cbc5a34c53e08fd43052ee539404af24'],6,6,12,1763091,1,,,,3941
887087d9b9de0e2cf932c4ddd337693efbbd3ddd,1,kevalbhatt,2020-05-21 22:03:19+05:18,['e29abf1294c241c96645781645caf4fff89c6180'],6,15,21,1763112,2,0.666666667,0.666666667,1,3941
2228d752714b8edeea2ccf0aba660f69e765e6fa,1,kevalbhatt,2020-05-21 22:04:19+05:18,['887087d9b9de0e2cf932c4ddd337693efbbd3ddd'],10,151,161,1763273,8,0.297297297,0.756756757,0.756756757,3941
2dd41162b1832a1f574a28567289772fa21d65af,1,kevalbhatt,2020-05-21 22:04:33+05:18,['2228d752714b8edeea2ccf0aba660f69e765e6fa'],2,32,34,1763307,4,0.933333333,0.933333333,1,3941
62451d62a01bf62e2bc50ec7d9585365329086a6,1,kevalbhatt,2020-05-21 22:05:24+05:18,['2dd41162b1832a1f574a28567289772fa21d65af'],94,163,257,1763564,18,0.977011494,0.965517241,0.816091954,3941
b9f4ae790accee9fa0e97d963038165742f88a72,0,kevalbhatt,2020-05-21 22:05:36+05:18,['62451d62a01bf62e2bc50ec7d9585365329086a6'],3,9,12,1763576,1,1,0,1,3941
7718c5eb4955818befefcd7d9768f1cdb202cff2,1,nixonrodrigues,2020-05-22 18:30:23+05:18,['b9f4ae790accee9fa0e97d963038165742f88a72'],39,172,211,1763787,4,0.484536082,1,0.515463918,3941
6248e361fc01256ba263a6f4523c50541f6fc86b,1,Madhan Neethiraj,2020-05-25 15:30:27-07:00,['7718c5eb4955818befefcd7d9768f1cdb202cff2'],29,91,120,1763907,4,0.2,0.966666667,0.533333333,3941
61abecac22ef3e9341a07be6d5354bf246544a3b,1,nixonrodrigues,2020-05-27 11:41:36+05:18,['6248e361fc01256ba263a6f4523c50541f6fc86b'],34,258,292,1764199,4,0.044303797,0.664556962,1,3941
56ecce625f89e2339d1467587f7a8ae134139160,0,Madhan Neethiraj,2020-05-27 07:29:40-07:00,['61abecac22ef3e9341a07be6d5354bf246544a3b'],29,29,58,1764257,1,,,,3941
d6ba8569f11cd1803bb0d335122111d9153552ae,1,kevalbhatt,2020-05-27 21:01:59+05:18,['56ecce625f89e2339d1467587f7a8ae134139160'],37,47,84,1764341,16,0,1,1,3941
1a971463d74320dcf093598cd456b1c369a5cb75,0,kevalbhatt,2020-05-27 21:01:59+05:18,['d6ba8569f11cd1803bb0d335122111d9153552ae'],4,6,10,1764351,2,,,,3941
e58c98ec65008280182472c4e63d7206393c99a9,0,Sarath Subramanian,2020-05-28 10:42:04-07:00,['1a971463d74320dcf093598cd456b1c369a5cb75'],3,3,6,1764357,2,,,,3941
00bef883c5561596ccc2b7b1075e8379bf8ac6bb,0,Ashutosh Mestry,2020-05-28 11:54:25-07:00,['e58c98ec65008280182472c4e63d7206393c99a9'],1,2,3,1764360,1,1,1,1,3941
ac0cd87ad4818020d012ae5265759891c3860a9a,1,Madhan Neethiraj,2020-05-30 10:07:57-07:00,['00bef883c5561596ccc2b7b1075e8379bf8ac6bb'],13,8,21,1764381,2,0,0,1,3941
7a8ca51f83bdd15bf5290f718bd6a79e16eca61b,0,Madhan Neethiraj,2020-05-30 10:17:09-07:00,['ac0cd87ad4818020d012ae5265759891c3860a9a'],8,89,97,1764478,2,0,0.892307692,1,3941
3c3eed082d99f5f509b80aecacbaa9531e37eb25,1,Madhan Neethiraj,2020-06-01 14:01:30-07:00,['7a8ca51f83bdd15bf5290f718bd6a79e16eca61b'],3,95,98,1764576,12,,,,3950
ceec7d746c6c510a35f2279f2149eaa16728dc44,0,Madhan Neethiraj,2020-06-03 00:39:16-07:00,['3c3eed082d99f5f509b80aecacbaa9531e37eb25'],3,0,3,1764579,1,1,1,1,3950
2ed6a48d092da5ebaaf23390f48011193a980265,0,Madhan Neethiraj,2020-06-03 15:49:58-07:00,['ceec7d746c6c510a35f2279f2149eaa16728dc44'],10,12,22,1764601,2,,,,3950
86ba342fe6baee08c6aaa20e50de4c3b8e2ae873,1,Madhan Neethiraj,2020-06-03 20:45:49-07:00,['2ed6a48d092da5ebaaf23390f48011193a980265'],114,110,224,1764825,2,0,0,1,3950
cc185c13c6a310ad34a243fd467890d6c8bf9c79,0,kevalbhatt,2020-06-04 11:03:15+05:18,['86ba342fe6baee08c6aaa20e50de4c3b8e2ae873'],0,3,3,1764828,1,1,1,1,3950
21b15842fd74bc91910b2d8901dbea57769065d0,1,kevalbhatt,2020-06-05 21:34:57+05:18,['cc185c13c6a310ad34a243fd467890d6c8bf9c79'],3,3,6,1764834,1,,,,3950
931d6efdc97f742370df334761673af70f240837,1,Sarath Subramanian,2020-06-08 15:47:38-07:00,['21b15842fd74bc91910b2d8901dbea57769065d0'],9,9,18,1764852,5,,,,3950
985264e129687e4d2c6bfaaa92f6a6550a106e89,0,nixonrodrigues,2020-06-09 10:27:01+05:18,['931d6efdc97f742370df334761673af70f240837'],8,6,14,1764866,2,,,,3950
0df34884deb73237cfb5ecb367a5e4510a080357,0,kevalbhatt,2020-06-10 16:06:27+05:18,['985264e129687e4d2c6bfaaa92f6a6550a106e89'],4,4,8,1764874,13,,,,3962
f4e1e6b0ec58febac3d72d20d4a40a8f218d74e1,0,kevalbhatt,2020-06-10 16:06:37+05:18,['0df34884deb73237cfb5ecb367a5e4510a080357'],23,48,71,1764945,4,0,0.428571429,1,3962
8092d6b5fda19ba523742444123bdbbe9b428914,1,kevalbhatt,2020-06-10 16:08:03+05:18,['f4e1e6b0ec58febac3d72d20d4a40a8f218d74e1'],6,6,12,1764957,2,1,,,3962
e590092c47ab18f904dd7974f834bf05045e5ee4,0,kevalbhatt,2020-06-11 17:14:04+05:18,['8092d6b5fda19ba523742444123bdbbe9b428914'],10,27,37,1764994,5,0,1,1,3962
a3fd6441b872c000ea523d433fca7d076fb173d9,0,Madhan Neethiraj,2020-06-11 12:04:05-07:00,['e590092c47ab18f904dd7974f834bf05045e5ee4'],12,63,75,1765069,6,0,0.36,1,3962
5e8b7f34a75e7b433ff9404fbb973cea04d8f2d4,1,kevalbhatt,2020-06-22 10:28:20+05:18,['a3fd6441b872c000ea523d433fca7d076fb173d9'],428,284,712,1765781,65,0,0.488372093,1,3962
79caa79ad72fca25cecaebdcfcdf5be095852933,0,kevalbhatt,2020-06-22 21:20:57+05:18,['5e8b7f34a75e7b433ff9404fbb973cea04d8f2d4'],42,20,62,1765843,4,0,0,0,3962
c8cf4765bb519fbe4cd4962ce9ab22999fdfaa4b,0,Sarath Subramanian,2020-06-22 13:03:18-07:00,['79caa79ad72fca25cecaebdcfcdf5be095852933'],1,1,2,1765845,1,,,,3962
474d73c5822183ba8e810615eb195d559ef9589a,1,Sarath Subramanian,2020-06-22 14:28:46-07:00,['c8cf4765bb519fbe4cd4962ce9ab22999fdfaa4b'],0,3,3,1765848,1,0,0,0,3962
992b8b47cc332efe71f82c5ecbbee94d3e2774e5,1,Madhan Neethiraj,2020-06-23 12:58:43-07:00,['474d73c5822183ba8e810615eb195d559ef9589a'],10,3,13,1765861,3,1,0,0,3962
aa86d62c057d56f858dc7962aa158d23c82f972b,1,nixonrodrigues,2020-06-25 20:03:31+05:18,['992b8b47cc332efe71f82c5ecbbee94d3e2774e5'],12,62,74,1765935,3,0.8125,0.46875,0.8125,3962
177b01bc61828cd03e7ee6bcd76d336d7d7d3f54,1,kevalbhatt,2020-06-25 20:59:22+05:18,['aa86d62c057d56f858dc7962aa158d23c82f972b'],15,46,61,1765996,6,0.9,0.9,1,3962
b5c4a56f1ece7e10e7a2da15de466899021da254,1,kevalbhatt,2020-06-25 20:59:22+05:18,['177b01bc61828cd03e7ee6bcd76d336d7d7d3f54'],14,44,58,1766054,8,1,1,1,3962
ab9f973123192e0711f67f707cb118525b19993f,0,kevalbhatt,2020-06-25 22:39:46+05:18,['b5c4a56f1ece7e10e7a2da15de466899021da254'],12,38,50,1766104,4,0,0.333333333,1,3962
25ba9b30b916269bc20a5b99b9bc326f5b9e18d3,1,Sarath Subramanian,2020-06-25 14:29:42-07:00,['ab9f973123192e0711f67f707cb118525b19993f'],0,262,262,1766366,1,,,,3963
eb641d560e1537808df172aad11f1338cc0e5e7f,0,Sarath Subramanian,2020-06-25 22:39:56-07:00,['25ba9b30b916269bc20a5b99b9bc326f5b9e18d3'],22,3,25,1766391,2,0.076923077,0.076923077,0,3963
e105576ba955a41e51a6e11f67eefd7b11a0571e,0,Sarath Subramanian,2020-06-26 10:52:15-07:00,['eb641d560e1537808df172aad11f1338cc0e5e7f'],0,0,0,1766391,16,,,,3979
e691a32c2d3888c99757e6aa31694ec8d14c2d48,0,nixonrodrigues,2020-06-29 11:20:24+05:18,['e105576ba955a41e51a6e11f67eefd7b11a0571e'],0,88,88,1766479,4,,,,3981
8b5cb9d9aa9f977ba5dfc455dfe440dd55eace06,1,Sarath Subramanian,2020-06-28 23:39:56-07:00,['e691a32c2d3888c99757e6aa31694ec8d14c2d48'],377,750,1127,1767606,15,0.479166667,0.527777778,0.736111111,3982
9d597f249bc222d362dd96921ed3254579e8fc1b,0,nixonrodrigues,2020-06-29 17:27:38+05:18,['8b5cb9d9aa9f977ba5dfc455dfe440dd55eace06'],33,33,66,1767672,1,,,,3982
0221e3dd297057dab344b8d9b6672a37adafabbc,1,Sarath Subramanian,2020-06-29 15:55:29-07:00,['9d597f249bc222d362dd96921ed3254579e8fc1b'],8,42,50,1767722,1,0,0,0,3982
ce95c6299986eae212f6861ab423f32aa8f7f7d0,0,Sarath Subramanian,2020-06-29 23:38:51-07:00,['0221e3dd297057dab344b8d9b6672a37adafabbc'],1,6,7,1767729,2,0,1,1,3982
8b50ac0c7d8eba8efa0deb97f1fee68d382f11ad,1,Sarath Subramanian,2020-06-30 00:21:21-07:00,['ce95c6299986eae212f6861ab423f32aa8f7f7d0'],302,763,1065,1768794,6,0.614035088,0.719298246,0.635964912,3985
f932e52c687479c77b9967165353b0fffa6f2fa0,1,nixonrodrigues,2020-07-01 14:29:37+05:18,['8b50ac0c7d8eba8efa0deb97f1fee68d382f11ad'],12,16,28,1768822,3,0,1,0,3985
e72aa1076a5a1272935fed4dedaf9e29e41fa30b,1,nixonrodrigues,2020-07-01 14:29:58+05:18,['f932e52c687479c77b9967165353b0fffa6f2fa0'],33,252,285,1769107,1,0.55625,1,0.34375,3985
337575c81b993e2cdcd6dc462dcf614940c783c2,0,nixonrodrigues,2020-07-01 14:36:16+05:18,['e72aa1076a5a1272935fed4dedaf9e29e41fa30b'],1,1,2,1769109,1,,,,3985
0c3d2ed350507db12a8884bb209467185d4723a5,1,nixonrodrigues,2020-07-01 17:00:35+05:18,['337575c81b993e2cdcd6dc462dcf614940c783c2'],40,42,82,1769191,9,1,0,1,3985
3d559d0195c3a93890a0b4c303b5ee99f71dd4de,0,kevalbhatt,2020-07-01 17:38:24+05:18,['0c3d2ed350507db12a8884bb209467185d4723a5'],0,1,1,1769192,1,,,,3985
cea851c5513cede054bc7704ac24c04cc498cd32,0,nixonrodrigues,2020-07-06 18:54:17+05:18,['3d559d0195c3a93890a0b4c303b5ee99f71dd4de'],8,6,14,1769206,1,0,0,0,3985
5f956110f719bcf8a3cb76d11551ce895e0ded9f,1,Madhan Neethiraj,2020-07-07 20:41:59-07:00,['cea851c5513cede054bc7704ac24c04cc498cd32'],54,159,213,1769419,3,0.181818182,0.654545455,1,3985
d604085efe18963f39020e62cd03a5e4fcb20b2b,0,kevalbhatt,2020-07-08 16:34:35+05:18,['5f956110f719bcf8a3cb76d11551ce895e0ded9f'],25,31,56,1769475,8,0.8,1,1,3985
16ced369e741a00cd31da4d6fd5d4fa3dc05ec1a,0,Madhan Neethiraj,2020-07-08 07:35:39-07:00,['d604085efe18963f39020e62cd03a5e4fcb20b2b'],4,34,38,1769513,3,0.380952381,0.380952381,0.571428571,3985
682d16dd19cb72d36af9798811ed701ecdc0dacf,0,nixonrodrigues,2020-07-08 21:20:57+05:18,['16ced369e741a00cd31da4d6fd5d4fa3dc05ec1a'],5,5,10,1769523,1,,,,3985
06cd0cb35a285b3c4a7b0b3c662ce7263848f7b6,0,nixonrodrigues,2020-07-09 12:09:45+05:18,['682d16dd19cb72d36af9798811ed701ecdc0dacf'],18,56,74,1769597,3,0.1875,0,0.59375,3985
f690755f79f9696e3214b9a3f158977b3bd5f4a7,0,nixonrodrigues,2020-07-09 18:34:35+05:18,['06cd0cb35a285b3c4a7b0b3c662ce7263848f7b6'],23,32,55,1769652,3,0,0,1,3985
d9d0e8c2abe293a520f89b85015d9c52985e28cb,0,nixonrodrigues,2020-07-10 20:48:15+05:18,['f690755f79f9696e3214b9a3f158977b3bd5f4a7'],0,11,11,1769663,1,0,0,0,3985
cec7aa851e6befa6d32f3dfd80cc79cc8c3c799a,0,Sarath Subramanian,2020-07-13 12:29:23-07:00,['d9d0e8c2abe293a520f89b85015d9c52985e28cb'],36,26,62,1769725,1,1,0,0,3985
a42f0c1cba87623a9553718a75a844cfadb24218,0,Madhan Neethiraj,2020-07-15 16:21:15-07:00,['cec7aa851e6befa6d32f3dfd80cc79cc8c3c799a'],14,37,51,1769776,1,,,,3985
8827bfb4dab5f19cf0dab5c3fc1e5a4d4a4abbe8,1,Madhan Neethiraj,2020-07-19 23:36:43-07:00,['a42f0c1cba87623a9553718a75a844cfadb24218'],229,2160,2389,1772165,13,0.718959732,0.895134228,0.870805369,3990
7e06f55fc952f7fbbd18eb717f70ae211085068d,0,kevalbhatt,2020-07-20 12:15:37+05:18,['8827bfb4dab5f19cf0dab5c3fc1e5a4d4a4abbe8'],4,30,34,1772199,8,1,1,1,3990
ec314fdeb871a479194af5b543a72df76472cb4c,1,kevalbhatt,2020-07-22 15:27:23+05:18,['7e06f55fc952f7fbbd18eb717f70ae211085068d'],78,348,426,1772625,13,0.376569038,0.928870293,0.979079498,3990
9a067d38e27fc2255647133373b952a6a64ed1a4,1,nixonrodrigues,2020-07-24 17:15:24+05:18,['ec314fdeb871a479194af5b543a72df76472cb4c'],133,608,741,1773366,7,0.779264214,1,0.966555184,3991
500ea95c3e2fbaa231026959304fa6f7ade055be,0,Ashutosh Mestry,2020-07-24 08:44:59-07:00,['9a067d38e27fc2255647133373b952a6a64ed1a4'],1,11,12,1773378,1,1,1,1,3991
05eba3fdb9fedf3483cdb1cef938f7a2cbf7933e,0,Ashutosh Mestry,2020-07-30 15:50:21-07:00,['500ea95c3e2fbaa231026959304fa6f7ade055be'],1,98,99,1773477,4,0.522727273,0.545454545,1,3992
80efe92630a9198ed4b4c564f6e78c8079045930,1,Madhan Neethiraj,2020-07-30 17:11:34-07:00,['05eba3fdb9fedf3483cdb1cef938f7a2cbf7933e'],19,19,38,1773515,4,0,0,1,3992
38d7b91e4aa205f89d71f85328a513cc61516266,0,kevalbhatt,2020-07-31 21:47:15+05:18,['80efe92630a9198ed4b4c564f6e78c8079045930'],6,64,70,1773585,4,0,1,1,3992
ce2ba123a2b9ce43503d5e101400b93fa5b6267e,0,kevalbhatt,2020-08-03 16:19:08+05:18,['38d7b91e4aa205f89d71f85328a513cc61516266'],8,22,30,1773615,2,1,1,1,3992
ba1b40f0426e5ff0e621eab5184d916a6f506f59,0,kevalbhatt,2020-08-03 17:23:43+05:18,['ce2ba123a2b9ce43503d5e101400b93fa5b6267e'],23,19,42,1773657,13,,,,3992
4a57f92f649e389b8f5ef653394a5f091f1a36de,1,Ashutosh Mestry,2020-08-03 11:49:41-07:00,['ba1b40f0426e5ff0e621eab5184d916a6f506f59'],78,351,429,1774086,6,1,1,0.888059701,3995
aa441de4f62947b96f6ff387f4d140a2b83c99dc,1,nixonrodrigues,2020-08-05 11:28:42+05:18,['4a57f92f649e389b8f5ef653394a5f091f1a36de'],217,218,435,1774521,7,1,1,1,3995
fb374763988d869fa8ce1b18bf4d438a64f4bb06,0,Madhan Neethiraj,2020-08-06 16:51:09-07:00,['aa441de4f62947b96f6ff387f4d140a2b83c99dc'],16,13,29,1774550,42,,,,3995
b7255ec7e24f87da6f2dba47965a4e22e94c2250,0,Madhan Neethiraj,2020-08-11 23:42:09-07:00,['fb374763988d869fa8ce1b18bf4d438a64f4bb06'],0,1204,1204,1775754,12,0.557655955,0.856332703,0.852551985,4006
83e9c21f7805b7badc9390a15fd747e1e6a7f8e2,0,Madhan Neethiraj,2020-08-13 08:05:01-07:00,['b7255ec7e24f87da6f2dba47965a4e22e94c2250'],79,73,152,1775906,7,0.666666667,0,0,4006
1b41b980415961419bb4af8710bd82f34395779c,1,kevalbhatt,2020-08-14 14:32:14+05:18,['83e9c21f7805b7badc9390a15fd747e1e6a7f8e2'],15,468,483,1776389,5,0.498550725,0.495652174,0.794202899,4006
41eebcf4cf435d37c5e67aea916513eac36e3ee5,1,kevalbhatt,2020-08-14 14:32:33+05:18,['1b41b980415961419bb4af8710bd82f34395779c'],259,536,795,1777184,15,0,0.364485981,0.588785047,4006
f077bbbf3b2df2e44df833017a307c565897a74e,1,Madhan Neethiraj,2020-08-14 06:41:59-07:00,['41eebcf4cf435d37c5e67aea916513eac36e3ee5'],1,178,179,1777363,6,0.569892473,0.76344086,0.956989247,4007
41e1039bd66829683e9b24f10186bde53a83d7ad,0,nixonrodrigues,2020-08-25 18:59:34+05:18,['f077bbbf3b2df2e44df833017a307c565897a74e'],1,1,2,1777365,1,,,,4007
892df24289d583028e74e78f7b86f6fde785e909,1,nixonrodrigues,2020-08-25 19:02:02+05:18,['41e1039bd66829683e9b24f10186bde53a83d7ad'],5,216,221,1777586,8,0.505494505,0.989010989,0.967032967,4009
813bab6439d5e6be135cb178ac846056c446fd9b,1,kevalbhatt,2020-08-26 11:58:48+05:18,['892df24289d583028e74e78f7b86f6fde785e909'],138,320,458,1778044,12,0.8125,1,1,4009
250c2eaf249fd115f71b11019bfc4b153810bde8,1,kevalbhatt,2020-08-26 15:29:55+05:18,['813bab6439d5e6be135cb178ac846056c446fd9b'],3,2,5,1778049,2,,,,4009
3468c2b4ac1175849ce119dcd69f5518b1d9a342,1,Sarath Subramanian,2020-09-01 23:51:07-07:00,['250c2eaf249fd115f71b11019bfc4b153810bde8'],2,24,26,1778075,2,0.444444444,0.277777778,1,4009
92c2ae30d27efcafbfea710f8e246cfb7487f35d,0,nixonrodrigues,2020-09-03 17:34:18+05:18,['3468c2b4ac1175849ce119dcd69f5518b1d9a342'],3,3,6,1778081,2,,,,4009
61b7a077bc541aad27ceadb8c55b4d568b376e3c,0,kevalbhatt,2020-09-03 18:29:24+05:18,['92c2ae30d27efcafbfea710f8e246cfb7487f35d'],2,2,4,1778085,2,,,,4009
3d69114fb8fbd604394d6d6c3124d906dce625ad,0,nikhilbonte,2020-09-03 19:56:54+05:18,['61b7a077bc541aad27ceadb8c55b4d568b376e3c'],0,10,10,1778095,1,,,,4009
c688af0957da5930cfeb97de1cc655a0e13ad936,0,Nikhil Bonte,2020-09-03 20:37:17+05:18,['3d69114fb8fbd604394d6d6c3124d906dce625ad'],1,1,2,1778097,1,,,,4009
01e9ccef466643a01f97900b97e69772dd8c4ea9,1,nixonrodrigues,2020-09-10 21:51:08+05:18,['c688af0957da5930cfeb97de1cc655a0e13ad936'],1,29,30,1778127,1,0.476190476,0,0.523809524,4009
d555c02ba283312e2d9b014b5d68a17da3661525,0,GitHub,2020-09-15 13:52:51+05:18,['01e9ccef466643a01f97900b97e69772dd8c4ea9'],0,7,7,1778134,1,,,,4009
1bfaf7add99e30130cabe20e9cedf2f90ca96e0d,1,nixonrodrigues,2020-09-16 13:08:00+05:18,['d555c02ba283312e2d9b014b5d68a17da3661525'],5,21,26,1778160,1,1,1,1,4009
e6c382680d1a3fa3284b5c9a9026264fc5bd3957,0,Nikhil Bonte,2020-09-17 12:24:46+05:18,['1bfaf7add99e30130cabe20e9cedf2f90ca96e0d'],2,2,4,1778164,2,,,,4009
ee80e6a675317f15a99429d509ffd49670d5df0d,1,Nikhil Bonte,2020-09-17 12:25:50+05:18,['e6c382680d1a3fa3284b5c9a9026264fc5bd3957'],85,209,294,1778458,30,0.115384615,0.096153846,1,4009
62c682b344c245015bca4e3d6bf7f55b5394a5e2,0,Ashutosh Mestry,2020-09-17 11:09:59-07:00,['ee80e6a675317f15a99429d509ffd49670d5df0d'],3,3,6,1778464,3,,,,4009
eccc37623e7c3d43e1aa494f88a5ad155fe9c123,0,Ashutosh Mestry,2020-09-17 13:09:46-07:00,['62c682b344c245015bca4e3d6bf7f55b5394a5e2'],0,6,6,1778470,1,1,1,1,4009
7690e51d10f008c1e13a4c85f9aa8821fee33f4a,1,Madhan Neethiraj,2020-09-17 19:37:02-07:00,['eccc37623e7c3d43e1aa494f88a5ad155fe9c123'],2,158,160,1778630,8,0.888888889,0.888888889,1,4010
9b1d4c387fb56d08bfc86150b0cff7d071540109,1,Madhan Neethiraj,2020-09-18 18:38:41-07:00,['7690e51d10f008c1e13a4c85f9aa8821fee33f4a'],21,343,364,1778994,12,,,,4021
4bc1c04adeba25254fce924e318c26fc9b72a8dd,1,nixonrodrigues,2020-09-20 19:50:24+05:18,['9b1d4c387fb56d08bfc86150b0cff7d071540109'],38,69,107,1779101,2,1,0.923076923,1,4021
74229d87043bc55a4dd83cad37db59031d624af5,0,nixonrodrigues,2020-09-20 19:51:02+05:18,['4bc1c04adeba25254fce924e318c26fc9b72a8dd'],0,2,2,1779103,1,1,1,1,4021
b8956dfd00b788ef90b79612a36669f5c6106855,1,kevalbhatt,2020-09-22 14:40:42+05:18,['74229d87043bc55a4dd83cad37db59031d624af5'],3696,18966,22662,1801765,62,0.749657064,0.839506173,0.852537723,4054
d0e246a7096d870b1bc6ee3dd46428bd3bf4b1e6,1,Madhan Neethiraj,2020-09-23 16:06:43-07:00,['b8956dfd00b788ef90b79612a36669f5c6106855'],11,23,34,1801799,4,,,,4054
23c33d14d0d8e11977c38377668030ae2bbe257b,0,kevalbhatt,2020-09-24 15:07:17+05:18,['d0e246a7096d870b1bc6ee3dd46428bd3bf4b1e6'],2,14,16,1801815,2,,,,4054
ec39c1e6207d2f875b3dc9d5a8a9818c3c9c46a5,0,nixonrodrigues,2020-09-24 16:54:15+05:18,['23c33d14d0d8e11977c38377668030ae2bbe257b'],23,37,60,1801875,3,0,0.529411765,0,4054
86e9149b031d62536fce6bb6fa815536d57144bc,0,nixonrodrigues,2020-09-29 14:10:32+05:18,['ec39c1e6207d2f875b3dc9d5a8a9818c3c9c46a5'],9,20,29,1801904,2,1,1,1,4054
7ae0bea9680d78605e1362dfbea288518f0e50ff,0,nixonrodrigues,2020-09-29 14:10:46+05:18,['86e9149b031d62536fce6bb6fa815536d57144bc'],0,5,5,1801909,1,0,0,1,4054
d4a50aadfc2e7076d8e5281f9be60fad4c5c232d,1,nixonrodrigues,2020-09-30 10:22:36+05:18,['7ae0bea9680d78605e1362dfbea288518f0e50ff'],14,88,102,1802011,6,0.240740741,0.259259259,1,4054
545afb53d0eb4154162f3887cea2bf4a4d26e752,1,kevalbhatt,2020-10-01 09:22:03+05:18,['d4a50aadfc2e7076d8e5281f9be60fad4c5c232d'],12,48,60,1802071,10,1,0,0,4054
9a605b6671b1719eebce04605f100e34c8f5afb0,0,Ashutosh Mestry,2020-09-30 23:00:26-07:00,['545afb53d0eb4154162f3887cea2bf4a4d26e752'],63,8,71,1802142,3,0,0,0.625,4054
ac573f33c72f5cf9b75b50453ad85dd3abadcb15,0,Madhan Neethiraj,2020-10-01 15:10:26-07:00,['9a605b6671b1719eebce04605f100e34c8f5afb0'],27,51,78,1802220,9,,,,4055
877e2b1729f3628d844c32769c30a3c948d567a6,0,Ashutosh Mestry,2020-10-02 09:06:52-07:00,['ac573f33c72f5cf9b75b50453ad85dd3abadcb15'],5,4,9,1802229,1,1,1,1,4055
45bb769f60ae2f23a4b260dd6e64d76149cd39d0,0,nixonrodrigues,2020-10-05 10:45:04+05:18,['877e2b1729f3628d844c32769c30a3c948d567a6'],18,20,38,1802267,1,1,1,1,4055
4f95ee8cc199d17ec954f81d8af9d0152af142f4,0,kevalbhatt,2020-10-06 21:20:08+05:18,['45bb769f60ae2f23a4b260dd6e64d76149cd39d0'],2,2,4,1802271,2,,,,4055
8bb3e853ea128e1eb2b181e8db869bf7d8050181,1,Madhan Neethiraj,2020-10-07 20:16:33-07:00,['4f95ee8cc199d17ec954f81d8af9d0152af142f4'],39,105,144,1802415,6,0.660377358,0.132075472,1,4055
54bab3f88ed580e54074fc0f26b01f6d103fde60,0,Ashutosh Mestry,2020-10-07 21:30:17-07:00,['8bb3e853ea128e1eb2b181e8db869bf7d8050181'],4,6,10,1802425,2,1,1,0,4055
8098bc5643cd45f53d2d9284785693a406d8a270,0,nixonrodrigues,2020-10-08 12:00:50+05:18,['54bab3f88ed580e54074fc0f26b01f6d103fde60'],1,2,3,1802428,1,,1,,4055
f5ffd06486f6ef3c28236c6c70e74561542d30c1,0,kevalbhatt,2020-10-08 15:07:23+05:18,['8098bc5643cd45f53d2d9284785693a406d8a270'],12,17,29,1802457,7,,,,4055
70c1087a121feb3fe88cc67681b470109443ff81,0,kevalbhatt,2020-10-08 15:07:41+05:18,['f5ffd06486f6ef3c28236c6c70e74561542d30c1'],3,3,6,1802463,2,,,,4055
4ab4962314a80d9e0ac766f81018e22995c8e83d,0,kevalbhatt,2020-10-09 15:56:04+05:18,['70c1087a121feb3fe88cc67681b470109443ff81'],62,8,70,1802533,4,0,0.9375,1,4055
f5db98b3ba5a6bdf851b1319abab5f953d6ff0f4,0,Ashutosh Mestry,2020-10-09 09:44:30-07:00,['4ab4962314a80d9e0ac766f81018e22995c8e83d'],3,20,23,1802556,3,1,1,1,4055
39ff496f129b64352e91b462c7882491a3929981,0,Ashutosh Mestry,2020-10-09 17:07:25-07:00,['f5db98b3ba5a6bdf851b1319abab5f953d6ff0f4'],2,7,9,1802565,2,1,1,1,4055
3c0b2746d0065b1d95b4511c46a8655d4167096e,0,kevalbhatt,2020-10-13 18:33:57+05:18,['39ff496f129b64352e91b462c7882491a3929981'],322,789,1111,1803676,26,0.161290323,0.913978495,1,4055
74c9394148d175950615f82455dc1e302000c01b,1,kevalbhatt,2020-10-13 18:34:04+05:18,['3c0b2746d0065b1d95b4511c46a8655d4167096e'],57,69,126,1803802,13,0,0,0,4055
5aab626e5a0436028389ba6b10734a323260cd66,1,Sarath Subramanian,2020-10-13 19:41:57-07:00,['74c9394148d175950615f82455dc1e302000c01b'],1,3585,3586,1807388,38,0.800171527,0.860205832,0.417667238,4091
080e4843480743558bc4b61d9c2860b414786ccc,0,Ashutosh Mestry,2020-10-13 21:05:24-07:00,['5aab626e5a0436028389ba6b10734a323260cd66'],1,4,5,1807393,1,1,1,0,4091
94d43c63c6021450845ff17c5bd952dbf5f8958a,0,kevalbhatt,2020-10-14 17:42:06+05:18,['080e4843480743558bc4b61d9c2860b414786ccc'],34,84,118,1807511,2,1,1,1,4091
39892854ffb696df70ecbc0f3e965c5a8261f621,0,kevalbhatt,2020-10-14 19:53:01+05:18,['94d43c63c6021450845ff17c5bd952dbf5f8958a'],44,79,123,1807634,12,0.444444444,0.444444444,1,4091
fd24e652b5e2f607cad0d665c88d770479832263,0,nixonrodrigues,2020-10-15 09:51:08+05:18,['39892854ffb696df70ecbc0f3e965c5a8261f621'],2,8,10,1807644,2,0,1,1,4091
d0de38970e1289cf726f8952dd3e2e93b0a158a3,0,nixonrodrigues,2020-10-15 19:24:17+05:18,['fd24e652b5e2f607cad0d665c88d770479832263'],1,1,2,1807646,1,,,,4091
b4e4f604b46805ade02413da6ef1a68b2f28da71,0,nixonrodrigues,2020-10-19 10:33:15+05:18,['d0de38970e1289cf726f8952dd3e2e93b0a158a3'],13,249,262,1807908,3,0.184971098,0.289017341,0.947976879,4091
bd9d1213b48721f269f32db1ee388e2beb9a7d3d,0,Madhan Neethiraj,2020-10-20 16:36:44-07:00,['b4e4f604b46805ade02413da6ef1a68b2f28da71'],13,3,16,1807924,13,,,,4091
3f1cf185200206827d309ab76f3ad729ad7a5e3b,0,kevalbhatt,2020-10-22 10:26:43+05:18,['bd9d1213b48721f269f32db1ee388e2beb9a7d3d'],8,8,16,1807940,4,,,,4091
de87bc5022627d82cb8e6048b6728e7028a4af25,1,Ashutosh Mestry,2020-10-22 13:45:47-07:00,['3f1cf185200206827d309ab76f3ad729ad7a5e3b'],45,3010,3055,1810995,35,0.70185923,0.848605578,0.885126162,4115
f959d84adf8108386f513b5bd1601a4ef73749ad,1,Nikhil Bonte,2020-10-23 17:45:59+05:18,['de87bc5022627d82cb8e6048b6728e7028a4af25'],2,1,3,1810998,1,1,1,0,4115
7dec8f538b6f3f52a4803b63efd3c5b0b41e966c,1,Nikhil Bonte,2020-10-23 17:46:26+05:18,['f959d84adf8108386f513b5bd1601a4ef73749ad'],5,151,156,1811154,7,0.125,1,1,4116
f3faad547380ac786427d84c95244de502781360,1,nixonrodrigues,2020-10-23 19:33:48+05:18,['7dec8f538b6f3f52a4803b63efd3c5b0b41e966c'],2,5,7,1811161,2,0,0,1,4116
8f9ef44660230030a69bfc7c488edf8f11cfe933,0,nixonrodrigues,2020-10-23 19:33:55+05:18,['f3faad547380ac786427d84c95244de502781360'],0,36,36,1811197,6,,,,4116
e45cd453a4abf9d0bf254ee127e62f0235039a69,0,nixonrodrigues,2020-10-23 19:34:44+05:18,['8f9ef44660230030a69bfc7c488edf8f11cfe933'],3,4,7,1811204,2,,,,4116
7925946adeeddeb878e2bdf3c0894b312a50f639,0,nixonrodrigues,2020-10-23 19:34:57+05:18,['e45cd453a4abf9d0bf254ee127e62f0235039a69'],2,2,4,1811208,1,,,,4116
82cdd700b2133e74ca8bce9aa55d93e76c8ec6fc,0,nixonrodrigues,2020-10-23 19:36:34+05:18,['7925946adeeddeb878e2bdf3c0894b312a50f639'],2,6,8,1811216,1,0,0,0,4116
90f5b4add36b8a006393d8fa92fa4ba93f49f309,0,Nikhil Bonte,2020-10-23 20:03:55+05:18,['82cdd700b2133e74ca8bce9aa55d93e76c8ec6fc'],2,13,15,1811231,1,0,1,0.333333333,4116
709598a3b6fd067327c922979a22071ff50fd1a6,0,Madhan Neethiraj,2020-10-23 08:09:11-07:00,['90f5b4add36b8a006393d8fa92fa4ba93f49f309'],187,354,541,1811772,38,0.784313725,0.31372549,1,4116
5b3da223ffa611a66e6fd3ade2cb2d5a2345c733,0,Madhan Neethiraj,2020-10-23 16:36:15-07:00,['709598a3b6fd067327c922979a22071ff50fd1a6'],19,13,32,1811804,5,,,,4116
24bb6b084d6c13d7ac94277ae6d730b8e7fcd67d,0,Madhan Neethiraj,2020-10-25 20:35:25-07:00,['5b3da223ffa611a66e6fd3ade2cb2d5a2345c733'],68,233,301,1812105,15,,,,4116
2f766f5c78d8c0b01e2c6c4a3cc5798ad7e06d3a,1,kevalbhatt,2020-10-26 11:20:21+05:18,['24bb6b084d6c13d7ac94277ae6d730b8e7fcd67d'],94,374,468,1812573,12,1,0.375,0.784090909,4116
91926971551767abd9d2d34fff202d9df3c72f9b,0,kevalbhatt,2020-10-26 11:36:37+05:18,['2f766f5c78d8c0b01e2c6c4a3cc5798ad7e06d3a'],8,8,16,1812589,6,,,,4116
8f5ba447ff2880804c2a1d820dc5f245c66075a6,0,kevalbhatt,2020-10-26 19:45:24+05:18,['91926971551767abd9d2d34fff202d9df3c72f9b'],7,9,16,1812605,2,1,0.868544601,0.877934272,4116
a22495b9b5942b7bf3c845f13e248c64908268d9,1,nixonrodrigues,2020-10-27 09:15:57+05:18,['8f5ba447ff2880804c2a1d820dc5f245c66075a6'],44,53,97,1812702,5,0,1,1,4116
c7f930068bc672f85a42eae232d3d232112b84b5,0,Madhan Neethiraj,2020-10-26 22:26:03-07:00,['a22495b9b5942b7bf3c845f13e248c64908268d9'],1,1,2,1812704,1,,,,4116
34709f229b62ce054ae819917dff9aad4cc976b8,0,Madhan Neethiraj,2020-10-27 10:20:24-07:00,['c7f930068bc672f85a42eae232d3d232112b84b5'],10,0,10,1812714,1,,,,4116
d4b15c7a2ab47d64a49070fab766a95497db4f0f,1,nixonrodrigues,2020-10-28 21:14:14+05:18,['34709f229b62ce054ae819917dff9aad4cc976b8'],626,587,1213,1813927,12,1,0.131147541,0,4118
7c68048fcc314d83100c7a5fc0a5b8294f62e2cd,0,Nikhil Bonte,2020-10-30 11:21:28+05:18,['d4b15c7a2ab47d64a49070fab766a95497db4f0f'],8,157,165,1814092,5,0.951923077,0.980769231,1,4118
53ae712a095930ebf008e70ece4a7a351030acf3,0,kevalbhatt,2020-11-02 13:41:11+05:18,['7c68048fcc314d83100c7a5fc0a5b8294f62e2cd'],4,32,36,1814128,2,0.75,0.75,1,4118
a0474d142c702e75f1820bffa542dc8cf39ba79d,1,nixonrodrigues,2020-11-03 17:18:30+05:18,['53ae712a095930ebf008e70ece4a7a351030acf3'],1,5,6,1814134,2,1,1,1,4118
e6fff74807c24a06aea1cb7666bd07da9d1100ed,1,Madhan Neethiraj,2020-11-05 08:31:00-08:00,['a0474d142c702e75f1820bffa542dc8cf39ba79d'],8,41,49,1814183,9,0,0,0.352941176,4119
801d40c3c62161a2bf8ae9fd0b1fea46d04eb7af,0,Nikhil Bonte,2020-11-10 13:34:00+05:18,['e6fff74807c24a06aea1cb7666bd07da9d1100ed'],2,223,225,1814408,7,0.787878788,0.787878788,1,4120
b7c219a52363c378832536b8f00e003a5b0bbe5a,0,nixonrodrigues,2020-11-11 11:02:07+05:18,['801d40c3c62161a2bf8ae9fd0b1fea46d04eb7af'],1,5,6,1814414,2,1,1,1,4120
dc9e268966fa27df400e827fd6e57a5098d7d478,0,Ashutosh Mestry,2020-11-10 22:20:09-08:00,['b7c219a52363c378832536b8f00e003a5b0bbe5a'],5,278,283,1814697,6,0.364864865,0.702702703,0.804054054,4121
06106fe92d597c012c01057724621b2d487ae46f,1,Sarath Subramanian,2020-11-12 14:11:21-08:00,['dc9e268966fa27df400e827fd6e57a5098d7d478'],194,149,343,1815040,4,,,,4121
a0a3c3183e2cc794eb35392d43008d0937616ffc,1,Ashutosh Mestry,2020-11-13 10:15:23-08:00,['06106fe92d597c012c01057724621b2d487ae46f'],7,9,16,1815056,2,0,1,1,4121
4ab95b9adafd3d845b626d2d82bd2b3aa23be691,0,Ashutosh Mestry,2020-11-13 10:26:25-08:00,['a0a3c3183e2cc794eb35392d43008d0937616ffc'],2,5,7,1815063,1,0,0,1,4121
dda50429d35e2bd8b56ee01aa91727285258d5c9,0,Sarath Subramanian,2020-11-16 13:24:39-08:00,['4ab95b9adafd3d845b626d2d82bd2b3aa23be691'],1,1,2,1815065,1,,,,4121
1b540056eaffd5406ed01f99119fa433322b4551,0,nixonrodrigues,2020-11-17 11:44:07+05:18,['dda50429d35e2bd8b56ee01aa91727285258d5c9'],0,4,4,1815069,1,,,,4121
fb996d55f81d8fb371405145bf56e693340d389b,1,kevalbhatt,2020-11-18 19:25:54+05:18,['1b540056eaffd5406ed01f99119fa433322b4551'],348,1190,1538,1816607,20,0.317073171,0.768292683,1,4123
9a30dc6863b4c44f75cd2b8855110c91c9a69d81,0,Sarath Subramanian,2020-11-18 13:54:31-08:00,['fb996d55f81d8fb371405145bf56e693340d389b'],1,1,2,1816609,1,,,,4123
dd4ba1b194e2157a0e4cd1c17fccf0b5ac010161,0,Sarath Subramanian,2020-11-18 14:09:43-08:00,['9a30dc6863b4c44f75cd2b8855110c91c9a69d81'],1,1,2,1816611,1,,,,4123
d12609bcd12e2cfe19a125da8e98e0d997adf3dc,0,Sarath Subramanian,2020-11-18 14:13:14-08:00,['dd4ba1b194e2157a0e4cd1c17fccf0b5ac010161'],4,6,10,1816621,3,,,,4123
cf232de6a1f71fdfbdc0b5d95309a1fe7ed4416c,0,kevalbhatt,2020-11-19 09:40:04+05:18,['d12609bcd12e2cfe19a125da8e98e0d997adf3dc'],4,4,8,1816629,2,,,,4123
0eb01b0edc618b8672fe0dc10f29a16ac31f385d,0,kevalbhatt,2020-11-19 15:25:28+05:18,['cf232de6a1f71fdfbdc0b5d95309a1fe7ed4416c'],2,2,4,1816633,2,,,,4123
099324e801accaf3b4be24028a9d6db2c4b36ed9,1,Madhan Neethiraj,2020-11-20 08:08:11-08:00,['0eb01b0edc618b8672fe0dc10f29a16ac31f385d'],45,45,90,1816723,8,,,,4123
f4b1c4294f37a53d2041fb925dc43dba5f166b67,0,Ashutosh Mestry,2020-11-20 10:17:29-08:00,['099324e801accaf3b4be24028a9d6db2c4b36ed9'],3,4,7,1816730,1,0,0,1,4123
05d8dec6fea6ba7566a900e3a2caca1470c975fc,0,Sarath Subramanian,2020-11-23 11:49:01-08:00,['f4b1c4294f37a53d2041fb925dc43dba5f166b67'],64,49,113,1816843,7,1,0,0,4123
389c25bcd05f05977750974db5cdc8dd44b581dc,1,kevalbhatt,2020-11-24 19:35:13+05:18,['05d8dec6fea6ba7566a900e3a2caca1470c975fc'],2,2,4,1816847,2,1,0,1,4123
5373cde5f4624e0989a41e9512e67f903d1fc26c,1,Ashutosh Mestry,2020-11-24 21:04:22-08:00,['389c25bcd05f05977750974db5cdc8dd44b581dc'],0,9,9,1816856,1,0,0,0,4123
97b5565d83be38e3c7e40c1cf949e0ffd89ede3c,0,Nikhil Bonte,2020-11-26 16:19:58+05:18,['5373cde5f4624e0989a41e9512e67f903d1fc26c'],0,18,18,1816874,1,0,0,1,4123
7779388fb000122fc1ddd29c9f6c36f57b41f5b1,0,nixonrodrigues,2020-11-30 20:02:13+05:18,['97b5565d83be38e3c7e40c1cf949e0ffd89ede3c'],3,14,17,1816891,1,0,0,1,4123
5037871ad95fd1d0a7596307b3f92e471cb84209,0,nixonrodrigues,2020-12-02 13:58:32+05:18,['7779388fb000122fc1ddd29c9f6c36f57b41f5b1'],2,5,7,1816898,1,0,1,1,4123
cbc3427133bfc1f119685b33f6d61f8d34f9f3ab,1,Sarath Subramanian,2020-12-02 11:34:11-08:00,['5037871ad95fd1d0a7596307b3f92e471cb84209'],1,6,7,1816905,1,1,1,1,4123
420983d5841fb6de545e101329cf7e12de68f4a0,0,Sarath Subramanian,2020-12-02 12:14:28-08:00,['cbc3427133bfc1f119685b33f6d61f8d34f9f3ab'],11,60,71,1816976,8,0.947368421,1,0.578947368,4124
294ca40d956615157dc49d1a30af4a5e68006429,0,Nikhil Bonte,2020-12-04 09:55:57+05:18,['420983d5841fb6de545e101329cf7e12de68f4a0'],4,390,394,1817370,16,0.995855209,0.894998618,0.828405637,4131
8801ba6814abbd2c60c88d04cf1649efed2f3429,0,Ashutosh Mestry,2020-12-09 14:17:37-08:00,['294ca40d956615157dc49d1a30af4a5e68006429'],1,1,2,1817372,1,,,,4131
10b6d142e479e0b2a27be6a7dd8b9f82a4d3f723,0,Ashutosh Mestry,2020-12-09 14:17:57-08:00,['8801ba6814abbd2c60c88d04cf1649efed2f3429'],2,5,7,1817379,2,1,1,1,4131
ff55b0a155bc1c6a0f150477998084de90da6cec,1,nixonrodrigues,2020-12-10 16:38:49+05:18,['10b6d142e479e0b2a27be6a7dd8b9f82a4d3f723'],38,138,176,1817555,8,1,1,0,4131
9cdc31d5851db61296c7ff07ecb9bc85c26939fa,1,Ashutosh Mestry,2020-12-10 10:52:24-08:00,['ff55b0a155bc1c6a0f150477998084de90da6cec'],27,52,79,1817634,1,0.64,0.64,1,4131
31125c58c8a6d2edf0bd7de4e31c44e18adc9a7f,0,Ashutosh Mestry,2020-12-10 10:52:24-08:00,['9cdc31d5851db61296c7ff07ecb9bc85c26939fa'],4,79,83,1817717,2,0,0.58490566,0.962264151,4131
404652e851ccc1c264d89b4e983bed929be5bf91,0,Sarath Subramanian,2020-12-10 11:40:06-08:00,['31125c58c8a6d2edf0bd7de4e31c44e18adc9a7f'],1,1,2,1817719,1,,,,4131
cc333af6e8b567d5c7bb4073e9a72020e6a67bcf,0,Sarath Subramanian,2020-12-10 11:42:06-08:00,['404652e851ccc1c264d89b4e983bed929be5bf91'],22,0,22,1817741,2,,,,4131
77943a9489bd49e53b1e8572fa9ea32ae02e5b04,1,Madhan Neethiraj,2020-12-11 16:20:57-08:00,['cc333af6e8b567d5c7bb4073e9a72020e6a67bcf'],1520,1775,3295,1821036,34,1,1,1,4136
4fb6c7b4b1df3bdcd5c40cf65241bf2e42a07d22,0,Madhan Neethiraj,2020-12-15 09:27:20-08:00,['77943a9489bd49e53b1e8572fa9ea32ae02e5b04'],11,40,51,1821087,3,1,1,1,4136
af55c7f8799a95a1f26a38d51309bd9c5246bc77,1,Madhan Neethiraj,2020-12-15 09:35:38-08:00,['4fb6c7b4b1df3bdcd5c40cf65241bf2e42a07d22'],8,47,55,1821142,5,1,1,0.9,4137
6ed73d88374aacbf3bd2ed5ddf30717944db347e,0,Sarath Subramanian,2020-12-15 13:26:25-08:00,['af55c7f8799a95a1f26a38d51309bd9c5246bc77'],7,3,10,1821152,1,1,1,0,4137
321c6b8383812ea7b3a27c02544d513e89bcdc59,0,Sarath Subramanian,2020-12-15 13:28:51-08:00,['6ed73d88374aacbf3bd2ed5ddf30717944db347e'],0,254,254,1821406,1,,,,4138
1907f6408c4c499a0cc7b4bf016571a4b752a7f8,1,nixonrodrigues,2020-12-16 10:58:52+05:18,['321c6b8383812ea7b3a27c02544d513e89bcdc59'],35,2,37,1821443,1,0.888888889,0,0,4138
ab92cf1e6db021e83d8b42ac559f077ab17afa65,0,nixonrodrigues,2020-12-16 10:59:39+05:18,['1907f6408c4c499a0cc7b4bf016571a4b752a7f8'],128,99,227,1821670,5,0,0.958333333,1,4138
b5ce624f8f12fd0be0f4928cecd7aeb469f9a460,0,nixonrodrigues,2020-12-16 11:29:22+05:18,['ab92cf1e6db021e83d8b42ac559f077ab17afa65'],3,11,14,1821684,2,,,,4138
b1cc951d9c2dfeb971e342006fcf6680b982a8fb,0,nixonrodrigues,2020-12-16 12:48:29+05:18,['b5ce624f8f12fd0be0f4928cecd7aeb469f9a460'],28,67,95,1821779,6,0.894736842,0.947368421,0.894736842,4138
de87800c19ea06f53904a2948fcde29a57d2f051,0,nixonrodrigues,2020-12-16 13:57:59+05:18,['b1cc951d9c2dfeb971e342006fcf6680b982a8fb'],2,24,26,1821805,4,1,0.1,1,4138
2e40de917083c7c5583a61537b6447ab3af41918,0,Ashutosh Mestry,2020-12-16 09:57:33-08:00,['de87800c19ea06f53904a2948fcde29a57d2f051'],0,10,10,1821815,2,1,1,1,4138
c1c28c12add6bf4b19a8218037b52409970d9857,0,Ashutosh Mestry,2020-12-16 09:58:26-08:00,['2e40de917083c7c5583a61537b6447ab3af41918'],8,54,62,1821877,7,0.512820513,0.615384615,0.820512821,4138
433ae4470f3a2853ff2319c11571ef15d2319875,0,Sarath Subramanian,2020-12-16 11:49:03-08:00,['c1c28c12add6bf4b19a8218037b52409970d9857'],0,23,23,1821900,1,,,,4139
a4b72a00786a25e13a7453ccb199cc74cefd4aed,0,nixonrodrigues,2020-12-23 15:12:20+05:18,['433ae4470f3a2853ff2319c11571ef15d2319875'],10,12,22,1821922,2,1,0,1,4139
a88e912dcd910aa9d0602ffe17cb0e4807d32363,1,nixonrodrigues,2020-12-23 16:47:42+05:18,['a4b72a00786a25e13a7453ccb199cc74cefd4aed'],1,53,54,1821976,3,,,,4139
a11d59f7a7f0fad96f153c161525a05881c5bf66,1,Madhan Neethiraj,2020-12-28 18:11:18-08:00,['a88e912dcd910aa9d0602ffe17cb0e4807d32363'],665,780,1445,1823421,27,1,1,0.27027027,4142
b3793fbb05ebea4135f1cc0c5e5899f0fb3210bf,0,Madhan Neethiraj,2020-12-28 18:50:38-08:00,['a11d59f7a7f0fad96f153c161525a05881c5bf66'],0,36,36,1823457,2,,,,4142
0f8b3353f9f972412bbc8b5ab3e53899d6a40f72,1,Madhan Neethiraj,2020-12-30 18:16:52-08:00,['b3793fbb05ebea4135f1cc0c5e5899f0fb3210bf'],13,7,20,1823477,1,,,,4142
c60ba61f3f7af368c456c4446ecdf117c9355f64,0,Pinal,2021-01-04 10:33:42+05:18,['0f8b3353f9f972412bbc8b5ab3e53899d6a40f72'],0,10,10,1823487,1,,,,4142
eb36a7fdecbf433f4b689392d8d61daa5f4b8ec3,0,Pinal,2021-01-04 10:52:54+05:18,['c60ba61f3f7af368c456c4446ecdf117c9355f64'],1,1,2,1823489,1,,,,4142
f9b786db65a4aa8002ade2c4ec45c2c31dbe3b71,0,nixonrodrigues,2021-01-05 10:17:06+05:18,['eb36a7fdecbf433f4b689392d8d61daa5f4b8ec3'],7,0,7,1823496,1,0,0,1,4142
c11361a1902cf74f70313c72f9c54cbc121be2da,0,Sarath Subramanian,2021-01-05 14:28:55-08:00,['f9b786db65a4aa8002ade2c4ec45c2c31dbe3b71'],7,179,186,1823682,1,,,,4142
f0bb4e94ca620919db8acd887fab5485d495b6f4,1,Madhan Neethiraj,2021-01-07 11:36:52-08:00,['c11361a1902cf74f70313c72f9c54cbc121be2da'],18,35,53,1823735,8,,,,4142
907eccdfb32d6394dd63917dcff03dacf80741fa,0,Madhan Neethiraj,2021-01-07 23:46:55-08:00,['f0bb4e94ca620919db8acd887fab5485d495b6f4'],46,50,96,1823831,12,,,,4142
54c1a9f7038b55e5ccc2eca1aa3ddbe73bdf74fd,0,Sarath Subramanian,2021-01-08 15:54:45-08:00,['907eccdfb32d6394dd63917dcff03dacf80741fa'],1,1,2,1823833,1,,,,4142
ec1a7cdc7dd813b9e2dc238192010d9e66f09ab7,0,Sarath Subramanian,2021-01-11 13:45:32-08:00,['54c1a9f7038b55e5ccc2eca1aa3ddbe73bdf74fd'],9,26,35,1823868,1,0,0,1,4142
dfaad7d8350f2603e0d07c7cbcf36f55996ab8f6,0,Sarath Subramanian,2021-01-11 21:57:32-08:00,['ec1a7cdc7dd813b9e2dc238192010d9e66f09ab7'],2,5,7,1823875,1,,,,4142
85c95078d5c02e17a0356bb7f1589c91b435508e,1,Pinal,2021-01-12 11:33:05+05:18,['dfaad7d8350f2603e0d07c7cbcf36f55996ab8f6'],11,48,59,1823934,2,0.1875,0.1875,1,4142
8045c7841216974cafa8b04aa14fbd5aa893ba55,0,Nikhil Bonte,2021-01-13 12:00:57+05:18,['85c95078d5c02e17a0356bb7f1589c91b435508e'],6,6,12,1823946,2,0.571428571,0,0,4142
2742ba4b776377d7ebdc166214531788e8294776,1,Pinal,2021-01-14 12:00:44+05:18,['8045c7841216974cafa8b04aa14fbd5aa893ba55'],602,1717,2319,1826265,16,0.677932406,0.862823062,1,4144
d27790dfdde09a58db15064bbdaf77d224f61ecc,0,Sarath Subramanian,2021-01-13 22:50:09-08:00,['2742ba4b776377d7ebdc166214531788e8294776'],6,6,12,1826277,2,,,,4144
f47334a7475cd80960c070b4b2204ea2ab3e42ca,1,nixonrodrigues,2021-01-14 15:47:28+05:18,['d27790dfdde09a58db15064bbdaf77d224f61ecc'],0,16,16,1826293,2,0,0,1,4144
6edd4bc110a3fdde42659f797c588fa75432cc79,0,nixonrodrigues,2021-01-14 15:49:43+05:18,['f47334a7475cd80960c070b4b2204ea2ab3e42ca'],1,23,24,1826317,1,1,1,0,4144
517bf28489ebbf44dc39acbac972b30bb02043ba,0,Madhan Neethiraj,2021-01-15 19:59:25-08:00,['6edd4bc110a3fdde42659f797c588fa75432cc79'],10,10,20,1826337,3,,,,4144
e06db7deaa4a013e7ee64ed52572f63b3f990037,1,Madhan Neethiraj,2021-01-18 13:20:32-08:00,['517bf28489ebbf44dc39acbac972b30bb02043ba'],46,46,92,1826429,10,1,1,0,4144
e6ee5b43ee48f8d78ff84e222f50f36df4745c81,0,Sarath Subramanian,2021-01-19 10:01:57-08:00,['e06db7deaa4a013e7ee64ed52572f63b3f990037'],3,255,258,1826687,8,0.228395062,0.487654321,0.265432099,4144
b5014c606e5ad63b4bd2334375217e2fa09c90bd,1,Ashutosh Mestry,2021-01-20 14:41:26-08:00,['e6ee5b43ee48f8d78ff84e222f50f36df4745c81'],659,1929,2588,1829275,21,0.420977011,0.58908046,0.441091954,4151
810d70531467ccd49c09b79885e06dd00ba1b17d,0,Madhan Neethiraj,2021-01-20 19:38:47-08:00,['b5014c606e5ad63b4bd2334375217e2fa09c90bd'],280,427,707,1829982,13,0,0.888888889,0.111111111,4151
8d7ac77a74479263ce59b9e22bb3def91b8b9326,1,Madhan Neethiraj,2021-01-21 23:43:25-08:00,['810d70531467ccd49c09b79885e06dd00ba1b17d'],111,540,651,1830633,8,0.163179916,0.748953975,0.769874477,4153
c48e4c393b747b25f1c399a2c37175e5004d1526,1,Madhan Neethiraj,2021-01-23 17:09:36-08:00,['8d7ac77a74479263ce59b9e22bb3def91b8b9326'],0,11,11,1830644,3,0.571428571,0.571428571,1,4153
ea4e32d0657cbe5f161aa992578b0983636810ae,0,Madhan Neethiraj,2021-01-23 18:23:39-08:00,['c48e4c393b747b25f1c399a2c37175e5004d1526'],5,19,24,1830668,2,1,1,1,4153
c2ab99037637b7a918678c2fc46697fda95bfac2,1,Sarath Subramanian,2021-01-25 17:08:59-08:00,['ea4e32d0657cbe5f161aa992578b0983636810ae'],5,20,25,1830693,5,0.133333333,0.333333333,0.666666667,4153
ce1342dd6dd7cbc4d1e35bea3b26d08dc24bd67e,0,Sarath Subramanian,2021-01-28 10:36:31-08:00,['c2ab99037637b7a918678c2fc46697fda95bfac2'],88,174,262,1830955,3,1,0.851851852,1,4154
bb745b9e90c517517f88cd66ccca845bf73dfeca,0,Sarath Subramanian,2021-01-28 11:24:21-08:00,['ce1342dd6dd7cbc4d1e35bea3b26d08dc24bd67e'],7,26,33,1830988,3,1,1,0,4154
39a067a215dc247ff787567e8f25ae52b83e010d,0,Sarath Subramanian,2021-01-28 15:23:36-08:00,['bb745b9e90c517517f88cd66ccca845bf73dfeca'],1,1,2,1830990,1,,,,4154
f0bab76e8ec18ccbdf98c1d2fa8cc765ffb346e7,0,Sarath Subramanian,2021-02-02 12:43:39-08:00,['39a067a215dc247ff787567e8f25ae52b83e010d'],1,1,2,1830992,1,,,,4154
efcc31e8dcd5038eaa964386c3e123fb90f1b28b,0,Ashutosh Mestry,2021-02-02 20:59:07-08:00,['f0bab76e8ec18ccbdf98c1d2fa8cc765ffb346e7'],5,17,22,1831014,3,0.8,1,1,4154
0b02bd9f21eab4354b7d8479e05a38db75e5e1a0,0,Sarath Subramanian,2021-02-03 09:26:59-08:00,['efcc31e8dcd5038eaa964386c3e123fb90f1b28b'],0,2,2,1831016,1,0,0,1,4154
e873515f5c9bd4cbc6eda9609034779bcddaf3a4,1,Sarath Subramanian,2021-02-03 14:17:10-08:00,['0b02bd9f21eab4354b7d8479e05a38db75e5e1a0'],27,439,466,1831482,3,0.212121212,0.855218855,0.64983165,4154
7a3f512655bc450fc58a466301c6b3c511076c8c,1,kevalbhatt,2021-02-04 12:14:41+05:18,['e873515f5c9bd4cbc6eda9609034779bcddaf3a4'],69,38,107,1831589,14,0.738095238,0,0.285714286,4154
15cd0378ef54720349f28ef3f2624f93b4f5b30e,0,Ashutosh Mestry,2021-02-04 09:58:57-08:00,['7a3f512655bc450fc58a466301c6b3c511076c8c'],10,15,25,1831614,1,0.6,0.6,1,4154
960f9481e6914e6591687c13e084a90fec1c2d02,0,Ashutosh Mestry,2021-02-04 10:35:06-08:00,['15cd0378ef54720349f28ef3f2624f93b4f5b30e'],0,2,2,1831616,1,0,0,1,4154
c2b24adc71d21f2874e10266b7272f82999bc793,1,Madhan Neethiraj,2021-02-07 18:32:48-08:00,['960f9481e6914e6591687c13e084a90fec1c2d02'],24,437,461,1832077,15,0.580246914,0.765432099,0.87037037,4157
58c5c61d6ff4dafe9e5d0a366e9cb599e5d84a4c,1,Nikhil Bonte,2021-02-08 12:07:48+05:18,['c2b24adc71d21f2874e10266b7272f82999bc793'],267,196,463,1832540,8,0.925,0.55,0,4157
2152ae16a1464963de0ceda03a84263bfbbbca5e,1,nixonrodrigues,2021-02-09 16:24:08+05:18,['58c5c61d6ff4dafe9e5d0a366e9cb599e5d84a4c'],34,172,206,1832746,14,0.612244898,1,1,4157
2105d5a2d15502e00eda8b1c657952f5ee96cb94,0,Ashutosh Mestry,2021-02-09 09:08:54-08:00,['2152ae16a1464963de0ceda03a84263bfbbbca5e'],1,3,4,1832750,1,1,1,1,4157
e616779727e64d632b1414ecea08de3239ac3bac,0,Nikhil Bonte,2021-02-10 10:59:28+05:18,['2105d5a2d15502e00eda8b1c657952f5ee96cb94'],34,46,80,1832830,6,1,0,1,4157
a531e8c685a0758e13d2862a98284110bc8faf22,0,Sarath Subramanian,2021-02-09 21:46:46-08:00,['e616779727e64d632b1414ecea08de3239ac3bac'],18,21,39,1832869,1,1,1,1,4157
f848c9761bd340c9cbb790254420506d97c8e6b4,0,Sarath Subramanian,2021-02-09 21:49:31-08:00,['a531e8c685a0758e13d2862a98284110bc8faf22'],1,8,9,1832878,1,0,0,0,4157
ed2926ece4d1ba7a3fa773f527853253bd3352ba,0,Ashutosh Mestry,2021-02-09 22:33:54-08:00,['f848c9761bd340c9cbb790254420506d97c8e6b4'],18,13,31,1832909,3,1,0.2,0.2,4157
d99ea4b3fb6dad2c076f073d5b64b2ac5748f70a,0,Pinal,2021-02-17 15:14:31+05:18,['ed2926ece4d1ba7a3fa773f527853253bd3352ba'],7,22,29,1832938,4,1,1,1,4157
e17ef54d0f701bd5b8521d0ecd2908db32f984f3,0,Ashutosh Mestry,2021-02-17 21:17:30-08:00,['d99ea4b3fb6dad2c076f073d5b64b2ac5748f70a'],72,71,143,1833081,5,0,0,0,4157
928d86864b6e4c9244cd77c18c1d3d54d6a6a836,0,Sarath Subramanian,2021-02-18 21:34:24-08:00,['e17ef54d0f701bd5b8521d0ecd2908db32f984f3'],2,4,6,1833087,1,0,0,0,4157
47c18b9419f825fd6a15bbf9f22196b4ef49aefe,0,Sarath Subramanian,2021-02-18 21:57:49-08:00,['928d86864b6e4c9244cd77c18c1d3d54d6a6a836'],4,13,17,1833104,2,1,1,1,4157
ea66c181ba0d592ce2aff998ed84e4afd30a3d41,0,nixonrodrigues,2021-02-23 12:37:51+05:18,['47c18b9419f825fd6a15bbf9f22196b4ef49aefe'],123,407,530,1833634,6,0.528455285,1,0.991869919,4157
5d0eba4e7a92afd11fd47f47d7352a976af430e0,1,nixonrodrigues,2021-02-23 12:44:46+05:18,['ea66c181ba0d592ce2aff998ed84e4afd30a3d41'],2,5,7,1833641,2,0.666666667,1,1,4157
c5c73250b48217c0cdcc706ac654f352938bea41,1,nixonrodrigues,2021-02-23 12:45:47+05:18,['5d0eba4e7a92afd11fd47f47d7352a976af430e0'],0,29,29,1833670,1,0,0.833333333,1,4157
5aab9b0c6d1379d3751e0d13f06819f143617fe4,0,nixonrodrigues,2021-02-23 12:47:26+05:18,['c5c73250b48217c0cdcc706ac654f352938bea41'],2,20,22,1833692,2,1,1,1,4157
f84993293127c2036667c8fbec30469d85e52991,1,nixonrodrigues,2021-02-23 12:53:32+05:18,['5aab9b0c6d1379d3751e0d13f06819f143617fe4'],2,8,10,1833702,2,1,1,1,4157
c551f66556e01d69f2918831b8b93b0397b04d75,1,nixonrodrigues,2021-02-23 14:13:24+05:18,['f84993293127c2036667c8fbec30469d85e52991'],161,258,419,1834121,6,0.790322581,1,1,4157
33f7fcbb681bfb82c12272c95aafd715ec716d9e,0,Pinal,2021-03-02 11:07:40+05:18,['c551f66556e01d69f2918831b8b93b0397b04d75'],1,1,2,1834123,1,,,,4157
d653cea3c26b025ad7d6c37a2df41fff745fd952,0,Madhan Neethiraj,2021-03-05 10:56:55-08:00,['33f7fcbb681bfb82c12272c95aafd715ec716d9e'],4,279,283,1834406,6,0.310810811,0.432432432,0.722972973,4158
12e35d2f15578619b6375c37dc2087cc3e1e6cce,0,nixonrodrigues,2021-03-08 14:10:07+05:18,['d653cea3c26b025ad7d6c37a2df41fff745fd952'],7,8,15,1834421,4,0,0,,4158
8f820e68e6e52b2e8e24befd6601ab27a79ff92c,0,GitHub,2021-03-09 10:16:29+05:18,['12e35d2f15578619b6375c37dc2087cc3e1e6cce'],2,2,4,1834425,2,,,,4158
4880939d4fd1f48508b981de46d55db8e5bc02be,1,Nikhil Bonte,2021-03-10 13:12:41+05:18,['8f820e68e6e52b2e8e24befd6601ab27a79ff92c'],20,95,115,1834540,13,1,0.862068966,1,4158
e71eee708538b054e4e42764992f5aef87eeb0d2,0,Nikhil Bonte,2021-03-10 13:14:19+05:18,['4880939d4fd1f48508b981de46d55db8e5bc02be'],22,39,61,1834601,2,0,0,0,4158
122be98b6f2348951e860aead8d7e0bf1b88de79,0,Nikhil Bonte,2021-03-10 13:14:31+05:18,['e71eee708538b054e4e42764992f5aef87eeb0d2'],22,120,142,1834743,12,1,1,1,4158
e5e4be43cdde92fa15ff8afcdf1909c49572ae51,0,Nikhil Bonte,2021-03-10 13:15:01+05:18,['122be98b6f2348951e860aead8d7e0bf1b88de79'],8,10,18,1834761,6,1,0,1,4158
62a295ad19a62ce45e005e55fed25c4e40fb4862,1,Nikhil Bonte,2021-03-10 14:30:00+05:18,['e5e4be43cdde92fa15ff8afcdf1909c49572ae51'],2,2,4,1834765,2,,,,4158
2c62f14e1b032f7e60551d405893012db8746601,1,Madhan Neethiraj,2021-03-12 07:40:27-08:00,['62a295ad19a62ce45e005e55fed25c4e40fb4862'],4,3,7,1834772,2,1,1,1,4158
7eab2cb8d53ca4c86366e896119a1d7906ccb5b3,0,Madhan Neethiraj,2021-03-12 07:51:33-08:00,['2c62f14e1b032f7e60551d405893012db8746601'],5,5,10,1834782,1,,,,4158
5266d890db65d53c57312254a414b5f52b6f6225,0,Madhan Neethiraj,2021-03-13 12:18:52-08:00,['7eab2cb8d53ca4c86366e896119a1d7906ccb5b3'],2,2,4,1834786,2,,,,4158
80b305f827092f5e006d556aba3e02acee052c2d,1,Madhan Neethiraj,2021-03-13 13:36:18-08:00,['5266d890db65d53c57312254a414b5f52b6f6225'],54,2070,2124,1836910,36,,,,4184
9fbfd2a1e4bf88cfdfeb5ff19da89d0a9517c8df,1,Madhan Neethiraj,2021-03-13 23:50:26-08:00,['80b305f827092f5e006d556aba3e02acee052c2d'],3,3,6,1836916,2,,,,4184
c8b3f778c15c1780b809445389ad562104bb1404,1,Madhan Neethiraj,2021-03-15 09:44:18-07:00,['9fbfd2a1e4bf88cfdfeb5ff19da89d0a9517c8df'],4,15,19,1836935,3,0,1,1,4184
c45ab520f7d94b27cd59b387cf14e9651b8e6766,0,Madhan Neethiraj,2021-03-15 12:13:12-07:00,['c8b3f778c15c1780b809445389ad562104bb1404'],65,185,250,1837185,13,0.929824561,1,1,4184
80f0aa687faf4aea23937e5584e6469f28bd602d,1,nixonrodrigues,2021-03-17 18:22:20+05:18,['c45ab520f7d94b27cd59b387cf14e9651b8e6766'],461,698,1159,1838344,10,0.400843882,0.873417722,0.907172996,4184
56d0093e417e8ed51ee3a1b68cc226f59191b096,0,nixonrodrigues,2021-03-17 18:30:33+05:18,['80f0aa687faf4aea23937e5584e6469f28bd602d'],2,2,4,1838348,2,,,,4184
83aa1f45b9aebea50c9e6c0847d16a821978ddd5,0,Sarath Subramanian,2021-03-18 12:06:01-07:00,['56d0093e417e8ed51ee3a1b68cc226f59191b096'],2,3,5,1838353,1,0,0,0,4184
5362594e981e2bcc322dba945eaa446601958882,1,nixonrodrigues,2021-03-19 10:57:22+05:18,['83aa1f45b9aebea50c9e6c0847d16a821978ddd5'],471,383,854,1839207,3,1,0.137254902,0.147058824,4184
acb9880fa0f24089f7e566cc69436a074814df6a,0,Madhan Neethiraj,2021-03-19 12:02:55-07:00,['5362594e981e2bcc322dba945eaa446601958882'],33,84,117,1839324,1,0,0,1,4184
bc2c21898805da9e3c749a108b319c18f777ff2b,0,Sarath Subramanian,2021-03-22 10:15:32-07:00,['acb9880fa0f24089f7e566cc69436a074814df6a'],1,1,2,1839326,1,,,,4184
49576ba7dffa3403a2917d7a8fc0d477cd31bc1f,1,Sarath Subramanian,2021-03-22 10:23:19-07:00,['bc2c21898805da9e3c749a108b319c18f777ff2b'],2,2,4,1839330,1,,,,4184
f4f095367344a8e3028b9cfe2ca60f0e8922ca6f,0,nixonrodrigues,2021-03-23 11:59:30+05:18,['49576ba7dffa3403a2917d7a8fc0d477cd31bc1f'],42,0,42,1839372,2,0,0,0,4184
619a0a9dbbff626508f3185dfa3ec4357a078d30,0,nixonrodrigues,2021-03-23 12:00:43+05:18,['f4f095367344a8e3028b9cfe2ca60f0e8922ca6f'],4,4,8,1839380,2,,,,4184
1c2eedffcf51259b7855e5d1c032dc02322376e1,1,nixonrodrigues,2021-03-23 12:01:42+05:18,['619a0a9dbbff626508f3185dfa3ec4357a078d30'],6,22,28,1839408,2,1,1,1,4184
e6efbddf848282c4b2fcd5a4dba864992ef97c55,0,nixonrodrigues,2021-03-23 12:04:37+05:18,['1c2eedffcf51259b7855e5d1c032dc02322376e1'],12,47,59,1839467,4,0.894736842,1,0.578947368,4184
a27a15f902face47839aef7f5a65ecb1ad4cbc4f,0,Madhan Neethiraj,2021-03-24 08:00:01-07:00,['e6efbddf848282c4b2fcd5a4dba864992ef97c55'],13,382,395,1839862,19,,,,4193
3a59132a5fb05516d590f3061fd10c8af32a86f9,0,Sarath Subramanian,2021-03-29 15:12:56-07:00,['a27a15f902face47839aef7f5a65ecb1ad4cbc4f'],2,25,27,1839889,2,,,,4194
b5ef017400d390bd891296721387d66229d6f1e1,0,nixonrodrigues,2021-03-30 11:08:25+05:18,['3a59132a5fb05516d590f3061fd10c8af32a86f9'],2,12,14,1839903,2,1,1,1,4194
4be86b58732ede51c6e0228a4ee102f7283d9652,0,nixonrodrigues,2021-03-31 18:49:43+05:18,['b5ef017400d390bd891296721387d66229d6f1e1'],2,2,4,1839907,2,,,,4194
2aa448c110a175f74aa8c8e3bb338fefc71ae8b1,0,Sarath Subramanian,2021-03-31 12:09:50-07:00,['4be86b58732ede51c6e0228a4ee102f7283d9652'],0,232,232,1840139,1,,,,4195
c03ee72ca557eab49f2e315fc17aefcce03176ef,1,Sarath Subramanian,2021-03-31 12:13:02-07:00,['2aa448c110a175f74aa8c8e3bb338fefc71ae8b1'],4,155,159,1840298,2,0.295238095,0.447619048,0.19047619,4195
842890d27bf739a0949e82b58d9db1f1dd6111ea,1,Sarath Subramanian,2021-03-31 12:17:51-07:00,['c03ee72ca557eab49f2e315fc17aefcce03176ef'],84,125,209,1840507,8,0,0.75,1,4195
ff662427e54f675200646f52eb13db6084ef4ef3,1,Sarath Subramanian,2021-04-07 09:57:50-07:00,['842890d27bf739a0949e82b58d9db1f1dd6111ea'],132,205,337,1840844,9,1,0.477272727,0,4197
404f8a1a2d1c6d965b66d4d25f7c84543dde8626,0,Sarath Subramanian,2021-04-07 11:41:10-07:00,['ff662427e54f675200646f52eb13db6084ef4ef3'],0,0,0,1840844,4,,,,4201
3ca9650ca51b7c63c2f4f4d2cf7ff889820548f4,1,nixonrodrigues,2021-04-12 12:14:34+05:18,['404f8a1a2d1c6d965b66d4d25f7c84543dde8626'],2,2,4,1840848,1,,,,4201
2588540ebef16c6fa4890bb15c7841042b13ab3c,1,Ashutosh Mestry,2021-04-12 09:30:04-07:00,['3ca9650ca51b7c63c2f4f4d2cf7ff889820548f4'],2,2162,2164,1843012,25,0.781931464,0.856697819,1,4220
bbdae910545aeeb6bca31b51f5dcbacd1b2fa639,0,Ashutosh Mestry,2021-04-13 09:25:19-07:00,['2588540ebef16c6fa4890bb15c7841042b13ab3c'],1,1,2,1843014,1,,,,4220
2cfdcb2d980c31b0d4e4a381e0380c62268f2fa8,0,Pinal,2021-04-14 11:06:58+05:18,['bbdae910545aeeb6bca31b51f5dcbacd1b2fa639'],5,353,358,1843372,6,0.156097561,1,0.970731707,4221
af2cc7496ef4c856545a730b2e0859066b8dd4b5,0,nixonrodrigues,2021-04-14 15:20:30+05:18,['2cfdcb2d980c31b0d4e4a381e0380c62268f2fa8'],42,95,137,1843509,4,0.541666667,0.229166667,1,4221
7b0ecd1dcb92dad5b9a0659f7b5f2a7fa1d95f93,1,nixonrodrigues,2021-04-14 15:51:00+05:18,['af2cc7496ef4c856545a730b2e0859066b8dd4b5'],95,42,137,1843646,4,0.458333333,0.770833333,0,4221
e6f2a8afe3877db2f63e50137926ffe73ae6a991,0,nixonrodrigues,2021-04-14 15:51:09+05:18,['7b0ecd1dcb92dad5b9a0659f7b5f2a7fa1d95f93'],47,115,162,1843808,4,0.301587302,0.063492063,1,4221
0751f16250220271ce63ab7523de37e1f85defda,1,Sarath Subramanian,2021-04-14 16:49:28-07:00,['e6f2a8afe3877db2f63e50137926ffe73ae6a991'],329,2684,3013,1846821,46,0.610079576,0.862953139,0.83377542,4235
92fdf298b5cfeb8e3d4b265085f9783af9d79cf6,0,Pinal,2021-04-20 20:22:17+05:18,['0751f16250220271ce63ab7523de37e1f85defda'],16,44,60,1846881,15,1,1,1,4235
4d027b4bf1a0c6b4329422a75518f010c579133a,1,nixonrodrigues,2021-04-21 12:42:41+05:18,['92fdf298b5cfeb8e3d4b265085f9783af9d79cf6'],23,110,133,1847014,5,1,1,0.153846154,4235
2e0caefdd3b37df8ff9322dc4c14306d2df9dac6,0,nixonrodrigues,2021-04-21 18:47:23+05:18,['4d027b4bf1a0c6b4329422a75518f010c579133a'],2,2,4,1847018,2,,,,4235
f6ec21dfb85401b775d82e2727b7d94ddb637f34,0,Pinal,2021-04-22 21:11:15+05:18,['2e0caefdd3b37df8ff9322dc4c14306d2df9dac6'],2,66,68,1847086,2,0.173913043,1,1,4235
d7382ea61569ed8d5492bea53f41b3c038b9b654,0,Pinal,2021-04-22 21:14:41+05:18,['f6ec21dfb85401b775d82e2727b7d94ddb637f34'],4,4,8,1847094,2,,,,4235
ca96653919c4ab21482cf332a7a17f25f97316b4,0,Pinal,2021-04-23 14:44:37+05:18,['d7382ea61569ed8d5492bea53f41b3c038b9b654'],4,4,8,1847102,3,,,,4235
3a0612f58ad2c49c00541305de9b71b650907420,0,Sarath Subramanian,2021-04-23 14:26:13-07:00,['ca96653919c4ab21482cf332a7a17f25f97316b4'],1,1,2,1847104,1,,,,4235
683e2a91db50850014aa92a2abfa668d14624f1a,1,Sarath Subramanian,2021-04-26 11:35:28-07:00,['3a0612f58ad2c49c00541305de9b71b650907420'],4,346,350,1847454,6,0.30952381,0.904761905,0.833333333,4239
eddda699def908895f17384735bf90e08f02d6bf,1,Sarath Subramanian,2021-04-26 22:02:02-07:00,['683e2a91db50850014aa92a2abfa668d14624f1a'],29,137,166,1847620,13,0.963636364,0.981818182,0.672727273,4240
e5f6ce43cd13adefd94fe45bbd9267124f91f559,0,Nikhil Bonte,2021-04-27 13:01:54+05:18,['eddda699def908895f17384735bf90e08f02d6bf'],0,8,8,1847628,1,,,,4240
ad27e8b6a7e47d3fc080f8223efa3382e366b8b6,1,Pinal,2021-04-27 14:58:36+05:18,['e5f6ce43cd13adefd94fe45bbd9267124f91f559'],22,22,44,1847672,6,,,,4240
12aeec0391de47d33d0c27eb901c7e8761d9a2cf,0,Pinal,2021-04-27 14:59:56+05:18,['ad27e8b6a7e47d3fc080f8223efa3382e366b8b6'],10,13,23,1847695,1,1,1,1,4240
8d3c4ab0e8844f04e29f66acb3577e9d40de9a16,1,Pinal,2021-04-27 15:00:59+05:18,['12aeec0391de47d33d0c27eb901c7e8761d9a2cf'],10,22,32,1847727,1,0,1,1,4240
183c076b78e6f7e25cae48f961cb2c40846de179,0,Nikhil Bonte,2021-04-28 16:47:00+05:18,['8d3c4ab0e8844f04e29f66acb3577e9d40de9a16'],4,4,8,1847735,2,,,,4240
7d7d1f3e1b1be9ea585398eb337208250730bda3,1,Sarath Subramanian,2021-04-28 23:09:09-07:00,['183c076b78e6f7e25cae48f961cb2c40846de179'],97,262,359,1848094,5,0.825581395,1,1,4241
5673d72287d59aaf2685030a727998f040abdd72,0,Sarath Subramanian,2021-04-29 10:48:52-07:00,['7d7d1f3e1b1be9ea585398eb337208250730bda3'],12,12,24,1848118,1,,,,4241
7e73fc2591f8177630f1ffd82e774b490832650a,0,Sarath Subramanian,2021-04-29 13:09:30-07:00,['5673d72287d59aaf2685030a727998f040abdd72'],2,6,8,1848126,2,1,1,0,4241
1366a648d08a23d9ff3b3eb3c1e85d069800522f,0,Pinal,2021-04-30 09:43:09+05:18,['7e73fc2591f8177630f1ffd82e774b490832650a'],21,156,177,1848303,4,0.586206897,0.862068966,0.505747126,4241
85e3c5cf64747432bd434bbf1573224988c37bf6,0,Sarath Subramanian,2021-04-29 21:59:57-07:00,['1366a648d08a23d9ff3b3eb3c1e85d069800522f'],5,9,14,1848317,1,0,0,0,4241
8077863b2f5a9c7ee4bd140eb954e24fef684785,1,Sarath Subramanian,2021-04-29 22:35:38-07:00,['85e3c5cf64747432bd434bbf1573224988c37bf6'],24,2170,2194,1850511,46,0.413723512,0.612512614,0.884964682,4257
a3e3b9c02167e7832324b99c7c412bfaeeab52a8,1,Nikhil Bonte,2021-04-30 19:02:57+05:18,['8077863b2f5a9c7ee4bd140eb954e24fef684785'],9,586,595,1851106,17,0.759322034,0.979661017,0.911864407,4261
77914a3a0dafc0975ed5654ea5394d4215e2d426,1,Ashutosh Mestry,2021-05-03 16:23:21-07:00,['a3e3b9c02167e7832324b99c7c412bfaeeab52a8'],9,18,27,1851133,2,0,1,1,4261
21606bdc20e3890ddf9d26555fc71e4175310950,0,GitHub,2021-05-04 15:13:07+05:18,['77914a3a0dafc0975ed5654ea5394d4215e2d426'],28,80,108,1851241,2,0.068181818,1,1,4261
0384f4c0f428200bdd8cb46a7ae418b7acd6afdc,0,nixonrodrigues,2021-05-10 09:33:20+05:18,['21606bdc20e3890ddf9d26555fc71e4175310950'],6,8,14,1851255,1,0.5,0.5,1,4261
7605f7a6aee531ec82637edb2eec0aad3d24dc85,0,nixonrodrigues,2021-05-10 10:13:53+05:18,['0384f4c0f428200bdd8cb46a7ae418b7acd6afdc'],5,8,13,1851268,2,1,1,1,4261
efb0ee1df75ec0b03990c7e56feaa926314d9226,0,nixonrodrigues,2021-05-10 15:09:20+05:18,['7605f7a6aee531ec82637edb2eec0aad3d24dc85'],0,1,1,1851269,1,,,,4261
e6f78f28c8167c0099c1493fee51aac39abeebea,1,Sarath Subramanian,2021-05-10 18:11:43-07:00,['efb0ee1df75ec0b03990c7e56feaa926314d9226'],4,4,8,1851277,1,,,,4261
ed1c4854ba05093ac9484b2c96e284520414dfc3,1,nixonrodrigues,2021-05-11 10:23:58+05:18,['e6f78f28c8167c0099c1493fee51aac39abeebea'],1,3,4,1851281,1,0,1,1,4261
c5ad5810856e465efa0cbb2d33c1614d52ff3b00,0,Sarath Subramanian,2021-05-11 09:29:27-07:00,['ed1c4854ba05093ac9484b2c96e284520414dfc3'],4,5,9,1851290,1,,,,4261
4100684fa3f63cb2a6267ab24051002ce38de017,0,Sarath Subramanian,2021-05-12 09:58:48-07:00,['c5ad5810856e465efa0cbb2d33c1614d52ff3b00'],2,8,10,1851300,1,1,1,1,4261
81888a9c7772b83437d009071e91fbd2a13cc831,0,Sarath Subramanian,2021-05-12 14:44:18-07:00,['4100684fa3f63cb2a6267ab24051002ce38de017'],0,4,4,1851304,1,0,1,1,4261
bac159f46502233081bcdda1a75c9f71197b31dd,0,nixonrodrigues,2021-05-13 12:44:50+05:18,['81888a9c7772b83437d009071e91fbd2a13cc831'],4,2,6,1851310,2,,,,4261
c0cf04f7ece4af3734d1285c4385b46f8e556020,0,nixonrodrigues,2021-05-13 12:45:06+05:18,['bac159f46502233081bcdda1a75c9f71197b31dd'],2,4,6,1851316,2,1,1,1,4261
821b4c441153505db7f0ba9c5670623c527af989,1,Sarath Subramanian,2021-05-13 15:22:36-07:00,['c0cf04f7ece4af3734d1285c4385b46f8e556020'],23,185,208,1851524,2,0.268656716,0.291044776,0.910447761,4261
127ed22e7b50b7384f62abad47d8d1a175e395d3,0,sidmishra,2021-05-13 15:30:03-07:00,['821b4c441153505db7f0ba9c5670623c527af989'],0,11,11,1851535,1,,,,4261
64bea6a5e98fbb87a76d53f9e7e2f5ca01671426,0,Sidharth Mishra,2021-05-17 23:26:02-07:00,['127ed22e7b50b7384f62abad47d8d1a175e395d3'],11,19,30,1851565,2,0.428571429,0,0.428571429,4261
aba97b35393f1732eb30858e69fd5f489634afdc,0,Sarath Subramanian,2021-05-20 14:51:55-07:00,['64bea6a5e98fbb87a76d53f9e7e2f5ca01671426'],96,43,139,1851704,6,1,1,1,4261
7e2e130901f9876d5448d1155714daceccc25872,0,Nikhil Bonte,2021-05-21 16:06:27+05:18,['aba97b35393f1732eb30858e69fd5f489634afdc'],2,2,4,1851708,1,,,,4261
4691650dfe26f13884483bba6025cb66f4f818da,0,Nikhil Bonte,2021-05-21 16:06:44+05:18,['7e2e130901f9876d5448d1155714daceccc25872'],50,99,149,1851857,5,0.416666667,0,1,4261
07037d2f5328a85be7e106cbbe82ffc91c3ea77d,0,Nikhil Bonte,2021-05-21 16:07:23+05:18,['4691650dfe26f13884483bba6025cb66f4f818da'],43,96,139,1851996,2,0.608695652,0.652173913,1,4261
c3df22605795b9bddcba547852c04461ee9b8203,1,Nikhil Bonte,2021-05-21 16:08:01+05:18,['07037d2f5328a85be7e106cbbe82ffc91c3ea77d'],43,579,622,1852618,26,0.721115538,0.884462151,0.860557769,4266
f3afbdb3953e8ddbfcab6177083227b6cb89ecba,1,Ashutosh Mestry,2021-05-24 17:08:39-07:00,['c3df22605795b9bddcba547852c04461ee9b8203'],2,3,5,1852623,3,1,1,1,4266
35419d6c5a8b1b2bbba60e2f6d6fdf19efd8949b,1,Pinal,2021-05-25 21:58:44+05:18,['f3afbdb3953e8ddbfcab6177083227b6cb89ecba'],234,603,837,1853460,13,0.400809717,0.647773279,0.854251012,4266
3bdc51ea1e1ed463f8c2c35c8bfc1fbb4b792cab,1,sidmishra,2021-05-26 13:42:29-07:00,['35419d6c5a8b1b2bbba60e2f6d6fdf19efd8949b'],2,2,4,1853464,1,,,,4266
6648af332a234d606145a0440ac94da00782acc9,0,sidmishra,2021-05-26 13:54:36-07:00,['3bdc51ea1e1ed463f8c2c35c8bfc1fbb4b792cab'],11,94,105,1853569,2,0.193548387,0.467741935,0.822580645,4266
fd26e12f689161fd85676b4a3d81cf1fcbd4e10a,0,Ashutosh Mestry,2021-05-26 14:24:11-07:00,['6648af332a234d606145a0440ac94da00782acc9'],1,1,2,1853571,1,,,,4266
076904fa2bcbcc2b2e2563f7f6738ee10df2ffd4,0,nixonrodrigues,2021-05-27 19:13:03+05:18,['fd26e12f689161fd85676b4a3d81cf1fcbd4e10a'],5,10,15,1853586,2,,,,4266
aa001dbf7c08c9de2bb9eae27ac0581b09b5c403,0,nixonrodrigues,2021-05-27 19:13:15+05:18,['076904fa2bcbcc2b2e2563f7f6738ee10df2ffd4'],4,23,27,1853613,2,1,1,1,4266
47cca6fc1efb7b5c4158c0262f1ef2c434719f0a,0,nixonrodrigues,2021-05-27 19:13:24+05:18,['aa001dbf7c08c9de2bb9eae27ac0581b09b5c403'],2,2,4,1853617,2,,,,4266
a098068614bac0902eb8ccc8ce297f3ac1f580c1,0,nixonrodrigues,2021-05-27 19:13:33+05:18,['47cca6fc1efb7b5c4158c0262f1ef2c434719f0a'],15,2,17,1853634,2,0,0,0,4266
e2a0c10393558d2b4454e2da574cbfeedd043956,1,Nikhil Bonte,2021-05-28 09:39:52+05:18,['a098068614bac0902eb8ccc8ce297f3ac1f580c1'],12,276,288,1853922,11,0.857142857,0.982142857,0.660714286,4270
eec5d77f273ecbd10bfcfa3e10036a3f19994233,0,Nikhil Bonte,2021-05-28 09:41:45+05:18,['e2a0c10393558d2b4454e2da574cbfeedd043956'],0,2,2,1853924,2,0,1,1,4270
6ced16be4cc8c367a16fdfea3a11185c5a3206ef,0,nixonrodrigues,2021-06-01 10:38:29+05:18,['eec5d77f273ecbd10bfcfa3e10036a3f19994233'],0,12,12,1853936,2,0,0,1,4270
4f74de1498ef9f191f2b6d21d963d6de6ca0c5f9,0,GitHub,2021-06-01 20:10:22+05:18,['6ced16be4cc8c367a16fdfea3a11185c5a3206ef'],6,19,25,1853961,1,1,1,0,4270
8f1bd684e4168c4cf6f0f05a8cb64acb18c90a5b,0,GitHub,2021-06-01 20:14:27+05:18,['4f74de1498ef9f191f2b6d21d963d6de6ca0c5f9'],2,2,4,1853965,1,,,,4270
ab23b99c50ec355773da35da2af5a2c3d01c3cec,0,GitHub,2021-06-01 20:18:57+05:18,['8f1bd684e4168c4cf6f0f05a8cb64acb18c90a5b'],3,3,6,1853971,1,,,,4270
fac8349593a63a1578f9337712e4c1db055abcd8,0,GitHub,2021-06-01 22:34:53+05:18,['ab23b99c50ec355773da35da2af5a2c3d01c3cec'],1,1,2,1853973,1,,,,4270
3356dfc5f847f607d8dddef4eddda0f642dc6c76,0,GitHub,2021-06-01 23:02:09+05:18,['fac8349593a63a1578f9337712e4c1db055abcd8'],0,3,3,1853976,1,,,,4270
36678ab1f331eb717578c3b2ed6677544ac3aa2a,0,Ashutosh Mestry,2021-06-01 16:00:38-07:00,['3356dfc5f847f607d8dddef4eddda0f642dc6c76'],10,54,64,1854040,5,0.96875,1,1,4270
6d8718483f9ef60906addd7c2bb94785039986ac,0,GitHub,2021-06-03 08:45:37+05:18,['36678ab1f331eb717578c3b2ed6677544ac3aa2a'],1,0,1,1854041,1,1,0,0,4270
edf9936ce9692011a69be2cd58817e70942aa574,0,Ashutosh Mestry,2021-06-02 22:02:58-07:00,['6d8718483f9ef60906addd7c2bb94785039986ac'],8,9,17,1854058,1,0,0,1,4270
e993f85d7b2c5e11914a328f4b3aee4392c4e106,0,Sarath Subramanian,2021-06-03 09:12:40-07:00,['edf9936ce9692011a69be2cd58817e70942aa574'],9,12,21,1854079,3,0.666666667,0,0.333333333,4270
a9e528bca9277707a1847d110c33288188a8fff5,1,Sarath Subramanian,2021-06-03 09:33:31-07:00,['e993f85d7b2c5e11914a328f4b3aee4392c4e106'],14,270,284,1854363,11,1,1,1,4276
ff0c65a49fb4617b85a5b8a674be53305f5cf64b,0,sidmishra,2021-06-03 10:30:56-07:00,['a9e528bca9277707a1847d110c33288188a8fff5'],3,3,6,1854369,1,,,,4276
f96a6530c09a83e4f0d6613e558c4e2e5d5f236a,0,GitHub,2021-06-04 10:59:30+05:18,['ff0c65a49fb4617b85a5b8a674be53305f5cf64b'],5,5,10,1854379,5,,,,4276
ef43a55fccf60bafd1ce1a5c0f2565d6da0e0620,1,nixonrodrigues,2021-06-04 14:36:59+05:18,['f96a6530c09a83e4f0d6613e558c4e2e5d5f236a'],0,138,138,1854517,3,1,1,0.708333333,4277
005d8674e09338504278440658af3159c8e5a967,0,nixonrodrigues,2021-06-04 14:39:22+05:18,['ef43a55fccf60bafd1ce1a5c0f2565d6da0e0620'],0,106,106,1854623,1,,,,4278
ae3f655872c3a114ef1b38e2de77d270530e8db6,0,nixonrodrigues,2021-06-04 17:56:06+05:18,['005d8674e09338504278440658af3159c8e5a967'],2,2,4,1854627,2,,,,4278
f9d447d6ec0c6ac7a240b8965bac69fb4bf9c50d,0,nixonrodrigues,2021-06-04 17:57:57+05:18,['ae3f655872c3a114ef1b38e2de77d270530e8db6'],4,16,20,1854647,4,,,,4278
8db2ccc5ec05c1b2eaeae29bed7951d53fd87443,0,Sarath Subramanian,2021-06-07 10:31:10-07:00,['f9d447d6ec0c6ac7a240b8965bac69fb4bf9c50d'],2,2,4,1854651,1,,,,4278
0a43c1980c75f37a58fbb69347ec7a0e8f508126,0,nixonrodrigues,2021-06-10 10:55:56+05:18,['8db2ccc5ec05c1b2eaeae29bed7951d53fd87443'],4,4,8,1854659,2,,0,,4278
f048f84e78840387822d5ab5a5678f17756aa0b1,1,nixonrodrigues,2021-06-10 10:56:28+05:18,['0a43c1980c75f37a58fbb69347ec7a0e8f508126'],6,12,18,1854677,6,0,1,1,4278
e8832f0dbb203dc33475a49711463929b984a37b,0,nixonrodrigues,2021-06-10 10:58:09+05:18,['f048f84e78840387822d5ab5a5678f17756aa0b1'],6,20,26,1854703,6,0.75,1,0.875,4278
1078f25e90134be4a7e9f35f9774c113909aba97,0,nixonrodrigues,2021-06-10 19:22:50+05:18,['e8832f0dbb203dc33475a49711463929b984a37b'],24,2,26,1854729,4,0,0.9,0,4278
01f5eea5c60b710e16370b7e09a60a5353f8d17d,0,Ashutosh Mestry,2021-06-10 13:36:21-07:00,['1078f25e90134be4a7e9f35f9774c113909aba97'],1,2,3,1854732,1,1,0,1,4278
2afbf4daa650f49674ca1c7481697b852cb6a446,1,Pinal,2021-06-11 09:51:46+05:18,['01f5eea5c60b710e16370b7e09a60a5353f8d17d'],5,41,46,1854778,6,0.6,0.88,0.96,4278
cf925b6821854a6d6accd1875a3b67805cae110c,0,nixonrodrigues,2021-06-11 17:18:17+05:18,['2afbf4daa650f49674ca1c7481697b852cb6a446'],0,0,0,1854778,16,,,,4294
817afa0a33d31a32f5ed94e30a8e6584eccf77a9,0,nixonrodrigues,2021-06-11 18:49:50+05:18,['cf925b6821854a6d6accd1875a3b67805cae110c'],0,5,5,1854783,1,0,1,0,4294
0ac4b12be7c38ba34951da6bdbe82d23968cce13,0,Ashutosh Mestry,2021-06-11 09:20:42-07:00,['817afa0a33d31a32f5ed94e30a8e6584eccf77a9'],223,238,461,1855244,14,0,0,0,4294
2eb2b868fb802d99ec1bde99fffcd1416e7f516d,0,Pinal,2021-06-14 21:54:06+05:18,['0ac4b12be7c38ba34951da6bdbe82d23968cce13'],263,455,718,1855962,11,0.536764706,0.514705882,0.889705882,4294
ddf3bcff29b903f1efc6671285ddf8f3cc10c7c3,0,nixonrodrigues,2021-06-16 12:11:59+05:18,['2eb2b868fb802d99ec1bde99fffcd1416e7f516d'],0,0,0,1855962,24,,,,4314
b0323398ff5e554b3818f18581651b140535ca88,0,GitHub,2021-06-16 19:18:18+05:18,['ddf3bcff29b903f1efc6671285ddf8f3cc10c7c3'],1,1,2,1855964,1,,,,4314
244c5d519432754841709687aa008e544822dae3,0,nixonrodrigues,2021-06-22 14:00:21+05:18,['b0323398ff5e554b3818f18581651b140535ca88'],2,9,11,1855975,5,1,1,1,4316
fa044447f535f2b1f9315e8a7b75d9744c22fb9f,0,nixonrodrigues,2021-06-22 14:17:16+05:18,['244c5d519432754841709687aa008e544822dae3'],1,1,2,1855977,1,,,,4316
01082f1ea84d8c98cf4b7efc5bc88e0c71404e3f,0,Pinal,2021-06-22 23:11:53+05:18,['fa044447f535f2b1f9315e8a7b75d9744c22fb9f'],1,3,4,1855981,3,0,1,1,4316
77b03aa1407ec6d78cc0fcaf9a06654191d42d73,0,Sarath Subramanian,2021-06-24 12:01:44-07:00,['01082f1ea84d8c98cf4b7efc5bc88e0c71404e3f'],21,30,51,1856032,7,1,1,0.714285714,4316
2f6f20474bc08c9706b26c0a09d6092b69e8590f,0,nixonrodrigues,2021-06-29 16:51:40+05:18,['77b03aa1407ec6d78cc0fcaf9a06654191d42d73'],50,48,98,1856130,2,1,1,0,4316
475a89b30864bd95909837a2b3480779fc7ee5e2,0,nixonrodrigues,2021-07-06 19:45:25+05:18,['2f6f20474bc08c9706b26c0a09d6092b69e8590f'],0,35,35,1856165,2,0,1,1,4316
1868a2ddaf044fb1f5d4df5a7a3a765b213ad6ed,0,Pinal,2021-07-09 12:00:12+05:18,['475a89b30864bd95909837a2b3480779fc7ee5e2'],13,56,69,1856234,2,1,1,0.65,4316
fbaaa59e36010a4358d069aec8eebb7f48d59d24,0,sidmishra,2021-07-09 12:27:49-07:00,['1868a2ddaf044fb1f5d4df5a7a3a765b213ad6ed'],1,3,4,1856238,2,0.5,1,1,4316
c1dc84cdeeb1b5c3a53f2bec01ae138e5f578dd1,1,nixonrodrigues,2021-07-13 15:34:10+05:18,['fbaaa59e36010a4358d069aec8eebb7f48d59d24'],1,4,5,1856243,1,,,,4316
4c7aea1a170a1173fa1bb13023c79d52f5f27799,0,Nikhil Bonte,2021-07-16 21:21:32+05:18,['c1dc84cdeeb1b5c3a53f2bec01ae138e5f578dd1'],6,9,15,1856258,2,0,0,1,4316
8725f31af9821907ced99a829b9e0dbbf3f6de2b,0,Sarath Subramanian,2021-07-16 15:16:38-07:00,['4c7aea1a170a1173fa1bb13023c79d52f5f27799'],12,117,129,1856387,6,0.491525424,0.830508475,0.86440678,4317
217067210012798f88067582efbf8432474758ca,0,Sarath Subramanian,2021-07-20 17:05:32-07:00,['8725f31af9821907ced99a829b9e0dbbf3f6de2b'],1,1,2,1856389,1,,,,4317
e9c99739010b451638ad90773ca8d36e86fd2841,0,nixonrodrigues,2021-07-27 14:26:29+05:18,['217067210012798f88067582efbf8432474758ca'],0,8,8,1856397,2,,,,4317
9a5c5c5a39bbc5167127e25bf243c8cf93d81971,0,nixonrodrigues,2021-07-27 14:26:52+05:18,['e9c99739010b451638ad90773ca8d36e86fd2841'],10,20,30,1856427,4,,,,4317
b667943ff5217e8dc328dbd7f41c2c89199a78dd,0,nixonrodrigues,2021-07-27 14:28:27+05:18,['9a5c5c5a39bbc5167127e25bf243c8cf93d81971'],1,1,2,1856429,1,,,,4317
98c6cea0140d64761542e603532d13127a0524b4,0,Sarath Subramanian,2021-07-27 11:22:39-07:00,['b667943ff5217e8dc328dbd7f41c2c89199a78dd'],0,3,3,1856432,1,1,1,1,4317
a7ac64d54954064be6b0f56c04f05bbe128772d5,0,Sarath Subramanian,2021-07-27 14:59:48-07:00,['98c6cea0140d64761542e603532d13127a0524b4'],26,38,64,1856496,12,0,0,1,4317
cd4bb5497c28456c9a816eb7e6e37e1e1029c74d,0,Ashutosh Mestry,2021-07-28 13:51:49-07:00,['a7ac64d54954064be6b0f56c04f05bbe128772d5'],1,1,2,1856498,1,,,,4317
2576a236913915a928e48edc186d25461dae5774,0,Ashutosh Mestry,2021-07-28 13:52:43-07:00,['cd4bb5497c28456c9a816eb7e6e37e1e1029c74d'],1,1,2,1856500,1,,,,4317
4405b6795d264c208d94f9dd7c592ef3516ade24,0,Madhan Neethiraj,2021-08-07 13:15:58-07:00,['2576a236913915a928e48edc186d25461dae5774'],2,2,4,1856504,1,,,,4317
7917e548a9bf184fba9ed7b227bc153a7f11e949,0,nixonrodrigues,2021-08-09 09:36:50+05:18,['4405b6795d264c208d94f9dd7c592ef3516ade24'],2,2,4,1856508,2,,,,4317
e3cbaabfba4f0aeb606c696492747759a8d34423,1,Pinal,2021-08-09 13:28:58+05:18,['7917e548a9bf184fba9ed7b227bc153a7f11e949'],3,82,85,1856593,3,0.642857143,0.642857143,0.928571429,4317
8edec03affcc9881a3d55f0f3cf9893829bed3bd,0,sidmishra,2021-08-09 13:32:18-07:00,['e3cbaabfba4f0aeb606c696492747759a8d34423'],1,1,2,1856595,1,,,,4317
98b7118c1034c98ee403ab6083dc3c9670df5d1f,0,sidmishra,2021-08-09 14:55:51-07:00,['8edec03affcc9881a3d55f0f3cf9893829bed3bd'],2,4,6,1856601,1,,,,4317
d160138d5e7d23cd8c4345dba55c140dc9bc84b2,0,Nikhil Bonte,2021-08-17 16:10:57+05:18,['98b7118c1034c98ee403ab6083dc3c9670df5d1f'],2,29,31,1856632,2,1,1,1,4317
625bfd2064b36597eee795b51ed03b1d39190107,0,Nikhil Bonte,2021-08-17 17:00:27+05:18,['d160138d5e7d23cd8c4345dba55c140dc9bc84b2'],0,8,8,1856640,1,0,0,1,4317
d7605a254626a97b247aecdd3964c1b80d296a2d,0,sidmishra,2021-08-18 10:08:21-07:00,['625bfd2064b36597eee795b51ed03b1d39190107'],2,2,4,1856644,1,,,,4317
77d2c21b5f2c045c9e3ff47ed51641328f704489,0,sidmishra,2021-08-18 15:45:52-07:00,['d7605a254626a97b247aecdd3964c1b80d296a2d'],10,80,90,1856734,6,,,,4318
3b477dc91ee8e40ec5f9c45278183b886f9ee6ce,0,sidmishra,2021-08-19 18:40:41-07:00,['77d2c21b5f2c045c9e3ff47ed51641328f704489'],1,1,2,1856736,1,,,,4318
31c0edb3fd0bf7480a5d7bf2eb9d3c05bdcfe987,0,sidmishra,2021-08-19 22:19:30-07:00,['3b477dc91ee8e40ec5f9c45278183b886f9ee6ce'],13,15,28,1856764,1,,,,4318
d0d195cc0204e6c4fb1e87c9d758318eefb849e7,0,Nikhil Bonte,2021-08-25 19:01:41+05:18,['31c0edb3fd0bf7480a5d7bf2eb9d3c05bdcfe987'],4,25,29,1856793,2,1,1,1,4318
b612a9458004ee6601a6ad58d7ec88f8b322a49e,0,Sarath Subramanian,2021-08-26 09:52:07-07:00,['d0d195cc0204e6c4fb1e87c9d758318eefb849e7'],0,4,4,1856797,1,1,1,1,4318
d7547c493f25f3e1acc5572ce7159068d6b2d00e,1,sidmishra,2021-08-27 10:27:32-07:00,['b612a9458004ee6601a6ad58d7ec88f8b322a49e'],9,364,373,1857170,7,0.170212766,0.877659574,0.984042553,4320
097f50eae35e927411af3593fa401a335e61a0e3,0,Sarath Subramanian,2021-08-27 14:11:52-07:00,['d7547c493f25f3e1acc5572ce7159068d6b2d00e'],121,80,201,1857371,1,0.869565217,0.130434783,1,4320
fbbefce84eaa0e846faa01eb79b79a8f3184348f,0,nixonrodrigues,2021-08-31 20:41:24+05:18,['097f50eae35e927411af3593fa401a335e61a0e3'],7,170,177,1857548,5,0.21,0.38,0.77,4321
5deac6277cb5e0676e811f682da2a7692a9f628e,0,nixonrodrigues,2021-08-31 20:43:06+05:18,['fbbefce84eaa0e846faa01eb79b79a8f3184348f'],6,604,610,1858158,10,0.650862069,1,0.549568966,4323
50203e025852eda970bc812d9ba5ed2e5ba4242b,0,Ashutosh Mestry,2021-08-31 10:35:19-07:00,['5deac6277cb5e0676e811f682da2a7692a9f628e'],1,1,2,1858160,1,,,,4323
38caee17c9a80ea6196ec3363e0f3d58c905c580,0,Ashutosh Mestry,2021-08-31 10:35:19-07:00,['50203e025852eda970bc812d9ba5ed2e5ba4242b'],1,1,2,1858162,1,,,,4323
e962143866f69ad96a2207e07a5f0ce1d2e4797e,0,Ashutosh Mestry,2021-08-31 10:35:19-07:00,['38caee17c9a80ea6196ec3363e0f3d58c905c580'],0,1,1,1858163,1,0,1,1,4323
25dc63d69f37a13ddc3398dfbcacbf5bfd2b07a7,0,Pinal Shah,2021-09-06 11:59:13+05:18,['e962143866f69ad96a2207e07a5f0ce1d2e4797e'],6,12,18,1858181,4,0,0,0,4323
684b4a0b801c9c0ad4659a5a8521255d40c2e0c6,0,Pinal Shah,2021-09-06 12:00:22+05:18,['25dc63d69f37a13ddc3398dfbcacbf5bfd2b07a7'],2,44,46,1858227,4,0.15,0,1,4323
d6e84a80406ff13af4885ff02202b7447b728be3,0,Pinal Shah,2021-09-08 19:16:13+05:18,['684b4a0b801c9c0ad4659a5a8521255d40c2e0c6'],3,370,373,1858600,4,0.571895425,0.705882353,1,4324
9f270729eadeed0fcfc6aecf25b3afb130cac2e5,0,Pinal Shah,2021-09-08 19:16:33+05:18,['d6e84a80406ff13af4885ff02202b7447b728be3'],1,1,2,1858602,1,,,,4324
cdc73aeb7a55b484f31ed39913647703d66706d5,0,Pinal Shah,2021-09-08 19:16:42+05:18,['9f270729eadeed0fcfc6aecf25b3afb130cac2e5'],9,21,30,1858632,1,0.363636364,0.454545455,1,4324
6e4d369fd8b1f1529af14261d084c877109b58c6,0,Sarath Subramanian,2021-09-13 11:19:03-07:00,['cdc73aeb7a55b484f31ed39913647703d66706d5'],1,2,3,1858635,1,,,,4324
953f65b9c421432ebbf755214769b074d0847bae,0,Pinal Shah,2021-09-14 09:26:05+05:18,['6e4d369fd8b1f1529af14261d084c877109b58c6'],88,109,197,1858832,13,0.916666667,0.583333333,0.583333333,4324
98b43fc9d70afce4cd226bd1e3439ee7a76a3467,0,Pinal Shah,2021-09-16 09:31:56+05:18,['953f65b9c421432ebbf755214769b074d0847bae'],7,79,86,1858918,4,0.785714286,0.928571429,0.857142857,4324
068d1fae3fffe9207e10a62c53f41dc38b9251d9,0,Pinal Shah,2021-09-17 11:44:36+05:18,['98b43fc9d70afce4cd226bd1e3439ee7a76a3467'],2,8,10,1858928,4,0,0,1,4324
b9d4dd113a8ac12227b301daba3065f64d749d1d,0,Pinal Shah,2021-09-17 11:44:48+05:18,['068d1fae3fffe9207e10a62c53f41dc38b9251d9'],0,3,3,1858931,1,1,1,1,4324
3ad3f30ee5b74c1b231e82c4dd414da07b6a36c1,0,Pinal Shah,2021-09-17 11:45:03+05:18,['b9d4dd113a8ac12227b301daba3065f64d749d1d'],0,4,4,1858935,1,,,,4324
e57204bd55d27f258c19e7334c10cc4802cf14c7,0,Sarath Subramanian,2021-09-20 21:12:48-07:00,['3ad3f30ee5b74c1b231e82c4dd414da07b6a36c1'],2,10,12,1858947,1,0,1,1,4324
926fb297c13574e761db4798763780715af2477e,0,Pinal Shah,2021-09-21 10:47:35+05:18,['e57204bd55d27f258c19e7334c10cc4802cf14c7'],29,54,83,1859030,6,0.894736842,0.894736842,1,4324
60898d5888a7a6426680d70ae277a56401f096d4,1,Martin Tzvetanov Grigorov,2021-09-22 14:03:08+03:00,['926fb297c13574e761db4798763780715af2477e'],1,1,2,1859032,1,,,,4324
909d9531ca8031144f82e2be963dc27b5e780b4e,0,Ashutosh Mestry,2021-09-22 12:31:57-07:00,['926fb297c13574e761db4798763780715af2477e'],14,39,53,1859085,4,0,0.25,0.75,4324
913d43b19125a1127364ba3cf365c1f0bdf90035,0,Pinal Shah,2021-09-23 13:53:14+05:18,['909d9531ca8031144f82e2be963dc27b5e780b4e'],1,1,2,1859087,1,,,,4324
a2eaca4ed9a992b42bed18ba73c1da6ed414566e,0,Ashutosh Mestry,2021-09-27 16:30:08-07:00,['913d43b19125a1127364ba3cf365c1f0bdf90035'],18,27,45,1859132,1,0.8,1,0.4,4324
5053f93744dfdde26ebcd7f1d40f037c108803ae,0,Pinal Shah,2021-09-28 11:30:02+05:18,['a2eaca4ed9a992b42bed18ba73c1da6ed414566e'],2,2,4,1859136,1,,,,4324
23d5ef44807b21c78673d8f18dca53951688e6f7,0,Pinal Shah,2021-09-28 11:30:39+05:18,['5053f93744dfdde26ebcd7f1d40f037c108803ae'],42,35,77,1859213,3,1,1,0,4324
0aa45c8657a071bd4ee9e698abbeba81e1e542c6,0,Sarath Subramanian,2021-09-29 11:05:57-07:00,['23d5ef44807b21c78673d8f18dca53951688e6f7'],5,8,13,1859226,2,0,0,0.666666667,4324
a0e08b5ee8f3da1e3becd9e280d3e48bc6ffaff5,1,Pinal Shah,2021-09-30 20:15:59+05:18,['0aa45c8657a071bd4ee9e698abbeba81e1e542c6'],8,383,391,1859617,18,,,,4324
dbdc4225706ff40b0bc1a81a6d8cdc4a93fe53ae,0,Pinal Shah,2021-10-01 18:08:03+05:18,['a0e08b5ee8f3da1e3becd9e280d3e48bc6ffaff5'],6,6,12,1859629,6,,,,4324
71fd77129e91d05dd3ec582bc20968c1993ef905,0,Pinal Shah,2021-10-01 18:08:15+05:18,['dbdc4225706ff40b0bc1a81a6d8cdc4a93fe53ae'],1,2,3,1859632,1,,,,4324
028e3e0b85ee63619924a157f1bf790a2fd9f213,1,Ashutosh Mestry,2021-10-05 08:35:09-07:00,['71fd77129e91d05dd3ec582bc20968c1993ef905'],2,2,4,1859636,2,,,,4324
375a6e43f1cf3241172a7955028e11012f2c4dea,0,Ashutosh Mestry,2021-10-05 15:00:30-07:00,['028e3e0b85ee63619924a157f1bf790a2fd9f213'],1,1,2,1859638,1,,,,4324
8b48f0183e5ae34da1a7bad33aa75c427d35d063,0,Martin Tzvetanov Grigorov,2021-10-06 13:57:52+03:00,['60898d5888a7a6426680d70ae277a56401f096d4'],1,1,2,1859640,1,,,,4324
a8ecfdf8d735b56f35af9c0e6f47990b91910ba0,0,Pinal Shah,2021-10-08 19:07:27+05:18,['375a6e43f1cf3241172a7955028e11012f2c4dea'],2,48,50,1859690,3,0,0.653846154,1,4324
11627e33d3b262d60ae0a3c6338f7963ffedaeab,0,sidmishra,2021-10-08 10:26:14-07:00,['a8ecfdf8d735b56f35af9c0e6f47990b91910ba0'],21,136,157,1859847,2,0.118421053,0.592105263,1,4324
261331bbd1fa8e50517421ab834f01f89f4997e1,1,Sarath Subramanian,2021-10-10 21:50:29-07:00,['11627e33d3b262d60ae0a3c6338f7963ffedaeab'],28,575,603,1860450,11,0.527472527,0.875457875,0.970695971,4326
c7c6f3699ab2ffe3fbebfbb2885e3dd1c997c345,0,Pinal Shah,2021-10-12 14:11:12+05:18,['261331bbd1fa8e50517421ab834f01f89f4997e1'],1,128,129,1860579,5,0.413793103,0.413793103,0.413793103,4327
389cd417bb2741e306e9b12d6fee3e0db1bf59bf,0,Pinal Shah,2021-10-21 14:19:43+05:18,['c7c6f3699ab2ffe3fbebfbb2885e3dd1c997c345'],1,1,2,1860581,1,,,,4327
fc60a07e4de4fcd7a4fc5d6659dc860f4f55b4fa,0,Ashutosh Mestry,2021-10-21 08:39:49-07:00,['389cd417bb2741e306e9b12d6fee3e0db1bf59bf'],52,2,54,1860635,4,,,,4327
80b3c11d1f8b7deb4e35427635b15c1252fc40c7,0,Pinal Shah,2021-10-26 11:40:25+05:18,['fc60a07e4de4fcd7a4fc5d6659dc860f4f55b4fa'],14,12,26,1860661,3,,,,4327
f08003d136562f47ca93fe5b645cab2e235bb208,0,Pinal Shah,2021-10-26 11:41:00+05:18,['80b3c11d1f8b7deb4e35427635b15c1252fc40c7'],3,3,6,1860667,1,,,,4327
a5ffaae5cb8649a476b233db83ebe1f149991f5d,0,Sidharth Mishra,2021-10-26 14:10:36-07:00,['f08003d136562f47ca93fe5b645cab2e235bb208'],8,12,20,1860687,2,0.714285714,1,0.714285714,4327
8ed4c5e7cb3c7efb6a39e5c8342b5ff90d5810be,0,Sidharth Mishra,2021-10-28 15:19:21-07:00,['a5ffaae5cb8649a476b233db83ebe1f149991f5d'],270,8,278,1860965,15,,,,4327
680f23fab55f35cf65a5189ae3882ebe360b1b01,0,Sidharth Mishra,2021-10-28 15:22:34-07:00,['8ed4c5e7cb3c7efb6a39e5c8342b5ff90d5810be'],2,26,28,1860993,1,0.923076923,0.923076923,1,4327
65bcd9f57354fd5e50435d299df8508c14108184,1,Sidharth Mishra,2021-10-28 17:31:18-07:00,['680f23fab55f35cf65a5189ae3882ebe360b1b01'],18,159,177,1861170,11,0,0.536231884,1,4328
88b7d336a99d7a64aaca565dbaf73910c7d54308,0,Sidharth Mishra,2021-10-28 22:58:03-07:00,['65bcd9f57354fd5e50435d299df8508c14108184'],1,1,2,1861172,1,,,,4328
d9ce6089fee5749d69b525e49c2b446202b800ab,0,Pinal Shah,2021-10-29 19:29:43+05:18,['88b7d336a99d7a64aaca565dbaf73910c7d54308'],2,2,4,1861176,1,,,,4328
7581672b7a0d2ecd4588667bc225c9da90810937,0,Pinal Shah,2021-11-01 11:26:52+05:18,['d9ce6089fee5749d69b525e49c2b446202b800ab'],42,302,344,1861520,21,0.977777778,1,0.033333333,4330
6721c0d949863931896e6e0737470d387f71431b,0,Pinal Shah,2021-11-01 13:50:24+05:18,['7581672b7a0d2ecd4588667bc225c9da90810937'],47,98,145,1861665,12,0.272727273,0.242424242,0.303030303,4330
c0700e436afccc04e7f77480d6fb8aed8e293db4,0,Sidharth Mishra,2021-11-01 13:53:48-07:00,['6721c0d949863931896e6e0737470d387f71431b'],1,25,26,1861691,3,0,1,1,4330
69d0873eb5893b154a1f149b1691a0b1d7218d00,0,GitHub,2021-11-02 13:01:19-07:00,"['c0700e436afccc04e7f77480d6fb8aed8e293db4', '8b48f0183e5ae34da1a7bad33aa75c427d35d063']",1,1,2,1861693,1,,,,4330
a285f06ad8bc56890f0d796ec6b5eb4ef93b8071,0,Pinal Shah,2021-11-03 11:17:29+05:18,['69d0873eb5893b154a1f149b1691a0b1d7218d00'],4,14,18,1861711,4,,,,4330
041e7d737efbe243ebeb525ae4af1941b1008ee2,1,Sidharth Mishra,2021-11-03 16:48:51-07:00,['a285f06ad8bc56890f0d796ec6b5eb4ef93b8071'],113,1265,1378,1863089,9,0.42780027,0.604588394,0.773279352,4331
7ed56dbe6c0d38bbe3b3dc08228c6766768d5fb2,0,Pinal Shah,2021-11-08 10:18:30+05:18,['041e7d737efbe243ebeb525ae4af1941b1008ee2'],2,2,4,1863093,2,,,,4331
2be96918c89e54da15ce399f774a1938ab07f3db,0,Sarath Subramanian,2021-11-08 15:59:52-08:00,['7ed56dbe6c0d38bbe3b3dc08228c6766768d5fb2'],7,31,38,1863131,1,0,0,1,4331
10a7c76c8e07a60c65109391e76970714f2122e2,0,Sidharth Mishra,2021-11-09 12:58:21-08:00,['2be96918c89e54da15ce399f774a1938ab07f3db'],1,7,8,1863139,1,1,1,1,4331
b4ee37b6d850baa0803deb39652e6f4ff6d665e7,0,Sidharth Mishra,2021-11-15 11:21:51-08:00,['10a7c76c8e07a60c65109391e76970714f2122e2'],20,643,663,1863802,6,0.066326531,0.767857143,0.584183673,4332
dd0f137e80fce60bc7a9639985c540effe18b195,0,Pinal Shah,2021-11-16 10:00:47+05:18,['b4ee37b6d850baa0803deb39652e6f4ff6d665e7'],2,2,4,1863806,2,,,,4332
7211f4724fe827ebec1a6c1891a9b46b72f3553f,0,Sidharth Mishra,2021-11-16 15:27:23-08:00,['dd0f137e80fce60bc7a9639985c540effe18b195'],3,3,6,1863812,1,,,,4332
dd2722599da8edd9ce22c8ba5153a15decfee230,0,Sidharth Mishra,2021-11-17 11:00:43-08:00,['7211f4724fe827ebec1a6c1891a9b46b72f3553f'],0,1,1,1863813,1,1,1,1,4332
14e81aa648a950043ec09d4221c1f8551d50860c,0,Sidharth Mishra,2021-11-18 15:32:16-08:00,['dd2722599da8edd9ce22c8ba5153a15decfee230'],7,11,18,1863831,1,0,0.25,1,4332
b7809ab39868af4d9446fa64a14422ee5609066c,0,Pinal Shah,2021-11-24 18:59:22+05:18,['14e81aa648a950043ec09d4221c1f8551d50860c'],1,2,3,1863834,1,,,,4332
1db78435f48f2f2f6cff5d1daf1fd8d3deea3068,0,Pinal Shah,2021-12-01 10:13:09+05:18,['b7809ab39868af4d9446fa64a14422ee5609066c'],69,161,230,1864064,2,0.826086957,0.847826087,0.913043478,4332
a4ee6c05ad6e8759cf2945024684bfbd1e7af8e1,0,Sarath Subramanian,2021-12-02 10:11:12-08:00,['1db78435f48f2f2f6cff5d1daf1fd8d3deea3068'],19,1001,1020,1865084,13,0.462890625,0.96875,0.73828125,4335
bc2e13cd119663f3e827fb05e4a5d5d25026b411,0,Sarath Subramanian,2021-12-02 10:11:38-08:00,['a4ee6c05ad6e8759cf2945024684bfbd1e7af8e1'],4,38624,38628,1903712,20,0.623053164,0.793717553,0.969573503,4345
2543b19b6efc85b5a92b3e3474898b7d9f0075b1,0,Pinal Shah,2021-12-06 16:22:35+05:18,['bc2e13cd119663f3e827fb05e4a5d5d25026b411'],0,322,322,1904034,8,0.777777778,0.790123457,0.851851852,4349
2df43c237c5a6f95b3cbe5004088bf41d6d49ff3,0,Pinal Shah,2021-12-07 14:34:40+05:18,['2543b19b6efc85b5a92b3e3474898b7d9f0075b1'],4,4,8,1904042,1,,,,4349
c53c1095c5895e086a9f0366225932b825ef37b9,0,Pinal Shah,2021-12-07 14:38:10+05:18,['2df43c237c5a6f95b3cbe5004088bf41d6d49ff3'],1,1,2,1904044,1,,,,4349
11ed7f75c0473f2b8265db425400b749882d8ce4,0,Sidharth Mishra,2021-12-09 17:47:55-08:00,['c53c1095c5895e086a9f0366225932b825ef37b9'],6,45,51,1904095,3,0,1,0.954545455,4349
c90b4568e8854fcfbf2fda6453ad6fd0610b559a,0,Ada Wong,2021-12-11 00:04:49+08:00,['11ed7f75c0473f2b8265db425400b749882d8ce4'],1,1,2,1904097,1,,,,4349
9383be7e94d64d514372b270a1c2e79d27dc5a75,0,GitHub,2021-12-11 14:59:13-08:00,"['11ed7f75c0473f2b8265db425400b749882d8ce4', 'c90b4568e8854fcfbf2fda6453ad6fd0610b559a']",1,1,2,1904099,1,,,,4349
35627e5b191d6697b6fee6422067734620b78dad,0,Sidharth Mishra,2021-12-15 14:30:01-08:00,['9383be7e94d64d514372b270a1c2e79d27dc5a75'],4,72,76,1904175,4,,,,4349
8e5dbabd1b06e0d8e1594e456fe112e7514ee1d1,0,Pinal Shah,2021-12-18 11:16:09+05:18,['35627e5b191d6697b6fee6422067734620b78dad'],2,2,4,1904179,2,,,,4349
4226d82d860374681cd8657dcda5a856380b9bad,0,Pinal Shah,2022-01-04 16:04:13+05:18,['8e5dbabd1b06e0d8e1594e456fe112e7514ee1d1'],1,3,4,1904183,1,0,0,1,4349
8b4ca740acf2b8e67dc89966fe4734b4c5d56b51,0,Sidharth Mishra,2022-01-04 11:09:39-08:00,['4226d82d860374681cd8657dcda5a856380b9bad'],5,5,10,1904193,1,,,,4349
2eb180ca60d900f5fa3c00915a8d72666b5c55b4,0,Pinal Shah,2022-01-05 10:15:09+05:18,['8b4ca740acf2b8e67dc89966fe4734b4c5d56b51'],2,24,26,1904219,4,0.761904762,0.857142857,1,4349
f10c8482bd41da0acb514114068fcc014d39d242,0,Pinal Shah,2022-01-10 20:56:47+05:18,['2eb180ca60d900f5fa3c00915a8d72666b5c55b4'],4,4,8,1904227,1,,,,4349
be824ba8c567ca9f307dbc6ea2534b0751d5369d,0,Madhan Neethiraj,2022-01-10 19:50:27-08:00,['f10c8482bd41da0acb514114068fcc014d39d242'],11,4,15,1904242,2,1,1,0,4349
fdb3ab85b695e119970db277ca2dbdec4d0f5e16,0,Pinal Shah,2022-01-12 16:24:45+05:18,['be824ba8c567ca9f307dbc6ea2534b0751d5369d'],12,46,58,1904300,6,0,1,1,4349
c0f318f18ff621a4fe88fd49f3d2fad8468d2de4,0,Pinal Shah,2022-01-12 17:50:18+05:18,['fdb3ab85b695e119970db277ca2dbdec4d0f5e16'],28,2199,2227,1906527,26,0.766016713,0.821727019,0.844011142,4359
eb38d8f34715728e1859c0d7d5e11403c92885c5,0,Pinal Shah,2022-01-13 09:47:28+05:18,['c0f318f18ff621a4fe88fd49f3d2fad8468d2de4'],4,4,8,1906535,3,,,,4359
1b0dff89e26ff06f7b14456369975fe696f05ebc,0,Sarath Subramanian,2022-01-19 21:38:22-08:00,['eb38d8f34715728e1859c0d7d5e11403c92885c5'],8,90,98,1906633,7,0.018181818,0.854545455,0.872727273,4359
224f6ade1e438b930432fa1b461332f72dc4ca3c,0,Pinal Shah,2022-01-20 12:28:52+05:18,['1b0dff89e26ff06f7b14456369975fe696f05ebc'],2,2,4,1906637,2,,,,4359
fd55c6fe2695c62338c0cfa751d1e019a523e81f,0,Sarath Subramanian,2022-01-24 11:50:34-08:00,['224f6ade1e438b930432fa1b461332f72dc4ca3c'],1,2,3,1906640,1,,,,4359
e1aa485dd44d0258a6077a713e19940e203f8c8f,0,Madhan Neethiraj,2022-01-25 08:32:31-08:00,['fd55c6fe2695c62338c0cfa751d1e019a523e81f'],1,1,2,1906642,1,,,,4359
23aacc831ca82178ecb4b26c4e373fb59c3dcbff,0,Pinal Shah,2022-01-31 18:56:24+05:18,['e1aa485dd44d0258a6077a713e19940e203f8c8f'],1,1,2,1906644,1,,,,4359
27f31c35121cbbfccc36de0c1974c95c00ebf2cd,0,Pinal Shah,2022-02-01 10:57:45+05:18,['23aacc831ca82178ecb4b26c4e373fb59c3dcbff'],2,14,16,1906660,2,0,0,1,4359
fb4d43a50fe9acf30f379fda46dfe7e2e0fb4a24,0,Pinal Shah,2022-02-01 10:58:56+05:18,['27f31c35121cbbfccc36de0c1974c95c00ebf2cd'],1,17,18,1906678,3,1,1,1,4359
4387d9795b60bfa0a01f81ba208030dadc9430bf,0,Pinal Shah,2022-02-02 15:05:24+05:18,['fb4d43a50fe9acf30f379fda46dfe7e2e0fb4a24'],7,7,14,1906692,2,,,,4359
362f6c1b61247492367af1e5627960588bcc204b,0,Sidharth Mishra,2022-02-02 14:18:30-08:00,['4387d9795b60bfa0a01f81ba208030dadc9430bf'],2,2,4,1906696,1,,,,4359
e1726d6cb85aa5821176a149d7b9aa9d4abb4df3,1,Pinal Shah,2022-02-03 10:32:32+05:18,['362f6c1b61247492367af1e5627960588bcc204b'],30,204,234,1906930,6,0.582417582,0.417582418,0.835164835,4359
8543adb69d57584f8c1ca6401410df04867f34fb,0,Sidharth Mishra,2022-02-03 15:23:16-08:00,['e1726d6cb85aa5821176a149d7b9aa9d4abb4df3'],34,50,84,1907014,1,0,0,0,4359
1c0ab9c93705bd7c302f1404794d0e798d1e9582,1,Sidharth Mishra,2022-02-03 21:18:59-08:00,['8543adb69d57584f8c1ca6401410df04867f34fb'],8,38,46,1907060,5,0,0.611111111,0.777777778,4359
5374b38f5551314205380ede28b730e33256ff23,0,Pinal Shah,2022-02-08 16:57:00+05:18,['1c0ab9c93705bd7c302f1404794d0e798d1e9582'],44,743,787,1907847,13,0.559585492,0.823834197,0.875647668,4365
7290ffbe9a2390464dc45fed633f15b051a9d64f,0,Radhika Kundam,2022-02-08 10:41:53-08:00,['5374b38f5551314205380ede28b730e33256ff23'],0,11,11,1907858,1,,,,4365
e49eb7ba2420e36c03db90cc8470fa6d5f26f550,0,Madhan Neethiraj,2022-02-09 23:17:32-08:00,['7290ffbe9a2390464dc45fed633f15b051a9d64f'],0,8,8,1907866,7,,,,4365
0847d6c371a4482924ff642b525c633d7e0f5e6a,0,Madhan Neethiraj,2022-02-16 10:02:52-08:00,['e49eb7ba2420e36c03db90cc8470fa6d5f26f550'],10,1355,1365,1909231,5,0.199191102,0.303336704,0.602628918,4366
05b27be8b8bccddc2c2d0c4d11dca2c97bd7ee8d,0,Pinal Shah,2022-02-17 10:12:40+05:18,['0847d6c371a4482924ff642b525c633d7e0f5e6a'],1,6,7,1909238,1,1,1,1,4366
e1b832cba15f81fe6544c642285f89fc8d9abcfd,0,Pinal Shah,2022-02-23 16:14:58+05:18,['05b27be8b8bccddc2c2d0c4d11dca2c97bd7ee8d'],18,56,74,1909312,2,0.571428571,0.571428571,0.571428571,4366
f12b0cde76b9c17080f12a5be59e7ce8ee4dc881,0,radhikakundam,2022-03-08 10:20:34-08:00,['e1b832cba15f81fe6544c642285f89fc8d9abcfd'],27,51,78,1909390,6,0,0.944444444,1,4366
6dad2f6f35c97cb3fee82c5aee7aa932325e688a,0,radhikakundam,2022-03-08 11:32:37-08:00,['f12b0cde76b9c17080f12a5be59e7ce8ee4dc881'],2,12,14,1909404,1,1,1,1,4366
ceb7f393e1fcd6032362ab78c86e7444fab4fc03,0,Pinal Shah,2022-03-21 09:39:39+05:18,['6dad2f6f35c97cb3fee82c5aee7aa932325e688a'],14,15,29,1909433,2,1,1,1,4366
7360c2064dddda9e83bb67c7ccc8cc065b715692,0,Pinal Shah,2022-03-23 09:59:18+05:18,['ceb7f393e1fcd6032362ab78c86e7444fab4fc03'],72,210,282,1909715,10,0.5,0.954545455,1,4366
a927f4740ed667c2e917e1baa8bb0849d6baea8a,0,Pinal Shah,2022-04-07 14:48:02+05:18,['7360c2064dddda9e83bb67c7ccc8cc065b715692'],1,1,2,1909717,1,,,,4366
6a9c072b8eab148bfc76dc957a68d256707424b2,0,Pinal Shah,2022-04-11 12:17:30+05:18,['a927f4740ed667c2e917e1baa8bb0849d6baea8a'],18,12,30,1909747,4,1,0.595041322,0.983471074,4366
13805035c2644c6e9122ccea9aef9fc43c1444eb,0,Pinal Shah,2022-04-11 16:33:10+05:18,['6a9c072b8eab148bfc76dc957a68d256707424b2'],1,1,2,1909749,1,,,,4366
742eeba4021d1f9972e8bf572693474fd8d7b367,0,Pinal Shah,2022-04-12 12:30:08+05:18,['13805035c2644c6e9122ccea9aef9fc43c1444eb'],7,71,78,1909827,3,0,1,1,4366
cc47aca6cf9a7e05c9e81ab218a077f40af8d9fe,0,Madhan Neethiraj,2022-04-25 12:10:33-07:00,['742eeba4021d1f9972e8bf572693474fd8d7b367'],1,1,2,1909829,1,,,,4366
e95753f64aa26817c648726c307413d69730ff10,1,Madhan Neethiraj,2022-04-25 12:16:59-07:00,['cc47aca6cf9a7e05c9e81ab218a077f40af8d9fe'],1,1,2,1909831,1,,,,4366
05716dc76a009e789177bc2b9419a7811c61a3f2,0,Madhan Neethiraj,2022-04-25 12:17:10-07:00,['e95753f64aa26817c648726c307413d69730ff10'],1,1,2,1909833,1,,,,4366
59480f3829b04d50a00fb62d763bb8438a2d433c,0,Pinal Shah,2022-04-26 16:17:54+05:18,['05716dc76a009e789177bc2b9419a7811c61a3f2'],2,4,6,1909839,4,,,,4366
09a8282fa2578ddb71c300ec5853a00fceb1af0c,0,Pinal Shah,2022-04-27 19:28:09+05:18,['59480f3829b04d50a00fb62d763bb8438a2d433c'],1,1,2,1909841,1,,,,4366
7ef1b45c978b55bdf792fa5ab3e747858a395047,0,Pinal Shah,2022-04-28 13:12:27+05:18,['09a8282fa2578ddb71c300ec5853a00fceb1af0c'],12,40,52,1909893,4,0.904761905,0.952380952,0.333333333,4366
719dcb2e7467282155d453bc12a5a29fdadbc138,0,Pinal Shah,2022-05-05 17:30:14+05:18,['7ef1b45c978b55bdf792fa5ab3e747858a395047'],0,4,4,1909897,1,0,0,0,4366
5bddf56a2b719adca5a43ce8ce307efaa6e023e8,0,radhikakundam,2022-06-01 16:22:44-07:00,['719dcb2e7467282155d453bc12a5a29fdadbc138'],0,4,4,1909901,1,0,0,0,4366
12438ff2a20c382307cc375478740e7108cd6a74,0,Pinal Shah,2022-06-07 11:22:10+05:18,['5bddf56a2b719adca5a43ce8ce307efaa6e023e8'],2,10,12,1909913,3,0.428571429,0,0.428571429,4366
065a004e53776c8507d6aa87c927b899f69f6b47,0,Pinal Shah,2022-06-10 10:13:08+05:18,['12438ff2a20c382307cc375478740e7108cd6a74'],1,1,2,1909915,1,,,,4366
bc49b631e9eb4f8e31feadb4b375b23a49aa9bdd,0,Pinal Shah,2022-06-15 19:46:53+05:18,['065a004e53776c8507d6aa87c927b899f69f6b47'],1,1,2,1909917,1,,,,4366
eaa6d1645e0f2215d9f210336d4be283f2bed05b,0,Pinal Shah,2022-06-15 20:51:50+05:18,['bc49b631e9eb4f8e31feadb4b375b23a49aa9bdd'],13,12,25,1909942,3,1,1,0,4366
bad730c76de50ae9b4682b1c0a357d70edccbcc9,0,Pinal Shah,2022-06-15 20:58:56+05:18,['eaa6d1645e0f2215d9f210336d4be283f2bed05b'],0,41,41,1909983,2,0.321428571,0.964285714,1,4366
15fc887065da0b673049065178a8b23ad11cbf63,0,Pinal Shah,2022-06-17 12:23:10+05:18,['bad730c76de50ae9b4682b1c0a357d70edccbcc9'],1,1,2,1909985,1,,,,4366
3415913d252597c24c6b5d19d315375a49e64152,0,Madhan Neethiraj,2022-06-17 13:20:05-07:00,['15fc887065da0b673049065178a8b23ad11cbf63'],8,59,67,1910052,2,1,1,1,4366
ff52f9c7c97f94e060e8362d68d992c0609b8811,0,Pinal Shah,2022-06-24 14:53:43+05:18,['3415913d252597c24c6b5d19d315375a49e64152'],1,1,2,1910054,1,,,,4366
307a3044faf52c3e6b9526994da1b1e0ab9cab2f,0,Pinal Shah,2022-07-07 13:25:35+05:18,['ff52f9c7c97f94e060e8362d68d992c0609b8811'],1,248,249,1910303,3,0.251908397,0.251908397,1,4367
e5e63c150e6f656bd261aed69dc3c47fbd4cdda3,0,Pinal Shah,2022-07-14 11:13:29+05:18,['307a3044faf52c3e6b9526994da1b1e0ab9cab2f'],1,33,34,1910337,2,0,1,1,4367
bc41d132556dbb6dd7597ce92a130a01a503f2ee,0,Pinal Shah,2022-07-14 11:17:54+05:18,['e5e63c150e6f656bd261aed69dc3c47fbd4cdda3'],101,101,202,1910539,33,,,,4367
e156bb56756aaa6ed23af41c4305b3f9d4bb5912,1,Madhan Neethiraj,2022-07-20 17:38:31-07:00,['bc41d132556dbb6dd7597ce92a130a01a503f2ee'],1,14,15,1910554,3,0.8,1,1,4367
2949b11627bc42dd32dc08737a970c31f0070c33,0,Madhan Neethiraj,2022-07-20 21:14:19-07:00,['e156bb56756aaa6ed23af41c4305b3f9d4bb5912'],3,3,6,1910560,1,,,,4367
218dd81db9f3ea87f75833bee6acee1c70e2b1df,0,Madhan Neethiraj,2022-07-20 21:20:33-07:00,['2949b11627bc42dd32dc08737a970c31f0070c33'],19,29,48,1910608,3,0.6,1,1,4367
7ba5f191c5701f6fa850d18895951df6d20ab812,0,radhikakundam,2022-07-27 23:01:12-07:00,['218dd81db9f3ea87f75833bee6acee1c70e2b1df'],34,716,750,1911358,13,0.477941176,0.644607843,0.691176471,4368
6a1f2ef5c1cdcbc001c6ea74f5cbcfdf9c98f448,0,Pinal Shah,2022-07-28 13:07:34+05:18,['7ba5f191c5701f6fa850d18895951df6d20ab812'],1021,1649,2670,1914028,26,0.451612903,0.725806452,0.975806452,4370
