sha,is_bug,committer_name,commit_time,parents,all_del,all_add,all_change_lines,all_lines,files_change_nums,dmm_unit_size,dmm_unit_complexity,dmm_unit_interfacing,file_nums
81cf991f580a841dd8c016921b6c567ae0c0c4f3,0,Douglass Cutting,2009-04-09 18:13:31+00:00,[],0,0,0,0,0,,,,0
9a0bad0604f93cb5733958532c8cc9dac2b605d7,0,Douglass Cutting,2009-04-09 19:25:42+00:00,['81cf991f580a841dd8c016921b6c567ae0c0c4f3'],0,14676,14676,14676,110,0.462305484,0.555824143,0.610515184,110
22c72f70298ae5b2edd636ddeb363d6d8f750685,0,Douglass Cutting,2009-04-09 19:44:32+00:00,['9a0bad0604f93cb5733958532c8cc9dac2b605d7'],0,136,136,14812,1,0.395833333,0.395833333,1,111
af32499fc9a5b141c80fb72a651d09b49eedcc77,0,Douglass Cutting,2009-04-09 19:47:24+00:00,['22c72f70298ae5b2edd636ddeb363d6d8f750685'],14812,0,14812,29624,111,0.538644825,0.446463142,0.383916605,111
5f34eb05951630323033eb8bdd89703a856e082f,0,Douglass Cutting,2009-04-09 21:01:59+00:00,['af32499fc9a5b141c80fb72a651d09b49eedcc77'],0,0,0,29624,1,,,,112
3b821839ea78784c99848626c495245006e31b30,0,Douglass Cutting,2009-04-09 21:09:25+00:00,['5f34eb05951630323033eb8bdd89703a856e082f'],0,112,112,29736,1,0,0,1,113
5d5df8f9ecfb5a568d13054bea859f075dc32f20,0,Douglass Cutting,2009-04-09 21:12:26+00:00,['3b821839ea78784c99848626c495245006e31b30'],112,0,112,29848,1,1,1,0,113
df459c34d674a40ac6e1dfaef995d47f0f11cf19,0,Douglass Cutting,2009-04-09 21:12:52+00:00,['5d5df8f9ecfb5a568d13054bea859f075dc32f20'],0,112,112,29960,1,0,0,1,114
af64465511bb744ab888859945792372374d988a,0,Douglass Cutting,2009-04-09 21:13:25+00:00,['df459c34d674a40ac6e1dfaef995d47f0f11cf19'],0,136,136,30096,1,0.395833333,0.395833333,1,115
4fc2ebf41689ef79dac5e1286fdc71f70f693d65,0,Douglass Cutting,2009-04-09 21:17:51+00:00,['af64465511bb744ab888859945792372374d988a'],248,0,248,30344,3,0.790055249,0.790055249,0,115
e8a0c370ddd6fb6bb70c0742ad7e864b819c2d08,1,Douglass Cutting,2009-04-09 21:28:53+00:00,['4fc2ebf41689ef79dac5e1286fdc71f70f693d65'],0,14676,14676,45020,110,0.462305484,0.555824143,0.610515184,225
8edb62db76579f58d3713e6dde9345363153d2df,0,Douglass Cutting,2009-04-09 22:06:01+00:00,['e8a0c370ddd6fb6bb70c0742ad7e864b819c2d08'],0,0,0,45020,0,,,,225
e2b3d669da0efd84d73805d0fe11383b049ca3de,0,Douglass Cutting,2009-04-10 23:31:37+00:00,['8edb62db76579f58d3713e6dde9345363153d2df'],42,171,213,45233,4,0.230769231,0.230769231,1,227
fc29ce8b138b408b3ae054c2bfca61cc08c0c232,0,Sharad Agarwal,2009-04-13 08:54:36+00:00,['e2b3d669da0efd84d73805d0fe11383b049ca3de'],0,0,0,45233,0,,,,227
7947e7367bfcbd96851ef986d99ef170ee09c992,1,Douglass Cutting,2009-04-14 21:42:16+00:00,['fc29ce8b138b408b3ae054c2bfca61cc08c0c232'],234,515,749,45982,20,1,0.99009901,0.772277228,227
9b14a2a7da50853d869d0fa0f153c6dbcbd4a2de,0,Douglass Cutting,2009-04-14 22:11:22+00:00,['7947e7367bfcbd96851ef986d99ef170ee09c992'],19,50,69,46051,4,0.210526316,0,1,227
e6d1fca400c0f5627f81f0f673ba06393b8745d0,0,Douglass Cutting,2009-04-14 22:15:14+00:00,['9b14a2a7da50853d869d0fa0f153c6dbcbd4a2de'],0,12,12,46063,3,1,1,1,227
952db93552b995be8af8a9c54f7c4ab8c152a364,1,Douglass Cutting,2009-04-14 22:28:43+00:00,['e6d1fca400c0f5627f81f0f673ba06393b8745d0'],152,50,202,46265,5,0.678571429,0.678571429,0.80952381,227
288a8cfdcf6bbba131fb5414663ad84b4dc35d0a,1,Sharad Agarwal,2009-04-15 05:17:36+00:00,['952db93552b995be8af8a9c54f7c4ab8c152a364'],94,108,202,46467,3,1,1,0.5,227
9bd461944d016a23876a28680c3ec405b8c8ff55,1,Sharad Agarwal,2009-04-15 05:24:09+00:00,['288a8cfdcf6bbba131fb5414663ad84b4dc35d0a'],65,286,351,46818,9,0.727272727,1,0.984848485,228
c201bb7b930d8c5be3e5b5c52a3f51192f9ebb14,1,Douglass Cutting,2009-04-21 19:54:56+00:00,['9bd461944d016a23876a28680c3ec405b8c8ff55'],22,26,48,46866,3,,,,228
55574fe9a59e76e111260d28de09ed1dec04d478,1,Sharad Agarwal,2009-04-22 05:35:47+00:00,['c201bb7b930d8c5be3e5b5c52a3f51192f9ebb14'],3,93,96,46962,4,1,0.631578947,0.407894737,228
5183bd9feb3a288632337de3533d36558248de61,1,Douglass Cutting,2009-04-27 20:13:31+00:00,['55574fe9a59e76e111260d28de09ed1dec04d478'],1719,174,1893,48855,20,0.162721893,0.115384615,0.390532544,228
0abe6d6ae36cc5f9cffd9047ed76baf13f2d0ca1,0,Douglass Cutting,2009-04-27 20:13:41+00:00,['5183bd9feb3a288632337de3533d36558248de61'],0,3,3,48858,1,,,,228
87f3bff4097e2782e8ebd6b3446ed5192f7e3934,1,Douglass Cutting,2009-04-27 20:18:06+00:00,['0abe6d6ae36cc5f9cffd9047ed76baf13f2d0ca1'],105,77,182,49040,15,0.321428571,0.321428571,0.285714286,228
75b5c9a86bf1d342b848ecd629d244f2942c904c,0,Douglass Cutting,2009-04-28 16:16:52+00:00,['87f3bff4097e2782e8ebd6b3446ed5192f7e3934'],1,1,2,49042,1,,,,228
d1a9521495c8ca1ed7f6e6f3437ae7e5a58f1b72,1,Douglass Cutting,2009-05-11 18:19:46+00:00,['75b5c9a86bf1d342b848ecd629d244f2942c904c'],44,197,241,49283,8,0.37,0.39,0.33,228
20633ecbe5bb3787857494b8476f612c7f7fddcb,1,Douglass Cutting,2009-05-12 19:41:18+00:00,['d1a9521495c8ca1ed7f6e6f3437ae7e5a58f1b72'],29,83,112,49395,2,,,,228
32a1fcb5682049aacfbd06c32b630f166c23f643,0,Douglass Cutting,2009-05-13 17:17:25+00:00,['20633ecbe5bb3787857494b8476f612c7f7fddcb'],7,18,25,49420,7,1,1,1,228
94335e391efff84c65e2d9f7bfd57c2e9f34c9e4,1,Douglass Cutting,2009-05-13 17:51:40+00:00,['32a1fcb5682049aacfbd06c32b630f166c23f643'],31,58,89,49509,3,1,0.571428571,0.857142857,228
13ba975ab15341d7ecda31b2e8870d68084828e8,1,Douglass Cutting,2009-05-14 21:15:10+00:00,['94335e391efff84c65e2d9f7bfd57c2e9f34c9e4'],4,1816,1820,51329,30,0.226939971,0.449487555,0.749633968,255
ff6e70c84c24f4c0e86dbaa3b4fc969d5660f6da,1,Douglass Cutting,2009-05-18 18:36:55+00:00,['13ba975ab15341d7ecda31b2e8870d68084828e8'],175,343,518,51847,18,1,1,1,259
f42255b1f8bbf661680383677e70135fd6ac8f2a,1,Douglass Cutting,2009-05-19 23:35:39+00:00,['ff6e70c84c24f4c0e86dbaa3b4fc969d5660f6da'],53,1809,1862,53709,27,0.581967213,0.693442623,0.626229508,260
b061e6203def8a518b23fc8863126b0b3d43002b,0,Douglass Cutting,2009-05-20 20:25:14+00:00,['f42255b1f8bbf661680383677e70135fd6ac8f2a'],20,0,20,53729,1,0,0,0,260
70ffe34fe20ea9b6a85995b29b6d1a8c25a43a83,1,Douglass Cutting,2009-05-22 17:48:18+00:00,['b061e6203def8a518b23fc8863126b0b3d43002b'],28,294,322,54051,21,0.52892562,0.545454545,0.67768595,264
998a811d2a0506a34aeb3f9bdb263cf2d89979fb,1,Douglass Cutting,2009-05-22 19:29:08+00:00,['70ffe34fe20ea9b6a85995b29b6d1a8c25a43a83'],34,36,70,54121,8,,,,266
513251ce736834d9507cd41ceb4cb73af9de0cd1,1,Douglass Cutting,2009-05-22 19:36:27+00:00,['998a811d2a0506a34aeb3f9bdb263cf2d89979fb'],2,3,5,54126,1,,,,266
2b7ea9cc6054a9408457fdd01a5a82181144c992,1,Douglass Cutting,2009-05-22 20:45:01+00:00,['513251ce736834d9507cd41ceb4cb73af9de0cd1'],2,56,58,54184,3,0.6,0.6,1,266
ac3528e555e4d896d275f9213c755ace0f549a15,1,Douglass Cutting,2009-05-22 21:31:32+00:00,['2b7ea9cc6054a9408457fdd01a5a82181144c992'],9,16,25,54209,4,0.5,0.5,0.75,266
dc20712f258623f6d9d8977f2a8f9100c279e5f1,1,Douglass Cutting,2009-05-26 17:38:46+00:00,['ac3528e555e4d896d275f9213c755ace0f549a15'],80,151,231,54440,10,0.811320755,1,0.716981132,266
60dabd6f9cae2a62554e9de8aff904bc07acb9dc,1,Douglass Cutting,2009-05-26 18:02:47+00:00,['dc20712f258623f6d9d8977f2a8f9100c279e5f1'],31,332,363,54803,12,0.294117647,0.596638655,0.033613445,268
c4c9689155ae22f1cab7f9f9bb9f23abbd807fac,0,Douglass Cutting,2009-05-27 16:06:45+00:00,['60dabd6f9cae2a62554e9de8aff904bc07acb9dc'],1,4,5,54808,3,1,1,0,268
c5aa64581b100d2e7d6ab7ab4e29734551f3c1ce,0,Douglass Cutting,2009-06-01 22:32:52+00:00,['c4c9689155ae22f1cab7f9f9bb9f23abbd807fac'],2,5,7,54815,2,,,,268
f806cb0b94a073c667debbcf54fc91d21ee85ccc,1,Douglass Cutting,2009-06-02 17:40:30+00:00,['c5aa64581b100d2e7d6ab7ab4e29734551f3c1ce'],2,114,116,54931,5,0.487804878,0.536585366,0.951219512,270
5e4733ecf7b1102772af70a2255924c3903653c0,1,Douglass Cutting,2009-06-02 19:02:36+00:00,['f806cb0b94a073c667debbcf54fc91d21ee85ccc'],212,457,669,55600,25,0.201923077,0.432692308,0.721153846,273
11c84aeb7b115b0108b193f1bbc7f8beec41e91b,1,Douglass Cutting,2009-06-03 00:00:48+00:00,['5e4733ecf7b1102772af70a2255924c3903653c0'],0,5940,5940,61540,54,0.630960608,0.920525225,1,327
111ac06544ec45b8f2b17f224e0b6b4b15a0219e,1,Douglass Cutting,2009-06-03 00:08:29+00:00,['11c84aeb7b115b0108b193f1bbc7f8beec41e91b'],3,6,9,61549,2,,,,327
c787721da830d7fc22cc49da4843f60685231b2d,1,Douglass Cutting,2009-06-03 00:10:50+00:00,['111ac06544ec45b8f2b17f224e0b6b4b15a0219e'],1,8,9,61558,2,,,,327
0282ee3550dd4d7c3ea05ad816a16c1bb125005c,0,Douglass Cutting,2009-06-03 17:43:58+00:00,['c787721da830d7fc22cc49da4843f60685231b2d'],2,11,13,61571,3,,,,327
8204eee49c1be262c2078dcb1404e8dc7be71bf3,1,Douglass Cutting,2009-06-05 18:31:45+00:00,['0282ee3550dd4d7c3ea05ad816a16c1bb125005c'],339,2030,2369,63940,19,0.526927138,0.740232313,0.781414995,329
bd8c9502c42ccfbeba3b82958d1571a861b6e7b0,0,Douglass Cutting,2009-06-08 20:09:06+00:00,['8204eee49c1be262c2078dcb1404e8dc7be71bf3'],0,0,0,63940,2,,,,329
7fd4f2c44cf7de14271c1ed5a20e534f66e6ab79,0,Douglass Cutting,2009-06-08 21:54:17+00:00,['bd8c9502c42ccfbeba3b82958d1571a861b6e7b0'],108,73,181,64121,26,1,0.5,0,329
8a714f4aeb5c723c6aafb98714bed027cddf8749,1,Sharad Agarwal,2009-06-15 05:38:20+00:00,['7fd4f2c44cf7de14271c1ed5a20e534f66e6ab79'],1,4,5,64126,2,,,,329
dfadedf21488a9f068367ca9ee36a12ba7e6f3ad,1,Douglass Cutting,2009-06-17 20:14:24+00:00,['8a714f4aeb5c723c6aafb98714bed027cddf8749'],9,75,84,64210,13,,,,330
774c3a041f810fe54a6ed47a02fc409cb713c0c5,0,Douglass Cutting,2009-06-18 20:11:04+00:00,['dfadedf21488a9f068367ca9ee36a12ba7e6f3ad'],2,3,5,64215,2,,,,330
40f9f941d3f9821d6f47c07a905dc5bdf0496955,1,Douglass Cutting,2009-06-19 20:46:04+00:00,['774c3a041f810fe54a6ed47a02fc409cb713c0c5'],112,162,274,64489,3,1,1,1,330
7a6f8469d096f6ff6c496df2e48365c772af9ce1,0,Douglass Cutting,2009-06-23 20:17:22+00:00,['40f9f941d3f9821d6f47c07a905dc5bdf0496955'],5,6405,6410,70899,38,0.148219442,0.215110683,0.762512031,363
33037ded0106608d9485934ba2ad21a1fe31df59,0,Douglass Cutting,2009-06-23 20:29:29+00:00,['7a6f8469d096f6ff6c496df2e48365c772af9ce1'],4,9,13,70912,4,0.5,0.5,0.5,363
842690ea2a8203b7d3a313a53feb761ec9d68383,1,Douglass Cutting,2009-06-23 20:38:46+00:00,['33037ded0106608d9485934ba2ad21a1fe31df59'],508,746,1254,72166,23,,,,365
98eb9203b65eb452bd2a1ff3559ccbca6f97f670,1,Douglass Cutting,2009-06-25 18:12:00+00:00,['842690ea2a8203b7d3a313a53feb761ec9d68383'],332,493,825,72991,14,0.220588235,0.191176471,0.941176471,367
345ff7eddf9c23302803157ae89b1301e47c80df,1,Douglass Cutting,2009-06-25 18:53:16+00:00,['98eb9203b65eb452bd2a1ff3559ccbca6f97f670'],195,3957,4152,77143,16,0.438148789,0.695069204,0.692041522,377
b2869cccb9627e3ff5c8f65a837129783707dd2e,1,Douglass Cutting,2009-06-25 19:12:45+00:00,['345ff7eddf9c23302803157ae89b1301e47c80df'],364,365,729,77872,15,0,0,0,380
df176b7a1fc65be86c7be47c8a3cd56c2d31d1cf,1,Douglass Cutting,2009-06-25 19:33:11+00:00,['b2869cccb9627e3ff5c8f65a837129783707dd2e'],91,169,260,78132,1,0,0,1,380
1b21659a1955b679532776854ecb1db9a0fb668f,0,Douglass Cutting,2009-06-30 21:46:26+00:00,['df176b7a1fc65be86c7be47c8a3cd56c2d31d1cf'],2,9,11,78143,2,,,,380
fe6629997fd57d96748e83001e12a371c737f62b,1,Douglass Cutting,2009-07-01 16:53:37+00:00,['1b21659a1955b679532776854ecb1db9a0fb668f'],92,331,423,78566,10,0.468292683,0.536585366,0.112195122,380
8120af19115d00d57d1ce1d29ef7d51443f2589f,0,Douglass Cutting,2009-07-01 21:02:13+00:00,['fe6629997fd57d96748e83001e12a371c737f62b'],0,39,39,78605,4,0,0,0.769230769,380
c1f86d23010746ef0821781a7236adedd2d6279e,1,Douglass Cutting,2009-07-01 22:01:00+00:00,['8120af19115d00d57d1ce1d29ef7d51443f2589f'],63,15,78,78683,6,,,,380
253247088f347695486d5c45c541ad22a23ed39a,1,Douglass Cutting,2009-07-02 20:50:41+00:00,['c1f86d23010746ef0821781a7236adedd2d6279e'],0,5,5,78688,1,,,,381
3727a55f345e638f7980a19841c108f67498e79d,0,Douglass Cutting,2009-07-02 22:39:58+00:00,['253247088f347695486d5c45c541ad22a23ed39a'],0,1150,1150,79838,10,,,,391
81fee7a09d854e760ecff4e0fb3bddf1b4ab910b,0,Douglass Cutting,2009-07-02 22:55:34+00:00,['3727a55f345e638f7980a19841c108f67498e79d'],0,134,134,79972,8,,,,391
63eb29883e0dfc6f80994775b94eda1e61332c83,0,Douglass Cutting,2009-07-02 23:09:11+00:00,['81fee7a09d854e760ecff4e0fb3bddf1b4ab910b'],0,629,629,80601,37,,,,391
5a34ebef52a77c087ffbc235424478b265ab2403,0,Douglass Cutting,2009-07-02 23:17:00+00:00,['63eb29883e0dfc6f80994775b94eda1e61332c83'],2,2,4,80605,1,0,0,1,391
8e9674a1b88b8c84d558534189dc10acea84bb15,1,Douglass Cutting,2009-07-03 04:34:31+00:00,['5a34ebef52a77c087ffbc235424478b265ab2403'],59,507,566,81171,29,0,0,1,391
f7cc40a6c6f5d4e9eeb28e8c95bcb57ff66e12cf,1,Douglass Cutting,2009-07-04 16:27:15+00:00,['8e9674a1b88b8c84d558534189dc10acea84bb15'],0,3,3,81174,2,,,,391
db7edf99495b95397c87afeb422931a40940ff9a,0,Douglass Cutting,2009-07-04 16:30:08+00:00,['f7cc40a6c6f5d4e9eeb28e8c95bcb57ff66e12cf'],2,18,20,81194,2,,,,391
ffe3481808405433362a0377354aec6d553e3f5c,0,Douglass Cutting,2009-07-04 17:03:03+00:00,['db7edf99495b95397c87afeb422931a40940ff9a'],0,54,54,81248,4,,,,391
55bd090ba3447e96c69416ab314718f67f0fe2db,0,Sharad Agarwal,2009-07-06 11:27:01+00:00,['ffe3481808405433362a0377354aec6d553e3f5c'],1,3,4,81252,2,,,,391
a63515ce5863262afedc1f77d83d43185e86809d,0,Sharad Agarwal,2009-07-07 11:45:48+00:00,['55bd090ba3447e96c69416ab314718f67f0fe2db'],3,8,11,81263,4,1,1,1,391
fff545fef5e06cc1eb970c97970757c8060e3a68,1,Douglass Cutting,2009-07-08 20:32:55+00:00,['a63515ce5863262afedc1f77d83d43185e86809d'],1,1,2,81265,1,,,,391
41d08b5cfd94954f5d663d3a091d0aba5f5e2c87,0,Douglass Cutting,2009-07-09 17:14:51+00:00,['fff545fef5e06cc1eb970c97970757c8060e3a68'],19,32,51,81316,4,0,0,0.333333333,391
eb3b1bbd9c5c1648af42eca6ab33d3db80ea88d7,0,Douglass Cutting,2009-07-14 22:46:48+00:00,['41d08b5cfd94954f5d663d3a091d0aba5f5e2c87'],0,12,12,81328,1,,,,391
86d3ba82a52c921bcf820f580405e06fd3d797cd,1,Douglass Cutting,2009-07-14 22:48:26+00:00,['eb3b1bbd9c5c1648af42eca6ab33d3db80ea88d7'],237,290,527,81855,11,0,0,0,392
86c74fb4b57813378fe2fd71d44dc1f8f7a28056,0,Douglass Cutting,2009-07-14 22:59:22+00:00,['86d3ba82a52c921bcf820f580405e06fd3d797cd'],61,499,560,82415,55,0,0,0.1,429
751a179769ed29c686558cd618a7934754b6691f,1,Douglass Cutting,2009-07-16 20:34:13+00:00,['86c74fb4b57813378fe2fd71d44dc1f8f7a28056'],19,72,91,82506,5,0.538461538,0.692307692,1,429
e6715a6d0792cca5fb0fd6961d565fa869795433,0,Douglass Cutting,2009-07-18 04:18:20+00:00,['751a179769ed29c686558cd618a7934754b6691f'],4,5,9,82515,3,,,,429
e2e7fd906abe882be5d9ffa6f8ce0ef9025f7107,0,Douglass Cutting,2009-07-20 21:03:52+00:00,['e6715a6d0792cca5fb0fd6961d565fa869795433'],1,5,6,82521,3,,,,429
0039f146bd31549fee2b80119a3c977a5072a5d5,1,Douglass Cutting,2009-07-22 20:20:55+00:00,['e2e7fd906abe882be5d9ffa6f8ce0ef9025f7107'],2360,2781,5141,87662,27,1,1,1,440
f352f56536e1855bdb97208b23f65c659eed3b69,1,Douglass Cutting,2009-07-28 18:44:51+00:00,['0039f146bd31549fee2b80119a3c977a5072a5d5'],270,231,501,88163,66,0,0,0,441
f03f432cc7d71b7969d56f9dc17ca264a3771650,1,Douglass Cutting,2009-07-28 20:54:14+00:00,['f352f56536e1855bdb97208b23f65c659eed3b69'],6,3,9,88172,2,,,,441
2034a4ee5bc4fd9623797590e1dbb411e4848787,1,Douglass Cutting,2009-07-28 21:54:34+00:00,['f03f432cc7d71b7969d56f9dc17ca264a3771650'],389,340,729,88901,18,0,1,1,442
eeb1023f9630a576bf8ea2d5b0e485f565e90e42,1,Douglass Cutting,2009-07-31 20:12:33+00:00,['2034a4ee5bc4fd9623797590e1dbb411e4848787'],22,46,68,88969,2,,,,442
62806bad9162f22afe69f01e97ea96321d83710a,1,Douglass Cutting,2009-07-31 22:56:28+00:00,['eeb1023f9630a576bf8ea2d5b0e485f565e90e42'],16,659,675,89644,13,0.837301587,0.773809524,0.976190476,448
127800a158ce6d6af08e5b32e01e153ade03d474,1,Douglass Cutting,2009-07-31 22:58:53+00:00,['62806bad9162f22afe69f01e97ea96321d83710a'],1,1,2,89646,1,,,,448
79d571847ca673a23733377fdfd9a489017c499c,1,Douglass Cutting,2009-08-12 16:39:20+00:00,['127800a158ce6d6af08e5b32e01e153ade03d474'],13,35,48,89694,10,,,,448
a02c72575832bd9a451bd6d8fed62c7818eac611,1,Douglass Cutting,2009-08-12 22:35:00+00:00,['79d571847ca673a23733377fdfd9a489017c499c'],1,15,16,89710,2,1,0,1,448
e1d53e342f55f7ee51b8f4b04fc03aaa287712dd,1,Douglass Cutting,2009-08-18 19:43:46+00:00,['a02c72575832bd9a451bd6d8fed62c7818eac611'],53,73,126,89836,8,0,1,0,448
f736dfd4dd6089d9323cf7290ca7852c9dd045cd,1,Douglass Cutting,2009-08-18 19:58:22+00:00,['e1d53e342f55f7ee51b8f4b04fc03aaa287712dd'],5,238,243,90079,7,0.527272727,1,0.963636364,451
73b69bc59c61294a6689b695342e7f9d6b48db90,0,Douglass Cutting,2009-08-18 20:49:30+00:00,['f736dfd4dd6089d9323cf7290ca7852c9dd045cd'],0,171,171,90250,3,0.169811321,1,0.886792453,452
b9821a460520ea9c7f5bcc6cb35a33c725295f44,1,Douglass Cutting,2009-08-18 21:03:22+00:00,['73b69bc59c61294a6689b695342e7f9d6b48db90'],15,143,158,90408,8,0,0.606060606,0.742424242,453
c529c6d5821d89bfb3f37e2c6bb0ec9b83635899,1,Douglass Cutting,2009-08-18 21:07:08+00:00,['b9821a460520ea9c7f5bcc6cb35a33c725295f44'],14,75,89,90497,11,0,1,1,453
a84db2bc15c8876d40993d29adfe22f8aa9601cd,0,Douglass Cutting,2009-08-18 22:28:59+00:00,['c529c6d5821d89bfb3f37e2c6bb0ec9b83635899'],5,2,7,90504,2,,,,453
a1ea81add49b8684f979988f342193a547795fb0,1,Douglass Cutting,2009-08-18 22:32:22+00:00,['a84db2bc15c8876d40993d29adfe22f8aa9601cd'],1,10,11,90515,2,0,0,1,453
710e2379a2ef1c5c4d2cf6ada9e0dc49795f5c86,0,Douglass Cutting,2009-08-21 22:41:17+00:00,['a1ea81add49b8684f979988f342193a547795fb0'],2,30,32,90547,2,,,,453
97a5793f050400d38b07d4fbab0539809ce579ff,1,Douglass Cutting,2009-08-25 22:52:55+00:00,['710e2379a2ef1c5c4d2cf6ada9e0dc49795f5c86'],41,207,248,90795,9,0.805555556,1,0.703703704,453
acba0fcdc047d14f0a28a88aec0a9b8b0cf524f8,0,Douglass Cutting,2009-08-27 22:24:54+00:00,['97a5793f050400d38b07d4fbab0539809ce579ff'],1,9,10,90805,3,1,0,1,453
f49a465349ae11ffccfffb1ed0693363a8b28a87,1,Douglass Cutting,2009-08-28 16:31:19+00:00,['acba0fcdc047d14f0a28a88aec0a9b8b0cf524f8'],168,227,395,91200,2,,,,453
b062afaea6c4534bea3e2ec1387afb549da72570,1,Douglass Cutting,2009-08-31 18:05:21+00:00,['f49a465349ae11ffccfffb1ed0693363a8b28a87'],0,353,353,91553,3,0.587234043,0.587234043,0.463829787,455
490d0c72dc345c4683e9099e8f2b5244cffb868a,1,Douglass Cutting,2009-09-02 18:10:02+00:00,['b062afaea6c4534bea3e2ec1387afb549da72570'],184,450,634,92187,25,0.458015267,0.717557252,0.290076336,457
c454652c1cd491976b894dc293856c8f73495725,1,Douglass Cutting,2009-09-03 16:22:48+00:00,['490d0c72dc345c4683e9099e8f2b5244cffb868a'],336,745,1081,93268,19,0,0,1,461
b43975aa1e773cd471f5771d7c7faac7a0f73a7c,1,Douglass Cutting,2009-09-03 21:19:46+00:00,['c454652c1cd491976b894dc293856c8f73495725'],109,157,266,93534,7,0,0,1,461
7d83e93e0d50487125d747265d2aa325cdce029d,0,Douglass Cutting,2009-09-04 16:39:51+00:00,['b43975aa1e773cd471f5771d7c7faac7a0f73a7c'],0,67,67,93601,2,,,,461
604f27bc286f17bb8b43c25c1aa3302882c80395,0,Douglass Cutting,2009-09-04 16:59:36+00:00,['7d83e93e0d50487125d747265d2aa325cdce029d'],0,34,34,93635,2,,,,461
d8d90987da6300e3c0a8741dfedc8109fee49da2,1,Douglass Cutting,2009-09-04 17:05:39+00:00,['604f27bc286f17bb8b43c25c1aa3302882c80395'],3,3,6,93641,3,,,,461
14c0ae1564cd6a067abb735c3b4f09ddf200910a,0,Douglass Cutting,2009-09-08 20:21:17+00:00,['d8d90987da6300e3c0a8741dfedc8109fee49da2'],1,3,4,93645,2,,,,461
1dbb683d17f571213a8367d8e1306019063325d3,1,Douglass Cutting,2009-09-11 17:25:21+00:00,['14c0ae1564cd6a067abb735c3b4f09ddf200910a'],5,13,18,93663,3,,,,461
cea9e51cfb33fb2baef302e0e7c1f4bf8f87a9f6,1,Douglass Cutting,2009-09-22 18:34:42+00:00,['1dbb683d17f571213a8367d8e1306019063325d3'],56,72,128,93791,3,0.833333333,0,0,461
fc44dd5d2201fae7208660c0bfb5d4847f452c87,1,Douglass Cutting,2009-09-22 18:47:46+00:00,['cea9e51cfb33fb2baef302e0e7c1f4bf8f87a9f6'],19,11,30,93821,3,1,0,0,461
c7a4f7c2caad4117a71f23ae97cfc10237674be0,1,Douglass Cutting,2009-09-22 18:51:04+00:00,['fc44dd5d2201fae7208660c0bfb5d4847f452c87'],4,114,118,93939,5,,,,462
cad632eb6c894f77cdf40f8c458491aba9677852,1,Douglass Cutting,2009-09-23 22:34:14+00:00,['c7a4f7c2caad4117a71f23ae97cfc10237674be0'],132,331,463,94402,15,0.983050847,1,1,466
0c2a837bb14eab720fef8a25409a8e489897b507,1,Douglass Cutting,2009-09-23 22:37:49+00:00,['cad632eb6c894f77cdf40f8c458491aba9677852'],0,15,15,94417,2,1,1,1,466
86614561e4d1dd43a1e508f169c091e7cc935a4c,0,Douglass Cutting,2009-09-23 22:40:41+00:00,['0c2a837bb14eab720fef8a25409a8e489897b507'],2,32,34,94451,5,,,,466
5661078ce4669dc428f8f59f39aa182666020f38,0,Douglass Cutting,2009-09-24 21:34:06+00:00,['86614561e4d1dd43a1e508f169c091e7cc935a4c'],2,9,11,94462,2,1,1,1,466
7c346f7ae726fd3213a9974752a3c4739469f79b,1,Douglass Cutting,2009-09-24 21:42:08+00:00,['5661078ce4669dc428f8f59f39aa182666020f38'],9,35,44,94506,7,0,1,0.785714286,466
78983ffcfbf719ee6d190c486074c87779c6663f,1,Douglass Cutting,2009-09-24 21:46:21+00:00,['7c346f7ae726fd3213a9974752a3c4739469f79b'],1,7,8,94514,2,,,,466
777d0477c689d2fd9ebfe72dbd4e4dbab705a99f,1,Douglass Cutting,2009-09-25 21:10:53+00:00,['78983ffcfbf719ee6d190c486074c87779c6663f'],356,625,981,95495,27,0.966101695,0.805084746,1,469
e0c27e12a33b282eb0036e8c5c95a338a7977c0c,0,Douglass Cutting,2009-09-25 21:22:47+00:00,['777d0477c689d2fd9ebfe72dbd4e4dbab705a99f'],2,17,19,95514,4,1,1,1,469
b397dd7b6f952bd1d2f34a09127661cee1b3e679,0,Douglass Cutting,2009-09-25 21:47:11+00:00,['e0c27e12a33b282eb0036e8c5c95a338a7977c0c'],2,5,7,95521,2,,,,469
aa7305fcb283a28841eb1f03959c0c1550c187f5,0,Douglass Cutting,2009-09-25 21:54:22+00:00,['b397dd7b6f952bd1d2f34a09127661cee1b3e679'],0,61,61,95582,2,0.459459459,1,1,469
8289fbdb37bb10b52d772327cb124555e1dfb020,1,Douglass Cutting,2009-09-25 22:09:46+00:00,['aa7305fcb283a28841eb1f03959c0c1550c187f5'],1,3,4,95586,2,,,,469
6b2a2265e242307fa50030990bc018bff7a7964a,1,Douglass Cutting,2009-09-30 20:52:22+00:00,['8289fbdb37bb10b52d772327cb124555e1dfb020'],0,237,237,95823,5,0.805825243,1,1,472
4ae97e26c4037a97aca08f05c93a2887285d356e,0,Douglass Cutting,2009-09-30 21:23:05+00:00,['6b2a2265e242307fa50030990bc018bff7a7964a'],160,134,294,96117,6,1,0,0,474
fdd0b8cb52af8256e5691d3065b256a387d17718,1,Douglass Cutting,2009-10-06 17:38:42+00:00,['4ae97e26c4037a97aca08f05c93a2887285d356e'],4,18,22,96139,4,,,,474
2b348c1f4dfe97f755034d57d5336cfd7ab130df,1,Douglass Cutting,2009-10-06 21:32:01+00:00,['fdd0b8cb52af8256e5691d3065b256a387d17718'],1,5,6,96145,2,,,,474
dc0107bc2ed79e4c17b8ddbb178fd14357d47147,0,Douglass Cutting,2009-10-07 18:36:33+00:00,['2b348c1f4dfe97f755034d57d5336cfd7ab130df'],28,80,108,96253,6,0,0,0.615384615,475
35776f85ca9b658fb187a988966c259781759ed7,1,Douglass Cutting,2009-10-07 19:39:32+00:00,['dc0107bc2ed79e4c17b8ddbb178fd14357d47147'],1,8,9,96262,2,,,,475
c1e75de882bf7e9eb669f2d6b8c23330b7c3313e,0,Scott Banachowski,2009-10-08 00:12:44+00:00,['35776f85ca9b658fb187a988966c259781759ed7'],43,34,77,96339,11,,,,475
2af1f70cdad4fb612bc22634ae183bd11e6e96e6,0,Sharad Agarwal,2009-10-09 05:56:03+00:00,['c1e75de882bf7e9eb669f2d6b8c23330b7c3313e'],0,3,3,96342,2,0,1,1,475
844b081141f6e1e42231e9598c167cbf547af488,1,Douglass Cutting,2009-10-09 20:52:47+00:00,['2af1f70cdad4fb612bc22634ae183bd11e6e96e6'],27,73,100,96442,5,1,1,1,476
db971a2ecfa4990f3512afac14acc1fb37248a42,0,Douglass Cutting,2009-10-09 20:54:47+00:00,['844b081141f6e1e42231e9598c167cbf547af488'],0,5,5,96447,4,,,,476
2427f18b729c51eb485f580572086bc782974d4a,1,Douglass Cutting,2009-10-09 21:11:29+00:00,['db971a2ecfa4990f3512afac14acc1fb37248a42'],2,2,4,96451,2,,,,476
a7bfbd4b56d99655062c069e26ab6d476f5f06a0,1,Douglass Cutting,2009-10-14 18:50:49+00:00,['2427f18b729c51eb485f580572086bc782974d4a'],5,30,35,96486,3,1,0,1,476
bc9491c9dcea4035f3fd4733a2c0b649d08398ed,1,Douglass Cutting,2009-10-14 20:46:55+00:00,['a7bfbd4b56d99655062c069e26ab6d476f5f06a0'],113,97,210,96696,26,0.071428571,0.142857143,0,476
7ddc6d64b2f81cc4022ae36aa233f7ce7e191314,1,Scott Banachowski,2009-10-15 15:39:08+00:00,['bc9491c9dcea4035f3fd4733a2c0b649d08398ed'],113,8652,8765,105461,13,1,1,1,483
1999497b9115b71d325e87f66f05dc006a9d0e9b,0,Douglass Cutting,2009-10-15 16:08:55+00:00,['7ddc6d64b2f81cc4022ae36aa233f7ce7e191314'],0,0,0,105461,0,,,,483
b57431769b7b42f8561ef4625ecf80e0d4bd019b,1,Matthew Lee Massie,2009-10-15 18:00:21+00:00,['1999497b9115b71d325e87f66f05dc006a9d0e9b'],1463,3704,5167,110628,133,0.260606061,0.824242424,0.476767677,533
5690cd025ce5c1bcb21b69e4f17bbb65e3db80fb,0,Matthew Lee Massie,2009-10-15 23:41:26+00:00,['b57431769b7b42f8561ef4625ecf80e0d4bd019b'],0,2,2,110630,1,,,,533
1ecc7b63fbb0b13181ea16b38055729536c0225e,0,Sharad Agarwal,2009-10-20 06:25:37+00:00,['5690cd025ce5c1bcb21b69e4f17bbb65e3db80fb'],4,12,16,110646,3,0,1,1,533
fac2b0477cba4cd01a56c635459a949f81680a84,0,Douglass Cutting,2009-10-20 18:01:38+00:00,['1ecc7b63fbb0b13181ea16b38055729536c0225e'],2,5,7,110653,2,,,,533
21ba02b631c068abd4f295b8b903bdc392fa4573,1,Scott Banachowski,2009-10-20 22:31:35+00:00,['fac2b0477cba4cd01a56c635459a949f81680a84'],23,132,155,110808,7,,,,533
62e4e5bc62c1716224f60e61813103ec54704459,0,Douglass Cutting,2009-10-21 16:47:27+00:00,['21ba02b631c068abd4f295b8b903bdc392fa4573'],6,12,18,110826,2,1,0,1,533
d086fd7aaa4906cf4c50600744ed30fac9544269,1,Douglass Cutting,2009-10-21 17:10:06+00:00,['62e4e5bc62c1716224f60e61813103ec54704459'],13,38,51,110877,3,1,1,0.090909091,533
edbb3feac1bb12c0b00934b1fa58ba7c4b094b40,1,Douglass Cutting,2009-10-21 17:45:57+00:00,['d086fd7aaa4906cf4c50600744ed30fac9544269'],135,265,400,111277,4,0.927272727,0.963636364,0.872727273,534
4d2c4381dc5019ec721b525dafec3e6197b7e972,0,Matthew Lee Massie,2009-10-22 16:16:00+00:00,['edbb3feac1bb12c0b00934b1fa58ba7c4b094b40'],11,1072,1083,112360,3,0.27027027,0.27027027,0.636363636,536
e83268ede627871932e5de46d3bc69be500715b2,1,Douglass Cutting,2009-10-22 22:24:28+00:00,['4d2c4381dc5019ec721b525dafec3e6197b7e972'],3,105,108,112468,5,,,,537
5f7cb7d6d00a284364c629ba85d4b3114c677cc2,0,Matthew Lee Massie,2009-10-23 18:57:24+00:00,['e83268ede627871932e5de46d3bc69be500715b2'],3,73,76,112544,4,,,,538
3623bbcaf7c0f889fa0973b4b9d4e38fdfddb863,0,Matthew Lee Massie,2009-10-27 17:47:55+00:00,['5f7cb7d6d00a284364c629ba85d4b3114c677cc2'],336,527,863,113407,20,1,0.935483871,1,538
4fadaaba38d555cd869a10ac6c8e305f4b59ec61,1,Douglass Cutting,2009-10-27 23:57:53+00:00,['3623bbcaf7c0f889fa0973b4b9d4e38fdfddb863'],3,219,222,113629,7,0.540540541,1,1,542
f1b834377fc2f4f7ba5436e2cc0945c4fd7a9652,1,Scott Banachowski,2009-10-28 20:23:47+00:00,['4fadaaba38d555cd869a10ac6c8e305f4b59ec61'],442,411,853,114482,21,,,,543
de86bbe9b92fda06368889a9554cb71fbb03bace,0,Scott Banachowski,2009-10-30 02:42:31+00:00,['f1b834377fc2f4f7ba5436e2cc0945c4fd7a9652'],25,96,121,114603,7,0.978723404,1,0.659574468,543
8be88359e7685ffba7d71b6710c2b0d9e1a02212,0,Matthew Lee Massie,2009-10-31 23:19:10+00:00,['de86bbe9b92fda06368889a9554cb71fbb03bace'],328,468,796,115399,25,0.184210526,1,0.578947368,543
a4b6df067b9e320919b8997612c922863fc6a911,1,Scott Banachowski,2009-11-03 18:25:24+00:00,['8be88359e7685ffba7d71b6710c2b0d9e1a02212'],60,220,280,115679,10,0.507246377,1,1,543
e4a937b229b3c8d77ac10a38bd05ce8ca1f86cee,1,Matthew Lee Massie,2009-11-03 18:59:32+00:00,['a4b6df067b9e320919b8997612c922863fc6a911'],269,548,817,116496,13,0.124390244,0.717073171,0.317073171,545
e0871c82beaced35e4b1ea2e1d7a9023ec7e4e4a,1,Douglass Cutting,2009-11-05 21:39:56+00:00,['e4a937b229b3c8d77ac10a38bd05ce8ca1f86cee'],5,7,12,116508,2,,,,545
6c6a0cb898b7b4182ebe6ee9ee41ae5c83206075,0,Douglass Cutting,2009-11-05 22:48:56+00:00,['e0871c82beaced35e4b1ea2e1d7a9023ec7e4e4a'],2,4,6,116514,2,,,,545
ea05a9146f0edb64e76a25ab30230e9b35c98092,1,Douglass Cutting,2009-11-07 00:56:12+00:00,['6c6a0cb898b7b4182ebe6ee9ee41ae5c83206075'],32,112,144,116658,5,0.276923077,1,0.969230769,545
e0940cb77cd3029fd90efc6952783754a619dd8e,1,Matthew Lee Massie,2009-11-09 23:08:32+00:00,['ea05a9146f0edb64e76a25ab30230e9b35c98092'],180,495,675,117333,26,0,0,0.141263941,546
8d1df9769947050afa23ae3b6371ac4a74dd4928,1,Matthew Lee Massie,2009-11-10 08:39:49+00:00,['e0940cb77cd3029fd90efc6952783754a619dd8e'],31,39,70,117403,129,1,0,1,546
a45e938a1c59fb4f1fdc66252bdafac6aa9f2069,0,Matthew Lee Massie,2009-11-10 20:00:58+00:00,['8d1df9769947050afa23ae3b6371ac4a74dd4928'],0,0,0,117403,0,,,,546
8d27b88ec0c3ff374952f56519896f0c932f2967,0,Matthew Lee Massie,2009-11-10 22:05:48+00:00,['a45e938a1c59fb4f1fdc66252bdafac6aa9f2069'],0,2,2,117405,1,,,,546
39e6d507642777ab6ac2db0903775fbf094257a9,1,Matthew Lee Massie,2009-11-10 23:31:34+00:00,['8d27b88ec0c3ff374952f56519896f0c932f2967'],3,20,23,117428,3,,,,546
76c6762906b4802dd9e41b647a7a5146a08e180b,1,Douglass Cutting,2009-11-11 21:11:50+00:00,['39e6d507642777ab6ac2db0903775fbf094257a9'],76,139,215,117643,8,0.18,1,0.7,546
8ab3b6db708dfd187159fb2785bad2cacfc3a2b6,0,Douglass Cutting,2009-11-11 22:04:05+00:00,['76c6762906b4802dd9e41b647a7a5146a08e180b'],2,31,33,117676,3,0.76,0.76,1,546
6b33f0278abc9a1d81f925d39673d9fccefc5370,1,Douglass Cutting,2009-11-11 23:53:00+00:00,['8ab3b6db708dfd187159fb2785bad2cacfc3a2b6'],406,428,834,118510,18,1,1,1,546
2185314c78c943fa3e5369e747c6807bc3b9d960,0,Scott Banachowski,2009-11-12 02:17:08+00:00,['6b33f0278abc9a1d81f925d39673d9fccefc5370'],0,5,5,118515,4,,,,546
f353002184959c18354700b5b5f14e9c4a5269be,1,Scott Banachowski,2009-11-12 18:16:44+00:00,['2185314c78c943fa3e5369e747c6807bc3b9d960'],51,108,159,118674,11,0,1,1,546
7ae507b40fd3493e02438165f1d0c982e6e79914,0,Scott Banachowski,2009-11-12 19:19:02+00:00,['f353002184959c18354700b5b5f14e9c4a5269be'],4,15,19,118693,6,0,1,1,546
21bb13cd6122a926b670945bb11cde8bc0d973a3,1,Douglass Cutting,2009-11-12 23:30:59+00:00,['7ae507b40fd3493e02438165f1d0c982e6e79914'],13,17,30,118723,3,,,,546
8fa1312a50ec65a250de8df72794c061654cd9c9,1,Douglass Cutting,2009-11-13 00:34:15+00:00,['21bb13cd6122a926b670945bb11cde8bc0d973a3'],11,30,41,118764,5,0.6,1,1,546
43884c872df6d638d67a4584391bd79802dbbaa2,0,Douglass Cutting,2009-11-13 00:35:10+00:00,['8fa1312a50ec65a250de8df72794c061654cd9c9'],2,2,4,118768,1,,,,546
ff753de85e2216415f8fda01c814af11da13c90f,0,Matthew Lee Massie,2009-11-14 07:09:01+00:00,['43884c872df6d638d67a4584391bd79802dbbaa2'],189,390,579,119347,21,0,0.44047619,0.982142857,547
57d8f4535d9321d47dccd2148c4d0df40d011612,1,Scott Banachowski,2009-11-16 18:20:58+00:00,['ff753de85e2216415f8fda01c814af11da13c90f'],10,124,134,119481,6,0,1,1,547
2bf0a95abdec4a7b49f2ec75200c7354b6df9564,1,Scott Banachowski,2009-11-17 01:11:51+00:00,['57d8f4535d9321d47dccd2148c4d0df40d011612'],51,98,149,119630,16,1,0.916666667,1,547
9c9b79b536b55d252da46863e067705f52572ac5,0,Scott Banachowski,2009-11-17 22:34:15+00:00,['2bf0a95abdec4a7b49f2ec75200c7354b6df9564'],5,372,377,120007,10,0.310160428,0.759358289,1,548
60ad460b6fd8d8cdd2ba3cf6b533bc0a94d7a521,0,Douglass Cutting,2009-11-19 00:45:26+00:00,['9c9b79b536b55d252da46863e067705f52572ac5'],172,198,370,120377,4,,,,549
c4e01e1353f25e5acc40cacba02b753430b84a31,0,Douglass Cutting,2009-11-19 00:49:26+00:00,['60ad460b6fd8d8cdd2ba3cf6b533bc0a94d7a521'],210,213,423,120800,15,,,,549
dd75906e473d7df696bb73ebfea4207992444629,1,Scott Banachowski,2009-11-19 19:07:39+00:00,['c4e01e1353f25e5acc40cacba02b753430b84a31'],44,100,144,120944,9,0.75,0.75,1,549
d9600ed0b2e237cc7fd0cb89319c724d3251ff00,0,Douglass Cutting,2009-11-19 19:09:20+00:00,['dd75906e473d7df696bb73ebfea4207992444629'],53,96,149,121093,2,1,1,0.92,549
1aa6a71c292d95f4f591713e4f8e51cf49822d8e,0,Douglass Cutting,2009-11-20 02:49:42+00:00,['d9600ed0b2e237cc7fd0cb89319c724d3251ff00'],54,61,115,121208,2,0,0,1,549
19684abe028c3362ca80884fd737a1ff6a44aad3,0,Douglass Cutting,2009-11-20 02:56:37+00:00,['1aa6a71c292d95f4f591713e4f8e51cf49822d8e'],1,38,39,121247,3,1,1,1,550
e2d1051e95de6628da5758bb91f2511e588d3eb1,0,Douglass Cutting,2009-11-20 03:04:07+00:00,['19684abe028c3362ca80884fd737a1ff6a44aad3'],1,5,6,121253,2,,,,550
148436898364857155f03278e3eff328403f7226,0,Douglass Cutting,2009-11-20 04:26:52+00:00,['e2d1051e95de6628da5758bb91f2511e588d3eb1'],4,13,17,121270,2,,,,550
43bcac65cdd6cd43f73714eb3d72a51c406d8feb,1,Douglass Cutting,2009-11-20 04:39:28+00:00,['148436898364857155f03278e3eff328403f7226'],2,69,71,121341,5,0.04,0.04,1,551
d0d4e91341d00075cc46eb3ced62761644ce2c6e,1,Matthew Lee Massie,2009-11-20 04:57:17+00:00,['43bcac65cdd6cd43f73714eb3d72a51c406d8feb'],90,96,186,121527,6,,,,551
fd1d9077277695e8f5668c062289f9d17bb9981a,1,Douglass Cutting,2009-11-20 19:22:34+00:00,['d0d4e91341d00075cc46eb3ced62761644ce2c6e'],10,110,120,121647,3,0.540983607,1,1,551
e0c709a3b29bdd335a9b604fb94580003f54c6af,1,Douglass Cutting,2009-11-20 20:54:42+00:00,['fd1d9077277695e8f5668c062289f9d17bb9981a'],13,15,28,121675,3,,,,551
c854cd83e69bc220cd472e4006086c043efb4cc8,0,Douglass Cutting,2009-11-20 22:14:44+00:00,['e0c709a3b29bdd335a9b604fb94580003f54c6af'],8,10,18,121693,4,,,,551
234893c3d0ff9c18fd2b90e5c7ea0b0a9a0b2762,1,Douglass Cutting,2009-11-20 22:58:18+00:00,['c854cd83e69bc220cd472e4006086c043efb4cc8'],87,683,770,122463,15,0.755905512,0.829396325,0.897637795,552
56d154f53715a3234a7cafd5fca4bbeb15999f6c,0,Douglass Cutting,2009-11-20 23:11:44+00:00,['234893c3d0ff9c18fd2b90e5c7ea0b0a9a0b2762'],2,4,6,122469,2,,,,552
6d882a3832cd9ecf2d15568dd74ff30c9c2cfe83,0,Scott Banachowski,2009-11-21 01:30:35+00:00,['56d154f53715a3234a7cafd5fca4bbeb15999f6c'],2,26,28,122497,4,0.9,1,1,552
6b3399f6ea202f570ad92deb26652a5480da2717,0,Scott Banachowski,2009-11-21 01:31:14+00:00,['6d882a3832cd9ecf2d15568dd74ff30c9c2cfe83'],0,363,363,122860,1,,,,553
6bf016960332ba751f3e1124e11b5993fc75e070,0,Scott Banachowski,2009-11-21 01:44:29+00:00,['6b3399f6ea202f570ad92deb26652a5480da2717'],193,1720,1913,124773,13,0.535812672,0.79338843,0.716253444,556
91856e0e927a07b4e6940cdb48d99261b1dbaa18,0,Scott Banachowski,2009-11-21 02:11:02+00:00,['6bf016960332ba751f3e1124e11b5993fc75e070'],2,5,7,124780,2,,,,556
6dcb9a03a1d161425cf722d9b5dea06ffe56e675,1,Douglass Cutting,2009-11-24 19:07:01+00:00,['91856e0e927a07b4e6940cdb48d99261b1dbaa18'],1,84,85,124865,6,,,,557
f1b61e8f9d5ae1c5e0f155ff1ebeb40e4e2295eb,0,Douglass Cutting,2009-11-24 19:13:30+00:00,['6dcb9a03a1d161425cf722d9b5dea06ffe56e675'],14,70,84,124949,6,0.913043478,0.956521739,0,557
ba55ccc8e773ecbb0e71b13997c628b82f40eeac,0,Douglass Cutting,2009-11-24 21:25:15+00:00,['f1b61e8f9d5ae1c5e0f155ff1ebeb40e4e2295eb'],11,35,46,124995,6,0.555555556,0.555555556,0.555555556,557
913074da585f2737160b962aca0b905bb283012a,0,Scott Banachowski,2009-11-25 05:08:20+00:00,['ba55ccc8e773ecbb0e71b13997c628b82f40eeac'],301,520,821,125816,14,0.533333333,0.733333333,0.133333333,561
c7fe3355d2c8d966179aa8ff3189f354bc252ceb,1,Douglass Cutting,2009-11-25 20:22:09+00:00,['913074da585f2737160b962aca0b905bb283012a'],68,152,220,126036,9,0.983050847,0.745762712,0.898305085,561
21b3430f67fd55dbdd508e9593e522705247680f,0,Douglass Cutting,2009-12-01 21:41:49+00:00,['c7fe3355d2c8d966179aa8ff3189f354bc252ceb'],7,22,29,126065,3,,,,561
e0839ab5642e57853443d7388565c5acd6311ee3,1,Douglass Cutting,2009-12-01 23:51:03+00:00,['21b3430f67fd55dbdd508e9593e522705247680f'],2,4,6,126071,2,,,,561
a976791d656760a9d724276d31bed869f6396fde,1,Douglass Cutting,2009-12-03 21:32:37+00:00,['e0839ab5642e57853443d7388565c5acd6311ee3'],57,136,193,126264,3,0.898550725,0.913043478,1,561
7c655949f7bd1bc0896181545204665ff0a8ed87,1,Thiruvalluvan M. G,2009-12-04 14:35:24+00:00,['a976791d656760a9d724276d31bed869f6396fde'],30,81,111,126375,4,,,,562
8fca9cd353d16aa7396fb91c4b9a7cb4660d23fd,1,Douglass Cutting,2009-12-04 23:13:09+00:00,['7c655949f7bd1bc0896181545204665ff0a8ed87'],205,202,407,126782,9,0,0,0,563
3abbd30b6ea58ef7916699d5715ebc343e49cf8e,1,Douglass Cutting,2009-12-05 00:05:25+00:00,['8fca9cd353d16aa7396fb91c4b9a7cb4660d23fd'],16,43,59,126841,7,0.05,0.05,0.45,563
47646602d304105ec8edac22be3ac8dd9b0bbe38,1,Douglass Cutting,2009-12-08 19:39:12+00:00,['3abbd30b6ea58ef7916699d5715ebc343e49cf8e'],7,114,121,126962,9,0.511111111,0.511111111,0.288888889,564
2bf92732789f7cb1ec25be368fe76f6ad8007848,0,Thiruvalluvan M. G,2009-12-09 07:43:01+00:00,['47646602d304105ec8edac22be3ac8dd9b0bbe38'],0,36,36,126998,3,1,1,1,564
4e4ef4f8834a17e879113bf9f6fc465859d2f548,1,Douglass Cutting,2009-12-10 22:07:10+00:00,['2bf92732789f7cb1ec25be368fe76f6ad8007848'],14,73,87,127085,6,0.736842105,0.131578947,0.578947368,564
cfd4b63a8bb9244e3c1cdd48fffe2dd429f8e48d,1,Douglass Cutting,2009-12-15 21:23:37+00:00,['4e4ef4f8834a17e879113bf9f6fc465859d2f548'],53,37,90,127175,3,1,0,0,564
a87b0c1be09e0449a2c941ea542ce0f22639fdb1,1,Douglass Cutting,2009-12-15 21:29:39+00:00,['cfd4b63a8bb9244e3c1cdd48fffe2dd429f8e48d'],19,43,62,127237,3,0.684210526,0.684210526,1,564
3fde11fc9af39832b871b098f18a90b15c079e82,1,Douglass Cutting,2009-12-15 22:34:48+00:00,['a87b0c1be09e0449a2c941ea542ce0f22639fdb1'],4,42,46,127283,2,,,,564
39c4b9c04f2232e71cca1e2f29dbc4e3319c9edf,0,Douglass Cutting,2009-12-15 23:05:45+00:00,['3fde11fc9af39832b871b098f18a90b15c079e82'],8,13,21,127304,3,,,,564
c5df78537022403f7725b273c1d9371e345cf905,0,Douglass Cutting,2009-12-29 22:32:04+00:00,['39c4b9c04f2232e71cca1e2f29dbc4e3319c9edf'],10,20,30,127334,6,0.5,0.75,0.5,564
e2b5b07fea44c4400386da565e880900fadfa7ea,0,Douglass Cutting,2009-12-29 22:41:32+00:00,['c5df78537022403f7725b273c1d9371e345cf905'],1,3,4,127338,2,,,,564
1acc9913afd9bee7ad319ffd789a6e47a2e7baa8,0,Douglass Cutting,2009-12-29 23:10:37+00:00,['e2b5b07fea44c4400386da565e880900fadfa7ea'],2,4,6,127344,2,,,,564
4471c7079a4e7cc62ff6d67cfe22b078a6bbe4af,1,Douglass Cutting,2009-12-30 23:43:28+00:00,['1acc9913afd9bee7ad319ffd789a6e47a2e7baa8'],24,755,779,128123,13,0.476489028,1,0.529780564,573
1d125b4a4fdabf0bf55f27d092226a53d70427ac,1,Douglass Cutting,2009-12-31 17:01:58+00:00,['4471c7079a4e7cc62ff6d67cfe22b078a6bbe4af'],363,405,768,128891,12,0.285714286,0.857142857,1,574
2310971c1ca6e632a938266f68921b0221a80d61,1,Douglass Cutting,2009-12-31 18:41:15+00:00,['1d125b4a4fdabf0bf55f27d092226a53d70427ac'],0,18,18,128909,5,0.75,0.75,1,574
d0b76375fb71ea127d0d0f2ef38b9712efce36da,1,Douglass Cutting,2009-12-31 19:23:02+00:00,['2310971c1ca6e632a938266f68921b0221a80d61'],34,89,123,129032,5,0.290322581,1,1,574
162726205705d4130e4090e4c4aa24d9e7ef34a6,1,Douglass Cutting,2009-12-31 20:23:22+00:00,['d0b76375fb71ea127d0d0f2ef38b9712efce36da'],16,2645,2661,131693,22,0.564356436,0.732673267,0.732673267,590
09077d848518150782f9a44c08d25699fbd680a1,0,Douglass Cutting,2009-12-31 21:18:43+00:00,['162726205705d4130e4090e4c4aa24d9e7ef34a6'],16,20,36,131729,2,,,,590
939eb8a8a6f5fb7239432eb0bc42730153d46c92,0,Douglass Cutting,2009-12-31 21:29:44+00:00,['09077d848518150782f9a44c08d25699fbd680a1'],3,8,11,131740,3,1,1,1,590
e5631c1b774681f92de43f9f7d6ec64ae15d5c9b,1,Douglass Cutting,2009-12-31 21:52:35+00:00,['939eb8a8a6f5fb7239432eb0bc42730153d46c92'],2,340,342,132082,8,0.398773006,1,0.552147239,593
3b522378847be1e45c11024f153dbac7f83c9c67,1,Douglass Cutting,2010-01-04 18:09:42+00:00,['e5631c1b774681f92de43f9f7d6ec64ae15d5c9b'],4221,2174,6395,138477,24,0.179130435,0.173043478,0.412173913,596
2faea630242fa636cbb123597f47d2216e159136,1,Douglass Cutting,2010-01-05 18:48:04+00:00,['3b522378847be1e45c11024f153dbac7f83c9c67'],1,1108,1109,139586,7,0.57079646,0.634955752,0.592920354,601
b0e42bf54f6575ffadd2766582cf01633d6061d7,1,Douglass Cutting,2010-01-05 18:55:19+00:00,['2faea630242fa636cbb123597f47d2216e159136'],0,118,118,139704,3,1,1,1,603
8911c848b1625d911a99ab846c4000985c74758c,0,Douglass Cutting,2010-01-06 23:26:30+00:00,['b0e42bf54f6575ffadd2766582cf01633d6061d7'],2,6,8,139712,3,1,1,1,603
fee963d618d493bf630fc0afdfbc1eb8d74b5362,1,Douglass Cutting,2010-01-07 19:21:17+00:00,['8911c848b1625d911a99ab846c4000985c74758c'],4,7,11,139723,3,,,,603
0def48146dd7e2590a41f9da2c025d4024865ccc,1,Douglass Cutting,2010-01-07 19:51:49+00:00,['fee963d618d493bf630fc0afdfbc1eb8d74b5362'],25,168,193,139916,3,0.106382979,1,1,603
e5d6f00462a43a94edd3ad1e4266443c63ecf51c,0,Douglass Cutting,2010-01-08 18:53:18+00:00,['0def48146dd7e2590a41f9da2c025d4024865ccc'],0,1079,1079,140995,12,0.742081448,1,0.943438914,614
d933c26e39b707dcfeeff28a089a085506cba5e2,1,Douglass Cutting,2010-01-08 19:06:53+00:00,['e5d6f00462a43a94edd3ad1e4266443c63ecf51c'],234,262,496,141491,4,1,0,0,614
7b13b5dda2f7014ed15d86887a963299232ca1d2,1,Douglass Cutting,2010-01-08 19:49:51+00:00,['d933c26e39b707dcfeeff28a089a085506cba5e2'],46,249,295,141786,13,0.637254902,0.911764706,0.666666667,615
853d0a7c72fbecb76748ea0ff7f4bf31f6529e6a,0,Douglass Cutting,2010-01-08 20:16:21+00:00,['7b13b5dda2f7014ed15d86887a963299232ca1d2'],30,51,81,141867,6,0.181818182,1,1,615
6a9539134694a73e1dd5bdded697461ac88b4744,1,Douglass Cutting,2010-01-08 20:36:04+00:00,['853d0a7c72fbecb76748ea0ff7f4bf31f6529e6a'],42,55,97,141964,8,1,1,1,615
8fc362ad49300d2aa145c0e0e118851fbcc563b6,1,Douglass Cutting,2010-01-09 00:03:46+00:00,['6a9539134694a73e1dd5bdded697461ac88b4744'],2,42,44,142008,3,1,1,1,616
8697acfffac7f9d677793ea65ad3d66143b6963d,1,Thiruvalluvan M. G,2010-01-10 14:38:18+00:00,['8fc362ad49300d2aa145c0e0e118851fbcc563b6'],2,4,6,142014,2,,,,616
5d6bcad33de3aec97c4de7a2ff143a728837b5c1,0,Douglass Cutting,2010-01-10 17:09:44+00:00,['8697acfffac7f9d677793ea65ad3d66143b6963d'],1,22,23,142037,3,0.9375,0.9375,1,616
7c85a78d59b838852273934706bd394df56c23ee,1,Douglass Cutting,2010-01-10 17:25:30+00:00,['5d6bcad33de3aec97c4de7a2ff143a728837b5c1'],27,61,88,142125,3,1,1,0.25,616
3765440645e1dd8a585a11fb14476334ed54f1e8,0,Douglass Cutting,2010-01-10 17:30:48+00:00,['7c85a78d59b838852273934706bd394df56c23ee'],6,13,19,142144,2,,,,616
5979ad309e117fed1d59c3610255fe16852d8d60,1,Douglass Cutting,2010-01-11 19:13:17+00:00,['3765440645e1dd8a585a11fb14476334ed54f1e8'],67,71,138,142282,15,0,1,1,616
666ef349f0d5700803cc24ac38b1216e926d1519,1,Douglass Cutting,2010-01-12 00:50:29+00:00,['5979ad309e117fed1d59c3610255fe16852d8d60'],38,44,82,142364,6,0,0,1,616
2b43cbdc5d51752325dd9f29a669dcc532a1c6b0,1,Douglass Cutting,2010-01-12 01:03:43+00:00,['666ef349f0d5700803cc24ac38b1216e926d1519'],28,666,694,143058,435,,,,620
198bdac00482ea898b6035e9cd6c96f00ea3f026,0,Douglass Cutting,2010-01-12 01:05:05+00:00,['2b43cbdc5d51752325dd9f29a669dcc532a1c6b0'],0,0,0,143058,0,,,,620
107cb5e18a20a09f19fb97e4e0f4a2652574ac09,0,Douglass Cutting,2010-01-12 19:41:18+00:00,['198bdac00482ea898b6035e9cd6c96f00ea3f026'],3,4,7,143065,4,,,,620
820d85de389914cd414a0dac60ca4e9cca359b02,1,Douglass Cutting,2010-01-12 22:26:55+00:00,['107cb5e18a20a09f19fb97e4e0f4a2652574ac09'],6,25,31,143096,3,,,,620
6b57b501c1c93efc5c6b42c511c4d3c19974a71a,0,Douglass Cutting,2010-01-12 22:30:29+00:00,['820d85de389914cd414a0dac60ca4e9cca359b02'],1,1,2,143098,1,,,,620
56794b99650ef9343e7e7fd5b518391cfeaff032,1,Douglass Cutting,2010-01-12 22:38:28+00:00,['6b57b501c1c93efc5c6b42c511c4d3c19974a71a'],764,33,797,143895,5,,,,620
f3820c4131858ee2c0781dfed445b239569e61cc,0,Douglass Cutting,2010-01-12 23:06:56+00:00,['56794b99650ef9343e7e7fd5b518391cfeaff032'],1,10,11,143906,2,,,,620
63a4e8c60a5aa8d269968e984b668c476ea18c36,0,Douglass Cutting,2010-01-13 20:19:30+00:00,['f3820c4131858ee2c0781dfed445b239569e61cc'],24,36,60,143966,4,1,1,1,620
e634f34b9abc17de550d37b249b5bc750e1e9f59,0,Douglass Cutting,2010-01-13 22:06:56+00:00,['63a4e8c60a5aa8d269968e984b668c476ea18c36'],5,16,21,143987,4,0,1,1,620
801eb60caf59f2af13fcc7edceb00787840716f6,1,Douglass Cutting,2010-01-13 22:15:57+00:00,['e634f34b9abc17de550d37b249b5bc750e1e9f59'],0,22,22,144009,1,1,1,1,620
1b0d92f9f1a06faafc698b8d170999cfd582dcfd,1,Douglass Cutting,2010-01-13 23:08:14+00:00,['801eb60caf59f2af13fcc7edceb00787840716f6'],28,56,84,144093,9,0,1,1,620
7e5266955d8c92e7c6f1b2f4de3f04d57759cc29,1,Douglass Cutting,2010-01-13 23:26:56+00:00,['1b0d92f9f1a06faafc698b8d170999cfd582dcfd'],9,61,70,144163,6,,,,622
e72ac6c69b0e3e06c22a6a84394b4f64dafd7b3e,1,Thiruvalluvan M. G,2010-01-14 12:47:30+00:00,['7e5266955d8c92e7c6f1b2f4de3f04d57759cc29'],20,213,233,144396,3,0.739837398,0.739837398,0.967479675,623
e10a0be31a2495dcc9205a681e8401003e2a5bea,0,Thiruvalluvan M. G,2010-01-14 12:53:32+00:00,['e72ac6c69b0e3e06c22a6a84394b4f64dafd7b3e'],24,68,92,144488,8,0,0.424242424,1,623
115547c97f36bd8cb8d95a85878eaed5d1074507,0,Thiruvalluvan M. G,2010-01-14 13:40:25+00:00,['e10a0be31a2495dcc9205a681e8401003e2a5bea'],68,111,179,144667,13,0.857142857,0.857142857,1,623
e2619a8330a83f8a4f88a5dc055fa9cc2c606873,0,Douglass Cutting,2010-01-14 18:47:52+00:00,['115547c97f36bd8cb8d95a85878eaed5d1074507'],1,1,2,144669,1,,,,623
b6bd22843bec5f28b5c44af91c4e5fb2b1187f2b,1,Douglass Cutting,2010-01-14 19:55:19+00:00,['e2619a8330a83f8a4f88a5dc055fa9cc2c606873'],11,12,23,144692,1,,,,623
aaa7f4764b7396fd2d1cb63058fbdf6209e829cb,0,Douglass Cutting,2010-01-14 23:03:26+00:00,['b6bd22843bec5f28b5c44af91c4e5fb2b1187f2b'],15,51,66,144758,5,,,,623
eeb127e7edec95b9663f416cee4bebab9581e0e3,0,Douglass Cutting,2010-01-14 23:32:24+00:00,['aaa7f4764b7396fd2d1cb63058fbdf6209e829cb'],177,92,269,145027,14,0.936170213,0.446808511,0,623
55e42a83f141d22d2c69b27167def8380e89683c,1,Scott Banachowski,2010-01-15 00:19:40+00:00,['eeb127e7edec95b9663f416cee4bebab9581e0e3'],1400,37760,39160,184187,26,0,1,1,638
516ad11ed8f9c3d2f7830a9b8624fc82cc2346ab,0,Thiruvalluvan M. G,2010-01-15 03:27:45+00:00,['55e42a83f141d22d2c69b27167def8380e89683c'],6,43,49,184236,5,0.2,0.24,1,638
91afe7721577c98ceef926842a2a1faf4b806f39,1,Thiruvalluvan M. G,2010-01-15 17:19:45+00:00,['516ad11ed8f9c3d2f7830a9b8624fc82cc2346ab'],79,138,217,184453,13,0.903225806,0.903225806,1,638
bbf437e11f1b6ccd16f3bc79cd09af077dc0f638,1,Matthew Lee Massie,2010-01-16 01:52:24+00:00,['91afe7721577c98ceef926842a2a1faf4b806f39'],12970,24690,37660,222113,193,1,0.772824689,0.542220317,717
76315b92e96ff9ed61183d81124fc3acf6998249,1,Thiruvalluvan M. G,2010-01-16 05:11:07+00:00,['bbf437e11f1b6ccd16f3bc79cd09af077dc0f638'],6,11,17,222130,5,0.666666667,1,1,717
4a0d5ae8a855c9f1b1260cd5eba802fcfc18dcf1,0,Thiruvalluvan M. G,2010-01-16 05:59:46+00:00,['76315b92e96ff9ed61183d81124fc3acf6998249'],4,193,197,222327,3,0.627272727,0.972727273,0.818181818,717
7ddcfd485ee59e909a107cf85b7af927f422c8c9,1,Matthew Lee Massie,2010-01-18 05:30:24+00:00,['4a0d5ae8a855c9f1b1260cd5eba802fcfc18dcf1'],286,491,777,223104,14,0.288343558,0.208588957,0.883435583,717
b844f7e03bbe8dd1b787d0c077c18a4a07330a01,0,Matthew Lee Massie,2010-01-18 05:31:11+00:00,['7ddcfd485ee59e909a107cf85b7af927f422c8c9'],0,2,2,223106,1,,,,717
771a96e26cab64a37d8dbbbcc898a2f0132db1c3,0,Matthew Lee Massie,2010-01-18 05:49:48+00:00,['b844f7e03bbe8dd1b787d0c077c18a4a07330a01'],1,3,4,223110,2,,,,717
c11181848af28d91162a4f87647400eacaafcff5,0,Douglass Cutting,2010-01-18 21:17:56+00:00,['771a96e26cab64a37d8dbbbcc898a2f0132db1c3'],7,12,19,223129,2,,,,717
93e81f7ce6480d3a18b7921e0263686a237bf0f6,1,Douglass Cutting,2010-01-18 21:42:45+00:00,['c11181848af28d91162a4f87647400eacaafcff5'],2,12,14,223143,1,,,,717
ca085246f097b19ba44b84768568fc56e8dfbb87,0,Douglass Cutting,2010-01-19 00:49:33+00:00,['93e81f7ce6480d3a18b7921e0263686a237bf0f6'],4,22,26,223169,3,1,1,1,717
b25e6a3de8adbc0a88c920e7d18ca96292835b1b,1,Thiruvalluvan M. G,2010-01-19 14:25:06+00:00,['ca085246f097b19ba44b84768568fc56e8dfbb87'],72,110,182,223351,5,0.785714286,0.785714286,0.857142857,717
abd816c13c3e1af987e8a7b88face7f06288bde9,1,Philip Zeyliger,2010-01-19 19:56:56+00:00,['b25e6a3de8adbc0a88c920e7d18ca96292835b1b'],4,41,45,223396,4,1,1,1,718
e3ddec6f5a87984a5d5358734f8ee5e26a6682df,1,Matthew Lee Massie,2010-01-19 21:13:05+00:00,['abd816c13c3e1af987e8a7b88face7f06288bde9'],246,543,789,224185,9,0.130268199,0.068965517,0.363984674,718
904a5a7b36db75afa7f6471c005e67ef50fee665,1,Matthew Lee Massie,2010-01-19 21:38:40+00:00,['e3ddec6f5a87984a5d5358734f8ee5e26a6682df'],0,7,7,224192,2,,,,718
558af6be61eaa44c36a7c45caaf184d9eae0ab33,1,Douglass Cutting,2010-01-20 01:05:06+00:00,['904a5a7b36db75afa7f6471c005e67ef50fee665'],0,2783,2783,226975,20,0.599118943,0.748898678,0.784140969,734
015b9bc7c86d8eba331ebc2dc1aea05325444151,0,Matthew Lee Massie,2010-01-20 01:52:29+00:00,['558af6be61eaa44c36a7c45caaf184d9eae0ab33'],0,8,8,226983,2,,,,734
25009db0b89af97cc8d863a7bd355a55cb6c89c8,0,Matthew Lee Massie,2010-01-20 21:52:35+00:00,['015b9bc7c86d8eba331ebc2dc1aea05325444151'],251,484,735,227718,7,0.253658537,1,0,734
89593506cd9e34fc28bfe2d0be546ab7c9915ebe,1,Matthew Lee Massie,2010-01-20 22:58:22+00:00,['25009db0b89af97cc8d863a7bd355a55cb6c89c8'],4135,3712,7847,235565,22,1,0.610644258,0.417366947,734
06896f8e3a96f125d099c1b5311eb3e6238a31f9,1,Jeffrey Evan Hammerbacher,2010-01-21 04:12:58+00:00,['89593506cd9e34fc28bfe2d0be546ab7c9915ebe'],0,10,10,235575,2,,,,734
77bb1e976a00ce949f5ca61421d43b08108e28e1,1,Philip Zeyliger,2010-01-21 23:19:19+00:00,['06896f8e3a96f125d099c1b5311eb3e6238a31f9'],17,39,56,235631,4,1,1,0.333333333,734
9de8a8d9f7c13dca27df22fcd1ee4ffe696cd144,1,Matthew Lee Massie,2010-01-22 00:38:01+00:00,['77bb1e976a00ce949f5ca61421d43b08108e28e1'],871,1055,1926,237557,13,0.168539326,0.516853933,0.460674157,738
56f6af364fa4d8d20e1bf7ed138e8445586b1ac6,1,Philip Zeyliger,2010-01-22 01:28:00+00:00,['9de8a8d9f7c13dca27df22fcd1ee4ffe696cd144'],57,688,745,238302,16,0.731277533,1,0.779735683,745
7679cb3ca82f36c56238845e7c71b6139c34e8a0,1,Matthew Lee Massie,2010-01-22 19:02:59+00:00,['56f6af364fa4d8d20e1bf7ed138e8445586b1ac6'],63,405,468,238770,13,0.035335689,0.183745583,0.823321555,746
01193b5705a8a36d0df95dd1e35ebfce3fc6c318,0,Matthew Lee Massie,2010-01-22 20:55:51+00:00,['7679cb3ca82f36c56238845e7c71b6139c34e8a0'],16,63,79,238849,6,0.441860465,0.930232558,0.372093023,746
005f0a6a6d474f7e80b308a1cddbe73c5d061895,1,Matthew Lee Massie,2010-01-22 22:38:09+00:00,['01193b5705a8a36d0df95dd1e35ebfce3fc6c318'],46,102,148,238997,9,0.395833333,0.354166667,0.3125,746
8590c10521e043f068999d182d616c80cd8b34e2,0,Scott Banachowski,2010-01-22 22:41:02+00:00,['005f0a6a6d474f7e80b308a1cddbe73c5d061895'],15,17,32,239029,7,,,,746
f24e3146f5515d4be9841bffd8840de492274d69,1,Scott Banachowski,2010-01-22 22:44:39+00:00,['8590c10521e043f068999d182d616c80cd8b34e2'],28,157,185,239214,7,,,,747
d5f3181c9bd0dae7597349302c4d9d0a822bdb6d,0,Douglass Cutting,2010-01-22 23:09:51+00:00,['f24e3146f5515d4be9841bffd8840de492274d69'],1,1,2,239216,1,,,,747
520b9b4f09dd9bec743be83722530133a7f1e3de,1,Matthew Lee Massie,2010-01-23 00:07:16+00:00,['d5f3181c9bd0dae7597349302c4d9d0a822bdb6d'],18,68,86,239302,8,0.065217391,0.97826087,0.217391304,747
61aad5477d396fcb9dfa27ae660e05fcac0b2dc8,0,Thiruvalluvan M. G,2010-01-25 08:58:53+00:00,['520b9b4f09dd9bec743be83722530133a7f1e3de'],6,15,21,239323,1,1,1,1,747
fbc0ac7c6c17e991e1dd6c3079df84efcbf3c0e7,0,Thiruvalluvan M. G,2010-01-25 09:04:21+00:00,['61aad5477d396fcb9dfa27ae660e05fcac0b2dc8'],0,2,2,239325,1,,,,747
ceba79182df36c355ad56298bdf33dc23d913264,1,Matthew Lee Massie,2010-01-26 00:31:08+00:00,['fbc0ac7c6c17e991e1dd6c3079df84efcbf3c0e7'],104,425,529,239854,12,0.864541833,0.992031873,0.549800797,747
27c7ad120beb6a432e3afa67acc9a532140cf6fd,0,Thiruvalluvan M. G,2010-01-26 15:27:07+00:00,['ceba79182df36c355ad56298bdf33dc23d913264'],5,14,19,239873,2,1,1,1,747
26f53a11450952dc17b2248d6d08d18cb106acf7,0,Thiruvalluvan M. G,2010-01-26 17:36:47+00:00,['27c7ad120beb6a432e3afa67acc9a532140cf6fd'],8,18,26,239899,4,1,1,1,747
8cbe31ef59354a9eff47aa82b13fd72650874b89,0,Thiruvalluvan M. G,2010-01-26 18:28:43+00:00,['26f53a11450952dc17b2248d6d08d18cb106acf7'],0,49,49,239948,1,1,1,1,748
8a4ddb52579070a3744a2bb9a0baf42d5da6b0a5,0,Thiruvalluvan M. G,2010-01-26 18:36:10+00:00,['8cbe31ef59354a9eff47aa82b13fd72650874b89'],0,3,3,239951,2,1,1,1,748
c85ab4b4f9a40f760fe781542d50a414cf1393e4,1,Philip Zeyliger,2010-01-26 18:51:54+00:00,['8a4ddb52579070a3744a2bb9a0baf42d5da6b0a5'],20,84,104,240055,8,0.954545455,1,1,749
c635452b1d8ce1f26364bfd18b118595bfed3945,0,Philip Zeyliger,2010-01-26 18:59:32+00:00,['c85ab4b4f9a40f760fe781542d50a414cf1393e4'],7,12,19,240074,4,,,,749
2be9e693c4d68e1afac5a0c75d9e2de4d910c5df,1,Matthew Lee Massie,2010-01-26 19:07:07+00:00,['c635452b1d8ce1f26364bfd18b118595bfed3945'],13198,286,13484,253558,19,0,0.660869565,0.652173913,752
e790f4837a3ee242a6e8b523ee4b10cb45d59bbc,1,Matthew Lee Massie,2010-01-26 23:58:49+00:00,['2be9e693c4d68e1afac5a0c75d9e2de4d910c5df'],143,96,239,253797,11,0.878787879,0.666666667,0,752
0319db2a8fe241b364968693afbb9bd741ee148d,1,Matthew Lee Massie,2010-01-27 02:13:24+00:00,['e790f4837a3ee242a6e8b523ee4b10cb45d59bbc'],5,88,93,253890,2,,,,752
8f3ad160ce8c452bfbafc4ca09ab263a2e6aa06a,1,Philip Zeyliger,2010-01-27 17:27:38+00:00,['0319db2a8fe241b364968693afbb9bd741ee148d'],1,9,10,253900,3,1,1,1,752
6915f0c35380fc41ba0af682ba0dc2c21f6cd5f3,1,Matthew Lee Massie,2010-01-28 02:06:31+00:00,['8f3ad160ce8c452bfbafc4ca09ab263a2e6aa06a'],63,352,415,254315,11,0.185344828,0.237068966,0.538793103,753
b73d4499cb85dda67ba432ce156a22a74e78f142,1,Scott Banachowski,2010-01-29 05:59:09+00:00,['6915f0c35380fc41ba0af682ba0dc2c21f6cd5f3'],44294,26,44320,298635,15,,,,754
3dfd487bf2a7b4f83b33f5ef9a9ed3e101bfe369,0,Thiruvalluvan M. G,2010-01-29 10:12:35+00:00,['b73d4499cb85dda67ba432ce156a22a74e78f142'],8,18,26,298661,3,1,1,1,754
7a0078b786f0e3575fef5d98a8242c13530ceccd,0,Thiruvalluvan M. G,2010-01-29 19:11:45+00:00,['3dfd487bf2a7b4f83b33f5ef9a9ed3e101bfe369'],19,257,276,298937,6,0.178343949,0.484076433,0.496815287,755
2e4f32687d9c6b669bcda7b8a0b42d71daf97a2c,1,Philip Zeyliger,2010-01-29 19:29:17+00:00,['7a0078b786f0e3575fef5d98a8242c13530ceccd'],40,97,137,299074,10,0.027777778,0.194444444,0.888888889,755
6e4ae0b6566b795e14dadf6d1902cfbd69bbe2b7,1,Thiruvalluvan M. G,2010-02-02 05:04:56+00:00,['2e4f32687d9c6b669bcda7b8a0b42d71daf97a2c'],8,19,27,299101,5,0,1,1,755
1167caf735140964f5dcba441b76d99e7c9ceed1,1,Thiruvalluvan M. G,2010-02-02 05:19:08+00:00,['6e4ae0b6566b795e14dadf6d1902cfbd69bbe2b7'],2,28,30,299131,3,0,1,1,755
bf7db0c2ecb2104fb087f0eea560a7d36935929c,0,Thiruvalluvan M. G,2010-02-02 05:34:17+00:00,['1167caf735140964f5dcba441b76d99e7c9ceed1'],5,22,27,299158,4,0,0.785714286,0.785714286,755
6c7b0e1396e9e6326f80a82515f4de44d4f0ebf9,0,Philip Zeyliger,2010-02-02 06:52:02+00:00,['bf7db0c2ecb2104fb087f0eea560a7d36935929c'],2,88,90,299248,3,0.144444444,0.877777778,1,755
f86e0305115fdf9aaa90b19e3bb8ee58324a1406,1,Douglass Cutting,2010-02-02 21:51:49+00:00,['6c7b0e1396e9e6326f80a82515f4de44d4f0ebf9'],79,121,200,299448,14,1,1,0.565217391,757
1b9263f5e8587f147c7d2920552c639f1bbf9759,0,Douglass Cutting,2010-02-02 22:51:57+00:00,['f86e0305115fdf9aaa90b19e3bb8ee58324a1406'],1,18,19,299467,3,1,1,1,757
7e4037de2a891fa738aaf8a4fc56f424d6c6833a,1,Thiruvalluvan M. G,2010-02-03 01:50:50+00:00,['1b9263f5e8587f147c7d2920552c639f1bbf9759'],273,340,613,300080,10,1,1,1,757
a861b870bd09f49ecea1a56146a9edf8fc173cb1,0,Philip Zeyliger,2010-02-03 06:58:46+00:00,['7e4037de2a891fa738aaf8a4fc56f424d6c6833a'],80,166,246,300326,4,0.421052632,0,0.868421053,758
1c5dc778b032b9b4bf5605e883b79fe36ce62363,1,Matthew Lee Massie,2010-02-03 23:59:40+00:00,['a861b870bd09f49ecea1a56146a9edf8fc173cb1'],858,367,1225,301551,14,0.0625,1,0.4375,758
e1e7220560d799b380d79c257dfc0aaac949a623,1,Douglass Cutting,2010-02-04 00:24:31+00:00,['1c5dc778b032b9b4bf5605e883b79fe36ce62363'],1,42,43,301594,3,1,1,1,759
a27490c186343bce568e64075f4e4dbfe13945ea,0,Douglass Cutting,2010-02-04 00:30:17+00:00,['e1e7220560d799b380d79c257dfc0aaac949a623'],1,1,2,301596,1,,,,759
00df8fbcb882af2c5f02e44483c07d2fe0c91a20,0,Matthew Lee Massie,2010-02-04 05:02:34+00:00,['a27490c186343bce568e64075f4e4dbfe13945ea'],0,8,8,301604,3,,,,759
710f365be8bc4b94b690f3a669976c7675d54704,0,Jeffrey Evan Hammerbacher,2010-02-04 08:11:43+00:00,['00df8fbcb882af2c5f02e44483c07d2fe0c91a20'],1,4,5,301609,2,,,,759
05b3442fbf6f20ede5212cbc8ce3c9b709341af2,1,Jeffrey Evan Hammerbacher,2010-02-04 08:15:02+00:00,['710f365be8bc4b94b690f3a669976c7675d54704'],212,251,463,302072,6,1,1,0.583333333,761
441e55023dbb9774ac2fd6b6543968d63a0c1d42,0,Jeffrey Evan Hammerbacher,2010-02-04 08:16:29+00:00,['05b3442fbf6f20ede5212cbc8ce3c9b709341af2'],0,0,0,302072,2,,,,761
cd1e3ed623a6edc0dba743dfc327ce5a4092d159,0,Douglass Cutting,2010-02-04 18:58:29+00:00,['441e55023dbb9774ac2fd6b6543968d63a0c1d42'],13,37,50,302122,7,1,1,1,761
8c3259ba2089f1af607e60296a8de56292ea91b9,1,Douglass Cutting,2010-02-04 20:00:36+00:00,['cd1e3ed623a6edc0dba743dfc327ce5a4092d159'],2,7,9,302131,4,1,1,0.5,761
62cba7ee3c6f0b73f1d195934b940b5061757a84,1,Douglass Cutting,2010-02-04 20:10:26+00:00,['8c3259ba2089f1af607e60296a8de56292ea91b9'],37,258,295,302426,15,0.185185185,1,0.425925926,769
79c0980088a4e97c114e75c4f251db3f95b72618,0,Douglass Cutting,2010-02-04 20:47:25+00:00,['62cba7ee3c6f0b73f1d195934b940b5061757a84'],1,3,4,302430,2,,,,769
b57e524fc1c9477515bb5ca9523b86f66461494c,1,Matthew Lee Massie,2010-02-04 21:41:02+00:00,['79c0980088a4e97c114e75c4f251db3f95b72618'],193,208,401,302831,10,0,0.511627907,1,769
340c58f3c11c90d1b678bd0ceea8dd4fdc90ff94,0,Matthew Lee Massie,2010-02-05 23:49:26+00:00,['b57e524fc1c9477515bb5ca9523b86f66461494c'],1,3,4,302835,2,,,,769
fc1935c78e8b885708edaa05adb790da9b63a4c8,1,Matthew Lee Massie,2010-02-06 00:56:51+00:00,['340c58f3c11c90d1b678bd0ceea8dd4fdc90ff94'],5,527,532,303367,12,0.267217631,0.785123967,0.721763085,772
e1c17e745462a8ac3d93ddef0bdaba3cdfac0a71,0,Matthew Lee Massie,2010-02-06 01:08:13+00:00,['fc1935c78e8b885708edaa05adb790da9b63a4c8'],1,3,4,303371,2,,,,772
258d4191bf1c8030686d65e38db74534eb7f0a71,0,Matthew Lee Massie,2010-02-06 01:15:40+00:00,['e1c17e745462a8ac3d93ddef0bdaba3cdfac0a71'],6,8,14,303385,7,,,,772
c06063a88b9956fab43db106157d5ea1c640fa37,1,Matthew Lee Massie,2010-02-06 03:39:08+00:00,['258d4191bf1c8030686d65e38db74534eb7f0a71'],26,33,59,303444,2,0,0,1,772
f4e4771f13fc9bc7921f71c1b9e094d5a4309134,0,Douglass Cutting,2010-02-08 23:37:55+00:00,['c06063a88b9956fab43db106157d5ea1c640fa37'],6,4,10,303454,2,1,1,0,772
c8ee72a75cf26b5c364a8ec032e7d9235af8f469,1,Matthew Lee Massie,2010-02-09 02:06:38+00:00,['f4e4771f13fc9bc7921f71c1b9e094d5a4309134'],18,86,104,303558,13,0,0,0.810344828,772
835e48610941ae55f70c71c7542482f30500e961,1,Thiruvalluvan M. G,2010-02-09 03:34:43+00:00,['c8ee72a75cf26b5c364a8ec032e7d9235af8f469'],161,373,534,304092,20,0.692307692,1,1,772
3e3f0fbe27d319893393f34a887b2ab427a038c0,1,Douglass Cutting,2010-02-09 19:36:42+00:00,['835e48610941ae55f70c71c7542482f30500e961'],88,124,212,304304,6,0,0,1,773
5fa06695d45c1ae7afc6e7f7ad4716e0ff32886d,0,Matthew Lee Massie,2010-02-09 20:42:02+00:00,['3e3f0fbe27d319893393f34a887b2ab427a038c0'],261,357,618,304922,14,0.25,0.291666667,1,773
02b9415b1d31f0c4a5d8c52ca9821e18dd060d31,1,Douglass Cutting,2010-02-09 22:37:52+00:00,['5fa06695d45c1ae7afc6e7f7ad4716e0ff32886d'],1,26,27,304949,2,,,,774
1d6b6c5549fd0086e0682d519527d879b1efda33,1,Thiruvalluvan M. G,2010-02-10 06:49:14+00:00,['02b9415b1d31f0c4a5d8c52ca9821e18dd060d31'],0,54,54,305003,2,0,1,1,775
a2a731f3f58e82d58e6359c32d8c423eee63a3c8,1,Jeffrey Evan Hammerbacher,2010-02-11 00:07:31+00:00,['1d6b6c5549fd0086e0682d519527d879b1efda33'],2,98,100,305103,5,1,1,1,777
c39ca5896e0d6c665c601666d2a9abf6aa0cd61a,1,Jeffrey Evan Hammerbacher,2010-02-15 22:13:08+00:00,['a2a731f3f58e82d58e6359c32d8c423eee63a3c8'],19,159,178,305281,4,0.481132075,0.481132075,0.660377358,777
f24c33c97cacbab60f6f3f0f5a26cb350c5cce28,1,Jeffrey Evan Hammerbacher,2010-02-15 22:18:10+00:00,['c39ca5896e0d6c665c601666d2a9abf6aa0cd61a'],1,1,2,305283,1,,,,777
ac2a19f791bfe80ce526139fcc3043f1972b0c34,1,Jeffrey Evan Hammerbacher,2010-02-16 21:00:02+00:00,['f24c33c97cacbab60f6f3f0f5a26cb350c5cce28'],14,104,118,305401,8,,,,778
89d56e9e23bee4db4c19a8f22d755a191e6cf0e5,0,Douglass Cutting,2010-02-16 21:13:16+00:00,['ac2a19f791bfe80ce526139fcc3043f1972b0c34'],0,0,0,305401,0,,,,778
dff585bd6876f20b5148ee2848e42e95d6ae94c2,0,Douglass Cutting,2010-02-16 21:24:06+00:00,['89d56e9e23bee4db4c19a8f22d755a191e6cf0e5'],5,8,13,305414,4,1,1,0,778
c221b63f52afd4d2b2c75b45360eb41bb9e55b7b,1,Douglass Cutting,2010-02-16 22:00:40+00:00,['dff585bd6876f20b5148ee2848e42e95d6ae94c2'],10,24,34,305448,1,,,,778
6595bb6610b4a43060471b4d54d53c1b874fa851,1,Douglass Cutting,2010-02-16 23:06:48+00:00,['c221b63f52afd4d2b2c75b45360eb41bb9e55b7b'],2,3,5,305453,1,,,,778
281f46ff26ed61d76d65cdfbd6e79382a804d236,0,Douglass Cutting,2010-02-19 01:16:53+00:00,['6595bb6610b4a43060471b4d54d53c1b874fa851'],0,2,2,305455,1,,,,778
fcb06cfeebb753332463b4f0ed2b404e2ed3b5f4,0,Douglass Cutting,2010-02-19 01:19:35+00:00,['281f46ff26ed61d76d65cdfbd6e79382a804d236'],0,0,0,305455,0,,,,778
674deee1e61c6ef21041951ad8db0771b4547a75,1,Douglass Cutting,2010-02-19 01:56:28+00:00,['fcb06cfeebb753332463b4f0ed2b404e2ed3b5f4'],2,15,17,305472,2,,,,778
5d523b4d7f0f99cb0d231c05f847cda331d0fb4f,0,Douglass Cutting,2010-02-19 18:39:25+00:00,['674deee1e61c6ef21041951ad8db0771b4547a75'],4,6,10,305482,3,,,,778
be98c2990d9d557e77424c0ea5d7b4b5a279a463,0,Scott Banachowski,2010-02-19 19:21:01+00:00,['5d523b4d7f0f99cb0d231c05f847cda331d0fb4f'],4,10,14,305496,6,,1,,778
03e67154953150c38fbf92e079ada74aec75398d,1,Douglass Cutting,2010-02-19 21:45:10+00:00,['be98c2990d9d557e77424c0ea5d7b4b5a279a463'],351,1897,2248,307744,24,0.472885033,0.765726681,0.819956616,780
2789bebdba3125304cf69747c95e80ba1e98fc67,0,Douglass Cutting,2010-02-19 22:01:56+00:00,['03e67154953150c38fbf92e079ada74aec75398d'],0,3,3,307747,1,,,,780
1e9fe807f93282fe8c98cab35642ca160ec1e368,1,Douglass Cutting,2010-02-19 23:16:57+00:00,['2789bebdba3125304cf69747c95e80ba1e98fc67'],66,413,479,308226,9,0.376190476,0.385714286,1,781
728362023bc6fbef9130e979818aa358c9152635,0,Douglass Cutting,2010-02-20 00:08:00+00:00,['1e9fe807f93282fe8c98cab35642ca160ec1e368'],8,4,12,308238,3,,,,781
af00ca67a7726c88f9e875f242cb09ea5a72f56f,0,Thiruvalluvan M. G,2010-02-21 00:54:29+00:00,['728362023bc6fbef9130e979818aa358c9152635'],1,1,2,308240,1,,,,781
c3a37aae3698172059b0f863d3d9fbdef21f140d,0,Douglass Cutting,2010-02-23 00:21:44+00:00,['af00ca67a7726c88f9e875f242cb09ea5a72f56f'],9,21,30,308270,6,,,,782
d5526daad1db62eec60e793b7278a47413a9e634,1,Matthew Lee Massie,2010-02-23 18:25:43+00:00,['c3a37aae3698172059b0f863d3d9fbdef21f140d'],6,64,70,308340,2,0,0.02173913,0.195652174,782
e5479e7b975bfc7c0251c49ba0bd40a0e1c46edd,0,Matthew Lee Massie,2010-02-23 18:48:03+00:00,['d5526daad1db62eec60e793b7278a47413a9e634'],0,6,6,308346,2,,,,782
e2c272282eb8911e286eb16c98dc2cd844eeae56,0,Douglass Cutting,2010-02-23 21:50:05+00:00,['e5479e7b975bfc7c0251c49ba0bd40a0e1c46edd'],0,4,4,308350,1,,,,782
2b1580376f7ad813683a981657e9a88615397568,0,Douglass Cutting,2010-02-25 00:31:31+00:00,['e2c272282eb8911e286eb16c98dc2cd844eeae56'],2,9,11,308361,2,,,,782
15bc535766bc375840b7f70915f68c1aad71b803,1,Douglass Cutting,2010-02-25 00:55:06+00:00,['2b1580376f7ad813683a981657e9a88615397568'],15,30,45,308406,4,,,,782
306ab962e91355e5d5843f787550ce748d732a38,1,Douglass Cutting,2010-02-25 19:59:57+00:00,['15bc535766bc375840b7f70915f68c1aad71b803'],2,3,5,308411,1,,,,782
65a762048fdf4ece99ebe105466f37861e89d0b2,0,Douglass Cutting,2010-03-02 19:48:54+00:00,['306ab962e91355e5d5843f787550ce748d732a38'],3,6,9,308420,2,,,,782
5dac18f3862ee12ab03f2a94be0f675d7101b40d,0,Douglass Cutting,2010-03-03 00:34:30+00:00,['65a762048fdf4ece99ebe105466f37861e89d0b2'],3,5,8,308428,3,,,,782
40ded25b536fb66d0311a81708fd8ae333122c9c,0,Matthew Lee Massie,2010-03-03 02:47:59+00:00,['5dac18f3862ee12ab03f2a94be0f675d7101b40d'],8,4,12,308440,2,,,,782
cddf986ed92adb768d6a1f8a82a56facb808fefa,0,Douglass Cutting,2010-03-03 23:09:54+00:00,['40ded25b536fb66d0311a81708fd8ae333122c9c'],443,438,881,309321,2,,,,782
5fd2d18c75104effed0bd90f6726d03dba46a723,1,Douglass Cutting,2010-03-03 23:27:48+00:00,['cddf986ed92adb768d6a1f8a82a56facb808fefa'],9,107,116,309437,5,0.545454545,0.931818182,0.954545455,783
4313c25bb307d1c79f64cdb54104ba86a80edc60,1,Douglass Cutting,2010-03-03 23:48:50+00:00,['5fd2d18c75104effed0bd90f6726d03dba46a723'],35,81,116,309553,12,1,1,0.888888889,784
97aa7f54862cb6386af67670ac1ecbccfa792419,1,Matthew Lee Massie,2010-03-04 02:15:53+00:00,['4313c25bb307d1c79f64cdb54104ba86a80edc60'],4,376,380,309933,8,0.21641791,0.694029851,0.138059701,785
9f1d7cdc003a26d0901bd975496bc403061b7003,1,Matthew Lee Massie,2010-03-04 02:38:22+00:00,['97aa7f54862cb6386af67670ac1ecbccfa792419'],9,12,21,309954,3,,,,785
a1368aa02fd7a5882cc0bb916742fcc9d5f0bdb1,0,Matthew Lee Massie,2010-03-04 02:41:03+00:00,['9f1d7cdc003a26d0901bd975496bc403061b7003'],2,5,7,309961,2,,,,785
4ed47ec7f88dca738f6c18c94d294b6fe7dd97b1,0,Matthew Lee Massie,2010-03-04 03:00:55+00:00,['a1368aa02fd7a5882cc0bb916742fcc9d5f0bdb1'],11,6,17,309978,3,,,,785
fc1f019c48bb677b460be103542cce4af12f3f06,0,Matthew Lee Massie,2010-03-04 03:06:06+00:00,['4ed47ec7f88dca738f6c18c94d294b6fe7dd97b1'],9,5,14,309992,6,0.5,0.5,1,785
3d190e5a2a735219cfc2118bbc5d4b297a0bb99a,0,Matthew Lee Massie,2010-03-05 19:38:42+00:00,['fc1f019c48bb677b460be103542cce4af12f3f06'],20,53,73,310065,22,,,,785
114601653caf6a866e6b48f5c0622ed5683827fc,0,Matthew Lee Massie,2010-03-05 19:50:31+00:00,['3d190e5a2a735219cfc2118bbc5d4b297a0bb99a'],5,69,74,310139,14,0.771428571,0.942857143,0.4,785
3c8d3aa06e74b586b8c83d37c110445b4a7e88ee,0,Matthew Lee Massie,2010-03-05 19:54:35+00:00,['114601653caf6a866e6b48f5c0622ed5683827fc'],0,7,7,310146,2,,,,785
cd965b576f92f0ef2261b92ea13a20dcdc813d67,0,Douglass Cutting,2010-03-08 23:09:45+00:00,['3c8d3aa06e74b586b8c83d37c110445b4a7e88ee'],10,10,20,310166,2,,,,785
6513df9bf5b0d7d56cfa48f087dbaee28d622fde,0,Matthew Lee Massie,2010-03-12 18:06:45+00:00,['cd965b576f92f0ef2261b92ea13a20dcdc813d67'],5,7,12,310178,2,,,,785
44fe73d4f54cde76fd8064e930cacd96b78977b1,1,Douglass Cutting,2010-03-12 20:53:17+00:00,['6513df9bf5b0d7d56cfa48f087dbaee28d622fde'],22,22,44,310222,6,,,,785
fe8f2de2ffb39e0fe6d3e633fed4564396d1b5cc,0,Douglass Cutting,2010-03-12 20:58:56+00:00,['44fe73d4f54cde76fd8064e930cacd96b78977b1'],2,2,4,310226,2,,,,785
977cd22c129e69177d6fbf095f7f6ac7462cf1ab,0,Douglass Cutting,2010-03-12 21:13:44+00:00,['fe8f2de2ffb39e0fe6d3e633fed4564396d1b5cc'],1,4,5,310231,2,,,,785
36b5eae90d2f30950ba784cb66b15239c7ed7177,1,Matthew Lee Massie,2010-03-15 22:05:51+00:00,['977cd22c129e69177d6fbf095f7f6ac7462cf1ab'],0,205,205,310436,6,,,,790
69d6017b4de1b0d449b7cf0f7a958546ba1ba897,1,Matthew Lee Massie,2010-03-15 22:38:00+00:00,['36b5eae90d2f30950ba784cb66b15239c7ed7177'],57,71,128,310564,10,1,1,1,791
02471d05b8043553a3f0436d45a96754ef62bb3d,1,Douglass Cutting,2010-03-17 22:30:32+00:00,['69d6017b4de1b0d449b7cf0f7a958546ba1ba897'],5,9,14,310578,1,,,,791
6e01d187db9e6afa423f40779cf8f2ca7597a3a6,1,Douglass Cutting,2010-03-17 22:32:05+00:00,['02471d05b8043553a3f0436d45a96754ef62bb3d'],1,7,8,310586,2,,,,791
3432fe2379f3d9a808a4f7bf02945f5303633b24,0,Matthew Lee Massie,2010-03-17 23:21:15+00:00,['6e01d187db9e6afa423f40779cf8f2ca7597a3a6'],8,10,18,310604,4,,,,791
37300016b27378e870dd6f48108792bc41e8ba3d,1,Matthew Lee Massie,2010-03-18 16:52:11+00:00,['3432fe2379f3d9a808a4f7bf02945f5303633b24'],6,14,20,310624,5,1,1,1,791
cd64e00c18831e2256751042899640e3764605a4,1,Jeffrey Evan Hammerbacher,2010-03-19 08:46:41+00:00,['37300016b27378e870dd6f48108792bc41e8ba3d'],2,11,13,310637,2,0,0,0,791
3131ef1f0ea5ab4bb72541a6a198a45ce0a0d559,0,Jeffrey Evan Hammerbacher,2010-03-19 09:00:27+00:00,['cd64e00c18831e2256751042899640e3764605a4'],10,12,22,310659,3,0,0,0,791
e3123126b5b07d7a71e2e15f838d98f047597554,0,Douglass Cutting,2010-03-24 19:49:36+00:00,['3131ef1f0ea5ab4bb72541a6a198a45ce0a0d559'],7,48,55,310714,5,0.2,0.88,1,791
4e0cc6ed2ae8d93603f9c768aec6a91883a6b7b8,0,Douglass Cutting,2010-03-25 18:46:10+00:00,['e3123126b5b07d7a71e2e15f838d98f047597554'],2,22,24,310738,3,,,,791
f33fb897c762b55b798dc5c43b6995b3c1ff202e,0,Douglass Cutting,2010-03-25 18:53:12+00:00,['4e0cc6ed2ae8d93603f9c768aec6a91883a6b7b8'],1,1,2,310740,1,,,,791
466dc8fc715889dbccd793e7fb7802dfcfe1063d,0,Douglass Cutting,2010-03-25 21:46:34+00:00,['f33fb897c762b55b798dc5c43b6995b3c1ff202e'],1,11,12,310752,2,,,,791
cdeb6ea2198cc94f450ca2ff949c0c198a4f8b00,1,Douglass Cutting,2010-04-01 18:30:36+00:00,['466dc8fc715889dbccd793e7fb7802dfcfe1063d'],0,1155,1155,311907,18,0.851174935,0.960835509,0.856396867,806
492dc3b8f8a1b5dbf98b6c30b79b18ec87e7e89e,0,Jeff Hodges,2010-04-03 02:13:06+00:00,['cdeb6ea2198cc94f450ca2ff949c0c198a4f8b00'],1,94,95,312002,2,0.126582278,0.582278481,1,807
e7456bf58156eaf072e18416e90a6ec2494eae94,1,Jeff Hodges,2010-04-03 02:18:12+00:00,['492dc3b8f8a1b5dbf98b6c30b79b18ec87e7e89e'],17,42,59,312061,2,1,1,0,807
be73ec7ae269c3f503e55211add6b8cf9cb1fe50,0,Jeff Hodges,2010-04-03 02:21:58+00:00,['e7456bf58156eaf072e18416e90a6ec2494eae94'],1,91,92,312153,3,0.35443038,1,1,807
9b8e375aea658b40495f91bfad343464d3824dfa,0,Jeff Hodges,2010-04-03 02:24:36+00:00,['be73ec7ae269c3f503e55211add6b8cf9cb1fe50'],30,4,34,312187,1,0,0,0,807
11dc42ad6478ab67d753a9f1b657cdaba0669b29,0,Jeff Hodges,2010-04-03 23:14:24+00:00,['9b8e375aea658b40495f91bfad343464d3824dfa'],0,6,6,312193,1,,,,807
e18f9ca99b848f301b6349869d2512f706dc73f3,0,Matthew Lee Massie,2010-04-04 15:14:36+00:00,['11dc42ad6478ab67d753a9f1b657cdaba0669b29'],0,7,7,312200,2,0,0,0,807
ed9239ee042925d1d37949e7954ae971fe391fc6,1,Matthew Lee Massie,2010-04-04 15:35:08+00:00,['e18f9ca99b848f301b6349869d2512f706dc73f3'],0,21,21,312221,3,1,1,0,807
a23505906e4fe76706365ff7aa92f386fb6fcf97,0,Jeffrey Evan Hammerbacher,2010-04-05 01:00:22+00:00,['ed9239ee042925d1d37949e7954ae971fe391fc6'],3,3,6,312227,2,0,0,1,807
f85120ba79690dc094ea33606facda1db19631ae,1,Scott Banachowski,2010-04-05 17:03:42+00:00,['a23505906e4fe76706365ff7aa92f386fb6fcf97'],51,53,104,312331,9,0.5,1,1,807
5c7b7486d1cbedbc006d5e9a7dfbcea7678a8311,1,Jeff Hodges,2010-04-06 05:52:09+00:00,['f85120ba79690dc094ea33606facda1db19631ae'],9,266,275,312606,4,1,1,1,809
ff664ef8a34de6dac9044875d4059c1493ce6528,1,Jeff Hodges,2010-04-06 05:55:56+00:00,['5c7b7486d1cbedbc006d5e9a7dfbcea7678a8311'],2,2,4,312610,1,,,,809
e1311b64517df7b121eb4878b8bde174db88f0cf,1,Jeff Hodges,2010-04-07 04:54:12+00:00,['ff664ef8a34de6dac9044875d4059c1493ce6528'],20,16,36,312646,1,0.8,0.8,0,809
0ac105e163d7fe4feaabc3d00521cf7e1d7d78d2,1,Scott Banachowski,2010-04-08 16:48:19+00:00,['e1311b64517df7b121eb4878b8bde174db88f0cf'],413,3451,3864,316510,29,0.065934066,1,1,819
87b64a3b0530a433520bd32ca81858207bd64588,0,Scott Banachowski,2010-04-11 17:45:14+00:00,['0ac105e163d7fe4feaabc3d00521cf7e1d7d78d2'],7,282,289,316799,13,1,1,1,820
8c1db2821e3a0e87e7ab96498d4be14cb75f49d7,0,Jeff Hodges,2010-04-12 09:16:56+00:00,['87b64a3b0530a433520bd32ca81858207bd64588'],8,10,18,316817,4,1,1,,820
48da0df6c57ad2fd51ed91a971b44b415e17de4d,0,Jeff Hodges,2010-04-12 10:29:05+00:00,['8c1db2821e3a0e87e7ab96498d4be14cb75f49d7'],2,29,31,316848,3,1,1,1,821
bc40723fc8aeeb0b57d83e8b2cbe1377d4a1ebe3,0,Jeff Hodges,2010-04-12 10:29:08+00:00,['48da0df6c57ad2fd51ed91a971b44b415e17de4d'],1,1,2,316850,1,,,,821
754bbd5a43f0156acaeb84bc2573274be1da8a69,0,Jeff Hodges,2010-04-12 10:37:43+00:00,['bc40723fc8aeeb0b57d83e8b2cbe1377d4a1ebe3'],2,3,5,316855,1,,,,821
9e422555234952d9d7090d14d86eb25e8114c586,0,Scott Banachowski,2010-04-17 16:33:09+00:00,['754bbd5a43f0156acaeb84bc2573274be1da8a69'],2,120,122,316977,5,,,,822
66243cb6fd778eeb5c2dc960b0430584088fc943,0,Scott Banachowski,2010-04-18 17:18:17+00:00,['9e422555234952d9d7090d14d86eb25e8114c586'],526,288,814,317791,19,0,0.521126761,0,822
1857557df701c5c27093dd2762cd60110f06a5f3,0,Thiruvalluvan M. G,2010-04-19 11:10:58+00:00,['66243cb6fd778eeb5c2dc960b0430584088fc943'],1,35,36,317827,4,0.4,1,1,822
3b1b3f0d79608c32df9acebcac1dd757ea3fef24,0,Thiruvalluvan M. G,2010-04-23 14:02:27+00:00,['1857557df701c5c27093dd2762cd60110f06a5f3'],44,63,107,317934,4,0,1,1,822
00c23392cc9a6a902217d58a5f20360163b61450,1,Thiruvalluvan M. G,2010-04-27 08:04:08+00:00,['3b1b3f0d79608c32df9acebcac1dd757ea3fef24'],6,5,11,317945,2,1,0,0,822
93a483eb1efafadd9cac2e104ecbe31ae2b9451d,0,Jeff Hodges,2010-04-27 17:34:19+00:00,['00c23392cc9a6a902217d58a5f20360163b61450'],7,12,19,317964,6,0,0,0,822
bbcfd0b3e23062b1f33e9f81eb94ff0c2093ad41,1,Jeff Hodges,2010-05-05 06:49:21+00:00,['93a483eb1efafadd9cac2e104ecbe31ae2b9451d'],0,128,128,318092,1,0.543209877,0.543209877,0.666666667,823
0c4cb52cbdc1b12732ec154dcfc70594ea9e9088,0,Jeffrey Evan Hammerbacher,2010-05-07 07:36:19+00:00,['bbcfd0b3e23062b1f33e9f81eb94ff0c2093ad41'],5,2,7,318099,5,,,,823
7a42efd0d6c07d85f89c46ced85bf3949f60fc02,0,Jeffrey Evan Hammerbacher,2010-05-07 07:53:29+00:00,['0c4cb52cbdc1b12732ec154dcfc70594ea9e9088'],8,14,22,318121,2,,,,823
3f7443f350516b697e9e409c757c432be4540662,0,Jeffrey Evan Hammerbacher,2010-05-07 08:03:11+00:00,['7a42efd0d6c07d85f89c46ced85bf3949f60fc02'],1,3,4,318125,2,,,,823
0fa29793bb738f3b1848063806c6fb53d44fca01,0,Jeffrey Evan Hammerbacher,2010-05-07 08:09:28+00:00,['3f7443f350516b697e9e409c757c432be4540662'],6,9,15,318140,1,,,,823
c22739175bc664887b4195f58cdec1e63e15959e,0,Douglass Cutting,2010-05-07 18:23:32+00:00,['0fa29793bb738f3b1848063806c6fb53d44fca01'],3,3,6,318146,1,,,,823
d77c7ecb8e3438e4ca4b25dd28373b3ae05a5c49,0,Joe Schaefer,2010-05-10 21:58:52+00:00,['c22739175bc664887b4195f58cdec1e63e15959e'],0,0,0,318146,0,,,,823
627d42de01bbd935ac469ff0ca0af135b75cef1e,0,Douglass Cutting,2010-05-13 21:56:34+00:00,['d77c7ecb8e3438e4ca4b25dd28373b3ae05a5c49'],2,34,36,318182,5,1,1,1,823
0d274c9617ee25f51abfcef572e881b93e8216b7,0,Douglass Cutting,2010-05-13 22:26:42+00:00,['627d42de01bbd935ac469ff0ca0af135b75cef1e'],3,18,21,318203,2,0,1,1,823
dd7d8f60f47002c6c785c59783b66ea5abf4bc60,1,Douglass Cutting,2010-05-13 23:01:20+00:00,['0d274c9617ee25f51abfcef572e881b93e8216b7'],111,347,458,318661,23,0.6796875,0.7890625,0.6953125,823
c2d9f070a66e2dd4203a8474ff8d53e4a6e0f406,0,Douglass Cutting,2010-05-13 23:02:31+00:00,['dd7d8f60f47002c6c785c59783b66ea5abf4bc60'],0,3,3,318664,1,,,,823
4c8ef34d89fd8ff2277c901a092c961bebe3269a,1,Jeff Hodges,2010-05-19 22:30:11+00:00,['c2d9f070a66e2dd4203a8474ff8d53e4a6e0f406'],57,62,119,318783,4,1,1,0,823
e70a61217cd55cf6449b814b49a02939363b120d,0,Bruce Mitchener Jr,2010-05-22 14:15:55+00:00,['4c8ef34d89fd8ff2277c901a092c961bebe3269a'],134,584,718,319501,19,0.290836653,0.804780876,0.717131474,825
37f6d5bc4ffdb794c4a7e03c5e2dd073c6d50cf4,0,Bruce Mitchener Jr,2010-05-23 09:06:55+00:00,['e70a61217cd55cf6449b814b49a02939363b120d'],162,347,509,320010,14,1,1,1,829
9c81a5237f5c72819ec66e8e7a1e87f3c71afc35,0,Bruce Mitchener Jr,2010-05-23 09:11:36+00:00,['37f6d5bc4ffdb794c4a7e03c5e2dd073c6d50cf4'],1,1,2,320012,1,,,,829
a2365d95f8b7a8d20730a44654b2a20215bf9156,0,Jeffrey Evan Hammerbacher,2010-05-24 10:15:54+00:00,['9c81a5237f5c72819ec66e8e7a1e87f3c71afc35'],1,4,5,320017,2,,,,829
e9c1d6396e4178b837181a624b65a958af03fd34,0,Jeffrey Evan Hammerbacher,2010-05-24 20:32:34+00:00,['a2365d95f8b7a8d20730a44654b2a20215bf9156'],0,2,2,320019,1,,,,829
9c3095aeab368e4984fde046e10d0c274cf240c0,0,Bruce Mitchener Jr,2010-05-25 08:40:25+00:00,['e9c1d6396e4178b837181a624b65a958af03fd34'],87,327,414,320433,20,0.467532468,0.948051948,0.974025974,834
b79cc95f1c33e84ec79c32abddf7bb2551440f0d,0,Bruce Mitchener Jr,2010-05-29 15:05:13+00:00,['9c3095aeab368e4984fde046e10d0c274cf240c0'],0,32,32,320465,2,,,,834
7eaba5aa09a2bff529590a1c309b9575a25a497e,0,Jeff Hodges,2010-05-30 04:59:00+00:00,['b79cc95f1c33e84ec79c32abddf7bb2551440f0d'],0,51,51,320516,4,,,,834
5949f5e5a36e47dc613b250a9b7f279f306240d0,0,Jeff Hodges,2010-06-01 03:37:29+00:00,['7eaba5aa09a2bff529590a1c309b9575a25a497e'],1,27,28,320544,3,0,1,1,834
3604f4fd70c81c782d26b7f7b0c2d6fa54240ae2,1,Douglass Cutting,2010-06-03 23:47:45+00:00,['5949f5e5a36e47dc613b250a9b7f279f306240d0'],3,5,8,320552,1,,,,834
1b5c4e428e3ac83bee7d0a73e518880819f34541,0,Douglass Cutting,2010-06-03 23:53:26+00:00,['3604f4fd70c81c782d26b7f7b0c2d6fa54240ae2'],2,2,4,320556,1,,,,834
cb3dab05528ea8597fa41d4c09618b2907d544d8,0,Douglass Cutting,2010-06-03 23:59:54+00:00,['1b5c4e428e3ac83bee7d0a73e518880819f34541'],4,5,9,320565,1,,,,834
8dfd1a6027d2c293fac298c3197567b80c2f0402,1,Jeffrey Evan Hammerbacher,2010-06-04 00:05:55+00:00,['cb3dab05528ea8597fa41d4c09618b2907d544d8'],11,35,46,320611,5,0.75,1,0.75,834
9b31fdd70fcd6aa0bac31f6d91256d1df81a86c8,1,Jeffrey Evan Hammerbacher,2010-06-04 00:57:23+00:00,['8dfd1a6027d2c293fac298c3197567b80c2f0402'],0,7,7,320618,2,1,1,0,834
05cc368353d72c798b261d9dbfcee05d8c7cdaa5,0,Jeff Hodges,2010-06-04 06:41:32+00:00,['9b31fdd70fcd6aa0bac31f6d91256d1df81a86c8'],4,9,13,320631,2,,,,834
a4c97afaf377cb1461faee2654a1a7c00e0a92c1,0,Jeffrey Evan Hammerbacher,2010-06-04 21:49:58+00:00,['05cc368353d72c798b261d9dbfcee05d8c7cdaa5'],3,6,9,320640,1,,,,834
2660351b81bb6ea57f5c8c33a935600132db1d57,0,Scott Banachowski,2010-06-05 05:31:10+00:00,['a4c97afaf377cb1461faee2654a1a7c00e0a92c1'],8,6,14,320654,2,,,,834
af73cd3f2d5249dd386dc299a9d4d1e4f9b3bec2,0,Douglass Cutting,2010-06-07 17:52:50+00:00,['2660351b81bb6ea57f5c8c33a935600132db1d57'],5,11,16,320670,1,,,,834
bed2354c5d0f773aedffc5299b4e18554e0b28ed,0,Douglass Cutting,2010-06-07 17:57:01+00:00,['af73cd3f2d5249dd386dc299a9d4d1e4f9b3bec2'],0,4,4,320674,2,,,,834
3c71a148c09d3951aaabdb7dcf6639d70905016f,0,Jeffrey Evan Hammerbacher,2010-06-09 22:48:58+00:00,['bed2354c5d0f773aedffc5299b4e18554e0b28ed'],34,42,76,320750,1,,,,834
50755b27a23a8ae8968f1126dbcff5ad91dd0a9f,1,Jeffrey Evan Hammerbacher,2010-06-09 23:17:54+00:00,['3c71a148c09d3951aaabdb7dcf6639d70905016f'],2,13,15,320765,2,1,1,0,834
7da52d806e8ad31fe039140e461ab7986fa7d948,1,Jeffrey Evan Hammerbacher,2010-06-10 00:00:17+00:00,['50755b27a23a8ae8968f1126dbcff5ad91dd0a9f'],55,301,356,321121,5,0,0.138461538,0.092307692,834
e6407b570ecbb06e93efe178194bd3fe33bfb0e5,1,Jeffrey Evan Hammerbacher,2010-06-10 04:33:48+00:00,['7da52d806e8ad31fe039140e461ab7986fa7d948'],63,110,173,321294,5,,,,834
2bce9ea43fada2e40501477af25c94c0f5fa771e,0,Douglass Cutting,2010-06-10 22:35:40+00:00,['e6407b570ecbb06e93efe178194bd3fe33bfb0e5'],2,15,17,321311,2,,,,834
cac9e93d3984bf05f67c86fba0d7024b82469ae1,1,Douglass Cutting,2010-06-15 18:21:18+00:00,['2bce9ea43fada2e40501477af25c94c0f5fa771e'],66,1839,1905,323216,37,0.590711176,0.837445573,0.680696662,852
2ca528fa31870b767f7d89550d8781c40c6b8bcf,0,Douglass Cutting,2010-06-15 21:50:28+00:00,['cac9e93d3984bf05f67c86fba0d7024b82469ae1'],0,140,140,323356,3,0.704225352,1,0.929577465,853
76bf17aaebe0ac8a6bd3d0c787a9e4616a00f5b1,0,Douglass Cutting,2010-06-15 21:51:00+00:00,['2ca528fa31870b767f7d89550d8781c40c6b8bcf'],0,3,3,323359,1,,,,853
3e8840cd1454bb16d170c9dec2b1f2b40171bdc8,0,Douglass Cutting,2010-06-15 22:58:50+00:00,['76bf17aaebe0ac8a6bd3d0c787a9e4616a00f5b1'],0,0,0,323359,1,,,,853
bbb830dff638cb1e80395941db1d0e0b58103eff,1,Douglass Cutting,2010-06-15 23:36:51+00:00,['3e8840cd1454bb16d170c9dec2b1f2b40171bdc8'],18,63,81,323440,4,0.09375,1,1,853
5874b2ab91721eaae00afb492b5b52bf58e0335f,1,Jeffrey Evan Hammerbacher,2010-06-16 05:24:44+00:00,['bbb830dff638cb1e80395941db1d0e0b58103eff'],23,27,50,323490,3,0,0,0,853
9c56ed4e8af0f977fe76f82d231757c2563d2094,1,Douglass Cutting,2010-06-18 19:06:15+00:00,['5874b2ab91721eaae00afb492b5b52bf58e0335f'],8,248,256,323746,6,0.036697248,1,0.431192661,855
26fb764f5bbf47abd0531c1e8633386171c1e1bf,1,Douglass Cutting,2010-06-18 19:18:44+00:00,['9c56ed4e8af0f977fe76f82d231757c2563d2094'],61,64,125,323871,20,,,,855
5cbc5e25099098ff17761b21fedc3581b27d05fc,0,Philip Zeyliger,2010-06-24 22:03:17+00:00,['26fb764f5bbf47abd0531c1e8633386171c1e1bf'],5,172,177,324048,4,0.627906977,0.441860465,1,856
0fcfe2863c26eb73d5cec07a6d552b0d130f362b,1,Douglass Cutting,2010-06-25 23:40:37+00:00,['5cbc5e25099098ff17761b21fedc3581b27d05fc'],31,123,154,324202,8,0,0.755102041,1,856
14b6af1c75a552e6d0718a1e9fde95f18a394bc3,1,Douglass Cutting,2010-07-01 20:17:27+00:00,['0fcfe2863c26eb73d5cec07a6d552b0d130f362b'],70,138,208,324410,7,,,,856
f739842c9055909dbd9bf8fc6e49dcd34661b84f,1,Douglass Cutting,2010-07-01 21:25:01+00:00,['14b6af1c75a552e6d0718a1e9fde95f18a394bc3'],5,713,718,325128,9,0.611295681,1,0.813953488,862
7f5901e8bdc281305ab29a32fd5630c5024b4feb,1,Thiruvalluvan M. G,2010-07-05 03:17:04+00:00,['f739842c9055909dbd9bf8fc6e49dcd34661b84f'],3,17,20,325148,4,0,1,1,862
d4a3c058e80030e85eb5dbe4b9d2a44819b22202,1,Douglass Cutting,2010-07-19 22:09:48+00:00,['7f5901e8bdc281305ab29a32fd5630c5024b4feb'],16,54,70,325218,23,0.9,1,0.9,862
76088c6238f58ba05a5c891e3439b288ef0d0bc5,1,Douglass Cutting,2010-07-20 20:55:26+00:00,['d4a3c058e80030e85eb5dbe4b9d2a44819b22202'],24,30,54,325272,3,,,,862
905586f88119ff02fb5eb9c3c713c6f6bad2301d,0,Philip Zeyliger,2010-07-21 18:15:08+00:00,['76088c6238f58ba05a5c891e3439b288ef0d0bc5'],71,397,468,325740,7,0.473684211,0.821052632,1,862
a90142c5321e6d48b46da96bc11fb56389cb6bb0,0,Douglass Cutting,2010-07-21 21:06:36+00:00,['905586f88119ff02fb5eb9c3c713c6f6bad2301d'],397,71,468,326208,7,0.526315789,0.178947368,0,862
ce35df9fb9c907883e9cede03109765e900248e7,1,Douglass Cutting,2010-07-21 21:14:29+00:00,['a90142c5321e6d48b46da96bc11fb56389cb6bb0'],442,1225,1667,327875,39,0.746081505,1,0.890282132,876
1c37d4cee7042d64acc446007b30c99357c158b9,0,Douglass Cutting,2010-07-23 18:13:48+00:00,['ce35df9fb9c907883e9cede03109765e900248e7'],1,6,7,327882,2,0,0,1,876
0457a5785252d997d93cebb4c275e2a355577d75,1,Philip Zeyliger,2010-07-28 19:28:53+00:00,['1c37d4cee7042d64acc446007b30c99357c158b9'],71,1794,1865,329747,18,0.697644812,0.645448759,0.812858052,887
2dc24e02526e29a3bd385276d7db162f8624fc65,1,Douglass Cutting,2010-07-28 19:44:50+00:00,['0457a5785252d997d93cebb4c275e2a355577d75'],5,79,84,329831,7,0.98,0.48,0.88,887
53aca6d7e502e83f1c38e8926ae671b026bd3872,1,Douglass Cutting,2010-08-03 22:48:57+00:00,['2dc24e02526e29a3bd385276d7db162f8624fc65'],40,79,119,329950,3,0.428571429,0.523809524,1,887
cc369c8d7ac793349eecf0fcdfe1ee82f79c6f88,0,Douglass Cutting,2010-08-03 23:03:14+00:00,['53aca6d7e502e83f1c38e8926ae671b026bd3872'],0,9,9,329959,2,0,0,1,887
5aa8b0cccef971441fcda29b86eee652ee6884a3,0,Douglass Cutting,2010-08-03 23:09:42+00:00,['cc369c8d7ac793349eecf0fcdfe1ee82f79c6f88'],1,4,5,329964,2,,,,887
2182b994ccaaeff046c37965d99a75a6709aa692,0,Douglass Cutting,2010-08-03 23:20:35+00:00,['5aa8b0cccef971441fcda29b86eee652ee6884a3'],12,24,36,330000,4,1,1,1,887
4c6d01f9bc333e20cf44f603804ce28bc7612501,0,Douglass Cutting,2010-08-04 18:50:54+00:00,['2182b994ccaaeff046c37965d99a75a6709aa692'],6,12,18,330018,2,,,,887
819709d877b8f21d4c680d8d1a91f70cfd6bbadb,1,Philip Zeyliger,2010-08-05 00:07:24+00:00,['4c6d01f9bc333e20cf44f603804ce28bc7612501'],4,2467,2471,332489,17,0.263377926,0.777591973,0.905518395,902
a71d0cf565522bac947fd25f8da16e90d59b4b81,0,Douglass Cutting,2010-08-05 19:28:52+00:00,['819709d877b8f21d4c680d8d1a91f70cfd6bbadb'],3,4,7,332496,2,,,,902
de5d14395bed3d9eeae07c7a1d60975b6778e3d2,1,Douglass Cutting,2010-08-10 17:09:04+00:00,['a71d0cf565522bac947fd25f8da16e90d59b4b81'],140,188,328,332824,28,0.545454545,0.818181818,1,903
d7041830569503ca674fe0600c0d18f3707779cd,0,Douglass Cutting,2010-08-10 21:56:44+00:00,['de5d14395bed3d9eeae07c7a1d60975b6778e3d2'],2,6,8,332832,3,0,1,0,903
de72584e5d5262f3c28f4b7be7ffd719482484d1,1,Douglass Cutting,2010-08-10 22:19:05+00:00,['d7041830569503ca674fe0600c0d18f3707779cd'],46,328,374,333206,5,0.729885057,0.948275862,0.942528736,904
230b96c418e4638d8529e1adbe61a195f142f0cd,0,Douglass Cutting,2010-08-12 01:12:23+00:00,['de72584e5d5262f3c28f4b7be7ffd719482484d1'],1,69,70,333276,5,0.277777778,0.055555556,0.333333333,904
5b06c3290bd7f43e9a1061aed66e1f751b885e05,1,Philip Zeyliger,2010-08-13 20:58:13+00:00,['230b96c418e4638d8529e1adbe61a195f142f0cd'],13,667,680,333956,11,0.353623188,0.597101449,0.889855072,906
e213cfe5d3614e2826c87ea604796838e428ce9e,1,Douglass Cutting,2010-08-17 19:09:44+00:00,['5b06c3290bd7f43e9a1061aed66e1f751b885e05'],7,262,269,334225,5,0.321428571,0.479591837,0.479591837,906
8349f69f13cafcb3b8de4e004725a85d6bdbc65c,0,Douglass Cutting,2010-08-17 19:35:25+00:00,['e213cfe5d3614e2826c87ea604796838e428ce9e'],1,11,12,334237,2,1,1,1,906
a3a4644d45779fddb50789f7ea48ddaa2d1f1afc,1,Douglass Cutting,2010-08-18 21:24:18+00:00,['8349f69f13cafcb3b8de4e004725a85d6bdbc65c'],23,178,201,334438,9,0,0,0,910
094c95b0a7ce084a1dd97776bc67d0f84786af08,0,Douglass Cutting,2010-08-18 21:28:45+00:00,['a3a4644d45779fddb50789f7ea48ddaa2d1f1afc'],2,26,28,334466,5,,,,910
7afee340172a95bf1d7df4038ce615448f719a0d,0,Douglass Cutting,2010-08-18 21:35:15+00:00,['094c95b0a7ce084a1dd97776bc67d0f84786af08'],0,18,18,334484,3,0.666666667,1,1,910
77a7965f776d2e6932d0abaac69c0747ac33d2d6,0,Douglass Cutting,2010-08-18 21:44:22+00:00,['7afee340172a95bf1d7df4038ce615448f719a0d'],22,55,77,334561,3,0.793103448,0.862068966,0.689655172,910
8a0ee2eea940e235ec42f0203b293fc7c155f7ca,0,Philip Zeyliger,2010-08-19 22:47:29+00:00,['77a7965f776d2e6932d0abaac69c0747ac33d2d6'],4,6,10,334571,3,,,,910
ec468882133c8ed33b3eeee9243b38f152727781,1,Philip Zeyliger,2010-08-20 15:22:10+00:00,['8a0ee2eea940e235ec42f0203b293fc7c155f7ca'],55,88,143,334714,7,0.590909091,0.772727273,1,910
c62f97dd29b803040d573845f335ac1ecaa765d7,1,Philip Zeyliger,2010-08-23 06:57:37+00:00,['ec468882133c8ed33b3eeee9243b38f152727781'],79,2212,2291,337005,25,0.666666667,0.691835482,0.815837937,924
b2c40ab4701dbc1fd7a2968afd69ee431a96beef,0,Douglass Cutting,2010-08-23 17:52:31+00:00,['c62f97dd29b803040d573845f335ac1ecaa765d7'],1,4,5,337010,1,,,,924
0f0875da373007f87acd3ad6a8bd88b9b747494d,0,Douglass Cutting,2010-08-23 19:18:15+00:00,['b2c40ab4701dbc1fd7a2968afd69ee431a96beef'],1,57,58,337068,3,0,1,1,924
18249237dc0ff1623c14239519d798963ef93269,0,Douglass Cutting,2010-08-23 20:39:16+00:00,['0f0875da373007f87acd3ad6a8bd88b9b747494d'],0,37,37,337105,2,0,0.485714286,0.485714286,924
19dccec28aeb48d40b403de97502df1490e17f67,0,Douglass Cutting,2010-08-23 20:42:19+00:00,['18249237dc0ff1623c14239519d798963ef93269'],0,2,2,337107,1,,,,924
bb4d21dec8fd0ab0ae233332197b90a783218082,1,Douglass Cutting,2010-08-23 20:52:09+00:00,['19dccec28aeb48d40b403de97502df1490e17f67'],28,40,68,337175,5,,,,924
4d31386d2a9c184b349a6f50b45bcdf73e7bb3f7,1,Philip Zeyliger,2010-08-24 04:37:30+00:00,['bb4d21dec8fd0ab0ae233332197b90a783218082'],156,134,290,337465,5,1,1,0.392857143,924
94c4c520a055d7e32dde19bdafac8c6ccfd72d08,0,Philip Zeyliger,2010-08-24 05:02:37+00:00,['4d31386d2a9c184b349a6f50b45bcdf73e7bb3f7'],2,34,36,337501,3,1,1,1,925
35bb270f96850e789372c9e68855a9727e64aa9c,1,Douglass Cutting,2010-08-24 21:22:52+00:00,['94c4c520a055d7e32dde19bdafac8c6ccfd72d08'],144,197,341,337842,5,1,1,1,925
ce397913a36beaf1077aa2f98cab98f9b2a0a45a,1,Douglass Cutting,2010-08-25 17:43:11+00:00,['35bb270f96850e789372c9e68855a9727e64aa9c'],3,39,42,337884,4,0.875,0.875,1,926
e0bbd4f474776009648b4f8389deefccbefb39a9,0,Douglass Cutting,2010-08-25 17:51:13+00:00,['ce397913a36beaf1077aa2f98cab98f9b2a0a45a'],1,48,49,337933,6,0.857142857,0.857142857,0.642857143,926
6593926aed7eb2a142e32d2d58894738c3de0f51,1,Douglass Cutting,2010-08-25 18:46:06+00:00,['e0bbd4f474776009648b4f8389deefccbefb39a9'],1271,364,1635,339568,37,0.611731844,0.148044693,0.203910615,926
8c2d1e975ddb3516e2c42de73d78f3d40556c13b,1,Douglass Cutting,2010-08-25 21:38:55+00:00,['6593926aed7eb2a142e32d2d58894738c3de0f51'],4,16,20,339588,2,0,0.888888889,0.666666667,926
5355146c7a871aa70d4f8ed1ad6d82de516f1b96,1,Douglass Cutting,2010-08-26 00:03:34+00:00,['8c2d1e975ddb3516e2c42de73d78f3d40556c13b'],11,20,31,339619,7,1,0.6,1,926
4537345e599d764591ff4ccb2fd8e11efe5cbc67,0,Douglass Cutting,2010-08-26 00:19:28+00:00,['5355146c7a871aa70d4f8ed1ad6d82de516f1b96'],0,4,4,339623,2,0,0,1,926
61a54e4487501db5ce5ce3447363560fb0d880d6,0,Jeff Hodges,2010-08-26 19:26:29+00:00,['4537345e599d764591ff4ccb2fd8e11efe5cbc67'],3,33,36,339659,3,0.19047619,1,1,926
c6cbf0b58c33dfc1db464aa439679e828dec7b3f,1,Douglass Cutting,2010-08-26 21:15:02+00:00,['61a54e4487501db5ce5ce3447363560fb0d880d6'],10,415,425,340084,5,1,1,0.736111111,929
5a7bae1a5937682448a0b67ad0aaf19b7da49279,0,Douglass Cutting,2010-08-26 23:11:47+00:00,['c6cbf0b58c33dfc1db464aa439679e828dec7b3f'],0,92,92,340176,6,,,,929
5d2ea9dc0e8ebbdeb3a99f47869ce245a4d4d441,1,Philip Zeyliger,2010-08-27 00:58:56+00:00,['5a7bae1a5937682448a0b67ad0aaf19b7da49279'],32,172,204,340380,9,1,1,1,930
bdedfc82349d9c3c4fa6fe8e55acefddd7a4d0b7,0,Douglass Cutting,2010-08-27 20:51:33+00:00,['5d2ea9dc0e8ebbdeb3a99f47869ce245a4d4d441'],3,11,14,340394,2,1,1,1,930
72d74a4d1548083846adc8f18fa53881b713df8c,0,Douglass Cutting,2010-08-27 20:52:45+00:00,['bdedfc82349d9c3c4fa6fe8e55acefddd7a4d0b7'],7,6,13,340407,3,,,,930
90e38800b75f2ddc58a8ccb4fe160a060a419b6a,0,Douglass Cutting,2010-08-27 20:54:21+00:00,['72d74a4d1548083846adc8f18fa53881b713df8c'],0,17,17,340424,1,,,,930
db2aff843fca366f96f98e3830811a4c0cfabbd1,0,Douglass Cutting,2010-08-27 21:05:59+00:00,['90e38800b75f2ddc58a8ccb4fe160a060a419b6a'],1,1,2,340426,1,,,,930
91b8e3c3df7ac9afe8b45e9d6c713686fab49b55,1,Philip Zeyliger,2010-08-27 23:33:28+00:00,['db2aff843fca366f96f98e3830811a4c0cfabbd1'],3,277,280,340706,8,0.522058824,0.875,1,933
5bc80f6428c46f41e88ce70f8f23866da762f70f,0,Douglass Cutting,2010-08-30 16:29:49+00:00,['91b8e3c3df7ac9afe8b45e9d6c713686fab49b55'],3,11,14,340720,1,,,,933
2b664be8e81f68125e14b3b920ce5980fbd00120,1,Douglass Cutting,2010-08-30 16:36:31+00:00,['5bc80f6428c46f41e88ce70f8f23866da762f70f'],64,57,121,340841,10,0,0,0,933
3418c6ed05c8bafaad7c3f4e94584aa6ac6e50e3,1,Douglass Cutting,2010-08-30 16:50:40+00:00,['2b664be8e81f68125e14b3b920ce5980fbd00120'],0,6193,6193,347034,26,0.527150917,0.870944993,0.816643159,956
7d9919f7d80450bb7a7c0116820484d16444b6ae,0,Douglass Cutting,2010-08-30 17:14:06+00:00,['3418c6ed05c8bafaad7c3f4e94584aa6ac6e50e3'],1,8,9,347043,2,,,,956
fdfd71874ee5a66580dfabd27551ac3c2150c286,0,Douglass Cutting,2010-08-30 17:20:08+00:00,['7d9919f7d80450bb7a7c0116820484d16444b6ae'],2,0,2,347045,1,,,,956
679c5317c3b60f7cb4ca7b799fdf97edf80c3e98,1,Douglass Cutting,2010-08-30 17:41:20+00:00,['fdfd71874ee5a66580dfabd27551ac3c2150c286'],1,1,2,347047,1,,,,956
3af2f76c6d3f62785d4017c127b0a0657870eb03,0,Douglass Cutting,2010-08-30 23:45:37+00:00,['679c5317c3b60f7cb4ca7b799fdf97edf80c3e98'],1,13,14,347061,3,,,,956
cac87ab452a3b1ab60f02730db30e7b4977dae30,0,Douglass Cutting,2010-09-01 03:20:12+00:00,['3af2f76c6d3f62785d4017c127b0a0657870eb03'],1,1,2,347063,1,,,,956
825c34115bfbd2e97fbd519ce9cb8e303c8a4e08,0,Douglass Cutting,2010-09-02 23:02:12+00:00,['cac87ab452a3b1ab60f02730db30e7b4977dae30'],1,4,5,347068,2,,,,956
73feedb2d246bc9e89259e96a35e869e166fe248,0,Douglass Cutting,2010-09-02 23:11:24+00:00,['825c34115bfbd2e97fbd519ce9cb8e303c8a4e08'],0,39,39,347107,3,0.172413793,1,1,956
8fed51d2d0faf08c744611b6feef61f853d43244,1,Douglass Cutting,2010-09-03 01:27:09+00:00,['73feedb2d246bc9e89259e96a35e869e166fe248'],6,15,21,347128,2,0,1,1,956
a3d6e2d839e1c1eeb81a08fdd1d3ad199326aee0,0,Jeffrey Evan Hammerbacher,2010-09-12 23:48:18+00:00,['8fed51d2d0faf08c744611b6feef61f853d43244'],1,3,4,347132,2,0,0,1,956
9b6148ddf8b1b7a231f06cdb41bb70fe263d48fc,0,Douglass Cutting,2010-09-13 18:58:14+00:00,['a3d6e2d839e1c1eeb81a08fdd1d3ad199326aee0'],5,5,10,347142,3,,,,956
9e3d6fd35ac79736f6339cedc5d94fe13d2f3fab,0,Douglass Cutting,2010-09-13 19:04:29+00:00,['9b6148ddf8b1b7a231f06cdb41bb70fe263d48fc'],3,7,10,347152,2,,,,956
1086f2ae3dc617dfcb8fec7333d62e3e72217ac7,1,Douglass Cutting,2010-09-13 19:21:10+00:00,['9e3d6fd35ac79736f6339cedc5d94fe13d2f3fab'],45,104,149,347301,6,0.416666667,0,1,956
25dabab47a6dcdaee4c291b47467b0e63a850357,0,Thiruvalluvan M. G,2010-09-14 12:48:38+00:00,['1086f2ae3dc617dfcb8fec7333d62e3e72217ac7'],2,15,17,347318,3,,,,956
3efcc1ed043bc4f9866a34d9d9206f75a8e0b905,1,Scott Carey,2010-09-17 01:41:49+00:00,['25dabab47a6dcdaee4c291b47467b0e63a850357'],12,70,82,347400,3,0.333333333,0.846153846,0.897435897,956
f9c3ccc83b9b5f89c786a593c9bc23af10209f00,1,Douglass Cutting,2010-09-17 22:02:48+00:00,['3efcc1ed043bc4f9866a34d9d9206f75a8e0b905'],12,888,900,348300,8,0.513002364,0.728132388,0.903073286,961
13bf69f3eda8d6046a61ffb3bf281e3dde3298f4,1,Douglass Cutting,2010-09-17 22:22:35+00:00,['f9c3ccc83b9b5f89c786a593c9bc23af10209f00'],12,514,526,348826,10,0.557823129,1,0.965986395,966
3397abb9d37d1a84a9d26c2e90558fc4e4be26d9,1,Philip Zeyliger,2010-09-20 17:10:18+00:00,['13bf69f3eda8d6046a61ffb3bf281e3dde3298f4'],12,67,79,348905,4,0.106382979,0,0.446808511,966
13c020ed4a76f0da417cd72416cf96aabcee75cc,0,Douglass Cutting,2010-09-21 19:20:38+00:00,['3397abb9d37d1a84a9d26c2e90558fc4e4be26d9'],1,2,3,348908,1,,,,966
1ff170419245138b875bc315cdf51d51f34955cd,0,Douglass Cutting,2010-09-21 19:23:24+00:00,['13c020ed4a76f0da417cd72416cf96aabcee75cc'],20,76,96,349004,8,1,1,0.833333333,966
b56ff0fecbf61869aa29d319f575187c0ef4f8b8,0,Philip Zeyliger,2010-09-30 17:43:53+00:00,['1ff170419245138b875bc315cdf51d51f34955cd'],0,87,87,349091,3,,,,968
4bcde0be98a25e6246b8e56bd0786c75791401ec,1,Matthew Lee Massie,2010-10-05 22:57:17+00:00,['b56ff0fecbf61869aa29d319f575187c0ef4f8b8'],2,39,41,349132,3,0,1,0.928571429,968
b5097567812c1e09e91cc610bd0860c7cd16df4b,0,Douglass Cutting,2010-10-07 21:31:15+00:00,['4bcde0be98a25e6246b8e56bd0786c75791401ec'],5,39,44,349176,3,0.692307692,0.461538462,1,968
f7245d4546960c783d48d6bba27465a8bb99b04b,0,Douglass Cutting,2010-10-08 21:06:15+00:00,['b5097567812c1e09e91cc610bd0860c7cd16df4b'],3,7,10,349186,2,0,0,0,968
4dda8ddb4f6ca16d11b908f5597e299bb7fd8d76,0,Douglass Cutting,2010-10-08 21:14:58+00:00,['f7245d4546960c783d48d6bba27465a8bb99b04b'],4,18,22,349208,3,1,1,1,968
ff8221710612c83b365d105091c816caf90c22e2,0,Douglass Cutting,2010-10-08 21:17:22+00:00,['4dda8ddb4f6ca16d11b908f5597e299bb7fd8d76'],1,1,2,349210,1,,,,968
48cbce8f86cc008c4d8f2e0685dae992ccab4922,0,Douglass Cutting,2010-10-14 19:26:30+00:00,['ff8221710612c83b365d105091c816caf90c22e2'],1,1,2,349212,1,,,,968
4794325c1b416be59dfdc8c40d2d12d1cacc8b10,0,Douglass Cutting,2010-10-14 19:28:16+00:00,['48cbce8f86cc008c4d8f2e0685dae992ccab4922'],4,5,9,349221,1,,,,968
63ad1ce82e49b683a073745223a017057db8acab,0,Douglass Cutting,2010-10-14 21:10:32+00:00,['4794325c1b416be59dfdc8c40d2d12d1cacc8b10'],1,1,2,349223,1,,,,968
954df1fc6c138b8213b7a8a3c6cb5a7888e51c7b,0,Douglass Cutting,2010-10-14 21:12:31+00:00,['63ad1ce82e49b683a073745223a017057db8acab'],1,4,5,349228,2,,,,968
77f169d8e43f9cd919cb9ef2154878e821ce85ac,1,Douglass Cutting,2010-10-22 22:17:38+00:00,['954df1fc6c138b8213b7a8a3c6cb5a7888e51c7b'],87,123,210,349438,10,0.28125,0.28125,0.46875,968
dd8e3d56354a611ed79f765d2a6775bd7df3db7f,0,Douglass Cutting,2010-10-26 20:32:13+00:00,['77f169d8e43f9cd919cb9ef2154878e821ce85ac'],0,23,23,349461,3,0.666666667,0.666666667,1,968
78d9518f26978baafb69670fefd1417a36bb10e7,1,Douglass Cutting,2010-10-26 20:45:46+00:00,['dd8e3d56354a611ed79f765d2a6775bd7df3db7f'],25,31,56,349517,15,0,0,0,968
ddf2947a0493dad44c4151689d20adc01a1870e0,0,Douglass Cutting,2010-10-28 23:21:18+00:00,['78d9518f26978baafb69670fefd1417a36bb10e7'],2,36,38,349555,3,0.047619048,0.952380952,1,968
ba0a281322583b6d92bbea81ab37bdf849b1f5e3,0,Douglass Cutting,2010-10-29 21:30:55+00:00,['ddf2947a0493dad44c4151689d20adc01a1870e0'],5,18,23,349578,3,0.6,0.6,0,968
efd4e04a712622b7a3df63b60e9b58f9a3f47d9c,1,Douglass Cutting,2010-11-01 18:24:36+00:00,['ba0a281322583b6d92bbea81ab37bdf849b1f5e3'],181,660,841,350419,11,0.727272727,0.559440559,1,974
c9e3bcf524da7c3618201aa2b7189ba54900e1e1,0,Doug Cutting,2010-11-05 21:12:08+00:00,['efd4e04a712622b7a3df63b60e9b58f9a3f47d9c'],0,5,5,350424,2,1,1,1,974
9ecce5d7f857f099bc3038e87c09974bae4b8b77,1,Doug Cutting,2010-11-17 21:03:02+00:00,['c9e3bcf524da7c3618201aa2b7189ba54900e1e1'],1,4,5,350429,2,,,,974
4d73af83a5ec618781a1476e55d60b5e3a6e72f5,1,Doug Cutting,2010-11-22 21:16:45+00:00,['9ecce5d7f857f099bc3038e87c09974bae4b8b77'],2,232,234,350663,5,0.101851852,0.472222222,0.472222222,976
7adf61bb2083f9f027901fd63441b3bf06607fd5,0,Doug Cutting,2010-11-23 20:10:02+00:00,['4d73af83a5ec618781a1476e55d60b5e3a6e72f5'],23,189,212,350875,6,1,1,0.7,976
0c52cf1c8f6ae6878787541fbc8973e8e71d9a8c,0,Doug Cutting,2010-11-29 23:18:47+00:00,['7adf61bb2083f9f027901fd63441b3bf06607fd5'],0,17,17,350892,3,0.866666667,1,1,976
5440e53a1a9792b3f67eaf3eedc0c7c5f38629e8,0,Thiruvalluvan M. G,2010-12-03 16:39:42+00:00,['0c52cf1c8f6ae6878787541fbc8973e8e71d9a8c'],6,26,32,350924,4,0.647058824,0.764705882,0.764705882,976
615d3d16d6cb969c8521c4c6b681dcf11aa29183,1,Doug Cutting,2010-12-09 19:47:34+00:00,['5440e53a1a9792b3f67eaf3eedc0c7c5f38629e8'],0,29,29,350953,3,1,1,1,976
2145bb9893c44e3506c9e6f6bb1d981e0999c5e8,1,Doug Cutting,2010-12-09 19:50:54+00:00,['615d3d16d6cb969c8521c4c6b681dcf11aa29183'],5,262,267,351220,7,0.623287671,0.623287671,1,978
6647059e85e3c70c01a1596fe11f4a12f69125a7,0,Doug Cutting,2010-12-09 22:09:41+00:00,['2145bb9893c44e3506c9e6f6bb1d981e0999c5e8'],15,70,85,351305,6,0.928571429,1,0.928571429,979
bc55a1460c19c127d143736baef3e1881f22418c,0,Doug Cutting,2010-12-10 19:43:21+00:00,['6647059e85e3c70c01a1596fe11f4a12f69125a7'],6,23,29,351334,3,0.8,0,1,979
759ef5d44b57bc23ac86a4eaf94f7d76d6e79f11,0,Doug Cutting,2010-12-10 20:24:26+00:00,['bc55a1460c19c127d143736baef3e1881f22418c'],4,35,39,351373,3,0,1,1,979
e0d56061638d04a592b7fcff2e1435182f4a4ec8,0,Doug Cutting,2010-12-13 20:01:24+00:00,['759ef5d44b57bc23ac86a4eaf94f7d76d6e79f11'],2,26,28,351401,3,0.2,1,1,979
352bc86e525eda5f83f13485cac01e57ab9447bb,0,Doug Cutting,2010-12-14 23:45:35+00:00,['e0d56061638d04a592b7fcff2e1435182f4a4ec8'],2,47,49,351450,5,0.222222222,0.888888889,1,979
d5ec60896fef71973d49436df077664b830aaa46,0,Doug Cutting,2010-12-15 22:31:29+00:00,['352bc86e525eda5f83f13485cac01e57ab9447bb'],2,2,4,351454,1,,,,979
4631aef659d3795b5d3d7dc8e458b131387c2640,1,Scott Carey,2010-12-15 23:04:39+00:00,['d5ec60896fef71973d49436df077664b830aaa46'],188,1512,1700,353154,325,0.448818898,0.519685039,0.559055118,999
50b4f76b01b201bcd3d272cdbe805c3c367c111b,1,Scott Carey,2010-12-16 00:43:54+00:00,['4631aef659d3795b5d3d7dc8e458b131387c2640'],4,20,24,353178,1,,,,999
69c78580f2a0862e90f69a79fc73b66b5e2dc75a,1,Doug Cutting,2010-12-16 21:54:53+00:00,['50b4f76b01b201bcd3d272cdbe805c3c367c111b'],2,75,77,353255,3,0.25,0.25,1,999
cb2aca3e71e9098c8ef2cfe7415039ad5954e27e,1,Doug Cutting,2010-12-17 19:36:49+00:00,['69c78580f2a0862e90f69a79fc73b66b5e2dc75a'],17,24,41,353296,1,,,,999
d2d8ce9cbdf9c8a05afb51ddcd3a1f8f65a21d49,1,Doug Cutting,2010-12-17 19:42:26+00:00,['cb2aca3e71e9098c8ef2cfe7415039ad5954e27e'],0,4,4,353300,1,,,,999
e623053db00a27e9c6ce80bb352f788b7759e806,0,Doug Cutting,2010-12-29 21:27:15+00:00,['d2d8ce9cbdf9c8a05afb51ddcd3a1f8f65a21d49'],6,6,12,353312,3,,,,1000
c5890b7be7522db5484a0bc1e95913ec438aab9d,0,Doug Cutting,2010-12-29 21:28:23+00:00,['e623053db00a27e9c6ce80bb352f788b7759e806'],2,2,4,353316,1,,,,1000
a612645c98b33802c70259bc9599e39afc32b385,1,Doug Cutting,2010-12-29 21:37:42+00:00,['c5890b7be7522db5484a0bc1e95913ec438aab9d'],12,274,286,353602,11,0.85,1,0.892857143,1001
1116da410809a4572e6134c01b1e8e4be6627647,0,Doug Cutting,2011-01-04 22:28:36+00:00,['a612645c98b33802c70259bc9599e39afc32b385'],2,69,71,353673,5,0.105263158,1,1,1002
9ea51393c75b1ec5a47ce6ce4cd66a4169c9da3d,1,Doug Cutting,2011-01-07 17:52:02+00:00,['1116da410809a4572e6134c01b1e8e4be6627647'],12,14,26,353699,3,,,,1002
5a8078804ce08c49c2c5e5314fec94cb72415f2a,0,Doug Cutting,2011-01-07 17:59:47+00:00,['9ea51393c75b1ec5a47ce6ce4cd66a4169c9da3d'],4,88,92,353791,3,1,1,1,1003
701473043802d2e54638df2c8c112af8d8d4504a,1,Doug Cutting,2011-01-07 20:36:11+00:00,['5a8078804ce08c49c2c5e5314fec94cb72415f2a'],55,142,197,353988,9,0.953488372,1,1,1003
6cac5fe1283d797f62e40b1dd755e40f5b213d7b,1,Doug Cutting,2011-01-07 20:42:51+00:00,['701473043802d2e54638df2c8c112af8d8d4504a'],2,57,59,354047,8,0.777777778,0.777777778,1,1004
ee5428d3eb38c34ef2a9ded2f0cd447fe3f2f959,0,Doug Cutting,2011-01-07 21:19:36+00:00,['6cac5fe1283d797f62e40b1dd755e40f5b213d7b'],1,54,55,354102,4,0.916666667,0.916666667,0.916666667,1005
a0d444d9eb8ffac43ecabb7476f80cbae998170a,1,Doug Cutting,2011-01-07 21:23:55+00:00,['ee5428d3eb38c34ef2a9ded2f0cd447fe3f2f959'],1,40,41,354143,3,,,,1005
161206d6d49f352e1a9158f884c8020709f5b1ff,1,Bruce Mitchener Jr,2011-01-11 14:32:37+00:00,['a0d444d9eb8ffac43ecabb7476f80cbae998170a'],1,239,240,354383,6,0.310344828,0.522988506,0.787356322,1006
02fc973f779bc18482554841abc43844562da75a,0,Bruce Mitchener Jr,2011-01-11 14:48:26+00:00,['161206d6d49f352e1a9158f884c8020709f5b1ff'],0,30,30,354413,4,0.555555556,1,1,1006
8028574ba42ff2aa8d1faf4085f84ca3d13d55b3,1,Bruce Mitchener Jr,2011-01-11 14:56:51+00:00,['02fc973f779bc18482554841abc43844562da75a'],14,617,631,355044,8,0.244292237,0.716894977,0.817351598,1006
7febb30db2f2038ab9b750457a6df016cd583a04,1,Bruce Mitchener Jr,2011-01-11 15:07:07+00:00,['8028574ba42ff2aa8d1faf4085f84ca3d13d55b3'],192,443,635,355679,16,0.260416667,1,0.291666667,1008
44eb7b879277cd5be5fa3f23376d299d8f4a6067,1,Bruce Mitchener Jr,2011-01-11 15:34:44+00:00,['7febb30db2f2038ab9b750457a6df016cd583a04'],10,13,23,355702,3,,,,1008
2a3841f9419723b3007832d368a8c365d89ffd17,0,Bruce Mitchener Jr,2011-01-11 16:50:35+00:00,['44eb7b879277cd5be5fa3f23376d299d8f4a6067'],0,2407,2407,358109,367,0.041254125,0.079207921,1,1375
8bb68f7949fa14c10fd2549bcae2e4ddfdb817da,1,Bruce Mitchener Jr,2011-01-11 16:53:53+00:00,['2a3841f9419723b3007832d368a8c365d89ffd17'],2237,1674,3911,362020,60,1,1,0,1384
c69a5bb3780fcae1ca02439ef03c2f2d6188774b,0,Bruce Mitchener Jr,2011-01-11 17:15:49+00:00,['8bb68f7949fa14c10fd2549bcae2e4ddfdb817da'],1,16,17,362037,3,,,,1384
2f5d854451fc832fda13e170323c065c9b048c3c,1,Bruce Mitchener Jr,2011-01-11 17:16:12+00:00,['c69a5bb3780fcae1ca02439ef03c2f2d6188774b'],0,424,424,362461,6,0.090592334,0.163763066,0.717770035,1385
d88f0e4b854b5317555ad2a08c2c0b8ce4fe5b90,0,Bruce Mitchener Jr,2011-01-11 17:46:30+00:00,['2f5d854451fc832fda13e170323c065c9b048c3c'],0,0,0,362461,7,,,,1385
a2d92d73cdc29f92091ac958511ffef36d2f9e1f,0,Bruce Mitchener Jr,2011-01-11 18:16:35+00:00,['d88f0e4b854b5317555ad2a08c2c0b8ce4fe5b90'],0,0,0,362461,6,,,,1391
fe2631a02ad01d755199076f43398a770b9750f4,0,Bruce Mitchener Jr,2011-01-11 18:29:34+00:00,['a2d92d73cdc29f92091ac958511ffef36d2f9e1f'],0,1,1,362462,1,,,,1391
4f8f908cf16850f7f6225c9359de2cbf9f770de6,0,Doug Cutting,2011-01-11 22:26:06+00:00,['fe2631a02ad01d755199076f43398a770b9750f4'],15,43,58,362520,9,,,,1392
5a5a90960f2a25e98198c8845e193b47ffeb208a,0,Scott Carey,2011-01-14 18:31:55+00:00,['4f8f908cf16850f7f6225c9359de2cbf9f770de6'],4,9,13,362533,2,,,,1392
f036caa094c30ad39abd76e75858aee4cca0cb62,0,Scott Carey,2011-01-14 18:41:50+00:00,['5a5a90960f2a25e98198c8845e193b47ffeb208a'],0,2,2,362535,1,,,,1392
d0985f9e601ba97754bf072ac77e754a6c0a8c92,0,Scott Carey,2011-01-14 18:44:10+00:00,['f036caa094c30ad39abd76e75858aee4cca0cb62'],1,0,1,362536,1,,,,1392
6076010d1b73aa9061b3a2a44f4242b6ab1d2230,1,Scott Carey,2011-01-14 19:41:03+00:00,['d0985f9e601ba97754bf072ac77e754a6c0a8c92'],85,197,282,362818,6,1,1,1,1393
309b4a3eddea7cf386d56c7371fc11159f0bb402,0,Scott Carey,2011-01-14 19:46:05+00:00,['6076010d1b73aa9061b3a2a44f4242b6ab1d2230'],0,3,3,362821,1,,,,1393
f46af6b5788544d8789bec5e8fdeb58d9d9d2d47,0,Scott Carey,2011-01-14 19:55:43+00:00,['309b4a3eddea7cf386d56c7371fc11159f0bb402'],1,2,3,362824,1,,,,1393
914bdb53b61b9b65e3260459217bdf6063b9b83b,0,Scott Carey,2011-01-14 23:07:05+00:00,['f46af6b5788544d8789bec5e8fdeb58d9d9d2d47'],1,1,2,362826,1,,,,1393
a1eb97af3d931594b450321eb277817d186e1f50,1,Doug Cutting,2011-01-17 20:57:54+00:00,['914bdb53b61b9b65e3260459217bdf6063b9b83b'],2,28,30,362856,4,1,1,1,1393
baab72449d90842142032a6cc668c52d855de716,0,Scott Carey,2011-01-18 05:10:31+00:00,['a1eb97af3d931594b450321eb277817d186e1f50'],138,0,138,362994,6,,,,1393
c849a8f76708f8995c311396f3933421b80bdaa7,0,Bruce Mitchener Jr,2011-01-20 11:35:56+00:00,['baab72449d90842142032a6cc668c52d855de716'],1,0,1,362995,1,1,0,0,1393
b4f29d127108be85af3ea0f856c4ef3b52a2a798,1,Bruce Mitchener Jr,2011-01-20 12:38:19+00:00,['c849a8f76708f8995c311396f3933421b80bdaa7'],1,1,2,362997,1,,,,1393
a1e801aadba4ba65ce54b078d6c02b8617a88774,0,Bruce Mitchener Jr,2011-01-24 12:05:09+00:00,['b4f29d127108be85af3ea0f856c4ef3b52a2a798'],9,9,18,363015,2,,,,1393
26ea6ca388642f96d4d0dfab28150d6b0f51aa33,0,Bruce Mitchener Jr,2011-01-24 12:09:17+00:00,['a1e801aadba4ba65ce54b078d6c02b8617a88774'],1,1,2,363017,1,,,,1393
335d72590281875b500f776afd3b43fc24c1e4dc,1,Bruce Mitchener Jr,2011-01-24 16:52:09+00:00,['26ea6ca388642f96d4d0dfab28150d6b0f51aa33'],6,28,34,363051,2,0.1,1,1,1393
bd1c8fedb2c9566a9b161749fb6b49904b8caad8,0,Bruce Mitchener Jr,2011-01-26 03:44:18+00:00,['335d72590281875b500f776afd3b43fc24c1e4dc'],99,91,190,363241,11,0,0,0.117647059,1393
9403bef4294b16c9eb59e6876f7a6fb6cecfaa0a,1,Scott Carey,2011-01-28 01:04:53+00:00,['bd1c8fedb2c9566a9b161749fb6b49904b8caad8'],154,225,379,363620,73,0,1,0,1394
330e7fb6c2708b4dba775d9bad05a62b0ce2146e,1,Thiruvalluvan M. G,2011-01-30 19:10:51+00:00,['9403bef4294b16c9eb59e6876f7a6fb6cecfaa0a'],280,171,451,364071,9,0,1,1,1395
7fedde60b8704c2715526f6da81d6c43c4ca03e3,0,Bruce Mitchener Jr,2011-01-31 12:29:27+00:00,['330e7fb6c2708b4dba775d9bad05a62b0ce2146e'],3,8,11,364082,3,,,,1395
5ca4688a84af2406da81c0915ef781a790a016cb,0,Scott Carey,2011-02-01 19:08:24+00:00,['7fedde60b8704c2715526f6da81d6c43c4ca03e3'],377,840,1217,365299,2,0.759615385,0.78525641,1,1395
bb9b1c9796fab5960839e5b3eb8ff53b036eb6ad,0,Doug Cutting,2011-02-01 19:20:59+00:00,['5ca4688a84af2406da81c0915ef781a790a016cb'],1,1,2,365301,1,,,,1395
214803f7333fa6681caf0c36abf5899b7e861992,1,Scott Carey,2011-02-01 19:24:40+00:00,['bb9b1c9796fab5960839e5b3eb8ff53b036eb6ad'],1587,530,2117,367418,23,1,1,1,1397
9a34604d54723f44660d71d3e0ecd609fbf7d8a1,1,Scott Carey,2011-02-07 18:37:16+00:00,['214803f7333fa6681caf0c36abf5899b7e861992'],9,19,28,367446,2,0.2,0,0.8,1397
0011118ad62f56a42559fb432c2d46155649ade9,1,Doug Cutting,2011-02-07 21:21:01+00:00,['9a34604d54723f44660d71d3e0ecd609fbf7d8a1'],24,98,122,367568,5,0.581395349,0.976744186,0.581395349,1397
e020bbab1ba977e7b2f0cd0693d0d20c2c73441f,0,Scott Carey,2011-02-09 01:38:00+00:00,['0011118ad62f56a42559fb432c2d46155649ade9'],8,19,27,367595,1,0.833333333,0.833333333,1,1397
555df469c341e8aedc6a4a2822735edeed8ec095,0,Scott Carey,2011-02-14 19:10:52+00:00,['e020bbab1ba977e7b2f0cd0693d0d20c2c73441f'],43,56,99,367694,2,0.285714286,0.285714286,1,1397
4becf049d94e442f0b7aed95d61cc7574454f96c,0,Douglas Adam Creager,2011-02-15 15:26:23+00:00,['555df469c341e8aedc6a4a2822735edeed8ec095'],0,20,20,367714,5,,,,1398
c6469bfc32c0ebd53439b42feebc28439ac04506,0,Douglas Adam Creager,2011-02-15 15:40:18+00:00,['4becf049d94e442f0b7aed95d61cc7574454f96c'],0,41,41,367755,3,0,1,1,1398
9075618bf7890a8761107fa96da92dedf73d8a3e,0,Doug Cutting,2011-02-15 21:49:20+00:00,['c6469bfc32c0ebd53439b42feebc28439ac04506'],4,12,16,367771,3,0.6,1,0.4,1398
1ab4eec4d462d7384045a6efec7da0973ca71492,1,Scott Carey,2011-02-16 01:12:35+00:00,['9075618bf7890a8761107fa96da92dedf73d8a3e'],4,61,65,367836,5,0.128205128,1,0.871794872,1398
b366fd1f242f160f86d473cf3c883e8a5d4ac8e5,0,Scott Carey,2011-02-16 01:14:00+00:00,['1ab4eec4d462d7384045a6efec7da0973ca71492'],1,1,2,367838,1,,,,1398
f7e0c4a5c396077c936beedf145c6178167bc0ee,0,Scott Carey,2011-02-16 01:29:55+00:00,['b366fd1f242f160f86d473cf3c883e8a5d4ac8e5'],0,1,1,367839,1,,,,1398
bccc9984b80b6f94e92281767500632c77286eed,0,Doug Cutting,2011-02-19 00:40:03+00:00,['f7e0c4a5c396077c936beedf145c6178167bc0ee'],0,77,77,367916,3,0.483870968,1,1,1398
dcbfacdced7d0a7b50edf39afc1c50c87b1dcd7a,1,Thiruvalluvan M. G,2011-02-20 18:23:18+00:00,['bccc9984b80b6f94e92281767500632c77286eed'],18,6311,6329,374245,26,0.562165775,0.655414439,0.822526738,1413
1c5bbe95f612b841bfeec3880e660d1b6ec44fab,1,Doug Cutting,2011-02-21 17:20:23+00:00,['dcbfacdced7d0a7b50edf39afc1c50c87b1dcd7a'],40,84,124,374369,7,0,0.966666667,1,1413
a21cdcde9e3b9f9d203a441abce5b2e3aa2a583f,0,Scott Carey,2011-02-21 21:20:57+00:00,['1c5bbe95f612b841bfeec3880e660d1b6ec44fab'],7,10,17,374386,2,,,,1413
6fccf353fcbf236c93f8afefdd20be5f7cd3fd5b,0,Bruce Mitchener Jr,2011-02-24 17:56:08+00:00,['a21cdcde9e3b9f9d203a441abce5b2e3aa2a583f'],2,113,115,374501,5,1,1,0.645833333,1416
8b173f0e65b83415ac4d6b6b772ed146ae499559,0,Doug Cutting,2011-02-24 18:10:32+00:00,['6fccf353fcbf236c93f8afefdd20be5f7cd3fd5b'],3,4,7,374508,1,,,,1416
507684968666f97c5af23116884cf0ba88c60be4,1,Doug Cutting,2011-02-24 22:20:32+00:00,['8b173f0e65b83415ac4d6b6b772ed146ae499559'],416,130,546,375054,23,0.677966102,0.542372881,0.056497175,1416
9852becf651de1d845b1bf6e80ab2deeacbd6d9c,0,Doug Cutting,2011-02-24 22:25:57+00:00,['507684968666f97c5af23116884cf0ba88c60be4'],0,12,12,375066,4,1,1,1,1416
690bcb19471a3e5bf201665b5a75c1247f021e1d,0,Doug Cutting,2011-02-24 22:33:37+00:00,['9852becf651de1d845b1bf6e80ab2deeacbd6d9c'],12,5,17,375083,2,,,,1416
82ba2e6a9320d3d81c0b9e9cdaa40f5be528ee3a,1,Doug Cutting,2011-02-24 22:53:59+00:00,['690bcb19471a3e5bf201665b5a75c1247f021e1d'],2,9,11,375094,2,1,1,1,1416
3962eec7f14fc83542437a50c49dcd2d4b481410,1,Scott Carey,2011-02-25 00:36:40+00:00,['82ba2e6a9320d3d81c0b9e9cdaa40f5be528ee3a'],494,1867,2361,377455,45,0.60816944,0.892586989,0.789712557,1421
5f561248fa164725ec1e7600124fa4aa65a81c9c,0,Douglas Adam Creager,2011-02-25 15:43:50+00:00,['3962eec7f14fc83542437a50c49dcd2d4b481410'],174,281,455,377910,11,0,1,1,1421
9534b3cd1c35add821f13f736fdfec28cbd8ccef,0,Douglas Adam Creager,2011-02-25 15:53:33+00:00,['5f561248fa164725ec1e7600124fa4aa65a81c9c'],0,0,0,377910,0,,,,1421
aa3e9607963bb35f9067d3539b8881fe154c14cb,1,Douglas Adam Creager,2011-02-25 16:08:41+00:00,['9534b3cd1c35add821f13f736fdfec28cbd8ccef'],391,749,1140,379050,19,0.190184049,1,0.552147239,1423
7f0c2f36e04d80eeca72df974c9c3eb6fb4c4914,0,Douglas Adam Creager,2011-02-25 16:17:56+00:00,['aa3e9607963bb35f9067d3539b8881fe154c14cb'],296,1712,2008,381058,13,0.57,1,0.308,1426
474cd6bb4632dc0bec91e9f4ec2707673cf96890,0,Douglas Adam Creager,2011-02-25 16:19:42+00:00,['7f0c2f36e04d80eeca72df974c9c3eb6fb4c4914'],31,164,195,381253,3,0,0.975,0.325,1426
3e897246bf0cb958aa80ca1749fdf3514a8fd2b6,0,Douglas Adam Creager,2011-02-25 16:22:55+00:00,['474cd6bb4632dc0bec91e9f4ec2707673cf96890'],103,313,416,381669,5,0.563492063,0.626984127,0,1426
16987f2bbedcc310a29e000b2ee72685170727be,1,Douglas Adam Creager,2011-02-25 20:33:27+00:00,['3e897246bf0cb958aa80ca1749fdf3514a8fd2b6'],1,1,2,381671,1,,,,1426
196a252b6657068013d76e903b1f90ad33ad5c8e,0,Douglas Adam Creager,2011-02-25 21:15:49+00:00,['16987f2bbedcc310a29e000b2ee72685170727be'],1,3,4,381675,1,,,,1426
3b5d0336153495e29ee42605e6b11fa27a3fec5b,1,Doug Cutting,2011-02-25 23:45:30+00:00,['196a252b6657068013d76e903b1f90ad33ad5c8e'],277,402,679,382354,38,1,1,0.6,1426
4d58a729c799e8d1fe3de8605bb53f14bd3374a2,0,Doug Cutting,2011-02-26 00:13:01+00:00,['3b5d0336153495e29ee42605e6b11fa27a3fec5b'],0,1,1,382355,1,,,,1426
e8dc149b002aa76473084894171f8df7e81ab767,1,Doug Cutting,2011-02-26 00:51:21+00:00,['4d58a729c799e8d1fe3de8605bb53f14bd3374a2'],9,23,32,382387,10,,,,1426
b328ff0683899b44bb931d6a10a9e6b3624d9a44,0,Doug Cutting,2011-03-01 17:40:25+00:00,['e8dc149b002aa76473084894171f8df7e81ab767'],17,44,61,382448,9,1,1,1,1426
e73a781d5a2ef9259749f882820d4b5932014d96,0,Doug Cutting,2011-03-01 19:35:00+00:00,['b328ff0683899b44bb931d6a10a9e6b3624d9a44'],0,13,13,382461,1,,,,1426
1b144474a26da6ea77d8d959a8b4dc8b07896cb4,0,Doug Cutting,2011-03-07 20:12:47+00:00,['e73a781d5a2ef9259749f882820d4b5932014d96'],3,18,21,382482,3,1,1,1,1426
ad935798984a24a6e9e9d2c136ff06a93b761ead,0,Doug Cutting,2011-03-08 00:55:57+00:00,['1b144474a26da6ea77d8d959a8b4dc8b07896cb4'],1,10,11,382493,3,1,1,1,1426
16f9fbc19a28d6c22e6a8fe8550ff5801b853d0b,0,Doug Cutting,2011-03-08 01:01:17+00:00,['ad935798984a24a6e9e9d2c136ff06a93b761ead'],21,57,78,382571,6,0.947368421,1,1,1426
b63f694a7efa6b0a4bc22c70bc2ac6747880267e,0,Doug Cutting,2011-03-08 01:04:11+00:00,['16f9fbc19a28d6c22e6a8fe8550ff5801b853d0b'],1,1,2,382573,1,,,,1426
c567683f528d5af38e6835773e55092e3e2749bc,0,Stephen Gargan,2011-03-09 06:39:16+00:00,['b63f694a7efa6b0a4bc22c70bc2ac6747880267e'],0,1,1,382574,1,1,1,1,1426
49681761a71ee17e1f554e3a411860a28a91fa18,0,Stephen Gargan,2011-03-09 07:00:58+00:00,['c567683f528d5af38e6835773e55092e3e2749bc'],1,1,2,382576,1,,,,1426
addcbe199d2fe5fbc690554c2309b947f5dd3d54,1,Thiruvalluvan M. G,2011-03-19 18:14:03+00:00,['49681761a71ee17e1f554e3a411860a28a91fa18'],6,825,831,383407,6,0.074626866,0.304904051,0.588486141,1428
3d64951d77db4a070e4f4be187dc03a92fc03c7e,1,Thiruvalluvan M. G,2011-03-27 12:21:07+00:00,['addcbe199d2fe5fbc690554c2309b947f5dd3d54'],3,1221,1224,384631,11,0.324574961,0.672333849,0.978361669,1434
b7d0d2bdc56d4bc7b5514feb534a5194335445fc,0,Doug Cutting,2011-03-29 20:34:13+00:00,['3d64951d77db4a070e4f4be187dc03a92fc03c7e'],10,35,45,384676,5,0.8125,0.8125,0.625,1434
60e5ddfd8fd3a41e513e22ef1b228117943886ca,0,Doug Cutting,2011-03-29 20:40:21+00:00,['b7d0d2bdc56d4bc7b5514feb534a5194335445fc'],1,6,7,384683,2,,,,1434
554434befcb9df043e6ac918966e4271482eb1f4,1,Thiruvalluvan M. G,2011-03-30 07:40:53+00:00,['60e5ddfd8fd3a41e513e22ef1b228117943886ca'],2,864,866,385549,10,0.688888889,0.930864198,0.948148148,1437
0963e563fde59a0848c9200da08885783bd0c637,0,Doug Cutting,2011-03-30 21:12:49+00:00,['554434befcb9df043e6ac918966e4271482eb1f4'],6,6,12,385561,1,,,,1437
7784b56a4aeda94de1de3bbe12a468108b7b8e0e,0,Doug Cutting,2011-03-30 23:10:33+00:00,['0963e563fde59a0848c9200da08885783bd0c637'],8,10,18,385579,6,,,,1437
a02c5c2ce3edae38b70648b177a78cc7a64a7b25,0,Doug Cutting,2011-03-30 23:36:20+00:00,['7784b56a4aeda94de1de3bbe12a468108b7b8e0e'],1,13,14,385593,4,1,1,1,1437
e9dbb30d296595f0ebd28350eb7904f4e596370d,1,Doug Cutting,2011-03-31 21:16:28+00:00,['a02c5c2ce3edae38b70648b177a78cc7a64a7b25'],0,9797,9797,395390,67,0.550268817,0.726344086,0.638172043,1501
fb8d5a0b64bed038374fff83de4abfeeb89c9461,0,Doug Cutting,2011-03-31 21:19:56+00:00,['e9dbb30d296595f0ebd28350eb7904f4e596370d'],0,0,0,395390,0,,,,1501
e3315556f1a58ed027e52047516b02992d26278d,1,Doug Cutting,2011-03-31 22:23:55+00:00,['fb8d5a0b64bed038374fff83de4abfeeb89c9461'],18,47,65,395455,6,0,1,1,1501
361b0fb520d83636b0301203295a25682939d582,0,Doug Cutting,2011-03-31 22:49:37+00:00,['e3315556f1a58ed027e52047516b02992d26278d'],7,86,93,395548,3,0.447368421,0.947368421,0.947368421,1502
fb9e558d5f831a8ec27cb578014a122dc36dfd33,0,Doug Cutting,2011-04-01 16:40:19+00:00,['361b0fb520d83636b0301203295a25682939d582'],1,1,2,395550,1,,,,1502
26b4efe10915380de91b0ab5672df6a08d79dd7f,0,Thiruvalluvan M. G,2011-04-05 16:42:03+00:00,['fb9e558d5f831a8ec27cb578014a122dc36dfd33'],0,2,2,395552,2,,,,1502
9d567ae97e945f0c5997b0f65d0e4697fd1d732b,1,Thiruvalluvan M. G,2011-04-05 16:54:08+00:00,['26b4efe10915380de91b0ab5672df6a08d79dd7f'],38,188,226,395778,4,0,1,1,1502
77047acd0d8b5b269047f471d5c2df7aad3cbf25,0,Doug Cutting,2011-04-06 17:59:26+00:00,['9d567ae97e945f0c5997b0f65d0e4697fd1d732b'],2,128,130,395908,11,0.897959184,0.918367347,0.918367347,1503
3f9db28ce5abc7163e7b8a718136d1d0b7e54caf,0,Scott Carey,2011-04-18 23:12:23+00:00,['77047acd0d8b5b269047f471d5c2df7aad3cbf25'],5,32,37,395945,3,0.695652174,1,0.652173913,1503
9f34df4ffa72adf599f8b2202de0af000159ef70,0,Doug Cutting,2011-04-19 20:44:51+00:00,['3f9db28ce5abc7163e7b8a718136d1d0b7e54caf'],2,64,66,396011,3,1,1,0.714285714,1503
4ed7ff8e89a89af2df7a56f3dc83996a080adece,1,Doug Cutting,2011-04-19 20:48:37+00:00,['9f34df4ffa72adf599f8b2202de0af000159ef70'],17,196,213,396224,4,0.104166667,0.333333333,0.677083333,1504
df001ad422e33182514811b50d0b63d81f868acd,1,Doug Cutting,2011-04-19 20:52:12+00:00,['4ed7ff8e89a89af2df7a56f3dc83996a080adece'],8,22,30,396254,3,0,1,1,1504
a364235bde361cb9d4336fdc5564e8a1b392291f,1,Doug Cutting,2011-04-20 19:55:37+00:00,['df001ad422e33182514811b50d0b63d81f868acd'],13,101,114,396368,6,0.894736842,1,1,1504
03933b393626604faabfb2d4a5adf3463bede4bb,1,Doug Cutting,2011-04-20 21:52:10+00:00,['a364235bde361cb9d4336fdc5564e8a1b392291f'],146,182,328,396696,13,1,1,0,1504
7833e4baa36951829a4ed4cbb81ae37df617464f,1,Doug Cutting,2011-04-20 23:08:31+00:00,['03933b393626604faabfb2d4a5adf3463bede4bb'],3,45,48,396744,3,1,1,1,1504
4601ccfd84bafa293d74ab4d2c9cd953652277c2,0,Doug Cutting,2011-04-20 23:09:53+00:00,['7833e4baa36951829a4ed4cbb81ae37df617464f'],1,1,2,396746,1,,,,1504
d1e46b246eeecee53c5c84a08578a066698e0c8e,1,Doug Cutting,2011-04-26 16:33:43+00:00,['4601ccfd84bafa293d74ab4d2c9cd953652277c2'],0,255,255,397001,5,0.783505155,1,0.948453608,1507
7472d98289bcb9776339ad253285a6f6dfa939cf,0,Doug Cutting,2011-04-29 19:05:20+00:00,['d1e46b246eeecee53c5c84a08578a066698e0c8e'],0,16,16,397017,3,0.083333333,1,1,1507
b34848d4b561098b6515ef8fc5217cf18a55a9f5,0,Doug Cutting,2011-04-29 19:35:47+00:00,['7472d98289bcb9776339ad253285a6f6dfa939cf'],13,40,53,397070,3,,,,1507
afa1fd51ad1defb83e622260625cedf597057458,0,Doug Cutting,2011-04-29 22:09:03+00:00,['b34848d4b561098b6515ef8fc5217cf18a55a9f5'],4,22,26,397096,5,,,,1507
064d76042fc429844fb51fed01c9399240a83020,0,Doug Cutting,2011-04-29 22:20:52+00:00,['afa1fd51ad1defb83e622260625cedf597057458'],0,16,16,397112,1,,,,1507
3ea269b831f04da1159b8156536fe8e823767714,0,Stephen Gargan,2011-05-03 21:15:52+00:00,['064d76042fc429844fb51fed01c9399240a83020'],26,98,124,397236,5,1,1,1,1507
3eb8a8c93c9388d1bd79b2297118a1d381bde51d,0,Stephen Gargan,2011-05-04 00:21:09+00:00,['3ea269b831f04da1159b8156536fe8e823767714'],0,4,4,397240,1,,,,1507
fbab55fdd499dae4736f099111aecf2bc8e488e3,0,Douglas Adam Creager,2011-05-12 14:57:27+00:00,['3eb8a8c93c9388d1bd79b2297118a1d381bde51d'],11,24,35,397275,4,0,0.2,1,1507
947bd7daab9ac512bba06f09d27f9dd29b55bef7,0,Douglas Adam Creager,2011-05-12 15:06:02+00:00,['fbab55fdd499dae4736f099111aecf2bc8e488e3'],0,4,4,397279,2,,,,1507
85bc4f8916fa5db77b6ac3d78747e98844780d04,0,Doug Cutting,2011-05-16 13:35:41+00:00,['947bd7daab9ac512bba06f09d27f9dd29b55bef7'],1,1,2,397281,1,,,,1507
ac835f5458ee587f937312bb1eeb3b70699d3aee,0,Doug Cutting,2011-05-18 09:23:24+00:00,['85bc4f8916fa5db77b6ac3d78747e98844780d04'],0,10,10,397291,1,,,,1507
e05d7e823c8b05c18d4245b894eb43db66df21b6,0,Doug Cutting,2011-05-18 09:25:18+00:00,['ac835f5458ee587f937312bb1eeb3b70699d3aee'],1,9,10,397301,3,1,1,1,1507
1dbd63f4d14887ad4f7ac4c74db576f336b8c95f,0,Doug Cutting,2011-05-18 09:28:17+00:00,['e05d7e823c8b05c18d4245b894eb43db66df21b6'],2,0,2,397303,1,,,,1507
ea05ebd20d8ae1fc7e6cdfa64c6a40c204d728fe,0,Doug Cutting,2011-05-19 15:50:40+00:00,['1dbd63f4d14887ad4f7ac4c74db576f336b8c95f'],3,56,59,397362,3,0.59375,0,1,1507
b65bfcf9cf6004ae8c2cff0cd58e251032e4c719,0,Doug Cutting,2011-05-30 08:27:54+00:00,['ea05ebd20d8ae1fc7e6cdfa64c6a40c204d728fe'],29,266,295,397657,6,0.305084746,1,0.805084746,1509
215c50fe20bd74b0d7cdf0e41aaa93bf39f6be91,0,Doug Cutting,2011-05-30 08:58:28+00:00,['b65bfcf9cf6004ae8c2cff0cd58e251032e4c719'],2,409,411,398068,5,1,0.780487805,0.865853659,1509
94d4da5ee1ee30e5f65f051885732e02fddef2f0,0,Douglas Adam Creager,2011-05-31 14:28:18+00:00,['215c50fe20bd74b0d7cdf0e41aaa93bf39f6be91'],1,74,75,398143,2,,,,1510
89d8396263807fd5bf94e3ee39e8b34baef28476,0,Douglas Adam Creager,2011-05-31 14:38:29+00:00,['94d4da5ee1ee30e5f65f051885732e02fddef2f0'],0,3,3,398146,1,,,,1510
535f4ba55859d64d4a566ec68eea64aec774f3f6,1,Douglas Adam Creager,2011-05-31 15:00:25+00:00,['89d8396263807fd5bf94e3ee39e8b34baef28476'],2,10,12,398158,3,,,,1510
452ed338b64e52116e0c0c3e24705ad09cb27584,1,Philip Zeyliger,2011-05-31 19:06:11+00:00,['535f4ba55859d64d4a566ec68eea64aec774f3f6'],1,10,11,398169,2,,,,1510
d4867eb2aba282ebc38d4a25631ea8cd802b2b18,1,Doug Cutting,2011-06-02 11:41:48+00:00,['452ed338b64e52116e0c0c3e24705ad09cb27584'],15,83,98,398267,8,0.26,1,0.56,1510
6c6b08cf33fb1911dd50c6abc2a5e7bfeb1c1a16,0,Doug Cutting,2011-06-02 11:49:36+00:00,['d4867eb2aba282ebc38d4a25631ea8cd802b2b18'],1,1,2,398269,1,,,,1510
153ce108ab9334a4a74e266c078f4d0c08e2f485,1,Doug Cutting,2011-06-16 09:33:29+00:00,['6c6b08cf33fb1911dd50c6abc2a5e7bfeb1c1a16'],226,1279,1505,399774,13,0.467032967,0.836996337,0.93040293,1514
77c3c699fa348c191cee812392dc025f6ed1331e,0,Doug Cutting,2011-06-17 17:41:57+00:00,['153ce108ab9334a4a74e266c078f4d0c08e2f485'],7,7,14,399788,1,,,,1514
52ae42f054fc9ac62262b28b6a5c5d3ba4a288fd,0,Philip Zeyliger,2011-06-20 07:02:28+00:00,['77c3c699fa348c191cee812392dc025f6ed1331e'],0,499,499,400287,5,0.859375,1,0.859375,1516
3a282bd65030c4361ea901a8e09a495227df15b0,0,Doug Cutting,2011-06-24 14:34:51+00:00,['52ae42f054fc9ac62262b28b6a5c5d3ba4a288fd'],0,45,45,400332,3,0.317073171,1,1,1516
2f5cdaf1a0d0003a01184ee201ca8e81bd8a9db0,0,Doug Cutting,2011-06-29 21:47:52+00:00,['3a282bd65030c4361ea901a8e09a495227df15b0'],1,4,5,400337,2,,,,1516
5b88de9f8724e046c745869b335b82a4af439af3,0,Philip Zeyliger,2011-06-30 16:56:26+00:00,['2f5cdaf1a0d0003a01184ee201ca8e81bd8a9db0'],2,5,7,400344,2,,,,1516
460b26da6b3d929887c9e0fa814851562e2a797f,0,Doug Cutting,2011-06-30 19:23:55+00:00,['5b88de9f8724e046c745869b335b82a4af439af3'],1,32,33,400377,4,1,0.95,1,1516
6a584228314e7ea255c6aa68edee4b770dc6e899,0,Doug Cutting,2011-06-30 19:47:14+00:00,['460b26da6b3d929887c9e0fa814851562e2a797f'],0,2,2,400379,1,,,,1516
0a3c5b470e8882e478052af07283b2a6b46ba79f,1,Doug Cutting,2011-07-01 16:23:39+00:00,['6a584228314e7ea255c6aa68edee4b770dc6e899'],21,216,237,400616,7,0.078125,0.34375,0.765625,1517
cd50b81836131e56355a8617be5ea9b1be5d63d9,0,Doug Cutting,2011-07-01 16:29:42+00:00,['0a3c5b470e8882e478052af07283b2a6b46ba79f'],2,2,4,400620,1,,,,1517
c4f243262392626c8a9e95ba1e4c355e21ab388a,1,Doug Cutting,2011-07-01 16:30:54+00:00,['cd50b81836131e56355a8617be5ea9b1be5d63d9'],80,327,407,401027,7,0.434210526,0.953947368,0.921052632,1517
df5f9be0214ea3884fc15181d88a0b3e0da4bf3c,0,Doug Cutting,2011-07-01 19:52:48+00:00,['c4f243262392626c8a9e95ba1e4c355e21ab388a'],1,40,41,401068,4,1,1,1,1517
07c66f99ada606e5e832d0b9cad0eab776c98c83,1,Doug Cutting,2011-07-01 20:02:28+00:00,['df5f9be0214ea3884fc15181d88a0b3e0da4bf3c'],34,256,290,401358,7,0.106382979,0.14893617,0.64893617,1520
0cc2905bb678d3b729a14913ae7bd7a6ee10aa28,0,Doug Cutting,2011-07-01 20:11:34+00:00,['07c66f99ada606e5e832d0b9cad0eab776c98c83'],3,39,42,401400,5,,,,1522
b623e6f1019798c69c9178c3eb3e2101fb0fe383,0,Doug Cutting,2011-07-11 21:21:09+00:00,['0cc2905bb678d3b729a14913ae7bd7a6ee10aa28'],31,24,55,401455,3,1,0,0,1522
34d6f3ac20492b8b39d05c8e71333bf4d46a59b9,1,Douglas Adam Creager,2011-07-12 20:21:04+00:00,['b623e6f1019798c69c9178c3eb3e2101fb0fe383'],48,566,614,402069,16,0.613445378,1,1,1529
1fa65b7921fd9a718a70b53c9c2f61efbcbfc279,0,Douglas Adam Creager,2011-07-12 21:36:53+00:00,['34d6f3ac20492b8b39d05c8e71333bf4d46a59b9'],0,2,2,402071,1,,,,1529
23b9833e7f7fc164e9ed715062ed84aec8d2a27e,1,Douglas Adam Creager,2011-07-14 02:35:04+00:00,['1fa65b7921fd9a718a70b53c9c2f61efbcbfc279'],625,10931,11556,413627,64,0.370448854,0.655557696,0.688691967,1556
aae39c90a3e5ac80d940471b5694aef1ab193803,0,Douglas Adam Creager,2011-07-14 22:58:10+00:00,['23b9833e7f7fc164e9ed715062ed84aec8d2a27e'],0,3,3,413630,1,,,,1556
3dff33cb9b8bc5d4c8a1f94a964bc4e5c4d7e5ff,0,Douglas Adam Creager,2011-07-15 00:54:01+00:00,['aae39c90a3e5ac80d940471b5694aef1ab193803'],102,92,194,413824,15,,,,1556
c9f6f4eb4756d387746ea458bc27a4bd08e121ca,1,Douglas Adam Creager,2011-07-15 01:22:18+00:00,['3dff33cb9b8bc5d4c8a1f94a964bc4e5c4d7e5ff'],0,518,518,414342,5,0.134969325,0.616564417,0.932515337,1558
6d3e2f0facaf2f21e049bd71e5f555c365f8c71e,0,Douglas Adam Creager,2011-07-15 01:31:04+00:00,['c9f6f4eb4756d387746ea458bc27a4bd08e121ca'],2,1,3,414345,1,,,,1558
78ab4204ce33450f466e7cacb1949b53c5b053f5,0,Doug Cutting,2011-07-25 20:16:27+00:00,['6d3e2f0facaf2f21e049bd71e5f555c365f8c71e'],5,45,50,414395,3,,,,1558
b61743eb5b604f50aeed13abcdd5164e2d71f706,0,Doug Cutting,2011-07-27 22:52:46+00:00,['78ab4204ce33450f466e7cacb1949b53c5b053f5'],0,163,163,414558,3,0.768115942,1,0.782608696,1559
827cac5eccfc507d829d7f734f9365f816eaf6d0,0,Doug Cutting,2011-07-28 19:48:35+00:00,['b61743eb5b604f50aeed13abcdd5164e2d71f706'],11,11,22,414580,1,,,,1559
a03c19564906b179de1845c9614a985523162f6a,0,Doug Cutting,2011-08-11 20:14:22+00:00,['827cac5eccfc507d829d7f734f9365f816eaf6d0'],7,23,30,414610,3,1,1,1,1559
646bfb81eece405f0e898b8caa9165579295859d,1,Doug Cutting,2011-08-12 20:47:23+00:00,['a03c19564906b179de1845c9614a985523162f6a'],25,133,158,414768,7,1,1,1,1563
b1bb350b513bfc925960faeb65a28351e7e9ceaa,0,Doug Cutting,2011-08-12 21:53:48+00:00,['646bfb81eece405f0e898b8caa9165579295859d'],20,55,75,414843,2,0.923076923,0.269230769,1,1563
2679a8b0563aea563d1d8ca4e124662e6d381db0,0,Doug Cutting,2011-08-15 22:12:04+00:00,['b1bb350b513bfc925960faeb65a28351e7e9ceaa'],1,1,2,414845,1,,,,1563
4f693b17f1065f1a688628af3578ee34c55bfbe8,1,Doug Cutting,2011-08-22 18:00:29+00:00,['2679a8b0563aea563d1d8ca4e124662e6d381db0'],1,2,3,414848,1,0,1,1,1563
174f5a8898511b7275a81a9b7e8f89ad6c7a40f4,0,Doug Cutting,2011-08-22 18:30:17+00:00,['4f693b17f1065f1a688628af3578ee34c55bfbe8'],1,1,2,414850,1,,,,1563
d3d6134e08a361a1ad774b527adc5ef7330c09ac,0,Doug Cutting,2011-08-25 20:41:54+00:00,['174f5a8898511b7275a81a9b7e8f89ad6c7a40f4'],0,6,6,414856,1,,,,1563
79b61b53124d555583791061429f12db0f7c4810,0,Doug Cutting,2011-08-25 20:48:38+00:00,['d3d6134e08a361a1ad774b527adc5ef7330c09ac'],3,3,6,414862,1,,,,1563
1462c10fb5ae684dfa9fb03b4eb5d54903c8a384,1,Doug Cutting,2011-08-25 20:51:43+00:00,['79b61b53124d555583791061429f12db0f7c4810'],12,295,307,415169,8,0.736842105,0.798245614,0.938596491,1568
341d12014ead1a0bf5bafb1c666c0cc668a62308,0,Doug Cutting,2011-08-25 20:58:35+00:00,['1462c10fb5ae684dfa9fb03b4eb5d54903c8a384'],1,1,2,415171,1,,,,1568
d15cce120f81f5118ea590fa48d3e7e6150d920f,0,Doug Cutting,2011-08-25 21:40:20+00:00,['341d12014ead1a0bf5bafb1c666c0cc668a62308'],1,4,5,415176,2,,,,1568
3be4df96cf956e38c56561e4e7954cb0ebc96cae,0,Doug Cutting,2011-08-25 21:53:09+00:00,['d15cce120f81f5118ea590fa48d3e7e6150d920f'],0,18,18,415194,1,,,,1568
31d1e9b84baf9c6ee4ea234ddad9a7b584e11d0c,0,Doug Cutting,2011-08-25 21:54:08+00:00,['3be4df96cf956e38c56561e4e7954cb0ebc96cae'],0,1,1,415195,1,,,,1568
203cbd49010dfcd677af4a6d8ce8b4065d4e629d,0,Doug Cutting,2011-08-25 22:12:57+00:00,['31d1e9b84baf9c6ee4ea234ddad9a7b584e11d0c'],3,1,4,415199,1,,,,1568
666be14b735fa4b6e03c20b5c15d229f90efd437,1,Doug Cutting,2011-08-26 20:54:50+00:00,['203cbd49010dfcd677af4a6d8ce8b4065d4e629d'],318,2656,2974,418173,42,0.384682332,0.842471715,0.953002611,1581
72c9d6bb7aa23546a0bf82c2ce546fd1278bd72b,0,Doug Cutting,2011-09-07 19:31:09+00:00,['666be14b735fa4b6e03c20b5c15d229f90efd437'],0,28,28,418201,3,0.411764706,0.411764706,1,1581
7c2bfeb2c6ebb2f69eaa4aafbf586ddd2c000629,1,Doug Cutting,2011-09-07 21:22:25+00:00,['72c9d6bb7aa23546a0bf82c2ce546fd1278bd72b'],7,60,67,418268,6,0,0,1,1582
b4d6a171e5e2d96d4e6fad49e06aca19c916420a,0,Doug Cutting,2011-09-07 21:38:39+00:00,['7c2bfeb2c6ebb2f69eaa4aafbf586ddd2c000629'],1,1,2,418270,1,,,,1582
5f2cc474348dfdc8cfca669f3f4f0d75bc9e7ae9,1,Doug Cutting,2011-09-12 20:24:04+00:00,['b4d6a171e5e2d96d4e6fad49e06aca19c916420a'],39,717,756,419026,12,0.558718861,0.896797153,0.814946619,1589
7185321c45049659c172d64651c2ebe83143a031,1,Doug Cutting,2011-09-12 22:34:57+00:00,['5f2cc474348dfdc8cfca669f3f4f0d75bc9e7ae9'],1,1,2,419028,1,,,,1589
fed95bb179d5459bd58538028f7deafe703f2f90,1,Doug Cutting,2011-09-13 01:30:43+00:00,['7185321c45049659c172d64651c2ebe83143a031'],9,11,20,419048,3,0,1,1,1589
ce10b0708139dd131a6342d5e189f5d857000c19,0,Doug Cutting,2011-09-13 02:33:04+00:00,['fed95bb179d5459bd58538028f7deafe703f2f90'],2,2,4,419052,2,,,,1589
bfdee03fe22f9743dbfddb593de3821fcfa737a8,0,Doug Cutting,2011-09-19 18:44:10+00:00,['ce10b0708139dd131a6342d5e189f5d857000c19'],3,8,11,419063,2,,,,1589
dba584208bc0006ce773c2919469b6027da753ed,0,Doug Cutting,2011-09-19 18:48:54+00:00,['bfdee03fe22f9743dbfddb593de3821fcfa737a8'],0,40,40,419103,3,1,1,1,1589
8feed041e4d0f296e954d1b4d38ce952d64bc07d,0,Doug Cutting,2011-09-20 17:55:21+00:00,['dba584208bc0006ce773c2919469b6027da753ed'],8,52,60,419163,15,0.8,1,0.5,1589
6ea146d357b041e1c16167124afd7fc4d0f36c21,0,Doug Cutting,2011-09-20 22:32:58+00:00,['8feed041e4d0f296e954d1b4d38ce952d64bc07d'],0,131,131,419294,3,0.618181818,1,1,1591
afc36212528a46d6e00a1031764a3defe66bed45,0,Doug Cutting,2011-09-21 20:44:41+00:00,['6ea146d357b041e1c16167124afd7fc4d0f36c21'],2,16,18,419312,3,1,1,1,1591
895ce26802026187f1a6ac227bf0ec1482178247,0,Doug Cutting,2011-09-21 20:47:08+00:00,['afc36212528a46d6e00a1031764a3defe66bed45'],6,3,9,419321,2,,,,1591
e93f2ff7ca53586dbfd3941035fdaf67cb8ae306,1,Doug Cutting,2011-09-21 20:57:09+00:00,['895ce26802026187f1a6ac227bf0ec1482178247'],14,128,142,419463,4,0.333333333,1,0.368421053,1592
3fe4738eff4bfe13116094a48ce5e22e4934bfbc,1,Doug Cutting,2011-09-22 19:07:08+00:00,['e93f2ff7ca53586dbfd3941035fdaf67cb8ae306'],1,101,102,419565,4,0.342857143,0.714285714,1,1593
fe169ad3db467159b48da150c639c4ad7c06c0bf,0,Doug Cutting,2011-09-22 20:49:11+00:00,['3fe4738eff4bfe13116094a48ce5e22e4934bfbc'],1,4,5,419570,2,,,,1593
471b3f5f896035f264f29cf4f6a136a23a0b40b3,1,Douglas Adam Creager,2011-09-25 19:57:53+00:00,['fe169ad3db467159b48da150c639c4ad7c06c0bf'],1,5,6,419576,2,,,,1593
d6d9116c6bfb31535491912f55a658d4f0291fb5,0,Douglas Adam Creager,2011-09-25 20:03:25+00:00,['471b3f5f896035f264f29cf4f6a136a23a0b40b3'],2,2,4,419580,1,,,,1593
e1fa71998aa7ecbf230b7b5dc8af8b446a2870f1,1,Douglas Adam Creager,2011-09-25 20:47:26+00:00,['d6d9116c6bfb31535491912f55a658d4f0291fb5'],1325,42326,43651,463231,315,0.218694885,0.267195767,0.510582011,1625
47161bac6a9c3e0ff5fbf3885cd922fa29848adb,0,Douglas Adam Creager,2011-09-25 20:49:43+00:00,['e1fa71998aa7ecbf230b7b5dc8af8b446a2870f1'],0,0,0,463231,0,,,,1625
27493bbf6257f48278df922517bc9e38be2df8d2,1,Douglas Adam Creager,2011-09-26 12:36:26+00:00,['47161bac6a9c3e0ff5fbf3885cd922fa29848adb'],4043,10795,14838,478069,35,0.559290383,0.867880486,0.472455649,1631
7a1cdae26c92bb14e63ac71eab4ee7ce3859752b,1,Douglas Adam Creager,2011-09-26 13:12:46+00:00,['27493bbf6257f48278df922517bc9e38be2df8d2'],4,75,79,478148,4,0.113636364,1,1,1631
fd02845b1307edba65587a6e2cefda72e54ed8b9,0,Doug Cutting,2011-09-26 21:14:35+00:00,['7a1cdae26c92bb14e63ac71eab4ee7ce3859752b'],0,692,692,478840,15,1,1,1,1644
d6d8e36128e1b733b520abfc2f6687914e0cd9e0,1,Doug Cutting,2011-09-29 23:35:23+00:00,['fd02845b1307edba65587a6e2cefda72e54ed8b9'],1,1685,1686,480526,6,,,,1645
21223692e8066b2bdf2100641fb7befdae453e8e,1,Thiruvalluvan M. G,2011-10-01 18:37:14+00:00,['d6d8e36128e1b733b520abfc2f6687914e0cd9e0'],11,327,338,480864,6,0.166666667,0.25,1,1645
2b4a20cddc3856755e1104775398c5d95d7570d5,1,Doug Cutting,2011-10-03 19:46:05+00:00,['21223692e8066b2bdf2100641fb7befdae453e8e'],2,10,12,480876,2,1,1,0,1645
ce9db305e58824d3f892a9fe89c38537f7e75a39,0,Doug Cutting,2011-10-03 19:47:29+00:00,['2b4a20cddc3856755e1104775398c5d95d7570d5'],1,3,4,480880,1,,,,1645
3f01ca6b4de96fc5b9167651d4f700b2fcb2c5f4,1,Doug Cutting,2011-10-04 21:54:25+00:00,['ce9db305e58824d3f892a9fe89c38537f7e75a39'],6,4360,4366,485246,17,0.561310782,0.655743481,0.964763918,1657
126e9769f45f978f42321c4fc465198982df482b,0,Doug Cutting,2011-10-05 18:11:01+00:00,['3f01ca6b4de96fc5b9167651d4f700b2fcb2c5f4'],1,10,11,485257,3,0.833333333,1,1,1657
29f33991babbc6ba48cb03b067d063d38751a7e9,0,Doug Cutting,2011-10-05 18:20:30+00:00,['126e9769f45f978f42321c4fc465198982df482b'],6,28,34,485291,4,1,1,1,1657
5c4ebdc2113e15afcbde83756a0dc1c0d09935ba,1,Doug Cutting,2011-10-05 18:37:45+00:00,['29f33991babbc6ba48cb03b067d063d38751a7e9'],27,36,63,485354,6,1,1,0,1657
86fa1ce37647ccc27cf85365ace50aa593073394,0,Thiruvalluvan M. G,2011-10-05 19:06:07+00:00,['5c4ebdc2113e15afcbde83756a0dc1c0d09935ba'],24,19,43,485397,3,1,0,0,1657
748e8c1be6a8c44e2a5cda05d05c5668526a7b25,0,Thiruvalluvan M. G,2011-10-05 19:07:38+00:00,['86fa1ce37647ccc27cf85365ace50aa593073394'],0,1,1,485398,1,,,,1657
d7dbac1ad7177bc8065298cc452466b2a39d7a9c,1,Thiruvalluvan M. G,2011-10-05 19:25:56+00:00,['748e8c1be6a8c44e2a5cda05d05c5668526a7b25'],1,4,5,485403,2,,,,1657
240c6945700aa1f2fd7e9c508ae24543a34211f7,1,Doug Cutting,2011-10-05 21:17:31+00:00,['d7dbac1ad7177bc8065298cc452466b2a39d7a9c'],29,1720,1749,487152,7,0.596625767,0.670245399,1,1658
c4fa8c58b9952951ba2307cc2ec796ad05e822e2,0,Thiruvalluvan M. G,2011-10-07 07:20:49+00:00,['240c6945700aa1f2fd7e9c508ae24543a34211f7'],15,27,42,487194,6,0.625,0.875,0.375,1658
a614a28bc9e2f90bf516577252863b8af1cd2e00,1,Thiruvalluvan M. G,2011-10-07 08:34:54+00:00,['c4fa8c58b9952951ba2307cc2ec796ad05e822e2'],1,3,4,487198,2,,,,1658
fdc2c4899f2ba71a661a3b3f239cc17fa7221fb2,0,Thiruvalluvan M. G,2011-10-07 08:59:34+00:00,['a614a28bc9e2f90bf516577252863b8af1cd2e00'],1,4,5,487203,2,,,,1658
85949e751323c72ed55af0a1ba1f47f3a55a318f,1,Thiruvalluvan M. G,2011-10-07 12:51:26+00:00,['fdc2c4899f2ba71a661a3b3f239cc17fa7221fb2'],4,6,10,487213,2,,,,1658
efc3db5634563602e2e504b8b1fe16475f431112,0,Doug Cutting,2011-10-07 20:39:10+00:00,['85949e751323c72ed55af0a1ba1f47f3a55a318f'],5,10,15,487228,1,,,,1658
ff1e35fb0774691aa77ff47b196c5a1e7335240b,0,Doug Cutting,2011-10-07 20:41:37+00:00,['efc3db5634563602e2e504b8b1fe16475f431112'],1,8,9,487237,2,0,0,1,1658
844ea7709ce2ef022cca280b4376cefb6d579c4b,0,Doug Cutting,2011-10-07 21:00:23+00:00,['ff1e35fb0774691aa77ff47b196c5a1e7335240b'],1,5,6,487243,2,,,,1658
c7acde0a81b8413c40b40c5cef2fed13faa1b85d,1,Thiruvalluvan M. G,2011-10-09 08:19:05+00:00,['844ea7709ce2ef022cca280b4376cefb6d579c4b'],2,8,10,487253,2,,,,1658
874faae7323ea0888769ef96bc0d12d23db052ca,0,Thiruvalluvan M. G,2011-10-10 18:06:27+00:00,['c7acde0a81b8413c40b40c5cef2fed13faa1b85d'],1,1,2,487255,1,,,,1658
da44c2318c5dc9bfc4116cd713bcd0eb872e6e5a,1,Doug Cutting,2011-10-11 23:25:04+00:00,['874faae7323ea0888769ef96bc0d12d23db052ca'],140,324,464,487719,39,0.376068376,0.145299145,0.914529915,1658
eb895229861088c0b25dc0b23693920ccee5d593,0,Thiruvalluvan M. G,2011-10-12 12:58:38+00:00,['da44c2318c5dc9bfc4116cd713bcd0eb872e6e5a'],12,28,40,487759,2,0.181818182,0.272727273,0.818181818,1658
c4c44266b38bce822072c200343520c58b4b6902,0,Thiruvalluvan M. G,2011-10-12 13:04:53+00:00,['eb895229861088c0b25dc0b23693920ccee5d593'],1,3,4,487763,2,,,,1658
6e774f574bc75ade354423dadacfa9dd6aa5ff2b,0,Thiruvalluvan M. G,2011-10-12 13:15:18+00:00,['c4c44266b38bce822072c200343520c58b4b6902'],3,27,30,487793,3,0.055555556,1,1,1658
122353642cc8ca30c04908f20e7636b342c30a0d,1,Thiruvalluvan M. G,2011-10-12 13:26:55+00:00,['6e774f574bc75ade354423dadacfa9dd6aa5ff2b'],9,46,55,487848,5,0,0,1,1659
883f32a9d1060d6578176efcc974ae453fc38e72,0,Thiruvalluvan M. G,2011-10-12 15:58:17+00:00,['122353642cc8ca30c04908f20e7636b342c30a0d'],31,49,80,487928,13,0,1,0.714285714,1659
287f348e2e331ebfca808275413585dd99e6865f,1,Thiruvalluvan M. G,2011-10-12 17:11:22+00:00,['883f32a9d1060d6578176efcc974ae453fc38e72'],53,65,118,488046,3,,,,1659
8fad411325a514d8dbf782c2a15ec169f3e428e6,0,Thiruvalluvan M. G,2011-10-14 03:52:53+00:00,['287f348e2e331ebfca808275413585dd99e6865f'],2,8,10,488056,2,,,,1659
5c7076df6a213fb62838a246fa061a34d24858fa,0,Douglas Adam Creager,2011-10-15 13:24:14+00:00,['8fad411325a514d8dbf782c2a15ec169f3e428e6'],1,4,5,488061,2,,,,1659
acbb703c989806356d7edb1d7ff563c913a5cb0e,1,Douglas Adam Creager,2011-10-15 13:30:08+00:00,['5c7076df6a213fb62838a246fa061a34d24858fa'],378,445,823,488884,8,0.145833333,0.708333333,1,1660
d5e1e385ce6464c2c95e1d3aaab7b5d015bf3e81,0,Douglas Adam Creager,2011-10-15 13:34:24+00:00,['acbb703c989806356d7edb1d7ff563c913a5cb0e'],18,58,76,488960,4,1,1,0.25,1660
c909aa17c9f592da6db3dffc3505e91af7545b86,0,Douglas Adam Creager,2011-10-15 13:36:40+00:00,['d5e1e385ce6464c2c95e1d3aaab7b5d015bf3e81'],7,36,43,489003,3,0.941176471,1,0.117647059,1660
0c0a454e4e06cb35fb9db9d5054684f8ea6c16fd,1,Douglas Adam Creager,2011-10-15 13:38:44+00:00,['c909aa17c9f592da6db3dffc3505e91af7545b86'],0,322,322,489325,4,0.035433071,0,1,1660
29fa142825a7b094abb61475e2f787ca3495a316,0,Douglas Adam Creager,2011-10-15 14:08:45+00:00,['0c0a454e4e06cb35fb9db9d5054684f8ea6c16fd'],2,75,77,489402,4,,,,1661
35f6ce9cbc8cbba05efe70a3578bc78ef29da594,0,Douglas Adam Creager,2011-10-15 14:22:30+00:00,['29fa142825a7b094abb61475e2f787ca3495a316'],0,6,6,489408,2,,,,1661
67142f000666b7bb8f344dcd45b0b2608457226d,0,Douglas Adam Creager,2011-10-15 14:32:45+00:00,['35f6ce9cbc8cbba05efe70a3578bc78ef29da594'],1,46,47,489455,3,,,,1662
9eed34dac2bc0203e2e42242d08e90b96fc56fbb,1,Thiruvalluvan M. G,2011-10-17 06:58:53+00:00,['67142f000666b7bb8f344dcd45b0b2608457226d'],0,6,6,489461,2,,,,1662
b4bd442ba87dddefa58143a9793b31df3cb7e708,0,Thiruvalluvan M. G,2011-10-17 07:03:33+00:00,['9eed34dac2bc0203e2e42242d08e90b96fc56fbb'],2,6,8,489469,2,,,,1662
fc986ce223a13e88c11d611c6d3870d023e99d08,1,Thiruvalluvan M. G,2011-10-17 07:14:12+00:00,['b4bd442ba87dddefa58143a9793b31df3cb7e708'],950,2065,3015,492484,53,0.325443787,1,1,1673
6310f6945fd409d27bc1347e993d8dab5c5da8f1,1,Thiruvalluvan M. G,2011-10-17 12:45:11+00:00,['fc986ce223a13e88c11d611c6d3870d023e99d08'],0,13,13,492497,1,,,,1673
ee35b2176aa020353549c1877052094f0cbd35ac,0,Thiruvalluvan M. G,2011-10-17 12:50:33+00:00,['6310f6945fd409d27bc1347e993d8dab5c5da8f1'],0,10,10,492507,2,,,,1673
60c0c5450755ee4dc21d3e6cb575f9291bc7656e,1,Doug Cutting,2011-10-17 20:43:12+00:00,['ee35b2176aa020353549c1877052094f0cbd35ac'],1,235,236,492743,6,0.31147541,0.327868852,1,1675
db12764c2637364addfb835b783533460d49a159,0,Doug Cutting,2011-10-17 20:47:25+00:00,['60c0c5450755ee4dc21d3e6cb575f9291bc7656e'],1,4,5,492748,2,,,,1675
2c39d103b922c3796e3771df1d979daa49cf494f,1,Doug Cutting,2011-10-17 21:03:18+00:00,['db12764c2637364addfb835b783533460d49a159'],1,5,6,492754,2,1,1,1,1675
1628df0503496cef5d3c55b255c44a90a0daa624,0,Thiruvalluvan M. G,2011-10-20 04:50:03+00:00,['2c39d103b922c3796e3771df1d979daa49cf494f'],2,7,9,492763,4,0,0,0,1675
6debff5cf9e7054aeffca17f9e91e87a2fc122f2,1,Thiruvalluvan M. G,2011-10-20 04:54:04+00:00,['1628df0503496cef5d3c55b255c44a90a0daa624'],85,42,127,492890,3,,,,1675
f6ddbe438d7f488314c50d536e2a1b2dd79adf8c,0,Thiruvalluvan M. G,2011-10-20 06:00:09+00:00,['6debff5cf9e7054aeffca17f9e91e87a2fc122f2'],7,10,17,492907,5,,,,1675
2eef70c41920acb336d7910acb0f577a1e83c968,1,Thiruvalluvan M. G,2011-10-21 15:00:25+00:00,['f6ddbe438d7f488314c50d536e2a1b2dd79adf8c'],250,278,528,493435,5,1,0.726315789,1,1675
b151f1f3a0fbb14a840aa33048a42427134f5fb5,0,Doug Cutting,2011-10-21 19:43:25+00:00,['2eef70c41920acb336d7910acb0f577a1e83c968'],9,19,28,493463,1,,,,1675
c542500c8316da5bfc83f9dba58ec8bb07c2a0a8,1,Scott Carey,2011-10-23 23:29:42+00:00,['b151f1f3a0fbb14a840aa33048a42427134f5fb5'],38,58,96,493559,8,0,0,0,1675
23c645641c0dcceff6515a2f00b3d7bc940aba9a,0,Douglas Adam Creager,2011-10-24 14:30:35+00:00,['c542500c8316da5bfc83f9dba58ec8bb07c2a0a8'],0,4,4,493563,2,0,0,0,1675
37f4c480cdfb3367f5482cf07ccd099d1d7a59ab,0,Douglas Adam Creager,2011-10-24 14:37:03+00:00,['23c645641c0dcceff6515a2f00b3d7bc940aba9a'],8,14,22,493585,2,,,,1675
ba6b305d9bf41d7e695132340147809f42e93b23,1,Douglas Adam Creager,2011-10-24 15:03:26+00:00,['37f4c480cdfb3367f5482cf07ccd099d1d7a59ab'],227,11,238,493823,12,,,,1675
cd30b485062b1920887276cc44552590d703f443,0,Doug Cutting,2011-10-24 21:09:01+00:00,['ba6b305d9bf41d7e695132340147809f42e93b23'],5,21,26,493849,3,0.222222222,0.222222222,1,1675
af78321f7d6fb7d35f7eba2116cb8811e38d5ab6,0,Doug Cutting,2011-10-24 22:23:33+00:00,['cd30b485062b1920887276cc44552590d703f443'],16,297,313,494162,31,,,,1675
1ef1b15816702ad7a9bad27a40d8abff34a4b4b8,0,Doug Cutting,2011-10-24 22:46:25+00:00,['af78321f7d6fb7d35f7eba2116cb8811e38d5ab6'],2,4,6,494168,1,,,,1675
12fce370b665d14852bb757f92bd5de99ab5859c,0,Doug Cutting,2011-10-24 22:55:55+00:00,['1ef1b15816702ad7a9bad27a40d8abff34a4b4b8'],2,1,3,494171,1,,,,1675
04d3e592f34d38d17c04a6e7b0217f7ae7ea1feb,0,Doug Cutting,2011-10-24 23:30:49+00:00,['12fce370b665d14852bb757f92bd5de99ab5859c'],79,79,158,494329,2,,,,1675
cc434590d3e8970208bd60c822146b2e2a91382c,0,Thiruvalluvan M. G,2011-10-28 18:06:40+00:00,['04d3e592f34d38d17c04a6e7b0217f7ae7ea1feb'],23,7,30,494359,5,,,,1675
08d0b88a9975956c107f1bbd378ae91550843be6,0,Doug Cutting,2011-10-28 22:14:21+00:00,['cc434590d3e8970208bd60c822146b2e2a91382c'],2,16,18,494377,2,0.5,0.5,1,1675
b0da28f5ba067365251aa0964caf5f3baee6d1bd,1,Doug Cutting,2011-10-28 22:20:07+00:00,['08d0b88a9975956c107f1bbd378ae91550843be6'],49,114,163,494540,5,0.953488372,0.186046512,1,1675
14bad855be78ba3416a0ff477ca8c6ca688ec9a8,0,Doug Cutting,2011-10-28 22:24:14+00:00,['b0da28f5ba067365251aa0964caf5f3baee6d1bd'],7,6,13,494553,2,,,,1675
28fbfce69cb4ad3f9622c18c965c9ca8233c77f3,0,Doug Cutting,2011-10-28 22:28:59+00:00,['14bad855be78ba3416a0ff477ca8c6ca688ec9a8'],1,1,2,494555,1,,,,1675
1db27e251129f32236e2c879c273189d596b63ac,0,Doug Cutting,2011-11-01 18:42:07+00:00,['28fbfce69cb4ad3f9622c18c965c9ca8233c77f3'],13,23,36,494591,14,,,,1675
c1038fad9da75fd0eae6a145690424d180ba73a3,1,Doug Cutting,2011-11-01 19:05:50+00:00,['1db27e251129f32236e2c879c273189d596b63ac'],1,1,2,494593,1,,,,1675
2ce7e30f51cbaec49016bc592df88202e39745ea,1,Doug Cutting,2011-11-01 19:09:06+00:00,['c1038fad9da75fd0eae6a145690424d180ba73a3'],41,165,206,494799,5,0.604166667,0.770833333,0,1675
5a0df85d1fd828969cb8dce1919cd40203c67d9a,0,Doug Cutting,2011-11-01 19:32:54+00:00,['2ce7e30f51cbaec49016bc592df88202e39745ea'],6,458,464,495263,7,1,1,0.627906977,1677
8b58efb07e6613d3a11a9e7b8e04797ffbc82413,1,Doug Cutting,2011-11-04 20:50:17+00:00,['5a0df85d1fd828969cb8dce1919cd40203c67d9a'],61,74,135,495398,6,0,1,1,1677
4e10536f31e6a1de4df0fceb77bfc7d34bbb1b21,1,Doug Cutting,2011-11-04 20:58:36+00:00,['8b58efb07e6613d3a11a9e7b8e04797ffbc82413'],32,62,94,495492,4,1,1,1,1677
729385bed515560f2d2319e9c3519958a4114846,1,Doug Cutting,2011-11-04 21:39:13+00:00,['4e10536f31e6a1de4df0fceb77bfc7d34bbb1b21'],1,10,11,495503,4,,,,1677
478925203c46758ba4cf3123bf7c7fa1f3f7baec,0,Doug Cutting,2011-11-04 21:44:43+00:00,['729385bed515560f2d2319e9c3519958a4114846'],14,14,28,495531,14,,,,1677
4cfa82af2adf6753bef4ce04748a9a7f4237d2d5,0,Doug Cutting,2011-11-04 21:47:48+00:00,['478925203c46758ba4cf3123bf7c7fa1f3f7baec'],1,1,2,495533,1,,,,1677
ed24ecc793981a4eeb15293f11f3ab89ef9a5f11,0,Doug Cutting,2011-11-15 17:33:50+00:00,['4cfa82af2adf6753bef4ce04748a9a7f4237d2d5'],12,22,34,495567,13,,,,1677
0e6318c7415cfc5c814cc01e6bc037fa584adba3,1,Doug Cutting,2011-12-05 23:24:50+00:00,['ed24ecc793981a4eeb15293f11f3ab89ef9a5f11'],61,66,127,495694,7,1,1,0,1677
dac0b38b159434ca492a1bde53ed9d3208266a65,0,Doug Cutting,2011-12-05 23:34:00+00:00,['0e6318c7415cfc5c814cc01e6bc037fa584adba3'],0,13,13,495707,4,1,1,0,1677
7ded439f4f7b6783b6e5334f9ca9310dff8d009a,0,Doug Cutting,2011-12-07 01:19:27+00:00,['dac0b38b159434ca492a1bde53ed9d3208266a65'],0,1,1,495708,1,1,1,0,1677
480e5934ffba54a02361bd40a865cfc1ee80383c,1,Doug Cutting,2011-12-07 22:36:53+00:00,['7ded439f4f7b6783b6e5334f9ca9310dff8d009a'],27,63,90,495798,5,0.928571429,1,0.928571429,1677
f8e718ab54836079fe75ea1d0e60d0154d50448f,0,Doug Cutting,2011-12-07 23:15:57+00:00,['480e5934ffba54a02361bd40a865cfc1ee80383c'],0,23,23,495821,3,0.75,0.75,1,1677
cf4b82354f818e583c8d3ab9c5c171c8ab3acf10,1,Doug Cutting,2011-12-08 00:58:17+00:00,['f8e718ab54836079fe75ea1d0e60d0154d50448f'],4,15,19,495840,3,1,1,0.8,1677
0ba056f58b54d299fbe991102b5aa416ac3ab845,1,Doug Cutting,2011-12-09 20:27:29+00:00,['cf4b82354f818e583c8d3ab9c5c171c8ab3acf10'],6,42,48,495888,6,0.588235294,0.764705882,1,1677
af1ab38314e5b7c6d0d1cee6dfd9478662da8d6f,1,Doug Cutting,2011-12-09 20:41:13+00:00,['0ba056f58b54d299fbe991102b5aa416ac3ab845'],36,184,220,496108,10,0.785714286,0.428571429,0.75,1677
c7919f9b5b52f38b9304799f157e9c3ff292842f,1,Doug Cutting,2011-12-13 00:11:45+00:00,['af1ab38314e5b7c6d0d1cee6dfd9478662da8d6f'],15,36,51,496159,2,0.5,1,0,1677
77480fda068aa8878e6f1002f92cfb436a1b964d,0,Doug Cutting,2011-12-13 00:14:29+00:00,['c7919f9b5b52f38b9304799f157e9c3ff292842f'],0,1,1,496160,1,,,,1677
cc0e5cf5eb7bc7b6dd2bf75064dd84c7d201e6b0,1,Doug Cutting,2011-12-13 00:16:00+00:00,['77480fda068aa8878e6f1002f92cfb436a1b964d'],3,6,9,496169,4,,,,1677
8f0693356c5c35d41e8ba8c40bfd8aa085f67ca9,0,Doug Cutting,2011-12-13 00:28:17+00:00,['cc0e5cf5eb7bc7b6dd2bf75064dd84c7d201e6b0'],2,2,4,496173,2,,,,1677
940493f37adab4c3e0da3f7e98b04037836a18b5,1,Doug Cutting,2011-12-13 18:56:48+00:00,['8f0693356c5c35d41e8ba8c40bfd8aa085f67ca9'],7,32,39,496212,6,0.75,0.75,0.75,1677
f95e27221ec2bb39fc29e46c4b4789e87142cc5a,0,Douglas Adam Creager,2011-12-13 19:44:37+00:00,['940493f37adab4c3e0da3f7e98b04037836a18b5'],20,24,44,496256,7,,,,1677
09e1155948e295b9fed27bf76d57125d75063726,1,Douglas Adam Creager,2011-12-13 19:54:32+00:00,['f95e27221ec2bb39fc29e46c4b4789e87142cc5a'],32,101,133,496389,4,0,0.9375,1,1678
2d4458383bd8a4a99da25171525ae9716061a339,0,Doug Cutting,2011-12-16 19:35:35+00:00,['09e1155948e295b9fed27bf76d57125d75063726'],20,128,148,496537,3,0.372881356,1,1,1678
9aed3b71c2e80014f8d3239273304a761891dd16,1,Douglas Adam Creager,2011-12-20 02:09:23+00:00,['2d4458383bd8a4a99da25171525ae9716061a339'],26,78,104,496641,6,1,0.921052632,0.026315789,1678
fdcb6c279bbc966d0d919333de43aa2f849d62e0,1,Douglas Adam Creager,2011-12-20 02:27:44+00:00,['9aed3b71c2e80014f8d3239273304a761891dd16'],19,695,714,497355,9,0.2625,0.38,0.385,1680
62d3cac249d5858d0650e1e5a1925ff98f4f05c1,0,Doug Cutting,2011-12-20 19:28:48+00:00,['fdcb6c279bbc966d0d919333de43aa2f849d62e0'],1,1,2,497357,1,,,,1680
2874dfde27e4390f9b2510629dacff9d2db409d6,1,Douglas Adam Creager,2011-12-27 15:14:49+00:00,['62d3cac249d5858d0650e1e5a1925ff98f4f05c1'],1,472,473,497830,4,0.057377049,0.635245902,0.56557377,1681
ebbcdcacd48ecb210a165de2d149582c87baca85,1,James Baldassari,2012-01-17 15:27:18+00:00,['2874dfde27e4390f9b2510629dacff9d2db409d6'],1,8,9,497839,2,0,0,1,1681
d72dafc3e20c310271e45acb371529e18e0c2fc4,0,James Baldassari,2012-01-17 18:00:56+00:00,['ebbcdcacd48ecb210a165de2d149582c87baca85'],1,1,2,497841,1,,,,1681
40b2a8672349cad661cf53f07d52d2219585e2fb,1,James Baldassari,2012-01-17 19:42:22+00:00,['d72dafc3e20c310271e45acb371529e18e0c2fc4'],0,40,40,497881,2,1,1,0.666666667,1681
b180bd8ab188342dc989740e082e2bf3487882fa,0,Doug Cutting,2012-01-23 23:26:39+00:00,['40b2a8672349cad661cf53f07d52d2219585e2fb'],9,16,25,497906,4,1,1,1,1681
b4ad6eb2375b93bfafde60fef3df4d1df021141b,0,Doug Cutting,2012-01-23 23:31:51+00:00,['b180bd8ab188342dc989740e082e2bf3487882fa'],13,8,21,497927,3,0,0,0,1681
c31563877d3ce82dda14d553d1132fecacc87c86,0,Doug Cutting,2012-01-23 23:43:26+00:00,['b4ad6eb2375b93bfafde60fef3df4d1df021141b'],1,45,46,497973,3,0.344827586,1,0.793103448,1681
2af5295264a8d9fb13f5aa18ed860b67e51703b9,0,Doug Cutting,2012-01-24 21:35:12+00:00,['c31563877d3ce82dda14d553d1132fecacc87c86'],1,3,4,497977,2,,,,1681
cef41283f2b5efd606d4a810e021218ee15a9fd9,0,Douglas Adam Creager,2012-01-26 13:59:22+00:00,['2af5295264a8d9fb13f5aa18ed860b67e51703b9'],0,5,5,497982,2,,,,1681
2681d58693dcf0c7987307e939e3c551880e93d3,0,Douglas Adam Creager,2012-01-26 14:02:11+00:00,['cef41283f2b5efd606d4a810e021218ee15a9fd9'],1,5,6,497988,2,,,,1681
dbab66b91b879c902e700a0ca9bbdd48696cbf5b,1,Douglas Adam Creager,2012-01-26 16:47:31+00:00,['2681d58693dcf0c7987307e939e3c551880e93d3'],8,194,202,498190,9,0.271028037,0.252336449,1,1683
f36a3b4bb5e9bc58f9bbe4579f8db2dd60ae45a3,0,Douglas Adam Creager,2012-02-01 17:38:31+00:00,['dbab66b91b879c902e700a0ca9bbdd48696cbf5b'],3,12,15,498205,2,0,0,1,1683
c0d9d5c0be6ac5627f3a2009acb46840fc7305b4,1,Thiruvalluvan M. G,2012-02-02 19:11:25+00:00,['f36a3b4bb5e9bc58f9bbe4579f8db2dd60ae45a3'],1767,2336,4103,502308,26,0.50802139,0.556149733,0.320855615,1690
634fead210e40e93f848389eff6118a1a2541d61,0,Thiruvalluvan M. G,2012-02-04 01:59:50+00:00,['c0d9d5c0be6ac5627f3a2009acb46840fc7305b4'],0,0,0,502308,4,,,,1690
29f8701a42d172cf4b9a2a474000d509f34a2d46,1,James Baldassari,2012-02-07 07:23:55+00:00,['634fead210e40e93f848389eff6118a1a2541d61'],8,116,124,502432,4,0,1,1,1691
70e19ce67e3ade7237663097c1952ed32f6b16b2,1,Scott Carey,2012-02-07 19:25:09+00:00,['29f8701a42d172cf4b9a2a474000d509f34a2d46'],428,330,758,503190,16,,,,1691
044c065e73bd04f639e7f26a9a8a3166fd3ab821,1,Doug Cutting,2012-02-07 22:15:41+00:00,['70e19ce67e3ade7237663097c1952ed32f6b16b2'],2,37,39,503229,8,1,1,1,1691
e99366aa5977c973a7be3ca96adf51b3bf52801f,1,Doug Cutting,2012-02-07 22:22:16+00:00,['044c065e73bd04f639e7f26a9a8a3166fd3ab821'],2,18,20,503249,3,0.555555556,1,1,1691
0b1df07d7172c6b847fb3e5e6c9d7bdb1752aab3,0,Doug Cutting,2012-02-07 22:40:58+00:00,['e99366aa5977c973a7be3ca96adf51b3bf52801f'],1,15,16,503265,2,1,1,1,1691
d517dcd5a1df13c49048ec19ad694e61edf2b5fd,0,Doug Cutting,2012-02-07 22:49:34+00:00,['0b1df07d7172c6b847fb3e5e6c9d7bdb1752aab3'],16,44,60,503325,4,,,,1691
c003680ca9f06f87e54385a84f30715358951537,0,Scott Carey,2012-02-07 23:37:19+00:00,['d517dcd5a1df13c49048ec19ad694e61edf2b5fd'],0,2,2,503327,1,,,,1691
d21d80226046af0947a860f249f1131c3671cedb,0,Scott Carey,2012-02-07 23:40:18+00:00,['c003680ca9f06f87e54385a84f30715358951537'],1,1,2,503329,1,,,,1691
142bcd964e4b2b519b010ed377eb9101d0cfdb7d,0,James Baldassari,2012-02-08 03:24:31+00:00,['d21d80226046af0947a860f249f1131c3671cedb'],0,201,201,503530,2,0.394736842,1,1,1692
69e23098c6ef347ebdcd4cb0a83c22b2a70f4e72,1,James Baldassari,2012-02-08 03:42:02+00:00,['142bcd964e4b2b519b010ed377eb9101d0cfdb7d'],7,53,60,503590,3,0.033333333,1,1,1692
17207770e6e311d2faae7e47149b6b3cf6a2b2a3,1,Scott Carey,2012-02-08 18:46:11+00:00,['69e23098c6ef347ebdcd4cb0a83c22b2a70f4e72'],11,24,35,503625,5,,,,1692
e5c993189cdfddc4e42c65304ecdecf9c423b411,0,Scott Carey,2012-02-08 20:08:24+00:00,['17207770e6e311d2faae7e47149b6b3cf6a2b2a3'],79,94,173,503798,8,,,,1692
212c6ee756eba7a622148eaf7382ce6b7500e799,0,Doug Cutting,2012-02-08 22:11:14+00:00,['e5c993189cdfddc4e42c65304ecdecf9c423b411'],4,8,12,503810,1,,,,1692
234487d0a347a100210258aea1466a2d3cde8509,1,Doug Cutting,2012-02-08 22:13:50+00:00,['212c6ee756eba7a622148eaf7382ce6b7500e799'],8,130,138,503948,11,0,1,0.5,1695
abe9f8d8be7e75417a19c73e65bdab2c781a213b,1,Doug Cutting,2012-02-09 00:15:22+00:00,['234487d0a347a100210258aea1466a2d3cde8509'],10,70,80,504028,6,0.880952381,0.19047619,1,1695
fc616d5176ed4750c2382bb229aef9f1c62ea78e,1,Thiruvalluvan M. G,2012-02-09 18:11:42+00:00,['abe9f8d8be7e75417a19c73e65bdab2c781a213b'],256,505,761,504789,59,1,1,0.891891892,1696
6f117bde64f18e2b1920c732dbbf1e8ff16b1a0f,0,Doug Cutting,2012-02-09 21:38:13+00:00,['fc616d5176ed4750c2382bb229aef9f1c62ea78e'],4,14,18,504807,2,,,,1696
2850cfb21f3b2463205a4defda9bdcf0999ba93a,0,Doug Cutting,2012-02-09 22:03:17+00:00,['6f117bde64f18e2b1920c732dbbf1e8ff16b1a0f'],1,37,38,504845,2,,,,1696
7fc68def2d27219fafd282c9525a3ad167e00b24,0,Doug Cutting,2012-02-09 22:30:15+00:00,['2850cfb21f3b2463205a4defda9bdcf0999ba93a'],17,15,32,504877,15,,,,1696
753c54f0c060e098cce00a125f6ce022dfa86815,1,Douglas Adam Creager,2012-02-09 23:26:32+00:00,['7fc68def2d27219fafd282c9525a3ad167e00b24'],102,109,211,505088,7,1,1,1,1696
a985f082ef6af57eb453228b0c74cf8222a28cf9,0,Doug Cutting,2012-02-15 00:43:44+00:00,['753c54f0c060e098cce00a125f6ce022dfa86815'],13,21,34,505122,14,,,,1696
9869e9b5db2e54a072f46cebf7044fcfbd8ca166,0,Doug Cutting,2012-02-22 22:49:15+00:00,['a985f082ef6af57eb453228b0c74cf8222a28cf9'],2,4,6,505128,2,,,,1696
61b059be57010a44023474ff40242a5c6e32ec75,0,Scott Carey,2012-02-24 22:43:32+00:00,['9869e9b5db2e54a072f46cebf7044fcfbd8ca166'],2,4,6,505134,2,,,,1696
17aec14ebba7764fb20cf4745157788dfcfe78ab,1,Doug Cutting,2012-02-24 23:47:15+00:00,['61b059be57010a44023474ff40242a5c6e32ec75'],22,178,200,505334,8,,,,1699
6de7a277f7c58af8f5d831176951291cd2d87d81,0,Douglas Adam Creager,2012-02-29 01:24:29+00:00,['17aec14ebba7764fb20cf4745157788dfcfe78ab'],9,12,21,505355,3,,,,1699
a77a88d8b2afbfd3bf57546aa03a0c4f56699426,0,Douglas Adam Creager,2012-02-29 01:33:03+00:00,['6de7a277f7c58af8f5d831176951291cd2d87d81'],4,54,58,505413,4,0,1,1,1700
8f779e177336039e695e4e4c97a8e152ed6ea815,0,Douglas Adam Creager,2012-03-01 03:52:24+00:00,['a77a88d8b2afbfd3bf57546aa03a0c4f56699426'],1,4,5,505418,2,,,,1700
0ad579a6276a75f018d60be364534ad2d142db69,0,Douglas Adam Creager,2012-03-01 03:54:53+00:00,['8f779e177336039e695e4e4c97a8e152ed6ea815'],1,10,11,505429,2,0,0,1,1700
523d2de7141ff2e6a3416a0e04a647a4283e3d8f,0,Douglas Adam Creager,2012-03-01 04:01:09+00:00,['0ad579a6276a75f018d60be364534ad2d142db69'],3,413,416,505845,4,0.144230769,1,0.418269231,1701
98b14a071b3e5b6aa7c694731099f72ae22a3473,0,Doug Cutting,2012-03-02 21:50:20+00:00,['523d2de7141ff2e6a3416a0e04a647a4283e3d8f'],1,23,24,505869,3,1,1,1,1701
c9dfafb695b7d7b3e4f637e0f9af862c6dad8a28,1,Doug Cutting,2012-03-02 22:09:30+00:00,['98b14a071b3e5b6aa7c694731099f72ae22a3473'],2,11,13,505882,2,0,0,0,1701
6979b94bbf1cdbd6845553424d9e6b1228931375,0,Doug Cutting,2012-03-02 22:23:28+00:00,['c9dfafb695b7d7b3e4f637e0f9af862c6dad8a28'],16,14,30,505912,14,,,,1701
66a34cf75e174d15451746f1b509993538603df3,0,Doug Cutting,2012-03-02 23:31:45+00:00,['6979b94bbf1cdbd6845553424d9e6b1228931375'],1,1,2,505914,1,,,,1701
87c3c2f57e0e2b67088ec3148a8a410ef8e4c0e6,0,Doug Cutting,2012-03-07 20:58:46+00:00,['66a34cf75e174d15451746f1b509993538603df3'],0,8,8,505922,1,,,,1701
0ea74a36cebb2e5fbc37e599814a05c33cb7d424,1,Doug Cutting,2012-03-07 21:01:33+00:00,['87c3c2f57e0e2b67088ec3148a8a410ef8e4c0e6'],0,1238,1238,507160,8,0.513793103,0.613793103,0.668965517,1707
989b7b643a038f32a84f14f428ca901b5bbfdef0,0,Doug Cutting,2012-03-07 21:04:32+00:00,['0ea74a36cebb2e5fbc37e599814a05c33cb7d424'],13,13,26,507186,13,,,,1707
17e0ec1ab5762644682900251ae5ad4eb8bdd249,1,Miki Tebeka,2012-03-16 17:07:38+00:00,['989b7b643a038f32a84f14f428ca901b5bbfdef0'],25,148,173,507359,2,0.295081967,0,0.704918033,1707
23fc278df3a8ae5a2b9093f9b91934d58a184fee,0,Miki Tebeka,2012-03-16 17:08:17+00:00,['17e0ec1ab5762644682900251ae5ad4eb8bdd249'],0,6,6,507365,1,,,,1707
36f9b467e714eff199edac938c00e017accefa5a,1,Doug Cutting,2012-03-16 23:12:08+00:00,['23fc278df3a8ae5a2b9093f9b91934d58a184fee'],6,31,37,507402,4,1,0.928571429,1,1707
5cac72e7c1173faae8da920eb9461b9ea958f96f,0,Thiruvalluvan M. G,2012-04-12 11:24:41+00:00,['36f9b467e714eff199edac938c00e017accefa5a'],11,14,25,507427,2,0,0,0,1707
446bd1be05c2e1c385d24b31e79504a9fcb1b4b2,1,Doug Cutting,2012-04-13 19:03:12+00:00,['5cac72e7c1173faae8da920eb9461b9ea958f96f'],0,6255,6255,513682,54,0.547027507,0.965838509,0.913487134,1758
2cb83f478424c00d36d2b58cae1508d1ab4df235,1,Doug Cutting,2012-04-16 20:37:18+00:00,['446bd1be05c2e1c385d24b31e79504a9fcb1b4b2'],3,5,8,513690,3,,,,1758
6fd751939e1759654c174b863637fad12ced9269,0,Thiruvalluvan M. G,2012-04-22 09:40:58+00:00,['2cb83f478424c00d36d2b58cae1508d1ab4df235'],1,3,4,513694,2,,,,1758
64664a630cb0674f145a1b8f4ef132b83bde9523,0,Thiruvalluvan M. G,2012-04-22 12:40:09+00:00,['6fd751939e1759654c174b863637fad12ced9269'],0,54,54,513748,2,,,,1758
52ea2d88416fbf964cfd6bf1c6c959596ed1063e,1,Douglas Adam Creager,2012-04-28 19:40:52+00:00,['64664a630cb0674f145a1b8f4ef132b83bde9523'],951,2372,3323,517071,77,0.919642857,0.330357143,0.758928571,1763
03dfcb3c4ce15896c12b39f96dbe3de1894dc172,0,Douglas Adam Creager,2012-04-28 19:47:28+00:00,['52ea2d88416fbf964cfd6bf1c6c959596ed1063e'],3,6,9,517080,2,,,,1763
acfa07feb6b47e554d14429c3c98a8810ac3be42,0,Doug Cutting,2012-05-08 21:21:21+00:00,['03dfcb3c4ce15896c12b39f96dbe3de1894dc172'],1,1,2,517082,1,,,,1763
6cf7a47b16039ee50cd616eedf23e8e166d457e4,0,Doug Cutting,2012-05-08 21:43:48+00:00,['acfa07feb6b47e554d14429c3c98a8810ac3be42'],0,6,6,517088,2,,,,1763
34ece34c097347fd06b0e4f717d5d102266e25ff,0,Thiruvalluvan M. G,2012-05-09 07:35:47+00:00,['6cf7a47b16039ee50cd616eedf23e8e166d457e4'],2,4,6,517094,2,,,,1763
6eb2c5801e9029b22e5800a86986bde03d5541b9,0,Thiruvalluvan M. G,2012-05-09 08:33:38+00:00,['34ece34c097347fd06b0e4f717d5d102266e25ff'],0,5,5,517099,3,0,0,1,1763
b50ab97269c4c52bf45db27d5b54e0d6e0e4154c,0,Thiruvalluvan M. G,2012-05-11 18:07:25+00:00,['6eb2c5801e9029b22e5800a86986bde03d5541b9'],2,11,13,517112,3,0,1,1,1763
563afdbf1e35b7d12723d0c88562a8f277ddd353,0,Thiruvalluvan M. G,2012-05-13 17:28:18+00:00,['b50ab97269c4c52bf45db27d5b54e0d6e0e4154c'],1,1,2,517114,2,,,,1763
0b0a574620b6ab87f36e4cad8480e9872c40f90a,0,Thiruvalluvan M. G,2012-05-16 07:58:45+00:00,['563afdbf1e35b7d12723d0c88562a8f277ddd353'],6,643,649,517763,9,0.303030303,0.474747475,0.593434343,1767
5e8664c16e75d4d9a4523d368ef75290fd0ea4c2,0,Thiruvalluvan M. G,2012-05-16 08:11:58+00:00,['0b0a574620b6ab87f36e4cad8480e9872c40f90a'],1,4,5,517768,2,0,1,0,1767
c6cf5d5fc36c69525dbf3712af42014a3da417e0,0,Thiruvalluvan M. G,2012-05-16 08:21:01+00:00,['5e8664c16e75d4d9a4523d368ef75290fd0ea4c2'],0,14,14,517782,2,,,,1767
7d46ba4ab4c4589e544f3df51b9d4552771b14fb,0,Thiruvalluvan M. G,2012-05-16 08:27:45+00:00,['c6cf5d5fc36c69525dbf3712af42014a3da417e0'],3,32,35,517817,2,0.083333333,0,0.916666667,1767
e16dd633702a190f91767a14c33393e2d0bbbf91,0,Doug Cutting,2012-05-16 21:24:16+00:00,['7d46ba4ab4c4589e544f3df51b9d4552771b14fb'],2,5,7,517824,2,,,,1767
7fb563982d6f44d05a6f3c578a6948e7c7d6f1e5,0,Doug Cutting,2012-05-16 21:47:22+00:00,['e16dd633702a190f91767a14c33393e2d0bbbf91'],1,78,79,517903,3,1,0.714285714,1,1768
02802d57b0698cacf72668fa50ca93e77c12b302,0,Doug Cutting,2012-05-16 21:57:46+00:00,['7fb563982d6f44d05a6f3c578a6948e7c7d6f1e5'],4,33,37,517940,5,0.052631579,0.947368421,1,1768
4a6cd2780b741db3a01296f758abdd6fcaa71a40,0,Doug Cutting,2012-05-17 19:04:45+00:00,['02802d57b0698cacf72668fa50ca93e77c12b302'],4,10,14,517954,1,,,,1768
5be068e83656f026c68ebe78bb039b84165564e5,1,Doug Cutting,2012-05-17 19:50:49+00:00,['4a6cd2780b741db3a01296f758abdd6fcaa71a40'],14,212,226,518180,10,0.763157895,0.973684211,0.859649123,1769
1f3580f5d53746eaf8eb1d5d0fad00a18971666c,1,Doug Cutting,2012-05-17 20:16:07+00:00,['5be068e83656f026c68ebe78bb039b84165564e5'],11,16,27,518207,2,1,,,1769
2020c8a8cc19c58eaef2d9de75260e7341099038,1,Doug Cutting,2012-05-17 21:12:43+00:00,['1f3580f5d53746eaf8eb1d5d0fad00a18971666c'],5,421,426,518633,8,0.906382979,0.774468085,0.982978723,1773
f84b9a4b6af31a7758f48f947e6a8fde1f126661,0,Doug Cutting,2012-05-17 21:17:20+00:00,['2020c8a8cc19c58eaef2d9de75260e7341099038'],0,11,11,518644,3,1,1,1,1773
d4151ed11a8a0f2a5a2032d524951efb3d50560e,1,Doug Cutting,2012-05-17 21:23:04+00:00,['f84b9a4b6af31a7758f48f947e6a8fde1f126661'],1,37,38,518682,3,1,1,1,1774
d3b4045aa537e048c2df007afd6e54b7ace5f272,0,Doug Cutting,2012-05-17 22:30:23+00:00,['d4151ed11a8a0f2a5a2032d524951efb3d50560e'],0,4,4,518686,2,1,1,1,1774
91af47b9ef66965d1df524c555d29af24d9b75c4,1,Doug Cutting,2012-05-18 21:29:10+00:00,['d3b4045aa537e048c2df007afd6e54b7ace5f272'],4,70,74,518760,4,0.833333333,1,1,1776
dc4d37dd6d5d69ea27ffff797d926b9042719643,0,Doug Cutting,2012-05-18 21:38:30+00:00,['91af47b9ef66965d1df524c555d29af24d9b75c4'],19,20,39,518799,2,0,0,0,1776
2567f66612bc97f984f52be54b0b213882a52287,0,Doug Cutting,2012-05-18 21:49:15+00:00,['dc4d37dd6d5d69ea27ffff797d926b9042719643'],33,93,126,518925,5,0.105263158,1,0.842105263,1776
aa24373e12a75bff689a543711391597d0e63e6b,0,Douglas Adam Creager,2012-05-20 13:41:50+00:00,['2567f66612bc97f984f52be54b0b213882a52287'],0,5,5,518930,3,0.5,1,0.5,1776
e7619cc5dec31c6db342d341504635048d60afb1,0,Douglas Adam Creager,2012-05-20 13:51:19+00:00,['aa24373e12a75bff689a543711391597d0e63e6b'],3,2,5,518935,2,,,,1776
24673177ca18128f1c5dd137e5968ae4e8359e7f,0,Douglas Adam Creager,2012-05-20 13:56:57+00:00,['e7619cc5dec31c6db342d341504635048d60afb1'],2,80,82,519017,4,0.033333333,1,1,1777
78b172c040f934ad59635b69ff797a09ff039136,0,Douglas Adam Creager,2012-05-20 14:02:53+00:00,['24673177ca18128f1c5dd137e5968ae4e8359e7f'],0,15,15,519032,4,0,0.153846154,0,1777
b49babe09e3c2a83fee4d52b11822d500ebc67f1,0,Douglas Adam Creager,2012-05-20 14:05:09+00:00,['78b172c040f934ad59635b69ff797a09ff039136'],0,5,5,519037,2,0,1,1,1777
46726e0e5b5a722096a2594c83946ac5c996bd10,0,Douglas Adam Creager,2012-05-20 14:09:45+00:00,['b49babe09e3c2a83fee4d52b11822d500ebc67f1'],0,13,13,519050,2,,,,1777
60d75c554ccbc72b8a60c5759f0175ae07e8254a,1,Douglas Adam Creager,2012-05-20 14:14:08+00:00,['46726e0e5b5a722096a2594c83946ac5c996bd10'],9,448,457,519507,2,0.331858407,0.632743363,0.632743363,1777
fbb36181e2b30571b71d177986f0e75285736866,0,Douglas Adam Creager,2012-05-20 14:24:19+00:00,['60d75c554ccbc72b8a60c5759f0175ae07e8254a'],14,98,112,519619,6,0.148148148,1,1,1777
bc4e7d8066a1ee564c096fc940e34f1b45c07eec,0,Douglas Adam Creager,2012-05-20 14:29:15+00:00,['fbb36181e2b30571b71d177986f0e75285736866'],0,44,44,519663,3,,,,1779
034665d0cd02b90558bb39115f7f1f2b42e4e156,1,Thiruvalluvan M. G,2012-05-20 16:39:14+00:00,['bc4e7d8066a1ee564c096fc940e34f1b45c07eec'],14,16,30,519693,3,,,,1779
b6632258952f5e60a1a40c10ea2625ba6c1f841f,1,Thiruvalluvan M. G,2012-05-20 16:51:44+00:00,['034665d0cd02b90558bb39115f7f1f2b42e4e156'],137,440,577,520270,17,1,1,0.090909091,1780
099e20794a818ccb5cbab71d1934c784ed45ac14,0,Douglas Adam Creager,2012-05-21 12:00:28+00:00,['b6632258952f5e60a1a40c10ea2625ba6c1f841f'],4,4,8,520278,1,,,,1780
3c2cec4957178552c5e325e622da270d863815f6,1,Douglas Adam Creager,2012-05-21 12:28:02+00:00,['099e20794a818ccb5cbab71d1934c784ed45ac14'],6,139,145,520423,4,0.333333333,0.305555556,1,1781
b52d006922d50150e4de9b447f44be574bef9633,0,Miki Tebeka,2012-05-21 19:14:20+00:00,['3c2cec4957178552c5e325e622da270d863815f6'],5,4,9,520432,1,,,,1781
ab4fe4f2647bca4123a6c1f5f5012958d75affcf,0,Doug Cutting,2012-05-21 20:49:19+00:00,['b52d006922d50150e4de9b447f44be574bef9633'],1,111,112,520544,7,,,,1781
c7e3f4a687564b125686f4a075d8fcfa90d63aaf,1,Doug Cutting,2012-05-21 22:14:15+00:00,['ab4fe4f2647bca4123a6c1f5f5012958d75affcf'],2,752,754,521298,4,0.4778157,0.744027304,0.57337884,1783
a581cf389f5d4ce82ff95f3d9d98efbe326cacae,0,Doug Cutting,2012-05-23 20:28:44+00:00,['c7e3f4a687564b125686f4a075d8fcfa90d63aaf'],1,23,24,521322,3,1,1,1,1783
ea125d9f3a7aaa3876bab84b08a0d7f1fa2e8904,0,Doug Cutting,2012-05-23 20:34:58+00:00,['a581cf389f5d4ce82ff95f3d9d98efbe326cacae'],0,5,5,521327,2,,,,1783
172408e77233aa562d5b3a5c3fae9c8a7160ca86,1,Doug Cutting,2012-05-23 20:42:11+00:00,['ea125d9f3a7aaa3876bab84b08a0d7f1fa2e8904'],93,33,126,521453,5,0.894736842,0,0.157894737,1783
f9a423d2a85d820cec8404a254b605f56eb070c7,0,Doug Cutting,2012-05-23 21:02:01+00:00,['172408e77233aa562d5b3a5c3fae9c8a7160ca86'],14,14,28,521481,14,,,,1783
3a7cc7ea565e8ff1a5dc6b106f7828e0922916c7,0,Douglas Adam Creager,2012-06-07 17:40:30+00:00,['f9a423d2a85d820cec8404a254b605f56eb070c7'],1,9,10,521491,2,1,1,1,1783
a39e6deea243dcd9a09df8f67af724003dec1d02,0,Doug Cutting,2012-06-07 20:41:44+00:00,['3a7cc7ea565e8ff1a5dc6b106f7828e0922916c7'],4,71,75,521566,3,1,1,1,1784
a760e09477b74b640ff8796c02da1c2be8585d1f,0,Doug Cutting,2012-06-07 20:47:28+00:00,['a39e6deea243dcd9a09df8f67af724003dec1d02'],1,1,2,521568,1,,,,1784
cbe3f07f01fa77c0f4cf6d18393856bcc01d5db5,0,Doug Cutting,2012-06-11 20:08:06+00:00,['a760e09477b74b640ff8796c02da1c2be8585d1f'],13,22,35,521603,14,,,,1784
f563913d15ec74a44ca86c8bd528b3573a4b031a,0,Doug Cutting,2012-06-11 21:51:50+00:00,['cbe3f07f01fa77c0f4cf6d18393856bcc01d5db5'],215,259,474,522077,44,,,,1784
dedacbf2e159dbf695aad3e9669940da0cc55a2c,1,Doug Cutting,2012-06-12 19:46:29+00:00,['f563913d15ec74a44ca86c8bd528b3573a4b031a'],1,899,900,522977,4,0.417302799,0.875318066,0.730279898,1786
98cffd10bbdb249a962e77ec6fbc993e56279b8e,0,Doug Cutting,2012-06-12 19:48:32+00:00,['dedacbf2e159dbf695aad3e9669940da0cc55a2c'],2,15,17,522994,2,0,1,1,1786
03f675f14810ae9341632a9b9d077afd74887473,0,Doug Cutting,2012-06-15 18:25:38+00:00,['98cffd10bbdb249a962e77ec6fbc993e56279b8e'],5,28,33,523027,4,1,1,1,1786
eaa8213371b88ceb301520235782db7bc95358d4,0,Doug Cutting,2012-06-15 21:29:12+00:00,['03f675f14810ae9341632a9b9d077afd74887473'],10,150,160,523187,7,0.282352941,1,0.8,1786
04f9469cc9e9e0cbb8158cd503612bccef2ade1b,0,Douglas Adam Creager,2012-06-18 21:40:26+00:00,['eaa8213371b88ceb301520235782db7bc95358d4'],0,171,171,523358,3,0.044642857,0.276785714,1,1787
69135f593004a942c43fec1194148689df5b1d0a,0,Douglas Adam Creager,2012-06-18 21:43:20+00:00,['04f9469cc9e9e0cbb8158cd503612bccef2ade1b'],7,33,40,523398,3,0,1,0,1787
6e9b037d4f4bcdfc955ffec71dea0f195d81c2a8,0,Douglas Adam Creager,2012-06-22 11:54:01+00:00,['69135f593004a942c43fec1194148689df5b1d0a'],0,9,9,523407,3,0,0.2,0.8,1787
f60833f8d4251691ea9134beacaf0abc09afdea8,0,Douglas Adam Creager,2012-06-22 11:59:32+00:00,['6e9b037d4f4bcdfc955ffec71dea0f195d81c2a8'],16,18,34,523441,3,0,1,0,1787
061fc31088fe6f2d2a96253607c47c2d56c016ea,0,Doug Cutting,2012-07-02 22:12:43+00:00,['f60833f8d4251691ea9134beacaf0abc09afdea8'],11,77,88,523529,3,0,1,0.849056604,1787
fdba5e0eb725230fc1cb55b653bb88f597015728,0,Thiruvalluvan M. G,2012-07-04 09:10:24+00:00,['061fc31088fe6f2d2a96253607c47c2d56c016ea'],12,21,33,523562,4,0,1,1,1787
f64893200b21f504c0bc291789de093728fae4ab,0,Doug Cutting,2012-07-05 21:41:47+00:00,['fdba5e0eb725230fc1cb55b653bb88f597015728'],27,300,327,523889,4,0.85,1,0.914285714,1789
dd4db64fdcd29966924effefa747d50a1a256700,1,Thiruvalluvan M. G,2012-07-12 18:17:44+00:00,['f64893200b21f504c0bc291789de093728fae4ab'],3,68,71,523960,3,0,0,1,1789
10c9b56e8af246d884c7f549bfe2d011881f8df8,0,Doug Cutting,2012-07-12 19:03:25+00:00,['dd4db64fdcd29966924effefa747d50a1a256700'],10,12,22,523982,2,,,,1789
b49190ec19694313d287331e48f03c6f4aae90fb,0,Doug Cutting,2012-07-12 19:23:44+00:00,['10c9b56e8af246d884c7f549bfe2d011881f8df8'],15,16,31,524013,14,,,,1789
85a0b7c2e7caff6a3836fdf97cc68c521036b7a7,0,Doug Cutting,2012-07-18 22:15:03+00:00,['b49190ec19694313d287331e48f03c6f4aae90fb'],13,21,34,524047,14,,,,1789
fa3db4e5b698ce3787ec3b0d7e60ee8410aec240,0,Doug Cutting,2012-07-19 21:25:00+00:00,['85a0b7c2e7caff6a3836fdf97cc68c521036b7a7'],1,5,6,524053,3,0,1,1,1789
eaa43dbcf545d2b28d5ed49b86e85d25742fc5ed,0,Thiruvalluvan M. G,2012-07-24 02:29:20+00:00,['fa3db4e5b698ce3787ec3b0d7e60ee8410aec240'],1,3,4,524057,2,,,,1789
be2f37890c7368277aabad722bad608f9d0fcb12,0,Doug Cutting,2012-08-01 21:12:38+00:00,['eaa43dbcf545d2b28d5ed49b86e85d25742fc5ed'],1,2,3,524060,1,,,,1789
196011b43149f38797fb7c462a0a46e0263d9f4e,0,Doug Cutting,2012-08-01 21:14:30+00:00,['be2f37890c7368277aabad722bad608f9d0fcb12'],14,56,70,524130,11,0.857142857,1,0.464285714,1789
a76428f0e1e3d0fef6a596eb953a1a79facd5006,0,Thiruvalluvan M. G,2012-08-20 07:58:25+00:00,['196011b43149f38797fb7c462a0a46e0263d9f4e'],1,3,4,524134,2,,,,1789
ab5eb85475902d62de9b16ad2f008b4f7f385f4a,0,Thiruvalluvan M. G,2012-08-20 08:03:34+00:00,['a76428f0e1e3d0fef6a596eb953a1a79facd5006'],1,3,4,524138,2,,,,1789
1096f34fa9dd01d418616a00184029f2a85c1bca,0,Doug Cutting,2012-08-23 21:35:05+00:00,['ab5eb85475902d62de9b16ad2f008b4f7f385f4a'],0,1,1,524139,1,,,,1789
31d32f47d50ffcf48f5e785212cc2140e7554681,0,Thiruvalluvan M. G,2012-08-27 04:53:02+00:00,['1096f34fa9dd01d418616a00184029f2a85c1bca'],1,19,20,524159,3,0.769230769,1,1,1789
9babffef5210c3d1621fb99c9b516cdd920d8821,0,Thiruvalluvan M. G,2012-09-09 04:45:51+00:00,['31d32f47d50ffcf48f5e785212cc2140e7554681'],6,16,22,524181,3,0,0,1,1789
6816e60f93ad02388b4fbcf4b9a0c70a7f640ef6,1,Doug Cutting,2012-09-10 18:31:48+00:00,['9babffef5210c3d1621fb99c9b516cdd920d8821'],5,61,66,524247,3,0.689655172,0.689655172,1,1789
df362fa186cd0ed08737391f430e7068aff04f34,1,Doug Cutting,2012-09-10 23:39:58+00:00,['6816e60f93ad02388b4fbcf4b9a0c70a7f640ef6'],3,6,9,524256,1,,,,1789
911cc53aea0ed2f26fe772b7d4751f2691233a01,1,Doug Cutting,2012-09-10 23:40:25+00:00,['df362fa186cd0ed08737391f430e7068aff04f34'],20,78,98,524354,6,0.941176471,0.941176471,0.735294118,1789
69c305b834818ba84b14a1b7f9636a6f80a41588,0,Doug Cutting,2012-09-10 23:42:59+00:00,['911cc53aea0ed2f26fe772b7d4751f2691233a01'],0,2,2,524356,1,,,,1789
2ff7ecbc409b2e0f72a253a09091fcc0f34f0544,1,Thomas White,2012-09-11 11:31:57+00:00,['69c305b834818ba84b14a1b7f9636a6f80a41588'],1,36,37,524393,3,1,1,1,1789
6d91cdfad4aeb24a82579ffb1e136e7c565a47b7,1,Thomas White,2012-09-11 11:48:44+00:00,['2ff7ecbc409b2e0f72a253a09091fcc0f34f0544'],1,44,45,524438,3,0.272727273,1,0.727272727,1789
8775193276e3c5511b6a97a9546c8c9804706b28,1,Doug Cutting,2012-09-11 21:35:56+00:00,['6d91cdfad4aeb24a82579ffb1e136e7c565a47b7'],1,6160,6161,530599,65,0.562808349,0.708918406,0.833017078,1847
156280d809b673fc56d57b7d1a351458c5181061,0,Doug Cutting,2012-09-11 22:37:58+00:00,['8775193276e3c5511b6a97a9546c8c9804706b28'],0,37,37,530636,3,1,1,0.142857143,1847
bd0f7ef963c6a9537e23713129febe2d0f2a6fd9,0,Thomas White,2012-09-12 08:19:08+00:00,['156280d809b673fc56d57b7d1a351458c5181061'],2,3,5,530641,3,0,0,0,1847
a4994fdf861d381ea9c6496935a09646dfbf0116,0,Doug Cutting,2012-09-12 23:53:15+00:00,['bd0f7ef963c6a9537e23713129febe2d0f2a6fd9'],4,32,36,530677,3,1,1,1,1847
c0781539c1b155ed7b7a53303ec46f1200015e5c,0,Doug Cutting,2012-09-13 20:04:47+00:00,['a4994fdf861d381ea9c6496935a09646dfbf0116'],3,7,10,530687,3,,,,1847
92a56a456c65dc728773c6434f8877987cf7c07f,0,Doug Cutting,2012-09-13 20:21:31+00:00,['c0781539c1b155ed7b7a53303ec46f1200015e5c'],0,9,9,530696,1,,,,1848
6f5327bf7fc0a62f7e1d737571780e20fcbfe4a2,1,Doug Cutting,2012-09-13 20:34:48+00:00,['92a56a456c65dc728773c6434f8877987cf7c07f'],2,166,168,530864,3,0.120481928,0,0.939759036,1849
111b2f49cd1685217319ed90ec00ed547848cc41,0,Doug Cutting,2012-09-13 20:37:02+00:00,['6f5327bf7fc0a62f7e1d737571780e20fcbfe4a2'],1,1,2,530866,1,,,,1849
850ca3cff4da4fc5f05072c27257b830fec5004c,0,Douglas Adam Creager,2012-09-13 21:12:01+00:00,['111b2f49cd1685217319ed90ec00ed547848cc41'],4,21,25,530891,3,0.5,0.625,0,1849
9fff186165946961776cde4e47793395a4a65e78,0,Douglas Adam Creager,2012-09-13 21:14:47+00:00,['850ca3cff4da4fc5f05072c27257b830fec5004c'],2,8,10,530901,3,1,1,1,1849
b85435944b6845dded6e512db2b25457e21aa830,0,Douglas Adam Creager,2012-09-13 21:20:34+00:00,['9fff186165946961776cde4e47793395a4a65e78'],1,14,15,530916,3,0,0.142857143,0.142857143,1849
124ed638b1472e67fd0efc21a5b2b77bedb78d35,1,Douglas Adam Creager,2012-09-13 21:24:25+00:00,['b85435944b6845dded6e512db2b25457e21aa830'],0,10,10,530926,2,0,1,1,1849
13bb8b26f0d9b08baf3570ade1aa2a043b60d8b4,0,Douglas Adam Creager,2012-09-13 21:28:19+00:00,['124ed638b1472e67fd0efc21a5b2b77bedb78d35'],7,30,37,530963,2,0,0,1,1849
a6cc5ca284ab09563228129dd700fb33dcd12d51,0,Doug Cutting,2012-09-13 23:40:10+00:00,['13bb8b26f0d9b08baf3570ade1aa2a043b60d8b4'],2,59,61,531024,3,0,1,1,1849
7470a57f98d9d9d0ef083b998cbc63f1baf75eea,0,Doug Cutting,2012-09-14 21:06:16+00:00,['a6cc5ca284ab09563228129dd700fb33dcd12d51'],0,329,329,531353,2,,,,1850
c41fc158d0f29ceea675ce7c9f8f277ddc51d87e,0,Doug Cutting,2012-09-14 21:08:39+00:00,['7470a57f98d9d9d0ef083b998cbc63f1baf75eea'],1,4,5,531358,2,,,,1850
17fe15ec630c8c1512bdfc7f20fd81948c7a5897,0,Doug Cutting,2012-09-17 20:13:28+00:00,['c41fc158d0f29ceea675ce7c9f8f277ddc51d87e'],2,4,6,531364,1,,,,1850
d2d05c3e5952bf56741c2cb8434292867c4a1096,0,Doug Cutting,2012-09-17 20:16:22+00:00,['17fe15ec630c8c1512bdfc7f20fd81948c7a5897'],2,15,17,531381,3,1,1,1,1850
cc6dce5eac8cf960f68175ffc13c99ea8217e00a,0,Doug Cutting,2012-09-17 20:42:50+00:00,['d2d05c3e5952bf56741c2cb8434292867c4a1096'],95,87,182,531563,15,0,0,0,1850
5f19b060591af1de2b09487ff464bea8bf0b498e,0,Douglas Adam Creager,2012-09-17 23:13:15+00:00,['cc6dce5eac8cf960f68175ffc13c99ea8217e00a'],2,8,10,531573,2,0.5,0.5,1,1850
a2589652eea0a321df6a4b9d60c43dc7a828112c,0,Douglas Adam Creager,2012-09-17 23:18:34+00:00,['5f19b060591af1de2b09487ff464bea8bf0b498e'],0,90,90,531663,4,0.021276596,1,1,1851
828c61c5f40d39697cd4a72b5ce0ea279a65870f,0,Douglas Adam Creager,2012-09-17 23:25:12+00:00,['a2589652eea0a321df6a4b9d60c43dc7a828112c'],0,7,7,531670,5,0,0.2,1,1851
caad471d0ec01197074a68ae5f77e311281b877f,0,Doug Cutting,2012-09-18 00:00:40+00:00,['828c61c5f40d39697cd4a72b5ce0ea279a65870f'],22,23,45,531715,19,,,,1851
69aef1e46bb98eaab52b00a64b5380a16481c1b7,0,Doug Cutting,2012-09-18 00:21:17+00:00,['caad471d0ec01197074a68ae5f77e311281b877f'],5,5,10,531725,4,,,,1851
7b78665d822003b268e8f7d34ac3cb6e967309af,0,Doug Cutting,2012-09-18 00:32:33+00:00,['69aef1e46bb98eaab52b00a64b5380a16481c1b7'],4,4,8,531733,1,,,,1851
ba55d815ea63d923fea504d1da8baa1e5920701f,0,Doug Cutting,2012-09-24 21:05:11+00:00,['7b78665d822003b268e8f7d34ac3cb6e967309af'],18,26,44,531777,18,,,,1851
79323b0bd6a3e77469f9b4c23f33783460324e09,0,Doug Cutting,2012-09-24 21:12:40+00:00,['ba55d815ea63d923fea504d1da8baa1e5920701f'],4,7,11,531788,2,,,,1851
1b896e1a8456c2320f3dba8eef43beffd15d2d91,0,Doug Cutting,2012-09-24 21:22:59+00:00,['79323b0bd6a3e77469f9b4c23f33783460324e09'],5,5,10,531798,4,0,0,0,1851
c3577650285efd083a22a86670e33137d0fc6cdf,1,Thomas White,2012-09-27 13:25:47+00:00,['1b896e1a8456c2320f3dba8eef43beffd15d2d91'],130,135,265,532063,9,0,0,1,1851
f920d4e1067e5951b5ea7b38b6cb5d925d60b99b,0,Doug Cutting,2012-09-27 17:20:39+00:00,['c3577650285efd083a22a86670e33137d0fc6cdf'],1,1,2,532065,1,,,,1851
01f774f28153d220f59bff026ade4982d20ace2d,0,Miki Tebeka,2012-10-06 15:37:19+00:00,['f920d4e1067e5951b5ea7b38b6cb5d925d60b99b'],4,10,14,532079,2,,,,1851
1dbb07ac2f068dbc6b0bea963bf2abacab7cc434,1,Doug Cutting,2012-10-08 23:26:07+00:00,['01f774f28153d220f59bff026ade4982d20ace2d'],0,1127,1127,533206,9,0.477091633,0.814741036,0.917330677,1857
3c15fc6183d1df06abc2eb1904f9c4514ef4f665,0,Doug Cutting,2012-11-01 17:42:12+00:00,['1dbb07ac2f068dbc6b0bea963bf2abacab7cc434'],167,198,365,533571,9,1,1,0,1858
9b9068a00a3a1fac2525fe245365238b58370120,0,Doug Cutting,2012-11-05 18:22:05+00:00,['3c15fc6183d1df06abc2eb1904f9c4514ef4f665'],4,113,117,533688,10,1,1,1,1859
9e5e0462b1957c372bd7351b7f5e6c68d4a41b5d,0,Doug Cutting,2012-11-08 21:14:23+00:00,['9b9068a00a3a1fac2525fe245365238b58370120'],0,15,15,533703,2,,,,1859
f261733c575fbb57ced1f11e8af69ec88b573b8a,1,Thomas White,2012-11-09 10:46:21+00:00,['9e5e0462b1957c372bd7351b7f5e6c68d4a41b5d'],2,9,11,533714,3,0,1,0,1859
121b98ddc5a9db44040260bf5a6ec7bb106ad3de,1,Thomas White,2012-11-09 10:56:27+00:00,['f261733c575fbb57ced1f11e8af69ec88b573b8a'],1,178,179,533893,3,0.128440367,1,0.816513761,1859
b81a91a57a111650245aa803a3c2233995b3bf56,0,Thomas White,2012-11-09 11:25:30+00:00,['121b98ddc5a9db44040260bf5a6ec7bb106ad3de'],9,2,11,533904,3,1,0,1,1859
957ccf706a1d124c7fb74caf31862b9c03a99a1b,0,Thomas White,2012-11-13 09:55:28+00:00,['b81a91a57a111650245aa803a3c2233995b3bf56'],2,68,70,533974,3,0,0,0.515151515,1859
1638ebb5ea88f277fe065babd90551fbf74439df,0,Doug Cutting,2012-11-14 21:00:03+00:00,['957ccf706a1d124c7fb74caf31862b9c03a99a1b'],18,72,90,534064,3,1,1,1,1860
c8fe3e085e7afb5ee7de69561f0578a8ca2f046c,1,Doug Cutting,2012-11-14 23:21:29+00:00,['1638ebb5ea88f277fe065babd90551fbf74439df'],26,39,65,534129,9,0.833333333,1,1,1860
22d55ddf3e6ff8021da1743c8bb989111391b32a,1,Doug Cutting,2012-11-16 23:16:13+00:00,['c8fe3e085e7afb5ee7de69561f0578a8ca2f046c'],0,887,887,535016,9,0,1,1,1867
88736f8d389c17584508a105d608bca2b3281084,0,Doug Cutting,2012-11-19 20:57:09+00:00,['22d55ddf3e6ff8021da1743c8bb989111391b32a'],1,469,470,535486,15,0.895833333,0.375,0.895833333,1879
a2a7aeae62aa0eb9f3225ce0befde7a7bedfbad2,1,Doug Cutting,2012-11-21 22:29:42+00:00,['88736f8d389c17584508a105d608bca2b3281084'],36,190,226,535712,6,1,1,0.923076923,1880
a8a905895a6a8a71617158bf4059f15905b3dd71,0,Doug Cutting,2012-11-21 22:57:28+00:00,['a2a7aeae62aa0eb9f3225ce0befde7a7bedfbad2'],0,43,43,535755,8,,,,1881
fab6363adf4cf07db4004017c8e1dc5968850475,1,Doug Cutting,2012-11-28 22:33:57+00:00,['a8a905895a6a8a71617158bf4059f15905b3dd71'],2,19,21,535776,4,1,1,1,1881
0c5813b70f38952cbac69f5217bbf13e0e0b1a4c,0,Doug Cutting,2012-11-28 22:38:28+00:00,['fab6363adf4cf07db4004017c8e1dc5968850475'],4,7,11,535787,3,,,,1881
2efa6cee3abd81f2816cff9631606647ed5998fb,0,Doug Cutting,2012-11-28 22:42:34+00:00,['0c5813b70f38952cbac69f5217bbf13e0e0b1a4c'],30,33,63,535850,2,,,,1881
fb165e6ec812d4d03ea89de09ca1b758a7cdab6c,0,Doug Cutting,2012-11-28 22:47:05+00:00,['2efa6cee3abd81f2816cff9631606647ed5998fb'],3,20,23,535873,2,0.4,0.4,0,1881
23c2acf93231095ae5f7eb58c08748b62c83d9b5,0,Doug Cutting,2012-11-28 22:56:05+00:00,['fb165e6ec812d4d03ea89de09ca1b758a7cdab6c'],22,32,54,535927,3,1,1,0.222222222,1881
47308d10309622d3e04912485b1c951f67d4ca73,0,Doug Cutting,2012-11-29 22:07:56+00:00,['23c2acf93231095ae5f7eb58c08748b62c83d9b5'],11,227,238,536165,8,0.573770492,0.983606557,0.950819672,1881
2eb0672964db2f8a0b047c62f0f50a4c8222cdc5,0,Doug Cutting,2012-11-30 00:42:28+00:00,['47308d10309622d3e04912485b1c951f67d4ca73'],20,89,109,536274,23,,,,1881
8e33d6c26000e31ee22e1f32e73324582f669ebc,0,Bruce Mitchener Jr,2012-11-30 09:39:40+00:00,['2eb0672964db2f8a0b047c62f0f50a4c8222cdc5'],0,4,4,536278,2,0,1,0,1881
dc1eadb8806821000412fa77963e86a60f78267b,0,Bruce Mitchener Jr,2012-11-30 09:52:33+00:00,['8e33d6c26000e31ee22e1f32e73324582f669ebc'],2,6,8,536286,3,,,,1881
d160f17357c241a2c925a182e064f4068db22fe6,0,Doug Cutting,2012-11-30 18:12:24+00:00,['dc1eadb8806821000412fa77963e86a60f78267b'],1,1,2,536288,1,,,,1881
f0e4e90568d40992c78e0b2e5e2367d33b1d05e1,0,Douglas Adam Creager,2012-12-01 17:04:07+00:00,['d160f17357c241a2c925a182e064f4068db22fe6'],3,7,10,536298,3,1,1,1,1881
785523bf05b62b0681e5c81ed210843262b59546,0,Doug Cutting,2012-12-03 17:37:26+00:00,['f0e4e90568d40992c78e0b2e5e2367d33b1d05e1'],1,1,2,536300,1,,,,1881
bfc1bdc733da592fd665a56692a4f5c08e731f53,0,Doug Cutting,2012-12-07 21:49:12+00:00,['785523bf05b62b0681e5c81ed210843262b59546'],18,26,44,536344,18,,,,1881
a77d713671e7a53a3c7ebed1d3f5b843b224a6da,0,Miki Tebeka,2012-12-08 01:05:15+00:00,['bfc1bdc733da592fd665a56692a4f5c08e731f53'],16,35,51,536395,2,0.111111111,1,0.888888889,1881
111c5c91507b943acfdb1370dd9401de4a63b5a8,1,Thomas White,2012-12-19 18:32:12+00:00,['a77d713671e7a53a3c7ebed1d3f5b843b224a6da'],0,713,713,537108,8,0.46,1,0.62,1886
588288be89c3d8aeca79f6aa41d09f3efe5a0918,0,Doug Cutting,2012-12-19 23:38:07+00:00,['111c5c91507b943acfdb1370dd9401de4a63b5a8'],1,8,9,537117,2,1,1,1,1886
6774ee3b5f08666c6ba1e9ee6040283932d0f875,0,Doug Cutting,2012-12-20 20:52:49+00:00,['588288be89c3d8aeca79f6aa41d09f3efe5a0918'],3,12,15,537132,4,0,0,1,1886
a4769d950af7074c060d7f962fada88352620dbe,0,Doug Cutting,2013-01-14 20:29:19+00:00,['6774ee3b5f08666c6ba1e9ee6040283932d0f875'],0,17,17,537149,3,0.923076923,0.923076923,0.923076923,1886
53fa2dcc0773985912ce5ced3c1dea1e5b2d0a45,0,Thomas White,2013-01-16 16:09:03+00:00,['a4769d950af7074c060d7f962fada88352620dbe'],1,4,5,537154,2,,,,1886
77c48330740108e658cb3fcc94c4d8e04324e547,0,Doug Cutting,2013-01-17 21:11:45+00:00,['53fa2dcc0773985912ce5ced3c1dea1e5b2d0a45'],0,15,15,537169,3,1,1,1,1886
7e141b815cd05d75a210b00010a6cad8edbb84b7,0,Doug Cutting,2013-01-18 19:34:34+00:00,['77c48330740108e658cb3fcc94c4d8e04324e547'],5,80,85,537254,11,0.566666667,0.85,1,1886
350f09f3cefec53e20762e7862cb37f38c6251e6,0,Doug Cutting,2013-01-18 21:15:13+00:00,['7e141b815cd05d75a210b00010a6cad8edbb84b7'],15,167,182,537436,7,0.698412698,1,1,1888
30e1a5222aba7f80e9609b020816931e857d35ef,0,Doug Cutting,2013-01-18 21:22:04+00:00,['350f09f3cefec53e20762e7862cb37f38c6251e6'],1,15,16,537452,6,1,1,1,1888
fd4edf6088965a6edda1bfc17ce992b0e0e1c37c,0,Doug Cutting,2013-01-18 21:32:55+00:00,['30e1a5222aba7f80e9609b020816931e857d35ef'],0,103,103,537555,4,0.326530612,1,0.836734694,1889
7666029b4a61c67530f24ee3bc109a520c296f95,0,Doug Cutting,2013-01-18 21:39:06+00:00,['fd4edf6088965a6edda1bfc17ce992b0e0e1c37c'],0,2,2,537557,2,1,1,1,1889
dc0d13f9456637e26b4e977bc187453d584d87e8,0,Doug Cutting,2013-01-24 22:03:14+00:00,['7666029b4a61c67530f24ee3bc109a520c296f95'],1,4,5,537562,3,1,1,1,1889
acf33453c71da6b92f9feface1a9e7c8d36456a0,0,Doug Cutting,2013-02-04 21:58:45+00:00,['dc0d13f9456637e26b4e977bc187453d584d87e8'],4,7,11,537573,2,,,,1889
ed8c6144f8fd716203a933fab8b43a9cb79e71e2,0,Doug Cutting,2013-02-04 22:13:38+00:00,['acf33453c71da6b92f9feface1a9e7c8d36456a0'],67,279,346,537919,7,0.458715596,0.633027523,0.963302752,1890
d84d4df196746d00c85657672b64e20be3c0d2e8,0,Doug Cutting,2013-02-05 14:47:17+00:00,['ed8c6144f8fd716203a933fab8b43a9cb79e71e2'],2,23,25,537944,4,1,1,1,1890
e73d18ddd3554dcaf36063ce7bc26f418155cff2,0,Doug Cutting,2013-02-07 17:06:50+00:00,['d84d4df196746d00c85657672b64e20be3c0d2e8'],5,63,68,538012,3,0.380952381,1,1,1891
57c9811a1695761d3e0f224b7e89e8174d927e43,1,Doug Cutting,2013-02-09 00:22:05+00:00,['e73d18ddd3554dcaf36063ce7bc26f418155cff2'],19,59,78,538090,5,1,1,1,1891
448249366ff5ab9f5cfe4117b26ef0ab3bc7d047,0,Philip Zeyliger,2013-02-10 19:01:48+00:00,['57c9811a1695761d3e0f224b7e89e8174d927e43'],0,211,211,538301,4,0.541666667,1,0.555555556,1893
68bdc4317ef2c5e33ad23bbc78f0b0690350e459,1,Doug Cutting,2013-02-12 19:42:36+00:00,['448249366ff5ab9f5cfe4117b26ef0ab3bc7d047'],0,20,20,538321,3,0,1,0.785714286,1893
cf495ef5736b6fc960196dda969fb1072ead324e,0,Doug Cutting,2013-02-12 22:27:25+00:00,['68bdc4317ef2c5e33ad23bbc78f0b0690350e459'],0,381,381,538702,4,0.293103448,0.706896552,0.63362069,1895
4d8a4dd7a2582ad4fa59b8ed3e0db27b91559334,1,Doug Cutting,2013-02-12 23:22:54+00:00,['cf495ef5736b6fc960196dda969fb1072ead324e'],18,540,558,539260,13,0.658227848,0.983122363,1,1899
c6d00c7462eaef15703f1b4ac635ac278263a6fe,0,Doug Cutting,2013-02-12 23:28:10+00:00,['4d8a4dd7a2582ad4fa59b8ed3e0db27b91559334'],3,19,22,539282,3,0.222222222,0.222222222,1,1899
e044aadc7c2d7da7f5f50a651b219d3270494263,0,Doug Cutting,2013-02-14 20:47:49+00:00,['c6d00c7462eaef15703f1b4ac635ac278263a6fe'],0,155,155,539437,5,0.339285714,0.767857143,1,1901
e32e2198384ed0c887c8d96f30c791dc0cfd91dc,0,Doug Cutting,2013-02-14 21:29:25+00:00,['e044aadc7c2d7da7f5f50a651b219d3270494263'],44,144,188,539625,13,1,1,0.463768116,1901
21c239025f435bea117e11e61792b89d20a9110e,1,Doug Cutting,2013-02-14 21:43:05+00:00,['e32e2198384ed0c887c8d96f30c791dc0cfd91dc'],5,348,353,539978,5,0.806282723,0.701570681,0.87434555,1903
85b9c2c8c79c34b2ebbd6187da58f6b46652f440,1,Doug Cutting,2013-02-14 22:18:46+00:00,['21c239025f435bea117e11e61792b89d20a9110e'],13,36,49,540027,3,1,0.368421053,1,1903
267bda8996a1c8ae0d016b25486731ce122cf222,0,Doug Cutting,2013-02-14 22:26:18+00:00,['85b9c2c8c79c34b2ebbd6187da58f6b46652f440'],115,136,251,540278,4,0.904761905,0,0,1904
f5c61dab3264c77e5ec12d7b1ddb95bd2239b51f,0,Doug Cutting,2013-02-18 18:27:49+00:00,['267bda8996a1c8ae0d016b25486731ce122cf222'],37,109,146,540424,3,0.403508772,0.01754386,0.543859649,1904
9eae49165b55cc25f441b5d52eafe95367fe9441,0,Doug Cutting,2013-02-19 17:15:22+00:00,['f5c61dab3264c77e5ec12d7b1ddb95bd2239b51f'],19,1156,1175,541599,15,0.761589404,1,0.834437086,1916
a78127b2356b9f6c2efab7e36cee442be5be90f4,0,Doug Cutting,2013-02-19 23:11:12+00:00,['9eae49165b55cc25f441b5d52eafe95367fe9441'],2,6,8,541607,2,1,1,1,1916
8e8de3360c93cca2b6e2877f96423cdf0b48e747,0,Doug Cutting,2013-02-19 23:14:49+00:00,['a78127b2356b9f6c2efab7e36cee442be5be90f4'],6,18,24,541631,4,1,1,1,1916
1dc08581ba6ad5c17d20555818faef9da300478c,0,Doug Cutting,2013-02-19 23:28:10+00:00,['8e8de3360c93cca2b6e2877f96423cdf0b48e747'],1,1,2,541633,1,,,,1916
b99318cc3b18e60a051cb03699e592611a50919e,0,Doug Cutting,2013-02-19 23:49:21+00:00,['1dc08581ba6ad5c17d20555818faef9da300478c'],19,19,38,541671,18,,,,1916
f7ce4ab5922dfe16c2b35bd21815c3180d7643ca,0,Doug Cutting,2013-02-21 21:08:30+00:00,['b99318cc3b18e60a051cb03699e592611a50919e'],8,14,22,541693,2,1,1,1,1916
882b0b32e1b0e01aee5d5ed6aeff8207f43919ed,0,Doug Cutting,2013-02-27 00:57:36+00:00,['f7ce4ab5922dfe16c2b35bd21815c3180d7643ca'],18,26,44,541737,18,,,,1916
84ad7a72bbf42ae7f1e22fceddc9edf48b81655d,1,Doug Cutting,2013-03-01 19:02:18+00:00,['882b0b32e1b0e01aee5d5ed6aeff8207f43919ed'],158,172,330,542067,5,0.333333333,0.333333333,1,1916
1788948bc9b1bbc36449e5039c8a5b8bf4626963,1,Doug Cutting,2013-03-04 21:08:59+00:00,['84ad7a72bbf42ae7f1e22fceddc9edf48b81655d'],4,20,24,542091,5,,,,1916
48c7b54ccf006935df64853f5c6443b8430b3c75,1,Doug Cutting,2013-03-19 15:44:37+00:00,['1788948bc9b1bbc36449e5039c8a5b8bf4626963'],124,225,349,542440,5,0,1,0,1917
a3b38ebfdaf93eb77860fe80540bbc788e9589df,1,Doug Cutting,2013-03-27 21:33:18+00:00,['48c7b54ccf006935df64853f5c6443b8430b3c75'],128,406,534,542974,19,0.7,0.964285714,1,1918
253e96e9d84da192c9095210529a84def74f6ec6,0,Doug Cutting,2013-03-27 23:42:30+00:00,['a3b38ebfdaf93eb77860fe80540bbc788e9589df'],9,67,76,543050,7,0.58974359,1,1,1918
0820a9e0e2442730395da77ece1c6a550a86383d,0,Martin Kleppmann,2013-04-13 04:30:13+00:00,['253e96e9d84da192c9095210529a84def74f6ec6'],15,182,197,543247,3,0.295454545,0.977272727,0.670454545,1918
3726dc2888b2b7d1c5e93f257563043fa9305b89,0,Martin Kleppmann,2013-04-13 04:43:26+00:00,['0820a9e0e2442730395da77ece1c6a550a86383d'],25,62,87,543334,6,0,1,1,1918
1e7a16eb1d624fd10b5b7676ade9a37b77234bb5,0,Martin Kleppmann,2013-04-13 04:50:28+00:00,['3726dc2888b2b7d1c5e93f257563043fa9305b89'],29,130,159,543493,6,0.984375,0.8125,0.90625,1918
0d22770de46e3aad404dff8901264067cdfdc714,0,Doug Cutting,2013-04-16 23:25:56+00:00,['1e7a16eb1d624fd10b5b7676ade9a37b77234bb5'],0,16,16,543509,3,0,0.153846154,1,1918
c56c4366f80f95a095090e30c511ed0ad4acf2a5,1,Philip Zeyliger,2013-04-22 17:50:57+00:00,['0d22770de46e3aad404dff8901264067cdfdc714'],10,47,57,543566,4,1,1,1,1918
ebe57473f9a64f540cd4f0dd977313f21de42f6f,1,Doug Cutting,2013-04-22 19:50:19+00:00,['c56c4366f80f95a095090e30c511ed0ad4acf2a5'],0,41,41,543607,4,0,1,1,1918
2985e27b367370c8c7176f52a26077044b0e77a1,1,Doug Cutting,2013-04-22 19:59:42+00:00,['ebe57473f9a64f540cd4f0dd977313f21de42f6f'],105,106,211,543818,10,1,0.107142857,0.785714286,1918
eb7a72136b48a827aae62296b1ba65d63ad0ead5,0,Philip Zeyliger,2013-04-22 21:02:59+00:00,['2985e27b367370c8c7176f52a26077044b0e77a1'],1,1,2,543820,1,,,,1918
3eb36b556128ddcc237489366996b8c237ecdcb8,1,Doug Cutting,2013-04-23 17:07:48+00:00,['eb7a72136b48a827aae62296b1ba65d63ad0ead5'],31,417,448,544268,5,0.703296703,1,1,1918
9a501d91b962ade5554e8ddeb8bbacde544fb9b8,0,Doug Cutting,2013-04-23 17:11:23+00:00,['3eb36b556128ddcc237489366996b8c237ecdcb8'],1,63,64,544332,3,1,1,1,1918
c880210c65d0289d96ca6472ad333fc8068f4e03,1,Doug Cutting,2013-04-23 20:15:55+00:00,['9a501d91b962ade5554e8ddeb8bbacde544fb9b8'],39,452,491,544823,7,0.73553719,0.619834711,1,1918
6983e7cf8fc86ae26d192cbeca779a57b3d75df5,0,Martin Kleppmann,2013-04-25 13:51:01+00:00,['c880210c65d0289d96ca6472ad333fc8068f4e03'],3,11,14,544837,2,,,,1918
3e35fd44125397c1a9d2313220e225c1059b04e0,1,Doug Cutting,2013-04-26 22:12:16+00:00,['6983e7cf8fc86ae26d192cbeca779a57b3d75df5'],0,631,631,545468,5,0.267002519,0.758186398,0.74559194,1920
866a68df261cc259074d864a2e584b077fa6b2bb,0,Thomas White,2013-04-29 11:37:57+00:00,['3e35fd44125397c1a9d2313220e225c1059b04e0'],4,1780,1784,547252,8,0.639204545,1,0.833806818,1924
2d90087552098f008bc8d4b6d9ae60f84b345b90,0,Scott Carey,2013-04-29 19:47:32+00:00,['866a68df261cc259074d864a2e584b077fa6b2bb'],0,0,0,547252,0,,,,1924
40650540dcb8ca8a6b6235de5cdd36c0f6e2eb31,1,Scott Carey,2013-04-30 16:18:26+00:00,['2d90087552098f008bc8d4b6d9ae60f84b345b90'],177,1727,1904,549156,16,0.771177118,0.848184818,0.661166117,1931
2e102f67b8ac4a29afba03b121b4f928ee27f09b,0,Scott Carey,2013-05-02 01:01:47+00:00,['40650540dcb8ca8a6b6235de5cdd36c0f6e2eb31'],7,13,20,549176,3,1,1,1,1931
258f800dce8433d0de3ced0916167df0446e9390,0,Doug Cutting,2013-05-08 17:35:51+00:00,['2e102f67b8ac4a29afba03b121b4f928ee27f09b'],12,41,53,549229,8,1,1,1,1933
52fe3505338ceb51a2299d1303d0f0c7c8afac2d,1,Doug Cutting,2013-05-09 20:55:06+00:00,['258f800dce8433d0de3ced0916167df0446e9390'],0,346,346,549575,6,0.212765957,0.673758865,0.460992908,1937
23201deb6d468b4cd8be4db7f812f37285358f5b,1,Doug Cutting,2013-05-09 21:00:45+00:00,['52fe3505338ceb51a2299d1303d0f0c7c8afac2d'],2,21,23,549598,4,1,1,1,1937
82441729dd69fc5d431cabc8b1ffa25e924b8bbe,0,Doug Cutting,2013-05-09 21:04:47+00:00,['23201deb6d468b4cd8be4db7f812f37285358f5b'],2,7,9,549607,3,0.666666667,1,1,1937
e10bd69255549a854d1ef178ab9df4dbd99dd2ac,0,Doug Cutting,2013-05-09 21:13:58+00:00,['82441729dd69fc5d431cabc8b1ffa25e924b8bbe'],12,97,109,549716,2,,,,1937
711a4ed4230c0ba1627670e7b89db88472575e1f,0,Doug Cutting,2013-05-09 22:15:16+00:00,['e10bd69255549a854d1ef178ab9df4dbd99dd2ac'],12,154,166,549882,10,0.656716418,1,1,1938
d32617f83f4b4b78c1a852127595e02d2ffb77f2,0,Scott Carey,2013-05-15 21:00:11+00:00,['711a4ed4230c0ba1627670e7b89db88472575e1f'],0,6,6,549888,4,,,,1938
9199bac9f99f1d5ec8d8f4c396b030c2ae08cd79,0,Doug Cutting,2013-05-16 17:33:53+00:00,['d32617f83f4b4b78c1a852127595e02d2ffb77f2'],4,5,9,549897,2,1,1,0,1938
16c626006f3d29f65f4fb1b648e09531106405f5,1,Scott Carey,2013-05-21 04:06:47+00:00,['9199bac9f99f1d5ec8d8f4c396b030c2ae08cd79'],1,4,5,549902,2,,,,1938
2fd8d25b142048ed159731b7e110aa9c3edba843,1,Douglas Adam Creager,2013-05-24 13:37:36+00:00,['16c626006f3d29f65f4fb1b648e09531106405f5'],15,173,188,550090,11,0.116666667,0.266666667,1,1941
0b9ac6561d279342f2eaf85985e2ebf5675691c5,1,Douglas Adam Creager,2013-05-24 13:49:20+00:00,['2fd8d25b142048ed159731b7e110aa9c3edba843'],48,175,223,550313,9,0.710526316,0.723684211,0,1943
b790897340eefc626c107c1578f26ee49a3de412,1,Thiruvalluvan M. G,2013-06-13 18:48:49+00:00,['0b9ac6561d279342f2eaf85985e2ebf5675691c5'],0,15,15,550328,3,1,1,1,1943
923b619a011733c9f0669556ab96322335568951,1,Thiruvalluvan M. G,2013-06-13 19:02:46+00:00,['b790897340eefc626c107c1578f26ee49a3de412'],25,116,141,550469,5,0.386666667,0.76,1,1943
710684f733c19928f4e5132b25f0c858ea9dfa3f,0,Thiruvalluvan M. G,2013-06-20 17:17:23+00:00,['923b619a011733c9f0669556ab96322335568951'],7,14,21,550490,3,1,1,1,1943
d2a8de16fcafeb94b381c38dbe4110b83a16872f,0,Thiruvalluvan M. G,2013-06-24 08:37:43+00:00,['710684f733c19928f4e5132b25f0c858ea9dfa3f'],7,62,69,550559,4,0.233333333,0.766666667,1,1943
a1796711e1470ba794f37ae74eb9a34101ff7daa,1,Doug Cutting,2013-07-01 18:04:37+00:00,['d2a8de16fcafeb94b381c38dbe4110b83a16872f'],16,2089,2105,552664,19,0.543933054,0.924686192,0.776150628,1954
1074bbd253c7275648ff8845c54e8f15e70e5428,0,Doug Cutting,2013-07-02 17:35:22+00:00,['a1796711e1470ba794f37ae74eb9a34101ff7daa'],4,8,12,552676,1,,,,1954
ecee999e3be6ea7ffec8f3c7bce267efe9395d4d,0,Doug Cutting,2013-07-02 17:45:37+00:00,['1074bbd253c7275648ff8845c54e8f15e70e5428'],1,10,11,552687,2,0,0,0,1954
c979ba8577fa3d29bd7ebbcf5d8f083c4033f4e2,0,Doug Cutting,2013-07-02 18:00:11+00:00,['ecee999e3be6ea7ffec8f3c7bce267efe9395d4d'],10,76,86,552773,2,0.111111111,0.694444444,0.861111111,1954
ae6eede41c9fca1bc235f65fece131816bda3d9d,1,Doug Cutting,2013-07-09 21:57:43+00:00,['c979ba8577fa3d29bd7ebbcf5d8f083c4033f4e2'],18,162,180,552953,8,0.465909091,0.954545455,1,1954
9d9ab81eead6ad75ef182de58f0c0c421fc52237,0,Doug Cutting,2013-07-09 22:00:09+00:00,['ae6eede41c9fca1bc235f65fece131816bda3d9d'],1,6,7,552960,2,,,,1954
b6c2905a5e28233f824147242e40a3c7df52f7da,0,Doug Cutting,2013-07-10 16:14:11+00:00,['9d9ab81eead6ad75ef182de58f0c0c421fc52237'],1,1,2,552962,1,,,,1954
6e79ea1e08f7ba0414934c7c65a3dad381a20562,0,Doug Cutting,2013-07-10 16:40:06+00:00,['b6c2905a5e28233f824147242e40a3c7df52f7da'],2,6,8,552970,2,,,,1954
1579ab1ac95731630af58fc303a07c9bf28541d6,1,James Baldassari,2013-07-15 00:53:28+00:00,['6e79ea1e08f7ba0414934c7c65a3dad381a20562'],1,19,20,552990,2,1,1,1,1954
4cd58297e1c30930d4cca53c10ff3cd99a33269c,0,Douglas Adam Creager,2013-07-26 13:40:47+00:00,['1579ab1ac95731630af58fc303a07c9bf28541d6'],3,183,186,553176,5,0,0.516853933,0.292134831,1955
9b0a633bca2f657e250ddd602468d1fccdc5c027,0,Douglas Adam Creager,2013-07-26 13:55:39+00:00,['4cd58297e1c30930d4cca53c10ff3cd99a33269c'],4,61,65,553241,7,0.866666667,0.866666667,0.6,1958
05e9ff1711b968388c7cb54e5488e91c8be630af,0,Douglas Adam Creager,2013-07-26 14:03:06+00:00,['9b0a633bca2f657e250ddd602468d1fccdc5c027'],6,8,14,553255,1,,,,1958
e6549b48822e7491406344397c5fce8b1e1f091e,1,Scott Carey,2013-07-28 22:10:12+00:00,['05e9ff1711b968388c7cb54e5488e91c8be630af'],967,2866,3833,557088,6,0.833729216,0.982185273,1,1958
b7897db6425377d3f0a6e6a9df169f65737b580b,0,Scott Carey,2013-07-31 02:30:50+00:00,['e6549b48822e7491406344397c5fce8b1e1f091e'],1,4,5,557093,2,,,,1958
00f36ae402b34d5b47ca5a6349ad5488e2ec5bcd,1,Doug Cutting,2013-08-07 19:22:57+00:00,['b7897db6425377d3f0a6e6a9df169f65737b580b'],0,175,175,557268,5,0.634615385,1,0.480769231,1961
fe114b90dff01f10d91055577e58c4325dd45a6e,1,Doug Cutting,2013-08-07 19:47:42+00:00,['00f36ae402b34d5b47ca5a6349ad5488e2ec5bcd'],3,38,41,557309,4,0,0.366666667,1,1961
d6b1d2cd0d1bb625f5fb73ef3931a63bbb622953,0,Doug Cutting,2013-08-07 22:25:06+00:00,['fe114b90dff01f10d91055577e58c4325dd45a6e'],1,37,38,557347,2,,,,1961
8af840b2cd1ad273e6417f58d359e9b113a1c927,1,Doug Cutting,2013-08-07 23:16:58+00:00,['d6b1d2cd0d1bb625f5fb73ef3931a63bbb622953'],27,673,700,558047,19,0.455696203,0.670886076,0.877637131,1968
854daafa0d91b3e0da986841ba6ad023eddddeca,1,Doug Cutting,2013-08-07 23:27:06+00:00,['8af840b2cd1ad273e6417f58d359e9b113a1c927'],80,355,435,558482,24,0.59602649,1,0.768211921,1968
74811387064c8668aaf6c538a54284d394bb1d09,0,Doug Cutting,2013-08-07 23:32:39+00:00,['854daafa0d91b3e0da986841ba6ad023eddddeca'],20,20,40,558522,18,,,,1968
7523d4c863886a1c60bfc89950836fe4c1f69ebf,0,Doug Cutting,2013-08-20 17:53:39+00:00,['74811387064c8668aaf6c538a54284d394bb1d09'],18,26,44,558566,18,,,,1968
d1a22055fa9bc51d44816b342a1035a6d91191d3,1,Doug Cutting,2013-08-20 19:13:39+00:00,['7523d4c863886a1c60bfc89950836fe4c1f69ebf'],160,6310,6470,565036,80,0.474354311,0.735540196,0.885049109,2024
79d6b2b0ff5777faef685639ef2ef9f1fc83f532,0,Doug Cutting,2013-08-20 20:26:13+00:00,['d1a22055fa9bc51d44816b342a1035a6d91191d3'],1,30,31,565067,3,0.705882353,1,1,2024
2b6eafc504cfb04732ba9b4523778fbd2a6f6908,0,Doug Cutting,2013-08-27 16:17:30+00:00,['79d6b2b0ff5777faef685639ef2ef9f1fc83f532'],2,2,4,565071,1,,,,2024
50baf4cfb47fbdd29c311de756bbc503f0508dd5,0,Doug Cutting,2013-09-04 20:59:57+00:00,['2b6eafc504cfb04732ba9b4523778fbd2a6f6908'],2,33,35,565106,3,1,1,0.875,2024
4128159f67cdfe1e28fa375f36e120243aeb3919,0,Doug Cutting,2013-09-11 20:26:37+00:00,['50baf4cfb47fbdd29c311de756bbc503f0508dd5'],1,4,5,565111,2,,,,2024
2c336d872d9fa863840ea753cfb92a978d6339e2,0,Doug Cutting,2013-09-12 22:00:16+00:00,['4128159f67cdfe1e28fa375f36e120243aeb3919'],11,12,23,565134,2,,,,2024
9e3de75e27aef8feab9abcda090f27a36e2add55,0,Doug Cutting,2013-09-27 20:12:55+00:00,['2c336d872d9fa863840ea753cfb92a978d6339e2'],2,26,28,565162,3,0.8,1,1,2024
a56e7f13c4fa976b7926649b058665f42850a349,1,Doug Cutting,2013-09-27 20:27:15+00:00,['9e3de75e27aef8feab9abcda090f27a36e2add55'],390,341,731,565893,10,0.392405063,0.53164557,0.556962025,2024
35750393891c40f0ceb925a852162ec764bcae6c,0,Doug Cutting,2013-10-25 22:13:43+00:00,['a56e7f13c4fa976b7926649b058665f42850a349'],5,103,108,566001,4,0.431818182,1,1,2024
0520c1cec0fcaf23104eaf40724485da1c67088e,0,Doug Cutting,2013-11-05 23:14:36+00:00,['35750393891c40f0ceb925a852162ec764bcae6c'],11,50,61,566062,6,1,1,1,2025
15d5cdc81c23c4d47099b510e4efa50fd18ac9bf,0,Doug Cutting,2013-11-06 23:47:22+00:00,['0520c1cec0fcaf23104eaf40724485da1c67088e'],1,62,63,566125,3,0.488888889,0.977777778,0.977777778,2025
62557712722e94614140ed945a2e1c276f604ba8,1,Doug Cutting,2013-11-07 19:09:09+00:00,['15d5cdc81c23c4d47099b510e4efa50fd18ac9bf'],4,207,211,566336,5,0.532258065,1,1,2027
217a633a4ddcceb6b3e30a4f2ee1fd98130d96ac,0,Doug Cutting,2013-11-08 22:15:02+00:00,['62557712722e94614140ed945a2e1c276f604ba8'],8,3589,3597,569933,18,0.48102981,0.620596206,0.823848238,2044
2e8db1e2c3e914d1938096f98c1d0f71e6af0a99,1,Doug Cutting,2013-11-11 06:54:42+00:00,['217a633a4ddcceb6b3e30a4f2ee1fd98130d96ac'],61,230,291,570224,14,0.965517241,0.942528736,1,2045
7d8746bdfdf86f2816d8b37a2192f06931d3c377,0,Doug Cutting,2013-11-21 20:09:12+00:00,['2e8db1e2c3e914d1938096f98c1d0f71e6af0a99'],0,4,4,570228,2,1,1,1,2045
335fb784a38d69700fbe4beeca4b2a08121e61db,0,Doug Cutting,2013-12-11 21:16:39+00:00,['7d8746bdfdf86f2816d8b37a2192f06931d3c377'],3,59,62,570290,5,0.545454545,0.545454545,1,2046
3289a4dec81912dada7bf38275ea47f4ae9b437f,0,Doug Cutting,2013-12-12 23:06:40+00:00,['335fb784a38d69700fbe4beeca4b2a08121e61db'],8,11,19,570309,8,,,,2046
fe0c6c82566cdade205b62b0c223886bf799f716,0,Doug Cutting,2013-12-13 00:58:52+00:00,['3289a4dec81912dada7bf38275ea47f4ae9b437f'],17,143,160,570469,5,0.534883721,1,1,2047
deb4354cc35e824951f7f5e2084693b59f67c9a1,0,Doug Cutting,2013-12-13 23:32:56+00:00,['fe0c6c82566cdade205b62b0c223886bf799f716'],22,54,76,570545,4,0.6,1,0.6,2047
692f2b7c529d6203916e17e45f5491062fad48b3,1,Doug Cutting,2013-12-13 23:50:22+00:00,['deb4354cc35e824951f7f5e2084693b59f67c9a1'],17,87,104,570649,7,0.958333333,1,0,2047
ffaf716f2d4c65d90c5a6e7def47751a263b28d9,1,Thiruvalluvan M. G,2013-12-15 16:50:00+00:00,['692f2b7c529d6203916e17e45f5491062fad48b3'],8,104,112,570761,5,0.372093023,1,1,2047
08c097bec5a8e078afa47810edbe0dccd9de8479,0,Thomas White,2013-12-16 16:32:22+00:00,['ffaf716f2d4c65d90c5a6e7def47751a263b28d9'],9,27,36,570797,2,,,,2047
be7fc3504828c42d534c1522d3f050fd52d66b2d,0,Thomas White,2013-12-16 16:34:37+00:00,['08c097bec5a8e078afa47810edbe0dccd9de8479'],0,3,3,570800,1,,,,2047
e2905e6225ef6b5ad1b177264d3d25bbebb50736,1,Doug Cutting,2013-12-16 20:30:38+00:00,['be7fc3504828c42d534c1522d3f050fd52d66b2d'],43,204,247,571047,8,0.268041237,0.484536082,0.144329897,2047
b69af81348c6ff15e5be9f1ac8f884b3680bdb74,1,Doug Cutting,2013-12-16 20:42:19+00:00,['e2905e6225ef6b5ad1b177264d3d25bbebb50736'],0,1138,1138,572185,3,0.407331976,0.682281059,0.959266802,2049
aab73f1762db333005ce15fc3f76a21fc754625a,0,Douglas Adam Creager,2013-12-18 12:50:06+00:00,['b69af81348c6ff15e5be9f1ac8f884b3680bdb74'],0,154,154,572339,5,0,1,0.766233766,2050
b0e6e0593931035b86e07bb4d88ce967cd18937e,0,Douglas Adam Creager,2013-12-18 13:25:34+00:00,['aab73f1762db333005ce15fc3f76a21fc754625a'],0,28,28,572367,8,,,,2050
4498b9928857ac010b77274da8d060b54f95d912,0,Douglas Adam Creager,2013-12-18 13:31:53+00:00,['b0e6e0593931035b86e07bb4d88ce967cd18937e'],1,122,123,572490,6,0,1,1,2053
f91e32bb70d22f1a344b769403e5148d795d0205,0,Douglas Adam Creager,2013-12-18 13:46:15+00:00,['4498b9928857ac010b77274da8d060b54f95d912'],1,9,10,572500,2,,,,2053
f36368729fa537559ef13060c304d14aa87f7671,0,Doug Cutting,2013-12-19 20:24:11+00:00,['f91e32bb70d22f1a344b769403e5148d795d0205'],1,3,4,572504,1,,,,2053
f5ebcf11bd09946ea0f717d0f236f19a0f9ab8e8,1,Doug Cutting,2013-12-19 20:26:37+00:00,['f36368729fa537559ef13060c304d14aa87f7671'],16,19,35,572539,7,,,,2053
7699e3d28d1596f29bb00483451cab3e392e992b,0,Doug Cutting,2013-12-19 20:33:05+00:00,['f5ebcf11bd09946ea0f717d0f236f19a0f9ab8e8'],2,40,42,572581,2,0.333333333,1,1,2053
a2fe7c3ff68f4cec606c644555172a40ba1e9cda,0,Doug Cutting,2013-12-19 20:58:46+00:00,['7699e3d28d1596f29bb00483451cab3e392e992b'],33,297,330,572911,6,0.487804878,1,0.609756098,2054
f03f61883f32e110818e6592b345329fd90a9426,0,Douglas Adam Creager,2013-12-19 22:23:30+00:00,['a2fe7c3ff68f4cec606c644555172a40ba1e9cda'],1,168,169,573080,4,0.212765957,1,1,2055
7c3ac7dd5688fc7d85721b8bef2f3bf84a7d0eec,1,Doug Cutting,2013-12-20 19:46:13+00:00,['f03f61883f32e110818e6592b345329fd90a9426'],3,57,60,573140,3,,,,2057
1547d4980cab06feeb09bc5b81ed4da03483de02,0,Doug Cutting,2013-12-20 20:55:28+00:00,['7c3ac7dd5688fc7d85721b8bef2f3bf84a7d0eec'],1,1,2,573142,1,,,,2057
f80baa2fe481adaee91569631e7dfb09e10e238a,0,Doug Cutting,2013-12-20 21:21:34+00:00,['1547d4980cab06feeb09bc5b81ed4da03483de02'],1,1,2,573144,1,,,,2057
6fd5335dbc3ad9cf38b3a582f204aeb495c28322,0,Doug Cutting,2013-12-20 21:27:53+00:00,['f80baa2fe481adaee91569631e7dfb09e10e238a'],1,1,2,573146,1,,,,2057
9414a3262ec98f4c8c4c8200ede87f918e785e90,0,Doug Cutting,2013-12-20 22:29:52+00:00,['6fd5335dbc3ad9cf38b3a582f204aeb495c28322'],1,1,2,573148,1,,,,2057
020089aaa9fcc670b391074408e8d605a2b86794,0,Doug Cutting,2013-12-20 22:59:18+00:00,['9414a3262ec98f4c8c4c8200ede87f918e785e90'],1,1,2,573150,1,,,,2057
da51810a0e603212742e30d7b13242a16a1b0a92,0,Doug Cutting,2013-12-20 23:13:37+00:00,['020089aaa9fcc670b391074408e8d605a2b86794'],1,1,2,573152,1,,,,2057
25c06cf3edb56fee923796d24c28c7af529c1b72,0,Doug Cutting,2013-12-20 23:38:22+00:00,['da51810a0e603212742e30d7b13242a16a1b0a92'],1,1,2,573154,1,,,,2057
cca7abe6e1308fa4565a78f80f5a974564e9b5c4,0,Doug Cutting,2013-12-21 00:38:02+00:00,['25c06cf3edb56fee923796d24c28c7af529c1b72'],0,0,0,573154,0,,,,2057
30f8e22712801890af94f19adfb1dc6b1fb602d0,0,Doug Cutting,2014-01-06 23:33:37+00:00,['cca7abe6e1308fa4565a78f80f5a974564e9b5c4'],4,139,143,573297,3,0.520833333,1,0.583333333,2058
5b2098924b36e784bfb6a6efd798efc225030458,1,Thiruvalluvan M. G,2014-01-07 17:30:38+00:00,['30f8e22712801890af94f19adfb1dc6b1fb602d0'],346,488,834,574131,14,1,1,0.974358974,2060
48dedd57aac54e35a4c54cf7a840bb55a1f53e76,0,Doug Cutting,2014-01-07 21:53:54+00:00,['5b2098924b36e784bfb6a6efd798efc225030458'],21,143,164,574295,5,0.066666667,0.944444444,0.911111111,2060
d70a506f2d6432d12975979f19a9e39e2e36b348,0,Doug Cutting,2014-01-07 22:10:34+00:00,['48dedd57aac54e35a4c54cf7a840bb55a1f53e76'],21,638,659,574954,8,0.211267606,0.757746479,0.847887324,2062
ed15da83f6981160078a5c6e30ff785cd3cc8ca0,0,Doug Cutting,2014-01-08 18:04:18+00:00,['d70a506f2d6432d12975979f19a9e39e2e36b348'],4,105,109,575063,4,0.580645161,0.064516129,0.774193548,2063
62d19fe37f1649c4fcef5d226ee11e2fdfd11f2a,0,Doug Cutting,2014-01-09 17:10:12+00:00,['ed15da83f6981160078a5c6e30ff785cd3cc8ca0'],0,15,15,575078,1,,,,2063
e4124c17adeb58f84b35d09cf3c865262006a629,0,Doug Cutting,2014-01-09 17:12:30+00:00,['62d19fe37f1649c4fcef5d226ee11e2fdfd11f2a'],6,77,83,575161,5,,,,2063
05354bf64a32425533b73bf5310a12586f284e9b,1,Doug Cutting,2014-01-09 17:24:50+00:00,['e4124c17adeb58f84b35d09cf3c865262006a629'],7,240,247,575408,17,1,1,1,2064
0855eb7eb478632ad8f1192f64e81ded7694a343,0,Doug Cutting,2014-01-09 19:51:50+00:00,['05354bf64a32425533b73bf5310a12586f284e9b'],47,53,100,575508,4,0,1,0,2064
4c51fe33c252ff7a5ab726539bddd3b2d313bee3,1,Doug Cutting,2014-01-09 23:13:32+00:00,['0855eb7eb478632ad8f1192f64e81ded7694a343'],53,60,113,575621,26,,,,2064
07b6a7cd3b6bef66d4fdff2b0199b823324db59a,0,Doug Cutting,2014-01-09 23:34:08+00:00,['4c51fe33c252ff7a5ab726539bddd3b2d313bee3'],0,23,23,575644,3,0.764705882,0.764705882,1,2064
0a576b82eb1fb2649e3c57e461a052131ad57d97,1,Thiruvalluvan M. G,2014-01-10 07:10:58+00:00,['07b6a7cd3b6bef66d4fdff2b0199b823324db59a'],12,73,85,575729,5,0,0.58,1,2065
6bb32463a05dac03e3bb4d15018e6bd55554edc5,1,Doug Cutting,2014-01-10 19:11:42+00:00,['0a576b82eb1fb2649e3c57e461a052131ad57d97'],0,7656,7656,583385,27,0.583219645,0.773533424,0.706684857,2090
ffe0bd8a8e6683e9129f7b9e1707bf0a3b869888,0,Doug Cutting,2014-01-10 19:16:43+00:00,['6bb32463a05dac03e3bb4d15018e6bd55554edc5'],0,0,0,583385,0,,,,2090
e4b9acafd627dc6771e4a49b028cef68b6ff2ab1,0,Doug Cutting,2014-01-10 19:20:58+00:00,['ffe0bd8a8e6683e9129f7b9e1707bf0a3b869888'],1,19,20,583405,1,,,,2090
2bd29335725d96280b5269064af6cbcc3586d2b1,0,Doug Cutting,2014-01-10 19:27:39+00:00,['e4b9acafd627dc6771e4a49b028cef68b6ff2ab1'],10,0,10,583415,1,,,,2090
c069e284fa1afb7620b8a4b0d35503624c659432,1,Doug Cutting,2014-01-10 20:52:02+00:00,['2bd29335725d96280b5269064af6cbcc3586d2b1'],15,10,25,583440,2,0.428571429,0.428571429,0,2090
bd263c4141780f56d0494fd58071a9c64d85a0a1,0,Doug Cutting,2014-01-10 20:54:12+00:00,['c069e284fa1afb7620b8a4b0d35503624c659432'],0,0,0,583440,0,,,,2090
ac7c3a784d7344eb9fd59488da94259ab5507bd6,0,Doug Cutting,2014-01-10 20:57:53+00:00,['bd263c4141780f56d0494fd58071a9c64d85a0a1'],19,19,38,583478,18,,,,2090
9ef7389146407441220a6d79af05ee754fcf73df,0,Doug Cutting,2014-01-23 21:50:29+00:00,['ac7c3a784d7344eb9fd59488da94259ab5507bd6'],18,28,46,583524,18,,,,2090
b19df789480e063ee36eb5f2b1fef47f9c2e90c4,1,Doug Cutting,2014-01-27 19:25:28+00:00,['9ef7389146407441220a6d79af05ee754fcf73df'],2,2,4,583528,2,,,,2090
86a642787c9bac4d608d053b9c7b3be1128368d9,0,Doug Cutting,2014-01-27 22:05:53+00:00,['b19df789480e063ee36eb5f2b1fef47f9c2e90c4'],39,57,96,583624,5,0.157894737,0.631578947,0.842105263,2090
9bae616d4f9948c6bb2c8d7b75a2c53d456a1646,0,Doug Cutting,2014-01-27 22:09:27+00:00,['86a642787c9bac4d608d053b9c7b3be1128368d9'],17,26,43,583667,4,0,0,1,2090
1c43a60e65da433cf1d0f2e5088ed30f9f8d8bca,0,Doug Cutting,2014-01-28 19:17:10+00:00,['9bae616d4f9948c6bb2c8d7b75a2c53d456a1646'],5,17,22,583689,2,0,1,1,2090
7be037b56f722005ea568b5b19766538434bc1c0,0,Doug Cutting,2014-01-28 20:02:23+00:00,['1c43a60e65da433cf1d0f2e5088ed30f9f8d8bca'],1,11,12,583701,2,,,,2090
06711d38a9a5913a3816c6eb8a5dc47b4b612e24,0,Doug Cutting,2014-01-28 20:05:21+00:00,['7be037b56f722005ea568b5b19766538434bc1c0'],2,4,6,583707,2,,,,2090
a0f75f971f81c1b01efd083888e65e968c057846,0,Doug Cutting,2014-01-28 22:37:38+00:00,['06711d38a9a5913a3816c6eb8a5dc47b4b612e24'],1,1,2,583709,1,,,,2090
49593cc38c388b89b85433b4533501a2d11e722f,0,Doug Cutting,2014-02-04 23:34:02+00:00,['a0f75f971f81c1b01efd083888e65e968c057846'],26,930,956,584665,8,0.625344353,0.859504132,0.713498623,2096
5e2e176168f7d8f528704a05608ee0ab68e32b63,1,Doug Cutting,2014-02-05 00:02:45+00:00,['49593cc38c388b89b85433b4533501a2d11e722f'],0,3770,3770,588435,29,,,,2122
364444783b65832b07a1436ee3a93faece63d484,1,Doug Cutting,2014-02-05 00:09:57+00:00,['5e2e176168f7d8f528704a05608ee0ab68e32b63'],18,119,137,588572,8,0.433333333,0.466666667,0.866666667,2122
41b8efb05a6de0a1112c0ea08dfb0c63a86b3614,0,Doug Cutting,2014-02-05 19:50:39+00:00,['364444783b65832b07a1436ee3a93faece63d484'],1,1,2,588574,1,,,,2122
706131388a81646d12a53ce31cf4c4557f93c017,0,Thomas White,2014-02-28 10:44:09+00:00,['41b8efb05a6de0a1112c0ea08dfb0c63a86b3614'],2,23,25,588599,3,0,1,1,2122
e0966a1ec55a6ca45baf5d3f53ad6b0e7a049452,0,Thomas White,2014-03-03 15:25:57+00:00,['706131388a81646d12a53ce31cf4c4557f93c017'],6,15,21,588620,3,0,0,1,2122
8dd83708d454f9dc7caebf2769b3f5c513ba242c,1,Doug Cutting,2014-03-03 18:40:19+00:00,['e0966a1ec55a6ca45baf5d3f53ad6b0e7a049452'],1,22,23,588643,4,0.5625,0.5625,1,2122
63b868907ada80f8621610ceefc47a0ec4fd26f4,0,Doug Cutting,2014-03-13 18:04:06+00:00,['8dd83708d454f9dc7caebf2769b3f5c513ba242c'],1,4,5,588648,2,,,,2122
6e1e0bcf4fb4a0466e0cedb4ac00a0d4bbfed8e1,0,Doug Cutting,2014-03-13 18:35:31+00:00,['63b868907ada80f8621610ceefc47a0ec4fd26f4'],11,65,76,588724,3,0.791666667,1,1,2122
4405ed978425b779a2e2fdd238af2e1a95bfd8b8,0,Doug Cutting,2014-03-13 20:39:26+00:00,['6e1e0bcf4fb4a0466e0cedb4ac00a0d4bbfed8e1'],1,6,7,588731,2,0,0,1,2122
c81303a746f4706b3c039635af37a81d6cfcc962,0,Doug Cutting,2014-03-13 20:43:05+00:00,['4405ed978425b779a2e2fdd238af2e1a95bfd8b8'],1,4,5,588736,2,,,,2122
14cae5dd0114a28f9a750c718291abba2763fcbd,1,Doug Cutting,2014-03-14 19:31:20+00:00,['c81303a746f4706b3c039635af37a81d6cfcc962'],1,50,51,588787,4,0,0.962962963,0.962962963,2122
f88cabc1e1271c8d4d2135807fc861664062c276,0,Doug Cutting,2014-03-14 19:41:32+00:00,['14cae5dd0114a28f9a750c718291abba2763fcbd'],10,19,29,588816,2,,,,2122
4fec1d9c1fde62c384d59ed520dfc80b4a4205a5,0,Thomas White,2014-04-04 10:33:02+00:00,['f88cabc1e1271c8d4d2135807fc861664062c276'],4,246,250,589066,8,0.757894737,1,0.905263158,2124
7122ddad939d59f03da8c60bd41eb9247352c449,0,Thomas White,2014-04-10 10:35:03+00:00,['4fec1d9c1fde62c384d59ed520dfc80b4a4205a5'],246,4,250,589316,8,0.242105263,0,0.094736842,2124
c754127aae3f252e59d4533f93c8cfaec5608529,0,Douglass R. Cutting,2014-04-18 15:45:51+00:00,['7122ddad939d59f03da8c60bd41eb9247352c449'],0,71,71,589387,2,,,,2124
c533aeff68af47a99f3f61d091451a4cff700e19,0,Doug Cutting,2014-05-28 21:26:30+00:00,['c754127aae3f252e59d4533f93c8cfaec5608529'],9,18,27,589414,4,0,1,1,2124
4deed74fe934dbc1edf207cefde92aed587c96a2,1,Doug Cutting,2014-05-28 21:43:43+00:00,['c533aeff68af47a99f3f61d091451a4cff700e19'],1,4,5,589419,2,,,,2124
c3a67e5ad90ff19d7557eb627678a3d0a09446e5,1,Doug Cutting,2014-05-28 22:19:54+00:00,['4deed74fe934dbc1edf207cefde92aed587c96a2'],4,412,416,589835,6,0.615384615,0.688644689,0.989010989,2125
71c2fc608a443404d0872b12ea08269a84f02d41,1,Doug Cutting,2014-05-28 22:25:55+00:00,['c3a67e5ad90ff19d7557eb627678a3d0a09446e5'],0,38,38,589873,3,0.888888889,0.888888889,0.888888889,2126
30e914cf37160bfd0aa4daf97feadd8e57435a33,0,Doug Cutting,2014-06-06 21:13:27+00:00,['71c2fc608a443404d0872b12ea08269a84f02d41'],0,106,106,589979,3,0.281690141,1,1,2126
5c5e2ea98e792d8a09e5ba173818e02ba570aabc,1,Doug Cutting,2014-06-06 21:56:40+00:00,['30e914cf37160bfd0aa4daf97feadd8e57435a33'],4,105,109,590088,6,0.28,0.32,1,2127
98ec5f2a172391cb5dfa7b4d85f39065bae22754,1,Thomas White,2014-06-09 11:36:34+00:00,['5c5e2ea98e792d8a09e5ba173818e02ba570aabc'],0,639,639,590727,12,0.791666667,0.895833333,0.864583333,2137
3e9479b3c8ec6c18f4f7dbe5b1a5a68671296206,0,Doug Cutting,2014-06-11 19:26:34+00:00,['98ec5f2a172391cb5dfa7b4d85f39065bae22754'],6,10,16,590743,7,,,,2137
a076f6f6f9848090776080b876fa0c1f2ca660a5,0,Doug Cutting,2014-06-11 19:40:47+00:00,['3e9479b3c8ec6c18f4f7dbe5b1a5a68671296206'],5,22,27,590770,3,,,,2137
070c430b72098481e544052d1dc116a624dbcce8,0,Doug Cutting,2014-06-11 19:48:07+00:00,['a076f6f6f9848090776080b876fa0c1f2ca660a5'],3,8,11,590781,4,,,,2137
cc7ec43e22f65fdea2bec9be04832f194c9bc6b8,0,Thomas White,2014-06-12 08:55:33+00:00,['070c430b72098481e544052d1dc116a624dbcce8'],0,19,19,590800,3,1,0.466666667,1,2137
b723741bfd071077c50d998131af1417c4371c26,1,Thiruvalluvan M. G,2014-06-29 18:00:05+00:00,['cc7ec43e22f65fdea2bec9be04832f194c9bc6b8'],668,1335,2003,592803,23,0.160883281,0.305993691,0.536277603,2140
010091fc66a92292525c18713117a673bee14831,0,Thiruvalluvan M. G,2014-06-29 18:29:31+00:00,['b723741bfd071077c50d998131af1417c4371c26'],1,35,36,592839,3,0.875,1,1,2140
289ea57aa60c151f4fd2eb59c73b8d81c141d2b8,0,Doug Cutting,2014-07-01 21:18:11+00:00,['010091fc66a92292525c18713117a673bee14831'],5,22,27,592866,4,0.818181818,1,1,2140
ce9888491b24b295865940ec68a21a43b0bca467,0,Doug Cutting,2014-07-01 21:29:22+00:00,['289ea57aa60c151f4fd2eb59c73b8d81c141d2b8'],2,5,7,592873,1,,,,2140
11a18d9b686d98f7731904584ed8a809cd86dea8,0,Doug Cutting,2014-07-01 21:33:48+00:00,['ce9888491b24b295865940ec68a21a43b0bca467'],4,96,100,592973,5,0.657142857,0.685714286,0.857142857,2140
b67cea15443e22db2e57c30dfdc5da2697e5ecb5,0,Martin Kleppmann,2014-07-03 15:02:13+00:00,['11a18d9b686d98f7731904584ed8a809cd86dea8'],28,4,32,593005,5,0,0,0,2140
3e997c3b63fd10ec27b1bc0061e14881da5e4dab,0,Martin Kleppmann,2014-07-03 15:10:26+00:00,['b67cea15443e22db2e57c30dfdc5da2697e5ecb5'],2,7,9,593014,2,0,1,0,2140
175a67d10cabb1672d4c966182432dec62e8d288,0,Doug Cutting,2014-07-03 18:35:42+00:00,['3e997c3b63fd10ec27b1bc0061e14881da5e4dab'],6,77,83,593097,5,0.188679245,0.509433962,1,2140
f406cb4693a95842ae99bea8d9971513ea975b27,0,Doug Cutting,2014-07-03 21:20:34+00:00,['175a67d10cabb1672d4c966182432dec62e8d288'],0,18,18,593115,1,,,,2140
f3e482fd2339cd697d3eb2136f0d76b7b602525a,0,Doug Cutting,2014-07-03 21:21:03+00:00,['f406cb4693a95842ae99bea8d9971513ea975b27'],0,3,3,593118,1,,,,2140
d5f32e1624696c6a67923595da82d53c1103e6c8,0,Doug Cutting,2014-07-03 21:21:35+00:00,['f3e482fd2339cd697d3eb2136f0d76b7b602525a'],2,2,4,593122,1,,,,2140
082fb97eb5d1c29b12e41115e45be357553afc8e,1,Christophe Taton,2014-07-05 04:34:49+00:00,['d5f32e1624696c6a67923595da82d53c1103e6c8'],92,141,233,593355,3,0.631578947,1,1,2140
0478e9cea93142e1ec0eefb9e0d7d19962a8bf0f,0,Thiruvalluvan M. G,2014-07-15 18:32:47+00:00,['082fb97eb5d1c29b12e41115e45be357553afc8e'],1,4,5,593360,3,,,,2140
1de668f8390edef0ee135b1c02c490a40e1a165e,0,Doug Cutting,2014-07-16 20:06:20+00:00,['0478e9cea93142e1ec0eefb9e0d7d19962a8bf0f'],11,8,19,593379,1,,,,2140
2cf39f749f0e58e0a48754d71bdb106540b4ca86,0,Doug Cutting,2014-07-18 18:37:13+00:00,['1de668f8390edef0ee135b1c02c490a40e1a165e'],19,19,38,593417,18,,,,2140
06d463b1a119c5d8bc4347fa9e280f4096551080,0,Doug Cutting,2014-07-18 19:11:17+00:00,['2cf39f749f0e58e0a48754d71bdb106540b4ca86'],3,8,11,593428,3,1,1,1,2140
d9f748e1469e5a37f1369270722f8b0d12376264,0,Doug Cutting,2014-07-24 20:20:04+00:00,['06d463b1a119c5d8bc4347fa9e280f4096551080'],19,29,48,593476,19,,,,2140
0d577247ca54ca9f180d2902c5ce6cf182b67904,0,Thomas White,2014-07-29 12:50:23+00:00,['d9f748e1469e5a37f1369270722f8b0d12376264'],4,69,73,593549,3,0,1,1,2140
b8dec14716b112a07ffba2df39cee9da1ee08725,1,Doug Cutting,2014-08-04 20:08:11+00:00,['0d577247ca54ca9f180d2902c5ce6cf182b67904'],0,40,40,593589,3,0,0.965517241,1,2140
0781e9f27d2f92af283e2033e4284ea18b3794a2,0,Doug Cutting,2014-08-04 20:12:16+00:00,['b8dec14716b112a07ffba2df39cee9da1ee08725'],2,7,9,593598,4,,,,2140
2a618069759cb7c68e3204edf3de28821721ffee,1,Doug Cutting,2014-08-05 17:52:53+00:00,['0781e9f27d2f92af283e2033e4284ea18b3794a2'],0,315,315,593913,3,0.574468085,1,1,2143
919ace25804400a6b14d42dc60f5685578b5fcb9,1,Doug Cutting,2014-08-07 17:19:23+00:00,['2a618069759cb7c68e3204edf3de28821721ffee'],9,16,25,593938,7,,,,2143
d3e984ec25fb0c0a99cd080fa4320cbe3432ee6c,0,Doug Cutting,2014-09-02 22:24:35+00:00,['919ace25804400a6b14d42dc60f5685578b5fcb9'],18,18,36,593974,17,,,,2143
aad41f750d1332d6a90ad52a70ba2791bd74969a,0,Doug Cutting,2014-09-09 22:06:00+00:00,['d3e984ec25fb0c0a99cd080fa4320cbe3432ee6c'],15,35,50,594024,3,1,1,0.230769231,2143
7aa6d34cf9f0bee928a2fcb69003fb579de67b25,0,Thomas White,2014-09-17 13:12:42+00:00,['aad41f750d1332d6a90ad52a70ba2791bd74969a'],0,44,44,594068,2,,,,2143
884c3fcbc57cc5d8afff87dccd4caf87ce478aed,1,Doug Cutting,2014-09-22 22:07:34+00:00,['7aa6d34cf9f0bee928a2fcb69003fb579de67b25'],1242,3020,4262,598330,32,0.422900763,0.578625954,0.986259542,2143
7c0f04e97f6b324ce2447afc4f05665bf83762a8,0,Doug Cutting,2014-09-22 22:13:38+00:00,['884c3fcbc57cc5d8afff87dccd4caf87ce478aed'],0,107,107,598437,3,0.234042553,1,1,2144
fdb45a7968cc0ba7f57bc5fa97777995dc946820,0,Doug Cutting,2014-09-23 16:25:27+00:00,['7c0f04e97f6b324ce2447afc4f05665bf83762a8'],13,32,45,598482,6,0.076923077,0.076923077,0.076923077,2144
fb28910e926f1c442b90e650c3bd9e6ecfb80a79,1,Doug Cutting,2014-09-29 22:58:29+00:00,['fdb45a7968cc0ba7f57bc5fa97777995dc946820'],6,202,208,598690,4,0.865853659,0.865853659,0.268292683,2144
4eec345521b9b7ec5a27e4f495a2e9a5b7d09efc,1,Doug Cutting,2014-10-03 20:33:39+00:00,['fb28910e926f1c442b90e650c3bd9e6ecfb80a79'],6,85,91,598781,7,0.320754717,1,0.962264151,2144
f71e0cd28d1ebc039ec57cd303ba30e190e72dce,1,Doug Cutting,2014-10-03 21:24:48+00:00,['4eec345521b9b7ec5a27e4f495a2e9a5b7d09efc'],34,457,491,599272,16,0.730994152,0.538011696,0.953216374,2146
f426a75e9c8dc48fdc4901224313edbb9c4739a1,0,Doug Cutting,2014-10-04 00:01:02+00:00,['f71e0cd28d1ebc039ec57cd303ba30e190e72dce'],25,131,156,599428,3,0.464285714,0.464285714,0.464285714,2147
5af5e3992a6a58dcb3e52969e4e2b5d903a076c3,1,Doug Cutting,2014-10-07 14:02:17+00:00,['f426a75e9c8dc48fdc4901224313edbb9c4739a1'],70,2086,2156,601584,31,0.330213904,0.505347594,0.627005348,2158
4a78a2da6a4d648d62249a9de048c419084320c0,0,Doug Cutting,2014-10-07 14:04:22+00:00,['5af5e3992a6a58dcb3e52969e4e2b5d903a076c3'],0,0,0,601584,0,,,,2158
2cfab13bb3cb9474745f1b34afeaed103def2999,0,Thomas White,2014-10-27 14:11:06+00:00,['4a78a2da6a4d648d62249a9de048c419084320c0'],2,8,10,601594,2,1,1,1,2158
c915fb13a26bd885200591148af91fe483d8723b,0,Doug Cutting,2014-10-28 17:06:33+00:00,['2cfab13bb3cb9474745f1b34afeaed103def2999'],1,22,23,601617,3,,,,2160
4f6eb207b1df2ff438d952e383041021f0275705,0,Doug Cutting,2014-10-28 23:12:15+00:00,['c915fb13a26bd885200591148af91fe483d8723b'],0,14,14,601631,1,,,,2160
3b8740860e33fa1b28609901b5e1bd554b11b090,0,Thomas White,2014-11-04 15:49:30+00:00,['4f6eb207b1df2ff438d952e383041021f0275705'],4,13,17,601648,1,1,1,1,2160
535f6efca296d80f01e1bad2050b1bdc453f4800,0,Doug Cutting,2014-11-04 17:27:17+00:00,['3b8740860e33fa1b28609901b5e1bd554b11b090'],8,25,33,601681,1,1,1,1,2160
97165abbb62a558fe498c33999c34a73a35b6bd8,0,Doug Cutting,2014-11-06 23:18:10+00:00,['535f6efca296d80f01e1bad2050b1bdc453f4800'],6,17,23,601704,2,,,,2160
d84eef25161d31bcc69829810e7c00e730f45935,1,Doug Cutting,2014-11-06 23:31:03+00:00,['97165abbb62a558fe498c33999c34a73a35b6bd8'],38,37,75,601779,2,1,1,0,2160
4210b05960b6657b4f0ca98f97c49649e1de7139,1,Doug Cutting,2014-11-08 00:54:22+00:00,['d84eef25161d31bcc69829810e7c00e730f45935'],14,31,45,601824,5,1,1,1,2161
77e7fa0274b85742937026b95a839590368d2879,1,Doug Cutting,2014-11-08 00:57:20+00:00,['4210b05960b6657b4f0ca98f97c49649e1de7139'],4,38,42,601866,3,1,1,1,2161
5b9b847fa099d2476ba497ad971ac36495add960,0,Doug Cutting,2014-11-13 22:08:27+00:00,['77e7fa0274b85742937026b95a839590368d2879'],5686,3,5689,607555,36,0.511558091,0.26508556,0.135394776,2161
3bb62d24aa90230d17da5ab612042799f5c2d7c9,0,Thomas White,2014-11-17 15:27:49+00:00,['5b9b847fa099d2476ba497ad971ac36495add960'],1,101,102,607657,3,0.066666667,1,1,2162
5cc99503deea276eabfb9deb8c88fd1f01f5ebad,0,Thomas White,2014-11-17 16:04:35+00:00,['3bb62d24aa90230d17da5ab612042799f5c2d7c9'],0,505,505,608162,5,0.283746556,0.449035813,0.377410468,2164
f66a7875b8b904e21e0f0e40a418627ea98d9ce7,1,Thomas White,2014-11-18 09:58:21+00:00,['5cc99503deea276eabfb9deb8c88fd1f01f5ebad'],42,499,541,608703,17,0.372093023,0.572093023,0.962790698,2166
ad27ed0d9430ea9b944ad6e70138a355aebe10e0,0,Doug Cutting,2014-11-26 19:16:47+00:00,['f66a7875b8b904e21e0f0e40a418627ea98d9ce7'],35,139,174,608877,5,0.240963855,0.265060241,1,2166
fbaf3c399e2f34e57008d8625c76f0543a3cadf4,0,Doug Cutting,2014-11-26 19:30:18+00:00,['ad27ed0d9430ea9b944ad6e70138a355aebe10e0'],0,97,97,608974,3,0.081081081,0,0.756756757,2167
5009caa85de9f61c3d8144713c5fecd0331eee61,0,Doug Cutting,2014-11-26 19:33:41+00:00,['fbaf3c399e2f34e57008d8625c76f0543a3cadf4'],2,75,77,609051,3,0,1,1,2167
d2cd7b84dccb647c9637074986edc0baec70e50d,0,Thomas White,2014-12-10 15:28:14+00:00,['5009caa85de9f61c3d8144713c5fecd0331eee61'],39,0,39,609090,1,0.53125,0,0,2167
6501dd51fc3a910a4cdc3e5abc73f49ed47240bc,0,Thomas White,2014-12-11 11:38:17+00:00,['d2cd7b84dccb647c9637074986edc0baec70e50d'],3,172,175,609265,10,,,,2167
71c29bdef8fb3c43ecbf1c5ddae8a10f6f38d830,0,Doug Cutting,2014-12-15 22:06:22+00:00,['6501dd51fc3a910a4cdc3e5abc73f49ed47240bc'],68,176,244,609509,5,,,,2167
7d61edb1057f9b3361f142228ec6da2797bc2dec,0,Doug Cutting,2014-12-15 22:14:05+00:00,['71c29bdef8fb3c43ecbf1c5ddae8a10f6f38d830'],0,6,6,609515,2,,,,2167
34174efd237c8aabdcf8b546d9b1b2bd1e16b01e,1,Doug Cutting,2014-12-17 23:02:33+00:00,['7d61edb1057f9b3361f142228ec6da2797bc2dec'],18,520,538,610053,9,0.161676647,0.814371257,0.958083832,2170
7c0a16b8385c95c3e319de1aca9b7f20c7e61c46,1,Doug Cutting,2014-12-17 23:07:02+00:00,['34174efd237c8aabdcf8b546d9b1b2bd1e16b01e'],6,18,24,610077,5,,,0,2170
510a61709411918fc7d4126b46176954189bb85f,0,Doug Cutting,2014-12-17 23:20:41+00:00,['7c0a16b8385c95c3e319de1aca9b7f20c7e61c46'],4,32,36,610113,3,0,0.894736842,1,2170
3fdea9c2021b1491825f45547c62b52d75dc505c,0,Doug Cutting,2014-12-17 23:36:22+00:00,['510a61709411918fc7d4126b46176954189bb85f'],2,160,162,610275,4,1,1,1,2171
3414ca077b774e98db41d32b69128cd8a7ed12b2,0,Thomas White,2014-12-18 15:09:22+00:00,['3fdea9c2021b1491825f45547c62b52d75dc505c'],3,49,52,610327,2,0.228571429,1,0.114285714,2171
005c7e0fd6377162a1bd7cc425cb35a23cdf9d52,0,Thomas White,2015-01-07 15:47:26+00:00,['3414ca077b774e98db41d32b69128cd8a7ed12b2'],9,19,28,610355,4,0,1,1,2171
56838397367fbe3570e3f361034aec24ba9e0f64,1,Thomas White,2015-01-12 12:11:55+00:00,['005c7e0fd6377162a1bd7cc425cb35a23cdf9d52'],2,106,108,610463,5,,,,2172
a34ae84b27d7060fcbd41dd744d047d316ce449e,0,Thomas White,2015-01-12 12:26:17+00:00,['56838397367fbe3570e3f361034aec24ba9e0f64'],2,8,10,610473,2,,,,2172
a471a726a499081c912d50fe9a6ad722e5fe3b4d,0,Doug Cutting,2015-01-14 21:16:56+00:00,['a34ae84b27d7060fcbd41dd744d047d316ce449e'],0,24,24,610497,3,1,1,1,2172
6a80468a68de9bd035d5cc21d2ee664e1956c884,0,Thomas White,2015-02-03 15:00:21+00:00,['a471a726a499081c912d50fe9a6ad722e5fe3b4d'],1,60,61,610558,3,0,1,1,2172
2e5acf3e5fd1e6c0f193bea0c2234c09a848f17a,1,Ryan Blue,2015-03-15 03:26:57+00:00,['6a80468a68de9bd035d5cc21d2ee664e1956c884'],7,664,671,611229,6,0.470862471,0.748251748,0.769230769,2173
42abe4f510cafa843d46805662a5b564e13f6aea,0,Ryan Blue,2015-03-30 23:45:17+00:00,['2e5acf3e5fd1e6c0f193bea0c2234c09a848f17a'],1,3,4,611233,2,,,,2173
5a52b4b8c9201102183ea643307ceae932e5b8f5,0,Ryan Blue,2015-03-31 21:11:39+00:00,['42abe4f510cafa843d46805662a5b564e13f6aea'],1,3,4,611237,2,,,,2173
630562a0b16ae73c8cb8d85da723bca6b28de6db,0,Ryan Blue,2015-03-31 23:19:05+00:00,['5a52b4b8c9201102183ea643307ceae932e5b8f5'],4,5,9,611246,2,0,0,1,2173
60d9ef0ad24d91735210830b2481e884ec45c9e7,0,Ryan Blue,2015-04-17 20:47:13+00:00,['630562a0b16ae73c8cb8d85da723bca6b28de6db'],2,51,53,611299,3,0.931034483,1,0.655172414,2173
eb31746cd5efd5e2c9c57780a651afaccd5cfe06,1,Ryan Blue,2015-05-27 04:48:58+00:00,['60d9ef0ad24d91735210830b2481e884ec45c9e7'],22,2182,2204,613503,14,0.5,0.80195258,0.761506276,2180
ab938b84b2cd305eef3fbd238edf78945bd043e9,0,Thomas White,2015-06-25 15:38:03+00:00,['eb31746cd5efd5e2c9c57780a651afaccd5cfe06'],5,111,116,613619,3,0.576923077,1,0.5,2181
83cb47e04c057627ac839a16e03972ed7481ca02,0,Thomas White,2015-06-25 16:28:07+00:00,['ab938b84b2cd305eef3fbd238edf78945bd043e9'],1,3,4,613623,2,,,,2181
1e1b379463d0dbe1d2e0d162586dcebceb6af1e6,0,Ryan Blue,2015-06-26 05:40:54+00:00,['83cb47e04c057627ac839a16e03972ed7481ca02'],3,26,29,613652,2,,,,2181
b81761e72307bfc62843c0b207a4712aa2d9c9c0,1,Thomas White,2015-06-26 14:39:14+00:00,['1e1b379463d0dbe1d2e0d162586dcebceb6af1e6'],32,156,188,613840,8,0,0,1,2181
4f7013b1465959d6c17e21c969dcb90b5a0d6a25,0,Thomas White,2015-07-07 10:10:34+00:00,['b81761e72307bfc62843c0b207a4712aa2d9c9c0'],6,9,15,613855,2,,,,2181
f2d7c194ddd2734e567e77b9810ffb44ed65d6bd,1,Thomas White,2015-07-07 10:30:22+00:00,['4f7013b1465959d6c17e21c969dcb90b5a0d6a25'],122,21,143,613998,6,,,,2181
c5fe80507610fcf24e53516365cd7c2efb2291dd,0,Thomas White,2015-07-07 13:23:32+00:00,['f2d7c194ddd2734e567e77b9810ffb44ed65d6bd'],5,6,11,614009,3,,,,2181
ba10e8bf61efbceaad0a8f95ba73c659f678bc1e,0,Thomas White,2015-07-07 14:03:16+00:00,['c5fe80507610fcf24e53516365cd7c2efb2291dd'],1,1,2,614011,1,,,,2181
9e9f0e86e00ba71f501ac2c8b09f98f8e3f9365e,0,Thomas White,2015-07-07 16:25:51+00:00,['ba10e8bf61efbceaad0a8f95ba73c659f678bc1e'],7,6,13,614024,4,,,,2181
d3f854449e540cd2f34a0a96df15d379d8c1d525,0,Thomas White,2015-07-08 14:27:44+00:00,['9e9f0e86e00ba71f501ac2c8b09f98f8e3f9365e'],2,25,27,614051,3,1,1,1,2181
a6743849b29b67f5013bf9b917daf70b19810929,0,Thomas White,2015-07-08 14:31:50+00:00,['d3f854449e540cd2f34a0a96df15d379d8c1d525'],7,22,29,614080,3,1,1,1,2181
dfdbb60a8d9f97b43db981b6ee08f434a288111a,1,Ryan Blue,2015-07-09 17:51:59+00:00,['a6743849b29b67f5013bf9b917daf70b19810929'],5,507,512,614592,6,0.462046205,0.9669967,0.900990099,2183
c4c3739dedd51a6fe02731adc617b30d3f4bbd80,0,Thomas White,2015-07-10 15:20:43+00:00,['dfdbb60a8d9f97b43db981b6ee08f434a288111a'],0,40,40,614632,4,1,1,1,2183
74b444929bfdbdd0bcdf45a80dec7b507f805428,0,Thomas White,2015-07-13 16:19:22+00:00,['c4c3739dedd51a6fe02731adc617b30d3f4bbd80'],1,16,17,614649,2,1,1,1,2183
e12bdb0bee1e298c5a2ab352e1b2ac3dac6448fa,0,Thomas White,2015-07-14 14:07:23+00:00,['74b444929bfdbdd0bcdf45a80dec7b507f805428'],29,450,479,615128,6,0.628691983,1,0.666666667,2184
96c95a93cc5cc4c4fc19ea16edb926ffb4625156,0,Thomas White,2015-07-15 11:26:54+00:00,['e12bdb0bee1e298c5a2ab352e1b2ac3dac6448fa'],2,3,5,615133,1,,,,2184
7fcfcf12648d322728da549a56994607baf989ae,0,Thomas White,2015-07-15 11:35:20+00:00,['96c95a93cc5cc4c4fc19ea16edb926ffb4625156'],1,5,6,615139,3,,,,2184
fe306bf207ab4fd290893651a9c92caae611aff3,0,Thomas White,2015-07-15 11:56:15+00:00,['7fcfcf12648d322728da549a56994607baf989ae'],2,5,7,615146,2,,,,2184
4de802425783c8abbb97a0574741670cab776dff,0,Thomas White,2015-07-15 12:02:44+00:00,['fe306bf207ab4fd290893651a9c92caae611aff3'],1,1,2,615148,1,,,,2184
90d02b4bfa2154ba71a8a05b6c2661cf792d062d,0,Thomas White,2015-07-15 13:40:58+00:00,['4de802425783c8abbb97a0574741670cab776dff'],0,35,35,615183,1,1,1,1,2185
65841fc8967c4599e29b99dafe8c8f7272b7a4c2,0,Thomas White,2015-07-15 14:00:20+00:00,['90d02b4bfa2154ba71a8a05b6c2661cf792d062d'],40,0,40,615223,4,0,0,0,2185
2c76eb516ccff61f29ea4efd15cff44c7832fd33,0,Thomas White,2015-07-15 14:50:35+00:00,['65841fc8967c4599e29b99dafe8c8f7272b7a4c2'],0,180,180,615403,10,,,,2185
946e96680764095588e5a3e40e97a821b5fb9038,0,Thomas White,2015-07-15 16:40:52+00:00,['2c76eb516ccff61f29ea4efd15cff44c7832fd33'],4,8,12,615415,3,,,,2185
bc657e4d93166b6d5c2cdc587aaeca17760099a6,1,Thomas White,2015-07-16 08:24:45+00:00,['946e96680764095588e5a3e40e97a821b5fb9038'],2,43,45,615460,5,1,1,1,2185
8570a93e1f6ebc14bc3c78692256122b9ba2c1ea,1,Thomas White,2015-07-16 14:29:03+00:00,['bc657e4d93166b6d5c2cdc587aaeca17760099a6'],2,9,11,615471,3,,,,2185
82ee5b448983f5074e513c053258c6ed23c8701b,0,Ryan Blue,2015-08-07 19:41:40+00:00,['8570a93e1f6ebc14bc3c78692256122b9ba2c1ea'],1,1,2,615473,1,,,,2185
e90092bce9d3e9436475dc61521e0cd019831a67,0,Thomas White,2015-08-10 13:24:32+00:00,['82ee5b448983f5074e513c053258c6ed23c8701b'],1,1,2,615475,1,,,,2185
72846f1daeadda01b3af29f922dc6f840b224b0e,0,Thomas White,2015-08-10 13:30:15+00:00,['e90092bce9d3e9436475dc61521e0cd019831a67'],18,21,39,615514,18,,,,2185
248c4bfefdc5fcc6966910ff2bf0b91d9c4da4ac,0,Thomas White,2015-08-11 10:04:19+00:00,['72846f1daeadda01b3af29f922dc6f840b224b0e'],2,8,10,615524,2,,,,2185
710a001a1b41d465db7a300bfcc03040fcef03b3,0,Thomas White,2015-08-25 14:26:00+00:00,['248c4bfefdc5fcc6966910ff2bf0b91d9c4da4ac'],2,16,18,615542,3,1,1,1,2185
069f00e0e849775a93c08a74e48fc10b34566d02,0,Ryan Blue,2015-08-26 21:32:44+00:00,['710a001a1b41d465db7a300bfcc03040fcef03b3'],1,5,6,615548,2,,,,2185
4fdc75209ba54f60b2c5798cff731a11053fbcfd,0,Ryan Blue,2015-08-26 21:40:42+00:00,['069f00e0e849775a93c08a74e48fc10b34566d02'],1,4,5,615553,2,,,,2185
4686716c4ef7bb139a371d1de881ad1aaf93a144,0,Sean Busbey,2015-09-12 07:20:58+00:00,['4fdc75209ba54f60b2c5798cff731a11053fbcfd'],1,3,4,615557,1,,,,2185
e0096f2f9d0036e02f16eb0b111fd68470758351,1,Sean Busbey,2015-09-14 00:03:51+00:00,['4686716c4ef7bb139a371d1de881ad1aaf93a144'],0,371,371,615928,6,0.655462185,0.865546218,1,2189
0f5758b2d0f75c8234443e72c43d2fd38fe1894d,0,Ryan Blue,2015-10-07 18:14:43+00:00,['e0096f2f9d0036e02f16eb0b111fd68470758351'],23,24,47,615975,15,,,,2189
4707d9abe1202c7266aa8d58711fd22907863cbd,0,Ryan Blue,2015-10-07 21:06:28+00:00,['0f5758b2d0f75c8234443e72c43d2fd38fe1894d'],6,27,33,616008,7,1,1,1,2189
bc19e3a12e033e60c4f5c6c1d7a20fc9f8182da6,1,Ryan Blue,2015-10-19 21:23:33+00:00,['4707d9abe1202c7266aa8d58711fd22907863cbd'],1,215,216,616224,5,,,,2191
5cb83db6a66a6d60aa01b41160a9c90ad4987736,1,Ryan Blue,2015-10-19 21:28:02+00:00,['bc19e3a12e033e60c4f5c6c1d7a20fc9f8182da6'],1,277,278,616502,5,,,,2193
3585c45902b99ae5cf5e3086d1dfc61389017d7f,1,Ryan Blue,2015-10-19 21:32:23+00:00,['5cb83db6a66a6d60aa01b41160a9c90ad4987736'],2,261,263,616765,5,,,,2195
1c5205ef3f1516fa5f3a323057139bffd5758182,0,Zoltan Farkas,2015-11-18 17:44:50-05:00,['e0096f2f9d0036e02f16eb0b111fd68470758351'],46,489,535,617300,7,0.152173913,0.339130435,0.673913043,2200
bdc98484730275bebcc4f22d6e3ffd9f97616920,0,Thomas White,2015-11-25 14:16:08+00:00,['3585c45902b99ae5cf5e3086d1dfc61389017d7f'],0,4,4,617304,2,,,,2200
5662cbbffa89fb8d363ccbee03fe85980e17ba15,0,Thiruvalluvan M. G,2015-11-26 18:46:01+00:00,['bdc98484730275bebcc4f22d6e3ffd9f97616920'],0,3,3,617307,2,1,1,1,2200
df5c513f1e7a606b7333975b6d28784702f77077,0,Ryan Blue,2015-12-03 16:55:18+00:00,['5662cbbffa89fb8d363ccbee03fe85980e17ba15'],1,458,459,617766,4,,,,2202
96d2d35fa20a7ec14f699e0c899cc7e21ae3393b,0,Ryan Blue,2015-12-03 17:11:18+00:00,['df5c513f1e7a606b7333975b6d28784702f77077'],3,219,222,617988,5,,,,2204
ada69ac5e0be21c96cdc683ae5152b0a8216e14f,0,Ryan Blue,2015-12-03 17:22:51+00:00,['96d2d35fa20a7ec14f699e0c899cc7e21ae3393b'],1,212,213,618201,4,,,,2206
e11c588ebe034d5f2a043598e600791e38e124bb,0,Ryan Blue,2015-12-03 17:24:26+00:00,['ada69ac5e0be21c96cdc683ae5152b0a8216e14f'],0,212,212,618413,3,,,,2208
2c6c570d3b66975cfac367334d8a6971801397e5,0,Ryan Blue,2015-12-03 17:24:45+00:00,['e11c588ebe034d5f2a043598e600791e38e124bb'],0,228,228,618641,5,0,1,1,2211
f49b2d31fd9a0249a64c049da800db6648792ee0,1,Ryan Blue,2015-12-03 17:39:34+00:00,['2c6c570d3b66975cfac367334d8a6971801397e5'],3698,1106,4804,623445,34,,,,2211
bf751dfaada53680f66bc200f3acb04a4d538fd1,0,Ryan Blue,2015-12-03 18:54:51+00:00,['f49b2d31fd9a0249a64c049da800db6648792ee0'],64,4,68,623513,5,,,,2211
2863a185ee8c6a036ce811e1ecd80eefd7f54401,1,Ryan Blue,2015-12-03 21:35:44+00:00,['bf751dfaada53680f66bc200f3acb04a4d538fd1'],35,8822,8857,632370,27,0.688865398,0.891120507,0.960535588,2231
02418de9dee7b330552d43183109efa0b50ddf1f,1,Ryan Blue,2015-12-04 19:46:22+00:00,['2863a185ee8c6a036ce811e1ecd80eefd7f54401'],1,6,7,632377,2,,,,2231
80ba788ecdccaff5fbc011f6ad619bb62815dc04,0,Ryan Blue,2015-12-08 17:06:20+00:00,['02418de9dee7b330552d43183109efa0b50ddf1f'],4,43,47,632424,3,,,,2231
273106bd1186680c54c8101e75e0e7a8a0d83fd1,0,Ryan Blue,2015-12-08 21:34:42+00:00,['80ba788ecdccaff5fbc011f6ad619bb62815dc04'],31,217,248,632672,4,0.976377953,0.992125984,1,2231
1f6fa7b79efde2eb999de34334b686a77b23e46a,0,Zoltan Farkas,2015-12-09 17:25:56-05:00,['273106bd1186680c54c8101e75e0e7a8a0d83fd1'],46,489,535,633207,7,0.152173913,0.339130435,0.673913043,2236
57bea12e3a0860958b2060cab4f1193391584839,0,Zoltan Farkas,2015-12-09 17:28:36-05:00,"['1f6fa7b79efde2eb999de34334b686a77b23e46a', '1c5205ef3f1516fa5f3a323057139bffd5758182']",0,0,0,633207,0,,,,2236
4590538073b1b9cb8d4d471e082cfcfc3e1940ff,1,Ryan Blue,2015-12-15 00:50:12+00:00,['273106bd1186680c54c8101e75e0e7a8a0d83fd1'],3,17,20,633227,3,1,1,1,2236
ee28a20bef542d693312a3fc39239eee33800879,0,Ryan Blue,2015-12-15 23:23:35+00:00,['4590538073b1b9cb8d4d471e082cfcfc3e1940ff'],12,3460,3472,636699,18,,,,2249
1ccb4c22c1723d8137c3fa21dc16252af593d76c,0,Ryan Blue,2015-12-15 23:52:42+00:00,['ee28a20bef542d693312a3fc39239eee33800879'],1,3,4,636703,1,,,,2249
1910fade19f52b4beccc167507bdc8d417672b81,0,Ryan Blue,2015-12-16 00:02:54+00:00,['1ccb4c22c1723d8137c3fa21dc16252af593d76c'],0,10,10,636713,1,,,,2249
a3957200a86a4582c6622738caacd153f0ad7882,0,Martin Kleppmann,2015-12-30 15:35:46+00:00,['1910fade19f52b4beccc167507bdc8d417672b81'],5,178,183,636896,4,0.191011236,0.191011236,1,2250
146c5285030aab67ac172b659e8b748335cd2275,0,Martin Kleppmann,2015-12-30 15:43:43+00:00,['a3957200a86a4582c6622738caacd153f0ad7882'],0,7,7,636903,2,0,0,1,2250
00b1c43740a78540c64c36731b4de64b3402d181,1,Martin Kleppmann,2015-12-30 15:52:56+00:00,['146c5285030aab67ac172b659e8b748335cd2275'],0,3,3,636906,2,,,,2250
7ff749b8f26a3f3c90d3b480a35434fb0352b278,0,Thomas White,2016-01-06 11:48:52+00:00,['00b1c43740a78540c64c36731b4de64b3402d181'],6,2,8,636914,2,1,0,0,2250
1abf6c2dc31528cc6cd0675a215932c81e7075c9,1,Thomas White,2016-01-06 12:05:23+00:00,['7ff749b8f26a3f3c90d3b480a35434fb0352b278'],1,420,421,637335,4,,,,2252
e747a43c3fbb5189175ddce143c1a587f1e8a26c,0,Thomas White,2016-01-06 12:10:49+00:00,['1abf6c2dc31528cc6cd0675a215932c81e7075c9'],1,9,10,637345,3,,,,2252
cfa305bc381a8bc4d428ce88eb1a3ff6668d7953,0,Martin Kleppmann,2016-01-11 21:00:40+00:00,['e747a43c3fbb5189175ddce143c1a587f1e8a26c'],2,6,8,637353,2,,,,2252
080cd772f235a8f490928ce512aa62089af0f203,0,Thomas White,2016-01-12 11:10:14+00:00,['cfa305bc381a8bc4d428ce88eb1a3ff6668d7953'],2,7,9,637362,3,,,,2252
2564afeb1fdc4792603f7ddc1a7b3b347d05b54e,1,Ryan Blue,2016-01-12 17:07:59+00:00,['080cd772f235a8f490928ce512aa62089af0f203'],1,14,15,637377,1,1,1,1,2252
f7ec67996b66444f9de2284d1ddfaa66297ba51e,1,Ryan Blue,2016-01-13 18:14:54+00:00,['2564afeb1fdc4792603f7ddc1a7b3b347d05b54e'],5,611,616,637993,10,,,,2256
60365c1b05181960e141b71ca035164137f2cf64,0,Martin Kleppmann,2016-01-13 20:33:03+00:00,['f7ec67996b66444f9de2284d1ddfaa66297ba51e'],1,5,6,637999,3,,,,2256
363360229e7ea5f816d87f9d5747dd4494d3b862,0,Thomas White,2016-01-18 10:52:47+00:00,['60365c1b05181960e141b71ca035164137f2cf64'],3,6,9,638008,2,,,,2256
5a2febcb97cd5c71cc620c4f294f2d4d12be3aa9,1,Martin Kleppmann,2016-01-19 20:52:27+00:00,['363360229e7ea5f816d87f9d5747dd4494d3b862'],49936,41,49977,687985,298,0.764805774,0.663128847,0.295266398,2256
693ba378fc15ef8774cddd6ac11b8177a1d3e4f5,0,Martin Kleppmann,2016-01-19 20:58:46+00:00,['5a2febcb97cd5c71cc620c4f294f2d4d12be3aa9'],2,100,102,688087,4,0,1,1,2257
7f2afa8df4167435f4e92c715d65519d01bda2f8,0,Martin Kleppmann,2016-01-19 21:16:55+00:00,['693ba378fc15ef8774cddd6ac11b8177a1d3e4f5'],38,216,254,688341,10,0.260162602,0.154471545,0.170731707,2260
05f3fced7811cb5c6b3cb07361a4c4563bec5632,0,Martin Kleppmann,2016-01-19 22:27:45+00:00,['7f2afa8df4167435f4e92c715d65519d01bda2f8'],0,3,3,688344,2,,,,2260
4c9b159c3e03dc0965f5d0eac1884a04856c258a,0,Ryan Blue,2016-01-20 04:19:31+00:00,['05f3fced7811cb5c6b3cb07361a4c4563bec5632'],16,1,17,688361,1,0,0,0,2260
257aba0638a18380a5f99b6226d01db0a0390e26,0,Thomas White,2016-01-21 12:19:49+00:00,['4c9b159c3e03dc0965f5d0eac1884a04856c258a'],1,1,2,688363,1,,,,2260
315d842148d57590a58fafecf6e5ea378e9e0d74,1,Martin Kleppmann,2016-01-21 15:28:06+00:00,['257aba0638a18380a5f99b6226d01db0a0390e26'],13,62,75,688438,5,1,1,1,2260
274c510db79c651cc2141c4e1eaa07df292295dc,0,Thomas White,2016-01-22 16:49:23+00:00,['315d842148d57590a58fafecf6e5ea378e9e0d74'],1,1,2,688440,1,,,,2260
499b756e7dbc5e0cde8f385ec7bd76023dc2534f,0,Thomas White,2016-01-22 16:51:03+00:00,['274c510db79c651cc2141c4e1eaa07df292295dc'],0,7,7,688447,1,,,,2260
a50068f11e121bf87fa8bc24639af0fc62064633,1,Matthieu Monsch,2016-02-06 10:34:33-08:00,['499b756e7dbc5e0cde8f385ec7bd76023dc2534f'],4,22,26,688473,3,1,1,1,2260
9101a42badd32f0540caa28e27ca053a36e936e3,1,Matthieu Monsch,2016-02-06 10:51:21-08:00,['a50068f11e121bf87fa8bc24639af0fc62064633'],30,3073,3103,691576,14,0.729959695,0.921182266,0.829377519,2263
5e6ffb8d444c0ed3fb6d0180718a9a7c131f2ce6,0,Ryan Blue,2016-02-21 16:43:30-08:00,['9101a42badd32f0540caa28e27ca053a36e936e3'],5,29,34,691610,3,1,1,1,2263
62ad11dcf765d6735ef652f4252d19e4ded7afae,0,Ryan Blue,2016-02-29 10:48:59-08:00,['5e6ffb8d444c0ed3fb6d0180718a9a7c131f2ce6'],2,6,8,691618,3,1,1,1,2263
482adcfa1857033f2a76b07b429a266b0231f433,0,Ryan Blue,2016-03-15 08:47:31-07:00,['62ad11dcf765d6735ef652f4252d19e4ded7afae'],1,93,94,691712,3,0.428571429,0.514285714,0.657142857,2264
fd6c4228fbecc6eff3e3ecd5ee27d2ceb46339ff,1,Zoltan Farkas,2016-03-17 09:56:09-04:00,['482adcfa1857033f2a76b07b429a266b0231f433'],46,480,526,692238,7,0.157657658,0.441441441,0.698198198,2269
c299da64ee53de57ea34e589b858d7fe8ada72fd,0,Zoltan Farkas,2016-03-17 10:03:24-04:00,"['fd6c4228fbecc6eff3e3ecd5ee27d2ceb46339ff', '57bea12e3a0860958b2060cab4f1193391584839']",0,0,0,692238,0,,,,2269
3ff1fa8cac828bfaabd082cb82d7ea3a3827f02f,0,Zoltan Farkas,2016-03-17 10:18:02-04:00,['c299da64ee53de57ea34e589b858d7fe8ada72fd'],3,2,5,692243,1,,,,2269
ce16a3fc9e493d50425ecc697e397c486e9c62dd,0,Zoltan Farkas,2016-03-17 10:28:44-04:00,['3ff1fa8cac828bfaabd082cb82d7ea3a3827f02f'],42,43,85,692328,1,,,,2269
1158152de6debcf8e5a532585a68a39ab64d78ed,0,Zoltan Farkas,2016-04-04 11:33:13-04:00,['ce16a3fc9e493d50425ecc697e397c486e9c62dd'],181,176,357,692685,1,1,1,1,2269
b5e13ff04d1e9b6e5bb02b482b6ef0111268a9ed,0,Zoltan Farkas,2016-04-04 11:46:10-04:00,['1158152de6debcf8e5a532585a68a39ab64d78ed'],18,0,18,692703,1,,,,2269
df57d3ad29918b6c45b6fce15d4f0815024d49f2,0,Zoltan Farkas,2016-04-04 11:50:52-04:00,['b5e13ff04d1e9b6e5bb02b482b6ef0111268a9ed'],50,52,102,692805,1,,,,2269
a084fcdb5e79b1b8b86710f836ac6afce08c4a54,0,Zoltan Farkas,2016-04-04 11:52:08-04:00,['df57d3ad29918b6c45b6fce15d4f0815024d49f2'],1,1,2,692807,1,,,,2269
32067dec274ba93aa0775fcfe990eef3b87b534c,0,Ryan Blue,2016-04-09 15:46:28-07:00,['482adcfa1857033f2a76b07b429a266b0231f433'],1,4,5,692812,2,,,,2269
e98caa9937c47a4b44c80e0497995fd404102755,0,Thiruvalluvan M. G,2016-04-13 10:46:22+05:18,['32067dec274ba93aa0775fcfe990eef3b87b534c'],72,154,226,693038,8,1,0,0,2269
683bc7135b6a69a8d524393f91ada8310a8f9f88,0,Thiruvalluvan M. G,2016-04-13 11:20:28+05:18,['e98caa9937c47a4b44c80e0497995fd404102755'],1,9,10,693048,2,,,,2269
1de82871ccf2886171efd917aac822b7f2486ad3,0,Thiruvalluvan M. G,2016-04-16 08:34:05+05:18,['683bc7135b6a69a8d524393f91ada8310a8f9f88'],16,18,34,693082,2,,,,2269
58daaf08a2637e0976cc124571200ce198b3143d,1,Ryan Blue,2016-04-16 14:13:29-07:00,['1de82871ccf2886171efd917aac822b7f2486ad3'],4,49,53,693135,4,1,1,1,2270
f4f226378918cce8a722d9795f3df4a6c7219746,0,Ryan Blue,2016-04-16 14:28:51-07:00,['58daaf08a2637e0976cc124571200ce198b3143d'],1,4,5,693140,2,,,,2270
54eefb8d780237a7108c2a0c91b12282686426ad,0,Ryan Blue,2016-04-16 14:57:46-07:00,['f4f226378918cce8a722d9795f3df4a6c7219746'],2,0,2,693142,1,,,,2270
e62b98c7c6ff0c38f142b72d3b3fed7f3d717710,1,Ryan Blue,2016-04-16 15:14:21-07:00,['54eefb8d780237a7108c2a0c91b12282686426ad'],2,167,169,693311,4,0.784090909,0.988636364,1,2270
4996990874d127f4908c9f55f7bc3a4334e2aed4,0,Niels Basjes,2016-04-17 23:10:19+02:00,['e62b98c7c6ff0c38f142b72d3b3fed7f3d717710'],1,13,14,693325,2,,,,2270
2875665a5bace62f4e7dfb01060cd50a08637b86,1,Niels Basjes,2016-04-17 23:18:43+02:00,['4996990874d127f4908c9f55f7bc3a4334e2aed4'],3,34,37,693362,2,,,,2270
b30b9e7a3365f50aa6f4481705937c462914764d,0,Ryan Blue,2016-04-17 15:10:03-07:00,['2875665a5bace62f4e7dfb01060cd50a08637b86'],0,18,18,693380,1,,,,2270
a593cb03f93a9d449723c0e5d765bf2dcf55e132,0,Zoltan Farkas,2016-04-17 18:15:57-04:00,['a084fcdb5e79b1b8b86710f836ac6afce08c4a54'],1,0,1,693381,1,,,,2270
cc224aba71ae32f7f371139701bf8f1a9587ad38,0,Zoltan Farkas,2016-04-17 21:54:49-04:00,['a593cb03f93a9d449723c0e5d765bf2dcf55e132'],23,42,65,693446,1,,,,2270
21efba087b9fec37500b59e21a8bf5be546ea5a8,0,Zoltan Farkas,2016-04-17 23:30:10-04:00,['cc224aba71ae32f7f371139701bf8f1a9587ad38'],3,13,16,693462,1,1,1,1,2270
4c1463cba1bc268c2ccf2a506d27e6ee84030316,0,Ryan Blue,2016-04-20 09:57:39-07:00,['b30b9e7a3365f50aa6f4481705937c462914764d'],12,53,65,693527,5,0.576923077,0.576923077,1,2270
ea242ffa266502e9c5ba01a964fc346d217b5846,0,Niels Basjes,2016-04-25 22:54:58+02:00,['4c1463cba1bc268c2ccf2a506d27e6ee84030316'],0,17,17,693544,4,,,,2270
4cac7c8980791856c3fb7d3377d249cf8dd44b86,1,Niels Basjes,2016-04-28 22:46:07+02:00,['ea242ffa266502e9c5ba01a964fc346d217b5846'],12,31,43,693587,5,,,,2270
96ef881811ac4f8f4017319d5344bcd3164a7bc4,0,Niels Basjes,2016-04-28 22:57:38+02:00,['4cac7c8980791856c3fb7d3377d249cf8dd44b86'],1,26,27,693614,2,,,,2270
da22ffcba82efa50aa384b3acdf26561085e14f6,0,Niels Basjes,2016-05-02 17:28:11+02:00,['96ef881811ac4f8f4017319d5344bcd3164a7bc4'],3534,3567,7101,700715,349,,,,2271
4fe9b453333c2cf1a0c212fa469b26ba5cf589ed,1,Niels Basjes,2016-05-05 21:02:30+02:00,['da22ffcba82efa50aa384b3acdf26561085e14f6'],0,32,32,700747,13,,,,2276
7e10babe3eaad11c90cfed41553fc0c1ff90c16a,0,Ryan Blue,2016-05-08 15:26:37-07:00,['4fe9b453333c2cf1a0c212fa469b26ba5cf589ed'],4,25,29,700776,3,0.9375,0.9375,1,2276
02f623bfe62fd35914b41a8727e041de70635655,1,Ryan Blue,2016-05-08 15:59:17-07:00,['7e10babe3eaad11c90cfed41553fc0c1ff90c16a'],157,35,192,700968,7,,,,2276
f614e15e6255877d31bb4836ae880eceda90484e,1,Niels Basjes,2016-05-09 10:29:15+02:00,['02f623bfe62fd35914b41a8727e041de70635655'],4,26,30,700998,7,,,,2276
bedf2f21a05715c3c1aa3b151329f2368c43c965,1,Niels Basjes,2016-05-09 15:57:10+02:00,['f614e15e6255877d31bb4836ae880eceda90484e'],0,127,127,701125,3,,,,2279
51a260a27f3b2d6a046d2ed005eeff0dc7fa6e76,1,Niels Basjes,2016-05-11 00:16:39+02:00,['bedf2f21a05715c3c1aa3b151329f2368c43c965'],1,52,53,701178,3,,,,2280
fc34234028264bc15e779350204b78056d65810a,0,Niels Basjes,2016-05-11 14:48:00+02:00,['51a260a27f3b2d6a046d2ed005eeff0dc7fa6e76'],0,15,15,701193,1,,,,2280
f793202c4b87ec258326513568dd62353850f1d0,0,Ryan Blue,2016-05-14 13:44:56-07:00,['fc34234028264bc15e779350204b78056d65810a'],0,4,4,701197,2,0,0,1,2280
c22a1a102d78558e04249dad2cc086ca647fc2dd,1,Ryan Blue,2016-05-14 14:15:40-07:00,['f793202c4b87ec258326513568dd62353850f1d0'],11,1672,1683,702880,19,0.617940199,0.716500554,0.940199336,2285
48239bb2207b1d1adecb35035898efd064a146ab,0,Ryan Blue,2016-05-14 16:18:51-07:00,['c22a1a102d78558e04249dad2cc086ca647fc2dd'],0,12,12,702892,1,,,,2285
ae3b78f7df9acf255c1534599c697106cf0c5e6d,0,Ryan Blue,2016-05-14 16:46:39-07:00,['48239bb2207b1d1adecb35035898efd064a146ab'],0,12,12,702904,1,,,,2285
191badb80281498611ffcbc0e79b9b020a3d5096,0,Ryan Blue,2016-06-02 08:38:31-07:00,['ae3b78f7df9acf255c1534599c697106cf0c5e6d'],2,7,9,702913,2,0,1,0,2285
89a31b9236c92b2036b8f4ddd190183a18c630fc,1,Sean Busbey,2016-06-22 14:31:06-05:00,['191badb80281498611ffcbc0e79b9b020a3d5096'],74,525,599,703512,19,0.268595041,0.731404959,0.681818182,2285
0376544cf47600eb1a23f0dc098051fbc75ec00c,1,Ryan Blue,2016-06-28 09:14:02-07:00,['89a31b9236c92b2036b8f4ddd190183a18c630fc'],1,4,5,703517,2,1,1,0,2285
c3964345189581db8347bf0e038a0559d7a7626c,0,Zoltan Farkas,2016-07-11 11:28:23-04:00,['21efba087b9fec37500b59e21a8bf5be546ea5a8'],0,2,2,703519,1,,,,2285
f2c7b08c3395cd9065730c21bd1a6dc25a57dbf4,0,Dmitry Marakasov,2016-07-19 18:50:24+03:00,['0376544cf47600eb1a23f0dc098051fbc75ec00c'],0,3,3,703522,1,,,,2285
5259f26ecee6c268f0ddc86ef45104fe967f267a,0,Sean Busbey,2016-07-21 10:55:14-05:00,['0376544cf47600eb1a23f0dc098051fbc75ec00c'],12,121,133,703655,2,0.197802198,0.978021978,1,2285
e3c5da696d4762b287bfec0d133efec20ddb8b14,1,Ryan Blue,2016-07-24 15:21:00-07:00,['5259f26ecee6c268f0ddc86ef45104fe967f267a'],0,1252,1252,704907,14,0.860273973,1,0.890410959,2297
f6c044e56f9de7d3e34eeb1702c11fa4add04d84,0,Ryan Blue,2016-07-24 15:21:00-07:00,['e3c5da696d4762b287bfec0d133efec20ddb8b14'],9,228,237,705144,7,0.3,1,1,2298
f01f61b96dce5b402939fd81f9247313b4b8da0c,1,Ryan Blue,2016-08-28 15:50:21-07:00,['f6c044e56f9de7d3e34eeb1702c11fa4add04d84'],1,4,5,705149,2,,,,2298
be1639c44b16ddec8c54ecfca050364048daf896,0,Doug Cutting,2016-08-31 16:20:47-07:00,['f01f61b96dce5b402939fd81f9247313b4b8da0c'],9,90,99,705248,3,0.685185185,1,0.592592593,2298
9456db01859dd3619fb09a6d4205ab433b357b02,0,Doug Cutting,2016-08-31 16:45:21-07:00,['be1639c44b16ddec8c54ecfca050364048daf896'],1,1,2,705250,1,,,,2298
5d45505b85fb55d4d3753b695bd3afc3f15b0c30,0,Sean Busbey,2016-09-01 08:44:21-05:00,['9456db01859dd3619fb09a6d4205ab433b357b02'],1,1,2,705252,1,,,,2298
07c8f328603a4cacca087133ec3fb45337867aaf,0,Sean Busbey,2016-09-01 08:44:41-05:00,['5d45505b85fb55d4d3753b695bd3afc3f15b0c30'],90,9,99,705351,3,0.314814815,0,0.407407407,2298
973aa71a97e99293a99da965c973c20ce6e0a84a,1,Sean Busbey,2016-09-01 08:45:15-05:00,['07c8f328603a4cacca087133ec3fb45337867aaf'],9,90,99,705450,3,0.685185185,1,0.592592593,2298
9cfd33870092d5c16a35b523305950215d1feabe,0,Sean Busbey,2016-09-01 08:45:37-05:00,['973aa71a97e99293a99da965c973c20ce6e0a84a'],1,1,2,705452,1,,,,2298
749934f3cd13c413e293815e7f64848a688a6e60,0,Ryan Blue,2016-09-03 17:01:13-07:00,['9cfd33870092d5c16a35b523305950215d1feabe'],24,26,50,705502,3,,,,2298
fa0059c55a31813634188eb85e53b68e33644489,0,Ryan Blue,2016-09-03 17:18:35-07:00,['749934f3cd13c413e293815e7f64848a688a6e60'],8,26,34,705536,3,,,,2298
17cfe99d72121fad1ead76e8bf80729c5c7f7e6b,0,Ryan Blue,2016-09-03 17:25:48-07:00,['fa0059c55a31813634188eb85e53b68e33644489'],2,42,44,705580,3,1,1,1,2298
d7e12314832f1ef58f87d2f5106ac6b49c5a0be9,0,Ryan Blue,2016-09-03 17:58:34-07:00,['17cfe99d72121fad1ead76e8bf80729c5c7f7e6b'],3,48,51,705631,5,0.842105263,0.842105263,1,2298
30408a9c192c5f4eaaf42f01f0ffbfffd705aa57,0,Ryan Blue,2016-09-04 13:42:34-07:00,['d7e12314832f1ef58f87d2f5106ac6b49c5a0be9'],4,34,38,705669,2,,,,2298
c37d05e87957d7b46c32c5fadcb569dc9be44117,0,Ryan Blue,2016-09-04 13:56:01-07:00,['30408a9c192c5f4eaaf42f01f0ffbfffd705aa57'],1,3,4,705673,2,,,,2298
e6d2c4d864222290e6e24039365476c8eeb2ea1e,1,Ryan Blue,2016-09-04 14:04:04-07:00,['c37d05e87957d7b46c32c5fadcb569dc9be44117'],3,12,15,705688,2,1,1,1,2298
64f898c4322ec641379c9916007303acfe817f84,0,Ryan Blue,2016-09-04 14:37:09-07:00,['e6d2c4d864222290e6e24039365476c8eeb2ea1e'],14,23,37,705725,5,,,,2298
5acae5e10ee5d9d7d98b208e29a930f1e66f40ae,1,Ryan Blue,2016-09-04 15:19:01-07:00,['64f898c4322ec641379c9916007303acfe817f84'],1,29,30,705755,3,0.666666667,0.666666667,1,2298
4c992a58743b564fba831bb7349e3bc07fca4b8e,0,Ryan Blue,2016-09-08 08:59:07-07:00,['5acae5e10ee5d9d7d98b208e29a930f1e66f40ae'],3,7,10,705765,3,1,1,1,2298
832512edcd7591c238c35b5a479e15ac0709e4cb,0,Ryan Blue,2016-09-12 09:08:07-07:00,['4c992a58743b564fba831bb7349e3bc07fca4b8e'],1,32,33,705798,3,1,1,1,2298
33d495840c896b693b7f37b5ec786ac1acacd3b4,0,Ryan Blue,2016-09-13 10:18:30-07:00,['832512edcd7591c238c35b5a479e15ac0709e4cb'],61,24,85,705883,6,,,,2298
4810d48cf9643850587e98a1cde17215feb24655,0,Niels Basjes,2016-09-15 10:18:05+02:00,['33d495840c896b693b7f37b5ec786ac1acacd3b4'],16,29,45,705928,6,,,,2298
27cb9e271715b00ff5784164a9fb02de00e57203,0,Niels Basjes,2016-09-15 10:19:52+02:00,['4810d48cf9643850587e98a1cde17215feb24655'],1,39,40,705968,4,,,,2298
bafac8d9d80bfcf8207f42629862617442a01481,0,Zoltan Farkas,2016-09-17 10:15:29-04:00,"['c3964345189581db8347bf0e038a0559d7a7626c', '27cb9e271715b00ff5784164a9fb02de00e57203']",4111,8803,12914,718882,426,,,,2298
be33922c03bd229b885fb9d664b55ce308f6ffaf,0,Niels Basjes,2016-09-19 10:15:46+02:00,['27cb9e271715b00ff5784164a9fb02de00e57203'],6,28,34,718916,7,0,1,1,2298
fcd0a65f64984fc4b469760f44e07e1bdf8d1644,0,Doug Cutting,2016-09-19 16:11:44-07:00,['be33922c03bd229b885fb9d664b55ce308f6ffaf'],1,0,1,718917,1,,,,2298
ab25bf2037f98a2fc99179b8ee175d3d876f87b3,1,Doug Cutting,2016-09-26 14:24:26-07:00,['fcd0a65f64984fc4b469760f44e07e1bdf8d1644'],16,267,283,719200,6,,,,2302
1296ce9238a315b4323db351483dc66ec1a1afe3,0,Tom White,2016-09-27 15:50:56+01:00,['ab25bf2037f98a2fc99179b8ee175d3d876f87b3'],9,76,85,719285,4,1,1,1,2302
a92c8f5413e537c116e6b09021b7ed9944467e32,0,Doug Cutting,2016-09-27 07:56:42-07:00,['1296ce9238a315b4323db351483dc66ec1a1afe3'],0,32,32,719317,3,,,,2302
bc3fffb067c93ebece18a80f455ea4662a240e0b,0,Tom White,2016-09-27 16:05:15+01:00,['1296ce9238a315b4323db351483dc66ec1a1afe3'],6,88,94,719411,5,0.210526316,1,1,2303
2b1639ce5adc100760118ed6ea0cbb66786bec4d,0,Doug Cutting,2016-09-27 08:15:44-07:00,"['a92c8f5413e537c116e6b09021b7ed9944467e32', 'bc3fffb067c93ebece18a80f455ea4662a240e0b']",6,88,94,719505,5,,,,2303
e276aa5e40cf51e36b581750c135c9c3875cac84,1,Niels Basjes,2016-10-04 16:22:20+02:00,['2b1639ce5adc100760118ed6ea0cbb66786bec4d'],7,76,83,719588,3,0,0.854166667,0,2303
ef0e1a1a011298ee77f1112ec9709ef03c5035ab,0,Doug Cutting,2016-10-06 14:43:29-07:00,['e276aa5e40cf51e36b581750c135c9c3875cac84'],1,24,25,719613,3,0,1,1,2303
0a74e1e0fb45dae8785f204f17d05bd86d0a2d2b,1,Doug Cutting,2016-10-06 15:07:12-07:00,['ef0e1a1a011298ee77f1112ec9709ef03c5035ab'],5,19,24,719637,3,0,0,1,2303
8ecb2f130fdb1f730e1e8df667ab99bd31af15b2,0,Niels Basjes,2016-10-16 07:43:26+02:00,['0a74e1e0fb45dae8785f204f17d05bd86d0a2d2b'],1,186,187,719824,7,1,1,1,2305
420824c13381c4014d102c8e51e231c694ddacf2,1,Ryan Blue,2016-10-30 14:09:50-07:00,['8ecb2f130fdb1f730e1e8df667ab99bd31af15b2'],14,112,126,719950,5,0.688888889,0.866666667,0.866666667,2306
e2d1073bf5095af38fc6ed194d92fc82de225fc9,0,Tom White,2016-10-31 11:07:06+00:00,['420824c13381c4014d102c8e51e231c694ddacf2'],3,15,18,719968,2,0,1,1,2306
67bec06dbdc910856fdc33d149aece97c26a59b1,0,Niels Basjes,2016-11-01 21:32:30+01:00,['e2d1073bf5095af38fc6ed194d92fc82de225fc9'],8,130,138,720106,3,0,0.788888889,0.788888889,2306
b2cd78d549ad72cc1a1441562ea1bc5181116040,0,Tom White,2016-11-04 10:26:29+00:00,['67bec06dbdc910856fdc33d149aece97c26a59b1'],2,7,9,720115,3,,,,2306
bf7f3934c3f33bbd1d8923bf3c33e0fe45831ec5,0,Ryan Blue,2016-11-05 12:38:00-07:00,['b2cd78d549ad72cc1a1441562ea1bc5181116040'],0,10,10,720125,2,0,0,1,2306
ecc2adb31a1bcd61d073d87de8be18b2a91f5e6d,0,Ryan Blue,2016-11-05 12:42:25-07:00,['bf7f3934c3f33bbd1d8923bf3c33e0fe45831ec5'],1,22,23,720148,3,,,,2307
23de4d0133f04fd9d33b54a7c304f92b6802049e,1,Ryan Blue,2016-11-05 13:56:40-07:00,['ecc2adb31a1bcd61d073d87de8be18b2a91f5e6d'],2,12,14,720162,5,,,,2307
454db15472ee849e58220fb714638610eb869bac,0,Ryan Blue,2016-11-05 15:03:02-07:00,['23de4d0133f04fd9d33b54a7c304f92b6802049e'],1,3,4,720166,1,0,0,1,2307
7a398e0f373fcbe4e9fe5e068c3e720530f0a849,0,Ryan Blue,2016-11-05 15:03:02-07:00,['454db15472ee849e58220fb714638610eb869bac'],2,4,6,720172,2,,,,2307
cae491a6204b8167481fcc46e7f7eed061a44a82,0,Ryan Blue,2016-11-06 13:02:44-08:00,['7a398e0f373fcbe4e9fe5e068c3e720530f0a849'],1,2,3,720175,1,,,,2307
a53a4fd10072471aa7c8170499a10792e61e0d95,0,Niels Basjes,2016-11-30 21:50:13+01:00,['cae491a6204b8167481fcc46e7f7eed061a44a82'],9,81,90,720265,6,0,1,1,2308
152fa0954bb74e8e1e627751ccab55ada4f5b375,0,Niels Basjes,2016-12-17 11:57:56+01:00,['a53a4fd10072471aa7c8170499a10792e61e0d95'],9,113,122,720387,5,0.435483871,1,1,2308
d559a7e877777096b3a2ad656606a5a2a88a2df9,0,Tom White,2017-01-10 14:50:52+00:00,['152fa0954bb74e8e1e627751ccab55ada4f5b375'],2,4,6,720393,2,,,,2308
4f53fa933447865d7afb22c5d7d472d87fc2a4ae,0,Tom White,2017-01-10 14:58:11+00:00,['d559a7e877777096b3a2ad656606a5a2a88a2df9'],0,7,7,720400,2,1,1,1,2308
d9338a4cf008b445ea3efbe2523288d07162ec71,1,Tom White,2017-01-20 11:52:11+00:00,['4f53fa933447865d7afb22c5d7d472d87fc2a4ae'],4,45,49,720449,3,1,1,1,2308
68a5418bf4b71c15876347260fd1df2b17069c99,0,Zoltan Farkas,2017-01-25 11:15:33-05:00,"['bafac8d9d80bfcf8207f42629862617442a01481', 'd9338a4cf008b445ea3efbe2523288d07162ec71']",100,1353,1453,721902,47,,,,2308
f8c70a3a9fe5a410363544493a03dc2d10340cbd,0,Sean Busbey,2017-01-27 09:59:21-06:00,['d9338a4cf008b445ea3efbe2523288d07162ec71'],17,143,160,722062,4,0.150537634,0.731182796,1,2308
6bdc8f43e1ac2019e5a405c3edb4cf8fb795ccf8,0,Sean Busbey,2017-01-27 11:14:15-06:00,['f8c70a3a9fe5a410363544493a03dc2d10340cbd'],5,14,19,722081,7,1,1,1,2308
630e6bc0e789d5baa5bf84cecd124ec1bb6486d2,1,Sean Busbey,2017-01-28 00:04:48-06:00,['6bdc8f43e1ac2019e5a405c3edb4cf8fb795ccf8'],61,625,686,722767,6,0.595121951,0.982926829,0.787804878,2310
f5cbd7378142dc4d730a234059543b2b1e083c0b,0,Thiruvalluvan M G,2017-01-29 16:08:08+05:18,"['630e6bc0e789d5baa5bf84cecd124ec1bb6486d2', 'f2c7b08c3395cd9065730c21bd1a6dc25a57dbf4']",0,3,3,722770,1,,,,2310
3ab93ca43aa2dbcac3c7b50c201bd3e297dc493b,0,Thiruvalluvan M G,2017-01-29 16:50:00+05:18,['f5cbd7378142dc4d730a234059543b2b1e083c0b'],0,11,11,722781,2,0,0,1,2310
ad42bb36c96e7dda17cc04900e3dedfd7b8ea9e7,0,Thiruvalluvan M G,2017-01-29 18:11:20+05:18,['3ab93ca43aa2dbcac3c7b50c201bd3e297dc493b'],8,59,67,722848,3,0.588235294,1,1,2310
57983af07b751809141cfc3b6a0ed07f4ea5ae9d,0,Thiruvalluvan M G,2017-01-29 18:35:31+05:18,['ad42bb36c96e7dda17cc04900e3dedfd7b8ea9e7'],1,5,6,722854,2,,,,2310
cc31afef46b76eef0feb60c1e506db206d0df593,0,Thiruvalluvan M G,2017-01-29 18:51:58+05:18,['57983af07b751809141cfc3b6a0ed07f4ea5ae9d'],14,24,38,722892,3,1,1,0.5,2310
92b83f5a6ca234b2ac7e3323e3bd2e0b58c758f0,0,Victor Mota,2017-01-30 11:31:09-08:00,['cc31afef46b76eef0feb60c1e506db206d0df593'],2,2,4,722896,1,,,,2310
2ac78613d444332194669c2e9807d2ea55c674b6,0,Thiruvalluvan M G,2017-01-31 10:40:55+05:18,['92b83f5a6ca234b2ac7e3323e3bd2e0b58c758f0'],0,2,2,722898,1,,,,2310
a974984e6e7150b2c6e757bce9cc994b740094c1,0,Thiruvalluvan M G,2017-01-31 10:56:31+05:18,['2ac78613d444332194669c2e9807d2ea55c674b6'],4,18,22,722920,3,0,1,1,2310
94d15f4be1f4e25e5d6170ad32b5251ac14a4736,0,sacharya,2017-02-06 21:15:31-06:00,['a974984e6e7150b2c6e757bce9cc994b740094c1'],1,1,2,722922,1,,,,2310
c3384e4d016bac264f6577fff9543199a1fb1970,1,Zoltan Farkas,2017-02-07 13:36:56-05:00,['68a5418bf4b71c15876347260fd1df2b17069c99'],45,432,477,723399,6,0.274611399,0.274611399,0.694300518,2314
b735b4259d0512482477a2648b92d095a29cfa54,0,Gabor Szadovszky,2017-02-08 13:46:32+01:00,['94d15f4be1f4e25e5d6170ad32b5251ac14a4736'],35,30,65,723464,3,,,,2314
656b2bb525b087d3d65f93a58f566164616e1766,0,sacharya,2017-02-08 21:17:11-06:00,['b735b4259d0512482477a2648b92d095a29cfa54'],0,24,24,723488,2,,,,2315
30b5d4dfa98bf49e7165ca47e86fc55ad51fa2bd,0,Sean Busbey,2017-02-09 20:44:13-08:00,['656b2bb525b087d3d65f93a58f566164616e1766'],0,0,0,723488,0,,,,2315
29129abeecd58d387fd8f8986fba052a4868fc7c,0,Gabor Szadovszky,2017-02-10 12:40:44+01:00,['30b5d4dfa98bf49e7165ca47e86fc55ad51fa2bd'],1,3,4,723492,2,,,,2315
e9fd99ffa53e95ddbb1d136ddd6fabbfd2961f7f,0,sacharya,2017-02-14 17:40:37-06:00,['29129abeecd58d387fd8f8986fba052a4868fc7c'],5,13,18,723510,2,1,1,1,2315
ce36fffca8dd0bf8f5282041ba473e84193483c1,0,Thiruvalluvan M G,2017-02-18 07:58:50+05:18,['e9fd99ffa53e95ddbb1d136ddd6fabbfd2961f7f'],10,125,135,723645,8,0,0,1,2319
ec8514f711b739307d460b23bcb6eccc784f419a,0,Thiruvalluvan M G,2017-02-18 08:39:23+05:18,['ce36fffca8dd0bf8f5282041ba473e84193483c1'],35,13,48,723693,4,1,1,1,2319
230c7e75392d3c3dc2598f027603b4fc9d78d041,0,Thiruvalluvan M G,2017-02-19 21:35:01+05:18,['ec8514f711b739307d460b23bcb6eccc784f419a'],1,35,36,723729,6,0,0,1,2319
52d12bbc11a2990d5c4b49fd7a971341f4474922,0,Gabor Szadovszky,2017-02-20 09:01:25+01:00,['230c7e75392d3c3dc2598f027603b4fc9d78d041'],14,23,37,723766,2,0,1,1,2319
0e24e2ab452ff85641cad8e8b74da81890fb6d03,0,Thiruvalluvan M G,2017-02-21 06:58:01+05:18,['52d12bbc11a2990d5c4b49fd7a971341f4474922'],0,15,15,723781,1,,,,2320
5ec94b9aff523cd0b847af823243f6fb11cf23c4,0,Thiruvalluvan M G,2017-02-21 13:57:52+05:18,['0e24e2ab452ff85641cad8e8b74da81890fb6d03'],18,219,237,724018,6,0,0,0.97979798,2321
27355642317a0c87b4dc7350203a4197232d83b1,0,Thiruvalluvan M G,2017-02-21 14:32:39+05:18,['5ec94b9aff523cd0b847af823243f6fb11cf23c4'],13,25,38,724056,2,,,,2321
db6bb9d7a9f404e907d12a1380b65caac776b8a3,0,Thiruvalluvan M G,2017-02-28 09:11:04+05:18,['27355642317a0c87b4dc7350203a4197232d83b1'],1,25,26,724082,3,0.615384615,0.923076923,1,2322
43297652d0d08b680b5ab75060d3f7de54e5aa3e,0,Thiruvalluvan M G,2017-02-28 09:41:57+05:18,['db6bb9d7a9f404e907d12a1380b65caac776b8a3'],0,2,2,724084,1,,,,2322
e06b40163584f46cb77ddf4a85002a5f1b45b9d5,1,Sean Busbey,2017-02-28 08:42:51-06:00,['43297652d0d08b680b5ab75060d3f7de54e5aa3e'],25,1,26,724110,3,0.384615385,0.076923077,0,2322
37ce7f72478fcd3dd15637efe25b422f9631bacc,0,Sean Busbey,2017-02-28 08:45:01-06:00,['e06b40163584f46cb77ddf4a85002a5f1b45b9d5'],1,25,26,724136,3,0.615384615,0.923076923,1,2323
884fbabd3a07e6442dac9a43f34eb9ca0e5a0cbc,1,Zoltan Farkas,2017-04-02 11:28:00-04:00,['c3384e4d016bac264f6577fff9543199a1fb1970'],259,1439,1698,725834,54,0.400907716,0.677760968,0.903177005,2332
0550d2cce2793d1b810960a652f03fadf88b02ff,0,sacharya,2017-04-03 18:11:24-05:00,['37ce7f72478fcd3dd15637efe25b422f9631bacc'],21,165,186,726020,4,0,0.972727273,0.936363636,2332
4b3677c32b879e0e7f717eb95f9135ac654da760,0,sacharya,2017-04-04 17:20:10-05:00,['0550d2cce2793d1b810960a652f03fadf88b02ff'],51,728,779,726799,8,0.793456033,0.957055215,0.99591002,2334
874fff780dfe6d6ee8a3fa13f461110794b56f35,1,Zoltan Farkas,2017-04-06 13:39:48-04:00,['884fbabd3a07e6442dac9a43f34eb9ca0e5a0cbc'],154,525,679,727478,6,0.703947368,0.855263158,1,2339
64c482fdeeaeac9d19511f9e4ea58447dbfcb91e,0,Zoltan Farkas,2017-04-06 13:46:24-04:00,"['874fff780dfe6d6ee8a3fa13f461110794b56f35', '4b3677c32b879e0e7f717eb95f9135ac654da760']",73,895,968,728446,12,,,,2339
fc3d582617c027f6215f92f8bcdf1bd55f9310aa,0,sacharya,2017-04-27 19:54:50-05:00,['4b3677c32b879e0e7f717eb95f9135ac654da760'],1,0,1,728447,1,0,0,1,2339
17f2d75132021fafeca29edbdcade40df960fdc9,0,sacharya,2017-04-27 19:55:57-05:00,['fc3d582617c027f6215f92f8bcdf1bd55f9310aa'],1,0,1,728448,1,1,0,0,2339
ce1654df5e6b3c9e4b142678b61d36f19c9da359,0,Zoltan Farkas,2017-04-28 13:56:17-04:00,['64c482fdeeaeac9d19511f9e4ea58447dbfcb91e'],17,6,23,728471,3,,,,2339
60b78961ae0117492062370f5a9774b10ea48255,0,Zoltan Farkas,2017-04-29 09:22:34-04:00,"['ce1654df5e6b3c9e4b142678b61d36f19c9da359', '17f2d75132021fafeca29edbdcade40df960fdc9']",2,0,2,728473,2,,,,2339
ce0bad58393fb1d1d5a446062aca16f1a68d1260,0,Zoltan Farkas,2017-04-29 09:24:09-04:00,['60b78961ae0117492062370f5a9774b10ea48255'],3,3,6,728479,1,,,,2339
9132015450a2ad6f56cd582b393e8f1b8df573c9,0,Thiruvalluvan M G,2017-04-30 23:19:29+05:18,['ce0bad58393fb1d1d5a446062aca16f1a68d1260'],278,552,830,729309,11,0.90521327,1,1,2341
008cd8a209564a958e9065a5f6ff05526a41f4a5,0,GitHub,2017-04-30 16:41:36-04:00,"['ce0bad58393fb1d1d5a446062aca16f1a68d1260', '9132015450a2ad6f56cd582b393e8f1b8df573c9']",278,552,830,730139,11,,,,2341
53156fd1e475d976df2d55231cbe40b6e0f5dec8,1,Thiruvalluvan M G,2017-05-01 08:30:21+05:18,['008cd8a209564a958e9065a5f6ff05526a41f4a5'],0,29,29,730168,2,,,,2343
1f4ec52df822f5b5689cb15c8d005c224a271b6d,0,GitHub,2017-05-01 09:56:58-04:00,"['008cd8a209564a958e9065a5f6ff05526a41f4a5', '53156fd1e475d976df2d55231cbe40b6e0f5dec8']",0,29,29,730197,2,,,,2343
5795c5e505b817d6481eb1863068c0aa0ad329b9,0,Zoltan Farkas,2017-05-14 19:44:47-04:00,['1f4ec52df822f5b5689cb15c8d005c224a271b6d'],8,30,38,730235,4,,,,2343
9d76342ae8d7d017b0fb71c673bf5774b7bf6f61,0,Zoltan Farkas,2017-05-14 20:37:40-04:00,['5795c5e505b817d6481eb1863068c0aa0ad329b9'],9,3,12,730247,1,,,,2343
e0a3907a58956bf35e64193d0e26f644905c7a1a,0,Thiruvalluvan M G,2017-05-18 22:11:47+05:18,['9132015450a2ad6f56cd582b393e8f1b8df573c9'],0,29,29,730276,2,,,,2345
e1d331dcec98e820f9d5bce6d1f18415fd45b3d5,0,Thiruvalluvan M G,2017-05-18 22:11:47+05:18,['e0a3907a58956bf35e64193d0e26f644905c7a1a'],8,30,38,730314,4,,,,2345
2cb0638bcaa0147134feb644a293a0512c499741,0,Thiruvalluvan M G,2017-05-18 22:11:47+05:18,['e1d331dcec98e820f9d5bce6d1f18415fd45b3d5'],9,3,12,730326,1,,,,2345
81ca4dba8176c1a577205d12e1088880b7714947,0,Thiruvalluvan M G,2017-05-19 22:29:24+05:18,['2cb0638bcaa0147134feb644a293a0512c499741'],0,2,2,730328,1,,,,2345
7fcd5eb3382f13e4100a424dce43079ed9c7e07e,0,Thiruvalluvan M G,2017-05-19 22:29:47+05:18,"['9d76342ae8d7d017b0fb71c673bf5774b7bf6f61', '81ca4dba8176c1a577205d12e1088880b7714947']",0,2,2,730330,1,,,,2345
0b74bd5e7a37ccdb42918a0ab7768e9292df5dab,0,Thiruvalluvan M G,2017-05-22 07:44:50+05:18,['7fcd5eb3382f13e4100a424dce43079ed9c7e07e'],0,3,3,730333,2,,,,2345
c9f2c49241397fb3967bd281225f7cce353c32fc,0,Gabor Szadovszky,2017-05-25 09:41:06+02:00,['0b74bd5e7a37ccdb42918a0ab7768e9292df5dab'],2,66,68,730401,3,1,1,1,2345
ddfcabcee064d137fb0b9082e8c522ab900433c2,0,sacharya,2017-05-31 21:02:39-05:00,['c9f2c49241397fb3967bd281225f7cce353c32fc'],3,5,8,730409,1,,,,2345
8336f7ece1dc65b1dc17edff5dab9d9ad7aa9666,0,Gabor Szadovszky,2017-06-14 10:28:42+02:00,['ddfcabcee064d137fb0b9082e8c522ab900433c2'],15,63,78,730487,3,0.793103448,0.793103448,0.793103448,2345
c04a17c86078431d0ae33a3045520e3ec9d9787d,0,Gabor Szadovszky,2017-06-14 11:35:17+02:00,['8336f7ece1dc65b1dc17edff5dab9d9ad7aa9666'],3,36,39,730526,3,1,1,1,2345
edd8edda0659f802e203e36bcb9d8ec51d821f26,0,Gabor Szadovszky,2017-06-16 09:01:32+02:00,['c04a17c86078431d0ae33a3045520e3ec9d9787d'],2,45,47,730573,4,0.95,0.95,1,2345
528a1c8a997a0831e83b525173c6a70b08ee681a,0,Gabor Szadovszky,2017-06-16 09:18:40+02:00,['edd8edda0659f802e203e36bcb9d8ec51d821f26'],36,88,124,730697,9,0,0.30952381,0.880952381,2345
e5ae42e5703b8b193e5c2a61458e28a931c5774e,0,Doug Cutting,2017-06-22 09:54:44-07:00,['528a1c8a997a0831e83b525173c6a70b08ee681a'],1,3,4,730701,2,,,,2345
49ddc8938e3268166a41f100269b93e7e3da652e,0,GitHub,2017-06-23 18:23:42+01:00,['528a1c8a997a0831e83b525173c6a70b08ee681a'],1,1,2,730703,1,,,,2345
d145b8b6463a7b0d1821d7ebdd561524f9d80914,0,Doug Cutting,2017-06-28 10:33:15-07:00,['e5ae42e5703b8b193e5c2a61458e28a931c5774e'],1,0,1,730704,1,0,0,0,2345
9bff02fbfa5b5d8356aa8af57e250bac7a92ca7f,0,Gabor Szadovszky,2017-06-29 13:17:51+02:00,['d145b8b6463a7b0d1821d7ebdd561524f9d80914'],0,13,13,730717,2,,,,2345
21b369895cc6826b862605796bc35704bd142841,0,Gabor Szadovszky,2017-07-20 16:09:27+02:00,['9bff02fbfa5b5d8356aa8af57e250bac7a92ca7f'],3,4,7,730724,2,,,,2345
f72b620b9d700cf5f2febb0022079b69b9c9577e,0,Gabor Szadovszky,2017-07-21 10:42:49+02:00,['21b369895cc6826b862605796bc35704bd142841'],15,17,32,730756,10,,,,2345
b1233fd6468d4de546891cc12d19f905c55604cc,0,sacharya,2017-07-21 14:46:42-07:00,['f72b620b9d700cf5f2febb0022079b69b9c9577e'],5,3,8,730764,2,0,0,0,2345
3801888fa8c9dc96a1613e41cbc33800bc84f1b4,0,Gabor Szadovszky,2017-07-27 09:42:13+02:00,['b1233fd6468d4de546891cc12d19f905c55604cc'],1,3,4,730768,2,0,0,0,2345
224f75f64982fa65c56039e4c413b5d9c138800b,0,Gabor Szadovszky,2017-07-27 10:17:44+02:00,['3801888fa8c9dc96a1613e41cbc33800bc84f1b4'],8,11,19,730787,2,,,,2345
d0cce25208ad83a9fb6fcce825ae64881bdda420,0,Gabor Szadovszky,2017-07-27 10:17:49+02:00,['224f75f64982fa65c56039e4c413b5d9c138800b'],23,8,31,730818,2,0,0,0,2345
91d4cc03bbe84ca2aa0ed7f9094a20061b04a8a3,0,Gabor Szadovszky,2017-07-27 10:17:49+02:00,['d0cce25208ad83a9fb6fcce825ae64881bdda420'],12,5,17,730835,3,0,0,0,2345
14488e35bc31f299de8cd88bd6d1ac07576eaa3e,1,Gabor Szadovszky,2017-07-27 10:17:49+02:00,['91d4cc03bbe84ca2aa0ed7f9094a20061b04a8a3'],5,31,36,730871,3,1,1,1,2345
5e852265ea7197efe809a8c37ec6a0c34811d3ba,0,Robert Edmonds,2017-08-07 19:02:35-04:00,['14488e35bc31f299de8cd88bd6d1ac07576eaa3e'],2,13,15,730886,2,,,,2345
040a3be09216f188dff2b1bf1c23d21ecd4a265c,0,Gabor Szadovszky,2017-08-14 11:26:03+02:00,['14488e35bc31f299de8cd88bd6d1ac07576eaa3e'],2,4,6,730892,2,,,,2345
15651fc95e058d1b3cc165a70c367d1dc2bad8b7,1,Sean Busbey,2017-08-18 09:54:39-05:00,['040a3be09216f188dff2b1bf1c23d21ecd4a265c'],6,329,335,731227,3,0.969135802,0.969135802,0.895061728,2346
09c997e206615c4b23ab9ae2ab5f6a3d793e9afb,0,Sean Busbey,2017-08-18 09:54:59-05:00,['15651fc95e058d1b3cc165a70c367d1dc2bad8b7'],1,1,2,731229,1,,,,2346
189368ed485f5577528824dd88856991a51b6918,0,Sean Busbey,2017-09-01 06:36:58-07:00,['09c997e206615c4b23ab9ae2ab5f6a3d793e9afb'],3,2,5,731234,2,,,,2346
db8ed216eaf13c8f3862eb31152185f0504c4467,1,Gabor Szadovszky,2017-09-07 14:05:19+02:00,['189368ed485f5577528824dd88856991a51b6918'],345,1273,1618,732852,11,0.509615385,0.865384615,0.897435897,2353
50eebb8a0b96565641bb56a0f11e326b3f5cc50b,0,Gabor Szadovszky,2017-09-11 14:42:21+02:00,['db8ed216eaf13c8f3862eb31152185f0504c4467'],9,128,137,732989,5,0.887323944,0.887323944,0.887323944,2353
6f8c72773753079527e6c5bc37f6ed7842915a24,0,Gabor Szadovszky,2017-09-12 14:31:20+02:00,['50eebb8a0b96565641bb56a0f11e326b3f5cc50b'],169,29,198,733187,5,,,,2353
ce3f821a79d2a653a08da2ac26a14df9deccb7ec,0,Gabor Szadovszky,2017-09-12 15:16:52+02:00,['6f8c72773753079527e6c5bc37f6ed7842915a24'],9,9,18,733205,2,1,1,1,2353
9f3ceefda1ee31c388f535a8d3007f0749119447,0,Gabor Szadovszky,2017-09-12 15:21:29+02:00,['ce3f821a79d2a653a08da2ac26a14df9deccb7ec'],4,8,12,733217,2,1,1,1,2353
3af404efb31a1dc2fd720384ef9a3f7326c2d303,0,Nandor Kollar,2017-11-17 10:12:32+01:00,['9f3ceefda1ee31c388f535a8d3007f0749119447'],75,98,173,733390,7,0.117647059,1,0,2353
2df0775d2f368b326e3ac6442ce4850e3fe62edc,1,Nandor Kollar,2017-11-21 17:28:28+01:00,['3af404efb31a1dc2fd720384ef9a3f7326c2d303'],251,648,899,734289,11,0.416666667,0.899122807,0,2354
8466975290773f5e0d19a16d2c36c05d64ea5134,0,Purushotham Nayak,2017-11-30 15:10:38-05:00,['3af404efb31a1dc2fd720384ef9a3f7326c2d303'],7,74,81,734370,3,0.875,1,1,2354
7741c904ad05344f15998c9360950074b599544f,0,Flavien Raynaud,2017-12-05 09:02:02+00:00,[],0,3,3,734373,1,,,,2355
7bbbf92cd699dd82240caa395ee5f6136f22f2b0,0,Niels Basjes,2017-12-11 18:04:09+01:00,['2df0775d2f368b326e3ac6442ce4850e3fe62edc'],24,1,25,734398,1,,,,2355
b8c37b32256113bd64f35f0b97e673d74ef61db2,1,Niels Basjes,2017-12-13 10:13:48+01:00,['7bbbf92cd699dd82240caa395ee5f6136f22f2b0'],17,80,97,734495,12,0.25,0,1,2357
b84f64023c4a8e61d1274fc8a3e9c26acfb15c5b,0,Niels Basjes,2017-12-13 10:37:51+01:00,['b8c37b32256113bd64f35f0b97e673d74ef61db2'],6,42,48,734543,4,,,,2357
c412267d1d32ab10a929f189cb53cfb3cc619300,0,Miguel Martinez-Espronceda,2017-12-13 12:04:08+01:00,['7bbbf92cd699dd82240caa395ee5f6136f22f2b0'],1,30,31,734574,3,0.85,0.85,1,2357
03a3d6f9affa0e70858725bccb11756f975784fb,0,Niels Basjes,2017-12-13 14:20:23+01:00,['b84f64023c4a8e61d1274fc8a3e9c26acfb15c5b'],0,1,1,734575,1,,,,2357
164ee588cf822588df2c877f07ba03cb1a4a9482,0,Miguel Martinez-Espronceda,2017-12-14 10:12:47+01:00,['c412267d1d32ab10a929f189cb53cfb3cc619300'],1,4,5,734580,1,1,1,1,2357
ba11ddab1558f408905d0f730096e9963cb58f4c,0,Niels Basjes,2017-12-14 11:45:45+01:00,['03a3d6f9affa0e70858725bccb11756f975784fb'],0,89,89,734669,5,,,,2357
53a9af762acbfdc734a3cadf7d3c6d8736e1ec61,0,Miguel Martinez-Espronceda,2017-12-15 09:39:13+01:00,['164ee588cf822588df2c877f07ba03cb1a4a9482'],2,3,5,734674,2,,,,2357
ff5099c85ddb668af8a80560d706a8914f717356,0,Niels Basjes,2017-12-15 21:13:53+01:00,['ba11ddab1558f408905d0f730096e9963cb58f4c'],49,278,327,735001,8,1,0.869565217,1,2358
5040c6413b112665cd051c415f368f9a51426b97,0,Doug Cutting,2017-12-18 10:01:47-08:00,"['ff5099c85ddb668af8a80560d706a8914f717356', '53a9af762acbfdc734a3cadf7d3c6d8736e1ec61']",3,40,43,735044,5,,,,2358
1f9553a759d05b46e91e7380699b0c646fa21e86,0,Marius Van Niekerk,2017-12-19 10:01:44-05:00,['189368ed485f5577528824dd88856991a51b6918'],5,58,63,735107,2,1,1,0.230769231,2358
c7a3c960902abffcbd3e9caf084f0dc5fae9f7f0,0,Niels Basjes,2017-12-21 18:24:35+01:00,['5040c6413b112665cd051c415f368f9a51426b97'],55,57,112,735219,2,,,,2358
48b2abca0f3b7873519f3566eb46a49cb4d15db7,0,Niels Basjes,2017-12-22 10:37:10+01:00,['c7a3c960902abffcbd3e9caf084f0dc5fae9f7f0'],41,75,116,735335,6,,,,2358
41653853c66143796e0bac503064e24cc0353a87,0,Niels Basjes,2017-12-22 10:48:40+01:00,['48b2abca0f3b7873519f3566eb46a49cb4d15db7'],10,4,14,735349,4,,,,2358
a79b4366305d8796aeac60bb7b68bfc86fbde804,0,Niels Basjes,2017-12-22 10:51:53+01:00,['41653853c66143796e0bac503064e24cc0353a87'],0,5,5,735354,2,,,,2358
2e25d2edd2d06c665502afe788c197a63ce663fa,0,Niels Basjes,2017-12-22 12:04:36+01:00,['a79b4366305d8796aeac60bb7b68bfc86fbde804'],1,2,3,735357,1,,,,2358
ea23e37f8fe3bc87248d917dd539575103aacfef,0,Karl Wallner,2017-12-28 12:40:18+01:00,['2e25d2edd2d06c665502afe788c197a63ce663fa'],2,14,16,735373,1,0,0,1,2358
4b69cb20ad51d80b9404b505c4550dec1ba32df5,0,Niels Basjes,2017-12-29 14:42:14+01:00,['2e25d2edd2d06c665502afe788c197a63ce663fa'],64,66,130,735503,42,,,,2358
706d8ce0da8aa595061e880288682385cc77a0d0,0,Niels Basjes,2017-12-29 14:42:45+01:00,['4b69cb20ad51d80b9404b505c4550dec1ba32df5'],70,70,140,735643,6,,,,2358
42afa621c8a3ce6fc2d1de73b15db5f253e5990d,0,Niels Basjes,2017-12-29 14:43:23+01:00,['706d8ce0da8aa595061e880288682385cc77a0d0'],246,246,492,736135,60,,,,2358
8bc495109e8be07dc4fb502131414059cbf7e3ca,1,Niels Basjes,2017-12-29 17:39:18+01:00,['42afa621c8a3ce6fc2d1de73b15db5f253e5990d'],1286,1282,2568,738703,262,0.666666667,0,0.333333333,2358
2bbb99602e9e925058ead86fc8ac4e27055b05d6,0,Niels Basjes,2017-12-29 17:48:52+01:00,['8bc495109e8be07dc4fb502131414059cbf7e3ca'],518,518,1036,739739,517,,,,2358
61ab73837a56b5ce89b6a05d205b38b78d58cea9,0,Niels Basjes,2017-12-29 17:52:54+01:00,['2bbb99602e9e925058ead86fc8ac4e27055b05d6'],181,8,189,739928,45,,,,2358
6a4dd09b8d24c2c62420f2eaf90365789606b2e3,0,Niels Basjes,2017-12-29 18:02:55+01:00,['61ab73837a56b5ce89b6a05d205b38b78d58cea9'],54,51,105,740033,14,,,,2358
a3e05bee1c81b54eed8cb37b278652cf80666121,0,Niels Basjes,2017-12-29 18:03:32+01:00,['6a4dd09b8d24c2c62420f2eaf90365789606b2e3'],11,11,22,740055,9,,,,2358
a7a43da6de9bd44e57e057319127c64b2fca56a0,0,Niels Basjes,2018-01-02 10:57:06+01:00,['a3e05bee1c81b54eed8cb37b278652cf80666121'],0,10,10,740065,3,0.5,0.5,1,2358
673261c8656124cc58bee65fe5e8c779350779ee,0,Gabor Szadovszky,2018-01-04 17:12:25+01:00,['a7a43da6de9bd44e57e057319127c64b2fca56a0'],10,108,118,740183,4,0.590909091,1,1,2359
37bd84dc608c39f611c19557d4b2d1052d08db32,0,Gabor Szadovszky,2018-01-18 11:13:00+01:00,['673261c8656124cc58bee65fe5e8c779350779ee'],0,3,3,740186,2,,,,2359
7f9cbca12af13d4b8b5709edba2bae4d4a808102,0,Nandor Kollar,2018-01-23 10:48:17+01:00,['37bd84dc608c39f611c19557d4b2d1052d08db32'],6,33,39,740225,3,0.636363636,0.636363636,0,2359
027d196fd3f6f990977a4e86c1c07464506cabc3,0,Nandor Kollar,2018-01-26 10:49:42+01:00,['7f9cbca12af13d4b8b5709edba2bae4d4a808102'],2,75,77,740302,2,1,1,1,2359
51a92fea4ad197c6f8ddd91cefc1e35840c15c4a,0,Victor Mota,2018-01-30 11:37:12-08:00,['027d196fd3f6f990977a4e86c1c07464506cabc3'],62,301,363,740665,7,0.213836478,0.566037736,0.163522013,2359
e74ab07e9a37650baac391da3d0d7a9cb626ad85,0,Victor Mota,2018-01-30 11:37:12-08:00,['51a92fea4ad197c6f8ddd91cefc1e35840c15c4a'],58,71,129,740794,6,0,0,1,2360
517e617d450074ba00781e7b9ff90a6ff0b10ee7,0,Victor Mota,2018-01-30 11:37:12-08:00,['e74ab07e9a37650baac391da3d0d7a9cb626ad85'],29,38,67,740861,3,1,1,0,2360
fe7838a5865d9029b0711b763947f5684f221848,0,Flavien Raynaud,2018-02-08 21:41:11+00:00,['7741c904ad05344f15998c9360950074b599544f'],0,10,10,740871,1,,,,2361
797622f45d4b81af410a837a50a4fef20107e6a5,0,Flavien Raynaud,2018-02-08 21:41:24+00:00,['fe7838a5865d9029b0711b763947f5684f221848'],0,272,272,741143,4,0.565217391,0.888198758,1,2365
5931c2a47b63dae2615c207c166b46a84ab8e2dd,0,Flavien Raynaud,2018-02-08 21:41:24+00:00,['797622f45d4b81af410a837a50a4fef20107e6a5'],12,67,79,741222,2,0.066666667,1,1,2365
fa255e05f5f1dbb73568e034fc152f0ca1fcac38,1,Flavien Raynaud,2018-02-08 21:41:24+00:00,['5931c2a47b63dae2615c207c166b46a84ab8e2dd'],253,846,1099,742321,7,0.705882353,0.87254902,0.950980392,2369
f1220e804801f8030ba5b82dda7f384533fde720,0,Flavien Raynaud,2018-02-08 21:41:24+00:00,['fa255e05f5f1dbb73568e034fc152f0ca1fcac38'],0,24,24,742345,1,1,1,1,2369
221c5eb68f58216edf4e6b0cd35cd1791b0b0623,0,Flavien Raynaud,2018-02-08 21:41:24+00:00,['f1220e804801f8030ba5b82dda7f384533fde720'],55,67,122,742467,4,0,1,1,2369
22fbfcfa211c2027a56f5ba777aa277021471953,0,Flavien Raynaud,2018-02-08 21:41:24+00:00,['221c5eb68f58216edf4e6b0cd35cd1791b0b0623'],0,158,158,742625,4,0.397590361,0.493975904,0.698795181,2370
e66a1a6f28bccd347508791a6637874b82b61893,0,Flavien Raynaud,2018-02-08 21:41:24+00:00,['22fbfcfa211c2027a56f5ba777aa277021471953'],4,96,100,742725,1,0.287878788,1,1,2370
54ee76c81ad0da528ef1be1180f2534a416fa417,0,Flavien Raynaud,2018-02-08 21:41:24+00:00,['e66a1a6f28bccd347508791a6637874b82b61893'],176,251,427,743152,6,0.923076923,1,1,2370
8dcefe7c03e607e3c9702c45edc8b659b05c00ec,0,Flavien Raynaud,2018-02-08 21:41:24+00:00,['54ee76c81ad0da528ef1be1180f2534a416fa417'],4,8,12,743164,3,0,1,1,2370
9429baf3f23ad76fa9e3945d6e8292ea98ac249e,0,Flavien Raynaud,2018-02-08 21:41:24+00:00,['8dcefe7c03e607e3c9702c45edc8b659b05c00ec'],1,1,2,743166,1,,,,2370
0ece0eb724aba49429dc09686d62be1daadbe359,0,Flavien Raynaud,2018-02-08 21:41:24+00:00,['9429baf3f23ad76fa9e3945d6e8292ea98ac249e'],8,7,15,743181,3,0,0,0,2370
40abec87553d1611ec3b53d4ba7c12293f65bdf1,0,Flavien Raynaud,2018-02-08 21:41:24+00:00,['0ece0eb724aba49429dc09686d62be1daadbe359'],67,58,125,743306,4,0,0,0,2370
83400073bd5c8b736914a2ddfbd335f0c577882f,0,Flavien Raynaud,2018-02-08 21:41:24+00:00,['40abec87553d1611ec3b53d4ba7c12293f65bdf1'],11,57,68,743374,4,0.684210526,0.789473684,1,2370
e34c2d49f945e3cff3584adb819c2052f944bae5,0,Flavien Raynaud,2018-02-08 21:41:24+00:00,['83400073bd5c8b736914a2ddfbd335f0c577882f'],5,23,28,743402,3,1,1,1,2370
523eda87c3e3da315229d36334d5c869eba6619c,0,Flavien Raynaud,2018-02-08 21:41:24+00:00,['e34c2d49f945e3cff3584adb819c2052f944bae5'],230,278,508,743910,3,0.151515152,0.787878788,0,2371
d78d679835e5417f116421f1f72db49b12b0d362,0,Flavien Raynaud,2018-02-08 21:41:24+00:00,['523eda87c3e3da315229d36334d5c869eba6619c'],44,13,57,743967,3,0.052631579,0,0.526315789,2371
cc5eea15136ff9753f0c5b9ed0070b60c97d8868,0,Flavien Raynaud,2018-02-08 21:41:24+00:00,['d78d679835e5417f116421f1f72db49b12b0d362'],8,3,11,743978,2,,,,2371
c2ee6469bd02c79f1461c55c313e2142a67adfe1,0,Flavien Raynaud,2018-02-08 21:41:24+00:00,['cc5eea15136ff9753f0c5b9ed0070b60c97d8868'],249,141,390,744368,3,0.495495495,0,0,2371
259f6a4fa679b61471f31c97dbc94b1b9916ddb9,0,Flavien Raynaud,2018-02-08 21:41:24+00:00,['c2ee6469bd02c79f1461c55c313e2142a67adfe1'],20,53,73,744441,3,0.512820513,0.451282051,0.025641026,2371
0a6d68bc9e090851b51ca38a0bd74e64e18c8eb5,1,Flavien Raynaud,2018-02-08 21:41:24+00:00,['259f6a4fa679b61471f31c97dbc94b1b9916ddb9'],21,358,379,744820,8,0.254098361,0.270491803,1,2373
a0e36c2e9b92191edf3ff94b500d9eccb715faad,0,Flavien Raynaud,2018-02-08 21:41:24+00:00,['0a6d68bc9e090851b51ca38a0bd74e64e18c8eb5'],14,9,23,744843,1,0,0,0,2373
b62c916397a6df1355aff8602d8ca134b15df966,0,Flavien Raynaud,2018-02-08 21:41:24+00:00,['a0e36c2e9b92191edf3ff94b500d9eccb715faad'],33,37,70,744913,3,,,,2374
8a17afe6f0e84868fb379d0029707d64c308004d,0,Flavien Raynaud,2018-02-08 21:41:24+00:00,['b62c916397a6df1355aff8602d8ca134b15df966'],27,47,74,744987,4,0.333333333,0.416666667,1,2374
02ad50142a97450ffa77bc35220c1e659dcc03f1,0,Flavien Raynaud,2018-02-08 21:41:24+00:00,['8a17afe6f0e84868fb379d0029707d64c308004d'],1,0,1,744988,1,,,,2374
62ac5633d8aba271e9ba2d4e5463d3cd99970b44,0,Flavien Raynaud,2018-02-08 21:41:24+00:00,['02ad50142a97450ffa77bc35220c1e659dcc03f1'],4,8,12,745000,1,0,0,1,2374
279a6fbf713c1ce229cc234808aba495318adb68,0,Flavien Raynaud,2018-02-08 21:41:24+00:00,['62ac5633d8aba271e9ba2d4e5463d3cd99970b44'],0,304,304,745304,2,1,1,1,2375
b6cb9b690a09760fe44ed2223d6b1c0828335fe7,0,Flavien Raynaud,2018-02-08 21:41:24+00:00,['279a6fbf713c1ce229cc234808aba495318adb68'],69,197,266,745570,4,0.682835821,0.914179104,0.735074627,2375
44186646d97961897579895eebe02eaf77b70e32,0,Flavien Raynaud,2018-02-08 21:41:24+00:00,['b6cb9b690a09760fe44ed2223d6b1c0828335fe7'],12,64,76,745646,2,,,,2375
3ea6c20db3f526ead9aaaff5abe962d65b224247,0,Flavien Raynaud,2018-02-08 21:41:24+00:00,['44186646d97961897579895eebe02eaf77b70e32'],7,365,372,746018,4,0.359550562,0.584269663,0.584269663,2376
e09f5d65a587bfe3eb4ee3fc35ec82b2252fb727,0,Flavien Raynaud,2018-02-08 21:41:24+00:00,['3ea6c20db3f526ead9aaaff5abe962d65b224247'],9,14,23,746041,10,,,,2378
f22501fa9aceb870d461896c13b1f4ba2518016e,0,Flavien Raynaud,2018-02-08 21:41:24+00:00,['e09f5d65a587bfe3eb4ee3fc35ec82b2252fb727'],73,3,76,746117,1,0.489208633,0.798561151,0.661870504,2378
26815f5a1e47886098685ba2259287dfda63c3d0,0,Flavien Raynaud,2018-02-08 21:41:24+00:00,['f22501fa9aceb870d461896c13b1f4ba2518016e'],11,197,208,746325,4,0.947368421,1,1,2378
85bc4e30608a58e4b08b63b51f954b3d94db93ce,0,Flavien Raynaud,2018-02-08 21:41:24+00:00,['26815f5a1e47886098685ba2259287dfda63c3d0'],64,104,168,746493,7,0.392290249,0,0.14739229,2378
7490170775727108d4449711804c66fe45c2fdd9,0,Flavien Raynaud,2018-02-08 21:41:24+00:00,['85bc4e30608a58e4b08b63b51f954b3d94db93ce'],5,9,14,746507,2,,,,2378
cf3bf1a15e4dab9e55c9a799c1d01d1fb4b317b9,0,Flavien Raynaud,2018-02-08 21:41:24+00:00,['7490170775727108d4449711804c66fe45c2fdd9'],13,43,56,746563,5,0.514606742,0.802247191,0.986516854,2378
571076f0daeee559a6a5b5c9e3bb22533745ad51,0,Flavien Raynaud,2018-02-08 21:41:24+00:00,['cf3bf1a15e4dab9e55c9a799c1d01d1fb4b317b9'],12,8,20,746583,9,,,,2378
e2e61ddce119489314a8d1417e02e60d518a51c5,0,Flavien Raynaud,2018-02-08 21:41:24+00:00,['571076f0daeee559a6a5b5c9e3bb22533745ad51'],213,57,270,746853,4,0,0.024390244,0.073170732,2378
9dc1db0b6cb78f33e5000d07a28e9ef054eccdc8,1,Flavien Raynaud,2018-02-08 21:41:24+00:00,['e2e61ddce119489314a8d1417e02e60d518a51c5'],8,14,22,746875,3,0,0,0,2378
0a0a66ac802774afa0e499819798912a953e2209,0,Flavien Raynaud,2018-02-08 21:41:24+00:00,['9dc1db0b6cb78f33e5000d07a28e9ef054eccdc8'],108,33,141,747016,4,1,1,0,2378
90cff7e9db9d709ce39888f99f428c616c202071,0,Flavien Raynaud,2018-02-08 21:41:24+00:00,['0a0a66ac802774afa0e499819798912a953e2209'],178,125,303,747319,7,0.686098655,0.753363229,0.609865471,2378
402180deec70910a8b05ee551d3689a05ff104c7,0,Flavien Raynaud,2018-02-08 21:41:24+00:00,['90cff7e9db9d709ce39888f99f428c616c202071'],17,93,110,747429,3,0,0,0,2378
ef930cc621a33239bc0259c394cc0ec14acf50ce,0,Flavien Raynaud,2018-02-08 21:41:24+00:00,['402180deec70910a8b05ee551d3689a05ff104c7'],127,0,127,747556,1,0,0,0,2378
65e2658b6b88c6a95126fbb8e1d312b8507af5bf,0,Flavien Raynaud,2018-02-09 09:31:06+00:00,['ef930cc621a33239bc0259c394cc0ec14acf50ce'],120,150,270,747826,7,1,1,0.111111111,2378
229830bf8435d8410db28b9e711be14c786bfa4e,0,Flavien Raynaud,2018-02-13 09:00:09+00:00,['65e2658b6b88c6a95126fbb8e1d312b8507af5bf'],1,41,42,747868,3,0,1,1,2378
340ef224eb856c7c5472051b4e5f9b30ce628f03,1,Doug Cutting,2018-02-13 11:26:28-08:00,['027d196fd3f6f990977a4e86c1c07464506cabc3'],20,42,62,747930,4,0.777777778,0.777777778,1,2378
8d008e59b5ec1b724f23c58bfdd9021dd2e86f45,0,Flavien Raynaud,2018-02-15 08:59:29+00:00,['229830bf8435d8410db28b9e711be14c786bfa4e'],186,30,216,748146,4,0.181818182,0,0,2378
338f250b69af0e577304aed7ec24be7b16c38f7c,0,Niels Basjes,2018-02-21 21:07:15+01:00,['027d196fd3f6f990977a4e86c1c07464506cabc3'],6,17,23,748169,1,,,,2378
407c48afdb9cb31f477d64b966184a5766545e3c,0,GitHub,2018-02-21 16:51:05-08:00,"['338f250b69af0e577304aed7ec24be7b16c38f7c', '340ef224eb856c7c5472051b4e5f9b30ce628f03']",20,42,62,748231,4,,,,2378
9c200c993147dd3ac0b5f6ed94b558ad863d7c18,1,Doug Cutting,2018-02-22 11:23:50-08:00,['407c48afdb9cb31f477d64b966184a5766545e3c'],1,14,15,748246,4,,,,2378
41855262899d95da86375c41a3f68ec3501aaae3,0,Flavien Raynaud,2018-02-22 20:06:30+00:00,['8d008e59b5ec1b724f23c58bfdd9021dd2e86f45'],12,178,190,748436,3,0.38372093,1,1,2378
26894395cb480790488e0db283f8a503bd093909,1,Doug Cutting,2018-02-22 15:38:30-08:00,['9c200c993147dd3ac0b5f6ed94b558ad863d7c18'],12,21,33,748469,5,1,1,0,2378
61befce7e70aeb13ab5a8d6ff3c336d4f982b9a9,0,GitHub,2018-02-23 08:38:35-08:00,"['9c200c993147dd3ac0b5f6ed94b558ad863d7c18', '26894395cb480790488e0db283f8a503bd093909']",12,21,33,748502,5,,,,2378
2ecd3aa185db0c5c1f2464c415f359c19372261d,0,Flavien Raynaud,2018-02-23 18:42:22+00:00,['41855262899d95da86375c41a3f68ec3501aaae3'],5,5,10,748512,2,,,,2378
79c3bf587670e5c02befe5fdb80c6cbab281afba,0,Flavien Raynaud,2018-02-23 18:53:24+00:00,['2ecd3aa185db0c5c1f2464c415f359c19372261d'],3,6,9,748521,4,0,1,1,2378
8135e24c50953bd79e35ce9048ff164747e126dc,0,Flavien Raynaud,2018-02-23 18:57:19+00:00,['79c3bf587670e5c02befe5fdb80c6cbab281afba'],13,10,23,748544,2,0.591111111,0.391111111,0.008888889,2378
7dada2088efcd6ff5911d4c9c382242dfe8d247a,0,Flavien Raynaud,2018-02-23 19:15:44+00:00,['8135e24c50953bd79e35ce9048ff164747e126dc'],16,11,27,748571,2,,,,2378
94f12b85c3d269cdb510f8c0b843008469e4f826,0,Doug Cutting,2018-03-02 14:31:22-08:00,['61befce7e70aeb13ab5a8d6ff3c336d4f982b9a9'],2,9,11,748582,1,1,1,1,2378
86bc2604c6832a56f806121dcde5fd3e91c9d3a4,0,Max Englander,2018-03-09 01:28:30-05:00,['94f12b85c3d269cdb510f8c0b843008469e4f826'],1,26,27,748609,4,,,,2379
5c270dad2a281f4e70fb8c8a657d93a0cc72b7a8,0,GitHub,2018-03-14 09:44:12-07:00,"['94f12b85c3d269cdb510f8c0b843008469e4f826', '86bc2604c6832a56f806121dcde5fd3e91c9d3a4']",1,26,27,748636,4,,,,2379
df4e8be060503ead99980dbf1a5ac8e5337580be,0,Flavien Raynaud,2018-03-15 09:24:22+00:00,['7dada2088efcd6ff5911d4c9c382242dfe8d247a'],258,1,259,748895,2,0.654545455,0,0,2379
b2ca48b34575d9e380ca68def9325510f8cb9f4a,0,Flavien Raynaud,2018-03-15 10:19:08+00:00,['df4e8be060503ead99980dbf1a5ac8e5337580be'],3,9,12,748907,1,,,,2379
c2c9f25b9387a07c2057e7f7249d84466719caa7,1,Flavien Raynaud,2018-03-15 13:49:04+00:00,['b2ca48b34575d9e380ca68def9325510f8cb9f4a'],19,26,45,748952,3,0.306666667,0.613333333,0.995555556,2379
22f7ecf7ecfdd080ea62dc79f55ae0a5c2a7f7f5,0,Flavien Raynaud,2018-03-15 19:01:05+00:00,['c2c9f25b9387a07c2057e7f7249d84466719caa7'],41,77,118,749070,3,1,0,0.347826087,2379
c87fe929420eb205e4fa9dbca369779b0855174a,0,Flavien Raynaud,2018-03-15 20:20:23+00:00,['22f7ecf7ecfdd080ea62dc79f55ae0a5c2a7f7f5'],0,125,125,749195,1,0.074074074,1,0.543209877,2380
662faf90261978569d572d26fe3dfd803f3b40fd,0,Flavien Raynaud,2018-03-16 10:00:05+00:00,['c87fe929420eb205e4fa9dbca369779b0855174a'],0,4,4,749199,1,1,1,1,2380
10041413396de4100e4347594fa390c12e2d7cf3,0,Flavien Raynaud,2018-03-20 09:39:33+00:00,['662faf90261978569d572d26fe3dfd803f3b40fd'],17,16,33,749232,2,0,0,0,2380
df94ea75aa95a203a2d125587b667be75df1f067,0,Flavien Raynaud,2018-03-22 22:12:39+00:00,['10041413396de4100e4347594fa390c12e2d7cf3'],0,19,19,749251,1,0,0,1,2380
5932ae7d5bc519a9f96879868d1fa9c9753125b8,0,Flavien Raynaud,2018-03-22 22:31:37+00:00,['df94ea75aa95a203a2d125587b667be75df1f067'],0,2,2,749253,1,1,1,1,2380
5554c4aacc79da3faeccd48fd5069ed48fc1573b,0,Flavien Raynaud,2018-03-23 15:15:12+00:00,['5932ae7d5bc519a9f96879868d1fa9c9753125b8'],53,44,97,749350,3,1,0,1,2380
82a57ada210dcda48a206b3ab47cb320a3e96bec,0,Jeffrey Mullins,2018-03-28 16:25:16-04:00,['5c270dad2a281f4e70fb8c8a657d93a0cc72b7a8'],0,290,290,749640,2,0.072727273,1,1,2380
463fbc07df0072570789a2b36592def8f3611fd0,0,GitHub,2018-03-28 14:42:02-07:00,"['5c270dad2a281f4e70fb8c8a657d93a0cc72b7a8', '82a57ada210dcda48a206b3ab47cb320a3e96bec']",0,290,290,749930,2,,,,2380
33c165b32eb73547905362766991b46765fba686,0,Thiruvalluvan M G,2018-04-01 12:07:19+05:18,['94f12b85c3d269cdb510f8c0b843008469e4f826'],19,39,58,749988,7,0.714285714,0.714285714,1,2380
bdeb76be063268756ebe84983475a93ee3fdc59b,0,GitHub,2018-04-01 21:30:56+05:18,"['463fbc07df0072570789a2b36592def8f3611fd0', '49ddc8938e3268166a41f100269b93e7e3da652e']",1,1,2,749990,1,,,,2380
79e4e9d41002ee8677cbd64148a62a0035d5512e,0,GitHub,2018-04-01 23:27:13+05:18,"['bdeb76be063268756ebe84983475a93ee3fdc59b', '8466975290773f5e0d19a16d2c36c05d64ea5134']",7,74,81,750071,3,,,,2380
3b6658dfcfea85e140420de207fb29d583a6df0e,0,GitHub,2018-04-03 19:35:07+05:18,"['79e4e9d41002ee8677cbd64148a62a0035d5512e', '33c165b32eb73547905362766991b46765fba686']",19,39,58,750129,7,,,,2380
3dfff91438bde16b13cbb3e836ce30ca0c3fa24b,1,Flavien Raynaud,2018-04-06 16:07:13+01:00,['5554c4aacc79da3faeccd48fd5069ed48fc1573b'],290,569,859,750988,20,0.018181818,0.757575758,0.636363636,2386
1c22ea72c130d8443d93bb2aadb783771227d9f7,0,Flavien Raynaud,2018-04-06 17:50:39+01:00,['3dfff91438bde16b13cbb3e836ce30ca0c3fa24b'],57,357,414,751402,7,1,1,0.819672131,2389
f102828d975a7cbe21055d91feaa3a153acbd407,0,GitHub,2018-04-06 18:21:08+01:00,['1c22ea72c130d8443d93bb2aadb783771227d9f7'],19,252,271,751673,2,0,1,0.076271186,2390
b77f77cfc4ddf478c420bb1efddf4e5522c13c9f,0,Flavien Raynaud,2018-04-10 14:42:50+01:00,['f102828d975a7cbe21055d91feaa3a153acbd407'],0,8,8,751681,1,0,1,1,2390
db894142614f861575a70183d1b3e881b9e6e926,0,Flavien Raynaud,2018-04-12 11:11:02+01:00,['b77f77cfc4ddf478c420bb1efddf4e5522c13c9f'],5,59,64,751745,4,1,1,1,2390
e881e833d01a4cfc78431b8c98e8f5b7a9dbe3d3,0,Flavien Raynaud,2018-04-19 15:28:20+01:00,['db894142614f861575a70183d1b3e881b9e6e926'],109,310,419,752164,8,0,0.806451613,1,2390
39dd1ee447eae842f07a4e962ca3aa24cfecc985,0,GitHub,2018-04-25 11:20:58+01:00,['e881e833d01a4cfc78431b8c98e8f5b7a9dbe3d3'],7,207,214,752378,4,0.067226891,1,1,2390
cc55d86ce7eb966d6945a3a3ed1be5703bca0c0f,0,Flavien Raynaud,2018-05-01 17:03:46+01:00,['39dd1ee447eae842f07a4e962ca3aa24cfecc985'],99,452,551,752929,10,1,0,1,2390
0f25ed1f6a78ad0356f4d0202f570cf09ed3f601,1,Srujan Narkedamalli,2018-05-01 21:05:33-07:00,['3b6658dfcfea85e140420de207fb29d583a6df0e'],0,1324,1324,754253,12,0.701520913,0.965779468,0.8878327,2401
238714d324d1623f144ca09c0dfb10330a2ba2c4,1,Doug Cutting,2018-05-02 09:50:54-07:00,['3b6658dfcfea85e140420de207fb29d583a6df0e'],24,308,332,754585,13,0.60483871,0.709677419,0.637096774,2402
d5eeeed469fc7de4e141042da9b347d18c084b9e,0,GitHub,2018-05-02 10:41:46-07:00,"['238714d324d1623f144ca09c0dfb10330a2ba2c4', '0f25ed1f6a78ad0356f4d0202f570cf09ed3f601']",0,1324,1324,755909,12,,,,2402
738fa3b416c66a9620a034f278bb9290035437c8,1,Flavien Raynaud,2018-05-03 14:33:57+01:00,['cc55d86ce7eb966d6945a3a3ed1be5703bca0c0f'],29,193,222,756131,6,0.393258427,1,1,2402
d6e9c797cce2c1899f508108df7632205829a0ba,1,GitHub,2018-05-03 16:19:23+01:00,['738fa3b416c66a9620a034f278bb9290035437c8'],80,304,384,756515,3,0.390625,0.984375,1,2402
deca059d9c84fe896ca710229dd8b02fd2670ccd,0,GitHub,2018-05-04 18:53:53+01:00,['d6e9c797cce2c1899f508108df7632205829a0ba'],27,59,86,756601,2,0.185185185,0.148148148,0.888888889,2402
b71dcf24f252da5858bd95bfd4bd56402e3a458c,0,Nandor Kollar,2018-05-09 11:05:03+02:00,['d5eeeed469fc7de4e141042da9b347d18c084b9e'],1,1,2,756603,1,,,,2402
69b10236ca8a5d5511de54b727275b9cc3f73a0d,0,Flavien Raynaud,2018-05-16 14:48:37+01:00,['deca059d9c84fe896ca710229dd8b02fd2670ccd'],13,532,545,757148,3,,,,2402
c0c7a3404bb3f62bb268ee6897bd5f768a7632b2,0,Flavien Raynaud,2018-05-16 15:29:21+01:00,['69b10236ca8a5d5511de54b727275b9cc3f73a0d'],1,5,6,757154,1,,,,2402
faadbc4babf31d392d5ca24748ff87616b90deea,0,Flavien Raynaud,2018-05-16 15:30:41+01:00,['c0c7a3404bb3f62bb268ee6897bd5f768a7632b2'],1,1,2,757156,1,,,,2402
aee5164af0ea760d88c42cc0c4cbf9126b4e7066,0,Flavien Raynaud,2018-05-16 15:57:38+01:00,['faadbc4babf31d392d5ca24748ff87616b90deea'],56,56,112,757268,6,,,,2402
2baa51181e0e01540aaee79cb77692f60ef4d136,0,Flavien Raynaud,2018-05-16 16:03:07+01:00,['aee5164af0ea760d88c42cc0c4cbf9126b4e7066'],1,1,2,757270,1,,,,2402
18164dc87649265c85f1dca76efd4ac5d16424dc,0,Nandor Kollar,2018-05-17 17:29:47+02:00,['b71dcf24f252da5858bd95bfd4bd56402e3a458c'],3611,0,3611,760881,1,,,,2402
5dde3b50fff38cbe41022e879b5a7572e23d5c6c,0,GitHub,2018-05-21 13:58:03+01:00,['2baa51181e0e01540aaee79cb77692f60ef4d136'],9,11,20,760901,3,,,,2402
b4138d001ca282fbdd27bc4c26d8aa4d63adf039,0,Flavien Raynaud,2018-05-22 10:32:50+01:00,['5dde3b50fff38cbe41022e879b5a7572e23d5c6c'],4,19,23,760924,4,,,,2403
90a649855e0a6fb9bcb9661d9f245f39d0e47331,0,Antonio Uccio Verardi,2018-05-23 18:44:48+01:00,['b4138d001ca282fbdd27bc4c26d8aa4d63adf039'],1,1,2,760926,1,,,,2403
f1434f01c23b266f51b4cd367d8cdeff6177400b,0,Flavien Raynaud,2018-05-29 20:08:09+00:00,['90a649855e0a6fb9bcb9661d9f245f39d0e47331'],71,168,239,761165,9,0.764705882,0.901960784,1,2403
520d2ce458f550534b6121c35229484c641a17c4,0,GitHub,2018-05-29 21:39:57+00:00,['f1434f01c23b266f51b4cd367d8cdeff6177400b'],9,15,24,761189,1,0.75,1,1,2403
ef8878d63315f0ac2ec896bdbe57554b54e0bdeb,0,Flavien Raynaud,2018-05-29 22:48:18+01:00,['520d2ce458f550534b6121c35229484c641a17c4'],3,10,13,761202,3,,,,2403
04f82c23a362c4f53235b301c22947eac6440a0c,1,Flavien Raynaud,2018-06-02 08:11:48+01:00,['ef8878d63315f0ac2ec896bdbe57554b54e0bdeb'],6,36,42,761244,4,0.067873303,1,1,2403
c3a19a206e02a1b80700267c6b356c4cf741eeea,0,Flavien Raynaud,2018-06-02 08:12:55+01:00,['04f82c23a362c4f53235b301c22947eac6440a0c'],1,3,4,761248,2,,,,2403
c94cbb0f35c377c6b00ab020a65ac5968e3d72f7,0,Flavien Raynaud,2018-06-07 10:03:32+01:00,['c3a19a206e02a1b80700267c6b356c4cf741eeea'],1,10,11,761259,1,0,0,1,2403
d39cc236d34e8a693d05decf03f9ba0fbfdc092a,0,Flavien Raynaud,2018-06-07 10:47:54+01:00,['c94cbb0f35c377c6b00ab020a65ac5968e3d72f7'],1,7,8,761267,2,,,,2403
372b548deb5b0641491295a4e3f5f4bcd3ee740d,1,Flavien Raynaud,2018-06-15 10:07:54+01:00,['d39cc236d34e8a693d05decf03f9ba0fbfdc092a'],188,440,628,761895,8,0.914285714,0.364285714,0.928571429,2405
5e8168a25494b04ef0aeaf6421a033d7192f5625,0,nandorKollar,2018-06-15 13:44:21+02:00,['b71dcf24f252da5858bd95bfd4bd56402e3a458c'],1,1,2,761897,1,,,,2405
8b0df4cc8cd45204b744c8f5ecdb9a41f7bb0c72,0,Antonio Uccio Verardi,2018-06-17 13:31:47+01:00,['372b548deb5b0641491295a4e3f5f4bcd3ee740d'],3,3,6,761903,1,,,,2405
2660a8bd48ab31165cd8b75e29c21370259e95f7,0,Antonio Uccio Verardi,2018-06-17 13:32:16+01:00,['8b0df4cc8cd45204b744c8f5ecdb9a41f7bb0c72'],2,10,12,761915,3,,,,2405
6a036fc9fdb17dd75a2ad85520aab30c644632c1,1,Flavien Raynaud,2018-06-17 19:04:37+01:00,['2660a8bd48ab31165cd8b75e29c21370259e95f7'],225,234,459,762374,11,0.667655786,0.145400593,0.005934718,2405
3b822b637779f2269956549f186c9dca0e4155d8,0,Antonio Uccio Verardi,2018-06-17 23:30:22+01:00,['6a036fc9fdb17dd75a2ad85520aab30c644632c1'],1,5,6,762380,2,,,,2405
d053b29590cbafddbf0c40ea379d93907659fd75,0,Flavien Raynaud,2018-06-20 08:44:37+01:00,['3b822b637779f2269956549f186c9dca0e4155d8'],1,10,11,762391,2,,,,2405
1860c7072b3ffcdb47787861a8641063955b5f20,0,Flavien Raynaud,2018-06-23 17:18:18+01:00,['d053b29590cbafddbf0c40ea379d93907659fd75'],0,4,4,762395,1,,,,2405
c7942e475fc850aa727d0f13cb2b08edfbb7d226,0,GitHub,2018-06-24 10:02:57+01:00,['1860c7072b3ffcdb47787861a8641063955b5f20'],107,203,310,762705,9,0.592592593,1,0.962962963,2405
5f885281acb5a4c3e6bae402761036828c6736d4,0,GitHub,2018-06-29 13:53:01+02:00,"['5e8168a25494b04ef0aeaf6421a033d7192f5625', '18164dc87649265c85f1dca76efd4ac5d16424dc']",3611,0,3611,766316,1,,,,2405
57bc8c6ca029cb79ece7ab947742ad6f9a8a5610,1,Flavien Raynaud,2018-07-18 13:33:22+01:00,['c7942e475fc850aa727d0f13cb2b08edfbb7d226'],1,112,113,766429,1,0.456790123,0.456790123,1,2405
d8ad935132bc5a375f339c5aa18af36423628b59,0,GitHub,2018-07-29 21:53:05+05:18,"['5f885281acb5a4c3e6bae402761036828c6736d4', 'ea23e37f8fe3bc87248d917dd539575103aacfef']",2,14,16,766445,1,,,,2405
cf2f30336efe0ecc3debc7bede86fde6d23f7c79,0,Nandor Kollar,2018-07-30 10:17:29+02:00,['d8ad935132bc5a375f339c5aa18af36423628b59'],2,197,199,766644,8,0.75,1,1,2407
260d189af83cfb5e91f73594bdbda139aa8e4d6e,0,GitHub,2018-08-05 13:36:32+01:00,['57bc8c6ca029cb79ece7ab947742ad6f9a8a5610'],0,57,57,766701,4,1,1,1,2408
e5c6c55c324d8c971df0e06e2527485593349ae2,1,Flavien Raynaud,2018-08-06 13:18:21+01:00,['260d189af83cfb5e91f73594bdbda139aa8e4d6e'],112,300,412,767113,8,0.178807947,0.82781457,1,2408
e35eb562e22ca9d8229d90dfd27e003eae68c98b,0,GitHub,2018-08-06 13:19:03+01:00,['e5c6c55c324d8c971df0e06e2527485593349ae2'],14,54,68,767181,3,0.862068966,0.862068966,1,2408
cebc49855e1b9571550436704f48e6dc0c3da63a,1,Flavien Raynaud,2018-08-08 13:12:24+01:00,['e35eb562e22ca9d8229d90dfd27e003eae68c98b'],72,84,156,767337,8,0.944444444,1,1,2408
c3a97bbbbd115eaed220603151ffb3b520af7286,0,Flavien Raynaud,2018-08-11 10:15:56+01:00,['cebc49855e1b9571550436704f48e6dc0c3da63a'],3,13,16,767353,3,,,,2408
ff1e23f2bdb5bd49ecbd20817647b65badc1e681,0,da77a,2018-08-12 13:31:38+10:00,['cf2f30336efe0ecc3debc7bede86fde6d23f7c79'],1,21,22,767375,3,0,0,0,2408
390a85409006f829d4d3564c2308c06ade211920,0,William Matthews,2018-08-11 22:45:47-07:00,['cf2f30336efe0ecc3debc7bede86fde6d23f7c79'],78,397,475,767850,6,0.402173913,1,0.951086957,2408
67204b83ddbce6d62f48fdf9dbe073f0b9f3abf1,0,William Matthews,2018-08-19 23:24:28-07:00,['cf2f30336efe0ecc3debc7bede86fde6d23f7c79'],51,84,135,767985,3,0,1,1,2408
b41da12492f084c0da0af84e37711348f92f0898,0,William Matthews,2018-08-19 23:35:36-07:00,['67204b83ddbce6d62f48fdf9dbe073f0b9f3abf1'],18,297,315,768300,5,0.166666667,0.733333333,1,2408
9bf236546d47434b37bbc7cea9868dc5d88f728f,0,Flavien Raynaud,2018-09-29 10:26:48+01:00,['c3a97bbbbd115eaed220603151ffb3b520af7286'],1,20,21,768321,1,1,1,1,2408
e1c30a236a6b8244fc6e78e759c886617e9a05fb,0,Niels Basjes,2018-09-30 10:43:56+02:00,['cf2f30336efe0ecc3debc7bede86fde6d23f7c79'],0,11,11,768332,1,,,,2408
dc15bfcdbb210396f4cf0580e485e7776d77d383,0,da77a,2018-10-01 17:13:24+10:00,"['ff1e23f2bdb5bd49ecbd20817647b65badc1e681', 'e1c30a236a6b8244fc6e78e759c886617e9a05fb']",0,11,11,768343,1,,,,2408
e83caaf341af5368cf39a461bb5a15fe6108a21b,0,da77a,2018-10-01 18:27:15+10:00,['dc15bfcdbb210396f4cf0580e485e7776d77d383'],0,1,1,768344,1,,,,2408
b814cd0b76b63b08cd7772f43c3cb904a1dcbff5,1,nandorKollar,2018-10-01 12:04:50+02:00,['e1c30a236a6b8244fc6e78e759c886617e9a05fb'],78,1959,2037,770381,30,0.626882966,0.828505214,0.922363847,2414
3efbd4c1a5d81966ab5dd01b394c4b0a188bf871,0,GitHub,2018-10-02 21:13:28+05:18,"['b814cd0b76b63b08cd7772f43c3cb904a1dcbff5', 'b41da12492f084c0da0af84e37711348f92f0898']",68,380,448,770829,7,,,,2414
fec162dda29ecbf36579ebb61a666bd17ed9bb01,0,Thiruvalluvan M G,2018-10-02 21:34:23+05:18,['3efbd4c1a5d81966ab5dd01b394c4b0a188bf871'],0,1,1,770830,1,,,,2414
a943df760f6df520702a54e9b061e98250172c8e,0,GitHub,2018-10-02 21:35:15+05:18,"['3efbd4c1a5d81966ab5dd01b394c4b0a188bf871', 'fec162dda29ecbf36579ebb61a666bd17ed9bb01']",0,1,1,770831,1,,,,2414
355d51ba1e09ae73737160880ee2f07f953ceb6e,0,Thiruvalluvan M G,2018-10-02 22:11:19+05:18,['3efbd4c1a5d81966ab5dd01b394c4b0a188bf871'],4,15,19,770850,1,1,1,1,2414
4505b498da9800f2d3143d7487ee07e99177808b,0,GitHub,2018-10-02 22:42:18+05:18,"['a943df760f6df520702a54e9b061e98250172c8e', '355d51ba1e09ae73737160880ee2f07f953ceb6e']",4,15,19,770869,1,,,,2414
993cedea14eb511e6341e1ed2692112bd253e3d3,0,Thiruvalluvan M G,2018-10-02 22:47:07+05:18,['a943df760f6df520702a54e9b061e98250172c8e'],5,5,10,770879,1,,,,2414
389231ef31b02d444a73105ea4d6b5e0cbaac1d4,0,GitHub,2018-10-02 23:02:15+05:18,"['4505b498da9800f2d3143d7487ee07e99177808b', '390a85409006f829d4d3564c2308c06ade211920']",78,397,475,771354,6,,,,2414
f7f2f82cc511e334db25015d32a911addce0c064,0,da77a,2018-10-04 00:08:24+10:00,['e83caaf341af5368cf39a461bb5a15fe6108a21b'],2,4,6,771360,1,0,0,0,2414
c83acd5ac1443c9afd5ae06eb5e3a802c2b1eeee,0,da77a,2018-10-04 01:20:26+10:00,['f7f2f82cc511e334db25015d32a911addce0c064'],1,1,2,771362,1,,,,2414
2cf3c9909a970039b7f85af4c59bf5fd8068bc88,0,GitHub,2018-10-03 13:54:17-07:00,"['027d196fd3f6f990977a4e86c1c07464506cabc3', '389231ef31b02d444a73105ea4d6b5e0cbaac1d4']",3929,5132,9061,780423,96,,,,2414
377bc5848d066a851560fb921b6b77996f7d150f,0,Victor Mota,2018-10-03 13:56:53-07:00,['2cf3c9909a970039b7f85af4c59bf5fd8068bc88'],62,301,363,780786,7,0.213836478,0.566037736,0.163522013,2414
54a79769987d78384899062b59d413412c577de3,0,GitHub,2018-10-04 08:53:14+05:18,"['389231ef31b02d444a73105ea4d6b5e0cbaac1d4', 'c83acd5ac1443c9afd5ae06eb5e3a802c2b1eeee']",1,23,24,780810,3,,,,2414
11300013b967b2441f4deed81d5eadff69bdeeef,0,Flavien Raynaud,2018-10-04 10:27:42+02:00,['9bf236546d47434b37bbc7cea9868dc5d88f728f'],1,28,29,780839,1,0,1,1,2414
6b6ddfeb920f901d851ca12c6be3476ca00a58a9,0,GitHub,2018-10-05 17:04:05+05:18,"['54a79769987d78384899062b59d413412c577de3', '993cedea14eb511e6341e1ed2692112bd253e3d3']",5,5,10,780849,1,,,,2414
bbd41db436a8185e9c66cf3c59272d7a65f80ecc,0,Daniel Kulp,2018-10-05 10:05:54-04:00,['6b6ddfeb920f901d851ca12c6be3476ca00a58a9'],1,1,2,780851,1,,,,2414
a11bd49e86d50f5a840ab2cdfe4f6927bedb4f93,1,Doug Cutting,2018-10-05 08:49:56-07:00,['bbd41db436a8185e9c66cf3c59272d7a65f80ecc'],45,146,191,781042,8,,,,2415
fe683289225f4e8d689b64c2c4c80adee177d56b,0,Flavien Raynaud,2018-10-07 08:00:21+01:00,['11300013b967b2441f4deed81d5eadff69bdeeef'],1,5,6,781048,2,,,,2415
f20b566febaac5d68a16802350272d8517c3775f,0,Victor Mota,2018-10-10 13:42:42-07:00,['377bc5848d066a851560fb921b6b77996f7d150f'],62,75,137,781185,5,0,0,1,2415
a9f286b6d27d432ba2028495ec9ecd251382108f,0,Victor Mota,2018-10-10 13:44:51-07:00,['f20b566febaac5d68a16802350272d8517c3775f'],29,38,67,781252,3,1,1,0,2415
8be63e391e698f743c4c84ce5708fd472f62e469,0,Victor Mota,2018-10-10 14:13:21-07:00,"['a9f286b6d27d432ba2028495ec9ecd251382108f', '517e617d450074ba00781e7b9ff90a6ff0b10ee7']",0,0,0,781252,0,,,,2415
787be93d3cb1ef8f90e9e136cff6b0d2b66f4bcb,0,Victor Mota,2018-10-10 14:44:51-07:00,['8be63e391e698f743c4c84ce5708fd472f62e469'],22,59,81,781333,2,0,0,1,2415
089ee708b2b2deb0a3cb1f1c937288954c6a5700,0,GitHub,2018-10-14 23:43:43+05:18,"['a11bd49e86d50f5a840ab2cdfe4f6927bedb4f93', '787be93d3cb1ef8f90e9e136cff6b0d2b66f4bcb']",139,437,576,781909,8,,,,2415
47923b7bec3ed1326941ad4db5cef9babfd2d106,1,rstata,2018-10-14 14:15:00-07:00,['089ee708b2b2deb0a3cb1f1c937288954c6a5700'],1,1,2,781911,1,,,,2415
421a37058d305a9f723aba0912bca25f4dad30b8,0,GitHub,2018-10-15 07:29:54+05:18,"['089ee708b2b2deb0a3cb1f1c937288954c6a5700', '47923b7bec3ed1326941ad4db5cef9babfd2d106']",1,1,2,781913,1,,,,2415
563e79d0f2d64b64d5407f1c3b8b579b91f6446d,0,GitHub,2018-10-15 09:47:01+05:18,"['421a37058d305a9f723aba0912bca25f4dad30b8', '1f9553a759d05b46e91e7380699b0c646fa21e86']",5,58,63,781976,2,,,,2415
d695a50ae56398b7daeac40f9a0bbbd605b68731,1,GitHub,2018-10-23 17:03:33+02:00,['563e79d0f2d64b64d5407f1c3b8b579b91f6446d'],4,6,10,781986,1,,,,2415
b4ede4b116b24b5308e8419504a73e02b7f7e406,1,Doug Cutting,2018-10-23 10:57:25-07:00,['d695a50ae56398b7daeac40f9a0bbbd605b68731'],15,864,879,782865,18,0.297959184,0.526530612,0.893877551,2418
764c9322c136f0e3b8bd1e3f646d683321927e1a,0,Doug Cutting,2018-10-25 15:36:04-07:00,['b4ede4b116b24b5308e8419504a73e02b7f7e406'],1,10,11,782876,1,,,,2418
c9a62f3c2530f5c957edca4b5096f74c78b408a3,0,Fokko Driesprong,2018-10-28 10:50:00+01:00,['764c9322c136f0e3b8bd1e3f646d683321927e1a'],21,25,46,782922,3,1,1,1,2418
8d2a2ce10db3fdef107f834a0fe0c9297b043a94,0,Daniel Kulp,2018-10-30 09:29:34-04:00,['c9a62f3c2530f5c957edca4b5096f74c78b408a3'],10,68,78,783000,1,0,0,0.653061224,2418
9373b13259181895faab95b02d7576ad51260249,0,Daniel Kulp,2018-11-01 15:21:07-04:00,['8d2a2ce10db3fdef107f834a0fe0c9297b043a94'],6,6,12,783012,1,,,,2418
63d0524a75b753dc4cf679ef9e2f423a639196c6,0,Daniel Kulp,2018-11-01 15:38:44-04:00,['9373b13259181895faab95b02d7576ad51260249'],7,7,14,783026,1,,,,2418
0ebd2c8448979daf97b5d1605d85de6b36c434a9,0,Daniel Kulp,2018-11-01 15:58:07-04:00,['63d0524a75b753dc4cf679ef9e2f423a639196c6'],10,9,19,783045,2,,,,2418
46d2c8b5da67b87f8f427140cb6964c3125c84cb,0,Daniel Kulp,2018-11-01 16:29:15-04:00,['0ebd2c8448979daf97b5d1605d85de6b36c434a9'],0,1,1,783046,1,,,,2418
8e069398b7da9d74f3b46a430ea869470eb299da,0,Daniel Kulp,2018-11-01 16:41:07-04:00,['46d2c8b5da67b87f8f427140cb6964c3125c84cb'],0,1,1,783047,1,,,,2418
26700949812e39f6ddedc63c53f8cb5562fd7f15,0,Daniel Kulp,2018-11-01 17:34:32-04:00,['8e069398b7da9d74f3b46a430ea869470eb299da'],0,2,2,783049,2,0.5,0.5,0,2418
943411d20d27c9f11f9bd0311ae5c4438b7cc81c,0,Daniel Kulp,2018-11-02 06:01:45-04:00,['26700949812e39f6ddedc63c53f8cb5562fd7f15'],2,9,11,783060,1,0,0,1,2418
95234db14b7afca9593829f43c41a9851e08dcd7,1,Daniel Kulp,2018-11-02 15:15:27-04:00,['943411d20d27c9f11f9bd0311ae5c4438b7cc81c'],211,262,473,783533,42,0,0,1,2418
9855529f1af979ade479d5658bbe90917ae2734b,0,Daniel Kulp,2018-11-02 15:31:19-04:00,['95234db14b7afca9593829f43c41a9851e08dcd7'],27,72,99,783632,2,,,,2418
d799e1829a39ca0379f3e12d2e8cfdf5fcd26151,1,Daniel Kulp,2018-11-02 16:53:49-04:00,['9855529f1af979ade479d5658bbe90917ae2734b'],162,294,456,784088,17,1,1,0.717391304,2419
c78a3d5ea4e7e511ba9f6182157956db3e65e1a0,1,Daniel Kulp,2018-11-06 15:38:51-05:00,['d799e1829a39ca0379f3e12d2e8cfdf5fcd26151'],468,107,575,784663,18,1,1,0.885714286,2419
fd26721a5b333d59ebf37d39ed69fedcf33dc8dd,0,Daniel Kulp,2018-11-06 15:48:40-05:00,['c78a3d5ea4e7e511ba9f6182157956db3e65e1a0'],2,4,6,784669,1,0,1,1,2419
25032e10a86851bdabfa29b99885ccfc03c6667e,1,GitHub,2018-11-07 13:52:22+01:00,['fd26721a5b333d59ebf37d39ed69fedcf33dc8dd'],1888,1658,3546,788215,108,0.733333333,0.044444444,0,2422
9e60e59c53e006629a341822a39a22fa35f8270c,0,Fokko Driesprong,2018-11-07 16:10:01+01:00,['25032e10a86851bdabfa29b99885ccfc03c6667e'],56,17,73,788288,2,0,0,0.80952381,2422
a318a34d1f5f8146fb441c092c73b6170719e88a,0,Daniel Kulp,2018-11-07 12:04:27-05:00,['9e60e59c53e006629a341822a39a22fa35f8270c'],29,101,130,788418,3,0.266666667,1,1,2422
33f7177e66e04c4843676e3d7a9cf739ba812304,1,Fokko Driesprong,2018-11-07 22:50:10+01:00,['a318a34d1f5f8146fb441c092c73b6170719e88a'],22,302,324,788742,9,1,1,1,2424
6527d6d1d5081d38168b9ea14bd7d715c5e2af8d,0,Fokko Driesprong,2018-11-07 23:15:27+01:00,['33f7177e66e04c4843676e3d7a9cf739ba812304'],15,21,36,788778,1,0,1,1,2424
aa5860fc355d7d44c3d567fdb1fb2d20ad474cc0,0,Daniel Kulp,2018-11-08 10:03:43-05:00,['6527d6d1d5081d38168b9ea14bd7d715c5e2af8d'],3,14,17,788795,1,0.222222222,0.222222222,0,2424
c4386ad21f16b4fdd761eeb5ac4332f6221aac3f,1,Daniel Kulp,2018-11-08 11:01:51-05:00,['aa5860fc355d7d44c3d567fdb1fb2d20ad474cc0'],101,20,121,788916,7,0.936507937,0.873015873,0.317460317,2424
409dac80e9e042f308d097f64b496df122c58dd2,0,nandorKollar,2018-11-08 17:09:35+01:00,['c4386ad21f16b4fdd761eeb5ac4332f6221aac3f'],128,96,224,789140,3,1,0,0,2425
9623e50cb0da0140fd0427c04f6fa29b518e4034,0,Daniel Kulp,2018-11-08 11:12:28-05:00,['409dac80e9e042f308d097f64b496df122c58dd2'],1,29,30,789170,1,,,,2425
33bbf35c3dcc6a89b8ac6a8433ccf4bca21c7435,0,Daniel Kulp,2018-11-08 11:12:29-05:00,['9623e50cb0da0140fd0427c04f6fa29b518e4034'],6,6,12,789182,3,,,,2425
561a811f671a16139403741f707da6bfdf23997c,1,Daniel Kulp,2018-11-08 11:46:31-05:00,['33bbf35c3dcc6a89b8ac6a8433ccf4bca21c7435'],2,49,51,789233,2,0,0.972972973,0.972972973,2425
43dbc590a0ef1d954b505b14c1f48b66f10f650a,0,Daniel Kulp,2018-11-08 12:18:10-05:00,['561a811f671a16139403741f707da6bfdf23997c'],1,1,2,789235,1,,,,2425
c8ea9dac88b112d8bb282b9502cd463bf9249396,0,Daniel Kulp,2018-11-08 12:22:16-05:00,['43dbc590a0ef1d954b505b14c1f48b66f10f650a'],1,0,1,789236,1,1,0,0,2425
c6f772b408046c61b3269d8aecc5f1684bcad6fb,0,Daniel Kulp,2018-11-08 12:28:27-05:00,['c8ea9dac88b112d8bb282b9502cd463bf9249396'],9,93,102,789338,8,1,1,1,2428
207d4ff95d4dd48a4267e3d2577f86b304d0b11b,0,Daniel Kulp,2018-11-08 13:10:44-05:00,['c6f772b408046c61b3269d8aecc5f1684bcad6fb'],35,2,37,789375,1,0.666666667,0,0,2428
4fad66df0132c815a2a74c01704168d87f47009f,1,Daniel Kulp,2018-11-08 13:28:50-05:00,['207d4ff95d4dd48a4267e3d2577f86b304d0b11b'],0,21,21,789396,1,1,1,1,2428
ca1ef06d87424630f80ade31afcd8a1108dd5fed,1,Fokko Driesprong,2018-11-10 10:19:16+01:00,['4fad66df0132c815a2a74c01704168d87f47009f'],12,19,31,789427,2,1,1,1,2428
bb6a79ea79315037956c1665b83b8c80a3016c73,0,Fokko Driesprong,2018-11-11 20:03:05+01:00,['ca1ef06d87424630f80ade31afcd8a1108dd5fed'],63,21,84,789511,9,0.972222222,0.972222222,0,2428
07bd95a82f93458196d44f8e285435a865d3d70d,0,Fokko Driesprong,2018-11-12 12:18:09+01:00,['bb6a79ea79315037956c1665b83b8c80a3016c73'],94,57,151,789662,7,0.4,0,0,2428
6d4f6bef8d03f6bb5d452b65e68074f11892ccbf,0,nandorKollar,2018-11-12 13:47:34+01:00,['07bd95a82f93458196d44f8e285435a865d3d70d'],1,1,2,789664,1,,,,2428
4a8e814327be1f18b203784778f8b17d7f9da8b0,0,Thiruvalluvan M G,2018-11-12 18:15:39+05:18,['6d4f6bef8d03f6bb5d452b65e68074f11892ccbf'],79,400,479,790143,13,0.398809524,0.744047619,0.797619048,2428
9bf8b01243b059911dc042ed2b0ecf4729005cf0,0,GitHub,2018-11-12 16:22:04+01:00,['4a8e814327be1f18b203784778f8b17d7f9da8b0'],1,1,2,790145,1,,,,2428
a8875da2cff6bd08c4169f3126b1871f09c557e3,0,GitHub,2018-11-12 16:22:24+01:00,['9bf8b01243b059911dc042ed2b0ecf4729005cf0'],1,1,2,790147,1,,,,2428
88de5c89207d92f402cf250f2225bf7898af3c0c,0,GitHub,2018-11-12 23:19:26+05:18,['a8875da2cff6bd08c4169f3126b1871f09c557e3'],0,2,2,790149,1,,,,2428
40a5e6ae4cc4cd2d8065880c2641d640d1ca2f8f,0,Fokko Driesprong,2018-11-12 21:05:38+01:00,['88de5c89207d92f402cf250f2225bf7898af3c0c'],0,33,33,790182,1,0,1,1,2428
80632f46e75f447739c2fe91b13d26910bc527ac,0,GitHub,2018-11-13 07:25:05+05:18,['40a5e6ae4cc4cd2d8065880c2641d640d1ca2f8f'],9,80,89,790271,5,0.081967213,1,1,2428
71be8a456ffb250abb22f2a956ae0c6acd5104fa,0,GitHub,2018-11-13 09:50:05+01:00,['80632f46e75f447739c2fe91b13d26910bc527ac'],123,49,172,790443,4,0.2,0,0,2428
113ea7f4397fd9a24746d1ab7c8124d3c3bf6bac,1,Thiruvalluvan M G,2018-11-14 19:47:17+05:18,['71be8a456ffb250abb22f2a956ae0c6acd5104fa'],28,504,532,790975,10,0.060402685,0.553691275,0.979865772,2430
5bd23ddf297952d816166083f2f02b83abae344a,0,Daniel Kulp,2018-11-15 16:02:42-05:00,['113ea7f4397fd9a24746d1ab7c8124d3c3bf6bac'],52,91,143,791118,1,,,,2430
89f3503af2acc7a6ef52bde01d4961a7f49899a8,0,Thiruvalluvan M G,2018-11-16 14:08:18+05:18,['5bd23ddf297952d816166083f2f02b83abae344a'],1,2,3,791121,1,0,1,1,2430
a7fb39172ddec93e289127e1a58d7ea1e0b3a498,1,Daniel Kulp,2018-11-16 14:14:50-05:00,['89f3503af2acc7a6ef52bde01d4961a7f49899a8'],123,98,221,791342,6,1,0,0,2430
21098529e659743e551f2c35652d1a93c1528082,0,Daniel Kulp,2018-11-16 15:48:57-05:00,['a7fb39172ddec93e289127e1a58d7ea1e0b3a498'],21,82,103,791445,8,0.344827586,1,1,2430
fe6a2fc4c4178633d85d84657520967893f18aec,0,Fokko Driesprong,2018-11-18 18:05:41+01:00,['21098529e659743e551f2c35652d1a93c1528082'],6,9,15,791460,3,0,1,0.75,2430
e6a3126e6f23ddabf829e47efa27d4ec2f76f7e0,0,Fokko Driesprong,2018-11-18 18:30:03+01:00,['fe6a2fc4c4178633d85d84657520967893f18aec'],2,16,18,791478,2,0.777777778,1,1,2430
eb06f71861025c9261b5ad7a09cab0c46f2ac311,0,Fokko Driesprong,2018-11-20 10:27:33+01:00,['e6a3126e6f23ddabf829e47efa27d4ec2f76f7e0'],314,87,401,791879,15,0.741721854,0.523178808,0.509933775,2430
39500088491512aeccf3e9dc7b76d99b91a82436,1,Fokko Driesprong,2018-11-20 10:31:46+01:00,['eb06f71861025c9261b5ad7a09cab0c46f2ac311'],70,186,256,792135,5,0.057553957,0.805755396,0.582733813,2430
e04c2c291395339b8eb488a5e045500d366553b6,0,Fokko Driesprong,2018-11-20 11:58:53+01:00,['39500088491512aeccf3e9dc7b76d99b91a82436'],7,11,18,792153,1,0,1,1,2430
04d4423d4ee4f86e308fa761c6918223b55a6c5c,0,Daniel Kulp,2018-11-20 14:05:03-05:00,['e04c2c291395339b8eb488a5e045500d366553b6'],1,149,150,792303,9,0.288135593,0.966101695,0.898305085,2430
021c01c4c2756f793a4eee3a0f914c2c131823ac,0,Daniel Kulp,2018-11-20 14:44:26-05:00,['04d4423d4ee4f86e308fa761c6918223b55a6c5c'],16,187,203,792506,4,0.530769231,1,1,2430
01a347e996a20406b0bf13026dd375725c4efb7f,0,Daniel Kulp,2018-11-20 15:28:16-05:00,['021c01c4c2756f793a4eee3a0f914c2c131823ac'],4,55,59,792565,3,0.714285714,0.714285714,1,2431
619c6c0bf5b3440cfe80fff8b1c399b91d1d69db,0,Daniel Kulp,2018-11-20 20:03:02-05:00,['01a347e996a20406b0bf13026dd375725c4efb7f'],0,17,17,792582,1,,,,2431
f86da24a94fb0cd9d31f266c2639f4b82a3392b7,0,Daniel Kulp,2018-11-21 10:01:19-05:00,['619c6c0bf5b3440cfe80fff8b1c399b91d1d69db'],6,44,50,792632,4,0,0.4,0,2434
fe58b5a5d434c60bf3971a5dce4079bde33363d7,0,Daniel Kulp,2018-11-26 13:27:35-05:00,['f86da24a94fb0cd9d31f266c2639f4b82a3392b7'],34,678,712,793344,3,0.913043478,0.913043478,0.898550725,2436
008b19051b0de6b81a57b93442b341916a6acf8a,0,Daniel Kulp,2018-11-26 13:27:35-05:00,['fe58b5a5d434c60bf3971a5dce4079bde33363d7'],2,44,46,793390,2,,,,2436
2950a10eb9bbaf4f6a52f4692f6a151e00997cd1,0,Daniel Kulp,2018-11-26 13:27:35-05:00,['008b19051b0de6b81a57b93442b341916a6acf8a'],2,5,7,793397,1,,,,2436
563cfb76e846e307426afd020d3e8c59d29cc1df,0,Daniel Kulp,2018-11-26 13:28:02-05:00,['2950a10eb9bbaf4f6a52f4692f6a151e00997cd1'],1,1,2,793399,1,,,,2436
d3c726fce8d5dd9632960939858af134895ff3ea,0,Ismaël Mejía,2018-11-27 11:01:02+01:00,['563cfb76e846e307426afd020d3e8c59d29cc1df'],1,1,2,793401,1,,,,2436
39ec1a3f0addfce06869f705f7a17c03d538fe16,0,Ismaël Mejía,2018-11-27 11:56:58+01:00,['d3c726fce8d5dd9632960939858af134895ff3ea'],1,1,2,793403,1,,,,2436
6eb25603b96169bf8d77269176218c63c181e9f4,1,Thiruvalluvan M G,2018-11-28 08:50:45+05:18,['39ec1a3f0addfce06869f705f7a17c03d538fe16'],83,266,349,793752,7,0.090909091,0.247933884,0.545454545,2436
226013fdc311fca600af1207e756518e1b153de8,0,Daniel Kulp,2018-11-29 12:56:46-05:00,['6eb25603b96169bf8d77269176218c63c181e9f4'],8,37,45,793797,8,,,,2436
bbea1cec3ed6ffae631b4c0d975639a098687ab4,0,Daniel Kulp,2018-11-29 12:57:28-05:00,['226013fdc311fca600af1207e756518e1b153de8'],7,14,21,793818,2,1,1,1,2436
30a5725789d4cf77beec0e504371a766529ad7a0,0,Daniel Kulp,2018-11-29 12:58:17-05:00,['bbea1cec3ed6ffae631b4c0d975639a098687ab4'],21,21,42,793860,7,,,0,2436
e2e11cba3303b189f090383c931f0ae60c4fa952,0,Daniel Kulp,2018-11-29 14:33:48-05:00,['30a5725789d4cf77beec0e504371a766529ad7a0'],0,24,24,793884,3,1,1,1,2436
0beb39d78f6bdccb803b8c6eb58af02b2cc80429,0,Daniel Kulp,2018-11-29 14:42:19-05:00,['e2e11cba3303b189f090383c931f0ae60c4fa952'],1,120,121,794005,2,0.405405405,0.864864865,1,2437
734eddefb2b271cdbe5386f6f78a17d7a7a1809e,0,Daniel Kulp,2018-11-29 14:43:31-05:00,['0beb39d78f6bdccb803b8c6eb58af02b2cc80429'],0,17,17,794022,1,,,,2437
3e5cf4a94dd1f71e42a45c812f26a53c7b89e945,1,Daniel Kulp,2018-11-29 15:21:34-05:00,['734eddefb2b271cdbe5386f6f78a17d7a7a1809e'],3,35,38,794060,2,0,0.741935484,1,2437
6583fcce6d32627c55faf9e1df35cc353b8c8841,0,Daniel Kulp,2018-11-29 15:34:10-05:00,['3e5cf4a94dd1f71e42a45c812f26a53c7b89e945'],0,110,110,794170,3,0.644067797,0.813559322,1,2438
ee5008d9ed66f3237cf1304484b1d1e6836c8a33,0,Daniel Kulp,2018-11-29 15:45:15-05:00,['6583fcce6d32627c55faf9e1df35cc353b8c8841'],4,71,75,794245,2,0.543478261,1,0.543478261,2438
b07dfbcc6c37da1b730a4bd897d4cfdeabe63cdc,0,Daniel Kulp,2018-11-29 16:24:46-05:00,['ee5008d9ed66f3237cf1304484b1d1e6836c8a33'],31,171,202,794447,7,0.125,0.55,1,2440
b991c93ad1238a1b128213a5d7ef754ddeaa827e,0,Daniel Kulp,2018-11-29 16:26:23-05:00,['b07dfbcc6c37da1b730a4bd897d4cfdeabe63cdc'],8,227,235,794682,3,0.071942446,0.726618705,0.964028777,2441
54fc3f53807f7cfa535100d826e19e66aa5cad8e,0,Daniel Kulp,2018-11-29 16:28:26-05:00,['b991c93ad1238a1b128213a5d7ef754ddeaa827e'],0,11,11,794693,2,1,1,1,2441
d9d95871441b015353429585baa3ae821fdb39c1,0,Daniel Kulp,2018-12-03 14:48:03-05:00,['54fc3f53807f7cfa535100d826e19e66aa5cad8e'],1,49,50,794743,2,0.1,1,0.15,2442
b5bec5ca18901507f6fc01d635f10465fd3edcdf,1,Daniel Kulp,2018-12-03 15:13:34-05:00,['d9d95871441b015353429585baa3ae821fdb39c1'],5,14,19,794762,4,,,,2442
3299a9f0fa36367c7b5a68dc6bde633fe6e1ae1c,0,Daniel Kulp,2018-12-03 15:51:26-05:00,['b5bec5ca18901507f6fc01d635f10465fd3edcdf'],2,2,4,794766,1,,,,2442
c5aa1d6962ee16812d8d8c19b167b1b256e8002f,0,nandorKollar,2018-12-04 14:05:30+01:00,['3299a9f0fa36367c7b5a68dc6bde633fe6e1ae1c'],3,41,44,794810,3,1,1,1,2442
0e6df4837b1032a51e7fd85c95451781991d4856,0,Daniel Kulp,2018-12-04 11:54:01-05:00,['c5aa1d6962ee16812d8d8c19b167b1b256e8002f'],171,170,341,795151,20,0.666666667,0.666666667,0,2442
227940c6f768e8ccd5cb08edd23fef2821041010,0,Flavien Raynaud,2018-12-04 18:38:34+00:00,['fe683289225f4e8d689b64c2c4c80adee177d56b'],10,36,46,795197,4,0,0,1,2442
37ea68810359b0e2e57bb6aa31e95f4402206707,0,Flavien Raynaud,2018-12-04 20:42:24+00:00,['227940c6f768e8ccd5cb08edd23fef2821041010'],1,3,4,795201,2,,,,2442
b64081ee174e5b5aefcd93c3bc6c5aefe6acbf49,0,Fokko Driesprong,2018-12-05 08:11:54+01:00,['0e6df4837b1032a51e7fd85c95451781991d4856'],102,15,117,795318,4,1,0,0,2442
915cb4541fa0e7d3d96646947f449cbb4b75589a,0,Daniel Kulp,2018-12-05 09:52:38-05:00,['b64081ee174e5b5aefcd93c3bc6c5aefe6acbf49'],10,86,96,795414,6,0.621621622,0.864864865,0.810810811,2442
eaa7cca922b916ab7ad0fac6e109330197f8c75f,0,Daniel Kulp,2018-12-05 09:53:11-05:00,['915cb4541fa0e7d3d96646947f449cbb4b75589a'],1,1,2,795416,1,,,,2442
602a2c5b5258d5e1f0f60f71506b16801cbdf156,1,Daniel Kulp,2018-12-05 09:54:00-05:00,['eaa7cca922b916ab7ad0fac6e109330197f8c75f'],10,150,160,795576,3,0,0.207920792,0.465346535,2442
0530d6cebf1979ca65b6abb7b2df080460910127,1,Daniel Kulp,2018-12-05 11:19:07-05:00,['602a2c5b5258d5e1f0f60f71506b16801cbdf156'],27,92,119,795695,2,1,1,1,2442
de5d8ebc897407eda369cbbab1facff61076e780,0,Ismaël Mejía,2018-12-05 18:24:33+01:00,['0530d6cebf1979ca65b6abb7b2df080460910127'],3,3,6,795701,2,,,,2442
8c99b3409005feae42d24529687860220b7d25d6,0,Daniel Kulp,2018-12-07 12:08:13-05:00,['de5d8ebc897407eda369cbbab1facff61076e780'],7,24,31,795732,1,1,1,1,2442
6eda0b41796d5d039ace7720bbd8066f0b7835e5,0,Daniel Kulp,2018-12-10 12:48:18-05:00,['8c99b3409005feae42d24529687860220b7d25d6'],2,6,8,795740,1,0,1,1,2442
eaaf263372229f9aad9970f54767e043b1e104dc,0,Daniel Kulp,2018-12-10 13:05:59-05:00,['6eda0b41796d5d039ace7720bbd8066f0b7835e5'],61,16,77,795817,2,0,0,0.413793103,2442
b9409b3bee5a45e8ffc67430e6a878be564569ce,0,Daniel Kulp,2018-12-10 13:31:23-05:00,['eaaf263372229f9aad9970f54767e043b1e104dc'],20,14,34,795851,2,,,,2442
b597c3ab93ef1c6a37a9c1fa3584d86d20723784,0,Daniel Kulp,2018-12-10 13:56:34-05:00,['b9409b3bee5a45e8ffc67430e6a878be564569ce'],20,233,253,796104,4,0.112903226,0.85483871,1,2444
7fbedbb8923bb203409f5d5576a38ac70aba9f4b,1,Daniel Kulp,2018-12-10 14:16:14-05:00,['b597c3ab93ef1c6a37a9c1fa3584d86d20723784'],35,68,103,796207,7,0.083333333,1,0.916666667,2444
4b1ab225fef8e8f66cb95d6605bdd4fd568929ed,0,GitHub,2018-12-10 14:22:16-05:00,"['7fbedbb8923bb203409f5d5576a38ac70aba9f4b', '5e852265ea7197efe809a8c37ec6a0c34811d3ba']",2,13,15,796222,2,,,,2444
e37a52d909b913059ba4493f509ede7d46dcf0e1,0,Daniel Kulp,2018-12-10 14:47:58-05:00,['4b1ab225fef8e8f66cb95d6605bdd4fd568929ed'],13,238,251,796473,2,0.10619469,0.424778761,1,2445
269d0ff7d3025cf3370023e353a373916dd67433,0,Daniel Kulp,2018-12-10 15:14:43-05:00,['e37a52d909b913059ba4493f509ede7d46dcf0e1'],2,18,20,796493,3,1,1,1,2445
4d07366aae24b6701c304dd5124b7c5bae5ea6ab,0,Daniel Kulp,2018-12-10 15:16:04-05:00,['269d0ff7d3025cf3370023e353a373916dd67433'],1,2,3,796496,1,,,,2445
c8436998ae107996c1c48c9b7efcbb98b8b92930,0,Daniel Kulp,2018-12-10 15:49:37-05:00,['4d07366aae24b6701c304dd5124b7c5bae5ea6ab'],3,3,6,796502,1,,,,2445
6971ac739aee41bfd62dcd4031f6c848bb0b2d4e,0,Daniel Kulp,2018-12-10 15:53:56-05:00,['c8436998ae107996c1c48c9b7efcbb98b8b92930'],0,44,44,796546,1,,,,2445
67dbda933bb2e1286a28fd832ea4316d34906005,0,Daniel Kulp,2018-12-10 15:58:13-05:00,['6971ac739aee41bfd62dcd4031f6c848bb0b2d4e'],0,0,0,796546,8,,,,2445
5432cd09da963bb72796729dafa2bf5954d57772,0,Daniel Kulp,2018-12-10 15:58:13-05:00,['67dbda933bb2e1286a28fd832ea4316d34906005'],12,12,24,796570,1,0.0375,1,0.5,2445
e65411f5cce2d58588fbb96a366560f6e6803dab,0,Daniel Kulp,2018-12-10 16:53:58-05:00,['5432cd09da963bb72796729dafa2bf5954d57772'],17,17,34,796604,5,,,,2445
595643cba16a2b4d7be68d46ee8f79c4e380cbf7,0,Daniel Kulp,2018-12-11 13:10:29-05:00,['e65411f5cce2d58588fbb96a366560f6e6803dab'],13,58,71,796675,4,1,1,0.666666667,2445
d55f5e152c288a2037d65d15a7169d76aa9be2be,0,Daniel Kulp,2018-12-11 13:13:31-05:00,['595643cba16a2b4d7be68d46ee8f79c4e380cbf7'],1,120,121,796796,2,0,0.946428571,1,2446
254ee8ff595c6c52580128aec9355394f96382d5,0,Daniel Kulp,2018-12-11 13:14:29-05:00,['d55f5e152c288a2037d65d15a7169d76aa9be2be'],12,7,19,796815,1,1,1,0,2446
475904893244b23e612073f9f8cf476380cec812,0,Daniel Kulp,2018-12-11 13:16:57-05:00,['254ee8ff595c6c52580128aec9355394f96382d5'],3,20,23,796838,2,,,,2446
beef86697a0dbd09d4d99a735f8a5afe37e5d976,0,Daniel Kulp,2018-12-11 13:28:03-05:00,['475904893244b23e612073f9f8cf476380cec812'],8,46,54,796892,2,0.838709677,0.838709677,0.774193548,2446
7ed38d7c7e150987ef8bf035196576fc158e03eb,1,Daniel Kulp,2018-12-11 14:07:08-05:00,['beef86697a0dbd09d4d99a735f8a5afe37e5d976'],92,1153,1245,798137,37,0.786743516,0.893371758,0.780979827,2464
726c7bf18300ece22199b37b2c4b2b1c4cc9ffc8,0,Daniel Kulp,2018-12-11 14:13:54-05:00,['7ed38d7c7e150987ef8bf035196576fc158e03eb'],1,1,2,798139,1,,,,2464
4b498e5c76569dfa7acb7e62f175075db3d314e2,0,Daniel Kulp,2018-12-11 15:04:42-05:00,['726c7bf18300ece22199b37b2c4b2b1c4cc9ffc8'],0,386,386,798525,6,0.62745098,1,1,2470
67014e575a96a1172b1601254ab7bfab19bceb88,0,Daniel Kulp,2018-12-11 15:07:56-05:00,['4b498e5c76569dfa7acb7e62f175075db3d314e2'],14,2,16,798541,3,,,,2470
c011d76436a1c11c614a133ae06abbc19baf2436,1,Daniel Kulp,2018-12-11 15:33:26-05:00,['67014e575a96a1172b1601254ab7bfab19bceb88'],1,11,12,798553,2,1,1,1,2470
35d21089685d707b47f7e3a7f41dc971230e434f,0,Flavien Raynaud,2018-12-16 11:22:12+00:00,['37ea68810359b0e2e57bb6aa31e95f4402206707'],41,41,82,798635,10,,,,2470
10ea827d83bab40e7a0b7f33258575c693d4ec84,0,GitHub,2018-12-16 11:23:43+00:00,['35d21089685d707b47f7e3a7f41dc971230e434f'],0,251,251,798886,3,0.479591837,1,1,2472
2fc8d9d12a25bb51865688fdefde933643adcdf5,0,Flavien Raynaud,2018-12-18 18:00:42+00:00,['10ea827d83bab40e7a0b7f33258575c693d4ec84'],0,113,113,798999,4,0.43902439,1,1,2472
29f318b26332c0f23a5d60dd1ab2ab76713136ce,0,Flavien Raynaud,2018-12-19 12:12:23+00:00,['2fc8d9d12a25bb51865688fdefde933643adcdf5'],2,6,8,799007,2,,,,2472
34aa0fa4c674c281c1060515dec0a72b1c973778,0,Daniel Kulp,2018-12-20 15:54:49-05:00,['c011d76436a1c11c614a133ae06abbc19baf2436'],33,42,75,799082,5,0,1,1,2472
a262a107ddd403e3ac5a773c735110a6565104de,1,Daniel Kulp,2018-12-20 15:55:21-05:00,['34aa0fa4c674c281c1060515dec0a72b1c973778'],6,95,101,799183,3,1,1,0.666666667,2473
52a53e9520d7657bd237cae3e92e3ed015c71811,0,GitHub,2018-12-23 13:23:46+05:18,['a262a107ddd403e3ac5a773c735110a6565104de'],46,8,54,799237,2,0.161290323,0.161290323,0.225806452,2473
29e1d662bafc66499e198a6af9b0920aa79695e5,0,GitHub,2018-12-23 17:11:27+05:18,['52a53e9520d7657bd237cae3e92e3ed015c71811'],9,9,18,799255,4,,,,2473
9492d6c38a3ef6206ec0a82192a08a493864fe6a,0,Flavien Raynaud,2018-12-24 12:12:02+00:00,['29f318b26332c0f23a5d60dd1ab2ab76713136ce'],2,11,13,799268,1,0,1,1,2473
1afc3d95b712de77c7740e7e12cd62dc06d50e50,0,Flavien Raynaud,2018-12-24 12:13:16+00:00,['9492d6c38a3ef6206ec0a82192a08a493864fe6a'],1,5,6,799274,2,,,,2473
d2f92b445cf07683b7aa9afd2f69e2b23a033e6b,0,GitHub,2018-12-25 07:28:02+05:18,['29e1d662bafc66499e198a6af9b0920aa79695e5'],23,46,69,799343,3,0.266666667,1,0.933333333,2473
6599fb29fb0ba8a2c3dba0b0e39feb31cfe2111c,0,Ismaël Mejía,2018-12-26 18:16:50+01:00,['d2f92b445cf07683b7aa9afd2f69e2b23a033e6b'],52,7,59,799402,6,,,,2473
7182fda6eb3f4b8aa43016ac8c32692103b0cb9e,0,Ismaël Mejía,2018-12-26 18:16:50+01:00,['6599fb29fb0ba8a2c3dba0b0e39feb31cfe2111c'],2,2,4,799406,2,,,,2473
4eb2bed0bbbf7c25d9a25ab06eb368348771e918,0,Ismaël Mejía,2018-12-26 18:16:50+01:00,['7182fda6eb3f4b8aa43016ac8c32692103b0cb9e'],6,6,12,799418,1,,,,2473
b1249403bc0e9e62af8e87f61bb4a33e44007b4d,0,Ismaël Mejía,2018-12-26 18:21:34+01:00,['4eb2bed0bbbf7c25d9a25ab06eb368348771e918'],19,15,34,799452,3,1,1,1,2473
a9ec22cce3c5d0bbde162dca99a96adf4584b429,0,Ismaël Mejía,2018-12-26 18:31:58+01:00,['b1249403bc0e9e62af8e87f61bb4a33e44007b4d'],8,10,18,799470,2,,,,2473
fab3d4051c6bf5cacf6bd80895a72332ae5f362f,0,Ismaël Mejía,2018-12-26 18:31:58+01:00,['a9ec22cce3c5d0bbde162dca99a96adf4584b429'],4,4,8,799478,1,,,,2473
35dd8813b6366b68ad302c38217ff5a7e26553d2,0,GitHub,2018-12-28 21:30:42+05:18,['fab3d4051c6bf5cacf6bd80895a72332ae5f362f'],1,1,2,799480,1,,,,2473
904a9146cbb95ef39ff85610e953b1ab428192e9,0,GitHub,2018-12-29 08:41:51+05:18,['35dd8813b6366b68ad302c38217ff5a7e26553d2'],4,59,63,799543,4,0,0,1,2473
6c1e81c8ce9140e7a9f9e1d389654e9aa6f4231f,0,Thiruvalluvan M G,2018-12-29 23:47:18+05:18,['904a9146cbb95ef39ff85610e953b1ab428192e9'],77,223,300,799843,10,0.098765432,0.098765432,1,2473
b3d027654b943899c609d5bcf529a45a458dfa56,0,Thiruvalluvan M G,2018-12-30 08:25:55+05:18,['6c1e81c8ce9140e7a9f9e1d389654e9aa6f4231f'],25,33,58,799901,2,1,1,1,2473
8f94f5647b6351c219fa105f37cd01f156427f71,0,GitHub,2018-12-30 12:37:16+05:18,"['904a9146cbb95ef39ff85610e953b1ab428192e9', 'b3d027654b943899c609d5bcf529a45a458dfa56']",101,255,356,800257,11,,,,2473
202748df75a29e8b27ce4e374ff289cfe8a91040,0,Thiruvalluvan M G,2018-12-31 07:36:23+05:18,['8f94f5647b6351c219fa105f37cd01f156427f71'],8,60,68,800325,4,0.057142857,1,1,2473
d3dbf7122d3b8386ae72f46f0e966c8b69b8621a,0,GitHub,2018-12-31 11:37:50+05:18,"['8f94f5647b6351c219fa105f37cd01f156427f71', '202748df75a29e8b27ce4e374ff289cfe8a91040']",8,60,68,800393,4,,,,2473
0917c496a26877a3bb260a5a09ff60b3d1ab85d8,0,Thiruvalluvan M G,2019-01-02 15:18:36+05:18,['d3dbf7122d3b8386ae72f46f0e966c8b69b8621a'],58,162,220,800613,10,0.637931034,1,1,2473
7da2a4f05f80a044a1d5033048d0040a9f7f2445,0,Thiruvalluvan M G,2019-01-02 18:24:23+05:18,['d3dbf7122d3b8386ae72f46f0e966c8b69b8621a'],3,6,9,800622,2,,,,2473
a296ebc8894ad52ae7c0946e635b93cadc709e70,0,GitHub,2019-01-02 19:34:59+05:18,"['d3dbf7122d3b8386ae72f46f0e966c8b69b8621a', '7da2a4f05f80a044a1d5033048d0040a9f7f2445']",3,6,9,800631,2,,,,2473
e61751efd9f72cc299fce55c16e1d15e2ee1addc,0,GitHub,2019-01-03 07:29:25+05:18,"['a296ebc8894ad52ae7c0946e635b93cadc709e70', '0917c496a26877a3bb260a5a09ff60b3d1ab85d8']",58,162,220,800851,10,,,,2473
1e5f62c8bd3b58d5d622d8abeb665d601c978f75,0,Thiruvalluvan M G,2019-01-03 10:18:15+05:18,['e61751efd9f72cc299fce55c16e1d15e2ee1addc'],3,10,13,800864,2,,,,2473
1d7f2d7b46794348394a2f0a70658d94c38530a1,0,GitHub,2019-01-03 13:33:27+05:18,"['e61751efd9f72cc299fce55c16e1d15e2ee1addc', '1e5f62c8bd3b58d5d622d8abeb665d601c978f75']",3,10,13,800877,2,,,,2473
0c223c9da6d0286c9e16257cef8b9988099cf8a2,0,Daniel Kulp,2019-01-03 16:30:04-05:00,['1d7f2d7b46794348394a2f0a70658d94c38530a1'],4,5,9,800886,1,,,,2473
7622817b35b5511607d33facb6c0877e08b6c21f,0,Thiruvalluvan M G,2019-01-04 23:26:24+05:18,['0c223c9da6d0286c9e16257cef8b9988099cf8a2'],2,4,6,800892,1,,,,2473
2b8513f94ba04b3b14867d639ae37750db56f765,0,Thiruvalluvan M G,2019-01-05 00:57:28+05:18,['7622817b35b5511607d33facb6c0877e08b6c21f'],1,2,3,800895,1,,,,2473
1a934e37e1d3bf63fdec844d676d6a5c129e1b67,0,Thiruvalluvan M G,2019-01-05 07:49:25+05:18,['2b8513f94ba04b3b14867d639ae37750db56f765'],16,3,19,800914,2,,,,2473
efd6274a4c7a9ed7c1c0d41477649b68baeefa0b,0,GitHub,2019-01-05 08:33:47+05:18,"['0c223c9da6d0286c9e16257cef8b9988099cf8a2', '1a934e37e1d3bf63fdec844d676d6a5c129e1b67']",13,3,16,800930,2,,,,2473
7740efa3ee8e3ddd01405c8f3af1937859f6bd1a,0,Tim Perkins,2019-01-06 14:47:31-05:00,['efd6274a4c7a9ed7c1c0d41477649b68baeefa0b'],3,13,16,800946,2,,,,2473
9133577129111a75103d9bcfa5444f9847abb515,0,Tim Perkins,2019-01-06 14:55:07-05:00,['7740efa3ee8e3ddd01405c8f3af1937859f6bd1a'],1,1,2,800948,1,,,,2473
dd31b7eb4d537d83197ba04059953283c58696fc,0,Thiruvalluvan M G,2019-01-07 11:16:36+05:18,['efd6274a4c7a9ed7c1c0d41477649b68baeefa0b'],27,213,240,801188,11,0.278195489,0.992481203,1,2473
a7e72b5b581605d70919b8d244414b879533bd8f,0,GitHub,2019-01-07 19:33:56+05:18,"['efd6274a4c7a9ed7c1c0d41477649b68baeefa0b', 'dd31b7eb4d537d83197ba04059953283c58696fc']",27,213,240,801428,11,,,,2473
298047ba76ad69007a5d9ba7e931322c933a03b3,0,Thiruvalluvan M G,2019-01-07 20:18:27+05:18,['a7e72b5b581605d70919b8d244414b879533bd8f'],37,41,78,801506,14,1,0,0,2473
e5fdce55138d59839ff16797aac02e4b1d916ab9,0,Thiruvalluvan M G,2019-01-07 21:20:02+05:18,['298047ba76ad69007a5d9ba7e931322c933a03b3'],15,15,30,801536,6,0,1,0.75,2473
63a34a693763f0f103b15e4fd77dcfc8547829dc,0,Thiruvalluvan M G,2019-01-07 21:50:49+05:18,['e5fdce55138d59839ff16797aac02e4b1d916ab9'],93,8,101,801637,4,,,,2473
6660870e3e13ceb91bcf9d4b8ff5cad8fa142856,0,GitHub,2019-01-07 22:17:03+05:18,"['a7e72b5b581605d70919b8d244414b879533bd8f', '9133577129111a75103d9bcfa5444f9847abb515']",4,14,18,801655,3,,,,2473
c3a488cb1808f0de86f4f0ab27acbc26095c6f09,0,Thiruvalluvan M G,2019-01-07 22:39:27+05:18,['63a34a693763f0f103b15e4fd77dcfc8547829dc'],83,64,147,801802,20,0,0,0,2473
695d83d02d5c5cd074c3fed0655f0940e0f3c4de,0,Thiruvalluvan M G,2019-01-07 23:32:01+05:18,['c3a488cb1808f0de86f4f0ab27acbc26095c6f09'],50,40,90,801892,10,,,,2473
29ebfc3af238de33dc4bbbf508c4b6daf3306b38,0,Thiruvalluvan M G,2019-01-08 00:09:42+05:18,['695d83d02d5c5cd074c3fed0655f0940e0f3c4de'],25,29,54,801946,9,,,,2473
8a42cd0642fcadca7765f59d83a059b1eddb26bd,0,Thiruvalluvan M G,2019-01-08 00:25:57+05:18,['29ebfc3af238de33dc4bbbf508c4b6daf3306b38'],27,0,27,801973,5,,,,2473
7f116b8d58655ac369e3ae2c31cd68bc93f0b903,0,Daniel Kulp,2019-01-08 12:11:17-05:00,['6660870e3e13ceb91bcf9d4b8ff5cad8fa142856'],11,0,11,801984,1,,,,2473
55acae0fdb725aec974dd125086d161c097b0dac,0,Daniel Kulp,2019-01-08 14:11:25-05:00,['7f116b8d58655ac369e3ae2c31cd68bc93f0b903'],1,9,10,801994,2,,,,2473
7a098485a585fa3e387e2ad2b2e4af682a88a997,0,GitHub,2019-01-09 08:04:13+05:18,"['55acae0fdb725aec974dd125086d161c097b0dac', '8a42cd0642fcadca7765f59d83a059b1eddb26bd']",322,189,511,802505,45,,,,2473
114cf9c826c38c925292f81109e3dce0837d71ed,0,Daniel Kulp,2019-01-11 11:41:29-05:00,['7a098485a585fa3e387e2ad2b2e4af682a88a997'],0,4,4,802509,1,,,,2473
9a05375436385b7fce75d32cfdcd359e279e0628,1,Fokko Driesprong,2019-01-12 11:32:50+01:00,['114cf9c826c38c925292f81109e3dce0837d71ed'],1066,619,1685,804194,58,1,1,0.155172414,2477
806adf7bba3dbff20002b6dd2d64d6e3be062321,0,Daniel Kulp,2019-01-14 16:10:25-05:00,['9a05375436385b7fce75d32cfdcd359e279e0628'],3,58,61,804255,4,1,1,0.911764706,2477
2084ca42ffd22b7827cc7e240cf249534b9f9d45,1,Daniel Kulp,2019-01-16 11:53:12-05:00,['806adf7bba3dbff20002b6dd2d64d6e3be062321'],2,2,4,804259,1,,,,2477
5a64ea53d2e37449295c8d29f3d33ce849691155,0,Thiruvalluvan M G,2019-01-17 14:16:58+05:18,['2084ca42ffd22b7827cc7e240cf249534b9f9d45'],2,51,53,804312,7,0.958333333,1,1,2477
6d0323cc950f0b05a7e30a81fa5970df312be736,0,GitHub,2019-01-17 23:48:11+05:18,"['2084ca42ffd22b7827cc7e240cf249534b9f9d45', '5a64ea53d2e37449295c8d29f3d33ce849691155']",2,51,53,804365,7,,,,2477
0d997e5e5952546e0bdeab3080ef7c00d8caffc1,0,Daniel Kulp,2019-01-17 14:55:16-05:00,['6d0323cc950f0b05a7e30a81fa5970df312be736'],1,1,2,804367,1,,,,2477
05171ee872bb8d6e9173a34b7832f522b2a56763,0,Daniel Kulp,2019-01-17 15:24:50-05:00,['0d997e5e5952546e0bdeab3080ef7c00d8caffc1'],12,23,35,804402,8,0,0.333333333,1,2477
411cfb96db6126a06df9e8093106e690b7e35dfc,0,Daniel Kulp,2019-01-17 15:37:08-05:00,['05171ee872bb8d6e9173a34b7832f522b2a56763'],39,22,61,804463,1,1,0,0,2477
7b820c13a1f25c7fd35850a6fed921aabc3ed103,0,Flavien Raynaud,2019-01-18 18:02:49+00:00,['1afc3d95b712de77c7740e7e12cd62dc06d50e50'],0,1,1,804464,1,,,,2477
2eea14c10f87029dfe89e7575fbd587cb23b812d,1,Fokko Driesprong,2019-01-19 15:05:39+01:00,['411cfb96db6126a06df9e8093106e690b7e35dfc'],25,35,60,804524,3,,,,2477
5896f1a1bdcbc2f7450b09b1dbbdeb4ad0cb13b6,1,Ismaël Mejía,2019-01-21 23:29:05+01:00,['2eea14c10f87029dfe89e7575fbd587cb23b812d'],26,32,58,804582,9,1,1,1,2477
c3e0c4974db92bf6001a6da654870455cac70eac,1,Ismaël Mejía,2019-01-22 09:57:13+01:00,['5896f1a1bdcbc2f7450b09b1dbbdeb4ad0cb13b6'],1,1,2,804584,1,,,,2477
8643e3bd73cab8dbbbcac1203a19c2d2cdc62cfe,0,Ismaël Mejía,2019-01-22 10:02:16+01:00,['c3e0c4974db92bf6001a6da654870455cac70eac'],1,7,8,804592,1,,,,2477
384061c05720287aa93a756a742aab2572b75e79,0,Ismaël Mejía,2019-01-23 09:55:24+01:00,['8643e3bd73cab8dbbbcac1203a19c2d2cdc62cfe'],1,1,2,804594,1,,,,2477
10445fe1c366cbafcd5de4ddf4520ac5f91183cb,0,Ismaël Mejía,2019-01-23 09:59:33+01:00,['384061c05720287aa93a756a742aab2572b75e79'],7,80,87,804681,7,,,,2477
3c16299956d64dc4a1b76161228ebb545d3d400b,0,Ismaël Mejía,2019-01-28 15:58:56+01:00,['10445fe1c366cbafcd5de4ddf4520ac5f91183cb'],85,45,130,804811,14,0.619047619,0.238095238,0.166666667,2477
bcc79e90540f55dc9e1dd34da7a1f5901ee22b2a,0,Ismaël Mejía,2019-01-29 10:31:29+01:00,['3c16299956d64dc4a1b76161228ebb545d3d400b'],7,3,10,804821,1,1,0,1,2477
0de805575f41c2d7deff9fcbe408e51606f88269,0,Ismaël Mejía,2019-01-29 10:37:11+01:00,['bcc79e90540f55dc9e1dd34da7a1f5901ee22b2a'],3,3,6,804827,1,0,0,0,2477
4fad0f252d06f5cf4c51fbfdfa2ac966daf55a1f,0,Daniel Kulp,2019-01-29 13:56:05-05:00,['0de805575f41c2d7deff9fcbe408e51606f88269'],2,8,10,804837,1,,,,2477
e03f9d44faaaa5fd0908f9402340164972415c0d,0,Fokko Driesprong,2019-02-04 09:55:08+01:00,['4fad0f252d06f5cf4c51fbfdfa2ac966daf55a1f'],36,114,150,804987,6,,,,2478
cef06d90fd2e4156f83498f6a77b325115491a49,0,GitHub,2019-02-05 09:44:54+01:00,['e03f9d44faaaa5fd0908f9402340164972415c0d'],1,1,2,804989,1,,,,2478
a780991e7316762cda2a7cc8bc7092c4c61ccf63,0,GitHub,2019-02-05 19:05:27+05:18,"['e03f9d44faaaa5fd0908f9402340164972415c0d', 'cef06d90fd2e4156f83498f6a77b325115491a49']",1,1,2,804991,1,,,,2478
99393272e65c24778254e97be11ec87e02d5689e,0,Fokko Driesprong,2019-02-05 23:36:25+01:00,['a780991e7316762cda2a7cc8bc7092c4c61ccf63'],0,29,29,805020,1,,,,2479
6b5963d64e8c339c5266b6b14c707ea9cb10f8fa,0,Ismaël Mejía,2019-02-06 09:40:10+01:00,['99393272e65c24778254e97be11ec87e02d5689e'],1,1,2,805022,1,,,,2479
f4425913940a11870bc8fda602d29217cff53af0,0,Ismaël Mejía,2019-02-06 09:44:54+01:00,['6b5963d64e8c339c5266b6b14c707ea9cb10f8fa'],1,1,2,805024,1,,,,2479
7e64b40104f0918b04ddc83038ef0bb779ff1c95,0,Ismaël Mejía,2019-02-06 21:22:12+01:00,['f4425913940a11870bc8fda602d29217cff53af0'],14,0,14,805038,1,,,,2479
c1faf3b56504de9e366000ceeb4a65ef9567f8d2,0,Ismaël Mejía,2019-02-06 21:22:12+01:00,['7e64b40104f0918b04ddc83038ef0bb779ff1c95'],63,68,131,805169,9,,,,2479
ba30662a00fe5f883d643c956d7b982a5d4b8751,0,Fokko Driesprong,2019-02-06 22:46:16+01:00,['c1faf3b56504de9e366000ceeb4a65ef9567f8d2'],1,1,2,805171,1,,,,2479
1f88d9ede26daad76f1343ca300f16cc824ef712,0,Fokko Driesprong,2019-02-06 22:47:04+01:00,['ba30662a00fe5f883d643c956d7b982a5d4b8751'],3,4,7,805178,3,,,,2479
c4f880eb00b07a4cc6fbab24ae9f5c9d970d269b,0,Fokko Driesprong,2019-02-06 22:48:18+01:00,['1f88d9ede26daad76f1343ca300f16cc824ef712'],1,1,2,805180,1,,,,2479
95cd62055fd24910d8873b4d8ab209eec198239e,0,nandorKollar,2019-02-07 08:12:26+01:00,['c4f880eb00b07a4cc6fbab24ae9f5c9d970d269b'],1,1,2,805182,1,,,,2479
ac95febf82b15ffa564cac1d92475cdf6efed9f6,0,Daniel Kulp,2019-02-07 15:47:10-05:00,['95cd62055fd24910d8873b4d8ab209eec198239e'],76,361,437,805619,40,0,1,1,2487
e0ab6bd54ab632569782a577b7e9a1d419e08845,0,Daniel Kulp,2019-02-07 16:00:37-05:00,['ac95febf82b15ffa564cac1d92475cdf6efed9f6'],7,9,16,805635,3,1,1,1,2487
114fee5317ca2bb2b09864c66da99e86190faffb,1,Fokko Driesprong,2019-02-12 13:10:57+01:00,['e0ab6bd54ab632569782a577b7e9a1d419e08845'],10,360,370,806005,5,0.207964602,0.504424779,0.442477876,2488
e44acccf69a0b40f12f904144df67b345a5138ad,0,Fokko Driesprong,2019-02-12 13:14:02+01:00,['114fee5317ca2bb2b09864c66da99e86190faffb'],0,0,0,806005,1,,,,2488
2aa4946f42541369b31094538801c2caec251c67,0,Fokko Driesprong,2019-02-12 16:24:20+01:00,['e44acccf69a0b40f12f904144df67b345a5138ad'],51,52,103,806108,2,1,1,0,2488
c62a8f9d11c85c18a9df1f28d23fe0396f7766b9,0,GitHub,2019-02-12 16:55:09+01:00,['2aa4946f42541369b31094538801c2caec251c67'],1,8,9,806117,2,0,1,1,2488
ff11298e397977b820bdeed612e61dab17f118b9,0,Ismaël Mejía,2019-02-19 23:23:33+01:00,['c62a8f9d11c85c18a9df1f28d23fe0396f7766b9'],1,1,2,806119,1,,,,2488
e2ca27ef053becb47d3b18a00215e9df3da3ad2a,0,GitHub,2019-02-27 12:59:01+01:00,['ff11298e397977b820bdeed612e61dab17f118b9'],1,1,2,806121,1,,,,2488
b82a370b1607d6f45c3ec9db6125dd527d5eaab5,0,GitHub,2019-02-27 13:30:02+01:00,['e2ca27ef053becb47d3b18a00215e9df3da3ad2a'],1,1,2,806123,1,,,,2488
846a9a1bb85e9832b696970c96e6089d43c3ee6b,1,Daniel Kulp,2019-03-01 15:41:52-05:00,['b82a370b1607d6f45c3ec9db6125dd527d5eaab5'],1,10,11,806134,1,0,0,1,2488
a56108835a0aa35530c8f367ce8a50d0c5861192,0,Daniel Kulp,2019-03-01 15:44:58-05:00,['846a9a1bb85e9832b696970c96e6089d43c3ee6b'],9,9,18,806152,6,,,,2488
5714c9e837428279329b9758e415ce89118be646,0,Daniel Kulp,2019-03-01 15:46:24-05:00,['a56108835a0aa35530c8f367ce8a50d0c5861192'],2,5,7,806159,1,1,1,0,2488
4468b34b5da5fba1a7ed5bf79a829e1efcffbd63,0,Daniel Kulp,2019-03-01 15:46:24-05:00,['5714c9e837428279329b9758e415ce89118be646'],1,1,2,806161,1,,,,2488
3ec3db79af89d5674c2cfe5cedb7c784787e9bcd,0,Ismaël Mejía,2019-03-04 05:24:52-05:00,['4468b34b5da5fba1a7ed5bf79a829e1efcffbd63'],1,1,2,806163,1,,,,2488
d93a33a3860787da855822c0d6e0cfd425f4583b,0,Fokko Driesprong,2019-03-04 14:27:46+01:00,['3ec3db79af89d5674c2cfe5cedb7c784787e9bcd'],1,1,2,806165,1,,,,2488
4a3609cd854e9ef5bdda5b43e188a3309a93aef9,0,Fokko Driesprong,2019-03-04 23:44:48+01:00,['d93a33a3860787da855822c0d6e0cfd425f4583b'],9,103,112,806277,8,1,1,1,2489
e561b5a95caecf9d394186031868251b7a229f2e,0,Fokko Driesprong,2019-03-06 20:24:28+01:00,['4a3609cd854e9ef5bdda5b43e188a3309a93aef9'],2,2,4,806281,2,,,,2489
02e08dafd35b31e9e596564b0996dc63bd2fb1ed,0,nandorKollar,2019-03-07 09:18:48+01:00,['e561b5a95caecf9d394186031868251b7a229f2e'],1,1,2,806283,1,,,,2489
2f2025201bf937cb163d263396a097bbc5fad1b0,0,nandorKollar,2019-03-07 10:32:58+01:00,['02e08dafd35b31e9e596564b0996dc63bd2fb1ed'],143,0,143,806426,2,0,0,0.209677419,2489
f173ae8d690b5f90e8cc5899b654762a9d11e17d,0,nandorKollar,2019-03-07 10:45:51+01:00,['2f2025201bf937cb163d263396a097bbc5fad1b0'],3,3,6,806432,1,,,,2489
f715c974b9f7eb4d4809c1e0f04b7b4ff12837b3,0,Daniel Kulp,2019-03-07 15:10:21-05:00,['f173ae8d690b5f90e8cc5899b654762a9d11e17d'],6,0,6,806438,2,,,,2489
e16f30abf6d1b7befcc36f49a5bc39166a75f814,0,Daniel Kulp,2019-03-07 15:12:00-05:00,['f715c974b9f7eb4d4809c1e0f04b7b4ff12837b3'],11,8,19,806457,3,1,1,1,2489
aa1cb568d8213e3ad7ed46fa6787d7876a95e77e,0,Flavien Raynaud,2019-03-09 12:17:37+00:00,['7b820c13a1f25c7fd35850a6fed921aabc3ed103'],1,1,2,806459,1,,,,2489
9e6b18fabd4c3d53c250aaa95a71e11b8bff4986,0,Flavien Raynaud,2019-03-09 12:59:25+00:00,['aa1cb568d8213e3ad7ed46fa6787d7876a95e77e'],1,38,39,806498,2,1,1,1,2489
e5ca80b51c634f5e75629af4f2f4e424c4754be4,0,Flavien Raynaud,2019-03-09 13:00:55+00:00,['9e6b18fabd4c3d53c250aaa95a71e11b8bff4986'],1,6,7,806505,2,,,,2489
ef8349ffd6da5c6f4693ac46548c96e22eeb7cd7,0,Daniel Kulp,2019-03-11 15:12:42-04:00,['e16f30abf6d1b7befcc36f49a5bc39166a75f814'],50,35,85,806590,3,1,1,0,2489
8c3c590d7bfa6d486f5741c5e2f5214a1f2436c1,0,Daniel Kulp,2019-03-11 15:13:21-04:00,['ef8349ffd6da5c6f4693ac46548c96e22eeb7cd7'],3,4,7,806597,1,0,0,1,2489
6d0698705299e67e2f463216b95bf962ab6f11a2,0,Daniel Kulp,2019-03-11 15:15:57-04:00,['8c3c590d7bfa6d486f5741c5e2f5214a1f2436c1'],9,5,14,806611,1,1,0,0,2489
a7a5aeba3927404f6d83306caeb546a7f3a5e705,0,Daniel Kulp,2019-03-11 15:20:09-04:00,['6d0698705299e67e2f463216b95bf962ab6f11a2'],2,2,4,806615,1,,,,2489
d195e1fc626f960eef7ef9a5aaeb3851cb4fda31,0,Daniel Kulp,2019-03-12 12:39:24-04:00,['a7a5aeba3927404f6d83306caeb546a7f3a5e705'],14,29,43,806658,1,,,,2489
6fddbae08fcf0aba1d51289d1b90681c3bfa9477,0,Daniel Kulp,2019-03-12 12:40:25-04:00,['d195e1fc626f960eef7ef9a5aaeb3851cb4fda31'],19,18,37,806695,1,1,0,0,2489
3d51ba5e96556136c2084838591aa325e81bfca9,1,Daniel Kulp,2019-03-12 12:44:59-04:00,['6fddbae08fcf0aba1d51289d1b90681c3bfa9477'],745,1132,1877,808572,198,0,1,0,2489
63e02101cf94d8ab0e1ae01baafe04c5767aa371,0,Daniel Kulp,2019-03-12 12:49:10-04:00,['3d51ba5e96556136c2084838591aa325e81bfca9'],17,32,49,808621,1,0,0,1,2489
0e6977d1b89c9a103cec0be5bd4bbeceb740d50f,0,Daniel Kulp,2019-03-12 12:50:51-04:00,['63e02101cf94d8ab0e1ae01baafe04c5767aa371'],19,15,34,808655,6,,,,2489
fb3c25f92baa17249219e263e0fe17568c67eadc,0,Daniel Kulp,2019-03-12 14:43:06-04:00,['0e6977d1b89c9a103cec0be5bd4bbeceb740d50f'],10,3,13,808668,2,0,0,0,2489
46485b555dc16b38be59aa8e777aaecf74185fab,0,Ismaël Mejía,2019-03-12 21:15:56+01:00,['fb3c25f92baa17249219e263e0fe17568c67eadc'],1,0,1,808669,1,,,,2489
1119b6eb5b92730b27e9798793bc67f192591c15,1,Ismaël Mejía,2019-03-18 09:47:57+01:00,['46485b555dc16b38be59aa8e777aaecf74185fab'],1363,763,2126,810795,159,0.929254302,0.437858509,0.173996176,2489
06a1b011385a811b1877fa80ecd327bf3d4eb9de,1,Flavien Raynaud,2019-03-24 09:23:12+00:00,['e5ca80b51c634f5e75629af4f2f4e424c4754be4'],309,261,570,811365,25,0,0.125,1,2489
8026c8ffe4ef67ab419dba73910636bf2c1a691c,1,Fokko Driesprong,2019-03-26 14:29:51+01:00,['1119b6eb5b92730b27e9798793bc67f192591c15'],19774,19484,39258,850623,572,1,0.002108815,0.2699283,2490
8f0eca6990a584707c0cc7690fc1d325803a5287,0,Ismaël Mejía,2019-03-28 10:12:08+01:00,['8026c8ffe4ef67ab419dba73910636bf2c1a691c'],0,2,2,850625,1,1,1,1,2490
d81bffd41c348d8ffe11506fe26c66c58a37a580,1,Daniel Kulp,2019-03-28 08:00:29-04:00,['8f0eca6990a584707c0cc7690fc1d325803a5287'],15,135,150,850775,7,0.392857143,1,0.857142857,2492
b2f4790ab20537907d9bc29050e9eb31f711f671,0,Daniel Kulp,2019-03-28 09:54:00-04:00,['d81bffd41c348d8ffe11506fe26c66c58a37a580'],26,28,54,850829,9,1,1,1,2492
ff6a4e8317689928056ed18805a944057ae666ad,1,Daniel Kulp,2019-03-28 11:13:46-04:00,['b2f4790ab20537907d9bc29050e9eb31f711f671'],31,95,126,850955,14,,,,2492
c1abf35eec063f582da2551bc9121ae0beee65f5,0,Daniel Kulp,2019-03-28 11:47:23-04:00,['ff6a4e8317689928056ed18805a944057ae666ad'],14,51,65,851020,6,0,1,1,2492
05ad1a7b49568b400268e7e2d504eac3ed97f0d1,0,Daniel Kulp,2019-03-28 12:05:39-04:00,['c1abf35eec063f582da2551bc9121ae0beee65f5'],0,7,7,851027,2,0,1,1,2492
48ed810a0d1352adcb3f608ff33b186ed433e784,1,Ismaël Mejía,2019-03-28 17:18:51+01:00,['05ad1a7b49568b400268e7e2d504eac3ed97f0d1'],3,5230,5233,856260,45,0.840255591,0.943556976,0.998935037,2534
8197803dceb89d53d6f5a3e9143f46c035d6558b,1,Daniel Kulp,2019-03-28 14:01:18-04:00,['48ed810a0d1352adcb3f608ff33b186ed433e784'],3,734,737,856997,8,0.774919614,0.704180064,0.951768489,2536
c552c1746ff9bac97512fc7db2523f3cff1bd15d,0,Ismaël Mejía,2019-03-29 00:05:24+01:00,['8197803dceb89d53d6f5a3e9143f46c035d6558b'],86,85,171,857168,25,0,0,0,2536
c369dd1b4d2f807bfdec5b25317a5adee855d7fc,0,Daniel Kulp,2019-03-29 09:06:22-04:00,['c552c1746ff9bac97512fc7db2523f3cff1bd15d'],543,563,1106,858274,12,0.666666667,0.833333333,0,2537
db992cf8686ffa681b0c592696b37ad519c33ee6,0,Daniel Kulp,2019-03-29 09:06:51-04:00,['c369dd1b4d2f807bfdec5b25317a5adee855d7fc'],2,18,20,858294,2,,,,2537
392c761952ec7f679b29ae28129403ea8cf307ea,0,Fokko Driesprong,2019-03-31 18:47:16+02:00,['db992cf8686ffa681b0c592696b37ad519c33ee6'],1,176,177,858471,5,0.092715232,1,0.993377483,2537
de48a0a8a0343b61fdb255011fde38c619761046,0,Fokko Driesprong,2019-03-31 18:53:25+02:00,['392c761952ec7f679b29ae28129403ea8cf307ea'],22,97,119,858590,3,0.321428571,0.392857143,1,2537
451deec474935db54824069dcf5cfe7ae49a1b11,0,Daniel Kulp,2019-04-01 15:54:48-04:00,['de48a0a8a0343b61fdb255011fde38c619761046'],37,98,135,858725,4,0.620689655,0,1,2537
22c4685e1711235e7435a2acbdb4df48f39e3f92,0,Daniel Kulp,2019-04-01 15:54:48-04:00,['451deec474935db54824069dcf5cfe7ae49a1b11'],1,27,28,858753,1,1,1,1,2537
dbf977989105217b37a798d30793d90e747eceb1,0,Daniel Kulp,2019-04-01 15:57:03-04:00,['22c4685e1711235e7435a2acbdb4df48f39e3f92'],256,11,267,859020,1,0.963917526,0.963917526,0,2537
e0871378317e2e10e60f7a6ec992802e341e240f,0,Daniel Kulp,2019-04-01 15:57:03-04:00,['dbf977989105217b37a798d30793d90e747eceb1'],11,13,24,859044,1,0,0,1,2537
7cd66387b7a249eabcfbd57fb651613d9eb1b8c4,0,Daniel Kulp,2019-04-01 16:01:13-04:00,['e0871378317e2e10e60f7a6ec992802e341e240f'],0,184,184,859228,2,0.163636364,1,0.909090909,2539
f7f1a5ec111a781201c5b720e058342b4ed69613,0,Daniel Kulp,2019-04-01 16:01:13-04:00,['7cd66387b7a249eabcfbd57fb651613d9eb1b8c4'],4,4,8,859236,1,,,,2539
763591d28c1c82245aa4360b9dad1949ef16a62d,0,Daniel Kulp,2019-04-01 16:12:21-04:00,['f7f1a5ec111a781201c5b720e058342b4ed69613'],1,1,2,859238,1,,,,2539
689ca49e41764d12df6963f5fd418052f0159900,0,Daniel Kulp,2019-04-01 16:12:30-04:00,['763591d28c1c82245aa4360b9dad1949ef16a62d'],27,20,47,859285,2,1,0,0.142857143,2539
6337479d5dff9bef5d249ace16fddaf8346923c4,0,Daniel Kulp,2019-04-01 16:26:48-04:00,['689ca49e41764d12df6963f5fd418052f0159900'],10,12,22,859307,1,0,1,1,2539
a5e0f4ad01703eb4a724e71dfcf99306819c6bf3,0,Daniel Kulp,2019-04-01 16:53:02-04:00,['6337479d5dff9bef5d249ace16fddaf8346923c4'],9,12,21,859328,1,0,1,0.7,2539
3a7786ed1a3bedf05e6bce7924aea2f75b576912,1,Fokko Driesprong,2019-04-03 10:45:19+02:00,['a5e0f4ad01703eb4a724e71dfcf99306819c6bf3'],16,106,122,859450,2,0.482352941,0.717647059,0.882352941,2539
bd89d59def7c3b273e122635b9a2ccfa9ada2f7f,0,Nándor Kollár,2019-04-04 10:43:49+02:00,['3a7786ed1a3bedf05e6bce7924aea2f75b576912'],664,4723,5387,864837,13,0.577654517,0.592709984,0.993660856,2546
4c0e41cebc0804c563dffe98a58c06b1c39098e1,0,Daniel Kulp,2019-04-04 19:10:34-04:00,['bd89d59def7c3b273e122635b9a2ccfa9ada2f7f'],124,109,233,865070,24,0,0,1,2546
1c679b12bab24c315a3547efa0aee1fd7838bbba,1,Daniel Kulp,2019-04-05 08:53:24-04:00,['4c0e41cebc0804c563dffe98a58c06b1c39098e1'],23,33,56,865126,3,1,1,1,2546
df9ce91231d26655ea1fc11ece5132b389fdf860,0,Daniel Kulp,2019-04-05 09:40:25-04:00,['1c679b12bab24c315a3547efa0aee1fd7838bbba'],8,8,16,865142,2,,,,2546
73506f295a7835334d31c68da35e4beabdeb4443,0,Daniel Kulp,2019-04-05 10:01:35-04:00,['df9ce91231d26655ea1fc11ece5132b389fdf860'],9,47,56,865198,2,0.322580645,0.838709677,0.774193548,2546
b09726d066111d3e884872960f511f97a0215d34,0,Daniel Kulp,2019-04-05 10:54:22-04:00,['73506f295a7835334d31c68da35e4beabdeb4443'],2,123,125,865323,5,0.448979592,1,0.448979592,2547
22d5483a1fe8a242f3a512cc0bb7131268e23e92,0,Daniel Kulp,2019-04-05 11:41:32-04:00,['b09726d066111d3e884872960f511f97a0215d34'],47,9,56,865379,2,0.677419355,0.161290323,0.225806452,2547
9839e2a67373a5cfd700182a15f949822ce3df99,0,Daniel Kulp,2019-04-05 13:05:12-04:00,['22d5483a1fe8a242f3a512cc0bb7131268e23e92'],3,5,8,865387,2,,,,2547
fa1a8ef805111c4bb0d6e5fc59e635cf72d33d14,1,Daniel Kulp,2019-04-05 15:04:57-04:00,['9839e2a67373a5cfd700182a15f949822ce3df99'],136,166,302,865689,6,0.333333333,0.916666667,0.916666667,2547
bf8f9edcaa8545c134ad2eab1b2715cb32f44e16,0,Daniel Kulp,2019-04-06 09:28:45-04:00,['fa1a8ef805111c4bb0d6e5fc59e635cf72d33d14'],1,1,2,865691,1,,,,2547
5ca17a271a8f31449cb51fb1f58fb8f9748d9447,0,Daniel Kulp,2019-04-06 09:28:45-04:00,['bf8f9edcaa8545c134ad2eab1b2715cb32f44e16'],1,1,2,865693,1,,,,2547
996c6382aa0dd9d3bb7955094f9247c77054c6fd,1,Daniel Kulp,2019-04-06 09:28:45-04:00,['5ca17a271a8f31449cb51fb1f58fb8f9748d9447'],1,1,2,865695,1,,,,2547
3a0f663db8294ea855d3520e43686c9ead28e5b9,0,Ismaël Mejía,2019-04-08 11:25:02+02:00,['996c6382aa0dd9d3bb7955094f9247c77054c6fd'],4,5,9,865704,3,,,,2547
3c3171eaa13e2aa6265577bff9cabf751bf29c4f,1,Ismaël Mejía,2019-04-08 11:25:02+02:00,['3a0f663db8294ea855d3520e43686c9ead28e5b9'],2,2,4,865708,1,,,,2547
adcd8a5fcce05fbfcf919d103cf4077a96084ba6,0,Ismaël Mejía,2019-04-08 11:25:02+02:00,['3c3171eaa13e2aa6265577bff9cabf751bf29c4f'],1,1,2,865710,1,,,,2547
95534f4ca63293fc51df3a533f07b5a9cae7f473,0,Ismaël Mejía,2019-04-08 11:25:02+02:00,['adcd8a5fcce05fbfcf919d103cf4077a96084ba6'],1,1,2,865712,1,,,,2547
c847de572528d64dfa28ad5a3a67deac692c3fe1,0,Ismaël Mejía,2019-04-08 11:25:02+02:00,['95534f4ca63293fc51df3a533f07b5a9cae7f473'],1,1,2,865714,1,,,,2547
d0354df648e8b0067f87ee162edf322dff60523c,0,Ismaël Mejía,2019-04-08 11:25:02+02:00,['c847de572528d64dfa28ad5a3a67deac692c3fe1'],1,1,2,865716,1,,,,2547
a02495613d514e984ff486f334890099b1c922e7,0,Ismaël Mejía,2019-04-08 18:32:47+02:00,['d0354df648e8b0067f87ee162edf322dff60523c'],0,17,17,865733,3,,,,2547
71fb2b29fc3e5f200b3d1ccbd177a95691910986,0,Ismaël Mejía,2019-04-08 18:35:28+02:00,['a02495613d514e984ff486f334890099b1c922e7'],52,0,52,865785,7,,,,2547
350a3f0beb779c783daecf6f1b1de58e53e5f3fa,0,Daniel Kulp,2019-04-09 14:11:17-04:00,['71fb2b29fc3e5f200b3d1ccbd177a95691910986'],0,0,0,865785,1,,,,2547
c4971ac08f52750db6bc95559c2b5faa6c0c9a06,0,Flavien Raynaud,2019-04-09 19:17:13+01:00,['06a1b011385a811b1877fa80ecd327bf3d4eb9de'],247,314,561,866346,5,0,1,1,2548
ee6386f44a288f20cf2df5933fd29b4ab54f9e55,0,Ismaël Mejía,2019-04-10 09:38:16+02:00,['350a3f0beb779c783daecf6f1b1de58e53e5f3fa'],6,6,12,866358,6,,,,2548
c41939351d00f2e1bb87ac8e8b8e1c721150c1ef,0,Ismaël Mejía,2019-04-10 11:15:50+02:00,['ee6386f44a288f20cf2df5933fd29b4ab54f9e55'],0,3,3,866361,1,,,,2548
94b3faeccfd7507d63a69027d7d1703a4bd18c9d,0,Nándor Kollár,2019-04-16 10:36:19+02:00,['c41939351d00f2e1bb87ac8e8b8e1c721150c1ef'],6,63,69,866430,3,0.636363636,0.636363636,1,2548
39d959e1c6a1f339f03dab18289e47f27c10be7f,1,Thiruvalluvan M G,2019-04-18 18:10:27-07:00,['94b3faeccfd7507d63a69027d7d1703a4bd18c9d'],562,1095,1657,868087,7,0.22,0.26,1,2550
ea61af812478af7e6922b83e0818bf06b91c0052,1,Thiruvalluvan M G,2019-04-18 18:11:01-07:00,['39d959e1c6a1f339f03dab18289e47f27c10be7f'],88,102,190,868277,3,1,1,0,2550
d39077d2f02ae0f11ad6c3af851c37567e70270f,1,Thiruvalluvan M G,2019-04-18 18:11:01-07:00,['ea61af812478af7e6922b83e0818bf06b91c0052'],56,90,146,868423,1,0.6,0.6,0,2550
b5ef7f8683d23df96b7621ba1db4558424f35767,0,Thiruvalluvan M G,2019-04-18 18:11:01-07:00,['d39077d2f02ae0f11ad6c3af851c37567e70270f'],2,9,11,868434,1,1,1,0,2550
918d04e517625de96b6931eb47f61abbc26487bf,1,Thiruvalluvan M G,2019-04-18 18:32:36-07:00,['b5ef7f8683d23df96b7621ba1db4558424f35767'],332,377,709,869143,7,0.04,0.06,0.68,2550
da50f7f205a7c3f8f69096fd27652d69066224e8,0,Ismaël Mejía,2019-04-19 14:05:08+02:00,['94b3faeccfd7507d63a69027d7d1703a4bd18c9d'],96,936,1032,870175,13,0.635730858,0.781902552,0.972157773,2552
b8b8ef5a44a7a3f25e943a9438772fc3bbc870bb,0,GitHub,2019-04-20 13:35:55-07:00,"['da50f7f205a7c3f8f69096fd27652d69066224e8', '918d04e517625de96b6931eb47f61abbc26487bf']",551,1184,1735,871910,8,,,,2552
47c27e907772947d5eae0e2b7b2aa668a931e17b,0,Fokko Driesprong,2019-04-24 15:05:43+02:00,['b8b8ef5a44a7a3f25e943a9438772fc3bbc870bb'],15,3,18,871928,2,,,,2552
307b2619f31ba18292fece706d8e282771f6ff46,0,Fokko Driesprong,2019-04-24 15:06:15+02:00,['47c27e907772947d5eae0e2b7b2aa668a931e17b'],1,1,2,871930,1,,,,2552
0f89cc8e7347fed1f348a33b00b434a6acb4791d,0,Fokko Driesprong,2019-04-24 19:59:41+02:00,['307b2619f31ba18292fece706d8e282771f6ff46'],16,9,25,871955,2,,,,2552
3cd2c2d6f41017d376c9751ed19e95c7e8db5d4d,1,Fokko Driesprong,2019-04-28 19:51:38+02:00,['0f89cc8e7347fed1f348a33b00b434a6acb4791d'],6,8,14,871969,2,,,,2552
5c8894b84578b18796fa9b71aa5beee7e94bae1d,0,Fokko Driesprong,2019-04-28 19:51:42+02:00,['3cd2c2d6f41017d376c9751ed19e95c7e8db5d4d'],20,23,43,872012,4,1,1,0,2552
9dea42829f5d9e4ce27264f4ddd513b168862025,0,Fokko Driesprong,2019-04-28 19:51:46+02:00,['5c8894b84578b18796fa9b71aa5beee7e94bae1d'],37,37,74,872086,1,,,,2552
605e1b9ed5f111b702a1061c5abee36ef1a2b774,0,Fokko Driesprong,2019-04-28 19:51:50+02:00,['9dea42829f5d9e4ce27264f4ddd513b168862025'],3,4,7,872093,1,,,,2552
3f44b7c22e355e5fde239fd16b5105cf5804b70b,0,Fokko Driesprong,2019-04-28 19:53:17+02:00,['605e1b9ed5f111b702a1061c5abee36ef1a2b774'],1,9,10,872103,2,1,1,1,2552
196777ccc2e698e9dba153d48a08ef4b68b144a1,0,Fokko Driesprong,2019-04-29 09:20:29+02:00,['3f44b7c22e355e5fde239fd16b5105cf5804b70b'],1,16,17,872120,2,0.846153846,1,1,2552
7ba925e86775ddb34a736fafced646837b73d08c,0,Daniel Kulp,2019-04-29 13:31:06-04:00,['196777ccc2e698e9dba153d48a08ef4b68b144a1'],1,1,2,872122,1,,,,2552
2a814405a2370480a8644dbb554def7226c9b0d7,0,Daniel Kulp,2019-04-29 13:36:17-04:00,['7ba925e86775ddb34a736fafced646837b73d08c'],2,1,3,872125,1,,,,2552
0c6367802773005f563bc2ca0429abf2c420c082,0,Daniel Kulp,2019-04-29 13:48:27-04:00,['2a814405a2370480a8644dbb554def7226c9b0d7'],0,1,1,872126,1,,,,2552
544e372c63daa720a01b4d558d53fb12aa6016b8,0,GitHub,2019-04-30 10:49:23+02:00,['0c6367802773005f563bc2ca0429abf2c420c082'],1,1,2,872128,1,,,,2552
e250dcc0ae0e3b32ce9d1cad0e9f580dbd241b15,0,Fokko Driesprong,2019-05-07 20:23:40+02:00,['544e372c63daa720a01b4d558d53fb12aa6016b8'],8,65,73,872201,6,1,1,1,2554
4066e612d05dd2e439781863b5256b9454c0a5ab,0,Fokko Driesprong,2019-05-10 17:56:24+02:00,['e250dcc0ae0e3b32ce9d1cad0e9f580dbd241b15'],0,0,0,872201,0,,,,2554
580519b20853cce4c7bc68137a25e76a6e9d742b,0,Fokko Driesprong,2019-05-17 10:05:31+02:00,['4066e612d05dd2e439781863b5256b9454c0a5ab'],23,23,46,872247,23,,,,2554
d2d26f9ef9f498063484a001d64617e993bce751,0,Nándor Kollár,2019-05-17 11:39:34+02:00,['580519b20853cce4c7bc68137a25e76a6e9d742b'],11,0,11,872258,1,,,,2554
4fe259547614b68b65989fd7c6cd69eb9fa25544,0,Nándor Kollár,2019-05-20 11:49:33+02:00,['d2d26f9ef9f498063484a001d64617e993bce751'],1,1,2,872260,1,,,,2554
e607b3164e59be9ab3f0dec641d8824a024429b9,0,GitHub,2019-05-21 17:02:32+02:00,['4fe259547614b68b65989fd7c6cd69eb9fa25544'],2,2,4,872264,1,,,,2554
48e518f5e7ad0e1bd456537e6ae0e640d5a46ef2,0,GitHub,2019-05-27 14:36:27+02:00,['e607b3164e59be9ab3f0dec641d8824a024429b9'],24,9,33,872297,9,,,,2554
41759e6c92d1d2578db0e878ead822a7f1abef99,1,Fokko Driesprong,2019-05-28 09:47:20+02:00,['48e518f5e7ad0e1bd456537e6ae0e640d5a46ef2'],3,40,43,872340,3,,,,2555
f33e36f70f5f149b38b9056273f584184591c23f,1,Fokko Driesprong,2019-05-31 19:43:42+02:00,['41759e6c92d1d2578db0e878ead822a7f1abef99'],164,186,350,872690,4,1,0,0,2557
b990042604b8bf83db3a137de0f54d726c1af9f0,0,Fokko Driesprong,2019-05-31 20:38:46+02:00,['f33e36f70f5f149b38b9056273f584184591c23f'],63,13,76,872766,2,0,0,0,2557
9cfc27ae51bece7e84dcf01263ce67175d67ad86,0,Fokko Driesprong,2019-06-03 15:12:21+02:00,['b990042604b8bf83db3a137de0f54d726c1af9f0'],2,1,3,872769,1,,,,2557
d3011c98d746e211c06a0308f759ef4d8312566c,1,Fokko Driesprong,2019-06-03 16:37:03+02:00,['9cfc27ae51bece7e84dcf01263ce67175d67ad86'],5,2259,2264,875033,3,0.535951045,0.952065273,0.961244263,2559
d88900ce2eebd2200a9f1a6912719854fba7a102,0,GitHub,2019-06-03 22:59:12+02:00,['d3011c98d746e211c06a0308f759ef4d8312566c'],0,27,27,875060,2,,,,2560
e72aae63be4d5ceb2ad05822e85894e868c7b2d6,1,Fokko Driesprong,2019-06-10 20:27:42+02:00,['d88900ce2eebd2200a9f1a6912719854fba7a102'],90,192,282,875342,3,0.909090909,0.909090909,1,2561
a897c50bf28720373b89b10661902a8b9754f7a5,0,Fokko Driesprong,2019-06-10 20:35:09+02:00,['e72aae63be4d5ceb2ad05822e85894e868c7b2d6'],0,419,419,875761,16,0.443037975,0.936708861,0.962025316,2568
57b22212351f6a9d0fc2fe7ca737c7f688e37829,0,Ismaël Mejía,2019-06-12 15:10:56+02:00,['a897c50bf28720373b89b10661902a8b9754f7a5'],1,1,2,875763,1,,,,2568
aa972ced3c001e0d9d8de6cd5013a1cb3b989551,1,Fokko Driesprong,2019-06-14 09:59:51+02:00,['57b22212351f6a9d0fc2fe7ca737c7f688e37829'],22,36,58,875821,9,0.6,0.2,0,2568
f6417e88b9973e932b8bad66fa6894d42c43c663,0,Nándor Kollár,2019-06-17 11:23:16+02:00,['aa972ced3c001e0d9d8de6cd5013a1cb3b989551'],6,11,17,875838,3,,,,2568
d8d73c8ea74268cd6d98d5ea9f83774d371ffed6,0,Nándor Kollár,2019-06-18 21:42:23+02:00,['f6417e88b9973e932b8bad66fa6894d42c43c663'],4,63,67,875905,4,1,1,1,2569
4db27025c8d9665370f8e951adc5ba7e5cfe3f17,0,Aniket Mokashi,2019-06-18 18:27:30-07:00,['d8d73c8ea74268cd6d98d5ea9f83774d371ffed6'],453,453,906,876811,59,,,,2569
81605f7d6467e687c518be5c3097521edcbb9494,1,Fokko Driesprong,2019-06-19 14:27:14+02:00,['d8d73c8ea74268cd6d98d5ea9f83774d371ffed6'],13,450,463,877274,7,0.55625,0.66875,0.7125,2571
347d209d2b07c46a2f9e2f2545abb2e6f89b8ff5,0,Nándor Kollár,2019-06-19 16:35:11+02:00,['81605f7d6467e687c518be5c3097521edcbb9494'],7,7,14,877288,2,,,,2571
89cf20fd44af8ce7b734e7455cd57f4dda7168f9,0,Nándor Kollár,2019-06-20 16:34:56+02:00,['347d209d2b07c46a2f9e2f2545abb2e6f89b8ff5'],1,1,2,877290,1,,,,2571
fb2d025a3d6d4a786283c770ec955f644d133b9a,0,Niels Basjes,2019-06-20 19:39:11+02:00,['89cf20fd44af8ce7b734e7455cd57f4dda7168f9'],1,1,2,877292,1,,,,2571
70260919426f89825ca148f5ee815f3b2cf4764d,1,Niels Basjes,2019-06-20 19:39:11+02:00,['fb2d025a3d6d4a786283c770ec955f644d133b9a'],2152,2163,4315,881607,1313,,,,2571
2d3b1fe7efd865639663ba785877182e7e038c45,0,Niels Basjes,2019-06-20 19:39:11+02:00,['70260919426f89825ca148f5ee815f3b2cf4764d'],123,124,247,881854,62,,,,2571
312df981a5511488ba5f6d88a310d7078de6403c,0,GitHub,2019-06-21 11:18:05-07:00,"['4db27025c8d9665370f8e951adc5ba7e5cfe3f17', '2d3b1fe7efd865639663ba785877182e7e038c45']",2299,2748,5047,886901,1330,,,,2571
42ef522cd6ad38487b09ebc9933e4e312c1beece,1,Fokko Driesprong,2019-06-22 22:29:46+02:00,['2d3b1fe7efd865639663ba785877182e7e038c45'],0,2,2,886903,1,,,,2571
d7621a0ece3f6d326f018a9ccc0e27213af1e222,0,Fokko Driesprong,2019-06-22 22:31:34+02:00,['42ef522cd6ad38487b09ebc9933e4e312c1beece'],2,2,4,886907,1,,,,2571
8bffed2c95cefb062d1593f7c59eae62da012c52,0,Fokko Driesprong,2019-06-24 11:16:00+02:00,['d7621a0ece3f6d326f018a9ccc0e27213af1e222'],1,1,2,886909,1,,,,2571
d5f46ac8789f86aa29d4da756ac1b6a5d6a66f35,0,Fokko Driesprong,2019-06-24 11:27:14+02:00,['8bffed2c95cefb062d1593f7c59eae62da012c52'],105,78,183,887092,2,1,1,0,2571
371e22468baa045b5eb5f1e05ee716d3996f520e,0,Niels Basjes,2019-06-25 12:06:35+02:00,['d5f46ac8789f86aa29d4da756ac1b6a5d6a66f35'],9,33,42,887134,2,1,1,0.833333333,2571
7a6d8b60b37f92700d4b80833dcca44653d83339,0,Niels Basjes,2019-06-25 12:06:35+02:00,['371e22468baa045b5eb5f1e05ee716d3996f520e'],0,2,2,887136,1,,,,2571
0b7ac89771461dfd610a56a1463532eeac96c892,0,Fokko Driesprong,2019-06-25 21:31:50+02:00,['7a6d8b60b37f92700d4b80833dcca44653d83339'],0,4,4,887140,4,,,,2571
fcffe2f11fd65f3a2e6ec369dadaaf3a6da9bf40,0,Fokko Driesprong,2019-06-26 10:06:27+02:00,['0b7ac89771461dfd610a56a1463532eeac96c892'],1,1,2,887142,1,,,,2571
e644e23998578d4b5e1995482c811b1174758be8,0,Fokko Driesprong,2019-06-26 10:09:32+02:00,['fcffe2f11fd65f3a2e6ec369dadaaf3a6da9bf40'],1,1,2,887144,1,,,,2571
72dfbf02b62df5d313ebfd9343c22b034214ee49,0,Nándor Kollár,2019-06-26 10:42:05+02:00,['e644e23998578d4b5e1995482c811b1174758be8'],3,6,9,887153,1,1,1,1,2571
413ab671864e399366e2b5e32bf464d1c0994ac0,0,Brian Lachniet,2019-06-27 06:45:11-04:00,['72dfbf02b62df5d313ebfd9343c22b034214ee49'],1,3,4,887157,1,,,,2571
1b98ad2d46fb2af0e0416b100ec6a0940192b017,0,Fokko Driesprong,2019-06-27 14:22:51+02:00,['413ab671864e399366e2b5e32bf464d1c0994ac0'],3598,20,3618,890775,13,0.853405503,0.772214705,0.682904826,2571
a604880b5245812d002932031b404b897d2c963a,0,Nándor Kollár,2019-06-28 10:07:42+02:00,['1b98ad2d46fb2af0e0416b100ec6a0940192b017'],7,1,8,890783,1,1,0,0,2571
96a7fb08e74cb7be1c63ab9c73ce0b25b1abfed1,0,Fokko Driesprong,2019-06-28 14:24:03+02:00,['a604880b5245812d002932031b404b897d2c963a'],0,27,27,890810,2,0,0,1,2571
4988b9b701a99561f49a0e5147f08d2dbec0ab3d,1,Brian Lachniet,2019-06-28 19:22:30-04:00,['96a7fb08e74cb7be1c63ab9c73ce0b25b1abfed1'],173,55,228,891038,12,,,,2571
c7a9b93246c6cccd4bfd210213141befc170990b,0,Nándor Kollár,2019-07-01 11:38:43+02:00,['4988b9b701a99561f49a0e5147f08d2dbec0ab3d'],1,5,6,891044,1,1,1,1,2571
b6407285171e6c08172b2239b0c989a17f6be628,0,Fokko Driesprong,2019-07-04 11:22:27+02:00,['c7a9b93246c6cccd4bfd210213141befc170990b'],167,196,363,891407,4,0.774193548,0,0,2571
4317e4a2610555fe205e892ba0494f8bc6dcb2b4,0,Fokko Driesprong,2019-07-04 11:23:19+02:00,['b6407285171e6c08172b2239b0c989a17f6be628'],5,15,20,891427,4,1,1,1,2571
223f953d5218cd3aab9b82a526d8177f27a50861,0,Fokko Driesprong,2019-07-04 11:27:03+02:00,['4317e4a2610555fe205e892ba0494f8bc6dcb2b4'],2,7,9,891436,2,1,1,1,2571
a49c3427694636280b5c09560863b031cd672d40,1,Nándor Kollár,2019-07-04 11:27:27+02:00,['223f953d5218cd3aab9b82a526d8177f27a50861'],1,33,34,891470,3,0,0,1,2571
9beb79def587e4ee7056a91cc3e21d6392b0ff94,0,Fokko Driesprong,2019-07-04 11:36:43+02:00,['a49c3427694636280b5c09560863b031cd672d40'],1,237,238,891708,2,,,,2572
95f6c12d3ec57ccc79d6a3ff4977947138b679a7,1,Brian Lachniet,2019-07-07 15:29:33-04:00,['9beb79def587e4ee7056a91cc3e21d6392b0ff94'],2,203,205,891913,6,0.045977011,1,1,2575
a15090758a09ef55196c1dd77cda0124e8278a1b,0,Daniel Kulp,2019-07-08 09:55:18-04:00,['95f6c12d3ec57ccc79d6a3ff4977947138b679a7'],2,40,42,891955,5,1,1,1,2575
a2098bd88361b5ff9298c462a2dccafbb0c2c508,0,GitHub,2019-07-08 16:43:59+02:00,['a15090758a09ef55196c1dd77cda0124e8278a1b'],1,267,268,892223,8,0.95862069,0.95862069,0.889655172,2575
5f3e59bf4bd2a89a1c676526f22036515c397b94,0,Fokko Driesprong,2019-07-12 09:18:03+01:00,['a2098bd88361b5ff9298c462a2dccafbb0c2c508'],15,30,45,892268,1,0.846153846,1,1,2575
fbfb135dd50fc39835c5323057561144eff2bc41,1,Fokko Driesprong,2019-07-12 19:55:42+02:00,['5f3e59bf4bd2a89a1c676526f22036515c397b94'],12,78,90,892358,6,,,,2575
fcb4764468cd1d70b3341c1488a394bb8f20929b,1,Fokko Driesprong,2019-07-16 15:49:58+02:00,['fbfb135dd50fc39835c5323057561144eff2bc41'],59,54,113,892471,4,1,1,1,2575
85fe67126ac9c732d8cdc58ec3c2ef23288c27d6,1,Fokko Driesprong,2019-07-18 13:02:23+02:00,['fcb4764468cd1d70b3341c1488a394bb8f20929b'],287,292,579,893050,68,1,1,1,2576
e19fe14a3a945539a66b672c74740ede19af6b6e,0,Fokko Driesprong,2019-07-19 09:48:53+02:00,['85fe67126ac9c732d8cdc58ec3c2ef23288c27d6'],1,45,46,893096,2,1,1,1,2576
e8e2fccd931df600ebed566a6c6b39b2b7f3907b,0,Nándor Kollár,2019-07-22 11:37:11+02:00,['e19fe14a3a945539a66b672c74740ede19af6b6e'],1,1,2,893098,1,,,,2576
ee4c2aaf4a5a0e1108dc01b157150d4629dd7881,0,Fokko Driesprong,2019-07-22 20:07:03+02:00,['e8e2fccd931df600ebed566a6c6b39b2b7f3907b'],11,7,18,893116,1,,,,2576
efe1181bc76adc89a69f0763ad469386db84ed67,0,Nándor Kollár,2019-07-23 11:44:29+02:00,['ee4c2aaf4a5a0e1108dc01b157150d4629dd7881'],19,6,25,893141,1,0,0,0.375,2576
e0ae0cd8a36520907304d52f4a19668a3218d5ea,0,Nándor Kollár,2019-07-23 11:46:54+02:00,['efe1181bc76adc89a69f0763ad469386db84ed67'],1,1,2,893143,1,,,,2576
ad9614acebcf686a67f052ba80ca8eb872402066,0,Nándor Kollár,2019-07-23 11:56:03+02:00,['e0ae0cd8a36520907304d52f4a19668a3218d5ea'],2,58,60,893203,2,1,1,0.882352941,2577
efc8f7d83c598fd61600d194ebb0aab7e5274ad4,0,Nándor Kollár,2019-07-25 10:21:49+02:00,['ad9614acebcf686a67f052ba80ca8eb872402066'],3,3,6,893209,2,,,,2577
10d61843003a16b738f65dd9d4580ede284f09d8,0,GitHub,2019-07-25 16:55:38-04:00,['efc8f7d83c598fd61600d194ebb0aab7e5274ad4'],13,82,95,893304,3,,,,2579
49ee803d6d5fd702a5370728b6e3e010b3ee8a29,0,Nándor Kollár,2019-07-26 15:05:32+02:00,['10d61843003a16b738f65dd9d4580ede284f09d8'],1,1,2,893306,1,,,,2579
f18d76af62d981bee21778af8872c736418f626e,0,Daniel Kulp,2019-07-30 18:14:03-04:00,['49ee803d6d5fd702a5370728b6e3e010b3ee8a29'],1,4,5,893311,1,,,,2579
1c5d3ff4ff78551edd4bab9824642d6918d3565d,0,Fokko Driesprong,2019-07-31 10:37:20+02:00,['f18d76af62d981bee21778af8872c736418f626e'],1,12,13,893324,2,,,,2579
7293dd0be192d8e5230f5a1c597c2c7577f91efd,1,Brian Lachniet,2019-08-01 20:15:06-04:00,['1c5d3ff4ff78551edd4bab9824642d6918d3565d'],1,3351,3352,896676,24,0.306740028,0.563273728,0.775103164,2601
41bc0ef4f2ccd65005d6ffd9ccdc141f3ac16d7d,0,Daniel Kulp,2019-08-02 10:57:34-04:00,['7293dd0be192d8e5230f5a1c597c2c7577f91efd'],11,13,24,896700,11,,,,2601
9125e9acff342accbb404270c09fef4ccff151d6,1,Fokko Driesprong,2019-08-05 10:07:18+02:00,['41bc0ef4f2ccd65005d6ffd9ccdc141f3ac16d7d'],25,36,61,896761,18,,,,2601
1d60c81c82f161f381c35bd5045e9a69b6d3c2ac,0,Fokko Driesprong,2019-08-05 15:15:45+02:00,['9125e9acff342accbb404270c09fef4ccff151d6'],4,4,8,896769,3,,,,2601
3cfebb821f6a34f8600bdef102355e5b8ac2160e,0,Daniel Kulp,2019-08-05 13:42:04-04:00,['1d60c81c82f161f381c35bd5045e9a69b6d3c2ac'],346,1588,1934,898703,66,1,1,1,2601
c0094b5bb1abb79304ce42a56cc115186370d407,1,Daniel Kulp,2019-08-05 13:42:04-04:00,['3cfebb821f6a34f8600bdef102355e5b8ac2160e'],2,27,29,898732,5,,,,2601
61f36e7df8daa9a49a89c0b35bcd9395360adae6,0,Daniel Kulp,2019-08-06 10:02:39-04:00,['c0094b5bb1abb79304ce42a56cc115186370d407'],1,1,2,898734,1,,,,2601
4593c3651516a6ff5c30e43198285d6435e2ff49,0,Brian Lachniet,2019-08-07 20:37:26-04:00,['61f36e7df8daa9a49a89c0b35bcd9395360adae6'],1,10,11,898745,2,1,1,1,2601
1b96b5bdf7d361bd25e1c2ef1697f0bc1d4a6e9d,0,Brian Lachniet,2019-08-10 13:18:27-04:00,['4593c3651516a6ff5c30e43198285d6435e2ff49'],64,211,275,899020,16,0.128205128,0.871794872,0.623931624,2602
122e3bb06e8a022ac9e755cb3ccc1b1924ac567f,0,Brian Lachniet,2019-08-10 15:43:48-04:00,['1b96b5bdf7d361bd25e1c2ef1697f0bc1d4a6e9d'],4,4,8,899028,4,,,,2602
4d324431edf34fc24373829a0d0af95235e6acc3,0,Daniel Kulp,2019-08-16 14:23:13-04:00,['122e3bb06e8a022ac9e755cb3ccc1b1924ac567f'],0,38,38,899066,1,,,,2603
26f59018800bd88dd58fb84cdaf04860e1b47a54,0,Daniel Kulp,2019-08-16 14:30:33-04:00,['4d324431edf34fc24373829a0d0af95235e6acc3'],1,1,2,899068,1,,,,2603
574d5ea5dea62afc58f195ddf7c0b8b4390270d3,0,Daniel Kulp,2019-08-16 14:35:38-04:00,['26f59018800bd88dd58fb84cdaf04860e1b47a54'],1,1,2,899070,1,,,,2603
080152eeb732a888dc6edd8e03073addeae7c2b0,0,Daniel Kulp,2019-08-16 14:37:48-04:00,['574d5ea5dea62afc58f195ddf7c0b8b4390270d3'],1,11,12,899082,1,1,1,1,2603
1267c4c8ce898143d58b18469aa9ea11726fcdd4,0,Daniel Kulp,2019-08-16 14:37:48-04:00,['080152eeb732a888dc6edd8e03073addeae7c2b0'],46,108,154,899236,1,1,1,0.704545455,2603
a2eae61d7fda7156176cae6ef9acd2e6f8a8e335,0,Daniel Kulp,2019-08-16 14:37:48-04:00,['1267c4c8ce898143d58b18469aa9ea11726fcdd4'],3,2,5,899241,1,,,,2603
67545b9b569a7d02e181ba7ab441d184b3aeacf8,0,Daniel Kulp,2019-08-16 14:37:48-04:00,['a2eae61d7fda7156176cae6ef9acd2e6f8a8e335'],31,31,62,899303,1,,,,2603
9b0c88cc6e9a4405d5731ddeda3ed831206e486c,1,Daniel Kulp,2019-08-16 15:01:13-04:00,['67545b9b569a7d02e181ba7ab441d184b3aeacf8'],16,34,50,899353,5,0.285714286,0.571428571,1,2603
93a3ca4f6a3ace56a2e32d4249d05dad6f220f1f,1,GitHub,2019-08-17 07:53:53-04:00,['9b0c88cc6e9a4405d5731ddeda3ed831206e486c'],28,385,413,899766,18,0.731707317,0.780487805,0.951219512,2606
d4c16599b3fbcb7671bf4255bf9419b1d6c4c281,0,Daniel Kulp,2019-08-19 13:08:26-04:00,['93a3ca4f6a3ace56a2e32d4249d05dad6f220f1f'],21,21,42,899808,1,,,,2606
4de6d838be56662b658e220deb2f1475685f768c,0,Daniel Kulp,2019-08-19 13:09:28-04:00,['d4c16599b3fbcb7671bf4255bf9419b1d6c4c281'],7,9,16,899824,2,,,,2606
e305f0625be79753dd34d20a5bfbecf9f01e5b41,0,Daniel Kulp,2019-08-19 13:47:42-04:00,['4de6d838be56662b658e220deb2f1475685f768c'],8,42,50,899874,6,1,1,1,2606
02dbe25e35d5ffc644f049cf602f88c1b137ea29,0,Fokko Driesprong,2019-08-20 11:36:53+02:00,['e305f0625be79753dd34d20a5bfbecf9f01e5b41'],6,170,176,900050,6,,,,2609
f17c77f20b74862b41bbc308619294d35871c518,1,Fokko Driesprong,2019-08-20 11:37:51+02:00,['02dbe25e35d5ffc644f049cf602f88c1b137ea29'],2,2,4,900054,1,,,,2609
058cfefadeaa642d1ce17727ded149b3a01b6de5,0,Fokko Driesprong,2019-08-20 14:41:40+02:00,['f17c77f20b74862b41bbc308619294d35871c518'],1,1,2,900056,1,,,,2609
d1eac15926e73d1bdc91867881b13b93d7fdf3e0,1,Fokko Driesprong,2019-08-20 15:30:08+02:00,['058cfefadeaa642d1ce17727ded149b3a01b6de5'],2,2,4,900060,1,,,,2609
eda435931b8dbd913b98567814494ddfe4bea016,0,Fokko Driesprong,2019-08-20 16:25:13+02:00,['d1eac15926e73d1bdc91867881b13b93d7fdf3e0'],2,1,3,900063,1,1,1,1,2609
bce00d9c4a44f66c6906e66cde21938935c00fc5,0,Fokko Driesprong,2019-08-22 13:23:53+02:00,['eda435931b8dbd913b98567814494ddfe4bea016'],2,2,4,900067,1,,,,2609
98c7c6cd898a156b5fe0cef93761f0e756ab94db,0,Fokko Driesprong,2019-08-22 13:51:33+02:00,['bce00d9c4a44f66c6906e66cde21938935c00fc5'],1,1,2,900069,1,,,,2609
1be286e774761ab67dd97f2ad96fc9d7b3d7b738,0,Fokko Driesprong,2019-08-23 14:29:59+02:00,['98c7c6cd898a156b5fe0cef93761f0e756ab94db'],2,134,136,900205,13,,,,2609
7a9f4aee4ffd97f9faffc9b417377a050f240a8f,0,Fokko Driesprong,2019-08-23 14:30:51+02:00,['1be286e774761ab67dd97f2ad96fc9d7b3d7b738'],98,98,196,900401,41,,,,2609
94923cf2fb64ed56705ae6310d948a28a506a2f4,0,Fokko Driesprong,2019-08-26 20:38:49+02:00,['7a9f4aee4ffd97f9faffc9b417377a050f240a8f'],1,1,2,900403,1,,,,2609
a8a7b74035835cda72e4764813ad999b53232efd,0,Nándor Kollár,2019-08-28 08:47:15+02:00,['94923cf2fb64ed56705ae6310d948a28a506a2f4'],1,1,2,900405,1,,,,2609
3018fc1448c1c16627932768c77b7a00e724f4a5,0,Fokko Driesprong,2019-08-28 09:52:33+02:00,['a8a7b74035835cda72e4764813ad999b53232efd'],5,18,23,900428,2,1,1,1,2609
bd559d63d5d86eeff7b317d8188cdd7038c9f3fe,0,Ismaël Mejía,2019-08-28 10:33:20+02:00,['3018fc1448c1c16627932768c77b7a00e724f4a5'],1,1,2,900430,1,,,,2609
5772eaf972b43a3a682bbc7bb1100836cd83bf01,0,GitHub,2019-08-29 10:11:18+02:00,['bd559d63d5d86eeff7b317d8188cdd7038c9f3fe'],1,1,2,900432,1,,,,2609
1adddb25be168f39798d0ff5ea173eeabff86260,0,GitHub,2019-08-29 10:11:53+02:00,['5772eaf972b43a3a682bbc7bb1100836cd83bf01'],1,1,2,900434,1,,,,2609
68240987e78004365c379ff05ba2d6fb8b31d8e5,0,GitHub,2019-08-29 10:13:27+02:00,['1adddb25be168f39798d0ff5ea173eeabff86260'],1,1,2,900436,1,,,,2609
ce36fc1c318810356fcceb7a27653cdc5629b147,0,GitHub,2019-08-29 10:14:33+02:00,['68240987e78004365c379ff05ba2d6fb8b31d8e5'],2,1,3,900439,1,,,,2609
13bc181e23871af9676c3553f0da90e7fcb7b0b1,0,GitHub,2019-08-29 10:15:42+02:00,['ce36fc1c318810356fcceb7a27653cdc5629b147'],1,1,2,900441,1,,,,2609
92e3f49ba15c7437fb99b1f21f55d2457a759cb2,1,Fokko Driesprong,2019-08-29 10:16:42+02:00,['13bc181e23871af9676c3553f0da90e7fcb7b0b1'],36,69,105,900546,15,1,1,1,2609
516af0958885b9da721b0ed6f626c20649df98f1,0,Fokko Driesprong,2019-08-29 10:18:27+02:00,['92e3f49ba15c7437fb99b1f21f55d2457a759cb2'],7,20,27,900573,6,,,,2609
fd80ae5939270a4af993465ca625f50f46a791b6,0,Fokko Driesprong,2019-08-29 10:19:23+02:00,['516af0958885b9da721b0ed6f626c20649df98f1'],35,25,60,900633,3,0.666666667,0.666666667,0,2609
811ce84d28e1a7e855452d368a08781dc0105d4f,1,Fokko Driesprong,2019-08-30 14:09:43+02:00,['fd80ae5939270a4af993465ca625f50f46a791b6'],13,54,67,900700,6,,,,2609
c493a4ed56e02df0bcce800eec10b3aab7a359ff,0,GitHub,2019-09-01 20:32:49+02:00,['811ce84d28e1a7e855452d368a08781dc0105d4f'],1,1,2,900702,1,,,,2609
ad1569240af6ba7c380fb7ac8eee65c72b9c02b5,0,GitHub,2019-09-01 20:33:49+02:00,['c493a4ed56e02df0bcce800eec10b3aab7a359ff'],6,4,10,900712,3,,,,2609
9cd2f49fc4c3bf2018723bab012241782deaf9e5,0,GitHub,2019-09-01 20:34:26+02:00,['ad1569240af6ba7c380fb7ac8eee65c72b9c02b5'],5,5,10,900722,3,,,,2609
d7f03892f6508ea476306bf09d4fd2169f4531f2,0,GitHub,2019-09-01 21:28:28+02:00,['9cd2f49fc4c3bf2018723bab012241782deaf9e5'],1,1,2,900724,1,,,,2609
a1d9b1a64c5c5ca273e5f6dfcf6015a7d1e0cc8f,0,Brian Lachniet,2019-09-03 20:22:27-04:00,['d7f03892f6508ea476306bf09d4fd2169f4531f2'],1,2,3,900727,2,,,,2609
21698b9baa331e0f2506acb4c1b5408c1b84f071,0,Brian Lachniet,2019-09-03 20:22:27-04:00,['a1d9b1a64c5c5ca273e5f6dfcf6015a7d1e0cc8f'],2,8,10,900737,3,,,,2609
770acd5a5f2de734eb7a6e51ae18ed254b2828f8,0,Brian Lachniet,2019-09-03 20:22:27-04:00,['21698b9baa331e0f2506acb4c1b5408c1b84f071'],1,3,4,900741,2,,,,2609
61e56249baa8aeb63ac4ce990ac595189e7282b4,0,Brian Lachniet,2019-09-03 20:22:27-04:00,['770acd5a5f2de734eb7a6e51ae18ed254b2828f8'],2,24,26,900767,3,1,1,1,2609
5d3ad3e179c31a444b51bc2f6556448eb5ad3408,0,Brian Lachniet,2019-09-03 20:22:27-04:00,['61e56249baa8aeb63ac4ce990ac595189e7282b4'],1,3,4,900771,1,,,,2609
539d746274a01011cffe6a863d7373d3a38d4c78,1,Brian Lachniet,2019-09-03 20:22:27-04:00,['5d3ad3e179c31a444b51bc2f6556448eb5ad3408'],20,33,53,900824,6,0.1,0.6,0.8,2609
33418a3955cac1c00b6c2ee31b3fc4929a54d996,0,Brian Lachniet,2019-09-03 20:22:27-04:00,['539d746274a01011cffe6a863d7373d3a38d4c78'],2,6,8,900832,1,,,,2609
ded1087822b590ac5106cf58bef51c8476653743,0,Brian Lachniet,2019-09-03 20:22:27-04:00,['33418a3955cac1c00b6c2ee31b3fc4929a54d996'],22,21,43,900875,16,,,,2609
e6479eae59aa9d83d6effc7284e5a3821c5e8c14,0,Brian Lachniet,2019-09-03 20:22:27-04:00,['ded1087822b590ac5106cf58bef51c8476653743'],14,34,48,900923,9,0,0.333333333,0.944444444,2609
0e1073e98b4323fd85af1826a72ca12d5eabc1d2,0,Brian Lachniet,2019-09-03 20:22:27-04:00,['e6479eae59aa9d83d6effc7284e5a3821c5e8c14'],17,16,33,900956,12,,,,2609
5b7fcf6d9a628e768410a369fd7773b46378052c,0,Brian Lachniet,2019-09-03 20:22:27-04:00,['0e1073e98b4323fd85af1826a72ca12d5eabc1d2'],3,7,10,900966,2,,,,2609
2e93877491ef385455183cf9a430b54227945858,0,Brian Lachniet,2019-09-03 20:22:27-04:00,['5b7fcf6d9a628e768410a369fd7773b46378052c'],4,2,6,900972,2,,,,2609
eef00d72cc172896980e515bee1a84fa3a29aa3a,0,Brian Lachniet,2019-09-03 20:22:27-04:00,['2e93877491ef385455183cf9a430b54227945858'],12,0,12,900984,7,,,,2609
2641b45e2d61d718fd3301cf380ea829f2c0ae6a,0,Brian Lachniet,2019-09-03 20:22:27-04:00,['eef00d72cc172896980e515bee1a84fa3a29aa3a'],2,3,5,900989,3,,,,2609
2014d7d6f86ad0a48f801ef152dbc88ef208f620,0,Brian Lachniet,2019-09-03 20:22:27-04:00,['2641b45e2d61d718fd3301cf380ea829f2c0ae6a'],39,43,82,901071,11,,,,2609
85016374897e776c54d7e8cfe022f60b1d4e9550,0,Brian Lachniet,2019-09-03 20:22:27-04:00,['2014d7d6f86ad0a48f801ef152dbc88ef208f620'],1,1,2,901073,2,,,,2609
2dd342921cc7264a54cd66c00528381a167230f9,0,Brian Lachniet,2019-09-03 20:22:27-04:00,['85016374897e776c54d7e8cfe022f60b1d4e9550'],1,2,3,901076,2,,,,2609
658b697a24685f7710c8596a68a86fe6a3f92725,0,Fokko Driesprong,2019-09-10 12:15:33+02:00,['2dd342921cc7264a54cd66c00528381a167230f9'],30,108,138,901214,8,0,0.333333333,1,2609
f310ac8db5ab962a49d448f41b7b953488cdb033,0,Nándor Kollár,2019-09-17 09:41:29+02:00,['658b697a24685f7710c8596a68a86fe6a3f92725'],2354,475,2829,904043,35,0.327868852,0.213114754,0.070257611,2609
e0171ea39c24624297159fb3bbe4a2ade0d18f73,0,Fokko Driesprong,2019-09-21 09:21:48+02:00,['f310ac8db5ab962a49d448f41b7b953488cdb033'],1,1,2,904045,1,,,,2609
1bd62dde0e065a1527553e3abf36b305b7e4004c,0,Fokko Driesprong,2019-09-22 08:47:32+02:00,['e0171ea39c24624297159fb3bbe4a2ade0d18f73'],1,1,2,904047,1,,,,2609
89b5acfbfcf9a9f0d2e9e91accf8ab880486e795,0,Daniel Kulp,2019-09-23 08:20:09-04:00,['1bd62dde0e065a1527553e3abf36b305b7e4004c'],2,2,4,904051,1,,,,2609
0fe596a123d03e3a2ada9d34a79685bc9d4be9de,0,Brian Lachniet,2019-09-29 08:32:05-04:00,['89b5acfbfcf9a9f0d2e9e91accf8ab880486e795'],11,361,372,904423,5,0.044117647,0.772058824,1,2610
ea1ee734ab12f8b931683cd9511b127257d41954,0,Brian Lachniet,2019-09-29 11:25:18-04:00,['0fe596a123d03e3a2ada9d34a79685bc9d4be9de'],2,2,4,904427,1,,,,2610
410b00ab4af7131f7409d7cd1c2bcc845e103732,0,Brian Lachniet,2019-09-29 12:14:58-04:00,['ea1ee734ab12f8b931683cd9511b127257d41954'],1,1,2,904429,1,,,,2610
062ecbedd7ee9f29a5dae374eeba419f8ab23c0d,0,Fokko Driesprong,2019-09-30 08:02:04+03:00,['410b00ab4af7131f7409d7cd1c2bcc845e103732'],1,2,3,904432,1,,,,2610
c7c2c932e7a177f8d3fe163777351fe2de4a9842,0,Fokko Driesprong,2019-10-01 09:08:57+03:00,['062ecbedd7ee9f29a5dae374eeba419f8ab23c0d'],2,1,3,904435,1,,,,2610
563c246628612287364a2e6596826831fab006e3,0,GitHub,2019-10-01 09:10:54+03:00,['c7c2c932e7a177f8d3fe163777351fe2de4a9842'],3,16,19,904454,1,,,,2610
85ce0227e427e5f7b5c84cfe59293e1b649b925a,1,Brian Lachniet,2019-10-06 07:33:13-04:00,['563c246628612287364a2e6596826831fab006e3'],4,23,27,904481,2,1,1,1,2610
bfbd2d115aec576545b0673e876a652806b41986,1,Brian Lachniet,2019-10-06 07:33:13-04:00,['85ce0227e427e5f7b5c84cfe59293e1b649b925a'],6,182,188,904669,3,0.278481013,0.278481013,1,2611
4cd5b8d804279eb670cbfdf0a0b08311e92d29a7,0,Nándor Kollár,2019-10-09 22:18:00+02:00,['bfbd2d115aec576545b0673e876a652806b41986'],1,1,2,904671,1,,,,2611
d99e2c2460ff305e92a9b103a9db441a0150ae81,0,Nándor Kollár,2019-10-09 22:19:09+02:00,['4cd5b8d804279eb670cbfdf0a0b08311e92d29a7'],1,1,2,904673,1,,,,2611
6a5ef2beabe52fb8612c807f424fc6cc64dacd2b,0,Nándor Kollár,2019-10-09 22:20:25+02:00,['d99e2c2460ff305e92a9b103a9db441a0150ae81'],1,1,2,904675,1,,,,2611
21a30042cf6b8704d440497088ede85afa17aee0,0,Nándor Kollár,2019-10-09 22:21:25+02:00,['6a5ef2beabe52fb8612c807f424fc6cc64dacd2b'],1,1,2,904677,1,,,,2611
2b75804d73fa3a8d4d25be2f79aa772f5965bbcd,1,Nándor Kollár,2019-10-09 22:24:58+02:00,['21a30042cf6b8704d440497088ede85afa17aee0'],5,5,10,904687,2,,,,2611
097ff2d69b52cddb249ea27c89bea7059f6a79df,1,Nándor Kollár,2019-10-09 22:32:42+02:00,['2b75804d73fa3a8d4d25be2f79aa772f5965bbcd'],57,82,139,904826,12,1,1,1,2611
2cd197acd8295f949f429613b82b66d042c43342,0,Fokko Driesprong,2019-10-11 10:37:58+02:00,['097ff2d69b52cddb249ea27c89bea7059f6a79df'],9,9,18,904844,4,,,,2611
2b579ee0df983c3fa28014f3a16e7a1ea18aa8cf,0,GitHub,2019-10-18 15:58:13+02:00,['2cd197acd8295f949f429613b82b66d042c43342'],1,1,2,904846,1,,,,2611
8d31e91f42390eb1cdc115c4a8e6cd7e70347805,0,Fokko Driesprong,2019-10-18 15:59:39+02:00,['2b579ee0df983c3fa28014f3a16e7a1ea18aa8cf'],86,105,191,905037,1,,,,2611
f13f026d92789ad442bff7e0a2f2fcb85a707364,0,zeshuai007,2019-10-19 10:19:09+08:00,['89b5acfbfcf9a9f0d2e9e91accf8ab880486e795'],12,12,24,905061,1,,,,2611
3a93d16dea5482486fd81d4ea971e639786c3dce,1,GitHub,2019-10-20 14:06:29+01:00,['c4971ac08f52750db6bc95559c2b5faa6c0c9a06'],6,783,789,905850,4,0.827272727,1,1,2612
6dde7e02c00568d723d13a8abb3ccacc4e509800,0,Michael A. Smith,2019-10-21 20:02:44-04:00,['8d31e91f42390eb1cdc115c4a8e6cd7e70347805'],0,2,2,905852,2,,,,2612
0f9b051ce95c88f53cb3dd91d86479100ba6f698,0,Michael A. Smith,2019-10-21 20:04:59-04:00,['6dde7e02c00568d723d13a8abb3ccacc4e509800'],1,2,3,905855,1,0,0,1,2612
edbf413e56c7f04b4a6291f94c2193ff2620a735,1,Fokko Driesprong,2019-10-22 14:49:44+02:00,['0f9b051ce95c88f53cb3dd91d86479100ba6f698'],431,587,1018,906873,36,0.625,0.125,0,2613
d5cc3ddf3068c32e3b6048d2312f5833478842cb,0,Fokko Driesprong,2019-10-23 12:44:27+02:00,['edbf413e56c7f04b4a6291f94c2193ff2620a735'],164,183,347,907220,5,,,,2613
a36cdb36b06541bcbb02345039390291d09e2080,1,Fokko Driesprong,2019-10-24 10:23:38+02:00,['d5cc3ddf3068c32e3b6048d2312f5833478842cb'],0,62,62,907282,2,1,1,1,2613
360f31b298ed5f6ad3c88aa25b7fb444cb0f144a,0,GitHub,2019-10-25 08:59:58-04:00,['a36cdb36b06541bcbb02345039390291d09e2080'],24,11,35,907317,1,0.75,0.75,0.25,2613
e3219382f3fbc9c20bc851f56d4e56a0f73c7c52,1,GitHub,2019-10-25 16:51:47-04:00,['360f31b298ed5f6ad3c88aa25b7fb444cb0f144a'],498,317,815,908132,2,1,0.710843373,0,2613
1f638fbad382881c5a7f0be7a29e29330e87e71f,1,GitHub,2019-10-25 17:58:36-04:00,['e3219382f3fbc9c20bc851f56d4e56a0f73c7c52'],47,41,88,908220,11,0.666666667,0,0,2613
5cf2361bbe0369e7efcfee4b8874e71c50641a0f,0,GitHub,2019-10-26 07:50:14-04:00,['1f638fbad382881c5a7f0be7a29e29330e87e71f'],7,4,11,908231,1,,,,2613
3e79dfec8461fb0157f068cff7ba24be8cdfa9d8,1,GitHub,2019-10-26 21:27:12-04:00,['5cf2361bbe0369e7efcfee4b8874e71c50641a0f'],203,233,436,908667,19,1,1,1,2613
a684f3e0b1859ba05c17b18407c2e9905701079a,0,Fokko Driesprong,2019-10-27 20:32:24+01:00,['3e79dfec8461fb0157f068cff7ba24be8cdfa9d8'],2,7,9,908676,2,0.75,0.75,1,2613
5bb2cb8c5818faeda134ccdce4f0b5560f316edd,0,Fokko Driesprong,2019-10-27 20:33:18+01:00,['a684f3e0b1859ba05c17b18407c2e9905701079a'],1,1,2,908678,1,,,,2613
eff234d910949d8052300eac7456ad50a0c294c5,0,GitHub,2019-10-28 12:18:31+05:18,"['5bb2cb8c5818faeda134ccdce4f0b5560f316edd', '312df981a5511488ba5f6d88a310d7078de6403c']",447,447,894,909572,59,,,,2613
ce91b2e67031bd0c0c6fd899ab76fc28d8d5dda4,0,GitHub,2019-10-28 15:27:46-04:00,['eff234d910949d8052300eac7456ad50a0c294c5'],36,27,63,909635,1,0.875,0.875,0.125,2613
7d87cde06253913e9ef23c671e9ce092bc35dfe3,0,GitHub,2019-10-28 15:35:53-04:00,['ce91b2e67031bd0c0c6fd899ab76fc28d8d5dda4'],26,37,63,909698,4,1,1,1,2613
cfc80417bb61e31c5e4ae66669b3cef27a873a13,0,GitHub,2019-10-30 20:57:43-04:00,['7d87cde06253913e9ef23c671e9ce092bc35dfe3'],28,22,50,909748,2,,,,2613
f0aad4230f5d2e6d6565c86701f3d21e59990f28,0,GitHub,2019-10-30 20:59:10-04:00,['cfc80417bb61e31c5e4ae66669b3cef27a873a13'],4,5,9,909757,1,,,,2613
eb3f51e7b5c9f87ed5fa9a6a10dd88cd5ec62faf,0,GitHub,2019-10-31 21:33:47-04:00,['f0aad4230f5d2e6d6565c86701f3d21e59990f28'],12,1,13,909770,1,1,1,0,2613
77fa25b5a65805f3067c065b9ff46eaf2c2f0897,0,GitHub,2019-11-01 21:18:47-04:00,['eb3f51e7b5c9f87ed5fa9a6a10dd88cd5ec62faf'],46,16,62,909832,1,0.176470588,0.176470588,0.294117647,2613
62f3c26e2c303df0a208590041bcf20590fce62d,0,GitHub,2019-11-02 12:28:24-04:00,['77fa25b5a65805f3067c065b9ff46eaf2c2f0897'],3,7,10,909842,2,,,,2613
044572a8550a87cd04c5ce31bd9f737a0e8cd3c3,1,Ismaël Mejía,2019-11-04 17:49:50+01:00,['62f3c26e2c303df0a208590041bcf20590fce62d'],6,6,12,909854,1,,,,2613
abe9ce706646b6bf43fa98cedccd3dd5ca6c6ab7,0,Fokko Driesprong,2019-11-04 20:17:18+01:00,['044572a8550a87cd04c5ce31bd9f737a0e8cd3c3'],1,1,2,909856,1,,,,2613
62bdc83e46fbd65d34a1715c1bcc53fa5d1919fa,0,GitHub,2019-11-04 20:35:54-05:00,['abe9ce706646b6bf43fa98cedccd3dd5ca6c6ab7'],36,344,380,910236,5,0.159090909,0.4375,0.909090909,2614
bf47ec97e0b7f5701042fac067b73b421a9177b7,0,Michael A. Smith,2019-11-06 07:04:35-05:00,['62bdc83e46fbd65d34a1715c1bcc53fa5d1919fa'],47,80,127,910363,3,0.761904762,0.80952381,1,2614
96cfef55661fe2f29b89aa8b6813f94d06a62500,0,Ryan Skraba,2019-11-07 12:02:46+01:00,['bf47ec97e0b7f5701042fac067b73b421a9177b7'],8,6,14,910377,4,0.25,0.25,0,2614
f0c6fe85ce3121c12b616d610f59aa6c6fdda169,0,Ryan Skraba,2019-11-07 13:33:27+01:00,['96cfef55661fe2f29b89aa8b6813f94d06a62500'],1,11,12,910389,1,0,1,1,2614
df663c511b640f912b673f55c0c8b679996b6c79,0,GitHub,2019-11-08 19:37:25-05:00,['bf47ec97e0b7f5701042fac067b73b421a9177b7'],86,75,161,910550,1,1,1,0,2614
bb304e9047c905d2da207ace2719c743ec26e10f,0,Michael A. Smith,2019-11-09 11:51:47-05:00,['df663c511b640f912b673f55c0c8b679996b6c79'],1,1,2,910552,1,,,,2614
6b02824fa4e7f3d019873ac04c1669765ad0aa08,0,GitHub,2019-11-09 22:34:57+05:18,"['bb304e9047c905d2da207ace2719c743ec26e10f', 'f13f026d92789ad442bff7e0a2f2fcb85a707364']",12,12,24,910576,1,,,,2614
eab8e019d6452c5cf54c1278db51861ca9bf6aac,0,GitHub,2019-11-09 22:56:09+05:18,"['6b02824fa4e7f3d019873ac04c1669765ad0aa08', 'f0c6fe85ce3121c12b616d610f59aa6c6fdda169']",9,17,26,910602,5,,,,2614
eaf11a8f0ce04b61b4f58cc071a29f82e4f23e5a,0,GitHub,2019-11-16 11:43:24-05:00,['eab8e019d6452c5cf54c1278db51861ca9bf6aac'],1,1,2,910604,1,,,,2614
af8f9c7dea4dd28f9c51dc43b1efaaa41dca9c4f,0,GitHub,2019-11-16 19:53:46-05:00,['eaf11a8f0ce04b61b4f58cc071a29f82e4f23e5a'],0,3,3,910607,1,,,,2614
3953878891efdc2a222e57382c3cfeab0a70079c,0,GitHub,2019-11-16 21:43:48-05:00,['af8f9c7dea4dd28f9c51dc43b1efaaa41dca9c4f'],3,2,5,910612,2,0,0,0,2614
bda7d995ff7cb3079285c169b23064309ecda8b1,1,GitHub,2019-11-17 09:37:51-05:00,['3953878891efdc2a222e57382c3cfeab0a70079c'],12,17,29,910641,1,0,0.2,1,2614
3c10c361a788add7d7f27fb6102148d6106f2544,0,Brian Lachniet,2019-11-18 19:11:31-05:00,['bda7d995ff7cb3079285c169b23064309ecda8b1'],22,83,105,910746,3,0,0.641025641,0.58974359,2614
76d918ab980590acb2cacc7504b86861bc26102a,0,GitHub,2019-11-18 20:11:41-05:00,['3c10c361a788add7d7f27fb6102148d6106f2544'],1,1,2,910748,1,,,,2614
1d55d10ed9200084d2603f2a6b136aede1f530b2,1,Michael A. Smith,2019-11-19 21:03:41-05:00,['76d918ab980590acb2cacc7504b86861bc26102a'],48,124,172,910920,2,0.529411765,0,0.470588235,2614
4254e280271e6b53495d866cf4262af4f1f2a288,0,GitHub,2019-11-20 21:37:36-05:00,['1d55d10ed9200084d2603f2a6b136aede1f530b2'],8,14,22,910942,2,,,,2614
f8afef1f98b1f27deb9e73ef804ed74ba2d20bbb,1,GitHub,2019-11-20 22:36:03-05:00,['4254e280271e6b53495d866cf4262af4f1f2a288'],90,91,181,911123,2,1,1,1,2614
68796d30d8898cf1cd9e806623602da519cd4058,0,Ismaël Mejía,2019-11-22 11:15:12+01:00,['f8afef1f98b1f27deb9e73ef804ed74ba2d20bbb'],48,43,91,911214,10,0.133333333,0.1,0.066666667,2614
bd8da9731f407d61f070748437789b2645c89912,0,Ismaël Mejía,2019-11-22 11:33:43+01:00,['68796d30d8898cf1cd9e806623602da519cd4058'],13,12,25,911239,5,0,0,0,2614
29db1adf5b9052d6d57a5c9f9e855a44e7c8d84b,0,GitHub,2019-11-26 09:23:57-05:00,['bd8da9731f407d61f070748437789b2645c89912'],13,3,16,911255,1,0.666666667,0,0,2614
ea084ff5e9dd0cc7d3d4c9c7c0e01fa4275a02db,0,Ismaël Mejía,2019-11-27 11:45:35+01:00,['29db1adf5b9052d6d57a5c9f9e855a44e7c8d84b'],2,1772,1774,913029,2,,,,2615
790faee01824abe9623dcdcb38af0788df595727,0,GitHub,2019-11-27 07:23:50-05:00,['ea084ff5e9dd0cc7d3d4c9c7c0e01fa4275a02db'],131,108,239,913268,8,0,0,1,2615
d28bf07d2da8dbddb561630ca69c0cee2d3f5b52,0,GitHub,2019-11-28 12:35:28-05:00,['790faee01824abe9623dcdcb38af0788df595727'],376,284,660,913928,3,1,0,0,2615
1238bdfad85e63becc53e21bb6dca506456264d2,0,Fokko Driesprong,2019-12-01 11:52:41+01:00,['d28bf07d2da8dbddb561630ca69c0cee2d3f5b52'],1,73,74,914002,4,0.583333333,0.583333333,1,2617
e3e41dcd27822ac3fd4692291d1bbea4f8a294dc,0,Fokko Driesprong,2019-12-01 12:18:58+01:00,['1238bdfad85e63becc53e21bb6dca506456264d2'],400,0,400,914402,3,0,0,0.253521127,2617
c4f3bb67dd8c6e28fce2f84cbaf0cb353ec2b2aa,0,Ismaël Mejía,2019-12-05 17:20:00+01:00,['e3e41dcd27822ac3fd4692291d1bbea4f8a294dc'],1,1,2,914404,1,,,,2617
2b8d7308489b4e9b4669fdedead59eb1b6544ec8,0,Michael A. Smith,2019-12-09 20:16:12-05:00,['c4f3bb67dd8c6e28fce2f84cbaf0cb353ec2b2aa'],14,16,30,914434,1,,,,2617
9ab19ee49678e930beeb05d2f1c7fedbd663223d,1,GitHub,2019-12-10 19:30:45-05:00,['2b8d7308489b4e9b4669fdedead59eb1b6544ec8'],420,294,714,915148,48,0.662337662,1,1,2617
0ff34ca6771ab7d9ff34844bc4e312df103450fb,1,Michael A. Smith,2019-12-10 19:49:35-05:00,['9ab19ee49678e930beeb05d2f1c7fedbd663223d'],8,66,74,915222,5,,,,2617
b9679a8986638304ffde1c99d203bb34754bc1ad,0,RyanSkraba,2019-12-17 11:06:39+01:00,['0ff34ca6771ab7d9ff34844bc4e312df103450fb'],11,19,30,915252,3,1,1,0,2617
9b39a985bcd6cd34f0820f3680f145d46c0e56bd,0,RyanSkraba,2019-12-18 14:11:27+01:00,['b9679a8986638304ffde1c99d203bb34754bc1ad'],0,2,2,915254,1,,,,2617
a4a0bccfaebcecce429acc78e7aab0b68cccaa45,0,RyanSkraba,2019-12-18 15:26:21+01:00,['9b39a985bcd6cd34f0820f3680f145d46c0e56bd'],1,21,22,915276,1,1,1,1,2617
f15b7de647cddc5836575818d81a73a46a8b85fd,0,Michael A. Smith,2019-12-18 09:49:28-05:00,['a4a0bccfaebcecce429acc78e7aab0b68cccaa45'],4,140,144,915420,6,1,1,1,2619
bd9e6c4514db274ca97dbf78975a3f9156a523b6,1,GitHub,2019-12-18 21:30:47-05:00,['f15b7de647cddc5836575818d81a73a46a8b85fd'],11,75,86,915506,10,,,,2621
3d54a9e4385358082ba5111f4a546a660f9d6c21,0,Michael A. Smith,2019-12-19 06:16:41-05:00,['bd9e6c4514db274ca97dbf78975a3f9156a523b6'],6,7,13,915519,5,,,,2621
5cca39d955e831be4ca4bfcc016a7da37e158aeb,0,GitHub,2019-12-19 18:57:38-05:00,['3d54a9e4385358082ba5111f4a546a660f9d6c21'],37,33,70,915589,1,,,,2621
652b233e7f33b1c65a578519d3cf7c3c1ae32f4b,0,Antonio Uccio Verardi,2019-12-22 22:00:52+01:00,['3a93d16dea5482486fd81d4ea971e639786c3dce'],2,48,50,915639,1,0.75,0.75,1,2621
af04ed8116c4698c169973def2c37f0e505a2f5c,0,Antonio Uccio Verardi,2019-12-22 22:09:39+01:00,['652b233e7f33b1c65a578519d3cf7c3c1ae32f4b'],1,5,6,915645,2,,,,2621
cd91695168f9edaac8c1f0140f4a023258f265d4,0,GitHub,2019-12-22 19:52:21-05:00,['5cca39d955e831be4ca4bfcc016a7da37e158aeb'],4,14,18,915663,2,,,,2621
ff5c4d6db9af3edd915a2176a627d51eb3478da3,0,Fokko Driesprong,2019-12-26 21:31:46+01:00,['cd91695168f9edaac8c1f0140f4a023258f265d4'],7,4,11,915674,2,0,0,0,2621
e8f6b003aff981e6b96d069153b8cd79cc1b9ec2,0,GitHub,2019-12-27 20:33:33+01:00,['ff5c4d6db9af3edd915a2176a627d51eb3478da3'],0,3,3,915677,1,,,,2621
ffede2992284ee092f7bdc5b8333f4504c26ef3f,0,GitHub,2019-12-31 18:18:10+01:00,['af04ed8116c4698c169973def2c37f0e505a2f5c'],3,2,5,915682,2,,,,2621
c9f62a1602bc00b8a04995e8543f5a3378e094e0,0,Antonio Uccio Verardi,2019-12-31 18:47:23+01:00,['ffede2992284ee092f7bdc5b8333f4504c26ef3f'],2,2,4,915686,2,,,,2621
d6cf7c46c20973f4e2e4ef41c064a40fb616994d,0,Fokko Driesprong,2020-01-02 21:37:41+01:00,['e8f6b003aff981e6b96d069153b8cd79cc1b9ec2'],1,49,50,915736,4,0.921052632,0.921052632,0.921052632,2621
4cd778a7e0de048eacf2a06abe3d0e310bbcc343,1,GitHub,2020-01-04 13:45:53-05:00,['d6cf7c46c20973f4e2e4ef41c064a40fb616994d'],345,468,813,916549,21,0.181818182,0,1,2621
9c54c3db7374b833b2fde97e3ee4ee57e9d90447,0,Michael A. Smith,2020-01-10 19:56:56-05:00,['4cd778a7e0de048eacf2a06abe3d0e310bbcc343'],237,16,253,916802,3,,,,2621
912c15b36caacdea5cf3a6753316022156681470,1,Fokko Driesprong,2020-01-11 13:26:42+01:00,['9c54c3db7374b833b2fde97e3ee4ee57e9d90447'],2,75,77,916879,2,0.593220339,0.898305085,0.813559322,2621
5df740679737fdfb591213dff5bf1217a299c4c3,0,GitHub,2020-01-11 13:31:17+01:00,['912c15b36caacdea5cf3a6753316022156681470'],1,1,2,916881,1,,,,2621
b0f0131647b8f8277b3648cb95c10ef4810e5c26,0,GitHub,2020-01-11 13:31:35+01:00,['5df740679737fdfb591213dff5bf1217a299c4c3'],1,1,2,916883,1,,,,2621
760112a748a608f555c20fcaec0edaa404beaf91,0,GitHub,2020-01-11 13:32:23+01:00,['b0f0131647b8f8277b3648cb95c10ef4810e5c26'],1,1,2,916885,1,,,,2621
8efc875f16b079e8c26d1b1bbedf433099aaa4eb,0,GitHub,2020-01-12 13:24:39+01:00,['760112a748a608f555c20fcaec0edaa404beaf91'],1,1,2,916887,1,,,,2621
2fba6f606b08140d0ef75b610c028f1b7872e06a,1,GitHub,2020-01-13 11:44:41+01:00,['8efc875f16b079e8c26d1b1bbedf433099aaa4eb'],210,400,610,917497,18,0.173333333,0.56,0.56,2624
e8f54211db381ad3b54b59bdb2fe71adb4d53cd5,0,GitHub,2020-01-13 06:49:28-05:00,['2fba6f606b08140d0ef75b610c028f1b7872e06a'],31,29,60,917557,1,,,,2624
bcaa54576074a1f786f7ce88710502dd03ddc656,1,Fokko Driesprong,2020-01-14 16:24:21+01:00,['e8f54211db381ad3b54b59bdb2fe71adb4d53cd5'],0,5,5,917562,4,,,,2624
fe383d8eba8078a706620c8848efe7949efb8017,0,Ismaël Mejía,2020-01-15 11:16:20+01:00,['bcaa54576074a1f786f7ce88710502dd03ddc656'],3,3,6,917568,1,,,,2624
ac82a6ef35b7ca76c557d46471becc818846c35a,0,Michael A. Smith,2020-01-15 08:22:42-05:00,['fe383d8eba8078a706620c8848efe7949efb8017'],131,228,359,917927,7,1,1,0.826086957,2625
f621d9370005c0dee32295d4c1ad45a2b7c54f1c,0,GitHub,2020-01-17 13:45:18+01:00,['ac82a6ef35b7ca76c557d46471becc818846c35a'],1,1,2,917929,1,,,,2625
ced4d7f9f3802216db81fb015b450bc7ad507d66,0,GitHub,2020-01-17 13:45:33+01:00,['f621d9370005c0dee32295d4c1ad45a2b7c54f1c'],1,1,2,917931,1,,,,2625
84b056c2adc069cf31f3b4d3c9337cb7cdaa58d6,0,GitHub,2020-01-17 13:45:43+01:00,['ced4d7f9f3802216db81fb015b450bc7ad507d66'],1,1,2,917933,1,,,,2625
dd9ea675124713c7abff343d34e2812f01d6a718,0,GitHub,2020-01-21 16:40:59+01:00,['84b056c2adc069cf31f3b4d3c9337cb7cdaa58d6'],1,1,2,917935,1,,,,2625
ca38fb98f83e0345ca6c49b0660e9fbd03ea3cd5,0,Fokko Driesprong,2020-01-22 15:17:22+01:00,['dd9ea675124713c7abff343d34e2812f01d6a718'],51,6,57,917992,19,0.333333333,0.25,0.5,2625
3417ccd2dc11b0bf419d426998551808a91ab191,0,Antonio Uccio Verardi,2020-01-23 20:41:24+00:00,['c9f62a1602bc00b8a04995e8543f5a3378e094e0'],2,4,6,917998,3,,,,2625
183893ef8b9ae76cb6ea8492767c4a81c5b95d6d,0,GitHub,2020-01-23 20:44:03+00:00,['3417ccd2dc11b0bf419d426998551808a91ab191'],3,13,16,918014,2,0,0,1,2625
afbda0798a4fe662bd5379cf535da79800c4e840,0,RyanSkraba,2020-01-28 11:03:38+01:00,['ca38fb98f83e0345ca6c49b0660e9fbd03ea3cd5'],2,41,43,918057,2,0.482758621,0,0.482758621,2625
ce9032a4123e262341a3e746e6eb2b8476eae1ae,0,Ismaël Mejía,2020-01-31 10:41:11+01:00,['afbda0798a4fe662bd5379cf535da79800c4e840'],3,44,47,918104,2,1,1,1,2625
3ad0106f5fa15fbe718727016c600d14cd23294c,1,GitHub,2020-02-03 09:37:02+01:00,['ce9032a4123e262341a3e746e6eb2b8476eae1ae'],26,833,859,918963,9,0.611854685,0.715105163,0.923518164,2627
4a1e3acdc09de0545cbb6bfd4554604e64ca1a35,0,GitHub,2020-02-04 17:01:56+01:00,['3ad0106f5fa15fbe718727016c600d14cd23294c'],4,4,8,918971,3,,0,,2627
9bc2c62c6a82dbce260d4cc0277f1d0276063468,0,GitHub,2020-02-04 17:32:30+01:00,['4a1e3acdc09de0545cbb6bfd4554604e64ca1a35'],76,50,126,919097,3,0,0,0,2627
0d7eda62854b89badd7e217062212364354e5a0d,0,GitHub,2020-02-04 20:20:56-05:00,['9bc2c62c6a82dbce260d4cc0277f1d0276063468'],19,32,51,919148,1,0,0.444444444,0.555555556,2627
75e8f58c95e2b8c69af1a6f60c35a848a6781f0c,1,GitHub,2020-02-05 10:51:28+01:00,['0d7eda62854b89badd7e217062212364354e5a0d'],3,1900,1903,921051,26,0.857659831,0.943305187,0.886610374,2639
5c40cb12c9e2694ad1e47f22e275b6692893c96d,0,GitHub,2020-02-05 11:43:26+01:00,['75e8f58c95e2b8c69af1a6f60c35a848a6781f0c'],2,1,3,921054,1,1,1,0,2639
5c49fdae92df878c587b3ea74e5d3d2418d3a32d,0,GitHub,2020-02-05 11:44:46+01:00,['5c40cb12c9e2694ad1e47f22e275b6692893c96d'],17,16,33,921087,3,,,,2639
8e5a4ea769d925df95b4d4cde596a71248f2d3c5,0,GitHub,2020-02-06 10:12:55+01:00,['5c49fdae92df878c587b3ea74e5d3d2418d3a32d'],1,1,2,921089,1,,,,2639
335acc5770f7ad6bd6fdf4caa305373a79912d70,0,GitHub,2020-02-06 11:06:48+01:00,['8e5a4ea769d925df95b4d4cde596a71248f2d3c5'],3,11,14,921103,2,1,1,1,2639
b31bf3133c641679741aca01f1ea61b4959d96bc,0,Ismaël Mejía,2020-02-06 15:50:47+01:00,['335acc5770f7ad6bd6fdf4caa305373a79912d70'],2,2,4,921107,1,,,,2639
1430ccde8d7a7035138d45eb433941c5fdc50baf,0,Ismaël Mejía,2020-02-06 15:50:47+01:00,['b31bf3133c641679741aca01f1ea61b4959d96bc'],4,5,9,921116,2,1,1,0,2639
6d76044e2d3aaaf34fdb634dc2b1608e207ebcb8,0,Ismaël Mejía,2020-02-06 17:12:27+01:00,['1430ccde8d7a7035138d45eb433941c5fdc50baf'],1,1,2,921118,1,,,,2639
f7892a319e4f8bf35098cc74ca0cbfcf7a3f6fc0,0,RyanSkraba,2020-02-07 09:17:31+01:00,['6d76044e2d3aaaf34fdb634dc2b1608e207ebcb8'],1,1,2,921120,1,,,,2639
343c92e736d8fa7fce5974314b79bc2f01b00800,0,GitHub,2020-02-10 13:38:27+01:00,['f7892a319e4f8bf35098cc74ca0cbfcf7a3f6fc0'],20,16,36,921156,8,,,,2639
ad2a8933d45488e4b0b306d14e1be50a87c33cf3,1,GitHub,2020-02-11 12:54:10+01:00,['343c92e736d8fa7fce5974314b79bc2f01b00800'],1,1,2,921158,1,,,,2639
c50a87e1d4a92232b5ec13997549822b51a3c02e,0,GitHub,2020-02-11 15:33:49+01:00,['ad2a8933d45488e4b0b306d14e1be50a87c33cf3'],1,0,1,921159,1,1,1,0,2639
a439bf96f922fb065aed4fa8eb9f0fc43223482b,0,GitHub,2020-02-15 11:30:26-05:00,['c50a87e1d4a92232b5ec13997549822b51a3c02e'],10,32,42,921201,2,1,1,1,2639
eff3deecaa35562f6f78c37ed9d01bf44b6d8893,0,GitHub,2020-02-15 16:46:18-05:00,['a439bf96f922fb065aed4fa8eb9f0fc43223482b'],9,0,9,921210,1,0,0,0,2639
7c725541bb3672e47d6ba5579797ec84c12cbf13,0,Antonio Uccio Verardi,2020-02-16 23:40:33+00:00,['183893ef8b9ae76cb6ea8492767c4a81c5b95d6d'],1,8,9,921219,2,,,,2639
59d8c6d3105f364127658dca270c6babdda59ba3,0,Ismaël Mejía,2020-02-17 15:40:23+01:00,['eff3deecaa35562f6f78c37ed9d01bf44b6d8893'],1,1,2,921221,1,,,,2639
ca048907828d557eda64a4c1afdfbf279f28e286,0,GitHub,2020-02-17 16:47:18+01:00,['59d8c6d3105f364127658dca270c6babdda59ba3'],1,1,2,921223,1,,,,2639
53a7d9feef4b857be7dbe6aa5b2744b086384302,0,GitHub,2020-02-17 17:09:09+01:00,['ca048907828d557eda64a4c1afdfbf279f28e286'],20,20,40,921263,3,,,,2639
a65dca9bc4981b7788b51d3297323136e4f664ae,0,GitHub,2020-02-17 17:11:23+01:00,['53a7d9feef4b857be7dbe6aa5b2744b086384302'],3,2,5,921268,1,,,,2639
3812985c2d4219815c0521dc193fdf811afba0dc,0,GitHub,2020-02-19 09:09:52+01:00,['a65dca9bc4981b7788b51d3297323136e4f664ae'],38,30,68,921336,4,0,0,0,2639
37be95b0bd64b9ecc118d0ff8b30e734f94e4d3c,0,GitHub,2020-02-19 09:42:41+01:00,['3812985c2d4219815c0521dc193fdf811afba0dc'],5,1,6,921342,1,1,1,0,2639
1dbf61ee8cf2866e6e590388198e64c190af1e3f,0,Ismaël Mejía,2020-02-19 13:42:51+01:00,['37be95b0bd64b9ecc118d0ff8b30e734f94e4d3c'],2,3,5,921347,1,,,,2639
2e8ba13d8a6c126224db503537c9870ce225c19d,0,GitHub,2020-02-21 15:21:08+01:00,['1dbf61ee8cf2866e6e590388198e64c190af1e3f'],0,20,20,921367,1,,,,2639
ebe9080060e5dd46328fcdd9a05f073944af54ce,0,GitHub,2020-02-23 20:45:44+01:00,['2e8ba13d8a6c126224db503537c9870ce225c19d'],1,7,8,921375,2,0,0,1,2639
9cba8570aa5d9fab9371915b048caff6e05779a1,0,GitHub,2020-02-23 20:55:01+01:00,['ebe9080060e5dd46328fcdd9a05f073944af54ce'],2,7,9,921384,2,1,1,1,2639
8288df87e69d9332caa7202901f321c88f06de86,0,GitHub,2020-02-23 15:08:21-05:00,['9cba8570aa5d9fab9371915b048caff6e05779a1'],29,68,97,921481,3,1,0.944444444,0,2639
8199b9626e4badd34a85946cd223a91863f44cee,0,GitHub,2020-02-24 10:01:31+01:00,['8288df87e69d9332caa7202901f321c88f06de86'],2,119,121,921602,5,0.761904762,0.19047619,0.80952381,2640
9d26540d9259f8e05d32e9f300f171f2530a17cd,0,GitHub,2020-02-26 17:11:46+01:00,['8199b9626e4badd34a85946cd223a91863f44cee'],1,1,2,921604,1,,,,2640
17be402804cd0264d89e94d7b6f8b2d595008656,0,Ismaël Mejía,2020-02-26 20:04:44+01:00,['9d26540d9259f8e05d32e9f300f171f2530a17cd'],93,62,155,921759,2,,,,2640
9741c08ae2ffe06adbf3559b5c5702d9bf8cae3c,0,GitHub,2020-03-02 09:27:54+01:00,['17be402804cd0264d89e94d7b6f8b2d595008656'],8,25,33,921792,11,,,,2640
791ec6017b03e3cc79fbf546dd9d79d20d476b4e,0,GitHub,2020-03-02 09:37:37+01:00,['9741c08ae2ffe06adbf3559b5c5702d9bf8cae3c'],1,1,2,921794,1,,,,2640
173e4c5a2bd9bd8d59aa6aabad2c8f00f7cb888f,0,GitHub,2020-03-22 22:34:22+00:00,['7c725541bb3672e47d6ba5579797ec84c12cbf13'],7,7,14,921808,3,,,,2640
0bcb437666358cd4f226351a41ab4ccc9d43ee9f,0,GitHub,2020-03-24 00:13:37+00:00,['173e4c5a2bd9bd8d59aa6aabad2c8f00f7cb888f'],25,8,33,921841,3,0.666666667,0.666666667,0,2640
40622368863c19f9b103927b85af9dd65d18aedb,0,GitHub,2020-03-29 12:36:06+02:00,['791ec6017b03e3cc79fbf546dd9d79d20d476b4e'],17,6,23,921864,1,1,1,1,2640
1fe960ef7b3da9222a38db443f56461466114f8f,0,GitHub,2020-03-29 12:36:50+02:00,['40622368863c19f9b103927b85af9dd65d18aedb'],16,14,30,921894,1,0,0,1,2640
7c44eef21561056aa0637c72f0f6be0bfd95a292,0,GitHub,2020-03-29 12:37:48+02:00,['1fe960ef7b3da9222a38db443f56461466114f8f'],4,44,48,921942,2,1,1,1,2641
da132659c4676ede53aabb66ebd943b8232a18f3,1,GitHub,2020-03-29 12:38:29+02:00,['7c44eef21561056aa0637c72f0f6be0bfd95a292'],34,20,54,921996,4,0,0.166666667,0,2641
87aefa28ad6cb11ab95010cdeac2223cfb701c0d,0,GitHub,2020-03-29 12:39:10+02:00,['da132659c4676ede53aabb66ebd943b8232a18f3'],7,15,22,922018,1,1,1,1,2641
3336bd159f49812e7ef995f7ad3d5b7a995598b5,0,GitHub,2020-04-02 00:22:19+01:00,['0bcb437666358cd4f226351a41ab4ccc9d43ee9f'],6,6,12,922030,2,,,,2641
c81ea58c601a2f600d9d45cf50b9f6434b911d5a,0,GitHub,2020-04-02 15:31:14-07:00,['87aefa28ad6cb11ab95010cdeac2223cfb701c0d'],2,27,29,922059,2,0.894736842,0.894736842,1,2641
d5d1cd70e920f45468bf696d3668b496a9adbab3,1,GitHub,2020-04-04 11:44:03+02:00,['c81ea58c601a2f600d9d45cf50b9f6434b911d5a'],3,21,24,922083,2,1,1,1,2641
01e039ca12ade8bc08b6b4b33ef87a32f3f06b88,0,GitHub,2020-04-11 08:50:01+02:00,['d5d1cd70e920f45468bf696d3668b496a9adbab3'],1,12,13,922096,2,1,1,1,2641
9af218d3c060da103868cdc69d7b39fc8d50dcbc,0,GitHub,2020-04-11 08:54:34+02:00,['01e039ca12ade8bc08b6b4b33ef87a32f3f06b88'],1,1,2,922098,1,,,,2641
1f8af338d81e0eebfc01116f6a1cfe4bfb5d2484,1,GitHub,2020-04-15 22:31:09+01:00,['3336bd159f49812e7ef995f7ad3d5b7a995598b5'],32,1044,1076,923174,2,0.002538071,0.885786802,0.730964467,2641
4e89943c1adcb0c05cbd6c3611b60849fabdeb16,0,Antonio Uccio Verardi,2020-04-15 22:35:47+01:00,['1f8af338d81e0eebfc01116f6a1cfe4bfb5d2484'],1,5,6,923180,2,,,,2641
6b0d470a79b4c4e10d9890183d6c913608a2a225,0,GitHub,2020-04-20 10:58:31+02:00,['9af218d3c060da103868cdc69d7b39fc8d50dcbc'],1,2,3,923183,1,,,,2641
97c2aeb6ca5186524e8576febfe44b1a03a1b97e,0,GitHub,2020-04-22 20:50:06+02:00,['6b0d470a79b4c4e10d9890183d6c913608a2a225'],10,8,18,923201,2,0,0,0,2641
8e345c48e8f9708c27af63754965777314dac85c,1,GitHub,2020-04-22 21:27:17+02:00,['97c2aeb6ca5186524e8576febfe44b1a03a1b97e'],0,3,3,923204,1,1,1,1,2641
f7f03f3c73c4fbd1da98e6a5068eca917520a649,1,GitHub,2020-04-24 19:42:36+01:00,['4e89943c1adcb0c05cbd6c3611b60849fabdeb16'],180,1443,1623,924827,11,1,0.346405229,0,2643
9837a4d21c252f1b6a9cd68ca32d551c0a1d0101,0,GitHub,2020-04-24 20:04:42+01:00,['f7f03f3c73c4fbd1da98e6a5068eca917520a649'],30,51,81,924908,2,0.131964809,1,0.391495601,2643
3d774b913a798dd7e88c31b6d1611853efacfe75,0,Antonio Uccio Verardi,2020-04-24 20:10:30+01:00,['9837a4d21c252f1b6a9cd68ca32d551c0a1d0101'],1,5,6,924914,2,,,,2643
85d8c450153e104be160a1b8d0342c41fe1b3164,0,GitHub,2020-04-24 21:02:39+01:00,['3d774b913a798dd7e88c31b6d1611853efacfe75'],118,162,280,925194,5,0.195121951,0,0,2643
7a80378aa83131cca4b2ccc810db6c92025284e3,0,Antonio Uccio Verardi,2020-04-24 21:03:48+01:00,['85d8c450153e104be160a1b8d0342c41fe1b3164'],4,0,4,925198,1,,,,2643
f679ac74a6c9132a609fbadff692a7e32c27869f,0,Antonio Uccio Verardi,2020-04-24 21:05:06+01:00,['7a80378aa83131cca4b2ccc810db6c92025284e3'],0,2,2,925200,1,,,,2643
83baa43d0776fca48aeb99918076ca5270b7ce41,0,Antonio Uccio Verardi,2020-04-25 01:46:05+01:00,['f679ac74a6c9132a609fbadff692a7e32c27869f'],8,26,34,925234,2,,,,2643
4c184f6bcb299a48e1d38045a0f429730297bef6,0,Antonio Uccio Verardi,2020-04-25 01:46:47+01:00,['83baa43d0776fca48aeb99918076ca5270b7ce41'],0,4,4,925238,1,,,,2643
1a9d3ae816468d0640c9fbe0ce54ab4b44ed61aa,0,GitHub,2020-04-25 02:06:47+01:00,['4c184f6bcb299a48e1d38045a0f429730297bef6'],1,1,2,925240,1,,,,2643
958917550ade0fa95af47c1f394d0dfb06f1d052,0,Antonio Uccio Verardi,2020-04-25 02:19:28+01:00,['1a9d3ae816468d0640c9fbe0ce54ab4b44ed61aa'],5,2,7,925247,2,,,,2643
d336babe3e0a11d90613083de72652f358207b29,0,GitHub,2020-04-26 10:05:44+02:00,['8e345c48e8f9708c27af63754965777314dac85c'],1,0,1,925248,1,,,,2643
b6f49705ad3cc81020117d04938e1ae03d3a99d9,0,GitHub,2020-04-26 11:25:25+02:00,['d336babe3e0a11d90613083de72652f358207b29'],1,1,2,925250,1,,,,2643
f56cafb83854a7529625bd1d82521f5848399ccc,0,GitHub,2020-04-26 11:26:20+02:00,['b6f49705ad3cc81020117d04938e1ae03d3a99d9'],2,7,9,925259,4,,,,2643
d83e43b3cf087aa1911befd39e9df0c9f5e82628,0,GitHub,2020-04-26 12:00:59+02:00,['f56cafb83854a7529625bd1d82521f5848399ccc'],2,2,4,925263,1,,,,2643
86b45873fd192e4ed9ccdf2400a30cf0e5f99a69,1,GitHub,2020-04-26 20:33:48+01:00,['958917550ade0fa95af47c1f394d0dfb06f1d052'],143,137,280,925543,10,1,0.857142857,0.142857143,2643
5acbfbfbc53a58774a8492a284ebca3a6670d52c,0,GitHub,2020-04-26 20:35:47+01:00,['86b45873fd192e4ed9ccdf2400a30cf0e5f99a69'],125,119,244,925787,2,1,0,1,2643
771c16b521e34e721e31bb2caf9f86699ea10dff,0,GitHub,2020-04-27 08:53:18-04:00,['d83e43b3cf087aa1911befd39e9df0c9f5e82628'],64,89,153,925940,2,1,1,0.16,2643
067af1875257a11438a3f35cc576b152b0e6ac9c,0,Ismaël Mejía,2020-04-28 13:27:28+02:00,['771c16b521e34e721e31bb2caf9f86699ea10dff'],1,1,2,925942,1,,,,2643
7d372932c08e10ef04e060c138949dfd7c714616,0,GitHub,2020-04-28 14:13:31-04:00,['067af1875257a11438a3f35cc576b152b0e6ac9c'],44,107,151,926093,11,0,0,0,2644
1dca808f1294056cd804af4f7bd417bc1917fe8a,0,GitHub,2020-04-29 23:08:08-04:00,['7d372932c08e10ef04e060c138949dfd7c714616'],10,74,84,926177,5,0,0,0,2646
cfb6a12a5eba4ebcef1e04f53b19728d6da9aa5c,0,GitHub,2020-04-30 09:54:22-07:00,['1dca808f1294056cd804af4f7bd417bc1917fe8a'],43,211,254,926431,3,0.848484848,0.848484848,0.727272727,2646
02f12b87b7a8254b5169c479d44d0e1a5952f1c7,0,GitHub,2020-05-01 09:01:21-04:00,['cfb6a12a5eba4ebcef1e04f53b19728d6da9aa5c'],5486,5686,11172,937603,35,0.035714286,0.714285714,0.714285714,2646
477c71e3e11f0bfb0ccb927e8f4d3449e95e25ec,0,GitHub,2020-05-02 20:34:17+01:00,['5acbfbfbc53a58774a8492a284ebca3a6670d52c'],31,40,71,937674,2,0,1,1,2646
5b7e52e9aed348415422cb8b887b0806afd9ca65,0,Antonio Uccio Verardi,2020-05-02 20:36:12+01:00,['477c71e3e11f0bfb0ccb927e8f4d3449e95e25ec'],1,0,1,937675,1,,,,2646
d7aa0a8cb33fd3511f056464985697359069705e,0,Antonio Uccio Verardi,2020-05-02 20:41:54+01:00,['5b7e52e9aed348415422cb8b887b0806afd9ca65'],2,3,5,937680,2,,,,2646
07fd336c6e5cc052931405b7257d9d06b5337d7c,0,GitHub,2020-05-03 09:12:03+02:00,['02f12b87b7a8254b5169c479d44d0e1a5952f1c7'],0,10,10,937690,2,0,0.333333333,1,2646
40196080593557380d8e9ad5bc588a61dc5de93e,0,GitHub,2020-05-03 09:30:34+02:00,['07fd336c6e5cc052931405b7257d9d06b5337d7c'],10,109,119,937809,6,0.322222222,0.988888889,0.933333333,2646
d5c1ad2d7facc3f328b51dd0f9b736d925217e39,0,GitHub,2020-05-03 09:50:28+02:00,['40196080593557380d8e9ad5bc588a61dc5de93e'],12,12,24,937833,1,,,,2646
5f7b068663671bb1d4a810c35e3a4a55815bc1ef,0,GitHub,2020-05-04 22:04:04+02:00,['d5c1ad2d7facc3f328b51dd0f9b736d925217e39'],5,5,10,937843,1,,,,2646
285bda86d3f49aa5054d4fd1487680bb1accd8ac,0,GitHub,2020-05-06 19:13:45+02:00,['5f7b068663671bb1d4a810c35e3a4a55815bc1ef'],285,10,295,938138,4,,,,2646
7ab212b8e454c271797fc343204762ca1b925057,0,GitHub,2020-05-09 09:11:22+02:00,['285bda86d3f49aa5054d4fd1487680bb1accd8ac'],7,9,16,938154,5,,,,2646
9c80782e3df8f025726ef6d7ccbba4817482082d,0,GitHub,2020-05-09 09:13:38+02:00,['7ab212b8e454c271797fc343204762ca1b925057'],1,74,75,938229,3,0.677966102,0.677966102,0.881355932,2646
b5a3c44d223d781fed2572cb4ed6f11ca431f25f,0,GitHub,2020-05-09 09:15:40+02:00,['9c80782e3df8f025726ef6d7ccbba4817482082d'],1,37,38,938267,2,1,1,1,2646
bcad995f4a70fe756decb9023575e0027c1243c0,0,GitHub,2020-05-09 09:32:17+02:00,['b5a3c44d223d781fed2572cb4ed6f11ca431f25f'],1,46,47,938314,7,0.222222222,0.962962963,0.888888889,2646
d916ca2c1ceaabb5fc002630171255dfcdf8d882,0,GitHub,2020-05-11 08:56:03+02:00,['bcad995f4a70fe756decb9023575e0027c1243c0'],1,1,2,938316,1,,,,2646
46d87d9aa8964684e602f114292825b9fd5c2554,0,GitHub,2020-05-11 08:59:21+02:00,['d916ca2c1ceaabb5fc002630171255dfcdf8d882'],28,22,50,938366,9,0,0,0,2646
384c355b976e107cff11a85b9fe2658e1f335792,0,Ismaël Mejía,2020-05-13 18:57:32+02:00,['46d87d9aa8964684e602f114292825b9fd5c2554'],0,26,26,938392,1,,,,2647
f50faa9c6bdc0ad9bc8db308b74668fa93644102,0,Ismaël Mejía,2020-05-13 18:57:32+02:00,['384c355b976e107cff11a85b9fe2658e1f335792'],0,51,51,938443,1,,,,2648
f93cd266d3031e35463a6bfc4aeee92a7550b260,0,Ismaël Mejía,2020-05-13 19:05:54+02:00,['f50faa9c6bdc0ad9bc8db308b74668fa93644102'],2,1,3,938446,1,,,,2648
8f4134a09f8cb707cd7f0de784ecda20234c818f,0,Ismaël Mejía,2020-05-13 19:25:05+02:00,['f93cd266d3031e35463a6bfc4aeee92a7550b260'],1,0,1,938447,1,,,,2648
e813aff84591724b237c1943e5d20b27d8d50bf4,0,GitHub,2020-05-13 20:48:46+02:00,['8f4134a09f8cb707cd7f0de784ecda20234c818f'],0,1,1,938448,1,,,,2648
4898556ee5455231645fc9c4c2e9cc7014dec1c0,0,GitHub,2020-05-13 20:50:02+02:00,['e813aff84591724b237c1943e5d20b27d8d50bf4'],0,6,6,938454,1,,,,2648
bfd5906795df1ddf830f96a1b3b5013968e6b829,0,Daniel Kulp,2020-05-15 13:26:40-04:00,['4898556ee5455231645fc9c4c2e9cc7014dec1c0'],1,1,2,938456,1,,,,2648
b2c58098704b9ffc70e40f657915fe820126e3d7,0,Daniel Kulp,2020-05-15 13:52:28-04:00,['bfd5906795df1ddf830f96a1b3b5013968e6b829'],3,2,5,938461,1,,,,2648
2b398cf179330ef545f2cae0daecd86a4aa3ac89,0,Daniel Kulp,2020-05-15 13:53:23-04:00,['b2c58098704b9ffc70e40f657915fe820126e3d7'],0,1,1,938462,1,,,,2648
414a51fdc1856083bb16851f09a4c61a48796132,0,Daniel Kulp,2020-05-15 13:55:15-04:00,['2b398cf179330ef545f2cae0daecd86a4aa3ac89'],29,1,30,938492,3,0,0,0,2648
32436402057df32011ebccf17ff9ba81e86b0130,0,Daniel Kulp,2020-05-15 13:55:23-04:00,['414a51fdc1856083bb16851f09a4c61a48796132'],1,1,2,938494,1,,,,2648
29fe2f612fc1420ad66d30859d424372098e9ff1,0,Daniel Kulp,2020-05-15 13:55:23-04:00,['32436402057df32011ebccf17ff9ba81e86b0130'],1,1,2,938496,1,,,,2648
69cc41c17eefd8a8e6c28cc5ed67a2246cbb1ca0,0,Daniel Kulp,2020-05-15 14:11:53-04:00,['29fe2f612fc1420ad66d30859d424372098e9ff1'],2,85,87,938583,4,,,,2648
1eb2eb7212d2c63cb96299de2f319c9f2a5a8162,0,GitHub,2020-05-17 16:50:56+02:00,['69cc41c17eefd8a8e6c28cc5ed67a2246cbb1ca0'],70,86,156,938739,9,0,0,0,2651
efd6cda8bf9a025ca2847fe8900ac590305facf6,0,GitHub,2020-05-19 16:56:00+02:00,['1eb2eb7212d2c63cb96299de2f319c9f2a5a8162'],2,22,24,938763,2,0.666666667,0.666666667,1,2651
f106abdb13fb1fd9e6dfaf6a417dece75b9c74ac,0,Daniel Kulp,2020-05-20 10:32:41-04:00,['efd6cda8bf9a025ca2847fe8900ac590305facf6'],20,25,45,938808,4,,,,2651
7e7681a6882b1815fc2762beef42e053f440f0f8,0,Daniel Kulp,2020-05-20 10:46:41-04:00,['f106abdb13fb1fd9e6dfaf6a417dece75b9c74ac'],1,1,2,938810,1,,,,2651
94b6a1fc495f4681a1dfd750effb739d6446dd60,0,Daniel Kulp,2020-05-20 10:50:01-04:00,['7e7681a6882b1815fc2762beef42e053f440f0f8'],2,2,4,938814,1,,,,2651
af429f7ea599d64becbef80a5cf8ac0fba3e85dc,0,Daniel Kulp,2020-05-20 10:56:44-04:00,['94b6a1fc495f4681a1dfd750effb739d6446dd60'],2,2,4,938818,1,,,,2651
c536a358e19644e3dc6b646b3ee541f531d6cc6c,0,GitHub,2020-05-21 12:18:02+02:00,['af429f7ea599d64becbef80a5cf8ac0fba3e85dc'],18,67,85,938903,5,1,1,1,2651
207035aaf405ce468902e86d8d64f096a5a812b2,1,Daniel Kulp,2020-05-21 08:06:42-04:00,['c536a358e19644e3dc6b646b3ee541f531d6cc6c'],2,119,121,939024,1,0,0,1,2651
88538e9f1d6be236ce69ea2e0bdd6eed352c503e,0,Daniel Kulp,2020-05-21 08:33:55-04:00,['207035aaf405ce468902e86d8d64f096a5a812b2'],47,63,110,939134,1,0,0,0.571428571,2651
833127d6ed09618babd1cce10053d5f183740dab,0,Daniel Kulp,2020-05-21 09:00:55-04:00,['88538e9f1d6be236ce69ea2e0bdd6eed352c503e'],4,6,10,939144,1,,,,2651
5e8537c3363a8fe3076295e5c8f3ae229991314f,0,Daniel Kulp,2020-05-21 09:42:28-04:00,['833127d6ed09618babd1cce10053d5f183740dab'],1,1,2,939146,1,,,,2651
1b1e4ba8172c083f65f3e400ab070570a3bb278a,0,Daniel Kulp,2020-05-21 09:52:08-04:00,['5e8537c3363a8fe3076295e5c8f3ae229991314f'],0,18,18,939164,2,,,,2652
258b917d5b3e00152d25de8f1a750bbe857afcfc,0,Daniel Kulp,2020-05-21 09:52:08-04:00,['1b1e4ba8172c083f65f3e400ab070570a3bb278a'],0,0,0,939164,1,,,,2652
b7948f40ca3de4edcb1ac1d10bd932b33a2c71d9,0,Daniel Kulp,2020-05-21 09:52:08-04:00,['258b917d5b3e00152d25de8f1a750bbe857afcfc'],0,17,17,939181,1,,,,2652
f5d2f11972d53eca4e6ce6f8b0e16218a7c4d6c7,0,Daniel Kulp,2020-05-21 09:54:24-04:00,['b7948f40ca3de4edcb1ac1d10bd932b33a2c71d9'],1,28,29,939210,5,0,0.541666667,1,2652
bb31f109c34212e4077518d95671429587bec2db,0,Daniel Kulp,2020-05-21 09:56:06-04:00,['f5d2f11972d53eca4e6ce6f8b0e16218a7c4d6c7'],6,9,15,939225,1,,,,2652
dcb8c5b25776f1d2434ac28587c68106998b4b37,0,Daniel Kulp,2020-05-21 10:01:05-04:00,['bb31f109c34212e4077518d95671429587bec2db'],0,19,19,939244,1,,,,2652
b9bfc07c43140ef0aa58340430ab3c4909337f21,0,Daniel Kulp,2020-05-21 10:08:56-04:00,['dcb8c5b25776f1d2434ac28587c68106998b4b37'],0,1,1,939245,1,,,,2652
eb21a2148b552d3df2db251558c7986ffb2bc833,0,Daniel Kulp,2020-05-21 10:11:07-04:00,['b9bfc07c43140ef0aa58340430ab3c4909337f21'],4,54,58,939303,5,,,,2652
ef85cd4099dc645bcd853ceb60e44ff93b4840f0,0,Daniel Kulp,2020-05-21 10:13:16-04:00,['eb21a2148b552d3df2db251558c7986ffb2bc833'],3,5,8,939311,1,,,,2652
b9efa050bac3aa5e67ad659f8d4bb972a0b5d2dc,0,Daniel Kulp,2020-05-21 10:13:16-04:00,['ef85cd4099dc645bcd853ceb60e44ff93b4840f0'],1,1,2,939313,1,,,,2652
efc7cbb8f6b586569903bda469a21b442e461108,0,Daniel Kulp,2020-05-21 10:17:45-04:00,['b9efa050bac3aa5e67ad659f8d4bb972a0b5d2dc'],83,141,224,939537,6,1,1,1,2653
f301980140db3c8506baa43a40ded48a7c2e2c40,0,Daniel Kulp,2020-05-21 10:39:29-04:00,['efc7cbb8f6b586569903bda469a21b442e461108'],36,54,90,939627,4,0.642857143,1,1,2653
641193688c0ec49a46af041d2d7b7fe1e8f108ec,0,Daniel Kulp,2020-05-21 10:39:29-04:00,['f301980140db3c8506baa43a40ded48a7c2e2c40'],8,4,12,939639,1,0,0,0,2653
acce806f68282a2b02f07e06ab304d2ae3fc308e,0,Daniel Kulp,2020-05-21 11:05:50-04:00,['641193688c0ec49a46af041d2d7b7fe1e8f108ec'],6,548,554,940193,5,0.711610487,0.734082397,0.928838951,2655
331587a27f93880a910985ea6a42125d3878bb16,0,Daniel Kulp,2020-05-21 11:08:55-04:00,['acce806f68282a2b02f07e06ab304d2ae3fc308e'],29,31,60,940253,8,,,,2655
a57f7537594dd10c85d3ecdeab1d193436e6a978,0,Daniel Kulp,2020-05-21 11:08:55-04:00,['331587a27f93880a910985ea6a42125d3878bb16'],7,4,11,940264,4,,,,2655
7baac0fbb5b8ff9d42e97e2dd65936318ae7f5c7,0,Daniel Kulp,2020-05-21 11:09:57-04:00,['a57f7537594dd10c85d3ecdeab1d193436e6a978'],0,8,8,940272,1,,,,2655
192cd3b8d607ce77a268f99ab4e3450597d882db,0,Daniel Kulp,2020-05-21 11:09:57-04:00,['7baac0fbb5b8ff9d42e97e2dd65936318ae7f5c7'],0,6,6,940278,1,,,,2655
b0c09361fe985fe57858f19485b43e1deeec8d89,0,Daniel Kulp,2020-05-21 11:09:57-04:00,['192cd3b8d607ce77a268f99ab4e3450597d882db'],0,16,16,940294,1,1,1,1,2655
ccb95a6763d53eaa5ba24ced3531096bac390d3a,0,Daniel Kulp,2020-05-21 11:12:59-04:00,['b0c09361fe985fe57858f19485b43e1deeec8d89'],1,1,2,940296,1,,,,2655
7347e25381f170a28d6ab081e08ddf4b3354b8fe,0,Daniel Kulp,2020-05-21 11:18:59-04:00,['ccb95a6763d53eaa5ba24ced3531096bac390d3a'],1,159,160,940456,3,0.853658537,0.853658537,1,2655
cb0d6e88a4f0c985a2ecceab3be77dadd874e3cb,0,Daniel Kulp,2020-05-21 11:27:30-04:00,['7347e25381f170a28d6ab081e08ddf4b3354b8fe'],5,5,10,940466,1,,,,2655
8c15c1241fb52f3ce6eb480bbe16ff70d3bc426a,0,Daniel Kulp,2020-05-21 11:27:30-04:00,['cb0d6e88a4f0c985a2ecceab3be77dadd874e3cb'],2,26,28,940494,1,,,,2655
2c238747755a19fe6acce107b6fb1ce7d1984563,0,Daniel Kulp,2020-05-21 11:29:50-04:00,['8c15c1241fb52f3ce6eb480bbe16ff70d3bc426a'],4,4,8,940502,1,,,,2655
74ad244741a391450610f4d273172707ae2b9a80,0,Daniel Kulp,2020-05-21 11:29:50-04:00,['2c238747755a19fe6acce107b6fb1ce7d1984563'],11,28,39,940541,1,1,1,1,2655
97e05457f55e3f51dd8279df1247be65125d767a,0,Daniel Kulp,2020-05-21 11:29:50-04:00,['74ad244741a391450610f4d273172707ae2b9a80'],9,13,22,940563,1,,,,2655
58569bd5dc678a753c8a456e29d78462228b9a29,0,Daniel Kulp,2020-05-21 11:30:51-04:00,['97e05457f55e3f51dd8279df1247be65125d767a'],4,4,8,940571,1,,,,2655
dab5fbe35e7bafcf86eb587cf4c6a898ea57f673,0,Daniel Kulp,2020-05-21 11:45:22-04:00,['58569bd5dc678a753c8a456e29d78462228b9a29'],26,28,54,940625,4,1,1,1,2655
ecc489ce5dc069a8fe8d047d9297ff11827010e6,0,Daniel Kulp,2020-05-21 11:46:25-04:00,['dab5fbe35e7bafcf86eb587cf4c6a898ea57f673'],0,56,56,940681,2,,,,2655
b534b8ba924cd7515ec71bd0c0898153952c6eba,0,Daniel Kulp,2020-05-21 11:49:33-04:00,['ecc489ce5dc069a8fe8d047d9297ff11827010e6'],210,270,480,941161,26,0,0.981818182,0.909090909,2655
3c8a4d4514e80788611710d92b2ac7880714507b,0,Daniel Kulp,2020-05-21 12:00:12-04:00,['b534b8ba924cd7515ec71bd0c0898153952c6eba'],0,27,27,941188,3,1,1,0.590909091,2655
734ea36dfe00fb70b506b4e987f0ad8341bcad94,0,Daniel Kulp,2020-05-22 07:58:44-04:00,['3c8a4d4514e80788611710d92b2ac7880714507b'],0,18,18,941206,1,1,1,1,2655
086a15f04cc16dc1ee6a6259e31f5339f2ade840,0,Daniel Kulp,2020-05-22 08:11:52-04:00,['734ea36dfe00fb70b506b4e987f0ad8341bcad94'],2,18,20,941226,3,0,0,0,2655
87656846db4684591ec13484f2e2347f6e1b68d0,0,Daniel Kulp,2020-05-22 08:11:52-04:00,['086a15f04cc16dc1ee6a6259e31f5339f2ade840'],3,3,6,941232,1,,,,2655
dfd3dd64bed7f783b0d33c7688a440235ecfc0f3,0,Daniel Kulp,2020-05-22 08:11:52-04:00,['87656846db4684591ec13484f2e2347f6e1b68d0'],1,1,2,941234,1,,,,2655
3a098e8be4944216f811211c9e3240fd6f67a4ae,0,GitHub,2020-05-22 08:17:43-04:00,['dfd3dd64bed7f783b0d33c7688a440235ecfc0f3'],21,41,62,941296,10,0,1,1,2655
61f162de6f441f65297cf8b57c0e8c36474be7d6,1,GitHub,2020-05-22 08:26:16-04:00,['3a098e8be4944216f811211c9e3240fd6f67a4ae'],80,224,304,941600,12,1,1,0.875,2657
13405739ccf0ac3b10d3ac66c6d2cc87ddfac3a2,0,Daniel Kulp,2020-05-22 08:30:02-04:00,['61f162de6f441f65297cf8b57c0e8c36474be7d6'],6,156,162,941762,4,0.411764706,1,0.147058824,2657
2d8c857a291ab61ee32e3e2b8ced02f6af6a5c76,0,GitHub,2020-05-22 08:33:51-04:00,['13405739ccf0ac3b10d3ac66c6d2cc87ddfac3a2'],26,255,281,942043,3,0.284671533,1,0.430656934,2657
3226f4ef7eab4e27b10b5a5266de15f78849c3db,0,Daniel Kulp,2020-05-22 08:35:15-04:00,['2d8c857a291ab61ee32e3e2b8ced02f6af6a5c76'],4,4,8,942051,2,,,,2657
005a39123a67b8fa81d985a63239c4f6a5096c34,0,Daniel Kulp,2020-05-22 08:36:51-04:00,['3226f4ef7eab4e27b10b5a5266de15f78849c3db'],20,81,101,942152,6,1,1,1,2657
da680e43943ef18f12443e2a7b21bb9258dfa827,0,Daniel Kulp,2020-05-22 09:48:59-04:00,['005a39123a67b8fa81d985a63239c4f6a5096c34'],2,2,4,942156,1,,,,2657
4318701a20e8b0131374e63ccd263338ea57891c,0,Daniel Kulp,2020-05-22 14:04:55-04:00,['da680e43943ef18f12443e2a7b21bb9258dfa827'],7,196,203,942359,3,0.705882353,1,0.717647059,2659
e208f4b2d442bc14aaba3dad86e8122b83a0873c,0,Daniel Kulp,2020-05-22 17:24:34-04:00,['4318701a20e8b0131374e63ccd263338ea57891c'],71,95,166,942525,21,1,1,1,2659
5f064c0d162ea3bb2a28b576c590638052177054,0,Daniel Kulp,2020-05-22 18:06:04-04:00,['e208f4b2d442bc14aaba3dad86e8122b83a0873c'],1,1,2,942527,1,,,,2659
9d6a4cf2d814d1efda5caf855b3a89d8a997c6e0,0,Daniel Kulp,2020-05-24 10:25:11-04:00,['5f064c0d162ea3bb2a28b576c590638052177054'],6,6,12,942539,1,,,,2659
ad63705b30504ba385cde76c530a524843adf0fc,0,Daniel Kulp,2020-05-26 08:07:20-04:00,['9d6a4cf2d814d1efda5caf855b3a89d8a997c6e0'],1,1,2,942541,1,,,,2659
6f431fa1717b4557768cb274524874d064485dfc,0,GitHub,2020-05-26 08:09:14-04:00,['ad63705b30504ba385cde76c530a524843adf0fc'],24,52,76,942617,1,0.9375,0.9375,1,2659
f30a7caee322f8679d90595f3f3d00549cdb6d29,1,GitHub,2020-05-26 08:16:12-04:00,['6f431fa1717b4557768cb274524874d064485dfc'],5415,6992,12407,955024,65,0.11754386,0.924561404,0.822807018,2697
664c2fc7fba19709c1f974055f9cf4c8a799e108,1,Daniel Kulp,2020-05-26 08:34:45-04:00,['f30a7caee322f8679d90595f3f3d00549cdb6d29'],9,11,20,955044,2,,,,2697
ab83dcd6fee848cb0a82a9da328e114cc9e3568b,1,GitHub,2020-05-26 15:53:36+02:00,['664c2fc7fba19709c1f974055f9cf4c8a799e108'],6,72,78,955122,5,1,1,0.363636364,2698
d3a2b149aa92608956fb0b163eb1bea06ef2c05a,0,Daniel Kulp,2020-05-26 09:59:02-04:00,['ab83dcd6fee848cb0a82a9da328e114cc9e3568b'],0,1,1,955123,1,0,0,1,2698
a565690bdaeb9ad1cc296f3832eb45384dded2a8,0,GitHub,2020-05-26 10:58:35-04:00,['d3a2b149aa92608956fb0b163eb1bea06ef2c05a'],0,7,7,955130,1,,,,2698
1e77a401b951a481b8175e9e5f99afeebd9acf75,0,Daniel Kulp,2020-05-26 11:01:28-04:00,['a565690bdaeb9ad1cc296f3832eb45384dded2a8'],11,19,30,955160,1,0,1,0.625,2698
d2d5663076d9c4a5b92b7102a21217a5c8cf6115,1,Daniel Kulp,2020-05-26 11:23:58-04:00,['1e77a401b951a481b8175e9e5f99afeebd9acf75'],470,316,786,955946,15,0,0,0.407407407,2698
4c0dccbaf557ae6a769f8d397b1be4e14ef979af,0,Daniel Kulp,2020-05-26 12:04:52-04:00,['d2d5663076d9c4a5b92b7102a21217a5c8cf6115'],3,0,3,955949,1,,,,2698
3bf7356376ff176d17960814fad62f13f66c3a4d,0,GitHub,2020-05-26 12:48:00-04:00,['4c0dccbaf557ae6a769f8d397b1be4e14ef979af'],16,63,79,956028,3,1,1,1,2698
7fd098a56064ece218c66ba1d2ad78bd358f6009,0,GitHub,2020-05-26 12:57:18-04:00,['3bf7356376ff176d17960814fad62f13f66c3a4d'],10,39,49,956077,2,0,0.9,0.9,2698
a6a0346b4aae937f8e19e928d7c45f85cde09ba2,0,Daniel Kulp,2020-05-26 13:01:31-04:00,['7fd098a56064ece218c66ba1d2ad78bd358f6009'],5,8,13,956090,2,0,0,1,2698
ccbbb8353fcc168563c567580cb773d5fe442704,0,GitHub,2020-05-26 13:06:52-04:00,['a6a0346b4aae937f8e19e928d7c45f85cde09ba2'],8,326,334,956424,11,0.969465649,1,0.923664122,2702
e3b06fb914abc05c0fc232e54be94883b784dff6,0,GitHub,2020-05-29 10:57:50+02:00,['ccbbb8353fcc168563c567580cb773d5fe442704'],4,20,24,956448,2,0,1,0.833333333,2702
1c5e32d2b98e193ea048f8ece8ee3984c6165bfe,0,Daniel Kulp,2020-05-29 09:09:45-04:00,['e3b06fb914abc05c0fc232e54be94883b784dff6'],15,18,33,956481,1,0,0,0,2702
49263e7ae117252bdf225499b6fdfb81bac71605,0,Ismaël Mejía,2020-05-29 15:39:40+02:00,['1c5e32d2b98e193ea048f8ece8ee3984c6165bfe'],2,2,4,956485,1,,,,2702
34c5e7b3b542c0e0b33747086c3cba7bc73b4904,0,Ismaël Mejía,2020-05-29 17:29:40+02:00,['49263e7ae117252bdf225499b6fdfb81bac71605'],1,1,2,956487,1,,,,2702
0281256d42c19bb45e4dc84f8ab7c35e45edd138,0,Daniel Kulp,2020-05-29 12:27:35-04:00,['34c5e7b3b542c0e0b33747086c3cba7bc73b4904'],1,1,2,956489,1,,,,2702
09f8afe0faa0a846b2537b0b5aff9ef05d0ce072,0,Daniel Kulp,2020-05-29 12:49:09-04:00,['0281256d42c19bb45e4dc84f8ab7c35e45edd138'],1,1,2,956491,1,,,,2702
d043d2381b7b115a481497854522bb78f7362e23,0,GitHub,2020-05-29 20:51:24+01:00,['d7aa0a8cb33fd3511f056464985697359069705e'],67,63,130,956621,12,0.947368421,1,0.842105263,2702
5287c794d17ec0aefbb4b964a0c01166333c8649,0,GitHub,2020-05-30 09:03:59-04:00,['09f8afe0faa0a846b2537b0b5aff9ef05d0ce072'],38,267,305,956926,6,0.822335025,0.802030457,0.944162437,2702
f3433838d04543e4eacc49434f45ed1fea2c2b2c,0,GitHub,2020-05-31 14:39:35+01:00,['d043d2381b7b115a481497854522bb78f7362e23'],77,451,528,957454,5,,,,2703
1988598fc738138cee550121bf66648d0022e70e,0,GitHub,2020-05-31 21:27:19+01:00,['f3433838d04543e4eacc49434f45ed1fea2c2b2c'],1,982,983,958437,4,0.378766141,0.715925395,0.816355811,2704
7395db85afb71c7bec8d9fd8d977a7f76804d346,0,GitHub,2020-05-31 23:14:45+01:00,['1988598fc738138cee550121bf66648d0022e70e'],90,78,168,958605,6,0,0,0.230769231,2704
606ba8dc889c77865c6f39841b6c05f4fa9f6a3a,0,Antonio Uccio Verardi,2020-05-31 23:20:00+01:00,['7395db85afb71c7bec8d9fd8d977a7f76804d346'],2,12,14,958619,2,,,,2704
2a766be2c417c71b42b49ed2898ad3e8ed0d0113,0,GitHub,2020-06-01 08:42:06+02:00,['5287c794d17ec0aefbb4b964a0c01166333c8649'],12,251,263,958882,2,0.814285714,1,1,2705
59f220109ea67f18cbcf02f28f2f3f85aeabfb8f,1,Ismaël Mejía,2020-06-01 14:19:01+02:00,['2a766be2c417c71b42b49ed2898ad3e8ed0d0113'],4,5,9,958891,2,,,,2705
6e9286ec80af368b2750a57d7a7869cb97ff3d74,0,Ismaël Mejía,2020-06-01 15:26:03+02:00,['59f220109ea67f18cbcf02f28f2f3f85aeabfb8f'],0,1,1,958892,1,,,,2705
42d81d70e7b9409d3b17fbcc9ea102876b45b945,0,Ismaël Mejía,2020-06-01 15:26:03+02:00,['6e9286ec80af368b2750a57d7a7869cb97ff3d74'],1,2,3,958895,1,,,,2705
bf707863e9c26696fe1046e1a45037d7d8b37463,0,Ismaël Mejía,2020-06-01 17:17:34+02:00,['42d81d70e7b9409d3b17fbcc9ea102876b45b945'],1,0,1,958896,1,,,,2705
144120b540122d11c509a11e74d2559957222e30,0,Ismaël Mejía,2020-06-01 17:21:28+02:00,['bf707863e9c26696fe1046e1a45037d7d8b37463'],1,1,2,958898,1,,,,2705
fe2228e59376f03709a558c65a9edf9031eef4e6,0,Ismaël Mejía,2020-06-01 17:46:00+02:00,['144120b540122d11c509a11e74d2559957222e30'],1,1,2,958900,1,,,,2705
0de45f5592f6a891e0493676de254a5f41db230b,0,Ismaël Mejía,2020-06-01 17:46:38+02:00,['fe2228e59376f03709a558c65a9edf9031eef4e6'],2,2,4,958904,1,,,,2705
8f3b419b2d8085d068c85e034d2ad8983733f56c,0,Ismaël Mejía,2020-06-01 17:46:38+02:00,['0de45f5592f6a891e0493676de254a5f41db230b'],19,19,38,958942,3,,,,2705
72c4a8f84a52c540f824db0dc9b80ec050bfe96d,0,Ismaël Mejía,2020-06-01 17:47:15+02:00,['8f3b419b2d8085d068c85e034d2ad8983733f56c'],1,1,2,958944,1,,,,2705
e982f2e6ee57c362a7fae21ba7373c1cfc964fce,0,Ismaël Mejía,2020-06-01 19:35:44+02:00,['72c4a8f84a52c540f824db0dc9b80ec050bfe96d'],3,7,10,958954,2,,,,2705
93ec41bacf678a875d3696dec72a84901482602a,0,Ismaël Mejía,2020-06-01 19:45:00+02:00,['e982f2e6ee57c362a7fae21ba7373c1cfc964fce'],26,26,52,959006,26,,,,2705
249db48c63a9ddf5bd736a8c020fa5ebb267c50d,0,GitHub,2020-06-08 14:58:18+02:00,['93ec41bacf678a875d3696dec72a84901482602a'],2,2,4,959010,2,,,,2705
51d0fe8451bc15e3274ba2f0c5ae0260fcfcb78b,0,GitHub,2020-06-08 14:59:50+02:00,['249db48c63a9ddf5bd736a8c020fa5ebb267c50d'],0,52,52,959062,1,1,1,1,2706
b8ccc2f6451343c1da00b288ed4161d055e5daef,0,GitHub,2020-06-08 15:04:25+02:00,['51d0fe8451bc15e3274ba2f0c5ae0260fcfcb78b'],7,27,34,959096,3,0.071428571,1,1,2706
f84ca85ab59cfef44b999262cde5fcd87f9aea19,0,GitHub,2020-06-08 15:10:54+02:00,['b8ccc2f6451343c1da00b288ed4161d055e5daef'],3,3,6,959102,3,,,,2706
5ac4553c796712c8f5941c6b35d031a4bbce64ac,0,Ismaël Mejía,2020-06-09 13:46:19+02:00,['f84ca85ab59cfef44b999262cde5fcd87f9aea19'],0,2,2,959104,1,,,,2706
91410e3a189dcc7cfcabe2ae1243efe0a1259c0b,0,Ismaël Mejía,2020-06-09 14:36:48+02:00,['5ac4553c796712c8f5941c6b35d031a4bbce64ac'],1,1,2,959106,1,,,,2706
9a33ed5498a68b58fc0d3d667d64899bed1fceeb,0,GitHub,2020-06-12 10:29:23+02:00,['91410e3a189dcc7cfcabe2ae1243efe0a1259c0b'],1,5,6,959112,1,,,,2706
e1cffc5a11d684f24ef1e88ffae9f84ededd8649,0,GitHub,2020-06-19 11:02:51+01:00,['606ba8dc889c77865c6f39841b6c05f4fa9f6a3a'],0,2,2,959114,1,,,,2706
da3580e3f3032b24a9722e308f87c88a13b5a077,0,GitHub,2020-06-19 11:07:55+01:00,['e1cffc5a11d684f24ef1e88ffae9f84ededd8649'],0,3,3,959117,1,,,,2706
45c941d3241b8d513b9eca1e641167d076dee6e6,0,Antonio Uccio Verardi,2020-06-19 11:09:13+01:00,['da3580e3f3032b24a9722e308f87c88a13b5a077'],1,4,5,959122,2,,,,2706
c1fc9df0b3c52e3c89279db06e85ac6b7ac91a0c,0,Antonio Uccio Verardi,2020-06-19 11:13:31+01:00,['45c941d3241b8d513b9eca1e641167d076dee6e6'],2,2,4,959126,2,,,,2706
ce7c71038101785dd238a04d97cb2c6ba9b8a61a,0,Antonio Uccio Verardi,2020-06-19 11:30:18+01:00,['c1fc9df0b3c52e3c89279db06e85ac6b7ac91a0c'],1,1,2,959128,1,,,,2706
95f48dd6dd51f98485d04c7359371e767579bc76,1,Ismaël Mejía,2020-06-22 15:27:50+02:00,['9a33ed5498a68b58fc0d3d667d64899bed1fceeb'],7,7,14,959142,1,,,,2706
d9fae92aed6d40bb881badbbbe5eb74060efd01b,0,Ismaël Mejía,2020-06-22 15:27:50+02:00,['95f48dd6dd51f98485d04c7359371e767579bc76'],0,8,8,959150,1,,,,2706
98c29fbf866302c6215cca7762c47e65ff062fb7,0,Ismaël Mejía,2020-07-02 11:05:50+02:00,['d9fae92aed6d40bb881badbbbe5eb74060efd01b'],0,14,14,959164,1,,,,2706
2c7b9af7d5ba35afe9cf84eae3b273a6df0612b1,0,GitHub,2020-07-02 14:05:23+02:00,['98c29fbf866302c6215cca7762c47e65ff062fb7'],37,52,89,959253,3,0,0,1,2706
df61e8ac0cd478bf0a4603228d6c33214dad8cca,0,GitHub,2020-07-03 18:31:49+01:00,['ce7c71038101785dd238a04d97cb2c6ba9b8a61a'],5,5,10,959263,2,,,,2706
3fb71e0f817495bcadd7e64e297f2339029dca05,1,GitHub,2020-07-05 16:43:10+01:00,['df61e8ac0cd478bf0a4603228d6c33214dad8cca'],110,105,215,959478,8,0.285714286,0,0,2706
72c0ffc94bac30cf1d3ce1931cde67b4b5cc593b,0,GitHub,2020-07-08 00:17:39+01:00,['3fb71e0f817495bcadd7e64e297f2339029dca05'],46,59,105,959583,2,0,0,0,2706
dc2afc5d3bedefa0fa1dfe611adfaedd67418a51,1,GitHub,2020-07-09 14:39:13+02:00,['2c7b9af7d5ba35afe9cf84eae3b273a6df0612b1'],1,4,5,959588,4,,,,2706
9592038cc61ac740a15af9efe63a379e571c46c5,1,GitHub,2020-07-10 22:18:26+01:00,['72c0ffc94bac30cf1d3ce1931cde67b4b5cc593b'],480,525,1005,960593,21,0,0.127659574,0.085106383,2708
656db36d8ebe0cde25dce715e778138a9d14b4db,0,GitHub,2020-07-12 11:20:35+01:00,['9592038cc61ac740a15af9efe63a379e571c46c5'],22,94,116,960709,7,,,,2711
d841c04aa7519b3f6f6b3632c0bd583d4ceee5b9,1,GitHub,2020-07-12 12:11:50+01:00,['656db36d8ebe0cde25dce715e778138a9d14b4db'],125,110,235,960944,19,,,,2712
69807e9fc90484aa6f723e5cbb1d618bde57e792,0,GitHub,2020-07-12 13:17:37+01:00,['d841c04aa7519b3f6f6b3632c0bd583d4ceee5b9'],6,0,6,960950,1,,,,2712
7a87b535f6e3139831db94eb35be9b5b8aa96a73,0,GitHub,2020-07-12 13:20:45+01:00,['69807e9fc90484aa6f723e5cbb1d618bde57e792'],4,2,6,960956,1,0,0,1,2712
d3f3c6eaf16cdfdf2094a61532dba86f046c26a0,1,GitHub,2020-07-14 00:39:37+01:00,['7a87b535f6e3139831db94eb35be9b5b8aa96a73'],396,445,841,961797,3,,,,2712
d719de228131a8978e230f8b404c5bf07ef89567,1,GitHub,2020-07-14 00:42:42+01:00,['d3f3c6eaf16cdfdf2094a61532dba86f046c26a0'],33,37,70,961867,1,1,1,1,2712
c903aa6d6fc42d3c347f95d469a8364ea44165e8,0,GitHub,2020-07-16 14:52:51+02:00,['dc2afc5d3bedefa0fa1dfe611adfaedd67418a51'],8,12,20,961887,2,0,0,1,2712
95ae8d22b36ec8f154b5cc5a5df9859184facce8,0,Antonio Uccio Verardi,2020-07-20 20:57:13+01:00,['d719de228131a8978e230f8b404c5bf07ef89567'],10,1,11,961898,3,,,,2712
0394e1772e78d9b726bd015c9d02b146a1abaee0,0,GitHub,2020-07-23 17:12:31+02:00,['c903aa6d6fc42d3c347f95d469a8364ea44165e8'],29,55,84,961982,7,0,0.5,0.5,2713
6c3b4cd2be4e8a07137e4dc715ea22930d3e2835,0,GitHub,2020-07-24 15:25:24+01:00,['95ae8d22b36ec8f154b5cc5a5df9859184facce8'],1,1,2,961984,1,,,,2713
307c8f85f3733dce4e22f83232094172084d8e62,0,GitHub,2020-08-06 18:09:16+02:00,['0394e1772e78d9b726bd015c9d02b146a1abaee0'],2,3,5,961989,1,,,,2713
20cbf14f8473154f0a27f064ec04823a8349c6a1,0,GitHub,2020-08-10 17:46:05+02:00,['307c8f85f3733dce4e22f83232094172084d8e62'],0,1,1,961990,1,,,,2713
7791b348c979453bb071bcb5189dcd400b5521b8,0,GitHub,2020-08-13 11:23:34+02:00,['20cbf14f8473154f0a27f064ec04823a8349c6a1'],1,54,55,962045,2,1,1,1,2714
b3edfacced605a9d3229426441a2808176c86120,1,GitHub,2020-08-13 17:10:00+02:00,['6c3b4cd2be4e8a07137e4dc715ea22930d3e2835'],530,692,1222,963267,19,1,0.703125,0.234375,2715
743a6dff6f532b10be4451bc2158bace681c89a1,0,GitHub,2020-08-13 17:41:57+02:00,['b3edfacced605a9d3229426441a2808176c86120'],1,5,6,963273,1,,,,2715
4aae22d71997a9f337f687ba1d11cc328a81fc91,0,GitHub,2020-08-13 19:14:08+02:00,['743a6dff6f532b10be4451bc2158bace681c89a1'],1,218,219,963492,3,0,1,1,2715
82490511e9995f77f40bd12ed07e2bc8cecf2fc5,0,GitHub,2020-08-13 19:15:54+02:00,['4aae22d71997a9f337f687ba1d11cc328a81fc91'],2,24,26,963518,2,0,1,1,2715
a89d82e75555160bebb660740baae5ec5793d883,0,GitHub,2020-08-13 19:16:39+02:00,['82490511e9995f77f40bd12ed07e2bc8cecf2fc5'],0,3,3,963521,1,,,,2715
0ca45b472e51152ce4ce4f52f55c533ec92fa22e,0,Antonio Uccio Verardi,2020-08-13 19:30:05+02:00,['a89d82e75555160bebb660740baae5ec5793d883'],1,3,4,963525,2,,,,2715
d5e35e8afaee0566cd85c748ffbff3841be2bd20,0,GitHub,2020-08-15 13:50:15-04:00,['7791b348c979453bb071bcb5189dcd400b5521b8'],363,317,680,964205,17,1,0,0.695652174,2716
0552c674637dd15b8751ed5181387cdbd81480d5,0,GitHub,2020-08-16 10:32:02-04:00,['d5e35e8afaee0566cd85c748ffbff3841be2bd20'],68,127,195,964400,48,0,0,0,2716
ad820ed7edba566a8a2be480d5e2e42238862a5a,0,GitHub,2020-08-16 14:48:20-04:00,['0552c674637dd15b8751ed5181387cdbd81480d5'],1,4,5,964405,1,,,,2716
fed505631bc9692080e35b7e8131e6f96e6e8f0d,0,GitHub,2020-08-16 15:39:43-04:00,['ad820ed7edba566a8a2be480d5e2e42238862a5a'],154,102,256,964661,1,1,1,0,2716
fd2286b128cd4592a49297978e5e6e653ad269b8,0,GitHub,2020-08-16 18:40:05-04:00,['fed505631bc9692080e35b7e8131e6f96e6e8f0d'],443,50,493,965154,10,0,0,0.260869565,2716
c670135804df6de5eda871691e872b7b57ba562b,1,Ismaël Mejía,2020-08-18 16:19:54+02:00,['fd2286b128cd4592a49297978e5e6e653ad269b8'],9,29,38,965192,3,,,,2716
d62132899c66e161209754f768fe5881bf7591ff,0,Ismaël Mejía,2020-08-18 16:19:54+02:00,['c670135804df6de5eda871691e872b7b57ba562b'],1,1,2,965194,1,,,,2716
4a298ad6dce730c4f323b9c739b810ac06d4ec3b,0,Ismaël Mejía,2020-08-18 16:19:54+02:00,['d62132899c66e161209754f768fe5881bf7591ff'],0,2,2,965196,1,,,,2716
c01f79f064ffaf489bfea106defce22e2fc66e6b,1,GitHub,2020-08-18 12:08:14-04:00,['4a298ad6dce730c4f323b9c739b810ac06d4ec3b'],88,109,197,965393,3,1,0,0,2717
e7e5cfe44f662c5a1af4c550e76b7756ee7f5e60,0,GitHub,2020-08-19 19:56:17+02:00,['c01f79f064ffaf489bfea106defce22e2fc66e6b'],0,2,2,965395,1,0,0,1,2717
efb12314b5acfea075a533368441c0f5a3b844d4,0,GitHub,2020-08-19 17:14:01-04:00,['e7e5cfe44f662c5a1af4c550e76b7756ee7f5e60'],82,236,318,965713,2,1,1,0.617021277,2717
859b224dd353701b38e86d1e24b4c3f0b4fddf73,0,GitHub,2020-08-24 09:24:59+02:00,['efb12314b5acfea075a533368441c0f5a3b844d4'],259,414,673,966386,12,0,1,0.803571429,2718
cca4401c7ab4ef9e1237e01b6ea1f52fcea7dfc2,0,GitHub,2020-08-24 14:22:28+02:00,['859b224dd353701b38e86d1e24b4c3f0b4fddf73'],1,1,2,966388,1,,,,2718
caa3a4265bf0a8e6496b63938bc4ab0b6620683c,1,GitHub,2020-08-27 19:45:23-04:00,['cca4401c7ab4ef9e1237e01b6ea1f52fcea7dfc2'],571,385,956,967344,32,0,0,0.333333333,2718
c2dbe4367c34452a424f580c6f3e8b239f256ec6,0,GitHub,2020-09-09 10:27:39+02:00,['0ca45b472e51152ce4ce4f52f55c533ec92fa22e'],5,143,148,967492,6,0.487179487,1,1,2719
2e24700c6fded6ac9c21e60bd72e3c8d1aab2fdc,0,GitHub,2020-09-09 10:28:30+02:00,['c2dbe4367c34452a424f580c6f3e8b239f256ec6'],3,1,4,967496,1,,,,2719
603319f79ca7db6a3b9f40e5270aa8f137d0fb25,0,GitHub,2020-09-11 10:30:21+02:00,['caa3a4265bf0a8e6496b63938bc4ab0b6620683c'],8,76,84,967580,3,,,,2721
322ba39e68893745f0d40fb5ccc642756507898a,0,GitHub,2020-09-14 13:27:35+02:00,['603319f79ca7db6a3b9f40e5270aa8f137d0fb25'],2,2,4,967584,2,,,,2721
2a4d846e6e1cf3e5e8576e0be9a9698c97b9f606,0,GitHub,2020-09-25 10:45:24+02:00,['322ba39e68893745f0d40fb5ccc642756507898a'],5,57,62,967646,2,1,1,1,2721
7d1e63b219e6d0778bc57195152477adee97fcab,0,GitHub,2020-09-30 19:34:16+05:18,['2a4d846e6e1cf3e5e8576e0be9a9698c97b9f606'],2,298,300,967946,3,0.25862069,0,0.982758621,2721
9a6aa43c8699ccde7bef485206928acb35378bdb,0,GitHub,2020-09-30 17:27:07+02:00,['7d1e63b219e6d0778bc57195152477adee97fcab'],21,65,86,968032,2,0.179487179,1,1,2721
816893eb5cb7a71d9a06c3c5e27db2e2fb7bbb94,0,GitHub,2020-10-02 19:07:42+02:00,['9a6aa43c8699ccde7bef485206928acb35378bdb'],0,2,2,968034,1,0,0,0,2721
408099a9f82c542caf397b96f4279a827774a1cb,0,GitHub,2020-10-05 14:56:25+02:00,['816893eb5cb7a71d9a06c3c5e27db2e2fb7bbb94'],5,4,9,968043,1,0,0,0,2721
328c539afc77da347ec52be1e112a6a7c371143b,0,GitHub,2020-10-14 11:35:05+02:00,['408099a9f82c542caf397b96f4279a827774a1cb'],4,34,38,968081,2,0.928571429,0.928571429,1,2721
6caf1c304185f581fdc5ef3ef10af27a3ab0ca91,1,GitHub,2020-10-28 13:40:40+01:00,['328c539afc77da347ec52be1e112a6a7c371143b'],23,1999,2022,970103,11,0.780652418,0.861642295,0.935883015,2729
9055b08eb00494e65adcf22498095864897b8b37,0,GitHub,2020-11-01 20:24:19+01:00,['6caf1c304185f581fdc5ef3ef10af27a3ab0ca91'],1,1,2,970105,1,,,,2729
6a5acde74c45c3997b093cea79d831038ac8a182,0,GitHub,2020-11-01 21:45:04+01:00,['9055b08eb00494e65adcf22498095864897b8b37'],29,62,91,970196,3,,,,2731
942ec8e0cc011ec9fcfff7ba9f5c656bb54d51d1,1,GitHub,2020-11-02 09:41:00+01:00,['6a5acde74c45c3997b093cea79d831038ac8a182'],6,68,74,970270,2,0.325581395,1,1,2731
c97fa4971ee951eab51a35d8e4a7c1ba7388e4e7,0,RyanSkraba,2020-11-10 14:21:34+01:00,['942ec8e0cc011ec9fcfff7ba9f5c656bb54d51d1'],0,3,3,970273,1,,,,2731
53b7ccc8d61427a60b6354564e1613a6577e7c04,0,RyanSkraba,2020-11-10 14:21:34+01:00,['c97fa4971ee951eab51a35d8e4a7c1ba7388e4e7'],1,1,2,970275,1,,,,2731
68b2e9df5aefa187db5b627133ba009606393e2f,0,Ismaël Mejía,2020-11-12 15:56:35+01:00,['53b7ccc8d61427a60b6354564e1613a6577e7c04'],2,8,10,970285,2,,,,2731
5ebede65e1a550295bc662e5aef9e2421a388abf,0,Ismaël Mejía,2020-11-12 15:56:35+01:00,['68b2e9df5aefa187db5b627133ba009606393e2f'],0,3,3,970288,1,,,,2731
b39848b75012efe6576aad7f1a013510e3baa9f0,0,GitHub,2020-11-12 16:00:39+01:00,['5ebede65e1a550295bc662e5aef9e2421a388abf'],0,5,5,970293,1,,,,2731
321d16deff543b2f07a9c1487a1dfccd8d25286e,0,GitHub,2020-11-12 17:00:13+01:00,['b39848b75012efe6576aad7f1a013510e3baa9f0'],0,5,5,970298,2,0.4,1,1,2731
4f4ddf041c1a73aad011be62e9cd7e9bb654148c,0,RyanSkraba,2020-11-13 10:23:49+01:00,['321d16deff543b2f07a9c1487a1dfccd8d25286e'],9,2,11,970309,2,,,,2731
e6ce95914cf28f6331d1c61896e65e40a121344b,0,RyanSkraba,2020-11-13 10:23:49+01:00,['4f4ddf041c1a73aad011be62e9cd7e9bb654148c'],1,1,2,970311,1,,,,2731
398e6c9dacc094b1f3349d60331c087a8e5a545c,0,RyanSkraba,2020-11-13 10:23:49+01:00,['e6ce95914cf28f6331d1c61896e65e40a121344b'],1,1,2,970313,1,,,,2731
79f94fbc67bdc3880215e89225069e0d6b3bb460,0,RyanSkraba,2020-11-13 10:23:49+01:00,['398e6c9dacc094b1f3349d60331c087a8e5a545c'],1,1,2,970315,1,,,,2731
00cdeecbf65c6cdf8ef58dbfab671475e76ec93c,0,RyanSkraba,2020-11-13 10:23:49+01:00,['79f94fbc67bdc3880215e89225069e0d6b3bb460'],2,2,4,970319,1,,,,2731
73ea6c5585ed13ddd97fb47fe7515bd05b47b818,0,RyanSkraba,2020-11-13 10:23:49+01:00,['00cdeecbf65c6cdf8ef58dbfab671475e76ec93c'],1,1,2,970321,1,,,,2731
51a7b211b152a5f3d3f5b13b03c3f8a1ccc4646c,0,RyanSkraba,2020-11-13 10:23:49+01:00,['73ea6c5585ed13ddd97fb47fe7515bd05b47b818'],1,13,14,970335,1,,,,2731
1a0bd70710bd30a4d7168e0b1c88fb33ebfdc6cd,0,RyanSkraba,2020-11-13 10:23:49+01:00,['51a7b211b152a5f3d3f5b13b03c3f8a1ccc4646c'],1,1,2,970337,1,,,,2731
372313b018c4b34e17469327aaf8e9381e6a4524,0,RyanSkraba,2020-11-13 10:23:49+01:00,['1a0bd70710bd30a4d7168e0b1c88fb33ebfdc6cd'],1,1,2,970339,1,,,,2731
63afb6a2ce867379c951d42ebc8b85ff653e9bdc,0,RyanSkraba,2020-11-13 10:23:49+01:00,['372313b018c4b34e17469327aaf8e9381e6a4524'],1,1,2,970341,1,,,,2731
c4686b715155cd31d926da962ebb2cc203e1a831,0,RyanSkraba,2020-11-13 10:23:49+01:00,['63afb6a2ce867379c951d42ebc8b85ff653e9bdc'],1,1,2,970343,1,,,,2731
e42b44e0bfeaaf1fcfd28bb7396b7f663ec1aa50,1,Brian Lachniet,2020-11-14 19:26:53-05:00,['c4686b715155cd31d926da962ebb2cc203e1a831'],16,117,133,970476,8,0.839285714,0.285714286,0.75,2731
edddf440521d253aecbd0f95a65c6b0063fe654f,0,GitHub,2020-11-16 10:00:06+01:00,['e42b44e0bfeaaf1fcfd28bb7396b7f663ec1aa50'],63,65,128,970604,10,,,,2731
d3bb916340203521065972da7e29aee05ea9f421,1,Ismaël Mejía,2020-11-17 14:37:05+01:00,['edddf440521d253aecbd0f95a65c6b0063fe654f'],2,2,4,970608,2,,,,2731
18b811aac4313e1ac67dab4048695bd0cf9e40ca,0,Ismaël Mejía,2020-11-17 14:37:05+01:00,['d3bb916340203521065972da7e29aee05ea9f421'],1,1,2,970610,1,,,,2731
75c4dd3436cbc8b86a04e9681ad83a2f2a22334e,0,Ismaël Mejía,2020-11-17 14:37:05+01:00,['18b811aac4313e1ac67dab4048695bd0cf9e40ca'],0,48,48,970658,1,0,1,1,2731
30328e20f92aee9944697de9bbb050184b8584a1,0,Ismaël Mejía,2020-11-17 14:51:05+01:00,['75c4dd3436cbc8b86a04e9681ad83a2f2a22334e'],0,46,46,970704,1,,,,2732
baa676566eaaa81c5249d03edcf58b6a690a4c11,0,GitHub,2020-11-18 10:47:59+01:00,['30328e20f92aee9944697de9bbb050184b8584a1'],1,2,3,970707,1,,,,2732
9d450a50846eec18635cbde059af378575fbcaae,0,Ismaël Mejía,2020-11-18 14:05:34+01:00,['baa676566eaaa81c5249d03edcf58b6a690a4c11'],1,1,2,970709,1,,,,2732
2a4b875081aee1e2e7030f4aedef49cb15a9fb2f,0,Ismaël Mejía,2020-11-18 14:06:17+01:00,['9d450a50846eec18635cbde059af378575fbcaae'],1,1,2,970711,1,,,,2732
60c59212a41406e4f24b8541332a4b2496a945e6,0,Ismaël Mejía,2020-11-18 14:07:22+01:00,['2a4b875081aee1e2e7030f4aedef49cb15a9fb2f'],1,1,2,970713,1,,,,2732
121df31767b77c70e9417b8521c9969d62dde95d,0,Ismaël Mejía,2020-11-18 14:07:55+01:00,['60c59212a41406e4f24b8541332a4b2496a945e6'],2,2,4,970717,2,,,,2732
7b778627616a97a06c19a9250bdc09d8e25935ce,0,Ismaël Mejía,2020-11-18 14:08:49+01:00,['121df31767b77c70e9417b8521c9969d62dde95d'],1,1,2,970719,1,,,,2732
b7d5027291621769653771e4fc91dba98bc08d8d,0,GitHub,2020-11-20 14:49:59-05:00,['7b778627616a97a06c19a9250bdc09d8e25935ce'],10,11,21,970740,2,,,,2732
d04fc44417920714e4cad4b11a73b41e68c101a6,0,Ismaël Mejía,2020-11-21 10:30:57+01:00,['b7d5027291621769653771e4fc91dba98bc08d8d'],1,1,2,970742,1,,,,2732
0bbdfc096d3d3435a6bc2c4eff7b771ba69fd8cd,0,Ismaël Mejía,2020-11-21 10:31:20+01:00,['d04fc44417920714e4cad4b11a73b41e68c101a6'],1,1,2,970744,1,,,,2732
64ce2af5cbdc36e0ebde12285068aa56c25ea9cf,0,Ismaël Mejía,2020-11-21 10:31:41+01:00,['0bbdfc096d3d3435a6bc2c4eff7b771ba69fd8cd'],1,1,2,970746,1,,,,2732
78e524962fbc68a103094f652d605b4035326975,0,Ismaël Mejía,2020-11-21 10:38:51+01:00,['64ce2af5cbdc36e0ebde12285068aa56c25ea9cf'],1,7,8,970754,2,,,,2732
389e5eae7bdb8618789df22c14cc3d6fd65cf594,0,GitHub,2020-11-25 01:23:18+00:00,['2e24700c6fded6ac9c21e60bd72e3c8d1aab2fdc'],0,2,2,970756,1,,,,2732
2817b09f09e1acce9691cbd6fa62b1c82fba0f5a,0,GitHub,2020-11-25 01:23:57+00:00,['389e5eae7bdb8618789df22c14cc3d6fd65cf594'],0,2,2,970758,1,,,,2732
9eebe823452a4e4772e4e9b379ba5956487d0da8,0,Antonio Uccio Verardi,2020-11-25 01:49:28+00:00,['2817b09f09e1acce9691cbd6fa62b1c82fba0f5a'],0,3,3,970761,3,,,,2732
f59297f10e4a8a4d938640ae2bd8046f4a7a2403,0,Antonio Uccio Verardi,2020-11-25 02:03:15+00:00,['9eebe823452a4e4772e4e9b379ba5956487d0da8'],2,23,25,970786,4,,,,2732
1b3e973baaa73873133a45403ca64b95c1c5ef7a,0,Antonio Uccio Verardi,2020-11-25 02:03:41+00:00,['f59297f10e4a8a4d938640ae2bd8046f4a7a2403'],10,10,20,970806,1,,,,2732
9d99073c5a90e7efca9c38dd0f2ff9508c5d96bb,0,Antonio Uccio Verardi,2020-11-25 02:10:14+00:00,['1b3e973baaa73873133a45403ca64b95c1c5ef7a'],3,3,6,970812,2,,,,2732
1e16824005d0f0fcae84e04ea4519691f710a3ec,0,Antonio Uccio Verardi,2020-11-25 02:15:37+00:00,['9d99073c5a90e7efca9c38dd0f2ff9508c5d96bb'],1,1,2,970814,1,,,,2732
9a42a2bc847054965cf86c77451f22105645662b,0,Antonio Uccio Verardi,2020-11-25 02:21:17+00:00,['1e16824005d0f0fcae84e04ea4519691f710a3ec'],1,1,2,970816,1,,,,2732
226ba8a2bd6bdc81ee9e79f85e05c63b7482fd52,1,Antonio Uccio Verardi,2020-11-25 02:22:03+00:00,['9a42a2bc847054965cf86c77451f22105645662b'],2,2,4,970820,2,,,,2732
318cb4651206d7f07f92a3328bd49eccd2d0cd06,1,Antonio Uccio Verardi,2020-11-27 18:55:32+00:00,['226ba8a2bd6bdc81ee9e79f85e05c63b7482fd52'],20,16,36,970856,4,0,0,0,2732
9076770e2bb8bed9e8bb11d0c2442df7495dcba2,0,GitHub,2020-11-27 19:02:25+00:00,['318cb4651206d7f07f92a3328bd49eccd2d0cd06'],1,1,2,970858,1,,,,2732
4e372ded6760295e68bb30efebba26d2ff7047ec,0,GitHub,2020-11-27 19:07:11+00:00,['9076770e2bb8bed9e8bb11d0c2442df7495dcba2'],9,4,13,970871,1,,,,2732
d5b1970e95c5b43a8998ee0e01dcae095bb26963,0,Antonio Uccio Verardi,2020-11-27 19:08:40+00:00,['4e372ded6760295e68bb30efebba26d2ff7047ec'],0,1,1,970872,1,,,,2732
d5179c3d0a2c3146edc1c499a816e48be7a5bf80,0,Antonio Uccio Verardi,2020-11-27 19:16:27+00:00,['d5b1970e95c5b43a8998ee0e01dcae095bb26963'],1,5,6,970878,1,,,,2732
de6153ecea6fe660bcf20ff67f47a0b05211b8e1,0,Antonio Uccio Verardi,2020-11-27 21:37:33+00:00,['d5179c3d0a2c3146edc1c499a816e48be7a5bf80'],2,12,14,970892,3,,,,2732
2cc44c5b3ab234ac1258a34d233a9d88cfe15565,0,GitHub,2020-11-30 14:03:53+01:00,['78e524962fbc68a103094f652d605b4035326975'],1,30,31,970923,1,,,,2732
89c03cfe5fe8a0ad1aacf910e9b94c57a41ea67e,0,GitHub,2020-12-04 16:13:18+01:00,['2cc44c5b3ab234ac1258a34d233a9d88cfe15565'],1,1,2,970925,1,,,,2732
f28acbbb9860bd62cb24ead83878d7526d075454,0,GitHub,2020-12-16 23:38:34+01:00,['de6153ecea6fe660bcf20ff67f47a0b05211b8e1'],1,1,2,970927,1,,,,2732
0fbc98b7625577a9b51c4c52467d62cf08cbc16f,0,GitHub,2020-12-20 20:25:28-05:00,['89c03cfe5fe8a0ad1aacf910e9b94c57a41ea67e'],1,1,2,970929,1,,,,2732
ca6d72dd618b7b52aedd32654bfaa6c35d950ccf,0,GitHub,2020-12-20 21:02:00-05:00,['0fbc98b7625577a9b51c4c52467d62cf08cbc16f'],16,46,62,970991,5,,,,2734
4467c66e05abf0f3e3ad3570fca4a7769a13533b,1,GitHub,2021-01-01 12:00:05-04:00,['ca6d72dd618b7b52aedd32654bfaa6c35d950ccf'],112,1022,1134,972125,16,,,,2743
6c527e5f6cebd595a14b4b38f47b973a151636fa,0,Ismaël Mejía,2021-01-04 14:35:36+01:00,['4467c66e05abf0f3e3ad3570fca4a7769a13533b'],2,23,25,972150,1,,,,2743
e8db541f0c343d5f5f0773f7cec687a83cee3698,0,GitHub,2021-01-10 07:33:36-05:00,['6c527e5f6cebd595a14b4b38f47b973a151636fa'],1,8,9,972159,2,0.8,0.8,0.8,2743
96312e4705fc6ef1c6d9fde631afe2a2cedc8e9e,0,GitHub,2021-01-10 07:45:06-05:00,['e8db541f0c343d5f5f0773f7cec687a83cee3698'],26,36,62,972221,4,0,0,0.25,2743
bd31cc452dbe8513f9d2f00181d910622dfd4bbe,0,GitHub,2021-01-10 07:46:06-05:00,['96312e4705fc6ef1c6d9fde631afe2a2cedc8e9e'],2,10,12,972233,2,0,0.666666667,1,2743
21e39347f227516aa353ee84367a0d46d18420ab,1,GitHub,2021-01-14 13:08:15+01:00,['bd31cc452dbe8513f9d2f00181d910622dfd4bbe'],4,21,25,972258,3,1,1,1,2743
1cc5f7b607714a0750d9634d5a27e40a00e92c9c,0,GitHub,2021-01-15 15:17:36+01:00,['21e39347f227516aa353ee84367a0d46d18420ab'],12,12,24,972282,4,,,,2743
1ee0e2778e8e6d95c9def1e94cb59c72ef0da369,0,Ismaël Mejía,2021-01-16 06:49:42+01:00,['1cc5f7b607714a0750d9634d5a27e40a00e92c9c'],5,15,20,972302,1,,,,2743
3c99902f50e7998f972c491bfaecac2e3cacc981,0,Ismaël Mejía,2021-01-16 06:49:42+01:00,['1ee0e2778e8e6d95c9def1e94cb59c72ef0da369'],2,20,22,972324,1,,,,2743
8c2c6bf7610194bdad61b00743dae22a839b7ff5,0,GitHub,2021-01-20 09:24:41+01:00,['3c99902f50e7998f972c491bfaecac2e3cacc981'],6,21,27,972351,2,,,,2743
90d0a49d02416cac41962ac40d3662967febfcdb,0,GitHub,2021-01-20 09:42:39+01:00,['8c2c6bf7610194bdad61b00743dae22a839b7ff5'],25,25,50,972401,1,,,,2743
f4d2b0ddf51ea1bd8a8c0151ee7741ae1239eb53,0,GitHub,2021-01-20 09:50:34+01:00,['90d0a49d02416cac41962ac40d3662967febfcdb'],1,1,2,972403,1,,,,2743
dbed143b8d1f056a0516f37589bb1925d8b56768,0,GitHub,2021-01-20 10:18:27+01:00,['f4d2b0ddf51ea1bd8a8c0151ee7741ae1239eb53'],1,1,2,972405,1,,,,2743
e3f977697c605f52973aa21e61f7be3208c38029,0,Ismaël Mejía,2021-01-20 10:33:24+01:00,['dbed143b8d1f056a0516f37589bb1925d8b56768'],1,1,2,972407,1,,,,2743
9f3c7ee088d0a7b81a6aefe82809a75360655b49,0,Ismaël Mejía,2021-01-20 10:33:46+01:00,['e3f977697c605f52973aa21e61f7be3208c38029'],1,1,2,972409,1,,,,2743
020e30c94c71ccfbc6de58a68befb9405ee4c048,0,Ismaël Mejía,2021-01-21 09:58:01+01:00,['9f3c7ee088d0a7b81a6aefe82809a75360655b49'],1,1,2,972411,1,,,,2743
5412eca32406e3a5d8579400bc6c3843ff5fb206,0,Ismaël Mejía,2021-01-21 10:00:47+01:00,['020e30c94c71ccfbc6de58a68befb9405ee4c048'],3,2,5,972416,1,,,,2743
7643ac45d041b4273fb1099f9638131d01381c11,0,Ismaël Mejía,2021-01-21 14:07:19+01:00,['5412eca32406e3a5d8579400bc6c3843ff5fb206'],1,1,2,972418,1,,,,2743
72b06153729b1a7963012b1e3e0cc3837e452322,0,Ismaël Mejía,2021-01-21 14:12:45+01:00,['7643ac45d041b4273fb1099f9638131d01381c11'],1,1,2,972420,1,,,,2743
5d97f286d01f95b20b6a47f3df4525433bd30efb,0,GitHub,2021-01-23 18:51:08+00:00,['f28acbbb9860bd62cb24ead83878d7526d075454'],1,1,2,972422,1,,,,2743
afe8fa1adfbed7971c077338cd9441b14503507a,0,GitHub,2021-01-27 15:26:48+01:00,['72b06153729b1a7963012b1e3e0cc3837e452322'],9,12,21,972443,1,,,,2743
d8299dc65eb5ea9fee0012032355a630e3c60f9c,0,GitHub,2021-01-28 20:09:46+00:00,['5d97f286d01f95b20b6a47f3df4525433bd30efb'],1,8,9,972452,2,0.285714286,0.428571429,1,2743
9c248bd138581c0d423ce9181c440ffe88a1d65e,0,GitHub,2021-01-28 20:27:29+00:00,['d8299dc65eb5ea9fee0012032355a630e3c60f9c'],4,17,21,972473,2,0,1,1,2743
8c02574102234d49a0b48d55dd2aa36bf14322e2,0,Flavien Raynaud,2021-01-29 17:53:49+00:00,['9c248bd138581c0d423ce9181c440ffe88a1d65e'],8,8,16,972489,2,,,,2743
eef23fcfea7971dc901553dcaed0f72ed365a32c,1,GitHub,2021-01-29 20:39:08+00:00,['8c02574102234d49a0b48d55dd2aa36bf14322e2'],52,613,665,973154,5,0.037900875,1,1,2743
f0c2ac2f0e9df12da7a135aba290e4fc2f727f81,0,Flavien Raynaud,2021-01-29 20:46:14+00:00,['eef23fcfea7971dc901553dcaed0f72ed365a32c'],1,15,16,973170,3,,,,2743
0fc0e05ddcef06958937af561159063d4b3c634e,0,GitHub,2021-01-29 22:20:45+01:00,['afe8fa1adfbed7971c077338cd9441b14503507a'],8,7,15,973185,7,,,,2743
41587a9099eae06ceb615ec440ed70e767af02b6,0,GitHub,2021-01-29 22:55:21+01:00,['0fc0e05ddcef06958937af561159063d4b3c634e'],74,10,84,973269,10,,,,2743
351f589913b9691322966fb77fe72269a0a2ec82,0,GitHub,2021-01-29 22:59:05+01:00,['41587a9099eae06ceb615ec440ed70e767af02b6'],9,9,18,973287,1,,,,2743
30515453b14b4ca15e2f10c840dae448e0e1089e,0,Ismaël Mejía,2021-01-31 13:43:42+01:00,['351f589913b9691322966fb77fe72269a0a2ec82'],1,1,2,973289,1,,,,2743
6d77f5048dcc3b6f0924c86b740a2c90a8354fa8,0,Ismaël Mejía,2021-01-31 14:00:55+01:00,['30515453b14b4ca15e2f10c840dae448e0e1089e'],1,1,2,973291,1,,,,2743
8da43216f0c1c7a64154ec6ebd668d7c76893137,0,GitHub,2021-01-31 16:11:52-05:00,['6d77f5048dcc3b6f0924c86b740a2c90a8354fa8'],2,6,8,973299,2,,,,2743
44737386cb17a359515f068e7fe9caa0f7bfff70,0,GitHub,2021-02-02 08:56:24+01:00,['8da43216f0c1c7a64154ec6ebd668d7c76893137'],587,35,622,973921,15,0.244525547,0.215328467,0.018248175,2743
568ee67c2d0c8d62049741ae78dc91910aa1b6f2,0,GitHub,2021-02-02 13:08:15+01:00,['44737386cb17a359515f068e7fe9caa0f7bfff70'],16,24,40,973961,1,0,1,1,2743
02bdc2da3ade2fe5a0c1138bff0d4574a8d7075b,0,Ismaël Mejía,2021-02-02 17:51:30+01:00,['568ee67c2d0c8d62049741ae78dc91910aa1b6f2'],1,1,2,973963,1,,,,2743
36ef0b71c6c624bef8525704229a7791b51788d5,0,GitHub,2021-02-03 17:43:12+01:00,['02bdc2da3ade2fe5a0c1138bff0d4574a8d7075b'],1,80,81,974044,2,0.192982456,0.631578947,1,2743
8e5a8ef61b0623efc797ac9bbb2028678b279956,1,GitHub,2021-02-07 15:57:55+00:00,['f0c2ac2f0e9df12da7a135aba290e4fc2f727f81'],0,37,37,974081,1,0,1,1,2743
941000b1e3c71a89010999d7aa0c4955e3672f5a,1,GitHub,2021-02-07 17:00:49+00:00,['8e5a8ef61b0623efc797ac9bbb2028678b279956'],2,54,56,974137,3,,,,2743
da771e4d603b771c4add65e17c25c13990a1c463,0,Ismaël Mejía,2021-02-08 12:25:54+01:00,['36ef0b71c6c624bef8525704229a7791b51788d5'],1,1,2,974139,1,,,,2743
5ebc186856114c508f28203b19654658e87045e7,0,Fokko Driesprong,2021-02-11 22:00:55+01:00,['da771e4d603b771c4add65e17c25c13990a1c463'],3,3,6,974145,1,,,,2743
3427f5f8f2c2f404b5112f15d143205a84fd737e,0,Ismaël Mejía,2021-02-14 10:29:23+01:00,['da771e4d603b771c4add65e17c25c13990a1c463'],1,1,2,974147,1,,,,2743
214e6ebf8dce91a0a0910281ddb8e82a19f6c310,0,Ismaël Mejía,2021-02-14 10:30:01+01:00,['3427f5f8f2c2f404b5112f15d143205a84fd737e'],1,1,2,974149,1,,,,2743
68090374cdb00e5bdb5e6fde3d5e08a29f2293a6,0,Ismaël Mejía,2021-02-15 14:42:55+01:00,['214e6ebf8dce91a0a0910281ddb8e82a19f6c310'],1,1,2,974151,1,,,,2743
7b4721d91e08ab8bf71c424365a76a5b44c74e93,0,Ismaël Mejía,2021-02-15 14:44:11+01:00,['68090374cdb00e5bdb5e6fde3d5e08a29f2293a6'],1,1,2,974153,1,,,,2743
1f746d4941ae80216295ce112b84353043be5395,0,Ismaël Mejía,2021-02-15 14:45:48+01:00,['7b4721d91e08ab8bf71c424365a76a5b44c74e93'],1,1,2,974155,1,,,,2743
e73952236118d144f60aa44af19eca79ba1d622a,0,Ismaël Mejía,2021-02-15 14:48:16+01:00,['1f746d4941ae80216295ce112b84353043be5395'],1,1,2,974157,1,,,,2743
ab583427573cd9a1476265ed176f18c6b1180a30,0,Ismaël Mejía,2021-02-15 14:50:48+01:00,['e73952236118d144f60aa44af19eca79ba1d622a'],1,1,2,974159,1,,,,2743
b90278af3446fe82b061c08076d61b7d1ecaa445,0,Ismaël Mejía,2021-02-15 14:51:13+01:00,['ab583427573cd9a1476265ed176f18c6b1180a30'],1,1,2,974161,1,,,,2743
4a3a624509f5dfd40e8f5b32e9d60cc7a90ab4fa,0,GitHub,2021-02-23 16:41:38+05:18,['b90278af3446fe82b061c08076d61b7d1ecaa445'],12,379,391,974552,4,0.722222222,0.888888889,1,2745
c7eef98ba68fc23df9a0256a0a93ac405fe3b948,0,GitHub,2021-02-23 18:20:57+01:00,['4a3a624509f5dfd40e8f5b32e9d60cc7a90ab4fa'],0,1,1,974553,1,,,,2745
4918c14684a384d80b077fe27488c1912c3bc9bb,0,GitHub,2021-02-23 22:45:46+01:00,['c7eef98ba68fc23df9a0256a0a93ac405fe3b948'],1,1,2,974555,1,,,,2745
552ee9e3c1679fec9ecb959c7c12ed7bd91827b0,0,GitHub,2021-02-24 16:10:13+01:00,['4918c14684a384d80b077fe27488c1912c3bc9bb'],9,80,89,974644,2,0.531914894,0.531914894,1,2745
25459ec86ca469ee3ead855bb78556b2f09b8a24,0,GitHub,2021-02-28 08:57:51+05:18,['552ee9e3c1679fec9ecb959c7c12ed7bd91827b0'],56,39,95,974739,2,0,0,0,2745
d4a257460cfbebec3dc2d0ab82375fb7ee4bd212,0,GitHub,2021-02-28 09:03:13+01:00,['25459ec86ca469ee3ead855bb78556b2f09b8a24'],1,1,2,974741,1,,,,2745
adf099d5898fd92397b21ed367be299e321e8aba,0,GitHub,2021-02-28 09:03:57+01:00,['d4a257460cfbebec3dc2d0ab82375fb7ee4bd212'],1,1,2,974743,1,,,,2745
23fe79f324d6c7e7e13243d6c39a5c0da7196609,0,GitHub,2021-02-28 09:04:52+01:00,['adf099d5898fd92397b21ed367be299e321e8aba'],1,1,2,974745,1,,,,2745
c076d619ebc32c5855258e1c9b337de2a2f3a1d1,0,Ismaël Mejía,2021-02-28 11:55:45+01:00,['23fe79f324d6c7e7e13243d6c39a5c0da7196609'],1,7,8,974753,1,,,,2745
bfbb45b0605b8498b4050d05adcb2270350579ae,0,Ismaël Mejía,2021-02-28 12:30:07+01:00,['c076d619ebc32c5855258e1c9b337de2a2f3a1d1'],1,1,2,974755,1,,,,2745
cff3bdad6e32faf74cae7321e0bcef83846d5351,0,Ismaël Mejía,2021-03-02 00:40:17+01:00,['bfbb45b0605b8498b4050d05adcb2270350579ae'],15,66,81,974836,6,0.4,0.5,0.25,2745
c175a63b64ee5440a906ad9dcbd298334c2c2555,1,GitHub,2021-03-02 19:37:02-05:00,['cff3bdad6e32faf74cae7321e0bcef83846d5351'],48,186,234,975070,15,,,,2747
7c38a2977f498708fae9ca4c0a1710d1417922ee,0,GitHub,2021-03-04 10:34:39+01:00,['c175a63b64ee5440a906ad9dcbd298334c2c2555'],1,1,2,975072,1,,,,2747
52e4d6ee1cd9f79970da38df11934e637e52b65a,0,GitHub,2021-03-04 10:35:02+01:00,['7c38a2977f498708fae9ca4c0a1710d1417922ee'],1,1,2,975074,1,,,,2747
fc22ada98fa5cca84651ba3f7c788910b324d852,0,GitHub,2021-03-04 10:35:14+01:00,['52e4d6ee1cd9f79970da38df11934e637e52b65a'],1,1,2,975076,1,,,,2747
f40474e07550cc33e054607a66f6cbd40fd09250,0,GitHub,2021-03-04 10:35:23+01:00,['fc22ada98fa5cca84651ba3f7c788910b324d852'],1,1,2,975078,1,,,,2747
1f49e55c71184fe73c754be4fa39dcb1db46d4cb,0,GitHub,2021-03-04 11:29:43+01:00,['f40474e07550cc33e054607a66f6cbd40fd09250'],341,2591,2932,978010,2,,,,2747
72654bf73c9eefec06001ab2d1181fbfb127922c,0,Ismaël Mejía,2021-03-04 14:06:29+01:00,['1f49e55c71184fe73c754be4fa39dcb1db46d4cb'],0,118,118,978128,2,0.487804878,0.902439024,1,2748
e90c0c5cd7740a948fa49172e921bc88573ed699,0,Ismaël Mejía,2021-03-04 14:34:58+01:00,['72654bf73c9eefec06001ab2d1181fbfb127922c'],8,68,76,978204,3,0.130434783,0.130434783,0.130434783,2748
bfe1d03d683d67cdb9a984c02c6b1eb75ffe7689,0,Ismaël Mejía,2021-03-04 14:34:58+01:00,['e90c0c5cd7740a948fa49172e921bc88573ed699'],47,1,48,978252,2,0.88372093,0.88372093,0.88372093,2748
2459d95096a59559553bc4bd8c74cebf8a75d804,1,GitHub,2021-03-04 19:02:23+01:00,['bfe1d03d683d67cdb9a984c02c6b1eb75ffe7689'],1,54,55,978307,5,1,1,1,2750
b882d5230991b42bd017601435ea059d7cd3b492,0,Ismaël Mejía,2021-03-05 16:29:48+01:00,['2459d95096a59559553bc4bd8c74cebf8a75d804'],1,7,8,978315,4,,,,2750
04928ad70d7c56f821f0cce2033984874c13f53a,0,GitHub,2021-03-07 19:07:36+05:18,['b882d5230991b42bd017601435ea059d7cd3b492'],3,6,9,978324,1,,,,2750
f4e2ebaadaf6e6d99b59882233f8024243adb55d,0,GitHub,2021-03-07 19:13:17+05:18,['04928ad70d7c56f821f0cce2033984874c13f53a'],1539,1252,2791,981115,35,0.634408602,0.23655914,0.172043011,2751
0209b21a348ed7d0866c3dc46bfbcc780e86f2dd,0,GitHub,2021-03-09 16:52:33+01:00,['f4e2ebaadaf6e6d99b59882233f8024243adb55d'],5,5,10,981125,2,,,,2751
8824d6577368cf29b867efcd331151259c24e7b0,0,Ismaël Mejía,2021-03-09 17:52:22+01:00,['0209b21a348ed7d0866c3dc46bfbcc780e86f2dd'],1,1,2,981127,1,,,,2751
6ebaa2d8ec5a72b459c2439a255096d67eb8bb9a,0,Ismaël Mejía,2021-03-14 19:01:06+01:00,['8824d6577368cf29b867efcd331151259c24e7b0'],1,1,2,981129,1,,,,2751
e0a6a770cbc597b635009a8cb5de3d9f5437bdfe,0,Ismaël Mejía,2021-03-14 19:03:36+01:00,['6ebaa2d8ec5a72b459c2439a255096d67eb8bb9a'],1,1,2,981131,1,,,,2751
ba7a5895179f12521eccc0b18a5941d356fc117c,0,Ismaël Mejía,2021-03-14 19:56:59+01:00,['e0a6a770cbc597b635009a8cb5de3d9f5437bdfe'],1,1,2,981133,1,,,,2751
f67e53ac7e8592b609ba46ea9cd4d73c350baa85,0,GitHub,2021-03-15 14:53:19-04:00,['ba7a5895179f12521eccc0b18a5941d356fc117c'],0,1089,1089,982222,3,0.20913884,0.780316344,0.724077329,2753
c030d4201e315f62f11ea9757017c38239fa6a17,0,GitHub,2021-03-17 18:42:40+01:00,['f67e53ac7e8592b609ba46ea9cd4d73c350baa85'],2,2,4,982226,1,,,,2753
b934afe2fa7d6a6553d505b1db2a516374c886f3,0,GitHub,2021-03-18 10:02:11+01:00,['c030d4201e315f62f11ea9757017c38239fa6a17'],0,1,1,982227,1,,,,2753
860f45803c611c985683c9fc28482338d7dd5b3b,0,GitHub,2021-03-18 17:42:07+01:00,['b934afe2fa7d6a6553d505b1db2a516374c886f3'],762,855,1617,983844,9,0.431372549,0.026143791,0.986928105,2754
5be7d16312fb3a0e1ea18c60a04ba0c1e92e1fc0,0,GitHub,2021-03-18 18:25:03+01:00,['860f45803c611c985683c9fc28482338d7dd5b3b'],1,5,6,983850,1,,,,2754
1fb064ddb647686a707f55290bd0fee83a366df1,0,Ismaël Mejía,2021-03-22 01:42:35+01:00,['5be7d16312fb3a0e1ea18c60a04ba0c1e92e1fc0'],6,6,12,983862,1,,,,2754
b4e8bd84205c0d7f210a4c5783a934d7c9a55275,0,GitHub,2021-03-22 10:15:02+05:18,['1fb064ddb647686a707f55290bd0fee83a366df1'],2,2,4,983866,1,,,,2754
338db27462cbb442a60033f99fde7d92f863b28a,0,GitHub,2021-03-22 14:53:09+05:18,['b4e8bd84205c0d7f210a4c5783a934d7c9a55275'],12,13,25,983891,3,0,0,1,2754
f0ee46dbceb4327f50a552ff32ad8c7641b43781,0,GitHub,2021-03-22 14:58:30+05:18,['338db27462cbb442a60033f99fde7d92f863b28a'],0,1,1,983892,1,,,,2754
42822886c28ea74a744abb7e7a80a942c540faa5,1,GitHub,2021-03-23 11:07:19+01:00,['f0ee46dbceb4327f50a552ff32ad8c7641b43781'],1,3,4,983896,3,,,,2754
0b13a87dae9e7379c6fd4c2e0e896f2efc188015,1,GitHub,2021-03-24 22:22:41+05:18,['42822886c28ea74a744abb7e7a80a942c540faa5'],1179,1064,2243,986139,32,0.692982456,0.552631579,0.201754386,2754
5bd7cfe0bf742d0482bf6f54b4541b4d22cc87d9,0,GitHub,2021-03-25 11:28:05-04:00,['0b13a87dae9e7379c6fd4c2e0e896f2efc188015'],4,4,8,986147,2,,,,2754
39de1e2049008415a01004dfefe7a875afbd66bd,1,GitHub,2021-03-29 11:53:08+05:18,['5bd7cfe0bf742d0482bf6f54b4541b4d22cc87d9'],5199,4453,9652,995799,82,0.415686275,0.08627451,0.084313725,2755
0ceb3dfdd3ca8ec84f43aff9678e01cf47f3fbe2,0,Ismaël Mejía,2021-03-29 13:32:45+02:00,['39de1e2049008415a01004dfefe7a875afbd66bd'],1,1,2,995801,1,,,,2755
563ca6af476ce56bc1be5b5b9be82e8809c41cfa,0,Ismaël Mejía,2021-03-29 13:33:11+02:00,['0ceb3dfdd3ca8ec84f43aff9678e01cf47f3fbe2'],1,1,2,995803,1,,,,2755
95876f284d59acb3d7993918bda9747a68f68b99,0,GitHub,2021-03-31 08:38:01+05:18,['563ca6af476ce56bc1be5b5b9be82e8809c41cfa'],192,209,401,996204,7,0,0,0,2755
7c5e429ac5a71596844bf1d52626ce29054dd335,0,GitHub,2021-04-01 10:22:57+02:00,['95876f284d59acb3d7993918bda9747a68f68b99'],35,6,41,996245,6,,,,2755
5b6e75cd29d7e78fd0422bc71b1dfad0bebe47d3,0,GitHub,2021-04-01 13:18:45+02:00,['7c5e429ac5a71596844bf1d52626ce29054dd335'],5,11,16,996261,1,,,,2755
c9aee06dc78ee01b39aaacba7582bc431fb36ccf,0,GitHub,2021-04-01 17:33:58+05:18,['5b6e75cd29d7e78fd0422bc71b1dfad0bebe47d3'],528,509,1037,997298,12,1,1,0.5,2755
4d3da1107b8c22b0b6a3b0853fa676553d35188c,0,GitHub,2021-04-02 08:23:16+02:00,['c9aee06dc78ee01b39aaacba7582bc431fb36ccf'],2,2,4,997302,1,,,,2755
c4168a0c0eccca5f117e2cc98e283fa73fe4ea91,0,GitHub,2021-04-03 09:47:11+05:18,['4d3da1107b8c22b0b6a3b0853fa676553d35188c'],71,54,125,997427,8,,,,2755
8a5774b8a4942c40ee9279efeb712cfea8a1ce55,0,GitHub,2021-04-04 09:58:03+05:18,['c4168a0c0eccca5f117e2cc98e283fa73fe4ea91'],327,300,627,998054,12,0.571428571,0,0,2755
20d67fdd27404b9f240a8275774b91f567ed4419,0,Ismaël Mejía,2021-04-04 09:57:14+02:00,['8a5774b8a4942c40ee9279efeb712cfea8a1ce55'],1,1,2,998056,1,,,,2755
83e31445a9cb2a7cf08c88f26fb7c7772bcbecfc,0,Ismaël Mejía,2021-04-04 10:51:57+02:00,['20d67fdd27404b9f240a8275774b91f567ed4419'],1,1,2,998058,1,,,,2755
2b299efb6ce3b294991e3461304e4f1715579ddc,0,Ismaël Mejía,2021-04-04 11:36:26+02:00,['83e31445a9cb2a7cf08c88f26fb7c7772bcbecfc'],1,1,2,998060,1,,,,2755
c769c4343e24d2473417afe46b37a1b60d7ca84f,1,GitHub,2021-04-05 09:41:47-04:00,['2b299efb6ce3b294991e3461304e4f1715579ddc'],42,580,622,998682,3,0.50297619,1,1,2755
e819e3677e6e46da6cb75b1dd41d66dc976d1ea0,0,Ismaël Mejía,2021-04-05 21:52:38+02:00,['c769c4343e24d2473417afe46b37a1b60d7ca84f'],1,1,2,998684,1,,,,2755
89efb8dd7bef28945d0e9598d913aa9ec843593c,0,GitHub,2021-04-06 15:09:47+02:00,['e819e3677e6e46da6cb75b1dd41d66dc976d1ea0'],11,17,28,998712,1,1,1,1,2755
589a9be3387aea2ad3c356964256eaff7645c3c2,0,GitHub,2021-04-06 20:20:52+02:00,['89efb8dd7bef28945d0e9598d913aa9ec843593c'],1,1,2,998714,1,,,,2755
d6e6fc068f8c0eaaf84d81b623744d363ece294d,0,Ismaël Mejía,2021-04-11 15:10:27+02:00,['589a9be3387aea2ad3c356964256eaff7645c3c2'],1,1,2,998716,1,,,,2755
a3befb526c0e011036b66649c2360a8c1c7d9419,0,Ismaël Mejía,2021-04-11 15:11:19+02:00,['d6e6fc068f8c0eaaf84d81b623744d363ece294d'],6,6,12,998728,1,,,,2755
357b8fad6464ab25f8e03385ca54d1ce8ec63543,0,Ismaël Mejía,2021-04-11 15:11:59+02:00,['a3befb526c0e011036b66649c2360a8c1c7d9419'],1,1,2,998730,1,,,,2755
0c9a60eba295adf9b92f785f204b5b2875ef5ac5,1,GitHub,2021-04-16 13:55:38+02:00,['357b8fad6464ab25f8e03385ca54d1ce8ec63543'],5,39,44,998774,4,0.928571429,0.928571429,0.928571429,2755
b47eda9d130f09847d5c666ce8b057196963b578,0,GitHub,2021-04-16 14:02:31+02:00,['0c9a60eba295adf9b92f785f204b5b2875ef5ac5'],18,24,42,998816,5,,,,2755
4961457f91d08a5907ebd71ca9ed088cea30f342,0,GitHub,2021-04-16 16:16:46+02:00,['b47eda9d130f09847d5c666ce8b057196963b578'],8,9,17,998833,3,,,,2755
c5cfc6c712af06487e54e52b3983c32949650f3e,0,Ismaël Mejía,2021-04-18 09:34:39+02:00,['4961457f91d08a5907ebd71ca9ed088cea30f342'],1,1,2,998835,1,,,,2755
493ff8a966e17fa5bf6e293aa64afc156915d624,0,Ismaël Mejía,2021-04-18 09:49:04+02:00,['c5cfc6c712af06487e54e52b3983c32949650f3e'],6,6,12,998847,1,,,,2755
7df18d6fa83c2ed6e3bd69b5cc84e5b6815fb280,0,GitHub,2021-04-19 17:32:43+02:00,['493ff8a966e17fa5bf6e293aa64afc156915d624'],1,1,2,998849,1,,,,2755
e25282a9bc53eb3558ec36d9daf72e84ba5145c1,0,GitHub,2021-04-19 17:34:29+02:00,['7df18d6fa83c2ed6e3bd69b5cc84e5b6815fb280'],1,1,2,998851,1,,,,2755
101b8327a0f143bc141d75a37c8e8f601137fbda,0,GitHub,2021-04-19 18:29:45+02:00,['e25282a9bc53eb3558ec36d9daf72e84ba5145c1'],1,1,2,998853,1,,,,2755
4fd00e0f3f7d925422293f7b64eb9827e69f9c6a,0,Ismaël Mejía,2021-04-19 21:48:41+02:00,['101b8327a0f143bc141d75a37c8e8f601137fbda'],1,1,2,998855,1,,,,2755
2ad9d3c69b29f9ea344a93f841fe57de683a520b,0,Ismaël Mejía,2021-04-20 17:48:39+02:00,['4fd00e0f3f7d925422293f7b64eb9827e69f9c6a'],4,9,13,998868,9,,,,2755
50676f142fad5d685d9f0e24a7f2e9d01e6eb8e8,0,Ismaël Mejía,2021-04-20 19:56:03+02:00,['2ad9d3c69b29f9ea344a93f841fe57de683a520b'],0,32,32,998900,1,,,,2755
e177951d56d3a7cbacc8165abf7d98da743db0e9,0,Ismaël Mejía,2021-04-20 20:42:28+02:00,['50676f142fad5d685d9f0e24a7f2e9d01e6eb8e8'],1,1,2,998902,1,,,,2755
31c4092b13cf22a2adb3a7a7925cde0a79a970f4,0,Ismaël Mejía,2021-04-20 22:36:03+02:00,['e177951d56d3a7cbacc8165abf7d98da743db0e9'],1,1,2,998904,1,,,,2755
1f00455e496be35a941833e956376ef3d791116b,0,GitHub,2021-04-21 09:44:13+02:00,['31c4092b13cf22a2adb3a7a7925cde0a79a970f4'],1,23,24,998928,2,,,,2755
ffac9093dc183afb790ab2c01f691d8527c5fff1,0,Ismaël Mejía,2021-04-22 12:43:40+02:00,['1f00455e496be35a941833e956376ef3d791116b'],1,1,2,998930,1,,,,2755
18890afe3d728a0c1ef1f2aba46155c32cf0d567,0,GitHub,2021-04-27 13:46:28+02:00,['ffac9093dc183afb790ab2c01f691d8527c5fff1'],37,11,48,998978,3,,,,2755
c17df618cbf717b17a0e906aa4200b0ce9daebc9,0,Ismaël Mejía,2021-04-28 15:25:32+02:00,['18890afe3d728a0c1ef1f2aba46155c32cf0d567'],5,2,7,998985,1,0,0,0,2755
01b174a161892802f22c6424e800ded903084078,0,Ismaël Mejía,2021-04-28 15:25:32+02:00,['c17df618cbf717b17a0e906aa4200b0ce9daebc9'],12,11,23,999008,6,,,,2755
4be83e4a6768bcae90d43c20a914d082850ffd76,0,Ismaël Mejía,2021-04-28 15:25:32+02:00,['01b174a161892802f22c6424e800ded903084078'],2,13,15,999023,3,,,,2755
3f34bf8b65df1190c54d80f437d47f76a029de76,0,GitHub,2021-04-28 15:47:54+02:00,['4be83e4a6768bcae90d43c20a914d082850ffd76'],27,90,117,999140,4,1,1,0.666666667,2755
1ac15edc8609d700aa0ed5ece207ab904f1a8623,0,GitHub,2021-04-30 15:36:44+02:00,['3f34bf8b65df1190c54d80f437d47f76a029de76'],3,24,27,999167,2,1,0.833333333,1,2755
546f9f9f11152a024a035df567b5d329d2acf46f,0,GitHub,2021-05-02 10:05:40+02:00,['1ac15edc8609d700aa0ed5ece207ab904f1a8623'],1,1,2,999169,1,,,,2755
ad4083b097257ac72e5cf32985e757aa09107b6e,0,GitHub,2021-05-02 10:41:31-04:00,['546f9f9f11152a024a035df567b5d329d2acf46f'],50,133,183,999352,33,,,,2756
d1ad56f762ab19a20f10000498e7c867532aa422,0,GitHub,2021-05-03 14:49:56+02:00,['ad4083b097257ac72e5cf32985e757aa09107b6e'],321,393,714,1000066,21,,,,2756
08d9f1998836355526d12a9f09b904b23e7ccb1f,0,GitHub,2021-05-03 15:20:10+02:00,['d1ad56f762ab19a20f10000498e7c867532aa422'],0,45,45,1000111,1,,,,2757
69871012fffdd6de82b32c194e7a1880320fa700,0,GitHub,2021-05-03 23:17:04+02:00,['08d9f1998836355526d12a9f09b904b23e7ccb1f'],160,384,544,1000655,33,,,,2757
103477369fcb49a5372f9f5c1353fcd575119287,0,GitHub,2021-05-04 16:04:06+02:00,['69871012fffdd6de82b32c194e7a1880320fa700'],17,37,54,1000709,11,1,1,1,2757
389d35131af037bbf3bd5da739528a13191ade43,0,GitHub,2021-05-08 07:46:13-04:00,['103477369fcb49a5372f9f5c1353fcd575119287'],15,227,242,1000951,4,0.1625,0.94375,0.975,2757
224e2bb3bae5ea22a38689b665ff730bae6a796b,0,Tim Perkins,2021-05-08 08:03:07-04:00,['389d35131af037bbf3bd5da739528a13191ade43'],1,1,2,1000953,1,,,,2757
759b63d90a6d8712b1e344254c5d32f350cda66a,0,GitHub,2021-05-09 07:52:36+02:00,['224e2bb3bae5ea22a38689b665ff730bae6a796b'],1,1,2,1000955,1,,,,2757
7d4dbee18244824f3bfea90247ee4a3e27b7b822,0,GitHub,2021-05-09 07:53:02+02:00,['759b63d90a6d8712b1e344254c5d32f350cda66a'],1,1,2,1000957,1,,,,2757
68708e718c8f3731768644305b15fcdca2e30a77,0,GitHub,2021-05-09 23:20:09+02:00,['7d4dbee18244824f3bfea90247ee4a3e27b7b822'],0,7,7,1000964,2,0.6,0.6,1,2757
542b65d174759f32666139422d848daccc4a1c3d,0,GitHub,2021-05-14 19:05:24+02:00,['68708e718c8f3731768644305b15fcdca2e30a77'],0,3,3,1000967,1,,,,2757
93d5e2110ca867c6c6611f8715c0934e437518c7,0,GitHub,2021-05-14 19:43:39-04:00,['542b65d174759f32666139422d848daccc4a1c3d'],341,341,682,1001649,3,0.333333333,1,0.5,2757
36974d0e87f6b1af34d3575403afd22c62b728d5,0,GitHub,2021-05-15 10:27:33+02:00,['93d5e2110ca867c6c6611f8715c0934e437518c7'],5,3,8,1001657,2,,,,2757
df51e78752030c5ac929bd9adbb6fe1739a28485,0,GitHub,2021-05-15 10:43:20-04:00,['36974d0e87f6b1af34d3575403afd22c62b728d5'],10,420,430,1002087,6,0.662162162,1,0.972972973,2757
2bbac9e8c6ebbf462e6610b699f852b8df835668,0,GitHub,2021-05-16 08:19:36+02:00,['df51e78752030c5ac929bd9adbb6fe1739a28485'],1,1,2,1002089,1,,,,2757
282ed6171792d30e9d15336e2ec2c289db7efd48,0,GitHub,2021-05-16 08:20:26+02:00,['2bbac9e8c6ebbf462e6610b699f852b8df835668'],1,1,2,1002091,1,,,,2757
b51f7158b4af6b3e54918ad89aca79f76200c460,0,GitHub,2021-05-16 10:16:31+02:00,['282ed6171792d30e9d15336e2ec2c289db7efd48'],1,1,2,1002093,1,,,,2757
04015fed09065138679e5e90fcf8615ffb5f4e6e,0,GitHub,2021-05-19 21:47:56+02:00,['b51f7158b4af6b3e54918ad89aca79f76200c460'],0,82,82,1002175,1,,,,2758
be168d7d19ede539b45d42c4a310b979a7406486,0,GitHub,2021-05-20 07:25:40+02:00,['04015fed09065138679e5e90fcf8615ffb5f4e6e'],0,2,2,1002177,1,,,,2758
817c85a2cc30c24ce2032eecccef7a7c50b6979a,0,GitHub,2021-05-20 20:50:14-04:00,['be168d7d19ede539b45d42c4a310b979a7406486'],10026,0,10026,1012203,32,0.442797495,0.161795407,0.185177453,2758
72a0fef3e9247bd94621288fb2e6d88408e3c836,0,GitHub,2021-05-21 09:11:07-04:00,['817c85a2cc30c24ce2032eecccef7a7c50b6979a'],63,44,107,1012310,2,0,0,0,2758
d979758d43f58c8c7cae38c246d8821c4e61fa31,0,GitHub,2021-05-23 10:00:10+02:00,['72a0fef3e9247bd94621288fb2e6d88408e3c836'],1,1,2,1012312,1,,,,2758
d67e6adcb307d159517c811eee60e62f90c265d3,0,GitHub,2021-05-23 10:00:59+02:00,['d979758d43f58c8c7cae38c246d8821c4e61fa31'],1,1,2,1012314,1,,,,2758
bdff7574f386ca317f37584531928641a66d1b96,0,GitHub,2021-05-23 10:01:08+02:00,['d67e6adcb307d159517c811eee60e62f90c265d3'],1,1,2,1012316,1,,,,2758
c8f953bc5e6599b90283992b643bdc91adbef84b,1,GitHub,2021-05-23 16:34:08-04:00,['bdff7574f386ca317f37584531928641a66d1b96'],318,548,866,1013182,4,0,0.764705882,0.546218487,2758
88a6014b17b36eb94df9e9208c5cc44449c1da51,0,Ismaël Mejía,2021-05-24 17:20:31+02:00,"['c8f953bc5e6599b90283992b643bdc91adbef84b', '941000b1e3c71a89010999d7aa0c4955e3672f5a']",0,12382,12382,1025564,40,,,,2758
7f15e3d52d0066b04c11e94b7dc9a3959cb3859b,0,Ismaël Mejía,2021-05-24 18:05:49+02:00,['88a6014b17b36eb94df9e9208c5cc44449c1da51'],5,197,202,1025766,1,,,,2758
f84c53c1fb066db34fef53ab4694ff2d44462b16,0,Ismaël Mejía,2021-05-24 18:15:33+02:00,['7f15e3d52d0066b04c11e94b7dc9a3959cb3859b'],0,605,605,1026371,35,,,,2758
e80bd2542243619673b7b3072da892a1afb9ac68,0,Ismaël Mejía,2021-05-24 18:22:50+02:00,['f84c53c1fb066db34fef53ab4694ff2d44462b16'],0,5,5,1026376,1,,,,2758
8cf8e7070958a4a287e0f1a138f1eea9d0c31fc9,0,Ismaël Mejía,2021-05-24 18:40:46+02:00,['e80bd2542243619673b7b3072da892a1afb9ac68'],18,22,40,1026416,4,,,,2758
25187ec39d3564b0e564baec53365c9cce565b74,0,GitHub,2021-05-28 14:24:27-04:00,['c8f953bc5e6599b90283992b643bdc91adbef84b'],2,256,258,1026674,5,,,,2761
0c96242bb7816cfe0d61ac8ff25c8572c3d9e2e6,1,GitHub,2021-05-28 14:37:22-04:00,['25187ec39d3564b0e564baec53365c9cce565b74'],44,90,134,1026808,3,0.958333333,0.958333333,0.958333333,2761
9f2f2d52b5449f82f4c7fa8db8581bc16ef70d1f,0,GitHub,2021-05-28 15:51:47-04:00,['0c96242bb7816cfe0d61ac8ff25c8572c3d9e2e6'],13,4,17,1026825,4,,,,2761
8c156bd10af22f5bda22a926f86c21e93b12ab4e,1,GitHub,2021-05-28 16:07:13-04:00,['9f2f2d52b5449f82f4c7fa8db8581bc16ef70d1f'],2021,2671,4692,1031517,40,0,0.861952862,0.939393939,2762
b0b86bf2887ed259882a7355f4573d25629fd776,1,GitHub,2021-05-28 21:14:07-04:00,['8c156bd10af22f5bda22a926f86c21e93b12ab4e'],14,52,66,1031583,6,1,1,0,2762
981c88a68a37012c9e7f9c26bd6982bfaaf469ea,0,GitHub,2021-05-30 13:12:28+02:00,['b0b86bf2887ed259882a7355f4573d25629fd776'],1,1,2,1031585,1,,,,2762
2ab8fa85d05f04387bd5d63b10ad1c8fd2243616,0,GitHub,2021-05-30 13:13:36+02:00,['981c88a68a37012c9e7f9c26bd6982bfaaf469ea'],1,1,2,1031587,1,,,,2762
67818ad2069916f25af7cc27bd192d66359aa372,0,GitHub,2021-06-03 13:51:12+02:00,['2ab8fa85d05f04387bd5d63b10ad1c8fd2243616'],2,8,10,1031597,2,,,,2762
14108018e886257cb629d84e85bf3148efcb4095,0,GitHub,2021-06-07 08:20:24+02:00,['67818ad2069916f25af7cc27bd192d66359aa372'],1,1,2,1031599,1,,,,2762
4db2e32cbdf5577c62e9770e8387d1d312b2bfce,0,GitHub,2021-06-07 23:32:36-04:00,['14108018e886257cb629d84e85bf3148efcb4095'],11,7,18,1031617,1,,,,2762
c58e23b5770a6710491f7136e1279ef408fe8f40,0,GitHub,2021-06-08 14:15:15+02:00,['4db2e32cbdf5577c62e9770e8387d1d312b2bfce'],1,1,2,1031619,1,,,,2762
95edb5b6506015093dad197377bd021fa94776e2,1,GitHub,2021-06-08 20:58:01-04:00,['c58e23b5770a6710491f7136e1279ef408fe8f40'],157,187,344,1031963,3,0,0.28125,0.03125,2763
6dc6055e04188919886bd1b4ed95a7c6f4fac23e,0,GitHub,2021-06-09 22:09:54-04:00,['95edb5b6506015093dad197377bd021fa94776e2'],115,89,204,1032167,2,1,1,1,2763
b3944584e0dfea7c945902bde1d850b346aed4fd,0,Ismaël Mejía,2021-06-11 14:09:50+02:00,['8cf8e7070958a4a287e0f1a138f1eea9d0c31fc9'],11,9,20,1032187,3,,,,2763
5fd979fafe50cb55f0cd8129d45be0e1f15c4015,0,Ismaël Mejía,2021-06-11 16:58:52+02:00,"['6dc6055e04188919886bd1b4ed95a7c6f4fac23e', 'b3944584e0dfea7c945902bde1d850b346aed4fd']",0,13186,13186,1045373,42,,,,2763
d8a08cec5cbb7962b09f019f32325a9072df52d3,0,GitHub,2021-06-13 14:01:35+02:00,['5fd979fafe50cb55f0cd8129d45be0e1f15c4015'],1,1,2,1045375,1,,,,2763
9855c0eb737973e7a3976e2d85d40b41201be56d,0,GitHub,2021-06-13 14:01:59+02:00,['d8a08cec5cbb7962b09f019f32325a9072df52d3'],1,1,2,1045377,1,,,,2763
94698e2a5f3ee5ec3a62a859c5c6a5965e835409,0,GitHub,2021-06-13 14:02:22+02:00,['9855c0eb737973e7a3976e2d85d40b41201be56d'],1,1,2,1045379,1,,,,2763
11621b56a5c0729d92b77974e0cd7835dab57356,0,GitHub,2021-06-14 09:11:10-04:00,['94698e2a5f3ee5ec3a62a859c5c6a5965e835409'],215,263,478,1045857,6,0,0.2,1,2763
a3e4572dc6de4097cdf9d1e9fe984ed59ba281ad,1,GitHub,2021-06-16 19:28:10-04:00,['11621b56a5c0729d92b77974e0cd7835dab57356'],109,92,201,1046058,15,1,1,0.2,2763
ea371817d2e148531bc9bae959939e2911be22b6,0,GitHub,2021-06-18 07:29:13-04:00,['a3e4572dc6de4097cdf9d1e9fe984ed59ba281ad'],21,45,66,1046124,1,,,,2763
b2abc70bb85a5b515790d0ada7be212fadd5cce1,0,GitHub,2021-06-18 19:18:46-04:00,['ea371817d2e148531bc9bae959939e2911be22b6'],201,302,503,1046627,8,1,1,0.974025974,2764
abee9574e0f8bbd8937dc20a6fc7ec1d6ba5eada,0,GitHub,2021-06-21 10:01:31+02:00,['b2abc70bb85a5b515790d0ada7be212fadd5cce1'],1,1,2,1046629,1,,,,2764
bd63189c2e1857e68e5266b42ab9b5247f3791a5,0,GitHub,2021-06-21 10:02:13+02:00,['abee9574e0f8bbd8937dc20a6fc7ec1d6ba5eada'],1,1,2,1046631,1,,,,2764
093f576cad4106d14eaf2129286c1bbdfbff574a,0,GitHub,2021-06-21 10:03:18+02:00,['bd63189c2e1857e68e5266b42ab9b5247f3791a5'],1,1,2,1046633,1,,,,2764
73b5fa85db895f239fc683a3225d833ec659b67c,0,GitHub,2021-06-21 10:06:02+02:00,['093f576cad4106d14eaf2129286c1bbdfbff574a'],1,1,2,1046635,1,,,,2764
5bb032029bb2e07e5b9175b72bbf72a6fdef4289,0,GitHub,2021-06-22 08:49:10+05:18,['73b5fa85db895f239fc683a3225d833ec659b67c'],1,4,5,1046640,1,,,,2764
6c4e165584431aeb21ff8f84fe1cefc5c398fa8e,1,GitHub,2021-06-23 08:04:34-04:00,['5bb032029bb2e07e5b9175b72bbf72a6fdef4289'],342,438,780,1047420,8,0.419786096,0.705882353,0.393048128,2764
3b5cdb919ca2b40bb67d806554e98a008dfa07b1,0,Michael A. Smith,2021-06-23 21:08:54-04:00,['6c4e165584431aeb21ff8f84fe1cefc5c398fa8e'],685,0,685,1048105,1,0.527777778,0,0.046296296,2764
e813d7ae065c3f58bd9f1b3a7396d3bcf3d8f4ee,0,GitHub,2021-06-28 17:54:02+02:00,['3b5cdb919ca2b40bb67d806554e98a008dfa07b1'],2,2,4,1048109,2,,,,2764
72b3c51512752f471392e3e5eaa40f954a99b752,0,GitHub,2021-06-30 17:45:05+02:00,['e813d7ae065c3f58bd9f1b3a7396d3bcf3d8f4ee'],2,6,8,1048117,1,0.75,0.75,0.75,2764
8dd55dbac12103c4e81be199a7d819e8e8fb5b56,0,GitHub,2021-07-02 22:29:40+02:00,['72b3c51512752f471392e3e5eaa40f954a99b752'],1,42,43,1048160,2,1,1,1,2764
c4bc1da6b28f326e7c33b434627ce980c31d78fe,0,GitHub,2021-07-06 17:43:04+02:00,['8dd55dbac12103c4e81be199a7d819e8e8fb5b56'],1,1,2,1048162,1,,,,2764
4a5e4a686e55882d48c527328502700c765f1772,0,GitHub,2021-07-07 14:52:11+02:00,['c4bc1da6b28f326e7c33b434627ce980c31d78fe'],1,1,2,1048164,1,,,,2764
45f425f022c64c06e6ac29df47ca2dbbbbe35fdf,0,GitHub,2021-07-12 14:59:14+02:00,['4a5e4a686e55882d48c527328502700c765f1772'],1,1,2,1048166,1,,,,2764
f468930a1e119517491ed4e64b1bbd2906446b49,0,GitHub,2021-07-12 21:56:31-04:00,['45f425f022c64c06e6ac29df47ca2dbbbbe35fdf'],19,39,58,1048224,5,0,0.117647059,1,2764
1b630a9b5099051ea6cb63a37f7ca13e949a6343,0,GitHub,2021-07-13 11:22:52+02:00,['f468930a1e119517491ed4e64b1bbd2906446b49'],1,1,2,1048226,1,,,,2764
a2cfd3519c20a3022c11ff01c1f42acfad6b0108,0,GitHub,2021-07-16 12:29:20+02:00,['1b630a9b5099051ea6cb63a37f7ca13e949a6343'],1,1,2,1048228,1,,,,2764
a9e3915732fc29a47b150a902f5f5cdf666b502c,0,GitHub,2021-07-19 10:27:30+02:00,['a2cfd3519c20a3022c11ff01c1f42acfad6b0108'],1,1,2,1048230,1,,,,2764
ff8b0300e796a65cff0e2df6ac912300e03cc0a4,0,GitHub,2021-07-20 11:02:30+02:00,['a9e3915732fc29a47b150a902f5f5cdf666b502c'],1,1,2,1048232,1,,,,2764
ccb7a50077cb672407296935ffd6bacf2890ec83,0,GitHub,2021-07-26 10:15:27+02:00,['ff8b0300e796a65cff0e2df6ac912300e03cc0a4'],1,1,2,1048234,1,,,,2764
d303de5c1e1e9d1348a2a3b0de847d6a80025f00,0,GitHub,2021-07-26 18:30:55+02:00,['ccb7a50077cb672407296935ffd6bacf2890ec83'],197,197,394,1048628,8,,,,2764
340eb3ad0d4efdcdd9646decf5f2d9fe15352d89,0,GitHub,2021-07-27 16:51:09+02:00,['d303de5c1e1e9d1348a2a3b0de847d6a80025f00'],1,1,2,1048630,1,,,,2764
fca3cb41b40a0b048a43ca33c74262e89afa278b,0,GitHub,2021-07-31 09:08:47+02:00,['340eb3ad0d4efdcdd9646decf5f2d9fe15352d89'],4,4,8,1048638,1,,,,2764
0980ddac4c0707c22cf71a8dddeb1e8b42cc0dee,0,GitHub,2021-08-02 10:56:47+02:00,['fca3cb41b40a0b048a43ca33c74262e89afa278b'],1,1,2,1048640,1,,,,2764
ba3ad6d7db72cb063c559babc1ef4ff8cb1c0c32,0,GitHub,2021-08-06 15:43:19+02:00,['0980ddac4c0707c22cf71a8dddeb1e8b42cc0dee'],2,2,4,1048644,1,,,,2764
d1b4810a12e369cc94b4166037b29462275f409f,1,GitHub,2021-08-07 10:26:12+02:00,['ba3ad6d7db72cb063c559babc1ef4ff8cb1c0c32'],65,118,183,1048827,11,1,0,0,2765
914a6f2ef561c655ab64d81a35cbde1fb83b4c9d,0,Meni Braun,2021-08-09 09:41:53+03:00,['0980ddac4c0707c22cf71a8dddeb1e8b42cc0dee'],6,73,79,1048906,7,0.96875,1,0.6875,2765
3abe819c3b8a5a5666081a14a7e85be47cb19104,0,GitHub,2021-08-16 13:11:39+02:00,['d1b4810a12e369cc94b4166037b29462275f409f'],1,1,2,1048908,1,,,,2765
1410e79f9df61669c2d52f6d0643e6c35156e615,0,GitHub,2021-08-17 14:24:21+02:00,['3abe819c3b8a5a5666081a14a7e85be47cb19104'],1,1,2,1048910,1,,,,2765
0a5d4c99c21d588d83e2eca2e658b0533c65d391,0,GitHub,2021-08-26 16:27:49+02:00,['1410e79f9df61669c2d52f6d0643e6c35156e615'],1,20,21,1048931,2,0,1,1,2765
411b6b9cbe4046abdc9cc4293ebd9f2548f37b64,0,GitHub,2021-08-26 18:28:18+02:00,['0a5d4c99c21d588d83e2eca2e658b0533c65d391'],0,1,1,1048932,1,,,,2765
6a1d0f3a1c3b39350a27802bb1df18434985fe4b,0,GitHub,2021-08-27 11:39:19+02:00,['411b6b9cbe4046abdc9cc4293ebd9f2548f37b64'],2,48,50,1048982,2,,,,2765
0dc26365c209c22161b16fc3a7665007aa0f9ea7,0,GitHub,2021-08-28 23:29:08-04:00,['6a1d0f3a1c3b39350a27802bb1df18434985fe4b'],0,12,12,1048994,1,,,,2765
e8c61ba4f0051a76d4bf2e2d4391ec92a6e90f4f,1,GitHub,2021-08-29 22:34:27-04:00,['0dc26365c209c22161b16fc3a7665007aa0f9ea7'],529,581,1110,1050104,15,0.698689956,0.995633188,0.834061135,2766
042593d21a22918b2c3920470bbe0b5e586313e9,0,GitHub,2021-08-30 22:12:16-04:00,['e8c61ba4f0051a76d4bf2e2d4391ec92a6e90f4f'],2,2,4,1050108,1,,,,2766
9fd2b0e1f7da1c53e02803f2666ed08e19883ed4,0,GitHub,2021-08-31 10:14:24+02:00,['042593d21a22918b2c3920470bbe0b5e586313e9'],0,37,37,1050145,3,1,1,1,2767
39c0069521015537d976786cf57b6b4990b1a8c1,0,GitHub,2021-08-31 06:54:08-04:00,['9fd2b0e1f7da1c53e02803f2666ed08e19883ed4'],6,22,28,1050173,2,,,,2767
6a0e712e5d027ea0e8b3a9ee30ebc139bf0b842b,0,GitHub,2021-09-02 09:35:17+02:00,['39c0069521015537d976786cf57b6b4990b1a8c1'],1,1,2,1050175,1,,,,2767
5a2a26bc68ae4642d3ac4839b606a6a479ac8c04,0,GitHub,2021-09-03 15:37:15+02:00,['6a0e712e5d027ea0e8b3a9ee30ebc139bf0b842b'],0,3,3,1050178,1,,,,2767
4654e621888e631fa6980e83efa8cb100a272378,0,GitHub,2021-09-06 15:18:24+02:00,['5a2a26bc68ae4642d3ac4839b606a6a479ac8c04'],1,1,2,1050180,1,,,,2767
5d9984ef07d821d40d70341e2848a3b312798e5c,0,GitHub,2021-09-06 15:23:24+02:00,['4654e621888e631fa6980e83efa8cb100a272378'],13,32,45,1050225,3,1,1,1,2767
c0874195b66005615487c56ffdf9a32fb2557d8b,0,GitHub,2021-09-07 09:49:56+02:00,['5d9984ef07d821d40d70341e2848a3b312798e5c'],1,1,2,1050227,1,,,,2767
6d92d7a0f0a9345df412496ede11cc33471d12d8,0,GitHub,2021-09-08 17:32:48+02:00,['c0874195b66005615487c56ffdf9a32fb2557d8b'],1,1,2,1050229,1,,,,2767
e15c34cc6ce7be9c172253ec528942aa8ded4ce1,0,Daniel Kulp,2021-09-08 15:38:57-04:00,['6d92d7a0f0a9345df412496ede11cc33471d12d8'],1,6,7,1050236,1,0,1,0,2767
46ef00a3da71cefa7ace866c203f7969b026009a,0,Daniel Kulp,2021-09-08 15:44:19-04:00,['e15c34cc6ce7be9c172253ec528942aa8ded4ce1'],0,19,19,1050255,1,,,,2767
1dbb2312163aed49937f1d96d57b305d44e39ed3,0,GitHub,2021-09-09 13:39:53+02:00,['46ef00a3da71cefa7ace866c203f7969b026009a'],0,1,1,1050256,1,,,,2767
cf7bfe7710febdc84e70fcc8ad21d859dbf1be1f,1,Daniel Kulp,2021-09-09 16:07:36-04:00,['1dbb2312163aed49937f1d96d57b305d44e39ed3'],65,39,104,1050360,3,,,,2767
289a3cfdcf5ef6950dc433d10113d860bad4c382,0,Daniel Kulp,2021-09-09 16:52:32-04:00,['cf7bfe7710febdc84e70fcc8ad21d859dbf1be1f'],3,4,7,1050367,2,,,,2767
289c193d02f9639c437692878fcad83087a4c5be,0,Daniel Kulp,2021-09-09 16:58:10-04:00,['289a3cfdcf5ef6950dc433d10113d860bad4c382'],2,4,6,1050373,1,,,,2767
e285a8a222e6610db4eb7dd7497b4324e50ac177,0,Daniel Kulp,2021-09-09 17:05:18-04:00,['289c193d02f9639c437692878fcad83087a4c5be'],5,5,10,1050383,2,,,,2767
ae84185254c70ada10ad93dbc7b362f934b05254,0,Daniel Kulp,2021-09-09 17:32:28-04:00,['e285a8a222e6610db4eb7dd7497b4324e50ac177'],1,1,2,1050385,1,,,,2767
5ad692bb5f4c29433a7a737ff3b01d24315aad52,1,Daniel Kulp,2021-09-10 15:00:27-04:00,['ae84185254c70ada10ad93dbc7b362f934b05254'],19,19,38,1050423,8,,,,2767
60e2da37f103868c5b776eaa22e7de6c41a7cf00,0,Daniel Kulp,2021-09-10 15:00:47-04:00,['5ad692bb5f4c29433a7a737ff3b01d24315aad52'],5,11,16,1050439,1,,,,2767
444ea493f2f210f7d9839b153f97d72671e64a7a,0,GitHub,2021-09-13 11:02:03+02:00,['60e2da37f103868c5b776eaa22e7de6c41a7cf00'],1,1,2,1050441,1,,,,2767
b6491f3f9d196867f52393985d849af54f245fbd,0,Daniel Kulp,2021-09-13 09:25:14-04:00,['444ea493f2f210f7d9839b153f97d72671e64a7a'],1,1,2,1050443,1,,,,2767
5978d6f558e7d1d15bcbc45ba1713116655c317d,0,Daniel Kulp,2021-09-13 14:13:25-04:00,['b6491f3f9d196867f52393985d849af54f245fbd'],1,1,2,1050445,1,,,,2767
4a9f9876f4839c668ebc6b4ce158678215a6704a,0,Daniel Kulp,2021-09-13 14:19:33-04:00,"['914a6f2ef561c655ab64d81a35cbde1fb83b4c9d', '5978d6f558e7d1d15bcbc45ba1713116655c317d']",729,986,1715,1052160,60,,,,2767
39b849e9aceecf9547d3bf4e8879ba7f227aa941,0,Daniel Kulp,2021-09-13 14:21:24-04:00,['4a9f9876f4839c668ebc6b4ce158678215a6704a'],6,6,12,1052172,1,,,,2767
1e44880328fb1e1c8f6e98d863c9d36938316904,0,Daniel Kulp,2021-09-13 14:22:16-04:00,['39b849e9aceecf9547d3bf4e8879ba7f227aa941'],5,5,10,1052182,1,,,,2767
79a1ae9dc81873cfd767a23003846bea0f51c936,0,Daniel Kulp,2021-09-13 14:30:12-04:00,['1e44880328fb1e1c8f6e98d863c9d36938316904'],1,1,2,1052184,1,,,,2767
a50d65c5f446708483e1fabcd816ceb3b76bcf81,0,Daniel Kulp,2021-09-13 14:33:30-04:00,['79a1ae9dc81873cfd767a23003846bea0f51c936'],1,1,2,1052186,1,,,,2767
fe40576cd22e93776e7e48302f4d3358b0b4a4e3,0,Daniel Kulp,2021-09-13 14:35:39-04:00,['a50d65c5f446708483e1fabcd816ceb3b76bcf81'],1,47,48,1052234,2,1,1,1,2768
1f1efa7a04981ac458e1889d33f7a70429e9eca7,0,Daniel Kulp,2021-09-13 14:37:12-04:00,['fe40576cd22e93776e7e48302f4d3358b0b4a4e3'],2,7,9,1052243,1,0,0,1,2768
62a2d3f0e1490ae110059823af3aeda008b8a912,0,Daniel Kulp,2021-09-13 14:37:12-04:00,['1f1efa7a04981ac458e1889d33f7a70429e9eca7'],2,143,145,1052388,2,0,1,1,2769
d4cad4813f34252bf09f2b2ef8eca9795848a144,0,Daniel Kulp,2021-09-13 14:38:46-04:00,['62a2d3f0e1490ae110059823af3aeda008b8a912'],1,18,19,1052407,1,,,,2769
b815566e0f3ad3840588019b4cad6f3b6fb54971,0,Daniel Kulp,2021-09-13 15:41:13-04:00,['d4cad4813f34252bf09f2b2ef8eca9795848a144'],9,232,241,1052648,5,0.675324675,1,1,2772
4c9d326c9d8fc0320256034132fa6bbc90a37aa9,0,Daniel Kulp,2021-09-13 15:41:13-04:00,['b815566e0f3ad3840588019b4cad6f3b6fb54971'],0,51,51,1052699,3,,,,2772
9418a49ef1c02a3d4192f94ac24b93e8cc58bdff,0,Daniel Kulp,2021-09-13 15:43:38-04:00,['4c9d326c9d8fc0320256034132fa6bbc90a37aa9'],3,10,13,1052712,3,0,1,1,2772
184b9b04bb51cbc294d180316fa5dc200ef6d98f,0,Daniel Kulp,2021-09-13 15:46:59-04:00,['9418a49ef1c02a3d4192f94ac24b93e8cc58bdff'],1,2,3,1052715,1,0,1,1,2772
0341f4dd09024495d8a49b06212697c17b8f973e,0,Daniel Kulp,2021-09-14 12:00:42-04:00,['184b9b04bb51cbc294d180316fa5dc200ef6d98f'],24,31,55,1052770,3,,,,2772
36f5f97f6330184594edaca84a829313b7c83bcf,0,Daniel Kulp,2021-09-14 12:20:05-04:00,['0341f4dd09024495d8a49b06212697c17b8f973e'],1,1,2,1052772,1,,,,2772
97d4dd72d3102233721d95a85bb5000dcf32396b,0,GitHub,2021-09-15 10:15:08+02:00,['36f5f97f6330184594edaca84a829313b7c83bcf'],0,22,22,1052794,1,0.5,0.5,1,2772
6a2d7e72744bee6eb954a516bfa455e430071b99,0,Daniel Kulp,2021-09-15 16:47:26-04:00,['97d4dd72d3102233721d95a85bb5000dcf32396b'],0,5,5,1052799,2,,,,2772
b951829f06be7654d9543e89ff25a8b81abb3046,0,Daniel Kulp,2021-09-15 16:51:32-04:00,['6a2d7e72744bee6eb954a516bfa455e430071b99'],1,1,2,1052801,1,,,,2772
6322fad07a01cba1f62a2f41b891b000832370ed,1,Daniel Kulp,2021-09-15 17:40:39-04:00,['b951829f06be7654d9543e89ff25a8b81abb3046'],3,36,39,1052840,2,0,0.153846154,0.692307692,2772
2a353f42c18169756d04750fc3d056f1f3e7a292,0,GitHub,2021-09-21 11:49:54+02:00,['6322fad07a01cba1f62a2f41b891b000832370ed'],6,8,14,1052854,1,,,,2772
b94de96866740ad3beb19d6f6784bc341aadf5a0,0,GitHub,2021-09-21 17:31:10+02:00,['2a353f42c18169756d04750fc3d056f1f3e7a292'],56,444,500,1053354,13,0.87012987,0.980519481,0.941558442,2776
c5ffd6e4fa5a231e2b37cf0f165b9fe4fc4c3c6c,0,GitHub,2021-09-22 17:50:17+02:00,['b94de96866740ad3beb19d6f6784bc341aadf5a0'],74,85,159,1053513,6,0,0,0,2777
82a7bb62a3a24d01ce33d6e4cec33387f582aad7,0,Ryan Skraba,2021-09-27 15:22:08+02:00,['c5ffd6e4fa5a231e2b37cf0f165b9fe4fc4c3c6c'],51,51,102,1053615,11,,,,2777
d2468e342b26fc613741363bd41d47e365d831b8,0,GitHub,2021-09-28 16:18:41+02:00,['82a7bb62a3a24d01ce33d6e4cec33387f582aad7'],28,0,28,1053643,1,0.058823529,0,0,2777
c86b34d01e80e19c58f28d4104b280a3e6b891f9,0,GitHub,2021-09-28 16:24:04+02:00,['d2468e342b26fc613741363bd41d47e365d831b8'],1,48,49,1053692,2,0.307692308,1,1,2777
00a4f5c486baf2876bb0aaa3d1978285f0cf1d0a,0,GitHub,2021-10-05 14:26:59+02:00,['c86b34d01e80e19c58f28d4104b280a3e6b891f9'],9,117,126,1053818,3,0,1,1,2779
3fe5e306eaa43bdc06cef291321a8c04058a6be9,1,GitHub,2021-10-05 15:52:48+02:00,['00a4f5c486baf2876bb0aaa3d1978285f0cf1d0a'],27,76,103,1053921,6,0,0,0,2780
14b381b576f9ceb86062f6e68708cc3343abf869,0,GitHub,2021-10-06 11:22:01+02:00,['3fe5e306eaa43bdc06cef291321a8c04058a6be9'],3,4,7,1053928,1,,,,2780
da39228b606c9260652aaa583f460cb74997b197,0,GitHub,2021-10-06 11:49:08+02:00,['14b381b576f9ceb86062f6e68708cc3343abf869'],53,471,524,1054452,19,1,1,1,2788
a86dde293841a5f7856c11c799ca6561e6745419,0,GitHub,2021-10-06 12:47:52+02:00,['da39228b606c9260652aaa583f460cb74997b197'],13,46,59,1054511,5,0.846153846,0.923076923,0.307692308,2788
753ff034cd853359ee1531a44d4ee8c4b85d8976,1,GitHub,2021-10-06 17:06:14+02:00,['a86dde293841a5f7856c11c799ca6561e6745419'],6,6,12,1054523,2,,,,2788
0789cb7d98608bc8ff8add3b395dddd464ba23c5,0,GitHub,2021-10-06 17:06:35+02:00,['753ff034cd853359ee1531a44d4ee8c4b85d8976'],1,1,2,1054525,1,,,,2788
8f0b8d68c3fc10b6a5fc09bae4a5c30defe53897,0,GitHub,2021-10-06 17:31:34+02:00,['0789cb7d98608bc8ff8add3b395dddd464ba23c5'],3,13,16,1054541,3,,,,2788
dee5e32f8581107c28f73dc95fff74c0b4efc6f1,0,GitHub,2021-10-12 08:29:07-04:00,['8f0b8d68c3fc10b6a5fc09bae4a5c30defe53897'],3,17,20,1054561,3,1,1,1,2788
131f2c503b38ca7513fc9657205c7c67db3ab3ba,0,GitHub,2021-10-12 16:35:11+02:00,['dee5e32f8581107c28f73dc95fff74c0b4efc6f1'],2294,44,2338,1056899,29,,,,2788
fb398e0ddbdd67ae50909533f55defe52488e5da,0,GitHub,2021-10-13 11:55:02+02:00,['131f2c503b38ca7513fc9657205c7c67db3ab3ba'],0,4,4,1056903,2,1,1,1,2788
0f4197d94cb4672e756129d49af5c52591e2528f,0,GitHub,2021-10-14 10:12:08+02:00,['fb398e0ddbdd67ae50909533f55defe52488e5da'],25,68,93,1056996,8,,,,2789
e5811b404ac01fac0d0d6e223d62441554c9cbe9,0,GitHub,2021-10-18 10:51:33+02:00,['0f4197d94cb4672e756129d49af5c52591e2528f'],1,1,2,1056998,1,,,,2789
0ebd940282edfcec20c0d18faca68ea26ee31733,0,GitHub,2021-10-20 12:09:27+02:00,['e5811b404ac01fac0d0d6e223d62441554c9cbe9'],9,27,36,1057034,7,,,,2789
a1fce29d9675b4dd95dfee9db32cc505d0b2227c,0,GitHub,2021-10-20 12:46:10+02:00,['0ebd940282edfcec20c0d18faca68ea26ee31733'],21,163,184,1057218,3,0.01010101,0.565656566,1,2789
99547e0ee2e0a4a839253848d7b34bac7f5e4cea,0,GitHub,2021-11-16 14:40:04+01:00,['a1fce29d9675b4dd95dfee9db32cc505d0b2227c'],6,57,63,1057281,3,0.052631579,1,1,2790
de50c244c00420825d4bd7d04c0c2d353e439367,0,GitHub,2021-11-17 06:50:59-05:00,['99547e0ee2e0a4a839253848d7b34bac7f5e4cea'],0,1,1,1057282,1,,,,2790
64267e1f4e54a12551d02ff85e41c18090917e69,0,GitHub,2021-12-04 14:35:16+01:00,['de50c244c00420825d4bd7d04c0c2d353e439367'],5,9,14,1057296,3,,,,2790
0332fdfdf07343f33e6c9e2c28c491cd80c0bb88,1,GitHub,2021-12-04 14:41:18+01:00,['64267e1f4e54a12551d02ff85e41c18090917e69'],37,116,153,1057449,8,1,1,1,2792
527221aeff36587ecf5689a11114399494c2fceb,1,GitHub,2021-12-04 14:43:14+01:00,['0332fdfdf07343f33e6c9e2c28c491cd80c0bb88'],1,1,2,1057451,1,,,,2792
24ab2812eae62ac921bf03e0c1c41d1993f6551c,0,GitHub,2021-12-09 15:19:33+01:00,['527221aeff36587ecf5689a11114399494c2fceb'],1,1,2,1057453,1,,,,2792
c1dd47e9388bc30922f043877df15caedaff23af,0,GitHub,2021-12-09 18:45:29+01:00,['24ab2812eae62ac921bf03e0c1c41d1993f6551c'],1,1,2,1057455,1,,,,2792
d206242f3f8438421122accb87898a28eda1ea75,0,GitHub,2021-12-09 19:19:23+01:00,['c1dd47e9388bc30922f043877df15caedaff23af'],0,8,8,1057463,1,,,,2792
0e74de1eedc90418731d14ce51528b84dc3caf24,0,GitHub,2021-12-11 15:32:23+01:00,['d206242f3f8438421122accb87898a28eda1ea75'],3,145,148,1057611,5,1,1,1,2794
7d851528a5e833c5bb10a54b080b8c347cdcb2c9,0,GitHub,2021-12-11 15:36:05+01:00,['0e74de1eedc90418731d14ce51528b84dc3caf24'],1,1,2,1057613,1,,,,2794
7e97a1084e11851a2614677dc088734758594049,0,GitHub,2021-12-12 12:12:42+01:00,['7d851528a5e833c5bb10a54b080b8c347cdcb2c9'],37,795,832,1058445,25,0.555160142,0.900355872,0.889679715,2801
69acacd50e06e489e953f8948ee6a36759c814a0,0,GitHub,2021-12-13 19:06:58+01:00,['7e97a1084e11851a2614677dc088734758594049'],1,1,2,1058447,1,,,,2801
d568e6d618e87ce176ba4f4dce29f44dc6da0507,0,GitHub,2021-12-14 18:48:24+01:00,['69acacd50e06e489e953f8948ee6a36759c814a0'],1,0,1,1058448,1,,,,2801
c528cfd7582ccb67da5789bc6b114294f89805f4,0,GitHub,2021-12-14 19:12:06+01:00,['d568e6d618e87ce176ba4f4dce29f44dc6da0507'],1,5,6,1058454,1,,,,2801
8a5fc3cd17bdf6211097daf237e1e149efa78b56,0,GitHub,2021-12-15 18:27:09+01:00,['c528cfd7582ccb67da5789bc6b114294f89805f4'],0,31,31,1058485,2,,,,2801
895cdc8e2ebbf0341f292ff4ea684bf9cfbc68cb,0,GitHub,2021-12-17 19:45:12-05:00,['8a5fc3cd17bdf6211097daf237e1e149efa78b56'],1,1,2,1058487,1,,,,2801
a946ea706b933606540bc2afae4b81cf14cdbeb0,0,GitHub,2021-12-17 20:41:16-05:00,['895cdc8e2ebbf0341f292ff4ea684bf9cfbc68cb'],21,29,50,1058537,8,1,1,1,2801
57e0bbf961d0bffafe6dceddadc65f0defd84d80,0,GitHub,2021-12-17 20:59:46-05:00,['a946ea706b933606540bc2afae4b81cf14cdbeb0'],3,3,6,1058543,2,0,1,1,2801
33d86a61a9d225d83349ffbda21d2b31eeefe7ac,0,GitHub,2021-12-20 18:47:14+01:00,['57e0bbf961d0bffafe6dceddadc65f0defd84d80'],6,56,62,1058605,4,1,1,0.3,2802
28f54cb35af3fab56985b710892cf9469aa7022d,0,GitHub,2021-12-21 18:18:02+01:00,['33d86a61a9d225d83349ffbda21d2b31eeefe7ac'],0,10,10,1058615,3,0,0,0,2802
e7e48170a62c6060d7e532f7198756781f1d60d8,0,GitHub,2021-12-21 19:47:11+01:00,['28f54cb35af3fab56985b710892cf9469aa7022d'],2,4,6,1058621,3,,,,2802
1aa963c44d1b9da3dfcf74acb3eeed56439332a0,0,GitHub,2021-12-22 08:58:43+01:00,['e7e48170a62c6060d7e532f7198756781f1d60d8'],19,102,121,1058742,9,1,1,1,2803
7c5d8df3fb282b1dffa6d11169756ed5593de838,0,GitHub,2021-12-22 18:16:08+01:00,['1aa963c44d1b9da3dfcf74acb3eeed56439332a0'],16,101,117,1058859,4,,,,2803
d97e81f96e11cf0b550234d7c76045bea1734ab3,1,GitHub,2021-12-22 18:32:34+01:00,['7c5d8df3fb282b1dffa6d11169756ed5593de838'],0,79,79,1058938,7,,,,2803
bbe3db4cc1ef68eaa129586beb5978e6315d598f,0,GitHub,2021-12-22 18:37:14+01:00,['d97e81f96e11cf0b550234d7c76045bea1734ab3'],7,20,27,1058965,3,0,0,1,2803
e5a0e064d795be5efa1b05d50191c0d3441c5195,0,GitHub,2021-12-23 17:44:43+01:00,['bbe3db4cc1ef68eaa129586beb5978e6315d598f'],1,1,2,1058967,1,,,,2803
ea07ac016fef769e3e80645b32ca72e0a0d13a26,0,GitHub,2022-01-05 07:48:08+02:00,['e5a0e064d795be5efa1b05d50191c0d3441c5195'],19,23,42,1059009,5,,,,2803
6c2e3700b6c17e518755386fd81a2caa9deb1797,0,GitHub,2022-01-05 08:38:29+02:00,['ea07ac016fef769e3e80645b32ca72e0a0d13a26'],0,58,58,1059067,1,,,,2804
336f04adbe596b8f303b55ac29fbfc5c4785d960,0,GitHub,2022-01-05 08:39:02+02:00,['6c2e3700b6c17e518755386fd81a2caa9deb1797'],1,0,1,1059068,1,,,,2804
04e41fc2c8aa21e829f690e791e8aa2b0a049700,0,GitHub,2022-01-05 09:01:28+02:00,['336f04adbe596b8f303b55ac29fbfc5c4785d960'],1,52,53,1059121,5,0.5,0,1,2804
9da79b68f4e37d2910d48e42dd43e559770fd38b,0,GitHub,2022-01-05 09:32:42+02:00,['04e41fc2c8aa21e829f690e791e8aa2b0a049700'],1,55,56,1059177,4,0.481481481,0.481481481,1,2804
54f37e52cb373904c7529a74dee1275bffac457a,0,GitHub,2022-01-05 09:45:25+02:00,['9da79b68f4e37d2910d48e42dd43e559770fd38b'],5,13,18,1059195,2,0,0,1,2804
6a67d7161cf7c0f2e229c780b90afea8f2818886,0,GitHub,2022-01-05 10:09:21+02:00,['54f37e52cb373904c7529a74dee1275bffac457a'],1,1,2,1059197,1,,,,2804
c4ce231b911cb26a4b860149c542a449d717e231,0,GitHub,2022-01-05 10:23:27+02:00,['6a67d7161cf7c0f2e229c780b90afea8f2818886'],1,1,2,1059199,1,,,,2804
87d04ef9065e3ef21f1fb4135c56d3c6500d2530,0,GitHub,2022-01-05 10:43:55+02:00,['c4ce231b911cb26a4b860149c542a449d717e231'],0,54,54,1059253,2,,,,2805
74f9a51c354f986aae3efc8766d321a0939ec45f,0,GitHub,2022-01-05 10:47:44+02:00,['87d04ef9065e3ef21f1fb4135c56d3c6500d2530'],2,1,3,1059256,1,1,1,1,2805
bce386623c79b204957f1c37c43079d1c51c2038,0,GitHub,2022-01-05 13:15:24+02:00,['74f9a51c354f986aae3efc8766d321a0939ec45f'],17,128,145,1059401,5,0.576923077,1,1,2805
409ed65dcc991f49744b6f8a9f74d94e3b29ce50,0,GitHub,2022-01-05 06:36:03-05:00,['bce386623c79b204957f1c37c43079d1c51c2038'],0,2,2,1059403,1,,,,2805
b76a437b970889255703ff48f7ee5981dfbcc17a,1,GitHub,2022-01-05 13:37:26+02:00,['409ed65dcc991f49744b6f8a9f74d94e3b29ce50'],6,92,98,1059501,3,0,1,1,2805
13de1f06ea6a4a64646a8dea5edc1d2538f2eadc,0,Martin Tzvetanov Grigorov,2022-01-05 13:58:25+02:00,"['b76a437b970889255703ff48f7ee5981dfbcc17a', '5ebc186856114c508f28203b19654658e87045e7']",3,3,6,1059507,1,,,,2805
edd836f9d191b4ded5f1a23b432cb6913979c0d2,0,Martin Tzvetanov Grigorov,2022-01-05 14:10:04+02:00,['13de1f06ea6a4a64646a8dea5edc1d2538f2eadc'],21,21,42,1059549,7,,,,2805
d5b85d820f28f0ad82864188531f853a78e33cb9,0,Martin Tzvetanov Grigorov,2022-01-05 14:10:41+02:00,"['b76a437b970889255703ff48f7ee5981dfbcc17a', 'edd836f9d191b4ded5f1a23b432cb6913979c0d2']",24,24,48,1059597,8,,,,2805
4015f96f1c71b444f626ec15fac8095861d07620,0,GitHub,2022-01-05 14:42:19+02:00,['d5b85d820f28f0ad82864188531f853a78e33cb9'],1,1,2,1059599,1,,,,2805
7bda57acf5f19749bb3930f8816b06e4b3dee15a,0,GitHub,2022-01-05 15:10:09+02:00,['4015f96f1c71b444f626ec15fac8095861d07620'],1,1,2,1059601,1,,,,2805
3af326e5e7befcc2d01c3f91ef525fbda788b565,0,GitHub,2022-01-05 15:21:22+02:00,['7bda57acf5f19749bb3930f8816b06e4b3dee15a'],1,1,2,1059603,1,,,,2805
5b003cba088e122c553b0c648d13edb5ba250409,1,GitHub,2022-01-05 15:36:10+02:00,['3af326e5e7befcc2d01c3f91ef525fbda788b565'],0,221,221,1059824,1,,,,2806
2e68b3ff4f7f3633a418219cd1dcee5e5bd08921,1,Martin Tzvetanov Grigorov,2022-01-05 15:50:37+02:00,['5b003cba088e122c553b0c648d13edb5ba250409'],15,4,19,1059843,3,0,0,0,2806
4209b14b8750c5d631a77e2b84906a449c43f706,0,Martin Tzvetanov Grigorov,2022-01-07 15:03:54+02:00,['2e68b3ff4f7f3633a418219cd1dcee5e5bd08921'],2,3,5,1059848,1,,,,2806
7584320142768612bc7a58242231a476404bbceb,1,GitHub,2022-01-07 15:30:56+02:00,['4209b14b8750c5d631a77e2b84906a449c43f706'],25,117,142,1059990,2,0.173913043,0.347826087,1,2806
00969b71fb23a15a4741b4c8e906b243db5386db,1,Martin Tzvetanov Grigorov,2022-01-07 15:33:00+02:00,['7584320142768612bc7a58242231a476404bbceb'],51,53,104,1060094,2,1,1,0,2806
36f34be4ae5a4c8b7a79867d6e082c5f608d5760,0,Martin Tzvetanov Grigorov,2022-01-07 15:50:14+02:00,['00969b71fb23a15a4741b4c8e906b243db5386db'],28,29,57,1060151,1,0,1,1,2806
e8200cd2d40d9cf4a702905e6d2eeb9d589ec57a,1,GitHub,2022-01-07 15:51:55+02:00,['36f34be4ae5a4c8b7a79867d6e082c5f608d5760'],2,79,81,1060232,1,,,,2806
c0bfb88abebff7ec754c20b7797cbbe6a548495b,0,Martin Tzvetanov Grigorov,2022-01-07 16:11:09+02:00,['e8200cd2d40d9cf4a702905e6d2eeb9d589ec57a'],28,104,132,1060364,1,,,,2806
a29b8691c216f2954e063230ce957a27e30e1853,0,Martin Tzvetanov Grigorov,2022-01-10 09:59:26+02:00,['c0bfb88abebff7ec754c20b7797cbbe6a548495b'],2,1,3,1060367,1,,,,2806
a4f200efcb14ab381b0d83d71e972753c1d178c1,0,GitHub,2022-01-10 10:00:19+02:00,['a29b8691c216f2954e063230ce957a27e30e1853'],16,23,39,1060406,2,,,,2806
4781d8fe91dc8cc873d6ed21dc65c0b168e6fef4,0,GitHub,2022-01-10 12:24:15+02:00,['a4f200efcb14ab381b0d83d71e972753c1d178c1'],1,1,2,1060408,1,,,,2806
9827fadaa339e9b81a480934542f7db57f7bed7b,0,GitHub,2022-01-10 12:26:17+02:00,['4781d8fe91dc8cc873d6ed21dc65c0b168e6fef4'],10,10,20,1060428,1,,,,2806
180c041af1c4ddaaea88222dc0c1ba4b62ab026f,0,GitHub,2022-01-10 12:30:18+02:00,['9827fadaa339e9b81a480934542f7db57f7bed7b'],1,1,2,1060430,1,,,,2806
c54684853c518c004a9c72f347deb81a93f4c210,0,GitHub,2022-01-10 12:36:49+02:00,['180c041af1c4ddaaea88222dc0c1ba4b62ab026f'],3,3,6,1060436,1,,,,2806
7b8f20ce52b2a74c6cc168778b655177251a53f8,0,GitHub,2022-01-10 13:54:29+02:00,['c54684853c518c004a9c72f347deb81a93f4c210'],19,45,64,1060500,10,,,,2806
8e0c4afdadbe9f1651919ab5dd66cb5fc60af83f,0,GitHub,2022-01-10 13:57:58+02:00,['7b8f20ce52b2a74c6cc168778b655177251a53f8'],1,1,2,1060502,1,,,,2806
0811b827a233c415a5b48612817148b01db102ac,0,GitHub,2022-01-10 14:02:30+02:00,['8e0c4afdadbe9f1651919ab5dd66cb5fc60af83f'],4,53,57,1060559,6,0,0.8,0.8,2806
012197272fde9c6253a8c1672380d615c9e0d176,0,GitHub,2022-01-10 14:26:45+02:00,['0811b827a233c415a5b48612817148b01db102ac'],1,1,2,1060561,1,,,,2806
a741b2c6e368a5fd3eddf97af1b82c45c84a333d,0,GitHub,2022-01-10 15:49:03+02:00,['012197272fde9c6253a8c1672380d615c9e0d176'],1,1,2,1060563,1,,,,2806
1246cc1dd31040cb6f65c503d739d065efcfec65,0,GitHub,2022-01-10 15:50:33+02:00,['a741b2c6e368a5fd3eddf97af1b82c45c84a333d'],1,1,2,1060565,1,,,,2806
613dd99f3f096a482fbce9579572dac4634c0858,0,GitHub,2022-01-10 15:53:52+02:00,['1246cc1dd31040cb6f65c503d739d065efcfec65'],42,40,82,1060647,8,,,,2806
6958462df53d88e96084a1288858e07291802f6a,0,GitHub,2022-01-10 15:56:58+02:00,['613dd99f3f096a482fbce9579572dac4634c0858'],1,1,2,1060649,1,,,,2806
633ce2cf931d95e5febbbee4e2dd8b5851d699bc,0,GitHub,2022-01-10 15:58:39+02:00,['6958462df53d88e96084a1288858e07291802f6a'],1,1,2,1060651,1,,,,2806
ac1b159e482f021fcbe8b839e2943f119005eb2c,0,GitHub,2022-01-11 09:19:41+02:00,['633ce2cf931d95e5febbbee4e2dd8b5851d699bc'],1,1,2,1060653,1,,,,2806
aa890d29419511135aa13d1e95dcae2922b2912a,0,GitHub,2022-01-11 09:21:27+02:00,['ac1b159e482f021fcbe8b839e2943f119005eb2c'],1,1,2,1060655,1,,,,2806
2a0c2638d13154e839d5cb4c438ecf67afba88b4,0,GitHub,2022-01-11 09:23:27+02:00,['aa890d29419511135aa13d1e95dcae2922b2912a'],2,2,4,1060659,1,,,,2806
f4ad908608279c760b3a08390fe6f6c719a773e8,0,GitHub,2022-01-11 10:19:03+02:00,['2a0c2638d13154e839d5cb4c438ecf67afba88b4'],1,1,2,1060661,1,,,,2806
e3b11ad1aaedae21c66a7f42509b83302369fbc6,0,Martin Tzvetanov Grigorov,2022-01-11 11:03:45+02:00,['f4ad908608279c760b3a08390fe6f6c719a773e8'],4,4,8,1060669,4,,,,2806
9b4c7fcb6c31d8bfcc0ad76484b0c374c521b525,1,Martin Tzvetanov Grigorov,2022-01-12 08:40:55+02:00,['e3b11ad1aaedae21c66a7f42509b83302369fbc6'],2,2,4,1060673,1,,,,2806
ee47d4cd64eddcbced7b7c77102480e767b210a6,0,GitHub,2022-01-13 10:22:15+02:00,['9b4c7fcb6c31d8bfcc0ad76484b0c374c521b525'],22,54,76,1060749,3,0,0,1,2806
3a8423fc48417e581d4423d2121cf16154e2dfaf,0,GitHub,2022-01-13 13:32:29+02:00,['ee47d4cd64eddcbced7b7c77102480e767b210a6'],95,75,170,1060919,10,1,0,0.384615385,2806
6603e7777eda6f81ba7ed49c4672951b824bd6df,0,GitHub,2022-01-13 15:39:43+02:00,['3a8423fc48417e581d4423d2121cf16154e2dfaf'],73,56,129,1061048,3,,,,2806
006f7c5ac462ab300747e367983a7223c4aa1365,0,GitHub,2022-01-14 23:12:52+02:00,['6603e7777eda6f81ba7ed49c4672951b824bd6df'],6,18,24,1061072,3,0,0,0,2806
dcf925ec6c3f26ff7e5dfd7d48503b70259a2093,0,Martin Tzvetanov Grigorov,2022-01-15 22:07:22+02:00,['006f7c5ac462ab300747e367983a7223c4aa1365'],12,16,28,1061100,1,0,0,1,2806
9ea105c793af3459c6aa492ff9898f37defd70e1,0,Martin Tzvetanov Grigorov,2022-01-17 09:11:41+02:00,['dcf925ec6c3f26ff7e5dfd7d48503b70259a2093'],7,6,13,1061113,1,1,0,0,2806
98f4f4a87bb61cacf91f50253f8154c8b36de690,1,GitHub,2022-01-19 09:44:47+02:00,['9ea105c793af3459c6aa492ff9898f37defd70e1'],315,916,1231,1062344,13,0.049822064,0.366548043,0,2808
bd4e91ac09d2dc6cc25e2369697dde57fb3ad2a8,0,GitHub,2022-01-19 13:36:02+02:00,['98f4f4a87bb61cacf91f50253f8154c8b36de690'],0,18,18,1062362,2,,,,2808
daba28643dd1b267949a659e91c6849a4cf6488d,0,GitHub,2022-01-19 13:40:34+02:00,['bd4e91ac09d2dc6cc25e2369697dde57fb3ad2a8'],1,1,2,1062364,1,,,,2808
dc4b19af1ba7d93bb36aec1b5432ef5ff3af44d4,0,GitHub,2022-01-19 13:42:01+02:00,['daba28643dd1b267949a659e91c6849a4cf6488d'],1,1,2,1062366,1,,,,2808
de6bfda7722d7df0bc9b14ee504af291fc9639c6,0,GitHub,2022-01-19 13:43:33+02:00,['dc4b19af1ba7d93bb36aec1b5432ef5ff3af44d4'],1,1,2,1062368,1,,,,2808
49c6e1067c937d066503be9c7f4032fb03f67474,1,GitHub,2022-01-19 13:47:08+02:00,['de6bfda7722d7df0bc9b14ee504af291fc9639c6'],111,257,368,1062736,10,0.416666667,0.916666667,0.958333333,2808
e2eb392b5f080b7703d8bac35f6a478403d6f9af,0,GitHub,2022-01-19 21:20:52+02:00,['49c6e1067c937d066503be9c7f4032fb03f67474'],21,21,42,1062778,5,1,0,1,2808
bb6b6dae7692f7ce6f0fbe9561c7408e8f295bec,1,Martin Tzvetanov Grigorov,2022-01-20 08:51:27+02:00,['e2eb392b5f080b7703d8bac35f6a478403d6f9af'],35,5,40,1062818,1,,,,2808
064cc6b4bd1c6dcf59da989e712a27f0a955f70d,1,Martin Tzvetanov Grigorov,2022-01-20 09:22:57+02:00,['bb6b6dae7692f7ce6f0fbe9561c7408e8f295bec'],5,60,65,1062883,1,,,,2808
29197da2a94c889faa9101c92b7c60fed6a6db0b,1,Martin Tzvetanov Grigorov,2022-01-20 09:46:03+02:00,['064cc6b4bd1c6dcf59da989e712a27f0a955f70d'],7,58,65,1062948,1,,,,2808
68484243164666833c03336b953c63c70a247b1a,0,GitHub,2022-01-20 11:22:08+02:00,['29197da2a94c889faa9101c92b7c60fed6a6db0b'],3,3,6,1062954,2,,,,2808
9917a55d858dcd74d53176fad5341eb3f8846ae8,0,Martin Tzvetanov Grigorov,2022-01-20 20:50:55+02:00,['68484243164666833c03336b953c63c70a247b1a'],2,1,3,1062957,1,1,0,0,2808
a35a2a5305560da8ccb8eb299498e73c8bafa3bd,1,GitHub,2022-01-21 08:37:30+02:00,['9917a55d858dcd74d53176fad5341eb3f8846ae8'],10,115,125,1063082,1,,,,2808
0cbcda5ab0b51fd1c9c47d9adf23388e865dbd44,0,GitHub,2022-01-24 10:40:00+02:00,['a35a2a5305560da8ccb8eb299498e73c8bafa3bd'],1,1,2,1063084,1,,,,2808
a5878d0aa4a64259885762e38485dc3e7dd54f98,0,GitHub,2022-01-24 10:42:23+02:00,['0cbcda5ab0b51fd1c9c47d9adf23388e865dbd44'],1,1,2,1063086,1,,,,2808
bdb7fadefe7c49488bfd38765c8eafc8b2d9b008,0,GitHub,2022-01-24 10:44:59+02:00,['a5878d0aa4a64259885762e38485dc3e7dd54f98'],1,1,2,1063088,1,,,,2808
8a06ea3107664bc0083883459e4d4839ab7dd6b4,0,GitHub,2022-01-24 10:51:07+02:00,['bdb7fadefe7c49488bfd38765c8eafc8b2d9b008'],10,15,25,1063113,1,1,1,1,2808
d369f4013d36492236d64670c533b8e28c8b186e,0,GitHub,2022-01-24 10:54:24+02:00,['8a06ea3107664bc0083883459e4d4839ab7dd6b4'],953,769,1722,1064835,7,,,,2808
df4638e20e94904b9ea8225061df6b04dab9198c,0,GitHub,2022-01-24 15:41:02+02:00,['d369f4013d36492236d64670c533b8e28c8b186e'],1,1,2,1064837,1,,,,2808
415f6ab02eb83becea308dfc0e16f09309a58939,0,GitHub,2022-01-24 16:08:17+02:00,['df4638e20e94904b9ea8225061df6b04dab9198c'],13,15,28,1064865,1,,,,2808
44aee9e09571ab3d92a9db7f103e473ae1644dce,0,Martin Tzvetanov Grigorov,2022-01-25 09:17:45+02:00,['415f6ab02eb83becea308dfc0e16f09309a58939'],11,4,15,1064880,2,,,,2808
2e53b45fb3cafee63c1b2f9d3ce31746f0763ef7,0,Martin Tzvetanov Grigorov,2022-01-25 09:20:51+02:00,['44aee9e09571ab3d92a9db7f103e473ae1644dce'],24,24,48,1064928,2,,,,2808
888ab68cb5b15098972ef99558dee903fe7b1e7b,0,GitHub,2022-01-30 22:08:21+02:00,['2e53b45fb3cafee63c1b2f9d3ce31746f0763ef7'],3,15,18,1064946,2,0,0,1,2808
df45003d21febb2098a0cfc752a25613f0b76f4c,0,GitHub,2022-01-30 22:20:23+02:00,['888ab68cb5b15098972ef99558dee903fe7b1e7b'],69,147,216,1065162,1,,,,2808
2af5d7e0116d53ca706b6e5a5f3b45e7d317ef7d,0,GitHub,2022-01-30 22:22:21+02:00,['df45003d21febb2098a0cfc752a25613f0b76f4c'],1,1,2,1065164,1,,,,2808
fadf29e734bbe2774b21cbabd711dc71bccc1008,0,GitHub,2022-01-30 22:23:35+02:00,['2af5d7e0116d53ca706b6e5a5f3b45e7d317ef7d'],4,12,16,1065180,1,1,1,1,2808
7ee056890cc44f956ee3a46a3663132a3b688655,0,GitHub,2022-01-30 22:25:27+02:00,['fadf29e734bbe2774b21cbabd711dc71bccc1008'],2,0,2,1065182,1,,,,2808
f7188bed2888d72a91c27e3ff0e7da63fe4ecc35,0,GitHub,2022-01-30 22:26:48+02:00,['7ee056890cc44f956ee3a46a3663132a3b688655'],0,12,12,1065194,1,0,1,1,2808
4c5379e4c15a0df2e3036094f6c90f142ee7a9fb,0,GitHub,2022-01-30 22:35:34+02:00,['f7188bed2888d72a91c27e3ff0e7da63fe4ecc35'],1,1,2,1065196,1,,,,2808
0766e423428b4caf36d5ef3ee1c10bcae21b6269,0,GitHub,2022-01-30 22:37:18+02:00,['4c5379e4c15a0df2e3036094f6c90f142ee7a9fb'],106,506,612,1065808,1,,,,2808
5eff9a7f503ab0de550c99b6b46ac628ca9d817d,0,GitHub,2022-01-30 23:02:58+02:00,['0766e423428b4caf36d5ef3ee1c10bcae21b6269'],25,145,170,1065978,1,0.039215686,0.323529412,0.450980392,2808
c88481400a70546e7c261ca939709a551c8b1d40,0,GitHub,2022-01-31 08:56:14+02:00,['5eff9a7f503ab0de550c99b6b46ac628ca9d817d'],7,9,16,1065994,1,,,,2808
b3c582237398aee44d55c831ac1ad45b107b450a,0,GitHub,2022-01-31 09:21:49+02:00,['c88481400a70546e7c261ca939709a551c8b1d40'],1,1,2,1065996,1,,,,2808
91f289e1a69ca0f337a582401381759b12d3dc22,0,GitHub,2022-01-31 09:23:45+02:00,['b3c582237398aee44d55c831ac1ad45b107b450a'],1,3,4,1066000,2,,,,2808
7e5bdeec02d90ac63413fad09ce5e54adc087621,1,GitHub,2022-01-31 16:06:05+02:00,['91f289e1a69ca0f337a582401381759b12d3dc22'],91,91,182,1066182,15,,,,2808
c00aaa731b67c22281ea1f93b3bfe1788bf191ff,0,GitHub,2022-01-31 11:32:22-05:00,['7e5bdeec02d90ac63413fad09ce5e54adc087621'],14,11,25,1066207,2,0,0,0,2808
ae3b007de6b1fab3eedca801adea8f425544baac,0,GitHub,2022-02-01 12:09:09+02:00,['c00aaa731b67c22281ea1f93b3bfe1788bf191ff'],14,13,27,1066234,1,1,1,1,2808
c304f08adaea2778a54349a95826d1cde1db8328,0,GitHub,2022-02-01 12:12:36+02:00,['ae3b007de6b1fab3eedca801adea8f425544baac'],46,147,193,1066427,1,,,,2808
100574019b35465831d1b2fb0bff4fe2f512c89a,0,GitHub,2022-02-01 12:27:03+02:00,['c304f08adaea2778a54349a95826d1cde1db8328'],63,0,63,1066490,1,0,0,0,2808
8bae4d83674dfd7b214c75bb920ecf1698f0919e,0,GitHub,2022-02-01 13:13:48+02:00,['100574019b35465831d1b2fb0bff4fe2f512c89a'],12,27,39,1066529,1,,,,2808
c7827d220c018ed777b26fe16bc561fe7ea5411a,0,GitHub,2022-02-01 13:14:48+02:00,['8bae4d83674dfd7b214c75bb920ecf1698f0919e'],1,18,19,1066548,1,,,,2808
9c2464ca2b76b914e3563e2b101752b59ebaf6ed,0,GitHub,2022-02-01 13:17:21+02:00,['c7827d220c018ed777b26fe16bc561fe7ea5411a'],2,45,47,1066595,2,1,1,1,2808
93db8e005eaaa07b5003dcbd03bee49dea3975b3,0,GitHub,2022-02-01 13:31:02+02:00,['9c2464ca2b76b914e3563e2b101752b59ebaf6ed'],21,32,53,1066648,3,1,0,0,2808
a95f0e677693ab8af75015f6bb333e55c7437f03,0,GitHub,2022-02-01 13:37:12+02:00,['93db8e005eaaa07b5003dcbd03bee49dea3975b3'],53,3483,3536,1070184,12,,,,2810
a80c58296037371912e9a9703bf2f7d17771b5fa,0,GitHub,2022-02-01 13:39:06+02:00,['a95f0e677693ab8af75015f6bb333e55c7437f03'],37,43,80,1070264,1,,,,2810
9a378ffab2b49d95edcd2dba36691096301b64ee,0,GitHub,2022-02-01 19:32:12+01:00,['a80c58296037371912e9a9703bf2f7d17771b5fa'],68,111,179,1070443,7,0.142857143,1,0.761904762,2810
e8cd44067de5090ec6371e97b4b7dba4ba230769,0,GitHub,2022-02-01 21:55:09+02:00,['9a378ffab2b49d95edcd2dba36691096301b64ee'],6,136,142,1070585,5,0.302631579,1,1,2810
18d74959d73346f9d1e1fa9dd8881177a1f49233,0,GitHub,2022-02-01 22:21:47+02:00,['e8cd44067de5090ec6371e97b4b7dba4ba230769'],7,7,14,1070599,1,,,,2810
b29ff557ffca53121dbc378d5c0873a06171dc60,1,GitHub,2022-02-02 09:24:47+02:00,['18d74959d73346f9d1e1fa9dd8881177a1f49233'],10,21,31,1070630,1,1,1,1,2810
bfe65c688c9f67c7491e394439ce4deb24b14db2,1,GitHub,2022-02-02 09:26:33+02:00,['b29ff557ffca53121dbc378d5c0873a06171dc60'],7,17,24,1070654,1,1,1,1,2810
df720718aee6832b056c4c26f6f470f8ed4107e0,0,GitHub,2022-02-02 09:32:55+02:00,['bfe65c688c9f67c7491e394439ce4deb24b14db2'],3,14,17,1070671,1,1,1,1,2810
8cbbe84bbf5e6fc97eee99131cee2b4df8d705b5,0,GitHub,2022-02-02 09:36:33+02:00,['df720718aee6832b056c4c26f6f470f8ed4107e0'],6,34,40,1070711,2,0.2,1,1,2810
41793f347d78127cd49d702df4d6c36abf4433fd,0,Martin Tzvetanov Grigorov,2022-02-02 09:53:39+02:00,['8cbbe84bbf5e6fc97eee99131cee2b4df8d705b5'],6,6,12,1070723,1,,,,2810
a5436c589d017a6670d6e65189f381f8d8c594c0,0,GitHub,2022-02-02 09:57:48+02:00,['41793f347d78127cd49d702df4d6c36abf4433fd'],1,1,2,1070725,1,,,,2810
4138f45fe19987fe4026eea2cbd8e0e7857e9bbd,0,Martin Tzvetanov Grigorov,2022-02-02 10:00:17+02:00,['a5436c589d017a6670d6e65189f381f8d8c594c0'],6,5,11,1070736,1,,,,2810
0cd0aa1f198e16c94cce03f7742f235d2d5bb4bd,0,GitHub,2022-02-02 21:06:02+02:00,['4138f45fe19987fe4026eea2cbd8e0e7857e9bbd'],18,10,28,1070764,4,1,0,0,2810
8ce603b6317638847fa547f0d2c587cd019903db,0,GitHub,2022-02-02 21:35:53+02:00,['0cd0aa1f198e16c94cce03f7742f235d2d5bb4bd'],0,50,50,1070814,1,1,1,1,2810
ac85ba202a476fdd42acf4f074dfbffedd680f2b,0,GitHub,2022-02-02 21:47:44+02:00,['8ce603b6317638847fa547f0d2c587cd019903db'],5,73,78,1070892,3,0,0.807692308,0.519230769,2810
69fda12c5f3695504e15851b9028cc57efa4c90e,0,Martin Tzvetanov Grigorov,2022-02-03 11:42:44+02:00,['ac85ba202a476fdd42acf4f074dfbffedd680f2b'],109,97,206,1071098,3,1,1,1,2810
fa443cf8c12b3f4cddf85c4a28f6b6aab68a148f,0,Martin Tzvetanov Grigorov,2022-02-03 12:18:27+02:00,['69fda12c5f3695504e15851b9028cc57efa4c90e'],1,1,2,1071100,1,,,,2810
60cdcd0e4dcc87a702a37272767e6e5e5c961aaf,0,GitHub,2022-02-04 11:06:27+02:00,['fa443cf8c12b3f4cddf85c4a28f6b6aab68a148f'],14,14,28,1071128,1,,,,2810
9ca68cb782a98badcbd24d0503777d6e45b0ab2f,0,GitHub,2022-02-04 11:08:37+02:00,['60cdcd0e4dcc87a702a37272767e6e5e5c961aaf'],59,12,71,1071199,1,1,1,1,2810
bddc96095089b95d3e527a8e7f03550a28acc236,0,GitHub,2022-02-04 11:10:34+02:00,['9ca68cb782a98badcbd24d0503777d6e45b0ab2f'],3,6,9,1071208,1,,,,2810
3c55d2610169f299b73bd453c293a4c91d193c2c,0,GitHub,2022-02-04 11:12:56+02:00,['bddc96095089b95d3e527a8e7f03550a28acc236'],8,8,16,1071224,1,,,,2810
ef1efc25c47e2a437c4f2d4475da9d2551d56d8d,0,GitHub,2022-02-04 11:16:18+02:00,['3c55d2610169f299b73bd453c293a4c91d193c2c'],2,2,4,1071228,1,,,,2810
42edbd721fedc0ed6cde89ab3b64a9ac606aa74f,0,GitHub,2022-02-04 11:17:31+02:00,['ef1efc25c47e2a437c4f2d4475da9d2551d56d8d'],9,93,102,1071330,1,,,,2810
f9cceedeb46bf3c0b48ad21acb2c5f8778bfc9d8,0,GitHub,2022-02-04 11:20:58+02:00,['42edbd721fedc0ed6cde89ab3b64a9ac606aa74f'],4,15,19,1071349,1,,,,2810
6f704b13e4a393bb035cede13e5a2200eb3a1092,0,GitHub,2022-02-04 11:30:40+02:00,['f9cceedeb46bf3c0b48ad21acb2c5f8778bfc9d8'],9,10,19,1071368,1,,,,2810
6eebdf9777117e0301603d227b6b275616624255,0,GitHub,2022-02-04 11:31:17+02:00,['6f704b13e4a393bb035cede13e5a2200eb3a1092'],6,12,18,1071386,1,0,0,0,2810
e57df5ea723fe403ab17d012180564ffbce1f993,0,GitHub,2022-02-04 11:31:51+02:00,['6eebdf9777117e0301603d227b6b275616624255'],4,2,6,1071392,1,0,0,0,2810
0cbfb17d49186348a85cc2afc19c6b940da4aad1,0,GitHub,2022-02-04 11:33:56+02:00,['e57df5ea723fe403ab17d012180564ffbce1f993'],2,0,2,1071394,1,,,,2810
c35add7b29b5fab9229d79927a74f327bd56fa70,0,GitHub,2022-02-05 11:55:25+01:00,['0cbfb17d49186348a85cc2afc19c6b940da4aad1'],3,34,37,1071431,4,1,1,1,2810
20cb8126867c2ab6a62d42f241e696fd91b7879d,0,GitHub,2022-02-07 12:39:59+02:00,['c35add7b29b5fab9229d79927a74f327bd56fa70'],1,1,2,1071433,1,,,,2810
62e337e8e04a653730c6630f27d9f24181922ff6,0,GitHub,2022-02-07 12:42:07+02:00,['20cb8126867c2ab6a62d42f241e696fd91b7879d'],1,1,2,1071435,1,,,,2810
8fbd830765adfd308984fe4a8595ecb3ae11388e,0,GitHub,2022-02-07 12:43:50+02:00,['62e337e8e04a653730c6630f27d9f24181922ff6'],1,1,2,1071437,1,,,,2810
2681c1b0979fc37685d019c0db956593aa2ea5a2,0,GitHub,2022-02-07 19:37:55+01:00,['8fbd830765adfd308984fe4a8595ecb3ae11388e'],112,140,252,1071689,5,1,0,0,2810
840dec6d47b6a81e94a451c425669f025e1c88af,0,GitHub,2022-02-07 20:00:07+01:00,['2681c1b0979fc37685d019c0db956593aa2ea5a2'],57,121,178,1071867,1,,,,2810
9ab5ae3cd60b8c38c330e9483140d1a6f8d254cc,0,GitHub,2022-02-07 20:05:43+01:00,['840dec6d47b6a81e94a451c425669f025e1c88af'],1,1,2,1071869,1,,,,2810
5d2f01a1ea73ba45391fcfaf0f349b81ec577f51,0,Daniel Kulp,2022-02-07 15:29:18-05:00,['9ab5ae3cd60b8c38c330e9483140d1a6f8d254cc'],9,25,34,1071903,2,,,,2810
443614c12a15bb58fcf2487eb67ca6f885a68f96,0,Daniel Kulp,2022-02-08 11:52:23-05:00,['5d2f01a1ea73ba45391fcfaf0f349b81ec577f51'],20,7,27,1071930,2,,,,2810
8988196545a17e76a984b07313dd4a86497c9e02,0,Martin Tzvetanov Grigorov,2022-02-09 23:04:06+02:00,['443614c12a15bb58fcf2487eb67ca6f885a68f96'],0,24,24,1071954,1,,,,2810
9f37f912e9bde481a14a27e5553fb61a4df1277b,0,GitHub,2022-02-10 16:36:52+02:00,['8988196545a17e76a984b07313dd4a86497c9e02'],5,50,55,1072009,3,0.8,1,1,2810
11595499d6d410bf8663c365ad161e0c5d1e1358,0,GitHub,2022-02-10 20:19:45+01:00,['9f37f912e9bde481a14a27e5553fb61a4df1277b'],2,4,6,1072015,3,,,,2810
a5f8def249e7ee510d37bcf97fc60b3b87ae8001,0,GitHub,2022-02-10 21:48:48+01:00,['11595499d6d410bf8663c365ad161e0c5d1e1358'],21,256,277,1072292,8,0.689393939,0.681818182,1,2811
5c645aefadaadacaa19c268db46df5c20e7908af,0,GitHub,2022-02-11 11:20:08+01:00,['a5f8def249e7ee510d37bcf97fc60b3b87ae8001'],1,63,64,1072356,3,0.115384615,0.980769231,0.980769231,2811
28cdc9fe57bc4d4abf8b28c9cb4b9859b4d34cdd,0,GitHub,2022-02-14 00:08:14+02:00,['5c645aefadaadacaa19c268db46df5c20e7908af'],1,1,2,1072358,1,,,,2811
d7f9b9072c82b960f9eba0615e1b9989b81273eb,0,Martin Tzvetanov Grigorov,2022-02-16 09:56:15+02:00,['28cdc9fe57bc4d4abf8b28c9cb4b9859b4d34cdd'],1,1,2,1072360,1,,,,2811
a87e3ad4360189991e28eca05f461b85b60d3cd9,0,Martin Tzvetanov Grigorov,2022-02-16 21:42:35+02:00,['d7f9b9072c82b960f9eba0615e1b9989b81273eb'],12,12,24,1072384,1,,,,2811
f888458721ce2573a6e04113a69a30ce785f8891,1,GitHub,2022-02-17 22:37:31+02:00,['a87e3ad4360189991e28eca05f461b85b60d3cd9'],50,306,356,1072740,9,0.207650273,1,0.918032787,2811
b8e7d7d4134318ddd7713d610a339b0cea9e12a3,0,GitHub,2022-02-18 08:06:45+01:00,['f888458721ce2573a6e04113a69a30ce785f8891'],1,6,7,1072747,2,1,1,1,2811
4c24d9ddddc8cc7d507caf495a4f93f3c7255654,0,GitHub,2022-02-18 08:09:57+01:00,['b8e7d7d4134318ddd7713d610a339b0cea9e12a3'],32,1035,1067,1073814,20,0.548076923,0.754807692,0.858173077,2826
7a8576475f776109d060ffdf22e876b754ac3ab4,0,GitHub,2022-02-19 09:40:22+02:00,['4c24d9ddddc8cc7d507caf495a4f93f3c7255654'],32,24,56,1073870,10,0,0,0,2826
96bc4983ddad9faa951035b3c94a5434c6a4940a,0,Martin Tzvetanov Grigorov,2022-02-21 08:22:31+02:00,['7a8576475f776109d060ffdf22e876b754ac3ab4'],4,4,8,1073878,2,,,,2826
9b83acd4c7fbf6beb5be2cf10f76230624c98637,0,GitHub,2022-02-21 08:24:50+02:00,['96bc4983ddad9faa951035b3c94a5434c6a4940a'],1,1,2,1073880,1,,,,2826
a5ba8b445252987dec2d5f31e34c573823a04f0b,0,Martin Tzvetanov Grigorov,2022-02-21 11:40:32+02:00,['9b83acd4c7fbf6beb5be2cf10f76230624c98637'],1,1,2,1073882,1,,,,2826
5d3f9a687484aac766783442f45fc66d02df530e,1,Martin Tzvetanov Grigorov,2022-02-21 15:20:46+02:00,['a5ba8b445252987dec2d5f31e34c573823a04f0b'],7,4,11,1073893,1,1,0,0.666666667,2826
52b6987b7281587bab6f7a307333b631ed9fd39c,0,Martin Tzvetanov Grigorov,2022-02-21 16:11:24+02:00,['5d3f9a687484aac766783442f45fc66d02df530e'],27,48,75,1073968,3,0.1875,0,0.3125,2826
70223760d8d29c1e21ca224df452f9f0cb801cbd,1,Martin Tzvetanov Grigorov,2022-02-21 22:51:04+02:00,['52b6987b7281587bab6f7a307333b631ed9fd39c'],14,16,30,1073998,2,1,1,0,2826
b91e4bcc8abb1b2ad54565514a00cec8c9b91a60,0,Martin Tzvetanov Grigorov,2022-02-21 22:54:02+02:00,['70223760d8d29c1e21ca224df452f9f0cb801cbd'],53,66,119,1074117,4,1,1,0.666666667,2826
5a8c87a96d9aeb63b68b1f93bcff99347913a81b,0,Martin Tzvetanov Grigorov,2022-02-21 22:59:13+02:00,['b91e4bcc8abb1b2ad54565514a00cec8c9b91a60'],1,1,2,1074119,1,,,,2826
57a8cafebabc10f22d8e2214fd7ac1eb9c5ccda5,0,GitHub,2022-02-24 18:16:12+01:00,['5a8c87a96d9aeb63b68b1f93bcff99347913a81b'],0,5,5,1074124,1,,,,2826
b6c6c98536e18abc244de515f440f7f0578b3c6f,0,Ryan Skraba,2022-02-24 18:33:25+01:00,['57a8cafebabc10f22d8e2214fd7ac1eb9c5ccda5'],0,0,0,1074124,22,,,,2826
ea2d633294384cecdd50e0dd6efeb08b938a8a30,0,Ryan Skraba,2022-02-24 18:33:25+01:00,['b6c6c98536e18abc244de515f440f7f0578b3c6f'],0,14694,14694,1088818,120,,,,2946
092d9a9267f2b4dd1464641739f68579145ecc0c,1,Ryan Skraba,2022-02-24 18:33:25+01:00,['ea2d633294384cecdd50e0dd6efeb08b938a8a30'],14117,3321,17438,1106256,188,,,,3019
d2ef493dc022e60268b25740fbffe9b51d6fc342,0,Ryan Skraba,2022-02-24 18:33:25+01:00,['092d9a9267f2b4dd1464641739f68579145ecc0c'],66,1751,1817,1108073,83,,,,3019
7d4e46bb848ea9f2d0c3642787fd265bef9d7bfa,0,Ryan Skraba,2022-02-24 18:33:25+01:00,['d2ef493dc022e60268b25740fbffe9b51d6fc342'],89,0,89,1108162,2,,,,3019
b184c357cb3e7c124a80ecd4698ba338df69d0c1,0,Ryan Skraba,2022-02-24 18:54:51+01:00,['7d4e46bb848ea9f2d0c3642787fd265bef9d7bfa'],0,89,89,1108251,2,,,,3020
b4ab253ade3b1e88a5125e1dd533caf010141803,0,GitHub,2022-02-25 08:16:00+01:00,['b184c357cb3e7c124a80ecd4698ba338df69d0c1'],2,2,4,1108255,1,,,,3020
a4a0993a3eeb2f6a185a4314c50511037dadbac2,0,Martin Tzvetanov Grigorov,2022-02-25 09:42:37+02:00,['b4ab253ade3b1e88a5125e1dd533caf010141803'],12,8,20,1108275,4,0,0,0,3020
f10fa6b9e30e38ec5cde6e00288f0b31b24bf1de,0,GitHub,2022-02-25 09:45:56+02:00,['a4a0993a3eeb2f6a185a4314c50511037dadbac2'],1,1,2,1108277,1,,,,3020
a183a205add80fa70348d5148f79e3d12f9ef144,0,GitHub,2022-02-25 11:02:24+02:00,['f10fa6b9e30e38ec5cde6e00288f0b31b24bf1de'],1,1,2,1108279,1,,,,3020
72e1135f7c1171b7f028f7f4f5fa0a652eb4edc2,0,GitHub,2022-02-25 11:12:35+01:00,['a183a205add80fa70348d5148f79e3d12f9ef144'],0,67,67,1108346,3,,,,3022
e4f629c66f22d05c63c2ff6ed7f1956d0a7e2dbc,0,GitHub,2022-02-25 12:14:16+01:00,['72e1135f7c1171b7f028f7f4f5fa0a652eb4edc2'],138,38,176,1108522,3,,,,3022
3753a15606407c6358f76aa45a059ad3af6a3c37,0,GitHub,2022-02-25 23:15:02+02:00,['e4f629c66f22d05c63c2ff6ed7f1956d0a7e2dbc'],1,1,2,1108524,1,,,,3022
ad585c29efb46e3c056a11e4e10f9c2d408bb84b,0,GitHub,2022-02-25 23:34:15+02:00,['3753a15606407c6358f76aa45a059ad3af6a3c37'],222,1920,2142,1110666,29,0.589403974,0.829139073,0.977483444,3039
5d3931b9ed94a6a4558432f4993948329be35357,1,GitHub,2022-02-26 00:20:17+02:00,['ad585c29efb46e3c056a11e4e10f9c2d408bb84b'],6,248,254,1110920,1,,,,3039
137def8f3cf63cf9b53e5548aaba1fc6bf38a03a,0,GitHub,2022-02-28 12:12:31+01:00,['5d3931b9ed94a6a4558432f4993948329be35357'],30,80,110,1111030,1,,,,3039
81b1982da5ce28826edad26d052e6e4faad2bb9e,0,GitHub,2022-02-28 15:01:53+01:00,['137def8f3cf63cf9b53e5548aaba1fc6bf38a03a'],16,24,40,1111070,1,,,,3039
5194d60ce70b6b848830f1e8ebbec1f44df0fcf6,1,GitHub,2022-03-03 13:48:07+02:00,['81b1982da5ce28826edad26d052e6e4faad2bb9e'],66,87,153,1111223,28,,,,3040
bdbb2a0379104cba9cf73a6df682c66c9e8180a4,0,GitHub,2022-03-03 16:25:08+02:00,['5194d60ce70b6b848830f1e8ebbec1f44df0fcf6'],0,80,80,1111303,20,,,,3040
a0d5b943ddb9452ecc8b0d9d9e804f039ec9df1f,0,GitHub,2022-03-03 16:27:02+02:00,['bdbb2a0379104cba9cf73a6df682c66c9e8180a4'],0,15,15,1111318,1,1,1,1,3040
9cd3c0e6df02e9706dc075d7be6eccd18c18d79d,0,GitHub,2022-03-03 16:29:11+02:00,['a0d5b943ddb9452ecc8b0d9d9e804f039ec9df1f'],1,1,2,1111320,1,,,,3040
5c1f4405ab46c68413a63a2206b49585a1d14695,0,GitHub,2022-03-03 16:36:51+02:00,['9cd3c0e6df02e9706dc075d7be6eccd18c18d79d'],2,753,755,1112075,12,0.771300448,0.784753363,1,3049
e828cb0adc3c24e970f47c181d39ba21350d2ab5,0,GitHub,2022-03-03 16:39:17+02:00,['5c1f4405ab46c68413a63a2206b49585a1d14695'],0,56,56,1112131,2,1,1,1,3050
44b8cd23756b752bf9d0976574453c712dcd44d9,0,GitHub,2022-03-07 14:47:50+02:00,['e828cb0adc3c24e970f47c181d39ba21350d2ab5'],188,236,424,1112555,2,1,0,0,3050
aa22276152802a85cc628c418f304a164d82b3af,1,GitHub,2022-03-08 08:01:19+02:00,['44b8cd23756b752bf9d0976574453c712dcd44d9'],72,695,767,1113322,7,0,0.972677596,0.856102004,3050
531ccde8a0fb2d782a4350cd8056de3ce08c427e,0,GitHub,2022-03-08 16:37:59+02:00,['aa22276152802a85cc628c418f304a164d82b3af'],5,5,10,1113332,1,,,,3050
4b8dac4d0f210dce0b37d9f5c990d265f4ffc20b,0,GitHub,2022-03-08 19:33:07+01:00,['531ccde8a0fb2d782a4350cd8056de3ce08c427e'],2,3,5,1113337,1,,,,3050
f4725ca1cdac1e7b9ef9c329caf5e4bfdc5b19c2,0,GitHub,2022-03-08 19:34:55+01:00,['4b8dac4d0f210dce0b37d9f5c990d265f4ffc20b'],2,24,26,1113363,3,,,,3050
7ec12f99c3995f50c392a5a5336cd1a5c04ae1b4,0,GitHub,2022-03-08 21:58:26+02:00,['f4725ca1cdac1e7b9ef9c329caf5e4bfdc5b19c2'],1,1,2,1113365,1,,,,3050
80a9bf87b12c78c3db14b8d1419e7f77eb16f0d5,0,GitHub,2022-03-10 18:17:14+01:00,['7ec12f99c3995f50c392a5a5336cd1a5c04ae1b4'],0,1,1,1113366,1,,,,3050
8e11c613e0b0b57cf06cae3d37cb86536375770b,0,GitHub,2022-03-10 19:27:46+01:00,['80a9bf87b12c78c3db14b8d1419e7f77eb16f0d5'],1,18,19,1113385,2,1,1,1,3050
4bc3ba0ff57bbfa4b67c6900e54181f8ed820787,0,GitHub,2022-03-17 15:39:31+02:00,['8e11c613e0b0b57cf06cae3d37cb86536375770b'],1,1,2,1113387,1,,,,3050
ce9ef8e0e9a6ee36121a98512b1d7f510e84deed,0,GitHub,2022-03-17 16:17:24+02:00,['4bc3ba0ff57bbfa4b67c6900e54181f8ed820787'],1,1,2,1113389,1,,,,3050
9d5c517caa2e2aaa8ae9cb5e4f7e3ef92e2801c6,0,GitHub,2022-03-17 16:21:05+02:00,['ce9ef8e0e9a6ee36121a98512b1d7f510e84deed'],9,29,38,1113427,2,,,,3050
128510c4e9c3a714279aa7cea22eda19080521f7,1,GitHub,2022-03-18 08:21:43+02:00,['9d5c517caa2e2aaa8ae9cb5e4f7e3ef92e2801c6'],510,1996,2506,1115933,9,0.038461538,0.95014245,0.95014245,3050
00be26acd539f9aecc809f802dc61c861f04ee2c,1,GitHub,2022-03-18 19:58:51+01:00,['128510c4e9c3a714279aa7cea22eda19080521f7'],181,951,1132,1117065,8,0.46835443,0.924050633,0.487341772,3053
269a6ae52892b8d54c494a208cd576aa30d72c1d,0,GitHub,2022-03-18 20:00:47+01:00,['00be26acd539f9aecc809f802dc61c861f04ee2c'],13,16,29,1117094,9,,,,3053
8d6f71209f81e27efd4644fc3c8c65121a583334,0,GitHub,2022-03-18 20:00:56+01:00,['269a6ae52892b8d54c494a208cd576aa30d72c1d'],4,16,20,1117114,6,,,,3053
ee4725c64807549ec74e20e83d35cfc1fe8e90a8,0,GitHub,2022-03-18 20:18:52+01:00,['8d6f71209f81e27efd4644fc3c8c65121a583334'],5,84,89,1117203,4,1,1,1,3055
c7fdf69d811b57e888f31ffa520ebeb2f055f55b,0,GitHub,2022-03-20 21:40:26+02:00,['ee4725c64807549ec74e20e83d35cfc1fe8e90a8'],114,324,438,1117641,2,0.770408163,0.149234694,0.144132653,3055
66827318f0a134e8f6d4638a0787cb1b36821d1c,0,GitHub,2022-03-20 22:07:59+02:00,['c7fdf69d811b57e888f31ffa520ebeb2f055f55b'],26,46,72,1117713,3,0.969872538,0,0.347624565,3055
842c9d26695c92a7f52d0850a09ec0f3d9f84513,0,GitHub,2022-03-20 22:10:55+02:00,['66827318f0a134e8f6d4638a0787cb1b36821d1c'],1,1,2,1117715,1,,,,3055
a4e42112cea950e76dd4fc914765205c7b305ae7,0,GitHub,2022-03-20 22:12:29+02:00,['842c9d26695c92a7f52d0850a09ec0f3d9f84513'],1,1,2,1117717,1,,,,3055
8d0e53c3781e4fcfaac61e0bfd9c04b00115ad79,0,GitHub,2022-03-22 10:04:07+02:00,['a4e42112cea950e76dd4fc914765205c7b305ae7'],9,61,70,1117787,2,0.848249027,0.447470817,0.357976654,3055
3797bbb6f844d40c58324474e9d7d8e1ea99e62b,0,GitHub,2022-03-22 10:05:28+02:00,['8d0e53c3781e4fcfaac61e0bfd9c04b00115ad79'],1,2,3,1117790,1,0,0,1,3055
17e5a4554f65f5c3cd3300d3f87344c3474f6f2b,0,GitHub,2022-03-22 10:46:50+02:00,['3797bbb6f844d40c58324474e9d7d8e1ea99e62b'],0,90,90,1117880,1,,,,3055
fcc4e2dec64e8cbb011a388f5e612c2b09e4d3ef,0,GitHub,2022-03-24 09:00:40+02:00,['17e5a4554f65f5c3cd3300d3f87344c3474f6f2b'],11,160,171,1118051,2,0,0,1,3055
c2acf468f206cba00a77dc2da462ac3029640cba,0,GitHub,2022-03-24 21:50:12+02:00,['fcc4e2dec64e8cbb011a388f5e612c2b09e4d3ef'],2,12,14,1118065,1,,,,3055
04bac0f9b63353b9e2b3eb88185ab7c7f8b84a13,0,GitHub,2022-03-24 21:54:12+02:00,['c2acf468f206cba00a77dc2da462ac3029640cba'],0,57,57,1118122,1,,,,3055
7bbba423aeb25b4ffe9dde90be090a4311c32f92,0,GitHub,2022-03-29 10:52:51+03:00,['04bac0f9b63353b9e2b3eb88185ab7c7f8b84a13'],18,80,98,1118220,4,0,1,0,3055
565849d05f768f5fc249711dc26bde0c9f68699b,0,GitHub,2022-03-29 10:55:12+03:00,['7bbba423aeb25b4ffe9dde90be090a4311c32f92'],3,2,5,1118225,1,,,,3055
47ed66f609f079d5ffa13405d1132ce1194e9fbc,0,GitHub,2022-03-29 11:10:06+03:00,['565849d05f768f5fc249711dc26bde0c9f68699b'],2,19,21,1118246,3,,,,3055
65eb24a6275632d02eed8bca54c71314bfdb42e2,0,GitHub,2022-03-29 11:31:52+03:00,['47ed66f609f079d5ffa13405d1132ce1194e9fbc'],13,245,258,1118504,6,0.398148148,0.972222222,0.537037037,3056
4fc9e2369d620f36eabdd5d6e1f36dd45e37c458,0,GitHub,2022-03-30 09:16:46+03:00,['65eb24a6275632d02eed8bca54c71314bfdb42e2'],47,104,151,1118655,7,0.742857143,0.742857143,1,3057
52abb50949e8d1933c7209f97d7bff5d8a20075d,0,GitHub,2022-03-30 09:25:04+03:00,['4fc9e2369d620f36eabdd5d6e1f36dd45e37c458'],2,5,7,1118662,2,,,,3057
d44ed5ae2fbb6b2b8d21d4a2ada218f35d59a38a,0,GitHub,2022-04-04 09:56:08+02:00,['52abb50949e8d1933c7209f97d7bff5d8a20075d'],1,1,2,1118664,1,,,,3057
c9a346e8eb6012fdc8594877f02ea21be98c8b26,1,GitHub,2022-04-13 12:17:25+03:00,['d44ed5ae2fbb6b2b8d21d4a2ada218f35d59a38a'],90,381,471,1119135,5,,,,3057
8c778c307ca34dce2190c2a4250ff607d5c9ab41,0,GitHub,2022-04-13 21:34:03+03:00,['c9a346e8eb6012fdc8594877f02ea21be98c8b26'],4,56,60,1119195,4,0.636363636,0.96969697,0.818181818,3057
fee1a73979b1f9e2b98e0797812f405c1ccb6615,0,Martin Tzvetanov Grigorov,2022-04-13 21:59:20+03:00,['8c778c307ca34dce2190c2a4250ff607d5c9ab41'],0,1,1,1119196,1,,,,3057
7673e8da822a9e27d7ff3e6258f91e2369b9f620,0,GitHub,2022-04-13 22:07:44+03:00,['fee1a73979b1f9e2b98e0797812f405c1ccb6615'],14,13,27,1119223,3,0,0,1,3057
387f497285d49ffc577263d154bca968e2b5ea65,0,GitHub,2022-04-13 23:21:21+03:00,['7673e8da822a9e27d7ff3e6258f91e2369b9f620'],20,19,39,1119262,2,,,,3057
dd625f4f3aec105fef49d4e88424b892d82de0cc,0,GitHub,2022-04-13 23:54:18+03:00,['387f497285d49ffc577263d154bca968e2b5ea65'],3,3,6,1119268,1,,,,3057
6077d63143dbef1c6d762c344f43384a2e0fc76b,0,GitHub,2022-04-14 00:13:46+03:00,['dd625f4f3aec105fef49d4e88424b892d82de0cc'],55,1038,1093,1120361,2,,,,3057
514e1c24f5a83901c4461efe3058dd0383b96a3f,0,GitHub,2022-04-14 09:52:41+03:00,['6077d63143dbef1c6d762c344f43384a2e0fc76b'],89,89,178,1120539,34,,,,3057
cbc4372029e7149c73db5a5aef491abdc5500b10,1,GitHub,2022-04-16 23:52:15+03:00,['514e1c24f5a83901c4461efe3058dd0383b96a3f'],18,1852,1870,1122409,8,0.084327087,0.966780239,0.926746167,3061
fbe7901093c5af959c9f0ddb3c8e447f62f86181,0,GitHub,2022-04-18 08:37:16+03:00,['cbc4372029e7149c73db5a5aef491abdc5500b10'],1,89,90,1122499,2,0,0.944444444,0.888888889,3061
fc6cf1ede40735f55a8c0d95e5699524676143ae,0,Martin Tzvetanov Grigorov,2022-04-18 21:59:21+03:00,['fbe7901093c5af959c9f0ddb3c8e447f62f86181'],25,16,41,1122540,1,,,,3061
5bdebfdc53f1c0ff62af9f84942f2519946fa3fb,0,GitHub,2022-04-18 22:43:57+03:00,['fc6cf1ede40735f55a8c0d95e5699524676143ae'],14,18,32,1122572,1,0,1,1,3061
e4521514c76a3b501612f376c9e6db356e28836d,0,GitHub,2022-04-19 00:06:13+03:00,['5bdebfdc53f1c0ff62af9f84942f2519946fa3fb'],17,92,109,1122681,2,0,0.981132075,0.962264151,3061
c5d7cff2643792ab4b8da3cba78df5fe7778c91f,0,GitHub,2022-04-19 10:30:09+03:00,['e4521514c76a3b501612f376c9e6db356e28836d'],0,44,44,1122725,4,,,,3062
c908995f5b8ff2c37b4180a5f2d50c671b426d0b,0,GitHub,2022-04-19 21:17:46+03:00,['c5d7cff2643792ab4b8da3cba78df5fe7778c91f'],28,1655,1683,1124408,3,,,,3063
3079cb8e88d185a3d3713163bed59d6b1c56ba5d,0,GitHub,2022-04-19 21:19:01+03:00,['c908995f5b8ff2c37b4180a5f2d50c671b426d0b'],5,127,132,1124540,2,0.275862069,0.275862069,0.982758621,3063
3c3c05edf519ce41060c0534f0099c32f5bd8989,0,GitHub,2022-04-19 21:20:03+03:00,['3079cb8e88d185a3d3713163bed59d6b1c56ba5d'],5,28,33,1124573,2,,,,3063
7c6fd1aad053b2cd33d79b6a383749e9ac50d7c6,0,GitHub,2022-04-19 21:23:05+03:00,['3c3c05edf519ce41060c0534f0099c32f5bd8989'],0,220,220,1124793,1,1,1,1,3064
cf0cb14de5498cf420265217e8f4d3a84dd2f4a4,0,GitHub,2022-04-19 21:24:05+03:00,['7c6fd1aad053b2cd33d79b6a383749e9ac50d7c6'],51,170,221,1125014,4,0.111111111,1,1,3064
1c84472681c888a77fa7295b43d84e06a4294641,0,GitHub,2022-04-19 21:27:30+03:00,['cf0cb14de5498cf420265217e8f4d3a84dd2f4a4'],45,675,720,1125734,13,0.434285714,0.771428571,0.645714286,3067
a852aa433111499f0479a8efd8149e7dcfb1b77a,0,GitHub,2022-04-19 21:28:33+03:00,['1c84472681c888a77fa7295b43d84e06a4294641'],2,132,134,1125868,4,0.547619048,0.547619048,1,3068
3312b986e43252963d567e3b1137b8de33220696,0,GitHub,2022-04-19 21:37:45+03:00,['a852aa433111499f0479a8efd8149e7dcfb1b77a'],52,117,169,1126037,6,0,0.685714286,0.685714286,3068
a3ee2f193c199e4ff3832bdb34477e33aebd14b0,0,GitHub,2022-04-19 21:39:00+03:00,['3312b986e43252963d567e3b1137b8de33220696'],1,1,2,1126039,1,,,,3068
361dd8b6ffdcba93c34a1801445c15fa02447442,0,GitHub,2022-04-19 21:40:48+03:00,['a3ee2f193c199e4ff3832bdb34477e33aebd14b0'],13,12,25,1126064,2,0.333333333,0,0,3068
82b606e4289e0a3efa88d65a59e7ae3731fd4f44,0,GitHub,2022-04-19 22:20:05+03:00,['361dd8b6ffdcba93c34a1801445c15fa02447442'],6,6,12,1126076,1,,,,3068
ab31be4a0fdadb0d48dd149a8ce43fe1583afb95,0,GitHub,2022-04-19 23:32:18+03:00,['82b606e4289e0a3efa88d65a59e7ae3731fd4f44'],36,86,122,1126198,2,0,1,0.352941176,3068
f1f304644d3cd1ca8fa33d1fedb4aacc3aff47de,0,GitHub,2022-04-20 10:46:50+03:00,['ab31be4a0fdadb0d48dd149a8ce43fe1583afb95'],15,661,676,1126874,3,0.038834951,0.077669903,0,3069
ca71f9996f78517bbff24b4c8a03f1cf0505e605,0,GitHub,2022-04-20 21:07:35+03:00,['f1f304644d3cd1ca8fa33d1fedb4aacc3aff47de'],6,147,153,1127027,3,0,0.472868217,0.937984496,3069
9d87a206b52de7dc9402be711a51b72cb3c11160,0,GitHub,2022-04-20 22:57:04+03:00,['ca71f9996f78517bbff24b4c8a03f1cf0505e605'],4,80,84,1127111,2,1,1,1,3070
95b61b1983d8c3bccea000362dcfec64a42d76f6,0,GitHub,2022-04-20 22:58:41+03:00,['9d87a206b52de7dc9402be711a51b72cb3c11160'],79,87,166,1127277,3,1,0,0,3070
f0b183f2773165e616ec22ed6c32f60cc5b961fe,0,Martin Tzvetanov Grigorov,2022-04-21 14:42:13+03:00,['95b61b1983d8c3bccea000362dcfec64a42d76f6'],2,3,5,1127282,1,,,,3070
5cab566ce2685ec4ad933a2cdd9793d26e538e8d,0,GitHub,2022-04-21 16:10:14+03:00,['f0b183f2773165e616ec22ed6c32f60cc5b961fe'],0,30,30,1127312,1,,,,3070
9d025ca5fe413a50fb8ec039a0e614d836bb2a37,0,GitHub,2022-04-21 21:12:17+03:00,['5cab566ce2685ec4ad933a2cdd9793d26e538e8d'],1,1,2,1127314,1,,,,3070
d16410a651c7cf6dd7b991d6bf91709fe016f937,0,GitHub,2022-04-21 21:13:27+03:00,['9d025ca5fe413a50fb8ec039a0e614d836bb2a37'],4,10,14,1127328,4,0,0,0,3070
91baad9c4a336bd149fd00e3d98fc774e88d5f0d,0,GitHub,2022-04-21 21:14:51+03:00,['d16410a651c7cf6dd7b991d6bf91709fe016f937'],1,1,2,1127330,1,,,,3070
8cc6650d6d52d8192b0da80cb4b1f71e33dff822,0,GitHub,2022-04-21 21:15:22+03:00,['91baad9c4a336bd149fd00e3d98fc774e88d5f0d'],1,1,2,1127332,1,,,,3070
104308d6bc6302b0d462ffc68105ec3c5dea14ad,0,GitHub,2022-04-21 21:15:51+03:00,['8cc6650d6d52d8192b0da80cb4b1f71e33dff822'],1,1,2,1127334,1,,,,3070
c0463d0c376b260b4095106935855c938e80105b,0,GitHub,2022-04-21 21:17:27+03:00,['104308d6bc6302b0d462ffc68105ec3c5dea14ad'],58,0,58,1127392,1,0,0,0,3070
cf373f2926e3e8e87b6aefe731d991611e65c95c,0,GitHub,2022-04-21 21:19:00+03:00,['c0463d0c376b260b4095106935855c938e80105b'],21,21,42,1127434,4,0,0,0,3070
64c8da735db1a6e2f8492de820e80f3174be3cb1,0,GitHub,2022-04-25 20:59:59+03:00,['cf373f2926e3e8e87b6aefe731d991611e65c95c'],1,1,2,1127436,1,,,,3070
e921542dca3ab6ca8a4f513eec3976f54d8d2379,0,GitHub,2022-04-25 21:00:48+03:00,['64c8da735db1a6e2f8492de820e80f3174be3cb1'],314,233,547,1127983,1,,,,3070
1343c80eba2f6685266d3cae67ca6281c5f7f4cf,0,GitHub,2022-04-25 21:05:37+03:00,['e921542dca3ab6ca8a4f513eec3976f54d8d2379'],0,7,7,1127990,1,0,0,0,3070
5b055ac43085b11e467acd66c8630f424b1af50e,0,GitHub,2022-04-25 21:36:51+03:00,['1343c80eba2f6685266d3cae67ca6281c5f7f4cf'],17,75,92,1128082,5,0.55,0.75,0.75,3070
9dedb2b8f635a2545617a65b4fdf1f074c3fc1a0,0,GitHub,2022-04-27 07:32:19-07:00,['5b055ac43085b11e467acd66c8630f424b1af50e'],14,31,45,1128127,3,1,1,0.714285714,3070
76e55d8775efb02b5248aadf0bd512b137b58443,0,GitHub,2022-04-29 17:54:36-07:00,['9dedb2b8f635a2545617a65b4fdf1f074c3fc1a0'],2,5,7,1128134,1,1,1,1,3070
75e74ee45c6a6f250a8f1321537e0fbb6c97517d,0,GitHub,2022-05-01 21:33:54-07:00,['76e55d8775efb02b5248aadf0bd512b137b58443'],1,1,2,1128136,1,,,,3070
a21094ba79a4cad3523a47507637e2f175650380,0,Martin Tzvetanov Grigorov,2022-05-03 12:20:19+03:00,['75e74ee45c6a6f250a8f1321537e0fbb6c97517d'],48,48,96,1128232,1,,,,3070
ac71ffe2812751b8a7e64660139a79c068b7af3c,0,GitHub,2022-05-03 21:46:20+03:00,['a21094ba79a4cad3523a47507637e2f175650380'],74,66,140,1128372,2,,,,3070
284280984e8f6a446825d30ec8c8768a644500e3,0,GitHub,2022-05-03 21:52:22+03:00,['ac71ffe2812751b8a7e64660139a79c068b7af3c'],1,1,2,1128374,1,,,,3070
fda48f29bdebbe9b7e0af9ee8397c8729f74b569,0,GitHub,2022-05-03 21:53:12+03:00,['284280984e8f6a446825d30ec8c8768a644500e3'],1,1,2,1128376,1,,,,3070
923ea8e6042db6eddbd727ee303adc54ae58f4b9,0,GitHub,2022-05-03 21:54:08+03:00,['fda48f29bdebbe9b7e0af9ee8397c8729f74b569'],46,27,73,1128449,8,1,1,1,3070
193d528d391a27079ae5ea4b0a01f4819405f6ff,0,GitHub,2022-05-04 00:19:08+03:00,['923ea8e6042db6eddbd727ee303adc54ae58f4b9'],14,51,65,1128514,5,1,1,1,3070
c2bd724f8af1f67ef540f6b8f80fab88663a92bf,0,GitHub,2022-05-04 00:21:39+03:00,['193d528d391a27079ae5ea4b0a01f4819405f6ff'],1,218,219,1128733,5,0.536585366,1,1,3072
95440c4c5b904d93cfa878d3e13879a20ff499ff,0,GitHub,2022-05-03 17:11:18-07:00,['c2bd724f8af1f67ef540f6b8f80fab88663a92bf'],1,2,3,1128736,1,,,,3072
7ba9447adc1d55a990125e4203c539611d093d50,0,GitHub,2022-05-04 10:59:11+03:00,['95440c4c5b904d93cfa878d3e13879a20ff499ff'],23,620,643,1129379,16,1,1,1,3078
ce74e7726b33ac414299a924c63a7a7bc036f8bd,0,GitHub,2022-05-05 23:22:00+03:00,['7ba9447adc1d55a990125e4203c539611d093d50'],51,98,149,1129528,3,,,,3078
ae89799545df2ffdb7cc8b42ce7ed63c435ed340,0,GitHub,2022-05-08 22:33:12+03:00,['ce74e7726b33ac414299a924c63a7a7bc036f8bd'],10,11,21,1129549,3,,,,3078
41fbaa8e9443bebc276dc8f2d056a155f47bf0c8,0,GitHub,2022-05-09 14:51:40+03:00,['ae89799545df2ffdb7cc8b42ce7ed63c435ed340'],14,291,305,1129854,6,0.173267327,0.836633663,0.975247525,3078
3fafde2cf8dd4b3a34cf48347a346c436741ae91,1,GitHub,2022-05-11 22:33:24+03:00,['41fbaa8e9443bebc276dc8f2d056a155f47bf0c8'],7,10,17,1129871,4,,,,3078
f56051539d9330722c36888b730aee5b559e01ec,0,GitHub,2022-05-12 09:05:12+03:00,['3fafde2cf8dd4b3a34cf48347a346c436741ae91'],27,27,54,1129925,2,,,,3078
57c5428543d63529dcac37610551f77132c690f0,0,GitHub,2022-05-16 22:43:24+03:00,['f56051539d9330722c36888b730aee5b559e01ec'],57,0,57,1129982,1,,,,3078
bed2ec96a8d8ecbffcf02f0ec73e4f4ecb886fb9,0,GitHub,2022-05-16 22:59:42+03:00,['57c5428543d63529dcac37610551f77132c690f0'],10,137,147,1130129,3,,,,3078
0c769f94515cc13ae2130a818bf566cb09f27774,0,GitHub,2022-05-17 09:15:18+03:00,['bed2ec96a8d8ecbffcf02f0ec73e4f4ecb886fb9'],65,182,247,1130376,3,0,1,1,3078
1ade72037cbb1f356f10f64550e5f94ce1a7fcde,0,GitHub,2022-05-19 14:56:52+03:00,['0c769f94515cc13ae2130a818bf566cb09f27774'],0,49,49,1130425,1,,,,3078
043aeb148cf86c17bc2622671127e65261e1e8d4,0,GitHub,2022-05-22 21:20:29+03:00,['1ade72037cbb1f356f10f64550e5f94ce1a7fcde'],1,1,2,1130427,1,,,,3078
e429672ba6f00db5cf5fecea7f6b344b5326f47b,0,GitHub,2022-05-22 21:21:29+03:00,['043aeb148cf86c17bc2622671127e65261e1e8d4'],1,1,2,1130429,1,,,,3078
74f6bb15c03136aedcac687c21c8914d1bee14ee,0,GitHub,2022-05-22 21:23:22+03:00,['e429672ba6f00db5cf5fecea7f6b344b5326f47b'],1,1,2,1130431,1,,,,3078
285858f7d9b7da8a5ae74990c785bc4e4818b940,0,GitHub,2022-05-22 21:28:13+03:00,['74f6bb15c03136aedcac687c21c8914d1bee14ee'],1,1,2,1130433,1,,,,3078
744af614ba4565b4d34ff637923961bb2e17a62d,0,GitHub,2022-05-22 21:29:01+03:00,['285858f7d9b7da8a5ae74990c785bc4e4818b940'],1,1,2,1130435,1,,,,3078
dc54464ea7694ad2facee1d333b1fa73ba1b9431,0,GitHub,2022-05-22 21:29:49+03:00,['744af614ba4565b4d34ff637923961bb2e17a62d'],1,1,2,1130437,1,,,,3078
b821b223c6e9d027a14893171c858d3ed3f03196,0,GitHub,2022-05-22 21:30:47+03:00,['dc54464ea7694ad2facee1d333b1fa73ba1b9431'],1,1,2,1130439,1,,,,3078
2c13cd7e6d6d7485e1cdf93c9777f7d2ccae7558,0,GitHub,2022-05-22 21:32:05+03:00,['b821b223c6e9d027a14893171c858d3ed3f03196'],73,234,307,1130746,21,0.962962963,1,1,3082
b6298437279cfe340aa2d51f7f9a0666f77f9cfe,0,GitHub,2022-05-22 21:55:50+03:00,['2c13cd7e6d6d7485e1cdf93c9777f7d2ccae7558'],1,1,2,1130748,1,,,,3082
5776ae39aa1495812ad66a4ce7a7ac5fb305255b,0,GitHub,2022-05-30 11:32:01+03:00,['b6298437279cfe340aa2d51f7f9a0666f77f9cfe'],1,1,2,1130750,1,,,,3082
e4f5674706704299eefd9abcf86d9b3fe84bd9a5,0,GitHub,2022-05-30 11:32:59+03:00,['5776ae39aa1495812ad66a4ce7a7ac5fb305255b'],1,1,2,1130752,1,,,,3082
5ad000848653d85a7a47699eb84c411ca037b0e4,0,GitHub,2022-05-30 11:33:33+03:00,['e4f5674706704299eefd9abcf86d9b3fe84bd9a5'],1,1,2,1130754,1,,,,3082
9738a759f01e267772092c2299d8f0d7047942a8,0,GitHub,2022-05-31 08:41:54+03:00,['5ad000848653d85a7a47699eb84c411ca037b0e4'],6,24,30,1130784,3,,,,3082
aa93007678cbabe118156179c8908399d481f625,0,GitHub,2022-06-07 14:44:29+03:00,['9738a759f01e267772092c2299d8f0d7047942a8'],1,1,2,1130786,1,,,,3082
a79c96ec8b2ac51c5da6f33c4461425db0763702,0,GitHub,2022-06-07 14:45:12+03:00,['aa93007678cbabe118156179c8908399d481f625'],1,1,2,1130788,1,,,,3082
8a4abf06303480114c7eec3ced8ad77f3697bd32,0,GitHub,2022-06-07 14:46:01+03:00,['a79c96ec8b2ac51c5da6f33c4461425db0763702'],3,3,6,1130794,1,,,,3082
051249634ad726f703c13341ad70917d300f517a,0,GitHub,2022-06-07 22:34:15+03:00,['8a4abf06303480114c7eec3ced8ad77f3697bd32'],0,2,2,1130796,1,,,,3082
e1206ade30daca0cae5399fb1d88179bf3dbe7ec,0,GitHub,2022-06-07 22:35:10+03:00,['051249634ad726f703c13341ad70917d300f517a'],17,11,28,1130824,2,,,,3082
d00865afecaea95b80eb3c511b8a018fd3070d99,0,GitHub,2022-06-09 23:53:03+03:00,['e1206ade30daca0cae5399fb1d88179bf3dbe7ec'],40,41,81,1130905,4,,,,3082
a8ee8778dfdccbc9bf5c8423d0d7dbdf1c2c0cbf,0,GitHub,2022-06-10 00:04:09+03:00,['d00865afecaea95b80eb3c511b8a018fd3070d99'],0,1,1,1130906,1,,,,3082
79976977feba9a1e77ca1d96137295bc0ab96e8a,1,Martin Tzvetanov Grigorov,2022-06-13 09:06:09+03:00,['a8ee8778dfdccbc9bf5c8423d0d7dbdf1c2c0cbf'],2,2,4,1130910,1,,,,3082
8c723173cfcd42a098e374cdcb2416776f61393a,0,GitHub,2022-06-16 20:10:02+02:00,['79976977feba9a1e77ca1d96137295bc0ab96e8a'],1,1,2,1130912,1,,,,3082
7f42e3ca9b44fc1745a59205445417d70ae294e7,0,GitHub,2022-06-17 18:04:53+02:00,['8c723173cfcd42a098e374cdcb2416776f61393a'],0,282,282,1131194,1,,,,3083
659917b08184528999e3307e69fabc6a66fd07b3,0,GitHub,2022-06-17 18:31:05+02:00,['7f42e3ca9b44fc1745a59205445417d70ae294e7'],10,24,34,1131228,4,,,,3083
5a80e32e6bba7d44fef0edfe333ff62c55da1392,0,GitHub,2022-06-17 18:33:32+02:00,['659917b08184528999e3307e69fabc6a66fd07b3'],1,4,5,1131233,2,,,,3083
5f15869cb3c3a031a755c7b10194625d5150d68d,0,GitHub,2022-06-18 17:45:41+02:00,['5a80e32e6bba7d44fef0edfe333ff62c55da1392'],0,23,23,1131256,1,,,,3084
5af6e43fa03be6d2a6dba4842479ae06e70bcd68,0,GitHub,2022-06-20 18:46:16+02:00,['5f15869cb3c3a031a755c7b10194625d5150d68d'],1,1,2,1131258,1,,,,3084
41c5a3710d03b26bad5e90d04bfc51d6d9e20d65,0,GitHub,2022-06-21 12:20:56+02:00,['5af6e43fa03be6d2a6dba4842479ae06e70bcd68'],1,1,2,1131260,1,,,,3084
e53628d62c14f95ae9acb74449b5445f00ca072f,0,GitHub,2022-06-21 12:23:20+02:00,['41c5a3710d03b26bad5e90d04bfc51d6d9e20d65'],97,0,97,1131357,1,,,,3084
990ed3eb8a7b10ebdbde709458c7754ca4972b9c,0,GitHub,2022-06-21 18:18:42+02:00,['e53628d62c14f95ae9acb74449b5445f00ca072f'],1,1,2,1131359,1,,,,3084
6de4d088630e0ec6c6b5e603f2029bda4f9530a7,0,GitHub,2022-06-21 19:19:05+02:00,['990ed3eb8a7b10ebdbde709458c7754ca4972b9c'],2,2,4,1131363,1,,,,3084
e4a40c4d6e93a50c17f7e42dd54928f8c42f633d,0,GitHub,2022-06-21 19:59:23+02:00,['6de4d088630e0ec6c6b5e603f2029bda4f9530a7'],2,4,6,1131369,1,,,,3084
f068da73b8543c9f6d151d1af58a43d8164b5adc,0,GitHub,2022-06-23 14:25:35+03:00,['e4a40c4d6e93a50c17f7e42dd54928f8c42f633d'],1,1,2,1131371,1,,,,3084
a8821d3ddd7e86d9567e48f0bc6387dcc0214c66,0,GitHub,2022-06-24 12:07:18+03:00,['f068da73b8543c9f6d151d1af58a43d8164b5adc'],7,35,42,1131413,7,,,,3084
f190f1e7d46f557881c3dc600df26d9d78a0233f,0,GitHub,2022-06-24 17:08:25+02:00,['a8821d3ddd7e86d9567e48f0bc6387dcc0214c66'],1,54,55,1131468,2,1,1,1,3084
e42a570fe5405f85dd5a3bab621b725d8766463f,0,GitHub,2022-06-28 08:36:21+02:00,['f190f1e7d46f557881c3dc600df26d9d78a0233f'],1,1,2,1131470,1,,,,3084
30bb7b43d8f702e9cfe4928c1e91cb764c9437d8,0,GitHub,2022-06-28 13:51:18+03:00,['e42a570fe5405f85dd5a3bab621b725d8766463f'],16,16,32,1131502,3,,,,3084
d17c5cc5c066297a09208098627bbed062549dd7,0,GitHub,2022-06-28 13:56:33+03:00,['30bb7b43d8f702e9cfe4928c1e91cb764c9437d8'],17,67,84,1131586,3,0,1,1,3084
eb3342bb445e42b6bd1ceedc264884d20306e98c,0,GitHub,2022-06-28 19:49:21+02:00,['d17c5cc5c066297a09208098627bbed062549dd7'],2,1,3,1131589,1,,,,3084
3f59a62b6d9ef01aa92674c9b3e776d2bee8b252,0,GitHub,2022-06-28 19:51:42+02:00,['eb3342bb445e42b6bd1ceedc264884d20306e98c'],8,17,25,1131614,10,,,,3084
f7142660d7ca58747fd53027182a42dd2acc8a1b,0,GitHub,2022-06-28 19:59:44+02:00,['3f59a62b6d9ef01aa92674c9b3e776d2bee8b252'],17,19,36,1131650,13,,,,3084
bbe92d0052e2561bb4dca4739c12f9a419cb1a3f,0,GitHub,2022-06-28 20:00:57+02:00,['f7142660d7ca58747fd53027182a42dd2acc8a1b'],1,1,2,1131652,1,,,,3084
903fa84725ca5b2aaa1c740c9b0c3b4dcf24e023,0,GitHub,2022-06-29 11:25:59+02:00,['bbe92d0052e2561bb4dca4739c12f9a419cb1a3f'],1,1,2,1131654,1,,,,3084
dd1d7ae0758596b6b4183a87eb3b94f1e7f298c2,0,GitHub,2022-06-29 19:56:41+02:00,['903fa84725ca5b2aaa1c740c9b0c3b4dcf24e023'],0,37,37,1131691,1,,,,3085
f6740929b08cb3e4e04b7b303da9152dfa11b93e,0,GitHub,2022-07-01 08:06:10+02:00,['dd1d7ae0758596b6b4183a87eb3b94f1e7f298c2'],1,26,27,1131718,3,,,,3086
a71fe72336d1ef5f387751551c5429a8a7c4c082,0,GitHub,2022-07-01 08:07:11+02:00,['f6740929b08cb3e4e04b7b303da9152dfa11b93e'],8,9,17,1131735,5,,,,3086
0654da6a33cab41c894a4b3dfdde6048a75f887a,0,GitHub,2022-07-01 08:07:26+02:00,['a71fe72336d1ef5f387751551c5429a8a7c4c082'],3,5,8,1131743,1,,,,3086
29600bd2f569b1d31f3ffdc9f2ebd55d13db8527,0,GitHub,2022-07-01 08:08:11+02:00,['0654da6a33cab41c894a4b3dfdde6048a75f887a'],0,47,47,1131790,1,,,,3087
bf6b86d2c784ced5ec791f8249d3f2ecf18a4ee0,0,GitHub,2022-07-01 11:17:11+03:00,['29600bd2f569b1d31f3ffdc9f2ebd55d13db8527'],11,230,241,1132031,10,0.403846154,1,1,3091
8066c57fe567c7f52ce2fd6c4d47a12831782351,0,GitHub,2022-07-01 18:40:02+02:00,['bf6b86d2c784ced5ec791f8249d3f2ecf18a4ee0'],2,2,4,1132035,1,,,,3091
797cec66c4d4b2d4eaf909bfc2a7d98922e2b128,0,GitHub,2022-07-01 19:37:08+02:00,['8066c57fe567c7f52ce2fd6c4d47a12831782351'],2,15,17,1132052,1,1,1,1,3091
1d72182fd6afc149d33b5de8e2c68492c116732f,0,GitHub,2022-07-04 13:06:51+02:00,['797cec66c4d4b2d4eaf909bfc2a7d98922e2b128'],1,1,2,1132054,1,,,,3091
85348352cebf14a465eea0725b316b471e2020ad,0,GitHub,2022-07-04 18:32:26+02:00,['1d72182fd6afc149d33b5de8e2c68492c116732f'],1,1,2,1132056,1,,,,3091
820ed6e5ea4417b5735078bfd26c99f1305ea363,0,GitHub,2022-07-04 18:38:51+02:00,['85348352cebf14a465eea0725b316b471e2020ad'],23,197,220,1132276,2,0.472527473,1,1,3092
80c04a32dcbc0165c4e7f15f79c83afc6937193a,0,GitHub,2022-07-04 18:42:06+02:00,['820ed6e5ea4417b5735078bfd26c99f1305ea363'],0,3,3,1132279,2,,,,3092
2a46a61b65697706e2277921c3bf5ccb819c311f,0,GitHub,2022-07-06 17:18:25-06:00,['80c04a32dcbc0165c4e7f15f79c83afc6937193a'],6,43,49,1132328,2,0.608695652,0.608695652,1,3092
d5621e9f8da61c02e4339c11b6852ad059dd72b3,0,GitHub,2022-07-07 16:16:28-06:00,['2a46a61b65697706e2277921c3bf5ccb819c311f'],1,218,219,1132547,13,0.446601942,0.766990291,1,3092
da2459fbc9edfd867fbd4bd7d77602b79d0ad3ce,0,GitHub,2022-07-11 11:23:51+03:00,['d5621e9f8da61c02e4339c11b6852ad059dd72b3'],34,18,52,1132599,1,,,,3092
5fc7e599958c38d5aa1d46776fbc8590fcc02424,0,GitHub,2022-07-11 11:26:03+03:00,['da2459fbc9edfd867fbd4bd7d77602b79d0ad3ce'],1,1,2,1132601,1,,,,3092
d4f7d57b43c798fd236020fe422072682cfdc67e,0,GitHub,2022-07-11 17:44:43+03:00,['5fc7e599958c38d5aa1d46776fbc8590fcc02424'],1,1380,1381,1133982,2,,,,3093
eb2477555d32d25ec1e8f5469d52ff76beaf33b6,0,GitHub,2022-07-12 10:48:49+03:00,['d4f7d57b43c798fd236020fe422072682cfdc67e'],4,183,187,1134169,12,0,0,1,3099
54c2110d05517793cb68e3a69d2e863bb7680f57,0,GitHub,2022-07-12 11:45:28+03:00,['eb2477555d32d25ec1e8f5469d52ff76beaf33b6'],4,4,8,1134177,3,,,,3099
40418733744975977c050677cf14ca3623e60c0b,0,GitHub,2022-07-12 11:46:03+03:00,['54c2110d05517793cb68e3a69d2e863bb7680f57'],5,11,16,1134193,2,,,,3099
9d79af0962bc2d4400d86175340fe16542cc1988,0,GitHub,2022-07-12 11:47:16+03:00,['40418733744975977c050677cf14ca3623e60c0b'],3,3,6,1134199,2,,,,3099
d193d4e7c4a19f535d56e2737e9eea20e3093af0,0,GitHub,2022-07-12 14:28:52+03:00,['9d79af0962bc2d4400d86175340fe16542cc1988'],5,5,10,1134209,2,,,,3099
6ef5709e6c53629b41890f9df3047554663d3727,0,GitHub,2022-07-12 14:30:13+03:00,['d193d4e7c4a19f535d56e2737e9eea20e3093af0'],7,7,14,1134223,4,,,,3099
3843ad09d37a7af89dd7e16c50824c87e450a3b3,0,GitHub,2022-07-18 10:33:58+03:00,['6ef5709e6c53629b41890f9df3047554663d3727'],1,1,2,1134225,1,,,,3099
5ca085de87274d05e6190fa571f7b9dc1d1b497d,0,GitHub,2022-07-18 10:35:05+03:00,['3843ad09d37a7af89dd7e16c50824c87e450a3b3'],1,1,2,1134227,1,,,,3099
82e9bae4be13eb6b2c9e65f6f467a5e601969fd6,0,GitHub,2022-07-20 09:41:23+03:00,['5ca085de87274d05e6190fa571f7b9dc1d1b497d'],1,1,2,1134229,1,,,,3099
2a7e85185e92f5ccb7f36b7cfab1d96e76b2bd12,0,GitHub,2022-07-20 09:42:40+03:00,['82e9bae4be13eb6b2c9e65f6f467a5e601969fd6'],97,101,198,1134427,4,0,0,0,3099
9c144131f1887a69221e5b30101ed890c214c277,0,GitHub,2022-07-21 10:37:19+03:00,['2a7e85185e92f5ccb7f36b7cfab1d96e76b2bd12'],3,3,6,1134433,1,,,,3099
f0ac564f981556e7a92cafc7a0e10eb95ed9d9e2,0,GitHub,2022-07-21 10:39:01+03:00,['9c144131f1887a69221e5b30101ed890c214c277'],7,7,14,1134447,4,,,,3099
18c9b4afb53f6216eca1fb464afaa1082781bf11,0,GitHub,2022-07-21 15:22:07+03:00,['f0ac564f981556e7a92cafc7a0e10eb95ed9d9e2'],0,33,33,1134480,1,,,,3099
945820a9ce5a4ad67fb9a9cdacbddbaacfd2e5db,0,GitHub,2022-07-25 11:16:09+03:00,['18c9b4afb53f6216eca1fb464afaa1082781bf11'],1,11,12,1134492,1,1,1,1,3099
aa2a3f1ab23d299449e9bdd85abf6276be8cb70d,0,GitHub,2022-07-25 11:17:41+03:00,['945820a9ce5a4ad67fb9a9cdacbddbaacfd2e5db'],1,1,2,1134494,1,,,,3099
8dc17b15f3791666667fb5c1ab140c084be1f2d1,0,GitHub,2022-07-25 11:18:08+03:00,['aa2a3f1ab23d299449e9bdd85abf6276be8cb70d'],1,1,2,1134496,1,,,,3099
4e1a1a854482b2bb0085de67d13c60e4dd6c6550,0,GitHub,2022-07-25 11:18:31+03:00,['8dc17b15f3791666667fb5c1ab140c084be1f2d1'],1,1,2,1134498,1,,,,3099
39480d6b67345c7d7d6d2de4447cae7215991b1c,0,GitHub,2022-07-25 11:54:01+02:00,['4e1a1a854482b2bb0085de67d13c60e4dd6c6550'],9,55,64,1134562,4,,,,3099
f2c5d56c2f57a26d7bca29d03a7352759c081dd4,0,GitHub,2022-07-25 22:33:54+03:00,['39480d6b67345c7d7d6d2de4447cae7215991b1c'],3,3,6,1134568,2,,,,3099
36b18515b014075ec2b3018ed9d598f18d44cfce,0,GitHub,2022-07-25 22:34:57+03:00,['f2c5d56c2f57a26d7bca29d03a7352759c081dd4'],20,20,40,1134608,2,,,,3099
cdc597490720a95a6cec40cb31c89116f74cddd5,0,GitHub,2022-07-25 22:35:30+03:00,['36b18515b014075ec2b3018ed9d598f18d44cfce'],1,1,2,1134610,1,,,,3099
61a1cdcd500356726d4995c19c8a4d5d89989b13,0,GitHub,2022-07-25 22:36:44+03:00,['cdc597490720a95a6cec40cb31c89116f74cddd5'],37,371,408,1135018,11,0.532374101,0.971223022,0.863309353,3101
4465d88d8eb8a89d4adffb7506393416dd3a964f,0,GitHub,2022-07-25 22:42:55+03:00,['61a1cdcd500356726d4995c19c8a4d5d89989b13'],0,3,3,1135021,1,0,0,1,3101
2c80b563a323dc24bd684385f0b2d95c3a066bd2,0,GitHub,2022-07-28 11:47:27+02:00,['4465d88d8eb8a89d4adffb7506393416dd3a964f'],72,78,150,1135171,21,,,,3101
816f025d3c4e324621b847b0268db0c5e2922afc,0,GitHub,2022-07-28 14:06:15+03:00,['2c80b563a323dc24bd684385f0b2d95c3a066bd2'],2,2,4,1135175,1,,,,3101
e9c10d552c14917b0bc7a13c403436d8e769dacc,0,GitHub,2022-07-28 14:06:54+03:00,['816f025d3c4e324621b847b0268db0c5e2922afc'],12,12,24,1135199,4,,,,3101
d3373bb12d2d0bf60964ad4a2cded4fc22bd31db,0,GitHub,2022-07-28 14:07:31+03:00,['e9c10d552c14917b0bc7a13c403436d8e769dacc'],3,3,6,1135205,2,,,,3101
799aa75211dc54b312728605610717cb50a7ef95,0,GitHub,2022-07-28 14:08:41+03:00,['d3373bb12d2d0bf60964ad4a2cded4fc22bd31db'],1,1,2,1135207,1,,,,3101
74cee286d9c1c52130ac4b7f45d5b88d61f714f6,0,GitHub,2022-07-28 14:09:14+03:00,['799aa75211dc54b312728605610717cb50a7ef95'],1,1,2,1135209,1,,,,3101
