sha,is_bug,committer_name,commit_time,parents,all_del,all_add,all_change_lines,all_lines,files_change_nums,dmm_unit_size,dmm_unit_complexity,dmm_unit_interfacing,file_nums
ff54fdce61302e51eef8dc34dccf57ed88bdf0f9,1,Marcel Kornacker,2011-05-23 15:28:19-07:00,[],0,1618,1618,1618,30,0.70505618,1,0.926966292,30
8b130c37bc9ababc3b644274449eb2c716bdaf0b,1,Patrick Hunt,2011-06-06 13:17:35-07:00,['ff54fdce61302e51eef8dc34dccf57ed88bdf0f9'],3,9,12,1630,1,,,,30
efb7e839342f10e14ac7a3769f4015883a85eb3d,1,Patrick Hunt,2011-06-06 13:18:33-07:00,['8b130c37bc9ababc3b644274449eb2c716bdaf0b'],56,216,272,1902,3,,,,32
05499642ece32bac3c8b28593961648b99eecc24,0,Patrick Hunt,2011-06-06 13:18:50-07:00,['efb7e839342f10e14ac7a3769f4015883a85eb3d'],0,9,9,1911,2,,,,32
d6cb35fbd68cb3973a754ac0610e49f2133c346e,1,Patrick Hunt,2011-06-06 13:19:22-07:00,['05499642ece32bac3c8b28593961648b99eecc24'],1,9,10,1921,1,,,,32
62bb27e31be2067e113806f9e7933e2f2eebf11f,0,Patrick Hunt,2011-06-06 17:14:05-07:00,['d6cb35fbd68cb3973a754ac0610e49f2133c346e'],5,58,63,1984,2,0,0,1,32
13436fb6cc4fb9e14cd977c03a9f3929dc617d03,0,Patrick Hunt,2011-06-07 14:35:04-07:00,['62bb27e31be2067e113806f9e7933e2f2eebf11f'],0,16,16,2000,1,,,,32
2715f1d7f004dc475f70906fb703fcc745e2d3d8,1,Marcel Kornacker,2011-06-09 11:55:52-07:00,['13436fb6cc4fb9e14cd977c03a9f3929dc617d03'],224,3830,4054,6054,58,0.588320115,0.780100937,0.900504686,60
0d703b8470cfc424917ced83851aae9d73ce981d,1,Marcel Kornacker,2011-06-10 13:42:15-07:00,['2715f1d7f004dc475f70906fb703fcc745e2d3d8'],367,818,1185,7239,32,0.577889447,0.346733668,1,66
e0f626269e2d0da57110fa0c19a29d7b2bcd2e8e,0,carl,2011-06-10 22:43:43-07:00,['0d703b8470cfc424917ced83851aae9d73ce981d'],31,123,154,7393,5,0,0,0,67
38dccb93b9a58a818b82dde9f4c8228c975690ef,1,Alexander Behm,2011-06-13 16:23:27-07:00,['e0f626269e2d0da57110fa0c19a29d7b2bcd2e8e'],104,403,507,7900,4,0.365384615,0.903846154,1,67
f1dd662111776f667a5f47291ce5f8cbc57122f6,0,carl,2011-06-14 13:26:35-07:00,['38dccb93b9a58a818b82dde9f4c8228c975690ef'],0,54,54,7954,3,,,,70
b4329d78eb651a5fc82f70142f84bc78ec447f2e,1,Marcel Kornacker,2011-06-16 17:55:58-07:00,['f1dd662111776f667a5f47291ce5f8cbc57122f6'],478,1259,1737,9691,48,0.525842697,0.752808989,0.959550562,76
853493b2c3d7e290f4ee25dbd50a72265223d26b,1,Marcel Kornacker,2011-06-16 17:58:26-07:00,['b4329d78eb651a5fc82f70142f84bc78ec447f2e'],16,258,274,9965,9,0.297752809,0.741573034,1,76
2eb85f43d830d4f7a7aa81f282d721fcd5bf2d1f,1,Alexander Behm,2011-06-17 18:06:56-07:00,['853493b2c3d7e290f4ee25dbd50a72265223d26b'],58,779,837,10802,18,0.410447761,0.495024876,0.776119403,77
c3539595a5521ce9426f80edf0567562c4ead1c0,0,Patrick Hunt,2011-06-20 12:34:06-07:00,['2eb85f43d830d4f7a7aa81f282d721fcd5bf2d1f'],0,9,9,10811,1,,,,77
cac1723b9967d66d86986d8f6526464af43447e6,1,marcel,2011-06-20 14:30:18-07:00,['c3539595a5521ce9426f80edf0567562c4ead1c0'],32,172,204,11015,21,0.487179487,1,1,78
8eed11aa8e84b172fb50483f69fcaeae58b098cb,0,marcel,2011-06-20 17:43:00-07:00,['cac1723b9967d66d86986d8f6526464af43447e6'],5,0,5,11020,1,0,0,0,78
78da2864cc96bf7c30465106fb1f99a30a8ed7f9,0,Patrick Hunt,2011-06-21 09:33:35-07:00,['8eed11aa8e84b172fb50483f69fcaeae58b098cb'],11,15,26,11046,3,,,,78
2619af1b57d36f2d11c81be4b913b58f7dc5f702,1,Alexander Behm,2011-06-22 11:48:29-07:00,['78da2864cc96bf7c30465106fb1f99a30a8ed7f9'],133,269,402,11448,17,0.447058824,0.917647059,0.917647059,79
e2e87582f5ae1ea94f7ef149da7a4b0c2e79bf46,0,marcel,2011-06-22 13:42:06-07:00,['2619af1b57d36f2d11c81be4b913b58f7dc5f702'],95,55,150,11598,50,0,0,0,79
b03d0a4353368e01f51da738c3fbcea82030380f,0,marcel,2011-06-22 21:06:36-07:00,['e2e87582f5ae1ea94f7ef149da7a4b0c2e79bf46'],4,4,8,11606,2,,,,79
33704feb7522acf3683ede11ebf5a137f2d4532d,0,Marcel Kornacker,2011-06-24 17:50:39-07:00,['b03d0a4353368e01f51da738c3fbcea82030380f'],31,241,272,11878,8,0.483050847,0.610169492,1,79
fd1df40ddd667312b79761450e9cfb993e900677,1,Patrick Hunt,2011-06-27 09:05:19-07:00,['33704feb7522acf3683ede11ebf5a137f2d4532d'],5,10,15,11893,4,1,1,1,79
77617256f4bfabec833c4497aae4652d074afe7b,1,marcel,2011-06-27 16:19:25-07:00,['fd1df40ddd667312b79761450e9cfb993e900677'],38,426,464,12357,12,0.382352941,1,1,86
d5593bfd7b2d86def8d0b0edaf611e4b6eb28eaf,1,Marcel Kornacker,2011-06-30 14:07:37-07:00,['77617256f4bfabec833c4497aae4652d074afe7b'],16,160,176,12533,6,0.490196078,0.656862745,0.921568627,86
c0dcd992d9e0b8ca718785ff0b26eaac2c4d671f,0,Marcel Kornacker,2011-06-30 14:12:32-07:00,['d5593bfd7b2d86def8d0b0edaf611e4b6eb28eaf'],6,43,49,12582,1,0.375,1,1,86
47ebc307aac92e87b9dbfd4843a3cc453ab39d1d,1,Marcel Kornacker,2011-06-30 17:32:10-07:00,['c0dcd992d9e0b8ca718785ff0b26eaac2c4d671f'],62,689,751,13333,35,1,1,0.969512195,90
32861905995d6ee257f85698cff6b8a45ef204c4,1,Patrick Hunt,2011-07-07 15:49:46-07:00,['47ebc307aac92e87b9dbfd4843a3cc453ab39d1d'],62,3895,3957,17290,72,0.407092199,0.612765957,0.753191489,157
018fda5cb29b69d590c1eb9b19fff78eb80b3dff,1,Marcel Kornacker,2011-07-08 14:52:57-07:00,['32861905995d6ee257f85698cff6b8a45ef204c4'],93,237,330,17620,11,1,1,0,160
28d3eb0d4fe37563c9218198d3d21e267a345914,0,Marcel Kornacker,2011-07-08 16:39:32-07:00,['018fda5cb29b69d590c1eb9b19fff78eb80b3dff'],53,159,212,17832,11,0.181818182,0.141414141,0.414141414,160
f2ceb748ab90fa11eb01e9d4a43cf0994fd62344,1,marcel,2011-07-12 11:04:35-07:00,['28d3eb0d4fe37563c9218198d3d21e267a345914'],28,1058,1086,18918,36,0.283687943,0.345744681,0.868794326,165
c23616a30c953989d281f1ddf676a564281a64d3,1,marcel,2011-07-13 13:48:54-07:00,['f2ceb748ab90fa11eb01e9d4a43cf0994fd62344'],153,198,351,19269,20,1,0,0,165
799bba93e01109bd49129d56c547c6dcaf1d40bc,0,carl,2011-07-13 17:10:52-07:00,['c23616a30c953989d281f1ddf676a564281a64d3'],1,29,30,19299,3,,,,166
b1bd604bd3728f0b19397c84184ceb025d2c7247,1,Alexander Behm,2011-07-14 10:50:18-07:00,['799bba93e01109bd49129d56c547c6dcaf1d40bc'],222,809,1031,20330,13,0.245901639,0.299180328,0.577868852,166
d6d61cf054d0eb13dbeab9f62dda84a43c94c346,0,Alexander Behm,2011-07-14 13:15:52-07:00,['b1bd604bd3728f0b19397c84184ceb025d2c7247'],0,7,7,20337,1,,,,166
83f60f0821e3b6c8f222a26b13444e5e05939b4e,0,Marcel Kornacker,2011-07-14 17:22:50-07:00,['d6d61cf054d0eb13dbeab9f62dda84a43c94c346'],102,333,435,20772,26,0.01863354,0.01863354,1,166
08e8a5db4cb93a59ff44989ef65269b2d6ac7502,1,Marcel Kornacker,2011-07-15 13:17:20-07:00,['83f60f0821e3b6c8f222a26b13444e5e05939b4e'],30,127,157,20929,12,0.387096774,0.967741935,0.387096774,166
5f050efcd3ffada50c465da76ebc2f25bdb740fc,0,Alexander Behm,2011-07-19 14:42:24-07:00,['08e8a5db4cb93a59ff44989ef65269b2d6ac7502'],67,513,580,21509,21,0.153508772,0.342105263,0.592105263,168
85ea75db78da59b3da36dd76df5de5d852233d8c,0,Alexander Behm,2011-07-20 13:28:32-07:00,['5f050efcd3ffada50c465da76ebc2f25bdb740fc'],2,8,10,21519,2,,,,169
de2b53c5801570f0d2361fd5a7037ef7cd4ff4bf,0,Alexander Behm,2011-07-20 14:17:01-07:00,['85ea75db78da59b3da36dd76df5de5d852233d8c'],148,528,676,22195,10,0.672131148,0.56557377,0.31147541,174
65911b5aae4cafc0a2cff53780143aed0138fcde,0,marcel,2011-07-20 16:12:18-07:00,['de2b53c5801570f0d2361fd5a7037ef7cd4ff4bf'],78,156,234,22429,2,0.704918033,0.885245902,0.655737705,174
603473b0b49c9c5009517e9bb9232e100894a095,0,Alexander Behm,2011-07-21 10:44:33-07:00,['65911b5aae4cafc0a2cff53780143aed0138fcde'],6,13,19,22448,3,,,,174
e4ab163593902ede5f356cf21936faa85d1db6a8,0,Alexander Behm,2011-07-21 13:29:39-07:00,['603473b0b49c9c5009517e9bb9232e100894a095'],2,23,25,22473,2,1,1,1,174
a16b4e2b8cab3e9dcad8592d203f6bdeea8c31f8,0,Alexander Behm,2011-07-21 15:12:42-07:00,['e4ab163593902ede5f356cf21936faa85d1db6a8'],2,2,4,22477,1,,,,174
cc141953de480d5aaa6a8fd718581398688e6ef2,1,Marcel Kornacker,2011-07-22 12:09:55-07:00,['a16b4e2b8cab3e9dcad8592d203f6bdeea8c31f8'],211,350,561,23038,23,0.793103448,1,1,180
ddcac4c05775018907fd5fb1c726d3837567f93c,0,Alexander Behm,2011-07-22 12:13:01-07:00,['cc141953de480d5aaa6a8fd718581398688e6ef2'],8,3209,3217,26255,14,0.995795375,0.996496146,0.880868956,189
a2d25b16642998177e10b4363b6ff45e2f2628de,0,Alexander Behm,2011-07-25 18:08:15-07:00,['ddcac4c05775018907fd5fb1c726d3837567f93c'],931,587,1518,27773,7,1,1,0.816793893,190
0526367daa1f4031850e4b3d7e1dcc67ec28b7d6,1,Alexander Behm,2011-07-25 18:51:21-07:00,['a2d25b16642998177e10b4363b6ff45e2f2628de'],215,560,775,28548,21,0.917355372,1,0.661157025,195
05f42d453ff4d0ec0691a5883c9b08c20f0793aa,0,Alexander Behm,2011-07-26 11:36:00-07:00,['0526367daa1f4031850e4b3d7e1dcc67ec28b7d6'],0,3,3,28551,1,,,,195
a3506de8e5f2824b0bebad0bd466a42e7df1a2d4,1,Marcel Kornacker,2011-07-26 17:08:27-07:00,['05f42d453ff4d0ec0691a5883c9b08c20f0793aa'],177,506,683,29234,24,0.39010989,0.802197802,1,198
a58a6dd099b13fb01c06e52ec62d523488c1e305,0,Alexander Behm,2011-07-27 12:03:46-07:00,['a3506de8e5f2824b0bebad0bd466a42e7df1a2d4'],4,117,121,29355,5,,,,200
f403a1289f44ff615f83074b272aa1583bd1ee76,0,Alexander Behm,2011-07-27 12:10:43-07:00,['a58a6dd099b13fb01c06e52ec62d523488c1e305'],1,1,2,29357,1,,,,200
9a3b4dd42c919fe8a7a028bec0cad44004930fc8,1,Alexander Behm,2011-07-27 14:48:39-07:00,['f403a1289f44ff615f83074b272aa1583bd1ee76'],19,45,64,29421,3,0,0.4,1,200
3cce60756b9804fa6c8cf0a832509ddc659f5510,0,Alexander Behm,2011-07-28 13:25:13-07:00,['9a3b4dd42c919fe8a7a028bec0cad44004930fc8'],20,131,151,29572,6,,,,201
9746370b86e2842649fd14855afea2c367f5c719,0,Marcel Kornacker,2011-07-28 14:07:01-07:00,['3cce60756b9804fa6c8cf0a832509ddc659f5510'],6,6,12,29584,3,,,,201
c1c6f21e5a33c31ab958828427151008a266298d,0,carl,2011-07-29 10:37:40-07:00,['9746370b86e2842649fd14855afea2c367f5c719'],3,19,22,29606,1,,,,201
cb30685bf4133be51ac313e96eb9483130d101ff,0,carl,2011-07-29 14:34:31-07:00,['c1c6f21e5a33c31ab958828427151008a266298d'],0,0,0,29606,0,,,,201
2100db776365a985c912b8face032bcb7ebd32a3,0,carl,2011-07-29 14:37:22-07:00,['cb30685bf4133be51ac313e96eb9483130d101ff'],0,0,0,29606,0,,,,201
649930f9cd572b03e20d9d8865864df3f9a0a4f3,0,Alexander Behm,2011-07-29 16:21:45-07:00,['2100db776365a985c912b8face032bcb7ebd32a3'],0,38,38,29644,5,0.928571429,1,1,201
b953ff1398caf6bb0d7c594f2f24f2dce1b32a31,0,carl,2011-07-29 18:44:57-07:00,['649930f9cd572b03e20d9d8865864df3f9a0a4f3'],0,0,0,29644,0,,,,201
edc3a5518439ed59e6c46b04d0393018aabfa8c5,1,carl,2011-07-31 17:31:09-07:00,['b953ff1398caf6bb0d7c594f2f24f2dce1b32a31'],83,295,378,30022,14,,,,208
d1f468bbe1658db002ac3199e949997d8b633c24,0,Carl Steinbach,2011-07-31 19:36:26-07:00,['edc3a5518439ed59e6c46b04d0393018aabfa8c5'],0,0,0,30022,0,,,,208
a94e7f92e83b5a3899bcf17a3489dd85103bf0b2,0,carl,2011-07-31 23:32:26-07:00,['d1f468bbe1658db002ac3199e949997d8b633c24'],2,2,4,30026,1,,,,208
fa1faefa01209b4dd3dc3c3bbb35087c3f139e63,1,Marcel Kornacker,2011-08-02 17:38:23-07:00,['a94e7f92e83b5a3899bcf17a3489dd85103bf0b2'],533,1139,1672,31698,46,0.494708995,0.732804233,1,212
ff91886e0d3483eda560fd7eea9b910a140fe8c1,0,Carl Steinbach,2011-08-02 18:54:39-07:00,['fa1faefa01209b4dd3dc3c3bbb35087c3f139e63'],1,2,3,31701,2,,,,212
69c353b943950ce60ca459da5bfb7770b095b645,0,Alexander Behm,2011-08-02 18:55:39-07:00,['ff91886e0d3483eda560fd7eea9b910a140fe8c1'],8,9,17,31718,3,1,1,0,212
2a85796d0e0236ef64bd1943c5141fd120d3c182,0,Alexander Behm,2011-08-02 19:08:46-07:00,['69c353b943950ce60ca459da5bfb7770b095b645'],19,355,374,32092,7,0,0.220779221,0.207792208,212
4f9f2e77181f4e18f34bba31a3e23ce397c00789,0,Marcel Kornacker,2011-08-02 20:09:50-07:00,['2a85796d0e0236ef64bd1943c5141fd120d3c182'],45,112,157,32249,10,0.75862069,0.793103448,0.862068966,212
d8fe755c55c0df7d3e58377586ae25ace67e28ce,1,Alexander Behm,2011-08-03 10:54:02-07:00,['4f9f2e77181f4e18f34bba31a3e23ce397c00789'],8,10,18,32267,4,1,1,1,212
d38a03a4fa81b90727cfeab46fd86d6fd1ee5b16,0,Alexander Behm,2011-08-03 12:04:57-07:00,['d8fe755c55c0df7d3e58377586ae25ace67e28ce'],2,6,8,32275,1,0,0,1,212
c534062c20fe3472f874c5fbeb61272327286c46,0,Marcel Kornacker,2011-08-03 15:37:58-07:00,['d38a03a4fa81b90727cfeab46fd86d6fd1ee5b16'],3,1,4,32279,2,,,,212
246bc8589c91d8a9b4256724b7b3e0a7c157a174,0,carl,2011-08-03 15:49:59-07:00,['c534062c20fe3472f874c5fbeb61272327286c46'],0,1,1,32280,1,,,,212
8661005072ea5ffb122309290d1ec70db0f790ce,0,Alexander Behm,2011-08-04 10:16:19-07:00,['246bc8589c91d8a9b4256724b7b3e0a7c157a174'],54,1280,1334,33614,13,1,0.983508246,0.874062969,218
48eb982b3815dcb1951c71cc33fc8a6fcd430247,0,Alexander Behm,2011-08-04 10:53:04-07:00,['8661005072ea5ffb122309290d1ec70db0f790ce'],10,103,113,33727,3,1,1,1,218
6e47f059cbe6f53d7865fbf6878072efbe978c82,0,carl,2011-08-04 15:24:53-07:00,['48eb982b3815dcb1951c71cc33fc8a6fcd430247'],0,9,9,33736,3,,,,220
8572d461f3c8e890d537f96f7528b1bf39f1ffea,0,Alexander Behm,2011-08-05 12:03:59-07:00,['6e47f059cbe6f53d7865fbf6878072efbe978c82'],13,76,89,33825,5,1,1,1,220
5ca75fae47c594c9fc40fa81ff5c5a65cef42478,1,Marcel Kornacker,2011-08-08 12:25:44-07:00,['8572d461f3c8e890d537f96f7528b1bf39f1ffea'],144,888,1032,34857,32,0.3387471,0.466357309,0.816705336,223
944277a7adfeb8b297cfb9ba0fca1c88ce2ee70f,1,Alexander Behm,2011-08-09 17:07:28-07:00,['5ca75fae47c594c9fc40fa81ff5c5a65cef42478'],48,211,259,35116,7,0.161616162,0.95959596,0.767676768,223
e5e12da4990ee3dae96926d288f1ecdef0841164,0,Alexander Behm,2011-08-10 11:01:19-07:00,['944277a7adfeb8b297cfb9ba0fca1c88ce2ee70f'],79,80,159,35275,5,0.35,0.1,1,223
e74892856f491cb7152296fed8aa4456ac54d94a,1,Alexander Behm,2011-08-10 14:22:22-07:00,['e5e12da4990ee3dae96926d288f1ecdef0841164'],152,825,977,36252,28,0.249122807,0.336842105,0.256140351,229
fa0dc20a11e3f3ac25b02e17cb9a00b315dbf4fd,0,Alexander Behm,2011-08-10 15:02:50-07:00,['e74892856f491cb7152296fed8aa4456ac54d94a'],26,35,61,36313,5,0,0,0,229
3a370414f2559cf901502ae8127f09e7c717d8d1,0,Carl Steinbach,2011-08-11 15:30:51-07:00,['fa0dc20a11e3f3ac25b02e17cb9a00b315dbf4fd'],1,1,2,36315,1,,,,229
1087bf061cbf102f4e0ab57ff132f8077e6adfe4,1,Marcel Kornacker,2011-08-11 17:34:36-07:00,['3a370414f2559cf901502ae8127f09e7c717d8d1'],245,519,764,37079,22,0.211764706,0.211764706,0.894117647,231
940fc08f444c8694ba4ede1372598cdddb0dd04f,0,Carl Steinbach,2011-08-12 18:19:20-07:00,['1087bf061cbf102f4e0ab57ff132f8077e6adfe4'],157,77,234,37313,10,,,,231
8dc3596784b34453ef45e9f31886ecd0a12c54d1,1,Alexander Behm,2011-08-17 13:36:25-07:00,['940fc08f444c8694ba4ede1372598cdddb0dd04f'],90,67,157,37470,5,1,0.882352941,0.176470588,231
da2404afb204aec607a49dc8de1cf9aaa6e8dbe5,1,Alexander Behm,2011-08-17 13:52:00-07:00,['8dc3596784b34453ef45e9f31886ecd0a12c54d1'],23,203,226,37696,14,0.313131313,0.95959596,0.95959596,234
7f9e57bc4d30d13e2abd6de2036b642ec1b1d0d8,1,Marcel Kornacker,2011-08-18 17:20:01-07:00,['da2404afb204aec607a49dc8de1cf9aaa6e8dbe5'],295,1071,1366,39062,64,0.478448276,0.36637931,0.719827586,237
fade777919236872639030062d9a3a43beb8792d,1,Alexander Behm,2011-08-18 18:30:32-07:00,['7f9e57bc4d30d13e2abd6de2036b642ec1b1d0d8'],309,768,1077,40139,19,0.269005848,0.666666667,0.918128655,242
8f2d47cdd9684f7c7b475d665752938b33c5baf8,0,Marcel Kornacker,2011-08-19 13:29:53-07:00,['fade777919236872639030062d9a3a43beb8792d'],1,1,2,40141,4,,,,242
fc8eb435be78545abc74fb3417168421a17ee0d0,0,Alexander Behm,2011-08-19 16:55:57-07:00,['8f2d47cdd9684f7c7b475d665752938b33c5baf8'],6,7,13,40154,2,,,,242
de706ba8305d4b04f896a067ec0529d5471c575f,0,Marcel Kornacker,2011-08-22 18:02:17-07:00,['fc8eb435be78545abc74fb3417168421a17ee0d0'],1,133,134,40288,2,,,,242
697c0c649f4f1cf9c27914b088e962944eda975d,0,Alexander Behm,2011-08-22 21:00:02-07:00,['de706ba8305d4b04f896a067ec0529d5471c575f'],65,138,203,40491,8,0.025,0.725,1,242
34e18b2219e70b7389c3e3f0136eb1fcbc6eefb5,1,Alexander Behm,2011-08-23 15:11:30-07:00,['697c0c649f4f1cf9c27914b088e962944eda975d'],88,312,400,40891,14,0.950980392,0.980392157,0.980392157,243
8c485ecb99fca96dc9b46446c8d4030f9846b954,1,Marcel Kornacker,2011-08-24 11:20:36-07:00,['34e18b2219e70b7389c3e3f0136eb1fcbc6eefb5'],57,77,134,41025,9,0,0,0,243
a69e30d532cdb8337723c2bc6e6e3a7450aea48f,1,Marcel Kornacker,2011-08-29 11:51:45-07:00,['8c485ecb99fca96dc9b46446c8d4030f9846b954'],477,1251,1728,42753,37,0.295546559,0.469635628,0.789473684,250
8fb607322d978ff618615cb5c00bb0f11c02acf3,1,Alexander Behm,2011-08-29 16:57:45-07:00,['a69e30d532cdb8337723c2bc6e6e3a7450aea48f'],520,1876,2396,45149,44,0.200828157,0.832298137,0.83436853,264
de9edbeb60619f3731e16a262bc48874237bcd00,0,Alexander Behm,2011-08-29 17:58:14-07:00,['8fb607322d978ff618615cb5c00bb0f11c02acf3'],0,18,18,45167,1,,,,265
28c333cd09ee48b1f6329005e40a383af3148bcc,1,Alexander Behm,2011-08-30 17:21:44-07:00,['de9edbeb60619f3731e16a262bc48874237bcd00'],493,1124,1617,46784,19,0.140625,0.390625,0.265625,268
9497890e7988ae1f786f701240f7f857c2e8ac3d,1,Marcel Kornacker,2011-08-30 22:10:36-07:00,['28c333cd09ee48b1f6329005e40a383af3148bcc'],44,439,483,47267,17,0.383116883,0.37012987,0.597402597,270
80813e712f6dc609dd84dcacaa588b8149836bce,0,Carl Steinbach,2011-09-01 11:30:49-07:00,['9497890e7988ae1f786f701240f7f857c2e8ac3d'],6,17,23,47290,1,,,,270
d8805bbff4ca3b9ca1d5de674fbcba5f86f45b85,0,Carl Steinbach,2011-09-01 14:27:12-07:00,['80813e712f6dc609dd84dcacaa588b8149836bce'],43,170,213,47503,17,0.833333333,0.333333333,0.770833333,274
f7f9fc62ea560824857a4c08300a2043363ff43b,0,Marcel Kornacker,2011-09-01 17:34:46-07:00,['d8805bbff4ca3b9ca1d5de674fbcba5f86f45b85'],9,5,14,47517,2,1,0,0,274
f546ff79719b035fabd75108792ae14c5a29b2ac,0,Carl Steinbach,2011-09-02 14:58:09-07:00,['f7f9fc62ea560824857a4c08300a2043363ff43b'],3,33,36,47553,1,,,,274
f0acd02db6d81f4f1653e8fcf7e3a5efeab84273,0,Carl Steinbach,2011-09-02 15:34:19-07:00,['f546ff79719b035fabd75108792ae14c5a29b2ac'],0,3,3,47556,1,,,,274
63f9e689c995eff1bb0fc80e2b777b302b75f4a5,1,Marcel Kornacker,2011-09-02 15:37:23-07:00,['f0acd02db6d81f4f1653e8fcf7e3a5efeab84273'],131,521,652,48208,21,0.322580645,0.975806452,0.669354839,278
dec6e263716b3cf179f9898047de620e7b78ce3a,0,Alexander Behm,2011-09-06 15:37:17-07:00,['63f9e689c995eff1bb0fc80e2b777b302b75f4a5'],3,315,318,48526,5,0.203045685,0.766497462,0.421319797,280
95fdaa289d23bdaf7d0b21cc33140cafd850d1c1,1,Marcel Kornacker,2011-09-06 16:21:36-07:00,['dec6e263716b3cf179f9898047de620e7b78ce3a'],244,555,799,49325,42,0.079787234,0.420212766,0.888297872,280
96f7ec781c18403b72e1d9e4fa27815da30da6be,0,Marcel Kornacker,2011-09-08 13:12:41-07:00,['95fdaa289d23bdaf7d0b21cc33140cafd850d1c1'],0,10,10,49335,1,,,,281
79567be9ac1725697ab3fc1062a66a86c53f26a4,1,Marcel Kornacker,2011-09-08 13:56:58-07:00,['96f7ec781c18403b72e1d9e4fa27815da30da6be'],54,432,486,49821,12,0.163636364,0.354545455,0.836363636,282
018c3975b46fad43394265d5397958d5999cc9f1,1,Marcel Kornacker,2011-09-09 16:31:26-07:00,['79567be9ac1725697ab3fc1062a66a86c53f26a4'],201,575,776,50597,49,0.316513761,0.233944954,0.19266055,285
4893baf2634577e0c0e6826692c6a7402770274a,0,Carl Steinbach,2011-09-09 17:34:16-07:00,['018c3975b46fad43394265d5397958d5999cc9f1'],305,1,306,50903,9,,,,286
7b0d8c22182f0fadeb0314297af29c51055efbaa,1,Carl Steinbach,2011-09-12 18:15:15-07:00,['4893baf2634577e0c0e6826692c6a7402770274a'],56,146,202,51105,5,0,1,1,286
58b960b7e68da712a5e1cf391db1d89bfddd022c,1,Carl Steinbach,2011-09-13 18:24:03-07:00,['7b0d8c22182f0fadeb0314297af29c51055efbaa'],3,9,12,51117,2,,,,286
606315513aac3f1b05f732df53a7802e8729441c,1,Marcel Kornacker,2011-09-15 18:18:57-07:00,['58b960b7e68da712a5e1cf391db1d89bfddd022c'],92,766,858,51975,51,0.480620155,0.531007752,0.872093023,291
6e2c757c5c60aabddc768a76f896267673050fc8,1,Carl Steinbach,2011-09-19 11:49:27-07:00,['606315513aac3f1b05f732df53a7802e8729441c'],0,16,16,51991,3,,,,292
0827146a2bb0f7e08c2caee83bde7740936108bb,1,Marcel Kornacker,2011-09-28 09:02:07-07:00,['6e2c757c5c60aabddc768a76f896267673050fc8'],174,924,1098,53089,29,0.35106383,0.590425532,0.771276596,295
b49efb3a8733ffe3d1bbf228639ee25952938adb,1,Carl Steinbach,2011-09-29 15:30:21-07:00,['0827146a2bb0f7e08c2caee83bde7740936108bb'],0,75,75,53164,2,,,,296
d5708b272f1626d8ac8ba4fc90d54b0c2cde5dc5,1,Marcel Kornacker,2011-09-29 22:34:46-07:00,['b49efb3a8733ffe3d1bbf228639ee25952938adb'],20,236,256,53420,17,0.480769231,0.211538462,0.75,297
33166839c7955cce103388d087e3dbbecf98072e,1,Marcel Kornacker,2011-10-17 05:10:21-07:00,['d5708b272f1626d8ac8ba4fc90d54b0c2cde5dc5'],323,663,986,54406,39,0.076923077,0.348717949,0.861538462,299
3b7d5e39809eb992bddba5f47b4ed54a3ea51932,0,Carl Steinbach,2011-10-20 14:22:06-07:00,['33166839c7955cce103388d087e3dbbecf98072e'],0,3356,3356,57762,2,0.255934718,0.270771513,0.255934718,301
84e915bb6e55af49cece86cbe52f28d95cbef0aa,0,Nong Li,2011-11-01 15:36:45-07:00,['3b7d5e39809eb992bddba5f47b4ed54a3ea51932'],23,423,446,58208,9,0.375,0.966346154,0.778846154,303
0914fedea916d277831a805c64c3a212d710a6c5,1,Marcel Kornacker,2011-11-02 14:47:32-07:00,['84e915bb6e55af49cece86cbe52f28d95cbef0aa'],261,637,898,59106,45,0.396694215,0.330578512,0.958677686,305
bfc9824b73914d69d7fd6b8d320c49450cbb2f88,0,Nong Li,2011-11-06 16:27:29-08:00,['0914fedea916d277831a805c64c3a212d710a6c5'],0,1708,1708,60814,2,,,,306
6eda6d19c6ef7c4f9f867775643f5f7bed933014,1,Nong Li,2011-11-06 17:03:33-08:00,['bfc9824b73914d69d7fd6b8d320c49450cbb2f88'],118,1151,1269,62083,35,0.394495413,0.605504587,0.834862385,311
27b29e4568c9afba10c6f2405f4264e752797cb5,1,Nong Li,2011-11-16 15:37:23-08:00,['6eda6d19c6ef7c4f9f867775643f5f7bed933014'],40,339,379,62462,19,0.317535545,0.6492891,0.616113744,311
62177d4d9c2dcb51bb15b25a3d436630fb29c06d,1,Alexander Behm,2011-11-22 15:34:04-08:00,['27b29e4568c9afba10c6f2405f4264e752797cb5'],26,750,776,63238,9,0.147959184,0.803571429,0.928571429,314
a8acd5228112f9c53a9a1800102b6206120faec4,1,Marcel Kornacker,2011-11-22 15:42:32-08:00,['62177d4d9c2dcb51bb15b25a3d436630fb29c06d'],197,662,859,64097,25,0.443089431,0.524390244,0.963414634,316
b1833d4de884e49df741897d9065d45b3f5a6c63,1,Nong Li,2011-11-20 13:44:41-08:00,['a8acd5228112f9c53a9a1800102b6206120faec4'],1122,1491,2613,66710,70,1,1,0,328
ea9d4b94f483fa424f05a4f1645f3e1a4720ab06,0,Nong Li,2011-11-20 14:27:27-08:00,['b1833d4de884e49df741897d9065d45b3f5a6c63'],0,15,15,66725,1,,,,329
44fa92a6392fd4f0353ba9c1099d91557cbe75ca,0,Carl Steinbach,2011-12-06 13:25:18-08:00,['ea9d4b94f483fa424f05a4f1645f3e1a4720ab06'],57,1,58,66783,4,0,0,0.620689655,329
5ae17ad5f933c5801a1f258eab98ef99f9ded053,1,Nong Li,2011-12-06 03:18:30-08:00,['44fa92a6392fd4f0353ba9c1099d91557cbe75ca'],4,40,44,66827,5,0,1,1,329
83d0d9094316873a5c604e8040bfc10c326c4f14,1,Marcel Kornacker,2011-12-08 15:12:58-08:00,['5ae17ad5f933c5801a1f258eab98ef99f9ded053'],196,1143,1339,68166,27,0.205761317,0.329218107,0.283950617,330
c7f7382c31ad15b4b4f3cd264b0514d0ee7a1a87,1,Alexander Behm,2011-12-12 15:14:49-08:00,['83d0d9094316873a5c604e8040bfc10c326c4f14'],97,801,898,69064,29,0.33490566,0.660377358,0.740566038,337
f51ed6a47cfea919d882b1cc82f89bc7a921335d,0,Alexander Behm,2011-12-12 15:37:25-08:00,['c7f7382c31ad15b4b4f3cd264b0514d0ee7a1a87'],10,11,21,69085,2,0,0,0,337
237841737601ae596633be0918d946b670e08a3a,1,Carl Steinbach,2011-12-15 15:50:54-08:00,['f51ed6a47cfea919d882b1cc82f89bc7a921335d'],59,2546,2605,71690,18,0.423529412,0.695588235,0.775,346
482e83a396dda06590f9374d3cd9ac945a5988fd,0,Marcel Kornacker,2011-12-16 13:16:28-08:00,['237841737601ae596633be0918d946b670e08a3a'],9,0,9,71699,3,,,,346
4930632c8d00439ba89256f56c8fa0f20345560d,0,Nong Li,2011-12-19 23:29:59-08:00,['482e83a396dda06590f9374d3cd9ac945a5988fd'],14,14,28,71727,1,,,,346
2880f54d35f7404c47f7f3978de01cb2f9f1a803,1,Nong Li,2011-12-30 00:26:27-08:00,['4930632c8d00439ba89256f56c8fa0f20345560d'],161,18078,18239,89966,48,0.113519092,0.30753354,0.62125903,368
01ff5b842feac4b258c1b15cd90fd9b330cbfa5e,1,Henry Robinson,2012-01-09 17:26:41-08:00,['2880f54d35f7404c47f7f3978de01cb2f9f1a803'],12,105,117,90083,5,0.466666667,1,1,368
c05644561253436ea944d529d7a3310b2ebd3824,1,Marcel Kornacker,2012-01-10 18:00:20-08:00,['01ff5b842feac4b258c1b15cd90fd9b330cbfa5e'],131,1370,1501,91584,42,0.543513957,0.896551724,0.205254516,374
c84fec38d357d6043036864316d4fdc8c9950cf3,1,Nong Li,2011-12-30 19:35:20-08:00,['c05644561253436ea944d529d7a3310b2ebd3824'],229,1644380,1644609,1736193,252,,,,586
94db70c9fd0d1c9ad61526cb7eaa8b73ccac0a74,0,Nong Li,2011-12-30 21:28:18-08:00,['c84fec38d357d6043036864316d4fdc8c9950cf3'],2,11,13,1736206,4,,,,586
bf74bc25e3b74a6a3dff142fde8bc7f06cf28b9e,0,Nong Li,2011-12-31 06:17:28-08:00,['94db70c9fd0d1c9ad61526cb7eaa8b73ccac0a74'],40,43,83,1736289,8,1,1,1,587
e3ae3a582369220fd098399ea0418d615a8e2e69,0,Henry Robinson,2012-01-16 13:59:40-08:00,['bf74bc25e3b74a6a3dff142fde8bc7f06cf28b9e'],0,3,3,1736292,1,,,,587
783480d6bfbf357a321844c9de434294770416f6,1,Nong Li,2012-01-18 23:08:29-08:00,['e3ae3a582369220fd098399ea0418d615a8e2e69'],640,676,1316,1737608,27,1,1,1,592
32e230b2568b26ab04158da1c6fc80a931ad0dd7,0,Henry Robinson,2012-01-30 17:32:12-08:00,['783480d6bfbf357a321844c9de434294770416f6'],0,62,62,1737670,4,,,,595
38b6d6286e85cbf00f06151e5212bcda779649aa,1,Marcel Kornacker,2012-02-01 12:06:55-08:00,['32e230b2568b26ab04158da1c6fc80a931ad0dd7'],559,1645,2204,1739874,71,0.404597701,1,0.664367816,605
ff7e268c6f3884b250b4313061f44df3739c2118,0,Marcel Kornacker,2012-02-01 14:30:09-08:00,['38b6d6286e85cbf00f06151e5212bcda779649aa'],1,1,2,1739876,1,,,,605
352deb82aa9f597432ddca28fb3d3566bb233f5d,0,Michael Ubell,2012-02-06 15:55:40-08:00,['ff7e268c6f3884b250b4313061f44df3739c2118'],7,71,78,1739954,6,0.85,1,1,605
52d95e90fcff2e924af86cf84df18c0ae14579e7,0,Michael Ubell,2012-02-06 16:23:12-08:00,['352deb82aa9f597432ddca28fb3d3566bb233f5d'],1,1,2,1739956,1,,,,605
a607c6c69f53103cbd03b327d9573a7f77dcb84b,1,Marcel Kornacker,2012-02-07 16:05:57-08:00,['52d95e90fcff2e924af86cf84df18c0ae14579e7'],601,801,1402,1741358,37,0.319148936,0.35106383,0.691489362,608
17aa46eb82f8a987a5b6c2135b3d7eb7c270b123,0,Marcel Kornacker,2012-02-07 17:13:54-08:00,['a607c6c69f53103cbd03b327d9573a7f77dcb84b'],0,1,1,1741359,1,,,,608
797bd1ee583d12b72f35482325b37710a7154409,1,Nong Li,2012-01-26 08:40:35-08:00,['17aa46eb82f8a987a5b6c2135b3d7eb7c270b123'],30,292,322,1741681,8,0.471014493,0.644927536,0.797101449,610
aec4f13ddaec9add30587da703d531a76f61457c,1,Marcel Kornacker,2012-02-08 11:14:55-08:00,['797bd1ee583d12b72f35482325b37710a7154409'],50,47,97,1741778,12,0,0.333333333,0.666666667,610
6a57a1d879a1bbb3ae52fa951c2efc512f4ebc84,1,Marcel Kornacker,2012-02-10 10:53:40-08:00,['aec4f13ddaec9add30587da703d531a76f61457c'],23,395,418,1742196,13,0.49375,0.73125,1,612
a078d0abcf3beb150b024b91c667f9e6b7794c4a,0,Nong Li,2012-02-10 13:24:33-08:00,['6a57a1d879a1bbb3ae52fa951c2efc512f4ebc84'],0,1,1,1742197,1,,,,612
e120233fb43bea271f2958e0b72e723f9e247e5c,0,Nong Li,2012-02-14 16:18:21-08:00,['a078d0abcf3beb150b024b91c667f9e6b7794c4a'],131,377,508,1742705,4,0.292207792,0.590909091,0.928571429,612
88237350f093d96c98729585faa70204feb413c5,0,Nong Li,2012-02-17 18:14:04-08:00,['e120233fb43bea271f2958e0b72e723f9e247e5c'],42,84,126,1742831,16,0,0,1,612
36129bca7685dcf4f7be12d657981b707c457a93,0,Henry Robinson,2012-02-20 23:21:06-08:00,['88237350f093d96c98729585faa70204feb413c5'],0,0,0,1742831,0,,,,612
518ebece37696ceb51c6c3d19f19de16fd72a073,0,Henry Robinson,2012-02-20 23:21:08-08:00,['36129bca7685dcf4f7be12d657981b707c457a93'],0,0,0,1742831,0,,,,612
09dd1c2ecdbef62cd621c30197d86aac1281d2d2,0,Henry Robinson,2012-02-20 23:21:12-08:00,['518ebece37696ceb51c6c3d19f19de16fd72a073'],0,0,0,1742831,0,,,,612
f2a602ea9d7774a13c5866ad294e2aaee677ae62,0,Henry Robinson,2012-02-21 14:32:51-08:00,['09dd1c2ecdbef62cd621c30197d86aac1281d2d2'],59,125,184,1743015,6,,,,613
6260989cd89664c8039535f7f44128b7e21b3a98,0,Henry Robinson,2012-02-21 14:32:52-08:00,['f2a602ea9d7774a13c5866ad294e2aaee677ae62'],3,3,6,1743021,2,,,,613
a0d7b3731e92c2128140b4a0c8d7bf3dad5ba614,0,Henry Robinson,2012-02-21 14:32:54-08:00,['6260989cd89664c8039535f7f44128b7e21b3a98'],0,11,11,1743032,3,,,,614
8eb9315c61fecebb5b7916531c16ae64e335af27,0,Henry Robinson,2012-02-21 14:32:54-08:00,['a0d7b3731e92c2128140b4a0c8d7bf3dad5ba614'],74,74,148,1743180,3,,,,614
8c1f59229501301d6ddc043fa213c7f349e94001,0,Henry Robinson,2012-02-21 14:32:54-08:00,['8eb9315c61fecebb5b7916531c16ae64e335af27'],86,85,171,1743351,2,,,,614
9c8fd1f82dfd6843e282451bf6a89234ce792192,0,Henry Robinson,2012-02-21 14:32:54-08:00,['8c1f59229501301d6ddc043fa213c7f349e94001'],2,2,4,1743355,1,,,,614
61b59c3390611b82e7f7f79d7e623ada978ce167,0,Henry Robinson,2012-02-21 14:32:55-08:00,['9c8fd1f82dfd6843e282451bf6a89234ce792192'],9,11,20,1743375,1,,,,614
ac03a01be2dd27c69d7031de4429b77ea62f23b2,0,Henry Robinson,2012-02-21 15:30:24-08:00,['61b59c3390611b82e7f7f79d7e623ada978ce167'],0,6,6,1743381,1,,,,614
563d5e3f71ca8b801851a47dfd809341f546fbd1,1,Nong Li,2012-02-22 13:22:32-08:00,['ac03a01be2dd27c69d7031de4429b77ea62f23b2'],25,112,137,1743518,9,0.677419355,0,0.935483871,614
c9aeea33015f067a35f6bf31af35c47179c7bc8c,1,Alan Choi,2012-02-23 13:11:03-08:00,['563d5e3f71ca8b801851a47dfd809341f546fbd1'],9,30,39,1743557,3,0.333333333,0.333333333,1,614
c8978f8c70d5082564b40de342e7ee527f83fadb,0,Nong Li,2012-02-24 14:53:42-08:00,['c9aeea33015f067a35f6bf31af35c47179c7bc8c'],5,5,10,1743567,2,,,,614
a10a7630d3da74501940e0cc4728a97a31050eb9,0,Alan Choi,2012-02-24 18:11:00-08:00,['c8978f8c70d5082564b40de342e7ee527f83fadb'],27,63,90,1743657,6,0,0.952380952,0.952380952,614
154309deba3d8768bd9980e4c292fcf9a028d430,0,Henry Robinson,2012-02-26 16:51:59-08:00,['a10a7630d3da74501940e0cc4728a97a31050eb9'],1,1,2,1743659,1,,,,614
3cb9236748c81b4d0aa360b482a3f39e63fbfdc8,0,Henry Robinson,2012-02-27 13:53:36-08:00,['154309deba3d8768bd9980e4c292fcf9a028d430'],26,0,26,1743685,1,,,,614
0e57932e6804a99447935d85ac18aec04607c6bf,0,Alexander Behm,2012-02-27 14:51:11-08:00,['3cb9236748c81b4d0aa360b482a3f39e63fbfdc8'],3,11,14,1743699,2,,,,614
b62c39044522866344a0383afc4971f45be6be2d,0,Alan Choi,2012-02-27 18:29:34-08:00,['0e57932e6804a99447935d85ac18aec04607c6bf'],2,209,211,1743910,7,,,,614
eeae4ea02dfe96d10053812c4eaf9ba8e5666035,0,Alexander Behm,2012-02-28 12:39:00-08:00,['b62c39044522866344a0383afc4971f45be6be2d'],18,64,82,1743992,3,0.375,1,0.53125,614
e514b1a5f926767b253d44536157c36e129fdc5f,0,Michael Ubell,2012-02-28 14:09:58-08:00,['eeae4ea02dfe96d10053812c4eaf9ba8e5666035'],12,18,30,1744022,2,,,,614
e1432af659a868cc193e52601b2c4a239e8f610c,0,Marcel Kornacker,2012-02-29 08:10:53-08:00,['e514b1a5f926767b253d44536157c36e129fdc5f'],4,4,8,1744030,1,,,,614
c50b80814db8ae3b7f75da2060d9e98604f8afae,0,Marcel Kornacker,2012-02-29 08:10:54-08:00,['e1432af659a868cc193e52601b2c4a239e8f610c'],0,0,0,1744030,0,,,,614
d4aa115876ead11be1c3c3027f92d2e3eeadd6ef,0,Marcel Kornacker,2012-02-29 08:10:54-08:00,['c50b80814db8ae3b7f75da2060d9e98604f8afae'],3,3,6,1744036,2,,,,614
17f7b16da8da7140725757f2921791306408f12d,0,Nong Li,2012-03-01 10:47:34-08:00,['d4aa115876ead11be1c3c3027f92d2e3eeadd6ef'],52,67,119,1744155,2,0,0,1,614
099069979eff04dcae93c5e6332edc82bf60f1ee,0,Henry Robinson,2012-03-01 11:09:03-08:00,['17f7b16da8da7140725757f2921791306408f12d'],18,0,18,1744173,1,,,,614
b410b627162ce831ef9f1173ce3d6e93b50afe97,1,Nong Li,2012-03-01 13:59:17-08:00,['099069979eff04dcae93c5e6332edc82bf60f1ee'],55,903,958,1745131,42,0.293838863,0.751184834,0.81042654,619
a780ffdcb325f3114e58d7f6947ac8df7ad9b8cd,1,Marcel Kornacker,2012-03-02 12:27:27-08:00,['b410b627162ce831ef9f1173ce3d6e93b50afe97'],459,925,1384,1746515,37,0.339285714,0.776785714,1,628
bacee81c5a6a8d0080aded89188bbcc8dc659aa2,1,Alexander Behm,2012-03-06 16:37:58-08:00,['a780ffdcb325f3114e58d7f6947ac8df7ad9b8cd'],1,875,876,1747391,8,0.424679487,0.774038462,0.850961538,628
727ee77ec44c12d561b04bad5991b75392b592ff,0,Alan Choi,2012-03-08 15:07:12-08:00,['bacee81c5a6a8d0080aded89188bbcc8dc659aa2'],37,127,164,1747555,12,,,,635
4a4a07fde70e5afdf1e425860f2cf6ca1649c59c,1,Marcel Kornacker,2012-03-08 16:19:47-08:00,['727ee77ec44c12d561b04bad5991b75392b592ff'],430,572,1002,1748557,17,,,,637
fb9532eacc171fc4c223e46eceea7c66dec4bfe9,1,Alan Choi,2012-03-12 16:34:33-07:00,['4a4a07fde70e5afdf1e425860f2cf6ca1649c59c'],46,288,334,1748891,6,0.598425197,0.283464567,1,637
be522a29cdb699ded23df580ff12bdb4f4140d6d,0,Marcel Kornacker,2012-03-12 18:18:09-07:00,['fb9532eacc171fc4c223e46eceea7c66dec4bfe9'],32,34,66,1748957,5,1,1,0,637
5d5333c2284720befa8f1f183339f5ee8bf16534,0,Marcel Kornacker,2012-03-13 11:53:12-07:00,['be522a29cdb699ded23df580ff12bdb4f4140d6d'],32,32,64,1749021,3,,,,637
0726a5480cc45d14e0092184e1d28490ecf04b4c,0,Nong Li,2012-02-29 10:02:34-08:00,['5d5333c2284720befa8f1f183339f5ee8bf16534'],0,2274,2274,1751295,1,0.291518175,0.409836066,0.769066287,638
ee9c09026d96ece903bf8d00e2e4e2b97994e8df,1,Alan Choi,2012-03-15 18:18:36-07:00,['0726a5480cc45d14e0092184e1d28490ecf04b4c'],1320,2137,3457,1754752,21,0.31372549,0.68627451,0.607843137,638
4d93992191413bbc484944677dd8841adedffedd,0,Nong Li,2012-03-01 17:41:54-08:00,['ee9c09026d96ece903bf8d00e2e4e2b97994e8df'],3,2,5,1754757,1,0,0,0,638
cb7f77e64c72ca2f7eef6c54c32780c02631570d,1,Alexander Behm,2012-03-19 13:23:45-07:00,['4d93992191413bbc484944677dd8841adedffedd'],33,660,693,1755450,13,0.165271967,0.493723849,0.979079498,638
0b076ddac31c974af269c8682719f903862303c6,0,Henry Robinson,2012-03-21 10:21:14-07:00,['cb7f77e64c72ca2f7eef6c54c32780c02631570d'],17,32,49,1755499,8,0,0,0.5,638
3bf96b645850cf4b7c3e965fd5cbf5d5490de25f,1,Henry Robinson,2012-03-22 16:36:45-07:00,['0b076ddac31c974af269c8682719f903862303c6'],2058,2254,4312,1759811,22,1,1,0,649
8897169c870a9aa1928b169a18466854e24f2ad0,1,Michael Ubell,2012-03-22 21:38:18-07:00,['3bf96b645850cf4b7c3e965fd5cbf5d5490de25f'],1454,2563,4017,1763828,56,0.538860104,0.829015544,0.904145078,654
a8df20524831e1d015f118e71e59aff46f59a6f7,0,Henry Robinson,2012-03-26 18:30:37-07:00,['8897169c870a9aa1928b169a18466854e24f2ad0'],1,43,44,1763872,3,,,,655
4be1d8478222e67c79ce33e0a9a036a363b08bbb,1,Alexander Behm,2012-03-26 22:24:53-07:00,['a8df20524831e1d015f118e71e59aff46f59a6f7'],0,661,661,1764533,9,0.042394015,0.516209476,0.693266833,657
07dc8f38f135f725520de733742b2f94e6961d33,0,Henry Robinson,2012-03-27 15:52:18-07:00,['4be1d8478222e67c79ce33e0a9a036a363b08bbb'],0,5,5,1764538,2,1,1,1,657
ec9eb80721a0d7a12a563cf8cc4bff8bd3c09d9a,0,Henry Robinson,2012-03-28 11:36:42-07:00,['07dc8f38f135f725520de733742b2f94e6961d33'],11,17,28,1764566,1,0,0,0,657
1bf7c1e748cb55068ee0ba5ef77553de4a525500,0,Henry Robinson,2012-03-29 16:18:46-07:00,['ec9eb80721a0d7a12a563cf8cc4bff8bd3c09d9a'],12,24,36,1764602,1,0,0,0,657
cf9cbfe996a9d9c6c3576a2b2bb9adba32e5c1c2,1,Alexander Behm,2012-04-03 14:22:52-07:00,['1bf7c1e748cb55068ee0ba5ef77553de4a525500'],47,800,847,1765449,19,0.221973094,0.432735426,0.948430493,659
efcf7abea6591131facac0a2effe4048b67efcb4,0,Henry Robinson,2012-04-03 19:17:34-07:00,['cf9cbfe996a9d9c6c3576a2b2bb9adba32e5c1c2'],0,0,0,1765449,0,,,,659
31d36ee2d37b9d24a16854746534fee8e9b93688,0,Nong Li,2012-04-04 13:56:43-07:00,['efcf7abea6591131facac0a2effe4048b67efcb4'],35,35,70,1765519,10,1,1,1,659
511b31e70a202d5b1b36fd29e46ac49ecac64d65,0,Henry Robinson,2012-04-04 15:57:20-07:00,['31d36ee2d37b9d24a16854746534fee8e9b93688'],29,98,127,1765646,4,0.909090909,0.909090909,1,660
bd9d5fe7a86b95222ac2672daa6adfa31c12caa5,1,Alan Choi,2012-04-04 21:26:49-07:00,['511b31e70a202d5b1b36fd29e46ac49ecac64d65'],78,169,247,1765893,8,0,0.826923077,0.903846154,660
799590854df484c36140a2040a11c0396b5c530a,1,Marcel Kornacker,2012-04-06 13:14:00-07:00,['bd9d5fe7a86b95222ac2672daa6adfa31c12caa5'],387,1329,1716,1767609,31,0.301639344,0.636065574,0.557377049,664
58b6e3574a0840be5fc2196cb7a45bc31e7f0d5a,1,Nong Li,2012-04-11 12:29:02-07:00,['799590854df484c36140a2040a11c0396b5c530a'],68,203,271,1767880,5,0,0.322580645,0.870967742,664
e6ecf98640a377aaa32b0d380cb9a39fe7453059,0,Nong Li,2012-04-12 12:49:57-07:00,['58b6e3574a0840be5fc2196cb7a45bc31e7f0d5a'],0,9,9,1767889,1,,,,664
1dc8ee78ee12f04cc2411aff70951d415fc5a02c,1,Nong Li,2012-04-12 14:50:39-07:00,['e6ecf98640a377aaa32b0d380cb9a39fe7453059'],195,3600,3795,1771684,65,0.253731343,0.487009397,0.821448314,678
73037cb6b9cecf138b282e87b0a5ca2f57c87236,0,Nong Li,2012-04-12 16:41:25-07:00,['1dc8ee78ee12f04cc2411aff70951d415fc5a02c'],17,31,48,1771732,3,,,,678
92673b7852552f9d513438857c8e678cc6fc3794,0,Henry Robinson,2012-04-12 16:59:52-07:00,['73037cb6b9cecf138b282e87b0a5ca2f57c87236'],51,105,156,1771888,4,,,,678
089d1d86eb3f5dd854c3e2aac3e9fd28c736c812,0,Henry Robinson,2012-04-12 17:00:03-07:00,['92673b7852552f9d513438857c8e678cc6fc3794'],4,10,14,1771902,1,0,1,1,678
75f351fd8dc80f93c63b1f8e1fc9ba254837bd31,0,Nong Li,2012-04-12 17:44:35-07:00,['089d1d86eb3f5dd854c3e2aac3e9fd28c736c812'],1,1,2,1771904,1,,,,678
aed3bb8b3ef3408930d96cbb471d8e10f670b2db,1,Alan Choi,2012-04-13 14:56:32-07:00,['75f351fd8dc80f93c63b1f8e1fc9ba254837bd31'],125,2056,2181,1774085,20,0.396600567,0.934844193,0.980169972,683
349d6688fc9c9aa0427d5e9812581cd03db013fc,1,Alan Choi,2012-04-17 14:37:22-07:00,['aed3bb8b3ef3408930d96cbb471d8e10f670b2db'],150,227,377,1774462,7,1,1,0,683
2b119d552e251e3b7d2c1653182d89095131f0c3,1,Nong Li,2012-04-18 16:57:13-07:00,['349d6688fc9c9aa0427d5e9812581cd03db013fc'],286,453,739,1775201,30,0,1,1,683
857cac81193d44173d7a29786a4e6db83e3b11a2,1,Henry Robinson,2012-04-19 15:18:32-07:00,['2b119d552e251e3b7d2c1653182d89095131f0c3'],362,458,820,1776021,19,1,0.647058824,0.882352941,683
f2ddd7bb73468a48d160993b94acd968afb8c0fb,1,Nong Li,2012-04-23 11:17:21-07:00,['857cac81193d44173d7a29786a4e6db83e3b11a2'],89,362,451,1776472,11,0.158940397,0.78807947,0.668874172,686
c32f83aaea0b1364c8983a6735445dd5924fb1f3,0,Alan Choi,2012-04-25 14:45:48-07:00,['f2ddd7bb73468a48d160993b94acd968afb8c0fb'],93,627,720,1777192,23,0,0,0.37254902,686
98402f6f309486322fe30d2f49b6b0d70ebf7039,0,Alan Choi,2012-04-25 18:50:01-07:00,['c32f83aaea0b1364c8983a6735445dd5924fb1f3'],0,31,31,1777223,2,0,1,1,686
e0e686c75f81362539eddd850eb9a776104039ba,0,Nong Li,2012-04-26 15:48:52-07:00,['98402f6f309486322fe30d2f49b6b0d70ebf7039'],2,4,6,1777229,1,0,0,0,686
b11d5a82b3890489884c0cd5726c6654d9e8c6c8,0,Michael Ubell,2012-04-27 17:48:06-07:00,['e0e686c75f81362539eddd850eb9a776104039ba'],0,0,0,1777229,0,,,,686
8bb82f7e2a470d09fa8c9e413da006b3c3386c15,0,Michael Ubell,2012-05-01 17:47:55-07:00,['b11d5a82b3890489884c0cd5726c6654d9e8c6c8'],0,0,0,1777229,0,,,,686
62d29ff1c6b798e9f0062efa05dba7e51fb5e102,1,Michael Ubell,2012-05-01 17:48:24-07:00,['8bb82f7e2a470d09fa8c9e413da006b3c3386c15'],1619,4958,6577,1783806,49,0.205882353,0.473529412,0.466176471,696
7b14187bf19dce10b79c0e7cd006a806c1c561b5,0,Michael Ubell,2012-05-02 07:31:10-07:00,['62d29ff1c6b798e9f0062efa05dba7e51fb5e102'],238,740,978,1784784,17,,,,698
a0d3b59aa61d20e1fdb6b9666a5c1110490810a5,1,Michael Ubell,2012-05-02 07:31:53-07:00,['7b14187bf19dce10b79c0e7cd006a806c1c561b5'],165,168,333,1785117,24,0,0,0.25,698
65cae17ef6e25204000794b910beba4bb468d97e,0,Michael Ubell,2012-05-02 13:33:42-07:00,['a0d3b59aa61d20e1fdb6b9666a5c1110490810a5'],1,2,3,1785120,1,,,,698
156c32e153b5f6d645143d2ee5de637b309b8e94,0,Michael Ubell,2012-05-02 14:27:58-07:00,['65cae17ef6e25204000794b910beba4bb468d97e'],13,8,21,1785141,5,,,,698
6efd19bd2609e1e2ae3bce3b217830f1f816867d,0,Michael Ubell,2012-05-02 16:38:56-07:00,['156c32e153b5f6d645143d2ee5de637b309b8e94'],1,2,3,1785144,1,0,1,0,698
81809f908b0097afdfd645bb1bf38742f9d50044,0,Michael Ubell,2012-05-02 21:21:42-07:00,['6efd19bd2609e1e2ae3bce3b217830f1f816867d'],0,12,12,1785156,1,,,,698
5e7f7b8bb792dcd62cd921273f1d51d8acd7aa1c,1,Henry Robinson,2012-05-03 09:47:10-07:00,['81809f908b0097afdfd645bb1bf38742f9d50044'],75,112,187,1785343,13,1,1,1,698
2af14392a60b7a14e2d3b98226b37c12a85d3e02,1,Henry Robinson,2012-05-03 13:44:32-07:00,['5e7f7b8bb792dcd62cd921273f1d51d8acd7aa1c'],357,2120,2477,1787820,62,0.281481481,0.631111111,0.712592593,706
2bbd4193a15757021c85f74dc99fce1fb2db180e,0,Henry Robinson,2012-05-03 17:15:16-07:00,['2af14392a60b7a14e2d3b98226b37c12a85d3e02'],7,10,17,1787837,2,,,,706
ac469ec4756dfea08be88fe970e579f44d284b02,0,Nong Li,2012-05-04 13:38:49-07:00,['2bbd4193a15757021c85f74dc99fce1fb2db180e'],25,19,44,1787881,4,1,0,1,706
97f9212659ab363f5d97929d7af10e9ba7410e7b,0,Nong Li,2012-05-04 13:47:46-07:00,['ac469ec4756dfea08be88fe970e579f44d284b02'],289,85,374,1788255,9,,,,706
bd2c63b69b9a147a34705a53180c679860622680,0,Lenni Kuff,2012-05-08 16:06:45-07:00,['97f9212659ab363f5d97929d7af10e9ba7410e7b'],143,827,970,1789225,18,0.824,0.928,0.816,720
0c5a2649119e07e517a9260ed781bf6f5b434bab,1,Nong Li,2012-05-10 16:52:46-07:00,['bd2c63b69b9a147a34705a53180c679860622680'],75,92,167,1789392,2,1,0,0,720
d0910320c4318289baf3179bd777e86a1828b8ed,0,Alan Choi,2012-05-10 17:25:58-07:00,['0c5a2649119e07e517a9260ed781bf6f5b434bab'],58,159,217,1789609,12,0.677419355,1,0.258064516,722
1dc09ce942242caa433047cb90e473c1a0e68409,1,Michael Ubell,2012-05-11 07:18:31-07:00,['d0910320c4318289baf3179bd777e86a1828b8ed'],444,1092,1536,1791145,21,0.276315789,0.407894737,0.266447368,727
e091dca5af96f9c594b068302ba2538d091169a6,0,Michael Ubell,2012-05-14 15:42:16-07:00,['1dc09ce942242caa433047cb90e473c1a0e68409'],1,9,10,1791155,2,,,,727
2f4f3a46a687489b4c0e7e1fc508ff9fde1f3ef6,0,Nong Li,2012-05-16 10:41:42-07:00,['e091dca5af96f9c594b068302ba2538d091169a6'],58,74,132,1791287,2,,,,728
09f69dfa7289def408eebd1f8c430358b9c67ab4,1,Nong Li,2012-05-17 13:43:09-07:00,['2f4f3a46a687489b4c0e7e1fc508ff9fde1f3ef6'],2,795,797,1792084,9,0.342158859,0.617107943,0.885947047,734
35951643f552b3fb82f0eb79bcd87b2d58389688,0,Lenni Kuff,2012-05-17 17:40:00-07:00,['09f69dfa7289def408eebd1f8c430358b9c67ab4'],78,114,192,1792276,12,1,0,0,734
ffb46722c330227a52479e81b3a0ef55acd57cc5,1,Henry Robinson,2012-05-17 17:57:10-07:00,['35951643f552b3fb82f0eb79bcd87b2d58389688'],20,44,64,1792340,11,0.166666667,0.333333333,0.5,734
47d06994160ae66dd104024c563479916b72526a,0,Henry Robinson,2012-05-18 12:15:10-07:00,['ffb46722c330227a52479e81b3a0ef55acd57cc5'],73,265,338,1792678,2,0.833333333,1,0.115384615,734
3c26a337f28a5acc370666adf977ef39366a9b13,1,Alan Choi,2012-05-18 15:39:13-07:00,['47d06994160ae66dd104024c563479916b72526a'],9,71,80,1792758,4,1,1,0,734
6ad22ec7dfee8aa6ea8c81914bc202be03a9d3e3,0,Nong Li,2012-05-18 16:08:05-07:00,['3c26a337f28a5acc370666adf977ef39366a9b13'],6,1,7,1792765,2,,,,734
42c1f7b104e7497a8c82e9b63902642f1a51b5bc,0,Nong Li,2012-05-21 11:48:59-07:00,['6ad22ec7dfee8aa6ea8c81914bc202be03a9d3e3'],1,1,2,1792767,1,,,,734
0227ea88683daa852e20ca2649827fb23913a9ab,1,Marcel Kornacker,2012-05-21 12:00:21-07:00,['42c1f7b104e7497a8c82e9b63902642f1a51b5bc'],258,1126,1384,1794151,37,0.218181818,0.460606061,0.860606061,745
344c171c6a0e899d14580e708113ec97d0e88149,1,Nong Li,2012-05-21 14:47:57-07:00,['0227ea88683daa852e20ca2649827fb23913a9ab'],516,1505,2021,1796172,68,0.251091703,0.318777293,0.919213974,750
4029b7cd4ccc5ec3cd3ac23ae741392abc15d3dc,0,Henry Robinson,2012-05-22 13:41:31-07:00,['344c171c6a0e899d14580e708113ec97d0e88149'],11,15,26,1796198,2,0,0,1,750
3402bc48eb196694b3d129a03849cf9130aed5b0,1,Nong Li,2012-05-22 16:17:27-07:00,['4029b7cd4ccc5ec3cd3ac23ae741392abc15d3dc'],168,876,1044,1797242,25,0.219745223,0.73566879,0.914012739,754
0198b2b18ca139c7d1fa9c3fb818f2c936e531a2,1,Michael Ubell,2012-05-22 16:43:34-07:00,['3402bc48eb196694b3d129a03849cf9130aed5b0'],67,577,644,1797886,17,0,0.814814815,0.925925926,754
a3eef52f9f96349119e6d029f36bc3ff706d18ab,0,Lenni Kuff,2012-05-22 17:02:57-07:00,['0198b2b18ca139c7d1fa9c3fb818f2c936e531a2'],1,2,3,1797889,1,,,,754
3608b3fb068b22e6f74ef6ebbaf35fe207d56815,1,Michael Ubell,2012-05-22 20:37:47-07:00,['a3eef52f9f96349119e6d029f36bc3ff706d18ab'],934,1328,2262,1800151,31,0,0.888888889,1,754
a9c7ee7f674a4eba49d2a9857ebde308b09cbcef,1,Marcel Kornacker,2012-05-06 15:38:49-07:00,['3608b3fb068b22e6f74ef6ebbaf35fe207d56815'],13,22,35,1800186,3,0.75,0.75,1,754
f42d459c26bb2ecc92e81a97661b02feee6be88a,1,Henry Robinson,2012-05-23 22:04:08-07:00,['a9c7ee7f674a4eba49d2a9857ebde308b09cbcef'],34,168,202,1800388,4,0.455882353,0.691176471,0.882352941,754
97a752d211a7ec3b32047563591034438d77ba5f,1,Alexander Behm,2012-05-29 00:08:30-07:00,['f42d459c26bb2ecc92e81a97661b02feee6be88a'],225,966,1191,1801579,18,0.236180905,0.753768844,0.969849246,756
942ebd3d5d1fad762e7d9808aaf7d801f52f64fa,0,Nong Li,2012-05-29 11:04:30-07:00,['97a752d211a7ec3b32047563591034438d77ba5f'],1,10,11,1801590,2,1,1,1,756
def56dbfa46336bc28e1a781b3ef16c28b5b9a6a,1,Nong Li,2012-05-29 11:08:43-07:00,['942ebd3d5d1fad762e7d9808aaf7d801f52f64fa'],24,41,65,1801655,5,1,1,1,757
0bf2c2a41429cffa56765b057077b9d5810948a2,1,Nong Li,2012-05-29 14:26:15-07:00,['def56dbfa46336bc28e1a781b3ef16c28b5b9a6a'],147,197,344,1801999,5,0,0.192307692,0,758
31e406badf5f29453df42c4953040b46c4264151,1,Michael Ubell,2012-05-30 12:37:08-07:00,['0bf2c2a41429cffa56765b057077b9d5810948a2'],388,418,806,1802805,5,0,1,1,759
4f95f58b0ac60dcc81632a00748d989df3d215ec,0,Lenni Kuff,2012-05-31 07:44:01-07:00,['31e406badf5f29453df42c4953040b46c4264151'],18,100,118,1802923,13,0.85,0.85,1,759
406b2c6b1f252283b1b5a52454bfb20c5bb1eb0f,0,Kay Ousterhout,2012-06-01 11:01:58-07:00,['4f95f58b0ac60dcc81632a00748d989df3d215ec'],20,31,51,1802974,10,,,,760
f9efe06649b4584857ad0c5c2009a6b3bd1029cc,0,Nong Li,2012-06-01 13:14:18-07:00,['406b2c6b1f252283b1b5a52454bfb20c5bb1eb0f'],3,4,7,1802981,5,,,,760
1abe6c973ad8df0ae0bd0fe0f9285a876e063004,1,Lenni Kuff,2012-06-01 14:20:29-07:00,['f9efe06649b4584857ad0c5c2009a6b3bd1029cc'],6,39,45,1803026,3,,,,760
d4396801f17e85c4df50a1141e0d41f4f09e4808,0,Lenni Kuff,2012-06-01 16:31:15-07:00,['1abe6c973ad8df0ae0bd0fe0f9285a876e063004'],180,250,430,1803456,11,0.878787879,0.878787879,0.272727273,760
6c2beaf37eb1c45a54a0af51642ae6fd11baea0b,1,Nong Li,2012-06-01 17:32:25-07:00,['d4396801f17e85c4df50a1141e0d41f4f09e4808'],633,1599,2232,1805688,52,0.189292543,0.500956023,1,761
9f4a5ffb7488fcbcac68dd85dab1d707e7ba67b8,1,Lenni Kuff,2012-06-04 11:19:29-07:00,['6c2beaf37eb1c45a54a0af51642ae6fd11baea0b'],6,16,22,1805710,1,,,,761
4a4a67ef7457230a15d6783567b6d0457246340b,0,Michael Ubell,2012-06-04 15:51:06-07:00,['9f4a5ffb7488fcbcac68dd85dab1d707e7ba67b8'],2,2,4,1805714,1,,,,761
3b52437a3cbcaa4230989cba322652a86ab17ae6,0,Michael Ubell,2012-06-05 06:37:08-07:00,['4a4a67ef7457230a15d6783567b6d0457246340b'],30,21,51,1805765,5,1,1,1,761
3ff35598056c810d37fce96ebd7ed72d19a7a8ed,1,Henry Robinson,2012-06-05 12:00:09-07:00,['3b52437a3cbcaa4230989cba322652a86ab17ae6'],1026,1230,2256,1808021,53,1,1,1,768
6d1720e669dc244a43f25dc4614b93adfe1cc754,0,Lenni Kuff,2012-06-05 16:40:22-07:00,['3ff35598056c810d37fce96ebd7ed72d19a7a8ed'],81,9,90,1808111,3,0.490196078,0,0,768
53c5acd70c8917e6c318df2694bde75b8946ebd0,1,Nong Li,2012-06-05 17:10:10-07:00,['6d1720e669dc244a43f25dc4614b93adfe1cc754'],107,529,636,1808747,20,0.142259414,0.970711297,0.707112971,770
580e4c4cbc930f6e57ef29aebc4d71aa43952746,1,Nong Li,2012-06-05 18:05:14-07:00,['53c5acd70c8917e6c318df2694bde75b8946ebd0'],95,289,384,1809131,9,0.25,0.090909091,0.147727273,771
7af87c7dea8b9e8f98715e5494def4afc91f06b9,1,Alan Choi,2012-06-06 10:08:06-07:00,['580e4c4cbc930f6e57ef29aebc4d71aa43952746'],217,677,894,1810025,14,1,1,0.552845528,772
dde9e67799ba6e32e160e41190c03e8eddb79951,0,Lenni Kuff,2012-06-06 11:01:08-07:00,['7af87c7dea8b9e8f98715e5494def4afc91f06b9'],1,1,2,1810027,1,,,,772
9a738cc48e34ff3df3583302bc5dd7a59261098c,1,Michael Ubell,2012-06-06 14:25:43-07:00,['dde9e67799ba6e32e160e41190c03e8eddb79951'],269,400,669,1810696,15,1,1,0.5,776
f6dbbfe748db6b843d9b7d1984d85712b518f8f6,1,Kay Ousterhout,2012-06-09 22:36:32-07:00,['9a738cc48e34ff3df3583302bc5dd7a59261098c'],7,6,13,1810709,1,1,0,0,776
eb2a09ed4a853527092f4b6a702010334b467dec,1,Henry Robinson,2012-06-12 12:22:31-07:00,['f6dbbfe748db6b843d9b7d1984d85712b518f8f6'],200,368,568,1811277,13,0.583333333,1,1,778
dab460eb21ec9cdb85219a600ca480071c5035be,1,Marcel Kornacker,2012-06-12 13:24:09-07:00,['eb2a09ed4a853527092f4b6a702010334b467dec'],57,73,130,1811407,10,0.555555556,0.444444444,0.888888889,778
1554930072b70a0b3a8778a6deac8bfc4f0203ce,1,Nong Li,2012-06-12 14:47:03-07:00,['dab460eb21ec9cdb85219a600ca480071c5035be'],13,57,70,1811477,4,0,0.5,0.5,778
e7df0160c236ea8c69af6a84d6f87f409f781c4b,0,Michael Ubell,2012-06-12 14:48:00-07:00,['1554930072b70a0b3a8778a6deac8bfc4f0203ce'],3,3,6,1811483,1,,,,778
642ff640131bb3ab9be5cf30f7ce3583051cd2c6,1,Marcel Kornacker,2012-06-12 17:47:23-07:00,['e7df0160c236ea8c69af6a84d6f87f409f781c4b'],30,33,63,1811546,6,1,1,1,778
0e844e71871921af08932fe6ea7b557feb8fc941,0,Lenni Kuff,2012-06-12 17:52:27-07:00,['642ff640131bb3ab9be5cf30f7ce3583051cd2c6'],45,77,122,1811668,1,,,,778
9a0433eebd6987cf00f05239e7b9b4fc327d4157,1,Michael Ubell,2012-06-14 07:37:34-07:00,['0e844e71871921af08932fe6ea7b557feb8fc941'],4,76,80,1811748,6,0,1,0.931034483,778
ef10afa439354493a0429f90c3d51f838c75c2ac,0,Alan Choi,2012-06-14 18:21:08-07:00,['9a0433eebd6987cf00f05239e7b9b4fc327d4157'],26,45,71,1811819,11,0,1,1,779
a1a4cf4ffdc7bf6441079ddf143aff37fa70da4d,1,Nong Li,2012-06-15 15:05:12-07:00,['ef10afa439354493a0429f90c3d51f838c75c2ac'],76,74,150,1811969,22,0.75,0,0.5,779
fa280e6c89ebdd947ad19e735601ab0ae8fc9d1c,0,Nong Li,2012-06-15 15:15:41-07:00,['a1a4cf4ffdc7bf6441079ddf143aff37fa70da4d'],14,37,51,1812020,3,0,0,0,779
f52286f72cd4404d5fd8c5c6c7009e2c56022ede,0,Alan Choi,2012-06-18 14:46:46-07:00,['fa280e6c89ebdd947ad19e735601ab0ae8fc9d1c'],256,422,678,1812698,26,0.078947368,0.50877193,0.833333333,780
b65b507ed6977798fe4a669fe17fd7a2b4a3a7d9,1,Nong Li,2012-06-19 13:12:43-07:00,['f52286f72cd4404d5fd8c5c6c7009e2c56022ede'],309,1170,1479,1814177,23,0.376753507,0.771543086,0.779559118,784
876f98da06f4341ef7f1c01906894494a236b623,1,Alexander Behm,2012-06-20 00:05:01-07:00,['b65b507ed6977798fe4a669fe17fd7a2b4a3a7d9'],54,1665,1719,1815896,7,0.345679012,0.240740741,0.666666667,786
54f0cd79b8a58695240a8830d9cf0f1e84674a13,0,Lenni Kuff,2012-06-20 14:24:42-07:00,['876f98da06f4341ef7f1c01906894494a236b623'],10,45,55,1815951,1,0.217391304,1,1,786
6f25153f33e8cb452da3c73b94424e9fb145d736,1,Henry Robinson,2012-06-21 23:06:41-07:00,['54f0cd79b8a58695240a8830d9cf0f1e84674a13'],85,231,316,1816267,12,0.53030303,0.53030303,0.818181818,789
2598450ae1f32b79d72d27f38b1a91bc7f63e453,0,Kay Ousterhout,2012-06-22 08:52:49-07:00,['6f25153f33e8cb452da3c73b94424e9fb145d736'],36,44,80,1816347,11,,,,790
2fe2ea713629e2a57a2801219d618a7daed4fe1c,0,Nong Li,2012-06-22 12:23:37-07:00,['2598450ae1f32b79d72d27f38b1a91bc7f63e453'],184,121,305,1816652,12,0.842105263,0.263157895,0.026315789,790
ad073ef1b2880b69de412882d62b4f3c3d55d328,0,Alan Choi,2012-06-22 14:08:44-07:00,['2fe2ea713629e2a57a2801219d618a7daed4fe1c'],138,179,317,1816969,21,0.409090909,0.636363636,0.727272727,790
97c70b252973316cb6e2b822fc65cff49ebb1d2b,0,Nong Li,2012-06-22 15:24:56-07:00,['ad073ef1b2880b69de412882d62b4f3c3d55d328'],9,38,47,1817016,4,0.2,0.2,0.8,790
430f704aad89d4b560f9668bc3f0a33e41eb7e8e,0,Henry Robinson,2012-06-22 16:05:03-07:00,['97c70b252973316cb6e2b822fc65cff49ebb1d2b'],0,0,0,1817016,0,,,,790
ce2ae276c198c1a46e0d3602f6c1ebef322bf063,1,Henry Robinson,2012-06-22 16:05:03-07:00,['430f704aad89d4b560f9668bc3f0a33e41eb7e8e'],42,55,97,1817113,9,,,,792
f5bcca5f7af104eaa79b6fa592e9cd709b0255d4,0,Henry Robinson,2012-06-23 15:18:01-07:00,['ce2ae276c198c1a46e0d3602f6c1ebef322bf063'],3,10,13,1817126,3,,,,793
464b095ad1b9089099d020d1fdfd21d7e829a2fe,0,Nong Li,2012-06-24 11:25:11-07:00,['f5bcca5f7af104eaa79b6fa592e9cd709b0255d4'],5,8,13,1817139,1,,,,793
c0b384f713e68978a81959c025818da2a328bfa0,0,Michael Ubell,2012-06-27 14:57:34-07:00,['464b095ad1b9089099d020d1fdfd21d7e829a2fe'],7,37,44,1817183,6,0,0,0,793
6fb4072ccac9536a7e3d3ad5e1a64d9edaac6b3d,1,Nong Li,2012-06-28 10:35:53-07:00,['c0b384f713e68978a81959c025818da2a328bfa0'],27,222,249,1817432,6,0.423076923,0.423076923,0.871794872,796
3130da5fc72595ef25f5d5492ad13a091a088026,1,Nong Li,2012-06-28 15:59:47-07:00,['6fb4072ccac9536a7e3d3ad5e1a64d9edaac6b3d'],158,209,367,1817799,13,0,0,0.681818182,797
96543325a72180a36fb6adb36190905979cba633,0,Lenni Kuff,2012-06-29 09:45:32-07:00,['3130da5fc72595ef25f5d5492ad13a091a088026'],5,1,6,1817805,1,,,,797
5a32d64937ab80ad7df0856bd91dc85189b6a4da,0,Lenni Kuff,2012-06-29 09:51:42-07:00,['96543325a72180a36fb6adb36190905979cba633'],89,318,407,1818212,2,1,0.896907216,0.443298969,798
462465164dec62423dd3bc44cdfe4bcf6c70c111,0,Lenni Kuff,2012-06-29 10:15:50-07:00,['5a32d64937ab80ad7df0856bd91dc85189b6a4da'],1,2,3,1818215,1,,,,798
372ed3a66acaeb28d29881a9ef15de6b246a281d,0,Daniel Jackoway,2012-06-29 10:52:07-07:00,['462465164dec62423dd3bc44cdfe4bcf6c70c111'],0,178,178,1818393,4,1,1,1,801
26499a260dac9142f357d641eff1c971d7fe4111,1,Alan Choi,2012-06-29 15:40:18-07:00,['372ed3a66acaeb28d29881a9ef15de6b246a281d'],62,215,277,1818670,8,0.204545455,1,1,802
122be6e60bc22bee8f92ef885e446267c74aea24,0,Lenni Kuff,2012-06-30 08:36:43-07:00,['26499a260dac9142f357d641eff1c971d7fe4111'],7,9,16,1818686,2,,,,802
da960b2ba437dbdedd3ad8ad828b88a2a692a890,0,Alan Choi,2012-07-03 10:24:38-07:00,['122be6e60bc22bee8f92ef885e446267c74aea24'],1,1,2,1818688,1,,,,802
8eb9090393f64d253d4f804ba86e874684a2108d,1,Nong Li,2012-07-03 18:43:57-07:00,['da960b2ba437dbdedd3ad8ad828b88a2a692a890'],28,35,63,1818751,1,0,0,1,802
b1e986e5aa71d469f7115e49d6e7155e5599a3ca,0,Lenni Kuff,2012-07-03 22:34:10-07:00,['8eb9090393f64d253d4f804ba86e874684a2108d'],3,12,15,1818766,1,0,0,0,802
7b065fa097fb149c8e7771b8a9c8b3ed910b4c85,1,Michael Ubell,2012-07-04 01:37:00-07:00,['b1e986e5aa71d469f7115e49d6e7155e5599a3ca'],72,256,328,1819094,11,0.747747748,1,1,803
cedb2872615d8a3e5404024a4cecab7d86d272e0,1,Henry Robinson,2012-07-05 11:02:58-07:00,['7b065fa097fb149c8e7771b8a9c8b3ed910b4c85'],44,106,150,1819244,3,0,0,1,803
174dc243f0e52c0da623e95395667b7da069dcb7,0,Kay Ousterhout,2012-07-05 12:50:50-07:00,['cedb2872615d8a3e5404024a4cecab7d86d272e0'],0,2,2,1819246,1,,,,803
1806424f99bb7db3960c15f22c249ffd493831af,0,Lenni Kuff,2012-07-07 08:18:06-07:00,['174dc243f0e52c0da623e95395667b7da069dcb7'],13,13,26,1819272,1,,,,803
8d448fbd90a902c15051be8d73071c2668f0b28d,1,Michael Ubell,2012-07-09 16:30:03-07:00,['1806424f99bb7db3960c15f22c249ffd493831af'],127,265,392,1819664,6,0,0.051282051,0.320512821,803
f2ea38831df5bbd9c245f358b5df355419524594,1,Michael Ubell,2012-07-09 22:20:29-07:00,['8d448fbd90a902c15051be8d73071c2668f0b28d'],324,487,811,1820475,15,0.125,0.528846154,0.134615385,805
5af1869475a871859a2d44c5ab8e06bafba29555,0,Lenni Kuff,2012-07-10 08:08:01-07:00,['f2ea38831df5bbd9c245f358b5df355419524594'],544,990,1534,1822009,11,0.587443946,1,0.560538117,811
759497c0ebfc1e8d24a7dc23555e03e0346c8a2c,1,Michael Ubell,2012-07-10 11:08:18-07:00,['5af1869475a871859a2d44c5ab8e06bafba29555'],1,1,2,1822011,1,,,,811
0d5eed70144c7a3a3b6e6ad18a0e96b9127eda1d,1,Michael Ubell,2012-07-10 15:05:34-07:00,['759497c0ebfc1e8d24a7dc23555e03e0346c8a2c'],18,35,53,1822064,2,0.533333333,0.6,1,811
8f0d4f856dffb55e40475346ad2526a0c813d0ea,0,Daniel Jackoway,2012-07-10 16:28:07-07:00,['0d5eed70144c7a3a3b6e6ad18a0e96b9127eda1d'],73,381,454,1822518,9,0.464912281,0.763157895,0.912280702,817
6f7fe6bba5c98be91c45027870339a29316dcc2d,0,Michael Ubell,2012-07-11 08:42:05-07:00,['8f0d4f856dffb55e40475346ad2526a0c813d0ea'],13,48,61,1822579,3,0,1,1,817
097616a31d825d52d3462109d6d5af153816ba1a,1,Alexander Behm,2012-07-11 13:12:43-07:00,['6f7fe6bba5c98be91c45027870339a29316dcc2d'],480,1489,1969,1824548,14,0.282051282,0.403846154,0.307692308,820
1bb1890eb9f49a1573116ea4fb8638d1afb4f654,0,Lenni Kuff,2012-07-11 18:20:16-07:00,['097616a31d825d52d3462109d6d5af153816ba1a'],0,5,5,1824553,1,,,,820
e4d3fa74fb9d68fa81c4fb1107317d4799dd9f26,1,Alan Choi,2012-07-12 10:16:57-07:00,['1bb1890eb9f49a1573116ea4fb8638d1afb4f654'],10,137,147,1824700,7,0,0.882352941,1,820
0da77037e354b754d4193a7ce8dc5138c9b450e2,1,Lenni Kuff,2012-07-12 23:12:20-07:00,['e4d3fa74fb9d68fa81c4fb1107317d4799dd9f26'],813,561,1374,1826074,26,0.666666667,0.583333333,0,827
073e38d6c2fb4337797451d4e9a7fb5566d3418e,1,Kay Ousterhout,2012-07-13 09:26:16-07:00,['0da77037e354b754d4193a7ce8dc5138c9b450e2'],23,2222,2245,1828319,27,0.267634855,0.830912863,0.952282158,841
69cf464b6a20f2438b0c123062446554c6d5287a,0,Nong Li,2012-07-13 11:28:44-07:00,['073e38d6c2fb4337797451d4e9a7fb5566d3418e'],1,1,2,1828321,1,,,,841
da1205dc83a66bdfb48860aaf99e849cd019621c,0,Henry Robinson,2012-07-13 15:28:53-07:00,['69cf464b6a20f2438b0c123062446554c6d5287a'],4,1,5,1828326,1,0,0,0,841
dd713081dccc35950e4e77327a0668426d534863,1,Nong Li,2012-07-13 16:18:30-07:00,['da1205dc83a66bdfb48860aaf99e849cd019621c'],313,1681,1994,1830320,31,0.01884253,0.395693136,0.823687752,843
d3e675e3f8ba3d67e074e3d49d57cfb57a17eba2,0,Nong Li,2012-07-13 16:53:44-07:00,['dd713081dccc35950e4e77327a0668426d534863'],10,10,20,1830340,1,,,,843
94e7a5640901fc2503121792283c879256022a97,1,Henry Robinson,2012-07-14 10:39:54-07:00,['d3e675e3f8ba3d67e074e3d49d57cfb57a17eba2'],63,266,329,1830669,18,0.322580645,0.978494624,0.774193548,845
7057b6c3a0a1237c288ae626a02e8b5ff09cb531,0,Henry Robinson,2012-07-14 10:39:54-07:00,['94e7a5640901fc2503121792283c879256022a97'],0,0,0,1830669,0,,,,845
3490ee4484ec35cfb225179d0ef1034a5d9be253,1,Henry Robinson,2012-07-14 10:39:54-07:00,['7057b6c3a0a1237c288ae626a02e8b5ff09cb531'],1,254,255,1830924,8,0.406976744,1,0.674418605,848
eae68f7a97f0a56fdbf6ef1346c77601c11d119d,0,Henry Robinson,2012-07-14 11:24:02-07:00,['3490ee4484ec35cfb225179d0ef1034a5d9be253'],1,0,1,1830925,1,,,,848
836cddfc18967878db6e51506736e4d6aef3804a,0,Henry Robinson,2012-07-14 13:54:05-07:00,['eae68f7a97f0a56fdbf6ef1346c77601c11d119d'],1,1,2,1830927,1,,,,848
82158058046b3a0604ca900ffd7ea7cbfccb3cfd,0,Alan Choi,2012-07-16 13:29:06-07:00,['836cddfc18967878db6e51506736e4d6aef3804a'],1,78,79,1831006,3,0,1,1,848
78fd2c5d6dd720f3e6e5d25bb1367455568646ba,1,Michael Ubell,2012-07-16 15:43:40-07:00,['82158058046b3a0604ca900ffd7ea7cbfccb3cfd'],105,295,400,1831406,11,0.084745763,0.457627119,0.93220339,848
dbb6ac5f63e1a54b91eb8fb29a496d12a14d52e9,0,Michael Ubell,2012-07-17 09:22:48-07:00,['78fd2c5d6dd720f3e6e5d25bb1367455568646ba'],11,14,25,1831431,3,0,0,1,848
1c86585d46a6ced97fab59abe63eeaed81c40711,0,Michael Ubell,2012-07-17 11:04:37-07:00,['dbb6ac5f63e1a54b91eb8fb29a496d12a14d52e9'],28,117,145,1831576,7,0.2,0.9,1,848
1f5ad2215a9cace1ebcd477ca4730a9dc870fcc5,0,Michael Ubell,2012-07-17 13:48:50-07:00,['1c86585d46a6ced97fab59abe63eeaed81c40711'],148,173,321,1831897,28,0.416666667,1,0.833333333,848
bd5c11429a0c78a0e275debe99bbd1a4ea1d954b,0,Henry Robinson,2012-07-17 13:57:04-07:00,['1f5ad2215a9cace1ebcd477ca4730a9dc870fcc5'],24,38,62,1831959,5,1,1,1,848
46099a41be5cc568c7898a384b311d4242d21b2f,1,Alan Choi,2012-07-17 17:44:57-07:00,['bd5c11429a0c78a0e275debe99bbd1a4ea1d954b'],0,10,10,1831969,2,0,0.333333333,1,848
bee2736de70ae05b3472c11121d99294b1279033,0,Alan Choi,2012-07-17 17:50:51-07:00,['46099a41be5cc568c7898a384b311d4242d21b2f'],2,11,13,1831982,3,1,1,0,848
c3c9099371312b1e70599a056f5576ce4fc00932,0,Henry Robinson,2012-07-18 15:01:34-07:00,['bee2736de70ae05b3472c11121d99294b1279033'],1,2,3,1831985,1,0,1,1,848
ed2edac79d2b69eadff28c0764b90ecfccdfeb47,1,Lenni Kuff,2012-07-19 12:30:48-07:00,['c3c9099371312b1e70599a056f5576ce4fc00932'],2286,2481,4767,1836752,25,0.3515625,0.3828125,0.625,850
4a06619c96d4cb3f1c81d04110015d8ed7b70f8e,0,Michael Ubell,2012-07-19 12:38:03-07:00,['ed2edac79d2b69eadff28c0764b90ecfccdfeb47'],3,3,6,1836758,3,,,,850
e6a46d704c26ec49e07797c9b5b87336154361fe,0,Kay Ousterhout,2012-07-19 13:18:12-07:00,['4a06619c96d4cb3f1c81d04110015d8ed7b70f8e'],29,34,63,1836821,4,0,0.625,1,850
d29acc35903c9dc7b75480c8c49625be545b9418,0,Lenni Kuff,2012-07-19 13:53:05-07:00,['e6a46d704c26ec49e07797c9b5b87336154361fe'],0,44,44,1836865,1,,,,850
a226e243f27a5c1ea97c0651fbfb226d4a4e9211,0,Lenni Kuff,2012-07-19 15:45:46-07:00,['d29acc35903c9dc7b75480c8c49625be545b9418'],0,16,16,1836881,1,,,,850
e5c42edad258e12c718214c7dd7d13d7ebbba462,0,Kay Ousterhout,2012-07-19 16:04:49-07:00,['a226e243f27a5c1ea97c0651fbfb226d4a4e9211'],1,1,2,1836883,1,,,,850
e293164b37df6c69da90e3460f7d5549b473c65e,1,Henry Robinson,2014-01-08 10:44:06-08:00,['e5c42edad258e12c718214c7dd7d13d7ebbba462'],113,3033,3146,1840029,44,0.675675676,0.567567568,0.851351351,881
a5e94fd40e64c2fdc4ca5046c4a8f6cd89250775,0,Henry Robinson,2014-01-08 10:44:12-08:00,['e293164b37df6c69da90e3460f7d5549b473c65e'],1,5,6,1840035,1,,,,881
6120ea310814be4e8b88b8b2693ebab39a12e2b9,0,Henry Robinson,2014-01-08 10:44:12-08:00,['a5e94fd40e64c2fdc4ca5046c4a8f6cd89250775'],1,1,2,1840037,3,,,,881
6678d2bd50afc18fada0a3b71cea372a7de3f536,0,Henry Robinson,2014-01-08 10:44:13-08:00,['6120ea310814be4e8b88b8b2693ebab39a12e2b9'],0,11,11,1840048,1,,,,881
2cdd473ea0c201892893d4ab698bd6ba92c120d0,0,Henry Robinson,2014-01-08 10:44:13-08:00,['6678d2bd50afc18fada0a3b71cea372a7de3f536'],8,22,30,1840078,3,1,1,1,881
7d14ece317f2f0bc585561fdc9812d6b64049562,1,Henry Robinson,2014-01-08 10:44:13-08:00,['2cdd473ea0c201892893d4ab698bd6ba92c120d0'],9,14,23,1840101,2,,,,881
ac824dd5f5b9a65dd8099c2579445cd39d88b4f7,1,Henry Robinson,2014-01-08 10:44:13-08:00,['7d14ece317f2f0bc585561fdc9812d6b64049562'],76,162,238,1840339,11,0.069767442,1,0.627906977,881
e49ae73236b8baa4756a2689f8b0a199156d2cc1,1,Henry Robinson,2014-01-08 10:44:14-08:00,['ac824dd5f5b9a65dd8099c2579445cd39d88b4f7'],1,1,2,1840341,1,,,,881
ac0064936902827da8d954a94359526ea7abb3ee,0,Henry Robinson,2014-01-08 10:44:14-08:00,['e49ae73236b8baa4756a2689f8b0a199156d2cc1'],4,4,8,1840349,3,,,,881
888b3416e213a87578166d25454e7a79792e9cbd,0,Henry Robinson,2014-01-08 10:44:14-08:00,['ac0064936902827da8d954a94359526ea7abb3ee'],8,5,13,1840362,1,,,,881
4eae92a81e75fb0e2ddc0b5f2f38e0bd42cc750c,0,Henry Robinson,2014-01-08 10:44:14-08:00,['888b3416e213a87578166d25454e7a79792e9cbd'],1,1,2,1840364,1,,,,881
a1e03b81cd75e30ff6962850b7758de902d94039,1,Henry Robinson,2014-01-08 10:44:15-08:00,['4eae92a81e75fb0e2ddc0b5f2f38e0bd42cc750c'],18,798,816,1841180,18,0.28,0.890909091,0.930909091,885
d2bb6ae068b0dd9fb225296f5c8774569a3c2ccf,1,Henry Robinson,2014-01-08 10:44:15-08:00,['a1e03b81cd75e30ff6962850b7758de902d94039'],679,4245,4924,1846104,28,0.133333333,0,0,886
b17e24d65486f4b2872684fe1ab7ea3a448ed01e,1,Henry Robinson,2014-01-08 10:44:15-08:00,['d2bb6ae068b0dd9fb225296f5c8774569a3c2ccf'],9,60,69,1846173,7,0,0.382352941,1,886
fb32d40b03fe6e411726ef40b15db2cf0e1fe637,1,Henry Robinson,2014-01-08 10:44:15-08:00,['b17e24d65486f4b2872684fe1ab7ea3a448ed01e'],1920,2325,4245,1850418,72,0.5703125,1,1,891
f4218ab55c24cb1e2fc4dfd9d933bb295817016e,1,Henry Robinson,2014-01-08 10:44:16-08:00,['fb32d40b03fe6e411726ef40b15db2cf0e1fe637'],306,368,674,1851092,28,1,0.088888889,0.111111111,894
d6e48f1c25a06f28f3d8d6563ca8a03efd427ec7,0,Henry Robinson,2014-01-08 10:44:16-08:00,['f4218ab55c24cb1e2fc4dfd9d933bb295817016e'],21,36,57,1851149,8,0.555555556,0.888888889,1,894
99fe1bb2b6bff069039fcba41c6593b23be9ac12,0,Henry Robinson,2014-01-08 10:44:16-08:00,['d6e48f1c25a06f28f3d8d6563ca8a03efd427ec7'],1,27,28,1851177,2,,,,894
b068006b38d320fa573617aa7d2c5431a60fead0,0,Henry Robinson,2014-01-08 10:44:16-08:00,['99fe1bb2b6bff069039fcba41c6593b23be9ac12'],1,1,2,1851179,1,,,,894
9c53d5af2dd9b23af23534741daaa5d976851270,0,Henry Robinson,2014-01-08 10:44:17-08:00,['b068006b38d320fa573617aa7d2c5431a60fead0'],78,62,140,1851319,10,1,0,0,894
9089c7f2e1e6b9dea278360cb728caecf0860215,0,Henry Robinson,2014-01-08 10:44:17-08:00,['9c53d5af2dd9b23af23534741daaa5d976851270'],6,71,77,1851396,4,0.3,1,0.925,894
1c443d129b231523508b3f7a830e5fbd35438c10,0,Henry Robinson,2014-01-08 10:44:17-08:00,['9089c7f2e1e6b9dea278360cb728caecf0860215'],2,7,9,1851405,1,1,1,1,894
69777066df0ffb80335c430e4408be8e1cbbb363,1,Henry Robinson,2014-01-08 10:44:17-08:00,['1c443d129b231523508b3f7a830e5fbd35438c10'],2,15,17,1851422,3,0.75,0,1,894
bf27a31f989cc5b460e65410bf47aabc87e9ffd8,1,Henry Robinson,2014-01-08 10:44:18-08:00,['69777066df0ffb80335c430e4408be8e1cbbb363'],4190,1370,5560,1856982,35,0.310344828,0.310344828,0.344827586,906
cef688d0fd5cf9ace7d5bab38fdc227d6b5da8cf,0,Henry Robinson,2014-01-08 10:44:18-08:00,['bf27a31f989cc5b460e65410bf47aabc87e9ffd8'],6,5,11,1856993,3,1,0,0,906
84d91fca4fbfaedf3610b2f2e24add1855d35ab8,1,Henry Robinson,2014-01-08 10:44:18-08:00,['cef688d0fd5cf9ace7d5bab38fdc227d6b5da8cf'],43,41,84,1857077,3,,,,906
10bf3e91e3219f999c3a6ff5f7fc560142924fd2,1,Henry Robinson,2014-01-08 10:44:18-08:00,['84d91fca4fbfaedf3610b2f2e24add1855d35ab8'],224,506,730,1857807,27,0.494186047,0.924418605,0.819767442,906
6de71b4b23801917d813398905d8c56ff10a1fb7,0,Henry Robinson,2014-01-08 10:44:19-08:00,['10bf3e91e3219f999c3a6ff5f7fc560142924fd2'],3,3,6,1857813,3,0,0.5,1,906
5a92fee31cfa3c3ac0e1dbb5f3813ea4e355255b,1,Henry Robinson,2014-01-08 10:44:19-08:00,['6de71b4b23801917d813398905d8c56ff10a1fb7'],19,178,197,1858010,19,0.642857143,0.196428571,0.75,906
02d63d8dc3af67082b1ddbc6553bb99326f387f9,1,Henry Robinson,2014-01-08 10:44:19-08:00,['5a92fee31cfa3c3ac0e1dbb5f3813ea4e355255b'],142,2975,3117,1861127,55,0.321348315,0.507116105,0.802996255,918
64058cb9b8f088ee93dcdd1c434c2df68b05113f,1,Henry Robinson,2014-01-08 10:44:19-08:00,['02d63d8dc3af67082b1ddbc6553bb99326f387f9'],64,117,181,1861308,11,0,0.655172414,0.827586207,918
bc7eff1240fb3901cc0f28b2cb1ba3f0507970b6,0,Henry Robinson,2014-01-08 10:44:20-08:00,['64058cb9b8f088ee93dcdd1c434c2df68b05113f'],0,2,2,1861310,1,1,1,1,918
f438249d3ba917ea15958fedabd491b59c0a694a,0,Henry Robinson,2014-01-08 10:44:20-08:00,['bc7eff1240fb3901cc0f28b2cb1ba3f0507970b6'],3,4,7,1861317,1,1,1,0,918
f1ba454b80ce9458c7127b6446d9b655dafde79e,0,Henry Robinson,2014-01-08 10:44:20-08:00,['f438249d3ba917ea15958fedabd491b59c0a694a'],1,1,2,1861319,1,,,,918
ede83a84b233eca9086e8b104d5d76996cc188c3,0,Henry Robinson,2014-01-08 10:44:20-08:00,['f1ba454b80ce9458c7127b6446d9b655dafde79e'],2,10,12,1861331,1,1,1,1,918
f2cccba998be7c00772158e776e29d51ab25d5a4,0,Henry Robinson,2014-01-08 10:44:21-08:00,['ede83a84b233eca9086e8b104d5d76996cc188c3'],3998,0,3998,1865329,10,0.0090212,0.00496166,0.117275598,918
c6e3e56c79f65e49c048d94a64cc6a7db83a6638,1,Henry Robinson,2014-01-08 10:44:21-08:00,['f2cccba998be7c00772158e776e29d51ab25d5a4'],19,102,121,1865450,6,0.530612245,1,1,920
88e9d4e4e9d4ee82f0422d6ffbb12e333d5d2a74,0,Henry Robinson,2014-01-08 10:44:21-08:00,['c6e3e56c79f65e49c048d94a64cc6a7db83a6638'],23,9,32,1865482,4,0.083333333,0,0.916666667,920
81d54e85e501458bdbc8254e60647aa926bd4506,0,Henry Robinson,2014-01-08 10:44:21-08:00,['88e9d4e4e9d4ee82f0422d6ffbb12e333d5d2a74'],6,3,9,1865491,1,0,0,0,920
04edc8f5349451e820130608d19927bbbde5f431,1,Henry Robinson,2014-01-08 10:44:22-08:00,['81d54e85e501458bdbc8254e60647aa926bd4506'],1564,1705,3269,1868760,90,0.826446281,0.768595041,0.892561983,929
4b60df645862e7ef3bd546d0c15ef739f6f95d29,1,Henry Robinson,2014-01-08 10:44:22-08:00,['04edc8f5349451e820130608d19927bbbde5f431'],97,285,382,1869142,22,0.231707317,0.170731707,0.902439024,929
dfe7dcfd9b6ed4d9d1286f0f46ad00b3ba480b71,1,Henry Robinson,2014-01-08 10:44:22-08:00,['4b60df645862e7ef3bd546d0c15ef739f6f95d29'],11,160,171,1869313,6,0.210526316,1,0.947368421,929
41200fc307a6c47fd178bfa2d6d9ccb3af1322db,1,Henry Robinson,2014-01-08 10:44:22-08:00,['dfe7dcfd9b6ed4d9d1286f0f46ad00b3ba480b71'],160,271,431,1869744,21,0.106666667,0.973333333,1,929
91f51a1b39f2db357960ede28ede65398ec07492,0,Henry Robinson,2014-01-08 10:44:23-08:00,['41200fc307a6c47fd178bfa2d6d9ccb3af1322db'],3,1,4,1869748,2,,,,929
431c2ac2d128a7c7076863686adbf9fdee6c9446,0,Henry Robinson,2014-01-08 10:44:23-08:00,['91f51a1b39f2db357960ede28ede65398ec07492'],2,6,8,1869756,2,1,1,1,929
16a52c3213f8fbb4ef976070bff4541e6dfec170,0,Henry Robinson,2014-01-08 10:44:23-08:00,['431c2ac2d128a7c7076863686adbf9fdee6c9446'],2,6,8,1869764,2,0,0,1,929
84f71a716fb592890bd34d67acce3d8cb50a200b,0,Henry Robinson,2014-01-08 10:44:23-08:00,['16a52c3213f8fbb4ef976070bff4541e6dfec170'],7,25,32,1869796,4,0.333333333,1,0.333333333,929
ff9a38b472c1269232be4856dca5fff56c610188,0,Henry Robinson,2014-01-08 10:44:24-08:00,['84f71a716fb592890bd34d67acce3d8cb50a200b'],43,516,559,1870355,10,0.674107143,0.888392857,0.799107143,932
cbadb4eac4e13b9b83e3a95c501b77aa9011f4cb,1,Henry Robinson,2014-01-08 10:44:24-08:00,['ff9a38b472c1269232be4856dca5fff56c610188'],92,277,369,1870724,24,0.567010309,0.154639175,0.309278351,934
3d97f3b7556ff70848c22c6310137969a031ba78,0,Henry Robinson,2014-01-08 10:44:24-08:00,['cbadb4eac4e13b9b83e3a95c501b77aa9011f4cb'],13,13,26,1870750,5,,,,934
17da75acef147b2ceda0c88c4fee3976512ff42c,0,Henry Robinson,2014-01-08 10:44:24-08:00,['3d97f3b7556ff70848c22c6310137969a031ba78'],141,241,382,1871132,7,1,0.96,0.92,934
79095b6400bd1720796f0d91a86d908d26a7053b,1,Henry Robinson,2014-01-08 10:44:25-08:00,['17da75acef147b2ceda0c88c4fee3976512ff42c'],49,55,104,1871236,2,0,0.6,0.4,934
4b581d1ef58381f7613d406d0be62521c6b79368,0,Henry Robinson,2014-01-08 10:44:25-08:00,['79095b6400bd1720796f0d91a86d908d26a7053b'],2,12,14,1871250,1,,,,934
1a39e6e12f583d32d84b5550ff3d8ca934c4addc,0,Henry Robinson,2014-01-08 10:44:26-08:00,['4b581d1ef58381f7613d406d0be62521c6b79368'],0,0,0,1871250,0,,,,934
a437dd39fa7c2cc49945ef05361c987d7ec8a787,1,Henry Robinson,2014-01-08 10:44:26-08:00,['1a39e6e12f583d32d84b5550ff3d8ca934c4addc'],20,27,47,1871297,2,1,0,0,934
8c45bf6c2b7212ce274eb8b31c4f1eccd27b7ae4,1,Henry Robinson,2014-01-08 10:44:27-08:00,['a437dd39fa7c2cc49945ef05361c987d7ec8a787'],0,2197,2197,1873494,9,0.268788683,0.468611848,0.729442971,941
86e09ae1aa961e78e60cc37653147c950ed120c8,1,Henry Robinson,2014-01-08 10:44:27-08:00,['8c45bf6c2b7212ce274eb8b31c4f1eccd27b7ae4'],52,117,169,1873663,2,0.03125,0.75,1,941
88101bc90e1537ddca2ba5c855080ed47c6048af,1,Henry Robinson,2014-01-08 10:44:27-08:00,['86e09ae1aa961e78e60cc37653147c950ed120c8'],136,689,825,1874488,37,0.2406639,0.336099585,0.473029046,941
89a5df690dc32c3f0946fda9f7a4b4eeacebfdd4,0,Henry Robinson,2014-01-08 10:44:27-08:00,['88101bc90e1537ddca2ba5c855080ed47c6048af'],4,4,8,1874496,1,,,,941
04d12f03fcb702e05928446cfc1723c0a4f0f083,1,Henry Robinson,2014-01-08 10:44:28-08:00,['89a5df690dc32c3f0946fda9f7a4b4eeacebfdd4'],613,957,1570,1876066,17,0.109375,0,0.765625,941
70e8b48d0e4f716df5e05fafc1d191598d48ef12,1,Henry Robinson,2014-01-08 10:44:28-08:00,['04d12f03fcb702e05928446cfc1723c0a4f0f083'],87,258,345,1876411,9,1,0.897959184,1,945
52bd3ad173b3cb67214f5c653c2d7a0f5f604f63,0,Henry Robinson,2014-01-08 10:44:28-08:00,['70e8b48d0e4f716df5e05fafc1d191598d48ef12'],6,6,12,1876423,2,,,,945
6f1a08839b841c2b3a45502a5409e418227826a1,1,Henry Robinson,2014-01-08 10:44:28-08:00,['52bd3ad173b3cb67214f5c653c2d7a0f5f604f63'],20,44,64,1876487,6,0,1,1,945
acb7fb626fa24927f30c8b31ad22c3b62d0458fa,0,Henry Robinson,2014-01-08 10:44:29-08:00,['6f1a08839b841c2b3a45502a5409e418227826a1'],26,36,62,1876549,1,0.444444444,1,1,945
4cbafb5458510f5e82114b5c81f65e538e819e27,1,Henry Robinson,2014-01-08 10:44:29-08:00,['acb7fb626fa24927f30c8b31ad22c3b62d0458fa'],18,127,145,1876694,6,0,0.493506494,0.688311688,945
1a05c4e776bf4f3720c4b1e16f202f5668f743d3,0,Henry Robinson,2014-01-08 10:44:29-08:00,['4cbafb5458510f5e82114b5c81f65e538e819e27'],14,16,30,1876724,3,1,1,0,945
a524507b833e2ead76e3c7fcb00b440371ff6ce5,0,Henry Robinson,2014-01-08 10:44:29-08:00,['1a05c4e776bf4f3720c4b1e16f202f5668f743d3'],2,15,17,1876741,2,,,,945
74250f512132bc8c8f438f578d768662bcca21fd,0,Henry Robinson,2014-01-08 10:44:30-08:00,['a524507b833e2ead76e3c7fcb00b440371ff6ce5'],110,120,230,1876971,2,1,1,1,945
87d0ed137f44698f5f2fd18eabab3ff9a314bcae,0,Henry Robinson,2014-01-08 10:44:30-08:00,['74250f512132bc8c8f438f578d768662bcca21fd'],1241,1241,2482,1879453,1,,,,945
f15ef994fbcc388c7e79f51ddae7c15b7b8a50ed,1,Henry Robinson,2014-01-08 10:44:30-08:00,['87d0ed137f44698f5f2fd18eabab3ff9a314bcae'],1718,524,2242,1881695,30,0.697947214,0.413489736,0.37829912,947
cc51e80b448ffc92a39c9a77a0964f1aa60c0889,0,Henry Robinson,2014-01-08 10:44:30-08:00,['f15ef994fbcc388c7e79f51ddae7c15b7b8a50ed'],4,6,10,1881705,1,0,1,1,947
ee705e30835a4dec2d753a5d705a30a481fc2f21,1,Henry Robinson,2014-01-08 10:44:31-08:00,['cc51e80b448ffc92a39c9a77a0964f1aa60c0889'],26,1030,1056,1882761,10,0.23798627,0.741418764,0.894736842,948
3d9808d7a607ce54a58d5fe1893fe4554c3b7721,0,Henry Robinson,2014-01-08 10:44:31-08:00,['ee705e30835a4dec2d753a5d705a30a481fc2f21'],9,7,16,1882777,3,,,,948
88ae4d748f39abee3d5beb45adecf1ce5318f0a7,1,Henry Robinson,2014-01-08 10:44:33-08:00,['3d9808d7a607ce54a58d5fe1893fe4554c3b7721'],13,64,77,1882854,3,0.424242424,0,0.878787879,948
c8b2b6023b542831d425a7738aaf9d6c22e5cdb8,1,Henry Robinson,2014-01-08 10:44:33-08:00,['88ae4d748f39abee3d5beb45adecf1ce5318f0a7'],9,8,17,1882871,1,1,0,1,948
893b01ccbf324d5503f51f03acac4310ca7f0c60,0,Henry Robinson,2014-01-08 10:44:34-08:00,['c8b2b6023b542831d425a7738aaf9d6c22e5cdb8'],2,21,23,1882894,3,0,0,1,948
13c6ca94de688305da99901bcbba354bd5ac247b,1,Henry Robinson,2014-01-08 10:44:34-08:00,['893b01ccbf324d5503f51f03acac4310ca7f0c60'],4,9,13,1882907,2,0,1,1,948
6e07e0b8d8251f833b51cd98cba5ed538f18a964,1,Henry Robinson,2014-01-08 10:44:34-08:00,['13c6ca94de688305da99901bcbba354bd5ac247b'],22,163,185,1883092,6,0.555555556,0.555555556,0.444444444,948
b96b9640ef4be3e018d168b84fff9d1f52d3ee21,1,Henry Robinson,2014-01-08 10:44:34-08:00,['6e07e0b8d8251f833b51cd98cba5ed538f18a964'],2,116,118,1883210,4,0.833333333,1,1,949
4fd7bd96066cbd742794f467c9d4f3c30a0dd3b2,0,Henry Robinson,2014-01-08 10:44:34-08:00,['b96b9640ef4be3e018d168b84fff9d1f52d3ee21'],0,2,2,1883212,1,,,,949
bd58f5d309b3dc0a15f5d7c3b4ff3dca6e677aab,0,Henry Robinson,2014-01-08 10:44:35-08:00,['4fd7bd96066cbd742794f467c9d4f3c30a0dd3b2'],15,119,134,1883346,9,0.138888889,0.527777778,1,951
49266d5172a8213c5f332a13b9aeb72a8d2178e4,0,Henry Robinson,2014-01-08 10:44:35-08:00,['bd58f5d309b3dc0a15f5d7c3b4ff3dca6e677aab'],14,14,28,1883374,3,,,,951
c472213eebc343e2ecc8f694d07620a8836c5d72,1,Henry Robinson,2014-01-08 10:44:35-08:00,['49266d5172a8213c5f332a13b9aeb72a8d2178e4'],238,429,667,1884041,14,0,0.452991453,1,951
c7c953e36acd31aca365b4c88edd158d6125efda,1,Henry Robinson,2014-01-08 10:44:35-08:00,['c472213eebc343e2ecc8f694d07620a8836c5d72'],2,12,14,1884055,1,0,0,1,951
881c88f1314cb9eed7f3a7ef5e87143c550b3449,1,Henry Robinson,2014-01-08 10:44:36-08:00,['c7c953e36acd31aca365b4c88edd158d6125efda'],0,7,7,1884062,1,,,,951
da2bb36ea610142382509634c352977e6705abc1,1,Henry Robinson,2014-01-08 10:44:36-08:00,['881c88f1314cb9eed7f3a7ef5e87143c550b3449'],1,218,219,1884281,9,0.588235294,0.6,1,953
6c5cdb3cc01420b0f1982d343f449c6ad151a532,1,Henry Robinson,2014-01-08 10:44:36-08:00,['da2bb36ea610142382509634c352977e6705abc1'],26,366,392,1884673,10,0.933774834,0.973509934,0.920529801,956
24228892bb2f3f93af3c4a6161e9e44072551fc0,0,Henry Robinson,2014-01-08 10:44:36-08:00,['6c5cdb3cc01420b0f1982d343f449c6ad151a532'],0,0,0,1884673,0,,,,956
fb681fba4e0218afb14189c3d683a68a968fed63,1,Henry Robinson,2014-01-08 10:44:37-08:00,['24228892bb2f3f93af3c4a6161e9e44072551fc0'],2,209,211,1884884,4,0.809917355,1,1,958
e5893064b0b5e62d05d186e5dc18b91969d58325,0,Henry Robinson,2014-01-08 10:44:37-08:00,['fb681fba4e0218afb14189c3d683a68a968fed63'],13,13,26,1884910,3,,,,958
9ac664f1f7be68109118708d405701e5a5704bfb,1,Henry Robinson,2014-01-08 10:44:37-08:00,['e5893064b0b5e62d05d186e5dc18b91969d58325'],165,183,348,1885258,8,0,1,0.818181818,960
617113c1d237b6149eb2078747e0bae9f7a06b64,1,Henry Robinson,2014-01-08 10:44:37-08:00,['9ac664f1f7be68109118708d405701e5a5704bfb'],2,25,27,1885285,1,0,1,1,960
81bba16dac06d6fed18f9219d78206f3e31af6cc,1,Henry Robinson,2014-01-08 10:44:38-08:00,['617113c1d237b6149eb2078747e0bae9f7a06b64'],1169,2873,4042,1889327,79,0.357664234,0.750608273,0.944038929,965
9ca5c8825868fc74764ba749e1b865148376e7fc,1,Henry Robinson,2014-01-08 10:44:38-08:00,['81bba16dac06d6fed18f9219d78206f3e31af6cc'],0,1,1,1889328,1,,,,965
233b1089866a51fa9b20ed7c896a30c1d2fe3138,0,Henry Robinson,2014-01-08 10:44:38-08:00,['9ca5c8825868fc74764ba749e1b865148376e7fc'],30,31,61,1889389,2,1,0,0,965
9aba7360b7ec06dd3c019214cdb1fa60037cf16e,1,Henry Robinson,2014-01-08 10:44:38-08:00,['233b1089866a51fa9b20ed7c896a30c1d2fe3138'],72,95,167,1889556,12,1,1,1,965
cbb06c191c0b99200d22259b747e37053abb2855,0,Henry Robinson,2014-01-08 10:44:39-08:00,['9aba7360b7ec06dd3c019214cdb1fa60037cf16e'],2,2,4,1889560,1,,,,965
2d836a9dfc991737438ede6493482a2acb080bdc,0,Henry Robinson,2014-01-08 10:44:39-08:00,['cbb06c191c0b99200d22259b747e37053abb2855'],3,3,6,1889566,1,,,,965
dd1537d116bfa8e234a6669f2c0968dde96e1f9a,1,Henry Robinson,2014-01-08 10:44:39-08:00,['2d836a9dfc991737438ede6493482a2acb080bdc'],8,27,35,1889601,4,0.333333333,1,1,965
25aa8cba0db83fdd801ae0f2bdb0a7c9b5aeca0d,0,Henry Robinson,2014-01-08 10:44:39-08:00,['dd1537d116bfa8e234a6669f2c0968dde96e1f9a'],139,254,393,1889994,1,0.490909091,0.181818182,0.327272727,965
4d0319d32bb05722d7e63697530e56ffff9b8e51,1,Henry Robinson,2014-01-08 10:44:40-08:00,['25aa8cba0db83fdd801ae0f2bdb0a7c9b5aeca0d'],66,162,228,1890222,7,0.375,0.375,0.375,967
4c9c82910a4ad3e7557cc0ca77b44eb01f13494e,1,Henry Robinson,2014-01-08 10:44:40-08:00,['4d0319d32bb05722d7e63697530e56ffff9b8e51'],2,43,45,1890267,4,1,1,1,968
692e50d73590effab330c61d0bbf019972bfc9cf,0,Henry Robinson,2014-01-08 10:44:40-08:00,['4c9c82910a4ad3e7557cc0ca77b44eb01f13494e'],2,2,4,1890271,1,,,,968
aa60a591881b33eb5506ff1028b71ac68ebd642c,0,Henry Robinson,2014-01-08 10:44:40-08:00,['692e50d73590effab330c61d0bbf019972bfc9cf'],71,134,205,1890476,1,0.357142857,1,0.642857143,968
5b2621a401e125222294a01db4f40b539a0e1681,0,Henry Robinson,2014-01-08 10:44:41-08:00,['aa60a591881b33eb5506ff1028b71ac68ebd642c'],2,12,14,1890490,1,,,,968
7c411da86c2abbe603fde34eaef2cf3827a6dd6f,0,Henry Robinson,2014-01-08 10:44:41-08:00,['5b2621a401e125222294a01db4f40b539a0e1681'],2,0,2,1890492,1,,,,968
58001240d5a2a7b18dc32643213aa3a05b988ccc,0,Henry Robinson,2014-01-08 10:44:41-08:00,['7c411da86c2abbe603fde34eaef2cf3827a6dd6f'],66,142,208,1890700,2,0.363636364,0.878787879,0.727272727,968
e84cc0a9ebe69732d062cc6740f9ff48ae82de12,1,Henry Robinson,2014-01-08 10:44:41-08:00,['58001240d5a2a7b18dc32643213aa3a05b988ccc'],8,18,26,1890726,4,,,,968
0fd68e5718f8bb51c225976980161f8db9fecb56,1,Henry Robinson,2014-01-08 10:44:42-08:00,['e84cc0a9ebe69732d062cc6740f9ff48ae82de12'],101,190,291,1891017,17,0,0.888888889,0.777777778,968
c53c3cb05242d882c15c67b0390323dd7f6937fd,0,Henry Robinson,2014-01-08 10:44:42-08:00,['0fd68e5718f8bb51c225976980161f8db9fecb56'],0,33,33,1891050,1,1,1,1,969
7725f25ff5219fb7440ac92d32802dd4ce3cb8f0,1,Henry Robinson,2014-01-08 10:44:42-08:00,['c53c3cb05242d882c15c67b0390323dd7f6937fd'],871,1496,2367,1893417,64,0.295652174,0.182608696,0.860869565,971
c7f375d7321dcd12f84acde8abeceeff57d4cca2,0,Henry Robinson,2014-01-08 10:44:42-08:00,['7725f25ff5219fb7440ac92d32802dd4ce3cb8f0'],3,1,4,1893421,2,0,0,0,971
14e3f29ef920408dd56fa951f08c8b6b12a66d3d,1,Henry Robinson,2014-01-08 10:44:43-08:00,['c7f375d7321dcd12f84acde8abeceeff57d4cca2'],6,2,8,1893429,2,,,,971
b21b1a5affe9251e2c47de8c2b3f2ed6be0e7046,0,Henry Robinson,2014-01-08 10:44:43-08:00,['14e3f29ef920408dd56fa951f08c8b6b12a66d3d'],1,1,2,1893431,1,,,,971
70f23ef3a3d6571419eb5eb0067d5f722bae1d1a,0,Henry Robinson,2014-01-08 10:44:43-08:00,['b21b1a5affe9251e2c47de8c2b3f2ed6be0e7046'],8,47,55,1893486,6,0.454545455,0.909090909,1,971
ca1b47d4b4bd613707361eb9baa03a847ec550f8,0,Henry Robinson,2014-01-08 10:44:43-08:00,['70f23ef3a3d6571419eb5eb0067d5f722bae1d1a'],1,1,2,1893488,1,,,,971
00fa6ba2fbb8f9eb462ce7fe20bf78fed5f37d7b,0,Henry Robinson,2014-01-08 10:44:44-08:00,['ca1b47d4b4bd613707361eb9baa03a847ec550f8'],121,57,178,1893666,70,,,,971
5a1dc644dff1e019e2adb30c2d657973c0e1df8c,1,Henry Robinson,2014-01-08 10:44:44-08:00,['00fa6ba2fbb8f9eb462ce7fe20bf78fed5f37d7b'],17,57,74,1893740,3,0.857142857,0.857142857,1,972
4c84cdae51ad58f93127063b8da4a8916e84384d,0,Henry Robinson,2014-01-08 10:44:44-08:00,['5a1dc644dff1e019e2adb30c2d657973c0e1df8c'],2,2,4,1893744,1,,,,972
e160e09a856ac03d7977a1a4aa47d77eb173b1ce,1,Henry Robinson,2014-01-08 10:44:44-08:00,['4c84cdae51ad58f93127063b8da4a8916e84384d'],35,19,54,1893798,9,1,1,0.75,972
b7c2455979bcdef3bfb346beddac31943498bcf4,0,Henry Robinson,2014-01-08 10:44:45-08:00,['e160e09a856ac03d7977a1a4aa47d77eb173b1ce'],0,6,6,1893804,1,0,0,1,972
22765fc33ab32a0e1fafc1c384d21ed659941c6f,1,Henry Robinson,2014-01-08 10:44:45-08:00,['b7c2455979bcdef3bfb346beddac31943498bcf4'],450,296,746,1894550,17,0.882352941,1,0.867647059,972
8dae344ceb75902297fb8a1f6284616360bf4afb,0,Henry Robinson,2014-01-08 10:44:45-08:00,['22765fc33ab32a0e1fafc1c384d21ed659941c6f'],6,12,18,1894568,2,0,0,0,972
af2d5e49ff8aa151b1156bc9e212333f3b703dfc,0,Henry Robinson,2014-01-08 10:44:45-08:00,['8dae344ceb75902297fb8a1f6284616360bf4afb'],0,2,2,1894570,1,0,0.5,1,972
c18d0970d7ed7045232e01cf331b898d46bd3581,1,Henry Robinson,2014-01-08 10:44:46-08:00,['af2d5e49ff8aa151b1156bc9e212333f3b703dfc'],53,74,127,1894697,5,0.363636364,0.727272727,1,972
689fb7d799949fca4eab6785548c4a7a2eca0a4c,1,Henry Robinson,2014-01-08 10:44:46-08:00,['c18d0970d7ed7045232e01cf331b898d46bd3581'],53,159,212,1894909,18,0,0.4375,0.875,972
3dad9589f4e3df47e602b8c0fa584f39cf0b07db,1,Henry Robinson,2014-01-08 10:44:46-08:00,['689fb7d799949fca4eab6785548c4a7a2eca0a4c'],33,97,130,1895039,7,1,1,1,973
80f977afc6ce9d85fdacb4df5e7674b5e24fd176,1,Henry Robinson,2014-01-08 10:44:46-08:00,['3dad9589f4e3df47e602b8c0fa584f39cf0b07db'],101,110,211,1895250,14,0,0,1,973
c858580526907c4c3d8e5841e0596df1022c4153,0,Henry Robinson,2014-01-08 10:44:47-08:00,['80f977afc6ce9d85fdacb4df5e7674b5e24fd176'],0,1,1,1895251,1,1,1,1,973
ca5de77423c0092f43dd89b327688035b2aee256,1,Henry Robinson,2014-01-08 10:44:47-08:00,['c858580526907c4c3d8e5841e0596df1022c4153'],4,15,19,1895270,1,0,0,1,973
a417099e66a3556cab9c668cda63a827a4412f1f,1,Henry Robinson,2014-01-08 10:44:47-08:00,['ca5de77423c0092f43dd89b327688035b2aee256'],31,35,66,1895336,6,0,1,0,973
c004cdaa1cc8b5fe4b7a7c5cc7a892bdb914b471,1,Henry Robinson,2014-01-08 10:44:47-08:00,['a417099e66a3556cab9c668cda63a827a4412f1f'],7,247,254,1895590,10,,,,975
4ab79db94fa5cb39b06e2028617964abbcf988e0,1,Henry Robinson,2014-01-08 10:44:48-08:00,['c004cdaa1cc8b5fe4b7a7c5cc7a892bdb914b471'],6,55,61,1895651,10,0.78125,1,0.96875,975
05d1fa5bc68bad429c8cac75c73353a4c915939e,1,Henry Robinson,2014-01-08 10:44:48-08:00,['4ab79db94fa5cb39b06e2028617964abbcf988e0'],0,2,2,1895653,1,0,0,1,975
b2822ab41071a665536b26a061b86fd0cb29bae0,0,Henry Robinson,2014-01-08 10:44:48-08:00,['05d1fa5bc68bad429c8cac75c73353a4c915939e'],73,111,184,1895837,2,0,0,1,975
99441da2f4eb023f8b840c8fb8cb8b58bcc4451c,0,Henry Robinson,2014-01-08 10:44:48-08:00,['b2822ab41071a665536b26a061b86fd0cb29bae0'],7,10,17,1895854,7,,,,975
825c63ad3b567d20cca132752fb2f37d2aee30c0,0,Henry Robinson,2014-01-08 10:44:49-08:00,['99441da2f4eb023f8b840c8fb8cb8b58bcc4451c'],38,24,62,1895916,7,1,0,0,975
e3e6ba984b5912b6284cd7100db4f195375cce53,1,Henry Robinson,2014-01-08 10:44:49-08:00,['825c63ad3b567d20cca132752fb2f37d2aee30c0'],188,1015,1203,1897119,29,0.395209581,0.736526946,0.901197605,982
eeb63e37add241194c74172f391b35b5962d2232,1,Henry Robinson,2014-01-08 10:44:49-08:00,['e3e6ba984b5912b6284cd7100db4f195375cce53'],38,227,265,1897384,8,0.723404255,0.968085106,1,983
dafee3e5048ecf8771c15176be72e88a66845925,1,Henry Robinson,2014-01-08 10:44:49-08:00,['eeb63e37add241194c74172f391b35b5962d2232'],3,9,12,1897396,2,0,0.666666667,0.333333333,983
30653278b41e941c02c090c9b8477600126faadf,0,Henry Robinson,2014-01-08 10:44:50-08:00,['dafee3e5048ecf8771c15176be72e88a66845925'],10,10,20,1897416,4,0,0,1,983
dc94b9d06f8e0867b6a8f8e3fb97524920950346,0,Henry Robinson,2014-01-08 10:44:50-08:00,['30653278b41e941c02c090c9b8477600126faadf'],19,12,31,1897447,2,0,0,0,983
a401b388309c0da72ca31ac6ffa2f2b33980f6bb,0,Henry Robinson,2014-01-08 10:44:50-08:00,['dc94b9d06f8e0867b6a8f8e3fb97524920950346'],4,4,8,1897455,1,,,,983
7d595ba740fe3320bf69c9c5b3045a3b104b8bcc,0,Henry Robinson,2014-01-08 10:44:50-08:00,['a401b388309c0da72ca31ac6ffa2f2b33980f6bb'],106,131,237,1897692,3,1,1,1,983
afc30baf52cc2748b0c1a2997d211f18b75b07f5,0,Henry Robinson,2014-01-08 10:44:51-08:00,['7d595ba740fe3320bf69c9c5b3045a3b104b8bcc'],1,2,3,1897695,1,1,1,1,983
1b11130a5d9d24c750f18433a0e0616ce1c40629,1,Henry Robinson,2014-01-08 10:44:51-08:00,['afc30baf52cc2748b0c1a2997d211f18b75b07f5'],10,67,77,1897772,4,0,0,0.977777778,983
bb1db52bdd8f40571ba902fc0f9e1d8d1b4545a4,0,Henry Robinson,2014-01-08 10:44:51-08:00,['1b11130a5d9d24c750f18433a0e0616ce1c40629'],8,5673,5681,1903453,67,0.638376384,0.8200082,0.84501845,1045
43da021a27636012d7adf710ce00498a7b4f672f,0,Henry Robinson,2014-01-08 10:44:54-08:00,['bb1db52bdd8f40571ba902fc0f9e1d8d1b4545a4'],9,6,15,1903468,2,1,1,0,1045
a895803d84ce4219cc2e1b79f01cc851f1329a20,0,Henry Robinson,2014-01-08 10:45:01-08:00,['43da021a27636012d7adf710ce00498a7b4f672f'],0,0,0,1903468,0,,,,1045
126971edbbebd87b6bcbcbe21f9a0443798307f1,1,Henry Robinson,2014-01-08 10:45:04-08:00,['a895803d84ce4219cc2e1b79f01cc851f1329a20'],78,206,284,1903752,8,0,0,0.578313253,1045
cb0685c69fe1d864232784226d9a284187265ac5,0,Henry Robinson,2014-01-08 10:45:04-08:00,['126971edbbebd87b6bcbcbe21f9a0443798307f1'],1,7,8,1903760,1,0,0,1,1045
e7348a209b702418bdb5025cf86ca8ed0aef1a20,1,Henry Robinson,2014-01-08 10:45:04-08:00,['cb0685c69fe1d864232784226d9a284187265ac5'],339,759,1098,1904858,33,1,0,0.952380952,1047
23db0c0605ebe22ada3a850b1811a34cbf3a1397,1,Henry Robinson,2014-01-08 10:45:05-08:00,['e7348a209b702418bdb5025cf86ca8ed0aef1a20'],27,98,125,1904983,1,0.23255814,0,1,1047
42231b7d86da639d90c9fcd2a155b44608e7fada,0,Henry Robinson,2014-01-08 10:45:05-08:00,['23db0c0605ebe22ada3a850b1811a34cbf3a1397'],0,35,35,1905018,21,,,,1047
a55e7777ef2df62c9cf7a1d3f7834734178fd311,0,Henry Robinson,2014-01-08 10:45:05-08:00,['42231b7d86da639d90c9fcd2a155b44608e7fada'],1,30,31,1905049,4,0.25,0,1,1047
f58db2994243249ad2931c06e9874228f3b4b1e5,1,Henry Robinson,2014-01-08 10:45:05-08:00,['a55e7777ef2df62c9cf7a1d3f7834734178fd311'],29,64,93,1905142,3,1,1,1,1047
decf02a1c9cd425e86730d8a0ece5e8b45020e1f,1,Henry Robinson,2014-01-08 10:45:06-08:00,['f58db2994243249ad2931c06e9874228f3b4b1e5'],3,16,19,1905161,3,1,1,1,1047
be33587e1027d2d229a4baa5cd6fd186028fcbca,1,Henry Robinson,2014-01-08 10:45:06-08:00,['decf02a1c9cd425e86730d8a0ece5e8b45020e1f'],28,221,249,1905410,12,0.289719626,0.943925234,1,1047
f08ba42df266bcabdcace225fd7e65eb7dd553ff,1,Henry Robinson,2014-01-08 10:45:06-08:00,['be33587e1027d2d229a4baa5cd6fd186028fcbca'],2,4,6,1905416,1,1,1,1,1047
1b4f318bf2f82f3a4055eb7e65beaa076eecb72d,0,Henry Robinson,2014-01-08 10:45:06-08:00,['f08ba42df266bcabdcace225fd7e65eb7dd553ff'],133,241,374,1905790,2,0.647058824,1,0.745098039,1048
6bf2b3c74ee18c8b51f87343e17165ae8ee0f184,1,Henry Robinson,2014-01-08 10:45:07-08:00,['1b4f318bf2f82f3a4055eb7e65beaa076eecb72d'],1,88,89,1905879,6,1,1,1,1050
a0f0064a2a5f364048d8e511e914d600e171314b,0,Henry Robinson,2014-01-08 10:45:07-08:00,['6bf2b3c74ee18c8b51f87343e17165ae8ee0f184'],9,27,36,1905915,2,,,,1050
067b094b1b14e4eb092445b0a2657b8c5a24e1c1,1,Henry Robinson,2014-01-08 10:45:07-08:00,['a0f0064a2a5f364048d8e511e914d600e171314b'],20,42,62,1905977,4,1,0,0.714285714,1050
0e714f5720ce25ca586ffd355e1adb97bc200f07,1,Henry Robinson,2014-01-08 10:45:07-08:00,['067b094b1b14e4eb092445b0a2657b8c5a24e1c1'],80,370,450,1906427,13,0.301282051,0,0.737179487,1052
6136e2f9c150e27ccda4c8be90919570cb09a230,1,Henry Robinson,2014-01-08 10:45:08-08:00,['0e714f5720ce25ca586ffd355e1adb97bc200f07'],0,2,2,1906429,1,0,1,1,1052
d0dd13053aafeabea29f2fdf5b8bfed4fffa9bae,1,Henry Robinson,2014-01-08 10:45:08-08:00,['6136e2f9c150e27ccda4c8be90919570cb09a230'],68,445,513,1906942,10,0.297297297,0.635135135,0.900900901,1053
5f72b34faa79a586be6eaf023d4bfd66bda9732f,0,Henry Robinson,2014-01-08 10:45:08-08:00,['d0dd13053aafeabea29f2fdf5b8bfed4fffa9bae'],159,206,365,1907307,2,0,0.8,0,1053
073837de79f3528af43c3d501b74bf63eb24fae8,1,Henry Robinson,2014-01-08 10:45:08-08:00,['5f72b34faa79a586be6eaf023d4bfd66bda9732f'],3,3,6,1907313,3,,,,1053
6f83af6efe0f596ef7de3c8c0df7d9d788b46300,0,Henry Robinson,2014-01-08 10:45:09-08:00,['073837de79f3528af43c3d501b74bf63eb24fae8'],3,6,9,1907322,1,0,0,1,1053
f06ca4578c58f9acae368b41ca16d48f1befc51b,0,Henry Robinson,2014-01-08 10:45:09-08:00,['6f83af6efe0f596ef7de3c8c0df7d9d788b46300'],13,13,26,1907348,1,,,,1053
b687f7469fb190c1555c70a02e84548b82fd718d,0,Henry Robinson,2014-01-08 10:45:09-08:00,['f06ca4578c58f9acae368b41ca16d48f1befc51b'],0,0,0,1907348,0,,,,1053
ad46b9836641e16f34891cae7a275208f4d69895,1,Henry Robinson,2014-01-08 10:45:10-08:00,['b687f7469fb190c1555c70a02e84548b82fd718d'],205,2538,2743,1910091,53,0.43792633,0.603001364,0.652114598,1068
2a4ab483eb43de095291c9afb30c57f256507e8c,0,Henry Robinson,2014-01-08 10:45:10-08:00,['ad46b9836641e16f34891cae7a275208f4d69895'],1,2,3,1910094,1,,,,1068
846b5c55bea1ab06cdb05f71f2d8ad02017c67d7,0,Henry Robinson,2014-01-08 10:45:10-08:00,['2a4ab483eb43de095291c9afb30c57f256507e8c'],3,5,8,1910102,1,,,,1068
5f951ffc4a9531b5f067bf73523f87aca5de06a3,1,Henry Robinson,2014-01-08 10:45:11-08:00,['846b5c55bea1ab06cdb05f71f2d8ad02017c67d7'],17,103,120,1910222,9,0.666666667,0.666666667,0.666666667,1068
2788bc07467fe0e8530d0580b46a2869c410ecc2,0,Henry Robinson,2014-01-08 10:45:11-08:00,['5f951ffc4a9531b5f067bf73523f87aca5de06a3'],6,0,6,1910228,1,0,0,0,1068
a9bf44c63f7a224f0c04a5c1579ff30e84076692,1,Henry Robinson,2014-01-08 10:45:11-08:00,['2788bc07467fe0e8530d0580b46a2869c410ecc2'],9,44,53,1910281,5,0,0.709677419,0.967741935,1068
76a4719f09778bffd0aa3fd2df8d18462331de5d,1,Henry Robinson,2014-01-08 10:45:11-08:00,['a9bf44c63f7a224f0c04a5c1579ff30e84076692'],33,118,151,1910432,2,0.476190476,0.523809524,0.928571429,1068
535894ba61169670dff8aa7976d99ab0c668588a,0,Henry Robinson,2014-01-08 10:45:12-08:00,['76a4719f09778bffd0aa3fd2df8d18462331de5d'],4,1,5,1910437,1,1,0.5,0,1068
be51d3f9a2fec9d73790387cca7a7367e4df0ab0,0,Henry Robinson,2014-01-08 10:45:12-08:00,['535894ba61169670dff8aa7976d99ab0c668588a'],0,6,6,1910443,1,1,1,1,1068
ac619f4466f6809fb0c65febbf08cbd8c8218169,1,Henry Robinson,2014-01-08 10:45:12-08:00,['be51d3f9a2fec9d73790387cca7a7367e4df0ab0'],100,169,269,1910712,1,0,0,0.84375,1068
69fcaadd5f8238ac62831eb01de34183c5a4dfa3,1,Henry Robinson,2014-01-08 10:45:12-08:00,['ac619f4466f6809fb0c65febbf08cbd8c8218169'],56,106,162,1910874,8,1,0.388888889,0,1068
8763d5768ddb70ebc40057e8f5073f1edd98c4d5,0,Henry Robinson,2014-01-08 10:45:13-08:00,['69fcaadd5f8238ac62831eb01de34183c5a4dfa3'],9,8,17,1910891,3,0,0,1,1068
e1c0459842400b661574ff607d64328c89b2e501,0,Henry Robinson,2014-01-08 10:45:13-08:00,['8763d5768ddb70ebc40057e8f5073f1edd98c4d5'],41,43,84,1910975,1,0,0,1,1068
5dea5a5fcb9df0817a2b212f3df843c45f66a0f9,0,Henry Robinson,2014-01-08 10:45:13-08:00,['e1c0459842400b661574ff607d64328c89b2e501'],0,1,1,1910976,1,0,0,1,1068
2e93c0b980c8a247aea756b1e2e0b43d27f59642,0,Henry Robinson,2014-01-08 10:45:13-08:00,['5dea5a5fcb9df0817a2b212f3df843c45f66a0f9'],10,51,61,1911037,2,0,1,1,1068
8720de6c07b64b02a7ca05b12114665dab498b7c,0,Henry Robinson,2014-01-08 10:45:14-08:00,['2e93c0b980c8a247aea756b1e2e0b43d27f59642'],9,16,25,1911062,2,,,,1068
2ea454fcdab30afbaf5037c696b4ee0ddfa4b52c,1,Henry Robinson,2014-01-08 10:45:14-08:00,['8720de6c07b64b02a7ca05b12114665dab498b7c'],76,315,391,1911453,20,0.197080292,1,1,1069
ff7933f51b26589e4b733ebb922d6d2bea484c05,0,Henry Robinson,2014-01-08 10:45:14-08:00,['2ea454fcdab30afbaf5037c696b4ee0ddfa4b52c'],13,16,29,1911482,1,1,1,1,1069
f5f528d764bd1121054c5dc780018c51a2cdfc8b,1,Henry Robinson,2014-01-08 10:45:15-08:00,['ff7933f51b26589e4b733ebb922d6d2bea484c05'],37,40,77,1911559,9,0,0,1,1069
bf5ce070d4bdf51d6beabd1318569a58392083a8,1,Henry Robinson,2014-01-08 10:45:15-08:00,['f5f528d764bd1121054c5dc780018c51a2cdfc8b'],232,196,428,1911987,10,0,0,0,1069
eb4f11c1948d06984c1442caba6d2b1510330846,1,Henry Robinson,2014-01-08 10:45:53-08:00,['bf5ce070d4bdf51d6beabd1318569a58392083a8'],2,66,68,1912055,3,1,1,1,1071
5984c0be52ad336be98dc613ef7ba1d833851ed1,1,Henry Robinson,2014-01-08 10:45:56-08:00,['eb4f11c1948d06984c1442caba6d2b1510330846'],878,12775,13653,1925708,70,0.295336788,0.459412781,0.70552677,1093
904d8601d464e929b2199f0fedafce220b305db1,0,Henry Robinson,2014-01-08 10:45:56-08:00,['5984c0be52ad336be98dc613ef7ba1d833851ed1'],0,0,0,1925708,1,,,,1094
a9ff7323f210a3decc44e124ee269b1d0e3099d1,0,Henry Robinson,2014-01-08 10:45:57-08:00,['904d8601d464e929b2199f0fedafce220b305db1'],26,31,57,1925765,3,0,0,0,1094
48c454d3190d1260e48a867d7ed228fc6d7ffc30,0,Henry Robinson,2014-01-08 10:45:57-08:00,['a9ff7323f210a3decc44e124ee269b1d0e3099d1'],0,46,46,1925811,7,0.833333333,1,1,1096
bee5f7485436bd0ba40f5c5372e0f7ba07a036fb,0,Henry Robinson,2014-01-08 10:45:57-08:00,['48c454d3190d1260e48a867d7ed228fc6d7ffc30'],1,1,2,1925813,1,,,,1096
bf57ae27a53ec68b1252bde30a182c2480d454c6,0,Henry Robinson,2014-01-08 10:45:57-08:00,['bee5f7485436bd0ba40f5c5372e0f7ba07a036fb'],27,96,123,1925936,8,0.514285714,0.628571429,0,1096
0c4f025a5e9544a08bc48b8bcb75c832a5186607,0,Henry Robinson,2014-01-08 10:45:58-08:00,['bf57ae27a53ec68b1252bde30a182c2480d454c6'],3,2,5,1925941,2,,,,1096
927f4c52f8ad9fb588447e146fcd41e67b93b87c,1,Henry Robinson,2014-01-08 10:45:58-08:00,['0c4f025a5e9544a08bc48b8bcb75c832a5186607'],356,994,1350,1927291,26,0.290322581,0.182795699,0.956989247,1096
003b05e820dec29a658e2980bc8de126a74613f7,0,Henry Robinson,2014-01-08 10:45:58-08:00,['927f4c52f8ad9fb588447e146fcd41e67b93b87c'],26,56,82,1927373,2,0.916666667,1,1,1096
dd2e58b7f2ccd9b09e486fb7e4149b934466d268,1,Henry Robinson,2014-01-08 10:45:59-08:00,['003b05e820dec29a658e2980bc8de126a74613f7'],222,591,813,1928186,19,0.151162791,0,0.936046512,1098
0c5e41c5d57b8f37a636890bf5ceb92401b81534,1,Henry Robinson,2014-01-08 10:45:59-08:00,['dd2e58b7f2ccd9b09e486fb7e4149b934466d268'],10,51,61,1928247,4,,,,1099
540673763fc72a6a2c6bb1a74391e620279b301e,1,Henry Robinson,2014-01-08 10:45:59-08:00,['0c5e41c5d57b8f37a636890bf5ceb92401b81534'],115,442,557,1928804,21,0.707692308,0.492307692,0.823076923,1100
91c3b979ca63f07aaa8bb033995ef14735833c3c,1,Henry Robinson,2014-01-08 10:45:59-08:00,['540673763fc72a6a2c6bb1a74391e620279b301e'],66,453,519,1929323,15,0.730769231,0.769230769,1,1101
351970152974148fa2e3f9c25590445c4d324184,1,Henry Robinson,2014-01-08 10:46:00-08:00,['91c3b979ca63f07aaa8bb033995ef14735833c3c'],10,67,77,1929400,6,0,1,1,1101
f4aac9239b2020647632cd1e9a95d8ddecdeeb5b,0,Henry Robinson,2014-01-08 10:46:00-08:00,['351970152974148fa2e3f9c25590445c4d324184'],0,3,3,1929403,1,0,0,1,1101
dbf107406633e74a90d71393130d40df2070bdfe,1,Henry Robinson,2014-01-08 10:46:00-08:00,['f4aac9239b2020647632cd1e9a95d8ddecdeeb5b'],35,139,174,1929577,12,0.173913043,0.405797101,0.710144928,1101
c4fc33d0a4537c714f8c20fb9e6105ffcd69e084,0,Henry Robinson,2014-01-08 10:46:00-08:00,['dbf107406633e74a90d71393130d40df2070bdfe'],1,1,2,1929579,1,,,,1101
c5edb8e3d4dbaedb5228f4cb9563c297f431d9f7,0,Henry Robinson,2014-01-08 10:46:01-08:00,['c4fc33d0a4537c714f8c20fb9e6105ffcd69e084'],1,2,3,1929582,1,,,,1101
62f9a2d5348f4d6df0ab15dfba1e7b9d8be8e73b,0,Henry Robinson,2014-01-08 10:46:01-08:00,['c5edb8e3d4dbaedb5228f4cb9563c297f431d9f7'],7,319,326,1929908,3,0.761061947,0.761061947,0.451327434,1103
8d0ee9aebe77da192f6c4556df80e94d85569897,1,Henry Robinson,2014-01-08 10:46:01-08:00,['62f9a2d5348f4d6df0ab15dfba1e7b9d8be8e73b'],146,340,486,1930394,13,0.382978723,0.872340426,0.968085106,1105
0ce8a044e38d16bd3e6f19dfe347f47acb6cedcc,1,Henry Robinson,2014-01-08 10:46:02-08:00,['8d0ee9aebe77da192f6c4556df80e94d85569897'],55,156,211,1930605,17,0.638297872,0.510638298,0.872340426,1107
d3876a3bff444391c43cee680c058ce21e32bd8e,0,Henry Robinson,2014-01-08 10:46:02-08:00,['0ce8a044e38d16bd3e6f19dfe347f47acb6cedcc'],0,2,2,1930607,1,,,,1107
73be676006ce8517a63ffc0b7fde287fd2d90305,0,Henry Robinson,2014-01-08 10:46:02-08:00,['d3876a3bff444391c43cee680c058ce21e32bd8e'],4,49,53,1930660,2,0,1,1,1107
7660daf84e6da5013587831b890ba8eee2b0f572,0,Henry Robinson,2014-01-08 10:46:02-08:00,['73be676006ce8517a63ffc0b7fde287fd2d90305'],28,0,28,1930688,2,,,,1107
f4bbc55fdf7cb545f0d6a635e7aad82ab2ce1824,1,Henry Robinson,2014-01-08 10:46:03-08:00,['7660daf84e6da5013587831b890ba8eee2b0f572'],64,57,121,1930809,19,0,0.75,1,1107
bf3291687cf2bf4566364bfbe43b312b43f1d511,0,Henry Robinson,2014-01-08 10:46:03-08:00,['f4bbc55fdf7cb545f0d6a635e7aad82ab2ce1824'],0,0,0,1930809,0,,,,1107
916d659c0c858773885cb9507f2905d95afde787,0,Henry Robinson,2014-01-08 10:46:05-08:00,['bf3291687cf2bf4566364bfbe43b312b43f1d511'],0,0,0,1930809,0,,,,1107
c93582e9b943a51b0ebb6b2f7bef5fc1571d7a24,0,Henry Robinson,2014-01-08 10:46:08-08:00,['916d659c0c858773885cb9507f2905d95afde787'],0,0,0,1930809,0,,,,1107
8842bf5866d0322dc1a0811ec59835015a60abbe,1,Henry Robinson,2014-01-08 10:46:12-08:00,['c93582e9b943a51b0ebb6b2f7bef5fc1571d7a24'],1,1,2,1930811,1,,,,1107
ae97ec5fd8b18053dc13b62b633ae0e7e085d6ba,0,Henry Robinson,2014-01-08 10:46:12-08:00,['8842bf5866d0322dc1a0811ec59835015a60abbe'],0,10,10,1930821,1,,,,1107
2c3a6806e0d1b0c97486a1050a4ac9d195f20ec7,1,Henry Robinson,2014-01-08 10:46:13-08:00,['ae97ec5fd8b18053dc13b62b633ae0e7e085d6ba'],28,77,105,1930926,6,0.620689655,0.310344828,1,1107
5e6974092c199a585d08f618d24b6002f90a058d,1,Henry Robinson,2014-01-08 10:46:13-08:00,['2c3a6806e0d1b0c97486a1050a4ac9d195f20ec7'],9,9,18,1930944,1,,,,1107
3c3526036638c11934e4f34ba70e7d13740d96b0,1,Henry Robinson,2014-01-08 10:46:13-08:00,['5e6974092c199a585d08f618d24b6002f90a058d'],483,583,1066,1932010,19,0.882352941,0,1,1107
a548a605fdadead44aed825f372f0e24ffb727c8,1,Henry Robinson,2014-01-08 10:46:13-08:00,['3c3526036638c11934e4f34ba70e7d13740d96b0'],9,16,25,1932035,2,0.75,0.75,1,1107
477422beda33cd5454718b369b8741289a28ae45,1,Henry Robinson,2014-01-08 10:46:14-08:00,['a548a605fdadead44aed825f372f0e24ffb727c8'],52,125,177,1932212,6,0,0,0.157894737,1107
3ec95e3226912469d75e1c5bae18aecd23ecd625,1,Henry Robinson,2014-01-08 10:46:14-08:00,['477422beda33cd5454718b369b8741289a28ae45'],121,401,522,1932734,5,0.976470588,0.917647059,0.829411765,1110
e8d83beb23aa1979e091ad8ab9adf1722e704f5e,0,Henry Robinson,2014-01-08 10:46:14-08:00,['3ec95e3226912469d75e1c5bae18aecd23ecd625'],0,6,6,1932740,1,,,,1110
d2442a3b7111daf51d8ef74f70388c60ab56f112,1,Henry Robinson,2014-01-08 10:46:14-08:00,['e8d83beb23aa1979e091ad8ab9adf1722e704f5e'],7,189,196,1932936,3,0.721649485,0.731958763,0.81443299,1111
42b9e96ce1365194ed96730ed1ff87c6e49a2d7e,0,Henry Robinson,2014-01-08 10:46:15-08:00,['231b66f37f44bfc14a2ab5911445d0bf2077495e'],1,1,2,1932938,1,,,,1111
a52322a0a10757fa647b86dcd9415e020397d075,0,Henry Robinson,2014-01-08 10:46:15-08:00,['42b9e96ce1365194ed96730ed1ff87c6e49a2d7e'],1,1,2,1932940,1,,,,1111
25edaae9d78524dbde0d35e4e407b7baa7855cd5,0,Henry Robinson,2014-01-08 10:46:16-08:00,['a52322a0a10757fa647b86dcd9415e020397d075'],9,25,34,1932974,3,0.454545455,0.454545455,0.090909091,1111
1510ad2a31a840c8b9ec34d15b62d3dc8545e072,0,Henry Robinson,2014-01-08 10:46:16-08:00,['25edaae9d78524dbde0d35e4e407b7baa7855cd5'],1,1,2,1932976,1,,,,1111
b3fce13b1dc3c63030c451d93d4c2664754e8e25,1,Henry Robinson,2014-01-08 10:46:16-08:00,['1510ad2a31a840c8b9ec34d15b62d3dc8545e072'],364,1012,1376,1934352,9,0.819935691,0.996784566,0.745980707,1116
16cdab2e9393121fbae4cb23d5bedfc487cc977c,1,Henry Robinson,2014-01-08 10:46:16-08:00,['b3fce13b1dc3c63030c451d93d4c2664754e8e25'],25,89,114,1934466,3,0.557692308,0.711538462,1,1116
5e91fc8ff86223b342ff957673efcb91685f6a20,0,Henry Robinson,2014-01-08 10:46:17-08:00,['16cdab2e9393121fbae4cb23d5bedfc487cc977c'],7,2,9,1934475,2,,,,1116
031db7e6681a5d8f8aefd83fab143c20ab452983,1,Henry Robinson,2014-01-08 10:46:17-08:00,['5e91fc8ff86223b342ff957673efcb91685f6a20'],12,21,33,1934508,4,1,1,1,1116
b4d71b2b8d7014334a77373a9f1567fd13353288,0,Henry Robinson,2014-01-08 10:46:17-08:00,['031db7e6681a5d8f8aefd83fab143c20ab452983'],2,14,16,1934524,2,0.875,0.875,1,1116
37aaf06f79c0f058c20efe1c2be7989c3d847394,1,Henry Robinson,2014-01-08 10:46:18-08:00,['b4d71b2b8d7014334a77373a9f1567fd13353288'],141,132,273,1934797,8,0,0,1,1117
325a2f01ad5b56fc761e494abda0442412806e6d,0,Henry Robinson,2014-01-08 10:46:18-08:00,['37aaf06f79c0f058c20efe1c2be7989c3d847394'],7,8,15,1934812,2,1,1,0.25,1117
85807f6169718ada6d136615a36c33e779696b5f,0,Henry Robinson,2014-01-08 10:46:18-08:00,['325a2f01ad5b56fc761e494abda0442412806e6d'],1,1,2,1934814,1,,,,1117
8f88f5c00ed9995fcc3c73419a438ae50adacb16,0,Henry Robinson,2014-01-08 10:46:18-08:00,['85807f6169718ada6d136615a36c33e779696b5f'],0,1,1,1934815,1,0,0,0,1117
08968c1d07f1fbd3fcef988500cf634eed77705d,1,Henry Robinson,2014-01-08 10:46:19-08:00,['8f88f5c00ed9995fcc3c73419a438ae50adacb16'],92,122,214,1935029,9,0,0,1,1118
859c81627dc5a4f83943be624110e234eb0455cf,0,Henry Robinson,2014-01-08 10:46:19-08:00,['08968c1d07f1fbd3fcef988500cf634eed77705d'],9,15,24,1935053,7,,,,1118
29222af04c3435d330ad14bb434aff4b1cb5c221,0,Henry Robinson,2014-01-08 10:46:19-08:00,['859c81627dc5a4f83943be624110e234eb0455cf'],1,2,3,1935056,1,,,,1118
bc08241ffbac0eec70b12ffc36929c9dbc97550c,0,Henry Robinson,2014-01-08 10:46:19-08:00,['29222af04c3435d330ad14bb434aff4b1cb5c221'],2,12,14,1935070,5,,,,1118
ea050a43ad1f89c4871a3e035e990c0afb1d5809,1,Henry Robinson,2014-01-08 10:46:20-08:00,['bc08241ffbac0eec70b12ffc36929c9dbc97550c'],3498,1426,4924,1939994,68,0.830570902,0.855432781,0.38305709,1119
34cbc13b159f84527de0d486cd1549a80e8b40df,0,Henry Robinson,2014-01-08 10:46:20-08:00,['ea050a43ad1f89c4871a3e035e990c0afb1d5809'],3,13,16,1940010,2,0,0,0,1119
fd77f06f15482be1539669ee543a52751f559cf1,1,Henry Robinson,2014-01-08 10:46:20-08:00,['34cbc13b159f84527de0d486cd1549a80e8b40df'],14230,5346,19576,1959586,30,,,,1119
bd0f35ac2aac63de693e34efd9a98bc1991a2dcf,0,Henry Robinson,2014-01-08 10:46:21-08:00,['fd77f06f15482be1539669ee543a52751f559cf1'],2,1,3,1959589,1,1,1,1,1119
ce8454758f8137028be63d1807b4bce3196c2643,0,Henry Robinson,2014-01-08 10:46:21-08:00,['bd0f35ac2aac63de693e34efd9a98bc1991a2dcf'],3,4,7,1959596,2,,1,,1119
9f91081183f173355d1282e07d1079a036fb8569,0,Henry Robinson,2014-01-08 10:46:21-08:00,['ce8454758f8137028be63d1807b4bce3196c2643'],61,62,123,1959719,9,1,1,1,1119
1451650055dee36796304384c20f0ec835eb1a23,1,Henry Robinson,2014-01-08 10:46:21-08:00,['9f91081183f173355d1282e07d1079a036fb8569'],1283,1833,3116,1962835,7,0.6,0.6,0.6,1119
c1852e2dcfa4240727f7bc05255ec5eede267ed3,1,Henry Robinson,2014-01-08 10:46:22-08:00,['1451650055dee36796304384c20f0ec835eb1a23'],9,133,142,1962977,5,0.113924051,0.607594937,1,1119
e88e4a3ed59bd974cd38bc8f22a1e9ae5f7e3635,0,Henry Robinson,2014-01-08 10:46:22-08:00,['c1852e2dcfa4240727f7bc05255ec5eede267ed3'],2,17,19,1962996,4,1,1,1,1119
def940ebc740656b46ba9f2d6956cc014be41ed7,1,Henry Robinson,2014-01-08 10:46:22-08:00,['e88e4a3ed59bd974cd38bc8f22a1e9ae5f7e3635'],46,169,215,1963211,9,0.253968254,0,0.396825397,1119
0878b8ba9af9405200358c4ddc07548a093f2fb6,0,Henry Robinson,2014-01-08 10:46:22-08:00,['def940ebc740656b46ba9f2d6956cc014be41ed7'],0,1,1,1963212,1,,,,1119
ec6a38a5b06ded87c5f254221f4b1335e211f045,0,Henry Robinson,2014-01-08 10:46:22-08:00,['0878b8ba9af9405200358c4ddc07548a093f2fb6'],5,9,14,1963226,1,0,1,0,1119
de713265ceea17dc2698f3e9be1ee3850f0e29b5,0,Henry Robinson,2014-01-08 10:46:23-08:00,['ec6a38a5b06ded87c5f254221f4b1335e211f045'],3,12,15,1963241,2,1,1,1,1119
d47a15dde9d1b635d10e5efa0ad02c691028d8cb,0,Henry Robinson,2014-01-08 10:46:23-08:00,['de713265ceea17dc2698f3e9be1ee3850f0e29b5'],2,2,4,1963245,1,,,,1119
32a319c88abb8752b740082162ecd17354512447,0,Henry Robinson,2014-01-08 10:46:23-08:00,['d47a15dde9d1b635d10e5efa0ad02c691028d8cb'],2,2,4,1963249,1,,,,1119
dee97f7ff9cbd000ed816a2b7b6a474a840c148d,1,Henry Robinson,2014-01-08 10:46:23-08:00,['32a319c88abb8752b740082162ecd17354512447'],65,111,176,1963425,5,0,0,0.583333333,1119
595edaa9d1969f2eb2ed84d9aee109e7b61752e6,0,Henry Robinson,2014-01-08 10:46:24-08:00,['dee97f7ff9cbd000ed816a2b7b6a474a840c148d'],87,86,173,1963598,9,0,1,1,1119
7ac07a4f3490ff5b9a06de6dff8eaa7e4fdfe342,0,Henry Robinson,2014-01-08 10:46:24-08:00,['595edaa9d1969f2eb2ed84d9aee109e7b61752e6'],12,14,26,1963624,1,1,0,0,1119
af3da01f77f3ca64db4ea0013b6425b503f62d1e,0,Henry Robinson,2014-01-08 10:46:24-08:00,['7ac07a4f3490ff5b9a06de6dff8eaa7e4fdfe342'],2,2,4,1963628,2,,,,1119
e0920e82e85b90d5b435c1afa1533dedc93c08e5,1,Henry Robinson,2014-01-08 10:46:25-08:00,['af3da01f77f3ca64db4ea0013b6425b503f62d1e'],328,577,905,1964533,19,0.310344828,0.075862069,0.124137931,1119
a87d0d97cdd1e218649fdaad47760a6fd104cde4,1,Henry Robinson,2014-01-08 10:46:25-08:00,['e0920e82e85b90d5b435c1afa1533dedc93c08e5'],120,589,709,1965242,24,0.511111111,0.906666667,1,1121
dd0e9f1180dd6847b0c248f35b8f827598b2c696,1,Henry Robinson,2014-01-08 10:46:25-08:00,['a87d0d97cdd1e218649fdaad47760a6fd104cde4'],307,475,782,1966024,25,0.661538462,1,0.953846154,1121
daddd7cb6285def34a3f91b4df47c1be1444b409,1,Henry Robinson,2014-01-08 10:46:25-08:00,['dd0e9f1180dd6847b0c248f35b8f827598b2c696'],14,150,164,1966188,5,0.08974359,0.243589744,0.884615385,1121
17566a66a2134fac37c68c24bc617e5d630a5cfb,1,Henry Robinson,2014-01-08 10:46:26-08:00,['daddd7cb6285def34a3f91b4df47c1be1444b409'],7,67,74,1966262,2,0.305555556,1,1,1121
0a133e67b9832871d4ecb4af6fb679143d3fc8b8,0,Henry Robinson,2014-01-08 10:46:26-08:00,['17566a66a2134fac37c68c24bc617e5d630a5cfb'],5,5,10,1966272,1,,,,1121
11dca590d01a8def05bb6d7fe229aa5fdf39555b,0,Henry Robinson,2014-01-08 10:46:26-08:00,['0a133e67b9832871d4ecb4af6fb679143d3fc8b8'],4,5,9,1966281,2,0,0,1,1121
5acecfb3b14322a9d993cf9ec232b6793b4b233a,1,Henry Robinson,2014-01-08 10:46:26-08:00,['11dca590d01a8def05bb6d7fe229aa5fdf39555b'],41,77,118,1966399,14,1,1,0,1121
f3bd50fdc8b2cd4d19736a83477cffce0af4d4c1,0,Henry Robinson,2014-01-08 10:46:27-08:00,['5acecfb3b14322a9d993cf9ec232b6793b4b233a'],1,4,5,1966404,1,,,,1121
a814ec82042b40a89d525c85332071ebc3dbb017,0,Henry Robinson,2014-01-08 10:46:27-08:00,['f3bd50fdc8b2cd4d19736a83477cffce0af4d4c1'],11,13,24,1966428,1,,,,1121
dcd3c8ecc51578f9b43bcc25d28d243952baa8aa,0,Henry Robinson,2014-01-08 10:46:27-08:00,['a814ec82042b40a89d525c85332071ebc3dbb017'],2,1,3,1966431,1,,,,1121
6463fc21136757bd1a18a013340534aa42be7063,1,Henry Robinson,2014-01-08 10:46:27-08:00,['dcd3c8ecc51578f9b43bcc25d28d243952baa8aa'],10,14,24,1966455,8,0,0,1,1121
816ec799a077f9faa7d258aa0dc99799679cc97c,1,Henry Robinson,2014-01-08 10:46:28-08:00,['6463fc21136757bd1a18a013340534aa42be7063'],3,62,65,1966520,4,0.452380952,0.738095238,1,1121
b0dbc8525cc556283c1a42eb3f3859fe926a7d89,0,Henry Robinson,2014-01-08 10:46:28-08:00,['816ec799a077f9faa7d258aa0dc99799679cc97c'],2,11,13,1966533,1,0,1,1,1121
54317a34eefcdd35d5caf4eb3a42f10f0f007fe1,1,Henry Robinson,2014-01-08 10:46:28-08:00,['b0dbc8525cc556283c1a42eb3f3859fe926a7d89'],10,13,23,1966556,1,0,,,1121
c5ddba42966ca06d1362358dcc20b4af75647a91,0,Henry Robinson,2014-01-08 10:46:29-08:00,['54317a34eefcdd35d5caf4eb3a42f10f0f007fe1'],5,48,53,1966609,4,0.833333333,1,0.583333333,1121
7e87d7125e57f9e6a62e762a6d85b7bdc14ef86b,0,Henry Robinson,2014-01-08 10:46:29-08:00,['c5ddba42966ca06d1362358dcc20b4af75647a91'],2,33,35,1966644,1,1,1,1,1121
86885da3a9839a54dc49fc84a192d931298d8c25,0,Henry Robinson,2014-01-08 10:46:29-08:00,['7e87d7125e57f9e6a62e762a6d85b7bdc14ef86b'],4,4,8,1966652,1,,,,1121
05c65789bb5e99a7bf1cd89860a7da73d675464b,0,Henry Robinson,2014-01-08 10:46:29-08:00,['86885da3a9839a54dc49fc84a192d931298d8c25'],296,296,592,1967244,291,,,,1121
ccb020c4a0510f2ff9d063ab81bd025c4590b2d3,0,Henry Robinson,2014-01-08 10:46:30-08:00,['05c65789bb5e99a7bf1cd89860a7da73d675464b'],1,8,9,1967253,7,,,,1121
a5994c20c7e8de87a758f297b52b3c8ba869a864,0,Henry Robinson,2014-01-08 10:46:30-08:00,['ccb020c4a0510f2ff9d063ab81bd025c4590b2d3'],14,14,28,1967281,14,,,,1121
fd2a36d56f4c43698194eefe348e689bc242b651,0,Henry Robinson,2014-01-08 10:46:30-08:00,['a5994c20c7e8de87a758f297b52b3c8ba869a864'],2,6,8,1967289,1,0,0,1,1121
f32f1b59c9ace6cd1a640593ed0d74f5cff75880,1,Henry Robinson,2014-01-08 10:46:30-08:00,['fd2a36d56f4c43698194eefe348e689bc242b651'],230,264,494,1967783,5,0,0,1,1121
7536510b69e46efca7b9be72f89d48e0753324c7,1,Henry Robinson,2014-01-08 10:46:31-08:00,['f32f1b59c9ace6cd1a640593ed0d74f5cff75880'],1,61,62,1967845,4,1,1,1,1122
f6b3724e19607266aaab9daeaf60860a960d2048,1,Henry Robinson,2014-01-08 10:46:31-08:00,['7536510b69e46efca7b9be72f89d48e0753324c7'],88,117,205,1968050,5,0,0.75,1,1122
7f3573b9aee6a93039e2bec5649157379f85a113,0,Henry Robinson,2014-01-08 10:46:31-08:00,['f6b3724e19607266aaab9daeaf60860a960d2048'],1145,0,1145,1969195,1,,,,1122
2f339f2ed892540992d7e8528f6788c281936e81,0,Henry Robinson,2014-01-08 10:46:32-08:00,['7f3573b9aee6a93039e2bec5649157379f85a113'],516,6376,6892,1976087,461,,,,1122
ed0a98952aaa31422751cfd0eccb56350745a29e,0,Henry Robinson,2014-01-08 10:46:32-08:00,['2f339f2ed892540992d7e8528f6788c281936e81'],1,1,2,1976089,1,,,,1122
64d02efa43e6488f3ec057c35b161d4952df8c24,0,Henry Robinson,2014-01-08 10:46:32-08:00,['ed0a98952aaa31422751cfd0eccb56350745a29e'],2,2,4,1976093,1,,,,1122
b526d1f750353730531ee02a95184a84b382b6b0,1,Henry Robinson,2014-01-08 10:46:33-08:00,['64d02efa43e6488f3ec057c35b161d4952df8c24'],37,47,84,1976177,3,0.142857143,1,1,1122
116241f1d1e0c58800fca3d6519dd44367de65ca,1,Henry Robinson,2014-01-08 10:46:33-08:00,['b526d1f750353730531ee02a95184a84b382b6b0'],3,89,92,1976269,3,0,0,1,1122
0750384b414c9f1c4fc7596e5287e68fe23818e1,0,Henry Robinson,2014-01-08 10:46:33-08:00,['116241f1d1e0c58800fca3d6519dd44367de65ca'],52,6,58,1976327,3,,,,1122
2fda5d9b998ce060e4bac94d3ad6380c672b4d05,1,Henry Robinson,2014-01-08 10:46:33-08:00,['0750384b414c9f1c4fc7596e5287e68fe23818e1'],31,169,200,1976527,9,0.636363636,0.272727273,1,1122
5f314a4d7eeb91d9bcfcb6b10bb851eb9b658384,1,Henry Robinson,2014-01-08 10:46:34-08:00,['2fda5d9b998ce060e4bac94d3ad6380c672b4d05'],10,1344,1354,1977881,4,,,,1124
24a4fafc5120d66107e2b02de66b397ba7a43b68,0,Henry Robinson,2014-01-08 10:46:34-08:00,['5f314a4d7eeb91d9bcfcb6b10bb851eb9b658384'],1,1,2,1977883,1,,,,1124
5a867a90892e873443fe38dcdd0897f1e94d683f,1,Henry Robinson,2014-01-08 10:46:34-08:00,['24a4fafc5120d66107e2b02de66b397ba7a43b68'],1,7,8,1977891,1,,,,1124
8a5297a5262d3297c7753da816c6469ecf1f2982,1,Henry Robinson,2014-01-08 10:46:35-08:00,['5a867a90892e873443fe38dcdd0897f1e94d683f'],51,617,668,1978559,38,0.53125,0.421875,0.5625,1132
8e63db4faa208776281de6761c0897a3daf96311,0,Henry Robinson,2014-01-08 10:46:35-08:00,['8a5297a5262d3297c7753da816c6469ecf1f2982'],6,102,108,1978667,3,0.233333333,1,0.9,1133
28897e1ab3cd644a33af3caa6574d80789556ffe,1,Henry Robinson,2014-01-08 10:46:35-08:00,['8e63db4faa208776281de6761c0897a3daf96311'],0,13,13,1978680,1,0,1,1,1133
432a7631afa0f4e9217c13b18408a6c80175663c,1,Henry Robinson,2014-01-08 10:46:35-08:00,['28897e1ab3cd644a33af3caa6574d80789556ffe'],3,3,6,1978686,3,,,,1133
3a5a358892f3114d9dddc68e6cb2abfc66f08863,0,Henry Robinson,2014-01-08 10:46:36-08:00,['432a7631afa0f4e9217c13b18408a6c80175663c'],5,13,18,1978704,3,0,0.5,0.5,1133
dfe7690add4fe6cb47eff11999b8e3ad8fa0d471,0,Henry Robinson,2014-01-08 10:46:36-08:00,['3a5a358892f3114d9dddc68e6cb2abfc66f08863'],33,72,105,1978809,6,0.833333333,1,0,1133
23be49f55890361979a5577cb501619f97d71c73,0,Henry Robinson,2014-01-08 10:46:36-08:00,['dfe7690add4fe6cb47eff11999b8e3ad8fa0d471'],11,31,42,1978851,2,0,1,1,1133
9b3667f424abe4eff7418c5a102f0ba00794f736,0,Henry Robinson,2014-01-08 10:46:36-08:00,['23be49f55890361979a5577cb501619f97d71c73'],0,0,0,1978851,0,,,,1133
df88e1ac7ad6d5d81225433412288afe72245a9c,0,Henry Robinson,2014-01-08 10:46:37-08:00,['9b3667f424abe4eff7418c5a102f0ba00794f736'],0,0,0,1978851,0,,,,1133
3d246590904b281f7c250c48121959766d9252ab,1,Henry Robinson,2014-01-08 10:46:37-08:00,['df88e1ac7ad6d5d81225433412288afe72245a9c'],4,6,10,1978861,2,1,1,1,1133
35e7e2a7a927b5dc29ac0556d23ed3fda9302897,0,Henry Robinson,2014-01-08 10:46:38-08:00,['3d246590904b281f7c250c48121959766d9252ab'],29,44,73,1978934,7,,,,1133
66be79e762a26776ffec10dade5e56a2073dfe95,0,Henry Robinson,2014-01-08 10:46:40-08:00,['35e7e2a7a927b5dc29ac0556d23ed3fda9302897'],1,5,6,1978940,1,0,1,1,1133
a5a9ccf8c27a929952d5d0aa437ec0aa9487a803,1,Henry Robinson,2014-01-08 10:46:41-08:00,['66be79e762a26776ffec10dade5e56a2073dfe95'],4,52,56,1978996,2,0,0,1,1133
c260fffc571956c13d858c94f9f2738231c07d4a,1,Henry Robinson,2014-01-08 10:46:42-08:00,['a5a9ccf8c27a929952d5d0aa437ec0aa9487a803'],14,39,53,1979049,7,0,0,0.684210526,1133
977df7475f40318873b81c17e53db2c699718e5a,1,Henry Robinson,2014-01-08 10:46:42-08:00,['c260fffc571956c13d858c94f9f2738231c07d4a'],25,39,64,1979113,21,0.714285714,0.714285714,0.714285714,1133
d4d3dde484e38c7fa23a6be2c1b00c22b599d34b,0,Henry Robinson,2014-01-08 10:46:42-08:00,['977df7475f40318873b81c17e53db2c699718e5a'],1,1,2,1979115,1,,,,1133
df0617bc83f6bb529dbe8906bfec9bd2e748b6ed,0,Henry Robinson,2014-01-08 10:46:43-08:00,['d4d3dde484e38c7fa23a6be2c1b00c22b599d34b'],4,1,5,1979120,2,,,,1133
b22b565a9268b8b64a683befc3ba7274a76cc348,1,Henry Robinson,2014-01-08 10:46:43-08:00,['df0617bc83f6bb529dbe8906bfec9bd2e748b6ed'],9,36,45,1979165,3,0,0,1,1133
41dc55b6664fa431912c0271fd8c6c08bef7f71b,1,Henry Robinson,2014-01-08 10:46:43-08:00,['b22b565a9268b8b64a683befc3ba7274a76cc348'],53,93,146,1979311,7,1,1,0,1135
229c2adb71e00897d83bc574edb75576295375f8,0,Henry Robinson,2014-01-08 10:46:44-08:00,['41dc55b6664fa431912c0271fd8c6c08bef7f71b'],0,4,4,1979315,1,1,1,1,1135
18762f9e9e63843358a3def5e5e6ea4736f2b379,0,Henry Robinson,2014-01-08 10:46:44-08:00,['229c2adb71e00897d83bc574edb75576295375f8'],0,23,23,1979338,3,0.157894737,1,1,1135
d3ada0c9e03a406e9d5f62b8225cfd782102ff0b,1,Henry Robinson,2014-01-08 10:46:44-08:00,['18762f9e9e63843358a3def5e5e6ea4736f2b379'],539,16,555,1979893,13,0.896713615,0.577464789,0.093896714,1135
34879a4ddc4d37165015142f1639521a663f8bb2,1,Henry Robinson,2014-01-08 10:46:44-08:00,['d3ada0c9e03a406e9d5f62b8225cfd782102ff0b'],13,91,104,1979997,10,0,0.791666667,0.5,1135
d226d2b7822083243d2f0aaf3c57fad7358055f8,1,Henry Robinson,2014-01-08 10:46:45-08:00,['34879a4ddc4d37165015142f1639521a663f8bb2'],161,183,344,1980341,8,1,0,0,1135
adf36b81f9c2668fd59691b63fae46d33f723930,0,Henry Robinson,2014-01-08 10:46:45-08:00,['d226d2b7822083243d2f0aaf3c57fad7358055f8'],13,21,34,1980375,4,,,,1135
b4dc3eeb35805d44b64d804cf42484eb01b543a5,1,Henry Robinson,2014-01-08 10:46:45-08:00,['adf36b81f9c2668fd59691b63fae46d33f723930'],1,50,51,1980426,2,,,,1135
ea546d38293e4f372978b93a5d47a523cba8c6d9,1,Henry Robinson,2014-01-08 10:46:45-08:00,['b4dc3eeb35805d44b64d804cf42484eb01b543a5'],4,40,44,1980470,2,0.647058824,1,0.764705882,1136
5364767d5f170e26da8a2651444f74dcb700ce69,0,Henry Robinson,2014-01-08 10:46:46-08:00,['ea546d38293e4f372978b93a5d47a523cba8c6d9'],0,249,249,1980719,2,0.540540541,1,1,1137
03b9b8acb69e408e1efbcae82af5f78e61f03a3e,0,Henry Robinson,2014-01-08 10:46:46-08:00,['5364767d5f170e26da8a2651444f74dcb700ce69'],4,4,8,1980727,3,,,,1137
10a1c066d79ddb2e170a7f1e6fbe9b14e65e3042,1,Henry Robinson,2014-01-08 10:46:46-08:00,['03b9b8acb69e408e1efbcae82af5f78e61f03a3e'],155,217,372,1981099,12,1,1,0,1137
997df15b69a6fc7f2241faa2dcca278d6e096594,1,Henry Robinson,2014-01-08 10:46:48-08:00,['10a1c066d79ddb2e170a7f1e6fbe9b14e65e3042'],18,39,57,1981156,4,1,1,1,1137
b4ee5ef0062aac49a86554c6d6529b300f6f0905,1,Henry Robinson,2014-01-08 10:46:48-08:00,['997df15b69a6fc7f2241faa2dcca278d6e096594'],4,66,70,1981226,3,0.172413793,0.75862069,0.75862069,1138
1e25c98fb421445b0dcd81d1fbd96eaa675851c4,1,Henry Robinson,2014-01-08 10:46:49-08:00,['b4ee5ef0062aac49a86554c6d6529b300f6f0905'],708,33843,34551,2015777,15,0,0,0.135135135,1146
46054386f56163f4a26536a14f23fdb88eeb0831,0,Henry Robinson,2014-01-08 10:46:49-08:00,['1e25c98fb421445b0dcd81d1fbd96eaa675851c4'],12,29,41,2015818,1,0,0,0.8,1146
0098b46907060db5dadfb042888a2968ebdee7d4,1,Henry Robinson,2014-01-08 10:46:49-08:00,['46054386f56163f4a26536a14f23fdb88eeb0831'],27,33,60,2015878,3,,,,1146
12782648939a65b61640f175c60fb44a10218814,0,Henry Robinson,2014-01-08 10:46:49-08:00,['0098b46907060db5dadfb042888a2968ebdee7d4'],2,10,12,2015890,1,0,1,1,1146
ef48f65e76d46b73ac7f328c6c810cdc4834a87e,1,Henry Robinson,2014-01-08 10:46:50-08:00,['12782648939a65b61640f175c60fb44a10218814'],483,1888,2371,2018261,81,0.916442049,0.760107817,0.706199461,1159
febdb112f480f0fdaaf40a99bad6faf244df2b69,0,Henry Robinson,2014-01-08 10:46:50-08:00,['ef48f65e76d46b73ac7f328c6c810cdc4834a87e'],5,5,10,2018271,2,,,,1159
f6af9316d99dae9dea049a68fde0ed11884da86a,1,Henry Robinson,2014-01-08 10:46:50-08:00,['febdb112f480f0fdaaf40a99bad6faf244df2b69'],628,1111,1739,2020010,20,0.55,1,0,1161
97380676d87cd12eb69dd9e58d2c7a6ee8173f3a,0,Henry Robinson,2014-01-08 10:46:50-08:00,['f6af9316d99dae9dea049a68fde0ed11884da86a'],15,31,46,2020056,5,1,1,1,1161
28c2f9ed365a3a3646aa690ff36de9a6961b54fb,1,Henry Robinson,2014-01-08 10:46:51-08:00,['97380676d87cd12eb69dd9e58d2c7a6ee8173f3a'],3,100,103,2020159,3,0.293103448,1,1,1162
f05dc4e1b53050c683ccdaf2a96134a9c31487c1,1,Henry Robinson,2014-01-08 10:46:51-08:00,['28c2f9ed365a3a3646aa690ff36de9a6961b54fb'],32,568,600,2020759,5,0.318181818,0.975524476,1,1163
ec07adf6eea350dc2aa38cd30f58e5768fe8edbd,0,Henry Robinson,2014-01-08 10:46:51-08:00,['f05dc4e1b53050c683ccdaf2a96134a9c31487c1'],1,4,5,2020764,1,0,0,1,1163
29b2d0c8961cf84f6ab1b51b2c53bf9ce8971ef1,0,Henry Robinson,2014-01-08 10:46:52-08:00,['ec07adf6eea350dc2aa38cd30f58e5768fe8edbd'],1,1,2,2020766,1,,,,1163
1b248d067bbcc9214f61ef0db3a0930778ac6f52,1,Henry Robinson,2014-01-08 10:46:52-08:00,['29b2d0c8961cf84f6ab1b51b2c53bf9ce8971ef1'],3,1678,1681,2022447,19,1,1,1,1179
61b1be359ce9010ab974ffc28b221cac365aff43,0,Henry Robinson,2014-01-08 10:46:52-08:00,['1b248d067bbcc9214f61ef0db3a0930778ac6f52'],7,11,18,2022465,2,0.5,0.5,0.5,1179
a035cf4e73eca94262f0dc5b64a796e244e1a6d9,0,Henry Robinson,2014-01-08 10:46:52-08:00,['61b1be359ce9010ab974ffc28b221cac365aff43'],661,661,1322,2023787,4,,,,1179
bed633c1aedac9103dbd1c1ed319796af37dc9e9,1,Henry Robinson,2014-01-08 10:46:53-08:00,['a035cf4e73eca94262f0dc5b64a796e244e1a6d9'],120,227,347,2024134,12,1,1,0.5,1181
837f35eab3b69a8362cf1d7c6c13e15839d7827a,1,Henry Robinson,2014-01-08 10:46:53-08:00,['bed633c1aedac9103dbd1c1ed319796af37dc9e9'],452,462,914,2025048,10,0,0.8,0.4,1181
36a8d4bcb16f3c98d36633e40c23a271b86d8b6c,1,Henry Robinson,2014-01-08 10:46:53-08:00,['837f35eab3b69a8362cf1d7c6c13e15839d7827a'],1,11,12,2025060,1,0,0,1,1181
b7c348edfa6bf0df24f2350342b3142442665b24,0,Henry Robinson,2014-01-08 10:46:54-08:00,['36a8d4bcb16f3c98d36633e40c23a271b86d8b6c'],3,3,6,2025066,1,,,,1181
fbfef4e22e24e4b562c2de3cd1dd20585888b256,1,Henry Robinson,2014-01-08 10:46:54-08:00,['b7c348edfa6bf0df24f2350342b3142442665b24'],13,46,59,2025125,4,1,1,0,1181
ccfc84fd6a4e25be3473c27839f8a0691decb2a7,1,Henry Robinson,2014-01-08 10:46:54-08:00,['fbfef4e22e24e4b562c2de3cd1dd20585888b256'],9,24,33,2025158,2,,,,1181
25147054a5e0fd1496bb90d8c7f4eced02aaa999,0,Henry Robinson,2014-01-08 10:46:55-08:00,['ccfc84fd6a4e25be3473c27839f8a0691decb2a7'],0,6,6,2025164,1,0,0,1,1181
9953224f68e973caad8709281211211b508d0c21,0,Henry Robinson,2014-01-08 10:46:55-08:00,['25147054a5e0fd1496bb90d8c7f4eced02aaa999'],63,2,65,2025229,11,,,,1181
12de941c744907c882defe468a7a8414dd76f9d5,0,Henry Robinson,2014-01-08 10:46:55-08:00,['9953224f68e973caad8709281211211b508d0c21'],8,0,8,2025237,1,,,,1181
2c12200395d6eb2de91f2d17968a5d982393b759,0,Henry Robinson,2014-01-08 10:46:55-08:00,['12de941c744907c882defe468a7a8414dd76f9d5'],8,19,27,2025264,3,,,,1182
155e08cf0840e733bbc8ae242876555f1e1dd7bd,0,Henry Robinson,2014-01-08 10:46:56-08:00,['2c12200395d6eb2de91f2d17968a5d982393b759'],1,4,5,2025269,1,,,,1182
b126105fca2eef83d59dff64c3f3116684972fab,0,Henry Robinson,2014-01-08 10:46:56-08:00,['155e08cf0840e733bbc8ae242876555f1e1dd7bd'],19,29,48,2025317,3,0,0,0.571428571,1182
2289906a5a535e39b898016e83bd1d6c5ef6db85,0,Henry Robinson,2014-01-08 10:46:56-08:00,['b126105fca2eef83d59dff64c3f3116684972fab'],45,18,63,2025380,8,,,,1182
18882eb676ea09c0020ed595ed1ef07db2a0e847,0,Henry Robinson,2014-01-08 10:46:56-08:00,['2289906a5a535e39b898016e83bd1d6c5ef6db85'],1,1,2,2025382,1,,,,1182
476a665763bd86af25cbd12044879e7b1a93eb17,1,Henry Robinson,2014-01-08 10:46:57-08:00,['18882eb676ea09c0020ed595ed1ef07db2a0e847'],613,654,1267,2026649,14,0,0.966666667,1,1182
4ffa68df606eb2163ae2ea5d78d1e7fbac764f05,1,Henry Robinson,2014-01-08 10:46:57-08:00,['476a665763bd86af25cbd12044879e7b1a93eb17'],7,7,14,2026663,1,1,1,0,1182
30dbf59ef2b69200913d25ede38cd36b72945af2,1,Henry Robinson,2014-01-08 10:46:57-08:00,['4ffa68df606eb2163ae2ea5d78d1e7fbac764f05'],76,201,277,2026940,19,0.814814815,0.814814815,0.814814815,1184
15228f945f1ad5ce86ae16bf28baf4791e9836aa,0,Henry Robinson,2014-01-08 10:46:57-08:00,['30dbf59ef2b69200913d25ede38cd36b72945af2'],64,76,140,2027080,5,1,0,0,1184
f7cbf6046281b9c527fcf89d1a06be5a74dc6318,0,Henry Robinson,2014-01-08 10:46:58-08:00,['15228f945f1ad5ce86ae16bf28baf4791e9836aa'],1,1,2,2027082,1,,,,1184
f8953ee8e6019d68d8c7764234af2759f79eaa56,0,Henry Robinson,2014-01-08 10:46:58-08:00,['f7cbf6046281b9c527fcf89d1a06be5a74dc6318'],3,9,12,2027094,2,,,,1184
e20720f5d3ebeeaa0f244b0d0ef8882cedf45411,0,Henry Robinson,2014-01-08 10:46:58-08:00,['f8953ee8e6019d68d8c7764234af2759f79eaa56'],1,4,5,2027099,2,,,,1184
6cea14f02423e0b45544f9acd1147369c0b352a2,0,Henry Robinson,2014-01-08 10:46:59-08:00,['e20720f5d3ebeeaa0f244b0d0ef8882cedf45411'],3,4,7,2027106,1,0,0,1,1184
e3ddb1f46402d0c0a8ad7fdf71b32bca3b8cc03f,1,Henry Robinson,2014-01-08 10:46:59-08:00,['6cea14f02423e0b45544f9acd1147369c0b352a2'],32,118,150,2027256,13,0,0,0.74,1184
34863b33b74fc8c1160e9b3572048c170608dd92,0,Henry Robinson,2014-01-08 10:46:59-08:00,['e3ddb1f46402d0c0a8ad7fdf71b32bca3b8cc03f'],7,3,10,2027266,1,0,0,1,1184
77519df4237c3e0cde05cc56d6d2119cae94f92f,0,Henry Robinson,2014-01-08 10:46:59-08:00,['34863b33b74fc8c1160e9b3572048c170608dd92'],0,1097,1097,2028363,8,0.660025707,0.773136247,0.971722365,1192
0dbd8317a9923d8ab4001484c0ac64250634ee60,1,Henry Robinson,2014-01-08 10:47:00-08:00,['77519df4237c3e0cde05cc56d6d2119cae94f92f'],16,82,98,2028461,4,0,0.565217391,0.565217391,1192
a9045374fc916466aa961a7ab906311a861b4ec4,1,Henry Robinson,2014-01-08 10:47:00-08:00,['0dbd8317a9923d8ab4001484c0ac64250634ee60'],83,348,431,2028892,11,0.2,0.51875,1,1192
0d41ed563c30f22f2cda6de0153ce0cf6cfc3931,0,Henry Robinson,2014-01-08 10:47:00-08:00,['a9045374fc916466aa961a7ab906311a861b4ec4'],0,6,6,2028898,1,0,0.25,1,1192
bb66609b6d926c22eae4a584f67040bedf09a617,1,Henry Robinson,2014-01-08 10:47:00-08:00,['0d41ed563c30f22f2cda6de0153ce0cf6cfc3931'],10,13,23,2028921,1,0,0.2,1,1192
ac1cb5dfcb3d319edd2525f498f1f416170fa851,1,Henry Robinson,2014-01-08 10:47:01-08:00,['bb66609b6d926c22eae4a584f67040bedf09a617'],13,46,59,2028980,3,1,1,0.307692308,1192
d85f66477271bf6ebd1591f73d1814a88285bc7b,0,Henry Robinson,2014-01-08 10:47:01-08:00,['ac1cb5dfcb3d319edd2525f498f1f416170fa851'],1,1,2,2028982,1,,,,1192
1fcf094d67138427e8df7042e0d922296078a192,1,Henry Robinson,2014-01-08 10:47:01-08:00,['d85f66477271bf6ebd1591f73d1814a88285bc7b'],9,133,142,2029124,2,0.670731707,0.5,0.585365854,1192
b575b08357ee0d70f29722a83b450c4baa56734f,1,Henry Robinson,2014-01-08 10:47:01-08:00,['1fcf094d67138427e8df7042e0d922296078a192'],13,73,86,2029210,4,0.34375,1,1,1193
7d83a2f9f34057172b40f5f2ca1b30288af592b0,0,Henry Robinson,2014-01-08 10:47:02-08:00,['b575b08357ee0d70f29722a83b450c4baa56734f'],5,109,114,2029324,7,0.384615385,0.692307692,1,1195
b26f394624a5e3d0fdf2cc5203b35447fa418b40,1,Henry Robinson,2014-01-08 10:47:02-08:00,['7d83a2f9f34057172b40f5f2ca1b30288af592b0'],1,7,8,2029332,1,1,1,1,1195
d5687d2e9cd083bed7c6ff04cdf165ade4e91c00,0,Henry Robinson,2014-01-08 10:47:02-08:00,['b26f394624a5e3d0fdf2cc5203b35447fa418b40'],2,2,4,2029336,1,,,,1195
ddf6fab0560f5a948addb72e8057f1f377f05c3e,1,Henry Robinson,2014-01-08 10:47:03-08:00,['d5687d2e9cd083bed7c6ff04cdf165ade4e91c00'],33,94,127,2029463,9,0,0.6875,0.5625,1195
f46c654e0172fede2106e85295292c19d019ce40,0,Henry Robinson,2014-01-08 10:47:03-08:00,['ddf6fab0560f5a948addb72e8057f1f377f05c3e'],98,91,189,2029652,3,,,,1195
cdc3e16cf7caf37ec4f79ca2809ca4c09b16318b,1,Henry Robinson,2014-01-08 10:47:03-08:00,['f46c654e0172fede2106e85295292c19d019ce40'],2,36,38,2029690,1,0.76,1,1,1195
15dfd968fb617ba6227946319ddc8ab12f3bc054,0,Henry Robinson,2014-01-08 10:47:03-08:00,['cdc3e16cf7caf37ec4f79ca2809ca4c09b16318b'],2,4,6,2029696,2,,,,1195
c265faade2441652112c148a0fd73eebb9e84399,0,Henry Robinson,2014-01-08 10:47:04-08:00,['15dfd968fb617ba6227946319ddc8ab12f3bc054'],3,13,16,2029712,3,1,1,1,1195
b19dc9c711f3adf6a24f0325fb86153eca9d1a48,0,Henry Robinson,2014-01-08 10:47:04-08:00,['c265faade2441652112c148a0fd73eebb9e84399'],1,3,4,2029716,1,,,,1195
e0525b515c4e49c83d43af12ea756c31beabe7c9,1,Henry Robinson,2014-01-08 10:47:04-08:00,['b19dc9c711f3adf6a24f0325fb86153eca9d1a48'],15,19,34,2029750,4,0.153846154,0.153846154,1,1195
bf56c21c1ba0a79368b5d92a84a6fbe82df956d2,1,Henry Robinson,2014-01-08 10:47:04-08:00,['e0525b515c4e49c83d43af12ea756c31beabe7c9'],30,39,69,2029819,7,0.166666667,0.333333333,0,1195
7a4012e15aa72704c0e87822bc65e23f2736ab07,1,Henry Robinson,2014-01-08 10:47:05-08:00,['bf56c21c1ba0a79368b5d92a84a6fbe82df956d2'],5,50,55,2029874,2,0.777777778,0.777777778,0.777777778,1196
fc41474f9ee057f259f7b4edffa7da17707a8466,1,Henry Robinson,2014-01-08 10:47:05-08:00,['7a4012e15aa72704c0e87822bc65e23f2736ab07'],3,6,9,2029883,1,0,0,0,1196
ef9a5c2d0ea085a03c39827bdde7fe6a8172dd1a,0,Henry Robinson,2014-01-08 10:47:05-08:00,['fc41474f9ee057f259f7b4edffa7da17707a8466'],26,87,113,2029996,4,0.96969697,1,0.757575758,1196
45c1cbe1fdf51699442192fdc4ec4cb1033fff87,0,Henry Robinson,2014-01-08 10:47:05-08:00,['ef9a5c2d0ea085a03c39827bdde7fe6a8172dd1a'],1,1,2,2029998,1,,,,1196
c806738af2f27203fd19273c02f6d30123c2938d,1,Henry Robinson,2014-01-08 10:47:06-08:00,['45c1cbe1fdf51699442192fdc4ec4cb1033fff87'],22,60,82,2030080,3,1,1,1,1197
5269915fe78fde4b0ab78326766fa15a08399485,0,Henry Robinson,2014-01-08 10:47:06-08:00,['c806738af2f27203fd19273c02f6d30123c2938d'],0,2,2,2030082,1,,,,1197
adf6607db61a12efe8e83339b745b2db601ee555,0,Henry Robinson,2014-01-08 10:47:06-08:00,['5269915fe78fde4b0ab78326766fa15a08399485'],29,33,62,2030144,2,0,0,0,1197
a954ff621afc15812b5876b18d05f8b66ada03e4,0,Henry Robinson,2014-01-08 10:47:07-08:00,['adf6607db61a12efe8e83339b745b2db601ee555'],1,1,2,2030146,1,,,,1197
12d18631e383e76a8bbcfb62cb75f52827846afb,1,Henry Robinson,2014-01-08 10:47:07-08:00,['a954ff621afc15812b5876b18d05f8b66ada03e4'],71,147,218,2030364,19,0.58974359,0.461538462,0.974358974,1197
5869611fb864752d33f58c0d2889a5cdcb00287a,1,Henry Robinson,2014-01-08 10:47:07-08:00,['12d18631e383e76a8bbcfb62cb75f52827846afb'],35,134,169,2030533,3,1,1,1,1198
c060086062808712a5ca6cd02260a0a56559819c,0,Henry Robinson,2014-01-08 10:47:07-08:00,['5869611fb864752d33f58c0d2889a5cdcb00287a'],2,2,4,2030537,1,,,,1198
c8663f8dd88dbba8f6cb56e3b4c7440c23feda44,0,Henry Robinson,2014-01-08 10:47:08-08:00,['c060086062808712a5ca6cd02260a0a56559819c'],3,2,5,2030542,1,,,,1198
cd0bea9cd74cca65f8471e45c5c2a3cf042a8c38,0,Henry Robinson,2014-01-08 10:47:08-08:00,['c8663f8dd88dbba8f6cb56e3b4c7440c23feda44'],1,1,2,2030544,1,,,,1198
ae75564d3e2d83f6ca525e74c86ce62dda2478e4,0,Henry Robinson,2014-01-08 10:47:08-08:00,['cd0bea9cd74cca65f8471e45c5c2a3cf042a8c38'],7,8,15,2030559,5,,,,1198
c138b8c613cbe9565dc891199d71cb5762f4f66c,0,Henry Robinson,2014-01-08 10:47:08-08:00,['ae75564d3e2d83f6ca525e74c86ce62dda2478e4'],2,3,5,2030564,1,,,,1198
4573f515edc4aa5e5c4b5d9f9882d7031273e768,0,Henry Robinson,2014-01-08 10:47:09-08:00,['c138b8c613cbe9565dc891199d71cb5762f4f66c'],1,3,4,2030568,1,,,,1198
982747c85620848c65ae0957220765a681b121b6,0,Henry Robinson,2014-01-08 10:47:09-08:00,['4573f515edc4aa5e5c4b5d9f9882d7031273e768'],1,6,7,2030575,2,0,1,1,1198
270124d44ed84d190b8fa9433d50f687f416dd86,0,Henry Robinson,2014-01-08 10:47:09-08:00,['982747c85620848c65ae0957220765a681b121b6'],1,12,13,2030588,1,0,1,1,1198
ea40a3078dbb3a9fba4d0d67edb8e3c1dfa57009,0,Henry Robinson,2014-01-08 10:47:09-08:00,['270124d44ed84d190b8fa9433d50f687f416dd86'],14,19,33,2030621,5,,,,1198
e10960b2c997c757aae9a4e80a1479400f7b4645,0,Henry Robinson,2014-01-08 10:47:10-08:00,['ea40a3078dbb3a9fba4d0d67edb8e3c1dfa57009'],22,7,29,2030650,10,,,,1198
deea7a86b9557011e0682366ab0a27e41ef65fcb,0,Henry Robinson,2014-01-08 10:47:10-08:00,['e10960b2c997c757aae9a4e80a1479400f7b4645'],5,6,11,2030661,3,1,1,1,1198
9d981984e77b252ae08e260c740b45c60238be32,0,Henry Robinson,2014-01-08 10:47:10-08:00,['deea7a86b9557011e0682366ab0a27e41ef65fcb'],45,39,84,2030745,1,,,,1198
63745c749e6f6b7ed2f1a878e42ec0c380042127,1,Henry Robinson,2014-01-08 10:47:11-08:00,['9d981984e77b252ae08e260c740b45c60238be32'],33,87,120,2030865,8,0.647058824,0,1,1198
06cb224a6fde3a7b519065c4b82add42ec5b9f34,0,Henry Robinson,2014-01-08 10:47:11-08:00,['63745c749e6f6b7ed2f1a878e42ec0c380042127'],0,0,0,2030865,0,,,,1198
5adef2c6d3291544d6eda344216008eda62bbb5c,1,Henry Robinson,2014-01-08 10:47:11-08:00,['06cb224a6fde3a7b519065c4b82add42ec5b9f34'],114,226,340,2031205,16,0.105263158,0.736842105,1,1200
02c329b97ab6020f41e68fa473ac298b6308ec01,1,Henry Robinson,2014-01-08 10:47:11-08:00,['5adef2c6d3291544d6eda344216008eda62bbb5c'],1284,878,2162,2033367,23,0.874538745,0.483394834,0.435424354,1202
986f3cddf651f434d42513bca8ccfe684909bb22,0,Henry Robinson,2014-01-08 10:47:12-08:00,['02c329b97ab6020f41e68fa473ac298b6308ec01'],416,316,732,2034099,36,,,,1202
b7f937577d341bc227995d13165b012b0647ad4f,0,Henry Robinson,2014-01-08 10:47:12-08:00,['986f3cddf651f434d42513bca8ccfe684909bb22'],0,49,49,2034148,1,,,,1203
664928060ca22632ab26eecf76dc7f34abfae71f,1,Henry Robinson,2014-01-08 10:47:12-08:00,['b7f937577d341bc227995d13165b012b0647ad4f'],15,55,70,2034218,6,0.3125,1,0,1203
20f9d463289feb6b174b030b9288d80056c3dd1b,1,Henry Robinson,2014-01-08 10:47:12-08:00,['664928060ca22632ab26eecf76dc7f34abfae71f'],28,75,103,2034321,7,1,1,0,1204
ff704ce5866617eac8678cc8cd84811b32202741,0,Henry Robinson,2014-01-08 10:47:13-08:00,['20f9d463289feb6b174b030b9288d80056c3dd1b'],2,17,19,2034340,4,0,1,1,1204
0387bb92bf6074be8eaec82f54ffbbc4942f916d,1,Henry Robinson,2014-01-08 10:47:13-08:00,['ff704ce5866617eac8678cc8cd84811b32202741'],57,97,154,2034494,3,0.7,0,0,1205
86525c00fe5925f796e1c3a2c93c0a89e2990d3c,0,Henry Robinson,2014-01-08 10:47:13-08:00,['0387bb92bf6074be8eaec82f54ffbbc4942f916d'],8,26,34,2034528,3,,,,1206
4feec31b376c67220fb6f9597226009dce729ad3,0,Henry Robinson,2014-01-08 10:47:14-08:00,['86525c00fe5925f796e1c3a2c93c0a89e2990d3c'],0,0,0,2034528,0,,,,1206
717152bc96e956100ae63e7a5514e22a5275652f,0,Henry Robinson,2014-01-08 10:47:14-08:00,['4feec31b376c67220fb6f9597226009dce729ad3'],0,0,0,2034528,0,,,,1206
ec02c872846eadd066b5a18ee6203cef5c1cfb9a,0,Henry Robinson,2014-01-08 10:47:16-08:00,['717152bc96e956100ae63e7a5514e22a5275652f'],0,0,0,2034528,0,,,,1206
a7e1a2e00db93678762770a30a0a7900e9582908,0,Henry Robinson,2014-01-08 10:47:17-08:00,['ec02c872846eadd066b5a18ee6203cef5c1cfb9a'],0,0,0,2034528,0,,,,1206
033ade88edd6ec527f3791d86273295068237fc5,0,Henry Robinson,2014-01-08 10:47:18-08:00,['a7e1a2e00db93678762770a30a0a7900e9582908'],0,0,0,2034528,0,,,,1206
b1b2e659af5778892d33f7da53faea28999d552d,1,Henry Robinson,2014-01-08 10:47:19-08:00,['033ade88edd6ec527f3791d86273295068237fc5'],262,380,642,2035170,4,1,1,0,1206
89875939673dab1398850aaec67dcf4a2c2e9c4f,1,Henry Robinson,2014-01-08 10:47:19-08:00,['b1b2e659af5778892d33f7da53faea28999d552d'],1,10,11,2035181,3,0.4,0.4,1,1206
86092885895bbda5eb4536a79dffc22fa9f947ef,0,Henry Robinson,2014-01-08 10:47:19-08:00,['89875939673dab1398850aaec67dcf4a2c2e9c4f'],1,1,2,2035183,1,,,,1206
014d1f8c0432bc9a0e1513971c379383e04cbc47,0,Henry Robinson,2014-01-08 10:47:20-08:00,['86092885895bbda5eb4536a79dffc22fa9f947ef'],0,0,0,2035183,1,,,,1207
d5177c3c30a458f0af1a42c963c9b670dd731167,0,Henry Robinson,2014-01-08 10:47:20-08:00,['014d1f8c0432bc9a0e1513971c379383e04cbc47'],17,21,38,2035221,3,0,0,0,1207
c8b1038b43aa2ac8c0407e4f2f7233d785ebd220,0,Henry Robinson,2014-01-08 10:47:20-08:00,['d5177c3c30a458f0af1a42c963c9b670dd731167'],3,5,8,2035229,2,,,,1207
5cc06a0915be7d2f981526c1a123d246fddc39aa,0,Henry Robinson,2014-01-08 10:47:21-08:00,['c8b1038b43aa2ac8c0407e4f2f7233d785ebd220'],0,0,0,2035229,0,,,,1207
adc84eea7a72c90b284bb9b9e33dca59184bc98f,0,Henry Robinson,2014-01-08 10:47:21-08:00,['5cc06a0915be7d2f981526c1a123d246fddc39aa'],0,0,0,2035229,0,,,,1207
cd78b2fe5374d29212b55ff1b29fba21c407c936,0,Henry Robinson,2014-01-08 10:47:22-08:00,['adc84eea7a72c90b284bb9b9e33dca59184bc98f'],0,0,0,2035229,0,,,,1207
7ba437a52ec8a0d66edecd4b4deb383441e656c4,1,Henry Robinson,2014-01-08 10:47:22-08:00,['cd78b2fe5374d29212b55ff1b29fba21c407c936'],254,228,482,2035711,50,1,0,0,1207
b5e14664dbba640967689d395ee0426a99eee656,0,Henry Robinson,2014-01-08 10:47:22-08:00,['7ba437a52ec8a0d66edecd4b4deb383441e656c4'],2,3,5,2035716,1,,,,1207
ecc8bf1e1bca47fc666b73edd9a83d8edfb213ea,1,Henry Robinson,2014-01-08 10:47:22-08:00,['b5e14664dbba640967689d395ee0426a99eee656'],6,14,20,2035736,2,0,0.5,1,1207
508c357f7728bbc53776ee2648edc11df4a7a7c1,0,Henry Robinson,2014-01-08 10:47:23-08:00,['ecc8bf1e1bca47fc666b73edd9a83d8edfb213ea'],2,6,8,2035744,2,1,1,1,1207
65f4fd98e470c066bc398096ce8958b87da8a012,0,Henry Robinson,2014-01-08 10:47:23-08:00,['508c357f7728bbc53776ee2648edc11df4a7a7c1'],15,37,52,2035796,10,0,0,0,1207
3fb375cdc41c95f70c4dcae077e4a948788de62a,0,Henry Robinson,2014-01-08 10:47:23-08:00,['65f4fd98e470c066bc398096ce8958b87da8a012'],0,2622,2622,2038418,6,,,,1213
0398efb99d88a930e34e4fcadcf5a8c2f4ae3df2,0,Henry Robinson,2014-01-08 10:47:24-08:00,['3fb375cdc41c95f70c4dcae077e4a948788de62a'],4,25,29,2038447,2,1,1,0,1213
411aa3d1f407d325373482aac64f78e5a56b72d5,1,Henry Robinson,2014-01-08 10:47:24-08:00,['0398efb99d88a930e34e4fcadcf5a8c2f4ae3df2'],172,241,413,2038860,6,0,0.230769231,0,1213
9fb4fb22316b0ffbe2fd335354f99ca95c5e0c27,1,Henry Robinson,2014-01-08 10:47:24-08:00,['411aa3d1f407d325373482aac64f78e5a56b72d5'],32,79,111,2038971,4,0,1,1,1213
be98df19c8efe59577e6faaa6089f0383009b703,1,Henry Robinson,2014-01-08 10:47:24-08:00,['9fb4fb22316b0ffbe2fd335354f99ca95c5e0c27'],877,19060,19937,2058908,38,0.345276292,0.621746881,0.901069519,1224
fec6b816f6e471377e80056a03f7934b67e19280,0,Henry Robinson,2014-01-08 10:47:27-08:00,['be98df19c8efe59577e6faaa6089f0383009b703'],0,0,0,2058908,0,,,,1224
1a2695781d9223c91a25a08b7ca93c7ec5c94d08,1,Henry Robinson,2014-01-08 10:47:29-08:00,['fec6b816f6e471377e80056a03f7934b67e19280'],40,395,435,2059343,7,0.47752809,0.853932584,0.792134831,1226
74fe6915e3567a4cdc269c83d6f144acaeccdef1,0,Henry Robinson,2014-01-08 10:47:29-08:00,['1a2695781d9223c91a25a08b7ca93c7ec5c94d08'],14,11,25,2059368,2,,,,1226
42eef8420081d51f7210ae802127802927ec3918,1,Henry Robinson,2014-01-08 10:47:30-08:00,['74fe6915e3567a4cdc269c83d6f144acaeccdef1'],147,326,473,2059841,6,0.222222222,1,1,1226
660229b54eac143571614ec99a61fd6a0ad29317,0,Henry Robinson,2014-01-08 10:47:30-08:00,['42eef8420081d51f7210ae802127802927ec3918'],3,20,23,2059864,2,1,0,0,1226
23b0ccbf4e3b18746e2b384c46256fe2de39569a,1,Henry Robinson,2014-01-08 10:47:30-08:00,['660229b54eac143571614ec99a61fd6a0ad29317'],30,47,77,2059941,5,0,1,1,1226
2c0d10dd1582fa1860562805da16ebbd719a0d60,0,Henry Robinson,2014-01-08 10:47:31-08:00,['23b0ccbf4e3b18746e2b384c46256fe2de39569a'],8,9,17,2059958,3,1,0,0,1226
42366f03875f90173d40bde70e8720304bc7b125,0,Henry Robinson,2014-01-08 10:47:31-08:00,['2c0d10dd1582fa1860562805da16ebbd719a0d60'],31,49,80,2060038,4,,,,1226
f276df2ef38258bef3645d38cd69c501c37b36df,0,Henry Robinson,2014-01-08 10:47:32-08:00,['42366f03875f90173d40bde70e8720304bc7b125'],2,3,5,2060043,1,,,,1226
0268308f15e19440b451052594990d313cfb90fa,0,Henry Robinson,2014-01-08 10:47:32-08:00,['f276df2ef38258bef3645d38cd69c501c37b36df'],1,1,2,2060045,1,,,,1226
fd8dfa21bddb3c924ade8d31229ce02c5da649d1,0,Henry Robinson,2014-01-08 10:47:33-08:00,['0268308f15e19440b451052594990d313cfb90fa'],3,3,6,2060051,1,,,,1226
bab8cedda41f5b26714684402eee7684535258d9,0,Henry Robinson,2014-01-08 10:47:33-08:00,['fd8dfa21bddb3c924ade8d31229ce02c5da649d1'],3,4,7,2060058,1,,,,1226
77711c8518ca9eac0ac7848931283a8039900853,0,Henry Robinson,2014-01-08 10:47:33-08:00,['bab8cedda41f5b26714684402eee7684535258d9'],3,7,10,2060068,2,,,0,1226
18967013993b3edf4cdeb5f41fc56675b3219498,0,Henry Robinson,2014-01-08 10:47:34-08:00,['77711c8518ca9eac0ac7848931283a8039900853'],9,18,27,2060095,4,0,1,1,1226
409d2ae5d7a301f1a1040cad667da517ebde9b79,1,Henry Robinson,2014-01-08 10:47:34-08:00,['18967013993b3edf4cdeb5f41fc56675b3219498'],63,168,231,2060326,11,0.888888889,0.888888889,1,1234
623d2a1a237d5bf448b5252fd6daf89a799af94f,0,Henry Robinson,2014-01-08 10:47:35-08:00,['409d2ae5d7a301f1a1040cad667da517ebde9b79'],8,13,21,2060347,1,0,1,1,1234
48fe9473abfcb3b1abefffaaabe25cef1750be61,0,Henry Robinson,2014-01-08 10:47:35-08:00,['623d2a1a237d5bf448b5252fd6daf89a799af94f'],0,0,0,2060347,0,,,,1234
e578ecb7ef96465c61bece042b2ac81369ee0da6,0,Henry Robinson,2014-01-08 10:47:35-08:00,['48fe9473abfcb3b1abefffaaabe25cef1750be61'],0,0,0,2060347,0,,,,1234
b56a5c42de0de20930d49659059d01ea54144c5a,0,Henry Robinson,2014-01-08 10:47:36-08:00,['e578ecb7ef96465c61bece042b2ac81369ee0da6'],2,4,6,2060353,1,,,,1234
19e080136c603ce4de519c5b139d656fc049fc6b,0,Henry Robinson,2014-01-08 10:47:36-08:00,['b56a5c42de0de20930d49659059d01ea54144c5a'],2,13,15,2060368,1,1,1,1,1234
f66f5f7868164fc20928b28913de06670c568474,0,Henry Robinson,2014-01-08 10:47:37-08:00,['19e080136c603ce4de519c5b139d656fc049fc6b'],2,6,8,2060376,1,1,1,1,1234
a6c58f195bf40988777e0422d4f050fd545c8ceb,1,Henry Robinson,2014-01-08 10:47:37-08:00,['f66f5f7868164fc20928b28913de06670c568474'],15,27,42,2060418,5,0,0.714285714,0.714285714,1234
63e3cd0279cdf143b01b0144748faf20e8e4f039,1,Henry Robinson,2014-01-08 10:47:37-08:00,['a6c58f195bf40988777e0422d4f050fd545c8ceb'],56,249,305,2060723,18,0.450819672,0.540983607,0.68852459,1234
900ddb5cbfa6ad6a7677c98eb2fa4fdb963fa46d,1,Henry Robinson,2014-01-08 10:47:38-08:00,['63e3cd0279cdf143b01b0144748faf20e8e4f039'],157,305,462,2061185,5,0.169230769,0.938461538,0.907692308,1235
2fd645990c1cf38639399aa85679320a94f5ff26,0,Henry Robinson,2014-01-08 10:47:41-08:00,['900ddb5cbfa6ad6a7677c98eb2fa4fdb963fa46d'],0,0,0,2061185,0,,,,1235
888a169bfbd85faa6021b53c23ba6d695a2f0427,0,Henry Robinson,2014-01-08 10:47:44-08:00,['2fd645990c1cf38639399aa85679320a94f5ff26'],0,0,0,2061185,0,,,,1235
d11029919db8b16d8e446f379a3d8cde6b14d8ec,0,Henry Robinson,2014-01-08 10:47:48-08:00,['888a169bfbd85faa6021b53c23ba6d695a2f0427'],0,0,0,2061185,0,,,,1235
7001fb103e95aca49c8f57642d2c55abcdaf1c65,1,Henry Robinson,2014-01-08 10:47:50-08:00,['d11029919db8b16d8e446f379a3d8cde6b14d8ec'],1330,856,2186,2063371,15,0,1,1,1235
99aa94149aeda701d73a1192840b12eac07f4f72,0,Henry Robinson,2014-01-08 10:47:50-08:00,['7001fb103e95aca49c8f57642d2c55abcdaf1c65'],1,1,2,2063373,1,,,,1235
e11c5a772c1bee28cc628bdeaac2ea30be355995,1,Henry Robinson,2014-01-08 10:47:50-08:00,['99aa94149aeda701d73a1192840b12eac07f4f72'],78,149,227,2063600,11,0,0.181818182,0.181818182,1235
d3d206c8f162b12130b18e3abdaeda7cb2210780,0,Henry Robinson,2014-01-08 10:47:51-08:00,['e11c5a772c1bee28cc628bdeaac2ea30be355995'],1,4,5,2063605,1,,,,1235
83e9bccabb8b1ed7b4af025c67ec8b770062c237,0,Henry Robinson,2014-01-08 10:47:51-08:00,['d3d206c8f162b12130b18e3abdaeda7cb2210780'],0,5766,5766,2069371,13,0.247055524,0.491306786,0.822209759,1248
a2783859eba8d2ff1db0f2f1117e7a7c56c191ee,0,Henry Robinson,2014-01-08 10:47:51-08:00,['83e9bccabb8b1ed7b4af025c67ec8b770062c237'],19,21,40,2069411,3,,,,1248
b1da373ffdc44ccaab7259ec4b11a886b731f257,0,Henry Robinson,2014-01-08 10:47:52-08:00,['a2783859eba8d2ff1db0f2f1117e7a7c56c191ee'],0,0,0,2069411,0,,,,1248
073de3e02e66a9b2f0c56d46247879436547af67,0,Henry Robinson,2014-01-08 10:47:52-08:00,['b1da373ffdc44ccaab7259ec4b11a886b731f257'],15298,21,15319,2084730,10,0.647885929,0.383206258,0.073076542,1248
5166bda64925f68bf7173b2cafdd18a919a55872,0,Henry Robinson,2014-01-08 10:47:52-08:00,['073de3e02e66a9b2f0c56d46247879436547af67'],2,2,4,2084734,2,,,,1248
850f3256d60083c415f45f570be94f152e9e044a,0,Henry Robinson,2014-01-08 10:47:53-08:00,['5166bda64925f68bf7173b2cafdd18a919a55872'],2,3,5,2084739,1,,,,1248
251a8a2bf13865219188dccf5d9660640af0af8f,1,Henry Robinson,2014-01-08 10:47:53-08:00,['850f3256d60083c415f45f570be94f152e9e044a'],27,27,54,2084793,10,,,,1248
8e1a125394fd0086e0b05ad1cc9987a218f825dd,0,Henry Robinson,2014-01-08 10:47:53-08:00,['251a8a2bf13865219188dccf5d9660640af0af8f'],106,49,155,2084948,9,,,,1248
a0229cd12e661539c86fd6bc6145a57d0234af9e,0,Henry Robinson,2014-01-08 10:47:54-08:00,['8e1a125394fd0086e0b05ad1cc9987a218f825dd'],36,36,72,2085020,6,,,,1248
aed6a66e294cfefc96dd17a7917b36ceded91aef,1,Henry Robinson,2014-01-08 10:47:54-08:00,['a0229cd12e661539c86fd6bc6145a57d0234af9e'],1,1,2,2085022,1,,,,1248
4bd6279646e590974a8cbea0b2f60dffad3dbde2,1,Henry Robinson,2014-01-08 10:47:54-08:00,['aed6a66e294cfefc96dd17a7917b36ceded91aef'],1,120,121,2085143,5,0.561403509,0.561403509,0.719298246,1250
bb9405a0f361fc71f6179b899af8389a50737214,0,Henry Robinson,2014-01-08 10:47:55-08:00,['4bd6279646e590974a8cbea0b2f60dffad3dbde2'],0,4,4,2085147,1,1,1,1,1250
4d876e01d01b64991eb8c25f767c10144ac650bf,0,Henry Robinson,2014-01-08 10:47:55-08:00,['bb9405a0f361fc71f6179b899af8389a50737214'],18,26,44,2085191,4,0.666666667,0.666666667,1,1250
2309b391e4f9d33471531b481a0b32e9cee1d808,1,Henry Robinson,2014-01-08 10:47:55-08:00,['4d876e01d01b64991eb8c25f767c10144ac650bf'],25,64,89,2085280,2,0.269230769,0.423076923,0.653846154,1250
868a99135af31b8a916ac623aa87d8c543d84281,1,Henry Robinson,2014-01-08 10:47:56-08:00,['2309b391e4f9d33471531b481a0b32e9cee1d808'],0,263,263,2085543,5,0.183206107,0.748091603,1,1252
557b59a80dddcd5aa83a26e09b2598fb7731d33b,1,Henry Robinson,2014-01-08 10:47:56-08:00,['868a99135af31b8a916ac623aa87d8c543d84281'],36,57,93,2085636,5,0.0625,0,1,1252
84e35d591cdec77ae9945f6447093b29f411ef32,1,Henry Robinson,2014-01-08 10:47:56-08:00,['557b59a80dddcd5aa83a26e09b2598fb7731d33b'],13,108,121,2085757,5,0.05,0,1,1252
57a8603150385a4a7a3f3ec2534f5c3694fd0fd2,0,Henry Robinson,2014-01-08 10:47:57-08:00,['84e35d591cdec77ae9945f6447093b29f411ef32'],2,2,4,2085761,2,,,,1252
67b9d126c42c8fe8cee1051234426101dd03fc7f,0,Henry Robinson,2014-01-08 10:47:57-08:00,['57a8603150385a4a7a3f3ec2534f5c3694fd0fd2'],22,25,47,2085808,2,,,,1252
84e25d2ab3b0f515c694af6a0045e2ea011b16c6,1,Henry Robinson,2014-01-08 10:47:57-08:00,['67b9d126c42c8fe8cee1051234426101dd03fc7f'],11,16,27,2085835,1,,1,,1252
d7a684de3fe67c9f4a489f77c40dc7b506bd01f3,0,Henry Robinson,2014-01-08 10:47:57-08:00,['84e25d2ab3b0f515c694af6a0045e2ea011b16c6'],1,1,2,2085837,1,,,,1252
2e4795a7cff0cf8f34c08dd499eb457b4f1d2532,1,Henry Robinson,2014-01-08 10:47:58-08:00,['d7a684de3fe67c9f4a489f77c40dc7b506bd01f3'],112,115,227,2086064,7,0,1,0,1252
270ca262cfaa147677ef0e57221db42859d1da3a,0,Henry Robinson,2014-01-08 10:47:58-08:00,['2e4795a7cff0cf8f34c08dd499eb457b4f1d2532'],11,12,23,2086087,1,1,1,0,1252
3d008119325915a97e2cc1127f072c00227dd970,0,Henry Robinson,2014-01-08 10:47:58-08:00,['270ca262cfaa147677ef0e57221db42859d1da3a'],3,11,14,2086101,1,1,1,1,1252
d2e477673193586ac7df45f973dd165808b3a121,1,Henry Robinson,2014-01-08 10:47:59-08:00,['3d008119325915a97e2cc1127f072c00227dd970'],441,118,559,2086660,13,0,0,0,1253
fee1b47e330fa72fd6095061cb68df29870cf03d,1,Henry Robinson,2014-01-08 10:47:59-08:00,['d2e477673193586ac7df45f973dd165808b3a121'],0,114,114,2086774,3,0.186666667,0,1,1253
73c8ee3d96af15e2210376372aa556989cb3423e,1,Henry Robinson,2014-01-08 10:48:00-08:00,['fee1b47e330fa72fd6095061cb68df29870cf03d'],0,13,13,2086787,2,0,1,1,1253
846301c394cb5cdccfb3d237be0bc8930952a7b0,0,Henry Robinson,2014-01-08 10:48:00-08:00,['73c8ee3d96af15e2210376372aa556989cb3423e'],30,72,102,2086889,6,,,,1254
a21954183f23e00fecf74aa6b5bdab2c5cf64c0c,0,Henry Robinson,2014-01-08 10:48:01-08:00,['846301c394cb5cdccfb3d237be0bc8930952a7b0'],0,0,0,2086889,0,,,,1254
4ec901612d176ca63721b99fb1515e9adff4d7f5,0,Henry Robinson,2014-01-08 10:48:04-08:00,['a21954183f23e00fecf74aa6b5bdab2c5cf64c0c'],0,0,0,2086889,0,,,,1254
8b870999986b99be7c6f584b122bb783d2b392fc,1,Henry Robinson,2014-01-08 10:48:05-08:00,['4ec901612d176ca63721b99fb1515e9adff4d7f5'],181,866,1047,2087936,24,0.100323625,0.355987055,0.69579288,1257
0e1c81459fc98479370baa6c0fb8291bbc4509e0,0,Henry Robinson,2014-01-08 10:48:05-08:00,['8b870999986b99be7c6f584b122bb783d2b392fc'],0,0,0,2087936,0,,,,1257
357327b5c04b5f8a2ab76fea7d26059a4cd9fcc4,0,Henry Robinson,2014-01-08 10:48:06-08:00,['0e1c81459fc98479370baa6c0fb8291bbc4509e0'],4,4,8,2087944,1,,,,1257
5be657f4cef7a1bf5493b7e247aaaa150214eb19,1,Henry Robinson,2014-01-08 10:48:06-08:00,['357327b5c04b5f8a2ab76fea7d26059a4cd9fcc4'],5,8,13,2087957,3,,,,1257
9c11c0ce2d398afa7a2b1da25e412fedb05cc43d,1,Henry Robinson,2014-01-08 10:48:06-08:00,['5be657f4cef7a1bf5493b7e247aaaa150214eb19'],225,667,892,2088849,15,0.536964981,1,0.891050584,1258
083b66e6f202b45598bd04d6110d9ce941524d2f,1,Henry Robinson,2014-01-08 10:48:07-08:00,['9c11c0ce2d398afa7a2b1da25e412fedb05cc43d'],0,2699,2699,2091548,2,0.628166915,0.642324888,0.619970194,1259
279c2ee996b673a2cb1fba294b7055669f06827c,1,Henry Robinson,2014-01-08 10:48:07-08:00,['083b66e6f202b45598bd04d6110d9ce941524d2f'],0,2,2,2091550,1,,,,1260
a6d89d1ad2bdd65f6d7e6784762edb35f381cc3f,0,Henry Robinson,2014-01-08 10:48:07-08:00,['279c2ee996b673a2cb1fba294b7055669f06827c'],1,1,2,2091552,1,,,,1260
0afdcb98b614b7ceb86624b181e5f80f265602f0,0,Henry Robinson,2014-01-08 10:48:07-08:00,['a6d89d1ad2bdd65f6d7e6784762edb35f381cc3f'],5,6,11,2091563,2,,,,1260
0d07b44bb0edab6c2c0b647fb2d451749d6630df,0,Henry Robinson,2014-01-08 10:48:08-08:00,['0afdcb98b614b7ceb86624b181e5f80f265602f0'],0,7,7,2091570,2,0.5,0.5,1,1260
45405ee546955b8d40b6b7a34fc8be19611c6da4,0,Henry Robinson,2014-01-08 10:48:08-08:00,['0d07b44bb0edab6c2c0b647fb2d451749d6630df'],1,1,2,2091572,1,,,,1260
99bb22dcacd6f9e0ba5e2c50c58e62ceedb4fa77,0,Henry Robinson,2014-01-08 10:48:08-08:00,['45405ee546955b8d40b6b7a34fc8be19611c6da4'],16,50,66,2091638,3,0,0,0,1260
09d6d931f4126b489dfb537076f1e0efaf0c44fe,1,Henry Robinson,2014-01-08 10:48:09-08:00,['99bb22dcacd6f9e0ba5e2c50c58e62ceedb4fa77'],2996,3182,6178,2097816,101,0.206030151,1,0.834170854,1261
c2c3eeddca91832787e409093bd2f15c12d508f8,0,Henry Robinson,2014-01-08 10:48:10-08:00,['09d6d931f4126b489dfb537076f1e0efaf0c44fe'],0,0,0,2097816,0,,,,1261
969cf4cafa5d36c0a85052af67232d694605d397,0,Henry Robinson,2014-01-08 10:48:14-08:00,['c2c3eeddca91832787e409093bd2f15c12d508f8'],0,0,0,2097816,0,,,,1261
27bc33d6b404b6e9992f2d5a060cbfe440e64eaa,0,Henry Robinson,2014-01-08 10:48:18-08:00,['969cf4cafa5d36c0a85052af67232d694605d397'],2,2,4,2097820,1,,,,1261
f4784947ce50242b1a0e6b12ea069af707962711,0,Henry Robinson,2014-01-08 10:48:18-08:00,['27bc33d6b404b6e9992f2d5a060cbfe440e64eaa'],4,9,13,2097833,2,,,,1261
d6286e411680a3f3541354247037a3427a83724f,0,Henry Robinson,2014-01-08 10:48:19-08:00,['f4784947ce50242b1a0e6b12ea069af707962711'],1,4,5,2097838,1,1,1,0,1261
d3b9de2222573333e83c2d7b36c3ebe16f85f4eb,1,Henry Robinson,2014-01-08 10:48:19-08:00,['d6286e411680a3f3541354247037a3427a83724f'],40,120,160,2097998,3,0.9,0.866666667,0.6,1261
11191d6c8239db3298ed3b0ccb76bcc4cea64c38,0,Henry Robinson,2014-01-08 10:48:19-08:00,['d3b9de2222573333e83c2d7b36c3ebe16f85f4eb'],1,2,3,2098001,1,,,,1261
7bec24ecc53dfb44e55b1ac280a1bbc2eab62217,1,Henry Robinson,2014-01-08 10:48:20-08:00,['11191d6c8239db3298ed3b0ccb76bcc4cea64c38'],35,72,107,2098108,13,0,1,1,1261
222d15c6ca0b1b20338235bcccd768bf97d0e889,1,Henry Robinson,2014-01-08 10:48:20-08:00,['7bec24ecc53dfb44e55b1ac280a1bbc2eab62217'],45,222,267,2098375,9,0.951219512,0.707317073,1,1264
f1d37646ed6635475b899a4aceb1326ce45a809b,0,Henry Robinson,2014-01-08 10:48:20-08:00,['222d15c6ca0b1b20338235bcccd768bf97d0e889'],1,1,2,2098377,1,,,,1264
6c087164392e5734743990d51d197ee833a0be86,0,Henry Robinson,2014-01-08 10:48:21-08:00,['f1d37646ed6635475b899a4aceb1326ce45a809b'],2,72,74,2098451,5,0.5,0.5625,1,1265
3ee82e754349700ef94249cb4ebde31cf5c9f10d,1,Henry Robinson,2014-01-08 10:48:21-08:00,['6c087164392e5734743990d51d197ee833a0be86'],40,78,118,2098569,5,0.5,1,0.4,1266
5138a720bbb5fd99e21e4cc80cf3b6dc45d1b8ec,1,Henry Robinson,2014-01-08 10:48:22-08:00,['3ee82e754349700ef94249cb4ebde31cf5c9f10d'],118,59,177,2098746,15,0.615384615,1,0.230769231,1266
1fd9ee4a01d135ff246244c1a1f49e8ca0d09fae,1,Henry Robinson,2014-01-08 10:48:22-08:00,['5138a720bbb5fd99e21e4cc80cf3b6dc45d1b8ec'],6,124,130,2098876,5,0.490566038,0.924528302,1,1266
b0663e622539e6ce97df462bea7e4cee9734569f,0,Henry Robinson,2014-01-08 10:48:22-08:00,['1fd9ee4a01d135ff246244c1a1f49e8ca0d09fae'],11,14,25,2098901,4,,0,0,1266
1a4f30ca9d1c119b73d1f6346ab3e84fabc6656e,0,Henry Robinson,2014-01-08 10:48:23-08:00,['b0663e622539e6ce97df462bea7e4cee9734569f'],2,5,7,2098908,2,1,1,0,1266
1d394cf77cb9fc2d35d1d8be27d199e4ec065d61,0,Henry Robinson,2014-01-08 10:48:23-08:00,['1a4f30ca9d1c119b73d1f6346ab3e84fabc6656e'],10,106,116,2099024,3,1,1,0.906976744,1267
6e1f8d178a2ba5762bf3f566dc615a726013f4f5,0,Henry Robinson,2014-01-08 10:48:23-08:00,['1d394cf77cb9fc2d35d1d8be27d199e4ec065d61'],18,25,43,2099067,2,1,1,0,1267
ebe9368f1485804608dc56b0b92a34b9f7f0ea9c,1,Henry Robinson,2014-01-08 10:48:24-08:00,['6e1f8d178a2ba5762bf3f566dc615a726013f4f5'],9,12,21,2099088,1,0,1,1,1267
f676b8ad1a66df063dbae03ad2604998a1ea6f22,0,Henry Robinson,2014-01-08 10:48:24-08:00,['ebe9368f1485804608dc56b0b92a34b9f7f0ea9c'],0,1,1,2099089,1,,,,1267
51908060b3689bff373258766fa4e21d0ef84389,0,Henry Robinson,2014-01-08 10:48:24-08:00,['f676b8ad1a66df063dbae03ad2604998a1ea6f22'],1,9,10,2099099,2,0,0,0,1267
b9d10cccbd8346d5365539df170821d20f5157ca,0,Henry Robinson,2014-01-08 10:48:25-08:00,['51908060b3689bff373258766fa4e21d0ef84389'],1,0,1,2099100,1,,,,1267
5f9cd044eedc7ad44a5feb4aca28ddf79d53414f,0,Henry Robinson,2014-01-08 10:48:25-08:00,['b9d10cccbd8346d5365539df170821d20f5157ca'],3,84,87,2099187,3,1,1,1,1269
05dd34a8191898f0731bccbd891593842c0804de,1,Henry Robinson,2014-01-08 10:48:25-08:00,['5f9cd044eedc7ad44a5feb4aca28ddf79d53414f'],1,19,20,2099207,2,,,,1269
fa4393bc1f387fc7ccf4c372f29b767054eaf8c2,0,Henry Robinson,2014-01-08 10:48:26-08:00,['05dd34a8191898f0731bccbd891593842c0804de'],1,1,2,2099209,1,,,,1269
46397cff69150a82944526c9712dfb8f86bb775a,0,Henry Robinson,2014-01-08 10:48:26-08:00,['fa4393bc1f387fc7ccf4c372f29b767054eaf8c2'],0,5,5,2099214,1,1,0,0,1269
bee54e209513eaab0cd80bb8394dcf18352ed738,1,Henry Robinson,2014-01-08 10:48:26-08:00,['46397cff69150a82944526c9712dfb8f86bb775a'],97,223,320,2099534,7,0.867924528,1,0.339622642,1269
153c48a464e235678d76137983c3466229f1b7d0,0,Henry Robinson,2014-01-08 10:48:27-08:00,['bee54e209513eaab0cd80bb8394dcf18352ed738'],2,2,4,2099538,2,0,0,0,1269
fdce1d44b42ca36dc64c9c098647f3cf8f6b2dbe,0,Henry Robinson,2014-01-08 10:48:27-08:00,['153c48a464e235678d76137983c3466229f1b7d0'],0,2,2,2099540,1,,,,1269
293bb9d832f787cc7db4f7b1113fcdb74d6a547a,0,Henry Robinson,2014-01-08 10:48:27-08:00,['fdce1d44b42ca36dc64c9c098647f3cf8f6b2dbe'],0,5,5,2099545,2,1,1,1,1269
fa3500eb43b477eacc6523ada644ce71f81fa8e2,1,Henry Robinson,2014-01-08 10:48:27-08:00,['293bb9d832f787cc7db4f7b1113fcdb74d6a547a'],1,2240,2241,2101786,14,0.586757991,0.555936073,0.690639269,1281
45297b01ff4f27dc44b0e8f86582583c5d359b5a,0,Henry Robinson,2014-01-08 10:48:28-08:00,['fa3500eb43b477eacc6523ada644ce71f81fa8e2'],1,3,4,2101790,1,1,1,1,1281
c9b49b7d3d81177e2b8b8c1167892aa1ca4498f2,0,Henry Robinson,2014-01-08 10:48:28-08:00,['45297b01ff4f27dc44b0e8f86582583c5d359b5a'],2,4,6,2101796,1,0,0,1,1281
f4370611e2fcbfa48c5f55ecf55cfb8863452388,0,Henry Robinson,2014-01-08 10:48:28-08:00,['c9b49b7d3d81177e2b8b8c1167892aa1ca4498f2'],0,2,2,2101798,1,0,0,1,1281
c781bad20a8480e51eaa0bff1992c91db1415ba2,0,Henry Robinson,2014-01-08 10:48:29-08:00,['f4370611e2fcbfa48c5f55ecf55cfb8863452388'],0,5,5,2101803,1,1,1,1,1281
006ded6c2ae592b6142e639ce425e65fad01d4f0,0,Henry Robinson,2014-01-08 10:48:29-08:00,['c781bad20a8480e51eaa0bff1992c91db1415ba2'],8,48,56,2101859,7,0,0.727272727,0.772727273,1281
c02d25baa877eeac713af1c6b9b99bf7ff02d4d2,1,Henry Robinson,2014-01-08 10:48:29-08:00,['006ded6c2ae592b6142e639ce425e65fad01d4f0'],170,1366,1536,2103395,26,0.519230769,0.698717949,0.532051282,1287
1cd847c85693a1db9c2c2e1e439be7d7028104cc,1,Henry Robinson,2014-01-08 10:48:30-08:00,['c02d25baa877eeac713af1c6b9b99bf7ff02d4d2'],323,2246,2569,2105964,28,0.623842593,0.72337963,0.841435185,1297
81846223649ade6ca650a715e99ac78c4f5ef816,1,Henry Robinson,2014-01-08 10:48:30-08:00,['1cd847c85693a1db9c2c2e1e439be7d7028104cc'],3,34,37,2106001,3,0.952380952,1,1,1297
4cf7d2634ea9105cd2788a0d60492a7cf87d9144,0,Henry Robinson,2014-01-08 10:48:30-08:00,['81846223649ade6ca650a715e99ac78c4f5ef816'],30,86,116,2106117,4,1,1,1,1298
d763948f013294206edd56dcca7755a46aa6bdb2,1,Henry Robinson,2014-01-08 10:48:31-08:00,['4cf7d2634ea9105cd2788a0d60492a7cf87d9144'],0,2,2,2106119,1,,,,1298
6db372a7c5f2818e1888afd5d2245e56c781c920,0,Henry Robinson,2014-01-08 10:48:31-08:00,['d763948f013294206edd56dcca7755a46aa6bdb2'],1,4,5,2106124,1,,,,1298
fdda4d70ebcb9e09779e45f401d466b710870abe,1,Henry Robinson,2014-01-08 10:48:31-08:00,['6db372a7c5f2818e1888afd5d2245e56c781c920'],4,4,8,2106132,1,,,,1298
7b9cd0288763adab33e96cf2ad94c6581889154e,0,Henry Robinson,2014-01-08 10:48:32-08:00,['fdda4d70ebcb9e09779e45f401d466b710870abe'],0,1,1,2106133,1,,,,1298
87d8f79efe96ad1c84eab078da1b32d780511a66,1,Henry Robinson,2014-01-08 10:48:32-08:00,['7b9cd0288763adab33e96cf2ad94c6581889154e'],16,38,54,2106187,6,0.714285714,0.928571429,1,1298
4b6ce8ecb326ea39af58e1730c7397558d52cb1c,1,Henry Robinson,2014-01-08 10:48:32-08:00,['87d8f79efe96ad1c84eab078da1b32d780511a66'],154,149,303,2106490,24,0,0,1,1298
6cbc4964d3966b46c3d4a09f47f610e6ad8e4d8d,1,Henry Robinson,2014-01-08 10:48:33-08:00,['4b6ce8ecb326ea39af58e1730c7397558d52cb1c'],45,107,152,2106642,5,0.119047619,0.761904762,0.619047619,1298
77f4fc8cf925488eb5196634871bd6599c28c087,1,Henry Robinson,2014-01-08 10:48:33-08:00,['6cbc4964d3966b46c3d4a09f47f610e6ad8e4d8d'],256,323,579,2107221,31,0,0.5,1,1299
71e6d81d1b671934f92a1185ca813c56d8e11e8f,1,Henry Robinson,2014-01-08 10:48:33-08:00,['77f4fc8cf925488eb5196634871bd6599c28c087'],343,463,806,2108027,42,0.606060606,1,1,1301
e15a39143a670c1f00d1d30c5acd9eef1140e05f,0,Henry Robinson,2014-01-08 10:48:34-08:00,['71e6d81d1b671934f92a1185ca813c56d8e11e8f'],1,1,2,2108029,1,,,,1301
c39c4c8b057ac0e343b9083456995302765f197b,0,Henry Robinson,2014-01-08 10:48:34-08:00,['e15a39143a670c1f00d1d30c5acd9eef1140e05f'],33,43,76,2108105,7,0,1,0,1301
31891f9f6993b50484d10514e45e872f90f62e51,0,Henry Robinson,2014-01-08 10:48:34-08:00,['c39c4c8b057ac0e343b9083456995302765f197b'],1,0,1,2108106,1,,,,1301
614e0f53079856c1bdc2dcb6df0e3a91a895a63d,1,Henry Robinson,2014-01-08 10:48:35-08:00,['31891f9f6993b50484d10514e45e872f90f62e51'],3,12,15,2108121,2,0.25,0,1,1301
9f71374875a522eed1b4994e264ac95b1273b579,1,Henry Robinson,2014-01-08 10:48:35-08:00,['614e0f53079856c1bdc2dcb6df0e3a91a895a63d'],34,136,170,2108291,9,0.433333333,0.9,0.933333333,1301
dd9798c9f3f0dcb284364d0250b8ceba3c91d9e5,0,Henry Robinson,2014-01-08 10:48:35-08:00,['9f71374875a522eed1b4994e264ac95b1273b579'],8,13,21,2108312,2,,,,1301
57c3072188924f09dc56aff6d7543767b1efa7f2,1,Henry Robinson,2014-01-08 10:48:36-08:00,['dd9798c9f3f0dcb284364d0250b8ceba3c91d9e5'],35,84,119,2108431,9,0.785714286,0.785714286,0.285714286,1301
8453d0aa5cc866eeb9c92a3a0a208f3390e8b059,1,Henry Robinson,2014-01-08 10:48:36-08:00,['57c3072188924f09dc56aff6d7543767b1efa7f2'],17,26,43,2108474,7,0,0.714285714,0,1301
f1fc449e93084328ddc8649c3b4fe626bf46144a,0,Henry Robinson,2014-01-08 10:48:36-08:00,['8453d0aa5cc866eeb9c92a3a0a208f3390e8b059'],6,5,11,2108485,2,,,,1301
322de24982f5dffe479687a966b95d83c39d6c5d,1,Henry Robinson,2014-01-08 10:48:37-08:00,['f1fc449e93084328ddc8649c3b4fe626bf46144a'],15,29,44,2108529,3,0,0,0.25,1301
a5611f3dbac7a61d3a95da79b637aa9feeab069a,1,Henry Robinson,2014-01-08 10:48:37-08:00,['322de24982f5dffe479687a966b95d83c39d6c5d'],95,120,215,2108744,5,1,0,0,1301
d57440e87dcb04bb2b21d263006fb48d7d049354,1,Henry Robinson,2014-01-08 10:48:37-08:00,['a5611f3dbac7a61d3a95da79b637aa9feeab069a'],106,165,271,2109015,16,0.193548387,0.935483871,0.774193548,1301
90d7e085fa8281f3f5c09e55931004aa35d62245,0,Henry Robinson,2014-01-08 10:48:38-08:00,['d57440e87dcb04bb2b21d263006fb48d7d049354'],25,40,65,2109080,8,0,1,1,1301
ad6b7198d8bf4e1dff7010c9bee727e959d4f5a5,1,Henry Robinson,2014-01-08 10:48:38-08:00,['90d7e085fa8281f3f5c09e55931004aa35d62245'],1,2,3,2109083,1,1,1,1,1301
328ceed4e7fe8f4d7d99316c3b8b96c109d21dbe,1,Henry Robinson,2014-01-08 10:48:38-08:00,['ad6b7198d8bf4e1dff7010c9bee727e959d4f5a5'],207,66,273,2109356,28,0.8,0.4,0.8,1301
57ac12887270fc6fd0a8afdc3da6e03e53ba348b,0,Henry Robinson,2014-01-08 10:48:39-08:00,['328ceed4e7fe8f4d7d99316c3b8b96c109d21dbe'],1,2,3,2109359,1,,,,1301
83358e9b38731ce494f6413c229d5c17c070595c,1,Henry Robinson,2014-01-08 10:48:39-08:00,['57ac12887270fc6fd0a8afdc3da6e03e53ba348b'],174,269,443,2109802,13,0.375,1,1,1303
dc13d816aba3f2687c69236038e537c6402ed3d4,1,Henry Robinson,2014-01-08 10:48:39-08:00,['83358e9b38731ce494f6413c229d5c17c070595c'],444,850,1294,2111096,8,0.229437229,0,0.653679654,1303
41904e51093683363ab0988ed294e13d93fd8dda,0,Henry Robinson,2014-01-08 10:48:40-08:00,['dc13d816aba3f2687c69236038e537c6402ed3d4'],43,152,195,2111291,2,0.512195122,1,0.853658537,1303
610da19f15bc1f926236b815afca74137861b9ac,1,Henry Robinson,2014-01-08 10:48:40-08:00,['41904e51093683363ab0988ed294e13d93fd8dda'],152,43,195,2111486,2,0.487804878,0,0.146341463,1303
13599845d052bbc08b695fddfd6ef2bb114972ec,0,Henry Robinson,2014-01-08 10:48:40-08:00,['610da19f15bc1f926236b815afca74137861b9ac'],1,0,1,2111487,1,1,1,1,1303
d7bfe6c68d8e05e44b69ed68a10cb82c09cea598,1,Henry Robinson,2014-01-08 10:48:41-08:00,['13599845d052bbc08b695fddfd6ef2bb114972ec'],134,323,457,2111944,12,0.311688312,0.87012987,0.974025974,1304
0385d14d696a4c113db0a439a484a39f420bd35f,1,Henry Robinson,2014-01-08 10:48:41-08:00,['d7bfe6c68d8e05e44b69ed68a10cb82c09cea598'],12,62,74,2112018,11,0.9,0.85,1,1305
899fcff363e5763b1cf2cf0bf16b55be3458d4fa,0,Henry Robinson,2014-01-08 10:48:41-08:00,['0385d14d696a4c113db0a439a484a39f420bd35f'],25,65,90,2112108,7,0,0.772727273,0.227272727,1305
62b4afbde4a205e98c824d44f0eb44fad5a9c288,1,Henry Robinson,2014-01-08 10:48:42-08:00,['899fcff363e5763b1cf2cf0bf16b55be3458d4fa'],23,29,52,2112160,1,1,1,1,1305
39e443407bc2551cbfc99378091c72f2cf0d8781,0,Henry Robinson,2014-01-08 10:48:43-08:00,['62b4afbde4a205e98c824d44f0eb44fad5a9c288'],37,97,134,2112294,3,1,0.294117647,0,1305
0bcb54fcf88d7ea5b2a4a9e3390bb49055a2ce32,1,Henry Robinson,2014-01-08 10:48:44-08:00,['39e443407bc2551cbfc99378091c72f2cf0d8781'],13,93,106,2112400,5,0.685185185,1,1,1305
6e293090e60aea300f9e83db67f56a5efd07c35c,1,Henry Robinson,2014-01-08 10:48:44-08:00,['0bcb54fcf88d7ea5b2a4a9e3390bb49055a2ce32'],1583,2936,4519,2116919,61,0.24217119,0.770354906,0.974947808,1321
18dfcbd361cd0776f75b54a786a90c533f5a9770,0,Henry Robinson,2014-01-08 10:48:45-08:00,['6e293090e60aea300f9e83db67f56a5efd07c35c'],1,1,2,2116921,1,,,,1321
6a7b7ea2e008d9272ff2e0fcbb1584206db65f6f,0,Henry Robinson,2014-01-08 10:48:45-08:00,['18dfcbd361cd0776f75b54a786a90c533f5a9770'],6,13,19,2116940,2,1,1,0,1321
2f8ba3c08e1cb6881df366808f1388cd1aa0d479,0,Henry Robinson,2014-01-08 10:48:45-08:00,['6a7b7ea2e008d9272ff2e0fcbb1584206db65f6f'],7,7,14,2116954,2,1,0,0,1321
461a48df2bfcfc324fac27c1f937993fd108bbc0,1,Henry Robinson,2014-01-08 10:48:45-08:00,['2f8ba3c08e1cb6881df366808f1388cd1aa0d479'],801,850,1651,2118605,23,0.329411765,0.447058824,0.105882353,1321
5ed84d7f65c45ba3ec6c6a266695153e86d59b4a,1,Henry Robinson,2014-01-08 10:48:46-08:00,['461a48df2bfcfc324fac27c1f937993fd108bbc0'],28,69,97,2118702,6,0,0.3,0.55,1321
129c6473b957e5451b776a4e893f9649fa01a11c,0,Henry Robinson,2014-01-08 10:48:46-08:00,['5ed84d7f65c45ba3ec6c6a266695153e86d59b4a'],42,50,92,2118794,6,0.5,0.5,0,1321
84398cca23a0d1ae98cf1a53d7997b62a5ef3bf1,0,Henry Robinson,2014-01-08 10:48:46-08:00,['129c6473b957e5451b776a4e893f9649fa01a11c'],1,0,1,2118795,1,1,1,1,1321
edaadc5091565535758f01707622725fa1ed038e,0,Henry Robinson,2014-01-08 10:48:47-08:00,['84398cca23a0d1ae98cf1a53d7997b62a5ef3bf1'],3,4,7,2118802,1,,,,1321
eceefba4e9287678c8e323c4e82133e81776ae20,0,Henry Robinson,2014-01-08 10:48:47-08:00,['edaadc5091565535758f01707622725fa1ed038e'],3,3,6,2118808,1,,,,1321
f4d961a241ace3456939bb625f7e6e4c6ea295a6,0,Henry Robinson,2014-01-08 10:48:47-08:00,['eceefba4e9287678c8e323c4e82133e81776ae20'],2,7,9,2118817,2,0,0,1,1321
e0a7b7cb551f87edb2935324da33d7dfbe4b2b94,0,Henry Robinson,2014-01-08 10:48:48-08:00,['f4d961a241ace3456939bb625f7e6e4c6ea295a6'],8,14,22,2118839,2,0,0,0,1321
0df9476be1477e570fc2e353d166acc3beae48a3,1,Henry Robinson,2014-01-08 10:48:48-08:00,['e0a7b7cb551f87edb2935324da33d7dfbe4b2b94'],18,97,115,2118954,16,0,0,0.625,1321
811d5dd00b87394ffa0f89431b60afc99d7ddd5a,1,Henry Robinson,2014-01-08 10:48:50-08:00,['0df9476be1477e570fc2e353d166acc3beae48a3'],6,13,19,2118973,2,1,1,1,1321
a01573af6372ae2fedd449dcd635f1177582a45e,1,Henry Robinson,2014-01-08 10:48:51-08:00,['811d5dd00b87394ffa0f89431b60afc99d7ddd5a'],20,115,135,2119108,6,0.583333333,1,1,1321
b72c6ab71bb4478368796a450595a2b25e21d8e8,0,Henry Robinson,2014-01-08 10:48:52-08:00,['a01573af6372ae2fedd449dcd635f1177582a45e'],49,60,109,2119217,2,1,1,1,1321
c4c2a7168d905c3e8889654171b4813b3114f605,0,Henry Robinson,2014-01-08 10:48:52-08:00,['b72c6ab71bb4478368796a450595a2b25e21d8e8'],13,22,35,2119252,5,,,,1321
88786fd910e9b2e6c6ee40e60425e01aa02577c4,0,Henry Robinson,2014-01-08 10:48:53-08:00,['c4c2a7168d905c3e8889654171b4813b3114f605'],0,1,1,2119253,1,,,,1321
be03e6c21ca4837f7b77850529c073082305c815,1,Henry Robinson,2014-01-08 10:48:53-08:00,['88786fd910e9b2e6c6ee40e60425e01aa02577c4'],9,109,118,2119371,10,0.657894737,0.605263158,1,1322
9c34c6dde92768915a421527bd403cd37d28e352,0,Henry Robinson,2014-01-08 10:48:53-08:00,['be03e6c21ca4837f7b77850529c073082305c815'],0,1,1,2119372,1,1,1,1,1322
6fdf65ad0f22ee726b28c612c16b9f833e8d6dbb,0,Henry Robinson,2014-01-08 10:48:54-08:00,['9c34c6dde92768915a421527bd403cd37d28e352'],0,2,2,2119374,1,0,0,1,1322
ade4453a179bf30c26eef61578fb4416c031ddbf,0,Henry Robinson,2014-01-08 10:48:54-08:00,['6fdf65ad0f22ee726b28c612c16b9f833e8d6dbb'],2,13,15,2119389,2,,,,1322
8d879726958b63cf631b4db4e8efa0c238531f31,1,Henry Robinson,2014-01-08 10:48:54-08:00,['ade4453a179bf30c26eef61578fb4416c031ddbf'],85,199,284,2119673,6,0.470588235,1,1,1322
06b5a3fe67d0153ae1461a3e8731d31d9c19467b,1,Henry Robinson,2014-01-08 10:48:55-08:00,['8d879726958b63cf631b4db4e8efa0c238531f31'],8,7,15,2119688,1,0,0,0,1322
ca0d23a84477597c12934c216e780d4532d7d018,1,Henry Robinson,2014-01-08 10:48:55-08:00,['06b5a3fe67d0153ae1461a3e8731d31d9c19467b'],78,504,582,2120270,17,0.483695652,0.64673913,0.902173913,1323
79066a2cdfba56b3c608fcd11ffc719564293fc2,1,Henry Robinson,2014-01-08 10:48:55-08:00,['ca0d23a84477597c12934c216e780d4532d7d018'],16,60,76,2120346,7,0.6,0.666666667,0.933333333,1323
75843125403d1ec94f44aae972f1925f464340eb,0,Henry Robinson,2014-01-08 10:48:56-08:00,['79066a2cdfba56b3c608fcd11ffc719564293fc2'],0,37,37,2120383,3,0,0.761904762,0.761904762,1323
831ee529becb61ba35dc82d8ffa899f5bc8186a2,1,Henry Robinson,2014-01-08 10:48:56-08:00,['75843125403d1ec94f44aae972f1925f464340eb'],62,99,161,2120544,9,0.666666667,0.666666667,1,1323
0b4dff1b28a27160434ddb8dc600812b0336a441,1,Henry Robinson,2014-01-08 10:48:56-08:00,['831ee529becb61ba35dc82d8ffa899f5bc8186a2'],18,56,74,2120618,7,0.913043478,1,0.826086957,1323
b5e22d21c7f8af451070268171caa99ecae1eb24,0,Henry Robinson,2014-01-08 10:48:57-08:00,['0b4dff1b28a27160434ddb8dc600812b0336a441'],0,198,198,2120816,2,0.64,0.81,0.81,1324
7c8dba37e492355a33a164fc00f43d31b9dfc768,0,Henry Robinson,2014-01-08 10:48:57-08:00,['b5e22d21c7f8af451070268171caa99ecae1eb24'],6,143,149,2120965,4,0.035087719,0.035087719,0.964912281,1324
180664dbb1fac8d6a23cd59bb44ebc2c9b81f26b,1,Henry Robinson,2014-01-08 10:48:57-08:00,['7c8dba37e492355a33a164fc00f43d31b9dfc768'],42,257,299,2121264,9,0.621428571,1,0.585714286,1324
57c2f828e0e9e9746d310ece36a482cdb6d830ef,1,Henry Robinson,2014-01-08 10:48:58-08:00,['180664dbb1fac8d6a23cd59bb44ebc2c9b81f26b'],4,20,24,2121288,3,0,0,0,1324
8d1674f6382160f9ec7516788a303d0940dc7b30,1,Henry Robinson,2014-01-08 10:48:58-08:00,['57c2f828e0e9e9746d310ece36a482cdb6d830ef'],18,46,64,2121352,8,1,0.411764706,1,1324
e8cd8bfae049c9ee0af634f490eface127d4fb6e,1,Henry Robinson,2014-01-08 10:48:58-08:00,['8d1674f6382160f9ec7516788a303d0940dc7b30'],7,309,316,2121668,8,0.42408377,0.738219895,0.994764398,1325
89ee17b3cab8cf8592d68bbe1bd9435fe49a5cb2,1,Henry Robinson,2014-01-08 10:48:58-08:00,['e8cd8bfae049c9ee0af634f490eface127d4fb6e'],74,145,219,2121887,4,0,0.136363636,0.295454545,1325
0c36c7f327cd372ecdc30c183ec4e88765372421,1,Henry Robinson,2014-01-08 10:48:59-08:00,['89ee17b3cab8cf8592d68bbe1bd9435fe49a5cb2'],264,768,1032,2122919,16,0,0,0,1325
2cae8688c510af8947e96ff3d34f6b2b72a65094,1,Henry Robinson,2014-01-08 10:48:59-08:00,['0c36c7f327cd372ecdc30c183ec4e88765372421'],1998,1677,3675,2126594,32,0.766666667,0.855555556,0.716666667,1329
1e512612b1edbf603df79b9a5b4ec7266ad84120,0,Henry Robinson,2014-01-08 10:48:59-08:00,['2cae8688c510af8947e96ff3d34f6b2b72a65094'],0,1,1,2126595,1,,,,1329
edeed006a57b537970dc6863ed6cbf93a6869de6,0,Henry Robinson,2014-01-08 10:49:00-08:00,['1e512612b1edbf603df79b9a5b4ec7266ad84120'],5,74,79,2126674,4,0.818181818,0.818181818,1,1331
ac7fb11da3fca8e2fe5f4dace4bf38512d4b0afa,1,Henry Robinson,2014-01-08 10:49:00-08:00,['edeed006a57b537970dc6863ed6cbf93a6869de6'],3,25,28,2126702,2,0,0.421052632,1,1331
5f81becd843b551c150ac3bdce3de5eb4e96fa88,0,Henry Robinson,2014-01-08 10:49:00-08:00,['ac7fb11da3fca8e2fe5f4dace4bf38512d4b0afa'],96,103,199,2126901,14,0,0,0,1331
011c43766c48b301fd6b0ceae0e5c6b3a9f7373c,1,Henry Robinson,2014-01-08 10:49:01-08:00,['5f81becd843b551c150ac3bdce3de5eb4e96fa88'],12,17,29,2126930,6,1,0,1,1331
e5f094b5cd3d9a621839ab0251ffbc39c715b2b3,1,Henry Robinson,2014-01-08 10:49:01-08:00,['011c43766c48b301fd6b0ceae0e5c6b3a9f7373c'],71,22,93,2127023,5,1,1,0,1331
fa3bfbaea82d68cb7b53115926eb8b689abb406e,1,Henry Robinson,2014-01-08 10:49:01-08:00,['e5f094b5cd3d9a621839ab0251ffbc39c715b2b3'],295,332,627,2127650,16,1,0,0,1333
15658f384b0b78da6495289b458b4da3b779113f,0,Henry Robinson,2014-01-08 10:49:02-08:00,['fa3bfbaea82d68cb7b53115926eb8b689abb406e'],347,400,747,2128397,2,1,1,1,1334
b6ce0bb7cfab3ff800377529c94cc6fd55b79796,1,Henry Robinson,2014-01-08 10:49:02-08:00,['15658f384b0b78da6495289b458b4da3b779113f'],0,2,2,2128399,1,0,0,1,1334
4c40e785893f053c7a3ac9cd0599428730513f9e,0,Henry Robinson,2014-01-08 10:49:02-08:00,['b6ce0bb7cfab3ff800377529c94cc6fd55b79796'],1,5,6,2128405,2,0,1,1,1334
8f654e9daaf787e715bc542947208d969a521490,0,Henry Robinson,2014-01-08 10:49:03-08:00,['4c40e785893f053c7a3ac9cd0599428730513f9e'],7,8,15,2128420,3,1,1,1,1334
991db9001be30a22e7fdabc317d3f2336d2e748f,1,Henry Robinson,2014-01-08 10:49:03-08:00,['8f654e9daaf787e715bc542947208d969a521490'],20,130,150,2128570,13,0.370967742,0.419354839,0.806451613,1334
f29414e4faae1645dbe6c6896b6642b01484a8f9,0,Henry Robinson,2014-01-08 10:49:03-08:00,['991db9001be30a22e7fdabc317d3f2336d2e748f'],1,1,2,2128572,1,,,,1334
03f04518d71c2a401cb9caa3afdf5ed3d23c7fc2,0,Henry Robinson,2014-01-08 10:49:04-08:00,['f29414e4faae1645dbe6c6896b6642b01484a8f9'],2,2,4,2128576,1,,,,1334
b877240ffdd601066e585bf08f78748f5cac8b47,0,Henry Robinson,2014-01-08 10:49:04-08:00,['03f04518d71c2a401cb9caa3afdf5ed3d23c7fc2'],0,7,7,2128583,2,1,1,0.5,1334
ab4fb45c624aa454f2386fe846385aecff4ee285,1,Henry Robinson,2014-01-08 10:49:04-08:00,['b877240ffdd601066e585bf08f78748f5cac8b47'],71,171,242,2128825,6,0.142857143,0.80952381,0.603174603,1334
b8c90d9852997d860fa82561a195f6ef63199f36,0,Henry Robinson,2014-01-08 10:49:05-08:00,['ab4fb45c624aa454f2386fe846385aecff4ee285'],0,82,82,2128907,1,1,1,0.785714286,1335
f078beda87d82589d090ea26e30fa44f2db90f23,0,Henry Robinson,2014-01-08 10:49:05-08:00,['b8c90d9852997d860fa82561a195f6ef63199f36'],1,1,2,2128909,1,,0,,1335
993da8fcba17a6e76ca78e1996402c136acb8325,0,Henry Robinson,2014-01-08 10:49:05-08:00,['f078beda87d82589d090ea26e30fa44f2db90f23'],4,5,9,2128918,1,0,0,0,1335
0e0c02b6bdf39d9b864f3665307221a1932f926f,1,Henry Robinson,2014-01-08 10:49:06-08:00,['993da8fcba17a6e76ca78e1996402c136acb8325'],189,1033,1222,2130140,30,0.63898917,0.703971119,0.74368231,1343
051c56073aa474b8f69ed3bf4241f81216b926f0,0,Henry Robinson,2014-01-08 10:49:06-08:00,['0e0c02b6bdf39d9b864f3665307221a1932f926f'],40,28,68,2130208,3,1,0,0,1343
0dc71464e49b2ab76981b4a66c8c768f42982777,1,Henry Robinson,2014-01-08 10:49:06-08:00,['051c56073aa474b8f69ed3bf4241f81216b926f0'],61,455,516,2130724,24,0.273469388,0.640816327,0.995918367,1343
cc35292f49686dce2ce050f87b5490139c4c6bd2,1,Henry Robinson,2014-01-08 10:49:07-08:00,['0dc71464e49b2ab76981b4a66c8c768f42982777'],0,135,135,2130859,2,0,0.016129032,1,1343
a354e5ef90ddf1bdf02766586cefaa6261583596,0,Henry Robinson,2014-01-08 10:49:07-08:00,['cc35292f49686dce2ce050f87b5490139c4c6bd2'],1,3,4,2130863,1,1,0,0,1343
8207047b85091b4bddfee91146541ab33aef6008,0,Henry Robinson,2014-01-08 10:49:07-08:00,['a354e5ef90ddf1bdf02766586cefaa6261583596'],2,0,2,2130865,1,1,1,0,1343
e0de4d25b900a131a548c161f749e928fbb51a94,1,Henry Robinson,2014-01-08 10:49:08-08:00,['8207047b85091b4bddfee91146541ab33aef6008'],21,54,75,2130940,1,0.555555556,0.777777778,1,1343
f6a4e20947a9d127954eb06f2e696d0d08799627,0,Henry Robinson,2014-01-08 10:49:08-08:00,['e0de4d25b900a131a548c161f749e928fbb51a94'],10,10,20,2130960,1,,,,1343
e260ac202b268aea87819c1fa8228134ce3bd908,0,Henry Robinson,2014-01-08 10:49:11-08:00,['f6a4e20947a9d127954eb06f2e696d0d08799627'],1,1,2,2130962,1,,,,1343
c5afb115585e2960867d020d7c1762d3c39771a7,1,Henry Robinson,2014-01-08 10:49:13-08:00,['e260ac202b268aea87819c1fa8228134ce3bd908'],116,151,267,2131229,10,0,0,0,1343
a3a3411dc23cecc012df7e804741232970e87337,1,Henry Robinson,2014-01-08 10:49:14-08:00,['c5afb115585e2960867d020d7c1762d3c39771a7'],17,334,351,2131580,17,0,0.120967742,0.927419355,1347
08beacb5f33d685509039a0b6af2708a16370d62,1,Henry Robinson,2014-01-08 10:49:14-08:00,['a3a3411dc23cecc012df7e804741232970e87337'],1,1,2,2131582,1,,,,1347
1fb72fbc73e135f7aadfa0f780826e3b605f6298,1,Henry Robinson,2014-01-08 10:49:14-08:00,['08beacb5f33d685509039a0b6af2708a16370d62'],60,2196,2256,2133838,32,0.552747253,0.759340659,0.825274725,1358
1d97643607a2b068d88bc28134f28824e8e45701,1,Henry Robinson,2014-01-08 10:49:15-08:00,['1fb72fbc73e135f7aadfa0f780826e3b605f6298'],442,608,1050,2134888,18,0.238888889,0.183333333,0.388888889,1358
ffb41b36bed1beb19191dbe356e131ae087691ee,1,Henry Robinson,2014-01-08 10:49:15-08:00,['1d97643607a2b068d88bc28134f28824e8e45701'],3,8,11,2134899,3,0,1,0.333333333,1358
fc310fadab5b6c9d0472b89e946f78b45f5080ef,0,Henry Robinson,2014-01-08 10:49:15-08:00,['ffb41b36bed1beb19191dbe356e131ae087691ee'],11,20,31,2134930,5,0,0,1,1358
63d3e7821a5045890dbfd6988f34f3201baba19f,1,Henry Robinson,2014-01-08 10:49:16-08:00,['fc310fadab5b6c9d0472b89e946f78b45f5080ef'],4,18,22,2134952,4,0.4,0.3,0.5,1358
8ef36831f6d3d44d0a321cbc36ad52519a241673,0,Henry Robinson,2014-01-08 10:49:16-08:00,['63d3e7821a5045890dbfd6988f34f3201baba19f'],1,1,2,2134954,1,,,,1358
45bdfeb199f4279a86cd2956e162799a1367aabc,0,Henry Robinson,2014-01-08 10:49:16-08:00,['8ef36831f6d3d44d0a321cbc36ad52519a241673'],1,1,2,2134956,1,,,,1358
f4a5c0628f23d08370a6ac50629a9ea3217116fe,1,Henry Robinson,2014-01-08 10:49:17-08:00,['45bdfeb199f4279a86cd2956e162799a1367aabc'],5,16,21,2134977,2,1,1,1,1358
9280739fabb3739eb80695a07c0df50b4bd0509c,0,Henry Robinson,2014-01-08 10:49:17-08:00,['f4a5c0628f23d08370a6ac50629a9ea3217116fe'],0,1,1,2134978,1,1,1,1,1358
f9464196304b36a8889966a0f631f183a4ddca25,0,Henry Robinson,2014-01-08 10:49:17-08:00,['9280739fabb3739eb80695a07c0df50b4bd0509c'],27,30,57,2135035,2,1,0,0,1358
5a0b1270c499a9c403dba0a2428b04ae09307d44,1,Henry Robinson,2014-01-08 10:49:17-08:00,['f9464196304b36a8889966a0f631f183a4ddca25'],51,470,521,2135556,14,0.126637555,0.794759825,0.602620087,1358
0821e2f8263d4136e70aae54f2c9cc6094b76b28,1,Henry Robinson,2014-01-08 10:49:18-08:00,['5a0b1270c499a9c403dba0a2428b04ae09307d44'],69,422,491,2136047,6,0,0.5625,0.125,1358
afc6f83ba6a555273fb169a4e8b1c693c1887a25,1,Henry Robinson,2014-01-08 10:49:18-08:00,['0821e2f8263d4136e70aae54f2c9cc6094b76b28'],11,20,31,2136078,4,0.571428571,1,0.714285714,1358
f60f2d3e5088645881210e402a79d3801c066750,1,Henry Robinson,2014-01-08 10:49:18-08:00,['afc6f83ba6a555273fb169a4e8b1c693c1887a25'],265,608,873,2136951,21,0.131707317,0.175609756,0.956097561,1358
20fc7000021f25c5bee45587f71ecf42398dc6b6,1,Henry Robinson,2014-01-08 10:49:19-08:00,['f60f2d3e5088645881210e402a79d3801c066750'],23,29,52,2137003,6,0,0,0,1358
36e9fe1c1aa9746d3158ee6003189b8977856ba7,0,Henry Robinson,2014-01-08 10:49:19-08:00,['20fc7000021f25c5bee45587f71ecf42398dc6b6'],13,28,41,2137044,3,1,1,1,1359
b3cdcc629016becc2af139c41413a52ba5980142,0,Henry Robinson,2014-01-08 10:49:19-08:00,['36e9fe1c1aa9746d3158ee6003189b8977856ba7'],1,3,4,2137048,1,,,,1359
10af855e04bce060d2711e56d864a65b41cbae29,0,Henry Robinson,2014-01-08 10:49:20-08:00,['b3cdcc629016becc2af139c41413a52ba5980142'],1,2,3,2137051,1,1,1,0,1359
329763e5ab3b778d5c6ca6780942cfe2a105393f,0,Henry Robinson,2014-01-08 10:49:20-08:00,['10af855e04bce060d2711e56d864a65b41cbae29'],2,0,2,2137053,2,,,,1359
4a503a4e35d2dea7860f8b2fac5b628de0b1ad7b,1,Henry Robinson,2014-01-08 10:49:20-08:00,['329763e5ab3b778d5c6ca6780942cfe2a105393f'],54,92,146,2137199,13,0.6,0.666666667,0.2,1359
018a72bfe258435fa7efbbac7a8636a826b37c13,1,Henry Robinson,2014-01-08 10:49:21-08:00,['4a503a4e35d2dea7860f8b2fac5b628de0b1ad7b'],65,247,312,2137511,10,0.259259259,0.888888889,1,1359
80168d1162a57f46ae69cd2d70f0dac4483eb6c1,0,Henry Robinson,2014-01-08 10:49:21-08:00,['018a72bfe258435fa7efbbac7a8636a826b37c13'],11,10,21,2137532,2,1,1,0,1359
15f0313283976acfe14d78c5e66af2939ae32118,1,Henry Robinson,2014-01-08 10:49:21-08:00,['80168d1162a57f46ae69cd2d70f0dac4483eb6c1'],52,164,216,2137748,11,0.684210526,0.842105263,0.736842105,1359
673d7b97cfd7538028891670cb746f3af565178f,1,Henry Robinson,2014-01-08 10:49:22-08:00,['15f0313283976acfe14d78c5e66af2939ae32118'],76,195,271,2138019,4,0,0,1,1359
1f12e8a85c677f08756f8be5deba29da73df47aa,1,Henry Robinson,2014-01-08 10:49:22-08:00,['673d7b97cfd7538028891670cb746f3af565178f'],91,127,218,2138237,5,1,0,0.4,1359
9a0e40958c8cd9acf9e0e3307f4e194a9299295b,1,Henry Robinson,2014-01-08 10:49:22-08:00,['1f12e8a85c677f08756f8be5deba29da73df47aa'],10,80,90,2138327,3,0,0.176470588,0.823529412,1359
e7488e25e6884fd29a2e174a2c9aca0d282b5336,1,Henry Robinson,2014-01-08 10:49:23-08:00,['9a0e40958c8cd9acf9e0e3307f4e194a9299295b'],77,106,183,2138510,2,0.3,1,1,1359
0b5b6c5667854c02a87b6d33949bc62ae057add9,1,Henry Robinson,2014-01-08 10:49:23-08:00,['e7488e25e6884fd29a2e174a2c9aca0d282b5336'],33,217,250,2138760,6,0.208333333,0.145833333,1,1360
2ae20cbbb79776375ead0f33cd3430125352a4ac,1,Henry Robinson,2014-01-08 10:49:23-08:00,['0b5b6c5667854c02a87b6d33949bc62ae057add9'],2686,1214,3900,2142660,37,0.734828496,0.10817942,0,1360
f144b9065050cf3b776da3e3710dac1bd9f27b0b,0,Henry Robinson,2014-01-08 10:49:24-08:00,['2ae20cbbb79776375ead0f33cd3430125352a4ac'],7,31,38,2142698,4,1,1,1,1360
4d8d58f35b9f3c03dbeb1a8f311a354e4d8279a6,1,Henry Robinson,2014-01-08 10:49:24-08:00,['f144b9065050cf3b776da3e3710dac1bd9f27b0b'],2,4,6,2142704,1,0,1,0,1360
0b768edcfd47de5feeba3f95e1376c7c867e8eed,1,Henry Robinson,2014-01-08 10:49:24-08:00,['4d8d58f35b9f3c03dbeb1a8f311a354e4d8279a6'],5,77,82,2142786,4,0.527272727,0.781818182,0.618181818,1360
a7e15b14178c155e3c37e98d5cfe4688de88d8f0,1,Henry Robinson,2014-01-08 10:49:25-08:00,['0b768edcfd47de5feeba3f95e1376c7c867e8eed'],7,26,33,2142819,4,0,0.444444444,1,1360
ebab23841ab3d3bd1df9e502cde1ff8115a35fb1,0,Henry Robinson,2014-01-08 10:49:25-08:00,['a7e15b14178c155e3c37e98d5cfe4688de88d8f0'],29,123,152,2142971,8,0,0.666666667,0.866666667,1360
554b6b2cb752297f24b06d39470b5d5b5815dc0a,1,Henry Robinson,2014-01-08 10:49:25-08:00,['ebab23841ab3d3bd1df9e502cde1ff8115a35fb1'],23,134,157,2143128,7,0,1,0.894736842,1360
05739af43d4c09130308217920d177b9236b4f1c,0,Henry Robinson,2014-01-08 10:49:26-08:00,['554b6b2cb752297f24b06d39470b5d5b5815dc0a'],0,17,17,2143145,2,0.636363636,0.636363636,1,1360
a6e8a8213155fb95590ce164af243c791c6457c2,0,Henry Robinson,2014-01-08 10:49:26-08:00,['05739af43d4c09130308217920d177b9236b4f1c'],3,0,3,2143148,1,1,1,0,1360
6f4b30a66b0b45ec489c1afb6bab28b7249cc169,0,Henry Robinson,2014-01-08 10:49:26-08:00,['a6e8a8213155fb95590ce164af243c791c6457c2'],13,14,27,2143175,6,,0,0,1360
1fcfb72bc45928b0c4e07be16a25dc9d8d01edc6,1,Henry Robinson,2014-01-08 10:49:27-08:00,['6f4b30a66b0b45ec489c1afb6bab28b7249cc169'],15,27,42,2143217,2,0,0,1,1360
eb385311cb34bf8792c5e4d24c4b430b232d0c36,1,Henry Robinson,2014-01-08 10:49:28-08:00,['1fcfb72bc45928b0c4e07be16a25dc9d8d01edc6'],9,14,23,2143240,3,0,1,1,1360
5f7084b4d2540955fca704e97d5c9b88fcb29e34,1,Henry Robinson,2014-01-08 10:49:28-08:00,['eb385311cb34bf8792c5e4d24c4b430b232d0c36'],5,5,10,2143250,1,,,,1360
558d5ce7552b57f80c9f5ce64c64b9687994b076,1,Henry Robinson,2014-01-08 10:49:28-08:00,['5f7084b4d2540955fca704e97d5c9b88fcb29e34'],194,189,383,2143633,5,0.25,0.25,0,1360
8d1521ca8086ed553a840d138fe60f95a567b38a,1,Henry Robinson,2014-01-08 10:49:29-08:00,['558d5ce7552b57f80c9f5ce64c64b9687994b076'],1,55,56,2143689,1,0.72,0.88,0.28,1360
f25c60884e0766c0139f98ea81c5106d5aa6c857,1,Henry Robinson,2014-01-08 10:49:29-08:00,['8d1521ca8086ed553a840d138fe60f95a567b38a'],67,99,166,2143855,12,0.428571429,0.642857143,0.928571429,1360
d7e22f44bbe540047b4147a603f2bf38db44b929,1,Henry Robinson,2014-01-08 10:49:29-08:00,['f25c60884e0766c0139f98ea81c5106d5aa6c857'],637,1242,1879,2145734,33,0.117408907,0.238866397,0.449392713,1360
5f9e26b4a82ed7a6e3fd79436534f6eaaa96b977,1,Henry Robinson,2014-01-08 10:49:30-08:00,['d7e22f44bbe540047b4147a603f2bf38db44b929'],120,629,749,2146483,16,0.334645669,0.547244094,0.637795276,1360
c85acf424d097d6d8404e97a9aaa43f95cf934f9,0,Henry Robinson,2014-01-08 10:49:30-08:00,['5f9e26b4a82ed7a6e3fd79436534f6eaaa96b977'],0,3,3,2146486,1,1,1,1,1360
bc63ac2461cfb181ebdbdd9b08470079fed2c301,0,Henry Robinson,2014-01-08 10:49:30-08:00,['c85acf424d097d6d8404e97a9aaa43f95cf934f9'],2,9,11,2146497,2,0,1,0.666666667,1360
8c3287db82d87c786781f79f46808f0c33d4aa61,1,Henry Robinson,2014-01-08 10:49:31-08:00,['bc63ac2461cfb181ebdbdd9b08470079fed2c301'],46,242,288,2146785,12,0.140495868,0.958677686,0.826446281,1360
c419ae1891ddd97fbe62be8523cf089c9fee3ee5,1,Henry Robinson,2014-01-08 10:49:31-08:00,['8c3287db82d87c786781f79f46808f0c33d4aa61'],33,286,319,2147104,7,0.074285714,0.228571429,1,1360
e2187213861cb3bb0f7de0f88af4ec00649024ca,1,Henry Robinson,2014-01-08 10:49:31-08:00,['c419ae1891ddd97fbe62be8523cf089c9fee3ee5'],53,157,210,2147314,8,0.066666667,0.711111111,0.777777778,1360
189f4313dc8a09f7bb38a83dc081f0829196da9b,0,Henry Robinson,2014-01-08 10:49:32-08:00,['e2187213861cb3bb0f7de0f88af4ec00649024ca'],18,23,41,2147355,2,0,0,1,1360
1b2e8280d4d561c8e30bc48dcb9b7b3567fc2e7e,1,Henry Robinson,2014-01-08 10:49:32-08:00,['189f4313dc8a09f7bb38a83dc081f0829196da9b'],406,1151,1557,2148912,41,0.082289803,0.84078712,0.955277281,1360
2773f00c218d8eed801201ad59e4f095627ec3dd,0,Henry Robinson,2014-01-08 10:49:32-08:00,['1b2e8280d4d561c8e30bc48dcb9b7b3567fc2e7e'],1,2,3,2148915,1,,,,1360
02183620d75748aca62178e68135592d0e2b0982,0,Henry Robinson,2014-01-08 10:49:33-08:00,['2773f00c218d8eed801201ad59e4f095627ec3dd'],1,3,4,2148919,1,1,1,1,1360
612e1b22dc5d5d89e84358b2be84cad15ae1e252,0,Henry Robinson,2014-01-08 10:49:33-08:00,['02183620d75748aca62178e68135592d0e2b0982'],4,6,10,2148929,1,0,1,1,1360
0b0367d82ef545baf2850d152dae4eddbf8a31c3,0,Henry Robinson,2014-01-08 10:49:33-08:00,['612e1b22dc5d5d89e84358b2be84cad15ae1e252'],30,15,45,2148974,1,1,1,0,1360
32ee207de49bc614c4d6124f71ee84d07a31437e,0,Henry Robinson,2014-01-08 10:49:34-08:00,['0b0367d82ef545baf2850d152dae4eddbf8a31c3'],33,14,47,2149021,2,1,1,0,1360
398e725a23e165318c39fda67d769855e124d71e,1,Henry Robinson,2014-01-08 10:49:34-08:00,['32ee207de49bc614c4d6124f71ee84d07a31437e'],425,232,657,2149678,6,,,,1360
cba9cd00dd65f651bc496c513accbc9aa6547da1,1,Henry Robinson,2014-01-08 10:49:34-08:00,['398e725a23e165318c39fda67d769855e124d71e'],56,24,80,2149758,3,0.333333333,0.333333333,0,1360
1cc976819eb4e1075d3b7551e9c42ce674dd6121,0,Henry Robinson,2014-01-08 10:49:35-08:00,['cba9cd00dd65f651bc496c513accbc9aa6547da1'],3,1,4,2149762,1,0,0,0,1360
51c47a94d26a45b8e97bb6595daaf85b7dec1362,1,Henry Robinson,2014-01-08 10:49:35-08:00,['1cc976819eb4e1075d3b7551e9c42ce674dd6121'],33,31,64,2149826,1,1,1,0,1360
0891179bbf28fd7e6b74b5091f3d90b04b35f2f5,0,Henry Robinson,2014-01-08 10:49:35-08:00,['51c47a94d26a45b8e97bb6595daaf85b7dec1362'],2,11,13,2149839,4,0,0.5,1,1360
d0c08eb8d6b67cfa2b9d54d5faccae74832a68ef,0,Henry Robinson,2014-01-08 10:49:35-08:00,['0891179bbf28fd7e6b74b5091f3d90b04b35f2f5'],12,5,17,2149856,2,0.25,0,0,1360
b72b711bdb7d9a3a40ead5474d2ae7c1ef846b69,1,Henry Robinson,2014-01-08 10:49:36-08:00,['d0c08eb8d6b67cfa2b9d54d5faccae74832a68ef'],3,11,14,2149870,2,0.2,0.4,0.8,1360
1f9f6562473748c2c1f99d298e41db35fe659c59,1,Henry Robinson,2014-01-08 10:49:36-08:00,['b72b711bdb7d9a3a40ead5474d2ae7c1ef846b69'],1,14,15,2149885,2,0,1,1,1360
e3a16903d569eeb8153fbbf768ec0b2d4c402b57,1,Henry Robinson,2014-01-08 10:49:36-08:00,['1f9f6562473748c2c1f99d298e41db35fe659c59'],2,11,13,2149898,3,0,0.333333333,1,1360
d3375d4aece33b5e5f109511977e1d77eaa6d07c,1,Henry Robinson,2014-01-08 10:49:37-08:00,['e3a16903d569eeb8153fbbf768ec0b2d4c402b57'],0,1,1,2149899,1,0,0,1,1360
3e705944840f4bfa28015b5724de54c04abef9ec,0,Henry Robinson,2014-01-08 10:49:37-08:00,['d3375d4aece33b5e5f109511977e1d77eaa6d07c'],5,5,10,2149909,1,,,,1360
c0c2c735186cdb105b3da9d5483615bbcfd8f748,0,Henry Robinson,2014-01-08 10:49:37-08:00,['3e705944840f4bfa28015b5724de54c04abef9ec'],1,4,5,2149914,1,1,1,1,1360
3567935f11f10e46436d8d36c8b4442f8dc7ae05,1,Henry Robinson,2014-01-08 10:49:38-08:00,['c0c2c735186cdb105b3da9d5483615bbcfd8f748'],2,69,71,2149985,1,0.21875,0,1,1360
14d29aa579004a669b47a355e36b75f6df4ead4c,0,Henry Robinson,2014-01-08 10:49:38-08:00,['3567935f11f10e46436d8d36c8b4442f8dc7ae05'],2,18,20,2150005,4,0,0,1,1360
2575a34fa30b19705f982e1b1090932d146f3c86,1,Henry Robinson,2014-01-08 10:49:38-08:00,['14d29aa579004a669b47a355e36b75f6df4ead4c'],8,22,30,2150035,3,1,1,1,1360
c998c30771f977c49c6b6b70fd5c4f36fc75eed8,1,Henry Robinson,2014-01-08 10:49:39-08:00,['2575a34fa30b19705f982e1b1090932d146f3c86'],55,141,196,2150231,8,0,1,0.022222222,1360
3093006ca955c80382b6668ec6779be1e0386815,1,Henry Robinson,2014-01-08 10:49:39-08:00,['c998c30771f977c49c6b6b70fd5c4f36fc75eed8'],4,12,16,2150247,1,0.666666667,0.666666667,0,1360
0dcfbfafed6fa85bd77cbff68a98ab1f2e3101dc,1,Henry Robinson,2014-01-08 10:49:39-08:00,['3093006ca955c80382b6668ec6779be1e0386815'],31,54,85,2150332,12,0,0,0.875,1360
563cbfa3a8adc1e245929f2233fe25f1b5beb59e,1,Henry Robinson,2014-01-08 10:49:40-08:00,['0dcfbfafed6fa85bd77cbff68a98ab1f2e3101dc'],13,12,25,2150357,6,0,1,0,1360
741599dc2a56551d9e5a944324d2a06fb31fb003,1,Henry Robinson,2014-01-08 10:49:40-08:00,['563cbfa3a8adc1e245929f2233fe25f1b5beb59e'],0,4,4,2150361,1,1,1,1,1360
711e3f1aed3fab3efb8df73d18df517a8274cef9,0,Henry Robinson,2014-01-08 10:49:40-08:00,['741599dc2a56551d9e5a944324d2a06fb31fb003'],13,20,33,2150394,2,0,1,1,1360
189575f23f86ada56fe70453f442f58ca31da034,0,Henry Robinson,2014-01-08 10:49:41-08:00,['711e3f1aed3fab3efb8df73d18df517a8274cef9'],8,24,32,2150426,3,0,1,1,1360
1f6481382e65f07757fc9e4c9a41577aec42db73,0,Henry Robinson,2014-01-08 10:49:41-08:00,['189575f23f86ada56fe70453f442f58ca31da034'],6,7,13,2150439,6,,,,1360
2a4982ffd49cd08767192d17e8c0633569850fc4,0,Henry Robinson,2014-01-08 10:49:41-08:00,['1f6481382e65f07757fc9e4c9a41577aec42db73'],2,0,2,2150441,1,0,0,0,1360
57aac373aede1fe01ab29b8d49ec8a55af00f299,0,Henry Robinson,2014-01-08 10:49:42-08:00,['2a4982ffd49cd08767192d17e8c0633569850fc4'],0,13,13,2150454,3,0,1,1,1360
925223d437685f7e1b45b538399d83c8215829c2,0,Henry Robinson,2014-01-08 10:49:42-08:00,['57aac373aede1fe01ab29b8d49ec8a55af00f299'],27,48,75,2150529,4,1,1,1,1360
1693ad4eb3427e03718d1d71fa93f88fb6ee845b,0,Henry Robinson,2014-01-08 10:49:43-08:00,['925223d437685f7e1b45b538399d83c8215829c2'],3,3,6,2150535,1,,,,1360
7ccb1b8194307ba74855ff8a1a006f21f4e6e00c,0,Henry Robinson,2014-01-08 10:49:43-08:00,['1693ad4eb3427e03718d1d71fa93f88fb6ee845b'],1,5,6,2150541,2,0,1,1,1360
a3ae4e3252a7057b4ac617610d6c51d48cb03c51,0,Henry Robinson,2014-01-08 10:49:43-08:00,['7ccb1b8194307ba74855ff8a1a006f21f4e6e00c'],0,11,11,2150552,1,0,0.333333333,1,1360
b282175461ad502bcacc8b9c781fe4c726478f1c,1,Henry Robinson,2014-01-08 10:49:44-08:00,['a3ae4e3252a7057b4ac617610d6c51d48cb03c51'],57,36,93,2150645,5,1,1,0,1360
16504f2a27e529f1967c4d3b3f8d351769111a14,1,Henry Robinson,2014-01-08 10:49:44-08:00,['b282175461ad502bcacc8b9c781fe4c726478f1c'],2,2,4,2150649,1,,,,1360
cd9debb792aa07a54c3fc9af6916ffc7a30fb3e0,0,Henry Robinson,2014-01-08 10:49:44-08:00,['16504f2a27e529f1967c4d3b3f8d351769111a14'],1,1,2,2150651,1,,,,1360
ab709cb517857e8e344e20ee55b01a641c015cb6,1,Henry Robinson,2014-01-08 10:49:45-08:00,['cd9debb792aa07a54c3fc9af6916ffc7a30fb3e0'],21,139,160,2150811,11,0,0.527777778,0.513888889,1361
2277386d4d200c33d06bd44fd6d787ddde1c289a,0,Henry Robinson,2014-01-08 10:49:45-08:00,['ab709cb517857e8e344e20ee55b01a641c015cb6'],1,42,43,2150854,2,1,1,1,1361
829c0dc9489eaf62a74c0c671a68b79bfc66f605,1,Henry Robinson,2014-01-08 10:49:45-08:00,['2277386d4d200c33d06bd44fd6d787ddde1c289a'],11,14,25,2150879,4,1,1,1,1361
49160d0ad89caa5b90b3b8385bbd8b88e811dcee,1,Henry Robinson,2014-01-08 10:49:46-08:00,['829c0dc9489eaf62a74c0c671a68b79bfc66f605'],35,104,139,2151018,7,0.357142857,0.380952381,0.80952381,1361
58631d9ce0610bc8dfe1fa5c6cf81885644729eb,1,Henry Robinson,2014-01-08 10:49:46-08:00,['49160d0ad89caa5b90b3b8385bbd8b88e811dcee'],19,19,38,2151056,2,,,,1361
60a4c823b50a28ef30011ddc146859fd8e3ac3ba,0,Henry Robinson,2014-01-08 10:49:46-08:00,['58631d9ce0610bc8dfe1fa5c6cf81885644729eb'],11,16,27,2151083,5,0,1,1,1361
c74b7e41dd867b70da9a6d62b76d060cf6219074,1,Henry Robinson,2014-01-08 10:49:47-08:00,['60a4c823b50a28ef30011ddc146859fd8e3ac3ba'],15,47,62,2151145,5,1,1,1,1361
04bee45af514246b024827154b1db6aa4c3a37ce,0,Henry Robinson,2014-01-08 10:49:47-08:00,['c74b7e41dd867b70da9a6d62b76d060cf6219074'],1,1,2,2151147,1,,,,1361
b140597210f0fa6bfdc7c6fd5763b797ba9f5f3e,0,Henry Robinson,2014-01-08 10:49:47-08:00,['04bee45af514246b024827154b1db6aa4c3a37ce'],2,0,2,2151149,1,1,1,0,1361
805fa50d6f8f74e2e7e90a757c416b29a10a09fe,1,Henry Robinson,2014-01-08 10:49:48-08:00,['b140597210f0fa6bfdc7c6fd5763b797ba9f5f3e'],14,312,326,2151475,10,0,0,1,1361
8c55a89190543c0e791b4f402b0c80124d93a4c2,0,Henry Robinson,2014-01-08 10:49:48-08:00,['805fa50d6f8f74e2e7e90a757c416b29a10a09fe'],1,1,2,2151477,1,,,,1361
5db3f2cdf5ffd076b00034ab656fdd60fd8f37cc,1,Henry Robinson,2014-01-08 10:49:48-08:00,['8c55a89190543c0e791b4f402b0c80124d93a4c2'],483,513,996,2152473,15,1,0,0.666666667,1361
9e8fe07059ed79aa7b59d7b1d5591e322450119b,0,Henry Robinson,2014-01-08 10:49:49-08:00,['5db3f2cdf5ffd076b00034ab656fdd60fd8f37cc'],19,23,42,2152515,3,0,0.571428571,1,1361
2a5df9e9f0dcc9599ae1f4e5328cf7260d17fd84,0,Henry Robinson,2014-01-08 10:49:49-08:00,['9e8fe07059ed79aa7b59d7b1d5591e322450119b'],0,6,6,2152521,1,0,0,1,1361
83ba08cf1319ed06021180d6785211bcf24aa508,0,Henry Robinson,2014-01-08 10:49:49-08:00,['2a5df9e9f0dcc9599ae1f4e5328cf7260d17fd84'],1,1,2,2152523,1,,,,1361
885438dc4bfe2a3ac6db3999544f1334c9faafe3,1,Henry Robinson,2014-01-08 10:49:50-08:00,['83ba08cf1319ed06021180d6785211bcf24aa508'],3,4,7,2152530,1,,,,1361
0d45a3a54b8e2bcb93598e11795299c71544ae69,0,Henry Robinson,2014-01-08 10:49:50-08:00,['885438dc4bfe2a3ac6db3999544f1334c9faafe3'],6,14,20,2152550,1,0,0,0,1361
7bf87a4b54207b44e49989c87f4cf20ac1637e99,0,Henry Robinson,2014-01-08 10:49:50-08:00,['0d45a3a54b8e2bcb93598e11795299c71544ae69'],99,347,446,2152996,6,0,0,0,1361
0cf6c6efca723ec60f059f9377b8a3dde1ee31d8,1,Henry Robinson,2014-01-08 10:49:51-08:00,['7bf87a4b54207b44e49989c87f4cf20ac1637e99'],85,143,228,2153224,8,1,0.842105263,0.473684211,1361
7aadac236de0cdd7e8fb88d1dcc2adad2662caec,1,Henry Robinson,2014-01-08 10:49:51-08:00,['0cf6c6efca723ec60f059f9377b8a3dde1ee31d8'],3,15,18,2153242,2,0,0,0.888888889,1361
2c8ec05dcf5da0c5a87f2e30850f0bf958a21229,1,Henry Robinson,2014-01-08 10:49:51-08:00,['7aadac236de0cdd7e8fb88d1dcc2adad2662caec'],21,29,50,2153292,4,1,1,1,1361
21685d4f8f27d554ffbee546a12c6f5bccfcc397,1,Henry Robinson,2014-01-08 10:49:52-08:00,['2c8ec05dcf5da0c5a87f2e30850f0bf958a21229'],44,74,118,2153410,4,0,0,0,1361
0ac303ad82a0229aa550643edd46d35fbe9900f7,1,Henry Robinson,2014-01-08 10:49:52-08:00,['21685d4f8f27d554ffbee546a12c6f5bccfcc397'],43,55,98,2153508,6,0,1,0,1361
cc6007cf9ee1ae19c942685399a7970a4957b078,0,Henry Robinson,2014-01-08 10:49:52-08:00,['0ac303ad82a0229aa550643edd46d35fbe9900f7'],19,20,39,2153547,3,1,0,0,1361
329edcef64455590b3ec8260f2c5347a8ee77ec5,0,Henry Robinson,2014-01-08 10:49:53-08:00,['cc6007cf9ee1ae19c942685399a7970a4957b078'],3,2,5,2153552,1,,,,1361
dcbd408fa8a62b13bf73ee4c4dac48dbfeb098c2,0,Henry Robinson,2014-01-08 10:49:53-08:00,['329edcef64455590b3ec8260f2c5347a8ee77ec5'],0,11,11,2153563,1,1,1,0.9,1361
dbe312738312264029ce508e4bbc07d5d03c9d90,0,Henry Robinson,2014-01-08 10:49:53-08:00,['dcbd408fa8a62b13bf73ee4c4dac48dbfeb098c2'],1,26,27,2153590,2,0,1,1,1361
4c45bc06c4653719fe7dd4d084468aeef3fb7a91,1,Henry Robinson,2014-01-08 10:49:53-08:00,['dbe312738312264029ce508e4bbc07d5d03c9d90'],1,15,16,2153606,3,,,,1361
abafcf81ff65b32fee5732da689407c4360c9601,0,Henry Robinson,2014-01-08 10:49:54-08:00,['4c45bc06c4653719fe7dd4d084468aeef3fb7a91'],3,3,6,2153612,2,0,0,1,1361
7d2c47ad729b052d2ac7c7b009c96953e282d4b7,1,Henry Robinson,2014-01-08 10:49:54-08:00,['abafcf81ff65b32fee5732da689407c4360c9601'],23,72,95,2153707,5,1,0.857142857,0,1361
d5a6a3f5fcc39328dd0e441500e364dde04d57f1,0,Henry Robinson,2014-01-08 10:49:54-08:00,['7d2c47ad729b052d2ac7c7b009c96953e282d4b7'],7,47,54,2153761,4,0.2,1,1,1361
aa08c56c91719e4b4b66782b8eaae14e1b22a448,0,Henry Robinson,2014-01-08 10:49:55-08:00,['d5a6a3f5fcc39328dd0e441500e364dde04d57f1'],1,1,2,2153763,1,,,,1361
872d736ae9e3b1c4f1d966f6766211ae40d5e837,0,Henry Robinson,2014-01-08 10:49:55-08:00,['aa08c56c91719e4b4b66782b8eaae14e1b22a448'],6,15,21,2153784,2,0.125,0.125,0.125,1361
a8733dfe495a213ee4c51cc67fd91a72573fb0cb,0,Henry Robinson,2014-01-08 10:49:55-08:00,['872d736ae9e3b1c4f1d966f6766211ae40d5e837'],0,10,10,2153794,1,0,1,1,1361
3f871be042d53ef16d02760224bcc64a0853abaf,0,Henry Robinson,2014-01-08 10:49:56-08:00,['a8733dfe495a213ee4c51cc67fd91a72573fb0cb'],1,1,2,2153796,1,,,,1361
a4cc48a633d1bb99a57f02d3323a4f96590a42ee,1,Henry Robinson,2014-01-08 10:49:56-08:00,['3f871be042d53ef16d02760224bcc64a0853abaf'],101,158,259,2154055,13,0.277777778,0.444444444,0.944444444,1362
ab2c5763cb07f5f148846f52ecb606e8f0a27fad,0,Henry Robinson,2014-01-08 10:49:56-08:00,['a4cc48a633d1bb99a57f02d3323a4f96590a42ee'],1,28,29,2154084,4,0.466666667,1,1,1362
371579211d6fce72d1abc102be3bf375150db0ec,1,Henry Robinson,2014-01-08 10:49:57-08:00,['ab2c5763cb07f5f148846f52ecb606e8f0a27fad'],22,52,74,2154158,3,0.833333333,0.5,1,1362
c3ab9160604dceab4a319059c086f7ade07ce47c,1,Henry Robinson,2014-01-08 10:49:57-08:00,['371579211d6fce72d1abc102be3bf375150db0ec'],4,41,45,2154203,6,1,1,1,1362
baf5e1d50c5431d58cd2c77ba2a3657aeea56ccd,0,Henry Robinson,2014-01-08 10:49:57-08:00,['c3ab9160604dceab4a319059c086f7ade07ce47c'],0,6,6,2154209,1,,,,1362
1260c6fc3e323352e2cfb951b5a092415cb9044b,1,Henry Robinson,2014-01-08 10:49:58-08:00,['baf5e1d50c5431d58cd2c77ba2a3657aeea56ccd'],18,6,24,2154233,1,0.166666667,1,0,1362
132513f98cb8fa5fe9087aadaa9e7cc03fd4ece2,0,Henry Robinson,2014-01-08 10:49:58-08:00,['1260c6fc3e323352e2cfb951b5a092415cb9044b'],112,155,267,2154500,3,0.454545455,1,0.454545455,1362
ce92b2d906ac3cb7fe517780228d410550f6e67b,0,Henry Robinson,2014-01-08 10:49:58-08:00,['132513f98cb8fa5fe9087aadaa9e7cc03fd4ece2'],4,10,14,2154514,2,0.2,1,1,1362
b872db23617cf3514033cf01dae9fa1216069195,0,Henry Robinson,2014-01-08 10:49:59-08:00,['ce92b2d906ac3cb7fe517780228d410550f6e67b'],0,15,15,2154529,4,0.8,1,1,1362
5bfc477ccc78066a78315972746f083f38eb15ae,0,Henry Robinson,2014-01-08 10:49:59-08:00,['b872db23617cf3514033cf01dae9fa1216069195'],381,401,782,2155311,8,0.571428571,0.857142857,0.785714286,1362
4dc46002aec3dd68c636a07669dfe265f5697650,1,Henry Robinson,2014-01-08 10:49:59-08:00,['5bfc477ccc78066a78315972746f083f38eb15ae'],40,81,121,2155432,6,0,1,0.823529412,1362
39789d5da27c383e80387cda603b86fb514cb3c0,1,Henry Robinson,2014-01-08 10:50:00-08:00,['4dc46002aec3dd68c636a07669dfe265f5697650'],12,33,45,2155477,8,0.0625,0.1875,0.875,1362
afd87ed3b52079e7316365144faee1ff3a126a47,0,Henry Robinson,2014-01-08 10:50:00-08:00,['39789d5da27c383e80387cda603b86fb514cb3c0'],18,19,37,2155514,1,0,0,1,1362
c5286a631845700bb5aae1caa94fd744132c5eaf,0,Henry Robinson,2014-01-08 10:50:00-08:00,['afd87ed3b52079e7316365144faee1ff3a126a47'],9,26,35,2155549,1,0,0,0.3,1362
b472b4bca6ab6da9192485da2b2e56e250414d17,0,Henry Robinson,2014-01-08 10:50:01-08:00,['c5286a631845700bb5aae1caa94fd744132c5eaf'],1,1,2,2155551,1,,,,1362
9559f2a3d95f6edfe6c9bf25e95c16483679173d,1,Henry Robinson,2014-01-08 10:50:01-08:00,['b472b4bca6ab6da9192485da2b2e56e250414d17'],23,158,181,2155732,10,0.710526316,0.934210526,0.960526316,1362
018028f8e390639b5ff2dc3a37b39a74432630e5,1,Henry Robinson,2014-01-08 10:50:01-08:00,['9559f2a3d95f6edfe6c9bf25e95c16483679173d'],6,30,36,2155768,4,0.5,0,1,1362
0c343913faff4e029d61aaf92ecf5c0d8c24cb8a,0,Henry Robinson,2014-01-08 10:50:02-08:00,['018028f8e390639b5ff2dc3a37b39a74432630e5'],42,85,127,2155895,13,0.333333333,0.388888889,0,1362
76b4102101074c8c9e221fd55e1a073ae07c9a84,1,Henry Robinson,2014-01-08 10:50:02-08:00,['0c343913faff4e029d61aaf92ecf5c0d8c24cb8a'],297,1140,1437,2157332,37,0.412921348,0.696629213,0.803370787,1365
b9d76b560677744b91e10dd6e23b809e1530c9ea,1,Henry Robinson,2014-01-08 10:50:02-08:00,['76b4102101074c8c9e221fd55e1a073ae07c9a84'],11,38,49,2157381,1,1,1,0,1365
6783da6c9b087e3f341172cd40cdcda1369af31f,1,Henry Robinson,2014-01-08 10:50:03-08:00,['b9d76b560677744b91e10dd6e23b809e1530c9ea'],135,300,435,2157816,17,0.421052632,0.473684211,0.881578947,1365
1656e779b968ba9e36bc7eb0330fac04b5ff0bbe,1,Henry Robinson,2014-01-08 10:50:03-08:00,['6783da6c9b087e3f341172cd40cdcda1369af31f'],30,3834,3864,2161680,26,0.486452426,0.483301827,0.563957152,1390
a90924400091b897b36fdd69ddb84e37e22944a1,1,Henry Robinson,2014-01-08 10:50:04-08:00,['1656e779b968ba9e36bc7eb0330fac04b5ff0bbe'],8,8,16,2161696,1,,,,1390
193219e71857203782fe158f9ecf11118d6e4823,0,Henry Robinson,2014-01-08 10:50:04-08:00,['a90924400091b897b36fdd69ddb84e37e22944a1'],6,11,17,2161713,1,1,1,0,1390
b2a3ddd11ba45c46dcc4a777267f731acfb39a40,1,Henry Robinson,2014-01-08 10:50:04-08:00,['193219e71857203782fe158f9ecf11118d6e4823'],0,3,3,2161716,1,,,,1390
558590140ced949e821d34236ba567be0c352b7d,1,Henry Robinson,2014-01-08 10:50:05-08:00,['b2a3ddd11ba45c46dcc4a777267f731acfb39a40'],13,59,72,2161788,6,0.260869565,0,1,1390
eaecfd027da686d03dfd22bed9629cafef4817a5,1,Henry Robinson,2014-01-08 10:50:05-08:00,['558590140ced949e821d34236ba567be0c352b7d'],34,95,129,2161917,13,0.75,0.805555556,0.638888889,1390
ea9314373f05c18818cb8848bf2b7e869827c268,0,Henry Robinson,2014-01-08 10:50:05-08:00,['eaecfd027da686d03dfd22bed9629cafef4817a5'],9,29,38,2161955,8,0.8,0,0.8,1390
9ae79116db294d82c9e1dd21b053d6bde2e6c79f,1,Henry Robinson,2014-01-08 10:50:06-08:00,['ea9314373f05c18818cb8848bf2b7e869827c268'],1,25,26,2161981,5,0.375,0.75,0.875,1390
5673ae32a325a008748bb004e0e742de01de3194,0,Henry Robinson,2014-01-08 10:50:06-08:00,['9ae79116db294d82c9e1dd21b053d6bde2e6c79f'],0,6,6,2161987,1,0,1,0,1390
ff2ae70b275768102f85a78e384bd70668d57745,0,Henry Robinson,2014-01-08 10:50:06-08:00,['5673ae32a325a008748bb004e0e742de01de3194'],9,30,39,2162026,4,0.5,0.875,1,1390
7a8f014d15c9ff276fbe396f3239f2172fba41df,0,Henry Robinson,2014-01-08 10:50:06-08:00,['ff2ae70b275768102f85a78e384bd70668d57745'],1,1,2,2162028,1,,,,1390
21ec49e81007c1448971c34d8a35796f3177cc6e,1,Henry Robinson,2014-01-08 10:50:07-08:00,['7a8f014d15c9ff276fbe396f3239f2172fba41df'],86,290,376,2162404,10,0,0.25,0,1390
421378c0075636070e56d73db9cb3c4a40002872,0,Henry Robinson,2014-01-08 10:50:07-08:00,['21ec49e81007c1448971c34d8a35796f3177cc6e'],2,1,3,2162407,1,0,0,0,1390
14557c7bab3c81b82ab3f2e10eb321042e4452ad,1,Henry Robinson,2014-01-08 10:50:08-08:00,['421378c0075636070e56d73db9cb3c4a40002872'],674,529,1203,2163610,26,0,1,0,1390
1f017b8f5bf3c23415211091fbcca8ec8a216096,1,Henry Robinson,2014-01-08 10:50:08-08:00,['14557c7bab3c81b82ab3f2e10eb321042e4452ad'],12,49,61,2163671,8,0,1,0,1390
f8e664791a9a3bc54b6d3d41253eb5087db53214,0,Henry Robinson,2014-01-08 10:50:08-08:00,['1f017b8f5bf3c23415211091fbcca8ec8a216096'],6,9,15,2163686,2,0.666666667,1,0.666666667,1390
d02f37e60f058cbc81096fe7f01bd3e42d1e730c,0,Henry Robinson,2014-01-08 10:50:09-08:00,['f8e664791a9a3bc54b6d3d41253eb5087db53214'],0,4,4,2163690,1,0,1,0,1390
c9040aee22d1f20e1b9f2a60df487d51e8d9fff4,0,Henry Robinson,2014-01-08 10:50:09-08:00,['d02f37e60f058cbc81096fe7f01bd3e42d1e730c'],33,139,172,2163862,5,0,0.592592593,0,1390
861ba059893a98653f28980fc4a548d79f9aeba7,1,Henry Robinson,2014-01-08 10:50:09-08:00,['c9040aee22d1f20e1b9f2a60df487d51e8d9fff4'],61,442,503,2164365,21,0.897260274,0.98630137,0.883561644,1393
2d25f11ec3af5322e2507243bbff432d8b167626,1,Henry Robinson,2014-01-08 10:50:10-08:00,['861ba059893a98653f28980fc4a548d79f9aeba7'],8560,10412,18972,2183337,29,0.3,0,0,1393
c31f8a856aef5087033fb61208c96dcf69ddaf8c,1,Henry Robinson,2014-01-08 10:50:10-08:00,['2d25f11ec3af5322e2507243bbff432d8b167626'],1,11,12,2183349,1,0,1,1,1393
0ebd2f76e451bb1cad43a0920b44045b0aad8d72,0,Henry Robinson,2014-01-08 10:50:10-08:00,['c31f8a856aef5087033fb61208c96dcf69ddaf8c'],2,17,19,2183368,3,0,0.666666667,0.833333333,1393
6b636d63a8d5b88d20af267197308bd206699a16,0,Henry Robinson,2014-01-08 10:50:11-08:00,['0ebd2f76e451bb1cad43a0920b44045b0aad8d72'],7,10,17,2183385,1,,,,1393
93536d980f573fd419af657948d6714749f6ef0b,1,Henry Robinson,2014-01-08 10:50:11-08:00,['6b636d63a8d5b88d20af267197308bd206699a16'],3,28,31,2183416,1,0.9375,1,1,1393
351d907e3dd67222f7ee3fbc74e0bb07e0654feb,0,Henry Robinson,2014-01-08 10:50:11-08:00,['93536d980f573fd419af657948d6714749f6ef0b'],18,24,42,2183458,5,1,1,0,1393
4235bf5009f39b2528a9e5287e43ad302cfb2360,0,Henry Robinson,2014-01-08 10:50:11-08:00,['351d907e3dd67222f7ee3fbc74e0bb07e0654feb'],6,6,12,2183470,1,,,,1393
6f613730743cfb8c327dea9626da55853419a14d,0,Henry Robinson,2014-01-08 10:50:12-08:00,['4235bf5009f39b2528a9e5287e43ad302cfb2360'],2,4,6,2183476,1,1,1,0,1393
3f0252c9f3f7abc9e81ed34212d4c40cffa23038,0,Henry Robinson,2014-01-08 10:50:12-08:00,['6f613730743cfb8c327dea9626da55853419a14d'],19,22,41,2183517,3,1,1,1,1393
ab7e80acceb15b107743895206cb8f10ea08f105,0,Henry Robinson,2014-01-08 10:50:12-08:00,['3f0252c9f3f7abc9e81ed34212d4c40cffa23038'],0,6,6,2183523,1,0,0,1,1393
c7bcb37b1e70dcfeef2aa94e51f1076ef88f04e8,0,Henry Robinson,2014-01-08 10:50:13-08:00,['ab7e80acceb15b107743895206cb8f10ea08f105'],1,12,13,2183536,1,0,0.333333333,0.333333333,1393
f4d8df7119d7815f788723f6fcee1b634ddbd9e3,0,Henry Robinson,2014-01-08 10:50:13-08:00,['c7bcb37b1e70dcfeef2aa94e51f1076ef88f04e8'],22,17,39,2183575,4,0,0,1,1393
11556a1ad24fd08c6844741f86e997d94ab9cfbd,0,Henry Robinson,2014-01-08 10:50:13-08:00,['f4d8df7119d7815f788723f6fcee1b634ddbd9e3'],0,13,13,2183588,1,,,,1393
ead69d377f92d58a443f49eb0d59d2bdea35305b,1,Henry Robinson,2014-01-08 10:50:14-08:00,['11556a1ad24fd08c6844741f86e997d94ab9cfbd'],136,419,555,2184143,20,0,0.753333333,1,1393
c5dfdf44ddaa23feec695bc2c76855140f690dc1,1,Henry Robinson,2014-01-08 10:50:14-08:00,['ead69d377f92d58a443f49eb0d59d2bdea35305b'],7,17,24,2184167,2,1,1,0,1393
d8416485429594ee68f5ebca633f0cabc3676f8c,1,Henry Robinson,2014-01-08 10:50:14-08:00,['c5dfdf44ddaa23feec695bc2c76855140f690dc1'],0,28,28,2184195,2,0.636363636,0.818181818,0.909090909,1393
25517c555f29dbea896aa3ded85b62723f8a9235,1,Henry Robinson,2014-01-08 10:50:15-08:00,['d8416485429594ee68f5ebca633f0cabc3676f8c'],44,142,186,2184381,18,0.689655172,0.482758621,0,1393
821da075707ca561087d80a779dfef9d24a99c5c,0,Henry Robinson,2014-01-08 10:50:15-08:00,['25517c555f29dbea896aa3ded85b62723f8a9235'],2,9,11,2184392,2,0,0,1,1393
62fe6cae185ef887f4bbba625eaa743065959544,0,Henry Robinson,2014-01-08 10:50:15-08:00,['821da075707ca561087d80a779dfef9d24a99c5c'],7,8,15,2184407,2,0,1,0,1393
0e73fb9caba30242ccb5385a5228baa6b5780bfe,1,Henry Robinson,2014-01-08 10:50:16-08:00,['62fe6cae185ef887f4bbba625eaa743065959544'],16,27,43,2184450,3,0,0,0,1393
a541a8bc532ebc1fcd574254fd61d3ec704ab5b2,0,Henry Robinson,2014-01-08 10:50:16-08:00,['0e73fb9caba30242ccb5385a5228baa6b5780bfe'],0,0,0,2184450,0,,,,1393
f4fc37368fe99233134dcd5effc9dc2494fa8e08,1,Henry Robinson,2014-01-08 10:50:16-08:00,['a541a8bc532ebc1fcd574254fd61d3ec704ab5b2'],44,119,163,2184613,8,1,1,0,1394
aebe03d2e5990147a4f12bb367ccd7a9cdb69969,0,Henry Robinson,2014-01-08 10:50:17-08:00,['f4fc37368fe99233134dcd5effc9dc2494fa8e08'],5,15,20,2184633,4,0,0.1,1,1394
223b1a8e4718e8f7dcc0094082754fbb8fa1633b,1,Henry Robinson,2014-01-08 10:50:17-08:00,['aebe03d2e5990147a4f12bb367ccd7a9cdb69969'],17,35,52,2184685,4,0,1,1,1395
275308659188ab91f7faad26e94c3c6f41d2fe97,0,Henry Robinson,2014-01-08 10:50:17-08:00,['223b1a8e4718e8f7dcc0094082754fbb8fa1633b'],33,38,71,2184756,4,0,1,1,1395
caaa47d30eb258799a401e17407a6d204760cdf5,1,Henry Robinson,2014-01-08 10:50:18-08:00,['275308659188ab91f7faad26e94c3c6f41d2fe97'],2,4,6,2184762,2,0,1,1,1395
463feea031718331b3394c8ff3f518afbb7e7ee0,1,Henry Robinson,2014-01-08 10:50:18-08:00,['caaa47d30eb258799a401e17407a6d204760cdf5'],171,157,328,2185090,13,1,1,1,1395
9a4feb73916e10ed2d2f41fe912ef2a7ef39dbe9,1,Henry Robinson,2014-01-08 10:50:18-08:00,['463feea031718331b3394c8ff3f518afbb7e7ee0'],397,852,1249,2186339,10,0.816326531,0.948979592,0.673469388,1400
7b500d04a73d5ab629805469f6818080327189c9,0,Henry Robinson,2014-01-08 10:50:19-08:00,['9a4feb73916e10ed2d2f41fe912ef2a7ef39dbe9'],1,1,2,2186341,1,,,,1400
2f228d545a16580b258d70dde7595d9c3aab09b3,0,Henry Robinson,2014-01-08 10:50:19-08:00,['7b500d04a73d5ab629805469f6818080327189c9'],2,8,10,2186351,2,1,1,1,1400
a10927d5920353bbde14cc13491f1c3a01bda850,0,Henry Robinson,2014-01-08 10:50:19-08:00,['2f228d545a16580b258d70dde7595d9c3aab09b3'],3,176,179,2186530,6,0.677966102,1,1,1402
90ed9f0ab86294ab6b614f294c64186d47e773f6,0,Henry Robinson,2014-01-08 10:50:20-08:00,['a10927d5920353bbde14cc13491f1c3a01bda850'],525,115,640,2187170,15,1,0.04784689,0.028708134,1402
e7e1a382e9cd9ec397c77fb313852552dbce62e3,0,Henry Robinson,2014-01-08 10:50:20-08:00,['90ed9f0ab86294ab6b614f294c64186d47e773f6'],43,0,43,2187213,3,0,0,0,1402
5281b026d8e3270d9f142777221c9d4398a24647,1,Henry Robinson,2014-01-08 10:50:20-08:00,['e7e1a382e9cd9ec397c77fb313852552dbce62e3'],14,61,75,2187288,5,0.64,0.72,0.84,1402
30f62366a4bd6e9c014edc766db064e676ff120c,0,Henry Robinson,2014-01-08 10:50:21-08:00,['5281b026d8e3270d9f142777221c9d4398a24647'],2,12,14,2187302,3,1,1,1,1402
e568df230bb8ef129a44611beb3d22805596e785,1,Henry Robinson,2014-01-08 10:50:21-08:00,['30f62366a4bd6e9c014edc766db064e676ff120c'],7,75,82,2187384,5,0.352941176,1,1,1402
54bd0aeddc1aeef233a920f53f8bba856d70cf7a,0,Henry Robinson,2014-01-08 10:50:21-08:00,['e568df230bb8ef129a44611beb3d22805596e785'],1,3,4,2187388,1,,,,1402
68e4c14527b83d26418d2c461dccd75ffa706882,1,Henry Robinson,2014-01-08 10:50:22-08:00,['54bd0aeddc1aeef233a920f53f8bba856d70cf7a'],39,147,186,2187574,7,0.469879518,0.518072289,0.831325301,1402
dc5a33f18ca05c014cde443ef90b35643e5ec50f,0,Henry Robinson,2014-01-08 10:50:22-08:00,['68e4c14527b83d26418d2c461dccd75ffa706882'],61,128,189,2187763,5,0.152542373,1,0.966101695,1402
8af35425e63186305ff439ca34096839b8a0b443,1,Henry Robinson,2014-01-08 10:50:22-08:00,['dc5a33f18ca05c014cde443ef90b35643e5ec50f'],7,50,57,2187820,4,0.5,0.5,0,1402
261119b91fc0810a9651cdff0d6e5a9c175b9742,1,Henry Robinson,2014-01-08 10:50:23-08:00,['8af35425e63186305ff439ca34096839b8a0b443'],10,10,20,2187840,1,,,,1402
d730071dde3193dfacbeb351b8f406e4a632e8dd,1,Henry Robinson,2014-01-08 10:50:23-08:00,['261119b91fc0810a9651cdff0d6e5a9c175b9742'],18,24,42,2187882,2,0,0,0.75,1402
dd6e771e6c4da7836d9992df7382fca9d27d653b,1,Henry Robinson,2014-01-08 10:50:23-08:00,['d730071dde3193dfacbeb351b8f406e4a632e8dd'],190,252,442,2188324,17,0,1,0.133333333,1402
547c75e3d5f9ed0ef70a1bcde8d567c703f3ff63,1,Henry Robinson,2014-01-08 10:50:24-08:00,['dd6e771e6c4da7836d9992df7382fca9d27d653b'],188,251,439,2188763,15,1,0.347826087,1,1402
3af83530f74054eedb5ca4301815fe5d46bb4110,1,Henry Robinson,2014-01-08 10:50:24-08:00,['547c75e3d5f9ed0ef70a1bcde8d567c703f3ff63'],55,58,113,2188876,4,0,1,0,1402
3364c73f4a52ebbf87e9444403ea5a371d961ad5,0,Henry Robinson,2014-01-08 10:50:24-08:00,['3af83530f74054eedb5ca4301815fe5d46bb4110'],3,2,5,2188881,1,1,0,1,1402
b1ad5f9ea894d784e93551713f08fcc8484d9ff9,0,Henry Robinson,2014-01-08 10:50:25-08:00,['3364c73f4a52ebbf87e9444403ea5a371d961ad5'],1,13,14,2188895,2,0.666666667,1,1,1402
5ee53125897dfdb2faef3e70c63ea7dd189b5110,0,Henry Robinson,2014-01-08 10:50:25-08:00,['b1ad5f9ea894d784e93551713f08fcc8484d9ff9'],14,78,92,2188987,1,0,0,1,1402
b0cef64877ebb18ebaac86f93c821a6b72baf92b,1,Henry Robinson,2014-01-08 10:50:25-08:00,['5ee53125897dfdb2faef3e70c63ea7dd189b5110'],22,91,113,2189100,6,0.525,1,1,1402
6ad2c627c538866048dd8b2e6271853aa969abb3,0,Henry Robinson,2014-01-08 10:50:26-08:00,['b0cef64877ebb18ebaac86f93c821a6b72baf92b'],31,35,66,2189166,2,0,1,1,1402
4255805037b4fe8d6daea21d28303fdd8cda1583,1,Henry Robinson,2014-01-08 10:50:26-08:00,['6ad2c627c538866048dd8b2e6271853aa969abb3'],8,110,118,2189284,4,0.2,1,0.914285714,1402
e0507e192b4b0571b50895e55e01cb4fe46608e3,0,Henry Robinson,2014-01-08 10:50:26-08:00,['4255805037b4fe8d6daea21d28303fdd8cda1583'],4,4,8,2189292,1,,,,1402
627e74a06846ec510391e47019236bf76cf29bb5,0,Henry Robinson,2014-01-08 10:50:27-08:00,['e0507e192b4b0571b50895e55e01cb4fe46608e3'],0,1,1,2189293,1,,,,1402
192704567abc70e41b64a987ea1715e08acb80f1,0,Henry Robinson,2014-01-08 10:50:27-08:00,['627e74a06846ec510391e47019236bf76cf29bb5'],143,148,291,2189584,2,0,0,1,1402
407160b787e838fe73783baacb3c1d99dfa0154e,1,Henry Robinson,2014-01-08 10:50:27-08:00,['192704567abc70e41b64a987ea1715e08acb80f1'],97,100,197,2189781,8,0,1,1,1402
9ff09cd3f4fedb93dbd6e3847921e75d106e82af,1,Henry Robinson,2014-01-08 10:50:28-08:00,['407160b787e838fe73783baacb3c1d99dfa0154e'],28,166,194,2189975,20,0,0.488372093,0.279069767,1402
ef2a55d17b69cae7342f6f8cc1c7de3d9fc492c5,1,Henry Robinson,2014-01-08 10:50:28-08:00,['9ff09cd3f4fedb93dbd6e3847921e75d106e82af'],9,34,43,2190018,5,1,1,1,1402
546979833dabaa616788b067335107dff3cf00f2,0,Henry Robinson,2014-01-08 10:50:28-08:00,['ef2a55d17b69cae7342f6f8cc1c7de3d9fc492c5'],3,0,3,2190021,1,1,1,0,1402
f026354721c957c4181360531f7a089111acd444,0,Henry Robinson,2014-01-08 10:50:29-08:00,['546979833dabaa616788b067335107dff3cf00f2'],6,14,20,2190041,3,1,1,1,1402
a9b7eca5e8e1f10f95bc1ec9a556d944ed993f52,0,Henry Robinson,2014-01-08 10:50:29-08:00,['f026354721c957c4181360531f7a089111acd444'],0,21,21,2190062,2,0.857142857,1,0.857142857,1402
1971632e7617cbd799d5ec2cbc7a8e9a1b038609,0,Henry Robinson,2014-01-08 10:50:29-08:00,['a9b7eca5e8e1f10f95bc1ec9a556d944ed993f52'],23,26,49,2190111,6,0,0,1,1402
4404ee65bc23260825bcb6fb8fce13a7ba2995fc,0,Henry Robinson,2014-01-08 10:50:30-08:00,['1971632e7617cbd799d5ec2cbc7a8e9a1b038609'],7,49,56,2190167,8,1,1,1,1403
117431fa79c7d57b09301a53e169aa76852eebcd,1,Henry Robinson,2014-01-08 10:50:30-08:00,['4404ee65bc23260825bcb6fb8fce13a7ba2995fc'],70,73,143,2190310,30,1,0,0,1403
c7819f4db7ca8b655409cfe7e91811ccf431616e,1,Henry Robinson,2014-01-08 10:50:30-08:00,['117431fa79c7d57b09301a53e169aa76852eebcd'],142,214,356,2190666,15,0.727272727,1,0,1403
937a44f9f8bac0ccd20720ea623709390985447d,1,Henry Robinson,2014-01-08 10:50:31-08:00,['c7819f4db7ca8b655409cfe7e91811ccf431616e'],34,904,938,2191604,22,0.428571429,1,0.898809524,1406
27f3840f83cef47cc9a071fa0672527a554b9a23,0,Henry Robinson,2014-01-08 10:50:31-08:00,['937a44f9f8bac0ccd20720ea623709390985447d'],0,58,58,2191662,5,0.181818182,1,1,1406
0546d7a08ac3d6046ebf1e6b060ab90b91757f75,0,Henry Robinson,2014-01-08 10:50:31-08:00,['27f3840f83cef47cc9a071fa0672527a554b9a23'],36,203,239,2191901,4,0.314814815,0.796296296,0.787037037,1407
b1de018298cc14ea0ba85893d475829759e52b54,1,Henry Robinson,2014-01-08 10:50:32-08:00,['0546d7a08ac3d6046ebf1e6b060ab90b91757f75'],92,313,405,2192306,14,0.411764706,1,1,1409
2f7198292a638a57a79795410c856e8d55c8101a,1,Henry Robinson,2014-01-08 10:50:32-08:00,['b1de018298cc14ea0ba85893d475829759e52b54'],121,43,164,2192470,11,0.952380952,0,0.333333333,1409
afb601c6a42b8096cc0d87118222639757cef815,1,Henry Robinson,2014-01-08 10:50:32-08:00,['2f7198292a638a57a79795410c856e8d55c8101a'],21,159,180,2192650,3,0.12,0.346666667,1,1409
f566a58997d22b8e714b9159d7c26dfe47fc5a93,0,Henry Robinson,2014-01-08 10:50:33-08:00,['afb601c6a42b8096cc0d87118222639757cef815'],1,1,2,2192652,1,,,,1409
cf4196b174c8604bff131e6e6a4d42b8051f5103,1,Henry Robinson,2014-01-08 10:50:33-08:00,['f566a58997d22b8e714b9159d7c26dfe47fc5a93'],68,132,200,2192852,11,0,1,0.7,1409
2b5e446fd7a81997a2ee92cb4df02a2f2d7a31de,0,Henry Robinson,2014-01-08 10:50:33-08:00,['cf4196b174c8604bff131e6e6a4d42b8051f5103'],0,0,0,2192852,0,,,,1409
227102f4aaf1c4a2f5a28763ef597ea241fdd214,0,Henry Robinson,2014-01-08 10:50:35-08:00,['2b5e446fd7a81997a2ee92cb4df02a2f2d7a31de'],1,1,2,2192854,1,,,,1409
4e912e95f6b353d1add896c131bab7da5f621fe9,0,Henry Robinson,2014-01-08 10:50:36-08:00,['227102f4aaf1c4a2f5a28763ef597ea241fdd214'],0,0,0,2192854,0,,,,1409
5ccd53d0626d155ccd8dafa971c97d3083528412,0,Henry Robinson,2014-01-08 10:50:38-08:00,['4e912e95f6b353d1add896c131bab7da5f621fe9'],1,1,2,2192856,1,,,,1409
f0ec902188986229ae107ec305a8aa4515192465,0,Henry Robinson,2014-01-08 10:50:40-08:00,['5ccd53d0626d155ccd8dafa971c97d3083528412'],0,0,0,2192856,0,,,,1409
97a1d4d8b8cd1af452f1e1992ca5ddb3a91ca906,0,Henry Robinson,2014-01-08 10:50:44-08:00,['f0ec902188986229ae107ec305a8aa4515192465'],1,1,2,2192858,1,,,,1409
2e1910749655cf064a4616b6e78d6c3db8c36ab8,1,Henry Robinson,2014-01-08 10:50:46-08:00,['97a1d4d8b8cd1af452f1e1992ca5ddb3a91ca906'],113,153,266,2193124,1,,,,1409
06a2c401b4579ee27113b8aa4c4aeb7e7411b2a4,1,Henry Robinson,2014-01-08 10:50:46-08:00,['2e1910749655cf064a4616b6e78d6c3db8c36ab8'],95,159,254,2193378,8,0,0.857142857,1,1409
816141b9f58bbf2238cbddf6a041b13d6e72b6dd,1,Henry Robinson,2014-01-08 10:50:46-08:00,['06a2c401b4579ee27113b8aa4c4aeb7e7411b2a4'],432,507,939,2194317,10,0.337209302,0.802325581,0.325581395,1409
fc8a08dac2554f3109cd17671e3044be1092446d,1,Henry Robinson,2014-01-08 10:50:47-08:00,['816141b9f58bbf2238cbddf6a041b13d6e72b6dd'],2434,2466,4900,2199217,4,,,,1412
d173812f64d06e44deb36e452c95494403d68ce4,0,Henry Robinson,2014-01-08 10:50:47-08:00,['fc8a08dac2554f3109cd17671e3044be1092446d'],4,57,61,2199278,5,0.448275862,1,1,1412
c96feb9c60d477bfee476fd5932dc3e2430a9a71,0,Henry Robinson,2014-01-08 10:50:47-08:00,['d173812f64d06e44deb36e452c95494403d68ce4'],1,1,2,2199280,1,,,,1412
9ceda2ccc79a0907172cdc9dd41888bb74562d2d,0,Henry Robinson,2014-01-08 10:50:48-08:00,['c96feb9c60d477bfee476fd5932dc3e2430a9a71'],21,1,22,2199302,2,1,1,0,1412
0bb0df780fcdadec2a4418bddf3237cb8c41fd43,0,Henry Robinson,2014-01-08 10:50:48-08:00,['9ceda2ccc79a0907172cdc9dd41888bb74562d2d'],70,47,117,2199419,4,1,0.363636364,0.545454545,1412
bd59bbb07a9b0115bc5ec8d68ca2d1197fed7da6,0,Henry Robinson,2014-01-08 10:50:48-08:00,['0bb0df780fcdadec2a4418bddf3237cb8c41fd43'],7,63,70,2199489,4,0.333333333,0.296296296,0.296296296,1412
c8fd4f8016aa83a51bef60055c3be0ddbe966d4f,0,Henry Robinson,2014-01-08 10:50:49-08:00,['bd59bbb07a9b0115bc5ec8d68ca2d1197fed7da6'],2,6,8,2199497,4,,1,1,1413
49199bb0d517683bc1fe0ee3dfca7e1c372bf689,0,Henry Robinson,2014-01-08 10:50:49-08:00,['c8fd4f8016aa83a51bef60055c3be0ddbe966d4f'],84,9,93,2199590,4,1,0,0.423076923,1413
5c55c0cfae7c81ad48448a87394981831ebdf59a,1,Henry Robinson,2014-01-08 10:50:49-08:00,['49199bb0d517683bc1fe0ee3dfca7e1c372bf689'],45,78,123,2199713,4,0.111111111,1,0,1413
6d8f2f67b1d71dce8295e78a71dde22b8372ed26,0,Henry Robinson,2014-01-08 10:50:50-08:00,['5c55c0cfae7c81ad48448a87394981831ebdf59a'],0,0,0,2199713,0,,,,1413
5eace8d6b3f83b5d162a61688a451c00de15b6ee,1,Henry Robinson,2014-01-08 10:50:50-08:00,['6d8f2f67b1d71dce8295e78a71dde22b8372ed26'],501,580,1081,2200794,7,,,,1415
a69722f461698163d756da6374dc8a52429c22f3,0,Henry Robinson,2014-01-08 10:50:51-08:00,['5eace8d6b3f83b5d162a61688a451c00de15b6ee'],12,11,23,2200817,7,,,,1415
26684b07d74a9bf91a43ac5d8223484cc9482987,1,Henry Robinson,2014-01-08 10:50:51-08:00,['a69722f461698163d756da6374dc8a52429c22f3'],103,176,279,2201096,3,0.935483871,0.935483871,1,1416
cee633065733fb9cf302c12d43f1286880846823,0,Henry Robinson,2014-01-08 10:50:51-08:00,['26684b07d74a9bf91a43ac5d8223484cc9482987'],2,2,4,2201100,1,,,,1416
1ab189c78994c630d373e4d7e4ded33278dfb809,0,Henry Robinson,2014-01-08 10:50:52-08:00,['cee633065733fb9cf302c12d43f1286880846823'],2,2,4,2201104,1,,,,1416
8722922093da3f912980f9eaa5a240676d8e1ea4,0,Henry Robinson,2014-01-08 10:50:52-08:00,['1ab189c78994c630d373e4d7e4ded33278dfb809'],10,18,28,2201132,6,,,,1416
8e06af68717c14007763cfbe7e3f60ef406dd5c0,0,Henry Robinson,2014-01-08 10:50:52-08:00,['8722922093da3f912980f9eaa5a240676d8e1ea4'],0,4,4,2201136,1,0,1,1,1416
ce092065be4f438c28ebe37fd92a66a9f3e98908,0,Henry Robinson,2014-01-08 10:50:53-08:00,['8e06af68717c14007763cfbe7e3f60ef406dd5c0'],2,22,24,2201160,2,1,1,1,1416
00b5f65e08a36029f0236845a8dfebdd01653678,0,Henry Robinson,2014-01-08 10:50:53-08:00,['ce092065be4f438c28ebe37fd92a66a9f3e98908'],0,2,2,2201162,1,,,,1416
68d9c081581f02d91ece17652d7975884fbc4cbd,0,Henry Robinson,2014-01-08 10:50:53-08:00,['00b5f65e08a36029f0236845a8dfebdd01653678'],1,0,1,2201163,1,0,0,0,1416
5a43b11a552eed576b84009e4ebbffb3870ce19d,0,Henry Robinson,2014-01-08 10:50:54-08:00,['68d9c081581f02d91ece17652d7975884fbc4cbd'],27,106,133,2201296,13,1,1,1,1417
d1c5ec3293e04e6edd10d3978d974134a0c37c50,1,Henry Robinson,2014-01-08 10:50:54-08:00,['5a43b11a552eed576b84009e4ebbffb3870ce19d'],39,27,66,2201362,10,0,0,1,1417
2bdba77f6141196cbfea878088d1284d1117c887,1,Henry Robinson,2014-01-08 10:50:54-08:00,['d1c5ec3293e04e6edd10d3978d974134a0c37c50'],87,403,490,2201852,10,0.311111111,0.703703704,0.518518519,1418
2b4071bf5d6bcec83bc5381dc626e1acb46bc4da,0,Henry Robinson,2014-01-08 10:50:55-08:00,['2bdba77f6141196cbfea878088d1284d1117c887'],3,0,3,2201855,1,,,,1418
a740809b4eb2bb5e393f8f40c308a137011d642a,0,Henry Robinson,2014-01-08 10:50:55-08:00,['2b4071bf5d6bcec83bc5381dc626e1acb46bc4da'],0,0,0,2201855,0,,,,1418
397b82f197da7d3c1b4cafe40dfd728b8092f43a,0,Henry Robinson,2014-01-08 10:50:55-08:00,['a740809b4eb2bb5e393f8f40c308a137011d642a'],21,23,44,2201899,2,0,1,0,1418
7ac88e1fa9473ee3920d0159bdd426be41e6abfb,1,Henry Robinson,2014-01-08 10:50:56-08:00,['397b82f197da7d3c1b4cafe40dfd728b8092f43a'],577,2406,2983,2204882,80,0.558546433,0.955585464,0.795423957,1438
58687d16b8c874a6fa52afa1480058c43546d9e0,0,Henry Robinson,2014-01-08 10:50:56-08:00,['7ac88e1fa9473ee3920d0159bdd426be41e6abfb'],0,28,28,2204910,4,0.571428571,0.571428571,1,1439
247b0ceb99de638672b697a189bd957a733529ed,0,Henry Robinson,2014-01-08 10:50:57-08:00,['58687d16b8c874a6fa52afa1480058c43546d9e0'],0,1,1,2204911,1,0,0,0,1439
15a3d9249239bf219204731c8abda895d5a4e7b0,0,Henry Robinson,2014-01-08 10:50:57-08:00,['247b0ceb99de638672b697a189bd957a733529ed'],3,3,6,2204917,1,,,,1439
0754655d1a17fc9e0788be786e2a4cfbc1d137dd,1,Henry Robinson,2014-01-08 10:50:57-08:00,['15a3d9249239bf219204731c8abda895d5a4e7b0'],0,29,29,2204946,1,0,0,0.65,1439
442e4cf2ca33e205ccb68765525f4e40c4895814,0,Henry Robinson,2014-01-08 10:50:58-08:00,['0754655d1a17fc9e0788be786e2a4cfbc1d137dd'],9,59,68,2205014,4,0,0.296296296,0,1439
7712cf2bb0c20f04c9bbd19e0424d7e9d8922213,0,Henry Robinson,2014-01-08 10:50:58-08:00,['442e4cf2ca33e205ccb68765525f4e40c4895814'],1,21,22,2205036,1,0,0,1,1439
11decfa48a3578d19b50513c3a1a8daae7721ae4,0,Henry Robinson,2014-01-08 10:50:58-08:00,['7712cf2bb0c20f04c9bbd19e0424d7e9d8922213'],2,7,9,2205045,2,1,1,1,1439
85c27f8771188c1cf6fa00845b48556b904a455e,0,Henry Robinson,2014-01-08 10:50:59-08:00,['11decfa48a3578d19b50513c3a1a8daae7721ae4'],7,16,23,2205068,2,0,0.666666667,0.666666667,1439
79b36a5eb3a41e073cb69eabeb05e75be412d274,1,Henry Robinson,2014-01-08 10:50:59-08:00,['85c27f8771188c1cf6fa00845b48556b904a455e'],251,834,1085,2206153,11,0.127272727,0.65,0.790909091,1441
7385b5690e28fccbb8a1e1750e34da59ac043e51,1,Henry Robinson,2014-01-08 10:50:59-08:00,['79b36a5eb3a41e073cb69eabeb05e75be412d274'],16,19,35,2206188,3,1,1,1,1441
405c2fcb1d3742301118cc2522dc0bcba02962ff,1,Henry Robinson,2014-01-08 10:51:00-08:00,['7385b5690e28fccbb8a1e1750e34da59ac043e51'],63,125,188,2206376,9,0.814814815,0.962962963,1,1441
44761c24bb1a3663153e4d763e2a0e6c9da58ce2,1,Henry Robinson,2014-01-08 10:51:00-08:00,['405c2fcb1d3742301118cc2522dc0bcba02962ff'],2,152,154,2206530,5,0.647058824,1,1,1443
045038e479aabea50de1e77f9306f23f775d11cd,1,Henry Robinson,2014-01-08 10:51:00-08:00,['44761c24bb1a3663153e4d763e2a0e6c9da58ce2'],79,2031,2110,2208640,27,0.527204503,0.853658537,0.836772983,1447
034b83351872ca8e22c1970ff3b6113750810f2a,1,Henry Robinson,2014-01-08 10:51:01-08:00,['045038e479aabea50de1e77f9306f23f775d11cd'],30,138,168,2208808,8,0.678571429,1,1,1448
b152a2e71aec395eaab7cc93720badc865928b94,0,Henry Robinson,2014-01-08 10:51:01-08:00,['034b83351872ca8e22c1970ff3b6113750810f2a'],1,1,2,2208810,1,,,,1448
6915ef96732dd7c3964efc890f81be53bc5459a0,0,Henry Robinson,2014-01-08 10:51:02-08:00,['b152a2e71aec395eaab7cc93720badc865928b94'],16,6,22,2208832,2,0,0,0.428571429,1448
df87577e6bef052c6c30c3b68bc35415f69d2ca5,1,Henry Robinson,2014-01-08 10:51:02-08:00,['6915ef96732dd7c3964efc890f81be53bc5459a0'],8,51,59,2208891,4,0.28125,0.28125,1,1448
c2cfc7e2a3ff4f2a0600d4fdedee8dd296690598,1,Henry Robinson,2014-01-08 10:51:02-08:00,['df87577e6bef052c6c30c3b68bc35415f69d2ca5'],273,1299,1572,2210463,28,0.524229075,0.870044053,0.931718062,1452
b3bd330cd1a0d582600f08bcf6462debe7bdcd74,0,Henry Robinson,2014-01-08 10:51:03-08:00,['c2cfc7e2a3ff4f2a0600d4fdedee8dd296690598'],0,25,25,2210488,4,0.578947368,1,1,1452
a28ab1e030bd558db54ece99e212ba5433268acf,0,Henry Robinson,2014-01-08 10:51:03-08:00,['b3bd330cd1a0d582600f08bcf6462debe7bdcd74'],6,21,27,2210515,3,0,0,1,1452
1e66f3658172fb13e065b58a4c3cc432e9dbe71e,0,Henry Robinson,2014-01-08 10:51:03-08:00,['a28ab1e030bd558db54ece99e212ba5433268acf'],0,54,54,2210569,4,0,0.348837209,1,1452
7b7c92512a785b1876bd6def7371b3e722970752,0,Henry Robinson,2014-01-08 10:51:04-08:00,['1e66f3658172fb13e065b58a4c3cc432e9dbe71e'],1,1,2,2210571,1,,,,1452
7c6598066cd0244653813d12f20ec5fbbfbf5584,0,Henry Robinson,2014-01-08 10:51:04-08:00,['7b7c92512a785b1876bd6def7371b3e722970752'],8,72,80,2210651,8,0,0.4,0.314285714,1452
5e41b304d1751597e01f04a5a9fada0222a303f8,1,Henry Robinson,2014-01-08 10:51:04-08:00,['7c6598066cd0244653813d12f20ec5fbbfbf5584'],124,127,251,2210902,8,0.25,0.25,0,1452
4ff958e49760730f3de4906275ef8d22d0cb7783,0,Henry Robinson,2014-01-08 10:51:05-08:00,['5e41b304d1751597e01f04a5a9fada0222a303f8'],4,30,34,2210936,2,0.333333333,0.333333333,0.888888889,1452
f54672e48a9755a697e6617747b3b182880c68fe,1,Henry Robinson,2014-01-08 10:51:05-08:00,['4ff958e49760730f3de4906275ef8d22d0cb7783'],13,89,102,2211038,3,0.274509804,1,0.941176471,1452
fe9dbb64d72ca2f2fb02d0cb548bf463af569ae5,1,Henry Robinson,2014-01-08 10:51:05-08:00,['f54672e48a9755a697e6617747b3b182880c68fe'],82,234,316,2211354,14,1,1,1,1453
e7ea89524b687f03a9bc23095eb06fa72ea3da8a,0,Henry Robinson,2014-01-08 10:51:06-08:00,['fe9dbb64d72ca2f2fb02d0cb548bf463af569ae5'],4,4,8,2211362,3,,,,1453
711704d9076237d945fa09be72de1047a50506a9,0,Henry Robinson,2014-01-08 10:51:06-08:00,['e7ea89524b687f03a9bc23095eb06fa72ea3da8a'],0,0,0,2211362,0,,,,1453
34d178dc193ecce1765aa48ca8ea2afb180d55a2,0,Henry Robinson,2014-01-08 10:51:07-08:00,['711704d9076237d945fa09be72de1047a50506a9'],0,0,0,2211362,0,,,,1453
0d662a3c8cf146d19d7b4d14b499ddb38964bec6,1,Henry Robinson,2014-01-08 10:51:07-08:00,['34d178dc193ecce1765aa48ca8ea2afb180d55a2'],21,119,140,2211502,11,0,0,0.488372093,1453
1a5c2c137ef8bd603e3a0a89f0a1c2648acba9d7,1,Henry Robinson,2014-01-08 10:51:07-08:00,['0d662a3c8cf146d19d7b4d14b499ddb38964bec6'],0,263,263,2211765,3,0.713178295,1,1,1455
ce91daa68589f921a20d3027cd224af01c701431,0,Henry Robinson,2014-01-08 10:51:08-08:00,['1a5c2c137ef8bd603e3a0a89f0a1c2648acba9d7'],1,13,14,2211779,1,0,1,1,1455
e4688c0f454963258d24aa43a149b0155c756471,0,Henry Robinson,2014-01-08 10:51:08-08:00,['ce91daa68589f921a20d3027cd224af01c701431'],3,7,10,2211789,1,,,,1455
92cfeef69ae5fc3defebbf49dd3fe87b590bdcbc,1,Henry Robinson,2014-01-08 10:51:09-08:00,['e4688c0f454963258d24aa43a149b0155c756471'],25,54,79,2211868,3,0,0,0.090909091,1455
9796d2c7763443b5decd44cd4a6aab058b44d992,1,Henry Robinson,2014-01-08 10:51:10-08:00,['92cfeef69ae5fc3defebbf49dd3fe87b590bdcbc'],68,157,225,2212093,14,0,0.52,1,1455
ece9f76a0b9c1035e33816c7fb425529e1236397,0,Henry Robinson,2014-01-08 10:51:13-08:00,['9796d2c7763443b5decd44cd4a6aab058b44d992'],13,128,141,2212234,2,1,1,0,1455
fe15f51e7250a126cf5f516cc74c79b95915efaf,0,Henry Robinson,2014-01-08 10:51:13-08:00,['ece9f76a0b9c1035e33816c7fb425529e1236397'],8,8,16,2212250,2,0,1,1,1455
4d89735ec58148f0d38c1f760906d8368482b6ef,0,Henry Robinson,2014-01-08 10:51:14-08:00,['fe15f51e7250a126cf5f516cc74c79b95915efaf'],3,3,6,2212256,3,,,,1455
abdfae5b24ed458ce412c089c2eedf55602bdc8a,1,Henry Robinson,2014-01-08 10:51:14-08:00,['4d89735ec58148f0d38c1f760906d8368482b6ef'],29,64,93,2212349,8,0.142857143,1,1,1455
acf2111bce5aaf285b4dc4c869258aea7073e3b7,0,Henry Robinson,2014-01-08 10:51:14-08:00,['abdfae5b24ed458ce412c089c2eedf55602bdc8a'],2,19,21,2212370,3,,,,1455
c0117816148778f78582845b2d30f0059180c7d2,1,Henry Robinson,2014-01-08 10:51:15-08:00,['acf2111bce5aaf285b4dc4c869258aea7073e3b7'],496,839,1335,2213705,21,0.383838384,0.813131313,0.994949495,1458
e8344bb0d02d0b8ec4f21773281f3d4d88095686,1,Henry Robinson,2014-01-08 10:51:15-08:00,['c0117816148778f78582845b2d30f0059180c7d2'],41,708,749,2214454,15,0.559139785,0.569892473,0.830645161,1460
15f6abf5205b04cdea49a04d052089f225660838,0,Henry Robinson,2014-01-08 10:51:15-08:00,['e8344bb0d02d0b8ec4f21773281f3d4d88095686'],0,1,1,2214455,1,,,,1460
4b3eb0b64954c5248de2439f2660dd20efac7782,0,Henry Robinson,2014-01-08 10:51:16-08:00,['15f6abf5205b04cdea49a04d052089f225660838'],3,3,6,2214461,1,,,,1460
866e4920bd269e09948a594239ff126efed32a34,1,Henry Robinson,2014-01-08 10:51:16-08:00,['4b3eb0b64954c5248de2439f2660dd20efac7782'],1,1,2,2214463,1,,,,1460
f26f66b3c47d2a0318da5f9b62214287c710ae51,0,Henry Robinson,2014-01-08 10:51:16-08:00,['866e4920bd269e09948a594239ff126efed32a34'],0,1,1,2214464,1,,,,1460
b71357fc28611caa11b527e01007f4acfe711788,1,Henry Robinson,2014-01-08 10:51:17-08:00,['f26f66b3c47d2a0318da5f9b62214287c710ae51'],556,623,1179,2215643,18,0,0,0,1460
c2370c3a2d59092c57914ccee9142524ec2be3d2,1,Henry Robinson,2014-01-08 10:51:17-08:00,['b71357fc28611caa11b527e01007f4acfe711788'],1,2,3,2215646,1,,,,1460
1765cd47b76d04c2495793a334246ad25d46b2fb,1,Henry Robinson,2014-01-08 10:51:17-08:00,['c2370c3a2d59092c57914ccee9142524ec2be3d2'],12,19,31,2215677,2,1,1,0,1460
254ee6ef89bd02954ae2aee958f6865b70c74342,1,Henry Robinson,2014-01-08 10:51:18-08:00,['1765cd47b76d04c2495793a334246ad25d46b2fb'],157,930,1087,2216764,20,0.176470588,0.449197861,0.251336898,1460
ea1dd923807a1b7f2acb9c55b5221f8b9570f111,1,Henry Robinson,2014-01-08 10:51:19-08:00,['254ee6ef89bd02954ae2aee958f6865b70c74342'],307,268,575,2217339,19,1,1,0.428571429,1460
28243342c00b095d623a0954150bcb22c1c49efd,1,Henry Robinson,2014-01-08 10:51:21-08:00,['ea1dd923807a1b7f2acb9c55b5221f8b9570f111'],57,91,148,2217487,9,0.454545455,1,1,1460
10cbcab8b612473ebb4817ed695880e4f2f234d9,1,Henry Robinson,2014-01-08 10:51:22-08:00,['28243342c00b095d623a0954150bcb22c1c49efd'],521,551,1072,2218559,11,0.85,0.625,0,1462
4f80cd6171753e51e7956a7f8163a81155dc8e18,0,Henry Robinson,2014-01-08 10:51:23-08:00,['10cbcab8b612473ebb4817ed695880e4f2f234d9'],1,3,4,2218563,1,1,1,1,1462
903b90f5d23a37206a0ca38233fe5249839d096d,1,Henry Robinson,2014-01-08 10:51:24-08:00,['4f80cd6171753e51e7956a7f8163a81155dc8e18'],6,239,245,2218808,5,0.764044944,1,0.898876404,1464
665a5b0f0cf522e428104cd336ebd3cd877609ac,1,Henry Robinson,2014-01-08 10:51:25-08:00,['903b90f5d23a37206a0ca38233fe5249839d096d'],24,66,90,2218898,3,0.625,0,1,1464
e7c6d57f9c0c08a8a8c66b30946cf8b6699764aa,1,Henry Robinson,2014-01-08 10:51:25-08:00,['665a5b0f0cf522e428104cd336ebd3cd877609ac'],57,227,284,2219182,8,1,0.897435897,1,1465
ecee109e6807f25b45ee0f691c4c61c28cba6627,1,Henry Robinson,2014-01-08 10:51:25-08:00,['e7c6d57f9c0c08a8a8c66b30946cf8b6699764aa'],167,264,431,2219613,25,1,0.75,1,1466
b2b3ed929d0877f9b3e054048cbcd1786c9bda5c,0,Henry Robinson,2014-01-08 10:51:26-08:00,['ecee109e6807f25b45ee0f691c4c61c28cba6627'],0,0,0,2219613,0,,,,1466
c8a8308ece69f5f13d4b33888fa22b286775fbbf,1,Henry Robinson,2014-01-08 10:51:26-08:00,['b2b3ed929d0877f9b3e054048cbcd1786c9bda5c'],40,213,253,2219866,9,0,0.032608696,0.956521739,1467
3bba336bbfa99c0420b834b2902feac915ecb8b3,1,Henry Robinson,2014-01-08 10:51:26-08:00,['c8a8308ece69f5f13d4b33888fa22b286775fbbf'],1,174,175,2220041,3,1,1,1,1467
7c83abba9ae3d51445ab85fd49c8a4d1bf86b9e7,1,Henry Robinson,2014-01-08 10:51:27-08:00,['3bba336bbfa99c0420b834b2902feac915ecb8b3'],3,184,187,2220228,5,0.988636364,0.988636364,1,1470
19c488ccccf2bc8e05eb10314faf13383967360a,0,Henry Robinson,2014-01-08 10:51:27-08:00,['7c83abba9ae3d51445ab85fd49c8a4d1bf86b9e7'],2,2,4,2220232,1,,,,1470
cacc427890c2c19ab18dac7c5dce016cc9e9a8f4,1,Henry Robinson,2014-01-08 10:51:27-08:00,['19c488ccccf2bc8e05eb10314faf13383967360a'],3,23,26,2220258,3,0.916666667,0.916666667,0.916666667,1470
5946801c73937c2a67384b0485746dc2356e15a2,0,Henry Robinson,2014-01-08 10:51:28-08:00,['cacc427890c2c19ab18dac7c5dce016cc9e9a8f4'],0,2,2,2220260,1,,,,1470
03c66b1f0aa1184f95a5f2bc8fde5767b999a997,0,Henry Robinson,2014-01-08 10:51:28-08:00,['5946801c73937c2a67384b0485746dc2356e15a2'],0,8,8,2220268,1,0,1,0.5,1470
1c66ded411613abe3514e43b3f849a3b5e61439f,1,Henry Robinson,2014-01-08 10:51:28-08:00,['03c66b1f0aa1184f95a5f2bc8fde5767b999a997'],174,135,309,2220577,3,1,0,0,1470
1454927d98b7fa25352921755b785df495fba16b,1,Henry Robinson,2014-01-08 10:51:29-08:00,['1c66ded411613abe3514e43b3f849a3b5e61439f'],89,199,288,2220865,13,0.148148148,1,1,1471
31cf1cc5603add4b0cfa97d2a52fac938b9ccc14,0,Henry Robinson,2014-01-08 10:51:29-08:00,['1454927d98b7fa25352921755b785df495fba16b'],1,1,2,2220867,1,,,,1471
8f44b85440aa6af90d994b8b3a060721296bba8a,1,Henry Robinson,2014-01-08 10:51:29-08:00,['31cf1cc5603add4b0cfa97d2a52fac938b9ccc14'],70,192,262,2221129,7,0,0,0.923076923,1471
5fa2de16f8d99a858af1fa963fb1183e557c533b,0,Henry Robinson,2014-01-08 10:51:30-08:00,['8f44b85440aa6af90d994b8b3a060721296bba8a'],1,1,2,2221131,1,,,,1471
fa3c927b2581df40e792470e2daacd6582e97310,1,Henry Robinson,2014-01-08 10:51:30-08:00,['5fa2de16f8d99a858af1fa963fb1183e557c533b'],0,10,10,2221141,1,1,1,1,1471
c70dc45d1110c9c08f745310d0e78e74828d7cb5,0,Henry Robinson,2014-01-08 10:51:30-08:00,['fa3c927b2581df40e792470e2daacd6582e97310'],4,4,8,2221149,1,,,,1471
77859a5262d4c0d5444e789a0647fc10f48dba02,0,Henry Robinson,2014-01-08 10:51:31-08:00,['c70dc45d1110c9c08f745310d0e78e74828d7cb5'],4,9,13,2221162,1,1,1,1,1471
308abfce3a7dcf4f3b39af930e3619194842d6d1,0,Henry Robinson,2014-01-08 10:51:31-08:00,['77859a5262d4c0d5444e789a0647fc10f48dba02'],0,2,2,2221164,1,,,,1471
e9e85c0dfca9cff3185a32ef429842188a30ff57,1,Henry Robinson,2014-01-08 10:51:31-08:00,['308abfce3a7dcf4f3b39af930e3619194842d6d1'],828,842,1670,2222834,5,0,0,1,1472
caef51e48513474b9658330b10cbfa8844e29cd3,1,Henry Robinson,2014-01-08 10:51:32-08:00,['e9e85c0dfca9cff3185a32ef429842188a30ff57'],0,92,92,2222926,2,0.14893617,1,0.14893617,1473
9fb3f037e3581c49e7f1df869c2a5eea5408f561,0,Henry Robinson,2014-01-08 10:51:32-08:00,['caef51e48513474b9658330b10cbfa8844e29cd3'],0,4,4,2222930,1,,,,1473
27dfe2e2675eaca677895d182cb09b91f96bbbee,0,Henry Robinson,2014-01-08 10:51:32-08:00,['9fb3f037e3581c49e7f1df869c2a5eea5408f561'],63,117,180,2223110,3,0.341463415,1,1,1473
633c559ac90419f483978387301cc364f7b0ad8c,0,Henry Robinson,2014-01-08 10:51:33-08:00,['27dfe2e2675eaca677895d182cb09b91f96bbbee'],2,2,4,2223114,1,,,,1473
50f471d1acf9e268c91ce70ac1619838056506c5,0,Henry Robinson,2014-01-08 10:51:33-08:00,['633c559ac90419f483978387301cc364f7b0ad8c'],0,2,2,2223116,1,1,1,1,1473
63fe068d70b4a434e2529118b7198ab606f0d0ff,0,Henry Robinson,2014-01-08 10:51:33-08:00,['50f471d1acf9e268c91ce70ac1619838056506c5'],2,6,8,2223124,1,,,,1473
813e94ed6dd88a140ac681f3997a04c3ca3331f3,0,Henry Robinson,2014-01-08 10:51:34-08:00,['63fe068d70b4a434e2529118b7198ab606f0d0ff'],0,1,1,2223125,1,0,0,1,1473
e4aebb20a7f0b727d82ead6fb96f83ad9c3d6e01,1,Henry Robinson,2014-01-08 10:51:34-08:00,['813e94ed6dd88a140ac681f3997a04c3ca3331f3'],12,19,31,2223156,4,0,0,0.333333333,1473
75ad8b939e47edf162453e690fc353c5c14fc35b,1,Henry Robinson,2014-01-08 10:51:34-08:00,['e4aebb20a7f0b727d82ead6fb96f83ad9c3d6e01'],3,7,10,2223166,4,0,0,1,1473
63ae6fd6b742bde1d0004846a3d1751957e470b9,1,Henry Robinson,2014-01-08 10:51:35-08:00,['75ad8b939e47edf162453e690fc353c5c14fc35b'],6,57,63,2223229,4,0.466666667,0.5,1,1473
efa4aac8d69966ead61968d5c0e7f5017a7ce525,0,Henry Robinson,2014-01-08 10:51:35-08:00,['63ae6fd6b742bde1d0004846a3d1751957e470b9'],3,0,3,2223232,1,,,,1473
8ad15fabcf9c826f5be45267e30055d4a92dc702,1,Henry Robinson,2014-01-08 10:51:35-08:00,['efa4aac8d69966ead61968d5c0e7f5017a7ce525'],566,3810,4376,2227608,64,0.205128205,0.725838264,0.813609467,1485
e176ed4343c644dbbf24fa09bbb8f29250f728dc,0,Henry Robinson,2014-01-08 10:51:36-08:00,['8ad15fabcf9c826f5be45267e30055d4a92dc702'],2,3,5,2227613,1,,,,1485
3c87472fa1a94910a4b0d37e2776775b19c18849,0,Henry Robinson,2014-01-08 10:51:36-08:00,['e176ed4343c644dbbf24fa09bbb8f29250f728dc'],37,38,75,2227688,3,,,,1485
dff90b0d3a3953be4a26ecbd7f222e6a6c1a7e17,1,Henry Robinson,2014-01-08 10:51:36-08:00,['3c87472fa1a94910a4b0d37e2776775b19c18849'],7,126,133,2227821,12,0.291666667,0.875,1,1485
d29896fbe9d86eb8fcfb9470a29cac8c76859bfd,1,Henry Robinson,2014-01-08 10:51:37-08:00,['dff90b0d3a3953be4a26ecbd7f222e6a6c1a7e17'],0,12,12,2227833,2,0,1,1,1485
2c9c438f8c52dfafee2eb3527c50a9a58af30296,1,Henry Robinson,2014-01-08 10:51:37-08:00,['d29896fbe9d86eb8fcfb9470a29cac8c76859bfd'],24,46,70,2227903,2,0,1,1,1485
262c8c31f39431f9ef626f7d5ee913e88bc17db0,0,Henry Robinson,2014-01-08 10:51:37-08:00,['2c9c438f8c52dfafee2eb3527c50a9a58af30296'],0,2,2,2227905,1,,,,1485
0c0d578b8f5c37ed70e41f5063c54d3965734dcf,0,Henry Robinson,2014-01-08 10:51:38-08:00,['262c8c31f39431f9ef626f7d5ee913e88bc17db0'],8,7,15,2227920,6,,,,1485
c81deae40a91c260648007ac47bafceb9a0f039e,0,Henry Robinson,2014-01-08 10:51:38-08:00,['0c0d578b8f5c37ed70e41f5063c54d3965734dcf'],0,0,0,2227920,0,,,,1485
aee3c648ed17e5c4274634e97776159c571ebcff,0,Henry Robinson,2014-01-08 10:51:39-08:00,['c81deae40a91c260648007ac47bafceb9a0f039e'],0,0,0,2227920,0,,,,1485
3fecdeb7937a75c0b07258ef40bb26effa14caea,1,Henry Robinson,2014-01-08 10:51:39-08:00,['aee3c648ed17e5c4274634e97776159c571ebcff'],223,461,684,2228604,18,0.239669421,0.239669421,0.818181818,1495
6f9569ea6ffcba809601fa1f2f187875ac2f0011,0,Henry Robinson,2014-01-08 10:51:39-08:00,['3fecdeb7937a75c0b07258ef40bb26effa14caea'],17,281,298,2228902,8,0.918367347,0.591836735,0.755102041,1500
2819f4c56e6025aa151e72d2a9db5624297f5701,1,Henry Robinson,2014-01-08 10:51:40-08:00,['6f9569ea6ffcba809601fa1f2f187875ac2f0011'],23,28,51,2228953,1,1,1,0,1500
6bc3a190d6fb529a501748e3dc439c437e8853e2,1,Henry Robinson,2014-01-08 10:51:40-08:00,['2819f4c56e6025aa151e72d2a9db5624297f5701'],7,16,23,2228976,1,0,1,0,1500
60c47144c7d90f0dfa8f021f0a767c73d2b16e3f,1,Henry Robinson,2014-01-08 10:51:40-08:00,['6bc3a190d6fb529a501748e3dc439c437e8853e2'],96,20,116,2229092,6,0.68,0.76,0.76,1500
61b6c68ea39237059e3dab0b9fa53b7566e90f14,0,Henry Robinson,2014-01-08 10:51:41-08:00,['60c47144c7d90f0dfa8f021f0a767c73d2b16e3f'],24,28,52,2229144,2,0,0,1,1500
969331ca0c2f88612807038dec6146693c3381d1,1,Henry Robinson,2014-01-08 10:51:41-08:00,['61b6c68ea39237059e3dab0b9fa53b7566e90f14'],365,261,626,2229770,3,0.840909091,0,0,1501
33cf73d991fbe35ba2784e2c5d8f97ef1ab0570e,0,Henry Robinson,2014-01-08 10:51:41-08:00,['969331ca0c2f88612807038dec6146693c3381d1'],1,5,6,2229776,1,,,,1501
2491ee8803dc775cff1a35ec8ea5195469a92087,1,Henry Robinson,2014-01-08 10:51:42-08:00,['33cf73d991fbe35ba2784e2c5d8f97ef1ab0570e'],2174,2578,4752,2234528,24,1,1,1,1508
564874b1bce940d83c8df839b7c44efd1a2b9ca7,1,Henry Robinson,2014-01-08 10:51:42-08:00,['2491ee8803dc775cff1a35ec8ea5195469a92087'],713,394,1107,2235635,17,1,0.306122449,0.231292517,1508
caeadcc1f301cc5946ce14dace2f599614b6b849,0,Henry Robinson,2014-01-08 10:51:42-08:00,['564874b1bce940d83c8df839b7c44efd1a2b9ca7'],1,22,23,2235658,1,1,0.076923077,1,1508
e73464b3c32a6684e4ebc905d09e2a05c763b73e,1,Henry Robinson,2014-01-08 10:51:43-08:00,['caeadcc1f301cc5946ce14dace2f599614b6b849'],30,89,119,2235777,6,0,0.891891892,0.648648649,1508
cc5549728602d9671927c4be670461d607500476,1,Henry Robinson,2014-01-08 10:51:43-08:00,['e73464b3c32a6684e4ebc905d09e2a05c763b73e'],1,61,62,2235839,2,1,1,1,1509
8549d57a38973d04822e087ca52c0cefc6c69005,1,Henry Robinson,2014-01-08 10:51:43-08:00,['cc5549728602d9671927c4be670461d607500476'],251,353,604,2236443,19,0.082352941,0.376470588,1,1509
a7f6bacb6d5446d7b08c1f3179411a243bbc1ac1,0,Henry Robinson,2014-01-08 10:51:44-08:00,['8549d57a38973d04822e087ca52c0cefc6c69005'],3,7,10,2236453,1,1,1,0,1509
3696e6a4b48cd1878a21a10dec11ed2ce60a5228,1,Henry Robinson,2014-01-08 10:51:44-08:00,['a7f6bacb6d5446d7b08c1f3179411a243bbc1ac1'],56,77,133,2236586,17,0.916666667,0.75,0.833333333,1509
ecaea06874d29396e5691351f33ed92955d272c5,0,Henry Robinson,2014-01-08 10:51:44-08:00,['3696e6a4b48cd1878a21a10dec11ed2ce60a5228'],0,6,6,2236592,1,1,1,1,1509
520e75fbae89467cbcbd32d9485f9ec495c2ef4f,0,Henry Robinson,2014-01-08 10:51:45-08:00,['ecaea06874d29396e5691351f33ed92955d272c5'],24,44,68,2236660,3,0,1,1,1509
ece902d95344a3f0d84529db9385ac600ebf19e5,0,Henry Robinson,2014-01-08 10:51:45-08:00,['520e75fbae89467cbcbd32d9485f9ec495c2ef4f'],1,1,2,2236662,1,,,,1509
483e05d83b1628b720d58894dc95280e7f772ddc,1,Henry Robinson,2014-01-08 10:51:45-08:00,['ece902d95344a3f0d84529db9385ac600ebf19e5'],2,13,15,2236677,1,1,1,1,1509
c46a561f6870324e858029f9a44a53d41c3f0d50,1,Henry Robinson,2014-01-08 10:51:46-08:00,['483e05d83b1628b720d58894dc95280e7f772ddc'],4,9,13,2236690,1,0,0,1,1509
6602b1088f7c680efde0280834e23746b91110e6,1,Henry Robinson,2014-01-08 10:51:46-08:00,['c46a561f6870324e858029f9a44a53d41c3f0d50'],13,17,30,2236720,6,1,1,1,1509
d84a33efa78233fed5ccb18af928e02588de4d52,0,Henry Robinson,2014-01-08 10:51:46-08:00,['6602b1088f7c680efde0280834e23746b91110e6'],32,5,37,2236757,4,0,0,0.166666667,1509
039bfa475dfa36acce754b0eaa19d6fee7cd9fb7,1,Henry Robinson,2014-01-08 10:51:47-08:00,['d84a33efa78233fed5ccb18af928e02588de4d52'],3,23,26,2236783,2,0.785714286,0.785714286,1,1509
3768e1ca1f431e473ca18db04fe57e40a2bb415d,1,Henry Robinson,2014-01-08 10:51:47-08:00,['039bfa475dfa36acce754b0eaa19d6fee7cd9fb7'],4,45,49,2236832,3,0.28,1,1,1509
87e0f8b330684c66598c2d5afe1fc0fa4438078e,0,Henry Robinson,2014-01-08 10:51:47-08:00,['3768e1ca1f431e473ca18db04fe57e40a2bb415d'],0,0,0,2236832,0,,,,1509
8c264f039503b59b272759e209d926c46fdda346,1,Henry Robinson,2014-01-08 10:51:48-08:00,['87e0f8b330684c66598c2d5afe1fc0fa4438078e'],14,14,28,2236860,2,,,,1509
e875d446ed2f1477c241050374d63dea87fb30d6,1,Henry Robinson,2014-01-08 10:51:48-08:00,['8c264f039503b59b272759e209d926c46fdda346'],41,42,83,2236943,9,,,,1509
2f7d24b35bb7c322da5ef9a8ed00142737318f13,0,Henry Robinson,2014-01-08 10:51:49-08:00,['e875d446ed2f1477c241050374d63dea87fb30d6'],1,1,2,2236945,1,,,,1509
0d587e86817f191fd928f313cf735f9178643095,1,Henry Robinson,2014-01-08 10:51:49-08:00,['2f7d24b35bb7c322da5ef9a8ed00142737318f13'],25,26,51,2236996,10,1,1,1,1509
7e7b9d1084c31a9c6db41ebce27376cc454cb3b1,1,Henry Robinson,2014-01-08 10:51:49-08:00,['0d587e86817f191fd928f313cf735f9178643095'],13,23,36,2237032,5,0,0.666666667,1,1509
af37e71c417f5a6f05aaafad437dcc73ff325cd7,0,Henry Robinson,2014-01-08 10:51:50-08:00,['7e7b9d1084c31a9c6db41ebce27376cc454cb3b1'],1,1,2,2237034,1,,,,1509
97586453651e0957cbd462085280f4e6337d14d5,1,Henry Robinson,2014-01-08 10:51:50-08:00,['af37e71c417f5a6f05aaafad437dcc73ff325cd7'],0,1,1,2237035,1,1,1,0,1509
0ced9049c1603b7bc83db8b8abf0e2473e800cbf,0,Henry Robinson,2014-01-08 10:51:50-08:00,['97586453651e0957cbd462085280f4e6337d14d5'],1,2,3,2237038,1,,,,1509
f87878f111c7c9e3cbff5347aaebd8d626eb6bec,1,Henry Robinson,2014-01-08 10:51:51-08:00,['0ced9049c1603b7bc83db8b8abf0e2473e800cbf'],18,97,115,2237153,8,0,0,1,1509
c8afd16bbb8848dfc4a92fe9ee567db49020abe5,1,Henry Robinson,2014-01-08 10:51:51-08:00,['f87878f111c7c9e3cbff5347aaebd8d626eb6bec'],50,431,481,2237634,8,0.265895954,0.265895954,0.757225434,1510
fc2d8836c4e0c252a4be84cf54aafdebe0328604,0,Henry Robinson,2014-01-08 10:51:51-08:00,['c8afd16bbb8848dfc4a92fe9ee567db49020abe5'],1,1,2,2237636,1,,,,1510
cf98b11f8ee96515fae3cff21d335723cdd605bf,1,Henry Robinson,2014-01-08 10:51:52-08:00,['fc2d8836c4e0c252a4be84cf54aafdebe0328604'],4,9,13,2237649,2,0,1,1,1510
14b103431838c67283bd1a569b1e4fd904627621,1,Henry Robinson,2014-01-08 10:51:52-08:00,['cf98b11f8ee96515fae3cff21d335723cdd605bf'],51,121,172,2237821,3,0,0,0.5,1510
3a4dd146541883c31b0d364869f55908cd11c7a3,0,Henry Robinson,2014-01-08 10:51:52-08:00,['14b103431838c67283bd1a569b1e4fd904627621'],8,3,11,2237832,1,0,0,0,1510
6a9f6a9d779fb87f8e8b2c1ceeda69fff295bce1,1,Henry Robinson,2014-01-08 10:51:53-08:00,['3a4dd146541883c31b0d364869f55908cd11c7a3'],3,160,163,2237995,6,0.407407407,0.481481481,0.50617284,1511
9b9efc6ec73bf57f524a51dadfa57a02cbe3dcb6,1,Henry Robinson,2014-01-08 10:51:53-08:00,['6a9f6a9d779fb87f8e8b2c1ceeda69fff295bce1'],8,7,15,2238010,3,1,0,0,1511
c4d06d9e9532fb88eb7abb17b12473ef62bfb3c6,1,Henry Robinson,2014-01-08 10:51:53-08:00,['9b9efc6ec73bf57f524a51dadfa57a02cbe3dcb6'],5,18,23,2238033,4,0.428571429,1,1,1511
4c32278782922f14280e08c852141b190ba9fd70,1,Henry Robinson,2014-01-08 10:51:54-08:00,['c4d06d9e9532fb88eb7abb17b12473ef62bfb3c6'],12,18,30,2238063,2,,,,1511
c72a24cdd57f4aa8a45db028b43b811432a3041f,1,Henry Robinson,2014-01-08 10:51:54-08:00,['4c32278782922f14280e08c852141b190ba9fd70'],47,211,258,2238321,8,0.650485437,0.86407767,0.669902913,1512
a743a3779c316f98e41b50e6f784d634d66246cf,0,Henry Robinson,2014-01-08 10:51:54-08:00,['c72a24cdd57f4aa8a45db028b43b811432a3041f'],1,1,2,2238323,1,,,,1512
9af39ad4c408c93c7faa47435a22d2afe60f751b,0,Henry Robinson,2014-01-08 10:51:55-08:00,['a743a3779c316f98e41b50e6f784d634d66246cf'],0,12,12,2238335,2,,,,1512
686c81067a46c19acd71b694e48db63b6eddf245,0,Henry Robinson,2014-01-08 10:51:55-08:00,['9af39ad4c408c93c7faa47435a22d2afe60f751b'],6,11,17,2238352,1,1,1,1,1512
49eaa8c340ef268e18771a5b57ae8b44ff0b8621,0,Henry Robinson,2014-01-08 10:51:55-08:00,['686c81067a46c19acd71b694e48db63b6eddf245'],1,1,2,2238354,1,,,,1512
21aa5b547a3d23dbd63b38d3dd202b2ae3bb595c,1,Henry Robinson,2014-01-08 10:51:56-08:00,['49eaa8c340ef268e18771a5b57ae8b44ff0b8621'],3,7,10,2238364,1,1,1,1,1512
55d5d0b0c6c9055717810a9f929a1cc5d1707054,1,Henry Robinson,2014-01-08 10:51:56-08:00,['21aa5b547a3d23dbd63b38d3dd202b2ae3bb595c'],101,147,248,2238612,14,0.451612903,0.677419355,0,1512
d85b90cb22884f9ee28113feff3938c5491843d5,1,Henry Robinson,2014-01-08 10:51:56-08:00,['55d5d0b0c6c9055717810a9f929a1cc5d1707054'],605,606,1211,2239823,18,0.455696203,0,0,1512
6f69136405e25623bfbf3d67d563eb576647b657,0,Henry Robinson,2014-01-08 10:51:57-08:00,['d85b90cb22884f9ee28113feff3938c5491843d5'],0,7,7,2239830,1,1,1,1,1512
4242db3c76b5c5052556ebb62342e7558d9037a7,1,Henry Robinson,2014-01-08 10:51:57-08:00,['6f69136405e25623bfbf3d67d563eb576647b657'],2,5,7,2239837,2,0,1,1,1512
65b11c61d4407a1a16ebca8094957e586f988f14,1,Henry Robinson,2014-01-08 10:51:57-08:00,['4242db3c76b5c5052556ebb62342e7558d9037a7'],0,51,51,2239888,4,0.555555556,0.444444444,1,1512
ae2ea0b0a5e642ca1ed5bcddaba20d4805e469fc,1,Henry Robinson,2014-01-08 10:51:58-08:00,['65b11c61d4407a1a16ebca8094957e586f988f14'],1,1,2,2239890,1,,,,1512
1c0ba4d64f9e1863b896ad67972c465acc919e3f,0,Henry Robinson,2014-01-08 10:51:58-08:00,['ae2ea0b0a5e642ca1ed5bcddaba20d4805e469fc'],5,8,13,2239903,1,1,1,1,1512
4cd883081491e664de799bea57c219d2d852e507,1,Henry Robinson,2014-01-08 10:51:58-08:00,['1c0ba4d64f9e1863b896ad67972c465acc919e3f'],12,16,28,2239931,2,,,,1512
70ac6a94ee0256d04c26bcca51efb724269b9799,1,Henry Robinson,2014-01-08 10:52:00-08:00,['4cd883081491e664de799bea57c219d2d852e507'],1,1,2,2239933,1,,,,1512
bba0b2bc48195dd3cc7ec9ebdef02bd80e1d0499,1,Henry Robinson,2014-01-08 10:52:00-08:00,['70ac6a94ee0256d04c26bcca51efb724269b9799'],10,72,82,2240015,6,0.269230769,0.884615385,1,1512
838657772028e656ac34410f7c5b1a74568b9e0c,1,Henry Robinson,2014-01-08 10:52:00-08:00,['bba0b2bc48195dd3cc7ec9ebdef02bd80e1d0499'],74,103,177,2240192,16,0.8125,0.875,0.625,1512
79cee63e9bb1ed42c4c3d312bdc5aa54dcf3f617,0,Henry Robinson,2014-01-08 10:52:01-08:00,['838657772028e656ac34410f7c5b1a74568b9e0c'],5,29,34,2240226,4,0,1,1,1512
69836f8ef44ced9deb21b0b363aac1f5fbc8af89,1,Henry Robinson,2014-01-08 10:52:01-08:00,['79cee63e9bb1ed42c4c3d312bdc5aa54dcf3f617'],1,9,10,2240236,2,0.75,1,1,1512
faeb7f5fa354e0219c0d46c239efb9592326caab,1,Henry Robinson,2014-01-08 10:52:01-08:00,['69836f8ef44ced9deb21b0b363aac1f5fbc8af89'],1,218,219,2240455,4,1,1,0.8,1513
fd53edbbe445b4aca5a65036302bbe40212c82dc,0,Henry Robinson,2014-01-08 10:52:02-08:00,['faeb7f5fa354e0219c0d46c239efb9592326caab'],2,51,53,2240508,5,0,0.35483871,1,1513
6e7406df8bd7e415f2b4f0d87a20c4713ce47a7e,0,Henry Robinson,2014-01-08 10:52:02-08:00,['fd53edbbe445b4aca5a65036302bbe40212c82dc'],66,64,130,2240638,7,1,1,0,1513
7b5836f3fbfb6719eafc279d3d30dd1eb6a9f212,1,Henry Robinson,2014-01-08 10:52:02-08:00,['6e7406df8bd7e415f2b4f0d87a20c4713ce47a7e'],37,42,79,2240717,3,0,0,1,1513
41b1d36a9d5fcb0dd2f6da53a7a0d4604b21a0eb,0,Henry Robinson,2014-01-08 10:52:03-08:00,['7b5836f3fbfb6719eafc279d3d30dd1eb6a9f212'],2,0,2,2240719,1,0,0,0,1513
9754f5bf526cc2c0b016d3322def47957a8b5644,0,Henry Robinson,2014-01-08 10:52:03-08:00,['41b1d36a9d5fcb0dd2f6da53a7a0d4604b21a0eb'],9,37,46,2240765,7,0,0,0.666666667,1513
52c9d26d16ba4fe96a48eb42754fe1f9a97ed144,1,Henry Robinson,2014-01-08 10:52:03-08:00,['9754f5bf526cc2c0b016d3322def47957a8b5644'],45,84,129,2240894,12,0.25,0.9375,0,1513
2b427208e502bfce3c57c4f8facbedcdfb394fc2,0,Henry Robinson,2014-01-08 10:52:04-08:00,['52c9d26d16ba4fe96a48eb42754fe1f9a97ed144'],5,18,23,2240917,2,0,0,1,1513
c9965e5a5c516581ee8d549b78ea1e12ff4e235b,0,Henry Robinson,2014-01-08 10:52:04-08:00,['2b427208e502bfce3c57c4f8facbedcdfb394fc2'],6,20,26,2240943,6,1,1,1,1513
f0e2d539fcc04888ee470ddc94ddaefb3c308790,1,Henry Robinson,2014-01-08 10:52:04-08:00,['c9965e5a5c516581ee8d549b78ea1e12ff4e235b'],157,316,473,2241416,32,0,1,1,1513
48ee7ce891dda3037a075d45077159c6dd745733,0,Henry Robinson,2014-01-08 10:52:05-08:00,['f0e2d539fcc04888ee470ddc94ddaefb3c308790'],11,67,78,2241494,4,1,0.5,0,1513
43deb6692fa0cc528b76e847deb1425cb72adb5d,1,Henry Robinson,2014-01-08 10:52:05-08:00,['48ee7ce891dda3037a075d45077159c6dd745733'],6,14,20,2241514,1,,,,1513
a6cb5f70a4e8d00c4c31ffb8456f770de0c47432,0,Henry Robinson,2014-01-08 10:52:05-08:00,['43deb6692fa0cc528b76e847deb1425cb72adb5d'],17,34,51,2241565,3,1,0,0.2,1513
ac61f7e1cabfda56d3aeae727ebdd843eceb8410,1,Henry Robinson,2014-01-08 10:52:06-08:00,['a6cb5f70a4e8d00c4c31ffb8456f770de0c47432'],13,77,90,2241655,3,1,1,1,1514
1b7800f914a9871d1e62c7eec82c44a6529c3f56,0,Henry Robinson,2014-01-08 10:52:06-08:00,['ac61f7e1cabfda56d3aeae727ebdd843eceb8410'],0,28,28,2241683,1,,,,1515
1b5083f63b93827ca07858c475d74f1cbac8bc18,0,Henry Robinson,2014-01-08 10:52:06-08:00,['1b7800f914a9871d1e62c7eec82c44a6529c3f56'],0,0,0,2241683,0,,,,1515
f2ec7ebb6ce6fd93c108e117426cf63124a2dcfe,0,Henry Robinson,2014-01-08 10:52:07-08:00,['1b5083f63b93827ca07858c475d74f1cbac8bc18'],7,7,14,2241697,1,,,,1515
b93219be38f59c5006f71ed1d5ef2fad57f69f76,1,Henry Robinson,2014-01-08 10:52:07-08:00,['f2ec7ebb6ce6fd93c108e117426cf63124a2dcfe'],73,162,235,2241932,5,1,1,0.829268293,1516
10939b33c4662a5281a4228e0de1a4c0c933f995,0,Henry Robinson,2014-01-08 10:52:07-08:00,['b93219be38f59c5006f71ed1d5ef2fad57f69f76'],0,0,0,2241932,0,,,,1516
e0876b951b6a31b42f7e5d0898cbf92ac93f2704,1,Henry Robinson,2014-01-08 10:52:08-08:00,['10939b33c4662a5281a4228e0de1a4c0c933f995'],198,841,1039,2242971,34,0.576388889,0.885416667,0.875,1520
2f046445c121ece3b4c6c6e1cfe4a3a9941f94dc,0,Henry Robinson,2014-01-08 10:52:08-08:00,['e0876b951b6a31b42f7e5d0898cbf92ac93f2704'],28,0,28,2242999,1,,,,1520
0d4c9e869d23bf8122853e1e4851f07c6bc23adf,0,Henry Robinson,2014-01-08 10:52:09-08:00,['2f046445c121ece3b4c6c6e1cfe4a3a9941f94dc'],0,0,0,2242999,0,,,,1520
9975ea8a02d0a1d778f813144f6a4535de830a68,0,Henry Robinson,2014-01-08 10:52:09-08:00,['0d4c9e869d23bf8122853e1e4851f07c6bc23adf'],13,8,21,2243020,1,0,0,0.333333333,1520
9a201645cd5cc235b479b31240af3847f66c1737,1,Henry Robinson,2014-01-08 10:52:09-08:00,['9975ea8a02d0a1d778f813144f6a4535de830a68'],23,163,186,2243206,11,0.862068966,0.862068966,0.862068966,1523
fbb95eb0e0060b057b6b7a41e04aa399f1178cb7,0,Henry Robinson,2014-01-08 10:52:10-08:00,['9a201645cd5cc235b479b31240af3847f66c1737'],0,0,0,2243206,0,,,,1523
f63437e62ad44a65a39b2597d6b081f90458de17,1,Henry Robinson,2014-01-08 10:52:10-08:00,['fbb95eb0e0060b057b6b7a41e04aa399f1178cb7'],10,30,40,2243246,4,0,0,0,1523
1c7baa643f7ef2db9a88d77d40bf4846658c4873,0,Henry Robinson,2014-01-08 10:52:10-08:00,['f63437e62ad44a65a39b2597d6b081f90458de17'],0,54,54,2243300,3,1,1,1,1524
e52ed0800bbaf41d9f59f45c912b55d90edea738,0,Henry Robinson,2014-01-08 10:52:11-08:00,['1c7baa643f7ef2db9a88d77d40bf4846658c4873'],10,128,138,2243438,4,1,1,0.333333333,1524
012c5a225eb49dd60e7394d0ef9991f4dc799cd0,0,Henry Robinson,2014-01-08 10:52:11-08:00,['e52ed0800bbaf41d9f59f45c912b55d90edea738'],1,2,3,2243441,1,,,,1524
b692146fd725605220c1824f5d054d3682180868,0,Henry Robinson,2014-01-08 10:52:11-08:00,['012c5a225eb49dd60e7394d0ef9991f4dc799cd0'],1,4,5,2243446,1,1,1,0,1524
09729f43ae287629500f3eee8b6ace166f7dbcf9,1,Henry Robinson,2014-01-08 10:52:12-08:00,['b692146fd725605220c1824f5d054d3682180868'],390,262,652,2244098,7,1,0.801801802,0.603603604,1524
a4e441cc15139b962eadc4ceb62ff0a2dcf43bee,0,Henry Robinson,2014-01-08 10:52:12-08:00,['09729f43ae287629500f3eee8b6ace166f7dbcf9'],8,153,161,2244259,2,1,1,0.920634921,1525
a0ad16af4152662af3ac1bd4937064469485ff70,0,Henry Robinson,2014-01-08 10:52:12-08:00,['a4e441cc15139b962eadc4ceb62ff0a2dcf43bee'],16,43,59,2244318,3,0.708333333,0.5,0.541666667,1525
17ed6ea1771cd84ab86a116283e0ac294535c272,0,Henry Robinson,2014-01-08 10:52:13-08:00,['a0ad16af4152662af3ac1bd4937064469485ff70'],990,2529,3519,2247837,26,0.28,0.92,0.88,1537
67a5de52cc99558acc9957ab3fc39f76d395e211,0,Henry Robinson,2014-01-08 10:52:13-08:00,['17ed6ea1771cd84ab86a116283e0ac294535c272'],8,29,37,2247874,2,1,1,1,1537
b9ea32e9b77a3aa2fe2f4538345cb662e3d7330d,1,Henry Robinson,2014-01-08 10:52:14-08:00,['67a5de52cc99558acc9957ab3fc39f76d395e211'],596,494,1090,2248964,19,1,0.515151515,1,1537
340b735804c56396bac8a4d7ca1099d678ab13e5,0,Henry Robinson,2014-01-08 10:52:14-08:00,['b9ea32e9b77a3aa2fe2f4538345cb662e3d7330d'],2,3,5,2248969,2,1,1,1,1537
e098b4cd85ead614831aff7c292b005bbff8ae11,1,Henry Robinson,2014-01-08 10:52:14-08:00,['340b735804c56396bac8a4d7ca1099d678ab13e5'],33,54,87,2249056,3,0,1,0,1537
be1d42c05a3d4d07e54f341452931b54914804a9,1,Henry Robinson,2014-01-08 10:52:15-08:00,['e098b4cd85ead614831aff7c292b005bbff8ae11'],15,40,55,2249111,2,0,0,1,1537
26fe0e757c18d922c972db285bb33204c208b1aa,1,Henry Robinson,2014-01-08 10:52:15-08:00,['be1d42c05a3d4d07e54f341452931b54914804a9'],24,22,46,2249157,7,1,1,0,1537
b58fd6ca66d5a8b339390f75410a973bbff3ce00,0,Henry Robinson,2014-01-08 10:52:15-08:00,['26fe0e757c18d922c972db285bb33204c208b1aa'],15,15,30,2249187,1,,,,1537
a3bc1ce13368622c74065ba13df34d13316ab7cf,1,Henry Robinson,2014-01-08 10:52:16-08:00,['b58fd6ca66d5a8b339390f75410a973bbff3ce00'],381,538,919,2250106,10,1,1,0.848484848,1538
e9e23bff5dcbc2af54293492a3b80034590a790a,1,Henry Robinson,2014-01-08 10:52:16-08:00,['a3bc1ce13368622c74065ba13df34d13316ab7cf'],18,46,64,2250170,1,,,,1538
a3016cc4d419f1b1c8b5fb12e49f53206d3d41e6,0,Henry Robinson,2014-01-08 10:52:16-08:00,['e9e23bff5dcbc2af54293492a3b80034590a790a'],0,112,112,2250282,7,1,1,1,1543
707a566b5d531bc4d676d2dcd41b54f28df801f3,0,Henry Robinson,2014-01-08 10:52:17-08:00,['a3016cc4d419f1b1c8b5fb12e49f53206d3d41e6'],0,68,68,2250350,2,1,1,1,1544
f264db1647bca4a4b630f72073b2eb8cf6317e90,1,Henry Robinson,2014-01-08 10:52:17-08:00,['707a566b5d531bc4d676d2dcd41b54f28df801f3'],1,10,11,2250361,1,0,0,0,1544
d66d3bfce3b025752a385af8c3c9dad4ed8b5fb4,1,Henry Robinson,2014-01-08 10:52:17-08:00,['f264db1647bca4a4b630f72073b2eb8cf6317e90'],407,792,1199,2251560,27,0,0.605839416,0.919708029,1545
b664f06aad45f53390d8f8c38863b3ef930a8c61,1,Henry Robinson,2014-01-08 10:52:18-08:00,['d66d3bfce3b025752a385af8c3c9dad4ed8b5fb4'],7,90,97,2251657,6,0.56097561,1,1,1546
a30192b84ddeed2812ffac6683b75b2537e9a094,1,Henry Robinson,2014-01-08 10:52:18-08:00,['b664f06aad45f53390d8f8c38863b3ef930a8c61'],8,10,18,2251675,3,0,0,1,1546
660161b419c3bc3f36575b4599ece7b271408cbc,0,Henry Robinson,2014-01-08 10:52:18-08:00,['a30192b84ddeed2812ffac6683b75b2537e9a094'],0,1,1,2251676,1,,,,1546
e3ef3ff4eb1de65fdcc07ea19980bab9abb57ec8,0,Henry Robinson,2014-01-08 10:52:19-08:00,['660161b419c3bc3f36575b4599ece7b271408cbc'],9,36,45,2251721,4,0,1,1,1546
a1fac7a81f520bd986f5b89fbeb5903f1cdddca4,1,Henry Robinson,2014-01-08 10:52:19-08:00,['e3ef3ff4eb1de65fdcc07ea19980bab9abb57ec8'],2,2,4,2251725,1,,,,1546
0151f9ce588fa08108c0e251a4d69f5c6d264a98,0,Henry Robinson,2014-01-08 10:52:19-08:00,['a1fac7a81f520bd986f5b89fbeb5903f1cdddca4'],32,100,132,2251857,1,0.310344828,0.965517241,0.689655172,1546
6e61b4c7c84dd05253ed628bcee990739829385e,1,Henry Robinson,2014-01-08 10:52:20-08:00,['0151f9ce588fa08108c0e251a4d69f5c6d264a98'],15,18,33,2251890,3,0,0,1,1546
efac6f82fd1777bc5d98711d86e0e2eff61a3209,1,Henry Robinson,2014-01-08 10:52:20-08:00,['6e61b4c7c84dd05253ed628bcee990739829385e'],60,30,90,2251980,3,0.916666667,0.666666667,0,1546
3dccab529669ceb1481656cb25578b4874335706,1,Henry Robinson,2014-01-08 10:52:20-08:00,['efac6f82fd1777bc5d98711d86e0e2eff61a3209'],168,923,1091,2253071,38,0.26,0.876666667,0.743333333,1550
71cb9059bd483714ec03234526fd490576b5dfa4,1,Henry Robinson,2014-01-08 10:52:21-08:00,['3dccab529669ceb1481656cb25578b4874335706'],34,76,110,2253181,7,1,0.909090909,1,1550
00275ce3a92090b5cede5c7c59b915c736df93f3,0,Henry Robinson,2014-01-08 10:52:21-08:00,['71cb9059bd483714ec03234526fd490576b5dfa4'],92,348,440,2253621,13,0,0.589473684,0.715789474,1550
fe4ed6717f867ae998c59d93ba6dd4e6b6b9038b,1,Henry Robinson,2014-01-08 10:52:22-08:00,['00275ce3a92090b5cede5c7c59b915c736df93f3'],1,4,5,2253626,1,0,0,1,1550
f5387d9b09d9eb1355511f70e5172d647818e8f7,1,Henry Robinson,2014-01-08 10:52:22-08:00,['fe4ed6717f867ae998c59d93ba6dd4e6b6b9038b'],0,1,1,2253627,1,1,1,1,1550
d0665481d1f6236f641c7f164c25e7f6fc303d45,0,Henry Robinson,2014-01-08 10:52:22-08:00,['f5387d9b09d9eb1355511f70e5172d647818e8f7'],6,8,14,2253641,5,,,,1550
f7cd659a4c0a1f3483d25279f298beaec0ef928c,0,Henry Robinson,2014-01-08 10:52:23-08:00,['d0665481d1f6236f641c7f164c25e7f6fc303d45'],11,4,15,2253656,1,,,,1550
bbec47644d1bd07460513904af391ed94ece7ebe,1,Henry Robinson,2014-01-08 10:52:23-08:00,['f7cd659a4c0a1f3483d25279f298beaec0ef928c'],7,28,35,2253691,5,0,0,1,1550
6fd5700ce1aa5d24a39297010ae916fbc672e99e,1,Henry Robinson,2014-01-08 10:52:23-08:00,['bbec47644d1bd07460513904af391ed94ece7ebe'],0,7,7,2253698,2,0,0,1,1550
07330abddd13c0aeeaf87ecb0cacb3eaa184ccee,1,Henry Robinson,2014-01-08 10:52:24-08:00,['6fd5700ce1aa5d24a39297010ae916fbc672e99e'],9,2,11,2253709,1,0,0,0,1550
567eb6b759f8690fd784b3da041b5574158721a8,0,Henry Robinson,2014-01-08 10:52:24-08:00,['07330abddd13c0aeeaf87ecb0cacb3eaa184ccee'],1,10,11,2253720,2,0.6,0.6,1,1550
ca9f0eb5b5ddfe3fb180d353b553232ad51c70f0,0,Henry Robinson,2014-01-08 10:52:24-08:00,['567eb6b759f8690fd784b3da041b5574158721a8'],1,1,2,2253722,1,,,,1550
6e0dd1f829d3dd602c642344ff8ac688861a8b27,1,Henry Robinson,2014-01-08 10:52:25-08:00,['ca9f0eb5b5ddfe3fb180d353b553232ad51c70f0'],3,3,6,2253728,2,,,,1550
70ac30f283605d13c1b1bd67069620cd4e37f8f8,1,Henry Robinson,2014-01-08 10:52:25-08:00,['6e0dd1f829d3dd602c642344ff8ac688861a8b27'],7,38,45,2253773,1,1,0,1,1550
1b49174a0a39b54556dcf3e12a772318b73a77f1,0,Henry Robinson,2014-01-08 10:52:25-08:00,['70ac30f283605d13c1b1bd67069620cd4e37f8f8'],108,21,129,2253902,3,0,0,0,1550
13343fb5ec74206355baae7b5f79d85dec997264,0,Henry Robinson,2014-01-08 10:52:26-08:00,['1b49174a0a39b54556dcf3e12a772318b73a77f1'],9,9,18,2253920,1,,,,1550
6a70da000004b6f2c81a4d6d0c2f6ddafad3b6a7,0,Henry Robinson,2014-01-08 10:52:26-08:00,['13343fb5ec74206355baae7b5f79d85dec997264'],6,1,7,2253927,1,1,1,0,1550
1e9139d5670f2f5c6d0c8e193c0ce09d3b9a3a7c,1,Henry Robinson,2014-01-08 10:52:26-08:00,['6a70da000004b6f2c81a4d6d0c2f6ddafad3b6a7'],2,4,6,2253933,1,0,1,1,1550
19e11f0378fb308d499f0019f236e3ff9fd67e7e,0,Henry Robinson,2014-01-08 10:52:27-08:00,['1e9139d5670f2f5c6d0c8e193c0ce09d3b9a3a7c'],1,1,2,2253935,1,,,,1550
04af2828c3d9c38c1eb4184fc3d6cf759fbf945f,1,Henry Robinson,2014-01-08 10:52:27-08:00,['19e11f0378fb308d499f0019f236e3ff9fd67e7e'],38,132,170,2254105,5,0.857142857,0.857142857,0.816326531,1552
cafb7b72f848039376bbb299a41ea8b880c95d84,1,Henry Robinson,2014-01-08 10:52:27-08:00,['04af2828c3d9c38c1eb4184fc3d6cf759fbf945f'],72,6264,6336,2260441,33,0.399689441,0.805900621,0.670496894,1577
133eae33ccf88a1374b028c60e7a6f2f3f6da619,0,Henry Robinson,2014-01-08 10:52:28-08:00,['cafb7b72f848039376bbb299a41ea8b880c95d84'],19,42,61,2260502,2,0.368421053,1,0.315789474,1577
73a9c5f02482abe376ce518f6fcf5e42f322952c,1,Henry Robinson,2014-01-08 10:52:28-08:00,['133eae33ccf88a1374b028c60e7a6f2f3f6da619'],1,4,5,2260507,1,1,1,1,1577
10f48c67fb04b17a5fcf5e90082f61a919c439e7,0,Henry Robinson,2014-01-08 10:52:28-08:00,['73a9c5f02482abe376ce518f6fcf5e42f322952c'],1,1,2,2260509,1,,,,1577
08848dbd70e7fe61c399c3a0173ce2d3c06ca5dc,0,Henry Robinson,2014-01-08 10:52:29-08:00,['10f48c67fb04b17a5fcf5e90082f61a919c439e7'],34,43,77,2260586,2,1,1,0.5,1577
cdf93565a6c5fbce3963348c95c9dfdf9498fefd,0,Henry Robinson,2014-01-08 10:52:29-08:00,['08848dbd70e7fe61c399c3a0173ce2d3c06ca5dc'],3,4,7,2260593,3,0,0,1,1577
49eeb8ef2e17e7bb0288884c4ab25361dc9a395a,1,Henry Robinson,2014-01-08 10:52:29-08:00,['cdf93565a6c5fbce3963348c95c9dfdf9498fefd'],2,161,163,2260756,2,0.617021277,1,1,1578
b7710dfa3586ef6b6e4f7b0235a81fd8de88ff0c,0,Henry Robinson,2014-01-08 10:52:30-08:00,['49eeb8ef2e17e7bb0288884c4ab25361dc9a395a'],0,39,39,2260795,1,0,0.785714286,0,1578
44ed760e06488fdb4bf7b821bd01d7acb3dea123,0,Henry Robinson,2014-01-08 10:52:30-08:00,['b7710dfa3586ef6b6e4f7b0235a81fd8de88ff0c'],0,2,2,2260797,2,1,1,1,1578
c9b92d574f77d18e581a0e5036794c453ed72d67,0,Henry Robinson,2014-01-08 10:52:30-08:00,['44ed760e06488fdb4bf7b821bd01d7acb3dea123'],5,7,12,2260809,1,1,1,1,1578
1780084753aa6a056db3f2b4a89888800ad31ef0,0,Henry Robinson,2014-01-08 10:52:31-08:00,['c9b92d574f77d18e581a0e5036794c453ed72d67'],14,9,23,2260832,3,0,0,0,1578
c54ac1c669de6fda5f01f87e7b1a151b7ca8be15,1,Henry Robinson,2014-01-08 10:52:31-08:00,['1780084753aa6a056db3f2b4a89888800ad31ef0'],107,92,199,2261031,15,1,0,1,1578
7bcafcb2395318d40f4f73badc8d0b31929e2613,1,Henry Robinson,2014-01-08 10:52:31-08:00,['c54ac1c669de6fda5f01f87e7b1a151b7ca8be15'],275,764,1039,2262070,12,0.471861472,0.454545455,0.796536797,1581
36b0ce6a7d78eaca8ab7ef0b500907b3d1827d67,0,Henry Robinson,2014-01-08 10:52:32-08:00,['7bcafcb2395318d40f4f73badc8d0b31929e2613'],1,5,6,2262076,1,,,,1581
bfbe9a7f7fa7db54e838fffe1f705f712534fef2,0,Henry Robinson,2014-01-08 10:52:32-08:00,['36b0ce6a7d78eaca8ab7ef0b500907b3d1827d67'],1,4,5,2262081,1,1,1,1,1581
2394ae2e663811c8b5ad97a7227d21ac6a32b5e2,1,Henry Robinson,2014-01-08 10:52:32-08:00,['bfbe9a7f7fa7db54e838fffe1f705f712534fef2'],228,1399,1627,2263708,49,0.519455253,0.789883268,0.885214008,1588
640a21802dff98313a0837ff8c52f646a3e6173c,1,Henry Robinson,2014-01-08 10:52:33-08:00,['2394ae2e663811c8b5ad97a7227d21ac6a32b5e2'],122,246,368,2264076,9,0.121621622,0.972972973,1,1588
4d9e97a1a7f74ecb213c330650ab5da380005896,1,Henry Robinson,2014-01-08 10:52:33-08:00,['640a21802dff98313a0837ff8c52f646a3e6173c'],7,13,20,2264096,1,0,0,1,1588
2163b89e6c8ded7af3053a742204a32559b904c3,0,Henry Robinson,2014-01-08 10:52:33-08:00,['4d9e97a1a7f74ecb213c330650ab5da380005896'],1,1,2,2264098,1,,,,1588
cea1b2fcc33f16c0f2d7bf0906faf00ef2de37bb,0,Henry Robinson,2014-01-08 10:52:34-08:00,['2163b89e6c8ded7af3053a742204a32559b904c3'],6,9,15,2264113,1,1,0,0,1588
39909fe71b250adec9511844cec082f8fec066be,0,Henry Robinson,2014-01-08 10:52:34-08:00,['cea1b2fcc33f16c0f2d7bf0906faf00ef2de37bb'],74,78,152,2264265,2,1,1,1,1588
931fdd54c5cc8e674f681485bc2715f7d27dda26,0,Henry Robinson,2014-01-08 10:52:35-08:00,['39909fe71b250adec9511844cec082f8fec066be'],0,0,0,2264265,0,,,,1588
5ea0bb6d30bb2fa3acdbeb82625304afac542f12,0,Henry Robinson,2014-01-08 10:52:35-08:00,['931fdd54c5cc8e674f681485bc2715f7d27dda26'],13,21,34,2264299,2,0.083333333,0.166666667,0.083333333,1588
af90c8a133b0dc1f639ebf5df4a4c6895afda8f9,1,Henry Robinson,2014-01-08 10:52:36-08:00,['5ea0bb6d30bb2fa3acdbeb82625304afac542f12'],1142,1649,2791,2267090,88,0.394636015,0.75862069,0.655172414,1591
3907f9c28d699c485c6af1e1e813b8feb5380a6b,0,Henry Robinson,2014-01-08 10:52:36-08:00,['af90c8a133b0dc1f639ebf5df4a4c6895afda8f9'],6,0,6,2267096,6,1,0.5,0.166666667,1591
53cd9eadab5b8bd2d364107a1107b3999d9eae1f,1,Henry Robinson,2014-01-08 10:52:36-08:00,['3907f9c28d699c485c6af1e1e813b8feb5380a6b'],1559,1520,3079,2270175,51,0.712643678,0.804597701,0.413793103,1592
f42ab83b79774428efdc0baf03b20e0d7537c1fd,1,Henry Robinson,2014-01-08 10:52:37-08:00,['53cd9eadab5b8bd2d364107a1107b3999d9eae1f'],15,17,32,2270207,3,1,1,1,1592
367243454260a72fa782b9bea2dfd95d5e2a362e,1,Henry Robinson,2014-01-08 10:52:37-08:00,['f42ab83b79774428efdc0baf03b20e0d7537c1fd'],0,21,21,2270228,1,1,1,1,1592
6735e3983f16fce8587393687c94b880c74d58c8,0,Henry Robinson,2014-01-08 10:52:37-08:00,['367243454260a72fa782b9bea2dfd95d5e2a362e'],5,4,9,2270237,2,,,,1592
aaf0d0a8b4def853edc751655ed9fff4d71a319c,0,Henry Robinson,2014-01-08 10:52:38-08:00,['6735e3983f16fce8587393687c94b880c74d58c8'],1,1,2,2270239,1,,,,1592
dc7a1566fdb581c592554af9c5e7193d06e3724e,0,Henry Robinson,2014-01-08 10:52:38-08:00,['aaf0d0a8b4def853edc751655ed9fff4d71a319c'],1,6,7,2270246,1,1,1,1,1592
b22d1f41a792cd419da0b46359114cf891c48abb,1,Henry Robinson,2014-01-08 10:52:38-08:00,['dc7a1566fdb581c592554af9c5e7193d06e3724e'],207,264,471,2270717,59,0.840909091,0,0,1592
69d6f20bbe2a4394cff449eacb5ca503385af621,0,Henry Robinson,2014-01-08 10:52:39-08:00,['b22d1f41a792cd419da0b46359114cf891c48abb'],30,39,69,2270786,1,,,,1592
9f542429415ce55686aeccb52394a29919841261,0,Henry Robinson,2014-01-08 10:52:39-08:00,['69d6f20bbe2a4394cff449eacb5ca503385af621'],2,18,20,2270806,1,,,,1592
048f9c64853c2cfc07f811705e1e331e351b996d,1,Henry Robinson,2014-01-08 10:52:39-08:00,['9f542429415ce55686aeccb52394a29919841261'],28,40,68,2270874,4,0.857142857,0.857142857,0.857142857,1592
d6d1557fe7c539a467b938a4b87df93f0d077163,1,Henry Robinson,2014-01-08 10:52:40-08:00,['048f9c64853c2cfc07f811705e1e331e351b996d'],130,6,136,2271010,3,,,,1592
41d7bed28029ea44f9e63344eddc2421303c66f9,0,Henry Robinson,2014-01-08 10:52:40-08:00,['d6d1557fe7c539a467b938a4b87df93f0d077163'],6,1,7,2271017,1,0,0,0,1592
8eea7a6953c29623873fa21eae8edf89f0d7dd22,1,Henry Robinson,2014-01-08 10:52:40-08:00,['41d7bed28029ea44f9e63344eddc2421303c66f9'],59,397,456,2271473,8,0.463768116,0.528985507,0.84057971,1594
2cc519c6e5c115c8fea91e889d3e9a4ece255e0c,1,Henry Robinson,2014-01-08 10:52:41-08:00,['8eea7a6953c29623873fa21eae8edf89f0d7dd22'],9,190,199,2271672,6,0.948717949,1,0.897435897,1596
88bc7ea39d5a5c5650a38b915fd3124cf2e4967e,0,Henry Robinson,2014-01-08 10:52:41-08:00,['2cc519c6e5c115c8fea91e889d3e9a4ece255e0c'],1,1,2,2271674,1,,,,1596
d0a125c7987f81c6a68441c9132b013fcf109fc9,1,Henry Robinson,2014-01-08 10:52:41-08:00,['88bc7ea39d5a5c5650a38b915fd3124cf2e4967e'],115,136,251,2271925,6,1,1,1,1596
0fc9f64ccfec0e7e3832eb64ca1d1cf9352c66d4,0,Henry Robinson,2014-01-08 10:52:42-08:00,['d0a125c7987f81c6a68441c9132b013fcf109fc9'],2,3,5,2271930,1,1,1,1,1596
fa309529dfdbf9e71402e45125d0a14bff91b11f,1,Henry Robinson,2014-01-08 10:52:42-08:00,['0fc9f64ccfec0e7e3832eb64ca1d1cf9352c66d4'],25,59,84,2272014,1,1,1,0.894736842,1596
bcfe9d97e07a83a90d2a60de95f54dba4ee0bffa,1,Henry Robinson,2014-01-08 10:52:42-08:00,['fa309529dfdbf9e71402e45125d0a14bff91b11f'],150,372,522,2272536,12,0.288888889,0.455555556,1,1598
d3a94aa4feb16be6ced09787860eebd7b71789c2,0,Henry Robinson,2014-01-08 10:52:43-08:00,['bcfe9d97e07a83a90d2a60de95f54dba4ee0bffa'],1,1,2,2272538,1,,,,1598
8eb727b585ce0a14a28eb58cbe5bb4c1fbe05882,1,Henry Robinson,2014-01-08 10:52:43-08:00,['d3a94aa4feb16be6ced09787860eebd7b71789c2'],579,889,1468,2274006,42,0.25,0.592592593,1,1598
308650f208f37953a107fea78f0e68dd9d0ebc09,0,Henry Robinson,2014-01-08 10:52:44-08:00,['8eb727b585ce0a14a28eb58cbe5bb4c1fbe05882'],3,5,8,2274014,2,0,1,1,1598
8ada9b438315949ff61ebde5e57d411045336a6b,0,Henry Robinson,2014-01-08 10:52:44-08:00,['308650f208f37953a107fea78f0e68dd9d0ebc09'],0,1,1,2274015,1,,,,1598
8492db3b7d56c4c8b1e93a421e139c31a100ae2c,0,Henry Robinson,2014-01-08 10:52:44-08:00,['8ada9b438315949ff61ebde5e57d411045336a6b'],1,5,6,2274021,1,,,,1598
eced91713ac5d6c8661e86406eadf599003d9bf2,1,Henry Robinson,2014-01-08 10:52:45-08:00,['8492db3b7d56c4c8b1e93a421e139c31a100ae2c'],207,222,429,2274450,3,1,1,0,1598
8095a963d045a2de2033cf8bd90e04db87acd835,1,Henry Robinson,2014-01-08 10:52:45-08:00,['eced91713ac5d6c8661e86406eadf599003d9bf2'],163,376,539,2274989,10,0.306666667,0,0.96,1598
052ab52c1929386e0583c7464f527b64a5d95842,1,Henry Robinson,2014-01-08 10:52:45-08:00,['8095a963d045a2de2033cf8bd90e04db87acd835'],3,2489,2492,2277481,21,0.719789842,0.786339755,0.660245184,1616
33000b8c15b17302ae1cf4ed2d796442e60808e4,0,Henry Robinson,2014-01-08 10:52:46-08:00,['052ab52c1929386e0583c7464f527b64a5d95842'],0,24,24,2277505,2,0,0,1,1616
9aa15da7191e6af727e0685b1b9917d8e0c6c310,0,Henry Robinson,2014-01-08 10:52:46-08:00,['33000b8c15b17302ae1cf4ed2d796442e60808e4'],38,21,59,2277564,1,,,,1616
bd8bc8ef436754d5124aae726de514f949c3f18c,1,Henry Robinson,2014-01-08 10:52:46-08:00,['9aa15da7191e6af727e0685b1b9917d8e0c6c310'],43,121,164,2277728,5,0.466666667,0.488888889,0.8,1616
8e2a3136736ab76ef1dde356b7c95b825c27ee34,0,Henry Robinson,2014-01-08 10:52:47-08:00,['bd8bc8ef436754d5124aae726de514f949c3f18c'],10,37,47,2277775,6,1,1,1,1616
f5c9e4d075a550d8873269f17be03fa287e398a4,0,Henry Robinson,2014-01-08 10:52:47-08:00,['8e2a3136736ab76ef1dde356b7c95b825c27ee34'],2,3,5,2277780,1,,,,1616
6c3bd2bb84ba275ed67baeaff4fa02461739d67a,0,Henry Robinson,2014-01-08 10:52:47-08:00,['f5c9e4d075a550d8873269f17be03fa287e398a4'],27,76,103,2277883,2,0,1,1,1616
a0bf45a0b4e61ee1b03deb00fd7cde93ab6a44ae,1,Henry Robinson,2014-01-08 10:52:48-08:00,['6c3bd2bb84ba275ed67baeaff4fa02461739d67a'],12,80,92,2277975,10,0.117647059,0.470588235,1,1616
77c0e54bb9b5afc87d5728366c3943c45a310ed0,0,Henry Robinson,2014-01-08 10:52:48-08:00,['a0bf45a0b4e61ee1b03deb00fd7cde93ab6a44ae'],151,83,234,2278209,2,,,,1616
a1f2f72f4927a7320e18489cc2dfdf93f51994c8,1,Henry Robinson,2014-01-08 10:52:48-08:00,['77c0e54bb9b5afc87d5728366c3943c45a310ed0'],292,324,616,2278825,18,0,1,0,1616
4531b215bcd8297b0fcb3aaa9b97386fecf734b8,1,Henry Robinson,2014-01-08 10:52:49-08:00,['a1f2f72f4927a7320e18489cc2dfdf93f51994c8'],54,134,188,2279013,15,0.545454545,0.454545455,1,1618
533f1751a43a72e5be65eb648bb11f7c4dd8f153,0,Henry Robinson,2014-01-08 10:52:49-08:00,['4531b215bcd8297b0fcb3aaa9b97386fecf734b8'],3,1,4,2279017,1,,,,1618
2cf314262f2d75f929a31fd19d6d8542b6421241,1,Henry Robinson,2014-01-08 10:52:49-08:00,['533f1751a43a72e5be65eb648bb11f7c4dd8f153'],6,39,45,2279062,7,0.380952381,0,0.666666667,1618
2b9105cd114c40c43f0afb3f4205296a28545059,0,Henry Robinson,2014-01-08 10:52:50-08:00,['2cf314262f2d75f929a31fd19d6d8542b6421241'],2295,2298,4593,2283655,9,0,0,0,1618
a46276325c6af1b27fe8af8b20da1d92b8936290,1,Henry Robinson,2014-01-08 10:52:50-08:00,['2b9105cd114c40c43f0afb3f4205296a28545059'],7,131,138,2283793,9,0.148148148,0.611111111,1,1620
fd99db03008522bf21427e17e3d31f112cc138ac,1,Henry Robinson,2014-01-08 10:52:50-08:00,['a46276325c6af1b27fe8af8b20da1d92b8936290'],8,786,794,2284587,21,0.205223881,0.764925373,0.891791045,1625
073abb803d73341bdbd2152b273cf7b96ec89eba,0,Henry Robinson,2014-01-08 10:52:51-08:00,['fd99db03008522bf21427e17e3d31f112cc138ac'],1,1,2,2284589,1,,,,1625
84f1fda6bb7c92692f64b94dbf63a0c40693d9c0,1,Henry Robinson,2014-01-08 10:52:51-08:00,['073abb803d73341bdbd2152b273cf7b96ec89eba'],13,33,46,2284635,3,1,1,1,1625
2da1cb498e1529a4e7f42e4866164b8cd79a0ece,1,Henry Robinson,2014-01-08 10:52:51-08:00,['84f1fda6bb7c92692f64b94dbf63a0c40693d9c0'],123,543,666,2285301,20,0.252136752,0.504273504,0.576923077,1625
29dad70512179d8c0c0efff126ff1957c7ed85ad,0,Henry Robinson,2014-01-08 10:52:52-08:00,['2da1cb498e1529a4e7f42e4866164b8cd79a0ece'],1,3,4,2285305,1,0,1,1,1625
49e58ce2a138c68e29a1b0e4c7ae4f5bcf5b7711,1,Henry Robinson,2014-01-08 10:52:52-08:00,['29dad70512179d8c0c0efff126ff1957c7ed85ad'],33,77,110,2285415,9,1,0,0.666666667,1625
b83b027c877aa851cc9e1dcfbe16f7ee3fc71620,1,Henry Robinson,2014-01-08 10:52:52-08:00,['49e58ce2a138c68e29a1b0e4c7ae4f5bcf5b7711'],6,12,18,2285433,2,0,1,0,1625
cf7ed25377cb708d8d344bce406bd63fc4d22982,0,Henry Robinson,2014-01-08 10:52:53-08:00,['b83b027c877aa851cc9e1dcfbe16f7ee3fc71620'],0,4,4,2285437,1,,,,1625
4ab4a1098e6f26d1d59c237e0057502b127f8387,1,Henry Robinson,2014-01-08 10:52:53-08:00,['cf7ed25377cb708d8d344bce406bd63fc4d22982'],12,65,77,2285514,11,0.705882353,0.852941176,0.794117647,1625
be454117ed3f1620a8663bb548a6b1d52cd83145,1,Henry Robinson,2014-01-08 10:52:53-08:00,['4ab4a1098e6f26d1d59c237e0057502b127f8387'],6,6,12,2285526,2,,,,1625
6253b21834aeaa36c6c0607c74e87396395d9a2b,0,Henry Robinson,2014-01-08 10:52:54-08:00,['be454117ed3f1620a8663bb548a6b1d52cd83145'],1,14,15,2285541,2,0,0,0,1625
82d7806db22667e281880f00e8f4ede889f35c72,1,Henry Robinson,2014-01-08 10:52:54-08:00,['6253b21834aeaa36c6c0607c74e87396395d9a2b'],293,561,854,2286395,18,0.296296296,0.638888889,1,1626
dbed012396db37a41b178edfbd17b625ea3ca504,1,Henry Robinson,2014-01-08 10:52:55-08:00,['82d7806db22667e281880f00e8f4ede889f35c72'],68,68,136,2286531,8,,,,1627
10a637d6c8eb4c1003b0e7db427db18f0a19a0bd,1,Henry Robinson,2014-01-08 10:52:55-08:00,['dbed012396db37a41b178edfbd17b625ea3ca504'],0,128,128,2286659,6,0.263157895,1,0.263157895,1629
01832396a5fa9b57f405c8999083a331f13f5ac4,1,Henry Robinson,2014-01-08 10:52:55-08:00,['10a637d6c8eb4c1003b0e7db427db18f0a19a0bd'],23,54,77,2286736,2,0.272727273,1,1,1629
533ca4d3e61848d5570310b500898262d5fe81e9,1,Henry Robinson,2014-01-08 10:52:56-08:00,['01832396a5fa9b57f405c8999083a331f13f5ac4'],2,2,4,2286740,1,,,,1629
79cdeac3d68e7a049dd5de3e1ba42e3650602d08,0,Henry Robinson,2014-01-08 10:52:56-08:00,['533ca4d3e61848d5570310b500898262d5fe81e9'],9,18,27,2286767,4,,,,1629
39f9a067fa6c0291929d62b57edd30b93a6f06f6,1,Henry Robinson,2014-01-08 10:52:56-08:00,['79cdeac3d68e7a049dd5de3e1ba42e3650602d08'],65,178,243,2287010,4,0.268292683,0.963414634,0.963414634,1629
f287b5711280d85c23be57d4d52c662c147b4bef,1,Henry Robinson,2014-01-08 10:52:57-08:00,['39f9a067fa6c0291929d62b57edd30b93a6f06f6'],6,139,145,2287155,13,0.222222222,0.567901235,0.975308642,1629
7982c30f7f423107c3d5f9fe069742746a3b557d,1,Henry Robinson,2014-01-08 10:52:57-08:00,['f287b5711280d85c23be57d4d52c662c147b4bef'],90,68,158,2287313,12,1,0.952380952,1,1629
b5ca38cf7ea2d6900850e49e52c6738172efcbd6,1,Henry Robinson,2014-01-08 10:52:57-08:00,['7982c30f7f423107c3d5f9fe069742746a3b557d'],9,19,28,2287341,3,0.2,1,1,1629
6a1cc58936306536251ab06789aa709cefd1adf7,1,Henry Robinson,2014-01-08 10:52:58-08:00,['b5ca38cf7ea2d6900850e49e52c6738172efcbd6'],53,145,198,2287539,10,0.551020408,0.714285714,0.693877551,1629
bd3158b8440dde1339218475241b832b324adc9b,1,Henry Robinson,2014-01-08 10:52:58-08:00,['6a1cc58936306536251ab06789aa709cefd1adf7'],32,249,281,2287820,5,0.458715596,0.743119266,0.944954128,1630
c81da1099431decafd431471f3cd4027354f293f,0,Henry Robinson,2014-01-08 10:52:58-08:00,['bd3158b8440dde1339218475241b832b324adc9b'],0,45,45,2287865,4,0,1,1,1630
e78ef0a92502d7376a4c1fb578f2e7b499f0fadd,1,Henry Robinson,2014-01-08 10:52:59-08:00,['c81da1099431decafd431471f3cd4027354f293f'],9,9,18,2287883,1,1,1,0,1630
74ddecf30cd36e2f45546f9ee4939df02044ec75,1,Henry Robinson,2014-01-08 10:52:59-08:00,['e78ef0a92502d7376a4c1fb578f2e7b499f0fadd'],27,46,73,2287956,6,1,0,0.857142857,1630
e39de943162af93f59f366ba42b6da7aa2f0c2aa,1,Henry Robinson,2014-01-08 10:52:59-08:00,['74ddecf30cd36e2f45546f9ee4939df02044ec75'],488,1273,1761,2289717,39,0.421052632,0.657894737,0.847953216,1635
f3e4df14ac545575823c1028d6ccec4f6521ab78,0,Henry Robinson,2014-01-08 10:53:00-08:00,['e39de943162af93f59f366ba42b6da7aa2f0c2aa'],64,89,153,2289870,39,,,,1636
b9bc9a9e899e0e1ee82a167fd52d4f550915a1da,1,Henry Robinson,2014-01-08 10:53:00-08:00,['f3e4df14ac545575823c1028d6ccec4f6521ab78'],60,341,401,2290271,15,0.134020619,1,0.865979381,1639
41c88219ab224fbaefa7a79b9b477d58c7fde987,0,Henry Robinson,2014-01-08 10:53:00-08:00,['b9bc9a9e899e0e1ee82a167fd52d4f550915a1da'],1,1,2,2290273,1,,,,1639
8cee9fa13883ecf1108336a9506581ce2339c547,1,Henry Robinson,2014-01-08 10:53:01-08:00,['41c88219ab224fbaefa7a79b9b477d58c7fde987'],4,3,7,2290280,1,0,0,0,1639
93bece32ae6ecb7e408d4b7be7fd2819708883d9,1,Henry Robinson,2014-01-08 10:53:01-08:00,['8cee9fa13883ecf1108336a9506581ce2339c547'],209,215,424,2290704,16,0,1,0.8,1639
8963d79f510428968fd70d4133c68c94aa0416c2,0,Henry Robinson,2014-01-08 10:53:01-08:00,['93bece32ae6ecb7e408d4b7be7fd2819708883d9'],10,10,20,2290724,1,,,,1639
c0129a1683ad69c4b5f06bf498dc93524407b804,1,Henry Robinson,2014-01-08 10:53:02-08:00,['8963d79f510428968fd70d4133c68c94aa0416c2'],20,46,66,2290790,2,0,0.411764706,1,1639
3dfdbd88d9c2b5f088a15523b42edcf091867014,1,Henry Robinson,2014-01-08 10:53:02-08:00,['c0129a1683ad69c4b5f06bf498dc93524407b804'],4,22,26,2290816,1,1,1,1,1639
beea7d3d10b6b5ac84eb8936273485b3a0fc37b3,0,Henry Robinson,2014-01-08 10:53:02-08:00,['3dfdbd88d9c2b5f088a15523b42edcf091867014'],1,2,3,2290819,1,,,,1639
e4a24c8c1dbcab917ad585c63ccc9d907075b682,1,Henry Robinson,2014-01-08 10:53:03-08:00,['beea7d3d10b6b5ac84eb8936273485b3a0fc37b3'],7,31,38,2290857,2,0,1,0.058823529,1639
e5ed8e4105eb040989dd6c8e15a41b8ce1027033,0,Henry Robinson,2014-01-08 10:53:03-08:00,['e4a24c8c1dbcab917ad585c63ccc9d907075b682'],3,5,8,2290865,3,1,0,0,1639
b7f83bcd730be49e4bae3c66726e1d459ad75bd9,1,Henry Robinson,2014-01-08 10:53:03-08:00,['e5ed8e4105eb040989dd6c8e15a41b8ce1027033'],272,924,1196,2292061,26,0.616438356,0.730593607,0.716894977,1645
68e8470ae3438b451781aac1f68f96d2d08e91b5,1,Henry Robinson,2014-01-08 10:53:04-08:00,['b7f83bcd730be49e4bae3c66726e1d459ad75bd9'],156,357,513,2292574,20,0.367816092,0.517241379,0.885057471,1647
43eed3365c96148866c7e3c50913e271ca49d320,1,Henry Robinson,2014-01-08 10:53:04-08:00,['68e8470ae3438b451781aac1f68f96d2d08e91b5'],206,284,490,2293064,25,1,0,0,1651
b93b15f10ff9f5cdcd629d2a5ed6dbd2cdb64681,0,Henry Robinson,2014-01-08 10:53:05-08:00,['43eed3365c96148866c7e3c50913e271ca49d320'],11,54,65,2293129,4,1,1,1,1651
8e553a8a2eb9af5298b64f4fd6910beed70299d1,0,Henry Robinson,2014-01-08 10:53:05-08:00,['b93b15f10ff9f5cdcd629d2a5ed6dbd2cdb64681'],0,23,23,2293152,1,0.857142857,1,0.428571429,1651
4bb1e8c8541630811938dba6655fc76de50f15ec,1,Henry Robinson,2014-01-08 10:53:05-08:00,['8e553a8a2eb9af5298b64f4fd6910beed70299d1'],164,534,698,2293850,24,0.216346154,0.524038462,0.956730769,1652
e959e49b7cd125b04bc4ca0c485e97009d1df250,1,Henry Robinson,2014-01-08 10:53:06-08:00,['4bb1e8c8541630811938dba6655fc76de50f15ec'],53,203,256,2294106,14,0.630434783,0.130434783,0.956521739,1654
4b29b54d76fcd13e2364253dd53da724c1dfb827,0,Henry Robinson,2014-01-08 10:53:06-08:00,['e959e49b7cd125b04bc4ca0c485e97009d1df250'],7,19,26,2294132,2,0,0,0.7,1654
e4786f08fe2b35eaf8857f8d3a084ceb045f6418,0,Henry Robinson,2014-01-08 10:53:06-08:00,['4b29b54d76fcd13e2364253dd53da724c1dfb827'],1,2,3,2294135,1,,,,1654
dc055c57ffee7869d08d5f89df8f492b0b056bc9,0,Henry Robinson,2014-01-08 10:53:07-08:00,['e4786f08fe2b35eaf8857f8d3a084ceb045f6418'],11,260,271,2294406,5,0.370558376,0.954314721,0.954314721,1654
565d15579c5940cb32edd7ccf0f7f5cadc9a1af2,1,Henry Robinson,2014-01-08 10:53:07-08:00,['dc055c57ffee7869d08d5f89df8f492b0b056bc9'],304,476,780,2295186,8,1,1,1,1655
ba7c7642792e710152928ecf4495c04f7f5eba09,0,Henry Robinson,2014-01-08 10:53:07-08:00,['565d15579c5940cb32edd7ccf0f7f5cadc9a1af2'],44,234,278,2295464,4,0,0.112,1,1655
a33c795de3f5cea1059a62ee0968d4eab15ddb22,0,Henry Robinson,2014-01-08 10:53:08-08:00,['ba7c7642792e710152928ecf4495c04f7f5eba09'],39,38,77,2295541,1,1,1,1,1655
9065648d7760a91adc94cc72c17dad80bba53126,1,Henry Robinson,2014-01-08 10:53:08-08:00,['a33c795de3f5cea1059a62ee0968d4eab15ddb22'],203,315,518,2296059,19,0,0.204819277,1,1655
3a388eb4616517d6745613160a4a237d5287fff4,0,Henry Robinson,2014-01-08 10:53:08-08:00,['9065648d7760a91adc94cc72c17dad80bba53126'],9,25,34,2296093,2,0,1,1,1655
ee42aa8d36542f686eb3060b6ff1f9b522d6e505,0,Henry Robinson,2014-01-08 10:53:09-08:00,['3a388eb4616517d6745613160a4a237d5287fff4'],5,13,18,2296111,3,1,1,0.5,1655
1eb2b7a96466cc77aa2f5745b2cef4c814b7b557,1,Henry Robinson,2014-01-08 10:53:09-08:00,['ee42aa8d36542f686eb3060b6ff1f9b522d6e505'],34,237,271,2296382,12,0.184210526,0.065789474,0.684210526,1655
e5ea52444848d8db1286a18b8169caf0007ea086,0,Henry Robinson,2014-01-08 10:53:09-08:00,['1eb2b7a96466cc77aa2f5745b2cef4c814b7b557'],25,9,34,2296416,2,1,0.166666667,0,1655
78539ee53126c74e2d11f704694180553abb679e,1,Henry Robinson,2014-01-08 10:53:10-08:00,['e5ea52444848d8db1286a18b8169caf0007ea086'],1,4,5,2296421,1,1,1,1,1655
f3b5f9d5d80ec057cf9ad309a68a6627f64059c9,0,Henry Robinson,2014-01-08 10:53:10-08:00,['78539ee53126c74e2d11f704694180553abb679e'],0,0,0,2296421,0,,,,1655
a2cbd2820e956e63005385b7e725c6cbc7c45501,1,Henry Robinson,2014-01-08 10:53:11-08:00,['f3b5f9d5d80ec057cf9ad309a68a6627f64059c9'],2207,4986,7193,2303614,113,0.423162584,0.681514477,0.968819599,1672
5a97258c1abfbe60c599859cbb64b27669849f55,1,Henry Robinson,2014-01-08 10:53:11-08:00,['a2cbd2820e956e63005385b7e725c6cbc7c45501'],42,70,112,2303726,7,0.555555556,1,0.555555556,1672
6e8741aafd6f01db8b94ad60e63eb217a46857ac,0,Henry Robinson,2014-01-08 10:53:12-08:00,['5a97258c1abfbe60c599859cbb64b27669849f55'],0,14,14,2303740,3,0,0.5,1,1672
aa530ce11de34ec9366fea7dbec6c6910224c13f,0,Henry Robinson,2014-01-08 10:53:12-08:00,['6e8741aafd6f01db8b94ad60e63eb217a46857ac'],1,3,4,2303744,1,,,,1672
bf139d1ebaa803958e4afd3a59dcfe105beee850,1,Henry Robinson,2014-01-08 10:53:12-08:00,['aa530ce11de34ec9366fea7dbec6c6910224c13f'],55,80,135,2303879,11,1,0.777777778,0.333333333,1673
656ae8b1c8c54a97c975e93e1270f73b055e85b8,1,Henry Robinson,2014-01-08 10:53:13-08:00,['bf139d1ebaa803958e4afd3a59dcfe105beee850'],10,39,49,2303928,7,0,0.55,0.65,1673
0b2bebdfd13139dac2fa51bf443058fc0b0aabe0,0,Henry Robinson,2014-01-08 10:53:13-08:00,['656ae8b1c8c54a97c975e93e1270f73b055e85b8'],9,25,34,2303962,2,0,0.833333333,1,1673
15db34e356a3fee3afa1742083dd9377da012f9a,1,Henry Robinson,2014-01-08 10:53:13-08:00,['0b2bebdfd13139dac2fa51bf443058fc0b0aabe0'],3278,4210,7488,2311450,58,0.788359788,1,1,1681
49c07abce3603cbc09f2aa20329f206c43d77d47,0,Henry Robinson,2014-01-08 10:53:14-08:00,['15db34e356a3fee3afa1742083dd9377da012f9a'],1,4,5,2311455,1,0,1,1,1681
c868350fbd75b4caeaedbf79ea8947d5fa36ed86,1,Henry Robinson,2014-01-08 10:53:14-08:00,['49c07abce3603cbc09f2aa20329f206c43d77d47'],0,99,99,2311554,5,0.739130435,1,0.913043478,1683
92829b840010623b4ffb7c052b43cdda85e9134f,0,Henry Robinson,2014-01-08 10:53:14-08:00,['c868350fbd75b4caeaedbf79ea8947d5fa36ed86'],64,134,198,2311752,8,0.25,0,0.8,1683
6981f33b11deede0396395a58108c75968705466,0,Henry Robinson,2014-01-08 10:53:15-08:00,['92829b840010623b4ffb7c052b43cdda85e9134f'],0,0,0,2311752,0,,,,1683
b07a3ccfd6fff46bbc4ca55d04d1ccdf406034f6,0,Henry Robinson,2014-01-08 10:53:15-08:00,['6981f33b11deede0396395a58108c75968705466'],78,31,109,2311861,6,0.675675676,0,0,1683
9425ad1e14ae387b2e7660818d99b1c1c0496563,0,Henry Robinson,2014-01-08 10:53:15-08:00,['b07a3ccfd6fff46bbc4ca55d04d1ccdf406034f6'],2,6,8,2311869,1,0,0,0,1683
dd6736b74d3a53a233a68d1a908a63d965960abb,0,Henry Robinson,2014-01-08 10:53:16-08:00,['9425ad1e14ae387b2e7660818d99b1c1c0496563'],2,2,4,2311873,1,,,,1683
1621d2705384baf4cc5005dd8cf983771d02565b,1,Henry Robinson,2014-01-08 10:53:16-08:00,['dd6736b74d3a53a233a68d1a908a63d965960abb'],128,306,434,2312307,8,0,0.949152542,0.220338983,1683
13605ad834d8a5a4577c413fb0ba3dc0ebbd1de2,1,Henry Robinson,2014-01-08 10:53:16-08:00,['1621d2705384baf4cc5005dd8cf983771d02565b'],16,47,63,2312370,3,0,0.555555556,0.888888889,1683
8a434268795ffd2b5f1ac91fa9a7a65b9016e231,0,Henry Robinson,2014-01-08 10:53:17-08:00,['13605ad834d8a5a4577c413fb0ba3dc0ebbd1de2'],1,2,3,2312373,1,,,,1683
c031cd4e960f2aae2d13b04050cf9b7e4fc5938b,1,Henry Robinson,2014-01-08 10:53:17-08:00,['8a434268795ffd2b5f1ac91fa9a7a65b9016e231'],24,36,60,2312433,3,0,0.25,1,1683
971a9f959ce344eddf7a6d24f736078c185ddf2e,0,Henry Robinson,2014-01-08 10:53:17-08:00,['c031cd4e960f2aae2d13b04050cf9b7e4fc5938b'],1,5,6,2312439,1,0,0,1,1683
56d9b62edd531d99f3aedb1bd0ab258b11287a16,0,Henry Robinson,2014-01-08 10:53:18-08:00,['971a9f959ce344eddf7a6d24f736078c185ddf2e'],0,0,0,2312439,0,,,,1683
790d7ecf88fafbd7b8a0b0034199ea7924a2b262,0,Henry Robinson,2014-01-08 10:53:18-08:00,['56d9b62edd531d99f3aedb1bd0ab258b11287a16'],1,8,9,2312448,1,,,,1683
b9ac04e3f32b7945c9c588cb81deca6730a1e6f6,1,Henry Robinson,2014-01-08 10:53:19-08:00,['790d7ecf88fafbd7b8a0b0034199ea7924a2b262'],80,383,463,2312911,15,0.317365269,0.359281437,0.784431138,1685
92fa5241cd3cebea64e0b68057b264b567107d1e,0,Henry Robinson,2014-01-08 10:53:19-08:00,['b9ac04e3f32b7945c9c588cb81deca6730a1e6f6'],9,17,26,2312937,2,0,1,1,1685
41ae589a261ecc24ef6c910bf4245335982ca112,1,Henry Robinson,2014-01-08 10:53:19-08:00,['92fa5241cd3cebea64e0b68057b264b567107d1e'],28,54,82,2313019,5,0.066666667,0,1,1685
6b9a7de02e8ea512e5048d5dd24f5e5469b8143b,1,Henry Robinson,2014-01-08 10:53:20-08:00,['41ae589a261ecc24ef6c910bf4245335982ca112'],189,1371,1560,2314579,32,0.265474553,0.687757909,0.661623109,1690
a5096cb150f5f45590fb8377b82bd59f985eec43,0,Henry Robinson,2014-01-08 10:53:20-08:00,['6b9a7de02e8ea512e5048d5dd24f5e5469b8143b'],6,9,15,2314594,1,1,1,1,1690
716cbe75428a28dc868cf609c1105601b129177a,0,Henry Robinson,2014-01-08 10:53:20-08:00,['a5096cb150f5f45590fb8377b82bd59f985eec43'],1,2,3,2314597,1,,,,1690
83f196eae6107748b7abb4e38566dbabf37e546c,1,Henry Robinson,2014-01-08 10:53:21-08:00,['716cbe75428a28dc868cf609c1105601b129177a'],88,86,174,2314771,22,0.5,1,1,1690
31ea219bb400ac6d9e8c7a4ac440490bfdd60498,1,Henry Robinson,2014-01-08 10:53:21-08:00,['83f196eae6107748b7abb4e38566dbabf37e546c'],48,73,121,2314892,5,1,0.888888889,1,1690
8692e7df8dc25c77f10e306c2970a884c4d912c1,1,Henry Robinson,2014-01-08 10:53:21-08:00,['31ea219bb400ac6d9e8c7a4ac440490bfdd60498'],162,249,411,2315303,16,0,0.391304348,1,1690
6c2320fe9653b6e485ff9c95f6bbdbafb413794e,0,Henry Robinson,2014-01-08 10:53:22-08:00,['8692e7df8dc25c77f10e306c2970a884c4d912c1'],4,5,9,2315312,2,0,1,1,1690
4bb8b38cde02e11978fa5e9b048cbc5f091b7336,1,Henry Robinson,2014-01-08 10:53:22-08:00,['6c2320fe9653b6e485ff9c95f6bbdbafb413794e'],991,8648,9639,2324951,37,0.151162791,0,0.604651163,1692
c5c2ccb56cc94e5199a6226e0e45531132654e80,0,Henry Robinson,2014-01-08 10:53:22-08:00,['4bb8b38cde02e11978fa5e9b048cbc5f091b7336'],5,2,7,2324958,1,,,,1692
01f7231b3b306b301c0a9993f03280dbda253093,1,Henry Robinson,2014-01-08 10:53:23-08:00,['c5c2ccb56cc94e5199a6226e0e45531132654e80'],135,160,295,2325253,20,1,1,0.666666667,1692
3f54240fed50abbb4f0cd7f32d9f848393e0cbc0,1,Henry Robinson,2014-01-08 10:53:23-08:00,['01f7231b3b306b301c0a9993f03280dbda253093'],9934,96,10030,2335283,26,0,0,0.875,1692
24116169ad3e7c128965ca7eedd0a961748d1b60,0,Henry Robinson,2014-01-08 10:53:23-08:00,['3f54240fed50abbb4f0cd7f32d9f848393e0cbc0'],3,4,7,2335290,2,1,1,1,1692
7f9b16c24122e9e44aa13abac55dc36d393012bd,1,Henry Robinson,2014-01-08 10:53:24-08:00,['24116169ad3e7c128965ca7eedd0a961748d1b60'],17,103,120,2335410,5,0.680851064,0.723404255,0.957446809,1692
904289d1687fb9a73bd74325fd4bb70ea39da2f3,1,Henry Robinson,2014-01-08 10:53:24-08:00,['7f9b16c24122e9e44aa13abac55dc36d393012bd'],25,156,181,2335591,8,0.028169014,0.056338028,0.661971831,1693
4800995d440f0966cf57c448c367e45ee54ece32,1,Henry Robinson,2014-01-08 10:53:25-08:00,['904289d1687fb9a73bd74325fd4bb70ea39da2f3'],51,2145,2196,2337787,32,0.336394948,0.498277842,0.786452354,1712
0cb16863ee39fbeaa5a936cb448568fe16254e17,0,Henry Robinson,2014-01-08 10:53:25-08:00,['4800995d440f0966cf57c448c367e45ee54ece32'],5,13,18,2337805,3,0.5,0,0,1712
3ad10e4459cab77dd8a68a99fb295358e45a06a4,0,Henry Robinson,2014-01-08 10:53:25-08:00,['0cb16863ee39fbeaa5a936cb448568fe16254e17'],0,1,1,2337806,1,1,1,1,1712
f15a5a3135a59d0c5b643c178cae6cf079286eed,1,Henry Robinson,2014-01-08 10:53:26-08:00,['3ad10e4459cab77dd8a68a99fb295358e45a06a4'],52,189,241,2338047,35,0,0.839506173,0.987654321,1712
72e211ca4a7d06ba1bc8ab808831aed0996e6f3a,0,Henry Robinson,2014-01-08 10:53:26-08:00,['f15a5a3135a59d0c5b643c178cae6cf079286eed'],18,12,30,2338077,4,,,,1712
911cfc1bb94395066a0bf5c138c095d97dadde0e,1,Henry Robinson,2014-01-08 10:53:26-08:00,['72e211ca4a7d06ba1bc8ab808831aed0996e6f3a'],15,134,149,2338226,7,0.389830508,0.389830508,0.372881356,1712
80b4a3b306ed9d6e71e2ce8867d6373cb9537bd0,1,Henry Robinson,2014-01-08 10:53:27-08:00,['911cfc1bb94395066a0bf5c138c095d97dadde0e'],4,34,38,2338264,3,0.84,0,0.84,1712
b41ff0c8cd4bff079dfaf29c860f48ae7ce7ae2a,0,Henry Robinson,2014-01-08 10:53:27-08:00,['80b4a3b306ed9d6e71e2ce8867d6373cb9537bd0'],16,8,24,2338288,4,1,1,1,1712
6d5fc03f303f6cf1badaa61e95198f88fb6006cf,0,Henry Robinson,2014-01-08 10:53:27-08:00,['b41ff0c8cd4bff079dfaf29c860f48ae7ce7ae2a'],3,9,12,2338300,5,0.75,1,0.5,1712
36f9c765dee1514c96528a9673251d7c6ff3d8bf,1,Henry Robinson,2014-01-08 10:53:28-08:00,['6d5fc03f303f6cf1badaa61e95198f88fb6006cf'],1,57,58,2338358,4,1,1,1,1714
1d460474afd2cd07ce7baa18af421ca21ed2254a,1,Henry Robinson,2014-01-08 10:53:28-08:00,['36f9c765dee1514c96528a9673251d7c6ff3d8bf'],6,250,256,2338614,5,0.695035461,1,0.730496454,1715
42a9d6c92e248d5c9cc0ba8df44ca5d41e04a383,1,Henry Robinson,2014-01-08 10:53:28-08:00,['1d460474afd2cd07ce7baa18af421ca21ed2254a'],1,4,5,2338619,1,1,1,1,1715
b82880738cc4078fcf6147e7ce072eda5ea023d8,1,Henry Robinson,2014-01-08 10:53:29-08:00,['42a9d6c92e248d5c9cc0ba8df44ca5d41e04a383'],4,19,23,2338642,2,,,,1715
01c8c43fec76f99e78d722d44b83e7ee8189ebfd,1,Henry Robinson,2014-01-08 10:53:29-08:00,['b82880738cc4078fcf6147e7ce072eda5ea023d8'],15,52,67,2338709,3,0,0,0,1715
029aaf6c5a330f89e3313d6af7ea1c807844a9e7,0,Henry Robinson,2014-01-08 10:53:29-08:00,['01c8c43fec76f99e78d722d44b83e7ee8189ebfd'],15,27,42,2338751,2,0.2,0,0.866666667,1715
a4c7f24877ce49a1df8d23097930be48a9bcde3c,1,Henry Robinson,2014-01-08 10:53:30-08:00,['029aaf6c5a330f89e3313d6af7ea1c807844a9e7'],41,127,168,2338919,19,0.810344828,0.896551724,0.879310345,1715
f09c416f1205ab8afa72722fd5babfb8f401353d,1,Henry Robinson,2014-01-08 10:53:30-08:00,['a4c7f24877ce49a1df8d23097930be48a9bcde3c'],46,132,178,2339097,4,0.035714286,0.964285714,1,1715
7ffa7ea343b775712c6030076258595f15e4f105,1,Henry Robinson,2014-01-08 10:53:30-08:00,['f09c416f1205ab8afa72722fd5babfb8f401353d'],26,49,75,2339172,2,0.071428571,0,0,1715
93ee6f54304ec5d72899f1cbb4dc0a8ca5e10a38,0,Henry Robinson,2014-01-08 10:53:31-08:00,['7ffa7ea343b775712c6030076258595f15e4f105'],8,16,24,2339196,2,0.875,0.875,0.875,1715
4dfe735028e8cb28d79d5614ae3110c02d59950f,1,Henry Robinson,2014-01-08 10:53:31-08:00,['93ee6f54304ec5d72899f1cbb4dc0a8ca5e10a38'],56,57,113,2339309,5,0,1,1,1715
f2d9c4c122a862ddd56f2e0391ce2e529e14659c,1,Henry Robinson,2014-01-08 10:53:31-08:00,['4dfe735028e8cb28d79d5614ae3110c02d59950f'],5,27,32,2339341,4,0.714285714,1,0.857142857,1715
535e6a62d4071c85253dc8a437e3c7c36b2b7ee4,0,Henry Robinson,2014-01-08 10:53:32-08:00,['f2d9c4c122a862ddd56f2e0391ce2e529e14659c'],13,21,34,2339375,13,0.4375,0,1,1715
b0a65869ae480af1cc43fd71751141ba930a7965,1,Henry Robinson,2014-01-08 10:53:32-08:00,['535e6a62d4071c85253dc8a437e3c7c36b2b7ee4'],3,49,52,2339427,5,1,1,1,1716
21d3669c1064e0bbc1f1a498c47d04d95a44324a,1,Henry Robinson,2014-01-08 10:53:32-08:00,['b0a65869ae480af1cc43fd71751141ba930a7965'],260,265,525,2339952,6,0,0,,1718
1eea99c21f90b926e2ce622088b9b0059930cf56,1,Henry Robinson,2014-01-08 10:53:33-08:00,['21d3669c1064e0bbc1f1a498c47d04d95a44324a'],0,20,20,2339972,1,0.857142857,1,0.857142857,1718
34ccec86267bec5f8df4bf647186ef8daafe7fa4,1,Henry Robinson,2014-01-08 10:53:33-08:00,['1eea99c21f90b926e2ce622088b9b0059930cf56'],99,230,329,2340301,6,0.323943662,0.633802817,0.521126761,1718
51e914e911194d13c758ce24a4d5aaf47a4b045f,0,Henry Robinson,2014-01-08 10:53:33-08:00,['34ccec86267bec5f8df4bf647186ef8daafe7fa4'],4,4,8,2340309,2,,,,1718
dfd24852fd3a9499f670b5837da8ef30436adc1d,0,Henry Robinson,2014-01-08 10:53:34-08:00,['51e914e911194d13c758ce24a4d5aaf47a4b045f'],8,0,8,2340317,1,1,1,0,1718
6576be957a9e4c1a450ce0808a0b3d822a065bf5,1,Henry Robinson,2014-01-08 10:53:34-08:00,['dfd24852fd3a9499f670b5837da8ef30436adc1d'],51,190,241,2340558,8,0.042253521,0.042253521,0.929577465,1718
97f4fadf1ffc23f2ca655f7f455961db9071fef8,0,Henry Robinson,2014-01-08 10:53:34-08:00,['6576be957a9e4c1a450ce0808a0b3d822a065bf5'],1,9,10,2340568,2,0,0.875,0.875,1718
b670b9f4f93f8842c58422e457b4fd2ad035216f,0,Henry Robinson,2014-01-08 10:53:35-08:00,['97f4fadf1ffc23f2ca655f7f455961db9071fef8'],6,6,12,2340580,1,,,,1718
1d6fb3e41ba5d9c78bdaa42c8ba13c00672f4c03,1,Henry Robinson,2014-01-08 10:53:35-08:00,['b670b9f4f93f8842c58422e457b4fd2ad035216f'],152,182,334,2340914,9,0,1,1,1718
30bd4b842128b6538b003fabae9ff12b016ebc1a,1,Henry Robinson,2014-01-08 10:53:35-08:00,['1d6fb3e41ba5d9c78bdaa42c8ba13c00672f4c03'],8,17,25,2340939,1,0,1,1,1718
09d3afe0321742721186f201ac8bbd274ef49233,1,Henry Robinson,2014-01-08 10:53:36-08:00,['30bd4b842128b6538b003fabae9ff12b016ebc1a'],3,8,11,2340950,2,1,1,1,1718
a944a1fe52dcc462b12e6951a57028c22a245751,1,Henry Robinson,2014-01-08 10:53:36-08:00,['09d3afe0321742721186f201ac8bbd274ef49233'],4,100,104,2341054,5,0.333333333,0.333333333,1,1718
07c2aabf97df8b6a2673aacadb7103b915342f03,0,Henry Robinson,2014-01-08 10:53:36-08:00,['a944a1fe52dcc462b12e6951a57028c22a245751'],4,13,17,2341071,2,1,1,0,1718
8b2acf5c222c25cbca162c3974e2af4d2a59c1b9,1,Henry Robinson,2014-01-08 10:53:37-08:00,['07c2aabf97df8b6a2673aacadb7103b915342f03'],31,355,386,2341457,11,0.533783784,0.452702703,0.831081081,1721
a4883480901928105da383ae05897a9942117482,1,Henry Robinson,2014-01-08 10:53:37-08:00,['8b2acf5c222c25cbca162c3974e2af4d2a59c1b9'],1,3,4,2341461,1,0,0,1,1721
89a0beb56a91b3e1b0f1bbfb77ab1d1a54e1d0b0,1,Henry Robinson,2014-01-08 10:53:37-08:00,['a4883480901928105da383ae05897a9942117482'],112,159,271,2341732,20,0.206896552,0,1,1721
babb2dfa72e2097a13986e8de640c698ab7d5b97,1,Henry Robinson,2014-01-08 10:53:38-08:00,['89a0beb56a91b3e1b0f1bbfb77ab1d1a54e1d0b0'],48,261,309,2342041,3,0.453900709,0.638297872,0.432624113,1721
601f24a198817bb69e158cd3683ee16807a60513,1,Henry Robinson,2014-01-08 10:53:38-08:00,['babb2dfa72e2097a13986e8de640c698ab7d5b97'],394,434,828,2342869,30,0.133333333,0,0.35,1721
af6d381401ae53cb39c7d1d125793ab2f9bce361,1,Henry Robinson,2014-01-08 10:53:39-08:00,['601f24a198817bb69e158cd3683ee16807a60513'],88,195,283,2343152,10,0.035294118,0,1,1723
97a6b12e374281823d7f0fe8b3b3bff026de5902,0,Henry Robinson,2014-01-08 10:53:39-08:00,['af6d381401ae53cb39c7d1d125793ab2f9bce361'],11,48,59,2343211,5,0.1,0.2,0.9,1723
7e8e184acf588e34a9994a7e049918cbe62d3ce8,1,Henry Robinson,2014-01-08 10:53:39-08:00,['97a6b12e374281823d7f0fe8b3b3bff026de5902'],200,288,488,2343699,14,0,0,0.95,1723
0aa120adcae3a898b04e5d7510a60a6cee51b956,0,Henry Robinson,2014-01-08 10:53:40-08:00,['7e8e184acf588e34a9994a7e049918cbe62d3ce8'],78,157,235,2343934,1,,,,1723
f02293bf5f72f02875d62a5e2e47276dc43ec761,0,Henry Robinson,2014-01-08 10:53:40-08:00,['0aa120adcae3a898b04e5d7510a60a6cee51b956'],1,1,2,2343936,1,,,,1723
bb1f48588ddee7a51096e916299cdc355d3c139c,0,Henry Robinson,2014-01-08 10:53:41-08:00,['f02293bf5f72f02875d62a5e2e47276dc43ec761'],2,2,4,2343940,1,,,,1723
b1867529deb54c561d43daab25142c5070a7d850,0,Henry Robinson,2014-01-08 10:53:41-08:00,['bb1f48588ddee7a51096e916299cdc355d3c139c'],1,1,2,2343942,1,,,,1723
f861a4291a7cb3a6fcf55f079afd49cf9c6accdf,1,Henry Robinson,2014-01-08 10:53:42-08:00,['b1867529deb54c561d43daab25142c5070a7d850'],16,11,27,2343969,3,1,1,0,1723
9d5b94baa5635e01239469f9cdb53bdd0adc0357,1,Henry Robinson,2014-01-08 10:53:42-08:00,['f861a4291a7cb3a6fcf55f079afd49cf9c6accdf'],708,773,1481,2345450,46,0.217391304,1,0.913043478,1725
4749084b6cb0e793dc73231c0996e91fbb221da6,0,Henry Robinson,2014-01-08 10:53:42-08:00,['9d5b94baa5635e01239469f9cdb53bdd0adc0357'],2,5,7,2345457,1,1,1,1,1725
e0f60e16588f18cd40782960efcdcd326d73fce8,1,Henry Robinson,2014-01-08 10:53:43-08:00,['4749084b6cb0e793dc73231c0996e91fbb221da6'],2,26,28,2345485,1,1,1,1,1725
f238f5fdcf4cb76286fdae96718f0fcb696156d6,1,Henry Robinson,2014-01-08 10:53:43-08:00,['e0f60e16588f18cd40782960efcdcd326d73fce8'],242,485,727,2346212,26,0.907692308,0.861538462,0.938461538,1727
8ea9811f503bf88708ff4c3696e1ff2cf6c9cb6f,0,Henry Robinson,2014-01-08 10:53:43-08:00,['f238f5fdcf4cb76286fdae96718f0fcb696156d6'],2,2,4,2346216,1,,,,1727
18fa2a5a69d3fff48bdaf1d93d3efb92f69091b0,0,Henry Robinson,2014-01-08 10:53:44-08:00,['8ea9811f503bf88708ff4c3696e1ff2cf6c9cb6f'],0,9,9,2346225,1,1,1,1,1727
1ad26f77f6ced8a5f4d8f54a4322ea6966bd7b0d,0,Henry Robinson,2014-01-08 10:53:44-08:00,['18fa2a5a69d3fff48bdaf1d93d3efb92f69091b0'],12,11,23,2346248,3,,,,1727
fc7733d53049d96b0a93dd7390713293a5a00b59,1,Henry Robinson,2014-01-08 10:53:44-08:00,['1ad26f77f6ced8a5f4d8f54a4322ea6966bd7b0d'],59,65,124,2346372,9,1,0,,1727
939db2dc060121f4a27470b8a5122b90a48a07af,1,Henry Robinson,2014-01-08 10:53:45-08:00,['fc7733d53049d96b0a93dd7390713293a5a00b59'],7,30,37,2346409,3,0.8,1,0,1727
d698881f71bba0f0c9c3860ac8c76753d0390977,1,Henry Robinson,2014-01-08 10:53:46-08:00,['939db2dc060121f4a27470b8a5122b90a48a07af'],30,35,65,2346474,9,0.833333333,1,1,1727
8218c19528a461088a0d45a409d6377776a2ef34,0,Henry Robinson,2014-01-08 10:53:46-08:00,['d698881f71bba0f0c9c3860ac8c76753d0390977'],2,8,10,2346484,1,0,0,1,1727
927c486e0c55cde15e73efdebac3cd59f1e5c649,0,Henry Robinson,2014-01-08 10:53:46-08:00,['8218c19528a461088a0d45a409d6377776a2ef34'],1,1,2,2346486,1,,,,1727
9d05d6d03a4acd154cf63d36cf89c502a0e6158a,1,Henry Robinson,2014-01-08 10:53:47-08:00,['927c486e0c55cde15e73efdebac3cd59f1e5c649'],288,215,503,2346989,6,1,1,0.375,1727
8bdf8d4a1789770f18f385897bd03f4b8b87aac8,0,Henry Robinson,2014-01-08 10:53:47-08:00,['9d05d6d03a4acd154cf63d36cf89c502a0e6158a'],10,35,45,2347034,2,0,1,1,1727
7aa3d6ee6bb66c306c9738ce6b5ea4c3f665e41b,1,Henry Robinson,2014-01-08 10:53:47-08:00,['8bdf8d4a1789770f18f385897bd03f4b8b87aac8'],0,5,5,2347039,1,1,1,1,1727
1f92f36080484fa97a86c4b0d1c13a083a5763ec,0,Henry Robinson,2014-01-08 10:53:48-08:00,['7aa3d6ee6bb66c306c9738ce6b5ea4c3f665e41b'],1,1,2,2347041,1,,,,1727
65353fd9fb5b60b070d8352043d38145003950fe,1,Henry Robinson,2014-01-08 10:53:48-08:00,['1f92f36080484fa97a86c4b0d1c13a083a5763ec'],104,383,487,2347528,18,0.209876543,0.617283951,0.679012346,1727
7951ef58237d8fde41522221f9b9bd285da5ebf3,0,Henry Robinson,2014-01-08 10:53:48-08:00,['65353fd9fb5b60b070d8352043d38145003950fe'],36,49,85,2347613,9,0.416666667,0.75,0.75,1727
f6f8d9d19d9eb584e7e291cf0bc177ef631d851f,0,Henry Robinson,2014-01-08 10:53:49-08:00,['7951ef58237d8fde41522221f9b9bd285da5ebf3'],16,9,25,2347638,3,0,0,0,1727
00bc971d34c735b26272a3059fdd78e1f92d29d9,1,Henry Robinson,2014-01-08 10:53:49-08:00,['f6f8d9d19d9eb584e7e291cf0bc177ef631d851f'],121,233,354,2347992,11,0.070175439,0.368421053,1,1727
6b4591d5fc86cafcd139da077b45410c9a8ef3a7,0,Henry Robinson,2014-01-08 10:53:50-08:00,['00bc971d34c735b26272a3059fdd78e1f92d29d9'],7,10,17,2348009,2,,,,1727
498c2529d4e7ad874708c68b6a26b131e46d033e,0,Henry Robinson,2014-01-08 10:53:50-08:00,['6b4591d5fc86cafcd139da077b45410c9a8ef3a7'],0,1,1,2348010,1,,,,1727
77e6430811ddcc421d4dbd886fdab1dd9f2320d2,0,Henry Robinson,2014-01-08 10:53:50-08:00,['498c2529d4e7ad874708c68b6a26b131e46d033e'],0,4,4,2348014,1,,,,1727
130e93a8cce1de23b84a55c6158909cbb4bcbb0d,1,Henry Robinson,2014-01-08 10:53:51-08:00,['77e6430811ddcc421d4dbd886fdab1dd9f2320d2'],14,103,117,2348131,12,1,1,1,1729
1497002013f40dd0c3eac72e200e302e157a8c24,1,Henry Robinson,2014-01-08 10:53:51-08:00,['130e93a8cce1de23b84a55c6158909cbb4bcbb0d'],528,1328,1856,2349987,52,0.342857143,0.831168831,0.745454545,1731
7c8cdaad5c0e40a397ce1c7844965ac19582688b,1,Henry Robinson,2014-01-08 10:53:51-08:00,['1497002013f40dd0c3eac72e200e302e157a8c24'],10,142,152,2350139,8,0.428571429,0.976190476,1,1733
2336ed99a498fd082ed2ed6717e6e779e4597ed7,1,Henry Robinson,2014-01-08 10:53:52-08:00,['7c8cdaad5c0e40a397ce1c7844965ac19582688b'],31,71,102,2350241,5,0.090909091,1,1,1733
b17bc4514837cbf6ed7b033917189b65832052bb,0,Henry Robinson,2014-01-08 10:53:52-08:00,['2336ed99a498fd082ed2ed6717e6e779e4597ed7'],1,3,4,2350245,1,,,,1733
8350bd7d65a769245cfb6005b63b74e4a5b38ca3,1,Henry Robinson,2014-01-08 10:53:52-08:00,['b17bc4514837cbf6ed7b033917189b65832052bb'],24,104,128,2350373,6,0.137254902,0,1,1733
fcdcf1a9d8449b5b7cec5bcd8f7f6b1fa7dd8a88,1,Henry Robinson,2014-01-08 10:53:53-08:00,['8350bd7d65a769245cfb6005b63b74e4a5b38ca3'],50,120,170,2350543,2,0.432432432,0.432432432,0.837837838,1733
51bfc99c63143da1339c4217e4f5b39be6678c96,1,Henry Robinson,2014-01-08 10:53:53-08:00,['fcdcf1a9d8449b5b7cec5bcd8f7f6b1fa7dd8a88'],118,977,1095,2351638,24,0.661538462,0.649230769,0.6,1736
f2417829660a6ce548a4904a5669ce4fa5a74f2f,1,Henry Robinson,2014-01-08 10:53:53-08:00,['51bfc99c63143da1339c4217e4f5b39be6678c96'],148,359,507,2352145,16,0.313953488,0.860465116,0.348837209,1738
bb821c10d46624dd861c27156010fb9e498e6daf,1,Henry Robinson,2014-01-08 10:53:54-08:00,['f2417829660a6ce548a4904a5669ce4fa5a74f2f'],107,502,609,2352754,11,0.121621622,0.977477477,0.824324324,1739
000062e6c1dae95d2bc39ba5db284025c9a6b5a9,0,Henry Robinson,2014-01-08 10:53:54-08:00,['bb821c10d46624dd861c27156010fb9e498e6daf'],8,13,21,2352775,4,1,,,1739
f275c6b951984e1fc3c3d70585f774e473232cc3,1,Henry Robinson,2014-01-08 10:53:54-08:00,['000062e6c1dae95d2bc39ba5db284025c9a6b5a9'],0,1,1,2352776,1,0,0,1,1739
94c72936e0b89df8c5b444466d8d6b0dd575512b,0,Henry Robinson,2014-01-08 10:53:55-08:00,['f275c6b951984e1fc3c3d70585f774e473232cc3'],1,3,4,2352780,1,,,,1739
ecbc852524fe353ac265990abfa0a2ef79a82fb6,0,Henry Robinson,2014-01-08 10:53:55-08:00,['94c72936e0b89df8c5b444466d8d6b0dd575512b'],0,31,31,2352811,2,1,1,1,1739
23c0c1a31766a304c0358fc6cff5053b15828f84,1,Henry Robinson,2014-01-08 10:53:55-08:00,['ecbc852524fe353ac265990abfa0a2ef79a82fb6'],5,20,25,2352836,7,0,0.642857143,0.928571429,1739
f6540bc4ab19bd4dfb0d219edc1eb8a8666aa855,1,Henry Robinson,2014-01-08 10:53:56-08:00,['23c0c1a31766a304c0358fc6cff5053b15828f84'],87,114,201,2353037,5,0.181818182,1,0.636363636,1739
9090250167d236e017b548a2af263e6bc9f72fc5,1,Henry Robinson,2014-01-08 10:53:56-08:00,['f6540bc4ab19bd4dfb0d219edc1eb8a8666aa855'],24,238,262,2353299,7,0.294736842,0.410526316,0.978947368,1739
e9317cc40f8c671ba5c8997540974c0bf926b40e,1,Henry Robinson,2014-01-08 10:53:56-08:00,['9090250167d236e017b548a2af263e6bc9f72fc5'],13,54,67,2353366,3,0.789473684,0.947368421,1,1739
8bb001041505d48106d5253e0c37b7905a80f309,1,Henry Robinson,2014-01-08 10:53:57-08:00,['e9317cc40f8c671ba5c8997540974c0bf926b40e'],147,313,460,2353826,11,0.125,0.875,1,1740
9bc840dc85f6daa61a7c7222a8c6e022de31c144,1,Henry Robinson,2014-01-08 10:53:57-08:00,['8bb001041505d48106d5253e0c37b7905a80f309'],64,243,307,2354133,6,0.608695652,0.608695652,0.956521739,1743
48c1efad8a2b7aab7bd0edc8dcee4007b4dd940a,0,Henry Robinson,2014-01-08 10:53:57-08:00,['9bc840dc85f6daa61a7c7222a8c6e022de31c144'],3,3,6,2354139,1,,,,1743
f579ee8b253035a2def3633a25325f71cb71e3df,1,Henry Robinson,2014-01-08 10:53:58-08:00,['48c1efad8a2b7aab7bd0edc8dcee4007b4dd940a'],0,1,1,2354140,1,0,1,1,1743
35817f6a17900ccd2f58f95944072c49ee3d8d9f,1,Henry Robinson,2014-01-08 10:53:58-08:00,['f579ee8b253035a2def3633a25325f71cb71e3df'],183,542,725,2354865,26,0.150259067,0.595854922,0.943005181,1744
39f77b8b8f7b143681ae65e190e622ddf2f8c851,1,Henry Robinson,2014-01-08 10:53:58-08:00,['35817f6a17900ccd2f58f95944072c49ee3d8d9f'],153,223,376,2355241,16,0.25,0.319444444,0.777777778,1744
6c25e78715c798d5637f35ffc94acb62fe5f5327,1,Henry Robinson,2014-01-08 10:53:59-08:00,['39f77b8b8f7b143681ae65e190e622ddf2f8c851'],22,37,59,2355300,1,,,,1744
219b786fc64633e26635169966c1253aa402a4c9,0,Henry Robinson,2014-01-08 10:53:59-08:00,['6c25e78715c798d5637f35ffc94acb62fe5f5327'],3,1,4,2355304,1,1,0,0,1744
4f41179352de9944cfd357e03c50760e3b1dde5e,0,Henry Robinson,2014-01-08 10:53:59-08:00,['219b786fc64633e26635169966c1253aa402a4c9'],7,8,15,2355319,1,0,0,1,1744
04ebe6821271f6ad8aeab9ee3cf06bc3773f59c7,1,Henry Robinson,2014-01-08 10:54:00-08:00,['4f41179352de9944cfd357e03c50760e3b1dde5e'],16,34,50,2355369,2,0,0,0.846153846,1744
6bba0c8ffedf4b485b750013dec0d5900220fcde,1,Henry Robinson,2014-01-08 10:54:00-08:00,['04ebe6821271f6ad8aeab9ee3cf06bc3773f59c7'],47,34,81,2355450,4,0.214285714,0,0,1744
9147cd7518c318e7815bc532a7569a754b753aa4,1,Henry Robinson,2014-01-08 10:54:01-08:00,['6bba0c8ffedf4b485b750013dec0d5900220fcde'],88,294,382,2355832,20,0,0.67961165,0.922330097,1746
739a1dbea5369360c4fc55377f5777768c41206f,0,Henry Robinson,2014-01-08 10:54:01-08:00,['9147cd7518c318e7815bc532a7569a754b753aa4'],9,22,31,2355863,4,0.142857143,1,0,1746
acc0efbc423c9570b8f8ba38239f6c0fb486297a,1,Henry Robinson,2014-01-08 10:54:01-08:00,['739a1dbea5369360c4fc55377f5777768c41206f'],124,355,479,2356342,15,0.41,0.82,0.81,1747
bf5359be8def9a15bfd8f674d70a6f7470f57f1d,1,Henry Robinson,2014-01-08 10:54:02-08:00,['acc0efbc423c9570b8f8ba38239f6c0fb486297a'],4,11,15,2356357,1,0,0.142857143,1,1747
8a559821059e524f2a2d87a4ea0cc581e0302db4,1,Henry Robinson,2014-01-08 10:54:02-08:00,['bf5359be8def9a15bfd8f674d70a6f7470f57f1d'],147,548,695,2357052,21,0.433962264,1,0.603773585,1748
89c96fa37caca2fa1c66d4e79238043ae7bffc69,0,Henry Robinson,2014-01-08 10:54:02-08:00,['8a559821059e524f2a2d87a4ea0cc581e0302db4'],18,49,67,2357119,2,0,0,1,1748
7f08146b88e47f6f4470c6e6455be2cd72092f3c,1,Henry Robinson,2014-01-08 10:54:03-08:00,['89c96fa37caca2fa1c66d4e79238043ae7bffc69'],14,238,252,2357371,13,0.608333333,0.725,0.758333333,1748
6282d364a8c22b2d495f9df85a95302b2084f202,1,Henry Robinson,2014-01-08 10:54:03-08:00,['7f08146b88e47f6f4470c6e6455be2cd72092f3c'],25,71,96,2357467,4,0.848484848,0.939393939,0.484848485,1748
b26837adae4d42ece29444d70ba2cbae705234b2,0,Henry Robinson,2014-01-08 10:54:03-08:00,['6282d364a8c22b2d495f9df85a95302b2084f202'],6,2,8,2357475,1,1,0,1,1748
128907544e96540a6177b316cc844bd7e2eb1848,0,Henry Robinson,2014-01-08 10:54:04-08:00,['b26837adae4d42ece29444d70ba2cbae705234b2'],0,0,0,2357475,0,,,,1748
81b80c702c080d1b615a32883b242a0d147eacf0,0,Henry Robinson,2014-01-08 10:54:09-08:00,['128907544e96540a6177b316cc844bd7e2eb1848'],5,6,11,2357486,2,,,,1748
d3ffdbea159e0db47a2944202de3ca2faae7ca16,1,Henry Robinson,2014-01-08 10:54:11-08:00,['81b80c702c080d1b615a32883b242a0d147eacf0'],3,12,15,2357501,1,0.428571429,0.428571429,0.428571429,1748
3f77cc563bde393c780122d4154d7330e5faa4a7,1,Henry Robinson,2014-01-08 10:54:11-08:00,['d3ffdbea159e0db47a2944202de3ca2faae7ca16'],2,3,5,2357506,1,,,,1748
95a01cd90a12c442a1bd750419f08abf511719c5,1,Henry Robinson,2014-01-08 10:54:11-08:00,['3f77cc563bde393c780122d4154d7330e5faa4a7'],55,111,166,2357672,12,0,0,0.96875,1748
9717b7af28a11d311d1e1ac23b270fc858c62e1e,1,Henry Robinson,2014-01-08 10:54:11-08:00,['95a01cd90a12c442a1bd750419f08abf511719c5'],19,19,38,2357710,8,,,,1748
17761f1f5ec5b6820dee8da0e3a9df0bca052b6b,1,Henry Robinson,2014-01-08 10:54:12-08:00,['9717b7af28a11d311d1e1ac23b270fc858c62e1e'],183,217,400,2358110,2,1,1,0,1748
7485e2e2235ca60ad2a5739d052ff342f81312a5,0,Henry Robinson,2014-01-08 10:54:12-08:00,['17761f1f5ec5b6820dee8da0e3a9df0bca052b6b'],8,69,77,2358187,3,0.055555556,0.944444444,1,1748
7fe67f8d0dab9d346a233743c8b4d8b51334c2e6,0,Henry Robinson,2014-01-08 10:54:12-08:00,['7485e2e2235ca60ad2a5739d052ff342f81312a5'],11,31,42,2358229,2,0,1,1,1748
e2b9b4a735a3831f44e5dc37decfd61ef69ff0ae,0,Henry Robinson,2014-01-08 10:54:12-08:00,['7fe67f8d0dab9d346a233743c8b4d8b51334c2e6'],1,1,2,2358231,1,,,,1748
bc0c08b90c618b1c9a79c9785eb4fdad5f410e06,1,Henry Robinson,2014-01-08 10:54:13-08:00,['e2b9b4a735a3831f44e5dc37decfd61ef69ff0ae'],8,19,27,2358258,3,0,0.666666667,1,1748
6e09b90ea38b5d90f78e471aac7c5f585e9cfe05,0,Henry Robinson,2014-01-08 10:54:13-08:00,['bc0c08b90c618b1c9a79c9785eb4fdad5f410e06'],1,2,3,2358261,1,1,1,1,1748
287953e87c0d5811829452dd0eab0e06109d7ed5,0,Henry Robinson,2014-01-08 10:54:13-08:00,['6e09b90ea38b5d90f78e471aac7c5f585e9cfe05'],8,3,11,2358272,1,1,1,0,1748
71df58de49487fc8266393bc04703a1cf6da894f,1,Henry Robinson,2014-01-08 10:54:13-08:00,['287953e87c0d5811829452dd0eab0e06109d7ed5'],6,11,17,2358289,1,1,1,0,1748
659382f334fba5039044900c5eaad09e1817bf08,0,Henry Robinson,2014-01-08 10:54:13-08:00,['71df58de49487fc8266393bc04703a1cf6da894f'],0,8,8,2358297,1,,,,1748
49f4bd285aa86893d992be1a2b6c8b3b833d4195,0,Henry Robinson,2014-01-08 10:54:14-08:00,['659382f334fba5039044900c5eaad09e1817bf08'],25,25,50,2358347,1,,,,1748
bb39e3310195e04c18169d048b96a7fc9183602b,0,Henry Robinson,2014-01-08 10:54:14-08:00,['49f4bd285aa86893d992be1a2b6c8b3b833d4195'],1,4,5,2358352,1,,,,1748
93e5b262c242edaa2aaddadc5fa7c8dd2477afc0,1,Henry Robinson,2014-01-08 10:54:14-08:00,['bb39e3310195e04c18169d048b96a7fc9183602b'],124,1427,1551,2359903,31,0.263473054,0.672654691,0.816367265,1753
2b313a97823d65f9e42e063102634339776ee8a4,0,Henry Robinson,2014-01-08 10:54:14-08:00,['93e5b262c242edaa2aaddadc5fa7c8dd2477afc0'],2,2,4,2359907,1,,,,1753
ce2781c48d12438b90bced9091ac1e572a147ff8,0,Henry Robinson,2014-01-08 10:54:14-08:00,['2b313a97823d65f9e42e063102634339776ee8a4'],1,1,2,2359909,1,,,,1753
5a6d08ded4f3f6eb638a31ae58e06b1a7687dcee,0,Henry Robinson,2014-01-08 10:54:15-08:00,['ce2781c48d12438b90bced9091ac1e572a147ff8'],3,6,9,2359918,1,0,1,1,1753
783052c2eac88b7be945c8bc79bade112a87ee11,1,Henry Robinson,2014-01-08 10:54:15-08:00,['5a6d08ded4f3f6eb638a31ae58e06b1a7687dcee'],8,32,40,2359958,3,0.8,1,1,1753
2ea5ed506951e6bb2b48ec5c89db78ab9fead247,1,Henry Robinson,2014-01-08 10:54:15-08:00,['783052c2eac88b7be945c8bc79bade112a87ee11'],65,142,207,2360165,16,0.238095238,1,1,1753
4864998a41b43db5047604c7195a99a9df787ea8,0,Henry Robinson,2014-01-08 10:54:16-08:00,['2ea5ed506951e6bb2b48ec5c89db78ab9fead247'],64,43,107,2360272,22,,,,1753
882b5f09b2e0777ac48c65eab0ed0fff2e327a54,0,Henry Robinson,2014-01-08 10:54:16-08:00,['4864998a41b43db5047604c7195a99a9df787ea8'],4,23,27,2360299,1,,,,1753
e86ca62ec763457a67c529a4d0dd47242ef1b18d,0,Henry Robinson,2014-01-08 10:54:16-08:00,['882b5f09b2e0777ac48c65eab0ed0fff2e327a54'],5,1,6,2360305,1,,,,1753
2325c8c923decf6d546a17bd12cb3a607eb9457f,1,Henry Robinson,2014-01-08 10:54:16-08:00,['e86ca62ec763457a67c529a4d0dd47242ef1b18d'],212,429,641,2360946,7,0,0.602564103,0.923076923,1753
01660374c617c980851ebca4edc1ff07697346f6,0,Henry Robinson,2014-01-08 10:54:17-08:00,['2325c8c923decf6d546a17bd12cb3a607eb9457f'],204,13,217,2361163,6,0,0,0.384615385,1753
c3619d9581ae6617552a80c610b27ea9bee3f9a4,0,Henry Robinson,2014-01-08 10:54:17-08:00,['01660374c617c980851ebca4edc1ff07697346f6'],0,44,44,2361207,1,,,,1753
ab21dde002c484957e5ed3758e30b68a99b213d7,1,Henry Robinson,2014-01-08 10:54:17-08:00,['c3619d9581ae6617552a80c610b27ea9bee3f9a4'],32,32,64,2361271,1,,,,1753
b225477ae97548b3226d5f36b40c3c31c7024d2a,0,Henry Robinson,2014-01-08 10:54:17-08:00,['ab21dde002c484957e5ed3758e30b68a99b213d7'],1,1,2,2361273,1,,,,1753
c1a64d6863397bfbcb3b0dba46da2a303d8729a4,0,Henry Robinson,2014-01-08 10:54:17-08:00,['b225477ae97548b3226d5f36b40c3c31c7024d2a'],0,7,7,2361280,2,,,,1754
9d71dd3d0cebf21bb90dbc8598e851003d3991e0,1,Henry Robinson,2014-01-08 10:54:18-08:00,['c1a64d6863397bfbcb3b0dba46da2a303d8729a4'],6,43,49,2361329,3,1,1,0.761904762,1754
76fa3b2ded92cf5542c19e01809ce6933c40ddae,1,Henry Robinson,2014-01-08 10:54:18-08:00,['9d71dd3d0cebf21bb90dbc8598e851003d3991e0'],37,42,79,2361408,11,0,1,1,1754
0bae3978c9b4f76c3316bb98f8761836574534ec,1,Henry Robinson,2014-01-08 10:54:18-08:00,['76fa3b2ded92cf5542c19e01809ce6933c40ddae'],494,468,962,2362370,6,0.1875,0.25,1,1754
2e23c94d0225d83a896a5c82bc08f8432215c9d7,0,Henry Robinson,2014-01-08 10:54:19-08:00,['0bae3978c9b4f76c3316bb98f8761836574534ec'],0,0,0,2362370,0,,,,1754
cb965d259aa75e5a3e890767092377909c86163f,0,Henry Robinson,2014-01-08 10:54:19-08:00,['2e23c94d0225d83a896a5c82bc08f8432215c9d7'],1,1,2,2362372,1,,,,1754
e4cda8249381ab6ed99c77c5e0d13f30b352598b,0,Henry Robinson,2014-01-08 10:54:20-08:00,['cb965d259aa75e5a3e890767092377909c86163f'],0,0,0,2362372,0,,,,1754
6d9a7e290d1ad1483f48b6a614eb1ba80e8a66e7,0,Henry Robinson,2014-01-08 10:54:20-08:00,['e4cda8249381ab6ed99c77c5e0d13f30b352598b'],3,75,78,2362450,5,,,,1755
00bb491344a0dd10b436bea6271c9637fd312b8e,1,Henry Robinson,2014-01-08 10:54:20-08:00,['6d9a7e290d1ad1483f48b6a614eb1ba80e8a66e7'],10,143,153,2362603,2,0.15625,0.875,0.328125,1755
2487b9dd04a6083a9c8af6ca5af2a7663782b628,1,Henry Robinson,2014-01-08 10:54:21-08:00,['00bb491344a0dd10b436bea6271c9637fd312b8e'],2,4,6,2362609,1,,,,1755
5c96dffc96585a8ee5ae22b46376da3f8898c84f,0,Henry Robinson,2014-01-08 10:54:21-08:00,['2487b9dd04a6083a9c8af6ca5af2a7663782b628'],18,18,36,2362645,3,,1,1,1755
0551f16d6094531c9161c5d6a50953255843248b,0,Henry Robinson,2014-01-08 10:54:21-08:00,['5c96dffc96585a8ee5ae22b46376da3f8898c84f'],8,67,75,2362720,2,0,0.971428571,0.828571429,1755
e3fdef7839702830904b4d5eee676398cfd462f7,1,Henry Robinson,2014-01-08 10:54:22-08:00,['0551f16d6094531c9161c5d6a50953255843248b'],30,47,77,2362797,2,,,,1755
bfb16ff5522eef4142c88568a97d40ffe94b11d9,1,Henry Robinson,2014-01-08 10:54:22-08:00,['e3fdef7839702830904b4d5eee676398cfd462f7'],152,165,317,2363114,4,1,1,1,1756
24662b1941bef952095fa69ffcbb8a1020a97c5d,1,Henry Robinson,2014-01-08 10:54:22-08:00,['bfb16ff5522eef4142c88568a97d40ffe94b11d9'],49,129,178,2363292,8,0.045454545,0,0.977272727,1756
f986782f0fa952caf4c088288337a36195c0e308,0,Henry Robinson,2014-01-08 10:54:22-08:00,['24662b1941bef952095fa69ffcbb8a1020a97c5d'],9,36,45,2363337,3,0.230769231,0.307692308,1,1756
b54d16dabde6a05b0edb094544139837a95bd2fd,1,Henry Robinson,2014-01-08 10:54:22-08:00,['f986782f0fa952caf4c088288337a36195c0e308'],25,67,92,2363429,7,1,1,1,1757
d39062f848e46acb43cfd186e67d658c6cec4a09,0,Henry Robinson,2014-01-08 10:54:23-08:00,['b54d16dabde6a05b0edb094544139837a95bd2fd'],1,21,22,2363451,2,0,1,1,1757
9565657c49c9ee52b85c9d62b70441a6dc7865c9,0,Henry Robinson,2014-01-08 10:54:23-08:00,['d39062f848e46acb43cfd186e67d658c6cec4a09'],4,20,24,2363475,2,0,0.916666667,1,1757
5c612bce1279cc3d91a3192a5a0a591d7111caa7,0,Henry Robinson,2014-01-08 10:54:23-08:00,['9565657c49c9ee52b85c9d62b70441a6dc7865c9'],0,1,1,2363476,1,1,1,1,1757
c9aa31ac02d07c0cf2168f825dacd4fc7b8e047b,0,Henry Robinson,2014-01-08 10:54:23-08:00,['5c612bce1279cc3d91a3192a5a0a591d7111caa7'],5,10,15,2363491,1,1,1,1,1757
cd17c3df4b24a8b81cc76c85f4487accb45bf32e,0,Henry Robinson,2014-01-08 10:54:24-08:00,['c9aa31ac02d07c0cf2168f825dacd4fc7b8e047b'],1,1,2,2363493,1,,,,1757
d401f746d442517eb80b4483c84865b138db49c9,1,Henry Robinson,2014-01-08 10:54:24-08:00,['cd17c3df4b24a8b81cc76c85f4487accb45bf32e'],42,95,137,2363630,3,0.961538462,0.961538462,1,1758
ece3acdcc54d9fefbf9bda8884f86db542002984,1,Henry Robinson,2014-01-08 10:54:24-08:00,['d401f746d442517eb80b4483c84865b138db49c9'],28,36,64,2363694,3,0,0,0,1758
fd182201bcbe95c4e478ed081247fb748d37f773,1,Henry Robinson,2014-01-08 10:54:24-08:00,['ece3acdcc54d9fefbf9bda8884f86db542002984'],3653,6692,10345,2374039,78,0.335714286,0.582857143,0.765714286,1761
acdc79235563994070ca4e708224adfb5de3e211,1,Henry Robinson,2014-01-08 10:54:25-08:00,['fd182201bcbe95c4e478ed081247fb748d37f773'],25,156,181,2374220,13,0.978723404,1,1,1763
255e89d23c1bbb5fe3b90c72ef3d59e0a76481c1,0,Henry Robinson,2014-01-08 10:54:25-08:00,['acdc79235563994070ca4e708224adfb5de3e211'],1,5,6,2374226,2,0,1,1,1763
a5f322b62ed26ae1d6eabb1f142bfa4f2bad4421,1,Henry Robinson,2014-01-08 10:54:25-08:00,['255e89d23c1bbb5fe3b90c72ef3d59e0a76481c1'],3,5,8,2374234,1,1,1,1,1763
f327431a8e5f551f2137f297ff7eda14b813a7a1,1,Henry Robinson,2014-01-08 10:54:25-08:00,['a5f322b62ed26ae1d6eabb1f142bfa4f2bad4421'],290,1394,1684,2375918,27,0.661931818,0.826704545,0.65625,1770
4bd266c29676dbbf0899f7246a9c75b95ccf7a1a,1,Henry Robinson,2014-01-08 10:54:26-08:00,['f327431a8e5f551f2137f297ff7eda14b813a7a1'],434,401,835,2376753,9,0,0,1,1770
da46464b91151390bbf5337375585132ceda5901,1,Henry Robinson,2014-01-08 10:54:26-08:00,['4bd266c29676dbbf0899f7246a9c75b95ccf7a1a'],2,23,25,2376778,3,0,0.466666667,1,1770
9c2093fb7943d3008cc214c1f3b7ab51935cb967,0,Henry Robinson,2014-01-08 10:54:26-08:00,['da46464b91151390bbf5337375585132ceda5901'],2,0,2,2376780,2,0,0,0,1770
6830f630853ade4cc8ea362f30cfd746e9649000,0,Henry Robinson,2014-01-08 10:54:26-08:00,['9c2093fb7943d3008cc214c1f3b7ab51935cb967'],0,35,35,2376815,1,,,,1770
e63cc59a9400777b2ef8fe6728a792e9ee8819f7,1,Henry Robinson,2014-01-08 10:54:26-08:00,['6830f630853ade4cc8ea362f30cfd746e9649000'],12,4098,4110,2380925,4,0.8,0.8,0,1771
2d9a2e07bdd3f43c8853029734c69ea8563e63b2,1,Henry Robinson,2014-01-08 10:54:27-08:00,['e63cc59a9400777b2ef8fe6728a792e9ee8819f7'],181,490,671,2381596,7,0.138461538,0.138461538,0.507692308,1771
37ad54210ca8c1c8baa8d070c6cace6293ecaa38,1,Henry Robinson,2014-01-08 10:54:27-08:00,['2d9a2e07bdd3f43c8853029734c69ea8563e63b2'],1052,829,1881,2383477,6,0,0.571428571,1,1771
de531e15bd43cf1f3030c185256a529ad147a826,1,Henry Robinson,2014-01-08 10:54:27-08:00,['37ad54210ca8c1c8baa8d070c6cace6293ecaa38'],30,162,192,2383669,9,0.347826087,0.376811594,0.768115942,1773
9e1704218592d1488fe06810698cadcc400e1b61,1,Henry Robinson,2014-01-08 10:54:27-08:00,['de531e15bd43cf1f3030c185256a529ad147a826'],3,40,43,2383712,6,1,1,1,1774
df0b28d16365dc78eb80c0e79c7e0f11fb4233b4,0,Henry Robinson,2014-01-08 10:54:28-08:00,['9e1704218592d1488fe06810698cadcc400e1b61'],5,47,52,2383764,3,,,,1774
bb9bea6323d679aa1663a782575235a3d2031371,0,Henry Robinson,2014-01-08 10:54:28-08:00,['df0b28d16365dc78eb80c0e79c7e0f11fb4233b4'],8,75,83,2383847,4,0.885714286,0.914285714,0.971428571,1774
a94f1efe29831f137514ac94f1217e8c2060597b,1,Henry Robinson,2014-01-08 10:54:28-08:00,['bb9bea6323d679aa1663a782575235a3d2031371'],178,195,373,2384220,4,0.4,0.4,0,1774
680c6c1a4c782002f7f7f4ab1eadf1386fcbebf4,1,Henry Robinson,2014-01-08 10:54:28-08:00,['a94f1efe29831f137514ac94f1217e8c2060597b'],723,499,1222,2385442,9,0.627240143,0.215053763,0,1775
454b611c9e017d5e8e05bba5291b461f1db7c973,1,Henry Robinson,2014-01-08 10:54:28-08:00,['680c6c1a4c782002f7f7f4ab1eadf1386fcbebf4'],59,124,183,2385625,6,0.827586207,1,0.827586207,1775
0647aeb0c50b21f1619d61c4b002a26ff5e8f62c,0,Henry Robinson,2014-01-08 10:54:29-08:00,['454b611c9e017d5e8e05bba5291b461f1db7c973'],0,1,1,2385626,1,,,,1775
b374fc2bc2679a49f1617253a6aafb8da4e8c509,1,Henry Robinson,2014-01-08 10:54:29-08:00,['0647aeb0c50b21f1619d61c4b002a26ff5e8f62c'],50,60,110,2385736,2,0,1,1,1775
c6397ca1e3fa4deb026007be7552ff8e00e22e38,1,Henry Robinson,2014-01-08 10:54:29-08:00,['b374fc2bc2679a49f1617253a6aafb8da4e8c509'],47,5,52,2385788,3,,,,1775
93368e20b18fbeedbbdc4c8c66aef1e808a5469f,1,Henry Robinson,2014-01-08 10:54:29-08:00,['c6397ca1e3fa4deb026007be7552ff8e00e22e38'],2,418,420,2386208,4,0,0,0.166666667,1775
dd0409e9d6e256110082b87cd49b68af3a8c620f,0,Henry Robinson,2014-01-08 10:54:30-08:00,['93368e20b18fbeedbbdc4c8c66aef1e808a5469f'],44,73,117,2386325,10,0.307692308,0.307692308,0.884615385,1775
b35f13931ed26585790cda06721bbf35473b0203,0,Henry Robinson,2014-01-08 10:54:30-08:00,['dd0409e9d6e256110082b87cd49b68af3a8c620f'],87,32,119,2386444,4,0.114285714,0.057142857,0.057142857,1775
e4ad086dee18f21f71ffa918ba6603fe03a63344,1,Henry Robinson,2014-01-08 10:54:30-08:00,['b35f13931ed26585790cda06721bbf35473b0203'],229,223,452,2386896,8,0,0.090909091,1,1775
aa9796817f811413d106d231a979c1ad986118f4,1,Henry Robinson,2014-01-08 10:54:30-08:00,['e4ad086dee18f21f71ffa918ba6603fe03a63344'],47,39,86,2386982,5,0.444444444,0.111111111,0.111111111,1775
2489e211f02dc4f9f7fc8985e10eeb3501ca4536,0,Henry Robinson,2014-01-08 10:54:30-08:00,['aa9796817f811413d106d231a979c1ad986118f4'],1,1,2,2386984,1,,,,1775
bd895fd2de3ca5469a73c728f5c20ca6cec96ee2,0,Henry Robinson,2014-01-08 10:54:31-08:00,['2489e211f02dc4f9f7fc8985e10eeb3501ca4536'],97,0,97,2387081,2,0,0,0.35483871,1775
01b6b0d9815fb4c1d9e6704923f03f4928d83372,0,Henry Robinson,2014-01-08 10:54:31-08:00,['bd895fd2de3ca5469a73c728f5c20ca6cec96ee2'],0,8,8,2387089,2,0,1,0.8,1775
271278f1fdda607155d012ca282ff0ab9322164f,0,Henry Robinson,2014-01-08 10:54:31-08:00,['01b6b0d9815fb4c1d9e6704923f03f4928d83372'],3,6,9,2387098,1,,,,1775
ff5fa0817c9d98670cf57fb3da6d6ba9b848bbaa,1,Henry Robinson,2014-01-08 10:54:31-08:00,['271278f1fdda607155d012ca282ff0ab9322164f'],18,20,38,2387136,8,0,0.666666667,1,1775
f099b4a9fb4aa439c7874f803970e7d626f461a8,0,Henry Robinson,2014-01-08 10:54:32-08:00,['ff5fa0817c9d98670cf57fb3da6d6ba9b848bbaa'],4,0,4,2387140,2,0,0,1,1775
ac2648e5688f09ac4cad7aa3814d71eae9b2af59,0,Henry Robinson,2014-01-08 10:54:32-08:00,['f099b4a9fb4aa439c7874f803970e7d626f461a8'],0,0,0,2387140,0,,,,1775
1c2e767b8908b9a32d0bd54240e9bd83b65e69c0,0,Henry Robinson,2014-01-08 10:54:32-08:00,['ac2648e5688f09ac4cad7aa3814d71eae9b2af59'],1,1,2,2387142,1,,,,1775
04604d2a6f49ae505e4a735d6f3bebaa2af8f3b3,1,Henry Robinson,2014-01-08 10:54:32-08:00,['1c2e767b8908b9a32d0bd54240e9bd83b65e69c0'],33,33,66,2387208,5,1,1,0,1775
f57230e52644c160403e2e9105c55b58de66b88a,1,Henry Robinson,2014-01-08 10:54:32-08:00,['04604d2a6f49ae505e4a735d6f3bebaa2af8f3b3'],7,28,35,2387243,6,0,0.9,1,1775
0440f26f3e7410340a92fd50a13d3ddcdba707ff,0,Henry Robinson,2014-01-08 10:54:33-08:00,['f57230e52644c160403e2e9105c55b58de66b88a'],7,12,19,2387262,1,,,,1775
15e6cf6b5ce9e4f0a530b68e9cdd55dd91320129,0,Henry Robinson,2014-01-08 10:54:33-08:00,['0440f26f3e7410340a92fd50a13d3ddcdba707ff'],0,4,4,2387266,1,1,1,1,1775
74164e8f997920b682175abb99fea3ba567b437a,1,Henry Robinson,2014-01-08 10:54:33-08:00,['15e6cf6b5ce9e4f0a530b68e9cdd55dd91320129'],34,37,71,2387337,6,0,0,0,1775
ba804aed474e808a8b5fff07b268b0ed2bcac607,0,Henry Robinson,2014-01-08 10:54:33-08:00,['74164e8f997920b682175abb99fea3ba567b437a'],3,4,7,2387344,1,,,,1775
3af619f2a2740a9260e06f6925d81070fac5943d,1,Henry Robinson,2014-01-08 10:54:34-08:00,['ba804aed474e808a8b5fff07b268b0ed2bcac607'],727,726,1453,2388797,21,0.666666667,0.666666667,1,1775
7e98708d7d192f7e6d8823f2f394d291a516a8ee,1,Henry Robinson,2014-01-08 10:54:34-08:00,['3af619f2a2740a9260e06f6925d81070fac5943d'],258,1183,1441,2390238,12,0.071786311,0.105175292,0.373956594,1777
f2b1a99f2736a97cc5879083e4048aef0e1321a9,1,Henry Robinson,2014-01-08 10:54:34-08:00,['7e98708d7d192f7e6d8823f2f394d291a516a8ee'],2177,2007,4184,2394422,92,0,0,0.015625,1777
4409a828a7bddc8267f84d3c9ca36d7b14ff78cf,1,Henry Robinson,2014-01-08 10:54:34-08:00,['f2b1a99f2736a97cc5879083e4048aef0e1321a9'],20,20,40,2394462,7,0,1,0,1777
b54416d2928fd8d691ac085e085133bcb379a464,0,Henry Robinson,2014-01-08 10:54:35-08:00,['4409a828a7bddc8267f84d3c9ca36d7b14ff78cf'],0,9,9,2394471,2,0,1,0.333333333,1777
7e520f8f23fdfa267b6810e371b78adaaa16e4bb,1,Henry Robinson,2014-01-08 10:54:35-08:00,['b54416d2928fd8d691ac085e085133bcb379a464'],16,17,33,2394504,3,1,1,1,1777
177b9ba3b13ea01450e7da55acd33826392f1173,1,Henry Robinson,2014-01-08 10:54:35-08:00,['7e520f8f23fdfa267b6810e371b78adaaa16e4bb'],97,29,126,2394630,13,1,1,0.45,1777
94eaf17a7351c8e666e1d177725e7e15df8e0b42,1,Henry Robinson,2014-01-08 10:54:35-08:00,['177b9ba3b13ea01450e7da55acd33826392f1173'],8,53,61,2394691,13,0.653846154,0.730769231,0.769230769,1777
291f0e9ad575be0ed7573d318e04586438e0025f,1,Henry Robinson,2014-01-08 10:54:35-08:00,['94eaf17a7351c8e666e1d177725e7e15df8e0b42'],630,605,1235,2395926,24,0,0,0,1777
60fde39e33c277847507d5e326b1d49a7529509c,1,Henry Robinson,2014-01-08 10:54:36-08:00,['291f0e9ad575be0ed7573d318e04586438e0025f'],28,28,56,2395982,1,,,,1777
576afd007135355460848cc3bd01bb21b1b1eb0d,0,Henry Robinson,2014-01-08 10:54:36-08:00,['60fde39e33c277847507d5e326b1d49a7529509c'],5,23,28,2396010,3,0.833333333,1,1,1777
8834d77dd83784cf64cac09f3f4796b4455fe255,0,Henry Robinson,2014-01-08 10:54:36-08:00,['576afd007135355460848cc3bd01bb21b1b1eb0d'],0,18,18,2396028,1,,,,1777
86e89a83deb692ec2c13f7f6ab7c8ce65993beee,0,Henry Robinson,2014-01-08 10:54:36-08:00,['8834d77dd83784cf64cac09f3f4796b4455fe255'],0,1,1,2396029,1,,,,1777
967346b0c448a07230ae3e2c2bfb72f3780ed3f7,0,Henry Robinson,2014-01-08 10:54:37-08:00,['86e89a83deb692ec2c13f7f6ab7c8ce65993beee'],25,108,133,2396162,15,0.916666667,1,0.833333333,1778
fbe79fc47b812cba6015ce37a66aabe6be1e1256,1,Henry Robinson,2014-01-08 10:54:37-08:00,['967346b0c448a07230ae3e2c2bfb72f3780ed3f7'],7,15,22,2396184,2,,,,1778
baf79f818548d124c182697a17978beb0de49ff4,0,Henry Robinson,2014-01-08 10:54:37-08:00,['fbe79fc47b812cba6015ce37a66aabe6be1e1256'],7,8,15,2396199,1,1,1,0,1778
6642c377d579a8401eb5827f25a1aaf6ab117921,0,Henry Robinson,2014-01-08 10:54:37-08:00,['baf79f818548d124c182697a17978beb0de49ff4'],1,4,5,2396204,1,,,,1778
6b9f01374bff48b5bc05bb7611706a6b7daf7a9f,0,Henry Robinson,2014-01-08 10:54:37-08:00,['6642c377d579a8401eb5827f25a1aaf6ab117921'],14,14,28,2396232,1,0,0,0,1778
12300cb9341dcbbb242989b34fcba9a00c6ae029,1,Henry Robinson,2014-01-08 10:54:38-08:00,['6b9f01374bff48b5bc05bb7611706a6b7daf7a9f'],316,278,594,2396826,26,0,0,0,1778
b3109354244436497600d37b0d82898486b33ed5,0,Henry Robinson,2014-01-08 10:54:38-08:00,['12300cb9341dcbbb242989b34fcba9a00c6ae029'],13,13,26,2396852,3,,,,1778
533d82858dd70601d0aaeae17839ee25e9646a47,1,Henry Robinson,2014-01-08 10:54:38-08:00,['b3109354244436497600d37b0d82898486b33ed5'],125,124,249,2397101,15,1,1,1,1778
c0c8716cf36c3afaa60db0caa5ae0cc369f193fa,1,Henry Robinson,2014-01-08 10:54:38-08:00,['533d82858dd70601d0aaeae17839ee25e9646a47'],196,236,432,2397533,5,0,0,0,1780
8f9f5e59979c18e4c3130bf8a4374b3ee942e52c,1,Henry Robinson,2014-01-08 10:54:39-08:00,['c0c8716cf36c3afaa60db0caa5ae0cc369f193fa'],389,431,820,2398353,5,0,1,0,1781
00e912b372bc7cc5f0ac67c46e0388970703e016,0,Henry Robinson,2014-01-08 10:54:39-08:00,['8f9f5e59979c18e4c3130bf8a4374b3ee942e52c'],2,16,18,2398371,2,,,,1781
fc73e292e16877bcab8c12913f925ccb2835fdcb,1,Henry Robinson,2014-01-08 10:54:39-08:00,['00e912b372bc7cc5f0ac67c46e0388970703e016'],7,8,15,2398386,1,0,1,0,1781
0ed17813236abe190eca6e7e456fc533365a5246,1,Henry Robinson,2014-01-08 10:54:39-08:00,['fc73e292e16877bcab8c12913f925ccb2835fdcb'],9,12,21,2398407,1,1,1,1,1781
6483f53581136ce0d4a69365d9f0f1bbe0549313,1,Henry Robinson,2014-01-08 10:54:40-08:00,['0ed17813236abe190eca6e7e456fc533365a5246'],8,64,72,2398479,3,1,1,1,1781
6afea607047537bcf0aec768660e255ad0f46343,1,Henry Robinson,2014-01-08 10:54:40-08:00,['6483f53581136ce0d4a69365d9f0f1bbe0549313'],54,231,285,2398764,12,0.958333333,0.958333333,0.847222222,1782
964c7666d1fa50a962e8aeca1b88d32e1f3ca822,0,Henry Robinson,2014-01-08 10:54:40-08:00,['6afea607047537bcf0aec768660e255ad0f46343'],22,24,46,2398810,5,1,0,0,1782
468ca0aa5d0b8020d352dee179e01038e389f312,0,Henry Robinson,2014-01-08 10:54:40-08:00,['964c7666d1fa50a962e8aeca1b88d32e1f3ca822'],1,14,15,2398825,3,0,0,1,1782
57b961168debd486435140a523df104d9999ce08,1,Henry Robinson,2014-01-08 10:54:40-08:00,['468ca0aa5d0b8020d352dee179e01038e389f312'],27,271,298,2399123,6,0.088235294,0.735294118,1,1782
16f9ef2f37b2974e8acb7796338ffc170bdb20f3,1,Henry Robinson,2014-01-08 10:54:41-08:00,['57b961168debd486435140a523df104d9999ce08'],32,59,91,2399214,12,0.647058824,0.705882353,0.941176471,1782
831e8742d2984d07fc41ec0d62bf3e434cfe0ca4,1,Henry Robinson,2014-01-08 10:54:41-08:00,['16f9ef2f37b2974e8acb7796338ffc170bdb20f3'],35,127,162,2399376,5,0,0.431034483,0.293103448,1782
daf0626dbd4171dc582160af467cf1638271dc60,1,Henry Robinson,2014-01-08 10:54:42-08:00,['831e8742d2984d07fc41ec0d62bf3e434cfe0ca4'],69,376,445,2399821,14,0.238709677,0.464516129,0.903225806,1783
561da008c76aa74fcebc5405457b801a386e472f,1,Henry Robinson,2014-01-08 10:56:26-08:00,['daf0626dbd4171dc582160af467cf1638271dc60'],65,56,121,2399942,10,0,0,0.035714286,1785
51e58e1f3c7ed4999c4863f870e94c73a4aaf41d,1,Henry Robinson,2014-01-09 09:56:04-08:00,['561da008c76aa74fcebc5405457b801a386e472f'],427,407,834,2400776,24,,,,1785
85b1154ba1c2edcccd673eb92c4d30c9a635442e,1,Henry Robinson,2014-01-09 09:56:05-08:00,['51e58e1f3c7ed4999c4863f870e94c73a4aaf41d'],6,7,13,2400789,3,1,1,0,1785
ca814c094c7954b8a77191b47a8cde76205e0d2d,1,Henry Robinson,2014-01-09 09:56:05-08:00,['85b1154ba1c2edcccd673eb92c4d30c9a635442e'],6,26,32,2400821,2,0,0.909090909,0.909090909,1785
9a0dc187001c0514bc5aaf8fa17b52b17006b898,0,Henry Robinson,2014-01-09 09:56:05-08:00,['ca814c094c7954b8a77191b47a8cde76205e0d2d'],2284,0,2284,2403105,3,0.708689459,0.59045584,0.232193732,1785
36d3784db1785053676241e23de77d7861529006,1,jenkins,2014-01-09 19:02:01-08:00,['9a0dc187001c0514bc5aaf8fa17b52b17006b898'],419,360,779,2403884,42,1,0,1,1785
056c7d94d61ae10d0c385ff4b27ad08bd6ad939e,0,Nong Li,2014-01-10 14:01:35-08:00,['36d3784db1785053676241e23de77d7861529006'],3,0,3,2403887,1,,,,1785
4e9913b52f702a3dd8afb0ee7adc2c9318398aac,1,jenkins,2014-01-10 15:01:59-08:00,['056c7d94d61ae10d0c385ff4b27ad08bd6ad939e'],4,13,17,2403904,1,0,0,1,1785
6799c939226cd56d0a5fa157d404f987086cce0c,1,jenkins,2014-01-10 19:17:59-08:00,['4e9913b52f702a3dd8afb0ee7adc2c9318398aac'],19033,11199,30232,2434136,53,0.487341772,0.056962025,0,1790
ca373c74734d55b43a564d22a79c83d2fd9a879a,0,jenkins,2014-01-11 00:06:46-08:00,['6799c939226cd56d0a5fa157d404f987086cce0c'],9,24,33,2434169,3,0.090909091,0.909090909,1,1790
0ce83818a6b87bf67a9e7bd0ee99712d49c0b6d7,1,jenkins,2014-01-13 22:27:22-08:00,['ca373c74734d55b43a564d22a79c83d2fd9a879a'],2,29,31,2434200,6,0.538461538,0.615384615,1,1790
51f003a785e6ac724df37bf2a0557dc338c786e9,0,jenkins,2014-01-14 00:01:25-08:00,['0ce83818a6b87bf67a9e7bd0ee99712d49c0b6d7'],11,244,255,2434455,10,0.247933884,1,0.991735537,1791
633d0e82e9b1165cf35eb00aa2e0dbd444c1db6a,0,jenkins,2014-01-14 20:21:22-08:00,['51f003a785e6ac724df37bf2a0557dc338c786e9'],0,73,73,2434528,4,0.297297297,0.297297297,1,1791
85719207532e2b8a8977b326a48ede0a872821dd,0,Lenni Kuff,2014-01-14 21:33:22-08:00,['633d0e82e9b1165cf35eb00aa2e0dbd444c1db6a'],1,1,2,2434530,1,,,,1791
09eb510956d82744a1e955da4876fa95ed10b9e3,0,Alex Behm,2014-01-15 15:10:54-08:00,['85719207532e2b8a8977b326a48ede0a872821dd'],0,0,0,2434530,0,,,,1791
752b8e3ee42f1bdb3d576185a3218451c2ba8a5b,0,Alex Behm,2014-01-15 15:11:13-08:00,['09eb510956d82744a1e955da4876fa95ed10b9e3'],3,4,7,2434537,1,,,,1791
60003ad211b92aaec8d5eb03cbe70865cecfde6f,1,Alex Behm,2014-01-15 15:11:23-08:00,['752b8e3ee42f1bdb3d576185a3218451c2ba8a5b'],75,165,240,2434777,8,1,1,1,1791
57af5fba8df880a504724edb9ef610f480d6f509,0,Alex Behm,2014-01-15 15:11:28-08:00,['60003ad211b92aaec8d5eb03cbe70865cecfde6f'],1,0,1,2434778,1,,,,1791
fc6ecd39e5a4d80163795375eaac19580d83fe86,1,Alex Behm,2014-01-15 15:11:32-08:00,['57af5fba8df880a504724edb9ef610f480d6f509'],2,17,19,2434797,4,,,,1791
5bdfc97987563f570925955c743136442cd9703d,0,Alex Behm,2014-01-15 15:11:37-08:00,['fc6ecd39e5a4d80163795375eaac19580d83fe86'],0,7,7,2434804,1,,,,1791
4a50ede4353853f81c3508fe12c8e7333f47e55b,1,Alex Behm,2014-01-15 15:11:41-08:00,['5bdfc97987563f570925955c743136442cd9703d'],18,38,56,2434860,2,0,1,0,1791
c295b5eda84a1ef1a93199056e0e7045a6656833,0,Alex Behm,2014-01-15 15:11:47-08:00,['4a50ede4353853f81c3508fe12c8e7333f47e55b'],15,56,71,2434931,7,0.130434783,0,0.956521739,1791
62f6c066a6e8538554dddc4215765e86d7176142,1,Alex Behm,2014-01-15 15:11:51-08:00,['c295b5eda84a1ef1a93199056e0e7045a6656833'],4,26,30,2434961,3,1,1,1,1791
d0dc0d04ff36ef3361030ad25582d57c1f18894b,0,Alex Behm,2014-01-15 15:11:56-08:00,['62f6c066a6e8538554dddc4215765e86d7176142'],0,1,1,2434962,1,,,,1791
56e9c838fb286dfc548838878db571de4882245d,1,Alex Behm,2014-01-15 15:12:00-08:00,['d0dc0d04ff36ef3361030ad25582d57c1f18894b'],15,71,86,2435048,1,,,,1791
dc7b398bd30cd1c49b9a0eae15221685e65f269d,1,Alex Behm,2014-01-15 15:12:04-08:00,['56e9c838fb286dfc548838878db571de4882245d'],405,2136,2541,2437589,42,0.403481013,0.618670886,0.974683544,1802
06147747061b20a8a99eb42e82f21a25c3d98a4f,0,Alex Behm,2014-01-15 15:12:04-08:00,['dc7b398bd30cd1c49b9a0eae15221685e65f269d'],30,76,106,2437695,9,0.222222222,0.972222222,0.972222222,1802
1dbb31a732e21574d5892db6707089026c8763f3,1,Alex Behm,2014-01-15 15:12:04-08:00,['06147747061b20a8a99eb42e82f21a25c3d98a4f'],13,63,76,2437771,14,0,0,0.952380952,1802
760750af27a9dc117adf5e22801df9a10916def5,1,Alex Behm,2014-01-15 15:12:05-08:00,['1dbb31a732e21574d5892db6707089026c8763f3'],35,59,94,2437865,12,0.05,0,1,1802
ab60e40aeba54048b966ca49a4f8611a6722d80d,0,Alex Behm,2014-01-15 15:12:05-08:00,['760750af27a9dc117adf5e22801df9a10916def5'],36,15,51,2437916,3,0.142857143,0,0.071428571,1802
d8ef4abab7b6687766a0531133f16283f52a6b44,0,Alex Behm,2014-01-15 15:12:05-08:00,['ab60e40aeba54048b966ca49a4f8611a6722d80d'],2,2,4,2437920,1,,,,1802
944cfc2e8230d089a02c119643247394b718520c,0,Alex Behm,2014-01-15 15:12:05-08:00,['d8ef4abab7b6687766a0531133f16283f52a6b44'],22,37,59,2437979,6,0,1,1,1802
c0c95aaffb632246d7e2ac05056cbfebcb6d0d37,0,Alex Behm,2014-01-15 15:12:06-08:00,['944cfc2e8230d089a02c119643247394b718520c'],0,1,1,2437980,1,1,1,1,1802
c70905628b4db0401afef5a77a31137d1cad1246,0,Alex Behm,2014-01-15 15:12:06-08:00,['c0c95aaffb632246d7e2ac05056cbfebcb6d0d37'],1,1,2,2437982,1,,,,1802
5cfbec913927d27c1a5f83a7ab9ac84ae5bba615,1,Alex Behm,2014-01-15 15:12:06-08:00,['c70905628b4db0401afef5a77a31137d1cad1246'],219,525,744,2438726,19,0.129032258,0.877419355,1,1805
6df1b69998f02ed5292d4cd793f14bcb232286cb,1,Alex Behm,2014-01-15 15:12:06-08:00,['5cfbec913927d27c1a5f83a7ab9ac84ae5bba615'],10,147,157,2438883,4,0,0.427083333,0.802083333,1806
e6299b684bd51117ee18d6857f776980c817f663,1,Alex Behm,2014-01-15 15:12:07-08:00,['6df1b69998f02ed5292d4cd793f14bcb232286cb'],50,105,155,2439038,6,0.575757576,0.545454545,0.545454545,1806
60025a09c380374add51043d12d13dae6885f8c5,0,Alex Behm,2014-01-15 15:12:07-08:00,['e6299b684bd51117ee18d6857f776980c817f663'],1,16,17,2439055,2,0,0,1,1806
18ba8330c8d6de2d5a59c70ee0a2ce6c4f7fe89f,1,Alex Behm,2014-01-15 15:12:07-08:00,['60025a09c380374add51043d12d13dae6885f8c5'],1,12,13,2439068,3,0.166666667,0.166666667,0.833333333,1806
2aea460a708faddbe15ca0af1506b00bc6b9ba3b,0,Alex Behm,2014-01-15 15:12:07-08:00,['18ba8330c8d6de2d5a59c70ee0a2ce6c4f7fe89f'],8,8,16,2439084,1,,,,1806
c74f6767f44ad2971fe2c4ef0077674eca89e2be,1,Alex Behm,2014-01-15 15:12:08-08:00,['2aea460a708faddbe15ca0af1506b00bc6b9ba3b'],1,39,40,2439124,4,0,1,1,1806
f4b809dd116ab537133f2586c46a8d36001003d8,1,Alex Behm,2014-01-15 15:12:08-08:00,['c74f6767f44ad2971fe2c4ef0077674eca89e2be'],60,161,221,2439345,4,0.433333333,0.183333333,0.983333333,1806
c733f112993c8dfd10a9b57b64f30a51988276a0,0,Alex Behm,2014-01-15 15:12:08-08:00,['f4b809dd116ab537133f2586c46a8d36001003d8'],11,35,46,2439391,6,0.176470588,0.176470588,0.705882353,1806
dbaf5aac7c6e066b16cb4c33c6945ccb338d8dfe,0,Alex Behm,2014-01-15 15:12:08-08:00,['c733f112993c8dfd10a9b57b64f30a51988276a0'],2,8,10,2439401,1,,,,1806
de611e329df375d57df876a4c798f830e3d91db5,0,Alex Behm,2014-01-15 15:12:09-08:00,['dbaf5aac7c6e066b16cb4c33c6945ccb338d8dfe'],1,12,13,2439414,1,0,0,1,1806
8318cbcbcf2810bfc8fca1628e3b0c98500c7745,1,Alex Behm,2014-01-15 15:12:09-08:00,['de611e329df375d57df876a4c798f830e3d91db5'],37,42,79,2439493,1,0,1,1,1806
f988c38cb64a64bf6c61c5f58b51ee6052b3859d,1,Alex Behm,2014-01-15 15:12:09-08:00,['8318cbcbcf2810bfc8fca1628e3b0c98500c7745'],7,44,51,2439544,4,0.363636364,0,1,1806
438b7703047693c78d07ed64eb193c01ba653a34,0,Alex Behm,2014-01-15 15:12:09-08:00,['f988c38cb64a64bf6c61c5f58b51ee6052b3859d'],1,2,3,2439547,1,0,0,1,1806
678edf76918dcb451889a3e3d4ab21c2dea0a14d,0,Alex Behm,2014-01-15 15:12:10-08:00,['438b7703047693c78d07ed64eb193c01ba653a34'],0,4,4,2439551,1,0,0,1,1806
1e6961bba75a409fb116e50b5dbbf3f23ae8a7ea,0,Alex Behm,2014-01-15 15:12:10-08:00,['678edf76918dcb451889a3e3d4ab21c2dea0a14d'],20,63,83,2439634,6,0.09375,0.59375,1,1806
29a32a507882e01886078f5b01a7d835bec2e6f6,0,Alex Behm,2014-01-15 15:12:10-08:00,['1e6961bba75a409fb116e50b5dbbf3f23ae8a7ea'],1,6,7,2439641,1,0,0,1,1806
6465f75da3ffc11874ac85ba967359477f02689a,0,Alex Behm,2014-01-15 15:12:10-08:00,['29a32a507882e01886078f5b01a7d835bec2e6f6'],1,1,2,2439643,1,,,,1806
dc93020ee9439b9a1fa552d8249a31a3e300056c,0,Alex Behm,2014-01-15 15:12:11-08:00,['6465f75da3ffc11874ac85ba967359477f02689a'],10,41,51,2439694,3,0,0,0.5,1806
bbb773982db444b8994acfecaae710c869156804,0,Alex Behm,2014-01-15 15:12:11-08:00,['dc93020ee9439b9a1fa552d8249a31a3e300056c'],1,2,3,2439697,1,0,0,1,1806
6458d170b6e17f9cc4d175b1f754b61361dbce4f,1,Alex Behm,2014-01-15 15:12:11-08:00,['bbb773982db444b8994acfecaae710c869156804'],16,54,70,2439767,2,0.2,0,1,1806
d2136d82b7a167f06268ee845043cb24102143fb,0,Alex Behm,2014-01-15 15:12:11-08:00,['6458d170b6e17f9cc4d175b1f754b61361dbce4f'],11,12,23,2439790,4,0,1,1,1806
9191f94b89fdd175451c8f62b720f2e72240401c,0,Alex Behm,2014-01-15 15:12:12-08:00,['d2136d82b7a167f06268ee845043cb24102143fb'],1,19,20,2439810,2,0,1,0,1806
5e853f8704f8fc0de707b13b38af21b62005f2dc,0,Alex Behm,2014-01-15 15:12:12-08:00,['9191f94b89fdd175451c8f62b720f2e72240401c'],4,6,10,2439820,1,,,,1806
ebf4ebeb8649ad6d6ade440599b039965ca39cab,0,Alex Behm,2014-01-15 15:12:12-08:00,['5e853f8704f8fc0de707b13b38af21b62005f2dc'],2,7,9,2439829,1,,,,1806
93f635e7e497908b65f7603eaf0a743a25059bb4,0,Alex Behm,2014-01-15 15:12:12-08:00,['ebf4ebeb8649ad6d6ade440599b039965ca39cab'],1,1,2,2439831,1,,,,1806
5ae53c2f8021b090542e1dfb75062117b6056994,0,Alex Behm,2014-01-15 15:12:12-08:00,['93f635e7e497908b65f7603eaf0a743a25059bb4'],13,10,23,2439854,4,,,,1806
53d7bbb97a9bbe73db47ec95bb4b7aad4681a4ae,1,Alex Behm,2014-01-15 15:12:13-08:00,['5ae53c2f8021b090542e1dfb75062117b6056994'],151,162,313,2440167,20,0.633802817,0.014084507,0,1806
04b501d3a1c1cf40f4de53f0556f1e58f75bcf35,0,Alex Behm,2014-01-15 15:12:20-08:00,['53d7bbb97a9bbe73db47ec95bb4b7aad4681a4ae'],5,74,79,2440246,9,0.344827586,0.896551724,0.448275862,1807
22ab2595d6932398ea5488de36b45f6cf448df38,0,Alex Behm,2014-01-15 15:12:24-08:00,['04b501d3a1c1cf40f4de53f0556f1e58f75bcf35'],12,12,24,2440270,2,,,,1807
9d79e00adcfb8fbb73ed397e17e6fc00473cac74,0,Alex Behm,2014-01-15 15:13:55-08:00,['22ab2595d6932398ea5488de36b45f6cf448df38'],0,0,0,2440270,0,,,,1807
b636fdefe0414cb771257c1bb9b60a4d4239482c,0,Alex Behm,2014-01-15 15:14:05-08:00,['9d79e00adcfb8fbb73ed397e17e6fc00473cac74'],24,80,104,2440374,4,0,0,1,1807
22b98b36c1dacbd154097c3423230e8f5f441f34,0,Henry Robinson,2014-01-15 21:16:39-08:00,['b636fdefe0414cb771257c1bb9b60a4d4239482c'],4,11,15,2440389,5,0.5,0.5,0,1807
69fe1c6c1027ddf40c4025c27d24760cf2199684,1,Henry Robinson,2014-01-17 14:32:55-08:00,['22b98b36c1dacbd154097c3423230e8f5f441f34'],1138,1208,2346,2442735,82,0.134615385,0,0.961538462,1807
241270044bb7918ba35a5baa9bf5b94ee35375ce,1,Henry Robinson,2014-01-17 14:33:18-08:00,['69fe1c6c1027ddf40c4025c27d24760cf2199684'],1,3,4,2442739,1,,,,1807
5535a8a1282d288b9db1f69aff7e46e2de9e9eed,0,Henry Robinson,2014-01-17 14:34:01-08:00,['241270044bb7918ba35a5baa9bf5b94ee35375ce'],1,1,2,2442741,1,,,,1807
3ee5c9a2f9a64c4fabb1448961a39832453cec28,0,Matthew Jacobs,2014-01-20 13:29:14-08:00,['5535a8a1282d288b9db1f69aff7e46e2de9e9eed'],1,1,2,2442743,1,,,,1807
9a62e6729b86e3d03058afebe01894b4c6af626e,1,Henry Robinson,2014-01-21 17:20:19-08:00,['3ee5c9a2f9a64c4fabb1448961a39832453cec28'],7,6,13,2442756,1,1,1,0,1807
44f3e3448fb91904c0b78767e75cbec871b04281,1,Henry Robinson,2014-01-21 19:23:26-08:00,['9a62e6729b86e3d03058afebe01894b4c6af626e'],49,88,137,2442893,17,0,1,1,1808
b4f5c1edcff6fce26349f34c7f32327ee24f0d76,1,Lenni Kuff,2014-01-21 21:43:29-08:00,['44f3e3448fb91904c0b78767e75cbec871b04281'],1069,1397,2466,2445359,36,0.685714286,1,1,1809
b0a7c4567feaad7d02dde70e94057faaf12a0311,0,Nong Li,2014-01-22 16:08:13-08:00,['b4f5c1edcff6fce26349f34c7f32327ee24f0d76'],2,4,6,2445365,1,,,,1809
af765efee2d356b600a40c7785e8dd1c779083e2,0,jenkins,2014-01-28 14:00:01-08:00,['b0a7c4567feaad7d02dde70e94057faaf12a0311'],3,0,3,2445368,1,0,0,0,1809
e97a1b52e0ed6e2a478c9e854e206684186f9c20,0,Lenni Kuff,2014-01-28 16:03:02-08:00,['af765efee2d356b600a40c7785e8dd1c779083e2'],22,0,22,2445390,2,,,,1809
3f68be2caad9b5ae4b34dacedda6526bac68ae11,1,jenkins,2014-01-28 17:18:17-08:00,['e97a1b52e0ed6e2a478c9e854e206684186f9c20'],29,80,109,2445499,13,0.777777778,0.777777778,1,1809
37fad61b96858d152711b16cc4279effa7cc9bc7,1,jenkins,2014-01-29 13:37:16-08:00,['3f68be2caad9b5ae4b34dacedda6526bac68ae11'],11,32,43,2445542,4,1,1,0.571428571,1809
3cff60c8eb10ce925c2853de3b1959029bd7c667,1,Skye Wanderman-Milne,2014-01-30 10:10:57-08:00,['37fad61b96858d152711b16cc4279effa7cc9bc7'],29,56,85,2445627,3,,,,1810
be67ab0ef95e600451aae3b8b1edbc3dd106dfc7,1,Skye Wanderman-Milne,2014-01-30 10:11:54-08:00,['3cff60c8eb10ce925c2853de3b1959029bd7c667'],2,2,4,2445631,1,,,,1810
057b4807ab4abfdd6b6b0b56781c785d653e243b,0,Skye Wanderman-Milne,2014-01-30 10:12:29-08:00,['be67ab0ef95e600451aae3b8b1edbc3dd106dfc7'],1,144,145,2445776,2,0.561403509,0.964912281,0.859649123,1810
6b769d011d2016a73483f63b311e108d17d9a083,1,jenkins,2014-01-30 14:58:46-08:00,['057b4807ab4abfdd6b6b0b56781c785d653e243b'],75,741,816,2446592,14,0.315384615,0.717948718,0.874358974,1812
01ef3ef4c1419c21db0055555719e45bfaa3bfdd,1,jenkins,2014-01-30 15:47:13-08:00,['6b769d011d2016a73483f63b311e108d17d9a083'],4,5,9,2446601,1,1,1,0,1812
42b904357a22342e4f3801f6253e7769fe3c2e2a,1,Lenni Kuff,2014-01-31 12:23:44-08:00,['01ef3ef4c1419c21db0055555719e45bfaa3bfdd'],10,8,18,2446619,2,,,,1812
62338694e421095281d9d825272e14e62c561e55,1,jenkins,2014-01-31 13:57:13-08:00,['42b904357a22342e4f3801f6253e7769fe3c2e2a'],21,73,94,2446713,3,1,1,1,1812
7a6892dcbedda4ed034a787585263f3dbae5bc2a,1,jenkins,2014-01-31 16:16:32-08:00,['62338694e421095281d9d825272e14e62c561e55'],678,621,1299,2448012,19,0.352941176,0,0,1814
c4879340e852067d9719ff212b7011ca4edfc297,0,jenkins,2014-02-01 10:05:19-08:00,['7a6892dcbedda4ed034a787585263f3dbae5bc2a'],1,41,42,2448054,6,0,1,1,1814
ccd8c0338f787355d0c8af5d06c32c1c349c0327,1,jenkins,2014-02-05 11:02:27-08:00,['c4879340e852067d9719ff212b7011ca4edfc297'],3,34,37,2448091,5,0.777777778,1,0.777777778,1814
98ca62a8f64b7df11d3079c49f3ab3228c4b36e2,0,Alex Behm,2014-02-05 12:29:31-08:00,['ccd8c0338f787355d0c8af5d06c32c1c349c0327'],0,0,0,2448091,0,,,,1814
6cd6e0af63591f59b50168fd7b54263fdadbc5d0,1,jenkins,2014-02-05 16:50:16-08:00,['98ca62a8f64b7df11d3079c49f3ab3228c4b36e2'],76,309,385,2448476,8,0,0.449612403,1,1814
8e6a998257e06a0c6f439f02d5f01da55715a5d3,0,jenkins,2014-02-05 19:30:02-08:00,['6cd6e0af63591f59b50168fd7b54263fdadbc5d0'],56,0,56,2448532,8,,,,1814
16af29ea5ff4845949882933d866a413ac523b83,1,Henry Robinson,2014-02-05 22:01:35-08:00,['8e6a998257e06a0c6f439f02d5f01da55715a5d3'],33,98,131,2448663,9,1,1,1,1814
7d578a9e540aac0e33c582486c249ca3862d4ac9,0,jenkins,2014-02-05 22:58:51-08:00,['16af29ea5ff4845949882933d866a413ac523b83'],2,6,8,2448671,2,,,,1814
56461563820e25a4c68d6edcf4d1c2badc43fc79,1,jenkins,2014-02-07 00:02:09-08:00,['7d578a9e540aac0e33c582486c249ca3862d4ac9'],96,142,238,2448909,5,0,0,1,1814
a7ff8da1a5f2709c4155c338492406beff605203,1,jenkins,2014-02-07 10:12:24-08:00,['56461563820e25a4c68d6edcf4d1c2badc43fc79'],16,893,909,2449818,14,0.191099476,0.67539267,0.934554974,1817
ac42ef5a5f73741f07817e53b469ad1d992d5665,0,jenkins,2014-02-08 15:06:57-08:00,['a7ff8da1a5f2709c4155c338492406beff605203'],5,8,13,2449831,2,0,0,1,1817
d94c7d2f3bcd54505361e22555757a9f38f8d5cd,1,jenkins,2014-02-10 04:56:40-08:00,['ac42ef5a5f73741f07817e53b469ad1d992d5665'],8,16,24,2449855,5,0.8,1,1,1817
1a55133f0aae585784ea61f6edc3905e702e010c,1,jenkins,2014-02-10 05:00:21-08:00,['d94c7d2f3bcd54505361e22555757a9f38f8d5cd'],6,31,37,2449892,5,0,0.25,0.75,1817
d5d4b4785bbae26a07cd479184a09d91c79e9fef,0,jenkins,2014-02-10 11:34:56-08:00,['1a55133f0aae585784ea61f6edc3905e702e010c'],2,2,4,2449896,1,,,,1817
b4ac26d8e9f24fb9b57d3ab0369a20e73843985c,1,Henry Robinson,2014-02-10 16:59:29-08:00,['d5d4b4785bbae26a07cd479184a09d91c79e9fef'],52,85,137,2450033,6,0,1,1,1817
80d4fd958e8810b7a7da45e42655e253719e1da5,1,jenkins,2014-02-10 18:51:39-08:00,['b4ac26d8e9f24fb9b57d3ab0369a20e73843985c'],18,142,160,2450193,11,0.176470588,0.980392157,0.862745098,1820
21652c02e8874beff727260e0e4a5911c94c4e8b,1,jenkins,2014-02-11 22:28:57-08:00,['80d4fd958e8810b7a7da45e42655e253719e1da5'],108,278,386,2450579,8,0.243902439,0.036585366,1,1820
3151972c980187f4be8977d13a8c9f937fa03357,1,Henry Robinson,2014-02-12 13:18:17-08:00,['21652c02e8874beff727260e0e4a5911c94c4e8b'],166,224,390,2450969,4,0.285714286,1,1,1820
0c6c74ca8ac4b501b74b76adb45674170b147fdc,1,Henry Robinson,2014-02-12 13:20:26-08:00,['3151972c980187f4be8977d13a8c9f937fa03357'],11,3,14,2450983,1,1,1,0,1820
bb227a20ca64aafd098c0fe4dd758687b49c67bf,1,jenkins,2014-02-12 23:42:23-08:00,['0c6c74ca8ac4b501b74b76adb45674170b147fdc'],17,50,67,2451050,3,0,0.703703704,0.777777778,1820
2754cb17b61203c280f294396c2a42101c628102,1,Henry Robinson,2014-02-13 17:19:12-08:00,['bb227a20ca64aafd098c0fe4dd758687b49c67bf'],4,12,16,2451066,1,0,1,1,1820
ab54f5051513cd44621e47fb4fef4eec63755320,1,Henry Robinson,2014-02-13 17:27:05-08:00,['2754cb17b61203c280f294396c2a42101c628102'],3,4,7,2451073,1,0,0,1,1820
95404d48888a559afef14eb0a6e334e31f11db20,1,jenkins,2014-02-13 23:43:06-08:00,['ab54f5051513cd44621e47fb4fef4eec63755320'],567,932,1499,2452572,42,0.292857143,0.7,0.964285714,1820
3722711a06ce0237d023053e7874d3e3440dc159,1,Nong Li,2014-02-14 00:22:08-08:00,['95404d48888a559afef14eb0a6e334e31f11db20'],0,1,1,2452573,1,,,,1820
35983952906b0634a6702bee2d8acf49e0fd29ee,1,Skye Wanderman-Milne,2014-02-14 10:44:54-08:00,['3722711a06ce0237d023053e7874d3e3440dc159'],0,26,26,2452599,2,1,1,1,1820
5f027f61c5318cf50978d04ba84e1c69543d65c8,1,jenkins,2014-02-17 17:56:49-08:00,['35983952906b0634a6702bee2d8acf49e0fd29ee'],36,28,64,2452663,4,0,0,0,1820
17febe7b0d18e6170a65598ce8a9acb18c816c6f,1,jenkins,2014-02-17 22:01:45-08:00,['5f027f61c5318cf50978d04ba84e1c69543d65c8'],10,9,19,2452682,1,1,1,0,1820
e3a0bedfe45581e064f669168975bdd186c73546,0,jenkins,2014-02-18 10:12:36-08:00,['17febe7b0d18e6170a65598ce8a9acb18c816c6f'],0,7,7,2452689,1,0,0,1,1820
d75de9cd3f1229f1818335ac1fa3e926800a9216,1,jenkins,2014-02-18 11:53:58-08:00,['e3a0bedfe45581e064f669168975bdd186c73546'],53,30,83,2452772,6,0,0,0,1820
52b48b9e1b6da174df8b8e6d50b9a65b73a12c26,0,jenkins,2014-02-18 16:53:28-08:00,['d75de9cd3f1229f1818335ac1fa3e926800a9216'],0,0,0,2452772,0,,,,1820
a60c4779c8fb635ae7023fe2f06e0328e5821b00,0,jenkins,2014-02-18 17:11:26-08:00,['52b48b9e1b6da174df8b8e6d50b9a65b73a12c26'],14,0,14,2452786,1,,,,1820
0d2919fe7f513388ff9d9b475419ba26979ce00a,1,jenkins,2014-02-18 18:40:08-08:00,['a60c4779c8fb635ae7023fe2f06e0328e5821b00'],3506,3076,6582,2459368,119,0.692307692,1,0,1822
1fc3b384edd9a53415888c1872164ec1f3609f5d,1,jenkins,2014-02-19 13:23:11-08:00,['0d2919fe7f513388ff9d9b475419ba26979ce00a'],9,27,36,2459404,3,1,1,1,1822
15f4f2c33a825af2d45ecc8870b3f08d068ffd2d,1,jenkins,2014-02-19 15:27:44-08:00,['1fc3b384edd9a53415888c1872164ec1f3609f5d'],66,270,336,2459740,6,0.269230769,1,1,1822
cb8150e8ee8c99a30df367660e6e46241f466a63,1,jenkins,2014-02-19 17:13:51-08:00,['15f4f2c33a825af2d45ecc8870b3f08d068ffd2d'],0,45,45,2459785,3,0.333333333,0,1,1822
bb028a54b74585b8a1d6820268bf9c305e8a4001,1,jenkins,2014-02-19 17:34:37-08:00,['cb8150e8ee8c99a30df367660e6e46241f466a63'],61,174,235,2460020,5,0.166666667,0,0.738095238,1822
11046facb06aab51091029c9111328488c76fc83,0,Skye Wanderman-Milne,2014-02-19 20:26:51-08:00,['bb028a54b74585b8a1d6820268bf9c305e8a4001'],10,24,34,2460054,1,0,0,1,1822
904ae86e823bae64da82cf071620c8b4a472f91c,1,jenkins,2014-02-20 13:12:10-08:00,['11046facb06aab51091029c9111328488c76fc83'],140,283,423,2460477,28,0.807228916,0.963855422,0.831325301,1822
af84be67dd8a156c8ab78776b679336bceae414d,1,jenkins,2014-02-20 14:19:34-08:00,['904ae86e823bae64da82cf071620c8b4a472f91c'],131,287,418,2460895,13,0.012195122,0.634146341,0.341463415,1822
9156cb94ca648b64cb0b88150574b802e22a6422,1,jenkins,2014-02-20 14:48:30-08:00,['af84be67dd8a156c8ab78776b679336bceae414d'],8,468,476,2461371,5,0.221343874,0.383399209,0.727272727,1823
3d764619f7c051a33d9d05505c25f2ff110aacd3,1,jenkins,2014-02-20 15:43:31-08:00,['9156cb94ca648b64cb0b88150574b802e22a6422'],75,48,123,2461494,9,,,,1824
af7d38d5d3da44dadd53dd7f612bdad34fd0296d,1,Lenni Kuff,2014-02-21 09:35:27-08:00,['3d764619f7c051a33d9d05505c25f2ff110aacd3'],1,4,5,2461499,1,0,1,1,1824
83414c56d91f64fed3375ba5b46dacaccfc99572,1,Lenni Kuff,2014-02-21 11:59:21-08:00,['af7d38d5d3da44dadd53dd7f612bdad34fd0296d'],7,87,94,2461593,4,0.411764706,0.941176471,0.911764706,1825
315e3fca98da6d6b6dc00278d7fef4b623fa5cd1,1,jenkins,2014-02-23 00:16:24-08:00,['83414c56d91f64fed3375ba5b46dacaccfc99572'],130,157,287,2461880,2,1,0.727272727,1,1826
d6cbd3dc441137ff2d4b8dc3df143ff9f07f616c,1,jenkins,2014-02-23 00:20:16-08:00,['315e3fca98da6d6b6dc00278d7fef4b623fa5cd1'],7,24,31,2461911,5,0,1,1,1826
aef01a305187f0ef80093edab1cdd0fdc9cddcda,0,Henry Robinson,2014-02-25 09:58:55-08:00,['d6cbd3dc441137ff2d4b8dc3df143ff9f07f616c'],3,3,6,2461917,2,,,,1826
8223e1e44b67f7f69826ac31a10d0aa21b658fbd,0,jenkins,2014-02-25 17:33:53-08:00,['aef01a305187f0ef80093edab1cdd0fdc9cddcda'],0,45,45,2461962,2,,,,1827
9cabee4a7179ee4e849b09d99fbb9fa0913dce06,0,jenkins,2014-02-25 21:05:33-08:00,['8223e1e44b67f7f69826ac31a10d0aa21b658fbd'],15,163,178,2462140,7,0.6,1,0.8,1829
313c3f371b1a3d6fe57f4c831d1899ed27b2925a,1,jenkins,2014-02-27 00:11:26-08:00,['9cabee4a7179ee4e849b09d99fbb9fa0913dce06'],275,286,561,2462701,40,1,1,1,1829
8ac929f09566e9909d5f56b5ef535fd84393cbf7,1,jenkins,2014-02-27 13:34:29-08:00,['313c3f371b1a3d6fe57f4c831d1899ed27b2925a'],177,301,478,2463179,7,0.955882353,0.602941176,0.779411765,1829
80658d9eabeafdfbd7de4d7025ab7fd766dee063,0,jenkins,2014-02-27 19:58:13-08:00,['8ac929f09566e9909d5f56b5ef535fd84393cbf7'],3,21,24,2463203,3,0,0.5,0,1829
a52b002757036ef4d6f73ecf5edcdd596bce6e4d,1,jenkins,2014-02-27 20:38:26-08:00,['80658d9eabeafdfbd7de4d7025ab7fd766dee063'],164,262,426,2463629,29,1,1,1,1831
fcd9ab49788f2a36cd89a61e03713e6587f25bbb,0,Skye Wanderman-Milne,2014-02-27 22:21:28-08:00,['a52b002757036ef4d6f73ecf5edcdd596bce6e4d'],21,9,30,2463659,2,0,0,0,1831
75e89263fb295689dc0d687f9038ae9251554795,1,jenkins,2014-02-28 10:40:55-08:00,['fcd9ab49788f2a36cd89a61e03713e6587f25bbb'],7,24,31,2463690,4,0,0,1,1831
098ad99b821f9ee249910af1db266b8d1d8f4696,0,jenkins,2014-02-28 10:42:48-08:00,['75e89263fb295689dc0d687f9038ae9251554795'],0,2,2,2463692,1,,,,1831
1e88e6d0c07e37a30a3100dadbe36e868c530edc,0,Henry Robinson,2014-02-28 14:32:22-08:00,['098ad99b821f9ee249910af1db266b8d1d8f4696'],11,13,24,2463716,2,1,1,0,1831
6a7d7ab858d3753c0f7e9ebf6ac85f4cdda59142,0,jenkins,2014-02-28 22:22:57-08:00,['1e88e6d0c07e37a30a3100dadbe36e868c530edc'],0,18,18,2463734,2,0,1,1,1831
bf16b5cd0d3be684aaacb340bbe0e138246351a3,1,jenkins,2014-02-28 22:30:45-08:00,['6a7d7ab858d3753c0f7e9ebf6ac85f4cdda59142'],8,302,310,2464044,5,0.712121212,1,0.454545455,1834
19e642e5830df2606441fced47d532931accd926,1,jenkins,2014-03-01 00:23:49-08:00,['bf16b5cd0d3be684aaacb340bbe0e138246351a3'],517,518,1035,2465079,17,0,0.379310345,0.862068966,1835
7a5222a3618790826b233c91bf86e23b8440b241,1,jenkins,2014-03-01 00:29:33-08:00,['19e642e5830df2606441fced47d532931accd926'],127,182,309,2465388,5,0.611111111,1,1,1835
8a16709265ec60232d2211209c02652db1cfd2ac,1,jenkins,2014-03-01 17:16:50-08:00,['7a5222a3618790826b233c91bf86e23b8440b241'],22,62,84,2465472,5,0.413793103,0.606896552,0.937931034,1835
203fc664563062242258e0da7c8da166619ecc20,1,jenkins,2014-03-01 20:24:30-08:00,['8a16709265ec60232d2211209c02652db1cfd2ac'],28,146,174,2465646,13,0.35443038,0.430379747,0.696202532,1835
309ab4df0d2d8ff4003de46bcb4dc233b242ca3c,1,jenkins,2014-03-02 00:36:33-08:00,['203fc664563062242258e0da7c8da166619ecc20'],23,113,136,2465782,14,0.025,0.2,0.625,1835
d816e0fc5146e587da82477279ff23e6618391b9,1,jenkins,2014-03-02 20:57:49-08:00,['309ab4df0d2d8ff4003de46bcb4dc233b242ca3c'],0,174,174,2465956,5,0.177777778,1,1,1838
00eca313f1ea7bd0337b5d1df8d4152e7f3d0a04,0,jenkins,2014-03-03 16:19:10-08:00,['d816e0fc5146e587da82477279ff23e6618391b9'],1,1,2,2465958,1,,,,1838
f71767c612e3d98062383f894ac5dc49a24c2ced,0,jenkins,2014-03-03 16:50:36-08:00,['00eca313f1ea7bd0337b5d1df8d4152e7f3d0a04'],0,21,21,2465979,1,,,,1838
09f77a941f26c1ec656bb229f0e0cd4765eaf91b,0,jenkins,2014-03-03 17:01:53-08:00,['f71767c612e3d98062383f894ac5dc49a24c2ced'],2,7,9,2465988,2,0,0,1,1838
b879b4c2e44ae9141c02fc3ef6771d9d28e4058a,1,jenkins,2014-03-03 19:44:51-08:00,['09f77a941f26c1ec656bb229f0e0cd4765eaf91b'],41,70,111,2466099,5,0,0.555555556,0.814814815,1838
f0a67153d388f68f761d1518e38527cdbdf639f0,1,jenkins,2014-03-03 21:15:00-08:00,['b879b4c2e44ae9141c02fc3ef6771d9d28e4058a'],285,1024,1309,2467408,78,0.126948775,0.371937639,0.832962138,1840
1a01bc04aca4c5db5893332cb4631346ca803d60,1,jenkins,2014-03-04 01:37:45-08:00,['f0a67153d388f68f761d1518e38527cdbdf639f0'],68,108,176,2467584,9,0.590909091,1,1,1840
6d8090df69e733ac0ba7023fe502fc18c89269c7,1,jenkins,2014-03-04 03:41:46-08:00,['1a01bc04aca4c5db5893332cb4631346ca803d60'],5,13,18,2467602,4,0.5,0.5,1,1840
00724a47dabc3146200f45d63d85ba2c1a9c79ed,0,jenkins,2014-03-04 09:59:50-08:00,['6d8090df69e733ac0ba7023fe502fc18c89269c7'],0,6,6,2467608,1,,,,1840
68f6d57809c9945b5551cc5776560e8bdd722dc0,1,jenkins,2014-03-04 21:39:47-08:00,['00724a47dabc3146200f45d63d85ba2c1a9c79ed'],9,55,64,2467672,4,0.681818182,0.863636364,0.863636364,1840
f6a297568d56adda92c5685493799cef14ce1860,1,Henry Robinson,2014-03-04 22:26:55-08:00,['68f6d57809c9945b5551cc5776560e8bdd722dc0'],69,42,111,2467783,20,0,0,0,1840
9e043e862c71d627402c48e44eb2b23a5ce2a4ba,0,Ishaan Joshi,2014-03-05 01:04:56-08:00,['f6a297568d56adda92c5685493799cef14ce1860'],3,3,6,2467789,2,,,,1840
4c202b61f32b80e9a30dabb060130a88d689617c,0,ishaan,2014-03-05 01:05:40-08:00,['9e043e862c71d627402c48e44eb2b23a5ce2a4ba'],0,0,0,2467789,0,,,,1840
2814f9aff561eab7da45fbdefbed00b7b56faf2b,0,ishaan,2014-03-05 01:05:49-08:00,['4c202b61f32b80e9a30dabb060130a88d689617c'],0,0,0,2467789,0,,,,1840
a283d72cddb7605308dfaa64ecae0c281d612cdf,0,ishaan,2014-03-05 01:06:09-08:00,['2814f9aff561eab7da45fbdefbed00b7b56faf2b'],1,1,2,2467791,1,,,,1840
2b1bf02d74b5027db45b74c0a7c587dadfc459a9,1,ishaan,2014-03-05 01:06:11-08:00,['a283d72cddb7605308dfaa64ecae0c281d612cdf'],7,10,17,2467808,2,0,1,1,1840
69a840d9651e0da9299b06c77adb457c8c770027,1,jenkins,2014-03-05 05:38:30-08:00,['2b1bf02d74b5027db45b74c0a7c587dadfc459a9'],33,41,74,2467882,5,1,1,1,1840
6ceed1e632b5c1a4b5b94f3dc6833e7a8170cab5,1,jenkins,2014-03-05 07:32:34-08:00,['69a840d9651e0da9299b06c77adb457c8c770027'],221,1292,1513,2469395,61,0.556862745,0.533333333,0.794117647,1843
04dc1859939a85f390ec1d05fc98d548e9c6779f,1,Alex Behm,2014-03-05 15:24:53-08:00,['6ceed1e632b5c1a4b5b94f3dc6833e7a8170cab5'],22,32,54,2469449,1,0.625,0.625,1,1843
0b6832928bbc2714f1b554bd3ca49219e103ea79,0,ishaan,2014-03-06 01:06:05-08:00,['04dc1859939a85f390ec1d05fc98d548e9c6779f'],1,1,2,2469451,1,,,,1843
66a6c1f312c037fdd69fc55cb775b9905b9dd482,0,jenkins,2014-03-06 07:37:14-08:00,['0b6832928bbc2714f1b554bd3ca49219e103ea79'],18,18,36,2469487,2,,,,1843
fc5ac1f7076978defe79c4ffa5fdf15ad92272d2,1,jenkins,2014-03-06 11:21:44-08:00,['66a6c1f312c037fdd69fc55cb775b9905b9dd482'],2,12,14,2469501,1,,,,1843
d675c9987f816f9855e0580d1e78d7b641277306,1,Nong Li,2014-03-06 13:23:52-08:00,['fc5ac1f7076978defe79c4ffa5fdf15ad92272d2'],4,4,8,2469509,1,,,,1843
76e43e8d35665148eac6e05e03872e06a7beacc9,0,jenkins,2014-03-06 13:50:52-08:00,['d675c9987f816f9855e0580d1e78d7b641277306'],5,9,14,2469523,1,0,1,1,1843
41d90312faafd696854fc4a617d50066fc349d88,1,jenkins,2014-03-06 14:21:31-08:00,['76e43e8d35665148eac6e05e03872e06a7beacc9'],50,1162,1212,2470735,17,0.366925065,0.865633075,0.84754522,1853
989830186f12a6f1c6a2c57a950862ad9e02616c,1,jenkins,2014-03-06 14:46:09-08:00,['41d90312faafd696854fc4a617d50066fc349d88'],228,22,250,2470985,12,0.984848485,0.727272727,0.21969697,1853
e144ae241ebc7682b62d61c248432cfdc2822966,0,Lenni Kuff,2014-03-06 15:39:47-08:00,['989830186f12a6f1c6a2c57a950862ad9e02616c'],0,0,0,2470985,0,,,,1853
569614b73d026ca956833e613b49af5d6900778b,0,Lenni Kuff,2014-03-06 15:40:04-08:00,['e144ae241ebc7682b62d61c248432cfdc2822966'],0,0,0,2470985,0,,,,1853
3744bbb676ad19c5de357a5bf526e70410b6a486,0,jenkins,2014-03-07 05:58:17-08:00,['569614b73d026ca956833e613b49af5d6900778b'],26,53,79,2471064,4,0.230769231,1,1,1853
aa4a2b6ee845bcdda2d7074a278da59d2ecebeba,0,jenkins,2014-03-07 06:14:34-08:00,['3744bbb676ad19c5de357a5bf526e70410b6a486'],1,6,7,2471071,1,0,0,1,1853
da1c7d37ff9d738c17250cd079341bd4b6322f19,1,jenkins,2014-03-07 08:58:05-08:00,['aa4a2b6ee845bcdda2d7074a278da59d2ecebeba'],227,954,1181,2472252,26,0.415384615,0.624615385,0.901538462,1855
f36a90004842e51effac916f9b4e6a5af45471a8,0,jenkins,2014-03-07 12:24:51-08:00,['da1c7d37ff9d738c17250cd079341bd4b6322f19'],5,2,7,2472259,1,0,1,1,1855
e23964e123abfcda3f4749d32171782c38428f26,0,jenkins,2014-03-07 14:17:03-08:00,['f36a90004842e51effac916f9b4e6a5af45471a8'],1,0,1,2472260,1,1,1,0,1855
d0386083fb3ed32cefeb7af888865f592cb32178,1,jenkins,2014-03-07 14:49:57-08:00,['e23964e123abfcda3f4749d32171782c38428f26'],3,1,4,2472264,1,1,0,0,1855
d64c516fa83df51d919637b80707502e98385268,1,jenkins,2014-03-07 15:46:08-08:00,['d0386083fb3ed32cefeb7af888865f592cb32178'],14,39,53,2472317,1,1,1,0,1855
57fb848f910a3a7a9d833326713cc78d837dc526,1,jenkins,2014-03-07 16:41:05-08:00,['d64c516fa83df51d919637b80707502e98385268'],4,145,149,2472466,5,0.115789474,0.115789474,0.968421053,1855
bd9c05eadd8f9787110d701b7e3fd660ae87c9b0,1,jenkins,2014-03-07 18:00:04-08:00,['57fb848f910a3a7a9d833326713cc78d837dc526'],4,61,65,2472531,2,0,1,1,1855
23c619f794c01d5b7a2ab1015b0725c81ae7550c,0,jenkins,2014-03-07 18:44:11-08:00,['bd9c05eadd8f9787110d701b7e3fd660ae87c9b0'],0,5,5,2472536,1,1,1,1,1855
f7c2781afe52190ec7fde8779756ff5da7043a88,1,jenkins,2014-03-07 21:45:16-08:00,['23c619f794c01d5b7a2ab1015b0725c81ae7550c'],5,67,72,2472608,3,0,0,0,1855
a615ebc549e7d4824272c96bfa0cba2d20e8413a,1,jenkins,2014-03-08 00:25:26-08:00,['f7c2781afe52190ec7fde8779756ff5da7043a88'],18,76,94,2472702,7,0,0.428571429,1,1855
fe4f3babe521aea4c98e0db9f426444d4496c682,1,jenkins,2014-03-08 04:22:39-08:00,['a615ebc549e7d4824272c96bfa0cba2d20e8413a'],198,429,627,2473329,11,1,0.047619048,0,1855
3cdb2d9fb17405da057c2ccf7335b137f46041a5,1,jenkins,2014-03-08 06:04:37-08:00,['fe4f3babe521aea4c98e0db9f426444d4496c682'],15,73,88,2473417,3,0.543478261,1,0.608695652,1855
91a200dabe3655b5c7429552ddb388ca50c99988,0,jenkins,2014-03-08 10:43:37-08:00,['3cdb2d9fb17405da057c2ccf7335b137f46041a5'],2,10,12,2473429,2,0,1,1,1855
f7dd4f4bb71e82816a93baadd6370df4c05f7353,0,jenkins,2014-03-08 12:54:30-08:00,['91a200dabe3655b5c7429552ddb388ca50c99988'],13,21,34,2473463,1,,,,1855
985d90146e13f7bf5b92adb9ca92f2ae4b3a4e57,0,jenkins,2014-03-08 13:09:33-08:00,['f7dd4f4bb71e82816a93baadd6370df4c05f7353'],0,109,109,2473572,4,0.367346939,0.367346939,1,1855
05c8e4da933b4307254ad9d9d098a32b9ea4b651,1,jenkins,2014-03-08 13:21:06-08:00,['985d90146e13f7bf5b92adb9ca92f2ae4b3a4e57'],79,122,201,2473773,5,0.625,0,0,1855
f2e37534706b1f710cbbc675e4e42936c2dffe0d,0,jenkins,2014-03-08 14:48:58-08:00,['05c8e4da933b4307254ad9d9d098a32b9ea4b651'],0,4,4,2473777,1,,,,1855
23d394c57289b2c34f181ca13263f3c9a335722a,0,jenkins,2014-03-08 16:53:49-08:00,['f2e37534706b1f710cbbc675e4e42936c2dffe0d'],4,9,13,2473790,2,0,1,1,1855
942d97ef1370b9e59432a3e6afead58d36888417,1,jenkins,2014-03-10 14:22:16-07:00,['23d394c57289b2c34f181ca13263f3c9a335722a'],2,4,6,2473796,1,0.5,1,0.5,1855
f6de8d9e30eadf887382a9425f3599a290c86b90,0,jenkins,2014-03-10 15:20:53-07:00,['942d97ef1370b9e59432a3e6afead58d36888417'],100,130,230,2474026,6,0,0,1,1855
6038b7593f3769fb91bc6df98c8a97ede5ede916,1,jenkins,2014-03-10 18:55:00-07:00,['f6de8d9e30eadf887382a9425f3599a290c86b90'],65,234,299,2474325,5,0.142857143,1,0.802197802,1855
5022aa08fb8a6e794766cfef23b5cc2ff70a67b7,0,jenkins,2014-03-11 17:26:31-07:00,['6038b7593f3769fb91bc6df98c8a97ede5ede916'],2,12,14,2474339,2,,,,1855
85bc9d96e6371cb094fb381054df4ca430e7b7d9,1,jenkins,2014-03-11 17:34:04-07:00,['5022aa08fb8a6e794766cfef23b5cc2ff70a67b7'],12,25,37,2474376,4,0.375,0.375,0.875,1855
47c52ade8493e9ffdb26c0773a5a0101aa19d1e9,0,jenkins,2014-03-11 18:20:15-07:00,['85bc9d96e6371cb094fb381054df4ca430e7b7d9'],461,462,923,2475299,15,0,0,1,1855
08417c875f9281ffe62d01bf8e295e665df183b5,1,Lenni Kuff,2014-03-11 18:42:08-07:00,['47c52ade8493e9ffdb26c0773a5a0101aa19d1e9'],19,385,404,2475703,8,0.435483871,0.822580645,1,1857
748ea3f38b093c10a2dc235ea2c4751732444d7f,0,jenkins,2014-03-12 11:25:17-07:00,['08417c875f9281ffe62d01bf8e295e665df183b5'],9,11,20,2475723,2,,,,1857
5966492a61bee1bb5313a4e7acad922ed6a9e4bb,0,jenkins,2014-03-12 13:28:08-07:00,['748ea3f38b093c10a2dc235ea2c4751732444d7f'],8,11,19,2475742,3,0,0.666666667,1,1857
e817c3742c27e9bd3218c750355a3a7355fbf9f6,1,jenkins,2014-03-12 14:23:54-07:00,['5966492a61bee1bb5313a4e7acad922ed6a9e4bb'],258,317,575,2476317,18,0,0,0.583333333,1858
8fa8a0f8282eff184db248e2ac0ef4acb6347dab,1,jenkins,2014-03-12 14:44:18-07:00,['e817c3742c27e9bd3218c750355a3a7355fbf9f6'],8,39,47,2476364,7,0.714285714,0.857142857,1,1858
58950a52a332c04cd9be6876a8743a07fb41d2c6,1,jenkins,2014-03-12 16:51:50-07:00,['8fa8a0f8282eff184db248e2ac0ef4acb6347dab'],29,157,186,2476550,14,0,0,1,1859
b1aeea3f0b7d22a277e313cb330ef30484f6fcc9,0,Nong Li,2014-03-12 18:55:06-07:00,['58950a52a332c04cd9be6876a8743a07fb41d2c6'],236,246,482,2477032,7,0.975609756,0.136585366,0,1859
7fcd7cd64efbd3c70d5b46bf82d5652b2dbc70d2,1,jenkins,2014-03-12 21:15:22-07:00,['b1aeea3f0b7d22a277e313cb330ef30484f6fcc9'],29,323,352,2477384,15,0.3,0,0.74,1859
c503c8789197b4809c372f238f96587b9fcb0254,1,Henry Robinson,2014-03-12 22:11:49-07:00,['7fcd7cd64efbd3c70d5b46bf82d5652b2dbc70d2'],8,11,19,2477403,4,1,1,1,1859
d640273a3f967c18b99c8d11453e22a69c46124d,1,jenkins,2014-03-13 04:39:48-07:00,['c503c8789197b4809c372f238f96587b9fcb0254'],10,104,114,2477517,4,0,0,1,1859
cc1c0c61fdbc5cc8f99077bedf14bb4c68546cc4,1,jenkins,2014-03-13 13:00:15-07:00,['d640273a3f967c18b99c8d11453e22a69c46124d'],66,283,349,2477866,12,0.165048544,0.961165049,0.708737864,1861
15e05082c00fe7f29ddd2886bb109e17954123ba,1,jenkins,2014-03-13 15:42:31-07:00,['cc1c0c61fdbc5cc8f99077bedf14bb4c68546cc4'],286,1377,1663,2479529,13,0.419354839,0.274193548,0.564516129,1861
3311e3f92ccc23ce84d7cd262c4f2731083336d0,1,Matthew Jacobs,2014-03-13 16:33:21-07:00,['15e05082c00fe7f29ddd2886bb109e17954123ba'],0,2,2,2479531,2,0,0.5,1,1861
e02a1159fa1a253ebb2e6dab5eb3b4212ff4b7fa,0,Matthew Jacobs,2014-03-13 18:57:13-07:00,['3311e3f92ccc23ce84d7cd262c4f2731083336d0'],2,3,5,2479536,1,0,0,0,1861
8571c76b98ce1d4dbff4574c61cffb6c5cc2f39b,0,Matthew Jacobs,2014-03-13 19:21:40-07:00,['e02a1159fa1a253ebb2e6dab5eb3b4212ff4b7fa'],2,2,4,2479540,1,,,,1861
54276c2bcbec2d7dea676d134c944fa2d826b131,0,Henry Robinson,2014-03-13 22:22:37-07:00,['8571c76b98ce1d4dbff4574c61cffb6c5cc2f39b'],1,2,3,2479543,1,,,,1861
79b2ce3bcc2578812ab8e179dc4fc2f35c51f7a6,1,jenkins,2014-03-14 00:50:03-07:00,['54276c2bcbec2d7dea676d134c944fa2d826b131'],85,115,200,2479743,2,0,1,0,1861
01d25f5a81d894102c5d678c43d459c1e6e4c139,1,jenkins,2014-03-14 01:39:16-07:00,['79b2ce3bcc2578812ab8e179dc4fc2f35c51f7a6'],0,7,7,2479750,3,0.5,1,1,1861
86f69fb96fac8c7260d24620d83bf4490a968a0f,0,Lenni Kuff,2014-03-14 08:45:16-07:00,['01d25f5a81d894102c5d678c43d459c1e6e4c139'],10,13,23,2479773,5,,,,1861
fd174a5e691fd6f99c046d419a3d50d1128a401a,1,jenkins,2014-03-14 14:30:08-07:00,['86f69fb96fac8c7260d24620d83bf4490a968a0f'],97,185,282,2480055,4,0.514285714,0,0.457142857,1861
6629c32d6a7867fd454f51cd726cff05977ffea7,1,jenkins,2014-03-14 16:08:45-07:00,['fd174a5e691fd6f99c046d419a3d50d1128a401a'],75,155,230,2480285,3,0.181818182,0.545454545,1,1862
1b99829e3442648f735979bf3d704d4d1dc7997c,0,jenkins,2014-03-14 16:50:18-07:00,['6629c32d6a7867fd454f51cd726cff05977ffea7'],11,24,35,2480320,3,0.363636364,0.818181818,1,1862
aa0b7a35f5ddf22898bb34e4eba9413251d10b3c,1,jenkins,2014-03-14 19:20:12-07:00,['1b99829e3442648f735979bf3d704d4d1dc7997c'],28,1317,1345,2481665,6,0.105263158,0,0.684210526,1863
ce40134ad013187fb86b205661d06fd0e1bde30b,1,jenkins,2014-03-14 23:24:55-07:00,['aa0b7a35f5ddf22898bb34e4eba9413251d10b3c'],1,348,349,2482014,5,0.015873016,0.26984127,1,1863
74a975c45b02b6bfb47ccad7d6dc99dec8f6b4cb,1,jenkins,2014-03-14 23:35:55-07:00,['ce40134ad013187fb86b205661d06fd0e1bde30b'],164,242,406,2482420,11,0,0,0.166666667,1863
f4cfc755448cb8171ae266aa017a80eb6d4128a5,1,jenkins,2014-03-15 05:18:11-07:00,['74a975c45b02b6bfb47ccad7d6dc99dec8f6b4cb'],36,202,238,2482658,3,0.545454545,0.545454545,0.181818182,1863
9e90c923ac00df06a401fd544d7828797c21c841,1,jenkins,2014-03-15 10:33:44-07:00,['f4cfc755448cb8171ae266aa017a80eb6d4128a5'],12,10,22,2482680,1,1,1,0,1863
2caf687d8d0fe3935f5e83a24e8ee70848509ccd,0,jenkins,2014-03-15 20:13:20-07:00,['9e90c923ac00df06a401fd544d7828797c21c841'],1,3,4,2482684,1,,,,1863
7fa41471f6ef4e6f1e1e2a6cec667a2fad5c37b2,0,Henry Robinson,2014-03-16 11:41:26-07:00,['2caf687d8d0fe3935f5e83a24e8ee70848509ccd'],13,63,76,2482760,6,0,1,1,1864
88a54dc5320d5bdbed62933a515b4126a70a48a3,0,Nong Li,2014-03-16 15:37:37-07:00,['7fa41471f6ef4e6f1e1e2a6cec667a2fad5c37b2'],0,2,2,2482762,1,1,1,1,1864
3c199255176e49fb4d6a3b3ade2189229937e9c5,1,jenkins,2014-03-17 14:52:54-07:00,['88a54dc5320d5bdbed62933a515b4126a70a48a3'],16,8,24,2482786,4,1,1,0,1864
be18bd8f76760640aa296ac262c3224e04780f22,0,jenkins,2014-03-17 14:54:46-07:00,['3c199255176e49fb4d6a3b3ade2189229937e9c5'],3,29,32,2482818,2,0.833333333,0.833333333,0.833333333,1864
c6833c0a8394dd901d3b27218c0db91060412580,1,Nong Li,2014-03-17 16:49:31-07:00,['be18bd8f76760640aa296ac262c3224e04780f22'],137,191,328,2483146,29,0,1,1,1864
dd20958e5dc40283c1bf209c8b3b7ca164d82cab,0,jenkins,2014-03-17 17:30:15-07:00,['c6833c0a8394dd901d3b27218c0db91060412580'],108,3,111,2483257,4,0.574074074,0,0.574074074,1864
635dd7d28998d85e00328b22e576968a539ff800,1,jenkins,2014-03-17 17:35:12-07:00,['dd20958e5dc40283c1bf209c8b3b7ca164d82cab'],5,53,58,2483315,5,0.888888889,0.888888889,1,1865
d7c06486e1030ea37e3d014cd3f0b62df82e2572,0,Lenni Kuff,2014-03-17 17:42:21-07:00,['635dd7d28998d85e00328b22e576968a539ff800'],0,2,2,2483317,1,,,,1865
4638505cba6a0fea64cc7be1d4eb136223b3e33b,1,jenkins,2014-03-17 18:40:01-07:00,['d7c06486e1030ea37e3d014cd3f0b62df82e2572'],8,40,48,2483365,4,1,1,1,1867
44125729dc7d1e12e7ee2fad83254eebcb435ac5,1,jenkins,2014-03-17 20:38:25-07:00,['4638505cba6a0fea64cc7be1d4eb136223b3e33b'],187,559,746,2484111,30,0.551351351,0.140540541,0.486486486,1871
8728dc4cbb813e00d9e2541b96d384fe61c86b35,1,jenkins,2014-03-17 20:56:33-07:00,['44125729dc7d1e12e7ee2fad83254eebcb435ac5'],1,9,10,2484121,2,0,0,1,1871
5137a7eab49002ee1df2659c4b3e872486d5ba22,0,jenkins,2014-03-17 22:03:42-07:00,['8728dc4cbb813e00d9e2541b96d384fe61c86b35'],9,22,31,2484152,2,0,0.5,0.6,1871
c0654cf60e8eab37038554817cb26bd2c25ba900,0,jenkins,2014-03-17 22:17:52-07:00,['5137a7eab49002ee1df2659c4b3e872486d5ba22'],15,26,41,2484193,2,1,1,1,1871
9c2dfb90f1acc1c06a7b7dc49ae3987042a156dd,0,Lenni Kuff,2014-03-17 23:42:26-07:00,['c0654cf60e8eab37038554817cb26bd2c25ba900'],0,0,0,2484193,0,,,,1871
99d0c0a961640cb884434f77f040927ce76d1a82,0,Lenni Kuff,2014-03-17 23:43:52-07:00,['9c2dfb90f1acc1c06a7b7dc49ae3987042a156dd'],0,0,0,2484193,0,,,,1871
b7432cd68af26bf6ede67911b9f5aefd4aad783d,0,jenkins,2014-03-18 11:51:19-07:00,['99d0c0a961640cb884434f77f040927ce76d1a82'],0,1,1,2484194,1,1,1,1,1871
9c3b318112f3d955e6b0f3560ee858e7426c7d80,1,jenkins,2014-03-18 13:24:10-07:00,['b7432cd68af26bf6ede67911b9f5aefd4aad783d'],2,2,4,2484198,1,,,,1871
240ae7ec81637b1ff99951983bc769eb89e7e8ba,1,Henry Robinson,2014-03-18 16:09:23-07:00,['9c3b318112f3d955e6b0f3560ee858e7426c7d80'],2,2,4,2484202,1,,,,1871
5d90380bfdd002c794d7515684a3003aee9cf219,0,Nong Li,2014-03-18 16:38:50-07:00,['240ae7ec81637b1ff99951983bc769eb89e7e8ba'],19,22,41,2484243,1,,,,1871
457055f8f4df293149a4829c356f5bf0d8a4deb2,0,jenkins,2014-03-18 16:49:34-07:00,['5d90380bfdd002c794d7515684a3003aee9cf219'],1,17,18,2484261,3,0,0,1,1871
70c05d4caa624755589ef1aa34635504372a7988,1,jenkins,2014-03-18 18:46:54-07:00,['457055f8f4df293149a4829c356f5bf0d8a4deb2'],7,40,47,2484308,4,0.941176471,0.941176471,0.647058824,1872
6baf19507270abd617beb6e83af0dd13cebaae7a,1,jenkins,2014-03-18 20:41:29-07:00,['70c05d4caa624755589ef1aa34635504372a7988'],18,34,52,2484360,8,0,1,0,1872
ed65d26070bcaf56e61506b100c46aad1a69c758,0,jenkins,2014-03-18 20:48:30-07:00,['6baf19507270abd617beb6e83af0dd13cebaae7a'],0,13,13,2484373,5,0,0.857142857,1,1872
8e3d47908f7d5ae097d9b306690c44917d97d826,1,jenkins,2014-03-19 00:28:16-07:00,['ed65d26070bcaf56e61506b100c46aad1a69c758'],3,8,11,2484384,2,1,1,,1872
0492087f3e69c0394a3490ef858c0104f5051b54,0,jenkins,2014-03-19 00:32:39-07:00,['8e3d47908f7d5ae097d9b306690c44917d97d826'],14,56,70,2484454,2,0.038461538,1,1,1872
3e728f3180009edb77d8c40eabed4d77d204923e,1,jenkins,2014-03-19 02:15:07-07:00,['0492087f3e69c0394a3490ef858c0104f5051b54'],142,94,236,2484690,8,0.352941176,0.862745098,0.705882353,1872
cf56bbdd7e2c1d379c6e2e47c8cbd48143e1f5b8,1,jenkins,2014-03-19 11:29:53-07:00,['3e728f3180009edb77d8c40eabed4d77d204923e'],0,54,54,2484744,2,0.263157895,1,0.736842105,1872
d4f9e0a4357f328a7a5d798624ba535e394abf0a,1,Henry Robinson,2014-03-19 13:54:06-07:00,['cf56bbdd7e2c1d379c6e2e47c8cbd48143e1f5b8'],12,13,25,2484769,3,0,0,1,1872
8e9776b8245447873462e5fa608178964ad2267e,1,jenkins,2014-03-19 14:18:11-07:00,['d4f9e0a4357f328a7a5d798624ba535e394abf0a'],0,3,3,2484772,1,,,,1872
ecdd41bc087aeb3ebcc056926f8b3112b6d81f99,0,jenkins,2014-03-19 14:29:00-07:00,['8e9776b8245447873462e5fa608178964ad2267e'],0,1,1,2484773,1,1,1,1,1872
af50a10614fbff86aaf0e4755eadbf0dbf775a39,1,jenkins,2014-03-19 23:24:06-07:00,['ecdd41bc087aeb3ebcc056926f8b3112b6d81f99'],15,96,111,2484884,5,0.225806452,0,0.387096774,1872
ee2b9ffb1feb1c664d7f8d68ef58e73efeee89c2,0,jenkins,2014-03-20 16:19:52-07:00,['af50a10614fbff86aaf0e4755eadbf0dbf775a39'],1,1,2,2484886,1,,,,1872
30ee86c88005a1de2953d537333b9939afcb16f2,0,jenkins,2014-03-20 16:30:03-07:00,['ee2b9ffb1feb1c664d7f8d68ef58e73efeee89c2'],1,3,4,2484890,1,,,,1872
3d82c9a5d60a6a529aed3311925faf4dd9ce1901,0,Lenni Kuff,2014-03-20 17:22:11-07:00,['30ee86c88005a1de2953d537333b9939afcb16f2'],1,1,2,2484892,1,,,,1872
02fbeef5e679d0c912cddea0da19e105b152f56c,1,Matthew Jacobs,2014-03-20 17:34:39-07:00,['3d82c9a5d60a6a529aed3311925faf4dd9ce1901'],7,22,29,2484921,2,0,0,1,1872
bf9741835f030936d616dc4662b7704816bf1cea,1,Henry Robinson,2014-03-20 18:49:35-07:00,['02fbeef5e679d0c912cddea0da19e105b152f56c'],0,4,4,2484925,2,0.75,0.75,1,1872
8e5848eaf80fd5f8ed141f29a6f6cf0b766fd12b,0,Henry Robinson,2014-03-24 15:07:45-07:00,['bf9741835f030936d616dc4662b7704816bf1cea'],11,27,38,2484963,4,0.25,0.5,0.75,1872
b0de4bbe409baf2ac7334b8ab08c4395cea87343,0,jenkins,2014-03-25 18:38:55-07:00,['8e5848eaf80fd5f8ed141f29a6f6cf0b766fd12b'],1,12,13,2484976,2,0,0,0,1872
8e7b6d52d373ec7b20fc80e46bcf3a266028252a,1,jenkins,2014-03-25 18:39:38-07:00,['b0de4bbe409baf2ac7334b8ab08c4395cea87343'],6,8,14,2484990,2,0.5,0.5,0.5,1872
734e720297431c3eebd7a0efa5049b97fb3ae271,0,jenkins,2014-03-25 22:26:42-07:00,['8e7b6d52d373ec7b20fc80e46bcf3a266028252a'],0,1,1,2484991,1,,,,1872
d68c518042b7d1eade38fd57b523ef0134f232fa,1,jenkins,2014-03-26 13:13:49-07:00,['734e720297431c3eebd7a0efa5049b97fb3ae271'],27,56,83,2485074,2,0,0,0.928571429,1872
c27bd340758bc9f6ae90abce6f2d57277dc274f7,0,jenkins,2014-03-27 12:45:55-07:00,['d68c518042b7d1eade38fd57b523ef0134f232fa'],246,237,483,2485557,7,0.024390244,0.863414634,1,1872
f52662c7391dae608b18e04911adbcb79e532868,0,jenkins,2014-03-28 18:42:49-07:00,['c27bd340758bc9f6ae90abce6f2d57277dc274f7'],3,3,6,2485563,1,0,0,0,1872
cd2dc3e2bd6abd401ab67fe1cbf49ba576f76888,0,jenkins,2014-03-28 18:47:25-07:00,['f52662c7391dae608b18e04911adbcb79e532868'],3,16,19,2485582,3,1,1,0.875,1872
4d9aad8b9c1b478c26cb13a9ffc66f4d675a8548,0,jenkins,2014-03-31 15:53:26-07:00,['cd2dc3e2bd6abd401ab67fe1cbf49ba576f76888'],3,5,8,2485590,1,,,,1872
c798b23fd9d6e47a841b2b1fdf8c206e18d90cd5,1,jenkins,2014-04-03 17:12:25-07:00,['4d9aad8b9c1b478c26cb13a9ffc66f4d675a8548'],33,63,96,2485686,2,0,1,1,1872
99c37aac372ff96b310b03973d039ce8f8ba1ebc,1,Henry Robinson,2014-04-04 10:25:20-07:00,['c798b23fd9d6e47a841b2b1fdf8c206e18d90cd5'],17,271,288,2485974,8,0.181818182,0.776223776,0.622377622,1873
a85dacafe8b729a968079dec71da067974829b00,1,jenkins,2014-04-07 14:18:49-07:00,['99c37aac372ff96b310b03973d039ce8f8ba1ebc'],5,30,35,2486009,4,0,0,0,1873
8b319f8959f8110e505d866af0f470840449b175,0,jenkins,2014-04-07 16:21:24-07:00,['a85dacafe8b729a968079dec71da067974829b00'],1,53,54,2486063,2,1,1,1,1873
415540d78945cd6827725316c6d795bd6efbea93,0,jenkins,2014-04-07 17:30:52-07:00,['8b319f8959f8110e505d866af0f470840449b175'],5,52,57,2486120,4,0,0.833333333,1,1875
0585dfb546ab09406981749dd9aa4c13ee342c42,1,jenkins,2014-04-07 18:32:29-07:00,['415540d78945cd6827725316c6d795bd6efbea93'],13,83,96,2486216,6,0.185185185,0.111111111,1,1875
f1f4e99c85d2e879f6c286de54d1c02a2e597bb8,1,Lenni Kuff,2014-04-08 22:06:14-07:00,['0585dfb546ab09406981749dd9aa4c13ee342c42'],17,12,29,2486245,1,1,1,0,1875
9e2dd7e04906f114427eb26571cde117a990f492,1,jenkins,2014-04-10 12:15:39-07:00,['f1f4e99c85d2e879f6c286de54d1c02a2e597bb8'],20,137,157,2486402,9,0.916666667,1,1,1876
342ff28ae2e305f2063afbc5a1686cd62cd4a598,0,jenkins,2014-04-10 12:20:33-07:00,['9e2dd7e04906f114427eb26571cde117a990f492'],0,0,0,2486402,0,,,,1876
37236845b12cb265a7324c3854616c1f36d98ad6,0,jenkins,2014-04-10 15:17:25-07:00,['342ff28ae2e305f2063afbc5a1686cd62cd4a598'],1,2,3,2486405,2,,,,1876
91db96d9030388b2574deb80c5a742f111a648f9,1,jenkins,2014-04-10 15:47:06-07:00,['37236845b12cb265a7324c3854616c1f36d98ad6'],4,14,18,2486423,3,0.222222222,1,1,1876
ba89e60a81878ea48668192c103f4fa83d33416e,0,jenkins,2014-04-10 20:20:36-07:00,['91db96d9030388b2574deb80c5a742f111a648f9'],14,22,36,2486459,1,0,0.5,1,1876
2fff51d9e91f63174fb0643b6754bad87853e963,1,jenkins,2014-04-10 23:49:38-07:00,['ba89e60a81878ea48668192c103f4fa83d33416e'],16,129,145,2486604,7,0.603174603,0.73015873,1,1877
e60bf29a968a54570c3600966a45699c086a2239,1,Skye Wanderman-Milne,2014-04-11 11:16:24-07:00,['2fff51d9e91f63174fb0643b6754bad87853e963'],178,250,428,2487032,18,0,1,0.930555556,1878
c85d88714fed3f6f5c46c73d5a128a547a157f99,1,Skye Wanderman-Milne,2014-04-11 11:16:50-07:00,['e60bf29a968a54570c3600966a45699c086a2239'],5,220,225,2487257,3,0.35483871,0.496774194,0.496774194,1879
d101ef86e279fa0d708473a4ac5886776ab38307,0,Lenni Kuff,2014-04-11 16:03:09-07:00,['c85d88714fed3f6f5c46c73d5a128a547a157f99'],1,1,2,2487259,1,,,,1879
826a57d246f5fae06ec4581ec90ec538b6f79e44,1,jenkins,2014-04-13 16:02:59-07:00,['d101ef86e279fa0d708473a4ac5886776ab38307'],1,36,37,2487296,3,0.157894737,0.736842105,1,1879
1a3caca8c45af5e68c2ca3923b9406f731731e2d,0,jenkins,2014-04-13 17:11:21-07:00,['826a57d246f5fae06ec4581ec90ec538b6f79e44'],0,77,77,2487373,4,0.216216216,0.27027027,1,1880
f9dd32724c8a656d9878a91b0e180b6600509d0c,1,jenkins,2014-04-13 17:11:39-07:00,['1a3caca8c45af5e68c2ca3923b9406f731731e2d'],57,94,151,2487524,5,,,,1881
6f416dd2c28234150ac2b0807cb7bbf252f19cbb,1,jenkins,2014-04-13 17:45:51-07:00,['f9dd32724c8a656d9878a91b0e180b6600509d0c'],9,11,20,2487544,1,0,0,0,1881
0e0c480262c538dba1495218e73844e49699c30c,0,jenkins,2014-04-13 17:51:45-07:00,['6f416dd2c28234150ac2b0807cb7bbf252f19cbb'],9,6,15,2487559,1,0,0,0,1881
5803e6883eecd4304d5575080143891959a6e745,1,jenkins,2014-04-13 17:55:43-07:00,['0e0c480262c538dba1495218e73844e49699c30c'],28,20,48,2487607,1,1,0,0,1881
3bbe002d194595de78679295fb7563f1b310ef6a,1,jenkins,2014-04-13 19:50:25-07:00,['5803e6883eecd4304d5575080143891959a6e745'],24,30,54,2487661,3,1,1,1,1881
b1f46c8029c183bb1ac7333249bc3aba32f45bf2,1,jenkins,2014-04-14 12:03:53-07:00,['3bbe002d194595de78679295fb7563f1b310ef6a'],68,71,139,2487800,6,1,1,1,1881
87295a4e06c0ae30d197015823d6434625ad3a43,1,jenkins,2014-04-14 21:07:32-07:00,['b1f46c8029c183bb1ac7333249bc3aba32f45bf2'],165,2390,2555,2490355,66,0.39737582,0.710402999,0.570759138,1892
d0c353a9b483749d8ba2ae1b302ad25b0c812fed,1,jenkins,2014-04-15 15:32:05-07:00,['87295a4e06c0ae30d197015823d6434625ad3a43'],14,78,92,2490447,5,0.743589744,1,0.923076923,1893
44fd279f18d4913225a9010e951174ad90638aa5,1,jenkins,2014-04-15 23:24:46-07:00,['d0c353a9b483749d8ba2ae1b302ad25b0c812fed'],73,414,487,2490934,17,0.337748344,1,0.960264901,1895
85be9a50506c30b43ba4167ecc9209662eb5104f,0,jenkins,2014-04-16 00:37:00-07:00,['44fd279f18d4913225a9010e951174ad90638aa5'],1,1,2,2490936,1,,,,1895
831c0bbdc18ab4a1ceebc1aad63544b69f262a87,0,jenkins,2014-04-17 15:13:54-07:00,['85be9a50506c30b43ba4167ecc9209662eb5104f'],19,18,37,2490973,4,0,0,0,1895
1cab95066d856ab949b2777c0bc0f4ebe7eabf4f,1,jenkins,2014-04-17 17:58:13-07:00,['831c0bbdc18ab4a1ceebc1aad63544b69f262a87'],183,238,421,2491394,13,0.6875,1,1,1896
2a69019525f364adca7e5076a2fcad92829dfb96,1,jenkins,2014-04-18 00:12:12-07:00,['1cab95066d856ab949b2777c0bc0f4ebe7eabf4f'],14,157,171,2491565,4,0,0,1,1896
ac230c7021833e97c12927e20ca85a8fd28a363a,1,jenkins,2014-04-18 02:24:28-07:00,['2a69019525f364adca7e5076a2fcad92829dfb96'],22,61,83,2491648,12,0,0.681818182,0.772727273,1896
15327e81362ff1e96139ef033144cb0a1c0cd6b6,1,jenkins,2014-04-18 02:25:11-07:00,['ac230c7021833e97c12927e20ca85a8fd28a363a'],1528,206,1734,2493382,16,0.605974395,0.449502134,0.522048364,1897
c8e928119d2787999542e34ca32ccec8d3a82a77,1,jenkins,2014-04-18 13:28:49-07:00,['15327e81362ff1e96139ef033144cb0a1c0cd6b6'],44,563,607,2493989,11,0.169642857,0.308035714,0.736607143,1899
bb09b5270fe3f77e379a360d702407202282e7d7,1,jenkins,2014-04-18 20:11:31-07:00,['c8e928119d2787999542e34ca32ccec8d3a82a77'],46,53,99,2494088,17,1,0,0,1899
689870ca3aa3b5192687579af1ebae08f1fc9b75,0,jenkins,2014-04-21 15:00:32-07:00,['bb09b5270fe3f77e379a360d702407202282e7d7'],1,19,20,2494108,2,1,1,1,1899
c414c91931c03b3ad75da62832c298c780c8fd1c,1,jenkins,2014-04-22 13:17:12-07:00,['689870ca3aa3b5192687579af1ebae08f1fc9b75'],12,493,505,2494613,9,0.224543081,0.74151436,0.822454308,1899
b1c331fd818b205fdf33c6b94fcbb44fad5df777,0,jenkins,2014-04-22 13:55:39-07:00,['c414c91931c03b3ad75da62832c298c780c8fd1c'],2,26,28,2494641,2,1,1,1,1899
25c0ebf58cd0b64517f0c5839dd863057c8fdba4,1,jenkins,2014-04-22 18:34:48-07:00,['b1c331fd818b205fdf33c6b94fcbb44fad5df777'],9,619,628,2495269,11,1,1,1,1907
45a734f6cde32dcc118905e875ddd30ee24b3745,0,jenkins,2014-04-23 11:20:35-07:00,['25c0ebf58cd0b64517f0c5839dd863057c8fdba4'],4,14,18,2495287,2,0,1,1,1907
2351266d0eb73d0941fe8c1c44f3be8e1caa2c26,1,Ishaan Joshi,2014-04-23 18:24:05-07:00,['45a734f6cde32dcc118905e875ddd30ee24b3745'],128,1305,1433,2496720,31,0,0,0,1927
121fab8fdf847d5a8c9675dbf2af37da3ab68ffe,1,jenkins,2014-04-23 18:25:14-07:00,['2351266d0eb73d0941fe8c1c44f3be8e1caa2c26'],127,95,222,2496942,6,0.821428571,0.821428571,0,1927
405a6fbba368b5ca6bbafb870b1dac5f3b011653,1,jenkins,2014-04-24 11:36:56-07:00,['121fab8fdf847d5a8c9675dbf2af37da3ab68ffe'],1,20,21,2496963,1,,,,1927
a3b8215956eda8b463629e81e988fde7c5fa44de,0,jenkins,2014-04-24 19:33:40-07:00,['405a6fbba368b5ca6bbafb870b1dac5f3b011653'],4,1,5,2496968,2,1,0,0,1927
bd2fc2d1d4885dcda5b63e7267763c091fb16edc,1,jenkins,2014-04-24 19:39:16-07:00,['a3b8215956eda8b463629e81e988fde7c5fa44de'],38,170,208,2497176,9,0.291139241,0.17721519,0.658227848,1927
0117a9226890ddc2e3e92d77a77cc58a2157a834,0,jenkins,2014-04-24 19:42:50-07:00,['bd2fc2d1d4885dcda5b63e7267763c091fb16edc'],12,27,39,2497215,4,0.166666667,0.166666667,0.833333333,1927
91e1eb0789de91a6dc6fac2f7aaffacf29d8e600,1,jenkins,2014-04-24 23:53:28-07:00,['0117a9226890ddc2e3e92d77a77cc58a2157a834'],139,476,615,2497830,6,0.155737705,0.245901639,0.680327869,1927
46151dc7dd431e424e7ffcd16247d188112d44aa,1,jenkins,2014-04-25 15:38:51-07:00,['91e1eb0789de91a6dc6fac2f7aaffacf29d8e600'],25,210,235,2498065,7,0.207207207,0.423423423,0.540540541,1927
808f9a661afb602aa8bfeba5e77458e088a8457b,0,jenkins,2014-04-25 16:16:15-07:00,['46151dc7dd431e424e7ffcd16247d188112d44aa'],19,72,91,2498156,5,0.409090909,0,0.772727273,1927
d9c436912e6ee49e8a85acfe74fbf6d78c41b87a,0,jenkins,2014-04-25 19:35:58-07:00,['808f9a661afb602aa8bfeba5e77458e088a8457b'],10,6,16,2498172,1,1,1,0,1927
1f07f2d7ee4441f070007f94e5ddf5f1645f8de9,0,jenkins,2014-04-27 12:57:13-07:00,['d9c436912e6ee49e8a85acfe74fbf6d78c41b87a'],50,71,121,2498293,3,1,1,1,1927
01961613a03c5403153c64b178b530dc7e89df13,0,jenkins,2014-04-28 15:19:16-07:00,['1f07f2d7ee4441f070007f94e5ddf5f1645f8de9'],1,3,4,2498297,1,0,0,0,1927
60db4d4d82ca69d87bdec982ed68294727a97769,1,Skye Wanderman-Milne,2014-04-28 15:58:15-07:00,['01961613a03c5403153c64b178b530dc7e89df13'],81,313,394,2498691,12,0.739130435,1,0.815217391,1930
0fa87cba548c581897b6bec260553ed32c9c5a4f,0,jenkins,2014-04-28 23:42:48-07:00,['60db4d4d82ca69d87bdec982ed68294727a97769'],2,2,4,2498695,2,,,,1930
88ec1e0a83ff5153d538d8330a1e450a5692ed57,0,jenkins,2014-04-28 23:47:24-07:00,['0fa87cba548c581897b6bec260553ed32c9c5a4f'],1,4,5,2498700,1,,,,1930
35d986cc8d4a29eddaf397fd50907238195826b0,0,jenkins,2014-04-29 16:54:31-07:00,['88ec1e0a83ff5153d538d8330a1e450a5692ed57'],1,68,69,2498769,4,1,1,1,1930
8d8ea28820adebbdf599653a9c9133d845cd4624,0,jenkins,2014-05-01 02:12:55-07:00,['35d986cc8d4a29eddaf397fd50907238195826b0'],1,4,5,2498774,1,0,0,1,1930
192d52c258912ef997cd21055272868777798b51,1,ishaan,2014-05-01 14:20:35-07:00,['8d8ea28820adebbdf599653a9c9133d845cd4624'],1,3178,3179,2501953,9,0.497083603,0.52624757,0.617627997,1938
bb3feb675e1d76f00e05fed347b94162b5f59431,1,jenkins,2014-05-01 15:04:07-07:00,['192d52c258912ef997cd21055272868777798b51'],21,226,247,2502200,6,0.346153846,0.358974359,0.987179487,1939
5adbcbbce53985862f0cfcceadb4a3c0da2abe3d,0,jenkins,2014-05-02 12:18:37-07:00,['bb3feb675e1d76f00e05fed347b94162b5f59431'],1,2,3,2502203,1,1,1,1,1939
03e5665e56f00948e215392ffb66d5cd66cc61c7,1,jenkins,2014-05-02 16:38:35-07:00,['5adbcbbce53985862f0cfcceadb4a3c0da2abe3d'],118,580,698,2502901,14,0.31152648,0.473520249,0.6105919,1939
61b36a42bd4fffcb1893b3ab8e53e0a2265c3e14,0,jenkins,2014-05-02 17:10:25-07:00,['03e5665e56f00948e215392ffb66d5cd66cc61c7'],17,49,66,2502967,5,1,1,1,1939
f968bb608756ca780a5e3f076d5956895027bd96,0,jenkins,2014-05-02 18:45:21-07:00,['61b36a42bd4fffcb1893b3ab8e53e0a2265c3e14'],2,18,20,2502987,2,,,,1939
83893eac4e6503ded6c4f35dc680607b716aa22b,1,jenkins,2014-05-02 21:26:06-07:00,['f968bb608756ca780a5e3f076d5956895027bd96'],8,8,16,2503003,2,0,1,0,1939
f696135a31a623adaa6c80d2d52b585ff29fc023,0,jenkins,2014-05-05 18:40:42-07:00,['83893eac4e6503ded6c4f35dc680607b716aa22b'],4,31,35,2503038,1,0,1,0.826086957,1939
cb5b2f0b381a56c64c1d206ca6104ff956587c39,1,jenkins,2014-05-05 18:47:15-07:00,['f696135a31a623adaa6c80d2d52b585ff29fc023'],4,1,5,2503043,1,1,1,0,1939
6f31dc7f8aaabedd75badcd5d91838f339dfc481,1,jenkins,2014-05-06 13:06:26-07:00,['cb5b2f0b381a56c64c1d206ca6104ff956587c39'],2,265,267,2503310,4,0.583333333,0.583333333,0.808333333,1939
1da4a673c295715dca773946aa75cfa1fe6786c4,0,jenkins,2014-05-06 16:16:35-07:00,['6f31dc7f8aaabedd75badcd5d91838f339dfc481'],0,7,7,2503317,1,0,0,0,1939
4d3f12666b7787d3d11b2685338dd591b536d02e,1,Henry Robinson,2014-05-06 20:47:50-07:00,['1da4a673c295715dca773946aa75cfa1fe6786c4'],27,12,39,2503356,4,0.833333333,0.833333333,0.166666667,1939
13c794db918d0b24453609b765011b84f8c7d030,1,Srinath Shankar,2014-05-07 15:10:40-07:00,['4d3f12666b7787d3d11b2685338dd591b536d02e'],114,20,134,2503490,5,,,,1939
ac3279d13111b378fc64cdbdff284bf3d795a4c9,0,Srinath Shankar,2014-05-07 20:09:50-07:00,['13c794db918d0b24453609b765011b84f8c7d030'],0,0,0,2503490,0,,,,1939
d6b48db7b54432e10d8f48153bfff14206a2980c,0,Srinath Shankar,2014-05-07 20:10:09-07:00,['ac3279d13111b378fc64cdbdff284bf3d795a4c9'],0,0,0,2503490,0,,,,1939
50caed17d7776e55a373544a32a5036429473a41,0,Lenni Kuff,2014-05-07 22:56:38-07:00,['d6b48db7b54432e10d8f48153bfff14206a2980c'],3,2,5,2503495,1,,,,1939
63f37791e8c8dca245275eae04a1d31774c45713,0,Henry Robinson,2014-05-08 11:16:53-07:00,['50caed17d7776e55a373544a32a5036429473a41'],0,202,202,2503697,1,,,,1940
38fdda20e4ee98e92fb706c5cc133232b3439e14,1,Henry Robinson,2014-05-08 12:28:43-07:00,['63f37791e8c8dca245275eae04a1d31774c45713'],1,18,19,2503716,2,0,1,1,1940
38befd21264ef424401734b919f182e955f58e4a,1,Henry Robinson,2014-05-08 12:28:53-07:00,['38fdda20e4ee98e92fb706c5cc133232b3439e14'],81,263,344,2504060,13,0.047619048,0.666666667,0.638095238,1940
1a21bb9b9ee2b0faa21527203d5f7de06b31d27e,1,jenkins,2014-05-08 13:59:00-07:00,['38befd21264ef424401734b919f182e955f58e4a'],34,264,298,2504358,3,1,1,0,1940
ebc6c5894eb0e587e7af993e53594f06f600f499,1,jenkins,2014-05-08 14:56:19-07:00,['1a21bb9b9ee2b0faa21527203d5f7de06b31d27e'],118,2239,2357,2506715,49,0.44488189,0.562007874,0.858267717,1953
fb49706ec82fcb9aab391551c3edf04eb3612ef3,1,jenkins,2014-05-08 17:38:54-07:00,['ebc6c5894eb0e587e7af993e53594f06f600f499'],101,119,220,2506935,17,0,0,1,1953
dd9521d089ed8f7c8351c925b8cc7fab39027bf5,1,jenkins,2014-05-09 01:54:10-07:00,['fb49706ec82fcb9aab391551c3edf04eb3612ef3'],1,33,34,2506969,2,0.08,1,0.92,1953
0c533bb152dffa21b6ebaa2a93c4bc6a7a1c4ef6,1,jenkins,2014-05-09 02:24:41-07:00,['dd9521d089ed8f7c8351c925b8cc7fab39027bf5'],8,799,807,2507776,14,0.354570637,0.490304709,0.637119114,1959
0bb66ef3270d643e1fb6c971e26ebfa3302ca4ed,0,jenkins,2014-05-09 17:35:29-07:00,['0c533bb152dffa21b6ebaa2a93c4bc6a7a1c4ef6'],2,10,12,2507788,2,,,,1959
19f34d91879a3724465c9c8fb9cb3b9fb19bd900,0,jenkins,2014-05-09 19:32:18-07:00,['0bb66ef3270d643e1fb6c971e26ebfa3302ca4ed'],2,4,6,2507794,1,1,1,1,1959
7eb4f7f22652b3c0a4366699ca1efa38ece61a7c,1,jenkins,2014-05-11 15:11:12-07:00,['19f34d91879a3724465c9c8fb9cb3b9fb19bd900'],1,15,16,2507810,2,0.769230769,0,1,1959
54ba2223ef150c7caf844e157eeedf1fad9de41d,1,jenkins,2014-05-11 15:11:43-07:00,['7eb4f7f22652b3c0a4366699ca1efa38ece61a7c'],7,63,70,2507880,4,0,1,0.826086957,1959
8aea6df02e08e204809eafe1eb4a82452e1a79ee,1,jenkins,2014-05-11 15:12:08-07:00,['54ba2223ef150c7caf844e157eeedf1fad9de41d'],7,8,15,2507895,1,,,,1959
a225ae5e2fc7d730927e65f54e118ab31d5aacb0,1,Lenni Kuff,2014-05-11 15:42:22-07:00,['8aea6df02e08e204809eafe1eb4a82452e1a79ee'],2,2,4,2507899,2,,,,1959
2d7a8b7c706a2041de4bf35ddcfd008430a8dc2a,0,jenkins,2014-05-11 19:30:38-07:00,['a225ae5e2fc7d730927e65f54e118ab31d5aacb0'],0,14,14,2507913,2,1,1,1,1959
a02577f9f384ecd4f5da87bb04a9a1d6497250b9,1,jenkins,2014-05-12 17:14:08-07:00,['2d7a8b7c706a2041de4bf35ddcfd008430a8dc2a'],62,361,423,2508336,6,0.371794872,0.775641026,0.923076923,1960
0fa2d6db9b64bf5f7c393ffde7e243c143eb6364,0,jenkins,2014-05-12 22:51:08-07:00,['a02577f9f384ecd4f5da87bb04a9a1d6497250b9'],1,7,8,2508344,2,0.75,0.75,1,1960
f1d9c0f58b86ea09573ae72735ff853e6f912c24,0,jenkins,2014-05-13 02:57:07-07:00,['0fa2d6db9b64bf5f7c393ffde7e243c143eb6364'],15,28,43,2508387,5,0.8,0.8,0.4,1960
79d43e1e4199421c293267acc029403d54da02c9,0,Lenni Kuff,2014-05-13 08:22:42-07:00,['f1d9c0f58b86ea09573ae72735ff853e6f912c24'],2,4,6,2508393,1,,,,1960
61cbdd4f4977a2ec047cc5816b2b7686b6bed3c3,1,Lenni Kuff,2014-05-14 12:02:02-07:00,['79d43e1e4199421c293267acc029403d54da02c9'],1,219,220,2508613,6,0.301886792,1,1,1965
83cd23ed63291dadb9446b23d03df08054829a3c,1,jenkins,2014-05-14 23:23:24-07:00,['61cbdd4f4977a2ec047cc5816b2b7686b6bed3c3'],134,212,346,2508959,13,0.688888889,1,1,1965
ec08bf7f58e3d62eb63040c00ec5ac7b6d6a62c7,0,jenkins,2014-05-15 20:04:30-07:00,['83cd23ed63291dadb9446b23d03df08054829a3c'],3,8,11,2508970,1,0,0,1,1965
4b883ac7ebb0ee350413f7e720a108daf2c7ba15,1,jenkins,2014-05-16 00:17:38-07:00,['ec08bf7f58e3d62eb63040c00ec5ac7b6d6a62c7'],66,468,534,2509504,13,0.169172932,0.72556391,0.778195489,1967
fcf4e43a3c5980a634110649488c42f97af5e74a,1,jenkins,2014-05-16 01:26:38-07:00,['4b883ac7ebb0ee350413f7e720a108daf2c7ba15'],40,99,139,2509643,6,0.428571429,1,0.714285714,1967
699f915550bcba7096fdfa1811f243cdb063a50a,0,jenkins,2014-05-16 17:45:20-07:00,['fcf4e43a3c5980a634110649488c42f97af5e74a'],0,0,0,2509643,0,,,,1967
0298e8b6abcd7cea99df4cb235c73a49e340521a,1,jenkins,2014-05-16 18:14:30-07:00,['699f915550bcba7096fdfa1811f243cdb063a50a'],0,2,2,2509645,1,1,1,1,1967
edbbe6035e674593077e91a773b13d3ef24cdf0c,1,jenkins,2014-05-16 22:26:11-07:00,['0298e8b6abcd7cea99df4cb235c73a49e340521a'],96,286,382,2510027,10,0.108910891,0.366336634,0.623762376,1969
8c2dda577107db99bea98eda0ff3d140fdf8f863,1,jenkins,2014-05-17 16:36:39-07:00,['edbbe6035e674593077e91a773b13d3ef24cdf0c'],8,11,19,2510046,5,0,0,0,1969
a7a9cde86f401c719b3bede269cfbdfefed6e59a,1,jenkins,2014-05-18 16:29:11-07:00,['8c2dda577107db99bea98eda0ff3d140fdf8f863'],7,80,87,2510133,5,0.083333333,0.083333333,0,1969
d193a1e8a5f0d00bd7f4e6a0dd6d36a42aba3de8,1,jenkins,2014-05-19 12:40:12-07:00,['a7a9cde86f401c719b3bede269cfbdfefed6e59a'],12,72,84,2510217,7,0.709677419,0.709677419,1,1969
6ccd56bc1fcd6dd57b82f74821c1eec6d99bb44d,1,jenkins,2014-05-19 14:37:44-07:00,['d193a1e8a5f0d00bd7f4e6a0dd6d36a42aba3de8'],8,30,38,2510255,4,1,1,1,1969
f9c9a7ca13730f8164123cf242efafadd3741791,1,jenkins,2014-05-19 17:52:27-07:00,['6ccd56bc1fcd6dd57b82f74821c1eec6d99bb44d'],13,311,324,2510579,16,0.491666667,0.841666667,0.866666667,1970
b252921363dd103a3030e99c79980e6f21a9c2aa,0,jenkins,2014-05-19 20:17:23-07:00,['f9c9a7ca13730f8164123cf242efafadd3741791'],12,18,30,2510609,4,0,0,0,1970
1b9a8020bf40d5945e7b47b3251bd8291dd6c559,1,jenkins,2014-05-20 16:21:59-07:00,['b252921363dd103a3030e99c79980e6f21a9c2aa'],35,71,106,2510715,4,0.032258065,1,1,1970
e87c0eb22a6adb14e42ce47fa8c97d6e5a8363ef,1,jenkins,2014-05-20 21:24:33-07:00,['1b9a8020bf40d5945e7b47b3251bd8291dd6c559'],85,148,233,2510948,23,0.857142857,1,1,1970
93a3d654928e1a93dda038ae2faa0a99f6bbe6d1,1,jenkins,2014-05-21 05:52:55-07:00,['e87c0eb22a6adb14e42ce47fa8c97d6e5a8363ef'],8,34,42,2510990,5,1,0.125,0.1875,1970
46aba6149d06bba92f2c970034cc61902069dde0,1,jenkins,2014-05-21 15:34:24-07:00,['93a3d654928e1a93dda038ae2faa0a99f6bbe6d1'],1,17,18,2511008,2,0,0,1,1970
83e239723fa0f73d32167981d77a5a58eaeef42f,1,jenkins,2014-05-21 15:51:24-07:00,['46aba6149d06bba92f2c970034cc61902069dde0'],1,45,46,2511054,1,,,,1970
794aaad8ad1c2088b646fa989dc79cb40e127fbe,0,jenkins,2014-05-21 16:06:27-07:00,['83e239723fa0f73d32167981d77a5a58eaeef42f'],5,9,14,2511068,2,0,0,1,1970
5729024fe9effbe0662d436fc3ed42c212744740,0,jenkins,2014-05-21 18:18:29-07:00,['794aaad8ad1c2088b646fa989dc79cb40e127fbe'],20,49,69,2511137,6,0,0,1,1970
723f583b4da9349b668b5952466400baa62d6e4f,1,jenkins,2014-05-22 13:09:51-07:00,['5729024fe9effbe0662d436fc3ed42c212744740'],66,393,459,2511596,20,0.435064935,0.305194805,0.525974026,1971
1dff1686aa7c2beb5f53e759db78df8b349664d9,1,jenkins,2014-05-22 18:01:55-07:00,['723f583b4da9349b668b5952466400baa62d6e4f'],0,26,26,2511622,1,,,,1971
e34a3d48720d2ef7071c77f50237e6524cb024b9,1,jenkins,2014-05-23 00:22:22-07:00,['1dff1686aa7c2beb5f53e759db78df8b349664d9'],7,26,33,2511655,1,0,1,1,1971
c13a1d080ee9fbf6e631ba20cbc7806a2e9ec485,0,jenkins,2014-05-23 14:11:35-07:00,['e34a3d48720d2ef7071c77f50237e6524cb024b9'],1,13,14,2511669,2,0,0,1,1971
39dda02fd664372996ca2318af0d57c3016588c4,0,jenkins,2014-05-23 21:46:00-07:00,['c13a1d080ee9fbf6e631ba20cbc7806a2e9ec485'],4,4,8,2511677,1,,,,1971
2dea6708b240c3f51c4b815d739fc9746d37f4e2,0,jenkins,2014-05-23 21:54:02-07:00,['39dda02fd664372996ca2318af0d57c3016588c4'],3,11,14,2511691,1,0.25,0.25,0.75,1971
ca86e470ded04ef88a99800ac10546d01b5a4962,1,jenkins,2014-05-26 13:10:12-07:00,['2dea6708b240c3f51c4b815d739fc9746d37f4e2'],51,226,277,2511968,8,0.130952381,0.785714286,0.845238095,1971
00e956f7cf2a72b7d2bc3857978cb4385bbbbc64,1,jenkins,2014-05-26 13:28:12-07:00,['ca86e470ded04ef88a99800ac10546d01b5a4962'],286,336,622,2512590,7,,,,1973
10952da6e0c653fcc9fa664bbbdedf3ada24608e,0,jenkins,2014-05-27 13:46:17-07:00,['00e956f7cf2a72b7d2bc3857978cb4385bbbbc64'],3,3,6,2512596,2,,,,1973
53a6ead074b7e67707d6488362a546efb9bd86f1,0,jenkins,2014-05-27 15:54:21-07:00,['10952da6e0c653fcc9fa664bbbdedf3ada24608e'],2,20,22,2512618,2,0,0.5,1,1973
c45e9a70d9f948b7970f323ed53ed6308b952fc5,1,jenkins,2014-05-27 16:47:15-07:00,['53a6ead074b7e67707d6488362a546efb9bd86f1'],1584,3294,4878,2517496,39,0.28375,0.46875,0.90375,1980
30357f2351b03d3835dc89786300c55a6de5c12e,1,jenkins,2014-05-27 19:12:40-07:00,['c45e9a70d9f948b7970f323ed53ed6308b952fc5'],12,28,40,2517536,2,0,0,1,1980
c5c58c6bcea82f230c28c4b1d08c60af9b9de308,0,jenkins,2014-05-27 20:46:21-07:00,['30357f2351b03d3835dc89786300c55a6de5c12e'],12,19,31,2517567,2,0.75,0.75,0,1980
d529c6446fef2e3af17747cd66767e80d425a559,1,jenkins,2014-05-28 08:50:44-07:00,['c5c58c6bcea82f230c28c4b1d08c60af9b9de308'],363,383,746,2518313,2,1,0,0,1981
745c091fcc9224b79a7f962fa94c40f63f96cf69,1,jenkins,2014-05-28 08:54:54-07:00,['d529c6446fef2e3af17747cd66767e80d425a559'],1473,1489,2962,2521275,6,0,0,1,1981
12b72c43307429dbfde2c7040e88e00c9a6dbe47,0,jenkins,2014-05-28 20:38:41-07:00,['745c091fcc9224b79a7f962fa94c40f63f96cf69'],0,12,12,2521287,2,0,1,1,1981
91175de7c7d8d328e1e406210bed0dc647795282,1,jenkins,2014-05-29 14:54:46-07:00,['12b72c43307429dbfde2c7040e88e00c9a6dbe47'],131,134,265,2521552,2,1,1,0,1981
c8b201709379989c04617682c9a6413baedd88f3,1,jenkins,2014-05-29 20:49:53-07:00,['91175de7c7d8d328e1e406210bed0dc647795282'],98,532,630,2522182,20,0.120171674,0.223175966,0.785407725,1981
6e691f9500c36e1aa0e84143a19a5f7d9d795664,0,jenkins,2014-05-30 11:50:50-07:00,['c8b201709379989c04617682c9a6413baedd88f3'],4,14,18,2522200,3,1,1,0,1981
26ca559f38b36f794ebb1dc383d937b7c9cb8910,1,jenkins,2014-05-30 11:53:06-07:00,['6e691f9500c36e1aa0e84143a19a5f7d9d795664'],45,783,828,2523028,15,0.131868132,0.67032967,0.772893773,1981
84f851b5a5975c9a27901a85c28014cc515af84c,1,Nong Li,2014-05-30 16:47:07-07:00,['26ca559f38b36f794ebb1dc383d937b7c9cb8910'],13,37,50,2523078,4,0.9,0.9,1,1981
5d80942d429637b82a9f727a4c464626b429286a,1,jenkins,2014-05-30 19:14:39-07:00,['84f851b5a5975c9a27901a85c28014cc515af84c'],137,127,264,2523342,9,1,1,1,1981
7b7ca065c92f7a139048c9cd6205d024e1e6465b,1,jenkins,2014-05-30 23:46:56-07:00,['5d80942d429637b82a9f727a4c464626b429286a'],80,239,319,2523661,5,0.352272727,0.170454545,0.795454545,1981
8f4dc0f2f0bf08fc2d83a7a0ccf4a8c18b6559bb,1,jenkins,2014-05-31 22:19:06-07:00,['7b7ca065c92f7a139048c9cd6205d024e1e6465b'],581,1268,1849,2525510,57,0.17866005,0.58560794,0.905707196,1984
e34ede292ce1ffbae7b86eaca6d88561c34ecf3c,1,jenkins,2014-06-01 01:28:25-07:00,['8f4dc0f2f0bf08fc2d83a7a0ccf4a8c18b6559bb'],20,156,176,2525686,3,0,0,1,1984
0f23ddd5c1a5318ff19dba9a1ded1b866405dbc0,1,jenkins,2014-06-02 01:11:11-07:00,['e34ede292ce1ffbae7b86eaca6d88561c34ecf3c'],63,419,482,2526168,15,0.227979275,0.015544041,0.735751295,1984
418739813f178ad2b97adc691b4ee30a5d5245ce,0,jenkins,2014-06-02 11:54:42-07:00,['0f23ddd5c1a5318ff19dba9a1ded1b866405dbc0'],0,6,6,2526174,1,1,1,1,1984
cdc1002060cff7ccf3a9d05be07a77ca5ab15f75,0,Alex Behm,2014-06-02 23:07:05-07:00,['418739813f178ad2b97adc691b4ee30a5d5245ce'],0,0,0,2526174,0,,,,1984
84686f6b9514739e0dcc2bc91797b643e9aa21fa,0,Alex Behm,2014-06-02 23:07:18-07:00,['cdc1002060cff7ccf3a9d05be07a77ca5ab15f75'],0,0,0,2526174,0,,,,1984
e6b7565eff6d6f37a045fde0c8accd4d2da3f023,0,jenkins,2014-06-02 23:34:20-07:00,['84686f6b9514739e0dcc2bc91797b643e9aa21fa'],17,99,116,2526290,8,1,1,1,1984
f34a0507bf4a5944c217f44217b9c1d3e1bf210a,1,Lenni Kuff,2014-06-03 07:19:52-07:00,['e6b7565eff6d6f37a045fde0c8accd4d2da3f023'],278,1493,1771,2528061,30,0.470175439,0.763157895,0.829824561,1990
3f6f570e51729182227f26e944615988284c6ae7,1,jenkins,2014-06-03 17:17:58-07:00,['f34a0507bf4a5944c217f44217b9c1d3e1bf210a'],9,62,71,2528132,2,0,0.222222222,0.638888889,1990
03e8b3bb31289e4566aa3149038777948047daec,1,jenkins,2014-06-03 18:00:55-07:00,['3f6f570e51729182227f26e944615988284c6ae7'],1,2,3,2528135,1,,,,1990
3e7e7ed0dc20e665e2276cfbdd93da2d95956a26,0,jenkins,2014-06-03 19:48:57-07:00,['03e8b3bb31289e4566aa3149038777948047daec'],1,1,2,2528137,1,,,,1990
1b88bf928aecce0b45ac197c123822e2801ad2b1,1,jenkins,2014-06-03 20:43:47-07:00,['3e7e7ed0dc20e665e2276cfbdd93da2d95956a26'],16,93,109,2528246,3,0.098360656,0,0.540983607,1990
89e115436fd42ef51ca8734966c2f08d7d4e51dc,0,jenkins,2014-06-03 20:50:18-07:00,['1b88bf928aecce0b45ac197c123822e2801ad2b1'],1,10,11,2528257,1,0,1,0,1990
0348a36b49558f2d94475e97bd62281daa4a5949,1,jenkins,2014-06-03 23:17:44-07:00,['89e115436fd42ef51ca8734966c2f08d7d4e51dc'],38,724,762,2529019,9,0.204892966,0.480122324,0.917431193,1990
b5c5c05bcb48dd4034794de96a761c7d88ba6750,0,Nong Li,2014-06-05 08:36:46-07:00,['0348a36b49558f2d94475e97bd62281daa4a5949'],2,2,4,2529023,1,,,,1990
d264ab90fe50bafe27f216cd74cd6fb9e7c5d51b,0,Henry Robinson,2014-06-05 10:48:23-07:00,['b5c5c05bcb48dd4034794de96a761c7d88ba6750'],10,26,36,2529059,4,0,0.384615385,0,1990
2f9b2ae7858f2b1ba6aa15a9087f3053691d2924,1,jenkins,2014-06-05 20:07:57-07:00,['d264ab90fe50bafe27f216cd74cd6fb9e7c5d51b'],44,50,94,2529153,3,1,1,1,1991
5faa60346163e5d2cff3af5a170616b0481dd400,1,jenkins,2014-06-05 22:02:06-07:00,['2f9b2ae7858f2b1ba6aa15a9087f3053691d2924'],35,67,102,2529255,2,0,0,0.363636364,1991
60276f7e8c232cfb66e668cd4aa4784fb89e39ef,1,jenkins,2014-06-06 06:22:36-07:00,['5faa60346163e5d2cff3af5a170616b0481dd400'],527,1123,1650,2530905,17,0.165775401,0.625668449,0.719251337,1991
12a08ec07ce2eab546a9821f0ac97698241adb53,0,Lenni Kuff,2014-06-06 09:08:21-07:00,['60276f7e8c232cfb66e668cd4aa4784fb89e39ef'],0,8,8,2530913,1,,,,1991
895d69c09f3e1c037fb96f137b4418e8ac62bd72,1,Nong Li,2014-06-06 09:26:56-07:00,['12a08ec07ce2eab546a9821f0ac97698241adb53'],10,95,105,2531018,4,0,0,1,1991
8f26285801b7d2478859716fb2f31ec266b8cc0b,0,jenkins,2014-06-06 10:59:53-07:00,['895d69c09f3e1c037fb96f137b4418e8ac62bd72'],7,6,13,2531031,1,1,0,0,1991
a618d34f1727035440b2b65ca419fc650e2d8b96,0,jenkins,2014-06-06 19:42:45-07:00,['8f26285801b7d2478859716fb2f31ec266b8cc0b'],104,442,546,2531577,11,0.102990033,0.641196013,1,1991
5a4a8aca8165e85233310a3490642c3cea1676f0,0,jenkins,2014-06-06 19:58:07-07:00,['a618d34f1727035440b2b65ca419fc650e2d8b96'],1,1,2,2531579,1,,,,1991
2a469e72d684c12fa287946e484c1ecc3a297875,1,jenkins,2014-06-06 22:14:05-07:00,['5a4a8aca8165e85233310a3490642c3cea1676f0'],114,208,322,2531901,4,0.169491525,1,0.288135593,1991
e7cdb3e3b5794b7eb69f01c62511fe83d6d1a28b,0,jenkins,2014-06-08 01:51:58-07:00,['2a469e72d684c12fa287946e484c1ecc3a297875'],7,1,8,2531909,1,0,0,0,1991
db97981ab9d0e6c37bbdf3b275f3135cbd775bfe,1,jenkins,2014-06-08 11:47:23-07:00,['e7cdb3e3b5794b7eb69f01c62511fe83d6d1a28b'],1791,1815,3606,2535515,23,,,,1991
60cbe1b0e186093a067a0f139fbe65820a7f13af,1,jenkins,2014-06-08 18:44:45-07:00,['db97981ab9d0e6c37bbdf3b275f3135cbd775bfe'],195,280,475,2535990,20,0,1,1,1991
fd3ca93b8030524fbf1ba03261498d49f20a3bb2,0,jenkins,2014-06-08 19:32:21-07:00,['60cbe1b0e186093a067a0f139fbe65820a7f13af'],1,39,40,2536030,1,0,0,0.56,1991
b53ee1cafe5271563e108537159a2424a705206e,0,jenkins,2014-06-08 23:09:54-07:00,['fd3ca93b8030524fbf1ba03261498d49f20a3bb2'],17,15,32,2536062,2,,,,1991
c1db245e1ff3eb0f86f2dee2797935424fa02df9,0,jenkins,2014-06-08 23:14:58-07:00,['b53ee1cafe5271563e108537159a2424a705206e'],89,115,204,2536266,3,0.777777778,1,1,1992
4f804f9a34ef3b8755ededb9f57e627b2d6f82e6,1,jenkins,2014-06-09 11:37:16-07:00,['c1db245e1ff3eb0f86f2dee2797935424fa02df9'],33,120,153,2536419,5,0.265625,0.03125,0.859375,1992
6c779b9173d2d58d216eaddd863abb8fbafa88cd,0,jenkins,2014-06-09 12:09:53-07:00,['4f804f9a34ef3b8755ededb9f57e627b2d6f82e6'],3,3,6,2536425,1,,,,1992
76fa721cc43fe9975df346cdee5fa10d96918d67,1,jenkins,2014-06-09 13:40:14-07:00,['6c779b9173d2d58d216eaddd863abb8fbafa88cd'],12,32,44,2536469,2,1,1,0.933333333,1992
7d54f3f499dcb6814559ececbc618550e8ee7849,1,jenkins,2014-06-09 15:10:13-07:00,['76fa721cc43fe9975df346cdee5fa10d96918d67'],23,32,55,2536524,3,0.75,1,1,1992
5755b0bdee8e7daa3cc71d67300e100b59a15912,1,jenkins,2014-06-09 16:58:08-07:00,['7d54f3f499dcb6814559ececbc618550e8ee7849'],6951,6507,13458,2549982,105,0.419323671,0,0.554589372,2008
89ec6b3d7a8568158087b465a4a78afddfd89da8,1,Matthew Jacobs,2014-06-09 17:17:14-07:00,['5755b0bdee8e7daa3cc71d67300e100b59a15912'],99,100,199,2550181,12,,,,2008
09aff77a6c941d714117b86a7b7b7ea68f9eac69,1,jenkins,2014-06-09 19:06:15-07:00,['89ec6b3d7a8568158087b465a4a78afddfd89da8'],8,38,46,2550227,5,0.285714286,0,0,2009
e6308b5b7667a62aeed8bf47067601f59c5c35c6,0,jenkins,2014-06-09 22:37:37-07:00,['09aff77a6c941d714117b86a7b7b7ea68f9eac69'],36,37,73,2550300,7,1,1,1,2009
b212634f95d1bee065993b350efaa5c4423f1f5a,1,Lenni Kuff,2014-06-09 22:46:11-07:00,['e6308b5b7667a62aeed8bf47067601f59c5c35c6'],2,2,4,2550304,1,,,,2009
b3ebfddadd196a19ea74d4ad4fdb62f01dda8e4a,1,jenkins,2014-06-09 23:24:26-07:00,['b212634f95d1bee065993b350efaa5c4423f1f5a'],17,106,123,2550427,4,0.468085106,0.872340426,0.85106383,2010
f5da01955580847ee94cd11412eb762e4880407b,1,jenkins,2014-06-09 23:54:09-07:00,['b3ebfddadd196a19ea74d4ad4fdb62f01dda8e4a'],40,154,194,2550621,6,0,0.267605634,1,2010
892eccc8d0d09594cf77ac039206da4ea604c74f,1,jenkins,2014-06-10 11:08:25-07:00,['f5da01955580847ee94cd11412eb762e4880407b'],13,63,76,2550697,6,0.275862069,1,0.75862069,2010
45d652c2c86358d12bf77b71a256303907d644d7,1,jenkins,2014-06-10 13:50:47-07:00,['892eccc8d0d09594cf77ac039206da4ea604c74f'],13,56,69,2550766,2,0.266666667,0.266666667,1,2010
fe0646f76bf35b525f8f63948a7d3baa481e5bc0,1,jenkins,2014-06-10 17:27:54-07:00,['45d652c2c86358d12bf77b71a256303907d644d7'],13,61,74,2550840,3,0,0,1,2010
ad534429df40bc350a0635e03c8e68ebb2170714,0,jenkins,2014-06-10 18:24:42-07:00,['fe0646f76bf35b525f8f63948a7d3baa481e5bc0'],0,1,1,2550841,1,,,,2010
5e49150a22e7894850e37c4c9cfc616425df9bf9,0,jenkins,2014-06-10 20:53:23-07:00,['ad534429df40bc350a0635e03c8e68ebb2170714'],24,24,48,2550889,3,0.5,0.5,0.5,2010
6ac9a8104b6d877c937b37c7e9b35cfee60958c8,1,jenkins,2014-06-10 21:46:47-07:00,['5e49150a22e7894850e37c4c9cfc616425df9bf9'],31,59,90,2550979,5,0.25,0,1,2010
5d903efca3b695c4235d554ce24040681e7dea51,1,jenkins,2014-06-11 03:10:11-07:00,['6ac9a8104b6d877c937b37c7e9b35cfee60958c8'],825,1426,2251,2553230,54,0.226277372,0.416058394,0.394160584,2013
66e90d75ee6ab9c9e15056424d0cdf3171cefa36,1,jenkins,2014-06-11 11:51:19-07:00,['5d903efca3b695c4235d554ce24040681e7dea51'],11,25,36,2553266,2,0.444444444,0.222222222,0,2013
c096d7688102e0570d2461ccc9745abded1b5ae6,1,jenkins,2014-06-11 14:33:34-07:00,['66e90d75ee6ab9c9e15056424d0cdf3171cefa36'],33,35,68,2553334,1,0,0,0,2013
fa98766cebed692f36790e75b5ed117e98075b69,0,Lenni Kuff,2014-06-11 14:54:06-07:00,['c096d7688102e0570d2461ccc9745abded1b5ae6'],1,1,2,2553336,1,,,,2013
1cc628d32dc468f5179a772a4d1d8635b1432bd5,1,jenkins,2014-06-11 19:16:34-07:00,['fa98766cebed692f36790e75b5ed117e98075b69'],36,180,216,2553552,15,0.3,0.6,0.95,2014
a9cb6c40ea4e26def41eec6a3ac5e53fb4251213,1,jenkins,2014-06-11 21:29:04-07:00,['1cc628d32dc468f5179a772a4d1d8635b1432bd5'],12,22,34,2553586,6,0.9,1,0.8,2014
d5a9ada976108aa6007b8da95ffb37a1a4a8e1ad,0,Lenni Kuff,2014-06-11 22:14:00-07:00,['a9cb6c40ea4e26def41eec6a3ac5e53fb4251213'],1,1,2,2553588,1,,,,2014
d6b01d2f01a3438dbe5dc4c274f339398991cdd5,1,jenkins,2014-06-12 01:34:55-07:00,['d5a9ada976108aa6007b8da95ffb37a1a4a8e1ad'],5,36,41,2553629,4,0,0,1,2014
c1c097b1b82906c914364be1c0784b4cf6eb2b1b,1,jenkins,2014-06-12 02:23:20-07:00,['d6b01d2f01a3438dbe5dc4c274f339398991cdd5'],31,61,92,2553721,4,0,1,1,2014
9a7c6d286ffc54245a75b996f00fed338a9f3261,1,jenkins,2014-06-12 02:59:58-07:00,['c1c097b1b82906c914364be1c0784b4cf6eb2b1b'],2,156,158,2553879,3,0.287037037,0.472222222,0.398148148,2014
c8ba9568d78e7c529da2c88190fc6296085d6f26,0,jenkins,2014-06-12 04:34:01-07:00,['9a7c6d286ffc54245a75b996f00fed338a9f3261'],0,3,3,2553882,1,0,1,1,2014
029476fad9d9aafa2483dc5e9f147b9a146d50c7,0,Lenni Kuff,2014-06-12 08:53:31-07:00,['c8ba9568d78e7c529da2c88190fc6296085d6f26'],1,1,2,2553884,1,,,,2014
2e2d8ca4a5a5b1aa13b5732eaa31ee54a68a7f13,0,jenkins,2014-06-12 12:18:29-07:00,['029476fad9d9aafa2483dc5e9f147b9a146d50c7'],7,10,17,2553901,1,0,0,1,2014
095d5275090faecfffc95387ae26e6b6b0f4557c,1,jenkins,2014-06-12 14:09:21-07:00,['2e2d8ca4a5a5b1aa13b5732eaa31ee54a68a7f13'],4,8,12,2553913,3,1,1,1,2014
0251e5215cff40c20eb3d7f30240c0d0567caf88,1,jenkins,2014-06-12 16:39:55-07:00,['095d5275090faecfffc95387ae26e6b6b0f4557c'],366,368,734,2554647,50,1,0.714285714,1,2014
ffc334a735003331a79302675bfb251d3515d21e,1,jenkins,2014-06-12 22:13:30-07:00,['0251e5215cff40c20eb3d7f30240c0d0567caf88'],2,64,66,2554713,5,0,0,1,2014
d1625712115d5115bd0e13b4f709591275f47a91,0,Henry Robinson,2014-06-12 22:18:04-07:00,['ffc334a735003331a79302675bfb251d3515d21e'],1,7,8,2554721,2,1,1,1,2014
27a57dda28a474ca3b09c7e9d5d68c989dc5ad7f,0,jenkins,2014-06-13 00:34:09-07:00,['d1625712115d5115bd0e13b4f709591275f47a91'],5,5,10,2554731,2,,,,2014
c503e1aa20c208ae525d210f8baabdc1c876a252,0,jenkins,2014-06-13 01:36:34-07:00,['27a57dda28a474ca3b09c7e9d5d68c989dc5ad7f'],0,3,3,2554734,1,,,,2014
5bbf006d19a3bdcfe1856aaf43e6776511bb61f4,0,Nong Li,2014-06-13 11:18:00-07:00,['c503e1aa20c208ae525d210f8baabdc1c876a252'],32,195,227,2554961,3,0,0.045454545,1,2014
0f5a4de07f9c3a3e80c59b82cf3824cc74ec0a11,1,jenkins,2014-06-13 17:22:07-07:00,['5bbf006d19a3bdcfe1856aaf43e6776511bb61f4'],21,103,124,2555085,2,1,0.729166667,0.229166667,2014
bbb908db1ec73e1564deded808a07088677e204c,1,jenkins,2014-06-13 18:39:07-07:00,['0f5a4de07f9c3a3e80c59b82cf3824cc74ec0a11'],0,37,37,2555122,1,0,1,1,2014
705ef72cef10b99d9529b5906207dc66922809a6,0,jenkins,2014-06-13 20:54:02-07:00,['bbb908db1ec73e1564deded808a07088677e204c'],3,275,278,2555400,8,0.53125,0.90625,0.75,2016
5e0060f8b4c904105895885c9dbbe1173b03cf9a,0,jenkins,2014-06-13 21:36:43-07:00,['705ef72cef10b99d9529b5906207dc66922809a6'],0,10,10,2555410,1,0,0,0,2016
38387f82ebb51f73758bd3738a6e918792c7a2d9,1,jenkins,2014-06-13 22:13:52-07:00,['5e0060f8b4c904105895885c9dbbe1173b03cf9a'],41,108,149,2555559,9,0.5,0.045454545,1,2016
2e163e408dcd2a678090e31c1a58687bb6a659fb,1,jenkins,2014-06-14 14:12:51-07:00,['38387f82ebb51f73758bd3738a6e918792c7a2d9'],45,156,201,2555760,3,0,0.68,0.986666667,2016
87c52a42ab7414c98acf3f485d5f0a991917ed02,1,jenkins,2014-06-14 15:37:56-07:00,['2e163e408dcd2a678090e31c1a58687bb6a659fb'],8,16,24,2555784,1,1,1,1,2016
b7351f7d4c51f41d3fb6c03e174bc46a5f11850d,0,jenkins,2014-06-14 15:42:07-07:00,['87c52a42ab7414c98acf3f485d5f0a991917ed02'],1,10,11,2555795,2,0,1,0,2016
0df773eed6134f26b97db6d47fbfdd3f6c1a1b75,1,jenkins,2014-06-14 17:48:40-07:00,['b7351f7d4c51f41d3fb6c03e174bc46a5f11850d'],21,61,82,2555877,5,0.789473684,0.842105263,0.947368421,2016
895bdeddd8626c1863158e7b1e3040ec013faa03,0,jenkins,2014-06-14 18:36:43-07:00,['0df773eed6134f26b97db6d47fbfdd3f6c1a1b75'],6,78,84,2555961,4,0.666666667,0.666666667,1,2016
dbe1b534ed089e91e8a341a9acc444f29d362fb3,1,jenkins,2014-06-15 13:38:20-07:00,['895bdeddd8626c1863158e7b1e3040ec013faa03'],16,67,83,2556044,4,0.379310345,1,0.75862069,2016
47bd01bd76815065751b828e09c0302e5bb64e2b,0,jenkins,2014-06-16 10:57:35-07:00,['dbe1b534ed089e91e8a341a9acc444f29d362fb3'],0,0,0,2556044,0,,,,2016
0326f17bb39ccbf33d9bf170c2975101b839506f,1,jenkins,2014-06-16 14:20:34-07:00,['47bd01bd76815065751b828e09c0302e5bb64e2b'],79,254,333,2556377,11,0.929824561,1,0.49122807,2017
b3c98cf3c859c2be9a757b4348f07f92321f411e,0,Matthew Jacobs,2014-06-16 15:50:33-07:00,['0326f17bb39ccbf33d9bf170c2975101b839506f'],0,3,3,2556380,1,0,0,1,2017
67eb5eb3a84f4e3b71dcde62de0ade91ae26553a,1,jenkins,2014-06-16 20:36:13-07:00,['b3c98cf3c859c2be9a757b4348f07f92321f411e'],4,40,44,2556424,2,0.909090909,0.909090909,1,2017
a136277a67b5369ec5a374bfd462fcc4b8ff25f4,0,jenkins,2014-06-16 23:56:23-07:00,['67eb5eb3a84f4e3b71dcde62de0ade91ae26553a'],3,8,11,2556435,1,0,1,1,2017
6b3689e8c73c4c463b009e9a0aad651ff7533701,1,jenkins,2014-06-17 12:18:50-07:00,['a136277a67b5369ec5a374bfd462fcc4b8ff25f4'],5,38,43,2556478,3,0,0.6,0.76,2017
eed829f7783eabe995599b3b7a78413a2522dc17,0,Alex Behm,2014-06-17 17:45:04-07:00,['6b3689e8c73c4c463b009e9a0aad651ff7533701'],6,6,12,2556490,1,,,,2017
ce22acc974b15b037de83079cb67b9a84b68a1c4,0,jenkins,2014-06-17 22:55:35-07:00,['eed829f7783eabe995599b3b7a78413a2522dc17'],0,1,1,2556491,1,0,0,0,2017
4be9611474bbfed309da0e72a23544c993cb6651,0,Alex Behm,2014-06-17 23:34:07-07:00,['ce22acc974b15b037de83079cb67b9a84b68a1c4'],21,22,43,2556534,1,,,,2017
220b3ac5a8c239df319974cbc79a2bcc6dfdd8da,1,jenkins,2014-06-18 12:27:50-07:00,['4be9611474bbfed309da0e72a23544c993cb6651'],44,42,86,2556620,3,1,0,1,2017
9545921e7a54e1c5797023c9ae95202f291bed9f,1,jenkins,2014-06-18 13:39:16-07:00,['220b3ac5a8c239df319974cbc79a2bcc6dfdd8da'],31,58,89,2556709,4,0.083333333,0.666666667,0.75,2017
9dc883b140ddc4bc38dca287dfb839b610bb5754,0,jenkins,2014-06-18 15:44:43-07:00,['9545921e7a54e1c5797023c9ae95202f291bed9f'],3,9,12,2556721,3,0.333333333,0.333333333,1,2017
0ac052764386f2a239d72ef680401b184bce662d,0,jenkins,2014-06-18 16:18:17-07:00,['9dc883b140ddc4bc38dca287dfb839b610bb5754'],10,35,45,2556766,8,1,0.9375,1,2017
d8175f71092a97c87f8dd2d2b4f769f12019c783,0,Lenni Kuff,2014-06-18 22:22:12-07:00,['0ac052764386f2a239d72ef680401b184bce662d'],1,1,2,2556768,1,,,,2017
677062be3d1888752e4bc1eb511004c96488144b,1,jenkins,2014-06-19 00:56:58-07:00,['d8175f71092a97c87f8dd2d2b4f769f12019c783'],1565,1194,2759,2559527,24,0.781818182,0.027272727,0.472727273,2017
7dacd32983230549ff7e76549c6fdef452d73885,1,jenkins,2014-06-19 00:57:32-07:00,['677062be3d1888752e4bc1eb511004c96488144b'],16,56,72,2559599,4,0.04,0.96,0.96,2017
99602fb8c2f529f980c023ef98750b47b00c718a,0,jenkins,2014-06-19 02:25:50-07:00,['7dacd32983230549ff7e76549c6fdef452d73885'],9,54,63,2559662,2,,,,2018
e7f7eab1b5a37f0911cf7ab1be46c56675cb93f5,1,jenkins,2014-06-19 02:52:10-07:00,['99602fb8c2f529f980c023ef98750b47b00c718a'],1,30,31,2559693,4,0.583333333,0.75,1,2018
c3c9365c1710e92b2d9a7b47afea946281d8c78d,0,Skye Wanderman-Milne,2014-06-19 10:42:58-07:00,['e7f7eab1b5a37f0911cf7ab1be46c56675cb93f5'],9,9,18,2559711,2,,,,2018
ef6705d7e03916428a28a9bc7ac56dbf410c7c2b,1,Alex Behm,2014-06-19 12:44:21-07:00,['c3c9365c1710e92b2d9a7b47afea946281d8c78d'],450,448,898,2560609,22,,,,2018
f92c9a933531cb6569ea69b9eb665c6e08070bf2,0,Ishaan Joshi,2014-06-19 12:48:29-07:00,['ef6705d7e03916428a28a9bc7ac56dbf410c7c2b'],0,2,2,2560611,1,,,,2018
dca53ce023b8a64a770ecedaff90793f1ed5087a,1,jenkins,2014-06-19 12:53:41-07:00,['f92c9a933531cb6569ea69b9eb665c6e08070bf2'],8,12,20,2560631,2,0,0,1,2018
778fba232c1a89cf2f72e75660607146161000e9,1,jenkins,2014-06-19 14:48:59-07:00,['dca53ce023b8a64a770ecedaff90793f1ed5087a'],1,158,159,2560790,4,0.676190476,1,0.79047619,2018
dc3dc3dc1eecf613cf8338f4faefd04b00b046e9,0,Ishaan Joshi,2014-06-19 16:19:13-07:00,['778fba232c1a89cf2f72e75660607146161000e9'],1,1,2,2560792,1,,,,2018
aacd8bcf72a18ce8185f35e5ac24c4d6b17fbece,1,jenkins,2014-06-19 16:44:43-07:00,['dc3dc3dc1eecf613cf8338f4faefd04b00b046e9'],31,39,70,2560862,3,1,1,1,2018
70d7ff07afb37e3415d09b0abcbbd4f4366f812a,1,jenkins,2014-06-19 16:48:34-07:00,['aacd8bcf72a18ce8185f35e5ac24c4d6b17fbece'],26,33,59,2560921,4,,,,2018
11b4d85bf120e34970f9cce7492281db1c136991,0,jenkins,2014-06-19 17:16:29-07:00,['70d7ff07afb37e3415d09b0abcbbd4f4366f812a'],206,216,422,2561343,4,0,0,0,2018
6afbc412ff1b19de76ca73da52b0077dbb9691a9,1,Srinath Shankar,2014-06-19 18:00:39-07:00,['11b4d85bf120e34970f9cce7492281db1c136991'],1,65,66,2561409,2,0,0,1,2019
d6042f77805fc86c71c039db031e298c474bdc77,0,Ishaan Joshi,2014-06-19 18:18:01-07:00,['6afbc412ff1b19de76ca73da52b0077dbb9691a9'],1,2,3,2561412,1,,,,2019
9a57334e3424402b36c3979196830a282e1958f7,1,jenkins,2014-06-19 18:42:32-07:00,['d6042f77805fc86c71c039db031e298c474bdc77'],1,59,60,2561472,3,0,0.136363636,0.454545455,2019
035cf113de70599b10d93debeb18f7c29cb6d4b5,1,jenkins,2014-06-19 22:31:05-07:00,['9a57334e3424402b36c3979196830a282e1958f7'],76,162,238,2561710,2,0.468085106,0.893617021,0.765957447,2019
52f2b2cb5262be0d3a5243cee7185643b378e2d0,1,jenkins,2014-06-20 02:24:41-07:00,['035cf113de70599b10d93debeb18f7c29cb6d4b5'],61,130,191,2561901,9,0.108108108,1,0.432432432,2019
6026f1ebe16f21902d883e8bfeb2413e55bdc9ee,0,jenkins,2014-06-20 09:32:52-07:00,['52f2b2cb5262be0d3a5243cee7185643b378e2d0'],10,43,53,2561954,5,0.666666667,0.666666667,1,2019
c4219929f94ad50c45e1f22232dcd17497a4603d,1,jenkins,2014-06-20 09:57:13-07:00,['6026f1ebe16f21902d883e8bfeb2413e55bdc9ee'],101,191,292,2562246,6,0.263157895,0.964912281,0.964912281,2019
df9c13dcbedbd83350cd5a8b78d5d181725438f6,0,jenkins,2014-06-20 12:29:20-07:00,['c4219929f94ad50c45e1f22232dcd17497a4603d'],1,10,11,2562257,1,0,0,1,2019
7dbd3a5860c3dae25093dd8db646b83da61ebcb4,0,jenkins,2014-06-20 12:46:52-07:00,['df9c13dcbedbd83350cd5a8b78d5d181725438f6'],14,103,117,2562374,9,0.419354839,0.322580645,0.967741935,2019
0d0614765df0eb07ee2344b0a6d0f6ab0631ce29,1,Ishaan Joshi,2014-06-20 12:52:08-07:00,['7dbd3a5860c3dae25093dd8db646b83da61ebcb4'],1,7,8,2562382,1,,,,2019
7faaa659967fbe54597b2018c12a33e5f4b57554,1,jenkins,2014-06-20 13:35:10-07:00,['0d0614765df0eb07ee2344b0a6d0f6ab0631ce29'],4,4892,4896,2567278,11,1,1,1,2023
2d7f2e19b2b33ba2059dd2dc03984b1a06a8e9e9,1,jenkins,2014-06-20 17:38:01-07:00,['7faaa659967fbe54597b2018c12a33e5f4b57554'],12,471,483,2567761,18,0.231155779,0.708542714,0.929648241,2032
881f3a8c33231e09e4e65ffcd32f366d48259e3c,1,jenkins,2014-06-20 18:46:10-07:00,['2d7f2e19b2b33ba2059dd2dc03984b1a06a8e9e9'],465,530,995,2568756,11,0.297297297,0.297297297,0.972972973,2032
7b81a0330cc8ce48a420c22a93e7e49a423f370a,1,jenkins,2014-06-20 20:05:10-07:00,['881f3a8c33231e09e4e65ffcd32f366d48259e3c'],44,26,70,2568826,5,0.25,0,0,2032
b72ef379b693e672a6f1e254fa2e4fc3fec929b2,0,Nong Li,2014-06-20 23:03:05-07:00,['7b81a0330cc8ce48a420c22a93e7e49a423f370a'],0,0,0,2568826,0,,,,2032
a7beb125405bd1e031cb11b1ff8f158b2454395b,1,Nong Li,2014-06-20 23:03:06-07:00,['b72ef379b693e672a6f1e254fa2e4fc3fec929b2'],34,36,70,2568896,5,0,0,1,2032
7992e872c15676ea04ea9cf268f21f3b09b0c780,0,jenkins,2014-06-21 00:03:16-07:00,['a7beb125405bd1e031cb11b1ff8f158b2454395b'],0,0,0,2568896,0,,,,2032
2a374e5893ce9eacf25da9e0ed97d26ffbef15f4,1,jenkins,2014-06-21 00:08:19-07:00,['7992e872c15676ea04ea9cf268f21f3b09b0c780'],146,236,382,2569278,4,0.555555556,0,0.805555556,2032
bac4f6c9c8ca5c38226b7890ec2ae27d3577e270,1,jenkins,2014-06-21 00:40:26-07:00,['2a374e5893ce9eacf25da9e0ed97d26ffbef15f4'],37,53,90,2569368,3,0.2,1,1,2032
bf8e1b81a08c5b8ef19f029689defc7a29328780,1,jenkins,2014-06-23 11:40:08-07:00,['bac4f6c9c8ca5c38226b7890ec2ae27d3577e270'],50,77,127,2569495,7,1,1,0.571428571,2032
bf852259117fa57940e7dc17488b19c3feb2aec5,0,jenkins,2014-06-23 15:38:06-07:00,['bf8e1b81a08c5b8ef19f029689defc7a29328780'],0,210,210,2569705,2,,,,2032
13f487ae31edaf119d289c3856246dba918c6334,1,jenkins,2014-06-23 19:08:37-07:00,['bf852259117fa57940e7dc17488b19c3feb2aec5'],121,206,327,2570032,7,0,0.590909091,1,2032
5a6f53db16f1464abbdddbe6f82f338f2769e3ca,1,jenkins,2014-06-24 02:14:27-07:00,['13f487ae31edaf119d289c3856246dba918c6334'],1682,1271,2953,2572985,30,1,1,1,2032
6a795915d678fec79a8bcefd339766d51e884e12,1,jenkins,2014-06-25 21:52:11-07:00,['5a6f53db16f1464abbdddbe6f82f338f2769e3ca'],2,10,12,2572997,2,0,0,0,2032
d6a20c2f08df643aef026a024a496e1e7742c143,1,jenkins,2014-06-26 12:06:39-07:00,['6a795915d678fec79a8bcefd339766d51e884e12'],2,2,4,2573001,1,,,,2032
3a6600c964d26a4c1747911960e8602cc34bdd18,0,jenkins,2014-06-26 22:17:56-07:00,['d6a20c2f08df643aef026a024a496e1e7742c143'],1,1,2,2573003,1,,,,2032
6d17b93814b830748cb1e8009ff6def8a58a8bd2,0,jenkins,2014-06-26 23:48:29-07:00,['3a6600c964d26a4c1747911960e8602cc34bdd18'],9,37,46,2573049,5,1,1,0.80952381,2032
3a6d6b71cb92c998fa2f749775fcc8cd4ae0f030,0,jenkins,2014-06-26 23:52:02-07:00,['6d17b93814b830748cb1e8009ff6def8a58a8bd2'],31,29,60,2573109,3,1,0,0,2032
5305b1712155d23fa2ef2ecadc82c589b25302bb,0,jenkins,2014-06-26 23:58:40-07:00,['3a6d6b71cb92c998fa2f749775fcc8cd4ae0f030'],4,29,33,2573142,1,1,1,1,2032
553395928eb48fa19033d887c2ab9f1582cfb538,0,Nong Li,2014-06-27 11:21:47-07:00,['5305b1712155d23fa2ef2ecadc82c589b25302bb'],1,1,2,2573144,1,,,,2032
67e80b16e34996f2f97cfdcee0b38e01c9137781,0,Nong Li,2014-06-27 11:21:54-07:00,['553395928eb48fa19033d887c2ab9f1582cfb538'],13,84,97,2573241,1,0.80952381,1,1,2032
3e31f81731bcb4cff5e7cd0625093c8c7a2618ab,0,Nong Li,2014-06-27 11:22:00-07:00,['67e80b16e34996f2f97cfdcee0b38e01c9137781'],1,4,5,2573246,1,1,0,1,2032
163750f170c61b652943bcb4f09f85c669e05a04,0,Nong Li,2014-06-27 11:22:05-07:00,['3e31f81731bcb4cff5e7cd0625093c8c7a2618ab'],9,12,21,2573267,3,,,,2032
2aedf5fab44177a8bd16f81c7db541e3a7d0545f,0,jenkins,2014-06-27 18:00:09-07:00,['163750f170c61b652943bcb4f09f85c669e05a04'],0,1,1,2573268,1,,,,2032
ad933ec7657a24410ad3b4b1c883f786304ff9b7,1,jenkins,2014-06-28 20:46:06-07:00,['2aedf5fab44177a8bd16f81c7db541e3a7d0545f'],38,38,76,2573344,9,,,,2032
96722da3fe8e76eaf7ed0a1b5aa64dc1c6c94da0,0,jenkins,2014-06-30 10:17:26-07:00,['ad933ec7657a24410ad3b4b1c883f786304ff9b7'],1,1,2,2573346,1,,,,2032
7777fbff5335804ed01b22374047099a59a5c084,1,jenkins,2014-06-30 10:18:26-07:00,['96722da3fe8e76eaf7ed0a1b5aa64dc1c6c94da0'],781,965,1746,2575092,56,0.727272727,0.022727273,0,2033
630d90392ef60f6f5a2cd82351abba49999d77eb,0,jenkins,2014-06-30 15:05:31-07:00,['7777fbff5335804ed01b22374047099a59a5c084'],1,43,44,2575136,2,0,0,1,2033
65c1a6f21ef6da21120cbb04b495d789265b2f92,1,Matthew Jacobs,2014-06-30 16:47:47-07:00,['630d90392ef60f6f5a2cd82351abba49999d77eb'],137,199,336,2575472,12,0.052631579,1,1,2033
d0fe59fe959bd8c8f32291ed7d7090ec355f8f41,0,Nong Li,2014-07-01 08:05:09-07:00,['65c1a6f21ef6da21120cbb04b495d789265b2f92'],1,3,4,2575476,1,,,,2033
3fe082d3c96d290dfe8118bda70240203ee166ef,0,Nong Li,2014-07-01 08:05:28-07:00,['d0fe59fe959bd8c8f32291ed7d7090ec355f8f41'],8,73,81,2575557,3,0,0.145454545,1,2033
9abca8321bc5906ed15d498b3a9065add4f1cbd0,1,Nong Li,2014-07-01 08:05:39-07:00,['3fe082d3c96d290dfe8118bda70240203ee166ef'],44,110,154,2575711,7,0,0.725,0.9,2033
140b1c8b952b0c2e86057dcd00f98c3ba32c1ef4,0,jenkins,2014-07-01 13:45:20-07:00,['9abca8321bc5906ed15d498b3a9065add4f1cbd0'],12,16,28,2575739,1,1,1,1,2033
3c388cd1dc10b022edf67e5363d4ff506280897f,1,jenkins,2014-07-01 13:49:53-07:00,['140b1c8b952b0c2e86057dcd00f98c3ba32c1ef4'],8,57,65,2575804,3,0,0.75,1,2033
a5c85898e6801ec14b370c265c66cf77c8a90a73,0,jenkins,2014-07-01 15:24:39-07:00,['3c388cd1dc10b022edf67e5363d4ff506280897f'],1,2,3,2575807,2,0,1,1,2033
f0fb28158b813856a31d4bb2671a38b7e1800741,1,jenkins,2014-07-01 15:48:08-07:00,['a5c85898e6801ec14b370c265c66cf77c8a90a73'],13,117,130,2575937,15,0.424242424,0.454545455,1,2033
003da0ec59db936fd869f7f28f728adedd87bfec,1,jenkins,2014-07-01 17:50:21-07:00,['f0fb28158b813856a31d4bb2671a38b7e1800741'],233,397,630,2576567,11,0.25,0,0.956896552,2033
dd4c1c32dc849c02d3988048021e46036a6edac9,1,Henry Robinson,2014-07-01 18:08:47-07:00,['003da0ec59db936fd869f7f28f728adedd87bfec'],87,179,266,2576833,20,0,0.254901961,0.68627451,2033
cf782fe5001a6e24f44b1acd2a78ab4f86e1679c,1,jenkins,2014-07-01 19:23:29-07:00,['dd4c1c32dc849c02d3988048021e46036a6edac9'],12,41,53,2576886,7,1,0.941176471,1,2033
f05e2a92afc12f162af1c48e5139b663d2e990a8,0,jenkins,2014-07-01 20:44:36-07:00,['cf782fe5001a6e24f44b1acd2a78ab4f86e1679c'],3,4,7,2576893,1,,,,2033
274f97efc5eb0197ad1e6aebb30517ee65f9109b,1,jenkins,2014-07-01 20:45:08-07:00,['f05e2a92afc12f162af1c48e5139b663d2e990a8'],2,8,10,2576903,1,1,1,1,2033
1d3267ef8bce46112f5e3c7302b77dafb0954240,0,Lenni Kuff,2014-07-02 15:23:24-07:00,['274f97efc5eb0197ad1e6aebb30517ee65f9109b'],0,1,1,2576904,1,,,,2034
f262fcea6433c80b6c0585e0e2c3403564979ede,1,jenkins,2014-07-02 23:18:27-07:00,['1d3267ef8bce46112f5e3c7302b77dafb0954240'],8,40,48,2576952,3,0.764705882,1,1,2034
dbae673715d4c2b40516db916378c462ef843acc,1,jenkins,2014-07-03 12:04:25-07:00,['f262fcea6433c80b6c0585e0e2c3403564979ede'],7,58,65,2577017,5,0,0.696969697,1,2034
b572fe0af51142b3df59afcaf25d1c25fbff8d00,1,jenkins,2014-07-03 21:32:51-07:00,['dbae673715d4c2b40516db916378c462ef843acc'],29,87,116,2577133,8,0.038461538,0.653846154,1,2034
e1ae5fe95a753a4e6198c55fbfffda7b484d7a54,1,jenkins,2014-07-07 15:13:25-07:00,['b572fe0af51142b3df59afcaf25d1c25fbff8d00'],147,151,298,2577431,4,,,,2034
21c9eb68b1251e5ed23ad06fa8df88e3641b8be5,0,jenkins,2014-07-08 10:45:43-07:00,['e1ae5fe95a753a4e6198c55fbfffda7b484d7a54'],4,69,73,2577504,4,0,0.954545455,1,2034
2b5df0c6ff50bbcad05658f12d7078ae40537c93,1,jenkins,2014-07-08 14:51:43-07:00,['21c9eb68b1251e5ed23ad06fa8df88e3641b8be5'],611,17908,18519,2596023,24,,,,2034
84195eb1b0235e1d35acf723e4ed23b0e71ef2b3,0,jenkins,2014-07-09 14:19:11-07:00,['2b5df0c6ff50bbcad05658f12d7078ae40537c93'],1,1,2,2596025,1,,,,2034
087431697546331439daf753d9a3efbf9815c11e,0,jenkins,2014-07-09 17:57:05-07:00,['84195eb1b0235e1d35acf723e4ed23b0e71ef2b3'],0,2,2,2596027,1,0,0,0,2034
04ef96e873b76f824762299039270431572ac1bc,1,jenkins,2014-07-09 17:59:13-07:00,['087431697546331439daf753d9a3efbf9815c11e'],755,414,1169,2597196,19,0.390625,0.390625,0.671875,2034
ff32821c6b85a9a3ed30e9f35b1a56796e8a9d33,0,jenkins,2014-07-09 19:04:55-07:00,['04ef96e873b76f824762299039270431572ac1bc'],0,74,74,2597270,3,0.326530612,1,0.87755102,2034
17fb6e758f755c98a9244a0dfac7aed52a73ed24,0,jenkins,2014-07-10 15:33:46-07:00,['ff32821c6b85a9a3ed30e9f35b1a56796e8a9d33'],3,38,41,2597311,2,0,1,1,2034
ebc70d921d69259716146d4c955382578b72b1cc,1,jenkins,2014-07-10 19:09:08-07:00,['17fb6e758f755c98a9244a0dfac7aed52a73ed24'],61,73,134,2597445,10,1,1,1,2034
79d64ad7ba5922ed3627c33f04c209f10e5a700a,0,Henry Robinson,2014-07-11 23:06:36-07:00,['ebc70d921d69259716146d4c955382578b72b1cc'],1,3,4,2597449,1,,,,2034
9d0173c6475069634f5eef0ba8b16f391f163b37,0,jenkins,2014-07-14 15:38:11-07:00,['79d64ad7ba5922ed3627c33f04c209f10e5a700a'],0,1,1,2597450,1,,,,2034
f4d1afe0ce5d098ddfe0b57241671bd54466bad8,0,jenkins,2014-07-15 12:32:43-07:00,['9d0173c6475069634f5eef0ba8b16f391f163b37'],1,3,4,2597454,2,0,1,1,2034
8d6f8ff01c6c3ce0e1a4d951608ddee16131d029,0,jenkins,2014-07-15 14:43:10-07:00,['f4d1afe0ce5d098ddfe0b57241671bd54466bad8'],0,4,4,2597458,1,1,1,1,2034
568e8517746867a2b457fb82a6886b016301e304,0,jenkins,2014-07-15 14:44:37-07:00,['8d6f8ff01c6c3ce0e1a4d951608ddee16131d029'],3,10,13,2597471,2,0.333333333,0.833333333,0.5,2034
864ed53511f746a7aae4a3861e26799a26503d7c,1,jenkins,2014-07-15 15:43:49-07:00,['568e8517746867a2b457fb82a6886b016301e304'],9,14,23,2597494,2,1,1,1,2034
f5d4280045ef60d78f0d4d8982399e137d5f7c73,0,Nong Li,2014-07-15 16:57:09-07:00,['864ed53511f746a7aae4a3861e26799a26503d7c'],8,8,16,2597510,5,,,,2034
1ce1c47184eeaee68cbe8c2a5146a7f862126681,1,Nong Li,2014-07-15 16:57:09-07:00,['f5d4280045ef60d78f0d4d8982399e137d5f7c73'],65,5,70,2597580,6,1,0.702702703,0.081081081,2034
6ca2eb49440bb9efab3d20628194bc19457d001e,1,Nong Li,2014-07-15 16:57:09-07:00,['1ce1c47184eeaee68cbe8c2a5146a7f862126681'],44,51,95,2597675,3,1,0,1,2034
188a0ea8338f58b7ffa2659a80dc03f3a82dee68,0,Nong Li,2014-07-15 16:57:09-07:00,['6ca2eb49440bb9efab3d20628194bc19457d001e'],182,165,347,2598022,11,1,0,0.555555556,2034
207e3f8b95143046e3dfb4911bc19ec68b0732d8,0,Nong Li,2014-07-15 16:57:09-07:00,['188a0ea8338f58b7ffa2659a80dc03f3a82dee68'],15,34,49,2598071,4,0,0.818181818,0.818181818,2034
0e6b8ecfcd2fcdd9c4988d9249536e8bd9997928,1,Nong Li,2014-07-15 16:57:09-07:00,['207e3f8b95143046e3dfb4911bc19ec68b0732d8'],4,58,62,2598133,3,0.555555556,1,0.955555556,2034
6c1e272ef76bd9b2cb21aca71d4f1c74dcfb485b,0,jenkins,2014-07-15 18:10:40-07:00,['0e6b8ecfcd2fcdd9c4988d9249536e8bd9997928'],0,5,5,2598138,2,0.75,0.75,1,2034
075c9bc0d9bce409ba96ddda610f7f5a3b40642b,1,jenkins,2014-07-15 18:48:28-07:00,['6c1e272ef76bd9b2cb21aca71d4f1c74dcfb485b'],44,32,76,2598214,5,0,0,0,2034
52f223137c0a329ccde03e3285d2b2de0300972c,0,jenkins,2014-07-15 19:37:38-07:00,['075c9bc0d9bce409ba96ddda610f7f5a3b40642b'],24,0,24,2598238,1,,,,2034
798dcd3a3c4d96b7e9c220d3d0a68b2454385061,0,jenkins,2014-07-16 22:38:35-07:00,['52f223137c0a329ccde03e3285d2b2de0300972c'],4,41,45,2598283,1,0,0,1,2034
b2bc920c6ce4b075f4797d00538463120e7f2cf2,1,jenkins,2014-07-17 12:25:25-07:00,['798dcd3a3c4d96b7e9c220d3d0a68b2454385061'],70,833,903,2599186,12,0.132882883,0.84009009,0.921171171,2036
3d173e65d2a23b9131631639f04b348bf19555f6,0,jenkins,2014-07-18 12:03:58-07:00,['b2bc920c6ce4b075f4797d00538463120e7f2cf2'],1,353,354,2599540,3,0,0,1,2036
7157f54bbe11490460ee8b8f29af219542743d63,1,jenkins,2014-07-21 10:28:16-07:00,['3d173e65d2a23b9131631639f04b348bf19555f6'],35,367,402,2599942,12,0.463768116,0.630434783,0.826086957,2037
879a40913c8737da246952ec5a2185ccc1716244,1,jenkins,2014-07-21 15:27:46-07:00,['7157f54bbe11490460ee8b8f29af219542743d63'],490,652,1142,2601084,10,0.363636364,0.935064935,0,2037
80cc3d88cb65639c77ee8c23cea048c870f8a44c,1,jenkins,2014-07-21 19:10:07-07:00,['879a40913c8737da246952ec5a2185ccc1716244'],2,9,11,2601095,3,0,1,1,2037
e9864d5f78c95900a28375f0368155dd1d4e722b,1,jenkins,2014-07-21 20:00:46-07:00,['80cc3d88cb65639c77ee8c23cea048c870f8a44c'],1875,2458,4333,2605428,90,0.347692308,0.618461538,0.923076923,2043
c6f49bb8e39c7179fc68d7c5c43bc3b2c9a4efe4,0,jenkins,2014-07-21 20:05:50-07:00,['e9864d5f78c95900a28375f0368155dd1d4e722b'],42,53,95,2605523,4,,,,2043
d8e76cc43eb89c425a4a76dc55e6c6e658e96ef0,0,jenkins,2014-07-21 23:29:46-07:00,['c6f49bb8e39c7179fc68d7c5c43bc3b2c9a4efe4'],1,1,2,2605525,1,,,,2043
9a2f7d3bbefc0e14243eaf5656ac724e27e9c5b1,1,jenkins,2014-07-22 02:54:51-07:00,['d8e76cc43eb89c425a4a76dc55e6c6e658e96ef0'],17,21,38,2605563,7,0,0,1,2043
dacdee63174068c479c0f706621a3b293057415c,0,jenkins,2014-07-22 03:46:31-07:00,['9a2f7d3bbefc0e14243eaf5656ac724e27e9c5b1'],32,62,94,2605657,12,0.1,1,0.9,2043
202d656ddcf0891f3959dde6a073c73556b219e0,1,jenkins,2014-07-22 04:08:28-07:00,['dacdee63174068c479c0f706621a3b293057415c'],11,19,30,2605687,6,0.75,1,1,2043
1d5b9440d781dbeb20a224f2abc52dcb7862c731,0,jenkins,2014-07-22 11:26:43-07:00,['202d656ddcf0891f3959dde6a073c73556b219e0'],7,19,26,2605713,4,,,,2043
a25400c94ec3c154e090391e1f3aef9b77175815,1,jenkins,2014-07-22 12:12:13-07:00,['1d5b9440d781dbeb20a224f2abc52dcb7862c731'],5,5,10,2605723,3,1,,0,2043
7dc57aaa9eeb440b043f540e5be102543ec8020b,1,Nong Li,2014-07-22 12:45:37-07:00,['a25400c94ec3c154e090391e1f3aef9b77175815'],333,715,1048,2606771,10,0,0.558704453,1,2043
6850d7ff90c8ca50394d692ef3a8792493f8b3e1,1,jenkins,2014-07-22 13:24:42-07:00,['7dc57aaa9eeb440b043f540e5be102543ec8020b'],43,130,173,2606944,6,0,1,1,2043
cfa58a4567e9164bbbad00e34faa4512ef88e628,0,jenkins,2014-07-22 14:35:46-07:00,['6850d7ff90c8ca50394d692ef3a8792493f8b3e1'],0,5,5,2606949,1,,,,2043
629d351ae15344f38fb71b013ab4857c5ea0dc73,0,jenkins,2014-07-22 14:55:28-07:00,['cfa58a4567e9164bbbad00e34faa4512ef88e628'],52,110,162,2607111,4,0.244897959,1,1,2043
045d69a6c6ea28fb42501de84fde8e4b76b18476,1,jenkins,2014-07-22 20:23:37-07:00,['629d351ae15344f38fb71b013ab4857c5ea0dc73'],33,118,151,2607262,6,0.8125,0.916666667,0.729166667,2043
19bab59854809b565c26efa0aefb6b2fc5976973,1,jenkins,2014-07-23 17:26:14-07:00,['045d69a6c6ea28fb42501de84fde8e4b76b18476'],168,642,810,2608072,25,0.103286385,1,0.971830986,2043
f9bad0530a80163d8e5cfa13c926f15bd5eddc56,0,jenkins,2014-07-24 01:56:41-07:00,['19bab59854809b565c26efa0aefb6b2fc5976973'],1,18,19,2608091,3,0,0.615384615,1,2043
c001be18d4dd1c9bec373ea62e095574d7b1c5ba,0,jenkins,2014-07-24 10:57:29-07:00,['f9bad0530a80163d8e5cfa13c926f15bd5eddc56'],10,6,16,2608107,3,1,1,1,2043
67d23c2d4b8e7fcccbfd0a4ed399a46b72085c82,0,jenkins,2014-07-24 12:34:02-07:00,['c001be18d4dd1c9bec373ea62e095574d7b1c5ba'],85,128,213,2608320,1,,,,2043
b83aa4984b40be30ac2ea0024f3b23064d07dbb5,1,jenkins,2014-07-25 00:21:10-07:00,['67d23c2d4b8e7fcccbfd0a4ed399a46b72085c82'],23,908,931,2609251,10,0.376666667,0.83,0.863333333,2044
1fee56cb26ae8f3c46bd0ccddc2c0fbb7145a87f,1,jenkins,2014-07-25 10:25:09-07:00,['b83aa4984b40be30ac2ea0024f3b23064d07dbb5'],7,331,338,2609589,14,0.517241379,0.74137931,1,2047
3bed0be1df4f8f899c89b237490c5e54a42ab08d,1,jenkins,2014-07-25 18:17:11-07:00,['1fee56cb26ae8f3c46bd0ccddc2c0fbb7145a87f'],968,804,1772,2611361,12,0.620967742,0.169354839,1,2050
e94de02469a3dfeda7d9358d7a78cb54c7a67159,1,jenkins,2014-07-25 21:06:00-07:00,['3bed0be1df4f8f899c89b237490c5e54a42ab08d'],545,1123,1668,2613029,9,0.137777778,0.764444444,0.768888889,2050
3e3c0991cc69f88f130567eb683bdd41c49a43e4,0,jenkins,2014-07-27 02:14:42-07:00,['e94de02469a3dfeda7d9358d7a78cb54c7a67159'],148,28,176,2613205,6,,,,2050
a537375135433dcbe68ec63674ffed65d8e73763,0,jenkins,2014-07-29 03:31:23-07:00,['3e3c0991cc69f88f130567eb683bdd41c49a43e4'],3,9,12,2613217,2,0,0,1,2050
504c83fe782c0f8554457d628e0932c9e5384e09,1,jenkins,2014-07-29 22:14:50-07:00,['a537375135433dcbe68ec63674ffed65d8e73763'],68,270,338,2613555,6,0.105263158,0.798245614,1,2054
b996fccc3ffbad4ffda9a7e9acb635087871a26b,0,jenkins,2014-07-29 17:06:24-07:00,['504c83fe782c0f8554457d628e0932c9e5384e09'],1097,584,1681,2615236,16,0,0,0,2062
55a054e1b8bbd50370f44347f7d484d114284f03,0,Henry Robinson,2014-07-29 17:20:55-07:00,['b996fccc3ffbad4ffda9a7e9acb635087871a26b'],5,4,9,2615245,1,,,,2062
4b8ca060b8465a51441138aebd347b8c852818be,0,jenkins,2014-07-29 17:24:45-07:00,['55a054e1b8bbd50370f44347f7d484d114284f03'],0,31,31,2615276,3,,,,2063
7701c651a454f40a1b2e024d2abed7b77e865ba0,1,jenkins,2014-07-29 20:28:36-07:00,['4b8ca060b8465a51441138aebd347b8c852818be'],307,565,872,2616148,42,0,0.455882353,0.911764706,2063
0c9b3d498502b767a8e32fdae81936762e621b69,1,jenkins,2014-07-30 01:09:54-07:00,['7701c651a454f40a1b2e024d2abed7b77e865ba0'],484,957,1441,2617589,32,0.557377049,0,0.163934426,2073
8258c53478319dddddeb73049ed972295b94dab7,0,jenkins,2014-07-30 02:53:35-07:00,['0c9b3d498502b767a8e32fdae81936762e621b69'],7,8,15,2617604,1,,,,2073
09bd8b7c270a6b785fade1522f85469bc97b91b1,1,jenkins,2014-07-30 11:37:11-07:00,['8258c53478319dddddeb73049ed972295b94dab7'],29,40,69,2617673,5,0,0,0,2073
c2d9490e2fb334453ce507b76698474f5daa0592,1,jenkins,2014-07-31 00:44:39-07:00,['09bd8b7c270a6b785fade1522f85469bc97b91b1'],42,75,117,2617790,7,0.058823529,0,0.823529412,2073
822b3394f5bb1fb62baf4a162a9fcea376b74d0b,1,jenkins,2014-07-31 15:41:58-07:00,['c2d9490e2fb334453ce507b76698474f5daa0592'],0,63,63,2617853,1,,,,2073
285aeda16e39342b5e293dda2659b71f86229eed,1,jenkins,2014-07-31 18:15:16-07:00,['822b3394f5bb1fb62baf4a162a9fcea376b74d0b'],26,98,124,2617977,4,0.75,0.75,0.583333333,2073
5102d855e78a3a6084c9d2aba14af5371dc0b8d1,0,Ishaan Joshi,2014-07-31 19:03:51-07:00,['285aeda16e39342b5e293dda2659b71f86229eed'],0,2,2,2617979,1,,,,2073
22858ba7e16f74f843727bae8a16bfc767276e67,1,jenkins,2014-07-31 23:57:08-07:00,['5102d855e78a3a6084c9d2aba14af5371dc0b8d1'],29,168,197,2618176,5,0,0,1,2073
f3ae861b0ff428411a61eea74cd76b6b8d76a745,0,Lenni Kuff,2014-08-01 00:01:04-07:00,['22858ba7e16f74f843727bae8a16bfc767276e67'],0,114,114,2618290,3,,,,2074
24b4004bfff472dfbc086075791f35ca8621f651,1,jenkins,2014-08-01 18:06:36-07:00,['f3ae861b0ff428411a61eea74cd76b6b8d76a745'],1,2,3,2618293,1,0,0,1,2074
f518baf4547d5b8c31b1d2b401d0fe22a7c1b1cd,1,jenkins,2014-08-01 18:07:06-07:00,['24b4004bfff472dfbc086075791f35ca8621f651'],38,1710,1748,2620041,26,0.293124246,0.657418577,0.903498191,2080
1f81091daf18fea7346d1e92c0753e0dac07ee1d,0,Henry Robinson,2014-08-01 18:33:02-07:00,['f518baf4547d5b8c31b1d2b401d0fe22a7c1b1cd'],0,0,0,2620041,0,,,,2080
1a2cd20660d280f27d0e17979d20375e2e9422c4,1,jenkins,2014-08-01 20:20:03-07:00,['1f81091daf18fea7346d1e92c0753e0dac07ee1d'],800,679,1479,2621520,95,0,0,0.851351351,2081
08233499d48cb1a86a1f003349d2dfd0f5cbe2fd,1,jenkins,2014-08-03 15:15:55-07:00,['1a2cd20660d280f27d0e17979d20375e2e9422c4'],2,20,22,2621542,3,0.2,0.2,1,2081
ddf634abb223e86a1aec2e34df44ed88e2525259,1,jenkins,2014-08-03 15:20:49-07:00,['08233499d48cb1a86a1f003349d2dfd0f5cbe2fd'],1,15,16,2621558,3,0.142857143,0.285714286,1,2081
1c56301b8ec02fb813b98fab63f019a5933c946a,1,jenkins,2014-08-03 15:21:28-07:00,['ddf634abb223e86a1aec2e34df44ed88e2525259'],14,32,46,2621604,5,0,0.777777778,1,2081
56b422c0c485a46efbe95b76b197c47a428c7c40,1,jenkins,2014-08-03 18:13:44-07:00,['1c56301b8ec02fb813b98fab63f019a5933c946a'],1,5,6,2621610,1,,,,2081
f0c7947558a0695a145d0b13f6d1480f4d260612,1,jenkins,2014-08-04 01:45:40-07:00,['56b422c0c485a46efbe95b76b197c47a428c7c40'],0,45,45,2621655,3,0,0,1,2081
4895c68bd16419c01450849d6af0ab06d068764d,0,jenkins,2014-08-04 18:34:48-07:00,['f0c7947558a0695a145d0b13f6d1480f4d260612'],3,0,3,2621658,1,1,1,0,2081
3c9bc4110ba8de266d16b2c43c45654fbc6c4e88,0,jenkins,2014-08-04 18:40:16-07:00,['4895c68bd16419c01450849d6af0ab06d068764d'],14,29,43,2621701,1,0,0,1,2081
9b90a81c6612d271e0e314afcc478953288a1f67,1,jenkins,2014-08-04 19:49:54-07:00,['3c9bc4110ba8de266d16b2c43c45654fbc6c4e88'],222,337,559,2622260,10,0.280701754,1,0,2081
64f55f32fe94e4ff23fd384ffe7aa4bd000deb97,0,jenkins,2014-08-05 11:33:46-07:00,['9b90a81c6612d271e0e314afcc478953288a1f67'],71,123,194,2622454,17,,,,2082
c01f6c02ecd30676b7691832364f268b37c7d9bd,0,jenkins,2014-08-05 12:19:50-07:00,['64f55f32fe94e4ff23fd384ffe7aa4bd000deb97'],1,6,7,2622461,1,1,1,1,2082
572a4aed952858195c7bd9a682b82b909889f879,0,Ippokratis Pandis,2014-08-05 13:19:49-07:00,['c01f6c02ecd30676b7691832364f268b37c7d9bd'],4,12,16,2622477,2,1,1,1,2082
99b23f12851d926639ec187a65acf141fdaa0da3,0,Ippokratis Pandis,2014-08-05 13:19:49-07:00,['572a4aed952858195c7bd9a682b82b909889f879'],3,3,6,2622483,1,,,,2082
15f26f3991dde8b49631bbb805d84ca490f592fa,0,Ippokratis Pandis,2014-08-05 13:19:50-07:00,['99b23f12851d926639ec187a65acf141fdaa0da3'],3,4,7,2622490,1,,,,2082
8994f388dbb8c5596fd329d46bc58849027759ab,1,jenkins,2014-08-05 16:09:39-07:00,['15f26f3991dde8b49631bbb805d84ca490f592fa'],64,298,362,2622852,8,0.436781609,0.471264368,0.931034483,2082
5c3654cc2cab146e100a10ad694125e532c4f5f2,1,jenkins,2014-08-07 15:33:00-07:00,['8994f388dbb8c5596fd329d46bc58849027759ab'],13,44,57,2622909,2,0.304347826,0.086956522,1,2082
ecb0a60addac7fc9ce71345a01764456730fed2f,0,jenkins,2014-08-07 17:52:11-07:00,['5c3654cc2cab146e100a10ad694125e532c4f5f2'],8,14,22,2622931,2,0,0,1,2082
e3cdbf5eb9c86f2df10d6781735d86ca75a4600b,1,jenkins,2014-08-08 02:20:40-07:00,['ecb0a60addac7fc9ce71345a01764456730fed2f'],2658,3288,5946,2628877,23,,,,2082
3111827ae26fbd5e5a27f118a4de8dcfbbc0bef7,1,jenkins,2014-08-08 04:35:31-07:00,['e3cdbf5eb9c86f2df10d6781735d86ca75a4600b'],176,642,818,2629695,22,0.721311475,1,0.590163934,2086
10509a11d0838ff59a7d17a00fac82780b00105a,0,jenkins,2014-08-08 16:53:22-07:00,['3111827ae26fbd5e5a27f118a4de8dcfbbc0bef7'],2,4,6,2629701,1,,,,2086
4ff726fda151e2c4c40dc4f2440826b523fcf9d8,0,Lenni Kuff,2014-08-09 22:17:46-07:00,['10509a11d0838ff59a7d17a00fac82780b00105a'],6,5,11,2629712,1,,,,2086
ad6a339e7d6a4437bbc4c188fa633fc0e2a1170c,0,Lenni Kuff,2014-08-09 22:17:54-07:00,['4ff726fda151e2c4c40dc4f2440826b523fcf9d8'],0,0,0,2629712,0,,,,2086
18ae6cf7e6592ae89e206d8c5465a13faafc0e35,1,Lenni Kuff,2014-08-09 22:18:04-07:00,['ad6a339e7d6a4437bbc4c188fa633fc0e2a1170c'],1,1,2,2629714,1,,,,2086
286e312460a5342780617fb47b456343c474500d,1,Lenni Kuff,2014-08-11 09:53:02-07:00,['18ae6cf7e6592ae89e206d8c5465a13faafc0e35'],135,38,173,2629887,17,0.628712871,0,0,2086
af956e24efcecc7a63febfac91738f460c386aad,0,jenkins,2014-08-12 01:21:14-07:00,['286e312460a5342780617fb47b456343c474500d'],1,3,4,2629891,2,,,,2086
cd30246f17623ea81e086447a24a8806d9f5c6e7,0,Lenni Kuff,2014-08-12 13:38:12-07:00,['af956e24efcecc7a63febfac91738f460c386aad'],27,47,74,2629965,3,,,,2086
5f2a1b9ae5216cd320a5d789012e470493bcc2c7,0,Henry Robinson,2014-08-13 10:21:41-07:00,['cd30246f17623ea81e086447a24a8806d9f5c6e7'],0,0,0,2629965,0,,,,2086
8bdef248209942c340b468cb4115127fe9db391c,1,Ippokratis Pandis,2014-08-13 10:47:55-07:00,['5f2a1b9ae5216cd320a5d789012e470493bcc2c7'],187,221,408,2630373,21,0,0.583333333,0.166666667,2086
a20f03ff395f1a2aec39f6c57101983dc0f23a3d,1,Lenni Kuff,2014-08-13 22:29:59-07:00,['8bdef248209942c340b468cb4115127fe9db391c'],6,6,12,2630385,3,0.361581921,1,1,2086
4d5a2556f1f05ac43739a0ec02dcf8d89fbc6adb,0,Lenni Kuff,2014-08-15 12:35:54-07:00,['a20f03ff395f1a2aec39f6c57101983dc0f23a3d'],1,11,12,2630397,1,,,,2086
69db727f482963960e61d3c691e0b08842c2c084,1,Nong Li,2014-08-17 12:23:54-07:00,['4d5a2556f1f05ac43739a0ec02dcf8d89fbc6adb'],174,298,472,2630869,6,0.208791209,1,0.769230769,2086
3ee273ae504da2e172f19f034dc15ad9b8cb5b83,1,Nong Li,2014-08-17 12:24:17-07:00,['69db727f482963960e61d3c691e0b08842c2c084'],190,377,567,2631436,21,0,0.215384615,0.569230769,2086
5798cf7c6ffc3538d4c9e8c996d2e8a4ce95a697,1,Nong Li,2014-08-17 12:24:51-07:00,['3ee273ae504da2e172f19f034dc15ad9b8cb5b83'],111,182,293,2631729,6,0,0,0,2086
6c812a26481d137e4ab3d3365e06d9bd6bf24ed4,0,Nong Li,2014-08-17 12:25:14-07:00,['5798cf7c6ffc3538d4c9e8c996d2e8a4ce95a697'],9,26,35,2631764,2,0.0625,1,1,2086
2646a72ba1e5f8e3f0e0672680adcd5d735eb969,0,Nong Li,2014-08-17 12:26:32-07:00,['6c812a26481d137e4ab3d3365e06d9bd6bf24ed4'],0,5,5,2631769,1,0,0,1,2086
68592a82a3e0336f4286970b748a2bbd386408ab,1,Nong Li,2014-08-17 12:26:54-07:00,['2646a72ba1e5f8e3f0e0672680adcd5d735eb969'],9,76,85,2631854,6,0,0.714285714,1,2086
901f3504cca11ce7fd4743b095e5020145d89f7e,1,Nong Li,2014-08-17 12:43:23-07:00,['68592a82a3e0336f4286970b748a2bbd386408ab'],181,458,639,2632493,6,0.57,0.77,1,2086
1327f4f07bcbd409aa20869a3dd1ee31c2935e0c,1,Nong Li,2014-08-17 12:43:30-07:00,['901f3504cca11ce7fd4743b095e5020145d89f7e'],13,35,48,2632541,4,0,1,0.666666667,2086
c7c3eacd7d7f23f4cbdc33627c75cebf0c702f6e,1,Nong Li,2014-08-17 12:43:37-07:00,['1327f4f07bcbd409aa20869a3dd1ee31c2935e0c'],14,17,31,2632572,2,1,1,1,2086
3eb8db43c85ba69ad07c2e9d569579915e40025b,1,Nong Li,2014-08-17 12:43:44-07:00,['c7c3eacd7d7f23f4cbdc33627c75cebf0c702f6e'],554,995,1549,2634121,31,0,0.363636364,0.454545455,2096
66ac3ea57bc8c301b09e9aad9699a1418e21bba3,1,Nong Li,2014-08-17 12:43:51-07:00,['3eb8db43c85ba69ad07c2e9d569579915e40025b'],3,42,45,2634166,2,0.607142857,1,0.642857143,2096
fd35cee8873534ea1e920db4f284e19497a891cb,1,Nong Li,2014-08-17 12:43:57-07:00,['66ac3ea57bc8c301b09e9aad9699a1418e21bba3'],220,193,413,2634579,28,0,1,1,2096
8a33b1861bab84b40080f5c179fabe25ef61ed09,1,Nong Li,2014-08-17 12:44:05-07:00,['fd35cee8873534ea1e920db4f284e19497a891cb'],20,75,95,2634674,13,,,,2096
9b5c37f763ab06f49b72056f2318a59562f66adc,0,Nong Li,2014-08-17 12:44:12-07:00,['8a33b1861bab84b40080f5c179fabe25ef61ed09'],13,92,105,2634779,4,0,0.431818182,0.977272727,2096
7d29de16bbd324f8870136fb72ade178353bc39e,1,Nong Li,2014-08-17 12:44:18-07:00,['9b5c37f763ab06f49b72056f2318a59562f66adc'],759,950,1709,2636488,30,0.214285714,0.364285714,0.042857143,2096
1b12e17fc1f1540cb9dfc7928d4db4780bd66d06,1,Nong Li,2014-08-17 12:44:25-07:00,['7d29de16bbd324f8870136fb72ade178353bc39e'],736,1077,1813,2638301,25,0.067264574,0,1,2100
7a0cc27fd1113d924cf538df991acaaeeb169204,1,Nong Li,2014-08-17 12:44:32-07:00,['1b12e17fc1f1540cb9dfc7928d4db4780bd66d06'],612,510,1122,2639423,10,0.382653061,0.255102041,0,2100
f062a22997b38e607e8f2074ba0c0d89c87fbb44,1,Nong Li,2014-08-17 12:44:38-07:00,['7a0cc27fd1113d924cf538df991acaaeeb169204'],659,549,1208,2640631,10,1,1,0,2100
559b83d3d00cb53ad04a3ca20c30fe1cc8d97657,1,Nong Li,2014-08-17 12:44:44-07:00,['f062a22997b38e607e8f2074ba0c0d89c87fbb44'],7768,6238,14006,2654637,191,1,0.774973712,0,2112
9c1cbcff9757ae488eee973c723b8c4fd352439a,0,Nong Li,2014-08-17 12:44:51-07:00,['559b83d3d00cb53ad04a3ca20c30fe1cc8d97657'],1,0,1,2654638,1,,,,2112
446d1061c3eb081f7b4292d540364422dcbc0233,0,Nong Li,2014-08-17 12:44:58-07:00,['9c1cbcff9757ae488eee973c723b8c4fd352439a'],4,4,8,2654646,2,,,,2112
27a9b2eaf4cae97c86dd4e23860061b43094dba1,0,Nong Li,2014-08-17 12:45:04-07:00,['446d1061c3eb081f7b4292d540364422dcbc0233'],1,1,2,2654648,1,,,,2112
f2ef06bef18f2f5c1be837bea5c696225eee788a,1,Nong Li,2014-08-17 12:45:10-07:00,['27a9b2eaf4cae97c86dd4e23860061b43094dba1'],47,767,814,2655462,22,0.509493671,0.794303797,0.810126582,2117
12a9673511d78254da246fcf8b5e2994c235ccce,1,Nong Li,2014-08-17 12:45:37-07:00,['f2ef06bef18f2f5c1be837bea5c696225eee788a'],74,1304,1378,2656840,23,0.277912621,0.64684466,0.932038835,2120
bceeb834f322b730637906c1115a0e48e4366a1b,1,Nong Li,2014-08-17 12:45:45-07:00,['12a9673511d78254da246fcf8b5e2994c235ccce'],90,205,295,2657135,11,0.012987013,0.675324675,0.987012987,2120
a1f504d18c8da95cbbcfb4e1244e866469a2399a,0,Nong Li,2014-08-17 12:45:59-07:00,['bceeb834f322b730637906c1115a0e48e4366a1b'],1,1,2,2657137,1,,,,2120
a37003e64d89d4204980c4ec12141ccbbade6d79,1,Nong Li,2014-08-17 12:46:05-07:00,['a1f504d18c8da95cbbcfb4e1244e866469a2399a'],1,11,12,2657149,1,,,,2120
7f514498697d0423df89c5451a6f79923e43c63d,1,Nong Li,2014-08-17 12:46:10-07:00,['a37003e64d89d4204980c4ec12141ccbbade6d79'],36,37,73,2657222,13,0,0,1,2120
8e193abff35ff65cba82c9db91b37f6d7431a271,1,Nong Li,2014-08-17 12:46:17-07:00,['7f514498697d0423df89c5451a6f79923e43c63d'],22,37,59,2657281,2,0,0,0,2120
91d262a1d78dcf2eee08b3814bfc1ad0b2645ebf,0,jenkins,2014-08-18 16:10:09-07:00,['8e193abff35ff65cba82c9db91b37f6d7431a271'],1,12,13,2657294,2,1,1,1,2120
8e44347831eb431accefdf01241f00933ab8a2f2,1,jenkins,2014-08-18 20:17:05-07:00,['91d262a1d78dcf2eee08b3814bfc1ad0b2645ebf'],6,12,18,2657312,4,0,0.5,0.25,2120
4805dd4956cff3c30ef607f9b9b2ea02670146a4,0,Henry Robinson,2014-08-18 22:08:10-07:00,['8e44347831eb431accefdf01241f00933ab8a2f2'],1,1,2,2657314,1,,,,2120
0b10011f07f93e528072b5aeeff54f8634f4a572,1,jenkins,2014-08-18 23:18:43-07:00,['4805dd4956cff3c30ef607f9b9b2ea02670146a4'],30,772,802,2658116,17,0.425352113,0.729577465,0.723943662,2124
511c28de5cbb38f221d79a3a0d076fca4461da93,0,Daniel Hecht,2014-08-19 10:39:52-07:00,['0b10011f07f93e528072b5aeeff54f8634f4a572'],3,3,6,2658122,2,,,,2124
7a29bb66a11785fcf6a5d04d0562fe38bd7b29fe,1,jenkins,2014-08-19 11:34:43-07:00,['511c28de5cbb38f221d79a3a0d076fca4461da93'],96,159,255,2658377,13,1,1,1,2125
2f0d4534634609b391bf2c92b4a40034f9e2191e,0,jenkins,2014-08-19 15:17:56-07:00,['7a29bb66a11785fcf6a5d04d0562fe38bd7b29fe'],11,38,49,2658426,5,0.666666667,1,0.916666667,2125
7d504b847fe6b40c24db02234dbc6bb44c7e1350,1,Daniel Hecht,2014-08-19 18:00:55-07:00,['2f0d4534634609b391bf2c92b4a40034f9e2191e'],1,3,4,2658430,2,,,,2125
00902c433029d1af5ba3a989ee2cadb327a9c2d1,1,jenkins,2014-08-19 19:30:15-07:00,['7d504b847fe6b40c24db02234dbc6bb44c7e1350'],111,257,368,2658798,13,0.023255814,1,1,2128
ff31b5e8b55cd50fcb78c5e52f72b97cd4a764e7,0,jenkins,2014-08-19 20:08:03-07:00,['00902c433029d1af5ba3a989ee2cadb327a9c2d1'],29,72,101,2658899,3,0,0,0.95,2128
f02ac9453bf1aefaef3a75984b9140b4db1bc089,1,jenkins,2014-08-19 20:15:34-07:00,['ff31b5e8b55cd50fcb78c5e52f72b97cd4a764e7'],137,320,457,2659356,10,0,0,0.661157025,2128
564370a9a7ae2ef606a480024d99994910f44e3a,1,jenkins,2014-08-20 00:13:51-07:00,['f02ac9453bf1aefaef3a75984b9140b4db1bc089'],44,174,218,2659574,3,0.373626374,0.692307692,1,2128
d9a865e897e78d619ef507cf6503ebbc8655fa50,0,jenkins,2014-08-20 00:47:28-07:00,['564370a9a7ae2ef606a480024d99994910f44e3a'],2,2,4,2659578,2,,,,2128
466cedb2176ccf29358ad8ef236973b1249067c2,1,jenkins,2014-08-20 01:50:18-07:00,['d9a865e897e78d619ef507cf6503ebbc8655fa50'],15,143,158,2659736,5,0,1,1,2128
d7a9627161dbfedd98f61ed3dda8df81dc08ad2d,1,jenkins,2014-08-20 03:23:15-07:00,['466cedb2176ccf29358ad8ef236973b1249067c2'],37,1056,1093,2660829,12,0.212844037,0.244036697,0.627522936,2130
8ef98781e141ec040f3f86b9ac625b3285f79c58,1,jenkins,2014-08-20 03:52:27-07:00,['d7a9627161dbfedd98f61ed3dda8df81dc08ad2d'],38,188,226,2661055,7,0,0,0.910891089,2130
3d5e64730cb8525b4b741dcab9d76137826cc125,1,jenkins,2014-08-20 12:17:34-07:00,['8ef98781e141ec040f3f86b9ac625b3285f79c58'],10,28,38,2661093,3,0,0,1,2130
95ba50f80e9b502689e02cc2beab5e700d0fc15f,1,jenkins,2014-08-20 13:13:40-07:00,['3d5e64730cb8525b4b741dcab9d76137826cc125'],16,40,56,2661149,2,0.857142857,0.857142857,1,2130
41412d4ef2fa06082109d054d8bbe4a8d41b211b,1,jenkins,2014-08-20 17:51:40-07:00,['95ba50f80e9b502689e02cc2beab5e700d0fc15f'],2,7,9,2661158,1,0,1,1,2130
768a1bdc545c9f8bf3937dfc3ae84d624827c86f,1,jenkins,2014-08-20 18:52:50-07:00,['41412d4ef2fa06082109d054d8bbe4a8d41b211b'],45,41,86,2661244,6,0,0,0,2130
58ea2ba05a5a7ad18e467a3ea0b592b6a5b2909f,0,jenkins,2014-08-20 19:53:38-07:00,['768a1bdc545c9f8bf3937dfc3ae84d624827c86f'],4,7,11,2661255,2,0,0.333333333,1,2130
8a00f71e12663b7065d0cbe9a770681796c6b07e,1,jenkins,2014-08-20 20:06:02-07:00,['58ea2ba05a5a7ad18e467a3ea0b592b6a5b2909f'],25,130,155,2661410,10,0,0,0.306451613,2130
e21987e338c09589f901030c24708ff569f02877,1,jenkins,2014-08-22 01:51:34-07:00,['8a00f71e12663b7065d0cbe9a770681796c6b07e'],54,134,188,2661598,6,0.652173913,1,1,2131
ae4a4409dd47221997485254b89a6f48fc3e5ab4,0,jenkins,2014-08-22 13:36:38-07:00,['e21987e338c09589f901030c24708ff569f02877'],5,5,10,2661608,3,,,,2131
bb853c47c7bcf03da8bf04ebbe3ea01e2135d840,1,jenkins,2014-08-22 15:39:01-07:00,['ae4a4409dd47221997485254b89a6f48fc3e5ab4'],14,116,130,2661738,4,0.444444444,0.444444444,1,2133
a80506ff3c88383f6360351c80259201b272992e,1,jenkins,2014-08-22 20:13:04-07:00,['bb853c47c7bcf03da8bf04ebbe3ea01e2135d840'],651,800,1451,2663189,7,0.94047619,0.869047619,1,2134
1515fd9db21dd8f3ab2474faf5bd664d384501fa,1,jenkins,2014-08-23 17:12:19-07:00,['a80506ff3c88383f6360351c80259201b272992e'],20,684,704,2663893,12,0.403636364,0.541818182,0.734545455,2137
975b74786e4e2ddcf50d33ba614ca468efc0ddef,0,jenkins,2014-08-25 10:38:04-07:00,['1515fd9db21dd8f3ab2474faf5bd664d384501fa'],0,0,0,2663893,0,,,,2137
a309dad613301330dd1248bbf11dbb77a1118230,0,jenkins,2014-08-25 20:19:54-07:00,['975b74786e4e2ddcf50d33ba614ca468efc0ddef'],0,0,0,2663893,0,,,,2137
39939d596bc2ae94555580d6a811ab0dea3f7284,0,jenkins,2014-08-25 21:10:27-07:00,['a309dad613301330dd1248bbf11dbb77a1118230'],14,35,49,2663942,2,0,0.857142857,1,2137
6b91420928bcdcf01f841fbd53dfaa0e3999f937,1,jenkins,2014-08-26 01:39:16-07:00,['39939d596bc2ae94555580d6a811ab0dea3f7284'],3,10,13,2663955,2,0.285714286,0.285714286,0,2137
bc124b460a3b963a41ff93a924b45cd3ed04ebba,1,jenkins,2014-08-26 13:48:07-07:00,['6b91420928bcdcf01f841fbd53dfaa0e3999f937'],5,66,71,2664026,2,,,,2137
f746645be6cdc9a4ad8653daa0111730b8c75f47,0,Henry Robinson,2014-08-26 14:17:37-07:00,['bc124b460a3b963a41ff93a924b45cd3ed04ebba'],0,6687,6687,2670713,58,1,0.886363636,0.931818182,2194
95fd2358a5f70494cf8d9befde56cf705ff66016,1,jenkins,2014-08-26 15:51:21-07:00,['f746645be6cdc9a4ad8653daa0111730b8c75f47'],21,174,195,2670908,6,0.046728972,0.635514019,0.831775701,2194
9586394049b8c27933c91916af4494a62f8513d6,0,jenkins,2014-08-26 19:06:52-07:00,['95fd2358a5f70494cf8d9befde56cf705ff66016'],0,3,3,2670911,1,1,1,1,2194
6b726496a7c3ffae1c2ed77c4c821b246a8b1146,0,jenkins,2014-08-26 20:26:54-07:00,['9586394049b8c27933c91916af4494a62f8513d6'],8,159,167,2671078,6,0.176470588,0.220588235,0.220588235,2194
cb7da8738305b93aa2f94d566ad9f1a41605ec5e,0,jenkins,2014-08-26 21:09:55-07:00,['6b726496a7c3ffae1c2ed77c4c821b246a8b1146'],6,4,10,2671088,1,,,,2194
7d91391093e7fb4ea8e6cd756a074fb51d222a91,0,jenkins,2014-08-27 13:37:27-07:00,['cb7da8738305b93aa2f94d566ad9f1a41605ec5e'],0,6,6,2671094,1,,,,2194
820e1c070b548b5a05a647b477bc359b7430e5ff,1,jenkins,2014-08-27 13:41:42-07:00,['7d91391093e7fb4ea8e6cd756a074fb51d222a91'],14,489,503,2671597,13,0.221198157,0.543778802,0.834101382,2197
2dce31f6c201befdc0f8149d8b61290277e8d1cb,1,jenkins,2014-08-27 13:52:58-07:00,['820e1c070b548b5a05a647b477bc359b7430e5ff'],81,403,484,2672081,52,0.343137255,0.264705882,0.730392157,2199
5229830a222398c8152b4c8d17de3f246fffd60b,0,Sean Mackrory,2014-08-27 14:00:39-07:00,['2dce31f6c201befdc0f8149d8b61290277e8d1cb'],0,0,0,2672081,0,,,,2199
4d3923790d2472b194df6072f147593761015eda,1,Sean Mackrory,2014-08-27 14:01:11-07:00,['5229830a222398c8152b4c8d17de3f246fffd60b'],19,30,49,2672130,1,,,,2199
befe3ac1ff4600e19b9a6cb806c04673260d297e,0,Sean Mackrory,2014-08-27 14:01:26-07:00,['4d3923790d2472b194df6072f147593761015eda'],0,1,1,2672131,1,,,,2199
b5c13e66afc1a6bbfa8d310467e869ed5053c568,0,Henry Robinson,2014-08-27 14:24:44-07:00,['befe3ac1ff4600e19b9a6cb806c04673260d297e'],1,1,2,2672133,1,,,,2199
26c0b63b29bbc86f4921766379844478a3e6f39b,1,jenkins,2014-08-27 15:42:43-07:00,['b5c13e66afc1a6bbfa8d310467e869ed5053c568'],25,162,187,2672320,5,0.339130435,1,0.686956522,2199
4c3578cfb16302427700e50bb752d63eb81598a3,0,jenkins,2014-08-27 15:58:10-07:00,['26c0b63b29bbc86f4921766379844478a3e6f39b'],3,11,14,2672334,3,1,1,1,2199
db07f474141e39d25a268403e2eb1fe1c41f64be,0,Taras Bobrovytsky,2014-08-27 16:58:02-07:00,['4c3578cfb16302427700e50bb752d63eb81598a3'],12,35,47,2672381,2,0,0,1,2199
b6cfe1af418aff1c33a30cf980ea9525015cd290,1,jenkins,2014-08-27 18:03:22-07:00,['db07f474141e39d25a268403e2eb1fe1c41f64be'],32,109,141,2672522,8,0,0.272727273,0.818181818,2199
81546f35a68156f0ce10584a9fa00197d70fcaea,1,jenkins,2014-08-27 19:45:24-07:00,['b6cfe1af418aff1c33a30cf980ea9525015cd290'],3,19,22,2672544,2,1,1,1,2199
cc517a26d5807ede68bf0d7fc198c4ed3c0edd93,1,jenkins,2014-08-27 22:27:42-07:00,['81546f35a68156f0ce10584a9fa00197d70fcaea'],16,6,22,2672566,3,0.9,0,0,2199
58e230409b91bfc080979ffa2b9f69ad4230c365,1,jenkins,2014-08-28 02:01:39-07:00,['cc517a26d5807ede68bf0d7fc198c4ed3c0edd93'],11,16,27,2672593,1,0,0,0.428571429,2199
5a3d4dd4fc9bf8f17d99e13e3801943d79a5512b,0,Lenni Kuff,2014-08-28 10:50:22-07:00,['58e230409b91bfc080979ffa2b9f69ad4230c365'],1,1,2,2672595,1,,,,2199
54ad2755731694aaca0d063b517dbbdaf4f91fca,1,jenkins,2014-08-28 13:05:39-07:00,['5a3d4dd4fc9bf8f17d99e13e3801943d79a5512b'],0,486,486,2673081,5,0.27016129,0.548387097,0.967741935,2202
8a7df5c3b6e3c05549ae88f1e21ec00a26d99bbe,1,jenkins,2014-08-28 15:33:55-07:00,['54ad2755731694aaca0d063b517dbbdaf4f91fca'],0,162,162,2673243,1,0.768115942,1,0.84057971,2203
4b5be6cce2907edda0433aef71c4dc9f552d034f,1,jenkins,2014-08-28 16:13:07-07:00,['8a7df5c3b6e3c05549ae88f1e21ec00a26d99bbe'],145,77,222,2673465,2,0.266666667,0.266666667,0.911111111,2203
e89ba550c93c97e1400d4e7e12354b4a0f8538e6,1,jenkins,2014-08-28 21:33:34-07:00,['4b5be6cce2907edda0433aef71c4dc9f552d034f'],591,1034,1625,2675090,35,0.137037037,0.507407407,0.151851852,2203
a313a4b6b77aa4b492d98b7b36b3f4bce97b7049,1,Lenni Kuff,2014-08-29 00:45:36-07:00,['e89ba550c93c97e1400d4e7e12354b4a0f8538e6'],9,15,24,2675114,1,,,,2203
c2abcd6f3dac08597dd2daef2692784132d58de0,1,jenkins,2014-08-29 15:35:21-07:00,['a313a4b6b77aa4b492d98b7b36b3f4bce97b7049'],802,3411,4213,2679327,33,0.255648038,0.399524376,0.822829964,2210
39a8b9bc7a43ce29c70c846bd8dff28f63185c0d,0,jenkins,2014-08-30 19:46:54-07:00,['c2abcd6f3dac08597dd2daef2692784132d58de0'],6,33,39,2679366,1,,,,2210
c1db8bc5d9e9dd854b1161f980631ff764089468,1,jenkins,2014-09-02 01:37:48-07:00,['39a8b9bc7a43ce29c70c846bd8dff28f63185c0d'],419,479,898,2680264,27,1,1,0,2210
eb0801edb625f55c5789308c08be7847867e5ea4,1,jenkins,2014-09-02 11:30:25-07:00,['c1db8bc5d9e9dd854b1161f980631ff764089468'],223,263,486,2680750,8,0,0.888888889,1,2211
7274eba8ebbdaa151b96b0be59e2e905334e2e0c,1,jenkins,2014-09-02 13:13:31-07:00,['eb0801edb625f55c5789308c08be7847867e5ea4'],19,21,40,2680790,4,1,1,0,2211
2a59029c2cbac2176df424dfcd01f6653b65b955,0,jenkins,2014-09-02 15:25:54-07:00,['7274eba8ebbdaa151b96b0be59e2e905334e2e0c'],10,5,15,2680805,2,,,,2211
214593e848409c97cd838cf2bf76fa152d5e000b,1,Skye Wanderman-Milne,2014-09-03 11:15:27-07:00,['2a59029c2cbac2176df424dfcd01f6653b65b955'],164,265,429,2681234,11,0.56,1,0.04,2211
d9fa1a2e602a306fada3e2a107002644717943db,1,jenkins,2014-09-03 12:25:59-07:00,['214593e848409c97cd838cf2bf76fa152d5e000b'],3,97,100,2681334,6,0.333333333,0.722222222,0.5,2211
855a7b79161e9968654a40da3e3968a51f10c910,1,jenkins,2014-09-03 13:38:46-07:00,['d9fa1a2e602a306fada3e2a107002644717943db'],824,2336,3160,2684494,25,0.360323887,0.529014845,0.829959514,2216
01f924918768b4dd12ead7e85870d7217adb9279,0,Lenni Kuff,2014-09-03 15:17:08-07:00,['855a7b79161e9968654a40da3e3968a51f10c910'],1,1,2,2684496,1,,,,2216
ab3e27e8c2b97132bcfe0c93de952753031d23ba,0,Lenni Kuff,2014-09-03 15:17:11-07:00,['01f924918768b4dd12ead7e85870d7217adb9279'],0,0,0,2684496,0,,,,2216
e87c6b5f6e9ac1e92b2a1cacb4f527ee68e9f53d,0,Lenni Kuff,2014-09-03 15:17:16-07:00,['ab3e27e8c2b97132bcfe0c93de952753031d23ba'],0,0,0,2684496,0,,,,2216
8fbd5fe2c91c928412866848d2f6f3eab3b77e7e,1,jenkins,2014-09-03 20:12:24-07:00,['e87c6b5f6e9ac1e92b2a1cacb4f527ee68e9f53d'],109,181,290,2684786,8,0,0.23255814,1,2216
69491d26b37b3aa2e639ed44723371fc80350376,1,jenkins,2014-09-03 20:13:54-07:00,['8fbd5fe2c91c928412866848d2f6f3eab3b77e7e'],1,5,6,2684792,2,1,1,1,2216
c322e9590d6bdb6dbe6c503be8b0eb0088d2e055,1,jenkins,2014-09-04 00:46:23-07:00,['69491d26b37b3aa2e639ed44723371fc80350376'],67,456,523,2685315,6,0.141732283,0.566929134,0.842519685,2216
2643908539e347c3c56306d7194ccaf72058c742,1,jenkins,2014-09-04 02:09:54-07:00,['c322e9590d6bdb6dbe6c503be8b0eb0088d2e055'],65,145,210,2685525,6,0.045454545,0.818181818,1,2216
bc8a6f7a30fd4acca1cca188d92b2743866343c5,0,Skye Wanderman-Milne,2014-09-04 11:36:25-07:00,['2643908539e347c3c56306d7194ccaf72058c742'],4,3,7,2685532,1,,,,2216
68a7ac1a4fe102f1a8950b6f48ce2b29d49df712,0,jenkins,2014-09-04 12:58:39-07:00,['bc8a6f7a30fd4acca1cca188d92b2743866343c5'],18,21,39,2685571,1,1,1,0,2216
b68b6dedc17b5d61a52b86985c077e8151e92433,1,jenkins,2014-09-04 13:44:33-07:00,['68a7ac1a4fe102f1a8950b6f48ce2b29d49df712'],338,1184,1522,2687093,23,0.713592233,0.873786408,0.286407767,2217
ae18e62182b3ae98171484204d1ffd5f6502c264,1,jenkins,2014-09-04 19:06:42-07:00,['b68b6dedc17b5d61a52b86985c077e8151e92433'],99,147,246,2687339,8,0.041666667,0.958333333,0.666666667,2217
28e16b02bb8a5ca670b0d6037d70933f07e3301e,1,jenkins,2014-09-05 00:08:05-07:00,['ae18e62182b3ae98171484204d1ffd5f6502c264'],221,218,439,2687778,21,1,0.4,0,2217
2de3bd8a10eff8012d95da0041775a4ca5196978,0,jenkins,2014-09-05 00:08:18-07:00,['28e16b02bb8a5ca670b0d6037d70933f07e3301e'],5,7,12,2687790,2,,,0,2217
5bf1c1f223dff993b43ed499d07f105c368a31df,1,jenkins,2014-09-05 02:15:42-07:00,['2de3bd8a10eff8012d95da0041775a4ca5196978'],175,477,652,2688442,13,0.407407407,0.296296296,0.577777778,2217
321b9b0804282ac90945e17d76e46700596fd98e,0,jenkins,2014-09-05 10:12:55-07:00,['5bf1c1f223dff993b43ed499d07f105c368a31df'],2,44,46,2688488,4,0,0,0,2217
2ab66c4ca235e15bc39637d3ef52fa33b98e6379,1,jenkins,2014-09-05 12:36:18-07:00,['321b9b0804282ac90945e17d76e46700596fd98e'],65,207,272,2688760,5,0.071428571,0.678571429,0.857142857,2217
75a97d3d7eac860e3e51a901e2fac4eb7184449d,1,jenkins,2014-09-05 12:36:21-07:00,['2ab66c4ca235e15bc39637d3ef52fa33b98e6379'],76,1307,1383,2690143,44,0,0,0,2222
4633abb2eff9bdb9545f2315d1f16507601fe6df,1,Henry Robinson,2014-09-05 14:51:46-07:00,['75a97d3d7eac860e3e51a901e2fac4eb7184449d'],2,2,4,2690147,1,,,,2222
555aee810172a7680665bf8632064f426dc2abeb,1,jenkins,2014-09-05 14:57:39-07:00,['4633abb2eff9bdb9545f2315d1f16507601fe6df'],130,260,390,2690537,5,1,1,1,2223
3acee6b2b6e2c385554b5cf0b12a8a0cca085225,0,jenkins,2014-09-05 16:32:18-07:00,['555aee810172a7680665bf8632064f426dc2abeb'],10,0,10,2690547,1,,,,2223
dae2efc16d2a9cb2a2b56f033bdc6d4a3d1de366,1,jenkins,2014-09-05 19:09:37-07:00,['3acee6b2b6e2c385554b5cf0b12a8a0cca085225'],104,131,235,2690782,1,0.461538462,0.153846154,0.615384615,2223
dff1b3a34d2a0360176e78323dc5653beec2c516,1,jenkins,2014-09-06 16:02:48-07:00,['dae2efc16d2a9cb2a2b56f033bdc6d4a3d1de366'],53,23,76,2690858,2,0,0,0,2223
d52a6207376fc9d3449f4a4da7c34bbe62f5d263,1,Nong Li,2014-09-07 22:08:30-07:00,['dff1b3a34d2a0360176e78323dc5653beec2c516'],86,237,323,2691181,22,0,1,1,2224
73770841510a8e291c34c38d365a5f61e1102e73,0,jenkins,2014-09-08 11:41:53-07:00,['d52a6207376fc9d3449f4a4da7c34bbe62f5d263'],1,42,43,2691224,2,0,0.210526316,1,2224
22b264728b4304417ee02f4421c2ab49ca021784,1,Nong Li,2014-09-09 08:13:20-07:00,['73770841510a8e291c34c38d365a5f61e1102e73'],22,8,30,2691254,4,1,0.714285714,0,2224
965ee586b12e69103f8a65f3d21d6bfc857c5a34,1,Michael Yoder,2014-09-09 10:10:24-07:00,['22b264728b4304417ee02f4421c2ab49ca021784'],0,3,3,2691257,1,,,,2224
ad5a594597416ec1a678e09ff4ab781abdaefb69,1,jenkins,2014-09-09 14:53:52-07:00,['965ee586b12e69103f8a65f3d21d6bfc857c5a34'],83,135,218,2691475,3,0.380952381,0.523809524,1,2224
b9ec2cf3d7418352bd0de869628952dd53ef684e,0,Matthew Jacobs,2014-09-10 13:10:24-07:00,['ad5a594597416ec1a678e09ff4ab781abdaefb69'],0,6,6,2691481,1,1,1,1,2224
4d44dac8cf2e40feaf9c5b72c90c2bb06543dae5,0,Lenni Kuff,2014-09-10 17:47:07-07:00,['b9ec2cf3d7418352bd0de869628952dd53ef684e'],6,5,11,2691492,1,,,,2224
1ea0abe5dea4f947cadeda77cc730c891ab78467,1,Skye Wanderman-Milne,2014-09-10 20:54:40-07:00,['4d44dac8cf2e40feaf9c5b72c90c2bb06543dae5'],143,1178,1321,2692813,13,0,0.142076503,0.663023679,2226
165f1578a1281bd18550037a86f5f60e360393e6,1,Matthew Jacobs,2014-09-11 07:18:38-07:00,['1ea0abe5dea4f947cadeda77cc730c891ab78467'],5,15,20,2692833,1,1,1,1,2226
9ce5a7fd13f354edc0f123a167e26f890959c6dd,0,Nong Li,2014-09-11 08:47:23-07:00,['165f1578a1281bd18550037a86f5f60e360393e6'],3,6,9,2692842,2,1,1,1,2226
3275d2e3e59bfd1edee16197eccca5ed23775ab1,1,Nong Li,2014-09-11 08:47:43-07:00,['9ce5a7fd13f354edc0f123a167e26f890959c6dd'],73,134,207,2693049,10,0.766666667,0.233333333,0.966666667,2226
4f6d0cbb7ee1c4338ffc59431aca3f0e103d651a,1,Daniel Hecht,2014-09-11 09:03:42-07:00,['3275d2e3e59bfd1edee16197eccca5ed23775ab1'],7,13,20,2693069,2,0,0.571428571,1,2226
4c7688332ff837c64f5efa69916fc4f75543c225,1,jenkins,2014-09-11 09:55:21-07:00,['4f6d0cbb7ee1c4338ffc59431aca3f0e103d651a'],44,85,129,2693198,5,0.814814815,0.666666667,0.666666667,2226
730c8b216b6506a3a8ba17c924b59853515dd354,0,Skye Wanderman-Milne,2014-09-11 11:31:52-07:00,['4c7688332ff837c64f5efa69916fc4f75543c225'],0,2,2,2693200,2,,,,2226
266cc492b1a671905fdb6e593276e4bda05a2edd,0,jenkins,2014-09-11 12:29:32-07:00,['730c8b216b6506a3a8ba17c924b59853515dd354'],13,12,25,2693225,3,1,0,0,2226
3c650c3ba5b5d050819ce2809dc09e1cab9b4c33,1,jenkins,2014-09-11 20:50:05-07:00,['266cc492b1a671905fdb6e593276e4bda05a2edd'],87,519,606,2693831,13,0,0.52238806,1,2226
b8ad1d0296a76314b155f9497232c0f550be95de,1,jenkins,2014-09-12 01:22:32-07:00,['3c650c3ba5b5d050819ce2809dc09e1cab9b4c33'],28,36,64,2693895,9,,,,2226
7da3d1a5c074ae9e3135d62de56080d85a10e1ae,0,jenkins,2014-09-12 15:13:14-07:00,['b8ad1d0296a76314b155f9497232c0f550be95de'],22,22,44,2693939,3,,,,2226
257a3aee470677ea13f6946f2e513e679998711f,1,Henry Robinson,2014-09-12 18:17:28-07:00,['7da3d1a5c074ae9e3135d62de56080d85a10e1ae'],46,97,143,2694082,9,0,1,1,2226
ae69ff208b72384476b6b561cad23ba6f62690f6,1,Henry Robinson,2014-09-12 18:17:28-07:00,['257a3aee470677ea13f6946f2e513e679998711f'],3,34,37,2694119,2,0,0,1,2226
b670d98e404e93afeaab775aba9380ab9ede5b55,1,Henry Robinson,2014-09-12 18:17:28-07:00,['ae69ff208b72384476b6b561cad23ba6f62690f6'],145,428,573,2694692,10,0.037974684,0,0.987341772,2226
1267fde556a329f979a51a2aae953781b4faabeb,1,Henry Robinson,2014-09-12 18:17:28-07:00,['b670d98e404e93afeaab775aba9380ab9ede5b55'],8,22,30,2694722,2,1,0,1,2226
24488489875ec8b14033203a4ad46cb1ea498e37,0,Henry Robinson,2014-09-12 18:17:28-07:00,['1267fde556a329f979a51a2aae953781b4faabeb'],17,21,38,2694760,5,1,1,1,2226
681e41a8b7b1440660ca2243230cc6c7726f510e,1,Henry Robinson,2014-09-12 18:17:29-07:00,['24488489875ec8b14033203a4ad46cb1ea498e37'],176,200,376,2695136,4,1,1,1,2227
9a55d3a1735c2ce9ba8752192bf5bc5ceff3e7f4,1,Henry Robinson,2014-09-12 18:17:29-07:00,['681e41a8b7b1440660ca2243230cc6c7726f510e'],86,188,274,2695410,10,0.163636364,0.254545455,0.981818182,2227
524fd2490f455eaa40f143b212225fa82fe6eb06,1,Henry Robinson,2014-09-12 18:17:29-07:00,['9a55d3a1735c2ce9ba8752192bf5bc5ceff3e7f4'],8,68,76,2695486,3,0,0.148148148,0.666666667,2227
bb8b250b0f810965467603d555c27c5cd6a5be2c,1,Henry Robinson,2014-09-12 18:17:29-07:00,['524fd2490f455eaa40f143b212225fa82fe6eb06'],202,241,443,2695929,11,1,1,1,2227
571223d3f5517cda4eaf634ec68ad02f27001e1b,0,Henry Robinson,2014-09-12 18:17:29-07:00,['bb8b250b0f810965467603d555c27c5cd6a5be2c'],11,11,22,2695951,1,,,,2227
5ef992ddf66b0cf987ff55c5754a5f021e078890,0,Henry Robinson,2014-09-12 18:17:29-07:00,['571223d3f5517cda4eaf634ec68ad02f27001e1b'],16,17,33,2695984,1,0,0,0,2227
609ba7f754bb17e3f758b5f3573cb998fe283e0c,0,Lenni Kuff,2014-09-12 22:45:27-07:00,['5ef992ddf66b0cf987ff55c5754a5f021e078890'],1,1,2,2695986,1,,,,2227
f757955f0dacd59cdc429810eb485c63262f5f2b,0,Lenni Kuff,2014-09-12 22:45:47-07:00,['609ba7f754bb17e3f758b5f3573cb998fe283e0c'],0,0,0,2695986,0,,,,2227
04494124d02ea442808e11553d088f470384aede,0,Lenni Kuff,2014-09-12 22:45:48-07:00,['f757955f0dacd59cdc429810eb485c63262f5f2b'],0,0,0,2695986,0,,,,2227
43b1fd88cbf696d71bbf8242cea3f862d1621b16,0,Lenni Kuff,2014-09-12 22:47:44-07:00,['04494124d02ea442808e11553d088f470384aede'],1,1,2,2695988,1,,,,2227
4ecaf036ba780962e0b1eb5013842dbd11947a75,1,Lenni Kuff,2014-09-12 22:48:51-07:00,['43b1fd88cbf696d71bbf8242cea3f862d1621b16'],90,101,191,2696179,7,0,1,1,2228
f9907d5d4ab92cf7d5b9667e1742184106d16604,0,Lenni Kuff,2014-09-12 22:48:58-07:00,['4ecaf036ba780962e0b1eb5013842dbd11947a75'],0,0,0,2696179,0,,,,2228
ad9a15950fa30212b22f634cd9a8c8375a7810d9,1,Nong Li,2014-09-13 00:17:29-07:00,['f9907d5d4ab92cf7d5b9667e1742184106d16604'],44,38,82,2696261,7,0,0,1,2228
58b7c45ff96eab15b81983ed40936997bcba2d5f,1,Nong Li,2014-09-13 00:17:30-07:00,['ad9a15950fa30212b22f634cd9a8c8375a7810d9'],2,55,57,2696318,3,0.025641026,0.282051282,0.974358974,2228
5fe185e7db798b5d31e8b976d44cb63ec9058c24,0,Nong Li,2014-09-13 00:17:32-07:00,['58b7c45ff96eab15b81983ed40936997bcba2d5f'],5,28,33,2696351,2,0.6,0.733333333,1,2228
3b7449a59bed2bcfc3998e2bbe566a732e78009a,1,Nong Li,2014-09-13 00:17:33-07:00,['5fe185e7db798b5d31e8b976d44cb63ec9058c24'],105,363,468,2696819,14,0,0.438356164,0.794520548,2228
4b5d0a7744a896c0b8bf67d37b12ef8e3dd73e2a,0,Nong Li,2014-09-13 00:17:34-07:00,['3b7449a59bed2bcfc3998e2bbe566a732e78009a'],4,12,16,2696835,3,1,1,1,2228
e1e874a77f765ae1592ed159d558ed8150739677,1,Nong Li,2014-09-13 00:17:36-07:00,['4b5d0a7744a896c0b8bf67d37b12ef8e3dd73e2a'],4,110,114,2696949,6,0.318181818,0.227272727,1,2228
0d7d13c0d898fa0b889c2c6692ff8308fb67c6c2,1,Nong Li,2014-09-13 00:17:38-07:00,['e1e874a77f765ae1592ed159d558ed8150739677'],170,300,470,2697419,16,0,0.8125,0.9875,2228
503201794c960cd00c3ca4d6b73ace29ee5984f7,1,Nong Li,2014-09-13 00:17:40-07:00,['0d7d13c0d898fa0b889c2c6692ff8308fb67c6c2'],127,868,995,2698414,20,0.536842105,0.494736842,0.852631579,2228
913ed31340ad8e5c6f8e47280b2421c428affae6,1,Nong Li,2014-09-13 00:17:42-07:00,['503201794c960cd00c3ca4d6b73ace29ee5984f7'],121,116,237,2698651,33,1,0,0,2228
36373e7f16a67d3dc5626f4adf78683b091dcabd,0,Nong Li,2014-09-13 00:19:20-07:00,['913ed31340ad8e5c6f8e47280b2421c428affae6'],4,0,4,2698655,1,,,,2228
78efbf8903b32494ce84a3995f86276a3b626e23,1,Nong Li,2014-09-13 00:19:20-07:00,['36373e7f16a67d3dc5626f4adf78683b091dcabd'],104,596,700,2699355,9,0.375,0.368421053,0.993421053,2228
8bebf2b19652eb929941d9ea3de7596ac0db6034,1,Nong Li,2014-09-13 00:19:20-07:00,['78efbf8903b32494ce84a3995f86276a3b626e23'],96,475,571,2699926,42,0.18487395,0.403361345,0.789915966,2228
b143c0574d3449bc547830940e6eea8d0474ccba,0,Nong Li,2014-09-13 00:19:20-07:00,['8bebf2b19652eb929941d9ea3de7596ac0db6034'],70,57,127,2700053,3,0.928571429,0.642857143,0,2228
de75278125f4aba844d9aa077aa7909e813dcf75,1,Nong Li,2014-09-13 00:19:21-07:00,['b143c0574d3449bc547830940e6eea8d0474ccba'],100,231,331,2700384,21,0.052631579,0.631578947,0.789473684,2228
a4e2f97845735ef2d08294d44ded335524ed623a,0,Nong Li,2014-09-13 00:19:21-07:00,['de75278125f4aba844d9aa077aa7909e813dcf75'],27,98,125,2700509,6,0.764705882,0.647058824,0.882352941,2230
ea3b70d861e881be8bf8dc99c0b98e865c1fe630,1,Nong Li,2014-09-13 00:19:21-07:00,['a4e2f97845735ef2d08294d44ded335524ed623a'],30,518,548,2701057,7,0.702380952,0.738095238,0.571428571,2230
47861358c187512e8a431fd6a18acb178c9434d1,0,Nong Li,2014-09-13 00:19:21-07:00,['ea3b70d861e881be8bf8dc99c0b98e865c1fe630'],9,14,23,2701080,5,1,1,1,2230
c1a08aa3ae790b1e2ce040a816f9b5f4a7087c73,0,Nong Li,2014-09-13 00:19:21-07:00,['47861358c187512e8a431fd6a18acb178c9434d1'],1,1,2,2701082,1,,,,2230
ffe9e4b74e735271451dbc08f2ff53bc8bcaa960,1,Lenni Kuff,2014-09-13 21:21:10-07:00,['c1a08aa3ae790b1e2ce040a816f9b5f4a7087c73'],421,2090,2511,2703593,43,0.433417085,0.701005025,0.649497487,2239
bd1f38832a6f607b40f41f85996fce62a02455ab,1,jenkins,2014-09-15 01:23:27-07:00,['ffe9e4b74e735271451dbc08f2ff53bc8bcaa960'],67,92,159,2703752,2,1,1,1,2239
76834da1de0a807552f772a8851b49653d232a59,1,jenkins,2014-09-15 10:54:56-07:00,['bd1f38832a6f607b40f41f85996fce62a02455ab'],7,19,26,2703778,1,1,1,1,2239
af629cbbb0d12494ea8db1dc073543bae26a1b73,1,jenkins,2014-09-15 19:24:23-07:00,['76834da1de0a807552f772a8851b49653d232a59'],127,176,303,2704081,9,1,1,0.428571429,2239
326a93ee9cf90d3912aaa908cfdf6e637b266ba1,0,Lenni Kuff,2014-09-15 22:58:19-07:00,['af629cbbb0d12494ea8db1dc073543bae26a1b73'],0,1,1,2704082,1,0,0,0,2239
2df3742e67b89ad51b6e87ad4c1be8ef902ac625,0,Henry Robinson,2014-09-15 22:59:59-07:00,['326a93ee9cf90d3912aaa908cfdf6e637b266ba1'],1,2,3,2704085,1,0,0,1,2239
946aa3089bc6faf1dd76a6e232a49c1619bfe76b,1,jenkins,2014-09-16 19:42:24-07:00,['2df3742e67b89ad51b6e87ad4c1be8ef902ac625'],92,200,292,2704377,13,0.016666667,0.266666667,0.833333333,2239
c0f0bb875033eec65b7839e6c54e61b35a49934c,1,jenkins,2014-09-16 23:52:45-07:00,['946aa3089bc6faf1dd76a6e232a49c1619bfe76b'],22,15,37,2704414,1,1,1,1,2239
adeb09841862a9484ab9d2d64f6da29edb2ef713,0,jenkins,2014-09-17 00:41:39-07:00,['c0f0bb875033eec65b7839e6c54e61b35a49934c'],10,10,20,2704434,1,,,,2239
48ce094d41143434296d920d5bf72519ac0d90d7,0,jenkins,2014-09-17 00:49:27-07:00,['adeb09841862a9484ab9d2d64f6da29edb2ef713'],1,1,2,2704436,1,,,,2239
e061b3a4d37e5da9d19aa8a4e6046ed2c413dc17,0,Lenni Kuff,2014-09-17 09:31:28-07:00,['48ce094d41143434296d920d5bf72519ac0d90d7'],0,0,0,2704436,0,,,,2239
481a6dd41f7957d3f69261a57ed911dc4025ebb1,0,Lenni Kuff,2014-09-17 17:05:25-07:00,['e061b3a4d37e5da9d19aa8a4e6046ed2c413dc17'],0,0,0,2704436,0,,,,2239
aa1a63aca74fdb4498965c63d54911648b514490,1,Ishaan Joshi,2014-09-17 23:33:14-07:00,['481a6dd41f7957d3f69261a57ed911dc4025ebb1'],0,2,2,2704438,2,0.5,1,1,2239
5877f12be6740aa91bb6567be2a01c7b0ce39d7e,1,jenkins,2014-09-18 00:36:03-07:00,['aa1a63aca74fdb4498965c63d54911648b514490'],184,758,942,2705380,15,0.128027682,0.508650519,1,2239
42587cf62bce0cb0b6359afc144425923b061384,1,jenkins,2014-09-18 02:02:00-07:00,['5877f12be6740aa91bb6567be2a01c7b0ce39d7e'],57,92,149,2705529,3,0.384615385,1,1,2239
d1e83f8280f863ee014add4015b67c3fb16cd2c7,1,jenkins,2014-09-18 12:54:45-07:00,['42587cf62bce0cb0b6359afc144425923b061384'],366,594,960,2706489,15,0,0,0.990654206,2239
2509509770210610abe88ee4478a1ea7f7b65969,0,jenkins,2014-09-18 20:01:30-07:00,['d1e83f8280f863ee014add4015b67c3fb16cd2c7'],3,2,5,2706494,1,1,0,0,2239
6bc411c8904974c5e7ccac22d496f8de7d7ff886,1,Henry Robinson,2014-09-18 20:17:18-07:00,['2509509770210610abe88ee4478a1ea7f7b65969'],371,2105,2476,2708970,25,0.191646192,0.223587224,0.324324324,2242
eef70a64b9656c905b86aa2a958fd8718ae2bdc9,1,Henry Robinson,2014-09-18 20:17:35-07:00,['6bc411c8904974c5e7ccac22d496f8de7d7ff886'],1,1,2,2708972,1,,,,2242
293ead3b2a8f3256995ec502e873a72112379f4c,1,jenkins,2014-09-19 05:41:33-07:00,['eef70a64b9656c905b86aa2a958fd8718ae2bdc9'],69,414,483,2709455,23,0,0.431372549,0.503267974,2242
e4deef07bfb5532e81225646f39829d7aca959bc,1,jenkins,2014-09-19 17:45:15-07:00,['293ead3b2a8f3256995ec502e873a72112379f4c'],61,283,344,2709799,12,0.147540984,0.426229508,0.590163934,2242
267b81142de4726323f754014a009a2129108fea,1,jenkins,2014-09-19 20:34:48-07:00,['e4deef07bfb5532e81225646f39829d7aca959bc'],4,267,271,2710070,5,0.212903226,0.574193548,0.909677419,2242
9e43e4b5e83aed0021633c115063555e8f72faac,1,jenkins,2014-09-19 21:08:05-07:00,['267b81142de4726323f754014a009a2129108fea'],192,564,756,2710826,24,0.748466258,0.791411043,1,2244
ee9d3aa6fee499b66fb11cc50990c6d31a0f9118,0,Nong Li,2014-09-20 15:57:06-07:00,['9e43e4b5e83aed0021633c115063555e8f72faac'],0,0,0,2710826,0,,,,2244
01a9ab275003aa7117168ed48db1908b1ca45919,0,Nong Li,2014-09-20 16:00:03-07:00,['ee9d3aa6fee499b66fb11cc50990c6d31a0f9118'],22,64,86,2710912,4,0.032258065,0.032258065,0.709677419,2244
209927fbf2c5a80fd93845cbcdc5534abce6d8ef,1,Nong Li,2014-09-20 16:02:02-07:00,['01a9ab275003aa7117168ed48db1908b1ca45919'],276,536,812,2711724,12,0.204545455,0.590909091,1,2244
02f27a313c8940f92e1b7d1fbb28e8b648efd32c,0,Nong Li,2014-09-20 16:02:17-07:00,['209927fbf2c5a80fd93845cbcdc5534abce6d8ef'],2,10,12,2711736,2,0,0,1,2244
9db378f028cf84d81165e7c50f62db794eb8fee2,0,Nong Li,2014-09-20 16:02:28-07:00,['02f27a313c8940f92e1b7d1fbb28e8b648efd32c'],1,2,3,2711739,1,1,1,1,2244
19cfa2d58832be3d1ec4123cf2983cf79a2a81a3,1,Nong Li,2014-09-20 16:02:38-07:00,['9db378f028cf84d81165e7c50f62db794eb8fee2'],108,156,264,2712003,14,0.512195122,0.243902439,0,2244
f8905ea4851d72eb6df856a3fa9f297a8385b5f8,1,Nong Li,2014-09-20 16:02:47-07:00,['19cfa2d58832be3d1ec4123cf2983cf79a2a81a3'],50,18,68,2712071,3,1,1,0,2244
ae243837359f021c40b5bcc56bf49ff8b23a0916,1,Nong Li,2014-09-20 16:02:55-07:00,['f8905ea4851d72eb6df856a3fa9f297a8385b5f8'],26,36,62,2712133,1,0,0,1,2244
07657122151cecb13b820b21a690e45f171b6728,0,Nong Li,2014-09-20 16:03:02-07:00,['ae243837359f021c40b5bcc56bf49ff8b23a0916'],12,15,27,2712160,4,1,1,0,2244
61b4dc174d5e1c6a14c5e3d92904739eab4039d7,0,Nong Li,2014-09-20 16:03:45-07:00,['07657122151cecb13b820b21a690e45f171b6728'],1,62,63,2712223,3,0.0625,0.25,0.25,2244
c4b4e010ff84de7ca315d4adb939508732ac129b,1,Nong Li,2014-09-20 16:05:11-07:00,['61b4dc174d5e1c6a14c5e3d92904739eab4039d7'],208,409,617,2712840,19,0,0,0.493506494,2246
7efc4a37df8a17d70dfe646a4543cb781eee10f7,0,Nong Li,2014-09-20 16:06:14-07:00,['c4b4e010ff84de7ca315d4adb939508732ac129b'],1,2,3,2712843,1,0,1,1,2246
335c46a2060f4e76f9a689a1a285af7a024353cf,1,Nong Li,2014-09-20 16:06:47-07:00,['7efc4a37df8a17d70dfe646a4543cb781eee10f7'],169,367,536,2713379,11,0,0,0.597560976,2246
7355d9c2212665a5dfc4061b2d816fe37e376060,1,Nong Li,2014-09-20 16:07:06-07:00,['335c46a2060f4e76f9a689a1a285af7a024353cf'],6,30,36,2713415,3,0,0,0,2246
445599c37cfcbff8888c44d37c41a844144730f4,1,Nong Li,2014-09-20 16:07:11-07:00,['7355d9c2212665a5dfc4061b2d816fe37e376060'],21,48,69,2713484,5,0,0.055555556,0.833333333,2246
a1892a17d5abdfb921574594f0fe489845e4dd44,1,Nong Li,2014-09-20 16:07:16-07:00,['445599c37cfcbff8888c44d37c41a844144730f4'],3,10,13,2713497,3,0,0,0.333333333,2246
7e090335bce87cd262b1f1a7d9e0abb276ed2f72,0,Nong Li,2014-09-20 16:07:56-07:00,['a1892a17d5abdfb921574594f0fe489845e4dd44'],0,27,27,2713524,4,0,0,1,2246
0facf612960344c2a9890a12dda6926001c67fc2,1,Nong Li,2014-09-20 16:08:12-07:00,['7e090335bce87cd262b1f1a7d9e0abb276ed2f72'],219,575,794,2714318,11,0.1640625,0,0.3515625,2246
af489296cb47c4de74f73de62cd794722bec722c,0,Nong Li,2014-09-20 16:08:17-07:00,['0facf612960344c2a9890a12dda6926001c67fc2'],7,12,19,2714337,1,0,0,0,2246
abeac801d9131bd0d80c08c1f148a024ff8c2bcc,1,Nong Li,2014-09-20 16:10:23-07:00,['af489296cb47c4de74f73de62cd794722bec722c'],82,90,172,2714509,6,1,0,0,2246
ae7f59a65ac3fc4fb24b9188e658d063137df908,1,Nong Li,2014-09-20 16:11:25-07:00,['abeac801d9131bd0d80c08c1f148a024ff8c2bcc'],506,920,1426,2715935,18,0.138888889,0.708333333,0.923611111,2246
0fb380961c1566b719a334103f561f60f81e6b22,1,Nong Li,2014-09-20 16:11:34-07:00,['ae7f59a65ac3fc4fb24b9188e658d063137df908'],29,150,179,2716114,15,0.266666667,0.653333333,1,2246
2a449651daa00942bb60915ea29ae69dea7b363c,1,Nong Li,2014-09-20 16:11:40-07:00,['0fb380961c1566b719a334103f561f60f81e6b22'],72,141,213,2716327,9,0.139534884,0.418604651,0,2246
5a6f16512ccf74ca30b9c2373685cbeeb9e95799,1,Nong Li,2014-09-20 16:11:45-07:00,['2a449651daa00942bb60915ea29ae69dea7b363c'],16,23,39,2716366,1,0,0,1,2246
6289121261d877e9e033bd6d4519c762d6fc8913,1,Nong Li,2014-09-20 16:12:03-07:00,['5a6f16512ccf74ca30b9c2373685cbeeb9e95799'],83,238,321,2716687,20,0.525773196,0.505154639,0.670103093,2246
2596e936c7ccc75c465a04f6d8bff2f58eb745f6,1,Nong Li,2014-09-20 16:12:10-07:00,['6289121261d877e9e033bd6d4519c762d6fc8913'],81,196,277,2716964,12,0.184615385,0.184615385,0,2246
6b73eec02dcd4b1f47bfbccbc1ff3f9208a294e5,1,Nong Li,2014-09-20 16:12:21-07:00,['2596e936c7ccc75c465a04f6d8bff2f58eb745f6'],77,110,187,2717151,5,1,1,0,2246
a74a7556a35e1a89719dd299515a9fa30742f183,1,Nong Li,2014-09-20 16:12:26-07:00,['6b73eec02dcd4b1f47bfbccbc1ff3f9208a294e5'],18,181,199,2717350,5,0,0,0.87,2246
a36bddc7cbef1f5e2f208d4c790fc35b0f897ace,0,Nong Li,2014-09-20 16:12:32-07:00,['a74a7556a35e1a89719dd299515a9fa30742f183'],0,1,1,2717351,1,,,,2246
891e968f25c5119b0801fa064f2cdb62dddf44a5,1,Nong Li,2014-09-20 16:12:37-07:00,['a36bddc7cbef1f5e2f208d4c790fc35b0f897ace'],67,247,314,2717665,13,0,0.541666667,0.739583333,2247
9ffb9069b66fc806091d293546b2e384df2ecb5a,1,Nong Li,2014-09-20 16:12:44-07:00,['891e968f25c5119b0801fa064f2cdb62dddf44a5'],257,299,556,2718221,8,0.177777778,0.533333333,0.688888889,2247
ec3ac883bfb886a9146ae9f039e6616b900a4b50,1,Nong Li,2014-09-20 16:12:50-07:00,['9ffb9069b66fc806091d293546b2e384df2ecb5a'],250,694,944,2719165,2,0.422680412,0.505154639,1,2247
95fae93095340d5a012ea65b41b30fe28600ba0c,1,Nong Li,2014-09-20 16:12:59-07:00,['ec3ac883bfb886a9146ae9f039e6616b900a4b50'],72,155,227,2719392,5,0.186440678,0.118644068,0.559322034,2247
583783e6d4f56e28d10f94863d2279f77049043f,1,Nong Li,2014-09-20 16:13:08-07:00,['95fae93095340d5a012ea65b41b30fe28600ba0c'],81,189,270,2719662,7,0,0.61038961,0.74025974,2247
8de30cbdb6885ef50030e4c818472a372f61cf6d,1,Nong Li,2014-09-20 16:13:14-07:00,['583783e6d4f56e28d10f94863d2279f77049043f'],166,93,259,2719921,6,0,0,0,2247
fb0e9e9d0a3d3783c19d9c986a42d0073193d566,1,Nong Li,2014-09-20 16:13:20-07:00,['8de30cbdb6885ef50030e4c818472a372f61cf6d'],0,6,6,2719927,1,0,0.8,0.8,2247
1803321c1edb88fcb75b6aed125d80622dc50f5e,1,Nong Li,2014-09-20 16:13:26-07:00,['fb0e9e9d0a3d3783c19d9c986a42d0073193d566'],33,44,77,2720004,2,1,1,1,2247
3b5f1d3ab59a547e980d58cc37b35dcc172d3316,1,Nong Li,2014-09-20 16:13:49-07:00,['1803321c1edb88fcb75b6aed125d80622dc50f5e'],141,459,600,2720604,17,0.127906977,0,0.476744186,2247
1c933e39e465c1bdcad6b926c5a8f8560f498619,0,Nong Li,2014-09-20 16:14:04-07:00,['3b5f1d3ab59a547e980d58cc37b35dcc172d3316'],0,2,2,2720606,1,1,1,1,2247
51c1eae2dd12ae63da2d0fbeba361b6bcb0f225e,1,Nong Li,2014-09-20 16:14:09-07:00,['1c933e39e465c1bdcad6b926c5a8f8560f498619'],1,18,19,2720625,2,0,1,1,2247
82507218587022602bf67a67c23859fedceb239d,1,Nong Li,2014-09-20 16:14:14-07:00,['51c1eae2dd12ae63da2d0fbeba361b6bcb0f225e'],15,27,42,2720667,3,0,0.9,1,2247
8a661d0787488e798df99f816a6e00027b67ca48,1,Nong Li,2014-09-20 19:41:42-07:00,['82507218587022602bf67a67c23859fedceb239d'],3,4,7,2720674,3,1,1,1,2247
bbce0d62c97b8745f7ffb27d466a1f93b56419ff,0,Nong Li,2014-09-20 19:41:42-07:00,['8a661d0787488e798df99f816a6e00027b67ca48'],0,3,3,2720677,3,0,0,0,2247
3b2210a8c454085b095f055e98ba385ef0bcccf0,0,Nong Li,2014-09-20 19:41:42-07:00,['bbce0d62c97b8745f7ffb27d466a1f93b56419ff'],53,0,53,2720730,1,0,0,0,2247
e7dd8698e7514a1a199be14a4f7e2c84f76c49c4,0,Nong Li,2014-09-20 21:38:39-07:00,['3b2210a8c454085b095f055e98ba385ef0bcccf0'],0,55,55,2720785,1,1,1,1,2248
ebd750acc6e3585e1f0272c23074e0685619a0ba,0,jenkins,2014-09-21 19:43:50-07:00,['e7dd8698e7514a1a199be14a4f7e2c84f76c49c4'],20,10,30,2720815,2,0,0,0,2248
41de2e167a1083bd991864d10f7eae976abc9812,1,Michael Yoder,2014-09-22 17:57:35-07:00,['ebd750acc6e3585e1f0272c23074e0685619a0ba'],125,422,547,2721362,3,0.462962963,0.734567901,0.901234568,2248
0791eb2ee590cab1f000954e34e534cdc657c7ba,1,Nong Li,2014-09-23 07:25:37-07:00,['41de2e167a1083bd991864d10f7eae976abc9812'],39,20,59,2721421,3,,,,2248
8345494fb1d98c8b2f61152567f1127b2208529f,1,Nong Li,2014-09-23 07:25:51-07:00,['0791eb2ee590cab1f000954e34e534cdc657c7ba'],12,103,115,2721536,6,0,0,1,2248
da5198e61513c0be88ed348ed9678bc0ee805992,0,Nong Li,2014-09-23 07:26:09-07:00,['8345494fb1d98c8b2f61152567f1127b2208529f'],0,10,10,2721546,2,0,0,1,2248
57addd34ac53a33bb5f7e5e2ce33f82565a03e0b,1,Nong Li,2014-09-23 07:26:21-07:00,['da5198e61513c0be88ed348ed9678bc0ee805992'],43,61,104,2721650,6,0.235294118,0.764705882,1,2248
8a75e759cba834aab84c075a768737c678648276,0,Nong Li,2014-09-23 07:26:32-07:00,['57addd34ac53a33bb5f7e5e2ce33f82565a03e0b'],24,24,48,2721698,2,,,,2248
b10743a89f3d19e4e673346c52b9d3609a5bd115,0,Nong Li,2014-09-23 07:26:45-07:00,['8a75e759cba834aab84c075a768737c678648276'],2,34,36,2721734,3,0,0.214285714,0.25,2248
8f09a1b4adc652e972bca011f398d30691501410,0,Nong Li,2014-09-23 07:26:56-07:00,['b10743a89f3d19e4e673346c52b9d3609a5bd115'],23,38,61,2721795,4,0,0,0,2248
9939c9d00928eb315ba53379f205d2ea299e2fc0,1,Nong Li,2014-09-23 07:30:07-07:00,['8f09a1b4adc652e972bca011f398d30691501410'],19,136,155,2721950,13,0.066666667,0,0.866666667,2249
93936ae287fe3bb6db5ecec3d7cd1281c64a8693,0,Nong Li,2014-09-23 07:30:50-07:00,['9939c9d00928eb315ba53379f205d2ea299e2fc0'],1,8,9,2721959,1,0,1,1,2249
423ef62eb4b044a3016d3c1cf7836d06651ca3b9,0,Nong Li,2014-09-23 07:31:00-07:00,['93936ae287fe3bb6db5ecec3d7cd1281c64a8693'],5,8,13,2721972,1,0,0,1,2249
87e9c7760821c1fc4d6f391b03f668e12a45d3fc,1,Nong Li,2014-09-23 07:31:12-07:00,['423ef62eb4b044a3016d3c1cf7836d06651ca3b9'],14,40,54,2722026,5,0.263157895,0.421052632,0.842105263,2249
0b3124ab35402f1ab8141e8ffcca28a5a481c81e,1,Nong Li,2014-09-23 07:32:04-07:00,['87e9c7760821c1fc4d6f391b03f668e12a45d3fc'],33,264,297,2722323,7,0.14159292,0.150442478,0.265486726,2249
08a520459457092377c9be941473ae6f1546f372,1,Nong Li,2014-09-23 07:32:21-07:00,['0b3124ab35402f1ab8141e8ffcca28a5a481c81e'],52,165,217,2722540,5,0.2,0,0,2249
f9b60bce43164d3a3598127ae078bc4f33640720,1,Nong Li,2014-09-23 07:32:31-07:00,['08a520459457092377c9be941473ae6f1546f372'],20,29,49,2722589,3,0,1,1,2249
28fc8ddf6053e5d5b3b2bc0dd461597724ecbaf0,1,Nong Li,2014-09-23 07:32:43-07:00,['f9b60bce43164d3a3598127ae078bc4f33640720'],101,87,188,2722777,6,0.676470588,0,1,2249
bbbf2a64c14c8f6f6fc50c6e0ea347dff1e7b252,1,Nong Li,2014-09-23 07:32:52-07:00,['28fc8ddf6053e5d5b3b2bc0dd461597724ecbaf0'],74,125,199,2722976,23,0.279069767,0,0.76744186,2249
13d0234b3a0da6f6011d610db480173210f21d74,1,Nong Li,2014-09-23 07:33:03-07:00,['bbbf2a64c14c8f6f6fc50c6e0ea347dff1e7b252'],5,34,39,2723015,3,0.736842105,0.736842105,1,2249
47a11578d4b7e2a41b83e208ad174d17d889e61c,1,Nong Li,2014-09-23 07:33:13-07:00,['13d0234b3a0da6f6011d610db480173210f21d74'],3,38,41,2723056,3,1,1,1,2250
f21aed16fdd114d3977b922955580e8adb78dbaa,1,Nong Li,2014-09-23 07:33:23-07:00,['47a11578d4b7e2a41b83e208ad174d17d889e61c'],42,232,274,2723330,8,0.279569892,0.225806452,0.913978495,2250
77b00917e0984a3a4bf897ae308e0b755688c3e4,1,Nong Li,2014-09-23 07:33:34-07:00,['f21aed16fdd114d3977b922955580e8adb78dbaa'],1,50,51,2723381,10,0.111111111,0.148148148,0.592592593,2250
e450436b08822cc5cf83d38c1aa0e0a706724950,1,Nong Li,2014-09-23 07:33:44-07:00,['77b00917e0984a3a4bf897ae308e0b755688c3e4'],28,20,48,2723429,5,1,1,0,2250
6316f4d0f4a6ff93a41f6edc1d96d6f9ec5aa9f6,0,Nong Li,2014-09-23 07:33:55-07:00,['e450436b08822cc5cf83d38c1aa0e0a706724950'],5,9,14,2723443,1,0,0,1,2250
e3b4eb04567d09c8f3dbd9222afb9574ce8f392e,0,Lenni Kuff,2014-09-24 12:33:52-07:00,['6316f4d0f4a6ff93a41f6edc1d96d6f9ec5aa9f6'],0,0,0,2723443,0,,,,2250
7850c1b9c1c0ff1abfe1a4c14ffdba24da6fcb1b,1,Lenni Kuff,2014-09-24 19:08:32-07:00,['e3b4eb04567d09c8f3dbd9222afb9574ce8f392e'],0,1,1,2723444,1,1,1,1,2250
88ae4c9080e2ff645262882b5ede8d013869d430,1,Alex Behm,2014-09-25 18:44:28-07:00,['7850c1b9c1c0ff1abfe1a4c14ffdba24da6fcb1b'],3,30,33,2723477,1,0,0,0.882352941,2250
7f87e7e5b539e03e8f3fc6e8188c32ace78f0e67,1,Nong Li,2014-09-25 19:37:02-07:00,['88ae4c9080e2ff645262882b5ede8d013869d430'],8,31,39,2723516,2,1,1,1,2250
b554c99fa8f71f819429cc4883be8ead372fc0c9,1,Nong Li,2014-09-25 19:37:02-07:00,['7f87e7e5b539e03e8f3fc6e8188c32ace78f0e67'],5,41,46,2723562,4,0.823529412,0.823529412,1,2250
f2b01997df49822702aba91b5bcfd2d7d4fc24a5,1,Nong Li,2014-09-25 19:37:02-07:00,['b554c99fa8f71f819429cc4883be8ead372fc0c9'],65,90,155,2723717,6,0,0.666666667,0.266666667,2250
15a3920acf7aa6d91d096d6614585a96a0b3f824,0,Nong Li,2014-09-25 19:37:02-07:00,['f2b01997df49822702aba91b5bcfd2d7d4fc24a5'],3,6,9,2723726,1,0,0,0,2250
7d7127c25dd20f4c08a38fb405c9e7ec0763f71a,1,Nong Li,2014-09-25 19:37:02-07:00,['15a3920acf7aa6d91d096d6614585a96a0b3f824'],24,56,80,2723806,4,0,0,0,2250
3059cfa213981dd33dcb5f0848cb2efed80af55e,0,Nong Li,2014-09-25 19:37:02-07:00,['7d7127c25dd20f4c08a38fb405c9e7ec0763f71a'],5,5,10,2723816,4,,,,2250
3edeef53d828c1ec442d5ebc2b6c402083fb017e,0,Nong Li,2014-09-25 19:37:02-07:00,['3059cfa213981dd33dcb5f0848cb2efed80af55e'],0,31,31,2723847,3,0.076923077,1,1,2250
9103eb2a0aad8ce10f6e1d0bfb59a8912a615acd,0,Nong Li,2014-09-25 19:37:03-07:00,['3edeef53d828c1ec442d5ebc2b6c402083fb017e'],2,7,9,2723856,1,1,1,1,2250
204f9db95cb016b7a10a6b2de8eb95926a5c8f64,0,Nong Li,2014-09-25 19:37:03-07:00,['9103eb2a0aad8ce10f6e1d0bfb59a8912a615acd'],2,4,6,2723862,1,1,1,1,2250
875417d817eceaea50f52ba05583f3a894ad6b45,1,Nong Li,2014-09-25 19:37:03-07:00,['204f9db95cb016b7a10a6b2de8eb95926a5c8f64'],295,253,548,2724410,22,0.363636364,0.363636364,0.545454545,2250
30e7c450c57d24643b0c7db48813a03d69b0f1c4,0,Nong Li,2014-09-25 19:37:03-07:00,['875417d817eceaea50f52ba05583f3a894ad6b45'],25,48,73,2724483,4,0,0,0,2250
5b4e8b79bf277d093a996d9b1465ab8486cf6dff,1,Nong Li,2014-09-25 19:37:03-07:00,['30e7c450c57d24643b0c7db48813a03d69b0f1c4'],6,113,119,2724602,4,0.548387097,0.548387097,0.548387097,2250
9853f74db1094e3d2b2bbe46ed912b1ac6aa6d7b,0,Lenni Kuff,2014-09-26 11:00:05-07:00,['5b4e8b79bf277d093a996d9b1465ab8486cf6dff'],2,9,11,2724613,2,1,1,1,2250
f11de455a08bed24a69f80a9483dd8ea9aeac314,0,Lenni Kuff,2014-09-26 11:00:15-07:00,['9853f74db1094e3d2b2bbe46ed912b1ac6aa6d7b'],3,3,6,2724619,2,,,,2250
79493c9698a9a7dbe01a7bb757e4780e7424295c,0,Lenni Kuff,2014-09-26 11:23:33-07:00,['f11de455a08bed24a69f80a9483dd8ea9aeac314'],0,9,9,2724628,2,1,1,1,2250
9e67b4a40153608c9d5e921c04f3da5405312b82,1,Lenni Kuff,2014-09-26 11:26:05-07:00,['79493c9698a9a7dbe01a7bb757e4780e7424295c'],0,222,222,2724850,2,1,1,1,2252
bfce7322060d72e8b5239671f28bf9d784ddfcac,1,Lenni Kuff,2014-09-26 11:27:10-07:00,['9e67b4a40153608c9d5e921c04f3da5405312b82'],5,45,50,2724900,2,0.090909091,1,1,2252
f18646286f49a06103f863bbae6f4dd61d10f1eb,1,Lenni Kuff,2014-09-26 12:02:40-07:00,['bfce7322060d72e8b5239671f28bf9d784ddfcac'],78,127,205,2725105,5,0,1,0,2252
5046a47dc3401845886eebd48137b94aa3af545e,1,Lenni Kuff,2014-09-26 12:02:47-07:00,['f18646286f49a06103f863bbae6f4dd61d10f1eb'],12,26,38,2725143,2,0,0,1,2252
afbc2c28a3f620ee57bd31445dc659a1e384c5ac,1,Lenni Kuff,2014-09-26 12:02:54-07:00,['5046a47dc3401845886eebd48137b94aa3af545e'],7,139,146,2725289,9,0.081395349,0.38372093,0.941860465,2252
e3c8d2fe7e8f657ee4c8d1955024d3da9a3699bc,0,Lenni Kuff,2014-09-26 12:03:00-07:00,['afbc2c28a3f620ee57bd31445dc659a1e384c5ac'],1,1,2,2725291,1,,,,2252
f75fc4337ac7e1fe41cc13cf7303ab10a5e8130f,0,Lenni Kuff,2014-09-26 12:03:06-07:00,['e3c8d2fe7e8f657ee4c8d1955024d3da9a3699bc'],2,18,20,2725311,2,,,,2252
f92cd60b80255ba3786296c159db19ae93ce6cd9,0,Lenni Kuff,2014-09-26 12:03:12-07:00,['f75fc4337ac7e1fe41cc13cf7303ab10a5e8130f'],5,4,9,2725320,2,,,,2252
5da47dcb4fe69b2fa0eff3469554a7c4def35d83,1,Lenni Kuff,2014-09-26 12:03:33-07:00,['f92cd60b80255ba3786296c159db19ae93ce6cd9'],98,234,332,2725652,9,0.552631579,0.960526316,1,2252
b99fe95b7c790e3fea3eebd210538b53801ba497,1,Lenni Kuff,2014-09-26 12:03:40-07:00,['5da47dcb4fe69b2fa0eff3469554a7c4def35d83'],8,36,44,2725696,2,0,0.2,1,2252
af4b2086dc26518aa9ada591b35b48128a87921a,1,Lenni Kuff,2014-09-26 12:24:07-07:00,['b99fe95b7c790e3fea3eebd210538b53801ba497'],21,201,222,2725918,13,0.157407407,0.564814815,0.666666667,2256
4f906c0fd84651b5355b4d35de7d6723bcdc0349,1,Lenni Kuff,2014-09-26 12:24:58-07:00,['af4b2086dc26518aa9ada591b35b48128a87921a'],1,1,2,2725920,1,,,,2256
cb53f14087348402e157bbcb020e7307e0b7cd40,1,Lenni Kuff,2014-09-26 12:25:06-07:00,['4f906c0fd84651b5355b4d35de7d6723bcdc0349'],12,99,111,2726031,3,0,0,0.470588235,2256
f03b05ed50b96a4b9b48b08b2fb9cda1641707e7,1,Lenni Kuff,2014-09-26 12:26:09-07:00,['cb53f14087348402e157bbcb020e7307e0b7cd40'],128,299,427,2726458,13,0.208791209,0.230769231,1,2256
a3767c9f2be807aa839df49e7b81cb847c55d7a9,1,Lenni Kuff,2014-09-26 12:26:37-07:00,['f03b05ed50b96a4b9b48b08b2fb9cda1641707e7'],6,6,12,2726470,1,,,,2256
9a72c28832e9fddf95e36270c6473067cd32856d,1,Lenni Kuff,2014-09-26 12:26:46-07:00,['a3767c9f2be807aa839df49e7b81cb847c55d7a9'],61,336,397,2726867,10,0.21641791,0.71641791,1,2256
0660ca814d7884af7ebfaefee924f943358fcf35,1,Lenni Kuff,2014-09-26 12:26:53-07:00,['9a72c28832e9fddf95e36270c6473067cd32856d'],9,23,32,2726899,3,0.166666667,0.333333333,1,2256
e16c5171782a1c5d16401a96d4fcbd5f71c65a38,1,Lenni Kuff,2014-09-26 12:27:00-07:00,['0660ca814d7884af7ebfaefee924f943358fcf35'],1,1,2,2726901,1,,,,2256
fec685e0759a4460e99399dfaca2b0cf4da2805d,1,Lenni Kuff,2014-09-26 12:27:12-07:00,['e16c5171782a1c5d16401a96d4fcbd5f71c65a38'],1,65,66,2726967,2,1,1,1,2257
cb5f02e05fdcdae8c04fb5736727fdef4131034f,0,Lenni Kuff,2014-09-26 12:27:20-07:00,['fec685e0759a4460e99399dfaca2b0cf4da2805d'],4,4,8,2726975,1,,,,2257
d5c948c351a30faad45061d010e9028e665f0d10,0,Lenni Kuff,2014-09-26 12:27:29-07:00,['cb5f02e05fdcdae8c04fb5736727fdef4131034f'],1,1,2,2726977,1,,,,2257
186feedc584bb22e33e577d6a64d94d6faf06411,1,Lenni Kuff,2014-09-26 12:27:37-07:00,['d5c948c351a30faad45061d010e9028e665f0d10'],40,240,280,2727257,4,0.217821782,0.188118812,0.504950495,2257
72f9d506572c0ddec48fa7b3cd56075575df3158,1,Lenni Kuff,2014-09-26 12:27:46-07:00,['186feedc584bb22e33e577d6a64d94d6faf06411'],74,134,208,2727465,5,0.128205128,0.128205128,0,2257
dbaf718221492e72ff79203b98b2c511372cc091,0,Lenni Kuff,2014-09-26 12:28:03-07:00,['72f9d506572c0ddec48fa7b3cd56075575df3158'],3,59,62,2727527,4,0,0,0,2257
b5379e8cfdf939a10d59d02ea05cbc915b8f836a,1,Lenni Kuff,2014-09-26 12:28:10-07:00,['dbaf718221492e72ff79203b98b2c511372cc091'],24,8,32,2727559,3,0,0,0,2257
5068950a313c633a668344cf5c532823fc47ee95,1,Lenni Kuff,2014-09-26 12:28:16-07:00,['b5379e8cfdf939a10d59d02ea05cbc915b8f836a'],10,29,39,2727598,2,0.416666667,1,1,2257
e849bd7d2deb2c7edcbee9ad276a4550536173ff,0,Lenni Kuff,2014-09-26 15:27:16-07:00,['5068950a313c633a668344cf5c532823fc47ee95'],1,1,2,2727600,1,,,,2257
a7c87bb250b48aeb4fa7be4526ab8050135d2915,0,Ishaan Joshi,2014-09-26 16:56:40-07:00,['e849bd7d2deb2c7edcbee9ad276a4550536173ff'],69,69,138,2727738,1,,,,2257
010cc22a2f2e9870072e8b7696cf452363f5969a,1,Ishaan Joshi,2014-09-26 22:57:02-07:00,['a7c87bb250b48aeb4fa7be4526ab8050135d2915'],4,4,8,2727746,1,,,,2257
e126a3c8b567943aa35f0c95f3ea97699ee29e45,1,jenkins,2014-09-27 01:15:41-07:00,['010cc22a2f2e9870072e8b7696cf452363f5969a'],1352,1889,3241,2730987,7,1,1,1,2260
a36a9843681f96872cfdd1c2a7bfe05aadcfd573,0,Nong Li,2014-10-06 15:08:44-07:00,['e126a3c8b567943aa35f0c95f3ea97699ee29e45'],2,27,29,2731016,3,0.230769231,0.230769231,1,2260
f3b33181d3f29982e77fc6ad044271daa54ef715,0,Nong Li,2014-10-06 15:08:50-07:00,['a36a9843681f96872cfdd1c2a7bfe05aadcfd573'],41,118,159,2731175,28,0.489361702,0.638297872,0.765957447,2260
f6ed9852796c3d5d41cb1554c00a45d10d903451,1,Nong Li,2014-10-06 15:08:55-07:00,['f3b33181d3f29982e77fc6ad044271daa54ef715'],0,29,29,2731204,1,0.9375,1,1,2260
2ec5bbb0f8b7f605abf81f91bb2075fbd15e9c14,1,Nong Li,2014-10-06 15:09:01-07:00,['f6ed9852796c3d5d41cb1554c00a45d10d903451'],28,53,81,2731285,9,0,0.684210526,1,2260
1635ee6dce4f8b89334d393efa166fea44e2c7c7,0,Nong Li,2014-10-06 15:09:07-07:00,['2ec5bbb0f8b7f605abf81f91bb2075fbd15e9c14'],1,16,17,2731302,2,0,0.307692308,1,2260
8e48068d6b7bf0c363795e2e0c8e8e656f6702b5,1,Nong Li,2014-10-06 15:09:13-07:00,['1635ee6dce4f8b89334d393efa166fea44e2c7c7'],45,62,107,2731409,8,0.545454545,0.454545455,0.909090909,2260
4d2da726987b3f5ebe5cda9e8aa367c3e400bca9,1,Nong Li,2014-10-06 15:09:20-07:00,['8e48068d6b7bf0c363795e2e0c8e8e656f6702b5'],5,30,35,2731444,2,0,0,1,2260
b201c7a7d1541876fa7ec683c4a375a1a0baf000,1,Nong Li,2014-10-06 15:09:25-07:00,['4d2da726987b3f5ebe5cda9e8aa367c3e400bca9'],23,153,176,2731620,4,0,0.5,0.75,2260
5db0f877cb91dfe70cc046c93e003a93775d966a,0,Nong Li,2014-10-06 15:09:37-07:00,['b201c7a7d1541876fa7ec683c4a375a1a0baf000'],2,2,4,2731624,1,,,,2260
758ba08bbbf836c8486067e650b635b8075400bf,0,Nong Li,2014-10-06 15:09:42-07:00,['5db0f877cb91dfe70cc046c93e003a93775d966a'],8,18,26,2731650,1,,,,2260
c10e13a9dd94f225703b3c7e647c4330e0e40d40,0,Nong Li,2014-10-06 15:10:41-07:00,['758ba08bbbf836c8486067e650b635b8075400bf'],2,6,8,2731658,2,1,1,1,2260
177337dc33d86e0d677eb596340b6a0e87ce0772,1,Nong Li,2014-10-06 15:10:53-07:00,['c10e13a9dd94f225703b3c7e647c4330e0e40d40'],0,18,18,2731676,4,0.428571429,1,1,2260
5c4486a2b2bee34ae84c97c660443f317c762794,1,Nong Li,2014-10-06 15:10:58-07:00,['177337dc33d86e0d677eb596340b6a0e87ce0772'],321,1128,1449,2733125,27,0.320879121,0.494505495,0.479120879,2261
e5201dbd240b2e90a3d95f357b4b19cdaecca64f,1,Nong Li,2014-10-06 15:11:04-07:00,['5c4486a2b2bee34ae84c97c660443f317c762794'],6,37,43,2733168,4,0.705882353,0.705882353,0.294117647,2261
658f05f63c826027229e9908900d4519a8de0f9d,1,Nong Li,2014-10-06 15:11:10-07:00,['e5201dbd240b2e90a3d95f357b4b19cdaecca64f'],3,22,25,2733193,2,0,0,1,2261
39fef934252631ce8c479b6c6c04729fa340860d,1,Nong Li,2014-10-06 15:11:15-07:00,['658f05f63c826027229e9908900d4519a8de0f9d'],95,189,284,2733477,2,0.152542373,0.152542373,1,2261
66a4bc1994f4614883be34ce1b4fa5778d891018,0,Nong Li,2014-10-06 15:11:20-07:00,['39fef934252631ce8c479b6c6c04729fa340860d'],5,22,27,2733504,4,0.2,0.8,0.6,2261
928907905b5f34db6272de252d065812337d33ba,1,Nong Li,2014-10-06 15:11:27-07:00,['66a4bc1994f4614883be34ce1b4fa5778d891018'],51,66,117,2733621,5,0.333333333,0,0,2261
9c7c23cf327d04390fa8eda84516345f294505a5,0,Nong Li,2014-10-06 15:11:32-07:00,['928907905b5f34db6272de252d065812337d33ba'],6,4,10,2733631,1,0,0,1,2261
1394b334b87ac5c7b644a8d9f3a3db97f675d555,0,Nong Li,2014-10-06 15:11:38-07:00,['9c7c23cf327d04390fa8eda84516345f294505a5'],3,19,22,2733653,3,0.818181818,1,0.818181818,2261
8f0c206bdd5d83f59946112029acd2ea5f666e1f,1,Nong Li,2014-10-06 15:11:43-07:00,['1394b334b87ac5c7b644a8d9f3a3db97f675d555'],7,68,75,2733728,4,0,0.652173913,0,2261
ceeb5ee17d63ee0a22ce8183bc53ef82628fd621,0,Nong Li,2014-10-06 15:11:48-07:00,['8f0c206bdd5d83f59946112029acd2ea5f666e1f'],118,41,159,2733887,28,0.510638298,0.361702128,0.234042553,2261
f8af74a97fa996b34582f90a8d5da8413fd724f4,1,Nong Li,2014-10-06 15:11:54-07:00,['ceeb5ee17d63ee0a22ce8183bc53ef82628fd621'],3,3,6,2733893,1,,,,2261
86b9f8282fb3423147036f4e28acbf358db05ed6,0,Nong Li,2014-10-06 15:11:58-07:00,['f8af74a97fa996b34582f90a8d5da8413fd724f4'],20,20,40,2733933,2,,,,2261
8b1b8f57807a735d404b69029465eee470cc340b,1,Nong Li,2014-10-06 15:12:03-07:00,['86b9f8282fb3423147036f4e28acbf358db05ed6'],31,331,362,2734295,10,0.305555556,0.125,0.763888889,2261
232e378984666a8024ef390343150fd8e6cdcce7,0,Nong Li,2014-10-06 15:12:08-07:00,['8b1b8f57807a735d404b69029465eee470cc340b'],3,6,9,2734304,1,0,0,1,2261
a1b2de9c95f8a7a81c7453447561f02087307ddf,1,Nong Li,2014-10-06 15:12:12-07:00,['232e378984666a8024ef390343150fd8e6cdcce7'],62,46,108,2734412,6,0.083333333,0.083333333,0,2261
6be9c9948729a1b32a4a47bbb564f34ad28aa172,0,Nong Li,2014-10-06 15:12:20-07:00,['a1b2de9c95f8a7a81c7453447561f02087307ddf'],0,18,18,2734430,2,0,0,1,2261
080299730cd1a2e1b1dd51157ef1a6cd14bf1ba9,1,Nong Li,2014-10-06 15:12:25-07:00,['6be9c9948729a1b32a4a47bbb564f34ad28aa172'],10,30,40,2734470,2,0,0,1,2261
0db2181d97fd4877fd197d999e411997b4852ad5,0,Nong Li,2014-10-06 15:12:32-07:00,['080299730cd1a2e1b1dd51157ef1a6cd14bf1ba9'],1,11,12,2734482,2,,,,2261
21f665a312e821374ec1dcf3fe5afc2a15b35876,1,Nong Li,2014-10-06 15:12:39-07:00,['0db2181d97fd4877fd197d999e411997b4852ad5'],67,88,155,2734637,3,0,0,0.95,2261
fa502f973a5ac4b69f33cb30611dbbb522c9f8f2,1,Nong Li,2014-10-06 15:12:44-07:00,['21f665a312e821374ec1dcf3fe5afc2a15b35876'],27,74,101,2734738,6,0,0.346153846,0.884615385,2261
dc6fea29c15c5cbc14d2d6f6147fc8e65289091d,1,Nong Li,2014-10-06 15:12:49-07:00,['fa502f973a5ac4b69f33cb30611dbbb522c9f8f2'],2,2,4,2734742,1,,0,,2261
756c50171db13e6023b82fa91b1319ee068929e8,0,Nong Li,2014-10-06 15:12:53-07:00,['dc6fea29c15c5cbc14d2d6f6147fc8e65289091d'],0,13,13,2734755,2,0,1,1,2261
0c6f977726d1f65e269c2e66f09c5def9d258309,1,Nong Li,2014-10-06 15:12:59-07:00,['756c50171db13e6023b82fa91b1319ee068929e8'],14,28,42,2734797,3,0,0,1,2261
c2adbdf72e36fe5b2909a6afaa49c7f646564e5f,0,Nong Li,2014-10-06 15:13:04-07:00,['0c6f977726d1f65e269c2e66f09c5def9d258309'],15,23,38,2734835,2,0,0.285714286,1,2261
2a59c235c7fa1b3a8626c6728e5b188500a24b15,0,Nong Li,2014-10-06 15:13:09-07:00,['c2adbdf72e36fe5b2909a6afaa49c7f646564e5f'],0,3,3,2734838,1,,,,2261
794e70b0bdeb013991c94b30c6297c3e45fb3e99,1,Nong Li,2014-10-06 15:13:17-07:00,['2a59c235c7fa1b3a8626c6728e5b188500a24b15'],10,121,131,2734969,8,0,0.435897436,1,2261
c24557fe08d74d8e577d33d092006efd3deb7c59,1,Nong Li,2014-10-06 15:13:22-07:00,['794e70b0bdeb013991c94b30c6297c3e45fb3e99'],40,167,207,2735176,24,0.576923077,0.628205128,0.730769231,2261
c84caf3957068d7d0cb34a7548bdb98662df5d3b,1,Nong Li,2014-10-06 15:13:27-07:00,['c24557fe08d74d8e577d33d092006efd3deb7c59'],14,72,86,2735262,3,0.388888889,0.972222222,0.638888889,2261
3e632ef6adee3f13efec0439b75b28e8cd86bd18,1,Nong Li,2014-10-06 15:14:10-07:00,['c84caf3957068d7d0cb34a7548bdb98662df5d3b'],261,504,765,2736027,19,0.3203125,0.1796875,0.7890625,2261
b0e8a2b30cbb41c2219b486cf98d4ff408aeda6c,1,Nong Li,2014-10-06 15:14:22-07:00,['3e632ef6adee3f13efec0439b75b28e8cd86bd18'],9,14,23,2736050,3,0.5,0.5,1,2261
7823d6de3fe0c0405019b1e7cfd1d0121355ad97,1,Nong Li,2014-10-06 15:14:27-07:00,['b0e8a2b30cbb41c2219b486cf98d4ff408aeda6c'],11,36,47,2736097,2,0,1,1,2261
4202447627da8cc59c72a6186d7c2303e35313f1,1,Nong Li,2014-10-06 15:14:34-07:00,['7823d6de3fe0c0405019b1e7cfd1d0121355ad97'],2,16,18,2736115,2,0,1,1,2261
384daae537ba4479e3c50c71c6f7e52f14eae92f,1,Nong Li,2014-10-06 15:14:39-07:00,['4202447627da8cc59c72a6186d7c2303e35313f1'],26,167,193,2736308,3,0,0,0.179487179,2261
f4626b03e646ce4b0180e0b081593516b17764e9,1,Nong Li,2014-10-06 15:14:44-07:00,['384daae537ba4479e3c50c71c6f7e52f14eae92f'],1,29,30,2736338,2,0,0,0,2261
d5fd59e2ed6addd768048f695715e5f5845043a0,1,Nong Li,2014-10-06 15:14:51-07:00,['f4626b03e646ce4b0180e0b081593516b17764e9'],3,32,35,2736373,2,,,,2261
81fa556ffb97979e95a2b052487b602f4c75defa,0,Nong Li,2014-10-06 15:15:28-07:00,['d5fd59e2ed6addd768048f695715e5f5845043a0'],3,5,8,2736381,2,,,,2261
e08ffde0096a2fc5d55c6630b49dd5d5f197b71c,1,Nong Li,2014-10-06 15:16:16-07:00,['81fa556ffb97979e95a2b052487b602f4c75defa'],61,223,284,2736665,12,0,0,0.892156863,2261
a78de45bad7a4625301219a4a8fc670041ae3f62,1,Nong Li,2014-10-06 15:16:30-07:00,['e08ffde0096a2fc5d55c6630b49dd5d5f197b71c'],60,394,454,2737119,4,0,0.615384615,0,2261
c29ed3761e96951a29a385fcada787d38080e34c,1,Nong Li,2014-10-06 15:16:36-07:00,['a78de45bad7a4625301219a4a8fc670041ae3f62'],7,106,113,2737232,3,0,1,1,2261
78508f6f787473c154289c3d29bd42645d372567,1,Nong Li,2014-10-06 15:16:40-07:00,['c29ed3761e96951a29a385fcada787d38080e34c'],1,70,71,2737303,2,0,0,0,2261
a62500ee2844748446582d06d98b78d284d620e6,1,Nong Li,2014-10-06 15:16:45-07:00,['78508f6f787473c154289c3d29bd42645d372567'],12,58,70,2737373,6,0,0.75862069,1,2261
7b244d34b6d062e15596fd027367b1a60cca275e,1,Nong Li,2014-10-06 15:16:50-07:00,['a62500ee2844748446582d06d98b78d284d620e6'],77,35,112,2737485,2,0,0,1,2261
6af7c8fe4a9f75f2486a8816e0844ab8b2f0534d,1,Nong Li,2014-10-06 15:16:56-07:00,['7b244d34b6d062e15596fd027367b1a60cca275e'],229,252,481,2737966,9,1,1,1,2261
3e7de9f304ca955947ff0e562b858b4dd4e606dd,1,Nong Li,2014-10-06 15:17:22-07:00,['6af7c8fe4a9f75f2486a8816e0844ab8b2f0534d'],43,175,218,2738184,10,0.021276596,0,0.79787234,2261
de31fa8e211dc9f5553a03be94d6168896556419,0,Nong Li,2014-10-06 15:18:56-07:00,['3e7de9f304ca955947ff0e562b858b4dd4e606dd'],30,31,61,2738245,1,,,,2261
92cd953566a8856b04d5d639bcc1553c40e01056,0,Nong Li,2014-10-06 15:19:06-07:00,['de31fa8e211dc9f5553a03be94d6168896556419'],1,66,67,2738312,2,0.272727273,1,1,2261
6c541d8e4a118f775cb26b33e921354f6bc05997,0,Nong Li,2014-10-06 17:45:51-07:00,['92cd953566a8856b04d5d639bcc1553c40e01056'],0,4,4,2738316,2,1,1,1,2261
b6204dff59c013ec3f04f2867538f56c66c6e61e,1,Skye Wanderman-Milne,2014-10-06 17:47:37-07:00,['6c541d8e4a118f775cb26b33e921354f6bc05997'],63,120,183,2738499,22,0.7,0.8,0,2261
2ec3dff8242682fceb347ca13bf2dba429b7eb7f,1,Nong Li,2014-10-06 19:49:04-07:00,['b6204dff59c013ec3f04f2867538f56c66c6e61e'],5,134,139,2738638,5,1,1,1,2261
364b826d4d7875a1f9cb67e0e4949f8c3b3fd8ff,1,Nong Li,2014-10-06 19:49:10-07:00,['2ec3dff8242682fceb347ca13bf2dba429b7eb7f'],35,41,76,2738714,4,0,0,0.8,2261
b7aa5440a744dc1f02afb507857b1de75cc360a1,0,Nong Li,2014-10-06 19:49:18-07:00,['364b826d4d7875a1f9cb67e0e4949f8c3b3fd8ff'],0,1,1,2738715,1,1,1,1,2261
6374a21924196b576220e20f98b4e24259c45a8b,1,Nong Li,2014-10-06 19:49:25-07:00,['b7aa5440a744dc1f02afb507857b1de75cc360a1'],48,61,109,2738824,4,0,1,1,2261
a0463b6f3a5e24ca0cb2c6c34c2ade8bb1adfa59,0,Nong Li,2014-10-06 19:49:30-07:00,['6374a21924196b576220e20f98b4e24259c45a8b'],28,29,57,2738881,1,,,,2261
a82855adbd10d00bcb4b35f81fafd90c76dc8675,1,Nong Li,2014-10-06 19:49:36-07:00,['a0463b6f3a5e24ca0cb2c6c34c2ade8bb1adfa59'],16,16,32,2738913,1,,,,2261
ce3436dadbe94104847bd3bf3f8fc543c8662e56,1,Nong Li,2014-10-06 19:49:43-07:00,['a82855adbd10d00bcb4b35f81fafd90c76dc8675'],1,4,5,2738918,1,0,1,1,2261
652d4b4699a21242c3181fde93b1eb98d5096a3f,1,Nong Li,2014-10-06 19:49:50-07:00,['ce3436dadbe94104847bd3bf3f8fc543c8662e56'],15,57,72,2738990,4,1,0,1,2261
a2e7b05bb1ffcee702ced74fb6ea340b89386f91,0,Nong Li,2014-10-06 19:49:56-07:00,['652d4b4699a21242c3181fde93b1eb98d5096a3f'],1,17,18,2739008,3,0,0,1,2261
aabffc96745e6bfab1f3bc6e34ce9a5472bca426,1,Nong Li,2014-10-06 19:50:03-07:00,['a2e7b05bb1ffcee702ced74fb6ea340b89386f91'],25,25,50,2739058,4,1,1,0,2261
6c7bacf2fce20bb1afe6e9a50b483eefb6735837,1,Nong Li,2014-10-06 19:50:08-07:00,['aabffc96745e6bfab1f3bc6e34ce9a5472bca426'],2,6,8,2739066,1,0,0,1,2261
098772e9acc8065b9213918f61796906fd6542ed,1,Nong Li,2014-10-06 19:50:14-07:00,['6c7bacf2fce20bb1afe6e9a50b483eefb6735837'],0,25,25,2739091,2,0,0.391304348,1,2261
7152d858370fc9014146c943ad503b9eb1f01ffa,1,Nong Li,2014-10-06 19:50:19-07:00,['098772e9acc8065b9213918f61796906fd6542ed'],3,9,12,2739103,1,0,0,1,2261
c79cd3aa23c1b1a8a96489c7fcb69848ef4eefa6,0,ishaan,2014-10-07 15:48:32-07:00,['7152d858370fc9014146c943ad503b9eb1f01ffa'],0,9,9,2739112,1,,,,2261
d07f785a7c5e48e66d24cdcb2df350f89703a1d7,0,ishaan,2014-10-07 15:48:42-07:00,['c79cd3aa23c1b1a8a96489c7fcb69848ef4eefa6'],1,15,16,2739128,3,1,1,1,2261
d60df19249734bc796f4be1dae73668c7818594f,1,ishaan,2014-10-07 15:56:12-07:00,['d07f785a7c5e48e66d24cdcb2df350f89703a1d7'],24,71,95,2739223,4,0.423076923,1,0.730769231,2261
0752b9fa624d3588f3b15dbb5d1bc60d517412f8,1,ishaan,2014-10-07 16:49:15-07:00,['d60df19249734bc796f4be1dae73668c7818594f'],41,174,215,2739438,9,0,0.769230769,0.153846154,2261
5845a02b6e285e00a9b9e3460469579a7b727469,1,ishaan,2014-10-07 16:52:05-07:00,['0752b9fa624d3588f3b15dbb5d1bc60d517412f8'],18,70,88,2739526,4,1,0,0.909090909,2261
609c287b1729ae004b392c9b19fa54aeb0977bab,1,ishaan,2014-10-07 19:06:25-07:00,['5845a02b6e285e00a9b9e3460469579a7b727469'],37,151,188,2739714,11,0.375,0.53125,0.9375,2261
543fa73f3a846f0e4527514c993cb0985912b06c,1,ishaan,2014-10-08 16:44:37-07:00,['609c287b1729ae004b392c9b19fa54aeb0977bab'],81,294,375,2740089,10,0.366972477,0.816513761,0.779816514,2262
18d3ec50cc6b2e016b3e1aec6fb96355cdb3ba70,1,ishaan,2014-10-08 16:46:08-07:00,['543fa73f3a846f0e4527514c993cb0985912b06c'],1,13,14,2740103,1,1,1,1,2262
eb04f08bb53d51b9476d4755b728ddd7dd7bb228,0,ishaan,2014-10-08 16:46:56-07:00,['18d3ec50cc6b2e016b3e1aec6fb96355cdb3ba70'],2,12,14,2740117,3,,,,2262
7e4eb77dcd2e45af835860133aa38640e46dbaa3,1,ishaan,2014-10-08 16:48:16-07:00,['eb04f08bb53d51b9476d4755b728ddd7dd7bb228'],113,213,326,2740443,4,0,0.3,0.3,2262
b8918a90f49ac46c5162ab6fb4b6c68b5c3b7d29,1,ishaan,2014-10-08 16:48:26-07:00,['7e4eb77dcd2e45af835860133aa38640e46dbaa3'],6,6,12,2740455,2,,,,2262
7f576dc41eeb494cffe35a48c8025792ebfd4dbf,0,ishaan,2014-10-08 16:48:34-07:00,['b8918a90f49ac46c5162ab6fb4b6c68b5c3b7d29'],2,2,4,2740459,1,,,,2262
2d46029dab86be6ff2f3bc27c151c7ad18a21d92,1,ishaan,2014-10-08 16:48:44-07:00,['7f576dc41eeb494cffe35a48c8025792ebfd4dbf'],3,13,16,2740475,2,0.166666667,1,1,2262
173103a5087eb47d7ead8213c3cbc87aa41ec233,0,ishaan,2014-10-08 16:48:55-07:00,['2d46029dab86be6ff2f3bc27c151c7ad18a21d92'],0,15,15,2740490,1,,,,2262
3973608d34cf3ed3f04b6d0d1fb9c388e4acd56e,0,ishaan,2014-10-08 16:49:07-07:00,['173103a5087eb47d7ead8213c3cbc87aa41ec233'],12,130,142,2740632,2,0,0.970588235,1,2262
10303ed4405ec96951661f7ce5507140f0f3cce6,1,ishaan,2014-10-08 16:50:16-07:00,['3973608d34cf3ed3f04b6d0d1fb9c388e4acd56e'],109,115,224,2740856,4,,,,2262
23964c19af4df0dc634f7e2053439c14ebc0f751,0,ishaan,2014-10-08 23:19:02-07:00,['10303ed4405ec96951661f7ce5507140f0f3cce6'],2,2,4,2740860,1,,,,2262
23a095c640443f3abe875454a8791406e1cafaf0,1,jenkins,2014-10-09 15:42:51-07:00,['23964c19af4df0dc634f7e2053439c14ebc0f751'],45,89,134,2740994,2,0,1,1,2262
b6e91905ed2f6fbc2989d22570ad85c06c738445,0,Henry Robinson,2014-10-11 22:46:05-07:00,['23a095c640443f3abe875454a8791406e1cafaf0'],1235,1235,2470,2743464,1,,,,2262
3e5826511080839df45a27c4587e603f71dfb9a5,0,jenkins,2014-10-13 08:13:21-07:00,['b6e91905ed2f6fbc2989d22570ad85c06c738445'],0,2,2,2743466,1,0,1,1,2262
86aebc7f8f28f46a17b7b27a60640e9c29f1024f,1,Nong Li,2014-10-14 12:01:53-07:00,['3e5826511080839df45a27c4587e603f71dfb9a5'],13,31,44,2743510,5,0.5,0.5,1,2262
d8b9256454b1b54d68a3f287ec84dd4cbbfef613,1,Nong Li,2014-10-14 12:02:57-07:00,['86aebc7f8f28f46a17b7b27a60640e9c29f1024f'],0,1,1,2743511,1,0,1,1,2262
a4200a7d39228f76e175e520cee4f8ba311a5cb8,0,jenkins,2014-10-17 13:31:57-07:00,['d8b9256454b1b54d68a3f287ec84dd4cbbfef613'],0,0,0,2743511,0,,,,2262
f66223fae336b15f0921075fe3425aa1893ba009,1,jenkins,2014-10-17 18:57:12-07:00,['a4200a7d39228f76e175e520cee4f8ba311a5cb8'],1,7,8,2743519,2,0.4,1,1,2262
e672f1c79e2229dbefdb39e0f6e0c0d2036e19a3,1,jenkins,2014-10-21 22:07:12-07:00,['f66223fae336b15f0921075fe3425aa1893ba009'],4,29,33,2743552,2,0,0,1,2262
631c06858b3843ab918f020c4973412a6c356f24,0,jenkins,2014-10-22 12:47:39-07:00,['e672f1c79e2229dbefdb39e0f6e0c0d2036e19a3'],1,1,2,2743554,1,,,,2262
e8667652137d138428de87415a1534cfcdd320b5,1,Martin Grund,2014-10-22 15:19:09-07:00,['631c06858b3843ab918f020c4973412a6c356f24'],76,49,125,2743679,5,1,1,1,2262
7ecf10365f21d04d45d1e896f5ef4f2225ef8699,1,jenkins,2014-10-23 15:29:51-07:00,['e8667652137d138428de87415a1534cfcdd320b5'],22,54,76,2743755,8,0,1,1,2262
a74554485caddcbda7d0097483b9cd50851bd27d,0,jenkins,2014-10-23 17:28:03-07:00,['7ecf10365f21d04d45d1e896f5ef4f2225ef8699'],44,0,44,2743799,1,,,,2262
aedf8e5fb881f05a7be821f9f119280f9f6f5908,0,jenkins,2014-10-24 03:47:45-07:00,['a74554485caddcbda7d0097483b9cd50851bd27d'],22,0,22,2743821,1,,,,2262
a25867ee63e16753d8f48dc1222ac03e98a72131,0,jenkins,2014-10-24 03:54:19-07:00,['aedf8e5fb881f05a7be821f9f119280f9f6f5908'],2,2,4,2743825,1,,,,2262
56611601a3969fb41b0f79a6f9d81190ea97b7f7,0,jenkins,2014-10-24 10:31:48-07:00,['a25867ee63e16753d8f48dc1222ac03e98a72131'],0,23,23,2743848,1,,,,2262
ecdd1736be6f0fd16d8ad050f114dbcd811159f9,0,jenkins,2014-10-24 12:04:18-07:00,['56611601a3969fb41b0f79a6f9d81190ea97b7f7'],1,5,6,2743854,5,0,0,0,2262
4a722980e5f955af16bcde3bb6b73b806cad3056,1,jenkins,2014-10-27 16:30:56-07:00,['ecdd1736be6f0fd16d8ad050f114dbcd811159f9'],34,56,90,2743944,5,0,0,1,2263
5f8dc8aa1e2a3c8d00283a5ebf792f34ca769452,0,jenkins,2014-10-27 20:02:09-07:00,['4a722980e5f955af16bcde3bb6b73b806cad3056'],5,15,20,2743964,2,0,1,1,2263
6e0c1c26c9aa76393a5dd530687ddefda65f8f8b,1,jenkins,2014-10-28 08:07:21-07:00,['5f8dc8aa1e2a3c8d00283a5ebf792f34ca769452'],2,33,35,2743999,6,1,1,1,2263
09dbd5dd9f15252889c4bb1ad1094eb390522518,1,jenkins,2014-10-28 17:48:55-07:00,['6e0c1c26c9aa76393a5dd530687ddefda65f8f8b'],0,22,22,2744021,2,1,1,1,2263
65f7ee9a898d6a5792d717348836bf2b57c4b3e9,0,jenkins,2014-10-29 12:59:24-07:00,['09dbd5dd9f15252889c4bb1ad1094eb390522518'],15,22,37,2744058,4,0.6,0.6,0.8,2263
8ee3088d9c20068b8513bccd51f1e4e14678b331,0,jenkins,2014-10-29 20:27:57-07:00,['65f7ee9a898d6a5792d717348836bf2b57c4b3e9'],1,33,34,2744092,3,0.217391304,0.956521739,1,2263
08feed674b3516aebd294c689d7937483ba7486d,1,Henry Robinson,2014-10-29 21:45:18-07:00,['8ee3088d9c20068b8513bccd51f1e4e14678b331'],5,5,10,2744102,4,,,,2263
e5e06c307bd20c5e8f87810ac3e13ac25d19868a,1,jenkins,2014-10-29 22:07:33-07:00,['08feed674b3516aebd294c689d7937483ba7486d'],2105,3157,5262,2749364,26,1,1,1,2264
946852847702bebe43f67fc692ff33abc2eb07b8,1,jenkins,2014-10-30 00:01:08-07:00,['e5e06c307bd20c5e8f87810ac3e13ac25d19868a'],4,34,38,2749402,3,0,1,1,2264
164687ad812d881da264d14f9cee1620ef2b2d93,1,jenkins,2014-10-30 16:50:00-07:00,['946852847702bebe43f67fc692ff33abc2eb07b8'],18,57,75,2749477,4,0.8,1,1,2264
ef254f08a3151b4bcae66dfb1d4679c24607904c,0,jenkins,2014-11-03 12:12:00-08:00,['164687ad812d881da264d14f9cee1620ef2b2d93'],1,102,103,2749580,2,0,0,1,2264
cdaa10836c1aeb9f59fe16a2259bb20b8632708b,0,Michael Yoder,2014-11-03 17:07:49-08:00,['ef254f08a3151b4bcae66dfb1d4679c24607904c'],1,4,5,2749585,1,,,,2264
f50b664149384709a7466d50511154b2eb6933e4,0,jenkins,2014-11-03 18:50:57-08:00,['cdaa10836c1aeb9f59fe16a2259bb20b8632708b'],1,2,3,2749588,1,,,,2264
f96fb279820fc39f843878792a785b6e19523695,1,jenkins,2014-11-03 22:32:57-08:00,['f50b664149384709a7466d50511154b2eb6933e4'],43,52,95,2749683,8,0.8,0.8,1,2264
e2d7fb6402d431916d37f66f5089c30b74ff3cf7,0,jenkins,2014-11-03 22:33:08-08:00,['f96fb279820fc39f843878792a785b6e19523695'],69,70,139,2749822,4,0,0,0,2264
9bd8b5b8cd74ad86830a9f41f3e98d33dc1f0aea,1,jenkins,2014-11-03 22:33:51-08:00,['e2d7fb6402d431916d37f66f5089c30b74ff3cf7'],30,75,105,2749927,5,0,0.051282051,0.205128205,2264
90889985339b6b5220c393907949c86fe2891dea,0,jenkins,2014-11-03 22:42:00-08:00,['9bd8b5b8cd74ad86830a9f41f3e98d33dc1f0aea'],5,16,21,2749948,1,0,0.25,0.75,2264
9209bb3a293531fde011bd076c11d44b2e9e1824,0,jenkins,2014-11-03 23:05:09-08:00,['90889985339b6b5220c393907949c86fe2891dea'],12,33,45,2749993,2,0,0.833333333,0.5,2264
e656fe9b87603fbc2bb09608a774cb77a0d91b52,0,jenkins,2014-11-05 12:12:15-08:00,['9209bb3a293531fde011bd076c11d44b2e9e1824'],3,30,33,2750026,2,0.666666667,1,1,2264
d1e4206d40e26b96a5dc23ad06a6145f0f013a5e,1,jenkins,2014-11-05 12:12:18-08:00,['e656fe9b87603fbc2bb09608a774cb77a0d91b52'],15,15,30,2750056,1,,,,2264
b5623d2d80fc5f97c7dfc35790dd2b98a658b211,1,jenkins,2014-11-05 12:13:50-08:00,['d1e4206d40e26b96a5dc23ad06a6145f0f013a5e'],35,106,141,2750197,5,1,1,1,2265
433a86263cb165e9e0f1f246c50be444b1c56ed3,1,jenkins,2014-11-05 14:59:25-08:00,['b5623d2d80fc5f97c7dfc35790dd2b98a658b211'],217,342,559,2750756,7,0.542857143,1,0.171428571,2265
04da6d06ae7c11476416f0d0c58cffe07f9eb600,0,jenkins,2014-11-05 18:19:24-08:00,['433a86263cb165e9e0f1f246c50be444b1c56ed3'],1,23,24,2750780,2,0,0.5,0.75,2265
cb578fc8748004ea01f2eb7cbe424e48a4a30239,0,jenkins,2014-11-05 19:55:57-08:00,['04da6d06ae7c11476416f0d0c58cffe07f9eb600'],9,16,25,2750805,2,0,1,1,2265
f90213cb366eb5dc7239977e61c784d0f5617ce8,0,Henry Robinson,2014-11-06 14:54:19-08:00,['cb578fc8748004ea01f2eb7cbe424e48a4a30239'],0,0,0,2750805,0,,,,2265
dd57f6c594127510ccaf2a46f6e443864a8dc0aa,0,Ishaan Joshi,2014-11-06 15:56:34-08:00,['f90213cb366eb5dc7239977e61c784d0f5617ce8'],30,3,33,2750838,2,0.333333333,0,0,2265
a7618d01ddf6dfc9bd9e36e368ba4f5725750906,0,jenkins,2014-11-06 18:39:51-08:00,['dd57f6c594127510ccaf2a46f6e443864a8dc0aa'],3,19,22,2750860,3,0,0.285714286,1,2265
c693fbc48ca6040917976d23d24e9d8880ac4ccb,1,jenkins,2014-11-06 22:04:11-08:00,['a7618d01ddf6dfc9bd9e36e368ba4f5725750906'],1872,1896,3768,2754628,31,0.230769231,0.307692308,1,2265
5e27746e70361ba52741100b83583497defa956e,1,jenkins,2014-11-07 12:39:51-08:00,['c693fbc48ca6040917976d23d24e9d8880ac4ccb'],16,36,52,2754680,3,0.6,0.6,0.6,2265
873d88a6bf19af299a130f4eef84b7b9f0f4cdeb,0,jenkins,2014-11-08 01:00:54-08:00,['5e27746e70361ba52741100b83583497defa956e'],3,46,49,2754729,1,,,,2265
3213f9dd7759d2910799209eae366ee081936202,1,Henry Robinson,2014-11-11 14:51:16-08:00,['873d88a6bf19af299a130f4eef84b7b9f0f4cdeb'],7,13,20,2754749,5,0,1,1,2265
0f04b608af87ff9fb9a002d14309f0daba4cd445,1,Henry Robinson,2014-11-11 14:51:20-08:00,['3213f9dd7759d2910799209eae366ee081936202'],30,79,109,2754858,14,0,0.266666667,0.9,2265
7f411ecf9ff19851a978588cd2a550392087b15d,1,jenkins,2014-11-11 20:08:14-08:00,['0f04b608af87ff9fb9a002d14309f0daba4cd445'],58,110,168,2755026,31,0.35,0.25,0.875,2265
23c6820cd99b3a0cbc87dfb6c288c14de3c5e0bf,1,jenkins,2014-11-12 10:39:21-08:00,['7f411ecf9ff19851a978588cd2a550392087b15d'],115,152,267,2755293,2,0.791666667,0.791666667,0,2265
fb1c9c46d64004307cdac556724cedf6ef87ff4e,1,jenkins,2014-11-12 16:25:36-08:00,['23c6820cd99b3a0cbc87dfb6c288c14de3c5e0bf'],4,69,73,2755366,6,0.30952381,0.333333333,0.976190476,2265
4bf6a21a9e1bca081bb657f5d36fcd45d56315a0,0,jenkins,2014-11-13 12:42:32-08:00,['fb1c9c46d64004307cdac556724cedf6ef87ff4e'],17,21,38,2755404,6,0,1,1,2265
3c64890afe64d2c1c5e57e0810d6c771f43494c3,1,jenkins,2014-11-13 15:52:09-08:00,['4bf6a21a9e1bca081bb657f5d36fcd45d56315a0'],57,68,125,2755529,7,0,0.75,0.25,2265
13ef3d61ee8cabc197533a9256cbe8617f7c28a9,1,jenkins,2014-11-13 16:45:39-08:00,['3c64890afe64d2c1c5e57e0810d6c771f43494c3'],52,80,132,2755661,4,1,0.916666667,0.666666667,2265
fd1a4698785384dd727ac79a2a8e91e0d3f16157,1,jenkins,2014-11-13 18:54:08-08:00,['13ef3d61ee8cabc197533a9256cbe8617f7c28a9'],290,519,809,2756470,2,0,0.296089385,0.351955307,2265
e99428a37b8af777f3fda26da16b21491e0a4524,0,jenkins,2014-11-13 23:55:48-08:00,['fd1a4698785384dd727ac79a2a8e91e0d3f16157'],4,12,16,2756486,4,0,0.8,0.8,2265
2ff3662137c37ba4eea246166d2ba5388333a6a3,0,jenkins,2014-11-13 23:57:12-08:00,['e99428a37b8af777f3fda26da16b21491e0a4524'],6,30,36,2756522,3,0,0,1,2265
f58159d43129a27d672100e3e01306411731bd34,1,Martin Grund,2014-11-14 13:47:02-08:00,['2ff3662137c37ba4eea246166d2ba5388333a6a3'],117,270,387,2756909,6,0.666666667,0.645833333,0.916666667,2266
0cb8ba98ece06c7115e91b60b303ceaa20f626a5,0,jenkins,2014-11-14 16:30:12-08:00,['f58159d43129a27d672100e3e01306411731bd34'],2,5,7,2756916,1,0,0,0,2266
a4ee0a65f4dabf550daa4aaae99f8a4ffa71dc55,1,ishaan,2014-11-17 11:18:54-08:00,['0cb8ba98ece06c7115e91b60b303ceaa20f626a5'],107,46,153,2757069,13,0.545454545,1,0.340909091,2266
7b6ecbeea56786432d2565eac03a3fab9dabef32,0,ishaan,2014-11-17 11:19:01-08:00,['a4ee0a65f4dabf550daa4aaae99f8a4ffa71dc55'],2,3,5,2757074,1,,,,2266
516d7483dd01cfd9cdaba6770c4f4983c2c4dcb6,0,ishaan,2014-11-17 11:19:09-08:00,['7b6ecbeea56786432d2565eac03a3fab9dabef32'],41,98,139,2757213,8,0.823529412,1,1,2266
3f75bd6735d2f3eefa680cabb0525afa127ebcb8,0,ishaan,2014-11-17 11:19:16-08:00,['516d7483dd01cfd9cdaba6770c4f4983c2c4dcb6'],4,1,5,2757218,2,0,0,0,2266
cb697e40b1ef45d3f6f4780cf3d5aa6162b80a1e,0,ishaan,2014-11-17 15:02:04-08:00,['3f75bd6735d2f3eefa680cabb0525afa127ebcb8'],1,36,37,2757255,4,0.052631579,0.052631579,1,2266
4915ea4ac93c1c48022215d0a4c190d0f71f1e0e,1,ishaan,2014-11-17 15:02:24-08:00,['cb697e40b1ef45d3f6f4780cf3d5aa6162b80a1e'],14,31,45,2757300,5,,,,2266
24ce8cfada2bbd277dd4ffff2eecb2fcecb4f21c,1,ishaan,2014-11-17 15:02:30-08:00,['4915ea4ac93c1c48022215d0a4c190d0f71f1e0e'],14,28,42,2757342,4,0.8,1,0.2,2266
b9b533374c5d70b18c47b013b7c4d95f51df74ae,1,ishaan,2014-11-17 15:02:36-08:00,['24ce8cfada2bbd277dd4ffff2eecb2fcecb4f21c'],152,280,432,2757774,8,0.625,0.8125,0.8125,2269
742cae81c536119a3b729ccf6759e8d90c5decdc,0,ishaan,2014-11-17 15:02:42-08:00,['b9b533374c5d70b18c47b013b7c4d95f51df74ae'],0,5,5,2757779,1,0,1,0,2269
3b7862c633ce21de967dbca9e8b87642e2e50a02,1,ishaan,2014-11-17 15:02:48-08:00,['742cae81c536119a3b729ccf6759e8d90c5decdc'],0,4,4,2757783,1,1,1,1,2269
69e85a07f7c108a0a36b99b574867c6e07c5b202,1,ishaan,2014-11-17 15:02:54-08:00,['3b7862c633ce21de967dbca9e8b87642e2e50a02'],72,98,170,2757953,4,0.19047619,0,0.761904762,2269
13f793f9c259db4397d826f78585bddcd50f366f,1,ishaan,2014-11-17 15:03:00-08:00,['69e85a07f7c108a0a36b99b574867c6e07c5b202'],3,15,18,2757971,1,1,1,1,2269
41862f0d57f4f6d1ba19bee925370f867998df51,0,ishaan,2014-11-17 15:03:06-08:00,['13f793f9c259db4397d826f78585bddcd50f366f'],3,8,11,2757982,2,,,,2269
fa774bfb85bd7560c24d6efaae46da502c910f9b,1,ishaan,2014-11-17 15:03:14-08:00,['41862f0d57f4f6d1ba19bee925370f867998df51'],53,121,174,2758156,5,0.333333333,0.333333333,1,2270
ce54f373ea115514ce00676e0e74faa965eb1f56,1,ishaan,2014-11-17 15:03:20-08:00,['fa774bfb85bd7560c24d6efaae46da502c910f9b'],10,10,20,2758176,2,0,1,1,2270
78ee31246c812c6cd8bd960f996fefbc036b71ed,1,Martin Grund,2014-11-17 16:51:29-08:00,['ce54f373ea115514ce00676e0e74faa965eb1f56'],29,58,87,2758263,2,,,,2270
0ced5827ad2ad5db88d04e3c8c8af535090827fa,1,jenkins,2014-11-18 20:07:02-08:00,['78ee31246c812c6cd8bd960f996fefbc036b71ed'],32,48,80,2758343,7,1,1,1,2270
3345b7b98ad552af1c1fe7af6492c8791d3d5ca9,1,jenkins,2014-11-19 00:58:54-08:00,['0ced5827ad2ad5db88d04e3c8c8af535090827fa'],3,9,12,2758355,2,0,1,1,2270
821fccedbf2932e77f12b3ecb171fceb16082c9e,0,jenkins,2014-11-19 17:09:45-08:00,['3345b7b98ad552af1c1fe7af6492c8791d3d5ca9'],0,1,1,2758356,1,0,0,1,2270
c4a58365f77792a515e3f7a13e0cc2d40f401287,1,jenkins,2014-11-19 17:20:56-08:00,['821fccedbf2932e77f12b3ecb171fceb16082c9e'],6,25,31,2758387,3,0,0.428571429,0.571428571,2270
4339133887cc1b826e7975cf431495961006e8eb,1,jenkins,2014-11-19 17:21:36-08:00,['c4a58365f77792a515e3f7a13e0cc2d40f401287'],19,131,150,2758537,9,0.075,0,0.7,2270
e98cf951789de0376e94f6773e7e98f97865a62b,0,jenkins,2014-11-19 20:56:53-08:00,['4339133887cc1b826e7975cf431495961006e8eb'],7,9,16,2758553,1,0,0,1,2270
87502f829c00414c1d898409b869d8b25dfacb68,1,jenkins,2014-11-20 02:21:14-08:00,['e98cf951789de0376e94f6773e7e98f97865a62b'],2,153,155,2758708,3,0,0,0,2270
f853eeb2f02491bd78ca8a120a3e3a63746a279e,1,jenkins,2014-11-20 11:25:33-08:00,['87502f829c00414c1d898409b869d8b25dfacb68'],52,986,1038,2759746,12,0.7,0.7,0.5,2273
dc8ef8d5d8b6896ea9c37162ffa901e1dbb2fef9,1,jenkins,2014-11-20 12:48:47-08:00,['f853eeb2f02491bd78ca8a120a3e3a63746a279e'],1,4,5,2759751,2,1,1,0.666666667,2273
39e90bef8a2a9a04398041a0cca6490c24b212fd,1,jenkins,2014-11-20 13:58:44-08:00,['dc8ef8d5d8b6896ea9c37162ffa901e1dbb2fef9'],6,32,38,2759789,5,0.4,0.8,0.8,2273
dbbd2cc09f8bf305dc96d0a0a654cae2ab6c6b74,0,Henry Robinson,2014-11-20 17:07:45-08:00,['39e90bef8a2a9a04398041a0cca6490c24b212fd'],12,14,26,2759815,1,,,,2273
14caf66875e2359de82fb913158f2414eaa294f5,1,jenkins,2014-11-20 20:15:44-08:00,['dbbd2cc09f8bf305dc96d0a0a654cae2ab6c6b74'],0,7,7,2759822,1,,,,2273
fc5104751fa612b5639082b4def631935328ad64,1,jenkins,2014-11-20 20:22:47-08:00,['14caf66875e2359de82fb913158f2414eaa294f5'],7,26,33,2759855,3,1,1,1,2273
e7dbf1ac45cf2798d46afc221179f4a87ab8d0ab,0,jenkins,2014-11-20 23:37:44-08:00,['fc5104751fa612b5639082b4def631935328ad64'],3,3,6,2759861,2,,,,2273
c1d8c22862bcf25b63008e83c8c4eabe71f5fb35,1,jenkins,2014-11-21 01:08:27-08:00,['e7dbf1ac45cf2798d46afc221179f4a87ab8d0ab'],5,109,114,2759975,5,0.678571429,0.678571429,0.642857143,2273
906fba7e2a0e9af7b6933112ee0aa951d4dab2c0,0,jenkins,2014-11-21 11:33:48-08:00,['c1d8c22862bcf25b63008e83c8c4eabe71f5fb35'],2,6,8,2759983,2,0.75,1,1,2273
cc88fc01c1a0ebc94aadacced28256eb4cb43e32,1,jenkins,2014-11-21 11:33:51-08:00,['906fba7e2a0e9af7b6933112ee0aa951d4dab2c0'],0,38,38,2760021,1,0,0,1,2273
99ce6176bed76afa517fe82740bd363cbe29fa58,1,jenkins,2014-11-21 12:08:21-08:00,['cc88fc01c1a0ebc94aadacced28256eb4cb43e32'],3,122,125,2760146,4,0.64516129,0.612903226,0.741935484,2273
bc393c2f565dd8dfe59f19201f879e085d1ee955,1,jenkins,2014-11-21 13:46:08-08:00,['99ce6176bed76afa517fe82740bd363cbe29fa58'],20,86,106,2760252,11,0.684210526,0.815789474,1,2273
3e031fb3fc447428aa6da679a5d5944453c9fa56,1,jenkins,2014-11-21 15:40:12-08:00,['bc393c2f565dd8dfe59f19201f879e085d1ee955'],16,20,36,2760288,5,1,1,0.5,2273
25bc1a7a773ee4959f119e0908da73092b0156bc,1,jenkins,2014-11-21 16:02:18-08:00,['3e031fb3fc447428aa6da679a5d5944453c9fa56'],17,462,479,2760767,18,0.43220339,0.63559322,0.661016949,2276
c850e6c65cc51dbb216ce07442d51fd75ef29859,1,Nong Li,2014-11-21 16:40:41-08:00,['25bc1a7a773ee4959f119e0908da73092b0156bc'],93,283,376,2761143,8,0.397959184,1,0.969387755,2277
a8c76c57fdf61a867a56a3d499490445df90e8a3,0,Nong Li,2014-11-21 16:40:42-08:00,['c850e6c65cc51dbb216ce07442d51fd75ef29859'],1,3,4,2761147,1,,,,2277
4544f6eb117167f0df660676e3b7b4599e696d64,1,Nong Li,2014-11-21 16:40:42-08:00,['a8c76c57fdf61a867a56a3d499490445df90e8a3'],16,42,58,2761205,3,0.611111111,0.611111111,1,2277
19ba7c92c2587178089c0107458161199961e0f5,1,Nong Li,2014-11-21 16:40:42-08:00,['4544f6eb117167f0df660676e3b7b4599e696d64'],4,20,24,2761229,2,0,0,0.333333333,2277
25428fdb21ee7cfb30c9e2337134d38f588e6f60,1,jenkins,2014-11-23 01:55:55-08:00,['19ba7c92c2587178089c0107458161199961e0f5'],140,417,557,2761786,12,0.214285714,0.696428571,0.613095238,2278
b8f01c315a99a619ca779d0e44778f5ed880dbc4,1,Nong Li,2014-11-23 21:34:55-08:00,['25428fdb21ee7cfb30c9e2337134d38f588e6f60'],2,6,8,2761794,1,1,1,1,2278
b42e3e8ce995fa4366057e6222ddf212b651aa12,0,Nong Li,2014-11-23 21:35:03-08:00,['b8f01c315a99a619ca779d0e44778f5ed880dbc4'],1,1,2,2761796,1,,,,2278
2bfb69523f76c589ea05f925b83ea056ed64b28e,1,Nong Li,2014-11-23 21:36:03-08:00,['b42e3e8ce995fa4366057e6222ddf212b651aa12'],5,17,22,2761818,2,0,0,1,2278
4b748ef5dace7eb4b7a92618238e7c70a3c931d3,1,Nong Li,2014-11-23 21:36:31-08:00,['2bfb69523f76c589ea05f925b83ea056ed64b28e'],30,368,398,2762216,6,0.785714286,0.785714286,1,2278
8a7479823cd326ef2082d9d3d672c56a216f4812,1,Nong Li,2014-11-23 21:36:38-08:00,['4b748ef5dace7eb4b7a92618238e7c70a3c931d3'],1,27,28,2762244,2,0,0.947368421,0.947368421,2278
059d0f5b764e9df59447ce157347ae76576e46c1,0,jenkins,2014-11-24 15:32:14-08:00,['8a7479823cd326ef2082d9d3d672c56a216f4812'],3,3,6,2762250,1,1,1,0,2278
e90e35bd2c0aa69e4dc6591485622341c51bd0d6,1,jenkins,2014-11-24 16:46:56-08:00,['059d0f5b764e9df59447ce157347ae76576e46c1'],11,36,47,2762297,3,0,0.45,1,2278
b9701951f39327f2a0fa715815e4cadc42784f2b,1,jenkins,2014-11-25 01:32:35-08:00,['e90e35bd2c0aa69e4dc6591485622341c51bd0d6'],5,11,16,2762313,1,0,0,1,2278
44f57e5fb6878716ed26910dde14bd069fb96a82,1,Henry Robinson,2014-11-25 09:13:37-08:00,['b9701951f39327f2a0fa715815e4cadc42784f2b'],1623,4539,6162,2768475,41,0.314655172,0.46408046,0.708333333,2283
e79610c0ce4ec1f23069a232089eaf16e561c62e,0,jenkins,2014-11-25 11:48:26-08:00,['44f57e5fb6878716ed26910dde14bd069fb96a82'],1,8,9,2768484,2,1,1,1,2283
962cc35d68f3e9f7b06477821738761614c9f7bd,1,jenkins,2014-11-25 16:15:05-08:00,['e79610c0ce4ec1f23069a232089eaf16e561c62e'],57,72,129,2768613,2,0,0,1,2283
79b45d68b76892b6336b2f6d0c526c554b42a814,0,Henry Robinson,2014-11-25 18:08:15-08:00,['962cc35d68f3e9f7b06477821738761614c9f7bd'],1,1,2,2768615,1,,,,2283
8ad6ba9f8c3a2b29da800520213b47b7ab799359,0,jenkins,2014-11-25 18:18:45-08:00,['79b45d68b76892b6336b2f6d0c526c554b42a814'],1,13,14,2768629,2,1,1,1,2283
390e773a44b8148dc47f953a0ce6b752e0f95fd8,1,jenkins,2014-11-25 18:38:27-08:00,['8ad6ba9f8c3a2b29da800520213b47b7ab799359'],4,19,23,2768652,4,1,1,1,2283
dd89c1455a8b0abd6360182d00c64776b3bf8b9d,0,jenkins,2014-11-25 23:03:34-08:00,['390e773a44b8148dc47f953a0ce6b752e0f95fd8'],1,6,7,2768659,1,1,1,0,2283
4ad15bb2bec313d5053cd2e07b54c8d904796d66,0,Nong Li,2014-11-25 23:21:02-08:00,['dd89c1455a8b0abd6360182d00c64776b3bf8b9d'],7,24,31,2768690,3,,,,2283
72a993449fe7699d2cdd124dcf861936a331e168,0,jenkins,2014-11-26 13:11:15-08:00,['4ad15bb2bec313d5053cd2e07b54c8d904796d66'],22,14,36,2768726,1,1,1,1,2283
960892979e9b45b936faa4c35abf72890f6b0d20,0,jenkins,2014-11-26 13:22:31-08:00,['72a993449fe7699d2cdd124dcf861936a331e168'],3,3,6,2768732,1,,,,2283
e004307bbecf9ebb2ed0a5f418484fc6748dcbaf,0,jenkins,2014-11-26 14:29:48-08:00,['960892979e9b45b936faa4c35abf72890f6b0d20'],0,34,34,2768766,4,0.571428571,0.571428571,0.571428571,2283
30a5d1d4524cb647517de07c2a9c9fed9a3cd90e,1,jenkins,2014-11-26 14:42:54-08:00,['e004307bbecf9ebb2ed0a5f418484fc6748dcbaf'],3,65,68,2768834,3,0,0.777777778,1,2283
98064c4da8f5fb1d21a198b6c3ef1f456d6bc072,0,jenkins,2014-11-26 23:25:11-08:00,['30a5d1d4524cb647517de07c2a9c9fed9a3cd90e'],2,19,21,2768855,2,,,,2283
02db135ead612a7f671acf2b9c179c50afd8bce7,0,jenkins,2014-11-27 00:34:17-08:00,['98064c4da8f5fb1d21a198b6c3ef1f456d6bc072'],11,45,56,2768911,3,0.5,0.5,0,2283
c0f2e043b4ac52605f0176fb06315c535ed6a663,1,jenkins,2014-11-30 01:08:08-08:00,['02db135ead612a7f671acf2b9c179c50afd8bce7'],2,2,4,2768915,2,,,,2283
13b9cdd6b0dd356d9872df3dfbc5e17e70952c8b,0,Henry Robinson,2014-12-01 17:26:39-08:00,['c0f2e043b4ac52605f0176fb06315c535ed6a663'],0,35,35,2768950,1,,,,2283
1332228001bc24b68f3b43dca58d6c9711e5f66e,0,jenkins,2014-12-01 17:41:32-08:00,['13b9cdd6b0dd356d9872df3dfbc5e17e70952c8b'],3,4,7,2768957,3,0,0,1,2283
de2631a1b7228a9c03a48f21068681f0a048cf3d,1,jenkins,2014-12-01 18:10:31-08:00,['1332228001bc24b68f3b43dca58d6c9711e5f66e'],14,12,26,2768983,3,1,0,0,2283
8fed3e39ebe34f7a3277a009b4921b9d95de77fe,0,jenkins,2014-12-01 20:13:05-08:00,['de2631a1b7228a9c03a48f21068681f0a048cf3d'],1,14,15,2768998,2,0,1,1,2283
aaac1b36ade9477bc91f1b6ac64e5d4f6fae7c4f,1,jenkins,2014-12-02 00:54:38-08:00,['8fed3e39ebe34f7a3277a009b4921b9d95de77fe'],40,146,186,2769184,11,0.194805195,1,1,2283
6fd6a67aae11b6287c5e593dc39e230746c580f0,1,jenkins,2014-12-02 10:42:42-08:00,['aaac1b36ade9477bc91f1b6ac64e5d4f6fae7c4f'],15,26,41,2769225,3,0.6,0.6,1,2283
f696861c5ca8b1d84a5bf496695d74a38c97a8f0,0,jenkins,2014-12-02 18:08:09-08:00,['6fd6a67aae11b6287c5e593dc39e230746c580f0'],88,88,176,2769401,12,1,1,0,2283
a9c4a9f70096ee4c14c12986d82a0c21250fa232,0,jenkins,2014-12-03 14:12:56-08:00,['f696861c5ca8b1d84a5bf496695d74a38c97a8f0'],7,4,11,2769412,1,,,,2283
0f83037e927ffeb2f7eb427550ea8957088c8f5d,0,jenkins,2014-12-04 10:00:17-08:00,['a9c4a9f70096ee4c14c12986d82a0c21250fa232'],5,8,13,2769425,1,,,,2283
54de8d1d925bd8127cc07a3b8907bc02b5b76687,1,jenkins,2014-12-04 15:43:26-08:00,['0f83037e927ffeb2f7eb427550ea8957088c8f5d'],9,48,57,2769482,1,0.173913043,1,0.956521739,2283
325f5a4551d12fd2f705bf2439b31bc952ab3412,1,jenkins,2014-12-04 18:23:00-08:00,['54de8d1d925bd8127cc07a3b8907bc02b5b76687'],12,11,23,2769505,1,,,,2283
bf7e3ad2a7f1ad49b5a0689a904dbf4640653ddc,1,jenkins,2014-12-04 21:24:46-08:00,['325f5a4551d12fd2f705bf2439b31bc952ab3412'],2232,2443,4675,2774180,11,1,1,1,2287
bdb4792ce6cad9738c5570948e542066686e15ef,0,jenkins,2014-12-05 16:44:57-08:00,['bf7e3ad2a7f1ad49b5a0689a904dbf4640653ddc'],10,0,10,2774190,1,0,0,0,2287
66d6c79c6ee1e6326a22ed1826749a574228d21c,1,Alex Behm,2014-12-06 21:11:26-08:00,['bdb4792ce6cad9738c5570948e542066686e15ef'],64,21,85,2774275,10,1,0.333333333,0.833333333,2287
e25a3bcb0befff7fa0b3ad1bbaf313b2f9b8cccb,1,jenkins,2014-12-07 20:48:42-08:00,['66d6c79c6ee1e6326a22ed1826749a574228d21c'],14,22,36,2774311,4,0,0.166666667,1,2287
6411f2d8c696b36d76eeddc3ddbb5f95e86a7af5,1,Matthew Jacobs,2014-12-08 15:59:15-08:00,['e25a3bcb0befff7fa0b3ad1bbaf313b2f9b8cccb'],21,21,42,2774353,1,,,,2287
624b03dcd0d1c456c9490c42da7afd09283d85b4,0,jenkins,2014-12-08 18:02:49-08:00,['6411f2d8c696b36d76eeddc3ddbb5f95e86a7af5'],3,2,5,2774358,1,1,1,1,2287
09b97f3881eb4bf0dbbeeb56dc69dbd97dc9260a,1,jenkins,2014-12-08 18:16:45-08:00,['624b03dcd0d1c456c9490c42da7afd09283d85b4'],24,100,124,2774482,2,,,,2288
57132bf021acd93fa8524e6b362a9ba7e30a21ca,0,jenkins,2014-12-10 17:33:11-08:00,['09b97f3881eb4bf0dbbeeb56dc69dbd97dc9260a'],1,59,60,2774542,4,0,0,1,2288
0dc83f54be24445dc6d1d9332ec41bb54d4947e6,0,jenkins,2014-12-10 17:33:23-08:00,['57132bf021acd93fa8524e6b362a9ba7e30a21ca'],1,30,31,2774573,6,0.230769231,0,0.769230769,2288
b02921f7877a3c4ebeb3f8fcc508a7646c6ae339,1,jenkins,2014-12-10 20:00:32-08:00,['0dc83f54be24445dc6d1d9332ec41bb54d4947e6'],6,12,18,2774591,2,0,0.5,0.5,2288
0f8ebbc5be34a875f486d8b393345dbb522361d1,0,jenkins,2014-12-10 23:02:47-08:00,['b02921f7877a3c4ebeb3f8fcc508a7646c6ae339'],0,2,2,2774593,1,,,,2288
c95e43449b51f5aea8b3102a719a31d60a0f4000,1,jenkins,2014-12-11 16:34:48-08:00,['0f8ebbc5be34a875f486d8b393345dbb522361d1'],24,41,65,2774658,1,0,0,0,2288
9b7fa09ab6de04fbf33ca57d6562a52daabc6a8c,1,jenkins,2014-12-11 20:06:57-08:00,['c95e43449b51f5aea8b3102a719a31d60a0f4000'],47,137,184,2774842,6,0.339285714,0.267857143,0.839285714,2288
30d9e8efefa100aafa43d26f384d6927dea493b9,1,jenkins,2014-12-12 18:14:41-08:00,['9b7fa09ab6de04fbf33ca57d6562a52daabc6a8c'],20,178,198,2775040,13,0.233009709,0.640776699,0.67961165,2288
9d490dcc260cf20c7b2cf769e18171308f953fc3,1,jenkins,2014-12-12 20:17:15-08:00,['30d9e8efefa100aafa43d26f384d6927dea493b9'],2,2,4,2775044,1,,,,2288
4cf39ac9f6f76b9f7febb8e299c8d5e9d39ced24,0,jenkins,2014-12-12 20:47:34-08:00,['9d490dcc260cf20c7b2cf769e18171308f953fc3'],9,32,41,2775085,3,0,0,1,2288
9c17990e458441e0cf2981007ae7d12a3eae7c34,0,ishaan,2014-12-13 14:35:11-08:00,['4cf39ac9f6f76b9f7febb8e299c8d5e9d39ced24'],0,0,0,2775085,0,,,,2288
0ac953aef21776509a2f74c6967683bcebaeb751,0,ishaan,2014-12-16 11:28:03-08:00,['9c17990e458441e0cf2981007ae7d12a3eae7c34'],6,12,18,2775103,2,,,,2288
0ff8c99068178b2231a4692b2cdf79621630dbef,0,ishaan,2014-12-16 11:28:08-08:00,['0ac953aef21776509a2f74c6967683bcebaeb751'],1,1,2,2775105,1,,,,2288
3ba1d2a475363edf329bb4e33cc98312f0eac651,0,ishaan,2014-12-16 15:23:08-08:00,['0ff8c99068178b2231a4692b2cdf79621630dbef'],1,1,2,2775107,1,,,,2288
4165eac9427fec6bb0fe909f431e3ab9c5de4c06,0,jenkins,2014-12-16 18:14:55-08:00,['3ba1d2a475363edf329bb4e33cc98312f0eac651'],2,4,6,2775113,1,0,0,0,2288
31e95e6b440f0317acc8bf3d1ac4d56c8696c376,0,Skye Wanderman-Milne,2014-12-16 18:51:59-08:00,['4165eac9427fec6bb0fe909f431e3ab9c5de4c06'],6,53,59,2775172,2,0,0.130434783,0.543478261,2288
88add0d40bc902d0f28ecb5e7eab4f0b948986a3,1,Skye Wanderman-Milne,2014-12-16 18:52:16-08:00,['31e95e6b440f0317acc8bf3d1ac4d56c8696c376'],81,104,185,2775357,3,0,0.176470588,0.882352941,2288
c1ba95999a89362f0b9d4f81b655ac5af22ffb22,1,Skye Wanderman-Milne,2014-12-16 18:53:04-08:00,['88add0d40bc902d0f28ecb5e7eab4f0b948986a3'],15,25,40,2775397,1,0,0,0,2288
cfd4ff2546f344f80804381f0746410ea1a9ac2e,1,Skye Wanderman-Milne,2014-12-16 18:53:16-08:00,['c1ba95999a89362f0b9d4f81b655ac5af22ffb22'],3,158,161,2775558,4,0.241758242,0.241758242,0.758241758,2288
caf572d6158617fbd9db6e487e17b62ec9db2e17,0,jenkins,2014-12-17 14:10:19-08:00,['cfd4ff2546f344f80804381f0746410ea1a9ac2e'],11,21,32,2775590,1,1,1,1,2288
c2353a7d73cd273183a124879e31501ee951c708,0,jenkins,2014-12-18 14:21:42-08:00,['caf572d6158617fbd9db6e487e17b62ec9db2e17'],20,20,40,2775630,2,1,1,1,2288
47478b013d1a7f1873692654f944c8e07487639a,0,jenkins,2014-12-18 19:39:32-08:00,['c2353a7d73cd273183a124879e31501ee951c708'],30,28,58,2775688,4,0,0,0,2288
b013495e1d521298f847bb7d09bed68bbeac3cb6,1,jenkins,2014-12-19 03:30:44-08:00,['47478b013d1a7f1873692654f944c8e07487639a'],1539,3975,5514,2781202,10,0.387405886,0.453798768,0.441478439,2294
dee6911b205bd7cfe031a8c19c7d58a5f537f27c,1,jenkins,2014-12-19 13:41:00-08:00,['b013495e1d521298f847bb7d09bed68bbeac3cb6'],248,332,580,2781782,17,1,1,1,2294
c413c035175af211a93813b28298e315984cc02b,0,Casey Ching,2014-12-19 16:37:46-08:00,['dee6911b205bd7cfe031a8c19c7d58a5f537f27c'],479,1094,1573,2783355,8,0.311546841,0.448801743,0.716775599,2294
e764b29819a54adb457595f08e5e82f73cd665a6,1,jenkins,2014-12-23 19:43:05-08:00,['c413c035175af211a93813b28298e315984cc02b'],29,85,114,2783469,5,1,0.941176471,1,2294
76118bd000e36b1e1a36105fb81002b237088380,1,jenkins,2014-12-29 14:44:33-08:00,['e764b29819a54adb457595f08e5e82f73cd665a6'],306,308,614,2784083,2,1,1,1,2294
cfdc71f1e19dfc17f82a289f2724da324ee9dcbe,1,jenkins,2015-01-05 13:22:39-08:00,['76118bd000e36b1e1a36105fb81002b237088380'],358,416,774,2784857,9,1,0.4,0.4,2296
8f17cdd0129b2a6ee0d236789bb341415acf3d91,1,jenkins,2015-01-07 11:57:36-08:00,['cfdc71f1e19dfc17f82a289f2724da324ee9dcbe'],1,1,2,2784859,1,,,,2296
43885419bfaa53f63906154695ebcfe3e6055cf1,1,jenkins,2015-01-07 15:30:53-08:00,['8f17cdd0129b2a6ee0d236789bb341415acf3d91'],12,14,26,2784885,1,1,0,1,2296
709834672c55864c4f993d5445d512537fcf5e7e,0,jenkins,2015-01-08 15:23:56-08:00,['43885419bfaa53f63906154695ebcfe3e6055cf1'],1,17,18,2784903,3,1,1,1,2296
9e9a05ca82cf0067fe7a2c33333ec60774366e50,0,Nong Li,2015-01-08 16:17:24-08:00,['709834672c55864c4f993d5445d512537fcf5e7e'],1,11,12,2784915,2,0,0,0.5,2296
3735ea94a07b1072f3c3513722c8340cb3c0a79c,1,jenkins,2015-01-08 16:19:35-08:00,['9e9a05ca82cf0067fe7a2c33333ec60774366e50'],34,123,157,2785072,12,0.5,0.125,0.875,2299
07efc0cb17682b2e3218d8b94389f13366f8eca7,1,jenkins,2015-01-09 12:40:06-08:00,['3735ea94a07b1072f3c3513722c8340cb3c0a79c'],9,16,25,2785097,2,,,,2299
95ca6263d98306ae57eb2852c64fd608c26895c4,1,jenkins,2015-01-09 16:51:15-08:00,['07efc0cb17682b2e3218d8b94389f13366f8eca7'],3,67,70,2785167,3,0,0,1,2299
8088afd56dc702152b136474fdce4fb77c816462,1,jenkins,2015-01-10 02:49:50-08:00,['95ca6263d98306ae57eb2852c64fd608c26895c4'],24,46,70,2785237,6,1,1,1,2299
0c2a71576fb2954ca97d4f8225a60b93eab8594a,1,Henry Robinson,2015-01-11 21:05:00-08:00,['8088afd56dc702152b136474fdce4fb77c816462'],1233,1883,3116,2788353,77,0.537037037,0.844444444,0.574074074,2307
24c15e1a383ea76a5a291f578d8838f51e95fcf2,0,jenkins,2015-01-12 15:03:51-08:00,['0c2a71576fb2954ca97d4f8225a60b93eab8594a'],7,0,7,2788360,1,1,1,0,2307
72d7b4a39018795502ff54de98943c652edc099d,0,Henry Robinson,2015-01-12 17:02:34-08:00,['24c15e1a383ea76a5a291f578d8838f51e95fcf2'],2,2,4,2788364,2,,,,2307
e5f00ed4bdbb0daa6cf20d7b0ee817e1bda85a3d,1,Matthew Jacobs,2015-01-12 17:57:46-08:00,['72d7b4a39018795502ff54de98943c652edc099d'],1,15,16,2788380,3,0.071428571,0.142857143,1,2307
866e44715b39268f2db244113290c8df57647a17,0,jenkins,2015-01-12 22:21:33-08:00,['e5f00ed4bdbb0daa6cf20d7b0ee817e1bda85a3d'],5164,0,5164,2793544,61,0.380226267,0.241515002,0.065420561,2307
b5d8e032960d51054390cb327c7ccc1f2058033c,0,jenkins,2015-01-12 22:22:05-08:00,['866e44715b39268f2db244113290c8df57647a17'],4,8,12,2793556,2,,,,2307
f70d1087066c4e2e54925225c30cb025764a70ea,0,Henry Robinson,2015-01-12 22:22:45-08:00,['b5d8e032960d51054390cb327c7ccc1f2058033c'],9,27,36,2793592,2,0,0,1,2307
7542d719c941576d967876a89421dfe0d1e51524,1,jenkins,2015-01-12 23:25:54-08:00,['f70d1087066c4e2e54925225c30cb025764a70ea'],29,57,86,2793678,3,0.8,1,1,2307
f12f1866e79cf6f48410c9ad4e7fdae2193e726d,0,jenkins,2015-01-13 12:40:49-08:00,['7542d719c941576d967876a89421dfe0d1e51524'],7,7,14,2793692,1,1,1,1,2307
e702b52ca0eb37da4098f6193dd077715a88aeaf,1,jenkins,2015-01-14 15:00:15-08:00,['f12f1866e79cf6f48410c9ad4e7fdae2193e726d'],3,3,6,2793698,1,,,,2307
9c3946c57cd841e98d8c79608bfe3e93b6c6d85c,1,jenkins,2015-01-14 17:01:49-08:00,['e702b52ca0eb37da4098f6193dd077715a88aeaf'],472,472,944,2794642,77,,,,2307
0a7ee79e1a4b9428c3cdc7b274fc93d18d100659,0,jenkins,2015-01-15 15:10:55-08:00,['9c3946c57cd841e98d8c79608bfe3e93b6c6d85c'],10,35,45,2794687,1,0,1,1,2307
5f457952501e39d861d52eba54bec5f01bc4f889,0,jenkins,2015-01-20 16:51:21-08:00,['0a7ee79e1a4b9428c3cdc7b274fc93d18d100659'],7,43,50,2794737,2,0.545454545,0.545454545,1,2307
0aa4127fb9825a123abf12b32a5c3489b9200a4a,1,Daniel Hecht,2015-01-21 11:43:33-08:00,['5f457952501e39d861d52eba54bec5f01bc4f889'],93,112,205,2794942,16,0,0,0,2307
b0ebd25cbf09d74de785b36935a98fce858263cb,0,jenkins,2015-01-22 01:12:48-08:00,['0aa4127fb9825a123abf12b32a5c3489b9200a4a'],1,1,2,2794944,1,,,,2307
f2305d93592bb3df5762f04fe62eda261366ac7a,0,ishaan,2015-01-22 12:52:33-08:00,['b0ebd25cbf09d74de785b36935a98fce858263cb'],0,0,0,2794944,0,,,,2307
ba081abac9091cbbfd36512a521613400a91f2a1,0,jenkins,2015-01-24 14:37:27-08:00,['f2305d93592bb3df5762f04fe62eda261366ac7a'],59,75,134,2795078,5,1,1,1,2307
cee1e84c1e2e41cfc3a75f1b27f139ba3b6303bc,1,Martin Grund,2015-01-26 20:30:59-08:00,['ba081abac9091cbbfd36512a521613400a91f2a1'],3029,3445,6474,2801552,21,0.202380952,0.327380952,0.380952381,2307
d5eba0c6f4502ba0a498afe274baa18a47f8f9cd,0,Daniel Hecht,2015-01-27 14:54:29-08:00,['cee1e84c1e2e41cfc3a75f1b27f139ba3b6303bc'],0,1,1,2801553,1,,,,2307
20df8059f939a800838db1e29a180c47c0f922dc,0,jenkins,2015-01-27 18:47:43-08:00,['d5eba0c6f4502ba0a498afe274baa18a47f8f9cd'],0,0,0,2801553,0,,,,2307
fd84ae2b9801dd4b3a07ebf9c2bc159b2ac64d55,0,jenkins,2015-01-27 20:08:06-08:00,['20df8059f939a800838db1e29a180c47c0f922dc'],2,3,5,2801558,1,,,,2307
b1bbc2e15f27931682a20dc71946f2efffc998c0,0,Henry Robinson,2015-01-27 22:33:25-08:00,['fd84ae2b9801dd4b3a07ebf9c2bc159b2ac64d55'],2,2,4,2801562,1,,,,2307
e1ac28c17110b6b680dfe9200474d1688c713618,0,jenkins,2015-01-28 15:28:13-08:00,['b1bbc2e15f27931682a20dc71946f2efffc998c0'],118,0,118,2801680,2,,,,2307
c2d07908c91f6b19e2bca097bd93c123a5b9322f,0,jenkins,2015-01-28 15:31:33-08:00,['e1ac28c17110b6b680dfe9200474d1688c713618'],6,6,12,2801692,2,,,,2307
5091929027ddfd71773094a6dd1a0dceca501a77,1,jenkins,2015-01-28 17:12:01-08:00,['c2d07908c91f6b19e2bca097bd93c123a5b9322f'],154,143,297,2801989,1,1,1,0.473684211,2307
706d2a46cf9bf6ca0e3698e49116a81608fbb81f,0,jenkins,2015-01-28 17:30:09-08:00,['5091929027ddfd71773094a6dd1a0dceca501a77'],0,3,3,2801992,1,,,,2307
0620896d65ce93eb9579cb402bd52a498e49aa4c,0,jenkins,2015-01-28 18:11:04-08:00,['706d2a46cf9bf6ca0e3698e49116a81608fbb81f'],44,51,95,2802087,3,0,0,1,2307
f5856ca7fc29908a7ef83959116248b16fa40e84,1,jenkins,2015-01-28 20:11:04-08:00,['0620896d65ce93eb9579cb402bd52a498e49aa4c'],9,102,111,2802198,9,0.764705882,0.764705882,0.941176471,2308
56b299c917a2575c16016a9899511607ad1c8d8d,1,jenkins,2015-01-29 12:54:01-08:00,['f5856ca7fc29908a7ef83959116248b16fa40e84'],68,68,136,2802334,5,,,,2308
d3f519a3d7b649a991aeb20256d22270232f4f95,0,jenkins,2015-01-30 15:40:18-08:00,['56b299c917a2575c16016a9899511607ad1c8d8d'],6,8,14,2802348,2,0,0.5,1,2308
461a5dc15d7d9c2543f2feba63329ba9e000af13,1,jenkins,2015-01-30 17:11:09-08:00,['d3f519a3d7b649a991aeb20256d22270232f4f95'],77,87,164,2802512,1,0,0,0,2308
762cae3fb91f27d81a0b27c88870afd95e30109a,0,jenkins,2015-01-30 19:55:54-08:00,['461a5dc15d7d9c2543f2feba63329ba9e000af13'],51,0,51,2802563,2,,,,2308
6602a0f82c780e5e1467eea65fc53bdc9f40a636,1,jenkins,2015-02-02 16:51:22-08:00,['762cae3fb91f27d81a0b27c88870afd95e30109a'],15,131,146,2802709,4,0.074626866,0.940298507,1,2309
3f5f5776871d1443f000b768472ccad3aec93e1d,0,jenkins,2015-02-02 17:47:07-08:00,['6602a0f82c780e5e1467eea65fc53bdc9f40a636'],4,4,8,2802717,1,0,0,1,2309
d3f71186d2c4a775faaa881cd38b6e7d395afaf7,0,jenkins,2015-02-02 18:16:40-08:00,['3f5f5776871d1443f000b768472ccad3aec93e1d'],1,43,44,2802761,2,0.166666667,0.966666667,1,2309
f59c062471f3b96e5df9386ff08076b5d86cd362,0,jenkins,2015-02-02 20:21:07-08:00,['d3f71186d2c4a775faaa881cd38b6e7d395afaf7'],5,45,50,2802811,2,0,0.846153846,0.846153846,2309
fb609d7a235eaa3b40141607606e9a0dd73610e0,1,jenkins,2015-02-02 21:07:40-08:00,['f59c062471f3b96e5df9386ff08076b5d86cd362'],73,64,137,2802948,5,1,0.777777778,0.222222222,2309
51e1343d1c8942b727f9e3e328b56456f94670e1,0,jenkins,2015-02-02 22:51:22-08:00,['fb609d7a235eaa3b40141607606e9a0dd73610e0'],0,5,5,2802953,2,0,0.25,1,2309
26386eb41dafb2997f3bba5c77dcf0762e8ff44f,0,jenkins,2015-02-03 00:41:12-08:00,['51e1343d1c8942b727f9e3e328b56456f94670e1'],1,92,93,2803046,5,0,1,1,2309
5ac46af78607df65e3c151cbe6240620836de472,0,jenkins,2015-02-03 00:51:49-08:00,['26386eb41dafb2997f3bba5c77dcf0762e8ff44f'],0,2,2,2803048,1,,,,2309
2386fb84a8108fc87509e5a066d8229afd733952,1,jenkins,2015-02-03 01:02:42-08:00,['5ac46af78607df65e3c151cbe6240620836de472'],93,193,286,2803334,13,,,,2309
fd09294b742797de3066630eb15d01e5f52bd587,1,jenkins,2015-02-03 01:49:55-08:00,['2386fb84a8108fc87509e5a066d8229afd733952'],319,330,649,2803983,31,0.178571429,0.214285714,0.142857143,2309
b01252267a2c858cb497d41652702a23b9ed233a,0,jenkins,2015-02-04 02:51:00-08:00,['fd09294b742797de3066630eb15d01e5f52bd587'],3,3,6,2803989,1,,,,2309
a7e95e09927bfb8fd5f2334bc230da2d95e4c27d,1,jenkins,2015-02-04 12:28:54-08:00,['b01252267a2c858cb497d41652702a23b9ed233a'],1,33,34,2804023,2,0,0,1,2309
5d652421648d0f5ebab9334ba79349b74bf1cfdf,1,jenkins,2015-02-06 03:26:19-08:00,['a7e95e09927bfb8fd5f2334bc230da2d95e4c27d'],114,188,302,2804325,7,0,0.35,0.9,2309
4c4c0ad4fc5c99215500576157765bd9000e8022,1,jenkins,2015-02-06 15:13:19-08:00,['5d652421648d0f5ebab9334ba79349b74bf1cfdf'],33,40,73,2804398,6,0.166666667,0.166666667,0,2309
7a017cf582b9c6203c8dcf10f6d1f6dd869c8705,1,jenkins,2015-02-06 15:44:24-08:00,['4c4c0ad4fc5c99215500576157765bd9000e8022'],10,75,85,2804483,2,0,0.34,1,2309
68ce04d4571b8fe6667cda8e3c28c9647230c3af,1,jenkins,2015-02-06 15:54:13-08:00,['7a017cf582b9c6203c8dcf10f6d1f6dd869c8705'],0,845,845,2805328,7,0.337301587,0.755952381,0.964285714,2315
dfd72cdcb54489b6161742e92aa49eef0a80693e,0,jenkins,2015-02-07 16:06:24-08:00,['68ce04d4571b8fe6667cda8e3c28c9647230c3af'],25,50,75,2805403,4,0,1,1,2315
9d38b67f83f0ba04def5c014f1fa05122305d557,0,Internal Jenkins,2015-02-11 00:54:16+00:00,['dfd72cdcb54489b6161742e92aa49eef0a80693e'],21,11,32,2805435,1,,,,2315
fdafbc57096d25c0bccac3cfe4191003a27586b9,1,Internal Jenkins,2015-02-11 03:35:46+00:00,['9d38b67f83f0ba04def5c014f1fa05122305d557'],28,195,223,2805658,6,0.447761194,0.492537313,1,2316
87b9fac2adda3deeca61b108c644d89b97394485,1,Internal Jenkins,2015-02-11 13:28:17+00:00,['fdafbc57096d25c0bccac3cfe4191003a27586b9'],8,190,198,2805856,8,0.166666667,0.833333333,0.9,2318
89ee1aa9ee7a1981604c46f876e03559045d4065,0,Alex Leblang,2015-02-12 02:49:53+00:00,['87b9fac2adda3deeca61b108c644d89b97394485'],0,1,1,2805857,1,,,,2319
2799f6c7378e6afcace219451999b5b74090ebb2,1,Alex Leblang,2015-02-12 03:39:40+00:00,['89ee1aa9ee7a1981604c46f876e03559045d4065'],1,1,2,2805859,1,,,,2319
42d82573fd5388aeb4867f0b791a2e6581e9ee63,0,ishaan,2015-02-12 09:43:04-08:00,['2799f6c7378e6afcace219451999b5b74090ebb2'],0,0,0,2805859,0,,,,2319
245a96b532326c9476aa73ee200dede3f95983a6,0,ishaan,2015-02-12 09:44:00-08:00,['42d82573fd5388aeb4867f0b791a2e6581e9ee63'],1,1,2,2805861,1,,,,2319
3127a5fe76214172c277db0e311558bc262c85bb,0,ishaan,2015-02-12 09:44:22-08:00,['245a96b532326c9476aa73ee200dede3f95983a6'],0,0,0,2805861,0,,,,2319
5028ef8aa85e5401f106b93fff555d5f5ec02e61,1,Internal Jenkins,2015-02-12 23:30:19+00:00,['3127a5fe76214172c277db0e311558bc262c85bb'],12,58,70,2805931,2,0,1,0,2319
b0c82693b1152112dd0237ccc861d18541122d2b,0,Internal Jenkins,2015-02-12 23:49:11+00:00,['5028ef8aa85e5401f106b93fff555d5f5ec02e61'],5,2,7,2805938,1,1,1,0,2319
511b41c235659b4c2fc2a3526c49ce7bc376b2b8,0,Internal Jenkins,2015-02-13 01:12:29+00:00,['b0c82693b1152112dd0237ccc861d18541122d2b'],1,1,2,2805940,1,,,,2319
110c629bea3a8aa71660503b7d851297a5d2c494,1,Internal Jenkins,2015-02-13 19:54:10+00:00,['511b41c235659b4c2fc2a3526c49ce7bc376b2b8'],559,642,1201,2807141,3,1,1,1,2321
835d6dbef48ee6a69c2c70e7312865810bbd996a,1,Internal Jenkins,2015-02-13 20:46:14+00:00,['110c629bea3a8aa71660503b7d851297a5d2c494'],7,130,137,2807278,9,,,,2324
5578c0668f6c5a5238a5777d3b5639d96b1f463a,0,Internal Jenkins,2015-02-14 00:54:22+00:00,['835d6dbef48ee6a69c2c70e7312865810bbd996a'],6,32,38,2807316,3,0.555555556,0.888888889,1,2324
60f6373a568489d9aa6fbd64e39758d6b46df1e4,0,Internal Jenkins,2015-02-14 03:07:25+00:00,['5578c0668f6c5a5238a5777d3b5639d96b1f463a'],13,61,74,2807390,3,0,1,1,2324
217b2517b91422d1aae33c2462f95ff3f1042647,0,Casey Ching,2015-02-15 22:16:16+00:00,['60f6373a568489d9aa6fbd64e39758d6b46df1e4'],0,0,0,2807390,0,,,,2324
dbc504fad116f8123b7742df55c0b454be96c27e,1,Internal Jenkins,2015-02-16 00:59:34+00:00,['217b2517b91422d1aae33c2462f95ff3f1042647'],47,59,106,2807496,5,0.142857143,1,1,2324
60f2d4c19fb3be210975416d24375a11a69189ac,1,Internal Jenkins,2015-02-18 00:00:46+00:00,['dbc504fad116f8123b7742df55c0b454be96c27e'],11,57,68,2807564,8,0.307692308,0,0.692307692,2325
30ecc686e94b5e5faf8a2617b9b8f594442a7917,0,Internal Jenkins,2015-02-19 00:47:46+00:00,['60f2d4c19fb3be210975416d24375a11a69189ac'],16,18,34,2807598,1,0,1,1,2325
63805fa4f2ee9b30f6901a77bc25b7c4b0878577,0,Internal Jenkins,2015-02-19 19:02:23+00:00,['30ecc686e94b5e5faf8a2617b9b8f594442a7917'],47,90,137,2807735,2,0.166666667,1,0.833333333,2325
ad6b9364c07c87ede8dbab77fb994f7a5db2c500,1,Internal Jenkins,2015-02-19 22:53:42+00:00,['63805fa4f2ee9b30f6901a77bc25b7c4b0878577'],3,170,173,2807908,6,0,0,1,2325
a7e4b9e878cfe29ee523e467052d35e3b5f19fe4,0,Internal Jenkins,2015-02-19 23:29:00+00:00,['ad6b9364c07c87ede8dbab77fb994f7a5db2c500'],13,45,58,2807966,2,0,0.290322581,1,2325
f3f4946c26a71d8a12283d1ec3961b60d806768a,0,Internal Jenkins,2015-02-20 02:35:10+00:00,['a7e4b9e878cfe29ee523e467052d35e3b5f19fe4'],42,58,100,2808066,3,0.526315789,1,0.789473684,2325
cc8c9cf0895ae39fe78bfd9f149781443a2098a4,1,Internal Jenkins,2015-02-20 03:00:27+00:00,['f3f4946c26a71d8a12283d1ec3961b60d806768a'],13,332,345,2808411,8,0.630769231,0.738461538,0.646153846,2326
0a0aa0085caef2c6c9c6d474cef0f7efd98f02c7,0,Internal Jenkins,2015-02-20 05:10:21+00:00,['cc8c9cf0895ae39fe78bfd9f149781443a2098a4'],0,2,2,2808413,2,0,0.5,0,2326
42fddae692f57e3edb846a0cf06bbb80d72d6e0b,1,Internal Jenkins,2015-02-20 09:16:58+00:00,['0a0aa0085caef2c6c9c6d474cef0f7efd98f02c7'],46,114,160,2808573,5,0.952380952,0,0.523809524,2326
b6ca4feb4fe1680c9882d0adbfaa4001ae84b2de,1,Internal Jenkins,2015-02-21 00:19:42+00:00,['42fddae692f57e3edb846a0cf06bbb80d72d6e0b'],18,32,50,2808623,2,0,1,0.888888889,2326
1c4cb3a68c45d977854601ede0cd411d4796f6a9,0,Internal Jenkins,2015-02-21 01:33:42+00:00,['b6ca4feb4fe1680c9882d0adbfaa4001ae84b2de'],26,175,201,2808824,4,0.311926606,0.862385321,1,2326
1a2cd25ae858c68953a476d215a634176c5aedb0,1,Internal Jenkins,2015-02-21 02:50:00+00:00,['1c4cb3a68c45d977854601ede0cd411d4796f6a9'],48,454,502,2809326,11,0,0.822916667,0,2331
0565bd6416154e3e10fd12b98b161c366b9cbe06,1,Internal Jenkins,2015-02-21 02:50:35+00:00,['1a2cd25ae858c68953a476d215a634176c5aedb0'],10,6,16,2809342,2,0,0,0,2331
f24f72f02e502e0f2fb9d9507e84bd7e3decea5f,0,Henry Robinson,2015-02-21 03:40:09+00:00,['0565bd6416154e3e10fd12b98b161c366b9cbe06'],0,0,0,2809342,2,1,0.923355025,0.903832249,2333
bc6299730fd59f0d4293a84269ff6a435d1ea91d,0,Internal Jenkins,2015-02-23 21:39:51+00:00,['f24f72f02e502e0f2fb9d9507e84bd7e3decea5f'],4,6,10,2809352,1,,,,2333
6dd01e957333d84801b66cc42a399ba26bc9d8f1,0,Internal Jenkins,2015-02-23 21:50:27+00:00,['bc6299730fd59f0d4293a84269ff6a435d1ea91d'],2,19,21,2809373,2,1,1,1,2333
8369c3b13b883cd2fa0e2c335c9ca0dff42622b2,1,Internal Jenkins,2015-02-23 23:32:41+00:00,['6dd01e957333d84801b66cc42a399ba26bc9d8f1'],457,506,963,2810336,23,1,0.53125,1,2342
ffd124b48ef394b94f449aad71cc8695e4c09116,1,Internal Jenkins,2015-02-24 00:10:35+00:00,['8369c3b13b883cd2fa0e2c335c9ca0dff42622b2'],3,90,93,2810429,2,0,0,0,2342
11cd7d1d4685e1d801476f67b62e8854cdd9886f,0,Internal Jenkins,2015-02-24 01:43:28+00:00,['ffd124b48ef394b94f449aad71cc8695e4c09116'],7,61,68,2810497,22,0,0,1,2342
6ba9a3845e66341870975c5643800fa7310f9887,0,ishaan,2015-02-23 20:27:10-08:00,['11cd7d1d4685e1d801476f67b62e8854cdd9886f'],0,0,0,2810497,0,,,,2342
18f84c0e07534baef618ce71c6a0227a335bb408,0,ishaan,2015-02-23 20:27:12-08:00,['6ba9a3845e66341870975c5643800fa7310f9887'],1,1,2,2810499,1,,,,2342
21d24f5295892a06056ec1697b1bdc64e203e079,1,ishaan,2015-02-23 20:27:13-08:00,['18f84c0e07534baef618ce71c6a0227a335bb408'],1,18,19,2810518,3,,,,2342
b47d50d263a83fbbdce4b8b6016ac313e89506e2,0,Internal Jenkins,2015-02-24 10:01:03+00:00,['21d24f5295892a06056ec1697b1bdc64e203e079'],11,15,26,2810544,4,1,0.333333333,1,2342
37ca6b81ae4ecf674428205da25440ac56c64bcd,0,Internal Jenkins,2015-02-24 10:55:22+00:00,['b47d50d263a83fbbdce4b8b6016ac313e89506e2'],2,118,120,2810664,4,0.49122807,1,1,2344
2d3725d000abf9ba6a1faab27d3f65f47aab58af,0,Internal Jenkins,2015-02-24 20:18:23+00:00,['37ca6b81ae4ecf674428205da25440ac56c64bcd'],20,169,189,2810853,3,0.131578947,0.710526316,0.763157895,2345
82aa2ccd1d6b97a261df91ffc01ecbf4209b4f50,1,Internal Jenkins,2015-02-24 20:40:26+00:00,['2d3725d000abf9ba6a1faab27d3f65f47aab58af'],31,33,64,2810917,2,0,0,0,2345
67b5317bf79c5b99f2cda310f9c6a53974105ba1,0,Internal Jenkins,2015-02-25 01:50:25+00:00,['82aa2ccd1d6b97a261df91ffc01ecbf4209b4f50'],18,132,150,2811067,3,0,0.739130435,1,2345
de907905a52f23008689650db77bc5ce8a017738,0,Internal Jenkins,2015-02-25 02:20:37+00:00,['67b5317bf79c5b99f2cda310f9c6a53974105ba1'],9,7,16,2811083,4,,,,2345
57c7838fceb2ae038975fdc2289c160d956ce1cb,0,Internal Jenkins,2015-02-25 02:42:20+00:00,['de907905a52f23008689650db77bc5ce8a017738'],0,0,0,2811083,0,,,,2345
5680ddf9dd6b0257b653f0a2203d7e95bf9c2359,1,Internal Jenkins,2015-02-25 05:24:18+00:00,['57c7838fceb2ae038975fdc2289c160d956ce1cb'],8,72,80,2811163,5,0.815789474,0.842105263,1,2345
04e8b32df52bfa1b7c4bd2f05fa7c346e94319c4,0,Internal Jenkins,2015-02-25 20:40:16+00:00,['5680ddf9dd6b0257b653f0a2203d7e95bf9c2359'],6,56,62,2811225,2,0,0.733333333,1,2345
ae98febcc2f97f3d8ef9fd1b6b958fcd22e8be9a,0,Internal Jenkins,2015-02-25 20:40:34+00:00,['04e8b32df52bfa1b7c4bd2f05fa7c346e94319c4'],2,2,4,2811229,1,,,,2345
49fb6f776b3ad38f23c253b8f7aa55e4d11cb14e,0,Internal Jenkins,2015-02-25 22:59:37+00:00,['ae98febcc2f97f3d8ef9fd1b6b958fcd22e8be9a'],10,29,39,2811268,2,1,1,1,2345
1354a842e227f239a66a85711c3539601a8b5e23,1,Internal Jenkins,2015-02-25 23:01:31+00:00,['49fb6f776b3ad38f23c253b8f7aa55e4d11cb14e'],37,219,256,2811524,3,0.175438596,1,0.912280702,2345
289a5ad9b3339f2b27ffdcf78a01e5e8e39117d3,0,Internal Jenkins,2015-02-25 23:07:34+00:00,['1354a842e227f239a66a85711c3539601a8b5e23'],1,1,2,2811526,1,,,,2345
71c5ec7af536cde87537872d2d9dd3c1b1fae6f3,0,Internal Jenkins,2015-02-25 23:50:59+00:00,['289a5ad9b3339f2b27ffdcf78a01e5e8e39117d3'],95,2907,3002,2814528,58,0.758801498,0.97752809,0.9917603,2377
d2dcda5421c9d6263bdba743e4d6cf535a91e72d,1,Internal Jenkins,2015-02-26 00:19:25+00:00,['71c5ec7af536cde87537872d2d9dd3c1b1fae6f3'],185,346,531,2815059,18,0.705882353,0.5,1,2377
60b3fd253d379606b90049c367c8525cecbb7758,0,Internal Jenkins,2015-02-26 01:04:28+00:00,['d2dcda5421c9d6263bdba743e4d6cf535a91e72d'],1,5,6,2815065,3,,,,2377
c935ba56d43555fc1965559edecb2b6660e24351,1,Internal Jenkins,2015-02-26 03:05:28+00:00,['60b3fd253d379606b90049c367c8525cecbb7758'],0,11,11,2815076,1,0,0,0,2377
66d338c27afb9f971aaf833408a83608a5303af5,0,ishaan,2015-02-25 19:58:53-08:00,['c935ba56d43555fc1965559edecb2b6660e24351'],0,0,0,2815076,0,,,,2377
aa65f3de45cb416d4a27ec823ce77ae8182754f4,0,ishaan,2015-02-25 19:58:56-08:00,['66d338c27afb9f971aaf833408a83608a5303af5'],1,1,2,2815078,1,,,,2377
ad0d723170064d57903b869d3ef417f101fefe73,1,ishaan,2015-02-25 23:13:11-08:00,['aa65f3de45cb416d4a27ec823ce77ae8182754f4'],21,21,42,2815120,2,,,,2377
57b004713948fe3de78998f1c73be313ea91db11,0,Casey Ching,2015-02-26 18:21:17+00:00,['ad0d723170064d57903b869d3ef417f101fefe73'],0,6,6,2815126,1,,,,2377
2ed804f16cd3ebc804f060d002e075243a4fcb02,1,Internal Jenkins,2015-02-26 21:33:38+00:00,['57b004713948fe3de78998f1c73be313ea91db11'],7,8,15,2815141,1,0,1,1,2377
43311a66469e6d1b655fac16952a96f474cbdfe1,1,Internal Jenkins,2015-02-27 03:08:19+00:00,['2ed804f16cd3ebc804f060d002e075243a4fcb02'],10,9,19,2815160,2,0,0,1,2377
554f1f779bed17e2bf2cc7b4e435aa9b504d0fce,0,Internal Jenkins,2015-02-27 03:17:28+00:00,['43311a66469e6d1b655fac16952a96f474cbdfe1'],2,11,13,2815173,3,1,1,1,2377
1253b74c7e5adf0c759950418eba9ddf32cf6b7d,1,Internal Jenkins,2015-02-27 03:58:42+00:00,['554f1f779bed17e2bf2cc7b4e435aa9b504d0fce'],97,159,256,2815429,8,1,1,0.694444444,2377
cdc1ce055e0e0bc27e8b0e3ec2f4eac8f36aa71b,0,Internal Jenkins,2015-02-27 07:01:49+00:00,['1253b74c7e5adf0c759950418eba9ddf32cf6b7d'],5,23,28,2815457,2,0,1,0,2377
3852155feb3f8e2652f55262b709267d8bef5891,1,Internal Jenkins,2015-02-27 11:30:13+00:00,['cdc1ce055e0e0bc27e8b0e3ec2f4eac8f36aa71b'],59,4386,4445,2819902,31,0.476357268,0.712784588,0.795096322,2379
99d3caacb71d5af3ea83048ec4ea6e122de07c77,0,Internal Jenkins,2015-02-27 18:48:56+00:00,['3852155feb3f8e2652f55262b709267d8bef5891'],4,81,85,2819987,5,0.75,0.75,0.75,2382
0ede651685a61943f2ecf0a1e594538fc039ceee,1,Internal Jenkins,2015-02-27 22:07:56+00:00,['99d3caacb71d5af3ea83048ec4ea6e122de07c77'],49,20,69,2820056,4,1,0,0,2382
d58aedff420251eb5612f36ea5a450931c0708bf,1,Internal Jenkins,2015-02-28 00:42:04+00:00,['0ede651685a61943f2ecf0a1e594538fc039ceee'],147,240,387,2820443,12,0.523809524,0,0.396825397,2382
36937dac04e67e108535ec60930139efeda3e316,1,Internal Jenkins,2015-02-28 03:09:01+00:00,['d58aedff420251eb5612f36ea5a450931c0708bf'],10,41,51,2820494,2,0,1,0,2382
95ba2f13397ca853be97dc255feab487f6100c4a,0,Internal Jenkins,2015-02-28 03:45:33+00:00,['36937dac04e67e108535ec60930139efeda3e316'],0,6,6,2820500,1,,,,2382
d51737d8d94836ce3e4dffa1e4532b9c04fcc430,0,Internal Jenkins,2015-02-28 03:46:36+00:00,['95ba2f13397ca853be97dc255feab487f6100c4a'],1,1,2,2820502,1,,,,2382
296d1bba2f55418e5b9a6d5e6eb459baa8b6926f,0,Internal Jenkins,2015-02-28 05:01:15+00:00,['d51737d8d94836ce3e4dffa1e4532b9c04fcc430'],2,20,22,2820524,2,0,0,1,2382
b582cdc22b757e929016beed795b9a5d4eff6f59,1,Internal Jenkins,2015-03-01 03:37:32+00:00,['296d1bba2f55418e5b9a6d5e6eb459baa8b6926f'],598,1257,1855,2822379,93,0.990825688,1,0.504587156,2384
3aa90ca2e0d5695ce07bbd8c64bb6336242d48ea,1,Internal Jenkins,2015-03-01 08:15:26+00:00,['b582cdc22b757e929016beed795b9a5d4eff6f59'],40,171,211,2822590,12,0.632653061,0.653061224,0,2385
e02a38fa3296533be2cee23ede57237fee04db08,0,ishaan,2015-03-01 09:21:14-08:00,['3aa90ca2e0d5695ce07bbd8c64bb6336242d48ea'],1,4,5,2822595,1,,,,2385
e89cccb7b4e5075fe65834b7263ae8527bd97116,1,Internal Jenkins,2015-03-01 22:36:27+00:00,['e02a38fa3296533be2cee23ede57237fee04db08'],23,45,68,2822663,2,1,1,0.928571429,2385
a83a9beb87f58d7799b9901f283b23f9f77bcc03,0,Internal Jenkins,2015-03-02 22:31:58+00:00,['e89cccb7b4e5075fe65834b7263ae8527bd97116'],1,1,2,2822665,1,,,,2385
99219488d72d48e98324b7707fb83246e859ee64,1,Internal Jenkins,2015-03-03 05:44:55+00:00,['a83a9beb87f58d7799b9901f283b23f9f77bcc03'],26,65,91,2822756,3,0,0,1,2385
c8fb10f50a140eb33bbb2b2578a0c78614df0850,1,Internal Jenkins,2015-03-03 08:29:13+00:00,['99219488d72d48e98324b7707fb83246e859ee64'],63,142,205,2822961,25,0,0,0,2386
8c30332237fb6d5a946b80e5fed923e80d064d15,1,Internal Jenkins,2015-03-03 09:09:49+00:00,['c8fb10f50a140eb33bbb2b2578a0c78614df0850'],181,261,442,2823403,9,0.955555556,0.333333333,1,2386
cad29c7abeb62ee59d1df9c42c6667d08c0f6356,1,Internal Jenkins,2015-03-03 17:52:30+00:00,['8c30332237fb6d5a946b80e5fed923e80d064d15'],12,138,150,2823553,7,0.652173913,0.884057971,0.797101449,2387
d2988f8b11fd911462fe1bbb5efb16cb5889dea6,1,Internal Jenkins,2015-03-04 03:23:03+00:00,['cad29c7abeb62ee59d1df9c42c6667d08c0f6356'],29,50,79,2823632,8,0.9,0,0.9,2387
0c8022b9bc683cfe4e31f20aa2fca0149d0def87,1,Internal Jenkins,2015-03-04 05:22:53+00:00,['d2988f8b11fd911462fe1bbb5efb16cb5889dea6'],2,31,33,2823665,4,0.6,0.6,1,2387
a51902090852e382a390772edde969de162297f2,0,Internal Jenkins,2015-03-04 10:15:50+00:00,['0c8022b9bc683cfe4e31f20aa2fca0149d0def87'],5,4,9,2823674,3,0,0,0,2387
bcd4c1de2120c532ca9803a2241d39826d87f8f8,1,Internal Jenkins,2015-03-04 21:09:06+00:00,['a51902090852e382a390772edde969de162297f2'],0,307,307,2823981,4,0.070175439,1,1,2387
a51c2e60ab223709706f28146632d6118c7c2c83,0,Internal Jenkins,2015-03-05 02:43:22+00:00,['bcd4c1de2120c532ca9803a2241d39826d87f8f8'],1,1,2,2823983,1,,,,2387
27209e4cb18dce4f072f5e0786658539243ab880,0,Internal Jenkins,2015-03-05 03:05:49+00:00,['a51c2e60ab223709706f28146632d6118c7c2c83'],16,32,48,2824031,2,,,,2387
970a9d7b838f0414759b47eb2b08b702b3874c61,1,Internal Jenkins,2015-03-05 04:57:41+00:00,['27209e4cb18dce4f072f5e0786658539243ab880'],71,116,187,2824218,8,0.857142857,1,1,2388
16792b28beeeec33f7bb1964d3a3a5ecb929625e,1,Internal Jenkins,2015-03-05 05:13:50+00:00,['970a9d7b838f0414759b47eb2b08b702b3874c61'],3,299,302,2824520,15,0.340425532,0.921985816,1,2389
b1aee3475924fd1c0e1e580f3da7000a83dab074,0,Internal Jenkins,2015-03-05 06:25:13+00:00,['16792b28beeeec33f7bb1964d3a3a5ecb929625e'],6,9,15,2824535,1,1,1,1,2389
b46e8001ef902c6cd963ab6971598907a91c343e,1,Internal Jenkins,2015-03-05 09:12:46+00:00,['b1aee3475924fd1c0e1e580f3da7000a83dab074'],17,32,49,2824584,10,0.8,1,1,2389
4a9adfd68543d72bef9d44343fb892a6e4c2aa02,1,Internal Jenkins,2015-03-05 09:52:34+00:00,['b46e8001ef902c6cd963ab6971598907a91c343e'],2,2,4,2824588,1,,,,2389
41e3b6b61ea04c182f074187b299edd7713ab028,1,Internal Jenkins,2015-03-05 18:16:45+00:00,['4a9adfd68543d72bef9d44343fb892a6e4c2aa02'],13,432,445,2825033,4,0.5,0.5,0.5,2390
e9773135b3a68b96cf9d63586c34d0a27e8627ce,0,Internal Jenkins,2015-03-05 18:20:34+00:00,['41e3b6b61ea04c182f074187b299edd7713ab028'],1,1,2,2825035,1,,,,2390
146fe64a2692199d7ca326e7eff3f50879ec5e05,0,Internal Jenkins,2015-03-05 20:22:49+00:00,['e9773135b3a68b96cf9d63586c34d0a27e8627ce'],4,2,6,2825041,2,1,0,0,2390
7a65373d5cc2f849e7d45a2cf70a18fbf4f6beb7,0,Internal Jenkins,2015-03-06 07:44:33+00:00,['146fe64a2692199d7ca326e7eff3f50879ec5e05'],2,13,15,2825056,2,0,0.2,1,2390
92d79d2cc78458500e6f7b99fe9abebfa2eefbac,0,ishaan,2015-03-06 16:47:37-08:00,['7a65373d5cc2f849e7d45a2cf70a18fbf4f6beb7'],1,1,2,2825058,1,,,,2390
4282e20f29b7ffa163d27376286615201392559a,0,ishaan,2015-03-06 16:47:37-08:00,['92d79d2cc78458500e6f7b99fe9abebfa2eefbac'],3,17,20,2825078,2,0.2,0.2,1,2390
99cb338b112b89c896ea59c0461d7e3c15f69385,1,ishaan,2015-03-06 16:47:37-08:00,['4282e20f29b7ffa163d27376286615201392559a'],15,302,317,2825395,4,0.695035461,1,0.595744681,2391
e5d2453e8de7a9008c5b52b4397d6aa36f13bba1,0,ishaan,2015-03-06 16:47:37-08:00,['99cb338b112b89c896ea59c0461d7e3c15f69385'],1,6,7,2825402,1,,,,2391
251991b68dfcaaa3a303d5139633e86108333d12,0,ishaan,2015-03-06 16:47:37-08:00,['e5d2453e8de7a9008c5b52b4397d6aa36f13bba1'],3,5,8,2825410,3,0.5,1,0,2391
e05e57c45222c5d0f25f289bb5a58598ef7ed31e,1,ishaan,2015-03-06 16:47:37-08:00,['251991b68dfcaaa3a303d5139633e86108333d12'],16,29,45,2825455,1,0,0,1,2391
209983cae649b7f880ebe013f46b3ef12ddbf8f9,0,ishaan,2015-03-06 16:47:37-08:00,['e05e57c45222c5d0f25f289bb5a58598ef7ed31e'],2,3,5,2825460,1,,,,2391
b797f8c4848f903deac61192f44c1db0ef4eb76f,0,ishaan,2015-03-06 16:47:37-08:00,['209983cae649b7f880ebe013f46b3ef12ddbf8f9'],6,5,11,2825471,6,0,,,2391
a2c3abf0e0efbea636a56783ce0c8884ee0ddd0c,0,ishaan,2015-03-06 16:47:37-08:00,['b797f8c4848f903deac61192f44c1db0ef4eb76f'],17,180,197,2825668,4,0.523809524,1,1,2391
40ae95ccfd1dc7bea528241e8d38b916094d2771,0,ishaan,2015-03-06 16:47:38-08:00,['a2c3abf0e0efbea636a56783ce0c8884ee0ddd0c'],8,0,8,2825676,1,1,0,0,2391
9d76d5898e0afa58778fe1ae803f07be58a2de21,0,ishaan,2015-03-06 16:53:27-08:00,['40ae95ccfd1dc7bea528241e8d38b916094d2771'],1,1,2,2825678,1,,,,2391
01444cd045aaa007304a2f2c79c69b08a0a03ee3,0,Henry Robinson,2015-03-07 01:09:35+00:00,['9d76d5898e0afa58778fe1ae803f07be58a2de21'],0,0,0,2825678,0,,,,2391
c88d17941363a23cc190611925d4c0d3015df61a,1,Internal Jenkins,2015-03-07 09:51:27+00:00,['01444cd045aaa007304a2f2c79c69b08a0a03ee3'],37,83,120,2825798,4,0.333333333,0.333333333,1,2391
7615ec9b985824c4debf626e9c01e1ac2469117c,0,Alex Behm,2015-03-07 19:09:58+00:00,['c88d17941363a23cc190611925d4c0d3015df61a'],21,21,42,2825840,1,,,,2391
d04f1909739b2c40f5c8be62ddabbfea9205f516,0,Internal Jenkins,2015-03-10 19:41:32+00:00,['7615ec9b985824c4debf626e9c01e1ac2469117c'],4,74,78,2825918,2,0,0,0,2391
3b27c691d7c04d4908ed2d8d61eeda3a3c597c9b,1,Internal Jenkins,2015-03-11 00:35:33+00:00,['d04f1909739b2c40f5c8be62ddabbfea9205f516'],1,6,7,2825925,2,0.25,1,1,2391
d4d89cb7ac5c8fe9f934f004bd7ecc3a5f71f777,1,Internal Jenkins,2015-03-11 20:22:47+00:00,['3b27c691d7c04d4908ed2d8d61eeda3a3c597c9b'],5,4,9,2825934,1,,,,2391
7216d09fe7c1a1c9f21bed6e0b08315eb87b0315,1,ishaan,2015-03-11 16:39:37-07:00,['d4d89cb7ac5c8fe9f934f004bd7ecc3a5f71f777'],61,92,153,2826087,3,1,0,1,2391
be15b41fc938edf8d86ab57ba0b6182c2527253b,0,ishaan,2015-03-11 16:39:38-07:00,['7216d09fe7c1a1c9f21bed6e0b08315eb87b0315'],1,1,2,2826089,1,,,,2391
1de6618bbd3b12a25896e2cced16819fadcfb0e4,0,ishaan,2015-03-11 16:39:38-07:00,['be15b41fc938edf8d86ab57ba0b6182c2527253b'],10,32,42,2826131,7,0.5,1,0.5,2391
5aa8195534986ccc91e3ba018ce13e257b292b53,1,ishaan,2015-03-11 16:39:38-07:00,['1de6618bbd3b12a25896e2cced16819fadcfb0e4'],0,360,360,2826491,3,1,1,1,2393
adb19deecebd39753447bd0b66c4f8ca4c873ca6,1,ishaan,2015-03-11 16:39:38-07:00,['5aa8195534986ccc91e3ba018ce13e257b292b53'],27,55,82,2826573,4,0,1,1,2393
73a47167f7852c55e11b9fc9d87c7e4324085572,1,ishaan,2015-03-11 16:39:38-07:00,['adb19deecebd39753447bd0b66c4f8ca4c873ca6'],11,44,55,2826628,2,0.586206897,0,0.586206897,2393
291613228367384dc48dedb553c380103aea7977,1,ishaan,2015-03-11 16:39:39-07:00,['73a47167f7852c55e11b9fc9d87c7e4324085572'],67,73,140,2826768,10,0,1,0.666666667,2393
25b54eac1e98520249304f5b8d94194e10b4000b,0,ishaan,2015-03-11 16:39:39-07:00,['291613228367384dc48dedb553c380103aea7977'],10,10,20,2826788,1,,,,2393
32f644820d94027ed804945dc0a7b99e0a5329f2,1,ishaan,2015-03-11 16:39:39-07:00,['25b54eac1e98520249304f5b8d94194e10b4000b'],1,31,32,2826820,2,,,,2393
6df2d92f783ab43aca7e96b5218444f94d04c159,1,ishaan,2015-03-11 16:39:39-07:00,['32f644820d94027ed804945dc0a7b99e0a5329f2'],3,3,6,2826826,1,,,,2393
65692e712544c2eb9792a479acf950bb15ee79da,0,ishaan,2015-03-11 16:39:39-07:00,['6df2d92f783ab43aca7e96b5218444f94d04c159'],1,2,3,2826829,1,,,,2393
7fe06d264fbcef3766c1369eceb37a8c19402686,1,ishaan,2015-03-11 16:39:39-07:00,['65692e712544c2eb9792a479acf950bb15ee79da'],2,3,5,2826834,1,1,1,1,2393
66295a855494ff52b1a2f2be3a60789c5d2618d1,0,ishaan,2015-03-11 16:39:39-07:00,['7fe06d264fbcef3766c1369eceb37a8c19402686'],54,59,113,2826947,3,0,1,0,2393
e36c436fa6a53cdefc5d5b6c29b4abb153748954,1,ishaan,2015-03-11 16:39:40-07:00,['66295a855494ff52b1a2f2be3a60789c5d2618d1'],3,101,104,2827051,3,,,,2393
7558a4752b37502bf511cb75b9afaa15251d1aa4,1,ishaan,2015-03-11 16:39:40-07:00,['e36c436fa6a53cdefc5d5b6c29b4abb153748954'],26,27,53,2827104,7,,,,2393
b318b82f06e41b117538745c5480664b2fcb7218,1,ishaan,2015-03-11 16:39:40-07:00,['7558a4752b37502bf511cb75b9afaa15251d1aa4'],0,5,5,2827109,2,,,,2393
6355225aafc0f869343853d47c80c9c76768c82b,1,ishaan,2015-03-11 16:39:40-07:00,['b318b82f06e41b117538745c5480664b2fcb7218'],33,79,112,2827221,4,0.172413793,1,0,2393
3f0dd5628f2e0a1c78032e4b4a041d6245e0252d,0,ishaan,2015-03-11 16:39:40-07:00,['6355225aafc0f869343853d47c80c9c76768c82b'],2,9,11,2827232,6,,,,2393
e2e0df93db273886a6ccf6c3f4800940ed52da03,1,ishaan,2015-03-11 19:58:58-07:00,['3f0dd5628f2e0a1c78032e4b4a041d6245e0252d'],57,12,69,2827301,5,1,1,1,2393
745e64a096bf395436ace85a623b7dde4a686ce1,1,ishaan,2015-03-11 19:58:58-07:00,['e2e0df93db273886a6ccf6c3f4800940ed52da03'],4,43,47,2827348,3,1,1,1,2393
3a280b1644001ca2f8e5f71ac283356777655795,1,ishaan,2015-03-12 17:49:55-07:00,['745e64a096bf395436ace85a623b7dde4a686ce1'],29,25,54,2827402,2,0.285714286,0.714285714,0,2393
73d7ab11e1ee91bf8bb1ad0f37469a5d8d07ead6,1,ishaan,2015-03-12 17:49:55-07:00,['3a280b1644001ca2f8e5f71ac283356777655795'],18,9,27,2827429,2,0,0,0,2393
199f673a2c39d87ff1f5e968a3bca2c95d1d47d3,0,ishaan,2015-03-13 11:21:54-07:00,['73d7ab11e1ee91bf8bb1ad0f37469a5d8d07ead6'],0,0,0,2827429,0,,,,2393
548309dfb4b36b2a8119d1c6028b27a62566f905,0,ishaan,2015-03-13 12:15:42-07:00,['199f673a2c39d87ff1f5e968a3bca2c95d1d47d3'],6,6,12,2827441,1,,,,2393
bb40f4a7abca9a11703610a3e9480346ed2fcfe1,1,ishaan,2015-03-16 18:33:08-07:00,['548309dfb4b36b2a8119d1c6028b27a62566f905'],4,14,18,2827459,2,1,1,1,2393
01f457c14f4101ccb1b8c1f86e85ee5d8461b28f,0,ishaan,2015-03-16 18:33:15-07:00,['bb40f4a7abca9a11703610a3e9480346ed2fcfe1'],1,6,7,2827466,1,0,0,1,2393
926cf4f6f9ae4eca5c3998dbdbdff1c19cd2c3e0,1,ishaan,2015-03-16 18:33:23-07:00,['01f457c14f4101ccb1b8c1f86e85ee5d8461b28f'],17,3,20,2827486,2,0.8,0.8,0,2393
a9ddda251760a4ac106e92ed6b2d416db4787272,1,ishaan,2015-03-16 18:33:30-07:00,['926cf4f6f9ae4eca5c3998dbdbdff1c19cd2c3e0'],142,721,863,2828349,10,0.28,0.536,1,2394
af55dc109c24b9ea593b4197c9c4132727c1a4ac,1,ishaan,2015-03-16 18:33:38-07:00,['a9ddda251760a4ac106e92ed6b2d416db4787272'],1,2,3,2828352,2,0,1,1,2394
eccab6465222620221aa6bfd495be3507ebaa561,1,ishaan,2015-03-16 18:33:45-07:00,['af55dc109c24b9ea593b4197c9c4132727c1a4ac'],48,69,117,2828469,10,,,,2395
b54d95bc1e3f38c947c36fa0e3ed4a3167294570,1,ishaan,2015-03-16 18:33:54-07:00,['eccab6465222620221aa6bfd495be3507ebaa561'],2,2,4,2828473,1,,,,2395
0c5143c35386a56f1a0aa9d1b373fe07d5bac345,1,ishaan,2015-03-16 20:03:42-07:00,['b54d95bc1e3f38c947c36fa0e3ed4a3167294570'],105,130,235,2828708,3,1,0.3,0.5,2395
8b4a748d5e17269683cb95678fcdd6a50cd5cb94,1,ishaan,2015-03-20 14:37:14-07:00,['0c5143c35386a56f1a0aa9d1b373fe07d5bac345'],37,109,146,2828854,6,1,0.777777778,0,2395
95b067a157383b0f7e32c0018fa127b5d6390af4,1,ishaan,2015-03-20 14:37:14-07:00,['8b4a748d5e17269683cb95678fcdd6a50cd5cb94'],34,52,86,2828940,3,0,0.1,1,2395
bef6f62f9dce5265901c18cca25a9a791c3e5f34,1,ishaan,2015-03-20 14:37:15-07:00,['95b067a157383b0f7e32c0018fa127b5d6390af4'],1,4,5,2828945,2,1,1,1,2395
6284db9bd557048ea3b22d386ccb0f1cf2f94e1f,1,ishaan,2015-03-20 14:37:16-07:00,['bef6f62f9dce5265901c18cca25a9a791c3e5f34'],14,15,29,2828974,3,1,0.5,0,2395
af91e13711a6c98bd39087f47a98b7ca1042a36c,1,ishaan,2015-03-20 14:37:17-07:00,['6284db9bd557048ea3b22d386ccb0f1cf2f94e1f'],1,3,4,2828978,1,0,0,1,2395
5118c55a0a272e0fb236abd91e21c7ff986c2d03,1,ishaan,2015-03-20 14:37:18-07:00,['af91e13711a6c98bd39087f47a98b7ca1042a36c'],15,64,79,2829057,5,0.157894737,1,0,2395
e8527ddb8ef4c5734870135984d3c6dd4dc42411,0,ishaan,2015-03-20 14:37:19-07:00,['5118c55a0a272e0fb236abd91e21c7ff986c2d03'],27,59,86,2829143,3,0,0,1,2395
7101462eb0eaed2d7a967a3a2242a3de1583410f,0,ishaan,2015-03-20 14:37:20-07:00,['e8527ddb8ef4c5734870135984d3c6dd4dc42411'],0,3,3,2829146,2,1,1,0,2395
daf9dfd6e16185dd2c71fab161417bcfb25b7d50,0,ishaan,2015-03-20 14:37:21-07:00,['7101462eb0eaed2d7a967a3a2242a3de1583410f'],1,1,2,2829148,1,,,,2395
cee329b7603676fa5b5395a5c0e13a9dbc4666ac,0,ishaan,2015-03-20 14:37:22-07:00,['daf9dfd6e16185dd2c71fab161417bcfb25b7d50'],1,0,1,2829149,1,0,0,0,2395
9d6586cdb83399bda2188a7e0170067163883435,1,ishaan,2015-03-20 14:37:23-07:00,['cee329b7603676fa5b5395a5c0e13a9dbc4666ac'],148,241,389,2829538,7,0.314285714,1,0.771428571,2395
d87f83083c92ab121d6c3842935ca4014c1f9910,0,ishaan,2015-03-20 19:58:50-07:00,['9d6586cdb83399bda2188a7e0170067163883435'],1,1,2,2829540,1,,,,2395
9d4da588181dc7396042cf98ac180a48e6bf3222,0,ishaan,2015-03-20 19:58:50-07:00,['d87f83083c92ab121d6c3842935ca4014c1f9910'],17,58,75,2829615,6,0.066666667,1,1,2395
26a5e1ffa465626d3dd76cb05ca891ac1f546336,1,ishaan,2015-03-20 19:58:50-07:00,['9d4da588181dc7396042cf98ac180a48e6bf3222'],2,7,9,2829624,1,0,1,1,2395
e121bc9b0a4374cbdbad85b99dbcc74eb6e224cc,1,ishaan,2015-03-20 19:58:50-07:00,['26a5e1ffa465626d3dd76cb05ca891ac1f546336'],15,255,270,2829894,12,0.75,0.75,0.477272727,2398
bd3b81a99b45aff93a02ded7b3904034a6c3f3b2,0,Henry Robinson,2015-03-23 20:19:10+00:00,['e121bc9b0a4374cbdbad85b99dbcc74eb6e224cc'],0,26,26,2829920,1,,,,2399
1addd2ce8c5cf8872f03c9ba29832d8c3f7cb273,0,Henry Robinson,2015-03-23 20:32:23+00:00,['bd3b81a99b45aff93a02ded7b3904034a6c3f3b2'],7,7,14,2829934,1,,,,2399
90bc481be761c518e16f4133950be620f7cd69f3,1,ishaan,2015-03-23 14:15:53-07:00,['1addd2ce8c5cf8872f03c9ba29832d8c3f7cb273'],1,1,2,2829936,1,,,,2399
b20a21c671dccf174d2439403f6b13767566a077,1,Internal Jenkins,2015-03-24 00:20:31+00:00,['90bc481be761c518e16f4133950be620f7cd69f3'],1,4,5,2829941,1,0,0,1,2399
16200b5fe9f5cc4e46e264bd3b4efae7c0d0051d,0,Internal Jenkins,2015-03-24 00:31:10+00:00,['b20a21c671dccf174d2439403f6b13767566a077'],2,119,121,2830062,1,0.126582278,1,1,2399
b1fc5d6c40bfc6c3fb8e1c7ccde476d0a5bbd7e6,1,Internal Jenkins,2015-03-24 20:43:39+00:00,['16200b5fe9f5cc4e46e264bd3b4efae7c0d0051d'],101,167,268,2830330,5,1,1,0,2399
3a7ed7c59e8fcf19808fc94778a87b7e26f3448a,1,Internal Jenkins,2015-03-25 00:05:39+00:00,['b1fc5d6c40bfc6c3fb8e1c7ccde476d0a5bbd7e6'],40,567,607,2830937,9,0,0,0.882352941,2399
7442f7a5aeaa66bc537ceced862e595322a1cd69,0,Internal Jenkins,2015-03-25 20:25:54+00:00,['3a7ed7c59e8fcf19808fc94778a87b7e26f3448a'],0,6,6,2830943,2,,,,2399
f4f4e0bf223d6c16193b91ba4acbbdbeb70efc52,1,Internal Jenkins,2015-03-25 21:41:37+00:00,['7442f7a5aeaa66bc537ceced862e595322a1cd69'],610,1008,1618,2832561,12,0.676923077,0.876923077,0.682051282,2399
1e60e6da9c353540791971a5dcc3a4b7235b6d3c,0,ishaan,2015-03-25 14:45:48-07:00,['f4f4e0bf223d6c16193b91ba4acbbdbeb70efc52'],19,51,70,2832631,3,0,0,0.352941176,2399
89e1acb5586c70d195769a1a601aba4b37f74e66,1,ishaan,2015-03-25 14:45:48-07:00,['1e60e6da9c353540791971a5dcc3a4b7235b6d3c'],94,108,202,2832833,4,0,0,0.555555556,2399
47fb68cd133bc3c6292f272866aa4a486b1d845c,1,ishaan,2015-03-25 14:45:48-07:00,['89e1acb5586c70d195769a1a601aba4b37f74e66'],1,4,5,2832838,1,,,,2399
47032fa78992913b3cc64d787db0cd8b27e50705,1,ishaan,2015-03-25 14:45:49-07:00,['47fb68cd133bc3c6292f272866aa4a486b1d845c'],19,25,44,2832882,2,0.333333333,0.333333333,1,2399
ac875485c92b63da76fa9ebaf7ea16786c59a771,1,Internal Jenkins,2015-03-26 00:58:44+00:00,['47032fa78992913b3cc64d787db0cd8b27e50705'],13,16,29,2832911,1,0,0,1,2399
d16fa5836d24cd48071f4eb678857d5939002a6d,0,Internal Jenkins,2015-03-26 03:22:03+00:00,['ac875485c92b63da76fa9ebaf7ea16786c59a771'],0,0,0,2832911,0,,,,2399
e788c6e9e8bffbed755f3f575b99a4b19ce1d6ee,0,Internal Jenkins,2015-03-26 04:19:39+00:00,['d16fa5836d24cd48071f4eb678857d5939002a6d'],10,23,33,2832944,1,0,1,0,2399
9aa6a43b21a8fcb7c833f1e3566834b28c7053d4,0,Internal Jenkins,2015-03-26 20:04:11+00:00,['e788c6e9e8bffbed755f3f575b99a4b19ce1d6ee'],2,6,8,2832952,1,,,,2399
86053de3babbe9c970be5d3bfc2d7f2aea765057,0,Internal Jenkins,2015-03-26 20:06:59+00:00,['9aa6a43b21a8fcb7c833f1e3566834b28c7053d4'],0,0,0,2832952,0,,,,2399
1d0fb12039e7bb4bb8b7fe1bdd9b87a9887f10dd,0,Internal Jenkins,2015-03-26 23:13:22+00:00,['86053de3babbe9c970be5d3bfc2d7f2aea765057'],2,2,4,2832956,1,,,,2399
86d4516c443514be6e759bf10ef69fad770f3fd8,0,Internal Jenkins,2015-03-27 02:30:30+00:00,['1d0fb12039e7bb4bb8b7fe1bdd9b87a9887f10dd'],6,6,12,2832968,6,,,,2399
3c0a5844364eef35a7f62dec089c936b7f526075,0,Internal Jenkins,2015-03-27 02:44:13+00:00,['86d4516c443514be6e759bf10ef69fad770f3fd8'],7,6,13,2832981,1,0,0,1,2399
9ea43823e5f37b26a6282783dcdd4e8f9d8e5342,0,Internal Jenkins,2015-03-28 00:22:15+00:00,['3c0a5844364eef35a7f62dec089c936b7f526075'],1,2,3,2832984,1,,,,2399
a09e3abab30de03acecf486944a649111362c9da,1,Internal Jenkins,2015-03-30 19:41:54+00:00,['9ea43823e5f37b26a6282783dcdd4e8f9d8e5342'],12,37,49,2833033,1,,,,2399
cd57393f5444eb016b4d16a7a6230a0c2dc23c89,0,Internal Jenkins,2015-03-30 23:59:13+00:00,['a09e3abab30de03acecf486944a649111362c9da'],44,7,51,2833084,3,,,,2399
84c42ef6eba8c668fc924358358d354b6f28da86,0,Internal Jenkins,2015-03-30 23:59:18+00:00,['cd57393f5444eb016b4d16a7a6230a0c2dc23c89'],3,9,12,2833096,1,0,1,1,2399
9dc6d719e8d72f75d6fd6c17758c87e015a32132,1,Henry Robinson,2015-03-31 23:58:42+00:00,['84c42ef6eba8c668fc924358358d354b6f28da86'],63,457,520,2833616,5,0.863799283,0.913978495,0.921146953,2399
7431ece2a0a98a46123676d33f21fa735e573681,0,Taras Bobrovytsky,2015-04-01 13:06:52-07:00,['9dc6d719e8d72f75d6fd6c17758c87e015a32132'],74,61,135,2833751,6,0.55,1,0.55,2399
59283e7c1afc872351654b147ca8d6b7039e7e49,1,Henry Robinson,2015-04-02 00:10:16+00:00,['7431ece2a0a98a46123676d33f21fa735e573681'],3,374,377,2834128,6,0.405128205,1,1,2401
672ae91732c9cae6bf7f955e5fda5115ee407e90,1,Internal Jenkins,2015-04-02 02:48:47+00:00,['59283e7c1afc872351654b147ca8d6b7039e7e49'],430,582,1012,2835140,36,0.676470588,0.852941176,1,2402
4eceeacf1689f96f3ced448766a65bfe1f2f982b,1,Internal Jenkins,2015-04-02 19:11:00+00:00,['672ae91732c9cae6bf7f955e5fda5115ee407e90'],14,157,171,2835311,4,0.692307692,0.192307692,1,2402
6f1ce232f4c2e6d9e73d299c2bde816173fdb930,1,Internal Jenkins,2015-04-03 00:13:22+00:00,['4eceeacf1689f96f3ced448766a65bfe1f2f982b'],37,18,55,2835366,6,,,,2402
c21b3d2a3fd5e2af1812503fe2d2832928e2d99b,1,Internal Jenkins,2015-04-03 19:46:55+00:00,['6f1ce232f4c2e6d9e73d299c2bde816173fdb930'],19,22,41,2835407,7,0.5,1,1,2402
b605c57ee6ebac3702fa70775c6a0e8d28aadfb2,0,Internal Jenkins,2015-04-04 01:36:34+00:00,['c21b3d2a3fd5e2af1812503fe2d2832928e2d99b'],1,1,2,2835409,1,,,,2402
fb9ab9c26a0ff601c95ccf275023e16c01f1adfd,0,Internal Jenkins,2015-04-06 08:44:24+00:00,['b605c57ee6ebac3702fa70775c6a0e8d28aadfb2'],1,9,10,2835419,1,,,,2402
8967871971fb4da73b3ac49beb09b0bbf6f0bcc5,1,Internal Jenkins,2015-04-06 21:07:51+00:00,['fb9ab9c26a0ff601c95ccf275023e16c01f1adfd'],12,24,36,2835455,2,0,0,1,2402
30069f2cb5b2bfb2d3ebedd7a3dcd5271e254768,1,Internal Jenkins,2015-04-07 01:41:55+00:00,['8967871971fb4da73b3ac49beb09b0bbf6f0bcc5'],83,341,424,2835879,4,0.878787879,0.878787879,1,2402
1f83e1adc4f7b65abe206adc9d0282c8cd08c55a,0,Internal Jenkins,2015-04-08 02:37:27+00:00,['30069f2cb5b2bfb2d3ebedd7a3dcd5271e254768'],1,1,2,2835881,1,,,,2402
d947ef6f1fcc497ac7d913cfbd0c2e20b7b0cd45,1,Internal Jenkins,2015-04-08 03:27:10+00:00,['1f83e1adc4f7b65abe206adc9d0282c8cd08c55a'],8,11,19,2835900,1,,,,2402
5f62e3c804e1ad4b15d71e28e4c427ea2aac044a,1,Internal Jenkins,2015-04-09 02:29:05+00:00,['d947ef6f1fcc497ac7d913cfbd0c2e20b7b0cd45'],36,100,136,2836036,13,0.054054054,0.189189189,0.891891892,2402
29a73689402c6bf680e8f8abf529b585e2766b0a,1,Taras Bobrovytsky,2015-04-09 20:25:28+00:00,['5f62e3c804e1ad4b15d71e28e4c427ea2aac044a'],185,377,562,2836598,4,0.666666667,1,0,2403
d8e5bbe2da974386f463c4162da91fa26df61d6e,1,Internal Jenkins,2015-04-14 03:54:33+00:00,['29a73689402c6bf680e8f8abf529b585e2766b0a'],3,41,44,2836642,4,0,0.277777778,1,2403
6624fd55c742a83706ebc324e0bd929752d824c9,1,Internal Jenkins,2015-04-14 08:21:32+00:00,['d8e5bbe2da974386f463c4162da91fa26df61d6e'],115,123,238,2836880,2,0,0.333333333,1,2403
7067a5d94d910cd0983dac4d146a152c7ebb6245,1,Internal Jenkins,2015-04-14 23:33:20+00:00,['6624fd55c742a83706ebc324e0bd929752d824c9'],166,548,714,2837594,13,0.714285714,0,0,2403
afdd1b918ff2a1235bdef75ec0e62f16826ea894,1,Internal Jenkins,2015-04-15 04:00:02+00:00,['7067a5d94d910cd0983dac4d146a152c7ebb6245'],25,30,55,2837649,7,0,0.5,0.5,2403
caca8a5c9d28e4fa6a15fbba66d8810ba1c4328f,1,Internal Jenkins,2015-04-16 20:39:47+00:00,['afdd1b918ff2a1235bdef75ec0e62f16826ea894'],0,119,119,2837768,32,1,1,1,2403
8c6599330305d44c92042773a745e8395067744d,1,Internal Jenkins,2015-04-16 22:36:50+00:00,['caca8a5c9d28e4fa6a15fbba66d8810ba1c4328f'],85,88,173,2837941,6,0,0,0,2403
831331dda29c48c08bdeb3d232b929153fab74e4,0,Internal Jenkins,2015-04-17 02:29:19+00:00,['8c6599330305d44c92042773a745e8395067744d'],4,9,13,2837954,2,,,,2403
c03bc531a710b8119c7c99c6cba1a96369b80717,0,Taras Bobrovytsky,2015-04-18 00:34:14+00:00,['831331dda29c48c08bdeb3d232b929153fab74e4'],1,2,3,2837957,1,0,1,1,2403
2eb12e95930d1453a72ec9cdd572cf8308bf1400,1,Internal Jenkins,2015-04-18 01:26:47+00:00,['c03bc531a710b8119c7c99c6cba1a96369b80717'],677,994,1671,2839628,285,,,,2404
09e5eaeda27f2195f640882f4572eeebb6d1d2aa,1,Internal Jenkins,2015-04-19 03:09:59+00:00,['2eb12e95930d1453a72ec9cdd572cf8308bf1400'],91,100,191,2839819,32,,,,2404
210f528b53b4ae533812875dfb183866c64a1ddd,0,Internal Jenkins,2015-04-19 03:10:55+00:00,['09e5eaeda27f2195f640882f4572eeebb6d1d2aa'],1,1,2,2839821,1,,,,2404
c6b9d226161f11733a797ff801e55a229095bb73,1,Internal Jenkins,2015-04-19 03:33:16+00:00,['210f528b53b4ae533812875dfb183866c64a1ddd'],20,108,128,2839949,4,0.318181818,1,1,2405
154f1d66712bbdefe7894e9570e519c971de3799,0,Internal Jenkins,2015-04-20 23:17:32+00:00,['c6b9d226161f11733a797ff801e55a229095bb73'],12,31,43,2839992,10,,,,2405
a26b67c1733993e8ad363bd02409b3acc3d8040b,1,Internal Jenkins,2015-04-21 01:54:10+00:00,['154f1d66712bbdefe7894e9570e519c971de3799'],0,12,12,2840004,2,0,1,0,2405
f22b8659fdd998d928e2d9f0c5ef015722b5d272,1,Internal Jenkins,2015-04-21 19:27:50+00:00,['a26b67c1733993e8ad363bd02409b3acc3d8040b'],3004,3004,6008,2846012,12,0,0,1,2405
dd5ecb9deba077d37fb99de2c31dbf53db1e858a,0,Internal Jenkins,2015-04-21 23:29:14+00:00,['f22b8659fdd998d928e2d9f0c5ef015722b5d272'],8,64,72,2846084,3,0,0,1,2405
705f036829690aee851280618f5852ff2a229e88,1,Internal Jenkins,2015-04-22 02:30:20+00:00,['dd5ecb9deba077d37fb99de2c31dbf53db1e858a'],214,89,303,2846387,11,1,1,0.160377358,2405
706893c459a08316c63b899cc1f70f6586e92718,1,Internal Jenkins,2015-04-22 20:29:39+00:00,['705f036829690aee851280618f5852ff2a229e88'],106,121,227,2846614,19,0,0,0,2406
f98a7bee4617265dd9a09bcec60958c6863b62c9,0,Internal Jenkins,2015-04-23 19:46:31+00:00,['706893c459a08316c63b899cc1f70f6586e92718'],5,5,10,2846624,1,,,,2406
65c9ec0f6c07e4a251c50f923ac946e02913b03c,1,Internal Jenkins,2015-04-29 02:46:19+00:00,['f98a7bee4617265dd9a09bcec60958c6863b62c9'],0,362,362,2846986,4,0.861842105,1,0.927631579,2409
35e669f2ee6f54d6caca9178662cd5c0d7d37045,1,Internal Jenkins,2015-04-29 09:04:25+00:00,['65c9ec0f6c07e4a251c50f923ac946e02913b03c'],944,2764,3708,2850694,53,0.337696335,0.767015707,0.916230366,2412
2825420d2126298762745a95827ab864dee531d2,1,Internal Jenkins,2015-04-30 20:52:39+00:00,['35e669f2ee6f54d6caca9178662cd5c0d7d37045'],8,70,78,2850772,6,1,1,1,2413
c7bb42bad5641beace25702f353c662ab399a3af,1,Internal Jenkins,2015-04-30 22:17:50+00:00,['2825420d2126298762745a95827ab864dee531d2'],92,65,157,2850929,7,0.888888889,0.148148148,0,2413
2071af46e68a9640c2d01214c6729ed8fc9d7bb2,0,Internal Jenkins,2015-04-30 23:42:13+00:00,['c7bb42bad5641beace25702f353c662ab399a3af'],8,14,22,2850951,2,1,0,1,2413
9b6c54eac2ad2c59af17556ce6120c093e46c40d,1,Internal Jenkins,2015-05-01 03:32:35+00:00,['2071af46e68a9640c2d01214c6729ed8fc9d7bb2'],18,35,53,2851004,4,,,,2413
4d428440d89793a9c0a04da6a62890eaf0756ae6,1,Internal Jenkins,2015-05-04 19:49:56+00:00,['9b6c54eac2ad2c59af17556ce6120c093e46c40d'],14,60,74,2851078,4,0.944444444,0.944444444,0.944444444,2414
d1c263402ee893ef4bca72ff4474d35a59d0aa11,1,Internal Jenkins,2015-05-05 00:19:12+00:00,['4d428440d89793a9c0a04da6a62890eaf0756ae6'],3,96,99,2851177,6,0.5,0.5,1,2415
908393be714ae4d7b74db60610b43389bad91e19,0,Internal Jenkins,2015-05-06 03:18:49+00:00,['d1c263402ee893ef4bca72ff4474d35a59d0aa11'],1,1,2,2851179,1,,,,2415
f53f87cef148427f0ceddbfb6315c14a82c84eb2,1,Internal Jenkins,2015-05-06 17:22:42+00:00,['908393be714ae4d7b74db60610b43389bad91e19'],64,392,456,2851635,6,0.162601626,0.821138211,0.890243902,2416
75b16d5b8e25c0ae86944e7ffe578c7ac4cb1445,0,Internal Jenkins,2015-05-07 23:07:57+00:00,['f53f87cef148427f0ceddbfb6315c14a82c84eb2'],12628,12620,25248,2876883,243,,,,2416
62169b961de00e2473856e606d70163165b89fcb,0,Internal Jenkins,2015-05-08 04:36:16+00:00,['75b16d5b8e25c0ae86944e7ffe578c7ac4cb1445'],9,14,23,2876906,3,0,0.666666667,0.666666667,2416
058978dccbeffd161d1f7f7be36dda6251e9ec02,1,Internal Jenkins,2015-05-12 01:28:19+00:00,['62169b961de00e2473856e606d70163165b89fcb'],26,45,71,2876977,5,,,,2416
0224eb980cb2ac8c345021b41eb42fdc6d3950ba,0,Internal Jenkins,2015-05-13 00:59:27+00:00,['058978dccbeffd161d1f7f7be36dda6251e9ec02'],4,10,14,2876991,4,0,1,1,2416
1210e4ec0e961cd8271da371c5384b1f815f0904,1,Internal Jenkins,2015-05-13 08:27:31+00:00,['0224eb980cb2ac8c345021b41eb42fdc6d3950ba'],29,22,51,2877042,3,0.75,0.333333333,0.333333333,2416
304d985523629f3b270cd3c3de707a0869efe0c4,1,Internal Jenkins,2015-05-14 07:50:34+00:00,['1210e4ec0e961cd8271da371c5384b1f815f0904'],11,428,439,2877481,13,0.480314961,0.913385827,1,2418
5f54b2c4d3f49c80f466f553cb549dd693f550a6,1,Internal Jenkins,2015-05-14 07:55:36+00:00,['304d985523629f3b270cd3c3de707a0869efe0c4'],12,12,24,2877505,1,,,,2418
0568eb91d8e211f3130942dfdb4e9eb80c16ea34,1,Dan Hecht,2015-05-14 14:58:37+00:00,['5f54b2c4d3f49c80f466f553cb549dd693f550a6'],37,26,63,2877568,5,0.142857143,0.142857143,0,2418
35951f5b3b4ccd4bb404a010a0b1ac0c8cf5b20f,0,Internal Jenkins,2015-05-14 19:03:21+00:00,['0568eb91d8e211f3130942dfdb4e9eb80c16ea34'],5,11,16,2877584,1,0,1,1,2418
78446e5f34f44e1d475fc37336244c7e46dd01a8,0,Internal Jenkins,2015-05-14 19:18:37+00:00,['35951f5b3b4ccd4bb404a010a0b1ac0c8cf5b20f'],1,1,2,2877586,1,,,,2418
adf4b4863d7ea38fda21ec76f5699b4fd31e10c0,0,Internal Jenkins,2015-05-14 21:05:53+00:00,['78446e5f34f44e1d475fc37336244c7e46dd01a8'],5,6,11,2877597,1,,,,2418
cf0b6bc595ea55dedf59906a1180a19f31bcbf00,0,Matthew Jacobs,2015-05-14 21:15:24+00:00,['adf4b4863d7ea38fda21ec76f5699b4fd31e10c0'],2,97,99,2877696,2,1,1,1,2419
fe87bb15630982caaf6618869e6145c2b5416d01,1,Internal Jenkins,2015-05-14 21:27:28+00:00,['cf0b6bc595ea55dedf59906a1180a19f31bcbf00'],267,1774,2041,2879737,28,1,0.866666667,1,2422
1fefe61745d9d079fba6f3b80340db70b10e5105,1,Matthew Jacobs,2015-05-14 23:20:35+00:00,['fe87bb15630982caaf6618869e6145c2b5416d01'],7,6,13,2879750,1,0,0,0,2422
7801aa499fb5be6f1c9577154277dad76e4c1437,1,Internal Jenkins,2015-05-15 02:24:04+00:00,['1fefe61745d9d079fba6f3b80340db70b10e5105'],62,543,605,2880355,16,0.232209738,0.936329588,0.861423221,2423
ac0c0759974cfb3015964f1e27e4ad03a78d0db4,1,Internal Jenkins,2015-05-15 06:41:02+00:00,['7801aa499fb5be6f1c9577154277dad76e4c1437'],1,34,35,2880390,5,,,,2424
76529cdd8c6ccfced3ad20eb60268ba407a2bd96,0,Matthew Jacobs,2015-05-15 16:49:35+00:00,['ac0c0759974cfb3015964f1e27e4ad03a78d0db4'],1,4,5,2880395,1,1,1,1,2424
df3dab64418b332d625a96693f238290d2580ea2,0,Internal Jenkins,2015-05-15 19:28:30+00:00,['76529cdd8c6ccfced3ad20eb60268ba407a2bd96'],0,2,2,2880397,1,,,,2424
b3bb0ea525fd5d6a11f3c9d3386a996be439fc88,1,Internal Jenkins,2015-05-16 02:47:01+00:00,['df3dab64418b332d625a96693f238290d2580ea2'],2,2,4,2880401,1,,,,2424
b150583b9ac432f9d83cd9925f8b4f22be258c9c,0,Internal Jenkins,2015-05-16 11:37:28+00:00,['b3bb0ea525fd5d6a11f3c9d3386a996be439fc88'],19,22,41,2880442,2,,,,2424
013d6f968fd3a6317bfedbfd59e3cc422b8b13e1,1,Internal Jenkins,2015-05-18 07:20:07+00:00,['b150583b9ac432f9d83cd9925f8b4f22be258c9c'],28,19,47,2880489,3,,,,2424
38f0c3d046fcd3d96b21e54eca8464af6cd52195,0,Internal Jenkins,2015-05-19 02:12:03+00:00,['013d6f968fd3a6317bfedbfd59e3cc422b8b13e1'],5,11,16,2880505,1,1,1,1,2424
b558ea3f928adb1bc57978c388c1617f3631b11e,1,Internal Jenkins,2015-05-19 05:31:40+00:00,['38f0c3d046fcd3d96b21e54eca8464af6cd52195'],174,229,403,2880908,15,0,0.823529412,0,2425
1bd3eca22f16729c662e509bd27ee5d9370e2427,0,Internal Jenkins,2015-05-19 09:12:43+00:00,['b558ea3f928adb1bc57978c388c1617f3631b11e'],4,27,31,2880939,4,,,,2425
f37682a16f1d85ca36b1776889be94076d5c3158,0,Matthew Jacobs,2015-05-19 17:13:33+00:00,['1bd3eca22f16729c662e509bd27ee5d9370e2427'],2,5,7,2880946,2,,,,2425
b9765cedce712aaae0b06bf04a9f5dc8623ac5ef,1,Internal Jenkins,2015-05-19 18:03:52+00:00,['f37682a16f1d85ca36b1776889be94076d5c3158'],95,125,220,2881166,11,0,0.230769231,0,2425
456e99b21b9a89c7d707312de882d6c9240e29f9,0,Internal Jenkins,2015-05-19 23:05:44+00:00,['b9765cedce712aaae0b06bf04a9f5dc8623ac5ef'],3,28,31,2881197,2,,,,2425
abe7dc6566b3db8e7fea27668b2c4ff84ec8a524,1,Dan Hecht,2015-05-20 01:15:05+00:00,['456e99b21b9a89c7d707312de882d6c9240e29f9'],6,19,25,2881222,2,0.5,0,0.75,2425
26467d1f98399b29317fc8c926c4189e4005e68a,0,Internal Jenkins,2015-05-20 03:12:57+00:00,['abe7dc6566b3db8e7fea27668b2c4ff84ec8a524'],10,10,20,2881242,5,,,,2425
839ca0ccb528f5904b91461cca2846da318e469d,1,Internal Jenkins,2015-05-20 20:15:14+00:00,['26467d1f98399b29317fc8c926c4189e4005e68a'],57,269,326,2881568,8,0.356435644,0.99009901,1,2425
bc3a46daab0cde00af8f531c3f22801b2341f325,0,Matthew Jacobs,2015-05-20 21:11:49+00:00,['839ca0ccb528f5904b91461cca2846da318e469d'],1,1,2,2881570,1,,,,2425
bd92d2c9373722c4ad682134c3345fa3db1cd268,0,Internal Jenkins,2015-05-22 01:23:24+00:00,['bc3a46daab0cde00af8f531c3f22801b2341f325'],0,9,9,2881579,2,1,1,1,2425
934b28fe5e33a56fccd63e6a0e2d238c61dc7bc9,1,Internal Jenkins,2015-05-22 01:32:54+00:00,['bd92d2c9373722c4ad682134c3345fa3db1cd268'],387,1543,1930,2883509,7,1,1,1,2427
09018a3756305bccba4bc9d112007e2c65a7b9f9,1,Internal Jenkins,2015-05-22 05:19:25+00:00,['934b28fe5e33a56fccd63e6a0e2d238c61dc7bc9'],43,108,151,2883660,3,0.484848485,0.696969697,0,2427
1afe72830a696e700ac5948ac6e2e0994c50f991,1,Internal Jenkins,2015-05-22 09:53:13+00:00,['09018a3756305bccba4bc9d112007e2c65a7b9f9'],816,1033,1849,2885509,138,0.757894737,1,0.989473684,2429
4810e5144682b617aa5e4b85aeead6c0ca169c07,0,Internal Jenkins,2015-05-22 20:23:39+00:00,['1afe72830a696e700ac5948ac6e2e0994c50f991'],1,39,40,2885549,2,0,0.727272727,1,2429
7d66dfad5f15ab8755e24f762d2a3e58c39b0e27,1,Internal Jenkins,2015-05-22 23:49:59+00:00,['4810e5144682b617aa5e4b85aeead6c0ca169c07'],3,8,11,2885560,1,,,,2429
9a66dec222541aa5a837323230d5929593b7cdbe,0,Internal Jenkins,2015-05-23 01:20:26+00:00,['7d66dfad5f15ab8755e24f762d2a3e58c39b0e27'],1,1,2,2885562,1,,,,2429
69079411bf9cbf532e1329ce5ed629a60995e63a,0,Internal Jenkins,2015-05-24 06:26:47+00:00,['9a66dec222541aa5a837323230d5929593b7cdbe'],14,19,33,2885595,3,0,0,1,2429
d469d2d0c3265cf1b10b3e89fa958d82869feb53,1,Internal Jenkins,2015-05-26 00:39:00+00:00,['69079411bf9cbf532e1329ce5ed629a60995e63a'],5,997,1002,2886597,10,0.501160093,0.828306265,0.969837587,2432
82a34f5829c7c9294c3e2710e4600e57efe9c089,1,Internal Jenkins,2015-05-27 04:59:07+00:00,['d469d2d0c3265cf1b10b3e89fa958d82869feb53'],35,51,86,2886683,33,1,1,1,2432
d4817b697fa35dea834cdc23d293eeb67613f8d8,0,Henry Robinson,2015-05-27 15:54:55+00:00,['82a34f5829c7c9294c3e2710e4600e57efe9c089'],0,32,32,2886715,4,0,1,1,2432
42d639b196cbb08b75909eaefafcc7453b479d71,0,Internal Jenkins,2015-05-27 19:09:32+00:00,['d4817b697fa35dea834cdc23d293eeb67613f8d8'],0,5,5,2886720,3,1,1,1,2432
35b3cffeea29888c2fad3be5d93611653dbf4586,0,Internal Jenkins,2015-05-27 22:05:21+00:00,['42d639b196cbb08b75909eaefafcc7453b479d71'],4,4,8,2886728,3,,,,2432
dbc78aaa2c74f2b294a54ae0ac576de2973b7235,1,Internal Jenkins,2015-05-27 22:25:12+00:00,['35b3cffeea29888c2fad3be5d93611653dbf4586'],296,388,684,2887412,25,0.717948718,0.974358974,0.846153846,2432
0f85e0e7002355ed10a63513c05550b5d3f5cb0b,1,Martin Grund,2015-05-30 17:16:22+00:00,['dbc78aaa2c74f2b294a54ae0ac576de2973b7235'],54,527,581,2887993,16,0.196721311,0.546448087,0.715846995,2434
040c9149136bfcbd07184da6e5127e0293f5780e,1,Martin Grund,2015-06-01 15:41:52-07:00,['0f85e0e7002355ed10a63513c05550b5d3f5cb0b'],1,31,32,2888025,4,,,,2434
0edbe5004ac5a7c7d9272b2bcfce38c02550e5ab,0,Martin Grund,2015-06-01 15:41:52-07:00,['040c9149136bfcbd07184da6e5127e0293f5780e'],4,5,9,2888034,1,,,,2434
49f229a8e4d4e1ef40e39b4feeb5f715e2d66922,0,Martin Grund,2015-06-01 15:41:52-07:00,['0edbe5004ac5a7c7d9272b2bcfce38c02550e5ab'],0,3,3,2888037,1,,,,2434
933ec138419f1169db2dc2bb0d1c38dd6ee00bcd,0,Martin Grund,2015-06-01 15:41:52-07:00,['49f229a8e4d4e1ef40e39b4feeb5f715e2d66922'],0,3,3,2888040,1,,,,2434
6b945cf257c38c3d673a15c5e352d79e86b04a6b,1,Martin Grund,2015-06-01 15:53:34-07:00,['933ec138419f1169db2dc2bb0d1c38dd6ee00bcd'],21,116,137,2888177,11,0,0.166666667,0.133333333,2436
952da7e7a8945954bdbaab43ac142612b63c3dc8,0,Martin Grund,2015-06-01 15:53:34-07:00,['6b945cf257c38c3d673a15c5e352d79e86b04a6b'],0,8,8,2888185,1,,,,2436
5237a721662e2e0b277489f2890cfa18761abd80,0,Martin Grund,2015-06-01 15:53:34-07:00,['952da7e7a8945954bdbaab43ac142612b63c3dc8'],0,36,36,2888221,2,0.857142857,0.857142857,0.857142857,2436
395765c941e379d2bbf9c56e4ccbb344d4e296d4,0,Martin Grund,2015-06-01 15:53:34-07:00,['5237a721662e2e0b277489f2890cfa18761abd80'],1,5,6,2888227,2,,,,2436
ded8b06e5cfdf9931bcaae5604c5d40a434c552f,0,Martin Grund,2015-06-01 15:53:34-07:00,['395765c941e379d2bbf9c56e4ccbb344d4e296d4'],1,17,18,2888245,3,,,,2436
f06876277f9ece5ac7a441e2e8e0ca226ae325a9,0,Martin Grund,2015-06-01 15:53:34-07:00,['ded8b06e5cfdf9931bcaae5604c5d40a434c552f'],0,63,63,2888308,2,0.173913043,0.956521739,0.173913043,2437
2ab9a1a583035a962546704f1cb2d06f26398221,0,Martin Grund,2015-06-01 15:53:34-07:00,['f06876277f9ece5ac7a441e2e8e0ca226ae325a9'],2,2,4,2888312,1,0,0,0,2437
7fb89b61b53d2b3ff99d311ac1dc7a3336141f95,0,Martin Grund,2015-06-01 16:01:04-07:00,['2ab9a1a583035a962546704f1cb2d06f26398221'],0,71,71,2888383,2,0,0,1,2437
5a352b863a52af45c5aacfbd2b00a08697387454,1,Martin Grund,2015-06-01 16:01:06-07:00,['7fb89b61b53d2b3ff99d311ac1dc7a3336141f95'],0,66,66,2888449,2,,,,2438
4814ba9986a95795a5f5858681357e1a1bce8a2c,0,Martin Grund,2015-06-01 16:01:07-07:00,['5a352b863a52af45c5aacfbd2b00a08697387454'],7,7,14,2888463,3,,,,2438
5278103e2d9751ce54102991b716f82c8a6c7852,0,Martin Grund,2015-06-01 16:01:10-07:00,['4814ba9986a95795a5f5858681357e1a1bce8a2c'],0,44,44,2888507,1,0,1,1,2438
e95349676bf5e50e6f22ad0b0a18aa95c1da876a,0,Martin Grund,2015-06-01 16:01:10-07:00,['5278103e2d9751ce54102991b716f82c8a6c7852'],5,4,9,2888516,1,,,,2438
f8b682aab383a43938d035b41593afe1eebba114,1,Martin Grund,2015-06-01 16:01:11-07:00,['e95349676bf5e50e6f22ad0b0a18aa95c1da876a'],34,1093,1127,2889643,11,0.50456621,0.684931507,0.694063927,2444
55f6457a28f73c51c92945696187b44f35edcdac,1,Martin Grund,2015-06-01 16:51:53-07:00,['f8b682aab383a43938d035b41593afe1eebba114'],50,1200,1250,2890893,34,0.313978495,0.634408602,0.896774194,2453
8734cd642e02b2bd63566a1299e3f825cedfc840,1,Internal Jenkins,2015-06-02 08:38:07+00:00,['0f85e0e7002355ed10a63513c05550b5d3f5cb0b'],19,692,711,2891604,11,0.223476298,0.706546275,0.837471783,2455
fd859e1f2d2cdab1302a372e5d07e4fdd79b4669,1,Internal Jenkins,2015-06-03 00:13:49+00:00,['8734cd642e02b2bd63566a1299e3f825cedfc840'],0,13,13,2891617,2,0.818181818,0.818181818,1,2455
6d377340a1d3036fd52ab5468ede4567e68b2832,0,jenkins,2015-06-02 23:14:03-07:00,['55f6457a28f73c51c92945696187b44f35edcdac'],0,6,6,2891623,2,0.2,0.2,0.4,2455
3743063df51ab6a8c5a249fc09a27c85a58f0f2c,0,Martin Grund,2015-06-03 10:50:11-07:00,['6d377340a1d3036fd52ab5468ede4567e68b2832'],4,2,6,2891629,1,0,0,0,2455
03ba2319d157c11e29af829b438b75f94e271082,1,David Alves,2015-06-03 12:34:50-07:00,['3743063df51ab6a8c5a249fc09a27c85a58f0f2c'],4,46,50,2891679,2,0,0.904761905,0,2455
d46de9bba1dbacf3e98bac06b2f46bb9eb41a1bf,1,Internal Jenkins,2015-06-03 20:04:03+00:00,['fd859e1f2d2cdab1302a372e5d07e4fdd79b4669'],41,226,267,2891946,21,0.454545455,0.467532468,1,2456
5a93c795f95b605a6be0371131a5af4fb3cd971d,0,Internal Jenkins,2015-06-03 20:08:50+00:00,['d46de9bba1dbacf3e98bac06b2f46bb9eb41a1bf'],5,6,11,2891957,1,1,1,1,2456
8c0975c814a14b7379349de823095a9aa288646f,0,Internal Jenkins,2015-06-03 22:38:47+00:00,['5a93c795f95b605a6be0371131a5af4fb3cd971d'],0,1,1,2891958,1,,,,2456
f216c196dceda6628b6f91398335a7f20c1f6faa,0,Internal Jenkins,2015-06-04 00:48:30+00:00,['8c0975c814a14b7379349de823095a9aa288646f'],1,2,3,2891961,1,1,1,1,2456
fc969602f091b2bd7378624a451f79320c15dfca,1,Internal Jenkins,2015-06-04 01:11:18+00:00,['f216c196dceda6628b6f91398335a7f20c1f6faa'],15,123,138,2892099,10,0,0.847457627,0.779661017,2457
3a962e46c5b31dbbcfe4029fdd17c50e09a4d4df,0,Internal Jenkins,2015-06-04 03:03:31+00:00,['fc969602f091b2bd7378624a451f79320c15dfca'],0,52,52,2892151,2,0,0.714285714,0.714285714,2457
52a0912f1d5834f877c8fee5560119acd3a1c19a,0,Internal Jenkins,2015-06-04 17:09:02+00:00,['3a962e46c5b31dbbcfe4029fdd17c50e09a4d4df'],5,3,8,2892159,1,0,0,1,2457
060f08ef69a7a445fe786a365623afd35bd4eaa6,0,Internal Jenkins,2015-06-04 21:18:36+00:00,['52a0912f1d5834f877c8fee5560119acd3a1c19a'],5,212,217,2892376,3,0,0,0,2458
af72cde00e7b70ff202231e47fd5b2cbe26e5762,1,Internal Jenkins,2015-06-04 22:14:25+00:00,['060f08ef69a7a445fe786a365623afd35bd4eaa6'],1,22,23,2892399,2,1,1,1,2458
f327a53c70bde7a8340531c28b04caadf32cd401,1,Internal Jenkins,2015-06-05 00:52:14+00:00,['af72cde00e7b70ff202231e47fd5b2cbe26e5762'],61,77,138,2892537,3,0.916666667,0,0.416666667,2458
9a90bf88103fb3c80b49700a3eb36c09b33daa34,0,David Alves,2015-06-05 11:34:49-07:00,['03ba2319d157c11e29af829b438b75f94e271082'],13,26,39,2892576,2,0.857142857,0.857142857,1,2458
bd4efcbed80c0fde64b814487fbb52220ad9725a,1,David Alves,2015-06-06 11:45:47-07:00,['9a90bf88103fb3c80b49700a3eb36c09b33daa34'],51,105,156,2892732,3,0.5,0.263157895,0,2458
c3c7f6566ccb5525e11a0ca9420b2897986c73ea,1,Internal Jenkins,2015-06-09 08:09:45+00:00,['f327a53c70bde7a8340531c28b04caadf32cd401'],61,76,137,2892869,34,0,0,0,2458
8454c7712dd7ff181f974a4b1e6a6ca0c535b5cb,1,Internal Jenkins,2015-06-09 21:07:29+00:00,['c3c7f6566ccb5525e11a0ca9420b2897986c73ea'],41,67,108,2892977,5,,,,2458
eca9df6458f08ebd8ec793789c3cbfd6658d6216,1,David Alves,2015-06-10 02:04:45-07:00,['bd4efcbed80c0fde64b814487fbb52220ad9725a'],172,205,377,2893354,2,1,1,1,2459
a22ebb1698b99fe3e4c332156a303d55e8dcf99e,1,Internal Jenkins,2015-06-10 20:53:40+00:00,['8454c7712dd7ff181f974a4b1e6a6ca0c535b5cb'],147,130,277,2893631,6,0,1,0,2459
4823889e14de0d8ffd0ec08351a40ad21ac2a616,1,Internal Jenkins,2015-06-10 21:10:31+00:00,['a22ebb1698b99fe3e4c332156a303d55e8dcf99e'],63,123,186,2893817,6,1,1,1,2459
fe94cd25194d8d7af5bd0744c5d1261ed73728b7,1,jenkins,2015-06-10 15:33:35-07:00,['eca9df6458f08ebd8ec793789c3cbfd6658d6216'],20,79,99,2893916,4,0.4,0.4,0.133333333,2459
377214c469551454d8e31082be669b10d02f67d1,1,Internal Jenkins,2015-06-11 01:23:11+00:00,['4823889e14de0d8ffd0ec08351a40ad21ac2a616'],28,79,107,2894023,7,,,,2459
cbedd03d9fba16195b00c3d5d5ff74eba5f0e535,1,Internal Jenkins,2015-06-11 02:58:33+00:00,['377214c469551454d8e31082be669b10d02f67d1'],113,268,381,2894404,5,0.517241379,0.517241379,1,2459
2c1f0a49420872bf8e1e923203ec1c80a241f155,1,Internal Jenkins,2015-06-11 03:37:18+00:00,['cbedd03d9fba16195b00c3d5d5ff74eba5f0e535'],14,25,39,2894443,3,0,0,0,2459
2222518c7d0bb99d2f3e6ed1964e4ec9e3b7c7dd,0,David Alves,2015-06-11 12:14:58-07:00,['fe94cd25194d8d7af5bd0744c5d1261ed73728b7'],0,31,31,2894474,2,0,1,0,2459
bc0f677514c75f44720cd9f75744e1d32f52bfe6,0,David Alves,2015-06-12 10:45:11-07:00,['2222518c7d0bb99d2f3e6ed1964e4ec9e3b7c7dd'],1,3,4,2894478,1,0,1,1,2459
202e6f0caa6f01aa4cef46f7da93ffc170e1d229,1,David Alves,2015-06-12 10:45:30-07:00,['bc0f677514c75f44720cd9f75744e1d32f52bfe6'],2,546,548,2895026,5,0.414634146,0.592334495,0.526132404,2462
81f247b1711e08d8fc78f8989dcf2f7ea5a10f7e,1,Martin Grund,2015-06-13 03:11:44+00:00,['2c1f0a49420872bf8e1e923203ec1c80a241f155'],359,36030,36389,2931415,151,0.634631132,0.741978709,0.611330306,2570
81fbc8572b320ad2697665ad594ff789febb7103,1,Internal Jenkins,2015-06-14 00:41:05+00:00,['81f247b1711e08d8fc78f8989dcf2f7ea5a10f7e'],246,677,923,2932338,31,0.702222222,0.795555556,1,2570
dcb400f83d4556fd185c7812b7328767e505eb47,1,Internal Jenkins,2015-06-14 06:25:39+00:00,['81fbc8572b320ad2697665ad594ff789febb7103'],29,431,460,2932798,16,0.098360656,0.893442623,0.995901639,2570
384ae3ab08e8b045449b109093c5922632f5fba4,0,Internal Jenkins,2015-06-15 23:14:32+00:00,['dcb400f83d4556fd185c7812b7328767e505eb47'],42,51,93,2932891,21,,,,2570
e33452cb5404bbf478e3e278f8658645f9755c1c,1,Taras Bobrovytsky,2015-06-16 02:39:05+00:00,['384ae3ab08e8b045449b109093c5922632f5fba4'],0,3197,3197,2936088,27,0.578846888,0.717449408,0.948835433,2597
ec8b815fafca120b3929312ca74eea4055f15c15,0,Internal Jenkins,2015-06-16 04:42:47+00:00,['e33452cb5404bbf478e3e278f8658645f9755c1c'],1,2,3,2936091,1,,,,2597
79913b01e6e507c464c36b609ce6e9594aea9ef0,0,Internal Jenkins,2015-06-16 23:42:40+00:00,['ec8b815fafca120b3929312ca74eea4055f15c15'],37,112,149,2936240,9,0.888888889,1,1,2598
938158e1c3a5400dda8a65ee75c4969bdcdaf0b5,1,Matthew Jacobs,2015-06-17 18:24:14+00:00,['79913b01e6e507c464c36b609ce6e9594aea9ef0'],0,23,23,2936263,2,0.769230769,1,1,2598
bd4fea45f57151bd29fd883ba8d16b6fdfcfc8fa,1,Internal Jenkins,2015-06-17 19:45:52+00:00,['938158e1c3a5400dda8a65ee75c4969bdcdaf0b5'],0,33,33,2936296,1,0,0.952380952,1,2598
00438981edf15c5d4f1e4c1cb31bb9e6b0111be4,1,Internal Jenkins,2015-06-18 02:28:40+00:00,['bd4fea45f57151bd29fd883ba8d16b6fdfcfc8fa'],36,58,94,2936390,11,0.388888889,0.388888889,1,2598
e7087f3cbcafb05146f588fca80c0b297dac23fb,0,Casey Ching,2015-06-18 20:52:58+00:00,['00438981edf15c5d4f1e4c1cb31bb9e6b0111be4'],0,13,13,2936403,1,0,0,1,2598
3ca3e785cf715f6b18a8c11dec3898a3554f9649,0,Casey Ching,2015-06-18 20:53:22+00:00,['e7087f3cbcafb05146f588fca80c0b297dac23fb'],10,16,26,2936429,1,0,0,0,2598
4315109a128bbe0d90e8b2009a27bfe7e35e48a9,1,Internal Jenkins,2015-06-18 21:18:40+00:00,['3ca3e785cf715f6b18a8c11dec3898a3554f9649'],4,23,27,2936456,5,0.25,0.25,1,2598
cf2618df1e871b236b48c29484f2943cbac8e5a1,1,David Alves,2015-06-18 14:23:28-07:00,['202e6f0caa6f01aa4cef46f7da93ffc170e1d229'],14,39,53,2936509,2,0,0,0,2598
bd4b0fcd198030ad203be02dcc0f212f86daf252,0,Internal Jenkins,2015-06-18 21:50:57+00:00,['4315109a128bbe0d90e8b2009a27bfe7e35e48a9'],0,3,3,2936512,1,,,,2598
af466e4ae845db75ea7b253734348d5661c4fd64,0,jenkins,2015-06-18 17:08:11-07:00,['cf2618df1e871b236b48c29484f2943cbac8e5a1'],2,2,4,2936516,1,,,,2598
e385f5f05e3f9ef8b142215d4403dbe0e585e407,0,Casey Ching,2015-06-19 00:29:44+00:00,['bd4b0fcd198030ad203be02dcc0f212f86daf252'],18,20,38,2936554,1,,,,2598
0e59a77078219e8a79da1034db807c03c7e1c8dc,1,David Alves,2015-06-19 09:24:22-07:00,['af466e4ae845db75ea7b253734348d5661c4fd64'],20,17,37,2936591,3,1,1,0,2598
8a91b6b60f0c6d8a6762c48d582bed0afb730a17,1,David Alves,2015-06-19 10:40:16-07:00,['0e59a77078219e8a79da1034db807c03c7e1c8dc'],13,222,235,2936826,7,0.673076923,0.548076923,0.875,2599
c8aab96886cd89810b7c756bc271964cc57f5674,0,David Alves,2015-06-19 10:40:27-07:00,['8a91b6b60f0c6d8a6762c48d582bed0afb730a17'],57,0,57,2936883,1,1,0,0,2599
0b59ce58821b8ba0ba2ed6b98a7f72e76db07cfc,1,David Alves,2015-06-19 10:40:34-07:00,['c8aab96886cd89810b7c756bc271964cc57f5674'],0,130,130,2937013,4,0.235294118,0.735294118,0.558823529,2600
cc685fb8939e8a1d23a120586aeeff439c87b09f,0,jenkins,2015-06-19 13:42:56-07:00,['0b59ce58821b8ba0ba2ed6b98a7f72e76db07cfc'],12,11,23,2937036,2,,,,2600
4ddce7f97880409168c85ab71be1e10e35ebd3dd,0,Internal Jenkins,2015-06-19 22:46:13+00:00,['e385f5f05e3f9ef8b142215d4403dbe0e585e407'],8,33,41,2937077,1,0,1,1,2600
9950a23bed12186f664442641434f55c68e592eb,1,jenkins,2015-06-19 18:02:34-07:00,['cc685fb8939e8a1d23a120586aeeff439c87b09f'],2,4,6,2937083,1,0,1,1,2600
e8b97ee62977ecac282f79aa751a3a8e777f3eb9,0,Internal Jenkins,2015-06-20 01:59:09+00:00,['4ddce7f97880409168c85ab71be1e10e35ebd3dd'],4,11,15,2937098,3,0.375,0,1,2600
e61782249e28f82d71dd414da8cee5dfc317bde0,0,Internal Jenkins,2015-06-20 02:44:55+00:00,['e8b97ee62977ecac282f79aa751a3a8e777f3eb9'],15,50,65,2937163,3,0.857142857,0.857142857,1,2600
d224afcc4529bf2e0eaa868b9f0f305b682a83bb,0,Internal Jenkins,2015-06-22 22:13:46+00:00,['e61782249e28f82d71dd414da8cee5dfc317bde0'],5,20,25,2937188,2,,,,2600
f7b776240f4a7b09a33612680029b7471e3e9e5b,1,Internal Jenkins,2015-06-23 03:00:07+00:00,['d224afcc4529bf2e0eaa868b9f0f305b682a83bb'],43,115,158,2937346,9,0.226415094,0,1,2600
d9558cfdab2ef5270daec9d398f4953836765e39,1,Internal Jenkins,2015-06-23 03:31:39+00:00,['f7b776240f4a7b09a33612680029b7471e3e9e5b'],80,84,164,2937510,8,,,,2601
082e6dfeb2ac02956532c0754838292b38c56211,1,jenkins,2015-06-22 20:59:53-07:00,['9950a23bed12186f664442641434f55c68e592eb'],41,45,86,2937596,11,0,0.666666667,1,2601
45114fcb0e55a9e63c7911a87e4f72eb66bb977c,0,Internal Jenkins,2015-06-23 04:17:00+00:00,['d9558cfdab2ef5270daec9d398f4953836765e39'],14,38,52,2937648,2,0.083333333,0.416666667,0.916666667,2601
569e86a60b0d2523879e87dead461a92c6f07094,1,Internal Jenkins,2015-06-23 07:43:22+00:00,['45114fcb0e55a9e63c7911a87e4f72eb66bb977c'],175,498,673,2938321,36,0.2890625,0.796875,0.734375,2602
5612c31e930894f89d3e967588ca65a470329fb5,0,Henry Robinson,2015-06-23 21:04:50+00:00,['569e86a60b0d2523879e87dead461a92c6f07094'],38,54,92,2938413,1,0,0.5,1,2602
42d118a8ad9768ecf21bfd048235beb0f26ae2b7,1,Internal Jenkins,2015-06-23 23:53:52+00:00,['5612c31e930894f89d3e967588ca65a470329fb5'],7,34,41,2938454,3,0.8,0.8,0.55,2602
bdace43dae7286cbe01a3aceea456d88075e1e29,0,Internal Jenkins,2015-06-24 03:32:22+00:00,['42d118a8ad9768ecf21bfd048235beb0f26ae2b7'],1,1,2,2938456,1,,,,2602
dcb1b53749c498e4e4ebf3cd8920a98a7ed0ec82,1,Internal Jenkins,2015-06-24 08:04:30+00:00,['bdace43dae7286cbe01a3aceea456d88075e1e29'],36,76,112,2938568,11,0.947368421,1,1,2602
b2d9d459773f9f02e4d630fa9deede608aa593cb,1,Internal Jenkins,2015-06-25 00:09:23+00:00,['dcb1b53749c498e4e4ebf3cd8920a98a7ed0ec82'],7,21,28,2938596,1,,,,2602
406c2386e373a5e09f0f142f818a705468b13d65,1,Internal Jenkins,2015-06-25 21:47:15+00:00,['b2d9d459773f9f02e4d630fa9deede608aa593cb'],0,20845,20845,2959441,26,,,,2628
7799e637d9aad9b5caadc3a2f423a281128df0ac,1,Internal Jenkins,2015-06-25 22:36:47+00:00,['406c2386e373a5e09f0f142f818a705468b13d65'],107,102,209,2959650,36,,,,2628
12052021559217ea54a6ab114e4f8c26e4a84fa5,1,Martin Grund,2015-06-26 08:24:10-07:00,['082e6dfeb2ac02956532c0754838292b38c56211'],0,43,43,2959693,1,1,1,1,2629
12ef5be9e99e7d04deb3f234fe82a0264c61b447,1,Internal Jenkins,2015-06-26 22:05:41+00:00,['7799e637d9aad9b5caadc3a2f423a281128df0ac'],2,5,7,2959700,2,0,0,0,2629
fcba301b1813b1cef00df6645171246dc59d881c,1,Internal Jenkins,2015-06-26 23:35:25+00:00,['12ef5be9e99e7d04deb3f234fe82a0264c61b447'],3,54,57,2959757,2,0,0,0,2629
c3a79168120868efc77c2d4a0180f821909d76b5,1,Internal Jenkins,2015-06-27 01:17:50+00:00,['fcba301b1813b1cef00df6645171246dc59d881c'],0,40,40,2959797,3,0,0,1,2629
7e11e91356c2795d3789dd57755f03eb99b0ab9c,0,Internal Jenkins,2015-06-27 04:11:22+00:00,['c3a79168120868efc77c2d4a0180f821909d76b5'],229,219,448,2960245,1,,,,2629
b0f7dabab3d5ee059e39c63b1f479cb29929e747,1,Internal Jenkins,2015-06-30 01:10:33+00:00,['7e11e91356c2795d3789dd57755f03eb99b0ab9c'],27,302,329,2960574,3,0.252427184,0.621359223,0.611650485,2629
fcf4132d91e7fe62851f86ea55d415325312acd1,0,Internal Jenkins,2015-06-30 02:36:30+00:00,['b0f7dabab3d5ee059e39c63b1f479cb29929e747'],1,1,2,2960576,1,,,,2629
6c0af63a7aabcee95377e8d6d065b8df70014a3d,0,Internal Jenkins,2015-06-30 07:02:06+00:00,['fcf4132d91e7fe62851f86ea55d415325312acd1'],2,0,2,2960578,2,,,,2629
31dbe58d460039dd09b7f4e196715bc7d6a57780,0,Internal Jenkins,2015-06-30 23:14:56+00:00,['6c0af63a7aabcee95377e8d6d065b8df70014a3d'],1,1,2,2960580,1,,,,2629
f2c483802ff9c9fabb7c2a5b276d5cf69674b468,1,Internal Jenkins,2015-07-01 00:43:55+00:00,['31dbe58d460039dd09b7f4e196715bc7d6a57780'],148,249,397,2960977,5,0.45,1,0.9,2629
a274cfd787c3b7841d3485ab62dc691992855177,1,Internal Jenkins,2015-07-01 06:56:28+00:00,['f2c483802ff9c9fabb7c2a5b276d5cf69674b468'],13,44,57,2961034,4,1,1,1,2629
59625548c4678ee0663cdc6d1276628523f0f93c,0,David Alves,2015-07-01 10:12:52-07:00,['12052021559217ea54a6ab114e4f8c26e4a84fa5'],3,5,8,2961042,4,,,,2629
2bea2dbeb71a5334107a4424bc7bb8bbe8b3bd31,1,David Alves,2015-07-01 10:13:02-07:00,['59625548c4678ee0663cdc6d1276628523f0f93c'],11,16,27,2961069,1,0,0,0,2629
b33803437688801567c0bde8f83a1aa625fd25ee,0,Internal Jenkins,2015-07-01 20:18:37+00:00,['a274cfd787c3b7841d3485ab62dc691992855177'],1,1,2,2961071,1,,,,2629
3e0f6752781ced9548267e4bbeac7b2fc21c4911,1,Henry Robinson,2015-07-02 00:54:23+00:00,['b33803437688801567c0bde8f83a1aa625fd25ee'],54,98,152,2961223,4,0.608695652,1,0,2629
704e3fa6bf96879404d6e6b07e637a685d03434f,1,Internal Jenkins,2015-07-02 03:34:53+00:00,['3e0f6752781ced9548267e4bbeac7b2fc21c4911'],141,233,374,2961597,1,,,,2629
9a49f293e173d7d807368b3f744368dd07ce1ac9,0,ishaan,2015-07-02 14:05:03-07:00,['704e3fa6bf96879404d6e6b07e637a685d03434f'],0,0,0,2961597,0,,,,2629
8aea13e39f32db2f9af3c174f312af8dfeb9689c,1,ishaan,2015-07-02 14:05:41-07:00,['9a49f293e173d7d807368b3f744368dd07ce1ac9'],1,14,15,2961612,2,,,,2629
023bd823db892a95ba37ba954eaf5a6f937d1820,0,Martin Grund,2015-07-06 16:12:17-07:00,['2bea2dbeb71a5334107a4424bc7bb8bbe8b3bd31'],2,2,4,2961616,1,,,,2629
d55b300b5e3e7d415f52c47dc35a15eff5e9fe93,1,Internal Jenkins,2015-07-07 07:39:19+00:00,['8aea13e39f32db2f9af3c174f312af8dfeb9689c'],4,4,8,2961624,2,0,0,0,2629
4951f895e7f388121b55c8bbcc371ba13b31e389,1,Internal Jenkins,2015-07-08 01:51:09+00:00,['d55b300b5e3e7d415f52c47dc35a15eff5e9fe93'],125,211,336,2961960,4,1,1,0.95,2629
279806b7086a09beb52f9f7350a772c3bc5e92f2,0,Internal Jenkins,2015-07-08 02:54:20+00:00,['4951f895e7f388121b55c8bbcc371ba13b31e389'],74,74,148,2962108,26,,,,2629
cc68c1fcaf3d1b510c7815af5d794b6ba4350a65,1,Internal Jenkins,2015-07-08 23:26:48+00:00,['279806b7086a09beb52f9f7350a772c3bc5e92f2'],12,47,59,2962167,5,0,0.178571429,0,2629
5908ef983c8616a097b8ff52c0ea745afaeff62c,1,Internal Jenkins,2015-07-09 21:07:45+00:00,['cc68c1fcaf3d1b510c7815af5d794b6ba4350a65'],6,13,19,2962186,1,1,1,1,2629
c85ec8597f05ee0ef51333f8b61c57d0c07da066,1,Internal Jenkins,2015-07-10 23:32:25+00:00,['5908ef983c8616a097b8ff52c0ea745afaeff62c'],4,5,9,2962195,1,,,,2629
d6ef946df0497868de9d035ab0d56d0d828c2be1,0,David Alves,2015-07-12 22:22:13-07:00,['023bd823db892a95ba37ba954eaf5a6f937d1820'],1,4,5,2962200,1,0,0,0,2629
b911c7e97ea326ad59f44291f9f6cc531dfb1e95,1,David Alves,2015-07-12 23:02:08-07:00,['d6ef946df0497868de9d035ab0d56d0d828c2be1'],3,8,11,2962211,1,,,,2629
47bb63d2497b34a6a2f6148d12dd26df63c83b5b,1,David Alves,2015-07-13 09:25:08-07:00,['b911c7e97ea326ad59f44291f9f6cc531dfb1e95'],4,54,58,2962269,4,0,0.846153846,0.846153846,2630
84b2d60123c225331a3318eddf59b1d2377059a3,1,David Alves,2015-07-13 09:25:35-07:00,['47bb63d2497b34a6a2f6148d12dd26df63c83b5b'],13,48,61,2962330,4,0,1,0.684210526,2630
2db4256c677f5180c7f4ac5cfab1ed50561a3921,1,David Alves,2015-07-13 09:25:56-07:00,['84b2d60123c225331a3318eddf59b1d2377059a3'],21,21,42,2962372,1,,,,2630
51aa0774483ea835d5262eab5c3f15485da6a7eb,1,Internal Jenkins,2015-07-13 18:38:39+00:00,['c85ec8597f05ee0ef51333f8b61c57d0c07da066'],25,52,77,2962449,2,,,,2630
af1e1bea15c96a91ec0056a487879dc75742da98,1,David Alves,2015-07-13 14:56:03-07:00,['2db4256c677f5180c7f4ac5cfab1ed50561a3921'],5,14,19,2962468,2,,,,2630
f4ba3c2370b59f1eb9e83109e10227462f21a26d,0,Matthew Jacobs,2015-07-13 22:00:19+00:00,['51aa0774483ea835d5262eab5c3f15485da6a7eb'],1,0,1,2962469,1,0,0,0,2630
e99c68fe52f43d33195e931ecc33cdde49927698,1,Internal Jenkins,2015-07-14 02:52:02+00:00,['f4ba3c2370b59f1eb9e83109e10227462f21a26d'],3,22,25,2962494,5,,,,2631
7e9f8478e1157c6fc910c51cd28f0d8af09e0bb5,0,Internal Jenkins,2015-07-15 03:28:36+00:00,['e99c68fe52f43d33195e931ecc33cdde49927698'],8,0,8,2962502,1,,,,2631
d9b320c5de8481ae86348c3c18814e55a6e2549c,0,Internal Jenkins,2015-07-15 19:31:09+00:00,['7e9f8478e1157c6fc910c51cd28f0d8af09e0bb5'],2,64,66,2962568,2,0.162790698,1,1,2631
2aa81f3182b1c6bea5e78aeb3786783979a04b05,0,David Alves,2015-07-15 16:23:56-07:00,['af1e1bea15c96a91ec0056a487879dc75742da98'],30,16,46,2962614,5,1,0,0,2631
f351119730eb2f0690eae1a3f01b17f41ca02bbb,1,Internal Jenkins,2015-07-15 23:43:55+00:00,['d9b320c5de8481ae86348c3c18814e55a6e2549c'],14,24,38,2962652,4,0.5,0.5,0.875,2631
b029f69d221cdf3aeed03fea8935be964e1c2ff1,1,David Alves,2015-07-15 22:07:45-07:00,['2aa81f3182b1c6bea5e78aeb3786783979a04b05'],15,21,36,2962688,2,0,1,0,2631
6d87fe090c296d8e0e00aab865f23853b1686947,1,Henry Robinson,2015-07-16 19:38:17+00:00,['f351119730eb2f0690eae1a3f01b17f41ca02bbb'],279,1535,1814,2964502,14,0,0.372881356,1,2632
cb4998c28e02dd44875bc7cf673df61b362063bb,0,Casey Ching,2015-07-16 23:30:45+00:00,['6d87fe090c296d8e0e00aab865f23853b1686947'],1,0,1,2964503,1,,,,2632
a275f2a75182be596b957d982ac8eaf9df058da1,1,Tim Armstrong,2015-07-16 22:29:26-07:00,['cb4998c28e02dd44875bc7cf673df61b362063bb'],0,16,16,2964519,4,0.4,1,1,2632
ed18dd4a8bafd9d8e0d35e0207e31ff60092d006,1,Martin Grund,2015-07-17 17:59:29+00:00,['a275f2a75182be596b957d982ac8eaf9df058da1'],31,193,224,2964743,8,0.541666667,0.34375,0.625,2632
05b800e56703f7c4e94914dcf4bee7f955e8a647,1,Internal Jenkins,2015-07-17 21:48:04+00:00,['ed18dd4a8bafd9d8e0d35e0207e31ff60092d006'],4,9,13,2964756,1,0,0,1,2632
b472677e90e402a089b5888345d1b99a06070f1a,1,Martin Grund,2015-07-17 22:31:29+00:00,['05b800e56703f7c4e94914dcf4bee7f955e8a647'],0,27,27,2964783,1,1,1,1,2632
b8d2eb97e69133fb91bace068f85aacce22d4405,1,Internal Jenkins,2015-07-18 03:22:24+00:00,['b472677e90e402a089b5888345d1b99a06070f1a'],1,6,7,2964790,1,1,0,1,2632
a6d534682b406cbd18d35b7da5a4eb2b22fa4368,1,Internal Jenkins,2015-07-20 10:16:54+00:00,['b8d2eb97e69133fb91bace068f85aacce22d4405'],125,315,440,2965230,7,0.568627451,0.725490196,0.774509804,2632
e24878f680a098f48b9a419bc4b19133663d1a10,1,Internal Jenkins,2015-07-21 00:52:55+00:00,['a6d534682b406cbd18d35b7da5a4eb2b22fa4368'],2,170,172,2965402,4,0.333333333,0.784313725,0.823529412,2634
6d7bb76e87080b8c648ecc86853dad6ec01e58e2,1,Internal Jenkins,2015-07-21 04:01:39+00:00,['e24878f680a098f48b9a419bc4b19133663d1a10'],31,102,133,2965535,10,0.342105263,0,0.631578947,2634
d767bfea8c11580492c65610317a89a32e3a73a6,0,Internal Jenkins,2015-07-21 04:28:28+00:00,['6d7bb76e87080b8c648ecc86853dad6ec01e58e2'],1,1,2,2965537,1,,,,2634
f14f044d230df451a89ca9ad638226a289ea2194,0,Internal Jenkins,2015-07-21 10:29:25+00:00,['d767bfea8c11580492c65610317a89a32e3a73a6'],4,11,15,2965552,1,0,1,0,2634
1b6f14ab16efc5ae1c68029a04ad84f1d0ba1cbd,0,Internal Jenkins,2015-07-21 18:48:17+00:00,['f14f044d230df451a89ca9ad638226a289ea2194'],0,1,1,2965553,1,,,,2634
0ee478d1cea2231ad8219cb0cef158dafce2bfa2,1,Internal Jenkins,2015-07-22 00:44:45+00:00,['1b6f14ab16efc5ae1c68029a04ad84f1d0ba1cbd'],113,83,196,2965749,3,0,0,0.875,2634
a4f84b1b1aa02d9f27e51c53459af6891ab4419c,1,Internal Jenkins,2015-07-22 02:01:34+00:00,['0ee478d1cea2231ad8219cb0cef158dafce2bfa2'],27,26,53,2965802,14,,,,2634
af37e84bd4b8da280362b2f364f20ea676d0abd6,0,Internal Jenkins,2015-07-22 04:13:13+00:00,['a4f84b1b1aa02d9f27e51c53459af6891ab4419c'],1,1,2,2965804,1,,,,2634
5990b43fe2acffc55b922528c378039bf1103752,1,Tim Armstrong,2015-07-22 21:23:36+00:00,['af37e84bd4b8da280362b2f364f20ea676d0abd6'],33,97,130,2965934,4,0,1,0,2634
23eec9fc30de75d56f998d451efd25e7859ce6f6,1,Internal Jenkins,2015-07-23 04:09:11+00:00,['5990b43fe2acffc55b922528c378039bf1103752'],38,11,49,2965983,4,0,0.684210526,0,2634
00db434cd4193bf6189fee2d51cbdcf02ae8101c,0,Internal Jenkins,2015-07-23 20:39:17+00:00,['23eec9fc30de75d56f998d451efd25e7859ce6f6'],1,1,2,2965985,1,,,,2634
e5cc539d3fed93564b799b172d9e37d3dd95b426,1,Internal Jenkins,2015-07-23 21:56:33+00:00,['00db434cd4193bf6189fee2d51cbdcf02ae8101c'],10,20,30,2966015,2,0,1,1,2634
64653621da615f14b4ad71b3c4e6bc63c215ed55,1,Internal Jenkins,2015-07-24 02:36:36+00:00,['e5cc539d3fed93564b799b172d9e37d3dd95b426'],17,14,31,2966046,1,0,0,1,2634
19bf39e09b82a1028a8d5bed1c1654b05d736cd0,1,David Alves,2015-07-23 22:13:16-07:00,['b029f69d221cdf3aeed03fea8935be964e1c2ff1'],28,339,367,2966413,5,0.016574586,1,0.773480663,2634
c21c080a468a6a13acb5aae17f254f81b4c134e2,1,Internal Jenkins,2015-07-24 19:04:38+00:00,['64653621da615f14b4ad71b3c4e6bc63c215ed55'],33,25,58,2966471,6,0.733333333,0.733333333,0.133333333,2634
44151730db967e466655550704d8da24410c7bd6,0,Internal Jenkins,2015-07-24 23:43:30+00:00,['c21c080a468a6a13acb5aae17f254f81b4c134e2'],10,118,128,2966599,5,0.084507042,0.690140845,0.845070423,2634
62a799dd33d5e1eab119c48cf64430624d2a23ef,0,Internal Jenkins,2015-07-25 00:10:46+00:00,['44151730db967e466655550704d8da24410c7bd6'],71,60,131,2966730,7,0,1,0,2634
ddaa4f8c56ad91ccb89cd78dc92bc6256f3ff2c0,1,Internal Jenkins,2015-07-25 01:27:47+00:00,['62a799dd33d5e1eab119c48cf64430624d2a23ef'],1,31,32,2966762,2,0.818181818,0,1,2634
8b66b11bb8fe04851b00d3e201bb771a63de75fd,1,Internal Jenkins,2015-07-25 04:08:04+00:00,['ddaa4f8c56ad91ccb89cd78dc92bc6256f3ff2c0'],497,701,1198,2967960,10,0,0.698113208,0,2636
39874514d9d2a7e717d86174fd098e82ef7eb548,1,Internal Jenkins,2015-07-25 23:57:58+00:00,['8b66b11bb8fe04851b00d3e201bb771a63de75fd'],30,649,679,2968639,17,0.443089431,0.678861789,0.512195122,2642
4077987a3c968c6e91d53f586aa7b30aca8b8213,1,Internal Jenkins,2015-07-26 06:23:44+00:00,['39874514d9d2a7e717d86174fd098e82ef7eb548'],76,84,160,2968799,2,1,1,0.25,2642
822cb8f5e2cab9d69c0d816ed8283687dc3de395,1,Internal Jenkins,2015-07-27 19:03:48+00:00,['4077987a3c968c6e91d53f586aa7b30aca8b8213'],48,248,296,2969095,11,0.5,0.445945946,0.932432432,2642
3ac341287c3f8735f87cf6a8090aa285b9e88551,1,Alex Behm,2015-07-27 15:46:41-07:00,['822cb8f5e2cab9d69c0d816ed8283687dc3de395'],15,65,80,2969175,4,0.333333333,0.333333333,0.166666667,2642
4ff17906acde87cd3b74a47f60fe397d1ce64867,1,Alex Behm,2015-07-27 15:46:48-07:00,['3ac341287c3f8735f87cf6a8090aa285b9e88551'],4,142,146,2969321,3,0.795454545,1,1,2643
ae1238e7398586717169151044fb4b5a1d8348dd,1,Alex Behm,2015-07-27 22:08:29-07:00,['4ff17906acde87cd3b74a47f60fe397d1ce64867'],7,62,69,2969390,5,0,0,1,2643
8a01527badc5285e18fdb5ac90b0cf7cfd27be5e,0,Alex Behm,2015-07-27 22:09:19-07:00,['ae1238e7398586717169151044fb4b5a1d8348dd'],19,26,45,2969435,3,,,,2643
d238293e0c5d0d2f3e88bcac228d3c9e864e935d,1,Internal Jenkins,2015-07-28 08:21:05+00:00,['8a01527badc5285e18fdb5ac90b0cf7cfd27be5e'],1,40,41,2969476,2,0,0.769230769,1,2643
e151ebaa7198f4ce1076b3aca049d0846acd591a,1,Tim Armstrong,2015-07-28 08:11:01-07:00,['d238293e0c5d0d2f3e88bcac228d3c9e864e935d'],9,625,634,2970110,9,0.405,0.925,0.785,2645
3b71b24cfc42174ef3d187f27aeba67f4c836049,0,Internal Jenkins,2015-07-29 18:37:30+00:00,['e151ebaa7198f4ce1076b3aca049d0846acd591a'],1,2,3,2970113,1,,,,2645
664fd38e26512be5217a39327b3f39f2417ead89,0,Internal Jenkins,2015-07-29 22:54:37+00:00,['3b71b24cfc42174ef3d187f27aeba67f4c836049'],5,8,13,2970126,2,,,,2645
f6d87190073e05dcb7dafea45178b9ebc455e5fc,0,Internal Jenkins,2015-07-29 23:45:16+00:00,['664fd38e26512be5217a39327b3f39f2417ead89'],3,12,15,2970141,1,,,,2645
4702df40bc0bff1f3e09e171221e67f8336869e8,1,Internal Jenkins,2015-07-30 02:18:33+00:00,['f6d87190073e05dcb7dafea45178b9ebc455e5fc'],7,66,73,2970214,2,1,1,1,2645
621205ebbcdf451d90926145db2fcd49cd83f798,1,Internal Jenkins,2015-07-30 07:15:29+00:00,['4702df40bc0bff1f3e09e171221e67f8336869e8'],10,33,43,2970257,4,0.5,0.8,1,2645
84a87d7bb59e3267a607761285042597306ef271,1,Internal Jenkins,2015-07-30 23:00:39+00:00,['621205ebbcdf451d90926145db2fcd49cd83f798'],40,151,191,2970448,5,0.430769231,1,1,2646
acb886227278003e4fdd4b4532febd41e82b9a78,1,Internal Jenkins,2015-07-31 00:06:21+00:00,['84a87d7bb59e3267a607761285042597306ef271'],4,9,13,2970461,2,0,0,1,2646
0189f56e667e59dd48348c2577fd244b2bafc6ef,0,ishaan,2015-07-30 18:37:48-07:00,['acb886227278003e4fdd4b4532febd41e82b9a78'],0,0,0,2970461,0,,,,2646
4b5410781825f8b554d4b0c4fbfc89d3c283b36d,0,ishaan,2015-07-30 18:37:52-07:00,['0189f56e667e59dd48348c2577fd244b2bafc6ef'],1,1,2,2970463,1,,,,2646
26133e5df73d41ee43cb73f3d1e5ece68405cab3,1,Internal Jenkins,2015-07-31 02:56:00+00:00,['4b5410781825f8b554d4b0c4fbfc89d3c283b36d'],5,8,13,2970476,2,0,0,0,2646
c908ba1b7eaf06aa7f080cd09d29d0b7b8c87854,1,Internal Jenkins,2015-07-31 12:13:37+00:00,['26133e5df73d41ee43cb73f3d1e5ece68405cab3'],45,348,393,2970869,10,0.618644068,0.762711864,0.93220339,2647
b7417e0ab4487b60b053327232fc88933a33f233,0,Internal Jenkins,2015-07-31 21:43:17+00:00,['c908ba1b7eaf06aa7f080cd09d29d0b7b8c87854'],0,21,21,2970890,2,0,1,0,2647
ca5856b8f8293dc4af840a8e7ba426d6ac8d733c,1,Internal Jenkins,2015-08-01 01:30:12+00:00,['b7417e0ab4487b60b053327232fc88933a33f233'],0,218,218,2971108,7,0.771428571,0.8,1,2654
881919e69fec0aad37aa0d517a0e039d1eafbcac,0,Skye Wanderman-Milne,2015-08-02 16:15:40-07:00,['ca5856b8f8293dc4af840a8e7ba426d6ac8d733c'],0,0,0,2971108,0,,,,2654
dbf341b221183a5fe318a62ee2c79ee356d47ca3,0,Skye Wanderman-Milne,2015-08-02 16:20:33-07:00,['881919e69fec0aad37aa0d517a0e039d1eafbcac'],0,0,0,2971108,0,,,,2654
480a56e3a0b85df555dc9da25dc0241567eb4683,1,Internal Jenkins,2015-08-03 19:31:51+00:00,['dbf341b221183a5fe318a62ee2c79ee356d47ca3'],15,53,68,2971176,4,1,1,1,2654
891cdf18308a9f0399f46621bcafd8b5266344ce,1,Internal Jenkins,2015-08-03 20:45:05+00:00,['480a56e3a0b85df555dc9da25dc0241567eb4683'],5,7,12,2971188,2,1,1,1,2654
e38d4873d6d2e8d36d520f7185f6d134e2982588,0,Internal Jenkins,2015-08-03 20:58:44+00:00,['891cdf18308a9f0399f46621bcafd8b5266344ce'],9,18,27,2971215,1,0,0,1,2654
074e5b4349dfe6a5d5674b7a64f4131c4ea3355b,0,Internal Jenkins,2015-08-04 05:26:07+00:00,['e38d4873d6d2e8d36d520f7185f6d134e2982588'],101,0,101,2971316,101,,,,2654
619fdd8256c3a4009efe99b0e67514d65336c802,1,Internal Jenkins,2015-08-04 08:45:15+00:00,['074e5b4349dfe6a5d5674b7a64f4131c4ea3355b'],36,45,81,2971397,13,,0,1,2654
2b537b200f11aeda462d4db1115ecf423915c21e,1,Internal Jenkins,2015-08-04 08:46:10+00:00,['619fdd8256c3a4009efe99b0e67514d65336c802'],115,150,265,2971662,4,1,1,1,2654
c1fd86223873d78d426d7f3ca16594173fbd85db,1,Internal Jenkins,2015-08-05 01:00:54+00:00,['2b537b200f11aeda462d4db1115ecf423915c21e'],6,18,24,2971686,2,1,1,1,2654
14ac390e0145ee4095655757df885875a26c6a73,1,Internal Jenkins,2015-08-05 01:16:25+00:00,['c1fd86223873d78d426d7f3ca16594173fbd85db'],1,2,3,2971689,1,0,0,1,2654
c0f468a207a79de2269c8a4bc07e96dab15c13d4,0,David Alves,2015-08-04 23:48:14-07:00,['19bf39e09b82a1028a8d5bed1c1654b05d736cd0'],0,0,0,2971689,0,,,,2654
29b110a91d82dca915d9406a9f6cf0b1324c8e47,0,David Alves,2015-08-04 23:48:40-07:00,['c0f468a207a79de2269c8a4bc07e96dab15c13d4'],0,0,0,2971689,0,,,,2654
ee8d830d7aa430f79a72b41d4e13d15a07ad5b6b,1,David Alves,2015-08-04 23:49:14-07:00,['29b110a91d82dca915d9406a9f6cf0b1324c8e47'],36,192,228,2971917,4,0.181818182,0.181818182,0.818181818,2654
adac8b79bc4bd1944ae1f9e92f1f94cc0e44fc78,0,Internal Jenkins,2015-08-05 12:33:52+00:00,['14ac390e0145ee4095655757df885875a26c6a73'],32,32,64,2971981,5,0,0,1,2654
d69cd906074254b13fb1e04ee7d99800775b4912,1,Internal Jenkins,2015-08-06 02:02:52+00:00,['adac8b79bc4bd1944ae1f9e92f1f94cc0e44fc78'],9,15,24,2972005,2,0,0.833333333,0.333333333,2654
d202d6a9677a83ec45358efd827a34aae2b745ed,1,Internal Jenkins,2015-08-06 02:09:09+00:00,['d69cd906074254b13fb1e04ee7d99800775b4912'],39,37,76,2972081,33,,,,2654
9ba449d3db086e25c06b3fa27c11ed95bac2e65c,0,Internal Jenkins,2015-08-06 02:20:12+00:00,['d202d6a9677a83ec45358efd827a34aae2b745ed'],2,1,3,2972084,1,,,,2654
9428448146ec55463d465a259cfff56560730102,1,Internal Jenkins,2015-08-06 02:24:24+00:00,['9ba449d3db086e25c06b3fa27c11ed95bac2e65c'],1,105,106,2972190,4,0.315789474,0.710526316,0.710526316,2654
bb9bbafb0ac8983f93c632e85489260ca64d0876,0,Martin Grund,2015-08-06 08:39:31-07:00,['ee8d830d7aa430f79a72b41d4e13d15a07ad5b6b'],6,0,6,2972196,1,,,,2654
d08d768f74dd9ee79dd05cf52f265cc6f5bfd81e,0,Martin Grund,2015-08-06 14:21:23-07:00,['bb9bbafb0ac8983f93c632e85489260ca64d0876'],0,14,14,2972210,1,,,,2654
60e4f98b24828c8c589a37f50259649ddbd0b189,1,David Alves,2015-08-06 19:33:20-07:00,['d08d768f74dd9ee79dd05cf52f265cc6f5bfd81e'],145,896,1041,2973251,19,0.245283019,0.754716981,0.830188679,2657
fa0df14d764c0138f658c40cfb3f67e73d6d4b86,0,David Alves,2015-08-06 19:33:33-07:00,['60e4f98b24828c8c589a37f50259649ddbd0b189'],14,210,224,2973475,11,0.838709677,0.838709677,0.774193548,2658
f000758ca8160d0a1fa13121d2736003030edf27,0,Internal Jenkins,2015-08-07 02:47:32+00:00,['9428448146ec55463d465a259cfff56560730102'],1084,1692,2776,2976251,36,0.330601093,0.37704918,0.901639344,2662
8f11fbdd5ccf6c74ee982444409c014ba6a8a9ec,1,Henry Robinson,2015-08-07 04:57:37+00:00,['f000758ca8160d0a1fa13121d2736003030edf27'],13,456,469,2976720,5,0.20625,0.6125,0.88125,2662
23ca2f01adef58691412f378d75ba86c0c776416,1,Martin Grund,2015-08-08 07:02:37-07:00,['fa0df14d764c0138f658c40cfb3f67e73d6d4b86'],80,243,323,2977043,8,0.756756757,0.756756757,0,2663
f8134ff133700cbc75c8008dae88a9a3251cfad9,0,Internal Jenkins,2015-08-09 06:17:48+00:00,['8f11fbdd5ccf6c74ee982444409c014ba6a8a9ec'],2,16,18,2977061,3,,,,2664
9a5cef9c9520452c4096431ca0fe9ad42f0706cf,1,Alex Behm,2015-08-11 15:23:55+00:00,['f8134ff133700cbc75c8008dae88a9a3251cfad9'],1,1,2,2977063,1,,,,2664
e1c0a4c15a2f63f32556a622e24c0bbe9e6ac569,1,Martin Grund,2015-08-12 10:37:33-07:00,['23ca2f01adef58691412f378d75ba86c0c776416'],133,403,536,2977599,20,0.561797753,0.460674157,0.876404494,2667
fb04f5b431084cf2d51480f51f57fc73ab07479a,0,Martin Grund,2015-08-12 10:37:52-07:00,['e1c0a4c15a2f63f32556a622e24c0bbe9e6ac569'],18,85,103,2977702,3,0,0,0.304347826,2667
06f14cb1b8b94490365d736355f39e005f602f21,0,David Alves,2015-08-12 17:22:18-07:00,['fb04f5b431084cf2d51480f51f57fc73ab07479a'],0,5,5,2977707,1,,,,2667
47c5ae405a61be35367e3b5779334975495bc1e9,0,Internal Jenkins,2015-08-13 02:20:07+00:00,['9a5cef9c9520452c4096431ca0fe9ad42f0706cf'],1692,1084,2776,2980483,36,0.669398907,0.62295082,0.098360656,2672
9ea5caf0eff9e0b0007a2c445998c4941f193005,0,Internal Jenkins,2015-08-13 09:38:30+00:00,['47c5ae405a61be35367e3b5779334975495bc1e9'],1,26,27,2980510,2,0,0,1,2672
3c9ceb1a2b058cbe317942c0afb8530e1a2e123d,1,Internal Jenkins,2015-08-13 10:25:39+00:00,['9ea5caf0eff9e0b0007a2c445998c4941f193005'],1,192,193,2980703,8,0,0,1,2678
e067cea55b792e59d4e9596e61c094343b3afd27,1,Internal Jenkins,2015-08-13 20:59:33+00:00,['3c9ceb1a2b058cbe317942c0afb8530e1a2e123d'],250,728,978,2981681,31,0.225308642,0.271604938,0.561728395,2679
a2dd2d1a0b3059898cc230673c2dd75c39ae7df2,1,Adar Dembo,2015-08-13 16:29:00-07:00,['06f14cb1b8b94490365d736355f39e005f602f21'],68,33,101,2981782,7,0.952380952,0,0.857142857,2679
2372667ba3ae8c250e19c6f344a68eb19518e6ee,0,Internal Jenkins,2015-08-14 00:23:41+00:00,['e067cea55b792e59d4e9596e61c094343b3afd27'],0,10,10,2981792,1,,,,2679
1d2afcfec28ab08724cf5c3168e1dbe1138d605f,1,Internal Jenkins,2015-08-14 00:38:22+00:00,['2372667ba3ae8c250e19c6f344a68eb19518e6ee'],83,216,299,2982091,6,0.326732673,0.603960396,0.900990099,2679
38838995811f8bd5d693f7508c250e0265c7b70a,0,Internal Jenkins,2015-08-14 01:46:43+00:00,['1d2afcfec28ab08724cf5c3168e1dbe1138d605f'],0,4,4,2982095,1,,,,2679
b8dfdc629c5b12ecae0ae9b70a298540a86ee6a7,0,Internal Jenkins,2015-08-14 10:10:38+00:00,['38838995811f8bd5d693f7508c250e0265c7b70a'],7,166,173,2982268,3,0.163461538,1,1,2679
dd88b3b465879e289b318ba69e669e922037f08f,1,Internal Jenkins,2015-08-14 23:33:20+00:00,['b8dfdc629c5b12ecae0ae9b70a298540a86ee6a7'],29,63,92,2982360,2,0,1,1,2679
ec3697656b571c438c44c6d7d8ac3d67ff09d563,0,Martin Grund,2015-08-15 18:38:54+00:00,['dd88b3b465879e289b318ba69e669e922037f08f'],1,1,2,2982362,1,,,,2679
a4fe24c1b2049e6d59e28b56a2c6795775b7c1a1,1,Casey Ching,2015-08-15 23:10:10+00:00,['ec3697656b571c438c44c6d7d8ac3d67ff09d563'],9,48,57,2982419,1,0.34375,1,0.34375,2679
facedb2aa53ee416068f4d1c3ab1e33bc3c15a87,1,Casey Ching,2015-08-15 23:10:25+00:00,['a4fe24c1b2049e6d59e28b56a2c6795775b7c1a1'],0,930,930,2983349,1,0.384615385,0.396072013,0.767594108,2680
4ec1a86c90c45399a1ace5d9e519a02d8c317ade,1,Internal Jenkins,2015-08-16 07:09:19+00:00,['facedb2aa53ee416068f4d1c3ab1e33bc3c15a87'],59,60,119,2983468,1,,,,2680
cf60967b7e56674f69aa1ca1fc3f1f13c563b094,1,Internal Jenkins,2015-08-16 12:09:24+00:00,['4ec1a86c90c45399a1ace5d9e519a02d8c317ade'],201,408,609,2984077,5,0.382113821,0.723577236,0.430894309,2680
669290c513ecd08760bd6de41afe9679f4521935,0,Casey Ching,2015-08-17 20:45:35+00:00,['cf60967b7e56674f69aa1ca1fc3f1f13c563b094'],6,1,7,2984084,1,1,1,0,2680
b7826a5fef75c7072696b53fe286f2e43b26ad5b,0,Internal Jenkins,2015-08-17 22:24:49+00:00,['669290c513ecd08760bd6de41afe9679f4521935'],1,14,15,2984099,3,1,1,1,2680
7f003ceaa2fc32e0ddcd5f700a0965fe115678dc,1,Martin Grund,2015-08-17 15:30:25-07:00,['a2dd2d1a0b3059898cc230673c2dd75c39ae7df2'],47,53,100,2984199,5,0.761904762,0,0.047619048,2680
38a85f62835d076f1fabe473e0dc20438045e030,1,David Alves,2015-08-17 18:13:26-07:00,['7f003ceaa2fc32e0ddcd5f700a0965fe115678dc'],34,74,108,2984307,3,0,1,0.548387097,2680
4eb2754924bb217e4b05295d0a6abe82774544ff,0,Internal Jenkins,2015-08-18 01:29:45+00:00,['b7826a5fef75c7072696b53fe286f2e43b26ad5b'],1,5,6,2984313,2,0,0,1,2680
f9d26fb8966341cfada74db7d5a70204698bb1d4,1,Internal Jenkins,2015-08-18 01:44:45+00:00,['4eb2754924bb217e4b05295d0a6abe82774544ff'],1,65,66,2984379,3,,,,2680
c2cb8a974bc4eec8f28c60536234da422f381144,1,Internal Jenkins,2015-08-18 02:33:03+00:00,['f9d26fb8966341cfada74db7d5a70204698bb1d4'],19,31,50,2984429,2,0,0.739130435,0.826086957,2680
d439717ab7cb8935c20a79067c83287ff1cd3dc9,0,Martin Grund,2015-08-17 20:45:57-07:00,['38a85f62835d076f1fabe473e0dc20438045e030'],1,4,5,2984434,1,0,1,1,2680
1c46cab5c6b2c08b3ace8eb94284f897da5954e6,1,Internal Jenkins,2015-08-18 09:07:34+00:00,['c2cb8a974bc4eec8f28c60536234da422f381144'],4,401,405,2984839,8,0.052631579,0.240601504,0.353383459,2680
408fc6ec1e540d61f656a8db1a088d78c2753ff5,0,Internal Jenkins,2015-08-19 01:44:47+00:00,['1c46cab5c6b2c08b3ace8eb94284f897da5954e6'],3,29,32,2984871,2,0,0,1,2680
9123d8e8a8ec926c93c0938f8d2bd22caed1844f,0,Internal Jenkins,2015-08-19 02:55:29+00:00,['408fc6ec1e540d61f656a8db1a088d78c2753ff5'],5,4,9,2984880,2,0,0,1,2680
5350d49f8ce65b991411fcedc1cdcf933fd0580f,1,Tim Armstrong,2015-08-19 04:37:39+00:00,['9123d8e8a8ec926c93c0938f8d2bd22caed1844f'],47,64,111,2984991,5,1,1,0,2680
7906ed44ac20412fbed143e4820ad3fe3a6a57b2,1,Internal Jenkins,2015-08-19 08:40:14+00:00,['5350d49f8ce65b991411fcedc1cdcf933fd0580f'],1084,1738,2822,2987813,36,0.296758105,0.324189526,0.93765586,2684
2db16efda8e952604632fcd7a2718bda99edcdae,1,Internal Jenkins,2015-08-19 18:37:02+00:00,['7906ed44ac20412fbed143e4820ad3fe3a6a57b2'],192,1955,2147,2989960,23,0.352564103,0.689102564,0.208333333,2688
51b9db9ecb935353dcc2b7d1739b4a17dd0aecba,0,Internal Jenkins,2015-08-19 22:53:44+00:00,['2db16efda8e952604632fcd7a2718bda99edcdae'],0,1,1,2989961,1,,,,2688
a39ffcf9106920d6fef53915e30a55a9fa0ae64e,1,Internal Jenkins,2015-08-20 02:36:19+00:00,['51b9db9ecb935353dcc2b7d1739b4a17dd0aecba'],44,232,276,2990237,5,0,0.321100917,0.926605505,2688
e4c42fa8bf92ccb80a49c5149db30992ec1e9636,1,Internal Jenkins,2015-08-20 03:34:31+00:00,['a39ffcf9106920d6fef53915e30a55a9fa0ae64e'],43,131,174,2990411,11,0,1,1,2688
4120d41e2685c3f1393446af765949907746e67e,0,Internal Jenkins,2015-08-20 03:43:11+00:00,['e4c42fa8bf92ccb80a49c5149db30992ec1e9636'],23,38,61,2990472,7,0,1,0.428571429,2688
e71b1430318ccba0ff97ac12ea73df39344e1aaf,0,Internal Jenkins,2015-08-20 07:11:40+00:00,['4120d41e2685c3f1393446af765949907746e67e'],2,2,4,2990476,1,,,,2688
d84182eeb0f0ac37f5442c38afd74ba94db0592a,1,Internal Jenkins,2015-08-21 04:59:27+00:00,['e71b1430318ccba0ff97ac12ea73df39344e1aaf'],207,235,442,2990918,3,1,1,1,2688
5787dc2cf39805f91b1859a036df5db6aa4db272,1,Internal Jenkins,2015-08-21 08:19:04+00:00,['d84182eeb0f0ac37f5442c38afd74ba94db0592a'],17,186,203,2991121,6,0.776699029,0.388349515,0.941747573,2688
de4410af15b0756bdc22af20ffdcaaa7378b56c9,1,Internal Jenkins,2015-08-21 09:08:54+00:00,['5787dc2cf39805f91b1859a036df5db6aa4db272'],46,183,229,2991350,6,0.261904762,0.261904762,0.80952381,2688
113603a56323fd2ee4cf18955a61c529709b1b2d,0,Juan Yu,2015-08-21 12:07:29-07:00,['de4410af15b0756bdc22af20ffdcaaa7378b56c9'],1,1,2,2991352,1,,,,2688
9d83d1de83cf248bcf103632b6c8c6583fac119d,0,Juan Yu,2015-08-21 12:09:00-07:00,['113603a56323fd2ee4cf18955a61c529709b1b2d'],1,1,2,2991354,1,,,,2688
5afd5bc8f6eb7bc5c77c668751c004ed14368cf5,1,Martin Grund,2015-08-21 20:14:31+00:00,['9d83d1de83cf248bcf103632b6c8c6583fac119d'],15,96,111,2991465,9,,,,2689
ec671a406c6e310124bc09ab8961e9988dc65d5e,1,Internal Jenkins,2015-08-22 01:34:32+00:00,['5afd5bc8f6eb7bc5c77c668751c004ed14368cf5'],105,135,240,2991705,2,0,0.285714286,0,2689
b8b79303774a22816d9c6e63e36aeb514f525d86,1,Internal Jenkins,2015-08-22 01:46:26+00:00,['ec671a406c6e310124bc09ab8961e9988dc65d5e'],144,330,474,2992179,15,0.583333333,0,1,2689
1c5c2a666453c21c8e21cc2fc53403a0fdca578b,0,David Alves,2015-08-21 18:55:49-07:00,['d439717ab7cb8935c20a79067c83287ff1cd3dc9'],2,2,4,2992183,1,,,,2689
14a8cadcf6d0b09a4bf9373756f4773ebf46db12,1,Internal Jenkins,2015-08-22 09:26:35+00:00,['b8b79303774a22816d9c6e63e36aeb514f525d86'],41,108,149,2992332,11,1,1,1,2689
af4ac802e7880ce0b81e2bd8eee3e953c0a132bc,1,Internal Jenkins,2015-08-22 23:36:15+00:00,['14a8cadcf6d0b09a4bf9373756f4773ebf46db12'],0,2419,2419,2994751,2,1,1,1,2690
87a77c2517a816bef16d860c2e19f81d941d049a,0,Internal Jenkins,2015-08-23 01:55:14+00:00,['af4ac802e7880ce0b81e2bd8eee3e953c0a132bc'],46,12,58,2994809,4,0.6,0.4,1,2690
ae9fd52c5120a82623819242e914ba155f2cd8dd,1,Internal Jenkins,2015-08-23 04:43:37+00:00,['87a77c2517a816bef16d860c2e19f81d941d049a'],4,53,57,2994866,4,0,1,1,2690
75691156be951795f81bd6c0a6c3a887f1dc99ed,1,Internal Jenkins,2015-08-25 00:12:52+00:00,['ae9fd52c5120a82623819242e914ba155f2cd8dd'],39,39,78,2994944,1,,,,2690
927b8a4d39499c72ae1ec4dc5dae51fccc227b95,0,Internal Jenkins,2015-08-25 03:02:54+00:00,['75691156be951795f81bd6c0a6c3a887f1dc99ed'],0,1,1,2994945,1,,,,2690
6f0b255c5ac2b8d0d2980ce1db18cc272f0ee4aa,1,Internal Jenkins,2015-08-25 09:52:18+00:00,['927b8a4d39499c72ae1ec4dc5dae51fccc227b95'],252,474,726,2995671,11,0.640625,1,0.484375,2691
6627604655e85500a52a3920f9c6d33f81ff0c63,1,Internal Jenkins,2015-08-25 17:55:10+00:00,['6f0b255c5ac2b8d0d2980ce1db18cc272f0ee4aa'],79,629,708,2996379,9,0.172222222,0.85,0.694444444,2692
452ebee59d8d273ea3369ae291f191317a9dec93,1,Internal Jenkins,2015-08-25 23:28:13+00:00,['6627604655e85500a52a3920f9c6d33f81ff0c63'],5,81,86,2996465,4,0.8125,0.8125,0.8125,2692
1a9fc47295cb5e76e9f2a443cdb3fb2bfb2674c6,0,Internal Jenkins,2015-08-26 00:36:51+00:00,['452ebee59d8d273ea3369ae291f191317a9dec93'],37,37,74,2996539,1,,,,2692
99db6812a9603996c2b1ae020f6b24c18acc3246,0,Internal Jenkins,2015-08-26 02:59:27+00:00,['1a9fc47295cb5e76e9f2a443cdb3fb2bfb2674c6'],1,1,2,2996541,1,,,,2692
b8cd78823a1fa1523546d33c62342111c6378bdf,1,Internal Jenkins,2015-08-26 03:03:32+00:00,['99db6812a9603996c2b1ae020f6b24c18acc3246'],60,205,265,2996806,10,1,0.431818182,0.431818182,2693
9bd86d53c12abd19ff62cd34cdd9e25f374e365d,0,Internal Jenkins,2015-08-26 06:56:24+00:00,['b8cd78823a1fa1523546d33c62342111c6378bdf'],1,1,2,2996808,1,,,,2693
dcad11c3af54d94edef710ebc005d81109152fd4,0,Internal Jenkins,2015-08-26 10:10:32+00:00,['9bd86d53c12abd19ff62cd34cdd9e25f374e365d'],7,48,55,2996863,1,0.4375,0,0.46875,2693
a647cad5700710b455b273d97f53f5349cfdd35c,1,Internal Jenkins,2015-08-26 10:15:03+00:00,['dcad11c3af54d94edef710ebc005d81109152fd4'],6,6,12,2996875,4,,,,2693
9dbdf81fbd0b481e504b17a22b839c793cd58044,1,Internal Jenkins,2015-08-26 10:39:12+00:00,['a647cad5700710b455b273d97f53f5349cfdd35c'],8,48,56,2996931,3,0.055555556,0.055555556,1,2693
60c5140ea7b8742202f211d8a9deb4883bb3fd65,1,Internal Jenkins,2015-08-26 22:19:33+00:00,['9dbdf81fbd0b481e504b17a22b839c793cd58044'],2,270,272,2997203,9,0.208333333,0.208333333,0.75,2694
2db0371a264644914f8b6cd18234ce09bcf243fa,1,Internal Jenkins,2015-08-27 04:17:05+00:00,['60c5140ea7b8742202f211d8a9deb4883bb3fd65'],0,167,167,2997370,4,0.348623853,0.80733945,0.642201835,2694
d42ecb310a9ed06ea0bd82d940f820c90920884b,1,Internal Jenkins,2015-08-27 18:50:58+00:00,['2db0371a264644914f8b6cd18234ce09bcf243fa'],0,8,8,2997378,1,,,,2694
b761290cdba4e2db19de3aaa5b39139be5589efd,1,Internal Jenkins,2015-08-27 23:23:39+00:00,['d42ecb310a9ed06ea0bd82d940f820c90920884b'],33,43,76,2997454,8,0.125,0.375,0,2694
fa5eca09c8ec4775ab00986e28ef5e4d3b87bb51,1,Internal Jenkins,2015-08-27 23:34:30+00:00,['b761290cdba4e2db19de3aaa5b39139be5589efd'],18,131,149,2997603,3,0.62745098,1,0.901960784,2695
672f040d0334f7bfd7ce6e66299908096a2d395c,1,Internal Jenkins,2015-08-28 00:34:40+00:00,['fa5eca09c8ec4775ab00986e28ef5e4d3b87bb51'],33,113,146,2997749,5,0,0.607142857,1,2695
59a220cdb30072a5729ff215de64f7cff35e0718,0,Internal Jenkins,2015-08-28 02:46:57+00:00,['672f040d0334f7bfd7ce6e66299908096a2d395c'],0,0,0,2997749,0,,,,2695
c7ad002a20b26ec29e69fcbd61627f1d30458a19,1,Internal Jenkins,2015-08-28 04:15:30+00:00,['59a220cdb30072a5729ff215de64f7cff35e0718'],10,13,23,2997772,2,0,0,1,2695
fdb90ed753f51ecdaa009c1d25f2c1768c5680be,1,Internal Jenkins,2015-08-28 23:58:36+00:00,['c7ad002a20b26ec29e69fcbd61627f1d30458a19'],165,683,848,2998620,16,0.280542986,0.533936652,0.7239819,2695
c66785be4a018293f8cb60b7d98584f80bc16552,0,Internal Jenkins,2015-08-29 00:40:41+00:00,['fdb90ed753f51ecdaa009c1d25f2c1768c5680be'],4,3,7,2998627,1,,,,2695
30acd08f6e025a59972d708f352d9cfb49926c9a,1,David Alves,2015-08-28 18:57:38-07:00,['1c5c2a666453c21c8e21cc2fc53403a0fdca578b'],67,109,176,2998803,2,0,1,0.7,2695
6b6e3bf9479cd70ef7d438fe94ad2b5dbbe3a2a9,1,David Alves,2015-08-28 18:58:22-07:00,['30acd08f6e025a59972d708f352d9cfb49926c9a'],3,96,99,2998902,2,0.092307692,0.4,0.692307692,2695
e6311c018be0e42a89d12da74d530cee179939ad,1,David Alves,2015-08-28 19:23:48-07:00,['6b6e3bf9479cd70ef7d438fe94ad2b5dbbe3a2a9'],81,260,341,2999243,5,0.101851852,0.518518519,0.925925926,2695
d94a930ef07f691e5202a6d6c473d6bf5fa0ee33,0,Internal Jenkins,2015-08-29 23:45:11+00:00,['c66785be4a018293f8cb60b7d98584f80bc16552'],4,45,49,2999292,2,1,1,1,2695
b4020035326d1ba4db272b8ba13f095ba868183c,1,Tim Armstrong,2015-08-31 18:45:57+00:00,['d94a930ef07f691e5202a6d6c473d6bf5fa0ee33'],163,673,836,3000128,10,0.39862543,0.560137457,0.852233677,2697
9aa78c07278b36fbd70391b84eaf52d771cdfa8f,1,Internal Jenkins,2015-08-31 19:10:15+00:00,['b4020035326d1ba4db272b8ba13f095ba868183c'],6,99,105,3000233,2,0.770491803,0.770491803,1,2697
0a4981cd47a05d2670decd19ace12cb7ff91c565,1,Internal Jenkins,2015-08-31 20:24:14+00:00,['9aa78c07278b36fbd70391b84eaf52d771cdfa8f'],6,70,76,3000309,3,0,0.892857143,1,2697
d52318d64813b5d2be3927ac5b977317fae5e319,1,Internal Jenkins,2015-09-01 00:57:01+00:00,['0a4981cd47a05d2670decd19ace12cb7ff91c565'],27,172,199,3000508,4,0.09,0.97,0.99,2697
9d46853fbcc0fa86ffdee3a5027fa60b8207808c,1,Internal Jenkins,2015-09-01 03:26:53+00:00,['d52318d64813b5d2be3927ac5b977317fae5e319'],51,336,387,3000895,19,0.517241379,0.517241379,1,2698
d7e52e336a740f0c6ea17e2bab3df51ce03fde43,1,Internal Jenkins,2015-09-01 10:46:16+00:00,['9d46853fbcc0fa86ffdee3a5027fa60b8207808c'],16,38,54,3000949,3,0,0.75,1,2698
f927a285c67876f462d45441bf56bf170569d48b,1,Martin Grund,2015-09-02 00:37:28+00:00,['d7e52e336a740f0c6ea17e2bab3df51ce03fde43'],1,25,26,3000975,4,1,1,1,2699
9e4d91ef06abb235d44d668a97fe631ff94e558c,0,Internal Jenkins,2015-09-02 03:08:59+00:00,['f927a285c67876f462d45441bf56bf170569d48b'],0,0,0,3000975,0,,,,2699
f6985772dc3e628ddc15a0612f9514730a7a8389,0,Internal Jenkins,2015-09-02 04:29:41+00:00,['9e4d91ef06abb235d44d668a97fe631ff94e558c'],20,227,247,3001222,1,,,,2699
62b31bdb528c6b563250aee538a721c559a2d3bb,0,Internal Jenkins,2015-09-02 10:30:24+00:00,['f6985772dc3e628ddc15a0612f9514730a7a8389'],28,80,108,3001330,8,1,1,1,2699
9a80402e47d0d8465011b7d95fa9b01af486cbb3,1,Internal Jenkins,2015-09-02 11:07:03+00:00,['62b31bdb528c6b563250aee538a721c559a2d3bb'],34,177,211,3001541,7,0.148148148,0.925925926,0.916666667,2699
bcc73a36dae7107e525a170da730e8e99917c540,1,Internal Jenkins,2015-09-02 19:23:54+00:00,['9a80402e47d0d8465011b7d95fa9b01af486cbb3'],423,4169,4592,3006133,31,0.27032967,0.503296703,0.356043956,2713
cfc3952a83ca97b1aeac84693d5cbb094d29bc06,1,Internal Jenkins,2015-09-03 01:19:43+00:00,['bcc73a36dae7107e525a170da730e8e99917c540'],12,181,193,3006326,10,0.177083333,1,0.9375,2713
5b1157b44b189e5b7e26ad14991e34966c26802c,1,Internal Jenkins,2015-09-03 01:54:32+00:00,['cfc3952a83ca97b1aeac84693d5cbb094d29bc06'],131,835,966,3007292,14,0.379385965,0.734649123,0.710526316,2713
8586ec52802d6f4722df103f7d3051f52a6b280a,0,Casey Ching,2015-09-03 19:23:39+00:00,['5b1157b44b189e5b7e26ad14991e34966c26802c'],1,1,2,3007294,1,,,,2713
21a7a06b8391b3bc77637ed2daab6a5b0b8134d0,1,Martin Grund,2015-09-03 15:39:04-07:00,['e6311c018be0e42a89d12da74d530cee179939ad'],7,7,14,3007308,2,,,,2713
5056431f298ff15c4a50085f25178b70ebe0f2da,0,Internal Jenkins,2015-09-03 23:35:26+00:00,['8586ec52802d6f4722df103f7d3051f52a6b280a'],19,7,26,3007334,2,1,1,0,2713
8d56b7e23e3fc6ad8f4bef6ce8cdaa9590022da7,1,Martin Grund,2015-09-03 16:44:10-07:00,['21a7a06b8391b3bc77637ed2daab6a5b0b8134d0'],3,60,63,3007397,5,1,1,1,2714
e2270f120161ee78c9c6c88af3d1f90572fa9dbe,0,Internal Jenkins,2015-09-04 03:18:49+00:00,['5056431f298ff15c4a50085f25178b70ebe0f2da'],1,1,2,3007399,1,,,,2714
38fe995f331b696f55a014c9a2c086630dd7abd1,1,Internal Jenkins,2015-09-04 04:23:44+00:00,['e2270f120161ee78c9c6c88af3d1f90572fa9dbe'],17,13,30,3007429,2,0,0,0,2714
4ac7e5d15d3fba11ae37e5826ca6c7181539804b,1,Internal Jenkins,2015-09-04 05:38:17+00:00,['38fe995f331b696f55a014c9a2c086630dd7abd1'],0,2,2,3007431,1,1,1,1,2714
19b444aedd7e6e8910961a300fad3204f121a463,1,Martin Grund,2015-09-03 22:39:57-07:00,['8d56b7e23e3fc6ad8f4bef6ce8cdaa9590022da7'],0,78,78,3007509,4,0.105263158,1,1,2715
52f6deec356b9c872575dc5aad12dea963741879,1,Martin Grund,2015-09-03 22:40:17-07:00,['19b444aedd7e6e8910961a300fad3204f121a463'],4,24,28,3007537,3,0,0,1,2715
2e597a5cab4aadc24023b5723b5e82762de9e33b,1,Martin Grund,2015-09-03 22:59:35-07:00,['52f6deec356b9c872575dc5aad12dea963741879'],26,25,51,3007588,2,1,1,1,2715
3278ab9ef71155675054385e317257bb3a70cea4,0,Ishaan Joshi,2015-09-04 06:46:35+00:00,['4ac7e5d15d3fba11ae37e5826ca6c7181539804b'],1,1,2,3007590,1,,,,2715
d48ec4b8b32cdcb8ce69b0473991dde111dcc976,0,Internal Jenkins,2015-09-04 20:26:52+00:00,['3278ab9ef71155675054385e317257bb3a70cea4'],2,26,28,3007618,4,0,0,0,2715
cbfc65e0416a1130a9593ed5af8db1409476228b,0,Internal Jenkins,2015-09-04 21:51:26+00:00,['d48ec4b8b32cdcb8ce69b0473991dde111dcc976'],7,15,22,3007640,1,0,1,1,2715
956c9d74fa26310b9e6a607788b0e70f2e2aa18c,0,Internal Jenkins,2015-09-04 22:44:20+00:00,['cbfc65e0416a1130a9593ed5af8db1409476228b'],14,25,39,3007679,1,1,1,0.375,2715
4b007666ebec74bde88daa10a27292f37453baeb,0,Internal Jenkins,2015-09-05 02:05:11+00:00,['956c9d74fa26310b9e6a607788b0e70f2e2aa18c'],1,1,2,3007681,1,,,,2715
fa5eca0e0519ecd4a65b387ecb1eba57fb8896c0,0,Martin Grund,2015-09-04 20:49:08-07:00,['2e597a5cab4aadc24023b5723b5e82762de9e33b'],2,2,4,3007685,1,,,,2715
270f12b09a958ba85cf3a9368983ccda6e23f9fa,0,Internal Jenkins,2015-09-05 09:44:55+00:00,['4b007666ebec74bde88daa10a27292f37453baeb'],1,1,2,3007687,1,,,0,2715
4457eb2df35b3eaa6d4c96d1dd4f94e6e2374fe3,1,Internal Jenkins,2015-09-05 19:20:22+00:00,['270f12b09a958ba85cf3a9368983ccda6e23f9fa'],6,14,20,3007707,1,0,0,0,2715
f647b36e5874496dcb5485881525746855a1743e,0,Internal Jenkins,2015-09-06 05:29:22+00:00,['4457eb2df35b3eaa6d4c96d1dd4f94e6e2374fe3'],4,28,32,3007739,4,1,1,1,2715
dbb40c792274ee3ce99be9ecfa6d5b22d6f6fcf2,1,Internal Jenkins,2015-09-06 20:49:42+00:00,['f647b36e5874496dcb5485881525746855a1743e'],0,86,86,3007825,1,1,1,1,2716
4c95469a8098c37ad78c900c058040823a423506,0,Internal Jenkins,2015-09-06 22:48:25+00:00,['dbb40c792274ee3ce99be9ecfa6d5b22d6f6fcf2'],5,9,14,3007839,3,0,0,0,2716
0c4a7cbec2bd9e56b7850d3947fafec9c1c11813,1,Martin Grund,2015-09-06 21:23:57-07:00,['fa5eca0e0519ecd4a65b387ecb1eba57fb8896c0'],2,3,5,3007844,2,0,0,1,2716
5e733e8d62ea2768f527350afe8b2efd05602069,1,Internal Jenkins,2015-09-07 07:07:20+00:00,['4c95469a8098c37ad78c900c058040823a423506'],40,194,234,3008078,5,0.32038835,1,0.805825243,2716
662bc24c79e5f3d8e1b92e6fe70b28b71cd121fd,0,Internal Jenkins,2015-09-08 19:57:55+00:00,['5e733e8d62ea2768f527350afe8b2efd05602069'],65,13,78,3008156,1,,,,2716
af85fa63dafc4cadf9f3848e65306ad5c1ee48ba,0,Internal Jenkins,2015-09-08 20:08:21+00:00,['662bc24c79e5f3d8e1b92e6fe70b28b71cd121fd'],1,1,2,3008158,1,,,,2716
d73683b320cb8fe579bbf4ac952e664d148af176,0,Internal Jenkins,2015-09-08 21:57:52+00:00,['af85fa63dafc4cadf9f3848e65306ad5c1ee48ba'],1,3,4,3008162,1,,,,2716
5ac55f24ccbc452d7c363c6ad45c4ea5736f90e6,0,Internal Jenkins,2015-09-08 23:40:53+00:00,['d73683b320cb8fe579bbf4ac952e664d148af176'],7,54,61,3008223,3,0,0,1,2716
ed0b1e94d30d63d7f017ec830a8df7c3a1820c15,1,Internal Jenkins,2015-09-09 00:26:11+00:00,['5ac55f24ccbc452d7c363c6ad45c4ea5736f90e6'],2,2,4,3008227,1,,,,2716
1ae79dbb0a6ea9afdbe7b04b305e8ed5471be79a,0,Internal Jenkins,2015-09-09 01:33:37+00:00,['ed0b1e94d30d63d7f017ec830a8df7c3a1820c15'],5,14,19,3008246,3,0.666666667,1,1,2716
235a8d08da9fbc1aaa170c952c87f078623cc506,1,Internal Jenkins,2015-09-09 02:39:14+00:00,['1ae79dbb0a6ea9afdbe7b04b305e8ed5471be79a'],47,308,355,3008601,8,0.042105263,0.489473684,0.547368421,2716
94db0d3e402a30e1463a7d68686c771bfbd8f436,1,Internal Jenkins,2015-09-09 02:55:23+00:00,['235a8d08da9fbc1aaa170c952c87f078623cc506'],4,7,11,3008612,1,,,,2716
2e4e89c26777aa7691034821d8311f2d5e55620e,0,Internal Jenkins,2015-09-09 03:17:25+00:00,['94db0d3e402a30e1463a7d68686c771bfbd8f436'],0,1,1,3008613,1,,,,2716
8809567e822df5e18675d03704c9eab847caf87c,0,Henry Robinson,2015-09-09 04:15:30+00:00,['2e4e89c26777aa7691034821d8311f2d5e55620e'],6,16,22,3008635,2,1,1,1,2716
1beb8cc36d5401502e6172488e12701734042747,0,Internal Jenkins,2015-09-09 10:32:06+00:00,['8809567e822df5e18675d03704c9eab847caf87c'],0,3,3,3008638,1,,,,2716
0d484a97ceebce8ac416ae35ed0c763f7473886f,1,Todd Lipcon,2015-09-09 07:55:54-07:00,['0c4a7cbec2bd9e56b7850d3947fafec9c1c11813'],2,2,4,3008642,1,,,,2716
77774cbc6289e4cfb96a3ce95341f80dd4c96fa3,1,Todd Lipcon,2015-09-09 07:56:11-07:00,['0d484a97ceebce8ac416ae35ed0c763f7473886f'],29,171,200,3008842,3,0.734693878,1,1,2716
c404f2ea2e2d6742c3a81802170d97b4a5debd4b,1,Internal Jenkins,2015-09-09 17:48:36+00:00,['1beb8cc36d5401502e6172488e12701734042747'],2,45,47,3008889,2,0.730769231,1,1,2716
3a5d8a01eb293e85a72a5f83c5cb7c843255cb6f,1,Internal Jenkins,2015-09-09 18:45:57+00:00,['c404f2ea2e2d6742c3a81802170d97b4a5debd4b'],1,33,34,3008923,4,0,0.703703704,1,2716
2f62d30ccb80f0f3c267a2419ce8c8946666851b,0,Internal Jenkins,2015-09-09 18:53:50+00:00,['3a5d8a01eb293e85a72a5f83c5cb7c843255cb6f'],3,9,12,3008935,3,,,,2716
52b0e04c787443bc3bc5f9633b57779ea1ac3dfe,1,Internal Jenkins,2015-09-09 23:31:55+00:00,['2f62d30ccb80f0f3c267a2419ce8c8946666851b'],10,38,48,3008983,3,1,1,1,2716
1ab0b1289f64c1f9b82bed524f1a18db655ffa5e,1,Martin Grund,2015-09-09 17:02:45-07:00,['77774cbc6289e4cfb96a3ce95341f80dd4c96fa3'],21,49,70,3009053,7,0,0.5,0,2716
3c8241381f6b8bf25d2a2dfb2d46942ac804527b,0,Martin Grund,2015-09-09 17:02:56-07:00,['1ab0b1289f64c1f9b82bed524f1a18db655ffa5e'],1,7,8,3009061,1,0,1,1,2716
4204287069a76bac1d50b7194c9552ac4c6fa5c2,1,Internal Jenkins,2015-09-10 03:02:44+00:00,['52b0e04c787443bc3bc5f9633b57779ea1ac3dfe'],147,709,856,3009917,23,0.189759036,0.831325301,0.906626506,2717
361da011524546e36be07fa0200eb18e24b94134,1,Internal Jenkins,2015-09-10 04:50:31+00:00,['4204287069a76bac1d50b7194c9552ac4c6fa5c2'],0,101,101,3010018,3,0.695652174,0.695652174,0.695652174,2719
15a175b3b91e3b00ac7b1fac1fb7ed0f708a1a5c,0,Internal Jenkins,2015-09-10 04:55:05+00:00,['361da011524546e36be07fa0200eb18e24b94134'],12,16,28,3010046,1,0,0,0,2719
deb9c6f8e636fc7579c487791f5f40f51228e236,1,Internal Jenkins,2015-09-10 05:44:55+00:00,['15a175b3b91e3b00ac7b1fac1fb7ed0f708a1a5c'],15,167,182,3010228,9,0,0.372093023,0.209302326,2719
5c740c95c8ab83a11a619383918817765977c1af,1,Internal Jenkins,2015-09-10 08:31:15+00:00,['deb9c6f8e636fc7579c487791f5f40f51228e236'],11,14,25,3010253,4,0.666666667,1,1,2719
26479e1162a4370480510543f9305838a2aa0303,0,Internal Jenkins,2015-09-10 09:59:50+00:00,['5c740c95c8ab83a11a619383918817765977c1af'],41,79,120,3010373,1,0,1,0.275862069,2719
a46cd32b7e92be2184d0e1548799d7dc06dfa4ce,1,Martin Grund,2015-09-10 06:21:08-07:00,['3c8241381f6b8bf25d2a2dfb2d46942ac804527b'],5,31,36,3010409,4,0.4,0.4,1,2720
e9e43488cf636df007bc310decbfd2ec700f3a31,0,Internal Jenkins,2015-09-10 17:46:21+00:00,['26479e1162a4370480510543f9305838a2aa0303'],2,89,91,3010500,3,0.111111111,0.111111111,1,2720
302df6be5d5f68454a3b8148ce74b35f1fd683d3,0,Internal Jenkins,2015-09-10 21:27:52+00:00,['e9e43488cf636df007bc310decbfd2ec700f3a31'],8,9,17,3010517,2,,,,2720
1331599fe8f9a71294e7aae0673d742b987608ef,0,Martin Grund,2015-09-10 20:58:30-07:00,['a46cd32b7e92be2184d0e1548799d7dc06dfa4ce'],1,1,2,3010519,1,,,,2720
cde8437bde966029e95377a055ae80a6b2017711,1,Martin Grund,2015-09-11 10:46:27-07:00,['1331599fe8f9a71294e7aae0673d742b987608ef'],4,4,8,3010527,3,,,,2720
ece7fed4213997306e9a2eebc886cf89b4faf216,1,Internal Jenkins,2015-09-11 20:37:27+00:00,['302df6be5d5f68454a3b8148ce74b35f1fd683d3'],3,48,51,3010578,7,0,1,1,2720
1fe817f9f1036e8a5b6a35c101805e2dac4ecc5d,0,Internal Jenkins,2015-09-11 21:45:16+00:00,['ece7fed4213997306e9a2eebc886cf89b4faf216'],61,101,162,3010740,5,1,0,1,2720
25e7454bc9fd81dc9ab405e38a45eb573ac65001,0,Internal Jenkins,2015-09-11 22:45:39+00:00,['1fe817f9f1036e8a5b6a35c101805e2dac4ecc5d'],4,35,39,3010779,4,0.5,0.5,0.5,2720
14bd3611438e959fe3c30b9439fbca8f808ccdcb,0,Tim Armstrong,2015-09-13 08:29:25-07:00,['25e7454bc9fd81dc9ab405e38a45eb573ac65001'],19,0,19,3010798,1,,,,2720
ecdd5688b90c7298ff04b28e0e28ff1568fcf214,0,ishaan,2015-09-14 13:43:01-07:00,['14bd3611438e959fe3c30b9439fbca8f808ccdcb'],10,52,62,3010860,3,0,0,0.5,2720
64360d4701fb7adc0630938e8aae9fd87f873bfa,1,ishaan,2015-09-14 13:43:01-07:00,['ecdd5688b90c7298ff04b28e0e28ff1568fcf214'],8,94,102,3010962,3,1,1,0.72,2721
f57ce3436ccfd18db1e543dd74f63b7ec6ad10a3,1,ishaan,2015-09-14 13:43:01-07:00,['64360d4701fb7adc0630938e8aae9fd87f873bfa'],11,37,48,3011010,5,0.3,0.3,0.9,2721
8c55f9b2f5ac2bb65e1e1bb8fc2adb671231c60e,0,ishaan,2015-09-14 13:43:01-07:00,['f57ce3436ccfd18db1e543dd74f63b7ec6ad10a3'],5,1,6,3011016,1,,,,2721
f46aa381619a0d95ccecff99a62cb97dd0691dfb,1,ishaan,2015-09-14 13:43:01-07:00,['8c55f9b2f5ac2bb65e1e1bb8fc2adb671231c60e'],0,26,26,3011042,2,0,0,1,2721
41ef3a216d56db291aa8cf040fc03b2063ce0add,1,ishaan,2015-09-14 13:43:01-07:00,['f46aa381619a0d95ccecff99a62cb97dd0691dfb'],267,441,708,3011750,4,1,1,1,2722
930f31c28f69bf6d41a97b390048b6877b978b5d,0,ishaan,2015-09-14 13:43:02-07:00,['41ef3a216d56db291aa8cf040fc03b2063ce0add'],1,1,2,3011752,1,,,,2722
365263b39883d3465a03bcea243a740c480aac3e,1,ishaan,2015-09-14 13:43:02-07:00,['930f31c28f69bf6d41a97b390048b6877b978b5d'],0,18,18,3011770,2,1,1,1,2722
79e1ca689fa729d85f0f9d92c783cdd982984179,0,ishaan,2015-09-14 13:43:02-07:00,['365263b39883d3465a03bcea243a740c480aac3e'],0,4,4,3011774,1,0,0,0.5,2722
890abda16dc75f767db1b8923c7bdc7055b46e32,0,ishaan,2015-09-15 08:38:07-07:00,['79e1ca689fa729d85f0f9d92c783cdd982984179'],3,42,45,3011819,2,0,1,1,2722
d7ae529dac899035e6ff7219d9babddfe06530ff,0,ishaan,2015-09-15 08:38:09-07:00,['890abda16dc75f767db1b8923c7bdc7055b46e32'],1,15,16,3011835,2,,,,2722
1a72618fa02639b2aef95c80a9271df882726cb8,0,ishaan,2015-09-15 08:38:11-07:00,['d7ae529dac899035e6ff7219d9babddfe06530ff'],1,1,2,3011837,1,,,,2722
aa7eb329a5d5a42e61902433caa8808d29b02b7a,1,ishaan,2015-09-15 08:38:13-07:00,['1a72618fa02639b2aef95c80a9271df882726cb8'],90,87,177,3012014,4,1,1,1,2722
4b5f1582e940f8fa16416c080a29e1a255df2a36,0,ishaan,2015-09-15 08:38:15-07:00,['aa7eb329a5d5a42e61902433caa8808d29b02b7a'],0,5,5,3012019,1,,,,2722
e06764fb16cf2f58bf712811a0d48fa3297f439b,1,ishaan,2015-09-15 08:38:17-07:00,['4b5f1582e940f8fa16416c080a29e1a255df2a36'],6,10,16,3012035,2,,,,2722
712ced6b9fcb8c8449cc2bf5dea89bdcd5cbc4c1,1,David Alves,2015-09-15 09:07:50-07:00,['cde8437bde966029e95377a055ae80a6b2017711'],14,29,43,3012078,4,0.125,0,0.75,2722
6593d98f0e106effd29dfb0748f7ef2120167ff2,1,David Alves,2015-09-15 09:08:12-07:00,['712ced6b9fcb8c8449cc2bf5dea89bdcd5cbc4c1'],16,23,39,3012117,2,1,1,1,2722
cd5c344dcd2de02fe586972b37baaeaf9cc9d256,1,David Alves,2015-09-15 14:46:02-07:00,['6593d98f0e106effd29dfb0748f7ef2120167ff2'],1,73,74,3012191,5,0.709677419,1,0.741935484,2723
3b0ed19eb63efc5858defd7e5ef8480dd02e8280,1,Martin Grund,2015-09-16 11:21:45-07:00,['cd5c344dcd2de02fe586972b37baaeaf9cc9d256'],134,923,1057,3013248,19,0.234899329,0.520134228,0.812080537,2725
6405d947d39ea8c036de0e80fb7d43d0fc2b80d1,0,ishaan,2015-09-16 13:51:30-07:00,['e06764fb16cf2f58bf712811a0d48fa3297f439b'],0,0,0,3013248,0,,,,2725
b9cac28ae5586753de0004b140ba1ca3a11e6282,0,ishaan,2015-09-16 15:03:38-07:00,['6405d947d39ea8c036de0e80fb7d43d0fc2b80d1'],6,6,12,3013260,1,,,,2725
6cfcde1a22a2728488239eac21464ca4a647a69c,0,David Alves,2015-09-16 16:02:40-07:00,['3b0ed19eb63efc5858defd7e5ef8480dd02e8280'],10,81,91,3013351,3,0,0,1,2725
226ff25508080baa318f770c56703c1f9dfc2fd0,1,David Alves,2015-09-16 16:24:44-07:00,['6cfcde1a22a2728488239eac21464ca4a647a69c'],22,39,61,3013412,3,0.5,0.5,1,2725
c208a0093708daff690dbacf1601611212577982,0,David Alves,2015-09-16 16:24:55-07:00,['226ff25508080baa318f770c56703c1f9dfc2fd0'],16,93,109,3013521,3,0.157894737,0,0.105263158,2725
4b102fefd269a67421d03ddeaafb8f4d149d1dd9,1,Martin Grund,2015-09-16 16:43:47-07:00,['c208a0093708daff690dbacf1601611212577982'],63,68,131,3013652,9,1,0.25,0,2725
368c7e70b133ba5b4f1315fa488e61fbbf3261f0,1,ishaan,2015-09-16 20:49:40-07:00,['b9cac28ae5586753de0004b140ba1ca3a11e6282'],28,28,56,3013708,3,,,,2725
ade028cdf30dc5c2cbe2e12659243711296059c2,1,Martin Grund,2015-09-17 12:35:23-07:00,['4b102fefd269a67421d03ddeaafb8f4d149d1dd9'],40,7,47,3013755,3,1,1,0,2725
3ed9d8c3fe46cd932c7475ad1389ac973fd6c3bc,1,Ishaan Joshi,2015-09-17 23:37:58+00:00,['368c7e70b133ba5b4f1315fa488e61fbbf3261f0'],1,1,2,3013757,1,,,,2725
d7d6b381e09a63640735571bc48d2a68fb4d7df2,0,Martin Grund,2015-09-17 18:20:27-07:00,['ade028cdf30dc5c2cbe2e12659243711296059c2'],25,27,52,3013809,6,1,1,1,2725
a3aa2c22982f65b7115d35391296f361ec604fda,0,Martin Grund,2015-09-18 20:49:51-07:00,['d7d6b381e09a63640735571bc48d2a68fb4d7df2'],38,54,92,3013901,1,0,0.5,1,2725
caff1830ab9990d4750cb2996fb25b72ccec17da,0,Martin Grund,2015-09-18 20:50:38-07:00,['a3aa2c22982f65b7115d35391296f361ec604fda'],14,25,39,3013940,1,1,1,0.375,2725
3e2b88face2e2dd0017202b56ab0e2e3dd7acd15,0,Martin Grund,2015-09-18 20:51:00-07:00,['caff1830ab9990d4750cb2996fb25b72ccec17da'],1,1,2,3013942,1,,,0,2725
0d15734e2b98d24c45187dd4b33fe65989b17cae,0,Martin Grund,2015-09-18 20:51:52-07:00,['3e2b88face2e2dd0017202b56ab0e2e3dd7acd15'],1,5,6,3013948,2,0,0,1,2725
128919f73aca14632022b8212bb96990148fd687,1,Martin Grund,2015-09-20 13:12:51-07:00,['0d15734e2b98d24c45187dd4b33fe65989b17cae'],45,188,233,3014181,17,0,0.107142857,0.321428571,2725
9f1c81436a06d9e723c6af687d6cd89cdcaaf069,1,David Alves,2015-09-20 17:02:23-07:00,['128919f73aca14632022b8212bb96990148fd687'],15,94,109,3014290,8,0.47826087,0.47826087,1,2725
14cfa60cbedd81d359faa9135933b89f959e3c8b,0,Todd Lipcon,2015-09-21 08:03:15-07:00,['9f1c81436a06d9e723c6af687d6cd89cdcaaf069'],2,2,4,3014294,2,,,,2725
15cf82bc50c939200efb523cc7360531ff0b97dc,0,Todd Lipcon,2015-09-21 08:03:22-07:00,['14cfa60cbedd81d359faa9135933b89f959e3c8b'],0,1,1,3014295,1,1,1,1,2725
df6f1ae8bbcd62f5c187d870a1c3c019d6053b12,1,Martin Grund,2015-09-21 16:18:59-07:00,['15cf82bc50c939200efb523cc7360531ff0b97dc'],5,47,52,3014347,2,0.192307692,0.615384615,0.423076923,2725
d2dc12b458a03fcd5f58989e37b2f8668598c0d0,1,Martin Grund,2015-09-21 16:41:00-07:00,['df6f1ae8bbcd62f5c187d870a1c3c019d6053b12'],1,4,5,3014352,1,0,0.666666667,1,2725
0d45555a74d0c71b29efedb3e3d16fd095b31325,1,Internal Jenkins,2015-09-22 03:29:50+00:00,['3ed9d8c3fe46cd932c7475ad1389ac973fd6c3bc'],3,9,12,3014364,2,1,1,1,2725
9ebe92c4f916ab1d74f40e516495edfdb19b7c6a,0,ishaan,2015-09-22 10:58:31-07:00,['0d45555a74d0c71b29efedb3e3d16fd095b31325'],0,58,58,3014422,3,0.777777778,0.777777778,0.814814815,2725
84e2c043a4a7c0bbf52bd0786924e2dd86d7c17e,0,ishaan,2015-09-22 10:58:32-07:00,['9ebe92c4f916ab1d74f40e516495edfdb19b7c6a'],4,43,47,3014469,2,0,0,1,2725
55374c2a606b4f5fc86f2da3ca65232534ef2879,0,ishaan,2015-09-22 10:58:32-07:00,['84e2c043a4a7c0bbf52bd0786924e2dd86d7c17e'],0,212,212,3014681,1,,,,2725
c5b9b7a97db7e0eb4a9cddcca21b01525cb99045,1,ishaan,2015-09-22 10:58:32-07:00,['55374c2a606b4f5fc86f2da3ca65232534ef2879'],43,51,94,3014775,3,0,0,0,2725
057b0b7dba1078829184db0bff238f4087daa7e5,1,ishaan,2015-09-22 10:58:32-07:00,['c5b9b7a97db7e0eb4a9cddcca21b01525cb99045'],0,36,36,3014811,3,0,0,1,2725
ef29c976dfa26f03c749cbdeb2d79205005df9d6,1,ishaan,2015-09-22 10:58:32-07:00,['057b0b7dba1078829184db0bff238f4087daa7e5'],3,62,65,3014876,3,0,0,1,2725
378ca8fa09444067a35a88639cdf767880456174,0,ishaan,2015-09-22 10:58:32-07:00,['ef29c976dfa26f03c749cbdeb2d79205005df9d6'],0,2,2,3014878,1,0,0,1,2725
e408560c56e74109fa96cb74afef53e1cfa3a2c1,1,ishaan,2015-09-22 10:58:32-07:00,['378ca8fa09444067a35a88639cdf767880456174'],239,208,447,3015325,5,0.607142857,0,0.464285714,2726
750786fee262e5c013026243e07bf4dbab17671c,1,ishaan,2015-09-22 10:58:32-07:00,['e408560c56e74109fa96cb74afef53e1cfa3a2c1'],15,23,38,3015363,1,0,0,1,2726
1da025fb0a28d1b33ceb0acde1535d33d96d0aaa,1,ishaan,2015-09-22 10:58:32-07:00,['750786fee262e5c013026243e07bf4dbab17671c'],37,59,96,3015459,3,0.083333333,0.083333333,0.916666667,2726
db7519df240e90673aa10abeb67defc1c8597e77,1,ishaan,2015-09-22 10:58:32-07:00,['1da025fb0a28d1b33ceb0acde1535d33d96d0aaa'],15,155,170,3015629,8,0.46,1,0.98,2727
0c90bf7ef588598c93ca6e428dd68ce7f1d6816f,1,ishaan,2015-09-22 10:58:33-07:00,['db7519df240e90673aa10abeb67defc1c8597e77'],30,112,142,3015771,6,0,0.941176471,0.882352941,2727
1c528492d31355badb2814cfff24e45263130d76,0,ishaan,2015-09-22 10:58:33-07:00,['0c90bf7ef588598c93ca6e428dd68ce7f1d6816f'],24,125,149,3015920,6,0.315789474,0.789473684,0.947368421,2727
0c574394d6d759a59af0b20d9c019f66967faf1d,0,ishaan,2015-09-22 10:58:33-07:00,['1c528492d31355badb2814cfff24e45263130d76'],28,97,125,3016045,2,0.023255814,0.093023256,0,2727
0d46129458cfdc96ce9744e1bdb57ceb1d6efd3d,0,ishaan,2015-09-22 10:58:33-07:00,['0c574394d6d759a59af0b20d9c019f66967faf1d'],0,8,8,3016053,2,0,0,1,2727
f732fe2cdfc35e810ea5c91037dce797a97b3f0a,1,ishaan,2015-09-22 10:58:33-07:00,['0d46129458cfdc96ce9744e1bdb57ceb1d6efd3d'],25,26,51,3016104,11,1,1,1,2727
b6db42e678ef4c3f903ffd5f507a111ea00b3f3c,0,ishaan,2015-09-22 10:58:33-07:00,['f732fe2cdfc35e810ea5c91037dce797a97b3f0a'],10,8,18,3016122,2,0,0,0,2727
0b614cf915ac138c5ae7863ae29a8fca4c2210a4,1,ishaan,2015-09-22 10:58:33-07:00,['b6db42e678ef4c3f903ffd5f507a111ea00b3f3c'],28,74,102,3016224,6,0,0,1,2727
2d0ed379a2dd065da202990994e159a5c09f22a5,0,ishaan,2015-09-22 10:58:33-07:00,['0b614cf915ac138c5ae7863ae29a8fca4c2210a4'],1,3,4,3016228,1,,,,2727
68bd90dbc20bebeffea994bf6c2a9ab33d908a4d,1,ishaan,2015-09-22 10:58:33-07:00,['2d0ed379a2dd065da202990994e159a5c09f22a5'],109,64,173,3016401,1,1,1,1,2727
0e1161b161760f98089460e0e09b1cc7aaf86ccd,1,ishaan,2015-09-22 10:58:33-07:00,['68bd90dbc20bebeffea994bf6c2a9ab33d908a4d'],6,56,62,3016463,2,0,0.775,0.775,2727
ceb0781c5b7d7dce8d6c3ee43fd59723cf764946,1,ishaan,2015-09-22 10:58:33-07:00,['0e1161b161760f98089460e0e09b1cc7aaf86ccd'],27,105,132,3016595,6,1,0.818181818,0.818181818,2727
85c02cb1444598c8c71bfce3fd19c8881fddc977,1,ishaan,2015-09-22 10:58:33-07:00,['ceb0781c5b7d7dce8d6c3ee43fd59723cf764946'],53,124,177,3016772,5,0,0.270833333,1,2727
b2e64e9265ded1913037d995956c6df9ac25771b,0,ishaan,2015-09-22 10:58:33-07:00,['85c02cb1444598c8c71bfce3fd19c8881fddc977'],0,2,2,3016774,1,1,1,1,2727
212901a352929b12b1867e67e8f2f2cb1284877a,1,ishaan,2015-09-22 10:58:34-07:00,['b2e64e9265ded1913037d995956c6df9ac25771b'],55,293,348,3017122,14,0,0.611650485,0.86407767,2727
f1e27200996c47a4c3199d505d75a9070ce59e85,1,ishaan,2015-09-22 10:58:34-07:00,['212901a352929b12b1867e67e8f2f2cb1284877a'],16,546,562,3017684,8,0.28,1,1,2727
ddbfa921f89a280d1228b343978a523c7d94b7ac,1,Martin Grund,2015-09-22 13:27:16-07:00,['d2dc12b458a03fcd5f58989e37b2f8668598c0d0'],48,58,106,3017790,3,0,0,1,2727
57dd4d1502e095dcafdb4b45c4265e619cced6b0,1,Internal Jenkins,2015-09-23 09:42:17+00:00,['f1e27200996c47a4c3199d505d75a9070ce59e85'],44,458,502,3018292,9,0.098765432,0,0.814814815,2727
4d5ee2b3a27377eb449e575656523627c62f0147,1,ishaan,2015-09-23 10:38:58-07:00,['57dd4d1502e095dcafdb4b45c4265e619cced6b0'],19,49,68,3018360,3,1,1,1,2727
04eecf1f0895906c1aaac8fd7a6fb9d0226fa95e,1,ishaan,2015-09-23 10:38:59-07:00,['4d5ee2b3a27377eb449e575656523627c62f0147'],5,23,28,3018388,2,,,,2727
48699de6e36527d7e3ca7d2a40187f0d8e724409,1,ishaan,2015-09-23 11:07:42-07:00,['04eecf1f0895906c1aaac8fd7a6fb9d0226fa95e'],220,336,556,3018944,25,0.471698113,0,0.905660377,2728
549b01c23316772e4580eb27fd76e1fd4af885cb,0,ishaan,2015-09-23 15:15:51-07:00,['48699de6e36527d7e3ca7d2a40187f0d8e724409'],3,10,13,3018957,2,1,1,1,2728
f61b86f06030b7d01ecbde8d2f77032a503a3ae7,1,ishaan,2015-09-23 15:15:52-07:00,['549b01c23316772e4580eb27fd76e1fd4af885cb'],28,49,77,3019034,2,0,1,1,2728
8bdc7a2a332a4ea71d798674743e8b569af2afa9,0,ishaan,2015-09-23 15:15:53-07:00,['f61b86f06030b7d01ecbde8d2f77032a503a3ae7'],0,11,11,3019045,1,0,0.428571429,0.142857143,2728
474026e7852c9fe4ceae198ebe10cdd6aecbf0e3,0,ishaan,2015-09-23 15:15:54-07:00,['8bdc7a2a332a4ea71d798674743e8b569af2afa9'],18,21,39,3019084,2,0,0,0,2728
579be1c5422ea2befcfda814c1cbe3cd5eaf391c,1,ishaan,2015-09-23 15:15:55-07:00,['474026e7852c9fe4ceae198ebe10cdd6aecbf0e3'],47,181,228,3019312,11,0.604166667,0.5625,0.333333333,2729
df171aa109d0a3838413460dfddfc30c1a9906c0,1,David Alves,2015-09-23 15:37:45-07:00,['ddbfa921f89a280d1228b343978a523c7d94b7ac'],0,43,43,3019355,4,1,1,1,2730
0f7d93a77585eb473634101b50801d3062117cdf,1,Martin Grund,2015-09-23 16:01:29-07:00,['df171aa109d0a3838413460dfddfc30c1a9906c0'],1,460,461,3019816,2,0.265363128,0.351955307,0.625698324,2731
fcf18ebc0441244ec75ec4364ee3e9545a1faee3,0,David Alves,2015-09-23 21:20:53-07:00,['0f7d93a77585eb473634101b50801d3062117cdf'],33,58,91,3019907,5,1,1,0.818181818,2731
b8d15adcaf6ed1edf7e04bade39f46b91e8c192b,0,ishaan,2015-09-24 10:58:54-07:00,['579be1c5422ea2befcfda814c1cbe3cd5eaf391c'],1,3,4,3019911,1,0,0,1,2731
59df1b83e353e53e08c0fa687c2f5490162e03ad,0,ishaan,2015-09-24 10:58:55-07:00,['b8d15adcaf6ed1edf7e04bade39f46b91e8c192b'],18,7,25,3019936,2,0.375,0.375,0,2731
9795364a77f2e526769a263832953f0d6bee791d,1,ishaan,2015-09-24 10:58:57-07:00,['59df1b83e353e53e08c0fa687c2f5490162e03ad'],10,31,41,3019977,3,0,0,0,2731
7122f5a58fa6e4185f67c68cefd9354eb3e42110,1,ishaan,2015-09-24 10:58:58-07:00,['9795364a77f2e526769a263832953f0d6bee791d'],13,20,33,3020010,7,0.2,1,0.4,2731
0e5f50178233a316dd2a04dcb78e5db7d06ac330,1,ishaan,2015-09-24 10:58:59-07:00,['7122f5a58fa6e4185f67c68cefd9354eb3e42110'],8,40,48,3020058,4,0.5,0.5,0,2731
d37bf390a84953a9e3e07b8ef7565ef9b4b0c942,0,ishaan,2015-09-27 15:13:25-07:00,['0e5f50178233a316dd2a04dcb78e5db7d06ac330'],15,56,71,3020129,6,0.318181818,1,0.045454545,2731
fd400927a95131c73067f9dd5d222ac88cd7d53b,1,ishaan,2015-09-27 15:13:26-07:00,['d37bf390a84953a9e3e07b8ef7565ef9b4b0c942'],1,1,2,3020131,1,,,,2731
14aef7f6a7ec3edd67ba6d1d792d74681899c5e2,0,ishaan,2015-09-27 15:13:27-07:00,['fd400927a95131c73067f9dd5d222ac88cd7d53b'],4,23,27,3020158,2,0.75,0.75,1,2731
e00130e39aee90076fa8ddef34be762f730340e3,1,ishaan,2015-09-27 15:13:28-07:00,['14aef7f6a7ec3edd67ba6d1d792d74681899c5e2'],4,25,29,3020187,3,1,1,1,2731
24d63dd3b21547d4c0db36c3da2d0f46d90fc3eb,1,ishaan,2015-09-27 15:13:29-07:00,['e00130e39aee90076fa8ddef34be762f730340e3'],18,17,35,3020222,5,1,0.75,0,2731
b0bfe410461736276a61af4649a80ae77c40cae6,0,ishaan,2015-09-27 15:13:30-07:00,['24d63dd3b21547d4c0db36c3da2d0f46d90fc3eb'],1,7,8,3020230,1,0,0,1,2731
325916eefeba4297436074570103b6c245c88d6e,1,ishaan,2015-09-27 15:13:31-07:00,['b0bfe410461736276a61af4649a80ae77c40cae6'],7,12,19,3020249,2,0,0,0,2731
2478f05cb3322555c926dd8e6ced685022f7099e,1,ishaan,2015-09-27 15:13:32-07:00,['325916eefeba4297436074570103b6c245c88d6e'],14,20,34,3020283,3,1,1,1,2732
7a1336dbfdc2065450def42a03c8237e51d19f58,1,ishaan,2015-09-27 15:13:33-07:00,['2478f05cb3322555c926dd8e6ced685022f7099e'],3,16,19,3020302,2,,,,2732
773fa1016e81c705a43d4a18b3597632760b0508,1,ishaan,2015-09-27 15:13:34-07:00,['7a1336dbfdc2065450def42a03c8237e51d19f58'],5,6,11,3020313,1,,,,2732
08a6a34488b7383a1c63d4ba976e1a7c9cbc1155,0,Todd Lipcon,2015-09-27 21:07:29-07:00,['fcf18ebc0441244ec75ec4364ee3e9545a1faee3'],1,1,2,3020315,1,,,,2732
dbd7a010231299333306c51622c7f3c3734b3604,1,ishaan,2015-09-30 17:17:38-07:00,['773fa1016e81c705a43d4a18b3597632760b0508'],2,7,9,3020324,1,0,0,1,2732
fbec3f65a0ad21865d72a0170922ae100a1c3afe,1,ishaan,2015-09-30 17:17:39-07:00,['dbd7a010231299333306c51622c7f3c3734b3604'],0,15,15,3020339,2,,,,2732
c3b5edd2af2049b5ebfb664ee3d9d51f421764f5,1,ishaan,2015-09-30 17:17:40-07:00,['fbec3f65a0ad21865d72a0170922ae100a1c3afe'],12,192,204,3020543,8,0.714285714,0,1,2732
f5db872fa26559b86a8ac3bb93a34488eb3f5d64,0,ishaan,2015-09-30 17:17:41-07:00,['c3b5edd2af2049b5ebfb664ee3d9d51f421764f5'],8,23,31,3020574,2,0.6,0.6,1,2732
1b88d64463e9f6e480339ae459da7c13d02cdecd,0,ishaan,2015-09-30 17:17:42-07:00,['f5db872fa26559b86a8ac3bb93a34488eb3f5d64'],4,4,8,3020582,1,,,,2732
7d338af63806fc59b7c3c8edf14a1e60940c7c0c,1,ishaan,2015-09-30 17:17:43-07:00,['1b88d64463e9f6e480339ae459da7c13d02cdecd'],7,23,30,3020612,1,0,0,1,2732
cb713840b701d54cc0986c5d78abc4e87137cd7a,0,ishaan,2015-09-30 17:17:44-07:00,['7d338af63806fc59b7c3c8edf14a1e60940c7c0c'],0,16,16,3020628,2,0,0,0,2732
2d29aff8cdfabe6fa450a0a4a02fefe244314d6e,0,ishaan,2015-09-30 17:17:45-07:00,['cb713840b701d54cc0986c5d78abc4e87137cd7a'],25,48,73,3020701,4,0,0,1,2732
7c498627f62b19496ab88d20673db0bb61fc6abb,1,ishaan,2015-09-30 17:17:46-07:00,['2d29aff8cdfabe6fa450a0a4a02fefe244314d6e'],2,117,119,3020820,5,0.661764706,0.926470588,0.75,2732
851056489d80a73343d51ac7da5bf1b9d70ad961,1,ishaan,2015-09-30 17:17:47-07:00,['7c498627f62b19496ab88d20673db0bb61fc6abb'],4,21,25,3020845,3,0,0,0,2732
96d93083fe136bf798fd0b25ffc9781a41f02ac5,0,ishaan,2015-09-30 17:17:48-07:00,['851056489d80a73343d51ac7da5bf1b9d70ad961'],0,2,2,3020847,1,,,,2732
24d39886c8c8bdd3d4d04358238cb645420cc3ae,1,ishaan,2015-09-30 17:17:49-07:00,['96d93083fe136bf798fd0b25ffc9781a41f02ac5'],91,130,221,3021068,2,0.8,0.8,0.142857143,2732
fcd642caac3e036e51d3917a7d58e5bd18cb994e,0,ishaan,2015-09-30 17:17:50-07:00,['24d39886c8c8bdd3d4d04358238cb645420cc3ae'],13,3,16,3021084,1,1,1,0,2732
4ebe8de6a1ef117ea374536fc2f5a141c7bbd909,1,ishaan,2015-09-30 17:17:51-07:00,['fcd642caac3e036e51d3917a7d58e5bd18cb994e'],54,92,146,3021230,2,1,1,1,2732
70b9954593b010002461de13ef4980a90b625ed7,1,ishaan,2015-09-30 17:17:52-07:00,['4ebe8de6a1ef117ea374536fc2f5a141c7bbd909'],90,41,131,3021361,4,0,0.121212121,1,2732
62d4e5406b0e9f683bf2d44566baa2288de09733,0,ishaan,2015-09-30 17:17:53-07:00,['70b9954593b010002461de13ef4980a90b625ed7'],3,4,7,3021368,1,,,,2732
4d68fcc87ed0d76c5eb6d38bb237d78c2e72c321,1,ishaan,2015-09-30 17:17:54-07:00,['62d4e5406b0e9f683bf2d44566baa2288de09733'],1,51,52,3021420,2,0,1,1,2732
eb9db01092269e27c1004eae7a17ad9760203afe,1,ishaan,2015-10-01 13:58:35-07:00,['4d68fcc87ed0d76c5eb6d38bb237d78c2e72c321'],0,63,63,3021483,3,0.129032258,1,1,2733
6c9b93973ac17e63d69b0beffbac5d881cbd48e6,0,ishaan,2015-10-01 13:58:36-07:00,['eb9db01092269e27c1004eae7a17ad9760203afe'],1,36,37,3021520,2,0.9375,0.9375,1,2733
0c5e6a804fa9507ecb56e432185c402efc694046,1,ishaan,2015-10-01 13:58:37-07:00,['6c9b93973ac17e63d69b0beffbac5d881cbd48e6'],173,720,893,3022413,18,0.748953975,0.857740586,0.435146444,2742
6bac14a283a4817292f84d5e473a88d6e2bf3853,1,ishaan,2015-10-01 13:58:38-07:00,['0c5e6a804fa9507ecb56e432185c402efc694046'],13,148,161,3022574,8,0.493506494,0.714285714,1,2743
68fef6a5bfca4bedfc60cf117feacb815efe4c99,1,ishaan,2015-10-01 13:58:39-07:00,['6bac14a283a4817292f84d5e473a88d6e2bf3853'],9,173,182,3022756,6,0.866666667,0.866666667,0.813333333,2744
75887730cbc836f0d13e39dda51bf264583941a8,1,ishaan,2015-10-01 13:58:40-07:00,['68fef6a5bfca4bedfc60cf117feacb815efe4c99'],160,406,566,3023322,27,0.070422535,0.197183099,0.478873239,2744
a055b141b3868348b30bdda858373c9a3f040824,1,ishaan,2015-10-01 13:58:41-07:00,['75887730cbc836f0d13e39dda51bf264583941a8'],77,151,228,3023550,4,0.58974359,0.615384615,0.333333333,2744
b10ca820866966811975506c8e041c91d47ce50d,0,ishaan,2015-10-01 13:58:42-07:00,['a055b141b3868348b30bdda858373c9a3f040824'],7,25,32,3023582,1,1,1,1,2744
6866c3045be0a0f5ff7da248d45d05dcba24b5eb,1,ishaan,2015-10-01 13:58:43-07:00,['b10ca820866966811975506c8e041c91d47ce50d'],1,112,113,3023695,4,0.8125,0.9375,1,2744
df5271e7c132aa1e9c85c4fb450d451ce31cdf18,1,ishaan,2015-10-05 11:30:34-07:00,['6866c3045be0a0f5ff7da248d45d05dcba24b5eb'],2,2,4,3023699,1,,,,2744
1855f0be0c733445e9c424f8313f64879b3359d7,0,ishaan,2015-10-05 11:30:35-07:00,['df5271e7c132aa1e9c85c4fb450d451ce31cdf18'],1,3,4,3023703,1,,,,2744
265bed6494f4cc25c0e7e224a7455f68d45d6043,1,ishaan,2015-10-05 11:30:36-07:00,['1855f0be0c733445e9c424f8313f64879b3359d7'],0,651,651,3024354,1,0.578703704,1,0.819444444,2745
0df3b419a0a5e229d47b68dfe587910567b959aa,1,ishaan,2015-10-05 11:30:37-07:00,['265bed6494f4cc25c0e7e224a7455f68d45d6043'],1,31,32,3024386,2,1,1,1,2745
5b0fd9aad5c8d9314d589608bf35610e0a99e479,1,ishaan,2015-10-05 11:30:38-07:00,['0df3b419a0a5e229d47b68dfe587910567b959aa'],152,233,385,3024771,5,0.36,1,1,2745
7778b3ded5591d68513470031d9f5ae67fcf5b78,1,ishaan,2015-10-05 11:30:39-07:00,['5b0fd9aad5c8d9314d589608bf35610e0a99e479'],73,295,368,3025139,11,0.324675325,0.168831169,0.987012987,2747
6a5ff17ec5cd23ff084172074c89dc4facd4159d,0,ishaan,2015-10-05 11:30:40-07:00,['7778b3ded5591d68513470031d9f5ae67fcf5b78'],1,1,2,3025141,1,0,0,1,2747
5bbe2fe23d612565f619ba3dab9c9dcd89846726,1,ishaan,2015-10-05 11:30:41-07:00,['6a5ff17ec5cd23ff084172074c89dc4facd4159d'],20,20,40,3025181,2,,,,2747
1a09ca10856af757962094bce4c5424c696a0bd2,0,ishaan,2015-10-05 11:30:42-07:00,['5bbe2fe23d612565f619ba3dab9c9dcd89846726'],0,11,11,3025192,1,0.8,1,1,2747
eecab357a702df9ea27fd1ba345a4505124b3650,0,ishaan,2015-10-05 11:30:43-07:00,['1a09ca10856af757962094bce4c5424c696a0bd2'],1,3,4,3025196,2,0.5,0.5,0.5,2747
e07a2da9a7d22e515198bfb7be9a4a8ffa298577,1,ishaan,2015-10-05 11:30:44-07:00,['eecab357a702df9ea27fd1ba345a4505124b3650'],20,21,41,3025237,2,1,1,0,2747
b2ba5365638769a28f130b9b5bf2128018947c10,0,ishaan,2015-10-05 11:30:45-07:00,['e07a2da9a7d22e515198bfb7be9a4a8ffa298577'],48,48,96,3025333,3,,,,2747
86d0780b0793ab09c4d6e3efcb41bdc1f5586413,0,ishaan,2015-10-05 11:30:46-07:00,['b2ba5365638769a28f130b9b5bf2128018947c10'],31,31,62,3025395,2,,,,2747
d58eb083a74f9c754400cc5f214ec2cbde9fcca3,0,ishaan,2015-10-05 11:30:47-07:00,['86d0780b0793ab09c4d6e3efcb41bdc1f5586413'],0,3,3,3025398,1,,,,2747
c039906e901d5070995191e4961a513ca0b5ad1b,0,ishaan,2015-10-05 11:30:48-07:00,['d58eb083a74f9c754400cc5f214ec2cbde9fcca3'],26,23,49,3025447,1,0,0,0,2747
749c19c5fc96a12176a88d84f89c7c16320ad232,1,ishaan,2015-10-05 11:30:49-07:00,['c039906e901d5070995191e4961a513ca0b5ad1b'],48,48,96,3025543,3,,,,2747
c263439c26115d026141c25ad394e8697377e203,0,ishaan,2015-10-05 11:30:50-07:00,['749c19c5fc96a12176a88d84f89c7c16320ad232'],11,14,25,3025568,3,1,1,1,2747
06c96e40744656b5c02265db05a4e81550c4f6a7,1,ishaan,2015-10-05 11:30:51-07:00,['c263439c26115d026141c25ad394e8697377e203'],24,175,199,3025767,2,1,1,1,2747
263ec3f1922eb118d02d7ce8815196e5568f3da4,0,ishaan,2015-10-05 11:30:52-07:00,['06c96e40744656b5c02265db05a4e81550c4f6a7'],0,8,8,3025775,1,,,,2747
1f93a816dfdf8d97e553633bede5af371b330da2,1,ishaan,2015-10-05 11:30:53-07:00,['263ec3f1922eb118d02d7ce8815196e5568f3da4'],0,1,1,3025776,1,0,1,1,2747
b89d69da907c86859b96edecec38cf1e478a38df,1,ishaan,2015-10-05 11:30:54-07:00,['1f93a816dfdf8d97e553633bede5af371b330da2'],10,410,420,3026196,17,0.686868687,0.696969697,0.95959596,2754
d5e0e2eebc1aaa00b27ee464bfcba42f26827712,0,ishaan,2015-10-06 10:54:08-07:00,['b89d69da907c86859b96edecec38cf1e478a38df'],0,31,31,3026227,2,0,0,1,2754
d2f37b0a06b85685b95d5f44a21a4e4b9ff676b1,0,ishaan,2015-10-06 10:54:09-07:00,['d5e0e2eebc1aaa00b27ee464bfcba42f26827712'],1,2,3,3026230,1,0,1,1,2754
a4d24954b53d324aeb2fa879bcc7c64c8b914f1c,0,ishaan,2015-10-06 10:54:10-07:00,['d2f37b0a06b85685b95d5f44a21a4e4b9ff676b1'],15,109,124,3026354,4,0,0,1,2754
f06497e1d61d32b9fffd99a580f56e9a14be3f40,1,Taras Bobrovytsky,2015-10-07 14:47:37-07:00,['a4d24954b53d324aeb2fa879bcc7c64c8b914f1c'],17,39,56,3026410,2,0,1,1,2754
c153d094d43859c639803ee61be3b54d6fb3a90b,1,Taras Bobrovytsky,2015-10-07 14:47:38-07:00,['f06497e1d61d32b9fffd99a580f56e9a14be3f40'],0,22,22,3026432,2,0,0,0,2754
73a187aa24744b4f6a586f632c5694fb0e3714f1,1,Taras Bobrovytsky,2015-10-07 14:47:39-07:00,['c153d094d43859c639803ee61be3b54d6fb3a90b'],48,364,412,3026844,10,0.489208633,0.474820144,0.935251799,2755
38bc1c77b8cb3ae83108ab2b9cbb7ad4b0dba5ec,1,Taras Bobrovytsky,2015-10-07 14:47:40-07:00,['73a187aa24744b4f6a586f632c5694fb0e3714f1'],101,115,216,3027060,7,1,1,1,2757
41509ce3c1c7addcdc5fafa846b185e5fefa2181,1,Taras Bobrovytsky,2015-10-07 14:47:41-07:00,['38bc1c77b8cb3ae83108ab2b9cbb7ad4b0dba5ec'],22,28,50,3027110,5,0,0,0,2757
9f5fbdfb9a070455f25443bbd152d0b692f5026e,0,Taras Bobrovytsky,2015-10-07 14:47:42-07:00,['41509ce3c1c7addcdc5fafa846b185e5fefa2181'],4,4,8,3027118,1,,,,2757
347d692afeb0f84ee332987fee33c0b579540cf3,1,Taras Bobrovytsky,2015-10-08 15:16:32-07:00,['9f5fbdfb9a070455f25443bbd152d0b692f5026e'],2,6,8,3027126,1,0,0,1,2757
13738e26e68ca50606d4b93e5d53268f7cf75b98,1,Taras Bobrovytsky,2015-10-08 15:16:33-07:00,['347d692afeb0f84ee332987fee33c0b579540cf3'],48,48,96,3027222,3,,,,2757
1055d867937847b57ec88bc431ae819b7f7cac68,0,Taras Bobrovytsky,2015-10-08 15:16:34-07:00,['13738e26e68ca50606d4b93e5d53268f7cf75b98'],0,4,4,3027226,1,,,,2757
277a92a14ac9f9034978d212d744de8b474519e8,0,Taras Bobrovytsky,2015-10-08 15:16:35-07:00,['1055d867937847b57ec88bc431ae819b7f7cac68'],5,10,15,3027241,4,1,0,0,2757
7920ceaa8898d893a19944cfcd4b013944fa41ca,0,Taras Bobrovytsky,2015-10-08 15:16:36-07:00,['277a92a14ac9f9034978d212d744de8b474519e8'],7,16,23,3027264,2,0,1,1,2757
f1ef5170cb779095110c57e6df59abbfc88a554d,1,Taras Bobrovytsky,2015-10-09 16:33:14-07:00,['7920ceaa8898d893a19944cfcd4b013944fa41ca'],15,26,41,3027305,2,1,1,0,2757
ba2947a325783512cdd6592efa196dd7449b7ffe,1,Taras Bobrovytsky,2015-10-09 16:33:25-07:00,['f1ef5170cb779095110c57e6df59abbfc88a554d'],40,60,100,3027405,6,1,1,0.933333333,2757
0ccbd4a85867c7a03355b308b4fe25eb9c56bed6,1,Taras Bobrovytsky,2015-10-09 16:33:43-07:00,['ba2947a325783512cdd6592efa196dd7449b7ffe'],2,29,31,3027436,2,0.368421053,1,0.631578947,2757
0c7db5e7bd9c177c3972a3c944ca0231e98a4848,0,Taras Bobrovytsky,2015-10-09 16:33:52-07:00,['0ccbd4a85867c7a03355b308b4fe25eb9c56bed6'],0,3,3,3027439,1,,,,2757
38f29b048d1d7a13070916da3d35ccf8a4e19909,1,Taras Bobrovytsky,2015-10-09 16:39:28-07:00,['0c7db5e7bd9c177c3972a3c944ca0231e98a4848'],27,27,54,3027493,2,,,,2757
49b588a714f9ee295633a52693bd0cbb013f7f69,1,Taras Bobrovytsky,2015-10-09 16:42:03-07:00,['38f29b048d1d7a13070916da3d35ccf8a4e19909'],156,190,346,3027839,7,0,0.25,0.5,2757
13a357b6e61ec3beb3421e4a4e1f37a6baf019d8,1,Taras Bobrovytsky,2015-10-09 16:42:24-07:00,['49b588a714f9ee295633a52693bd0cbb013f7f69'],0,13,13,3027852,1,0,1,1,2757
6deff33ae85da995863297a8b2155a24209ae578,1,Taras Bobrovytsky,2015-10-09 16:44:03-07:00,['13a357b6e61ec3beb3421e4a4e1f37a6baf019d8'],4,70,74,3027926,2,0.038461538,0.846153846,1,2757
bbaef98281330053fb48554a21f754192844a7cb,1,Taras Bobrovytsky,2015-10-09 16:47:00-07:00,['6deff33ae85da995863297a8b2155a24209ae578'],40,77,117,3028043,4,0,0,0,2757
cfe1e38d6ee1b9aa90144b9cc8c6a69f587d26bd,1,Taras Bobrovytsky,2015-10-09 16:47:46-07:00,['bbaef98281330053fb48554a21f754192844a7cb'],4,43,47,3028090,5,1,1,1,2757
67564c9cdc28c2e983cf7ab15c1a92cdeba51ba4,1,Taras Bobrovytsky,2015-10-09 16:47:47-07:00,['cfe1e38d6ee1b9aa90144b9cc8c6a69f587d26bd'],1,7,8,3028098,1,0,0,1,2757
b669800432630960b7023441c6a31a142634e0c9,1,Taras Bobrovytsky,2015-10-09 16:47:48-07:00,['67564c9cdc28c2e983cf7ab15c1a92cdeba51ba4'],1,2,3,3028101,1,,,,2757
c66ea8ad0327f3522b359f7c53cb19fb60e3bceb,0,Harrison Sheinblatt,2015-10-12 14:41:00-07:00,['b669800432630960b7023441c6a31a142634e0c9'],2,13,15,3028116,2,0,0,0,2757
b31bb2798f2bace0833ac87ed1cc44a49e0d5fa6,0,Harrison Sheinblatt,2015-10-12 14:41:01-07:00,['c66ea8ad0327f3522b359f7c53cb19fb60e3bceb'],0,4,4,3028120,1,0,1,1,2757
c0c4f0f36faa9c62482b7f1e09074adca3a43ee9,0,Harrison Sheinblatt,2015-10-12 14:41:02-07:00,['b31bb2798f2bace0833ac87ed1cc44a49e0d5fa6'],0,2,2,3028122,1,,,,2757
e4d12931ddb90328af236d53f368b5721b2fd41c,1,Harrison Sheinblatt,2015-10-12 14:41:03-07:00,['c0c4f0f36faa9c62482b7f1e09074adca3a43ee9'],4,5,9,3028131,2,1,0,0,2757
0144fc3be61b3ddfdf17e353970f99e38b60a6ec,1,Harrison Sheinblatt,2015-10-12 14:41:04-07:00,['e4d12931ddb90328af236d53f368b5721b2fd41c'],2,3,5,3028136,1,,,,2757
16759d798957368aabdca916a0230e0172dc9a83,0,Harrison Sheinblatt,2015-10-12 14:41:05-07:00,['0144fc3be61b3ddfdf17e353970f99e38b60a6ec'],11,13,24,3028160,2,,,,2757
6071c68e899314139a6a2cbcdbccc2760ac1cb87,0,Harrison Sheinblatt,2015-10-12 14:41:06-07:00,['16759d798957368aabdca916a0230e0172dc9a83'],1,1,2,3028162,1,,,,2757
2895656f8ae4d23d7ea33341ff28ced93f8db936,0,Harrison Sheinblatt,2015-10-12 14:41:07-07:00,['6071c68e899314139a6a2cbcdbccc2760ac1cb87'],2,5,7,3028169,1,1,0,0,2757
84c4c2ce869cd210baab72f086546b9fe2979cba,0,Harrison Sheinblatt,2015-10-12 14:41:08-07:00,['2895656f8ae4d23d7ea33341ff28ced93f8db936'],12,12,24,3028193,2,1,1,0,2757
586f43357cbff44b565b4931f01b941de56a717a,0,Harrison Sheinblatt,2015-10-12 14:41:09-07:00,['84c4c2ce869cd210baab72f086546b9fe2979cba'],1,2,3,3028196,1,0,0,1,2757
6771b88d5353d0705738357ad5bf0aa9073363c4,0,Harrison Sheinblatt,2015-10-12 14:41:10-07:00,['586f43357cbff44b565b4931f01b941de56a717a'],1,3,4,3028200,1,,,,2757
d985c67f011bdaf856a5bf15368ce65b41fe7579,1,Internal Jenkins,2015-10-14 02:55:00+00:00,['6771b88d5353d0705738357ad5bf0aa9073363c4'],16,12,28,3028228,1,1,1,0,2757
720080bba78447d3436e4c01c04889327d7f9013,0,Internal Jenkins,2015-10-14 07:12:53+00:00,['d985c67f011bdaf856a5bf15368ce65b41fe7579'],34,41,75,3028303,3,1,0,1,2757
26690ff1cd68d0f8f6e8d029d38da2385ce2a058,0,Internal Jenkins,2015-10-14 19:16:48+00:00,['720080bba78447d3436e4c01c04889327d7f9013'],9,50,59,3028362,4,0,0.75,0.875,2757
3661e753b2beb61b6aeb91eb967437569978b3e6,1,Internal Jenkins,2015-10-14 23:12:52+00:00,['26690ff1cd68d0f8f6e8d029d38da2385ce2a058'],17,149,166,3028528,6,0.068965517,0.206896552,1,2757
7be74313d80414a787460e21b986592457488f31,1,Harrison Sheinblatt,2015-10-14 17:51:36-07:00,['3661e753b2beb61b6aeb91eb967437569978b3e6'],235,330,565,3029093,13,0.818181818,1,0.454545455,2757
4ed0742f3ed74365d4723cb04cfa7f57bfa7cf4c,1,Harrison Sheinblatt,2015-10-14 17:51:37-07:00,['7be74313d80414a787460e21b986592457488f31'],49,287,336,3029429,11,0.189189189,0.986486486,0.932432432,2757
65772cf9ce497b359b314ac28d04dbc8513245d4,0,Harrison Sheinblatt,2015-10-14 17:51:38-07:00,['4ed0742f3ed74365d4723cb04cfa7f57bfa7cf4c'],2,25,27,3029456,3,1,1,1,2757
2c16f64c4156b71d4bc4562c4e59539e7d051adc,0,Internal Jenkins,2015-10-15 23:50:06+00:00,['65772cf9ce497b359b314ac28d04dbc8513245d4'],16,38,54,3029510,3,0,1,1,2757
583a60fbfe6cae39bb9deddc3c7e4905c6bef842,1,Internal Jenkins,2015-10-16 00:09:12+00:00,['2c16f64c4156b71d4bc4562c4e59539e7d051adc'],9,15,24,3029534,2,0,0.5,1,2757
1cd95f79f0a6e96231f11113347b47bc22de17dd,0,Internal Jenkins,2015-10-17 00:52:53+00:00,['583a60fbfe6cae39bb9deddc3c7e4905c6bef842'],2,2,4,3029538,1,,,,2757
3472fdbbc01bd1a00d74aae765c8503b3f046381,1,Internal Jenkins,2015-10-17 03:38:41+00:00,['1cd95f79f0a6e96231f11113347b47bc22de17dd'],20,26,46,3029584,2,0,0.5,1,2757
b5eaf3df209cf609ddf002a4575823eae13aef07,1,Internal Jenkins,2015-10-17 06:35:27+00:00,['3472fdbbc01bd1a00d74aae765c8503b3f046381'],11,22,33,3029617,1,0,0,1,2757
6918dace79e70a3d8922919ab22c97a43392f3e2,0,Internal Jenkins,2015-10-20 23:37:01+00:00,['b5eaf3df209cf609ddf002a4575823eae13aef07'],0,20,20,3029637,1,1,1,0.461538462,2757
8d1e15ee9e6628ecb301688f0c274a9b2fee76d9,0,Internal Jenkins,2015-10-21 04:53:55+00:00,['6918dace79e70a3d8922919ab22c97a43392f3e2'],1,7,8,3029645,1,,,,2757
2e3231ed195184ed09d5e7d99aa51de173c426a3,1,Internal Jenkins,2015-10-21 21:11:38+00:00,['8d1e15ee9e6628ecb301688f0c274a9b2fee76d9'],6,14,20,3029665,3,1,1,0.666666667,2757
e593c62556166fce7b5288dbf83e68fa553eae55,0,Internal Jenkins,2015-10-23 05:07:39+00:00,['2e3231ed195184ed09d5e7d99aa51de173c426a3'],166,267,433,3030098,7,0.216216216,0,0,2757
f0c274264157eef8a1a6c5e4b4b0a3c61a265f52,1,Internal Jenkins,2015-10-23 05:11:07+00:00,['e593c62556166fce7b5288dbf83e68fa553eae55'],73,424,497,3030595,25,0.864,1,0.848,2758
648cc201477a0b450731b52de16a6bd4d509c545,0,Internal Jenkins,2015-10-23 19:20:15+00:00,['f0c274264157eef8a1a6c5e4b4b0a3c61a265f52'],142,7,149,3030744,7,0.506493506,0.285714286,0,2758
2d39f1cc59533ee9249a135e9c21b291eac7961f,1,Internal Jenkins,2015-10-25 04:26:27+00:00,['648cc201477a0b450731b52de16a6bd4d509c545'],4,53,57,3030801,9,0.85,0,1,2758
34a94c250303f03dd8160cba83ad7eab4ebf856f,0,Internal Jenkins,2015-10-27 10:11:13+00:00,['2d39f1cc59533ee9249a135e9c21b291eac7961f'],54,316,370,3031171,7,0.029411765,0.433823529,0.448529412,2758
9830f465b54f5a22f02bb5452c10d45ed6010b72,0,Internal Jenkins,2015-10-28 10:20:29+00:00,['34a94c250303f03dd8160cba83ad7eab4ebf856f'],1,1,2,3031173,1,,,,2758
a2b54f8334420ebbf6495810925f94a8b3069fcb,0,Martin Grund,2015-10-28 18:52:48+00:00,['9830f465b54f5a22f02bb5452c10d45ed6010b72'],2,9,11,3031184,1,,,,2758
daaedd7cf67b24c2a70626f9c8cca7eb93df6ee1,1,Martin Grund,2015-10-28 18:53:05+00:00,['a2b54f8334420ebbf6495810925f94a8b3069fcb'],2,3,5,3031189,2,,,,2758
65d7c1c41abeb8ae97deefb4e76e0a31839796d4,1,Internal Jenkins,2015-10-28 22:24:41+00:00,['daaedd7cf67b24c2a70626f9c8cca7eb93df6ee1'],101,176,277,3031466,16,0.833333333,1,0.166666667,2760
19b6bf0201b62bed6edcb49218ff1dae221badf2,1,Internal Jenkins,2015-10-29 19:39:25+00:00,['65d7c1c41abeb8ae97deefb4e76e0a31839796d4'],9,241,250,3031716,8,0.204545455,0.602272727,0.920454545,2760
dd2eb951d70ee3bae18d633a16ed353939e384bc,1,Internal Jenkins,2015-10-30 22:35:57+00:00,['19b6bf0201b62bed6edcb49218ff1dae221badf2'],78,188,266,3031982,8,0.5,0.5,1,2762
3c07b805f7edbfbe0d9afadd2f8b8524b9b90199,0,Internal Jenkins,2015-11-03 22:57:34+00:00,['dd2eb951d70ee3bae18d633a16ed353939e384bc'],1,1,2,3031984,1,,,,2762
084b9b169285db88f45e10a0f32e431baa301b91,1,Internal Jenkins,2015-11-04 08:39:12+00:00,['3c07b805f7edbfbe0d9afadd2f8b8524b9b90199'],106,400,506,3032490,13,0.460431655,0.985611511,1,2764
7fb1220ee27b73ec01fdbf6e44e293c507673508,0,Internal Jenkins,2015-11-04 22:36:02+00:00,['084b9b169285db88f45e10a0f32e431baa301b91'],18,24,42,3032532,3,0.6,0.6,1,2764
b16053db165cc0b004f975da076007026767415f,0,Internal Jenkins,2015-11-05 02:46:58+00:00,['7fb1220ee27b73ec01fdbf6e44e293c507673508'],9,18,27,3032559,4,0.25,1,1,2764
aad9e595c36954512393dafa5aa992ebdfd798a1,1,Internal Jenkins,2015-11-05 03:45:11+00:00,['b16053db165cc0b004f975da076007026767415f'],3,101,104,3032663,2,1,1,0.727272727,2765
2f0dbde07c255c412276606faf781c4a55536ab5,0,Martin Grund,2015-11-06 07:03:25-08:00,['08a6a34488b7383a1c63d4ba976e1a7c9cbc1155'],27,66,93,3032756,3,0.85193133,0.712446352,0.206008584,2765
eb479d040e8a8eb04a431cafbaa52536b2870eb3,1,Internal Jenkins,2015-11-06 23:30:14+00:00,['aad9e595c36954512393dafa5aa992ebdfd798a1'],21,212,233,3032989,11,0.084210526,0,0.947368421,2765
f05126774e4c38abceb1f12bb698a719b9133ea0,0,Internal Jenkins,2015-11-07 00:06:00+00:00,['eb479d040e8a8eb04a431cafbaa52536b2870eb3'],2,26,28,3033017,2,0,0.947368421,1,2765
82c7dbe2659d186b76da90aef0faa917c0fb7f0c,1,Internal Jenkins,2015-11-07 01:50:57+00:00,['f05126774e4c38abceb1f12bb698a719b9133ea0'],18,7,25,3033042,2,,,,2765
d8521cc6a7544444a0a1515b74560ddac841b102,0,Internal Jenkins,2015-11-07 05:54:39+00:00,['82c7dbe2659d186b76da90aef0faa917c0fb7f0c'],1,1,2,3033044,1,,,,2765
12e57c5b32104cc89157f1fe0ab68bdd1f2fc88f,1,Internal Jenkins,2015-11-09 21:13:38+00:00,['d8521cc6a7544444a0a1515b74560ddac841b102'],129,620,749,3033793,24,0.371212121,0.693181818,0.962121212,2767
3831c5186da5703881108e4e2792297749309d68,1,Internal Jenkins,2015-11-09 22:02:49+00:00,['12e57c5b32104cc89157f1fe0ab68bdd1f2fc88f'],3,12,15,3033808,3,1,1,1,2767
113dfc835da9ef8c6a94eec4ff538bbc59799da2,0,Internal Jenkins,2015-11-10 21:37:43+00:00,['3831c5186da5703881108e4e2792297749309d68'],1,2,3,3033811,1,,,,2767
40d002a94fbc24eb09ef3ad13599d08c035f281c,1,Martin Grund,2015-11-12 23:28:16+00:00,['113dfc835da9ef8c6a94eec4ff538bbc59799da2'],49,73,122,3033933,2,,,,2768
47f7f687b9d7090e2222af4b67d9875c9e26ddde,1,Tim Armstrong,2015-11-13 18:12:18+00:00,['40d002a94fbc24eb09ef3ad13599d08c035f281c'],60,237,297,3034230,7,1,0.636363636,0,2770
22df1fe1ca822031f089ff00f120cf0dcd1a79d8,0,Internal Jenkins,2015-11-14 05:19:32+00:00,['47f7f687b9d7090e2222af4b67d9875c9e26ddde'],0,562,562,3034792,3,0.770034843,0.801393728,0.881533101,2773
06719753b419dee154a92c9682992d8370de0f90,0,Internal Jenkins,2015-11-16 21:04:30+00:00,['22df1fe1ca822031f089ff00f120cf0dcd1a79d8'],2,2,4,3034796,2,,,,2773
71518c50b9fba79d4a70393e1810b226c3ac83a7,0,Internal Jenkins,2015-11-17 02:01:21+00:00,['06719753b419dee154a92c9682992d8370de0f90'],73,21,94,3034890,4,0.875,1,0.625,2773
c7e62454deae0354b21c5df0e9e8a77659cc6852,1,Internal Jenkins,2015-11-17 02:31:43+00:00,['71518c50b9fba79d4a70393e1810b226c3ac83a7'],136,529,665,3035555,20,0.369565217,0.471014493,0.942028986,2775
a78f53bc7333a712c2a7198a2063c1201d77fcc5,1,Martin Grund,2015-11-17 17:33:59+00:00,['c7e62454deae0354b21c5df0e9e8a77659cc6852'],1,6,7,3035562,2,,,,2775
b4ef1c3d216fd56bb086a38bac64b7a4c6cd1ec9,1,Internal Jenkins,2015-11-18 05:15:17+00:00,['a78f53bc7333a712c2a7198a2063c1201d77fcc5'],15,92,107,3035669,5,0,0.022222222,1,2775
643c800d628188b2fc28002439f496fcdde5aa7d,1,Internal Jenkins,2015-11-19 22:57:05+00:00,['b4ef1c3d216fd56bb086a38bac64b7a4c6cd1ec9'],26,81,107,3035776,7,0,0,0,2775
2ef4b09736100aebd90ea2f3785f4c3b1b503649,0,Internal Jenkins,2015-11-20 00:54:56+00:00,['643c800d628188b2fc28002439f496fcdde5aa7d'],37,31,68,3035844,6,1,1,1,2775
096073472f36e8dc809606b87caffe6321e8dde5,1,Internal Jenkins,2015-11-20 04:53:28+00:00,['2ef4b09736100aebd90ea2f3785f4c3b1b503649'],24,82,106,3035950,4,0.5,0.5,1,2775
06ab4dec027ca6f2620cdab14da4e6c9a2311b3e,1,Internal Jenkins,2015-11-20 05:28:46+00:00,['096073472f36e8dc809606b87caffe6321e8dde5'],10,27,37,3035987,2,0,0,1,2775
39dd756a813f17869da85df2d2d72ce6f4ffab2c,1,Juan Yu,2015-11-20 19:47:47+00:00,['06ab4dec027ca6f2620cdab14da4e6c9a2311b3e'],12,64,76,3036063,4,0.322580645,0.387096774,1,2775
65d506fe3fc33369c3e752fc47a6f8b3d31832d8,1,Internal Jenkins,2015-11-20 22:21:36+00:00,['39dd756a813f17869da85df2d2d72ce6f4ffab2c'],28,48,76,3036139,1,0,1,1,2775
fc23a14931215612e1b7dd934f44d8677ca87d4b,0,Internal Jenkins,2015-11-21 02:03:21+00:00,['65d506fe3fc33369c3e752fc47a6f8b3d31832d8'],0,26,26,3036165,1,0.047619048,1,1,2775
f3e4065519233b3da1819dc7c406b44fe707ae1b,0,Internal Jenkins,2015-11-24 00:10:46+00:00,['fc23a14931215612e1b7dd934f44d8677ca87d4b'],195,1,196,3036361,1,0.8515625,0.5,0,2775
74c1acc81a254a2f88f8878d26439237f8389947,0,Internal Jenkins,2015-11-24 03:52:19+00:00,['f3e4065519233b3da1819dc7c406b44fe707ae1b'],11,9,20,3036381,1,1,1,0,2775
3262dfda27ad863a4d5705b2e9d415128dccd744,0,Internal Jenkins,2015-11-24 05:29:52+00:00,['74c1acc81a254a2f88f8878d26439237f8389947'],1,1,2,3036383,1,,,,2775
d65cb3362908a4618a01e9d6aeef7a49d4be47fb,0,Internal Jenkins,2015-11-24 09:06:09+00:00,['3262dfda27ad863a4d5705b2e9d415128dccd744'],30,30,60,3036443,21,,,,2775
46e3e3d2742c0d09a27b48efd43a89a92349ea7b,0,Internal Jenkins,2015-11-25 04:57:16+00:00,['d65cb3362908a4618a01e9d6aeef7a49d4be47fb'],2,2,4,3036447,1,,,,2775
003fc4054860d1ad13f7e0418e9e0fcaad975ecb,1,Internal Jenkins,2015-11-25 05:29:56+00:00,['46e3e3d2742c0d09a27b48efd43a89a92349ea7b'],15,11,26,3036473,3,1,1,1,2775
a0581e1e2d025f81b02b8e0bfe730b0daabcaf4b,0,Internal Jenkins,2015-11-25 06:06:06+00:00,['003fc4054860d1ad13f7e0418e9e0fcaad975ecb'],0,2,2,3036475,1,,,,2775
24716b666ca0c351a93b40a5a084ab9cc11a505c,1,Internal Jenkins,2015-11-25 09:26:46+00:00,['a0581e1e2d025f81b02b8e0bfe730b0daabcaf4b'],152,148,300,3036775,4,1,1,0,2775
f15e4f9033e4581b5c05049b31c825c11601fb9a,1,Internal Jenkins,2015-11-26 00:40:29+00:00,['24716b666ca0c351a93b40a5a084ab9cc11a505c'],158,994,1152,3037927,10,0.673624288,0.815939279,0.732447818,2776
ba78337329cc7ee44fa1c88b366f65ebc867c14d,0,Internal Jenkins,2015-11-26 00:59:25+00:00,['f15e4f9033e4581b5c05049b31c825c11601fb9a'],2,2,4,3037931,2,,,,2776
ba0bd1d0da611aab43c9facb281da8c44678d3a1,1,Internal Jenkins,2015-11-26 03:21:46+00:00,['ba78337329cc7ee44fa1c88b366f65ebc867c14d'],8,49,57,3037988,9,0,0,1,2776
b055bc394a8b517781716633f18f1bc04d322856,1,Henry Robinson,2015-11-29 18:03:54-08:00,['ba0bd1d0da611aab43c9facb281da8c44678d3a1'],5,29,34,3038022,5,0.777777778,1,0.888888889,2776
c5b6bdd10b7920187b8a9ad6c1ae61143692e0d3,1,Internal Jenkins,2015-12-03 06:27:16+00:00,['b055bc394a8b517781716633f18f1bc04d322856'],42,30,72,3038094,3,0,0,1,2776
e9d9dc04e5565fe10e728ada76bab69a964b329f,0,Internal Jenkins,2015-12-04 01:02:48+00:00,['c5b6bdd10b7920187b8a9ad6c1ae61143692e0d3'],0,5,5,3038099,2,0,0,1,2776
a280b93a378def34da61a4ded1dd8fbb0e575bf7,1,Internal Jenkins,2015-12-04 01:40:41+00:00,['e9d9dc04e5565fe10e728ada76bab69a964b329f'],161,248,409,3038508,32,1,1,0.955555556,2776
9400fd545bdabd1930f2de0eaa4f3302c52b6f24,1,Internal Jenkins,2015-12-04 09:56:04+00:00,['a280b93a378def34da61a4ded1dd8fbb0e575bf7'],74,123,197,3038705,8,1,1,0.785714286,2776
1814a38341362c95476b3ba3f380d75ced6e6eb1,0,Internal Jenkins,2015-12-04 21:14:53+00:00,['9400fd545bdabd1930f2de0eaa4f3302c52b6f24'],4,0,4,3038709,1,,,,2776
0f3eb6d53d20ca6dca9f020ef483e48485d030b1,1,Internal Jenkins,2015-12-04 23:19:45+00:00,['1814a38341362c95476b3ba3f380d75ced6e6eb1'],14,9,23,3038732,2,0.5,0.5,0,2776
b6c20b2a402d0c8f36f9471b999711915d43c875,1,Alex Behm,2015-12-05 06:48:32+00:00,['0f3eb6d53d20ca6dca9f020ef483e48485d030b1'],91,273,364,3039096,43,0.2,0.95,1,2776
42e92abfe017bb074e4bf24b630d646b49e5369e,1,Internal Jenkins,2015-12-07 19:32:03+00:00,['b6c20b2a402d0c8f36f9471b999711915d43c875'],23,72,95,3039191,6,0.464285714,1,0.785714286,2776
b510f8cb2dd76a453c86fd015d6ca4b072495a39,0,Internal Jenkins,2015-12-07 23:03:39+00:00,['42e92abfe017bb074e4bf24b630d646b49e5369e'],0,4,4,3039195,1,,,,2776
350543bd2d308d45786b1435fa2f7a847a83c7f5,1,Internal Jenkins,2015-12-09 00:48:26+00:00,['b510f8cb2dd76a453c86fd015d6ca4b072495a39'],12,11,23,3039218,2,1,1,1,2776
016d2b0a374ea0696789e6442a8863469f11318c,0,Internal Jenkins,2015-12-09 01:59:58+00:00,['350543bd2d308d45786b1435fa2f7a847a83c7f5'],2,8,10,3039228,2,0.333333333,0.666666667,0.666666667,2776
b0343c17b16c91bde7e5357ab2d3453e2bcbbffd,0,Internal Jenkins,2015-12-09 02:18:35+00:00,['016d2b0a374ea0696789e6442a8863469f11318c'],9,1,10,3039238,2,1,1,1,2776
98e36881f59950f51a2c6147ad237fd642e1fff5,0,Internal Jenkins,2015-12-09 05:09:12+00:00,['b0343c17b16c91bde7e5357ab2d3453e2bcbbffd'],25,4,29,3039267,1,1,1,0,2776
256853e347be0d88786c133de63adb9d7b83be54,1,Internal Jenkins,2015-12-09 09:56:51+00:00,['98e36881f59950f51a2c6147ad237fd642e1fff5'],69,89,158,3039425,4,0,0,1,2776
57f11e16536af587975b5ce4571450f6902a5c12,0,Internal Jenkins,2015-12-10 10:57:42+00:00,['256853e347be0d88786c133de63adb9d7b83be54'],13,1,14,3039439,1,1,1,0,2776
366fba38af105be606c8bca2afe54ccacfe13df2,0,Internal Jenkins,2015-12-10 23:11:33+00:00,['57f11e16536af587975b5ce4571450f6902a5c12'],0,5,5,3039444,1,,,,2776
64a32ebb3bcec149bda94312bb18654d36d9982a,0,Internal Jenkins,2015-12-11 07:16:40+00:00,['366fba38af105be606c8bca2afe54ccacfe13df2'],0,4,4,3039448,1,,,,2776
add0ffb9a921100bc585d1b24d6f5fe68debe9f1,0,Internal Jenkins,2015-12-11 10:56:47+00:00,['64a32ebb3bcec149bda94312bb18654d36d9982a'],6,6,12,3039460,1,,,,2776
577e33512271c5304a35fc73f7db8a0465acadc7,1,Internal Jenkins,2015-12-11 22:09:45+00:00,['add0ffb9a921100bc585d1b24d6f5fe68debe9f1'],10,18,28,3039488,1,,,,2776
31503db4f801e299687ece1fc66552f9446f7dcf,1,Martin Grund,2015-12-14 06:35:09+00:00,['577e33512271c5304a35fc73f7db8a0465acadc7'],0,1,1,3039489,1,,,,2776
b2686ce31c1d117a28972bbbff37dead2bf74c84,1,Internal Jenkins,2015-12-14 22:28:58+00:00,['31503db4f801e299687ece1fc66552f9446f7dcf'],160,177,337,3039826,29,0.3125,0.9375,1,2776
cf9d2485dd4e6544f6f1f407e2ad0b43eba31874,1,Internal Jenkins,2015-12-15 04:45:50+00:00,['b2686ce31c1d117a28972bbbff37dead2bf74c84'],200,294,494,3040320,7,0.346153846,0.596153846,0.192307692,2776
d08fc365c8d1eabb8a5856a26a963953e082a353,1,Internal Jenkins,2015-12-15 10:06:47+00:00,['cf9d2485dd4e6544f6f1f407e2ad0b43eba31874'],17,15,32,3040352,1,0,0,0,2776
aeadd326a982af0f2ac8d55e425248a8bc7babfe,1,Internal Jenkins,2015-12-15 10:13:34+00:00,['d08fc365c8d1eabb8a5856a26a963953e082a353'],21,590,611,3040963,7,0.945086705,1,0.786127168,2777
83199ec8370a51d9def8972123a96a9a4d18b91b,1,Internal Jenkins,2015-12-15 22:09:42+00:00,['aeadd326a982af0f2ac8d55e425248a8bc7babfe'],53,116,169,3041132,11,0,0,0,2777
99ae157d4f6b133f02e99bcfa4dcaf7001b5251a,1,Internal Jenkins,2015-12-16 03:25:22+00:00,['83199ec8370a51d9def8972123a96a9a4d18b91b'],546,754,1300,3042432,15,1,1,0.333333333,2779
6e5317e4ba4741fdf41d06b9d1527a0022a838e9,0,Internal Jenkins,2015-12-16 05:47:30+00:00,['99ae157d4f6b133f02e99bcfa4dcaf7001b5251a'],5,0,5,3042437,1,,,,2779
e202efe1aa11989dbc3bdcec80ab0b8e6bb42c06,1,Internal Jenkins,2015-12-17 01:30:07+00:00,['6e5317e4ba4741fdf41d06b9d1527a0022a838e9'],0,5,5,3042442,1,,,,2779
ab3e9f19bfd62dca2e7f573e207ee739f59c8f8b,1,Internal Jenkins,2015-12-17 03:28:32+00:00,['e202efe1aa11989dbc3bdcec80ab0b8e6bb42c06'],53,131,184,3042626,7,1,1,0,2779
afeb7fc10ec36d78a9e71f6e616a435e70c2e0a2,1,Skye Wanderman-Milne,2015-12-17 03:42:12+00:00,['ab3e9f19bfd62dca2e7f573e207ee739f59c8f8b'],338,325,663,3043289,28,1,1,0.666666667,2779
ed95351d460a81a4a13390fe557abf3ff536c74e,0,Internal Jenkins,2015-12-17 05:06:09+00:00,['afeb7fc10ec36d78a9e71f6e616a435e70c2e0a2'],1,4,5,3043294,1,,,,2779
c56ba5149cf788bc003eb4e331df2d347b808f06,1,Internal Jenkins,2015-12-17 12:08:33+00:00,['ed95351d460a81a4a13390fe557abf3ff536c74e'],21,14,35,3043329,3,,,,2779
e2bfb6ae2f1d3c6df6dd09e1b7c310f5f71982fb,1,Casey Ching,2015-12-17 18:25:27+00:00,['c56ba5149cf788bc003eb4e331df2d347b808f06'],185,301,486,3043815,43,,,,2780
c3a1f36a6c1c1cf75195333fa819215ab5cf142c,1,Internal Jenkins,2015-12-17 23:44:24+00:00,['e2bfb6ae2f1d3c6df6dd09e1b7c310f5f71982fb'],4,17,21,3043836,4,0.714285714,0.714285714,0.857142857,2780
aec7ad90504ff0a172ee777494eed197377beae9,1,Internal Jenkins,2015-12-17 23:44:35+00:00,['c3a1f36a6c1c1cf75195333fa819215ab5cf142c'],0,49,49,3043885,1,,,,2780
a10686f38f5b26216af21630422ad967556bc5a5,0,Internal Jenkins,2015-12-18 06:29:41+00:00,['aec7ad90504ff0a172ee777494eed197377beae9'],58,65,123,3044008,5,0,0,1,2780
44f4d4250b693990caff7d2a565ed12639732083,1,Internal Jenkins,2015-12-18 07:01:07+00:00,['a10686f38f5b26216af21630422ad967556bc5a5'],4,9,13,3044021,2,,,,2780
cabfe16a411b60532154e4cf1050875af41bcaf6,0,Internal Jenkins,2015-12-18 08:43:31+00:00,['44f4d4250b693990caff7d2a565ed12639732083'],1,4,5,3044026,1,,,,2780
776b0c5b2039e715f1c9831204faf2ab00fa368a,1,Internal Jenkins,2015-12-19 02:18:43+00:00,['cabfe16a411b60532154e4cf1050875af41bcaf6'],3,3,6,3044032,1,,,,2780
e0be8a3de360f5638c6da14c8f28b70b70fa6b9a,1,Matthew Jacobs,2015-12-19 02:21:01+00:00,['776b0c5b2039e715f1c9831204faf2ab00fa368a'],65,58,123,3044155,5,1,1,0,2780
f7740e0fa8a86b34c1278ba1751d904cea78571d,1,Internal Jenkins,2015-12-19 04:44:23+00:00,['e0be8a3de360f5638c6da14c8f28b70b70fa6b9a'],77,290,367,3044522,7,0.162393162,0.658119658,0.58974359,2780
e01ab4f1b21f39d7f91b8c3a739cfc64bd81d3fe,1,Internal Jenkins,2015-12-19 04:45:55+00:00,['f7740e0fa8a86b34c1278ba1751d904cea78571d'],126,573,699,3045221,24,0.170212766,0.489361702,0.542553191,2783
051d1199e270f02d29a1bd7487603adc56a3844a,1,Internal Jenkins,2015-12-19 05:38:29+00:00,['e01ab4f1b21f39d7f91b8c3a739cfc64bd81d3fe'],60,56,116,3045337,6,0.4,1,0,2783
7f133b453ebe6c78a34aa9f9a060a27493b637b0,1,Internal Jenkins,2015-12-19 05:43:59+00:00,['051d1199e270f02d29a1bd7487603adc56a3844a'],31,28,59,3045396,2,0,0,0,2783
775d464fdcaeee6c2655c7fae58bc3a1ac0fbb44,1,Internal Jenkins,2015-12-19 09:52:51+00:00,['7f133b453ebe6c78a34aa9f9a060a27493b637b0'],23,31,54,3045450,3,1,0,0,2783
b02c349e25ed0e609b23edae155563583b1ee071,1,Lars Volker,2015-12-22 10:48:00+00:00,['775d464fdcaeee6c2655c7fae58bc3a1ac0fbb44'],17,67,84,3045534,2,0,0.8125,0.8125,2783
6f3e794058eed3ee7dd47091ee38496fb50fbda3,1,Internal Jenkins,2015-12-22 14:53:42+00:00,['b02c349e25ed0e609b23edae155563583b1ee071'],9,14,23,3045557,3,,,,2783
adb131c6c122803f918f015c42b45a424652543d,1,Internal Jenkins,2015-12-22 14:58:46+00:00,['6f3e794058eed3ee7dd47091ee38496fb50fbda3'],1,1,2,3045559,1,,,,2783
17204095456cb35c1cebe157df7bf30065bf8b7e,1,Internal Jenkins,2015-12-22 22:22:59+00:00,['adb131c6c122803f918f015c42b45a424652543d'],21,166,187,3045746,5,0.644444444,1,0.755555556,2784
ddbee7611e7e5454554d5e4f554ca7bab46c1d2a,0,Internal Jenkins,2015-12-25 17:36:43+00:00,['17204095456cb35c1cebe157df7bf30065bf8b7e'],2,2,4,3045750,1,,,,2784
84ce1e22afce1c81142c455d00068dba806e7682,1,Casey Ching,2015-12-28 11:34:22-08:00,['2f0dbde07c255c412276606faf781c4a55536ab5'],9,27,36,3045786,3,0.333333333,0.333333333,0.333333333,2784
f79a021cce1c157d8edce22725014c2c46a378c0,1,Internal Jenkins,2015-12-29 05:04:10+00:00,['ddbee7611e7e5454554d5e4f554ca7bab46c1d2a'],0,353,353,3046139,23,,,,2807
cc1dac11583ff55473919997e737485b8cbfc4aa,1,Internal Jenkins,2015-12-29 12:14:16+00:00,['f79a021cce1c157d8edce22725014c2c46a378c0'],2,31,33,3046172,4,0,1,1,2807
3a3497e8191ff3fc8247880453b7ffb8f6bfda41,1,Internal Jenkins,2015-12-29 23:25:02+00:00,['cc1dac11583ff55473919997e737485b8cbfc4aa'],8,17,25,3046197,2,,,,2807
3496d3fea45418a741c16e6d7a4eb51627a12198,0,Internal Jenkins,2015-12-30 01:04:35+00:00,['3a3497e8191ff3fc8247880453b7ffb8f6bfda41'],1,1,2,3046199,1,,,,2807
bbe0750c1a8e1f67a30c37ab954bcec8b611bfbb,0,Internal Jenkins,2015-12-30 05:38:17+00:00,['3496d3fea45418a741c16e6d7a4eb51627a12198'],2,2,4,3046203,1,,,,2807
89113544cd2347486c26b18634ffbf1b287e0318,0,Internal Jenkins,2016-01-05 00:52:38+00:00,['bbe0750c1a8e1f67a30c37ab954bcec8b611bfbb'],80,79,159,3046362,27,0,1,1,2807
a612dfaf8f2bbfe3e8154c847157c554dd825853,1,Internal Jenkins,2016-01-05 02:54:56+00:00,['89113544cd2347486c26b18634ffbf1b287e0318'],156,105,261,3046623,2,1,1,1,2807
1a4a830a6db59f6ea481afcdd03c100560a18a30,0,Alex Behm,2016-01-05 06:04:41+00:00,['a612dfaf8f2bbfe3e8154c847157c554dd825853'],50,0,50,3046673,3,,,,2807
7353c5cefc1c3f10e819cf9fea63cadecaf1f60b,0,Skye Wanderman-Milne,2016-01-06 02:05:02+00:00,['1a4a830a6db59f6ea481afcdd03c100560a18a30'],26,33,59,3046732,1,0,1,1,2807
f09050beddd0e57cee987aa26a72731c545f0d62,1,Alex Behm,2016-01-06 02:58:49+00:00,['7353c5cefc1c3f10e819cf9fea63cadecaf1f60b'],8,8,16,3046748,1,,,,2807
718da8b1fda5cb671364f4791653a1a50ad4195f,0,Alex Behm,2016-01-06 03:16:19+00:00,['f09050beddd0e57cee987aa26a72731c545f0d62'],12,10,22,3046770,1,1,0,0,2807
dcbe1272a44c9b82d5aab07701135a87166efd1e,0,Alex Behm,2016-01-06 08:50:38+00:00,['718da8b1fda5cb671364f4791653a1a50ad4195f'],13,0,13,3046783,1,0,0,0,2807
26429aee4d2d55adad2c6e289fd7c0af470aeafd,1,Internal Jenkins,2016-01-06 12:01:18+00:00,['dcbe1272a44c9b82d5aab07701135a87166efd1e'],1,3,4,3046787,1,,,,2807
38c320cfdd1d30b1563bef4022c1aec951d941c2,1,Internal Jenkins,2016-01-07 04:34:55+00:00,['26429aee4d2d55adad2c6e289fd7c0af470aeafd'],45,75,120,3046907,9,0.4,0.9,0.55,2807
c6f0667837254a44813b32a7ff2681afbe12e23e,1,Internal Jenkins,2016-01-08 00:57:48+00:00,['38c320cfdd1d30b1563bef4022c1aec951d941c2'],26,29,55,3046962,1,1,0,0.333333333,2807
85de03f294695f577cb6d0d1ec6b3eeab4d643e5,0,Internal Jenkins,2016-01-08 10:53:45+00:00,['c6f0667837254a44813b32a7ff2681afbe12e23e'],24,52,76,3047038,3,0.5,1,1,2807
c54ab5ef8640be058601b75912b35129ac6af777,0,Internal Jenkins,2016-01-08 20:28:50+00:00,['85de03f294695f577cb6d0d1ec6b3eeab4d643e5'],11,9,20,3047058,1,1,0,0,2807
51d59354a806bdf51e448fe59db95fd065d703f0,0,Internal Jenkins,2016-01-10 23:22:44+00:00,['c54ab5ef8640be058601b75912b35129ac6af777'],23,23,46,3047104,1,,,,2807
93c703b6022443ff3e6afdc6b7416117c67af39e,0,Internal Jenkins,2016-01-11 21:11:15+00:00,['51d59354a806bdf51e448fe59db95fd065d703f0'],0,5,5,3047109,5,,,,2807
1bfe51f16b676095544984ec0ed14e1246032101,0,Internal Jenkins,2016-01-11 21:35:43+00:00,['93c703b6022443ff3e6afdc6b7416117c67af39e'],120,0,120,3047229,1,0.873417722,0,0,2807
4f810e84962204ffd542450453068e67a442746a,1,Internal Jenkins,2016-01-11 21:45:18+00:00,['1bfe51f16b676095544984ec0ed14e1246032101'],13,17,30,3047259,3,1,1,0,2807
53e457f088f925647a87638504df69c17733b7d7,1,Internal Jenkins,2016-01-12 00:57:01+00:00,['4f810e84962204ffd542450453068e67a442746a'],4,13,17,3047276,8,,,,2807
bcfdd7bb31c89fd4c5478d772376eeb93f9fff9d,1,Internal Jenkins,2016-01-12 02:49:37+00:00,['53e457f088f925647a87638504df69c17733b7d7'],27,40,67,3047343,8,0.615384615,0.384615385,1,2807
f5ecadedb75bc323870c332b458ae439032f2e67,1,Internal Jenkins,2016-01-12 04:41:47+00:00,['bcfdd7bb31c89fd4c5478d772376eeb93f9fff9d'],1,7,8,3047351,1,1,1,0,2807
72c7428d2712fe01312859f16e1cb8071d96403a,0,Internal Jenkins,2016-01-12 04:42:59+00:00,['f5ecadedb75bc323870c332b458ae439032f2e67'],1,1,2,3047353,1,,,,2807
52f88fbd75350593f5e86690b40747931f9886ef,1,Internal Jenkins,2016-01-12 06:10:05+00:00,['72c7428d2712fe01312859f16e1cb8071d96403a'],1,21,22,3047375,2,,,,2807
e96b87994e2ae38d0123be11e176b649f4f37495,1,Internal Jenkins,2016-01-12 22:00:56+00:00,['52f88fbd75350593f5e86690b40747931f9886ef'],15,36,51,3047426,4,0.529411765,0.529411765,1,2807
2a940846955f76ab3860c690268f9a0c1e9d97f7,0,Martin Grund,2016-01-13 01:33:32+00:00,['e96b87994e2ae38d0123be11e176b649f4f37495'],10,13,23,3047449,5,0,1,1,2807
4b5ad8cbfd3241d0c2600bc59ffee602a0c58990,1,Internal Jenkins,2016-01-13 03:58:50+00:00,['2a940846955f76ab3860c690268f9a0c1e9d97f7'],10,6,16,3047465,3,,,,2807
dfc05657de71ec109733c092c7af62876d59610b,0,Internal Jenkins,2016-01-13 05:37:32+00:00,['4b5ad8cbfd3241d0c2600bc59ffee602a0c58990'],58,93,151,3047616,4,0.847345133,0.703539823,0.212389381,2807
fc17169006d6131376a447211bd86506eb0baf0a,0,Internal Jenkins,2016-01-13 12:37:32+00:00,['dfc05657de71ec109733c092c7af62876d59610b'],2,19,21,3047637,4,0,1,1,2807
cb9888e10e2ad4f96a07f26b02307e6e7b54d4ec,1,Casey Ching,2016-01-13 12:01:44-08:00,['84ce1e22afce1c81142c455d00068dba806e7682'],9,12,21,3047658,2,,,,2807
82a561f4ccb8839e5ef0e75c61d0013e6c3a56dc,0,Internal Jenkins,2016-01-13 21:03:09+00:00,['fc17169006d6131376a447211bd86506eb0baf0a'],2,2,4,3047662,1,,,,2807
ede6e749fdde95b3a052c17849c2a7bb9f156574,0,Internal Jenkins,2016-01-14 00:42:53+00:00,['82a561f4ccb8839e5ef0e75c61d0013e6c3a56dc'],7,11,18,3047680,2,,,,2807
022403bffc1976e9f3698346ebf4ba85545094da,1,Bharath Vissapragada,2016-01-14 02:28:16+00:00,['ede6e749fdde95b3a052c17849c2a7bb9f156574'],97,556,653,3048333,11,0.511111111,1,0.766666667,2808
1a3d7ffd4fd392b3ed831dfc7a3bfcfdb8cb8bbd,1,Internal Jenkins,2016-01-14 05:45:22+00:00,['022403bffc1976e9f3698346ebf4ba85545094da'],146,1366,1512,3049845,40,0,0,0.937062937,2808
4f61edee1dbe0f7921cf060a1f629468b68df3f7,1,Internal Jenkins,2016-01-14 06:04:48+00:00,['1a3d7ffd4fd392b3ed831dfc7a3bfcfdb8cb8bbd'],1,136,137,3049982,5,1,1,1,2808
cfb1ab5c2c513ea12fad19d3be33483718107f30,1,Internal Jenkins,2016-01-14 07:10:54+00:00,['4f61edee1dbe0f7921cf060a1f629468b68df3f7'],38,38,76,3050058,38,,,,2808
c9cb00f4a19a3eaf9fe93ffe69ec5ccab8996843,1,Internal Jenkins,2016-01-14 08:05:29+00:00,['cfb1ab5c2c513ea12fad19d3be33483718107f30'],9,28,37,3050095,2,,,,2808
d51f20fa1ff88e8de8f5dbc55f224e8251366d77,1,Martin Grund,2016-01-14 16:48:43+00:00,['c9cb00f4a19a3eaf9fe93ffe69ec5ccab8996843'],3,3,6,3050101,1,,,,2808
c59bf58d4684fa3958e7121a7219835c8336d9bf,1,Internal Jenkins,2016-01-14 21:00:55+00:00,['d51f20fa1ff88e8de8f5dbc55f224e8251366d77'],29,89,118,3050219,4,0,0.117647059,0.735294118,2808
f13dfcbddc6f55895c8be0e58c7c217682b2b039,1,Internal Jenkins,2016-01-15 19:38:46+00:00,['c59bf58d4684fa3958e7121a7219835c8336d9bf'],42,28,70,3050289,6,,,,2809
d74ed2cf174e36601f0afa7a5a273e73c7dd34df,0,Adar Dembo,2016-01-15 17:13:41-08:00,['cb9888e10e2ad4f96a07f26b02307e6e7b54d4ec'],0,8,8,3050297,1,,,,2809
1d8d1959c6075628fde75d5f87348cb65c68ee83,1,Internal Jenkins,2016-01-16 02:06:52+00:00,['f13dfcbddc6f55895c8be0e58c7c217682b2b039'],6,24,30,3050327,3,1,1,0.923076923,2809
992c261d66e8c78f9ce334345d88a46338638018,0,Internal Jenkins,2016-01-16 03:31:01+00:00,['1d8d1959c6075628fde75d5f87348cb65c68ee83'],0,12,12,3050339,3,1,1,1,2809
1832bb285e2b0dc4b503e8f4e0705dd89da071cd,1,Internal Jenkins,2016-01-17 08:50:07+00:00,['992c261d66e8c78f9ce334345d88a46338638018'],4,6,10,3050349,3,,,,2809
4648a39823df5b957b0f59cb5ccddb9596e00b68,1,Internal Jenkins,2016-01-17 09:04:53+00:00,['1832bb285e2b0dc4b503e8f4e0705dd89da071cd'],15,29,44,3050393,6,,,,2809
82a1aef91b86393973d98b8680c08d6064a70c99,1,Internal Jenkins,2016-01-18 16:55:45+00:00,['4648a39823df5b957b0f59cb5ccddb9596e00b68'],13,201,214,3050607,9,0.08988764,0.741573034,0.730337079,2809
b46b0f48adfeabc713ced4db1a871d4f3ee2a2e5,1,Internal Jenkins,2016-01-19 02:51:44+00:00,['82a1aef91b86393973d98b8680c08d6064a70c99'],16,71,87,3050694,4,1,1,1,2809
cca964c3c6d6744b65741c8875ada94cad876042,1,Internal Jenkins,2016-01-19 23:41:25+00:00,['b46b0f48adfeabc713ced4db1a871d4f3ee2a2e5'],19,50,69,3050763,3,0.8,1,1,2809
6982a49b582b83fe44873dbfe3e79215446500e5,0,Internal Jenkins,2016-01-20 04:10:02+00:00,['cca964c3c6d6744b65741c8875ada94cad876042'],15,4,19,3050782,3,,,,2809
30b861708f9402b82b0820f489ef9fa83cd68738,0,Internal Jenkins,2016-01-20 04:27:01+00:00,['6982a49b582b83fe44873dbfe3e79215446500e5'],16,16,32,3050814,3,,,,2809
9894cf6a55d708ff8fddc91445fde62fc116858f,1,Internal Jenkins,2016-01-20 04:32:21+00:00,['30b861708f9402b82b0820f489ef9fa83cd68738'],8,43,51,3050865,4,1,1,1,2809
43de306d17b16b36020f2e6d22afe3b3711550cc,1,Internal Jenkins,2016-01-20 04:38:19+00:00,['9894cf6a55d708ff8fddc91445fde62fc116858f'],59,120,179,3051044,3,,,,2810
05931e0e7f992ad73dee1f96fd070d523be80ada,0,Internal Jenkins,2016-01-20 05:15:04+00:00,['43de306d17b16b36020f2e6d22afe3b3711550cc'],0,12,12,3051056,2,,,,2811
ddad0607c2bcff6a6dc9516f206e6547ea2f25a6,0,Tim Armstrong,2016-01-20 09:27:29-08:00,['05931e0e7f992ad73dee1f96fd070d523be80ada'],5,0,5,3051061,1,,,,2811
f288867833b6f2953ef570217b953c9d523435b4,1,Internal Jenkins,2016-01-20 23:00:25+00:00,['ddad0607c2bcff6a6dc9516f206e6547ea2f25a6'],2718,4176,6894,3057955,34,0.453355155,0.490180033,0.744680851,2823
fdcb13565cdd6f3a11549c2fb8fd423760756837,0,Internal Jenkins,2016-01-20 23:11:09+00:00,['f288867833b6f2953ef570217b953c9d523435b4'],14,31,45,3058000,2,1,1,1,2823
7e92a5b8c90fdf9c62eb4278507d7a3218687674,1,Internal Jenkins,2016-01-20 23:42:08+00:00,['fdcb13565cdd6f3a11549c2fb8fd423760756837'],7,12,19,3058019,2,,,,2823
72d1889c0822ca9ecad87db741dcd3466624729c,1,Internal Jenkins,2016-01-21 05:42:17+00:00,['7e92a5b8c90fdf9c62eb4278507d7a3218687674'],4,5,9,3058028,3,,,,2823
39cf93a14566951d1a59efb07c7fd044d7177de8,0,Internal Jenkins,2016-01-21 11:43:58+00:00,['72d1889c0822ca9ecad87db741dcd3466624729c'],1,5,6,3058034,2,0,1,1,2823
78772d9d592caf53f55149a64696c5e7e37d25a1,0,Internal Jenkins,2016-01-21 20:24:29+00:00,['39cf93a14566951d1a59efb07c7fd044d7177de8'],2,2,4,3058038,1,0,1,1,2823
f8363a4dc1c917315c57587d6d9362dfef7e892c,0,Internal Jenkins,2016-01-22 00:17:10+00:00,['78772d9d592caf53f55149a64696c5e7e37d25a1'],1,1,2,3058040,1,,,,2823
6c2435d444b2230d1a98c3118ee4b907b1a8a284,0,Alex Behm,2016-01-22 02:30:36+00:00,['f8363a4dc1c917315c57587d6d9362dfef7e892c'],0,2,2,3058042,1,,,,2823
16f7119b37e9a0c3eb11d3e7b1adb1c370368ba3,0,Internal Jenkins,2016-01-22 08:39:06+00:00,['6c2435d444b2230d1a98c3118ee4b907b1a8a284'],1,1,2,3058044,1,,,,2823
418a165e7c15bd481cdd5676dc85c398b8c7c135,1,Internal Jenkins,2016-01-22 08:55:35+00:00,['16f7119b37e9a0c3eb11d3e7b1adb1c370368ba3'],1,1,2,3058046,1,,,,2823
1cc69a1761ff0ff97eb4efd07decc69a45d2280d,1,Internal Jenkins,2016-01-22 19:41:52+00:00,['418a165e7c15bd481cdd5676dc85c398b8c7c135'],0,1,1,3058047,1,,,,2823
b3ae4921a6ce980e46ef82b4158bda47c83c97e7,0,Internal Jenkins,2016-01-22 21:01:18+00:00,['1cc69a1761ff0ff97eb4efd07decc69a45d2280d'],2,2,4,3058051,1,,,,2823
d3ab94162c51549dced0ef82668121e9191e9a5c,0,Internal Jenkins,2016-01-22 22:13:47+00:00,['b3ae4921a6ce980e46ef82b4158bda47c83c97e7'],5,0,5,3058056,1,1,0,0.2,2823
9c4eb9fc6140c2c5606cc7cc1e08c1e442709929,1,Internal Jenkins,2016-01-22 22:59:22+00:00,['d3ab94162c51549dced0ef82668121e9191e9a5c'],7,16,23,3058079,3,0.333333333,1,1,2823
f2a1274a05267c7329f0e4fdd1fdbc47a03c7a35,1,Internal Jenkins,2016-01-23 03:25:23+00:00,['9c4eb9fc6140c2c5606cc7cc1e08c1e442709929'],26,38,64,3058143,1,0,0,1,2823
708ab3c6690cb8ecc8e8dc9608d8f3e010014d9b,1,Internal Jenkins,2016-01-23 09:38:40+00:00,['f2a1274a05267c7329f0e4fdd1fdbc47a03c7a35'],107,138,245,3058388,6,0.636363636,0.636363636,0.636363636,2823
0aec98f674b2159658e203d82651ba34d8364d30,1,Internal Jenkins,2016-01-23 23:59:27+00:00,['708ab3c6690cb8ecc8e8dc9608d8f3e010014d9b'],1,37,38,3058426,3,0,0,0,2823
75d444176335af5acf363572ff243067a9ba5837,1,Internal Jenkins,2016-01-24 00:51:25+00:00,['0aec98f674b2159658e203d82651ba34d8364d30'],1,3,4,3058430,1,,,,2823
e60cde8acdb5dab8ef299f8372ae25db088f073f,1,Internal Jenkins,2016-01-25 22:44:54+00:00,['75d444176335af5acf363572ff243067a9ba5837'],76,77,153,3058583,14,,,,2823
b948973d196b7454297ae1861a342e5a87c166e9,0,Internal Jenkins,2016-01-26 03:09:39+00:00,['e60cde8acdb5dab8ef299f8372ae25db088f073f'],2,15,17,3058600,1,0,0.5,1,2823
968c61c940fe78faa08e8cc4bd257dd2ec19dc11,1,Internal Jenkins,2016-01-26 03:13:05+00:00,['b948973d196b7454297ae1861a342e5a87c166e9'],71,65,136,3058736,13,0.1,0.133333333,0.766666667,2823
a2bed785a32d4c6cef1248f9434be5291adfafbc,0,Internal Jenkins,2016-01-26 04:38:53+00:00,['968c61c940fe78faa08e8cc4bd257dd2ec19dc11'],1,2,3,3058739,1,,,,2823
9439b2ba24523ba6cca1eecdd7334a58206ed341,0,Internal Jenkins,2016-01-26 06:43:56+00:00,['a2bed785a32d4c6cef1248f9434be5291adfafbc'],7,11,18,3058757,4,0.333333333,0.333333333,1,2823
8eac4da39a1b917848e7f621fe2559f27d32101c,0,Internal Jenkins,2016-01-26 11:08:51+00:00,['9439b2ba24523ba6cca1eecdd7334a58206ed341'],0,2,2,3058759,1,,,,2823
95951a36e83c3ab577d744445c60e8d193c93a53,1,Internal Jenkins,2016-01-26 11:32:40+00:00,['8eac4da39a1b917848e7f621fe2559f27d32101c'],1,59,60,3058819,3,0,0,0,2823
f3e72743428e6c0a2d551c81f92bcad32d4f6785,1,Internal Jenkins,2016-01-26 11:53:38+00:00,['95951a36e83c3ab577d744445c60e8d193c93a53'],4,28,32,3058851,4,1,1,1,2823
0c6628af18bcb72747dc1d368b499af7dbca70da,1,Internal Jenkins,2016-01-26 21:15:04+00:00,['f3e72743428e6c0a2d551c81f92bcad32d4f6785'],7,7,14,3058865,2,,,,2823
f1824c955225ad6c928beb9def0ecdf4c8d4db56,0,Internal Jenkins,2016-01-26 21:22:58+00:00,['0c6628af18bcb72747dc1d368b499af7dbca70da'],1,4,5,3058870,1,,,,2823
0853ea1a7d41720f09e8b65aa1186b197d6100a9,1,Internal Jenkins,2016-01-26 22:06:26+00:00,['f1824c955225ad6c928beb9def0ecdf4c8d4db56'],471,926,1397,3060267,22,0.447058824,0,0,2825
6b3c9cac459983674df1b21b5ae4a039828e3085,0,Internal Jenkins,2016-01-27 01:51:42+00:00,['0853ea1a7d41720f09e8b65aa1186b197d6100a9'],23,10,33,3060300,1,,,,2825
525189371041585160fdb3caccc502cf4e487f78,0,Internal Jenkins,2016-01-27 05:15:06+00:00,['6b3c9cac459983674df1b21b5ae4a039828e3085'],8,19,27,3060327,3,1,0,0,2825
2876a1a541504dd1436ad06556b61348b7dae159,1,Internal Jenkins,2016-01-27 09:04:30+00:00,['525189371041585160fdb3caccc502cf4e487f78'],89,167,256,3060583,7,0.35,0.3,1,2825
65a8bbca8e1aaa6df4d1bba95891e35c1695767e,1,Internal Jenkins,2016-01-27 10:16:11+00:00,['2876a1a541504dd1436ad06556b61348b7dae159'],113,99,212,3060795,8,1,0.375,0.25,2825
0687c547925908c5da0da0218966661af3c3a16d,1,Internal Jenkins,2016-01-27 20:41:45+00:00,['65a8bbca8e1aaa6df4d1bba95891e35c1695767e'],23,23,46,3060841,2,,,,2825
c1d1fdadb5c9f8cc58a0d44fefd96358b13e47c7,0,Internal Jenkins,2016-01-28 01:12:30+00:00,['0687c547925908c5da0da0218966661af3c3a16d'],8,15,23,3060864,3,0,0,0,2825
755c18b09954204abe83471838e8df4217b57c31,0,Adar Dembo,2016-01-27 17:18:23-08:00,['d74ed2cf174e36601f0afa7a5a273e73c7dd34df'],1,4,5,3060869,1,0,0,1,2825
a1b11261d1a41c1c7f415409bfcdac7191c98ffd,1,Internal Jenkins,2016-01-28 01:38:01+00:00,['c1d1fdadb5c9f8cc58a0d44fefd96358b13e47c7'],6,31,37,3060906,2,0,1,0.916666667,2825
84a9ad5fbb5e7b7ea281d79c20ce1472aae8eeb9,0,Internal Jenkins,2016-01-28 03:33:37+00:00,['a1b11261d1a41c1c7f415409bfcdac7191c98ffd'],3,8,11,3060917,1,,,,2825
ace5e827486211f35d02da1922315b693901ea56,1,Internal Jenkins,2016-01-28 04:36:14+00:00,['84a9ad5fbb5e7b7ea281d79c20ce1472aae8eeb9'],34,13,47,3060964,8,0.882352941,0.294117647,0.235294118,2825
838e7737974ac2149285b50a03577e74f6f0365d,1,Internal Jenkins,2016-01-28 04:38:54+00:00,['ace5e827486211f35d02da1922315b693901ea56'],0,1,1,3060965,1,,,,2825
5a4daeb787a032f66d314ed573f24decafc15e5c,1,Internal Jenkins,2016-01-28 05:29:49+00:00,['838e7737974ac2149285b50a03577e74f6f0365d'],153,66,219,3061184,27,0.753846154,1,0.307692308,2825
b78b37cbdc450147d00c8ccb0173334618cf2f6f,1,Internal Jenkins,2016-01-28 09:18:57+00:00,['5a4daeb787a032f66d314ed573f24decafc15e5c'],1185,1641,2826,3064010,22,0.314984709,0.743119266,0.896024465,2825
aed3505c8d17f759be4f73593f6aa290df384cfa,0,Internal Jenkins,2016-01-28 13:40:32+00:00,['b78b37cbdc450147d00c8ccb0173334618cf2f6f'],2,26,28,3064038,3,0,0,1,2825
1f3da41f73900e4b4c5baeb6fc08dbf3eae405c5,1,Internal Jenkins,2016-01-28 20:01:37+00:00,['aed3505c8d17f759be4f73593f6aa290df384cfa'],23,140,163,3064201,9,0.024096386,0.891566265,0,2825
b648d203ea857b02b1c5e7623b5549d346b05d5e,1,Tim Armstrong,2016-01-28 21:31:28+00:00,['1f3da41f73900e4b4c5baeb6fc08dbf3eae405c5'],59,229,288,3064489,8,0.308411215,0.906542056,0.925233645,2825
1e88abb6d51dbd47839b6dcb4556056ef59c37db,1,Casey Ching,2016-01-28 16:22:57-08:00,['755c18b09954204abe83471838e8df4217b57c31'],3,1,4,3064493,1,1,1,0,2825
b8b5fecd12ff592310662418b966e34316ca8ae6,1,Internal Jenkins,2016-01-29 01:06:19+00:00,['b648d203ea857b02b1c5e7623b5549d346b05d5e'],93,702,795,3065288,7,0.111111111,0.64021164,0.420634921,2826
1ad99ca27e5de9c8a035a537f3662ee9b46edcb6,0,Todd Lipcon,2016-01-28 17:06:59-08:00,['1e88abb6d51dbd47839b6dcb4556056ef59c37db'],1,2,3,3065291,1,1,1,1,2826
8c224398bb660d061758c2124a111b15dafe7957,1,Casey Ching,2016-01-28 21:49:39-08:00,['1ad99ca27e5de9c8a035a537f3662ee9b46edcb6'],2,28,30,3065321,2,,,,2826
8e78f1ece94363c656a6a07c3c5a22231e6e2eab,1,Todd Lipcon,2016-01-29 16:33:17-08:00,['8c224398bb660d061758c2124a111b15dafe7957'],7,25,32,3065353,3,0.909090909,0.909090909,1,2826
dbf5f0c86d76597f2729d5ad8946b9872ac50749,1,Internal Jenkins,2016-01-30 04:20:04+00:00,['b8b5fecd12ff592310662418b966e34316ca8ae6'],4,4,8,3065361,1,,,,2826
f3d2f6bd7e1a95e3f8bfb7064ff82f450b749477,1,Internal Jenkins,2016-01-30 06:02:09+00:00,['dbf5f0c86d76597f2729d5ad8946b9872ac50749'],98,288,386,3065747,12,0.10619469,0.637168142,0.504424779,2826
5d33a01ae81d16a762c8e54407ab6f55ca7efb5c,1,Internal Jenkins,2016-02-02 00:19:22+00:00,['f3d2f6bd7e1a95e3f8bfb7064ff82f450b749477'],6,15,21,3065768,1,1,1,1,2826
8395d285b7f99c3504a05ad65321da8b267c89b7,0,Internal Jenkins,2016-02-02 03:25:29+00:00,['5d33a01ae81d16a762c8e54407ab6f55ca7efb5c'],0,3,3,3065771,1,,,,2826
7fbf56430ad2cfe777bd0bbba32b5bbf14fa5103,1,Internal Jenkins,2016-02-02 03:44:19+00:00,['8395d285b7f99c3504a05ad65321da8b267c89b7'],0,21,21,3065792,2,,,,2826
177ac96e84b1ff3c1fb36e976ea7aaa341dce645,1,Internal Jenkins,2016-02-02 04:30:15+00:00,['7fbf56430ad2cfe777bd0bbba32b5bbf14fa5103'],5,34,39,3065831,5,0.823529412,1,0.588235294,2826
71694b7b429f6e702279d738419cf4efddcecefa,1,Internal Jenkins,2016-02-02 06:32:05+00:00,['177ac96e84b1ff3c1fb36e976ea7aaa341dce645'],7,8,15,3065846,1,0,0,0,2826
ac1e33fdb0b4f4081c2cfd20fa9d3484bb5df740,1,Internal Jenkins,2016-02-02 07:07:44+00:00,['71694b7b429f6e702279d738419cf4efddcecefa'],58,257,315,3066161,8,0.014084507,0.478873239,0.774647887,2826
89c3c61a923a03dcc8928d7a081c23943e7140b6,1,Internal Jenkins,2016-02-02 20:10:02+00:00,['ac1e33fdb0b4f4081c2cfd20fa9d3484bb5df740'],164,297,461,3066622,13,1,0.848484848,0.818181818,2827
cb9a78ca090035e758cd09c9060f368afae28024,0,Internal Jenkins,2016-02-02 21:28:43+00:00,['89c3c61a923a03dcc8928d7a081c23943e7140b6'],11,20,31,3066653,2,0.5,0.5,0.5,2827
4fc7f15376a3acc9206751a0f205a7217bb4b91c,0,Internal Jenkins,2016-02-02 21:55:57+00:00,['cb9a78ca090035e758cd09c9060f368afae28024'],10,10,20,3066673,3,,,,2827
e1e0bbda37c9bb2ada44523973850350d8941331,1,Internal Jenkins,2016-02-02 22:46:28+00:00,['4fc7f15376a3acc9206751a0f205a7217bb4b91c'],54,56,110,3066783,2,0,1,1,2827
82af47c7af2b925bea679e8cdc823af07efa53d3,1,Internal Jenkins,2016-02-03 00:14:28+00:00,['e1e0bbda37c9bb2ada44523973850350d8941331'],26,52,78,3066861,3,0.666666667,0.958333333,0.958333333,2827
194377f7d8180419fad1144dd6f0bbfd4fbe99d5,0,Internal Jenkins,2016-02-03 00:24:59+00:00,['82af47c7af2b925bea679e8cdc823af07efa53d3'],2,5,7,3066868,2,,,,2827
1ac44df24b47a554bce3f4d89129495b9cd5d13d,1,Internal Jenkins,2016-02-03 00:38:08+00:00,['194377f7d8180419fad1144dd6f0bbfd4fbe99d5'],63,248,311,3067179,7,0.401869159,0.420560748,0.46728972,2827
db4bd623ed9542e35454f8fbc18d9b10c6452a72,1,Internal Jenkins,2016-02-03 00:58:50+00:00,['1ac44df24b47a554bce3f4d89129495b9cd5d13d'],19,14,33,3067212,5,,,,2827
d718efb40462aad4feb2ccff525530924a4b4359,1,Internal Jenkins,2016-02-03 02:27:09+00:00,['db4bd623ed9542e35454f8fbc18d9b10c6452a72'],5,5,10,3067222,1,,,,2827
5d2bc776cd6d9c2ce5c2c28e918dcd4b01809d28,1,Henry Robinson,2016-02-03 04:52:05+00:00,['d718efb40462aad4feb2ccff525530924a4b4359'],400,586,986,3068208,18,0.76744186,0.930232558,0.290697674,2828
df599b79d983ef54c9f45c276117eaa114092fbb,1,Internal Jenkins,2016-02-03 10:10:28+00:00,['5d2bc776cd6d9c2ce5c2c28e918dcd4b01809d28'],0,67,67,3068275,4,1,1,1,2828
7fc739f6d6d20f379de21127ea5fbf5de932980b,1,Internal Jenkins,2016-02-03 20:46:32+00:00,['df599b79d983ef54c9f45c276117eaa114092fbb'],67,183,250,3068525,16,0.361111111,0.833333333,0.75,2833
1750fa0945898d3f9460d2ab23e61268e9d17489,1,Internal Jenkins,2016-02-03 23:01:19+00:00,['7fc739f6d6d20f379de21127ea5fbf5de932980b'],438,895,1333,3069858,12,0.061371841,0.353790614,1,2833
ccf1f8f73f9f9343b54665d82d6ed7bce9c268a9,1,Internal Jenkins,2016-02-04 01:06:03+00:00,['1750fa0945898d3f9460d2ab23e61268e9d17489'],16,102,118,3069976,6,0.191489362,0.680851064,0.978723404,2833
c10da64d83f3b147aefd552eb49f9353e86a66fa,0,Internal Jenkins,2016-02-04 01:26:13+00:00,['ccf1f8f73f9f9343b54665d82d6ed7bce9c268a9'],0,0,0,3069976,0,,,,2833
2ff0f251d1247259653dda39e9c421df60276f39,0,Internal Jenkins,2016-02-04 04:18:07+00:00,['c10da64d83f3b147aefd552eb49f9353e86a66fa'],1,10,11,3069987,1,1,1,1,2833
844b3081b319498f75ce8bec8e9cf0e4fc444373,1,Internal Jenkins,2016-02-04 21:27:13+00:00,['2ff0f251d1247259653dda39e9c421df60276f39'],3,26,29,3070016,2,1,1,1,2833
e84cb11adfa7d6b16eb4d974c877e62e0dea4c04,1,Internal Jenkins,2016-02-05 01:36:57+00:00,['844b3081b319498f75ce8bec8e9cf0e4fc444373'],61,61,122,3070138,1,1,0.5,0.666666667,2833
0f0d9c058dc387aa5441c6eb5d080bd8aa869471,0,Internal Jenkins,2016-02-05 01:57:24+00:00,['e84cb11adfa7d6b16eb4d974c877e62e0dea4c04'],0,0,0,3070138,0,,,,2833
a1a1bf9e3992e727ae57d8323ab19b5ac62fcb8a,1,Internal Jenkins,2016-02-05 04:31:39+00:00,['0f0d9c058dc387aa5441c6eb5d080bd8aa869471'],10,53,63,3070201,3,0,1,1,2833
b8f700f5e6b2ea1690f6b71546639c596a90929d,0,Internal Jenkins,2016-02-05 10:00:47+00:00,['a1a1bf9e3992e727ae57d8323ab19b5ac62fcb8a'],14,6,20,3070221,3,0,0,0,2833
281decf2bfba720fb0cc48554ba9bd6ce4389cf5,1,Internal Jenkins,2016-02-05 10:15:12+00:00,['b8f700f5e6b2ea1690f6b71546639c596a90929d'],438,319,757,3070978,20,1,0.282608696,0.101449275,2834
f6309c4bd155ee2fcb90c848a34c6ffd983f32af,1,Internal Jenkins,2016-02-05 11:11:34+00:00,['281decf2bfba720fb0cc48554ba9bd6ce4389cf5'],1,1,2,3070980,1,,,,2834
188dee6c07902127698a70a9ae326249e7a1b49f,1,Internal Jenkins,2016-02-05 11:47:35+00:00,['f6309c4bd155ee2fcb90c848a34c6ffd983f32af'],19,344,363,3071343,4,0.698841699,0.911196911,0.428571429,2834
50bf47418762281599f0c9b9d8a5c1acd3f2f957,0,Internal Jenkins,2016-02-05 19:15:53+00:00,['188dee6c07902127698a70a9ae326249e7a1b49f'],2,32,34,3071377,2,1,1,1,2834
ba1ad352a6abdbf7566118a63aadc98acfbe4712,0,Internal Jenkins,2016-02-05 19:23:37+00:00,['50bf47418762281599f0c9b9d8a5c1acd3f2f957'],1,15,16,3071393,2,0,1,1,2834
7c81e7e05752ca8ac6a0e713757b578cf7d7768d,1,Internal Jenkins,2016-02-05 20:17:19+00:00,['ba1ad352a6abdbf7566118a63aadc98acfbe4712'],423,714,1137,3072530,29,1,1,0,2836
b2e5361851cf8bba137d330727cbb33bf359e9ab,0,Internal Jenkins,2016-02-05 21:45:42+00:00,['7c81e7e05752ca8ac6a0e713757b578cf7d7768d'],2,6,8,3072538,1,1,1,1,2836
12ebc65483cd98716da70f578b5368a1202c80cd,0,Internal Jenkins,2016-02-05 21:54:05+00:00,['b2e5361851cf8bba137d330727cbb33bf359e9ab'],31,31,62,3072600,7,1,1,1,2836
fbcc2433ea96f67a7d105bdec8238b797db770a4,0,Internal Jenkins,2016-02-05 22:20:46+00:00,['12ebc65483cd98716da70f578b5368a1202c80cd'],7,10,17,3072617,1,,,,2836
e75dd8cfc56ab4304ef812373599d365b3974964,1,Internal Jenkins,2016-02-05 22:38:39+00:00,['fbcc2433ea96f67a7d105bdec8238b797db770a4'],20,34,54,3072671,2,1,1,1,2836
9dac1b92b5273dcd940e4f4312a11d20ae4bf358,0,Internal Jenkins,2016-02-06 00:52:47+00:00,['e75dd8cfc56ab4304ef812373599d365b3974964'],1,1,2,3072673,1,,,,2836
226df6874788f19e0d9bf3f6c83a9e3904a6a3a0,1,Internal Jenkins,2016-02-06 01:10:24+00:00,['9dac1b92b5273dcd940e4f4312a11d20ae4bf358'],0,17,17,3072690,2,0,0,0.615384615,2836
733d1352125b2a5be077e5d54b92a5b3dab320a8,1,Internal Jenkins,2016-02-06 01:31:34+00:00,['226df6874788f19e0d9bf3f6c83a9e3904a6a3a0'],21,44,65,3072755,4,0,0.6,1,2836
454f1ce3d4c0dffa2cd6b09f4e1ce7ee14907ee1,0,Internal Jenkins,2016-02-06 01:49:11+00:00,['733d1352125b2a5be077e5d54b92a5b3dab320a8'],1,3,4,3072759,2,0,1,1,2836
481988fceaaaa013b561dd3ebe1406557f3003e3,1,Internal Jenkins,2016-02-06 02:07:39+00:00,['454f1ce3d4c0dffa2cd6b09f4e1ce7ee14907ee1'],1,1,2,3072761,1,,,,2836
19b83763fbfd942d6559a2a24bf8b9f2318f1373,1,Internal Jenkins,2016-02-06 03:24:35+00:00,['481988fceaaaa013b561dd3ebe1406557f3003e3'],36,64,100,3072861,9,0.333333333,0.777777778,0.388888889,2836
4da0b5a30d588fb533d96b078088bfa053905600,0,Internal Jenkins,2016-02-06 04:49:16+00:00,['19b83763fbfd942d6559a2a24bf8b9f2318f1373'],39,57,96,3072957,1,0,0,0,2836
3d7a4477ee13b627d3e66f374d3e213694a146aa,1,Internal Jenkins,2016-02-06 05:28:28+00:00,['4da0b5a30d588fb533d96b078088bfa053905600'],4,46,50,3073007,4,0,0,0.4,2836
a467363c1c07332f43c2d11b34bc959343da29f7,0,Internal Jenkins,2016-02-06 05:47:48+00:00,['3d7a4477ee13b627d3e66f374d3e213694a146aa'],128,11,139,3073146,2,0.43373494,0.228915663,0,2836
ecf46a5af8663ca8d0b04a8ea5341ccca0fe6817,1,Internal Jenkins,2016-02-06 09:26:46+00:00,['a467363c1c07332f43c2d11b34bc959343da29f7'],1402,1779,3181,3076327,25,0.944444444,0.944444444,0.972222222,2836
b35f6d070c8e6b51079f962b448ecc2b0eb74c1a,1,Internal Jenkins,2016-02-07 23:51:00+00:00,['ecf46a5af8663ca8d0b04a8ea5341ccca0fe6817'],2,1015,1017,3077344,10,0.592427617,0.828507795,0.942093541,2842
062fbebf0b45571fc0470f2ac2df49fc2dddf041,1,Internal Jenkins,2016-02-08 20:08:21+00:00,['b35f6d070c8e6b51079f962b448ecc2b0eb74c1a'],31,69,100,3077444,2,0,0.916666667,0.916666667,2842
f9c718e4ea3c0a1ec1abeb7a8401afdea4ff9503,0,Internal Jenkins,2016-02-08 20:14:05+00:00,['062fbebf0b45571fc0470f2ac2df49fc2dddf041'],11,11,22,3077466,1,,,,2842
80b7f798401d45e10f9b66d7d230994e16ec09a6,1,Internal Jenkins,2016-02-08 23:17:47+00:00,['f9c718e4ea3c0a1ec1abeb7a8401afdea4ff9503'],150,235,385,3077851,10,0,1,0,2842
a89fc4a3b817541d4fbd904480925f9343412a16,0,Internal Jenkins,2016-02-09 01:07:09+00:00,['80b7f798401d45e10f9b66d7d230994e16ec09a6'],18,24,42,3077893,1,0,0,1,2842
a5820cb0d0770c876756ce4a4588d09f8177d7f1,0,Internal Jenkins,2016-02-09 03:57:55+00:00,['a89fc4a3b817541d4fbd904480925f9343412a16'],3,5,8,3077901,1,,,,2842
81effb46e6293c9aa3d56fadbeff5cfd8b620d75,0,Internal Jenkins,2016-02-09 04:36:48+00:00,['a5820cb0d0770c876756ce4a4588d09f8177d7f1'],4,7,11,3077912,2,1,1,1,2842
4cbb8f07ae82de4dcb564bba6f51a6a4ab3dca02,0,Internal Jenkins,2016-02-09 05:29:41+00:00,['81effb46e6293c9aa3d56fadbeff5cfd8b620d75'],36,31,67,3077979,2,0.333333333,0,0,2842
444292468f7ad19c05b91d29092228447c5db544,0,Internal Jenkins,2016-02-09 05:31:21+00:00,['4cbb8f07ae82de4dcb564bba6f51a6a4ab3dca02'],4,5,9,3077988,2,1,1,0,2842
a57be09fc7340ae3416cecf29dec74d071ea7479,1,Internal Jenkins,2016-02-09 08:42:58+00:00,['444292468f7ad19c05b91d29092228447c5db544'],154,258,412,3078400,5,0.264150943,0,0,2842
2e0b1226148899b347d29fb8e151fbab08f7b926,1,Internal Jenkins,2016-02-09 10:29:25+00:00,['a57be09fc7340ae3416cecf29dec74d071ea7479'],3,10,13,3078413,2,,,,2842
ac3f2fc243d422dacd26b3b465de975bc8b83312,0,Internal Jenkins,2016-02-09 23:31:41+00:00,['2e0b1226148899b347d29fb8e151fbab08f7b926'],5,13,18,3078431,3,1,1,1,2842
bcce19012d51e61e6be2cb6eeb6f8e7c6283aa55,1,Internal Jenkins,2016-02-10 00:20:46+00:00,['ac3f2fc243d422dacd26b3b465de975bc8b83312'],13,163,176,3078607,5,0.281553398,0.689320388,1,2843
256aec65d0b72454a13f07dbd6235aeeaada5248,0,Internal Jenkins,2016-02-10 00:43:27+00:00,['bcce19012d51e61e6be2cb6eeb6f8e7c6283aa55'],6,6,12,3078619,2,,,,2843
16e3dfa49a0d45fddca2a076285ec095e2d1ddf6,1,Internal Jenkins,2016-02-10 00:43:43+00:00,['256aec65d0b72454a13f07dbd6235aeeaada5248'],47,297,344,3078963,18,0.037634409,0.537634409,0.946236559,2843
40f75fb1ba75e744a4d260012c24cc3bbd1803ff,0,Internal Jenkins,2016-02-10 00:54:11+00:00,['16e3dfa49a0d45fddca2a076285ec095e2d1ddf6'],41,19,60,3079023,2,1,1,1,2843
7a0a5012bea1836c300da6e6b73812344159bf9a,0,Internal Jenkins,2016-02-10 02:17:44+00:00,['40f75fb1ba75e744a4d260012c24cc3bbd1803ff'],1,13,14,3079037,2,,,,2843
c06e124dc208d68908467d857f8b54a881e6c9a3,0,Internal Jenkins,2016-02-10 04:44:31+00:00,['7a0a5012bea1836c300da6e6b73812344159bf9a'],45,43,88,3079125,7,1,0,0,2844
9a9886ee37651c610e6640487f2c79c9a65c1044,0,Internal Jenkins,2016-02-10 07:16:58+00:00,['c06e124dc208d68908467d857f8b54a881e6c9a3'],13,43,56,3079181,2,1,1,0,2844
f3733aed8491cceed939ab18471d66eb917ef923,1,Internal Jenkins,2016-02-10 10:17:18+00:00,['9a9886ee37651c610e6640487f2c79c9a65c1044'],78,185,263,3079444,5,0.348837209,1,0.930232558,2845
6c8cffd426c3b60154ed152c894c4c38ee5a6986,1,Internal Jenkins,2016-02-10 11:08:51+00:00,['f3733aed8491cceed939ab18471d66eb917ef923'],35,18,53,3079497,13,1,0,1,2845
d787e1e3a701be3fdc042cb5a32faa35df91e669,0,Internal Jenkins,2016-02-10 11:30:19+00:00,['6c8cffd426c3b60154ed152c894c4c38ee5a6986'],1,35,36,3079533,3,0.833333333,0.833333333,0.833333333,2846
ca8d454b04a6778f6748d692513ce9a41fe9f91d,0,Internal Jenkins,2016-02-10 11:30:49+00:00,['d787e1e3a701be3fdc042cb5a32faa35df91e669'],8,15,23,3079556,1,1,1,1,2846
392f4a9f6d8d5499a1bebd4d1093f2ef446237b4,1,Internal Jenkins,2016-02-10 22:21:45+00:00,['ca8d454b04a6778f6748d692513ce9a41fe9f91d'],25,126,151,3079707,13,0.382978723,0.744680851,0.723404255,2846
30637ab8af9709ca9c1d2c43b7523ba4d3466823,0,Internal Jenkins,2016-02-10 23:28:52+00:00,['392f4a9f6d8d5499a1bebd4d1093f2ef446237b4'],0,0,0,3079707,0,,,,2846
039bd44fdf22596978def43d66262e4279afd93e,1,Internal Jenkins,2016-02-11 02:32:22+00:00,['30637ab8af9709ca9c1d2c43b7523ba4d3466823'],84,189,273,3079980,13,0,0,0.95,2846
c9353e306c304911cb96bbd9f5aeda9dd0820fb0,0,Internal Jenkins,2016-02-11 06:37:33+00:00,['039bd44fdf22596978def43d66262e4279afd93e'],6,0,6,3079986,1,0,0,0,2846
2c2670e389beb4058fd2a20ce8e58204da6cefe5,1,Tim Armstrong,2016-02-11 19:03:51+00:00,['c9353e306c304911cb96bbd9f5aeda9dd0820fb0'],313,1061,1374,3081360,44,0.077844311,0.278443114,0.832335329,2848
3c2cb9569831aee2df484786577cfc9a1e2e2db5,1,Internal Jenkins,2016-02-11 21:23:10+00:00,['2c2670e389beb4058fd2a20ce8e58204da6cefe5'],601,962,1563,3082923,11,1,1,1,2848
c943d6ab7d39bd36e18bc966cad5b1fad8cb8cf8,1,Henry Robinson,2016-02-12 00:11:45+00:00,['3c2cb9569831aee2df484786577cfc9a1e2e2db5'],35,1572,1607,3084530,21,0.498412698,0.546031746,0.866666667,2851
d7ee6fa7a4b6314dc0cdfb21419d6cae241c0eed,1,Internal Jenkins,2016-02-12 00:23:43+00:00,['c943d6ab7d39bd36e18bc966cad5b1fad8cb8cf8'],37,283,320,3084850,13,0.830188679,0.830188679,0.830188679,2854
a3409f803199e39ee21e655fc6cb5ccb9c1c6667,0,Internal Jenkins,2016-02-12 01:35:50+00:00,['d7ee6fa7a4b6314dc0cdfb21419d6cae241c0eed'],7,36,43,3084893,1,0,0,1,2854
843ea3668a31ee30d8aafd855a0d413ff9f4d74b,1,Internal Jenkins,2016-02-12 04:56:09+00:00,['a3409f803199e39ee21e655fc6cb5ccb9c1c6667'],26,44,70,3084963,9,0.428571429,0.428571429,0.714285714,2854
7ca4977b4cac830c6e87205de3820de799de47a1,1,Bharath Vissapragada,2016-02-12 12:49:31+00:00,['843ea3668a31ee30d8aafd855a0d413ff9f4d74b'],9,10,19,3084982,1,0,1,1,2854
1855da1347d2edeec9f368e545f15a8ebe35c50a,1,Internal Jenkins,2016-02-13 08:16:06+00:00,['7ca4977b4cac830c6e87205de3820de799de47a1'],121,207,328,3085310,3,0,1,1,2854
1c102d9d8e9d6779280a8af1e2cb556e6d831a37,1,Internal Jenkins,2016-02-13 10:08:13+00:00,['1855da1347d2edeec9f368e545f15a8ebe35c50a'],20,18,38,3085348,2,,,,2854
22122401067112d969980a445b8cd38efce121de,1,Henry Robinson,2016-02-13 16:19:41+00:00,['1c102d9d8e9d6779280a8af1e2cb556e6d831a37'],658,2942,3600,3088948,101,0.429769392,0.593291405,0.800838574,2858
63cafc97d51fa93dee1d6bcc853a52de91ffffbb,0,Henry Robinson,2016-02-13 16:21:42+00:00,['22122401067112d969980a445b8cd38efce121de'],2,1,3,3088951,1,,,,2858
3589eab84c42889faaa29fc2595c3feb55fa3860,1,Henry Robinson,2016-02-13 16:22:32+00:00,['63cafc97d51fa93dee1d6bcc853a52de91ffffbb'],3,94,97,3089048,5,0.263157895,0.298245614,0.98245614,2858
b78324a4ba27c4324d5967a221d893838561bcc6,1,Henry Robinson,2016-02-13 16:22:57+00:00,['3589eab84c42889faaa29fc2595c3feb55fa3860'],0,18,18,3089066,1,0,0,0,2858
dd068429c6316e7b05bf9e2ede936d274e373dd6,1,Henry Robinson,2016-02-13 16:24:15+00:00,['b78324a4ba27c4324d5967a221d893838561bcc6'],6,22,28,3089094,5,0,0,0,2858
db90f9954ef772608af4e9621592c3e82da54f57,1,Internal Jenkins,2016-02-14 07:08:22+00:00,['dd068429c6316e7b05bf9e2ede936d274e373dd6'],5,1,6,3089100,2,,,,2858
d2e8881065986ae2a74da9d2dd246e7f92393922,0,Internal Jenkins,2016-02-18 02:44:40+00:00,['db90f9954ef772608af4e9621592c3e82da54f57'],4,19,23,3089123,1,1,1,1,2858
2388f54bfe18499c24a0dd1207ba44e90c5c50ad,0,Juan Yu,2016-02-17 20:21:47-08:00,['d2e8881065986ae2a74da9d2dd246e7f92393922'],2,2,4,3089127,2,,,,2858
212bea529fc0694b43253960408170e9a04b47ec,0,Juan Yu,2016-02-17 20:21:57-08:00,['2388f54bfe18499c24a0dd1207ba44e90c5c50ad'],3,4,7,3089134,1,,,,2858
4dd0a5a2bd22ce5cde13b5b0a0638ffded735b2e,0,Juan Yu,2016-02-17 20:22:05-08:00,['212bea529fc0694b43253960408170e9a04b47ec'],36,54,90,3089224,3,0,0,0,2858
35ad46c1ce05651ac6a49a8f62e6a6b863e9506f,0,Juan Yu,2016-02-17 20:22:14-08:00,['4dd0a5a2bd22ce5cde13b5b0a0638ffded735b2e'],2,3,5,3089229,1,,,,2858
f90c5a43c784010315e3d558b283bf9166f90f9b,1,Juan Yu,2016-02-17 20:22:35-08:00,['35ad46c1ce05651ac6a49a8f62e6a6b863e9506f'],8,24,32,3089261,3,1,1,1,2858
9aeb77023f8e9ca95bdccf79ca9cd5434a2c8aa1,0,Harrison Sheinblatt,2016-02-18 01:25:10-08:00,['f90c5a43c784010315e3d558b283bf9166f90f9b'],1,2,3,3089264,1,,,,2858
0424d5a238d40f4bfac7c2defb55b5a7a9161834,1,Harrison Sheinblatt,2016-02-18 01:25:10-08:00,['9aeb77023f8e9ca95bdccf79ca9cd5434a2c8aa1'],1,1,2,3089266,1,,,,2858
9076f56a88c454cde6f8df57a9cb058a83ccdd0a,1,Harrison Sheinblatt,2016-02-18 01:25:10-08:00,['0424d5a238d40f4bfac7c2defb55b5a7a9161834'],2,3,5,3089271,1,0,0,1,2858
91d411fa39cbc8bd19e98f4c634137e91d1da267,0,Harrison Sheinblatt,2016-02-18 01:25:10-08:00,['9076f56a88c454cde6f8df57a9cb058a83ccdd0a'],2,7,9,3089280,2,0.2,0.2,1,2858
f9232c98b0db35d70ecd4c8d147cbde7f3f1394c,1,Harrison Sheinblatt,2016-02-18 01:25:10-08:00,['91d411fa39cbc8bd19e98f4c634137e91d1da267'],6,15,21,3089301,2,0,0,1,2858
00256f7ab63b654061951cc4a6a3b6c6afa57908,1,David Alves,2016-02-18 11:21:47-08:00,['8e78f1ece94363c656a6a07c3c5a22231e6e2eab'],15,15,30,3089331,2,0,0,0,2858
0589b8648160dfd94a1f800526dbaf0a211a48f0,1,Internal Jenkins,2016-02-19 01:30:11+00:00,['f9232c98b0db35d70ecd4c8d147cbde7f3f1394c'],12,37,49,3089380,3,1,1,1,2858
cdb4f464aeb5c6b2121ed91646c500a98342f718,0,David Alves,2016-02-18 21:28:59-08:00,['8e78f1ece94363c656a6a07c3c5a22231e6e2eab'],15,15,30,3089410,2,0,0,0,2858
6b566a2d35c21984f84e4bb6d623fc00524ae088,0,Harrison Sheinblatt,2016-02-19 00:03:15-08:00,['0589b8648160dfd94a1f800526dbaf0a211a48f0'],1,58,59,3089469,6,0.611111111,0.611111111,0.611111111,2860
2baac229617cbf950c42a9c3ec56f6432e5d4435,0,Harrison Sheinblatt,2016-02-19 00:03:15-08:00,['6b566a2d35c21984f84e4bb6d623fc00524ae088'],17,15,32,3089501,5,0,0,0,2860
d4cf78e79adc82d658c2e42e9375bf0168541fe2,0,Harrison Sheinblatt,2016-02-19 00:03:20-08:00,['2baac229617cbf950c42a9c3ec56f6432e5d4435'],6,6,12,3089513,1,,,,2860
1b40a83903829bdc43121d1a2fc29f7d34764e28,1,Harrison Sheinblatt,2016-02-19 00:03:22-08:00,['d4cf78e79adc82d658c2e42e9375bf0168541fe2'],108,516,624,3090137,6,0.441509434,0.347169811,0.860377358,2860
a7d686135f4f4309c6c44c66ba1a682d69c29908,1,Harrison Sheinblatt,2016-02-19 00:03:22-08:00,['1b40a83903829bdc43121d1a2fc29f7d34764e28'],2,8,10,3090147,1,,,,2860
35721407f5687b5dde0c8fe46a457f5a330e51e0,1,Harrison Sheinblatt,2016-02-19 00:03:22-08:00,['a7d686135f4f4309c6c44c66ba1a682d69c29908'],74,99,173,3090320,2,0,0,0.833333333,2860
2334c7da6d5816130b4c2e77a72c99013951dfe0,1,Harrison Sheinblatt,2016-02-19 00:03:23-08:00,['35721407f5687b5dde0c8fe46a457f5a330e51e0'],51,134,185,3090505,6,0.923076923,0.307692308,0.076923077,2861
32a17973e4db6c555330bbe79f7064832e89cf43,1,Harrison Sheinblatt,2016-02-19 00:03:23-08:00,['2334c7da6d5816130b4c2e77a72c99013951dfe0'],2,2,4,3090509,1,,,,2861
36844e9a398f97a0cc1ff0c2eb719aac01e19bbd,0,Harrison Sheinblatt,2016-02-19 00:03:23-08:00,['32a17973e4db6c555330bbe79f7064832e89cf43'],2,25,27,3090536,3,0.461538462,0.461538462,0.461538462,2861
ecc57abc38500a3e83907c5d028544c971635db9,0,Harrison Sheinblatt,2016-02-19 00:03:23-08:00,['36844e9a398f97a0cc1ff0c2eb719aac01e19bbd'],6,25,31,3090567,2,0.352941176,0,0.352941176,2861
5a81d2db88c6028e937dafbf636eaf1d7a465d0c,1,Harrison Sheinblatt,2016-02-19 00:03:23-08:00,['ecc57abc38500a3e83907c5d028544c971635db9'],96,139,235,3090802,7,0.888888889,0.888888889,0.888888889,2861
524ac8858955c2bfc241b45959cafa1d956670be,0,Harrison Sheinblatt,2016-02-19 00:03:23-08:00,['5a81d2db88c6028e937dafbf636eaf1d7a465d0c'],13,12,25,3090827,2,1,1,1,2861
8135ef6eaa7304380be0122dbf2dd4af2195572e,1,Internal Jenkins,2016-02-19 14:08:58+00:00,['524ac8858955c2bfc241b45959cafa1d956670be'],10,66,76,3090903,6,0,0,1,2861
2cc586372c66d2837b0e4e5b5d788d4c0ce2a10a,1,Harrison Sheinblatt,2016-02-19 23:04:02-08:00,['8135ef6eaa7304380be0122dbf2dd4af2195572e'],60,160,220,3091123,14,0,0,0.818181818,2861
4ddba998b1518d19b996011d5a175911e6d4f9af,0,Harrison Sheinblatt,2016-02-19 23:04:03-08:00,['2cc586372c66d2837b0e4e5b5d788d4c0ce2a10a'],3,1,4,3091127,1,0,0,0,2861
f4ccb520c1aa07e152026530fa67d60a943152e2,0,Harrison Sheinblatt,2016-02-19 23:04:03-08:00,['4ddba998b1518d19b996011d5a175911e6d4f9af'],25,16,41,3091168,2,1,1,0,2861
c39fb34128289d0c69f56065bb34c9aa522a7625,1,Harrison Sheinblatt,2016-02-19 23:04:03-08:00,['f4ccb520c1aa07e152026530fa67d60a943152e2'],1,12,13,3091181,1,0,0,1,2861
5f9dc3eee77ed9c594da98207b60c32119256c71,1,Harrison Sheinblatt,2016-02-19 23:04:03-08:00,['c39fb34128289d0c69f56065bb34c9aa522a7625'],0,32,32,3091213,3,0.9375,0.9375,0.9375,2861
eee0db4a0b584340aed331bfcdd1e5942590806b,0,Harrison Sheinblatt,2016-02-19 23:04:03-08:00,['5f9dc3eee77ed9c594da98207b60c32119256c71'],16,75,91,3091304,8,0,1,1,2862
ef0dac661ce2f0a66f5bd0dbacb770b6ea442222,1,Harrison Sheinblatt,2016-02-19 23:04:03-08:00,['eee0db4a0b584340aed331bfcdd1e5942590806b'],296,1320,1616,3092920,36,0.2305026,0.514731369,0.86135182,2864
2de0f751560a86e37d94f21af29047b34d548013,0,Harrison Sheinblatt,2016-02-19 23:04:03-08:00,['ef0dac661ce2f0a66f5bd0dbacb770b6ea442222'],6,17,23,3092943,1,0.272727273,0.272727273,0.272727273,2864
6bde0a0c4b1920d5979f814c1cbd28cca5bc47e4,0,Harrison Sheinblatt,2016-02-19 23:04:03-08:00,['2de0f751560a86e37d94f21af29047b34d548013'],4,30,34,3092977,1,0.85,0.85,1,2864
af69097f19af27abe3b3f7c0edfbe02587b968fe,1,David Alves,2016-02-22 13:46:34-08:00,['00256f7ab63b654061951cc4a6a3b6c6afa57908'],49,78,127,3093104,4,0,0,0.125,2864
2591a6718a9be698b3d74524f3a1d5ce51d89bd0,1,David Alves,2016-02-22 13:49:10-08:00,['af69097f19af27abe3b3f7c0edfbe02587b968fe'],48,71,119,3093223,3,0,0,0.428571429,2864
f5552a189c70310a813f49a9088f385e0c58555c,0,David Alves,2016-02-22 16:57:04-08:00,['cdb4f464aeb5c6b2121ed91646c500a98342f718'],49,78,127,3093350,4,0,0,0.125,2864
25919c214c5e403c069c73d393e49ae39bc3149f,0,David Alves,2016-02-22 16:58:16-08:00,['f5552a189c70310a813f49a9088f385e0c58555c'],48,71,119,3093469,3,0,0,0.428571429,2864
8b32cbb9040a40d27e291a9896c83850243b04f0,1,Harrison Sheinblatt,2016-02-22 20:16:24-08:00,['6bde0a0c4b1920d5979f814c1cbd28cca5bc47e4'],17,440,457,3093926,6,0.4,1,1,2864
c6fd5a0fe42753ca8472fd3ce4adb3f24b629f60,1,Harrison Sheinblatt,2016-02-22 20:16:24-08:00,['8b32cbb9040a40d27e291a9896c83850243b04f0'],36,56,92,3094018,4,0,0,1,2864
a99e17457b77ab19b588a92785cadd2738f67873,1,Harrison Sheinblatt,2016-02-22 20:16:24-08:00,['c6fd5a0fe42753ca8472fd3ce4adb3f24b629f60'],3,6,9,3094027,1,,,,2864
94f46661750f6f371345b232ccf8871b3068b5dc,0,Harrison Sheinblatt,2016-02-22 20:16:24-08:00,['a99e17457b77ab19b588a92785cadd2738f67873'],23,3,26,3094053,3,1,0.7,0.4,2864
303ddf89f6aa03a0b4632886e04e85ca4a762f14,0,Harrison Sheinblatt,2016-02-22 20:16:24-08:00,['94f46661750f6f371345b232ccf8871b3068b5dc'],3,17,20,3094073,3,1,1,1,2864
e7e6fd5477ebb4edb4ff087c3d082aeb0ec158ef,1,Harrison Sheinblatt,2016-02-22 20:16:24-08:00,['303ddf89f6aa03a0b4632886e04e85ca4a762f14'],8,27,35,3094108,1,,,,2864
6411fc2618c4954de2146da20cbd98b5c51c7e01,1,Harrison Sheinblatt,2016-02-22 20:16:24-08:00,['e7e6fd5477ebb4edb4ff087c3d082aeb0ec158ef'],19,116,135,3094243,6,0.29787234,0.680851064,0.680851064,2865
f2324ad6194d58eaaab72cb2a32ab227b4c08c0f,1,Harrison Sheinblatt,2016-02-22 20:16:24-08:00,['6411fc2618c4954de2146da20cbd98b5c51c7e01'],14,74,88,3094331,7,0.25,1,1,2865
f55f0ddd571f581a171650ef8906760ce95ba618,1,Harrison Sheinblatt,2016-02-22 20:16:24-08:00,['f2324ad6194d58eaaab72cb2a32ab227b4c08c0f'],13,10,23,3094354,2,0,0,0,2865
29c3f138b71ca97bf1858f9b24ad90e7099a4e64,0,Harrison Sheinblatt,2016-02-22 20:16:24-08:00,['f55f0ddd571f581a171650ef8906760ce95ba618'],8,8,16,3094370,3,,,,2865
c8d926a90db9be0724c493cd1864c858083f9f98,0,Harrison Sheinblatt,2016-02-22 20:16:24-08:00,['29c3f138b71ca97bf1858f9b24ad90e7099a4e64'],2,4,6,3094376,2,0,1,0,2865
c2912c6db9ec1b7aa5c0aee618764b93ea5b40ee,1,Harrison Sheinblatt,2016-02-24 13:31:00-08:00,['c8d926a90db9be0724c493cd1864c858083f9f98'],36,42,78,3094454,10,1,0,0,2865
56f49d4a8ef9e20f253b7843ff364b74084af255,0,Harrison Sheinblatt,2016-02-24 13:31:00-08:00,['c2912c6db9ec1b7aa5c0aee618764b93ea5b40ee'],1,10,11,3094465,1,,0,,2865
97af107729a33205bb12ce7aaed1e68cff3c889f,1,Harrison Sheinblatt,2016-02-24 13:31:00-08:00,['56f49d4a8ef9e20f253b7843ff364b74084af255'],58,154,212,3094677,9,0.797101449,0.086956522,0.797101449,2865
5a9f5124e2a6cdfd0a09ee6ed212e6358778e563,0,Harrison Sheinblatt,2016-02-24 13:31:00-08:00,['97af107729a33205bb12ce7aaed1e68cff3c889f'],2,2,4,3094681,1,,,,2865
120a9c10bdba0df85767c98957cee1f10580ff8e,1,Harrison Sheinblatt,2016-02-24 13:31:00-08:00,['5a9f5124e2a6cdfd0a09ee6ed212e6358778e563'],19,5,24,3094705,2,0,0,0,2865
85983c64f151e9e3f29c4fbb11d11bee693004f4,0,Harrison Sheinblatt,2016-02-24 13:31:00-08:00,['120a9c10bdba0df85767c98957cee1f10580ff8e'],1,14,15,3094720,2,0.583333333,0.583333333,1,2865
c7eb486257f12db7e7359961193b4f0a3829bb78,1,Harrison Sheinblatt,2016-02-24 13:31:00-08:00,['85983c64f151e9e3f29c4fbb11d11bee693004f4'],1,1,2,3094722,1,,,,2865
e7ae4e4a92a410f4173d5f60e14e3e82ba9bf59a,0,Harrison Sheinblatt,2016-02-24 13:31:00-08:00,['c7eb486257f12db7e7359961193b4f0a3829bb78'],1,1,2,3094724,1,,,,2865
2e8fa93eb1c80babdff90eff11a9a33c40c4767c,1,Harrison Sheinblatt,2016-02-24 13:31:00-08:00,['e7ae4e4a92a410f4173d5f60e14e3e82ba9bf59a'],13,5,18,3094742,1,1,0,0,2865
52362d4079efff58f77d57d216d1ddad478dbccc,0,Harrison Sheinblatt,2016-02-24 13:31:00-08:00,['2e8fa93eb1c80babdff90eff11a9a33c40c4767c'],199,216,415,3095157,3,1,1,1,2866
2c8f41b7d476d9e870cdd75ca100745382a11ad2,1,Harrison Sheinblatt,2016-02-24 13:31:00-08:00,['52362d4079efff58f77d57d216d1ddad478dbccc'],15,33,48,3095205,3,0,0,0,2866
249f6ac2ca60912c5dcb95f2c854be116a7975cb,1,Harrison Sheinblatt,2016-02-24 13:31:00-08:00,['2c8f41b7d476d9e870cdd75ca100745382a11ad2'],12,12,24,3095229,5,0,0,0,2866
7f4db1e09133376b81a3afa66d85aa64a0736736,0,Harrison Sheinblatt,2016-02-24 13:31:00-08:00,['249f6ac2ca60912c5dcb95f2c854be116a7975cb'],2,4,6,3095235,1,,,,2866
b777903fff077e153d50a78704d7faf3d7d6678a,0,Harrison Sheinblatt,2016-02-24 13:31:00-08:00,['7f4db1e09133376b81a3afa66d85aa64a0736736'],3,10,13,3095248,2,0,1,1,2866
6b9ed4e95f9276f8d573c35389c09438802c49cd,1,Harrison Sheinblatt,2016-02-24 19:54:40-08:00,['b777903fff077e153d50a78704d7faf3d7d6678a'],7,13,20,3095268,1,0,0,1,2866
3cf72ee0792d2e85b2ce3f23f8b329d1a8f06d97,0,Harrison Sheinblatt,2016-02-24 19:54:40-08:00,['6b9ed4e95f9276f8d573c35389c09438802c49cd'],1,5,6,3095274,1,0,1,1,2866
d3b92b0d9f6d545c0a619f28c29f454ee5790655,1,Harrison Sheinblatt,2016-02-24 19:54:40-08:00,['3cf72ee0792d2e85b2ce3f23f8b329d1a8f06d97'],44,91,135,3095409,9,0.048780488,0.048780488,0.048780488,2866
197eb4347759433c47aade5d7380738696e5955e,1,Harrison Sheinblatt,2016-02-24 19:54:40-08:00,['d3b92b0d9f6d545c0a619f28c29f454ee5790655'],1,40,41,3095450,2,0,0,1,2866
e8fe2202e6c5971a7dbd4513653d86b21375cb35,0,David Alves,2016-02-25 15:39:04-08:00,['2591a6718a9be698b3d74524f3a1d5ce51d89bd0'],793,36592,37385,3132835,146,0.635370534,0.743135518,0.613817538,2983
309040088fb7bb66deb8e7563bca850811a3f312,1,Harrison Sheinblatt,2016-02-26 15:37:24-08:00,['197eb4347759433c47aade5d7380738696e5955e'],6,56,62,3132897,3,0.857142857,0.857142857,0.714285714,2983
d5ecaeca738c68c3b99b1469a56fcf321a100c32,1,Harrison Sheinblatt,2016-02-26 15:37:24-08:00,['309040088fb7bb66deb8e7563bca850811a3f312'],85,75,160,3133057,2,1,1,1,2983
5c0e1fa1e83190ea44d5a2a5cc028ccd8b7d78e0,0,Harrison Sheinblatt,2016-02-26 15:37:24-08:00,['d5ecaeca738c68c3b99b1469a56fcf321a100c32'],8,24,32,3133089,2,,,,2983
ee55bd8e17e1f06e1f0e2d1155d93fda050a7412,1,Harrison Sheinblatt,2016-02-26 15:37:24-08:00,['5c0e1fa1e83190ea44d5a2a5cc028ccd8b7d78e0'],93,193,286,3133375,3,0.016393443,0,0.016393443,2983
5d45fb18ec7f226478baa60011ff4a2ff4096e11,0,Harrison Sheinblatt,2016-02-26 15:37:24-08:00,['ee55bd8e17e1f06e1f0e2d1155d93fda050a7412'],31,37,68,3133443,2,1,0,0,2983
2c37d99fedfb18d07e6f7340846d351f5eccfc50,0,Harrison Sheinblatt,2016-02-26 15:37:24-08:00,['5d45fb18ec7f226478baa60011ff4a2ff4096e11'],2,20,22,3133465,2,0,0,1,2983
3f70ac65b0ad94e2837c0153d090f22a4e5e03bb,0,Harrison Sheinblatt,2016-02-26 15:37:24-08:00,['2c37d99fedfb18d07e6f7340846d351f5eccfc50'],0,1,1,3133466,1,1,1,1,2983
393c65de6dacd2ced4e6ddcf9f31bae7366ca96a,0,Harrison Sheinblatt,2016-02-26 15:37:24-08:00,['3f70ac65b0ad94e2837c0153d090f22a4e5e03bb'],0,2,2,3133468,1,,,,2983
5050b8c3bb4ee23e7191cd910a626c73a300100c,1,Harrison Sheinblatt,2016-02-26 15:37:24-08:00,['393c65de6dacd2ced4e6ddcf9f31bae7366ca96a'],7,32,39,3133507,8,0.736842105,1,1,2983
c9b33ddf635bdbbdbf6ab27e32d6ef9c6460b297,1,Harrison Sheinblatt,2016-02-28 21:31:37-08:00,['5050b8c3bb4ee23e7191cd910a626c73a300100c'],187,529,716,3134223,18,0.572916667,0.760416667,0,2988
70096c588b054f96fc88ab7585a11029d8126dea,0,Harrison Sheinblatt,2016-02-28 21:31:37-08:00,['c9b33ddf635bdbbdbf6ab27e32d6ef9c6460b297'],2,2,4,3134227,1,,,,2988
003425d95b80d127bf75ea13ad31e1f091b59083,0,Harrison Sheinblatt,2016-02-29 22:22:41-08:00,['70096c588b054f96fc88ab7585a11029d8126dea'],12,78,90,3134317,2,0.357142857,1,1,2988
a303f25256c8de4630e6bd1da73ae97e76d86973,1,Harrison Sheinblatt,2016-02-29 22:22:41-08:00,['003425d95b80d127bf75ea13ad31e1f091b59083'],10,152,162,3134479,3,0.5,0.375,1,2988
d998ca9d48f14f13d6ea466e624d2eea13dffe70,1,Harrison Sheinblatt,2016-03-01 22:15:40-08:00,['a303f25256c8de4630e6bd1da73ae97e76d86973'],32,40,72,3134551,4,1,1,1,2988
0a6954de74eec4cca77d1172cff7f206fbfb2c7e,1,Harrison Sheinblatt,2016-03-01 22:15:40-08:00,['d998ca9d48f14f13d6ea466e624d2eea13dffe70'],18,15,33,3134584,3,0,0,0.4,2988
9a2ac6cd7fcf9bef3f6452cb21bcdc7951c14f8e,1,Harrison Sheinblatt,2016-03-01 22:15:40-08:00,['0a6954de74eec4cca77d1172cff7f206fbfb2c7e'],46,66,112,3134696,4,0,0.666666667,0,2988
c1e950b5413676c6fdf6c7de010bb9e2ca0c799d,0,Harrison Sheinblatt,2016-03-01 22:15:40-08:00,['9a2ac6cd7fcf9bef3f6452cb21bcdc7951c14f8e'],7,10,17,3134713,1,0,0,0,2988
e90635c3651deda1967b6e5209a54a7369419504,1,Harrison Sheinblatt,2016-03-01 22:15:40-08:00,['c1e950b5413676c6fdf6c7de010bb9e2ca0c799d'],38,105,143,3134856,10,0.5,0.461538462,0.576923077,2988
739ed87376949a01246527f75a70d52970540a3a,0,Harrison Sheinblatt,2016-03-01 22:15:40-08:00,['e90635c3651deda1967b6e5209a54a7369419504'],0,4,4,3134860,1,,,,2988
bcb3fba8d2695f7777af6273ba9c27a28daa148e,1,Harrison Sheinblatt,2016-03-01 22:15:40-08:00,['739ed87376949a01246527f75a70d52970540a3a'],0,3,3,3134863,1,,,,2988
1c13c6c5972fd3ae93f26dfb5a50851eecb3a978,0,Harrison Sheinblatt,2016-03-01 22:15:41-08:00,['bcb3fba8d2695f7777af6273ba9c27a28daa148e'],4,32,36,3134899,3,0.2,0.4,0.6,2988
82c444bde3e5defc85cc974c3e0257940482f45c,0,Harrison Sheinblatt,2016-03-02 09:53:58-08:00,['1c13c6c5972fd3ae93f26dfb5a50851eecb3a978'],6,6,12,3134911,1,,,,2988
c98c4f331200612c293d417dca7558e985305eb8,0,Juan Yu,2016-03-02 19:22:53+00:00,['82c444bde3e5defc85cc974c3e0257940482f45c'],1,1,2,3134913,1,,,,2988
6cdcdb12ff74d38ab83f3257b8646ec516fbf014,1,Harrison Sheinblatt,2016-03-02 23:23:04-08:00,['c98c4f331200612c293d417dca7558e985305eb8'],0,68,68,3134981,4,0,1,1,2990
54a46e94591cdbd76fb5bf88bf63ecda3aab8f34,1,Harrison Sheinblatt,2016-03-02 23:23:05-08:00,['6cdcdb12ff74d38ab83f3257b8646ec516fbf014'],88,197,285,3135266,6,1,0,1,2990
6fcb7f15ef7dba3badc7c7a29da1da837bacd71f,1,Harrison Sheinblatt,2016-03-03 18:34:52-08:00,['54a46e94591cdbd76fb5bf88bf63ecda3aab8f34'],2,2,4,3135270,1,,,,2990
744f83a453f698341fd6ffce51c9b50c947a66c5,1,Harrison Sheinblatt,2016-03-03 18:34:54-08:00,['6fcb7f15ef7dba3badc7c7a29da1da837bacd71f'],7,11,18,3135288,1,1,1,1,2990
bf1194a33de47ca2030a8cdc2815489998388735,1,Harrison Sheinblatt,2016-03-03 18:34:55-08:00,['744f83a453f698341fd6ffce51c9b50c947a66c5'],7,16,23,3135311,3,0,1,1,2990
293192ff05b61a05341fcd10fc0e12900171e4ed,0,Internal Jenkins,2016-03-04 04:13:36+00:00,['bf1194a33de47ca2030a8cdc2815489998388735'],3,1,4,3135315,1,1,0,0,2990
4a25f87d5cb9460fbc7d38ac3503086a747a3e2a,0,Internal Jenkins,2016-03-04 04:35:54+00:00,['293192ff05b61a05341fcd10fc0e12900171e4ed'],59,23,82,3135397,2,,,,2990
368d7be7e6ffefd7bdcc7fa2cf91bc986833712f,0,Internal Jenkins,2016-03-04 07:59:09+00:00,['4a25f87d5cb9460fbc7d38ac3503086a747a3e2a'],2,1,3,3135400,1,0,0,0,2990
d0478519ffba583eb509c8ccbf3502828ff6c24f,1,Internal Jenkins,2016-03-04 12:38:38+00:00,['368d7be7e6ffefd7bdcc7fa2cf91bc986833712f'],1,1,2,3135402,1,,,,2990
cdbb6f80eebb7409e199c3e50f59de9afc00721b,1,Internal Jenkins,2016-03-05 05:33:32+00:00,['d0478519ffba583eb509c8ccbf3502828ff6c24f'],109,458,567,3135969,3,0.184549356,0.433476395,0.188841202,2990
bca5634ca8b7ca3c168c351500fc8d877cad52e2,1,Internal Jenkins,2016-03-05 22:19:56+00:00,['cdbb6f80eebb7409e199c3e50f59de9afc00721b'],149,127,276,3136245,3,,,,2990
b22c604b2b2b5609d61d2db53830be11bd586f48,0,Harrison Sheinblatt,2016-03-06 15:23:36-08:00,['bca5634ca8b7ca3c168c351500fc8d877cad52e2'],7,7,14,3136259,2,,,,2990
662dceec26e439a0dd5e2f14694cbaea6c2ac6f8,0,Harrison Sheinblatt,2016-03-06 15:23:37-08:00,['b22c604b2b2b5609d61d2db53830be11bd586f48'],2,4,6,3136265,2,0,0,0,2990
4ed905583f068ed0210c4ea87a2d005b05dd3f41,0,Harrison Sheinblatt,2016-03-06 15:23:38-08:00,['662dceec26e439a0dd5e2f14694cbaea6c2ac6f8'],2,2,4,3136269,2,,,,2990
049ede9f623434914da62e74f728c153cb4c662f,1,Harrison Sheinblatt,2016-03-06 15:23:39-08:00,['4ed905583f068ed0210c4ea87a2d005b05dd3f41'],38,114,152,3136421,6,0,0.071428571,1,2990
cf6d470ed33265123e5c6b737f9a8d580e266cfd,1,Harrison Sheinblatt,2016-03-06 15:23:40-08:00,['049ede9f623434914da62e74f728c153cb4c662f'],7,9,16,3136437,3,1,1,0,2990
928e7a48273688d04d2004b8414ff9c24a0c8db2,0,Internal Jenkins,2016-03-07 10:42:35+00:00,['cf6d470ed33265123e5c6b737f9a8d580e266cfd'],14,18,32,3136469,5,,,,2990
7257a89f151ce0cc1d9a938f4d195381306228be,0,Internal Jenkins,2016-03-08 00:21:33+00:00,['928e7a48273688d04d2004b8414ff9c24a0c8db2'],2,4,6,3136475,1,,,,2990
3cf22ec16ddce9dd141a159d761f7e39a2337dab,1,Internal Jenkins,2016-03-08 01:14:09+00:00,['7257a89f151ce0cc1d9a938f4d195381306228be'],220,211,431,3136906,13,1,1,0,2990
1c98ec7f816bfe97a4c0b4ed615f284cdd7aa5cc,0,Internal Jenkins,2016-03-08 03:12:51+00:00,['3cf22ec16ddce9dd141a159d761f7e39a2337dab'],0,17,17,3136923,4,0.571428571,1,1,2990
723509a57173634d25f1c985ff4cfea5daac8bfe,0,Internal Jenkins,2016-03-09 00:16:31+00:00,['1c98ec7f816bfe97a4c0b4ed615f284cdd7aa5cc'],5,21,26,3136949,1,0,0,1,2990
f2ad40bd057127144a1b7ca61dcff338ca56d504,0,Internal Jenkins,2016-03-09 00:52:21+00:00,['723509a57173634d25f1c985ff4cfea5daac8bfe'],40,58,98,3137047,8,,,,2990
01ff103efb2f1ccc4ab34cf6c2bb254b614695f0,0,Casey Ching,2016-03-09 03:36:52+00:00,['f2ad40bd057127144a1b7ca61dcff338ca56d504'],0,3,3,3137050,1,0.5,0.5,0.5,2990
ea1b15df3322645dad2210bb74f22ed0af956f4d,1,Internal Jenkins,2016-03-09 10:28:48+00:00,['01ff103efb2f1ccc4ab34cf6c2bb254b614695f0'],2,9,11,3137061,1,0,1,1,2990
923d591ab6e1caa31dc5742f0a986bb545680798,1,Internal Jenkins,2016-03-10 19:25:36+00:00,['ea1b15df3322645dad2210bb74f22ed0af956f4d'],284,5146,5430,3142491,21,0.384164223,0.501466276,0.929618768,2998
583d31a9060df604428f1f4ded48c0cd802802fa,0,Casey Ching,2016-03-10 21:48:46+00:00,['923d591ab6e1caa31dc5742f0a986bb545680798'],1,4,5,3142496,1,,,,2998
31ccd85605d0c92691266de1c2b433c35cd1f3e4,0,Casey Ching,2016-03-10 21:49:53+00:00,['583d31a9060df604428f1f4ded48c0cd802802fa'],14,40,54,3142550,2,0,0.52,0.8,2998
85e6bcf5aaf8d901041b4b4e8a08cd593fb057df,0,Casey Ching,2016-03-10 21:50:49+00:00,['31ccd85605d0c92691266de1c2b433c35cd1f3e4'],16,55,71,3142621,1,0.035714286,0.035714286,0.928571429,2998
a7c3f301bb1da14d6bb35d37aab47450c67cca0c,0,Internal Jenkins,2016-03-10 22:50:14+00:00,['85e6bcf5aaf8d901041b4b4e8a08cd593fb057df'],43,3,46,3142667,3,0.25,1,0.15625,2998
13007f9634c240c4570b9ddb0f0bb78d2ee1f588,1,Internal Jenkins,2016-03-10 23:16:29+00:00,['a7c3f301bb1da14d6bb35d37aab47450c67cca0c'],36,162,198,3142865,6,0.12195122,1,0.987804878,2998
4c2d04dc8fd384feb7e7b192c6624a01c5fb9172,0,Internal Jenkins,2016-03-11 02:13:58+00:00,['13007f9634c240c4570b9ddb0f0bb78d2ee1f588'],1,2,3,3142868,2,,,,2998
82222abaf556c7675b649bbe463e862b5f75a25e,1,David Alves,2016-03-11 11:37:58-08:00,"['197eb4347759433c47aade5d7380738696e5955e', 'e8fe2202e6c5971a7dbd4513653d86b21375cb35']",314,8875,9189,3152057,121,,,,2998
804cfbdd64cd3af740b839ccf5192555844eb656,1,David Alves,2016-03-11 11:38:05-08:00,['82222abaf556c7675b649bbe463e862b5f75a25e'],104,347,451,3152508,39,0.45,0.933333333,0.65,3003
e7074537c60505dea1593fc20ffbfabdf1d25296,0,Todd Lipcon,2016-03-11 14:29:07-08:00,"['804cfbdd64cd3af740b839ccf5192555844eb656', '25919c214c5e403c069c73d393e49ae39bc3149f']",0,0,0,3152508,0,,,,3003
9ed3b685a109559fad8dd94f6c03af93e164305a,1,Internal Jenkins,2016-03-12 02:05:45+00:00,['4c2d04dc8fd384feb7e7b192c6624a01c5fb9172'],195,332,527,3153035,23,0,0.295652174,0.582608696,3003
5197e9fcc8e7856d5fd545c24e1bba9c2509e3de,1,Internal Jenkins,2016-03-12 02:50:12+00:00,['9ed3b685a109559fad8dd94f6c03af93e164305a'],19,26,45,3153080,6,0,0,0,3003
7dfbfd15813a00fb4a8f5d0273f86d2d31e8f28d,1,Internal Jenkins,2016-03-12 04:17:11+00:00,['5197e9fcc8e7856d5fd545c24e1bba9c2509e3de'],47,24,71,3153151,5,0,1,0,3003
7381304a230125838e2de30b4c69a22b57165601,1,David Alves,2016-03-13 19:28:43-07:00,"['7dfbfd15813a00fb4a8f5d0273f86d2d31e8f28d', 'e7074537c60505dea1593fc20ffbfabdf1d25296']",330,9177,9507,3162658,129,,,,3003
71785bdf6a7ac5e688277f31b85c22a0ba6b9dec,0,Casey Ching,2016-03-15 07:17:20+00:00,['7381304a230125838e2de30b4c69a22b57165601'],2,9,11,3162669,3,1,1,1,3003
6a9d462e5e26806771fd701c49a9e55a81300dee,0,Dan Hecht,2016-03-15 07:31:06+00:00,['71785bdf6a7ac5e688277f31b85c22a0ba6b9dec'],1,1,2,3162671,1,,,,3003
f5b7842414c334ff0803b3d8ab44c6002270383b,1,Internal Jenkins,2016-03-15 09:21:22+00:00,['6a9d462e5e26806771fd701c49a9e55a81300dee'],105,286,391,3163062,7,0.125,1,1,3003
ce76f9adf4515ba65d48f7ea1452bba65ec03726,0,Internal Jenkins,2016-03-15 11:04:08+00:00,['f5b7842414c334ff0803b3d8ab44c6002270383b'],5,5,10,3163072,2,,,,3003
978d83775872cacd7338079123ca23ce03540f06,1,Internal Jenkins,2016-03-15 12:10:33+00:00,['ce76f9adf4515ba65d48f7ea1452bba65ec03726'],0,54,54,3163126,4,0.052631579,0.052631579,1,3003
0d0f5a2fa642aee844ad041cc62199d5838d5f76,0,Internal Jenkins,2016-03-15 20:35:13+00:00,['978d83775872cacd7338079123ca23ce03540f06'],6,14,20,3163146,3,,0,1,3003
5010810b9cdbd4bb46e6c17b6a308949a5ba1252,1,Internal Jenkins,2016-03-16 00:10:24+00:00,['0d0f5a2fa642aee844ad041cc62199d5838d5f76'],4,6,10,3163156,2,0,0,0,3003
432a76e4dd44641c65059b3ac0b0eceb594d9ba1,1,Internal Jenkins,2016-03-16 00:15:34+00:00,['5010810b9cdbd4bb46e6c17b6a308949a5ba1252'],3,8,11,3163167,2,,,,3003
8d98eadc1c483aa6cc30f9d120fa18fcfad8dcaf,1,Internal Jenkins,2016-03-16 04:24:27+00:00,['432a76e4dd44641c65059b3ac0b0eceb594d9ba1'],1363,1636,2999,3166166,71,0.838709677,0.967741935,0.774193548,3006
26be352d4c8e49889c6c6d236e3f0a69775096e0,0,Internal Jenkins,2016-03-16 05:37:13+00:00,['8d98eadc1c483aa6cc30f9d120fa18fcfad8dcaf'],18,17,35,3166201,11,,,,3006
e85261ea77ff4227ab5474d077bd4c31b22e0bf8,1,Bharath Vissapragada,2016-03-16 09:27:50+00:00,['26be352d4c8e49889c6c6d236e3f0a69775096e0'],3,37,40,3166241,1,0.866666667,0.866666667,0.866666667,3006
58219eac2c1566f7c7d4f6a7cfa081f562de6c94,1,Internal Jenkins,2016-03-16 18:29:57+00:00,['e85261ea77ff4227ab5474d077bd4c31b22e0bf8'],213,370,583,3166824,4,0.441176471,1,1,3008
4e7732bb0dc88a43bdf72d19f852c9cefe91cebe,1,Dan Hecht,2016-03-16 22:38:27+00:00,['58219eac2c1566f7c7d4f6a7cfa081f562de6c94'],17,18,35,3166859,11,,,,3008
a78f3a8ca58b9faed7b6dcfb1e17e1a97c4760c2,1,Internal Jenkins,2016-03-17 05:58:39+00:00,['4e7732bb0dc88a43bdf72d19f852c9cefe91cebe'],7,143,150,3167009,8,0.029850746,0.552238806,0.925373134,3009
cc9a279c6740338c3297962b2533f278e43144cd,1,Internal Jenkins,2016-03-18 06:26:17+00:00,['a78f3a8ca58b9faed7b6dcfb1e17e1a97c4760c2'],259,324,583,3167592,14,0,0,0,3009
8710bf1abfa2d2aa1468ed485a8da0f45cfd9cec,1,Thomas Tauber-Marshall,2016-03-18 17:28:31+00:00,['cc9a279c6740338c3297962b2533f278e43144cd'],41,187,228,3167820,8,0.375,0.96875,0.984375,3010
ce11d88c33f2f1c97a8ba51f79f4df091aa6344f,0,Internal Jenkins,2016-03-18 21:58:25+00:00,['8710bf1abfa2d2aa1468ed485a8da0f45cfd9cec'],1,7,8,3167828,1,,,,3010
62dbdb06d03e5b7a208cb9a53863febf778386d3,0,Internal Jenkins,2016-03-18 23:08:09+00:00,['ce11d88c33f2f1c97a8ba51f79f4df091aa6344f'],18,17,35,3167863,11,,,,3010
445c88339f5d2ab59b733f76b0a8f5e96db1955c,1,Thomas Tauber-Marshall,2016-03-19 00:03:03+00:00,['62dbdb06d03e5b7a208cb9a53863febf778386d3'],11,60,71,3167934,4,0.388888889,0,0.888888889,3010
45e1609f49a06382e06d7cd29ea19f273be9df0c,0,Internal Jenkins,2016-03-21 23:46:25+00:00,['445c88339f5d2ab59b733f76b0a8f5e96db1955c'],1,2,3,3167937,1,,,,3010
8977af47a939226196adb8831d5ae8c00fc5259d,0,Internal Jenkins,2016-03-22 04:40:04+00:00,['45e1609f49a06382e06d7cd29ea19f273be9df0c'],1,1,2,3167939,1,,,,3010
e99961771956a7f9228494934b03a82a655452ec,0,Skye Wanderman-Milne,2016-03-22 06:43:51+00:00,['8977af47a939226196adb8831d5ae8c00fc5259d'],11,7,18,3167957,1,1,0,0,3010
152c586f398269856169c271c771484793fdfee9,1,Internal Jenkins,2016-03-22 20:43:38+00:00,['e99961771956a7f9228494934b03a82a655452ec'],402,471,873,3168830,34,0.166666667,1,0,3010
981b441e5b1815eae61a88d5e2bb88e92d87e885,0,Internal Jenkins,2016-03-22 21:16:04+00:00,['152c586f398269856169c271c771484793fdfee9'],1,1,2,3168832,1,,,,3010
41b26f6a11be4365d8e908445af90695592aea1c,0,Internal Jenkins,2016-03-22 21:35:17+00:00,['981b441e5b1815eae61a88d5e2bb88e92d87e885'],2,4,6,3168838,1,0,0,1,3010
b3937295fb6288aef3733d9bc4f8a68b389940c5,1,Internal Jenkins,2016-03-23 04:07:14+00:00,['41b26f6a11be4365d8e908445af90695592aea1c'],3,637,640,3169478,5,1,1,1,3014
a75d7dd282bd6bdd3b0b82d389403a80c6732feb,1,Internal Jenkins,2016-03-23 05:14:29+00:00,['b3937295fb6288aef3733d9bc4f8a68b389940c5'],2,2,4,3169482,1,,,,3014
c0397911b5aec4733b284c9c76fc554db64ffbef,0,Internal Jenkins,2016-03-23 22:25:13+00:00,['a75d7dd282bd6bdd3b0b82d389403a80c6732feb'],1,3,4,3169486,1,,,,3014
10e7de7969f96fe3edb00fcab3f7a8c432bd20a0,1,Internal Jenkins,2016-03-23 22:29:18+00:00,['c0397911b5aec4733b284c9c76fc554db64ffbef'],53,64,117,3169603,20,,,,3014
077d0fab112ec16d416571898adc1c3b12165944,1,Internal Jenkins,2016-03-24 04:54:07+00:00,['10e7de7969f96fe3edb00fcab3f7a8c432bd20a0'],4,10,14,3169617,2,1,1,1,3014
c06912ebb6e9f6e06fdb7b6f37b66f693a38c927,1,Internal Jenkins,2016-03-24 07:59:53+00:00,['077d0fab112ec16d416571898adc1c3b12165944'],29,29,58,3169675,2,,,,3014
0d1eab7a9ebc7e4653f9043ef90672c6f3088c3b,1,Henry Robinson,2016-03-24 23:17:50+00:00,['c06912ebb6e9f6e06fdb7b6f37b66f693a38c927'],246,226,472,3170147,22,1,1,1,3014
76b674850fa1db36ab6e6acda6d3f958661eefbc,1,Internal Jenkins,2016-03-25 13:10:15+00:00,['0d1eab7a9ebc7e4653f9043ef90672c6f3088c3b'],18,164,182,3170329,8,0.529411765,0,0,3016
35dfbafab6f83d7197248a9264fdcac805bdbc30,0,Casey Ching,2016-03-25 23:05:52+00:00,['76b674850fa1db36ab6e6acda6d3f958661eefbc'],1,3,4,3170333,1,,,,3016
7e76e92bef668b3ad95ef66b5d74a02662e2d1ce,1,Internal Jenkins,2016-03-28 19:23:22+00:00,['35dfbafab6f83d7197248a9264fdcac805bdbc30'],60,106,166,3170499,25,0,0,0,3017
5e51f1cd0366bfd590ade2a9c54f0bab942c79ac,0,Internal Jenkins,2016-03-28 20:19:41+00:00,['7e76e92bef668b3ad95ef66b5d74a02662e2d1ce'],37,0,37,3170536,2,0.380952381,0.380952381,0,3017
b2ccb17c21b32856f8f23de1e0df1c5c800c9e0b,0,Internal Jenkins,2016-03-28 20:22:18+00:00,['5e51f1cd0366bfd590ade2a9c54f0bab942c79ac'],1,1,2,3170538,1,,,,3017
2b47c5a3bf454aca199cf0a9b2397b540b6cdf0d,1,Internal Jenkins,2016-03-29 02:04:02+00:00,['b2ccb17c21b32856f8f23de1e0df1c5c800c9e0b'],18,66,84,3170622,4,0,0.181818182,1,3017
39a28185e813e05a2b8a8afd8215754adb6ab327,1,Internal Jenkins,2016-03-29 23:57:54+00:00,['2b47c5a3bf454aca199cf0a9b2397b540b6cdf0d'],191,187,378,3171000,24,1,0.75,1,3018
49a73cd598890ca9642feea07f81217e67753233,1,Internal Jenkins,2016-03-30 00:03:45+00:00,['39a28185e813e05a2b8a8afd8215754adb6ab327'],4,4,8,3171008,1,,,,3018
943b7cc7a7a5090be139f08fa4712c596870e270,0,Internal Jenkins,2016-03-30 03:58:33+00:00,['49a73cd598890ca9642feea07f81217e67753233'],0,6,6,3171014,1,0,0,1,3018
b74e57a31201c6ba3f2b1f62a8c16cdb3c1c9279,0,Internal Jenkins,2016-03-30 04:50:15+00:00,['943b7cc7a7a5090be139f08fa4712c596870e270'],31,38,69,3171083,1,0,1,0,3018
2d0b944500f6a44fcf95ea5b519393bec0dc749c,0,Internal Jenkins,2016-03-30 06:18:23+00:00,['b74e57a31201c6ba3f2b1f62a8c16cdb3c1c9279'],19,4,23,3171106,2,,,,3018
97b523389e7604183c23574842bd6c35385aa7f5,1,Internal Jenkins,2016-03-30 09:25:33+00:00,['2d0b944500f6a44fcf95ea5b519393bec0dc749c'],5,25,30,3171136,2,1,1,1,3018
ce9284454b6c3ff382ca5f509f75697a528b14a4,1,Tim Armstrong,2016-03-30 15:42:42+00:00,['97b523389e7604183c23574842bd6c35385aa7f5'],3,13,16,3171152,1,0.25,0.25,0.75,3018
51eef3a3ad09f97a4c319e635dfa068f39d2e92a,0,Internal Jenkins,2016-03-31 03:18:44+00:00,['ce9284454b6c3ff382ca5f509f75697a528b14a4'],0,4,4,3171156,1,0,1,1,3018
2809746b2c2f8621b6ed9c75410f41dd8253e255,1,Internal Jenkins,2016-03-31 11:30:44+00:00,['51eef3a3ad09f97a4c319e635dfa068f39d2e92a'],0,7,7,3171163,1,,,,3018
5cd7ada727d04fe56d62ced2e8bfa56f4448ea57,1,Internal Jenkins,2016-03-31 12:06:57+00:00,['2809746b2c2f8621b6ed9c75410f41dd8253e255'],22,43,65,3171228,3,0.4,0.4,0.8,3018
3d5a21c04737d318501f3fe4c80ff7f4e272631a,1,Internal Jenkins,2016-03-31 12:30:19+00:00,['5cd7ada727d04fe56d62ced2e8bfa56f4448ea57'],1,2,3,3171231,1,1,1,1,3018
40117bf7258f00d156b5a458c6949041aa076118,0,Internal Jenkins,2016-03-31 22:01:01+00:00,['3d5a21c04737d318501f3fe4c80ff7f4e272631a'],9,14,23,3171254,2,,,,3018
52841302de23e5cb08e6eba1aa95175d45fe72c2,0,Internal Jenkins,2016-04-01 01:26:44+00:00,['40117bf7258f00d156b5a458c6949041aa076118'],123,0,123,3171377,2,,,,3018
2cbd327d4127fa895e312cf68f77427a401abed3,0,Internal Jenkins,2016-04-01 05:06:38+00:00,['52841302de23e5cb08e6eba1aa95175d45fe72c2'],1,58,59,3171436,4,,,,3018
3f2840f52869aacaefe840efbbeb9130fb083541,0,Internal Jenkins,2016-04-01 12:26:02+00:00,['2cbd327d4127fa895e312cf68f77427a401abed3'],1,1,2,3171438,1,,,,3018
9b51b2b6e64b29d8af5147945e4b0d2679611350,1,Internal Jenkins,2016-04-02 04:04:25+00:00,['3f2840f52869aacaefe840efbbeb9130fb083541'],18,395,413,3171851,15,0,0,0.118421053,3023
449901fac68beff8d41dc185550d634c0cf4fdb5,0,Henry Robinson,2016-04-05 17:37:32+00:00,['9b51b2b6e64b29d8af5147945e4b0d2679611350'],0,3,3,3171854,1,,,,3023
5703f4e0c6916fbd474f72e4a0ecb011fc5e0927,0,Internal Jenkins,2016-04-05 22:25:05+00:00,['449901fac68beff8d41dc185550d634c0cf4fdb5'],1,1,2,3171856,1,,,,3023
7dd4998b4fc142425080fa1cce07dcf36df24c1d,0,Henry Robinson,2016-04-05 22:26:16+00:00,['5703f4e0c6916fbd474f72e4a0ecb011fc5e0927'],1,3,4,3171860,1,0,0,0,3023
4208fdacc1db755562cb952d82f197f3bed740db,0,Tim Armstrong,2016-04-12 14:02:35-07:00,['7dd4998b4fc142425080fa1cce07dcf36df24c1d'],0,1,1,3171861,1,,,,3023
0c4dc965a4f2d90dcbcd504400fe3a592fd16384,0,Tim Armstrong,2016-04-12 14:02:35-07:00,['4208fdacc1db755562cb952d82f197f3bed740db'],3,1,4,3171865,1,,,,3023
7050294215cdd81963aa815f69a573421a05ab3e,1,Tim Armstrong,2016-04-12 14:02:35-07:00,['0c4dc965a4f2d90dcbcd504400fe3a592fd16384'],128,285,413,3172278,16,0,0.355263158,0.276315789,3023
9d43aac6ce0c23ffee9378cbbd63cc3233670b84,1,Tim Armstrong,2016-04-12 14:02:35-07:00,['7050294215cdd81963aa815f69a573421a05ab3e'],15,12,27,3172305,3,,,,3023
e956a6be0ad993d4c88c124a858a862002e36cec,0,Tim Armstrong,2016-04-12 14:03:35-07:00,['9d43aac6ce0c23ffee9378cbbd63cc3233670b84'],0,0,0,3172305,0,,,,3023
8311f5e30afd29598e733f500406a8de9eaace3b,1,Tim Armstrong,2016-04-12 14:03:43-07:00,['e956a6be0ad993d4c88c124a858a862002e36cec'],9,10,19,3172324,1,0,0,1,3023
9bb1b8a3660f5b76f92670d6e0273ca49f41e3b9,0,Tim Armstrong,2016-04-12 14:03:43-07:00,['8311f5e30afd29598e733f500406a8de9eaace3b'],0,10,10,3172334,2,,,,3023
b085e31ff415e5eea56fa7dc6d35b508ed313e7c,0,Tim Armstrong,2016-04-12 14:03:43-07:00,['9bb1b8a3660f5b76f92670d6e0273ca49f41e3b9'],2,3,5,3172339,1,1,1,1,3023
86fd262dc91a638ddc18272c6c9f3d7b8e93b887,1,Tim Armstrong,2016-04-12 14:03:43-07:00,['b085e31ff415e5eea56fa7dc6d35b508ed313e7c'],1,2,3,3172342,1,,,,3023
4bdd0b976dc80f64ebd1f2c37ad03b4ec661cf02,0,Tim Armstrong,2016-04-12 14:03:44-07:00,['86fd262dc91a638ddc18272c6c9f3d7b8e93b887'],19,80,99,3172441,3,,,,3023
0d9028dd49af9b371d40aa91ea3c201f63454d1a,1,Tim Armstrong,2016-04-12 14:03:44-07:00,['4bdd0b976dc80f64ebd1f2c37ad03b4ec661cf02'],4,4,8,3172449,2,0,1,0.666666667,3023
ee8c3091871ebf168000e81aee349689b6671792,0,Tim Armstrong,2016-04-12 14:03:44-07:00,['0d9028dd49af9b371d40aa91ea3c201f63454d1a'],1,1,2,3172451,1,,,,3023
344fbc096644a5d06753aedeafe36eca82910cbc,0,Tim Armstrong,2016-04-12 14:03:44-07:00,['ee8c3091871ebf168000e81aee349689b6671792'],44,27,71,3172522,1,1,0.375,1,3023
92fafa1c0687141481e56ea6f09a67987d571d6e,1,Tim Armstrong,2016-04-12 14:03:44-07:00,['344fbc096644a5d06753aedeafe36eca82910cbc'],55,65,120,3172642,10,0,0,0,3023
36c294b55e64b6b9dd1c0fca30205a05db24b120,0,Tim Armstrong,2016-04-12 14:03:44-07:00,['92fafa1c0687141481e56ea6f09a67987d571d6e'],19,70,89,3172731,5,0.166666667,0.333333333,0.916666667,3023
62bb864704d5838726095bf90aeec1ba2c0ef881,1,Tim Armstrong,2016-04-12 14:03:44-07:00,['36c294b55e64b6b9dd1c0fca30205a05db24b120'],5,7,12,3172743,1,0,0,0,3023
49f9559f204278e39dcd362786adcc7b2f950d9e,1,Tim Armstrong,2016-04-12 14:03:44-07:00,['62bb864704d5838726095bf90aeec1ba2c0ef881'],16,13,29,3172772,5,1,1,0,3023
a65ffda542e6efd8f44cb116912260f056d6f141,1,Tim Armstrong,2016-04-12 14:03:44-07:00,['49f9559f204278e39dcd362786adcc7b2f950d9e'],13,33,46,3172818,1,,,,3023
f915d59aa4b028fafc3d12a028a2d937d2e19928,0,Tim Armstrong,2016-04-12 14:15:55-07:00,['a65ffda542e6efd8f44cb116912260f056d6f141'],0,7,7,3172825,1,,,,3023
687a4373e0b34cf60638f82a2368e3a25e2b8949,1,Tim Armstrong,2016-05-12 14:17:29-07:00,['f915d59aa4b028fafc3d12a028a2d937d2e19928'],24,28,52,3172877,1,,,,3023
bacf47d9bffcb4d76c86b46bdef98c1843b8cb1d,0,Tim Armstrong,2016-05-12 14:17:29-07:00,['687a4373e0b34cf60638f82a2368e3a25e2b8949'],0,14,14,3172891,2,0,0.333333333,1,3023
c083c798886a2ce94f8602cf6e469d81811a64cc,0,Tim Armstrong,2016-05-12 14:17:29-07:00,['bacf47d9bffcb4d76c86b46bdef98c1843b8cb1d'],11,14,25,3172916,2,1,1,1,3023
83a1434bc91286fdf1f063a84816ca7ab6b1f9f5,1,Tim Armstrong,2016-05-12 14:17:29-07:00,['c083c798886a2ce94f8602cf6e469d81811a64cc'],54,424,478,3173394,12,0.990566038,0.745283019,0.556603774,3024
1d8a6aed965d09c9f3ac3463d70341fe9ab0bcb2,0,Tim Armstrong,2016-05-12 14:17:30-07:00,['83a1434bc91286fdf1f063a84816ca7ab6b1f9f5'],5,3,8,3173402,1,1,1,1,3024
4d4901f038366a57e0b9310fcc1e278b137708cb,1,Tim Armstrong,2016-05-12 14:17:30-07:00,['1d8a6aed965d09c9f3ac3463d70341fe9ab0bcb2'],17,123,140,3173542,4,0.111111111,0.968253968,0.46031746,3024
5fef58937c7b608422b93814cc739200ecf27f65,0,Tim Armstrong,2016-05-12 14:17:30-07:00,['4d4901f038366a57e0b9310fcc1e278b137708cb'],2,4,6,3173548,1,0,0,0,3024
8e0267f2a918a6b8ad68082c4ecc1a4610e86deb,0,Tim Armstrong,2016-05-12 14:17:30-07:00,['5fef58937c7b608422b93814cc739200ecf27f65'],1,2,3,3173551,1,1,1,1,3024
f8b5481830f89f547afc04d731f5ae0a3f0766c5,1,Tim Armstrong,2016-05-12 14:17:31-07:00,['8e0267f2a918a6b8ad68082c4ecc1a4610e86deb'],2,6,8,3173559,1,0,1,1,3024
cbcda93dfb20a150281f02e1ff8655ef1150ca7e,1,Tim Armstrong,2016-05-12 14:17:31-07:00,['f8b5481830f89f547afc04d731f5ae0a3f0766c5'],2,96,98,3173657,2,0,0,0,3024
0ea3c9387d1bf01b75e4cf716d140bb79040045a,1,Tim Armstrong,2016-05-12 14:17:31-07:00,['cbcda93dfb20a150281f02e1ff8655ef1150ca7e'],70,77,147,3173804,9,,1,0,3024
261250a5a82c7ad0381221c8621fe41f42ffb6c9,1,Tim Armstrong,2016-05-12 14:17:32-07:00,['0ea3c9387d1bf01b75e4cf716d140bb79040045a'],26,27,53,3173857,1,0,0,0,3024
f0d6bb51e5b30884d1339927ba94e2dba9a0ad92,0,Tim Armstrong,2016-05-12 14:17:32-07:00,['261250a5a82c7ad0381221c8621fe41f42ffb6c9'],21,24,45,3173902,1,,,,3024
0bf887edce3ddf53aa5b2e75319d0bfe21bd55d8,0,Tim Armstrong,2016-05-12 14:17:32-07:00,['f0d6bb51e5b30884d1339927ba94e2dba9a0ad92'],0,7,7,3173909,1,0,1,1,3024
f5e8047886ae7c7a9466319d86ddf9bb0c7801c3,1,Tim Armstrong,2016-05-12 14:17:32-07:00,['0bf887edce3ddf53aa5b2e75319d0bfe21bd55d8'],18,27,45,3173954,3,1,1,1,3024
1c16dd0cf8fdf712b7bb2a908940463a4bbcbf3e,1,Tim Armstrong,2016-05-12 14:17:32-07:00,['f5e8047886ae7c7a9466319d86ddf9bb0c7801c3'],0,158,158,3174112,5,0.10989011,0,1,3024
630f1ab2706c2a5974e3b90b689fd2c00c039f4c,0,Tim Armstrong,2016-05-12 14:17:33-07:00,['1c16dd0cf8fdf712b7bb2a908940463a4bbcbf3e'],0,2,2,3174114,1,,,,3024
6d8c075d9c018883c56ff59c9f07ba0bbfa69873,1,Tim Armstrong,2016-05-12 14:17:33-07:00,['630f1ab2706c2a5974e3b90b689fd2c00c039f4c'],12,36,48,3174162,2,,,,3025
956a48fc50ea2b3bf7141924503621757060555c,0,Tim Armstrong,2016-05-12 14:17:33-07:00,['6d8c075d9c018883c56ff59c9f07ba0bbfa69873'],9,1,10,3174172,4,,,,3025
b3d744d101bc737b25c6d6db19d2628677ae208c,0,Tim Armstrong,2016-05-12 14:17:33-07:00,['956a48fc50ea2b3bf7141924503621757060555c'],23,82,105,3174277,7,0,0.833333333,1,3025
bcfc812ef912bf0693281265c627a0c8a74b072a,1,Tim Armstrong,2016-05-12 14:17:34-07:00,['b3d744d101bc737b25c6d6db19d2628677ae208c'],95,56,151,3174428,4,1,0.958333333,0,3025
e2792ec2624aa2acca7a61a410c2730932265ac6,0,Tim Armstrong,2016-05-12 14:17:34-07:00,['bcfc812ef912bf0693281265c627a0c8a74b072a'],23,34,57,3174485,2,0,1,1,3025
5387636140cf9ef873c7152141b07b4dc098f31a,1,Tim Armstrong,2016-05-12 14:17:34-07:00,['e2792ec2624aa2acca7a61a410c2730932265ac6'],1,15,16,3174501,2,0,1,0,3025
c14a6f11dfa3a3bd66d4868bd6e20f81ba822420,1,Tim Armstrong,2016-05-12 14:17:34-07:00,['5387636140cf9ef873c7152141b07b4dc098f31a'],122,129,251,3174752,7,0,1,0.260869565,3025
cef87e39dcd247774d03e99c67e534728ecd93ea,1,Tim Armstrong,2016-05-12 14:17:35-07:00,['c14a6f11dfa3a3bd66d4868bd6e20f81ba822420'],44,165,209,3174961,8,0.073170732,0.073170732,0.146341463,3025
9dcf857ddbe5fa6c8f09d021069b4b2bf1484618,1,Tim Armstrong,2016-05-12 14:17:35-07:00,['cef87e39dcd247774d03e99c67e534728ecd93ea'],34,47,81,3175042,1,0,1,0,3025
50314b5b2ce44c6a7f4f808654abd964da8e672d,0,Tim Armstrong,2016-05-12 14:17:35-07:00,['9dcf857ddbe5fa6c8f09d021069b4b2bf1484618'],0,8,8,3175050,2,,,,3025
6f4a5e6bb02b33d91aef909c6c1c69451c1bcbb5,1,Tim Armstrong,2016-05-12 14:17:36-07:00,['50314b5b2ce44c6a7f4f808654abd964da8e672d'],16,24,40,3175090,4,,,,3025
31d4103416bb67c373ca1b81cbc425a79bc9cace,1,Tim Armstrong,2016-05-12 14:17:36-07:00,['6f4a5e6bb02b33d91aef909c6c1c69451c1bcbb5'],30,77,107,3175197,3,1,1,0.583333333,3026
6629e79f328cc7ec6e9ad08d471958708d5fe10e,1,Tim Armstrong,2016-05-12 14:17:36-07:00,['31d4103416bb67c373ca1b81cbc425a79bc9cace'],47,55,102,3175299,4,1,1,1,3027
cf5dfd01a3bdc03a771a2757e82c5734cb52cbc1,0,Tim Armstrong,2016-05-12 14:17:36-07:00,['6629e79f328cc7ec6e9ad08d471958708d5fe10e'],1,1,2,3175301,1,,,,3027
fd523c65c4f8cddca2e6b1beac8e099f54d5b961,0,Tim Armstrong,2016-05-12 14:17:36-07:00,['cf5dfd01a3bdc03a771a2757e82c5734cb52cbc1'],1,5,6,3175307,1,,,,3027
1058163f70aa26ca3bc51b6e8d8262cf6641d61c,1,Tim Armstrong,2016-05-12 14:17:37-07:00,['fd523c65c4f8cddca2e6b1beac8e099f54d5b961'],0,6,6,3175313,1,,,,3027
4f18c701ba146130d82cae36455977d7ea4c57d0,1,Tim Armstrong,2016-05-12 14:17:37-07:00,['1058163f70aa26ca3bc51b6e8d8262cf6641d61c'],44,371,415,3175728,17,0.830508475,1,1,3028
a9e8e8530506ead32debe926962e5b4f101f9dfc,0,Tim Armstrong,2016-05-12 14:17:37-07:00,['4f18c701ba146130d82cae36455977d7ea4c57d0'],1,1,2,3175730,1,,,,3028
a27946e69679ef4c11aa8c61fda5684ec5e70911,1,Tim Armstrong,2016-05-12 14:17:37-07:00,['a9e8e8530506ead32debe926962e5b4f101f9dfc'],19,87,106,3175836,2,,,,3028
7cb8ed15f821618036de408f0aed81983d92d293,0,Tim Armstrong,2016-05-12 14:17:38-07:00,['a27946e69679ef4c11aa8c61fda5684ec5e70911'],4,4,8,3175844,1,,,,3028
5e64c858c386de4906b692be9b4db4ff9f127d59,1,Tim Armstrong,2016-05-12 14:17:38-07:00,['7cb8ed15f821618036de408f0aed81983d92d293'],117,183,300,3176144,11,0.518518519,1,0.555555556,3028
5b75601920c3184dcb43db67ab8f70ebadded8d2,1,Tim Armstrong,2016-05-12 14:17:38-07:00,['5e64c858c386de4906b692be9b4db4ff9f127d59'],1,5,6,3176150,2,,,,3028
abf5d78721195b6a1884b5f051058fe5219fdc84,1,Tim Armstrong,2016-05-12 14:17:38-07:00,['5b75601920c3184dcb43db67ab8f70ebadded8d2'],10,10,20,3176170,1,,,,3028
56654a8364d0da83e9d7d59b072bc9e24096aa94,0,Tim Armstrong,2016-05-12 14:17:39-07:00,['abf5d78721195b6a1884b5f051058fe5219fdc84'],1,1,2,3176172,1,,,,3028
37a73ae9f7de8a342ca790ccd8a750ad7e3a332e,1,Tim Armstrong,2016-05-12 14:17:39-07:00,['56654a8364d0da83e9d7d59b072bc9e24096aa94'],17,113,130,3176302,9,0.461538462,0.615384615,0.461538462,3028
0d82eb900b95625019be01691d4de12723725d18,0,Tim Armstrong,2016-05-12 14:17:39-07:00,['37a73ae9f7de8a342ca790ccd8a750ad7e3a332e'],1,2,3,3176305,1,0,0,1,3028
89aa6597f47325bfab7b06e866b1e1f14b155421,1,Tim Armstrong,2016-05-12 14:17:39-07:00,['0d82eb900b95625019be01691d4de12723725d18'],8,127,135,3176440,2,0.218181818,0.545454545,0.545454545,3028
a91529310975517fa59da92d993acfc473158d7c,1,Tim Armstrong,2016-05-12 14:17:40-07:00,['89aa6597f47325bfab7b06e866b1e1f14b155421'],26,67,93,3176533,17,0.368421053,0.315789474,0.789473684,3028
e54c99cd9a310cd0f3276a97457a07911e128965,1,Tim Armstrong,2016-05-12 14:17:40-07:00,['a91529310975517fa59da92d993acfc473158d7c'],65,3,68,3176601,7,0.473684211,0.315789474,0.368421053,3028
be415f380f1fc846fa6be40c85840fc51f40a0a2,0,Tim Armstrong,2016-05-12 14:17:40-07:00,['e54c99cd9a310cd0f3276a97457a07911e128965'],754,542,1296,3177897,33,0.142857143,1,0.285714286,3029
b4a9dfcc928dd50195e9a2938e48dd049b96a72d,1,Tim Armstrong,2016-05-12 14:17:40-07:00,['be415f380f1fc846fa6be40c85840fc51f40a0a2'],542,754,1296,3179193,33,0.857142857,0,0.714285714,3031
9f366645ab16ef569de60d834c534aa1d7743c56,1,Tim Armstrong,2016-05-12 14:17:41-07:00,['b4a9dfcc928dd50195e9a2938e48dd049b96a72d'],94,160,254,3179447,12,1,0.090909091,1,3031
a4bdfee75ddc18a128c5c733745065c5129a192e,1,Tim Armstrong,2016-05-12 14:17:41-07:00,['9f366645ab16ef569de60d834c534aa1d7743c56'],28,122,150,3179597,4,0.186440678,0.711864407,0.288135593,3031
465d0dde9d18634de84c35e3a281800f623a13ab,1,Tim Armstrong,2016-05-12 14:17:41-07:00,['a4bdfee75ddc18a128c5c733745065c5129a192e'],1,1,2,3179599,1,,,,3031
d6613e9531d259e70511e25d1cbdf7f9d95d0a19,1,Tim Armstrong,2016-05-12 14:17:42-07:00,['465d0dde9d18634de84c35e3a281800f623a13ab'],754,541,1295,3180894,33,0.142857143,1,0.285714286,3032
e4c0fb84b064d06ed005338acadee72404fad754,0,Tim Armstrong,2016-05-12 14:17:42-07:00,['d6613e9531d259e70511e25d1cbdf7f9d95d0a19'],2,2,4,3180898,1,,,,3032
50851f8775070fb0c14a0415a1e41ea71ac1f5a1,1,Tim Armstrong,2016-05-12 14:17:43-07:00,['e4c0fb84b064d06ed005338acadee72404fad754'],2,19,21,3180919,2,1,1,1,3032
6ee804e4e4869e14bbd6c3f24a65430d1387b895,0,Tim Armstrong,2016-05-12 14:17:43-07:00,['50851f8775070fb0c14a0415a1e41ea71ac1f5a1'],1,1,2,3180921,1,,,,3032
2826df93d287625caae698cbf9d09f8c561a48bd,0,Tim Armstrong,2016-05-12 14:17:44-07:00,['6ee804e4e4869e14bbd6c3f24a65430d1387b895'],4,2,6,3180927,1,1,0,0,3032
6be3de755abfa3410df3ab6bf2975703c110d979,1,Tim Armstrong,2016-05-12 14:17:44-07:00,['2826df93d287625caae698cbf9d09f8c561a48bd'],67,84,151,3181078,13,0,0,1,3032
a0d71e8192eb534624fab333d5caa2e36e953f87,1,Tim Armstrong,2016-05-12 14:17:44-07:00,['6be3de755abfa3410df3ab6bf2975703c110d979'],116,152,268,3181346,5,0.642857143,0.642857143,0.357142857,3032
4f9e16055f977652c78150280a5f950611bc3b88,1,Tim Armstrong,2016-05-12 14:17:45-07:00,['a0d71e8192eb534624fab333d5caa2e36e953f87'],7,47,54,3181400,4,,,,3033
6f9434217edcbab506765fabe5950699f589e939,1,Tim Armstrong,2016-05-12 14:17:45-07:00,['4f9e16055f977652c78150280a5f950611bc3b88'],11,38,49,3181449,4,0,0,1,3033
1b7823cdec8cab2ec01321f566f4c42c4ccc7deb,1,Tim Armstrong,2016-05-12 14:17:45-07:00,['6f9434217edcbab506765fabe5950699f589e939'],27,20,47,3181496,6,0,0,0,3033
b5570da405d4ccbdadd530837247b00d86a0c0ed,1,Tim Armstrong,2016-05-12 14:17:46-07:00,['1b7823cdec8cab2ec01321f566f4c42c4ccc7deb'],19,485,504,3182000,28,0.159663866,0.56302521,0.857142857,3036
3559931aa4e8ef1014fdc975084644b72a620f17,1,Tim Armstrong,2016-05-12 14:17:46-07:00,['b5570da405d4ccbdadd530837247b00d86a0c0ed'],9,123,132,3182132,9,0.465116279,0.930232558,0.395348837,3037
6fd8faa718851933ea2d6b2752339666443b47c5,1,Tim Armstrong,2016-05-12 14:17:46-07:00,['3559931aa4e8ef1014fdc975084644b72a620f17'],103,230,333,3182465,16,0.36,0,0.92,3037
ce2da6058a544968ef2cf930c7fb230d33db7416,0,Tim Armstrong,2016-05-12 14:17:47-07:00,['6fd8faa718851933ea2d6b2752339666443b47c5'],24,24,48,3182513,14,,,,3037
a09c80a33e79ed5609d9ddf7715a0098b03718d3,0,Tim Armstrong,2016-05-12 14:17:47-07:00,['ce2da6058a544968ef2cf930c7fb230d33db7416'],5,18,23,3182536,3,,,,3037
33e4ba94548c9b71da7cc4613b5c3f49da452c34,0,Tim Armstrong,2016-05-12 14:17:47-07:00,['a09c80a33e79ed5609d9ddf7715a0098b03718d3'],1,19,20,3182556,3,,,,3038
bce6b2b4229464c188569983fc482b7517c41378,1,Tim Armstrong,2016-05-12 14:17:48-07:00,['33e4ba94548c9b71da7cc4613b5c3f49da452c34'],176,503,679,3183235,8,0.452702703,0.506756757,0.594594595,3039
9a86fb3303cde5c96a32229bd74f3d3294aee790,1,Tim Armstrong,2016-05-12 14:17:48-07:00,['bce6b2b4229464c188569983fc482b7517c41378'],1,1,2,3183237,1,,,,3039
5302acd8fac4ae2340694773439aebe428110ee4,1,Tim Armstrong,2016-05-12 14:17:48-07:00,['9a86fb3303cde5c96a32229bd74f3d3294aee790'],14,61,75,3183312,3,0,0.052631579,0.710526316,3039
99879aad4751567a305f216d61d180c6772c4260,1,Tim Armstrong,2016-05-12 14:17:48-07:00,['5302acd8fac4ae2340694773439aebe428110ee4'],45,154,199,3183511,11,0.246575342,0.98630137,0.863013699,3040
ed7f5ebf53e9e318fbf1a9842e0e77c1b81498d3,1,Tim Armstrong,2016-05-12 14:17:49-07:00,['99879aad4751567a305f216d61d180c6772c4260'],450,809,1259,3184770,60,0.340659341,0.285714286,0.807692308,3043
767185087135b79ca9db41668d499494c2f107a4,0,Tim Armstrong,2016-05-12 14:17:49-07:00,['ed7f5ebf53e9e318fbf1a9842e0e77c1b81498d3'],0,16,16,3184786,2,0.857142857,1,0.857142857,3043
5ff8dc5a900428367c5e630e492eaf6c25615d64,1,Tim Armstrong,2016-05-12 14:17:49-07:00,['767185087135b79ca9db41668d499494c2f107a4'],16,16,32,3184818,6,,,,3043
68e8262caf62aed1f514dc6f0b9f0a4a1ff9a435,1,Tim Armstrong,2016-05-12 14:17:50-07:00,['5ff8dc5a900428367c5e630e492eaf6c25615d64'],1,188,189,3185007,7,0.177777778,0.877777778,0.722222222,3044
9a376385421b378fd71206317c86ab412f0b3a0d,1,Tim Armstrong,2016-05-12 14:17:50-07:00,['68e8262caf62aed1f514dc6f0b9f0a4a1ff9a435'],167,354,521,3185528,3,0.010309278,0.268041237,0.010309278,3044
a41710a0c80f2fb72438f7e555050e86472eaf74,1,Tim Armstrong,2016-05-12 14:17:50-07:00,['9a376385421b378fd71206317c86ab412f0b3a0d'],246,232,478,3186006,7,0,0,0,3045
01baf57aa4ca82acb0967ffaca5165ab0572ee59,1,Tim Armstrong,2016-05-12 14:17:51-07:00,['a41710a0c80f2fb72438f7e555050e86472eaf74'],1,14,15,3186021,2,1,1,1,3045
e32720e02241e70c2af2c6e677ea6eb6563d8f39,1,Tim Armstrong,2016-05-12 14:17:51-07:00,['01baf57aa4ca82acb0967ffaca5165ab0572ee59'],121,190,311,3186332,10,0,0.695652174,0.065217391,3045
f6fcee9a7a3ab28bcc95946973343ee6bac45931,0,Tim Armstrong,2016-05-12 14:17:51-07:00,['e32720e02241e70c2af2c6e677ea6eb6563d8f39'],4,23,27,3186359,3,0,0,1,3045
05acec5b00363cbae2624043458c79c536e8f073,1,Tim Armstrong,2016-05-12 14:17:52-07:00,['f6fcee9a7a3ab28bcc95946973343ee6bac45931'],191,1140,1331,3187690,4,0.689013035,0.860335196,0.804469274,3045
c9df348c3804fcc85579613a185435b60cd9476b,1,Tim Armstrong,2016-05-12 14:17:52-07:00,['05acec5b00363cbae2624043458c79c536e8f073'],6,426,432,3188122,13,0.427710843,0.656626506,0.891566265,3049
6e89f1a250ea1dd16a98f11dea2cdfa68e6dc73a,1,Tim Armstrong,2016-05-12 14:17:53-07:00,['c9df348c3804fcc85579613a185435b60cd9476b'],18,32,50,3188172,2,,,,3049
8c2bf9769aa7c2918468554c18bffaa072d18073,1,Tim Armstrong,2016-05-12 14:17:53-07:00,['6e89f1a250ea1dd16a98f11dea2cdfa68e6dc73a'],247,733,980,3189152,56,0.303030303,0.406060606,1,3051
3093054e95a70436b197ac878639b6864140a36d,0,Tim Armstrong,2016-05-12 14:17:54-07:00,['8c2bf9769aa7c2918468554c18bffaa072d18073'],622,1,623,3189775,2,0,0,0,3051
e1c5959b4dfbd13c60048d705d9a147ffb40cd04,0,Tim Armstrong,2016-05-12 14:17:54-07:00,['3093054e95a70436b197ac878639b6864140a36d'],2,10,12,3189787,2,0,0,1,3051
a805e100b2c89c23c44f4f9eac6410b79375c561,1,Tim Armstrong,2016-05-12 14:17:54-07:00,['e1c5959b4dfbd13c60048d705d9a147ffb40cd04'],23,82,105,3189892,5,1,1,1,3054
34c95c95901ba3d81a2b30f17ebf194cec4ef1d1,1,Tim Armstrong,2016-05-12 14:17:55-07:00,['a805e100b2c89c23c44f4f9eac6410b79375c561'],20,257,277,3190169,2,,,,3054
b5d77f43f41c565c08a24a701c4524e3d5d00012,0,Tim Armstrong,2016-05-12 14:17:55-07:00,['34c95c95901ba3d81a2b30f17ebf194cec4ef1d1'],1,1,2,3190171,1,,,,3054
5454086c748d2b77a3fcfb1e2a71866c6260ca54,1,Tim Armstrong,2016-05-12 14:17:56-07:00,['b5d77f43f41c565c08a24a701c4524e3d5d00012'],368,286,654,3190825,75,0.566666667,0,0,3054
8e64273fee3869dd8b70c604d3865dc34d752163,0,Tim Armstrong,2016-05-12 14:17:56-07:00,['5454086c748d2b77a3fcfb1e2a71866c6260ca54'],1,1,2,3190827,1,,,,3054
3b7d5b7c178fff8b269b6854842cc5dcf2e4d725,1,Tim Armstrong,2016-05-12 14:17:56-07:00,['8e64273fee3869dd8b70c604d3865dc34d752163'],555,5187,5742,3196569,30,0.42481203,0.627819549,0.706766917,3059
a0d424965230bd43020b493af24d6e209346823b,0,Tim Armstrong,2016-05-12 14:17:57-07:00,['3b7d5b7c178fff8b269b6854842cc5dcf2e4d725'],36,45,81,3196650,7,1,1,1,3059
2bb98a08c03b9ac47246c1957cce58a2614cccfd,0,Tim Armstrong,2016-05-12 14:17:57-07:00,['a0d424965230bd43020b493af24d6e209346823b'],15,24,39,3196689,4,0,0.333333333,1,3059
41e31439d331df7cb2921a31e8290b52b5e2581d,0,Tim Armstrong,2016-05-12 14:17:57-07:00,['2bb98a08c03b9ac47246c1957cce58a2614cccfd'],0,1,1,3196690,1,1,1,1,3059
5cae398a488ca43b7a688c35f130fe7ff360e553,1,Tim Armstrong,2016-05-12 14:17:57-07:00,['41e31439d331df7cb2921a31e8290b52b5e2581d'],1,22,23,3196713,2,0,0,0,3059
bff194ce17ea62c71f941b8091ecddfa791b39e1,0,Tim Armstrong,2016-05-12 14:17:58-07:00,['5cae398a488ca43b7a688c35f130fe7ff360e553'],91,40,131,3196844,2,0,0,0,3059
b204d5dea3212a81602aaf148a1960a0ecd47ccf,1,Tim Armstrong,2016-05-12 14:17:58-07:00,['bff194ce17ea62c71f941b8091ecddfa791b39e1'],37,61,98,3196942,9,1,1,1,3059
0f1dd55c79d978a3bdcd47216269128b3f92824f,0,Tim Armstrong,2016-05-12 14:17:58-07:00,['b204d5dea3212a81602aaf148a1960a0ecd47ccf'],0,1,1,3196943,1,,,,3059
07bdb6d4847105d0a7102b1da0415f1ddf9dcf95,0,Tim Armstrong,2016-05-12 14:17:58-07:00,['0f1dd55c79d978a3bdcd47216269128b3f92824f'],1,4,5,3196948,1,,,,3059
96e18f9e62f508a1a38aaf725a99a611de7c51be,0,Tim Armstrong,2016-05-12 14:17:59-07:00,['07bdb6d4847105d0a7102b1da0415f1ddf9dcf95'],57,39,96,3197044,1,0,0,0,3059
12097a07074efb1d83dfb43c4b851781345bb71a,0,Tim Armstrong,2016-05-12 14:17:59-07:00,['96e18f9e62f508a1a38aaf725a99a611de7c51be'],29,22,51,3197095,2,0,0,0,3059
30cc3f5ae0cb5565b041d705e816264b9754d213,1,Tim Armstrong,2016-05-12 14:18:00-07:00,['12097a07074efb1d83dfb43c4b851781345bb71a'],0,4,4,3197099,1,,,,3059
616eb2fccecef6ff17b4e3fd48e1908aaae7726e,1,Tim Armstrong,2016-05-12 14:18:00-07:00,['30cc3f5ae0cb5565b041d705e816264b9754d213'],75,57,132,3197231,3,0.1,0,0,3059
27815818b92362bc8b913a3da789c6debc88d551,1,Tim Armstrong,2016-05-12 14:18:00-07:00,['616eb2fccecef6ff17b4e3fd48e1908aaae7726e'],18,137,155,3197386,8,0.333333333,0.333333333,0.583333333,3059
c0ee93bbbe250507b524a3404e8092c5c83b0225,1,Tim Armstrong,2016-05-12 14:18:00-07:00,['27815818b92362bc8b913a3da789c6debc88d551'],135,136,271,3197657,1,0,1,0,3059
3092c96619f54bd47d71c2bc19c99bb03807ec1a,1,Tim Armstrong,2016-05-12 14:18:01-07:00,['c0ee93bbbe250507b524a3404e8092c5c83b0225'],80,277,357,3198014,18,0.456790123,0.962962963,0.950617284,3059
18f8f46be2b06d0bf93f9493853dd688bd1e2158,0,Tim Armstrong,2016-05-12 14:18:01-07:00,['3092c96619f54bd47d71c2bc19c99bb03807ec1a'],4,3,7,3198021,1,,,,3059
ca3f911f1af9f1c53b9bb589af3c99f7aeb89a6e,0,Tim Armstrong,2016-05-12 14:18:02-07:00,['18f8f46be2b06d0bf93f9493853dd688bd1e2158'],1,1,2,3198023,1,,,,3059
1c19c232f3cc40a99efa3e80d225726c31dd8167,0,Tim Armstrong,2016-05-12 14:18:02-07:00,['ca3f911f1af9f1c53b9bb589af3c99f7aeb89a6e'],14,5,19,3198042,1,0,0,0,3059
5c56ec0997cfd8f28a508ec796f547724ba8b986,0,Tim Armstrong,2016-05-12 14:18:02-07:00,['1c19c232f3cc40a99efa3e80d225726c31dd8167'],5,8,13,3198055,4,1,1,1,3059
da49a37edc136bd97a7255a57325ede8d37e6b5e,1,Tim Armstrong,2016-05-12 14:18:03-07:00,['5c56ec0997cfd8f28a508ec796f547724ba8b986'],1,1,2,3198057,1,,,,3059
8e8df2f2f60f72cf05bf7b9f8a1c5e2839691a87,1,Tim Armstrong,2016-05-12 14:18:03-07:00,['da49a37edc136bd97a7255a57325ede8d37e6b5e'],97,519,616,3198673,17,0.240740741,0.981481481,0.277777778,3060
1c704f3cfd79614d9b98e2c8bbbb002e932201b5,1,Tim Armstrong,2016-05-12 14:18:03-07:00,['8e8df2f2f60f72cf05bf7b9f8a1c5e2839691a87'],2,356,358,3199031,7,0.189781022,0.379562044,0.562043796,3062
02d3e93774d49b2170079bbe5172d326e03be012,0,Tim Armstrong,2016-05-12 14:18:04-07:00,['1c704f3cfd79614d9b98e2c8bbbb002e932201b5'],2,1,3,3199034,1,0,1,0,3062
eaa3926452bcba3c273c4e7e3c33a8828c63d647,0,Tim Armstrong,2016-05-12 14:18:04-07:00,['02d3e93774d49b2170079bbe5172d326e03be012'],17,33,50,3199084,1,0,0,0.866666667,3062
df8bf3a96551b4844ec8152aa5d4c16c5d6b6bde,1,Tim Armstrong,2016-05-12 14:18:04-07:00,['eaa3926452bcba3c273c4e7e3c33a8828c63d647'],8,63,71,3199155,3,0.821428571,1,1,3062
14cdb0497c52f102623b386bc35482f4c2fa7f8b,1,Tim Armstrong,2016-05-12 14:18:05-07:00,['df8bf3a96551b4844ec8152aa5d4c16c5d6b6bde'],133,356,489,3199644,3,0.090277778,0,0.520833333,3062
df1412c962945fe6e69591e80354fad692413ba3,1,Tim Armstrong,2016-05-12 23:06:35-07:00,['14cdb0497c52f102623b386bc35482f4c2fa7f8b'],63,183,246,3199890,20,0,0.658536585,0.658536585,3062
a2e88f0e6c7f017a3fe64bebbf5f05913aed4bc7,0,Tim Armstrong,2016-05-12 23:06:35-07:00,['df1412c962945fe6e69591e80354fad692413ba3'],1,1,2,3199892,1,,,,3062
6910f4975ad7969f5b6ba67e341f68dddf6608fa,0,Tim Armstrong,2016-05-12 23:06:35-07:00,['a2e88f0e6c7f017a3fe64bebbf5f05913aed4bc7'],1,1,2,3199894,1,,,,3062
7e0cbaf1a06da075639b36290b1ec09ef82122e0,0,Tim Armstrong,2016-05-12 23:06:36-07:00,['6910f4975ad7969f5b6ba67e341f68dddf6608fa'],44,52,96,3199990,2,0,1,1,3062
e96b463587cf5e7e5211741bcbc70237d1b1b2a6,0,Tim Armstrong,2016-05-12 23:06:36-07:00,['7e0cbaf1a06da075639b36290b1ec09ef82122e0'],0,2,2,3199992,1,0,0,1,3062
2b61ae7f2a31cdddc73d2a8eb5a6fc3d3272c2b2,0,Tim Armstrong,2016-05-12 23:06:36-07:00,['e96b463587cf5e7e5211741bcbc70237d1b1b2a6'],1,7,8,3200000,1,,,,3062
9174dee395bd1391b54224804aaab18254910cd0,1,Tim Armstrong,2016-05-12 23:06:36-07:00,['2b61ae7f2a31cdddc73d2a8eb5a6fc3d3272c2b2'],16,171,187,3200187,4,0.324324324,0.554054054,0.540540541,3062
cb377741eca8b5e5aa218e39518136676e535561,1,Tim Armstrong,2016-05-12 23:06:36-07:00,['9174dee395bd1391b54224804aaab18254910cd0'],103,30,133,3200320,10,0.950819672,0.704918033,0.37704918,3062
7767d300a3f018c8c8b32fa72abe5c126900a2be,1,Tim Armstrong,2016-05-12 23:06:36-07:00,['cb377741eca8b5e5aa218e39518136676e535561'],0,97,97,3200417,5,0.170212766,0.638297872,0.382978723,3063
46c3e43edb753b432b104a1953fbde779e70d2b4,1,Tim Armstrong,2016-05-12 23:06:36-07:00,['7767d300a3f018c8c8b32fa72abe5c126900a2be'],34,113,147,3200564,6,1,1,1,3063
0306dd576d05b6773e380d93af8b3dab90ecdd32,0,Tim Armstrong,2016-05-13 15:52:53-07:00,['46c3e43edb753b432b104a1953fbde779e70d2b4'],34,162,196,3200760,4,0,0.178947368,0.178947368,3064
3649ff89e1643bcf3d7889fd57ed3fbd2b17d64f,1,Tim Armstrong,2016-05-13 15:52:53-07:00,['0306dd576d05b6773e380d93af8b3dab90ecdd32'],1,6,7,3200767,1,0,0,1,3064
1aeda141aab3406c3df177dbbd05c887a190ca7a,0,Tim Armstrong,2016-05-13 15:52:53-07:00,['3649ff89e1643bcf3d7889fd57ed3fbd2b17d64f'],3,6,9,3200776,1,,,,3064
ff0cd823cc65b393e919511ef3239532b635a3b5,1,Tim Armstrong,2016-05-13 15:52:53-07:00,['1aeda141aab3406c3df177dbbd05c887a190ca7a'],0,343,343,3201119,2,0.422222222,0.672222222,0.888888889,3066
11ea79c5251a15d7a6902084f8a537fdab649cfc,0,Tim Armstrong,2016-05-14 01:30:00-07:00,['ff0cd823cc65b393e919511ef3239532b635a3b5'],5,5,10,3201129,1,,,,3066
cd193f063f02bf7921c2d0f5b1231f91deed6694,1,Tim Armstrong,2016-05-14 01:30:01-07:00,['11ea79c5251a15d7a6902084f8a537fdab649cfc'],83,91,174,3201303,1,0,0,0,3066
e61b5bc119f712fdcb9b0326302c466add65a217,1,Tim Armstrong,2016-05-14 01:30:01-07:00,['cd193f063f02bf7921c2d0f5b1231f91deed6694'],0,2,2,3201305,1,,,,3066
b4558d384ee103e8cc1b7456e504ac1ef07180be,0,Tim Armstrong,2016-05-14 01:30:01-07:00,['e61b5bc119f712fdcb9b0326302c466add65a217'],4,4,8,3201313,1,,,,3066
4c9c74dd33e0b84c3a3328df0a1721d627267192,0,Tim Armstrong,2016-05-14 01:30:01-07:00,['b4558d384ee103e8cc1b7456e504ac1ef07180be'],24,30,54,3201367,1,0,1,1,3066
12799fae6c01d2ca29fcab37d6d7f2a8a6a409df,1,Tim Armstrong,2016-05-17 01:30:11-07:00,['4c9c74dd33e0b84c3a3328df0a1721d627267192'],0,276,276,3201643,2,0.458015267,0.923664122,0.778625954,3067
b634a55b9244d8e3bc9ca79280d1246455b9ed4f,1,Tim Armstrong,2016-05-17 01:30:12-07:00,['12799fae6c01d2ca29fcab37d6d7f2a8a6a409df'],9,9,18,3201661,4,,,,3067
a59408b575ff6f48b8f0e1084ebcf7489c9de8af,1,Tim Armstrong,2016-05-17 01:30:12-07:00,['b634a55b9244d8e3bc9ca79280d1246455b9ed4f'],520,1177,1697,3203358,20,0.424561404,0.571929825,0.589473684,3067
f067929f3a2b66f60c9bc020df268dd13d1dbc02,0,Tim Armstrong,2016-05-17 10:09:05-07:00,['a59408b575ff6f48b8f0e1084ebcf7489c9de8af'],14,112,126,3203484,8,0.490196078,0.568627451,0.941176471,3068
9172f4b82444596da182955cda65951b60460501,1,Tim Armstrong,2016-05-17 10:09:06-07:00,['f067929f3a2b66f60c9bc020df268dd13d1dbc02'],10,17,27,3203511,1,0,1,0,3068
9f4276eea80a2e162a3045cefcc38f936df271d4,1,Tim Armstrong,2016-05-17 10:09:06-07:00,['9172f4b82444596da182955cda65951b60460501'],134,230,364,3203875,5,0,0.636363636,0,3068
265e39f89a914541064555b764bfd8f7747bb294,0,Tim Armstrong,2016-05-17 10:09:06-07:00,['9f4276eea80a2e162a3045cefcc38f936df271d4'],56,215,271,3204146,8,0.547169811,0.783018868,0.283018868,3068
f992dc7f88668ada08783b283025bfc8d22cdc66,1,Tim Armstrong,2016-05-18 01:40:22-07:00,['265e39f89a914541064555b764bfd8f7747bb294'],280,728,1008,3205154,33,0.625,0.455357143,0.482142857,3068
cb2a3aacd6d1b9b36007164c3fcc925557cb45cd,1,Tim Armstrong,2016-05-18 14:40:34-07:00,['f992dc7f88668ada08783b283025bfc8d22cdc66'],4,6,10,3205164,2,,,,3068
3403037b9707e49bbfec81eb64c3fa6771f9bfff,0,Tim Armstrong,2016-05-19 12:40:57-07:00,['cb2a3aacd6d1b9b36007164c3fcc925557cb45cd'],12,9,21,3205185,1,0,1,0,3068
36b524f68c925c89389aca0ba242391935614170,0,Tim Armstrong,2016-05-19 19:45:48-07:00,['3403037b9707e49bbfec81eb64c3fa6771f9bfff'],44,348,392,3205577,8,0.515923567,0.554140127,1,3069
08eff2bc0984b09508b49f8b3520af4204347927,0,Tim Armstrong,2016-05-20 08:46:00-07:00,['36b524f68c925c89389aca0ba242391935614170'],348,44,392,3205969,8,0.484076433,0.445859873,0,3069
38416eeeb95942b26b239c05de53dd805e0590f0,0,Tim Armstrong,2016-05-23 08:40:15-07:00,['08eff2bc0984b09508b49f8b3520af4204347927'],52,47,99,3206068,2,0,1,0,3069
f7501d2ec18feb2fd8e12cd7de3b9b9726085b54,0,Tim Armstrong,2016-05-23 08:40:18-07:00,['38416eeeb95942b26b239c05de53dd805e0590f0'],52,91,143,3206211,4,0.833333333,0.958333333,0.916666667,3069
d2c3c8711b7fc6783044572e1f7259b1bc769dd4,0,Tim Armstrong,2016-05-23 08:40:19-07:00,['f7501d2ec18feb2fd8e12cd7de3b9b9726085b54'],0,5,5,3206216,1,,,,3069
51869eac5624c4482653984db2719db880a775f5,0,Tim Armstrong,2016-05-23 08:40:19-07:00,['d2c3c8711b7fc6783044572e1f7259b1bc769dd4'],1,17,18,3206234,2,1,1,1,3069
1ccfc45d41acabd5fc9330a9a8b4bb50284c3e99,1,Tim Armstrong,2016-05-23 08:40:19-07:00,['51869eac5624c4482653984db2719db880a775f5'],47,42,89,3206323,7,0.75,0,0,3069
ea45de84f49412778b2f3f009bf2f5819307bfd6,1,Tim Armstrong,2016-05-23 08:40:19-07:00,['1ccfc45d41acabd5fc9330a9a8b4bb50284c3e99'],75,88,163,3206486,4,,,0,3069
72e4c4140033b4225d003686cb9c3ddb34d4a3b3,0,Tim Armstrong,2016-05-23 08:40:19-07:00,['ea45de84f49412778b2f3f009bf2f5819307bfd6'],25,11,36,3206522,1,0,0,0,3069
9a5e7012092e85f25fcd2a51347f08cbe38bfeb8,1,Tim Armstrong,2016-05-23 08:40:19-07:00,['72e4c4140033b4225d003686cb9c3ddb34d4a3b3'],39,1,40,3206562,3,,,,3069
9d23f4a65d1c9d1dfadca6316c34304fbcb20ef6,1,Tim Armstrong,2016-05-23 08:40:19-07:00,['9a5e7012092e85f25fcd2a51347f08cbe38bfeb8'],23,81,104,3206666,4,,,,3069
7d5d36a6e4a866c01193516a65c0fee00d81c20f,1,Tim Armstrong,2016-05-23 08:40:19-07:00,['9d23f4a65d1c9d1dfadca6316c34304fbcb20ef6'],27,37,64,3206730,8,0.333333333,0.166666667,0.666666667,3069
0243a21da874f850381d49ad4fed273a1b1fa997,1,Tim Armstrong,2016-05-23 08:40:19-07:00,['7d5d36a6e4a866c01193516a65c0fee00d81c20f'],61,60,121,3206851,12,0.833333333,1,0.222222222,3069
afdc32e409527c3907b916fb57e7a9e17e30d981,0,Tim Armstrong,2016-05-23 08:40:20-07:00,['0243a21da874f850381d49ad4fed273a1b1fa997'],6,7,13,3206864,1,,,,3069
bd6b16f132cd2e236c8339a7aa7d1a5aaa864881,0,Tim Armstrong,2016-05-23 08:40:20-07:00,['afdc32e409527c3907b916fb57e7a9e17e30d981'],6,10,16,3206880,2,0.5,0,0.5,3069
ca8ac3505554fd3c1bd5fbb18f2c49897a8b9c01,0,Tim Armstrong,2016-05-23 08:40:20-07:00,['bd6b16f132cd2e236c8339a7aa7d1a5aaa864881'],7,15,22,3206902,2,0.166666667,1,1,3069
49610e2cfa40aa10b626c5ae41d7f0d99d7cabc5,1,Tim Armstrong,2016-05-23 08:40:20-07:00,['ca8ac3505554fd3c1bd5fbb18f2c49897a8b9c01'],19,107,126,3207028,6,0.481481481,1,0.740740741,3070
fa30a0c818c0a9a6dbacb25d9e55bd24fb0c9b93,1,Tim Armstrong,2016-05-23 08:40:20-07:00,['49610e2cfa40aa10b626c5ae41d7f0d99d7cabc5'],0,57,57,3207085,3,0.9375,0.0625,0.9375,3070
f413e236a8474f355426d0612862e5e8c8cb5c57,1,Tim Armstrong,2016-05-23 08:40:20-07:00,['fa30a0c818c0a9a6dbacb25d9e55bd24fb0c9b93'],22,132,154,3207239,16,0.384615385,0.423076923,0.384615385,3072
d70ffa455d48bb5ffb26c9eb065a40374c369d8c,1,Tim Armstrong,2016-05-24 14:40:52-07:00,['f413e236a8474f355426d0612862e5e8c8cb5c57'],20,210,230,3207469,14,0.135135135,0.162162162,0.189189189,3072
f0e02867787aebbbb8dc893d262bde5bb642c35b,0,Tim Armstrong,2016-05-24 16:40:59-07:00,['d70ffa455d48bb5ffb26c9eb065a40374c369d8c'],1,1,2,3207471,1,,,,3072
5112e65be2c191cd606396f853ce51e3f915f097,1,Tim Armstrong,2016-05-24 16:40:59-07:00,['f0e02867787aebbbb8dc893d262bde5bb642c35b'],44,350,394,3207865,8,0.515923567,0.554140127,1,3073
6c8dc1bf7b12509e0ef08e40f60acbabae9ddad9,1,Tim Armstrong,2016-05-24 20:41:09-07:00,['5112e65be2c191cd606396f853ce51e3f915f097'],1,1,2,3207867,1,,,,3073
a0ad1868bda902fd914bc2be39eb9629a6eceb76,0,Tim Armstrong,2016-05-24 20:41:09-07:00,['6c8dc1bf7b12509e0ef08e40f60acbabae9ddad9'],3,10,13,3207880,1,1,1,1,3073
3ee075f96209086e6522a1e43cada213d39f0858,0,Tim Armstrong,2016-05-24 20:41:09-07:00,['a0ad1868bda902fd914bc2be39eb9629a6eceb76'],3,1,4,3207884,1,,,,3073
f09c6311c9a05e590145c80c1f66e561c8a3ba61,1,Tim Armstrong,2016-05-25 06:41:29-07:00,['3ee075f96209086e6522a1e43cada213d39f0858'],9,44,53,3207937,4,1,1,1,3073
6198d9262e6a9b5beb937e996b9afa942190bfdc,1,Tim Armstrong,2016-05-25 19:41:45-07:00,['f09c6311c9a05e590145c80c1f66e561c8a3ba61'],1139,1415,2554,3210491,156,0,0,0,3078
22669e23bef947ea155156e1af85aadc2c64e64a,1,Tim Armstrong,2016-05-25 19:41:45-07:00,['6198d9262e6a9b5beb937e996b9afa942190bfdc'],34,267,301,3210792,6,0.386666667,0.453333333,0.453333333,3079
a485d44fd0277e2b388620d879d1a7cf9d293b47,1,Tim Armstrong,2016-05-27 08:42:17-07:00,['22669e23bef947ea155156e1af85aadc2c64e64a'],12,9,21,3210813,2,,,,3079
0b7ae6e4eb4e363d6d67ff98f1fe78d7f73a6fce,1,Tim Armstrong,2016-05-31 23:31:41-07:00,['a485d44fd0277e2b388620d879d1a7cf9d293b47'],66,5771,5837,3216650,12,0.193521595,0.338870432,0.515503876,3085
e26dc856847ec01fde9fc4bc77fbc0f7937a2a61,1,Tim Armstrong,2016-05-31 23:32:10-07:00,['0b7ae6e4eb4e363d6d67ff98f1fe78d7f73a6fce'],10,19,29,3216679,5,0.857142857,1,0,3085
3a4a77521e31e28d139472809ae3642c6c912e2f,1,Tim Armstrong,2016-05-31 23:32:10-07:00,['e26dc856847ec01fde9fc4bc77fbc0f7937a2a61'],16,38,54,3216733,3,0.733333333,0.733333333,0,3085
8d2320df26febd10f48792c72da91e086de9ee66,0,Tim Armstrong,2016-05-31 23:32:10-07:00,['3a4a77521e31e28d139472809ae3642c6c912e2f'],2,2,4,3216737,1,,,,3085
35a95aca00380a12269333fea1e4c54190c2b5f0,1,Tim Armstrong,2016-05-31 23:32:10-07:00,['8d2320df26febd10f48792c72da91e086de9ee66'],1,1,2,3216739,1,,,,3085
c0269b23bcab27a2c7de7b04781bd330cad4b92a,0,Tim Armstrong,2016-05-31 23:32:10-07:00,['35a95aca00380a12269333fea1e4c54190c2b5f0'],1,1,2,3216741,1,,,,3085
6f1fe4ebe7ca9998218e0909b4ea6f8b2d27f31a,1,Tim Armstrong,2016-05-31 23:32:11-07:00,['c0269b23bcab27a2c7de7b04781bd330cad4b92a'],67,86,153,3216894,7,0.357142857,0.285714286,0,3085
d16e83214a956710eb56243afccb2df89b9e5285,1,Tim Armstrong,2016-05-31 23:32:11-07:00,['6f1fe4ebe7ca9998218e0909b4ea6f8b2d27f31a'],28,72,100,3216994,5,1,1,0.125,3085
77da3834ffed32a365e64aad66f9bd4863bc14ee,1,Tim Armstrong,2016-05-31 23:32:11-07:00,['d16e83214a956710eb56243afccb2df89b9e5285'],48,606,654,3217648,13,0.136029412,0.113970588,0.794117647,3087
489689598857adf0065df4ad86e577b5b28fa66b,0,Tim Armstrong,2016-05-31 23:32:11-07:00,['77da3834ffed32a365e64aad66f9bd4863bc14ee'],4,8,12,3217660,2,,,,3087
98d7b8a90d534736915206fea9b8a64ef049ba08,1,Tim Armstrong,2016-05-31 23:32:11-07:00,['489689598857adf0065df4ad86e577b5b28fa66b'],7,75,82,3217742,3,0.226415094,0.169811321,1,3087
816735a032daff77da089735faab68904a803fd4,1,Tim Armstrong,2016-05-31 23:32:11-07:00,['98d7b8a90d534736915206fea9b8a64ef049ba08'],45,79,124,3217866,4,0,1,1,3088
5ede8eb8a7bb0ed455610eec89c3ae49898b778e,1,Tim Armstrong,2016-05-31 23:32:11-07:00,['816735a032daff77da089735faab68904a803fd4'],1,23,24,3217890,2,1,1,1,3088
8f79e9eb3c0c497f056f22583555b4a2e842eb94,1,Tim Armstrong,2016-05-31 23:32:11-07:00,['5ede8eb8a7bb0ed455610eec89c3ae49898b778e'],1,3,4,3217894,1,0,0,0,3088
32c40f9c5daae8f130c928578636f6fa4204fd22,0,Tim Armstrong,2016-05-31 23:32:11-07:00,['8f79e9eb3c0c497f056f22583555b4a2e842eb94'],6,4,10,3217904,2,0,0,0,3088
5be7c68ed86bee90bec1e9d64ec8829c38d2026d,1,Tim Armstrong,2016-05-31 23:32:12-07:00,['32c40f9c5daae8f130c928578636f6fa4204fd22'],180,193,373,3218277,17,0,0,0.666666667,3088
06238ef1a338905c42e7841e9d989e0a5ec8a923,0,Tim Armstrong,2016-05-31 23:32:12-07:00,['5be7c68ed86bee90bec1e9d64ec8829c38d2026d'],6,0,6,3218283,1,,,,3088
c76750a7537b44a46940728d47cf28f18c2bd23d,0,Tim Armstrong,2016-05-31 23:32:12-07:00,['06238ef1a338905c42e7841e9d989e0a5ec8a923'],1,1,2,3218285,1,,,,3088
4edb8bb60de5264848b3f6934edce7df11a41a11,1,Tim Armstrong,2016-05-31 23:32:12-07:00,['c76750a7537b44a46940728d47cf28f18c2bd23d'],7,4,11,3218296,1,,,,3088
7ac341d4271d564ae11cb5607c05760728c99d2d,1,Tim Armstrong,2016-05-31 23:32:12-07:00,['4edb8bb60de5264848b3f6934edce7df11a41a11'],0,14,14,3218310,1,,,,3088
585ee48dc77489f371cf477df544178ddf787fde,1,Tim Armstrong,2016-05-31 23:32:12-07:00,['7ac341d4271d564ae11cb5607c05760728c99d2d'],9,23,32,3218342,5,0.5,0.75,1,3088
5231301084c76bd48059620798579873d935079f,1,Tim Armstrong,2016-06-01 19:32:39-07:00,['585ee48dc77489f371cf477df544178ddf787fde'],23,75,98,3218440,6,0.818181818,0.96969697,0.666666667,3088
5f3996e6d1c53a5255b84f9e32da9324f3f972b3,1,Tim Armstrong,2016-06-02 09:32:54-07:00,['5231301084c76bd48059620798579873d935079f'],27,26,53,3218493,9,,,,3088
40b79aecbc8fff713ae0a1409cc7ea65223c2397,0,Tim Armstrong,2016-06-02 09:32:54-07:00,['5f3996e6d1c53a5255b84f9e32da9324f3f972b3'],7,9,16,3218509,1,,,,3088
710fa06b7c63f3978a35fbfa9d8e465eab16ec06,1,Tim Armstrong,2016-06-02 09:32:54-07:00,['40b79aecbc8fff713ae0a1409cc7ea65223c2397'],141,125,266,3218775,1,1,1,0,3088
b14ca6d09fcc431ea585810620c940ee2f537da9,0,Tim Armstrong,2016-06-02 09:32:54-07:00,['710fa06b7c63f3978a35fbfa9d8e465eab16ec06'],1,18,19,3218794,2,0,0.5,1,3088
37ec25396f2964c386655ce3408b32a73f71edf6,1,Tim Armstrong,2016-06-02 21:33:08-07:00,['b14ca6d09fcc431ea585810620c940ee2f537da9'],956,1251,2207,3221001,41,1,1,0.546511628,3088
ee53ddb389549247f5bfe760d446dc7b3b963a29,1,Tim Armstrong,2016-06-06 17:34:07-07:00,['37ec25396f2964c386655ce3408b32a73f71edf6'],116,188,304,3221305,5,0.764705882,0.882352941,0.941176471,3088
067af1957c3c58c54adacaa267d3de319a98a0c3,1,Tim Armstrong,2016-06-06 17:34:07-07:00,['ee53ddb389549247f5bfe760d446dc7b3b963a29'],40,34,74,3221379,6,0,0,0,3088
a1b035a251f0c2e9674aa33543601c956e9bdd98,0,Tim Armstrong,2016-06-06 18:34:13-07:00,['067af1957c3c58c54adacaa267d3de319a98a0c3'],2,30,32,3221411,1,0.058823529,1,1,3088
d23e5505c81a793e931b7070b9bebfddee35f430,0,Tim Armstrong,2016-06-06 22:34:19-07:00,['a1b035a251f0c2e9674aa33543601c956e9bdd98'],25,45,70,3221481,2,0.833333333,0.833333333,1,3088
a9f7cf51f4e422a048e871d97ef1b42d4a4cefe0,1,Tim Armstrong,2016-06-07 09:34:30-07:00,['d23e5505c81a793e931b7070b9bebfddee35f430'],139,113,252,3221733,4,1,0,0,3088
95064359cc5948d043e271fbb18621fb1dffc02f,0,Tim Armstrong,2016-06-07 09:34:30-07:00,['a9f7cf51f4e422a048e871d97ef1b42d4a4cefe0'],40,22,62,3221795,3,0,0,0,3088
2fb14d1b89b9258d3e29fa5b9857dcde490d7d34,0,Tim Armstrong,2016-06-07 09:34:30-07:00,['95064359cc5948d043e271fbb18621fb1dffc02f'],2,2,4,3221799,1,,,,3088
86ff18eee9cf3babe0d596050088bf75b5287467,1,Tim Armstrong,2016-06-07 17:29:59-07:00,['2fb14d1b89b9258d3e29fa5b9857dcde490d7d34'],457,116,573,3222372,8,,,,3088
025fd3bd7f3b7f4bc3dcb6b21e3598124b19b577,1,Tim Armstrong,2016-06-07 17:29:59-07:00,['86ff18eee9cf3babe0d596050088bf75b5287467'],3,85,88,3222460,9,0,0.5,0.529411765,3092
6c992f97f2f314a7837ac0c8b4fd7d8de0414806,1,Tim Armstrong,2016-06-07 22:30:08-07:00,['025fd3bd7f3b7f4bc3dcb6b21e3598124b19b577'],48,37,85,3222545,1,0,1,0,3092
2c07ca3aac825d2dc900f3d43c72375fb5cd7c82,0,Tim Armstrong,2016-06-08 02:30:17-07:00,['6c992f97f2f314a7837ac0c8b4fd7d8de0414806'],0,51,51,3222596,2,,,,3093
e57fd2d831f51d19cf0a1b961d3bb5d69a1a612f,0,Tim Armstrong,2016-06-08 16:30:32-07:00,['2c07ca3aac825d2dc900f3d43c72375fb5cd7c82'],22,5,27,3222623,2,0,0,0,3093
870839dc1fea0ec303227ced5a5c2d6f11cbfe6f,0,Tim Armstrong,2016-06-08 18:30:38-07:00,['e57fd2d831f51d19cf0a1b961d3bb5d69a1a612f'],0,241,241,3222864,1,,,,3094
4e7172f6f5bf8a836fbb0c495ce8bdefecc2d6e5,1,Tim Armstrong,2016-06-09 04:30:48-07:00,['870839dc1fea0ec303227ced5a5c2d6f11cbfe6f'],0,123,123,3222987,4,0,0.697916667,0.697916667,3094
c1093ed8611e8cc2702f81575e6c7193e0580386,0,Tim Armstrong,2016-06-09 17:31:00-07:00,['4e7172f6f5bf8a836fbb0c495ce8bdefecc2d6e5'],7,8,15,3223002,1,,,,3094
abd6ad3020bd782221277d5bf1583577327639a4,1,Tim Armstrong,2016-06-09 17:31:00-07:00,['c1093ed8611e8cc2702f81575e6c7193e0580386'],15,14,29,3223031,1,,,,3094
ca62ce65e9c652eecc9cb883842bd43594627be8,1,Tim Armstrong,2016-06-09 17:31:00-07:00,['abd6ad3020bd782221277d5bf1583577327639a4'],13,34,47,3223078,1,1,1,0,3094
19ff47091cad90fe2975a696d287a863e47f877f,1,Tim Armstrong,2016-06-10 10:31:15-07:00,['ca62ce65e9c652eecc9cb883842bd43594627be8'],1100,1098,2198,3225276,9,1,1,1,3099
c69cd15a0ac4ac3efc5c6d74939cd2b64d72db30,1,Tim Armstrong,2016-06-11 05:31:32-07:00,['19ff47091cad90fe2975a696d287a863e47f877f'],1,16,17,3225293,2,1,1,1,3099
f772840994787e759727190f9949d51cb55ceb78,0,Tim Armstrong,2016-06-13 13:32:10-07:00,['c69cd15a0ac4ac3efc5c6d74939cd2b64d72db30'],1,1,2,3225295,1,,,,3099
bee5375502882a2bf28e7378f705cb247e9b241e,0,Tim Armstrong,2016-06-13 15:32:17-07:00,['f772840994787e759727190f9949d51cb55ceb78'],0,2,2,3225297,1,,,,3099
fc444c102ed148140330a70cf3b54980b4f0804c,0,Tim Armstrong,2016-06-13 16:32:22-07:00,['bee5375502882a2bf28e7378f705cb247e9b241e'],19,11,30,3225327,1,0,0,0,3099
ec3a1c7866741d0e28c6fb98e0d485422767ebbf,0,Tim Armstrong,2016-06-13 17:32:27-07:00,['fc444c102ed148140330a70cf3b54980b4f0804c'],7,47,54,3225381,3,,,,3100
c076f098d46292fec98eb3431ca292ed229c678d,1,Tim Armstrong,2016-06-13 18:32:32-07:00,['ec3a1c7866741d0e28c6fb98e0d485422767ebbf'],88,97,185,3225566,1,0,0,0,3100
01287a3ba909f93a5bbe72081d5b9ec67db70257,1,Tim Armstrong,2016-06-13 18:32:32-07:00,['c076f098d46292fec98eb3431ca292ed229c678d'],242,1143,1385,3226951,27,0.268953069,0.85198556,0.660649819,3107
3dff390e48c19a37e93e952951b060e0f28a73d0,1,Tim Armstrong,2016-06-14 10:32:46-07:00,['01287a3ba909f93a5bbe72081d5b9ec67db70257'],19,56,75,3227026,4,0.923076923,0.961538462,1,3107
b1af24556347b72c3160f66dd9434d537b7daa9b,1,Tim Armstrong,2016-06-14 11:32:53-07:00,['3dff390e48c19a37e93e952951b060e0f28a73d0'],198,245,443,3227469,5,1,0,0,3108
d8d3e239114413d39a82dc747adbea46cd69f644,1,Tim Armstrong,2016-06-14 13:33:00-07:00,['b1af24556347b72c3160f66dd9434d537b7daa9b'],1,1,2,3227471,1,,,,3108
2dad444c8c1db09598d40ae34a81b4bc4276fbb4,1,Tim Armstrong,2016-06-15 02:33:17-07:00,['d8d3e239114413d39a82dc747adbea46cd69f644'],16,108,124,3227595,5,0.454545455,1,0.257575758,3108
547be27e77441c50db068aa51f19d87b3a2fd3af,1,Tim Armstrong,2016-06-15 21:33:39-07:00,['2dad444c8c1db09598d40ae34a81b4bc4276fbb4'],81,272,353,3227948,19,0.605769231,0.625,0.625,3113
a6198ce8a48ea59162389cc9fb3cd1a0aa6096d3,0,Tim Armstrong,2016-06-16 00:34:13-07:00,['547be27e77441c50db068aa51f19d87b3a2fd3af'],5,0,5,3227953,3,,,,3113
2100b3a346d760d9e0c3fe450ec2fe74d254a38d,0,Tim Armstrong,2016-06-16 00:34:14-07:00,['a6198ce8a48ea59162389cc9fb3cd1a0aa6096d3'],8,7,15,3227968,3,1,0,0,3113
73595d8f40dd5ac67cf6f225dd55f1297d06e3ff,0,Tim Armstrong,2016-06-16 17:34:34-07:00,['2100b3a346d760d9e0c3fe450ec2fe74d254a38d'],2,3,5,3227973,1,,,,3113
a3a7c7cc8d19773a76cc5426f63b91c1dbb1992a,0,Tim Armstrong,2016-06-20 15:37:05-07:00,['73595d8f40dd5ac67cf6f225dd55f1297d06e3ff'],6,6,12,3227985,1,,,,3113
7f95fe23f11a280d1d42ca5e99d3315b6e5fc2a9,1,Tim Armstrong,2016-06-20 15:37:17-07:00,['a3a7c7cc8d19773a76cc5426f63b91c1dbb1992a'],20,85,105,3228090,5,0,0.672727273,0.6,3113
8a04b170d25599fa23c655b1148defb217b730f2,0,Tim Armstrong,2016-06-20 15:37:18-07:00,['7f95fe23f11a280d1d42ca5e99d3315b6e5fc2a9'],2,2,4,3228094,2,,,,3113
6e71e903ff0b7181c487376512c8dc1421642636,1,Tim Armstrong,2016-06-21 00:37:53-07:00,['8a04b170d25599fa23c655b1148defb217b730f2'],60,106,166,3228260,5,1,1,0.75,3113
fc3ff1c52f3b3bfa5f94cc48b76025dd3e9b30b0,1,Tim Armstrong,2016-06-21 00:37:54-07:00,['6e71e903ff0b7181c487376512c8dc1421642636'],7,20,27,3228287,2,1,1,1,3113
38b18ea1c599cf8bfdad5c072beefad869088b45,1,Tim Armstrong,2016-06-21 17:38:12-07:00,['fc3ff1c52f3b3bfa5f94cc48b76025dd3e9b30b0'],123,339,462,3228749,6,0.987341772,0.987341772,1,3113
06abb57877e1aeab9e9fa54ffe8ae2f360603552,0,Tim Armstrong,2016-06-21 17:38:12-07:00,['38b18ea1c599cf8bfdad5c072beefad869088b45'],14,27,41,3228790,2,0,0,0,3113
140220323d4d0d8767edeff7ee3e8426a0dd55e6,1,Tim Armstrong,2016-06-21 19:38:19-07:00,['06abb57877e1aeab9e9fa54ffe8ae2f360603552'],1,4,5,3228795,1,,,,3113
893e6f498b3743de71735eb1dd0178382b80c3bd,0,Tim Armstrong,2016-06-22 11:38:46-07:00,['140220323d4d0d8767edeff7ee3e8426a0dd55e6'],1,6,7,3228802,1,0,1,1,3113
a5ae2bfd881ba8a39f171b0cc39c29b592015c2d,1,Tim Armstrong,2016-06-22 14:38:57-07:00,['893e6f498b3743de71735eb1dd0178382b80c3bd'],2,12,14,3228816,2,,,,3113
7e4aacdf611edf69f4905a9a52fd9f7df6144a1c,0,Tim Armstrong,2016-06-22 23:39:12-07:00,['a5ae2bfd881ba8a39f171b0cc39c29b592015c2d'],3,12,15,3228831,2,,,,3113
3dccb01257af8c59dc55feb819ed80f3539c386d,0,Tim Armstrong,2016-06-22 23:39:12-07:00,['7e4aacdf611edf69f4905a9a52fd9f7df6144a1c'],2,6,8,3228839,1,0,1,1,3113
7cb863154ab3f8d40b1bb73635ef03f5910ee64c,1,Tim Armstrong,2016-07-05 13:37:25-07:00,['3dccb01257af8c59dc55feb819ed80f3539c386d'],10,86,96,3228935,3,0.894736842,0.894736842,0.947368421,3114
5d9e13a6af1e3da80d7361ca591704aa94e59099,0,Tim Armstrong,2016-07-05 13:37:25-07:00,['7cb863154ab3f8d40b1bb73635ef03f5910ee64c'],38,72,110,3229045,9,,,,3115
5f3dfdf6c7c01fe15a0d31d99adcd6241d09ce4b,1,Tim Armstrong,2016-07-05 13:37:25-07:00,['5d9e13a6af1e3da80d7361ca591704aa94e59099'],338,363,701,3229746,29,0,0,1,3115
7b9e9c634912c312e7e114fc5d983ffddf0b399f,0,Tim Armstrong,2016-07-05 13:37:25-07:00,['5f3dfdf6c7c01fe15a0d31d99adcd6241d09ce4b'],1,2,3,3229749,1,,,,3115
08e8de73b28deda1d0afba91bea3f6e5619b5c76,0,Tim Armstrong,2016-07-05 13:37:26-07:00,['7b9e9c634912c312e7e114fc5d983ffddf0b399f'],4,4,8,3229757,2,,,,3115
d19751669acb5b5886792d8606d5dca7ee5b30a8,0,Tim Armstrong,2016-07-05 13:37:26-07:00,['08e8de73b28deda1d0afba91bea3f6e5619b5c76'],5,83,88,3229845,3,0.152173913,0.152173913,0.260869565,3115
a07fc367eee92f6f51365b60883ba3fc2fdabd90,1,Tim Armstrong,2016-07-05 13:37:26-07:00,['d19751669acb5b5886792d8606d5dca7ee5b30a8'],363,338,701,3230546,29,1,1,0,3115
cd2ee9ecf9947644a582dd214a18b2f589c2439c,0,Tim Armstrong,2016-07-05 13:37:26-07:00,['a07fc367eee92f6f51365b60883ba3fc2fdabd90'],0,2,2,3230548,1,,,,3115
0dde1c2f86ef924777ac196013d11aa2e28cc067,1,Tim Armstrong,2016-07-05 16:40:23-07:00,['cd2ee9ecf9947644a582dd214a18b2f589c2439c'],119,202,321,3230869,7,0.27027027,1,0.837837838,3117
d60b70769a7ef14a8170565253aaefdd6e80f7bf,0,Tim Armstrong,2016-07-05 17:40:33-07:00,['0dde1c2f86ef924777ac196013d11aa2e28cc067'],10,42,52,3230921,3,0.041666667,1,0.583333333,3117
36b4f88bd3c24b056576b7e8a895993a5d582971,0,Tim Armstrong,2016-07-06 11:40:47-07:00,['d60b70769a7ef14a8170565253aaefdd6e80f7bf'],250,567,817,3231738,17,0.612627986,0.619453925,0.860068259,3122
a070217750d4006a41426e97f41d94c93489457e,0,Tim Armstrong,2016-07-06 14:40:54-07:00,['36b4f88bd3c24b056576b7e8a895993a5d582971'],1,5,6,3231744,1,,,,3122
f407288d7b53da337abd8aac4ac6988d2c428a9c,0,Tim Armstrong,2016-07-06 23:41:04-07:00,['a070217750d4006a41426e97f41d94c93489457e'],2,30,32,3231776,2,0,0.88,0.88,3122
c1da1409ba8c915b7e59e74d924a9c823f48ae2d,1,Tim Armstrong,2016-07-07 10:41:29-07:00,['f407288d7b53da337abd8aac4ac6988d2c428a9c'],143,329,472,3232248,12,0,0.009090909,0.918181818,3122
c7b7c3ece2eb28db7ad76397c433ef582aeac7f8,1,Tim Armstrong,2016-07-07 18:41:45-07:00,['c1da1409ba8c915b7e59e74d924a9c823f48ae2d'],390,424,814,3233062,4,1,1,0,3123
667a778af134ac987a151055388a41bb8e208dc7,0,Tim Armstrong,2016-07-08 02:41:53-07:00,['c7b7c3ece2eb28db7ad76397c433ef582aeac7f8'],14,10,24,3233086,7,,,,3123
ed5ec6772fd24ad28901bc68f120c59597439cf2,1,Tim Armstrong,2016-07-08 15:42:09-07:00,['667a778af134ac987a151055388a41bb8e208dc7'],340,370,710,3233796,30,0,0,1,3125
3810b7c413f575ad5970d3fb5c53509d81cb0032,0,Tim Armstrong,2016-07-08 19:42:18-07:00,['ed5ec6772fd24ad28901bc68f120c59597439cf2'],42,89,131,3233927,6,0,0.692307692,0.192307692,3125
476f687b4f29dee4da5e5e10251a546b8db9194f,1,Tim Armstrong,2016-07-08 19:42:18-07:00,['3810b7c413f575ad5970d3fb5c53509d81cb0032'],129,189,318,3234245,4,0,1,1,3125
c6ce32b3b6ae9b16f9b7921d22205c851745f410,1,Taras Bobrovytsky,2016-07-14 19:04:43+00:00,['476f687b4f29dee4da5e5e10251a546b8db9194f'],17,131,148,3234393,5,0,0,0,3125
db4294c76139209b663f880d7aa7d03f6bcd1b3d,0,Taras Bobrovytsky,2016-07-14 19:04:43+00:00,['c6ce32b3b6ae9b16f9b7921d22205c851745f410'],13,13,26,3234419,1,,,,3125
948a6c34fcaa7ba481254e0a7b0d2cf987a4b690,1,Taras Bobrovytsky,2016-07-14 19:04:44+00:00,['db4294c76139209b663f880d7aa7d03f6bcd1b3d'],10,74,84,3234503,2,0.622222222,0.8,0.822222222,3125
df2fc08d22a3be8c9b6a2f2e6a4d9d59c2b6ca44,1,Taras Bobrovytsky,2016-07-14 19:04:44+00:00,['948a6c34fcaa7ba481254e0a7b0d2cf987a4b690'],11,24,35,3234538,8,0,0,0,3125
55b2a639e81e295a99927d5063adaf896985b29a,0,Taras Bobrovytsky,2016-07-14 19:04:44+00:00,['df2fc08d22a3be8c9b6a2f2e6a4d9d59c2b6ca44'],103,102,205,3234743,62,,,,3125
4680252a9e4fc9ad63060010050d11e2c8355705,1,Taras Bobrovytsky,2016-07-14 19:04:44+00:00,['55b2a639e81e295a99927d5063adaf896985b29a'],8,10,18,3234761,1,,,,3125
f4fbd7914c8756e8b657d630a3e5d7d1f010dfa1,1,Taras Bobrovytsky,2016-07-14 19:04:44+00:00,['4680252a9e4fc9ad63060010050d11e2c8355705'],171,167,338,3235099,41,0.2,0.6,0.4,3125
59cdec21bf2a890e6f7fe856a8e1c616e8bebec3,1,Taras Bobrovytsky,2016-07-14 19:04:44+00:00,['f4fbd7914c8756e8b657d630a3e5d7d1f010dfa1'],8,11,19,3235118,4,1,1,1,3125
d75f327adda7377300e448cdda12d321da837efe,0,Taras Bobrovytsky,2016-07-14 19:04:44+00:00,['59cdec21bf2a890e6f7fe856a8e1c616e8bebec3'],2,5,7,3235125,1,0,0,1,3125
761c39c54510f08b10c9dc567335243d61d6b2d9,1,Taras Bobrovytsky,2016-07-14 19:04:44+00:00,['d75f327adda7377300e448cdda12d321da837efe'],0,295,295,3235420,1,0.464968153,0.738853503,0.738853503,3126
148c23a3cc0c588fe85f3d933e92cba0c0a72323,0,Taras Bobrovytsky,2016-07-14 19:04:44+00:00,['761c39c54510f08b10c9dc567335243d61d6b2d9'],7,4,11,3235431,2,1,0,1,3126
79641a873d2d12c2d8646349e58eff2ac0b1952d,0,Taras Bobrovytsky,2016-07-14 19:04:44+00:00,['148c23a3cc0c588fe85f3d933e92cba0c0a72323'],12,0,12,3235443,1,,,,3126
26266fda4ca00ab0034ae67dfc0dfde26f62ad70,0,Taras Bobrovytsky,2016-07-14 19:04:45+00:00,['79641a873d2d12c2d8646349e58eff2ac0b1952d'],61,16,77,3235520,2,0,0,0.847826087,3126
144cc68cc12e713824f5b9c7269dda4b70385557,0,Taras Bobrovytsky,2016-07-14 19:04:45+00:00,['26266fda4ca00ab0034ae67dfc0dfde26f62ad70'],7,12,19,3235539,1,0,0,1,3126
900f148078b4fdb8375e3a3107d62fb3ca74e24f,1,Taras Bobrovytsky,2016-07-14 19:04:45+00:00,['144cc68cc12e713824f5b9c7269dda4b70385557'],8,49,57,3235596,7,0.7,0.7,0.6,3126
f129dfd2022d268a5658bac9da279df79dd6c857,0,Taras Bobrovytsky,2016-07-14 19:04:45+00:00,['900f148078b4fdb8375e3a3107d62fb3ca74e24f'],12,28,40,3235636,5,1,0,0,3126
744103264546e5fd695c0d4661a804da247e86c4,1,Taras Bobrovytsky,2016-07-14 19:04:45+00:00,['f129dfd2022d268a5658bac9da279df79dd6c857'],1,41,42,3235678,2,0,1,0,3126
baf8fe202c1e212bbed3c73a6a63017eceb4a180,1,Taras Bobrovytsky,2016-07-14 19:04:45+00:00,['744103264546e5fd695c0d4661a804da247e86c4'],73,170,243,3235921,5,0.382352941,0.176470588,1,3127
6ee15fadedcac9d41f8ad660caf8d4a60267df8e,1,Taras Bobrovytsky,2016-07-15 18:27:05+00:00,['baf8fe202c1e212bbed3c73a6a63017eceb4a180'],2462,2684,5146,3241067,19,0.486486486,0.486486486,0,3132
45740c8bcc05fb5075dd663c81de1cfc69ee5f1b,0,Taras Bobrovytsky,2016-07-15 18:27:05+00:00,['6ee15fadedcac9d41f8ad660caf8d4a60267df8e'],2,88,90,3241157,3,,0,0,3132
609b80410ed96e6b840cf7259444289b39b6f44d,1,Taras Bobrovytsky,2016-07-15 23:26:18+00:00,['45740c8bcc05fb5075dd663c81de1cfc69ee5f1b'],483,364,847,3242004,106,0.5,0,0,3132
343bdad866e08e5ceb55d2d66db2953c279fd2c0,1,Tim Armstrong,2016-07-18 08:28:09-07:00,['609b80410ed96e6b840cf7259444289b39b6f44d'],136,937,1073,3243077,11,0.481012658,0.664556962,0.746835443,3132
2ab130aa0a0d8b974a618899d162cd1d1fbd765d,1,Tim Armstrong,2016-07-18 13:29:24-07:00,['343bdad866e08e5ceb55d2d66db2953c279fd2c0'],64,397,461,3243538,17,0.704402516,0.647798742,0.572327044,3134
2f0a8851b1431ee8ffabedd02ce4b2b659686ee6,1,Tim Armstrong,2016-07-19 12:29:45-07:00,['2ab130aa0a0d8b974a618899d162cd1d1fbd765d'],63,83,146,3243684,2,0.909090909,0.090909091,1,3134
3fbd9c3380d060c07cea3efa5a20fc81616516b1,1,Tim Armstrong,2016-07-19 20:29:54-07:00,['2f0a8851b1431ee8ffabedd02ce4b2b659686ee6'],4,3,7,3243691,1,,,,3134
bc8c55afcd24054ad57a61f878e4a4669c190bf0,1,Tim Armstrong,2016-07-19 23:30:02-07:00,['3fbd9c3380d060c07cea3efa5a20fc81616516b1'],41,84,125,3243816,11,0.789473684,0.894736842,0.894736842,3134
94730574192d905c8c4b44143f45335cdddb7071,0,Tim Armstrong,2016-07-20 02:30:09-07:00,['bc8c55afcd24054ad57a61f878e4a4669c190bf0'],2,17,19,3243835,2,0,1,0.363636364,3134
276376acac848b73c415b7c8fb95b64be451b967,1,Tim Armstrong,2016-07-20 18:30:25-07:00,['94730574192d905c8c4b44143f45335cdddb7071'],168,326,494,3244329,14,0.45,0.383333333,0.55,3134
48725753e51ce99b2c179979e5e7bb5f8e6efdba,0,Tim Armstrong,2016-07-20 21:30:33-07:00,['276376acac848b73c415b7c8fb95b64be451b967'],1,70,71,3244400,4,0,1,1,3135
65806e200e8c45ab465c9b0f6678bd2670688617,1,Tim Armstrong,2016-07-21 00:30:39-07:00,['48725753e51ce99b2c179979e5e7bb5f8e6efdba'],18,29,47,3244447,6,0.5,0.5,0.666666667,3135
b94f88a697e0bf989b2a5392e1bddc105195cbf4,0,Tim Armstrong,2016-07-21 08:30:51-07:00,['65806e200e8c45ab465c9b0f6678bd2670688617'],1,1,2,3244449,1,,,,3135
e2a70388f5e5aef3160470d1bc6ca03897238706,0,Tim Armstrong,2016-07-21 16:31:09-07:00,['b94f88a697e0bf989b2a5392e1bddc105195cbf4'],4,12,16,3244465,1,0.111111111,1,1,3135
72e3c147e9329b472667c1fa0baeb7c4160e927c,0,Tim Armstrong,2016-07-22 11:03:33-07:00,['e2a70388f5e5aef3160470d1bc6ca03897238706'],3,7,10,3244475,1,,,,3135
af8b187660cddba3ec7b4af772dfa2c760076c84,0,Tim Armstrong,2016-07-22 11:03:33-07:00,['72e3c147e9329b472667c1fa0baeb7c4160e927c'],6,18,24,3244499,2,0.5,0.5,0.5,3135
e0fb432b8261672ff567ec2dafe651c2a92c13ce,1,Tim Armstrong,2016-07-22 11:03:33-07:00,['af8b187660cddba3ec7b4af772dfa2c760076c84'],20,65,85,3244584,3,0.095238095,0.928571429,0.904761905,3135
55b43ba8c46c635ce94146c9606b25b286ab9f03,1,Tim Armstrong,2016-07-22 22:35:18-07:00,['e0fb432b8261672ff567ec2dafe651c2a92c13ce'],152,182,334,3244918,9,0,0,0,3135
bf27c542b67125fe559edc672c37f1a8218f65af,0,Internal Jenkins,2016-07-25 21:31:44+00:00,['55b43ba8c46c635ce94146c9606b25b286ab9f03'],1,1,2,3244920,1,,,,3135
fbed1c9789c1bee5cb82aacda5f42bb30a44b924,0,Sailesh Mukil,2016-07-25 22:15:53+00:00,['bf27c542b67125fe559edc672c37f1a8218f65af'],18,26,44,3244964,1,0.333333333,1,1,3135
45ff0f9e674f54b35afb2b5eced0d6ec346890d6,1,Internal Jenkins,2016-07-26 02:44:25+00:00,['fbed1c9789c1bee5cb82aacda5f42bb30a44b924'],14,509,523,3245487,13,0.378640777,0.524271845,0.475728155,3145
0ad935b63c23029bd4cac4beefde6b3b7c0e322b,1,Internal Jenkins,2016-07-26 21:44:37+00:00,['45ff0f9e674f54b35afb2b5eced0d6ec346890d6'],488,983,1471,3246958,12,0.59223301,1,0.86407767,3145
f60b2beb8d2a7383b41ea2a34f10f1732362c438,1,Internal Jenkins,2016-07-27 22:43:45+00:00,['0ad935b63c23029bd4cac4beefde6b3b7c0e322b'],10,14,24,3246982,1,,,1,3145
a7963e6b03f5dc21600ee148f8fb62cc6ac1df80,1,Internal Jenkins,2016-07-28 03:45:45+00:00,['f60b2beb8d2a7383b41ea2a34f10f1732362c438'],10,11,21,3247003,1,,,,3145
6fbd35fa8798cea9e3ba97cc2f6db4de499c02b7,1,Internal Jenkins,2016-07-28 04:35:11+00:00,['a7963e6b03f5dc21600ee148f8fb62cc6ac1df80'],67,21060,21127,3268130,28,0,0,0,3167
c1d70f814e777fed22e1804eeea12fc9adcb3163,1,Internal Jenkins,2016-07-28 04:56:57+00:00,['6fbd35fa8798cea9e3ba97cc2f6db4de499c02b7'],1,110,111,3268241,5,1,1,1,3169
2c9b4a9ba96e0b9629403a4f45d6a3fd9a13f82d,1,Internal Jenkins,2016-07-28 06:45:11+00:00,['c1d70f814e777fed22e1804eeea12fc9adcb3163'],27,152,179,3268420,3,0.296296296,0.345679012,0.962962963,3169
68e9eed814123d1ddd18da719916a8f549d1eefa,0,Internal Jenkins,2016-07-28 21:10:19+00:00,['2c9b4a9ba96e0b9629403a4f45d6a3fd9a13f82d'],15,20,35,3268455,1,0.333333333,0.333333333,1,3169
34bc6a72dbbb4fd00939c3177da4b8e9f525898b,0,Internal Jenkins,2016-07-28 21:33:41+00:00,['68e9eed814123d1ddd18da719916a8f549d1eefa'],1,1,2,3268457,1,,,,3169
a9971300e40e1004ef7800c15857988c486a34c4,0,Internal Jenkins,2016-07-28 23:24:55+00:00,['34bc6a72dbbb4fd00939c3177da4b8e9f525898b'],9,2,11,3268468,1,,,,3169
0e88f0d7aa3450c6bf036a6559827c5152bfcb03,1,Internal Jenkins,2016-07-29 02:49:50+00:00,['a9971300e40e1004ef7800c15857988c486a34c4'],0,1268,1268,3269736,2,1,1,1,3170
c77fb628f7f1c968e6fca8db6f3ec7d0efd372e6,1,Internal Jenkins,2016-07-29 05:16:23+00:00,['0e88f0d7aa3450c6bf036a6559827c5152bfcb03'],104,136,240,3269976,10,0.4,1,1,3170
857b94d03cf719da37d6bb95695c57944f004d36,1,Internal Jenkins,2016-07-29 21:36:50+00:00,['c77fb628f7f1c968e6fca8db6f3ec7d0efd372e6'],42,66,108,3270084,2,0,1,1,3170
904265ccb5c3f6b4b35a8f0638b1151dbe8fcd32,0,Internal Jenkins,2016-07-29 21:42:07+00:00,['857b94d03cf719da37d6bb95695c57944f004d36'],0,14,14,3270098,2,,,,3171
dd33e8fbae5de13c0c91a49a87d576a83cff36e4,0,Internal Jenkins,2016-07-29 21:48:07+00:00,['904265ccb5c3f6b4b35a8f0638b1151dbe8fcd32'],5,6,11,3270109,1,0,1,0,3171
36b4ea6f651e904a62f4f4f8cab8c05a8f1b20dd,1,Internal Jenkins,2016-07-29 23:57:50+00:00,['dd33e8fbae5de13c0c91a49a87d576a83cff36e4'],8,406,414,3270523,12,0.218390805,0.977011494,0.440613027,3172
b9f6392e848555da1697394f57c7e7be9bcb923f,1,Internal Jenkins,2016-07-30 03:59:29+00:00,['36b4ea6f651e904a62f4f4f8cab8c05a8f1b20dd'],10,10,20,3270543,1,,,,3172
ac1215fd3162bfda3eb87759b7098002837a1307,1,Internal Jenkins,2016-07-30 07:23:52+00:00,['b9f6392e848555da1697394f57c7e7be9bcb923f'],10,53,63,3270606,3,0,0.5,1,3172
8343656189d631491b7372a60e228c851b61165c,1,Alex Behm,2016-07-30 23:52:27+00:00,['ac1215fd3162bfda3eb87759b7098002837a1307'],360,501,861,3271467,18,0.726190476,0.94047619,0.25,3172
45d059855b4afc2d5730c5e7ecaed7141993f354,1,Matthew Jacobs,2016-08-05 22:45:18+00:00,['8343656189d631491b7372a60e228c851b61165c'],16,137,153,3271620,4,0.144927536,0.434782609,0.144927536,3172
17bf14417e3438d772b19111431453bdd537742a,1,Internal Jenkins,2016-08-06 00:31:23+00:00,['45d059855b4afc2d5730c5e7ecaed7141993f354'],169,243,412,3272032,5,0.75,0,0.111111111,3172
a46b731915bbe8c71f4f0ca7aacc839edebcf6c5,1,Internal Jenkins,2016-08-06 02:40:46+00:00,['17bf14417e3438d772b19111431453bdd537742a'],84,124,208,3272240,10,0.516129032,0.774193548,0,3172
7237241087dcee4ff2367d56c166257be859dea9,0,Internal Jenkins,2016-08-09 02:58:02+00:00,['a46b731915bbe8c71f4f0ca7aacc839edebcf6c5'],4,12,16,3272256,1,0,1,1,3172
ffa7829b70933932d1ba5dfad9b6dc18d04e10e0,1,Internal Jenkins,2016-08-09 08:19:41+00:00,['7237241087dcee4ff2367d56c166257be859dea9'],14128,19705,33833,3306089,1381,,,,3172
3e2411f3078314c03bbe9c9b225770aa1580fdc4,1,Internal Jenkins,2016-08-09 19:26:22+00:00,['ffa7829b70933932d1ba5dfad9b6dc18d04e10e0'],460,717,1177,3307266,29,1,1,1,3174
f35ce4613786514b021c6c163d6eadca5a858211,0,Internal Jenkins,2016-08-09 21:01:51+00:00,['3e2411f3078314c03bbe9c9b225770aa1580fdc4'],10,14,24,3307290,1,,,,3174
0d689d362624a7a6b588f1c0eaa4242684868a6d,0,Internal Jenkins,2016-08-10 02:21:22+00:00,['f35ce4613786514b021c6c163d6eadca5a858211'],0,1,1,3307291,1,,,,3174
b66829f15f5d3072ba56b966ef2ca21620a59390,0,Internal Jenkins,2016-08-10 04:09:38+00:00,['0d689d362624a7a6b588f1c0eaa4242684868a6d'],4,16,20,3307311,2,1,1,1,3174
9ca292a1cce53cfb81217da93f6489422dabf9b5,1,Internal Jenkins,2016-08-10 06:26:03+00:00,['b66829f15f5d3072ba56b966ef2ca21620a59390'],23,32,55,3307366,7,,,,3174
27b3b4d470c6309729faba0b3872abf85f716f78,1,Internal Jenkins,2016-08-10 10:07:16+00:00,['9ca292a1cce53cfb81217da93f6489422dabf9b5'],212,331,543,3307909,18,1,1,1,3177
b6934f0fcd4cafc737ee44d9676657406511c162,0,Internal Jenkins,2016-08-10 21:31:38+00:00,['27b3b4d470c6309729faba0b3872abf85f716f78'],2,2,4,3307913,1,,,,3177
16a50f79ee76936734bd7a8f80d5665428988247,0,Internal Jenkins,2016-08-10 22:48:47+00:00,['b6934f0fcd4cafc737ee44d9676657406511c162'],1,1,2,3307915,1,,,,3177
e6702c67309cae4b46da6de935bcf873800a2f3c,0,Internal Jenkins,2016-08-11 01:31:37+00:00,['16a50f79ee76936734bd7a8f80d5665428988247'],1,25,26,3307941,3,0,1,1,3177
ac4f22b1b0a68600884358d373fffbcd817f22b8,0,Internal Jenkins,2016-08-11 03:06:09+00:00,['e6702c67309cae4b46da6de935bcf873800a2f3c'],0,2,2,3307943,1,1,1,0,3177
88b89b872dbab6b13df2adbbb40704da96f987ac,1,Internal Jenkins,2016-08-11 04:33:01+00:00,['ac4f22b1b0a68600884358d373fffbcd817f22b8'],72,141,213,3308156,3,0.317073171,1,1,3177
286da59219f322ce99563537214e3bb30c0fa8c5,1,Internal Jenkins,2016-08-11 08:22:30+00:00,['88b89b872dbab6b13df2adbbb40704da96f987ac'],575,2145,2720,3310876,13,0.935483871,1,0.774193548,3179
5afd9f7df765006c067ef5f57d7f7431fe9e1247,1,Internal Jenkins,2016-08-11 08:42:41+00:00,['286da59219f322ce99563537214e3bb30c0fa8c5'],56,427,483,3311359,19,0.421568627,0.338235294,0.367647059,3181
9162d5d0544bf080da0a86331e9f77fc56803678,0,Tim Armstrong,2016-08-11 22:04:03+00:00,['5afd9f7df765006c067ef5f57d7f7431fe9e1247'],1,49,50,3311409,1,0.022727273,0.045454545,0.931818182,3181
457ee684c8baee7ab0deff49e07c0d8dd5da370d,1,Michael Ho,2016-08-12 00:58:27+00:00,['9162d5d0544bf080da0a86331e9f77fc56803678'],31,37,68,3311477,2,1,1,1,3181
1ed8ada663c67ee03c4cc471a0108156e38ef6e7,0,Internal Jenkins,2016-08-12 05:50:59+00:00,['457ee684c8baee7ab0deff49e07c0d8dd5da370d'],0,44349,44349,3355826,26,0.201413566,0.717521184,0.348236948,3207
fe97579fe805b34bdccf4569ac626d11801a4823,1,Internal Jenkins,2016-08-12 10:39:39+00:00,['1ed8ada663c67ee03c4cc471a0108156e38ef6e7'],5,96,101,3355927,3,0,1,1,3208
15d20d8f12ffd01a1da807ea003939f1ff24a7bb,1,Internal Jenkins,2016-08-15 20:32:35+00:00,['fe97579fe805b34bdccf4569ac626d11801a4823'],190,124,314,3356241,16,1,0.671428571,0.428571429,3208
f4da9251346129189806a969288f2f7c4532bbe5,1,Internal Jenkins,2016-08-15 23:33:57+00:00,['15d20d8f12ffd01a1da807ea003939f1ff24a7bb'],27,121,148,3356389,3,0.166666667,1,1,3208
6fc399ebc435121cdb7865ff4987aca1c95af5fc,1,Internal Jenkins,2016-08-15 23:41:08+00:00,['f4da9251346129189806a969288f2f7c4532bbe5'],0,4,4,3356393,2,0.333333333,1,0.666666667,3208
5ec76c618f50405c154ebe5587b6be5d4f8d234d,0,Internal Jenkins,2016-08-16 01:50:50+00:00,['6fc399ebc435121cdb7865ff4987aca1c95af5fc'],220,2,222,3356615,8,0.607361963,0.484662577,0.331288344,3208
be6a3bc1a0d51163c8fb9a295cdae9288498ac9d,1,Internal Jenkins,2016-08-16 02:04:09+00:00,['5ec76c618f50405c154ebe5587b6be5d4f8d234d'],0,318,318,3356933,1,1,1,1,3209
3307acfef084ec46820dc2c8c90395908fea7ec1,0,Internal Jenkins,2016-08-16 03:32:37+00:00,['be6a3bc1a0d51163c8fb9a295cdae9288498ac9d'],1,2,3,3356936,1,0,1,1,3209
5a55ba76108443fb7a136d6a48fb95840ab7e5e6,0,Internal Jenkins,2016-08-16 04:27:11+00:00,['3307acfef084ec46820dc2c8c90395908fea7ec1'],3,16,19,3356955,3,0.454545455,0,1,3209
3a630a5d6871db6afe9ca343aea80b14c6525f3d,1,Internal Jenkins,2016-08-16 06:08:50+00:00,['5a55ba76108443fb7a136d6a48fb95840ab7e5e6'],0,7,7,3356962,1,0,0,1,3209
90a6b3206e0b522650bfe21c5754c15d009f708c,1,Internal Jenkins,2016-08-16 11:54:04+00:00,['3a630a5d6871db6afe9ca343aea80b14c6525f3d'],2,7,9,3356971,2,0,0,1,3209
dd906a81d5d3b2fbddeb853fb4b7405d337a8a8f,0,Internal Jenkins,2016-08-17 00:35:17+00:00,['90a6b3206e0b522650bfe21c5754c15d009f708c'],1,1,2,3356973,1,,,,3209
532b1fe1186725b8e81fff93b59fc7cebf563c8b,1,Internal Jenkins,2016-08-18 03:25:16+00:00,['dd906a81d5d3b2fbddeb853fb4b7405d337a8a8f'],361,659,1020,3357993,29,1,0.7,1,3209
50e21247d60b9d33cb2601126a1af9231fc7e43b,1,Internal Jenkins,2016-08-18 03:37:48+00:00,['532b1fe1186725b8e81fff93b59fc7cebf563c8b'],1,5,6,3357999,2,0.75,0.75,1,3209
0983da92bad9407c864f884973f9530e0059036d,1,Internal Jenkins,2016-08-18 04:03:00+00:00,['50e21247d60b9d33cb2601126a1af9231fc7e43b'],23,54,77,3358076,4,0,0,1,3209
4d03ed40c6e9cce30f09ab111c4077c7c6329233,1,Internal Jenkins,2016-08-18 20:13:17+00:00,['0983da92bad9407c864f884973f9530e0059036d'],2,2,4,3358080,1,,,0,3209
0849827147b1b4d415b32c3a569946820347aa98,0,Internal Jenkins,2016-08-19 01:20:01+00:00,['4d03ed40c6e9cce30f09ab111c4077c7c6329233'],1,1,2,3358082,1,,,,3209
d113205ceea7d9134d2e4def9ddecdf942dd4c3e,1,Internal Jenkins,2016-08-19 02:14:39+00:00,['0849827147b1b4d415b32c3a569946820347aa98'],36,93,129,3358211,13,0,0.7,0.933333333,3209
7eb30309f3847f416f204bd5f7d6925102e94b67,1,Internal Jenkins,2016-08-19 05:36:02+00:00,['d113205ceea7d9134d2e4def9ddecdf942dd4c3e'],45,38,83,3358294,8,0.8,0.666666667,0.066666667,3209
1bbd667fd3bb647eed93ff74a9206ad403c1578b,1,Internal Jenkins,2016-08-19 05:40:01+00:00,['7eb30309f3847f416f204bd5f7d6925102e94b67'],1798,1782,3580,3361874,12,1,1,0,3209
f613dcd02da989204026999b26247a024fb199ab,1,Internal Jenkins,2016-08-19 06:04:18+00:00,['1bbd667fd3bb647eed93ff74a9206ad403c1578b'],0,262,262,3362136,4,1,1,1,3211
2aa86309d15cba8a965c83d81308e32df899ec8a,1,Internal Jenkins,2016-08-19 22:37:28+00:00,['f613dcd02da989204026999b26247a024fb199ab'],22,76,98,3362234,10,0.625,0.583333333,0.583333333,3211
02608f89f5ee3385ef63533eb012cb75690d0b5d,1,Internal Jenkins,2016-08-20 01:53:24+00:00,['2aa86309d15cba8a965c83d81308e32df899ec8a'],13,15,28,3362262,2,0.75,0,1,3211
1522da3510a36635e3fc694b26211554fcd2793a,0,Internal Jenkins,2016-08-20 03:03:10+00:00,['02608f89f5ee3385ef63533eb012cb75690d0b5d'],3,14,17,3362279,3,1,1,1,3211
1fc487c7dfab862ca88a8f6ae7790e3b004756a8,1,Internal Jenkins,2016-08-20 04:23:50+00:00,['1522da3510a36635e3fc694b26211554fcd2793a'],31,96,127,3362406,15,0.533333333,0,0.333333333,3212
6b5f9cf0f53d8a9b35182af81ffecb1351e8d477,0,Internal Jenkins,2016-08-21 02:48:52+00:00,['1fc487c7dfab862ca88a8f6ae7790e3b004756a8'],1,1,2,3362408,1,,,,3212
b251fb0615d2bcdaade93a5d939c7ab6bc64960c,1,Internal Jenkins,2016-08-21 23:39:34+00:00,['6b5f9cf0f53d8a9b35182af81ffecb1351e8d477'],2,2,4,3362412,1,,,,3212
b69e469e99e4b0c08bc4718eb55b041cf7c11ffe,1,Marcel Kornacker,2016-08-22 17:15:37+00:00,['b251fb0615d2bcdaade93a5d939c7ab6bc64960c'],10,96,106,3362518,6,1,1,1,3213
60935a921e433fab4e74bc7166bc41c3b946624c,0,Internal Jenkins,2016-08-23 05:35:45+00:00,['b69e469e99e4b0c08bc4718eb55b041cf7c11ffe'],6,6,12,3362530,1,,,,3213
8fb159889771ee81381d2aa679917fa3b6d530bd,0,Internal Jenkins,2016-08-23 09:00:06+00:00,['60935a921e433fab4e74bc7166bc41c3b946624c'],1,2,3,3362533,1,1,1,0,3213
deaccbb967138afacbe261e6e4fb81312688b09e,0,Internal Jenkins,2016-08-23 12:20:44+00:00,['8fb159889771ee81381d2aa679917fa3b6d530bd'],2,77,79,3362612,5,0.6875,0.6875,1,3214
c23bf38a201e400a98b2f8f34b5aec95fad27e2b,1,Sailesh Mukil,2016-08-23 18:25:06+00:00,['deaccbb967138afacbe261e6e4fb81312688b09e'],31,70,101,3362713,6,0.147058824,0.882352941,0.764705882,3214
9e438a08f1fa5761a88f0c9329bfedaeae3206d1,1,Internal Jenkins,2016-08-23 21:57:55+00:00,['c23bf38a201e400a98b2f8f34b5aec95fad27e2b'],130,278,408,3363121,15,0,0.988764045,0,3215
310edd5d0040b2848f68354091d311fe9ee1c822,1,Internal Jenkins,2016-08-24 03:09:32+00:00,['9e438a08f1fa5761a88f0c9329bfedaeae3206d1'],8,17,25,3363146,1,0.6,0,0,3215
211f60d8318859155b3f8f8043c7cae039d76bbc,0,Internal Jenkins,2016-08-24 03:34:01+00:00,['310edd5d0040b2848f68354091d311fe9ee1c822'],41,205,246,3363392,4,0,1,1,3215
1a430fe40c95b11cfaf5a3c940f369f2db93204f,0,Internal Jenkins,2016-08-25 00:43:05+00:00,['211f60d8318859155b3f8f8043c7cae039d76bbc'],0,53,53,3363445,1,,,,3215
58cf558fcd2e8e2b5c308282c31515b6b4e38cc9,1,Internal Jenkins,2016-08-25 01:43:31+00:00,['1a430fe40c95b11cfaf5a3c940f369f2db93204f'],3,15,18,3363463,1,0.333333333,0.333333333,0.888888889,3215
480efc90834a50fdbf72f16adba80adc894626b6,0,Internal Jenkins,2016-08-25 02:56:27+00:00,['58cf558fcd2e8e2b5c308282c31515b6b4e38cc9'],31,0,31,3363494,2,0.428571429,0.142857143,0.285714286,3215
34b5f1c416148f95a34324d66c1ebbf9585d1845,1,Internal Jenkins,2016-08-25 10:20:36+00:00,['480efc90834a50fdbf72f16adba80adc894626b6'],407,393,800,3364294,19,1,0.5,0.75,3215
05b19bb848d5c01f09715aa79c5858d7cca79b8a,1,Matthew Jacobs,2016-08-25 15:20:02+00:00,['34b5f1c416148f95a34324d66c1ebbf9585d1845'],1,166,167,3364461,3,1,1,1,3217
8cab36cf61aa315bc8d8fffa24ce73f9f64227ba,0,Tim Armstrong,2016-08-25 15:35:25+00:00,['05b19bb848d5c01f09715aa79c5858d7cca79b8a'],12,8,20,3364481,2,,,,3217
f5541d604046a9f47d1000c2ddc8f38a732c6456,1,Internal Jenkins,2016-08-25 20:23:04+00:00,['8cab36cf61aa315bc8d8fffa24ce73f9f64227ba'],182,337,519,3365000,8,1,0.269230769,0.942307692,3220
19a2dcfbec14f3d1ada8aec833462b8a48915df1,0,Internal Jenkins,2016-08-25 21:17:08+00:00,['f5541d604046a9f47d1000c2ddc8f38a732c6456'],0,13,13,3365013,1,,,,3221
f7bf59f5c4db6d7b897fcf159a98913de2da8122,1,Internal Jenkins,2016-08-25 21:33:00+00:00,['19a2dcfbec14f3d1ada8aec833462b8a48915df1'],51,378,429,3365442,6,0.31372549,0.509803922,0.666666667,3222
9f2c42ddc8ead58d96143cae27174b02c8c96aa0,0,Internal Jenkins,2016-08-26 02:04:28+00:00,['f7bf59f5c4db6d7b897fcf159a98913de2da8122'],0,1,1,3365443,1,,,,3222
c23dc3a53aaacfad11e6dfd825fcfa4c1ded7568,1,Internal Jenkins,2016-08-26 16:29:24+00:00,['9f2c42ddc8ead58d96143cae27174b02c8c96aa0'],6,39,45,3365488,6,0.136363636,1,1,3222
0e886618e26f8480aa8926918e7f80b7bada3884,1,Jim Apple,2016-08-26 17:20:10+00:00,['c23dc3a53aaacfad11e6dfd825fcfa4c1ded7568'],15,101,116,3365604,5,1,1,1,3222
2618766baa710d0b92362817b21076e8569c512c,0,Alex Behm,2016-08-26 23:21:19+00:00,['0e886618e26f8480aa8926918e7f80b7bada3884'],1,4,5,3365609,1,0,0,1,3222
d0ff27cc3a7a693ae412fcbf9f8f1709de013855,0,Internal Jenkins,2016-08-27 02:21:34+00:00,['2618766baa710d0b92362817b21076e8569c512c'],25,45,70,3365679,2,0,1,0,3222
d72353d0c9a563e69b34ba0cccdc6c1c8bf2630b,1,Matthew Jacobs,2016-08-29 16:44:22+00:00,['d0ff27cc3a7a693ae412fcbf9f8f1709de013855'],119,148,267,3365946,8,,,,3222
e453086171c8069222fb45d5b8372968590834af,0,Internal Jenkins,2016-08-30 01:06:59+00:00,['d72353d0c9a563e69b34ba0cccdc6c1c8bf2630b'],1,1,2,3365948,1,,,,3222
6bbb7fb3d24974a18c17c475b48d01c37013c204,0,Internal Jenkins,2016-08-30 02:15:35+00:00,['e453086171c8069222fb45d5b8372968590834af'],0,335,335,3366283,4,0.487179487,1,0.474358974,3226
12496c7fbf62e364f7c23d819185237a5b1b9f59,0,Internal Jenkins,2016-08-31 00:58:03+00:00,['6bbb7fb3d24974a18c17c475b48d01c37013c204'],22,81,103,3366386,4,0,0,0.9,3226
d3494d8e00d6d83ca33311217760abc95bee0921,0,Internal Jenkins,2016-08-31 01:09:15+00:00,['12496c7fbf62e364f7c23d819185237a5b1b9f59'],0,3,3,3366389,1,0,1,0,3226
33a35ea4f82beffa4663b98b6abb8252a126fa13,0,Tim Armstrong,2016-08-31 01:35:02+00:00,['d3494d8e00d6d83ca33311217760abc95bee0921'],1,1,2,3366391,1,,,,3226
df830901de416384c684b16a7ea80eb6483c35e3,0,Internal Jenkins,2016-08-31 03:12:30+00:00,['33a35ea4f82beffa4663b98b6abb8252a126fa13'],83,82,165,3366556,2,0.1,0,0,3226
ecd78fb67d240485c96d60e745c674e0157d9263,1,Internal Jenkins,2016-08-31 06:58:44+00:00,['df830901de416384c684b16a7ea80eb6483c35e3'],12,23,35,3366591,2,0,0.25,0.75,3226
5adedc6a1a623b4c7b81f4ba6d5019d74dbd05f2,1,Internal Jenkins,2016-08-31 09:59:00+00:00,['ecd78fb67d240485c96d60e745c674e0157d9263'],85,126,211,3366802,4,1,0,0,3226
1350c34763d52f703ad1e870abff64fae46d20fa,1,Internal Jenkins,2016-08-31 21:20:29+00:00,['5adedc6a1a623b4c7b81f4ba6d5019d74dbd05f2'],5,58,63,3366865,3,0,1,1,3226
24869d40fd6b68ae65f19f613626333a062da6b4,1,Internal Jenkins,2016-09-01 02:35:41+00:00,['1350c34763d52f703ad1e870abff64fae46d20fa'],102,310,412,3367277,11,0.316455696,0.506329114,0.974683544,3226
5f3ee38bf4106fe4beb24e4f5237047decead3fe,1,Internal Jenkins,2016-09-01 04:15:04+00:00,['24869d40fd6b68ae65f19f613626333a062da6b4'],31,61,92,3367369,1,0,0,0,3226
2cd752461f69578694bd8be2bde137b5595b8bed,1,Harrison Sheinblatt,2016-09-01 05:01:03+00:00,['5f3ee38bf4106fe4beb24e4f5237047decead3fe'],1,1,2,3367371,1,,,,3226
a60ba6d2743eee5f2e5c5c3f1baa375ede0195e5,1,Tim Armstrong,2016-09-01 21:26:52+00:00,['2cd752461f69578694bd8be2bde137b5595b8bed'],203,209,412,3367783,8,,,,3226
20ef3b016e69db3d508b4dd615ee07b41b2cf336,0,Internal Jenkins,2016-09-02 01:47:08+00:00,['a60ba6d2743eee5f2e5c5c3f1baa375ede0195e5'],14,44,58,3367841,4,0.6,1,1,3226
ea7f158877bab927c5784027d941ffde78a8f113,0,Internal Jenkins,2016-09-02 02:12:45+00:00,['20ef3b016e69db3d508b4dd615ee07b41b2cf336'],0,9,9,3367850,1,,,,3227
16f1c8d8de0ad33e52524fd4761e7728852c27cc,0,Internal Jenkins,2016-09-02 02:19:52+00:00,['ea7f158877bab927c5784027d941ffde78a8f113'],16,9,25,3367875,4,,,,3227
ab9e54bc4298549048b1935837e8e818d5b980ce,1,Internal Jenkins,2016-09-02 02:47:02+00:00,['16f1c8d8de0ad33e52524fd4761e7728852c27cc'],736,562,1298,3369173,13,0,0,0,3227
052d3cc8dd893f2225accacde3c917aac0c1cfcd,1,Internal Jenkins,2016-09-02 20:11:27+00:00,['ab9e54bc4298549048b1935837e8e818d5b980ce'],22,22,44,3369217,4,0,1,1,3227
c8f3d40efcf2a192833a9e44da36652ae3283f82,0,Internal Jenkins,2016-09-03 00:39:07+00:00,['052d3cc8dd893f2225accacde3c917aac0c1cfcd'],135,91,226,3369443,2,0,0,0,3227
1909ce2d7d62627ddaf1df6511b54a20b699bb34,0,Internal Jenkins,2016-09-03 00:53:34+00:00,['c8f3d40efcf2a192833a9e44da36652ae3283f82'],31,79,110,3369553,2,0.538461538,1,1,3227
b35689d7d9a32029fd0766c5a140dbaf58177f8e,0,Internal Jenkins,2016-09-05 15:17:22+00:00,['1909ce2d7d62627ddaf1df6511b54a20b699bb34'],2,2,4,3369557,2,,,,3227
39e01abcf38bafaa03810fdbfd743a1558db92d8,0,Internal Jenkins,2016-09-07 01:35:30+00:00,['b35689d7d9a32029fd0766c5a140dbaf58177f8e'],57,245,302,3369859,1,0.710280374,0.551401869,1,3227
7194b28029227be0188697cc590b0a0b9e31a31f,1,Internal Jenkins,2016-09-07 07:22:15+00:00,['39e01abcf38bafaa03810fdbfd743a1558db92d8'],98,114,212,3370071,12,0,0.4,0,3227
25fe78291b72054d1447fe4ac089c3d683bcf668,0,Henry Robinson,2016-09-07 18:39:27+00:00,['7194b28029227be0188697cc590b0a0b9e31a31f'],82,354,436,3370507,3,,,,3227
94ef5b19b9c6f8599ae1787c2d085b54f562689f,1,Internal Jenkins,2016-09-07 23:33:36+00:00,['25fe78291b72054d1447fe4ac089c3d683bcf668'],18,5,23,3370530,2,0,0,1,3227
157c80056c62c89193a04d147d8c94fcb58610c4,1,Internal Jenkins,2016-09-08 01:50:51+00:00,['94ef5b19b9c6f8599ae1787c2d085b54f562689f'],1185,522,1707,3372237,25,0.987593052,0.518610422,0.153846154,3227
f0ffbca2c36ce3ad8ea5b3629d91e6b579d7dfcf,0,Internal Jenkins,2016-09-08 03:25:29+00:00,['157c80056c62c89193a04d147d8c94fcb58610c4'],40,26,66,3372303,2,0.142857143,0,0,3227
8c37bf35438aa827f092d99d6cff83ce1ed83fbb,0,Internal Jenkins,2016-09-08 04:31:27+00:00,['f0ffbca2c36ce3ad8ea5b3629d91e6b579d7dfcf'],55,34,89,3372392,2,0.25,0,0,3227
faebfebdfd227b8f72055e60e13ac8726eafc8fc,1,Alex Behm,2016-09-08 04:34:52+00:00,['8c37bf35438aa827f092d99d6cff83ce1ed83fbb'],1474,1837,3311,3375703,31,0.6,0.72,1,3231
37a2ba2553dae5bf647346cbd5d2cc286b1bdefe,0,Internal Jenkins,2016-09-09 02:40:47+00:00,['faebfebdfd227b8f72055e60e13ac8726eafc8fc'],27,38,65,3375768,2,0,0.5,1,3231
d153d181661e47cb9deffabaf356b7fcc2e77cb5,0,Internal Jenkins,2016-09-09 23:07:35+00:00,['37a2ba2553dae5bf647346cbd5d2cc286b1bdefe'],131,0,131,3375899,1,0.891566265,0,0.891566265,3231
7b4a6fac1acf16fb84b38a005f69c228620ddb3f,1,Internal Jenkins,2016-09-10 00:50:31+00:00,['d153d181661e47cb9deffabaf356b7fcc2e77cb5'],7,21,28,3375927,2,0,1,0.875,3231
218019e59fc6740e1564c91516b0dee46c64ed83,1,Internal Jenkins,2016-09-10 01:28:00+00:00,['7b4a6fac1acf16fb84b38a005f69c228620ddb3f'],106,59,165,3376092,6,1,1,0.1,3231
f9ac593ff9a9ea3a5b329eed618500c45a1e7400,1,Internal Jenkins,2016-09-11 00:36:12+00:00,['218019e59fc6740e1564c91516b0dee46c64ed83'],26,1439,1465,3377557,13,0.371118012,0.742236025,0.827639752,3239
13fc14d8a9c2d80392b706d3c3396b4abe3e12ad,0,Tim Armstrong,2016-09-12 17:07:29+00:00,['f9ac593ff9a9ea3a5b329eed618500c45a1e7400'],0,27,27,3377584,1,1,1,0.631578947,3239
78e129c923b92eebf272ff643711b05b5961b9ea,0,Internal Jenkins,2016-09-12 21:15:35+00:00,['13fc14d8a9c2d80392b706d3c3396b4abe3e12ad'],1,1,2,3377586,1,,,,3239
f3f72fa0e130aa8ac5f6cc57ae3385811c81b6f8,1,Jim Apple,2016-09-13 01:44:35+00:00,['78e129c923b92eebf272ff643711b05b5961b9ea'],3,5,8,3377594,1,,,,3239
f9bcb91a0217867db70a00fbf53a1f5d7aa390bf,0,Internal Jenkins,2016-09-13 02:10:07+00:00,['f3f72fa0e130aa8ac5f6cc57ae3385811c81b6f8'],30,32,62,3377656,2,,,,3239
94fc6a3d07aaf19591b832d4fc88eee831db9f99,0,Internal Jenkins,2016-09-13 03:40:02+00:00,['f9bcb91a0217867db70a00fbf53a1f5d7aa390bf'],25,45,70,3377726,1,0,0,1,3239
64ffbc4b5112b21e738a16218cb396c9b65ff70d,0,Matthew Jacobs,2016-09-13 20:28:27+00:00,['94fc6a3d07aaf19591b832d4fc88eee831db9f99'],20,343,363,3378089,9,0.042253521,0.276995305,0.708920188,3240
6c446b35b951ba27b4a458c23f408379495f85ff,0,Internal Jenkins,2016-09-13 21:36:28+00:00,['64ffbc4b5112b21e738a16218cb396c9b65ff70d'],33,19,52,3378141,4,0,0,0.555555556,3240
d379875806daed018cdbc93f82d21c85ea5b212a,0,Internal Jenkins,2016-09-13 21:57:36+00:00,['6c446b35b951ba27b4a458c23f408379495f85ff'],35,20,55,3378196,3,0,0,0,3240
0c874189ed902d566b3df37959c937ff6a7bfee8,0,Internal Jenkins,2016-09-14 00:24:06+00:00,['d379875806daed018cdbc93f82d21c85ea5b212a'],7,23,30,3378226,2,,,,3240
01b8ade668818bb49a53b3d434c5a3b436a4c2c9,1,Internal Jenkins,2016-09-14 03:04:18+00:00,['0c874189ed902d566b3df37959c937ff6a7bfee8'],279,270,549,3378775,8,1,1,0,3240
f4bbd415e8f0632661937e72da815332a27e412e,1,Internal Jenkins,2016-09-14 04:13:28+00:00,['01b8ade668818bb49a53b3d434c5a3b436a4c2c9'],419,167,586,3379361,73,0,0,0,3240
aa28e37eb7df9a53dbcf7aabe910095681dd3a51,1,Jim Apple,2016-09-14 14:42:23+00:00,['f4bbd415e8f0632661937e72da815332a27e412e'],0,191,191,3379552,2,,,,3242
bd2947329ef252a9355c4cf9da32a9c7eb55881b,0,Internal Jenkins,2016-09-14 22:09:24+00:00,['aa28e37eb7df9a53dbcf7aabe910095681dd3a51'],1648838,1285,1650123,5029675,282,0.744065282,0.729228487,0.744065282,3242
c7fa03286b473a34cdb170f8c89c261fb02d17a6,1,Internal Jenkins,2016-09-14 22:11:04+00:00,['bd2947329ef252a9355c4cf9da32a9c7eb55881b'],78,341,419,5030094,19,0.736842105,0.842105263,0.842105263,3242
a42d18dcc316ac2dbc32edcc2774272f0bdf469c,1,Internal Jenkins,2016-09-15 00:02:22+00:00,['c7fa03286b473a34cdb170f8c89c261fb02d17a6'],59,176,235,5030329,4,0.672727273,1,0.672727273,3243
9b3f43b9fd006fe5d72281b0862abe42e0a0a061,0,Internal Jenkins,2016-09-15 21:46:45+00:00,['a42d18dcc316ac2dbc32edcc2774272f0bdf469c'],4,9,13,5030342,2,0,1,1,3243
32199105f7ed0ba9339464fcd6a8f6c8957bc5e5,0,Internal Jenkins,2016-09-16 00:14:15+00:00,['9b3f43b9fd006fe5d72281b0862abe42e0a0a061'],6,9,15,5030357,3,,,,3243
6e4064d9420dc8300d43365fff9745a330c01523,0,Internal Jenkins,2016-09-16 00:38:16+00:00,['32199105f7ed0ba9339464fcd6a8f6c8957bc5e5'],10,0,10,5030367,1,,,,3243
a301ff4a5639102c17d9227571863a675b078f5e,0,Internal Jenkins,2016-09-16 01:44:36+00:00,['6e4064d9420dc8300d43365fff9745a330c01523'],1,1,2,5030369,1,,,,3243
3904d3091dbbeb5c75c1154736955970a99350d7,1,Sailesh Mukil,2016-09-16 06:40:27+00:00,['a301ff4a5639102c17d9227571863a675b078f5e'],18,36,54,5030423,2,,,,3243
e3abf84cce0dcc5fc5817688b9500b652550019d,1,Internal Jenkins,2016-09-16 07:37:36+00:00,['3904d3091dbbeb5c75c1154736955970a99350d7'],24,83,107,5030530,4,1,1,1,3244
1e33d04e52d71fc7de3417fad629abfd94e43b31,1,Jim Apple,2016-09-16 16:44:46+00:00,['e3abf84cce0dcc5fc5817688b9500b652550019d'],1,1,2,5030532,1,,,,3244
0f188636d029c19b06a23f60ba63b47f4cd2d866,0,Internal Jenkins,2016-09-16 20:37:55+00:00,['1e33d04e52d71fc7de3417fad629abfd94e43b31'],4,19,23,5030555,1,1,1,1,3244
57210ecd5eff1d51a780d832632ae451049d91d8,0,Internal Jenkins,2016-09-17 06:13:17+00:00,['0f188636d029c19b06a23f60ba63b47f4cd2d866'],31,70,101,5030656,7,,,,3244
3be61f902425a026a5f29f6943f9d236f77f58b4,1,Internal Jenkins,2016-09-19 23:39:33+00:00,['57210ecd5eff1d51a780d832632ae451049d91d8'],1,1,2,5030658,1,,,,3244
19de09ab7db4498fa3dd6e0775e32581139dd336,1,Henry Robinson,2016-09-20 23:50:43+00:00,['3be61f902425a026a5f29f6943f9d236f77f58b4'],4376,165,4541,5035199,76,0.706976744,0.566860465,0.213372093,3244
3aa43516252fe4e75176ab62cb6ce1f04938a96e,0,Internal Jenkins,2016-09-21 01:24:53+00:00,['19de09ab7db4498fa3dd6e0775e32581139dd336'],25,42,67,5035266,2,1,0,0,3244
cd6d86b83078290c62c2d92b071a15ec19bbeb4f,0,Internal Jenkins,2016-09-21 03:08:02+00:00,['3aa43516252fe4e75176ab62cb6ce1f04938a96e'],1,78,79,5035345,4,0.21875,0.96875,0.96875,3245
a8a5f6583ca4bf8a3d90d98b9dfb439fdedc9f8d,1,Internal Jenkins,2016-09-21 22:04:44+00:00,['cd6d86b83078290c62c2d92b071a15ec19bbeb4f'],3,4,7,5035352,2,0,1,1,3245
57fcbf7a28339e55a344dece10d87d16631939fa,1,Internal Jenkins,2016-09-22 02:00:50+00:00,['a8a5f6583ca4bf8a3d90d98b9dfb439fdedc9f8d'],42,46,88,5035440,6,,,,3245
1b9d9ea7c151c35b034b5e2097017794849a1b7b,1,Internal Jenkins,2016-09-22 02:10:32+00:00,['57fcbf7a28339e55a344dece10d87d16631939fa'],25,2,27,5035467,1,,,,3245
d76a2b2272ea4b2d2b9e5636c7f4e2e8da18961c,1,Internal Jenkins,2016-09-22 05:19:26+00:00,['1b9d9ea7c151c35b034b5e2097017794849a1b7b'],850,1015,1865,5037332,5,0.666666667,0.666666667,0.666666667,3247
0d0c93ec8c4949940ec113192731f2adb66a0c5e,1,Internal Jenkins,2016-09-22 10:07:52+00:00,['d76a2b2272ea4b2d2b9e5636c7f4e2e8da18961c'],104,227,331,5037663,7,0.541666667,0.895833333,1,3247
2465539dc15ffe51a8b424dad6aee65fa1a72d98,1,Henry Robinson,2016-09-23 05:57:44+00:00,['0d0c93ec8c4949940ec113192731f2adb66a0c5e'],14,12,26,5037689,1,1,1,1,3247
d83783e2464a50b04cec7a3df774306af5a62cdd,1,Internal Jenkins,2016-09-23 20:33:24+00:00,['2465539dc15ffe51a8b424dad6aee65fa1a72d98'],1,1,2,5037691,1,,,,3247
9313dcdb830b0cd24479ca892988d17defc9ca19,1,Internal Jenkins,2016-09-24 02:48:46+00:00,['d83783e2464a50b04cec7a3df774306af5a62cdd'],104,407,511,5038202,14,0.673469388,0.557823129,0.761904762,3248
435aec5489338d35c64e6aaa748fd6cad8283215,0,Internal Jenkins,2016-09-24 03:58:38+00:00,['9313dcdb830b0cd24479ca892988d17defc9ca19'],2,46,48,5038250,3,1,1,0.666666667,3248
872d5462b9a17d9f2d9edeb08728e29d6eb6eca6,0,Internal Jenkins,2016-09-26 22:07:17+00:00,['435aec5489338d35c64e6aaa748fd6cad8283215'],38,65,103,5038353,4,0.571428571,1,0.857142857,3248
f5c7668f9ea603f85dbeff13b4ef8f18f39f01a9,0,Taras Bobrovytsky,2016-09-27 18:14:42+00:00,['872d5462b9a17d9f2d9edeb08728e29d6eb6eca6'],20,139,159,5038512,4,0.4,0.844444444,0.866666667,3249
4849e5868e959f87db7a874a77c7f2b5711fc7b1,1,Internal Jenkins,2016-09-27 19:57:44+00:00,['f5c7668f9ea603f85dbeff13b4ef8f18f39f01a9'],119,135,254,5038766,7,0,1,0.833333333,3249
6cc296ec85a4260446333f89b1f5df0d7bd1ec95,1,Internal Jenkins,2016-09-27 20:20:17+00:00,['4849e5868e959f87db7a874a77c7f2b5711fc7b1'],175,349,524,5039290,13,0,0.5,0.8125,3249
4d9c261d6dee05b0fa29bf2f7535f0a6a5d7909b,0,Internal Jenkins,2016-09-27 22:23:12+00:00,['6cc296ec85a4260446333f89b1f5df0d7bd1ec95'],1,1,2,5039292,1,,,,3249
0780d2c8af56f5439ad482319e4dd7f106e38047,1,Taras Bobrovytsky,2016-09-27 22:24:59+00:00,['4d9c261d6dee05b0fa29bf2f7535f0a6a5d7909b'],24,121,145,5039437,5,0.896551724,0.5,0.551724138,3249
b5b848f373f90fef674e666c29ca54c6ccb54858,0,Taras Bobrovytsky,2016-09-27 22:47:21+00:00,['0780d2c8af56f5439ad482319e4dd7f106e38047'],2,72,74,5039511,2,0,1,0.962962963,3250
b7d107a6921d6c0f3a60abb3c20a0bf86656f700,0,Internal Jenkins,2016-09-28 04:22:51+00:00,['b5b848f373f90fef674e666c29ca54c6ccb54858'],1,2,3,5039514,1,0,1,1,3250
1ccd83b2d0cf60c3b711a5d9bd758438ab846150,1,Internal Jenkins,2016-09-28 23:07:37+00:00,['b7d107a6921d6c0f3a60abb3c20a0bf86656f700'],1498,2272,3770,5043284,27,0.694533762,1,1,3253
9cee2b5f1376ad6286ed65edffe6d152a0012cf1,0,Internal Jenkins,2016-09-28 23:09:28+00:00,['1ccd83b2d0cf60c3b711a5d9bd758438ab846150'],12,11,23,5043307,2,0,0,0,3253
241c7e01978f180012453b0a4ff6d061ca6d5093,1,Internal Jenkins,2016-09-28 23:38:20+00:00,['9cee2b5f1376ad6286ed65edffe6d152a0012cf1'],70,934,1004,5044311,8,0.46124031,1,0.82751938,3255
a35e4380966346b47a81eeb2500e01bf97fa8f95,1,Internal Jenkins,2016-09-29 02:10:17+00:00,['241c7e01978f180012453b0a4ff6d061ca6d5093'],78,124,202,5044513,2,0,0.96969697,0.96969697,3255
a5e84ac01491f8cca8a229c4348a23ae87ddca61,1,Internal Jenkins,2016-09-29 07:45:19+00:00,['a35e4380966346b47a81eeb2500e01bf97fa8f95'],0,44,44,5044557,1,,,,3255
b544f019aabc1d3aee4368966be8dab478a28f03,0,Internal Jenkins,2016-09-29 21:13:52+00:00,['a5e84ac01491f8cca8a229c4348a23ae87ddca61'],0,0,0,5044557,370,,,,3255
b2c2fe7813cbde794acc3dcf9c1d9e937683be72,1,Internal Jenkins,2016-09-29 21:14:13+00:00,['b544f019aabc1d3aee4368966be8dab478a28f03'],2864,2864,5728,5050285,441,,,,3255
f640b3a392dd954f65ab73be14b3670ae57ace29,0,Internal Jenkins,2016-09-29 22:29:37+00:00,['b2c2fe7813cbde794acc3dcf9c1d9e937683be72'],0,1,1,5050286,1,,,,3255
2a31fbdbfac9a7092c96e4ab9894e0db0e4ce9ca,1,Internal Jenkins,2016-09-30 01:21:05+00:00,['f640b3a392dd954f65ab73be14b3670ae57ace29'],7,39,46,5050332,5,1,1,1,3255
705045021ed1f53cdfeabf0dcc01b76144e54855,1,Internal Jenkins,2016-09-30 06:16:07+00:00,['2a31fbdbfac9a7092c96e4ab9894e0db0e4ce9ca'],67,221,288,5050620,6,0.216216216,0.972972973,0.945945946,3256
757c68b29e21e64fc4586cdf24ee6f9369be460f,1,Internal Jenkins,2016-09-30 10:24:13+00:00,['705045021ed1f53cdfeabf0dcc01b76144e54855'],266,505,771,5051391,32,0.875,0.647727273,0.636363636,3259
64c394827ab6f88e39545dc6c7b4ab1e5bb00c91,0,Internal Jenkins,2016-10-01 01:42:21+00:00,['757c68b29e21e64fc4586cdf24ee6f9369be460f'],1,10,11,5051402,4,,,,3259
886e26d58fd0b7ac3d3ffb277b330cc061835c29,0,Internal Jenkins,2016-10-04 01:19:01+00:00,['64c394827ab6f88e39545dc6c7b4ab1e5bb00c91'],95,0,95,5051497,1,,,,3259
8a08850fd42d516c5527899f295222f7c75ad721,0,Internal Jenkins,2016-10-04 03:52:48+00:00,['886e26d58fd0b7ac3d3ffb277b330cc061835c29'],1,1,2,5051499,1,,,,3259
e6593378716138583328f64afb27f926223aad5e,0,Internal Jenkins,2016-10-04 18:49:50+00:00,['8a08850fd42d516c5527899f295222f7c75ad721'],2,6,8,5051507,1,,,,3259
112ff68eddde5e29bacf31170741ee7746c0cbb8,0,Internal Jenkins,2016-10-05 03:04:17+00:00,['e6593378716138583328f64afb27f926223aad5e'],1,25,26,5051533,2,,,,3259
3be113cb9fd6460a80b8198a50f3619c4b9539a2,0,Internal Jenkins,2016-10-05 03:29:03+00:00,['112ff68eddde5e29bacf31170741ee7746c0cbb8'],3,4,7,5051540,1,,,,3259
5d9f5be6e398a4014856db8d1608d2089345c22a,1,Internal Jenkins,2016-10-05 22:55:36+00:00,['3be113cb9fd6460a80b8198a50f3619c4b9539a2'],13,16,29,5051569,1,,,,3259
a9b9933b5f059bd908291fd94d6f6f4fb88eeb7a,1,Internal Jenkins,2016-10-06 00:20:36+00:00,['5d9f5be6e398a4014856db8d1608d2089345c22a'],530,1525,2055,5053624,30,0.211129296,0.638297872,0.82487725,3259
08636ace0f1f569a4256b598685dd8e5fdda0d87,0,Internal Jenkins,2016-10-06 00:23:30+00:00,['a9b9933b5f059bd908291fd94d6f6f4fb88eeb7a'],0,10,10,5053634,1,,,,3259
485022a89921592fdaa12deffe27923832103d84,0,Internal Jenkins,2016-10-06 03:30:04+00:00,['08636ace0f1f569a4256b598685dd8e5fdda0d87'],376,0,376,5054010,2,0.678414097,0.334801762,0.334801762,3259
2b5d1344c9a0a86807a54c7bdaa643c531a52054,1,Internal Jenkins,2016-10-06 04:06:38+00:00,['485022a89921592fdaa12deffe27923832103d84'],57,78,135,5054145,4,0,0,1,3259
d9dc9090ea45220dc07dda3e171574828c1c0828,0,Internal Jenkins,2016-10-07 03:36:43+00:00,['2b5d1344c9a0a86807a54c7bdaa643c531a52054'],5,6,11,5054156,2,0,0,0,3259
acb25a6d164a5c1de0c2188ebdb1fd508d0a07f2,1,Internal Jenkins,2016-10-07 05:59:50+00:00,['d9dc9090ea45220dc07dda3e171574828c1c0828'],3,202,205,5054361,2,1,1,1,3259
50b2b888cd9053c013d4c2e5c34f0107e0d44036,0,Taras Bobrovytsky,2016-10-07 19:59:38+00:00,['acb25a6d164a5c1de0c2188ebdb1fd508d0a07f2'],21,30,51,5054412,1,0,0,1,3259
b0f5e0a5d0e0abd9b2fccf04e1851ed2c46bd23f,0,Taras Bobrovytsky,2016-10-07 22:18:30+00:00,['50b2b888cd9053c013d4c2e5c34f0107e0d44036'],6,189,195,5054607,4,0.536231884,0.884057971,0.739130435,3261
a9c40595549bfb74d2b9796a0a7098361793492e,1,Henry Robinson,2016-10-07 22:27:57+00:00,['b0f5e0a5d0e0abd9b2fccf04e1851ed2c46bd23f'],14,545,559,5055166,8,0.322709163,0.175298805,0.80876494,3263
3eb051f6f6f2dc7697380896bbec87f1db799d76,0,Internal Jenkins,2016-10-09 02:15:23+00:00,['a9c40595549bfb74d2b9796a0a7098361793492e'],2,27,29,5055195,2,,,,3263
3e23e40504000dd896fc1862809b659e41d468c1,0,Internal Jenkins,2016-10-12 00:06:51+00:00,['3eb051f6f6f2dc7697380896bbec87f1db799d76'],577,0,577,5055772,3,0.584745763,0.237288136,0.406779661,3263
b28baa4a038e78b7d3ba26c50b78d9b28cf901a9,0,Internal Jenkins,2016-10-12 08:37:30+00:00,['3e23e40504000dd896fc1862809b659e41d468c1'],3,7,10,5055782,1,0,0,1,3263
0449b5beaba89b02e8bc7fe133b4dc5fbe33fe81,1,Internal Jenkins,2016-10-12 09:22:57+00:00,['b28baa4a038e78b7d3ba26c50b78d9b28cf901a9'],1,65,66,5055848,6,0,0.95,0.05,3266
ef4c9958d018ae0b86cd4318e3288af6a2181c7c,0,Internal Jenkins,2016-10-13 00:40:41+00:00,['0449b5beaba89b02e8bc7fe133b4dc5fbe33fe81'],60,56,116,5055964,34,0,1,1,3266
f2780b567b33c9f57ffeefbf82a41d67cd0bb14d,0,Internal Jenkins,2016-10-13 01:28:10+00:00,['ef4c9958d018ae0b86cd4318e3288af6a2181c7c'],0,4,4,5055968,1,0,0,0,3266
0b3efb19cc0d971a47d0b7d7928a2d311c13e65a,0,Internal Jenkins,2016-10-13 04:31:42+00:00,['f2780b567b33c9f57ffeefbf82a41d67cd0bb14d'],3,6,9,5055977,1,0,0,1,3266
75a857c0ceb6a58691ff45f0df8d88586edc8acd,1,Internal Jenkins,2016-10-13 05:45:47+00:00,['0b3efb19cc0d971a47d0b7d7928a2d311c13e65a'],158,176,334,5056311,4,,,,3266
67a0451e3b9422681cc78bad6886f130a89fef30,0,Internal Jenkins,2016-10-13 21:25:06+00:00,['75a857c0ceb6a58691ff45f0df8d88586edc8acd'],3,2,5,5056316,1,,,,3266
89b41c68c180a96c4e34abfbe12f686d2461a7a3,0,Jim Apple,2016-10-14 00:08:17+00:00,['67a0451e3b9422681cc78bad6886f130a89fef30'],14,35,49,5056365,1,,,,3266
c7fe4385d927509443a1c4e2c6e9a802d2dcf63b,1,Internal Jenkins,2016-10-14 02:53:59+00:00,['89b41c68c180a96c4e34abfbe12f686d2461a7a3'],368,382,750,5057115,19,1,1,0,3266
47b8aa3a9e7682ebb182696901916900d3323039,1,Internal Jenkins,2016-10-14 03:02:35+00:00,['c7fe4385d927509443a1c4e2c6e9a802d2dcf63b'],123,175,298,5057413,2,0.384615385,1,1,3266
2a04b0e21a763e3d1f4269e7a8c3027ff0cab934,1,Internal Jenkins,2016-10-14 05:41:22+00:00,['47b8aa3a9e7682ebb182696901916900d3323039'],2,29,31,5057444,3,0,0,1,3266
784716f776492ed648833f2717b3784900b6f090,1,Internal Jenkins,2016-10-14 06:07:46+00:00,['2a04b0e21a763e3d1f4269e7a8c3027ff0cab934'],0,80,80,5057524,1,,,,3267
db5de41a808d0e177ac0089ead2e420ab6043d1d,1,Internal Jenkins,2016-10-14 07:44:23+00:00,['784716f776492ed648833f2717b3784900b6f090'],60,209,269,5057793,2,0,0.097560976,1,3267
1a5c43ef5e1f66a3b64fe2e2c382605337aaaab9,1,Internal Jenkins,2016-10-14 22:04:30+00:00,['db5de41a808d0e177ac0089ead2e420ab6043d1d'],388,394,782,5058575,23,0,0,1,3267
a1c9cb364655d0a65c4b00cb37757d55fc3131a1,0,Internal Jenkins,2016-10-15 00:43:56+00:00,['1a5c43ef5e1f66a3b64fe2e2c382605337aaaab9'],0,7,7,5058582,2,0,1,1,3267
7fad3e5dc38c1097db6be24da0cda6941f554150,1,Internal Jenkins,2016-10-15 01:25:51+00:00,['a1c9cb364655d0a65c4b00cb37757d55fc3131a1'],7,63,70,5058652,5,0.954545455,0.954545455,0.954545455,3268
ca3fd401be827680444590fbdf7c1b723434f2c5,1,Internal Jenkins,2016-10-15 02:49:58+00:00,['7fad3e5dc38c1097db6be24da0cda6941f554150'],2,8,10,5058662,2,1,1,1,3268
05b91a973c3aa23ef049761ef6d240482bb86c11,0,Internal Jenkins,2016-10-15 04:05:04+00:00,['ca3fd401be827680444590fbdf7c1b723434f2c5'],4,10,14,5058676,1,,,,3268
9f61397fc4d638aa78b37db2cd5b9c35b6deed94,1,Henry Robinson,2016-10-16 15:55:29+00:00,['05b91a973c3aa23ef049761ef6d240482bb86c11'],910,3831,4741,5063417,74,1,1,0,3272
b0e87c685d96e4e55a0fda3b23c10fc069f7551a,1,Internal Jenkins,2016-10-16 23:36:10+00:00,['9f61397fc4d638aa78b37db2cd5b9c35b6deed94'],312,402,714,5064131,26,1,1,1,3272
04802535661979c50e5d06ef04e62eee677b901e,1,Internal Jenkins,2016-10-17 09:22:57+00:00,['b0e87c685d96e4e55a0fda3b23c10fc069f7551a'],34,450,484,5064615,10,0.184210526,0.631578947,0.868421053,3273
ef762b73a1ddb8842bb5bac5bfed733b9a71fc1b,1,Internal Jenkins,2016-10-17 22:19:06+00:00,['04802535661979c50e5d06ef04e62eee677b901e'],3,14,17,5064632,1,,,,3273
07da7679d1755ada836706f752d8078260a76244,0,Internal Jenkins,2016-10-18 02:53:16+00:00,['ef762b73a1ddb8842bb5bac5bfed733b9a71fc1b'],84,929,1013,5065645,13,0.259911894,0.616740088,0.418502203,3278
e3a08914451a63fe65e8f66afc743739f4570ba4,1,Internal Jenkins,2016-10-18 04:48:43+00:00,['07da7679d1755ada836706f752d8078260a76244'],32,102,134,5065779,5,0,0.9,0.6,3279
d0a2d1d43da5ab8d4c1c06db3524458cb23a76bb,0,Henry Robinson,2016-10-18 05:08:21+00:00,['e3a08914451a63fe65e8f66afc743739f4570ba4'],39,67,106,5065885,2,,,,3279
df680cfe3a99fa295d25d39f2eab4a9cd98509be,1,Internal Jenkins,2016-10-18 05:54:09+00:00,['d0a2d1d43da5ab8d4c1c06db3524458cb23a76bb'],21,27,48,5065933,4,,,,3279
0686cc4e1f68b9cdacd6edfb4acb090a7ea0f865,0,Internal Jenkins,2016-10-18 06:12:51+00:00,['df680cfe3a99fa295d25d39f2eab4a9cd98509be'],0,4,4,5065937,1,0,1,0,3279
5a91964893a7ed2cadf8287471e25f8833ee45b1,0,Henry Robinson,2016-10-18 06:34:22+00:00,['0686cc4e1f68b9cdacd6edfb4acb090a7ea0f865'],1,1,2,5065939,1,,,,3279
080a67848b3f96eb49cdaab14f32eba8091a4320,0,Internal Jenkins,2016-10-18 09:29:31+00:00,['5a91964893a7ed2cadf8287471e25f8833ee45b1'],1,5,6,5065945,1,0,1,1,3279
3f5380dc73f3ab907443a2858d4fe0de6e3685e7,1,Internal Jenkins,2016-10-18 09:30:09+00:00,['080a67848b3f96eb49cdaab14f32eba8091a4320'],419,503,922,5066867,5,1,1,1,3280
ee2a06d827a94e659e7d92fe027eeaab6a9ac680,1,Tim Armstrong,2016-10-18 16:35:58+00:00,['3f5380dc73f3ab907443a2858d4fe0de6e3685e7'],43,13,56,5066923,9,0.8,0.8,0.2,3280
b15d992abe09bc841f6e2112d47099eb15f8454f,1,Internal Jenkins,2016-10-19 08:18:37+00:00,['ee2a06d827a94e659e7d92fe027eeaab6a9ac680'],693,647,1340,5068263,70,1,1,0,3280
ef5d0c36aa7d681d91f04be0f0a487c9fe402c51,0,Internal Jenkins,2016-10-19 23:07:47+00:00,['b15d992abe09bc841f6e2112d47099eb15f8454f'],8,2,10,5068273,3,0.666666667,0,0,3280
5a2c50a1633d8bc2d848f609e867b324c24fe06c,1,Internal Jenkins,2016-10-19 23:59:02+00:00,['ef5d0c36aa7d681d91f04be0f0a487c9fe402c51'],10,144,154,5068427,8,,,,3280
f1f54fe65db7d5af2e53b217fb7cb50abe8c50fc,0,Internal Jenkins,2016-10-20 03:09:59+00:00,['5a2c50a1633d8bc2d848f609e867b324c24fe06c'],4,3,7,5068434,2,,,,3280
502220c69d483f785632eaf0030babf40be78ff4,1,Internal Jenkins,2016-10-20 04:42:09+00:00,['f1f54fe65db7d5af2e53b217fb7cb50abe8c50fc'],0,13,13,5068447,2,0.727272727,1,1,3280
c6fc89913453befbf03d206d20c35323288702f4,1,Internal Jenkins,2016-10-20 09:14:19+00:00,['502220c69d483f785632eaf0030babf40be78ff4'],8,16,24,5068471,3,0.166666667,0.833333333,1,3280
bf1d9677fc09dabc88ab6c71f82ec99ec59ec164,1,Internal Jenkins,2016-10-20 23:47:52+00:00,['c6fc89913453befbf03d206d20c35323288702f4'],31,39,70,5068541,3,0,1,0,3280
2fa1633e4090000e9018c012df81f291a0d7566e,1,Internal Jenkins,2016-10-21 03:16:30+00:00,['bf1d9677fc09dabc88ab6c71f82ec99ec59ec164'],6,35,41,5068582,5,0.842105263,0.842105263,0.789473684,3280
9ef9512e5b58a75e075538b3b94ac551363609e5,0,Internal Jenkins,2016-10-21 05:45:18+00:00,['2fa1633e4090000e9018c012df81f291a0d7566e'],4,1,5,5068587,1,0,0,0,3280
f8d48b8582b9e460c2e0e3dbb4881636f179ae73,1,Internal Jenkins,2016-10-21 07:45:53+00:00,['9ef9512e5b58a75e075538b3b94ac551363609e5'],1,28,29,5068616,2,0.25,1,1,3280
041fa6d946e1cbe309593c4a5515bef88e06cdb4,1,Internal Jenkins,2016-10-21 10:52:25+00:00,['f8d48b8582b9e460c2e0e3dbb4881636f179ae73'],2215,3098,5313,5073929,63,0.284993695,0.924337957,0.624211854,3286
8a49ceaae532163f17836b1050b639329424ee5c,1,Internal Jenkins,2016-10-21 11:01:37+00:00,['041fa6d946e1cbe309593c4a5515bef88e06cdb4'],6,2459,2465,5076394,31,0.32,0.7,1,3314
8d7b01faea6362af675a2a335b462fad3e0caa03,1,Internal Jenkins,2016-10-21 23:32:58+00:00,['8a49ceaae532163f17836b1050b639329424ee5c'],14,35,49,5076443,1,0.142857143,0,1,3314
d1d88aaccd03c461c4ce6224f765afe94b7c073b,0,Internal Jenkins,2016-10-22 01:27:39+00:00,['8d7b01faea6362af675a2a335b462fad3e0caa03'],1,1,2,5076445,1,,,,3314
e39f1676e1c9269fb6549e8c319adf1a7ea9d445,1,Internal Jenkins,2016-10-22 02:51:25+00:00,['d1d88aaccd03c461c4ce6224f765afe94b7c073b'],0,1,1,5076446,1,,,,3314
48085274fa8ae57453477db21dae0e53eae6b766,0,Internal Jenkins,2016-10-22 04:49:39+00:00,['e39f1676e1c9269fb6549e8c319adf1a7ea9d445'],3,6,9,5076455,2,,,,3314
51268c053ffe41dc1aa9f1b250878113d4225258,1,Internal Jenkins,2016-10-22 07:39:37+00:00,['48085274fa8ae57453477db21dae0e53eae6b766'],55,120,175,5076630,7,0,0,1,3314
ff6b450ad380ce840e18875a89d9cf98058277a3,1,Internal Jenkins,2016-10-22 10:24:24+00:00,['51268c053ffe41dc1aa9f1b250878113d4225258'],75,73,148,5076778,10,1,1,0.947368421,3316
0fbb5b7e71e55346c8b97ec143854dba0088f124,0,Internal Jenkins,2016-10-24 17:53:33+00:00,['ff6b450ad380ce840e18875a89d9cf98058277a3'],122,32,154,5076932,6,0.430555556,0,0,3316
61fcb489745f3f0b3f1abbf9fbf666a29a6363de,1,Internal Jenkins,2016-10-24 18:07:25+00:00,['0fbb5b7e71e55346c8b97ec143854dba0088f124'],75,178,253,5077185,5,0.212765957,0.085106383,0.765957447,3316
e0a32721297db9d85da4a1d749672289537aca50,0,Internal Jenkins,2016-10-25 00:13:54+00:00,['61fcb489745f3f0b3f1abbf9fbf666a29a6363de'],4,3,7,5077192,2,,,,3316
0eaff805e28dd4afac134f58b294732e414235ce,1,Internal Jenkins,2016-10-25 01:15:50+00:00,['e0a32721297db9d85da4a1d749672289537aca50'],1,330,331,5077523,5,,,,3320
99ed6dc67ae889eb2a45b10c97cb23f52bc83e5d,1,Internal Jenkins,2016-10-25 02:06:10+00:00,['0eaff805e28dd4afac134f58b294732e414235ce'],97,248,345,5077868,14,0,0.68,1,3320
a6257013fad4d9bd0fcdef805b189a2cc666057a,0,Internal Jenkins,2016-10-25 04:17:58+00:00,['99ed6dc67ae889eb2a45b10c97cb23f52bc83e5d'],0,3,3,5077871,1,,,,3320
aa7741a57bbd3c11377e29c59e1d734bcdebf602,0,Internal Jenkins,2016-10-25 05:10:28+00:00,['a6257013fad4d9bd0fcdef805b189a2cc666057a'],2,14,16,5077887,2,1,1,0,3320
13455b5a24a9d4d009d1dd0d72944c6cacd54829,0,Michael Ho,2016-10-25 05:52:33+00:00,['aa7741a57bbd3c11377e29c59e1d734bcdebf602'],37,72,109,5077996,7,0.260869565,0.260869565,0,3320
01e7b1101523a668b5959462490918ae1a312452,1,Alex Behm,2016-10-25 21:56:11+00:00,['13455b5a24a9d4d009d1dd0d72944c6cacd54829'],218,203,421,5078417,27,0,0,1,3320
838c1f54428eec357bc21d27b302e25e125928c6,0,Internal Jenkins,2016-10-25 23:03:42+00:00,['01e7b1101523a668b5959462490918ae1a312452'],6,13,19,5078436,1,0,0,1,3320
0dbfe169b7b44cf127f4964baeef151fc38e84c1,0,Internal Jenkins,2016-10-26 02:34:01+00:00,['838c1f54428eec357bc21d27b302e25e125928c6'],1138,8,1146,5079582,3,,,,3320
d363b4d09890a7366e14a68e0ebfafbab2f8867b,1,Internal Jenkins,2016-10-26 03:22:08+00:00,['0dbfe169b7b44cf127f4964baeef151fc38e84c1'],11,23,34,5079616,1,0,0.75,1,3320
ba026f27267204610cf238f24cd219fe297dbe96,1,Internal Jenkins,2016-10-26 04:49:30+00:00,['d363b4d09890a7366e14a68e0ebfafbab2f8867b'],160,241,401,5080017,16,0.228571429,1,1,3320
c24e9da914e1d5e5dabd1bded5a78452bccff9b5,1,Internal Jenkins,2016-10-26 04:56:14+00:00,['ba026f27267204610cf238f24cd219fe297dbe96'],45,419,464,5080481,10,0.155172414,0.74137931,0.448275862,3320
c01644bcb9746c440cc6fd425a564ec40ea6d27c,1,Internal Jenkins,2016-10-26 21:11:06+00:00,['c24e9da914e1d5e5dabd1bded5a78452bccff9b5'],7,51,58,5080539,11,0.409090909,0.954545455,1,3320
f7d71950e3e2ebda07f90c48d6b93b1335eaa25e,1,Internal Jenkins,2016-10-26 22:21:19+00:00,['c01644bcb9746c440cc6fd425a564ec40ea6d27c'],1,26,27,5080566,3,0.75,0.75,0.75,3321
2808b84ad72ea58cd29d06b4b6d18f5061c93474,0,Internal Jenkins,2016-10-28 01:26:26+00:00,['f7d71950e3e2ebda07f90c48d6b93b1335eaa25e'],4,4,8,5080574,1,,,0,3321
d82411f81c746ec5df2f659e97e6b3ba4472676c,0,Henry Robinson,2016-10-28 19:40:32+00:00,['2808b84ad72ea58cd29d06b4b6d18f5061c93474'],2,6,8,5080582,2,,0,,3321
3b8a0891d9eebec00fc2654bb4a705752edc6759,1,Henry Robinson,2016-10-28 19:40:58+00:00,['d82411f81c746ec5df2f659e97e6b3ba4472676c'],35,65,100,5080682,5,0,0,1,3321
6587c08f701ea4a72d03a36e159f9074a84d5f8f,1,Internal Jenkins,2016-10-30 00:12:58+00:00,['3b8a0891d9eebec00fc2654bb4a705752edc6759'],27,104,131,5080813,11,0.411764706,0.411764706,0,3322
6d1a130d85562aad694ef78522e471b7cf025c30,1,Internal Jenkins,2016-10-30 01:23:11+00:00,['6587c08f701ea4a72d03a36e159f9074a84d5f8f'],70,118,188,5081001,1,0,0,0,3322
12e34b4c10e0685a24ad96ddbc82cd7a395474be,1,Marcel Kornacker,2016-10-30 19:35:50+00:00,['6d1a130d85562aad694ef78522e471b7cf025c30'],5,13,18,5081019,1,0,0,1,3322
9f3f4b713d78e8dcf02c02def447195a04f408e6,1,Marcel Kornacker,2016-10-30 19:36:10+00:00,['12e34b4c10e0685a24ad96ddbc82cd7a395474be'],202,67,269,5081288,5,0.93258427,0.707865169,0.719101124,3322
29faca5680e34d9211eb8d551385b671198f626b,1,Marcel Kornacker,2016-10-30 19:36:13+00:00,['9f3f4b713d78e8dcf02c02def447195a04f408e6'],16,303,319,5081607,8,0.277456647,0.653179191,0.786127168,3322
0d857237a8d5231caf9af4c30d4134b151cd1e0d,1,Tim Armstrong,2016-10-31 16:03:32+00:00,['29faca5680e34d9211eb8d551385b671198f626b'],1164,627,1791,5083398,23,0.967741935,0.328445748,0.519061584,3322
9b507b6ed6d1a1265544f129dbe75441a2f68783,1,Tim Armstrong,2016-10-31 16:03:54+00:00,['0d857237a8d5231caf9af4c30d4134b151cd1e0d'],66,136,202,5083600,12,0.125,0.875,0.694444444,3322
08ef70bebe972647a5e67ac622dc4ada74e4d3d9,0,Tim Armstrong,2016-10-31 22:44:54+00:00,['9b507b6ed6d1a1265544f129dbe75441a2f68783'],1,0,1,5083601,1,,,,3322
c0304471728e402baf92e6232c138d1d258a590f,0,Tim Armstrong,2016-10-31 22:45:22+00:00,['08ef70bebe972647a5e67ac622dc4ada74e4d3d9'],3,3,6,5083607,1,,,,3322
5107669a7ff6102f14ead96b58af0f958a51e18c,0,Tim Armstrong,2016-10-31 23:18:44+00:00,['c0304471728e402baf92e6232c138d1d258a590f'],6,10,16,5083623,1,,,,3322
7fc31b534d4c5cb118c559e16556a6c1ae6ca7fc,0,Tim Armstrong,2016-10-31 23:18:55+00:00,['5107669a7ff6102f14ead96b58af0f958a51e18c'],0,88,88,5083711,2,,,,3323
4918b20ac0a46d5dbc4455f0bb3e39eabe7f1cbd,0,Internal Jenkins,2016-11-01 01:47:30+00:00,['7fc31b534d4c5cb118c559e16556a6c1ae6ca7fc'],6,29,35,5083746,3,0.857142857,0.857142857,1,3323
dead771d1172b6095d19a64cef48ab9adf7ccb09,0,Henry Robinson,2016-11-02 05:27:29+00:00,['4918b20ac0a46d5dbc4455f0bb3e39eabe7f1cbd'],7,14,21,5083767,1,0,0,0,3323
dba30cc29b4ddcec0f735dcabee6a74ae9534eff,0,Internal Jenkins,2016-11-02 20:01:58+00:00,['dead771d1172b6095d19a64cef48ab9adf7ccb09'],1,1,2,5083769,1,,,,3323
81c5b8150f3ee3ad8a1e1c1b0e768164225e2251,0,Internal Jenkins,2016-11-02 20:05:47+00:00,['dba30cc29b4ddcec0f735dcabee6a74ae9534eff'],123,136,259,5084028,3,0.058823529,0,0.058823529,3323
2990696e08f39795b9a05c98f7753abafb89c02f,0,Internal Jenkins,2016-11-02 23:34:27+00:00,['81c5b8150f3ee3ad8a1e1c1b0e768164225e2251'],205,77,282,5084310,2,,,,3323
795c085fa38980085e830ce46ee8ccf298849dcb,1,Internal Jenkins,2016-11-03 08:59:45+00:00,['2990696e08f39795b9a05c98f7753abafb89c02f'],104,137,241,5084551,5,0.888888889,1,0,3323
6a16e44a2ad0e055e0d45c8f66f554c9bcb477be,0,Internal Jenkins,2016-11-03 11:59:07+00:00,['795c085fa38980085e830ce46ee8ccf298849dcb'],3,23,26,5084577,2,1,1,0,3324
1d8cdb02c67fad9279a899626f3cd56bce0b0eb3,1,Internal Jenkins,2016-11-03 20:08:37+00:00,['6a16e44a2ad0e055e0d45c8f66f554c9bcb477be'],214,724,938,5085515,30,0.719806763,1,0.695652174,3329
9755ea63b50d23f323c84edb4307ce603ded4fe1,0,Internal Jenkins,2016-11-03 20:10:02+00:00,['1d8cdb02c67fad9279a899626f3cd56bce0b0eb3'],32,66,98,5085613,4,1,1,0,3329
7862e809f608bd34cd0a318d0a91c70a6d95923d,1,Internal Jenkins,2016-11-03 21:28:35+00:00,['9755ea63b50d23f323c84edb4307ce603ded4fe1'],7,14,21,5085634,1,0,1,1,3329
40bce41765fd218cec623824c5bad21b1c207c6b,0,Taras Bobrovytsky,2016-11-03 21:28:43+00:00,['7862e809f608bd34cd0a318d0a91c70a6d95923d'],0,32,32,5085666,2,,,,3329
a9a00858da2fca89de0efc54393a97c68c033ea6,1,Internal Jenkins,2016-11-03 21:37:20+00:00,['40bce41765fd218cec623824c5bad21b1c207c6b'],10,4,14,5085680,2,0,1,1,3329
f397d756005a766ed1561ada0e43948051d164cd,0,Internal Jenkins,2016-11-03 22:53:04+00:00,['a9a00858da2fca89de0efc54393a97c68c033ea6'],8,41,49,5085729,4,,,,3329
9af59bfe2bb2747e71de45cb1fb96b7da3811ad1,0,Alex Behm,2016-11-03 23:08:56+00:00,['f397d756005a766ed1561ada0e43948051d164cd'],0,26,26,5085755,1,,,,3329
1af0aa4ad16b90bbec7c59fc75abe95d83b99c8d,0,Internal Jenkins,2016-11-03 23:47:53+00:00,['9af59bfe2bb2747e71de45cb1fb96b7da3811ad1'],2,3,5,5085760,1,0,0,0,3329
c03cfe51fc6640a4b5d0587582123b56b7575888,1,Internal Jenkins,2016-11-04 00:07:18+00:00,['1af0aa4ad16b90bbec7c59fc75abe95d83b99c8d'],11,42,53,5085813,6,0.55,0.85,0.75,3329
14891fe00461cc3af579a143811bc59fa6a1b1eb,1,Internal Jenkins,2016-11-04 00:13:12+00:00,['c03cfe51fc6640a4b5d0587582123b56b7575888'],323,565,888,5086701,114,0,0,1,3332
c5f49ec9bbc1b191545b6edd2848acb632b45973,0,Internal Jenkins,2016-11-04 00:19:33+00:00,['14891fe00461cc3af579a143811bc59fa6a1b1eb'],8,41,49,5086750,2,1,1,1,3332
32294220c4a0a7a159a70cf8ef313622b7190303,1,Internal Jenkins,2016-11-04 06:54:18+00:00,['c5f49ec9bbc1b191545b6edd2848acb632b45973'],20,24,44,5086794,5,0.666666667,1,1,3332
a807b3adba9124c935678e4ad18bbdb795ee1101,0,Sailesh Mukil,2016-11-04 18:26:40+00:00,['32294220c4a0a7a159a70cf8ef313622b7190303'],1,51,52,5086846,2,,,,3333
381a0f54be6ea1d16c4d65fc7c2747edd388fe8e,1,Internal Jenkins,2016-11-04 19:40:02+00:00,['a807b3adba9124c935678e4ad18bbdb795ee1101'],8,9,17,5086863,2,,,,3333
1cfe77dbaaf6186ea4c355520c983a16644773a8,0,Jim Apple,2016-11-04 20:35:17+00:00,['381a0f54be6ea1d16c4d65fc7c2747edd388fe8e'],6,3,9,5086872,2,0,0,0,3333
5f27ae0c2f16b56673f7710b619549b3e54c64bb,0,Internal Jenkins,2016-11-04 21:07:08+00:00,['1cfe77dbaaf6186ea4c355520c983a16644773a8'],3,1,4,5086876,1,1,1,1,3333
d802f321b2ba635962a2ba3c0cc2a50bb2ee75e5,1,Internal Jenkins,2016-11-04 22:02:22+00:00,['5f27ae0c2f16b56673f7710b619549b3e54c64bb'],494,858,1352,5088228,17,0,1,0.14159292,3334
e9a4077b3589ee0a6debadb4b5efc13e05ace773,0,Internal Jenkins,2016-11-05 01:00:00+00:00,['d802f321b2ba635962a2ba3c0cc2a50bb2ee75e5'],133,95,228,5088456,2,1,1,1,3334
832fb537635fb695dcc85d4e27dd3b7646a7e6ab,1,Internal Jenkins,2016-11-05 04:16:54+00:00,['e9a4077b3589ee0a6debadb4b5efc13e05ace773'],84,665,749,5089205,17,0.1375,0.970833333,0.958333333,3336
3e18755edaecfa475fa9d0babc3e71ab1016686a,0,Internal Jenkins,2016-11-05 04:43:55+00:00,['832fb537635fb695dcc85d4e27dd3b7646a7e6ab'],15,19,34,5089239,7,0.5,1,1,3336
50f7753d2bf3bde0ea67319b680806a071d69871,1,Internal Jenkins,2016-11-05 06:43:45+00:00,['3e18755edaecfa475fa9d0babc3e71ab1016686a'],91,199,290,5089529,21,1,0.909090909,0.772727273,3338
ac516670b66b48b54783be6d5b8816ae2273963c,0,Internal Jenkins,2016-11-05 19:27:17+00:00,['50f7753d2bf3bde0ea67319b680806a071d69871'],29,175,204,5089733,4,0.930232558,0.930232558,0.744186047,3338
120f34b0b171a0194f734f49acae4ab56f0361f3,1,Internal Jenkins,2016-11-06 00:32:06+00:00,['ac516670b66b48b54783be6d5b8816ae2273963c'],226,406,632,5090365,15,0.494736842,1,0.652631579,3338
7c0018881b5c111ab175bbbc678bebc902126f5a,0,Internal Jenkins,2016-11-06 01:51:59+00:00,['120f34b0b171a0194f734f49acae4ab56f0361f3'],113,114,227,5090592,2,,,,3338
822b2ca1c6a9bb09328857b59851035260be851f,0,Internal Jenkins,2016-11-06 06:50:48+00:00,['7c0018881b5c111ab175bbbc678bebc902126f5a'],10,271,281,5090873,3,0.361904762,0.780952381,0.885714286,3339
58d8861c58fd911411fdb61a4c2c850dc86d9803,0,Internal Jenkins,2016-11-07 11:50:43+00:00,['822b2ca1c6a9bb09328857b59851035260be851f'],2,2,4,5090877,1,,,,3339
c62d8244a4c3c674367dfa90831fc714d869ecb0,1,Henry Robinson,2016-11-07 20:50:04+00:00,['58d8861c58fd911411fdb61a4c2c850dc86d9803'],46,78,124,5091001,6,0,0.857142857,0.857142857,3339
5cc133947fe26a9ae39b0e7afb4678d251206b6b,1,Internal Jenkins,2016-11-07 22:29:19+00:00,['c62d8244a4c3c674367dfa90831fc714d869ecb0'],1,83,84,5091085,2,,,,3339
9bc90faca3df19500151ecd94fa51ab3b27a8ae5,0,Internal Jenkins,2016-11-07 22:39:55+00:00,['5cc133947fe26a9ae39b0e7afb4678d251206b6b'],12,15,27,5091112,2,,,,3339
3be4b3efd032a6723042aa2e9b087ff03b021872,0,Internal Jenkins,2016-11-07 23:26:02+00:00,['9bc90faca3df19500151ecd94fa51ab3b27a8ae5'],1,68,69,5091181,8,0.666666667,0.388888889,0.694444444,3339
1a99b78227dc37e2ab10d8b117fbc6930b703efb,0,Internal Jenkins,2016-11-08 00:31:35+00:00,['3be4b3efd032a6723042aa2e9b087ff03b021872'],20,2,22,5091203,1,0,0,0,3339
e3483c44a3180a5c1f15a09f7c4f4f7b45ffcb44,0,Internal Jenkins,2016-11-08 00:55:47+00:00,['1a99b78227dc37e2ab10d8b117fbc6930b703efb'],1,3,4,5091207,1,1,1,1,3339
10fa472fa6aa036be02748ae54daed1722449c68,1,Internal Jenkins,2016-11-08 02:44:51+00:00,['e3483c44a3180a5c1f15a09f7c4f4f7b45ffcb44'],360,578,938,5092145,34,0.837837838,0.635135135,0,3340
381e719065e9699fc2757295241594d548db6e1d,1,Internal Jenkins,2016-11-08 02:47:11+00:00,['10fa472fa6aa036be02748ae54daed1722449c68'],1,70,71,5092216,4,1,1,1,3341
51b1310681d07308fb508a038a4fdf5a1e73b5e8,0,Internal Jenkins,2016-11-08 05:34:50+00:00,['381e719065e9699fc2757295241594d548db6e1d'],2,8,10,5092226,1,0,0,1,3341
ef689edf36dd5715f17438e07a16fd4e38af5fb9,1,Internal Jenkins,2016-11-08 08:29:58+00:00,['51b1310681d07308fb508a038a4fdf5a1e73b5e8'],0,40,40,5092266,2,0,0.925925926,0.925925926,3341
ce4c5f67433ebe050261710920972621d625c81c,1,Internal Jenkins,2016-11-08 10:16:55+00:00,['ef689edf36dd5715f17438e07a16fd4e38af5fb9'],64,797,861,5093127,11,0.233082707,0.785714286,0.853383459,3342
08d89a5cc3d2135896a7d4518dac7d22e5e66ddf,1,Internal Jenkins,2016-11-08 20:34:00+00:00,['ce4c5f67433ebe050261710920972621d625c81c'],200,66,266,5093393,17,1,0.647058824,0.558823529,3342
ae24bf28509c8af6137f89cb425e3d163f8de12a,0,Internal Jenkins,2016-11-09 00:36:28+00:00,['08d89a5cc3d2135896a7d4518dac7d22e5e66ddf'],1,1,2,5093395,1,,,,3342
4af2ea4fe4e90588b13c4b551d0138123a743650,0,Internal Jenkins,2016-11-09 01:06:33+00:00,['ae24bf28509c8af6137f89cb425e3d163f8de12a'],0,4,4,5093399,1,,,,3342
f3d23be47871a4abefebca1f035d98ecc9203208,0,Internal Jenkins,2016-11-09 01:23:41+00:00,['4af2ea4fe4e90588b13c4b551d0138123a743650'],56,1,57,5093456,2,,,,3342
27e9f0aea1c898b2892b8129c042114d2e67bd6f,0,Internal Jenkins,2016-11-09 02:03:24+00:00,['f3d23be47871a4abefebca1f035d98ecc9203208'],15,15,30,5093486,1,,,,3342
67758938949496060c3cc7c7fb987e0b7c2c613f,0,Internal Jenkins,2016-11-09 02:44:36+00:00,['27e9f0aea1c898b2892b8129c042114d2e67bd6f'],4,4,8,5093494,1,,,,3342
d7246d64c777384f29fe0f824ee0036b58e8aa2d,1,Internal Jenkins,2016-11-09 03:27:12+00:00,['67758938949496060c3cc7c7fb987e0b7c2c613f'],809,1046,1855,5095349,47,0.947368421,0.394736842,0,3343
cfac09de10c996a48852b9a9d50c70cf24cf5f5f,1,Internal Jenkins,2016-11-09 06:43:41+00:00,['d7246d64c777384f29fe0f824ee0036b58e8aa2d'],101,180,281,5095630,9,0,0,1,3343
0aeb68050b3bc16b8a10a5a3ae65428e7edd9df5,1,Internal Jenkins,2016-11-09 09:44:59+00:00,['cfac09de10c996a48852b9a9d50c70cf24cf5f5f'],23,282,305,5095935,18,0.135338346,0.691729323,0.939849624,3344
b14f319708943b14680c77b2afbc502a056d06a1,0,Internal Jenkins,2016-11-11 00:37:59+00:00,['0aeb68050b3bc16b8a10a5a3ae65428e7edd9df5'],5,0,5,5095940,1,,,,3344
c68734ad6509869e8660cd1bad05e53461137474,0,Jim Apple,2016-11-11 03:44:07+00:00,['b14f319708943b14680c77b2afbc502a056d06a1'],13,34,47,5095987,5,0.047619048,0.047619048,0.952380952,3344
d15f86cb6fa5eb482b039f036dab3d979c7513c8,1,Internal Jenkins,2016-11-11 20:04:01+00:00,['c68734ad6509869e8660cd1bad05e53461137474'],5,14,19,5096006,2,1,1,1,3344
4258b9f09e1a0175ba00e7e273484f8f85aeddf0,0,Internal Jenkins,2016-11-13 02:52:33+00:00,['d15f86cb6fa5eb482b039f036dab3d979c7513c8'],2,2,4,5096010,1,,,,3344
10a4c5a2e47ec7bf1e563b6a75d1bf2afb47ebd8,0,Internal Jenkins,2016-11-14 21:25:42+00:00,['4258b9f09e1a0175ba00e7e273484f8f85aeddf0'],5,8,13,5096023,3,0,1,1,3344
cac02d6b767601ce308050f57520b65285566183,0,Internal Jenkins,2016-11-14 22:38:09+00:00,['10a4c5a2e47ec7bf1e563b6a75d1bf2afb47ebd8'],16,19,35,5096058,1,0,0,1,3344
3f2f008ac4365d7f7c616730d3faeebd776b74d2,1,Internal Jenkins,2016-11-15 03:22:11+00:00,['cac02d6b767601ce308050f57520b65285566183'],199,280,479,5096537,24,0,0,1,3347
628685ae749daa133c9b7a6184c5523136979974,1,Internal Jenkins,2016-11-15 03:27:36+00:00,['3f2f008ac4365d7f7c616730d3faeebd776b74d2'],596,1398,1994,5098531,42,0.163841808,0.395480226,0.435028249,3350
f4a5d863c3123503d8b8c89bf1415f4bbdd6a810,0,Internal Jenkins,2016-11-15 03:33:14+00:00,['628685ae749daa133c9b7a6184c5523136979974'],5,5,10,5098541,1,,,,3350
0ea4a666dc12e093cc12ca4cd640f0ede51661a2,0,Internal Jenkins,2016-11-15 04:18:33+00:00,['f4a5d863c3123503d8b8c89bf1415f4bbdd6a810'],0,5,5,5098546,1,0,1,1,3350
e6e2baea33eca0fbad9958c7c2f6087ee1019c46,1,Internal Jenkins,2016-11-15 05:38:12+00:00,['0ea4a666dc12e093cc12ca4cd640f0ede51661a2'],26,49,75,5098621,6,0.666666667,0.333333333,0,3350
91b5264e5239b2cf3ad4ea896eb28dd5fbdcb74a,0,Internal Jenkins,2016-11-15 11:17:43+00:00,['e6e2baea33eca0fbad9958c7c2f6087ee1019c46'],1,10,11,5098632,2,,,,3350
b3cbc960a7e4beebf6cb9076a02b3513bb0b2954,1,Internal Jenkins,2016-11-15 15:29:26+00:00,['91b5264e5239b2cf3ad4ea896eb28dd5fbdcb74a'],2,4,6,5098638,1,0,1,1,3350
4b774880c9bd46fccf8855f383ce579e585c7115,0,Internal Jenkins,2016-11-15 20:35:01+00:00,['b3cbc960a7e4beebf6cb9076a02b3513bb0b2954'],2,2,4,5098642,2,,,,3350
6937fa9a4caa9039a95d661ddf209777caa805f5,1,Internal Jenkins,2016-11-15 20:47:18+00:00,['4b774880c9bd46fccf8855f383ce579e585c7115'],1,71,72,5098714,3,0.151515152,1,0.96969697,3351
38ee3b6942f3e044555ee399c51cba65f0b35267,0,Internal Jenkins,2016-11-15 23:02:50+00:00,['6937fa9a4caa9039a95d661ddf209777caa805f5'],2,3,5,5098719,2,0,0,0,3351
9434e38abb515da25a3adbe43a217d4361ee531c,1,Internal Jenkins,2016-11-15 23:33:45+00:00,['38ee3b6942f3e044555ee399c51cba65f0b35267'],2,2,4,5098723,2,,,,3351
0a654b31869c77d667cd692a5f36cf0748b31c64,0,Internal Jenkins,2016-11-15 23:47:40+00:00,['9434e38abb515da25a3adbe43a217d4361ee531c'],14,30,44,5098767,1,0,1,0,3351
107fc4e9f9fd7d92a227ac4fc1e5820ee44dade1,0,Internal Jenkins,2016-11-16 21:57:37+00:00,['0a654b31869c77d667cd692a5f36cf0748b31c64'],4,5,9,5098776,1,,,,3351
f5e660dd6eabc667094d8bc40810602cd7fa56d4,0,Internal Jenkins,2016-11-16 23:55:42+00:00,['107fc4e9f9fd7d92a227ac4fc1e5820ee44dade1'],3,32,35,5098811,3,1,1,1,3351
ab0d21ab797a4511ef2717d1331ebda5cec7bfec,0,Internal Jenkins,2016-11-17 01:46:23+00:00,['f5e660dd6eabc667094d8bc40810602cd7fa56d4'],2,9,11,5098822,1,1,1,1,3351
3833707dbd78dd39f6cf25060607a7b8ae9bff10,1,Internal Jenkins,2016-11-17 02:54:30+00:00,['ab0d21ab797a4511ef2717d1331ebda5cec7bfec'],487,1624,2111,5100933,10,0.285714286,0.285714286,0,3355
77a2941a42b3023d22f3cc7b2db01a94b4ddec2f,1,Internal Jenkins,2016-11-17 04:13:25+00:00,['3833707dbd78dd39f6cf25060607a7b8ae9bff10'],25,102,127,5101060,5,0.387755102,0.285714286,0.714285714,3355
0ab3d7691e95bc16369779e334b75c328dd40602,1,Internal Jenkins,2016-11-17 04:37:56+00:00,['77a2941a42b3023d22f3cc7b2db01a94b4ddec2f'],74,64,138,5101198,19,0.833333333,0.833333333,1,3355
eb8120d218e825d36d3d8ca7560b3863691c8a73,0,Internal Jenkins,2016-11-17 05:31:34+00:00,['0ab3d7691e95bc16369779e334b75c328dd40602'],12,35,47,5101245,6,0,0,1,3355
2648bfbd90e6ef193f03a138e5a6903dd17626f1,0,Internal Jenkins,2016-11-17 09:35:14+00:00,['eb8120d218e825d36d3d8ca7560b3863691c8a73'],4,7,11,5101256,1,,,,3355
45ac10aa40d85187066d9048d18b3216b156a337,1,Impala Public Jenkins,2016-11-17 21:35:56+00:00,['2648bfbd90e6ef193f03a138e5a6903dd17626f1'],23,30,53,5101309,1,0.142857143,1,0,3355
46f5ad48e38b456d7a2f36e7d4c169f7cfe67a86,1,Internal Jenkins,2016-11-17 21:56:14+00:00,['45ac10aa40d85187066d9048d18b3216b156a337'],432,441,873,5102182,6,0,1,0,3355
3be0f122a5bb5d3549d9240b95a5d29b4a21b1a2,1,Jim Apple,2016-11-17 22:38:44+00:00,['46f5ad48e38b456d7a2f36e7d4c169f7cfe67a86'],0,89657,89657,5191839,264,,,,3619
263f222557d5931374c2ea453d4c3d9ad1eafa70,1,Internal Jenkins,2016-11-18 00:26:35+00:00,['3be0f122a5bb5d3549d9240b95a5d29b4a21b1a2'],5,34,39,5191878,2,,,,3619
76719de5d1d6a2609d7fd6bad05df79954d0fa56,1,Impala Public Jenkins,2016-11-18 03:06:52+00:00,['263f222557d5931374c2ea453d4c3d9ad1eafa70'],1,1,2,5191880,1,,,,3619
60414f06330aa62d06a67821309c8ff452de5a5f,1,Internal Jenkins,2016-11-18 03:12:12+00:00,['76719de5d1d6a2609d7fd6bad05df79954d0fa56'],49,285,334,5192214,10,0.185185185,0.759259259,0.925925926,3620
3db5ced4cee8967f28e337747efba902ce71cfee,1,Internal Jenkins,2016-11-18 11:41:01+00:00,['60414f06330aa62d06a67821309c8ff452de5a5f'],254,973,1227,5193441,31,0,0,0.753593429,3620
8e60e714a6e56cb65694cd9c12ab8594a57937b9,0,Internal Jenkins,2016-11-18 22:31:05+00:00,['3db5ced4cee8967f28e337747efba902ce71cfee'],2,2,4,5193445,1,,,,3620
bb36433b1e0e6426806f8ca40239561eb960abb2,0,Internal Jenkins,2016-11-19 04:30:07+00:00,['8e60e714a6e56cb65694cd9c12ab8594a57937b9'],1,27,28,5193473,1,,,,3620
de88f0c4af3a07ae6bd6b8c94edcb8748468f522,1,Internal Jenkins,2016-11-19 09:55:51+00:00,['bb36433b1e0e6426806f8ca40239561eb960abb2'],0,8,8,5193481,1,,,,3620
035b775a6dca0609ffec049f765b311d4eda6ebd,1,Internal Jenkins,2016-11-21 22:18:37+00:00,['de88f0c4af3a07ae6bd6b8c94edcb8748468f522'],30,86,116,5193597,6,1,1,1,3621
af67b2fef4d397dc2a304ffda876e9484c24069e,0,Internal Jenkins,2016-11-21 22:24:25+00:00,['035b775a6dca0609ffec049f765b311d4eda6ebd'],1,2,3,5193600,1,,,,3621
7bfa6e3e3f20d741f36e713ea62f9324e5739ea0,1,Internal Jenkins,2016-11-22 00:08:04+00:00,['af67b2fef4d397dc2a304ffda876e9484c24069e'],3,37,40,5193640,1,0.285714286,1,1,3621
178fd59142db5f401d1426fa4daa11432e1e2f50,0,Internal Jenkins,2016-11-22 00:42:57+00:00,['7bfa6e3e3f20d741f36e713ea62f9324e5739ea0'],23,43,66,5193706,3,1,1,0,3622
8ea21d099fde57bd358cc073017bdcf80c8d74ca,1,Internal Jenkins,2016-11-22 02:51:20+00:00,['178fd59142db5f401d1426fa4daa11432e1e2f50'],161,457,618,5194324,26,0.04,0.493333333,0.833333333,3622
eb0318609b11cba41e78bb105d266046c81cf6c9,1,Internal Jenkins,2016-11-22 06:33:15+00:00,['8ea21d099fde57bd358cc073017bdcf80c8d74ca'],0,11,11,5194335,1,0,0.125,1,3622
ac44d6c3ef0f71452cc47f7a61659e1b939110c3,0,Impala Public Jenkins,2016-11-22 07:31:34+00:00,['eb0318609b11cba41e78bb105d266046c81cf6c9'],27,25,52,5194387,15,,,,3622
b7eeb8bf85ef24b730c9ba2891f5a8075ba9605e,1,Internal Jenkins,2016-11-22 14:56:03+00:00,['ac44d6c3ef0f71452cc47f7a61659e1b939110c3'],117,180,297,5194684,24,1,1,1,3622
4821ea6c468d3d4ae37d47b21aafaee553fb0549,0,Internal Jenkins,2016-11-22 22:26:58+00:00,['b7eeb8bf85ef24b730c9ba2891f5a8075ba9605e'],17,25,42,5194726,2,0,1,1,3622
8f2bb2f72fc94307034881f500e23f335ec08eba,1,Internal Jenkins,2016-11-22 23:06:05+00:00,['4821ea6c468d3d4ae37d47b21aafaee553fb0549'],92,213,305,5195031,9,0,0.852941176,1,3623
bb1c63380b8ec14fb6058f3157cad8746463e054,1,Internal Jenkins,2016-11-23 00:56:48+00:00,['8f2bb2f72fc94307034881f500e23f335ec08eba'],25,17,42,5195073,7,0,0.166666667,0,3623
696fb68e58897868d6c6984f81c5823937ab4069,0,Internal Jenkins,2016-11-23 05:46:18+00:00,['bb1c63380b8ec14fb6058f3157cad8746463e054'],14,77,91,5195164,1,0,1,1,3623
4db330e69a2dbb4a23f46e34b484da0d6b9ef29b,1,Internal Jenkins,2016-11-23 08:18:17+00:00,['696fb68e58897868d6c6984f81c5823937ab4069'],145,1479,1624,5196788,29,0.447852761,0.104294479,0.447852761,3623
1e306211d0eb511ff3e4f3f6f91d7e6fcd01af15,1,Internal Jenkins,2016-11-23 12:48:47+00:00,['4db330e69a2dbb4a23f46e34b484da0d6b9ef29b'],174,518,692,5197480,27,0.384615385,1,0.573426573,3624
bbf5255d0e829ab553b57052ff9383aa365c7d59,1,Internal Jenkins,2016-11-23 21:11:30+00:00,['1e306211d0eb511ff3e4f3f6f91d7e6fcd01af15'],300,949,1249,5198729,58,0.654255319,0.707446809,1,3627
707f71b6ea13487c707337785e785487d2f470f2,1,Henry Robinson,2016-11-23 23:25:04+00:00,['bbf5255d0e829ab553b57052ff9383aa365c7d59'],72,111,183,5198912,10,0,0.666666667,1,3628
b82eed5ee02eccc21cc69d4af107c0acf31e08fa,0,Internal Jenkins,2016-11-24 00:23:58+00:00,['707f71b6ea13487c707337785e785487d2f470f2'],6,20,26,5198938,2,1,1,0,3628
3934e13b3b9da503f12363ba5d72cf3f151fd58b,1,Internal Jenkins,2016-11-24 01:21:56+00:00,['b82eed5ee02eccc21cc69d4af107c0acf31e08fa'],39,614,653,5199591,8,0.12,0.8,0.986666667,3628
1fea9973d2cd4fd61d9377ef9ce4f5accafb41b0,1,Internal Jenkins,2016-11-24 02:39:30+00:00,['3934e13b3b9da503f12363ba5d72cf3f151fd58b'],11,17,28,5199619,1,1,1,1,3628
96d98abff52e59742469f9d5a86018506e00f88f,1,Internal Jenkins,2016-11-24 04:11:25+00:00,['1fea9973d2cd4fd61d9377ef9ce4f5accafb41b0'],97,158,255,5199874,3,0.757575758,0.696969697,0.878787879,3628
e4fc5bd5c515a73358cdc83e7eed5cd128262380,1,Internal Jenkins,2016-11-24 05:39:45+00:00,['96d98abff52e59742469f9d5a86018506e00f88f'],8,34,42,5199916,2,0.764705882,1,1,3628
a35eb2fedb0ea565c766f4dd55bab2ca866f5cb2,0,Internal Jenkins,2016-11-24 06:14:20+00:00,['e4fc5bd5c515a73358cdc83e7eed5cd128262380'],1,1,2,5199918,1,,,,3628
90ebecdd407708e28ff4ff234ee059dd2d3b190e,1,Internal Jenkins,2016-11-24 08:03:28+00:00,['a35eb2fedb0ea565c766f4dd55bab2ca866f5cb2'],6,1,7,5199925,1,1,1,0,3628
16552f6eda11c1c8587ae467b55247df246c019c,1,Internal Jenkins,2016-11-24 08:03:39+00:00,['90ebecdd407708e28ff4ff234ee059dd2d3b190e'],11,41,52,5199977,5,0.3,0.3,0.3,3629
fc61f2a3f733ecd8fb75d8c5a7ac7e8c25eca5c8,0,Internal Jenkins,2016-11-24 22:28:01+00:00,['16552f6eda11c1c8587ae467b55247df246c019c'],13,14,27,5200004,5,0,0,1,3629
3c65fa1d7e91177770d745940e84645cf9c49ba8,0,Internal Jenkins,2016-11-25 15:26:48+00:00,['fc61f2a3f733ecd8fb75d8c5a7ac7e8c25eca5c8'],1,2,3,5200007,1,0,0,0,3629
fe8d994f0f320c541ff22fd15660a3d926c7d90b,0,Internal Jenkins,2016-11-25 23:32:24+00:00,['3c65fa1d7e91177770d745940e84645cf9c49ba8'],1,2,3,5200010,1,1,1,1,3629
f2ce30e6448fb1a5c1d5721c0de1c768261770b3,1,Internal Jenkins,2016-11-29 01:45:13+00:00,['fe8d994f0f320c541ff22fd15660a3d926c7d90b'],11,15,26,5200036,1,,,,3629
e2cde13a2b1b8c70a8f2d2d1d0853848de1f7d77,0,Tim Armstrong,2016-11-29 01:46:05+00:00,['f2ce30e6448fb1a5c1d5721c0de1c768261770b3'],3,4,7,5200043,1,,,,3629
8adc49e51c44aa3a4b5334a93b64ae5a21e400b9,1,Internal Jenkins,2016-11-29 16:36:43+00:00,['e2cde13a2b1b8c70a8f2d2d1d0853848de1f7d77'],1,1,2,5200045,1,,,,3629
9032952758b00c172a63fb83f6eb1c638f20de5f,1,Internal Jenkins,2016-11-29 17:06:16+00:00,['8adc49e51c44aa3a4b5334a93b64ae5a21e400b9'],2,58,60,5200105,6,0.108108108,0.216216216,1,3629
26805809f7fb91537b8068058cb3f7b5dd4fd5de,1,Impala Public Jenkins,2016-11-29 22:10:58+00:00,['9032952758b00c172a63fb83f6eb1c638f20de5f'],1,39,40,5200145,2,,,,3630
90bf40d213001060e8031d5606c367e4896427ed,1,Impala Public Jenkins,2016-11-30 00:28:02+00:00,['26805809f7fb91537b8068058cb3f7b5dd4fd5de'],0,7,7,5200152,1,,,,3630
9f497ba02f2c5147ddfa5be62a47f2bb45ac97af,1,Internal Jenkins,2016-11-30 04:55:03+00:00,['90bf40d213001060e8031d5606c367e4896427ed'],58,964,1022,5201174,20,0.294264339,0.850374065,0.778054863,3631
0f62bf35fd2266d130cf06de0710b7d7797d84ac,0,Internal Jenkins,2016-11-30 11:19:36+00:00,['9f497ba02f2c5147ddfa5be62a47f2bb45ac97af'],4,16,20,5201194,2,1,1,0,3631
585ed5aaae32607218e8056e34b40de0e24c1724,0,Sailesh Mukil,2016-11-30 16:22:56+00:00,['0f62bf35fd2266d130cf06de0710b7d7797d84ac'],0,6,6,5201200,1,1,1,1,3631
290db20dbc364c102c40ea2022535b896bf1c45c,1,Tim Armstrong,2016-11-30 17:18:36+00:00,['585ed5aaae32607218e8056e34b40de0e24c1724'],0,21,21,5201221,3,0,0,0,3631
d21728c0ae4ddcd1a063341d5f2db98534aedf3a,0,Tim Armstrong,2016-11-30 21:32:25+00:00,['290db20dbc364c102c40ea2022535b896bf1c45c'],1,1,2,5201223,1,,,,3631
5a158dbcd1330ebddc372ffe8d1374775a81fcab,0,Impala Public Jenkins,2016-11-30 22:30:39+00:00,['d21728c0ae4ddcd1a063341d5f2db98534aedf3a'],2,11,13,5201236,1,1,1,1,3631
352833b8cfcf5e0246f322fec1ee9b7612e0ed6a,1,Internal Jenkins,2016-12-01 04:42:38+00:00,['5a158dbcd1330ebddc372ffe8d1374775a81fcab'],193,388,581,5201817,39,0,0,0.635897436,3631
6d8fd7e79c44250ccd7fc88ade44b1bdd6ae2528,0,Impala Public Jenkins,2016-12-01 05:22:45+00:00,['352833b8cfcf5e0246f322fec1ee9b7612e0ed6a'],21,45,66,5201883,3,1,1,1,3631
c97bffcce1e3d053ad6152dae300bf5233507f34,1,Internal Jenkins,2016-12-01 11:04:48+00:00,['6d8fd7e79c44250ccd7fc88ade44b1bdd6ae2528'],35,53,88,5201971,6,0.75,0.75,1,3631
467642f2cab9c341aba5955d8bfd88565649b3ff,1,Internal Jenkins,2016-12-01 11:10:02+00:00,['c97bffcce1e3d053ad6152dae300bf5233507f34'],135,148,283,5202254,30,0,0,0.948717949,3631
b1edca2a5b6eb66fc5c316157f968b267ee36b48,0,Internal Jenkins,2016-12-01 12:03:17+00:00,['467642f2cab9c341aba5955d8bfd88565649b3ff'],6,41,47,5202301,4,1,1,0,3632
83f777da71c46e2a8eb6c14cdf0442f66bf6baa4,0,Jim Apple,2016-12-01 19:34:29+00:00,['b1edca2a5b6eb66fc5c316157f968b267ee36b48'],0,30,30,5202331,2,,,,3634
1b8fede3b5b3f5aff9d3fb3ac74f956da870186d,0,Internal Jenkins,2016-12-01 21:06:49+00:00,['83f777da71c46e2a8eb6c14cdf0442f66bf6baa4'],2,4,6,5202337,1,,,,3634
f3fe2cfe10c70443e7b62ae1e79949ce731588e8,0,Internal Jenkins,2016-12-01 23:11:49+00:00,['1b8fede3b5b3f5aff9d3fb3ac74f956da870186d'],2,2,4,5202341,2,,,,3634
a41918d443217d5e3205f6e9987d0c857f7ef7ef,0,Internal Jenkins,2016-12-01 23:43:03+00:00,['f3fe2cfe10c70443e7b62ae1e79949ce731588e8'],1,7,8,5202349,2,0,0,0,3634
56f4d0f592f129054985786287ad8ed8c241fc74,1,Internal Jenkins,2016-12-02 00:35:02+00:00,['a41918d443217d5e3205f6e9987d0c857f7ef7ef'],122,68,190,5202539,4,0.055555556,1,0,3634
b3740612065d742f7ddb96154da64c590867759e,0,Impala Public Jenkins,2016-12-02 01:46:55+00:00,['56f4d0f592f129054985786287ad8ed8c241fc74'],33,60,93,5202632,5,0.75,0.75,0.75,3635
da34ce9780d03b9abcd7adf2cd75d2f57ab97b1d,0,Internal Jenkins,2016-12-02 02:06:22+00:00,['b3740612065d742f7ddb96154da64c590867759e'],20,27,47,5202679,3,0,0,1,3635
48983b389366eb7f792f5e309fa3eb77b70990f6,0,Internal Jenkins,2016-12-02 04:01:19+00:00,['da34ce9780d03b9abcd7adf2cd75d2f57ab97b1d'],0,1,1,5202680,1,,,,3635
d44df83689f6cd0cb5c93d3893beaff4f7c9342a,1,Impala Public Jenkins,2016-12-02 11:37:14+00:00,['48983b389366eb7f792f5e309fa3eb77b70990f6'],40,34,74,5202754,3,1,1,1,3635
8d4f8d8d9317d2f562cbc7e1517906cd7d6cd8e1,0,Taras Bobrovytsky,2016-12-02 20:49:43+00:00,['d44df83689f6cd0cb5c93d3893beaff4f7c9342a'],68,642,710,5203464,4,0.838095238,0.828571429,0.99047619,3635
7bcb51b152ac0b2e7660ec96b1ee94e5ab906abd,1,Internal Jenkins,2016-12-02 21:58:03+00:00,['8d4f8d8d9317d2f562cbc7e1517906cd7d6cd8e1'],19,49,68,5203532,7,0,0.588235294,1,3635
d484d2f684fffa76cd8608e40d54a7521b3e605e,1,John Russell,2016-12-02 23:54:32+00:00,['7bcb51b152ac0b2e7660ec96b1ee94e5ab906abd'],26,4659,4685,5208217,258,,,,3635
cdbcdca67018fe77ee7a33a11695ca89cf8d476a,0,Impala Public Jenkins,2016-12-03 03:34:16+00:00,['d484d2f684fffa76cd8608e40d54a7521b3e605e'],2,2,4,5208221,1,,,,3635
858f5c219710f1b72b25e509643f0cf9e1113dee,1,Internal Jenkins,2016-12-03 06:41:07+00:00,['cdbcdca67018fe77ee7a33a11695ca89cf8d476a'],36,141,177,5208398,13,0.923076923,0.923076923,0.75,3638
b237d1316eac6ccde4ce395b4c238997be3e2f8b,1,Internal Jenkins,2016-12-03 06:46:01+00:00,['858f5c219710f1b72b25e509643f0cf9e1113dee'],11,24,35,5208433,3,0.909090909,1,1,3638
694d72ea9bd1543e2bf1b0a2edf2af213f89a35b,1,Impala Public Jenkins,2016-12-03 09:58:52+00:00,['b237d1316eac6ccde4ce395b4c238997be3e2f8b'],179,185,364,5208797,33,0.666666667,1,1,3638
b9034ea0d54ad40e11b482b577362ceee3768f1e,0,Internal Jenkins,2016-12-03 11:07:04+00:00,['694d72ea9bd1543e2bf1b0a2edf2af213f89a35b'],2,39,41,5208838,3,0,1,0.818181818,3638
6662c55364b1c429340edc1ffd14323167f7b561,1,Internal Jenkins,2016-12-03 21:17:46+00:00,['b9034ea0d54ad40e11b482b577362ceee3768f1e'],340,366,706,5209544,6,1,1,1,3639
7efa08316ecb8f73d1c968ed602d11d40c714a1f,1,Internal Jenkins,2016-12-03 22:28:53+00:00,['6662c55364b1c429340edc1ffd14323167f7b561'],11,107,118,5209662,9,0.189655172,0.775862069,0.689655172,3639
ff629c2deb97b4ef25e80745bf4689dcbe8407fe,1,Internal Jenkins,2016-12-03 23:21:10+00:00,['7efa08316ecb8f73d1c968ed602d11d40c714a1f'],9,14,23,5209685,3,0,,0,3639
1da57019ade33d85f76bfb86fa64332eea7b04eb,0,Internal Jenkins,2016-12-04 08:35:15+00:00,['ff629c2deb97b4ef25e80745bf4689dcbe8407fe'],1,10,11,5209696,2,,,,3639
852e272b32a5424e1ea31af7b3d532dac0f916b3,1,Internal Jenkins,2016-12-05 00:58:30+00:00,['1da57019ade33d85f76bfb86fa64332eea7b04eb'],12,74,86,5209782,2,0,0,0,3639
12cc5081783e435bbd2e577e8f7666c1ebe7d28a,1,Internal Jenkins,2016-12-05 09:31:25+00:00,['852e272b32a5424e1ea31af7b3d532dac0f916b3'],3,44,47,5209829,2,0.833333333,0.833333333,1,3639
b8b64e11081500563eca5ba548de814f6974bad3,0,Dimitris Tsirogiannis,2016-12-05 18:15:01+00:00,['12cc5081783e435bbd2e577e8f7666c1ebe7d28a'],1,1,2,5209831,1,,,,3639
730ac1bae1ecee03837fb7298e8bdc23ddfd8638,0,Impala Public Jenkins,2016-12-05 22:37:36+00:00,['b8b64e11081500563eca5ba548de814f6974bad3'],6,22,28,5209859,2,0.75,0.75,0.75,3639
1495b2007d9645053dae71ca4dbf4e3a48558ef4,1,Impala Public Jenkins,2016-12-05 23:33:44+00:00,['730ac1bae1ecee03837fb7298e8bdc23ddfd8638'],19,147,166,5210025,3,0.166666667,0.075757576,0.727272727,3639
867b2434ca678a66e8d7bdbd228c86a7d5d032cb,1,Impala Public Jenkins,2016-12-06 00:04:43+00:00,['1495b2007d9645053dae71ca4dbf4e3a48558ef4'],0,74,74,5210099,2,0,0,0,3639
9f387c858354a5c7df5fd922e731f887aa7e51f7,1,Internal Jenkins,2016-12-06 03:24:39+00:00,['867b2434ca678a66e8d7bdbd228c86a7d5d032cb'],7,99,106,5210205,3,0.1,0.1,0.4,3639
5bb9959fa4149f3b4976ab73c99b802b42e4fafc,0,Internal Jenkins,2016-12-06 03:53:15+00:00,['9f387c858354a5c7df5fd922e731f887aa7e51f7'],28,36,64,5210269,2,0,1,0,3639
b656f570e9d395129b820506a5e92ffb92b452f4,0,Internal Jenkins,2016-12-06 06:19:03+00:00,['5bb9959fa4149f3b4976ab73c99b802b42e4fafc'],1,42,43,5210312,2,0,1,1,3639
f8377543778b654336c978a4bb97efa3c1847441,1,Internal Jenkins,2016-12-06 07:24:01+00:00,['b656f570e9d395129b820506a5e92ffb92b452f4'],31,52,83,5210395,6,1,1,0,3639
cba93f1ac3d4c0219c6266924493ad19c8c10556,1,Internal Jenkins,2016-12-06 10:41:53+00:00,['f8377543778b654336c978a4bb97efa3c1847441'],415,416,831,5211226,36,0.666666667,0.666666667,1,3639
9b80224f9f782cd9a870c4a70d651392bb07c86c,1,Internal Jenkins,2016-12-06 12:37:17+00:00,['cba93f1ac3d4c0219c6266924493ad19c8c10556'],0,3,3,5211229,1,1,1,1,3639
534999382d5e75ce49c57b4223adc1e3b021778b,0,Internal Jenkins,2016-12-06 22:03:01+00:00,['9b80224f9f782cd9a870c4a70d651392bb07c86c'],4,32,36,5211265,6,0.571428571,0.571428571,1,3639
a65864a40ddc73aebeaf04abb5c5ca6fa70ba0ee,1,Internal Jenkins,2016-12-07 04:25:21+00:00,['534999382d5e75ce49c57b4223adc1e3b021778b'],2,84,86,5211351,7,0,1,1,3641
0d4bdc1b70464e71cd3dc44f6fbaf0aa619932e0,1,Internal Jenkins,2016-12-07 05:01:01+00:00,['a65864a40ddc73aebeaf04abb5c5ca6fa70ba0ee'],0,11,11,5211362,1,0,1,1,3641
5188f879a7940f96dcaf3892f08c0aa76f58abe2,1,Internal Jenkins,2016-12-07 05:11:13+00:00,['0d4bdc1b70464e71cd3dc44f6fbaf0aa619932e0'],12,12,24,5211386,5,,,,3641
6098ac7162742c11350de708188ce6c3f7ce11a7,1,Internal Jenkins,2016-12-07 06:27:51+00:00,['5188f879a7940f96dcaf3892f08c0aa76f58abe2'],12,28,40,5211426,4,0,0.75,1,3641
f83652c1da61c3996bd8c812dd57d2dd00e8ce3c,1,Internal Jenkins,2016-12-07 07:31:16+00:00,['6098ac7162742c11350de708188ce6c3f7ce11a7'],219,204,423,5211849,34,1,0,0,3641
bb633393775691807843a2b6bac28b1750c2c5da,0,Internal Jenkins,2016-12-07 09:45:11+00:00,['f83652c1da61c3996bd8c812dd57d2dd00e8ce3c'],1,39,40,5211889,2,1,1,,3641
9baf4f03ad0f37d54b0fe7f315cbb473e0c8a723,0,Henry Robinson,2016-12-07 15:20:27+00:00,['bb633393775691807843a2b6bac28b1750c2c5da'],12,16,28,5211917,1,1,1,1,3641
9337518137ddbbdefde9738ea1dce9f978f525a8,1,Impala Public Jenkins,2016-12-07 22:52:35+00:00,['9baf4f03ad0f37d54b0fe7f315cbb473e0c8a723'],11,76,87,5212004,5,1,1,0.5,3641
1083639ff2a09ff157d3e8c6880973d954a20bb9,1,Impala Public Jenkins,2016-12-08 02:20:50+00:00,['9337518137ddbbdefde9738ea1dce9f978f525a8'],8,9,17,5212021,6,,,,3641
5ec0eeda0800c9213dd20a290a24178e5f57b20e,0,Internal Jenkins,2016-12-08 03:53:52+00:00,['1083639ff2a09ff157d3e8c6880973d954a20bb9'],2,3,5,5212026,1,0,1,1,3641
eaa14f275066a5f29a9c286316f43deb9803feea,1,Impala Public Jenkins,2016-12-08 04:31:12+00:00,['5ec0eeda0800c9213dd20a290a24178e5f57b20e'],0,21,21,5212047,2,1,1,1,3641
29971ac7dafadb741cce7a55fe7312fe00ac7dcf,0,Impala Public Jenkins,2016-12-08 04:38:31+00:00,['eaa14f275066a5f29a9c286316f43deb9803feea'],8,10,18,5212065,1,1,0,0,3641
5ea179866114f7b7bd5922362dec62024d3ab5b8,0,Internal Jenkins,2016-12-08 04:53:38+00:00,['29971ac7dafadb741cce7a55fe7312fe00ac7dcf'],0,31,31,5212096,3,0,0,0.875,3641
88448d1d4ab31eaaf82f764b36dc7d11d4c63c32,1,Impala Public Jenkins,2016-12-08 04:53:53+00:00,['5ea179866114f7b7bd5922362dec62024d3ab5b8'],400,465,865,5212961,25,0.553571429,0.982142857,0.517857143,3643
b00310ca897de325c8c6bd67f430885cddd322da,0,Internal Jenkins,2016-12-08 08:30:51+00:00,['88448d1d4ab31eaaf82f764b36dc7d11d4c63c32'],68,75,143,5213104,3,0,0,0,3643
02b5cce846563913d49e2eb121896c096035eb39,0,Alex Behm,2016-12-08 21:58:46+00:00,['b00310ca897de325c8c6bd67f430885cddd322da'],0,1,1,5213105,1,,,,3643
cc57a229fdc7ad9fc6b3b6f2cfa3a64f7aacbd10,0,Impala Public Jenkins,2016-12-09 01:33:09+00:00,['02b5cce846563913d49e2eb121896c096035eb39'],9,6,15,5213120,1,1,1,0,3643
80f85179f99ff36d6ecad65b2041b45015ffb716,1,Internal Jenkins,2016-12-09 02:12:46+00:00,['cc57a229fdc7ad9fc6b3b6f2cfa3a64f7aacbd10'],52,121,173,5213293,2,1,1,0,3643
1762dd1b815b43d4507ce28e1879091dd2e4de57,0,Impala Public Jenkins,2016-12-09 02:19:41+00:00,['80f85179f99ff36d6ecad65b2041b45015ffb716'],1,1,2,5213295,1,,,,3643
84ee40428dbb18146760adec8c5a03559f527ddb,1,Impala Public Jenkins,2016-12-09 03:04:07+00:00,['1762dd1b815b43d4507ce28e1879091dd2e4de57'],6,13,19,5213314,1,,,,3643
1a558be5f5e34df1024026f69fe1f17a72a72d99,0,Tim Armstrong,2016-12-09 17:01:04+00:00,['84ee40428dbb18146760adec8c5a03559f527ddb'],1,3,4,5213318,1,,,,3643
e1a6db7609bf3d6cc46b79bd0c0396c3ce3fae47,0,Internal Jenkins,2016-12-09 19:24:50+00:00,['1a558be5f5e34df1024026f69fe1f17a72a72d99'],3,2,5,5213323,2,,,,3643
02fc53d5f0a4d39040ca710c00bae4ca62b73fcd,0,Internal Jenkins,2016-12-09 23:14:24+00:00,['e1a6db7609bf3d6cc46b79bd0c0396c3ce3fae47'],18,24,42,5213365,1,0,0,1,3643
2ae93b03ee00aff84e25db51813c9d1f5cb26b8b,0,Internal Jenkins,2016-12-09 23:28:41+00:00,['02fc53d5f0a4d39040ca710c00bae4ca62b73fcd'],2,4,6,5213371,1,,,,3643
1e683d4ee69891df1ee9c1f098f9deda98e94986,1,Internal Jenkins,2016-12-10 00:05:50+00:00,['2ae93b03ee00aff84e25db51813c9d1f5cb26b8b'],72,238,310,5213681,12,0,0.43956044,0.527472527,3643
48792eb92f010af99246a14d5a3570dfed662dfd,0,Internal Jenkins,2016-12-10 05:01:19+00:00,['1e683d4ee69891df1ee9c1f098f9deda98e94986'],3,1,4,5213685,1,1,0,0,3643
4b2d76dbb523c3761a6f53983b635ce88bc67a0c,1,Internal Jenkins,2016-12-11 02:29:28+00:00,['48792eb92f010af99246a14d5a3570dfed662dfd'],718,1113,1831,5215516,66,0.518518519,1,0,3648
39017adffc0cb13ebbdab89902d8403faf9a2b4b,1,Matthew Jacobs,2016-12-11 07:03:33+00:00,['4b2d76dbb523c3761a6f53983b635ce88bc67a0c'],6,7,13,5215529,1,,,,3648
2414d4c9c6f48e86629a87d454dc4ecf8691267d,1,Matthew Jacobs,2016-12-11 22:19:34+00:00,['39017adffc0cb13ebbdab89902d8403faf9a2b4b'],7,6,13,5215542,1,,,,3648
ffbdeda9469997dce6c6c3a80c78877486a3bdd9,0,Impala Public Jenkins,2016-12-13 01:56:28+00:00,['2414d4c9c6f48e86629a87d454dc4ecf8691267d'],0,10,10,5215552,1,0,0,1,3648
73e41cea196703701d40cc67f919287fb3511b9b,1,Internal Jenkins,2016-12-13 03:12:42+00:00,['ffbdeda9469997dce6c6c3a80c78877486a3bdd9'],0,11,11,5215563,1,1,0,0,3648
40c7c52510d362a4b3b842768e22d546b3a0ed90,0,Matthew Jacobs,2016-12-13 14:56:46+00:00,['73e41cea196703701d40cc67f919287fb3511b9b'],6,7,13,5215576,1,,,,3648
619bf26435a18da37417a47df78adc06ad07bc75,0,Internal Jenkins,2016-12-13 20:40:56+00:00,['40c7c52510d362a4b3b842768e22d546b3a0ed90'],1,1,2,5215578,1,,,,3648
b222d90bd8b4c0d4ab7e19aecbb96ac68404cf96,0,Impala Public Jenkins,2016-12-13 22:02:32+00:00,['619bf26435a18da37417a47df78adc06ad07bc75'],82,16,98,5215676,3,,,,3648
652e7d56d9ac52a8c3d36ca4b04298d4b89897aa,1,Internal Jenkins,2016-12-14 23:24:47+00:00,['b222d90bd8b4c0d4ab7e19aecbb96ac68404cf96'],28,19,47,5215723,3,0.666666667,0,1,3648
e6ef3b409027ffa66d5851a3a49d06fc636b1302,0,Impala Public Jenkins,2016-12-14 23:38:08+00:00,['652e7d56d9ac52a8c3d36ca4b04298d4b89897aa'],244,0,244,5215967,1,,,,3648
fc4ee65f9f51581915df55bfa07aaacc6eb610d0,1,Impala Public Jenkins,2016-12-14 23:42:19+00:00,['e6ef3b409027ffa66d5851a3a49d06fc636b1302'],66,85,151,5216118,8,,,,3648
246acba0b37f61e708c17ea55f2300ef96908fd1,1,Impala Public Jenkins,2016-12-15 01:31:28+00:00,['fc4ee65f9f51581915df55bfa07aaacc6eb610d0'],25,41,66,5216184,1,1,1,1,3648
6c5f8e3f5e3bdcb87f65d96b7af35aee8874cfb4,1,Internal Jenkins,2016-12-15 02:45:50+00:00,['246acba0b37f61e708c17ea55f2300ef96908fd1'],0,24,24,5216208,3,0.666666667,1,1,3648
4fa9270e647b9c097295dcc13d97136cca3139ad,0,Internal Jenkins,2016-12-15 04:39:22+00:00,['6c5f8e3f5e3bdcb87f65d96b7af35aee8874cfb4'],4,5,9,5216217,2,,,,3648
2eef39d7aea019e2aad7764d1cb590105f4cd5f6,0,Impala Public Jenkins,2016-12-15 08:01:22+00:00,['4fa9270e647b9c097295dcc13d97136cca3139ad'],0,857,857,5217074,6,0.406824147,0.80839895,0.900262467,3651
44ae9fceadb296bc386e91711e02866ad1411e88,0,Impala Public Jenkins,2016-12-15 21:37:17+00:00,['2eef39d7aea019e2aad7764d1cb590105f4cd5f6'],3,8,11,5217085,3,,,,3651
d6eb1b107d584cd181468fa8096d7f2ad59dd708,1,Impala Public Jenkins,2016-12-15 21:51:00+00:00,['44ae9fceadb296bc386e91711e02866ad1411e88'],1,1,2,5217087,1,,,,3651
54194af6ef08048a1ae367f29350228dafd8f2aa,0,Dan Hecht,2016-12-15 22:37:47+00:00,['d6eb1b107d584cd181468fa8096d7f2ad59dd708'],24,16,40,5217127,4,0,0,0,3651
c2faf4a8a13ba89f2f4f2bc4fbd878cffda53d1f,0,Internal Jenkins,2016-12-15 23:00:24+00:00,['54194af6ef08048a1ae367f29350228dafd8f2aa'],3,20,23,5217150,2,0,0,0,3651
c40958f3ff2bbc27b17c9e6acb3c2a69442f6aeb,0,Internal Jenkins,2016-12-16 08:07:07+00:00,['c2faf4a8a13ba89f2f4f2bc4fbd878cffda53d1f'],10,19,29,5217179,1,0,0,1,3651
26f0b4612c0d30e45a5850fdf576b4fc4ce86daf,0,Internal Jenkins,2016-12-17 00:26:12+00:00,['c40958f3ff2bbc27b17c9e6acb3c2a69442f6aeb'],1,2,3,5217182,1,,,,3651
68131b311577e6e16bfe5ef08b17a2312cc65296,0,Internal Jenkins,2016-12-17 00:32:46+00:00,['26f0b4612c0d30e45a5850fdf576b4fc4ce86daf'],16,3,19,5217201,1,1,1,0,3651
ce9b332ee9e640d79c8ae35e7abb8c7d787ddf78,1,Internal Jenkins,2016-12-17 05:37:43+00:00,['68131b311577e6e16bfe5ef08b17a2312cc65296'],139,489,628,5217829,13,0.325757576,1,0.984848485,3652
2159beee89d463be9b69886c95ad73271db49280,1,Impala Public Jenkins,2016-12-20 01:33:01+00:00,['ce9b332ee9e640d79c8ae35e7abb8c7d787ddf78'],284,725,1009,5218838,3,0.125,0.145348837,0.784883721,3652
c03d398da63139b2448fb67a9721fb3a8a571ded,0,Internal Jenkins,2016-12-20 05:58:36+00:00,['2159beee89d463be9b69886c95ad73271db49280'],5,5,10,5218848,1,,,,3652
73146a0a46817660505fa37957d44d73f020bc65,1,Internal Jenkins,2016-12-21 00:22:16+00:00,['c03d398da63139b2448fb67a9721fb3a8a571ded'],2,4,6,5218854,1,1,1,0,3652
ba8c135ef8a107eca6744ec063e4366d55374e07,0,Internal Jenkins,2016-12-21 04:08:38+00:00,['73146a0a46817660505fa37957d44d73f020bc65'],2,2,4,5218858,1,,,,3652
226a2e63321e9bcf4ba906512fc40e35b98db252,0,Internal Jenkins,2016-12-22 01:18:56+00:00,['ba8c135ef8a107eca6744ec063e4366d55374e07'],8,26,34,5218892,1,0,0,0,3652
b3636c97d4b872e1640955974409c57459d655e0,1,Internal Jenkins,2016-12-22 10:45:39+00:00,['226a2e63321e9bcf4ba906512fc40e35b98db252'],9,25,34,5218926,4,1,1,0,3652
5eef1bf82e08134cd85d916a208bf51450ac2b2a,0,Tim Armstrong,2016-12-22 23:41:27+00:00,['b3636c97d4b872e1640955974409c57459d655e0'],1,0,1,5218927,1,,,,3652
218ed9215648427dc08ece675e2a90088b71aa6c,1,Impala Public Jenkins,2016-12-28 05:25:38+00:00,['5eef1bf82e08134cd85d916a208bf51450ac2b2a'],3,33,36,5218963,5,0.875,0.875,1,3652
756231880880564318b7636e44e9d9f14b556cf0,0,Impala Public Jenkins,2016-12-28 17:58:05+00:00,['218ed9215648427dc08ece675e2a90088b71aa6c'],1,1,2,5218965,1,,,,3652
25ebf586e00adc058412fd083b5c4768fa16cc7d,1,Internal Jenkins,2017-01-04 12:12:04+00:00,['756231880880564318b7636e44e9d9f14b556cf0'],26,35,61,5219026,7,0,0.5,1,3652
6b90aa3a115f8274a5380945bc4e2b940ef4f711,1,Impala Public Jenkins,2017-01-05 01:43:36+00:00,['25ebf586e00adc058412fd083b5c4768fa16cc7d'],97,138,235,5219261,3,,,,3653
95ed4434f2f446e214934f7dc251b843c1d6b0a6,1,Impala Public Jenkins,2017-01-05 02:26:24+00:00,['6b90aa3a115f8274a5380945bc4e2b940ef4f711'],747,1331,2078,5221339,21,0.404081633,1,0.824489796,3655
6d15f03777afeb1375927ad9520a5db5bc9d42a1,1,Impala Public Jenkins,2017-01-05 04:15:30+00:00,['95ed4434f2f446e214934f7dc251b843c1d6b0a6'],72,77,149,5221488,2,0,0,0,3655
fac000d311db365f6c770de4e5205a506d209a5b,1,Impala Public Jenkins,2017-01-05 19:22:49+00:00,['6d15f03777afeb1375927ad9520a5db5bc9d42a1'],97,96,193,5221681,4,1,0,0,3655
4ce5213d16397c009e9eec93655ca434b5f83ade,0,Impala Public Jenkins,2017-01-05 19:40:08+00:00,['fac000d311db365f6c770de4e5205a506d209a5b'],38,0,38,5221719,2,0.964285714,0,0,3655
ede22bad980447dcb8967295911f4d8026a57b85,0,Henry Robinson,2017-01-05 21:38:23+00:00,['4ce5213d16397c009e9eec93655ca434b5f83ade'],2,2,4,5221723,1,,,,3655
66260bda9ea36bc59396492c83788bb2a786ec88,0,Impala Public Jenkins,2017-01-05 21:51:59+00:00,['ede22bad980447dcb8967295911f4d8026a57b85'],1,1,2,5221725,1,,,,3655
81c3653b9685d15789675c73ec7b0ff93ccd6953,0,Impala Public Jenkins,2017-01-05 22:57:37+00:00,['66260bda9ea36bc59396492c83788bb2a786ec88'],1,4,5,5221730,1,,,,3655
c4ee03a7e595e38886e6688182338a933a391285,0,John Russell,2017-01-05 23:55:45+00:00,['81c3653b9685d15789675c73ec7b0ff93ccd6953'],50,51,101,5221831,21,,,,3655
9fa2ff7138c5385277aec128b74d079aff902617,1,Impala Public Jenkins,2017-01-06 21:32:15+00:00,['c4ee03a7e595e38886e6688182338a933a391285'],0,24,24,5221855,2,1,1,1,3655
e98a65c65f6c619c89be30eab56e4aafb4c749dd,0,John Russell,2017-01-07 00:12:58+00:00,['9fa2ff7138c5385277aec128b74d079aff902617'],18,18,36,5221891,1,,,,3655
37827ed17b114b7cd42089c9b4895966c2f700d6,0,John Russell,2017-01-07 00:17:54+00:00,['e98a65c65f6c619c89be30eab56e4aafb4c749dd'],45,2,47,5221938,2,,,,3655
1184b33cd461604b2d8019d85e22fa04eba52c74,1,John Russell,2017-01-07 00:19:21+00:00,['37827ed17b114b7cd42089c9b4895966c2f700d6'],5,4,9,5221947,2,,,,3655
1072d076e474d1c9d3edb009ed553cd97f05636a,0,John Russell,2017-01-07 00:23:39+00:00,['1184b33cd461604b2d8019d85e22fa04eba52c74'],2,2,4,5221951,1,,,,3655
f3de156966b260514b65ddbc64c0f2e5c47914fa,0,John Russell,2017-01-07 00:23:53+00:00,['1072d076e474d1c9d3edb009ed553cd97f05636a'],1,0,1,5221952,1,,,,3655
62ec6de367f7d6c69a8e5ad6d79bcecd5dfc87f7,0,John Russell,2017-01-07 00:30:46+00:00,['f3de156966b260514b65ddbc64c0f2e5c47914fa'],7,11,18,5221970,2,,,,3655
7b1913afbc28c53aee704474bf101d5cba44c764,0,John Russell,2017-01-07 00:38:24+00:00,['62ec6de367f7d6c69a8e5ad6d79bcecd5dfc87f7'],1,1,2,5221972,1,,,,3655
11dc6bbb3af7f682c06cd9fbf1bd576eb0a065f5,0,Impala Public Jenkins,2017-01-07 03:21:36+00:00,['7b1913afbc28c53aee704474bf101d5cba44c764'],44,3,47,5222019,1,,,,3655
0ee6d19d596da1520733b6d1b064b26c002eb876,0,Impala Public Jenkins,2017-01-08 23:52:01+00:00,['11dc6bbb3af7f682c06cd9fbf1bd576eb0a065f5'],1,1,2,5222021,1,,,,3655
889494004e429a7dab4e693e737ca2a6dd7799b9,1,Impala Public Jenkins,2017-01-09 19:16:58+00:00,['0ee6d19d596da1520733b6d1b064b26c002eb876'],1,13,14,5222035,1,0,0,0,3655
63a9f3e19426a6e70f9de68472d080f98ce456a1,0,Impala Public Jenkins,2017-01-10 01:12:58+00:00,['889494004e429a7dab4e693e737ca2a6dd7799b9'],1,1,2,5222037,1,,,,3655
ac59489df9a96fe4770a907fe479c605ed05a12b,0,Impala Public Jenkins,2017-01-10 21:16:57+00:00,['63a9f3e19426a6e70f9de68472d080f98ce456a1'],2,16,18,5222055,2,1,1,1,3655
0cb76b6e5e6c64057611fb1eba82f6a40acfec1f,0,Impala Public Jenkins,2017-01-11 00:31:53+00:00,['ac59489df9a96fe4770a907fe479c605ed05a12b'],1,2,3,5222058,1,0,0,1,3655
09aa7618604e2f184d29c1615d99d6d305e7e5e2,1,Impala Public Jenkins,2017-01-11 00:43:16+00:00,['0cb76b6e5e6c64057611fb1eba82f6a40acfec1f'],18,16,34,5222092,1,1,0,0,3655
75027c913b9eaac8f983cff5b3ad26e8f316c1a9,0,Impala Public Jenkins,2017-01-11 03:47:29+00:00,['09aa7618604e2f184d29c1615d99d6d305e7e5e2'],2,2,4,5222096,1,,,,3655
6a2c9049ffe1fc914508c880ab66eaae8bd5f07e,0,Impala Public Jenkins,2017-01-11 23:38:00+00:00,['75027c913b9eaac8f983cff5b3ad26e8f316c1a9'],0,101,101,5222197,2,,,,3656
70ae2e38eb0c4f9be0084e057c70ba427bbbbcfc,1,Impala Public Jenkins,2017-01-12 02:31:44+00:00,['6a2c9049ffe1fc914508c880ab66eaae8bd5f07e'],10,28,38,5222235,7,1,0.5,0,3656
44bb99a61d03ac52097a7d2f7928a0c5be13a7de,1,Impala Public Jenkins,2017-01-12 02:53:45+00:00,['70ae2e38eb0c4f9be0084e057c70ba427bbbbcfc'],1,160,161,5222396,2,,,,3657
5d028d93b9b796af448c72396d99ccba43790f72,1,Impala Public Jenkins,2017-01-12 03:54:15+00:00,['44bb99a61d03ac52097a7d2f7928a0c5be13a7de'],15,23,38,5222434,5,0.166666667,0.166666667,1,3657
4b3fdc33019ffd6eeee075e9c8f233d99f066121,1,Henry Robinson,2017-01-12 05:18:17+00:00,['5d028d93b9b796af448c72396d99ccba43790f72'],2,250,252,5222686,5,,,,3658
ed0aa66ee1ec3dd31f451ec70432bf58c6b682c4,0,Henry Robinson,2017-01-12 05:18:33+00:00,['4b3fdc33019ffd6eeee075e9c8f233d99f066121'],1,4,5,5222691,1,,,,3658
1a611b39311837139b21b0acd4e803477510bbfc,1,Impala Public Jenkins,2017-01-12 05:42:41+00:00,['ed0aa66ee1ec3dd31f451ec70432bf58c6b682c4'],6,20,26,5222717,4,,,,3658
8b7f876649c34dec7fee1dea34f5acf4db1c037d,0,Impala Public Jenkins,2017-01-12 18:58:48+00:00,['1a611b39311837139b21b0acd4e803477510bbfc'],9,15,24,5222741,2,0.333333333,1,0.666666667,3658
5755261954d71b05b5e56c8659edd17de88b2d93,0,Henry Robinson,2017-01-12 20:41:35+00:00,['8b7f876649c34dec7fee1dea34f5acf4db1c037d'],3,8,11,5222752,3,1,1,1,3658
54665120cbf4f242688659941ac50bacc8c221c8,1,Impala Public Jenkins,2017-01-12 21:40:39+00:00,['5755261954d71b05b5e56c8659edd17de88b2d93'],100,370,470,5223222,17,0.050420168,0.655462185,0.672268908,3659
a81ad5eaab8a088e1fc1429449a1c15b029cffdb,0,Henry Robinson,2017-01-12 23:44:26+00:00,['54665120cbf4f242688659941ac50bacc8c221c8'],3,51,54,5223276,4,,,,3660
60c41c4f0fcfbd241cbf4163b09fbe7b28a98e81,0,Henry Robinson,2017-01-12 23:50:14+00:00,['a81ad5eaab8a088e1fc1429449a1c15b029cffdb'],2,49,51,5223327,4,,,,3661
db7facdee0017965e276c830e2aee16590f7ce37,0,Impala Public Jenkins,2017-01-13 01:31:47+00:00,['60c41c4f0fcfbd241cbf4163b09fbe7b28a98e81'],90,265,355,5223682,8,0.294117647,0.611764706,0.670588235,3661
b989efbb5607f45f0873d25764b5adc21cb87535,1,Impala Public Jenkins,2017-01-13 03:02:03+00:00,['db7facdee0017965e276c830e2aee16590f7ce37'],96,112,208,5223890,15,1,1,,3661
c4f2458e394cbba793e65ffeebac09e948b6198c,0,Impala Public Jenkins,2017-01-13 03:14:49+00:00,['b989efbb5607f45f0873d25764b5adc21cb87535'],23,13,36,5223926,1,0,0,0,3661
89a3d3c1ebf85629bb20457a9672d71fbf2504ca,0,Impala Public Jenkins,2017-01-13 04:44:07+00:00,['c4f2458e394cbba793e65ffeebac09e948b6198c'],4,35,39,5223965,3,0.714285714,0.714285714,1,3661
60a67cb7c12aea34d5ff8b89342893eeca8cb60b,0,Impala Public Jenkins,2017-01-13 04:46:05+00:00,['89a3d3c1ebf85629bb20457a9672d71fbf2504ca'],12,12,24,5223989,1,,,,3661
09c77a879e707c8fee1b7e2a6f9ca9e2b17673a1,0,Impala Public Jenkins,2017-01-13 19:58:46+00:00,['60a67cb7c12aea34d5ff8b89342893eeca8cb60b'],1,2,3,5223992,2,,,,3661
2665866c16cc4ddcf23d563bc1c37cd457bd248b,0,Impala Public Jenkins,2017-01-13 22:28:28+00:00,['09c77a879e707c8fee1b7e2a6f9ca9e2b17673a1'],882,895,1777,5225769,2,,,,3662
fa4a054cde012fc0cfc74b79cbdb7008491226bb,0,Impala Public Jenkins,2017-01-15 08:38:13+00:00,['2665866c16cc4ddcf23d563bc1c37cd457bd248b'],21,34,55,5225824,1,0,1,1,3662
3b7a179197bccdebf9c8492477f0cf88c6df0e18,1,Impala Public Jenkins,2017-01-17 02:25:11+00:00,['fa4a054cde012fc0cfc74b79cbdb7008491226bb'],39,39,78,5225902,5,1,1,1,3662
8377b9949cef975881e7f64eadb9400fcbf157b3,1,Impala Public Jenkins,2017-01-18 19:31:57+00:00,['3b7a179197bccdebf9c8492477f0cf88c6df0e18'],642,642,1284,5227186,176,,,,3662
7d9e76620743cced2c09e03cbc7ee9e4b4d7380b,0,Impala Public Jenkins,2017-01-18 20:05:53+00:00,['8377b9949cef975881e7f64eadb9400fcbf157b3'],24,22,46,5227232,1,,,,3662
69859bddfb058d742cece7d7c2e3e3f07f29bb6a,1,Impala Public Jenkins,2017-01-19 00:04:27+00:00,['7d9e76620743cced2c09e03cbc7ee9e4b4d7380b'],27,33,60,5227292,6,0,1,1,3662
85edc15fefe9ab9b2883b9c9f7451efc7e26ff94,1,Impala Public Jenkins,2017-01-19 02:34:39+00:00,['69859bddfb058d742cece7d7c2e3e3f07f29bb6a'],352,371,723,5228015,25,1,1,0,3662
31025ab10e838b8d575481c944a42ce10cf2ee41,1,Impala Public Jenkins,2017-01-19 05:35:23+00:00,['85edc15fefe9ab9b2883b9c9f7451efc7e26ff94'],16,61,77,5228092,4,0.36,1,0.68,3662
a5044a30c664dc55a221e7c31efe9e49a689a512,0,Tim Armstrong,2017-01-19 17:05:52+00:00,['31025ab10e838b8d575481c944a42ce10cf2ee41'],1,1,2,5228094,1,,,,3662
6cf3efdfec7cb9245b2b8ce2196e9629f4fe3f89,0,Jim Apple,2017-01-19 22:57:00+00:00,['a5044a30c664dc55a221e7c31efe9e49a689a512'],3,3,6,5228100,1,,,,3662
743873005225c55240de7181eea7bb438a260ff1,1,Impala Public Jenkins,2017-01-20 01:18:10+00:00,['6cf3efdfec7cb9245b2b8ce2196e9629f4fe3f89'],2,56,58,5228158,2,0,1,1,3662
fe2be25245280492c9a6b5b4e20e066b244fb808,0,Impala Public Jenkins,2017-01-20 02:24:47+00:00,['743873005225c55240de7181eea7bb438a260ff1'],9,11,20,5228178,3,0,0,1,3662
3426a04952eb5ee906b732b4644ce77c0d24fa7e,1,Impala Public Jenkins,2017-01-20 21:13:37+00:00,['fe2be25245280492c9a6b5b4e20e066b244fb808'],73,183,256,5228434,3,0,0,1,3662
a2041dddb7a054fe8a53db0e19474c803b29d728,0,Impala Public Jenkins,2017-01-21 09:49:29+00:00,['3426a04952eb5ee906b732b4644ce77c0d24fa7e'],1,1,2,5228436,1,,,,3662
4b486b0f90936ab5bc32daf0859bc74b340dd179,1,Impala Public Jenkins,2017-01-24 03:22:08+00:00,['a2041dddb7a054fe8a53db0e19474c803b29d728'],13,406,419,5228855,7,0.208092486,0.589595376,0.976878613,3664
cb52b2b8aebfe24e09743fca3c32936fa85105d2,0,Tim Armstrong,2017-01-24 18:49:24+00:00,['4b486b0f90936ab5bc32daf0859bc74b340dd179'],19,58,77,5228932,5,0,1,0.944444444,3664
eaefbb90cefc65fc7a0520b8a18f8bf4d03d99ad,0,Impala Public Jenkins,2017-01-25 18:39:12+00:00,['cb52b2b8aebfe24e09743fca3c32936fa85105d2'],3,186,189,5229121,4,,,,3664
2a314e780eb22279e6a9bc402744f96f06a5c99c,0,Impala Public Jenkins,2017-01-25 21:06:23+00:00,['eaefbb90cefc65fc7a0520b8a18f8bf4d03d99ad'],4,15,19,5229140,2,,,,3664
406632640d44c9eb45286d4ed73192b6c16daf2f,0,Impala Public Jenkins,2017-01-26 01:32:09+00:00,['2a314e780eb22279e6a9bc402744f96f06a5c99c'],3,5,8,5229148,1,,,,3664
6154a695b738c654fd8f094a5e6d31b1018ff687,1,Impala Public Jenkins,2017-01-26 09:24:05+00:00,['406632640d44c9eb45286d4ed73192b6c16daf2f'],12,25,37,5229185,3,1,1,0.384615385,3664
cca1eaa6f91eb0f167d59001c02c9e6a2da3495a,0,Impala Public Jenkins,2017-01-26 18:23:18+00:00,['6154a695b738c654fd8f094a5e6d31b1018ff687'],2,2,4,5229189,2,,,,3664
253ea71281d259a62f75527c429096a74a5e5075,1,Impala Public Jenkins,2017-01-26 21:25:35+00:00,['cca1eaa6f91eb0f167d59001c02c9e6a2da3495a'],386,1132,1518,5230707,16,0.4,0.715492958,0.847887324,3666
f590bc0da63ea957aa2be21f2dda8d67e6794d68,1,Impala Public Jenkins,2017-01-26 23:40:22+00:00,['253ea71281d259a62f75527c429096a74a5e5075'],392,457,849,5231556,81,0.634920635,0.746031746,1,3666
fc721fbd0691e03cee3f2e77dadd71da263a6d72,0,Impala Public Jenkins,2017-01-27 21:12:56+00:00,['f590bc0da63ea957aa2be21f2dda8d67e6794d68'],49,330,379,5231935,5,,,,3666
6a95f42022300540f485efda0252e1fe85f07823,0,Impala Public Jenkins,2017-01-27 23:49:37+00:00,['fc721fbd0691e03cee3f2e77dadd71da263a6d72'],1,223,224,5232159,5,,,,3667
98ff43c68dd0432ba108d195229e5a5f5c345d2d,0,Impala Public Jenkins,2017-01-27 23:52:05+00:00,['6a95f42022300540f485efda0252e1fe85f07823'],1,7,8,5232167,1,,,,3667
59dfa1f8f6fa81cb3a085d6ceab0ad126a3a0c2e,0,Impala Public Jenkins,2017-01-27 23:52:10+00:00,['98ff43c68dd0432ba108d195229e5a5f5c345d2d'],0,25,25,5232192,1,,,,3667
a0ec519362ce679485026909a6ef7a8d7dfc355d,0,Impala Public Jenkins,2017-01-28 01:06:19+00:00,['59dfa1f8f6fa81cb3a085d6ceab0ad126a3a0c2e'],19,20,39,5232231,1,,,,3667
7b8ffd35534c11ae3caa048229effc97613cd34f,1,Impala Public Jenkins,2017-01-28 09:22:09+00:00,['a0ec519362ce679485026909a6ef7a8d7dfc355d'],18,59,77,5232308,2,0,0.090909091,1,3667
dde559b3190a0cbe381352abfe258cba326b4213,0,Jim Apple,2017-01-29 00:01:03+00:00,['7b8ffd35534c11ae3caa048229effc97613cd34f'],1,1,2,5232310,1,,,,3667
a4206d3f1c5504c430e7d52255c673ae3de646c5,0,Tim Armstrong,2017-01-30 22:06:29+00:00,['dde559b3190a0cbe381352abfe258cba326b4213'],5,73,78,5232388,4,0.058823529,1,1,3667
a4eb4705c3796b1129b33cc99dd96ee8d8bddafb,1,Impala Public Jenkins,2017-01-31 10:27:20+00:00,['a4206d3f1c5504c430e7d52255c673ae3de646c5'],219,203,422,5232810,38,0.815789474,1,0,3667
446d95eed38d4aae38235ead0a0f41f3323999c8,0,Impala Public Jenkins,2017-01-31 22:12:40+00:00,['a4eb4705c3796b1129b33cc99dd96ee8d8bddafb'],1,1,2,5232812,1,,,,3667
8f59ce9dfc636cc9f6f03ca9f5ee289ca7cca602,1,Impala Public Jenkins,2017-01-31 22:17:13+00:00,['446d95eed38d4aae38235ead0a0f41f3323999c8'],9,107,116,5232928,3,0.775510204,0.571428571,0.693877551,3667
e3566ac048a122a8c6c88ac696a3cb1f9f31b2fc,0,Impala Public Jenkins,2017-02-01 07:56:56+00:00,['8f59ce9dfc636cc9f6f03ca9f5ee289ca7cca602'],1,1,2,5232930,1,,,,3667
32ff959814646458a34278500bd01fc7741951ce,0,Impala Public Jenkins,2017-02-01 23:42:50+00:00,['e3566ac048a122a8c6c88ac696a3cb1f9f31b2fc'],7,7,14,5232944,1,,,,3667
a5b768953d3cff909f1ed1c5aa4e4607de062d08,0,Impala Public Jenkins,2017-02-02 00:23:50+00:00,['32ff959814646458a34278500bd01fc7741951ce'],0,2,2,5232946,1,,,,3667
6251d8b4ddac3bdd6fb651f000aea15b7a0d1603,1,Tim Armstrong,2017-02-02 06:44:48+00:00,['a5b768953d3cff909f1ed1c5aa4e4607de062d08'],119,792,911,5233857,8,0.514880952,0.863095238,0.49702381,3668
e5c098b0765bc17bfc4c2517abcbd040cb1dc307,1,Jim Apple,2017-02-02 21:27:39+00:00,['6251d8b4ddac3bdd6fb651f000aea15b7a0d1603'],63,78,141,5233998,2,1,0,0,3668
5b8b61864e321978891c21fe7e90545ba798b930,0,Impala Public Jenkins,2017-02-03 00:13:38+00:00,['e5c098b0765bc17bfc4c2517abcbd040cb1dc307'],2,2,4,5234002,1,,,,3668
59cdf6b8f2a6180b727bcb9ee336a65381377ace,1,Impala Public Jenkins,2017-02-03 00:30:35+00:00,['5b8b61864e321978891c21fe7e90545ba798b930'],8,185,193,5234195,3,0.406976744,0.593023256,1,3669
3b36e939c0b18d79be079da79881865e83e4bdb2,1,Impala Public Jenkins,2017-02-03 03:40:06+00:00,['59cdf6b8f2a6180b727bcb9ee336a65381377ace'],6,17,23,5234218,1,0,1,1,3669
3ee981079d0dd086d656a1ecd54bc873b91c67e3,1,Impala Public Jenkins,2017-02-03 04:52:46+00:00,['3b36e939c0b18d79be079da79881865e83e4bdb2'],34,66,100,5234318,3,0.764705882,0.764705882,1,3669
933f2ce7fd17ebcee8c150f93ff4488f746232dd,0,Impala Public Jenkins,2017-02-03 05:16:09+00:00,['3ee981079d0dd086d656a1ecd54bc873b91c67e3'],2,2,4,5234322,2,,,,3669
1d933919ee964d8766ba028623d66ec20cd123ac,1,Impala Public Jenkins,2017-02-03 23:35:25+00:00,['933f2ce7fd17ebcee8c150f93ff4488f746232dd'],234,225,459,5234781,16,0,0,0,3669
7704b64df0bce05a73b33825c404498ef9fbba48,0,Impala Public Jenkins,2017-02-04 00:23:19+00:00,['1d933919ee964d8766ba028623d66ec20cd123ac'],22,15,37,5234818,2,,,,3669
0f8ae355cee00e1d7b0ee47814d31f7337926bcc,1,Impala Public Jenkins,2017-02-04 01:13:35+00:00,['7704b64df0bce05a73b33825c404498ef9fbba48'],4,17,21,5234839,4,0,0,0,3669
c452595bff5840f86b35f44d677558d3a940ceab,1,Impala Public Jenkins,2017-02-04 01:47:23+00:00,['0f8ae355cee00e1d7b0ee47814d31f7337926bcc'],207,858,1065,5235904,17,0.089108911,0.844884488,0.867986799,3670
39987d9bd130cb83483215d31197ec3c9a719b9d,1,Impala Public Jenkins,2017-02-04 04:17:06+00:00,['c452595bff5840f86b35f44d677558d3a940ceab'],19,64,83,5235987,5,0.594594595,0.945945946,0.891891892,3670
0154ace61feff65917388dd08591cb9d0d4369ed,0,Impala Public Jenkins,2017-02-04 06:13:34+00:00,['39987d9bd130cb83483215d31197ec3c9a719b9d'],70,296,366,5236353,6,0.2,0.32,1,3670
bdd39f6a86a582669e6aea4b55b4222700861041,0,Impala Public Jenkins,2017-02-06 04:20:58+00:00,['0154ace61feff65917388dd08591cb9d0d4369ed'],1,4,5,5236358,1,,,,3670
6a9df540967e07b09524268d0cc52b7d10835676,1,Impala Public Jenkins,2017-02-06 20:22:33+00:00,['bdd39f6a86a582669e6aea4b55b4222700861041'],40,233,273,5236631,4,0.350649351,0.376623377,0.883116883,3670
367117594ab7e7be0176601cf74962e875afa766,0,Impala Public Jenkins,2017-02-07 00:07:17+00:00,['6a9df540967e07b09524268d0cc52b7d10835676'],14,13,27,5236658,2,1,0,0.666666667,3670
c671ee1ece5fde1a5db40621cb27480dff74bc49,0,Impala Public Jenkins,2017-02-07 04:19:06+00:00,['367117594ab7e7be0176601cf74962e875afa766'],7,8,15,5236673,2,,,,3670
d074f71d819b876c907068634ba7a431ac1f2e9b,1,Impala Public Jenkins,2017-02-08 00:57:35+00:00,['c671ee1ece5fde1a5db40621cb27480dff74bc49'],20,22,42,5236715,9,,,,3670
fcc2d817b857fd0d57eabe2b5af89631e58c8186,1,Impala Public Jenkins,2017-02-08 02:02:15+00:00,['d074f71d819b876c907068634ba7a431ac1f2e9b'],102,166,268,5236983,8,0.021276596,0,0.595744681,3670
8de2884e8ba635c51af4f5d6fe8d12a369db4bd6,1,Impala Public Jenkins,2017-02-08 04:38:22+00:00,['fcc2d817b857fd0d57eabe2b5af89631e58c8186'],71,120,191,5237174,2,1,0,0,3670
4419d5f7f44ab21fad9adc130ee7b71c1078fb91,1,Impala Public Jenkins,2017-02-08 22:14:20+00:00,['8de2884e8ba635c51af4f5d6fe8d12a369db4bd6'],193,9836,10029,5247203,1,,,,3670
82290d61adc53f10342276e96e32e889385eecf8,0,Impala Public Jenkins,2017-02-09 00:50:15+00:00,['4419d5f7f44ab21fad9adc130ee7b71c1078fb91'],1,5,6,5247209,2,,,,3670
87cec889d091448d8cc0e0b00070fe324e97551f,0,Impala Public Jenkins,2017-02-09 19:30:22+00:00,['82290d61adc53f10342276e96e32e889385eecf8'],3,0,3,5247212,1,0,0,0,3670
3edc9099bcd1b2e962c83575bbb38155b77b780e,0,Impala Public Jenkins,2017-02-09 20:36:22+00:00,['87cec889d091448d8cc0e0b00070fe324e97551f'],1,16,17,5247229,2,,,,3670
4a7946da583f7813eab9e40230ea026c1c172cb5,0,Impala Public Jenkins,2017-02-09 21:11:31+00:00,['3edc9099bcd1b2e962c83575bbb38155b77b780e'],2,2,4,5247233,1,,,,3670
77208d36520b1118ec66a674980d3e7b954a7b1c,1,Impala Public Jenkins,2017-02-09 22:19:44+00:00,['4a7946da583f7813eab9e40230ea026c1c172cb5'],93,84,177,5247410,5,,,,3670
1335af3684ec54b63a9602816b2cda776b40ce2f,0,Dan Hecht,2017-02-10 01:28:16+00:00,['77208d36520b1118ec66a674980d3e7b954a7b1c'],18,47,65,5247475,3,0,0,0,3670
d2d3f4c1a6eefb3f1335da8bd6791fbebd63d98b,1,Impala Public Jenkins,2017-02-10 02:18:32+00:00,['1335af3684ec54b63a9602816b2cda776b40ce2f'],247,500,747,5248222,26,0.922580645,0.806451613,0.612903226,3670
6242478d0c06c8ee92310632a4903e56e50fe40a,0,Impala Public Jenkins,2017-02-10 21:34:54+00:00,['d2d3f4c1a6eefb3f1335da8bd6791fbebd63d98b'],1,1,2,5248224,1,,,,3670
af4699847090ff7d03a588aa1b2e48170c64f03f,1,Impala Public Jenkins,2017-02-11 01:34:13+00:00,['6242478d0c06c8ee92310632a4903e56e50fe40a'],8,110,118,5248342,3,0,0,0.789473684,3670
a78726db308f41c3a7a710cda8f049d21793bc42,0,Impala Public Jenkins,2017-02-11 03:30:15+00:00,['af4699847090ff7d03a588aa1b2e48170c64f03f'],87,101,188,5248530,2,0,1,0.888888889,3670
f982c3f76e762f646b52a01659796b4edcfbc1ad,1,Impala Public Jenkins,2017-02-11 07:07:45+00:00,['a78726db308f41c3a7a710cda8f049d21793bc42'],492,646,1138,5249668,29,0.032258065,0.903225806,0,3670
cd153d66dc20ebea7a9de7a2ef1c627fee45253c,0,Alex Behm,2017-02-13 23:00:01+00:00,['f982c3f76e762f646b52a01659796b4edcfbc1ad'],24,190,214,5249882,4,0.928571429,0,0.928571429,3670
1f80396b20529e6e77d4edbd7d3d62b29a106568,0,Impala Public Jenkins,2017-02-14 05:56:33+00:00,['cd153d66dc20ebea7a9de7a2ef1c627fee45253c'],66,129,195,5250077,3,1,1,0,3671
065bbda991adad716c7ff77c80245ca48d0c8ba4,0,Impala Public Jenkins,2017-02-14 09:07:51+00:00,['1f80396b20529e6e77d4edbd7d3d62b29a106568'],1,3,4,5250081,1,,,,3671
a53eeb2068970ff7575f4f3fdf3c383861a75f2d,1,Impala Public Jenkins,2017-02-14 18:40:54+00:00,['065bbda991adad716c7ff77c80245ca48d0c8ba4'],148,374,522,5250603,11,0.565217391,0.550724638,0.507246377,3672
9e36088c8d2859bfb862aa19fc1c6b68172a195e,0,Impala Public Jenkins,2017-02-14 21:09:45+00:00,['a53eeb2068970ff7575f4f3fdf3c383861a75f2d'],2,2,4,5250607,1,,,,3672
894bb7785519f4f00d1af52e9c6602c43396503c,1,Impala Public Jenkins,2017-02-14 21:51:39+00:00,['9e36088c8d2859bfb862aa19fc1c6b68172a195e'],39,52,91,5250698,7,0,,,3672
0715a303ea0db01c108ece3d7692da158ada5c20,1,Impala Public Jenkins,2017-02-15 01:33:23+00:00,['894bb7785519f4f00d1af52e9c6602c43396503c'],12,400,412,5251110,14,0.238095238,0.199134199,0.619047619,3672
cec3fe35740ed76065ac60f0d28ea3ca98c5e600,1,Impala Public Jenkins,2017-02-15 10:12:58+00:00,['0715a303ea0db01c108ece3d7692da158ada5c20'],36,27,63,5251173,1,1,0,0.5,3672
ffd297bdea5d58db3d1791a2528b7f1009a459c6,0,Impala Public Jenkins,2017-02-15 22:16:30+00:00,['cec3fe35740ed76065ac60f0d28ea3ca98c5e600'],19,65,84,5251257,6,0,0,1,3672
bd1d445b37f3cfc56ff868a678caf161b29a9d92,1,Impala Public Jenkins,2017-02-15 22:45:50+00:00,['ffd297bdea5d58db3d1791a2528b7f1009a459c6'],7,6,13,5251270,1,,,,3672
26eaa266092a5d8b37e21fd19dfbae81a952ac74,1,Impala Public Jenkins,2017-02-16 04:52:54+00:00,['bd1d445b37f3cfc56ff868a678caf161b29a9d92'],32,110,142,5251412,2,0.056603774,0.452830189,1,3672
aee5457a55d78203576b85440bc94fd3f6469fe0,0,Impala Public Jenkins,2017-02-16 22:25:13+00:00,['26eaa266092a5d8b37e21fd19dfbae81a952ac74'],3,0,3,5251415,1,,,,3672
661921b205caf5b894f0f8803418c302e7a55293,1,Impala Public Jenkins,2017-02-17 01:10:12+00:00,['aee5457a55d78203576b85440bc94fd3f6469fe0'],352,2590,2942,5254357,29,,,,3672
b7a76361bbab7ea4e3c4df7574755cf3f6bc8cae,1,Impala Public Jenkins,2017-02-17 04:08:32+00:00,['661921b205caf5b894f0f8803418c302e7a55293'],29,54,83,5254440,5,0,0,1,3672
0c8715292e93769c71f8160ad85ecd57552ca585,0,Impala Public Jenkins,2017-02-17 05:30:09+00:00,['b7a76361bbab7ea4e3c4df7574755cf3f6bc8cae'],50,1,51,5254491,3,1,0.333333333,0,3672
d845413ab8fb0c92fc2d8d0c2a54d0de4dbd7429,1,Impala Public Jenkins,2017-02-17 06:02:48+00:00,['0c8715292e93769c71f8160ad85ecd57552ca585'],9,47,56,5254547,2,1,1,1,3672
815c76f9cbbe6585ebed961da506fc54ce2ef4e3,1,Impala Public Jenkins,2017-02-17 23:09:39+00:00,['d845413ab8fb0c92fc2d8d0c2a54d0de4dbd7429'],6,227,233,5254780,3,0,0.758389262,0.154362416,3672
d2ae45b0a9a566e19a4bf504680f43e15bc8b8a9,1,Impala Public Jenkins,2017-02-18 04:33:07+00:00,['815c76f9cbbe6585ebed961da506fc54ce2ef4e3'],6,6,12,5254792,3,,,,3672
9414d53a891448be13228f5fc63e089522e143aa,1,Jim Apple,2017-02-21 21:12:36+00:00,['d2ae45b0a9a566e19a4bf504680f43e15bc8b8a9'],39,85,124,5254916,4,0,1,0,3672
56e83806bf21f58618c57245fede42a32f0b8792,0,Impala Public Jenkins,2017-02-22 01:14:01+00:00,['9414d53a891448be13228f5fc63e089522e143aa'],1,1,2,5254918,1,,,,3672
441e15a365540d52d022f475a64dc7576ae5df32,0,Impala Public Jenkins,2017-02-22 01:21:50+00:00,['56e83806bf21f58618c57245fede42a32f0b8792'],1,1,2,5254920,1,,,,3672
ed711330fce4b8b739e9f30a28720b1c8e90fc63,1,Impala Public Jenkins,2017-02-22 05:06:20+00:00,['441e15a365540d52d022f475a64dc7576ae5df32'],6,13,19,5254939,5,,,,3672
637cc3e447650a5c9bc4b8dd79ee74fd11459fa2,1,Impala Public Jenkins,2017-02-22 06:31:14+00:00,['ed711330fce4b8b739e9f30a28720b1c8e90fc63'],76,235,311,5255250,5,0.615384615,0.615384615,1,3672
d07580c171a1ec2d86578237129faa5388be0272,1,Impala Public Jenkins,2017-02-22 23:10:34+00:00,['637cc3e447650a5c9bc4b8dd79ee74fd11459fa2'],48,49,97,5255347,12,,,,3672
49b407e9a7324741cd72db0e3cbcdda38fe77eba,0,Impala Public Jenkins,2017-02-22 23:41:21+00:00,['d07580c171a1ec2d86578237129faa5388be0272'],1852,6,1858,5257205,1,,,,3672
79b5e7dee6ad16ca0c995063b2589426f5e44c0a,0,Impala Public Jenkins,2017-02-23 01:20:24+00:00,['49b407e9a7324741cd72db0e3cbcdda38fe77eba'],17,6,23,5257228,3,,,,3672
cede3762fe1641342fa56e2d92b74fa93a98200a,0,Impala Public Jenkins,2017-02-23 01:22:53+00:00,['79b5e7dee6ad16ca0c995063b2589426f5e44c0a'],35,57,92,5257320,2,,,,3672
1656d3dd5583312ddd0db147c1605e2d3448a081,0,Impala Public Jenkins,2017-02-23 01:30:13+00:00,['cede3762fe1641342fa56e2d92b74fa93a98200a'],0,4,4,5257324,1,,,,3672
d5645083925aa42d30144957d8b0841690dd649b,0,Impala Public Jenkins,2017-02-23 06:50:30+00:00,['1656d3dd5583312ddd0db147c1605e2d3448a081'],27,27,54,5257378,2,,,,3672
749a55c4ad93849e4a63a43ae910a70f5d5f334b,1,Impala Public Jenkins,2017-02-23 11:16:17+00:00,['d5645083925aa42d30144957d8b0841690dd649b'],163,980,1143,5258521,32,0.238095238,0.223809524,0.661904762,3676
60127ff93dee5d88a09f779f40c19f6d1dbf7a02,1,Impala Public Jenkins,2017-02-23 18:02:47+00:00,['749a55c4ad93849e4a63a43ae910a70f5d5f334b'],795,523,1318,5259839,6,,,,3676
025b5dbbb0f9879772a4f72450a93205c6ee6753,0,Impala Public Jenkins,2017-02-23 18:33:21+00:00,['60127ff93dee5d88a09f779f40c19f6d1dbf7a02'],43,60,103,5259942,5,,,,3676
53e9b68ec348c8f80e510448d8855c23778104fc,0,Impala Public Jenkins,2017-02-23 21:30:25+00:00,['025b5dbbb0f9879772a4f72450a93205c6ee6753'],8,26,34,5259976,3,,,,3676
20ee7a661f933e1d30880bfea343dbdb2b52e464,0,Impala Public Jenkins,2017-02-24 00:10:05+00:00,['53e9b68ec348c8f80e510448d8855c23778104fc'],2,1,3,5259979,1,,,,3676
1e73d7fc31e872335f6fe6a83032761fd843a361,0,Impala Public Jenkins,2017-02-24 00:11:09+00:00,['20ee7a661f933e1d30880bfea343dbdb2b52e464'],7,23,30,5260009,1,,,,3676
909be1dd47fb155f04d700fa9e7429c0f98fdc41,0,Impala Public Jenkins,2017-02-24 04:26:24+00:00,['1e73d7fc31e872335f6fe6a83032761fd843a361'],2,1,3,5260012,1,,,,3676
d2c540f1e3d63eea39311a03f1ee8741042312eb,1,Impala Public Jenkins,2017-02-24 07:58:59+00:00,['909be1dd47fb155f04d700fa9e7429c0f98fdc41'],110,472,582,5260594,9,0.055555556,0.990740741,0.953703704,3676
013456d3b462ec2af4e026538848fcad79e98531,1,Impala Public Jenkins,2017-02-24 09:26:25+00:00,['d2c540f1e3d63eea39311a03f1ee8741042312eb'],1,1,2,5260596,1,,,,3676
a71636847fe742a9d0eb770516aff34ff16bbca1,1,Impala Public Jenkins,2017-02-24 10:18:38+00:00,['013456d3b462ec2af4e026538848fcad79e98531'],101,122,223,5260819,5,0.769230769,1,0,3676
073bb526485d2573bba69981a61fe781952eedcc,1,Impala Public Jenkins,2017-02-24 21:47:59+00:00,['a71636847fe742a9d0eb770516aff34ff16bbca1'],20,11,31,5260850,3,,,,3676
4743342da1147b09b6bc6cf0322f99026c300952,1,Impala Public Jenkins,2017-02-28 01:20:58+00:00,['073bb526485d2573bba69981a61fe781952eedcc'],696,634,1330,5262180,13,0.666666667,0.666666667,0.5,3676
674d313251eeb94c9b1bd7eaec4c641709d395ca,0,Impala Public Jenkins,2017-02-28 03:36:35+00:00,['4743342da1147b09b6bc6cf0322f99026c300952'],1,1,2,5262182,1,,,,3676
1417d764e489acf8b93f56787aa988d1e94768ce,0,Impala Public Jenkins,2017-03-01 02:00:19+00:00,['674d313251eeb94c9b1bd7eaec4c641709d395ca'],0,37,37,5262219,2,1,1,1,3677
93eb8ccbedda060af01dccbb452c28d8f2072115,1,Impala Public Jenkins,2017-03-01 03:09:17+00:00,['1417d764e489acf8b93f56787aa988d1e94768ce'],4,36,40,5262259,6,,,,3677
c84807479e129e97c84d60e5028c721bcf52f3d2,1,Impala Public Jenkins,2017-03-01 04:01:30+00:00,['93eb8ccbedda060af01dccbb452c28d8f2072115'],1,7,8,5262267,1,0,0,1,3677
09f32d406bfc3976b8312a7dcd273b7b0679ffbb,1,Impala Public Jenkins,2017-03-01 04:18:14+00:00,['c84807479e129e97c84d60e5028c721bcf52f3d2'],0,21,21,5262288,2,1,1,1,3677
abe860ced09d2bcd87f534e1e4e655f4b17d2aae,0,Impala Public Jenkins,2017-03-01 07:41:42+00:00,['09f32d406bfc3976b8312a7dcd273b7b0679ffbb'],2,4,6,5262294,1,,,,3677
1609585dc5e9efca8c2fcab4a08474304e04302c,0,Impala Public Jenkins,2017-03-01 07:50:00+00:00,['abe860ced09d2bcd87f534e1e4e655f4b17d2aae'],1,1,2,5262296,1,,,,3677
8b417c692140e831deaf54d066e785bacbd5e68b,0,Impala Public Jenkins,2017-03-01 22:49:32+00:00,['1609585dc5e9efca8c2fcab4a08474304e04302c'],1082,2,1084,5263380,22,,,,3677
71eb569f395dc01fe7b17ec851f69f4c2625306f,0,Impala Public Jenkins,2017-03-02 02:02:17+00:00,['8b417c692140e831deaf54d066e785bacbd5e68b'],557,3,560,5263940,77,0.108843537,0.054421769,0.044217687,3677
60c1c6e81b8705f493c6f9844e4c9a0aeb813721,0,Impala Public Jenkins,2017-03-02 09:43:03+00:00,['71eb569f395dc01fe7b17ec851f69f4c2625306f'],4,57,61,5264001,4,,,,3678
c46379602af3c007f9f8c98d8d52b8f7dec03270,1,Impala Public Jenkins,2017-03-02 10:31:29+00:00,['60c1c6e81b8705f493c6f9844e4c9a0aeb813721'],49,23,72,5264073,2,0.833333333,0,0,3678
c87ab35af18d93b5f5e31b6adc0b20bc1ecf165a,1,Impala Public Jenkins,2017-03-02 20:12:05+00:00,['c46379602af3c007f9f8c98d8d52b8f7dec03270'],429,864,1293,5265366,12,0.107142857,0,0.928571429,3678
0ad55ba5a95ccdb9c514fa0c98996bd2ecbe606e,0,Impala Public Jenkins,2017-03-02 21:05:01+00:00,['c87ab35af18d93b5f5e31b6adc0b20bc1ecf165a'],111,68,179,5265545,14,,,,3678
b48bdaa9b7a519a6750d8a97855e8fd5136a8846,1,Impala Public Jenkins,2017-03-02 23:01:10+00:00,['0ad55ba5a95ccdb9c514fa0c98996bd2ecbe606e'],27,35,62,5265607,4,,,,3678
545bfcfe673dd24356eb8f84b664b03b6230b01e,1,Impala Public Jenkins,2017-03-03 00:41:35+00:00,['b48bdaa9b7a519a6750d8a97855e8fd5136a8846'],45,115,160,5265767,4,0,0.405405405,0,3678
642b8f1b5d5493dc9e3aa55a973ef92094d4dbc9,1,Impala Public Jenkins,2017-03-03 01:20:04+00:00,['545bfcfe673dd24356eb8f84b664b03b6230b01e'],14,26,40,5265807,5,0,0,0.5,3678
3a2a380cf73c55e55f4025c008c50accda056f85,1,Impala Public Jenkins,2017-03-03 01:29:14+00:00,['642b8f1b5d5493dc9e3aa55a973ef92094d4dbc9'],100,78,178,5265985,6,1,1,0,3678
bf2e897209f1672073380665f84a4209be04b349,0,Impala Public Jenkins,2017-03-03 01:43:42+00:00,['3a2a380cf73c55e55f4025c008c50accda056f85'],9,35,44,5266029,5,,,,3678
157da298d194cc4fa298e3750d87bf102c3295bb,0,Impala Public Jenkins,2017-03-03 01:55:50+00:00,['bf2e897209f1672073380665f84a4209be04b349'],1,1,2,5266031,1,,,,3678
996fb5eab3e9cefc738afbc8171b901ad116dfb8,1,Impala Public Jenkins,2017-03-03 02:34:10+00:00,['157da298d194cc4fa298e3750d87bf102c3295bb'],17,129,146,5266177,6,0.391304348,0.391304348,0.869565217,3679
47f7de9e2d76d7100d9a8486f6ac8ee27bd7a368,0,Impala Public Jenkins,2017-03-03 03:47:42+00:00,['996fb5eab3e9cefc738afbc8171b901ad116dfb8'],3,5,8,5266185,2,,,,3679
94a8b1a9c1689d0302291ce6faf933f43839dc23,0,Impala Public Jenkins,2017-03-03 08:26:18+00:00,['47f7de9e2d76d7100d9a8486f6ac8ee27bd7a368'],5,26,31,5266216,2,0,0,0,3679
7ea96c64a28cb349c21febdc95d4cf2e51e62353,0,Impala Public Jenkins,2017-03-03 08:36:13+00:00,['94a8b1a9c1689d0302291ce6faf933f43839dc23'],1,4,5,5266221,2,1,1,1,3679
34353218cebbcd02630b07681624c1a1d5c9fd5b,0,Impala Public Jenkins,2017-03-03 10:20:07+00:00,['7ea96c64a28cb349c21febdc95d4cf2e51e62353'],76,71,147,5266368,10,,,,3679
2644d6a68824deda0db3d13481e64e713d60027b,0,Impala Public Jenkins,2017-03-04 02:24:47+00:00,['34353218cebbcd02630b07681624c1a1d5c9fd5b'],26,10,36,5266404,5,0.222222222,0.111111111,0.111111111,3679
5214765e2ded7e32e75ca463f3b0b18f6c5a2204,0,Impala Public Jenkins,2017-03-04 22:06:35+00:00,['2644d6a68824deda0db3d13481e64e713d60027b'],15,45,60,5266464,5,,,,3679
13837262b7733b7ae51f7dc134a6037b978629e8,0,Impala Public Jenkins,2017-03-05 02:58:25+00:00,['5214765e2ded7e32e75ca463f3b0b18f6c5a2204'],0,36,36,5266500,2,0,1,1,3679
c6673634bb7aff2cd007bc886eba302cfaf33eb6,0,Impala Public Jenkins,2017-03-06 19:08:31+00:00,['13837262b7733b7ae51f7dc134a6037b978629e8'],81,5,86,5266586,4,,,,3679
9b923a1a277d90d7056e9c64f97904a90d8f231b,1,Impala Public Jenkins,2017-03-06 23:20:34+00:00,['c6673634bb7aff2cd007bc886eba302cfaf33eb6'],196,1482,1678,5268264,29,0.223602484,0.229813665,0.658385093,3682
c8e15e484ce7400da0c36a603b72514c1f41cb00,1,Impala Public Jenkins,2017-03-07 02:56:18+00:00,['9b923a1a277d90d7056e9c64f97904a90d8f231b'],97,198,295,5268559,7,1,1,0.681818182,3684
61c32a903b95d6d5432343ef36933e02c24f6d78,0,Impala Public Jenkins,2017-03-07 03:59:18+00:00,['c8e15e484ce7400da0c36a603b72514c1f41cb00'],5,5,10,5268569,1,,,,3684
ba2613abfb39357843e0a6e5dfd2d5ed49b36ea3,0,Impala Public Jenkins,2017-03-07 04:11:27+00:00,['61c32a903b95d6d5432343ef36933e02c24f6d78'],2,0,2,5268571,1,1,0,0,3684
5d306eff7fa5a0ef8dbccfe6e5135eaeea25ba1a,1,Impala Public Jenkins,2017-03-07 07:53:14+00:00,['ba2613abfb39357843e0a6e5dfd2d5ed49b36ea3'],11,469,480,5269051,12,0.37962963,0.893518519,0.925925926,3685
768fc0ea2773289b88256ea16090c0cfcf2d0a97,1,Impala Public Jenkins,2017-03-07 09:07:05+00:00,['5d306eff7fa5a0ef8dbccfe6e5135eaeea25ba1a'],28,117,145,5269196,16,0.106382979,0.765957447,0.340425532,3685
ae79288e129195c6889b53fde687833de55c640c,0,Impala Public Jenkins,2017-03-07 20:06:47+00:00,['768fc0ea2773289b88256ea16090c0cfcf2d0a97'],0,10,10,5269206,3,,,,3685
685cdc55ee7d4b0b8ae64331c666bca591b8438e,1,Impala Public Jenkins,2017-03-07 21:14:19+00:00,['ae79288e129195c6889b53fde687833de55c640c'],61,119,180,5269386,4,,,,3685
6f837118b864f6a3d679f13c5b17fd43ff7a6872,0,Impala Public Jenkins,2017-03-07 22:25:25+00:00,['685cdc55ee7d4b0b8ae64331c666bca591b8438e'],10,105,115,5269501,5,,,,3685
fdcea4304fbd06bdfef3ee5cc1d674a132a9160c,1,Impala Public Jenkins,2017-03-07 22:39:19+00:00,['6f837118b864f6a3d679f13c5b17fd43ff7a6872'],4,124,128,5269629,5,,,,3685
64c7f5b8b55720f355dfbd548f5dd32bf5352da6,0,Impala Public Jenkins,2017-03-07 23:16:40+00:00,['fdcea4304fbd06bdfef3ee5cc1d674a132a9160c'],15,76,91,5269720,6,,,,3685
c4fb67c98c44c28f0c375b11a5ef996a2c52bbb2,1,Impala Public Jenkins,2017-03-08 01:07:27+00:00,['64c7f5b8b55720f355dfbd548f5dd32bf5352da6'],4,5,9,5269729,1,,,,3685
317041f775c268d120ef99dfcb8770eed09ba52e,1,Impala Public Jenkins,2017-03-08 01:36:41+00:00,['c4fb67c98c44c28f0c375b11a5ef996a2c52bbb2'],78,402,480,5270209,12,0.190909091,0.945454545,0.727272727,3687
082b3eff0b7dff440479d6ca1795d4955daa0d77,0,Impala Public Jenkins,2017-03-08 01:51:07+00:00,['317041f775c268d120ef99dfcb8770eed09ba52e'],1,0,1,5270210,1,,,,3687
d3cc23e569eb44a3b9b823bd99da783b8356c6d4,0,Impala Public Jenkins,2017-03-08 02:00:30+00:00,['082b3eff0b7dff440479d6ca1795d4955daa0d77'],2,22,24,5270234,4,1,1,0,3688
ec469347fd08467d5763bdfc2ce707e6df77998a,0,Tim Armstrong,2017-03-08 06:16:08+00:00,['d3cc23e569eb44a3b9b823bd99da783b8356c6d4'],0,3,3,5270237,1,,,,3688
408d0aec336da826304ca5e144ce3655a5967f56,1,Impala Public Jenkins,2017-03-08 21:33:15+00:00,['ec469347fd08467d5763bdfc2ce707e6df77998a'],2,2,4,5270241,1,,,,3688
3b7ceceed29f2f34539a0def4ddb71b34e74d2b7,1,Impala Public Jenkins,2017-03-08 22:09:53+00:00,['408d0aec336da826304ca5e144ce3655a5967f56'],3,32,35,5270276,2,0.761904762,0.761904762,0.571428571,3688
18927ac852303288d3ada15ffd3f6b87b43b389e,1,Impala Public Jenkins,2017-03-08 22:40:19+00:00,['3b7ceceed29f2f34539a0def4ddb71b34e74d2b7'],1305,344,1649,5271925,26,,,,3688
cc8a11983945fe3409f4693431774733923a0222,0,Impala Public Jenkins,2017-03-09 01:57:37+00:00,['18927ac852303288d3ada15ffd3f6b87b43b389e'],10,7,17,5271942,2,1,0,1,3688
7d8acee81437c040255c3219bcd3e72f10b3b772,1,Impala Public Jenkins,2017-03-09 05:07:44+00:00,['cc8a11983945fe3409f4693431774733923a0222'],40,412,452,5272394,15,0.375,0.4,0,3695
32d45f42620621ee6d6faa4a7ca2d5c90ad6d8ee,0,Impala Public Jenkins,2017-03-09 06:00:15+00:00,['7d8acee81437c040255c3219bcd3e72f10b3b772'],1,13,14,5272408,1,,,,3695
1bda28c4858a08a224065a29cd9d806242bb021e,1,Impala Public Jenkins,2017-03-09 08:03:29+00:00,['32d45f42620621ee6d6faa4a7ca2d5c90ad6d8ee'],2,2,4,5272412,1,,,,3695
0467b0d54a70ab8d08d5a86efa835a8fda139920,1,Impala Public Jenkins,2017-03-09 23:27:53+00:00,['1bda28c4858a08a224065a29cd9d806242bb021e'],839,123,962,5273374,30,,,,3695
5f2fcd9f6ae97c52f395f509b7b221a3b27d2c45,1,Impala Public Jenkins,2017-03-10 02:00:47+00:00,['0467b0d54a70ab8d08d5a86efa835a8fda139920'],81,188,269,5273643,5,0.476190476,1,1,3697
5f3c68982859fe964737be3b95e9d7d8d6331e03,0,Impala Public Jenkins,2017-03-10 07:42:43+00:00,['5f2fcd9f6ae97c52f395f509b7b221a3b27d2c45'],126,377,503,5274146,3,,,,3697
def5355a24b9d81550df93b58baee154abcdc739,0,Impala Public Jenkins,2017-03-10 21:58:04+00:00,['5f3c68982859fe964737be3b95e9d7d8d6331e03'],5,37,42,5274188,2,,,,3697
f3820e62055135da32746d156b3e00f1ff5b59a6,1,Impala Public Jenkins,2017-03-10 23:56:51+00:00,['def5355a24b9d81550df93b58baee154abcdc739'],98,98,196,5274384,37,,,,3697
244ec22d8e8b2f108f723d49dc95a016a74d6d6f,0,Impala Public Jenkins,2017-03-11 05:01:25+00:00,['f3820e62055135da32746d156b3e00f1ff5b59a6'],0,1,1,5274385,1,0,0,0,3697
56e37166492b8ee155a6bae851489ace635ae085,0,Impala Public Jenkins,2017-03-11 06:40:17+00:00,['244ec22d8e8b2f108f723d49dc95a016a74d6d6f'],80,184,264,5274649,11,0.647058824,0.647058824,1,3698
6441ca65bda83c23dacfed8a27d944a0dabe6b65,1,Alex Behm,2017-03-13 17:37:15+00:00,['56e37166492b8ee155a6bae851489ace635ae085'],317,134,451,5275100,5,0,0,0.27027027,3698
5709b66e91d057478db8f94d0ad249b1afdc9bb6,0,Impala Public Jenkins,2017-03-13 17:51:43+00:00,['6441ca65bda83c23dacfed8a27d944a0dabe6b65'],276,22,298,5275398,1,,,,3698
cb2b8287c5df3898cb19be321c3493342d8ba2a4,0,Impala Public Jenkins,2017-03-13 21:56:35+00:00,['5709b66e91d057478db8f94d0ad249b1afdc9bb6'],18,15,33,5275431,1,,,,3698
7683838707af490489a6fac1af24868f4c23735e,1,Impala Public Jenkins,2017-03-13 21:58:42+00:00,['cb2b8287c5df3898cb19be321c3493342d8ba2a4'],3,2,5,5275436,2,,,,3698
a925f4a10e87f54c4a88ef3025c18f87ae8862b2,0,Impala Public Jenkins,2017-03-13 21:59:43+00:00,['7683838707af490489a6fac1af24868f4c23735e'],1,1,2,5275438,1,,,,3698
ff5d1ceb0d8fbe64ce4a3d2a1e2ed6f32bec9cd4,1,Impala Public Jenkins,2017-03-13 22:01:09+00:00,['a925f4a10e87f54c4a88ef3025c18f87ae8862b2'],1652,48,1700,5277138,29,,,,3698
ab23e16f89cb8e00c5b8b7eddbdba2fc030cf855,0,Impala Public Jenkins,2017-03-13 22:02:16+00:00,['ff5d1ceb0d8fbe64ce4a3d2a1e2ed6f32bec9cd4'],4,4,8,5277146,1,,,,3698
c4ffc3384f06d44c49096ba4e4c5ff24fa781c35,0,Impala Public Jenkins,2017-03-13 22:02:22+00:00,['ab23e16f89cb8e00c5b8b7eddbdba2fc030cf855'],2,2,4,5277150,1,,,,3698
6eb0fff4ff4d69f348c0efa88d7d6e81a64dda3d,0,Impala Public Jenkins,2017-03-13 22:08:40+00:00,['c4ffc3384f06d44c49096ba4e4c5ff24fa781c35'],5,2,7,5277157,1,,,,3698
4fa9ebbc3d9b49d6485f341bd6dbd9971642e057,0,Impala Public Jenkins,2017-03-13 22:22:14+00:00,['6eb0fff4ff4d69f348c0efa88d7d6e81a64dda3d'],11,1,12,5277169,2,,,,3698
d9602df71b6d686a8e8268d0e18e99f2a51d4e78,1,Impala Public Jenkins,2017-03-13 23:49:56+00:00,['4fa9ebbc3d9b49d6485f341bd6dbd9971642e057'],632,97,729,5277898,30,,,,3698
eec8d6fd15dc9e914a773aab1390f95d97f515ae,1,Impala Public Jenkins,2017-03-14 01:38:59+00:00,['d9602df71b6d686a8e8268d0e18e99f2a51d4e78'],25,58,83,5277981,2,0,0.916666667,0.083333333,3698
e1b092de683b4d2e67c90deffd2da7777631f3e1,0,Impala Public Jenkins,2017-03-14 03:26:24+00:00,['eec8d6fd15dc9e914a773aab1390f95d97f515ae'],0,2,2,5277983,1,,,,3698
3b3ef9747b0d30f521f6da59c0db65b4178f360f,0,Impala Public Jenkins,2017-03-14 16:48:20+00:00,['e1b092de683b4d2e67c90deffd2da7777631f3e1'],2,2,4,5277987,1,,,,3698
ea25355ba4c833c392d7bf1e9aa0be60fa2125d8,0,Impala Public Jenkins,2017-03-14 16:50:21+00:00,['3b3ef9747b0d30f521f6da59c0db65b4178f360f'],1,1,2,5277989,1,,,,3698
8049778159931cc5dc81df31ba9d9f4e098ef4b4,0,Impala Public Jenkins,2017-03-14 17:23:08+00:00,['ea25355ba4c833c392d7bf1e9aa0be60fa2125d8'],1,1,2,5277991,1,,,,3698
a19b696c87dcfe230ed12f1327dd967847f3e3b6,0,Impala Public Jenkins,2017-03-14 17:25:22+00:00,['8049778159931cc5dc81df31ba9d9f4e098ef4b4'],2,0,2,5277993,1,,,,3698
b4890dc722ffb7f1639d0ae618707cc847c67e2e,0,Impala Public Jenkins,2017-03-14 17:26:49+00:00,['a19b696c87dcfe230ed12f1327dd967847f3e3b6'],11,3,14,5278007,1,,,,3698
7df236fce252e33ff254356f97681ecc721399e8,0,Impala Public Jenkins,2017-03-14 17:28:15+00:00,['b4890dc722ffb7f1639d0ae618707cc847c67e2e'],1,1,2,5278009,1,,,,3698
d98f464918058b5459db0da7fcd483f1a5b3a47c,0,Impala Public Jenkins,2017-03-14 17:29:57+00:00,['7df236fce252e33ff254356f97681ecc721399e8'],1,1,2,5278011,1,,,,3698
78760b0cf2ba09a37f55404c6f338eab23d5f582,0,Impala Public Jenkins,2017-03-14 17:31:23+00:00,['d98f464918058b5459db0da7fcd483f1a5b3a47c'],1,1,2,5278013,1,,,,3698
1240e329e47a59e45271efa5eae665b78b3332d9,0,Impala Public Jenkins,2017-03-14 17:32:44+00:00,['78760b0cf2ba09a37f55404c6f338eab23d5f582'],4,4,8,5278021,1,,,,3698
bc514899e0d20fcef39ddb776337fd01e9c4c550,0,Impala Public Jenkins,2017-03-14 17:59:55+00:00,['1240e329e47a59e45271efa5eae665b78b3332d9'],21,17,38,5278059,1,,,,3698
d4b0b568227cb1b52e77cdf72f29548ee0f68030,0,Impala Public Jenkins,2017-03-14 18:22:32+00:00,['bc514899e0d20fcef39ddb776337fd01e9c4c550'],95,1,96,5278155,1,,,,3698
e98cf78763493bd522fc1b766b80e0b87110e34c,0,Impala Public Jenkins,2017-03-14 19:10:35+00:00,['d4b0b568227cb1b52e77cdf72f29548ee0f68030'],1,1,2,5278157,1,,,,3698
33e112bc9516c25290269c597a874601edea21cf,0,Impala Public Jenkins,2017-03-14 19:43:36+00:00,['e98cf78763493bd522fc1b766b80e0b87110e34c'],4,0,4,5278161,1,,,,3698
44dc8eec7e0ffc27518feab486cbe00a7224d1c0,0,Impala Public Jenkins,2017-03-14 19:46:12+00:00,['33e112bc9516c25290269c597a874601edea21cf'],4,0,4,5278165,1,,,,3698
16e2974fb464736a4909bf1df9892a6aaea3d5dd,0,Impala Public Jenkins,2017-03-14 19:53:42+00:00,['44dc8eec7e0ffc27518feab486cbe00a7224d1c0'],4,1,5,5278170,1,,,,3698
c19eb4f1942d5fd190b0671fc335de73101c79da,0,Impala Public Jenkins,2017-03-14 20:18:55+00:00,['16e2974fb464736a4909bf1df9892a6aaea3d5dd'],3,1,4,5278174,1,,,,3698
fa1361b86165b49fbb9de2fac9c53c4056a628c5,0,Impala Public Jenkins,2017-03-14 20:20:41+00:00,['c19eb4f1942d5fd190b0671fc335de73101c79da'],3,6,9,5278183,2,,,,3698
de12d86f208ceaf75b5d45aca229002002e8f860,0,Impala Public Jenkins,2017-03-14 20:36:32+00:00,['fa1361b86165b49fbb9de2fac9c53c4056a628c5'],1,3,4,5278187,1,,,,3698
5a333c47c533d7444adc239696401d542c4064d3,0,Impala Public Jenkins,2017-03-15 03:57:40+00:00,['de12d86f208ceaf75b5d45aca229002002e8f860'],1,1,2,5278189,1,,,,3698
87e95f804e2760fea0407e9fc75f3966a6e51ac9,0,Michael Ho,2017-03-15 05:11:15+00:00,['5a333c47c533d7444adc239696401d542c4064d3'],299,0,299,5278488,2,0.593495935,0.455284553,1,3698
62894e323a87f8f48ece7235f2ffb0eac922fbf8,0,Impala Public Jenkins,2017-03-16 02:10:02+00:00,['87e95f804e2760fea0407e9fc75f3966a6e51ac9'],150,163,313,5278801,7,1,0.318181818,0.272727273,3698
529a5f99b959079faead34a977fba1125d01840e,1,Impala Public Jenkins,2017-03-16 05:59:40+00:00,['62894e323a87f8f48ece7235f2ffb0eac922fbf8'],146,316,462,5279263,3,0.395833333,0.979166667,1,3698
0ff1e6e8d7e51fca6cd330527329008a3eee4e06,1,Impala Public Jenkins,2017-03-16 09:35:57+00:00,['529a5f99b959079faead34a977fba1125d01840e'],10,168,178,5279441,7,0.2,0.316666667,1,3700
663285244e413cfccb03a281d80403b15fdae663,1,Impala Public Jenkins,2017-03-16 21:07:58+00:00,['0ff1e6e8d7e51fca6cd330527329008a3eee4e06'],104,3011,3115,5282556,23,0.272617612,0.643546441,0.786489747,3704
3aeb2aeb575941d470a41511c33e1544e65e8a20,0,Impala Public Jenkins,2017-03-17 00:00:21+00:00,['663285244e413cfccb03a281d80403b15fdae663'],174,6,180,5282736,1,,,,3704
69510304f52c062dcbb291e37e96831ad0df6264,0,Impala Public Jenkins,2017-03-17 10:14:24+00:00,['3aeb2aeb575941d470a41511c33e1544e65e8a20'],15,14,29,5282765,3,,,,3704
6dff90661c07241794de5c24f4f27e7712dca82c,0,Impala Public Jenkins,2017-03-17 10:20:57+00:00,['69510304f52c062dcbb291e37e96831ad0df6264'],2,2,4,5282769,1,,,,3704
5bb988b1c58a2377777312c8e4dd56cbd0dee8a2,1,Impala Public Jenkins,2017-03-17 19:33:31+00:00,['6dff90661c07241794de5c24f4f27e7712dca82c'],143,563,706,5283475,17,0.643410853,0.914728682,0.527131783,3709
b41c2114f42f92441e96b408a6864420c0d00cae,0,Impala Public Jenkins,2017-03-17 19:57:08+00:00,['5bb988b1c58a2377777312c8e4dd56cbd0dee8a2'],1,31,32,5283507,4,,,,3710
58e07530298a33a3b60b2ff13f19068a188a9959,0,Impala Public Jenkins,2017-03-20 19:31:56+00:00,['b41c2114f42f92441e96b408a6864420c0d00cae'],0,4,4,5283511,1,,,,3710
69ba44c706660ed5611d417fdeb607d8a48274d8,0,Impala Public Jenkins,2017-03-20 21:19:04+00:00,['58e07530298a33a3b60b2ff13f19068a188a9959'],2,2,4,5283515,2,,,,3710
aafcda0c9bcea5e316f3cc43cee49551c7be5c60,0,Impala Public Jenkins,2017-03-20 22:59:03+00:00,['69ba44c706660ed5611d417fdeb607d8a48274d8'],2,2,4,5283519,1,,,,3710
ca2baa5d401f64b99fbb8f80e8ec1bdc1b3d52ce,0,Impala Public Jenkins,2017-03-20 23:07:50+00:00,['aafcda0c9bcea5e316f3cc43cee49551c7be5c60'],75,0,75,5283594,1,0,0,0,3710
5ecb97598ac0b33d99fdb84a624727952a5b1623,1,Impala Public Jenkins,2017-03-21 01:52:45+00:00,['ca2baa5d401f64b99fbb8f80e8ec1bdc1b3d52ce'],64,813,877,5284471,12,0.381974249,0.91416309,0.768240343,3713
bccbf9ebdaed9a03d9a5ecf2a39aad044f178ee1,1,Impala Public Jenkins,2017-03-21 02:29:53+00:00,['5ecb97598ac0b33d99fdb84a624727952a5b1623'],1,7,8,5284479,1,0,1,0,3713
2544f2394cbc25bb75fdafd5e5eb41cf88424708,0,Impala Public Jenkins,2017-03-21 02:38:22+00:00,['bccbf9ebdaed9a03d9a5ecf2a39aad044f178ee1'],3,3,6,5284485,1,,,,3713
c27ad3526675ff0ab80c7bb5d7c8364437448b53,0,Impala Public Jenkins,2017-03-21 09:13:08+00:00,['2544f2394cbc25bb75fdafd5e5eb41cf88424708'],4,7,11,5284496,1,0,1,1,3713
f4d9285e132a7ab4ef231e4f2a33e6230c5655fd,0,Impala Public Jenkins,2017-03-21 18:42:01+00:00,['c27ad3526675ff0ab80c7bb5d7c8364437448b53'],2,2,4,5284500,1,,,,3713
5deec604de079590fcac724b2c27008bb61f3d48,0,Impala Public Jenkins,2017-03-21 22:01:36+00:00,['f4d9285e132a7ab4ef231e4f2a33e6230c5655fd'],10413,10393,20806,5305306,7,,,,3713
a50c344077f6c9bbea3d3cbaa2e9146ba20ac9a9,1,Impala Public Jenkins,2017-03-21 22:24:01+00:00,['5deec604de079590fcac724b2c27008bb61f3d48'],735,1432,2167,5307473,32,0.299401198,0.431137725,0.880239521,3713
52ab7ce501c415675edbfa13969358dc1c6d363c,1,Impala Public Jenkins,2017-03-22 02:50:05+00:00,['a50c344077f6c9bbea3d3cbaa2e9146ba20ac9a9'],3,3,6,5307479,1,,,,3713
7592e332ad71a9e3c03af1d1d4a4130b9698cf66,0,Impala Public Jenkins,2017-03-22 17:44:28+00:00,['52ab7ce501c415675edbfa13969358dc1c6d363c'],31,4,35,5307514,2,,,,3713
7e25ec8ec03e0594a630910b244686ad12d264f8,1,Impala Public Jenkins,2017-03-22 23:33:36+00:00,['7592e332ad71a9e3c03af1d1d4a4130b9698cf66'],0,5,5,5307519,1,1,1,1,3713
e24333c1fb0c90d782bfeab6fd2b48cb6e225782,0,Impala Public Jenkins,2017-03-24 17:56:08+00:00,['7e25ec8ec03e0594a630910b244686ad12d264f8'],27,15,42,5307561,2,,,,3713
878fcf5a746153bcaf38dab2ecd6fa6a462ceb13,0,Impala Public Jenkins,2017-03-24 21:22:50+00:00,['e24333c1fb0c90d782bfeab6fd2b48cb6e225782'],2,16,18,5307579,3,0,0,1,3713
077c07eec77c05f97d5e45704454b788ed1b45e0,1,Impala Public Jenkins,2017-03-25 04:51:36+00:00,['878fcf5a746153bcaf38dab2ecd6fa6a462ceb13'],3,80,83,5307662,4,0.052631579,1,0,3713
8e45c4ae9c65f316072e395602648fe36081377a,0,Impala Public Jenkins,2017-03-26 15:36:44+00:00,['077c07eec77c05f97d5e45704454b788ed1b45e0'],9,14,23,5307685,2,,,,3713
77dbdc3f572260a90af174dcb9112cb991ec296c,1,Impala Public Jenkins,2017-03-27 21:53:04+00:00,['8e45c4ae9c65f316072e395602648fe36081377a'],10,20,30,5307715,6,0,1,1,3713
e98c88f233f17335b551ad53e4541491e07c5913,0,Impala Public Jenkins,2017-03-27 22:24:21+00:00,['77dbdc3f572260a90af174dcb9112cb991ec296c'],37,56,93,5307808,1,1,1,1,3713
874d20d0fabaf0572202a6e65dc55d334229ca6b,0,Impala Public Jenkins,2017-03-27 22:52:33+00:00,['e98c88f233f17335b551ad53e4541491e07c5913'],152,263,415,5308223,5,0.5,1,1,3713
4aa8e2d5cf590d6366a600f15bed3e998ccc4031,0,Impala Public Jenkins,2017-03-28 22:16:25+00:00,['874d20d0fabaf0572202a6e65dc55d334229ca6b'],4,6,10,5308233,3,1,1,1,3713
296df3c8269b7be16120397d60e97b6f24fc390b,1,Impala Public Jenkins,2017-03-28 22:27:25+00:00,['4aa8e2d5cf590d6366a600f15bed3e998ccc4031'],215,415,630,5308863,19,0.333333333,0,0.939393939,3714
ff095f1894979a3899a9367b44d8dd7a6bfe0726,0,Henry Robinson,2017-03-29 02:51:18+00:00,['296df3c8269b7be16120397d60e97b6f24fc390b'],0,3,3,5308866,1,,,,3714
02f3e3fcc1c58bcaf5080ddee939c9081412a553,1,Henry Robinson,2017-03-29 02:52:21+00:00,['ff095f1894979a3899a9367b44d8dd7a6bfe0726'],4103,9197,13300,5322166,122,0.127622378,0.697552448,0.247377622,3735
23100102c0a9a8f3a8a7ff069cbfaa7a56628238,1,Henry Robinson,2017-03-29 02:52:34+00:00,['02f3e3fcc1c58bcaf5080ddee939c9081412a553'],473,493,966,5323132,108,0.777777778,1,0,3735
d0152d424ad1aa21a91122ca874a81793d497720,0,Impala Public Jenkins,2017-03-30 00:17:24+00:00,['23100102c0a9a8f3a8a7ff069cbfaa7a56628238'],16,38,54,5323186,3,0.8,0.8,1,3735
36ead908f88f3719b600e793ddcd9a4058d88440,0,Impala Public Jenkins,2017-03-30 11:27:36+00:00,['d0152d424ad1aa21a91122ca874a81793d497720'],11,15,26,5323212,1,0,1,1,3735
a7bd260a4cfbfa8899643c3d6004f711e19aef83,0,Impala Public Jenkins,2017-03-30 19:10:11+00:00,['36ead908f88f3719b600e793ddcd9a4058d88440'],2,2,4,5323216,1,,,,3735
4c4235f4b23a6050d5a5efe9f358fca719e97c19,0,Impala Public Jenkins,2017-03-31 03:26:53+00:00,['a7bd260a4cfbfa8899643c3d6004f711e19aef83'],46,40,86,5323302,2,1,1,0,3735
2598e3b26449a03011ab419a4cc1171cee249427,1,Alex Behm,2017-03-31 18:21:27+00:00,['4c4235f4b23a6050d5a5efe9f358fca719e97c19'],1,2,3,5323305,1,,,,3735
fd1b40d5719745200dcb41ac248f1ab7042c1164,1,Impala Public Jenkins,2017-04-03 22:48:05+00:00,['2598e3b26449a03011ab419a4cc1171cee249427'],54,47,101,5323406,5,,,,3735
85d7f5eb2b0e092e5b950d2cab307a25537e457c,0,Impala Public Jenkins,2017-04-04 00:28:29+00:00,['fd1b40d5719745200dcb41ac248f1ab7042c1164'],3,32,35,5323441,5,,,,3735
be8d15122de9b1ee35bdd2de43b8daaaa7547098,1,Alex Behm,2017-04-04 01:21:07+00:00,['85d7f5eb2b0e092e5b950d2cab307a25537e457c'],219,296,515,5323956,15,0,0,0.262295082,3735
cfcb5f40017bc596bb26d4736ca73a318f5e0e6d,0,Impala Public Jenkins,2017-04-05 03:03:57+00:00,['be8d15122de9b1ee35bdd2de43b8daaaa7547098'],0,2,2,5323958,1,0,0,0,3735
676a88f346c3dac57ffe0b5742a64ee7136b6bb1,0,Impala Public Jenkins,2017-04-05 04:52:59+00:00,['cfcb5f40017bc596bb26d4736ca73a318f5e0e6d'],1,3,4,5323962,1,,,,3735
75cca8a90b05b733653e31fe0791791c5616d78e,0,Michael Brown,2017-04-05 20:02:09+00:00,['676a88f346c3dac57ffe0b5742a64ee7136b6bb1'],73,204,277,5324239,2,,,,3736
75980d891a1d7042e6d09230c5be4b348559aef9,0,Impala Public Jenkins,2017-04-05 22:27:20+00:00,['75cca8a90b05b733653e31fe0791791c5616d78e'],1,1,2,5324241,1,,,,3736
58286bda7a62251f3841fa431013bdb009c6bfaf,0,Impala Public Jenkins,2017-04-06 01:36:27+00:00,['75980d891a1d7042e6d09230c5be4b348559aef9'],0,35,35,5324276,2,0.037037037,1,0.037037037,3736
68f32e52bc42bef578330a4fe0edc5b292891eea,0,Impala Public Jenkins,2017-04-06 16:56:41+00:00,['58286bda7a62251f3841fa431013bdb009c6bfaf'],73,232,305,5324581,3,,,,3736
9e7fb830fd047ed6445ea82280993e56ea51e15b,0,Impala Public Jenkins,2017-04-07 22:57:16+00:00,['68f32e52bc42bef578330a4fe0edc5b292891eea'],12,33,45,5324626,5,,,,3736
4a79c9e7e3928f919b5fb60bab4145ba886d6252,0,Impala Public Jenkins,2017-04-08 00:19:08+00:00,['9e7fb830fd047ed6445ea82280993e56ea51e15b'],33,57,90,5324716,1,0.266666667,1,1,3736
a827e9edc1f93ec0ddb2184133b114182ebb2e02,1,Impala Public Jenkins,2017-04-08 19:58:25+00:00,['4a79c9e7e3928f919b5fb60bab4145ba886d6252'],15,22,37,5324753,1,1,0,0,3736
8146532b640eef012623a4ef107743f1bfc41cdd,0,Impala Public Jenkins,2017-04-08 23:09:37+00:00,['a827e9edc1f93ec0ddb2184133b114182ebb2e02'],2,3,5,5324758,1,,,,3736
924ddc6e935aa6e6d2a07c4926cbb26ea0df0b4e,0,Impala Public Jenkins,2017-04-11 20:59:04+00:00,['8146532b640eef012623a4ef107743f1bfc41cdd'],0,51,51,5324809,2,,,,3737
532c5f26052070cccf90eac83de9ba0052879729,0,Impala Public Jenkins,2017-04-13 09:06:50+00:00,['924ddc6e935aa6e6d2a07c4926cbb26ea0df0b4e'],10,5,15,5324824,2,0,0,0,3737
fcefe47d7348f01e6a6fef700b421290a3f536b3,1,Dan Hecht,2017-04-13 23:35:21+00:00,['532c5f26052070cccf90eac83de9ba0052879729'],3,57,60,5324884,2,0,0.7,0.1,3737
491154c8ef7a9b6b1be2430c1bf119e21ce171c3,1,Impala Public Jenkins,2017-04-14 01:50:30+00:00,['fcefe47d7348f01e6a6fef700b421290a3f536b3'],68,73,141,5325025,9,1,0.357142857,0.5,3737
cb1e4f659f6fd42469ef0813aa56fa36cb43fc22,1,Impala Public Jenkins,2017-04-14 22:34:44+00:00,['491154c8ef7a9b6b1be2430c1bf119e21ce171c3'],6,22,28,5325053,1,1,1,1,3737
8bdfe032012e0b52550bc6784dc972b9dcfb5f7b,1,Impala Public Jenkins,2017-04-14 22:37:34+00:00,['cb1e4f659f6fd42469ef0813aa56fa36cb43fc22'],2,40,42,5325095,1,,,,3737
6c162df38c1e929a6e8393733f27d56f07c3dea1,1,Impala Public Jenkins,2017-04-18 06:27:39+00:00,['8bdfe032012e0b52550bc6784dc972b9dcfb5f7b'],367,1569,1936,5327031,30,0.505747126,0.568965517,0.614942529,3742
cb900df435c643bc1046b35e15f68d0c4b983b06,1,Impala Public Jenkins,2017-04-18 06:33:44+00:00,['6c162df38c1e929a6e8393733f27d56f07c3dea1'],12,847,859,5327890,6,0.242957746,0.723591549,0.76584507,3742
42002b91cb2db42be984b6ed95bc08c6dbd70c74,0,Impala Public Jenkins,2017-04-18 06:34:47+00:00,['cb900df435c643bc1046b35e15f68d0c4b983b06'],10,112,122,5328012,3,0.2,0,1,3742
955b257cfb5f94775318c466ee18771ff167026d,1,Impala Public Jenkins,2017-04-18 09:53:54+00:00,['42002b91cb2db42be984b6ed95bc08c6dbd70c74'],41,396,437,5328449,15,0.317647059,0.7,0.723529412,3742
1fa331537acf4c2460f3787ba81a5a64cac89c99,1,Matthew Jacobs,2017-04-18 20:02:44+00:00,['955b257cfb5f94775318c466ee18771ff167026d'],0,3,3,5328452,1,,,,3742
96316e3b34e1102d0df2714e617d9847b853a4c4,0,Impala Public Jenkins,2017-04-18 20:11:23+00:00,['1fa331537acf4c2460f3787ba81a5a64cac89c99'],2,44,46,5328498,2,1,1,1,3742
c0e306047de57c39c43c9b7fbe06e64a4b824ca9,1,Impala Public Jenkins,2017-04-18 20:34:50+00:00,['96316e3b34e1102d0df2714e617d9847b853a4c4'],41,58,99,5328597,8,0,0,0,3742
9a29dfc91b1ff8bbae3c94b53bf2b6ac81a271e0,1,Impala Public Jenkins,2017-04-18 20:36:08+00:00,['c0e306047de57c39c43c9b7fbe06e64a4b824ca9'],1620,2119,3739,5332336,55,0.615942029,0.775362319,1,3744
841fe7f621be0c8af4fceeb8eec6a95426320bcd,0,Impala Public Jenkins,2017-04-19 22:03:51+00:00,['9a29dfc91b1ff8bbae3c94b53bf2b6ac81a271e0'],0,1,1,5332337,1,,,,3744
297e23ba993d9db22287d2ac54bacdff52d5461a,1,Impala Public Jenkins,2017-04-19 22:11:14+00:00,['841fe7f621be0c8af4fceeb8eec6a95426320bcd'],1,1,2,5332339,1,,,,3744
830889a68709db345002bbf867ea86ac10235e9d,0,Impala Public Jenkins,2017-04-20 02:01:10+00:00,['297e23ba993d9db22287d2ac54bacdff52d5461a'],2,2,4,5332343,2,,,,3744
c7fa4dceb667e7279dd04a42fcd2fba94ca5214f,0,Impala Public Jenkins,2017-04-20 02:56:43+00:00,['830889a68709db345002bbf867ea86ac10235e9d'],10,22,32,5332375,3,1,1,1,3744
634c2f7b9fcbb96f9c73a1cb6a6ce64780bd5eac,0,Impala Public Jenkins,2017-04-20 03:18:54+00:00,['c7fa4dceb667e7279dd04a42fcd2fba94ca5214f'],0,3,3,5332378,1,,,,3744
392c4badffa3a8ab9c605385f18cc8afb4182693,0,Impala Public Jenkins,2017-04-20 03:24:33+00:00,['634c2f7b9fcbb96f9c73a1cb6a6ce64780bd5eac'],21,0,21,5332399,3,,,,3744
a2805ca6fa31f6e49f4bb5167225a895c35f8974,0,Jim Apple,2017-04-20 15:02:36+00:00,['392c4badffa3a8ab9c605385f18cc8afb4182693'],5,5,10,5332409,1,,,,3744
8660c404c93673559c639cf7306c0a6f7ab9001f,1,Impala Public Jenkins,2017-04-20 19:39:17+00:00,['a2805ca6fa31f6e49f4bb5167225a895c35f8974'],1,19,20,5332429,3,0,0,1,3744
692c6a555811a09827dd963d4bf4f1ffd0a3aad4,1,Impala Public Jenkins,2017-04-20 21:55:57+00:00,['8660c404c93673559c639cf7306c0a6f7ab9001f'],28,21,49,5332478,2,0,0,1,3744
fb2a78567a2172a6778da6930aba4ed489d98d72,1,Impala Public Jenkins,2017-04-20 22:50:52+00:00,['692c6a555811a09827dd963d4bf4f1ffd0a3aad4'],9,11,20,5332498,2,,,,3744
e0d1db51ed4627cbe47fcec0d9a2909d14abbe4a,1,Impala Public Jenkins,2017-04-20 22:58:56+00:00,['fb2a78567a2172a6778da6930aba4ed489d98d72'],20,51,71,5332569,5,0.291666667,1,1,3744
2a34076b2db99bb83eb3e3929d310fcb10b1dd44,0,Impala Public Jenkins,2017-04-20 23:14:33+00:00,['e0d1db51ed4627cbe47fcec0d9a2909d14abbe4a'],0,2,2,5332571,1,0,0,1,3744
baba8960b3cdb167f4eaa300559813c5cea2786d,0,Impala Public Jenkins,2017-04-20 23:27:59+00:00,['2a34076b2db99bb83eb3e3929d310fcb10b1dd44'],1,29,30,5332601,2,,,,3744
75553165eed6c5decaa7fd0bfa3ae4d537aeb7ff,1,Impala Public Jenkins,2017-04-21 04:53:09+00:00,['baba8960b3cdb167f4eaa300559813c5cea2786d'],57,203,260,5332861,8,0.306122449,1,0.755102041,3745
8bd854dfa6f40bd32e8fcd6f284c15b045b4f1ee,1,Impala Public Jenkins,2017-04-21 20:53:26+00:00,['75553165eed6c5decaa7fd0bfa3ae4d537aeb7ff'],5,20,25,5332886,1,1,1,1,3745
7fcf1ea4c36e41c299e36078664522ef629bb5de,0,Impala Public Jenkins,2017-04-21 21:03:43+00:00,['8bd854dfa6f40bd32e8fcd6f284c15b045b4f1ee'],32,45,77,5332963,11,1,1,1,3745
58b206ff0e66e6357aaf81a9e54f660472171c88,0,Impala Public Jenkins,2017-04-21 21:25:40+00:00,['7fcf1ea4c36e41c299e36078664522ef629bb5de'],19,67,86,5333049,6,0.347826087,0.347826087,1,3745
72cf359ff313ff4b79b76ac0089e00ed141c089b,1,Impala Public Jenkins,2017-04-22 20:46:09+00:00,['58b206ff0e66e6357aaf81a9e54f660472171c88'],0,4,4,5333053,4,,,,3745
c1463ff6b1db163ead319636c419ee3b3a0d3e49,0,Impala Public Jenkins,2017-04-23 03:26:07+00:00,['72cf359ff313ff4b79b76ac0089e00ed141c089b'],1,1,2,5333055,1,,,,3745
915a16345c9325f29cad2a4c113d960e434b4ba7,1,Impala Public Jenkins,2017-04-24 21:41:11+00:00,['c1463ff6b1db163ead319636c419ee3b3a0d3e49'],10,41,51,5333106,4,0,0,1,3745
edcc593ee541bb2677d58e31fe713f2cb4951937,0,Impala Public Jenkins,2017-04-25 10:50:18+00:00,['915a16345c9325f29cad2a4c113d960e434b4ba7'],2,4,6,5333112,2,,,,3745
59b2db6ba722e5bef297bb4603519e06333ce5cb,1,Impala Public Jenkins,2017-04-25 21:07:53+00:00,['edcc593ee541bb2677d58e31fe713f2cb4951937'],77,495,572,5333684,8,0,0.962264151,0.726415094,3745
5809317c9a202159ac28e0565d04151eae843d09,1,Impala Public Jenkins,2017-04-26 01:12:01+00:00,['59b2db6ba722e5bef297bb4603519e06333ce5cb'],3,19,22,5333706,3,0.75,0.75,1,3746
e2c53a8bdf646331b29c3de921b681d0d885c82e,1,Impala Public Jenkins,2017-04-26 01:45:40+00:00,['5809317c9a202159ac28e0565d04151eae843d09'],307,432,739,5334445,17,0.610169492,0.966101695,0.118644068,3746
e78d71e63328397ffdb59066982c0c6e83feb3d9,1,Impala Public Jenkins,2017-04-26 20:46:02+00:00,['e2c53a8bdf646331b29c3de921b681d0d885c82e'],121,107,228,5334673,11,0,0.333333333,0,3746
42ca45e8307ba4c831ad7ac8da86bbbd957fe4cd,1,Impala Public Jenkins,2017-04-26 21:40:32+00:00,['e78d71e63328397ffdb59066982c0c6e83feb3d9'],51,152,203,5334876,5,0,0,0,3746
6cddb952cefedd373b2a1ce71a1b3cff2e774d70,1,Impala Public Jenkins,2017-04-26 22:34:04+00:00,['42ca45e8307ba4c831ad7ac8da86bbbd957fe4cd'],37,340,377,5335253,10,0.308641975,0.296296296,0.827160494,3747
5294bb2d7a7733b4c5b3fae7a14498d85e87c90d,1,Impala Public Jenkins,2017-04-27 06:27:08+00:00,['6cddb952cefedd373b2a1ce71a1b3cff2e774d70'],0,6,6,5335259,1,0,1,1,3747
1213843d54c79bcfbf613d3fd29a00b3e44e1151,0,Impala Public Jenkins,2017-04-27 11:24:04+00:00,['5294bb2d7a7733b4c5b3fae7a14498d85e87c90d'],2,14,16,5335275,2,0,1,1,3747
2e63752858d71cc745534367a686980e060a8180,0,Impala Public Jenkins,2017-04-28 06:20:29+00:00,['1213843d54c79bcfbf613d3fd29a00b3e44e1151'],0,3,3,5335278,1,,,,3747
741421de09f4236d9a45c00753501d6e6abe90ca,0,Impala Public Jenkins,2017-04-29 02:23:51+00:00,['2e63752858d71cc745534367a686980e060a8180'],25,27,52,5335330,8,0.375,0,0,3747
c1be77458be5f57b23ae70468873bfb70be5c5e8,0,Impala Public Jenkins,2017-04-29 02:54:42+00:00,['741421de09f4236d9a45c00753501d6e6abe90ca'],3,4,7,5335337,1,0,0,1,3747
ac2217b69ee043a5abd03ad876481a7e5c7437fd,1,Impala Public Jenkins,2017-04-29 03:34:15+00:00,['c1be77458be5f57b23ae70468873bfb70be5c5e8'],2,3,5,5335342,1,,,,3747
a2a0825b2fb54b1b23e0ed43512230f447fd9038,0,Impala Public Jenkins,2017-05-01 20:04:55+00:00,['ac2217b69ee043a5abd03ad876481a7e5c7437fd'],3,2,5,5335347,1,,,,3747
77304530f1e4146e045bae9c7037c7ec8e29e9af,1,Alex Behm,2017-05-02 01:12:14+00:00,['a2a0825b2fb54b1b23e0ed43512230f447fd9038'],93,636,729,5336076,19,0.12195122,0.048780488,0.43902439,3748
801c95f39f9de6c29380910274f97748ea8e47a9,1,Impala Public Jenkins,2017-05-02 01:40:43+00:00,['77304530f1e4146e045bae9c7037c7ec8e29e9af'],170,616,786,5336862,26,0.26618705,0.604316547,0.244604317,3751
8b459dffec9e093e87da9ab6e8b2e5a9de50a7bd,0,Impala Public Jenkins,2017-05-02 04:56:01+00:00,['801c95f39f9de6c29380910274f97748ea8e47a9'],18,61,79,5336941,5,0,1,0.59375,3751
f62e6b25d41ec585876538b46033d19c4926ac24,0,Impala Public Jenkins,2017-05-02 18:59:31+00:00,['8b459dffec9e093e87da9ab6e8b2e5a9de50a7bd'],1,17,18,5336959,3,,,,3751
5803a0b0744ddaee6830d4a1bc8dba8d3f2caa26,0,Impala Public Jenkins,2017-05-02 20:24:08+00:00,['f62e6b25d41ec585876538b46033d19c4926ac24'],74,850,924,5337883,28,0.385321101,0.729357798,0.596330275,3753
698f4a34c612985df9ffcf9a9a666ee6c38c5679,0,Impala Public Jenkins,2017-05-03 01:19:58+00:00,['5803a0b0744ddaee6830d4a1bc8dba8d3f2caa26'],7,5,12,5337895,1,0,0,0,3753
920641ffdce1618199ac4d18493151acfc96cda6,0,Impala Public Jenkins,2017-05-04 01:30:26+00:00,['698f4a34c612985df9ffcf9a9a666ee6c38c5679'],1,1,2,5337897,1,,,,3753
50e3abdc3daf89c76d0d40e7f8c926477c2a1db4,1,Impala Public Jenkins,2017-05-04 02:04:03+00:00,['920641ffdce1618199ac4d18493151acfc96cda6'],8,51,59,5337956,5,1,1,1,3753
c26a485afeebb74477f4f34303411614e3cb6921,0,Impala Public Jenkins,2017-05-04 22:20:11+00:00,['50e3abdc3daf89c76d0d40e7f8c926477c2a1db4'],20,28,48,5338004,11,0.857142857,0.857142857,0.714285714,3753
aa05c6493b0ff8bbf422a4c38cf780bde34d51c7,1,Impala Public Jenkins,2017-05-06 03:40:57+00:00,['c26a485afeebb74477f4f34303411614e3cb6921'],36,130,166,5338170,3,0.454545455,0.454545455,1,3753
5cab97fd7faced41bbcc2370a400cbe92c3e0128,0,Impala Public Jenkins,2017-05-06 22:05:04+00:00,['aa05c6493b0ff8bbf422a4c38cf780bde34d51c7'],160,49,209,5338379,2,0.907407407,0.111111111,0.592592593,3753
374f1121dab4deb2ac18fd204156f45e3f3221c1,0,Impala Public Jenkins,2017-05-07 04:44:57+00:00,['5cab97fd7faced41bbcc2370a400cbe92c3e0128'],36,24,60,5338439,11,1,1,0,3753
aca07ee8160bbea0812dc4ba3c08dff818240d22,0,Impala Public Jenkins,2017-05-08 19:05:11+00:00,['374f1121dab4deb2ac18fd204156f45e3f3221c1'],1,24,25,5338464,2,,,,3753
bdad90e695860744d5289e0983f7e8e218383b68,1,Impala Public Jenkins,2017-05-08 21:36:36+00:00,['aca07ee8160bbea0812dc4ba3c08dff818240d22'],85,492,577,5339041,27,1,1,0.24,3761
25ba76287e36181c3fce81239763532f98fc9420,1,Impala Public Jenkins,2017-05-08 22:38:00+00:00,['bdad90e695860744d5289e0983f7e8e218383b68'],25,12,37,5339078,3,,,,3761
fd62a7f774676a1d32f25a1805e75c969963027a,0,Impala Public Jenkins,2017-05-09 01:25:03+00:00,['25ba76287e36181c3fce81239763532f98fc9420'],10,12,22,5339100,9,0,0.5,1,3761
12f3ecceabc5a7cdf401956376ebcd483d0c2376,1,Impala Public Jenkins,2017-05-09 01:36:46+00:00,['fd62a7f774676a1d32f25a1805e75c969963027a'],39,75,114,5339214,9,0.2,0.2,0.1,3763
368115cdae98344e5c826f099582a60aa536951d,1,Impala Public Jenkins,2017-05-09 04:04:50+00:00,['12f3ecceabc5a7cdf401956376ebcd483d0c2376'],3488,3590,7078,5346292,73,0.697478992,0.596638655,0,3768
249632b3081e94b18361a43bd635586d6b1e0ed0,1,Impala Public Jenkins,2017-05-09 09:27:39+00:00,['368115cdae98344e5c826f099582a60aa536951d'],24,40,64,5346356,9,1,1,0.75,3768
9270346825b0bbc7708d458be076d7c26038edfc,1,Lars Volker,2017-05-09 15:47:21+00:00,['249632b3081e94b18361a43bd635586d6b1e0ed0'],348,974,1322,5347678,19,0.451807229,0.801204819,0.138554217,3770
9efed59163fd7c970614cb31d72e89cf0954a32f,1,Michael Brown,2017-05-09 22:08:16+00:00,['9270346825b0bbc7708d458be076d7c26038edfc'],19,33,52,5347730,1,,,,3770
ff5b0469b1a718d8e84976c9946752cfce0e357f,1,Impala Public Jenkins,2017-05-09 22:18:11+00:00,['9efed59163fd7c970614cb31d72e89cf0954a32f'],1,1,2,5347732,1,,,,3770
eb7ee67737288e654b4c291b2d726e2f8bc9f107,1,Impala Public Jenkins,2017-05-10 00:05:48+00:00,['ff5b0469b1a718d8e84976c9946752cfce0e357f'],25,47,72,5347804,2,0.25,0.166666667,0,3770
d6b5f82e31732c355af3f3d1a8e5da94ba9c1349,1,Impala Public Jenkins,2017-05-10 09:23:05+00:00,['eb7ee67737288e654b4c291b2d726e2f8bc9f107'],312,561,873,5348677,14,0,0.901639344,0.196721311,3772
b8c8fb1b439ceffc6e167089184b14559f03699c,1,Impala Public Jenkins,2017-05-10 22:53:02+00:00,['d6b5f82e31732c355af3f3d1a8e5da94ba9c1349'],3,47,50,5348727,3,0.75,0.75,0.625,3772
49b6af54c8194af34eacd5322dd6e2ea831f27f8,0,Impala Public Jenkins,2017-05-10 22:56:38+00:00,['b8c8fb1b439ceffc6e167089184b14559f03699c'],14,38,52,5348779,3,0,1,1,3772
e7cb80b66f6ff653fa41713c090a9284c5bbc1f7,0,Impala Public Jenkins,2017-05-10 23:08:48+00:00,['49b6af54c8194af34eacd5322dd6e2ea831f27f8'],2,3,5,5348784,1,,,,3772
84110fc90b1d51410a28365d13d03f4ba1aec6fe,0,Impala Public Jenkins,2017-05-11 00:45:03+00:00,['e7cb80b66f6ff653fa41713c090a9284c5bbc1f7'],89,25,114,5348898,5,1,0.714285714,0,3772
060b80fd9aac60ce5415d80fc8059b08957b0f2c,0,Matthew Jacobs,2017-05-11 03:30:25+00:00,['84110fc90b1d51410a28365d13d03f4ba1aec6fe'],2,2,4,5348902,1,,,,3772
cb37be8935579263122088e2943d014c4a9aba21,1,Impala Public Jenkins,2017-05-11 19:36:09+00:00,['060b80fd9aac60ce5415d80fc8059b08957b0f2c'],155,425,580,5349482,8,0.380645161,1,0.974193548,3772
a16a0fa84d77f96e428b278f8cc37ebd7a49899f,1,Impala Public Jenkins,2017-05-11 20:55:51+00:00,['cb37be8935579263122088e2943d014c4a9aba21'],336,702,1038,5350520,42,0.389221557,0.497005988,0.832335329,3775
5ec1984f56a2010fb9ca98bc58ca0c9ef83b2391,1,Impala Public Jenkins,2017-05-12 00:46:55+00:00,['a16a0fa84d77f96e428b278f8cc37ebd7a49899f'],75,296,371,5350891,3,0.227941176,0.75,1,3775
0b9d2cecd7c60841c4be8e880a40e7f3bcaf05d2,1,Impala Public Jenkins,2017-05-12 05:12:58+00:00,['5ec1984f56a2010fb9ca98bc58ca0c9ef83b2391'],1,9,10,5350901,1,1,1,1,3775
1ada9dac88f5665d228538d61c3fa21c161be8f8,1,Impala Public Jenkins,2017-05-12 15:43:30+00:00,['0b9d2cecd7c60841c4be8e880a40e7f3bcaf05d2'],113,1531,1644,5352545,39,0.276056338,0.433802817,0.816901408,3777
f195b7577c268b794180da50b1f3aaf01304f3a1,0,Impala Public Jenkins,2017-05-12 19:34:16+00:00,['1ada9dac88f5665d228538d61c3fa21c161be8f8'],0,4,4,5352549,1,,,,3777
a2caacf872ac0881723c865539f5be2d3e79e0e2,1,Impala Public Jenkins,2017-05-13 02:26:56+00:00,['f195b7577c268b794180da50b1f3aaf01304f3a1'],3,16,19,5352568,3,0.888888889,0.888888889,1,3777
c826af6831719cfe5e967a56099493a103c68a90,1,Impala Public Jenkins,2017-05-15 22:57:32+00:00,['a2caacf872ac0881723c865539f5be2d3e79e0e2'],1,56,57,5352625,4,0,0.181818182,1,3777
5905083bfec82dd179fe94c1a109445f69d1faea,1,Impala Public Jenkins,2017-05-16 02:35:22+00:00,['c826af6831719cfe5e967a56099493a103c68a90'],18,46,64,5352689,4,0,0,1,3777
b73c445eba48a4637c5642fa1866e237617a322d,0,Impala Public Jenkins,2017-05-17 04:31:08+00:00,['5905083bfec82dd179fe94c1a109445f69d1faea'],0,9,9,5352698,1,0,1,0,3777
d1910a39fcc50ce211b95c3552c0c90b4bc37bbd,1,Impala Public Jenkins,2017-05-17 09:11:05+00:00,['b73c445eba48a4637c5642fa1866e237617a322d'],2,2,4,5352702,1,,,,3777
8afb59045eb5c5a69f11ac955e16d08e98277b40,0,Impala Public Jenkins,2017-05-17 15:19:12+00:00,['d1910a39fcc50ce211b95c3552c0c90b4bc37bbd'],12,7,19,5352721,2,,,0,3777
7c368999f8d991b51d440e42a7a4aafab034fe39,0,Matthew Jacobs,2017-05-17 16:34:14+00:00,['8afb59045eb5c5a69f11ac955e16d08e98277b40'],2,2,4,5352725,1,,,,3777
d04f96b990c18ed17c82c0151978b56f936f0574,0,Impala Public Jenkins,2017-05-17 23:44:37+00:00,['7c368999f8d991b51d440e42a7a4aafab034fe39'],42,5,47,5352772,2,0,0,0,3777
24c77f194b68f7ac5dd3af56b834be623949e280,1,Impala Public Jenkins,2017-05-18 21:09:51+00:00,['d04f96b990c18ed17c82c0151978b56f936f0574'],8,157,165,5352937,7,0.526315789,0.526315789,0.736842105,3777
6226e597020b6950d7f2f2d43bf54d944e194bda,1,Impala Public Jenkins,2017-05-19 00:41:46+00:00,['24c77f194b68f7ac5dd3af56b834be623949e280'],8,188,196,5353133,5,0.040816327,0.040816327,0.530612245,3777
d6e612f5c7c800bce98dc35b2e04dd893d1b6f86,1,Impala Public Jenkins,2017-05-19 08:50:25+00:00,['6226e597020b6950d7f2f2d43bf54d944e194bda'],9,39,48,5353181,4,0,0,0.5,3777
d9d4a6c69c8896ad9397e9b309cb2dd26cfaf669,0,Impala Public Jenkins,2017-05-19 18:57:24+00:00,['d6e612f5c7c800bce98dc35b2e04dd893d1b6f86'],1,173,174,5353355,1,,,,3777
3610533f4bbe8b5db74e64ad0457e9e2aff589ce,1,Impala Public Jenkins,2017-05-20 00:56:45+00:00,['d9d4a6c69c8896ad9397e9b309cb2dd26cfaf669'],6,82,88,5353443,4,,1,,3777
ee9fbeca9041349d3532d315bf07e77d784a846d,1,Impala Public Jenkins,2017-05-20 03:17:59+00:00,['3610533f4bbe8b5db74e64ad0457e9e2aff589ce'],13,75,88,5353531,4,0,1,1,3777
0c8b2d3dbeff6440cdb0223680f77f8daa10a4a7,0,Impala Public Jenkins,2017-05-22 00:40:04+00:00,['ee9fbeca9041349d3532d315bf07e77d784a846d'],279,62,341,5353872,14,1,0.66,0,3777
514e04ea4ff3b7dc4225144b869616f2f92e4573,0,Impala Public Jenkins,2017-05-22 04:51:19+00:00,['0c8b2d3dbeff6440cdb0223680f77f8daa10a4a7'],1,1,2,5353874,1,,,,3777
005101586ac89019f73d6bd6fe02c547fc54115e,1,Impala Public Jenkins,2017-05-22 10:39:12+00:00,['514e04ea4ff3b7dc4225144b869616f2f92e4573'],4,18,22,5353896,2,0.333333333,0.333333333,0.888888889,3777
f5ef7e6ae76db02d89a8d2b0b32183716fe537c9,1,Impala Public Jenkins,2017-05-22 10:44:04+00:00,['005101586ac89019f73d6bd6fe02c547fc54115e'],69,127,196,5354092,12,0.416666667,0,0.375,3777
691bbf0345da1a4771a70be07aa1c714017f5c16,1,Impala Public Jenkins,2017-05-22 17:02:33+00:00,['f5ef7e6ae76db02d89a8d2b0b32183716fe537c9'],28,71,99,5354191,3,,,,3777
21f90633044c727e81f467ccf04a217a709ab0b2,1,Impala Public Jenkins,2017-05-23 01:46:22+00:00,['691bbf0345da1a4771a70be07aa1c714017f5c16'],850,75,925,5355116,28,0.614678899,0.270642202,0.403669725,3777
6a31d355b02cbd147d4cf5f7faadfca01d328563,0,Impala Public Jenkins,2017-05-23 02:32:33+00:00,['21f90633044c727e81f467ccf04a217a709ab0b2'],4,4,8,5355124,1,1,0,0,3777
44e8bbffc33d125f1b357f4605a95bb37946de51,0,Alex Behm,2017-05-23 16:42:48+00:00,['6a31d355b02cbd147d4cf5f7faadfca01d328563'],1,44,45,5355169,3,0.137931034,1,1,3777
7cd81c52fd8b7479b36817321b60068f60aafef1,0,Impala Public Jenkins,2017-05-23 19:10:29+00:00,['44e8bbffc33d125f1b357f4605a95bb37946de51'],0,28,28,5355197,2,,,,3777
d49d964c610af18d5000d6a9daac8214b2fd8039,0,Impala Public Jenkins,2017-05-23 20:22:34+00:00,['7cd81c52fd8b7479b36817321b60068f60aafef1'],0,2,2,5355199,1,1,1,1,3777
4b54df8cd33936546d67e2136c5e12aa8f43d64b,0,Impala Public Jenkins,2017-05-23 22:55:52+00:00,['d49d964c610af18d5000d6a9daac8214b2fd8039'],0,39,39,5355238,2,,,,3777
3f1ca6357acd6f6ccbbb2d324e0d9c8c022f8a9a,0,Impala Public Jenkins,2017-05-24 00:22:31+00:00,['4b54df8cd33936546d67e2136c5e12aa8f43d64b'],8,0,8,5355246,1,,,,3777
ee0fc260d1420b34a3d3fb1073fe80b3c63a9ab9,1,Impala Public Jenkins,2017-05-24 02:38:08+00:00,['3f1ca6357acd6f6ccbbb2d324e0d9c8c022f8a9a'],73,693,766,5356012,20,0.25498008,0.697211155,0.74501992,3780
aa076491b999020b173cd21a53b28f27ee0f3b5d,1,Impala Public Jenkins,2017-05-24 03:36:02+00:00,['ee0fc260d1420b34a3d3fb1073fe80b3c63a9ab9'],54,164,218,5356230,7,0.42,0.16,0.46,3781
2bde3a4d8e72b1e1f4a9cca5106d5906d7b953ae,0,Impala Public Jenkins,2017-05-24 19:41:35+00:00,['aa076491b999020b173cd21a53b28f27ee0f3b5d'],2,2,4,5356234,1,,,,3781
7191e1b28ff450aba91d46a1001323a873bbf548,1,Impala Public Jenkins,2017-05-24 20:37:07+00:00,['2bde3a4d8e72b1e1f4a9cca5106d5906d7b953ae'],6,48,54,5356288,2,0,0.84375,0.84375,3781
eb54287fb4c635c8fc6c96872e87ad5a98b16339,1,Impala Public Jenkins,2017-05-24 22:27:37+00:00,['7191e1b28ff450aba91d46a1001323a873bbf548'],69,73,142,5356430,8,0,0,1,3781
a173f70a0ccacff2de978d171d6bb42349917471,0,Impala Public Jenkins,2017-05-25 01:37:25+00:00,['eb54287fb4c635c8fc6c96872e87ad5a98b16339'],4,3,7,5356437,1,,,,3781
b4343895d8906d66e5777edab080aacc0eeb3717,0,Impala Public Jenkins,2017-05-25 02:55:36+00:00,['a173f70a0ccacff2de978d171d6bb42349917471'],60,212,272,5356709,6,0.673469388,1,0.93877551,3781
24ff0f2fc21f0111f4c4fa9cbab40105e1e7ee01,1,Impala Public Jenkins,2017-05-25 03:30:03+00:00,['b4343895d8906d66e5777edab080aacc0eeb3717'],63,323,386,5357095,12,0.099378882,0.372670807,0.732919255,3781
3e58bf4074d0ff22696127d7ec726fa0b6a6fd9d,0,Impala Public Jenkins,2017-05-25 07:50:18+00:00,['24ff0f2fc21f0111f4c4fa9cbab40105e1e7ee01'],0,29,29,5357124,2,0,0.592592593,1,3781
25290a00caf28cca42f74848ca0fbeaeff03489b,0,Impala Public Jenkins,2017-05-25 08:24:16+00:00,['3e58bf4074d0ff22696127d7ec726fa0b6a6fd9d'],1,1,2,5357126,1,,,,3781
b2782774491b5e280c4b51e39c393810deaa1e22,0,Impala Public Jenkins,2017-05-25 11:38:06+00:00,['25290a00caf28cca42f74848ca0fbeaeff03489b'],47,114,161,5357287,9,0.16,0.08,0.16,3781
7763b8cc8d0e2a35a5ccf8dd37768750a11b5193,0,Impala Public Jenkins,2017-05-25 19:17:12+00:00,['b2782774491b5e280c4b51e39c393810deaa1e22'],1,1,2,5357289,1,,,,3781
50bd015f2d9cd66449bc8494bc35ca2aa741c156,1,Sailesh Mukil,2017-05-25 19:35:24+00:00,['7763b8cc8d0e2a35a5ccf8dd37768750a11b5193'],49,359,408,5357697,43,0.870967742,0.564516129,0.677419355,3783
4471eb3b9511fc6d7308ecd52eccacfaaa4e26e9,0,Impala Public Jenkins,2017-05-25 20:36:25+00:00,['50bd015f2d9cd66449bc8494bc35ca2aa741c156'],5,0,5,5357702,1,,,,3783
bbca087939975647c2b33355ac37c5642927bf4a,0,Impala Public Jenkins,2017-05-25 20:59:38+00:00,['4471eb3b9511fc6d7308ecd52eccacfaaa4e26e9'],2,2,4,5357706,1,,,,3783
014c5603f867907963f3821948f90d526e9a4789,1,Impala Public Jenkins,2017-05-25 21:08:59+00:00,['bbca087939975647c2b33355ac37c5642927bf4a'],34,105,139,5357845,8,1,1,1,3783
4e5497995b3b1c4e8db658a3a54ab458c5430572,0,Impala Public Jenkins,2017-05-26 07:52:40+00:00,['014c5603f867907963f3821948f90d526e9a4789'],11,13,24,5357869,3,1,1,1,3783
5d59d854d0274c89debb6f654f5cb3a0d2ef48e5,1,Impala Public Jenkins,2017-05-26 09:52:46+00:00,['4e5497995b3b1c4e8db658a3a54ab458c5430572'],13,27,40,5357909,2,0,1,1,3783
bad10da4a6eb13673aa44eb4d45d6ad87a2dd690,1,Impala Public Jenkins,2017-05-26 13:45:42+00:00,['5d59d854d0274c89debb6f654f5cb3a0d2ef48e5'],56,38,94,5358003,3,1,1,0,3783
e89d7057a6c759b91a61deef8c5ce2d91a049408,1,Impala Public Jenkins,2017-05-26 21:06:17+00:00,['bad10da4a6eb13673aa44eb4d45d6ad87a2dd690'],206,817,1023,5359026,30,0.286432161,0.628140704,0.547738693,3786
effe973a58ba2147e175aa19aeefc2be1ea840cb,1,Impala Public Jenkins,2017-05-27 03:04:38+00:00,['e89d7057a6c759b91a61deef8c5ce2d91a049408'],425,872,1297,5360323,13,0.237288136,0,0.231638418,3788
f15589573b47ad204b2ac717d136fc9ac623dbe5,1,Impala Public Jenkins,2017-05-27 05:19:53+00:00,['effe973a58ba2147e175aa19aeefc2be1ea840cb'],3932,10553,14485,5374808,41,0.75,0.75,0.8125,3795
45e2329c92c2e3e31c6940e52bedfa20f48c8fd7,0,Impala Public Jenkins,2017-05-30 19:01:20+00:00,['f15589573b47ad204b2ac717d136fc9ac623dbe5'],9,15,24,5374832,1,,,,3795
4e56cad8bf835bad4ab6f107987fb5b10fba56c6,0,Impala Public Jenkins,2017-05-31 06:49:43+00:00,['45e2329c92c2e3e31c6940e52bedfa20f48c8fd7'],0,12,12,5374844,1,,,,3795
9caf21426bf35fdb380d66c62e279d289df2783d,0,Impala Public Jenkins,2017-05-31 07:04:14+00:00,['4e56cad8bf835bad4ab6f107987fb5b10fba56c6'],2,2,4,5374848,1,1,1,1,3795
1f34a9e7034cb1b068dbcaba94d3f01295995fee,1,Impala Public Jenkins,2017-05-31 07:41:24+00:00,['9caf21426bf35fdb380d66c62e279d289df2783d'],8,17,25,5374873,5,0.875,0.875,1,3795
07a71388172e8a1f6af2724527bd381b6fbb003a,1,Impala Public Jenkins,2017-05-31 08:10:48+00:00,['1f34a9e7034cb1b068dbcaba94d3f01295995fee'],20,385,405,5375278,10,0.494117647,0.811764706,0.741176471,3796
f7f8c4518a6a329ad8c0fe19fcae05272adfab0f,1,Impala Public Jenkins,2017-06-01 01:00:13+00:00,['07a71388172e8a1f6af2724527bd381b6fbb003a'],1,30,31,5375309,6,0,0,0,3796
64e8538ab2a45794821fcf7b84160fdc334e6505,0,Impala Public Jenkins,2017-06-01 03:33:46+00:00,['f7f8c4518a6a329ad8c0fe19fcae05272adfab0f'],3,3,6,5375315,2,,,,3796
f2580acba5201628592742b1bda5f49614d1400f,0,Impala Public Jenkins,2017-06-01 17:12:27+00:00,['64e8538ab2a45794821fcf7b84160fdc334e6505'],2,67,69,5375384,2,,,,3796
9eb0b11a6dbf21948ea65f918b9c29c7f58d7571,1,Impala Public Jenkins,2017-06-01 18:13:46+00:00,['f2580acba5201628592742b1bda5f49614d1400f'],7,24,31,5375415,1,,,,3796
bbc3ce1b985d56b9fb2ab95656b7d0ae2b6126ca,0,Impala Public Jenkins,2017-06-01 21:52:19+00:00,['9eb0b11a6dbf21948ea65f918b9c29c7f58d7571'],1,1,2,5375417,1,,,,3796
9caea9bfad025274762642a03cb5483625d86a09,1,Impala Public Jenkins,2017-06-01 22:45:53+00:00,['bbc3ce1b985d56b9fb2ab95656b7d0ae2b6126ca'],26,40,66,5375483,8,0,0,1,3796
9c4f75a6a877f2b5e56d24f1e73fcf72d74f9129,1,Impala Public Jenkins,2017-06-01 22:55:09+00:00,['9caea9bfad025274762642a03cb5483625d86a09'],0,24,24,5375507,3,0.777777778,0.555555556,0.777777778,3796
2dcbefc652ac59d62e83f55a40d4833b364d50be,1,Impala Public Jenkins,2017-06-02 01:47:48+00:00,['9c4f75a6a877f2b5e56d24f1e73fcf72d74f9129'],49,312,361,5375868,19,0.036809816,0.380368098,0.779141104,3796
f3fdd4d4a8025bab1d2babe9772252f1703a60ee,0,Impala Public Jenkins,2017-06-02 04:59:25+00:00,['2dcbefc652ac59d62e83f55a40d4833b364d50be'],7,10,17,5375885,1,0,1,1,3796
cde19ab8c7801436070ce0438e28d5042265dfd1,0,Impala Public Jenkins,2017-06-02 10:03:11+00:00,['f3fdd4d4a8025bab1d2babe9772252f1703a60ee'],0,1,1,5375886,1,0,0,1,3796
95c74b7c9d04bff84dd03275cc9137a8c6395bf8,1,Impala Public Jenkins,2017-06-02 15:32:14+00:00,['cde19ab8c7801436070ce0438e28d5042265dfd1'],2,106,108,5375994,2,,,,3796
a0e3a06fc7ccfb555e86492dc49ce1511192b984,0,Impala Public Jenkins,2017-06-02 15:35:19+00:00,['95c74b7c9d04bff84dd03275cc9137a8c6395bf8'],0,80,80,5376074,1,,,,3796
1b9cb04f7997eb8f741b0708a2b2e755e8c75aed,0,Impala Public Jenkins,2017-06-02 18:03:22+00:00,['a0e3a06fc7ccfb555e86492dc49ce1511192b984'],0,18,18,5376092,1,0,0,1,3796
5518cbcb78a708047dc7056afc1f41e7f1dd8f7d,0,Impala Public Jenkins,2017-06-02 23:23:52+00:00,['1b9cb04f7997eb8f741b0708a2b2e755e8c75aed'],1,1,2,5376094,1,,,,3796
ecda49f3e3001e23bebd6bdfaa1c612716df4bf1,1,Impala Public Jenkins,2017-06-04 08:11:53+00:00,['5518cbcb78a708047dc7056afc1f41e7f1dd8f7d'],88,242,330,5376424,10,0.47826087,0.47826087,0.304347826,3798
a2281508ff64b9ef3ea730cfd98f6a1c7a497766,0,Impala Public Jenkins,2017-06-05 17:35:16+00:00,['ecda49f3e3001e23bebd6bdfaa1c612716df4bf1'],1,0,1,5376425,1,1,1,1,3798
f2cb8199ddc73833b493cc0304b9e48a6fd4658a,0,Impala Public Jenkins,2017-06-05 20:10:18+00:00,['a2281508ff64b9ef3ea730cfd98f6a1c7a497766'],1,1,2,5376427,1,,,,3798
ce3157279233b181021b01a9931758dfcf3d445e,1,Impala Public Jenkins,2017-06-05 21:09:16+00:00,['f2cb8199ddc73833b493cc0304b9e48a6fd4658a'],1,1,2,5376429,1,,,,3798
98ae318a149e4496221b366e68064b9167be8e99,0,Impala Public Jenkins,2017-06-05 22:39:54+00:00,['ce3157279233b181021b01a9931758dfcf3d445e'],2,2,4,5376433,1,,,,3798
9c8c5908867b61ff963cc14b182365f23d1f7b86,1,Lars Volker,2017-06-06 00:53:13+00:00,['98ae318a149e4496221b366e68064b9167be8e99'],9,28,37,5376470,2,1,1,1,3798
f59371d8cb914ba234a80b8428dc53cafa8077bc,1,Impala Public Jenkins,2017-06-06 00:59:56+00:00,['9c8c5908867b61ff963cc14b182365f23d1f7b86'],229,280,509,5376979,4,1,1,0,3799
f0065d376f9a0cfbefc20164c87137df56363166,1,Impala Public Jenkins,2017-06-06 02:07:53+00:00,['f59371d8cb914ba234a80b8428dc53cafa8077bc'],16,15,31,5377010,4,0,0,0,3799
bf58f111699662705838e0c748cb135d1750ec76,0,Impala Public Jenkins,2017-06-06 02:56:04+00:00,['f0065d376f9a0cfbefc20164c87137df56363166'],9,12,21,5377031,1,0,0,1,3799
5089aecdd48ab5d4e5419733760d5d29118010fd,1,Impala Public Jenkins,2017-06-06 03:40:29+00:00,['bf58f111699662705838e0c748cb135d1750ec76'],4,4,8,5377039,1,,,,3799
9400af6178b6cc63611f43764d6206c5b45fa567,1,Impala Public Jenkins,2017-06-06 05:05:21+00:00,['5089aecdd48ab5d4e5419733760d5d29118010fd'],6,6,12,5377051,1,,,,3799
fda539a1dc8928c38200a2940c85156a90bca139,0,Matthew Jacobs,2017-06-06 16:17:32+00:00,['9400af6178b6cc63611f43764d6206c5b45fa567'],2,2,4,5377055,1,,,,3799
edf9f2ffb6cdfed3884415e468cdf0b08b63aadd,0,Impala Public Jenkins,2017-06-06 18:02:49+00:00,['fda539a1dc8928c38200a2940c85156a90bca139'],3,18,21,5377076,3,,,,3799
02eb18b12b01af2c012d2313aae6498c15214bd1,0,Impala Public Jenkins,2017-06-06 18:15:27+00:00,['edf9f2ffb6cdfed3884415e468cdf0b08b63aadd'],8,13,21,5377097,1,,,,3799
227a180ab927c485f24663600114af0157d69450,1,Impala Public Jenkins,2017-06-06 18:20:41+00:00,['02eb18b12b01af2c012d2313aae6498c15214bd1'],17,19,36,5377133,8,0,0.5,1,3799
621af4b7cf932c26118ca4a3a9dc3dcc43f11adb,0,Impala Public Jenkins,2017-06-06 20:32:44+00:00,['227a180ab927c485f24663600114af0157d69450'],34,154,188,5377321,5,,,,3799
dad4896693c99f6a59be5c25bed2297a1ed57c5f,1,Impala Public Jenkins,2017-06-06 20:33:50+00:00,['621af4b7cf932c26118ca4a3a9dc3dcc43f11adb'],11,64,75,5377396,2,0.5625,0.03125,1,3799
6604083f518d332f3f13601e61a9860c23cab4ca,1,Impala Public Jenkins,2017-06-07 00:30:46+00:00,['dad4896693c99f6a59be5c25bed2297a1ed57c5f'],17,86,103,5377499,3,0.277777778,0.75,1,3799
0992a6afdaf96df744f8f25c5e747e5bb82d8a40,1,Impala Public Jenkins,2017-06-07 02:51:54+00:00,['6604083f518d332f3f13601e61a9860c23cab4ca'],1,33,34,5377533,6,0,1,1,3800
26a3d04b86bc0d4313ca634ad658d85af021ea97,0,Tim Armstrong,2017-06-07 14:25:52+00:00,['0992a6afdaf96df744f8f25c5e747e5bb82d8a40'],35,105,140,5377673,6,0.025,0,0.3,3800
91237051af9fd02f8aba5987e25f21ca98b33e52,1,Impala Public Jenkins,2017-06-08 00:16:12+00:00,['26a3d04b86bc0d4313ca634ad658d85af021ea97'],12,214,226,5377899,3,1,1,1,3801
70657a860a2f08e43d6eb5d3845749d293ae08ce,1,Impala Public Jenkins,2017-06-08 02:02:00+00:00,['91237051af9fd02f8aba5987e25f21ca98b33e52'],239,34,273,5378172,3,0,0,0,3801
54118010590d8605303715bf570cac18e1d5e64e,1,Impala Public Jenkins,2017-06-08 03:40:56+00:00,['70657a860a2f08e43d6eb5d3845749d293ae08ce'],29,37,66,5378238,2,0.5,0.75,1,3801
488291022688e750342a3d8a775d2184e98b5822,0,Impala Public Jenkins,2017-06-08 05:49:37+00:00,['54118010590d8605303715bf570cac18e1d5e64e'],7,31,38,5378276,2,0,0.461538462,0.461538462,3801
7db2d3064620b984f7dd9f8cd747dc45a4553a9c,1,Impala Public Jenkins,2017-06-08 10:09:18+00:00,['488291022688e750342a3d8a775d2184e98b5822'],55,301,356,5378632,9,0.505882353,0.611764706,1,3803
0e65409926a83c791ba6da78863bfbcdddff8f22,1,Impala Public Jenkins,2017-06-08 18:15:08+00:00,['7db2d3064620b984f7dd9f8cd747dc45a4553a9c'],1,26,27,5378659,3,,,,3803
1886da45e872055559c0d625554462d68e2b44bb,1,Impala Public Jenkins,2017-06-08 21:31:08+00:00,['0e65409926a83c791ba6da78863bfbcdddff8f22'],34,34,68,5378727,2,,,,3803
88f1f86b3d2f9ed23a94e285bad6bf09f8c80c93,0,Impala Public Jenkins,2017-06-08 22:08:03+00:00,['1886da45e872055559c0d625554462d68e2b44bb'],8,16,24,5378751,1,,,,3803
5f9f704bde6816c8469e31b1d655f3df5732dac4,1,Impala Public Jenkins,2017-06-09 01:45:37+00:00,['88f1f86b3d2f9ed23a94e285bad6bf09f8c80c93'],18,28,46,5378797,5,0.2,0.2,0,3803
eea4ad7caa8cf6ab7cea125e9564392d63ea2c27,1,Impala Public Jenkins,2017-06-09 03:39:38+00:00,['5f9f704bde6816c8469e31b1d655f3df5732dac4'],4,6,10,5378807,2,0,0,0.5,3803
87a7a6418eacea9e1be6757baa40b6df3f72f4dd,0,Impala Public Jenkins,2017-06-09 05:16:18+00:00,['eea4ad7caa8cf6ab7cea125e9564392d63ea2c27'],6,9,15,5378822,1,0,0,1,3803
1014d768883f6eb49136c05da9d699ac3605a5e2,0,Impala Public Jenkins,2017-06-09 21:14:18+00:00,['87a7a6418eacea9e1be6757baa40b6df3f72f4dd'],1,1,2,5378824,1,,,,3803
6dd50f6d0c6750c9e8e91a9b71c95f464b603f5d,0,Impala Public Jenkins,2017-06-09 23:29:17+00:00,['1014d768883f6eb49136c05da9d699ac3605a5e2'],1,1,2,5378826,1,,,,3803
1d8ad29387019b86e91092ecedc4c2f01d017da8,0,Impala Public Jenkins,2017-06-10 00:19:52+00:00,['6dd50f6d0c6750c9e8e91a9b71c95f464b603f5d'],80,232,312,5379138,8,1,0.943396226,1,3803
fa174fc962c174598ee41e558aff33698753d9f5,0,Impala Public Jenkins,2017-06-10 01:55:01+00:00,['1d8ad29387019b86e91092ecedc4c2f01d017da8'],3,8,11,5379149,1,0,1,1,3803
aba37d3218a8b2d97f41c463af51517376317bc3,1,Impala Public Jenkins,2017-06-10 02:08:37+00:00,['fa174fc962c174598ee41e558aff33698753d9f5'],55,285,340,5379489,17,0,0.911392405,0.481012658,3803
adbb0b7f817ea2fdefc46ffc0555d0223fddeadc,1,Impala Public Jenkins,2017-06-10 02:26:13+00:00,['aba37d3218a8b2d97f41c463af51517376317bc3'],4,10,14,5379503,2,0,1,0,3803
e0f69ca1da448246a6260099c64f4cc5862188a2,0,Impala Public Jenkins,2017-06-10 03:09:10+00:00,['adbb0b7f817ea2fdefc46ffc0555d0223fddeadc'],11,21,32,5379535,5,0.75,0.75,0.75,3803
de9f5230eb5580230a62b19fbc9d93a180ef8c24,0,Impala Public Jenkins,2017-06-11 18:20:22+00:00,['e0f69ca1da448246a6260099c64f4cc5862188a2'],0,4,4,5379539,1,0.5,0.5,1,3803
61696f3ba81ba27d830bf262c6e56b0712f19e53,1,Impala Public Jenkins,2017-06-12 20:31:03+00:00,['de9f5230eb5580230a62b19fbc9d93a180ef8c24'],17,126,143,5379682,2,0.428571429,0.514285714,0.885714286,3803
9fd46f7df1f6f02d0db08155d4f49bcadec0ce5f,0,Impala Public Jenkins,2017-06-12 23:54:40+00:00,['61696f3ba81ba27d830bf262c6e56b0712f19e53'],1,5,6,5379688,1,,,,3803
58baca7455fb5ff153455fe7b53292ab5e431371,0,Impala Public Jenkins,2017-06-13 00:34:21+00:00,['9fd46f7df1f6f02d0db08155d4f49bcadec0ce5f'],3,1,4,5379692,1,1,1,0,3803
7a0ee685b846b4300c00eb2dc99c6f9c462bf66e,1,Impala Public Jenkins,2017-06-13 05:13:44+00:00,['58baca7455fb5ff153455fe7b53292ab5e431371'],21,43,64,5379756,4,1,1,1,3803
467ccd19508eca0733cb061497a3c2ceca3ea849,0,Lars Volker,2017-06-13 05:57:49+00:00,['7a0ee685b846b4300c00eb2dc99c6f9c462bf66e'],4,11,15,5379771,1,,,,3803
428b5a1bfe5e8a533db95c98f8ffbc1f825cdcef,0,Impala Public Jenkins,2017-06-13 19:25:57+00:00,['467ccd19508eca0733cb061497a3c2ceca3ea849'],11,56,67,5379838,3,0.142857143,1,0.742857143,3803
11ec9f1958482bbd5dc224f55e409a8ec907f066,0,Impala Public Jenkins,2017-06-14 01:50:22+00:00,['428b5a1bfe5e8a533db95c98f8ffbc1f825cdcef'],1,2,3,5379841,1,0,0,0,3803
9ef5ad48a878f77fd78965d9d97920cfae88bd5f,0,Impala Public Jenkins,2017-06-14 08:26:29+00:00,['11ec9f1958482bbd5dc224f55e409a8ec907f066'],1,1,2,5379843,1,,,,3803
e2532a96c81ecfa2dc763306e96eb340fb49afe3,0,Impala Public Jenkins,2017-06-14 20:51:18+00:00,['9ef5ad48a878f77fd78965d9d97920cfae88bd5f'],1,2,3,5379846,1,0,1,1,3803
df2b5a938c64799a1264540c349e14593aec1544,1,Impala Public Jenkins,2017-06-15 04:26:48+00:00,['e2532a96c81ecfa2dc763306e96eb340fb49afe3'],17,27,44,5379890,5,0.125,0,1,3803
d5b6cb903de24c95de9000c473a6ddfca8516412,0,Impala Public Jenkins,2017-06-15 04:51:49+00:00,['df2b5a938c64799a1264540c349e14593aec1544'],0,75,75,5379965,4,0.181818182,1,1,3803
567814b4c9cb7f7fe2e621cebec32c8481fc0cad,1,Impala Public Jenkins,2017-06-15 20:23:48+00:00,['d5b6cb903de24c95de9000c473a6ddfca8516412'],51,357,408,5380373,14,0.471014493,0.485507246,0.891304348,3803
6d5cd6174ee4e90a9d5dae5bedf02275d3d814a8,1,Impala Public Jenkins,2017-06-15 22:00:54+00:00,['567814b4c9cb7f7fe2e621cebec32c8481fc0cad'],126,134,260,5380633,4,1,1,0,3803
1fc7e65723869e8d8f32d726044b2fefb89aa1e6,1,Impala Public Jenkins,2017-06-16 09:33:40+00:00,['6d5cd6174ee4e90a9d5dae5bedf02275d3d814a8'],0,18,18,5380651,2,0.777777778,0.777777778,0.777777778,3803
3480c892c86c41d0873c93e91f4ad5807a9daaee,0,Impala Public Jenkins,2017-06-16 09:38:23+00:00,['1fc7e65723869e8d8f32d726044b2fefb89aa1e6'],202,137,339,5380990,11,0.069767442,0.093023256,0.372093023,3803
d062257462fcbdc399c28d724b2ad5b4cad0f216,1,Impala Public Jenkins,2017-06-16 22:18:07+00:00,['3480c892c86c41d0873c93e91f4ad5807a9daaee'],6,73,79,5381069,3,0.846153846,0.846153846,1,3804
d6abb29dc915521b98a32cadbe82eb02f46c37da,0,Impala Public Jenkins,2017-06-17 00:42:48+00:00,['d062257462fcbdc399c28d724b2ad5b4cad0f216'],0,58970,58970,5440039,304,0.527245247,0.814135709,0.82777822,4106
7f3817982ff7968193e77abff051a52fc6e0d8cf,1,Impala Public Jenkins,2017-06-17 01:16:00+00:00,['d6abb29dc915521b98a32cadbe82eb02f46c37da'],14,122,136,5440175,9,0.139240506,0.518987342,0.202531646,4106
a07253a814c370bcde9bdc9351b62134ba9550ed,0,Impala Public Jenkins,2017-06-17 02:30:11+00:00,['7f3817982ff7968193e77abff051a52fc6e0d8cf'],1,1,2,5440177,1,,,,4106
bd6d2df7304ea395cfbce286ab2d47711e2ea5b4,0,Impala Public Jenkins,2017-06-17 03:18:06+00:00,['a07253a814c370bcde9bdc9351b62134ba9550ed'],0,863,863,5441040,9,0.474501109,0.616407982,0.671840355,4114
a3ce5b44889b46c7c3995bfa0cfdb620a1464ae8,1,Impala Public Jenkins,2017-06-17 10:08:29+00:00,['bd6d2df7304ea395cfbce286ab2d47711e2ea5b4'],344,977,1321,5442361,10,0.050480769,0.461538462,0.625,4114
b38d9826d7ef9bc0ecff548626d30690f935e9c3,1,Impala Public Jenkins,2017-06-18 11:08:25+00:00,['a3ce5b44889b46c7c3995bfa0cfdb620a1464ae8'],5904,6881,12785,5455146,196,0.268774704,1,1,4122
986bc76d50ebd5de42bffce41be1c1233082ef57,1,Tim Armstrong,2017-06-20 02:41:26+00:00,['b38d9826d7ef9bc0ecff548626d30690f935e9c3'],11,14,25,5455171,1,1,1,1,4122
352ad55dbf2de191e1ed3bdb1438bd80a63164c0,1,Impala Public Jenkins,2017-06-20 20:31:19+00:00,['986bc76d50ebd5de42bffce41be1c1233082ef57'],1,1,2,5455173,1,,,,4122
317c413a00bd9b3b29eeaf2efe556c2e924e2d74,1,Impala Public Jenkins,2017-06-21 02:07:25+00:00,['352ad55dbf2de191e1ed3bdb1438bd80a63164c0'],326,330,656,5455829,57,1,0.2,0.2,4122
abd4ddac3e955fd3e58a9b636c9e124b47be0ed1,0,Impala Public Jenkins,2017-06-21 03:36:12+00:00,['317c413a00bd9b3b29eeaf2efe556c2e924e2d74'],2,2,4,5455833,1,,,,4122
330558e46ee2a6e2e4d423f21fdb908fa6450d72,1,Tim Armstrong,2017-06-21 05:30:01+00:00,['abd4ddac3e955fd3e58a9b636c9e124b47be0ed1'],3,7,10,5455843,2,0,1,1,4122
53287df0a11ba43ff12067267cf2e3b0ffad075c,1,Impala Public Jenkins,2017-06-21 09:42:34+00:00,['330558e46ee2a6e2e4d423f21fdb908fa6450d72'],75,106,181,5456024,5,1,1,0,4122
23565166886d7e7b33b477e391c3e6b658a80b32,1,Impala Public Jenkins,2017-06-21 10:04:15+00:00,['53287df0a11ba43ff12067267cf2e3b0ffad075c'],92,425,517,5456541,17,0.736196319,0.950920245,0.257668712,4125
46ebbab0cfaaa8a67ddeceb2210a14a999a94733,0,Impala Public Jenkins,2017-06-21 19:16:28+00:00,['23565166886d7e7b33b477e391c3e6b658a80b32'],1,3,4,5456545,1,,,,4125
605a2711f668c854d689e4615ba44667e6765e2f,0,Impala Public Jenkins,2017-06-21 20:07:30+00:00,['46ebbab0cfaaa8a67ddeceb2210a14a999a94733'],2,2,4,5456549,1,,,,4125
266cd53c1ccd5a0dcfbcf2c26d98e5e561c2fae5,0,Impala Public Jenkins,2017-06-21 20:23:20+00:00,['605a2711f668c854d689e4615ba44667e6765e2f'],1,1,2,5456551,1,,,,4125
fae36fc77d249c6e8ac372ae47c25747f670bc9f,1,Impala Public Jenkins,2017-06-21 20:56:00+00:00,['266cd53c1ccd5a0dcfbcf2c26d98e5e561c2fae5'],85,85,170,5456721,6,1,1,1,4125
3008a7e66471a2e68be676241d8346b11e59af14,1,Impala Public Jenkins,2017-06-21 21:23:12+00:00,['fae36fc77d249c6e8ac372ae47c25747f670bc9f'],1,1,2,5456723,1,,,,4125
4a11f0bb17ae93a23328f036d982194c65cdcf9c,1,Impala Public Jenkins,2017-06-22 01:00:21+00:00,['3008a7e66471a2e68be676241d8346b11e59af14'],103,22,125,5456848,3,1,1,0.042553191,4125
29d2587bd657bd11f6ef0347abd8198676c206d7,0,Impala Public Jenkins,2017-06-22 01:25:15+00:00,['4a11f0bb17ae93a23328f036d982194c65cdcf9c'],1,2,3,5456851,1,,,,4125
7135d8cc913984a47fd9e9d1dae655ad464a3dc4,1,Impala Public Jenkins,2017-06-22 02:09:16+00:00,['29d2587bd657bd11f6ef0347abd8198676c206d7'],19,22,41,5456892,5,,,,4125
5d11203b3406a1b1c7dd90979e5c01983a977f96,0,Impala Public Jenkins,2017-06-22 06:10:38+00:00,['7135d8cc913984a47fd9e9d1dae655ad464a3dc4'],102,114,216,5457108,3,,,,4125
a306096e5665467b9525967441aa44eaee227130,1,Impala Public Jenkins,2017-06-22 19:08:59+00:00,['5d11203b3406a1b1c7dd90979e5c01983a977f96'],147,456,603,5457711,12,0.130718954,0.320261438,0.522875817,4126
54cda7858513256f776b04ae43c0a241f14faa72,1,Impala Public Jenkins,2017-06-22 21:56:25+00:00,['a306096e5665467b9525967441aa44eaee227130'],9,69,78,5457789,4,0.25,0.25,0.25,4127
00535ab1709e8aa5149a2609a5c912455e3678f8,0,Impala Public Jenkins,2017-06-23 06:17:14+00:00,['54cda7858513256f776b04ae43c0a241f14faa72'],2,12,14,5457803,3,,,,4127
604759afbc20bdd6b2acdcd5e99f9d9a87b144df,1,Impala Public Jenkins,2017-06-24 05:58:56+00:00,['00535ab1709e8aa5149a2609a5c912455e3678f8'],67,70,137,5457940,31,0.5,1,0,4127
e0ba5ef6a20213a84f68e375a43f049dd80f5737,1,Impala Public Jenkins,2017-06-26 09:06:38+00:00,['604759afbc20bdd6b2acdcd5e99f9d9a87b144df'],142,158,300,5458240,10,1,1,0.916666667,4127
27b0a5e3bd5864277640a7c018b3d22bc169820a,1,Impala Public Jenkins,2017-06-26 18:01:51+00:00,['e0ba5ef6a20213a84f68e375a43f049dd80f5737'],0,129,129,5458369,4,,,,4127
67b63f37e6f99086b64415bc9b0b99bdbbae92d5,0,Impala Public Jenkins,2017-06-26 18:05:05+00:00,['27b0a5e3bd5864277640a7c018b3d22bc169820a'],0,19,19,5458388,1,,,,4127
384e864fa19cc004e66c4139508cf44a41e0479c,0,Impala Public Jenkins,2017-06-26 23:14:07+00:00,['67b63f37e6f99086b64415bc9b0b99bdbbae92d5'],1,3,4,5458392,1,0,1,1,4127
91dbeb3c061292c832b069bdf07fb76533332f23,0,Impala Public Jenkins,2017-06-27 00:17:03+00:00,['384e864fa19cc004e66c4139508cf44a41e0479c'],0,26,26,5458418,1,,,,4127
466808aede88df3bb6b6f8faff39ab5db8103955,1,Impala Public Jenkins,2017-06-27 02:36:46+00:00,['91dbeb3c061292c832b069bdf07fb76533332f23'],1,11,12,5458430,2,0,1,1,4127
d9fc9be02195605a63365d6171b75e95e646dab7,1,Impala Public Jenkins,2017-06-27 03:40:52+00:00,['466808aede88df3bb6b6f8faff39ab5db8103955'],39,64,103,5458533,2,0.916666667,0.916666667,0.083333333,4127
4a3ef9c7731a45c028a36ef75d3a6a10bd4bf4cd,0,Impala Public Jenkins,2017-06-27 05:36:11+00:00,['d9fc9be02195605a63365d6171b75e95e646dab7'],3,39,42,5458575,2,0,0,1,4127
8a77fff9a8175a6d0939d195ac622ed099988a37,0,Impala Public Jenkins,2017-06-27 07:39:44+00:00,['4a3ef9c7731a45c028a36ef75d3a6a10bd4bf4cd'],1,7,8,5458583,1,0,0,0,4127
dbb0d863beeff16241fae87c4de3ae4bc5ab85be,1,Impala Public Jenkins,2017-06-27 20:30:34+00:00,['8a77fff9a8175a6d0939d195ac622ed099988a37'],38,983,1021,5459604,10,0.533333333,0.533333333,1,4129
9b0d71faaa18ee5e421feb55c9507be53d3ea834,0,Impala Public Jenkins,2017-06-27 22:52:07+00:00,['dbb0d863beeff16241fae87c4de3ae4bc5ab85be'],2,2,4,5459608,1,,,,4129
ae5a8770eef05f8dab025164e599eed96f033cfe,1,Impala Public Jenkins,2017-06-28 01:24:11+00:00,['9b0d71faaa18ee5e421feb55c9507be53d3ea834'],278,321,599,5460207,14,0.8125,0.9375,1,4129
dbd596bebbd4ed2e4a34ca0aa14a8a9bfcca8c62,0,Impala Public Jenkins,2017-06-28 03:10:54+00:00,['ae5a8770eef05f8dab025164e599eed96f033cfe'],6,7,13,5460220,3,,,,4129
d861db44a96887ef8156d8d57c81cd2ecd0744d4,0,Impala Public Jenkins,2017-06-28 21:21:18+00:00,['dbd596bebbd4ed2e4a34ca0aa14a8a9bfcca8c62'],3,3,6,5460226,3,,,,4129
d2430ea0ab284a560366b1172e8e73e149505ce4,1,Impala Public Jenkins,2017-06-29 01:20:47+00:00,['d861db44a96887ef8156d8d57c81cd2ecd0744d4'],5,136,141,5460367,5,0,0.6875,1,4130
ee640d902ecc96dff3d1f1117c52bd940e5bf990,0,Impala Public Jenkins,2017-06-29 02:52:54+00:00,['d2430ea0ab284a560366b1172e8e73e149505ce4'],2,2,4,5460371,1,,,,4130
7e4f23507197b1a9e5b10b65e85dcef064bf7070,0,Impala Public Jenkins,2017-06-29 04:36:53+00:00,['ee640d902ecc96dff3d1f1117c52bd940e5bf990'],2,6,8,5460379,1,0,1,1,4130
6311f39cd4a6ce71dc60547e4482e38383bc3b60,0,Impala Public Jenkins,2017-06-29 05:26:56+00:00,['7e4f23507197b1a9e5b10b65e85dcef064bf7070'],1,15,16,5460395,2,,,,4130
536a0612acce9987a990df2d8ff483ed66438146,1,Impala Public Jenkins,2017-06-29 08:57:29+00:00,['6311f39cd4a6ce71dc60547e4482e38383bc3b60'],49,284,333,5460728,13,0.478873239,0.809859155,0.795774648,4131
c4d284f3cc22a8e0f99b3974973ca2bbfa277943,1,Impala Public Jenkins,2017-06-29 21:14:59+00:00,['536a0612acce9987a990df2d8ff483ed66438146'],45,461,506,5461234,21,0.608695652,0.623188406,0.739130435,4135
f4c82bf540f2aa54bb9180231e6e5063d35ae824,0,Impala Public Jenkins,2017-06-29 22:40:04+00:00,['c4d284f3cc22a8e0f99b3974973ca2bbfa277943'],2,24,26,5461260,1,0.1,0.2,0.2,4135
3ca5a766821b8495e7e8f13b3f311c74da2e8a08,0,Impala Public Jenkins,2017-06-30 00:46:37+00:00,['f4c82bf540f2aa54bb9180231e6e5063d35ae824'],2,2,4,5461264,1,,,,4135
fb8ea6a9ccaedc41a71f6f6dcb367fc1facd73b6,0,Impala Public Jenkins,2017-06-30 09:27:47+00:00,['3ca5a766821b8495e7e8f13b3f311c74da2e8a08'],5,7,12,5461276,2,1,1,1,4135
7843b472f2fd04cd63dd5758aaf0cc082a7da025,1,Impala Public Jenkins,2017-06-30 22:49:40+00:00,['fb8ea6a9ccaedc41a71f6f6dcb367fc1facd73b6'],130,69,199,5461475,19,1,0.2,0.472727273,4135
50071597a61eefc5afc7a5ce4db56a343172ea44,0,Impala Public Jenkins,2017-07-01 03:45:19+00:00,['7843b472f2fd04cd63dd5758aaf0cc082a7da025'],65,86,151,5461626,6,1,1,0,4135
931bf49cd90e496df6bf260ae668ec6944f0016c,1,Impala Public Jenkins,2017-07-01 21:59:34+00:00,['50071597a61eefc5afc7a5ce4db56a343172ea44'],820,705,1525,5463151,26,0.769230769,0.294871795,0.41025641,4135
9f678a74269250bf5c7ae2c5e8afd93c5b3734de,1,Impala Public Jenkins,2017-07-03 00:04:54+00:00,['931bf49cd90e496df6bf260ae668ec6944f0016c'],993,1591,2584,5465735,16,0.390243902,0.5,0.256097561,4136
d7d6c036747ed7db8affd3a3fec524fd109ac6db,1,Impala Public Jenkins,2017-07-04 02:05:59+00:00,['9f678a74269250bf5c7ae2c5e8afd93c5b3734de'],19,28,47,5465782,1,0,0,0.777777778,4136
57d7c614bcce018f486f1bfeccba369cfc21391c,1,Impala Public Jenkins,2017-07-06 01:26:44+00:00,['d7d6c036747ed7db8affd3a3fec524fd109ac6db'],82,873,955,5466737,27,0.352112676,0.330985915,0.901408451,4139
03734fe870edcc0c79e465d76c9b2f62291db6be,0,Impala Public Jenkins,2017-07-06 21:23:34+00:00,['57d7c614bcce018f486f1bfeccba369cfc21391c'],3,4,7,5466744,1,,,,4139
4e17839033f931f98e0c3ec46d99b250b0bb4660,1,Impala Public Jenkins,2017-07-06 21:45:39+00:00,['03734fe870edcc0c79e465d76c9b2f62291db6be'],7,13,20,5466764,2,,,,4139
9037b8e38598a9710cd2dfcf30b9fd353bdf6191,1,Matthew Jacobs,2017-07-06 23:04:28+00:00,['4e17839033f931f98e0c3ec46d99b250b0bb4660'],5,73,78,5466842,10,0.0625,1,0.9375,4139
924066a4fa554bf8d61a429d0c6d0a55ddd9e2ff,0,Impala Public Jenkins,2017-07-07 01:30:59+00:00,['9037b8e38598a9710cd2dfcf30b9fd353bdf6191'],31,28,59,5466901,2,1,1,1,4139
da89330823f7559a57a68338fdf34c055c84d2fc,0,Impala Public Jenkins,2017-07-07 05:48:21+00:00,['924066a4fa554bf8d61a429d0c6d0a55ddd9e2ff'],5,23,28,5466929,2,,,,4139
bc1feb34d0df37d38b6c718d65d654637e9bb525,0,Impala Public Jenkins,2017-07-07 05:50:47+00:00,['da89330823f7559a57a68338fdf34c055c84d2fc'],0,57,57,5466986,3,,,,4139
081ecf01526449c2360d2d702afc1488b57e07fb,0,Impala Public Jenkins,2017-07-07 08:15:59+00:00,['bc1feb34d0df37d38b6c718d65d654637e9bb525'],72,81,153,5467139,4,1,1,1,4139
07d3cea1f096239beebed3295608743fe60e12ec,0,Impala Public Jenkins,2017-07-07 17:10:32+00:00,['081ecf01526449c2360d2d702afc1488b57e07fb'],20,20,40,5467179,8,,,,4139
717dd73d78c52ff372a0faf1af1b8c40b51101ad,1,Impala Public Jenkins,2017-07-10 17:21:39+00:00,['07d3cea1f096239beebed3295608743fe60e12ec'],0,718,718,5467897,6,,,,4140
cd44381796aa9851e074991290120d0873a010ac,0,Impala Public Jenkins,2017-07-10 23:06:18+00:00,['717dd73d78c52ff372a0faf1af1b8c40b51101ad'],0,33,33,5467930,1,,,,4140
db3f3235d7c28ff9963e0332b830ecc86f54a505,0,Impala Public Jenkins,2017-07-10 23:06:45+00:00,['cd44381796aa9851e074991290120d0873a010ac'],0,59,59,5467989,4,,,,4140
801c32dec3914939c95c2cab07f8628dd627aef5,0,Impala Public Jenkins,2017-07-10 23:08:12+00:00,['db3f3235d7c28ff9963e0332b830ecc86f54a505'],0,136,136,5468125,3,,,,4141
01b5973c403ab93d1a5aa3ba1ed4c4cb95befb54,0,Impala Public Jenkins,2017-07-11 00:12:24+00:00,['801c32dec3914939c95c2cab07f8628dd627aef5'],0,5,5,5468130,1,0,0.75,1,4141
09ff2fca2ecce1544e4e589a831fcfb02edc4f13,0,Impala Public Jenkins,2017-07-11 00:24:36+00:00,['01b5973c403ab93d1a5aa3ba1ed4c4cb95befb54'],1,6,7,5468137,1,,,,4141
f1a3d8e14dae4948ce77e2f85e036d83f2d8b246,0,Impala Public Jenkins,2017-07-11 00:26:13+00:00,['09ff2fca2ecce1544e4e589a831fcfb02edc4f13'],0,22,22,5468159,3,,,,4141
a15d8acba06e2a9850e5fc19b634e6d956330bc1,0,Impala Public Jenkins,2017-07-11 00:44:29+00:00,['f1a3d8e14dae4948ce77e2f85e036d83f2d8b246'],2,2,4,5468163,1,,,,4141
3939591aa891ce8e277f9c9a11e155927d413ea1,0,Impala Public Jenkins,2017-07-11 02:07:55+00:00,['a15d8acba06e2a9850e5fc19b634e6d956330bc1'],1,19,20,5468183,2,0,0,1,4141
7761692fb1cfb92778ece3a1e5305494a158dde9,0,Impala Public Jenkins,2017-07-11 03:10:16+00:00,['3939591aa891ce8e277f9c9a11e155927d413ea1'],13,21,34,5468217,2,0,0.4,0.8,4141
dbdab4a3385c636a39dce106f8a6854ccc546014,0,Impala Public Jenkins,2017-07-11 05:49:27+00:00,['7761692fb1cfb92778ece3a1e5305494a158dde9'],7,15,22,5468239,2,0.4,1,0.6,4141
bd3b95e3a9ac0df329d523e3ef4dac9812d39399,1,Impala Public Jenkins,2017-07-11 08:43:11+00:00,['dbdab4a3385c636a39dce106f8a6854ccc546014'],0,5,5,5468244,1,,,,4141
36cca141e0bff77b35e2890114dac41c3088e307,0,Impala Public Jenkins,2017-07-11 11:05:14+00:00,['bd3b95e3a9ac0df329d523e3ef4dac9812d39399'],2,6,8,5468252,1,0,1,1,4141
d806d5fc2af7adabb5b1572e396b0616f4ed77e1,0,Impala Public Jenkins,2017-07-11 20:06:20+00:00,['36cca141e0bff77b35e2890114dac41c3088e307'],2,2,4,5468256,1,,,,4141
5b670f49b62db90c0eca28dfc8c5c9dc9c933cd6,0,Impala Public Jenkins,2017-07-12 00:18:44+00:00,['d806d5fc2af7adabb5b1572e396b0616f4ed77e1'],4,2,6,5468262,2,,,,4141
b329e6208766e12233e8c782851b863b739d7bc1,0,Impala Public Jenkins,2017-07-12 00:34:12+00:00,['5b670f49b62db90c0eca28dfc8c5c9dc9c933cd6'],8,6,14,5468276,2,0,0,0,4141
64fd0115e5691cfaebb730651df003ffee38fd8e,1,Impala Public Jenkins,2017-07-12 01:17:24+00:00,['b329e6208766e12233e8c782851b863b739d7bc1'],615,3245,3860,5472136,59,1,1,1,4144
39e8cf313f41acc1a70be4c12b67173bd156f029,0,Impala Public Jenkins,2017-07-12 03:54:23+00:00,['64fd0115e5691cfaebb730651df003ffee38fd8e'],0,20,20,5472156,2,0.928571429,0.928571429,1,4144
4655c45e9a797ab48008c92f6be1fd4abc7c24a9,1,Impala Public Jenkins,2017-07-12 04:29:02+00:00,['39e8cf313f41acc1a70be4c12b67173bd156f029'],50,125,175,5472331,8,0.125,1,0.84375,4144
67bc7a774c778c59cdaf7be39ceb5620f75e4f34,0,Impala Public Jenkins,2017-07-12 04:40:51+00:00,['4655c45e9a797ab48008c92f6be1fd4abc7c24a9'],1,17,18,5472349,2,1,1,1,4144
1d8274a89230cf0a7e3d59268431fa3fa582bfd4,0,Impala Public Jenkins,2017-07-12 05:18:53+00:00,['67bc7a774c778c59cdaf7be39ceb5620f75e4f34'],0,3,3,5472352,1,0,1,1,4144
e6c02db9737e39b3a239e0ea8f92a2fd35f3a8fb,0,Impala Public Jenkins,2017-07-14 00:59:08+00:00,['1d8274a89230cf0a7e3d59268431fa3fa582bfd4'],5,10,15,5472367,2,0,0,0,4144
e49b3691f391ad5c0883a79ecb696b6a56c5cf2b,0,Impala Public Jenkins,2017-07-14 22:12:20+00:00,['e6c02db9737e39b3a239e0ea8f92a2fd35f3a8fb'],1,1,2,5472369,1,,,,4144
19005e6e473e0af765431d4404b61c698436ebf5,1,Impala Public Jenkins,2017-07-18 01:23:36+00:00,['e49b3691f391ad5c0883a79ecb696b6a56c5cf2b'],2,6,8,5472377,2,1,1,1,4144
bc2250f84f4cb134ed97edad2be91ec6229b88bc,1,Impala Public Jenkins,2017-07-18 02:50:56+00:00,['19005e6e473e0af765431d4404b61c698436ebf5'],22,120,142,5472519,4,0.459016393,0.393442623,0.901639344,4144
d79e01ef9fec559d4ebe57d41539f4e4164ae78f,0,Henry Robinson,2017-07-19 02:44:18+00:00,['bc2250f84f4cb134ed97edad2be91ec6229b88bc'],301,155,456,5472975,18,,,,4144
3bd21bc09b9e948659dd2547920deab39b529136,0,Impala Public Jenkins,2017-07-19 03:02:58+00:00,['d79e01ef9fec559d4ebe57d41539f4e4164ae78f'],2,2,4,5472979,1,,,,4144
bc56d3c48c3629bda989e1f6b8265bd42c1b5c63,0,Impala Public Jenkins,2017-07-19 06:48:06+00:00,['3bd21bc09b9e948659dd2547920deab39b529136'],1,18,19,5472998,2,1,0,0,4144
db5103dc9fd083344a3216c7687400dc2cade2a0,0,Tim Armstrong,2017-07-19 16:11:13+00:00,['bc56d3c48c3629bda989e1f6b8265bd42c1b5c63'],0,1,1,5472999,1,0,0,0,4144
5bb48ed71dc8272fdabac45a33b515cdd0d5f12d,1,Henry Robinson,2017-07-19 17:01:01+00:00,['db5103dc9fd083344a3216c7687400dc2cade2a0'],1,30,31,5473030,2,0.875,0.875,1,4144
7a1ff1e5e9302ad9c3bf287d414436cc0d3046cf,1,Impala Public Jenkins,2017-07-19 22:17:13+00:00,['5bb48ed71dc8272fdabac45a33b515cdd0d5f12d'],16,146,162,5473192,15,1,1,0.916666667,4146
ab287955d00939531b5bc6b9871fcb24def9d38e,1,Henry Robinson,2017-07-19 23:39:24+00:00,['7a1ff1e5e9302ad9c3bf287d414436cc0d3046cf'],178,71,249,5473441,12,0.8625,1,0.5625,4146
5c8ed4fd4366a8a39953abcaa31eb0d550af9d0b,0,Impala Public Jenkins,2017-07-20 05:39:21+00:00,['ab287955d00939531b5bc6b9871fcb24def9d38e'],0,7,7,5473448,1,,,,4146
d0bf4132084d466be820dcd867fc36110af93d82,1,Impala Public Jenkins,2017-07-20 09:39:34+00:00,['5c8ed4fd4366a8a39953abcaa31eb0d550af9d0b'],13,170,183,5473631,6,0.419354839,0,1,4147
34d9a79c599950fd06ea53cce157994b265a97eb,0,Impala Public Jenkins,2017-07-20 10:15:00+00:00,['d0bf4132084d466be820dcd867fc36110af93d82'],1,2,3,5473634,1,,,,4147
9f2f06556fe3bfe569831da99ed80f3d282dc146,0,Impala Public Jenkins,2017-07-20 19:57:53+00:00,['34d9a79c599950fd06ea53cce157994b265a97eb'],2,34,36,5473670,3,0,1,1,4147
9d1e4449cdf3f83dda6d87ebbb7bb4a6c854ce0b,0,Impala Public Jenkins,2017-07-20 22:53:25+00:00,['9f2f06556fe3bfe569831da99ed80f3d282dc146'],28,45,73,5473743,2,1,1,1,4147
83bfc142e45e6394b30f712f90d201ea57eecc02,1,Impala Public Jenkins,2017-07-21 01:14:07+00:00,['9d1e4449cdf3f83dda6d87ebbb7bb4a6c854ce0b'],5,21,26,5473769,3,1,1,1,4147
54865c4ef1a1b54bf3fcdea4de29f7aaeb9278e8,0,Impala Public Jenkins,2017-07-21 01:29:24+00:00,['83bfc142e45e6394b30f712f90d201ea57eecc02'],16,28,44,5473813,5,0,1,0,4147
daff8eb0ca19aa612c9fc7cc2ddd647735b31266,1,Impala Public Jenkins,2017-07-21 02:51:51+00:00,['54865c4ef1a1b54bf3fcdea4de29f7aaeb9278e8'],74,101,175,5473988,11,0.882352941,0.882352941,0.941176471,4147
322ccb0e4918623dad4edae68ad422018e58c7b5,1,Impala Public Jenkins,2017-07-21 19:16:57+00:00,['daff8eb0ca19aa612c9fc7cc2ddd647735b31266'],93,188,281,5474269,9,0.059701493,0.134328358,0.985074627,4147
399b184bbcf5a1fb06b5afbebf9062e69d02beed,1,Impala Public Jenkins,2017-07-21 21:49:04+00:00,['322ccb0e4918623dad4edae68ad422018e58c7b5'],31,55,86,5474355,6,0,0.923076923,0.846153846,4147
ad0c6e7499534d70d5b7de8e38199a9c5cfcbb48,1,Impala Public Jenkins,2017-07-22 00:28:36+00:00,['399b184bbcf5a1fb06b5afbebf9062e69d02beed'],70,459,529,5474884,16,0.575418994,0.592178771,0.519553073,4149
ed7324431d16a37a279d730a036197fc9019c3ce,0,Impala Public Jenkins,2017-07-22 03:44:01+00:00,['ad0c6e7499534d70d5b7de8e38199a9c5cfcbb48'],3,3,6,5474890,1,,,,4149
1653419bd8b3748bbc0e3d5e7ffa1d412bc4b50f,0,Impala Public Jenkins,2017-07-22 04:11:39+00:00,['ed7324431d16a37a279d730a036197fc9019c3ce'],7,9,16,5474906,1,,1,,4149
408b0aac831ab7d6d6459353848f9a11b811e281,0,Impala Public Jenkins,2017-07-22 05:53:06+00:00,['1653419bd8b3748bbc0e3d5e7ffa1d412bc4b50f'],4,26,30,5474936,3,,,0,4149
304edb28c7acff4b188de651d21f122c0b26f465,0,Impala Public Jenkins,2017-07-22 08:10:27+00:00,['408b0aac831ab7d6d6459353848f9a11b811e281'],22,2,24,5474960,2,,,,4149
f3d8ccdf0f19b0b4077df517cf604a863c55bb37,1,Impala Public Jenkins,2017-07-24 09:38:24+00:00,['304edb28c7acff4b188de651d21f122c0b26f465'],216,223,439,5475399,11,0,0,0,4149
ba4c6fc8987de8225fb9ac28a1bd5c8a0d12dbaa,0,Impala Public Jenkins,2017-07-24 18:03:11+00:00,['f3d8ccdf0f19b0b4077df517cf604a863c55bb37'],3,2,5,5475404,2,,,,4149
b7cc7a3699e2a2648498462ac5200dc4e79452c4,0,Impala Public Jenkins,2017-07-24 18:05:02+00:00,['ba4c6fc8987de8225fb9ac28a1bd5c8a0d12dbaa'],1,1,2,5475406,1,,,,4149
b50108a1d7cb496f5a0dfd5a6d3231e7f4fa653f,0,Impala Public Jenkins,2017-07-24 21:39:01+00:00,['b7cc7a3699e2a2648498462ac5200dc4e79452c4'],2,2,4,5475410,1,,,,4149
7a6008b9d678bcfbecc853b7b9270c5c189e04c0,0,Impala Public Jenkins,2017-07-24 23:14:10+00:00,['b50108a1d7cb496f5a0dfd5a6d3231e7f4fa653f'],9,0,9,5475419,2,,,,4149
d25db64f0e17092af9ef60eb37ec9214900c2d1c,0,Impala Public Jenkins,2017-07-25 00:09:19+00:00,['7a6008b9d678bcfbecc853b7b9270c5c189e04c0'],9,10,19,5475438,1,0,0,0,4149
d2d7328dd3aa1051bcb5329c5bea8bdc1850d281,1,Impala Public Jenkins,2017-07-25 02:01:12+00:00,['d25db64f0e17092af9ef60eb37ec9214900c2d1c'],128,15,143,5475581,4,0.833333333,0,0,4149
2c0fc30628dd1f5d9ad7831de2cad5df1bbce80a,1,Impala Public Jenkins,2017-07-25 03:31:19+00:00,['d2d7328dd3aa1051bcb5329c5bea8bdc1850d281'],8,72,80,5475661,3,1,1,0,4149
7ccbfe47fe1a0b693f6d94ae4b1062a0e3b66e88,0,Tim Armstrong,2017-07-25 03:57:14+00:00,['2c0fc30628dd1f5d9ad7831de2cad5df1bbce80a'],8,16,24,5475685,2,0,0,1,4149
1aa3a5c616ec058ab50e2185472beb9aff306b1e,1,Impala Public Jenkins,2017-07-26 05:43:01+00:00,['7ccbfe47fe1a0b693f6d94ae4b1062a0e3b66e88'],31,102,133,5475818,7,1,1,0,4149
c5a9b43db4315f4728a3454f20fa1b265a0de0fc,0,Michael Brown,2017-07-26 13:16:08+00:00,['1aa3a5c616ec058ab50e2185472beb9aff306b1e'],0,22,22,5475840,2,0.933333333,0.933333333,1,4149
b088878c8c7dab7783bc73fb9514e83095292c20,1,Impala Public Jenkins,2017-07-26 19:02:07+00:00,['c5a9b43db4315f4728a3454f20fa1b265a0de0fc'],51,146,197,5476037,16,0,1,0.615384615,4151
78845e5b6cba6eb04aa9a075bd6172b335fe4a6c,0,Impala Public Jenkins,2017-07-26 21:24:15+00:00,['b088878c8c7dab7783bc73fb9514e83095292c20'],1,1,2,5476039,1,,,,4151
41e3055f925093f971a3a800ae9601728ff9e37c,1,Impala Public Jenkins,2017-07-26 22:08:35+00:00,['78845e5b6cba6eb04aa9a075bd6172b335fe4a6c'],15,12,27,5476066,2,,,,4151
9bfcd78bdabe41c22d69afc5684e6bc6f73143af,0,Impala Public Jenkins,2017-07-28 11:24:21+00:00,['41e3055f925093f971a3a800ae9601728ff9e37c'],11,80,91,5476157,3,1,0,1,4151
fec05231b14e5309704a185182a087887932addb,0,Tim Armstrong,2017-07-28 16:51:02+00:00,['9bfcd78bdabe41c22d69afc5684e6bc6f73143af'],0,1,1,5476158,1,,,,4151
1cbfa423b4b884d160a607c7a1f359444cdd6aaf,0,Henry Robinson,2017-07-28 21:47:07+00:00,['fec05231b14e5309704a185182a087887932addb'],46,203,249,5476407,21,1,1,0.666666667,4154
e90afcb36e80d11ff4d374f37b1c84b906ab7c4f,0,Impala Public Jenkins,2017-07-28 22:45:49+00:00,['1cbfa423b4b884d160a607c7a1f359444cdd6aaf'],3,3,6,5476413,2,,,,4154
2ee160679ca693777ad6764706a251755ad6ece3,0,Impala Public Jenkins,2017-07-29 05:43:58+00:00,['e90afcb36e80d11ff4d374f37b1c84b906ab7c4f'],5,178,183,5476596,5,1,1,0.759259259,4155
862314599614fd20f6e64ccb8600cd53f0f879d5,1,Impala Public Jenkins,2017-07-29 09:43:47+00:00,['2ee160679ca693777ad6764706a251755ad6ece3'],6,31,37,5476633,3,0.047619048,0.380952381,0.380952381,4155
32960649746bca7517d0981f3563efea14c51950,0,Impala Public Jenkins,2017-07-29 20:21:40+00:00,['862314599614fd20f6e64ccb8600cd53f0f879d5'],8,226,234,5476867,4,0.454545455,1,1,4155
c8814262e79a6a5d7b6695604496361d5d9bdff5,0,Impala Public Jenkins,2017-07-29 20:24:59+00:00,['32960649746bca7517d0981f3563efea14c51950'],1,22,23,5476890,3,1,1,1,4155
15e6cf8fd03e3ae012435592f0bf4d6a64298099,1,Matthew Jacobs,2017-07-29 20:53:45+00:00,['c8814262e79a6a5d7b6695604496361d5d9bdff5'],19,36,55,5476945,3,0,0.941176471,1,4155
b2dbcbc2d1bb7d57c5f50989ad25eec1783e52b2,0,Tim Armstrong,2017-07-31 17:03:01+00:00,['15e6cf8fd03e3ae012435592f0bf4d6a64298099'],2,1,3,5476948,1,0,0,0,4155
922ee70317ec21ddc7c12a50c6b46f39ec0e7f90,1,Impala Public Jenkins,2017-07-31 21:49:17+00:00,['b2dbcbc2d1bb7d57c5f50989ad25eec1783e52b2'],1,35,36,5476984,6,0.833333333,0.833333333,1,4156
229f12c1f64c17cd029291125a8ab540259438b7,0,Impala Public Jenkins,2017-08-01 00:00:01+00:00,['922ee70317ec21ddc7c12a50c6b46f39ec0e7f90'],10,15,25,5477009,2,0.166666667,0.166666667,1,4156
b6d400c9d80d5e69d827d2a05f2a5fbae6e492c5,0,Impala Public Jenkins,2017-08-01 00:41:09+00:00,['229f12c1f64c17cd029291125a8ab540259438b7'],75,72,147,5477156,1,1,0,0,4156
3059024bd8dc63bc1f4ecb91c99e11e2ae34ebb1,1,Impala Public Jenkins,2017-08-01 01:53:04+00:00,['b6d400c9d80d5e69d827d2a05f2a5fbae6e492c5'],17,48,65,5477221,5,0.684210526,1,0.631578947,4156
ae72008747d453f4378fddb8a245b570b0528e30,0,Impala Public Jenkins,2017-08-01 07:35:28+00:00,['3059024bd8dc63bc1f4ecb91c99e11e2ae34ebb1'],4,2,6,5477227,2,1,0,1,4156
1f89d2dc4452bed4e7590ec6e8b5ce65cfd95390,1,Impala Public Jenkins,2017-08-01 20:23:37+00:00,['ae72008747d453f4378fddb8a245b570b0528e30'],2,2,4,5477231,1,,,,4156
344c26aa29cd5f0ec7711eb873cbfa2a4151942a,1,Impala Public Jenkins,2017-08-02 01:32:06+00:00,['1f89d2dc4452bed4e7590ec6e8b5ce65cfd95390'],4,14,18,5477249,3,0.75,0,1,4156
507bd8be7e5e710b37f845ef6cf23238b426ee0a,1,Impala Public Jenkins,2017-08-02 01:49:12+00:00,['344c26aa29cd5f0ec7711eb873cbfa2a4151942a'],4363,36,4399,5481648,41,0.820027688,0.687586525,0.297185048,4156
3f82d15704160f31d4060123520c3fb3493a3533,1,Impala Public Jenkins,2017-08-02 04:06:57+00:00,['507bd8be7e5e710b37f845ef6cf23238b426ee0a'],38,384,422,5482070,9,0.486956522,0.591304348,0.747826087,4156
748fe94a916d7dfc5781b3711c8484f8ae508cab,0,Impala Public Jenkins,2017-08-02 21:07:40+00:00,['3f82d15704160f31d4060123520c3fb3493a3533'],2,2,4,5482074,1,,,,4156
5797f859692ced6f30a790568b29669c663fa65c,1,Impala Public Jenkins,2017-08-03 02:20:48+00:00,['748fe94a916d7dfc5781b3711c8484f8ae508cab'],2,53,55,5482129,4,0.230769231,0.230769231,0.576923077,4156
79205bb3307a48cdfe62a8a5ccd4c78b93d2ecef,1,Impala Public Jenkins,2017-08-03 17:28:32+00:00,['5797f859692ced6f30a790568b29669c663fa65c'],8,13,21,5482150,5,1,1,1,4156
b55ec3f64f2a16259d4c5cd2e881701fee4c603f,1,Impala Public Jenkins,2017-08-04 07:54:00+00:00,['79205bb3307a48cdfe62a8a5ccd4c78b93d2ecef'],19,19,38,5482188,1,,,,4156
dced731671d28249f35d707854605e7ada82a6e0,0,Impala Public Jenkins,2017-08-04 19:51:46+00:00,['b55ec3f64f2a16259d4c5cd2e881701fee4c603f'],6,16,22,5482210,2,1,1,1,4156
2ae94e7ead090b3e80b7a75fee7026f2fe8d8ca9,1,Impala Public Jenkins,2017-08-04 21:51:19+00:00,['dced731671d28249f35d707854605e7ada82a6e0'],44,29,73,5482283,4,1,0.64,0,4156
d5b0c6b9366bc54801ac0dc74c942cdbda213b67,0,Tim Armstrong,2017-08-04 22:44:59+00:00,['2ae94e7ead090b3e80b7a75fee7026f2fe8d8ca9'],0,13,13,5482296,3,,,,4156
a98b90bd3877886e97dc2385cfdf5e3f95245533,1,Impala Public Jenkins,2017-08-05 01:03:02+00:00,['d5b0c6b9366bc54801ac0dc74c942cdbda213b67'],8334,2853,11187,5493483,122,0.765547445,0.481751825,0.210218978,4158
6b7425a574b7d5c37562c6fb0d3d1a148cf21ea0,0,Impala Public Jenkins,2017-08-05 04:40:01+00:00,['a98b90bd3877886e97dc2385cfdf5e3f95245533'],11,22,33,5493516,2,0.75,0.875,1,4158
aa0ee1e10a971cb7aee71094e15a2b1970a195bb,1,Impala Public Jenkins,2017-08-05 22:13:31+00:00,['6b7425a574b7d5c37562c6fb0d3d1a148cf21ea0'],37,140,177,5493693,13,0.615384615,0.346153846,0.673076923,4158
c4f903033ccd1965b937b77b159e4398eb91222e,1,Impala Public Jenkins,2017-08-07 00:57:46+00:00,['aa0ee1e10a971cb7aee71094e15a2b1970a195bb'],221,409,630,5494323,15,1,1,0.955555556,4161
3deb1a952919c08ed0d93b834bae59a4d73e93cd,0,Impala Public Jenkins,2017-08-07 08:53:34+00:00,['c4f903033ccd1965b937b77b159e4398eb91222e'],0,3,3,5494326,1,,,,4161
b881fba7633f138c251532f3c58255689db4e22b,0,Impala Public Jenkins,2017-08-07 19:53:59+00:00,['3deb1a952919c08ed0d93b834bae59a4d73e93cd'],11,58,69,5494395,6,0,0.6,0.6,4161
5caadbbedd1917019937290e9427fd6f798f0cd8,0,Impala Public Jenkins,2017-08-07 23:41:45+00:00,['b881fba7633f138c251532f3c58255689db4e22b'],1,1,2,5494397,1,,,,4161
0c46147e5fd93e2a9a63d145d60b656d2f6a7612,1,Impala Public Jenkins,2017-08-08 10:22:20+00:00,['5caadbbedd1917019937290e9427fd6f798f0cd8'],194,194,388,5494785,21,,,,4161
d61065d6383ece19fdafd2526ecf00dab4e1f4d4,0,Impala Public Jenkins,2017-08-08 10:23:29+00:00,['0c46147e5fd93e2a9a63d145d60b656d2f6a7612'],6,34,40,5494825,5,0.647058824,0.647058824,0,4161
68df21b426feca8e7a458152d8dca1b7e1335bcb,1,Impala Public Jenkins,2017-08-08 10:33:31+00:00,['d61065d6383ece19fdafd2526ecf00dab4e1f4d4'],143,440,583,5495408,13,0.325443787,0.928994083,0.923076923,4162
f14e68c7255927a595b5fc017cc86960f59bc8df,0,Impala Public Jenkins,2017-08-08 10:45:33+00:00,['68df21b426feca8e7a458152d8dca1b7e1335bcb'],17,68,85,5495493,4,0,0,1,4163
27dcc768d20e11f29a2d24059214dfc2bacef229,1,Impala Public Jenkins,2017-08-08 19:43:36+00:00,['f14e68c7255927a595b5fc017cc86960f59bc8df'],102,144,246,5495739,21,0.555555556,0.666666667,1,4163
4456ead8411ebb8b98282bdd646377a0e76ad6a3,1,Impala Public Jenkins,2017-08-08 22:13:11+00:00,['27dcc768d20e11f29a2d24059214dfc2bacef229'],48,17,65,5495804,5,0.315789474,0,0.368421053,4163
7007cd85feaf8cc6631551d889c0d99c6895ca16,0,Impala Public Jenkins,2017-08-09 00:04:25+00:00,['4456ead8411ebb8b98282bdd646377a0e76ad6a3'],4,3,7,5495811,1,,,,4163
d30f5f4e302845132e346263aaf3dfb8c0bb5e1e,0,Impala Public Jenkins,2017-08-09 05:48:34+00:00,['7007cd85feaf8cc6631551d889c0d99c6895ca16'],2,7,9,5495820,1,0,0,1,4163
cfcbfab4ff6df0092e68b169c46958467fc0ec14,0,Impala Public Jenkins,2017-08-09 21:47:51+00:00,['d30f5f4e302845132e346263aaf3dfb8c0bb5e1e'],7,15,22,5495842,1,0,1,1,4163
d40ada01b4ed5edc4b75bf045afa044da0368d67,1,Impala Public Jenkins,2017-08-09 22:22:43+00:00,['cfcbfab4ff6df0092e68b169c46958467fc0ec14'],3,3,6,5495848,1,,,,4163
d3a6b0bf2da1fba883b10c570ce98aff61d1b034,1,Impala Public Jenkins,2017-08-09 22:45:51+00:00,['d40ada01b4ed5edc4b75bf045afa044da0368d67'],39,436,475,5496323,20,0.915492958,0.985915493,0.788732394,4169
00e3a55cb8091b6d410fb2f40691150612900629,0,Tim Armstrong,2017-08-10 06:12:08+00:00,['d3a6b0bf2da1fba883b10c570ce98aff61d1b034'],24,74,98,5496421,2,,,,4169
9f4d9ff68fae72d2c7cce44587b82e977ea668e9,1,Impala Public Jenkins,2017-08-11 01:18:03+00:00,['00e3a55cb8091b6d410fb2f40691150612900629'],5,6,11,5496432,2,,,,4169
d5cefe07c931a0d3bf02bca97bbba05400d91a48,1,Impala Public Jenkins,2017-08-11 06:03:04+00:00,['9f4d9ff68fae72d2c7cce44587b82e977ea668e9'],38,164,202,5496634,1,,,,4169
200ce49b9cb7517b5ab0d7bcde3f2308d97f3af1,1,Impala Public Jenkins,2017-08-11 19:24:34+00:00,['d5cefe07c931a0d3bf02bca97bbba05400d91a48'],8,22,30,5496664,1,,,,4169
f2f52a8e1ce9560329566ee71945b3901a1ef958,0,Henry Robinson,2017-08-12 01:49:50+00:00,['200ce49b9cb7517b5ab0d7bcde3f2308d97f3af1'],48,54,102,5496766,12,1,1,0.833333333,4169
6c1254656186b62e90674b4fe093a6864ccbbde5,1,Impala Public Jenkins,2017-08-12 08:10:07+00:00,['f2f52a8e1ce9560329566ee71945b3901a1ef958'],241,390,631,5497397,27,0.333333333,1,0.947368421,4170
a99114283b371852254fe05eb24ac0e339cf777b,0,Henry Robinson,2017-08-13 17:01:02+00:00,['6c1254656186b62e90674b4fe093a6864ccbbde5'],31,189,220,5497617,10,0.561797753,0.764044944,1,4170
24a6e53d141cfcea158607942983e62ef5172ca6,0,Tim Armstrong,2017-08-14 03:35:21+00:00,['a99114283b371852254fe05eb24ac0e339cf777b'],47,110,157,5497774,8,0.394736842,0.842105263,0.421052632,4170
df9ecdc45a34b176f2ee6eda8e12d0195fba9ae7,0,Impala Public Jenkins,2017-08-14 09:08:36+00:00,['24a6e53d141cfcea158607942983e62ef5172ca6'],3,3,6,5497780,1,,,,4170
6757b6235c68f3886e28ecda8fc6598305717d2e,1,Thomas Tauber-Marshall,2017-08-14 19:35:12+00:00,['df9ecdc45a34b176f2ee6eda8e12d0195fba9ae7'],21,23,44,5497824,2,1,1,1,4170
84b8155cc340f7235cc2915abbeba13a081a7890,0,Henry Robinson,2017-08-15 00:45:44+00:00,['6757b6235c68f3886e28ecda8fc6598305717d2e'],0,9175,9175,5506999,49,0.366030637,0.79629132,0.79521634,4217
f51c4435c9b9ce04e5476d7b54f442e8b72db878,0,Henry Robinson,2017-08-15 00:47:26+00:00,['84b8155cc340f7235cc2915abbeba13a081a7890'],18,92,110,5507109,8,0.857142857,0,1,4217
dfb158b474afc26e761caf4b53ec4b4a48f842d3,0,Impala Public Jenkins,2017-08-15 02:04:31+00:00,['f51c4435c9b9ce04e5476d7b54f442e8b72db878'],41,53,94,5507203,3,0,0,0,4217
b9880cefbe97be2f5c7ed706a9b570c8b3234e34,0,Impala Public Jenkins,2017-08-15 04:27:36+00:00,['dfb158b474afc26e761caf4b53ec4b4a48f842d3'],0,9,9,5507212,2,0,0.555555556,1,4217
97803ce8d2dc1b56f2a2ac2a2cbaaf72e0ad54ee,0,Impala Public Jenkins,2017-08-15 04:32:07+00:00,['b9880cefbe97be2f5c7ed706a9b570c8b3234e34'],1,1,2,5507214,1,,,,4217
16ce201f5250451cb55e2cb9821b5d628d777160,1,Impala Public Jenkins,2017-08-15 09:28:05+00:00,['97803ce8d2dc1b56f2a2ac2a2cbaaf72e0ad54ee'],26,215,241,5507455,10,0.326923077,0.903846154,0.846153846,4217
aaec43b9a1dc1b1a2fb97ae257147c4f6d78f27a,0,Impala Public Jenkins,2017-08-15 16:20:57+00:00,['16ce201f5250451cb55e2cb9821b5d628d777160'],185,37,222,5507677,7,0,0,0,4217
8605784b73cc8e70940279aad5ed690deb986be4,0,Impala Public Jenkins,2017-08-15 17:41:30+00:00,['aaec43b9a1dc1b1a2fb97ae257147c4f6d78f27a'],1,1,2,5507679,1,,,,4217
b70acf92bfe7acf69775818cc16369b7527dd5e2,0,Impala Public Jenkins,2017-08-15 17:43:34+00:00,['8605784b73cc8e70940279aad5ed690deb986be4'],6,3,9,5507688,1,,,,4217
6a606ed459c173b50af7b1bd922970ac57fd17fc,0,Impala Public Jenkins,2017-08-15 20:17:36+00:00,['b70acf92bfe7acf69775818cc16369b7527dd5e2'],1,2,3,5507691,1,,,,4217
f8c36b92c3a2f59a003359c571559db961874aac,1,Impala Public Jenkins,2017-08-16 00:34:11+00:00,['6a606ed459c173b50af7b1bd922970ac57fd17fc'],3,3,6,5507697,1,,,,4217
b82957055cfa56ef22bce36122928d6d26eb3558,0,Impala Public Jenkins,2017-08-16 01:18:22+00:00,['f8c36b92c3a2f59a003359c571559db961874aac'],9,33,42,5507739,2,0.875,0.875,1,4217
bc93b1690d15d97a70cf5f6886b4969578a44240,1,Impala Public Jenkins,2017-08-16 02:04:30+00:00,['b82957055cfa56ef22bce36122928d6d26eb3558'],31,61,92,5507831,9,0.2,0.2,0,4217
8149dbfc9cc0898a7b376d754ac36b9c314ba71e,0,Impala Public Jenkins,2017-08-16 02:27:35+00:00,['bc93b1690d15d97a70cf5f6886b4969578a44240'],2,8,10,5507841,2,0,0,1,4217
e4a0e2f391bce3b8411ce7e5010856a54dc52991,1,Impala Public Jenkins,2017-08-16 08:10:02+00:00,['8149dbfc9cc0898a7b376d754ac36b9c314ba71e'],2,41,43,5507884,3,0.6,0.6,0.4,4217
f74f665b6cf4425ad890c9e1e79aced883ccbf7a,0,Impala Public Jenkins,2017-08-16 08:15:30+00:00,['e4a0e2f391bce3b8411ce7e5010856a54dc52991'],9,52,61,5507945,2,0.047619048,0,0.761904762,4217
294d42adc117046f975665834af03ddaa53ec27e,0,Impala Public Jenkins,2017-08-16 08:41:16+00:00,['f74f665b6cf4425ad890c9e1e79aced883ccbf7a'],17,45,62,5508007,4,0.055555556,1,1,4217
158fd330b8e037429aefa8fde77515c12246d76f,0,Impala Public Jenkins,2017-08-16 18:38:46+00:00,['294d42adc117046f975665834af03ddaa53ec27e'],0,62,62,5508069,1,,,,4217
b660bd652f69913ac558d5e6ab5c4bdee3d97601,1,Impala Public Jenkins,2017-08-16 23:20:22+00:00,['158fd330b8e037429aefa8fde77515c12246d76f'],134,219,353,5508422,7,1,0,1,4217
51ec60713980bd6e64e626f4476e843c49f5ea48,1,Impala Public Jenkins,2017-08-17 01:51:15+00:00,['b660bd652f69913ac558d5e6ab5c4bdee3d97601'],3,80,83,5508505,3,0.210526316,0.561403509,1,4217
79818f024f7c153c2b0348c76f1dffce0d59b655,1,Impala Public Jenkins,2017-08-17 02:29:22+00:00,['51ec60713980bd6e64e626f4476e843c49f5ea48'],26,69,95,5508600,4,0.263157895,0.894736842,0.263157895,4217
852e1bb728c790f27b49ebee2857f68860272c70,1,Tim Armstrong,2017-08-17 03:12:48+00:00,['79818f024f7c153c2b0348c76f1dffce0d59b655'],451,651,1102,5509702,36,0.37414966,0.285714286,0.789115646,4218
c7db60aa46565c19634e8a791df3af8d116b9017,0,Impala Public Jenkins,2017-08-17 03:13:20+00:00,['852e1bb728c790f27b49ebee2857f68860272c70'],0,20264,20264,5529966,77,0.425110132,0.715511245,0.80871783,4295
da60a9a15ab21fd2569a90e1e91df56ae2640819,0,Impala Public Jenkins,2017-08-17 05:48:02+00:00,['c7db60aa46565c19634e8a791df3af8d116b9017'],1,1,2,5529968,1,,,,4295
86e88cad5d7ee41264bbb66742b267ef67dec47e,1,Impala Public Jenkins,2017-08-17 09:04:56+00:00,['da60a9a15ab21fd2569a90e1e91df56ae2640819'],309,403,712,5530680,82,0,0.421052632,0.526315789,4295
5fcc9cb4cc2a9848c7d8ba677494588d8014fa92,0,Impala Public Jenkins,2017-08-17 20:01:27+00:00,['86e88cad5d7ee41264bbb66742b267ef67dec47e'],5,32,37,5530717,4,0.75,1,1,4295
8609b09a95f2b20e42e4ba4aa8b5d605fb545a4e,1,Impala Public Jenkins,2017-08-17 20:17:48+00:00,['5fcc9cb4cc2a9848c7d8ba677494588d8014fa92'],11,187,198,5530915,14,0.43902439,1,0.87804878,4296
5c82f9d84cc46735ed515a92d2e5d43fa5b88d84,0,Impala Public Jenkins,2017-08-17 23:05:56+00:00,['8609b09a95f2b20e42e4ba4aa8b5d605fb545a4e'],0,2,2,5530917,1,,,,4296
79fba2768768107e408644e0caea15f60b5f3354,0,Impala Public Jenkins,2017-08-18 02:53:23+00:00,['5c82f9d84cc46735ed515a92d2e5d43fa5b88d84'],0,13,13,5530930,1,,,,4296
039255a6ad01be785fb7b5ee02758dd125218ba9,0,Impala Public Jenkins,2017-08-18 04:22:32+00:00,['79fba2768768107e408644e0caea15f60b5f3354'],84,243,327,5531257,14,0,0.831578947,0.589473684,4296
dc2f69e5a0b36ca721eeadeec661a251c957410b,0,Impala Public Jenkins,2017-08-18 04:51:30+00:00,['039255a6ad01be785fb7b5ee02758dd125218ba9'],10,9,19,5531276,1,1,1,1,4296
985698bb6f69a61bc2bd88b8fb7e89d476d970a5,0,Impala Public Jenkins,2017-08-18 19:34:35+00:00,['dc2f69e5a0b36ca721eeadeec661a251c957410b'],27,39,66,5531342,7,,,,4296
082058e2c760e7b5bd84f580bed61a21aee16f25,1,Impala Public Jenkins,2017-08-18 23:27:38+00:00,['985698bb6f69a61bc2bd88b8fb7e89d476d970a5'],51,65,116,5531458,3,0,1,1,4296
3e770405e328f883610ce40867f770e588839c13,0,Impala Public Jenkins,2017-08-19 20:56:10+00:00,['082058e2c760e7b5bd84f580bed61a21aee16f25'],3,24,27,5531485,3,,,,4296
3b5c460ac27e81f1169b5babe0b28e664bdd237e,1,Henry Robinson,2017-08-20 22:23:43+00:00,['3e770405e328f883610ce40867f770e588839c13'],8,9,17,5531502,2,0,1,1,4296
fcf32b584b3afa9099f3553dc9506c97fac27275,1,Impala Public Jenkins,2017-08-21 09:38:27+00:00,['3b5c460ac27e81f1169b5babe0b28e664bdd237e'],10,33,43,5531545,2,0,1,1,4296
7d6b05a7215d579f8df6c0685575662c6cfc09c4,0,Impala Public Jenkins,2017-08-21 22:02:57+00:00,['fcf32b584b3afa9099f3553dc9506c97fac27275'],1,1,2,5531547,1,,0,,4296
1e1be6d6e0a4aa7c3779f478ae1d0a061efa37ad,0,Impala Public Jenkins,2017-08-22 03:50:16+00:00,['7d6b05a7215d579f8df6c0685575662c6cfc09c4'],2,2,4,5531551,1,,,,4296
d0d0af27863370d66a9f5c7fa902e08eac0a37d5,1,Impala Public Jenkins,2017-08-22 04:37:14+00:00,['1e1be6d6e0a4aa7c3779f478ae1d0a061efa37ad'],53,136,189,5531740,11,0.244444444,0.377777778,0.911111111,4296
5ec404640a4aea64d086b9828a317a424f8b5f65,0,Impala Public Jenkins,2017-08-22 07:28:10+00:00,['d0d0af27863370d66a9f5c7fa902e08eac0a37d5'],191,193,384,5532124,9,1,1,0,4296
7264c547516569b6c1152bcb61724ee8c2ee79d0,1,Impala Public Jenkins,2017-08-22 08:27:12+00:00,['5ec404640a4aea64d086b9828a317a424f8b5f65'],99,293,392,5532516,13,0,0.519480519,0.103896104,4298
f9b222e9229ef3830f00b0e47073d7a8880e2bfb,0,Impala Public Jenkins,2017-08-22 08:56:22+00:00,['7264c547516569b6c1152bcb61724ee8c2ee79d0'],5,6,11,5532527,1,,,,4298
e3075c39ac488ebbb59a2483c78ebb106d13d5b1,1,Impala Public Jenkins,2017-08-22 19:42:05+00:00,['f9b222e9229ef3830f00b0e47073d7a8880e2bfb'],802,908,1710,5534237,8,0,0,1,4298
db60c1cd24ea80bded09dd93a2f28f548ce9db32,1,Impala Public Jenkins,2017-08-22 20:41:07+00:00,['e3075c39ac488ebbb59a2483c78ebb106d13d5b1'],2,2,4,5534241,1,,,,4298
2f3e824af6b80becb4feeba23138ccfbe6c0602d,0,Impala Public Jenkins,2017-08-22 21:35:24+00:00,['db60c1cd24ea80bded09dd93a2f28f548ce9db32'],1,5,6,5534247,1,,0,,4298
e71e359affb21a699ab6b659170bea51bce86388,0,Impala Public Jenkins,2017-08-22 21:45:48+00:00,['2f3e824af6b80becb4feeba23138ccfbe6c0602d'],85,85,170,5534417,18,,,,4298
b98c621a801d75dc1e8f9603c858335548d54cfb,1,Impala Public Jenkins,2017-08-23 02:35:15+00:00,['e71e359affb21a699ab6b659170bea51bce86388'],53,53,106,5534523,3,1,1,0,4298
c8f531b2052f78bce8e06c781224986bca398798,0,Impala Public Jenkins,2017-08-23 03:26:00+00:00,['b98c621a801d75dc1e8f9603c858335548d54cfb'],23,24,47,5534570,1,,,,4298
ed87c4060017399b3e0ee144347a38b14a4b1794,1,Impala Public Jenkins,2017-08-23 03:27:26+00:00,['c8f531b2052f78bce8e06c781224986bca398798'],165,902,1067,5535637,34,0.358208955,0.611940299,0.76119403,4301
c871e007bed662732944fd5bb8d88e306ff4865b,1,Impala Public Jenkins,2017-08-23 03:34:45+00:00,['ed87c4060017399b3e0ee144347a38b14a4b1794'],4,81,85,5535722,2,0.071428571,0.625,1,4301
b6c02972d6bb8dc4c62ef806c6145acae95842ad,0,Impala Public Jenkins,2017-08-23 03:59:02+00:00,['c871e007bed662732944fd5bb8d88e306ff4865b'],5,42,47,5535769,3,0,0,1,4301
57dae5ec7e927a1c836f6bf0a1cbe5a81541327e,1,Impala Public Jenkins,2017-08-23 04:44:21+00:00,['b6c02972d6bb8dc4c62ef806c6145acae95842ad'],31,172,203,5535972,4,0.433962264,0.037735849,0.830188679,4301
5f323124ae4e68e4022f0d7be5d0872988124eb0,0,Impala Public Jenkins,2017-08-23 04:49:13+00:00,['57dae5ec7e927a1c836f6bf0a1cbe5a81541327e'],3,4,7,5535979,2,0,0,0,4301
3b1a1df7e30de7d21cc30eba8bc7d318ee063d5a,0,Impala Public Jenkins,2017-08-23 06:17:17+00:00,['5f323124ae4e68e4022f0d7be5d0872988124eb0'],1,7,8,5535987,1,0,0,1,4301
679ebc1ac66e07edc0e81b34c8ed56a0a8aff0ca,1,Impala Public Jenkins,2017-08-23 06:24:12+00:00,['3b1a1df7e30de7d21cc30eba8bc7d318ee063d5a'],28,136,164,5536151,7,0.655172414,0.655172414,0.086206897,4302
d8bc570b67930dd136a7a10fc05dfa4b995c65fa,0,Impala Public Jenkins,2017-08-23 07:18:33+00:00,['679ebc1ac66e07edc0e81b34c8ed56a0a8aff0ca'],44,34,78,5536229,5,1,0,0,4302
cb645b1bcb3e18123bee0916da9fbcf7ff55050d,0,Impala Public Jenkins,2017-08-23 20:15:37+00:00,['d8bc570b67930dd136a7a10fc05dfa4b995c65fa'],1,1,2,5536231,1,,,,4302
91fc5b587926bca079bfbe52d7471d5460788418,0,Impala Public Jenkins,2017-08-23 23:55:04+00:00,['cb645b1bcb3e18123bee0916da9fbcf7ff55050d'],2,2,4,5536235,1,,,,4302
74dad1702aaa58f22ea98cbde25765190ff452a2,0,Impala Public Jenkins,2017-08-24 02:04:13+00:00,['91fc5b587926bca079bfbe52d7471d5460788418'],7,7,14,5536249,4,,,,4302
81c3d883b9be13f1afe766477f2d056afd9a3a8a,0,Impala Public Jenkins,2017-08-24 02:23:21+00:00,['74dad1702aaa58f22ea98cbde25765190ff452a2'],3,8,11,5536260,1,,,,4302
6f20df81f727f89dfb1efef9a86f39cf5a4ef88a,0,Impala Public Jenkins,2017-08-24 02:32:13+00:00,['81c3d883b9be13f1afe766477f2d056afd9a3a8a'],40,131,171,5536431,10,0.862068966,0,1,4302
ff5e9b6c9a35e2869c0c845d7bbb7beb16b5d45e,1,Impala Public Jenkins,2017-08-24 02:40:28+00:00,['6f20df81f727f89dfb1efef9a86f39cf5a4ef88a'],34,237,271,5536702,9,0.434782609,0.985507246,0.913043478,4303
c67b198a19eda12c99905c2b9db30cc86f6e332d,1,Impala Public Jenkins,2017-08-24 02:42:01+00:00,['ff5e9b6c9a35e2869c0c845d7bbb7beb16b5d45e'],11,13,24,5536726,3,0.333333333,0.333333333,1,4303
acaf8b9f0cb7ea94b1c1ab8cd6a2f7c89d8be2e4,0,Impala Public Jenkins,2017-08-24 04:24:10+00:00,['c67b198a19eda12c99905c2b9db30cc86f6e332d'],91,435,526,5537252,8,0.493150685,0.438356164,0.821917808,4305
88d00b4b09ed4bf727083296dab2cfb843ae1c41,0,Impala Public Jenkins,2017-08-24 05:54:01+00:00,['acaf8b9f0cb7ea94b1c1ab8cd6a2f7c89d8be2e4'],17,611,628,5537880,10,,,,4306
bb6b0ce249f561af04ea42752ca874cd93dd63c9,0,Impala Public Jenkins,2017-08-24 06:27:05+00:00,['88d00b4b09ed4bf727083296dab2cfb843ae1c41'],1,45,46,5537926,3,1,1,1,4307
b2ebf3de369c628b58259cce1ffb031b6b7d0b20,0,Impala Public Jenkins,2017-08-24 06:55:08+00:00,['bb6b0ce249f561af04ea42752ca874cd93dd63c9'],8,17,25,5537951,3,0,0,1,4307
d03e7d6ce59343924b9659089dc709225630e0fc,0,Impala Public Jenkins,2017-08-24 10:11:09+00:00,['b2ebf3de369c628b58259cce1ffb031b6b7d0b20'],24,115,139,5538090,3,0.264705882,0.264705882,0.352941176,4307
fb735df134652b4131f77e1807684af0cc424647,1,Michael Brown,2017-08-24 19:41:33+00:00,['d03e7d6ce59343924b9659089dc709225630e0fc'],60,92,152,5538242,1,0.666666667,0.523809524,1,4307
dc7792c98026323ad87d49fa6f616ee378cc30cd,1,Impala Public Jenkins,2017-08-24 22:37:19+00:00,['fb735df134652b4131f77e1807684af0cc424647'],0,85,85,5538327,4,0.393442623,0,0.62295082,4307
2a7c8b9011905bfeb21b0610f0739f9df9daacef,1,Impala Public Jenkins,2017-08-25 00:48:28+00:00,['dc7792c98026323ad87d49fa6f616ee378cc30cd'],119,108,227,5538554,9,0.857142857,0.357142857,0.071428571,4307
51c7fcd5dc4a7fe1d8788be534809c4969ffe8a7,0,Impala Public Jenkins,2017-08-25 01:17:46+00:00,['2a7c8b9011905bfeb21b0610f0739f9df9daacef'],0,9,9,5538563,1,,,,4307
b524a5ce69945fb2c7a7667bd2a66f371161bc2a,1,Impala Public Jenkins,2017-08-25 02:58:16+00:00,['51c7fcd5dc4a7fe1d8788be534809c4969ffe8a7'],1,41,42,5538605,2,,,,4307
48539a1bbcfd2697dcd8e519b47e4e6d55a05e5c,0,Impala Public Jenkins,2017-08-25 22:30:23+00:00,['b524a5ce69945fb2c7a7667bd2a66f371161bc2a'],5,39,44,5538649,2,0.45,1,1,4307
113526198051f6810c84df513d507074856f5e4c,0,Impala Public Jenkins,2017-08-25 22:51:41+00:00,['48539a1bbcfd2697dcd8e519b47e4e6d55a05e5c'],14,151,165,5538814,7,,,,4308
f20b1626b8bdf2a87e089cb18f82cd80a7cc981c,0,Impala Public Jenkins,2017-08-26 01:44:26+00:00,['113526198051f6810c84df513d507074856f5e4c'],3,6,9,5538823,1,,,,4308
244c1fba66ffcce64b205ee04e69dd6a51087d99,0,Impala Public Jenkins,2017-08-26 08:33:12+00:00,['f20b1626b8bdf2a87e089cb18f82cd80a7cc981c'],143,328,471,5539294,13,0.3203125,1,0,4308
5f2a440698a1d9958b75b2f16284c19dba563a46,1,Tim Armstrong,2017-08-28 15:14:23+00:00,['244c1fba66ffcce64b205ee04e69dd6a51087d99'],0,2,2,5539296,1,0,0,0,4308
59d1aa6ea7788398574263c4a716b41c8b250ba6,1,Impala Public Jenkins,2017-08-28 20:03:06+00:00,['5f2a440698a1d9958b75b2f16284c19dba563a46'],180,60,240,5539536,2,0.842105263,0.842105263,0.342105263,4308
260a97256f0aae47bbba56fa2a08c6f4c63d1e1d,0,Impala Public Jenkins,2017-08-29 01:28:02+00:00,['59d1aa6ea7788398574263c4a716b41c8b250ba6'],8,10,18,5539554,1,0,1,1,4308
77e9e262af8a28ecc54aa545ed13f66aa57106a3,1,Impala Public Jenkins,2017-08-29 02:43:47+00:00,['260a97256f0aae47bbba56fa2a08c6f4c63d1e1d'],35,57,92,5539646,3,1,0.105263158,0.105263158,4309
593ec25736bffdea11ffceb645a27f27d2eb73f5,0,Impala Public Jenkins,2017-08-29 02:45:00+00:00,['77e9e262af8a28ecc54aa545ed13f66aa57106a3'],31,14,45,5539691,4,0,0,0,4309
d637642534dcfd0b92b1caa7848cf4bf3f97f70a,0,Impala Public Jenkins,2017-08-29 03:26:20+00:00,['593ec25736bffdea11ffceb645a27f27d2eb73f5'],2,3,5,5539696,1,,,,4309
f6c38ac5dcd5a732e111fa5d26c4f2c4f481c347,0,Impala Public Jenkins,2017-08-29 04:30:45+00:00,['d637642534dcfd0b92b1caa7848cf4bf3f97f70a'],4,2,6,5539702,1,,,,4309
8149d0e5778525cb4988953377685946f31d70a2,0,Impala Public Jenkins,2017-08-29 05:22:51+00:00,['f6c38ac5dcd5a732e111fa5d26c4f2c4f481c347'],9,5,14,5539716,1,1,1,0,4309
6a9ca345b0dc913f82c0a6ea4d793153732e3916,0,Tim Armstrong,2017-08-29 20:01:17+00:00,['8149d0e5778525cb4988953377685946f31d70a2'],3,1,4,5539720,1,1,1,1,4309
caefd86136e7d8d5d3cd390402abf3370dc6cc6f,1,Impala Public Jenkins,2017-08-29 23:01:10+00:00,['6a9ca345b0dc913f82c0a6ea4d793153732e3916'],23,85,108,5539828,4,1,1,1,4310
35f5c7bd37e7151f7f71d3136e9a16da6e85d582,1,Impala Public Jenkins,2017-08-30 00:26:52+00:00,['caefd86136e7d8d5d3cd390402abf3370dc6cc6f'],30,33,63,5539891,19,,,,4310
d5670d6b912c65c9156d165603d65336d96a30a1,0,Impala Public Jenkins,2017-08-30 03:36:41+00:00,['35f5c7bd37e7151f7f71d3136e9a16da6e85d582'],2,2,4,5539895,1,,,,4310
cc4816b3d6ae2ca00ce61b1bc442161bfbe6de3f,0,Impala Public Jenkins,2017-08-30 04:04:08+00:00,['d5670d6b912c65c9156d165603d65336d96a30a1'],10,65,75,5539970,5,0.315789474,1,0.342105263,4310
c1c4815049ca3deab7465070b1207446cb3a1645,0,Impala Public Jenkins,2017-08-30 07:33:58+00:00,['cc4816b3d6ae2ca00ce61b1bc442161bfbe6de3f'],24,443,467,5540437,15,0.325,0.675,0.9375,4310
8c8a1a65e02ed25f22d87adcb42069b269f2d6c1,0,Impala Public Jenkins,2017-08-30 20:22:25+00:00,['c1c4815049ca3deab7465070b1207446cb3a1645'],36,83,119,5540556,2,1,1,1,4310
a48960e2eb9f953d56d67a4fd126b70c2ffc697f,0,Impala Public Jenkins,2017-08-30 21:10:45+00:00,['8c8a1a65e02ed25f22d87adcb42069b269f2d6c1'],0,3,3,5540559,3,,,,4310
9e03e933204001b3b243d4093b10bbe309c61dd9,0,Impala Public Jenkins,2017-08-30 21:20:47+00:00,['a48960e2eb9f953d56d67a4fd126b70c2ffc697f'],67,81,148,5540707,7,0,0,1,4310
701cd503e749993d65646336ecbc09b8b8df695e,0,Impala Public Jenkins,2017-08-30 22:05:47+00:00,['9e03e933204001b3b243d4093b10bbe309c61dd9'],48,59,107,5540814,8,0.875,1,0.375,4310
95f5fb7548df92e20cd2eb2d67e84447fa224ab1,0,Impala Public Jenkins,2017-08-31 01:08:40+00:00,['701cd503e749993d65646336ecbc09b8b8df695e'],22,22,44,5540858,23,,,,4310
8aaf9ec1fb5a0eab4b3a62eff35101cd07890938,0,Impala Public Jenkins,2017-08-31 01:40:47+00:00,['95f5fb7548df92e20cd2eb2d67e84447fa224ab1'],4,14,18,5540876,5,,,,4310
ec2ba02d1668fb7f604fb3b40db54ef76d98798f,0,Impala Public Jenkins,2017-08-31 01:50:41+00:00,['8aaf9ec1fb5a0eab4b3a62eff35101cd07890938'],2,2,4,5540880,1,,,,4310
7b6ad283f46d31aa953d4d44e142b0bc6b0afbb4,1,Impala Public Jenkins,2017-08-31 02:09:54+00:00,['ec2ba02d1668fb7f604fb3b40db54ef76d98798f'],60,158,218,5541098,16,0.520833333,0.625,1,4310
3a41c21e1780798636e4290d126d4daf10fe96e9,0,Impala Public Jenkins,2017-08-31 02:15:42+00:00,['7b6ad283f46d31aa953d4d44e142b0bc6b0afbb4'],55,431,486,5541584,10,0.25087108,1,0.31358885,4310
c163ac1468e4d878c3516ec933c69fb66851af01,0,Impala Public Jenkins,2017-08-31 02:50:16+00:00,['3a41c21e1780798636e4290d126d4daf10fe96e9'],4,7,11,5541595,1,,,,4310
30129c4535e3505bb203c3f84e2d3da7c73f1117,1,Impala Public Jenkins,2017-08-31 03:42:46+00:00,['c163ac1468e4d878c3516ec933c69fb66851af01'],16,10,26,5541621,1,1,1,0,4310
b66af0357ec905581f0544048a9a7a8a1ae9dca8,1,Impala Public Jenkins,2017-08-31 19:12:49+00:00,['30129c4535e3505bb203c3f84e2d3da7c73f1117'],6,6,12,5541633,1,,,,4310
b20f45962c5ccbc4e1006c0cad2cdda646527fa6,0,Impala Public Jenkins,2017-09-01 00:35:51+00:00,['b66af0357ec905581f0544048a9a7a8a1ae9dca8'],2,4,6,5541639,3,,,,4310
d1239a9b49131825f2949671f1f9b85cce199c68,0,Sailesh Mukil,2017-09-01 03:08:51+00:00,['b20f45962c5ccbc4e1006c0cad2cdda646527fa6'],0,3,3,5541642,1,1,1,1,4310
e7bd0ce5b9f2d44bc0d429672924d19a0142c2b1,0,Sailesh Mukil,2017-09-01 03:09:25+00:00,['d1239a9b49131825f2949671f1f9b85cce199c68'],7,10,17,5541659,1,1,1,1,4310
7d41b96b23c2a084247f38dcdf068053e46e432c,0,Sailesh Mukil,2017-09-01 03:11:43+00:00,['e7bd0ce5b9f2d44bc0d429672924d19a0142c2b1'],120,175,295,5541954,8,,,,4312
1b70eb661a04ff1642d7862df9cd30a3e7d9ab6f,0,Sailesh Mukil,2017-09-01 03:12:49+00:00,['7d41b96b23c2a084247f38dcdf068053e46e432c'],36,13,49,5542003,5,0,0,0,4312
64e28021957f6993aea5ceb3ad626fb577597107,0,Impala Public Jenkins,2017-09-01 21:31:55+00:00,['1b70eb661a04ff1642d7862df9cd30a3e7d9ab6f'],9,23,32,5542035,3,0,1,1,4312
2774d80f6b604a4e6256606c6f50c9d21f715fa4,0,Impala Public Jenkins,2017-09-02 03:22:00+00:00,['64e28021957f6993aea5ceb3ad626fb577597107'],57,29,86,5542121,2,1,1,0,4312
e4a2d226a7649b29c346b3f4f072984a938af787,0,Impala Public Jenkins,2017-09-02 08:21:21+00:00,['2774d80f6b604a4e6256606c6f50c9d21f715fa4'],85,142,227,5542348,16,0.217391304,0.934782609,0.717391304,4312
ac8a72f3041688316a20c9a85eda5a5cb9af1578,1,Henry Robinson,2017-09-02 18:39:21+00:00,['e4a2d226a7649b29c346b3f4f072984a938af787'],35,77,112,5542460,8,0,0,0.833333333,4312
796db0fce374c9aff0ec6e1e82862db012b8854a,0,Impala Public Jenkins,2017-09-05 21:35:20+00:00,['ac8a72f3041688316a20c9a85eda5a5cb9af1578'],33,38,71,5542531,3,0.5,0.5,0.5,4312
915d30f4bb6334e9d816e080722484537732fe3d,1,Impala Public Jenkins,2017-09-06 00:09:40+00:00,['796db0fce374c9aff0ec6e1e82862db012b8854a'],12,33,45,5542576,4,0.333333333,0.666666667,0.666666667,4312
9ce691af22d37d9e6914b6cc82dc241b9530e200,1,Impala Public Jenkins,2017-09-06 00:10:45+00:00,['915d30f4bb6334e9d816e080722484537732fe3d'],8,33,41,5542617,4,1,1,1,4312
f8e7c31b2c681da91c02011fe2207c30dec3d6c5,1,Impala Public Jenkins,2017-09-06 03:05:38+00:00,['9ce691af22d37d9e6914b6cc82dc241b9530e200'],36,59,95,5542712,2,1,1,1,4312
387bde0639ffd8ef580ccbf727152954e62bacbe,0,Impala Public Jenkins,2017-09-06 19:43:57+00:00,['f8e7c31b2c681da91c02011fe2207c30dec3d6c5'],60,106,166,5542878,7,1,1,1,4312
545eab6d6202ca3968279d14fad28bd2a6d566f6,0,Impala Public Jenkins,2017-09-06 20:07:56+00:00,['387bde0639ffd8ef580ccbf727152954e62bacbe'],1,27,28,5542906,4,0.833333333,0.833333333,0,4313
91f7bc1947c1800e689fee040d4820fd8dbf94e4,1,Impala Public Jenkins,2017-09-06 21:26:24+00:00,['545eab6d6202ca3968279d14fad28bd2a6d566f6'],22,73,95,5543001,6,0,0,0.3125,4313
4c9b46a904c5b660ab5faa33cf1c58ab6417d799,1,Impala Public Jenkins,2017-09-06 22:49:05+00:00,['91f7bc1947c1800e689fee040d4820fd8dbf94e4'],0,19,19,5543020,2,0,0,1,4313
be98aaacada6966ca39741696d8f95d24f2d3117,0,Impala Public Jenkins,2017-09-07 00:52:56+00:00,['4c9b46a904c5b660ab5faa33cf1c58ab6417d799'],2,12,14,5543034,1,0,0,0.8,4313
b1edaf215e537d8cef5ffb305973b6c5baa63583,1,Impala Public Jenkins,2017-09-07 01:22:41+00:00,['be98aaacada6966ca39741696d8f95d24f2d3117'],52,105,157,5543191,20,0.863636364,0.863636364,0.136363636,4313
f538b43911eb4bdc4ce5269038f0011e3e83a3de,1,Impala Public Jenkins,2017-09-07 01:29:01+00:00,['b1edaf215e537d8cef5ffb305973b6c5baa63583'],46,382,428,5543619,5,0.180392157,0.8,0.760784314,4313
897f025c69bd0dd45520721a0d6eb9c9f14aa342,0,Impala Public Jenkins,2017-09-07 01:47:41+00:00,['f538b43911eb4bdc4ce5269038f0011e3e83a3de'],62,117,179,5543798,26,1,1,1,4313
e993b9712c81dfb66fdf65bb5269cdc38a8eef18,1,Impala Public Jenkins,2017-09-07 03:25:30+00:00,['897f025c69bd0dd45520721a0d6eb9c9f14aa342'],216,456,672,5544470,55,0.015384615,0.253846154,0.761538462,4313
72b7e1cc12a17fab2e8e72eb1db898388b8814fd,0,Impala Public Jenkins,2017-09-07 23:00:16+00:00,['e993b9712c81dfb66fdf65bb5269cdc38a8eef18'],2,2,4,5544474,1,,,,4313
ac689131190f5bf01a7c0a4892c30647139e7d32,0,Impala Public Jenkins,2017-09-07 23:41:25+00:00,['72b7e1cc12a17fab2e8e72eb1db898388b8814fd'],0,173,173,5544647,3,,,,4313
2fbdc8e37e4cb0a3b3408e90b5a972d778fea7eb,0,Impala Public Jenkins,2017-09-08 03:05:11+00:00,['ac689131190f5bf01a7c0a4892c30647139e7d32'],50,104,154,5544801,3,0.2,0.8,0.9,4313
e1ae9884168b0c455fa147bb10dc57d37989f9e8,0,Impala Public Jenkins,2017-09-12 01:53:20+00:00,['2fbdc8e37e4cb0a3b3408e90b5a972d778fea7eb'],6,6,12,5544813,1,,,,4313
4e84262074cab9cc8ad83a5a9d5bc42b4be42d76,0,Impala Public Jenkins,2017-09-12 03:46:21+00:00,['e1ae9884168b0c455fa147bb10dc57d37989f9e8'],10,20,30,5544843,4,0,1,0.428571429,4313
39f23bb8b9d7cd01c3e31962c9b9e35c4827a593,0,Impala Public Jenkins,2017-09-12 03:54:21+00:00,['4e84262074cab9cc8ad83a5a9d5bc42b4be42d76'],9,13,22,5544865,4,0,0.75,0.75,4313
03571788be44d903a81dc092a447c74ccb9bac76,1,Impala Public Jenkins,2017-09-12 07:02:09+00:00,['39f23bb8b9d7cd01c3e31962c9b9e35c4827a593'],5,12,17,5544882,3,,,,4313
84233b297826524548be4476b8ee356f9d02f885,0,Impala Public Jenkins,2017-09-12 07:23:16+00:00,['03571788be44d903a81dc092a447c74ccb9bac76'],8,8,16,5544898,1,,,,4313
4a5757fae063f6935d05941783904a8b04697fa0,0,Impala Public Jenkins,2017-09-12 21:06:42+00:00,['84233b297826524548be4476b8ee356f9d02f885'],2,2,4,5544902,1,,,,4313
d7e41a3776991645577412583b2116fa0d3f192a,1,Impala Public Jenkins,2017-09-13 00:55:05+00:00,['4a5757fae063f6935d05941783904a8b04697fa0'],21,30,51,5544953,1,0,0,1,4313
34d63e9dea9765c48ae2040bd25a718d39fc6314,1,Impala Public Jenkins,2017-09-13 07:36:04+00:00,['d7e41a3776991645577412583b2116fa0d3f192a'],2,12,14,5544967,3,0,0.888888889,0.888888889,4313
caa382c284fcae6b795c48d53cace6956fc41371,1,Impala Public Jenkins,2017-09-13 07:39:03+00:00,['34d63e9dea9765c48ae2040bd25a718d39fc6314'],16,53,69,5545036,6,0,0,0,4313
322e2dc80259cfa712fc6d0d224d2c2c16a6708d,1,Impala Public Jenkins,2017-09-13 09:20:53+00:00,['caa382c284fcae6b795c48d53cace6956fc41371'],55,104,159,5545195,9,0.103448276,0.24137931,0.827586207,4313
6596bebe009e363a0095b2a29b17a73b0b891856,0,Tim Armstrong,2017-09-13 15:23:06+00:00,['322e2dc80259cfa712fc6d0d224d2c2c16a6708d'],0,59,59,5545254,1,,,,4314
cbf38dcd03ea5abb92d11a9d35e032e2428d299f,0,Impala Public Jenkins,2017-09-14 00:32:11+00:00,['6596bebe009e363a0095b2a29b17a73b0b891856'],12,10,22,5545276,3,0,,,4314
5325b1c07f4d215b9e5502076b925f05cea7c2b9,0,Tim Armstrong,2017-09-14 06:29:53+00:00,['cbf38dcd03ea5abb92d11a9d35e032e2428d299f'],0,2,2,5545278,1,,,,4314
3e73ce2c4d2a591ef91291d520d4cb3e1d69b092,0,Impala Public Jenkins,2017-09-14 16:27:06+00:00,['5325b1c07f4d215b9e5502076b925f05cea7c2b9'],1,1,2,5545280,1,,,,4314
50d603d306c58ef42605eeb715356e1003dedeb4,0,Impala Public Jenkins,2017-09-15 01:59:29+00:00,['3e73ce2c4d2a591ef91291d520d4cb3e1d69b092'],332,279,611,5545891,6,0.8,0.514285714,0.028571429,4314
032dee28de2fe95f80d9284eb41b64fd12a56c86,1,Impala Public Jenkins,2017-09-15 02:26:49+00:00,['50d603d306c58ef42605eeb715356e1003dedeb4'],5,46,51,5545942,2,1,1,1,4314
0a54cb5ec0f5d1646e5fa3d211dd2b765242816e,1,Impala Public Jenkins,2017-09-15 02:30:29+00:00,['032dee28de2fe95f80d9284eb41b64fd12a56c86'],56,256,312,5546254,3,0.333333333,0.985815603,0.907801418,4314
bdbfe22c7f19a6c5599b5bb7d59b8e035ffc6cc9,0,Impala Public Jenkins,2017-09-15 20:48:00+00:00,['0a54cb5ec0f5d1646e5fa3d211dd2b765242816e'],1,1,2,5546256,1,,,,4314
02302b7cfee0397a9d8080289635fb694d89f15d,1,Impala Public Jenkins,2017-09-15 22:48:52+00:00,['bdbfe22c7f19a6c5599b5bb7d59b8e035ffc6cc9'],122,205,327,5546583,19,0.276923077,0.769230769,0.938461538,4315
491822f0e3c8e5b4890533924d72375caad4bc74,0,Impala Public Jenkins,2017-09-16 00:46:05+00:00,['02302b7cfee0397a9d8080289635fb694d89f15d'],5,158,163,5546746,6,0.510638298,0.510638298,0.617021277,4317
5119ced50c0e0c4001621c9d4da598c187bdb580,1,Impala Public Jenkins,2017-09-16 00:50:07+00:00,['491822f0e3c8e5b4890533924d72375caad4bc74'],4,23,27,5546773,2,0,0,0,4317
f0e79314fe9d9d3e920ad65c3ca6a4ef279e68fc,0,Impala Public Jenkins,2017-09-16 04:06:53+00:00,['5119ced50c0e0c4001621c9d4da598c187bdb580'],106,60,166,5546939,7,0,0,0,4317
1e63ff8431baa17da0785406dccc60eb8038be93,0,Impala Public Jenkins,2017-09-18 19:35:28+00:00,['f0e79314fe9d9d3e920ad65c3ca6a4ef279e68fc'],32,45,77,5547016,11,0,0.2,0.8,4317
8ad6d03310825418b6aa1d427200b07bc8bdb0bc,1,Matthew Jacobs,2017-09-19 21:32:07+00:00,['1e63ff8431baa17da0785406dccc60eb8038be93'],17,1690,1707,5548723,18,0.364569961,0.535301669,0.654685494,4330
eecbbcb7c7f392c417d4b65117435faf6ef32820,0,David Knupp,2017-09-19 22:59:04+00:00,['8ad6d03310825418b6aa1d427200b07bc8bdb0bc'],2,5,7,5548730,1,,,,4330
741b0524a43c93f2d339dad259dea510524cbdbe,0,Impala Public Jenkins,2017-09-20 02:45:04+00:00,['eecbbcb7c7f392c417d4b65117435faf6ef32820'],16,7,23,5548753,1,1,1,0,4330
7866eec5bdcbf9194a4aad2c87c354cbaad7b802,1,Impala Public Jenkins,2017-09-20 08:48:38+00:00,['741b0524a43c93f2d339dad259dea510524cbdbe'],430,460,890,5549643,43,1,0,0.5,4330
fc275fab62c41f3ddc2978fab531b61870817541,0,Impala Public Jenkins,2017-09-20 10:30:04+00:00,['7866eec5bdcbf9194a4aad2c87c354cbaad7b802'],0,1,1,5549644,1,,,,4330
fa93a47dd70ad23d45dfc8b9498d00a4c52e54da,1,Impala Public Jenkins,2017-09-21 00:56:36+00:00,['fc275fab62c41f3ddc2978fab531b61870817541'],23,50,73,5549717,3,,,,4331
f87da848f5f204ae0dc84ffd9de64007e197c4d9,1,Tim Armstrong,2017-09-21 17:38:08+00:00,['fa93a47dd70ad23d45dfc8b9498d00a4c52e54da'],20,71,91,5549808,7,0,0,0,4331
77c0e32f33f55a39387fa4b63f0a23462c805ef8,0,Tim Armstrong,2017-09-21 20:48:00+00:00,['f87da848f5f204ae0dc84ffd9de64007e197c4d9'],32,2,34,5549842,3,0.92,1,0,4331
a6438540a221b5df85ac764652e65a3f699eea0b,0,Impala Public Jenkins,2017-09-21 21:31:23+00:00,['77c0e32f33f55a39387fa4b63f0a23462c805ef8'],11,9,20,5549862,1,1,0.25,0.25,4331
bd08ed42304b7375f5bc9c5ba6d72088cc76678a,1,Impala Public Jenkins,2017-09-21 21:41:31+00:00,['a6438540a221b5df85ac764652e65a3f699eea0b'],4,10,14,5549876,2,0.6,0.6,1,4331
b175226869853e219165a8fe3f7ab67ba7187caf,0,Impala Public Jenkins,2017-09-21 22:25:09+00:00,['bd08ed42304b7375f5bc9c5ba6d72088cc76678a'],45,74,119,5549995,3,0.592592593,0.740740741,0.407407407,4331
537ae013eef8022532fba5b193d5c9d0b1892dba,0,Michael Brown,2017-09-21 22:57:26+00:00,['b175226869853e219165a8fe3f7ab67ba7187caf'],1,1,2,5549997,1,,,,4331
eb276d48e4fc651d910ccb3af78a235eac190905,0,Impala Public Jenkins,2017-09-22 00:53:49+00:00,['537ae013eef8022532fba5b193d5c9d0b1892dba'],6,9,15,5550012,1,1,0,0,4331
71fd1941f006bb8e7629c8bcfbcfd1da050deed1,0,Alex Behm,2017-09-22 03:39:04+00:00,['eb276d48e4fc651d910ccb3af78a235eac190905'],25,25,50,5550062,4,,,,4331
98df90767a069585822eac8393a01a872e15d215,0,Impala Public Jenkins,2017-09-22 03:45:28+00:00,['71fd1941f006bb8e7629c8bcfbcfd1da050deed1'],8,31,39,5550101,1,0.526315789,0.526315789,0.421052632,4331
4953254409d5779b41b74c4b6b96c45cc49d6824,0,Impala Public Jenkins,2017-09-22 05:08:22+00:00,['98df90767a069585822eac8393a01a872e15d215'],10,14,24,5550125,3,1,1,1,4332
f53ce3b16d476214167a686ecb513c6d866105b9,0,Impala Public Jenkins,2017-09-23 02:41:32+00:00,['4953254409d5779b41b74c4b6b96c45cc49d6824'],13,41,54,5550179,5,0.347826087,1,1,4332
d53f43b42c7c41f72d6a31505344f0393bdbe8a5,0,Impala Public Jenkins,2017-09-23 02:46:01+00:00,['f53ce3b16d476214167a686ecb513c6d866105b9'],13,274,287,5550466,5,0.42519685,1,0.94488189,4333
646920810f581698c5150553d6bccc0f82c0fe6b,1,Impala Public Jenkins,2017-09-23 04:33:20+00:00,['d53f43b42c7c41f72d6a31505344f0393bdbe8a5'],8,184,192,5550658,6,0,0.627906977,1,4333
79dc220bd75eb5dc333aeeff3f65fc5dbfe3a6e8,0,Impala Public Jenkins,2017-09-25 19:37:20+00:00,['646920810f581698c5150553d6bccc0f82c0fe6b'],9,311,320,5550978,10,0.080291971,1,0.102189781,4334
d565386b245128cedaa07367a2ff8407988aeaa2,0,Impala Public Jenkins,2017-09-26 18:44:19+00:00,['79dc220bd75eb5dc333aeeff3f65fc5dbfe3a6e8'],1,54,55,5551033,4,,,,4334
dd340b8810ecd00ad2ffe79845ca137e941aefb7,1,Impala Public Jenkins,2017-09-26 20:20:56+00:00,['d565386b245128cedaa07367a2ff8407988aeaa2'],438,477,915,5551948,21,0,0,0,4334
439f245d34fa7a76508a5a620a0d69e7bed947a4,0,Impala Public Jenkins,2017-09-27 03:27:45+00:00,['dd340b8810ecd00ad2ffe79845ca137e941aefb7'],4,4,8,5551956,2,,,,4334
4d49099a8bbea3f24f53272f321a19266dc932b8,1,Impala Public Jenkins,2017-09-27 18:55:26+00:00,['439f245d34fa7a76508a5a620a0d69e7bed947a4'],4,11,15,5551971,5,0.428571429,1,1,4334
c1781b73b35899ed9374befa2e04e14747224be7,1,Impala Public Jenkins,2017-09-28 18:36:17+00:00,['4d49099a8bbea3f24f53272f321a19266dc932b8'],136,126,262,5552233,7,0,0,0,4334
a93b7c52bf17838bcbfeb5002b982f213df4be31,0,Impala Public Jenkins,2017-09-28 21:54:39+00:00,['c1781b73b35899ed9374befa2e04e14747224be7'],1,0,1,5552234,1,,,,4334
1969c56c2fba248794d4d52eae4410998afa0709,1,Impala Public Jenkins,2017-09-29 01:50:31+00:00,['a93b7c52bf17838bcbfeb5002b982f213df4be31'],2,2,4,5552238,1,,,,4334
64d0dd93eca13ae27714f1aadf90bf9f6e2c9c15,1,Impala Public Jenkins,2017-09-29 18:38:03+00:00,['1969c56c2fba248794d4d52eae4410998afa0709'],0,90,90,5552328,3,,,,4334
5d92264c48c23c4cc673e5308cf152d694173f8e,0,Impala Public Jenkins,2017-09-30 00:50:43+00:00,['64d0dd93eca13ae27714f1aadf90bf9f6e2c9c15'],33,0,33,5552361,2,0,0,0,4334
c07391ce518ffec0441839f70a822f78683acffc,0,Impala Public Jenkins,2017-09-30 01:13:19+00:00,['5d92264c48c23c4cc673e5308cf152d694173f8e'],2,19,21,5552382,3,1,1,1,4334
c38a1ac1edf77a342ce52bdf544d79d5f98f197d,1,Impala Public Jenkins,2017-10-02 20:01:25+00:00,['c07391ce518ffec0441839f70a822f78683acffc'],114,131,245,5552627,6,1,1,1,4334
eb11b46be683ddadb307a90f3f968706d6ed46e8,1,Impala Public Jenkins,2017-10-03 01:11:50+00:00,['c38a1ac1edf77a342ce52bdf544d79d5f98f197d'],60,106,166,5552793,7,1,1,1,4334
ef990cf9b579e26982d4b8074350415666bfb8ec,0,Impala Public Jenkins,2017-10-03 01:33:34+00:00,['eb11b46be683ddadb307a90f3f968706d6ed46e8'],3,4,7,5552800,1,,,,4334
fed75810bc8eba0195e5c55845ae04715ea75203,1,Impala Public Jenkins,2017-10-03 02:20:17+00:00,['ef990cf9b579e26982d4b8074350415666bfb8ec'],138,129,267,5553067,10,1,1,1,4334
3c870aa360c5c2447ba0412e7758e3d78333110a,1,Alex Behm,2017-10-03 21:03:53+00:00,['fed75810bc8eba0195e5c55845ae04715ea75203'],11,10,21,5553088,2,,,,4334
98092dd6cb53c5a54978d8eccc1906f187aecb0b,1,Impala Public Jenkins,2017-10-03 22:15:21+00:00,['3c870aa360c5c2447ba0412e7758e3d78333110a'],8,24,32,5553120,1,,,,4334
0601f06cb62549e132e1a4a1a272e72fb3839e30,1,Impala Public Jenkins,2017-10-04 03:14:20+00:00,['98092dd6cb53c5a54978d8eccc1906f187aecb0b'],1,73,74,5553194,2,,,,4334
ab0bc9eedf1b871a32c25507164101f1d30694db,0,Impala Public Jenkins,2017-10-04 08:26:04+00:00,['0601f06cb62549e132e1a4a1a272e72fb3839e30'],117,117,234,5553428,45,,,,4334
6259641077250dcd3360e2e6c2bf9023b201d858,1,Impala Public Jenkins,2017-10-04 09:37:36+00:00,['ab0bc9eedf1b871a32c25507164101f1d30694db'],61,332,393,5553821,5,0.157894737,0,0.828947368,4334
72072f6e89880c57a4afd3a88304eb963806ea7c,0,Tim Armstrong,2017-10-04 20:51:47+00:00,['6259641077250dcd3360e2e6c2bf9023b201d858'],1,1,2,5553823,1,,,,4334
4dd0f1b3d84f67eb40bf671160b057be9bbdb921,0,Impala Public Jenkins,2017-10-05 02:26:01+00:00,['72072f6e89880c57a4afd3a88304eb963806ea7c'],110,157,267,5554090,10,0,1,0.666666667,4334
226c99e01c49d3d25840c5982474740a7dcb9c62,0,Impala Public Jenkins,2017-10-05 02:50:36+00:00,['4dd0f1b3d84f67eb40bf671160b057be9bbdb921'],21,32,53,5554143,6,0.428571429,1,1,4334
c9740b43d1493a8249ad7497430e5bfbcc6ebf64,1,Impala Public Jenkins,2017-10-05 03:04:38+00:00,['226c99e01c49d3d25840c5982474740a7dcb9c62'],26,266,292,5554435,14,0.198275862,0.922413793,0.862068966,4335
af6d1156302026715e73db637b5ff3c7059745bc,0,Impala Public Jenkins,2017-10-05 19:50:53+00:00,['c9740b43d1493a8249ad7497430e5bfbcc6ebf64'],2,2,4,5554439,1,,,,4335
44ef4cb105d8c48773142592a41d37da93b97de9,0,Tim Armstrong,2017-10-05 20:59:48+00:00,['af6d1156302026715e73db637b5ff3c7059745bc'],1,1,2,5554441,1,,,,4335
d8bdea5e8206b47bf5bbcf8bda7b4edd7fec935a,0,Impala Public Jenkins,2017-10-05 23:49:43+00:00,['44ef4cb105d8c48773142592a41d37da93b97de9'],0,92,92,5554533,3,,,,4335
c14a0904005ce150e15820c8bb9ade94fb58ed56,1,Impala Public Jenkins,2017-10-06 00:01:08+00:00,['d8bdea5e8206b47bf5bbcf8bda7b4edd7fec935a'],839,753,1592,5556125,76,0,0.3,0,4335
d40047aa9b6aff6ef33c10ce5f05ebdac9b37e63,1,Impala Public Jenkins,2017-10-06 00:32:17+00:00,['c14a0904005ce150e15820c8bb9ade94fb58ed56'],16,50,66,5556191,1,0.24,0.92,0,4335
ec957456d26cf0935654e8a70dbc1f36e8c1adae,0,Impala Public Jenkins,2017-10-06 03:02:05+00:00,['d40047aa9b6aff6ef33c10ce5f05ebdac9b37e63'],217,0,217,5556408,4,0.318181818,0,0.515151515,4335
1e581a66dddae5b400e50e440063d16de868bb63,0,Impala Public Jenkins,2017-10-06 04:42:15+00:00,['ec957456d26cf0935654e8a70dbc1f36e8c1adae'],0,26,26,5556434,1,,,,4335
e6594bf0280ce3f097ca2d6400fb14f135078b96,0,Impala Public Jenkins,2017-10-06 06:51:31+00:00,['1e581a66dddae5b400e50e440063d16de868bb63'],0,144,144,5556578,1,,,,4335
dd4c6be8e082d4dd42e099e9a03ed23fdae9c13b,1,Impala Public Jenkins,2017-10-06 07:09:55+00:00,['e6594bf0280ce3f097ca2d6400fb14f135078b96'],51,780,831,5557409,19,0.493023256,1,0.6,4341
bd6577e3ccaed8b045a544e567bbf784e420e206,0,Impala Public Jenkins,2017-10-06 16:45:47+00:00,['dd4c6be8e082d4dd42e099e9a03ed23fdae9c13b'],2,69,71,5557480,1,,,,4341
6ff54ab3b65194cc020a1228b3596346bc5a4013,0,Impala Public Jenkins,2017-10-06 19:10:22+00:00,['bd6577e3ccaed8b045a544e567bbf784e420e206'],0,56,56,5557536,1,,,,4341
581dfe002e732a39fe53456ebca49ff261716f02,0,Impala Public Jenkins,2017-10-06 20:05:17+00:00,['6ff54ab3b65194cc020a1228b3596346bc5a4013'],10,11,21,5557557,2,,,,4341
36cd610d6ba27104a40207ca34132b3349231d11,0,Impala Public Jenkins,2017-10-06 22:29:55+00:00,['581dfe002e732a39fe53456ebca49ff261716f02'],17,170,187,5557744,2,,,,4341
e278ed228b9e15bcf2ba89dab6b002eb8d71f892,1,Impala Public Jenkins,2017-10-06 23:33:15+00:00,['36cd610d6ba27104a40207ca34132b3349231d11'],110,172,282,5558026,4,,,,4341
874a1158972566de06b4d3b355b56b18c874fd92,0,Impala Public Jenkins,2017-10-07 00:18:52+00:00,['e278ed228b9e15bcf2ba89dab6b002eb8d71f892'],8,619,627,5558653,8,,,,4345
999a444e246fcfc7aca2f48541428886dd994b63,1,Impala Public Jenkins,2017-10-07 03:16:06+00:00,['874a1158972566de06b4d3b355b56b18c874fd92'],23,142,165,5558818,3,0.33,0.71,0.91,4345
adb92d33979c71a62481e7eeae4b96f6588a18d5,1,Impala Public Jenkins,2017-10-10 01:25:27+00:00,['999a444e246fcfc7aca2f48541428886dd994b63'],7,30,37,5558855,1,1,1,1,4345
192cd96d9ee3be1cd3e7c3ad774bf8d5c8efb1c0,1,Impala Public Jenkins,2017-10-10 01:30:33+00:00,['adb92d33979c71a62481e7eeae4b96f6588a18d5'],13,132,145,5559000,7,0.4,0.784615385,0.584615385,4349
2747d521ad92ea38f3cf25fee6de6777dbf95677,0,Impala Public Jenkins,2017-10-10 02:20:49+00:00,['192cd96d9ee3be1cd3e7c3ad774bf8d5c8efb1c0'],15,16,31,5559031,6,1,1,1,4349
e5703433200007e634d7d9fdc895a1dbbdd4b3f4,0,Impala Public Jenkins,2017-10-10 02:37:42+00:00,['2747d521ad92ea38f3cf25fee6de6777dbf95677'],2,4,6,5559037,2,0,1,1,4349
c189d0a39cfb106f369522c57926196cc772da5e,0,Impala Public Jenkins,2017-10-10 02:45:46+00:00,['e5703433200007e634d7d9fdc895a1dbbdd4b3f4'],5,6,11,5559048,1,1,1,1,4349
87065638f04d0830d359b5d145f62c8cb44014d3,1,Impala Public Jenkins,2017-10-10 21:54:33+00:00,['c189d0a39cfb106f369522c57926196cc772da5e'],126,265,391,5559439,3,0.03125,0.7265625,0.859375,4349
f03900a805dff636fa05cf430e15bf6fed70e80a,0,Impala Public Jenkins,2017-10-10 23:08:44+00:00,['87065638f04d0830d359b5d145f62c8cb44014d3'],23,33,56,5559495,1,,,,4349
3bdde74a70ce8f202faee8ce52b157ea88860ecf,0,Impala Public Jenkins,2017-10-11 21:45:40+00:00,['f03900a805dff636fa05cf430e15bf6fed70e80a'],4,15,19,5559514,1,0,1,0,4349
0290e92da866ac92b4b2fbfa6054f1fa9ad13995,0,Impala Public Jenkins,2017-10-11 22:32:50+00:00,['3bdde74a70ce8f202faee8ce52b157ea88860ecf'],6,16,22,5559536,2,0,0,1,4349
dae5eb8d86b4fc2d1196b20d125254f15870b2e7,0,Impala Public Jenkins,2017-10-12 01:34:13+00:00,['0290e92da866ac92b4b2fbfa6054f1fa9ad13995'],4,9,13,5559549,2,0.333333333,1,1,4349
0bddf0fb635abd8ef90c0385a2972ef4bf2ce75c,0,Impala Public Jenkins,2017-10-12 02:16:20+00:00,['dae5eb8d86b4fc2d1196b20d125254f15870b2e7'],0,4,4,5559553,1,,,,4349
f2357a227e8e95742caebab4e7e6c27cbf4cafeb,0,Lars Volker,2017-10-12 16:39:26+00:00,['0bddf0fb635abd8ef90c0385a2972ef4bf2ce75c'],2,7,9,5559562,2,0,1,1,4349
9ba92394816d033aef10d69d8767b73ce9f68a09,0,Impala Public Jenkins,2017-10-12 20:30:57+00:00,['f2357a227e8e95742caebab4e7e6c27cbf4cafeb'],3,3,6,5559568,1,,,,4349
2187d36b36f5b2fc4318e57265cc31ee11d22423,1,Jim Apple,2017-10-12 20:54:36+00:00,['9ba92394816d033aef10d69d8767b73ce9f68a09'],174,227,401,5559969,3,,,,4350
bf29ec53c3ee94db83e266cfcba0b95e7b82e3a9,0,Impala Public Jenkins,2017-10-14 01:02:08+00:00,['2187d36b36f5b2fc4318e57265cc31ee11d22423'],0,1,1,5559970,1,1,1,1,4350
80f0c5ae820efeb9e3714cf844e856b264ed291d,0,Impala Public Jenkins,2017-10-17 03:59:20+00:00,['bf29ec53c3ee94db83e266cfcba0b95e7b82e3a9'],1,1,2,5559972,1,,,,4350
0d5fcc8662e42c2e418f90e04f7b33517b55568e,0,Impala Public Jenkins,2017-10-17 22:01:44+00:00,['80f0c5ae820efeb9e3714cf844e856b264ed291d'],0,0,0,5559972,1,,,,4350
b95732b80c998996adb8d7956ab8b71e4ca41540,0,Impala Public Jenkins,2017-10-18 20:26:41+00:00,['0d5fcc8662e42c2e418f90e04f7b33517b55568e'],12,19,31,5560003,2,0,1,1,4350
8e6dd8a8059a678eaa6000a1f7e8afd43892fad3,0,Impala Public Jenkins,2017-10-18 21:09:16+00:00,['b95732b80c998996adb8d7956ab8b71e4ca41540'],1,1,2,5560005,1,,,,4350
048ce2af9c5c2a8431f4518fa34e11c0db8e0d8b,1,Impala Public Jenkins,2017-10-18 23:30:04+00:00,['8e6dd8a8059a678eaa6000a1f7e8afd43892fad3'],0,93,93,5560098,6,0.941176471,0.529411765,0.980392157,4350
e06268e829350d4bc390a54b7685457bba6706ba,0,Impala Public Jenkins,2017-10-19 01:23:32+00:00,['048ce2af9c5c2a8431f4518fa34e11c0db8e0d8b'],28,59,87,5560185,10,0.444444444,0.777777778,0.666666667,4350
57bde365a31805440103b207e443991b127ce873,1,Impala Public Jenkins,2017-10-20 03:01:07+00:00,['e06268e829350d4bc390a54b7685457bba6706ba'],64,79,143,5560328,1,0.555555556,1,1,4350
359b409b9636e20414270bc7a642d9116304eac1,1,Impala Public Jenkins,2017-10-20 03:59:49+00:00,['57bde365a31805440103b207e443991b127ce873'],197,200,397,5560725,22,0.655737705,1,0.983606557,4351
0bccb3ea02817b7cc67d57458dc9fb341f96d119,0,Impala Public Jenkins,2017-10-20 07:55:18+00:00,['359b409b9636e20414270bc7a642d9116304eac1'],5,55,60,5560785,4,0,0.975,1,4351
0e0f295e4653eb77fc30fd904d8ee54a69d3399f,0,Zach Amsden,2017-10-20 20:45:22+00:00,['0bccb3ea02817b7cc67d57458dc9fb341f96d119'],7,28,35,5560820,1,0,1,1,4351
78776e9b5f03d122dbc6ddda81aec6e292f75ab4,1,Impala Public Jenkins,2017-10-20 22:38:54+00:00,['0e0f295e4653eb77fc30fd904d8ee54a69d3399f'],37,45,82,5560902,5,1,1,0,4351
3b5a36337f190481cef7ebef398324805d7e4485,0,Impala Public Jenkins,2017-10-21 00:06:38+00:00,['78776e9b5f03d122dbc6ddda81aec6e292f75ab4'],0,17,17,5560919,5,,,,4351
41f0c6a5a6be887fbe42ae338274096c27090af6,0,Impala Public Jenkins,2017-10-21 03:13:14+00:00,['3b5a36337f190481cef7ebef398324805d7e4485'],10,146,156,5561075,8,0.230769231,0.538461538,1,4351
b4c24ad2ad66cdb9ecffb754b8d133e476c99b3e,0,Impala Public Jenkins,2017-10-21 10:24:51+00:00,['41f0c6a5a6be887fbe42ae338274096c27090af6'],53,66,119,5561194,4,1,1,0,4351
f05bd241ea7e5ac65d57384f65264e212fa09ff5,1,Impala Public Jenkins,2017-10-23 19:32:10+00:00,['b4c24ad2ad66cdb9ecffb754b8d133e476c99b3e'],2403,7779,10182,5571376,62,1,1,1,4400
6ae08ef98b3de3261940c737fda816cae100117a,1,Impala Public Jenkins,2017-10-23 23:22:16+00:00,['f05bd241ea7e5ac65d57384f65264e212fa09ff5'],4,10,14,5571390,1,,,,4400
308bd5d58812470c6b760f889547ed90832eacb3,1,Impala Public Jenkins,2017-10-24 07:40:16+00:00,['6ae08ef98b3de3261940c737fda816cae100117a'],48,45,93,5571483,4,1,0,0,4400
31c440bf341c18a838e15360bb4b2e8c90f86c75,0,Impala Public Jenkins,2017-10-24 21:22:58+00:00,['308bd5d58812470c6b760f889547ed90832eacb3'],18,30,48,5571531,4,0,0.916666667,0,4400
1640aa9796879405c7112de3065c7fbe88064e8a,1,Impala Public Jenkins,2017-10-24 21:29:49+00:00,['31c440bf341c18a838e15360bb4b2e8c90f86c75'],67,59,126,5571657,11,1,1,1,4400
c87ad3631a4f3f1854759937ae0f8de63cb6e5dc,0,Impala Public Jenkins,2017-10-24 22:11:39+00:00,['1640aa9796879405c7112de3065c7fbe88064e8a'],0,7,7,5571664,1,0,0,0,4400
2bd010781c07fee9dc09924856ac7ced11e6be3e,0,Impala Public Jenkins,2017-10-24 22:19:22+00:00,['c87ad3631a4f3f1854759937ae0f8de63cb6e5dc'],6,4,10,5571674,3,1,1,0,4400
77e010ae4ee07c02a7a945fcb5898db50166c767,0,Impala Public Jenkins,2017-10-24 23:54:15+00:00,['2bd010781c07fee9dc09924856ac7ced11e6be3e'],29,58,87,5571761,2,0.692307692,0.692307692,0.230769231,4400
e020c37106383be5416f882cbe11fc25efad8968,1,Impala Public Jenkins,2017-10-25 00:00:25+00:00,['77e010ae4ee07c02a7a945fcb5898db50166c767'],5,44,49,5571810,3,,,,4400
5ebea0ec4db9a0b954988975b4b7c02971a780a0,1,Impala Public Jenkins,2017-10-25 00:44:34+00:00,['e020c37106383be5416f882cbe11fc25efad8968'],565,682,1247,5573057,3,0,0,1,4400
98f8b19c3bd0debfe25055aaecaf86e38b23c748,0,Impala Public Jenkins,2017-10-25 00:48:44+00:00,['5ebea0ec4db9a0b954988975b4b7c02971a780a0'],1,2,3,5573060,1,0,0,1,4400
ca55b5926ecfaf764f3f46add4391588e18b90f0,1,Impala Public Jenkins,2017-10-25 01:17:28+00:00,['98f8b19c3bd0debfe25055aaecaf86e38b23c748'],62,131,193,5573253,8,0.681818182,1,1,4401
e4f585240ac8f478e25402806f4ea38531b4bf84,0,Impala Public Jenkins,2017-10-25 03:43:26+00:00,['ca55b5926ecfaf764f3f46add4391588e18b90f0'],152,160,312,5573565,5,0.1,0.1,0.1,4401
e7b1c321033c1201ee88c9695c44535bd02a2f4e,1,Impala Public Jenkins,2017-10-25 18:56:00+00:00,['e4f585240ac8f478e25402806f4ea38531b4bf84'],24,28,52,5573617,2,1,1,1,4401
c36c34c95723702bbd6844308ac3a0569366ec42,0,Impala Public Jenkins,2017-10-25 19:19:22+00:00,['e7b1c321033c1201ee88c9695c44535bd02a2f4e'],1,1,2,5573619,1,,,,4401
1a74b24bd64d67a420021e1503331581f89cdfff,0,Impala Public Jenkins,2017-10-25 22:32:10+00:00,['c36c34c95723702bbd6844308ac3a0569366ec42'],0,9,9,5573628,1,,,,4401
839c45777b32b50b6d44e60593a39266338754d3,0,Impala Public Jenkins,2017-10-26 00:35:39+00:00,['1a74b24bd64d67a420021e1503331581f89cdfff'],1,5,6,5573634,1,,,,4401
e301ca6418be6645872ff738054d3ceed1fea548,1,Impala Public Jenkins,2017-10-26 02:07:50+00:00,['839c45777b32b50b6d44e60593a39266338754d3'],44,5,49,5573683,3,,,,4401
00fd8388c37e1b3207dddf564463b7eeafe3f887,1,Alex Behm,2017-10-26 17:06:32+00:00,['e301ca6418be6645872ff738054d3ceed1fea548'],108,775,883,5574566,12,0.307692308,1,1,4402
bb73a2964bf35b3349267c0a79a89563ed232ef1,0,Impala Public Jenkins,2017-10-26 21:32:34+00:00,['00fd8388c37e1b3207dddf564463b7eeafe3f887'],9,57,66,5574632,6,0,0.2,0.2,4403
f2cd5bd516adb4bcb41d28ebed3894edd15fcef6,1,Impala Public Jenkins,2017-10-26 21:56:25+00:00,['bb73a2964bf35b3349267c0a79a89563ed232ef1'],236,456,692,5575324,9,0.37037037,0.503703704,0.866666667,4403
4592ed445e5cd946efbec8e40c73ed3e8162f3b2,1,Impala Public Jenkins,2017-10-27 00:19:44+00:00,['f2cd5bd516adb4bcb41d28ebed3894edd15fcef6'],21,234,255,5575579,10,0.553571429,1,0.75,4404
30629fdea555e1a243106380df22dce2ef1ce942,0,Impala Public Jenkins,2017-10-27 22:15:47+00:00,['4592ed445e5cd946efbec8e40c73ed3e8162f3b2'],99,63,162,5575741,5,0,0,1,4404
5810c759ca03d3e3b59776f3fe3abe11234cefd2,1,Impala Public Jenkins,2017-10-28 01:55:44+00:00,['30629fdea555e1a243106380df22dce2ef1ce942'],6,18,24,5575765,1,0,0,1,4404
9174af38c85c080c776ecc5b1aff0aee9aef2f57,1,Impala Public Jenkins,2017-10-28 02:45:35+00:00,['5810c759ca03d3e3b59776f3fe3abe11234cefd2'],89,140,229,5575994,10,1,1,1,4404
43ef80e4f1c93ea69883a4670c79ba10b0ed0432,1,Impala Public Jenkins,2017-10-28 02:51:38+00:00,['9174af38c85c080c776ecc5b1aff0aee9aef2f57'],104,162,266,5576260,3,0.11627907,0,0.11627907,4404
f11181cbe5a7eaa3ae16bfb6a60ab9e200e37d39,0,Impala Public Jenkins,2017-10-28 06:29:38+00:00,['43ef80e4f1c93ea69883a4670c79ba10b0ed0432'],1,3,4,5576264,1,,,,4404
471285bee3b8d4e18f97153fa0bd95641bba0d78,0,Impala Public Jenkins,2017-10-31 04:00:37+00:00,['f11181cbe5a7eaa3ae16bfb6a60ab9e200e37d39'],9,6,15,5576279,2,1,1,0.333333333,4404
d1594298eac2f3b5b4e9a1ce72de499df2b3ecc1,1,Impala Public Jenkins,2017-10-31 05:23:28+00:00,['471285bee3b8d4e18f97153fa0bd95641bba0d78'],6,6,12,5576291,1,,,,4404
1b0852c9d65c62b21df7bf7a9b1398052d5a1396,1,Impala Public Jenkins,2017-10-31 21:14:57+00:00,['d1594298eac2f3b5b4e9a1ce72de499df2b3ecc1'],3,19,22,5576313,2,1,1,1,4404
fba3fc21fb8046ee885be20ab9a3b4612ebb7b53,0,Impala Public Jenkins,2017-10-31 21:17:33+00:00,['1b0852c9d65c62b21df7bf7a9b1398052d5a1396'],0,21,21,5576334,1,,,,4404
efe95bd3e43050f7a65f1747614193e8038c482d,1,Impala Public Jenkins,2017-10-31 22:02:21+00:00,['fba3fc21fb8046ee885be20ab9a3b4612ebb7b53'],1,1,2,5576336,1,,,,4404
10385c11a19218e711b074e49e7c2d394db4f354,1,Impala Public Jenkins,2017-11-01 04:26:44+00:00,['efe95bd3e43050f7a65f1747614193e8038c482d'],114,401,515,5576851,22,0.370629371,0.664335664,0.167832168,4405
76111ce168c25a7882a13705963dc3c7118121a3,1,Impala Public Jenkins,2017-11-02 00:40:19+00:00,['10385c11a19218e711b074e49e7c2d394db4f354'],6,59,65,5576916,4,,,,4405
98490925cb0dc05e46c437ea3b88fbd1f02b8f52,0,Impala Public Jenkins,2017-11-02 00:45:11+00:00,['76111ce168c25a7882a13705963dc3c7118121a3'],3,12,15,5576931,2,0,0.111111111,0.111111111,4405
eeb32426a3724dc127695368ef3c49ca76e437cf,0,Impala Public Jenkins,2017-11-02 22:53:31+00:00,['98490925cb0dc05e46c437ea3b88fbd1f02b8f52'],0,6,6,5576937,1,1,1,1,4405
0a0affb692fa4dfe27bdcc233312c8665f51b55b,1,Impala Public Jenkins,2017-11-03 00:11:31+00:00,['eeb32426a3724dc127695368ef3c49ca76e437cf'],48,161,209,5577146,8,0.431818182,1,0,4408
5edbb15335034900847c5d329da10260cf961126,1,Impala Public Jenkins,2017-11-03 02:12:00+00:00,['0a0affb692fa4dfe27bdcc233312c8665f51b55b'],3,8,11,5577157,1,,,,4408
3cea0e9dbbf842b8eb3a377f881c9a116b97eed5,0,Impala Public Jenkins,2017-11-03 02:22:21+00:00,['5edbb15335034900847c5d329da10260cf961126'],2,13,15,5577172,4,0,0.5,0,4408
1803b403e38b3f952afc4ff3fd3e5f4d14c088f8,0,Impala Public Jenkins,2017-11-03 06:41:04+00:00,['3cea0e9dbbf842b8eb3a377f881c9a116b97eed5'],1,2,3,5577175,1,,,,4408
6b37a793a0af74ba01c67bb5ac7285af7c5c4d52,0,Impala Public Jenkins,2017-11-03 21:38:20+00:00,['1803b403e38b3f952afc4ff3fd3e5f4d14c088f8'],7,43,50,5577225,2,0.833333333,0.916666667,0.25,4408
ca680b61e1e8bbb36e6a1dfa9617d796c7e9702d,0,Impala Public Jenkins,2017-11-04 01:42:27+00:00,['6b37a793a0af74ba01c67bb5ac7285af7c5c4d52'],1,1,2,5577227,1,,,,4408
e6c3a01b948777affaee3dd004a526f5e4dcd5a0,1,Impala Public Jenkins,2017-11-04 02:08:57+00:00,['ca680b61e1e8bbb36e6a1dfa9617d796c7e9702d'],0,9,9,5577236,2,0,1,1,4408
94236ff2ff6e3d6d25a80150c98d4275914dc8c2,1,Impala Public Jenkins,2017-11-07 04:34:26+00:00,['e6c3a01b948777affaee3dd004a526f5e4dcd5a0'],286,637,923,5578159,19,0.349557522,0.685840708,0.212389381,4411
fe90867d890c71bfdcf8ff941f8ec51e36083f25,1,Impala Public Jenkins,2017-11-07 05:16:11+00:00,['94236ff2ff6e3d6d25a80150c98d4275914dc8c2'],91,189,280,5578439,9,0.6,1,0.485714286,4411
216642e28d2454f7078c2e19f84e91e63221ea3c,0,Jim Apple,2017-11-07 16:16:09+00:00,['fe90867d890c71bfdcf8ff941f8ec51e36083f25'],2,22,24,5578463,1,0,1,1,4411
bf9c2f521fc920ac78ba88a186f100de354c60e1,0,Impala Public Jenkins,2017-11-07 21:44:34+00:00,['216642e28d2454f7078c2e19f84e91e63221ea3c'],5,37,42,5578505,6,0,0.928571429,0.928571429,4411
40ec6d0080638efaf3260672ab54ea4674896c5e,0,Impala Public Jenkins,2017-11-07 22:29:30+00:00,['bf9c2f521fc920ac78ba88a186f100de354c60e1'],0,71,71,5578576,1,,,,4411
9923b8297a329aa245866e9ed4611ad502b807b7,0,Impala Public Jenkins,2017-11-08 00:13:56+00:00,['40ec6d0080638efaf3260672ab54ea4674896c5e'],1,1,2,5578578,1,,,,4411
1673e726bb5dc64d316d699f2f63fa00ac321819,1,Impala Public Jenkins,2017-11-08 02:16:26+00:00,['9923b8297a329aa245866e9ed4611ad502b807b7'],122,137,259,5578837,31,1,1,1,4411
1ca3adf46c5ef5055c13fd3ce57e7c53218c219c,1,Impala Public Jenkins,2017-11-08 02:37:00+00:00,['1673e726bb5dc64d316d699f2f63fa00ac321819'],35,39,74,5578911,5,1,1,1,4411
73d1bc3ad448181626c559c36f9d86b23e036fef,0,Impala Public Jenkins,2017-11-08 07:39:02+00:00,['1ca3adf46c5ef5055c13fd3ce57e7c53218c219c'],101,207,308,5579219,13,0,0.611940299,0.656716418,4411
19c17e64b54fcc0a599eadaa14d35943ee703ed4,1,Impala Public Jenkins,2017-11-08 10:09:25+00:00,['73d1bc3ad448181626c559c36f9d86b23e036fef'],212,144,356,5579575,23,1,0.75,0,4411
a772f845628f19b816935cd4770714c980c553a6,1,Impala Public Jenkins,2017-11-08 22:03:59+00:00,['19c17e64b54fcc0a599eadaa14d35943ee703ed4'],192,94,286,5579861,9,0.4,0,0.514285714,4411
b4ea57a7e369c8c0532239db5bb95a701683a150,1,Impala Public Jenkins,2017-11-09 20:05:08+00:00,['a772f845628f19b816935cd4770714c980c553a6'],176,3147,3323,5583184,33,0.385388128,0.825570776,0.620091324,4418
3a1073c87c6ea08d9e8e2367851775748495300f,0,Impala Public Jenkins,2017-11-09 23:59:13+00:00,['b4ea57a7e369c8c0532239db5bb95a701683a150'],1,13,14,5583198,2,0,1,1,4418
5ab07f032941537755a3d8bc8e58caa6c8ac8233,0,Impala Public Jenkins,2017-11-10 01:21:45+00:00,['3a1073c87c6ea08d9e8e2367851775748495300f'],11,0,11,5583209,1,0,0,0,4418
2212a8897e66e1a5c548132d09a8e33e275a0e3b,1,Impala Public Jenkins,2017-11-10 02:42:16+00:00,['5ab07f032941537755a3d8bc8e58caa6c8ac8233'],57,138,195,5583404,2,0.833333333,1,0,4418
fdf94a400341c175943272d823b73d4b23f3919d,0,Impala Public Jenkins,2017-11-10 04:27:59+00:00,['2212a8897e66e1a5c548132d09a8e33e275a0e3b'],2,7,9,5583413,2,0.5,1,0.5,4418
11bbc26d09d0fddb2f680a1ef279f528f82912a5,0,Impala Public Jenkins,2017-11-13 18:59:48+00:00,['fdf94a400341c175943272d823b73d4b23f3919d'],5,5,10,5583423,2,,,,4418
6a2b7a64fb1fd710fe2e3c2a106a3bf589fefe76,1,Impala Public Jenkins,2017-11-13 21:14:14+00:00,['11bbc26d09d0fddb2f680a1ef279f528f82912a5'],215,347,562,5583985,20,0.230769231,0,0.038461538,4419
a0be00ad6dab69bfd843aa89766b861932c5a0d7,1,Impala Public Jenkins,2017-11-14 01:29:56+00:00,['6a2b7a64fb1fd710fe2e3c2a106a3bf589fefe76'],8,14,22,5584007,5,,,,4419
d1b92c8b525e73fd9dbc91d5e0a1d73a5d402b82,0,Impala Public Jenkins,2017-11-15 02:54:53+00:00,['a0be00ad6dab69bfd843aa89766b861932c5a0d7'],1,27,28,5584035,2,,,,4419
a8c123b55a78d39dd2e465e7641d4706b3aaaf4e,0,Jim Apple,2017-11-15 19:38:30+00:00,['d1b92c8b525e73fd9dbc91d5e0a1d73a5d402b82'],25,60,85,5584120,2,0,0,1,4419
e98d2f1c0af270930cd8a50d31b8924ad263937d,1,Impala Public Jenkins,2017-11-15 21:50:50+00:00,['a8c123b55a78d39dd2e465e7641d4706b3aaaf4e'],1387,1420,2807,5586927,42,0,0.472727273,0.545454545,4419
87fc463e0a98ce7402f89817ed847e77005b0ddb,1,Impala Public Jenkins,2017-11-15 22:05:10+00:00,['e98d2f1c0af270930cd8a50d31b8924ad263937d'],812,653,1465,5588392,16,0.338582677,0.086614173,0,4420
6539e89c81b070f2587d00334c71312e0cd87706,1,Impala Public Jenkins,2017-11-15 22:42:22+00:00,['87fc463e0a98ce7402f89817ed847e77005b0ddb'],7,106,113,5588505,4,1,1,1,4421
46d1be4c3cfedfde79d7b1c177e0c52d54c98801,1,Impala Public Jenkins,2017-11-15 23:53:36+00:00,['6539e89c81b070f2587d00334c71312e0cd87706'],45,86,131,5588636,4,0.736842105,0.842105263,0.105263158,4421
9502e21d0315b60ba2c7dd55c5a3af76bfefd2ea,0,Impala Public Jenkins,2017-11-16 04:57:39+00:00,['46d1be4c3cfedfde79d7b1c177e0c52d54c98801'],1,2,3,5588639,1,1,1,1,4421
f9155f0d8185b3344fe16368806b463fe27bc5c7,0,Impala Public Jenkins,2017-11-16 09:01:37+00:00,['9502e21d0315b60ba2c7dd55c5a3af76bfefd2ea'],2,2,4,5588643,2,,,,4421
6769220e28e5b6b229f4b48b76f57d34d47ad252,0,Impala Public Jenkins,2017-11-16 12:04:17+00:00,['f9155f0d8185b3344fe16368806b463fe27bc5c7'],0,2,2,5588645,1,,,,4421
155bb7764989c45f8274aac3196852a830402375,0,Alex Behm,2017-11-16 15:51:48+00:00,['6769220e28e5b6b229f4b48b76f57d34d47ad252'],24,0,24,5588669,3,,,,4421
ae116b5bf7b8b2514d7a8655d9a6666ad3fd36dd,1,Impala Public Jenkins,2017-11-16 21:23:09+00:00,['155bb7764989c45f8274aac3196852a830402375'],968,1253,2221,5590890,20,0,0.708661417,0,4423
70919187c64cced4f805cc995a3bcf5e1fc9f02f,1,Impala Public Jenkins,2017-11-16 21:43:27+00:00,['ae116b5bf7b8b2514d7a8655d9a6666ad3fd36dd'],110,116,226,5591116,6,0.333333333,1,0,4423
edc70c166166dbf88fa27c1e15da8a315aed4db9,0,Impala Public Jenkins,2017-11-16 22:31:38+00:00,['70919187c64cced4f805cc995a3bcf5e1fc9f02f'],28,19,47,5591163,19,,,,4423
c886f21da4f6b43fdd79a21c56376d879f534505,0,Impala Public Jenkins,2017-11-16 23:10:10+00:00,['edc70c166166dbf88fa27c1e15da8a315aed4db9'],2,2,4,5591167,1,,,,4423
3ddafcd29505614a01c8f4362396635c84ab4052,0,Impala Public Jenkins,2017-11-17 02:24:48+00:00,['c886f21da4f6b43fdd79a21c56376d879f534505'],2,89,91,5591258,3,1,1,0.974358974,4423
2510fe0aa0c86f460af9040eb413aad76c13cc84,1,Impala Public Jenkins,2017-11-17 21:33:51+00:00,['3ddafcd29505614a01c8f4362396635c84ab4052'],1649,3855,5504,5596762,87,0.263944223,0.587649402,0.755976096,4432
b840137c940d71af5cec2daf482b523a38b6a9f1,1,Impala Public Jenkins,2017-11-17 22:47:34+00:00,['2510fe0aa0c86f460af9040eb413aad76c13cc84'],809,916,1725,5598487,37,,0,1,4434
1128e1a44f80956e20b4fec0ba6a6d4e25009604,0,Impala Public Jenkins,2017-11-18 01:21:00+00:00,['b840137c940d71af5cec2daf482b523a38b6a9f1'],6,5,11,5598498,1,,,,4434
10334260d893c8bca03349f23e34ad8832aa1d51,0,Impala Public Jenkins,2017-11-18 03:22:27+00:00,['1128e1a44f80956e20b4fec0ba6a6d4e25009604'],0,1,1,5598499,1,0,1,1,4434
5e9b4e2fd2a459a3b61e8939e3085ad8e1a5795e,1,Impala Public Jenkins,2017-11-18 09:07:06+00:00,['10334260d893c8bca03349f23e34ad8832aa1d51'],777,1168,1945,5600444,33,0.652777778,1,0.847222222,4438
fb4c3b01240d8f65fc2c45bf27b668ae9b1fa5d2,1,Impala Public Jenkins,2017-11-19 22:21:03+00:00,['5e9b4e2fd2a459a3b61e8939e3085ad8e1a5795e'],11,22,33,5600477,3,1,1,1,4438
7487c5de04c2c5d97b8a8d5c935d10568f1ed686,1,Impala Public Jenkins,2017-11-20 04:34:47+00:00,['fb4c3b01240d8f65fc2c45bf27b668ae9b1fa5d2'],95,194,289,5600766,9,0.6,1,0.485714286,4438
690e302a62fac18a2e157f53c9b11280d2fe590e,0,Impala Public Jenkins,2017-11-20 20:37:56+00:00,['7487c5de04c2c5d97b8a8d5c935d10568f1ed686'],0,1,1,5600767,1,0,0,0,4438
3632ed4b9e90d7a7a10300fed4d5710ae72c6ebf,0,Michael Ho,2017-11-20 21:50:49+00:00,['690e302a62fac18a2e157f53c9b11280d2fe590e'],22,11,33,5600800,3,0,0,0,4438
27c43fed0ec05cbcddd9225fd4a194b1cfd0704b,0,Impala Public Jenkins,2017-11-21 04:40:05+00:00,['3632ed4b9e90d7a7a10300fed4d5710ae72c6ebf'],18,33,51,5600851,1,0,0,1,4438
baa537f8e1e2e284ef9c139a283b86a873e01ee7,1,Impala Public Jenkins,2017-11-21 05:28:47+00:00,['27c43fed0ec05cbcddd9225fd4a194b1cfd0704b'],44,35,79,5600930,3,1,0,0,4438
bc12a9eb35ff60d7a7e0f6732e9ab6a1d4538f2a,1,Impala Public Jenkins,2017-11-21 22:08:20+00:00,['baa537f8e1e2e284ef9c139a283b86a873e01ee7'],76,386,462,5601392,5,0.179245283,0,0.08490566,4438
32baa695f499a936b72c5a51ae3649c408aa5a85,0,Impala Public Jenkins,2017-11-22 00:34:56+00:00,['bc12a9eb35ff60d7a7e0f6732e9ab6a1d4538f2a'],22,65,87,5601479,7,0,1,0,4438
223707d7c99d0d81a5555dbba55e95654686286c,0,Zach Amsden,2017-11-22 18:49:28+00:00,['32baa695f499a936b72c5a51ae3649c408aa5a85'],2,2,4,5601483,1,,,,4438
21a96ed2e39537db39cda14ebdacc83a8c4c89f3,1,Impala Public Jenkins,2017-11-22 22:00:16+00:00,['223707d7c99d0d81a5555dbba55e95654686286c'],38,649,687,5602170,10,0.966666667,0.966666667,1,4438
3845c0f157e2ab2022dcf610a69c85abee9028ea,0,Impala Public Jenkins,2017-11-23 00:21:30+00:00,['21a96ed2e39537db39cda14ebdacc83a8c4c89f3'],1,4,5,5602175,1,0,0,0,4438
70f1c023aada346343eba548cc9cc5129de2410f,1,Impala Public Jenkins,2017-11-23 00:55:35+00:00,['3845c0f157e2ab2022dcf610a69c85abee9028ea'],29,129,158,5602333,3,0,0,0.045454545,4438
c656181826848d71c6d53c51321769968660ddf7,1,Impala Public Jenkins,2017-11-23 03:25:58+00:00,['70f1c023aada346343eba548cc9cc5129de2410f'],3,10,13,5602346,1,0,0,1,4438
1a7b0d0bdcbdab1778f7be89cd67893c86a1e330,1,Impala Public Jenkins,2017-11-23 07:48:18+00:00,['c656181826848d71c6d53c51321769968660ddf7'],50,117,167,5602513,3,0,0.333333333,0.2,4438
79a5de1028b1c9523d3a2525d2a189288ca55357,0,Impala Public Jenkins,2017-11-26 22:53:21+00:00,['1a7b0d0bdcbdab1778f7be89cd67893c86a1e330'],2,2,4,5602517,1,,,,4438
71fdbb926f2bd4b0cca072a8a9d178790a3cbce3,0,Impala Public Jenkins,2017-11-27 18:19:26+00:00,['79a5de1028b1c9523d3a2525d2a189288ca55357'],1,1,2,5602519,1,,,,4438
017338f8577117d7f4bebc0c4dec541cf58424b8,0,Impala Public Jenkins,2017-11-27 19:20:43+00:00,['71fdbb926f2bd4b0cca072a8a9d178790a3cbce3'],3,3,6,5602525,1,,,,4438
a86cc7a3ded43063fddffc161aea447f404f2d46,0,Impala Public Jenkins,2017-11-27 19:21:12+00:00,['017338f8577117d7f4bebc0c4dec541cf58424b8'],2,2,4,5602529,1,,,,4438
628f19ed0b951ba559da0c6b00bfa6d472269180,0,Impala Public Jenkins,2017-11-27 21:20:20+00:00,['a86cc7a3ded43063fddffc161aea447f404f2d46'],9,16,25,5602554,3,0,1,0,4438
abd9b0e70a3793405af8ad72259e4c7196804a47,0,Impala Public Jenkins,2017-11-27 22:28:37+00:00,['628f19ed0b951ba559da0c6b00bfa6d472269180'],26,45,71,5602625,3,1,1,0,4438
16d8dd580bf7175df3243d226d788ab0f7a25473,1,Impala Public Jenkins,2017-11-27 23:43:25+00:00,['abd9b0e70a3793405af8ad72259e4c7196804a47'],8,14,22,5602647,3,0,1,0.5,4438
88cb68cfbeb399ee3bb561caa329ccf40ad836c0,1,Impala Public Jenkins,2017-11-28 00:31:15+00:00,['16d8dd580bf7175df3243d226d788ab0f7a25473'],226,486,712,5603359,18,0.507692308,0.969230769,0.9,4438
d1c9510001c621e9fd8920cd9febf5774b3620e4,1,Impala Public Jenkins,2017-11-28 02:57:04+00:00,['88cb68cfbeb399ee3bb561caa329ccf40ad836c0'],160,152,312,5603671,5,0.9,0.9,0.9,4438
7dd28ff4316dd3191c955ef48dfc53493ff5c0af,0,Impala Public Jenkins,2017-11-28 03:01:39+00:00,['d1c9510001c621e9fd8920cd9febf5774b3620e4'],20,21,41,5603712,2,1,1,1,4438
45ccf4ae3b21a394b8b299931c1becdf239607e3,0,Impala Public Jenkins,2017-11-28 03:02:53+00:00,['7dd28ff4316dd3191c955ef48dfc53493ff5c0af'],40,0,40,5603752,1,,,,4438
d3afe30752d5d75281d8869ff46bc8202ea92a9b,0,Impala Public Jenkins,2017-11-28 04:01:27+00:00,['45ccf4ae3b21a394b8b299931c1becdf239607e3'],1,1,2,5603754,1,,,,4438
4f11bed407e305a88ccb1b94d9fc2ce356830154,0,Impala Public Jenkins,2017-11-28 21:11:45+00:00,['d3afe30752d5d75281d8869ff46bc8202ea92a9b'],1,24,25,5603779,2,,,,4438
0588309ed6938fd7c280a241be01d0b69b6357d9,0,Impala Public Jenkins,2017-11-28 23:40:38+00:00,['4f11bed407e305a88ccb1b94d9fc2ce356830154'],16,11,27,5603806,1,1,0,0,4438
a88c3b9c529b2215b232455598f8f8332c27f996,0,Impala Public Jenkins,2017-11-29 02:19:50+00:00,['0588309ed6938fd7c280a241be01d0b69b6357d9'],477,438,915,5604721,21,1,1,1,4438
dc1282fbc927a0e6fd93eba04bca9eaa568b2f3e,1,Impala Public Jenkins,2017-11-29 03:28:22+00:00,['a88c3b9c529b2215b232455598f8f8332c27f996'],135,64,199,5604920,6,1,0.864864865,0.864864865,4438
6d9da172889cde75e041caf4fa024f4d9f223db5,1,Impala Public Jenkins,2017-11-29 03:44:51+00:00,['dc1282fbc927a0e6fd93eba04bca9eaa568b2f3e'],6,56,62,5604982,3,0.666666667,0.703703704,0,4438
2fba80ee5ecf14117d7a9bfbbb0f27c45044f412,0,Impala Public Jenkins,2017-11-29 05:22:32+00:00,['6d9da172889cde75e041caf4fa024f4d9f223db5'],3,6,9,5604991,3,0.333333333,1,1,4438
63f17e9ceaed92a28ea12567a36b746e54fffdb3,1,Impala Public Jenkins,2017-11-29 05:53:15+00:00,['2fba80ee5ecf14117d7a9bfbbb0f27c45044f412'],11,74,85,5605076,8,0,0.083333333,1,4438
72ed4fc88791257422278b741d7565c6a205eb64,0,Impala Public Jenkins,2017-11-29 20:58:50+00:00,['63f17e9ceaed92a28ea12567a36b746e54fffdb3'],11,11,22,5605098,7,,,,4438
b3d8a507cb4e5e7887ed55782f5de1d6cdfcd276,1,Impala Public Jenkins,2017-11-29 22:37:01+00:00,['72ed4fc88791257422278b741d7565c6a205eb64'],1252,1952,3204,5608302,42,0.322834646,0.62992126,0.74015748,4439
af8b58a785c5b270e6a342504f309ba4c0394fb3,0,Impala Public Jenkins,2017-11-30 02:15:47+00:00,['b3d8a507cb4e5e7887ed55782f5de1d6cdfcd276'],0,45,45,5608347,1,,,,4439
3ed122185f3e5f0fce661faef7bc33e3ba5f90f9,0,Impala Public Jenkins,2017-11-30 07:22:53+00:00,['af8b58a785c5b270e6a342504f309ba4c0394fb3'],0,6,6,5608353,2,,,,4439
24c2ba0cc5560fb54c1695e7c14e1a62c55654b5,0,Impala Public Jenkins,2017-11-30 07:33:16+00:00,['3ed122185f3e5f0fce661faef7bc33e3ba5f90f9'],5,5,10,5608363,1,,,,4439
9560d883e2e8584353242146c85cf17fc5bb55b9,0,Impala Public Jenkins,2017-11-30 18:30:47+00:00,['24c2ba0cc5560fb54c1695e7c14e1a62c55654b5'],14,28,42,5608405,1,1,0,1,4439
0a0be17102981e7874c6396c42f56e0be8286069,0,Impala Public Jenkins,2017-11-30 23:34:35+00:00,['9560d883e2e8584353242146c85cf17fc5bb55b9'],11,19,30,5608435,2,0.125,0.375,0.125,4439
ea8d2ba7f6b54c45f06d5effa6bc7238c50452a9,0,Impala Public Jenkins,2017-12-01 05:51:59+00:00,['0a0be17102981e7874c6396c42f56e0be8286069'],1,25,26,5608461,2,0.6,0.6,1,4439
575b5a20e6ddc72b7cefcdd27ae722a8ad0530ee,1,Impala Public Jenkins,2017-12-01 23:23:01+00:00,['ea8d2ba7f6b54c45f06d5effa6bc7238c50452a9'],78,231,309,5608770,7,0,0.333333333,0.102564103,4439
633dbff71dd005858ba4cf6907376d944235d404,1,Impala Public Jenkins,2017-12-02 04:09:05+00:00,['575b5a20e6ddc72b7cefcdd27ae722a8ad0530ee'],206,935,1141,5609911,7,0.063636364,1,0.990909091,4440
d428c16f1e9560af88b326ca19eafecfef2851c2,1,Impala Public Jenkins,2017-12-02 04:55:10+00:00,['633dbff71dd005858ba4cf6907376d944235d404'],182,468,650,5610561,14,0.852941176,1,0.931372549,4442
7e368b8f0f6255d338beb127ff6a3c4e11a28c9e,0,Impala Public Jenkins,2017-12-04 21:43:00+00:00,['d428c16f1e9560af88b326ca19eafecfef2851c2'],1,39,40,5610601,8,0.086956522,1,0.782608696,4442
66704f915e6145b003fa9d1dffddb31d9699ffbd,1,Zach Amsden,2017-12-04 23:46:44+00:00,['7e368b8f0f6255d338beb127ff6a3c4e11a28c9e'],38,61,99,5610700,3,0.1,0.1,0.1,4442
e4a2f5d2123508dbd9281980a395d4f9e1851dd7,0,Impala Public Jenkins,2017-12-05 02:09:21+00:00,['66704f915e6145b003fa9d1dffddb31d9699ffbd'],8,13,21,5610721,5,0.5,0.833333333,0.666666667,4442
1f1bff8e8d35b66308a1e865cdc8bce41ce89873,1,Impala Public Jenkins,2017-12-05 21:03:00+00:00,['e4a2f5d2123508dbd9281980a395d4f9e1851dd7'],2,8,10,5610731,1,,,,4442
75121819bee10b7f8f0093b694c9fefc63fb9bdf,0,Impala Public Jenkins,2017-12-05 21:40:11+00:00,['1f1bff8e8d35b66308a1e865cdc8bce41ce89873'],9,36,45,5610776,1,0.058823529,1,0,4442
e27b01f4bb73a56261ef075eb29b030b60881d73,0,Impala Public Jenkins,2017-12-05 22:58:23+00:00,['75121819bee10b7f8f0093b694c9fefc63fb9bdf'],3,3,6,5610782,1,,,,4442
e79f6446b1eb9647ecbf61ed6b8fe7e992142de1,0,Impala Public Jenkins,2017-12-05 23:24:08+00:00,['e27b01f4bb73a56261ef075eb29b030b60881d73'],3,9,12,5610794,2,1,1,1,4442
16c5f514e0315dfd63ee88d98d25099547e42cc4,0,Impala Public Jenkins,2017-12-06 00:41:11+00:00,['e79f6446b1eb9647ecbf61ed6b8fe7e992142de1'],8,13,21,5610815,1,,,,4442
c505a8159be73879e0a75d6199f60aa5ca1726fb,1,Impala Public Jenkins,2017-12-06 00:52:19+00:00,['16c5f514e0315dfd63ee88d98d25099547e42cc4'],7,186,193,5611008,7,0.35483871,0.451612903,0.967741935,4444
9303b0aed808c7b323d7ec9a7583a15193dda5df,0,Tim Armstrong,2017-12-06 01:56:29+00:00,['c505a8159be73879e0a75d6199f60aa5ca1726fb'],20,19,39,5611047,3,0,,0,4444
ae6ecf51ecfaa95466de2c75bce869bf8babfc09,0,Impala Public Jenkins,2017-12-06 19:15:59+00:00,['9303b0aed808c7b323d7ec9a7583a15193dda5df'],6,6,12,5611059,1,,,,4444
d52fa75cb9d7c1fae825390a6d4e7b14dd1c61fd,1,Impala Public Jenkins,2017-12-07 07:13:29+00:00,['ae6ecf51ecfaa95466de2c75bce869bf8babfc09'],33,51,84,5611143,6,1,0.666666667,0.222222222,4444
ed72910e96b261ff1d7da06c49aceef508b477f9,1,Impala Public Jenkins,2017-12-07 09:47:09+00:00,['d52fa75cb9d7c1fae825390a6d4e7b14dd1c61fd'],79,87,166,5611309,21,0,0,0,4445
a4916e6d5f5f3542100af791534bfaf9ed544720,0,Impala Public Jenkins,2017-12-07 09:48:50+00:00,['ed72910e96b261ff1d7da06c49aceef508b477f9'],15,31,46,5611355,6,,,,4445
a94d6068c757912eaa741db82331ef72e5696004,1,Sailesh Mukil,2017-12-07 14:49:45+00:00,['a4916e6d5f5f3542100af791534bfaf9ed544720'],0,317,317,5611672,2,0.527559055,0.700787402,0.921259843,4447
82267a2779da2165802195ba202223d2c205b73d,1,Impala Public Jenkins,2017-12-07 18:29:59+00:00,['a94d6068c757912eaa741db82331ef72e5696004'],138,116,254,5611926,6,0,0,0.333333333,4447
f3fa3e017f1341579d008619f57cc5dceb21603d,1,Impala Public Jenkins,2017-12-07 21:07:02+00:00,['82267a2779da2165802195ba202223d2c205b73d'],21,37,58,5611984,3,1,1,1,4447
d60eb192a959afd5e1a7062b360ade2ef8a8f4f4,0,Impala Public Jenkins,2017-12-07 23:58:40+00:00,['f3fa3e017f1341579d008619f57cc5dceb21603d'],16,31,47,5612031,3,0,1,0,4447
542dc227c613e2fbe2b9a4f98817f395b2d1238c,0,Impala Public Jenkins,2017-12-08 05:02:08+00:00,['d60eb192a959afd5e1a7062b360ade2ef8a8f4f4'],10,19,29,5612060,2,,,,4447
e94c60833a36728ae9ecbf22c161c0d7f41a7184,1,Impala Public Jenkins,2017-12-08 22:42:03+00:00,['542dc227c613e2fbe2b9a4f98817f395b2d1238c'],2,36,38,5612098,3,,,,4447
11497c2aa9b49c031a9237e18a142ddbd115188f,0,Impala Public Jenkins,2017-12-08 23:11:36+00:00,['e94c60833a36728ae9ecbf22c161c0d7f41a7184'],43,168,211,5612309,4,1,0.125,1,4447
2e83ba5796d42bf3a568bfae5823896dfa644cc2,1,Impala Public Jenkins,2017-12-08 23:58:18+00:00,['11497c2aa9b49c031a9237e18a142ddbd115188f'],15,60,75,5612384,4,0,1,0.2,4447
e81b7c6b682fa4bf06db0fbd30818fe698890b00,1,Impala Public Jenkins,2017-12-09 01:43:01+00:00,['2e83ba5796d42bf3a568bfae5823896dfa644cc2'],52,176,228,5612612,5,1,0,0,4448
eeb34b657105e87bb7ee82a4724bfc6688d54cce,0,Impala Public Jenkins,2017-12-09 03:45:01+00:00,['e81b7c6b682fa4bf06db0fbd30818fe698890b00'],2,71,73,5612685,3,0.361111111,1,1,4448
12fa20d1aea854031260e15dbf00fc4a7a29bea6,0,Impala Public Jenkins,2017-12-09 03:58:23+00:00,['eeb34b657105e87bb7ee82a4724bfc6688d54cce'],16,16,32,5612717,1,,,,4448
b4cf5f2174b338c097e42d43c32b494a6e0b46c0,0,Impala Public Jenkins,2017-12-11 21:45:43+00:00,['12fa20d1aea854031260e15dbf00fc4a7a29bea6'],0,1,1,5612718,1,,,,4448
245df3c69a932abf4accc57cb359c7bcda6d8aec,0,Impala Public Jenkins,2017-12-12 00:17:56+00:00,['b4cf5f2174b338c097e42d43c32b494a6e0b46c0'],39,42,81,5612799,2,0,1,0,4448
ebc00c75ac040ace797d227fe89c0744be9f57f4,0,Impala Public Jenkins,2017-12-12 04:01:42+00:00,['245df3c69a932abf4accc57cb359c7bcda6d8aec'],1,2,3,5612802,1,,,,4448
d2fe9f437e4f3da1206739ff2458b590bd3b5973,1,Impala Public Jenkins,2017-12-12 04:30:15+00:00,['ebc00c75ac040ace797d227fe89c0744be9f57f4'],336,207,543,5613345,15,,,,4450
e57c77f095cbf1660b02d629f7b0cb6a92491e0e,0,Impala Public Jenkins,2017-12-12 21:05:54+00:00,['d2fe9f437e4f3da1206739ff2458b590bd3b5973'],3,3,6,5613351,1,,,,4450
0936e3296697aa63f07c0919629d0967b88474e6,1,Impala Public Jenkins,2017-12-12 22:20:18+00:00,['e57c77f095cbf1660b02d629f7b0cb6a92491e0e'],12,3976,3988,5617339,19,0.063210227,0.076704545,0.1875,4456
9a6e5fa99650c4d916aa577742a7758af53f14ee,0,Impala Public Jenkins,2017-12-13 02:05:21+00:00,['0936e3296697aa63f07c0919629d0967b88474e6'],0,15,15,5617354,1,0,0,1,4456
4feb4f3a549a79646b52f6aabb75c3f529d5cfe8,1,Impala Public Jenkins,2017-12-13 10:04:40+00:00,['9a6e5fa99650c4d916aa577742a7758af53f14ee'],32,3458,3490,5620844,13,0.591578947,0.716842105,0.806315789,4462
2fcbf36c32b12f8434eac0370b7f214acba7cc4c,0,Impala Public Jenkins,2017-12-13 22:48:10+00:00,['4feb4f3a549a79646b52f6aabb75c3f529d5cfe8'],2,0,2,5620846,1,,,,4462
5c593be59c725f004ead81af94931852410e3a1c,1,Impala Public Jenkins,2017-12-13 23:06:45+00:00,['2fcbf36c32b12f8434eac0370b7f214acba7cc4c'],31,31,62,5620908,4,,,,4462
11dbb3952a1c598f27de281c5020ed2df325d6e8,0,Impala Public Jenkins,2017-12-14 02:28:40+00:00,['5c593be59c725f004ead81af94931852410e3a1c'],3,4,7,5620915,1,,,,4462
3cbbaf3b30dd53fd45d45632ed250f79bdd8b48d,0,Alex Behm,2017-12-14 16:58:53+00:00,['11dbb3952a1c598f27de281c5020ed2df325d6e8'],1,1,2,5620917,1,,,,4462
de29925912703ba73139ca9b34ab0e28712af45e,0,Impala Public Jenkins,2017-12-14 22:34:30+00:00,['3cbbaf3b30dd53fd45d45632ed250f79bdd8b48d'],39,176,215,5621132,7,0.422680412,0.659793814,0.659793814,4462
f4eb00123ff6be770bf0fb75f71b6468cb5e7085,0,Impala Public Jenkins,2017-12-15 01:28:13+00:00,['de29925912703ba73139ca9b34ab0e28712af45e'],1,11,12,5621144,2,0.8,0,1,4462
bfbcd1fe86e4161b9419b3a0c653d0327d3aacdb,1,Impala Public Jenkins,2017-12-15 21:32:20+00:00,['f4eb00123ff6be770bf0fb75f71b6468cb5e7085'],49,118,167,5621311,6,0.051282051,0.41025641,0.974358974,4464
e0c0848f1586687efc973ab79eca4f7a924b26e4,0,Impala Public Jenkins,2017-12-16 02:42:30+00:00,['bfbcd1fe86e4161b9419b3a0c653d0327d3aacdb'],2,2,4,5621315,2,,,,4464
3f1f7063935f8a1217ced0bb15c0f33f7f4931b6,1,Impala Public Jenkins,2017-12-16 03:06:19+00:00,['e0c0848f1586687efc973ab79eca4f7a924b26e4'],22,100,122,5621437,3,0,0,0,4464
7256fcefb4c64d3d61d88091d6447317654bd96e,0,Impala Public Jenkins,2017-12-16 03:26:43+00:00,['3f1f7063935f8a1217ced0bb15c0f33f7f4931b6'],3,7,10,5621447,3,1,1,1,4464
5a7c10ec3d500c1bb582e985cb299e7dbcfe5520,0,Impala Public Jenkins,2017-12-16 04:53:56+00:00,['7256fcefb4c64d3d61d88091d6447317654bd96e'],0,19,19,5621466,1,,,,4464
1f7b3b00e921d68857abb22f48656ee4444c194c,1,Impala Public Jenkins,2017-12-16 04:58:59+00:00,['5a7c10ec3d500c1bb582e985cb299e7dbcfe5520'],259,179,438,5621904,8,0.882352941,1,0.176470588,4464
8047b1dcb421994e67e6db412529159dde2f40b5,0,Impala Public Jenkins,2017-12-18 15:32:59+00:00,['1f7b3b00e921d68857abb22f48656ee4444c194c'],2,241,243,5622147,9,0.662337662,0.896103896,0.974025974,4467
061287d912d260ffe569ed9fce3e9ce12af2ab68,0,Impala Public Jenkins,2017-12-18 18:37:45+00:00,['8047b1dcb421994e67e6db412529159dde2f40b5'],2,13,15,5622162,2,0,0,0,4467
2fb11fb7326b11c9c5c1b1bab811333d91d8640c,0,Impala Public Jenkins,2017-12-19 23:26:29+00:00,['061287d912d260ffe569ed9fce3e9ce12af2ab68'],19,0,19,5622181,1,,,,4467
f755910e9773eabcf6c65caf992ac4153fbdf167,0,Impala Public Jenkins,2017-12-20 22:04:18+00:00,['2fb11fb7326b11c9c5c1b1bab811333d91d8640c'],48,23,71,5622252,5,,,,4467
ac9ca569db3fa2dde5045fa19849d4086db148bf,0,Impala Public Jenkins,2017-12-21 00:13:42+00:00,['f755910e9773eabcf6c65caf992ac4153fbdf167'],11,24,35,5622287,1,0,0,1,4467
b581a9d1ee277674671431dbd6880806d6120567,1,Impala Public Jenkins,2017-12-21 04:26:33+00:00,['ac9ca569db3fa2dde5045fa19849d4086db148bf'],1,78,79,5622366,2,0,1,0.588235294,4467
4ce23f72bae9ca1ccfea5a8b9498aa115c65eecd,0,Impala Public Jenkins,2017-12-22 04:48:53+00:00,['b581a9d1ee277674671431dbd6880806d6120567'],1,8,9,5622375,1,,,,4467
a16fe803caac16d4ba64aeaa4fc750388aeca203,0,Impala Public Jenkins,2017-12-22 11:39:08+00:00,['4ce23f72bae9ca1ccfea5a8b9498aa115c65eecd'],104,245,349,5622724,12,0.198198198,0.900900901,0.576576577,4467
abab176e25790da40f7568043db4e06e320ece67,1,Impala Public Jenkins,2017-12-22 19:53:38+00:00,['a16fe803caac16d4ba64aeaa4fc750388aeca203'],135,128,263,5622987,6,0.857142857,1,0,4467
fac2b2cd9b365b8637806ec9eb64e7f03912c24c,0,Impala Public Jenkins,2017-12-23 01:34:23+00:00,['abab176e25790da40f7568043db4e06e320ece67'],27,73,100,5623087,5,0,0.931034483,0.965517241,4467
4a45c829bd8e5c5bedc434e87bd2a1d19b7d44e6,0,Impala Public Jenkins,2017-12-30 05:31:38+00:00,['fac2b2cd9b365b8637806ec9eb64e7f03912c24c'],35,104,139,5623226,5,0,1,1,4467
a550b5b56063eab6dafc2863c4dccd1455db6606,0,Impala Public Jenkins,2018-01-02 22:25:39+00:00,['4a45c829bd8e5c5bedc434e87bd2a1d19b7d44e6'],0,8,8,5623234,1,0,1,1,4467
f168a7d472d5c49799bc6e05579c96e230427f14,0,Impala Public Jenkins,2018-01-02 23:25:04+00:00,['a550b5b56063eab6dafc2863c4dccd1455db6606'],8,22,30,5623264,2,0,0,1,4467
545163bb0a5c86aa02652d0557871f5b694a6c82,1,Impala Public Jenkins,2018-01-03 01:15:42+00:00,['f168a7d472d5c49799bc6e05579c96e230427f14'],1,196,197,5623461,4,0,0.75,0.990384615,4468
6f2ebadf8d119b1486f54b911ba3c7ecc1921d55,0,Impala Public Jenkins,2018-01-03 11:45:48+00:00,['545163bb0a5c86aa02652d0557871f5b694a6c82'],283,381,664,5624125,24,0.511111111,1,0.488888889,4470
7810d1f9a2c7d59b4b916d4d1793672cd8c33143,1,Impala Public Jenkins,2018-01-03 20:32:24+00:00,['6f2ebadf8d119b1486f54b911ba3c7ecc1921d55'],9,13,22,5624147,2,1,1,1,4470
96b976aff38de29619ca97dabc47566382e90bf8,0,Impala Public Jenkins,2018-01-04 01:23:43+00:00,['7810d1f9a2c7d59b4b916d4d1793672cd8c33143'],35,97,132,5624279,6,1,1,0,4470
4f4912c532532bac6822a91be32d0927d505b861,0,Impala Public Jenkins,2018-01-04 02:30:48+00:00,['96b976aff38de29619ca97dabc47566382e90bf8'],1,1,2,5624281,1,,,,4470
b4a73a68fb2c5b9d428a6a6d15ddf1ba2795088e,0,Impala Public Jenkins,2018-01-04 07:27:32+00:00,['4f4912c532532bac6822a91be32d0927d505b861'],1,48,49,5624330,1,,,,4470
eea8ade36de084aac01ca81c71a3ce00254cd396,0,Impala Public Jenkins,2018-01-05 02:18:05+00:00,['b4a73a68fb2c5b9d428a6a6d15ddf1ba2795088e'],4,6,10,5624340,1,1,1,1,4470
d3ff67b8b3d7f1ba598ff6a66355562a840d2075,0,Impala Public Jenkins,2018-01-05 20:44:21+00:00,['eea8ade36de084aac01ca81c71a3ce00254cd396'],3,385,388,5624728,3,0.071428571,1,0.071428571,4471
d1a0510bfe0a168256d37904aca3a30994306454,1,Impala Public Jenkins,2018-01-05 21:21:46+00:00,['d3ff67b8b3d7f1ba598ff6a66355562a840d2075'],87,138,225,5624953,6,1,1,0.034482759,4471
d25607d01b90abe6fdb7a422278688876fa54594,0,Impala Public Jenkins,2018-01-05 22:57:21+00:00,['d1a0510bfe0a168256d37904aca3a30994306454'],15,75,90,5625043,5,0.275862069,0.965517241,0.965517241,4471
302ec25b2e76398f11bb5dccbdad84e06c750f22,0,Impala Public Jenkins,2018-01-06 01:30:36+00:00,['d25607d01b90abe6fdb7a422278688876fa54594'],24,173,197,5625240,5,0.52173913,0.869565217,0.847826087,4471
ce65b43d47d16840998eb5fab5333695050ac436,1,Impala Public Jenkins,2018-01-06 01:47:47+00:00,['302ec25b2e76398f11bb5dccbdad84e06c750f22'],60,391,451,5625691,14,0.510869565,0.85326087,0.918478261,4472
6a87eb20a5d55b0a2f6f9102375ff8da4b98ccba,1,Impala Public Jenkins,2018-01-06 22:54:17+00:00,['ce65b43d47d16840998eb5fab5333695050ac436'],13,56,69,5625760,6,0.391304348,1,0.695652174,4472
c4d950b9e96c22ca76aab288814428a775a88fa5,1,Impala Public Jenkins,2018-01-09 03:24:36+00:00,['6a87eb20a5d55b0a2f6f9102375ff8da4b98ccba'],0,19,19,5625779,1,,,,4472
38461c524f64cc367c483f5f958c64ffd014fcaa,0,Impala Public Jenkins,2018-01-09 04:55:59+00:00,['c4d950b9e96c22ca76aab288814428a775a88fa5'],1,99,100,5625879,5,0,0,0.257575758,4473
99962d2e81e7809565a85421b607fb1082a419a5,1,Impala Public Jenkins,2018-01-10 03:03:49+00:00,['38461c524f64cc367c483f5f958c64ffd014fcaa'],82,263,345,5626224,8,0.382978723,0.936170213,0.638297872,4473
f810458ca41536d31f2e8d168ca09ef3cb25603c,1,Impala Public Jenkins,2018-01-10 03:03:52+00:00,['99962d2e81e7809565a85421b607fb1082a419a5'],0,248,248,5626472,1,0.578616352,0.698113208,0.911949686,4474
514dfaf9fdff219256eaa9baf3efcc66bfdfafda,1,Impala Public Jenkins,2018-01-10 05:39:09+00:00,['f810458ca41536d31f2e8d168ca09ef3cb25603c'],46,96,142,5626614,4,0,1,1,4474
c86b0a9736ee1e19b95a2d06771ca2ab8577950f,0,Impala Public Jenkins,2018-01-10 05:47:23+00:00,['514dfaf9fdff219256eaa9baf3efcc66bfdfafda'],15,83,98,5626712,5,0,0.363636364,0,4474
1f4d687a9bd51a5c869dd806fb31449cdfb34180,0,Impala Public Jenkins,2018-01-10 18:41:31+00:00,['c86b0a9736ee1e19b95a2d06771ca2ab8577950f'],1,104,105,5626817,3,,,,4474
31c6a1719a271810f0ec09873a3424311e5627ec,0,Impala Public Jenkins,2018-01-10 18:42:04+00:00,['1f4d687a9bd51a5c869dd806fb31449cdfb34180'],0,14,14,5626831,1,,,,4474
6041865031c9298a6da00401bafe14553e1e0662,1,Impala Public Jenkins,2018-01-10 20:17:26+00:00,['31c6a1719a271810f0ec09873a3424311e5627ec'],0,134,134,5626965,6,0.433333333,1,1,4474
409b58150aaf6092107f1ad98813a9bd832e60fe,0,Impala Public Jenkins,2018-01-10 20:38:23+00:00,['6041865031c9298a6da00401bafe14553e1e0662'],0,50,50,5627015,4,,,,4474
3394eb1be77e4c79f298150484f979212ce78be2,0,Impala Public Jenkins,2018-01-10 21:13:56+00:00,['409b58150aaf6092107f1ad98813a9bd832e60fe'],2,6,8,5627023,1,,,,4474
a34df684f78ede6925ebeff1ed174b00828a980f,0,Impala Public Jenkins,2018-01-10 22:31:32+00:00,['3394eb1be77e4c79f298150484f979212ce78be2'],1,24,25,5627048,2,0.1875,0,1,4474
c0c1202dbfd1ffbd36a1053aa59e92d53b23e67a,1,Impala Public Jenkins,2018-01-11 00:42:02+00:00,['a34df684f78ede6925ebeff1ed174b00828a980f'],1,6,7,5627055,1,,,,4474
604e48d2f3f86b18f7d588d1861e17f177dfedc9,0,Impala Public Jenkins,2018-01-11 08:05:30+00:00,['c0c1202dbfd1ffbd36a1053aa59e92d53b23e67a'],5,14,19,5627074,2,0.875,0.875,1,4474
ab81c48d7ae6f9466cefb26e023aed020a58d931,1,Impala Public Jenkins,2018-01-11 20:10:01+00:00,['604e48d2f3f86b18f7d588d1861e17f177dfedc9'],1,1,2,5627076,1,,,,4474
b27537a15b679c0c84b7d2e9f49c9a51f9ae93ba,0,Impala Public Jenkins,2018-01-11 21:49:23+00:00,['ab81c48d7ae6f9466cefb26e023aed020a58d931'],6,71,77,5627153,8,,,,4474
20daa4d516987242ed7da5fe9474267666cf8add,0,Impala Public Jenkins,2018-01-11 22:52:29+00:00,['b27537a15b679c0c84b7d2e9f49c9a51f9ae93ba'],2,32,34,5627187,4,0.555555556,1,0.888888889,4474
fd5c3a7e18d1fc4f340a349713035a2a6fd17792,0,Impala Public Jenkins,2018-01-12 02:06:33+00:00,['20daa4d516987242ed7da5fe9474267666cf8add'],205,311,516,5627703,10,0.358974359,0.564102564,0.205128205,4474
5842c8406ddeed9ae51b9d976d868f49769cb788,0,Impala Public Jenkins,2018-01-12 09:04:48+00:00,['fd5c3a7e18d1fc4f340a349713035a2a6fd17792'],6,110,116,5627819,4,,,,4474
6dc7237fc128ae52e85ef9fdd887a1ab4eb2a465,0,Lars Volker,2018-01-12 17:22:56+00:00,['5842c8406ddeed9ae51b9d976d868f49769cb788'],1,1,2,5627821,1,,,,4474
e0c99300372a04e23d30cb08eb7a998b2d9019ce,1,Impala Public Jenkins,2018-01-12 20:11:20+00:00,['6dc7237fc128ae52e85ef9fdd887a1ab4eb2a465'],9,78,87,5627908,1,,,,4474
b5e2f338abe073438c80ef1ce2dea2294d87df7d,1,Impala Public Jenkins,2018-01-12 20:39:52+00:00,['e0c99300372a04e23d30cb08eb7a998b2d9019ce'],2,48,50,5627958,3,,,,4474
717cb9d1720405df54fdfba6081ea5eb97d88be5,0,Impala Public Jenkins,2018-01-12 21:38:38+00:00,['b5e2f338abe073438c80ef1ce2dea2294d87df7d'],1,1,2,5627960,1,,,,4474
ceeb130c5dba12dc37f69b01ec4cca4b577c0549,0,Impala Public Jenkins,2018-01-12 22:24:34+00:00,['717cb9d1720405df54fdfba6081ea5eb97d88be5'],5,61,66,5628026,2,,,,4474
df3a440fff38225a03879955c99a87d8ced3b13a,0,Impala Public Jenkins,2018-01-12 22:35:13+00:00,['ceeb130c5dba12dc37f69b01ec4cca4b577c0549'],14,44,58,5628084,5,1,1,0.9,4474
10fb24afb966c567adcf632a314f6af1826f19fc,1,Impala Public Jenkins,2018-01-13 02:48:08+00:00,['df3a440fff38225a03879955c99a87d8ced3b13a'],9,30,39,5628123,3,0.636363636,0.727272727,1,4474
6bff0bd766ece21c6f7605f0307fcc710641ab7f,0,Impala Public Jenkins,2018-01-13 03:24:06+00:00,['10fb24afb966c567adcf632a314f6af1826f19fc'],3,6,9,5628132,2,,,,4474
91d109d6e982b83500c7869f866ec719f73eb7b6,1,Impala Public Jenkins,2018-01-13 03:44:43+00:00,['6bff0bd766ece21c6f7605f0307fcc710641ab7f'],5,27,32,5628164,5,0.526315789,1,1,4474
888a16cad5faf381898ee50d25c49f35111f9142,0,Impala Public Jenkins,2018-01-16 21:43:46+00:00,['91d109d6e982b83500c7869f866ec719f73eb7b6'],0,11,11,5628175,3,1,1,0.75,4474
3fc42ded02bd9314cbc1881cc52692cde35e02fb,1,Impala Public Jenkins,2018-01-16 23:01:32+00:00,['888a16cad5faf381898ee50d25c49f35111f9142'],852,1768,2620,5630795,46,0.432122371,0.709369025,0.682600382,4477
4c43cace877c9d7455eff8329ed3b285f51bf84d,1,Impala Public Jenkins,2018-01-16 23:58:24+00:00,['3fc42ded02bd9314cbc1881cc52692cde35e02fb'],20,339,359,5631154,8,0.323741007,0.690647482,0.741007194,4478
f8b406222de8f41765ef1d130e2debbd8ab06369,0,Impala Public Jenkins,2018-01-17 01:41:16+00:00,['4c43cace877c9d7455eff8329ed3b285f51bf84d'],0,93,93,5631247,4,1,1,1,4478
6cc76d72016b8d5672676e8e8a979b0807803ad9,0,Impala Public Jenkins,2018-01-17 04:18:24+00:00,['f8b406222de8f41765ef1d130e2debbd8ab06369'],0,26,26,5631273,5,1,1,0.090909091,4480
b6e43133e671773d2757612f72cfcdb0ff303226,1,Lars Volker,2018-01-17 22:31:33+00:00,['6cc76d72016b8d5672676e8e8a979b0807803ad9'],1,1,2,5631275,1,,,,4480
dcc7be0ed483b332dac22d6596f56ff2a6cfdaa3,1,Impala Public Jenkins,2018-01-17 22:40:13+00:00,['b6e43133e671773d2757612f72cfcdb0ff303226'],6,29,35,5631310,4,0.066666667,0.866666667,0.933333333,4480
d9b6fd073055b436c7404d49454dc215b2c7a369,1,Impala Public Jenkins,2018-01-17 22:52:58+00:00,['dcc7be0ed483b332dac22d6596f56ff2a6cfdaa3'],17,18,35,5631345,2,0,0,0,4480
35a3e186d61b8f365b0f7d1127be311758437e16,1,Impala Public Jenkins,2018-01-18 03:28:51+00:00,['d9b6fd073055b436c7404d49454dc215b2c7a369'],4,14182,14186,5645531,74,1,1,0.981132075,4551
f5d73f5e76d477ae47e02df4fb69ad590363c0d6,1,Impala Public Jenkins,2018-01-18 21:25:28+00:00,['35a3e186d61b8f365b0f7d1127be311758437e16'],30,9,39,5645570,3,0.363636364,0.272727273,0,4551
ca7d03cfe94bd4961587b918ba6ef6bdb91bb2a6,0,Impala Public Jenkins,2018-01-18 21:53:40+00:00,['f5d73f5e76d477ae47e02df4fb69ad590363c0d6'],1,1,2,5645572,1,,,,4551
028a83e6543a18dd3b9161226355f1e8d36c4ed7,1,Impala Public Jenkins,2018-01-18 23:08:26+00:00,['ca7d03cfe94bd4961587b918ba6ef6bdb91bb2a6'],8,34,42,5645614,4,0,0.409090909,0.409090909,4551
b3d38b5c8650fb455ca556f321fb7aea35dbd5ee,1,Impala Public Jenkins,2018-01-18 23:25:09+00:00,['028a83e6543a18dd3b9161226355f1e8d36c4ed7'],44,14,58,5645672,5,0,0,0.1,4551
e714f2b33c5b64d5680dbc15e166759930f04560,1,Impala Public Jenkins,2018-01-18 23:31:52+00:00,['b3d38b5c8650fb455ca556f321fb7aea35dbd5ee'],329,350,679,5646351,30,1,1,0,4551
d8ae8801ae668f6ba4771c5794b80f7c9262cd65,0,Impala Public Jenkins,2018-01-19 01:21:45+00:00,['e714f2b33c5b64d5680dbc15e166759930f04560'],1,9,10,5646361,3,,,,4551
3f00d10e1b6c5785990c1a73835f82e3821f839e,1,Impala Public Jenkins,2018-01-19 09:25:01+00:00,['d8ae8801ae668f6ba4771c5794b80f7c9262cd65'],112,1205,1317,5647678,24,0.483739837,0.918699187,0.894308943,4556
579e33207b3bbe8b6a26cf1fe1e7fd8d26021475,0,Impala Public Jenkins,2018-01-19 09:55:52+00:00,['3f00d10e1b6c5785990c1a73835f82e3821f839e'],301,286,587,5648265,3,0.742857143,0,0,4557
db98dc6504368f24eb20e12959f6d779be31c9b6,1,Impala Public Jenkins,2018-01-19 20:37:25+00:00,['579e33207b3bbe8b6a26cf1fe1e7fd8d26021475'],246,706,952,5649217,20,0.12,0.2,0.786666667,4559
4afabd4e317ae368f5cb2bd2dd1a36ddafc90e0a,0,Impala Public Jenkins,2018-01-19 21:26:12+00:00,['db98dc6504368f24eb20e12959f6d779be31c9b6'],0,1,1,5649218,1,,,,4559
1dfdc6704b74c77d63accb69e9197fd203455be0,0,Impala Public Jenkins,2018-01-19 23:22:49+00:00,['4afabd4e317ae368f5cb2bd2dd1a36ddafc90e0a'],13,9,22,5649240,3,0.666666667,0.666666667,0,4559
6dac74eff168601f3a09799c3342a092f58d0944,0,Impala Public Jenkins,2018-01-20 01:52:46+00:00,['1dfdc6704b74c77d63accb69e9197fd203455be0'],8,9,17,5649257,1,,,,4559
503583e529ac0d3a3b0abd08bb7742fd4b4fcffa,0,Impala Public Jenkins,2018-01-20 05:14:27+00:00,['6dac74eff168601f3a09799c3342a092f58d0944'],1,7,8,5649265,1,0,0,0,4559
018f95e424414eff1bfec2718244172713f729ab,0,Impala Public Jenkins,2018-01-20 20:34:27+00:00,['503583e529ac0d3a3b0abd08bb7742fd4b4fcffa'],1,1,2,5649267,1,,,,4559
c9593550482c68f410cd8d269a089370fe20581a,1,Impala Public Jenkins,2018-01-20 22:16:12+00:00,['018f95e424414eff1bfec2718244172713f729ab'],0,2,2,5649269,1,,,,4559
7f652ce659142abf1cd908196be1b56eed30bcbd,1,Impala Public Jenkins,2018-01-22 22:34:30+00:00,['c9593550482c68f410cd8d269a089370fe20581a'],106,157,263,5649532,7,0.766666667,1,0.433333333,4559
281f7ab0109ad4e538e1fda2b59e57047ffc44c1,1,Impala Public Jenkins,2018-01-23 01:24:29+00:00,['7f652ce659142abf1cd908196be1b56eed30bcbd'],13,11,24,5649556,2,0,0,0,4559
56464e4616ca624bc88faca9218ba75cb1ff582b,0,Impala Public Jenkins,2018-01-23 01:48:50+00:00,['281f7ab0109ad4e538e1fda2b59e57047ffc44c1'],30,1,31,5649587,6,0.571428571,1,0.071428571,4559
a3c0fffa1275c1d1d2770b9fc35885a22dc7edce,0,Impala Public Jenkins,2018-01-23 01:59:41+00:00,['56464e4616ca624bc88faca9218ba75cb1ff582b'],13,46,59,5649646,4,1,1,1,4559
fa7ae65db59a326014a3ccc583f95ccbdf212248,1,Lars Volker,2018-01-23 18:42:39+00:00,['a3c0fffa1275c1d1d2770b9fc35885a22dc7edce'],14,20,34,5649680,1,1,0,0,4559
72b4b815b6eae55e91290b98345b912dbd7128e2,0,Impala Public Jenkins,2018-01-23 20:35:25+00:00,['fa7ae65db59a326014a3ccc583f95ccbdf212248'],4,93,97,5649777,3,0.092436975,0.798319328,1,4559
1890230246bc197a4d246915a1128a0b852f425a,0,Impala Public Jenkins,2018-01-23 22:19:08+00:00,['72b4b815b6eae55e91290b98345b912dbd7128e2'],1,2,3,5649780,1,,,,4559
f68aa87efde6f2535a5726348475431081004547,0,Impala Public Jenkins,2018-01-23 22:26:32+00:00,['1890230246bc197a4d246915a1128a0b852f425a'],3,6,9,5649789,1,,,,4559
c2d27ca823f30636c97c7a0dc22cddf35560236d,0,Impala Public Jenkins,2018-01-23 23:44:46+00:00,['f68aa87efde6f2535a5726348475431081004547'],88,178,266,5650055,4,0,1,0.619047619,4559
be0f4f9d21ac3c34f6ebf214e26686a008b57e24,1,Impala Public Jenkins,2018-01-24 02:41:31+00:00,['c2d27ca823f30636c97c7a0dc22cddf35560236d'],81,594,675,5650730,19,0.518518519,0.652777778,0.935185185,4560
674d29d71d9c75da4509544ea609bb1a62e6b0fb,1,Impala Public Jenkins,2018-01-24 03:34:52+00:00,['be0f4f9d21ac3c34f6ebf214e26686a008b57e24'],0,274,274,5651004,2,0.148648649,0.371621622,1,4562
11d1784c0a41d24db8bb0dadcedacfbf7f256a18,0,Impala Public Jenkins,2018-01-24 05:00:33+00:00,['674d29d71d9c75da4509544ea609bb1a62e6b0fb'],1,20,21,5651025,2,0,0,1,4562
92fd7e56eb83b67f7f4ec836ebf8e495c75cbdb7,1,Impala Public Jenkins,2018-01-24 06:56:56+00:00,['11d1784c0a41d24db8bb0dadcedacfbf7f256a18'],3,7,10,5651035,1,0,0,0,4562
545e60f8329ddd98b5adaff5981b52bbdcf4d69d,1,Impala Public Jenkins,2018-01-24 22:47:18+00:00,['92fd7e56eb83b67f7f4ec836ebf8e495c75cbdb7'],60,252,312,5651347,16,0,0.941860465,0.941860465,4563
1fc40f4a6661e8e9d2550458adae32f40122db28,0,Impala Public Jenkins,2018-01-25 03:55:31+00:00,['545e60f8329ddd98b5adaff5981b52bbdcf4d69d'],21,44,65,5651412,3,0.5,0.571428571,1,4563
0a1d586d2a2822ad9b4052fef91b1d147b9b4e2b,1,Impala Public Jenkins,2018-01-25 04:33:11+00:00,['1fc40f4a6661e8e9d2550458adae32f40122db28'],139,235,374,5651786,23,0,1,0.736842105,4563
b38db91b5e463f68efbd7eacf3e719e34d87e2bb,0,Impala Public Jenkins,2018-01-25 04:36:06+00:00,['0a1d586d2a2822ad9b4052fef91b1d147b9b4e2b'],1,9,10,5651796,2,,,,4563
088d6add784619e4f1be84588bafe94faf1693f4,0,Impala Public Jenkins,2018-01-25 20:27:59+00:00,['b38db91b5e463f68efbd7eacf3e719e34d87e2bb'],10,12,22,5651818,1,1,1,1,4563
0fdd81682db633ebc69ca415080e7b790ab901ab,0,Impala Public Jenkins,2018-01-25 21:08:58+00:00,['088d6add784619e4f1be84588bafe94faf1693f4'],2,2,4,5651822,1,,,,4563
2ee2c4fdb9b75d4acadd73627d09193c0198ade8,1,Impala Public Jenkins,2018-01-26 01:27:41+00:00,['0fdd81682db633ebc69ca415080e7b790ab901ab'],7,54,61,5651883,3,1,1,1,4564
5ca603a3769d23c2085bc37d6261517cf0bbcb6e,0,Impala Public Jenkins,2018-01-26 22:45:57+00:00,['2ee2c4fdb9b75d4acadd73627d09193c0198ade8'],6,7,13,5651896,1,0,1,1,4564
47959067ea79b3406ffc411a95362708514c31b2,1,Impala Public Jenkins,2018-01-26 23:07:47+00:00,['5ca603a3769d23c2085bc37d6261517cf0bbcb6e'],0,6,6,5651902,1,0,1,1,4564
0b494d55ad1fcedb0506b96bbd6d09024de5e045,0,Impala Public Jenkins,2018-01-28 04:49:37+00:00,['47959067ea79b3406ffc411a95362708514c31b2'],12,43,55,5651957,4,1,1,0.9,4564
12938fd4490f3cb79bd39577193bd9e7e4979f03,0,Impala Public Jenkins,2018-01-29 08:00:00+00:00,['0b494d55ad1fcedb0506b96bbd6d09024de5e045'],6,145,151,5652108,2,0,0,1,4564
82cf99d4383f3e568d59999db978d7bd4b03f149,0,Impala Public Jenkins,2018-01-29 23:32:17+00:00,['12938fd4490f3cb79bd39577193bd9e7e4979f03'],3,4,7,5652115,2,0,0,0,4564
4aafa5e9ba9fe22d2dbc7764a796b3cd04136cc0,0,Impala Public Jenkins,2018-01-30 20:00:41+00:00,['82cf99d4383f3e568d59999db978d7bd4b03f149'],58,177,235,5652350,8,0.285714286,0.38961039,0.25974026,4564
7d72b225d85bbb115488c84295d6f7a049c73d8f,1,Impala Public Jenkins,2018-01-30 23:23:51+00:00,['4aafa5e9ba9fe22d2dbc7764a796b3cd04136cc0'],71,332,403,5652753,15,0.144654088,1,0.761006289,4564
22d9ac08937f348b21075b276d487f4b1ba3524c,1,Impala Public Jenkins,2018-01-31 03:21:09+00:00,['7d72b225d85bbb115488c84295d6f7a049c73d8f'],19,135,154,5652907,10,0.214285714,0.657142857,0.671428571,4564
6e4af50695e098db753eae9f66fbcde754c36127,1,Impala Public Jenkins,2018-01-31 18:06:13+00:00,['22d9ac08937f348b21075b276d487f4b1ba3524c'],1,1,2,5652909,1,,,,4564
f97634fcf9a2e48d307f19595e70bdcee9c1980e,0,Impala Public Jenkins,2018-01-31 21:27:00+00:00,['6e4af50695e098db753eae9f66fbcde754c36127'],15,108,123,5653032,3,1,1,1,4565
f6576adc2eeff4496882c633be4abccae7f3bed2,1,Impala Public Jenkins,2018-01-31 22:08:48+00:00,['f97634fcf9a2e48d307f19595e70bdcee9c1980e'],13,35,48,5653080,2,0,1,0,4565
4b16ecd032ac19c040d5cfa2a26ab8a11e4d554d,1,Impala Public Jenkins,2018-02-01 01:43:12+00:00,['f6576adc2eeff4496882c633be4abccae7f3bed2'],3,7,10,5653090,1,,,,4565
cb2fa2475ee504c9d849a7a139b89c55cc59ce30,0,Impala Public Jenkins,2018-02-01 02:26:50+00:00,['4b16ecd032ac19c040d5cfa2a26ab8a11e4d554d'],2,8,10,5653100,1,0,1,0,4565
999a3f60c11d4bcaea77da887abf26b743fc6794,0,Impala Public Jenkins,2018-02-01 02:45:51+00:00,['cb2fa2475ee504c9d849a7a139b89c55cc59ce30'],12,9,21,5653121,1,,,,4565
99234d2121f7dd189c0ff2d9f7ad6c7d0c62c5dd,0,Impala Public Jenkins,2018-02-01 04:34:33+00:00,['999a3f60c11d4bcaea77da887abf26b743fc6794'],5,14,19,5653140,4,0.285714286,1,0.714285714,4565
1b1087eb0546d81574e8c7fdcaf3fc11d6db3cea,0,Impala Public Jenkins,2018-02-01 05:14:14+00:00,['99234d2121f7dd189c0ff2d9f7ad6c7d0c62c5dd'],2,91,93,5653233,5,0,0.62745098,1,4565
acfd169c8e814adb61a1f1d35327b38ee980f217,1,Impala Public Jenkins,2018-02-01 08:26:26+00:00,['1b1087eb0546d81574e8c7fdcaf3fc11d6db3cea'],200,105,305,5653538,23,0.823529412,0.254901961,0.666666667,4565
3bfda3348740e0951cbf8f60cde70cc4d1391c5e,0,Impala Public Jenkins,2018-02-01 08:53:36+00:00,['acfd169c8e814adb61a1f1d35327b38ee980f217'],84,350,434,5653972,14,0.917525773,0.958762887,0.597938144,4567
d49f629c447ea59ad73ceeb0547fde4d41c651d1,0,Impala Public Jenkins,2018-02-01 19:50:52+00:00,['3bfda3348740e0951cbf8f60cde70cc4d1391c5e'],1,2,3,5653975,1,1,1,1,4567
08ca346f2e917ce2382e8ac532ee016dd5b320fc,1,Impala Public Jenkins,2018-02-01 20:27:14+00:00,['d49f629c447ea59ad73ceeb0547fde4d41c651d1'],39,303,342,5654317,7,0,0.247058824,0.788235294,4567
4bd7cc8dbf2f07db3468e1feb595cd16a7cd81e3,0,Impala Public Jenkins,2018-02-02 01:01:36+00:00,['08ca346f2e917ce2382e8ac532ee016dd5b320fc'],40,127,167,5654484,3,0.311111111,0.911111111,0.822222222,4567
f0b3d9d122f2c6eb4137bf93e3512a489ff8fab0,1,Impala Public Jenkins,2018-02-02 01:13:08+00:00,['4bd7cc8dbf2f07db3468e1feb595cd16a7cd81e3'],444,572,1016,5655500,29,0.588235294,0.647058824,1,4568
ff86feaa67ff8bf703896e33d9a358e42739ae30,1,Impala Public Jenkins,2018-02-02 02:14:46+00:00,['f0b3d9d122f2c6eb4137bf93e3512a489ff8fab0'],59,267,326,5655826,2,0.352941176,1,0.754901961,4568
4a00398d07e26e731781d23b7f04071a67e6bdf8,0,Impala Public Jenkins,2018-02-02 22:37:30+00:00,['ff86feaa67ff8bf703896e33d9a358e42739ae30'],1,1,2,5655828,1,,,,4568
c2184e56ae91bc9c6f04ac0dae1b75261d6d20a2,1,Impala Public Jenkins,2018-02-02 23:17:47+00:00,['4a00398d07e26e731781d23b7f04071a67e6bdf8'],564,816,1380,5657208,27,1,1,0.875,4570
a018038df5b13f24f7980b75d755e0123ae2687d,0,Impala Public Jenkins,2018-02-02 23:22:51+00:00,['c2184e56ae91bc9c6f04ac0dae1b75261d6d20a2'],18,30,48,5657256,6,0,0,1,4570
097f2f3f3b25a0f148bb8f5465debe7d690b07fe,1,Impala Public Jenkins,2018-02-03 03:24:37+00:00,['a018038df5b13f24f7980b75d755e0123ae2687d'],0,59,59,5657315,4,0.666666667,0.666666667,0.666666667,4570
c201753b2e5e50a6afbc01b734583138bf964302,0,Impala Public Jenkins,2018-02-03 05:10:59+00:00,['097f2f3f3b25a0f148bb8f5465debe7d690b07fe'],0,2,2,5657317,1,,,,4570
a493a016450dc217d4d034d49f4a150429828454,0,Impala Public Jenkins,2018-02-03 05:22:24+00:00,['c201753b2e5e50a6afbc01b734583138bf964302'],2,2,4,5657321,1,,,,4570
fc529b7f9fce9d1bc1f6da2952380bad3dea0b11,1,Impala Public Jenkins,2018-02-03 05:58:50+00:00,['a493a016450dc217d4d034d49f4a150429828454'],66,248,314,5657635,12,1,1,1,4570
1a1927b07de816826e73231d93560ba95a8e2cf6,1,Impala Public Jenkins,2018-02-03 22:56:13+00:00,['fc529b7f9fce9d1bc1f6da2952380bad3dea0b11'],175,359,534,5658169,9,0.277227723,0.95049505,0.693069307,4571
c856b30e36e7bdf5160e7a71b8e84a82d8258934,0,Impala Public Jenkins,2018-02-03 23:06:13+00:00,['1a1927b07de816826e73231d93560ba95a8e2cf6'],0,3,3,5658172,3,,,,4571
30c0375ed358f8040d28fe756a17c6e3965177b1,0,Impala Public Jenkins,2018-02-05 22:22:45+00:00,['c856b30e36e7bdf5160e7a71b8e84a82d8258934'],36,44,80,5658252,7,1,1,1,4571
9ac9f7e3f8f327a3cade75548a85106190c8842c,1,Impala Public Jenkins,2018-02-05 22:49:07+00:00,['30c0375ed358f8040d28fe756a17c6e3965177b1'],317,381,698,5658950,4,1,0,0,4573
9b68645f9eb9e08899fda860e0946cc05f205479,0,Impala Public Jenkins,2018-02-05 22:58:32+00:00,['9ac9f7e3f8f327a3cade75548a85106190c8842c'],74,228,302,5659252,6,0.828571429,0.685714286,0.871428571,4573
32bf54dfd03c1f880864ff6295df50a921dd5922,0,Impala Public Jenkins,2018-02-06 03:25:02+00:00,['9b68645f9eb9e08899fda860e0946cc05f205479'],6,33,39,5659291,3,0,0,0,4573
dedff5e25c19da724ae032a52354cd4fd61ec40a,0,Impala Public Jenkins,2018-02-06 22:58:25+00:00,['32bf54dfd03c1f880864ff6295df50a921dd5922'],196,156,352,5659643,3,0,0,1,4573
1acddfc86fbacf0eb498c65d00c1eb0e9b486875,0,Impala Public Jenkins,2018-02-06 23:40:43+00:00,['dedff5e25c19da724ae032a52354cd4fd61ec40a'],228,74,302,5659945,6,0.171428571,0.314285714,0.128571429,4573
f243055b880afdc459373975347db5a99c3538f0,1,Impala Public Jenkins,2018-02-07 03:25:01+00:00,['1acddfc86fbacf0eb498c65d00c1eb0e9b486875'],0,28,28,5659973,2,0.866666667,1,1,4573
2890f30c1dab203750ac997b0ce34f9d4edca626,0,Impala Public Jenkins,2018-02-07 03:49:40+00:00,['f243055b880afdc459373975347db5a99c3538f0'],84,86,170,5660143,2,,,,4573
0a9f0369659b0996ac9db3a2e9ef877941d8b9eb,1,Thomas Tauber-Marshall,2018-02-07 20:06:52+00:00,['2890f30c1dab203750ac997b0ce34f9d4edca626'],30,18,48,5660191,6,1,1,0,4573
136267e87ff3b9304b9aefa70947b160721ca32b,1,Thomas Tauber-Marshall,2018-02-07 20:54:37+00:00,['0a9f0369659b0996ac9db3a2e9ef877941d8b9eb'],177,58,235,5660426,8,0.714285714,0.61038961,0.74025974,4573
36e301db4ba0a00459d4ef573745943fc7f082fe,0,Impala Public Jenkins,2018-02-07 21:59:44+00:00,['136267e87ff3b9304b9aefa70947b160721ca32b'],3,8,11,5660437,1,0,1,0,4573
572af614d6d2af21dc4d261a3c53ed9b2b05c833,0,Impala Public Jenkins,2018-02-07 23:03:40+00:00,['36e301db4ba0a00459d4ef573745943fc7f082fe'],1,62,63,5660500,5,0.6,1,1,4573
8abc166e113a54e7921796fd1ddfebf6bfdc3982,0,Impala Public Jenkins,2018-02-08 20:22:26+00:00,['572af614d6d2af21dc4d261a3c53ed9b2b05c833'],2,9,11,5660511,2,0,1,1,4573
07965a4c816c016a88e066d7f09a81ab2d86d91f,1,Impala Public Jenkins,2018-02-08 21:42:57+00:00,['8abc166e113a54e7921796fd1ddfebf6bfdc3982'],4,5,9,5660520,2,1,1,1,4573
9233a8e9751bceacc176f1644737526141694edd,0,Impala Public Jenkins,2018-02-09 02:15:58+00:00,['07965a4c816c016a88e066d7f09a81ab2d86d91f'],2,3,5,5660525,1,,,,4573
5aa28b1b3a731a37afa3f028e4f5a39207294ffc,0,Tim Armstrong,2018-02-09 16:24:00+00:00,['9233a8e9751bceacc176f1644737526141694edd'],79,233,312,5660837,6,0.828571429,0.685714286,0.871428571,4573
3151421902e1373d483dd784f4241bf3caa0ceea,0,Tim Armstrong,2018-02-09 16:49:54+00:00,['5aa28b1b3a731a37afa3f028e4f5a39207294ffc'],2,2,4,5660841,2,,,,4573
0047f813abc4dc8fb08a15ac8b9d0f582ab8a5f5,0,Impala Public Jenkins,2018-02-09 20:01:33+00:00,['3151421902e1373d483dd784f4241bf3caa0ceea'],47,54,101,5660942,9,1,0,0,4573
2e60347868d7e719d80401f9abcbe971e659502b,1,Impala Public Jenkins,2018-02-10 03:10:26+00:00,['0047f813abc4dc8fb08a15ac8b9d0f582ab8a5f5'],40,42,82,5661024,8,1,,1,4573
95f16663092af3ffa6dddf745973c7065c164436,0,Impala Public Jenkins,2018-02-12 21:59:37+00:00,['2e60347868d7e719d80401f9abcbe971e659502b'],32,53,85,5661109,5,1,0.545454545,0.545454545,4573
f4d7e2644a7c3ab7450bc4fd7dfd274803fbf8dd,0,Impala Public Jenkins,2018-02-13 03:13:47+00:00,['95f16663092af3ffa6dddf745973c7065c164436'],1,4,5,5661114,1,1,1,1,4573
955fca68d53499455fceb5d7d308957eb6687a87,0,Impala Public Jenkins,2018-02-13 04:26:34+00:00,['f4d7e2644a7c3ab7450bc4fd7dfd274803fbf8dd'],0,117,117,5661231,2,0,0.620689655,0.620689655,4573
5f7599687748b1e1ce0a5a34d38cc49a4c4cd9f5,0,Impala Public Jenkins,2018-02-13 05:41:18+00:00,['955fca68d53499455fceb5d7d308957eb6687a87'],1,17,18,5661249,4,1,1,1,4573
8fc1eccce494c36c5f8d94e5083366b40365a71f,1,Impala Public Jenkins,2018-02-13 08:29:03+00:00,['5f7599687748b1e1ce0a5a34d38cc49a4c4cd9f5'],539,891,1430,5662679,38,0.572139303,0.68159204,0.7960199,4573
887fb14438a91c9668bee42875d7991fbf956a35,0,Alex Behm,2018-02-13 21:02:17+00:00,['8fc1eccce494c36c5f8d94e5083366b40365a71f'],18,51,69,5662748,4,0.380952381,1,1,4573
f9971f81a35bad2e176fde9c93fa4a7a04214438,0,Impala Public Jenkins,2018-02-13 23:44:14+00:00,['887fb14438a91c9668bee42875d7991fbf956a35'],5,3,8,5662756,2,1,1,0,4573
d7f2ce10b4b77258640be3dfba3bee6cb5031555,0,Impala Public Jenkins,2018-02-14 03:01:59+00:00,['f9971f81a35bad2e176fde9c93fa4a7a04214438'],0,4,4,5662760,1,0,0,0,4573
d45de4747c57fdfb6b88f30a4b4b7685696277fc,0,Impala Public Jenkins,2018-02-14 05:26:48+00:00,['d7f2ce10b4b77258640be3dfba3bee6cb5031555'],3,5,8,5662768,1,0,1,1,4573
f5986bebcbe7f89b2435ca67d1a7fe43a363541f,0,Impala Public Jenkins,2018-02-14 05:54:25+00:00,['d45de4747c57fdfb6b88f30a4b4b7685696277fc'],31,31,62,5662830,2,,,,4573
e1173653b30ed3a0d8edfbed381446aa27c4fd09,1,Impala Public Jenkins,2018-02-14 07:38:28+00:00,['f5986bebcbe7f89b2435ca67d1a7fe43a363541f'],0,43,43,5662873,2,0,0.96969697,1,4573
b0d3433e36d7942b3e10bddc310287266240810b,1,Impala Public Jenkins,2018-02-14 22:44:40+00:00,['e1173653b30ed3a0d8edfbed381446aa27c4fd09'],483,843,1326,5664199,15,0.225433526,0.664739884,0.011560694,4573
cce0b2de28e81ffd7a9622e3e5eba7a2081a7fba,1,Impala Public Jenkins,2018-02-15 01:35:34+00:00,['b0d3433e36d7942b3e10bddc310287266240810b'],33,131,164,5664363,6,0.340425532,0,0.361702128,4573
19ab465b391167e99658c9270a2a3d76b2b2652f,1,Impala Public Jenkins,2018-02-15 05:04:50+00:00,['cce0b2de28e81ffd7a9622e3e5eba7a2081a7fba'],59,379,438,5664801,8,0.300884956,1,0.831858407,4575
9d370219273e5068ec447168516dd539985d9903,0,Impala Public Jenkins,2018-02-15 10:55:55+00:00,['19ab465b391167e99658c9270a2a3d76b2b2652f'],2,2,4,5664805,2,,,,4575
61f892a60c88650ed05799ca06d2f74cfffc845f,0,Impala Public Jenkins,2018-02-15 21:58:06+00:00,['9d370219273e5068ec447168516dd539985d9903'],25,75,100,5664905,8,0.391304348,1,0.913043478,4575
be675e15578eda6285c9558c21bc16ce9dfb7ffc,0,Impala Public Jenkins,2018-02-16 06:36:48+00:00,['61f892a60c88650ed05799ca06d2f74cfffc845f'],2,5,7,5664912,2,0,0,1,4575
cb05241c87b69f76005334158733ab580e48b320,0,Impala Public Jenkins,2018-02-16 08:46:11+00:00,['be675e15578eda6285c9558c21bc16ce9dfb7ffc'],1,1,2,5664914,1,,,,4575
a8fc9f0fc7925c106a6a290420d0f6bc42460af4,1,Impala Public Jenkins,2018-02-16 09:26:01+00:00,['cb05241c87b69f76005334158733ab580e48b320'],7,86,93,5665007,8,0.545454545,0.818181818,0.818181818,4576
0eaab69fff82a62fbddaae8a0d4ee7a4302ee715,0,Impala Public Jenkins,2018-02-16 20:23:21+00:00,['a8fc9f0fc7925c106a6a290420d0f6bc42460af4'],2,27,29,5665036,5,0,0.8,1,4576
e0abffb94f64266bb1b3bcda45b791bf5d51af7d,0,Impala Public Jenkins,2018-02-16 23:55:33+00:00,['0eaab69fff82a62fbddaae8a0d4ee7a4302ee715'],3,3,6,5665042,2,,,,4576
9c0b1ba33ccd547ebe63039ba20a0a0c0c87857d,0,Impala Public Jenkins,2018-02-16 23:56:55+00:00,['e0abffb94f64266bb1b3bcda45b791bf5d51af7d'],1,1,2,5665044,1,,,,4576
61d941fad36f3c07cd9ba4daad7ffbac69507a02,0,Impala Public Jenkins,2018-02-17 01:40:08+00:00,['9c0b1ba33ccd547ebe63039ba20a0a0c0c87857d'],1,1,2,5665046,1,,,,4576
3a049a530ee9ef1f85aa021e3995f39626f2c980,0,Impala Public Jenkins,2018-02-17 22:27:35+00:00,['61d941fad36f3c07cd9ba4daad7ffbac69507a02'],162,282,444,5665490,15,1,0.925,1,4576
8302608bdff15d6e8af324fc885dd0a8c2b44a5d,0,Impala Public Jenkins,2018-02-20 00:45:48+00:00,['3a049a530ee9ef1f85aa021e3995f39626f2c980'],2,4,6,5665496,2,1,1,1,4576
62d8462e13c69e6b2d67ad571fcd5c288514d398,1,Impala Public Jenkins,2018-02-20 04:08:11+00:00,['8302608bdff15d6e8af324fc885dd0a8c2b44a5d'],95,242,337,5665833,19,0.197674419,1,0.23255814,4576
c3a8560c384c1cc60bd1728277536d263c2ac0eb,0,Impala Public Jenkins,2018-02-20 09:03:23+00:00,['62d8462e13c69e6b2d67ad571fcd5c288514d398'],0,10,10,5665843,2,0,1,0,4576
ac86e9d931fa6e5d273e51c26cd7c1d1ad2cc6ce,1,Impala Public Jenkins,2018-02-20 09:32:38+00:00,['c3a8560c384c1cc60bd1728277536d263c2ac0eb'],10,50,60,5665903,2,0.966666667,1,0.5,4576
04383f1769aaf7e2baefa3fe3b18d74643f85e84,0,Impala Public Jenkins,2018-02-20 22:09:06+00:00,['ac86e9d931fa6e5d273e51c26cd7c1d1ad2cc6ce'],9,9,18,5665921,1,,,,4576
97f950c54ac587970c9bc90dbf7808875e3d712d,1,Impala Public Jenkins,2018-02-20 22:09:56+00:00,['04383f1769aaf7e2baefa3fe3b18d74643f85e84'],5,23,28,5665949,1,0,0,1,4576
3a68e69ec7117e697bd8964fe32ae63c7b95b319,0,Impala Public Jenkins,2018-02-20 22:32:02+00:00,['97f950c54ac587970c9bc90dbf7808875e3d712d'],7,227,234,5666183,5,0.057377049,0.131147541,0.631147541,4577
f562be8c29a080549fa15e689f795b7a57003154,1,Impala Public Jenkins,2018-02-21 01:33:42+00:00,['3a68e69ec7117e697bd8964fe32ae63c7b95b319'],395,359,754,5666937,26,1,0.875,1,4577
baec8cae34591c92c9309333280f85f81d852f8d,1,Impala Public Jenkins,2018-02-21 03:17:57+00:00,['f562be8c29a080549fa15e689f795b7a57003154'],0,24,24,5666961,2,0,1,1,4577
678bf28e233e667b05585110422762614840bdc2,0,Impala Public Jenkins,2018-02-21 04:33:55+00:00,['baec8cae34591c92c9309333280f85f81d852f8d'],70,219,289,5667250,3,0.494736842,1,0.842105263,4577
74dd9e9bfe32541e9ab6bddb8b839f3e491361f1,1,Impala Public Jenkins,2018-02-21 10:19:06+00:00,['678bf28e233e667b05585110422762614840bdc2'],124,547,671,5667921,19,0.497109827,0.878612717,0.971098266,4578
a25f69355fa6cccaabcea86a434c4ca61ed7c8ac,0,Impala Public Jenkins,2018-02-21 22:11:22+00:00,['74dd9e9bfe32541e9ab6bddb8b839f3e491361f1'],48,110,158,5668079,3,0,0,1,4578
881e00a8bff0469ab7860bcd0d4d4794fb04a4b8,0,Impala Public Jenkins,2018-02-22 00:57:46+00:00,['a25f69355fa6cccaabcea86a434c4ca61ed7c8ac'],2,137,139,5668218,6,1,1,0,4580
1b121c9f1bd6127bc167c5aba7ad0aa38014fad5,0,Impala Public Jenkins,2018-02-22 01:36:50+00:00,['881e00a8bff0469ab7860bcd0d4d4794fb04a4b8'],8,15,23,5668241,2,,,,4580
d4621780180f189d770508a70c330631013d2de9,1,Impala Public Jenkins,2018-02-22 03:28:21+00:00,['1b121c9f1bd6127bc167c5aba7ad0aa38014fad5'],0,8,8,5668249,1,0,0,1,4580
8ea1ce87e2150c843b4da15f9d42b87006e6ffca,1,Impala Public Jenkins,2018-02-22 06:55:03+00:00,['d4621780180f189d770508a70c330631013d2de9'],937,1460,2397,5670646,69,1,1,0.775665399,4582
623ace0e4c84297606d13f321bd2ceee70a8b9f2,0,Impala Public Jenkins,2018-02-22 07:18:39+00:00,['8ea1ce87e2150c843b4da15f9d42b87006e6ffca'],14,16,30,5670676,4,0,0,0,4582
5a1f432e8198e3eab7197a3b09455b57ab4b4412,1,Impala Public Jenkins,2018-02-22 20:43:44+00:00,['623ace0e4c84297606d13f321bd2ceee70a8b9f2'],65,211,276,5670952,9,1,1,1,4582
0c8eba076c10eecde578917e7f8ef78bba983fc4,1,Impala Public Jenkins,2018-02-23 00:03:54+00:00,['5a1f432e8198e3eab7197a3b09455b57ab4b4412'],637,882,1519,5672471,21,0,0,0.138461538,4582
7ce519f92b7497ea5c9b1519348f3509aa57ad7d,0,Impala Public Jenkins,2018-02-23 03:50:39+00:00,['0c8eba076c10eecde578917e7f8ef78bba983fc4'],14,48,62,5672533,3,0.16,1,0.08,4582
65680dc42107db4ff2273c635cedf83d20f0ea94,0,Tim Armstrong,2018-02-23 04:17:41+00:00,['7ce519f92b7497ea5c9b1519348f3509aa57ad7d'],911,579,1490,5674023,19,1,0.238738739,0.058558559,4582
5699b59d0c5cbe37e888a367adb42fa12dfb0916,1,Tim Armstrong,2018-02-23 04:17:41+00:00,['65680dc42107db4ff2273c635cedf83d20f0ea94'],590,1020,1610,5675633,24,0.059055118,0.641732283,0.948818898,4582
24b4ed0b29a44090350e630d625291c01b753a36,1,Tim Armstrong,2018-02-23 04:17:41+00:00,['5699b59d0c5cbe37e888a367adb42fa12dfb0916'],1545,3204,4749,5680382,73,0.287671233,0.760273973,0.54109589,4584
ff3ddb51a49dcd38da2e0d1a09a1cc9405649f40,1,Impala Public Jenkins,2018-02-23 04:22:28+00:00,['24b4ed0b29a44090350e630d625291c01b753a36'],111,304,415,5680797,10,0.221428571,0.357142857,0.907142857,4584
ad7cbc94e2099e0dd8f0d958602c7c46f196a72a,0,Impala Public Jenkins,2018-02-23 05:02:31+00:00,['ff3ddb51a49dcd38da2e0d1a09a1cc9405649f40'],9,7,16,5680813,1,,,,4584
152cf8b54d155cd4699b96f6fa83190f6ac9e9aa,0,Impala Public Jenkins,2018-02-23 06:58:40+00:00,['ad7cbc94e2099e0dd8f0d958602c7c46f196a72a'],9,19,28,5680841,4,0,1,0.333333333,4584
d91df9b63fa1fc8a907fc28e5db53b8eb275e8f3,1,Impala Public Jenkins,2018-02-23 07:19:07+00:00,['152cf8b54d155cd4699b96f6fa83190f6ac9e9aa'],54,109,163,5681004,10,0.214285714,1,0.910714286,4584
1765a44da00401298a6367a2885996f4b12a5e3b,0,Impala Public Jenkins,2018-02-23 10:49:28+00:00,['d91df9b63fa1fc8a907fc28e5db53b8eb275e8f3'],20,30,50,5681054,2,1,1,1,4584
ad91e0b04cedb84b5b08c810de4ab1a5555ef036,1,Alex Behm,2018-02-23 21:16:27+00:00,['1765a44da00401298a6367a2885996f4b12a5e3b'],1,24,25,5681079,2,1,1,1,4584
7112d05e5c95905613aa08d5bf7ff7fc20a402bc,0,Impala Public Jenkins,2018-02-24 01:55:51+00:00,['ad91e0b04cedb84b5b08c810de4ab1a5555ef036'],1,1,2,5681081,1,,,,4584
0f33370b8b6a69ec1ae4c3df048394bd0ff0cc5f,0,Impala Public Jenkins,2018-02-24 03:59:18+00:00,['7112d05e5c95905613aa08d5bf7ff7fc20a402bc'],4,4,8,5681089,1,,,,4584
9f3c73ddbecd6eed3aa4207d58d848eef5684b2a,1,Impala Public Jenkins,2018-02-24 22:04:15+00:00,['0f33370b8b6a69ec1ae4c3df048394bd0ff0cc5f'],7,14,21,5681110,1,0,1,1,4584
fd66890bf1933e708e88939d053b8708d1acaabe,0,Impala Public Jenkins,2018-02-25 03:04:58+00:00,['9f3c73ddbecd6eed3aa4207d58d848eef5684b2a'],4,9,13,5681123,1,0,0.5,0,4584
46f74df0ad055737a8a088d9aed16617a6d9052e,1,Impala Public Jenkins,2018-02-26 00:32:10+00:00,['fd66890bf1933e708e88939d053b8708d1acaabe'],23,53,76,5681199,3,0.066666667,0.533333333,0.6,4584
93e7a72dba3476c29d27e92a8f5022df25c0c477,1,Impala Public Jenkins,2018-02-26 23:08:54+00:00,['46f74df0ad055737a8a088d9aed16617a6d9052e'],11,126,137,5681336,4,0.369230769,0.323076923,0.830769231,4584
83ac412cc1a5a702ae08d234fc813db0ba42db62,1,Impala Public Jenkins,2018-02-27 07:40:47+00:00,['93e7a72dba3476c29d27e92a8f5022df25c0c477'],65,113,178,5681514,10,0,0.421052632,0.421052632,4584
5464c09786b6207507d8ebdbc1f0275f007c08e3,0,Impala Public Jenkins,2018-02-27 08:34:36+00:00,['83ac412cc1a5a702ae08d234fc813db0ba42db62'],6,17,23,5681537,1,0,1,1,4584
881600c070055a3b30855ed537a9632a7a36cab0,0,Impala Public Jenkins,2018-02-27 08:51:21+00:00,['5464c09786b6207507d8ebdbc1f0275f007c08e3'],3,3,6,5681543,1,,,,4584
61ca7be6ec6da060b0f1a03725be6bff17b51146,1,Impala Public Jenkins,2018-02-27 11:43:10+00:00,['881600c070055a3b30855ed537a9632a7a36cab0'],2,7,9,5681552,1,0,0,0,4584
065974ccc5dad26794610dc81617c71a2b3e9911,0,Impala Public Jenkins,2018-02-27 22:29:32+00:00,['61ca7be6ec6da060b0f1a03725be6bff17b51146'],24,25,49,5681601,2,0.5,1,1,4584
4c8b02ffc43e8346440a45f6fee7b2b761a006fd,1,Impala Public Jenkins,2018-02-28 01:17:29+00:00,['065974ccc5dad26794610dc81617c71a2b3e9911'],11,53,64,5681665,4,0,1,0.608695652,4584
d57fbec6f67b83227b4c6117476da8f7d75fc4f6,0,Impala Public Jenkins,2018-02-28 01:45:57+00:00,['4c8b02ffc43e8346440a45f6fee7b2b761a006fd'],6,14,20,5681685,5,0.166666667,0.333333333,1,4584
6f2d90524757188bdb1dcc4fd6427aa193402b5c,0,Impala Public Jenkins,2018-02-28 21:28:20+00:00,['d57fbec6f67b83227b4c6117476da8f7d75fc4f6'],3,2,5,5681690,2,,,,4584
6ec44eafda648b76832ce919d951661a4a9d928b,0,Impala Public Jenkins,2018-02-28 22:56:35+00:00,['6f2d90524757188bdb1dcc4fd6427aa193402b5c'],13,23,36,5681726,3,1,1,1,4584
cf5ef7f70983747103ca2d5052a9a61f7eb4b349,0,Impala Public Jenkins,2018-02-28 23:04:54+00:00,['6ec44eafda648b76832ce919d951661a4a9d928b'],1,77,78,5681804,5,0.076923077,0.974358974,1,4584
66d222ec9df20e71c5e6ec816af17472adc6d808,1,Impala Public Jenkins,2018-03-01 22:56:07+00:00,['cf5ef7f70983747103ca2d5052a9a61f7eb4b349'],6,9,15,5681819,3,0,0,1,4584
efd85cdd851ff7fa8bb6c7802a3affb55a011c6e,0,Impala Public Jenkins,2018-03-02 03:26:07+00:00,['66d222ec9df20e71c5e6ec816af17472adc6d808'],47,60,107,5681926,7,0,,0,4584
25bcb258dfd712f1514cf188206667a5e6be0e26,0,Impala Public Jenkins,2018-03-02 10:34:34+00:00,['efd85cdd851ff7fa8bb6c7802a3affb55a011c6e'],1,1,2,5681928,1,,,,4584
7e15db644efe93e23560e836a88d5e99c202aab3,0,Impala Public Jenkins,2018-03-02 23:40:04+00:00,['25bcb258dfd712f1514cf188206667a5e6be0e26'],5,4,9,5681937,1,,,,4584
ce9ae30d7dbbe990b49dda6c5ee681f778352b3e,0,Impala Public Jenkins,2018-03-03 01:51:03+00:00,['7e15db644efe93e23560e836a88d5e99c202aab3'],0,1,1,5681938,1,,,,4584
a2c9a7c86b7aa91c010ec281fb8c657e17693974,0,Impala Public Jenkins,2018-03-03 02:12:06+00:00,['ce9ae30d7dbbe990b49dda6c5ee681f778352b3e'],0,76,76,5682014,2,,,,4584
161cbe30ff0cba70e48fe48d41e0d76ec5273264,1,Impala Public Jenkins,2018-03-03 04:22:12+00:00,['a2c9a7c86b7aa91c010ec281fb8c657e17693974'],4565,2801,7366,5689380,88,0.684848485,0.345454545,0.406060606,4584
3302abaa32cf3290cb038fbc1dbd0a821f5cbbc7,0,Impala Public Jenkins,2018-03-05 02:56:14+00:00,['161cbe30ff0cba70e48fe48d41e0d76ec5273264'],3,6,9,5689389,1,0,1,1,4584
3b72a6c0dac537192ed939bb6370199179c67c88,1,Impala Public Jenkins,2018-03-05 08:57:40+00:00,['3302abaa32cf3290cb038fbc1dbd0a821f5cbbc7'],26,25,51,5689440,8,,,,4584
9f9932d70ba4746d87f357e68645b0b0279cc7fd,0,Impala Public Jenkins,2018-03-05 18:42:06+00:00,['3b72a6c0dac537192ed939bb6370199179c67c88'],4,12,16,5689456,1,,,,4584
77d07f80671e7605da20f23a58ae0e93847db37d,0,Impala Public Jenkins,2018-03-05 21:31:12+00:00,['9f9932d70ba4746d87f357e68645b0b0279cc7fd'],263,0,263,5689719,7,,,,4584
3a1d802eada1b4ab77f5fe1a95fc6e8d2a02d0f4,1,Impala Public Jenkins,2018-03-06 00:48:00+00:00,['77d07f80671e7605da20f23a58ae0e93847db37d'],10,38,48,5689767,2,,,,4584
5f2f445e7d29ed26f6818b5c41edda2fe7c49b59,0,Impala Public Jenkins,2018-03-06 00:53:30+00:00,['3a1d802eada1b4ab77f5fe1a95fc6e8d2a02d0f4'],1,1,2,5689769,1,,,,4584
b0027575cbce7002ff867750e955ff3ecd3b1bcd,0,Impala Public Jenkins,2018-03-06 03:29:47+00:00,['5f2f445e7d29ed26f6818b5c41edda2fe7c49b59'],15,57,72,5689841,5,0,0,1,4584
7376ca29b43bfc3e68f6730c9527a97c688b7e38,0,Tim Armstrong,2018-03-06 16:12:05+00:00,['b0027575cbce7002ff867750e955ff3ecd3b1bcd'],6,24,30,5689871,5,0.8,0,0.8,4584
994272b684f1f04a4f27844aa9066e423615a28f,0,Lars Volker,2018-03-06 23:39:36+00:00,['7376ca29b43bfc3e68f6730c9527a97c688b7e38'],5,4,9,5689880,1,,,,4584
8dcff3aa41e7f252aa27c6ab1275712103ed5d2c,0,Impala Public Jenkins,2018-03-07 03:03:29+00:00,['994272b684f1f04a4f27844aa9066e423615a28f'],1,48,49,5689929,2,0,0,1,4584
772afb03695acb3f8b07cf1665458146f9fe7f47,0,Lars Volker,2018-03-07 20:53:49+00:00,['8dcff3aa41e7f252aa27c6ab1275712103ed5d2c'],1,1,2,5689931,1,,,,4584
dd0883479384a76c6d29f0f7501c9400d0307644,0,Impala Public Jenkins,2018-03-07 21:37:02+00:00,['772afb03695acb3f8b07cf1665458146f9fe7f47'],25,44,69,5690000,2,0.181818182,0.727272727,0.727272727,4584
474f64079b85fb8cfe8b2369aa11733b5d767897,0,Impala Public Jenkins,2018-03-07 22:06:39+00:00,['dd0883479384a76c6d29f0f7501c9400d0307644'],2,5,7,5690007,2,0,1,1,4584
8b7f27af8ffc63f1280d3c092d6949a767c477b1,1,Impala Public Jenkins,2018-03-08 02:14:08+00:00,['474f64079b85fb8cfe8b2369aa11733b5d767897'],30,37,67,5690074,6,0.142857143,0.857142857,1,4584
73e90d237e5d0c59a06480b769e2dddf6891b49f,0,Impala Public Jenkins,2018-03-08 04:48:36+00:00,['8b7f27af8ffc63f1280d3c092d6949a767c477b1'],48,138,186,5690260,10,1,1,0.607142857,4587
38cbff33e1b82c3ca497cf147223f0da3b5bce13,0,Impala Public Jenkins,2018-03-08 06:48:45+00:00,['73e90d237e5d0c59a06480b769e2dddf6891b49f'],1,4,5,5690265,1,0,1,1,4587
5d044e0cb201d975bc2af478501bd968407e1962,0,Impala Public Jenkins,2018-03-08 07:34:41+00:00,['38cbff33e1b82c3ca497cf147223f0da3b5bce13'],17,90,107,5690372,3,1,1,1,4587
b50aaff399d8da368c992217d35d42083444357a,1,Impala Public Jenkins,2018-03-08 09:52:55+00:00,['5d044e0cb201d975bc2af478501bd968407e1962'],6,19,25,5690397,1,1,1,0,4587
2186c692ee2c66ae64375592de073f0f0993b121,1,Impala Public Jenkins,2018-03-08 11:37:09+00:00,['b50aaff399d8da368c992217d35d42083444357a'],2,8,10,5690407,2,0,1,1,4587
778823c09eacb771db96239b00768be9aeb48681,0,Impala Public Jenkins,2018-03-08 23:29:30+00:00,['2186c692ee2c66ae64375592de073f0f0993b121'],4,11,15,5690422,1,,,,4587
35d459479edfda3601afa0ed2e9985de58bedbe5,0,Impala Public Jenkins,2018-03-09 00:00:18+00:00,['778823c09eacb771db96239b00768be9aeb48681'],19,19,38,5690460,1,,,1,4587
c3b6b55a261eceeaccac1b8e2730c97af66da984,0,Impala Public Jenkins,2018-03-09 00:57:38+00:00,['35d459479edfda3601afa0ed2e9985de58bedbe5'],5,14,19,5690479,1,,,,4587
bbf929a1ece739164ba1cc0bc00afc1a685c923e,1,Impala Public Jenkins,2018-03-09 02:27:12+00:00,['c3b6b55a261eceeaccac1b8e2730c97af66da984'],603,51,654,5691133,6,0.857605178,0.566343042,0.022653722,4587
c7a58b8a7374b7cb1aacf6024deb861c79fe5a14,1,Impala Public Jenkins,2018-03-09 22:54:47+00:00,['bbf929a1ece739164ba1cc0bc00afc1a685c923e'],8,14,22,5691155,1,,,,4587
e096233a25d65c1078a153630547f9551f1cf15e,0,Impala Public Jenkins,2018-03-09 23:37:57+00:00,['c7a58b8a7374b7cb1aacf6024deb861c79fe5a14'],0,208,208,5691363,3,,,,4588
4e12ba6ba563510addad3e2766aa32188b1e5ea9,1,Impala Public Jenkins,2018-03-10 00:42:36+00:00,['e096233a25d65c1078a153630547f9551f1cf15e'],24,25,49,5691412,6,1,1,0,4588
6c264d8eb8b0973bc50fe32c0a18f6c011a00028,0,Impala Public Jenkins,2018-03-10 01:31:13+00:00,['4e12ba6ba563510addad3e2766aa32188b1e5ea9'],0,8,8,5691420,1,,,,4588
d3c115ae9aefac6317a2b9b96745702c43bce804,0,Impala Public Jenkins,2018-03-10 01:33:03+00:00,['6c264d8eb8b0973bc50fe32c0a18f6c011a00028'],5,6,11,5691431,1,0,0,0,4588
532a0d7afcb56217d2aae45c1c97890d6788251b,0,Impala Public Jenkins,2018-03-12 21:53:10+00:00,['d3c115ae9aefac6317a2b9b96745702c43bce804'],1,5,6,5691437,1,0,1,1,4588
077f94a82b86fddd9daecb7d173009ab5d351deb,1,Impala Public Jenkins,2018-03-12 22:31:01+00:00,['532a0d7afcb56217d2aae45c1c97890d6788251b'],30,104,134,5691571,5,0,0.88,0.92,4588
8e1bf0e99a0e6faacf01256c93bc90cfb51af09a,1,Impala Public Jenkins,2018-03-13 00:39:38+00:00,['077f94a82b86fddd9daecb7d173009ab5d351deb'],3,13,16,5691587,2,,,,4588
8283081bf089b7ec61ce7c28f4e91e9acd157980,0,Impala Public Jenkins,2018-03-13 02:01:15+00:00,['8e1bf0e99a0e6faacf01256c93bc90cfb51af09a'],17,104,121,5691708,7,1,1,0.533333333,4588
3839826e69e9dff2062464f7eb1bdfed66ca7702,0,Impala Public Jenkins,2018-03-13 02:40:07+00:00,['8283081bf089b7ec61ce7c28f4e91e9acd157980'],24,37,61,5691769,1,,,,4588
6d8ce64020ac8a103f03814c2903f6c5835886c0,0,Impala Public Jenkins,2018-03-13 20:31:43+00:00,['3839826e69e9dff2062464f7eb1bdfed66ca7702'],0,35,35,5691804,3,0,0,0.166666667,4588
0d7787fe4df1ab2bb8231b0ee0912e3cf2787f9e,1,Impala Public Jenkins,2018-03-13 22:10:18+00:00,['6d8ce64020ac8a103f03814c2903f6c5835886c0'],7,398,405,5692209,7,0.140969163,0.581497797,0.881057269,4590
8079cd9d2a87051f81a41910b74fab15e35f36ea,0,Impala Public Jenkins,2018-03-13 22:20:39+00:00,['0d7787fe4df1ab2bb8231b0ee0912e3cf2787f9e'],1,84,85,5692294,4,0,1,0.942307692,4590
0d95d3a03c3f82313169058950f9b6d926bad859,1,Impala Public Jenkins,2018-03-14 01:45:34+00:00,['8079cd9d2a87051f81a41910b74fab15e35f36ea'],67,324,391,5692685,13,0.010869565,0,0.293478261,4590
ccd0d51faa50d84169887e769772f08be1410b78,1,Impala Public Jenkins,2018-03-14 01:59:12+00:00,['0d95d3a03c3f82313169058950f9b6d926bad859'],6,45,51,5692736,2,0.173913043,0.956521739,0.130434783,4590
03794389fc0ba747a9f1c32793a29228f6c90280,1,Impala Public Jenkins,2018-03-14 21:38:06+00:00,['ccd0d51faa50d84169887e769772f08be1410b78'],22157,108,22265,5715001,52,0.142857143,0,0.142857143,4590
6a07076de39645dd39b5d752cb7b3643f6b8e696,0,Impala Public Jenkins,2018-03-15 00:38:17+00:00,['03794389fc0ba747a9f1c32793a29228f6c90280'],329,3834,4163,5719164,1,,,,4590
34fdc59079988569084d1ae58cd492550dffcd70,0,Impala Public Jenkins,2018-03-15 01:04:57+00:00,['6a07076de39645dd39b5d752cb7b3643f6b8e696'],1,78,79,5719243,2,,,,4590
45aee121eb95505396c63f08c48f2cd0e0182e41,1,Impala Public Jenkins,2018-03-15 01:32:14+00:00,['34fdc59079988569084d1ae58cd492550dffcd70'],14,3,17,5719260,1,,,,4590
42abe8139ebb16f3284328c8f028b47ae86ab78a,0,Impala Public Jenkins,2018-03-15 02:00:46+00:00,['45aee121eb95505396c63f08c48f2cd0e0182e41'],227,225,452,5719712,8,1,0.5,0.9,4590
6c166bf015b67b71375850f6c816e53366919b72,0,Impala Public Jenkins,2018-03-15 02:13:42+00:00,['42abe8139ebb16f3284328c8f028b47ae86ab78a'],49,56,105,5719817,1,1,1,1,4590
69f6bfd85c7a243d40f930b9b713001ff0744f5d,0,Impala Public Jenkins,2018-03-15 03:45:16+00:00,['6c166bf015b67b71375850f6c816e53366919b72'],15,15,30,5719847,3,,,,4590
241031d339a7a78ccc75f5c6c6146028bb9c76db,1,Impala Public Jenkins,2018-03-15 19:50:54+00:00,['69f6bfd85c7a243d40f930b9b713001ff0744f5d'],94,215,309,5720156,3,0.266666667,0.626666667,0.266666667,4590
b5b207eefaf8160c6e17704a883f80c313de7b0b,0,Impala Public Jenkins,2018-03-16 01:48:41+00:00,['241031d339a7a78ccc75f5c6c6146028bb9c76db'],5,27,32,5720188,1,,,,4590
8dde41e802e3566d07e2db7b2bf5cd76030ab3d3,1,Impala Public Jenkins,2018-03-16 03:39:33+00:00,['b5b207eefaf8160c6e17704a883f80c313de7b0b'],18,30,48,5720236,1,0.75,0.916666667,0,4590
0532ff97c80aad08e800fede78348653e57a872f,0,Impala Public Jenkins,2018-03-16 08:20:40+00:00,['8dde41e802e3566d07e2db7b2bf5cd76030ab3d3'],2,1,3,5720239,1,1,1,0,4590
b62ecb6795cca22a6641f10d00d097c4957aa5fc,0,Impala Public Jenkins,2018-03-16 16:36:14+00:00,['0532ff97c80aad08e800fede78348653e57a872f'],9,11,20,5720259,3,,,,4590
2f508183cb4dfefe1c67bf8c1988f350700763fe,0,Impala Public Jenkins,2018-03-16 19:12:46+00:00,['b62ecb6795cca22a6641f10d00d097c4957aa5fc'],6,6,12,5720271,2,,,,4590
41a516f949223a090bf4e2702993d760c3fa87d5,1,Impala Public Jenkins,2018-03-16 19:28:37+00:00,['2f508183cb4dfefe1c67bf8c1988f350700763fe'],1,29,30,5720301,5,0.666666667,0.666666667,0.833333333,4590
af6769d95a35f66af191a54e676401411b766988,0,Impala Public Jenkins,2018-03-17 01:32:22+00:00,['41a516f949223a090bf4e2702993d760c3fa87d5'],1,1,2,5720303,1,,,,4590
e148c1a7c3cf67e84cb6be736ed709dd683b7188,0,Impala Public Jenkins,2018-03-17 02:52:19+00:00,['af6769d95a35f66af191a54e676401411b766988'],4,50,54,5720357,6,0.916666667,0.916666667,0.083333333,4592
5c8da5d13a0fc1289428aad2a5e207b2c5b0fc8e,0,Impala Public Jenkins,2018-03-17 04:08:53+00:00,['e148c1a7c3cf67e84cb6be736ed709dd683b7188'],8,8,16,5720373,4,,,,4592
b1ef7de0e75b50f6268d73114938ed94d03ad939,1,Lars Volker,2018-03-18 16:39:32+00:00,['5c8da5d13a0fc1289428aad2a5e207b2c5b0fc8e'],1,2,3,5720376,2,,,,4592
4fbe4cb208c3d5a044fc64f151d496475524eda9,0,Lars Volker,2018-03-18 23:31:17+00:00,['b1ef7de0e75b50f6268d73114938ed94d03ad939'],1,2,3,5720379,1,,,,4592
e6aadc9c35c0a5adfde7c888dd349c46752764e1,1,Impala Public Jenkins,2018-03-20 06:47:30+00:00,['4fbe4cb208c3d5a044fc64f151d496475524eda9'],0,5,5,5720384,1,0,0,1,4592
1d38c584aef2d0f852af8ee659157d00eb3b061a,1,Impala Public Jenkins,2018-03-20 20:37:35+00:00,['e6aadc9c35c0a5adfde7c888dd349c46752764e1'],51,204,255,5720639,10,0.067307692,0.75,1,4592
3d65f856f765caa9d87e569373d191f323d94a96,1,Impala Public Jenkins,2018-03-21 00:40:10+00:00,['1d38c584aef2d0f852af8ee659157d00eb3b061a'],192,700,892,5721531,4,0,0,1,4592
d7c8902dc8f66be38f97cf4d6caae62f80ffd372,0,Impala Public Jenkins,2018-03-21 03:20:26+00:00,['3d65f856f765caa9d87e569373d191f323d94a96'],1,27,28,5721559,3,0,1,1,4592
be2e226a6c6ac11af697cce159e6e0ddbbe21de0,0,Impala Public Jenkins,2018-03-21 06:44:39+00:00,['d7c8902dc8f66be38f97cf4d6caae62f80ffd372'],1,7,8,5721567,1,1,1,1,4592
c38a3a0307174e88d53fad4f202095f768c61dc7,0,Impala Public Jenkins,2018-03-21 17:04:49+00:00,['be2e226a6c6ac11af697cce159e6e0ddbbe21de0'],16,16,32,5721599,1,,,,4592
644af57b564560e383ebae361bfbc9036f4c1aa0,0,Impala Public Jenkins,2018-03-21 17:50:35+00:00,['c38a3a0307174e88d53fad4f202095f768c61dc7'],1,1,2,5721601,1,,,,4592
8db3fb2cc7107968c7b3d9c36746d1868efc8407,0,Impala Public Jenkins,2018-03-21 20:14:02+00:00,['644af57b564560e383ebae361bfbc9036f4c1aa0'],53,37,90,5721691,4,0,0,0,4592
595421e77d17eeeacaf15a5e4d7314c7026958c1,0,Impala Public Jenkins,2018-03-21 20:31:36+00:00,['8db3fb2cc7107968c7b3d9c36746d1868efc8407'],88,624,712,5722403,17,0.890804598,1,0.465517241,4598
d972614881e064335fd6df0ca9bbc9220c0cb8f7,0,Impala Public Jenkins,2018-03-21 20:34:22+00:00,['595421e77d17eeeacaf15a5e4d7314c7026958c1'],1,1,2,5722405,1,,,,4598
2c1fbecc9f1302efab597c827976a944927af649,1,Impala Public Jenkins,2018-03-21 20:45:48+00:00,['d972614881e064335fd6df0ca9bbc9220c0cb8f7'],5,24,29,5722434,4,0,0.615384615,0.846153846,4598
da3617899c7c7eb8ef7f4355b1c47b22ea8ca28a,0,Impala Public Jenkins,2018-03-21 22:19:00+00:00,['2c1fbecc9f1302efab597c827976a944927af649'],0,18,18,5722452,3,0,1,1,4598
c9cb5935eebfe959ee3770050bebae1f45ed3594,0,Impala Public Jenkins,2018-03-21 23:14:42+00:00,['da3617899c7c7eb8ef7f4355b1c47b22ea8ca28a'],1,1,2,5722454,1,,,,4598
d03b66ca3550a525282e33a8002f4bbdc9a2cb60,0,Impala Public Jenkins,2018-03-22 00:41:16+00:00,['c9cb5935eebfe959ee3770050bebae1f45ed3594'],10,19,29,5722483,1,,,,4598
588e1d46e9bd88d17676c47a0bf1237d3ebb11da,1,Impala Public Jenkins,2018-03-22 02:47:33+00:00,['d03b66ca3550a525282e33a8002f4bbdc9a2cb60'],53,331,384,5722867,10,0.595744681,0.787234043,0.482269504,4601
4e4cbc6a72948acdb52919a97ae761a003d40169,0,Impala Public Jenkins,2018-03-22 03:12:56+00:00,['588e1d46e9bd88d17676c47a0bf1237d3ebb11da'],0,3,3,5722870,1,0,1,1,4601
942de7219bfeccb4db7dcb46ba30c80f2870bb19,0,Impala Public Jenkins,2018-03-22 10:27:08+00:00,['4e4cbc6a72948acdb52919a97ae761a003d40169'],38,135,173,5723043,17,0,0.781818182,0.781818182,4601
08b60a15cc9548487e1d62ecefde7672a20a8487,1,Impala Public Jenkins,2018-03-22 10:58:40+00:00,['942de7219bfeccb4db7dcb46ba30c80f2870bb19'],3,17,20,5723063,2,0.75,0.75,0.75,4601
466d1266fde76534affe0a0e6ff2b5f2c538ab3e,0,Impala Public Jenkins,2018-03-23 19:50:23+00:00,['08b60a15cc9548487e1d62ecefde7672a20a8487'],2,3,5,5723068,1,0,0,0,4601
783de170c934be52109eccd88aac91e5a017e1ce,1,Impala Public Jenkins,2018-03-23 20:56:00+00:00,['466d1266fde76534affe0a0e6ff2b5f2c538ab3e'],647,1835,2482,5725550,54,0.313291139,0.560126582,0.71835443,4613
2894884deb713bd5225086391be11c3f7150fdd6,1,Impala Public Jenkins,2018-03-24 04:38:53+00:00,['783de170c934be52109eccd88aac91e5a017e1ce'],83,440,523,5726073,22,0.282178218,0.905940594,0.811881188,4613
8fec1911e52e40aff4cc1de17265bd6803cb13f5,0,Impala Public Jenkins,2018-03-24 04:43:01+00:00,['2894884deb713bd5225086391be11c3f7150fdd6'],69,111,180,5726253,7,0.054054054,1,0.945945946,4613
ef589727b998169a066b239811fa62f0ecff911b,1,Impala Public Jenkins,2018-03-24 22:04:22+00:00,['8fec1911e52e40aff4cc1de17265bd6803cb13f5'],42,176,218,5726471,13,0.049382716,0.975308642,1,4613
52a2996100c10d05173c60e0f3b690dcd952c50d,1,Impala Public Jenkins,2018-03-26 19:49:43+00:00,['ef589727b998169a066b239811fa62f0ecff911b'],16,53,69,5726540,2,0,0.483870968,0.580645161,4613
cd939a2415077781d4fee258257f097eaa68cf4a,1,Impala Public Jenkins,2018-03-26 22:26:12+00:00,['52a2996100c10d05173c60e0f3b690dcd952c50d'],26,87,113,5726653,4,0.2,0.2,1,4614
66e5a1212aaab387035a4cce2b1d233a15fdb287,0,Impala Public Jenkins,2018-03-26 22:40:44+00:00,['cd939a2415077781d4fee258257f097eaa68cf4a'],67,84,151,5726804,6,0,1,1,4614
37565e38128173798223b363593228a915bd7beb,1,Lars Volker,2018-03-26 22:45:03+00:00,['66e5a1212aaab387035a4cce2b1d233a15fdb287'],15,71,86,5726890,5,1,1,0.3,4615
fc1eb75da0aadd82597ca63d089c1a218b94f9f9,0,Impala Public Jenkins,2018-03-27 02:22:24+00:00,['37565e38128173798223b363593228a915bd7beb'],0,10,10,5726900,3,0,1,1,4615
7263c33ea7adabf0c1cc876681a9b8b6b5a2f5f8,0,Impala Public Jenkins,2018-03-27 04:04:28+00:00,['fc1eb75da0aadd82597ca63d089c1a218b94f9f9'],4,4,8,5726908,4,,,,4615
ee1b0fccf24ae5858b0670bbb625fa3b9e066d1c,1,Impala Public Jenkins,2018-03-27 09:34:32+00:00,['7263c33ea7adabf0c1cc876681a9b8b6b5a2f5f8'],113,149,262,5727170,7,0,1,0,4615
b5dcc031f75b2faff00d29616d83feedcb91c812,0,Impala Public Jenkins,2018-03-27 18:39:33+00:00,['ee1b0fccf24ae5858b0670bbb625fa3b9e066d1c'],29,0,29,5727199,2,,,,4615
5d57ca5da2a7ddbe7816dce19db4c11b87a90d37,0,Impala Public Jenkins,2018-03-27 20:00:38+00:00,['b5dcc031f75b2faff00d29616d83feedcb91c812'],1,17,18,5727217,1,,,,4615
61b7808dfe5ad52d8e07a63e8f7d79438c225944,1,Impala Public Jenkins,2018-03-27 22:02:12+00:00,['5d57ca5da2a7ddbe7816dce19db4c11b87a90d37'],22,69,91,5727308,1,1,0.176470588,0.882352941,4615
4851b03deb7f145cf1378320e3fb82719d82e587,0,Impala Public Jenkins,2018-03-27 23:19:59+00:00,['61b7808dfe5ad52d8e07a63e8f7d79438c225944'],84,169,253,5727561,8,0.25,0.84375,0.9375,4615
c8ad56f1d9886712b458b12e8ebb98777a99376c,0,Impala Public Jenkins,2018-03-28 03:18:19+00:00,['4851b03deb7f145cf1378320e3fb82719d82e587'],14,61,75,5727636,2,0.555555556,1,1,4615
0812f8737a4301e5b52cad9dc911589f9e98ecdb,0,Impala Public Jenkins,2018-03-28 03:30:03+00:00,['c8ad56f1d9886712b458b12e8ebb98777a99376c'],4,2,6,5727642,1,,,,4615
bc3e4fb376c4834c96d0e7e935a211e46f9ee62b,0,Impala Public Jenkins,2018-03-28 04:14:40+00:00,['0812f8737a4301e5b52cad9dc911589f9e98ecdb'],1,1,2,5727644,1,,,,4615
4a39e7c29f7b910c9ae0d622b355e9362c17aaec,1,Impala Public Jenkins,2018-03-28 04:25:27+00:00,['bc3e4fb376c4834c96d0e7e935a211e46f9ee62b'],123,131,254,5727898,26,0.428571429,0.714285714,0.642857143,4615
ccad17b06678d28866dd34179ef31528e9736eed,0,Impala Public Jenkins,2018-03-28 07:49:55+00:00,['4a39e7c29f7b910c9ae0d622b355e9362c17aaec'],7,7,14,5727912,1,,,,4615
421af4e40a862e6fb9184520ee64b4c86b77f7e2,1,Impala Public Jenkins,2018-03-28 19:21:46+00:00,['ccad17b06678d28866dd34179ef31528e9736eed'],135,278,413,5728325,10,0.381818182,0.890909091,0.727272727,4615
84e30700f1a510e53bda852ec498fcc2690426d8,1,Impala Public Jenkins,2018-03-28 21:21:36+00:00,['421af4e40a862e6fb9184520ee64b4c86b77f7e2'],6,104,110,5728435,2,0,0.784615385,1,4615
25218487533f6bf6959c32ff4ee38b77e0ab30b5,0,Michael Brown,2018-03-28 15:27:10-07:00,['84e30700f1a510e53bda852ec498fcc2690426d8'],3,9,12,5728447,3,0,0,1,4615
2c0926e2de22ecafafc460f2b31ca2423b8f7e98,1,Michael Brown,2018-03-28 15:28:48-07:00,['25218487533f6bf6959c32ff4ee38b77e0ab30b5'],9,3,12,5728459,3,1,1,0,4615
2883c9950026db74240a69ab07e867810b8547b0,0,Impala Public Jenkins,2018-03-29 00:12:18+00:00,['2c0926e2de22ecafafc460f2b31ca2423b8f7e98'],0,620,620,5729079,5,0.414012739,0.573248408,0.891719745,4619
77efb2820e62f8066c2ee00593bd5deeb9f7d9a6,0,Impala Public Jenkins,2018-03-29 01:40:06+00:00,['2883c9950026db74240a69ab07e867810b8547b0'],1,1,2,5729081,1,,,,4619
4028e9c5ec66fe006d26f8ca5f13daaf474dffbb,1,Impala Public Jenkins,2018-03-29 03:27:25+00:00,['77efb2820e62f8066c2ee00593bd5deeb9f7d9a6'],7,13,20,5729101,3,0,0,1,4619
8091b2f469a3678561e47e918ffe8db0eb5d48db,1,Impala Public Jenkins,2018-03-29 03:38:35+00:00,['4028e9c5ec66fe006d26f8ca5f13daaf474dffbb'],76,213,289,5729390,1,0.111111111,0.49382716,0.567901235,4619
2194dfd0ff63a51c1b17b1bbcd78895d0c2d6951,0,Impala Public Jenkins,2018-03-29 04:38:31+00:00,['8091b2f469a3678561e47e918ffe8db0eb5d48db'],3,3,6,5729396,2,,,,4619
b78daedf52bdaf5028bae90f157d37b6c5bea2c6,1,Zach Amsden,2018-03-29 04:59:48+00:00,['2194dfd0ff63a51c1b17b1bbcd78895d0c2d6951'],169,84,253,5729649,8,0.75,0.15625,0.0625,4619
408ee4d68cbb7217eba4b020064a1e878e412ce8,1,Impala Public Jenkins,2018-03-29 06:29:16+00:00,['b78daedf52bdaf5028bae90f157d37b6c5bea2c6'],595,750,1345,5730994,26,1,1,0,4621
1c4775d92abab73f01cc967967aebeacc4ead5de,0,Philip Zeyliger,2018-03-29 15:35:19+00:00,['408ee4d68cbb7217eba4b020064a1e878e412ce8'],1,1,2,5730996,1,,,,4621
cf4f314922f13fbf54c6d7300ceaa2229bf5916a,0,Michael Ho,2018-03-30 21:35:48+00:00,['1c4775d92abab73f01cc967967aebeacc4ead5de'],620,0,620,5731616,5,0.585987261,0.426751592,0.108280255,4621
832974383c36a4c74922e4f98b150634ab25f6ad,0,Impala Public Jenkins,2018-04-02 20:29:51+00:00,['cf4f314922f13fbf54c6d7300ceaa2229bf5916a'],0,12,12,5731628,1,,,,4621
ab5c98c28a35c67d4f4cdd1b5920df6c0242c341,0,Impala Public Jenkins,2018-04-02 21:04:07+00:00,['832974383c36a4c74922e4f98b150634ab25f6ad'],31,76,107,5731735,2,,,,4621
c3ab27681fbca613d6106567615138777f513b95,1,Impala Public Jenkins,2018-04-02 21:05:40+00:00,['ab5c98c28a35c67d4f4cdd1b5920df6c0242c341'],4,68,72,5731807,4,0.1,0.9,1,4621
08d386f0fc62e2991bcc046dde8574f25d421580,0,Impala Public Jenkins,2018-04-02 21:12:31+00:00,['c3ab27681fbca613d6106567615138777f513b95'],26,195,221,5732028,7,0.047619048,1,1,4621
36111ce885b31616fb4a10e918abc0c5f5989732,1,Impala Public Jenkins,2018-04-02 21:25:01+00:00,['08d386f0fc62e2991bcc046dde8574f25d421580'],19,184,203,5732231,7,0,0.99137931,1,4621
4f5999149938b41a98e212cc03cffc36abe54823,0,Impala Public Jenkins,2018-04-02 23:17:30+00:00,['36111ce885b31616fb4a10e918abc0c5f5989732'],1,1,2,5732233,1,,,,4621
5a78a30d1e49ca6289a666bc62a5af544224af90,0,Impala Public Jenkins,2018-04-03 00:36:26+00:00,['4f5999149938b41a98e212cc03cffc36abe54823'],57,54,111,5732344,1,,,,4621
a026f265a260462015d90ad3d3be7686d8486865,0,Impala Public Jenkins,2018-04-03 01:06:01+00:00,['5a78a30d1e49ca6289a666bc62a5af544224af90'],1,35,36,5732380,2,1,1,1,4622
89b29d3a89cca041c541476e25435dc0d34344c1,0,Impala Public Jenkins,2018-04-03 02:09:09+00:00,['a026f265a260462015d90ad3d3be7686d8486865'],0,26,26,5732406,1,,,,4622
d478c492bd4e1bac4ab84d63eafb788940e49d53,0,Alex Behm,2018-04-03 08:05:22+00:00,['89b29d3a89cca041c541476e25435dc0d34344c1'],23,23,46,5732452,1,,,,4622
ba3e5870363603076ca96d19914b074e9a618a75,0,Impala Public Jenkins,2018-04-03 19:45:00+00:00,['d478c492bd4e1bac4ab84d63eafb788940e49d53'],11,38,49,5732501,1,,,,4622
0733c8c4054397db7cf10b911f8c5594508d5d28,0,Impala Public Jenkins,2018-04-03 21:20:44+00:00,['ba3e5870363603076ca96d19914b074e9a618a75'],0,10,10,5732511,2,0.333333333,1,1,4622
6b18b00310fbdae64bc3d8aec0b58385884fe76f,1,Impala Public Jenkins,2018-04-03 21:41:56+00:00,['0733c8c4054397db7cf10b911f8c5594508d5d28'],6,13,19,5732530,1,0,0,1,4622
c55c52b17432d5136ad6342686d32c8d969f61bf,0,Impala Public Jenkins,2018-04-03 22:52:24+00:00,['6b18b00310fbdae64bc3d8aec0b58385884fe76f'],16,6,22,5732552,2,,,,4622
cf76953cc6cd1e464ff403089498a3ab55c12847,0,Tim Armstrong,2018-04-03 23:45:03+00:00,['c55c52b17432d5136ad6342686d32c8d969f61bf'],1,131,132,5732684,2,,,,4623
8173e9ab4d8c7e1ad6875e7696ea347c6a604d9a,1,Impala Public Jenkins,2018-04-04 00:12:30+00:00,['cf76953cc6cd1e464ff403089498a3ab55c12847'],29,33,62,5732746,4,0,0,1,4623
f33431dc4c5f53fb46a6392d61c858f7818b068c,0,Impala Public Jenkins,2018-04-04 00:55:23+00:00,['8173e9ab4d8c7e1ad6875e7696ea347c6a604d9a'],11,42,53,5732799,3,,,,4623
e279f0f250cb2616e8774662e6a08150851c7f67,0,Impala Public Jenkins,2018-04-04 00:55:57+00:00,['f33431dc4c5f53fb46a6392d61c858f7818b068c'],5,48,53,5732852,3,,,,4623
4c1f0ac6c8938bfcfafb3f1e70df06c960a5db56,0,Impala Public Jenkins,2018-04-04 01:48:24+00:00,['e279f0f250cb2616e8774662e6a08150851c7f67'],7,20,27,5732879,2,,,,4623
890bd4c72babef838bf00b71d62ac9605719e897,1,Impala Public Jenkins,2018-04-04 18:58:42+00:00,['4c1f0ac6c8938bfcfafb3f1e70df06c960a5db56'],5,37,42,5732921,3,0,0.833333333,0.833333333,4623
7e8c9281d7e607b7db80a6670195b7861ab34005,0,Impala Public Jenkins,2018-04-04 20:59:52+00:00,['890bd4c72babef838bf00b71d62ac9605719e897'],1,1,2,5732923,1,,,,4623
b80a75f07bd0b6b37d32b83f559a6794033c5c2e,0,Impala Public Jenkins,2018-04-04 21:26:25+00:00,['7e8c9281d7e607b7db80a6670195b7861ab34005'],16,16,32,5732955,1,,,,4623
75e1bd1bcd001770511247f2a762d9e74f38ce4f,0,Impala Public Jenkins,2018-04-04 21:51:29+00:00,['b80a75f07bd0b6b37d32b83f559a6794033c5c2e'],1,14,15,5732970,2,0,1,1,4623
c9f4fdc6bc7145bb3fcfe88f15bbdf77656cdab5,1,Impala Public Jenkins,2018-04-04 22:05:20+00:00,['75e1bd1bcd001770511247f2a762d9e74f38ce4f'],32,159,191,5733161,11,0,0.988372093,1,4623
4d6b07f0e2d18c8f5284d27b82bcee3aa9f1fe77,1,Impala Public Jenkins,2018-04-05 02:17:10+00:00,['c9f4fdc6bc7145bb3fcfe88f15bbdf77656cdab5'],9,25,34,5733195,1,0,0,0,4623
58ee5ecadf2b389fe47dc87085a7d63b4c364e26,0,Impala Public Jenkins,2018-04-05 03:47:54+00:00,['4d6b07f0e2d18c8f5284d27b82bcee3aa9f1fe77'],37,37,74,5733269,11,0,,0,4623
8e5f923158b73204329f17e01bf66ad17059b0e1,1,Impala Public Jenkins,2018-04-05 06:54:53+00:00,['58ee5ecadf2b389fe47dc87085a7d63b4c364e26'],1,1,2,5733271,1,,,,4623
380e17aa3cf678d4502245f12d8a77f58f4b8996,0,Zach Amsden,2018-04-05 18:42:03+00:00,['8e5f923158b73204329f17e01bf66ad17059b0e1'],86,172,258,5733529,8,0.242424242,0.848484848,0.939393939,4623
ab7afa7b4e85d0a2c3801950f529ac6d71f9dd03,0,Impala Public Jenkins,2018-04-05 23:36:00+00:00,['380e17aa3cf678d4502245f12d8a77f58f4b8996'],16,45,61,5733590,1,,,,4623
b131ee7983a787912c79e3432dd9a18f7c2fa661,0,Impala Public Jenkins,2018-04-05 23:49:56+00:00,['ab7afa7b4e85d0a2c3801950f529ac6d71f9dd03'],82,2,84,5733674,4,,,,4623
c6582b3a1545fda186ab01b087f5339433c8695a,0,Impala Public Jenkins,2018-04-06 05:03:19+00:00,['b131ee7983a787912c79e3432dd9a18f7c2fa661'],4,263,267,5733941,4,0,1,0.104545455,4623
2896b8d1275cd507fca770b67bc268bfebb747a2,1,Impala Public Jenkins,2018-04-06 06:40:07+00:00,['c6582b3a1545fda186ab01b087f5339433c8695a'],13,1467,1480,5735421,13,0.238197425,0.678111588,0.824034335,4629
d1357f5ee0dc8cbe00ee610921338e81ea7bf86d,0,Impala Public Jenkins,2018-04-09 21:39:19+00:00,['2896b8d1275cd507fca770b67bc268bfebb747a2'],1,1,2,5735423,1,,,,4629
d437f956cacc2afab72231b0d5ab8cc0d1d1d71e,0,Impala Public Jenkins,2018-04-09 21:52:57+00:00,['d1357f5ee0dc8cbe00ee610921338e81ea7bf86d'],2,3,5,5735428,1,,,,4629
2b7311af77f676d72b566fec0bc0718bbc6d0ac1,0,Impala Public Jenkins,2018-04-09 22:10:02+00:00,['d437f956cacc2afab72231b0d5ab8cc0d1d1d71e'],5,3,8,5735436,1,,,,4629
f76b1bf130df95ec3c4fb512a1117ffa8a04dafb,0,Impala Public Jenkins,2018-04-10 00:39:47+00:00,['2b7311af77f676d72b566fec0bc0718bbc6d0ac1'],0,3,3,5735439,1,,,,4629
2995be8238898660cf68cf125c4a52dea727f898,0,Impala Public Jenkins,2018-04-10 04:00:37+00:00,['f76b1bf130df95ec3c4fb512a1117ffa8a04dafb'],86,94,180,5735619,6,1,1,1,4629
65f25c767c9125bc7c2bd1a75269f82ab5709cfe,0,Impala Public Jenkins,2018-04-10 04:26:04+00:00,['2995be8238898660cf68cf125c4a52dea727f898'],4,5,9,5735628,1,1,0,0,4629
ae8097993043c603443bf4a08803fbab1ed7ece0,0,Impala Public Jenkins,2018-04-10 08:15:31+00:00,['65f25c767c9125bc7c2bd1a75269f82ab5709cfe'],2,34,36,5735664,2,0,1,1,4629
4c1538ab106ec2097927e7586e5d736010706d6a,1,Impala Public Jenkins,2018-04-10 08:28:26+00:00,['ae8097993043c603443bf4a08803fbab1ed7ece0'],87,200,287,5735951,5,0.402298851,1,0.896551724,4630
942781d80f243d36c557edb67ad828e8be5ff0d5,0,Philip Zeyliger,2018-04-10 09:17:28-07:00,['4c1538ab106ec2097927e7586e5d736010706d6a'],4,9,13,5735964,1,,,,4630
01b6995abf54954e824c6b2e06f6dc4007e28713,0,Philip Zeyliger,2018-04-10 16:21:09+00:00,['942781d80f243d36c557edb67ad828e8be5ff0d5'],9,4,13,5735977,1,,,,4630
6dc13d933b5ea9a41e584d83e95db72b9e8e19b3,1,Impala Public Jenkins,2018-04-10 20:15:30+00:00,['01b6995abf54954e824c6b2e06f6dc4007e28713'],4,9,13,5735990,1,,,,4630
830e3346f186aebc879e4ef2927e08db97143100,0,Impala Public Jenkins,2018-04-10 20:52:48+00:00,['6dc13d933b5ea9a41e584d83e95db72b9e8e19b3'],7,50,57,5736047,2,0.2,0.966666667,1,4630
27c028f0578ac5edb42ba55c2c54ab8b7c195422,0,Impala Public Jenkins,2018-04-11 02:14:28+00:00,['830e3346f186aebc879e4ef2927e08db97143100'],55,167,222,5736269,8,0.289473684,0.394736842,0.263157895,4630
2ee914d5b365c8230645fdd0604a67eff1edbeb2,1,Impala Public Jenkins,2018-04-11 02:21:48+00:00,['27c028f0578ac5edb42ba55c2c54ab8b7c195422'],72,366,438,5736707,37,0,0,0.609375,4630
d28b39afae5b8f1d621dcd2e1884c0353f1c058f,0,Impala Public Jenkins,2018-04-11 03:55:07+00:00,['2ee914d5b365c8230645fdd0604a67eff1edbeb2'],29,34,63,5736770,10,0,0,,4630
818cd8fa2721cd8205b304563b728952bffc8b2f,1,Impala Public Jenkins,2018-04-11 05:13:02+00:00,['d28b39afae5b8f1d621dcd2e1884c0353f1c058f'],307,1745,2052,5738822,62,0.205198358,0.407660739,0.651162791,4638
389860bf0dfb3d8c6204a83db0b21fe58b278130,0,Impala Public Jenkins,2018-04-11 16:18:22+00:00,['818cd8fa2721cd8205b304563b728952bffc8b2f'],10,0,10,5738832,1,,,,4638
f9a476eb41ca21763b5f632f76cefe61eea206b0,0,Impala Public Jenkins,2018-04-11 21:51:57+00:00,['389860bf0dfb3d8c6204a83db0b21fe58b278130'],84,173,257,5739089,1,,,,4638
257ae0ea0d0a0538fe0acf371127dd5f1304bc72,0,Impala Public Jenkins,2018-04-11 22:02:16+00:00,['f9a476eb41ca21763b5f632f76cefe61eea206b0'],4,8,12,5739101,1,,,,4638
242e822ae6819c5029270f58f771ee61c52b676e,0,Philip Zeyliger,2018-04-11 22:54:51+00:00,['257ae0ea0d0a0538fe0acf371127dd5f1304bc72'],5,16,21,5739122,1,0,0,0,4638
c68da03e7570b9ce9460d87532a0f020da912af4,0,Impala Public Jenkins,2018-04-12 01:25:36+00:00,['242e822ae6819c5029270f58f771ee61c52b676e'],4,13,17,5739139,1,1,1,1,4638
5bdce5a86ae81081809c7d61f02319b32f18a29d,1,Impala Public Jenkins,2018-04-12 03:30:53+00:00,['c68da03e7570b9ce9460d87532a0f020da912af4'],2,7,9,5739148,1,,,,4638
54f70b6d6960ad53355b43f704a82f1f3a457d4d,0,Tim Armstrong,2018-04-12 05:29:03+00:00,['5bdce5a86ae81081809c7d61f02319b32f18a29d'],6,7,13,5739161,2,,,,4638
15b388c5f1b87d7f1ea57ee762208fab00d6997d,0,Tim Armstrong,2018-04-12 05:30:19+00:00,['54f70b6d6960ad53355b43f704a82f1f3a457d4d'],1,9,10,5739171,1,,,,4638
ead30cff35574a25151691ab24872f6efdeea658,0,Impala Public Jenkins,2018-04-12 18:51:06+00:00,['15b388c5f1b87d7f1ea57ee762208fab00d6997d'],16,0,16,5739187,1,,,,4638
75b612ad49e962052a6dcaf931b2a302e2c30413,0,Impala Public Jenkins,2018-04-12 20:19:38+00:00,['ead30cff35574a25151691ab24872f6efdeea658'],0,15,15,5739202,1,,,,4638
318051cc21cc7fbe96886e30b3f13b90bbb7b50a,1,Impala Public Jenkins,2018-04-12 20:34:47+00:00,['75b612ad49e962052a6dcaf931b2a302e2c30413'],6,31,37,5739239,3,1,1,1,4638
4438a85a34eda96a23c01862589c89219de733fb,0,Impala Public Jenkins,2018-04-12 21:05:22+00:00,['318051cc21cc7fbe96886e30b3f13b90bbb7b50a'],20,13,33,5739272,6,0.833333333,0.166666667,0.833333333,4638
bc466c226f5f39014cf3fa2b6b88c0427ee3ec8a,0,Impala Public Jenkins,2018-04-12 21:22:34+00:00,['4438a85a34eda96a23c01862589c89219de733fb'],2,2,4,5739276,1,,,,4638
9a751f00b8a399116c12a81e130a696b01eb1ba8,1,Impala Public Jenkins,2018-04-12 22:01:35+00:00,['bc466c226f5f39014cf3fa2b6b88c0427ee3ec8a'],24,454,478,5739754,9,0.533333333,0,0.533333333,4639
5417e712f33dfb963b4646723ec173a5f3c4f49b,0,Impala Public Jenkins,2018-04-12 23:57:54+00:00,['9a751f00b8a399116c12a81e130a696b01eb1ba8'],29,179,208,5739962,3,0,1,1,4639
2dfa2611b759dc9bae6368d4a611c8ccf1daf763,1,Impala Public Jenkins,2018-04-13 00:44:04+00:00,['5417e712f33dfb963b4646723ec173a5f3c4f49b'],8,14,22,5739984,1,,,,4639
6f8f757446597ffde4d4d77ce51543f82fed0c0b,1,Impala Public Jenkins,2018-04-13 20:55:01+00:00,['2dfa2611b759dc9bae6368d4a611c8ccf1daf763'],22,44,66,5740050,4,0.214285714,1,1,4639
ffb74e7c0fb75e3062ad08451e474be59264f6a4,0,Impala Public Jenkins,2018-04-13 21:20:47+00:00,['6f8f757446597ffde4d4d77ce51543f82fed0c0b'],2,19,21,5740071,2,0.9,0.9,1,4639
16bed5c3a91d2575e1a0d3327735df15d51b5bf6,0,Impala Public Jenkins,2018-04-13 21:46:17+00:00,['ffb74e7c0fb75e3062ad08451e474be59264f6a4'],16,28,44,5740115,2,1,1,0,4639
ce09269fde901a262b9e1ce0c7259d8864c1bb3b,0,Bharath Vissapragada,2018-04-13 22:01:33+00:00,['16bed5c3a91d2575e1a0d3327735df15d51b5bf6'],0,647,647,5740762,5,0.43768997,0.589665653,0.896656535,4643
bc6c3c7447592ed2f17de41d8002207e7aee3d57,0,Impala Public Jenkins,2018-04-13 23:51:36+00:00,['ce09269fde901a262b9e1ce0c7259d8864c1bb3b'],5,1,6,5740768,1,,,,4643
d481cd4842e8d92dd77cdd7f70720ff0b696dfbb,1,Impala Public Jenkins,2018-04-14 00:16:26+00:00,['bc6c3c7447592ed2f17de41d8002207e7aee3d57'],180,398,578,5741346,4,0.090225564,0.015037594,0.84962406,4643
b4228dfd14975059b2aac68792e63007b5c4e1e2,0,Impala Public Jenkins,2018-04-14 00:28:46+00:00,['d481cd4842e8d92dd77cdd7f70720ff0b696dfbb'],360,0,360,5741706,9,,,,4643
51cf5b27fc3a5f5c7965d1bf88aebe2a6132b538,1,Impala Public Jenkins,2018-04-14 01:41:38+00:00,['b4228dfd14975059b2aac68792e63007b5c4e1e2'],5,8,13,5741719,2,,,,4643
fef527d60b1dc33cc083d44f0d697086dab4f361,0,Impala Public Jenkins,2018-04-14 02:21:31+00:00,['51cf5b27fc3a5f5c7965d1bf88aebe2a6132b538'],39,30,69,5741788,11,0,0.666666667,0.333333333,4643
e53bf279b07bd66c4371185eaec1f9a33261bf30,0,Impala Public Jenkins,2018-04-14 16:32:55+00:00,['fef527d60b1dc33cc083d44f0d697086dab4f361'],0,103,103,5741891,4,,,,4644
5960d1b364a661a81c4513a33b6e9470282de162,0,Impala Public Jenkins,2018-04-16 01:50:14+00:00,['e53bf279b07bd66c4371185eaec1f9a33261bf30'],5,64,69,5741960,2,,,,4644
a6767de0aa7b385cf2846797e109257d7b23075d,0,Impala Public Jenkins,2018-04-16 20:27:51+00:00,['5960d1b364a661a81c4513a33b6e9470282de162'],3,54,57,5742017,5,,,,4644
0e98b9abd05ccfb3f01657434f913ad7d061f087,0,Impala Public Jenkins,2018-04-16 20:28:34+00:00,['a6767de0aa7b385cf2846797e109257d7b23075d'],39,77,116,5742133,1,,,,4644
ea698cd497f63908b231e4b108c20d259e5bd8fb,1,Impala Public Jenkins,2018-04-17 00:34:52+00:00,['0e98b9abd05ccfb3f01657434f913ad7d061f087'],48,181,229,5742362,3,,,,4644
eaf66172df113dbf10cdb0a08a2bc51e4077ca38,0,Philip Zeyliger,2018-04-17 19:49:55+00:00,['ea698cd497f63908b231e4b108c20d259e5bd8fb'],2,2,4,5742366,1,,,,4644
834b3b93a1787add4e9e0a8762aa372610935568,0,Impala Public Jenkins,2018-04-18 00:38:27+00:00,['eaf66172df113dbf10cdb0a08a2bc51e4077ca38'],1,4,5,5742371,1,,,,4644
3ebf30a2a4de675388e8f2237cc0ec0c99458cf5,1,Impala Public Jenkins,2018-04-18 01:18:20+00:00,['834b3b93a1787add4e9e0a8762aa372610935568'],11,135,146,5742517,8,0.571428571,0.619047619,0.666666667,4645
249e5abda520dab9aea5b2462469ad43bf508020,0,Impala Public Jenkins,2018-04-18 08:05:30+00:00,['3ebf30a2a4de675388e8f2237cc0ec0c99458cf5'],1,22,23,5742540,3,1,1,1,4645
cfaffc25f9fa770c86b00143b66a1fd4e13b9558,0,Impala Public Jenkins,2018-04-18 17:09:59+00:00,['249e5abda520dab9aea5b2462469ad43bf508020'],4,4,8,5742548,1,,,,4645
740fc6b57f074a448bac04ec2e8e05312f141f67,1,Tianyi Wang,2018-04-18 18:26:24+00:00,['cfaffc25f9fa770c86b00143b66a1fd4e13b9558'],12,67,79,5742627,4,0.095238095,0.952380952,1,4646
62d33881b0a122df4284495e88f4266bc97ad353,0,Impala Public Jenkins,2018-04-18 20:32:07+00:00,['740fc6b57f074a448bac04ec2e8e05312f141f67'],0,61,61,5742688,3,,,,4647
39f986ecf4fca0733c3778d7756dd6b12175dd35,0,Impala Public Jenkins,2018-04-18 21:17:02+00:00,['62d33881b0a122df4284495e88f4266bc97ad353'],456,448,904,5743592,3,,,,4647
353f7d41f9a5d262006fc945b1d5c8f66025c316,0,Impala Public Jenkins,2018-04-19 01:26:44+00:00,['39f986ecf4fca0733c3778d7756dd6b12175dd35'],23,11,34,5743626,2,,,,4647
bfb21316c79bc07d745603f58a138be57de15d8a,0,Impala Public Jenkins,2018-04-19 01:44:38+00:00,['353f7d41f9a5d262006fc945b1d5c8f66025c316'],107,182,289,5743915,2,,,,4647
ddc795d86a909770490d28ed84156c42757c2821,0,Impala Public Jenkins,2018-04-19 03:06:04+00:00,['bfb21316c79bc07d745603f58a138be57de15d8a'],8,28,36,5743951,2,,,,4647
22714a7ab127b3871aa1cc5c97ff415a48ce2f85,0,Impala Public Jenkins,2018-04-19 04:30:01+00:00,['ddc795d86a909770490d28ed84156c42757c2821'],41,165,206,5744157,2,,,,4647
1176a5244a8dd1e48f7c39a51d23cb91f5ccc5e5,0,Impala Public Jenkins,2018-04-19 04:40:06+00:00,['22714a7ab127b3871aa1cc5c97ff415a48ce2f85'],372,1,373,5744530,2,,,,4647
5d328f4a05198eac756594b140fa1927a67bf479,1,Impala Public Jenkins,2018-04-19 04:56:29+00:00,['1176a5244a8dd1e48f7c39a51d23cb91f5ccc5e5'],6,16,22,5744552,1,0,1,1,4647
08a1a7a967f19e41e8523a9020320bbad5cdac77,0,Impala Public Jenkins,2018-04-19 07:23:29+00:00,['5d328f4a05198eac756594b140fa1927a67bf479'],1,21,22,5744574,2,0,1,1,4647
5bbcfaf22e6603c6dd799116c804dd8be499370d,0,Impala Public Jenkins,2018-04-19 18:00:53+00:00,['08a1a7a967f19e41e8523a9020320bbad5cdac77'],4,2,6,5744580,2,,,,4647
48643a572b165f0d87c33e6f3a5f88d0b0214d2a,0,Impala Public Jenkins,2018-04-19 20:31:34+00:00,['5bbcfaf22e6603c6dd799116c804dd8be499370d'],2,8,10,5744590,1,0,0,0,4647
abcc1356ea38e63242d89fd20c269c6a684dc7a1,0,Impala Public Jenkins,2018-04-19 21:24:56+00:00,['48643a572b165f0d87c33e6f3a5f88d0b0214d2a'],1,1,2,5744592,1,,,,4647
a12d19c794e0d8a9bd3ae62be3718c1b803c33db,0,Impala Public Jenkins,2018-04-19 21:58:48+00:00,['abcc1356ea38e63242d89fd20c269c6a684dc7a1'],0,4,4,5744596,1,,,,4647
b68e06997c1f49f6b723d78e217efddec4f56f3a,0,Impala Public Jenkins,2018-04-19 23:43:19+00:00,['a12d19c794e0d8a9bd3ae62be3718c1b803c33db'],1,2,3,5744599,1,,,,4647
9117ce073b4f5fc4bacc760a7bd82698447d115c,0,Impala Public Jenkins,2018-04-20 00:04:12+00:00,['b68e06997c1f49f6b723d78e217efddec4f56f3a'],2,158,160,5744759,1,,,,4647
8e86678d65be7635039154f6edecd15cc08b1e0b,1,Impala Public Jenkins,2018-04-20 10:28:12+00:00,['9117ce073b4f5fc4bacc760a7bd82698447d115c'],290,278,568,5745327,50,0,0.416666667,0.5,4647
34b2f218411155de076d3e5463376c585bcff4f3,0,Impala Public Jenkins,2018-04-20 11:01:44+00:00,['8e86678d65be7635039154f6edecd15cc08b1e0b'],7,54,61,5745388,2,0.243243243,0.243243243,0.243243243,4647
7134d812b57a734c194cc94d32f1e212ed0f17cd,0,Impala Public Jenkins,2018-04-20 19:45:46+00:00,['34b2f218411155de076d3e5463376c585bcff4f3'],0,135,135,5745523,1,,,,4647
4dc3d340d866ef9a7ef1f654cbfff402e0bc69cc,0,Impala Public Jenkins,2018-04-20 21:40:13+00:00,['7134d812b57a734c194cc94d32f1e212ed0f17cd'],110,11,121,5745644,6,0,0,0,4647
5bc5279b07451f8c6fb8af29ef83127dc7785440,0,Impala Public Jenkins,2018-04-21 01:08:50+00:00,['4dc3d340d866ef9a7ef1f654cbfff402e0bc69cc'],1,3,4,5745648,1,,,,4647
b9271ccf0e2e2e8cfbe7c6538aca0109c68acbef,0,Impala Public Jenkins,2018-04-21 04:02:34+00:00,['5bc5279b07451f8c6fb8af29ef83127dc7785440'],441,894,1335,5746983,1,,,,4647
da363a99a4b1afff91600c71650e26932be9350a,0,Impala Public Jenkins,2018-04-23 21:29:59+00:00,['b9271ccf0e2e2e8cfbe7c6538aca0109c68acbef'],127,136,263,5747246,3,,,,4647
62eed0d5d582a3bc7ffe0fe97a800e314ade25c2,0,Impala Public Jenkins,2018-04-23 23:13:49+00:00,['da363a99a4b1afff91600c71650e26932be9350a'],894,441,1335,5748581,1,,,,4647
c84764d571021b7a6653a70f28ce04978aa8993d,1,Impala Public Jenkins,2018-04-23 23:39:46+00:00,['62eed0d5d582a3bc7ffe0fe97a800e314ade25c2'],1476,375,1851,5750432,1,,,,4647
c1be4e9670d5fcbae68f47926a341f62482d4d25,0,Impala Public Jenkins,2018-04-24 00:35:28+00:00,['c84764d571021b7a6653a70f28ce04978aa8993d'],0,31,31,5750463,3,,,,4647
1dcc6c1beb9c36528184aa5a90f5d3f258e32971,0,Impala Public Jenkins,2018-04-24 02:46:08+00:00,['c1be4e9670d5fcbae68f47926a341f62482d4d25'],57,49,106,5750569,1,0.333333333,0,1,4647
da7f865f058c6860b639baaf74d3f33abfd2bf04,0,Impala Public Jenkins,2018-04-24 05:37:53+00:00,['1dcc6c1beb9c36528184aa5a90f5d3f258e32971'],0,49,49,5750618,3,,,,4648
e9535bc024fac22943853d87bc20b7637d25d0d4,0,Impala Public Jenkins,2018-04-24 06:03:00+00:00,['da7f865f058c6860b639baaf74d3f33abfd2bf04'],1,1,2,5750620,1,,,,4648
20c161d7583ee1b4fc0dac3c76a7c067badfcdb2,1,Impala Public Jenkins,2018-04-25 01:25:33+00:00,['e9535bc024fac22943853d87bc20b7637d25d0d4'],2,2,4,5750624,1,,,,4648
1b706fb32b3338b3fe6f37680c32874de101cd44,0,Impala Public Jenkins,2018-04-25 04:44:23+00:00,['20c161d7583ee1b4fc0dac3c76a7c067badfcdb2'],0,48,48,5750672,1,,,,4648
b56ac8f0a0888f8130fa8e5a6f6ed184f2538128,1,Impala Public Jenkins,2018-04-25 07:28:40+00:00,['1b706fb32b3338b3fe6f37680c32874de101cd44'],2,8,10,5750682,1,0,0,0,4648
2fb73f94b425fde488166a19f78050ddbc3d7b50,1,Impala Public Jenkins,2018-04-25 20:52:42+00:00,['b56ac8f0a0888f8130fa8e5a6f6ed184f2538128'],0,47,47,5750729,3,,,,4650
65bcb1608d0e24603dfd8726a5c6e59e4682717c,1,Impala Public Jenkins,2018-04-25 21:19:22+00:00,['2fb73f94b425fde488166a19f78050ddbc3d7b50'],6,13,19,5750748,1,0,0,1,4650
770ef77d532046ca2b3379a6ea7f1c30087e6940,0,Impala Public Jenkins,2018-04-26 00:40:18+00:00,['65bcb1608d0e24603dfd8726a5c6e59e4682717c'],16,11,27,5750775,1,,,,4650
d879fa9930144ee44972dce718cdada35c3071bd,1,Impala Public Jenkins,2018-04-26 00:56:36+00:00,['770ef77d532046ca2b3379a6ea7f1c30087e6940'],25,53,78,5750853,2,1,0,1,4650
61655340160aa3bcb42126ed325d0caa6d38b4a8,0,Impala Public Jenkins,2018-04-26 02:27:55+00:00,['d879fa9930144ee44972dce718cdada35c3071bd'],0,79,79,5750932,1,,,,4651
c557a5bfb7695c9e6fb506b57d1c2d952cf5c3a4,0,Impala Public Jenkins,2018-04-26 02:59:27+00:00,['61655340160aa3bcb42126ed325d0caa6d38b4a8'],1,7,8,5750940,1,,,,4651
a377f28543f576577ab748c2c3212ffb93f56767,0,Impala Public Jenkins,2018-04-26 04:26:50+00:00,['c557a5bfb7695c9e6fb506b57d1c2d952cf5c3a4'],2,13,15,5750955,2,1,1,0.714285714,4651
518bcd3e148caa8b42011de11e971c2978fb6f3b,1,Impala Public Jenkins,2018-04-26 07:14:30+00:00,['a377f28543f576577ab748c2c3212ffb93f56767'],5,70,75,5751030,4,0,1,1,4651
e54ce629da550d7ee940c2dbbc9a6e9a1c444e10,0,Impala Public Jenkins,2018-04-26 19:49:45+00:00,['518bcd3e148caa8b42011de11e971c2978fb6f3b'],25,59,84,5751114,2,0.3125,1,0,4651
25422c74b295cd76f13037eb90f67b548960c396,1,Impala Public Jenkins,2018-04-26 20:12:38+00:00,['e54ce629da550d7ee940c2dbbc9a6e9a1c444e10'],2,37,39,5751153,3,,,,4651
2e6a63e31e22657173ad2f03a8185f8a4a8f074e,1,Impala Public Jenkins,2018-04-26 20:47:29+00:00,['25422c74b295cd76f13037eb90f67b548960c396'],149,426,575,5751728,10,0.368852459,0,0.508196721,4651
1e79f14798a8f742bbf17f79a4666627dcef3faf,1,Impala Public Jenkins,2018-04-27 20:06:56+00:00,['2e6a63e31e22657173ad2f03a8185f8a4a8f074e'],79,1130,1209,5752937,28,0.564417178,0.858895706,0.705521472,4654
87be63e321f688486b98d4ea69200967a8a2effa,0,Impala Public Jenkins,2018-04-27 21:55:11+00:00,['1e79f14798a8f742bbf17f79a4666627dcef3faf'],0,120,120,5753057,3,0.333333333,0.333333333,0.666666667,4655
22c7ded07eb2710aba3e1aa07ed7ec1a448f7c61,1,Impala Public Jenkins,2018-04-28 01:55:45+00:00,['87be63e321f688486b98d4ea69200967a8a2effa'],0,15,15,5753072,1,,,,4655
d0f838b66a935310de9aeae7b9ba6513a5197ba9,1,Impala Public Jenkins,2018-04-28 03:33:02+00:00,['22c7ded07eb2710aba3e1aa07ed7ec1a448f7c61'],295,553,848,5753920,34,0,0.639240506,0.848101266,4655
789c5aac23480acc6e18c057b767b65fdd791c97,1,Impala Public Jenkins,2018-04-28 04:30:55+00:00,['d0f838b66a935310de9aeae7b9ba6513a5197ba9'],337,290,627,5754547,13,1,0.206896552,0,4655
fb5dc9eb484e54cf9f37d06168392c5bc2a0f4fe,1,Tim Armstrong,2018-04-28 23:41:39+00:00,['789c5aac23480acc6e18c057b767b65fdd791c97'],2799,4568,7367,5761914,91,0.310447761,0.659701493,0.585074627,4657
d7bba821923b96272c254840facd3d870b1ebe36,1,Tim Armstrong,2018-04-28 23:41:39+00:00,['fb5dc9eb484e54cf9f37d06168392c5bc2a0f4fe'],174,288,462,5762376,11,0,0,1,4657
93d714c6458a680151c7208b1fe23677f4705a17,1,Tim Armstrong,2018-04-28 23:41:39+00:00,['d7bba821923b96272c254840facd3d870b1ebe36'],11,23,34,5762410,2,0,0,0,4657
418c705787f060afb3e9e5fbeadb891b2484b6c5,1,Tim Armstrong,2018-04-28 23:41:39+00:00,['93d714c6458a680151c7208b1fe23677f4705a17'],1003,1652,2655,5765065,49,0.476190476,0.842857143,0.923809524,4659
8a609b3513c4a181cd06bb82e2aeb97908590184,0,Michael Brown,2018-04-30 15:58:42+00:00,['418c705787f060afb3e9e5fbeadb891b2484b6c5'],15,0,15,5765080,1,,,,4659
0833408fd769a7225cbdd21ff9b1555f6031e796,0,Alex Rodoni,2018-04-30 18:13:34+00:00,['8a609b3513c4a181cd06bb82e2aeb97908590184'],697,839,1536,5766616,2,,,,4659
d8ab804e3e04a778fa10bd43efa4654ca96f7fe9,0,Impala Public Jenkins,2018-04-30 20:37:42+00:00,['0833408fd769a7225cbdd21ff9b1555f6031e796'],1,1,2,5766618,1,,,,4659
167ed627febe5a10d8a4a7474a34efde1ac6f1c2,0,Impala Public Jenkins,2018-04-30 22:28:51+00:00,['d8ab804e3e04a778fa10bd43efa4654ca96f7fe9'],2,2,4,5766622,1,,,,4659
671de258f29d31d280defe989af261fdbd9182ae,1,Impala Public Jenkins,2018-05-01 02:53:42+00:00,['167ed627febe5a10d8a4a7474a34efde1ac6f1c2'],3,659,662,5767284,2,0.418367347,1,0.83877551,4660
52a2d90f980dd360946c37284280de09cf5fab39,0,Impala Public Jenkins,2018-05-01 20:40:28+00:00,['671de258f29d31d280defe989af261fdbd9182ae'],0,35,35,5767319,2,,,,4660
80d07afff3ab03da77071198eb8c5181c01a215c,0,Alex Rodoni,2018-05-01 22:10:42+00:00,['52a2d90f980dd360946c37284280de09cf5fab39'],88,78,166,5767485,1,,,,4660
202807e2ff93b6771f26f47b65c3fb9e0cedac38,0,Impala Public Jenkins,2018-05-01 22:12:39+00:00,['80d07afff3ab03da77071198eb8c5181c01a215c'],33,27,60,5767545,2,0.375,0.375,0,4660
0b6be850ca640f17aba3212f96993ca7f77fc0a7,1,Impala Public Jenkins,2018-05-01 22:18:54+00:00,['202807e2ff93b6771f26f47b65c3fb9e0cedac38'],181,82,263,5767808,15,0.052631579,0.052631579,0.868421053,4660
583dcc31b0c1e6a4c63d72732db8cb7b86163604,0,Impala Public Jenkins,2018-05-01 22:41:18+00:00,['0b6be850ca640f17aba3212f96993ca7f77fc0a7'],11,38,49,5767857,2,1,1,1,4660
ba84ad03cb83d7f7aed8524fcfbb0e2cdc9fdd53,1,Impala Public Jenkins,2018-05-02 02:54:23+00:00,['583dcc31b0c1e6a4c63d72732db8cb7b86163604'],8,16,24,5767881,5,0,0,0,4660
b69f02ba02a2d9d0cdbe3abc5c662f73e919aee7,0,Impala Public Jenkins,2018-05-02 22:14:03+00:00,['ba84ad03cb83d7f7aed8524fcfbb0e2cdc9fdd53'],7,5,12,5767893,1,0,0,1,4660
aee045df806c5736a9f49d2324fc1e30db732db2,0,Impala Public Jenkins,2018-05-03 18:33:20+00:00,['b69f02ba02a2d9d0cdbe3abc5c662f73e919aee7'],3,6,9,5767902,1,,,,4660
51bc004d798d2c7ab7b8b4553d32d26cb7382ad6,1,Impala Public Jenkins,2018-05-03 19:18:09+00:00,['aee045df806c5736a9f49d2324fc1e30db732db2'],398,482,880,5768782,6,0,1,0.444444444,4660
1eedafed6ae147829e84c3a08a1bf54d7ab4b1fb,0,Impala Public Jenkins,2018-05-03 20:45:28+00:00,['51bc004d798d2c7ab7b8b4553d32d26cb7382ad6'],4,20,24,5768806,1,,,,4660
2f6bd64b5f7d063ff3e22fb15cc729b4cf03681a,0,Impala Public Jenkins,2018-05-04 02:53:28+00:00,['1eedafed6ae147829e84c3a08a1bf54d7ab4b1fb'],41,4,45,5768851,5,1,1,0,4660
d6dad9cdf8b6d2bf10ed3b54e00ca3765638c7a7,0,Impala Public Jenkins,2018-05-04 03:10:50+00:00,['2f6bd64b5f7d063ff3e22fb15cc729b4cf03681a'],3,7,10,5768861,1,0,1,1,4660
5592ecfe1a3681a1b8ac6b318ccdede9817dfccf,1,Impala Public Jenkins,2018-05-04 20:12:54+00:00,['d6dad9cdf8b6d2bf10ed3b54e00ca3765638c7a7'],7,17,24,5768885,1,1,1,1,4660
c05696dd6abc1fbf9a85f634ae56b3eff1efb348,0,Impala Public Jenkins,2018-05-05 01:20:59+00:00,['5592ecfe1a3681a1b8ac6b318ccdede9817dfccf'],9,41,50,5768935,6,,,,4660
f13abdca67774e12ed1a4fca655497b6f407c720,0,Impala Public Jenkins,2018-05-05 03:01:35+00:00,['c05696dd6abc1fbf9a85f634ae56b3eff1efb348'],1,1,2,5768937,1,,,,4660
f20415755401d56103df7f16348cea8ed12fb3d8,0,Impala Public Jenkins,2018-05-07 19:21:09+00:00,['f13abdca67774e12ed1a4fca655497b6f407c720'],4,0,4,5768941,1,,,,4660
f1709a64bdb27146167ac7b11f883cd69900dee5,0,Philip Zeyliger,2018-05-07 20:10:35+00:00,['f20415755401d56103df7f16348cea8ed12fb3d8'],5,4,9,5768950,1,,,,4660
14f6c242f21eca3c73bc3b4fa45c8d90ebcdd571,0,Impala Public Jenkins,2018-05-07 20:19:00+00:00,['f1709a64bdb27146167ac7b11f883cd69900dee5'],7,12,19,5768969,2,0,1,1,4660
10187bfff4b926945d648f42290be60a1367e43e,1,Impala Public Jenkins,2018-05-07 21:50:56+00:00,['14f6c242f21eca3c73bc3b4fa45c8d90ebcdd571'],39,90,129,5769098,5,0,0,1,4660
18455ec6f8dda2f1d47bf0bc2ed10eb847d27b9c,0,Impala Public Jenkins,2018-05-08 03:04:41+00:00,['10187bfff4b926945d648f42290be60a1367e43e'],35,74,109,5769207,8,0,1,1,4660
e2e7c103a7ac87d848eed3138841ae5d2ec32863,1,Impala Public Jenkins,2018-05-08 03:31:24+00:00,['18455ec6f8dda2f1d47bf0bc2ed10eb847d27b9c'],7,98,105,5769312,6,0.295081967,0.721311475,0.885245902,4660
d8d8ddf8af5984bcd87970c6c978bafc47b39d50,0,Impala Public Jenkins,2018-05-08 17:34:36+00:00,['e2e7c103a7ac87d848eed3138841ae5d2ec32863'],0,9,9,5769321,1,,,,4660
4a24618fcd715092341b51970e823b895bad96d7,0,Impala Public Jenkins,2018-05-08 20:42:44+00:00,['d8d8ddf8af5984bcd87970c6c978bafc47b39d50'],18,3,21,5769342,1,,,,4660
4cf4c90a2040e3f0bb2311a6cad8561f8db0a10e,0,Impala Public Jenkins,2018-05-08 21:31:45+00:00,['4a24618fcd715092341b51970e823b895bad96d7'],13,10,23,5769365,1,,,,4660
ab2fc5c8b894ef7332d9e4307eacc7842d986aae,1,Impala Public Jenkins,2018-05-08 22:22:47+00:00,['4cf4c90a2040e3f0bb2311a6cad8561f8db0a10e'],8,34,42,5769407,3,1,1,0.666666667,4660
96c9dac287f5b1db305f4ce9b77a92a4f5f68eff,0,Impala Public Jenkins,2018-05-08 22:23:13+00:00,['ab2fc5c8b894ef7332d9e4307eacc7842d986aae'],1,1,2,5769409,1,,,,4660
df2798ea977e1cca87842c524b35ac46a51d5c28,0,Impala Public Jenkins,2018-05-08 23:40:24+00:00,['96c9dac287f5b1db305f4ce9b77a92a4f5f68eff'],1,1,2,5769411,1,,,,4660
f976318cc1a7e1e9779e5c7695033536c8c22593,0,Impala Public Jenkins,2018-05-08 23:42:11+00:00,['df2798ea977e1cca87842c524b35ac46a51d5c28'],1,1,2,5769413,1,,,,4660
4a5d2dafab2de515bd6479e4bd94b46ddab8c455,0,Impala Public Jenkins,2018-05-08 23:59:54+00:00,['f976318cc1a7e1e9779e5c7695033536c8c22593'],0,27,27,5769440,1,,,,4660
19752af1fdce9f6946d3136cdecb4ff4498032ca,0,Impala Public Jenkins,2018-05-09 03:50:18+00:00,['4a5d2dafab2de515bd6479e4bd94b46ddab8c455'],23,282,305,5769745,1,0.076923077,1,1,4660
e34f6aa5a885d21a17ecae0a5ec1b0329f6b3b01,0,Impala Public Jenkins,2018-05-09 16:42:21+00:00,['19752af1fdce9f6946d3136cdecb4ff4498032ca'],2,2,4,5769749,1,,,,4660
6a86c8e8d482cc884ebad94c78d2a4a98320bbb7,0,Impala Public Jenkins,2018-05-09 19:07:00+00:00,['e34f6aa5a885d21a17ecae0a5ec1b0329f6b3b01'],6,12,18,5769767,3,,,,4660
28c1f76529b79d437b66a80b954ec227e0ddc6cd,1,Impala Public Jenkins,2018-05-09 22:27:36+00:00,['6a86c8e8d482cc884ebad94c78d2a4a98320bbb7'],68,242,310,5770077,6,0.594936709,0.189873418,0.911392405,4662
c35ec6c9bda2bdd86117fd5a7d60ff8e4ece3dc9,0,David Knupp,2018-05-09 23:08:44+00:00,['28c1f76529b79d437b66a80b954ec227e0ddc6cd'],171,675,846,5770923,14,,,,4675
b126b2d1053bde6671701af3931c7424a646cd54,0,Impala Public Jenkins,2018-05-10 01:30:13+00:00,['c35ec6c9bda2bdd86117fd5a7d60ff8e4ece3dc9'],1,11,12,5770935,3,,,,4675
3e736450354e55244e16924cfeb223a30629351d,0,Impala Public Jenkins,2018-05-10 09:29:55+00:00,['b126b2d1053bde6671701af3931c7424a646cd54'],1,4,5,5770940,1,1,1,1,4675
8668d18ebb0e137993a12d5303411b6c06e91c59,0,Impala Public Jenkins,2018-05-10 18:55:08+00:00,['3e736450354e55244e16924cfeb223a30629351d'],1,1,2,5770942,1,,,,4675
49413d9c5b96153b79ce5aa756a2411e25610fd2,0,Impala Public Jenkins,2018-05-10 19:27:52+00:00,['8668d18ebb0e137993a12d5303411b6c06e91c59'],188,558,746,5771688,61,0.891774892,0.917748918,0.844155844,4676
ea4715fd76d6dba0c3777146989c2bf020efabdd,0,Impala Public Jenkins,2018-05-10 22:39:21+00:00,['49413d9c5b96153b79ce5aa756a2411e25610fd2'],4,17,21,5771709,2,1,0,0,4676
25c13bfdd6f7b6e12095a22dd4a44832129b5fe4,1,Impala Public Jenkins,2018-05-11 22:41:49+00:00,['ea4715fd76d6dba0c3777146989c2bf020efabdd'],156,196,352,5772061,15,1,1,0.8,4679
6ca87e46736a1e591ed7d7d5fee05b4b4d2fbb50,1,Impala Public Jenkins,2018-05-12 00:46:01+00:00,['25c13bfdd6f7b6e12095a22dd4a44832129b5fe4'],396,397,793,5772854,6,1,1,0.615384615,4679
e12ee485cf4c77203b144c053ee167509cc39374,1,Impala Public Jenkins,2018-05-12 01:43:37+00:00,['6ca87e46736a1e591ed7d7d5fee05b4b4d2fbb50'],1931,1977,3908,5776762,43,1,0.066666667,1,4679
47f95f14bc00ad00e3615c4532e32407bcb1c53f,0,Impala Public Jenkins,2018-05-12 03:32:43+00:00,['e12ee485cf4c77203b144c053ee167509cc39374'],35,56,91,5776853,3,1,0.625,1,4679
4cdb6dfa6d4657a9b3d8018a06d9a200032c5628,0,Impala Public Jenkins,2018-05-12 19:29:33+00:00,['47f95f14bc00ad00e3615c4532e32407bcb1c53f'],1,25,26,5776879,3,1,1,1,4679
bb9237d942abc69efcf1b26bfd10f149dd781948,1,Impala Public Jenkins,2018-05-13 09:06:06+00:00,['4cdb6dfa6d4657a9b3d8018a06d9a200032c5628'],0,5297,5297,5782176,101,,,,4780
19bcc3099ef5e244fe74a0466b0b0eeb673acc8e,0,Impala Public Jenkins,2018-05-14 18:09:42+00:00,['bb9237d942abc69efcf1b26bfd10f149dd781948'],2,2,4,5782180,1,,,,4780
fc47a545d69fe321ad835575a399cfacacd5e982,0,David Knupp,2018-05-14 20:34:36+00:00,['19bcc3099ef5e244fe74a0466b0b0eeb673acc8e'],560,0,560,5782740,1,0.767175573,0.20610687,0.145038168,4780
f2963a208a929c985024cb0fb2c291572f5cd1e7,0,Impala Public Jenkins,2018-05-14 21:52:57+00:00,['fc47a545d69fe321ad835575a399cfacacd5e982'],49,69,118,5782858,1,,,,4780
33f90cc74b3003c7657d003f522dc2cf20b3ba0c,1,Impala Public Jenkins,2018-05-14 21:54:39+00:00,['f2963a208a929c985024cb0fb2c291572f5cd1e7'],1,1,2,5782860,1,,,,4780
4ce9dbb475ef52812691d0cddae6df75ab496369,0,Impala Public Jenkins,2018-05-14 22:17:58+00:00,['33f90cc74b3003c7657d003f522dc2cf20b3ba0c'],3,3,6,5782866,2,,,,4780
c6fc0be282ec9e8d3b3b043f79570d4cef4fb65d,0,Impala Public Jenkins,2018-05-14 23:09:48+00:00,['4ce9dbb475ef52812691d0cddae6df75ab496369'],7,1,8,5782874,2,,,,4780
3033f3b3190050f479117f9a27dae5a32d4b8260,1,Impala Public Jenkins,2018-05-15 00:21:50+00:00,['c6fc0be282ec9e8d3b3b043f79570d4cef4fb65d'],9,32,41,5782915,2,,,,4780
675e4c161fb39b5825af5ecff10a1a41ebdb3d16,1,Impala Public Jenkins,2018-05-15 03:37:27+00:00,['3033f3b3190050f479117f9a27dae5a32d4b8260'],14,23,37,5782952,2,0.272727273,0.272727273,0.272727273,4780
97ecc154bdb43912eab2d4748693f24bd5da5ba6,1,Impala Public Jenkins,2018-05-15 04:02:30+00:00,['675e4c161fb39b5825af5ecff10a1a41ebdb3d16'],5,233,238,5783190,13,0.728070175,0.894736842,0.719298246,4782
3661100fa3323b062adb0802323898b92e80212b,0,Tim Armstrong,2018-05-15 22:23:14+00:00,['97ecc154bdb43912eab2d4748693f24bd5da5ba6'],6,9,15,5783205,3,,,,4782
4fab42883184c247b951dba4237f4303c502d410,0,Impala Public Jenkins,2018-05-15 22:24:26+00:00,['3661100fa3323b062adb0802323898b92e80212b'],395,395,790,5783995,6,0,0,0.384615385,4782
fab65d44792f5a5effcb6f26f08c6ad865c4b64a,0,Tim Armstrong,2018-05-15 23:37:06+00:00,['4fab42883184c247b951dba4237f4303c502d410'],4,4,8,5784003,1,,,,4782
13a1acd7e42b533c39b9f4eea1c17823bde4c1c5,0,Impala Public Jenkins,2018-05-15 23:59:58+00:00,['fab65d44792f5a5effcb6f26f08c6ad865c4b64a'],12,44,56,5784059,5,,,,4782
a64cfc523ecd5ee7f13c3c7ca63cafe510c4610a,0,Lars Volker,2018-05-16 00:00:15+00:00,['13a1acd7e42b533c39b9f4eea1c17823bde4c1c5'],0,18,18,5784077,2,0,1,1,4782
caf275c11a62c33d0211e71f3285c4977dd6799d,0,Impala Public Jenkins,2018-05-16 02:22:24+00:00,['a64cfc523ecd5ee7f13c3c7ca63cafe510c4610a'],0,10,10,5784087,1,0,0,0,4782
be2d61a7e2e21f5837c946641b094651c4461aa4,0,Impala Public Jenkins,2018-05-16 02:23:52+00:00,['caf275c11a62c33d0211e71f3285c4977dd6799d'],84,136,220,5784307,3,0.785714286,0.785714286,0.785714286,4782
75a10a3dda80137120ecb9c1871e6bdfb74f6522,1,Impala Public Jenkins,2018-05-16 02:50:30+00:00,['be2d61a7e2e21f5837c946641b094651c4461aa4'],114,396,510,5784817,1,0.091370558,0.553299492,1,4782
fcbbae4952a47926c2567bcd9fa1ac0f2f3e0e5c,0,Michael Brown,2018-05-16 15:20:31+00:00,['75a10a3dda80137120ecb9c1871e6bdfb74f6522'],0,3,3,5784820,1,1,1,1,4782
02ee2d1c509bffc71817fdc4bd25b9589e7085e5,0,Impala Public Jenkins,2018-05-16 20:02:20+00:00,['fcbbae4952a47926c2567bcd9fa1ac0f2f3e0e5c'],51,56,107,5784927,2,1,1,1,4782
1e6544f7da1d756b437d8b0f12a6446f10f1f836,1,Impala Public Jenkins,2018-05-16 23:33:57+00:00,['02ee2d1c509bffc71817fdc4bd25b9589e7085e5'],0,8,8,5784935,1,1,1,1,4782
6af65697f291b859509d756b1d839176f664111d,0,Impala Public Jenkins,2018-05-17 09:01:14+00:00,['1e6544f7da1d756b437d8b0f12a6446f10f1f836'],3,22,25,5784960,2,1,1,0,4782
2e9f5c90ebbe0a9b63db92238787071b027b2c66,1,Impala Public Jenkins,2018-05-17 09:13:01+00:00,['6af65697f291b859509d756b1d839176f664111d'],1,5,6,5784966,1,,,,4782
015058d0f28e8e2b9b28f659a04a5748399ca8f1,0,Impala Public Jenkins,2018-05-17 18:12:03+00:00,['2e9f5c90ebbe0a9b63db92238787071b027b2c66'],644,466,1110,5786076,1,,,,4782
05e0db3a0e9c00ff075452941082408d39f794f8,0,Impala Public Jenkins,2018-05-17 18:31:16+00:00,['015058d0f28e8e2b9b28f659a04a5748399ca8f1'],5,7,12,5786088,1,,,,4782
ccf19f9f8f2914639b6997849a56c13cfd2399b8,1,Impala Public Jenkins,2018-05-17 20:22:02+00:00,['05e0db3a0e9c00ff075452941082408d39f794f8'],113,1002,1115,5787203,14,0.362352941,0.524705882,0.458823529,4786
5b824408af17d084a5ea3464e0ff913f2c94e4c4,0,Impala Public Jenkins,2018-05-17 22:15:32+00:00,['ccf19f9f8f2914639b6997849a56c13cfd2399b8'],0,12,12,5787215,2,,,,4786
6454b74d2e299415d49fb8d9e1a099857830403c,0,Impala Public Jenkins,2018-05-18 02:18:38+00:00,['5b824408af17d084a5ea3464e0ff913f2c94e4c4'],2,21,23,5787238,2,0,0.181818182,0,4786
f4f28d310c08b97171a50147e283c1153fc57679,1,Impala Public Jenkins,2018-05-18 03:44:46+00:00,['6454b74d2e299415d49fb8d9e1a099857830403c'],280,458,738,5787976,18,0.863636364,1,0,4791
c1c122a10177920903009420d2faac673d867c4b,1,Impala Public Jenkins,2018-05-18 04:36:15+00:00,['f4f28d310c08b97171a50147e283c1153fc57679'],395,400,795,5788771,6,1,1,0.655172414,4791
ab75dd12e49100f153911bef87a9dab810cf9b58,1,Impala Public Jenkins,2018-05-18 05:05:57+00:00,['c1c122a10177920903009420d2faac673d867c4b'],68,255,323,5789094,9,0.007042254,0,0.612676056,4791
48625335d220566a1d69e65fb34bfca9a7dc3cff,1,Impala Public Jenkins,2018-05-19 00:26:53+00:00,['ab75dd12e49100f153911bef87a9dab810cf9b58'],16,28,44,5789138,6,1,1,1,4791
85ed7ae88bcec17ffd45b1dd66d07818cb1d55b0,0,Impala Public Jenkins,2018-05-19 00:37:50+00:00,['48625335d220566a1d69e65fb34bfca9a7dc3cff'],7,48,55,5789193,2,0.375,0.75,0.875,4791
d880c72c8e257f2375b56df52399ad44f02b7cea,0,Impala Public Jenkins,2018-05-20 22:04:28+00:00,['85ed7ae88bcec17ffd45b1dd66d07818cb1d55b0'],1,4,5,5789198,1,,,,4791
5c7d3b12e3aa750e7ab88e3ef1092d5218e53cc2,1,Impala Public Jenkins,2018-05-21 18:25:26+00:00,['d880c72c8e257f2375b56df52399ad44f02b7cea'],180,235,415,5789613,8,1,0,0,4791
7485d6082cb9d298e7ba5a829ff15dcc4937d338,0,Impala Public Jenkins,2018-05-21 21:55:49+00:00,['5c7d3b12e3aa750e7ab88e3ef1092d5218e53cc2'],0,5,5,5789618,1,,,,4791
a5aa6ffdaf850a2efe872a8ec9d648bfdf0c4cd2,0,Impala Public Jenkins,2018-05-21 23:41:49+00:00,['7485d6082cb9d298e7ba5a829ff15dcc4937d338'],8,5,13,5789631,1,,,,4791
482ea3914093064da1f4f176b6c616150100768c,1,Impala Public Jenkins,2018-05-21 23:50:42+00:00,['a5aa6ffdaf850a2efe872a8ec9d648bfdf0c4cd2'],68,60,128,5789759,4,1,1,0,4791
21d92aacbfdbe9780b983acfacd02ced4bb0c132,1,Impala Public Jenkins,2018-05-22 01:10:14+00:00,['482ea3914093064da1f4f176b6c616150100768c'],28,75,103,5789862,17,0,0.909090909,0.181818182,4791
23e11dc72662417059b1b7337d69e78c2ac4ba65,0,Impala Public Jenkins,2018-05-22 02:23:26+00:00,['21d92aacbfdbe9780b983acfacd02ced4bb0c132'],1,4,5,5789867,1,,,,4791
fd7e7c93c5d2ae153784548a2f83f423e85dda43,0,Impala Public Jenkins,2018-05-22 03:43:40+00:00,['23e11dc72662417059b1b7337d69e78c2ac4ba65'],23,20,43,5789910,3,1,1,0,4791
8d474a0170f60526e0b5611687e5166ae29ecae9,1,Impala Public Jenkins,2018-05-22 22:27:21+00:00,['fd7e7c93c5d2ae153784548a2f83f423e85dda43'],38,127,165,5790075,9,0,0.755102041,0.734693878,4791
c4b214b3a2ef8ca4692f74e6a289ddf76d1b3f58,0,Impala Public Jenkins,2018-05-23 01:38:58+00:00,['8d474a0170f60526e0b5611687e5166ae29ecae9'],1,33,34,5790109,2,1,1,1,4792
710b08bfd84b24f478582364a3077a01f4a7700b,0,Impala Public Jenkins,2018-05-23 15:19:27+00:00,['c4b214b3a2ef8ca4692f74e6a289ddf76d1b3f58'],0,2,2,5790111,1,,,,4792
c1362afb9a072e49df470d9068d44cdbdf5cdec5,1,Impala Public Jenkins,2018-05-23 20:25:56+00:00,['710b08bfd84b24f478582364a3077a01f4a7700b'],1,1,2,5790113,1,,,,4792
879f106d1b28380fbe71680d04cf6df568b3daa3,0,Impala Public Jenkins,2018-05-23 21:45:09+00:00,['c1362afb9a072e49df470d9068d44cdbdf5cdec5'],2,64,66,5790179,3,1,1,1,4794
3bedfcdbfe90a89cae687a1498c926641a2b656e,0,Impala Public Jenkins,2018-05-24 00:30:36+00:00,['879f106d1b28380fbe71680d04cf6df568b3daa3'],30,50,80,5790259,1,,,,4794
20a1a15124e27d7db030e876ab7b82bf9e73e374,0,Impala Public Jenkins,2018-05-24 01:43:48+00:00,['3bedfcdbfe90a89cae687a1498c926641a2b656e'],0,4,4,5790263,1,,,,4794
1ca077fd065bc5689e7614073c174b5a2bb11d96,0,Impala Public Jenkins,2018-05-24 09:49:14+00:00,['20a1a15124e27d7db030e876ab7b82bf9e73e374'],950,961,1911,5792174,2,1,1,0.666666667,4794
a22ee6419c4fa1ed7dfb04ca9930f1e791a85411,0,Impala Public Jenkins,2018-05-24 18:26:27+00:00,['1ca077fd065bc5689e7614073c174b5a2bb11d96'],51,42,93,5792267,1,,,,4794
2362b672ccd94ed97331fe9c84ac1603ecb3772f,0,Impala Public Jenkins,2018-05-24 19:09:49+00:00,['a22ee6419c4fa1ed7dfb04ca9930f1e791a85411'],8,19,27,5792294,2,0,0,1,4794
a7c6fa71010a803b232de01c0d66798f171d3bb0,0,Tim Armstrong,2018-05-24 19:27:51+00:00,['2362b672ccd94ed97331fe9c84ac1603ecb3772f'],3,6,9,5792303,1,1,1,1,4794
890457c01878cb3ee3b2045b63bbcabf772d88bc,0,Impala Public Jenkins,2018-05-24 20:10:29+00:00,['a7c6fa71010a803b232de01c0d66798f171d3bb0'],526,582,1108,5793411,21,1,1,1,4794
bdad189469a463fbefde932ca6255fa4b26380ae,0,Impala Public Jenkins,2018-05-24 21:59:31+00:00,['890457c01878cb3ee3b2045b63bbcabf772d88bc'],5,25,30,5793441,2,0.941176471,0.941176471,1,4794
5f20296921ebaef855c3b58c56a671fe508dcd37,0,Impala Public Jenkins,2018-05-25 00:03:55+00:00,['bdad189469a463fbefde932ca6255fa4b26380ae'],2,1,3,5793444,1,1,0,1,4794
9a5410570e25431813b96e00f7b91db44f672f38,0,Impala Public Jenkins,2018-05-25 00:28:18+00:00,['5f20296921ebaef855c3b58c56a671fe508dcd37'],728,329,1057,5794501,10,0.640350877,0.548245614,0.578947368,4796
2d59e4eb0d79ab0da24bf7a394410313b07af270,0,Impala Public Jenkins,2018-05-25 21:26:35+00:00,['9a5410570e25431813b96e00f7b91db44f672f38'],10,2,12,5794513,1,,,,4796
456356ca0a69ad9de6c5acd6c1605fc5db66d174,0,Impala Public Jenkins,2018-05-25 21:44:48+00:00,['2d59e4eb0d79ab0da24bf7a394410313b07af270'],49,33,82,5794595,1,,,,4796
ff26663f90b58153e8086c1a779f8604b2cfe685,0,Impala Public Jenkins,2018-05-25 22:13:08+00:00,['456356ca0a69ad9de6c5acd6c1605fc5db66d174'],0,9,9,5794604,1,0,1,1,4796
56a740c07a6d80921e86fee769033fab5ad1ccf3,0,Impala Public Jenkins,2018-05-26 03:24:17+00:00,['ff26663f90b58153e8086c1a779f8604b2cfe685'],0,1,1,5794605,1,,,,4796
6ee48b9a11709ecb6eb8554500f6245eb42f1f8b,0,Impala Public Jenkins,2018-05-28 04:00:56+00:00,['56a740c07a6d80921e86fee769033fab5ad1ccf3'],22,0,22,5794627,2,,,,4796
0b9334a564dd7dd8d4a08e78876aba3fb0852e4d,0,Impala Public Jenkins,2018-05-29 16:53:40+00:00,['6ee48b9a11709ecb6eb8554500f6245eb42f1f8b'],0,5,5,5794632,1,,,,4796
4653637b9e2ee573f3ad7a76da8941a0a4870bd8,0,Impala Public Jenkins,2018-05-29 20:03:54+00:00,['0b9334a564dd7dd8d4a08e78876aba3fb0852e4d'],5,29,34,5794666,2,,,,4796
573550ca2f781ff5cb781a6c6dcdfcbfc25edf04,0,Impala Public Jenkins,2018-05-29 21:34:02+00:00,['4653637b9e2ee573f3ad7a76da8941a0a4870bd8'],1,2,3,5794669,1,0,1,1,4796
e660149670e7d2d18b74a6eb3bc06cb929887ca1,1,Impala Public Jenkins,2018-05-29 21:49:35+00:00,['573550ca2f781ff5cb781a6c6dcdfcbfc25edf04'],1,2,3,5794672,1,,,,4796
e9bd917a218b5e1717fced983f70f64850c6e02f,0,Impala Public Jenkins,2018-05-30 00:38:22+00:00,['e660149670e7d2d18b74a6eb3bc06cb929887ca1'],1,3,4,5794676,1,,,,4796
ba7893cb9e72752299743225139d052a5a0276a6,0,Impala Public Jenkins,2018-05-30 08:00:50+00:00,['e9bd917a218b5e1717fced983f70f64850c6e02f'],8,12,20,5794696,1,,,,4796
84b55c6148dd4e756359717cca30a8eea71cb62a,1,Impala Public Jenkins,2018-05-30 08:12:58+00:00,['ba7893cb9e72752299743225139d052a5a0276a6'],25,5,30,5794726,2,0.058823529,0.058823529,0,4796
aba8fdf8b2e1831986b82cec6f79fc71586e6b01,0,Impala Public Jenkins,2018-05-30 09:28:29+00:00,['84b55c6148dd4e756359717cca30a8eea71cb62a'],15,75,90,5794816,2,0.333333333,0.911111111,0.844444444,4796
e4c52e31551333af0ef37367a33b5e89b9b74d2f,0,Impala Public Jenkins,2018-05-30 17:13:35+00:00,['aba8fdf8b2e1831986b82cec6f79fc71586e6b01'],1,1,2,5794818,1,,,,4796
2f22a6f67ff363a0832a7ceee5d0020c8fd9b15a,0,Impala Public Jenkins,2018-05-30 17:50:04+00:00,['e4c52e31551333af0ef37367a33b5e89b9b74d2f'],5,4,9,5794827,1,,,,4796
fdd9d059c2eb2f31dcebd708eaa029f62232b632,1,Impala Public Jenkins,2018-05-31 05:29:13+00:00,['2f22a6f67ff363a0832a7ceee5d0020c8fd9b15a'],6,6,12,5794839,1,,,,4796
fc0c5f58f00b360a7651187e0b0fe79add426742,0,Impala Public Jenkins,2018-05-31 07:02:21+00:00,['fdd9d059c2eb2f31dcebd708eaa029f62232b632'],2,6,8,5794847,1,0,1,1,4796
9cf8f19897be3b7ada6f84a3e3339ae7757accfa,0,Impala Public Jenkins,2018-05-31 23:51:37+00:00,['fc0c5f58f00b360a7651187e0b0fe79add426742'],3,4,7,5794854,1,,,,4796
7bd2f723a935e4b1715f0da0769471a2bb8f923b,0,Impala Public Jenkins,2018-06-01 02:03:40+00:00,['9cf8f19897be3b7ada6f84a3e3339ae7757accfa'],4,4,8,5794862,1,,,,4796
7a41f587473603e31911fc4b58d7ff829ed11952,0,Impala Public Jenkins,2018-06-01 03:57:30+00:00,['7bd2f723a935e4b1715f0da0769471a2bb8f923b'],1,4,5,5794867,1,0,1,0,4796
418354f1e00f9f92cc90cb80a37f3972f15ea44c,0,Impala Public Jenkins,2018-06-01 18:58:23+00:00,['7a41f587473603e31911fc4b58d7ff829ed11952'],0,4,4,5794871,1,,,,4796
ae8f4ebbc795614f96a6e66b873c7161a63bde19,1,Impala Public Jenkins,2018-06-01 20:21:49+00:00,['418354f1e00f9f92cc90cb80a37f3972f15ea44c'],5,15,20,5794891,1,,,,4796
4fda68a59d0a7f3855d13d5a4b682c7348abb0cb,0,Impala Public Jenkins,2018-06-01 23:41:20+00:00,['ae8f4ebbc795614f96a6e66b873c7161a63bde19'],7,0,7,5794898,1,,,,4796
c9e8f2f7e720b1e9a96d48f2f09f8aff9dc93f44,0,Impala Public Jenkins,2018-06-05 01:14:35+00:00,['4fda68a59d0a7f3855d13d5a4b682c7348abb0cb'],0,3,3,5794901,1,,,,4796
f9ab03fd3548a2efba6a3931b3e0861afae1a55f,1,Impala Public Jenkins,2018-06-05 01:33:50+00:00,['c9e8f2f7e720b1e9a96d48f2f09f8aff9dc93f44'],1,19,20,5794921,3,0.666666667,0.666666667,0.666666667,4796
ec0f002e081b62abd80afe75447cdd723d89f1d7,0,Impala Public Jenkins,2018-06-05 03:56:52+00:00,['f9ab03fd3548a2efba6a3931b3e0861afae1a55f'],2,2,4,5794925,1,,,,4796
1693e149b714a0c5bbdd603bc3fc70a03502830c,0,Tim Armstrong,2018-06-05 06:10:21+00:00,['ec0f002e081b62abd80afe75447cdd723d89f1d7'],0,2,2,5794927,1,,,,4796
094a56187dc3adf2d75b85ad4b38e30a77c09c5d,0,Impala Public Jenkins,2018-06-05 18:20:59+00:00,['1693e149b714a0c5bbdd603bc3fc70a03502830c'],10,82,92,5795019,1,,,,4796
496f7469f8e9b2f38499b9ae89294cb7b7ff32c3,0,Impala Public Jenkins,2018-06-05 18:21:32+00:00,['094a56187dc3adf2d75b85ad4b38e30a77c09c5d'],1,36,37,5795056,1,,,,4796
456605b01b880a259d5922b0ed27d7e3a8ad0006,1,Impala Public Jenkins,2018-06-05 20:46:13+00:00,['496f7469f8e9b2f38499b9ae89294cb7b7ff32c3'],39,57,96,5795152,1,,,,4796
316ccbe7e8114f72899f87f9f5104c161f27aac4,0,Tim Armstrong,2018-06-05 21:10:43+00:00,['456605b01b880a259d5922b0ed27d7e3a8ad0006'],26,0,26,5795178,1,,,,4796
725f450ccf16801f10f29342ef8cee6a24e19c90,0,Impala Public Jenkins,2018-06-05 21:47:02+00:00,['316ccbe7e8114f72899f87f9f5104c161f27aac4'],4,11,15,5795193,1,,,,4796
09506e787f8254a8503e2ae592ba7dc90445b9b4,0,Impala Public Jenkins,2018-06-05 22:09:32+00:00,['725f450ccf16801f10f29342ef8cee6a24e19c90'],20,35,55,5795248,3,0,1,1,4796
c9b3b55bad9f65c335725b0743a544183eccd6c7,0,Impala Public Jenkins,2018-06-05 22:34:09+00:00,['09506e787f8254a8503e2ae592ba7dc90445b9b4'],2,2,4,5795252,2,,,,4796
705a5438027ecad591a6c8196d654b7a180fafc3,0,Impala Public Jenkins,2018-06-05 23:47:26+00:00,['c9b3b55bad9f65c335725b0743a544183eccd6c7'],9,47,56,5795308,2,0.111111111,0.111111111,1,4796
88fe1283f1499ad3ebc73a40189b2fe4b5e4a093,0,Impala Public Jenkins,2018-06-06 01:58:07+00:00,['705a5438027ecad591a6c8196d654b7a180fafc3'],3,14,17,5795325,4,1,1,1,4796
388f2df22d5ceba8cb25065389ae7aa9911ac208,0,Impala Public Jenkins,2018-06-06 03:19:47+00:00,['88fe1283f1499ad3ebc73a40189b2fe4b5e4a093'],6,9,15,5795340,1,1,1,0,4796
b265cb68a229124fdd21427941c3d75ed86e3e2e,0,Tim Armstrong,2018-06-06 03:40:33+00:00,['388f2df22d5ceba8cb25065389ae7aa9911ac208'],4,4,8,5795348,1,,,,4796
f0ab334445046599b55415edece1c22e1ec27b1e,0,Tim Armstrong,2018-06-06 03:41:49+00:00,['b265cb68a229124fdd21427941c3d75ed86e3e2e'],14,51,65,5795413,11,,1,0,4796
af4909fdfc21f223510857645dfed615a083306c,0,Impala Public Jenkins,2018-06-06 07:12:19+00:00,['f0ab334445046599b55415edece1c22e1ec27b1e'],1,0,1,5795414,1,,,,4796
8f7a3f9c6c48da83bcb94e3fd7d2f824ef6e1b4a,1,Tim Armstrong,2018-06-06 17:16:15+00:00,['af4909fdfc21f223510857645dfed615a083306c'],0,2,2,5795416,1,,,,4796
31f549e701e90096b3ee58da10aefdc424a0a4fa,0,Impala Public Jenkins,2018-06-06 17:22:18+00:00,['8f7a3f9c6c48da83bcb94e3fd7d2f824ef6e1b4a'],7,0,7,5795423,1,,,,4796
b996e0f0c8ad4ee6e4edaaeb92420ef18a3f6e26,0,Impala Public Jenkins,2018-06-06 20:21:16+00:00,['31f549e701e90096b3ee58da10aefdc424a0a4fa'],0,3,3,5795426,1,,,,4796
1c0eeafe0ee77175590986c7e76dcb451d9eff51,0,Impala Public Jenkins,2018-06-06 21:30:01+00:00,['b996e0f0c8ad4ee6e4edaaeb92420ef18a3f6e26'],12,33,45,5795471,1,,,,4796
cd2aad4595e533be560aafa1f591d4f533f4283f,1,Impala Public Jenkins,2018-06-06 21:34:22+00:00,['1c0eeafe0ee77175590986c7e76dcb451d9eff51'],3,336,339,5795810,4,,,,4797
1b750033099228ccd37340de406bfd3139516e4c,1,Tim Armstrong,2018-06-07 04:40:49+00:00,['cd2aad4595e533be560aafa1f591d4f533f4283f'],71,233,304,5796114,13,0.216494845,0.721649485,0.989690722,4797
68aeb71b4b849bddb2d55e77ec90d12c6a44dd6d,1,Tim Armstrong,2018-06-07 04:40:49+00:00,['1b750033099228ccd37340de406bfd3139516e4c'],6,19,25,5796139,1,0,1,1,4797
725a47b3f275aa76db6a65d4e320f8dbaf9d6b28,0,Impala Public Jenkins,2018-06-07 06:10:36+00:00,['68aeb71b4b849bddb2d55e77ec90d12c6a44dd6d'],14,39,53,5796192,4,1,1,0.5,4798
a0257013df735141e5d36f884305af26c92b7c4b,0,Tim Armstrong,2018-06-07 17:10:58+00:00,['725a47b3f275aa76db6a65d4e320f8dbaf9d6b28'],6,9,15,5796207,1,1,0,0,4798
056e4bf31f8755ca007660db9ae7e053756c4d5e,0,Tim Armstrong,2018-06-07 19:06:36+00:00,['a0257013df735141e5d36f884305af26c92b7c4b'],0,2,2,5796209,1,0,1,1,4798
6682e4a09463ee547dc603aa2a4863e85e14efcc,0,Impala Public Jenkins,2018-06-07 22:36:24+00:00,['056e4bf31f8755ca007660db9ae7e053756c4d5e'],4,22,26,5796235,1,0,1,1,4798
c72c5dc663252a7a43c652d27e313813e758a20f,0,Impala Public Jenkins,2018-06-07 23:01:05+00:00,['6682e4a09463ee547dc603aa2a4863e85e14efcc'],26,30,56,5796291,4,1,1,1,4798
495d7781898c1189c199740702c4801a7a245640,0,Impala Public Jenkins,2018-06-08 00:14:37+00:00,['c72c5dc663252a7a43c652d27e313813e758a20f'],2,37,39,5796330,2,1,1,1,4799
9d0ae238d41de78bd458055849276d40e0ee6fd5,0,Dan Hecht,2018-06-08 00:43:02+00:00,['495d7781898c1189c199740702c4801a7a245640'],1,0,1,5796331,1,,,,4799
8c2af8ce7afd1cc014475b3ff3bdc2d197ec4d0a,0,Impala Public Jenkins,2018-06-08 00:55:46+00:00,['9d0ae238d41de78bd458055849276d40e0ee6fd5'],81,157,238,5796569,1,,,,4799
56d331f28417d02a908da08c1be34727fb3c3b04,1,Impala Public Jenkins,2018-06-08 02:56:07+00:00,['8c2af8ce7afd1cc014475b3ff3bdc2d197ec4d0a'],563,525,1088,5797657,17,1,0.294117647,1,4799
2fee52149e913a12338885cc49c5a86f7d788376,0,Impala Public Jenkins,2018-06-08 04:15:40+00:00,['56d331f28417d02a908da08c1be34727fb3c3b04'],1,2,3,5797660,1,,,,4799
c52e455c460b1f6fd18c07b874e6fc374af02789,1,Impala Public Jenkins,2018-06-08 04:41:00+00:00,['2fee52149e913a12338885cc49c5a86f7d788376'],12,50,62,5797722,4,0.259259259,0.333333333,0.740740741,4799
7332398e79fb7f79a3d3f792dd02edd076f47534,0,Tim Armstrong,2018-06-08 15:53:29+00:00,['c52e455c460b1f6fd18c07b874e6fc374af02789'],2,1,3,5797725,1,,,,4799
8b71c67cad3d4d69bb4aeaa842b0997513cf0aa3,0,Impala Public Jenkins,2018-06-08 18:18:05+00:00,['7332398e79fb7f79a3d3f792dd02edd076f47534'],400,325,725,5798450,5,,,,4800
e6ca7ca14d4dc64e0f43547c8d9f156ef42d2818,1,Impala Public Jenkins,2018-06-08 20:15:50+00:00,['8b71c67cad3d4d69bb4aeaa842b0997513cf0aa3'],2,67,69,5798519,4,1,0,1,4800
c4d7f2ee8c0bedbb5898bdfd143bd2778fd195d4,0,Impala Public Jenkins,2018-06-08 20:24:48+00:00,['e6ca7ca14d4dc64e0f43547c8d9f156ef42d2818'],7,1,8,5798527,1,1,0,1,4800
c84782e7466862e85e9ba534faa9f2baf85cc45e,1,Impala Public Jenkins,2018-06-08 20:28:47+00:00,['c4d7f2ee8c0bedbb5898bdfd143bd2778fd195d4'],247,677,924,5799451,22,0.021276596,0.480851064,0.689361702,4802
06fe3210509424cf50fdd3cc919466a1ce6bc842,0,Tim Armstrong,2018-06-11 23:25:46+00:00,['c84782e7466862e85e9ba534faa9f2baf85cc45e'],3,21,24,5799475,5,1,1,0,4803
88366bab07db3defa14ce00ac4f02ad97ec54176,0,Impala Public Jenkins,2018-06-12 01:15:44+00:00,['06fe3210509424cf50fdd3cc919466a1ce6bc842'],120,149,269,5799744,3,1,1,1,4803
09f16232e308594a1f522d88c75db9daa5f6e038,1,Impala Public Jenkins,2018-06-12 15:23:07+00:00,['88366bab07db3defa14ce00ac4f02ad97ec54176'],293,286,579,5800323,2,,,,4803
ac25e3f2515d1bad0700888ca880e082e5d3071a,0,Impala Public Jenkins,2018-06-12 20:29:16+00:00,['09f16232e308594a1f522d88c75db9daa5f6e038'],188,176,364,5800687,1,0,0.191489362,1,4803
60dbc4db56b258026dc7ce91276dcec7600a67b4,0,Impala Public Jenkins,2018-06-12 20:59:56+00:00,['ac25e3f2515d1bad0700888ca880e082e5d3071a'],1,1,2,5800689,1,,,,4803
dc8dd3eedf75315e1b6e7319b83a6b0e062d6de2,0,Lars Volker,2018-06-12 21:32:27+00:00,['60dbc4db56b258026dc7ce91276dcec7600a67b4'],6,10,16,5800705,1,,,,4803
501dc6abfb360575613eb2210c0c87f3e37235ce,0,Impala Public Jenkins,2018-06-12 22:08:22+00:00,['dc8dd3eedf75315e1b6e7319b83a6b0e062d6de2'],14,38,52,5800757,4,0.833333333,0.833333333,0.833333333,4803
8d49797194f5e2f2c6128945fc4fecd5054163da,0,Impala Public Jenkins,2018-06-12 23:58:34+00:00,['501dc6abfb360575613eb2210c0c87f3e37235ce'],7,2,9,5800766,1,0,0,0,4803
bf2124bf30bb768f06a614bdfa260a6877b1da35,1,Impala Public Jenkins,2018-06-13 00:10:13+00:00,['8d49797194f5e2f2c6128945fc4fecd5054163da'],33,115,148,5800914,6,0,0.666666667,1,4803
2b05c3c3ca6cfa7a41215c84185a12d6ad97ff19,1,Impala Public Jenkins,2018-06-13 00:22:58+00:00,['bf2124bf30bb768f06a614bdfa260a6877b1da35'],6,26,32,5800946,2,0.941176471,0.941176471,1,4803
2de9db8fc64dc1054ac3ca41ab0f0047db670da6,1,Tim Armstrong,2018-06-13 15:48:17+00:00,['2b05c3c3ca6cfa7a41215c84185a12d6ad97ff19'],244,687,931,5801877,31,0.152,0.228,0.968,4803
ee9a9b6c5000cf915716a15ea8a0b3605290a9a5,0,Impala Public Jenkins,2018-06-13 20:49:11+00:00,['2de9db8fc64dc1054ac3ca41ab0f0047db670da6'],14,27,41,5801918,3,0.625,0.625,1,4803
1365012cbf8fbe2fd6699d55cf05f6b80de63797,0,Impala Public Jenkins,2018-06-14 00:33:56+00:00,['ee9a9b6c5000cf915716a15ea8a0b3605290a9a5'],1,28,29,5801947,2,1,1,1,4803
0b540b0258e1407e7d19d9bb37bceb9478e4d243,1,Impala Public Jenkins,2018-06-14 00:46:29+00:00,['1365012cbf8fbe2fd6699d55cf05f6b80de63797'],517,1232,1749,5803696,92,0,0,0.933333333,4809
d8ed07f11227257254682fff3b62de8834291d66,1,Impala Public Jenkins,2018-06-14 03:25:55+00:00,['0b540b0258e1407e7d19d9bb37bceb9478e4d243'],29,254,283,5803979,12,0.166666667,0.222222222,0.222222222,4811
555d4a0219d32237cdc2d097ad04e2b4c39145b3,1,Bharath Vissapragada,2018-06-14 04:11:26+00:00,['d8ed07f11227257254682fff3b62de8834291d66'],12,173,185,5804164,2,0.27826087,0.991304348,0.973913043,4811
b864112fa28926ba289938d8faa3ee3f9a0c84a0,0,Impala Public Jenkins,2018-06-14 04:49:03+00:00,['555d4a0219d32237cdc2d097ad04e2b4c39145b3'],5,7,12,5804176,2,0,0,1,4811
d29d5a25e578e4a8d70a96f0a0d9c15d76277f4a,0,Impala Public Jenkins,2018-06-14 16:16:11+00:00,['b864112fa28926ba289938d8faa3ee3f9a0c84a0'],63,101,164,5804340,3,,,,4811
df6ad0dde34e0945fbedf017597fc3814c2e7421,1,Impala Public Jenkins,2018-06-14 19:30:40+00:00,['d29d5a25e578e4a8d70a96f0a0d9c15d76277f4a'],7,361,368,5804708,15,0.651898734,0.841772152,0.765822785,4814
1d699a142b2b4adc0dc19665f6196ffc1eff4bfa,0,Impala Public Jenkins,2018-06-14 20:35:24+00:00,['df6ad0dde34e0945fbedf017597fc3814c2e7421'],10,10,20,5804728,3,,,,4814
31d95e721f822398a84da62b827fba4beeeb66a2,1,Tim Armstrong,2018-06-14 22:26:53+00:00,['1d699a142b2b4adc0dc19665f6196ffc1eff4bfa'],36,384,420,5805148,13,0.273291925,0.857142857,0.788819876,4816
51ff47d05e6edf80ca07805c68b417dec789d85b,0,Impala Public Jenkins,2018-06-14 23:37:00+00:00,['31d95e721f822398a84da62b827fba4beeeb66a2'],101,425,526,5805674,26,0.291338583,1,0.992125984,4818
527c0ca0ed67d6cf0a3cc2b168faf9a79708149c,0,Impala Public Jenkins,2018-06-14 23:39:00+00:00,['51ff47d05e6edf80ca07805c68b417dec789d85b'],32,110,142,5805816,14,,,,4820
76f8ff4a1507c3a7f86eb58dbac191024b59890e,1,Impala Public Jenkins,2018-06-15 00:00:58+00:00,['527c0ca0ed67d6cf0a3cc2b168faf9a79708149c'],1,1,2,5805818,1,,,,4820
b98fb8c2a9777538b1a5fb38db1529f172dbac58,1,Impala Public Jenkins,2018-06-15 00:42:08+00:00,['76f8ff4a1507c3a7f86eb58dbac191024b59890e'],5,339,344,5806162,13,0.303191489,1,0.659574468,4823
1b0a027ffb216d729fe68e7240313af77550ae08,0,Impala Public Jenkins,2018-06-15 02:00:58+00:00,['b98fb8c2a9777538b1a5fb38db1529f172dbac58'],5,105,110,5806272,4,,,,4824
76d40f92ad9214053602518adaf00df8b7477a37,0,Impala Public Jenkins,2018-06-15 02:07:40+00:00,['1b0a027ffb216d729fe68e7240313af77550ae08'],6,48,54,5806326,4,0.230769231,1,1,4824
547bc5712137d089432b277b4cb2960e14199b6a,0,Impala Public Jenkins,2018-06-15 03:21:27+00:00,['76d40f92ad9214053602518adaf00df8b7477a37'],21,14,35,5806361,5,1,1,1,4824
853b6a9c83b7f136e5df200a579ff39b3db42b8c,1,Impala Public Jenkins,2018-06-15 04:10:48+00:00,['547bc5712137d089432b277b4cb2960e14199b6a'],6,823,829,5807190,11,0.936305732,1,0.984076433,4832
9073402f20e08d091833b646ffeb4a54a42d88fc,0,Impala Public Jenkins,2018-06-15 19:47:45+00:00,['853b6a9c83b7f136e5df200a579ff39b3db42b8c'],11,9,20,5807210,1,,,,4832
3e4015c6013fe9275714dc91a20e554e6a71d02a,0,Impala Public Jenkins,2018-06-16 07:51:42+00:00,['9073402f20e08d091833b646ffeb4a54a42d88fc'],2,3,5,5807215,2,1,1,1,4832
e7d5a25a4516337ef651983b1d945abf06c3a831,1,Impala Public Jenkins,2018-06-17 06:45:38+00:00,['3e4015c6013fe9275714dc91a20e554e6a71d02a'],10,48,58,5807273,2,0,0.95,0.95,4832
58eaf1f89a904e57c043444f5cadda37f2ff4ae8,0,Impala Public Jenkins,2018-06-18 17:39:15+00:00,['e7d5a25a4516337ef651983b1d945abf06c3a831'],3,2,5,5807278,1,,,,4832
533afadca0e6e32550f4114711e66f23a93c8e3b,0,Impala Public Jenkins,2018-06-18 17:39:50+00:00,['58eaf1f89a904e57c043444f5cadda37f2ff4ae8'],0,45,45,5807323,1,,,,4832
a90b42911f1753b14e4f9f581bad837e33dcf9bf,1,Todd Lipcon,2018-06-18 17:49:28+00:00,['533afadca0e6e32550f4114711e66f23a93c8e3b'],64,241,305,5807628,11,0.980769231,1,1,4833
13b82624b58275469988147c33981446c86e4174,1,Impala Public Jenkins,2018-06-18 20:19:53+00:00,['a90b42911f1753b14e4f9f581bad837e33dcf9bf'],8,119,127,5807755,13,0.698412698,0.746031746,0.317460317,4833
28b4ad14f61bf6f0195b731195767d3a59e92ed8,0,Joe McDonnell,2018-06-18 21:42:22+00:00,['13b82624b58275469988147c33981446c86e4174'],12,26,38,5807793,2,,,,4833
147e962f2dc7507d36cde696640bd76e8821b37c,1,Impala Public Jenkins,2018-06-18 21:46:11+00:00,['28b4ad14f61bf6f0195b731195767d3a59e92ed8'],10,29,39,5807832,1,,,,4833
4cfd40cef8ff1df1efe301894dc7425513dd1f74,1,Tim Armstrong,2018-06-18 22:42:01+00:00,['147e962f2dc7507d36cde696640bd76e8821b37c'],57,279,336,5808168,1,0.067484663,0.110429448,0.809815951,4833
6fb1cc6a0ed405e386af40584c22268648dda011,0,Impala Public Jenkins,2018-06-18 22:42:24+00:00,['4cfd40cef8ff1df1efe301894dc7425513dd1f74'],15,31,46,5808214,3,,,,4833
cfe25043a8275943cc88b7aa26a4d1ef480e0b11,0,Impala Public Jenkins,2018-06-19 00:06:25+00:00,['6fb1cc6a0ed405e386af40584c22268648dda011'],1,35,36,5808250,1,,,,4833
5c3f06c7232fac2d72c100e8f28582459760e320,1,Impala Public Jenkins,2018-06-19 00:23:49+00:00,['cfe25043a8275943cc88b7aa26a4d1ef480e0b11'],242,297,539,5808789,28,1,1,0,4834
9e069d9c83b705389e31a4434101d07fd0756ba3,1,Impala Public Jenkins,2018-06-19 00:49:28+00:00,['5c3f06c7232fac2d72c100e8f28582459760e320'],166,290,456,5809245,13,1,1,0.652173913,4836
894ab8e980ae0e101633680225bafcd34f383223,0,Impala Public Jenkins,2018-06-19 03:02:49+00:00,['9e069d9c83b705389e31a4434101d07fd0756ba3'],1,24,25,5809270,2,,,,4836
cbefc6eef0724ac184d72afbc44921648491b10a,1,Todd Lipcon,2018-06-19 17:02:47+00:00,['894ab8e980ae0e101633680225bafcd34f383223'],79,300,379,5809649,9,0.657407407,1,0.944444444,4837
2324712e3a7006296ec9ef9fd6c24d60ce54720b,0,Impala Public Jenkins,2018-06-19 18:15:20+00:00,['cbefc6eef0724ac184d72afbc44921648491b10a'],17,13,30,5809679,1,,,,4837
0d476f81f1d110cabc11537015c0c888d6371f41,1,Impala Public Jenkins,2018-06-19 19:24:09+00:00,['2324712e3a7006296ec9ef9fd6c24d60ce54720b'],18,148,166,5809845,3,0.38372093,0.38372093,0.709302326,4837
1953e6191f37c14c4c2dd145fa20e0d90020a693,1,Impala Public Jenkins,2018-06-19 20:06:34+00:00,['0d476f81f1d110cabc11537015c0c888d6371f41'],29,39,68,5809913,1,1,1,0,4837
00519a68d25ee27aec4ed2437b6097c4f471b3af,0,Impala Public Jenkins,2018-06-20 01:32:36+00:00,['1953e6191f37c14c4c2dd145fa20e0d90020a693'],2,2,4,5809917,1,,,,4837
afe1146821e57ba9951a243d5196b5e7407411e6,1,Impala Public Jenkins,2018-06-20 01:39:49+00:00,['00519a68d25ee27aec4ed2437b6097c4f471b3af'],29,30,59,5809976,5,0,1,0,4837
747e0a949316b8e14fa6ad123ffc34d9c450608b,1,Todd Lipcon,2018-06-20 05:07:22+00:00,['afe1146821e57ba9951a243d5196b5e7407411e6'],206,164,370,5810346,18,0.975609756,0.975609756,0.073170732,4837
0063e0c5d7747aca39a8d9c53cc1c52eed5c884b,1,Todd Lipcon,2018-06-20 05:07:22+00:00,['747e0a949316b8e14fa6ad123ffc34d9c450608b'],52,175,227,5810573,18,0.5,0.538461538,0.923076923,4838
08cf0aafae7d383afe40c195a6a86055e2a252d8,1,Todd Lipcon,2018-06-20 05:07:22+00:00,['0063e0c5d7747aca39a8d9c53cc1c52eed5c884b'],24,278,302,5810875,10,0.955357143,1,0.9375,4839
11aaa6caa0818a30db662a4b6f07147faf1f52b2,1,Impala Public Jenkins,2018-06-20 19:37:51+00:00,['08cf0aafae7d383afe40c195a6a86055e2a252d8'],71,202,273,5811148,10,0.263157895,0.284210526,1,4839
2b1970abef16d1db6b01aead06204cb035ff7e82,0,Impala Public Jenkins,2018-06-20 21:33:14+00:00,['11aaa6caa0818a30db662a4b6f07147faf1f52b2'],3,7,10,5811158,1,,,,4839
da8e1c2f665a1717e654aef2aa5f71d1689ff4a4,1,Impala Public Jenkins,2018-06-20 22:22:59+00:00,['2b1970abef16d1db6b01aead06204cb035ff7e82'],128,175,303,5811461,23,1,1,1,4839
143e9c47a562102cdb450293a1ea68a0a90bece6,0,Impala Public Jenkins,2018-06-21 01:30:41+00:00,['da8e1c2f665a1717e654aef2aa5f71d1689ff4a4'],4,1,5,5811466,1,0,0,0,4839
a9b01963b682aa0122d416d642141973ef4a5c8e,0,Impala Public Jenkins,2018-06-21 01:36:18+00:00,['143e9c47a562102cdb450293a1ea68a0a90bece6'],7,4,11,5811477,1,,,,4839
94ffcc64a997022ed582c2b428aac1f06dd2da77,0,Impala Public Jenkins,2018-06-21 07:18:12+00:00,['a9b01963b682aa0122d416d642141973ef4a5c8e'],6,15,21,5811498,3,0,1,1,4839
a541ac603912e789cbe0e34f5cb581e2116a94ee,0,Joe McDonnell,2018-06-22 06:23:23+00:00,['94ffcc64a997022ed582c2b428aac1f06dd2da77'],1,1,2,5811500,1,,,,4839
17749dbcfc51ebe67c269ce812749d1845e47e7a,1,Impala Public Jenkins,2018-06-22 13:18:58+00:00,['a541ac603912e789cbe0e34f5cb581e2116a94ee'],1179,3089,4268,5815768,72,0.336589031,0.79338843,0.825694966,4858
fdc3873733afa771df944c223e315b603f3dbe3f,0,Impala Public Jenkins,2018-06-22 14:42:54+00:00,['17749dbcfc51ebe67c269ce812749d1845e47e7a'],3,17,20,5815788,2,1,1,1,4858
15e4f06cf6039c95dc0697fe8131d35a2ad89b5c,0,Impala Public Jenkins,2018-06-22 16:35:41+00:00,['fdc3873733afa771df944c223e315b603f3dbe3f'],19,38,57,5815845,1,,,,4858
bfb5622adbafdeceb702ce90a727e76a7e814368,0,Impala Public Jenkins,2018-06-22 20:19:33+00:00,['15e4f06cf6039c95dc0697fe8131d35a2ad89b5c'],219,30,249,5816094,1,,,,4858
034144355d66bfb68a0c03f73766fb20db15973e,1,Todd Lipcon,2018-06-22 22:28:54+00:00,['bfb5622adbafdeceb702ce90a727e76a7e814368'],108,707,815,5816909,14,0.518032787,0.783606557,0.806557377,4860
d87459f783a168d86c42a4277dd2cbeeb8f447a9,1,Todd Lipcon,2018-06-22 22:28:54+00:00,['034144355d66bfb68a0c03f73766fb20db15973e'],105,227,332,5817241,11,0.543859649,0.964912281,0.403508772,4860
19fddbf2ecf8dd425c9ea0cc7911a2e994f933a1,0,Impala Public Jenkins,2018-06-22 22:44:59+00:00,['d87459f783a168d86c42a4277dd2cbeeb8f447a9'],2,2,4,5817245,1,,,,4860
83789387e8bd9e8b293bcd229605404867e1d00c,0,Impala Public Jenkins,2018-06-23 01:14:07+00:00,['19fddbf2ecf8dd425c9ea0cc7911a2e994f933a1'],11,2,13,5817258,5,0.75,0.125,0.125,4860
92292e79f0af785e952fa1edc30b64598291129b,1,Impala Public Jenkins,2018-06-23 01:46:40+00:00,['83789387e8bd9e8b293bcd229605404867e1d00c'],33,297,330,5817588,7,0,0,0,4860
c8bfcbd6e826110678df4a699a9e8f05cf57b5d2,0,Joe McDonnell,2018-06-23 05:04:11+00:00,['92292e79f0af785e952fa1edc30b64598291129b'],1,2,3,5817591,1,,,,4860
424d6d072280e1fda6b71aea8ae8d86cea7e592a,0,Impala Public Jenkins,2018-06-25 10:07:15+00:00,['c8bfcbd6e826110678df4a699a9e8f05cf57b5d2'],12,6,18,5817609,2,1,1,0,4860
4dad7edd5aee832a937bb79aa45308b9d80bb24e,0,Impala Public Jenkins,2018-06-25 18:58:19+00:00,['424d6d072280e1fda6b71aea8ae8d86cea7e592a'],23,25,48,5817657,1,,,,4860
b9e19d093ce3339f0ce135de5aa36ae98747ea6c,1,Impala Public Jenkins,2018-06-25 22:25:22+00:00,['4dad7edd5aee832a937bb79aa45308b9d80bb24e'],20,19,39,5817696,4,,,,4860
011acd073ae275baedc02f960beaebfc2035a8e5,1,Impala Public Jenkins,2018-06-26 02:38:23+00:00,['b9e19d093ce3339f0ce135de5aa36ae98747ea6c'],4,538,542,5818238,1,0.052752294,1,1,4860
64e6719870db5602a6fa85014bc6c264080b9414,0,Todd Lipcon,2018-06-26 04:27:33+00:00,['011acd073ae275baedc02f960beaebfc2035a8e5'],50,188,238,5818476,8,0.487804878,1,0.670731707,4860
bbb399ddf405709ec5a82edb50e39c359f64098a,0,Impala Public Jenkins,2018-06-26 18:26:08+00:00,['64e6719870db5602a6fa85014bc6c264080b9414'],2,3,5,5818481,1,,,,4860
aebec1cf8705f590b8b3fa54a1ef412802d75a07,0,Impala Public Jenkins,2018-06-26 19:00:44+00:00,['bbb399ddf405709ec5a82edb50e39c359f64098a'],4,7,11,5818492,1,,,,4860
888dc82ff70afa227d594087806354ad60e0d915,1,Impala Public Jenkins,2018-06-26 23:55:38+00:00,['aebec1cf8705f590b8b3fa54a1ef412802d75a07'],34,160,194,5818686,10,0.183908046,0.126436782,0.402298851,4860
e6abf8e86058349531caabe0a800432b1703e8f1,1,Impala Public Jenkins,2018-06-27 00:14:54+00:00,['888dc82ff70afa227d594087806354ad60e0d915'],4,4,8,5818694,2,,,,4860
e988c36bf07f8b005603b5f8943bcd9da05485aa,1,Impala Public Jenkins,2018-06-27 03:41:47+00:00,['e6abf8e86058349531caabe0a800432b1703e8f1'],11,148,159,5818853,8,0.032258065,1,0.935483871,4860
8000c31d14a439a37a5f8dd626763a433f014504,1,Impala Public Jenkins,2018-06-28 07:38:42+00:00,['e988c36bf07f8b005603b5f8943bcd9da05485aa'],38,51,89,5818942,4,0.285714286,0.285714286,1,4860
4ce2af9ff2340bba1bfb40a1ed3b5b39d6011f87,0,Impala Public Jenkins,2018-06-28 21:18:25+00:00,['8000c31d14a439a37a5f8dd626763a433f014504'],25,62,87,5819029,5,0.75,1,1,4860
5c880e52bc82270588496817fbbf1fb62ad2ef0d,1,Impala Public Jenkins,2018-06-29 19:16:24+00:00,['4ce2af9ff2340bba1bfb40a1ed3b5b39d6011f87'],2057,554,2611,5821640,2,0.904267589,0.043829296,0,4860
8060f4d50e6e9530fe90c32c65b67b2537681302,1,Impala Public Jenkins,2018-06-29 23:26:35+00:00,['5c880e52bc82270588496817fbbf1fb62ad2ef0d'],5,61,66,5821706,12,0.411764706,0.411764706,0.764705882,4861
dde930830b763f58e2f2e73b8b0fe265c4c33f2b,1,Impala Public Jenkins,2018-06-30 04:47:23+00:00,['8060f4d50e6e9530fe90c32c65b67b2537681302'],7,246,253,5821959,7,0.120300752,0.360902256,0.360902256,4861
010321d404a9ad5b7338eeb24a4e9ac576cf4dff,1,Impala Public Jenkins,2018-07-02 21:07:35+00:00,['dde930830b763f58e2f2e73b8b0fe265c4c33f2b'],2241,3056,5297,5827256,19,1,1,0.620192308,4872
e07fbc1b6342836b3e2e472a91c61c5f75d48733,1,Impala Public Jenkins,2018-07-02 22:06:38+00:00,['010321d404a9ad5b7338eeb24a4e9ac576cf4dff'],7,12,19,5827275,2,1,1,1,4872
f20ecadb0598166a747b2d89c479976cd8e9bedb,0,Impala Public Jenkins,2018-07-02 23:06:52+00:00,['e07fbc1b6342836b3e2e472a91c61c5f75d48733'],2,3,5,5827280,1,,,,4872
f3b1c4bc65031899ca9d7e41ab6c7da79b18777d,1,Impala Public Jenkins,2018-07-03 02:48:29+00:00,['f20ecadb0598166a747b2d89c479976cd8e9bedb'],5,49,54,5827334,3,0.542857143,1,0.457142857,4872
0a470168138b5f3254d7604a120eb2376a91c20c,1,Impala Public Jenkins,2018-07-03 08:21:48+00:00,['f3b1c4bc65031899ca9d7e41ab6c7da79b18777d'],124,94,218,5827552,8,0,0,0,4872
2b6d71fee779088af54cc416ee25027bbd415954,0,Tim Armstrong,2018-07-03 15:37:27+00:00,['0a470168138b5f3254d7604a120eb2376a91c20c'],11,40,51,5827603,6,0.933333333,1,1,4872
d03a2d63fef2d29083fa5ee85b89b85891e923fc,0,Impala Public Jenkins,2018-07-03 16:52:42+00:00,['2b6d71fee779088af54cc416ee25027bbd415954'],230,110,340,5827943,2,,,,4872
83448f1c41d3f73ce0c0174c1725c78af3afd0d0,0,Impala Public Jenkins,2018-07-03 18:29:31+00:00,['d03a2d63fef2d29083fa5ee85b89b85891e923fc'],1,2,3,5827946,1,,,,4872
6f52ce10e302ed9d168731dc11db07aabbfa2e53,0,Impala Public Jenkins,2018-07-03 18:41:47+00:00,['83448f1c41d3f73ce0c0174c1725c78af3afd0d0'],85,61,146,5828092,1,,,,4872
30e82c63ecdd56ded10fed931d95ab6d994b9244,1,Impala Public Jenkins,2018-07-03 20:34:27+00:00,['6f52ce10e302ed9d168731dc11db07aabbfa2e53'],1607,121,1728,5829820,25,0.897058824,0.386029412,0.257352941,4873
4ff9f5f3d280607ca523652319c8691803c5db57,1,Impala Public Jenkins,2018-07-03 23:21:07+00:00,['30e82c63ecdd56ded10fed931d95ab6d994b9244'],701,543,1244,5831064,3,,,,4873
61e6a47776ba7f14139b69f91a49d2072a76178b,0,Impala Public Jenkins,2018-07-03 23:49:44+00:00,['4ff9f5f3d280607ca523652319c8691803c5db57'],1,2,3,5831067,2,0,0,0,4873
4c5029afe76cf6ddff0a6a18322e386751065671,1,Impala Public Jenkins,2018-07-05 19:08:03+00:00,['61e6a47776ba7f14139b69f91a49d2072a76178b'],31,346,377,5831444,11,0.196721311,1,0.579234973,4875
fd0ba0fd2c7631d48b4cce56e60f0b9f902cc446,0,Impala Public Jenkins,2018-07-05 20:31:02+00:00,['4c5029afe76cf6ddff0a6a18322e386751065671'],0,1,1,5831445,1,0,0,0,4875
c6f9b61ec2277e1ac16783ee345ad715f30118b9,1,Impala Public Jenkins,2018-07-06 02:06:50+00:00,['fd0ba0fd2c7631d48b4cce56e60f0b9f902cc446'],34,483,517,5831962,14,0.583333333,0.583333333,1,4876
837d386886759f7e884b145e74df83bfc013b2e2,1,Impala Public Jenkins,2018-07-06 22:06:03+00:00,['c6f9b61ec2277e1ac16783ee345ad715f30118b9'],3,54,57,5832019,5,,,,4877
30d196fd50f44519a5289d94388bdcbe970923d1,1,Impala Public Jenkins,2018-07-07 01:10:36+00:00,['837d386886759f7e884b145e74df83bfc013b2e2'],83,147,230,5832249,2,0.188679245,0.58490566,0.603773585,4877
54b3c607f027c445fc8d52acc4d3b1073e84aa77,0,Impala Public Jenkins,2018-07-07 01:32:03+00:00,['30d196fd50f44519a5289d94388bdcbe970923d1'],6,335,341,5832590,12,0.518072289,0.969879518,0.831325301,4880
28162117ad462dfe5fd608d4c09ba02ad213285b,1,Impala Public Jenkins,2018-07-07 02:58:40+00:00,['54b3c607f027c445fc8d52acc4d3b1073e84aa77'],6,25,31,5832621,3,1,1,1,4880
880011fa1f2fc48f9972ad3c673a4bff838cc5ce,1,Impala Public Jenkins,2018-07-07 03:33:08+00:00,['28162117ad462dfe5fd608d4c09ba02ad213285b'],62,103,165,5832786,11,0.043478261,1,1,4880
a70c05ee2d295669707a2ab69d632f5b9cfab1cf,0,Impala Public Jenkins,2018-07-09 16:39:43+00:00,['880011fa1f2fc48f9972ad3c673a4bff838cc5ce'],291,120,411,5833197,2,,,,4880
2fddd39f0eb8cb4d476f35d1fe68f481444eb19b,0,Impala Public Jenkins,2018-07-09 17:10:15+00:00,['a70c05ee2d295669707a2ab69d632f5b9cfab1cf'],0,5,5,5833202,1,,,,4880
7a8f61c79eb13eea8202b9a17cfa416d7e113e76,0,Impala Public Jenkins,2018-07-09 17:50:52+00:00,['2fddd39f0eb8cb4d476f35d1fe68f481444eb19b'],1,0,1,5833203,1,,,,4880
af5d0db99650d47da7efda89e2e798514e58fc63,0,Impala Public Jenkins,2018-07-09 20:01:08+00:00,['7a8f61c79eb13eea8202b9a17cfa416d7e113e76'],3,3,6,5833209,1,,,,4880
c01efd09679faaacfd5488fc7f4c1526a1af2f35,0,Bikramjeet Vig,2018-07-10 22:02:55+00:00,['af5d0db99650d47da7efda89e2e798514e58fc63'],335,6,341,5833550,12,0.481927711,0.030120482,0.168674699,4880
9abd1fea0ef520cc5d15512c972148193e0fbb1d,0,Impala Public Jenkins,2018-07-11 01:43:42+00:00,['c01efd09679faaacfd5488fc7f4c1526a1af2f35'],1,1,2,5833552,1,,,,4880
f1643662882b73dcc9c32b49ada69f5bfda06770,1,Impala Public Jenkins,2018-07-11 02:32:09+00:00,['9abd1fea0ef520cc5d15512c972148193e0fbb1d'],5,97,102,5833654,2,0,0.590909091,1,4880
c465150ba94a5d43e949344b4f4444124a8738a3,1,Impala Public Jenkins,2018-07-11 02:41:16+00:00,['f1643662882b73dcc9c32b49ada69f5bfda06770'],4,81,85,5833739,4,0.115942029,1,1,4880
36ce54bd5c5aca2a09294460dcc1c2e5a80ba497,0,Impala Public Jenkins,2018-07-11 05:09:38+00:00,['c465150ba94a5d43e949344b4f4444124a8738a3'],5,23,28,5833767,2,0,0,1,4880
0ae9d58c0f760dace23e31780bfe67cfc025b155,1,Impala Public Jenkins,2018-07-11 22:40:18+00:00,['36ce54bd5c5aca2a09294460dcc1c2e5a80ba497'],40,50,90,5833857,2,0,0,1,4880
192771511b62a05d1183ecf974f4ff9eb174617e,0,Impala Public Jenkins,2018-07-11 22:44:27+00:00,['0ae9d58c0f760dace23e31780bfe67cfc025b155'],46,66,112,5833969,4,0.75,1,1,4880
5d672457cf05a10dc56c97609f873252b7c65ec1,1,Impala Public Jenkins,2018-07-11 23:19:39+00:00,['192771511b62a05d1183ecf974f4ff9eb174617e'],359,498,857,5834826,20,1,1,1,4880
9b4e6d82219ed1cccfdc6e735000183b6a7f866b,0,Impala Public Jenkins,2018-07-12 01:08:13+00:00,['5d672457cf05a10dc56c97609f873252b7c65ec1'],5,8,13,5834839,2,0,0,0,4880
9df9efc5f33d2e31f218b69a6053b575a30696a6,1,Todd Lipcon,2018-07-12 02:36:55+00:00,['9b4e6d82219ed1cccfdc6e735000183b6a7f866b'],20,114,134,5834973,7,1,1,0.872340426,4880
e8a669bf918e8d1c7ec158acdbacdaf6d1755549,1,Impala Public Jenkins,2018-07-12 02:42:00+00:00,['9df9efc5f33d2e31f218b69a6053b575a30696a6'],48,22,70,5835043,3,1,1,0,4880
80c009631e6018a64806233a31a327d33b4e4b49,0,Impala Public Jenkins,2018-07-12 04:04:39+00:00,['e8a669bf918e8d1c7ec158acdbacdaf6d1755549'],63,62,125,5835168,3,1,0,1,4880
fb6ff57c06153784fa5c014af74856b184027b06,1,Impala Public Jenkins,2018-07-12 20:58:37+00:00,['80c009631e6018a64806233a31a327d33b4e4b49'],3,20,23,5835191,1,,,,4880
39870d434c581aca25f467932d986a539e6a25ef,0,Lars Volker,2018-07-12 21:35:42+00:00,['fb6ff57c06153784fa5c014af74856b184027b06'],90285,0,90285,5925476,430,0.522649881,0.205499948,0.192369209,4880
fcf190c4de1fcc291a5356634fd7cd12efa64852,1,Lars Volker,2018-07-12 21:35:42+00:00,['39870d434c581aca25f467932d986a539e6a25ef'],0,99139,99139,6024615,450,0.466948093,0.78536896,0.816074334,5330
e1d3a616651c93a0164d3e6377f16aaae298d8cd,1,Lars Volker,2018-07-12 21:35:42+00:00,['fcf190c4de1fcc291a5356634fd7cd12efa64852'],32,150,182,6024797,10,1,1,1,5331
96aa7b477d5172c723e80efa03f747658c16e687,0,Lars Volker,2018-07-12 21:35:42+00:00,['e1d3a616651c93a0164d3e6377f16aaae298d8cd'],9,0,9,6024806,2,,,,5331
ae5eec774d3d064e92b5414ab5db3ed548eb69d6,1,Lars Volker,2018-07-12 21:35:42+00:00,['96aa7b477d5172c723e80efa03f747658c16e687'],2,11,13,6024819,4,,,,5331
bee01825e23fc097c1d8ff58f68afb5141ea57db,1,Lars Volker,2018-07-12 21:35:42+00:00,['ae5eec774d3d064e92b5414ab5db3ed548eb69d6'],1,12,13,6024832,2,,,,5331
1ac9a3f329e3a792c1f3e26272149d05b14732b5,1,Lars Volker,2018-07-12 21:35:42+00:00,['bee01825e23fc097c1d8ff58f68afb5141ea57db'],1,1,2,6024834,1,,,,5331
0459721ccd59deae34548d44c684def4e04b31a6,0,Lars Volker,2018-07-12 21:35:42+00:00,['1ac9a3f329e3a792c1f3e26272149d05b14732b5'],40,100,140,6024974,6,0,0.545454545,0.454545455,5331
e2aafae204a695ddc6a9745f879f6164af19027a,0,Impala Public Jenkins,2018-07-13 03:04:35+00:00,['0459721ccd59deae34548d44c684def4e04b31a6'],15,51,66,6025040,8,1,1,1,5331
540611e863fe99b3d3ae35f8b94a745a68b9eba2,0,Impala Public Jenkins,2018-07-13 04:07:19+00:00,['e2aafae204a695ddc6a9745f879f6164af19027a'],4,17,21,6025061,4,1,1,1,5331
7f8a4d3fff00c878327260cfe279bfec6ae14ab8,0,Todd Lipcon,2018-07-13 17:39:06+00:00,['540611e863fe99b3d3ae35f8b94a745a68b9eba2'],42,65,107,6025168,14,0,0,1,5331
f14ae3fc3a16bf707f5c23ec60816c4df0996682,0,Todd Lipcon,2018-07-13 17:39:06+00:00,['7f8a4d3fff00c878327260cfe279bfec6ae14ab8'],33,116,149,6025317,4,1,0.965517241,0.724137931,5332
fa6db57769ddef60f6d4f8aa342fb1b0a4d4eb8b,0,Todd Lipcon,2018-07-13 17:39:06+00:00,['f14ae3fc3a16bf707f5c23ec60816c4df0996682'],10,38,48,6025365,3,0,0,1,5332
408e0255c52edfe89585f324d372e4d8a12263ed,1,Impala Public Jenkins,2018-07-13 19:39:58+00:00,['fa6db57769ddef60f6d4f8aa342fb1b0a4d4eb8b'],4,50,54,6025419,2,0.129032258,0.838709677,0.774193548,5332
dcbff6bbbd731cb21c01b3a0aef6327ccd469f00,0,Impala Public Jenkins,2018-07-13 20:29:48+00:00,['408e0255c52edfe89585f324d372e4d8a12263ed'],1,2,3,6025422,1,0,0,1,5332
3da2dc63fe0c716998cdbdf6334036fbc7698714,1,Impala Public Jenkins,2018-07-13 20:45:37+00:00,['dcbff6bbbd731cb21c01b3a0aef6327ccd469f00'],4,3,7,6025429,1,,,,5332
d36601182cb1e2f3693d379877df930250897886,0,Impala Public Jenkins,2018-07-14 00:20:03+00:00,['3da2dc63fe0c716998cdbdf6334036fbc7698714'],6,3,9,6025438,2,0,0,0,5332
a203733fac3e1e37df8abeee39a88d187153a8c5,1,Impala Public Jenkins,2018-07-14 01:03:18+00:00,['d36601182cb1e2f3693d379877df930250897886'],1121,236,1357,6026795,39,0.470198675,0.264900662,0.225165563,5332
df78eaec0b42d7fa5d148238f40fa57fcfcb25b5,1,Impala Public Jenkins,2018-07-15 21:50:23+00:00,['a203733fac3e1e37df8abeee39a88d187153a8c5'],6,335,341,6027136,12,0.518072289,0.969879518,0.831325301,5335
9bcc8c6ace321514a9853ca6494e6112ed6ebca5,0,Impala Public Jenkins,2018-07-16 18:21:37+00:00,['df78eaec0b42d7fa5d148238f40fa57fcfcb25b5'],0,22,22,6027158,1,,,,5335
2ddff521bb69034b3979bfaa60b1505cbcad40fe,0,Impala Public Jenkins,2018-07-17 02:33:17+00:00,['9bcc8c6ace321514a9853ca6494e6112ed6ebca5'],1,1,2,6027160,1,,,,5335
b1ec9e375f6a2104585b1acae29f9fed407679f6,1,Impala Public Jenkins,2018-07-17 04:36:59+00:00,['2ddff521bb69034b3979bfaa60b1505cbcad40fe'],43,203,246,6027406,17,0.203539823,0.734513274,0.946902655,5335
27c788f826820791fcdd972b55afd970d6643c1a,1,Jim Apple,2018-07-17 04:58:28+00:00,['b1ec9e375f6a2104585b1acae29f9fed407679f6'],6,14,20,6027426,3,,,,5335
041197444d2a73bc3e3da4c6dbfdf1d63c236fbf,1,Impala Public Jenkins,2018-07-17 12:27:55+00:00,['27c788f826820791fcdd972b55afd970d6643c1a'],0,11,11,6027437,2,0,1,0.2,5335
558fa145a10c3a333b6113363b7e6d8777400520,0,Todd Lipcon,2018-07-17 16:11:54+00:00,['041197444d2a73bc3e3da4c6dbfdf1d63c236fbf'],11,1,12,6027449,3,1,0.25,0,5335
6887fc2190da26af2ae5b6bd3b90e5b22d20c963,0,Joe McDonnell,2018-07-17 16:45:34+00:00,['558fa145a10c3a333b6113363b7e6d8777400520'],2,2,4,6027453,1,,,,5335
7f3f63424f1a82390386ab1a21408d0b820e6c81,1,Joe McDonnell,2018-07-17 16:45:44+00:00,['6887fc2190da26af2ae5b6bd3b90e5b22d20c963'],0,111,111,6027564,4,,,,5337
3f393bc27c68f23fa7032fb941adf014e18b7b3b,0,Impala Public Jenkins,2018-07-17 21:12:53+00:00,['7f3f63424f1a82390386ab1a21408d0b820e6c81'],0,92,92,6027656,3,,,,5338
c845aab86ea8ffb27ffb8d2f577f7a71e7e46120,0,Impala Public Jenkins,2018-07-17 22:06:54+00:00,['3f393bc27c68f23fa7032fb941adf014e18b7b3b'],66,129,195,6027851,13,0,0,0,5340
effe4e66684fcd86f0e6b78bcc7b815a951e3018,0,Todd Lipcon,2018-07-17 22:56:50+00:00,['c845aab86ea8ffb27ffb8d2f577f7a71e7e46120'],13,29,42,6027893,2,0.071428571,0,0.571428571,5340
980076117f43d2189b5fc9484ef0c1c54c2c18c1,0,Impala Public Jenkins,2018-07-18 02:43:30+00:00,['effe4e66684fcd86f0e6b78bcc7b815a951e3018'],0,2,2,6027895,1,0,0,0,5340
4f2a8158599a4c2201f43d721c93a79c71a67e19,1,Impala Public Jenkins,2018-07-18 03:14:48+00:00,['980076117f43d2189b5fc9484ef0c1c54c2c18c1'],34,26,60,6027955,2,1,1,0,5340
c0e00cad96338ca006638c58453627109b4415e0,1,Impala Public Jenkins,2018-07-18 03:33:29+00:00,['4f2a8158599a4c2201f43d721c93a79c71a67e19'],51,93,144,6028099,7,0.060606061,0.242424242,0.878787879,5340
bc6946599298a3bb05a78b22483321b2608f0b18,0,Impala Public Jenkins,2018-07-18 21:30:32+00:00,['c0e00cad96338ca006638c58453627109b4415e0'],1057,320,1377,6029476,2,,,,5340
add651c11b135146c278ac78d14ebf97cfe7da93,0,Impala Public Jenkins,2018-07-18 21:31:00+00:00,['bc6946599298a3bb05a78b22483321b2608f0b18'],7,3,10,6029486,1,,,,5340
b90ce3f06891fbaa913f9d85fca977e886e042ed,0,Impala Public Jenkins,2018-07-18 21:52:46+00:00,['add651c11b135146c278ac78d14ebf97cfe7da93'],2,2,4,6029490,1,,,,5340
8c284e771c6933f51e0010379bc98c43e4407867,1,Fredy Wijaya,2018-07-18 22:42:09+00:00,['b90ce3f06891fbaa913f9d85fca977e886e042ed'],1,1,2,6029492,1,,,,5340
2008702759d16460803b6e190173f887cc6ef832,0,Impala Public Jenkins,2018-07-18 23:32:07+00:00,['8c284e771c6933f51e0010379bc98c43e4407867'],2,39,41,6029533,3,,,,5341
940d536f21160cd93a900aa70c003b6d1cb1fac8,0,Impala Public Jenkins,2018-07-19 04:34:58+00:00,['2008702759d16460803b6e190173f887cc6ef832'],2,2,4,6029537,1,,,,5341
c7d2c2ec73a5e2073de22e10742faa0553c5018d,0,Impala Public Jenkins,2018-07-19 05:00:10+00:00,['940d536f21160cd93a900aa70c003b6d1cb1fac8'],27,33,60,6029597,10,0.4,1,0,5341
70e2d57fc06499d3eb7c278c28daf51f782d93b3,1,Impala Public Jenkins,2018-07-19 09:49:26+00:00,['c7d2c2ec73a5e2073de22e10742faa0553c5018d'],1,1,2,6029599,1,,,,5341
1d491d64803908ece376df2d445c7a7f6d5920c8,1,Fredy Wijaya,2018-07-19 15:32:46+00:00,['70e2d57fc06499d3eb7c278c28daf51f782d93b3'],15,70,85,6029684,2,0.272727273,0.272727273,1,5341
2a40e8f2a973391b61165ebd95cb30b9b67d93ba,0,Impala Public Jenkins,2018-07-19 20:35:31+00:00,['1d491d64803908ece376df2d445c7a7f6d5920c8'],6,5,11,6029695,1,1,0,1,5341
649397e37dd9b33b4df7b743b8d2e1c67b2c3ad7,0,Impala Public Jenkins,2018-07-20 01:59:23+00:00,['2a40e8f2a973391b61165ebd95cb30b9b67d93ba'],4,8,12,6029707,1,1,1,1,5341
eaea7d289aa8d9bd4944d9ae59639e965f19d76b,0,Impala Public Jenkins,2018-07-20 02:19:34+00:00,['649397e37dd9b33b4df7b743b8d2e1c67b2c3ad7'],15,58,73,6029780,1,,,,5341
79eef49248ecc763d54b39cf7b04f1ac5ab46936,0,Impala Public Jenkins,2018-07-20 21:00:00+00:00,['eaea7d289aa8d9bd4944d9ae59639e965f19d76b'],10,23,33,6029813,7,0,0,0.75,5341
42809cbd11e11eb07f861076b722d80c8fef5a02,0,Impala Public Jenkins,2018-07-23 17:47:46+00:00,['79eef49248ecc763d54b39cf7b04f1ac5ab46936'],4,4,8,6029821,1,,,,5341
cb0f8a0ada054cf09995b362e7dd0fe7674e535d,0,Tim Armstrong,2018-07-23 20:17:22+00:00,['42809cbd11e11eb07f861076b722d80c8fef5a02'],13,10,23,6029844,7,,,,5341
f7efba23607974a9c5d3da02999db531a92628c2,0,Impala Public Jenkins,2018-07-23 22:37:16+00:00,['cb0f8a0ada054cf09995b362e7dd0fe7674e535d'],1,39,40,6029884,2,1,1,0,5342
514dbb79abe3476c18fc4ffbe36c733a7076dcfd,0,Impala Public Jenkins,2018-07-23 23:56:14+00:00,['f7efba23607974a9c5d3da02999db531a92628c2'],29,95,124,6030008,6,0.137931034,1,1,5342
f9e7d938546b5bad607075d4e852e21558d4d67c,0,Impala Public Jenkins,2018-07-24 00:35:48+00:00,['514dbb79abe3476c18fc4ffbe36c733a7076dcfd'],136,87,223,6030231,1,,,,5342
8d7f63865405c50981647ae3198bd4d39b465bf8,1,Impala Public Jenkins,2018-07-24 02:36:50+00:00,['f9e7d938546b5bad607075d4e852e21558d4d67c'],2143,88,2231,6032462,44,0.523364486,0.248331108,0.198931909,5342
ac4acf1b77ccad95528741c255834d8ccdb84518,1,Tianyi Wang,2018-07-24 17:59:41+00:00,['8d7f63865405c50981647ae3198bd4d39b465bf8'],13,49,62,6032524,3,0.76,0.76,1,5342
02389d4dd225573eaace0263bc84ea7cddff3f47,0,Impala Public Jenkins,2018-07-24 18:36:59+00:00,['ac4acf1b77ccad95528741c255834d8ccdb84518'],2,2,4,6032528,1,,,,5342
21d0c06a4cd1963e386f2467c4c9a499facb5c3f,0,Impala Public Jenkins,2018-07-24 19:35:25+00:00,['02389d4dd225573eaace0263bc84ea7cddff3f47'],33,177,210,6032738,4,,,,5343
b76207c5924f163f022264730a7b0d977c663300,0,Todd Lipcon,2018-07-24 20:45:20+00:00,['21d0c06a4cd1963e386f2467c4c9a499facb5c3f'],0,4,4,6032742,1,0,0,1,5343
cdc8b9ba78e6ac336160a916a630ec2b99e3d9f8,0,Impala Public Jenkins,2018-07-25 06:29:14+00:00,['b76207c5924f163f022264730a7b0d977c663300'],1,2,3,6032745,1,,,,5343
73be15409a6fffe45b1423e847c0d2e737c186ca,0,Alex Rodoni,2018-07-25 15:46:12+00:00,['cdc8b9ba78e6ac336160a916a630ec2b99e3d9f8'],12,14,26,6032771,1,,,,5343
def5c881b1dee93848daea52d93a0602e11338ca,0,Alex Rodoni,2018-07-25 19:19:16+00:00,['73be15409a6fffe45b1423e847c0d2e737c186ca'],35,52,87,6032858,1,,,,5343
c333b55260bb5183fbf8e112cc1b3864bd7b383b,1,Todd Lipcon,2018-07-25 19:27:26+00:00,['def5c881b1dee93848daea52d93a0602e11338ca'],343,697,1040,6033898,33,0.515151515,1,0.76969697,5345
ba81386941a7178048fd1469bf6c2a371f253c3e,1,Todd Lipcon,2018-07-25 19:27:26+00:00,['c333b55260bb5183fbf8e112cc1b3864bd7b383b'],28,135,163,6034061,9,0.274509804,1,0.529411765,5345
cec33fa0ae75392668273d40b5a1bc4bbd7e9e2e,1,Todd Lipcon,2018-07-25 19:27:26+00:00,['ba81386941a7178048fd1469bf6c2a371f253c3e'],71,148,219,6034280,19,0.9375,0.9375,0.78125,5345
b0da2e0c1d8ea8b5c1f806b268b725c585421c42,0,Alex Rodoni,2018-07-25 21:50:34+00:00,['cec33fa0ae75392668273d40b5a1bc4bbd7e9e2e'],1,1,2,6034282,1,,,,5345
04ed7ac132d37bff1c648a807059705ae5fac220,0,Todd Lipcon,2018-07-26 00:14:26+00:00,['b0da2e0c1d8ea8b5c1f806b268b725c585421c42'],43,90,133,6034415,5,0.5,0,1,5345
729e1fb6788eee9d48dc73860d4bfc892565d134,0,Alex Rodoni,2018-07-26 23:18:16+00:00,['04ed7ac132d37bff1c648a807059705ae5fac220'],1,1,2,6034417,1,,,,5345
3bbfbb5ed90f67de1fa0c343e6a8c63e796351f6,0,Impala Public Jenkins,2018-07-27 00:11:29+00:00,['729e1fb6788eee9d48dc73860d4bfc892565d134'],25,42,67,6034484,2,1,0.615384615,0,5345
170956b8541a2b159ba711eb1022451f159e3060,1,Tim Armstrong,2018-07-27 05:00:20+00:00,['3bbfbb5ed90f67de1fa0c343e6a8c63e796351f6'],20,86,106,6034590,3,0.736842105,1,1,5346
154c530c296036f65f8f7879e2a0eba101c6aced,0,Impala Public Jenkins,2018-07-27 21:01:35+00:00,['170956b8541a2b159ba711eb1022451f159e3060'],0,10,10,6034600,1,0,0,0,5346
b5608264b4552e44eb73ded1e232a8775c3dba6b,0,Impala Public Jenkins,2018-07-27 22:34:47+00:00,['154c530c296036f65f8f7879e2a0eba101c6aced'],65,53,118,6034718,5,0.333333333,0.333333333,0,5346
10a67509f283e1434aaed0f5d5e03937d3b76aa9,0,Impala Public Jenkins,2018-07-29 02:25:30+00:00,['b5608264b4552e44eb73ded1e232a8775c3dba6b'],2,8,10,6034728,2,0,1,0,5346
9146f73a58c645cd861006cd6c90d9cbf08feeec,0,Impala Public Jenkins,2018-07-31 02:11:52+00:00,['10a67509f283e1434aaed0f5d5e03937d3b76aa9'],1,123,124,6034852,5,0.265957447,0.723404255,1,5346
240fde62d532c7166fc613a97b38c199cec09f1f,0,Impala Public Jenkins,2018-07-31 02:25:27+00:00,['9146f73a58c645cd861006cd6c90d9cbf08feeec'],137,408,545,6035397,6,0.312849162,0.441340782,0.69273743,5346
47b4606742287361b8c3751b4db77ab5b3508783,0,Impala Public Jenkins,2018-07-31 02:30:54+00:00,['240fde62d532c7166fc613a97b38c199cec09f1f'],0,130,130,6035527,1,0.340909091,1,1,5347
3f8375d3e642554b5506f3e731f94e6328fcbcf9,0,Impala Public Jenkins,2018-07-31 02:45:21+00:00,['47b4606742287361b8c3751b4db77ab5b3508783'],27,206,233,6035760,8,0.542553191,1,0.744680851,5347
316b17ac55adb3d1deeb1289b4045688269b201d,0,Impala Public Jenkins,2018-07-31 02:49:48+00:00,['3f8375d3e642554b5506f3e731f94e6328fcbcf9'],0,20,20,6035780,1,,,,5347
b95111094b70a060e145e61013559ba7f2e1799a,0,Alex Rodoni,2018-07-31 18:06:22+00:00,['316b17ac55adb3d1deeb1289b4045688269b201d'],44,221,265,6036045,1,,,,5347
de4bdb0bbfd9a8ef17e020cc4904e3a66d2ac298,1,Impala Public Jenkins,2018-07-31 20:35:27+00:00,['b95111094b70a060e145e61013559ba7f2e1799a'],4,75,79,6036124,2,0.288461538,0.615384615,0.980769231,5347
672a271fd0966bd77f38eda9b6f1e768415bac04,1,Impala Public Jenkins,2018-07-31 21:01:57+00:00,['de4bdb0bbfd9a8ef17e020cc4904e3a66d2ac298'],78,70,148,6036272,8,1,0.65,0,5347
72db58acd054785fa6f57ef775e13e07ea0920a6,1,Impala Public Jenkins,2018-07-31 21:50:33+00:00,['672a271fd0966bd77f38eda9b6f1e768415bac04'],17,56,73,6036345,3,1,1,0.95,5347
abf6f8f465e6b99fdd0a97e12bbde143ef98f3db,0,Impala Public Jenkins,2018-08-01 01:25:38+00:00,['72db58acd054785fa6f57ef775e13e07ea0920a6'],1,8,9,6036354,1,,,,5347
55083f38cce74347a3a528dd59c402f5cfd4441a,1,Tim Armstrong,2018-08-01 17:23:10+00:00,['abf6f8f465e6b99fdd0a97e12bbde143ef98f3db'],5,91,96,6036450,1,0.358974359,0.358974359,0.717948718,5347
87b02e7332fd4d74ec09aa7270f242afb92ed36c,0,Tim Armstrong,2018-08-01 23:44:26+00:00,['55083f38cce74347a3a528dd59c402f5cfd4441a'],3,7,10,6036460,2,,,,5347
9f20b7582a695b802fc4edb740a63a7eebe2bce4,0,Impala Public Jenkins,2018-08-02 01:18:02+00:00,['87b02e7332fd4d74ec09aa7270f242afb92ed36c'],3,3,6,6036466,2,,,,5347
68736bc3784ad69b7f4f485a7a3ec0fc3d8d3a9b,1,Impala Public Jenkins,2018-08-02 01:46:19+00:00,['9f20b7582a695b802fc4edb740a63a7eebe2bce4'],151,313,464,6036930,17,0,0.78313253,0.903614458,5348
a76ea5c2ea055b8ba1aee9df9e574fc31cdebbc0,1,Impala Public Jenkins,2018-08-02 02:20:58+00:00,['68736bc3784ad69b7f4f485a7a3ec0fc3d8d3a9b'],2,16,18,6036948,2,0.833333333,0.833333333,1,5348
7917eac0ad52fbfa4f6e95046986950ea04af676,0,Impala Public Jenkins,2018-08-02 20:21:12+00:00,['a76ea5c2ea055b8ba1aee9df9e574fc31cdebbc0'],15,109,124,6037072,9,0.28,0.6,0.26,5350
fb3d47d3567750f728d0784cf30f53ad6b06865b,1,Impala Public Jenkins,2018-08-02 20:25:31+00:00,['7917eac0ad52fbfa4f6e95046986950ea04af676'],2,3,5,6037077,2,,,,5350
d0ec011b3d50e968cf6c4074e15c0b887d962ab3,0,Alex Rodoni,2018-08-02 22:18:05+00:00,['fb3d47d3567750f728d0784cf30f53ad6b06865b'],3,31,34,6037111,1,,,,5350
479c83cf72f82b86fc08bde93a7910bf456dcae1,0,Alex Rodoni,2018-08-03 02:38:27+00:00,['d0ec011b3d50e968cf6c4074e15c0b887d962ab3'],99,245,344,6037455,1,,,,5350
d5ada970c66ddb22aae5fc7282384e62b729031e,0,Impala Public Jenkins,2018-08-03 08:23:57+00:00,['479c83cf72f82b86fc08bde93a7910bf456dcae1'],2,16,18,6037473,4,,,,5350
dc32bf770381842eaf3f2c123b7899f4a2dda530,1,Impala Public Jenkins,2018-08-03 17:45:25+00:00,['d5ada970c66ddb22aae5fc7282384e62b729031e'],7,159,166,6037639,9,0.382978723,0.787234043,0.680851064,5351
2b4d06710695ecc6b5cc6ae3b1656b3522ba97be,1,Impala Public Jenkins,2018-08-03 19:47:54+00:00,['dc32bf770381842eaf3f2c123b7899f4a2dda530'],20,38,58,6037697,6,,,,5351
2aa9ca25f4e33537cd1da3d373804866d5335262,1,Alex Rodoni,2018-08-03 23:35:07+00:00,['2b4d06710695ecc6b5cc6ae3b1656b3522ba97be'],82,51,133,6037830,1,,,,5351
504e9955a1481425c9fde64f9259d4b16b0f27c5,0,Impala Public Jenkins,2018-08-04 17:42:07+00:00,['2aa9ca25f4e33537cd1da3d373804866d5335262'],2,42,44,6037874,3,0.24137931,0.24137931,1,5351
34fd9732e6fa66c7eec41317bbec3486063559eb,1,Impala Public Jenkins,2018-08-04 21:23:18+00:00,['504e9955a1481425c9fde64f9259d4b16b0f27c5'],1,1,2,6037876,1,,,,5351
312a8d60dd0f8f9efa4072a3f12579640857abc5,0,Alex Rodoni,2018-08-06 15:59:48+00:00,['34fd9732e6fa66c7eec41317bbec3486063559eb'],115,631,746,6038622,4,,,,5352
3334c167a69a6506d595898dff73fb16410266e6,0,Bharath Vissapragada,2018-08-06 16:29:10+00:00,['312a8d60dd0f8f9efa4072a3f12579640857abc5'],5,38,43,6038665,3,1,1,1,5352
332d59b1152014d09bec2974a1152facf0d589fc,0,Alex Rodoni,2018-08-06 19:01:20+00:00,['3334c167a69a6506d595898dff73fb16410266e6'],10,63,73,6038738,1,,,,5352
8bd9f175b79f117c425def065dbeaa92098bdecd,0,Impala Public Jenkins,2018-08-06 19:38:45+00:00,['332d59b1152014d09bec2974a1152facf0d589fc'],7,19,26,6038764,3,,,,5352
a0673c058754a323ef88459532f0c19881f3c143,0,Tim Armstrong,2018-08-06 20:19:43+00:00,['8bd9f175b79f117c425def065dbeaa92098bdecd'],2,3,5,6038769,2,1,1,0,5352
e6bf4dc2a1c6205b9ae5d921702340ac0089370e,1,Impala Public Jenkins,2018-08-06 22:05:15+00:00,['a0673c058754a323ef88459532f0c19881f3c143'],750,923,1673,6040442,20,1,1,1,5354
cf5de09761c21aee4f3d571a94fbee5bda306a97,0,Impala Public Jenkins,2018-08-06 22:41:02+00:00,['e6bf4dc2a1c6205b9ae5d921702340ac0089370e'],21,17,38,6040480,2,0,1,0,5354
70bf9ea29636a6fbecfd7a003cc746d3a0046edb,0,Impala Public Jenkins,2018-08-06 23:45:08+00:00,['cf5de09761c21aee4f3d571a94fbee5bda306a97'],2,14,16,6040496,3,1,1,1,5354
df3f1658461553a174dd27fce2edce8594aefd16,1,Impala Public Jenkins,2018-08-07 00:36:15+00:00,['70bf9ea29636a6fbecfd7a003cc746d3a0046edb'],1,17,18,6040514,2,0,0.5625,0.5625,5354
a8d7a50bd51f49c67291915164ad36154e83b8da,1,Impala Public Jenkins,2018-08-07 08:34:33+00:00,['df3f1658461553a174dd27fce2edce8594aefd16'],392,925,1317,6041831,16,0.166666667,0.606060606,0.96969697,5355
75a11d41f714a897b32d5df3217296dbd3fb88a6,0,Impala Public Jenkins,2018-08-07 08:48:05+00:00,['a8d7a50bd51f49c67291915164ad36154e83b8da'],7,15,22,6041853,2,1,1,1,5355
b8222003f9a0a39ea9b22eefe24f7b70102a5a8b,0,Jim Apple,2018-08-07 16:14:36+00:00,['75a11d41f714a897b32d5df3217296dbd3fb88a6'],2,4,6,6041859,1,,,,5355
58191d546ae20eced50c955bd0051c775960bdc1,0,Todd Lipcon,2018-08-07 17:38:04+00:00,['b8222003f9a0a39ea9b22eefe24f7b70102a5a8b'],4,9,13,6041872,2,1,1,1,5355
4aec50484a51610efdea08db7af9e9737b3bc1c2,0,Todd Lipcon,2018-08-07 17:38:04+00:00,['58191d546ae20eced50c955bd0051c775960bdc1'],35,270,305,6042177,12,0.511111111,1,0.8,5356
aa26087fea6f48f3764c9ac39385221737cf4047,0,Todd Lipcon,2018-08-07 17:38:04+00:00,['4aec50484a51610efdea08db7af9e9737b3bc1c2'],70,62,132,6042309,6,0,0,0.5,5356
4a049c61562e6fc5562e3cb41c78161ec32e74f0,0,Todd Lipcon,2018-08-07 17:38:04+00:00,['aa26087fea6f48f3764c9ac39385221737cf4047'],108,101,209,6042518,5,0,0,1,5356
bf06e38df7101e7c504c58373f48c7537f381f2d,0,Todd Lipcon,2018-08-07 17:38:04+00:00,['4a049c61562e6fc5562e3cb41c78161ec32e74f0'],116,123,239,6042757,5,,,,5356
22f167f542edb6a73e4c4e5350e788f6bf2683cb,0,Impala Public Jenkins,2018-08-07 19:01:02+00:00,['bf06e38df7101e7c504c58373f48c7537f381f2d'],18,19,37,6042794,1,,,,5356
d33d5b74c24b452c23f705d51768a86e90d25772,0,Tim Armstrong,2018-08-07 21:18:15+00:00,['22f167f542edb6a73e4c4e5350e788f6bf2683cb'],408,137,545,6043339,6,0.687150838,0.558659218,0.30726257,5356
96e552eb2fa7138e3115ac1eb9c56aa56d445d6e,0,Impala Public Jenkins,2018-08-07 21:23:21+00:00,['d33d5b74c24b452c23f705d51768a86e90d25772'],1,6,7,6043346,1,1,1,0,5356
35bce6b12bc3dc972b7b2a718e66895425a34e1f,0,Todd Lipcon,2018-08-07 23:40:11+00:00,['96e552eb2fa7138e3115ac1eb9c56aa56d445d6e'],61,221,282,6043628,8,0.25,1,0.681818182,5356
cbc8c63ef0446550bd080e226b38307c4de967eb,1,Impala Public Jenkins,2018-08-08 00:16:18+00:00,['35bce6b12bc3dc972b7b2a718e66895425a34e1f'],69,299,368,6043996,7,0.294117647,0.892156863,1,5356
2d6a459c76edbe619543fd50d68be72b79a63bc5,0,Impala Public Jenkins,2018-08-08 00:26:34+00:00,['cbc8c63ef0446550bd080e226b38307c4de967eb'],4,26,30,6044026,2,,,,5356
bf24a814ccf568fd0f165f05c90488ebc4c2db47,1,Todd Lipcon,2018-08-08 03:39:39+00:00,['2d6a459c76edbe619543fd50d68be72b79a63bc5'],70,57,127,6044153,7,0.857142857,1,1,5356
dd8a25d4c2976bddbe40cf7b37a2b69447855f83,0,Alex Rodoni,2018-08-08 20:33:08+00:00,['bf24a814ccf568fd0f165f05c90488ebc4c2db47'],220,179,399,6044552,1,,,,5356
a6c356850bd4606f8506fa763d5f543229dce780,1,Impala Public Jenkins,2018-08-08 20:51:45+00:00,['dd8a25d4c2976bddbe40cf7b37a2b69447855f83'],95,137,232,6044784,5,0,0,1,5356
b9d44aff3ee5850dc7f08ba61091c959f08bc474,0,Todd Lipcon,2018-08-08 21:28:32+00:00,['a6c356850bd4606f8506fa763d5f543229dce780'],94,223,317,6045101,6,1,1,1,5358
3c9fef2aeebcf65c8b87f6e9abe744ab89198828,0,Impala Public Jenkins,2018-08-08 22:03:07+00:00,['b9d44aff3ee5850dc7f08ba61091c959f08bc474'],14,13,27,6045128,2,1,1,0,5358
ab25d34b1c10c0a9673e628ea6246852d535dae2,0,Impala Public Jenkins,2018-08-09 00:34:44+00:00,['3c9fef2aeebcf65c8b87f6e9abe744ab89198828'],1,1,2,6045130,1,,,,5358
b4d20ab78071059a981d7be06726a4042c1227de,0,Tim Armstrong,2018-08-09 00:36:19+00:00,['ab25d34b1c10c0a9673e628ea6246852d535dae2'],0,2,2,6045132,1,,,,5358
2ced56c00b73ecdc92f1021f5d0129a41553e4f2,1,Impala Public Jenkins,2018-08-09 01:04:41+00:00,['b4d20ab78071059a981d7be06726a4042c1227de'],16,45,61,6045193,2,0.166666667,0.166666667,1,5358
5cb956e3fd86ba6f9b49a273737f46467b4a1936,0,Impala Public Jenkins,2018-08-09 03:04:33+00:00,['2ced56c00b73ecdc92f1021f5d0129a41553e4f2'],0,3,3,6045196,1,0,0,1,5358
4976ff3c07f465915ac31312ca67519a600212e6,1,Impala Public Jenkins,2018-08-09 04:33:59+00:00,['5cb956e3fd86ba6f9b49a273737f46467b4a1936'],90,850,940,6046136,19,0.350828729,0.53038674,0.790055249,5363
2868bf569afaf950b79a79a05893f314a9c51387,1,Tianyi Wang,2018-08-09 18:07:40+00:00,['4976ff3c07f465915ac31312ca67519a600212e6'],4,6,10,6046146,3,,,,5363
d958b4779ca3f6403780bc700e4f88a2c18589d7,0,Impala Public Jenkins,2018-08-09 19:18:08+00:00,['2868bf569afaf950b79a79a05893f314a9c51387'],2,4,6,6046152,2,1,1,0,5363
8f9f91f38bebba3c69fc15cc522840941b871658,0,David Knupp,2018-08-09 20:53:48+00:00,['d958b4779ca3f6403780bc700e4f88a2c18589d7'],0,252,252,6046404,6,0.303797468,1,1,5368
7f9a74ffcaf1818f1f3c9d427557acca21a627da,1,Todd Lipcon,2018-08-09 21:39:30+00:00,['8f9f91f38bebba3c69fc15cc522840941b871658'],59,218,277,6046681,4,0,0.530612245,0,5369
3e17705ecaba0b6ab9ae929e6c7c409e0b6aea1d,1,Impala Public Jenkins,2018-08-09 22:18:01+00:00,['7f9a74ffcaf1818f1f3c9d427557acca21a627da'],55,371,426,6047107,15,0.111842105,0.282894737,0.901315789,5370
35713cace06f32a575ddee23863141643dd148a0,1,Todd Lipcon,2018-08-10 05:13:12+00:00,['3e17705ecaba0b6ab9ae929e6c7c409e0b6aea1d'],255,539,794,6047901,9,0.636363636,0.93006993,0.342657343,5371
4af3a7853e9d450675a61bff5b031a12e7a05172,1,Impala Public Jenkins,2018-08-10 09:22:11+00:00,['35713cace06f32a575ddee23863141643dd148a0'],137,408,545,6048446,6,0.312849162,0.441340782,0.69273743,5371
b7d509d76117940a8ee57eb6012063c1a93be59a,1,Impala Public Jenkins,2018-08-10 19:31:30+00:00,['4af3a7853e9d450675a61bff5b031a12e7a05172'],21,1174,1195,6049641,25,0.473214286,0.633928571,0.866071429,5372
9961c33e8af3b7b1fe8af671e77b4ab1cb9203a7,0,Impala Public Jenkins,2018-08-10 19:50:11+00:00,['b7d509d76117940a8ee57eb6012063c1a93be59a'],9,12,21,6049662,1,0,1,1,5372
83fc1fbb6749b5d09089879e5f5e4c618dd91373,1,Impala Public Jenkins,2018-08-11 01:53:51+00:00,['9961c33e8af3b7b1fe8af671e77b4ab1cb9203a7'],17,2,19,6049681,2,0,0,0,5372
7002ad3b35a8217daa0f5a1962eaff338030d327,0,Impala Public Jenkins,2018-08-11 06:02:52+00:00,['83fc1fbb6749b5d09089879e5f5e4c618dd91373'],3,5,8,6049689,3,0,1,1,5372
0f6d051d8520f986bf17e0449305337d4ada067d,0,Impala Public Jenkins,2018-08-13 19:39:38+00:00,['7002ad3b35a8217daa0f5a1962eaff338030d327'],1,3,4,6049693,1,,,,5372
13c6116f76bf2fa568710038d3897a1e248cf243,0,Impala Public Jenkins,2018-08-13 21:02:13+00:00,['0f6d051d8520f986bf17e0449305337d4ada067d'],1,9,10,6049703,2,1,1,0,5372
3cb784310f16547be850228cdf03cfc115721857,0,Impala Public Jenkins,2018-08-13 21:36:16+00:00,['13c6116f76bf2fa568710038d3897a1e248cf243'],2,1,3,6049706,2,,,,5372
2e5df138aaf4354fd4ada69b627842c34fef2e05,1,Impala Public Jenkins,2018-08-13 22:24:41+00:00,['3cb784310f16547be850228cdf03cfc115721857'],0,8,8,6049714,1,0,0,1,5372
b07a65a67afe1ee69f0f8983293671a98aaa04bd,0,Impala Public Jenkins,2018-08-14 00:01:46+00:00,['2e5df138aaf4354fd4ada69b627842c34fef2e05'],3,9,12,6049726,2,0,0.4,1,5372
4ab1b924527afd5189d5795ecb28168fcfb6cd80,0,Impala Public Jenkins,2018-08-14 00:43:23+00:00,['b07a65a67afe1ee69f0f8983293671a98aaa04bd'],10,9,19,6049745,1,0,1,1,5372
884fcf81b8f0df949ee615c6b99694c01500da08,0,Impala Public Jenkins,2018-08-14 01:37:44+00:00,['4ab1b924527afd5189d5795ecb28168fcfb6cd80'],65,54,119,6049864,2,1,1,0.928571429,5372
ea615d1d8026dbe1cda3f5c2b048d210b2df435b,0,Todd Lipcon,2018-08-14 04:14:29+00:00,['884fcf81b8f0df949ee615c6b99694c01500da08'],22,23,45,6049909,5,,,,5372
c0ff4fe8f6caa0047b9c425d497fda5f61d60d04,0,Impala Public Jenkins,2018-08-14 20:09:24+00:00,['ea615d1d8026dbe1cda3f5c2b048d210b2df435b'],18,12,30,6049939,1,1,1,0,5372
7b706750bcb4e3b5009f82b79c135a399173f5e6,0,Tim Armstrong,2018-08-14 21:44:56+00:00,['c0ff4fe8f6caa0047b9c425d497fda5f61d60d04'],28,2,30,6049969,1,1,1,0,5372
2a2c3daaa9fb64b148114cb3fd9bfdc6bb4b37eb,1,Tim Armstrong,2018-08-14 21:46:26+00:00,['7b706750bcb4e3b5009f82b79c135a399173f5e6'],48,85,133,6050102,1,0.272727273,0.03030303,0.818181818,5372
c692e5cc9ec2ab2d626c2510d300a03c27790a9b,1,Impala Public Jenkins,2018-08-15 01:58:18+00:00,['2a2c3daaa9fb64b148114cb3fd9bfdc6bb4b37eb'],10,94,104,6050206,8,0.193548387,0.903225806,0.741935484,5373
415300d0d82d2bdae1e07a6f56091716e40721ed,0,Impala Public Jenkins,2018-08-15 02:14:10+00:00,['c692e5cc9ec2ab2d626c2510d300a03c27790a9b'],0,59,59,6050265,3,,,,5375
cddb35be92b9b91e707aaf1781aed7999344a96a,1,Impala Public Jenkins,2018-08-15 04:15:46+00:00,['415300d0d82d2bdae1e07a6f56091716e40721ed'],22,35,57,6050322,4,1,1,1,5377
1455548c8cd09381fcb74daade870c2e1a5c310a,1,Tim Armstrong,2018-08-15 17:10:48+00:00,['cddb35be92b9b91e707aaf1781aed7999344a96a'],2,5,7,6050329,2,,,,5377
efb82325feefd709da1c2c762ee2faae109bdce8,1,Impala Public Jenkins,2018-08-15 18:22:44+00:00,['1455548c8cd09381fcb74daade870c2e1a5c310a'],48,79,127,6050456,16,0.230769231,0.576923077,0.769230769,5377
b1a5aebb861aefa4a0a2448f20dbe3cf2136769a,0,Alex Rodoni,2018-08-15 20:25:15+00:00,['efb82325feefd709da1c2c762ee2faae109bdce8'],0,9,9,6050465,1,,,,5377
a7c20aef8cd9f682ba8300bb6ff5ef18e661a107,0,Alex Rodoni,2018-08-15 21:53:38+00:00,['b1a5aebb861aefa4a0a2448f20dbe3cf2136769a'],0,186,186,6050651,3,,,,5379
e4ea23178663eaf1860add436897e20cbd2392e0,0,Alex Rodoni,2018-08-15 22:00:13+00:00,['a7c20aef8cd9f682ba8300bb6ff5ef18e661a107'],0,73,73,6050724,1,,,,5379
a23e6f296369854b7fade98bf476242c1201dacc,1,Impala Public Jenkins,2018-08-15 22:02:46+00:00,['e4ea23178663eaf1860add436897e20cbd2392e0'],479,1010,1489,6052213,21,0.355704698,0.818791946,0.533557047,5381
48fdd0b0a89a2949d81b6d3486c202ceb4c5c1c9,0,Alex Rodoni,2018-08-15 23:04:02+00:00,['a23e6f296369854b7fade98bf476242c1201dacc'],0,132,132,6052345,2,,,,5382
29905d1ea41b3c0e7ceebf913981173292dfffbf,1,Impala Public Jenkins,2018-08-16 00:21:54+00:00,['48fdd0b0a89a2949d81b6d3486c202ceb4c5c1c9'],8,7,15,6052360,1,,,,5382
a61ff04fb0a177e10dc6dca1111d60e08c732a87,0,Alex Rodoni,2018-08-16 01:11:02+00:00,['29905d1ea41b3c0e7ceebf913981173292dfffbf'],2,3,5,6052365,2,,,,5382
864be3e60dc1a9863607fbaa4d50c296c6873975,0,Impala Public Jenkins,2018-08-16 05:00:25+00:00,['a61ff04fb0a177e10dc6dca1111d60e08c732a87'],4,2,6,6052371,1,0,0,0,5382
59435fe0a9237eb4772eff10b56840820d5c38f8,0,Impala Public Jenkins,2018-08-16 19:51:22+00:00,['864be3e60dc1a9863607fbaa4d50c296c6873975'],0,11,11,6052382,1,,,,5382
7ccf7369085aa49a8fc0daf6f91d97b8a3135682,1,Impala Public Jenkins,2018-08-16 21:25:00+00:00,['59435fe0a9237eb4772eff10b56840820d5c38f8'],49,444,493,6052875,15,0.11971831,0.521126761,0.964788732,5386
0286142b67c1ed9175da271457b65e642bb4178d,0,David Knupp,2018-08-16 21:59:52+00:00,['7ccf7369085aa49a8fc0daf6f91d97b8a3135682'],57,160,217,6053092,5,0.722222222,1,0.555555556,5388
a8b32dbafa1f015c8316f205e32bbdce349f2474,0,Impala Public Jenkins,2018-08-16 22:12:55+00:00,['0286142b67c1ed9175da271457b65e642bb4178d'],125,176,301,6053393,4,0.846153846,1,1,5388
7c0450d6d4b43ab920d4abf97ee918eeca3e6fcf,1,Todd Lipcon,2018-08-17 00:54:28+00:00,['a8b32dbafa1f015c8316f205e32bbdce349f2474'],50,36,86,6053479,6,0,0,0,5388
199c0f2f9f5ef96e232c53579a21009242ea866c,0,Todd Lipcon,2018-08-17 00:54:41+00:00,['7c0450d6d4b43ab920d4abf97ee918eeca3e6fcf'],1,2,3,6053482,1,,,,5388
1dd4403fdcae665b0f343bf3fb7cb644c1875851,0,Todd Lipcon,2018-08-17 18:41:36+00:00,['199c0f2f9f5ef96e232c53579a21009242ea866c'],10,60,70,6053552,1,1,1,1,5388
83bb4aed71db140ab13b2d727e7e09bb2077ccc6,1,Impala Public Jenkins,2018-08-18 03:05:46+00:00,['1dd4403fdcae665b0f343bf3fb7cb644c1875851'],176,125,301,6053853,4,0.153846154,0,0,5388
1158883e859c38339800053a28dff5454f93ba5b,0,Impala Public Jenkins,2018-08-18 03:44:50+00:00,['83bb4aed71db140ab13b2d727e7e09bb2077ccc6'],33,47,80,6053933,2,0,0.181818182,1,5388
30bb0b3d897e165157dd682846f14b6b8106a87c,0,Todd Lipcon,2018-08-18 04:21:00+00:00,['1158883e859c38339800053a28dff5454f93ba5b'],18,16,34,6053967,12,1,1,1,5388
1d4df94125a5465a118046f3c46c81fde7740d8a,1,Impala Public Jenkins,2018-08-18 06:29:20+00:00,['30bb0b3d897e165157dd682846f14b6b8106a87c'],238,566,804,6054771,4,0,1,1,5388
0a901fcb275058fc4c24e243d2a829dfddfef4d5,1,Impala Public Jenkins,2018-08-18 07:31:27+00:00,['1d4df94125a5465a118046f3c46c81fde7740d8a'],73,195,268,6055039,4,0.15,0.725,1,5388
73d37d6ebbccba7045fff2f228f7364cc1302582,1,Impala Public Jenkins,2018-08-20 01:50:54+00:00,['0a901fcb275058fc4c24e243d2a829dfddfef4d5'],139,174,313,6055352,13,0,0.772727273,0.636363636,5388
f8f200e58ddfb37abac9fedaad7ee4b5516b244f,0,Todd Lipcon,2018-08-20 18:15:57+00:00,['73d37d6ebbccba7045fff2f228f7364cc1302582'],102,0,102,6055454,1,0,0,0.289473684,5388
dccc2de86a01e1a109f215c1a08d118471f57ca4,1,Thomas Marshall,2018-08-20 19:56:11+00:00,['f8f200e58ddfb37abac9fedaad7ee4b5516b244f'],1,17,18,6055472,2,1,1,1,5388
d29300281b5d07c1ed98032536c008b076a7baa5,0,Todd Lipcon,2018-08-20 20:32:42+00:00,['dccc2de86a01e1a109f215c1a08d118471f57ca4'],26,86,112,6055584,6,1,0.724137931,1,5388
8360277eaf6ab9743f253105dbaa25ecdfd6c5e7,0,Impala Public Jenkins,2018-08-21 09:44:20+00:00,['d29300281b5d07c1ed98032536c008b076a7baa5'],8,14,22,6055606,2,0,0,1,5388
ef15da08aa124126805201ba0c7199e22c0dcdb7,1,Todd Lipcon,2018-08-21 16:17:03+00:00,['8360277eaf6ab9743f253105dbaa25ecdfd6c5e7'],280,1640,1920,6057526,38,0.52,0.681481481,0.691851852,5391
3fa05604aca2d8f65b3ded4950df8f38fffe43d5,1,Todd Lipcon,2018-08-21 16:17:03+00:00,['ef15da08aa124126805201ba0c7199e22c0dcdb7'],38,538,576,6058102,6,0.491452991,0.85042735,0.790598291,5392
f849eff42134e7d11311acaf834d20ddceefeb60,1,Impala Public Jenkins,2018-08-21 19:52:40+00:00,['3fa05604aca2d8f65b3ded4950df8f38fffe43d5'],1,3,4,6058106,1,0,1,1,5392
2a60655b09afaa76d3bf2120c7043eb0b22eefcf,0,Impala Public Jenkins,2018-08-21 21:29:07+00:00,['f849eff42134e7d11311acaf834d20ddceefeb60'],14,14,28,6058134,2,0,1,1,5392
bddd7def991f60f87772299df1aa53bc0fde48f2,0,Impala Public Jenkins,2018-08-21 21:38:11+00:00,['2a60655b09afaa76d3bf2120c7043eb0b22eefcf'],0,13,13,6058147,2,1,1,1,5392
3ff4cde772b96e040316e6a08e384b5e065c79b7,0,Tim Armstrong,2018-08-21 22:06:02+00:00,['bddd7def991f60f87772299df1aa53bc0fde48f2'],0,7,7,6058154,2,1,1,1,5392
bdd904922a220c37326928ac674779acaef5f6fa,0,Impala Public Jenkins,2018-08-22 02:22:50+00:00,['3ff4cde772b96e040316e6a08e384b5e065c79b7'],7,62,69,6058223,3,0,0.928571429,1,5392
fccaa72366e972228178687adcb0ee1d8e8c5930,0,Impala Public Jenkins,2018-08-22 06:07:51+00:00,['bdd904922a220c37326928ac674779acaef5f6fa'],50,26,76,6058299,14,0,0,0.066666667,5392
c0c3de2057307883fb258f00d1aa6871b88906e0,1,Impala Public Jenkins,2018-08-22 09:06:58+00:00,['fccaa72366e972228178687adcb0ee1d8e8c5930'],65,118,183,6058482,1,0.538461538,1,1,5392
078232112469c238d5332453627eb37dcb10eb97,1,Todd Lipcon,2018-08-22 16:05:55+00:00,['c0c3de2057307883fb258f00d1aa6871b88906e0'],12,113,125,6058607,7,0.428571429,1,1,5392
da01f29d303dca1dbc2be30bc75a72d698a9f4d2,1,Todd Lipcon,2018-08-22 16:05:55+00:00,['078232112469c238d5332453627eb37dcb10eb97'],16,115,131,6058738,10,0.280701754,0.368421053,0.789473684,5392
e27954a5aa585db23fe3c97726aa89305efa306d,1,Impala Public Jenkins,2018-08-22 18:08:20+00:00,['da01f29d303dca1dbc2be30bc75a72d698a9f4d2'],161,115,276,6059014,4,0.506493506,0,1,5393
632e0e2e36463fc8dce7a50ddf2defe8dae25def,0,Impala Public Jenkins,2018-08-22 18:26:23+00:00,['e27954a5aa585db23fe3c97726aa89305efa306d'],125,201,326,6059340,4,0.55,1,1,5393
649f175df08cf4708fe48ab5d4364d1634c16d22,1,Impala Public Jenkins,2018-08-22 21:27:01+00:00,['632e0e2e36463fc8dce7a50ddf2defe8dae25def'],84,236,320,6059660,15,0.266055046,0.798165138,0.256880734,5393
971cf179f674b312cd133397fe74ee8c5f29a215,1,Impala Public Jenkins,2018-08-23 00:20:15+00:00,['649f175df08cf4708fe48ab5d4364d1634c16d22'],82,157,239,6059899,11,0.727272727,1,1,5395
9934b473b7239b1077dad1f0d308e168b803db6d,0,Impala Public Jenkins,2018-08-23 15:55:53+00:00,['971cf179f674b312cd133397fe74ee8c5f29a215'],6,139,145,6060044,9,0.701298701,0.74025974,0.38961039,5397
bb9454fcef73d6686d3e0c03c6c69652909a8b37,0,Impala Public Jenkins,2018-08-23 18:14:41+00:00,['9934b473b7239b1077dad1f0d308e168b803db6d'],1,1,2,6060046,1,,,,5397
6e5ec22b1237f1d466c095c96a2fc1cb71ccb2d9,1,Impala Public Jenkins,2018-08-23 18:33:58+00:00,['bb9454fcef73d6686d3e0c03c6c69652909a8b37'],68,159,227,6060273,46,0,1,0,5398
df1865856a7a9988f946c38deeb39cbb3fff80da,1,Impala Public Jenkins,2018-08-23 19:55:10+00:00,['6e5ec22b1237f1d466c095c96a2fc1cb71ccb2d9'],28,36,64,6060337,8,0,1,1,5398
d1d07f7295ae4d6876097f0f86cb722da63f4caa,0,Alex Rodoni,2018-08-23 20:11:31+00:00,['df1865856a7a9988f946c38deeb39cbb3fff80da'],0,87,87,6060424,2,,,,5399
6ce7ba29586547515221040b5b19b35e9e36ed16,0,Alex Rodoni,2018-08-23 20:16:30+00:00,['d1d07f7295ae4d6876097f0f86cb722da63f4caa'],1,1,2,6060426,1,,,,5399
0d380828d4f18cd138e68cd22720a9fc8e6094bb,0,Alex Rodoni,2018-08-23 22:15:25+00:00,['6ce7ba29586547515221040b5b19b35e9e36ed16'],3,3,6,6060432,1,,,,5399
1d84d68559735e1a20dff8bfa43e3b14334ce9df,1,Impala Public Jenkins,2018-08-24 00:11:53+00:00,['0d380828d4f18cd138e68cd22720a9fc8e6094bb'],1,14,15,6060447,2,0,0,0,5399
063d2c9d554331d75dffe910a7b450bf143842fa,0,Impala Public Jenkins,2018-08-24 01:12:16+00:00,['1d84d68559735e1a20dff8bfa43e3b14334ce9df'],6,7,13,6060460,1,,,,5399
b206aeb71b8795bd14d1ae80b95c4e98829f8dce,0,Impala Public Jenkins,2018-08-24 22:26:25+00:00,['063d2c9d554331d75dffe910a7b450bf143842fa'],1,10,11,6060471,1,0,0.333333333,1,5399
71b36fe08bedb2d9129e2d8d0560f0bc0a055e3e,0,Alex Rodoni,2018-08-24 22:33:37+00:00,['b206aeb71b8795bd14d1ae80b95c4e98829f8dce'],166,0,166,6060637,1,,,,5399
a8f8c8d6f58d750c6949ff89e6f88f608d1ce462,0,Joe McDonnell,2018-08-25 19:26:34+00:00,['71b36fe08bedb2d9129e2d8d0560f0bc0a055e3e'],125,137,262,6060899,1,1,1,1,5399
c285ab9791214097eb377b39c3ddc530f7459894,1,Impala Public Jenkins,2018-08-25 21:57:07+00:00,['a8f8c8d6f58d750c6949ff89e6f88f608d1ce462'],14,114,128,6061027,3,0,0.515625,1,5399
c6ce735d1b2e050f7e363d93267fc4b84e71f2f7,0,Impala Public Jenkins,2018-08-27 21:01:51+00:00,['c285ab9791214097eb377b39c3ddc530f7459894'],6,9,15,6061042,3,,,,5399
547423007b82c8181be277842f092bfd86f5b720,1,Todd Lipcon,2018-08-28 23:40:52+00:00,['c6ce735d1b2e050f7e363d93267fc4b84e71f2f7'],99,223,322,6061364,11,1,1,1,5399
17bfac00f79219d1cd06be436f6f78b974c6811b,0,Alex Rodoni,2018-08-29 00:11:22+00:00,['547423007b82c8181be277842f092bfd86f5b720'],10,9,19,6061383,1,,,,5399
88485880a5e709d78d3a51324448b0f11ba71009,0,Impala Public Jenkins,2018-08-29 20:41:42+00:00,['17bfac00f79219d1cd06be436f6f78b974c6811b'],2,2,4,6061387,1,,,,5399
8692bfbef657fe95da68e9dcaca9b49de331ccc3,1,Impala Public Jenkins,2018-08-29 22:06:00+00:00,['88485880a5e709d78d3a51324448b0f11ba71009'],3,104,107,6061494,4,0.387096774,0.967741935,0.951612903,5399
e8210ab201f1fad874a4b81b418ad36ac71add41,0,Todd Lipcon,2018-08-29 23:10:45+00:00,['8692bfbef657fe95da68e9dcaca9b49de331ccc3'],16,16,32,6061526,8,,,,5399
b97e5ba38dcb8128efc18dbc995307386b8d2210,0,Impala Public Jenkins,2018-08-30 01:11:08+00:00,['e8210ab201f1fad874a4b81b418ad36ac71add41'],43,57,100,6061626,3,0,1,1,5399
5c541b960491ba91533712144599fb3b6d99521d,1,Impala Public Jenkins,2018-08-30 04:06:09+00:00,['b97e5ba38dcb8128efc18dbc995307386b8d2210'],135,332,467,6062093,19,0.394495413,1,1,5400
5f4f01b4da7fb5cf325f10cba879109a7ea7370d,0,Impala Public Jenkins,2018-08-30 17:54:08+00:00,['5c541b960491ba91533712144599fb3b6d99521d'],2,2,4,6062097,1,,,,5400
fa0869d1f20eb52ee2f649622b964abe51b6dc86,0,Impala Public Jenkins,2018-08-30 20:02:23+00:00,['5f4f01b4da7fb5cf325f10cba879109a7ea7370d'],50,76,126,6062223,8,1,1,1,5400
13e93e75bf1cab44f80ceee17b0b0abde8ccd034,0,Todd Lipcon,2018-08-31 17:34:33+00:00,['fa0869d1f20eb52ee2f649622b964abe51b6dc86'],5,12,17,6062240,2,0,0,1,5400
d4e281b734befdd4b4d289526887d1828581925d,1,Impala Public Jenkins,2018-08-31 22:11:22+00:00,['13e93e75bf1cab44f80ceee17b0b0abde8ccd034'],127,376,503,6062743,17,0.535353535,0.939393939,0.808080808,5402
37c66996a0819a81d8b209f73b52fd2c4c99129a,0,Impala Public Jenkins,2018-08-31 23:47:44+00:00,['d4e281b734befdd4b4d289526887d1828581925d'],417,15,432,6063175,3,0.353211009,0,0.770642202,5402
1e7d627d0d32687042b23613d3ef8d58334ff97b,0,Alex Rodoni,2018-09-01 00:51:15+00:00,['37c66996a0819a81d8b209f73b52fd2c4c99129a'],1,1,2,6063177,1,,,,5402
fe613e3247c43bf507b30fd279b73768e36ff5b5,1,Impala Public Jenkins,2018-09-01 03:54:29+00:00,['1e7d627d0d32687042b23613d3ef8d58334ff97b'],0,143,143,6063320,3,0.520833333,0.520833333,0.729166667,5404
357c0a959d1a3a9cb2662773a407acfee3ca6fe2,0,Impala Public Jenkins,2018-09-01 12:00:43+00:00,['fe613e3247c43bf507b30fd279b73768e36ff5b5'],1,5,6,6063326,1,0,0,1,5404
b288a6af2eda9631b2bad91896ae4bfd2a3fdf30,0,Impala Public Jenkins,2018-09-04 17:11:47+00:00,['357c0a959d1a3a9cb2662773a407acfee3ca6fe2'],161,320,481,6063807,6,0.631578947,1,0,5404
c8d21d0137db9bf4c5cac294f8a25aa76da6fcb6,0,Alex Rodoni,2018-09-04 17:44:21+00:00,['b288a6af2eda9631b2bad91896ae4bfd2a3fdf30'],0,111,111,6063918,2,,,,5405
5f5c8612f6db39624b8988d2587781e3a3a29d3f,0,Bharath Vissapragada,2018-09-04 20:17:37+00:00,['c8d21d0137db9bf4c5cac294f8a25aa76da6fcb6'],5,10,15,6063933,1,0,1,1,5405
304e02cf6238a3c1e9537337f802bcf7a92df5db,0,Impala Public Jenkins,2018-09-04 21:58:08+00:00,['5f5c8612f6db39624b8988d2587781e3a3a29d3f'],8,10,18,6063951,1,1,1,0.5,5405
3433d8fe1f5a24c87ee80c9d86e79c4ecda87490,0,Impala Public Jenkins,2018-09-05 03:08:05+00:00,['304e02cf6238a3c1e9537337f802bcf7a92df5db'],1,40,41,6063992,2,,,,5406
72ee4a42753cfd8703ab5935dd61fcc8ad5fb7e1,1,Impala Public Jenkins,2018-09-05 20:49:54+00:00,['3433d8fe1f5a24c87ee80c9d86e79c4ecda87490'],54,628,682,6064674,27,0.442244224,0.666666667,0.620462046,5407
8e7818a2df2abc74859921645f1976ba1cc5f470,1,Impala Public Jenkins,2018-09-05 22:12:24+00:00,['72ee4a42753cfd8703ab5935dd61fcc8ad5fb7e1'],2,5,7,6064681,1,0,0,1,5407
8dcf54aee2b396378aba1cc84426b91d4976eef8,1,Todd Lipcon,2018-09-05 22:51:15+00:00,['8e7818a2df2abc74859921645f1976ba1cc5f470'],100,820,920,6065601,20,0.184952978,0.749216301,0.92476489,5408
37c080bfa8f11542450045e35f99bb132ac8296c,0,Todd Lipcon,2018-09-06 02:39:08+00:00,['8dcf54aee2b396378aba1cc84426b91d4976eef8'],2,6,8,6065609,1,1,1,1,5408
b986f2a8bb9bdfb75edabc20420fa8254f3e899e,1,Todd Lipcon,2018-09-06 02:39:08+00:00,['37c080bfa8f11542450045e35f99bb132ac8296c'],67,272,339,6065948,9,0.385542169,0.048192771,1,5408
0acf1b3a94c874f11508972d1d873969a74e5a20,0,Alex Rodoni,2018-09-06 03:28:21+00:00,['b986f2a8bb9bdfb75edabc20420fa8254f3e899e'],347,569,916,6066864,4,,,,5408
1c6058fa16fc1627799c03112ea3e0ee3c08d0e1,1,Todd Lipcon,2018-09-06 17:27:07+00:00,['0acf1b3a94c874f11508972d1d873969a74e5a20'],170,232,402,6067266,9,0.266666667,0.933333333,0.7,5408
b8d68cad00b0630d0c87032d53a117b2324c10c1,0,Impala Public Jenkins,2018-09-07 13:54:14+00:00,['1c6058fa16fc1627799c03112ea3e0ee3c08d0e1'],0,12,12,6067278,2,0.777777778,1,0.222222222,5408
2a274a1597664ba3127ce869ded522eaedea53b3,0,Impala Public Jenkins,2018-09-07 21:15:45+00:00,['b8d68cad00b0630d0c87032d53a117b2324c10c1'],42,76,118,6067396,13,,,,5408
d19f75764140e3a0a7cd8db4f36791cf635b0dbc,0,Impala Public Jenkins,2018-09-08 00:01:14+00:00,['2a274a1597664ba3127ce869ded522eaedea53b3'],6,5,11,6067407,1,1,1,0,5408
9cfa228c2e1bd65dee4b5c49dcda1dd4f90c3864,0,Philip Zeyliger,2018-09-10 15:59:55+00:00,['d19f75764140e3a0a7cd8db4f36791cf635b0dbc'],1,1,2,6067409,1,,,,5408
dbe0f86e005b07133ef38972905ff1dd2ef35efc,0,Tim Armstrong,2018-09-10 16:09:41+00:00,['9cfa228c2e1bd65dee4b5c49dcda1dd4f90c3864'],18,86,104,6067513,7,1,1,0,5412
a11e50549deeec54400d65696540e832d3650960,0,Tim Armstrong,2018-09-10 21:46:50+00:00,['dbe0f86e005b07133ef38972905ff1dd2ef35efc'],1,8,9,6067522,1,0,0,1,5412
ab6bd74ff73f52a3bd0247027bd82d977189ded6,1,Impala Public Jenkins,2018-09-10 22:05:49+00:00,['a11e50549deeec54400d65696540e832d3650960'],0,51,51,6067573,3,0.34375,0.9375,0.9375,5412
85f3bb0178da0bf62fe462cb28be6ac0ff2fc878,1,Impala Public Jenkins,2018-09-11 01:01:06+00:00,['ab6bd74ff73f52a3bd0247027bd82d977189ded6'],102,151,253,6067826,5,1,1,0.333333333,5412
c28dd512d35d3d3c4e94fb9769bfbe71cc2face7,0,Alex Rodoni,2018-09-11 21:07:32+00:00,['85f3bb0178da0bf62fe462cb28be6ac0ff2fc878'],47,261,308,6068134,4,,,,5414
d91bc44021f28a5d113285be9c920bd1a646a9b9,0,Impala Public Jenkins,2018-09-11 21:08:43+00:00,['c28dd512d35d3d3c4e94fb9769bfbe71cc2face7'],1,1,2,6068136,1,,,,5414
369d5a5b2b49ec1bf5520581641a477de8055706,0,Alex Rodoni,2018-09-11 22:48:05+00:00,['d91bc44021f28a5d113285be9c920bd1a646a9b9'],11,6,17,6068153,2,,,,5414
e6afb6507d7be3840148c2b5bd49d91fef224096,0,Alex Rodoni,2018-09-11 23:22:39+00:00,['369d5a5b2b49ec1bf5520581641a477de8055706'],2,2,4,6068157,1,,,,5414
fda44aed9d4df818e95dc1b7d02ac080cdff1102,0,Impala Public Jenkins,2018-09-11 23:57:20+00:00,['e6afb6507d7be3840148c2b5bd49d91fef224096'],139,1134,1273,6069430,37,0.26142596,0.800731261,0.967093236,5415
cb26d8d82880e934aae9ef211ca7752de510e84a,1,Impala Public Jenkins,2018-09-12 21:10:54+00:00,['fda44aed9d4df818e95dc1b7d02ac080cdff1102'],38,86,124,6069554,2,0.789473684,0.052631579,0.631578947,5415
a0a404441141a8be4502953e0f1242678984aab6,1,Impala Public Jenkins,2018-09-13 09:50:35+00:00,['cb26d8d82880e934aae9ef211ca7752de510e84a'],59,144,203,6069757,2,1,1,0,5415
5129cf94cf90ff84d83e1fb2a477c8d22fbe4eb8,0,Impala Public Jenkins,2018-09-13 20:30:59+00:00,['a0a404441141a8be4502953e0f1242678984aab6'],3,5,8,6069765,1,0,0,1,5415
eb3108c461523915b20f6686d7aabcaddfe79114,1,Impala Public Jenkins,2018-09-13 21:18:56+00:00,['5129cf94cf90ff84d83e1fb2a477c8d22fbe4eb8'],12,74,86,6069851,6,0.947368421,0.947368421,0.210526316,5416
49095c7e8b8ba1f8e69a68f15a322cc1ead13b7e,1,Tianyi Wang,2018-09-13 22:54:49+00:00,['eb3108c461523915b20f6686d7aabcaddfe79114'],25,829,854,6070705,27,0.413202934,0.794621027,0.885085575,5420
36237f7897ad5228f222ab593ef59d3f65e9ce52,1,Alex Rodoni,2018-09-13 23:26:58+00:00,['49095c7e8b8ba1f8e69a68f15a322cc1ead13b7e'],21,6,27,6070732,2,,,,5420
16a04ce81b71462a62858196ad09f4d59bd8489a,0,Tim Armstrong,2018-09-14 01:12:22+00:00,['36237f7897ad5228f222ab593ef59d3f65e9ce52'],1134,139,1273,6072005,37,0.73857404,0.199268739,0.043875686,5420
e5b424ba4eee23a195e105d9160b35313062acd9,0,Impala Public Jenkins,2018-09-14 06:03:44+00:00,['16a04ce81b71462a62858196ad09f4d59bd8489a'],153,1364,1517,6073522,34,0.381048387,0.4375,0.387096774,5424
7793124b6cb7d2e16e7389e59e33cec4963175ad,0,David Knupp,2018-09-14 15:39:30+00:00,['e5b424ba4eee23a195e105d9160b35313062acd9'],17,44,61,6073583,1,0.9375,0.9375,1,5424
2ee8caeb3053dfa2c434c680ffb2ac756627ee38,1,Impala Public Jenkins,2018-09-17 14:19:00+00:00,['7793124b6cb7d2e16e7389e59e33cec4963175ad'],108,378,486,6074069,9,0.385416667,0,0.755208333,5424
7eb64a9be7bb06d1c6f2c8fd1805c12cf61d1844,0,Impala Public Jenkins,2018-09-17 21:49:01+00:00,['2ee8caeb3053dfa2c434c680ffb2ac756627ee38'],1,7,8,6074077,2,1,1,1,5424
94cfdac664cbc9644c4873407783727ff0b87710,1,Impala Public Jenkins,2018-09-17 22:00:04+00:00,['7eb64a9be7bb06d1c6f2c8fd1805c12cf61d1844'],68,192,260,6074337,5,0.164179104,0.746268657,0.656716418,5424
463f2244afec8ca332971b33ede1884b678dec30,0,Impala Public Jenkins,2018-09-18 00:37:50+00:00,['94cfdac664cbc9644c4873407783727ff0b87710'],12,26,38,6074375,3,1,1,1,5424
23da6241136371e0d4e5bca91af24d039e9be7c8,0,Impala Public Jenkins,2018-09-18 02:11:48+00:00,['463f2244afec8ca332971b33ede1884b678dec30'],1364,153,1517,6075892,34,0.618951613,0.5625,0.612903226,5424
b84e22e51bdb0cc021b2104fd62df030056ec8b0,1,Impala Public Jenkins,2018-09-18 02:47:09+00:00,['23da6241136371e0d4e5bca91af24d039e9be7c8'],4,9,13,6075905,1,,,,5424
f46691a3f3f0f018f62c04bbf139087085517082,0,Impala Public Jenkins,2018-09-18 19:38:22+00:00,['b84e22e51bdb0cc021b2104fd62df030056ec8b0'],1,1,2,6075907,1,,,,5424
038af345933fde4fbcc9bc524f4ca93bfc08c633,1,Impala Public Jenkins,2018-09-18 20:01:16+00:00,['f46691a3f3f0f018f62c04bbf139087085517082'],5,8,13,6075920,1,1,1,1,5424
109028e89ce27880cc2ef69a7a5032c05df4d4df,0,Zoltan Borok-Nagy,2018-09-19 10:16:20+00:00,['038af345933fde4fbcc9bc524f4ca93bfc08c633'],320,161,481,6076401,6,0.368421053,0,1,5424
1d4a3f0e4f1f34e09759160981eca2d666ca58d3,0,Impala Public Jenkins,2018-09-19 13:24:06+00:00,['109028e89ce27880cc2ef69a7a5032c05df4d4df'],1,1,2,6076403,1,,,,5424
e4b349e15a47fc113f20233fed19d2a494f5878c,0,Impala Public Jenkins,2018-09-19 22:07:06+00:00,['1d4a3f0e4f1f34e09759160981eca2d666ca58d3'],3,2,5,6076408,1,1,0,0,5424
4845f98beecc90775f58e8e3eb72721e02252f18,1,Impala Public Jenkins,2018-09-19 22:19:07+00:00,['e4b349e15a47fc113f20233fed19d2a494f5878c'],67,86,153,6076561,17,1,0.666666667,1,5424
23f5338bf6f133bf06a10f786200ef4ca3a4df0a,1,Impala Public Jenkins,2018-09-20 00:51:28+00:00,['4845f98beecc90775f58e8e3eb72721e02252f18'],153,1364,1517,6078078,34,0.381048387,0.4375,0.387096774,5428
e563a8dd39f66c45faf917f890c20897fee50ebd,1,Impala Public Jenkins,2018-09-20 02:12:21+00:00,['23f5338bf6f133bf06a10f786200ef4ca3a4df0a'],4,7,11,6078089,1,,,,5428
b727bb03fda35e4c955277a55e81bf57bfb99690,0,Impala Public Jenkins,2018-09-20 21:38:21+00:00,['e563a8dd39f66c45faf917f890c20897fee50ebd'],8,95,103,6078192,2,1,1,1,5428
a9d0305c765312d4d65a36d8bc8209a9418f98d2,0,Impala Public Jenkins,2018-09-20 22:03:27+00:00,['b727bb03fda35e4c955277a55e81bf57bfb99690'],1,1,2,6078194,1,,,,5428
ad3e1c94abc9a4c9bf37b5c42dafd149537375dc,1,Impala Public Jenkins,2018-09-20 22:54:04+00:00,['a9d0305c765312d4d65a36d8bc8209a9418f98d2'],40,40,80,6078274,2,1,1,0,5428
d7b8275ed04581c4b9bef60ae0abdb7201661618,1,Impala Public Jenkins,2018-09-21 15:59:16+00:00,['ad3e1c94abc9a4c9bf37b5c42dafd149537375dc'],400,738,1138,6079412,11,1,0.96969697,0.484848485,5434
6f9e305122970c72a353ebf10bd862cc9d704ade,0,Alex Rodoni,2018-09-21 18:22:06+00:00,['d7b8275ed04581c4b9bef60ae0abdb7201661618'],17,41,58,6079470,2,,,,5434
3fd85782680ebefed218db110c83b468ee4511d7,0,Alex Rodoni,2018-09-21 23:54:10+00:00,['6f9e305122970c72a353ebf10bd862cc9d704ade'],4,6,10,6079480,1,,,,5434
083352b1e7e39e53d7146f37d206443057778653,0,Impala Public Jenkins,2018-09-22 00:20:19+00:00,['3fd85782680ebefed218db110c83b468ee4511d7'],5,14,19,6079499,6,1,1,1,5434
d81d5086bf29bd81a30fe1ab5287615ee613c02f,0,Bharath Vissapragada,2018-09-24 17:31:05+00:00,['083352b1e7e39e53d7146f37d206443057778653'],4,7,11,6079510,1,1,1,1,5434
8c330adf409aa74857b23ba345f0c710a1f25a32,1,Impala Public Jenkins,2018-09-24 19:52:44+00:00,['d81d5086bf29bd81a30fe1ab5287615ee613c02f'],15,315,330,6079840,10,0.42962963,0.896296296,0.703703704,5435
16f9437b4b86c444e80f54fc19f35f1cb8bae920,1,Impala Public Jenkins,2018-09-24 20:02:40+00:00,['8c330adf409aa74857b23ba345f0c710a1f25a32'],4,19,23,6079863,1,0,0.5,0.75,5435
89724d8a3a5f943cbc94e4c88ce23810dd20de67,0,Impala Public Jenkins,2018-09-24 20:09:15+00:00,['16f9437b4b86c444e80f54fc19f35f1cb8bae920'],0,21,21,6079884,2,,,,5436
cf7f221d2fe89681d0fb357ce47204d0366e3dfe,1,Impala Public Jenkins,2018-09-24 20:24:26+00:00,['89724d8a3a5f943cbc94e4c88ce23810dd20de67'],1,61,62,6079946,2,0.130434783,0.130434783,1,5436
15e40a3c9407e5f3d9cf44bfd270b2c4bbc842e9,0,Impala Public Jenkins,2018-09-24 20:26:44+00:00,['cf7f221d2fe89681d0fb357ce47204d0366e3dfe'],0,66,66,6080012,6,0.8,1,1,5436
a72c096f87c2b11a16ce4d998570d8336ade1bec,0,Impala Public Jenkins,2018-09-24 22:24:43+00:00,['15e40a3c9407e5f3d9cf44bfd270b2c4bbc842e9'],1,1,2,6080014,1,,,,5436
4c656677accc9948a55b534619e3a81fd49808a9,1,Impala Public Jenkins,2018-09-25 00:14:56+00:00,['a72c096f87c2b11a16ce4d998570d8336ade1bec'],3,9,12,6080026,2,0,1,1,5436
f970b755c38ec86425f911400605d0018355ebb5,0,Impala Public Jenkins,2018-09-25 03:29:51+00:00,['4c656677accc9948a55b534619e3a81fd49808a9'],17,100,117,6080143,2,0,1,1,5436
f8b472ee6442e31a867a6dd6aaac22cc44291d41,0,Impala Public Jenkins,2018-09-25 03:44:57+00:00,['f970b755c38ec86425f911400605d0018355ebb5'],378,108,486,6080629,9,0.614583333,1,0.244791667,5436
e38715e25297cc3643482be04e3b1b273e339b54,0,Impala Public Jenkins,2018-09-25 04:52:12+00:00,['f8b472ee6442e31a867a6dd6aaac22cc44291d41'],10,79,89,6080718,1,0.479166667,0.958333333,0.979166667,5436
17bc980d9540b29a1667841b7bffc2084204ac35,0,Alex Rodoni,2018-09-25 19:42:59+00:00,['e38715e25297cc3643482be04e3b1b273e339b54'],0,120,120,6080838,2,,,,5437
c5dc6ded68c62f9f2138ab3376531c6292d1df78,1,Impala Public Jenkins,2018-09-25 22:21:57+00:00,['17bc980d9540b29a1667841b7bffc2084204ac35'],198,483,681,6081519,8,0,0.413793103,0.193103448,5438
48640b5dfa131ca0c7ae9e541e376d11ac6e6d33,1,Impala Public Jenkins,2018-09-25 23:03:27+00:00,['c5dc6ded68c62f9f2138ab3376531c6292d1df78'],55,103,158,6081677,6,0.05,0.05,1,5438
f46de21140f3bb483884fc49f5ded7afc466faac,1,Impala Public Jenkins,2018-09-26 01:28:36+00:00,['48640b5dfa131ca0c7ae9e541e376d11ac6e6d33'],139,1140,1279,6082956,37,0.26142596,0.800731261,0.956124314,5439
91673fee607b552f142c6ab2aad0e96efa9e0f80,0,Impala Public Jenkins,2018-09-26 02:20:45+00:00,['f46de21140f3bb483884fc49f5ded7afc466faac'],40,47,87,6083043,1,0,0.5,0,5439
df53ec2385190bba2b3cefb43b094cde6d33642f,1,Impala Public Jenkins,2018-09-26 03:54:49+00:00,['91673fee607b552f142c6ab2aad0e96efa9e0f80'],831,5881,6712,6089755,51,0.313751669,0.531375167,0.826435247,5450
ce145ffee6ee68a60c4ef663cb9f47f22d9eb19f,0,Impala Public Jenkins,2018-09-26 06:51:56+00:00,['df53ec2385190bba2b3cefb43b094cde6d33642f'],1,1,2,6089757,1,,,,5450
09150f04cac84965e3b390404c57a51261aecf56,0,Impala Public Jenkins,2018-09-26 19:56:11+00:00,['ce145ffee6ee68a60c4ef663cb9f47f22d9eb19f'],0,2,2,6089759,1,,,,5450
009b252eb63d8977a31a21d5590b926bbc88e0d7,1,Impala Public Jenkins,2018-09-26 23:56:48+00:00,['09150f04cac84965e3b390404c57a51261aecf56'],0,15,15,6089774,1,,,,5450
abd230647fa92db29ac3719096eb4ebc7c151069,1,Impala Public Jenkins,2018-09-27 01:55:09+00:00,['009b252eb63d8977a31a21d5590b926bbc88e0d7'],145,389,534,6090308,12,0.851851852,1,0.925925926,5452
8f766f02c0116812c25bfa88c7fcf15b8f058b63,1,Impala Public Jenkins,2018-09-27 02:51:33+00:00,['abd230647fa92db29ac3719096eb4ebc7c151069'],142,158,300,6090608,15,0,1,1,5452
1c94450ca92606fb6b708de2ea07445cc6610dbf,1,Impala Public Jenkins,2018-09-27 03:42:58+00:00,['8f766f02c0116812c25bfa88c7fcf15b8f058b63'],266,472,738,6091346,8,0.136363636,0.651515152,1,5452
72bb2a6a01e0895b7c8b5c440ff3c1f38e4697e7,0,Impala Public Jenkins,2018-09-27 04:21:04+00:00,['1c94450ca92606fb6b708de2ea07445cc6610dbf'],4,36,40,6091386,2,1,1,1,5452
3f78b74c921508cb30099dc9f809d898ba4aced7,1,Impala Public Jenkins,2018-09-27 19:21:34+00:00,['72bb2a6a01e0895b7c8b5c440ff3c1f38e4697e7'],0,20,20,6091406,4,,,,5452
ba27b038148f0694662c14710f18ee6e94cf82b7,0,Tim Armstrong,2018-09-27 20:41:29+00:00,['3f78b74c921508cb30099dc9f809d898ba4aced7'],33,127,160,6091566,12,1,0.71875,0.15625,5452
90ff232b606f68bd01c2da56fbd47a677a94d5cf,0,Impala Public Jenkins,2018-09-27 21:23:51+00:00,['ba27b038148f0694662c14710f18ee6e94cf82b7'],51,10,61,6091627,1,0,0,0,5452
fcc3b8bf7e09c1dd008f3875089a29f66902973f,0,Alex Rodoni,2018-09-28 01:10:00+00:00,['90ff232b606f68bd01c2da56fbd47a677a94d5cf'],3,1,4,6091631,1,,,,5452
e83fe23a5fd61a279e51d6dd9a979f9db2574dcd,1,Impala Public Jenkins,2018-09-28 01:23:41+00:00,['fcc3b8bf7e09c1dd008f3875089a29f66902973f'],14,14,28,6091659,5,0,0,1,5452
ac33c0c42e1e7cc898893b1ae1f69c13287d20a8,1,Impala Public Jenkins,2018-09-28 02:15:44+00:00,['e83fe23a5fd61a279e51d6dd9a979f9db2574dcd'],30,402,432,6092091,11,0,0.606837607,1,5452
235748316c5cada5c58b3e84a4e20ee57f1c4a49,0,Impala Public Jenkins,2018-09-28 11:22:53+00:00,['ac33c0c42e1e7cc898893b1ae1f69c13287d20a8'],3,93,96,6092187,3,0.185185185,0.833333333,0,5452
34e666f520a5a7ef87f055263f5e4d9df5d888c0,1,Impala Public Jenkins,2018-09-28 17:05:59+00:00,['235748316c5cada5c58b3e84a4e20ee57f1c4a49'],178,1401,1579,6093766,15,0.521428571,0.864285714,0.857142857,5456
cb49371613909e56debee6275fd54759eb36ad33,0,Impala Public Jenkins,2018-09-28 18:14:56+00:00,['34e666f520a5a7ef87f055263f5e4d9df5d888c0'],732,1896,2628,6096394,19,0.357005758,0.746641075,0.616122841,5463
f699a6ce83f2c7b24e6b7b31c5a7647cc132eef6,1,Impala Public Jenkins,2018-09-29 00:08:24+00:00,['cb49371613909e56debee6275fd54759eb36ad33'],5,64,69,6096463,4,0,0.769230769,0.512820513,5463
aa36885aade2a682778898831ba735f12c014da1,0,Impala Public Jenkins,2018-09-29 00:43:59+00:00,['f699a6ce83f2c7b24e6b7b31c5a7647cc132eef6'],36,18,54,6096517,3,1,0,0.692307692,5463
6f7b162154daae4614a6f1da0be920394478b123,1,Impala Public Jenkins,2018-09-29 04:41:30+00:00,['aa36885aade2a682778898831ba735f12c014da1'],12,93,105,6096622,8,0.558139535,1,0.790697674,5463
ddef2cb9b14e7f8cf9a68a2a382e10a8e0f91c3d,1,Impala Public Jenkins,2018-09-29 11:59:03+00:00,['6f7b162154daae4614a6f1da0be920394478b123'],1,658,659,6097281,11,0.221428571,0.669047619,0.464285714,5464
810841115a4f62dffd219cca8a9fbd34ea73e37c,0,Impala Public Jenkins,2018-10-01 13:20:40+00:00,['ddef2cb9b14e7f8cf9a68a2a382e10a8e0f91c3d'],4,57,61,6097342,8,1,1,0.888888889,5465
10bffe2f934720b848acd6b2fe8ce10b282d891d,0,Alex Rodoni,2018-10-01 17:52:05+00:00,['810841115a4f62dffd219cca8a9fbd34ea73e37c'],103,1366,1469,6098811,1,,,,5465
d918b2aeb582ca465dc3e5066a77a7b4dab39641,0,Impala Public Jenkins,2018-10-01 21:33:43+00:00,['10bffe2f934720b848acd6b2fe8ce10b282d891d'],93,3,96,6098907,3,0.814814815,0.166666667,1,5465
a381483e658f824d1639096e03f1a23b2a216c41,0,Impala Public Jenkins,2018-10-01 22:48:46+00:00,['d918b2aeb582ca465dc3e5066a77a7b4dab39641'],1,1,2,6098909,1,,,,5465
de39b0331e1e000162a93bfb90888e2dfbadcd13,1,Impala Public Jenkins,2018-10-02 00:30:18+00:00,['a381483e658f824d1639096e03f1a23b2a216c41'],2,5,7,6098916,1,0,0,1,5465
ade399c08f5a74f87d192b47d2b65c3b56d05f7c,0,Impala Public Jenkins,2018-10-02 00:53:49+00:00,['de39b0331e1e000162a93bfb90888e2dfbadcd13'],1,4,5,6098921,1,0,1,0,5465
d3cf6d325779fff4ab0ba9db53411c510aa0f717,0,Impala Public Jenkins,2018-10-02 01:54:41+00:00,['ade399c08f5a74f87d192b47d2b65c3b56d05f7c'],7,10,17,6098938,1,,,,5465
ea2809f5ddcf48f3f41dcd12743e8a17b4ea8cd7,0,Impala Public Jenkins,2018-10-02 06:49:46+00:00,['d3cf6d325779fff4ab0ba9db53411c510aa0f717'],301,19,320,6099258,10,0.6171875,0.125,0.3125,5465
20bde289ebb6d1097b1afab7ad171498f4d164a7,1,Impala Public Jenkins,2018-10-02 20:24:17+00:00,['ea2809f5ddcf48f3f41dcd12743e8a17b4ea8cd7'],12,27,39,6099297,7,0.875,1,0,5465
e1d1b4f14f1a2d8cab378b419eed3c4e4590a311,0,Impala Public Jenkins,2018-10-02 21:55:44+00:00,['20bde289ebb6d1097b1afab7ad171498f4d164a7'],1,15,16,6099313,3,1,1,0,5465
ccec241637e78a1432653330a45540127eb3e7df,0,Alex Rodoni,2018-10-03 02:16:41+00:00,['e1d1b4f14f1a2d8cab378b419eed3c4e4590a311'],19,22,41,6099354,2,,,,5465
e6bbe4eaf5ba606ea3f4f1ed3360ecf9172a9ec3,1,Impala Public Jenkins,2018-10-04 01:37:45+00:00,['ccec241637e78a1432653330a45540127eb3e7df'],18,301,319,6099673,10,0.3828125,0.875,0.6875,5466
d301600a85f399863d89c281a9a1dc3091d52fcc,1,Impala Public Jenkins,2018-10-04 03:40:44+00:00,['e6bbe4eaf5ba606ea3f4f1ed3360ecf9172a9ec3'],108,371,479,6100152,9,0.368983957,0,0.748663102,5466
93606e6046054526c093975894efc1eef8a53bc1,0,Tim Armstrong,2018-10-04 21:51:50+00:00,['d301600a85f399863d89c281a9a1dc3091d52fcc'],3,25,28,6100180,3,0.1,0.1,0.1,5466
3fabc2de4771349079bcd9dc8bdcb267f43b2a6b,1,Impala Public Jenkins,2018-10-04 22:04:02+00:00,['93606e6046054526c093975894efc1eef8a53bc1'],79,205,284,6100464,9,0.565217391,1,1,5466
80edf37010884d6aa7edae818d8219918ea0809e,0,Alex Rodoni,2018-10-04 23:11:07+00:00,['3fabc2de4771349079bcd9dc8bdcb267f43b2a6b'],50,45,95,6100559,1,,,,5466
c80c62f22d17235774919b5ffcb08a0aea517aea,1,Impala Public Jenkins,2018-10-05 01:36:17+00:00,['80edf37010884d6aa7edae818d8219918ea0809e'],1,104,105,6100664,3,1,1,1,5467
fc91e706b4f3b45cdda28d977f652cee3f050e7b,1,Impala Public Jenkins,2018-10-05 04:38:24+00:00,['c80c62f22d17235774919b5ffcb08a0aea517aea'],268,1077,1345,6102009,30,0.384259259,0.675925926,0.305555556,5471
3a37c724d4940074421745c54eee4d5c29d47c85,0,Impala Public Jenkins,2018-10-05 06:03:39+00:00,['fc91e706b4f3b45cdda28d977f652cee3f050e7b'],12,26,38,6102047,2,0.666666667,1,1,5471
1914a8b5557e835cdf67161af1d12f883dbf25d1,0,Impala Public Jenkins,2018-10-05 19:07:23+00:00,['3a37c724d4940074421745c54eee4d5c29d47c85'],10,10,20,6102067,5,,,,5471
23428dc147fa7ff0b65c4942229e6147bda243d5,0,Alex Rodoni,2018-10-05 19:36:21+00:00,['1914a8b5557e835cdf67161af1d12f883dbf25d1'],68,51,119,6102186,2,,,,5471
37bee3aeca036f3eb96f55425627f02af78a1279,1,Impala Public Jenkins,2018-10-05 20:43:05+00:00,['23428dc147fa7ff0b65c4942229e6147bda243d5'],18,23,41,6102227,1,1,1,0,5471
0e1de31ba56bdac73b8db5c5ff316334c84725d9,1,Impala Public Jenkins,2018-10-05 21:16:17+00:00,['37bee3aeca036f3eb96f55425627f02af78a1279'],25,86,111,6102338,4,0.09375,0.59375,0.78125,5471
f8b2eb585ad4c5a57763e07a88266a3a757432a2,1,Impala Public Jenkins,2018-10-05 22:05:24+00:00,['0e1de31ba56bdac73b8db5c5ff316334c84725d9'],2,2,4,6102342,1,,,,5471
d3db32660537e55948f3132f778d257d078b9197,0,Impala Public Jenkins,2018-10-05 22:30:44+00:00,['f8b2eb585ad4c5a57763e07a88266a3a757432a2'],8,29,37,6102379,3,0.272727273,0.363636364,0.909090909,5471
81c58d5de0d0295b5535ff15afb284bccb6b0026,1,Impala Public Jenkins,2018-10-06 03:13:42+00:00,['d3db32660537e55948f3132f778d257d078b9197'],58,117,175,6102554,1,0.296296296,0.37037037,0.37037037,5471
e5c502e4e428bd1cd5b04f06d72eba8fba61e918,1,Impala Public Jenkins,2018-10-06 07:25:49+00:00,['81c58d5de0d0295b5535ff15afb284bccb6b0026'],2,23,25,6102579,3,0.333333333,0.333333333,0.333333333,5471
843683ed6c2ef41c7c25e9fa4af68801dbdd1a78,1,Impala Public Jenkins,2018-10-08 13:27:49+00:00,['e5c502e4e428bd1cd5b04f06d72eba8fba61e918'],76,105,181,6102760,4,0,1,1,5471
d48ffc2d45b2a9d4b9c730bba5677d3096311a25,1,Bharath Vissapragada,2018-10-08 17:09:40+00:00,['843683ed6c2ef41c7c25e9fa4af68801dbdd1a78'],12,255,267,6103027,13,0.490909091,1,0.990909091,5471
51cc1d2cf78433bcb8aa58f2c0a868ff5ac2154e,0,Alex Rodoni,2018-10-08 17:19:08+00:00,['d48ffc2d45b2a9d4b9c730bba5677d3096311a25'],121,29,150,6103177,3,,,,5471
fec2d64e8f4c5adef7cdb746d8ce946cad75acdd,1,Impala Public Jenkins,2018-10-08 22:19:54+00:00,['51cc1d2cf78433bcb8aa58f2c0a868ff5ac2154e'],86,25,111,6103288,4,0.90625,0.40625,0.21875,5471
d05f73f41588dc1ba08684df63c2da85055be84a,1,Impala Public Jenkins,2018-10-09 00:45:10+00:00,['fec2d64e8f4c5adef7cdb746d8ce946cad75acdd'],149,762,911,6104199,28,0.704918033,0.836065574,0.508196721,5471
122c3667dac4a604adbe6dbe90030f8801b579bc,0,Impala Public Jenkins,2018-10-09 06:09:24+00:00,['d05f73f41588dc1ba08684df63c2da85055be84a'],4,3,7,6104206,2,1,1,0,5471
ee3da43709895450bded45a6aa9bccca947c6add,0,Impala Public Jenkins,2018-10-09 19:12:50+00:00,['122c3667dac4a604adbe6dbe90030f8801b579bc'],13,46,59,6104265,3,1,1,0.5,5471
7b13117293380821c28df81ed8c308623e835dd5,0,Alex Rodoni,2018-10-09 19:18:10+00:00,['ee3da43709895450bded45a6aa9bccca947c6add'],3,0,3,6104268,1,,,,5471
6568e6e110e507f5228c1da11e56fd7117ab8a25,0,Alex Rodoni,2018-10-09 21:57:12+00:00,['7b13117293380821c28df81ed8c308623e835dd5'],22,34,56,6104324,1,,,,5471
9ac874d1be84a591c79fe2ca3ba48b9cbe7c7c70,0,Impala Public Jenkins,2018-10-10 03:00:27+00:00,['6568e6e110e507f5228c1da11e56fd7117ab8a25'],2,6,8,6104332,2,0,1,1,5471
53decbc9fcfe117470df09eb27b361195d704a06,0,Impala Public Jenkins,2018-10-10 09:03:10+00:00,['9ac874d1be84a591c79fe2ca3ba48b9cbe7c7c70'],42,67,109,6104441,7,0.444444444,0.5,0.5,5471
8ca79261a336741f7b537809d2f5de422744d8b3,0,Alex Rodoni,2018-10-10 18:04:21+00:00,['53decbc9fcfe117470df09eb27b361195d704a06'],9,7,16,6104457,1,,,,5471
b0d0d73938b1fe06ea836533babad8d0c2f4bc53,0,Alex Rodoni,2018-10-10 18:06:10+00:00,['8ca79261a336741f7b537809d2f5de422744d8b3'],29,33,62,6104519,1,,,,5471
e8ee827a6d39cf470f33a07e0f760ffc36775e1d,1,Alex Rodoni,2018-10-10 18:18:09+00:00,['b0d0d73938b1fe06ea836533babad8d0c2f4bc53'],2725,3383,6108,6110627,11,,,,5471
6099255fa69d41c5f3dd581a976fd5be3b027f0a,0,Impala Public Jenkins,2018-10-10 23:06:45+00:00,['e8ee827a6d39cf470f33a07e0f760ffc36775e1d'],1,1,2,6110629,1,,,,5471
0cbe37afc8f77fd8e0aef7e710e2d1b214c1c5b1,0,Impala Public Jenkins,2018-10-11 08:44:02+00:00,['6099255fa69d41c5f3dd581a976fd5be3b027f0a'],10,31,41,6110670,1,0,1,0,5471
0047191262d6a90eb704dff880efe6e625b805bc,1,Michael Brown,2018-10-11 16:43:14+00:00,['0cbe37afc8f77fd8e0aef7e710e2d1b214c1c5b1'],5,10,15,6110685,3,0.8,1,1,5471
21f521a7c280031e33cde7c61a979683c5abed00,1,Impala Public Jenkins,2018-10-12 01:00:56+00:00,['0047191262d6a90eb704dff880efe6e625b805bc'],57,87,144,6110829,5,0.5,0.5,0,5471
e65ac1a4341acfce7c1afc08c0c0566ee0ca50ab,0,Impala Public Jenkins,2018-10-12 01:28:07+00:00,['21f521a7c280031e33cde7c61a979683c5abed00'],1,1,2,6110831,1,,,,5471
a80ec4a6d987464352e8f7da89110151569a5a64,1,Impala Public Jenkins,2018-10-12 20:22:48+00:00,['e65ac1a4341acfce7c1afc08c0c0566ee0ca50ab'],95,156,251,6111082,4,0.146341463,1,0.146341463,5472
97f028299c9d9d7493bdbeaacbf0a288678f9371,0,Impala Public Jenkins,2018-10-12 23:44:42+00:00,['a80ec4a6d987464352e8f7da89110151569a5a64'],3,93,96,6111178,3,0.185185185,0.833333333,0,5472
af76186e013607cb64baf151c039e4f6aaab4350,0,Joe McDonnell,2018-10-13 03:26:03+00:00,['97f028299c9d9d7493bdbeaacbf0a288678f9371'],105,76,181,6111359,4,1,0,0,5472
8fc702be0c5017775e99fba0e88772ce3c14eb68,0,Impala Public Jenkins,2018-10-13 06:23:17+00:00,['af76186e013607cb64baf151c039e4f6aaab4350'],87,145,232,6111591,6,0.75,0.916666667,0.333333333,5473
9571b18ca4ad197eee1bb43092f05722de4c8ee5,1,Impala Public Jenkins,2018-10-13 19:02:14+00:00,['8fc702be0c5017775e99fba0e88772ce3c14eb68'],2,2,4,6111595,1,,,,5473
1bfd7ee1c6315cc38126ed81dd757f56e01c5b16,0,Alex Rodoni,2018-10-15 19:35:51+00:00,['9571b18ca4ad197eee1bb43092f05722de4c8ee5'],12,93,105,6111700,4,,,,5474
fe6dabda6a55dcd6f047829012a5f9ebf0755df3,0,Alex Rodoni,2018-10-15 21:51:12+00:00,['1bfd7ee1c6315cc38126ed81dd757f56e01c5b16'],2,14,16,6111716,1,,,,5474
2737e22eeb0dc7b1aa7064e92eb25b67928d033b,0,Impala Public Jenkins,2018-10-16 00:42:24+00:00,['fe6dabda6a55dcd6f047829012a5f9ebf0755df3'],1,1,2,6111718,1,,,,5474
31dfa3e28c2dadb6567c1bc812011286024efa4c,1,Impala Public Jenkins,2018-10-16 00:50:26+00:00,['2737e22eeb0dc7b1aa7064e92eb25b67928d033b'],42,73,115,6111833,2,0,0.857142857,1,5474
3b6c0f6296e807b25f3e40bd614b2571f4f01d48,0,Impala Public Jenkins,2018-10-16 01:13:16+00:00,['31dfa3e28c2dadb6567c1bc812011286024efa4c'],2,4,6,6111839,1,,,,5474
97731e5b85c75ae6fa06af74456428890069ca12,0,Impala Public Jenkins,2018-10-16 01:23:55+00:00,['3b6c0f6296e807b25f3e40bd614b2571f4f01d48'],6,32,38,6111877,1,,,,5474
ec2dabafb989e2aca0fddb8f6c467e6f551d0424,0,Impala Public Jenkins,2018-10-16 01:47:05+00:00,['97731e5b85c75ae6fa06af74456428890069ca12'],13,89,102,6111979,4,0,0,1,5474
ad265842b691927e1c204203390172a92dc38a68,0,Impala Public Jenkins,2018-10-16 10:12:03+00:00,['ec2dabafb989e2aca0fddb8f6c467e6f551d0424'],86,102,188,6112167,5,0.666666667,0.666666667,0,5475
96debe0a5c701781029908848437b66fcc5fff25,0,Alex Rodoni,2018-10-17 01:34:31+00:00,['ad265842b691927e1c204203390172a92dc38a68'],317,444,761,6112928,2,,,,5475
28aecd6db8e9c330c73ee906eac88ec5f2bb2056,0,Alex Rodoni,2018-10-17 01:41:13+00:00,['96debe0a5c701781029908848437b66fcc5fff25'],5,7,12,6112940,1,,,,5475
2b2cf8d96617320d184d070f9319c2463aa0d84f,1,Impala Public Jenkins,2018-10-17 04:03:53+00:00,['28aecd6db8e9c330c73ee906eac88ec5f2bb2056'],3,60,63,6113003,6,0.358974359,0.923076923,1,5475
0cd9151801cf446330b129b0609d6cedd4b98f06,1,Impala Public Jenkins,2018-10-17 05:33:05+00:00,['2b2cf8d96617320d184d070f9319c2463aa0d84f'],0,67,67,6113070,2,0.586956522,1,1,5475
5e92d139b951e77d3f9f355c1e46736454a654b0,1,Impala Public Jenkins,2018-10-17 05:39:32+00:00,['0cd9151801cf446330b129b0609d6cedd4b98f06'],52,110,162,6113232,6,0.551724138,0.551724138,0.931034483,5475
a0f351a647b7f48468e6dd3877a16947a746ab9c,0,Alex Rodoni,2018-10-17 18:49:55+00:00,['5e92d139b951e77d3f9f355c1e46736454a654b0'],94,120,214,6113446,2,,,,5475
6c0512e1a329ada236f2b1e047179beca9dc2e5a,0,Alex Rodoni,2018-10-17 19:20:13+00:00,['a0f351a647b7f48468e6dd3877a16947a746ab9c'],7,4,11,6113457,1,,,,5475
275124e874f946cb12c4b97c655409107efbcc3c,0,Alex Rodoni,2018-10-17 19:49:58+00:00,['6c0512e1a329ada236f2b1e047179beca9dc2e5a'],1,1,2,6113459,1,,,,5475
de7f09d726240a32739d59fe16faec5792e7c7a3,1,Impala Public Jenkins,2018-10-17 19:57:17+00:00,['275124e874f946cb12c4b97c655409107efbcc3c'],103,122,225,6113684,4,0.666666667,1,1,5475
6399a65a00cfb6b48da29acbb0921a360bf3a019,0,Joe McDonnell,2018-10-17 21:31:24+00:00,['de7f09d726240a32739d59fe16faec5792e7c7a3'],162,206,368,6114052,2,1,1,1,5476
5af5456a2d95a43ce63f4e364ff0b9631729bb1a,0,Impala Public Jenkins,2018-10-18 00:57:47+00:00,['6399a65a00cfb6b48da29acbb0921a360bf3a019'],4,3,7,6114059,1,,,,5476
2fb8ebaef2beecd511e963fadbb41cbb11add138,1,Impala Public Jenkins,2018-10-18 01:41:42+00:00,['5af5456a2d95a43ce63f4e364ff0b9631729bb1a'],15,52,67,6114126,5,0,0.916666667,0.833333333,5476
48fb4902d4f28c9e4d327b80b00b33962c118c22,1,Impala Public Jenkins,2018-10-18 20:33:36+00:00,['2fb8ebaef2beecd511e963fadbb41cbb11add138'],158,511,669,6114795,15,0.328767123,0.607305936,0.365296804,5477
9f5c5e6df03824cba292fe5a619153462c11669c,1,Impala Public Jenkins,2018-10-18 20:56:52+00:00,['48fb4902d4f28c9e4d327b80b00b33962c118c22'],49,113,162,6114957,9,0,0.923076923,1,5477
5cc49c343f8558602af2663e3bb519da6d9852cc,1,Impala Public Jenkins,2018-10-19 00:20:12+00:00,['9f5c5e6df03824cba292fe5a619153462c11669c'],101,289,390,6115347,3,0.850746269,0.992537313,0.507462687,5477
8c93a456891587c1add30a08fa8ab395208e0cf1,0,Impala Public Jenkins,2018-10-19 09:22:05+00:00,['5cc49c343f8558602af2663e3bb519da6d9852cc'],56,25,81,6115428,5,0.518518519,0,0,5477
072f3ee9045d62cceb23f1f416f3052e0024cdcd,1,Impala Public Jenkins,2018-10-19 21:48:28+00:00,['8c93a456891587c1add30a08fa8ab395208e0cf1'],7,61,68,6115496,5,0.944444444,1,0,5477
bad49e73632f64a386ad1154201f99137af864d8,1,Impala Public Jenkins,2018-10-20 00:19:18+00:00,['072f3ee9045d62cceb23f1f416f3052e0024cdcd'],13,260,273,6115769,6,0,0.504950495,0.886138614,5477
77c56a805abf23db27db493ed12af965e515428d,0,Impala Public Jenkins,2018-10-20 03:32:07+00:00,['bad49e73632f64a386ad1154201f99137af864d8'],1,1,2,6115771,1,,,,5477
0340a153ceed2ac6897569faf158e357f8f628df,0,Impala Public Jenkins,2018-10-20 03:43:41+00:00,['77c56a805abf23db27db493ed12af965e515428d'],6,1,7,6115778,1,,,,5477
7a022cf36a2c678dcff02d48db0641e6f74f068f,1,Impala Public Jenkins,2018-10-20 06:43:00+00:00,['0340a153ceed2ac6897569faf158e357f8f628df'],32,360,392,6116170,48,0.726415094,0.396226415,0.679245283,5478
52c3a89a2272886d4944b8b553a0c095d5a273e8,0,Alex Rodoni,2018-10-22 23:22:10+00:00,['7a022cf36a2c678dcff02d48db0641e6f74f068f'],0,24,24,6116194,1,,,,5478
1104f6785b44535d1bbd38b338c18fa6febbf2c3,1,Impala Public Jenkins,2018-10-23 01:35:25+00:00,['52c3a89a2272886d4944b8b553a0c095d5a273e8'],13,15,28,6116222,5,,,,5478
0e80b4b1851c54bb082d5523e96ef4951f5532fe,0,Alex Rodoni,2018-10-23 19:37:36+00:00,['1104f6785b44535d1bbd38b338c18fa6febbf2c3'],10,14,24,6116246,1,,,,5478
e0c54b7c8ee05a88cec6f4f7a479971c45271bbb,0,Impala Public Jenkins,2018-10-23 21:50:16+00:00,['0e80b4b1851c54bb082d5523e96ef4951f5532fe'],31,43,74,6116320,3,0,0,0,5478
e00c0822abaa12cb7a99b6b78ce3fc25d5cd2e11,0,Alex Rodoni,2018-10-24 00:38:35+00:00,['e0c54b7c8ee05a88cec6f4f7a479971c45271bbb'],67,92,159,6116479,1,,,,5478
15e8ce4f273945ce548fe677ee0140dea8068e6d,1,Impala Public Jenkins,2018-10-24 01:03:38+00:00,['e00c0822abaa12cb7a99b6b78ce3fc25d5cd2e11'],1,16,17,6116496,2,,,,5478
1d72c7584fd33746b17826c1dc54a1819fce9ec5,0,Impala Public Jenkins,2018-10-24 20:27:36+00:00,['15e8ce4f273945ce548fe677ee0140dea8068e6d'],0,5,5,6116501,2,,,,5478
8cbec20ea4f1399fce14018d30050d4b7ee501bc,1,Impala Public Jenkins,2018-10-25 21:17:12+00:00,['1d72c7584fd33746b17826c1dc54a1819fce9ec5'],831,920,1751,6118252,13,0.956521739,1,1,5478
1dbb3c1be634c2a3e356c3b2ee5deac2436c9815,0,Impala Public Jenkins,2018-10-25 23:52:58+00:00,['8cbec20ea4f1399fce14018d30050d4b7ee501bc'],18,26,44,6118296,1,0,0.142857143,0.714285714,5478
93ee538c5403509804cb18411e4407352f5b242b,0,Tim Armstrong,2018-10-26 01:50:16+00:00,['1dbb3c1be634c2a3e356c3b2ee5deac2436c9815'],6,9,15,6118311,3,,,,5478
9bd22a3ce65a3186153b5d7988eae2bb48559b26,0,Alex Rodoni,2018-10-26 02:17:07+00:00,['93ee538c5403509804cb18411e4407352f5b242b'],16,11,27,6118338,1,,,,5478
c1701074d6e94d98a43ab049ef807ac1b368180f,1,Impala Public Jenkins,2018-10-26 08:43:22+00:00,['9bd22a3ce65a3186153b5d7988eae2bb48559b26'],62,167,229,6118567,3,0,0.25,0.75,5478
de0c6bd6bd0db163d2820ae238bee5887f410f52,0,Impala Public Jenkins,2018-10-26 18:44:58+00:00,['c1701074d6e94d98a43ab049ef807ac1b368180f'],10,58,68,6118635,2,0,1,1,5478
f8b7f257fb676d96fbde0ce9b078bbe4af3d4a4f,1,Impala Public Jenkins,2018-10-26 20:35:17+00:00,['de0c6bd6bd0db163d2820ae238bee5887f410f52'],1,3,4,6118639,1,0,0,0,5478
8d628d7b62c4903bfd0236d2de150dae0752f0fe,1,Impala Public Jenkins,2018-10-26 20:54:45+00:00,['f8b7f257fb676d96fbde0ce9b078bbe4af3d4a4f'],16,21,37,6118676,1,0,0,1,5478
aa654d4b87dd2f2b590e8a300f686bd2154e63d2,1,Impala Public Jenkins,2018-10-26 22:19:35+00:00,['8d628d7b62c4903bfd0236d2de150dae0752f0fe'],0,35,35,6118711,7,,,,5480
2e5d65819aaa52e1a89bc5cc212bba3b1b404339,0,Impala Public Jenkins,2018-10-27 00:56:54+00:00,['aa654d4b87dd2f2b590e8a300f686bd2154e63d2'],5,5,10,6118721,1,,,,5480
449fe73d2145bd22f0f857623c3652a097f06d73,1,Impala Public Jenkins,2018-10-27 04:07:51+00:00,['2e5d65819aaa52e1a89bc5cc212bba3b1b404339'],39,108,147,6118868,12,1,1,0.5,5481
bf7bb58d0bbce971cda02dc4e6cfe9d359e43922,1,Impala Public Jenkins,2018-10-27 18:07:00+00:00,['449fe73d2145bd22f0f857623c3652a097f06d73'],24,67,91,6118959,7,0,1,0,5481
44e69e8182954db90b22809b5440bba59ed8d0ae,0,Impala Public Jenkins,2018-10-29 20:40:50+00:00,['bf7bb58d0bbce971cda02dc4e6cfe9d359e43922'],21,99,120,6119079,3,0,0,1,5481
bae27edf532d4e29ad8a83bf2ddd3b1b43f8a23f,0,Impala Public Jenkins,2018-10-30 01:11:30+00:00,['44e69e8182954db90b22809b5440bba59ed8d0ae'],3,48,51,6119130,5,0.608695652,0.956521739,0.956521739,5481
932bf2dd8170563e7d82c8711a7b89f62bc2f6cb,0,Impala Public Jenkins,2018-10-30 02:02:37+00:00,['bae27edf532d4e29ad8a83bf2ddd3b1b43f8a23f'],24,102,126,6119256,5,0,0.387096774,0.612903226,5482
4c923b29d884bef3592fdf2e3e1cbf04aca58dc2,1,Impala Public Jenkins,2018-10-30 19:47:08+00:00,['932bf2dd8170563e7d82c8711a7b89f62bc2f6cb'],0,6,6,6119262,1,,,,5482
35c0e4416d23b33d1c3a3e9594230a7ed0e11d59,1,Impala Public Jenkins,2018-10-30 19:55:12+00:00,['4c923b29d884bef3592fdf2e3e1cbf04aca58dc2'],27,37,64,6119326,6,0.666666667,0,0,5482
85166afa8a884d6b1430a773f8877e2dfc2eb9f5,1,Tim Armstrong,2018-10-30 22:17:49+00:00,['35c0e4416d23b33d1c3a3e9594230a7ed0e11d59'],112,157,269,6119595,10,1,1,1,5483
dcc4024b1d13631ec57e0dcd3dddb461c918cb1b,0,Alex Rodoni,2018-10-30 23:55:25+00:00,['85166afa8a884d6b1430a773f8877e2dfc2eb9f5'],111,33,144,6119739,6,,,,5483
d4c0ce32a67a3f8d7fd4b8e92e42f6d4567d8db2,0,Alex Rodoni,2018-10-31 00:25:45+00:00,['dcc4024b1d13631ec57e0dcd3dddb461c918cb1b'],47,75,122,6119861,2,,,,5483
f7794cf2280ec9742c47d8b425751ad92a25c675,0,Alex Rodoni,2018-10-31 01:05:04+00:00,['d4c0ce32a67a3f8d7fd4b8e92e42f6d4567d8db2'],0,90,90,6119951,2,,,,5484
01f60d9389a52453c346d11e36a6bce6ed0d2fcd,0,Alex Rodoni,2018-10-31 01:06:23+00:00,['f7794cf2280ec9742c47d8b425751ad92a25c675'],34,35,69,6120020,1,,,,5484
8402827e1155adfebcb576aa10900cbcaac73b6a,0,Alex Rodoni,2018-10-31 19:15:45+00:00,['01f60d9389a52453c346d11e36a6bce6ed0d2fcd'],8,9,17,6120037,1,,,,5484
e03f7206d2c500386694e7d3dfa438c396d8798d,0,Impala Public Jenkins,2018-10-31 21:52:14+00:00,['8402827e1155adfebcb576aa10900cbcaac73b6a'],0,23,23,6120060,1,,,,5484
aff174c7282ed1587e74e2d8f31c70c1234d73c3,1,Impala Public Jenkins,2018-11-01 02:01:07+00:00,['e03f7206d2c500386694e7d3dfa438c396d8798d'],0,4,4,6120064,2,,,,5484
85526157bc87f129c9390a46b086f597714f3717,0,Impala Public Jenkins,2018-11-01 03:02:14+00:00,['aff174c7282ed1587e74e2d8f31c70c1234d73c3'],1,43,44,6120108,3,0.818181818,0.818181818,1,5484
2057931fbe10474b542dd13dd17acef22c29623e,0,Impala Public Jenkins,2018-11-01 04:41:01+00:00,['85526157bc87f129c9390a46b086f597714f3717'],11,11,22,6120130,3,0.333333333,0,0,5484
0e1f304e6bfd22795084252be9efb2937679f1eb,1,Impala Public Jenkins,2018-11-01 07:30:58+00:00,['2057931fbe10474b542dd13dd17acef22c29623e'],20,71,91,6120221,5,1,0,0,5486
e3a702707cb60b4e127215b99ab4e6945cedcd1f,0,Impala Public Jenkins,2018-11-01 08:05:48+00:00,['0e1f304e6bfd22795084252be9efb2937679f1eb'],32,268,300,6120521,3,1,1,1,5487
5391100c7eeb33193de7861e761c3920f1d1eecc,1,Impala Public Jenkins,2018-11-01 21:12:12+00:00,['e3a702707cb60b4e127215b99ab4e6945cedcd1f'],766,1296,2062,6122583,65,0.428571429,0.696428571,0.077380952,5491
95b56d0e2d8232d8707603c360b98a35bb80ff3a,0,Impala Public Jenkins,2018-11-01 21:27:13+00:00,['5391100c7eeb33193de7861e761c3920f1d1eecc'],14,199,213,6122796,15,0.75,0.875,1,5494
aa6a6e3d01b3eced7cf3932e5dc881a1a08ad48c,1,Alex Rodoni,2018-11-02 00:02:58+00:00,['95b56d0e2d8232d8707603c360b98a35bb80ff3a'],148,43,191,6122987,6,,,,5494
15d48c3205778ce775270feac10186e8e4851d7c,1,Michael Ho,2018-11-02 02:59:07+00:00,['aa6a6e3d01b3eced7cf3932e5dc881a1a08ad48c'],35,202,237,6123224,11,0.353846154,0.707692308,0.753846154,5494
43121bac7d94d17e79720363cea309211fad74be,1,Impala Public Jenkins,2018-11-02 09:28:59+00:00,['15d48c3205778ce775270feac10186e8e4851d7c'],419,290,709,6123933,3,1,0.5,0.722222222,5494
f876b320aae3ea657b1cd937a68b56e9b281a9f8,0,Impala Public Jenkins,2018-11-02 22:11:03+00:00,['43121bac7d94d17e79720363cea309211fad74be'],66,358,424,6124357,4,1,1,1,5494
a03e22011dfc6c93818e923d0dc29e6f61fefbe9,0,Impala Public Jenkins,2018-11-03 22:25:29+00:00,['f876b320aae3ea657b1cd937a68b56e9b281a9f8'],2,3,5,6124362,2,,,,5494
f08642bf43102cf326f4f00e9b9e3536d6906b2c,0,Impala Public Jenkins,2018-11-05 21:19:06+00:00,['a03e22011dfc6c93818e923d0dc29e6f61fefbe9'],21,40,61,6124423,7,,,,5494
572722e3505a663560e3fff1fe04d8fe932c0959,0,Impala Public Jenkins,2018-11-05 21:41:00+00:00,['f08642bf43102cf326f4f00e9b9e3536d6906b2c'],39,81,120,6124543,4,1,1,0,5494
31669a6703474f27259c8ad52208cd26d5788a1c,0,Tim Armstrong,2018-11-05 21:58:45+00:00,['572722e3505a663560e3fff1fe04d8fe932c0959'],2,10,12,6124555,3,,,,5494
691f9d9ff98e90da7c5552d4a883b4fb28acb6b0,1,Impala Public Jenkins,2018-11-05 22:47:31+00:00,['31669a6703474f27259c8ad52208cd26d5788a1c'],96,368,464,6125019,20,0.768518519,0.462962963,0.731481481,5494
78b6f1db69eafaf01408fda444e53513200852f3,0,Impala Public Jenkins,2018-11-05 23:30:52+00:00,['691f9d9ff98e90da7c5552d4a883b4fb28acb6b0'],3,54,57,6125076,2,1,1,1,5494
58cd69ac48d4014ef956a7df9dce63c0b8f122c4,0,Impala Public Jenkins,2018-11-06 00:00:12+00:00,['78b6f1db69eafaf01408fda444e53513200852f3'],0,41,41,6125117,2,1,1,0,5495
f7d89ef4ed3c03f88730226aaa5ae80fee541cda,0,Alex Rodoni,2018-11-06 00:45:34+00:00,['58cd69ac48d4014ef956a7df9dce63c0b8f122c4'],0,68,68,6125185,2,,,,5496
941038229ae7073ddf7b9c6f58e9eaf866b89b2c,1,Impala Public Jenkins,2018-11-06 01:01:07+00:00,['f7d89ef4ed3c03f88730226aaa5ae80fee541cda'],474,422,896,6126081,22,0,1,1,5497
ca516ecb6423c3433403227799ae38badc387b81,0,Impala Public Jenkins,2018-11-06 03:22:56+00:00,['941038229ae7073ddf7b9c6f58e9eaf866b89b2c'],7,17,24,6126105,1,0,0,1,5497
cf89c73485c119d5068be1cdddf1acbd3c8acfd5,1,Michael Ho,2018-11-06 07:54:47+00:00,['ca516ecb6423c3433403227799ae38badc387b81'],26,77,103,6126208,6,1,1,0,5497
3792a749923f7490b239e451d6500f1e946821ff,1,Impala Public Jenkins,2018-11-06 20:08:21+00:00,['cf89c73485c119d5068be1cdddf1acbd3c8acfd5'],1,2,3,6126211,1,0,0,0,5497
b84075f7f0067c54a340872e5ec1814398310318,1,Impala Public Jenkins,2018-11-06 21:27:55+00:00,['3792a749923f7490b239e451d6500f1e946821ff'],161,331,492,6126703,6,0.52,1,0,5497
5baa289fd039d339c63d5c475645e69fe0c6b8df,1,Alex Rodoni,2018-11-06 23:57:19+00:00,['b84075f7f0067c54a340872e5ec1814398310318'],97,127,224,6126927,4,,,,5497
98d923243f8bc95d66e497f4d8a15db57af32663,1,Tim Armstrong,2018-11-07 01:17:34+00:00,['5baa289fd039d339c63d5c475645e69fe0c6b8df'],38,205,243,6127170,25,0.35,1,0.35,5499
c7ef48e1ddd1489221a11fe472a72289a6ef3d47,1,Impala Public Jenkins,2018-11-07 02:56:45+00:00,['98d923243f8bc95d66e497f4d8a15db57af32663'],648,727,1375,6128545,2,0.803921569,1,1,5499
04695f4ed8e66aec117ab64cf6e56f62ef93d865,1,Bharath Vissapragada,2018-11-07 20:26:19+00:00,['c7ef48e1ddd1489221a11fe472a72289a6ef3d47'],5,5,10,6128555,1,,,,5499
690d905a5c14a87b5b32a656d3f463117d27c50d,0,Alex Rodoni,2018-11-07 20:57:02+00:00,['04695f4ed8e66aec117ab64cf6e56f62ef93d865'],113,100,213,6128768,3,,,,5499
1cd965d9d90f7df29243fb1ea867fdc3096858c9,0,Alex Rodoni,2018-11-07 21:37:00+00:00,['690d905a5c14a87b5b32a656d3f463117d27c50d'],2,0,2,6128770,1,,,,5499
250d85e94eef356caac15de94ed500b7d7ec2ca6,1,Impala Public Jenkins,2018-11-07 21:49:15+00:00,['1cd965d9d90f7df29243fb1ea867fdc3096858c9'],5,28,33,6128803,3,0,0.222222222,0.222222222,5499
b48e25689515ffa6a4bfd4c7d8bab8412e85387b,0,Impala Public Jenkins,2018-11-07 22:00:22+00:00,['250d85e94eef356caac15de94ed500b7d7ec2ca6'],82,97,179,6128982,7,0,0,1,5499
c28bc3e4f3900bfd0b14084ca19e51b36ea4dca7,0,Impala Public Jenkins,2018-11-07 22:53:57+00:00,['b48e25689515ffa6a4bfd4c7d8bab8412e85387b'],86,149,235,6129217,46,0,0.869565217,1,5500
a3d0f30ba61b63cf227d7bf100ebd2176914e51f,0,Impala Public Jenkins,2018-11-08 01:45:34+00:00,['c28bc3e4f3900bfd0b14084ca19e51b36ea4dca7'],94,138,232,6129449,29,1,1,1,5500
d1aa1c009f62500ae2ee8cd915751b0d42bee911,0,Impala Public Jenkins,2018-11-08 03:53:53+00:00,['a3d0f30ba61b63cf227d7bf100ebd2176914e51f'],2,2,4,6129453,1,,,,5500
898c515882dc64e1c98bff073f5529ea63a20cfe,1,Impala Public Jenkins,2018-11-08 05:42:45+00:00,['d1aa1c009f62500ae2ee8cd915751b0d42bee911'],4,18,22,6129475,4,0.833333333,0.833333333,0.833333333,5500
76842acc34f05760defb6e803df96fe61699ede0,1,Impala Public Jenkins,2018-11-08 07:05:09+00:00,['898c515882dc64e1c98bff073f5529ea63a20cfe'],14,147,161,6129636,6,0.527272727,0.436363636,1,5502
7299a6aedbbb7563e465dcfc6a20a981e9f1b804,0,Impala Public Jenkins,2018-11-08 09:54:58+00:00,['76842acc34f05760defb6e803df96fe61699ede0'],3,5,8,6129644,1,1,1,1,5502
a44aadda93e21de58b1d66f02cebaaf1339f28cb,0,Impala Public Jenkins,2018-11-09 03:23:15+00:00,['7299a6aedbbb7563e465dcfc6a20a981e9f1b804'],7,11,18,6129662,1,0,1,0,5502
58a469ca24e0225ce2274af779fbbd344595c5cc,1,Impala Public Jenkins,2018-11-09 03:37:51+00:00,['a44aadda93e21de58b1d66f02cebaaf1339f28cb'],11,88,99,6129761,5,0.022727273,0.477272727,0.568181818,5502
62db9216c6ca6f7a9b4c1048fe3fb5896db8add7,0,Impala Public Jenkins,2018-11-11 05:02:05+00:00,['58a469ca24e0225ce2274af779fbbd344595c5cc'],0,43,43,6129804,2,,,,5502
9f81ef1f1c5204d674f00a5c1a33cc859afd4efc,0,Impala Public Jenkins,2018-11-13 21:32:20+00:00,['62db9216c6ca6f7a9b4c1048fe3fb5896db8add7'],55,93,148,6129952,10,0.7,0.9,0.2,5502
cd26e807f18ef5fa729d7e15d0492a1284990122,1,Impala Public Jenkins,2018-11-13 23:25:02+00:00,['9f81ef1f1c5204d674f00a5c1a33cc859afd4efc'],13,112,125,6130077,8,0.5,0,1,5503
3f647577b471c3d4d954890a12b5ff829516e08c,0,Impala Public Jenkins,2018-11-14 02:59:58+00:00,['cd26e807f18ef5fa729d7e15d0492a1284990122'],0,1,1,6130078,1,,,,5503
c66d44ea7539e821c3b9e2f4a815ecfcb94218c9,1,Impala Public Jenkins,2018-11-14 07:40:53+00:00,['3f647577b471c3d4d954890a12b5ff829516e08c'],152,784,936,6131014,2,0.653243848,0.986577181,0.503355705,5504
c4c1eba6b74de1e3902005e56141839833592954,0,Impala Public Jenkins,2018-11-14 10:17:13+00:00,['c66d44ea7539e821c3b9e2f4a815ecfcb94218c9'],1,40,41,6131055,2,0,1,1,5504
b2dbc0f0bc106c89c5722ae909e067c4dabff4d1,0,Impala Public Jenkins,2018-11-14 10:30:30+00:00,['c4c1eba6b74de1e3902005e56141839833592954'],21,28,49,6131104,6,1,1,1,5504
74354a7189491625f3afa7e628eb4b04af7ecaed,0,Alex Rodoni,2018-11-14 17:47:45+00:00,['b2dbc0f0bc106c89c5722ae909e067c4dabff4d1'],73,0,73,6131177,1,,,,5504
731254b52934c17d953da541df8bc4493beb037a,0,Alex Rodoni,2018-11-14 18:26:42+00:00,['74354a7189491625f3afa7e628eb4b04af7ecaed'],0,85,85,6131262,2,,,,5505
71f8d0eba33c5d5d0a0cd2d2b617ac871dbcbb8a,0,Alex Rodoni,2018-11-14 18:37:43+00:00,['731254b52934c17d953da541df8bc4493beb037a'],0,223,223,6131485,2,,,,5506
c75b3711bc1a5cbbab983cbf52bd81eb084b8559,0,Alex Rodoni,2018-11-14 18:46:47+00:00,['71f8d0eba33c5d5d0a0cd2d2b617ac871dbcbb8a'],3,2,5,6131490,1,,,,5506
60095a4c6bebc412a040d5b4a723e528ba0b2278,1,Impala Public Jenkins,2018-11-14 20:16:14+00:00,['c75b3711bc1a5cbbab983cbf52bd81eb084b8559'],209,927,1136,6132626,24,0.43772242,0.800711744,0.743772242,5511
067657aa7db9ffbdecae19219f88f542065a9725,0,Impala Public Jenkins,2018-11-14 22:32:12+00:00,['60095a4c6bebc412a040d5b4a723e528ba0b2278'],2,3,5,6132631,1,0,1,0,5511
d031bf82467ce5e046f464295c8ac6d6804fc196,1,Impala Public Jenkins,2018-11-14 22:58:56+00:00,['067657aa7db9ffbdecae19219f88f542065a9725'],245,572,817,6133448,2,0.351758794,0.462311558,0.798994975,5511
0d0356c9329bf0cf0e7c69dee42f2b8b1315ec05,0,Impala Public Jenkins,2018-11-15 05:48:39+00:00,['d031bf82467ce5e046f464295c8ac6d6804fc196'],12,15,27,6133475,1,,,,5511
3dea93ef0f364325dff2893642d5516a4ecd16bd,0,Alex Rodoni,2018-11-15 21:30:23+00:00,['0d0356c9329bf0cf0e7c69dee42f2b8b1315ec05'],10,9,19,6133494,1,,,,5511
d3948d9a0114b7702da684e14919d369e74fe596,1,Thomas Marshall,2018-11-15 21:32:07+00:00,['3dea93ef0f364325dff2893642d5516a4ecd16bd'],460,1341,1801,6135295,133,0.517241379,0.931034483,0.785440613,5512
a47b3b82c4288d324c3917c2b1a1f8a409958191,0,Alex Rodoni,2018-11-15 23:13:38+00:00,['d3948d9a0114b7702da684e14919d369e74fe596'],5,8,13,6135308,1,,,,5512
153663c22f13f175975de9b1f20d0e2a8affbd94,1,Impala Public Jenkins,2018-11-17 01:48:05+00:00,['a47b3b82c4288d324c3917c2b1a1f8a409958191'],133,883,1016,6136324,27,0.275985663,0.326164875,0.189964158,5517
53ce6bb571cd9ae07ba5255197d35aa852a6f97c,0,Impala Public Jenkins,2018-11-18 06:50:50+00:00,['153663c22f13f175975de9b1f20d0e2a8affbd94'],1,4,5,6136329,1,0,0,0,5517
2a4835cfba7597362cc1e72e21315868c5c75d0a,1,Tim Armstrong,2018-11-19 17:27:13+00:00,['53ce6bb571cd9ae07ba5255197d35aa852a6f97c'],1468,1459,2927,6139256,33,0,1,1,5517
e1c9cbd0771cd01776c2db79cf753bf73d786e5a,0,Jim Apple,2018-11-19 18:46:38+00:00,['2a4835cfba7597362cc1e72e21315868c5c75d0a'],2,21,23,6139279,4,0,1,0.7,5517
93a0ce857f181f2fe4248252428fc2adfdf1bdb7,1,Impala Public Jenkins,2018-11-19 22:55:40+00:00,['e1c9cbd0771cd01776c2db79cf753bf73d786e5a'],9,44,53,6139332,3,0.266666667,1,1,5517
48d1d2d7421d668f8dd5142b05395e2b163f621b,0,Impala Public Jenkins,2018-11-19 23:11:40+00:00,['93a0ce857f181f2fe4248252428fc2adfdf1bdb7'],3,1,4,6139336,1,,,,5517
70fbd1df446f4830b55d684d82c851867b9c1444,0,Joe McDonnell,2018-11-19 23:33:20+00:00,['48d1d2d7421d668f8dd5142b05395e2b163f621b'],80,0,80,6139416,3,,,,5517
8f151d0e63aa5f3548e283fadcaf801456cb3354,0,Impala Public Jenkins,2018-11-19 23:41:23+00:00,['70fbd1df446f4830b55d684d82c851867b9c1444'],1,1,2,6139418,1,,,,5517
09c25144fddcfc9b72c9c4914e41675f865857ac,0,Alex Rodoni,2018-11-20 01:18:29+00:00,['8f151d0e63aa5f3548e283fadcaf801456cb3354'],23,43,66,6139484,1,,,,5517
a78a8d62ae7a7fe6800c4eec93eed0e082a3ff07,0,Impala Public Jenkins,2018-11-20 01:50:58+00:00,['09c25144fddcfc9b72c9c4914e41675f865857ac'],1,3,4,6139488,1,,,,5517
9ef9dacaf764aac869c8072eee823d1129657cf4,0,Impala Public Jenkins,2018-11-20 23:49:11+00:00,['a78a8d62ae7a7fe6800c4eec93eed0e082a3ff07'],19,12,31,6139519,3,0,0,0,5517
5e2dcd25d855711508088fd2f9f6e2bf7523fdfc,1,Joe McDonnell,2018-11-21 00:08:25+00:00,['9ef9dacaf764aac869c8072eee823d1129657cf4'],1,1,2,6139521,1,,,,5517
07b8aaf6c57b6050e81def05561fcc37dba77052,0,Tim Armstrong,2018-11-21 23:31:56+00:00,['5e2dcd25d855711508088fd2f9f6e2bf7523fdfc'],13,15,28,6139549,1,1,1,0,5517
d4019be2a259b6f5bc14da3261fac36e07f771ad,0,Impala Public Jenkins,2018-11-22 01:22:37+00:00,['07b8aaf6c57b6050e81def05561fcc37dba77052'],51,47,98,6139647,2,0,0,1,5517
8c59f0dcef11389ebfde1788aa3237b7b31ab3a4,1,Impala Public Jenkins,2018-11-22 01:37:30+00:00,['d4019be2a259b6f5bc14da3261fac36e07f771ad'],60,49,109,6139756,10,0,0,0,5517
aa294cf6b2c03e3ab0816cd447b72f4c0ffee4aa,0,Impala Public Jenkins,2018-11-22 04:36:21+00:00,['8c59f0dcef11389ebfde1788aa3237b7b31ab3a4'],0,393,393,6140149,3,0.557291667,0.734375,1,5520
622e19c5f8bb3523f4cbbd0053fd6314ea66a929,0,Alex Rodoni,2018-11-22 18:59:04+00:00,['aa294cf6b2c03e3ab0816cd447b72f4c0ffee4aa'],1,41,42,6140191,5,,,,5520
e421223c5d4ef4a7536a223779834064d74df75d,0,Alex Rodoni,2018-11-25 04:28:38+00:00,['622e19c5f8bb3523f4cbbd0053fd6314ea66a929'],297,340,637,6140828,3,,,,5521
fcfabe0f5c38a4e37d52d14a1010b02ae2973afb,0,Alex Rodoni,2018-11-26 20:04:24+00:00,['e421223c5d4ef4a7536a223779834064d74df75d'],26,28,54,6140882,1,,,,5521
12dc29e5ee1ec03bbc1556eca4539645e2b9bbf1,0,Impala Public Jenkins,2018-11-27 00:04:57+00:00,['fcfabe0f5c38a4e37d52d14a1010b02ae2973afb'],92,103,195,6141077,17,,,,5521
5e740f45c6c93e0c0ab49afaf1fc5b74072753af,0,Alex Rodoni,2018-11-27 01:12:44+00:00,['12dc29e5ee1ec03bbc1556eca4539645e2b9bbf1'],2,2,4,6141081,1,,,,5521
07fd332089c262fa8813605f12b927c8602ac0d2,0,Impala Public Jenkins,2018-11-27 02:01:12+00:00,['5e740f45c6c93e0c0ab49afaf1fc5b74072753af'],778,1164,1942,6143023,45,1,0.796296296,0,5529
af7476d550bcf8b3819bd4816bfe0c16ea78758a,0,Impala Public Jenkins,2018-11-27 05:01:40+00:00,['07fd332089c262fa8813605f12b927c8602ac0d2'],2,2,4,6143027,1,1,0,0,5529
a39c8472adc5bd832b0fdd0469f8152356708974,1,Impala Public Jenkins,2018-11-28 01:17:36+00:00,['af7476d550bcf8b3819bd4816bfe0c16ea78758a'],87,6,93,6143120,39,,,,5529
a1407adf61cec9bdd2ebb5bb7a7ccbbf5d2edd41,1,Impala Public Jenkins,2018-11-28 02:48:09+00:00,['a39c8472adc5bd832b0fdd0469f8152356708974'],5,52,57,6143177,6,1,1,1,5529
e546e5234444f491166a052667aeb8fddebd6873,0,Impala Public Jenkins,2018-11-28 04:25:54+00:00,['a1407adf61cec9bdd2ebb5bb7a7ccbbf5d2edd41'],2,2,4,6143181,1,,,,5529
96f976534837dde6d3fb87ea02019b67d9c3ea78,1,Impala Public Jenkins,2018-11-28 10:28:39+00:00,['e546e5234444f491166a052667aeb8fddebd6873'],3,8,11,6143192,3,0,1,1,5529
e64261adb780518b5fd03e2702c9b2912a9cd174,1,Impala Public Jenkins,2018-11-29 05:16:15+00:00,['96f976534837dde6d3fb87ea02019b67d9c3ea78'],14,88,102,6143294,4,0.27027027,0.945945946,1,5530
2ab57438fd93a2e4bcf6398c48021eb722275b60,0,Joe McDonnell,2018-11-29 22:09:26+00:00,['e64261adb780518b5fd03e2702c9b2912a9cd174'],0,10,10,6143304,1,,,,5530
a03fb1df4db7b79e8ed5e092556ebb3bfe99b70d,0,Impala Public Jenkins,2018-11-30 01:00:07+00:00,['2ab57438fd93a2e4bcf6398c48021eb722275b60'],8,86,94,6143398,7,0.219512195,0.292682927,0.853658537,5531
b26572f0ce8fcec9fb7219f96499516873934798,0,Alex Rodoni,2018-11-30 01:16:35+00:00,['a03fb1df4db7b79e8ed5e092556ebb3bfe99b70d'],202,208,410,6143808,3,,,,5531
f1a3c47959e17d301f970b7ea2755067d00ae986,1,Joe McDonnell,2018-11-30 01:58:52+00:00,['b26572f0ce8fcec9fb7219f96499516873934798'],13,24,37,6143845,1,0,0,1,5531
4dd70b67b8c3624dd6fbf53394f4b8674d8c2229,0,Impala Public Jenkins,2018-11-30 05:05:44+00:00,['f1a3c47959e17d301f970b7ea2755067d00ae986'],0,43,43,6143888,2,,,,5532
b880b8a79cfe9c8a23b5c0e03f4833d8406aa8df,0,Alex Rodoni,2018-11-30 19:00:07+00:00,['4dd70b67b8c3624dd6fbf53394f4b8674d8c2229'],13,13,26,6143914,1,,,,5532
9038c57d08fd2c44aeda26eac9fdaaf842cfe3c1,0,Impala Public Jenkins,2018-12-01 04:51:44+00:00,['b880b8a79cfe9c8a23b5c0e03f4833d8406aa8df'],72,274,346,6144260,14,0,0.657142857,0,5532
ba9b78c103fcdd3e99c9e724bc604b0044ad219a,0,Impala Public Jenkins,2018-12-02 10:39:44+00:00,['9038c57d08fd2c44aeda26eac9fdaaf842cfe3c1'],4,141,145,6144405,7,0.076923077,0.538461538,0.523076923,5533
971adb2f8f5614473d115ac1d775a8fc3ccee201,0,Impala Public Jenkins,2018-12-03 21:59:53+00:00,['ba9b78c103fcdd3e99c9e724bc604b0044ad219a'],69,159,228,6144633,3,0.763157895,0.789473684,0.736842105,5533
404465193fd1132d93b676348a2063ce3d8ccbea,0,Alex Rodoni,2018-12-03 23:11:00+00:00,['971adb2f8f5614473d115ac1d775a8fc3ccee201'],2,2,4,6144637,1,,,,5533
df4ccf5ddf9340049d193d7e6244c8af88a2dd5c,0,Impala Public Jenkins,2018-12-04 01:51:46+00:00,['404465193fd1132d93b676348a2063ce3d8ccbea'],11,66,77,6144714,5,0.172413793,0.931034483,0.896551724,5533
c23c852bd0d019df670109fa7420e107a757e6dd,0,Impala Public Jenkins,2018-12-04 02:03:00+00:00,['df4ccf5ddf9340049d193d7e6244c8af88a2dd5c'],45,214,259,6144973,25,0.621621622,0.72972973,0.797297297,5534
3f0989a4fcad1b95c79c765d829fce72dd122f21,1,Impala Public Jenkins,2018-12-04 08:20:34+00:00,['c23c852bd0d019df670109fa7420e107a757e6dd'],58,201,259,6145232,14,0.107142857,0,0.946428571,5535
9d885b8ee859cbd4d2ebe85fe97a624ab6504597,0,Alex Rodoni,2018-12-04 23:38:29+00:00,['3f0989a4fcad1b95c79c765d829fce72dd122f21'],41,83,124,6145356,1,,,,5535
91c754bf0ac707d0b2cee23c11ef41d7c81dd0f0,1,Impala Public Jenkins,2018-12-05 00:32:17+00:00,['9d885b8ee859cbd4d2ebe85fe97a624ab6504597'],20,178,198,6145554,14,0.145454545,0.245454545,0.909090909,5535
5189300b2f9b12f147c8dfd39bd5e30613fcfbfe,0,Alex Rodoni,2018-12-05 18:59:37+00:00,['91c754bf0ac707d0b2cee23c11ef41d7c81dd0f0'],10,26,36,6145590,1,,,,5535
0164fa769ee1efcdbea4d5ba0847fe3fa979c303,0,Lars Volker,2018-12-06 02:22:21+00:00,['5189300b2f9b12f147c8dfd39bd5e30613fcfbfe'],12,27,39,6145629,5,0.571428571,1,0.571428571,5535
9af2fdc44a06d6309b21cbca1cbc6a3f383c9b81,0,Impala Public Jenkins,2018-12-06 05:42:20+00:00,['0164fa769ee1efcdbea4d5ba0847fe3fa979c303'],9,37,46,6145675,3,0.647058824,0.647058824,0.764705882,5535
7dbeb6950f4d21248dc71b89add1aa14b8c95a8f,1,Impala Public Jenkins,2018-12-06 07:56:01+00:00,['9af2fdc44a06d6309b21cbca1cbc6a3f383c9b81'],38,258,296,6145971,5,0.602564103,0.935897436,1,5536
2572a78bdaa1d51b44ae3d90b0324dd4d54fa1cb,0,Impala Public Jenkins,2018-12-07 02:26:18+00:00,['7dbeb6950f4d21248dc71b89add1aa14b8c95a8f'],2,2,4,6145975,1,,,,5536
938be0e840c84263a2b47fb89e655d998363b819,1,Joe McDonnell,2018-12-07 03:50:11+00:00,['2572a78bdaa1d51b44ae3d90b0324dd4d54fa1cb'],86,582,668,6146643,16,0.552325581,1,0.947674419,5539
be88ae4f0b614971724dafd481ec6b7dc2334936,1,Bharath Vissapragada,2018-12-07 03:53:00+00:00,['938be0e840c84263a2b47fb89e655d998363b819'],26,75,101,6146744,1,1,1,1,5539
f266d2398ad507a466dd0cfe42db204ae1917f55,0,Impala Public Jenkins,2018-12-07 03:55:11+00:00,['be88ae4f0b614971724dafd481ec6b7dc2334936'],1,1,2,6146746,1,,,,5539
a18809ba1ffc2decede819d506a42ed9ed62c0dc,0,Impala Public Jenkins,2018-12-07 06:57:24+00:00,['f266d2398ad507a466dd0cfe42db204ae1917f55'],2,2,4,6146750,2,,,,5539
d8792c21c5a385fc80e3cfe34293abc560c09b37,1,Impala Public Jenkins,2018-12-07 07:33:01+00:00,['a18809ba1ffc2decede819d506a42ed9ed62c0dc'],137,349,486,6147236,37,0.4,0.690909091,0.781818182,5539
04d027df13e1c3c5c654b5a0bc965b670483b535,1,Impala Public Jenkins,2018-12-08 00:21:55+00:00,['d8792c21c5a385fc80e3cfe34293abc560c09b37'],1304,1295,2599,6149835,14,0,1,1,5539
244476b392acda8e69d7376b1560d23831fe795d,0,Impala Public Jenkins,2018-12-09 22:55:18+00:00,['04d027df13e1c3c5c654b5a0bc965b670483b535'],1,20,21,6149856,2,0.7,0.7,0.7,5539
56dd5767b87d13e467e88aa20fe33149681afc1e,1,Impala Public Jenkins,2018-12-10 15:39:24+00:00,['244476b392acda8e69d7376b1560d23831fe795d'],67,172,239,6150095,13,0.322033898,0,0.440677966,5540
12ce20b09db77f36dae7110271b8377d5c32be8f,0,Impala Public Jenkins,2018-12-10 17:35:03+00:00,['56dd5767b87d13e467e88aa20fe33149681afc1e'],0,1,1,6150096,1,0,1,0,5540
24445d5bf1ca889bd3edac985a5463743c6f3f8b,1,Impala Public Jenkins,2018-12-10 17:54:33+00:00,['12ce20b09db77f36dae7110271b8377d5c32be8f'],5,7,12,6150108,1,,,,5540
ecf12bec42e11262b88dc0993e375fe4d8acaafb,0,Joe McDonnell,2018-12-10 23:43:22+00:00,['24445d5bf1ca889bd3edac985a5463743c6f3f8b'],2,5,7,6150115,1,0,1,1,5540
d94a474658cb5f6114bc3cfb9a5426bdf1610e11,0,Impala Public Jenkins,2018-12-11 02:47:16+00:00,['ecf12bec42e11262b88dc0993e375fe4d8acaafb'],41,224,265,6150380,9,0,1,0.987096774,5540
80a4e6d3187d4dde6381e229cd409aa8ab13d9b7,0,Impala Public Jenkins,2018-12-11 09:53:43+00:00,['d94a474658cb5f6114bc3cfb9a5426bdf1610e11'],21,72,93,6150473,18,,,,5541
00ddac32dc8ae49e49e4ba0b417779117522d870,1,Impala Public Jenkins,2018-12-11 20:57:44+00:00,['80a4e6d3187d4dde6381e229cd409aa8ab13d9b7'],6,16,22,6150495,2,1,1,1,5541
78008c47e34f7957bf8211924a781188272439d7,1,Alex Rodoni,2018-12-11 22:12:11+00:00,['00ddac32dc8ae49e49e4ba0b417779117522d870'],1,1,2,6150497,1,,,,5541
0eae772f92ca6041fbf99fb1db9c48d7af6401e1,0,Impala Public Jenkins,2018-12-11 22:44:39+00:00,['78008c47e34f7957bf8211924a781188272439d7'],298,0,298,6150795,1,0.913875598,0.497607656,0.679425837,5541
899bfd10a2a42d40634cdb8c9c670494b3c8945e,0,Impala Public Jenkins,2018-12-12 04:47:41+00:00,['0eae772f92ca6041fbf99fb1db9c48d7af6401e1'],100,0,100,6150895,3,1,0,0.012820513,5541
575ead888be855b063b93b3bc1bc57bd49e7db53,0,Zoltan Borok-Nagy,2018-12-12 17:21:20+00:00,['899bfd10a2a42d40634cdb8c9c670494b3c8945e'],1,1,2,6150897,1,,,,5541
50ee98a0fae329c139b19761326e5263f179cf24,0,Alex Rodoni,2018-12-12 18:53:53+00:00,['575ead888be855b063b93b3bc1bc57bd49e7db53'],125,175,300,6151197,1,,,,5541
9c44853998705172015626e6e29d1d23a7f9e53e,1,Impala Public Jenkins,2018-12-12 22:44:34+00:00,['50ee98a0fae329c139b19761326e5263f179cf24'],21,38,59,6151256,6,1,0.111111111,0,5541
1cbcd0c37d47b1b22780a788e59f0f3e67d2a626,0,Impala Public Jenkins,2018-12-13 01:08:52+00:00,['9c44853998705172015626e6e29d1d23a7f9e53e'],15,17,32,6151288,1,1,1,0,5541
c209fed5350666c0b62004670714bdb404c39e06,1,Impala Public Jenkins,2018-12-13 03:46:35+00:00,['1cbcd0c37d47b1b22780a788e59f0f3e67d2a626'],23,89,112,6151400,4,0.714285714,1,1,5541
cf5355bd4051c937100eadc8eaadf77d829f18e2,1,Impala Public Jenkins,2018-12-13 06:52:46+00:00,['c209fed5350666c0b62004670714bdb404c39e06'],40,9,49,6151449,1,0,0,0,5541
b2e63da2bad513864fcad3341e7206c24c166dcc,0,Impala Public Jenkins,2018-12-13 21:51:11+00:00,['cf5355bd4051c937100eadc8eaadf77d829f18e2'],3,24,27,6151476,3,,,,5541
520a2b150cade5b83611bb11abea7997cf535cdc,1,Impala Public Jenkins,2018-12-14 01:38:02+00:00,['b2e63da2bad513864fcad3341e7206c24c166dcc'],390,387,777,6152253,55,1,1,1,5541
962a7e52803b65c7226d6ce2b0989d49898336e7,0,Alex Rodoni,2018-12-14 19:27:49+00:00,['520a2b150cade5b83611bb11abea7997cf535cdc'],170,203,373,6152626,2,,,,5541
282199a5ab89b9850213fb21ecb341727fa8a090,1,Impala Public Jenkins,2018-12-15 01:38:37+00:00,['962a7e52803b65c7226d6ce2b0989d49898336e7'],62,95,157,6152783,9,1,0,0,5542
00f971eccb9ea8b1a79f42c90f8ea39eefd8f729,0,Impala Public Jenkins,2018-12-15 01:58:49+00:00,['282199a5ab89b9850213fb21ecb341727fa8a090'],83,467,550,6153333,4,1,1,0.888888889,5543
fb3f324c691806dbc8d9fa8752cd392d41c509e3,1,Impala Public Jenkins,2018-12-15 03:07:18+00:00,['00f971eccb9ea8b1a79f42c90f8ea39eefd8f729'],13,21,34,6153367,3,1,1,1,5543
40caf7898cae163d4f8c5b7831341bc55c3bcf35,1,Impala Public Jenkins,2018-12-15 08:35:33+00:00,['fb3f324c691806dbc8d9fa8752cd392d41c509e3'],0,5,5,6153372,1,0,0,0,5543
b9377d3fdebb8f13fe4cc56ce16b666897b35822,0,Bharath Vissapragada,2018-12-15 20:58:15+00:00,['40caf7898cae163d4f8c5b7831341bc55c3bcf35'],9,40,49,6153421,1,1,1,1,5543
c187601b0f62c68c34d4db94dcfe479b88176c68,0,Impala Public Jenkins,2018-12-18 01:10:37+00:00,['b9377d3fdebb8f13fe4cc56ce16b666897b35822'],40,11,51,6153472,2,0,0,0,5543
ea826ca0d9a57c3719da760a4d047f89e91a62ba,1,Tim Armstrong,2018-12-18 04:45:32+00:00,['c187601b0f62c68c34d4db94dcfe479b88176c68'],10,378,388,6153860,14,1,1,1,5550
01f436979cc7ed26208ffb81a9218e090192d205,0,Impala Public Jenkins,2018-12-18 04:57:37+00:00,['ea826ca0d9a57c3719da760a4d047f89e91a62ba'],1,1,2,6153862,1,,,,5550
4ea5c9b977552cc3e927116328aa50051d447bc3,0,Joe McDonnell,2018-12-18 18:20:54+00:00,['01f436979cc7ed26208ffb81a9218e090192d205'],1,7,8,6153870,2,1,1,1,5550
fb3f7e6aa07d2acd94ebe1c3994fdc16131090f4,0,Impala Public Jenkins,2018-12-18 23:01:10+00:00,['4ea5c9b977552cc3e927116328aa50051d447bc3'],1,3,4,6153874,1,0,1,0,5550
d51aa522dd0e636d0de5a8d423cd3b689bdd39cb,1,Impala Public Jenkins,2018-12-19 02:37:23+00:00,['fb3f7e6aa07d2acd94ebe1c3994fdc16131090f4'],141,330,471,6154345,5,1,0.534482759,1,5550
0c957fcd5b78f8146d39d61ece0b3e53195dcfa0,0,Impala Public Jenkins,2018-12-19 06:46:05+00:00,['d51aa522dd0e636d0de5a8d423cd3b689bdd39cb'],5,3,8,6154353,1,,,,5550
ba6ca11d8b073fce20f8f9d824b3dc8a2f331082,0,Joe McDonnell,2018-12-19 18:57:58+00:00,['0c957fcd5b78f8146d39d61ece0b3e53195dcfa0'],17,125,142,6154495,3,0.016666667,0.966666667,1,5550
cf28d8acbd97d067f5ae190558ffe711b0abaaf3,0,Impala Public Jenkins,2018-12-19 21:28:04+00:00,['ba6ca11d8b073fce20f8f9d824b3dc8a2f331082'],0,1,1,6154496,1,,,,5550
86a8bf0cfcf425ab434350c881fd780c4f324603,0,Michael Ho,2018-12-20 00:27:31+00:00,['cf28d8acbd97d067f5ae190558ffe711b0abaaf3'],31,138,169,6154665,7,0.014705882,1,1,5550
db4bc0844015d03c87f195fd48838fa4c755f902,0,Michael Ho,2018-12-20 00:27:31+00:00,['86a8bf0cfcf425ab434350c881fd780c4f324603'],2,8,10,6154675,2,1,1,0,5550
5bf81cdc2797f986189aec4e78ebff2c2d1ed1b6,0,Bharath Vissapragada,2018-12-20 21:23:04+00:00,['db4bc0844015d03c87f195fd48838fa4c755f902'],5,0,5,6154680,1,1,1,1,5550
9396009d44080ba481c4a76f5259d7ae49557ac8,0,Alex Rodoni,2018-12-20 22:08:51+00:00,['5bf81cdc2797f986189aec4e78ebff2c2d1ed1b6'],1,2,3,6154683,1,,,,5550
9a52dd67bad7b8eb84fdeb6fb193505af7af931e,0,Joe McDonnell,2018-12-20 23:28:27+00:00,['9396009d44080ba481c4a76f5259d7ae49557ac8'],13,15,28,6154711,1,1,0,0,5550
32fc07b50c24496510eaf280573c75aac7d43f99,1,Impala Public Jenkins,2018-12-21 19:17:06+00:00,['9a52dd67bad7b8eb84fdeb6fb193505af7af931e'],244,253,497,6155208,35,0.333333333,0.333333333,0.833333333,5550
c59f76186aa98c1bd418d2d2951561f0521edec8,0,Impala Public Jenkins,2018-12-21 23:23:56+00:00,['32fc07b50c24496510eaf280573c75aac7d43f99'],17,97,114,6155322,3,0,0.971428571,1,5550
635149b85f209aceb0eb7680a904c303117e3ca1,0,Impala Public Jenkins,2018-12-27 21:02:57+00:00,['c59f76186aa98c1bd418d2d2951561f0521edec8'],20,103,123,6155445,5,1,1,1,5552
e4facae6210885b3fc710cf7ed08662b09d50302,0,Impala Public Jenkins,2018-12-27 21:48:31+00:00,['635149b85f209aceb0eb7680a904c303117e3ca1'],1,1,2,6155447,1,,,,5552
11a48234ec61431bf88e1395997bdb90762ba4e3,0,Impala Public Jenkins,2018-12-27 22:23:40+00:00,['e4facae6210885b3fc710cf7ed08662b09d50302'],0,10,10,6155457,1,0,1,0,5552
a3eb5fa90cf721e82a6f5d0aa7edf217be7ef3a1,1,Joe McDonnell,2018-12-27 22:28:25+00:00,['11a48234ec61431bf88e1395997bdb90762ba4e3'],10,28,38,6155495,4,0,0,1,5552
378f8c279587608a00a8eb4ad06b0e4f9e547c31,0,Impala Public Jenkins,2018-12-28 01:38:16+00:00,['a3eb5fa90cf721e82a6f5d0aa7edf217be7ef3a1'],4,1,5,6155500,1,0,0,0,5552
6f6d1f64a10f9a958dfa6162ec8bdab4cdcc6d92,0,Impala Public Jenkins,2018-12-28 01:50:39+00:00,['378f8c279587608a00a8eb4ad06b0e4f9e547c31'],1,3,4,6155504,2,,,,5552
27577dd652554dda5a03016e2d1e3ab66fe6b1f5,1,Impala Public Jenkins,2018-12-28 23:25:06+00:00,['6f6d1f64a10f9a958dfa6162ec8bdab4cdcc6d92'],296,1434,1730,6157234,23,0.279069767,1,0.981727575,5557
928c5c261b08154f0ab2fb5d814c3732c9301bf9,0,Impala Public Jenkins,2019-01-03 22:07:56+00:00,['27577dd652554dda5a03016e2d1e3ab66fe6b1f5'],17,38,55,6157289,13,0,0.631578947,0.473684211,5557
11c90c3d7d18ec81ae66d7cf1e6d71ac2be4eec2,1,Impala Public Jenkins,2019-01-03 22:30:51+00:00,['928c5c261b08154f0ab2fb5d814c3732c9301bf9'],3,85,88,6157377,3,,,,5558
a954d5443a613e746f04da9766e77a7a4ea8ce72,0,Impala Public Jenkins,2019-01-04 05:34:53+00:00,['11c90c3d7d18ec81ae66d7cf1e6d71ac2be4eec2'],4,61,65,6157442,5,0.260869565,1,1,5559
05b09f259988f3022ed2d20055a4a57de540788f,1,Impala Public Jenkins,2019-01-04 07:22:37+00:00,['a954d5443a613e746f04da9766e77a7a4ea8ce72'],225,527,752,6158194,18,0.285714286,0.385714286,0.466666667,5559
7cc909221241b6fea7096465cbb01b1e2dcb1a0a,0,Tim Armstrong,2019-01-04 21:51:48+00:00,['05b09f259988f3022ed2d20055a4a57de540788f'],4,36,40,6158234,2,1,0.315789474,0.315789474,5559
a91b24cb7962200f330c4887f38f4704a52f7c7e,1,Impala Public Jenkins,2019-01-05 04:14:36+00:00,['7cc909221241b6fea7096465cbb01b1e2dcb1a0a'],188,556,744,6158978,17,0.810344828,0.683908046,0.494252874,5560
e9652a48dd00c3c076ddccaa940d074b6970b7fc,0,Joe McDonnell,2019-01-07 17:55:48+00:00,['a91b24cb7962200f330c4887f38f4704a52f7c7e'],7,42,49,6159027,3,1,1,1,5560
c7ff26a0435ec0bfcd228725c834da406baeb34c,0,Impala Public Jenkins,2019-01-07 21:55:23+00:00,['e9652a48dd00c3c076ddccaa940d074b6970b7fc'],0,4,4,6159031,1,,,,5560
ec2dfd9482d48470176ee3c7925875855879a0b2,1,Impala Public Jenkins,2019-01-07 22:05:04+00:00,['c7ff26a0435ec0bfcd228725c834da406baeb34c'],50,85,135,6159166,3,0,1,0,5560
e4cff7d0d60e60ddf6c77b48ca0da7b878672c1a,1,Impala Public Jenkins,2019-01-08 01:05:54+00:00,['ec2dfd9482d48470176ee3c7925875855879a0b2'],142,195,337,6159503,12,0,0.307692308,0,5560
78da2b135143ac1faecd9ed1a62e1ce926555de3,1,Impala Public Jenkins,2019-01-08 01:22:29+00:00,['e4cff7d0d60e60ddf6c77b48ca0da7b878672c1a'],20,8,28,6159531,1,1,0.916666667,0,5560
ae65ff831966eb99417e15738c1aa96013a66f39,0,Impala Public Jenkins,2019-01-09 05:26:50+00:00,['78da2b135143ac1faecd9ed1a62e1ce926555de3'],38,125,163,6159694,9,0.102040816,1,1,5560
fa78c594de39878902f3887a209f29f7976583d0,1,Impala Public Jenkins,2019-01-09 05:54:59+00:00,['ae65ff831966eb99417e15738c1aa96013a66f39'],38,96,134,6159828,5,,,,5560
274e96bd147b5d91872c441c3a600fa8d5295bbe,1,Impala Public Jenkins,2019-01-09 06:27:41+00:00,['fa78c594de39878902f3887a209f29f7976583d0'],0,3,3,6159831,1,,,,5560
56dea84382e0a4d4a158299555c9c45d36a48d1b,0,Alex Rodoni,2019-01-09 20:58:08+00:00,['274e96bd147b5d91872c441c3a600fa8d5295bbe'],744,572,1316,6161147,6,,,,5561
43058cbf65179e39de13b3e2f39feedf6d7dec10,0,Alex Rodoni,2019-01-09 21:37:32+00:00,['56dea84382e0a4d4a158299555c9c45d36a48d1b'],1,1,2,6161149,1,,,,5561
049e1056f8d772c55274a54ff99e2cf44b82fa56,1,Impala Public Jenkins,2019-01-09 23:17:25+00:00,['43058cbf65179e39de13b3e2f39feedf6d7dec10'],321,328,649,6161798,46,1,1,1,5561
a8d3b765d88496bd51194cb1aa6edcd9459f68fa,0,Impala Public Jenkins,2019-01-10 03:11:35+00:00,['049e1056f8d772c55274a54ff99e2cf44b82fa56'],5,30,35,6161833,6,0.333333333,0.333333333,0.666666667,5561
aacd5c35d3134870b9a55658011cf08e60275459,1,Impala Public Jenkins,2019-01-10 03:32:25+00:00,['a8d3b765d88496bd51194cb1aa6edcd9459f68fa'],23,7321,7344,6169177,22,0.356846473,0.788381743,0.381742739,5564
51f30a6b9088cf3a0217a49a5792f1b41a8ad51b,0,Joe McDonnell,2019-01-10 21:19:02+00:00,['aacd5c35d3134870b9a55658011cf08e60275459'],3,4,7,6169184,2,1,1,0,5564
6d5ca479f6a1fab7cb8007599663fc51b060c95e,0,Impala Public Jenkins,2019-01-11 05:34:07+00:00,['51f30a6b9088cf3a0217a49a5792f1b41a8ad51b'],5,34,39,6169223,3,0,1,0.823529412,5564
3a3ab7ff8f6fef0407dc0e2b05b122fd9a0586db,0,Impala Public Jenkins,2019-01-12 03:42:48+00:00,['6d5ca479f6a1fab7cb8007599663fc51b060c95e'],1,12,13,6169236,4,,,,5564
a7ea86b768247ff5388174445e7c91736b99c2de,1,Impala Public Jenkins,2019-01-12 04:03:26+00:00,['3a3ab7ff8f6fef0407dc0e2b05b122fd9a0586db'],1149,11078,12227,6181463,90,0.488372093,0.534883721,0.709302326,5564
85b9c6c4257cabb866a3a4580c009f2729d8df8e,0,Impala Public Jenkins,2019-01-12 04:10:15+00:00,['a7ea86b768247ff5388174445e7c91736b99c2de'],14,24,38,6181501,1,0,1,1,5564
f8c3e4c0a44dbfa389c195c399e17a64d38a0824,0,Impala Public Jenkins,2019-01-14 09:07:03+00:00,['85b9c6c4257cabb866a3a4580c009f2729d8df8e'],165,169,334,6181835,3,1,1,1,5564
3338bae608b565f471ad1c9bd31f4fd3d88e431c,0,Impala Public Jenkins,2019-01-15 17:04:55+00:00,['f8c3e4c0a44dbfa389c195c399e17a64d38a0824'],24,51,75,6181910,3,0,1,1,5564
e1e258039d2b0129cc2d3a0feadfb8e7284457cf,0,Impala Public Jenkins,2019-01-17 02:34:12+00:00,['3338bae608b565f471ad1c9bd31f4fd3d88e431c'],7,14,21,6181931,1,,,,5564
0906e0817ce2301d7e20f355b334861f0232f16f,1,Impala Public Jenkins,2019-01-17 02:48:39+00:00,['e1e258039d2b0129cc2d3a0feadfb8e7284457cf'],83,272,355,6182286,6,0.968,0.92,0.216,5564
8da44ce16bb190dadab2ff3d22e5df726d1128e3,1,Impala Public Jenkins,2019-01-17 03:06:51+00:00,['0906e0817ce2301d7e20f355b334861f0232f16f'],10,283,293,6182579,9,0.132352941,0.779411765,0.897058824,5564
e6b492ad11a94a5d9a36e1d101481cc7c3d33acf,0,Impala Public Jenkins,2019-01-17 21:14:01+00:00,['8da44ce16bb190dadab2ff3d22e5df726d1128e3'],0,1,1,6182580,1,,,,5564
a8b66e5f1d63bda435c979d337a17d950aedb702,0,Impala Public Jenkins,2019-01-18 00:26:52+00:00,['e6b492ad11a94a5d9a36e1d101481cc7c3d33acf'],15,101,116,6182696,6,,,,5566
0771e23e0b11b7a78256672a54e95b21dea05f0a,0,Impala Public Jenkins,2019-01-18 00:41:31+00:00,['a8b66e5f1d63bda435c979d337a17d950aedb702'],1,4,5,6182701,1,,,,5566
e9d62bd2339dd434437f8220bd89c276e7555c07,0,Tim Armstrong,2019-01-18 00:46:24+00:00,['0771e23e0b11b7a78256672a54e95b21dea05f0a'],4,4,8,6182709,4,,,,5566
0df73c736e3545f7300a0b635df553468c7fafac,0,Tim Armstrong,2019-01-18 01:46:18+00:00,['e9d62bd2339dd434437f8220bd89c276e7555c07'],4,0,4,6182713,1,,,,5566
663e9ccc9e4b5167d73c5e28ac4becbd0813afca,0,Impala Public Jenkins,2019-01-18 02:18:51+00:00,['0df73c736e3545f7300a0b635df553468c7fafac'],0,38,38,6182751,3,0,0.642857143,1,5566
06d24b46f67015222a3406e8307b92e913dd372d,1,Impala Public Jenkins,2019-01-18 03:50:06+00:00,['663e9ccc9e4b5167d73c5e28ac4becbd0813afca'],3,7,10,6182761,2,,,,5566
ff628d2b136e9b5ca72a7179294dea06f4cdf0d8,0,Impala Public Jenkins,2019-01-18 04:56:49+00:00,['06d24b46f67015222a3406e8307b92e913dd372d'],171,439,610,6183371,17,0.674603175,0.80952381,0.595238095,5566
236b9194d345bbfdfb177dd7ef4908170eaff259,1,Impala Public Jenkins,2019-01-18 21:33:16+00:00,['ff628d2b136e9b5ca72a7179294dea06f4cdf0d8'],229,358,587,6183958,11,0.979591837,0.673469388,0,5566
fd7e32f24a9f56a84bb68e8fcdcf845563bdf461,0,Impala Public Jenkins,2019-01-19 01:20:41+00:00,['236b9194d345bbfdfb177dd7ef4908170eaff259'],1,1,2,6183960,1,,,,5566
6fa35478d5930cc3ec6d88c6b2e3f6bedd3d8ed9,1,Impala Public Jenkins,2019-01-22 01:20:31+00:00,['fd7e32f24a9f56a84bb68e8fcdcf845563bdf461'],119,166,285,6184245,20,0.833333333,0.866666667,0.7,5570
561158b30656b97ccb6ec83052b62c476e0873ed,1,Impala Public Jenkins,2019-01-23 00:15:28+00:00,['6fa35478d5930cc3ec6d88c6b2e3f6bedd3d8ed9'],12,23,35,6184280,4,0.333333333,0,0,5570
9105c5c5427dd0479caf280b5754b31845df5fc2,1,Impala Public Jenkins,2019-01-23 00:54:55+00:00,['561158b30656b97ccb6ec83052b62c476e0873ed'],189,215,404,6184684,12,0.631578947,0.947368421,0.947368421,5570
d1f2c1a2269604efb9a498c0a0137bb4ea4eff07,0,Impala Public Jenkins,2019-01-23 10:44:51+00:00,['9105c5c5427dd0479caf280b5754b31845df5fc2'],52,289,341,6185025,9,0.29245283,0.254716981,0.990566038,5572
969dea84f41cfccf863b14904958a5d2be91983f,1,Impala Public Jenkins,2019-01-23 16:31:56+00:00,['d1f2c1a2269604efb9a498c0a0137bb4ea4eff07'],130,765,895,6185920,12,0.228571429,0.705494505,0.595604396,5574
6c0ec348a7ed04857a4931e7670fc81aa819b2e1,1,Impala Public Jenkins,2019-01-23 20:47:07+00:00,['969dea84f41cfccf863b14904958a5d2be91983f'],2,4,6,6185926,2,,,,5574
365e35a36f142532044d8a34cbb87646bf9cb240,1,Impala Public Jenkins,2019-01-23 23:28:10+00:00,['6c0ec348a7ed04857a4931e7670fc81aa819b2e1'],2,22,24,6185950,3,0,0.166666667,0.583333333,5574
81d0bcb3c967bf76b6858b221416e6fcb863b187,0,Impala Public Jenkins,2019-01-24 00:09:09+00:00,['365e35a36f142532044d8a34cbb87646bf9cb240'],12,90,102,6186052,2,,,,5574
fe47b2352ea9fc13f2d51da8fa9d0f7c70037779,0,Impala Public Jenkins,2019-01-24 01:12:56+00:00,['81d0bcb3c967bf76b6858b221416e6fcb863b187'],100,94,194,6186246,7,1,0,0,5574
85a8b34645a46038fd217c03e64326b72d9669b5,1,Impala Public Jenkins,2019-01-24 01:26:08+00:00,['fe47b2352ea9fc13f2d51da8fa9d0f7c70037779'],1064,1310,2374,6188620,44,0.592307692,1,1,5574
bfb9ccc8e02be20fb8b57bae4d55e4094ab7ea3f,1,Impala Public Jenkins,2019-01-24 03:14:35+00:00,['85a8b34645a46038fd217c03e64326b72d9669b5'],124,473,597,6189217,11,0.234939759,0.674698795,0.981927711,5575
264f2274a74c39956c1c60fd8dc5eaa371e441e3,0,Alex Rodoni,2019-01-24 19:32:15+00:00,['bfb9ccc8e02be20fb8b57bae4d55e4094ab7ea3f'],2,2,4,6189221,2,,,,5575
aa603d8cb9e870919b60d80828951beee1db6622,0,Impala Public Jenkins,2019-01-25 00:13:49+00:00,['264f2274a74c39956c1c60fd8dc5eaa371e441e3'],8,14,22,6189243,2,1,1,0,5575
13dfdc64db6b2ff06bf3762428781b01fd166485,0,Impala Public Jenkins,2019-01-25 00:47:09+00:00,['aa603d8cb9e870919b60d80828951beee1db6622'],67,265,332,6189575,16,0.311926606,0.990825688,0.880733945,5576
e5af7f92926f94fd4c91a8c30089de142ea5f3ac,0,Impala Public Jenkins,2019-01-25 02:22:18+00:00,['13dfdc64db6b2ff06bf3762428781b01fd166485'],3,3,6,6189581,1,,,,5576
8c673ed6a00d1ed5c542a2311608993651bae850,1,Impala Public Jenkins,2019-01-25 03:50:45+00:00,['e5af7f92926f94fd4c91a8c30089de142ea5f3ac'],3,141,144,6189725,12,0.325,0.3375,1,5576
678ed162d468be53faf443e5188b3d41fe5636fd,0,Impala Public Jenkins,2019-01-25 05:28:21+00:00,['8c673ed6a00d1ed5c542a2311608993651bae850'],0,3,3,6189728,2,,,,5576
dccb97ba795f58d76d5e0e664685ec52754f059f,1,Impala Public Jenkins,2019-01-25 20:45:38+00:00,['678ed162d468be53faf443e5188b3d41fe5636fd'],116,511,627,6190355,10,0,0.461538462,0.961538462,5577
b3318ad434f1a82a880afeaf600233ea76e8ca0f,0,Impala Public Jenkins,2019-01-25 23:41:39+00:00,['dccb97ba795f58d76d5e0e664685ec52754f059f'],1,4,5,6190360,1,0,1,1,5577
7aec1b6db042d88c04a501e24afaa25d4794cccb,1,Impala Public Jenkins,2019-01-26 04:40:08+00:00,['b3318ad434f1a82a880afeaf600233ea76e8ca0f'],75,126,201,6190561,7,0.111111111,0.194444444,0.805555556,5577
fa672909c868f76aa50e9fb756114c32daaf6d9b,0,Impala Public Jenkins,2019-01-27 03:04:25+00:00,['7aec1b6db042d88c04a501e24afaa25d4794cccb'],11,20,31,6190592,1,1,1,1,5577
e111627888dd1072aceabb81c4a88fec63a1e345,0,Impala Public Jenkins,2019-01-28 21:43:47+00:00,['fa672909c868f76aa50e9fb756114c32daaf6d9b'],6,54,60,6190652,2,0.75,0.75,0.75,5577
71db6db378d638ab5d4cab41e7b8fc343620f753,0,Alex Rodoni,2019-01-30 00:21:07+00:00,['e111627888dd1072aceabb81c4a88fec63a1e345'],8,82,90,6190742,1,,,,5577
efb333d5c4dc790f15cb07d203a497a149432050,0,Impala Public Jenkins,2019-01-30 03:28:33+00:00,['71db6db378d638ab5d4cab41e7b8fc343620f753'],1,1,2,6190744,1,,,,5577
389fb169d2782729aa48b820f3cd5bbfcb5f8dd8,1,Impala Public Jenkins,2019-01-30 03:32:36+00:00,['efb333d5c4dc790f15cb07d203a497a149432050'],3,2553,2556,6193300,14,0.36,0.928,0.9152,5585
89362ea869e80658b315a517ada7de1bdfc5d180,0,Tim Armstrong,2019-01-30 09:49:29+00:00,['389fb169d2782729aa48b820f3cd5bbfcb5f8dd8'],2,10,12,6193312,1,,,,5585
f20a03a7b1bc2a9bb6cd8b54b8afb9ce384538f1,0,Impala Public Jenkins,2019-01-30 22:07:57+00:00,['89362ea869e80658b315a517ada7de1bdfc5d180'],6,250,256,6193568,5,0.462121212,0.537878788,0.977272727,5586
cd25af360f8f7583582cb239353dd15f572fe211,0,Impala Public Jenkins,2019-01-30 22:18:33+00:00,['f20a03a7b1bc2a9bb6cd8b54b8afb9ce384538f1'],0,5,5,6193573,1,0,0,0,5586
653ff1585daf1ae0f1c914a3d03581e6ca80c47f,1,Philip Zeyliger,2019-01-30 23:29:47+00:00,['cd25af360f8f7583582cb239353dd15f572fe211'],113,157,270,6193843,13,0.615384615,0,0.115384615,5586
e8ea4b0525fb3223da9291775eff4b7fbd15c547,0,Impala Public Jenkins,2019-01-30 23:42:05+00:00,['653ff1585daf1ae0f1c914a3d03581e6ca80c47f'],60,0,60,6193903,3,,,,5586
6214d2d81236695a9e606634dbeebdbbbccf3847,0,Impala Public Jenkins,2019-01-31 02:08:31+00:00,['e8ea4b0525fb3223da9291775eff4b7fbd15c547'],1,11,12,6193915,2,0,0,1,5586
ee491bb67da2d62b2b801d6ff0de40fc286411b9,0,Impala Public Jenkins,2019-01-31 02:12:05+00:00,['6214d2d81236695a9e606634dbeebdbbbccf3847'],1,3,4,6193919,1,,,,5586
1c2778a9a371a0cb21bfb4afeeb6e50e3c94e469,0,Alex Rodoni,2019-01-31 19:06:38+00:00,['ee491bb67da2d62b2b801d6ff0de40fc286411b9'],4,3,7,6193926,1,,,,5586
79e735a46df258395ea518a5cf6e22e851a91119,0,Alex Rodoni,2019-01-31 19:12:34+00:00,['1c2778a9a371a0cb21bfb4afeeb6e50e3c94e469'],27,18,45,6193971,1,,,,5586
b0942296ab5f24660473abc218d45978fc402d81,0,Impala Public Jenkins,2019-02-01 06:34:07+00:00,['79e735a46df258395ea518a5cf6e22e851a91119'],9,9,18,6193989,4,,,,5586
396f542eda32dd92e80edbeb216a4cdeb7fe0ace,1,Impala Public Jenkins,2019-02-01 07:39:32+00:00,['b0942296ab5f24660473abc218d45978fc402d81'],201,212,413,6194402,48,0,0,0,5586
6291d6063fe4ff9c483b60b8d9fc254298a51473,0,Tim Armstrong,2019-02-01 14:15:30+00:00,['396f542eda32dd92e80edbeb216a4cdeb7fe0ace'],15,16,31,6194433,1,,,,5586
a8e30506aafef14646d95a56fb87cf7c28d259d6,1,Philip Zeyliger,2019-02-01 19:05:38+00:00,['6291d6063fe4ff9c483b60b8d9fc254298a51473'],50,82,132,6194565,8,0.615384615,0,1,5586
11120a9599da986040964bfd672571d97d377c94,0,Michael Ho,2019-02-01 19:31:36+00:00,['a8e30506aafef14646d95a56fb87cf7c28d259d6'],0,60,60,6194625,3,,,,5589
0a2261f3c237d9a7c77e8c1a19d95a2318dbbe1d,1,Impala Public Jenkins,2019-02-01 22:52:19+00:00,['11120a9599da986040964bfd672571d97d377c94'],38,787,825,6195450,17,0.228813559,0.733050847,0.826271186,5590
781cb915e5bfc01c3fb198cbf195d67f01b90aa1,0,Alex Rodoni,2019-02-05 00:17:01+00:00,['0a2261f3c237d9a7c77e8c1a19d95a2318dbbe1d'],0,55,55,6195505,1,,,,5590
26b8b427188052735ce52f319aebe2ff1ac17e2a,0,Impala Public Jenkins,2019-02-05 03:14:05+00:00,['781cb915e5bfc01c3fb198cbf195d67f01b90aa1'],9,5,14,6195519,2,1,1,0,5590
b08c8e3db2e769609f47d5c0ed87c547d41d1c8b,1,Impala Public Jenkins,2019-02-05 06:47:55+00:00,['26b8b427188052735ce52f319aebe2ff1ac17e2a'],0,2546,2546,6198065,5,1,1,1,5594
b7bd6ac44dfbc5f82e5cba52bf7e751f62a35751,0,Impala Public Jenkins,2019-02-05 07:06:11+00:00,['b08c8e3db2e769609f47d5c0ed87c547d41d1c8b'],2,7,9,6198074,2,0,0,1,5594
3db3b3b0a74d003ef497cd76d3bd66480f7dc4d7,1,Impala Public Jenkins,2019-02-05 07:44:24+00:00,['b7bd6ac44dfbc5f82e5cba52bf7e751f62a35751'],53,47,100,6198174,6,1,0.8,0,5594
f9ced753badae46fe2f23cd9aa4383f1bf6844b3,1,Impala Public Jenkins,2019-02-05 13:10:08+00:00,['3db3b3b0a74d003ef497cd76d3bd66480f7dc4d7'],339,157,496,6198670,10,0.916666667,1,0.666666667,5595
b5714097e096c6e4b0573a7b326789807a1e4e5f,1,Impala Public Jenkins,2019-02-05 20:25:51+00:00,['f9ced753badae46fe2f23cd9aa4383f1bf6844b3'],237,1151,1388,6200058,36,0.595567867,0.878116343,0.8033241,5599
efd2478ed3c5f54ec5a1c486e7f4c657ca6addac,0,Alex Rodoni,2019-02-05 21:49:44+00:00,['b5714097e096c6e4b0573a7b326789807a1e4e5f'],25,19,44,6200102,1,,,,5599
72b845279edabfc536a331d6a34eafd2160c2097,1,Impala Public Jenkins,2019-02-05 22:04:44+00:00,['efd2478ed3c5f54ec5a1c486e7f4c657ca6addac'],2,4,6,6200108,1,,,,5599
52af0bff63af91506f08affa5fcd943af428be45,0,Impala Public Jenkins,2019-02-05 23:24:51+00:00,['72b845279edabfc536a331d6a34eafd2160c2097'],0,1,1,6200109,1,,,,5599
2f5d0016eaa3f9e0e4e3b02032d092cd7b887198,1,Impala Public Jenkins,2019-02-06 01:21:36+00:00,['52af0bff63af91506f08affa5fcd943af428be45'],0,18,18,6200127,1,,,,5599
14996f495129eaee35ee030be87b289b9dae517e,0,Impala Public Jenkins,2019-02-06 04:06:56+00:00,['2f5d0016eaa3f9e0e4e3b02032d092cd7b887198'],160,121,281,6200408,11,0.625,0.75,0.375,5599
ae96a9fb19e0a2e0a5529f2f36d3b5ee0d336f69,0,Impala Public Jenkins,2019-02-06 04:19:20+00:00,['14996f495129eaee35ee030be87b289b9dae517e'],1,3,4,6200412,1,0,0,1,5599
24eab713a0d35f629509f59711f8a563e1346acf,1,Joe McDonnell,2019-02-06 05:15:37+00:00,['ae96a9fb19e0a2e0a5529f2f36d3b5ee0d336f69'],16,823,839,6201251,17,0.401595745,0.928191489,0.805851064,5603
69652fa0d6f92f3e23a7de1f0137ffd321635824,1,Impala Public Jenkins,2019-02-06 09:04:01+00:00,['24eab713a0d35f629509f59711f8a563e1346acf'],286,316,602,6201853,30,0,1,1,5603
cbddda46a1b9ff153e3ff9213b5bae7e8da9f19a,1,Impala Public Jenkins,2019-02-06 22:40:33+00:00,['69652fa0d6f92f3e23a7de1f0137ffd321635824'],71,139,210,6202063,9,0.46875,0.78125,1,5603
2cf66cfc49bb53f044289258e741ce4dd5ded6a9,0,Impala Public Jenkins,2019-02-07 01:48:13+00:00,['cbddda46a1b9ff153e3ff9213b5bae7e8da9f19a'],9,10,19,6202082,2,0,1,1,5603
255ec4687ebe6195b20e5566394f3692c07e3b7f,0,Joe McDonnell,2019-02-07 04:47:01+00:00,['2cf66cfc49bb53f044289258e741ce4dd5ded6a9'],4,3,7,6202089,1,,,,5603
9a3633c75f84601e7b8d05522daa6a9e0cf66a53,0,Alex Rodoni,2019-02-07 20:03:07+00:00,['255ec4687ebe6195b20e5566394f3692c07e3b7f'],197,165,362,6202451,1,,,,5603
6601327af6088def7d880940a5712719fe46acb2,1,Impala Public Jenkins,2019-02-07 21:41:52+00:00,['9a3633c75f84601e7b8d05522daa6a9e0cf66a53'],3,66,69,6202520,9,0.047619048,0,0.428571429,5603
2fad3d08dd6d6c4ebc27f56d8a03e637a65fd29c,0,Impala Public Jenkins,2019-02-07 21:48:07+00:00,['6601327af6088def7d880940a5712719fe46acb2'],1,14,15,6202535,2,1,1,1,5603
7707eb041728456ea5e05ae8acc5ab59c715b98a,0,Impala Public Jenkins,2019-02-07 22:14:15+00:00,['2fad3d08dd6d6c4ebc27f56d8a03e637a65fd29c'],41,361,402,6202937,15,0,1,1,5605
b1e4957ba78ef496d21728606889d1eb83ef6b27,1,Impala Public Jenkins,2019-02-07 22:21:51+00:00,['7707eb041728456ea5e05ae8acc5ab59c715b98a'],66,193,259,6203196,8,0.484375,0.140625,0.90625,5605
d7a0690142c5d965389a5a62b64a649d2619ffa2,0,Alex Rodoni,2019-02-07 22:45:19+00:00,['b1e4957ba78ef496d21728606889d1eb83ef6b27'],0,81,81,6203277,3,,,,5606
06d078e76bad6944ad487fd432ff6d0aa9174960,1,Tim Armstrong,2019-02-07 23:05:30+00:00,['d7a0690142c5d965389a5a62b64a649d2619ffa2'],4,70,74,6203351,4,0,0.947368421,0.052631579,5607
c10113c6f72ba7a877f9bb67a014537f5d278a44,0,Tim Armstrong,2019-02-08 00:03:10+00:00,['06d078e76bad6944ad487fd432ff6d0aa9174960'],0,72,72,6203423,2,,,,5608
d0c103095019f1b80dec63193847eb516d7f8dd7,1,Impala Public Jenkins,2019-02-08 03:54:40+00:00,['c10113c6f72ba7a877f9bb67a014537f5d278a44'],25,89,114,6203537,4,,,,5608
3ce34a81b2189dcaf182c078484a570fbde08ce6,1,Joe McDonnell,2019-02-08 19:00:21+00:00,['d0c103095019f1b80dec63193847eb516d7f8dd7'],192,548,740,6204277,48,0,0.170731707,1,5614
13be8cd8b510cffd4533918c4526733e89a6f26b,0,Alex Rodoni,2019-02-08 19:25:43+00:00,['3ce34a81b2189dcaf182c078484a570fbde08ce6'],163,281,444,6204721,1,,,,5614
bf96eb30a2b96a945fc7c10716252ea37dc665f5,0,Impala Public Jenkins,2019-02-08 23:43:42+00:00,['13be8cd8b510cffd4533918c4526733e89a6f26b'],0,5,5,6204726,1,,,,5614
29cdaf022ca7310b955ecb30eeebf126ac389b14,0,Tim Armstrong,2019-02-09 00:37:50+00:00,['bf96eb30a2b96a945fc7c10716252ea37dc665f5'],3,25,28,6204754,3,,,,5614
5f59eefeb71688913e24263a1724c95039e12c54,0,Alex Rodoni,2019-02-09 01:19:31+00:00,['29cdaf022ca7310b955ecb30eeebf126ac389b14'],162,281,443,6205197,1,,,,5614
022ba2bbdb6feec0ba944847e92d5a051cedc9a1,0,Alex Rodoni,2019-02-09 01:19:57+00:00,['5f59eefeb71688913e24263a1724c95039e12c54'],382,498,880,6206077,1,,,,5614
9d5e2a20ec4fd0e34fc930c072f71d6170c5c4de,0,Alex Rodoni,2019-02-09 01:51:12+00:00,['022ba2bbdb6feec0ba944847e92d5a051cedc9a1'],15,6,21,6206098,1,,,,5614
df83d562e2a277c87fd603e81b66bf5fcdb1d6ea,0,Impala Public Jenkins,2019-02-09 01:56:39+00:00,['9d5e2a20ec4fd0e34fc930c072f71d6170c5c4de'],3,13,16,6206114,2,1,1,1,5614
adde66b37cea3689dac453f5d4f2aa4863a35979,1,Impala Public Jenkins,2019-02-09 02:18:09+00:00,['df83d562e2a277c87fd603e81b66bf5fcdb1d6ea'],150,229,379,6206493,16,0,0.348837209,0.953488372,5614
4ce689e58a000e78f641ecf544ca7f8c23345abb,1,Impala Public Jenkins,2019-02-09 02:56:52+00:00,['adde66b37cea3689dac453f5d4f2aa4863a35979'],322,1493,1815,6208308,16,0.838797814,0.99726776,0.852459016,5619
f7df8adfaee1e824d9e32271e0e564cd33a37d70,1,Impala Public Jenkins,2019-02-09 03:59:10+00:00,['4ce689e58a000e78f641ecf544ca7f8c23345abb'],130,4487,4617,6212925,116,0.385395538,0.636916836,0.951318458,5698
9bd3ba7637fb339f2f9cf34ed65327f6fd122c88,0,Impala Public Jenkins,2019-02-09 05:00:31+00:00,['f7df8adfaee1e824d9e32271e0e564cd33a37d70'],0,1,1,6212926,1,,,,5698
c3c69ae362ae06adcf304b8610221a656e7b2eba,1,Impala Public Jenkins,2019-02-09 05:16:43+00:00,['9bd3ba7637fb339f2f9cf34ed65327f6fd122c88'],34,208,242,6213168,6,0,0.181818182,0.886363636,5698
81305f205849f20fe3d31a142b10aee16d5c46de,0,Impala Public Jenkins,2019-02-09 06:37:11+00:00,['c3c69ae362ae06adcf304b8610221a656e7b2eba'],62,72,134,6213302,3,0,0,1,5698
8b8d935a0045aba5caea4106a42fdc647a2a6147,0,Impala Public Jenkins,2019-02-09 18:52:34+00:00,['81305f205849f20fe3d31a142b10aee16d5c46de'],1,4,5,6213307,1,,,,5698
fa604fb5059307321a174db02469b4f5fb78410f,0,Impala Public Jenkins,2019-02-11 01:08:25+00:00,['8b8d935a0045aba5caea4106a42fdc647a2a6147'],1,11,12,6213319,2,,,,5698
29df1d55f668d18450b86428844308c0f536f374,0,Impala Public Jenkins,2019-02-11 10:57:20+00:00,['fa604fb5059307321a174db02469b4f5fb78410f'],0,10,10,6213329,1,,,,5698
697a15b341186046d8fae3a2139f1ad13d304734,0,Alex Rodoni,2019-02-11 20:19:58+00:00,['29df1d55f668d18450b86428844308c0f536f374'],473,169,642,6213971,9,,,,5698
8b5cb576d23d771456ed571ee0d362d96af6ae13,0,Impala Public Jenkins,2019-02-12 00:03:36+00:00,['697a15b341186046d8fae3a2139f1ad13d304734'],10,16,26,6213997,2,0.833333333,0.833333333,1,5698
6fc05a6f7385bf21de1c01a3071b9a91efc85b07,0,Impala Public Jenkins,2019-02-12 00:44:23+00:00,['8b5cb576d23d771456ed571ee0d362d96af6ae13'],1,2,3,6214000,1,1,1,0,5698
e0aabddd573c204a780d3f5ff0af442cdb26b7c6,0,Impala Public Jenkins,2019-02-12 05:16:31+00:00,['6fc05a6f7385bf21de1c01a3071b9a91efc85b07'],12,17,29,6214029,3,0,1,1,5698
a154b2d6e775a508df4fd2c8d51a18d5c1d1f933,0,Impala Public Jenkins,2019-02-12 20:37:45+00:00,['e0aabddd573c204a780d3f5ff0af442cdb26b7c6'],1,126,127,6214156,3,,,,5698
dbe9fefa05ce9738865349e9130004457ff31c62,0,Tim Armstrong,2019-02-12 21:03:31+00:00,['a154b2d6e775a508df4fd2c8d51a18d5c1d1f933'],0,53,53,6214209,1,,,,5699
5b32a0d60110be7c21184819c2dffbb7cbff750f,0,Alex Rodoni,2019-02-12 22:07:12+00:00,['dbe9fefa05ce9738865349e9130004457ff31c62'],26,23,49,6214258,2,,,,5699
d2b8b7b9b0f3a02e2418d9182007b736bb739a1b,0,Impala Public Jenkins,2019-02-12 22:59:39+00:00,['5b32a0d60110be7c21184819c2dffbb7cbff750f'],13,32,45,6214303,1,1,1,1,5699
6938831ae98f3e9cdb63ecbf63a608c17bdc0b6b,0,Impala Public Jenkins,2019-02-12 23:25:28+00:00,['d2b8b7b9b0f3a02e2418d9182007b736bb739a1b'],1,0,1,6214304,1,,,,5699
9492d451d5d5a82bfc6f4c93c3a0c6e6d0cc4981,0,Impala Public Jenkins,2019-02-13 03:20:55+00:00,['6938831ae98f3e9cdb63ecbf63a608c17bdc0b6b'],2,2,4,6214308,1,,,,5699
55b9c899b1c1f5d0e6d7fde5eff677bb015c2e54,0,Impala Public Jenkins,2019-02-13 22:19:43+00:00,['9492d451d5d5a82bfc6f4c93c3a0c6e6d0cc4981'],3,188,191,6214499,10,1,1,0.176470588,5699
7cee01d1ba7ab6018bf6d7e4d90f4758fd458ce0,0,Impala Public Jenkins,2019-02-14 02:57:52+00:00,['55b9c899b1c1f5d0e6d7fde5eff677bb015c2e54'],1,1,2,6214501,1,,,,5699
f8c9ef48419966840b6026a7d81cfa11a3540a17,1,Impala Public Jenkins,2019-02-14 22:15:54+00:00,['7cee01d1ba7ab6018bf6d7e4d90f4758fd458ce0'],8,9,17,6214518,2,,,,5699
345d012fff81b0d2c261ab15ec29b9e1ead66192,0,Alex Rodoni,2019-02-14 22:28:53+00:00,['f8c9ef48419966840b6026a7d81cfa11a3540a17'],26,5,31,6214549,1,,,,5699
6a8bc7f742c6ee1085d8be5ac374bcf6c7bfa10f,0,Impala Public Jenkins,2019-02-15 01:54:03+00:00,['345d012fff81b0d2c261ab15ec29b9e1ead66192'],0,1,1,6214550,1,,,,5699
f0a47ab2ca6e5c19f74c55af67927f446785f23c,0,Impala Public Jenkins,2019-02-15 02:15:40+00:00,['6a8bc7f742c6ee1085d8be5ac374bcf6c7bfa10f'],1,3,4,6214554,1,0,1,1,5699
5ed6c665d190dbe5303e241afbc50e0eacb0a6af,1,Impala Public Jenkins,2019-02-15 03:50:15+00:00,['f0a47ab2ca6e5c19f74c55af67927f446785f23c'],31,92,123,6214677,4,0.346153846,0,0,5699
4f5096570cab1b4b76b4345f9f69dc23baa04aad,0,Alex Rodoni,2019-02-15 21:16:19+00:00,['5ed6c665d190dbe5303e241afbc50e0eacb0a6af'],9,12,21,6214698,1,,,,5699
0cb7187841780cabe368607ff559e493be59db22,1,Impala Public Jenkins,2019-02-15 21:28:05+00:00,['4f5096570cab1b4b76b4345f9f69dc23baa04aad'],30,1262,1292,6215990,15,1,1,1,5708
99e2d5056c977ed6d9c4b2f65febd183b3b0e64c,0,Alex Rodoni,2019-02-15 21:31:24+00:00,['0cb7187841780cabe368607ff559e493be59db22'],12,38,50,6216040,1,,,,5708
f4dd98236a45fc0cc2b11a6db7c91a6f04c183d3,1,Impala Public Jenkins,2019-02-16 01:08:12+00:00,['99e2d5056c977ed6d9c4b2f65febd183b3b0e64c'],161,1060,1221,6217261,5,0.4375,0.699652778,0.359375,5709
4344914bb3da582d4ed7d73d08c8a274033b5430,0,Impala Public Jenkins,2019-02-16 04:48:01+00:00,['f4dd98236a45fc0cc2b11a6db7c91a6f04c183d3'],3,9,12,6217273,1,0,0,1,5709
9c65cc436478bfc3c3ad81c2b3285eb663135597,0,Alex Rodoni,2019-02-19 20:53:48+00:00,['4344914bb3da582d4ed7d73d08c8a274033b5430'],1,1,2,6217275,1,,,,5709
7bb5b03703538e88d83a413b9dc838e1eed7250a,0,Impala Public Jenkins,2019-02-19 21:39:02+00:00,['9c65cc436478bfc3c3ad81c2b3285eb663135597'],0,1,1,6217276,1,0,1,0,5709
77960571b0e5c9fae6ddc037ca7624e03bcfe13a,0,Impala Public Jenkins,2019-02-19 22:09:06+00:00,['7bb5b03703538e88d83a413b9dc838e1eed7250a'],7,7,14,6217290,1,,,,5709
b8a8edddcb727a28c2d15bdb3533a32454364ade,0,Impala Public Jenkins,2019-02-19 22:31:17+00:00,['77960571b0e5c9fae6ddc037ca7624e03bcfe13a'],63,107,170,6217460,8,0,0,0,5710
c1274fafb04de1b9b7c3a17e209814b8c4346311,0,Impala Public Jenkins,2019-02-20 04:06:17+00:00,['b8a8edddcb727a28c2d15bdb3533a32454364ade'],22,55,77,6217537,2,1,1,0.954545455,5710
c659b78198a767b91c293cbaf77f5c8b269fba39,0,Impala Public Jenkins,2019-02-20 05:46:47+00:00,['c1274fafb04de1b9b7c3a17e209814b8c4346311'],12,12,24,6217561,3,,,,5710
290e48f5d703202d927da5ae188e1bb5d79e7bfe,1,Impala Public Jenkins,2019-02-20 19:24:37+00:00,['c659b78198a767b91c293cbaf77f5c8b269fba39'],805,1198,2003,6219564,73,0.340425532,0.319148936,0.946808511,5716
0b7c9645451e6c2d30e225a27a89a901df940b09,0,Impala Public Jenkins,2019-02-20 23:14:36+00:00,['290e48f5d703202d927da5ae188e1bb5d79e7bfe'],20,23,43,6219607,8,0,1,1,5716
113b2eb120ca36777b5f33632deb3a5dcfe3322a,0,Impala Public Jenkins,2019-02-20 23:37:19+00:00,['0b7c9645451e6c2d30e225a27a89a901df940b09'],1,2,3,6219610,1,0,1,1,5716
257fa0c68bb4e64880a64844d8d4023c54645230,0,Impala Public Jenkins,2019-02-21 00:30:12+00:00,['113b2eb120ca36777b5f33632deb3a5dcfe3322a'],3,19,22,6219632,4,1,1,0.909090909,5716
95414528199011716af0c55ac9c11eb69fb442b7,1,Impala Public Jenkins,2019-02-21 01:11:03+00:00,['257fa0c68bb4e64880a64844d8d4023c54645230'],115,222,337,6219969,1,0.16,0.72,0.7,5716
540278d57f9d44917c47ea070169c084cdf6dd61,1,Impala Public Jenkins,2019-02-21 02:35:41+00:00,['95414528199011716af0c55ac9c11eb69fb442b7'],43,292,335,6220304,5,0.67826087,0.87826087,0.965217391,5718
57ce2bd6416008a7a270a56b8a3d6efe00d2f20a,0,Impala Public Jenkins,2019-02-21 04:06:43+00:00,['540278d57f9d44917c47ea070169c084cdf6dd61'],24,11,35,6220339,1,0.615384615,1,0,5718
c8634b5287ad1a03461c340845f14053aab38230,0,Impala Public Jenkins,2019-02-21 09:10:00+00:00,['57ce2bd6416008a7a270a56b8a3d6efe00d2f20a'],1,3,4,6220343,1,0,1,1,5718
b7df73d3392e485fb7c2ed335a49f8c42a254563,1,Impala Public Jenkins,2019-02-21 21:07:44+00:00,['c8634b5287ad1a03461c340845f14053aab38230'],6,12,18,6220361,4,,,,5718
01592b5fa374ece9e973585d831f771c46fb5645,0,Impala Public Jenkins,2019-02-21 21:25:31+00:00,['b7df73d3392e485fb7c2ed335a49f8c42a254563'],1,4,5,6220366,1,1,1,1,5718
4ed947365447934c55eeec94610a2b3cbd993937,0,Impala Public Jenkins,2019-02-21 23:20:07+00:00,['01592b5fa374ece9e973585d831f771c46fb5645'],4,4,8,6220374,2,,,,5718
f9ae897c4b7a6d93cb0a5e9505f1e0faddebc65a,0,Alex Rodoni,2019-02-21 23:40:39+00:00,['4ed947365447934c55eeec94610a2b3cbd993937'],13,28,41,6220415,1,,,,5718
91d8a8f6280b2b802fe8ccc52251937c5a415766,0,Impala Public Jenkins,2019-02-22 04:01:35+00:00,['f9ae897c4b7a6d93cb0a5e9505f1e0faddebc65a'],444,482,926,6221341,20,,,,5718
dce82e4e018d1944ff19bb6f87139b51c1b0287e,1,Joe McDonnell,2019-02-22 17:23:03+00:00,['91d8a8f6280b2b802fe8ccc52251937c5a415766'],33,62,95,6221436,17,0.384615385,0.538461538,0.461538462,5718
681b256627e5e569778d4996bbdf530e30c528eb,0,Impala Public Jenkins,2019-02-22 22:50:28+00:00,['dce82e4e018d1944ff19bb6f87139b51c1b0287e'],0,12,12,6221448,1,1,1,1,5718
59e1087d112df21d1ffe4d6f616d93da595036d7,0,Impala Public Jenkins,2019-02-23 05:32:01+00:00,['681b256627e5e569778d4996bbdf530e30c528eb'],1,3,4,6221452,1,,,,5718
63eee03968c78fafd8afa23cf3f8c93ad415d796,0,Alex Rodoni,2019-02-26 00:58:43+00:00,['59e1087d112df21d1ffe4d6f616d93da595036d7'],1,3,4,6221456,1,,,,5718
1718f9c07bfac2e14d0d9a2de052dea8ac65f45f,1,Impala Public Jenkins,2019-02-26 03:38:09+00:00,['63eee03968c78fafd8afa23cf3f8c93ad415d796'],47,157,204,6221660,7,0.595744681,0.957446809,0.680851064,5719
fced1cc1bbe62bb94b82962aea0560df8ed00d2d,0,Bharath Vissapragada,2019-02-26 04:02:29+00:00,['1718f9c07bfac2e14d0d9a2de052dea8ac65f45f'],1,4,5,6221665,1,,,,5719
1772b3bbb54fc23263abf53b621b00b6c89caecd,0,Impala Public Jenkins,2019-02-26 04:25:59+00:00,['fced1cc1bbe62bb94b82962aea0560df8ed00d2d'],0,1,1,6221666,1,,,,5719
5a270e097214624ced7814692c58b03d575e7ace,1,Impala Public Jenkins,2019-02-26 14:47:26+00:00,['1772b3bbb54fc23263abf53b621b00b6c89caecd'],53,138,191,6221857,6,0,0,1,5720
e9936b02cf5b9673d6dd8f3624b07e2ec81f763e,0,Joe McDonnell,2019-02-26 17:28:23+00:00,['5a270e097214624ced7814692c58b03d575e7ace'],1,19,20,6221877,2,0,0,1,5720
72fd7c3d4d50f30479b5f6d50b327dff9ff013ac,0,Impala Public Jenkins,2019-02-26 22:32:25+00:00,['e9936b02cf5b9673d6dd8f3624b07e2ec81f763e'],2,4,6,6221883,2,0,1,1,5720
e4f46dad92f92c9a0e7730d7b393d42cf7ee8c7f,0,Impala Public Jenkins,2019-02-26 23:11:10+00:00,['72fd7c3d4d50f30479b5f6d50b327dff9ff013ac'],17,71,88,6221971,4,0,0,0,5720
360f88e20709a4f1447c4997d1dc458e80874389,0,Impala Public Jenkins,2019-02-26 23:29:56+00:00,['e4f46dad92f92c9a0e7730d7b393d42cf7ee8c7f'],532,552,1084,6223055,21,1,0.833333333,1,5720
7ba6aa64a2455df30524ad42b10d7fd9227efacb,1,Joe McDonnell,2019-02-26 23:44:14+00:00,['360f88e20709a4f1447c4997d1dc458e80874389'],3,79,82,6223137,3,0.868421053,0.868421053,1,5720
0cc9371f0fce8b1c341d9cf034afe18590246070,0,Impala Public Jenkins,2019-02-27 00:08:44+00:00,['7ba6aa64a2455df30524ad42b10d7fd9227efacb'],410,479,889,6224026,4,1,1,1,5722
ca89014eaabdb8a74f1ff7643f65020a03ce82ab,0,Impala Public Jenkins,2019-02-27 04:01:26+00:00,['0cc9371f0fce8b1c341d9cf034afe18590246070'],0,2,2,6224028,1,,,,5722
b74d63222875482c7efe38b8b2e5ff091a94fb6a,0,Impala Public Jenkins,2019-02-27 04:11:46+00:00,['ca89014eaabdb8a74f1ff7643f65020a03ce82ab'],4,4,8,6224036,2,,,,5722
46e03392c38299731d937898c4177b7baedc8f7d,0,Impala Public Jenkins,2019-02-27 07:49:26+00:00,['b74d63222875482c7efe38b8b2e5ff091a94fb6a'],9,92,101,6224137,9,0,0.576923077,0.057692308,5722
8b143f53036657fc74180def4fb8276d57ca179a,0,Impala Public Jenkins,2019-02-27 08:00:26+00:00,['46e03392c38299731d937898c4177b7baedc8f7d'],2,23,25,6224162,3,0.846153846,0.846153846,1,5722
360b23bfa4eeb337cce380512f106a692bf3c49b,1,Impala Public Jenkins,2019-02-27 09:12:44+00:00,['8b143f53036657fc74180def4fb8276d57ca179a'],97,776,873,6225035,19,0.372,0.804,0.412,5725
adced30896ade0f71e64cc2d5bad1cd9f43119b7,0,Impala Public Jenkins,2019-02-27 09:38:15+00:00,['360b23bfa4eeb337cce380512f106a692bf3c49b'],58,0,58,6225093,7,1,0.55,0,5725
3ead9b9a08fe071992347682098b73ba26d5b95e,0,Impala Public Jenkins,2019-02-28 00:08:36+00:00,['adced30896ade0f71e64cc2d5bad1cd9f43119b7'],1,1,2,6225095,1,,,,5725
793e8192efae3b777717408b41b3787e681968c6,0,Impala Public Jenkins,2019-02-28 02:05:39+00:00,['3ead9b9a08fe071992347682098b73ba26d5b95e'],16,78,94,6225189,6,0.25,1,0.75,5725
1879436955e06b094da52835881528e453274d29,1,Impala Public Jenkins,2019-02-28 03:15:01+00:00,['793e8192efae3b777717408b41b3787e681968c6'],6,162,168,6225357,9,0.025,0.9875,0.675,5725
ab2eda2096fcb6e62e27816d9ce96aa80f0ebda7,0,Impala Public Jenkins,2019-02-28 05:50:50+00:00,['1879436955e06b094da52835881528e453274d29'],0,7,7,6225364,1,,,,5725
1e6c6724bc2c62e062244df62be9bd950d9d684c,0,Impala Public Jenkins,2019-02-28 20:20:14+00:00,['ab2eda2096fcb6e62e27816d9ce96aa80f0ebda7'],5,19,24,6225388,2,0,0,1,5725
43410a33cd3e5415f7a98a77e9eb1d62a17e43c9,0,Alex Rodoni,2019-02-28 20:58:26+00:00,['1e6c6724bc2c62e062244df62be9bd950d9d684c'],498,743,1241,6226629,4,,,,5725
81e7789eca50d03bb7c5fbcf447593be523d539d,1,Alex Rodoni,2019-02-28 21:43:10+00:00,['43410a33cd3e5415f7a98a77e9eb1d62a17e43c9'],104,171,275,6226904,1,,,,5725
eb3afac37a73731042c44c96ed2f47362f926c60,1,Impala Public Jenkins,2019-03-01 02:52:32+00:00,['81e7789eca50d03bb7c5fbcf447593be523d539d'],3,50,53,6226957,2,1,1,0.851851852,5725
cf92d5b23f01e3cb610006bf17a249ab75c719e7,0,Impala Public Jenkins,2019-03-01 03:27:30+00:00,['eb3afac37a73731042c44c96ed2f47362f926c60'],8,15,23,6226980,2,0,0,1,5725
74dba7a52da6dc99d450e3a7d789ceac3197bdfb,0,Impala Public Jenkins,2019-03-01 04:20:49+00:00,['cf92d5b23f01e3cb610006bf17a249ab75c719e7'],2,16,18,6226998,3,1,1,1,5725
dc1bc3ca03337d6d63d88261226047bb7a55493b,0,Impala Public Jenkins,2019-03-04 14:40:14+00:00,['74dba7a52da6dc99d450e3a7d789ceac3197bdfb'],2,25,27,6227025,2,1,1,1,5725
43adfac5078780cd939d8ba23d481529dbebf0aa,0,Impala Public Jenkins,2019-03-04 22:42:13+00:00,['dc1bc3ca03337d6d63d88261226047bb7a55493b'],6,4,10,6227035,1,1,0,1,5725
110b362a52eda053caa0d177016e22a23a1a9612,0,Impala Public Jenkins,2019-03-04 23:56:13+00:00,['43adfac5078780cd939d8ba23d481529dbebf0aa'],17,33,50,6227085,2,0.416666667,0.416666667,0.416666667,5725
63d45d59bae3fb37571088c0a2418a9df7630c51,0,Impala Public Jenkins,2019-03-05 02:33:19+00:00,['110b362a52eda053caa0d177016e22a23a1a9612'],4,8,12,6227097,2,0,1,1,5725
60ca5f22eb0f880a1ade3a3888231ce9b2c04b1c,1,Impala Public Jenkins,2019-03-05 05:35:38+00:00,['63d45d59bae3fb37571088c0a2418a9df7630c51'],35,73,108,6227205,2,0.714285714,1,0.142857143,5725
f1fd72a8ee6334711f381af887619d13cfa3f5b3,1,Impala Public Jenkins,2019-03-05 09:20:12+00:00,['60ca5f22eb0f880a1ade3a3888231ce9b2c04b1c'],1,9,10,6227215,1,,,,5725
2e99659e05ec3f0cc81f12c0ab913aac3abe1720,0,Impala Public Jenkins,2019-03-05 09:39:44+00:00,['f1fd72a8ee6334711f381af887619d13cfa3f5b3'],19,51,70,6227285,4,1,1,0.666666667,5725
9f61dc755db4a5a80a886661e1431e3c91815251,1,Impala Public Jenkins,2019-03-05 22:31:13+00:00,['2e99659e05ec3f0cc81f12c0ab913aac3abe1720'],4,19,23,6227308,3,1,1,1,5725
e316f1be3b25e460fc01704b24d8f3a3f0ed2942,0,Alex Rodoni,2019-03-06 00:12:46+00:00,['9f61dc755db4a5a80a886661e1431e3c91815251'],0,19,19,6227327,1,,,,5725
10a400f10c66f0897f62c990a03013c1069f6110,0,Impala Public Jenkins,2019-03-06 00:16:46+00:00,['e316f1be3b25e460fc01704b24d8f3a3f0ed2942'],41,0,41,6227368,1,,,,5725
f88d5da899deb1465a9745827e95ba96dc6c1c55,1,Alex Rodoni,2019-03-06 00:30:51+00:00,['10a400f10c66f0897f62c990a03013c1069f6110'],47,96,143,6227511,1,,,,5725
c0114874fe414c9637681f41078872f382d4321f,1,Alex Rodoni,2019-03-06 01:20:33+00:00,['f88d5da899deb1465a9745827e95ba96dc6c1c55'],3,4,7,6227518,1,,,,5725
794b9a35c37daced3139cc477bf3c60ee7af300b,0,Impala Public Jenkins,2019-03-06 03:49:03+00:00,['c0114874fe414c9637681f41078872f382d4321f'],823,903,1726,6229244,5,0.5,0.5,0.5,5727
7d4533065b8acf3a9ff7a4fdc6b51dea3fab124e,0,Joe McDonnell,2019-03-06 05:09:08+00:00,['794b9a35c37daced3139cc477bf3c60ee7af300b'],1,2,3,6229247,1,,,,5727
8b2e2a6a18be3dc8d5f591a2e9193f02bb64af68,0,Impala Public Jenkins,2019-03-06 05:12:08+00:00,['7d4533065b8acf3a9ff7a4fdc6b51dea3fab124e'],27,9,36,6229283,1,,,,5727
eba08aa749211522631b16f87bf0f113d2470f29,1,Impala Public Jenkins,2019-03-06 05:23:15+00:00,['8b2e2a6a18be3dc8d5f591a2e9193f02bb64af68'],157,223,380,6229663,5,0.263157895,1,0.973684211,5727
bb5d3bf5cc2460fe0551840d01dcfc382498261f,0,Impala Public Jenkins,2019-03-07 05:58:13+00:00,['eba08aa749211522631b16f87bf0f113d2470f29'],1,2,3,6229666,1,1,1,0,5727
b32ca155ea463187bdee87e74039d3dcd2681603,1,Impala Public Jenkins,2019-03-07 10:46:13+00:00,['bb5d3bf5cc2460fe0551840d01dcfc382498261f'],297,1112,1409,6231075,52,0.663157895,0.894736842,0.887719298,5739
337bc74881bf9d4219fdc5610f40cdeb73781a9e,0,Alex Rodoni,2019-03-07 21:40:56+00:00,['b32ca155ea463187bdee87e74039d3dcd2681603'],0,98,98,6231173,2,,,,5740
1c32317645c7eae1aef597ffd754a5e46f6a7390,0,Alex Rodoni,2019-03-07 22:39:26+00:00,['337bc74881bf9d4219fdc5610f40cdeb73781a9e'],5,8,13,6231186,1,,,,5740
31a48610fc30db0a1f329b64deda839c70d63d1d,0,Alex Rodoni,2019-03-07 23:39:08+00:00,['1c32317645c7eae1aef597ffd754a5e46f6a7390'],17,16,33,6231219,2,,,,5740
6b0fd9fa8023c9c06b2bce2811097df29827731a,0,Impala Public Jenkins,2019-03-08 00:15:19+00:00,['31a48610fc30db0a1f329b64deda839c70d63d1d'],246,0,246,6231465,4,,,,5740
214f61a180580e56019af141ded3b196ba5e10cf,1,Impala Public Jenkins,2019-03-08 03:35:09+00:00,['6b0fd9fa8023c9c06b2bce2811097df29827731a'],10,55,65,6231530,7,0.244444444,0.844444444,0.377777778,5740
9686545bfd7236350d165813621bf783b42d1c18,1,Impala Public Jenkins,2019-03-08 04:39:08+00:00,['214f61a180580e56019af141ded3b196ba5e10cf'],465,1942,2407,6233937,30,0.640540541,0.736486486,0.401351351,5747
49027de9ff4450a438c8e631373c572ce189b36e,0,Todd Lipcon,2019-03-08 21:15:43+00:00,['9686545bfd7236350d165813621bf783b42d1c18'],4,16,20,6233957,2,0,0,1,5747
729fcf34764928bebfe7cf31153b57f7246404af,0,Impala Public Jenkins,2019-03-08 21:18:39+00:00,['49027de9ff4450a438c8e631373c572ce189b36e'],383,141,524,6234481,3,0.770700637,0.605095541,0.114649682,5747
288abf10f6142ae6cb02329604805a9a1dcc804f,0,Impala Public Jenkins,2019-03-09 01:21:05+00:00,['729fcf34764928bebfe7cf31153b57f7246404af'],1,65,66,6234547,2,0,1,1,5747
26639963e0ea66bea716c0238cdf1ff086159c7c,0,Impala Public Jenkins,2019-03-11 20:49:13+00:00,['288abf10f6142ae6cb02329604805a9a1dcc804f'],1,4,5,6234552,1,1,1,0,5747
76286bf2c0320cce0eb1bf0c269d344255b4dd0e,1,Alex Rodoni,2019-03-12 00:27:50+00:00,['26639963e0ea66bea716c0238cdf1ff086159c7c'],54,497,551,6235103,4,,,,5748
9cc75c59d5a09bd8cccc98bdf05cc64a98a70ffd,0,Alex Rodoni,2019-03-12 00:35:12+00:00,['76286bf2c0320cce0eb1bf0c269d344255b4dd0e'],56,85,141,6235244,1,,,,5748
9d67aafaea5ba8673d130dfc7c1e7a0b4f58303b,1,Impala Public Jenkins,2019-03-12 02:11:50+00:00,['9cc75c59d5a09bd8cccc98bdf05cc64a98a70ffd'],148,1103,1251,6236495,6,0.444444444,0.946127946,0.707070707,5748
535d286ee16721a35bda1861e4d011ea99a8c02f,1,Alex Rodoni,2019-03-13 02:37:08+00:00,['9d67aafaea5ba8673d130dfc7c1e7a0b4f58303b'],12,107,119,6236614,3,,,,5749
0d3d3258d2762887c61bf8e64e5df33dc2419817,0,Alex Rodoni,2019-03-13 18:04:17+00:00,['535d286ee16721a35bda1861e4d011ea99a8c02f'],89,69,158,6236772,4,,,,5749
668bb73e1153afcb50ffc8b45267232b926a2258,0,Alex Rodoni,2019-03-13 21:01:58+00:00,['0d3d3258d2762887c61bf8e64e5df33dc2419817'],0,24,24,6236796,1,,,,5749
ca98d6649d700517e90359d39c94d3356c6c092e,0,Alex Rodoni,2019-03-13 21:26:10+00:00,['668bb73e1153afcb50ffc8b45267232b926a2258'],105,83,188,6236984,2,,,,5749
79ce6b47f7ccf725c4d55cfb2d2988b7c602d0ea,0,Joe McDonnell,2019-03-13 22:54:38+00:00,['ca98d6649d700517e90359d39c94d3356c6c092e'],0,27,27,6237011,1,,,,5749
f9399087d837db05c247db6965de6c56c35e0935,0,Alex Rodoni,2019-03-14 18:45:28+00:00,['79ce6b47f7ccf725c4d55cfb2d2988b7c602d0ea'],0,20,20,6237031,3,,,,5749
58bc8937fae2b8c24065df57fc9c878e686a7fad,0,Alex Rodoni,2019-03-14 20:25:12+00:00,['f9399087d837db05c247db6965de6c56c35e0935'],4,3,7,6237038,1,,,,5749
3c71a4780c9ad5425ad3b933092c6fc12ca0ad80,0,Alex Rodoni,2019-03-14 21:00:56+00:00,['58bc8937fae2b8c24065df57fc9c878e686a7fad'],21,21,42,6237080,1,,,,5749
57a667189dc4bc74b2ac6a103f2cb8520337e5ca,1,Impala Public Jenkins,2019-03-14 21:26:58+00:00,['3c71a4780c9ad5425ad3b933092c6fc12ca0ad80'],469,538,1007,6238087,3,1,1,0,5751
067679616953aa1788b5712e943077dfef2aed66,0,Impala Public Jenkins,2019-03-14 22:11:22+00:00,['57a667189dc4bc74b2ac6a103f2cb8520337e5ca'],96,124,220,6238307,2,,,,5752
b7c1124b9e8fc17a75d45c2380379ad28e98d332,0,Impala Public Jenkins,2019-03-14 22:43:50+00:00,['067679616953aa1788b5712e943077dfef2aed66'],160,125,285,6238592,5,1,1,1,5752
b79a03bf408e32d0a29ead33c788b84e7bf1d439,0,Impala Public Jenkins,2019-03-15 04:26:59+00:00,['b7c1124b9e8fc17a75d45c2380379ad28e98d332'],17,157,174,6238766,5,0,0.515625,1,5753
dee911ee6cc749b4c8172f0e644069e16bf5ef57,0,Impala Public Jenkins,2019-03-15 05:15:49+00:00,['b79a03bf408e32d0a29ead33c788b84e7bf1d439'],1,8,9,6238775,2,1,1,1,5753
4b83ff1a8d0cf97d45d01a89456f48a57031291d,0,Alex Rodoni,2019-03-15 19:00:08+00:00,['dee911ee6cc749b4c8172f0e644069e16bf5ef57'],24,0,24,6238799,1,,,,5753
53ef115e8e5cac231ef948f8670106c348d197fe,1,Joe McDonnell,2019-03-15 20:26:12+00:00,['4b83ff1a8d0cf97d45d01a89456f48a57031291d'],147,251,398,6239197,18,0,0.223529412,0.964705882,5753
e73a007ee8209ac63e66e126d8488c11e3697f18,0,Impala Public Jenkins,2019-03-16 02:29:49+00:00,['53ef115e8e5cac231ef948f8670106c348d197fe'],0,6,6,6239203,1,0,0,0,5753
ab9a7b7e1982a534c0cfd341836120bf6ae30cb4,0,Joe McDonnell,2019-03-18 16:53:05+00:00,['e73a007ee8209ac63e66e126d8488c11e3697f18'],0,15,15,6239218,1,,,,5753
e0a43fa8a21fd89df6d0a86d9e0da1faa6cfcb7b,0,Alex Rodoni,2019-03-18 22:15:12+00:00,['ab9a7b7e1982a534c0cfd341836120bf6ae30cb4'],1,1,2,6239220,1,,,,5753
c5918b44b024b3fb476fbae2a1b194e6259befcd,0,Todd Lipcon,2019-03-18 23:54:00+00:00,['e0a43fa8a21fd89df6d0a86d9e0da1faa6cfcb7b'],6,51,57,6239277,4,0,1,1,5753
6e8c330f40da087ca0d8ba844cd9d97a8e60ff67,0,Todd Lipcon,2019-03-18 23:55:57+00:00,['c5918b44b024b3fb476fbae2a1b194e6259befcd'],6,6,12,6239289,1,,,,5753
9090fc239b62c0d698c6c256c20d86b69f8cc64f,0,Impala Public Jenkins,2019-03-19 01:20:13+00:00,['6e8c330f40da087ca0d8ba844cd9d97a8e60ff67'],20,200,220,6239509,13,1,0.086956522,0.391304348,5755
2014199c80c6c74ba4e46139337cd41e1089cc9e,0,Todd Lipcon,2019-03-19 06:54:09+00:00,['9090fc239b62c0d698c6c256c20d86b69f8cc64f'],2,2,4,6239513,1,,,,5755
d3428a58d8f54d1a64d5aeb1af3f76b7ffcb53d0,0,Lars Volker,2019-03-19 14:52:32+00:00,['2014199c80c6c74ba4e46139337cd41e1089cc9e'],6,6,12,6239525,1,,,,5755
4743f5edb93905d9feff2b5db5b6e4741c972449,0,Lars Volker,2019-03-19 14:52:58+00:00,['d3428a58d8f54d1a64d5aeb1af3f76b7ffcb53d0'],2,2,4,6239529,1,,,,5755
3baf08ae3b8bf2bcf6d83a4a8b9259d12bbdad84,0,Impala Public Jenkins,2019-03-20 01:23:11+00:00,['4743f5edb93905d9feff2b5db5b6e4741c972449'],1,7,8,6239537,1,0,0,1,5755
5c2ee58066288289b8dc916284b4c8df883f92e9,1,Impala Public Jenkins,2019-03-20 03:23:08+00:00,['3baf08ae3b8bf2bcf6d83a4a8b9259d12bbdad84'],50,73,123,6239660,1,1,1,0,5755
9ad9a1624a3ccc3caadab6d7dd4eb7de96e110dd,1,Impala Public Jenkins,2019-03-20 22:18:16+00:00,['5c2ee58066288289b8dc916284b4c8df883f92e9'],1,8,9,6239669,2,0.25,1,1,5755
602a9eb7193b81a3b7f8a05e044a70831da06714,0,Impala Public Jenkins,2019-03-20 22:55:30+00:00,['9ad9a1624a3ccc3caadab6d7dd4eb7de96e110dd'],1,15,16,6239685,2,1,1,1,5755
685318423415cd6235adf47fe8026383f5e99a60,1,Impala Public Jenkins,2019-03-21 10:29:43+00:00,['602a9eb7193b81a3b7f8a05e044a70831da06714'],11,59,70,6239755,5,0,0.642857143,0.678571429,5755
656a2e8af04d23623da9fbcb4c2d2e8153d85083,1,Impala Public Jenkins,2019-03-21 19:08:12+00:00,['685318423415cd6235adf47fe8026383f5e99a60'],237,1131,1368,6241123,38,0.328981723,0.637075718,0.890339426,5764
6436fc5fa3461b1e23a437a070c38e77d51ed1dc,0,Impala Public Jenkins,2019-03-22 02:02:09+00:00,['656a2e8af04d23623da9fbcb4c2d2e8153d85083'],10,176,186,6241309,4,0.113636364,0.265151515,1,5764
bd6f98c601c0b28d643f7fce47c7a569e919e6ae,0,Impala Public Jenkins,2019-03-22 04:55:03+00:00,['6436fc5fa3461b1e23a437a070c38e77d51ed1dc'],5,0,5,6241314,1,1,1,1,5764
75ec9336e04d0fce0ac30963108c967dfeec771f,0,Impala Public Jenkins,2019-03-22 05:00:35+00:00,['bd6f98c601c0b28d643f7fce47c7a569e919e6ae'],2,4,6,6241320,1,0,0,1,5764
3135af8c437b3756da57a5d31d9e4080da07ec02,1,Impala Public Jenkins,2019-03-22 08:24:30+00:00,['75ec9336e04d0fce0ac30963108c967dfeec771f'],424,1118,1542,6242862,23,1,1,0.381625442,5768
00df388c5faaad7dba03f29a7160265f85547422,1,Impala Public Jenkins,2019-03-22 23:11:18+00:00,['3135af8c437b3756da57a5d31d9e4080da07ec02'],1,13,14,6242876,2,1,0,0.714285714,5768
54c440a5597cc40c9ecfce0dbf42954660d0d20a,0,Impala Public Jenkins,2019-03-23 01:30:08+00:00,['00df388c5faaad7dba03f29a7160265f85547422'],0,14,14,6242890,2,0.454545455,1,1,5768
eb95c912cb7e720caf66388942b4e94d95e95658,1,Impala Public Jenkins,2019-03-23 04:14:29+00:00,['54c440a5597cc40c9ecfce0dbf42954660d0d20a'],4,10,14,6242904,2,,,,5768
515ded0035e721ad2dfe24a713aefa375f518ad1,1,Impala Public Jenkins,2019-03-25 20:23:33+00:00,['eb95c912cb7e720caf66388942b4e94d95e95658'],1009,431,1440,6244344,22,1,0.027863777,0,5768
25559dd43cf25cd010b902f314b5a50c88c35228,1,Impala Public Jenkins,2019-03-25 21:46:18+00:00,['515ded0035e721ad2dfe24a713aefa375f518ad1'],3,3,6,6244350,1,,,,5768
ed9e1d499b3a3e6e30386dc11e55b6907eaaf409,1,Impala Public Jenkins,2019-03-26 04:03:46+00:00,['25559dd43cf25cd010b902f314b5a50c88c35228'],28,8,36,6244386,3,0.166666667,0.166666667,0.833333333,5768
209a350aae4c84a00dcd3bbc7354f84be3f7f572,0,Todd Lipcon,2019-03-26 04:37:49+00:00,['ed9e1d499b3a3e6e30386dc11e55b6907eaaf409'],6,6,12,6244398,1,,,,5768
36a67c467dbaf713f19c9423a9b4de1f0fc7a5a0,0,Alex Rodoni,2019-03-26 17:58:20+00:00,['209a350aae4c84a00dcd3bbc7354f84be3f7f572'],3,249,252,6244650,4,,,,5768
c63eebb2e3e386e60c91a06d9cbe586fee92025b,1,Impala Public Jenkins,2019-03-26 22:42:32+00:00,['36a67c467dbaf713f19c9423a9b4de1f0fc7a5a0'],5,20,25,6244675,1,1,1,1,5768
eb9021119b332005ac409c32c064e47c0be6ec02,0,Joe McDonnell,2019-03-27 15:49:25+00:00,['c63eebb2e3e386e60c91a06d9cbe586fee92025b'],3,1,4,6244679,1,,,,5768
1f5645c0d4027b326e90d40fe4705f8174c09ab2,0,Joe McDonnell,2019-03-27 15:49:25+00:00,['eb9021119b332005ac409c32c064e47c0be6ec02'],1,1,2,6244681,1,,,,5768
fbe6cb4e0189e1e7f00c5a1a501002e676e216ce,0,Joe McDonnell,2019-03-27 15:49:25+00:00,['1f5645c0d4027b326e90d40fe4705f8174c09ab2'],2,2,4,6244685,1,,,,5768
7cdeab7f75bfcf98c15f8554586aa621cbe9b631,0,Joe McDonnell,2019-03-27 15:49:25+00:00,['fbe6cb4e0189e1e7f00c5a1a501002e676e216ce'],7,10,17,6244702,1,,,,5768
7079fc99a91bc140fcb278d45c428ab90642f10c,0,Joe McDonnell,2019-03-27 15:49:25+00:00,['7cdeab7f75bfcf98c15f8554586aa621cbe9b631'],3,3,6,6244708,1,,,,5768
5578ccca154712b45bc472252e132e389a75d6c2,1,Impala Public Jenkins,2019-03-27 21:57:03+00:00,['7079fc99a91bc140fcb278d45c428ab90642f10c'],223,604,827,6245535,13,0.605405405,0.951351351,0.048648649,5770
6b77c61d9460f372edd3e98fa28754e2235f4888,1,Impala Public Jenkins,2019-03-28 01:52:45+00:00,['5578ccca154712b45bc472252e132e389a75d6c2'],11,284,295,6245830,5,0,0,1,5771
ca21c0cf0908048dbeec38b0a6874064958e0cce,0,Impala Public Jenkins,2019-03-28 07:18:50+00:00,['6b77c61d9460f372edd3e98fa28754e2235f4888'],91,129,220,6246050,2,1,0,0,5771
d255e7353827fa936cf82b7197fe282a71144f12,0,Alex Rodoni,2019-03-29 00:41:23+00:00,['ca21c0cf0908048dbeec38b0a6874064958e0cce'],13,11,24,6246074,2,,,,5771
826747bc4c8fc575f1cf8d25fdf7d8a2c9b86e42,0,Impala Public Jenkins,2019-03-29 01:24:10+00:00,['d255e7353827fa936cf82b7197fe282a71144f12'],14,23,37,6246111,2,0,1,1,5771
7adb411bd99812d30e2a8cf795557746591df15e,1,Impala Public Jenkins,2019-03-29 09:38:24+00:00,['826747bc4c8fc575f1cf8d25fdf7d8a2c9b86e42'],7,45,52,6246163,4,0,0,0.72,5771
a2a4de00145742ceb380510c9c53e6e22e221988,0,Impala Public Jenkins,2019-03-29 19:47:24+00:00,['7adb411bd99812d30e2a8cf795557746591df15e'],1,1,2,6246165,1,,,,5771
b2a87797a8be076a8e57a91e8db2692ca693e2f3,0,Impala Public Jenkins,2019-03-29 22:19:49+00:00,['a2a4de00145742ceb380510c9c53e6e22e221988'],41,314,355,6246520,4,0.560344828,1,1,5772
1fcea9e4b677f07dfaf6b0314ac763241a029e66,1,Impala Public Jenkins,2019-03-30 04:39:24+00:00,['b2a87797a8be076a8e57a91e8db2692ca693e2f3'],42,263,305,6246825,5,0.477876106,0.982300885,1,5772
eb483dddaf8fa8b9143deac23a583a6cb1a6aa27,0,Impala Public Jenkins,2019-03-30 12:20:30+00:00,['1fcea9e4b677f07dfaf6b0314ac763241a029e66'],36,249,285,6247110,7,0.885245902,0.918032787,0.573770492,5773
26c700c947e418a6d75f248664e8e6f085d10478,0,Impala Public Jenkins,2019-04-01 22:40:15+00:00,['eb483dddaf8fa8b9143deac23a583a6cb1a6aa27'],4,6,10,6247120,1,1,1,1,5773
5670f96b828d57f9e36510bb9af02bcc31de775c,1,Alex Rodoni,2019-04-02 01:26:24+00:00,['26c700c947e418a6d75f248664e8e6f085d10478'],2627,3680,6307,6253427,20,,,,5773
2cb93b7ac8cddf36545a7ad764530d443cfd51b5,0,Impala Public Jenkins,2019-04-03 03:47:32+00:00,['5670f96b828d57f9e36510bb9af02bcc31de775c'],0,8,8,6253435,1,0,0,1,5773
c7b63365e01bc3b5f6ec10a99977c8199f9b963b,0,Impala Public Jenkins,2019-04-03 06:22:35+00:00,['2cb93b7ac8cddf36545a7ad764530d443cfd51b5'],7,8,15,6253450,1,,,,5773
5771c45a21450e49fd2d969a8218bbc62f5530b0,1,Impala Public Jenkins,2019-04-03 23:42:08+00:00,['c7b63365e01bc3b5f6ec10a99977c8199f9b963b'],10,40,50,6253500,1,,,,5773
a0a20cdf9adcb899e4bb04e3f9278077dc2b52c0,0,Impala Public Jenkins,2019-04-04 13:55:57+00:00,['5771c45a21450e49fd2d969a8218bbc62f5530b0'],1,17,18,6253518,2,1,1,0,5773
d31ac7b9cc06d2cffe13eb4b53b9070db00f02cb,1,Impala Public Jenkins,2019-04-04 22:41:00+00:00,['a0a20cdf9adcb899e4bb04e3f9278077dc2b52c0'],1,1,2,6253520,1,,,,5773
17ed50b5ce37f64990c83df97ab73b1e653f138b,1,Impala Public Jenkins,2019-04-05 00:04:37+00:00,['d31ac7b9cc06d2cffe13eb4b53b9070db00f02cb'],335,473,808,6254328,17,1,1,0.261904762,5774
f3f7774d1a6dc41bd3d3a347bec5909d2ec4910f,0,Bharath Vissapragada,2019-04-05 00:43:57+00:00,['17ed50b5ce37f64990c83df97ab73b1e653f138b'],3,5,8,6254336,1,,,,5774
80b82b5b2c60ff934eabe42dd145c9f84ca3a60b,0,Impala Public Jenkins,2019-04-05 01:52:48+00:00,['f3f7774d1a6dc41bd3d3a347bec5909d2ec4910f'],1,16,17,6254353,1,1,1,1,5774
4057331fb8cb976ea11364c374183bab01d795da,0,Impala Public Jenkins,2019-04-05 21:57:16+00:00,['80b82b5b2c60ff934eabe42dd145c9f84ca3a60b'],1,52,53,6254406,2,0.692307692,0,0,5774
bcd7b0424597698540fec4ae201786ca39ad0dd0,1,Todd Lipcon,2019-04-06 00:08:50+00:00,['4057331fb8cb976ea11364c374183bab01d795da'],998,321,1319,6255725,12,0.102040816,1,0.469387755,5777
daa1bf9883e65adb82b11576b5ada4273bc9dd7f,0,Impala Public Jenkins,2019-04-06 03:15:21+00:00,['bcd7b0424597698540fec4ae201786ca39ad0dd0'],4,18,22,6255747,1,,,,5777
da153104f26ef94f1b4db323f5629d678c55f9ee,1,Tim Armstrong,2019-04-07 19:44:48+00:00,['daa1bf9883e65adb82b11576b5ada4273bc9dd7f'],0,1,1,6255748,1,,,,5777
8bb366573c3072149444c4524fc32a1245629548,0,Impala Public Jenkins,2019-04-09 01:17:51+00:00,['da153104f26ef94f1b4db323f5629d678c55f9ee'],1,12,13,6255761,1,,,,5777
39413a18117acde1822d9f084ab30c748ce837bc,1,Csaba Ringhofer,2019-04-09 08:54:23+00:00,['8bb366573c3072149444c4524fc32a1245629548'],121,615,736,6256497,18,0.411764706,0.739495798,0.655462185,5777
ead4d4d1dfc165f014f4bad331920e4e951e3fcb,1,Impala Public Jenkins,2019-04-09 10:23:13+00:00,['39413a18117acde1822d9f084ab30c748ce837bc'],1,5,6,6256503,2,1,1,1,5777
d808bcda9df74d02d452bfa9f4ce491dd873f241,0,Impala Public Jenkins,2019-04-09 10:31:14+00:00,['ead4d4d1dfc165f014f4bad331920e4e951e3fcb'],11,46,57,6256560,3,0.52173913,0,1,5777
d81e851a9ba4cc409b873b93deb54abb87a240da,0,Impala Public Jenkins,2019-04-09 10:37:54+00:00,['d808bcda9df74d02d452bfa9f4ce491dd873f241'],0,1,1,6256561,1,,,,5777
45364a47c12a71eee9ee5592e05a8fc2295951d5,0,Joe McDonnell,2019-04-09 15:35:26+00:00,['d81e851a9ba4cc409b873b93deb54abb87a240da'],51,80,131,6256692,3,1,1,1,5778
284a9814aad89877fe6b80456c628cdaaa286b24,1,Impala Public Jenkins,2019-04-09 22:29:19+00:00,['45364a47c12a71eee9ee5592e05a8fc2295951d5'],82,194,276,6256968,17,0.040816327,1,0.204081633,5779
5eaa265f6737633b4de1bdd68731d387780d4a76,0,Impala Public Jenkins,2019-04-10 00:34:55+00:00,['284a9814aad89877fe6b80456c628cdaaa286b24'],6,97,103,6257071,2,0.186440678,0.644067797,1,5779
8f23bac91ae8f1b98ccb7728a02b0179265f5ef8,0,Alex Rodoni,2019-04-10 21:51:37+00:00,['5eaa265f6737633b4de1bdd68731d387780d4a76'],282,796,1078,6258149,2,,,,5779
65837f82e19be13367edeb1dbb6daec442189817,0,Alex Rodoni,2019-04-11 01:04:44+00:00,['8f23bac91ae8f1b98ccb7728a02b0179265f5ef8'],27,32,59,6258208,1,,,,5779
50e259e3691b7de36f58408bde6413880c74845e,0,Impala Public Jenkins,2019-04-11 06:47:43+00:00,['65837f82e19be13367edeb1dbb6daec442189817'],1,1,2,6258210,1,,,,5779
10e052a681863a08d895c5447c6c7bf8b31156c1,1,Impala Public Jenkins,2019-04-11 11:06:02+00:00,['50e259e3691b7de36f58408bde6413880c74845e'],64,266,330,6258540,6,0.824742268,1,0.81443299,5779
2950955b3e3c74cc261de288511aa4704d46498a,0,Alex Rodoni,2019-04-11 18:56:29+00:00,['10e052a681863a08d895c5447c6c7bf8b31156c1'],12,7,19,6258559,1,,,,5779
f998d64767c074216e75a552b36ecf44ff295d07,1,Impala Public Jenkins,2019-04-11 21:19:31+00:00,['2950955b3e3c74cc261de288511aa4704d46498a'],8,8,16,6258575,1,,,,5779
8a859af16b45ad14360616f99275057591668748,0,Impala Public Jenkins,2019-04-11 21:20:48+00:00,['f998d64767c074216e75a552b36ecf44ff295d07'],17,23,40,6258615,1,1,1,1,5779
a103cb8ee2357c220eaf912d9aefd522b09f3e04,0,Impala Public Jenkins,2019-04-12 07:28:26+00:00,['8a859af16b45ad14360616f99275057591668748'],88,624,712,6259327,19,0.605504587,0.862385321,0.871559633,5781
a4ad8f35f7768ac608317e702fdbd3a042140186,0,Impala Public Jenkins,2019-04-13 00:27:19+00:00,['a103cb8ee2357c220eaf912d9aefd522b09f3e04'],14,26,40,6259367,3,1,1,1,5781
464cd0389a989d2e4f1c1c5321612521b1e57bed,0,Impala Public Jenkins,2019-04-13 02:30:44+00:00,['a4ad8f35f7768ac608317e702fdbd3a042140186'],1,1,2,6259369,1,,,,5781
2ca7f8e7c0781a1914275b3506cf8a7748c44c85,1,Impala Public Jenkins,2019-04-13 02:42:32+00:00,['464cd0389a989d2e4f1c1c5321612521b1e57bed'],80,181,261,6259630,36,0,0.53125,0.5625,5781
3895828c4e973d641e1a0d60a3fec348cbe287a5,1,Impala Public Jenkins,2019-04-13 02:54:19+00:00,['2ca7f8e7c0781a1914275b3506cf8a7748c44c85'],0,131,131,6259761,3,,,,5783
df2d9f1333967e166895c13361d99f6554022eec,0,Impala Public Jenkins,2019-04-13 03:48:09+00:00,['3895828c4e973d641e1a0d60a3fec348cbe287a5'],2,5,7,6259768,1,,,,5783
8ec17b7cdffbd82ce7b3e652edc2530df083eeab,0,Impala Public Jenkins,2019-04-14 08:11:05+00:00,['df2d9f1333967e166895c13361d99f6554022eec'],31,51,82,6259850,4,0,0,1,5783
7bba2e4e4fc4d774f6970473cc7df30a2cbb2be3,1,Impala Public Jenkins,2019-04-15 18:43:40+00:00,['8ec17b7cdffbd82ce7b3e652edc2530df083eeab'],8,10,18,6259868,4,,,,5783
596daf09fe22524bafb16f4deff1b79493303c05,1,Impala Public Jenkins,2019-04-15 22:34:23+00:00,['7bba2e4e4fc4d774f6970473cc7df30a2cbb2be3'],2,2,4,6259872,1,,,,5783
a223353c6d2daa6184566914c08aeab5eb3d3a08,0,Impala Public Jenkins,2019-04-16 02:46:08+00:00,['596daf09fe22524bafb16f4deff1b79493303c05'],4,6,10,6259882,1,,,,5783
53798b0454332df44efce0032a88ef49e770a095,0,Impala Public Jenkins,2019-04-16 03:49:09+00:00,['a223353c6d2daa6184566914c08aeab5eb3d3a08'],30,82,112,6259994,4,0,0.333333333,1,5783
55881609f1c21eb7a59c383de60171ffa8943db8,1,Impala Public Jenkins,2019-04-16 05:16:16+00:00,['53798b0454332df44efce0032a88ef49e770a095'],22,130,152,6260146,3,0.376811594,1,0.463768116,5783
986dbbc5145a4cfd796453d94e6c74eb786ea0d7,1,Impala Public Jenkins,2019-04-16 09:40:23+00:00,['55881609f1c21eb7a59c383de60171ffa8943db8'],49,407,456,6260602,11,0.170909091,1,0.901818182,5783
ded73049673eb44bb02ad3f7277d1e7915998bc0,0,Impala Public Jenkins,2019-04-16 11:56:48+00:00,['986dbbc5145a4cfd796453d94e6c74eb786ea0d7'],2,2,4,6260606,1,,,,5783
c0a6aad28dd1efaf388f0cfeaa056995213d56e5,0,Impala Public Jenkins,2019-04-16 22:40:13+00:00,['ded73049673eb44bb02ad3f7277d1e7915998bc0'],30,36,66,6260672,4,0,1,0,5783
a80ebb7a729c1ffd25db262527d4261e01763646,1,Impala Public Jenkins,2019-04-17 03:19:37+00:00,['c0a6aad28dd1efaf388f0cfeaa056995213d56e5'],3,135,138,6260810,6,0.536231884,0.942028986,0.724637681,5783
5fa076e95cfbfcc044dc14cbb20af825936af82a,1,Impala Public Jenkins,2019-04-17 05:30:33+00:00,['a80ebb7a729c1ffd25db262527d4261e01763646'],227,84,311,6261121,10,1,1,0,5783
667067a7b7c3b2b42187e59295b94ba0ca4249f0,1,Impala Public Jenkins,2019-04-17 09:14:22+00:00,['5fa076e95cfbfcc044dc14cbb20af825936af82a'],2,3,5,6261126,1,1,1,0,5783
30082232ed83d712b24756bf09fd2c48dc15e571,1,Impala Public Jenkins,2019-04-17 22:10:03+00:00,['667067a7b7c3b2b42187e59295b94ba0ca4249f0'],30,509,539,6261665,2,0,0,0,5783
c8dbad8ed989258c241affb40a059fc083f9a90a,0,Impala Public Jenkins,2019-04-17 22:16:54+00:00,['30082232ed83d712b24756bf09fd2c48dc15e571'],9,11,20,6261685,2,,,,5783
2ab23088849fa1da33e14b25816622837e50e99e,1,Impala Public Jenkins,2019-04-18 01:20:22+00:00,['c8dbad8ed989258c241affb40a059fc083f9a90a'],5,13,18,6261703,2,0.285714286,1,1,5783
25c3dfb774296bce6ca511042babd97dca4b02cb,1,Impala Public Jenkins,2019-04-18 03:11:33+00:00,['2ab23088849fa1da33e14b25816622837e50e99e'],87,91,178,6261881,6,1,0,1,5783
5c2d211a88c1190a02ce7720fda7b0871f1e5cf5,0,Impala Public Jenkins,2019-04-18 10:05:51+00:00,['25c3dfb774296bce6ca511042babd97dca4b02cb'],5,40,45,6261926,2,0,1,1,5783
10b9195035a7a8f948c378a09b357deb549c8285,1,Impala Public Jenkins,2019-04-18 23:19:04+00:00,['5c2d211a88c1190a02ce7720fda7b0871f1e5cf5'],3,10,13,6261939,2,0.666666667,0.666666667,1,5783
1a800457a13c3407a33e796cef0c328b2d90c52e,0,Impala Public Jenkins,2019-04-19 05:00:30+00:00,['10b9195035a7a8f948c378a09b357deb549c8285'],11,124,135,6262074,5,0.617647059,0.985294118,0.985294118,5783
8412c772cb551c59fdb6e9dd59b49043f4aa9ef6,0,Tim Armstrong,2019-04-19 20:55:38+00:00,['1a800457a13c3407a33e796cef0c328b2d90c52e'],12,92,104,6262178,4,0.242424242,1,0.96969697,5784
2fdc0a57d1b5ca85e47a4ac7dc955336fda693a6,1,Impala Public Jenkins,2019-04-19 21:49:46+00:00,['8412c772cb551c59fdb6e9dd59b49043f4aa9ef6'],189,329,518,6262696,29,1,1,1,5785
67f77d41d40523074385b8dbccfa6ef6ef81dd57,0,Impala Public Jenkins,2019-04-19 22:08:24+00:00,['2fdc0a57d1b5ca85e47a4ac7dc955336fda693a6'],2,5,7,6262703,1,1,1,1,5785
b5805de3e65fd1c7154e4169b323bb38ddc54f4f,1,Impala Public Jenkins,2019-04-23 13:33:57+00:00,['67f77d41d40523074385b8dbccfa6ef6ef81dd57'],463,4241,4704,6267407,163,0.277434312,0.717928903,0.731066461,5801
26a20b8404ebbc83a9ad5d0c7087dd913a53add5,0,Impala Public Jenkins,2019-04-24 03:52:13+00:00,['b5805de3e65fd1c7154e4169b323bb38ddc54f4f'],1,1,2,6267409,1,,,,5801
f25a899924856f705ecb581b237a149003279473,1,Impala Public Jenkins,2019-04-24 20:08:13+00:00,['26a20b8404ebbc83a9ad5d0c7087dd913a53add5'],20,410,430,6267839,6,0.042253521,0.042253521,0.943661972,5801
95c6495ae53cebf44fc1585b3bca021b8f3c5759,0,Impala Public Jenkins,2019-04-25 00:05:42+00:00,['f25a899924856f705ecb581b237a149003279473'],1,1,2,6267841,1,,,,5801
63d55359e06b7b061c8edea38b34617c250ad3b1,0,Impala Public Jenkins,2019-04-25 01:38:13+00:00,['95c6495ae53cebf44fc1585b3bca021b8f3c5759'],34,145,179,6268020,5,0.0375,0.5625,1,5801
2c45ab093353e1215c08552b2db8c458eb4a0b29,0,Impala Public Jenkins,2019-04-25 04:24:23+00:00,['63d55359e06b7b061c8edea38b34617c250ad3b1'],95,27,122,6268142,14,,,,5801
b66ac16375d6763e5b5a0128d66e73835dcef904,0,Impala Public Jenkins,2019-04-25 06:59:08+00:00,['2c45ab093353e1215c08552b2db8c458eb4a0b29'],5,3,8,6268150,2,,,,5801
e4388740f765275a4fbd004adc67f1fcc13403a7,1,Impala Public Jenkins,2019-04-25 20:43:45+00:00,['b66ac16375d6763e5b5a0128d66e73835dcef904'],15,25,40,6268190,3,,,,5801
e28910aa5cf5191676fa9d40fcfaa100dbb6993f,0,Todd Lipcon,2019-04-25 23:39:53+00:00,['e4388740f765275a4fbd004adc67f1fcc13403a7'],215,34,249,6268439,10,1,1,1,5801
28d5a8299c27fd06779e108943a9aa128c5af15f,0,Impala Public Jenkins,2019-04-26 02:28:45+00:00,['e28910aa5cf5191676fa9d40fcfaa100dbb6993f'],9,9,18,6268457,3,,,,5801
2dda47ec27e8f15810907d77c6e41c275355cea6,1,Impala Public Jenkins,2019-04-26 05:47:36+00:00,['28d5a8299c27fd06779e108943a9aa128c5af15f'],17,263,280,6268737,6,0.658119658,1,0.658119658,5802
114712031f2293af5b3d9509776f88c23d3fa0fc,1,Impala Public Jenkins,2019-04-26 10:54:33+00:00,['2dda47ec27e8f15810907d77c6e41c275355cea6'],466,479,945,6269682,10,1,0.333333333,0.287356322,5804
6a703741d8fdc359833a0d593ca8b121cd5d890d,0,Impala Public Jenkins,2019-04-26 21:08:41+00:00,['114712031f2293af5b3d9509776f88c23d3fa0fc'],95,468,563,6270245,3,0.200980392,0.666666667,0.392156863,5805
349142635250f92412003a1e62829fc4b441dc75,1,Impala Public Jenkins,2019-04-26 21:11:43+00:00,['6a703741d8fdc359833a0d593ca8b121cd5d890d'],126,141,267,6270512,8,1,0.818181818,1,5805
8e97a3b5f68e55bd68b25a6d7966c8eb0d57e6d0,1,Joe McDonnell,2019-04-26 23:45:14+00:00,['349142635250f92412003a1e62829fc4b441dc75'],10,90,100,6270612,5,0,0,0.8,5805
3ea929af6b685f353b8cc2042f553985a4c0b4c7,1,Impala Public Jenkins,2019-04-27 22:32:47+00:00,['8e97a3b5f68e55bd68b25a6d7966c8eb0d57e6d0'],111,337,448,6271060,6,0.352941176,1,0.691176471,5805
42e326244857b3b03a659b34fd038f9036dddbe3,1,Impala Public Jenkins,2019-04-27 23:26:30+00:00,['3ea929af6b685f353b8cc2042f553985a4c0b4c7'],62,340,402,6271462,16,0.8,1,1,5808
b51c82d29643934477e7726bfeccf0b8fa6ffd0f,0,Impala Public Jenkins,2019-04-27 23:47:34+00:00,['42e326244857b3b03a659b34fd038f9036dddbe3'],1,1,2,6271464,1,,,,5808
931a8f0ba7f45d5b1608e62aff397b517b943e95,1,Tim Armstrong,2019-04-28 17:26:23+00:00,['b51c82d29643934477e7726bfeccf0b8fa6ffd0f'],32,117,149,6271613,14,0.571428571,0.642857143,0,5808
5ced9160bd65e5a72d739a7a5c548add2dbc4b84,1,Todd Lipcon,2019-04-29 18:16:25+00:00,['931a8f0ba7f45d5b1608e62aff397b517b943e95'],59,267,326,6271939,17,0.666666667,0.977011494,0.816091954,5809
15a33d1baaf4723794e52825a5c4082ff7487507,1,Bharath Vissapragada,2019-04-29 21:24:42+00:00,['5ced9160bd65e5a72d739a7a5c548add2dbc4b84'],13,592,605,6272544,10,0.289017341,0.621387283,0.471098266,5810
1090b3b2e4df1caa52dfcb8dfeb9484ee939f5d0,0,Impala Public Jenkins,2019-04-29 23:41:54+00:00,['15a33d1baaf4723794e52825a5c4082ff7487507'],1,13,14,6272558,1,1,1,0,5810
a73ef68745da6542657892d256e5b1bd29c68803,0,Impala Public Jenkins,2019-04-30 00:53:54+00:00,['1090b3b2e4df1caa52dfcb8dfeb9484ee939f5d0'],47,191,238,6272796,12,0.153846154,0.362637363,0.901098901,5810
095d609260ba8957c13e61c539892ab37c5da10b,0,Todd Lipcon,2019-04-30 03:15:11+00:00,['a73ef68745da6542657892d256e5b1bd29c68803'],1,1,2,6272798,1,,,,5810
246a5f661ef5f7174aacaec5386954366d1f33af,0,Todd Lipcon,2019-04-30 04:35:32+00:00,['095d609260ba8957c13e61c539892ab37c5da10b'],2,151,153,6272951,8,0.379746835,0.987341772,0.35443038,5811
c0dc9fddfe5eb7b4f3076f0589dcf02d795be566,0,Impala Public Jenkins,2019-04-30 10:45:50+00:00,['246a5f661ef5f7174aacaec5386954366d1f33af'],2,9,11,6272962,1,1,1,1,5811
c6e3ea4846cc56bc2d941a07f2f29821d4b788d5,0,Impala Public Jenkins,2019-04-30 11:29:54+00:00,['c0dc9fddfe5eb7b4f3076f0589dcf02d795be566'],51,57,108,6273070,5,0.875,1,1,5811
0a9ea803d2ed05135d1538dadf4b09ab6ad58e72,1,Impala Public Jenkins,2019-04-30 11:30:45+00:00,['c6e3ea4846cc56bc2d941a07f2f29821d4b788d5'],617,770,1387,6274457,13,0.222222222,0.98989899,0,5811
b273afd94067dfd062f9c1c039a082e4e6cbeb0c,0,Impala Public Jenkins,2019-04-30 11:48:53+00:00,['0a9ea803d2ed05135d1538dadf4b09ab6ad58e72'],2,3,5,6274462,1,,,,5811
7d80aedc3e0ee634e2a229fba8388f01097189de,1,Impala Public Jenkins,2019-04-30 17:34:18+00:00,['b273afd94067dfd062f9c1c039a082e4e6cbeb0c'],7,15,22,6274484,1,,,,5811
66fda62213472ab1a5e07e8719c73de4d4cd7ab4,1,Impala Public Jenkins,2019-04-30 19:58:22+00:00,['7d80aedc3e0ee634e2a229fba8388f01097189de'],67,530,597,6275081,7,0.319502075,1,0.883817427,5812
3ad5b3fba202bf6809986a86f5e041da656f0a88,1,Impala Public Jenkins,2019-04-30 22:45:32+00:00,['66fda62213472ab1a5e07e8719c73de4d4cd7ab4'],77,210,287,6275368,3,0.158878505,0.299065421,0.943925234,5812
d533cb1d43879cfa3892726bcae6316dea212754,1,Impala Public Jenkins,2019-04-30 23:31:44+00:00,['3ad5b3fba202bf6809986a86f5e041da656f0a88'],123,804,927,6276295,10,0.284090909,0.681818182,0.340909091,5814
c1b0a073938c144e9bf33901bd4df6dcda0f09ec,1,Impala Public Jenkins,2019-04-30 23:46:41+00:00,['d533cb1d43879cfa3892726bcae6316dea212754'],3,42,45,6276340,4,0.85,0.85,0.85,5814
d820952d86d34ba887c55a09e58b735cbef866c2,1,Impala Public Jenkins,2019-05-01 00:37:04+00:00,['c1b0a073938c144e9bf33901bd4df6dcda0f09ec'],55,101,156,6276496,8,0.565217391,1,0.47826087,5814
b4ff8018d33c71a502b3184d2f8ffb6c5e6c0207,0,Impala Public Jenkins,2019-05-01 02:56:50+00:00,['d820952d86d34ba887c55a09e58b735cbef866c2'],2,2,4,6276500,1,,,,5814
a89762bc014e97095c5108fd5785f51bf54a7a5d,1,Impala Public Jenkins,2019-05-01 03:27:43+00:00,['b4ff8018d33c71a502b3184d2f8ffb6c5e6c0207'],343,1694,2037,6278537,30,0.475083056,0.526578073,0.453488372,5819
61e7ff19f6afd080420af0af36591f6174906410,0,Impala Public Jenkins,2019-05-01 05:28:12+00:00,['a89762bc014e97095c5108fd5785f51bf54a7a5d'],1,1,2,6278539,1,,,,5819
eb97c746d2309fcf78ff3b50751cd5e27101539a,1,Impala Public Jenkins,2019-05-01 11:12:11+00:00,['61e7ff19f6afd080420af0af36591f6174906410'],69,349,418,6278957,20,0.72,0.673333333,0.733333333,5820
436a70e604d92ba17d11680dfdccc95988257a98,0,Impala Public Jenkins,2019-05-01 18:32:49+00:00,['eb97c746d2309fcf78ff3b50751cd5e27101539a'],1,3,4,6278961,1,1,1,0,5820
f07be8dfd802d41ee5a4011d17f4aad4d7208d65,0,Alex Rodoni,2019-05-01 19:37:48+00:00,['436a70e604d92ba17d11680dfdccc95988257a98'],13,30,43,6279004,1,,,,5820
e01fc42f16a6a2d6f8e7f8c8e89becb6ad9aa739,0,Alex Rodoni,2019-05-01 21:36:41+00:00,['f07be8dfd802d41ee5a4011d17f4aad4d7208d65'],5,0,5,6279009,1,,,,5820
909bf9320225c1e2dabb405ff591b4386548a9f4,0,Impala Public Jenkins,2019-05-02 03:38:07+00:00,['e01fc42f16a6a2d6f8e7f8c8e89becb6ad9aa739'],1,1,2,6279011,1,,,,5820
f22445fdb266ea6e835892d9a0885b283c84ca0c,0,Impala Public Jenkins,2019-05-02 10:21:54+00:00,['909bf9320225c1e2dabb405ff591b4386548a9f4'],2,2,4,6279015,1,,,,5820
fd622a47c8ce5fc35b967f027c86ac0695ba489a,0,Alex Rodoni,2019-05-02 19:51:09+00:00,['f22445fdb266ea6e835892d9a0885b283c84ca0c'],11,40,51,6279066,3,,,,5820
ab416d42232caf1d3eea5bf3d715c4d229eae8bb,0,Impala Public Jenkins,2019-05-02 20:13:19+00:00,['fd622a47c8ce5fc35b967f027c86ac0695ba489a'],1,1,2,6279068,1,,,,5820
d29d68c90d557353f7e312ba99747a6adca23820,1,Impala Public Jenkins,2019-05-02 20:41:00+00:00,['ab416d42232caf1d3eea5bf3d715c4d229eae8bb'],46,38,84,6279152,9,,,,5820
79c5f87565467074697a7d98e01c9742f7228991,1,Tim Armstrong,2019-05-02 23:33:32+00:00,['d29d68c90d557353f7e312ba99747a6adca23820'],397,881,1278,6280430,14,0.344827586,1,0.5,5822
c2516d220da8e532b6ebdb6f3a12e7ad97c4f597,0,Impala Public Jenkins,2019-05-02 23:58:26+00:00,['79c5f87565467074697a7d98e01c9742f7228991'],50,80,130,6280560,5,1,1,0,5822
04be046ecc3a4d43a62dc834ea4925f979d2dc27,0,Impala Public Jenkins,2019-05-03 03:38:35+00:00,['c2516d220da8e532b6ebdb6f3a12e7ad97c4f597'],6,0,6,6280566,1,,,,5822
99e1a39b908b81a94ef8cf4b41458c388a34755c,1,Impala Public Jenkins,2019-05-03 04:35:39+00:00,['04be046ecc3a4d43a62dc834ea4925f979d2dc27'],18,7,25,6280591,2,,,,5822
f5e89d6239eb7dbfa0acedd1704bcd398a197f9f,0,Alex Rodoni,2019-05-03 19:32:07+00:00,['99e1a39b908b81a94ef8cf4b41458c388a34755c'],37,39,76,6280667,1,,,,5822
2ece4c9b2e114a5e8873c5ac69e75b84c62bf5bd,1,Impala Public Jenkins,2019-05-03 19:39:42+00:00,['f5e89d6239eb7dbfa0acedd1704bcd398a197f9f'],55,2150,2205,6282872,23,0.366486486,0.606486486,0.873513514,5827
84addd2a4b74454bd929d6b2ada0f501a2c6b0cb,0,Impala Public Jenkins,2019-05-03 20:13:49+00:00,['2ece4c9b2e114a5e8873c5ac69e75b84c62bf5bd'],8,2,10,6282882,3,,,,5827
3fb36570ae0c7329cdbe3640515bc3e0cb066c81,0,Impala Public Jenkins,2019-05-03 20:28:48+00:00,['84addd2a4b74454bd929d6b2ada0f501a2c6b0cb'],25,96,121,6283003,9,0,0.857142857,0.301587302,5827
1423122945a901792c205d1532593f36c5fd2f87,0,Impala Public Jenkins,2019-05-04 03:24:52+00:00,['3fb36570ae0c7329cdbe3640515bc3e0cb066c81'],9,3,12,6283015,3,1,1,1,5827
748a3d57e5036934ea11723eea11e2535dd6fffa,0,Impala Public Jenkins,2019-05-04 20:02:48+00:00,['1423122945a901792c205d1532593f36c5fd2f87'],10,16,26,6283041,1,1,1,0,5827
23d7a6dce6ce4287edf20e3f63b225822cb88598,0,Impala Public Jenkins,2019-05-05 00:00:31+00:00,['748a3d57e5036934ea11723eea11e2535dd6fffa'],7,2,9,6283050,4,,,,5827
25db9ea8f3f4de3086610ccb6040a101691e6340,1,Impala Public Jenkins,2019-05-05 02:11:55+00:00,['23d7a6dce6ce4287edf20e3f63b225822cb88598'],6,36,42,6283092,2,1,1,1,5827
03ab3a58df0716b1259c1067175ee096c37460c0,0,Impala Public Jenkins,2019-05-06 21:46:56+00:00,['25db9ea8f3f4de3086610ccb6040a101691e6340'],3,2,5,6283097,1,,,,5827
ab47981098a6492bdc5c36c90fd9f742100298b5,0,Impala Public Jenkins,2019-05-06 22:03:39+00:00,['03ab3a58df0716b1259c1067175ee096c37460c0'],1,2,3,6283100,1,,,,5827
ae7aefe34cc3a88f8a7650312b8a2ac9dc6a348e,0,Alex Rodoni,2019-05-06 23:08:01+00:00,['ab47981098a6492bdc5c36c90fd9f742100298b5'],311,54,365,6283465,4,,,,5827
2bce974990e19788ec359deec50f06d44ec92048,1,Impala Public Jenkins,2019-05-07 00:36:56+00:00,['ae7aefe34cc3a88f8a7650312b8a2ac9dc6a348e'],148,465,613,6284078,29,1,0.936708861,0.506329114,5832
2fb2c7a6b56642e20f240a5da80fd8804d060ce9,0,Alex Rodoni,2019-05-07 20:03:52+00:00,['2bce974990e19788ec359deec50f06d44ec92048'],2,2,4,6284082,1,,,,5832
460aef657a7afdb0aa3bf91ac0f92c0496624379,0,Tim Armstrong,2019-05-08 18:16:28+00:00,['2fb2c7a6b56642e20f240a5da80fd8804d060ce9'],32,86,118,6284200,7,0.714285714,0,1,5832
9a216f1de96722a43056a724ea22071383b58360,0,Tim Armstrong,2019-05-08 18:18:14+00:00,['460aef657a7afdb0aa3bf91ac0f92c0496624379'],21,27,48,6284248,1,0,0,1,5832
4c6ac151ef2c6efac8a8a3d02c342334bf9d688c,1,Tim Armstrong,2019-05-08 20:14:27+00:00,['9a216f1de96722a43056a724ea22071383b58360'],9,38,47,6284295,1,,,,5832
081887272891f082300e00ca42b750bb284532ee,0,Alex Rodoni,2019-05-09 19:19:57+00:00,['4c6ac151ef2c6efac8a8a3d02c342334bf9d688c'],12,6,18,6284313,1,,,,5832
446ae499a7fd4bb1f018d2d8a90a442d283c76d0,0,Tim Armstrong,2019-05-09 21:41:19+00:00,['081887272891f082300e00ca42b750bb284532ee'],0,15,15,6284328,1,,,,5832
ed0a2b6010107c0719ca00991259298c59730a0b,0,Impala Public Jenkins,2019-05-10 00:38:54+00:00,['446ae499a7fd4bb1f018d2d8a90a442d283c76d0'],1,1,2,6284330,1,,,,5832
1e49b6a6b4ecb756b6d11c73cc479508c86e7028,0,Impala Public Jenkins,2019-05-10 01:50:06+00:00,['ed0a2b6010107c0719ca00991259298c59730a0b'],47,91,138,6284468,16,0.956521739,0.956521739,1,5832
9075099c27f68e4a9fd35c6db76d36dae3301643,0,Tim Armstrong,2019-05-10 06:27:41+00:00,['1e49b6a6b4ecb756b6d11c73cc479508c86e7028'],1,2,3,6284471,1,,,,5832
d423979866c737005882f54d157819e43897a5e8,1,Impala Public Jenkins,2019-05-10 11:46:38+00:00,['9075099c27f68e4a9fd35c6db76d36dae3301643'],96,3397,3493,6287964,36,0.29390681,0.579450418,0.556750299,5846
a2c5d953b0fa6d69aa34eccaa13fa9aacd31ad10,1,Impala Public Jenkins,2019-05-10 12:06:01+00:00,['d423979866c737005882f54d157819e43897a5e8'],47,222,269,6288233,20,0.336633663,0.98019802,0.663366337,5846
327b93821453f6abda2cb2d4437bba10946acc00,1,Todd Lipcon,2019-05-10 13:37:16+00:00,['a2c5d953b0fa6d69aa34eccaa13fa9aacd31ad10'],7,22,29,6288262,2,,,,5846
17daa6efb9c3c5c6fbd0908f2176b99d8498a250,1,Todd Lipcon,2019-05-10 13:42:55+00:00,['327b93821453f6abda2cb2d4437bba10946acc00'],173,389,562,6288824,13,0.625,1,0.875,5848
e57fd17cd99bd1680480dad6de769d0ef57aaacb,1,Csaba Ringhofer,2019-05-10 18:51:16+00:00,['17daa6efb9c3c5c6fbd0908f2176b99d8498a250'],5,4,9,6288833,3,0,0,0,5848
832c9de7810b47b5f782bccb761e07264e7548e5,0,Impala Public Jenkins,2019-05-10 22:07:12+00:00,['e57fd17cd99bd1680480dad6de769d0ef57aaacb'],137,235,372,6289205,36,1,1,1,5848
6140c1c5af1c6a33804c6be8683e88c955d2a47a,1,Impala Public Jenkins,2019-05-11 00:09:37+00:00,['832c9de7810b47b5f782bccb761e07264e7548e5'],104,140,244,6289449,11,1,1,0,5848
e2ead7f8572c6005f23f8654305ea8eb389c7c5a,0,Impala Public Jenkins,2019-05-11 01:28:58+00:00,['6140c1c5af1c6a33804c6be8683e88c955d2a47a'],125,135,260,6289709,1,1,0,0,5848
e4352aa63f2bdfb0f9e82f8b04567fa6b729af95,0,Impala Public Jenkins,2019-05-11 06:20:33+00:00,['e2ead7f8572c6005f23f8654305ea8eb389c7c5a'],2,91,93,6289802,4,0.058823529,0.941176471,1,5848
7188ad32e6e94e90cbee492f3ad3628855f70925,0,Impala Public Jenkins,2019-05-13 22:12:26+00:00,['e4352aa63f2bdfb0f9e82f8b04567fa6b729af95'],8,11,19,6289821,3,0,1,0,5848
4fdd9aeaacf5b9a80ed9f011eda3490fd830ac89,0,Todd Lipcon,2019-05-13 22:45:21+00:00,['7188ad32e6e94e90cbee492f3ad3628855f70925'],2,9,11,6289832,2,1,1,0,5848
eedff62f7c5d4c07354d0d7aaa4a40c7e4a8fbbd,0,Todd Lipcon,2019-05-13 22:45:21+00:00,['4fdd9aeaacf5b9a80ed9f011eda3490fd830ac89'],9,69,78,6289910,7,1,1,1,5848
cc78b764e85503e26f3eb37bdcf5df50c0cc6484,1,Impala Public Jenkins,2019-05-13 22:53:28+00:00,['eedff62f7c5d4c07354d0d7aaa4a40c7e4a8fbbd'],36,84,120,6290030,7,0.071428571,0.857142857,1,5848
b55d905322db017a11b5424da9c26c8d43aebb4c,1,Impala Public Jenkins,2019-05-14 01:32:47+00:00,['cc78b764e85503e26f3eb37bdcf5df50c0cc6484'],5,39,44,6290074,3,1,1,0,5848
a1f4a849cf1c4f51e0acc737c7da166651645870,0,Impala Public Jenkins,2019-05-14 07:25:01+00:00,['b55d905322db017a11b5424da9c26c8d43aebb4c'],0,6,6,6290080,1,,,,5848
5a23bacdba9f199948b6a971aebca30586c360a5,1,Impala Public Jenkins,2019-05-14 07:28:21+00:00,['a1f4a849cf1c4f51e0acc737c7da166651645870'],283,346,629,6290709,7,1,1,0,5849
559f19a5be95d686a71e616517ad4ae916c85824,1,Todd Lipcon,2019-05-14 18:23:27+00:00,['5a23bacdba9f199948b6a971aebca30586c360a5'],16,36,52,6290761,3,,,,5849
d12675af59f2ac74db4fae09d41b720bfd72fe4b,0,Impala Public Jenkins,2019-05-14 22:23:23+00:00,['559f19a5be95d686a71e616517ad4ae916c85824'],1,1,2,6290763,1,,,,5849
9dd8d8241a6f3b20d4625560416498dc02498945,1,Vihang Karajgaonkar,2019-05-15 00:04:38+00:00,['d12675af59f2ac74db4fae09d41b720bfd72fe4b'],15,39,54,6290817,3,0,0,1,5849
454d85be8a5b003c725586d2f75ee672925f1962,0,Impala Public Jenkins,2019-05-15 01:57:26+00:00,['9dd8d8241a6f3b20d4625560416498dc02498945'],6,86,92,6290909,3,0.122807018,0.877192982,1,5849
30ea70a7ff00bad1c104b63083fdef06e406c595,0,Impala Public Jenkins,2019-05-15 02:03:11+00:00,['454d85be8a5b003c725586d2f75ee672925f1962'],23,86,109,6291018,7,0.05,0.65,0.775,5849
bda8d95f2a9b566be9eb3d56b453ff545b7a5b6a,0,Todd Lipcon,2019-05-15 02:11:23+00:00,['30ea70a7ff00bad1c104b63083fdef06e406c595'],34,27,61,6291079,2,0.285714286,0,0,5849
efae8dcf3b70ec1e0ccb7bdd45084b03c0be4354,1,Impala Public Jenkins,2019-05-15 10:58:15+00:00,['bda8d95f2a9b566be9eb3d56b453ff545b7a5b6a'],83,54,137,6291216,9,0.25,0.25,0,5849
3567a2b5d4f797d0d48e37efc0126d022cb6a189,1,Impala Public Jenkins,2019-05-15 11:00:45+00:00,['efae8dcf3b70ec1e0ccb7bdd45084b03c0be4354'],11,60,71,6291287,6,1,1,1,5850
8c5d4e25708356ea84d504d8b0286bd5f165f2e9,0,Alex Rodoni,2019-05-15 20:45:04+00:00,['3567a2b5d4f797d0d48e37efc0126d022cb6a189'],15,11,26,6291313,3,,,,5850
d4648e87b4bc0c05203f6af0f4448dc2017bda80,1,Impala Public Jenkins,2019-05-15 22:34:28+00:00,['8c5d4e25708356ea84d504d8b0286bd5f165f2e9'],921,843,1764,6293077,66,0.395480226,0.903954802,0,5852
d873922e717d4ef5b78f13b3cf677281d1c7b502,1,Impala Public Jenkins,2019-05-16 00:23:02+00:00,['d4648e87b4bc0c05203f6af0f4448dc2017bda80'],2,2,4,6293081,2,,,,5852
f203dfa983f90624e371b229e1f4f8898b7106d4,1,Impala Public Jenkins,2019-05-16 15:34:04+00:00,['d873922e717d4ef5b78f13b3cf677281d1c7b502'],1,8,9,6293090,2,,,,5852
2e7f689e26510a66e701fb7767a6ee2e7a097963,1,Impala Public Jenkins,2019-05-16 21:12:16+00:00,['f203dfa983f90624e371b229e1f4f8898b7106d4'],3,348,351,6293441,15,0.75862069,0.373563218,0.954022989,5853
8f533e334c660dcdeaa4322b8755d7c0dce55f69,1,Impala Public Jenkins,2019-05-17 01:43:54+00:00,['2e7f689e26510a66e701fb7767a6ee2e7a097963'],0,15,15,6293456,1,,,,5853
719ac4a87a226fadb250b0add0639107b38ab661,1,Impala Public Jenkins,2019-05-17 04:54:15+00:00,['8f533e334c660dcdeaa4322b8755d7c0dce55f69'],1,2,3,6293459,1,,,,5853
a9f58146ebc1a2fef78a7ac7b057ab449f668f01,1,Tim Armstrong,2019-05-17 17:24:05+00:00,['719ac4a87a226fadb250b0add0639107b38ab661'],2,2,4,6293463,1,,,,5853
4767d9263782d132ca1eeef8fea7761dc746354f,0,Impala Public Jenkins,2019-05-17 20:13:47+00:00,['a9f58146ebc1a2fef78a7ac7b057ab449f668f01'],1,47,48,6293511,2,0,1,1,5853
092ba576186855d4838699b8e9f26e4417258f65,0,Impala Public Jenkins,2019-05-17 20:37:52+00:00,['4767d9263782d132ca1eeef8fea7761dc746354f'],2,2,4,6293515,1,,,,5853
98a79c8ce190ff86eb7e95c3ecdda059ffeeed4a,1,Impala Public Jenkins,2019-05-17 23:30:08+00:00,['092ba576186855d4838699b8e9f26e4417258f65'],1,10,11,6293526,1,,,,5853
358e92ffa25270adb0cec90710409a7a6f2151da,0,Impala Public Jenkins,2019-05-18 01:24:48+00:00,['98a79c8ce190ff86eb7e95c3ecdda059ffeeed4a'],5,5,10,6293536,3,,,,5853
d72f3330c1edc9086ba120e6d3469a75c0aea083,1,Tim Armstrong,2019-05-18 18:19:38+00:00,['358e92ffa25270adb0cec90710409a7a6f2151da'],89,333,422,6293958,9,0.709090909,1,1,5857
5f1b00c0809657bd3fa07567670ac88714f7f253,0,Tim Armstrong,2019-05-20 16:06:55+00:00,['d72f3330c1edc9086ba120e6d3469a75c0aea083'],4,3,7,6293965,1,,,,5857
aaf1cf0e9dc473b8ddc5034a96427de87e12f085,0,Alex Rodoni,2019-05-20 17:59:21+00:00,['5f1b00c0809657bd3fa07567670ac88714f7f253'],1,3,4,6293969,1,,,,5857
2d605cc107b307c0699449c777d8a0761f8c6257,0,Alex Rodoni,2019-05-20 18:05:50+00:00,['aaf1cf0e9dc473b8ddc5034a96427de87e12f085'],68,109,177,6294146,1,,,,5857
e21764b912b3118ee62defc07a568aa7e84790e5,0,Alex Rodoni,2019-05-21 00:24:13+00:00,['2d605cc107b307c0699449c777d8a0761f8c6257'],0,365,365,6294511,2,,,,5858
7af981f7afdd25c6e0ed7e86c21bbc7710098a9e,0,Todd Lipcon,2019-05-21 04:33:10+00:00,['e21764b912b3118ee62defc07a568aa7e84790e5'],57,78,135,6294646,3,0,0,1,5858
578efe61d9cf696a5a735ef80b798c571f7b1d23,0,Todd Lipcon,2019-05-21 16:44:19+00:00,['7af981f7afdd25c6e0ed7e86c21bbc7710098a9e'],22,54,76,6294722,2,1,1,1,5858
f9bf62eefab7fb807f4e5d6900064b612b455a5e,1,Impala Public Jenkins,2019-05-21 17:01:43+00:00,['578efe61d9cf696a5a735ef80b798c571f7b1d23'],77,77,154,6294876,3,,,,5858
95be560e0c43a5f8ea7b00f3ba9f83ec3f734ca2,1,Impala Public Jenkins,2019-05-21 18:25:33+00:00,['f9bf62eefab7fb807f4e5d6900064b612b455a5e'],51,150,201,6295077,8,0.716216216,0.77027027,0.121621622,5858
3e9aa862d8870a76d89cb47ab5e26cac31dbe9b0,0,Tim Armstrong,2019-05-21 22:41:40+00:00,['95be560e0c43a5f8ea7b00f3ba9f83ec3f734ca2'],1,12,13,6295090,1,,,,5858
21ecc9ced89ddcee16649264b32f8b0a5ef4e565,0,Todd Lipcon,2019-05-22 02:59:37+00:00,['3e9aa862d8870a76d89cb47ab5e26cac31dbe9b0'],1,7,8,6295098,1,,,,5858
2706a4437e9eaef2dffb2d3bb997b5ae3bfa793e,0,Alex Rodoni,2019-05-22 04:18:40+00:00,['21ecc9ced89ddcee16649264b32f8b0a5ef4e565'],10,3,13,6295111,1,,,,5858
67015004cfd16b78cf5b4019c29a6f1301b37fcc,1,Todd Lipcon,2019-05-22 18:09:42+00:00,['2706a4437e9eaef2dffb2d3bb997b5ae3bfa793e'],15,296,311,6295422,16,0.439393939,0.962121212,0.992424242,5859
cb331d0e6048ba6bf68f58f6ea1cb69017e5d12b,0,Joe McDonnell,2019-05-22 22:59:44+00:00,['67015004cfd16b78cf5b4019c29a6f1301b37fcc'],8,0,8,6295430,1,,,,5859
dfde59e587bd75d012c31ddf9c95ab315bf5460f,1,Todd Lipcon,2019-05-22 23:01:58+00:00,['cb331d0e6048ba6bf68f58f6ea1cb69017e5d12b'],14,23,37,6295467,5,0,0,0.666666667,5859
6b09612e763aace6ec3ec22031e4e960b9a41e3d,1,Joe McDonnell,2019-05-23 18:25:46+00:00,['dfde59e587bd75d012c31ddf9c95ab315bf5460f'],373,316,689,6296156,13,0.309090909,0.327272727,0.327272727,5861
c9552768772b66d040f0d731ccf79fa55d3fdc97,0,Impala Public Jenkins,2019-05-24 02:36:02+00:00,['6b09612e763aace6ec3ec22031e4e960b9a41e3d'],6,15,21,6296177,2,1,1,1,5861
a838aafbaabb3619f3f49e0346c008f7a7924299,1,Impala Public Jenkins,2019-05-24 05:38:34+00:00,['c9552768772b66d040f0d731ccf79fa55d3fdc97'],370,401,771,6296948,8,1,0,0,5865
9ee4a5e1940afa47227a92e0f6fba6d4c9909f63,1,Impala Public Jenkins,2019-05-24 07:35:29+00:00,['a838aafbaabb3619f3f49e0346c008f7a7924299'],170,810,980,6297928,22,0.533568905,0.632508834,0.763250883,5870
2750f0ab358ce754fb651a019fc06a071395395f,1,Impala Public Jenkins,2019-05-24 10:32:22+00:00,['9ee4a5e1940afa47227a92e0f6fba6d4c9909f63'],768,1299,2067,6299995,16,0.34893617,0.85106383,0,5875
6839d9738b0d5c3c176fea4345ab623783915454,0,Impala Public Jenkins,2019-05-24 15:08:19+00:00,['2750f0ab358ce754fb651a019fc06a071395395f'],31,60,91,6300086,5,1,1,0,5877
90da7fa48a3f3d7b781172d91dfa6026c5d7fab8,0,Alex Rodoni,2019-05-24 18:11:30+00:00,['6839d9738b0d5c3c176fea4345ab623783915454'],50,18,68,6300154,2,,,,5877
377471fb4b2794caae63601f937b6c4a48ef2cd3,0,Impala Public Jenkins,2019-05-24 20:37:02+00:00,['90da7fa48a3f3d7b781172d91dfa6026c5d7fab8'],0,175,175,6300329,1,0.129770992,0.916030534,0.709923664,5877
b00d031fb37b83924d4dfa020360f35540717501,0,Impala Public Jenkins,2019-05-25 02:04:52+00:00,['377471fb4b2794caae63601f937b6c4a48ef2cd3'],4,56,60,6300389,4,0.307692308,1,0.269230769,5877
31195eb8119ac6a557486a10dc24692bb0202f85,1,Impala Public Jenkins,2019-05-26 23:16:07+00:00,['b00d031fb37b83924d4dfa020360f35540717501'],26,1112,1138,6301527,20,0.66557377,0.940983607,0.960655738,5886
5faf1745b0e27ff3f95d532ad5e7dc8e34310172,1,Csaba Ringhofer,2019-05-27 13:08:45+00:00,['31195eb8119ac6a557486a10dc24692bb0202f85'],24,83,107,6301634,5,0,0.8,0.8,5886
5ce57cafb20f4627054c6c1d0d2a79e9ae97fd78,0,Csaba Ringhofer,2019-05-27 13:21:37+00:00,['5faf1745b0e27ff3f95d532ad5e7dc8e34310172'],1,154,155,6301789,3,0,0,0,5886
3bbb85598a271e18e512b066ff22c263f85ab241,1,Impala Public Jenkins,2019-05-28 14:43:07+00:00,['5ce57cafb20f4627054c6c1d0d2a79e9ae97fd78'],1,2,3,6301792,1,0,1,0,5886
625dd524cae2cadbcd8f05748e43e9eb9374c9ae,0,Impala Public Jenkins,2019-05-28 19:31:14+00:00,['3bbb85598a271e18e512b066ff22c263f85ab241'],1,5,6,6301798,2,,,,5886
7ea8c5706db5d2e7424d687465d702f01eef8824,0,Impala Public Jenkins,2019-05-28 21:36:41+00:00,['625dd524cae2cadbcd8f05748e43e9eb9374c9ae'],5,14,19,6301817,1,0,0,1,5886
c2aeb93c4f5269e2a0ad2f027ef239767abd32dd,1,Impala Public Jenkins,2019-05-29 08:40:52+00:00,['7ea8c5706db5d2e7424d687465d702f01eef8824'],0,681,681,6302498,6,0.283687943,0.746453901,0.742907801,5886
396d57709e147fd5ae9b692a225cc2174d59df6f,1,Impala Public Jenkins,2019-05-29 14:37:18+00:00,['c2aeb93c4f5269e2a0ad2f027ef239767abd32dd'],1,202,203,6302701,5,0.037735849,1,0.962264151,5887
7ea9a949259a7ab600eb9d7de888d22ef4ecd6b9,1,Tim Armstrong,2019-05-29 15:33:47+00:00,['396d57709e147fd5ae9b692a225cc2174d59df6f'],1,20,21,6302722,8,0,0,0,5887
879357c8a2924a22ca695c7ad609c11d48bc717e,0,Alex Rodoni,2019-05-29 22:25:23+00:00,['7ea9a949259a7ab600eb9d7de888d22ef4ecd6b9'],16,51,67,6302789,1,,,,5887
a7b8c1e9574afba4385d4518713e412bdeaedb8c,0,Alex Rodoni,2019-05-29 22:49:10+00:00,['879357c8a2924a22ca695c7ad609c11d48bc717e'],86,109,195,6302984,2,,,,5887
9e13fd7de53978f7ef8543a3661ce70c5ed4d60a,1,Impala Public Jenkins,2019-05-30 00:10:59+00:00,['a7b8c1e9574afba4385d4518713e412bdeaedb8c'],1,602,603,6303587,5,0.482517483,0.818181818,1,5891
b1cb879577f1e7ea8b6ea1e72c856eee0a582627,1,Impala Public Jenkins,2019-05-30 03:00:12+00:00,['9e13fd7de53978f7ef8543a3661ce70c5ed4d60a'],90,331,421,6304008,10,0.4140625,0.4375,1,5892
487547ec44ac0742c9f59c90b20b05124174e57f,1,Impala Public Jenkins,2019-05-30 03:59:54+00:00,['b1cb879577f1e7ea8b6ea1e72c856eee0a582627'],34,110,144,6304152,9,0.04,1,1,5893
cce709a6e37a9e615a093232f9b0dded8c8b5828,1,Impala Public Jenkins,2019-05-30 08:38:04+00:00,['487547ec44ac0742c9f59c90b20b05124174e57f'],147,683,830,6304982,24,0.378787879,0.52020202,0.601010101,5894
0a37377aa331d6c967be00efaf5028138de5d65d,0,Impala Public Jenkins,2019-05-30 22:34:17+00:00,['cce709a6e37a9e615a093232f9b0dded8c8b5828'],11,6,17,6304999,2,0,1,1,5894
89cf6aed65c0556d9b96b8f1d47762131e167a6a,0,Impala Public Jenkins,2019-05-31 01:46:59+00:00,['0a37377aa331d6c967be00efaf5028138de5d65d'],4,48,52,6305051,1,0,1,1,5894
dc0f8a1eee19f0bf9a0bbfdadad1d4231756a238,0,Impala Public Jenkins,2019-05-31 04:26:02+00:00,['89cf6aed65c0556d9b96b8f1d47762131e167a6a'],6,14,20,6305071,3,0,1,1,5894
8cfd18ae89683869392693541f7ba05c1013076f,0,Impala Public Jenkins,2019-05-31 12:19:38+00:00,['dc0f8a1eee19f0bf9a0bbfdadad1d4231756a238'],6,21,27,6305098,3,0,0,0,5894
3c68ddf3aa45021415919bc3250287961ebd1d32,1,Impala Public Jenkins,2019-05-31 15:28:21+00:00,['8cfd18ae89683869392693541f7ba05c1013076f'],1,1,2,6305100,1,,,,5894
d26aae5f2d171cc0ec97ffff9b3e029fe2259eaf,1,Thomas Marshall,2019-05-31 23:33:51+00:00,['3c68ddf3aa45021415919bc3250287961ebd1d32'],577,920,1497,6306597,16,0.439716312,0.631205674,0.865248227,5898
d9de31ea439847a9c011c3b3e14f38a8ee0f606b,0,Alex Rodoni,2019-06-01 01:46:53+00:00,['d26aae5f2d171cc0ec97ffff9b3e029fe2259eaf'],0,39,39,6306636,1,,,,5898
cd30949102425e28adadb51232653d910ac8422f,0,Impala Public Jenkins,2019-06-01 04:28:16+00:00,['d9de31ea439847a9c011c3b3e14f38a8ee0f606b'],3,3,6,6306642,1,,,,5898
e10d56762d26a6364e915d8693f936944f43d3ab,0,Impala Public Jenkins,2019-06-02 01:28:55+00:00,['cd30949102425e28adadb51232653d910ac8422f'],6,8,14,6306656,1,,,,5898
d8a0c60b88329bd89c9d80265d1292168bf7603e,0,Impala Public Jenkins,2019-06-02 01:40:23+00:00,['e10d56762d26a6364e915d8693f936944f43d3ab'],1,2,3,6306659,1,,,,5898
24b7a3bf56400ac4007de1bb16761bafac98b5a6,0,Impala Public Jenkins,2019-06-02 01:40:41+00:00,['d8a0c60b88329bd89c9d80265d1292168bf7603e'],5,10,15,6306674,4,1,1,1,5898
d5673bf241ed60ffe7aa0bcdf952bca1e9cc7631,1,Impala Public Jenkins,2019-06-02 02:40:10+00:00,['24b7a3bf56400ac4007de1bb16761bafac98b5a6'],4,20,24,6306698,3,,,,5898
6b3e5fe426a7cd8b13c18a54fe6c2726ab8667d8,1,Impala Public Jenkins,2019-06-02 06:38:07+00:00,['d5673bf241ed60ffe7aa0bcdf952bca1e9cc7631'],1026,1993,3019,6309717,50,0.361858191,0.633251834,1,5906
e32a4967c8094c334f4f6415019b52ef96a76e6d,1,Csaba Ringhofer,2019-06-03 09:24:38+00:00,['6b3e5fe426a7cd8b13c18a54fe6c2726ab8667d8'],1,29,30,6309747,4,0.142857143,0.142857143,0,5906
ab3bc22534ba4dabbf8d4ef71b7faeef50dfed99,1,Thomas Marshall,2019-06-03 17:17:37+00:00,['e32a4967c8094c334f4f6415019b52ef96a76e6d'],5,22,27,6309774,5,0,0,1,5906
0b564ec374c6e7e50f70fc7607fa4205fecf1916,0,Tim Armstrong,2019-06-04 00:13:23+00:00,['ab3bc22534ba4dabbf8d4ef71b7faeef50dfed99'],6,8,14,6309788,1,,,,5906
6bb404dc35999c250cc9112c19b74ffcf17fe14b,1,Thomas Marshall,2019-06-04 17:36:59+00:00,['0b564ec374c6e7e50f70fc7607fa4205fecf1916'],20,306,326,6310114,10,0.337662338,0.214285714,0.597402597,5906
e78e6f0c260b342c67e055656d239438bca13288,0,Tim Armstrong,2019-06-04 21:56:11+00:00,['6bb404dc35999c250cc9112c19b74ffcf17fe14b'],61,160,221,6310335,60,1,1,1,5907
2c5eb89550cb25696c4457e23ce746980eb3c3e4,0,Impala Public Jenkins,2019-06-04 22:10:06+00:00,['e78e6f0c260b342c67e055656d239438bca13288'],3,3,6,6310341,3,,,,5907
9891597e5a0f9a8a290da5295a1343228b7dafef,0,Impala Public Jenkins,2019-06-05 01:27:39+00:00,['2c5eb89550cb25696c4457e23ce746980eb3c3e4'],126,135,261,6310602,3,0,1,1,5907
95a1da2d32ea7b28585ad574b22c2bb9dd921029,1,Impala Public Jenkins,2019-06-05 03:29:47+00:00,['9891597e5a0f9a8a290da5295a1343228b7dafef'],458,620,1078,6311680,33,1,0.833333333,1,5909
d9af99589fb9d8afd0844ee835b0fe945590e0bb,1,Impala Public Jenkins,2019-06-05 06:39:04+00:00,['95a1da2d32ea7b28585ad574b22c2bb9dd921029'],617,2181,2798,6314478,15,0.32195122,0.419512195,0.770731707,5909
e573b5502d4a93623dd1375e8e8febf9647c98db,1,Impala Public Jenkins,2019-06-05 07:31:35+00:00,['d9af99589fb9d8afd0844ee835b0fe945590e0bb'],11,47,58,6314536,4,0,0,1,5909
51e8175c622014064e5a6853317de13b6987c629,0,Impala Public Jenkins,2019-06-05 11:15:04+00:00,['e573b5502d4a93623dd1375e8e8febf9647c98db'],98,497,595,6315131,30,0.538922156,0.748502994,0.562874251,5911
f0678b06e64b57e0b26ca73577444e1941925dbc,0,Impala Public Jenkins,2019-06-05 14:23:23+00:00,['51e8175c622014064e5a6853317de13b6987c629'],302,1373,1675,6316806,13,0.5625,0.62804878,0.705792683,5912
74a763c20d7e5b706350924ce8d71b517c7f5ca5,1,Impala Public Jenkins,2019-06-05 15:18:11+00:00,['f0678b06e64b57e0b26ca73577444e1941925dbc'],15,52,67,6316873,1,0.476190476,1,1,5912
ae8295118191486f31da4d8d3c9d0f7e7e5d4b3a,0,Tim Armstrong,2019-06-05 16:06:30+00:00,['74a763c20d7e5b706350924ce8d71b517c7f5ca5'],13,482,495,6317368,6,0,0,0.597402597,5912
0e1d2e148416458b50fba2f790833122beb88aca,1,Thomas Marshall,2019-06-05 17:17:52+00:00,['ae8295118191486f31da4d8d3c9d0f7e7e5d4b3a'],41,149,190,6317558,2,0.823529412,1,0.264705882,5912
45c5652b6694864afef2af3fdf93d3bd8dfa7190,1,Impala Public Jenkins,2019-06-05 23:40:30+00:00,['0e1d2e148416458b50fba2f790833122beb88aca'],22,33,55,6317613,3,,,,5912
b7077ffd524e31b768e1e8a28a907f995cdeb058,1,Thomas Marshall,2019-06-06 22:16:27+00:00,['45c5652b6694864afef2af3fdf93d3bd8dfa7190'],16,679,695,6318308,5,0.307692308,0.307692308,0.076923077,5913
90d84425292532bd0e18aaa9851cc4ca01fd4bce,1,Impala Public Jenkins,2019-06-07 02:18:38+00:00,['b7077ffd524e31b768e1e8a28a907f995cdeb058'],5,21,26,6318334,3,0,0,1,5913
970a07503b7d5f547461c5ec2381a00a60b1d67a,0,Todd Lipcon,2019-06-07 05:11:44+00:00,['90d84425292532bd0e18aaa9851cc4ca01fd4bce'],3,4,7,6318341,1,,,,5913
d4c05b96e2f1166572b01cae31b20ecd22fa4094,0,Impala Public Jenkins,2019-06-07 23:23:06+00:00,['970a07503b7d5f547461c5ec2381a00a60b1d67a'],15,11,26,6318367,1,0,0,0,5913
1f407fd8d347618fdc18a85b5350556681998ce3,1,Thomas Marshall,2019-06-07 23:50:09+00:00,['d4c05b96e2f1166572b01cae31b20ecd22fa4094'],17,9,26,6318393,3,0.181818182,0.181818182,0,5913
f6d40b37c8b13131cbc75db6a7327c34bf0c5a34,0,Impala Public Jenkins,2019-06-08 03:56:14+00:00,['1f407fd8d347618fdc18a85b5350556681998ce3'],1,1,2,6318395,1,,,,5913
45c6c46bf6d051c715fe75a68c7970b208a7d376,0,Impala Public Jenkins,2019-06-10 08:34:27+00:00,['f6d40b37c8b13131cbc75db6a7327c34bf0c5a34'],6,19,25,6318420,5,0,1,0.8,5913
d753600f9cf4bda0c955f0f5eecc6fb41b0c365e,0,Thomas Marshall,2019-06-10 16:12:41+00:00,['45c6c46bf6d051c715fe75a68c7970b208a7d376'],13,24,37,6318457,4,1,0.909090909,0.545454545,5913
2f3780e846d8c0870e73788837af67019481ae23,0,Impala Public Jenkins,2019-06-10 21:56:53+00:00,['d753600f9cf4bda0c955f0f5eecc6fb41b0c365e'],14,26,40,6318497,1,0.75,0.75,0.375,5913
564def2dabec5209525514f4c2ef77992550e42f,0,Impala Public Jenkins,2019-06-10 23:10:22+00:00,['2f3780e846d8c0870e73788837af67019481ae23'],0,4,4,6318501,2,,,,5913
f1967a0d597f034e1300d351a339a06a3d5700ec,0,Impala Public Jenkins,2019-06-11 00:49:34+00:00,['564def2dabec5209525514f4c2ef77992550e42f'],5,5,10,6318511,1,,,,5913
270deda049f4f8551742475017e860f1dab3754b,1,Impala Public Jenkins,2019-06-11 05:01:19+00:00,['f1967a0d597f034e1300d351a339a06a3d5700ec'],0,2,2,6318513,1,,,,5913
666c1be66420468936b6b34f6d1fb8f695a72d7d,0,Impala Public Jenkins,2019-06-11 06:20:08+00:00,['270deda049f4f8551742475017e860f1dab3754b'],2,64,66,6318579,2,0.081632653,0.081632653,1,5913
11a2e86c28c7c7dcf9f394a82fc4045760fff97b,0,Joe McDonnell,2019-06-11 22:22:22+00:00,['666c1be66420468936b6b34f6d1fb8f695a72d7d'],65,71,136,6318715,17,0,0,0,5913
ab908d54c22861967f693428ec7d9f6d7008607f,0,Impala Public Jenkins,2019-06-11 22:38:24+00:00,['11a2e86c28c7c7dcf9f394a82fc4045760fff97b'],134,689,823,6319538,13,0.262068966,0.610344828,0.593103448,5914
25c8b6226ba90e0fee7bdd61ae5313570ce28754,0,Impala Public Jenkins,2019-06-11 23:25:00+00:00,['ab908d54c22861967f693428ec7d9f6d7008607f'],103,185,288,6319826,4,0.140350877,0.035087719,0.175438596,5914
fcaec278ccf4638692701fd03309a4f40e8fd611,1,Zoltan Borok-Nagy,2019-06-12 13:21:58+00:00,['25c8b6226ba90e0fee7bdd61ae5313570ce28754'],1,56,57,6319883,4,0.4,0.4,1,5914
d9f17c963407bfcb19c89dcaad6e9be17522cd1e,0,Impala Public Jenkins,2019-06-12 21:11:22+00:00,['fcaec278ccf4638692701fd03309a4f40e8fd611'],18,33,51,6319934,2,0,1,1,5914
5b0c098b080515cc928984a46ddc973021964f90,1,Impala Public Jenkins,2019-06-12 21:36:50+00:00,['d9f17c963407bfcb19c89dcaad6e9be17522cd1e'],26,47,73,6320007,3,0,0,0.8,5914
e3117aa6645fec89ef587d6e57b38b981080cb03,0,Impala Public Jenkins,2019-06-13 00:07:53+00:00,['5b0c098b080515cc928984a46ddc973021964f90'],2,9,11,6320018,1,,,,5914
ff4e0a3a459b233495e71f9bcb584ac200caf23a,1,Impala Public Jenkins,2019-06-13 01:53:37+00:00,['e3117aa6645fec89ef587d6e57b38b981080cb03'],50,45,95,6320113,9,0,0.2,0.6,5914
94652d74521e95e8606ea2d22aabcaddde6fc471,1,Impala Public Jenkins,2019-06-13 02:15:29+00:00,['ff4e0a3a459b233495e71f9bcb584ac200caf23a'],44,189,233,6320346,10,0,0.604651163,0.790697674,5914
8ee18c3b7736e02ef76507162ed2592ba11d16e3,1,Impala Public Jenkins,2019-06-13 11:56:04+00:00,['94652d74521e95e8606ea2d22aabcaddde6fc471'],7,80,87,6320433,8,0,1,0.791666667,5915
3b15a5c55ab14a256f82c3d734444bc23ff1f267,0,Tim Armstrong,2019-06-13 15:19:29+00:00,['8ee18c3b7736e02ef76507162ed2592ba11d16e3'],23,0,23,6320456,3,,,,5915
11b18d7228a18e8609aa9ed8ff04f6784b30cb74,1,Impala Public Jenkins,2019-06-13 21:34:57+00:00,['3b15a5c55ab14a256f82c3d734444bc23ff1f267'],12,71,83,6320539,10,0.365384615,0.980769231,0.942307692,5915
dec14abbd46467a73d1159508971e04da68fa508,1,Impala Public Jenkins,2019-06-14 01:44:15+00:00,['11b18d7228a18e8609aa9ed8ff04f6784b30cb74'],154,187,341,6320880,5,0.933333333,1,1,5915
3a4dce24a9b0113b049b2f22e4b34d5ac8153416,0,Impala Public Jenkins,2019-06-14 15:17:29+00:00,['dec14abbd46467a73d1159508971e04da68fa508'],0,6,6,6320886,1,,,,5915
02a79822eb1714293ba72c18b52181f33663843a,0,Impala Public Jenkins,2019-06-14 21:50:18+00:00,['3a4dce24a9b0113b049b2f22e4b34d5ac8153416'],2,1,3,6320889,1,,,,5915
3bd53972cec3b8a863075cb2344115a950be848a,1,Impala Public Jenkins,2019-06-14 23:06:08+00:00,['02a79822eb1714293ba72c18b52181f33663843a'],22,111,133,6321022,8,0.638888889,0.944444444,0.5,5915
7af2eae6b82dcc1ce5a592901a8bd706a7dff685,1,Impala Public Jenkins,2019-06-15 03:46:49+00:00,['3bd53972cec3b8a863075cb2344115a950be848a'],36,133,169,6321191,12,0.095238095,1,0.761904762,5917
50e0fbf889465eb288a5ef69477ccbc627681105,1,Todd Lipcon,2019-06-18 02:43:29+00:00,['7af2eae6b82dcc1ce5a592901a8bd706a7dff685'],144,207,351,6321542,18,0,0.388888889,0,5917
0415130a8e764575adc7d0a38e0ed5597d249307,0,Impala Public Jenkins,2019-06-18 03:05:59+00:00,['50e0fbf889465eb288a5ef69477ccbc627681105'],1,8,9,6321551,1,1,1,1,5917
f4ef9ca87352406cc7a484e90ed1d1d702745810,1,Todd Lipcon,2019-06-18 06:27:42+00:00,['0415130a8e764575adc7d0a38e0ed5597d249307'],4,297,301,6321852,3,0.286624204,0.585987261,1,5917
ab5ee0b7857c6ad19f244dc308210f2809436684,0,Impala Public Jenkins,2019-06-18 06:47:56+00:00,['f4ef9ca87352406cc7a484e90ed1d1d702745810'],1,92,93,6321945,8,,,,5919
800f6358552bfab0bb4cfc0cf518854305379d61,0,Impala Public Jenkins,2019-06-19 01:07:00+00:00,['ab5ee0b7857c6ad19f244dc308210f2809436684'],185,41,226,6322171,15,0.947368421,1,1,5919
2b76da027dfd4bda9992122ef92ed12108dfc9df,1,Impala Public Jenkins,2019-06-19 02:30:57+00:00,['800f6358552bfab0bb4cfc0cf518854305379d61'],134,213,347,6322518,22,0.5,0.675,0,5919
97a6a3c8077affd5a181054d706cc7f30aecca91,1,Impala Public Jenkins,2019-06-19 04:43:43+00:00,['2b76da027dfd4bda9992122ef92ed12108dfc9df'],59,440,499,6323017,18,0.220264317,0.621145374,0.488986784,5920
acea70227601b8033f08a700bdcb9f8487719151,1,Impala Public Jenkins,2019-06-19 05:58:10+00:00,['97a6a3c8077affd5a181054d706cc7f30aecca91'],303,1396,1699,6324716,20,0.302828619,0.881863561,0.738768719,5920
30c3cd95a42cacbfa2dbb0b29a4757745af942c3,1,Impala Public Jenkins,2019-06-19 07:21:01+00:00,['acea70227601b8033f08a700bdcb9f8487719151'],188,245,433,6325149,15,0.108108108,0,0,5920
f1f3ae9ec2b1f3e23ecfad7592e977647d692f7e,1,Impala Public Jenkins,2019-06-20 10:23:28+00:00,['30c3cd95a42cacbfa2dbb0b29a4757745af942c3'],530,7372,7902,6333051,35,0.437131631,0.696709234,0.825638507,5925
9ecbe7d3dc22d7233e4bf2f91aaab43d0ad4e373,1,Impala Public Jenkins,2019-06-20 20:27:31+00:00,['f1f3ae9ec2b1f3e23ecfad7592e977647d692f7e'],106,144,250,6333301,17,0.826086957,0.956521739,0,5925
09182c8ba4284c758201bfdb41c70cee0cab9e75,0,Joe McDonnell,2019-06-20 21:13:49+00:00,['9ecbe7d3dc22d7233e4bf2f91aaab43d0ad4e373'],1,10,11,6333312,2,0,0,1,5925
65175a23b2ed73d91734607d474ba80e15323c9b,1,Impala Public Jenkins,2019-06-20 22:42:17+00:00,['09182c8ba4284c758201bfdb41c70cee0cab9e75'],27,84,111,6333423,13,0.379310345,1,0.896551724,5925
8431a95698b6f687ac8862cc6549e1949af0b034,0,Impala Public Jenkins,2019-06-20 23:06:52+00:00,['65175a23b2ed73d91734607d474ba80e15323c9b'],22,260,282,6333705,4,0.240740741,0.175925926,0.824074074,5925
67cd55e0445d037d834ecd120d08b0948b064491,1,Impala Public Jenkins,2019-06-21 02:34:09+00:00,['8431a95698b6f687ac8862cc6549e1949af0b034'],94,329,423,6334128,11,0.2,0.681818182,0.681818182,5925
b3b00da1a1c7b98e84debe11c10258c4a0dff944,1,Impala Public Jenkins,2019-06-21 03:28:43+00:00,['67cd55e0445d037d834ecd120d08b0948b064491'],24,2144,2168,6336296,23,0.820197044,0.86453202,0.896551724,5931
3a4f8b3ae1a293fb350778a44ac9db6a6036d33b,1,Impala Public Jenkins,2019-06-21 06:01:57+00:00,['b3b00da1a1c7b98e84debe11c10258c4a0dff944'],4,9,13,6336309,2,0,0,1,5931
cad97be479bc2c7256ad927beb7f24859dafac0e,1,Impala Public Jenkins,2019-06-21 23:14:23+00:00,['3a4f8b3ae1a293fb350778a44ac9db6a6036d33b'],145,275,420,6336729,2,0.979166667,1,0.270833333,5932
7e897893b9ad6d8e5d4950a3d37b6217f2319131,0,Impala Public Jenkins,2019-06-21 23:31:23+00:00,['cad97be479bc2c7256ad927beb7f24859dafac0e'],0,80,80,6336809,1,,,,5933
3453f76c67b74865f63201762ae549bece50ba5f,0,Joe McDonnell,2019-06-24 23:28:14+00:00,['7e897893b9ad6d8e5d4950a3d37b6217f2319131'],2,2,4,6336813,2,,,,5933
84dfbb488089db8c5cb1b169c0c0aa6758b9656a,1,Impala Public Jenkins,2019-06-25 11:03:11+00:00,['3453f76c67b74865f63201762ae549bece50ba5f'],41,3,44,6336857,1,,,,5933
1e1b8e9bc6418fecfe4e57cb4fe25d1f64129657,0,Tim Armstrong,2019-06-25 18:30:18+00:00,['84dfbb488089db8c5cb1b169c0c0aa6758b9656a'],3,5,8,6336865,3,,,,5933
cbbc1123e377d4ccae6a7341025aade511fb7364,0,Alex Rodoni,2019-06-25 19:44:43+00:00,['1e1b8e9bc6418fecfe4e57cb4fe25d1f64129657'],2,2,4,6336869,1,,,,5933
9e117be4a63ae90e80b6d99a004750e5d3d9744a,0,Tim Armstrong,2019-06-25 21:46:41+00:00,['cbbc1123e377d4ccae6a7341025aade511fb7364'],1,3,4,6336873,1,,,,5933
2fd795cf56e65a43087375867dcc9890e3a27330,0,Impala Public Jenkins,2019-06-25 22:02:08+00:00,['9e117be4a63ae90e80b6d99a004750e5d3d9744a'],29,131,160,6337033,7,0.316666667,0.5,0.633333333,5933
e03de0d76f02932b1fe752d76adb7c04cb9efbe0,0,Impala Public Jenkins,2019-06-25 22:49:53+00:00,['2fd795cf56e65a43087375867dcc9890e3a27330'],1,1,2,6337035,1,,,,5933
f40935a30e04576dafef03701e75cdffd4837a41,1,Impala Public Jenkins,2019-06-25 23:06:25+00:00,['e03de0d76f02932b1fe752d76adb7c04cb9efbe0'],178,1705,1883,6338918,17,0.193154034,0.86797066,0.85207824,5935
1b531be9be839740d5a021047331ba85b6670360,1,Impala Public Jenkins,2019-06-26 00:13:44+00:00,['f40935a30e04576dafef03701e75cdffd4837a41'],196,126,322,6339240,6,0,0,0.111111111,5935
572c1278566ca329f3e47e5c2d7e13dd0c7967f7,0,Impala Public Jenkins,2019-06-26 01:58:10+00:00,['1b531be9be839740d5a021047331ba85b6670360'],0,1,1,6339241,1,,,,5935
d750d884e5fc28117c051ba29b73cdc51e698cea,0,Tim Armstrong,2019-06-26 17:12:56+00:00,['572c1278566ca329f3e47e5c2d7e13dd0c7967f7'],131,29,160,6339401,7,0.683333333,0.5,0.366666667,5935
e158352fe2f0c911c7bd60caae90673f8fc6fde0,0,Tim Armstrong,2019-06-26 17:13:25+00:00,['d750d884e5fc28117c051ba29b73cdc51e698cea'],5,3,8,6339409,3,,,,5935
e29b387ea10739e78075bac8170e45722d4b9940,0,Alex Rodoni,2019-06-26 18:54:25+00:00,['e158352fe2f0c911c7bd60caae90673f8fc6fde0'],2,87,89,6339498,2,,,,5936
c9937fd99a3a0f52124797374da76a9d2d25f650,0,Impala Public Jenkins,2019-06-26 22:59:59+00:00,['e29b387ea10739e78075bac8170e45722d4b9940'],4,4,8,6339506,1,0,0,0,5936
5d42fa3ad6aa5778a2fbab3caa8091985718d910,0,Impala Public Jenkins,2019-06-26 23:02:59+00:00,['c9937fd99a3a0f52124797374da76a9d2d25f650'],1,1,2,6339508,1,,,,5936
ee2b3b9bfaf7950a8fb3f87ea44c29d0f6a13be4,1,Impala Public Jenkins,2019-06-27 00:22:44+00:00,['5d42fa3ad6aa5778a2fbab3caa8091985718d910'],23,54,77,6339585,5,0.428571429,1,0.428571429,5936
524f97136a17bb87cc3605371b1e600739f1e489,0,Impala Public Jenkins,2019-06-27 05:02:39+00:00,['ee2b3b9bfaf7950a8fb3f87ea44c29d0f6a13be4'],4,0,4,6339589,1,1,0,0,5936
4d0578dc812ad51edc589a9d7dd1fd23a041370b,0,Impala Public Jenkins,2019-06-27 05:03:55+00:00,['524f97136a17bb87cc3605371b1e600739f1e489'],10,6,16,6339605,3,,,,5936
03bf2d25663dfa09133c466709a485e03c544236,0,Impala Public Jenkins,2019-06-27 06:56:01+00:00,['4d0578dc812ad51edc589a9d7dd1fd23a041370b'],0,13,13,6339618,2,,,,5936
dbba52c77c4bd83479fc44c323d76ec728b17aeb,0,Impala Public Jenkins,2019-06-27 14:39:46+00:00,['03bf2d25663dfa09133c466709a485e03c544236'],8,12,20,6339638,3,1,1,1,5936
a20977a5c0b37d20aab13bb441756f887a2d1c59,0,Joe McDonnell,2019-06-27 17:21:53+00:00,['dbba52c77c4bd83479fc44c323d76ec728b17aeb'],54,331,385,6340023,7,0.211678832,0.97810219,0.686131387,5936
63b2df763223ba2bd8651e4db679579f3ab132e7,0,Impala Public Jenkins,2019-06-27 20:51:15+00:00,['a20977a5c0b37d20aab13bb441756f887a2d1c59'],0,2,2,6340025,1,,,,5936
e59e9261339a7a353c05548df84ff0d8793b768d,1,Impala Public Jenkins,2019-06-27 22:24:15+00:00,['63b2df763223ba2bd8651e4db679579f3ab132e7'],4,9,13,6340038,1,0,0,1,5936
c353cf7a648651244ac39677d0cb028e704281d0,0,Impala Public Jenkins,2019-06-28 03:02:01+00:00,['e59e9261339a7a353c05548df84ff0d8793b768d'],3,6,9,6340047,2,0,1,1,5936
5d8c99ce74c45a7d04f11e1f252b346d654f02bf,1,Impala Public Jenkins,2019-06-28 11:27:18+00:00,['c353cf7a648651244ac39677d0cb028e704281d0'],2,4,6,6340053,1,0,1,0,5936
b8e20905a80f6541efdb2161333fb1552a976135,1,Impala Public Jenkins,2019-06-29 05:08:13+00:00,['5d8c99ce74c45a7d04f11e1f252b346d654f02bf'],171,847,1018,6341071,16,0.174342105,0.953947368,0.625,5938
7206b52e5b6ab1df045e4249d859129d32aacf6b,0,Impala Public Jenkins,2019-07-01 23:28:09+00:00,['b8e20905a80f6541efdb2161333fb1552a976135'],2,112,114,6341185,7,0.407407407,0.981481481,0.388888889,5938
e8c60a30839463f162e31fc76a87de9753531b72,0,Impala Public Jenkins,2019-07-02 02:58:23+00:00,['7206b52e5b6ab1df045e4249d859129d32aacf6b'],31,77,108,6341293,4,0,0,0.384615385,5938
aee0abd76b762e57ce9f0a2e40a9a8b4f97dc986,1,Impala Public Jenkins,2019-07-02 03:26:09+00:00,['e8c60a30839463f162e31fc76a87de9753531b72'],24,101,125,6341418,3,0,1,0.37254902,5938
10d1be051bd56c4f74a2193c6962aa7fcaf92290,0,Impala Public Jenkins,2019-07-02 19:14:12+00:00,['aee0abd76b762e57ce9f0a2e40a9a8b4f97dc986'],90,193,283,6341701,9,1,1,0.55,5940
2164244a75189622085fe0319be4acd7185795f6,0,Alex Rodoni,2019-07-02 23:56:26+00:00,['10d1be051bd56c4f74a2193c6962aa7fcaf92290'],23,28,51,6341752,1,,,,5940
875961da6fc60901685b2cc2de50644464ae102e,0,Alex Rodoni,2019-07-03 01:31:25+00:00,['2164244a75189622085fe0319be4acd7185795f6'],0,4,4,6341756,1,,,,5940
252b117954065db68eba746ca5afb0476c94313b,0,Impala Public Jenkins,2019-07-03 01:57:04+00:00,['875961da6fc60901685b2cc2de50644464ae102e'],0,20,20,6341776,2,0,0.944444444,0.055555556,5940
111035ef77f0f3331fff6abe3e60185c3d4e9a10,0,Impala Public Jenkins,2019-07-03 02:54:50+00:00,['252b117954065db68eba746ca5afb0476c94313b'],4,1359,1363,6343139,17,0.443708609,0.894039735,0.973509934,5948
78c55230288f8874bcd16454eb3c55277211719a,0,Impala Public Jenkins,2019-07-03 03:08:17+00:00,['111035ef77f0f3331fff6abe3e60185c3d4e9a10'],0,9,9,6343148,1,,,,5948
98459244954e5b5e34427efea10c5770c2bf70e7,0,Alex Rodoni,2019-07-03 17:20:38+00:00,['78c55230288f8874bcd16454eb3c55277211719a'],3,2,5,6343153,1,,,,5948
5fdef39fcf7e1b59bcf8d670d217ca7a88fc2738,0,Alex Rodoni,2019-07-03 17:39:30+00:00,['98459244954e5b5e34427efea10c5770c2bf70e7'],2,3,5,6343158,1,,,,5948
e7dde1510df6e0022935376e145acbfda7311cfc,0,Joe McDonnell,2019-07-03 18:32:35+00:00,['5fdef39fcf7e1b59bcf8d670d217ca7a88fc2738'],9,0,9,6343167,1,,,,5948
7bbf8344e174ef0ff948c6aa9e55e1bd91348f79,0,Alex Rodoni,2019-07-03 18:50:38+00:00,['e7dde1510df6e0022935376e145acbfda7311cfc'],34,68,102,6343269,1,,,,5948
19430082f34ae69c86dd3cd6078f8855e9e8646d,0,Alex Rodoni,2019-07-03 19:20:52+00:00,['7bbf8344e174ef0ff948c6aa9e55e1bd91348f79'],55,153,208,6343477,3,,,,5949
3f74171a271b9e5614ce1752221517a12dae0c2f,0,Impala Public Jenkins,2019-07-03 20:46:45+00:00,['19430082f34ae69c86dd3cd6078f8855e9e8646d'],10,46,56,6343533,5,1,0.5,0.9,5950
d5ea0d60678655a633ee99eab35970a88ceee697,0,Alex Rodoni,2019-07-03 21:03:17+00:00,['3f74171a271b9e5614ce1752221517a12dae0c2f'],2,2,4,6343537,1,,,,5950
99cfa92d3c085aaea838b329097c65221c0cbd38,0,Impala Public Jenkins,2019-07-04 00:50:30+00:00,['d5ea0d60678655a633ee99eab35970a88ceee697'],0,2,2,6343539,1,,,,5950
b1cbf9e6b786132e86699cbb1e472ec98499bb11,0,Impala Public Jenkins,2019-07-05 01:26:09+00:00,['99cfa92d3c085aaea838b329097c65221c0cbd38'],205,415,620,6344159,10,0.824,0.992,0.728,5950
1776c7a54adb929bbd41eea50aed7665282f46f0,0,Impala Public Jenkins,2019-07-05 20:58:55+00:00,['b1cbf9e6b786132e86699cbb1e472ec98499bb11'],415,205,620,6344779,10,0.176,0.008,0.272,5950
433640ccdc5231a3be2ebe2029c2ee51c193bea7,0,Alex Rodoni,2019-07-08 21:30:31+00:00,['1776c7a54adb929bbd41eea50aed7665282f46f0'],2,10,12,6344791,1,,,,5950
b9302d50def117021d74a48bde0862cfbfcb0292,0,Alex Rodoni,2019-07-08 23:44:16+00:00,['433640ccdc5231a3be2ebe2029c2ee51c193bea7'],2,5,7,6344798,1,,,,5950
fce190a5d96f722f549983e2deb1fd5c20a27af7,0,Impala Public Jenkins,2019-07-09 10:50:43+00:00,['b9302d50def117021d74a48bde0862cfbfcb0292'],13,13,26,6344824,3,1,1,1,5950
fc974f944a9266e68e6f1694eecdc2160fd52582,1,Vihang Karajgaonkar,2019-07-09 15:31:28+00:00,['fce190a5d96f722f549983e2deb1fd5c20a27af7'],9,236,245,6345069,6,0.495726496,1,0.914529915,5951
414b0122674c1b7cd7022df9d0d39d9b7401e48a,0,Impala Public Jenkins,2019-07-09 23:36:44+00:00,['fc974f944a9266e68e6f1694eecdc2160fd52582'],1,1,2,6345071,1,,,,5951
bc761753125485e20f896eead73defc071ebc19a,1,Vihang Karajgaonkar,2019-07-10 04:47:04+00:00,['414b0122674c1b7cd7022df9d0d39d9b7401e48a'],19,37,56,6345127,6,0,1,1,5951
0fedc1f97f9571e59b8b1dc3ed963d44d9ac3f03,0,Impala Public Jenkins,2019-07-10 23:35:57+00:00,['bc761753125485e20f896eead73defc071ebc19a'],1,1,2,6345129,1,,,,5951
b068c2c4e21ab302ca372f870eccfb2111752e34,0,Joe McDonnell,2019-07-11 00:20:51+00:00,['0fedc1f97f9571e59b8b1dc3ed963d44d9ac3f03'],27,113,140,6345269,11,0,0.342857143,0.514285714,5951
e83f67e4e3ad24711703224c8efc42e291a0d89c,0,Impala Public Jenkins,2019-07-11 06:55:53+00:00,['b068c2c4e21ab302ca372f870eccfb2111752e34'],28,189,217,6345486,3,0,0.214285714,1,5951
8081045bebb253698bcd748a64ccff843e3e85ff,0,Alex Rodoni,2019-07-11 20:37:48+00:00,['e83f67e4e3ad24711703224c8efc42e291a0d89c'],0,98,98,6345584,1,,,,5951
a0cc0b73865dfd30fec7088f327db8c972af863d,0,Impala Public Jenkins,2019-07-12 01:12:57+00:00,['8081045bebb253698bcd748a64ccff843e3e85ff'],17,20,37,6345621,1,0,0,1,5951
9f0cd9743a9c364d1eb42f29f67494298ed574ae,1,Impala Public Jenkins,2019-07-15 23:05:16+00:00,['a0cc0b73865dfd30fec7088f327db8c972af863d'],41,266,307,6345928,7,0.5,0.5,0.724489796,5952
1cd85d1f8a0d772a4cab263cce4f41728f6ebac7,0,Impala Public Jenkins,2019-07-16 00:25:13+00:00,['9f0cd9743a9c364d1eb42f29f67494298ed574ae'],13,13,26,6345954,4,0,0,1,5952
b6b6b22c86702fd457fcfbb6401a9b27207c5f58,0,Impala Public Jenkins,2019-07-16 06:04:18+00:00,['1cd85d1f8a0d772a4cab263cce4f41728f6ebac7'],7,1,8,6345962,1,,,,5952
21586fbfbc885b1a330154a1199189d9f9a38609,0,Impala Public Jenkins,2019-07-16 06:07:00+00:00,['b6b6b22c86702fd457fcfbb6401a9b27207c5f58'],10,10,20,6345982,1,,,,5952
a852b9fb749860221d8919ac94efc39115d8a65b,0,Impala Public Jenkins,2019-07-16 09:38:30+00:00,['21586fbfbc885b1a330154a1199189d9f9a38609'],6,21,27,6346009,4,0,0,0,5952
2dbd7eec81485293f79bcddd5b40546c7a0471c2,1,Impala Public Jenkins,2019-07-16 11:11:43+00:00,['a852b9fb749860221d8919ac94efc39115d8a65b'],5,15,20,6346029,4,0.6,1,1,5952
23855c8e623e192ead788e1602559af9b81582f0,1,Impala Public Jenkins,2019-07-16 15:32:02+00:00,['2dbd7eec81485293f79bcddd5b40546c7a0471c2'],11,418,429,6346458,21,0.467005076,0.974619289,0.934010152,5952
4dfe19cb13e65eeeafbcccbe3f74a0897205796f,0,Impala Public Jenkins,2019-07-16 17:05:25+00:00,['23855c8e623e192ead788e1602559af9b81582f0'],5,5,10,6346468,1,,,,5952
7364912088f66d2fb329d40b884763d1d1d63619,0,Impala Public Jenkins,2019-07-18 11:57:20+00:00,['4dfe19cb13e65eeeafbcccbe3f74a0897205796f'],6,57,63,6346531,2,0.6,1,1,5952
6907528089abab78e7f07b3327eb7a9c5268db50,0,Alex Rodoni,2019-07-18 17:10:40+00:00,['7364912088f66d2fb329d40b884763d1d1d63619'],11,53,64,6346595,2,,,,5952
245f2375e28ff7f5b0e89341d974341fa20444d1,1,Impala Public Jenkins,2019-07-18 21:20:03+00:00,['6907528089abab78e7f07b3327eb7a9c5268db50'],1,8,9,6346604,2,,,,5952
4ff2cd86e26876607ece8ac705e6dabc1f338c07,1,Impala Public Jenkins,2019-07-19 01:34:01+00:00,['245f2375e28ff7f5b0e89341d974341fa20444d1'],156,410,566,6347170,13,0.763157895,0.763157895,0.5,5957
4cc3ff9c6763de10236df351a47324d662766de3,0,Joe McDonnell,2019-07-19 22:01:00+00:00,['4ff2cd86e26876607ece8ac705e6dabc1f338c07'],188,190,378,6347548,61,0,0,0,5957
10e72915de591cbd6354da9ac769550d2bc55df5,0,Alex Rodoni,2019-07-19 22:10:58+00:00,['4cc3ff9c6763de10236df351a47324d662766de3'],0,19,19,6347567,1,,,,5957
0604ff51e00a1dcfef5823a02bb7bf612c917efc,0,Impala Public Jenkins,2019-07-20 07:30:45+00:00,['10e72915de591cbd6354da9ac769550d2bc55df5'],1,5,6,6347573,2,1,1,0,5957
a7a80d1241a09cfa1f73a80900b74a012de52641,0,Impala Public Jenkins,2019-07-21 01:04:30+00:00,['0604ff51e00a1dcfef5823a02bb7bf612c917efc'],12,24,36,6347609,3,0.4,0.4,0.1,5957
2397ae5590d487025fb446efecd34f5395b8997f,1,Impala Public Jenkins,2019-07-21 04:54:03+00:00,['a7a80d1241a09cfa1f73a80900b74a012de52641'],662,2579,3241,6350850,41,0.428715875,0.664307381,0.552072801,5961
adaf344d48920c8a66a317c3720ca090f470fe5a,0,Impala Public Jenkins,2019-07-21 06:38:46+00:00,['2397ae5590d487025fb446efecd34f5395b8997f'],1,4,5,6350855,1,0,0,1,5961
51092260b69b9082f0ecb2a9212e680f5dbc6f43,1,Impala Public Jenkins,2019-07-21 23:27:02+00:00,['adaf344d48920c8a66a317c3720ca090f470fe5a'],40,49,89,6350944,1,1,1,1,5961
5466cf6344af893521b093915aba25fde6b13d4e,0,Alex Rodoni,2019-07-22 18:59:41+00:00,['51092260b69b9082f0ecb2a9212e680f5dbc6f43'],64,85,149,6351093,3,,,,5961
2813d0c18414a5b7977cc713755daed7e53358ce,0,Alex Rodoni,2019-07-22 20:53:01+00:00,['5466cf6344af893521b093915aba25fde6b13d4e'],3,2,5,6351098,2,,,,5961
55e52287e7d8fb9f3a22a70c26627eabdcaa48d0,0,Alex Rodoni,2019-07-23 18:04:34+00:00,['2813d0c18414a5b7977cc713755daed7e53358ce'],0,82,82,6351180,2,,,,5962
1c9af2cb526b038c080f1b09acc403e8d7378364,0,Alex Rodoni,2019-07-23 18:11:06+00:00,['55e52287e7d8fb9f3a22a70c26627eabdcaa48d0'],0,32,32,6351212,1,,,,5962
1f4e89e66ed45cb28dfa2c98023464621b3ee7ab,0,Alex Rodoni,2019-07-23 21:40:59+00:00,['1c9af2cb526b038c080f1b09acc403e8d7378364'],26,112,138,6351350,3,,,,5962
f689daef7f140fb2e227ee96218f31076b5ba257,0,Tim Armstrong,2019-07-23 23:57:43+00:00,['1f4e89e66ed45cb28dfa2c98023464621b3ee7ab'],101,35,136,6351486,6,,,,5962
8911b73a367c7e598d4808a5799197ab68c8cd54,0,Impala Public Jenkins,2019-07-24 03:40:51+00:00,['f689daef7f140fb2e227ee96218f31076b5ba257'],1,1,2,6351488,1,,,,5962
4000da35be69e469500f5f11e0e5fdec119cf5c7,1,Csaba Ringhofer,2019-07-24 09:24:47+00:00,['8911b73a367c7e598d4808a5799197ab68c8cd54'],210,431,641,6352129,10,0.817460317,0.984126984,0.73015873,5962
7c11cd46cccafdfd8a3148eed7fb577d1ceec603,0,Joe McDonnell,2019-07-24 17:00:54+00:00,['4000da35be69e469500f5f11e0e5fdec119cf5c7'],14,29,43,6352172,2,,,,5962
b2136c39fcafacec308dc9dd13ad13133596d05d,0,Alex Rodoni,2019-07-24 21:03:38+00:00,['7c11cd46cccafdfd8a3148eed7fb577d1ceec603'],6,36,42,6352214,1,,,,5962
e8b2282985320737e292778a01ffd46640f5bfc6,0,Alex Rodoni,2019-07-25 00:32:40+00:00,['b2136c39fcafacec308dc9dd13ad13133596d05d'],1,2,3,6352217,1,,,,5962
1c18a46c16484c596404f8d2661585ce0e53e187,0,Impala Public Jenkins,2019-07-25 07:13:58+00:00,['e8b2282985320737e292778a01ffd46640f5bfc6'],5,6,11,6352228,1,0,0,1,5962
33b5c3dcbe4d0bd574122af5afd8af8a07ddc78a,1,Impala Public Jenkins,2019-07-25 11:21:27+00:00,['1c18a46c16484c596404f8d2661585ce0e53e187'],31,92,123,6352351,2,0.84,0.84,1,5963
6d4cde7c926e0c002f976697d8437165cca4c247,0,Alex Rodoni,2019-07-25 17:25:26+00:00,['33b5c3dcbe4d0bd574122af5afd8af8a07ddc78a'],7,24,31,6352382,2,,,,5963
8909abb9c3134c7c785b8b57b46547047a0d8a9f,0,Alex Rodoni,2019-07-25 18:44:10+00:00,['6d4cde7c926e0c002f976697d8437165cca4c247'],4,6,10,6352392,2,,,,5963
ddf92017668a9e4a0935a3643c27115522b845c1,0,Alex Rodoni,2019-07-25 21:44:12+00:00,['8909abb9c3134c7c785b8b57b46547047a0d8a9f'],21,46,67,6352459,1,,,,5963
ca0785ec206f27f06d8d6fd1b710779e548bbd8e,1,Impala Public Jenkins,2019-07-25 21:59:44+00:00,['ddf92017668a9e4a0935a3643c27115522b845c1'],15,156,171,6352630,11,0.924528302,0.905660377,0.905660377,5964
c501b34fb2ea7378ae0b1b615d9610e93a2e5af0,0,Impala Public Jenkins,2019-07-26 03:28:46+00:00,['ca0785ec206f27f06d8d6fd1b710779e548bbd8e'],1,29,30,6352660,2,0.619047619,0,0.380952381,5964
21a600409bb3d780d171abd7b5f54b69a601553c,0,Alex Rodoni,2019-07-26 16:06:11+00:00,['c501b34fb2ea7378ae0b1b615d9610e93a2e5af0'],0,255,255,6352915,5,,,,5967
f6b72aa24add8232e1a20ac291c4400395839c74,0,Impala Public Jenkins,2019-07-26 16:19:27+00:00,['21a600409bb3d780d171abd7b5f54b69a601553c'],1,22,23,6352938,1,,,,5967
8d4ba5d146da8685adb71d0fb49b0ca73f00a8d2,1,Lars Volker,2019-07-26 18:21:26+00:00,['f6b72aa24add8232e1a20ac291c4400395839c74'],0,79,79,6353017,4,1,1,1,5968
12575f8abff160be425445b47c1142958e4718bd,0,Lars Volker,2019-07-26 18:22:05+00:00,['8d4ba5d146da8685adb71d0fb49b0ca73f00a8d2'],1,11,12,6353029,1,,,,5968
2551a873a0ab5636b3693711de11e2a91474d86a,1,Vihang Karajgaonkar,2019-07-26 22:36:38+00:00,['12575f8abff160be425445b47c1142958e4718bd'],16,36,52,6353081,2,0.5,0.5,0.5,5968
20b5b1f13a5cdafd793014c81ae3c3b4e5568d06,0,Impala Public Jenkins,2019-07-26 23:56:44+00:00,['2551a873a0ab5636b3693711de11e2a91474d86a'],1,13,14,6353095,1,1,1,1,5968
6dd36d9d1be7437d3d5e18088a5e85a380c11040,0,Lars Volker,2019-07-27 02:42:28+00:00,['20b5b1f13a5cdafd793014c81ae3c3b4e5568d06'],0,4,4,6353099,1,,,,5968
241a9265926e13204f780187144e0e703c2d4e09,0,Impala Public Jenkins,2019-07-27 03:47:50+00:00,['6dd36d9d1be7437d3d5e18088a5e85a380c11040'],18,47,65,6353164,1,,,,5968
82f753e3044bd2482f35d137fbb28516fc0ef86c,1,Impala Public Jenkins,2019-07-27 06:53:17+00:00,['241a9265926e13204f780187144e0e703c2d4e09'],101,396,497,6353661,11,0.41322314,0.826446281,0.867768595,5969
6360657cb4d3b7655d9ff80958b2694ae4609370,1,Impala Public Jenkins,2019-07-27 13:45:51+00:00,['82f753e3044bd2482f35d137fbb28516fc0ef86c'],133,939,1072,6354733,36,0.483146067,0.838951311,0.651685393,5973
d412c4b69d2ec7fc01d4e21d4316fb367b488f4d,1,Impala Public Jenkins,2019-07-29 04:05:33+00:00,['6360657cb4d3b7655d9ff80958b2694ae4609370'],119,165,284,6355017,4,0.384615385,1,1,5973
72c9370856d7436885adbee3e8da7e7d9336df15,1,Bharath Vissapragada,2019-07-29 05:43:48+00:00,['d412c4b69d2ec7fc01d4e21d4316fb367b488f4d'],62,326,388,6355405,19,0.102739726,0.671232877,0.945205479,5974
8099911fd7886e02cdb727ddebc4ace19f2201bc,0,Impala Public Jenkins,2019-07-29 23:33:34+00:00,['72c9370856d7436885adbee3e8da7e7d9336df15'],2,2,4,6355409,1,,,,5974
b6b45c06656276edc90928c0bbb95c93e4a04f6f,0,Alex Rodoni,2019-07-30 00:59:32+00:00,['8099911fd7886e02cdb727ddebc4ace19f2201bc'],6,22,28,6355437,1,,,,5974
88da6fd421a9449d372de77aae61a33197f4d3c2,0,Impala Public Jenkins,2019-07-30 03:59:49+00:00,['b6b45c06656276edc90928c0bbb95c93e4a04f6f'],4,26,30,6355467,2,0,0,0,5974
dfc968dff1eabc71871e2d941fbe9539944c3e88,1,Impala Public Jenkins,2019-07-30 10:38:03+00:00,['88da6fd421a9449d372de77aae61a33197f4d3c2'],35,735,770,6356237,15,0.234042553,0.525835866,0.838905775,5977
def70c241dffcdab8301cbc7456ea6680ca01692,0,Impala Public Jenkins,2019-07-30 23:36:48+00:00,['dfc968dff1eabc71871e2d941fbe9539944c3e88'],45,96,141,6356378,9,0,0,0,5977
ffb78e24d91fadd3ffb79692211a6208a9eaedf1,0,Impala Public Jenkins,2019-07-31 02:34:21+00:00,['def70c241dffcdab8301cbc7456ea6680ca01692'],5,5,10,6356388,3,,,,5977
b587751e72c6d1ac1836edbae7d82e9110ca6574,1,Csaba Ringhofer,2019-07-31 12:57:09+00:00,['ffb78e24d91fadd3ffb79692211a6208a9eaedf1'],4,131,135,6356523,10,0.194805195,0.909090909,0.415584416,5977
615a8213159268aa893da51921d3c7728d82c7f7,1,Tim Armstrong,2019-08-01 01:45:57+00:00,['b587751e72c6d1ac1836edbae7d82e9110ca6574'],8,17,25,6356548,2,1,0,1,5977
699450aadbf45f36617472b7c777dc2d9aad066a,0,Impala Public Jenkins,2019-08-01 13:12:54+00:00,['615a8213159268aa893da51921d3c7728d82c7f7'],160,514,674,6357222,20,0.61682243,0.373831776,0.607476636,5980
a0b0fd4fce7676255dda52445cb972424f0b7c26,1,Impala Public Jenkins,2019-08-01 13:18:19+00:00,['699450aadbf45f36617472b7c777dc2d9aad066a'],115,820,935,6358157,18,0.273901809,0.723514212,0.826873385,5981
2d819655118c8c6e82649e3c3821311f3dd01174,1,Gabor Kaszab,2019-08-01 17:23:38+00:00,['a0b0fd4fce7676255dda52445cb972424f0b7c26'],85,220,305,6358462,8,0.373493976,0.43373494,1,5981
e8bd307941f8734d24b5e3ce61e2b319f59563c5,0,Alex Rodoni,2019-08-01 17:24:50+00:00,['2d819655118c8c6e82649e3c3821311f3dd01174'],76,39,115,6358577,1,,,,5981
48bb93d4744f54f609f4f81580b17ef39d1f1a2b,0,Impala Public Jenkins,2019-08-01 17:44:26+00:00,['e8bd307941f8734d24b5e3ce61e2b319f59563c5'],0,2,2,6358579,1,,,,5981
31aa38b4c78bebafff40bf166dc876be36c13fc5,0,Impala Public Jenkins,2019-08-01 23:22:36+00:00,['48bb93d4744f54f609f4f81580b17ef39d1f1a2b'],3,6,9,6358588,1,0,1,1,5981
f5c593ae85d18db1f8eca15b6b9c2a86ffd5eea8,1,Alex Rodoni,2019-08-02 20:16:01+00:00,['31aa38b4c78bebafff40bf166dc876be36c13fc5'],39,185,224,6358812,3,,,,5981
2450cd49b6f2dbd6b73c210a2f000d427572d245,0,Alex Rodoni,2019-08-02 21:20:19+00:00,['f5c593ae85d18db1f8eca15b6b9c2a86ffd5eea8'],69,56,125,6358937,1,,,,5981
1dcd2eb959b5bac642e9c0ccf512f2d68a51dd12,1,Bharath Vissapragada,2019-08-03 23:58:53+00:00,['2450cd49b6f2dbd6b73c210a2f000d427572d245'],1,1,2,6358939,1,,,,5981
cdc586916d25533a5edb0f196fd7e036293657e6,0,Alex Rodoni,2019-08-05 21:31:33+00:00,['1dcd2eb959b5bac642e9c0ccf512f2d68a51dd12'],91,81,172,6359111,2,,,,5981
6a31be8dd748972b2bfbe4544904cc85edc77923,0,Impala Public Jenkins,2019-08-06 00:13:49+00:00,['cdc586916d25533a5edb0f196fd7e036293657e6'],1,3,4,6359115,1,,,,5981
b5193f36de05218f90581d29dd71d7e570e38b46,1,Impala Public Jenkins,2019-08-06 02:33:59+00:00,['6a31be8dd748972b2bfbe4544904cc85edc77923'],48,177,225,6359340,9,0,0.802631579,0.842105263,5981
bbec8fa74961755269298706302477780019e7d5,1,Impala Public Jenkins,2019-08-06 02:35:54+00:00,['b5193f36de05218f90581d29dd71d7e570e38b46'],64,314,378,6359718,5,0.8125,0.9375,0.296875,5983
bbe064ec194aff4ecf1e794bd4071df4ea4be166,1,Impala Public Jenkins,2019-08-06 04:14:33+00:00,['bbec8fa74961755269298706302477780019e7d5'],60,182,242,6359960,7,0,0.7,0.066666667,5983
bcedd1572ee69bf5f5551af08f8fcb0ae0c48aea,0,Impala Public Jenkins,2019-08-06 09:10:52+00:00,['bbe064ec194aff4ecf1e794bd4071df4ea4be166'],58,47,105,6360065,4,1,1,0,5983
227b839e4e71778b74b045331682317e29014c7c,0,Tim Armstrong,2019-08-06 16:38:07+00:00,['bcedd1572ee69bf5f5551af08f8fcb0ae0c48aea'],27,32,59,6360124,5,1,1,0.5,5984
972104b6d6611ba0c1667671f9c25061fbe19b55,0,Impala Public Jenkins,2019-08-06 17:48:26+00:00,['227b839e4e71778b74b045331682317e29014c7c'],2,2,4,6360128,1,,,,5984
4fb8e8e324ad3258d24d0ae40946c954b6c21a8d,0,Impala Public Jenkins,2019-08-06 21:34:26+00:00,['972104b6d6611ba0c1667671f9c25061fbe19b55'],21,140,161,6360289,19,0.933333333,1,0.96,5984
39613c8226aeb48f639bccc361f002c7085cf75a,1,Impala Public Jenkins,2019-08-07 01:41:15+00:00,['4fb8e8e324ad3258d24d0ae40946c954b6c21a8d'],68,208,276,6360565,16,0.448275862,1,0.149425287,5985
411189a8d733a66c363c72f8c404123d68640a3e,0,Impala Public Jenkins,2019-08-07 01:56:44+00:00,['39613c8226aeb48f639bccc361f002c7085cf75a'],41,382,423,6360988,10,0.088785047,0.822429907,0.780373832,5985
33f1e86ce3dc5e278b804004671062f46d42d90e,1,Tim Armstrong,2019-08-07 03:38:55+00:00,['411189a8d733a66c363c72f8c404123d68640a3e'],4,31,35,6361023,2,0,1,1,5985
e849855b232660d418dd5e226221bfc853b1ad9c,0,Impala Public Jenkins,2019-08-07 04:06:21+00:00,['33f1e86ce3dc5e278b804004671062f46d42d90e'],2,2,4,6361027,1,,,,5985
df7730f7fea948409958db2dfdce2c52b0333c2f,0,Impala Public Jenkins,2019-08-07 14:50:11+00:00,['e849855b232660d418dd5e226221bfc853b1ad9c'],29,9,38,6361065,1,1,1,0,5985
fb3b1079d21f814c05ef429aeaca4fbdf9915a7b,0,Impala Public Jenkins,2019-08-07 21:10:12+00:00,['df7730f7fea948409958db2dfdce2c52b0333c2f'],60,646,706,6361771,16,0.207070707,0.406565657,0.898989899,5985
6d68c4f6c01c3d1f9d51a802476e0ef99fbfa208,0,Tim Armstrong,2019-08-08 01:05:02+00:00,['fb3b1079d21f814c05ef429aeaca4fbdf9915a7b'],19,25,44,6361815,5,1,0,0,5985
ef796639451af63bc9f4dbdc2a79bfc2f5048a93,0,Csaba Ringhofer,2019-08-08 13:44:59+00:00,['6d68c4f6c01c3d1f9d51a802476e0ef99fbfa208'],7,13,20,6361835,4,1,1,0,5985
a0c00e508f08542b55f140e4c329bf498141e921,1,Impala Public Jenkins,2019-08-08 15:29:13+00:00,['ef796639451af63bc9f4dbdc2a79bfc2f5048a93'],11,16,27,6361862,3,1,1,1,5985
8ca8ca3aad504d30521546ed0ef49e3a8c1b4038,1,Impala Public Jenkins,2019-08-08 21:48:01+00:00,['a0c00e508f08542b55f140e4c329bf498141e921'],19,537,556,6362418,9,0.324414716,0.662207358,0.538461538,5986
6cfa65e1de836510e2f3a8aee1525d529c0d4ad2,0,Alex Rodoni,2019-08-08 22:58:57+00:00,['8ca8ca3aad504d30521546ed0ef49e3a8c1b4038'],1,4,5,6362423,1,,,,5986
06cb9b7832c20e211696899d7cf7a87244917250,0,Impala Public Jenkins,2019-08-09 16:31:41+00:00,['6cfa65e1de836510e2f3a8aee1525d529c0d4ad2'],25,195,220,6362643,2,0.598130841,0.728971963,0.831775701,5986
f34a243a956dacd52f8afe79a122410ccf45ae26,0,Impala Public Jenkins,2019-08-10 22:21:38+00:00,['06cb9b7832c20e211696899d7cf7a87244917250'],1,24,25,6362668,2,0,1,1,5986
2066b72bc4b43fd57679c37145eecebaa6be8b27,0,Impala Public Jenkins,2019-08-10 23:01:45+00:00,['f34a243a956dacd52f8afe79a122410ccf45ae26'],4,27,31,6362699,2,0,0,1,5986
8eb50076c2b232b60fa5e44fb9341c752e2bf417,0,Alex Rodoni,2019-08-12 17:40:48+00:00,['2066b72bc4b43fd57679c37145eecebaa6be8b27'],171,311,482,6363181,3,,,,5986
620329f6d72d1a09edf560e7da0bc1d09e13a57f,0,Alex Rodoni,2019-08-12 17:42:42+00:00,['8eb50076c2b232b60fa5e44fb9341c752e2bf417'],6,14,20,6363201,2,,,,5986
f26a32f85542bfdbceb7306a06327f66dc30294a,0,Impala Public Jenkins,2019-08-12 18:33:26+00:00,['620329f6d72d1a09edf560e7da0bc1d09e13a57f'],1,1,2,6363203,1,,,,5986
760169edcbca438c5964380a604b6c271c6bd1a3,1,Impala Public Jenkins,2019-08-12 21:55:54+00:00,['f26a32f85542bfdbceb7306a06327f66dc30294a'],123,154,277,6363480,12,0,0.041666667,0.625,5986
6cde6d3b3a7d639fcabb19fb00940bd0cd444563,0,Alex Rodoni,2019-08-12 22:46:52+00:00,['760169edcbca438c5964380a604b6c271c6bd1a3'],1,1,2,6363482,1,,,,5986
8094811b5d975e18e20071552f86c2e3f8c0fc8f,1,Vihang Karajgaonkar,2019-08-13 00:18:39+00:00,['6cde6d3b3a7d639fcabb19fb00940bd0cd444563'],49,48,97,6363579,3,,,,5986
2df3b8cf82af66199f5851c84f3aa065577f6d7d,1,Tim Armstrong,2019-08-13 01:00:25+00:00,['8094811b5d975e18e20071552f86c2e3f8c0fc8f'],154,123,277,6363856,12,1,0.958333333,0.375,5986
a2f1ba1a1b5016b3d8a4fbe3873d9e1f7a6e78d8,0,Tim Armstrong,2019-08-13 17:44:41+00:00,['2df3b8cf82af66199f5851c84f3aa065577f6d7d'],104,5,109,6363965,2,0.363636364,0,0.136363636,5986
e1b93f27f3fb2a0f3d1c754f8e0e988bad838f11,1,Impala Public Jenkins,2019-08-13 18:07:21+00:00,['a2f1ba1a1b5016b3d8a4fbe3873d9e1f7a6e78d8'],40,205,245,6364210,11,0.5375,0.7125,0,5986
8db7f27ddde226f3efd3bddcc00665d0d9b99ef0,0,Impala Public Jenkins,2019-08-13 18:25:32+00:00,['e1b93f27f3fb2a0f3d1c754f8e0e988bad838f11'],0,323,323,6364533,4,0.165217391,0,0.456521739,5986
dfae1aea540edf75061fb5ba8b44a49b6cb93590,1,Impala Public Jenkins,2019-08-13 18:55:09+00:00,['8db7f27ddde226f3efd3bddcc00665d0d9b99ef0'],5,340,345,6364878,6,0.311688312,0.805194805,0.5,5988
fd8667234683c185c5183e02c14a69c6c2730836,0,Alex Rodoni,2019-08-13 20:09:09+00:00,['dfae1aea540edf75061fb5ba8b44a49b6cb93590'],3,18,21,6364899,2,,,,5988
1908e44c3c9faac8c7bf09422ca4c5ec598ffd58,0,Impala Public Jenkins,2019-08-14 04:36:31+00:00,['fd8667234683c185c5183e02c14a69c6c2730836'],11,381,392,6365291,13,0.322115385,0.25,0.701923077,5988
e0c0fe988ac7c0c4b274c472ec544965d19c6184,1,Impala Public Jenkins,2019-08-14 06:11:45+00:00,['1908e44c3c9faac8c7bf09422ca4c5ec598ffd58'],125,167,292,6365583,13,0,0.233333333,0,5988
cef76db392bfe83507ff703b054a73e811358860,1,Zoltan Borok-Nagy,2019-08-14 09:27:14+00:00,['e0c0fe988ac7c0c4b274c472ec544965d19c6184'],0,1,1,6365584,1,1,1,1,5988
33475a3e2c482681f1bab307055b75b0643ecdee,0,Joe McDonnell,2019-08-14 15:20:01+00:00,['cef76db392bfe83507ff703b054a73e811358860'],44,87,131,6365715,2,0,0,0.833333333,5988
d5d3ace6c27123f788dc292a651f1df0c8620686,0,Tim Armstrong,2019-08-15 00:43:23+00:00,['33475a3e2c482681f1bab307055b75b0643ecdee'],5,19,24,6365739,1,,,,5988
0ff4f450e3f76eb3ac8622588fe0824e367c2b03,1,Vihang Karajgaonkar,2019-08-15 07:00:56+00:00,['d5d3ace6c27123f788dc292a651f1df0c8620686'],10,162,172,6365911,3,0.316455696,0.911392405,0.632911392,5989
1f904719e4c7e398a7a8e152d82c8da1590b6d25,0,Impala Public Jenkins,2019-08-15 11:06:49+00:00,['0ff4f450e3f76eb3ac8622588fe0824e367c2b03'],14,40,54,6365965,2,0.2,0,0.28,5989
3e9cac0cac0063dda5d73ce00ccc8bd2332f50a1,0,Impala Public Jenkins,2019-08-15 13:02:55+00:00,['1f904719e4c7e398a7a8e152d82c8da1590b6d25'],74,41,115,6366080,3,0,0,0,5989
fafb2c9786467ebe582b92b27e2990f5789c9c00,1,Tim Armstrong,2019-08-15 14:01:27+00:00,['3e9cac0cac0063dda5d73ce00ccc8bd2332f50a1'],0,12,12,6366092,2,0.5,0.5,1,5989
c3a67b67faaebf18735fa36d35c80d8c11043f7f,1,Tim Armstrong,2019-08-15 14:40:04+00:00,['fafb2c9786467ebe582b92b27e2990f5789c9c00'],79,154,233,6366325,8,0.12244898,0.244897959,0.183673469,5989
fdb728e9d84f3400a9adae128c6cbc1c9b4752fe,0,Alex Rodoni,2019-08-15 17:51:05+00:00,['c3a67b67faaebf18735fa36d35c80d8c11043f7f'],64,717,781,6367106,1,,,,5989
60ac7c07511015de130dbd01885421459e96bc3e,1,Impala Public Jenkins,2019-08-15 19:51:25+00:00,['fdb728e9d84f3400a9adae128c6cbc1c9b4752fe'],17,106,123,6367229,9,1,1,0.303030303,5989
0364e5f8d4195210bf5eb0a6b5145b9f9940d2b5,0,Impala Public Jenkins,2019-08-15 21:21:56+00:00,['60ac7c07511015de130dbd01885421459e96bc3e'],2,3,5,6367234,1,0,1,1,5989
cebed8b88a3ce928dff694e79f04db8c83ba0970,1,Impala Public Jenkins,2019-08-16 01:50:34+00:00,['0364e5f8d4195210bf5eb0a6b5145b9f9940d2b5'],5,16,21,6367255,1,0,0,1,5989
d596f1c01aca2128bc15ec704f44dfe58867a19d,0,Csaba Ringhofer,2019-08-16 14:41:31+00:00,['cebed8b88a3ce928dff694e79f04db8c83ba0970'],19,40,59,6367314,5,0.8,1,0.6,5989
b04488a61ad477b4e1eb18197ef705fe50522c82,0,Alex Rodoni,2019-08-16 15:19:43+00:00,['d596f1c01aca2128bc15ec704f44dfe58867a19d'],1507,1057,2564,6369878,1,,,,5989
f24432f80c308def7208f2ae143a9cf49b996830,1,Tim Armstrong,2019-08-16 16:03:01+00:00,['b04488a61ad477b4e1eb18197ef705fe50522c82'],6,85,91,6369969,1,,,,5989
4ee31de3a104b4d64008a087925b4830e95ea826,1,Vihang Karajgaonkar,2019-08-16 22:15:38+00:00,['f24432f80c308def7208f2ae143a9cf49b996830'],24,1598,1622,6371591,6,0.726447219,0.796821793,0.743473326,5992
70b0492e6b0322ec5b673a2ab20e02d9e35d0a93,0,Vihang Karajgaonkar,2019-08-16 22:16:11+00:00,['4ee31de3a104b4d64008a087925b4830e95ea826'],1,1,2,6371593,1,,,,5992
df2c6f200f66e6849e17ef177c99adf035766d6a,0,Tim Armstrong,2019-08-16 23:00:01+00:00,['70b0492e6b0322ec5b673a2ab20e02d9e35d0a93'],0,19,19,6371612,2,,,,5992
3948eda50bcae20c1080475571f95a1080b0820d,1,Impala Public Jenkins,2019-08-16 23:19:43+00:00,['df2c6f200f66e6849e17ef177c99adf035766d6a'],14,41,55,6371667,1,0,1,0,5992
8c5ea90aa53dd925ec038ef9d8ea71e7919e3127,1,Tim Armstrong,2019-08-16 23:22:53+00:00,['3948eda50bcae20c1080475571f95a1080b0820d'],119,406,525,6372192,10,0.336283186,0.672566372,0,5993
c37f17732edcb1740941d8c2dc8ad289d8d11898,0,Impala Public Jenkins,2019-08-17 00:57:32+00:00,['8c5ea90aa53dd925ec038ef9d8ea71e7919e3127'],1,1,2,6372194,1,,,,5993
46976ba4c1d7157d6fda36dbfc2ca9b3d7174a28,0,Impala Public Jenkins,2019-08-17 04:10:10+00:00,['c37f17732edcb1740941d8c2dc8ad289d8d11898'],5,10,15,6372209,1,0,0,1,5993
c665fc1e06d53c7b70611ad3993c712c7fe35cb2,1,Impala Public Jenkins,2019-08-17 05:35:30+00:00,['46976ba4c1d7157d6fda36dbfc2ca9b3d7174a28'],3,109,112,6372321,4,0,0,0.125,5993
7d387d97eef83f3e8e8f2a5e6868c2dcd677b0a4,0,Bharath Vissapragada,2019-08-17 15:11:50+00:00,['c665fc1e06d53c7b70611ad3993c712c7fe35cb2'],0,16,16,6372337,1,,,,5993
ad7d20c46503ce791a8fd71467afe0dcd19cf860,1,Tim Armstrong,2019-08-19 03:22:02+00:00,['7d387d97eef83f3e8e8f2a5e6868c2dcd677b0a4'],79,293,372,6372709,4,,,,5995
69f2fbd848a5df7bc0a38571be7accf2af833f3a,0,Quanlong Huang,2019-08-19 15:34:37+00:00,['ad7d20c46503ce791a8fd71467afe0dcd19cf860'],942,833,1775,6374484,3,,,,5995
0f840c5a0f5e673c67cbd482e62065fd47b98e1a,0,Quanlong Huang,2019-08-19 15:35:00+00:00,['69f2fbd848a5df7bc0a38571be7accf2af833f3a'],6,15,21,6374505,3,,,,5995
ff7d81834cef5b6160bb06064198de54e8a0c512,0,Quanlong Huang,2019-08-19 17:27:44+00:00,['0f840c5a0f5e673c67cbd482e62065fd47b98e1a'],0,5,5,6374510,1,,,,5995
623e923cc6e190e1cbcb991cb3eadc3e349556b4,0,Quanlong Huang,2019-08-19 17:51:29+00:00,['ff7d81834cef5b6160bb06064198de54e8a0c512'],1,8,9,6374519,1,,,,5995
014c455aaaa38010ae706228f7b439c080c0bc7d,0,Impala Public Jenkins,2019-08-19 21:35:51+00:00,['623e923cc6e190e1cbcb991cb3eadc3e349556b4'],8,19,27,6374546,7,0,0.163366337,0.143564356,5996
bc4781078717a191dcac8e2c284d472ba524abc9,0,Impala Public Jenkins,2019-08-20 09:35:50+00:00,['014c455aaaa38010ae706228f7b439c080c0bc7d'],21,79,100,6374646,4,0.357142857,0,0.357142857,5996
4b5ea534d25b7d18d6ecb71d90c18efda99c1b29,0,Impala Public Jenkins,2019-08-21 04:09:22+00:00,['bc4781078717a191dcac8e2c284d472ba524abc9'],1,5,6,6374652,2,0.333333333,0.333333333,1,5996
475ee7930bef3160227cddde22b63bd7fe531a36,0,Alex Rodoni,2019-08-21 18:37:24+00:00,['4b5ea534d25b7d18d6ecb71d90c18efda99c1b29'],1,1,2,6374654,1,,,,5996
dce3a58b330798e2362b2701b698805721633ff9,0,Impala Public Jenkins,2019-08-21 21:35:17+00:00,['475ee7930bef3160227cddde22b63bd7fe531a36'],0,2,2,6374656,1,,,,5996
a85b18503f430acbf7f0bd285b67c3eecc7ac377,0,Impala Public Jenkins,2019-08-22 05:03:03+00:00,['dce3a58b330798e2362b2701b698805721633ff9'],1,46,47,6374703,3,1,1,1,5997
62f9407b3a512f6c2dbb6bcea9d899581aa1c381,0,Bharath Vissapragada,2019-08-22 14:26:55+00:00,['a85b18503f430acbf7f0bd285b67c3eecc7ac377'],4,28,32,6374735,1,0.5,1,0.9,5997
3787e47d74e5964d3f3ea2f4b05c3f5f8ec2ee84,0,Impala Public Jenkins,2019-08-22 22:36:23+00:00,['62f9407b3a512f6c2dbb6bcea9d899581aa1c381'],1,1,2,6374737,1,,,,5997
f6117c9580731b290d3566fef420f9c4a02273d9,0,Impala Public Jenkins,2019-08-22 23:04:35+00:00,['3787e47d74e5964d3f3ea2f4b05c3f5f8ec2ee84'],6,13,19,6374756,1,0.571428571,1,0.428571429,5997
661d2d6bc73042adb7ece6be69661b4869def99e,0,Impala Public Jenkins,2019-08-22 23:38:53+00:00,['f6117c9580731b290d3566fef420f9c4a02273d9'],1,1,2,6374758,1,,,,5997
9874ce37a989240571e2473dce3153357a0e417f,1,Michael Ho,2019-08-23 18:25:44+00:00,['661d2d6bc73042adb7ece6be69661b4869def99e'],80,171,251,6375009,25,0.551020408,0.714285714,0.714285714,5997
af0e04f33bbf2e93b7676ed7768c335c49b195f2,1,Impala Public Jenkins,2019-08-24 00:32:28+00:00,['9874ce37a989240571e2473dce3153357a0e417f'],8,12,20,6375029,4,1,1,0,5997
d037ac8304b43f6e4bb4c6ba2eb1910a9e921c24,1,Impala Public Jenkins,2019-08-24 00:38:50+00:00,['af0e04f33bbf2e93b7676ed7768c335c49b195f2'],268,995,1263,6376292,46,0.400763359,0.908396947,0.847328244,6001
5fde84a7aba9284004b481b41fe6f23d11527b6f,1,Impala Public Jenkins,2019-08-25 05:43:56+00:00,['d037ac8304b43f6e4bb4c6ba2eb1910a9e921c24'],106,541,647,6376939,13,0.140271493,0.212669683,0.511312217,6003
141066684ddb7542575280a6b8acde06ff201dfe,0,Thomas Tauber-Marshall,2019-08-26 20:49:04+00:00,['5fde84a7aba9284004b481b41fe6f23d11527b6f'],25,0,25,6376964,1,0.230769231,0.230769231,0.461538462,6003
1c4bdcede475395d1139210a5d3ddf2641efa7eb,0,Impala Public Jenkins,2019-08-27 02:06:40+00:00,['141066684ddb7542575280a6b8acde06ff201dfe'],13,103,116,6377080,6,0.277777778,1,0.944444444,6004
0018b710f46f6f8551bf356225add8a12817a82f,0,Impala Public Jenkins,2019-08-27 02:32:38+00:00,['1c4bdcede475395d1139210a5d3ddf2641efa7eb'],6,20,26,6377106,3,,,,6004
3f4cbe961702552a187c0bbc04b616e0029c1412,0,Csaba Ringhofer,2019-08-27 11:58:07+00:00,['0018b710f46f6f8551bf356225add8a12817a82f'],25,19,44,6377150,7,1,0,0,6004
db007486a3d11ca935c3a6722f9ae388fb097853,0,Impala Public Jenkins,2019-08-27 15:46:45+00:00,['3f4cbe961702552a187c0bbc04b616e0029c1412'],4,4,8,6377158,1,,,,6004
e40d24ee0aa2f8ca928618eb6d86728ee5422958,1,Impala Public Jenkins,2019-08-27 18:51:55+00:00,['db007486a3d11ca935c3a6722f9ae388fb097853'],47,368,415,6377573,11,0.592920354,0.592920354,0.663716814,6006
eea617be8f3ffa72acdb4fb857803adb5ec1579a,1,Impala Public Jenkins,2019-08-27 20:13:35+00:00,['e40d24ee0aa2f8ca928618eb6d86728ee5422958'],29,114,143,6377716,10,0.064516129,0.822580645,0.983870968,6006
3209055ba2b5a05bedf7c9ecf0edd0e06c2525c9,0,Impala Public Jenkins,2019-08-27 21:46:31+00:00,['eea617be8f3ffa72acdb4fb857803adb5ec1579a'],5,9,14,6377730,1,0,0,1,6006
0df613f5e3ece63ed21fe84db6044d06546e900d,0,Lars Volker,2019-08-27 23:49:20+00:00,['3209055ba2b5a05bedf7c9ecf0edd0e06c2525c9'],7,49,56,6377786,10,0.75,1,0,6006
20dec47ae6c377cf8281c32787b003e5e6f3c07a,0,Alex Rodoni,2019-08-28 19:31:57+00:00,['0df613f5e3ece63ed21fe84db6044d06546e900d'],1,10,11,6377797,1,,,,6006
08ecb6d28cd7794a654f66fe41bb8ae727bc1a3e,1,Impala Public Jenkins,2019-08-28 21:23:56+00:00,['20dec47ae6c377cf8281c32787b003e5e6f3c07a'],0,150,150,6377947,2,0.4125,0.875,0.9875,6006
152a76479f61da4ccb58ab00f29df7c6e7d99a45,0,Impala Public Jenkins,2019-08-28 21:34:44+00:00,['08ecb6d28cd7794a654f66fe41bb8ae727bc1a3e'],2,2,4,6377951,1,,,,6006
a5cf105d95e9c15ce8065279f26366e021b5a432,1,Tim Armstrong,2019-08-28 22:52:29+00:00,['152a76479f61da4ccb58ab00f29df7c6e7d99a45'],0,669,669,6378620,2,1,1,1,6007
94f7d12f87f61cef6b341a5a1141b9bbe701de0b,1,Tim Armstrong,2019-08-28 22:52:29+00:00,['a5cf105d95e9c15ce8065279f26366e021b5a432'],854,963,1817,6380437,8,0.433333333,1,0.783333333,6007
4e23a529cbfee753298ca5437e9ed511554faedb,0,Impala Public Jenkins,2019-08-29 04:26:20+00:00,['94f7d12f87f61cef6b341a5a1141b9bbe701de0b'],1,1,2,6380439,1,,,,6007
026c5345e0e27383244d757660856e8a157aac20,1,Impala Public Jenkins,2019-08-29 12:34:56+00:00,['4e23a529cbfee753298ca5437e9ed511554faedb'],38,280,318,6380757,11,0.19375,0.6125,0.49375,6007
6308915a66d837b5545b601ef7f97caa5703c30f,1,Impala Public Jenkins,2019-08-29 19:38:18+00:00,['026c5345e0e27383244d757660856e8a157aac20'],56,306,362,6381119,5,0.315315315,0.927927928,0.756756757,6007
146af97944bb2797d501ecdbc6417a3bc758891f,0,Lars Volker,2019-08-29 19:54:33+00:00,['6308915a66d837b5545b601ef7f97caa5703c30f'],0,1,1,6381120,1,,,,6007
b7dfc18c59e831fa265d14ef4f7d26e33120b67f,1,Impala Public Jenkins,2019-08-29 23:32:02+00:00,['146af97944bb2797d501ecdbc6417a3bc758891f'],71,119,190,6381310,19,0.571428571,0.380952381,0.380952381,6008
b14848151b5e47ab0ca0f4e8a11add0d6e6b7b64,1,Impala Public Jenkins,2019-08-31 21:58:31+00:00,['b7dfc18c59e831fa265d14ef4f7d26e33120b67f'],13447,1961,15408,6396718,69,0.532821652,0.603716421,0.392243991,6025
d21f00ef2f2219551e3501e3cf1cf45ff4afdcef,0,Impala Public Jenkins,2019-09-03 07:53:20+00:00,['b14848151b5e47ab0ca0f4e8a11add0d6e6b7b64'],7,34,41,6396759,2,0,0.095238095,0.571428571,6025
f36ea767c8eac608d37dfc954e426a7da2a07251,1,Impala Public Jenkins,2019-09-04 08:37:54+00:00,['d21f00ef2f2219551e3501e3cf1cf45ff4afdcef'],16,33,49,6396808,7,0.1,0,0.8,6025
1915a3e7f49f753cf18b919a087e249fe6769127,0,Impala Public Jenkins,2019-09-05 02:27:52+00:00,['f36ea767c8eac608d37dfc954e426a7da2a07251'],3,4,7,6396815,1,0,1,1,6025
53aa0add886bde95b53597a01501844dbec3a93c,0,Impala Public Jenkins,2019-09-05 04:22:11+00:00,['1915a3e7f49f753cf18b919a087e249fe6769127'],1,1,2,6396817,1,,,,6025
69f7c8e1cd31519febf13637b4c9054ec9ab0423,1,Impala Public Jenkins,2019-09-05 11:10:25+00:00,['53aa0add886bde95b53597a01501844dbec3a93c'],19,542,561,6397378,14,0.321917808,0.832191781,0.890410959,6028
45cb8b2e92eeb1ab92c9e4f4e87ee9da7dca3930,0,Impala Public Jenkins,2019-09-05 22:50:31+00:00,['69f7c8e1cd31519febf13637b4c9054ec9ab0423'],6,1,7,6397385,2,1,0,0,6028
fdde66987b4c05aed1f0d848c6f408110a3fcdcc,0,Impala Public Jenkins,2019-09-05 22:52:05+00:00,['45cb8b2e92eeb1ab92c9e4f4e87ee9da7dca3930'],13,38,51,6397436,6,1,1,1,6028
eb680e4633256562f1a1a33feec5005e8fc60e2f,0,Impala Public Jenkins,2019-09-07 03:39:31+00:00,['fdde66987b4c05aed1f0d848c6f408110a3fcdcc'],74,17,91,6397527,5,0.565217391,1,0.217391304,6028
ece7c4d77ce387fba26e841c8bddd5dc08bcacc0,0,Impala Public Jenkins,2019-09-07 06:28:44+00:00,['eb680e4633256562f1a1a33feec5005e8fc60e2f'],15,26,41,6397568,2,0,0,0,6028
df365a8e306adc9113a000e427fa86b385754804,1,Impala Public Jenkins,2019-09-07 21:15:52+00:00,['ece7c4d77ce387fba26e841c8bddd5dc08bcacc0'],94,1044,1138,6398706,16,0.3125,0.84,0.9175,6032
521b15293eaeef6d02917ce20569275adcbd0802,0,Impala Public Jenkins,2019-09-07 23:23:51+00:00,['df365a8e306adc9113a000e427fa86b385754804'],9,10,19,6398725,2,,,,6032
fe54ebdc90e2d8d889474fe51154d684a1430203,0,Impala Public Jenkins,2019-09-09 17:49:15+00:00,['521b15293eaeef6d02917ce20569275adcbd0802'],0,22,22,6398747,1,,,,6032
4327cc351317878de51003c2dcf4a71c9183eb44,0,Impala Public Jenkins,2019-09-09 19:07:13+00:00,['fe54ebdc90e2d8d889474fe51154d684a1430203'],4,13,17,6398764,2,1,1,1,6032
19cb8dc1c1c2247e91adc4bf62cab27a7c1e4381,0,Impala Public Jenkins,2019-09-10 04:21:42+00:00,['4327cc351317878de51003c2dcf4a71c9183eb44'],16,77,93,6398857,3,0.407407407,0.703703704,0.740740741,6033
954e810b0ec67faca66e68b924b83dd805f455db,0,Impala Public Jenkins,2019-09-10 04:25:04+00:00,['19cb8dc1c1c2247e91adc4bf62cab27a7c1e4381'],1,5,6,6398863,2,,,,6033
151835116a7972b15a646f8eae6bd8a593bb3564,1,Impala Public Jenkins,2019-09-10 05:56:57+00:00,['954e810b0ec67faca66e68b924b83dd805f455db'],9,196,205,6399068,14,0.32967033,0.56043956,0.516483516,6033
de77c61f383794601c79d9783d36235482740417,0,Impala Public Jenkins,2019-09-10 09:25:16+00:00,['151835116a7972b15a646f8eae6bd8a593bb3564'],27,68,95,6399163,4,0,0.923076923,0,6033
b11a985677ab49f1db114ee39719fce1d19f5747,0,Thomas Tauber-Marshall,2019-09-11 00:10:52+00:00,['de77c61f383794601c79d9783d36235482740417'],3,6,9,6399172,3,1,1,1,6033
576f205bffadd0a18cbc36167e6f191279fbc911,1,Impala Public Jenkins,2019-09-11 08:04:05+00:00,['b11a985677ab49f1db114ee39719fce1d19f5747'],10,10,20,6399192,3,1,0,0,6033
b37dd05e8f35bba5d9126ef79b35c1831f966f1b,0,Impala Public Jenkins,2019-09-11 10:29:00+00:00,['576f205bffadd0a18cbc36167e6f191279fbc911'],3,8,11,6399203,2,0,0,0,6033
23ca556d0104758b50d1f085e6c5d4a7c5a50db8,1,Alex Rodoni,2019-09-11 17:46:17+00:00,['b37dd05e8f35bba5d9126ef79b35c1831f966f1b'],44,171,215,6399418,1,,,,6033
bb5d3c255e12478e30405bccaa4fd202393471c1,1,Impala Public Jenkins,2019-09-11 18:18:12+00:00,['23ca556d0104758b50d1f085e6c5d4a7c5a50db8'],14,137,151,6399569,5,0.3,0.3,0.3,6033
32dbf5d78a4ced803a9182bfb0d7c0992497f97e,1,Impala Public Jenkins,2019-09-12 02:02:44+00:00,['bb5d3c255e12478e30405bccaa4fd202393471c1'],243,6018,6261,6405830,10,0.68852459,0.442622951,0.442622951,6034
ced6e98fb4c361efa4bcc7e5441ccdb8debba8e9,1,Bharath Vissapragada,2019-09-12 04:31:19+00:00,['32dbf5d78a4ced803a9182bfb0d7c0992497f97e'],101,570,671,6406501,30,0.199335548,0.860465116,0.531561462,6034
4dc0af494bc9d0651a435cd3a90e37199b499b63,1,Impala Public Jenkins,2019-09-12 13:15:38+00:00,['ced6e98fb4c361efa4bcc7e5441ccdb8debba8e9'],2,6,8,6406509,1,1,1,1,6034
54c1957f134710fdc75753a4255d99dd0c6f67ba,0,Alex Rodoni,2019-09-12 18:58:26+00:00,['4dc0af494bc9d0651a435cd3a90e37199b499b63'],21,11,32,6406541,2,,,,6034
b3eb2d3c99ad45250866b0ef2a55a795def4df2f,0,Impala Public Jenkins,2019-09-13 01:38:06+00:00,['54c1957f134710fdc75753a4255d99dd0c6f67ba'],0,11,11,6406552,3,0,1,1,6034
da0ab1d41ae777fbd7094d44628dfee1ff0fc8fe,1,Joe McDonnell,2019-09-13 01:40:11+00:00,['b3eb2d3c99ad45250866b0ef2a55a795def4df2f'],367,523,890,6407442,3,0.131147541,1,1,6034
e070dbb02c264e26df576b40b8b792d02619fc60,0,Impala Public Jenkins,2019-09-13 19:51:29+00:00,['da0ab1d41ae777fbd7094d44628dfee1ff0fc8fe'],1,1,2,6407444,1,,,,6034
1a00227e6aaffd99ffcce30b4beda5eb5f0d2fb1,0,Impala Public Jenkins,2019-09-14 02:19:54+00:00,['e070dbb02c264e26df576b40b8b792d02619fc60'],1,33,34,6407478,6,0,0.666666667,1,6034
d155ef01f5708febf296dd0c2d0db921240bafb1,0,Bharath Vissapragada,2019-09-16 17:04:17+00:00,['1a00227e6aaffd99ffcce30b4beda5eb5f0d2fb1'],0,2,2,6407480,1,,,,6034
77aad0405fb248e3ea55554c28b6742caffc2ca2,0,Bharath Vissapragada,2019-09-16 17:04:17+00:00,['d155ef01f5708febf296dd0c2d0db921240bafb1'],18,18,36,6407516,1,,,,6034
34d132c513bfe5dc46478d9cb780a93200301b91,1,Sahil Takiar,2019-09-16 19:36:11+00:00,['77aad0405fb248e3ea55554c28b6742caffc2ca2'],13,199,212,6407728,10,0.593023256,0.976744186,0.813953488,6035
e74c294b133dc8fcf523b50ffa9cbb7986ca8790,0,Alex Rodoni,2019-09-16 20:38:08+00:00,['34d132c513bfe5dc46478d9cb780a93200301b91'],10,54,64,6407792,3,,,,6035
e38d57fe5d0266d0423a04b7f0b7350a3fd300f2,0,Alex Rodoni,2019-09-16 20:57:08+00:00,['e74c294b133dc8fcf523b50ffa9cbb7986ca8790'],19,19,38,6407830,1,,,,6035
451d31f2b45d0bfdfab8d8110cc63b06a061849a,0,Impala Public Jenkins,2019-09-17 00:47:40+00:00,['e38d57fe5d0266d0423a04b7f0b7350a3fd300f2'],1,14,15,6407845,3,0.083333333,1,1,6035
05e1a4f2185c892226497b4592fe0eac3e2747d2,0,Alex Rodoni,2019-09-17 17:52:47+00:00,['451d31f2b45d0bfdfab8d8110cc63b06a061849a'],2,2,4,6407849,1,,,,6035
7136e8b965bd0df974dccd1419ea65d42c494c06,1,Sahil Takiar,2019-09-17 20:08:13+00:00,['05e1a4f2185c892226497b4592fe0eac3e2747d2'],30,170,200,6408049,9,0.448275862,0.609195402,0.505747126,6035
d60c7524b5400fdaade378b14d46804b0713fe60,0,Alex Rodoni,2019-09-18 16:51:04+00:00,['7136e8b965bd0df974dccd1419ea65d42c494c06'],21,19,40,6408089,1,,,,6035
c0646a6c2f7f177e3eb2994be9597a04e72ee198,0,Alex Rodoni,2019-09-18 18:25:45+00:00,['d60c7524b5400fdaade378b14d46804b0713fe60'],6,5,11,6408100,1,,,,6035
b2e5e942867ee1eeca754fd383075e7db3c8b590,1,Impala Public Jenkins,2019-09-19 01:49:06+00:00,['c0646a6c2f7f177e3eb2994be9597a04e72ee198'],5,43,48,6408148,2,0,0,1,6035
feed25084a999fe0a4e7b58b5264fce5829c43e7,0,Impala Public Jenkins,2019-09-19 04:46:51+00:00,['b2e5e942867ee1eeca754fd383075e7db3c8b590'],13,79,92,6408240,6,1,1,0.875,6036
bca1b43efb72d839962f9e6999ca747fca7f17d9,1,Impala Public Jenkins,2019-09-19 18:46:19+00:00,['feed25084a999fe0a4e7b58b5264fce5829c43e7'],973,3522,4495,6412735,54,0.242276423,0.651219512,0.705691057,6047
391942d79dec18b086a85e29a75a873e74955518,0,Impala Public Jenkins,2019-09-19 19:03:27+00:00,['bca1b43efb72d839962f9e6999ca747fca7f17d9'],14,137,151,6412886,5,0.904761905,0.928571429,0.761904762,6048
b96b3b0b1ca97e5d756392a159e22dfcd8bcae71,1,Impala Public Jenkins,2019-09-19 23:07:55+00:00,['391942d79dec18b086a85e29a75a873e74955518'],85,232,317,6413203,5,0.381578947,0.855263158,0.802631579,6049
d99bc14936ff4891a8d932e9d6ff63f96d156e7f,1,Impala Public Jenkins,2019-09-20 02:43:58+00:00,['b96b3b0b1ca97e5d756392a159e22dfcd8bcae71'],229,393,622,6413825,13,0.212121212,0.767676768,0.858585859,6049
16e0d550c28a59510fb152d1d2ad32ac9dac741c,0,Impala Public Jenkins,2019-09-20 20:43:26+00:00,['d99bc14936ff4891a8d932e9d6ff63f96d156e7f'],64,112,176,6414001,10,0.103448276,0.103448276,0.689655172,6049
9c367968d00be3e1880c07494dd82ecf077e7ec0,1,Tim Armstrong,2019-09-20 21:19:28+00:00,['16e0d550c28a59510fb152d1d2ad32ac9dac741c'],2,2,4,6414005,1,,,,6049
983e3a66deef5bce52e9ebe74db8e2f86233d036,0,Impala Public Jenkins,2019-09-20 22:15:41+00:00,['9c367968d00be3e1880c07494dd82ecf077e7ec0'],687,680,1367,6415372,19,1,1,0.153846154,6049
91f8f379a989f13d99b7dc6e5265ff1021f2937d,0,Alex Rodoni,2019-09-20 23:43:05+00:00,['983e3a66deef5bce52e9ebe74db8e2f86233d036'],3,7,10,6415382,1,,,,6049
eb5368f9bbbf6a5907652cb0295aa23f819c187d,0,Alex Rodoni,2019-09-23 18:36:17+00:00,['91f8f379a989f13d99b7dc6e5265ff1021f2937d'],95,276,371,6415753,1,,,,6049
a23606902d06b006cc95cd321a6712e6114a78db,0,Alex Rodoni,2019-09-23 19:08:11+00:00,['eb5368f9bbbf6a5907652cb0295aa23f819c187d'],1,1,2,6415755,1,,,,6049
eb090700e3cc7575640f960c960041b9c42bbb10,0,Alex Rodoni,2019-09-23 21:22:26+00:00,['a23606902d06b006cc95cd321a6712e6114a78db'],0,27,27,6415782,1,,,,6049
f08bad4f4a7b2b593b31ded72a3ddb34a881831b,0,Alex Rodoni,2019-09-23 22:22:54+00:00,['eb090700e3cc7575640f960c960041b9c42bbb10'],60,33,93,6415875,1,,,,6049
3984c69f03c14355731dd6a518aa64dfc8219450,0,Impala Public Jenkins,2019-09-23 23:14:52+00:00,['f08bad4f4a7b2b593b31ded72a3ddb34a881831b'],4,92,96,6415971,7,0.542857143,0.542857143,0.485714286,6049
864a99956946750a7122025a6388ec34a686efe6,0,Tim Armstrong,2019-09-24 16:46:31+00:00,['3984c69f03c14355731dd6a518aa64dfc8219450'],26,10,36,6416007,7,,,,6049
750f65912046d39a82adbc4907ea8bc673c18964,0,Impala Public Jenkins,2019-09-24 19:14:06+00:00,['864a99956946750a7122025a6388ec34a686efe6'],25,54,79,6416086,3,0.777777778,0,1,6049
803323bb39aee3a3bd38e7cca544cef72500b8b6,1,Impala Public Jenkins,2019-09-24 22:05:48+00:00,['750f65912046d39a82adbc4907ea8bc673c18964'],20,108,128,6416214,8,0.577777778,0.888888889,1,6049
3c193c33b2f3004588fa435d7d545fb8fd4db552,1,Impala Public Jenkins,2019-09-25 01:06:19+00:00,['803323bb39aee3a3bd38e7cca544cef72500b8b6'],632,976,1608,6417822,54,1,1,0.324324324,6049
ab975c95171bdc0892326133a63e467398d5bbe2,0,Impala Public Jenkins,2019-09-25 16:58:14+00:00,['3c193c33b2f3004588fa435d7d545fb8fd4db552'],2,18,20,6417842,2,,,,6049
b7c081cb9966166be8d20d6b75a541394a001ddc,0,Csaba Ringhofer,2019-09-26 16:50:21+00:00,['ab975c95171bdc0892326133a63e467398d5bbe2'],505,973,1478,6419320,8,0.928057554,1,0.561151079,6053
288c8c41b530e2a54850257c3c70d16328dbcf0b,1,Impala Public Jenkins,2019-09-26 18:35:06+00:00,['b7c081cb9966166be8d20d6b75a541394a001ddc'],171,1678,1849,6421169,45,0.377969762,0.645788337,0.617710583,6061
0ff7c8118554258cdc46a3499ef98e1f62d6c533,0,Impala Public Jenkins,2019-09-26 21:43:43+00:00,['288c8c41b530e2a54850257c3c70d16328dbcf0b'],29,21,50,6421219,2,0,0,0,6061
93fb9182b4158baf6118c166acc92c7caab16ec4,1,Impala Public Jenkins,2019-09-26 22:22:16+00:00,['0ff7c8118554258cdc46a3499ef98e1f62d6c533'],637,642,1279,6422498,12,0,1,1,6061
548106f5e19c6ece17ef25b5ce2ece6881f00098,1,Impala Public Jenkins,2019-09-27 01:54:39+00:00,['93fb9182b4158baf6118c166acc92c7caab16ec4'],27,166,193,6422691,17,0,1,1,6063
104a454d3e88d96ec28837e1032de8b292daa84d,1,Impala Public Jenkins,2019-09-27 02:02:11+00:00,['548106f5e19c6ece17ef25b5ce2ece6881f00098'],9,54,63,6422754,7,0.458333333,0.5,0.25,6063
5645c4682a5efb8b7f9af32a46084af602e2e928,0,Thomas Tauber-Marshall,2019-09-27 16:57:35+00:00,['104a454d3e88d96ec28837e1032de8b292daa84d'],2,7,9,6422763,2,1,1,0,6063
27fa27e808d74db3e07be419dd0657c4448534e5,1,Impala Public Jenkins,2019-09-27 17:18:35+00:00,['5645c4682a5efb8b7f9af32a46084af602e2e928'],75,434,509,6423272,35,0.105769231,0.759615385,0.519230769,6068
0b68189166cfe27a7234877b5ce52ded6d62e0ab,1,Quanlong Huang,2019-09-30 04:28:50+00:00,['27fa27e808d74db3e07be419dd0657c4448534e5'],2,110,112,6423384,4,0.507462687,0.910447761,1,6068
e77e954ec2ebd4bfd7641dd55c6837a2799b05e7,1,Impala Public Jenkins,2019-10-01 17:15:57+00:00,['0b68189166cfe27a7234877b5ce52ded6d62e0ab'],0,133,133,6423517,1,0.757142857,1,0.471428571,6069
eb6116d49df8817afaa5bd0b12cd32894901cfa9,0,Impala Public Jenkins,2019-10-01 23:08:35+00:00,['e77e954ec2ebd4bfd7641dd55c6837a2799b05e7'],5,32,37,6423554,3,0.8,0.8,1,6069
f08d21335c5a81d31a3de7dc838ac4487080ac42,0,Tim Armstrong,2019-10-02 01:11:49+00:00,['eb6116d49df8817afaa5bd0b12cd32894901cfa9'],74,126,200,6423754,6,0.277777778,1,1,6070
49202ffc51f4c4198b9b03c5c508a237c40c71e3,1,Impala Public Jenkins,2019-10-03 03:41:59+00:00,['f08d21335c5a81d31a3de7dc838ac4487080ac42'],4,4,8,6423762,1,,,,6070
88cc930a94c600a87c3fc034733a298a37df9bfc,1,Joe McDonnell,2019-10-03 04:31:56+00:00,['49202ffc51f4c4198b9b03c5c508a237c40c71e3'],5,6,11,6423773,2,,,,6070
d24f868cef5cf94a3774fd2f213859bdd93bebb7,0,Alex Rodoni,2019-10-03 18:43:38+00:00,['88cc930a94c600a87c3fc034733a298a37df9bfc'],62,102,164,6423937,2,,,,6070
8f3733910811eeb7d0018a5284f0a170f618e092,0,Impala Public Jenkins,2019-10-03 21:21:39+00:00,['d24f868cef5cf94a3774fd2f213859bdd93bebb7'],218,1,219,6424156,1,0.341666667,0.3,0.733333333,6070
38290f91311bec57d2658d046ee27ed6901329ea,1,Alex Rodoni,2019-10-03 22:39:24+00:00,['8f3733910811eeb7d0018a5284f0a170f618e092'],45,68,113,6424269,4,,,,6071
bef0baed441f52fcf2589c2bf8b546dbf67f6598,0,Alex Rodoni,2019-10-03 23:38:51+00:00,['38290f91311bec57d2658d046ee27ed6901329ea'],1,0,1,6424270,1,,,,6071
c67e0868e032d0aec95018612b121c18aed3b914,0,Impala Public Jenkins,2019-10-04 01:10:25+00:00,['bef0baed441f52fcf2589c2bf8b546dbf67f6598'],2,6,8,6424278,2,,,,6071
c4874d9a94d6e2fda7ead957dbb385fea3a5c0b1,0,Alex Rodoni,2019-10-04 18:03:21+00:00,['c67e0868e032d0aec95018612b121c18aed3b914'],6,405,411,6424689,9,,,,6076
684a54a89e1752534dc713b05185bae1a6b69ba8,0,Impala Public Jenkins,2019-10-04 18:36:22+00:00,['c4874d9a94d6e2fda7ead957dbb385fea3a5c0b1'],199,251,450,6425139,16,0,0,1,6076
9cd1d72194391d18d4949ee8c2b86f32efa8a8ab,0,Impala Public Jenkins,2019-10-04 21:05:50+00:00,['684a54a89e1752534dc713b05185bae1a6b69ba8'],0,10,10,6425149,2,0,0,0,6076
7b3da1d6d27320be92839d4594896b7515f2f91f,1,Impala Public Jenkins,2019-10-04 21:57:18+00:00,['9cd1d72194391d18d4949ee8c2b86f32efa8a8ab'],127,123,250,6425399,3,0.9,0.6,1,6076
ac87278b169422091af1c03fcd2101516372defb,1,Impala Public Jenkins,2019-10-05 00:04:08+00:00,['7b3da1d6d27320be92839d4594896b7515f2f91f'],110,206,316,6425715,21,0.976190476,0.30952381,0.285714286,6076
ea79ba66ece6c0793b30cec2b0114267f7c29728,0,Tim Armstrong,2019-10-07 17:14:42+00:00,['ac87278b169422091af1c03fcd2101516372defb'],3,83,86,6425801,2,,,,6077
2465bc5c076d1f88b04dc3802647b0f702d87123,0,Alex Rodoni,2019-10-07 23:26:10+00:00,['ea79ba66ece6c0793b30cec2b0114267f7c29728'],68,8,76,6425877,1,,,,6077
23731ba90cea87ebd89089ddcf134f5cdeb7314f,0,Impala Public Jenkins,2019-10-08 09:26:14+00:00,['2465bc5c076d1f88b04dc3802647b0f702d87123'],1,1,2,6425879,1,,,,6077
c47fca5960b5be1a8e2013c4c4ffe260e98a1bff,0,Impala Public Jenkins,2019-10-08 19:13:33+00:00,['23731ba90cea87ebd89089ddcf134f5cdeb7314f'],189,563,752,6426631,19,0.141361257,0.769633508,0.335078534,6078
4f8a1b9b088e44821c59710c353a13c94f85d305,1,Impala Public Jenkins,2019-10-08 23:12:11+00:00,['c47fca5960b5be1a8e2013c4c4ffe260e98a1bff'],30,47,77,6426708,3,0,1,1,6078
d1b42c836c3458a2ef3662c0b0b1fd8fbf8f2baf,0,Thomas Tauber-Marshall,2019-10-09 00:26:13+00:00,['4f8a1b9b088e44821c59710c353a13c94f85d305'],166,325,491,6427199,11,0.060606061,0.797979798,0.393939394,6078
ae7a9189081b6ade267198873bd65fcb4bd90001,1,Impala Public Jenkins,2019-10-09 02:29:02+00:00,['d1b42c836c3458a2ef3662c0b0b1fd8fbf8f2baf'],118,240,358,6427557,17,0.255319149,0.382978723,0.191489362,6078
de6e27e6a05c2a533e4794e445f472ac26da8bee,0,Impala Public Jenkins,2019-10-09 05:21:29+00:00,['ae7a9189081b6ade267198873bd65fcb4bd90001'],1,1,2,6427559,1,,,,6078
4c3f701204f92f8753cf65a97fe4804d1f77bc08,0,Impala Public Jenkins,2019-10-09 15:58:04+00:00,['de6e27e6a05c2a533e4794e445f472ac26da8bee'],1,3,4,6427563,1,,,,6078
950973a1680432735319f0992620b6425ba1ec57,0,Impala Public Jenkins,2019-10-09 20:12:39+00:00,['4c3f701204f92f8753cf65a97fe4804d1f77bc08'],4,7,11,6427574,1,,,,6078
0dff5ef3621a0be907c6968096b643a5b2d9f30c,0,Impala Public Jenkins,2019-10-10 04:10:51+00:00,['950973a1680432735319f0992620b6425ba1ec57'],51,177,228,6427802,3,0.152777778,1,1,6078
ba808f67ddb55639d468da1d06bcad0da332b9be,1,Impala Public Jenkins,2019-10-10 06:50:50+00:00,['0dff5ef3621a0be907c6968096b643a5b2d9f30c'],0,424,424,6428226,9,0.192307692,0.192307692,0.846153846,6084
cb2430c24967274819f2739213237789f36ca28a,0,Alex Rodoni,2019-10-10 22:13:42+00:00,['ba808f67ddb55639d468da1d06bcad0da332b9be'],8,55,63,6428289,1,,,,6084
89dc05bb24d069b0816b1015795bd3371cd6979c,0,Impala Public Jenkins,2019-10-11 00:11:09+00:00,['cb2430c24967274819f2739213237789f36ca28a'],4,40,44,6428333,3,0.04,0.32,0.32,6084
f65c2a754fe3011a17aa3bde093c117e57ffedcb,1,Impala Public Jenkins,2019-10-14 15:21:16+00:00,['89dc05bb24d069b0816b1015795bd3371cd6979c'],37,96,133,6428466,3,0.265306122,0.857142857,0.142857143,6084
b0b8f20267f96c902eee5bab85475ee41645bbe3,0,Impala Public Jenkins,2019-10-15 03:52:29+00:00,['f65c2a754fe3011a17aa3bde093c117e57ffedcb'],1,1,2,6428468,1,,,,6084
f41a1887fd85f526d32ef917c3ba94c6902e7e98,0,Csaba Ringhofer,2019-10-15 10:58:33+00:00,['b0b8f20267f96c902eee5bab85475ee41645bbe3'],1,3,4,6428472,1,,,,6084
63a1d210d3476fa6f673c640bb26cd96c835c641,1,Impala Public Jenkins,2019-10-15 11:32:38+00:00,['f41a1887fd85f526d32ef917c3ba94c6902e7e98'],8,108,116,6428588,7,0.057692308,0.461538462,0.076923077,6084
e6409743900d3e86000c495e0481b5f5adb9f5c6,0,Alex Rodoni,2019-10-15 18:22:49+00:00,['63a1d210d3476fa6f673c640bb26cd96c835c641'],75,201,276,6428864,3,,,,6084
3ae5f98420d685365e6fee6880732ee825492fd2,1,Tim Armstrong,2019-10-15 23:34:16+00:00,['e6409743900d3e86000c495e0481b5f5adb9f5c6'],38,45,83,6428947,3,,,,6084
2d74dfd5e2bf4791c116e14911631715c0db3a86,0,Alex Rodoni,2019-10-16 00:00:09+00:00,['3ae5f98420d685365e6fee6880732ee825492fd2'],49,90,139,6429086,4,,,,6085
0cd690dcbc5b90021a14804d7dc1aaeecca77439,0,Impala Public Jenkins,2019-10-16 02:04:12+00:00,['2d74dfd5e2bf4791c116e14911631715c0db3a86'],3,19,22,6429108,2,0,0,1,6085
53774770bcfdc21ca86717653da31d0e0e93419e,0,Joe McDonnell,2019-10-16 03:23:14+00:00,['0cd690dcbc5b90021a14804d7dc1aaeecca77439'],1,23,24,6429132,2,1,1,1,6085
6e32ca3617ba0d207b60850f0b78000f613d5f31,1,Impala Public Jenkins,2019-10-16 11:53:22+00:00,['53774770bcfdc21ca86717653da31d0e0e93419e'],2,42,44,6429176,2,0.64,0,1,6085
241adb116c3ab04917fe4100eff359dec9d395a3,1,Impala Public Jenkins,2019-10-16 17:57:09+00:00,['6e32ca3617ba0d207b60850f0b78000f613d5f31'],8,24,32,6429208,8,0.25,0,1,6085
b0c6740faec6b0a00dcfee126ab39324026c0ca9,1,Tim Armstrong,2019-10-16 20:26:11+00:00,['241adb116c3ab04917fe4100eff359dec9d395a3'],88,416,504,6429712,20,0.038674033,0.696132597,0.806629834,6086
dec917d72a0adaa8909139f0827b95cc1081b74e,0,Impala Public Jenkins,2019-10-17 04:21:19+00:00,['b0c6740faec6b0a00dcfee126ab39324026c0ca9'],9,16,25,6429737,1,0,1,0,6086
b64efa76f7f0f46462400811ed3dcc878fac768d,0,Impala Public Jenkins,2019-10-17 20:11:06+00:00,['dec917d72a0adaa8909139f0827b95cc1081b74e'],2,61,63,6429800,4,0.863636364,0.863636364,1,6086
999becd2522fd9857e49015cf54f01d39ca8123b,0,Zoltan Borok-Nagy,2019-10-18 08:15:00+00:00,['b64efa76f7f0f46462400811ed3dcc878fac768d'],9,19,28,6429828,4,1,0,1,6086
4d65eed6b4be2da59a82cd349af331a28850e2d2,0,Alex Rodoni,2019-10-18 18:09:22+00:00,['999becd2522fd9857e49015cf54f01d39ca8123b'],411,68,479,6430307,2,,,,6086
12007e1ac3ea5c85fc29e51c6a081d90ebd8d225,1,Tim Armstrong,2019-10-18 22:08:46+00:00,['4d65eed6b4be2da59a82cd349af331a28850e2d2'],4,4,8,6430315,1,,,,6086
378a108ecc3c70a73140155324249fa124bf7bdd,1,Tim Armstrong,2019-10-21 20:12:47+00:00,['12007e1ac3ea5c85fc29e51c6a081d90ebd8d225'],449,882,1331,6431646,7,0.0625,0.3125,0.5,6086
3f1d0472243f25eacf611b12a5e1150294683957,0,Impala Public Jenkins,2019-10-21 20:23:56+00:00,['378a108ecc3c70a73140155324249fa124bf7bdd'],92,583,675,6432321,18,0.444444444,0.888888889,0.847222222,6088
87f546d01fec0b077ffd9d7b0b540659cac289ff,0,Alex Rodoni,2019-10-21 21:05:13+00:00,['3f1d0472243f25eacf611b12a5e1150294683957'],196,102,298,6432619,1,,,,6088
00fedc6eaa8bd931c49dd81e485df3b130a585c3,0,Alex Rodoni,2019-10-21 21:50:29+00:00,['87f546d01fec0b077ffd9d7b0b540659cac289ff'],12,12,24,6432643,1,,,,6088
a1c136b3916bb6c09f0b38639137a38fc7a79ddb,0,Alex Rodoni,2019-10-21 22:39:30+00:00,['00fedc6eaa8bd931c49dd81e485df3b130a585c3'],3,3,6,6432649,1,,,,6088
96143cfcf11f2a455a0f2511da67dc2e6b69d7f3,1,Impala Public Jenkins,2019-10-22 00:31:01+00:00,['a1c136b3916bb6c09f0b38639137a38fc7a79ddb'],62,177,239,6432888,16,1,1,0.947368421,6089
9549d3859ed502b109abb916be818e0909e9e207,1,Impala Public Jenkins,2019-10-22 04:21:51+00:00,['96143cfcf11f2a455a0f2511da67dc2e6b69d7f3'],90,132,222,6433110,7,0,0.5,1,6089
e05a5323785ecb09e45bdb5dfc96533e68256175,0,Impala Public Jenkins,2019-10-22 04:31:20+00:00,['9549d3859ed502b109abb916be818e0909e9e207'],40,105,145,6433255,8,0.37037037,0.962962963,1,6089
b02f51458396e5d9fcb1444ae9d33642cbf9580f,1,Impala Public Jenkins,2019-10-24 04:41:58+00:00,['e05a5323785ecb09e45bdb5dfc96533e68256175'],217,380,597,6433852,8,0,0,1,6090
b6b31e4cc415d0ba22d30b17f5dd039ba23700a6,1,Joe McDonnell,2019-10-24 22:10:03+00:00,['b02f51458396e5d9fcb1444ae9d33642cbf9580f'],12,156,168,6434020,9,0.537037037,0.87037037,0.925925926,6091
b496487cb9e8795050fd4f0215361da9849cdb67,0,Tim Armstrong,2019-10-24 23:09:39+00:00,['b6b31e4cc415d0ba22d30b17f5dd039ba23700a6'],24,25,49,6434069,1,,,,6091
e1f9bd6349d0d739a03f217fb968f0bcda905c87,0,Tim Armstrong,2019-10-24 23:49:06+00:00,['b496487cb9e8795050fd4f0215361da9849cdb67'],0,2,2,6434071,1,,,,6091
9e26b7f25abbe147bc19cf94b01607bb37663364,0,Impala Public Jenkins,2019-10-25 01:29:05+00:00,['e1f9bd6349d0d739a03f217fb968f0bcda905c87'],2,13,15,6434086,2,0.142857143,0.571428571,1,6091
8e08a2a889b7212f74045e40e3e175d689bb042d,0,Impala Public Jenkins,2019-10-25 22:44:06+00:00,['9e26b7f25abbe147bc19cf94b01607bb37663364'],2,4,6,6434092,1,1,1,0,6091
9100a98273aa840dc6781c446757b97db50c8b47,1,Impala Public Jenkins,2019-10-25 22:44:39+00:00,['8e08a2a889b7212f74045e40e3e175d689bb042d'],37,140,177,6434269,11,0.933333333,0.977777778,1,6091
0f70ade0d78a9eb3afafdfd1a3e36cc8a5563cb4,1,Joe McDonnell,2019-10-25 23:09:33+00:00,['9100a98273aa840dc6781c446757b97db50c8b47'],27,49,76,6434345,4,0.75,1,0.5,6091
6be37f9f400660e07e799af8a43c6bba21468c87,0,Impala Public Jenkins,2019-10-25 23:49:23+00:00,['0f70ade0d78a9eb3afafdfd1a3e36cc8a5563cb4'],7,11,18,6434363,6,1,1,1,6092
351a92217d8a406f452a844ef9389b7dce1d3448,1,Impala Public Jenkins,2019-10-26 04:38:36+00:00,['6be37f9f400660e07e799af8a43c6bba21468c87'],17,42,59,6434422,3,0.1875,0.9375,0.25,6092
02a4a5f5d8f6ab21842450b1c3bd03c1bf776afc,0,Impala Public Jenkins,2019-10-29 05:25:55+00:00,['351a92217d8a406f452a844ef9389b7dce1d3448'],2,9,11,6434433,1,0,0,0,6092
41426077fb0e4c67c954801220b1a8296de5ff4a,0,Impala Public Jenkins,2019-10-29 23:11:47+00:00,['02a4a5f5d8f6ab21842450b1c3bd03c1bf776afc'],6,35,41,6434474,5,0.5,1,0.857142857,6092
bb1229411c2b19e1258450e6dc2003f9676ee236,0,Impala Public Jenkins,2019-10-30 01:24:54+00:00,['41426077fb0e4c67c954801220b1a8296de5ff4a'],15,61,76,6434550,5,0.194444444,1,0.722222222,6092
5dc5035a794c8a5fbd027b2309e598923f8c60f4,0,Thomas Tauber-Marshall,2019-10-30 01:46:29+00:00,['bb1229411c2b19e1258450e6dc2003f9676ee236'],10,8,18,6434568,3,1,0,0,6092
d08d1956cc65cee2d9d5558eac38b0562e93fcab,0,Impala Public Jenkins,2019-10-31 03:33:43+00:00,['5dc5035a794c8a5fbd027b2309e598923f8c60f4'],24,28,52,6434620,12,,,,6092
b8b39f1d275c36e624b24942916586f199ebb88d,1,Impala Public Jenkins,2019-10-31 05:01:17+00:00,['d08d1956cc65cee2d9d5558eac38b0562e93fcab'],5,7,12,6434632,2,,,,6092
28b1d53f9cb7581974dfc0b2dd75f2f015c1c6b9,1,Tim Armstrong,2019-10-31 17:44:13+00:00,['b8b39f1d275c36e624b24942916586f199ebb88d'],0,22,22,6434654,1,,,,6092
49a31aef0b71e94cbbea412a4071721b3b5f5359,0,Alex Rodoni,2019-10-31 23:02:49+00:00,['28b1d53f9cb7581974dfc0b2dd75f2f015c1c6b9'],27,19,46,6434700,1,,,,6092
770e72d53e11c2902be848a5f2608c4b4c6e19aa,0,Impala Public Jenkins,2019-11-01 05:03:31+00:00,['49a31aef0b71e94cbbea412a4071721b3b5f5359'],3,4,7,6434707,1,,,,6092
eb8f415f7c93eaac9e712ea245ebd1a8f6338c01,0,Impala Public Jenkins,2019-11-01 21:12:10+00:00,['770e72d53e11c2902be848a5f2608c4b4c6e19aa'],8,15,23,6434730,1,0,0,1,6092
b28d56f5b42acef8f95890d647700ef9b8c7ea66,1,Impala Public Jenkins,2019-11-01 21:51:53+00:00,['eb8f415f7c93eaac9e712ea245ebd1a8f6338c01'],1,14,15,6434745,1,0,1,1,6092
476e1b12e79c83674ec5cd0983e30e9d47c65e8f,1,Joe McDonnell,2019-11-02 00:33:42+00:00,['b28d56f5b42acef8f95890d647700ef9b8c7ea66'],10,227,237,6434982,8,0.1,0.97,1,6092
72efec9bc65897f0497e123c657a3550e1145296,0,Impala Public Jenkins,2019-11-02 01:08:30+00:00,['476e1b12e79c83674ec5cd0983e30e9d47c65e8f'],1,1,2,6434984,1,,,,6092
ad43c873fa5d823a56ba93315a8e76e7cd6a0685,1,Impala Public Jenkins,2019-11-05 03:56:20+00:00,['72efec9bc65897f0497e123c657a3550e1145296'],667,769,1436,6436420,9,0,0,0,6092
4bffd12b20aa6ddce136f34ad423eb5dd9e4d05f,0,Impala Public Jenkins,2019-11-06 00:01:33+00:00,['ad43c873fa5d823a56ba93315a8e76e7cd6a0685'],0,18,18,6436438,2,0,0.625,1,6092
e8fda1f224d3ad237183a53e238eee90188d82e2,0,Impala Public Jenkins,2019-11-06 05:44:01+00:00,['4bffd12b20aa6ddce136f34ad423eb5dd9e4d05f'],5,8,13,6436451,5,,,,6092
8b8a49e617818e9bcf99b784b63587c95cebd622,1,Impala Public Jenkins,2019-11-06 05:49:31+00:00,['e8fda1f224d3ad237183a53e238eee90188d82e2'],3,35,38,6436489,3,0.9,0.9,0.5,6092
f49f8d8a32d12128eafb4c76632ca2908d22fa28,0,Impala Public Jenkins,2019-11-06 22:14:04+00:00,['8b8a49e617818e9bcf99b784b63587c95cebd622'],2,20,22,6436511,2,0,0.916666667,1,6092
050dcf912e31924c1ebe122ab19b51e9e0af7bf7,0,Gabor Kaszab,2019-11-07 14:30:47+00:00,['f49f8d8a32d12128eafb4c76632ca2908d22fa28'],3,12,15,6436526,3,,,,6092
7ccfc43d963e4c36d065f1d912b52cf983e0595d,1,Impala Public Jenkins,2019-11-07 15:40:05+00:00,['050dcf912e31924c1ebe122ab19b51e9e0af7bf7'],98,370,468,6436994,7,0.525139665,1,0.296089385,6092
443ca2e8b7f77f70011e351a87207037871b9a74,1,Gabor Kaszab,2019-11-07 16:03:30+00:00,['7ccfc43d963e4c36d065f1d912b52cf983e0595d'],48,699,747,6437741,9,0.02690583,0.686098655,0.80941704,6092
ef51104f7f2181dba4bb73fb5d7ae8611fa76ee9,0,Impala Public Jenkins,2019-11-07 23:17:22+00:00,['443ca2e8b7f77f70011e351a87207037871b9a74'],1,10,11,6437752,1,1,1,0.714285714,6092
a0ebeef63bb6903a5e318c2d13497c43ce3a7ee1,0,Impala Public Jenkins,2019-11-07 23:56:06+00:00,['ef51104f7f2181dba4bb73fb5d7ae8611fa76ee9'],2,54,56,6437808,4,0,1,1,6092
f9cf70d0352196e7b1b8465d6507ae4b16a3e82c,1,Impala Public Jenkins,2019-11-08 02:22:59+00:00,['a0ebeef63bb6903a5e318c2d13497c43ce3a7ee1'],3,108,111,6437919,3,0.567567568,0.756756757,1,6093
52c774d2ae9bb9d37a10f51fe5721d11a3ec7416,1,Impala Public Jenkins,2019-11-08 18:37:33+00:00,['f9cf70d0352196e7b1b8465d6507ae4b16a3e82c'],42,245,287,6438206,12,0.276119403,0.985074627,0.111940299,6093
03a2ffc14512f39280e04a290c328165ac11a387,0,Impala Public Jenkins,2019-11-08 22:23:23+00:00,['52c774d2ae9bb9d37a10f51fe5721d11a3ec7416'],14,307,321,6438527,10,0.285714286,0.108571429,0.84,6093
0a082174c5717018971a9b2462306ca26494d6d0,1,Impala Public Jenkins,2019-11-08 22:35:19+00:00,['03a2ffc14512f39280e04a290c328165ac11a387'],115,383,498,6439025,19,0.511811024,0.881889764,0.88976378,6094
ec11c18884988e838a8838e1e8ecc37461e1a138,1,Impala Public Jenkins,2019-11-09 01:54:51+00:00,['0a082174c5717018971a9b2462306ca26494d6d0'],753,1090,1843,6440868,39,0,0,0,6094
a4743fd9bb9158ac5c4de55f77276f39b4570346,0,Impala Public Jenkins,2019-11-12 22:18:39+00:00,['ec11c18884988e838a8838e1e8ecc37461e1a138'],2,13,15,6440883,2,0.5,1,1,6094
d06943c27563cf69ce3a5f739b5f71aba0989ddc,1,Impala Public Jenkins,2019-11-12 23:36:32+00:00,['a4743fd9bb9158ac5c4de55f77276f39b4570346'],4,87,91,6440974,4,0.170212766,0,0.638297872,6094
e0a98df3fabb84cae8c355d046c1aaa14e5bab25,1,Impala Public Jenkins,2019-11-13 11:04:13+00:00,['d06943c27563cf69ce3a5f739b5f71aba0989ddc'],59,749,808,6441782,18,0.39481268,0.435158501,0.864553314,6094
186bc64652dc386417716ae0c3b47c8bf078141c,0,Alex Rodoni,2019-11-13 18:20:20+00:00,['e0a98df3fabb84cae8c355d046c1aaa14e5bab25'],11,0,11,6441793,1,,,,6094
4c5015d5a2d7ebbb85afae35d0ca94f4961af32d,0,Alex Rodoni,2019-11-13 19:00:47+00:00,['186bc64652dc386417716ae0c3b47c8bf078141c'],85,156,241,6442034,5,,,,6095
f8c8fa5b454b7c56c8383dd103a6f6b87d231327,0,Joe McDonnell,2019-11-13 19:23:33+00:00,['4c5015d5a2d7ebbb85afae35d0ca94f4961af32d'],2,9,11,6442045,2,,,,6095
cf224f8461553e41a095404235eb8f58f795eedd,1,Tim Armstrong,2019-11-14 20:24:58+00:00,['f8c8fa5b454b7c56c8383dd103a6f6b87d231327'],10,43,53,6442098,6,0.076923077,0.846153846,0.461538462,6095
96394b4e3f653139d0a9a36e34122528fae6dcde,1,Csaba Ringhofer,2019-11-15 14:40:53+00:00,['cf224f8461553e41a095404235eb8f58f795eedd'],11,14,25,6442123,3,0,1,1,6095
4cce896b8fd8cd45f4b69e4ebcd540899b072f3b,0,Tim Armstrong,2019-11-15 20:21:04+00:00,['96394b4e3f653139d0a9a36e34122528fae6dcde'],52,87,139,6442262,5,1,1,1,6095
2c2df0bcf0fbc77ba1244b6700deebb834355086,0,Impala Public Jenkins,2019-11-16 05:39:00+00:00,['4cce896b8fd8cd45f4b69e4ebcd540899b072f3b'],22,26,48,6442310,5,1,1,1,6095
a5676981a67d63b2f0ef92e0ad2aec8fcc9a13a6,0,Impala Public Jenkins,2019-11-17 04:18:57+00:00,['2c2df0bcf0fbc77ba1244b6700deebb834355086'],5,0,5,6442315,1,0,0,0.5,6095
e642a5cd168dbbe6d7e9ca86ae15caeafc003e65,1,Joe McDonnell,2019-11-17 07:05:05+00:00,['a5676981a67d63b2f0ef92e0ad2aec8fcc9a13a6'],4,25,29,6442344,6,0.555555556,1,0.555555556,6095
7b135949d94eb1e530a525e6a0ea264965762dd4,1,Impala Public Jenkins,2019-11-18 23:27:01+00:00,['e642a5cd168dbbe6d7e9ca86ae15caeafc003e65'],1,1,2,6442346,1,,,,6095
d69507086d55a20555d3fa26e00aeec25e4b6ba2,0,Impala Public Jenkins,2019-11-19 02:58:55+00:00,['7b135949d94eb1e530a525e6a0ea264965762dd4'],0,3,3,6442349,1,,,,6095
e4cc2bc5f960e55b45ae014b4443fc15d509c439,0,Impala Public Jenkins,2019-11-19 03:48:20+00:00,['d69507086d55a20555d3fa26e00aeec25e4b6ba2'],1,0,1,6442350,1,,,,6095
6f9a842a5113d76778b40241136dc28e4f27a6c1,0,Sahil Takiar,2019-11-19 20:02:21+00:00,['e4cc2bc5f960e55b45ae014b4443fc15d509c439'],7,9,16,6442366,2,0,1,0,6095
66322f27e36f3c322bfa78726e9742ff110e96fd,0,Impala Public Jenkins,2019-11-19 23:41:38+00:00,['6f9a842a5113d76778b40241136dc28e4f27a6c1'],30,62,92,6442458,1,0.055555556,1,1,6095
89b9c93c7ac5f3eb19977290ba5115547120a0a3,1,Impala Public Jenkins,2019-11-20 00:44:13+00:00,['66322f27e36f3c322bfa78726e9742ff110e96fd'],52,20,72,6442530,6,0,0,0,6095
9d8b846825ae11369923034ce8843cb10459682d,0,Tim Armstrong,2019-11-20 16:43:06+00:00,['89b9c93c7ac5f3eb19977290ba5115547120a0a3'],1,1,2,6442532,1,,,,6095
6b6e15b08ef799bbbb916c553b013dcd88ffb055,0,Impala Public Jenkins,2019-11-20 21:35:08+00:00,['9d8b846825ae11369923034ce8843cb10459682d'],4,8,12,6442544,6,0,0.333333333,1,6095
fc4a91cf8c87966a910106dded7e7eb8d215270a,0,Joe McDonnell,2019-11-20 21:59:26+00:00,['6b6e15b08ef799bbbb916c553b013dcd88ffb055'],71,129,200,6442744,4,,,,6096
a5f28487b407825fdf50a4e860c2b1be36e48bce,0,Impala Public Jenkins,2019-11-20 22:20:41+00:00,['fc4a91cf8c87966a910106dded7e7eb8d215270a'],1,2,3,6442747,1,,,,6096
c1244c2f04e629cc07b0830a597c70317be92768,1,Impala Public Jenkins,2019-11-20 22:31:06+00:00,['a5f28487b407825fdf50a4e860c2b1be36e48bce'],0,34,34,6442781,2,0,1,1,6096
0c0671e04e9a71ebcba0e64d28b15f5c332f35ff,1,Impala Public Jenkins,2019-11-21 22:25:22+00:00,['c1244c2f04e629cc07b0830a597c70317be92768'],48,835,883,6443664,25,0.145054945,0.650549451,0.487912088,6099
6dd2cfa9e0aa709e97e710e8327291021205210e,0,Joe McDonnell,2019-11-21 22:44:34+00:00,['0c0671e04e9a71ebcba0e64d28b15f5c332f35ff'],0,5,5,6443669,1,,,,6099
abdd5ab7de8144b21ca320a9ad20565d543f01e6,0,Impala Public Jenkins,2019-11-21 22:54:04+00:00,['6dd2cfa9e0aa709e97e710e8327291021205210e'],106,166,272,6443941,8,0.583333333,1,1,6100
9c167c09640c1db104d6e68d900422d29c3076e2,0,Joe McDonnell,2019-11-21 23:57:06+00:00,['abdd5ab7de8144b21ca320a9ad20565d543f01e6'],1,1,2,6443943,1,,,,6100
d747cc3646511531d6ae4479ec17012c58a596f4,0,Joe McDonnell,2019-11-22 06:38:37+00:00,['9c167c09640c1db104d6e68d900422d29c3076e2'],9,14,23,6443966,1,1,1,1,6100
65198faa3beeea13aec905f8cda8f644e99af960,0,Impala Public Jenkins,2019-11-22 11:10:06+00:00,['d747cc3646511531d6ae4479ec17012c58a596f4'],34,185,219,6444185,10,0,0.542056075,0.841121495,6100
a862282811e76767c6c5d7874db2a310586f2421,0,Impala Public Jenkins,2019-11-22 21:39:21+00:00,['65198faa3beeea13aec905f8cda8f644e99af960'],38,153,191,6444376,4,0,0,0.170454545,6100
e716e76cccf59c2780571429b1b945d6bbc61b8d,0,Impala Public Jenkins,2019-11-22 23:10:46+00:00,['a862282811e76767c6c5d7874db2a310586f2421'],1090,753,1843,6446219,39,1,1,1,6100
4c09975c14f624028100e9940526a111897846cb,0,Impala Public Jenkins,2019-11-23 02:42:25+00:00,['e716e76cccf59c2780571429b1b945d6bbc61b8d'],3,18,21,6446240,3,,,,6100
db69fe87a8c152709f069fe048fe4b0f595f4864,1,Impala Public Jenkins,2019-11-25 22:52:15+00:00,['4c09975c14f624028100e9940526a111897846cb'],1,14,15,6446255,1,1,1,1,6100
1f792bea4779229acbaaa40d4904df4546658bfb,0,Impala Public Jenkins,2019-11-25 23:57:51+00:00,['db69fe87a8c152709f069fe048fe4b0f595f4864'],1,6,7,6446262,1,0,0,1,6100
cba6e344eef1689fc22d1dd3e2b86dbd66b5797f,0,Alex Rodoni,2019-11-26 00:05:32+00:00,['1f792bea4779229acbaaa40d4904df4546658bfb'],548,358,906,6447168,2,,,,6100
ae2425241d51ac5b9559401faa3c66c694f0fd1c,0,Impala Public Jenkins,2019-11-26 00:16:29+00:00,['cba6e344eef1689fc22d1dd3e2b86dbd66b5797f'],8,82,90,6447258,4,0.3125,0.3125,1,6101
ddd07e17136302aee58c44060c0f93876d00294c,1,Impala Public Jenkins,2019-11-26 02:03:41+00:00,['ae2425241d51ac5b9559401faa3c66c694f0fd1c'],3,5,8,6447266,1,,,,6101
0f2aa509891642e29763aa24e47f07554932c7d2,0,Impala Public Jenkins,2019-11-26 06:47:04+00:00,['ddd07e17136302aee58c44060c0f93876d00294c'],5,131,136,6447402,10,0.52173913,0.565217391,0.347826087,6103
2114fc6155e5bb21e398ded21c5bdfd1e7f49879,0,Impala Public Jenkins,2019-11-26 07:28:23+00:00,['0f2aa509891642e29763aa24e47f07554932c7d2'],41,65,106,6447508,8,0.055555556,0.444444444,0.944444444,6103
8e33b84b049e9d31188792ae18ad43c0e887966b,1,Impala Public Jenkins,2019-11-26 11:31:39+00:00,['2114fc6155e5bb21e398ded21c5bdfd1e7f49879'],209,359,568,6448076,3,0,0.719298246,0,6103
7878203b4a1d0aecde431f1c0d578e6b80d7ead6,0,Alex Rodoni,2019-11-26 19:14:02+00:00,['8e33b84b049e9d31188792ae18ad43c0e887966b'],74,77,151,6448227,1,,,,6103
bf031a2142db67d2c8741059d2a3ee551f02e4a4,0,Impala Public Jenkins,2019-11-26 19:14:24+00:00,['7878203b4a1d0aecde431f1c0d578e6b80d7ead6'],14,100,114,6448341,8,1,1,1,6103
74c7b7e55f1122619c4cc74a96960afa3dc2f4e1,1,Impala Public Jenkins,2019-11-26 22:46:40+00:00,['bf031a2142db67d2c8741059d2a3ee551f02e4a4'],249,535,784,6449125,26,0.637254902,0.911764706,0.68627451,6106
baa35f2ce7fde009464adc5bc0ac7a230249a929,0,Alex Rodoni,2019-11-26 23:00:14+00:00,['74c7b7e55f1122619c4cc74a96960afa3dc2f4e1'],21,25,46,6449171,1,,,,6106
b571aa9b745c4c27542d509b31e6748e10838fca,0,Impala Public Jenkins,2019-11-27 01:47:12+00:00,['baa35f2ce7fde009464adc5bc0ac7a230249a929'],185,190,375,6449546,6,1,1,1,6106
7c4edbc9e79f9cee327cf1dc1b86a0e5c6eda855,0,Alex Rodoni,2019-11-27 20:13:52+00:00,['b571aa9b745c4c27542d509b31e6748e10838fca'],55,67,122,6449668,1,,,,6106
f998427cf0a161c8ae6e57a77e095dada070aa26,1,Impala Public Jenkins,2019-11-27 22:27:58+00:00,['7c4edbc9e79f9cee327cf1dc1b86a0e5c6eda855'],278,239,517,6450185,26,1,1,0,6106
b421741d7f17868958c50b4b19f22d255071472a,1,Impala Public Jenkins,2019-11-28 03:44:52+00:00,['f998427cf0a161c8ae6e57a77e095dada070aa26'],390,552,942,6451127,5,0.641509434,1,0,6106
1dc729f2b27da46671cd33903b2ef52a0ae29ebe,0,Gabor Kaszab,2019-12-03 14:19:10+00:00,['b421741d7f17868958c50b4b19f22d255071472a'],15,142,157,6451284,6,0,0.644444444,0.811111111,6106
a1588e44980c648cb7f9263cbd0409abfbaeacf7,1,Impala Public Jenkins,2019-12-03 23:26:25+00:00,['1dc729f2b27da46671cd33903b2ef52a0ae29ebe'],108,139,247,6451531,13,0,0.526315789,0,6106
69a9ac102dbb193f727e9e0e991e226ceb5f47c9,1,Impala Public Jenkins,2019-12-04 00:40:04+00:00,['a1588e44980c648cb7f9263cbd0409abfbaeacf7'],18,266,284,6451815,8,0.63963964,0.666666667,1,6107
655ce205f1bd000b916c41a32ed4998886b427d8,0,Alex Rodoni,2019-12-04 18:52:13+00:00,['69a9ac102dbb193f727e9e0e991e226ceb5f47c9'],390,365,755,6452570,1,,,,6107
85e138d3f0178a349aab3c11264a3c9b9f029533,0,Impala Public Jenkins,2019-12-04 23:29:43+00:00,['655ce205f1bd000b916c41a32ed4998886b427d8'],15,15,30,6452600,1,1,0,0,6107
f9a52ca0e0cdfd7c23a36273b557c6385827b71b,1,Impala Public Jenkins,2019-12-05 03:26:00+00:00,['85e138d3f0178a349aab3c11264a3c9b9f029533'],11,14,25,6452625,2,0,0,0,6107
30c7a6a18c85574ff76dc750dfef94475f1c9796,0,Impala Public Jenkins,2019-12-05 14:19:41+00:00,['f9a52ca0e0cdfd7c23a36273b557c6385827b71b'],111,1060,1171,6453796,18,0.070261438,0.756535948,0.854575163,6107
92aa2c16f172cf15cf6b026ab7af9c72576772f5,0,Impala Public Jenkins,2019-12-05 17:07:55+00:00,['30c7a6a18c85574ff76dc750dfef94475f1c9796'],4,6,10,6453806,2,0,0,0.5,6107
a0e03071c0902c86f9f76cfafe3205af672b3d4b,0,Impala Public Jenkins,2019-12-05 19:58:01+00:00,['92aa2c16f172cf15cf6b026ab7af9c72576772f5'],2,19,21,6453827,2,0,1,1,6107
17e534e3164a88c4f1da85b39e8245d1ef079bd6,0,Impala Public Jenkins,2019-12-06 01:28:18+00:00,['a0e03071c0902c86f9f76cfafe3205af672b3d4b'],121,183,304,6454131,6,0,0.756097561,1,6107
85c9895c119a0dcc5872dde29d8d8b1c243f7903,0,Impala Public Jenkins,2019-12-06 04:38:09+00:00,['17e534e3164a88c4f1da85b39e8245d1ef079bd6'],3,16,19,6454150,2,,,,6107
f33a9d0d426f2cbaaf225d7ea08b15966e537f31,0,Impala Public Jenkins,2019-12-06 14:16:30+00:00,['85c9895c119a0dcc5872dde29d8d8b1c243f7903'],1,42,43,6454193,6,0,1,0,6109
4093975e2d5da61c1ef6217796a1543a602b1d40,0,Csaba Ringhofer,2019-12-09 11:55:23+00:00,['f33a9d0d426f2cbaaf225d7ea08b15966e537f31'],5,4,9,6454202,1,,,,6109
f608be7d02813d458deee59f9b102c6f29778dbc,0,Alex Rodoni,2019-12-09 19:17:14+00:00,['4093975e2d5da61c1ef6217796a1543a602b1d40'],296,832,1128,6455330,1,,,,6109
306b606f84ceb1b5eaa8e12eb4d636529ab2f2dd,0,Alex Rodoni,2019-12-09 19:19:22+00:00,['f608be7d02813d458deee59f9b102c6f29778dbc'],619,170,789,6456119,3,,,,6109
85425b81f04c856d7d5ec375242303f78ec7964e,0,Impala Public Jenkins,2019-12-09 20:52:19+00:00,['306b606f84ceb1b5eaa8e12eb4d636529ab2f2dd'],62,152,214,6456333,5,1,1,1,6110
df5c4061456abb947cec8add81b361b60c5d3ad8,0,Impala Public Jenkins,2019-12-10 05:48:53+00:00,['85425b81f04c856d7d5ec375242303f78ec7964e'],1,130,131,6456464,2,0,0,1,6110
d72fd9a99927045a5b5ef9f4e617b1b6613e1574,0,Impala Public Jenkins,2019-12-10 21:54:25+00:00,['df5c4061456abb947cec8add81b361b60c5d3ad8'],6,5,11,6456475,1,0,1,0,6110
4687885b808c9856e792f2439435dbcf2bedf7d1,0,Alex Rodoni,2019-12-10 22:17:19+00:00,['d72fd9a99927045a5b5ef9f4e617b1b6613e1574'],348,240,588,6457063,2,,,,6110
c5104d3d5b3478b26ec8ee6468b671ca29fbc3df,0,Alex Rodoni,2019-12-10 22:54:26+00:00,['4687885b808c9856e792f2439435dbcf2bedf7d1'],17,9,26,6457089,1,,,,6110
6bfa86faa06ce053d9c88c2c291af5a3c0e119c3,1,Sahil Takiar,2019-12-11 15:53:44+00:00,['c5104d3d5b3478b26ec8ee6468b671ca29fbc3df'],99,200,299,6457388,8,0.813559322,0.627118644,0.898305085,6110
acddf76bcb3fe8b5f8cc1c60e8d3f15c6e164d5b,0,Alex Rodoni,2019-12-11 20:41:29+00:00,['6bfa86faa06ce053d9c88c2c291af5a3c0e119c3'],15,16,31,6457419,1,,,,6110
c7d2af1bd7320cdbc9b738350cb9a038467dc493,1,Impala Public Jenkins,2019-12-11 22:46:36+00:00,['acddf76bcb3fe8b5f8cc1c60e8d3f15c6e164d5b'],6,17,23,6457442,2,0,1,1,6110
313d758a89f389dc69ef5b8b3e8a07cf27ec2105,1,Impala Public Jenkins,2019-12-12 04:11:04+00:00,['c7d2af1bd7320cdbc9b738350cb9a038467dc493'],55,666,721,6458163,18,0,0.09623431,0.481171548,6111
590da59a3ce3337395487de8d91dceba1786e11b,0,Impala Public Jenkins,2019-12-13 20:02:16+00:00,['313d758a89f389dc69ef5b8b3e8a07cf27ec2105'],147,907,1054,6459217,13,0.177514793,0.767258383,0.779092702,6111
6ebea33a9d249fc0097746c21f04d977fdeaa13c,1,Impala Public Jenkins,2019-12-13 23:02:13+00:00,['590da59a3ce3337395487de8d91dceba1786e11b'],231,714,945,6460162,15,0.103896104,0.813852814,0.476190476,6111
ee9823d0dd96fe3e4705a9c1499834a748d91cf9,0,Alex Rodoni,2019-12-14 02:40:27+00:00,['6ebea33a9d249fc0097746c21f04d977fdeaa13c'],21,16,37,6460199,1,,,,6111
f2f348c0f93208a0f34c33b6a4dc82f4d9d4b290,0,Impala Public Jenkins,2019-12-15 05:04:31+00:00,['ee9823d0dd96fe3e4705a9c1499834a748d91cf9'],278,683,961,6461160,15,0.572413793,1,0.786206897,6112
cd7454be660a8b6895f440c3eab8a707587ad2c5,0,Alex Rodoni,2019-12-16 18:53:40+00:00,['f2f348c0f93208a0f34c33b6a4dc82f4d9d4b290'],7,7,14,6461174,1,,,,6112
6fb0d1eb552abaa060699e31b1eb5c46ca4bf191,0,Impala Public Jenkins,2019-12-17 04:34:46+00:00,['cd7454be660a8b6895f440c3eab8a707587ad2c5'],10,21,31,6461205,1,1,0,1,6112
f1c9f4c093bde9b6b8dc66c20021ab627c1842ae,0,Impala Public Jenkins,2019-12-17 05:41:48+00:00,['6fb0d1eb552abaa060699e31b1eb5c46ca4bf191'],682,1320,2002,6463207,64,0.442687747,1,0.675889328,6112
4c04e6773855d9e2a0093c92f37bb34d59143723,1,Impala Public Jenkins,2019-12-17 07:11:20+00:00,['f1c9f4c093bde9b6b8dc66c20021ab627c1842ae'],19,75,94,6463301,2,0,0,0.263157895,6112
094c23b2a829d0e4d26539aba1039c6274fdbc5d,0,Impala Public Jenkins,2019-12-18 00:41:40+00:00,['4c04e6773855d9e2a0093c92f37bb34d59143723'],1,5,6,6463307,1,,,,6112
32829b9594a90900a27c8117111a1b3499013e37,0,Vihang Karajgaonkar,2019-12-18 18:15:36+00:00,['094c23b2a829d0e4d26539aba1039c6274fdbc5d'],3,9,12,6463319,2,0,0,1,6112
14be8f6a30bc715c2b65978e41fc8087d8d08128,0,Impala Public Jenkins,2019-12-19 04:53:52+00:00,['32829b9594a90900a27c8117111a1b3499013e37'],3,0,3,6463322,1,,,,6112
4d9d6b49566cd99a06cf6bd4f1d202b7cfedead8,0,Impala Public Jenkins,2019-12-19 17:02:40+00:00,['14be8f6a30bc715c2b65978e41fc8087d8d08128'],1,1,2,6463324,1,,,,6112
e081e42f684593f176e1f1989db26598d79aebbe,1,Impala Public Jenkins,2019-12-19 22:35:36+00:00,['4d9d6b49566cd99a06cf6bd4f1d202b7cfedead8'],52,217,269,6463593,9,0.705882353,0.505882353,0.552941176,6112
ed5e7dae948c50cef7311358b1e096a08b8d8d01,1,Impala Public Jenkins,2019-12-20 00:14:00+00:00,['e081e42f684593f176e1f1989db26598d79aebbe'],3,62,65,6463658,2,0.34375,0.96875,1,6112
8a4fececcf8e9599978cc1a532386b8e924838ed,1,Impala Public Jenkins,2019-12-20 02:50:46+00:00,['ed5e7dae948c50cef7311358b1e096a08b8d8d01'],0,230,230,6463888,11,0.336538462,0.567307692,0.971153846,6112
1b4ca58a98a1509e6129132c9645fe059c9079d9,1,Impala Public Jenkins,2019-12-20 11:08:23+00:00,['8a4fececcf8e9599978cc1a532386b8e924838ed'],212,387,599,6464487,12,0.733333333,0.966666667,0.6,6115
112953c63bc3bff014f46042a60804af0f52653d,0,Tim Armstrong,2019-12-22 08:57:32+00:00,['1b4ca58a98a1509e6129132c9645fe059c9079d9'],4,8,12,6464499,1,0.25,1,1,6115
320f05852060c1027326ac20be7df340a7a5263f,1,Tim Armstrong,2019-12-27 07:15:02+00:00,['112953c63bc3bff014f46042a60804af0f52653d'],2,144,146,6464645,3,0.426470588,0.985294118,1,6116
05dfb208ff32d434399cb18219425467b0f9b2a9,1,Impala Public Jenkins,2019-12-27 16:09:11+00:00,['320f05852060c1027326ac20be7df340a7a5263f'],20,144,164,6464809,6,0.169811321,1,0.566037736,6116
fa7d91fd305bac2dc5c4a145528b6cc45f5972fe,0,Joe McDonnell,2019-12-28 02:16:56+00:00,['05dfb208ff32d434399cb18219425467b0f9b2a9'],0,2,2,6464811,1,,,,6116
8afce97c521f16f3775b396077382138a2932768,1,Impala Public Jenkins,2019-12-30 06:31:26+00:00,['fa7d91fd305bac2dc5c4a145528b6cc45f5972fe'],3,3,6,6464817,1,,,,6116
bb5000eec933e966e17a5cde6e1caf91a357bf0d,0,Impala Public Jenkins,2020-01-02 15:49:32+00:00,['8afce97c521f16f3775b396077382138a2932768'],2,2,4,6464821,1,,,,6116
229317af44d11bda20c8fd9de7f91abb3e2920db,1,Impala Public Jenkins,2020-01-03 04:10:05+00:00,['bb5000eec933e966e17a5cde6e1caf91a357bf0d'],22,101,123,6464944,3,0.184210526,0.736842105,0.789473684,6117
497a17dbdc0669abd47c2360b8ca94de8b54d413,0,Joe McDonnell,2020-01-04 01:39:04+00:00,['229317af44d11bda20c8fd9de7f91abb3e2920db'],139,45,184,6465128,4,0.62295082,0,0,6118
597285a1cd9cce00ddac4b461df70f6ef3d8e4d8,0,Impala Public Jenkins,2020-01-07 10:41:07+00:00,['497a17dbdc0669abd47c2360b8ca94de8b54d413'],1,1,2,6465130,1,,,,6118
1bf92120dd4cf7df3fd9764ef9fcb2b061b87644,0,Tim Armstrong,2020-01-09 02:21:21+00:00,['597285a1cd9cce00ddac4b461df70f6ef3d8e4d8'],0,288,288,6465418,4,0.539823009,1,1,6121
6e3d1216f1680e7fca4b5979f182a19673018a2f,0,Impala Public Jenkins,2020-01-09 16:17:58+00:00,['1bf92120dd4cf7df3fd9764ef9fcb2b061b87644'],0,95,95,6465513,3,0.243243243,0.27027027,0.972972973,6122
641e2abf2985972f96a1f27b94758c7bf26e64d5,1,Impala Public Jenkins,2020-01-09 23:02:17+00:00,['6e3d1216f1680e7fca4b5979f182a19673018a2f'],225,475,700,6466213,27,0.97826087,1,0.130434783,6122
8f448cfc6bb3c101ab4737eecd1e84a858744793,1,Impala Public Jenkins,2020-01-10 17:35:31+00:00,['641e2abf2985972f96a1f27b94758c7bf26e64d5'],6,26,32,6466245,4,0.533333333,1,0.466666667,6123
d46f4a68fa86ca59b9066abbfe70a5d3c8d090a3,1,Impala Public Jenkins,2020-01-10 22:45:02+00:00,['8f448cfc6bb3c101ab4737eecd1e84a858744793'],671,1096,1767,6468012,14,0.39047619,1,0.385714286,6126
f437146e33dcf4cc3cf79b71bdea462d1e557bd5,1,Impala Public Jenkins,2020-01-10 22:49:00+00:00,['d46f4a68fa86ca59b9066abbfe70a5d3c8d090a3'],6,53,59,6468071,1,0.296296296,1,0.925925926,6126
64828f8b765ad9a8f2cc0f4aede9a1d4def235d7,0,Sahil Takiar,2020-01-13 20:02:16+00:00,['f437146e33dcf4cc3cf79b71bdea462d1e557bd5'],1,1,2,6468073,1,,,,6126
a36e2c9c5eb313f5fddb08a52382ca3237397706,1,Sahil Takiar,2020-01-13 22:01:25+00:00,['64828f8b765ad9a8f2cc0f4aede9a1d4def235d7'],12,21,33,6468106,2,0,0,1,6126
915e811c2cc95615f2619589d0128e98a188507e,0,Impala Public Jenkins,2020-01-13 23:14:21+00:00,['a36e2c9c5eb313f5fddb08a52382ca3237397706'],3,5,8,6468114,1,0,1,1,6126
c359c557eb299174c43ed0d27ab1c2247fc94f74,0,Impala Public Jenkins,2020-01-13 23:48:19+00:00,['915e811c2cc95615f2619589d0128e98a188507e'],3,1,4,6468118,1,,,,6126
0511b44f9236c655e695185b33f412ec65a80a07,1,Impala Public Jenkins,2020-01-14 17:15:17+00:00,['c359c557eb299174c43ed0d27ab1c2247fc94f74'],81,495,576,6468694,15,0.47133758,1,0.974522293,6129
d836246ab53e643407224d2340e30ef017d6b058,1,Impala Public Jenkins,2020-01-14 19:15:20+00:00,['0511b44f9236c655e695185b33f412ec65a80a07'],24,40,64,6468758,6,0,1,1,6130
482c769b0965ea25a404b9ed836890c9d66c5d94,0,Impala Public Jenkins,2020-01-14 19:50:38+00:00,['d836246ab53e643407224d2340e30ef017d6b058'],3,17,20,6468778,1,,,,6130
47053ccbc40e83eefc2f8e2b9ec59edc26d77e44,1,Impala Public Jenkins,2020-01-15 02:40:37+00:00,['482c769b0965ea25a404b9ed836890c9d66c5d94'],19,28,47,6468825,4,0,0,0,6130
d66610837e53965cb969b78116aec58164bb8548,1,Impala Public Jenkins,2020-01-15 05:59:11+00:00,['47053ccbc40e83eefc2f8e2b9ec59edc26d77e44'],188,968,1156,6469981,26,0.458937198,0.54589372,0.183574879,6132
09363842712f8429899776a0f1c56b2eba6d7073,0,Impala Public Jenkins,2020-01-17 15:34:34+00:00,['d66610837e53965cb969b78116aec58164bb8548'],0,1590,1590,6471571,7,0.546536797,0.916666667,0.431818182,6134
63f52518ab331ad6ef31875c1cc6e16072ef8b70,1,Impala Public Jenkins,2020-01-17 18:54:33+00:00,['09363842712f8429899776a0f1c56b2eba6d7073'],29,170,199,6471770,16,0.678571429,0.892857143,0.125,6138
dbc69e9caeca49817937ae0c8d9e45e39f293c30,0,Impala Public Jenkins,2020-01-17 20:56:57+00:00,['63f52518ab331ad6ef31875c1cc6e16072ef8b70'],0,3,3,6471773,1,,,,6138
df13de70fe5a286d7d3596bf2f1ecd71945e8f27,0,Impala Public Jenkins,2020-01-17 22:17:40+00:00,['dbc69e9caeca49817937ae0c8d9e45e39f293c30'],71,136,207,6471980,8,0,0.941176471,0.941176471,6138
7f7743dcc67f112e684737acb5441c544f2c94b1,0,Impala Public Jenkins,2020-01-18 02:05:45+00:00,['df13de70fe5a286d7d3596bf2f1ecd71945e8f27'],14,25,39,6472019,5,0.285714286,0.285714286,1,6138
023e92f5e7b9f9a722db34bc738607aeae10a07a,0,Impala Public Jenkins,2020-01-18 02:05:54+00:00,['7f7743dcc67f112e684737acb5441c544f2c94b1'],1,13,14,6472033,2,1,1,0.625,6138
cfe60858da110cf1256bd3aa5d4f8d374578a33d,0,Impala Public Jenkins,2020-01-18 03:36:37+00:00,['023e92f5e7b9f9a722db34bc738607aeae10a07a'],67,375,442,6472475,14,0.273743017,0.938547486,0.983240223,6138
195bd7635f326061e999fe2a5e4a20ce6a4a9874,1,Impala Public Jenkins,2020-01-20 23:08:32+00:00,['cfe60858da110cf1256bd3aa5d4f8d374578a33d'],28,98,126,6472601,8,0.029411765,0.794117647,0.823529412,6138
702e6c4fa8b7a71ea7f8444245466fd117bf98b1,1,Tim Armstrong,2020-01-21 00:49:05+00:00,['195bd7635f326061e999fe2a5e4a20ce6a4a9874'],753,1090,1843,6474444,39,0,0,0,6138
79aae231443a305ce8503dbc7b4335e8ae3f3946,1,Tim Armstrong,2020-01-21 00:49:05+00:00,['702e6c4fa8b7a71ea7f8444245466fd117bf98b1'],76,151,227,6474671,5,0.465116279,1,0.069767442,6138
0ae77f4cdc77be9424e9c129a1658fc91f64c4a6,0,Impala Public Jenkins,2020-01-22 06:14:32+00:00,['79aae231443a305ce8503dbc7b4335e8ae3f3946'],0,21,21,6474692,2,1,1,1,6138
2c429d6d537931953edb72bc6a6845d4fbae8dd0,1,Impala Public Jenkins,2020-01-22 09:56:53+00:00,['0ae77f4cdc77be9424e9c129a1658fc91f64c4a6'],7,8,15,6474707,2,0,1,1,6138
aa4c115e584cf3a2946323119fae4d9add31fd1f,0,Tim Armstrong,2020-01-22 17:18:06+00:00,['2c429d6d537931953edb72bc6a6845d4fbae8dd0'],2,5,7,6474714,1,,,,6138
6a23ec698560cfc95660c0764000b6045288ee4c,1,Impala Public Jenkins,2020-01-23 01:48:13+00:00,['aa4c115e584cf3a2946323119fae4d9add31fd1f'],15,93,108,6474822,9,0,1,1,6141
3d10e8abbe9bc309c1436af1a6fa049589760a0e,0,Impala Public Jenkins,2020-01-23 07:19:32+00:00,['6a23ec698560cfc95660c0764000b6045288ee4c'],0,5,5,6474827,2,,,,6141
0163a10332cc534f3a355a662a50de2d50b01c82,1,Joe McDonnell,2020-01-24 17:29:15+00:00,['3d10e8abbe9bc309c1436af1a6fa049589760a0e'],43,99,142,6474969,17,0.222222222,0,0.5,6142
6ac51522d8505416e8ef7ae2d911741fd1c4a3e5,0,Impala Public Jenkins,2020-01-27 17:33:57+00:00,['0163a10332cc534f3a355a662a50de2d50b01c82'],25,41,66,6475035,2,1,1,1,6142
641c406938c0e17c0b85fb2a5e30739a5439df1d,0,Impala Public Jenkins,2020-01-27 20:57:36+00:00,['6ac51522d8505416e8ef7ae2d911741fd1c4a3e5'],1,1,2,6475037,1,,,,6142
567b3cd04c7ecd43282127c47b21f177ecb9a2b5,0,Tim Armstrong,2020-01-27 21:48:23+00:00,['641c406938c0e17c0b85fb2a5e30739a5439df1d'],13,31,44,6475081,7,1,1,1,6142
4fa6b5260d9e28dee63a87de3bea1434706a9d05,0,Joe McDonnell,2020-01-28 00:48:08+00:00,['567b3cd04c7ecd43282127c47b21f177ecb9a2b5'],385,0,385,6475466,4,0.233128834,0,0.067484663,6142
7a9547262ab0dee9b9d3a2662bcc2fff782e5dcd,0,Impala Public Jenkins,2020-01-28 04:30:22+00:00,['4fa6b5260d9e28dee63a87de3bea1434706a9d05'],28,132,160,6475626,6,0,0,0.4,6142
8e7fd6fe7ed79ba18a864c69753e2a5812f50034,0,Impala Public Jenkins,2020-01-28 06:42:17+00:00,['7a9547262ab0dee9b9d3a2662bcc2fff782e5dcd'],0,6,6,6475632,1,0,0,1,6142
f38da0df8e7d594d1260ea05705f19adbd839db1,1,Impala Public Jenkins,2020-01-29 00:58:24+00:00,['8e7fd6fe7ed79ba18a864c69753e2a5812f50034'],652,1612,2264,6477896,44,0.327586207,0.42816092,0.755747126,6143
55efe5cacab4b1e10cebd4519aadf406120f5949,0,Impala Public Jenkins,2020-01-30 00:45:22+00:00,['f38da0df8e7d594d1260ea05705f19adbd839db1'],1,2,3,6477899,1,,,,6143
135fa1613dac4999fec666d428e8fbe9ad1dfc60,1,Impala Public Jenkins,2020-01-30 19:13:19+00:00,['55efe5cacab4b1e10cebd4519aadf406120f5949'],103,90,193,6478092,7,1,0,0,6143
ba00551581b9ba87fc478eaa16ecaab043d378f5,1,Impala Public Jenkins,2020-01-31 03:06:24+00:00,['135fa1613dac4999fec666d428e8fbe9ad1dfc60'],224,448,672,6478764,15,0.213592233,0.834951456,0.572815534,6143
b12f0506080971f1e44bb732116fb3197862e378,0,Impala Public Jenkins,2020-01-31 09:24:39+00:00,['ba00551581b9ba87fc478eaa16ecaab043d378f5'],54,80,134,6478898,5,0.727272727,0.818181818,0,6143
e083ec0d412ff196465823094a5cab04e87870a8,1,Impala Public Jenkins,2020-01-31 15:09:58+00:00,['b12f0506080971f1e44bb732116fb3197862e378'],6,166,172,6479070,10,0.008264463,1,0.917355372,6143
443da2172cc10b8b732606d1d4465d4386022f19,0,Impala Public Jenkins,2020-01-31 18:39:02+00:00,['e083ec0d412ff196465823094a5cab04e87870a8'],32,81,113,6479183,3,0,0.952380952,0,6143
7b280e5841bf247b3866c16ea26f04c9e2dd3a61,0,Impala Public Jenkins,2020-02-01 02:25:13+00:00,['443da2172cc10b8b732606d1d4465d4386022f19'],0,22,22,6479205,3,0,0,0.5,6143
4024d827a3e901fa22f340118e248e9cf192fe39,0,Thomas Tauber-Marshall,2020-02-03 18:34:51+00:00,['7b280e5841bf247b3866c16ea26f04c9e2dd3a61'],6,33,39,6479244,1,,,,6143
66e6879e8ccf18f9af82a49ff28cd95fe9fcf390,0,Impala Public Jenkins,2020-02-04 00:55:54+00:00,['4024d827a3e901fa22f340118e248e9cf192fe39'],4,19,23,6479267,4,0,1,1,6144
fe001a7ded5d4c3da6b698722b26085f83dfca4e,1,Thomas Tauber-Marshall,2020-02-04 23:03:58+00:00,['66e6879e8ccf18f9af82a49ff28cd95fe9fcf390'],2896,12395,15291,6494558,221,0.366340841,0.851466213,0.840203995,6176
19a4d8fe794c9b17e69d6c65473f9a68084916bb,0,Thomas Tauber-Marshall,2020-02-04 23:03:58+00:00,['fe001a7ded5d4c3da6b698722b26085f83dfca4e'],86,177,263,6494821,17,1,0,0,6177
a17bea916f289599360796c45e8267a6338af6f8,1,Impala Public Jenkins,2020-02-05 04:18:28+00:00,['19a4d8fe794c9b17e69d6c65473f9a68084916bb'],24,538,562,6495383,16,0.125,0.089285714,0.705357143,6177
3b8609f400f9341139a592add135f3faf4a169ab,0,Impala Public Jenkins,2020-02-05 06:23:44+00:00,['a17bea916f289599360796c45e8267a6338af6f8'],6,4,10,6495393,2,0,0,0,6177
ec3a3ff5b3130a2ec1e5eac9998333112db1363f,0,Impala Public Jenkins,2020-02-05 14:56:23+00:00,['3b8609f400f9341139a592add135f3faf4a169ab'],0,4,4,6495397,1,1,1,1,6177
d3e90af1dbba3175e31956224f89f9a33e1916cb,0,Impala Public Jenkins,2020-02-05 16:29:51+00:00,['ec3a3ff5b3130a2ec1e5eac9998333112db1363f'],1,10,11,6495408,2,0,0.6,0.6,6177
9800f95c7efea0c613d02a4603c60696f3d3bf00,0,Impala Public Jenkins,2020-02-05 20:54:38+00:00,['d3e90af1dbba3175e31956224f89f9a33e1916cb'],12,41,53,6495461,2,0.692307692,0.692307692,1,6177
5b233150d21734e0d6f612c749b9a2f3220ed5c5,0,Impala Public Jenkins,2020-02-05 22:00:48+00:00,['9800f95c7efea0c613d02a4603c60696f3d3bf00'],1,8,9,6495470,2,,,,6177
41bf93decea02ee0fe5429ee8a12c4aa1c59a60a,0,Quanlong Huang,2020-02-06 06:28:59+00:00,['5b233150d21734e0d6f612c749b9a2f3220ed5c5'],0,81,81,6495551,1,,,,6177
f340adb3bf8dd0d1629f782b5a99f325315c686d,0,Impala Public Jenkins,2020-02-07 03:17:32+00:00,['41bf93decea02ee0fe5429ee8a12c4aa1c59a60a'],0,9,9,6495560,1,,,,6177
c07f54b3c45c0b1ae18c458d744d154db89f5e3c,0,Impala Public Jenkins,2020-02-07 21:37:20+00:00,['f340adb3bf8dd0d1629f782b5a99f325315c686d'],71,236,307,6495867,2,0.314285714,1,0.40952381,6177
d971b19dee289d8fe54eebf484cb14ee6d56f60e,0,Impala Public Jenkins,2020-02-08 02:39:43+00:00,['c07f54b3c45c0b1ae18c458d744d154db89f5e3c'],2,16,18,6495885,1,1,0,1,6177
6f150d383c64d9adb8e11c73c5bb18d3f5b6ff97,0,Impala Public Jenkins,2020-02-08 05:16:12+00:00,['d971b19dee289d8fe54eebf484cb14ee6d56f60e'],301,188,489,6496374,16,1,0,0,6179
014f973e927a74b4d6020f756fe548e6a7b84ff5,0,Impala Public Jenkins,2020-02-08 05:22:48+00:00,['6f150d383c64d9adb8e11c73c5bb18d3f5b6ff97'],28,208,236,6496610,13,0,0,0.59375,6181
ebc2c366f5780a89f09eb2014ca94f9d970f50b4,0,Impala Public Jenkins,2020-02-09 23:18:20+00:00,['014f973e927a74b4d6020f756fe548e6a7b84ff5'],8,121,129,6496739,4,0,0.08,0.36,6181
ca6c8d43d78de3c4fa5e4606882b0865e2bce5b4,1,Impala Public Jenkins,2020-02-10 20:49:15+00:00,['ebc2c366f5780a89f09eb2014ca94f9d970f50b4'],122,241,363,6497102,29,0,0.555555556,0.888888889,6182
c8f1034f30671d997f770a8f7f037deac186ae8c,0,Impala Public Jenkins,2020-02-11 00:52:37+00:00,['ca6c8d43d78de3c4fa5e4606882b0865e2bce5b4'],1,5,6,6497108,1,0,0,1,6182
ea0e1def6160d596082b01365fcbbb6e24afb21d,0,Impala Public Jenkins,2020-02-11 15:08:39+00:00,['c8f1034f30671d997f770a8f7f037deac186ae8c'],41,626,667,6497775,44,0.258064516,0.887096774,0.903225806,6206
14ae6eae1e3e0ff78040ae2bad92d36d745cf365,1,Impala Public Jenkins,2020-02-12 13:27:18+00:00,['ea0e1def6160d596082b01365fcbbb6e24afb21d'],25,42,67,6497842,3,,,,6206
e7d10df2ecaf14f244eb32224e2c8099f2f0d8cf,1,Impala Public Jenkins,2020-02-12 15:02:26+00:00,['14ae6eae1e3e0ff78040ae2bad92d36d745cf365'],9,513,522,6498364,5,0.739285714,0.9,0.621428571,6208
aca2215c358cbbdc5d460200bc4f78c793d56ffc,0,Impala Public Jenkins,2020-02-12 21:54:41+00:00,['e7d10df2ecaf14f244eb32224e2c8099f2f0d8cf'],2,2,4,6498368,1,,,,6208
55612f99910414b01627c537203737d8f24971bf,0,Impala Public Jenkins,2020-02-12 22:54:14+00:00,['aca2215c358cbbdc5d460200bc4f78c793d56ffc'],4,36,40,6498408,4,,,,6208
8ddbc1807a641587a05c2f5327c498f92acb935c,0,Impala Public Jenkins,2020-02-13 03:10:49+00:00,['55612f99910414b01627c537203737d8f24971bf'],16,41,57,6498465,2,0,1,1,6208
d96dab20dd663dfdcdcd2771d2f210cb02ecd710,0,Impala Public Jenkins,2020-02-13 21:43:07+00:00,['8ddbc1807a641587a05c2f5327c498f92acb935c'],30,77,107,6498572,6,0.029411765,0.058823529,0.647058824,6208
cad156181b29b7897fb2366bd621f2349c090e20,1,Impala Public Jenkins,2020-02-14 04:26:16+00:00,['d96dab20dd663dfdcdcd2771d2f210cb02ecd710'],5,93,98,6498670,7,1,1,1,6209
f48474f3f65b1f6a9ea14b560612a65b3fa3ff33,0,Vihang Karajgaonkar,2020-02-14 17:57:03+00:00,['cad156181b29b7897fb2366bd621f2349c090e20'],14,74,88,6498758,1,,,,6209
4f0f8701a1ac25ce4ab9df1edffab62adb07d945,0,Impala Public Jenkins,2020-02-15 03:41:10+00:00,['f48474f3f65b1f6a9ea14b560612a65b3fa3ff33'],36,4,40,6498798,4,,,,6209
d75562a7e331b7e5b2509bdc3652c557a24a04d0,0,Impala Public Jenkins,2020-02-15 12:50:43+00:00,['4f0f8701a1ac25ce4ab9df1edffab62adb07d945'],354,405,759,6499557,24,0,1,1,6211
ba903deba7e529df6d3136589086105a99c878c1,0,Impala Public Jenkins,2020-02-17 19:18:08+00:00,['d75562a7e331b7e5b2509bdc3652c557a24a04d0'],0,3,3,6499560,1,,,,6211
796f5cc43d545a645f9eed3d13934375f31a3ce8,0,Impala Public Jenkins,2020-02-17 21:20:26+00:00,['ba903deba7e529df6d3136589086105a99c878c1'],3,18,21,6499581,2,,,,6211
f216e68089e49af970674600fc1ff05b759d641b,0,Impala Public Jenkins,2020-02-19 02:43:52+00:00,['796f5cc43d545a645f9eed3d13934375f31a3ce8'],9,65,74,6499655,3,0,1,1,6211
04fd9ae268d89b07e2a692a916bf2ddcfb2e351b,1,Impala Public Jenkins,2020-02-19 05:57:11+00:00,['f216e68089e49af970674600fc1ff05b759d641b'],729,697,1426,6501081,169,,,,6214
f403a96700e47df184ff782378342569be8f1c58,1,Impala Public Jenkins,2020-02-19 06:38:45+00:00,['04fd9ae268d89b07e2a692a916bf2ddcfb2e351b'],37,39,76,6501157,5,1,0,0,6214
a69b19a59ba6802583e9c01e7d3dae0561e9b5d8,0,Tim Armstrong,2020-02-19 23:36:29+00:00,['f403a96700e47df184ff782378342569be8f1c58'],4,5,9,6501166,3,0,0,1,6214
88b6dd6a712cde32465308291af6341ce31676de,1,Tim Armstrong,2020-02-19 23:36:29+00:00,['a69b19a59ba6802583e9c01e7d3dae0561e9b5d8'],4,10,14,6501180,1,,,,6214
0bb056e525794fca41cd333bc2896098566945bb,1,Impala Public Jenkins,2020-02-20 01:51:54+00:00,['88b6dd6a712cde32465308291af6341ce31676de'],1031,2159,3190,6504370,65,0.350262697,0.691768827,0.607705779,6216
556e63f72d6412263e0fa2cef722bf2dbe3f3ca5,1,Laszlo Gaal,2020-02-20 22:16:35+00:00,['0bb056e525794fca41cd333bc2896098566945bb'],3,3,6,6504376,2,,,,6216
fa383b007154df7885784102af0ad801cb69406f,0,Impala Public Jenkins,2020-02-20 23:34:14+00:00,['556e63f72d6412263e0fa2cef722bf2dbe3f3ca5'],1,1,2,6504378,1,,,,6216
e04a839d9c000c9652519d5e76bbe280ceb1114d,0,Impala Public Jenkins,2020-02-20 23:37:47+00:00,['fa383b007154df7885784102af0ad801cb69406f'],23,29,52,6504430,3,0.666666667,1,0.666666667,6216
eead1873dddd2ba2b2d97aeb80482835e3e1c7eb,1,Joe McDonnell,2020-02-20 23:53:34+00:00,['e04a839d9c000c9652519d5e76bbe280ceb1114d'],0,2595,2595,6507025,8,0.545905707,0.806451613,0.867659222,6223
091faebe61645c9f86f59bc67668688f15a2fc7c,0,Joe McDonnell,2020-02-20 23:53:34+00:00,['eead1873dddd2ba2b2d97aeb80482835e3e1c7eb'],952,71,1023,6508048,12,0.46637744,0.242950108,0.180043384,6223
e36cb92e2ca0085d77bafafd2ab3ce941ebf3541,0,Impala Public Jenkins,2020-02-21 04:09:19+00:00,['091faebe61645c9f86f59bc67668688f15a2fc7c'],64,192,256,6508304,4,0.818181818,1,0.409090909,6224
9d19cf6f753821188c06a0c00b36be1ee25338bf,0,Impala Public Jenkins,2020-02-21 18:30:19+00:00,['e36cb92e2ca0085d77bafafd2ab3ce941ebf3541'],367,330,697,6509001,133,0,0.333333333,0,6224
a4ccda14e989797c443ec2ddb38b3a8488d23d6c,0,Impala Public Jenkins,2020-02-21 19:01:19+00:00,['9d19cf6f753821188c06a0c00b36be1ee25338bf'],1,1,2,6509003,1,,,,6224
fa2fabfc025b87add7fac64e52593b36a14acd4b,0,Impala Public Jenkins,2020-02-21 20:55:01+00:00,['a4ccda14e989797c443ec2ddb38b3a8488d23d6c'],13,19,32,6509035,2,,,,6224
2c54dbe22507661664b39cb76849f794cf4743d6,1,Impala Public Jenkins,2020-02-22 02:02:56+00:00,['fa2fabfc025b87add7fac64e52593b36a14acd4b'],209,288,497,6509532,27,0,0,0,6225
0282c024b45c627695c217d2a714ee9c752fd7c1,1,Impala Public Jenkins,2020-02-24 15:18:16+00:00,['2c54dbe22507661664b39cb76849f794cf4743d6'],0,39,39,6509571,2,0,0.884615385,0.884615385,6225
90ab610d3432a93248486ee38e10f58ec47908e6,0,Joe McDonnell,2020-02-24 21:22:18+00:00,['0282c024b45c627695c217d2a714ee9c752fd7c1'],115,102,217,6509788,4,,,,6225
571131fdc11acecf4c2003668dbccde0667efe07,1,Impala Public Jenkins,2020-02-25 00:31:34+00:00,['90ab610d3432a93248486ee38e10f58ec47908e6'],9,10000275,10000284,16510072,11,0.274509804,0.732026144,0.418300654,6228
777d0d203f138183d65885b523b619421b487714,0,Impala Public Jenkins,2020-02-25 00:39:36+00:00,['571131fdc11acecf4c2003668dbccde0667efe07'],15,94,109,16510181,5,0.260869565,0.934782609,1,6228
1e616774d4d3a00e002d1e383ccd89c46f6d9010,1,Impala Public Jenkins,2020-02-25 01:22:34+00:00,['777d0d203f138183d65885b523b619421b487714'],255,426,681,16510862,11,0.5,0.638297872,1,6228
f22812144279a3f722fcace5925cfb2f52efb598,1,Impala Public Jenkins,2020-02-25 13:27:20+00:00,['1e616774d4d3a00e002d1e383ccd89c46f6d9010'],2,2,4,16510866,1,,,,6228
1bd45d295ebfc3f526a98eebb9b61525b9332c91,0,Impala Public Jenkins,2020-02-25 20:46:49+00:00,['f22812144279a3f722fcace5925cfb2f52efb598'],148,159,307,16511173,8,0,1,1,6228
1fde39db7ddc5528f032eadbcbb3f2cb255970f9,0,Impala Public Jenkins,2020-02-25 22:51:05+00:00,['1bd45d295ebfc3f526a98eebb9b61525b9332c91'],36,75,111,16511284,4,1,1,1,6228
ad3177035103dfcb1625b32f04f22ea87456eb6c,0,Impala Public Jenkins,2020-02-26 04:15:04+00:00,['1fde39db7ddc5528f032eadbcbb3f2cb255970f9'],226,257,483,16511767,16,0.066666667,0,0.733333333,6228
322483987600fb3cf84da21a47cadccb6989820b,0,Impala Public Jenkins,2020-02-26 11:06:12+00:00,['ad3177035103dfcb1625b32f04f22ea87456eb6c'],9,9,18,16511785,1,,,,6228
ded55d696acaaf2b87227f7f23b7fb799a80e872,0,Tim Armstrong,2020-02-26 21:36:22+00:00,['322483987600fb3cf84da21a47cadccb6989820b'],0,3,3,16511788,1,,,,6228
49774fd2e14343dbb5f32c71655f91dae6e6daac,0,Impala Public Jenkins,2020-02-26 23:44:00+00:00,['ded55d696acaaf2b87227f7f23b7fb799a80e872'],6,18,24,16511812,2,0,0,0,6228
7479be4e18a1821768cd8a921e72405c830eca9c,0,Joe McDonnell,2020-02-27 17:29:51+00:00,['49774fd2e14343dbb5f32c71655f91dae6e6daac'],286,426,712,16512524,3,1,0.962962963,0.444444444,6229
df875dc05ba5023d01ddb94154638c33cc16a79d,0,Impala Public Jenkins,2020-02-28 01:37:38+00:00,['7479be4e18a1821768cd8a921e72405c830eca9c'],2,2563,2565,16515089,15,0.724611162,0.859103385,0.881976212,6239
3fb376ba5455eee713a31a08606c7652c15cd92e,0,Impala Public Jenkins,2020-02-28 02:03:34+00:00,['df875dc05ba5023d01ddb94154638c33cc16a79d'],4,180,184,16515273,4,0,0,0.294117647,6239
c48efd407e7b857c6df0d167aafe02f93c81e2fb,0,Impala Public Jenkins,2020-02-28 14:28:16+00:00,['3fb376ba5455eee713a31a08606c7652c15cd92e'],42,135,177,16515450,4,0,0.066666667,0.533333333,6239
60a9e72faf7b8c3e034f4319c0761ed389994707,1,Impala Public Jenkins,2020-02-28 17:27:27+00:00,['c48efd407e7b857c6df0d167aafe02f93c81e2fb'],95,1119,1214,16516664,18,0.424076607,0.916552668,0.785225718,6240
519093fbb5c499aaf588999c77d8a711e8bd2aab,0,Impala Public Jenkins,2020-02-28 22:47:04+00:00,['60a9e72faf7b8c3e034f4319c0761ed389994707'],40,40,80,16516744,2,,,,6240
984f675e05d83f048afbee5b8a78413b2a624d13,0,Impala Public Jenkins,2020-03-02 09:01:14+00:00,['519093fbb5c499aaf588999c77d8a711e8bd2aab'],49,76,125,16516869,15,0.454545455,0.545454545,0.909090909,6240
48e08e42ba199954c21be208719fcd1b8e89d7ab,0,Tim Armstrong,2020-03-02 21:31:42+00:00,['984f675e05d83f048afbee5b8a78413b2a624d13'],1,4,5,16516874,1,,,,6240
d3a2d73fda48fde5e35c2c2d92730d4c2c9a3eb9,0,Impala Public Jenkins,2020-03-02 22:35:31+00:00,['48e08e42ba199954c21be208719fcd1b8e89d7ab'],2,13,15,16516889,1,0,1,1,6240
8357f61886fe53fe9800df281099ae487b32f3a5,0,Joe McDonnell,2020-03-03 00:23:27+00:00,['d3a2d73fda48fde5e35c2c2d92730d4c2c9a3eb9'],1,1,2,16516891,1,,,,6240
044969c6ea4aeeab37f1e8f13272a1affc8f7110,0,Impala Public Jenkins,2020-03-03 00:26:01+00:00,['8357f61886fe53fe9800df281099ae487b32f3a5'],190,281,471,16517362,16,0.121212121,0.939393939,0.575757576,6240
8eba9471facde2a8e721a39d6b0ddc0273e5d0cb,0,Impala Public Jenkins,2020-03-03 05:37:01+00:00,['044969c6ea4aeeab37f1e8f13272a1affc8f7110'],139,225,364,16517726,41,1,1,1,6240
1ea013cac8faaa7f66abe5de736bbe39cf3ea30d,0,Impala Public Jenkins,2020-03-03 06:12:24+00:00,['8eba9471facde2a8e721a39d6b0ddc0273e5d0cb'],24,1,25,16517751,1,,,,6240
d448f465091455082e9e71020f860edbb4465ba9,0,Impala Public Jenkins,2020-03-03 14:59:52+00:00,['1ea013cac8faaa7f66abe5de736bbe39cf3ea30d'],6,11,17,16517768,1,1,1,0,6240
f7c78ba27eaa4d228fd7fb9f349cf18c92cddc46,1,Impala Public Jenkins,2020-03-03 15:19:08+00:00,['d448f465091455082e9e71020f860edbb4465ba9'],144,425,569,16518337,15,0.623853211,0.788990826,0.660550459,6242
50f981a142fe6220e7e8b8e2a44f6614a1d0b507,0,Sahil Takiar,2020-03-03 17:03:17+00:00,['f7c78ba27eaa4d228fd7fb9f349cf18c92cddc46'],7,10,17,16518354,1,,,,6242
2b173dd41bcce1d68109c3559f9b0a7ec0d8a90f,1,Impala Public Jenkins,2020-03-03 17:46:47+00:00,['50f981a142fe6220e7e8b8e2a44f6614a1d0b507'],158,1202,1360,16519714,22,0.715261959,0.838268793,0.890660592,6252
158f0b45752de52037a682d5766669c287f2fb72,0,Impala Public Jenkins,2020-03-04 18:46:56+00:00,['2b173dd41bcce1d68109c3559f9b0a7ec0d8a90f'],4,19,23,16519737,3,0,0,1,6252
bc3cf8aed288d41a316b859520a879d1bf2d9431,1,Impala Public Jenkins,2020-03-04 22:53:52+00:00,['158f0b45752de52037a682d5766669c287f2fb72'],5,75,80,16519817,10,0.714285714,0.238095238,0.904761905,6252
ae0bd674a86f2d7deb4f72a7544fe5f0950ded0b,0,Impala Public Jenkins,2020-03-04 23:43:43+00:00,['bc3cf8aed288d41a316b859520a879d1bf2d9431'],45,122,167,16519984,12,0.166666667,0.9,0.9,6252
0b081aef3fc681b40c9cc45e0387bf7dd84358a9,0,Impala Public Jenkins,2020-03-05 13:21:34+00:00,['ae0bd674a86f2d7deb4f72a7544fe5f0950ded0b'],47,58,105,16520089,6,0,0.857142857,1,6252
92839b7e835229ce889f1777cd3be032c0842c9f,1,Impala Public Jenkins,2020-03-06 01:55:34+00:00,['0b081aef3fc681b40c9cc45e0387bf7dd84358a9'],204,233,437,16520526,14,1,1,1,6252
fb4f654d7c200325a15f0f7bb6d2f89957bae39e,0,Impala Public Jenkins,2020-03-06 17:37:33+00:00,['92839b7e835229ce889f1777cd3be032c0842c9f'],27,23,50,16520576,2,,,,6252
a007e3caf8d07a7cffbbc96ef099ecd3dc344ce6,0,Impala Public Jenkins,2020-03-07 00:00:22+00:00,['fb4f654d7c200325a15f0f7bb6d2f89957bae39e'],15,32,47,16520623,3,1,1,1,6252
9672d945963e1ca3c8699340f92d7d6ce1d91c9f,1,Impala Public Jenkins,2020-03-09 06:29:35+00:00,['a007e3caf8d07a7cffbbc96ef099ecd3dc344ce6'],24,217,241,16520864,14,0.266666667,0.933333333,0.3,6252
e1d1428181c26faa0fb2fb9a3454e00008daa2be,1,Tim Armstrong,2020-03-09 21:28:19+00:00,['9672d945963e1ca3c8699340f92d7d6ce1d91c9f'],7,47,54,16520918,5,0.407407407,0.407407407,1,6252
e858aba5d21793f134ff25da74a30992395fda62,0,Impala Public Jenkins,2020-03-12 00:58:59+00:00,['e1d1428181c26faa0fb2fb9a3454e00008daa2be'],44,124,168,16521086,4,0.023255814,1,1,6252
151754a454c698b4db9bb605a1bcd437c7f1ce9b,0,Impala Public Jenkins,2020-03-12 01:00:28+00:00,['e858aba5d21793f134ff25da74a30992395fda62'],62,161,223,16521309,5,0.488372093,0.697674419,1,6253
f66874e67b6895e2d939a0602e9633d8f3cc1cb2,0,Impala Public Jenkins,2020-03-12 01:13:18+00:00,['151754a454c698b4db9bb605a1bcd437c7f1ce9b'],54,138,192,16521501,7,0.086956522,1,1,6253
6fdc644fed40d2270f3b1d9176ee7e4ad12e4dd5,1,Impala Public Jenkins,2020-03-12 14:26:13+00:00,['f66874e67b6895e2d939a0602e9633d8f3cc1cb2'],572,728,1300,16522801,12,0.236842105,0.236842105,0.368421053,6253
a20edd57d9da037a6123961b753fe26e558b7433,0,Tim Armstrong,2020-03-12 18:49:31+00:00,['6fdc644fed40d2270f3b1d9176ee7e4ad12e4dd5'],0,92,92,16522893,3,,,,6254
8337131c1ee29210c6a0b13a5ef57afef4fdb4f4,1,Impala Public Jenkins,2020-03-13 02:27:26+00:00,['a20edd57d9da037a6123961b753fe26e558b7433'],33,84,117,16523010,3,1,1,1,6254
c3d65cab55789b3cc6950eec072b9931db57e4fe,0,Thomas Tauber-Marshall,2020-03-13 17:00:42+00:00,['8337131c1ee29210c6a0b13a5ef57afef4fdb4f4'],1,190,191,16523201,4,0.336206897,0.336206897,0.594827586,6255
3fd6f60b2219d31d61bd838e94a7f8f9df3d15e2,1,Thomas Tauber-Marshall,2020-03-13 17:00:42+00:00,['c3d65cab55789b3cc6950eec072b9931db57e4fe'],71,134,205,16523406,10,0,0,0.764705882,6256
e61f485a374ccefb346ba012aee6cbfc647c2928,0,Tim Armstrong,2020-03-13 22:27:42+00:00,['3fd6f60b2219d31d61bd838e94a7f8f9df3d15e2'],0,3,3,16523409,1,0,0,1,6256
4a8221877cc1782b861184f0ccf86238d002af13,0,Tim Armstrong,2020-03-13 23:54:47+00:00,['e61f485a374ccefb346ba012aee6cbfc647c2928'],12,6,18,16523427,2,,,,6256
f71e97f0b30acf84fff58024ead4740166295c06,0,Impala Public Jenkins,2020-03-17 04:55:47+00:00,['4a8221877cc1782b861184f0ccf86238d002af13'],28,84,112,16523539,5,0.027027027,0.540540541,0.567567568,6256
42dcaabf7c7f5e8ba5b98ce7c039574516d9e65d,0,Joe McDonnell,2020-03-17 17:02:23+00:00,['f71e97f0b30acf84fff58024ead4740166295c06'],32,33,65,16523604,3,,,,6256
955868f88a0593b2c75168e304bd4ff65b06ff98,0,Joe McDonnell,2020-03-17 20:16:58+00:00,['42dcaabf7c7f5e8ba5b98ce7c039574516d9e65d'],224,223,447,16524051,5,,,,6256
15f0ea9476ea9236c0e038c603a4bc63ba1f4b7a,0,Joe McDonnell,2020-03-17 23:04:37+00:00,['955868f88a0593b2c75168e304bd4ff65b06ff98'],0,68,68,16524119,2,,,,6257
08acccf9ebb13445ab7e3d5d2cd6ceb122bde1f3,1,Impala Public Jenkins,2020-03-17 23:29:45+00:00,['15f0ea9476ea9236c0e038c603a4bc63ba1f4b7a'],772,1320,2092,16526211,53,0.18442623,0.618852459,1,6258
7dd13f72784514a59f82c9a7a5e2250503dbfaf0,0,Thomas Tauber-Marshall,2020-03-18 18:05:34+00:00,['08acccf9ebb13445ab7e3d5d2cd6ceb122bde1f3'],149,190,339,16526550,8,0,0.896551724,0.896551724,6258
ca53f68525504b6a1a64bb35c7edb57d030916d7,1,Impala Public Jenkins,2020-03-19 06:03:36+00:00,['7dd13f72784514a59f82c9a7a5e2250503dbfaf0'],6,203,209,16526759,9,0.285714286,0.333333333,0.666666667,6259
9cb6dabe10da0aa29d61b6bba0f82ec3cefc4e0d,1,Impala Public Jenkins,2020-03-19 07:17:51+00:00,['ca53f68525504b6a1a64bb35c7edb57d030916d7'],73,317,390,16527149,7,0.434782609,0.456521739,0.173913043,6259
1d27b91a36f687f958b02738ba7899652b2cfec7,1,Impala Public Jenkins,2020-03-19 12:31:19+00:00,['9cb6dabe10da0aa29d61b6bba0f82ec3cefc4e0d'],145,241,386,16527535,7,0.22972973,0.418918919,0.824324324,6259
ed15c2c58f75c47a1111690a30e81af3202e7f82,1,Impala Public Jenkins,2020-03-20 03:10:07+00:00,['1d27b91a36f687f958b02738ba7899652b2cfec7'],203,243,446,16527981,6,0.366666667,0.366666667,0.666666667,6259
030c12ab2c995a8618dcf601296e310203f70f8c,0,Impala Public Jenkins,2020-03-20 05:21:53+00:00,['ed15c2c58f75c47a1111690a30e81af3202e7f82'],6,9,15,16527996,1,1,0,1,6259
f1c8176e656a46c7e245649c2f737841ffae460f,1,Impala Public Jenkins,2020-03-21 12:25:55+00:00,['030c12ab2c995a8618dcf601296e310203f70f8c'],33,323,356,16528352,11,1,1,1,6263
ed7049258055a07635c6412c159b8e08a6f0ca5d,1,Impala Public Jenkins,2020-03-21 19:52:07+00:00,['f1c8176e656a46c7e245649c2f737841ffae460f'],14,60,74,16528426,8,1,1,0,6264
01684ab3aa03645d3e0ab77026816f015b8aee23,1,Impala Public Jenkins,2020-03-21 20:14:33+00:00,['ed7049258055a07635c6412c159b8e08a6f0ca5d'],17,61,78,16528504,13,1,1,1,6264
603e5147d59a4f6a79e5cfeaf9d1421d01bf2d09,0,Impala Public Jenkins,2020-03-22 21:08:06+00:00,['01684ab3aa03645d3e0ab77026816f015b8aee23'],1,155,156,16528660,5,,,,6266
66de7808c7e1b017e442939d6dd6fd58017e4a1b,0,Impala Public Jenkins,2020-03-23 17:55:32+00:00,['603e5147d59a4f6a79e5cfeaf9d1421d01bf2d09'],2,17,19,16528679,1,0,1,0,6266
3b833902519fb8f0ef9b5fd20919c5fd85d22fcf,1,Impala Public Jenkins,2020-03-23 17:59:40+00:00,['66de7808c7e1b017e442939d6dd6fd58017e4a1b'],1,62,63,16528742,5,0.866666667,0.866666667,0.866666667,6266
8b162ff480aa346d1d32830097586d681976e2d1,0,Sahil Takiar,2020-03-23 22:57:53+00:00,['3b833902519fb8f0ef9b5fd20919c5fd85d22fcf'],24,47,71,16528813,5,0.142857143,0.857142857,0,6266
b865de7d971313beab486211b227b7ce4ad10c44,0,Impala Public Jenkins,2020-03-24 04:26:32+00:00,['8b162ff480aa346d1d32830097586d681976e2d1'],16,281,297,16529110,3,0,0.5,0.5,6266
acf59ab882277b2359e2d69134307955ced59103,0,Impala Public Jenkins,2020-03-24 04:44:39+00:00,['b865de7d971313beab486211b227b7ce4ad10c44'],3,6,9,16529119,1,0,0,0,6266
3062a8f67cf35c9390838601342f5854b18fea95,0,Impala Public Jenkins,2020-03-24 07:45:47+00:00,['acf59ab882277b2359e2d69134307955ced59103'],4,10,14,16529133,2,,,,6266
1411ca6a00d408956bd63d20995d13c3e6ded1b1,1,Impala Public Jenkins,2020-03-24 09:18:32+00:00,['3062a8f67cf35c9390838601342f5854b18fea95'],2,831,833,16529966,12,0.366972477,0.412844037,0.697247706,6268
35d2718d36c06abe867dff61307be920325e8a5e,0,Impala Public Jenkins,2020-03-24 20:31:19+00:00,['1411ca6a00d408956bd63d20995d13c3e6ded1b1'],1,10,11,16529977,1,0,0,0,6268
a6948487346f29e2d06a3493262e79f961285400,0,Tim Armstrong,2020-03-24 21:14:31+00:00,['35d2718d36c06abe867dff61307be920325e8a5e'],89,90,179,16530156,2,,,,6268
b8d6b0dade27ad7978f8f2c2f21c3dd42c06e1ed,0,Impala Public Jenkins,2020-03-25 02:10:40+00:00,['a6948487346f29e2d06a3493262e79f961285400'],9,13,22,16530178,2,,,,6268
da5b498c18ba1a22b122682da73481af633a3398,1,Impala Public Jenkins,2020-03-25 03:37:32+00:00,['b8d6b0dade27ad7978f8f2c2f21c3dd42c06e1ed'],890,1069,1959,16532137,159,1,1,1,6268
5ff7c6a7de76aac2623710b3e43ceed8ce7424c8,0,Tim Armstrong,2020-03-25 16:13:56+00:00,['da5b498c18ba1a22b122682da73481af633a3398'],943,1798,2741,16534878,3,0.711229947,1,0.203208556,6268
850de91cc38b681e8cb5ea6194e4ba3415ea2c4d,0,Joe McDonnell,2020-03-25 16:39:32+00:00,['5ff7c6a7de76aac2623710b3e43ceed8ce7424c8'],2,4,6,16534884,1,,,,6268
46a659871fa349f6aa828d7ea39fe19f64a3ab27,0,Impala Public Jenkins,2020-03-26 00:48:46+00:00,['850de91cc38b681e8cb5ea6194e4ba3415ea2c4d'],0,3,3,16534887,1,,,,6268
1d63348b933b266f63d76b06eecbdf636cb45770,0,Impala Public Jenkins,2020-03-27 03:41:53+00:00,['46a659871fa349f6aa828d7ea39fe19f64a3ab27'],5,70,75,16534962,4,0.705882353,0.882352941,0.823529412,6268
0167c5b4242fcebf6be19aba5ecfb440204278ad,1,Csaba Ringhofer,2020-03-27 12:22:23+00:00,['1d63348b933b266f63d76b06eecbdf636cb45770'],94,103,197,16535159,48,1,1,,6268
df6196e064bc7453bee8c7e644bb591391ee3ce2,0,Joe McDonnell,2020-03-27 16:52:49+00:00,['0167c5b4242fcebf6be19aba5ecfb440204278ad'],10,93,103,16535262,3,0.357142857,0.982142857,0.696428571,6268
2cd7a2b77acfa04094e91efbc6803d11fabcc0e9,1,Impala Public Jenkins,2020-03-27 17:16:00+00:00,['df6196e064bc7453bee8c7e644bb591391ee3ce2'],21,33,54,16535316,2,,,,6268
c9da86d00d5aba0aa91bfa59e47f2e28889b2a87,1,Impala Public Jenkins,2020-03-27 20:00:18+00:00,['2cd7a2b77acfa04094e91efbc6803d11fabcc0e9'],2,2,4,16535320,1,,,,6268
e9dd5d3f8c1d533bc5ae94c7e0677820fcd851aa,0,Impala Public Jenkins,2020-03-27 23:27:12+00:00,['c9da86d00d5aba0aa91bfa59e47f2e28889b2a87'],1,1,2,16535322,1,,,,6268
fc784f6e95dc633fa9a3504914646b1f793a8b93,0,Impala Public Jenkins,2020-03-28 00:32:18+00:00,['e9dd5d3f8c1d533bc5ae94c7e0677820fcd851aa'],51,505,556,16535878,4,0.561461794,0.777408638,0.754152824,6269
2f53783b14ddf215a4c96bc52a511d3a83896128,0,Impala Public Jenkins,2020-03-29 04:12:39+00:00,['fc784f6e95dc633fa9a3504914646b1f793a8b93'],0,117,117,16535995,2,,,,6271
a09963f2f7c06ba53397ffbe1095c5cb27a27646,0,Impala Public Jenkins,2020-03-30 18:43:24+00:00,['2f53783b14ddf215a4c96bc52a511d3a83896128'],1,5,6,16536001,1,,,,6271
5bdd3adb1aef9729a122d57490fefb521eef8885,1,Impala Public Jenkins,2020-03-30 20:04:17+00:00,['a09963f2f7c06ba53397ffbe1095c5cb27a27646'],3,5,8,16536009,1,,,,6271
fea7b7b6be8779687b581a2dc99219bab5709184,0,Impala Public Jenkins,2020-03-30 21:42:31+00:00,['5bdd3adb1aef9729a122d57490fefb521eef8885'],8,1,9,16536018,1,,,,6271
ebbe52b4bed944d3012e3679dc984827ce11d5a8,1,Tim Armstrong,2020-03-31 01:36:44+00:00,['fea7b7b6be8779687b581a2dc99219bab5709184'],247,852,1099,16537117,15,0.275147929,0.698224852,0.446745562,6271
d9a38c0bac70f0cf552855183d73daf53aa09ef6,0,Impala Public Jenkins,2020-03-31 13:10:04+00:00,['ebbe52b4bed944d3012e3679dc984827ce11d5a8'],6,15,21,16537138,6,,,,6271
01691b998a96fd29575a3c3912377bd18fdd712f,1,Joe McDonnell,2020-03-31 16:08:02+00:00,['d9a38c0bac70f0cf552855183d73daf53aa09ef6'],842,2676,3518,16540656,16,0.345433255,0.868852459,0.889929742,6276
e8f604a2139be2ee3f011e6f2ce71fa0dde26492,0,Impala Public Jenkins,2020-03-31 18:43:09+00:00,['01691b998a96fd29575a3c3912377bd18fdd712f'],2,18,20,16540676,3,1,1,1,6276
1cfc31c84fce543b6cf75341a699772ffde5e3bd,0,Impala Public Jenkins,2020-03-31 19:11:20+00:00,['e8f604a2139be2ee3f011e6f2ce71fa0dde26492'],8,8,16,16540692,1,,,,6276
208d9d6896f39a25be00ae4a4ce4679aa5ecd636,1,Impala Public Jenkins,2020-03-31 19:38:10+00:00,['1cfc31c84fce543b6cf75341a699772ffde5e3bd'],57,22,79,16540771,5,,,,6276
0038487267ccba77e6cb17a582039d6b35ff947c,1,Impala Public Jenkins,2020-03-31 20:09:43+00:00,['208d9d6896f39a25be00ae4a4ce4679aa5ecd636'],18,9,27,16540798,3,0,0,1,6276
ab7e209d1bf8f8d61e092b6de9078c0d2e8c657d,0,Impala Public Jenkins,2020-03-31 20:45:59+00:00,['0038487267ccba77e6cb17a582039d6b35ff947c'],369,179,548,16541346,8,0.043478261,0.043478261,0,6276
a08cd7f49bb9c69b05fabe9ccd18577cfd300b4e,0,Impala Public Jenkins,2020-03-31 22:57:00+00:00,['ab7e209d1bf8f8d61e092b6de9078c0d2e8c657d'],64,35,99,16541445,1,,,,6276
4e6780ebf1dfa90aea01b3e35d3dc9ceb100eaee,0,Impala Public Jenkins,2020-04-01 00:54:51+00:00,['a08cd7f49bb9c69b05fabe9ccd18577cfd300b4e'],166,495,661,16542106,8,0.040229885,0.183908046,0.908045977,6278
5c541512f080327686fe0ad6fcf4ef90ca048007,1,Impala Public Jenkins,2020-04-01 04:22:38+00:00,['4e6780ebf1dfa90aea01b3e35d3dc9ceb100eaee'],13,25,38,16542144,10,1,1,1,6278
5acce4d2000485b9cd87a545b2a05154c889181c,0,Joe McDonnell,2020-04-01 14:37:58+00:00,['5c541512f080327686fe0ad6fcf4ef90ca048007'],9,284,293,16542437,7,0,0.905263158,0.905263158,6278
2576952655d8e252943379dd4dbcdd0315e457c5,0,Thomas Tauber-Marshall,2020-04-01 15:48:36+00:00,['5acce4d2000485b9cd87a545b2a05154c889181c'],639,806,1445,16543882,17,0.097560976,0.073170732,0.609756098,6278
f2837e97b25be37221ab475b0fd4f66320a4f66b,1,Impala Public Jenkins,2020-04-01 22:51:41+00:00,['2576952655d8e252943379dd4dbcdd0315e457c5'],625,930,1555,16545437,100,0.27,0.92,0.56,6280
7fa43eef80bcb7823f144690bd1197276907b710,0,Impala Public Jenkins,2020-04-01 23:41:52+00:00,['f2837e97b25be37221ab475b0fd4f66320a4f66b'],1,2,3,16545440,1,0,0,1,6280
7abbde3c5d18217a84979454fffad1887e10816a,0,Impala Public Jenkins,2020-04-02 11:11:00+00:00,['7fa43eef80bcb7823f144690bd1197276907b710'],16,75,91,16545531,4,0.325581395,0.76744186,1,6280
8aa0652871c64639a34e54a7339a1eff1d594b19,1,Impala Public Jenkins,2020-04-02 12:01:41+00:00,['7abbde3c5d18217a84979454fffad1887e10816a'],532,1553,2085,16547616,53,0.21875,0.451704545,0.482954545,6283
3bd5c4aaa2c0ba00856effab83d8cb9bc1e49406,0,Joe McDonnell,2020-04-02 19:42:57+00:00,['8aa0652871c64639a34e54a7339a1eff1d594b19'],5,176,181,16547797,2,,,,6283
81b5f823aa715d47f939191f2370e32ef9983413,0,Impala Public Jenkins,2020-04-02 21:08:18+00:00,['3bd5c4aaa2c0ba00856effab83d8cb9bc1e49406'],100,479,579,16548376,9,0.274390244,0.548780488,0.652439024,6285
76061331781e67b90d7750abadfaf8b013dc64a5,0,Joe McDonnell,2020-04-03 16:14:16+00:00,['81b5f823aa715d47f939191f2370e32ef9983413'],6,13,19,16548395,1,,,,6285
d877dbc572e95f086b37142e1d41231d5b6b7f9f,1,Impala Public Jenkins,2020-04-04 03:55:06+00:00,['76061331781e67b90d7750abadfaf8b013dc64a5'],36,191,227,16548622,12,0.06504065,0.93495935,0.707317073,6285
24518467970f29d2a33f56c782ab52a049d9335a,0,Impala Public Jenkins,2020-04-07 11:11:34+00:00,['d877dbc572e95f086b37142e1d41231d5b6b7f9f'],9,2,11,16548633,1,,,,6285
5c2cae89f2ba1de55131a261dce7c8e284bb6c0e,1,Impala Public Jenkins,2020-04-07 15:10:27+00:00,['24518467970f29d2a33f56c782ab52a049d9335a'],32,371,403,16549036,10,0.52,0.86,1,6285
dbd22365fdaf56b1a76ba8d3b6460222f809090f,0,Tim Armstrong,2020-04-07 15:58:27+00:00,['5c2cae89f2ba1de55131a261dce7c8e284bb6c0e'],0,32,32,16549068,4,,,,6285
7fd046d00f9cd3106ff2c617c53ab6d183920785,0,Impala Public Jenkins,2020-04-07 23:26:14+00:00,['dbd22365fdaf56b1a76ba8d3b6460222f809090f'],12,40,52,16549120,4,0.625,0,1,6285
a2e94095a8f8df9432eec857aa6798a61bb2362c,0,Tim Armstrong,2020-04-08 00:09:15+00:00,['7fd046d00f9cd3106ff2c617c53ab6d183920785'],0,7,7,16549127,2,,,,6285
9754dca8e5df398d7bd537ae71c6922566a8bd9f,1,Impala Public Jenkins,2020-04-08 06:12:04+00:00,['a2e94095a8f8df9432eec857aa6798a61bb2362c'],8,8,16,16549143,1,,,,6285
928d5879c701f66ca01a6b1778cdf4ac79133e89,1,Csaba Ringhofer,2020-04-08 12:43:55+00:00,['9754dca8e5df398d7bd537ae71c6922566a8bd9f'],3,5,8,16549151,1,,,,6285
dc993daa34defadc57434ffe57331818c2c143f7,1,Impala Public Jenkins,2020-04-08 22:51:20+00:00,['928d5879c701f66ca01a6b1778cdf4ac79133e89'],3,8,11,16549162,2,,,,6285
49cdd785637c82d7ba3f38be7e5c13e2b7272c2e,0,Impala Public Jenkins,2020-04-09 02:01:57+00:00,['dc993daa34defadc57434ffe57331818c2c143f7'],2,43,45,16549207,6,0,0.483870968,0.161290323,6285
0f85cbd51130bb4ec3e7db9bdeb10e4ffe3470ae,1,Impala Public Jenkins,2020-04-09 04:46:45+00:00,['49cdd785637c82d7ba3f38be7e5c13e2b7272c2e'],8,65,73,16549280,2,0.972222222,1,1,6285
e0ed7d321c1dca85a0f1482842f8db6db517c909,1,Vihang Karajgaonkar,2020-04-09 04:58:07+00:00,['0f85cbd51130bb4ec3e7db9bdeb10e4ffe3470ae'],171,504,675,16549955,17,0.273631841,0.865671642,0.268656716,6285
5e69ae1d7dc113bbcc8d7d75e3b1b5244e76f76a,0,Impala Public Jenkins,2020-04-09 08:00:51+00:00,['e0ed7d321c1dca85a0f1482842f8db6db517c909'],12,133,145,16550100,4,0,1,1,6286
5989900ae81a98d6977bdd60f2281da47e9f69b7,0,Impala Public Jenkins,2020-04-09 08:01:24+00:00,['5e69ae1d7dc113bbcc8d7d75e3b1b5244e76f76a'],123,21,144,16550244,6,0,0,0,6286
293dc2ec92d0cadf1d3803a22e66e762d0ff6cf1,1,Impala Public Jenkins,2020-04-09 17:03:59+00:00,['5989900ae81a98d6977bdd60f2281da47e9f69b7'],6,53,59,16550303,3,0.5,0.75,0.5,6286
c52b1d8a689584f5502822cecd54c363c768f71d,0,Impala Public Jenkins,2020-04-09 22:25:30+00:00,['293dc2ec92d0cadf1d3803a22e66e762d0ff6cf1'],0,481,481,16550784,4,0.342857143,0.994285714,0.668571429,6287
b770d2d378d642dcc1bdda733c99cc80ca239dc3,1,Impala Public Jenkins,2020-04-11 00:36:56+00:00,['c52b1d8a689584f5502822cecd54c363c768f71d'],40,28,68,16550852,4,1,1,1,6287
d6f57eb97d11f9c43c8fe09e4ce80f2e2f539ff1,0,Impala Public Jenkins,2020-04-13 06:04:47+00:00,['b770d2d378d642dcc1bdda733c99cc80ca239dc3'],0,3,3,16550855,1,,,,6287
e93405f7600c2cefcf522fdc64162a9ceaac3aa3,0,Impala Public Jenkins,2020-04-13 12:57:53+00:00,['d6f57eb97d11f9c43c8fe09e4ce80f2e2f539ff1'],4,18,22,16550877,2,0,1,1,6287
1397dc9a499ae5340b2fe834752dd4a82443e39b,0,Joe McDonnell,2020-04-13 23:52:06+00:00,['e93405f7600c2cefcf522fdc64162a9ceaac3aa3'],1,1,2,16550879,1,,,,6287
c32849a3912a6fe295e74269bf0c1f350962d57f,1,Impala Public Jenkins,2020-04-14 12:18:21+00:00,['1397dc9a499ae5340b2fe834752dd4a82443e39b'],266,147,413,16551292,13,0.666666667,0.074074074,0.074074074,6287
76e4a17fb379bb232618dccb4ad3504dbe5c945c,1,Tim Armstrong,2020-04-14 15:42:13+00:00,['c32849a3912a6fe295e74269bf0c1f350962d57f'],158,252,410,16551702,12,0.666666667,0.461538462,0.923076923,6288
82ca3262b3aeee13d2cc27c5ff9aef3f6c70cc8a,0,Impala Public Jenkins,2020-04-14 20:07:16+00:00,['76e4a17fb379bb232618dccb4ad3504dbe5c945c'],2,0,2,16551704,1,,,,6288
8d264321efe370924b3e60fafad9aca1347a4dc1,0,Impala Public Jenkins,2020-04-14 21:41:18+00:00,['82ca3262b3aeee13d2cc27c5ff9aef3f6c70cc8a'],2,0,2,16551706,1,,,,6288
9ea8b1454fabf5872459cd8ae6af60e8d89f62a5,0,Impala Public Jenkins,2020-04-14 22:37:50+00:00,['8d264321efe370924b3e60fafad9aca1347a4dc1'],4,3,7,16551713,2,0,,,6288
bd4458b7a92910178a3f92cec888e83172899408,1,Impala Public Jenkins,2020-04-15 05:05:21+00:00,['9ea8b1454fabf5872459cd8ae6af60e8d89f62a5'],58,87,145,16551858,8,1,0,0,6288
026ae182ef4b5111aba625a26d50b8b53563088d,0,Impala Public Jenkins,2020-04-15 05:39:16+00:00,['bd4458b7a92910178a3f92cec888e83172899408'],4,36,40,16551898,3,0,1,0.5,6288
34018f62751b01c21e869ca7ff38e6d7d4a808d9,1,Impala Public Jenkins,2020-04-15 17:23:43+00:00,['026ae182ef4b5111aba625a26d50b8b53563088d'],14,116,130,16552028,4,,,,6288
e863bac074f70b9d063cd7e53e46b3065b99edcb,0,Impala Public Jenkins,2020-04-15 22:18:18+00:00,['34018f62751b01c21e869ca7ff38e6d7d4a808d9'],2,16,18,16552046,4,0,0,0.333333333,6288
21aa51435328fff2343430d26417f67c5586b7e0,0,Tim Armstrong,2020-04-16 00:53:35+00:00,['e863bac074f70b9d063cd7e53e46b3065b99edcb'],3,31,34,16552080,2,,,,6288
c97191b6a5c86f63af2a23d72c290d9f13387bd6,1,Impala Public Jenkins,2020-04-16 01:08:00+00:00,['21aa51435328fff2343430d26417f67c5586b7e0'],30,67,97,16552177,5,0.642857143,0.285714286,0.714285714,6288
dc410a2cf47bcf06a0f4563d05a9d0a339af5fb2,0,Tim Armstrong,2020-04-16 15:45:49+00:00,['c97191b6a5c86f63af2a23d72c290d9f13387bd6'],52,63,115,16552292,7,0,0,1,6289
327ec29c48a2f02411fe74be7f36ccfdb7d7e4e5,1,Impala Public Jenkins,2020-04-16 23:09:25+00:00,['dc410a2cf47bcf06a0f4563d05a9d0a339af5fb2'],0,10,10,16552302,1,,,,6289
c26e3db4bd8078240b71451ccbe51603b9f16f60,0,Impala Public Jenkins,2020-04-17 05:04:23+00:00,['327ec29c48a2f02411fe74be7f36ccfdb7d7e4e5'],6180,6832,13012,16565314,99,0.769820972,1,1,6325
6fcc758c1aa0b6075738edb76371a0cc43d04388,1,Vihang Karajgaonkar,2020-04-17 13:21:34+00:00,['c26e3db4bd8078240b71451ccbe51603b9f16f60'],6,29,35,16565349,3,0,0,0,6325
bc9d7e063dd71f9af75967f8c6af9ac1a6f49149,1,Impala Public Jenkins,2020-04-18 05:13:50+00:00,['6fcc758c1aa0b6075738edb76371a0cc43d04388'],149,352,501,16565850,19,0,0.464285714,1,6325
248c6d2495d4628c10e6bdbb00f9ed170bba19b6,1,Impala Public Jenkins,2020-04-20 13:12:31+00:00,['bc9d7e063dd71f9af75967f8c6af9ac1a6f49149'],264,226,490,16566340,4,0.791666667,1,1,6325
e11d02adcbaed38d1d0d09549383408ce33fa234,0,Impala Public Jenkins,2020-04-20 16:38:50+00:00,['248c6d2495d4628c10e6bdbb00f9ed170bba19b6'],0,0,0,16566340,0,,,,6325
02d84dcf502afbb610eb1f911b3a832adfbf5fa9,0,Impala Public Jenkins,2020-04-21 06:12:56+00:00,['e11d02adcbaed38d1d0d09549383408ce33fa234'],0,4,4,16566344,1,,,,6325
45802816394b24c3320537e53cf1e796f0fac3ee,1,Tim Armstrong,2020-04-21 19:27:34+00:00,['02d84dcf502afbb610eb1f911b3a832adfbf5fa9'],73,86,159,16566503,3,,,,6326
2dc2006c9ea09f9f83815aa5a450d6d95b2d8b1c,0,Tim Armstrong,2020-04-21 19:28:29+00:00,['45802816394b24c3320537e53cf1e796f0fac3ee'],6,6,12,16566515,2,,,,6326
c4ba8f829116b0f15bec09893b323a3552a4dfb5,0,Impala Public Jenkins,2020-04-22 04:47:00+00:00,['2dc2006c9ea09f9f83815aa5a450d6d95b2d8b1c'],70,92,162,16566677,2,,,,6326
3a795b5af01f6bc88897061776f70dcad8c5bf5b,0,Thomas Tauber-Marshall,2020-04-22 17:01:38+00:00,['c4ba8f829116b0f15bec09893b323a3552a4dfb5'],2,2,4,16566681,2,,,,6326
a9c4cf9745bfacd5c14d46a05fd319562547abfb,1,Thomas Tauber-Marshall,2020-04-22 17:01:38+00:00,['3a795b5af01f6bc88897061776f70dcad8c5bf5b'],1,1,2,16566683,1,,,,6326
7e1d774a15daa87a104adb336f73874d3415eb08,0,Impala Public Jenkins,2020-04-22 18:03:34+00:00,['a9c4cf9745bfacd5c14d46a05fd319562547abfb'],4,19,23,16566706,3,1,1,0.888888889,6326
b921d982b530d4546efeb10ceb02c82297859da9,0,Impala Public Jenkins,2020-04-22 21:56:01+00:00,['7e1d774a15daa87a104adb336f73874d3415eb08'],3,8,11,16566717,2,1,1,1,6326
1ab580a0917bba96643c5915dbb2cde21b5e457b,0,Impala Public Jenkins,2020-04-23 02:41:59+00:00,['b921d982b530d4546efeb10ceb02c82297859da9'],21,57,78,16566795,8,0,0,0,6326
9a3108709bf9cc11f00b97e966d1514bd59b34c8,1,Impala Public Jenkins,2020-04-24 16:26:21+00:00,['1ab580a0917bba96643c5915dbb2cde21b5e457b'],2,7381,7383,16574178,41,0.530850263,0.603837472,0.814522197,6364
4386c1b44a83f7f7b5000f0a8c0dda217651c16a,1,Joe McDonnell,2020-04-24 16:44:33+00:00,['9a3108709bf9cc11f00b97e966d1514bd59b34c8'],0,8,8,16574186,1,,,,6364
704ba38ae1b23d34829cf9a9b77f18b0b0235234,0,Impala Public Jenkins,2020-04-24 20:02:43+00:00,['4386c1b44a83f7f7b5000f0a8c0dda217651c16a'],0,7,7,16574193,1,,,,6364
b2d9901fb88703667c59aed73193196947be521d,1,Impala Public Jenkins,2020-04-24 20:56:58+00:00,['704ba38ae1b23d34829cf9a9b77f18b0b0235234'],439,834,1273,16575466,46,0.525,0.65625,0.75,6366
58273fff601dcc763ac43f7cc275a174a2e18b6b,0,Impala Public Jenkins,2020-04-24 21:43:53+00:00,['b2d9901fb88703667c59aed73193196947be521d'],17,63,80,16575546,4,0.75,0.944444444,1,6366
8749d5874350772cd745e6a2359f45a13537050e,1,Joe McDonnell,2020-04-24 23:07:56+00:00,['58273fff601dcc763ac43f7cc275a174a2e18b6b'],5,5,10,16575556,2,,,,6366
0eef60cc943518edbeffd84504574daeb11c812d,0,Impala Public Jenkins,2020-04-25 04:33:45+00:00,['8749d5874350772cd745e6a2359f45a13537050e'],0,38,38,16575594,1,,,,6366
f129a179a2c1b304e4d15fe4950449c5786abda1,0,David Knupp,2020-04-27 17:36:10+00:00,['0eef60cc943518edbeffd84504574daeb11c812d'],2,0,2,16575596,1,,,,6366
62080883feffbad4ff945d541981e70207950be9,0,Impala Public Jenkins,2020-04-27 17:37:31+00:00,['f129a179a2c1b304e4d15fe4950449c5786abda1'],11,59,70,16575666,2,0,0,1,6366
b9e84738b68710e00afb7efb3cf0c25c0582f7f8,0,Joe McDonnell,2020-04-27 21:27:03+00:00,['62080883feffbad4ff945d541981e70207950be9'],4,3,7,16575673,1,,,,6366
326ef554caef75c50a1394240766b501e5a699c3,0,David Knupp,2020-04-27 22:51:26+00:00,['b9e84738b68710e00afb7efb3cf0c25c0582f7f8'],0,2,2,16575675,1,,,,6366
c4ac9d2ee14e0bea855cbb26c962556a27983e52,0,David Knupp,2020-04-27 22:55:23+00:00,['326ef554caef75c50a1394240766b501e5a699c3'],38,0,38,16575713,1,,,,6366
961519747bf75bc2ba8519d00757b8e176d14538,0,Joe McDonnell,2020-04-28 01:31:39+00:00,['c4ac9d2ee14e0bea855cbb26c962556a27983e52'],0,11,11,16575724,1,,,,6366
afe765e3bdf8facb1940f4c7620eb7f9084bcb1f,0,Joe McDonnell,2020-04-28 02:21:21+00:00,['961519747bf75bc2ba8519d00757b8e176d14538'],1,2,3,16575727,1,,,,6366
75a6d7b2bba66825efb3a37f14c9447e64ea584f,0,Impala Public Jenkins,2020-04-28 06:00:42+00:00,['afe765e3bdf8facb1940f4c7620eb7f9084bcb1f'],12,24,36,16575763,3,0,0,0,6366
f4258b5f971f90390b93aa7a2e76dd0b8a1d8825,0,Impala Public Jenkins,2020-04-28 08:34:38+00:00,['75a6d7b2bba66825efb3a37f14c9447e64ea584f'],1,3,4,16575767,1,,,,6366
1a36a0348b85c2b2008d7b4b3a061a467f8456e7,1,Impala Public Jenkins,2020-04-30 01:55:51+00:00,['f4258b5f971f90390b93aa7a2e76dd0b8a1d8825'],17,48,65,16575832,2,0,0.541666667,0,6366
d0325b2ac176d536fc9c8959b1f2d01335bc32a2,1,Impala Public Jenkins,2020-05-01 04:47:31+00:00,['1a36a0348b85c2b2008d7b4b3a061a467f8456e7'],543,386,929,16576761,9,0,0,0,6366
53ff6f9bf5ca907f15ec1187eb5d4007d46eb61e,1,Impala Public Jenkins,2020-05-02 01:04:24+00:00,['d0325b2ac176d536fc9c8959b1f2d01335bc32a2'],1004,43,1047,16577808,8,0.723484848,0.083333333,0.606060606,6366
807b8dc81b815a690ecb0fc468e4eb6c92bb1e29,1,Impala Public Jenkins,2020-05-02 07:56:16+00:00,['53ff6f9bf5ca907f15ec1187eb5d4007d46eb61e'],9,35,44,16577852,1,,,,6366
6e0085c2207e9102b705778efe8e2698f1288ac0,0,David Knupp,2020-05-05 01:21:02+00:00,['807b8dc81b815a690ecb0fc468e4eb6c92bb1e29'],2,2,4,16577856,1,,,,6366
75d98b4b081df95b58d7388da39bb1ec7c2f4f67,0,David Knupp,2020-05-05 07:16:18+00:00,['6e0085c2207e9102b705778efe8e2698f1288ac0'],2702,0,2702,16580558,3,0.371833085,0.357675112,0.380029806,6366
cf8e41c14f684659a492799e384b9358cfef7541,0,Zoltan Borok-Nagy,2020-05-05 07:29:33+00:00,['75d98b4b081df95b58d7388da39bb1ec7c2f4f67'],0,5,5,16580563,1,,,,6366
748e41ab41a839be38d0865ff0e1bd3e9de8d157,1,Impala Public Jenkins,2020-05-05 10:12:42+00:00,['cf8e41c14f684659a492799e384b9358cfef7541'],156,362,518,16581081,22,0.36036036,0,0.846846847,6366
56c20ac4639cab3d6e5e0ae77ce395934a9294f6,1,Csaba Ringhofer,2020-05-05 11:12:29+00:00,['748e41ab41a839be38d0865ff0e1bd3e9de8d157'],70,124,194,16581275,3,0,1,0.708333333,6366
537c30dd063934373d171bdd9ad03835ee8febfc,1,Impala Public Jenkins,2020-05-05 12:33:31+00:00,['56c20ac4639cab3d6e5e0ae77ce395934a9294f6'],1427,3651,5078,16586353,19,0.576855124,0.758833922,0.858657244,6376
39c5c4d01db7ad60d21d8df6b681738a3f3b09b1,0,Thomas Tauber-Marshall,2020-05-05 17:44:40+00:00,['537c30dd063934373d171bdd9ad03835ee8febfc'],2,4,6,16586359,1,,,,6376
e46bbf29d43f1d3b118933d06c63ceb135beaf9c,1,Impala Public Jenkins,2020-05-05 21:49:44+00:00,['39c5c4d01db7ad60d21d8df6b681738a3f3b09b1'],495,621,1116,16587475,38,0.790322581,1,1,6377
c43c03c5eea624da98399f70a0bac3f9f2dcca0e,1,Impala Public Jenkins,2020-05-07 08:50:44+00:00,['e46bbf29d43f1d3b118933d06c63ceb135beaf9c'],82,181,263,16587738,18,1,0.5,1,6380
f241fd08ac97a9c20a3c97a86f45b9ba5e7ec2fb,1,Impala Public Jenkins,2020-05-07 22:14:39+00:00,['c43c03c5eea624da98399f70a0bac3f9f2dcca0e'],1108,81,1189,16588927,11,0.24,0.061538462,0.406153846,6380
0a0001e1a85462c81c9c4617a2e864c98913f229,0,Joe McDonnell,2020-05-07 23:15:32+00:00,['f241fd08ac97a9c20a3c97a86f45b9ba5e7ec2fb'],0,2702,2702,16591629,3,0.628166915,0.642324888,0.619970194,6381
f4f7fb53a48f114f520737af7be2433a5afd03d4,0,Tim Armstrong,2020-05-08 00:31:12+00:00,['0a0001e1a85462c81c9c4617a2e864c98913f229'],1,7,8,16591637,2,0,0,0,6381
4846751c84b70673ea25cd88e8c9d2085f7ae55e,0,Impala Public Jenkins,2020-05-08 04:18:26+00:00,['f4f7fb53a48f114f520737af7be2433a5afd03d4'],2,10,12,16591649,2,,,,6381
e8d17948fb94e9a5cf8b6cfce9e05d51ebb65492,0,Impala Public Jenkins,2020-05-08 21:48:03+00:00,['4846751c84b70673ea25cd88e8c9d2085f7ae55e'],1,9,10,16591659,1,1,1,1,6381
dcf497910a8db4796985fa4b01a37e747b12029a,0,Impala Public Jenkins,2020-05-10 00:18:43+00:00,['e8d17948fb94e9a5cf8b6cfce9e05d51ebb65492'],4,3,7,16591666,2,1,1,0,6381
f0e4b611734064e984bc3a208c76bcbf53a08d6c,1,Csaba Ringhofer,2020-05-11 09:42:41+00:00,['dcf497910a8db4796985fa4b01a37e747b12029a'],5,27,32,16591698,3,0.923076923,1,1,6381
b3af05f43d7420c76367c31f7b870e9d04bac0bb,0,Impala Public Jenkins,2020-05-11 10:36:22+00:00,['f0e4b611734064e984bc3a208c76bcbf53a08d6c'],6,1,7,16591705,1,1,0,0,6381
7295edcc26bc7396bde8b6eb940acdb09e303663,0,Csaba Ringhofer,2020-05-11 19:32:08+00:00,['b3af05f43d7420c76367c31f7b870e9d04bac0bb'],28,49,77,16591782,9,1,1,0.125,6381
7d260b602895280fab1a1a543a3e9700493febbd,0,Impala Public Jenkins,2020-05-12 06:37:37+00:00,['7295edcc26bc7396bde8b6eb940acdb09e303663'],13,17,30,16591812,2,,,,6381
2dd20dc1e409fb6c460f9dbb1b995044ba8b858e,0,Tim Armstrong,2020-05-12 22:49:39+00:00,['7d260b602895280fab1a1a543a3e9700493febbd'],12,27,39,16591851,1,,,,6381
a93f2c2675d72d03a6e8430126f3f461b153ca26,0,Impala Public Jenkins,2020-05-12 23:29:04+00:00,['2dd20dc1e409fb6c460f9dbb1b995044ba8b858e'],1872,1986,3858,16595709,25,0,0.293478261,0.630434783,6381
0815a184fdfeb3293849a8441ba003d63a588dab,0,Joe McDonnell,2020-05-13 02:50:15+00:00,['a93f2c2675d72d03a6e8430126f3f461b153ca26'],49,419,468,16596177,13,0.096330275,0.385321101,0.922018349,6382
5e72ca546ec3dd83a11de5d1905db50807544c5e,0,Impala Public Jenkins,2020-05-13 22:01:34+00:00,['0815a184fdfeb3293849a8441ba003d63a588dab'],27,109,136,16596313,4,0.181818182,0.181818182,0.181818182,6382
d0a97937ce7af821eb0675bbfd06087b00e39833,0,Impala Public Jenkins,2020-05-14 02:03:23+00:00,['5e72ca546ec3dd83a11de5d1905db50807544c5e'],3,13,16,16596329,4,,,,6382
592ed10a2192cfe87cd05f438028a5293ecadbda,0,Impala Public Jenkins,2020-05-14 02:47:18+00:00,['d0a97937ce7af821eb0675bbfd06087b00e39833'],252,172,424,16596753,1,,,,6382
506a303c6d48fd5d0653cdfd58b3ae419328ff31,1,Impala Public Jenkins,2020-05-14 02:52:16+00:00,['592ed10a2192cfe87cd05f438028a5293ecadbda'],40,125,165,16596918,9,0.148148148,0,1,6383
88c2f9a5268a71aced3a2788dc9c139182f74f56,0,Laszlo Gaal,2020-05-14 08:20:17+00:00,['506a303c6d48fd5d0653cdfd58b3ae419328ff31'],2,5,7,16596925,1,0,1,1,6383
ea4c7e4add8d97822323b4854b5d15f4a6a46878,0,Impala Public Jenkins,2020-05-14 21:54:33+00:00,['88c2f9a5268a71aced3a2788dc9c139182f74f56'],1,28,29,16596954,2,1,1,1,6383
fcf08d18228dd07c2371a89e3b0788791cb03dfa,1,Impala Public Jenkins,2020-05-15 16:49:32+00:00,['ea4c7e4add8d97822323b4854b5d15f4a6a46878'],10,68,78,16597032,3,1,1,1,6383
bd4d01a379fa483baf7524c0effb981c2fb0c742,1,Sahil Takiar,2020-05-15 20:11:07+00:00,['fcf08d18228dd07c2371a89e3b0788791cb03dfa'],697,2701,3398,16600430,27,0.399773499,0.783691959,0.625141563,6388
f2f4c9891a652be35212aba95d1149e4a79db030,0,Impala Public Jenkins,2020-05-15 21:46:38+00:00,['bd4d01a379fa483baf7524c0effb981c2fb0c742'],1,1,2,16600432,1,,,,6388
f7770f1d203e1edc24c5f147f4cc4bb56c3e34fc,0,Impala Public Jenkins,2020-05-15 22:25:56+00:00,['f2f4c9891a652be35212aba95d1149e4a79db030'],101,785,886,16601318,12,0.594117647,0.791176471,0.573529412,6389
29a7ce67f532ca1667308eb457252a2254ce6ac9,1,Impala Public Jenkins,2020-05-16 22:39:40+00:00,['f7770f1d203e1edc24c5f147f4cc4bb56c3e34fc'],3,46,49,16601367,3,,,,6389
7b8d2e1f78f30fe25e14bea2e5308e80786a4adc,0,Impala Public Jenkins,2020-05-18 16:51:42+00:00,['29a7ce67f532ca1667308eb457252a2254ce6ac9'],1,21,22,16601389,3,1,1,0,6390
a161881fbd83ca5358f56290741abf122f11de8a,0,Tim Armstrong,2020-05-19 02:49:08+00:00,['7b8d2e1f78f30fe25e14bea2e5308e80786a4adc'],2,4,6,16601395,2,,,,6390
a11106e794e793813a86840c2d8599cf149cc7a6,1,Impala Public Jenkins,2020-05-19 20:56:16+00:00,['a161881fbd83ca5358f56290741abf122f11de8a'],7,13,20,16601415,1,1,1,1,6390
95ee26354dc0ce61e5844430d1eaf553fd13d154,0,Impala Public Jenkins,2020-05-20 05:21:42+00:00,['a11106e794e793813a86840c2d8599cf149cc7a6'],4,7,11,16601426,1,0,0,1,6390
3e76da9f51763a5789195eb8ec3c786c391a0dc3,1,Joe McDonnell,2020-05-20 17:43:40+00:00,['95ee26354dc0ce61e5844430d1eaf553fd13d154'],9077,93,9170,16610596,81,0.603919404,0.290919128,0.402428926,6390
f8015ff68dddcc7e9813b3fec7953d87627ca5ab,1,Impala Public Jenkins,2020-05-20 21:00:44+00:00,['3e76da9f51763a5789195eb8ec3c786c391a0dc3'],188,1424,1612,16612208,43,0.302390999,0.628691983,0.741209564,6399
e5777f0eb8b42a582afdf048e1728f3676665bb0,1,Impala Public Jenkins,2020-05-20 23:03:23+00:00,['f8015ff68dddcc7e9813b3fec7953d87627ca5ab'],232,1187,1419,16613627,33,0.728395062,0.24691358,0.839506173,6403
29591eb7ad5a31c9cff201550d257aa74ce09013,0,Impala Public Jenkins,2020-05-21 01:33:58+00:00,['e5777f0eb8b42a582afdf048e1728f3676665bb0'],10,17,27,16613654,1,0,1,1,6403
2e07d0c07febf1d1ee9324708d543b792fb45b00,0,Impala Public Jenkins,2020-05-21 05:01:45+00:00,['29591eb7ad5a31c9cff201550d257aa74ce09013'],78,249,327,16613981,12,0.229166667,0.208333333,0.9375,6403
fb28011b5737f941e49de6bd6c53081d34a0f4d5,0,Impala Public Jenkins,2020-05-21 18:40:20+00:00,['2e07d0c07febf1d1ee9324708d543b792fb45b00'],2,22,24,16614005,3,1,1,1,6403
86e611bdb2a912e283ce1db01bf2940ee1583ff3,0,Impala Public Jenkins,2020-05-21 22:10:28+00:00,['fb28011b5737f941e49de6bd6c53081d34a0f4d5'],16,57,73,16614078,5,0.166666667,0,0,6403
8b09343e7dc75f30f25be9544c6d64818f0cc05a,0,Tim Armstrong,2020-05-22 05:07:00+00:00,['86e611bdb2a912e283ce1db01bf2940ee1583ff3'],5401,4721,10122,16624200,20,0.630081301,0.444250871,0.027293844,6410
a89b14ddec14cb05831f63cd26c862f536b08e8f,0,Impala Public Jenkins,2020-05-22 10:35:13+00:00,['8b09343e7dc75f30f25be9544c6d64818f0cc05a'],1,1,2,16624202,1,,,,6410
dd36732b790574bb94ac4a4be7c819034b6b6a37,0,Tim Armstrong,2020-05-22 19:06:43+00:00,['a89b14ddec14cb05831f63cd26c862f536b08e8f'],1,2,3,16624205,1,,,,6410
11a1ee55b0881104b0076880fc818a4cd83fe18a,0,Bikramjeet Vig,2020-05-22 20:21:53+00:00,['dd36732b790574bb94ac4a4be7c819034b6b6a37'],73,55,128,16624333,1,,,,6410
2b9c0cc7268994f7fd168897e85525f66ada5c25,0,Impala Public Jenkins,2020-05-24 02:58:59+00:00,['11a1ee55b0881104b0076880fc818a4cd83fe18a'],0,7,7,16624340,1,1,1,1,6410
5c69e7ba583297dc886652ac5952816882b928af,1,Impala Public Jenkins,2020-05-26 19:25:51+00:00,['2b9c0cc7268994f7fd168897e85525f66ada5c25'],55,259,314,16624654,9,0.368,0.976,0.984,6410
febce6519f5791e5578608eac4d68f5f9ccb0457,0,Impala Public Jenkins,2020-05-27 03:18:05+00:00,['5c69e7ba583297dc886652ac5952816882b928af'],5,11,16,16624670,2,0,0,0,6410
b8496d56e49814c36edadbff17b80b10bf40a3a2,0,Impala Public Jenkins,2020-05-28 00:05:11+00:00,['febce6519f5791e5578608eac4d68f5f9ccb0457'],1,6,7,16624677,1,1,1,0,6410
974fce33dc5d41579ac6aa25f0a803fbd165d634,0,Impala Public Jenkins,2020-05-28 20:26:28+00:00,['b8496d56e49814c36edadbff17b80b10bf40a3a2'],0,6,6,16624683,1,1,1,1,6410
a1485177d45df304ba16f158a871287c1415da91,0,Impala Public Jenkins,2020-05-28 22:26:29+00:00,['974fce33dc5d41579ac6aa25f0a803fbd165d634'],1,4,5,16624688,1,0,0,1,6410
b67c0906f596ca336d0ea0e8cbc618a20ac0e563,1,Impala Public Jenkins,2020-05-29 01:26:58+00:00,['a1485177d45df304ba16f158a871287c1415da91'],385,699,1084,16625772,56,0.119047619,0.555555556,1,6413
f39ddb1443eaa588ec85254d0a4aefe95f105b7a,0,Impala Public Jenkins,2020-05-29 01:57:20+00:00,['b67c0906f596ca336d0ea0e8cbc618a20ac0e563'],11,29,40,16625812,6,0,0.388888889,0.444444444,6413
4cc1b4ad04cd5770a41961269d69a65cdfac1dcf,0,Impala Public Jenkins,2020-05-29 03:15:16+00:00,['f39ddb1443eaa588ec85254d0a4aefe95f105b7a'],2,2,4,16625816,1,,,,6413
227da84c3757eb857008e7b82aad622ed959eb84,0,Impala Public Jenkins,2020-05-29 03:51:11+00:00,['4cc1b4ad04cd5770a41961269d69a65cdfac1dcf'],4,9,13,16625829,3,0,0,1,6413
a75b5ec0456f3dccf3f9579e252676f621f65bdd,1,Laszlo Gaal,2020-05-29 15:12:06+00:00,['227da84c3757eb857008e7b82aad622ed959eb84'],3,3,6,16625835,1,,,,6413
e0734913becaf9b600ea0919c08855149467d6b5,0,Tim Armstrong,2020-05-29 16:50:20+00:00,['a75b5ec0456f3dccf3f9579e252676f621f65bdd'],0,4,4,16625839,1,0,0,1,6413
7a2e80cf602b8c13d935cfc06a2a55a3c48f8d0b,0,Joe McDonnell,2020-05-30 00:58:30+00:00,['e0734913becaf9b600ea0919c08855149467d6b5'],9,4,13,16625852,3,1,1,0,6413
f474b03dce35956d0762159eed16516b793903eb,0,Impala Public Jenkins,2020-05-30 01:22:32+00:00,['7a2e80cf602b8c13d935cfc06a2a55a3c48f8d0b'],5,7,12,16625864,1,1,1,1,6413
56ee90c598dcc637f10647ffc3e03cc0a70b92ce,1,Joe McDonnell,2020-05-30 16:25:37+00:00,['f474b03dce35956d0762159eed16516b793903eb'],78,105,183,16626047,24,0.333333333,0.666666667,0.666666667,6413
30f68dbe111c6c23394e805dfdf8ae63cedce57c,1,Thomas Tauber-Marshall,2020-06-01 15:49:19+00:00,['56ee90c598dcc637f10647ffc3e03cc0a70b92ce'],16,25,41,16626088,1,,,,6413
b82ae24458b6b52cb9c095ba31cc35b1c818b384,0,Tim Armstrong,2020-06-01 18:29:53+00:00,['30f68dbe111c6c23394e805dfdf8ae63cedce57c'],4,0,4,16626092,1,,,,6413
00aef7f79e045e3f07019112b86e2de6220c40b2,0,Impala Public Jenkins,2020-06-01 20:45:57+00:00,['b82ae24458b6b52cb9c095ba31cc35b1c818b384'],0,22,22,16626114,1,,,,6413
00ef25888080bb1ec792c01177ab6ebcff447c5d,0,Sahil Takiar,2020-06-01 21:25:48+00:00,['00aef7f79e045e3f07019112b86e2de6220c40b2'],0,2,2,16626116,1,,,,6413
b1883405cd59988b92df2799656666ff2f733c0e,0,Joe McDonnell,2020-06-01 22:04:27+00:00,['00ef25888080bb1ec792c01177ab6ebcff447c5d'],4,13,17,16626133,4,0.6,0.6,1,6413
a7866a94578be6289bbac31686de4d9032ad9261,0,Impala Public Jenkins,2020-06-01 22:47:16+00:00,['b1883405cd59988b92df2799656666ff2f733c0e'],1,1,2,16626135,1,,,,6413
052129c16a29891a72427b351bcc4e087d772fbe,1,Impala Public Jenkins,2020-06-01 23:34:38+00:00,['a7866a94578be6289bbac31686de4d9032ad9261'],410,697,1107,16627242,19,0.571428571,1,0.897959184,6413
75fb96415119b3b807ce52f809763893930411c5,0,Impala Public Jenkins,2020-06-02 05:00:20+00:00,['052129c16a29891a72427b351bcc4e087d772fbe'],1,3,4,16627246,1,,,,6413
bfdc5bf6af2703127d4ff5611ed049f11b2cb004,0,Impala Public Jenkins,2020-06-02 14:01:23+00:00,['75fb96415119b3b807ce52f809763893930411c5'],7,25,32,16627278,2,1,1,1,6413
69b0b15f59169520cdffdbc31f90a5a04aea79e0,0,Impala Public Jenkins,2020-06-03 00:50:18+00:00,['bfdc5bf6af2703127d4ff5611ed049f11b2cb004'],6,2,8,16627286,3,,,,6413
37b5599a7a25536a6e5265788cf4e139db3b0cfa,0,Impala Public Jenkins,2020-06-03 02:03:06+00:00,['69b0b15f59169520cdffdbc31f90a5a04aea79e0'],3,24,27,16627313,3,0.666666667,0.666666667,0,6414
3c715864674004011dd87e01187f6ed378506a91,0,Impala Public Jenkins,2020-06-03 20:12:57+00:00,['37b5599a7a25536a6e5265788cf4e139db3b0cfa'],1,35,36,16627349,2,0,0.75862069,0.75862069,6414
3713d5db8dcac540ce0b5cb45974054ca87792db,0,Impala Public Jenkins,2020-06-03 21:59:23+00:00,['3c715864674004011dd87e01187f6ed378506a91'],8,3,11,16627360,1,1,1,1,6414
6a1c448cf71c122c9c81b9434d64b80251464832,0,Impala Public Jenkins,2020-06-05 00:40:33+00:00,['3713d5db8dcac540ce0b5cb45974054ca87792db'],44,129,173,16627533,6,1,1,0.44,6414
c62a6808fc379f812a2eaa2363d3c3c18a1836b0,1,Thomas Tauber-Marshall,2020-06-05 17:43:32+00:00,['6a1c448cf71c122c9c81b9434d64b80251464832'],661,2024,2685,16630218,36,0.26119403,0.432835821,0.111940299,6417
03f2b559c31af7fc11165cf3b00876900e234663,0,Anurag Mantripragada,2020-06-05 18:27:02+00:00,['c62a6808fc379f812a2eaa2363d3c3c18a1836b0'],1,7,8,16630226,1,,,,6417
d45e3a50b003259e4ef1023333b47781a028eb19,1,Impala Public Jenkins,2020-06-05 23:48:53+00:00,['03f2b559c31af7fc11165cf3b00876900e234663'],34,78,112,16630338,8,0,0,0,6417
51687e54265aa833453b8574cf21fe615e3da556,0,Tim Armstrong,2020-06-08 15:52:41+00:00,['d45e3a50b003259e4ef1023333b47781a028eb19'],1,1,2,16630340,1,,,,6417
1d83168cdc3954dd6a19ac87371b225f374e2f30,0,Impala Public Jenkins,2020-06-08 23:47:43+00:00,['51687e54265aa833453b8574cf21fe615e3da556'],0,23,23,16630363,1,,,,6417
dbd454445165829541c9e2c67cce5446bb535f46,1,Impala Public Jenkins,2020-06-09 02:28:03+00:00,['1d83168cdc3954dd6a19ac87371b225f374e2f30'],3,4,7,16630370,1,,,,6417
9125de7ae3d2ba0eca59097fd9732a6fbb609107,1,Joe McDonnell,2020-06-09 16:26:23+00:00,['dbd454445165829541c9e2c67cce5446bb535f46'],1,170,171,16630541,9,0.655172414,0.75862069,1,6420
ad8f468871d3a893bf4c7b702025ec70765ce8e1,0,Impala Public Jenkins,2020-06-09 17:15:54+00:00,['9125de7ae3d2ba0eca59097fd9732a6fbb609107'],115,113,228,16630769,5,1,0,0,6420
f9cb0a65fe68411e03a57681611cbcc87dfaaf50,0,Impala Public Jenkins,2020-06-10 04:02:16+00:00,['ad8f468871d3a893bf4c7b702025ec70765ce8e1'],795,158,953,16631722,17,0.704477612,0.191044776,0.23880597,6420
0bc22205d8647063098562502202bec0f0593b55,0,Impala Public Jenkins,2020-06-10 04:12:39+00:00,['f9cb0a65fe68411e03a57681611cbcc87dfaaf50'],2,25,27,16631749,4,,,,6420
e389e857479efa56aab59476e07a23221d66a4c7,0,Impala Public Jenkins,2020-06-10 05:05:07+00:00,['0bc22205d8647063098562502202bec0f0593b55'],8,18,26,16631775,1,1,1,1,6420
3088ca8580ed2f8c87235cbee3f3b3a90c292218,1,Sahil Takiar,2020-06-10 17:46:21+00:00,['e389e857479efa56aab59476e07a23221d66a4c7'],37,141,178,16631953,6,0.783333333,0.783333333,0.683333333,6421
bf5b20d17c38934ea879321463fbe6a9921731c3,0,Impala Public Jenkins,2020-06-11 04:02:49+00:00,['3088ca8580ed2f8c87235cbee3f3b3a90c292218'],13,145,158,16632111,3,0.857142857,0.857142857,0.857142857,6422
fb282852ef52d72079a86c55a90982ffac567cc7,0,Joe McDonnell,2020-06-12 01:54:16+00:00,['bf5b20d17c38934ea879321463fbe6a9921731c3'],4,195,199,16632310,4,0.4875,0.6875,0.925,6423
67b4764853ed08b1861bcc854adc047ae9420676,0,Impala Public Jenkins,2020-06-12 04:01:37+00:00,['fb282852ef52d72079a86c55a90982ffac567cc7'],134,213,347,16632657,9,0,0,0.107142857,6423
0cb44242d20532945e5fb09f5bbef6c65415a753,1,Impala Public Jenkins,2020-06-12 12:36:40+00:00,['67b4764853ed08b1861bcc854adc047ae9420676'],182,1168,1350,16634007,22,0.221138211,0.73495935,1,6424
6ca6e403580dc592c026b4f684d31f8a4dcfae11,0,Impala Public Jenkins,2020-06-12 13:39:36+00:00,['0cb44242d20532945e5fb09f5bbef6c65415a753'],3,10,13,16634020,3,0,0,0,6424
f8c28f8adfd781727c311b15546a532ce65881e0,0,Vihang Karajgaonkar,2020-06-12 18:46:11+00:00,['6ca6e403580dc592c026b4f684d31f8a4dcfae11'],3,30,33,16634053,2,,,,6424
38b96174621c7d2f58b580d1e2bba4b95b261d1c,0,Impala Public Jenkins,2020-06-15 22:07:15+00:00,['f8c28f8adfd781727c311b15546a532ce65881e0'],1,1,2,16634055,1,,,,6424
f15a311065f2d30b727d53d96fae87f07132e4d9,0,Joe McDonnell,2020-06-15 23:42:12+00:00,['38b96174621c7d2f58b580d1e2bba4b95b261d1c'],346,88,434,16634489,65,1,0.92,0.64,6424
13fbe510c0d70a8cbe82f0ca83f59b3faf5353c8,0,Joe McDonnell,2020-06-15 23:42:12+00:00,['f15a311065f2d30b727d53d96fae87f07132e4d9'],27,36,63,16634552,17,,,,6424
419aa2e30db326f02e9b4ec563ef7864e82df86e,1,Impala Public Jenkins,2020-06-16 06:30:27+00:00,['13fbe510c0d70a8cbe82f0ca83f59b3faf5353c8'],503,810,1313,16635865,11,0.563157895,1,1,6424
ee70df2e9006d3592175af5f1fa7ec128f5f1b8d,0,Impala Public Jenkins,2020-06-16 12:51:29+00:00,['419aa2e30db326f02e9b4ec563ef7864e82df86e'],22,43,65,16635930,2,0.6,1,1,6424
692db778f8375a800ef5e7c7ac671bffb5f95807,0,Tim Armstrong,2020-06-17 04:53:23+00:00,['ee70df2e9006d3592175af5f1fa7ec128f5f1b8d'],16,1,17,16635947,2,,,,6424
aa6d7887eec1efd33c73f77e5346a499569e5b6b,0,Joe McDonnell,2020-06-17 05:15:36+00:00,['692db778f8375a800ef5e7c7ac671bffb5f95807'],2,11,13,16635960,1,1,1,1,6424
bf945824e62a48822414c9375d6641dc499846a9,0,Impala Public Jenkins,2020-06-17 06:47:28+00:00,['aa6d7887eec1efd33c73f77e5346a499569e5b6b'],1,1,2,16635962,1,,,,6424
a89489cbc8c8a4b4a9222e0de318ae0d0d8ad26e,0,Impala Public Jenkins,2020-06-17 06:54:50+00:00,['bf945824e62a48822414c9375d6641dc499846a9'],0,505,505,16636467,8,0.142857143,0.142857143,1,6431
d38e4d10de98d46c4b5b6a4f5ef0a9b9bbb61dae,0,Joe McDonnell,2020-06-17 14:57:58+00:00,['a89489cbc8c8a4b4a9222e0de318ae0d0d8ad26e'],272,1507,1779,16638246,9,0.359805511,0.526742301,0.889789303,6435
fd810e6f0926e0651c0ae30dd7ae654962701b95,0,Joe McDonnell,2020-06-17 20:08:59+00:00,['d38e4d10de98d46c4b5b6a4f5ef0a9b9bbb61dae'],6,0,6,16638252,1,,,,6435
23bb0859ccf027d46f4e8b079330f4bd73161f4c,0,Impala Public Jenkins,2020-06-17 22:48:20+00:00,['fd810e6f0926e0651c0ae30dd7ae654962701b95'],8,9,17,16638269,3,0,0,1,6435
6ec6aaae8edc552feb3416bebba0ed355c36e46e,0,Impala Public Jenkins,2020-06-18 01:11:18+00:00,['23bb0859ccf027d46f4e8b079330f4bd73161f4c'],292,80,372,16638641,30,0.790697674,0.829457364,0.015503876,6435
3ba6fcb47909af7c4f22493a94cd08e9b9689a88,0,Impala Public Jenkins,2020-06-18 10:07:20+00:00,['6ec6aaae8edc552feb3416bebba0ed355c36e46e'],3,7,10,16638651,2,,,,6435
dc5046487ae66b37a2fdca19e55b9daf8bf410c7,1,Vihang Karajgaonkar,2020-06-18 16:54:29+00:00,['3ba6fcb47909af7c4f22493a94cd08e9b9689a88'],37,72,109,16638760,4,0.052631579,1,1,6435
2c76ff5e6e49a56688ad1d9b4d1a8b4731fb5271,0,Impala Public Jenkins,2020-06-18 21:00:27+00:00,['dc5046487ae66b37a2fdca19e55b9daf8bf410c7'],19,105,124,16638884,7,1,1,0,6437
8fcad905a12d018eb0a354f7e4793e5b0d5efd3b,1,Impala Public Jenkins,2020-06-18 21:56:32+00:00,['2c76ff5e6e49a56688ad1d9b4d1a8b4731fb5271'],16,1594,1610,16640494,33,0.409566517,0.597907324,0.777279522,6446
b02fad2db48b5725483fc52098a0c6c04806394b,0,Impala Public Jenkins,2020-06-18 22:03:24+00:00,['8fcad905a12d018eb0a354f7e4793e5b0d5efd3b'],34,175,209,16640703,13,0.486486486,0.621621622,0.945945946,6446
950e51f9a8531b9388d8e427e5e76dcf13048362,0,Impala Public Jenkins,2020-06-18 23:52:02+00:00,['b02fad2db48b5725483fc52098a0c6c04806394b'],1,4,5,16640708,1,0,0,1,6446
004e3c897e4890adb7d751b881b31ca71f5a533d,1,Impala Public Jenkins,2020-06-19 01:35:29+00:00,['950e51f9a8531b9388d8e427e5e76dcf13048362'],52,110,162,16640870,8,0.772727273,0,1,6446
17fd15c6e4981499932c02d541c76757a5fdf87d,0,Impala Public Jenkins,2020-06-19 21:03:31+00:00,['004e3c897e4890adb7d751b881b31ca71f5a533d'],15,37,52,16640922,5,0.222222222,0.222222222,0.888888889,6446
d82cefc6a4d2d8e12c507bae4c29da592a4341eb,1,Tim Armstrong,2020-06-22 21:36:09+00:00,['17fd15c6e4981499932c02d541c76757a5fdf87d'],7,416,423,16641345,12,0.166666667,0.920634921,0.996031746,6448
7b1cfacbc6c4c709947cb91517baa9ec364afee1,0,Joe McDonnell,2020-06-22 22:10:16+00:00,['d82cefc6a4d2d8e12c507bae4c29da592a4341eb'],1,1,2,16641347,1,,,,6448
dcf0fe43bc31bdbc845b992d64197fad38fc079b,0,Impala Public Jenkins,2020-06-23 02:42:37+00:00,['7b1cfacbc6c4c709947cb91517baa9ec364afee1'],2,8,10,16641357,2,0,0,0,6448
839cd0ba5a185cee55d9bb8f5344bda2df7cbbce,0,Impala Public Jenkins,2020-06-23 18:47:53+00:00,['dcf0fe43bc31bdbc845b992d64197fad38fc079b'],2,2,4,16641361,1,,,,6448
4d4c364258019cff4a4f2e9191b02e9b7efa19a8,1,Impala Public Jenkins,2020-06-23 23:53:39+00:00,['839cd0ba5a185cee55d9bb8f5344bda2df7cbbce'],3,2,5,16641366,1,,,,6448
b6ed07bd75140b01c5bcde5fdb096d2ddcb1a650,0,Impala Public Jenkins,2020-06-24 01:58:47+00:00,['4d4c364258019cff4a4f2e9191b02e9b7efa19a8'],0,2,2,16641368,1,1,1,1,6448
71a64591e35b5de818ca0cc1212b720d2e69c111,1,Impala Public Jenkins,2020-06-24 03:47:18+00:00,['b6ed07bd75140b01c5bcde5fdb096d2ddcb1a650'],465,315,780,16642148,20,0.379310345,0.137931034,0.413793103,6448
e6c930a38f54899e66ad83ab88d886dcd4c869f9,0,Impala Public Jenkins,2020-06-24 16:51:49+00:00,['71a64591e35b5de818ca0cc1212b720d2e69c111'],19,73,92,16642240,8,0.789473684,0.473684211,0,6448
eef61d22d89b97eb589936701a41d05d84b0da8a,0,Impala Public Jenkins,2020-06-25 21:55:10+00:00,['e6c930a38f54899e66ad83ab88d886dcd4c869f9'],80,424,504,16642744,9,0.464,0.72,0.776,6448
62729980d9b0b458f8eeff506ce4f2456b16dfc1,1,Impala Public Jenkins,2020-06-26 00:05:53+00:00,['eef61d22d89b97eb589936701a41d05d84b0da8a'],10,212,222,16642966,6,1,0,1,6448
c7ce4fa109043ad0e0a5def73df3bedc322a6d84,1,Impala Public Jenkins,2020-06-26 06:56:16+00:00,['62729980d9b0b458f8eeff506ce4f2456b16dfc1'],30,311,341,16643307,7,0.227272727,0,0.568181818,6448
3b9ae415e22296683fd905e590c02fe7de3d668c,0,Impala Public Jenkins,2020-06-26 10:20:41+00:00,['c7ce4fa109043ad0e0a5def73df3bedc322a6d84'],50,371,421,16643728,4,0.04845815,0.9030837,0.779735683,6448
a11b8b687a97c25d1df09cab4d0bb5d2101cbada,0,Tim Armstrong,2020-06-26 19:46:15+00:00,['3b9ae415e22296683fd905e590c02fe7de3d668c'],6,23,29,16643757,8,0,0,0,6448
94c1b6354b9da14db7ea9e59f09fcb06bae2acfe,0,Impala Public Jenkins,2020-06-27 03:54:05+00:00,['a11b8b687a97c25d1df09cab4d0bb5d2101cbada'],15,258,273,16644030,6,0.037037037,0.37654321,1,6448
930264afbdc6d309a30e2c7e1eef9fd7129ef29b,1,Impala Public Jenkins,2020-06-29 21:00:05+00:00,['94c1b6354b9da14db7ea9e59f09fcb06bae2acfe'],76,711,787,16644817,16,0.264317181,0.281938326,0.634361233,6450
931063f0f2afc9cf6ea139b431db1a39f12e1f6e,0,Impala Public Jenkins,2020-06-30 05:58:02+00:00,['930264afbdc6d309a30e2c7e1eef9fd7129ef29b'],13,96,109,16644926,7,0,0.161290323,0.758064516,6450
1fbca6d43bc3fb08b9e04a4eb8e1c1dcf7c67712,0,Impala Public Jenkins,2020-06-30 12:11:24+00:00,['931063f0f2afc9cf6ea139b431db1a39f12e1f6e'],28,120,148,16645074,5,0.196721311,0.770491803,0.442622951,6450
2a48f7dd98c8af64f05f88e17b62c42c076c8bda,0,Impala Public Jenkins,2020-06-30 13:06:33+00:00,['1fbca6d43bc3fb08b9e04a4eb8e1c1dcf7c67712'],1,2622,2623,16647697,26,1,1,1,6473
36ced942d84e7237de28a0ebfae785139dbd3836,0,Impala Public Jenkins,2020-06-30 19:33:24+00:00,['2a48f7dd98c8af64f05f88e17b62c42c076c8bda'],4,7,11,16647708,1,0,0,1,6473
8aeb28287f40987a755d5352a51cef24cf1f6c74,1,Impala Public Jenkins,2020-06-30 21:46:27+00:00,['36ced942d84e7237de28a0ebfae785139dbd3836'],35,54,89,16647797,2,1,1,0.2,6473
b142d0324cb155fd8dbda704ed569583eeed8af5,1,Impala Public Jenkins,2020-06-30 22:06:48+00:00,['8aeb28287f40987a755d5352a51cef24cf1f6c74'],779,1085,1864,16649661,34,0.177419355,0.516129032,0.5,6476
e4a3e9a35eeb3f2791f4f80e76ca35f9a048f13b,1,Impala Public Jenkins,2020-07-01 00:16:53+00:00,['b142d0324cb155fd8dbda704ed569583eeed8af5'],10,10,20,16649681,2,,,,6476
6c8a3dfc339e43a8992af2ff3429ba5940a061ec,1,Impala Public Jenkins,2020-07-01 17:31:52+00:00,['e4a3e9a35eeb3f2791f4f80e76ca35f9a048f13b'],442,958,1400,16651081,56,0.930635838,0.826589595,0.710982659,6478
40d037549dc69ac85c0096c4e9db620d8523611b,0,Impala Public Jenkins,2020-07-02 05:19:41+00:00,['6c8a3dfc339e43a8992af2ff3429ba5940a061ec'],0,261,261,16651342,1,0.042553191,0.042553191,0.09929078,6478
08a7569d4c372d6fb5003609c31c87a55db4e71b,0,Impala Public Jenkins,2020-07-02 11:24:44+00:00,['40d037549dc69ac85c0096c4e9db620d8523611b'],329,326,655,16651997,9,0.166666667,1,1,6478
49af396c1057ad8d3cd073cfe87d002c1dbae2fe,0,Impala Public Jenkins,2020-07-04 23:07:49+00:00,['08a7569d4c372d6fb5003609c31c87a55db4e71b'],0,1,1,16651998,1,0,1,1,6478
388ad555d7df9e2711ea0ab81dbae4235c54b3cc,1,Tim Armstrong,2020-07-05 22:03:42+00:00,['49af396c1057ad8d3cd073cfe87d002c1dbae2fe'],18,1572,1590,16653588,13,0,0.064,1,6480
2dca55695ef3c208ece543ad36bece2a985cf8da,0,Tim Armstrong,2020-07-05 22:03:42+00:00,['388ad555d7df9e2711ea0ab81dbae4235c54b3cc'],22,1192,1214,16654802,12,0.039215686,0.107843137,0.980392157,6485
24f24b131f0c40efe2aaff3ebcff9fe1cdeb6c88,0,Impala Public Jenkins,2020-07-06 23:47:45+00:00,['2dca55695ef3c208ece543ad36bece2a985cf8da'],2,40,42,16654844,4,1,1,1,6486
9429ca7aa2fe127af11073b2fc09bc8e62d2e410,0,Impala Public Jenkins,2020-07-07 01:00:43+00:00,['24f24b131f0c40efe2aaff3ebcff9fe1cdeb6c88'],5,5,10,16654854,3,,,,6486
7e456dfa9d932bcdb317ad6477abc3c399abacf2,1,Gabor Kaszab,2020-07-07 14:11:21+00:00,['9429ca7aa2fe127af11073b2fc09bc8e62d2e410'],8,505,513,16655367,17,0.813793103,0.813793103,0.682758621,6491
7a5b1bab5adde5cdf4cd3f772edc5631efd3737e,0,Impala Public Jenkins,2020-07-07 20:49:21+00:00,['7e456dfa9d932bcdb317ad6477abc3c399abacf2'],23,759,782,16656149,10,0.226107226,0.687645688,0.997668998,6492
e9f8a2c085313f2c7b9513e44f5c3a789231726c,1,Impala Public Jenkins,2020-07-08 04:07:35+00:00,['7a5b1bab5adde5cdf4cd3f772edc5631efd3737e'],626,632,1258,16657407,9,0.125,0.125,0.75,6492
3b820d777442dbec244a924604f47952479c2fff,0,Impala Public Jenkins,2020-07-08 04:40:07+00:00,['e9f8a2c085313f2c7b9513e44f5c3a789231726c'],1,15,16,16657423,1,0,1,1,6492
1bafb7bd29f4ecf1706d35e274c2b701a32281ac,1,Gabor Kaszab,2020-07-08 19:32:15+00:00,['3b820d777442dbec244a924604f47952479c2fff'],228,275,503,16657926,34,1,1,0,6496
45c105d71d47c4c57e042b9bf8a0d8d8044083bc,0,Impala Public Jenkins,2020-07-08 20:23:03+00:00,['1bafb7bd29f4ecf1706d35e274c2b701a32281ac'],21,35,56,16657982,6,0,1,1,6496
55099517b059eadb064674768488bfd3287f649a,1,Impala Public Jenkins,2020-07-08 22:59:57+00:00,['45c105d71d47c4c57e042b9bf8a0d8d8044083bc'],167,295,462,16658444,12,0.575757576,0,0,6496
65722d3e9051d6a08cb1e69fd36a06684745c226,0,Impala Public Jenkins,2020-07-09 04:13:22+00:00,['55099517b059eadb064674768488bfd3287f649a'],5,20,25,16658469,2,0,1,0,6496
17b083d371c8e62c30a5cc7fe6c4aa474866f289,0,Impala Public Jenkins,2020-07-09 21:10:02+00:00,['65722d3e9051d6a08cb1e69fd36a06684745c226'],20,65,85,16658554,6,1,1,1,6496
70c2073d02675ffc64b09335e6c3a2744bc6d961,1,Impala Public Jenkins,2020-07-09 21:10:32+00:00,['17b083d371c8e62c30a5cc7fe6c4aa474866f289'],2,16,18,16658572,1,1,1,0.333333333,6496
dadc3bd61bfb23ad6ef713309b79f9c7bd9b4909,0,Tim Armstrong,2020-07-10 17:26:06+00:00,['70c2073d02675ffc64b09335e6c3a2744bc6d961'],1,32,33,16658605,4,,,,6496
605e301739b8ef7619482db9b13444e84145b219,0,Impala Public Jenkins,2020-07-13 00:13:19+00:00,['dadc3bd61bfb23ad6ef713309b79f9c7bd9b4909'],10,64,74,16658679,2,,,,6496
fea5dffec5bcaba5eb0be4a6aad29c03a86c2da3,1,Tim Armstrong,2020-07-13 16:02:27+00:00,['605e301739b8ef7619482db9b13444e84145b219'],61,1436,1497,16660176,10,0.150837989,0.905027933,0.642458101,6497
4e2498da6f94a8da78a077bb9e44ff85a66523d0,1,Impala Public Jenkins,2020-07-13 22:38:36+00:00,['fea5dffec5bcaba5eb0be4a6aad29c03a86c2da3'],26,463,489,16660665,8,0.52173913,0.565217391,1,6497
fc19e70cbc94735c38e64573c1e015878f218281,0,Impala Public Jenkins,2020-07-14 00:03:14+00:00,['4e2498da6f94a8da78a077bb9e44ff85a66523d0'],169,188,357,16661022,5,1,0.833333333,0.666666667,6497
3e1e7da229913ac1651ea908e8817d6e41adf8b0,0,Tim Armstrong,2020-07-14 03:13:18+00:00,['fc19e70cbc94735c38e64573c1e015878f218281'],65,4287,4352,16665374,22,0.447368421,0.907894737,0.539473684,6504
574fef2a7690ff2543df0e5e11932b4957d40676,0,Tim Armstrong,2020-07-14 03:13:18+00:00,['3e1e7da229913ac1651ea908e8817d6e41adf8b0'],82,2686,2768,16668142,19,0.141891892,0.493243243,0.77027027,6509
f602c3f80f5f61ccaebdf1493ff7c89230b77410,1,Impala Public Jenkins,2020-07-14 12:53:51+00:00,['574fef2a7690ff2543df0e5e11932b4957d40676'],147,1706,1853,16669995,27,0.463013699,0.682191781,0.619178082,6511
6d1a707cf50c2297972a69a7c0469afe4a78d739,0,Impala Public Jenkins,2020-07-14 19:54:02+00:00,['f602c3f80f5f61ccaebdf1493ff7c89230b77410'],68,63,131,16670126,6,1,0,0,6511
0b5a9889ee39a7df816efc6476aae2624f82f377,0,Impala Public Jenkins,2020-07-14 22:23:41+00:00,['6d1a707cf50c2297972a69a7c0469afe4a78d739'],8,135,143,16670269,5,0.376623377,0.961038961,0.792207792,6511
63f5e8ec00d089dee7eee9fd47a931e356e2f985,1,Impala Public Jenkins,2020-07-15 17:10:50+00:00,['0b5a9889ee39a7df816efc6476aae2624f82f377'],465,3744,4209,16674478,25,0.395348837,0.244186047,0.244186047,6512
3a6022ce80ca1cedb629400b18caaf0d1f54137c,1,Tim Armstrong,2020-07-15 19:14:58+00:00,['63f5e8ec00d089dee7eee9fd47a931e356e2f985'],17,30,47,16674525,3,,,,6512
dabcedeca363051a9d73f2abb1a88ff230e41cc7,0,Impala Public Jenkins,2020-07-16 00:01:13+00:00,['3a6022ce80ca1cedb629400b18caaf0d1f54137c'],6,13,19,16674544,2,,,,6512
1ff7402ce332a44d4b28f837e57c04cd0e4eb0be,0,Impala Public Jenkins,2020-07-16 22:31:50+00:00,['dabcedeca363051a9d73f2abb1a88ff230e41cc7'],1,1,2,16674546,1,,,,6512
472f49705d9db315e5704b49e3eda7eed95bd921,0,Impala Public Jenkins,2020-07-20 06:50:38+00:00,['1ff7402ce332a44d4b28f837e57c04cd0e4eb0be'],3,58,61,16674607,4,0.227272727,0.909090909,1,6512
2561eae483bc540dc1abbd87c7cbc80eda8bc910,0,Impala Public Jenkins,2020-07-20 23:37:30+00:00,['472f49705d9db315e5704b49e3eda7eed95bd921'],85,289,374,16674981,3,0,1,1,6512
6cdc8b5ce7fd50bbb54d846594262ba766b22bed,0,Impala Public Jenkins,2020-07-21 02:43:56+00:00,['2561eae483bc540dc1abbd87c7cbc80eda8bc910'],3,40,43,16675024,3,0.666666667,0.666666667,0.833333333,6512
d12ceec23bbb11da171cb54a3370d22a904f1d2a,0,Impala Public Jenkins,2020-07-21 03:05:30+00:00,['6cdc8b5ce7fd50bbb54d846594262ba766b22bed'],0,23,23,16675047,1,1,1,1,6512
28b24effd864299d6a82208e30c5104c62696289,0,Tim Armstrong,2020-07-21 16:20:47+00:00,['d12ceec23bbb11da171cb54a3370d22a904f1d2a'],6,0,6,16675053,1,,,,6512
ee3f0538736d34ec39f4c647b4dd6adbf1a8469a,0,Impala Public Jenkins,2020-07-21 18:35:20+00:00,['28b24effd864299d6a82208e30c5104c62696289'],36,139,175,16675228,7,0,0.988372093,1,6512
ea95691b775ef0edd032a2590a119e6841cc2129,0,Impala Public Jenkins,2020-07-22 23:28:10+00:00,['ee3f0538736d34ec39f4c647b4dd6adbf1a8469a'],1,17,18,16675246,2,1,1,1,6512
4502097a2d6bc9d41da185762d231f7fe413224b,0,Impala Public Jenkins,2020-07-22 23:28:17+00:00,['ea95691b775ef0edd032a2590a119e6841cc2129'],2,6,8,16675254,1,0,1,1,6512
d3115a561d257ffba84e61664312b7150b8c888c,0,Impala Public Jenkins,2020-07-23 03:30:30+00:00,['4502097a2d6bc9d41da185762d231f7fe413224b'],72,162,234,16675488,5,1,0.973684211,0.605263158,6512
6f99cabdb9ab71d5c022b95716a276b04b5ba132,0,Impala Public Jenkins,2020-07-23 10:53:34+00:00,['d3115a561d257ffba84e61664312b7150b8c888c'],3,8,11,16675499,2,0,0.8,1,6512
09727a8d5105cc73bbb53e1be9038972b0b65bb3,1,Impala Public Jenkins,2020-07-23 17:13:43+00:00,['6f99cabdb9ab71d5c022b95716a276b04b5ba132'],10,224,234,16675733,15,0.658730159,0.857142857,0.904761905,6512
9c542ef5891f984300f9e5f45406caf145039e75,1,Impala Public Jenkins,2020-07-23 22:20:12+00:00,['09727a8d5105cc73bbb53e1be9038972b0b65bb3'],29,271,300,16676033,11,0.855421687,0.855421687,0.686746988,6515
d83074c5992d51d136a509639a038bde5c3393bf,0,Impala Public Jenkins,2020-07-24 05:49:53+00:00,['9c542ef5891f984300f9e5f45406caf145039e75'],1,18,19,16676052,2,0.090909091,1,0.909090909,6515
ee18dc383ed7f62630c9e770d14f5851a8747b81,0,Impala Public Jenkins,2020-07-24 20:33:47+00:00,['d83074c5992d51d136a509639a038bde5c3393bf'],3,23,26,16676078,3,0,0,1,6515
6c3ff1927e0aeacd974d2869ef88dc0233de22d6,0,Impala Public Jenkins,2020-07-24 20:35:02+00:00,['ee18dc383ed7f62630c9e770d14f5851a8747b81'],28,97,125,16676203,4,0.4,1,1,6515
ebb5599aaaaee8df217e51378079b3647a31f128,1,Impala Public Jenkins,2020-07-25 04:28:20+00:00,['6c3ff1927e0aeacd974d2869ef88dc0233de22d6'],3,16,19,16676222,2,,,,6515
a8fd3213f6e54d73658b66cddcc5b0c955dda283,1,Impala Public Jenkins,2020-07-27 12:46:45+00:00,['ebb5599aaaaee8df217e51378079b3647a31f128'],348,3283,3631,16679853,29,0.423258959,0.54158215,0.645706558,6526
074731e2bcf37643710f2fdf236829991a462fc3,1,Vihang Karajgaonkar,2020-07-27 16:52:12+00:00,['a8fd3213f6e54d73658b66cddcc5b0c955dda283'],63,629,692,16680545,13,0.253869969,0.383900929,0.780185759,6526
21918ef18b166021577770cb55b70bb2ccad0213,0,Impala Public Jenkins,2020-07-28 18:25:22+00:00,['074731e2bcf37643710f2fdf236829991a462fc3'],5,28,33,16680578,2,,,,6526
a10ad2cad99a8a1b84b4faa23e28f2bad592db43,1,Impala Public Jenkins,2020-07-30 06:53:59+00:00,['21918ef18b166021577770cb55b70bb2ccad0213'],4,28,32,16680610,3,0.133333333,1,1,6526
b29cb4ca82a4f05ea7dc0eadc330a64fbe685ef0,0,Tim Armstrong,2020-07-30 17:46:44+00:00,['a10ad2cad99a8a1b84b4faa23e28f2bad592db43'],1,10,11,16680621,2,,,,6526
033a4607e2c9cd5a107a3af01f3fb3490bc5bc6e,1,Impala Public Jenkins,2020-07-31 14:34:49+00:00,['b29cb4ca82a4f05ea7dc0eadc330a64fbe685ef0'],22,333,355,16680976,12,0.694736842,0.694736842,0.547368421,6528
ea3f073881783baed17cea2d8bb718038cdfba8a,1,Tim Armstrong,2020-07-31 17:23:45+00:00,['033a4607e2c9cd5a107a3af01f3fb3490bc5bc6e'],801,5122,5923,16686899,30,0.168807339,0.555963303,0.880733945,6538
9d43cfdaeeb1e0a88af3b7aefdc28aa585927a03,1,Impala Public Jenkins,2020-07-31 21:39:08+00:00,['ea3f073881783baed17cea2d8bb718038cdfba8a'],14,195,209,16687108,9,0.3,0.677777778,0.966666667,6538
da2999afd9ddc45d35141649d17db507e03ee9bf,1,Impala Public Jenkins,2020-08-02 00:08:48+00:00,['9d43cfdaeeb1e0a88af3b7aefdc28aa585927a03'],32,86,118,16687226,8,0.875,0.125,0.916666667,6538
ecfc1af0db18de7ad47406b9bff3dcdfdb9d2a05,1,Impala Public Jenkins,2020-08-02 02:42:40+00:00,['da2999afd9ddc45d35141649d17db507e03ee9bf'],288,1673,1961,16689187,28,0.247863248,0.064102564,0.307692308,6541
521c81466f980b95972026a7ac112cfa47a3f854,0,Tim Armstrong,2020-08-03 04:30:13+00:00,['ecfc1af0db18de7ad47406b9bff3dcdfdb9d2a05'],45,104,149,16689336,6,0.033333333,0.166666667,0.166666667,6541
34c2be0c3847103a6a7f0a7d66de8add285abc66,0,Impala Public Jenkins,2020-08-04 05:40:05+00:00,['521c81466f980b95972026a7ac112cfa47a3f854'],43,161,204,16689540,14,0.314285714,0.857142857,0.585714286,6541
0a13029afccb374763fce7a916ef9da257a8bcde,1,Impala Public Jenkins,2020-08-04 05:56:03+00:00,['34c2be0c3847103a6a7f0a7d66de8add285abc66'],34,903,937,16690477,16,0.316129032,0.451612903,0.606451613,6542
e187c4054340ed8f00c35711185a2fd6719f48b3,1,Impala Public Jenkins,2020-08-04 22:33:58+00:00,['0a13029afccb374763fce7a916ef9da257a8bcde'],25,90,115,16690592,2,0.851851852,0.851851852,0.481481481,6542
15afacd124b2f889d42e1fc2db9b03e9ba9a6121,0,Impala Public Jenkins,2020-08-04 23:10:21+00:00,['e187c4054340ed8f00c35711185a2fd6719f48b3'],2,152,154,16690746,6,0.180327869,1,1,6543
cc1eddbe193daf228dee1d53bb1e4ccd064d90a5,0,Impala Public Jenkins,2020-08-05 06:13:06+00:00,['15afacd124b2f889d42e1fc2db9b03e9ba9a6121'],1,6,7,16690753,1,1,1,1,6543
f38ca7dbbbbf8cf027fcaab4713a6b186b584cef,0,Impala Public Jenkins,2020-08-05 23:07:43+00:00,['cc1eddbe193daf228dee1d53bb1e4ccd064d90a5'],42,1,43,16690796,1,0.740740741,0,0.740740741,6543
dc2fdabbd1f2c930348671e17f885c5c54b628e4,0,Joe McDonnell,2020-08-06 00:06:53+00:00,['f38ca7dbbbbf8cf027fcaab4713a6b186b584cef'],0,11,11,16690807,1,0,0,1,6543
c413f9b558d51de877f497590baf14139ad5cf99,0,Joe McDonnell,2020-08-06 15:06:41+00:00,['dc2fdabbd1f2c930348671e17f885c5c54b628e4'],3,1,4,16690811,1,1,0,0,6543
87aeb2ad78e2106f1d8df84d4d84975c7cde5b5a,0,Impala Public Jenkins,2020-08-06 19:15:04+00:00,['c413f9b558d51de877f497590baf14139ad5cf99'],1,56,57,16690868,5,1,1,1,6543
dbbd40308a6d1cef77bfe45e016e775c918e0539,1,Joe McDonnell,2020-08-06 20:12:14+00:00,['87aeb2ad78e2106f1d8df84d4d84975c7cde5b5a'],87,135,222,16691090,2,1,0.142857143,0,6543
86b70e9850cce0b45194a64cd89ae21df0e82029,0,Impala Public Jenkins,2020-08-07 01:00:36+00:00,['dbbd40308a6d1cef77bfe45e016e775c918e0539'],62,163,225,16691315,8,0.279411765,1,0.926470588,6543
7a6469e44486191cd344e9f7dcf681763d6091db,1,Impala Public Jenkins,2020-08-07 03:47:29+00:00,['86b70e9850cce0b45194a64cd89ae21df0e82029'],2,7,9,16691324,3,0.333333333,0.666666667,0.666666667,6543
bbec0443fcdabf5de6f7ae0e47595414503f30f0,0,Joe McDonnell,2020-08-07 03:53:13+00:00,['7a6469e44486191cd344e9f7dcf681763d6091db'],1,2,3,16691327,1,,,,6543
0736fcf69107dca187828b0be88bd74a6539cde2,0,Impala Public Jenkins,2020-08-07 12:58:40+00:00,['bbec0443fcdabf5de6f7ae0e47595414503f30f0'],5,76,81,16691408,4,1,1,0,6543
fab251efe3de449d22439dd17798cd414168748c,0,Tim Armstrong,2020-08-07 16:45:06+00:00,['0736fcf69107dca187828b0be88bd74a6539cde2'],11,175,186,16691594,4,0.058139535,0,0.848837209,6543
a0057788c5c2300f58b6615a27116b8331171e06,1,Impala Public Jenkins,2020-08-07 20:08:21+00:00,['fab251efe3de449d22439dd17798cd414168748c'],21,88,109,16691703,7,0.469387755,0.489795918,0.673469388,6543
99443559bd701275ab53c7b7daa5ce1d144f0d49,0,Impala Public Jenkins,2020-08-07 23:50:02+00:00,['a0057788c5c2300f58b6615a27116b8331171e06'],1,1,2,16691705,1,,0,,6543
f95f7940e4a290d75ee85fd78e85bc26795f0f9f,1,Impala Public Jenkins,2020-08-08 11:50:04+00:00,['99443559bd701275ab53c7b7daa5ce1d144f0d49'],29,194,223,16691928,7,0.306666667,0.84,0.453333333,6544
19f16a0f4889a59f7785bb88d059d2d8c335988d,0,Joe McDonnell,2020-08-11 16:41:43+00:00,['f95f7940e4a290d75ee85fd78e85bc26795f0f9f'],0,1,1,16691929,1,0,1,1,6544
ac63e19e0d3c797b08dcf80053fc8e3259d8472d,0,Joe McDonnell,2020-08-11 16:45:12+00:00,['19f16a0f4889a59f7785bb88d059d2d8c335988d'],0,5,5,16691934,1,,,,6544
7a02e370be2aada393d6ab062e1c959c712abb9f,0,Impala Public Jenkins,2020-08-12 04:45:20+00:00,['ac63e19e0d3c797b08dcf80053fc8e3259d8472d'],4,50,54,16691988,4,0,0.222222222,0.833333333,6544
5149ea7ea3f9bb6eb5b1304f6d09f74915696926,0,Impala Public Jenkins,2020-08-12 07:07:03+00:00,['7a02e370be2aada393d6ab062e1c959c712abb9f'],5,5,10,16691998,1,1,0,0,6544
da34d34a42ad1bb77d6911708f1363c53ac79018,1,Tim Armstrong,2020-08-12 17:45:50+00:00,['5149ea7ea3f9bb6eb5b1304f6d09f74915696926'],48,922,970,16692968,13,0.366197183,1,0.746478873,6545
3e77650dcf56c80ac2a200eaba5c8e12b9ce1b89,0,Impala Public Jenkins,2020-08-12 20:20:34+00:00,['da34d34a42ad1bb77d6911708f1363c53ac79018'],8,29,37,16693005,1,1,1,1,6545
d45aac59d9b6e4ce6bf6934b5a98c6fed6c5ad6b,0,Tim Armstrong,2020-08-13 02:22:31+00:00,['3e77650dcf56c80ac2a200eaba5c8e12b9ce1b89'],1,5,6,16693011,1,,,,6545
b8c61345c9b11d9977d153a63e0e440cf744b3cb,0,Tim Armstrong,2020-08-13 02:22:31+00:00,['d45aac59d9b6e4ce6bf6934b5a98c6fed6c5ad6b'],5,10,15,16693026,3,,,,6545
6f2a1d0a6257fcf0401178b0b4e5faf1463f99bc,0,Tim Armstrong,2020-08-13 02:22:31+00:00,['b8c61345c9b11d9977d153a63e0e440cf744b3cb'],3,9,12,16693038,1,0,1,1,6545
1ef12788a4214bc748a62fc4ddea59177595b21b,0,Tim Armstrong,2020-08-13 02:22:31+00:00,['6f2a1d0a6257fcf0401178b0b4e5faf1463f99bc'],0,5,5,16693043,1,0,1,1,6545
c5d90169d7dc1974db18c130a9eb42a3d8095616,0,Tim Armstrong,2020-08-13 02:22:31+00:00,['1ef12788a4214bc748a62fc4ddea59177595b21b'],5,7,12,16693055,2,0,1,1,6545
8addf4300be33c57b79580d879c08316a47e3f90,0,Tim Armstrong,2020-08-13 02:22:31+00:00,['c5d90169d7dc1974db18c130a9eb42a3d8095616'],1,1,2,16693057,1,,,,6545
5fedf7bf7247240ae1d356a393179f80b97d5cb5,0,Impala Public Jenkins,2020-08-13 03:10:16+00:00,['8addf4300be33c57b79580d879c08316a47e3f90'],97,311,408,16693465,16,0.362831858,0.884955752,0.221238938,6545
05a6acbb5e6dce47b123c454f8200d0913388b11,0,Impala Public Jenkins,2020-08-13 14:59:12+00:00,['5fedf7bf7247240ae1d356a393179f80b97d5cb5'],1,1,2,16693467,1,,,,6545
6539c50f6611d9e2ba9c3051b8e4c8bd6e79d1e1,0,Impala Public Jenkins,2020-08-13 18:58:23+00:00,['05a6acbb5e6dce47b123c454f8200d0913388b11'],1,0,1,16693468,1,,,,6545
e63bf9d6c1b2a67f68057f2b8bf077aa7be27256,0,Impala Public Jenkins,2020-08-14 01:42:30+00:00,['6539c50f6611d9e2ba9c3051b8e4c8bd6e79d1e1'],57,235,292,16693760,13,0.349514563,0.747572816,0.961165049,6545
e0681615c2f8f38763437dc9440e8eda42334f5c,0,Thomas Tauber-Marshall,2020-08-14 22:32:55+00:00,['e63bf9d6c1b2a67f68057f2b8bf077aa7be27256'],7,32,39,16693799,2,0.7,1,1,6545
cd52932125e5636ff154c3cdb6a740877b255998,1,Quanlong Huang,2020-08-15 02:01:05+00:00,['e0681615c2f8f38763437dc9440e8eda42334f5c'],108,466,574,16694373,11,0.445595855,1,0.67357513,6545
d65cb05bb8398a65d6cfb460eed4712c4b47b753,0,Impala Public Jenkins,2020-08-19 22:28:35+00:00,['cd52932125e5636ff154c3cdb6a740877b255998'],5,9,14,16694387,2,1,1,1,6545
3f1b1476af2082f716812edac9ed72eac0c903b5,0,Tim Armstrong,2020-08-24 16:02:45+00:00,['d65cb05bb8398a65d6cfb460eed4712c4b47b753'],105,1252,1357,16695744,18,1,1,1,6558
6390e7e1da2c02e0dac914348cdd48b9ac2e7126,0,Tim Armstrong,2020-08-24 16:49:15+00:00,['3f1b1476af2082f716812edac9ed72eac0c903b5'],35,3966,4001,16699745,21,0.824108241,0.969864699,0.888068881,6560
2ebf554dfdb0dc9055ef95c8f2ec4fad51f1e657,0,Sahil Takiar,2020-08-25 15:42:01+00:00,['6390e7e1da2c02e0dac914348cdd48b9ac2e7126'],3,4,7,16699752,3,,,,6560
e0a6e942b28909baa0f56e21e3d33adfb5eb19b7,0,Tim Armstrong,2020-08-25 16:11:20+00:00,['2ebf554dfdb0dc9055ef95c8f2ec4fad51f1e657'],61,474,535,16700287,12,0.189189189,0.099099099,0.765765766,6560
41065845e927acef5a0ff95ef8fb32b2f86272d8,0,Impala Public Jenkins,2020-08-25 18:06:22+00:00,['e0a6e942b28909baa0f56e21e3d33adfb5eb19b7'],8,179,187,16700474,7,0,0,0,6560
b46ea7664c3b38e12ea6a06e7d342273d132fbf7,0,Impala Public Jenkins,2020-08-25 21:22:15+00:00,['41065845e927acef5a0ff95ef8fb32b2f86272d8'],6,4,10,16700484,5,1,1,0.8,6561
adf2c464aed5d35c976c1439982e0a927f76b609,0,Impala Public Jenkins,2020-08-25 22:29:45+00:00,['b46ea7664c3b38e12ea6a06e7d342273d132fbf7'],4,6,10,16700494,3,0,0.5,1,6561
e133d1838ab05e75007fef24e2ce1b6f18113c8d,0,Impala Public Jenkins,2020-08-25 23:08:40+00:00,['adf2c464aed5d35c976c1439982e0a927f76b609'],5,115,120,16700614,3,,,,6561
a8a35edbc407e02187279ac8d090a345d026c57a,0,Impala Public Jenkins,2020-08-26 01:50:16+00:00,['e133d1838ab05e75007fef24e2ce1b6f18113c8d'],15,171,186,16700800,6,0.625,0.625,0.28125,6561
28d94851b1418ddd57e4c046646f7a2df0e702d7,0,Impala Public Jenkins,2020-08-26 10:59:49+00:00,['a8a35edbc407e02187279ac8d090a345d026c57a'],8,132,140,16700940,4,0.8,0.8,0,6561
21c50f8dbb7ef75dbb56bee07590a710993f4d64,1,Vihang Karajgaonkar,2020-08-26 17:08:43+00:00,['28d94851b1418ddd57e4c046646f7a2df0e702d7'],3,156,159,16701099,4,0.302631579,0.802631579,1,6562
c4d4a425282e2bbdbcb152dd5303b62d551b555e,0,Tim Armstrong,2020-08-26 17:10:48+00:00,['21c50f8dbb7ef75dbb56bee07590a710993f4d64'],1,1,2,16701101,1,,,,6562
0fcf846592072e35a1d693ee432b8a0216e229ee,1,Tim Armstrong,2020-08-27 00:11:56+00:00,['c4d4a425282e2bbdbcb152dd5303b62d551b555e'],16031,92900,108931,16810032,107,1,1,1,6666
61dcc805e536af0f160225cc928aa188aa861225,1,Impala Public Jenkins,2020-08-27 04:09:58+00:00,['0fcf846592072e35a1d693ee432b8a0216e229ee'],8,244,252,16810284,11,0.266666667,0.733333333,0.82962963,6666
568b3394b2945d684d8fdb6c4f4e1f33cbf98898,0,Impala Public Jenkins,2020-08-27 10:17:31+00:00,['61dcc805e536af0f160225cc928aa188aa861225'],2,10,12,16810296,1,0,0,1,6666
34668fab878c224632710670618b3f0176cbc78d,0,Impala Public Jenkins,2020-08-28 01:37:16+00:00,['568b3394b2945d684d8fdb6c4f4e1f33cbf98898'],4,23,27,16810323,2,1,1,1,6666
3733c4cc2cfb78d7f13463fb1ee9e1c4560d4a3d,1,Impala Public Jenkins,2020-08-28 01:39:55+00:00,['34668fab878c224632710670618b3f0176cbc78d'],10,20,30,16810353,3,0,0,1,6666
2ef6184ee1010d29fdaa5cd4ba5f0c95ef9abc0d,0,Impala Public Jenkins,2020-08-28 20:22:57+00:00,['3733c4cc2cfb78d7f13463fb1ee9e1c4560d4a3d'],47,924,971,16811324,10,0.098739496,0.771008403,0.773109244,6666
5daff3472440dc6174f0f31a28bbdafee4f68716,0,Impala Public Jenkins,2020-08-29 00:58:34+00:00,['2ef6184ee1010d29fdaa5cd4ba5f0c95ef9abc0d'],8,231,239,16811563,9,,,,6668
ea75e68f9e07d9bec211adea2c9d0e0dd0f9c3bc,0,Impala Public Jenkins,2020-08-29 05:48:37+00:00,['5daff3472440dc6174f0f31a28bbdafee4f68716'],4,96,100,16811663,11,0.065217391,0.456521739,0.760869565,6668
578933fe74d8c320431148f9a458a0051afafb17,0,Impala Public Jenkins,2020-08-31 13:28:29+00:00,['ea75e68f9e07d9bec211adea2c9d0e0dd0f9c3bc'],1,25,26,16811689,2,0.916666667,0.916666667,0.916666667,6668
827070b473c02da480f3a9d77c59f7031f9070c2,1,Tim Armstrong,2020-08-31 18:34:07+00:00,['578933fe74d8c320431148f9a458a0051afafb17'],1787,2030,3817,16815506,6,0,0,1,6668
1cdae465b7f756d5e9e99d7512501c14eab7d081,0,Impala Public Jenkins,2020-09-01 00:09:48+00:00,['827070b473c02da480f3a9d77c59f7031f9070c2'],0,1,1,16815507,1,,,,6668
f85dbff97618066d60f37736808c8c24aa0a98e5,0,Impala Public Jenkins,2020-09-01 01:15:30+00:00,['1cdae465b7f756d5e9e99d7512501c14eab7d081'],102,51,153,16815660,5,0,,,6668
f4273a40fe2e2ab0806f0324ecf33a25b3df6279,1,Impala Public Jenkins,2020-09-01 08:54:42+00:00,['f85dbff97618066d60f37736808c8c24aa0a98e5'],784,795,1579,16817239,6,1,1,1,6668
69d0d0af471f7013627ead3dff86a402ebc263a6,0,Impala Public Jenkins,2020-09-01 09:43:03+00:00,['f4273a40fe2e2ab0806f0324ecf33a25b3df6279'],1,11,12,16817251,2,1,1,1,6668
329bb41294a57bfd63dc0d90d57966e8562686b1,0,Impala Public Jenkins,2020-09-01 22:27:27+00:00,['69d0d0af471f7013627ead3dff86a402ebc263a6'],27,88,115,16817366,7,1,1,0,6669
106dea63ba2f21ea43a580363445d4ad79a9c87c,0,Joe McDonnell,2020-09-01 23:30:55+00:00,['329bb41294a57bfd63dc0d90d57966e8562686b1'],2,23,25,16817391,1,,,,6669
28b1542db0c6c91a9d7fc626ac50c2bfc84dabb2,0,Impala Public Jenkins,2020-09-02 04:31:52+00:00,['106dea63ba2f21ea43a580363445d4ad79a9c87c'],0,8,8,16817399,1,,,,6669
0098113d9582c3b93044eed4078a7f0724dda26f,1,Impala Public Jenkins,2020-09-02 06:47:30+00:00,['28b1542db0c6c91a9d7fc626ac50c2bfc84dabb2'],11,63,74,16817473,4,0,0,1,6669
4cb3c3556e77ee24003383155ca5e1b70be4db6e,0,Impala Public Jenkins,2020-09-02 10:49:10+00:00,['0098113d9582c3b93044eed4078a7f0724dda26f'],1,59,60,16817533,4,1,1,1,6669
502e1134be595ed5506424ee5f06dcf52f6fc646,0,Impala Public Jenkins,2020-09-02 13:29:25+00:00,['4cb3c3556e77ee24003383155ca5e1b70be4db6e'],2,10,12,16817545,2,,,,6669
f9936549dcab58390c5662ebdedb9c60838185a4,0,Impala Public Jenkins,2020-09-02 22:06:50+00:00,['502e1134be595ed5506424ee5f06dcf52f6fc646'],120,106,226,16817771,4,0,1,1,6669
5e9f10d34cc2ba6e18b469a3a5ae3ed9f5f306b1,1,Impala Public Jenkins,2020-09-02 22:57:55+00:00,['f9936549dcab58390c5662ebdedb9c60838185a4'],31,412,443,16818214,11,0.427272727,0.445454545,0.563636364,6671
99e5f5a8859c58641973bc84058eeb15502da96c,0,Gabor Kaszab,2020-09-03 12:11:48+00:00,['5e9f10d34cc2ba6e18b469a3a5ae3ed9f5f306b1'],0,59,59,16818273,4,1,1,1,6671
2359a1be9dc491f6c35fe3415265d4a29d6bc939,0,Tim Armstrong,2020-09-03 18:25:58+00:00,['99e5f5a8859c58641973bc84058eeb15502da96c'],4,7,11,16818284,1,0,1,0,6671
dc08b657e86c3bd81af27c7acf4a31b39b5b20e9,1,Impala Public Jenkins,2020-09-04 00:55:02+00:00,['2359a1be9dc491f6c35fe3415265d4a29d6bc939'],39,454,493,16818777,10,0.134228188,0.88590604,0.416107383,6672
75146c9138051758176d3d4482f45a9d1056127b,0,Csaba Ringhofer,2020-09-04 12:18:28+00:00,['dc08b657e86c3bd81af27c7acf4a31b39b5b20e9'],5,37,42,16818819,3,0.761904762,0.761904762,0.761904762,6672
b7965d8240f3a5cd6972351b7fe1116e4a0835c1,1,Csaba Ringhofer,2020-09-04 12:28:56+00:00,['75146c9138051758176d3d4482f45a9d1056127b'],37,5,42,16818861,3,0.238095238,0.238095238,0.238095238,6672
fe6e6257475b521b3ceeae4f6a898aae6ce3eb94,1,Gabor Kaszab,2020-09-05 09:42:46+00:00,['b7965d8240f3a5cd6972351b7fe1116e4a0835c1'],5,37,42,16818903,3,0.761904762,0.761904762,0.761904762,6672
fb6d96e001c1a04475a8fd01f757dd0605cf3279,1,Impala Public Jenkins,2020-09-06 02:12:07+00:00,['fe6e6257475b521b3ceeae4f6a898aae6ce3eb94'],203,1454,1657,16820560,89,0.53286385,0.593896714,0.903755869,6726
1e63722f8da7cd94a6937891832e51eae834c956,0,Impala Public Jenkins,2020-09-08 21:33:38+00:00,['fb6d96e001c1a04475a8fd01f757dd0605cf3279'],0,4,4,16820564,1,,,,6726
fc51cd3bc0fa5e57e7b15fc07dbff9ced5d089c6,0,Impala Public Jenkins,2020-09-08 22:11:23+00:00,['1e63722f8da7cd94a6937891832e51eae834c956'],6,64,70,16820634,6,0.333333333,1,0.696969697,6726
6aaea3216ca2fabe352b9f11a7d140e9d9c183c9,0,Impala Public Jenkins,2020-09-08 23:35:41+00:00,['fc51cd3bc0fa5e57e7b15fc07dbff9ced5d089c6'],0,3,3,16820637,1,,,,6726
9f51673a40d61cf087dd72c6e50719ed522ac851,0,Impala Public Jenkins,2020-09-09 04:23:17+00:00,['6aaea3216ca2fabe352b9f11a7d140e9d9c183c9'],7,8,15,16820652,2,,,,6726
0c89a9d562c280507a6e842898bf3e41cadc3ff1,0,Impala Public Jenkins,2020-09-09 06:52:53+00:00,['9f51673a40d61cf087dd72c6e50719ed522ac851'],3,27,30,16820682,1,0,0,0,6726
efc627d050caeb9947af2dfd3fc8a02236c44d0e,0,Impala Public Jenkins,2020-09-09 13:26:42+00:00,['0c89a9d562c280507a6e842898bf3e41cadc3ff1'],0,5,5,16820687,2,,,,6726
e8251bb09316d1cea04502b5de8516bc879fd7d3,0,Impala Public Jenkins,2020-09-10 11:57:41+00:00,['efc627d050caeb9947af2dfd3fc8a02236c44d0e'],15,143,158,16820845,9,0.52173913,0.52173913,0.391304348,6726
673111be7d48a1f383e553e24bf6a027e41f91a3,0,Impala Public Jenkins,2020-09-10 14:32:03+00:00,['e8251bb09316d1cea04502b5de8516bc879fd7d3'],1,2,3,16820848,1,,,,6726
f7dbd4939903b1dbb1994423f24a2f4159daf48a,0,Impala Public Jenkins,2020-09-10 20:37:05+00:00,['673111be7d48a1f383e553e24bf6a027e41f91a3'],4,18,22,16820870,3,1,1,1,6726
6ff3707c7fd24f62b3cab9ed68d7e29841d92969,0,Impala Public Jenkins,2020-09-11 13:15:47+00:00,['f7dbd4939903b1dbb1994423f24a2f4159daf48a'],3,1,4,16820874,1,,,,6726
7baa31ea04b4d025b882c46848ca682f0b5beb2a,0,Tim Armstrong,2020-09-11 16:43:35+00:00,['6ff3707c7fd24f62b3cab9ed68d7e29841d92969'],10,4,14,16820888,1,,0,,6726
4bb7190549254c98eb675f3aa044085ca90084d0,0,Impala Public Jenkins,2020-09-11 21:45:30+00:00,['7baa31ea04b4d025b882c46848ca682f0b5beb2a'],94,402,496,16821384,8,0.510204082,0.765306122,1,6728
7b44b351321969fa6a90212f4c9b56c521a85ec4,1,Impala Public Jenkins,2020-09-12 05:30:45+00:00,['4bb7190549254c98eb675f3aa044085ca90084d0'],12,20,32,16821416,5,1,1,0,6728
1e1892e9c635da51a35724aaeb552830a2724de3,0,Tim Armstrong,2020-09-14 16:16:14+00:00,['7b44b351321969fa6a90212f4c9b56c521a85ec4'],3,3,6,16821422,1,,,,6728
3cc3484fcc062953f0d311154264a64ef6041a35,0,Zoltan Borok-Nagy,2020-09-14 16:40:25+00:00,['1e1892e9c635da51a35724aaeb552830a2724de3'],2,2,4,16821426,1,,,,6728
01316ad1c9d3d20633ee429ef95f159d2778a747,0,Impala Public Jenkins,2020-09-14 21:50:37+00:00,['3cc3484fcc062953f0d311154264a64ef6041a35'],11,16,27,16821453,8,0.666666667,0.333333333,0.333333333,6728
40777b706b39599efb4dd8e12fafd72f35bc580c,0,Impala Public Jenkins,2020-09-15 20:31:50+00:00,['01316ad1c9d3d20633ee429ef95f159d2778a747'],5,241,246,16821699,10,0.330188679,0.830188679,0.924528302,6728
7b55168894d43b8696ac72f50515f6b842556caa,1,Impala Public Jenkins,2020-09-17 05:25:36+00:00,['40777b706b39599efb4dd8e12fafd72f35bc580c'],394,649,1043,16822742,5,0.693877551,0.785714286,0.683673469,6728
13f50eaec59d2690dd54acda1bba83eb0aacb972,1,Impala Public Jenkins,2020-09-17 20:55:45+00:00,['7b55168894d43b8696ac72f50515f6b842556caa'],125,505,630,16823372,13,0.318181818,1,0.439393939,6728
b800f4a9234f2005e47e056ce3d164720c20bed8,0,Impala Public Jenkins,2020-09-18 00:14:37+00:00,['13f50eaec59d2690dd54acda1bba83eb0aacb972'],0,12,12,16823384,2,0,0.6,1,6728
3ef77566286c0077b89c0b8ce529ea9985018dd6,0,Impala Public Jenkins,2020-09-18 04:06:22+00:00,['b800f4a9234f2005e47e056ce3d164720c20bed8'],9,19,28,16823412,2,1,1,1,6728
5dccf8024b17148e3736473d03426588f434af48,0,Impala Public Jenkins,2020-09-18 22:12:47+00:00,['3ef77566286c0077b89c0b8ce529ea9985018dd6'],37,183,220,16823632,14,0.172413793,0.620689655,0,6728
8e745a778078b8b0f07573d6c2f53d80bc079a12,0,Impala Public Jenkins,2020-09-19 06:03:58+00:00,['5dccf8024b17148e3736473d03426588f434af48'],26,438,464,16824096,11,0.381322957,0.486381323,0.490272374,6730
32bb425719c28941096220d5c6cf027b9f04ac82,1,Impala Public Jenkins,2020-09-19 20:10:48+00:00,['8e745a778078b8b0f07573d6c2f53d80bc079a12'],2,56,58,16824154,2,0,0,0.333333333,6730
e038db4479e3ae1232da15d3dbbfdd9aeb058006,0,Impala Public Jenkins,2020-09-19 20:46:46+00:00,['32bb425719c28941096220d5c6cf027b9f04ac82'],2,20,22,16824176,4,0,1,0,6730
201eea6d779b73017935e2539dce791b003e26ba,0,Tim Armstrong,2020-09-21 17:11:00+00:00,['e038db4479e3ae1232da15d3dbbfdd9aeb058006'],0,3,3,16824179,1,,,,6730
79b17db83a2f97a409e468c5dd5cfaeb9454f5dd,1,Impala Public Jenkins,2020-09-21 22:02:24+00:00,['201eea6d779b73017935e2539dce791b003e26ba'],684,1630,2314,16826493,13,0.343621399,0.833333333,0.823045267,6730
6f9d9514c3c765c6e593ce0bf146041f3e561c29,1,Impala Public Jenkins,2020-09-22 00:41:28+00:00,['79b17db83a2f97a409e468c5dd5cfaeb9454f5dd'],2726,2737,5463,16831956,78,0.8,0.8,1,6730
179b14876d13353302d075be13f0ed1145041bfa,0,Impala Public Jenkins,2020-09-22 03:03:32+00:00,['6f9d9514c3c765c6e593ce0bf146041f3e561c29'],2,8,10,16831966,3,1,0,1,6730
462d91884fed4a139587a9e5ffa353b82e486c95,1,Impala Public Jenkins,2020-09-22 13:43:06+00:00,['179b14876d13353302d075be13f0ed1145041bfa'],1,71,72,16832038,2,0,0,1,6730
dcdbaf12224e7029dde3110d56edea022dd3a2a0,1,Impala Public Jenkins,2020-09-22 22:19:41+00:00,['462d91884fed4a139587a9e5ffa353b82e486c95'],9,1580,1589,16833627,13,0.312903226,0.319354839,0.987096774,6732
155ffd64ee3562c36d5000de3a5102e05b393cc2,0,Sahil Takiar,2020-09-22 23:45:57+00:00,['dcdbaf12224e7029dde3110d56edea022dd3a2a0'],24,223,247,16833874,5,0.036144578,1,1,6734
d6442e0d8afb9fc4f5070583f1ce2ee143b7f13b,0,Impala Public Jenkins,2020-09-24 00:45:23+00:00,['155ffd64ee3562c36d5000de3a5102e05b393cc2'],12,15,27,16833901,2,0,1,0,6734
c4277d8f7558451731b6da4d984df7bd78942050,0,Impala Public Jenkins,2020-09-24 05:04:17+00:00,['d6442e0d8afb9fc4f5070583f1ce2ee143b7f13b'],15,11,26,16833927,2,1,0,0,6734
5d9daf40511e8b43d9bfd186b19efc06588cd1ce,0,Impala Public Jenkins,2020-09-25 14:02:13+00:00,['c4277d8f7558451731b6da4d984df7bd78942050'],200,519,719,16834646,15,0.442857143,0.978571429,0.514285714,6736
5508be2b6273edd8074f466a7a64e70ecf304ddf,0,Impala Public Jenkins,2020-09-26 11:11:47+00:00,['5d9daf40511e8b43d9bfd186b19efc06588cd1ce'],76,8,84,16834730,6,0.294117647,0.294117647,0,6736
ee9904bc504edb19655bbee045c9b9e6a711eb7b,0,Gabor Kaszab,2020-09-28 14:02:35+00:00,['5508be2b6273edd8074f466a7a64e70ecf304ddf'],13,30,43,16834773,4,0,1,1,6736
e53d649f8a88f42a70237fe7c2663baa126fed1a,1,Vihang Karajgaonkar,2020-09-28 22:39:24+00:00,['ee9904bc504edb19655bbee045c9b9e6a711eb7b'],185,788,973,16835746,13,0.137472284,0.618625277,0.623059867,6736
0e96ee8e99359efe413aec29c1cad03859d268a1,1,Impala Public Jenkins,2020-09-29 13:51:21+00:00,['e53d649f8a88f42a70237fe7c2663baa126fed1a'],15,21,36,16835782,2,0,0,0,6736
aeeff53e884a67ee7f5980654a1d394c6e3e34ac,0,Impala Public Jenkins,2020-09-29 20:55:36+00:00,['0e96ee8e99359efe413aec29c1cad03859d268a1'],216,62,278,16836060,10,0.455555556,0.422222222,0.711111111,6736
a973c776f98273978256163a8db792d44275341b,0,Impala Public Jenkins,2020-09-29 22:21:43+00:00,['aeeff53e884a67ee7f5980654a1d394c6e3e34ac'],1,1,2,16836062,1,,,,6736
28181cbe6c59cc2f3da2246fd907d6bc69a5f7d2,1,Impala Public Jenkins,2020-09-29 23:14:50+00:00,['a973c776f98273978256163a8db792d44275341b'],193,475,668,16836730,29,1,1,0.8,6741
63bf92a2d1e60f440ec1bf827d81e7e87de47d12,0,Impala Public Jenkins,2020-09-30 13:57:52+00:00,['28181cbe6c59cc2f3da2246fd907d6bc69a5f7d2'],6,6,12,16836742,1,0,,,6741
d613d4c019ca91ec09e85f93d6947432fba0a531,0,Impala Public Jenkins,2020-09-30 21:01:54+00:00,['63bf92a2d1e60f440ec1bf827d81e7e87de47d12'],7,7,14,16836756,1,,,,6741
c9f8d2564d9df86295080b29f1a3ad34c2342c3d,0,Impala Public Jenkins,2020-09-30 22:36:05+00:00,['d613d4c019ca91ec09e85f93d6947432fba0a531'],11,21,32,16836788,3,0.2,0.2,0,6741
6bb3b88d05f89fb7a1a54f302b4d329cbf4f69ec,0,Impala Public Jenkins,2020-09-30 22:41:00+00:00,['c9f8d2564d9df86295080b29f1a3ad34c2342c3d'],351,130,481,16837269,42,0.690909091,0.436363636,0.6,6741
a0a25a61c302d864315daa7f09827b37a37419d5,0,Impala Public Jenkins,2020-10-01 08:38:18+00:00,['6bb3b88d05f89fb7a1a54f302b4d329cbf4f69ec'],3,9,12,16837281,3,1,1,1,6741
5b720a4d18cc2f2ade54ab223663521a3822343f,1,Impala Public Jenkins,2020-10-01 13:54:48+00:00,['a0a25a61c302d864315daa7f09827b37a37419d5'],65,858,923,16838204,40,0.753623188,0.753623188,0.557971014,6766
fd00efb32342b8201f20fd6d38ab773adebd3621,0,Impala Public Jenkins,2020-10-01 18:30:56+00:00,['5b720a4d18cc2f2ade54ab223663521a3822343f'],6,0,6,16838210,2,,,,6766
8e9cf51f6b328f500acf7c577289c5b888fd15d2,0,Impala Public Jenkins,2020-10-01 23:28:21+00:00,['fd00efb32342b8201f20fd6d38ab773adebd3621'],2,3,5,16838215,1,0,0,0,6766
d09294a4a6da142bf1bed7cf9b769c07d6d7baa0,0,Impala Public Jenkins,2020-10-02 05:34:13+00:00,['8e9cf51f6b328f500acf7c577289c5b888fd15d2'],6,11,17,16838232,3,0,0,1,6766
e60292fb3bd71f25b90119d0d48292f4c49e158f,0,Impala Public Jenkins,2020-10-03 13:04:42+00:00,['d09294a4a6da142bf1bed7cf9b769c07d6d7baa0'],27,85,112,16838344,4,0.894736842,0,0.263157895,6766
d453d52aadcbd158147b906813b22eb2944ac90b,1,Joe McDonnell,2020-10-03 19:58:29+00:00,['e60292fb3bd71f25b90119d0d48292f4c49e158f'],4,87,91,16838435,3,,,,6766
a5019eb12e7842e196f6dfed744eb8495e758776,1,Impala Public Jenkins,2020-10-06 01:42:30+00:00,['d453d52aadcbd158147b906813b22eb2944ac90b'],31,173,204,16838639,11,0.693877551,0.693877551,0.897959184,6766
04ce57dcaf338cb92ae8c811736fb99b58acc047,0,Joe McDonnell,2020-10-06 15:30:42+00:00,['a5019eb12e7842e196f6dfed744eb8495e758776'],114,53,167,16838806,6,,,,6766
5912c4761701b309183f352b87de4edcd17e7c9d,1,Impala Public Jenkins,2020-10-06 16:58:04+00:00,['04ce57dcaf338cb92ae8c811736fb99b58acc047'],22,22,44,16838850,6,,,,6766
d6c664ef71d7d338d2a3517d90b76c3606933ae3,0,Impala Public Jenkins,2020-10-06 20:52:33+00:00,['5912c4761701b309183f352b87de4edcd17e7c9d'],1,1,2,16838852,1,,,,6766
c9fcbe53c8a4822e1d39de848c7ff45ca2ff2c67,0,Impala Public Jenkins,2020-10-06 21:25:57+00:00,['d6c664ef71d7d338d2a3517d90b76c3606933ae3'],103,69,172,16839024,2,1,1,0.111111111,6766
832ad0b48662884c5dd8dfdc67acca28fae41827,0,Impala Public Jenkins,2020-10-06 21:47:10+00:00,['c9fcbe53c8a4822e1d39de848c7ff45ca2ff2c67'],111,6,117,16839141,2,0.887640449,0.438202247,0.449438202,6766
d6f2dcab79bc80448f3241ddf24d3259aa3919cd,0,Impala Public Jenkins,2020-10-07 00:34:32+00:00,['832ad0b48662884c5dd8dfdc67acca28fae41827'],37,79,116,16839257,3,1,1,1,6766
b907a1498d798ccf4ac89089b947d08d21b84814,1,Impala Public Jenkins,2020-10-07 13:28:49+00:00,['d6f2dcab79bc80448f3241ddf24d3259aa3919cd'],22,22,44,16839301,6,,,,6766
9817afbfd5919d810711e4b419475fd1e585c17a,1,Impala Public Jenkins,2020-10-07 13:41:34+00:00,['b907a1498d798ccf4ac89089b947d08d21b84814'],40,195,235,16839536,9,0,0.536585366,0.536585366,6768
76f9b75c8b701e50378ce92a729f01768da55171,0,Impala Public Jenkins,2020-10-07 18:32:51+00:00,['9817afbfd5919d810711e4b419475fd1e585c17a'],23,197,220,16839756,12,0,0.432432432,0.783783784,6768
cd51d031188ddd805042b8df72eb8ef59496a546,0,Impala Public Jenkins,2020-10-07 21:33:37+00:00,['76f9b75c8b701e50378ce92a729f01768da55171'],7,35,42,16839798,2,0,0.75,0.75,6768
90b8b49554453370dd8f49788fd29a2690e98346,0,Impala Public Jenkins,2020-10-08 22:49:59+00:00,['cd51d031188ddd805042b8df72eb8ef59496a546'],45,45,90,16839888,3,,,,6768
a2d5471cd53db4d8a5b12d3663aea376f3c686d9,1,Sahil Takiar,2020-10-08 23:11:52+00:00,['90b8b49554453370dd8f49788fd29a2690e98346'],296,441,737,16840625,17,1,1,1,6770
3382759664fe99317f27200b3e52a1e967f0a042,0,Impala Public Jenkins,2020-10-09 06:47:55+00:00,['a2d5471cd53db4d8a5b12d3663aea376f3c686d9'],82,50,132,16840757,19,0.642857143,1,0.571428571,6770
1f3160b4c07c8a5a146067222e6591d44bfa3c7d,0,Joe McDonnell,2020-10-09 15:52:05+00:00,['3382759664fe99317f27200b3e52a1e967f0a042'],18,108,126,16840883,5,1,1,1,6771
2fd6f5bc5aa6b50e36547e52657c1117637384b6,1,Impala Public Jenkins,2020-10-09 22:57:25+00:00,['1f3160b4c07c8a5a146067222e6591d44bfa3c7d'],3,86,89,16840972,7,0.090909091,0.840909091,0,6771
b8a2b754669eb7f8d164e8112e594ac413e436ef,0,Impala Public Jenkins,2020-10-10 02:08:22+00:00,['2fd6f5bc5aa6b50e36547e52657c1117637384b6'],3,5,8,16840980,2,1,1,1,6771
481ea4ab0d476a4aa491f99c2a4e376faddc0b03,0,Joe McDonnell,2020-10-14 05:39:01+00:00,['b8a2b754669eb7f8d164e8112e594ac413e436ef'],12,4,16,16840996,1,,,,6771
0fb234923c580ee39f3c296eebfc5062a71e8fb9,1,Impala Public Jenkins,2020-10-14 13:33:21+00:00,['481ea4ab0d476a4aa491f99c2a4e376faddc0b03'],3,12,15,16841011,1,0,0,1,6771
308d692a1ba0c86c7ff718425495d787571c1484,1,Impala Public Jenkins,2020-10-14 14:15:53+00:00,['0fb234923c580ee39f3c296eebfc5062a71e8fb9'],12,63,75,16841086,10,0,0,0.684210526,6771
3d067572dd401a08045de57fefa3d3131bea3c2b,0,Impala Public Jenkins,2020-10-14 14:39:39+00:00,['308d692a1ba0c86c7ff718425495d787571c1484'],15,62,77,16841163,7,0.821428571,0.964285714,0.785714286,6771
13a78fc1b080baed16ac42888a54c60e9eb7a894,1,Impala Public Jenkins,2020-10-14 19:07:06+00:00,['3d067572dd401a08045de57fefa3d3131bea3c2b'],67,352,419,16841582,12,0.163398693,0.797385621,1,6772
0c0985a825fba8d9702639e3e679d2e1b9070fe1,1,Impala Public Jenkins,2020-10-14 19:19:19+00:00,['13a78fc1b080baed16ac42888a54c60e9eb7a894'],1,300,301,16841883,31,1,1,1,6797
c7581b5d8a9e00006a34cb82e88fa0ede26cfb3f,0,Impala Public Jenkins,2020-10-14 22:20:06+00:00,['0c0985a825fba8d9702639e3e679d2e1b9070fe1'],6,8,14,16841897,1,0,0.5,1,6797
63c435cac11a623693402a2197efdf3b928bd349,0,Impala Public Jenkins,2020-10-14 23:25:42+00:00,['c7581b5d8a9e00006a34cb82e88fa0ede26cfb3f'],0,8,8,16841905,1,0,1,0,6797
41813b27bc40c7fdf4e5eed3461d857dd1a2724b,0,Impala Public Jenkins,2020-10-15 00:26:12+00:00,['63c435cac11a623693402a2197efdf3b928bd349'],4,12,16,16841921,1,0,0,1,6797
7b42e9a4391f8177ed6674f68efa7df5f526cd25,1,Joe McDonnell,2020-10-15 04:22:39+00:00,['41813b27bc40c7fdf4e5eed3461d857dd1a2724b'],64,171,235,16842156,3,0.657142857,0.885714286,1,6797
398f17f71094373880d827c65c423eea4c5e5b30,0,Impala Public Jenkins,2020-10-15 05:09:56+00:00,['7b42e9a4391f8177ed6674f68efa7df5f526cd25'],1,1,2,16842158,1,,,,6797
97856478ec4f952486786633d10e02d0682a0f94,1,Joe McDonnell,2020-10-15 19:30:13+00:00,['398f17f71094373880d827c65c423eea4c5e5b30'],190,57,247,16842405,77,,,,6797
97792c4bad526c84fbad01c98ef6b09b6c7cbcdf,1,Joe McDonnell,2020-10-15 19:30:13+00:00,['97856478ec4f952486786633d10e02d0682a0f94'],47,93,140,16842545,16,,,,6797
05ad4ce05fca2f3bcd01946836c657c5479adca6,1,Impala Public Jenkins,2020-10-15 21:28:57+00:00,['97792c4bad526c84fbad01c98ef6b09b6c7cbcdf'],96,378,474,16843019,13,0.708737864,0.912621359,0.815533981,6800
6542b6070d0dd4237e65943d09503282c24ccd84,1,Impala Public Jenkins,2020-10-15 21:31:30+00:00,['05ad4ce05fca2f3bcd01946836c657c5479adca6'],23,150,173,16843192,4,0.963636364,1,0.563636364,6802
faa2d398e647c0347f81af08d7e4fa4d4a7acf72,1,Impala Public Jenkins,2020-10-16 06:40:38+00:00,['6542b6070d0dd4237e65943d09503282c24ccd84'],36,220,256,16843448,11,0.485714286,0,0.542857143,6802
c7f118a860af6b811e2e2c4c5e3693f43429def8,0,Impala Public Jenkins,2020-10-19 10:24:43+00:00,['faa2d398e647c0347f81af08d7e4fa4d4a7acf72'],2,2,4,16843452,1,,,,6802
e76010d62889aaa2b04f6cfea9bb74b829877eb9,0,Joe McDonnell,2020-10-19 21:17:55+00:00,['c7f118a860af6b811e2e2c4c5e3693f43429def8'],4,14,18,16843470,2,,,,6802
1e2176c84909a26e6405df7ae6d34d724e5a5217,0,Impala Public Jenkins,2020-10-20 01:32:42+00:00,['e76010d62889aaa2b04f6cfea9bb74b829877eb9'],2,6,8,16843478,2,0.25,0.5,1,6802
ca4d6912be7c89acd518bbbe44e7c2407f1bb217,0,Joe McDonnell,2020-10-20 04:15:57+00:00,['1e2176c84909a26e6405df7ae6d34d724e5a5217'],0,3,3,16843481,1,,,,6802
198bbe280cb991f653eba18c3d49b35582608520,0,Impala Public Jenkins,2020-10-20 06:47:25+00:00,['ca4d6912be7c89acd518bbbe44e7c2407f1bb217'],1,1,2,16843483,1,,,,6802
65a0325572a5a66e4ed017d291145f567f02419c,1,Impala Public Jenkins,2020-10-20 23:30:51+00:00,['198bbe280cb991f653eba18c3d49b35582608520'],11,248,259,16843742,11,0.1484375,0.609375,0.875,6802
6dbf1ca09c9d8b53a0d37d9201508847e3247283,1,Impala Public Jenkins,2020-10-21 05:20:33+00:00,['65a0325572a5a66e4ed017d291145f567f02419c'],253,269,522,16844264,13,1,1,1,6802
ee4043e1a0940ae5711c68336d1ad522631d0e35,0,Impala Public Jenkins,2020-10-21 06:31:47+00:00,['6dbf1ca09c9d8b53a0d37d9201508847e3247283'],6,96,102,16844366,5,0.303030303,0.439393939,0.484848485,6802
9384a18180cc567a6c66af7a30d574cc2cb7f696,0,Impala Public Jenkins,2020-10-21 20:30:05+00:00,['ee4043e1a0940ae5711c68336d1ad522631d0e35'],4,62,66,16844432,2,0,0,1,6802
15c3b13e9730479e096275d974000ae9fe8fbb83,1,Impala Public Jenkins,2020-10-22 01:58:47+00:00,['9384a18180cc567a6c66af7a30d574cc2cb7f696'],57,389,446,16844878,16,0.31875,0.55625,0,6805
61a020d0f89ef1d6e736495aa2a98f7693dc7f39,0,Impala Public Jenkins,2020-10-22 05:03:32+00:00,['15c3b13e9730479e096275d974000ae9fe8fbb83'],1,3,4,16844882,2,,,,6805
227e43f48147c8725100ddc05521bae07ee9becd,0,Impala Public Jenkins,2020-10-22 23:44:33+00:00,['61a020d0f89ef1d6e736495aa2a98f7693dc7f39'],10,43,53,16844935,1,0.583333333,0.583333333,1,6805
eda06f41ce004cfc7a35d7d26d93e76d54c7cdb0,0,Impala Public Jenkins,2020-10-23 04:01:26+00:00,['227e43f48147c8725100ddc05521bae07ee9becd'],1,65,66,16845001,5,0,1,0.529411765,6805
d459b434b65ccdc49179c549688f4b798dddf3e4,0,Impala Public Jenkins,2020-10-23 06:11:04+00:00,['eda06f41ce004cfc7a35d7d26d93e76d54c7cdb0'],2,5,7,16845008,1,,,,6805
4159a8085cb4433958c1855e1e1677d2dc859140,0,Impala Public Jenkins,2020-10-23 06:35:54+00:00,['d459b434b65ccdc49179c549688f4b798dddf3e4'],55,161,216,16845224,5,0,0.753246753,0.805194805,6805
cfa8a7a5e54fe7826945f688df03eabc3cd03dd4,0,Joe McDonnell,2020-10-23 21:20:44+00:00,['4159a8085cb4433958c1855e1e1677d2dc859140'],2,4,6,16845230,1,,,,6805
4b5c66f329cdd818dd11cd1a9c68b58c84bcf45c,1,Impala Public Jenkins,2020-10-24 01:14:37+00:00,['cfa8a7a5e54fe7826945f688df03eabc3cd03dd4'],69,265,334,16845564,6,0.833333333,1,1,6805
fd1ea147b3b49764bb2f2576b10d60d2bd65b916,1,Impala Public Jenkins,2020-10-24 02:30:51+00:00,['4b5c66f329cdd818dd11cd1a9c68b58c84bcf45c'],45,422,467,16846031,11,0.119815668,0.705069124,0.760368664,6805
2a1d3acaf19345707a0e2bc9d73e0c1c9204b48b,0,Impala Public Jenkins,2020-10-24 05:11:06+00:00,['fd1ea147b3b49764bb2f2576b10d60d2bd65b916'],33,144,177,16846208,7,0.253521127,0.112676056,0.647887324,6805
3ba8d637cdf38a68e25e573afa8d1d05047df2f6,0,Impala Public Jenkins,2020-10-24 06:10:52+00:00,['2a1d3acaf19345707a0e2bc9d73e0c1c9204b48b'],0,2,2,16846210,1,,,,6805
981ef104654e187ae18b25f31df2fd324e687643,1,Impala Public Jenkins,2020-10-26 20:01:09+00:00,['3ba8d637cdf38a68e25e573afa8d1d05047df2f6'],196,870,1066,16847276,42,0,0.3632287,0.874439462,6809
8ac382c784de89c7ee8e14d9e26718f20774d190,0,Impala Public Jenkins,2020-10-27 04:47:13+00:00,['981ef104654e187ae18b25f31df2fd324e687643'],10,198,208,16847484,5,0.341666667,0.691666667,0.433333333,6810
bd4a38ea33ce64982f709535b133aac6d7052e01,0,Impala Public Jenkins,2020-10-28 05:40:51+00:00,['8ac382c784de89c7ee8e14d9e26718f20774d190'],1,1,2,16847486,1,,,,6810
09fdeb56f8aa1638cd1307f0ee83bda023d68b8b,0,Joe McDonnell,2020-10-29 00:49:54+00:00,['bd4a38ea33ce64982f709535b133aac6d7052e01'],0,1,1,16847487,1,0,0,1,6810
d62a04078d1e8455716720374dd07dfab1d7dfd1,0,Impala Public Jenkins,2020-10-29 01:45:11+00:00,['09fdeb56f8aa1638cd1307f0ee83bda023d68b8b'],3,19,22,16847509,1,0,0,0,6810
1bd27a3ea87622edc869d3ff72ce9b0881451c95,0,Impala Public Jenkins,2020-10-29 10:35:27+00:00,['d62a04078d1e8455716720374dd07dfab1d7dfd1'],2,28,30,16847539,1,0,0,0.466666667,6810
193c2e773fa9f6772e4a7c30ed3a4f75029863f1,0,Impala Public Jenkins,2020-10-29 17:45:01+00:00,['1bd27a3ea87622edc869d3ff72ce9b0881451c95'],0,103,103,16847642,5,0.181818182,0.181818182,0.181818182,6810
1682afcda6e28571c83200a89f0e334a5ae49aa7,0,Impala Public Jenkins,2020-10-30 01:16:07+00:00,['193c2e773fa9f6772e4a7c30ed3a4f75029863f1'],11,34,45,16847687,2,0.368421053,1,1,6810
01e1b4df805bbaa92cd15fdfc579e5abc3898fc1,0,Impala Public Jenkins,2020-10-30 02:17:29+00:00,['1682afcda6e28571c83200a89f0e334a5ae49aa7'],4,14,18,16847705,3,0.75,0.75,1,6810
047906bd6b91cb66a6984639bfda3a25fc3724ac,0,Joe McDonnell,2020-10-30 04:31:30+00:00,['01e1b4df805bbaa92cd15fdfc579e5abc3898fc1'],2,6,8,16847713,1,,,,6810
f4ed07c8eb673fcd2d569ca6474f27ef70ac26b5,0,Impala Public Jenkins,2020-10-30 04:33:10+00:00,['047906bd6b91cb66a6984639bfda3a25fc3724ac'],338,38,376,16848089,3,0.804347826,0,0.208695652,6810
d164bf42f9fd8ec65db44a5904730587d2b961ec,0,Impala Public Jenkins,2020-10-30 05:34:16+00:00,['f4ed07c8eb673fcd2d569ca6474f27ef70ac26b5'],10,10,20,16848109,1,,,,6810
3e06d600c2dcb2c9bcdc4f52cd27cd5d180a900b,1,Impala Public Jenkins,2020-10-30 14:03:29+00:00,['d164bf42f9fd8ec65db44a5904730587d2b961ec'],22,497,519,16848628,18,0.502538071,0.654822335,0.705583756,6811
2357958e734b0da36b908030f8a3d45c048cf16f,0,Joe McDonnell,2020-10-30 15:32:21+00:00,['3e06d600c2dcb2c9bcdc4f52cd27cd5d180a900b'],8,14,22,16848650,7,0.8,1,1,6811
c3b5cf8b4c807fa4136b64addb1e7e8be8aaf6c5,0,Impala Public Jenkins,2020-10-31 05:19:09+00:00,['2357958e734b0da36b908030f8a3d45c048cf16f'],39,238,277,16848927,3,0,0,0,6811
1af60a15605463ab4ba00d5326d130d0a3165821,0,Impala Public Jenkins,2020-11-03 00:56:26+00:00,['c3b5cf8b4c807fa4136b64addb1e7e8be8aaf6c5'],38,28,66,16848993,16,0.166666667,0.166666667,0.166666667,6811
4b654e7c97545d291fa2fd214b9caf1c2c7f9c59,1,Joe McDonnell,2020-11-03 20:05:20+00:00,['1af60a15605463ab4ba00d5326d130d0a3165821'],11,11,22,16849015,4,,,,6811
278d3d22729f6ca8aecab2edfc95aa996e8b32ee,0,Joe McDonnell,2020-11-04 03:40:59+00:00,['4b654e7c97545d291fa2fd214b9caf1c2c7f9c59'],21,89,110,16849125,1,0.205882353,0,0.088235294,6811
1337adff6cc0c59a0f066b5c9a64352d929627f2,0,Impala Public Jenkins,2020-11-09 21:28:57+00:00,['278d3d22729f6ca8aecab2edfc95aa996e8b32ee'],41,136,177,16849302,9,0.463414634,0.975609756,0.463414634,6811
9d6bf3509087dd94ac5bcc160145ba8940946dcb,1,Impala Public Jenkins,2020-11-10 04:25:50+00:00,['1337adff6cc0c59a0f066b5c9a64352d929627f2'],2,12,14,16849316,2,1,1,1,6811
6694d147002c9a713f486a9b58d1db74f0be2e85,0,Impala Public Jenkins,2020-11-10 04:58:48+00:00,['9d6bf3509087dd94ac5bcc160145ba8940946dcb'],73,187,260,16849576,12,0.821428571,1,0.928571429,6811
8243a97ec2ff698e1cf605928d48055160111a09,0,Tim Armstrong,2020-11-11 01:39:01+00:00,['6694d147002c9a713f486a9b58d1db74f0be2e85'],21,48,69,16849645,5,,,,6811
ea13e744977c71206c11a54f65d77aeecb55703d,0,Impala Public Jenkins,2020-11-11 07:08:12+00:00,['8243a97ec2ff698e1cf605928d48055160111a09'],12,143,155,16849800,4,0.761363636,0.761363636,0.613636364,6811
5e38f32f290e3ac139363ef0f1d94279f0360122,0,Impala Public Jenkins,2020-11-11 22:11:50+00:00,['ea13e744977c71206c11a54f65d77aeecb55703d'],5,5,10,16849810,3,,,,6811
1fd5e4279c75a7cb3e51e737d9ca7c36435412dc,0,Impala Public Jenkins,2020-11-12 17:12:22+00:00,['5e38f32f290e3ac139363ef0f1d94279f0360122'],0,34,34,16849844,5,0.333333333,1,0.333333333,6812
746c968ac372938d64298372a0790ec18135c889,0,Impala Public Jenkins,2020-11-13 00:37:29+00:00,['1fd5e4279c75a7cb3e51e737d9ca7c36435412dc'],10,11,21,16849865,3,0,0,1,6812
5a00a4c06f8ec40a8867dcbc036cf5bb47b8a3be,0,Tim Armstrong,2020-11-13 03:46:46+00:00,['746c968ac372938d64298372a0790ec18135c889'],2,11,13,16849878,3,1,1,1,6812
fa525dfdf72f6f612821a14e683cd7f16d2c423a,0,Impala Public Jenkins,2020-11-13 09:07:29+00:00,['5a00a4c06f8ec40a8867dcbc036cf5bb47b8a3be'],9,27,36,16849914,4,0,0.9,0.1,6812
8a4539d1dbe645224efdcd5fd61514b18cc116b6,0,Impala Public Jenkins,2020-11-13 13:13:52+00:00,['fa525dfdf72f6f612821a14e683cd7f16d2c423a'],35,10273,10308,16860222,24,0.389501312,0.50183727,0.660367454,6830
1c72c5a8f93ae3aa7e30b8bb59e0a18a654d0d34,0,Impala Public Jenkins,2020-11-17 19:21:19+00:00,['8a4539d1dbe645224efdcd5fd61514b18cc116b6'],14,286,300,16860522,8,0.225988701,0.564971751,0.768361582,6832
4657f062f401a2da5e5f4aa3a3e3244f45dba8c2,0,Impala Public Jenkins,2020-11-17 23:02:19+00:00,['1c72c5a8f93ae3aa7e30b8bb59e0a18a654d0d34'],96,22,118,16860640,6,0.352941176,1,0.117647059,6832
26fc6795ec5a77496f6b5482383223fc8dfdaac0,0,Impala Public Jenkins,2020-11-18 22:24:08+00:00,['4657f062f401a2da5e5f4aa3a3e3244f45dba8c2'],0,41,41,16860681,3,0,0,1,6832
63da9ccf0c64188a6cdd01ef8d88cfbd0c81fc9a,0,Tim Armstrong,2020-11-19 00:34:27+00:00,['26fc6795ec5a77496f6b5482383223fc8dfdaac0'],1,3,4,16860685,1,,,,6832
b81ff2d25f53586914695b95c77a9d9e31a2a51a,0,Impala Public Jenkins,2020-11-19 00:38:19+00:00,['63da9ccf0c64188a6cdd01ef8d88cfbd0c81fc9a'],34,34,68,16860753,2,0,0,0,6832
f14ce75008f27dea7e57a6add5c918438b6953e6,0,Tim Armstrong,2020-11-19 01:29:47+00:00,['b81ff2d25f53586914695b95c77a9d9e31a2a51a'],2,1,3,16860756,1,,,,6832
50b589422ac41dd6920c93504d3eecdb842abd47,0,Impala Public Jenkins,2020-11-19 01:48:27+00:00,['f14ce75008f27dea7e57a6add5c918438b6953e6'],1,1,2,16860758,1,,,,6832
c9ccb61acb6d0060de10833b4b37df096baa2cd3,0,Impala Public Jenkins,2020-11-19 01:54:35+00:00,['50b589422ac41dd6920c93504d3eecdb842abd47'],0,4,4,16860762,2,,,,6832
47dbfde0b2cabd14452f18527e954aec5891224c,0,Impala Public Jenkins,2020-11-19 03:19:55+00:00,['c9ccb61acb6d0060de10833b4b37df096baa2cd3'],1,1,2,16860764,1,,,,6832
ba509ad1809138844d52a8b5877880e5fc9cfe9a,0,Impala Public Jenkins,2020-11-19 14:51:14+00:00,['47dbfde0b2cabd14452f18527e954aec5891224c'],15,18,33,16860797,3,1,1,1,6832
48113bcffc68bb1379b8f7f991ce851755c86b28,0,Impala Public Jenkins,2020-11-20 07:44:35+00:00,['ba509ad1809138844d52a8b5877880e5fc9cfe9a'],1,6,7,16860804,1,,,,6832
5c91ff27372adb3117cf48ce95ab7f7b1b9ee73a,1,Zoltan Borok-Nagy,2020-11-20 16:24:56+00:00,['48113bcffc68bb1379b8f7f991ce851755c86b28'],62,62,124,16860928,2,,,,6832
301d7ebe75d2e74f361f048020181b51dce9f216,0,Csaba Ringhofer,2020-11-20 17:54:08+00:00,['5c91ff27372adb3117cf48ce95ab7f7b1b9ee73a'],8,52,60,16860988,5,0,0,0.25,6832
4448b8755b9b55dae08dbe74a9b8dd6fdebc47c4,1,Zoltan Borok-Nagy,2020-11-20 21:40:28+00:00,['301d7ebe75d2e74f361f048020181b51dce9f216'],87,572,659,16861647,16,0.760683761,0.905982906,0.777777778,6833
ef109e3fc8547dfa0956376eab849070ade81800,0,Impala Public Jenkins,2020-11-21 06:54:39+00:00,['4448b8755b9b55dae08dbe74a9b8dd6fdebc47c4'],18,14,32,16861679,1,0,0,0,6833
acc3de40fb6633af21f33fb51631a6b567191887,0,Impala Public Jenkins,2020-11-23 06:08:04+00:00,['ef109e3fc8547dfa0956376eab849070ade81800'],3,79,82,16861761,3,0.133333333,0.7,0.7,6834
cc8ecd0926633133dc2db291ac65c317da34bad7,1,Impala Public Jenkins,2020-11-23 11:30:48+00:00,['acc3de40fb6633af21f33fb51631a6b567191887'],2,12,14,16861775,1,,,,6834
6493f8735731bb1d7beadf5e093ebd812d8ad8d2,0,Impala Public Jenkins,2020-11-23 20:36:58+00:00,['cc8ecd0926633133dc2db291ac65c317da34bad7'],0,4,4,16861779,2,,,,6834
b66045c8a5d48c268a4dfad967021ff9bcbdd937,1,Tim Armstrong,2020-11-23 21:47:55+00:00,['6493f8735731bb1d7beadf5e093ebd812d8ad8d2'],15,283,298,16862077,14,0.540322581,0.733870968,0.879032258,6836
18b4e26b7beaeb08b46598e325f39a40d490f574,0,Impala Public Jenkins,2020-11-24 00:11:24+00:00,['b66045c8a5d48c268a4dfad967021ff9bcbdd937'],0,3,3,16862080,1,1,1,1,6836
78da6adab8ac2bd3a1c67431a5f255da9cf10308,0,Impala Public Jenkins,2020-11-24 00:11:33+00:00,['18b4e26b7beaeb08b46598e325f39a40d490f574'],2,8,10,16862090,1,0,1,1,6836
24015a6a5d7d1adc31b3f67429eb648f54dcbd7a,0,Impala Public Jenkins,2020-11-24 00:55:47+00:00,['78da6adab8ac2bd3a1c67431a5f255da9cf10308'],3,5,8,16862098,1,0,1,1,6836
b97c9e796689dc114fd8f1ceaf037f1364242ce3,0,Impala Public Jenkins,2020-11-24 01:57:56+00:00,['24015a6a5d7d1adc31b3f67429eb648f54dcbd7a'],2,2,4,16862102,1,,,,6836
c9aa60a0ff8bf558f2dbf2fa794209ce355053dd,0,Csaba Ringhofer,2020-11-24 11:49:37+00:00,['b97c9e796689dc114fd8f1ceaf037f1364242ce3'],16,34,50,16862152,1,0,0,0,6836
51d8f4fb21d8314191bafb75c7d2f0910080cb4e,1,Tim Armstrong,2020-11-24 16:49:32+00:00,['c9aa60a0ff8bf558f2dbf2fa794209ce355053dd'],2,2,4,16862156,1,,,,6836
96decf535ba9ae7a6b295012d2be85c3a1ae892c,1,Impala Public Jenkins,2020-11-24 18:35:07+00:00,['51d8f4fb21d8314191bafb75c7d2f0910080cb4e'],1,23,24,16862180,3,0,0,1,6836
c4e7977f5ee1b740215eb486a074bc1326cff360,0,Impala Public Jenkins,2020-11-25 03:14:37+00:00,['96decf535ba9ae7a6b295012d2be85c3a1ae892c'],132,69,201,16862381,11,0.371428571,0.314285714,0.228571429,6836
f07514add9956e676d99ae9cbca5855960a279f2,0,Impala Public Jenkins,2020-11-25 03:20:03+00:00,['c4e7977f5ee1b740215eb486a074bc1326cff360'],0,2,2,16862383,1,0,0,1,6836
6e33ffdabe9daa879386b7bd52c02bf7626c3750,0,Impala Public Jenkins,2020-11-25 13:52:05+00:00,['f07514add9956e676d99ae9cbca5855960a279f2'],110,43,153,16862536,1,,,,6836
8ea49e9b026d48b46e9fbd98dc5286f3e6dfa93d,0,Impala Public Jenkins,2020-11-25 14:33:10+00:00,['6e33ffdabe9daa879386b7bd52c02bf7626c3750'],1,116,117,16862653,4,0,0,0,6836
9429bd779de986d3e61858bef7e258bd73a2cacd,1,Impala Public Jenkins,2020-11-26 06:50:41+00:00,['8ea49e9b026d48b46e9fbd98dc5286f3e6dfa93d'],260,1348,1608,16864261,18,0.111918605,0.764534884,0.3125,6838
a4cf449c88ef3fe08db9abbad82664b99382014c,0,Tim Armstrong,2020-11-27 19:45:00+00:00,['9429bd779de986d3e61858bef7e258bd73a2cacd'],3,6,9,16864270,1,,,,6838
5530b62539e762ddf5825e2b43db2f29d9addae7,0,Impala Public Jenkins,2020-11-28 07:30:06+00:00,['a4cf449c88ef3fe08db9abbad82664b99382014c'],20,517,537,16864807,17,0.419117647,0.235294118,0.801470588,6839
63146103a76592fe7ee583f83bc1d5e0385353b7,0,Impala Public Jenkins,2020-11-30 22:33:57+00:00,['5530b62539e762ddf5825e2b43db2f29d9addae7'],1,1,2,16864809,1,,,,6839
62c19e63396c1e783e93b4e7fb71804b70955e89,0,Tim Armstrong,2020-12-01 16:44:18+00:00,['63146103a76592fe7ee583f83bc1d5e0385353b7'],0,3,3,16864812,2,,,,6839
22ac00fd4d0fd023a743be3b047258bdce03d3f4,0,Impala Public Jenkins,2020-12-01 22:46:31+00:00,['62c19e63396c1e783e93b4e7fb71804b70955e89'],1,209,210,16865022,7,,,,6843
579f5c67e0363e856738b160731f916e0ab24e3e,1,Impala Public Jenkins,2020-12-02 22:42:12+00:00,['22ac00fd4d0fd023a743be3b047258bdce03d3f4'],6,37,43,16865065,3,,,,6843
8542924fcaca1aa1d451363d6ac7cbf258a22631,0,Impala Public Jenkins,2020-12-03 00:59:12+00:00,['579f5c67e0363e856738b160731f916e0ab24e3e'],1,1,2,16865067,1,,,,6843
a34bb2ad1128a6f401ffd457db8d8fd8e1270374,0,Impala Public Jenkins,2020-12-03 05:19:24+00:00,['8542924fcaca1aa1d451363d6ac7cbf258a22631'],0,2,2,16865069,1,0,1,1,6843
90944d7340337a75929466b590bea23fdb302337,0,Impala Public Jenkins,2020-12-03 08:05:23+00:00,['a34bb2ad1128a6f401ffd457db8d8fd8e1270374'],38,105,143,16865212,4,0,1,0.294117647,6844
ca884476bb9f3ed2de3927a8c7d8107f8551f8f8,1,Impala Public Jenkins,2020-12-03 23:46:29+00:00,['90944d7340337a75929466b590bea23fdb302337'],172,1271,1443,16866655,24,0.135458167,0.639442231,0.466135458,6848
2004a87edfa3a78e89623f395e8697047fe3c984,0,Impala Public Jenkins,2020-12-04 23:55:25+00:00,['ca884476bb9f3ed2de3927a8c7d8107f8551f8f8'],9,118,127,16866782,5,0.564516129,1,0.838709677,6848
e3e93089d4233785df19a79669bb93b0d23e6d94,1,Impala Public Jenkins,2020-12-05 08:52:40+00:00,['2004a87edfa3a78e89623f395e8697047fe3c984'],139,239,378,16867160,10,0.293333333,0.626666667,0,6848
f684ed72c541fa04dc1841a1aab83a7c9847f1a2,1,Impala Public Jenkins,2020-12-08 03:15:44+00:00,['e3e93089d4233785df19a79669bb93b0d23e6d94'],9,144,153,16867313,6,0.260869565,0.260869565,0.260869565,6848
69578db9ae2c7befc1455d4dc8d29ce6e5bcf517,1,Tim Armstrong,2020-12-09 19:26:17+00:00,['f684ed72c541fa04dc1841a1aab83a7c9847f1a2'],1,1,2,16867315,1,,,,6848
b5ba793227238ef78545765d06ca844a1a94db47,1,Impala Public Jenkins,2020-12-10 07:15:36+00:00,['69578db9ae2c7befc1455d4dc8d29ce6e5bcf517'],47,329,376,16867691,13,0,0.347826087,0.753623188,6848
a850cd3cc6e5928851ec4c06c66cdc5299097b30,1,Zoltan Borok-Nagy,2020-12-10 19:01:08+00:00,['b5ba793227238ef78545765d06ca844a1a94db47'],22,724,746,16868437,55,0.34375,0.796875,0.807291667,6874
c04de9933d174ebf7fc3779faa1fa54de953be93,0,Tim Armstrong,2020-12-10 20:12:44+00:00,['a850cd3cc6e5928851ec4c06c66cdc5299097b30'],3,12,15,16868452,3,0,1,1,6874
a3da5c580ab2fe3b0e991744cf8b994f52e3fafd,0,Impala Public Jenkins,2020-12-11 05:03:41+00:00,['c04de9933d174ebf7fc3779faa1fa54de953be93'],3,8,11,16868463,1,0,0,0,6874
07f3ae3881a8ed652b2d4a4b965aed05e5a85e6f,0,Impala Public Jenkins,2020-12-11 13:43:28+00:00,['a3da5c580ab2fe3b0e991744cf8b994f52e3fafd'],21,15,36,16868499,1,,,,6874
eceec36f69d09343f6253b7fe02e2bae505b1c5d,0,Impala Public Jenkins,2020-12-11 19:24:52+00:00,['07f3ae3881a8ed652b2d4a4b965aed05e5a85e6f'],2,4,6,16868505,2,,,,6874
eb8b118db5be9a7c8dca9b3229e76c213e19c86c,1,Impala Public Jenkins,2020-12-11 19:51:28+00:00,['eceec36f69d09343f6253b7fe02e2bae505b1c5d'],747,740,1487,16869992,22,0.333333333,0.333333333,0,6874
4c0bdbada0bc0eeb0435e1ea647573566f0cddbd,0,Impala Public Jenkins,2020-12-11 23:17:43+00:00,['eb8b118db5be9a7c8dca9b3229e76c213e19c86c'],0,116,116,16870108,4,0.145833333,0.145833333,0.854166667,6875
87b95a55688dc0631b27db7306b2939ddafcba7e,1,Impala Public Jenkins,2020-12-14 20:47:10+00:00,['4c0bdbada0bc0eeb0435e1ea647573566f0cddbd'],0,12,12,16870120,2,0,0,1,6875
a8ac9f8a57730880520448df1c72a0d5b938fa7d,0,Impala Public Jenkins,2020-12-15 06:48:52+00:00,['87b95a55688dc0631b27db7306b2939ddafcba7e'],33,89,122,16870242,5,0.2,0.2,0.571428571,6875
9dd0abbb373c0256a948cdf54a1a677230e7f5cb,0,Impala Public Jenkins,2020-12-15 12:05:46+00:00,['a8ac9f8a57730880520448df1c72a0d5b938fa7d'],4,603,607,16870849,7,0.115384615,0.115384615,0.115384615,6876
d1f4a4cc457c0327cf0e5d482116b97431da154e,0,Impala Public Jenkins,2020-12-15 17:31:44+00:00,['9dd0abbb373c0256a948cdf54a1a677230e7f5cb'],13,3,16,16870865,2,0.818181818,0.818181818,0.818181818,6876
a7e71b45232c90af09ff70a7596db56688cfeb31,1,Impala Public Jenkins,2020-12-15 19:17:51+00:00,['d1f4a4cc457c0327cf0e5d482116b97431da154e'],275,304,579,16871444,14,1,1,0,6877
ec6070aee012648ef1441ca4fbb11e485693bfdb,0,Joe McDonnell,2020-12-16 20:38:40+00:00,['a7e71b45232c90af09ff70a7596db56688cfeb31'],2,44,46,16871490,2,0,0.88,0.88,6877
8de7bf773ded7e6db9a0463222e7f552fd20735f,0,Impala Public Jenkins,2020-12-16 21:59:55+00:00,['ec6070aee012648ef1441ca4fbb11e485693bfdb'],1,6,7,16871497,1,1,1,1,6877
10fe4b6c635601768e70054255b7e50e000e71b5,0,Thomas Tauber-Marshall,2020-12-17 01:55:28+00:00,['8de7bf773ded7e6db9a0463222e7f552fd20735f'],12,19,31,16871528,5,0,1,1,6877
296ed74d6f7a1e94589abbf92337511902c9fccd,1,Impala Public Jenkins,2020-12-17 08:54:51+00:00,['10fe4b6c635601768e70054255b7e50e000e71b5'],92,589,681,16872209,27,0.524193548,0.661290323,0.64516129,6878
6cb7cecacf0c091a19eb261f3a9c7d841c0e0676,0,Impala Public Jenkins,2020-12-19 03:09:06+00:00,['296ed74d6f7a1e94589abbf92337511902c9fccd'],2,1438,1440,16873649,14,0.262251656,0.78807947,0.614569536,6884
1b863132c6fbe1b45aabea9986653a9ec7817092,1,Impala Public Jenkins,2020-12-21 14:29:52+00:00,['6cb7cecacf0c091a19eb261f3a9c7d841c0e0676'],62,1687,1749,16875398,7,0.142857143,0.71957672,0.497354497,6885
2fccd82590d747d834b8be6f3b05bb446d9bac12,1,Impala Public Jenkins,2020-12-22 00:19:32+00:00,['1b863132c6fbe1b45aabea9986653a9ec7817092'],147,696,843,16876241,13,0.360902256,0.759398496,0.481203008,6886
6b292bdd1527ec5501685c4564145d2a725195d9,1,Impala Public Jenkins,2020-12-22 01:02:47+00:00,['2fccd82590d747d834b8be6f3b05bb446d9bac12'],2,15,17,16876258,2,0,0,1,6886
3f2eab8764cb19d75de64a6bdc4c4cf982b201a0,0,Impala Public Jenkins,2020-12-22 04:31:56+00:00,['6b292bdd1527ec5501685c4564145d2a725195d9'],5,7,12,16876270,1,0,0,0,6886
4099a606892c377b9e8c9c6df2a45a7d42afcaea,0,Impala Public Jenkins,2020-12-22 06:10:39+00:00,['3f2eab8764cb19d75de64a6bdc4c4cf982b201a0'],5,167,172,16876442,14,0.2,0.216666667,0.5,6886
29069b9499f177789a50d5cdf3536538835430ae,0,Impala Public Jenkins,2020-12-23 00:54:24+00:00,['4099a606892c377b9e8c9c6df2a45a7d42afcaea'],1,1,2,16876444,1,,,,6886
a6a244099502329d9193b316ea26d5fd6451b6bd,1,Impala Public Jenkins,2020-12-24 18:55:24+00:00,['29069b9499f177789a50d5cdf3536538835430ae'],7,73,80,16876524,3,0,0.955555556,1,6886
43b6093dc00a746f8617dc6e1a63fef2dd82d76b,0,Impala Public Jenkins,2020-12-25 07:06:29+00:00,['a6a244099502329d9193b316ea26d5fd6451b6bd'],14,27,41,16876565,1,1,1,1,6886
5baadd1da7d554ea3446e2a025afe8e991339765,1,Tim Armstrong,2020-12-28 05:16:21+00:00,['43b6093dc00a746f8617dc6e1a63fef2dd82d76b'],0,135,135,16876700,2,0,0,1,6886
a5f6c26044420498ea2e23f143dbef27243f2364,0,Impala Public Jenkins,2020-12-31 06:19:20+00:00,['5baadd1da7d554ea3446e2a025afe8e991339765'],191,244,435,16877135,24,0.534883721,0.930232558,0.744186047,6886
03af0b2c8c4d7a9db2fbcc63b93bcb0348e4d82f,0,Impala Public Jenkins,2021-01-05 21:31:05+00:00,['a5f6c26044420498ea2e23f143dbef27243f2364'],2,5,7,16877142,2,,,,6886
49680559b0da843fbb6ff949d52c9d43f98364b1,1,Impala Public Jenkins,2021-01-05 23:04:25+00:00,['03af0b2c8c4d7a9db2fbcc63b93bcb0348e4d82f'],1,166,167,16877309,3,0,0,0,6886
1d5fe2771fb88fc1e9fc4ff84c47c69f4ce1e142,0,Impala Public Jenkins,2021-01-05 23:30:35+00:00,['49680559b0da843fbb6ff949d52c9d43f98364b1'],24,79,103,16877412,10,1,0.352941176,0.764705882,6888
868a01dca9071978f482aec2a9c3e18aca957914,0,Impala Public Jenkins,2021-01-05 23:55:51+00:00,['1d5fe2771fb88fc1e9fc4ff84c47c69f4ce1e142'],16,23,39,16877451,5,,,,6888
e7839c4530df7161240eac9852c87a4c37c53fd1,0,Impala Public Jenkins,2021-01-06 04:39:56+00:00,['868a01dca9071978f482aec2a9c3e18aca957914'],18,125,143,16877594,3,0,0,0.428571429,6888
200d3664f0117e1f7a9b01941d004189d4343920,0,Impala Public Jenkins,2021-01-06 22:36:10+00:00,['e7839c4530df7161240eac9852c87a4c37c53fd1'],1,81,82,16877676,2,0,0,1,6888
0c7e5a4a7c27167d4f0f24f19895e63946afd752,0,Quanlong Huang,2021-01-06 23:22:37+00:00,['200d3664f0117e1f7a9b01941d004189d4343920'],1,25,26,16877702,1,,,,6888
799bc22d7077e1ce5a47cd4d74fbd18fe89f83e5,0,Impala Public Jenkins,2021-01-07 00:22:46+00:00,['0c7e5a4a7c27167d4f0f24f19895e63946afd752'],2,5,7,16877709,1,,,,6888
44bade8e7f14d22b6a16650d54dc9bee62caeb50,0,Vihang Karajgaonkar,2021-01-07 20:05:50+00:00,['799bc22d7077e1ce5a47cd4d74fbd18fe89f83e5'],0,73,73,16877782,2,,,,6889
35bae939abc5534098931221813cb5d500b68993,0,Joe McDonnell,2021-01-07 23:53:56+00:00,['44bade8e7f14d22b6a16650d54dc9bee62caeb50'],18,0,18,16877800,7,,,,6889
425e424b37f081ba1262f4f39298c6c13910aba8,0,Impala Public Jenkins,2021-01-08 04:41:43+00:00,['35bae939abc5534098931221813cb5d500b68993'],18,86,104,16877904,3,0.357142857,0,1,6889
ab6b7960db3181096134b8aa46cb90baff6df006,0,Impala Public Jenkins,2021-01-09 00:15:25+00:00,['425e424b37f081ba1262f4f39298c6c13910aba8'],8,44,52,16877956,6,0.636363636,0,0.863636364,6889
aa48651cb5a0ca035326c0cf1356889703422f20,0,Impala Public Jenkins,2021-01-09 04:14:43+00:00,['ab6b7960db3181096134b8aa46cb90baff6df006'],112,215,327,16878283,20,1,1,0.583333333,6891
1093a563e650ba8ba4c8e85ef25fc88c9dac3776,1,Impala Public Jenkins,2021-01-11 17:08:21+00:00,['aa48651cb5a0ca035326c0cf1356889703422f20'],173,241,414,16878697,14,1,0,0.714285714,6891
91adb33b22eb132b80091742c631e627058c9984,0,Impala Public Jenkins,2021-01-13 06:03:37+00:00,['1093a563e650ba8ba4c8e85ef25fc88c9dac3776'],206,658,864,16879561,29,0.7625,0.575,0.79375,6895
696dafed662cf7ef06b2a84bb4622eab4863f717,0,Impala Public Jenkins,2021-01-14 19:34:38+00:00,['91adb33b22eb132b80091742c631e627058c9984'],0,41,41,16879602,2,1,1,1,6895
5fddbb569a68bd438d9f4847481c8db1fce5b67c,1,Impala Public Jenkins,2021-01-15 00:50:39+00:00,['696dafed662cf7ef06b2a84bb4622eab4863f717'],125,95019,95144,16974746,18,0.48,0.27,0,6904
9bb7157bf014282c95ab3e233b80d77e00c95b52,0,Impala Public Jenkins,2021-01-15 13:01:53+00:00,['5fddbb569a68bd438d9f4847481c8db1fce5b67c'],1,609,610,16975356,11,0.620689655,0.620689655,0.103448276,6911
90f3b2f4918e6a91e369a97ce47816c9406ac71c,1,Impala Public Jenkins,2021-01-18 18:46:42+00:00,['9bb7157bf014282c95ab3e233b80d77e00c95b52'],43,1167,1210,16976566,12,0.578571429,0.514285714,0.721428571,6912
8ecb61e4bda0b0f712da67f43eea70e5b583f167,1,Impala Public Jenkins,2021-01-20 02:19:35+00:00,['90f3b2f4918e6a91e369a97ce47816c9406ac71c'],12,38,50,16976616,4,0.111111111,0.555555556,0.555555556,6912
4c6cf4b2efb37a80b9069f5da69931e585bfea7e,1,Impala Public Jenkins,2021-01-20 10:20:02+00:00,['8ecb61e4bda0b0f712da67f43eea70e5b583f167'],7,30,37,16976653,2,0,0.846153846,0.923076923,6912
cdf5108aa96df43ee3c1b71a5e5ad7f5e38bee24,0,Impala Public Jenkins,2021-01-21 02:10:14+00:00,['4c6cf4b2efb37a80b9069f5da69931e585bfea7e'],0,1,1,16976654,1,,,,6912
ac7f605711807843ea549b827a2c51120cf17ed2,0,Aman Sinha,2021-01-21 07:16:42+00:00,['cdf5108aa96df43ee3c1b71a5e5ad7f5e38bee24'],0,78,78,16976732,2,,,,6913
5852a0028b2b89d64f2b3281c91c3e23f2788f14,0,Impala Public Jenkins,2021-01-21 14:48:10+00:00,['ac7f605711807843ea549b827a2c51120cf17ed2'],60,2153,2213,16978945,16,0.377607025,0.684961581,0.699231614,6921
18acca92ee802c138db4eaaea8a6bc53f8ec0faf,0,Tim Armstrong,2021-01-21 19:35:26+00:00,['5852a0028b2b89d64f2b3281c91c3e23f2788f14'],5,340,345,16979290,5,0,1,0.8125,6921
1ada739e81416a6f49f2e8bb287a007252371444,1,Impala Public Jenkins,2021-01-22 05:31:37+00:00,['18acca92ee802c138db4eaaea8a6bc53f8ec0faf'],358,1278,1636,16980926,16,0.074074074,0.975308642,0.728395062,6922
6d4756da0123b8b4e0b49e1d7e37651dc02db7fd,1,Impala Public Jenkins,2021-01-22 20:39:59+00:00,['1ada739e81416a6f49f2e8bb287a007252371444'],1,1,2,16980928,1,,,,6922
2644203d1cbdd124a75a3da80fc176a447f3164c,1,Impala Public Jenkins,2021-01-25 16:05:00+00:00,['6d4756da0123b8b4e0b49e1d7e37651dc02db7fd'],21,71,92,16981020,2,0,0.791666667,0.791666667,6922
e8720b40f1b04712442dd9eb69cd603855eb6b8d,0,Impala Public Jenkins,2021-01-26 00:43:39+00:00,['2644203d1cbdd124a75a3da80fc176a447f3164c'],5,402,407,16981427,16,0.198830409,0.637426901,0.701754386,6924
3b763b5c3235ebdb445ad0a4ae1bf79385e8df02,0,Impala Public Jenkins,2021-01-26 08:32:29+00:00,['e8720b40f1b04712442dd9eb69cd603855eb6b8d'],0,29,29,16981456,2,1,1,0.294117647,6924
eb85c6eeca77c748a01d304625ea5d608a3e12c0,0,Impala Public Jenkins,2021-01-26 11:22:08+00:00,['3b763b5c3235ebdb445ad0a4ae1bf79385e8df02'],4,2985,2989,16984445,14,,,,6935
f4584dd2763edda9a24e4466b2d0a8f4bb065437,0,Tim Armstrong,2021-01-26 16:47:27+00:00,['eb85c6eeca77c748a01d304625ea5d608a3e12c0'],5,8,13,16984458,2,,,,6935
08367e91f04508b54f77b56e0d211dd167b0116f,1,Impala Public Jenkins,2021-01-26 22:12:25+00:00,['f4584dd2763edda9a24e4466b2d0a8f4bb065437'],1,98,99,16984557,4,1,1,1,6935
4ae847bf94e0a1e07860c9c7aa3f0dfcdf548fac,0,Tim Armstrong,2021-01-27 17:30:37+00:00,['08367e91f04508b54f77b56e0d211dd167b0116f'],11,223,234,16984791,3,0.666666667,0.666666667,1,6935
4c828b65abba7abee7cf509ef334ee39f0c1fc1c,0,Impala Public Jenkins,2021-01-27 23:33:14+00:00,['4ae847bf94e0a1e07860c9c7aa3f0dfcdf548fac'],4,9,13,16984804,1,,,,6935
39c424d7c8caaef2b1428d60632d349adcab39a3,0,Impala Public Jenkins,2021-01-28 04:19:39+00:00,['4c828b65abba7abee7cf509ef334ee39f0c1fc1c'],30,56,86,16984890,3,1,1,1,6935
f086d5c6f9e11da8b67ca1697fa51cdc16f3cceb,0,Joe McDonnell,2021-01-29 00:18:33+00:00,['39c424d7c8caaef2b1428d60632d349adcab39a3'],0,1,1,16984891,1,,,,6935
646b0e011c1af93901667de987c350f60f34e62d,1,wangsheng,2021-02-01 11:14:01+00:00,['f086d5c6f9e11da8b67ca1697fa51cdc16f3cceb'],17,117,134,16985025,8,1,0.894736842,0.736842105,6936
a81c6a78294d1da72b57ed90ec4e365de8c4e54b,0,Impala Public Jenkins,2021-02-01 16:55:53+00:00,['646b0e011c1af93901667de987c350f60f34e62d'],3,8,11,16985036,1,0,0,1,6936
1a38924d20679ffeb4550766a30b3be56763dc71,0,Impala Public Jenkins,2021-02-03 21:01:24+00:00,['a81c6a78294d1da72b57ed90ec4e365de8c4e54b'],1,12,13,16985049,1,0,0,0,6936
91fd8fd13075327d03a57bcfebfabec72388a357,0,Impala Public Jenkins,2021-02-03 23:01:27+00:00,['1a38924d20679ffeb4550766a30b3be56763dc71'],2,2,4,16985053,1,,,,6936
b5e2a0ce2ed34dc12a47da23ec2adf65a2f60c0a,0,Impala Public Jenkins,2021-02-04 05:12:42+00:00,['91fd8fd13075327d03a57bcfebfabec72388a357'],11,510,521,16985574,14,0.189090909,0.770909091,0.967272727,6936
f8ed3f67229c70dbc69501c72bdc146b88b55e4b,0,Impala Public Jenkins,2021-02-04 05:42:26+00:00,['b5e2a0ce2ed34dc12a47da23ec2adf65a2f60c0a'],0,10,10,16985584,2,1,1,1,6936
60f8f87b09a27618df2ac73c1cc6dcd052f8c60d,0,Joe McDonnell,2021-02-04 17:03:57+00:00,['f8ed3f67229c70dbc69501c72bdc146b88b55e4b'],4,44,48,16985632,5,1,1,1,6937
e71ea69bb8e80efc5559309195c3b62b06015530,0,Impala Public Jenkins,2021-02-05 06:35:26+00:00,['60f8f87b09a27618df2ac73c1cc6dcd052f8c60d'],80,28,108,16985740,4,1,1,0.444444444,6937
93d4348b543a74248af9a64757fffe3d9a158648,0,Impala Public Jenkins,2021-02-05 11:22:55+00:00,['e71ea69bb8e80efc5559309195c3b62b06015530'],49,206,255,16985995,4,,,,6939
0473e1b973b18c3ad8845a99fb1b1e70bc7c70fc,0,Impala Public Jenkins,2021-02-05 11:54:00+00:00,['93d4348b543a74248af9a64757fffe3d9a158648'],5,171,176,16986171,4,1,1,1,6939
a3f441193d25c6ca721d59ba88129b643b8ad69f,1,Impala Public Jenkins,2021-02-05 14:46:08+00:00,['0473e1b973b18c3ad8845a99fb1b1e70bc7c70fc'],9,245,254,16986425,7,0.888888889,1,0.944444444,6940
81d5377c27f1940235db332e43f1d0f073cf3d2f,0,Tim Armstrong,2021-02-05 22:11:33+00:00,['a3f441193d25c6ca721d59ba88129b643b8ad69f'],7,7,14,16986439,1,,,,6940
701714b10a77aee62cf2ad3e25db9e2dfd418780,1,Impala Public Jenkins,2021-02-07 05:20:48+00:00,['81d5377c27f1940235db332e43f1d0f073cf3d2f'],0,12,12,16986451,2,,,,6940
8551805875fcd2c701d988df887c1173520fca12,0,Tim Armstrong,2021-02-09 17:14:49+00:00,['701714b10a77aee62cf2ad3e25db9e2dfd418780'],0,9,9,16986460,2,,,,6940
1f7b413d11321bd74aaa1a9ea9ed30e42222d80d,0,Impala Public Jenkins,2021-02-09 21:44:33+00:00,['8551805875fcd2c701d988df887c1173520fca12'],4,2,6,16986466,1,1,1,1,6940
f888d362951454b273114c98686193498c0d3fe0,0,Impala Public Jenkins,2021-02-10 06:05:51+00:00,['1f7b413d11321bd74aaa1a9ea9ed30e42222d80d'],9,16,25,16986491,1,1,1,1,6940
79bee3befbc6cdcd358373822a0a3b4d19ab5ce0,0,Impala Public Jenkins,2021-02-10 06:56:45+00:00,['f888d362951454b273114c98686193498c0d3fe0'],14,115,129,16986620,5,,,,6941
b42c64993d46893488a667fb9c425548fdf964ab,1,Impala Public Jenkins,2021-02-10 23:52:28+00:00,['79bee3befbc6cdcd358373822a0a3b4d19ab5ce0'],385,5065,5450,16992070,44,0.160904255,0.341755319,0.481382979,6946
24a3f007710c38f71ccd8f7f2412a387708771f9,0,Tim Armstrong,2021-02-11 17:51:17+00:00,['b42c64993d46893488a667fb9c425548fdf964ab'],1,9,10,16992080,1,,,,6946
6fe3466d4d0a88941206aed8d265d9663758fec2,1,Impala Public Jenkins,2021-02-11 23:34:47+00:00,['24a3f007710c38f71ccd8f7f2412a387708771f9'],516,5760,6276,16998356,8,0.818181818,0.818181818,0.818181818,6949
4721978e8fb6d80a9f023e568b983b12b14f8acc,0,Impala Public Jenkins,2021-02-12 06:15:21+00:00,['6fe3466d4d0a88941206aed8d265d9663758fec2'],1,58,59,16998415,2,0,0,0,6949
baf81dea6d752d92de27165509d39c345e4f6503,0,Aman Sinha,2021-02-13 23:02:54+00:00,['4721978e8fb6d80a9f023e568b983b12b14f8acc'],2,38,40,16998455,3,1,1,1,6949
dc133d951389924e1f38856db1777d2b334dc7a2,0,Impala Public Jenkins,2021-02-15 22:25:41+00:00,['baf81dea6d752d92de27165509d39c345e4f6503'],1,1,2,16998457,1,,,,6949
9736e4c4777bdac306e8dd3fce58061ecc5d6692,0,Bikramjeet Vig,2021-02-17 00:40:22+00:00,['dc133d951389924e1f38856db1777d2b334dc7a2'],1,1,2,16998459,1,,,,6949
490aff51b9e3289f2225d3918734821cab7f28c2,0,Impala Public Jenkins,2021-02-17 05:57:20+00:00,['9736e4c4777bdac306e8dd3fce58061ecc5d6692'],5,8,13,16998472,1,0,1,1,6949
65c6a81ed908084da2175e97664c0f76ded9aed8,1,Impala Public Jenkins,2021-02-17 17:09:48+00:00,['490aff51b9e3289f2225d3918734821cab7f28c2'],0,447,447,16998919,11,0.403614458,0.855421687,0.710843373,6951
08cb4d36d206a1e218fe76dc83639dc581a0943b,1,Impala Public Jenkins,2021-02-17 22:52:05+00:00,['65c6a81ed908084da2175e97664c0f76ded9aed8'],53,2202,2255,17001174,38,0.56969697,0.850909091,0.912727273,6966
a55661d02bff6e02414010fd4cc799b5952ee9ae,0,Impala Public Jenkins,2021-02-18 08:49:13+00:00,['08cb4d36d206a1e218fe76dc83639dc581a0943b'],0,633,633,17001807,1,0.323308271,0.56641604,0.844611529,6967
ebb2e0663988d4fb597aeecb4defebbda1669f12,1,Impala Public Jenkins,2021-02-18 14:31:51+00:00,['a55661d02bff6e02414010fd4cc799b5952ee9ae'],3411,13045,16456,17018263,150,0.398996236,0.520702635,0.539523212,6969
5b0675fc5ced03de6093bf0d54c6702d2a6547b3,1,Impala Public Jenkins,2021-02-18 23:12:47+00:00,['ebb2e0663988d4fb597aeecb4defebbda1669f12'],339,908,1247,17019510,14,0.793103448,0.729885057,0.442528736,6975
4a65fcfbe55f9a9132402459480ddb16b4a85d2b,0,Impala Public Jenkins,2021-02-19 01:33:59+00:00,['5b0675fc5ced03de6093bf0d54c6702d2a6547b3'],2,2,4,17019514,1,,,,6975
c5e8c973221be640063472226a42ee6776dd9f2a,0,Impala Public Jenkins,2021-02-19 06:30:59+00:00,['4a65fcfbe55f9a9132402459480ddb16b4a85d2b'],0,10,10,17019524,1,0,1,1,6975
7f60990028cb7fba71a29b9f3f518f5cc8d43a0b,1,Impala Public Jenkins,2021-02-19 13:32:09+00:00,['c5e8c973221be640063472226a42ee6776dd9f2a'],0,152,152,17019676,7,0.835616438,0.835616438,0.657534247,6976
9c990dedacf85f51cdff99195147e01b413b729e,0,Impala Public Jenkins,2021-02-19 18:59:27+00:00,['7f60990028cb7fba71a29b9f3f518f5cc8d43a0b'],5,4,9,17019685,1,,,,6976
7c8e3eb4400f5924c2ed12be92899d254d5b412b,0,Impala Public Jenkins,2021-02-19 23:07:43+00:00,['9c990dedacf85f51cdff99195147e01b413b729e'],140,82,222,17019907,7,1,1,0.625,6976
85e39e170fab6ceb579dac442995239857efca42,1,Impala Public Jenkins,2021-02-19 23:54:44+00:00,['7c8e3eb4400f5924c2ed12be92899d254d5b412b'],277,4334,4611,17024518,26,0.211446046,0.570991699,0.784185234,6981
d271baa33da1a02aa6ffc47b0380dc62239107b4,0,Impala Public Jenkins,2021-02-20 06:28:17+00:00,['85e39e170fab6ceb579dac442995239857efca42'],59,126,185,17024703,20,1,1,1,6981
89a5fc789cb7cdbab08e331c4c95d9cd4eb30b8d,0,Impala Public Jenkins,2021-02-22 15:54:16+00:00,['d271baa33da1a02aa6ffc47b0380dc62239107b4'],3,18,21,17024724,2,0.363636364,0.363636364,1,6981
47850f15128577ae39ec1c182171718dae483469,0,Impala Public Jenkins,2021-02-23 04:37:28+00:00,['89a5fc789cb7cdbab08e331c4c95d9cd4eb30b8d'],12,21,33,17024757,2,,,,6981
15fd8c92a80817158a900dab8e1da1d64f47f9a8,0,Csaba Ringhofer,2021-02-23 08:35:07+00:00,['47850f15128577ae39ec1c182171718dae483469'],3,2,5,17024762,2,,,,6981
c004cc686df8b258bc19610b7c4c8df8507367a1,0,Impala Public Jenkins,2021-02-23 08:41:05+00:00,['15fd8c92a80817158a900dab8e1da1d64f47f9a8'],1,15,16,17024778,1,1,1,1,6981
b9593d572514c3d72dea79aee5d841760d841e05,0,Joe McDonnell,2021-02-23 15:59:38+00:00,['c004cc686df8b258bc19610b7c4c8df8507367a1'],20,18,38,17024816,3,1,1,0.714285714,6981
8059af8cee3563b42ffe04179add49c15c8067a8,0,Impala Public Jenkins,2021-02-23 21:57:04+00:00,['b9593d572514c3d72dea79aee5d841760d841e05'],12,22,34,17024850,3,1,1,1,6981
c8d94e6e365ca21d731617767bd7793f67f32222,0,Impala Public Jenkins,2021-02-24 00:23:57+00:00,['8059af8cee3563b42ffe04179add49c15c8067a8'],0,44,44,17024894,2,0,0.676470588,0.676470588,6981
20d4df365196a04d061a1d19520580847de952e5,0,Impala Public Jenkins,2021-02-24 02:12:10+00:00,['c8d94e6e365ca21d731617767bd7793f67f32222'],1,11,12,17024906,2,,,,6981
f13170ef655e92e624ac65a381dd42bba6c084e5,0,Impala Public Jenkins,2021-02-24 23:06:27+00:00,['20d4df365196a04d061a1d19520580847de952e5'],7,19,26,17024932,2,1,1,1,6981
285cea92910ee59a96a8c9c78c74272dedcbf1f9,0,Impala Public Jenkins,2021-02-25 01:22:03+00:00,['f13170ef655e92e624ac65a381dd42bba6c084e5'],13,24,37,17024969,2,0,0,0,6981
bead2ede1c79fb477d2fb4d2f73703df1e34e97a,0,Impala Public Jenkins,2021-02-25 07:50:36+00:00,['285cea92910ee59a96a8c9c78c74272dedcbf1f9'],1,1,2,17024971,1,,,,6981
d038e392de8ba453155040f3ca1ae33f03e39b2e,0,Impala Public Jenkins,2021-02-25 16:05:11+00:00,['bead2ede1c79fb477d2fb4d2f73703df1e34e97a'],4,127,131,17025102,5,0.025974026,0.415584416,0.935064935,6981
9f1b5272a1ed0f1970ace7ba820d1c0dba590f46,0,Impala Public Jenkins,2021-02-26 02:46:08+00:00,['d038e392de8ba453155040f3ca1ae33f03e39b2e'],6,6,12,17025114,1,0,0,0,6981
16493c0416d5de9c02e70c9b786e980a739020da,0,Impala Public Jenkins,2021-02-26 22:52:16+00:00,['9f1b5272a1ed0f1970ace7ba820d1c0dba590f46'],13,52,65,17025179,2,0.066666667,0.066666667,0.066666667,6981
466c26047b13ea67b9bc3eef91d14d5c9c19db61,0,Impala Public Jenkins,2021-02-26 23:44:32+00:00,['16493c0416d5de9c02e70c9b786e980a739020da'],0,12,12,17025191,1,,,,6981
801efdcf097e82c79a077141c753d6d4d44d83e8,0,Impala Public Jenkins,2021-02-28 00:27:40+00:00,['466c26047b13ea67b9bc3eef91d14d5c9c19db61'],2,2,4,17025195,2,,,,6981
49ac55fb691e280ccf061a3fa067aff938614af9,1,Impala Public Jenkins,2021-03-02 04:58:51+00:00,['801efdcf097e82c79a077141c753d6d4d44d83e8'],1828,1896,3724,17028919,154,0,0.958333333,0.666666667,6981
3554b0752d4be142dabb82b6b751323cde5323d8,1,Impala Public Jenkins,2021-03-02 05:57:26+00:00,['49ac55fb691e280ccf061a3fa067aff938614af9'],25,82,107,17029026,14,0.4,0.933333333,0.433333333,6981
a47700ed790c2415e52a85e40063bed53a7cb9e8,1,Vihang Karajgaonkar,2021-03-02 21:44:24+00:00,['3554b0752d4be142dabb82b6b751323cde5323d8'],6,121,127,17029153,5,0.588235294,0.588235294,0.617647059,6983
ca17e307ab3abb2c95c27b3ba749adf6bf16efc7,0,Impala Public Jenkins,2021-03-03 22:46:05+00:00,['a47700ed790c2415e52a85e40063bed53a7cb9e8'],9,137,146,17029299,10,0.133333333,0.133333333,0.133333333,6983
d89c04bf806682d3449c566ce979632bd2ac5b29,0,Thomas Tauber-Marshall,2021-03-04 01:03:04+00:00,['ca17e307ab3abb2c95c27b3ba749adf6bf16efc7'],16,56,72,17029371,6,0.107142857,0.964285714,0.964285714,6983
06fbb0d629e14d7129a5d0d7cf271e38362830e6,0,Impala Public Jenkins,2021-03-09 23:03:05+00:00,['d89c04bf806682d3449c566ce979632bd2ac5b29'],2,15,17,17029388,2,0,1,1,6983
b2088b30d7a4bc46878ca4815a89561551c05b15,0,Impala Public Jenkins,2021-03-10 05:07:25+00:00,['06fbb0d629e14d7129a5d0d7cf271e38362830e6'],0,38,38,17029426,2,0.1,0.9,1,6983
2039746ebecaf75b416d46abb4201e19bcbb98d8,0,Quanlong Huang,2021-03-12 00:00:03+00:00,['b2088b30d7a4bc46878ca4815a89561551c05b15'],1,2,3,17029429,1,,,,6983
a29d06db533e371eb28fc2a4afe8fd2e1803dcad,0,Impala Public Jenkins,2021-03-12 03:15:44+00:00,['2039746ebecaf75b416d46abb4201e19bcbb98d8'],7,26,33,17029462,4,0,1,1,6983
1a01bfe831b548204cde8087def51a2f27b40cb4,1,Zoltan Borok-Nagy,2021-03-12 14:23:04+00:00,['a29d06db533e371eb28fc2a4afe8fd2e1803dcad'],3586,3854,7440,17036902,127,0.361842105,0.671052632,0.855263158,6983
0d22e89df452d3e21912b60c72a087a3e8c38057,1,Impala Public Jenkins,2021-03-12 16:13:48+00:00,['1a01bfe831b548204cde8087def51a2f27b40cb4'],0,182,182,17037084,4,0.851851852,0.851851852,0.691358025,6983
311938b4f500aeb26f5a42cd955231588821e18b,1,Thomas Tauber-Marshall,2021-03-12 17:49:08+00:00,['0d22e89df452d3e21912b60c72a087a3e8c38057'],760,959,1719,17038803,21,0.258823529,0.270588235,0,6984
b3d95d8f32c33c60657d6f518fe87a624509a618,0,Thomas Tauber-Marshall,2021-03-12 17:49:08+00:00,['311938b4f500aeb26f5a42cd955231588821e18b'],46,99,145,17038948,12,0.481481481,0.481481481,0,6984
2e53c11484dd1f9044020b0035d9eab96d496a9c,1,Thomas Tauber-Marshall,2021-03-12 17:49:08+00:00,['b3d95d8f32c33c60657d6f518fe87a624509a618'],6,64,70,17039018,10,0.451612903,1,1,6984
d5f67fce41a919b9904c70e53740d8bfd5831e71,0,Impala Public Jenkins,2021-03-12 18:19:11+00:00,['2e53c11484dd1f9044020b0035d9eab96d496a9c'],1,16,17,17039035,2,0.7,0.7,0.7,6984
6c6b0ee869a766ba816e82c2fc821e499b2041c2,1,Impala Public Jenkins,2021-03-12 19:28:19+00:00,['d5f67fce41a919b9904c70e53740d8bfd5831e71'],46,686,732,17039767,18,0.783673469,0.934693878,0.914285714,6987
2dfc68d85277f05bf20c09e31dd10c9474ada62c,1,Impala Public Jenkins,2021-03-13 11:20:08+00:00,['6c6b0ee869a766ba816e82c2fc821e499b2041c2'],64,303,367,17040134,68,0.615384615,0,0.923076923,6987
47219ec3663fa8e27ea16b826425b139c94580da,0,Aman Sinha,2021-03-14 03:35:40+00:00,['2dfc68d85277f05bf20c09e31dd10c9474ada62c'],6,143,149,17040283,8,0.102040816,0,1,6988
37ec96e72af782900760e24eb520dd7904c3d632,1,Impala Public Jenkins,2021-03-14 13:41:40+00:00,['47219ec3663fa8e27ea16b826425b139c94580da'],0,6,6,17040289,1,1,1,1,6988
c60a626ac66cc7cf24080b7ea84166c70bad9b22,0,Aman Sinha,2021-03-15 20:55:29+00:00,['37ec96e72af782900760e24eb520dd7904c3d632'],137,138,275,17040564,2,,,,6988
573c60a29849643b03fcd3a24ff88bdccc13fdac,0,Impala Public Jenkins,2021-03-16 01:14:06+00:00,['c60a626ac66cc7cf24080b7ea84166c70bad9b22'],0,2,2,17040566,1,0,0,1,6988
768722b8686c15d84af3c0a94427edd70e9efb9f,0,Joe McDonnell,2021-03-16 15:17:26+00:00,['573c60a29849643b03fcd3a24ff88bdccc13fdac'],12,99,111,17040677,9,0.897959184,0.959183673,0.775510204,6988
122bd9ea06dc9ebd126fe4f99d62651957016176,0,Joe McDonnell,2021-03-16 15:17:26+00:00,['768722b8686c15d84af3c0a94427edd70e9efb9f'],17,120,137,17040814,5,0.222222222,0.314814815,0,6988
3e8250153108954870409fa27e35b33d608c5cb7,0,Impala Public Jenkins,2021-03-17 22:14:44+00:00,['122bd9ea06dc9ebd126fe4f99d62651957016176'],0,169,169,17040983,5,0.292682927,0.292682927,0.292682927,6988
c823f17f2c842d679b5b36e3b214b5a88b473b45,0,Impala Public Jenkins,2021-03-18 00:36:54+00:00,['3e8250153108954870409fa27e35b33d608c5cb7'],28,137,165,17041148,5,0,0.967213115,0.360655738,6988
decb79d0328f6b4daa74ca4228291571e7b4b668,1,Impala Public Jenkins,2021-03-18 00:39:22+00:00,['c823f17f2c842d679b5b36e3b214b5a88b473b45'],39,124,163,17041311,8,0.391304348,1,1,6988
231d41ae1f2ea19e1b7a94866ce11041685aa857,0,Impala Public Jenkins,2021-03-18 01:31:25+00:00,['decb79d0328f6b4daa74ca4228291571e7b4b668'],7,43,50,17041361,5,0.736842105,0.789473684,0.789473684,6988
ac4984b74fdb20ff16b8c3054969e781875d9c68,1,Impala Public Jenkins,2021-03-18 07:24:31+00:00,['231d41ae1f2ea19e1b7a94866ce11041685aa857'],138,137,275,17041636,2,,,,6988
61623438428deebdeb73225f664242d5a4aeba46,1,Impala Public Jenkins,2021-03-18 19:35:58+00:00,['ac4984b74fdb20ff16b8c3054969e781875d9c68'],41,133,174,17041810,7,0.892857143,1,0,6988
98de1c5436415c270901e4af76e0ec06deee1f32,1,Impala Public Jenkins,2021-03-18 21:08:14+00:00,['61623438428deebdeb73225f664242d5a4aeba46'],112,1004,1116,17042926,23,0.095588235,0.799019608,0.534313725,6990
879986ea6f478cfa35f78249d25441fc6d15cc3d,0,Impala Public Jenkins,2021-03-19 22:24:29+00:00,['98de1c5436415c270901e4af76e0ec06deee1f32'],12,30,42,17042968,4,0,0.3,0.5,6990
c9d7bcb4a1e77deaa431b152b0833e46cb267239,1,Impala Public Jenkins,2021-03-22 08:41:00+00:00,['879986ea6f478cfa35f78249d25441fc6d15cc3d'],238,517,755,17043723,23,0.385964912,1,0.675438596,6990
a0f77680c53d4bd4b85aa2d80224dbd76dd15126,1,Impala Public Jenkins,2021-03-22 15:52:03+00:00,['c9d7bcb4a1e77deaa431b152b0833e46cb267239'],58,297,355,17044078,8,0.114754098,1,0.295081967,6990
e5d5dbc30a253b6385e5d84dcf53435166d55314,0,Impala Public Jenkins,2021-03-22 19:34:00+00:00,['a0f77680c53d4bd4b85aa2d80224dbd76dd15126'],1,1,2,17044080,1,,,,6990
b28da054f3595bb92873433211438306fc22fbc7,0,Impala Public Jenkins,2021-03-22 23:33:55+00:00,['e5d5dbc30a253b6385e5d84dcf53435166d55314'],0,1,1,17044081,1,1,1,0,6990
410c3e79e4eeba0a3f1ad62f6bf2f11b2de48819,1,Impala Public Jenkins,2021-03-23 22:52:38+00:00,['b28da054f3595bb92873433211438306fc22fbc7'],0,218,218,17044299,5,0.081081081,0.959459459,0.094594595,6991
622e3c95adca5cf30a0aff6542556feab9b8a861,0,Impala Public Jenkins,2021-03-24 15:16:07+00:00,['410c3e79e4eeba0a3f1ad62f6bf2f11b2de48819'],0,114,114,17044413,4,1,1,0,6991
452c2f1f7f9cc4c8472ab38949e9990281dcc3a3,0,Impala Public Jenkins,2021-03-24 19:06:09+00:00,['622e3c95adca5cf30a0aff6542556feab9b8a861'],1,9,10,17044423,1,1,1,1,6991
e3bafcbef4fd7152ecfcbc7d331e41e9778caf15,0,Impala Public Jenkins,2021-03-24 22:41:27+00:00,['452c2f1f7f9cc4c8472ab38949e9990281dcc3a3'],49,278,327,17044750,10,0.11965812,0.615384615,0.273504274,6991
5b27b7ca7232a17d2a099f8567553004248989f2,0,Impala Public Jenkins,2021-03-25 02:51:54+00:00,['e3bafcbef4fd7152ecfcbc7d331e41e9778caf15'],2,16,18,17044768,1,1,0,1,6991
281a47caad1c7c53033ee1ce0affa35b8fd4d2d7,1,Impala Public Jenkins,2021-03-25 21:45:10+00:00,['5b27b7ca7232a17d2a099f8567553004248989f2'],9,21,30,17044798,1,0,0,0,6991
0b79464d9c74d3cc89230a5a3ec3c3955ea2a953,1,Impala Public Jenkins,2021-03-25 22:59:16+00:00,['281a47caad1c7c53033ee1ce0affa35b8fd4d2d7'],7,6,13,17044811,1,,,,6991
2e5589d85fa5b6be1ec0378d31d4040547f6ef71,0,Impala Public Jenkins,2021-03-27 09:05:32+00:00,['0b79464d9c74d3cc89230a5a3ec3c3955ea2a953'],4,7,11,17044822,2,1,0,1,6991
cf463f28c3ff98749cf38093ab1deeab0b070895,0,Impala Public Jenkins,2021-03-27 12:26:23+00:00,['2e5589d85fa5b6be1ec0378d31d4040547f6ef71'],8,20,28,17044850,4,1,1,0.5,6991
8f8668aaf0960d5c86b88cb1d8433012cf7cd6b5,0,Impala Public Jenkins,2021-03-28 05:51:18+00:00,['cf463f28c3ff98749cf38093ab1deeab0b070895'],1,8,9,17044859,2,1,1,1,6991
77d6acd032333d54063b43db25d35b5f29fc2c38,0,Impala Public Jenkins,2021-03-29 15:59:49+00:00,['8f8668aaf0960d5c86b88cb1d8433012cf7cd6b5'],13,157,170,17045029,6,0.448275862,1,0,6991
dbc2fc14d86f84b25670ee9af7cedbbc3cd18b9f,1,Impala Public Jenkins,2021-03-29 18:32:31+00:00,['77d6acd032333d54063b43db25d35b5f29fc2c38'],6,92,98,17045127,5,0.058823529,0.088235294,0.970588235,6991
7198f07c9237e9b46b0442a256a704c216f22235,0,Impala Public Jenkins,2021-03-30 01:05:40+00:00,['dbc2fc14d86f84b25670ee9af7cedbbc3cd18b9f'],1,1,2,17045129,1,,,,6991
103774a8e517e5c8532e313df29e67008bc56617,0,Joe McDonnell,2021-03-30 01:27:04+00:00,['7198f07c9237e9b46b0442a256a704c216f22235'],5,6,11,17045140,2,,,,6991
45fb0fb3e7d8541ef2886cb8d5c9510955bbe242,0,Impala Public Jenkins,2021-03-30 23:46:48+00:00,['103774a8e517e5c8532e313df29e67008bc56617'],23,3,26,17045166,1,1,1,0,6991
1142c7b58eeb26cf727327c0e42329184cfd52bf,0,Joe McDonnell,2021-03-31 03:17:24+00:00,['45fb0fb3e7d8541ef2886cb8d5c9510955bbe242'],121,88,209,17045375,5,1,0,0,6991
9670c1455d7088bf76cb285f2f00f212e3df647c,0,Joe McDonnell,2021-03-31 03:17:24+00:00,['1142c7b58eeb26cf727327c0e42329184cfd52bf'],34,22,56,17045431,1,,,,6991
e7fc18c4ea4907b86c36ffba90a59e98d32c28e0,0,Joe McDonnell,2021-03-31 03:17:24+00:00,['9670c1455d7088bf76cb285f2f00f212e3df647c'],60,15,75,17045506,7,0,0,0,6991
2baed42736481280d9279642efeb72b504b832ba,1,Impala Public Jenkins,2021-03-31 05:38:50+00:00,['e7fc18c4ea4907b86c36ffba90a59e98d32c28e0'],116,602,718,17046224,11,0,0.665680473,0.553254438,6991
1d839e423e51b05314e3dbfd790cb1fa7fc82d98,0,Impala Public Jenkins,2021-03-31 08:45:05+00:00,['2baed42736481280d9279642efeb72b504b832ba'],31,82,113,17046337,1,0.142857143,1,0.238095238,6991
ec391ab25c690bddd7dd3f42410cb4882b186ddb,0,Impala Public Jenkins,2021-03-31 14:24:41+00:00,['1d839e423e51b05314e3dbfd790cb1fa7fc82d98'],4,6,10,17046347,1,,,,6991
ede22a63a5acec36031dfeddb86691821c24d40c,0,Joe McDonnell,2021-03-31 22:33:43+00:00,['ec391ab25c690bddd7dd3f42410cb4882b186ddb'],1,25,26,17046373,1,0.058823529,0.294117647,1,6991
4ef67c21153157d552a6d5db09f4c1e15cbe8ac0,0,Impala Public Jenkins,2021-04-01 03:07:19+00:00,['ede22a63a5acec36031dfeddb86691821c24d40c'],14,47,61,17046434,2,0,0.32,0,6991
553af0a1a18e38a854f0b15c4148188bfc9ba82e,0,Impala Public Jenkins,2021-04-01 04:15:27+00:00,['4ef67c21153157d552a6d5db09f4c1e15cbe8ac0'],1,1,2,17046436,1,,,,6991
d8ef9562cc6491f5d4de1a2229d0abc35dd44662,0,Impala Public Jenkins,2021-04-01 04:32:30+00:00,['553af0a1a18e38a854f0b15c4148188bfc9ba82e'],3,6,9,17046445,1,0,0,1,6991
96e7f85275056dd4ec1460ec8df3afb86d401e43,0,Impala Public Jenkins,2021-04-01 05:56:25+00:00,['d8ef9562cc6491f5d4de1a2229d0abc35dd44662'],1,7,8,17046453,1,0,0,1,6991
559f6044bed1c0bcfe0312b2eb2c349450628e76,0,Impala Public Jenkins,2021-04-01 15:09:10+00:00,['96e7f85275056dd4ec1460ec8df3afb86d401e43'],0,7,7,17046460,1,,,,6991
8ac761348aa805b53e0a13d85fd5c9b2de5f3985,0,Thomas Tauber-Marshall,2021-04-01 16:27:14+00:00,['559f6044bed1c0bcfe0312b2eb2c349450628e76'],46,113,159,17046619,4,0.689655172,0,0.413793103,6991
9adb093ae056f1bb7fcd14ba138fd23517648226,0,Impala Public Jenkins,2021-04-01 22:19:25+00:00,['8ac761348aa805b53e0a13d85fd5c9b2de5f3985'],9,125,134,17046753,6,0.428571429,0.542857143,0.957142857,6991
d621c68136b4a47388f579de5e3fe9fd3372bd68,0,Impala Public Jenkins,2021-04-01 22:22:27+00:00,['9adb093ae056f1bb7fcd14ba138fd23517648226'],2,4,6,17046759,1,,,,6991
2e71f35b2f8e6f6cc04a8bd55991e59cda4bc373,0,Impala Public Jenkins,2021-04-01 23:33:10+00:00,['d621c68136b4a47388f579de5e3fe9fd3372bd68'],5,12,17,17046776,1,,,,6991
87555314dc62f8d66e71a0ea8f6b92009a77e6ba,0,Impala Public Jenkins,2021-04-01 23:35:48+00:00,['2e71f35b2f8e6f6cc04a8bd55991e59cda4bc373'],1,36,37,17046813,1,,,,6991
b40870d55b68b1307569380b135475824aeac2e4,1,Impala Public Jenkins,2021-04-01 23:37:21+00:00,['87555314dc62f8d66e71a0ea8f6b92009a77e6ba'],4,32,36,17046849,2,1,0.5,1,6991
1ab1143e98ff09610dff82d1795cf103659ffe97,1,Impala Public Jenkins,2021-04-02 13:44:11+00:00,['b40870d55b68b1307569380b135475824aeac2e4'],14,29,43,17046892,5,,,,6991
1231208da7104c832c13f272d1e5b8f554d29337,1,Impala Public Jenkins,2021-04-02 21:50:17+00:00,['1ab1143e98ff09610dff82d1795cf103659ffe97'],141,1434,1575,17048467,37,0.259694477,0.28319624,0.593419506,6992
f18e0d72a7ef472c8084a3c02705be5192743c7d,0,Zoltan Borok-Nagy,2021-04-06 09:26:45+00:00,['1231208da7104c832c13f272d1e5b8f554d29337'],1,1,2,17048469,1,,,,6992
e30178dce447180ccd93e3375543b3bca2497e4c,1,Impala Public Jenkins,2021-04-06 14:21:05+00:00,['f18e0d72a7ef472c8084a3c02705be5192743c7d'],41,186,227,17048696,4,0.690909091,0.690909091,0.890909091,6992
34a183d3d6632c70c19af939d8034af2b5c42f11,0,Impala Public Jenkins,2021-04-07 05:46:39+00:00,['e30178dce447180ccd93e3375543b3bca2497e4c'],5,86,91,17048787,6,0.333333333,0.972222222,0.75,6992
ed0faaffb79557702b0ef0b952806bb632b62188,1,Impala Public Jenkins,2021-04-07 12:45:30+00:00,['34a183d3d6632c70c19af939d8034af2b5c42f11'],42,48,90,17048877,3,0.666666667,1,0,6992
a7eae471b84f05816780093938bba50f4d78aef1,0,Vihang Karajgaonkar,2021-04-08 01:01:22+00:00,['ed0faaffb79557702b0ef0b952806bb632b62188'],22,5398,5420,17054297,24,0.650259859,0.900642006,0.683583002,7003
5d307cbb7b2ec3432bebd7759b0bcebf54a6cc22,0,Vihang Karajgaonkar,2021-04-08 16:43:56+00:00,['a7eae471b84f05816780093938bba50f4d78aef1'],1,16,17,17054314,2,1,1,1,7003
d29fab1ad9a32c0200b71506c3b31f1ac8838e63,0,Joe McDonnell,2021-04-08 20:46:37+00:00,['5d307cbb7b2ec3432bebd7759b0bcebf54a6cc22'],6,34,40,17054354,1,0,0.909090909,0.272727273,7003
d7cc510c95c4850190ca02ae1397aef95cde3d98,1,Joe McDonnell,2021-04-08 20:46:37+00:00,['d29fab1ad9a32c0200b71506c3b31f1ac8838e63'],8,6,14,17054368,3,,,,7003
267f4d67f4f9c8b10af539f8f2e0a2abfa4bafd5,0,Impala Public Jenkins,2021-04-08 21:38:35+00:00,['d7cc510c95c4850190ca02ae1397aef95cde3d98'],37,54,91,17054459,1,,,,7003
829d1a6ab4643b07877fb410971b67f1b1d1b045,0,Joe McDonnell,2021-04-09 00:04:00+00:00,['267f4d67f4f9c8b10af539f8f2e0a2abfa4bafd5'],5398,22,5420,17059879,24,0.349740141,0.099357994,0.316416998,7003
1dcd59638c340e2e1d167f7e8b21019e897893a9,0,Impala Public Jenkins,2021-04-09 21:31:24+00:00,['829d1a6ab4643b07877fb410971b67f1b1d1b045'],4,8,12,17059891,1,,,,7003
bf4c2dfb3893d77bc288bd683e7a3b304377fe8c,0,Impala Public Jenkins,2021-04-09 23:23:47+00:00,['1dcd59638c340e2e1d167f7e8b21019e897893a9'],3,4,7,17059898,1,,,,7003
aa2302e53b0ba9ab493025f3c8aedb5401fb2360,0,Impala Public Jenkins,2021-04-10 00:51:47+00:00,['bf4c2dfb3893d77bc288bd683e7a3b304377fe8c'],0,4,4,17059902,1,0,0,1,7003
e01b6312593197749a17dd6895f976c35eac5769,0,Impala Public Jenkins,2021-04-10 01:13:05+00:00,['aa2302e53b0ba9ab493025f3c8aedb5401fb2360'],6,43,49,17059951,4,0.791666667,0.791666667,0.875,7003
de764ebecf9afbc123da0e47758a08ebbb8219d8,0,Aman Sinha,2021-04-12 21:06:55+00:00,['e01b6312593197749a17dd6895f976c35eac5769'],7,18,25,17059976,3,1,1,1,7003
6b16df9e9a4696b46b6f9c7fe2fc0aaded285623,0,Impala Public Jenkins,2021-04-13 17:59:21+00:00,['de764ebecf9afbc123da0e47758a08ebbb8219d8'],19,76,95,17060071,4,0,0,1,7003
a1a1f9922565f866692b17c82106a1a8f6ac64a5,0,Impala Public Jenkins,2021-04-14 17:40:34+00:00,['6b16df9e9a4696b46b6f9c7fe2fc0aaded285623'],4,6,10,17060081,4,,,,7003
fdb6a4e264ad3f156a76c4fc01d4c1b8f9b39189,0,Impala Public Jenkins,2021-04-15 09:44:10+00:00,['a1a1f9922565f866692b17c82106a1a8f6ac64a5'],0,4,4,17060085,2,,,,7003
a985e1134ee2a51cb44d0b6ccf83c77bcef64e83,0,Impala Public Jenkins,2021-04-20 00:44:48+00:00,['fdb6a4e264ad3f156a76c4fc01d4c1b8f9b39189'],29,223,252,17060337,9,0.1,0.311111111,0.822222222,7003
9355b25e118bd057396bdc36aee47d6e54c7d5cf,0,Impala Public Jenkins,2021-04-20 22:21:32+00:00,['a985e1134ee2a51cb44d0b6ccf83c77bcef64e83'],249,8,257,17060594,10,1,1,1,7003
dfc1b549687bf78226af8701bd67325b88c4ff69,0,Impala Public Jenkins,2021-04-21 03:09:32+00:00,['9355b25e118bd057396bdc36aee47d6e54c7d5cf'],1,34,35,17060629,5,1,1,1,7003
1fb7dbac0d43f3ccbbbbaaf9c41db10d3320fc48,0,Impala Public Jenkins,2021-04-21 08:45:57+00:00,['dfc1b549687bf78226af8701bd67325b88c4ff69'],34,314,348,17060977,11,0.525773196,0.81443299,0.845360825,7005
8336b7b3cd8ba90d37c3f7454a9c9c4074bca1f0,0,Impala Public Jenkins,2021-04-22 13:55:15+00:00,['1fb7dbac0d43f3ccbbbbaaf9c41db10d3320fc48'],6,50,56,17061033,2,0.102564103,0.102564103,0.923076923,7005
91d2ab2116293b8f45afd02d029d47233877c538,1,Impala Public Jenkins,2021-04-23 05:19:30+00:00,['8336b7b3cd8ba90d37c3f7454a9c9c4074bca1f0'],8,100,108,17061141,4,0,0,1,7005
8b46d00f641abdb89d3d22de5c9a5d7044075893,0,Impala Public Jenkins,2021-04-23 21:12:35+00:00,['91d2ab2116293b8f45afd02d029d47233877c538'],2,4,6,17061147,1,,,,7005
75fa056dc04c6cf2c153de29595d5568db6a074f,0,Impala Public Jenkins,2021-04-26 13:35:54+00:00,['8b46d00f641abdb89d3d22de5c9a5d7044075893'],1850,2623,4473,17065620,66,1,0,0,7020
32f0aa6dd2436966b503f30835ee694f45f69954,0,Joe McDonnell,2021-04-26 22:01:31+00:00,['75fa056dc04c6cf2c153de29595d5568db6a074f'],8,6,14,17065634,1,,,,7020
c65d7861d9ae28f6fc592727ff699a8155dcda2c,1,Impala Public Jenkins,2021-04-27 00:41:05+00:00,['32f0aa6dd2436966b503f30835ee694f45f69954'],226,247,473,17066107,12,1,0,0,7020
94f67a343294430b53da58d1af60e659af18545a,1,Impala Public Jenkins,2021-04-27 13:36:54+00:00,['c65d7861d9ae28f6fc592727ff699a8155dcda2c'],310,258,568,17066675,58,1,0,0,7020
af6adf7618f50444f50bc53e42b676f5a377f386,0,Impala Public Jenkins,2021-04-27 14:52:43+00:00,['94f67a343294430b53da58d1af60e659af18545a'],1,1579,1580,17068255,8,0.069868996,0.089519651,0.056768559,7024
f672c315bc4d08d56cc7399b86767d30c9676287,0,Csaba Ringhofer,2021-04-28 06:34:34+00:00,['af6adf7618f50444f50bc53e42b676f5a377f386'],0,3,3,17068258,1,0,0,1,7024
98aca0f416d1bd4eb967cc3800ad95c3c712c0df,0,Zoltan Borok-Nagy,2021-04-29 13:13:17+00:00,['f672c315bc4d08d56cc7399b86767d30c9676287'],1,66,67,17068325,2,0,0.5,1,7024
87384e3377ee25f56a16573cf8493c19b4578258,0,Impala Public Jenkins,2021-04-29 19:49:34+00:00,['98aca0f416d1bd4eb967cc3800ad95c3c712c0df'],4,6,10,17068335,2,1,,,7024
676f79aa81d02c8638439edf6a43841fb0a7671e,0,Impala Public Jenkins,2021-04-30 23:36:31+00:00,['87384e3377ee25f56a16573cf8493c19b4578258'],9,23,32,17068367,3,0.833333333,1,0,7024
f0f083e45e2c77b1499fa6fa08ff8d9dc4a2785f,0,Impala Public Jenkins,2021-05-03 20:42:30+00:00,['676f79aa81d02c8638439edf6a43841fb0a7671e'],2,233,235,17068602,8,0.333333333,0.888888889,0.444444444,7024
603091ed772f3f82511fd8fec355fe9b0126933b,1,Csaba Ringhofer,2021-05-05 05:41:29+00:00,['f0f083e45e2c77b1499fa6fa08ff8d9dc4a2785f'],28,85,113,17068715,2,0,0.581395349,0,7024
9253e0a9e7751a471ddfde754767ca8f56b14ec4,0,Impala Public Jenkins,2021-05-05 13:08:43+00:00,['603091ed772f3f82511fd8fec355fe9b0126933b'],0,11,11,17068726,1,,,,7024
e26543426c8b7cc86fc0d9f60c53c7a7fd7bc8a8,0,Impala Public Jenkins,2021-05-07 14:11:08+00:00,['9253e0a9e7751a471ddfde754767ca8f56b14ec4'],12,76,88,17068814,13,0.863636364,0.863636364,0.363636364,7026
c10e7c969dfcc4847a8f7708940f4aa1852dbee4,0,Joe McDonnell,2021-05-09 18:15:56+00:00,['e26543426c8b7cc86fc0d9f60c53c7a7fd7bc8a8'],156,120,276,17069090,8,1,0,0.214285714,7026
ff52064823695e0cfffc9c9df3e7a1487f7b570a,0,Impala Public Jenkins,2021-05-10 15:17:35+00:00,['c10e7c969dfcc4847a8f7708940f4aa1852dbee4'],39,42,81,17069171,6,0.80952381,1,1,7026
af0cb594e34b5691b0d00febdd6fa727b74018f6,0,Csaba Ringhofer,2021-05-11 11:57:13+00:00,['ff52064823695e0cfffc9c9df3e7a1487f7b570a'],10,298,308,17069479,1,,,,7026
e39c30b3cd94cc334068203a948bacdabf3eea41,1,Impala Public Jenkins,2021-05-11 18:07:40+00:00,['af0cb594e34b5691b0d00febdd6fa727b74018f6'],0,398,398,17069877,12,0.652542373,0.796610169,0.686440678,7028
42684b44d3f6c8f3cacfccaafb83cb11f1e90287,1,Impala Public Jenkins,2021-05-12 06:37:43+00:00,['e39c30b3cd94cc334068203a948bacdabf3eea41'],14,106,120,17069997,4,0.36,0.72,0.88,7028
986e236939256349474528d9ec48e5cb4ced34e6,0,Impala Public Jenkins,2021-05-12 07:05:52+00:00,['42684b44d3f6c8f3cacfccaafb83cb11f1e90287'],1,5,6,17070003,1,,,,7028
c8adc9ccd23400ea50319f50f724e8ae6ab33ec2,0,Vihang Karajgaonkar,2021-05-12 14:28:15+00:00,['986e236939256349474528d9ec48e5cb4ced34e6'],12,20,32,17070035,2,,,,7028
b1326f7eff62dd521989132d650fa8b53057085b,1,Impala Public Jenkins,2021-05-13 12:18:55+00:00,['c8adc9ccd23400ea50319f50f724e8ae6ab33ec2'],6,177,183,17070218,7,0.851851852,0.851851852,0.641975309,7029
4697db021411e95165cfd199e1aa3fc848dbfc8b,0,Impala Public Jenkins,2021-05-14 13:58:04+00:00,['b1326f7eff62dd521989132d650fa8b53057085b'],6,15,21,17070239,2,0,0,0.666666667,7029
9c38568657d62b6f6d7b10aa1c721ba843374dd8,0,Jim Apple,2021-05-15 22:20:58+00:00,['4697db021411e95165cfd199e1aa3fc848dbfc8b'],1,1,2,17070241,1,,,,7029
d2a1460b92a20404582166c5588e9c5319b97292,0,Vihang Karajgaonkar,2021-05-17 22:21:23+00:00,['9c38568657d62b6f6d7b10aa1c721ba843374dd8'],10,58,68,17070309,2,,,,7029
5c85bf5c54fb1e0dffbe01b3f70c289de3700a66,1,Vihang Karajgaonkar,2021-05-18 00:37:53+00:00,['d2a1460b92a20404582166c5588e9c5319b97292'],22,5406,5428,17075737,24,0.650473572,0.900702719,0.683776352,7040
d111443e8f9692a3eac734e565a5afc41980a0ba,0,Impala Public Jenkins,2021-05-18 13:54:33+00:00,['5c85bf5c54fb1e0dffbe01b3f70c289de3700a66'],2,36,38,17075775,3,0.666666667,0.888888889,1,7040
86beb2f9dd1454e25916b723dce3af23de2ac9e0,0,Impala Public Jenkins,2021-05-18 18:48:10+00:00,['d111443e8f9692a3eac734e565a5afc41980a0ba'],1,181,182,17075957,5,0.210526316,0.675438596,0.675438596,7040
824b39e82967261f5a40f26318cf0913751b5134,0,Impala Public Jenkins,2021-05-19 00:59:35+00:00,['86beb2f9dd1454e25916b723dce3af23de2ac9e0'],19,10,29,17075986,2,1,1,0,7040
202ba60c61a7dbcd4dfc5998a5fb94f3b9095d17,1,Impala Public Jenkins,2021-05-19 04:02:19+00:00,['824b39e82967261f5a40f26318cf0913751b5134'],34,437,471,17076457,11,0.244444444,0.894444444,0.922222222,7041
9cc4f5e2b97ee5c06f70d28b6f64ca8ff0194059,1,Impala Public Jenkins,2021-05-19 05:52:54+00:00,['202ba60c61a7dbcd4dfc5998a5fb94f3b9095d17'],2,15,17,17076474,7,0.5,1,1,7041
26eaa43dbe6f99a6f97f4d3e0eafb1cf7c24217c,0,Impala Public Jenkins,2021-05-19 08:16:27+00:00,['9cc4f5e2b97ee5c06f70d28b6f64ca8ff0194059'],1,25,26,17076500,5,0.545454545,0.545454545,0.818181818,7041
47d868fe586905b2f4ea347a97ce582a45aac405,0,Impala Public Jenkins,2021-05-19 12:36:49+00:00,['26eaa43dbe6f99a6f97f4d3e0eafb1cf7c24217c'],23,129,152,17076652,5,0.525,0.8,0.7625,7041
74407651427cdca574b49a4d57a83d8b552659ee,0,Impala Public Jenkins,2021-05-19 17:41:28+00:00,['47d868fe586905b2f4ea347a97ce582a45aac405'],3,3,6,17076658,1,,,,7041
71ccad2f415aa2e3f1cac35514c2d6b9c6db3ebc,0,Impala Public Jenkins,2021-05-20 11:35:04+00:00,['74407651427cdca574b49a4d57a83d8b552659ee'],64,2,66,17076724,3,0,0,0.777777778,7041
ced7b7d221cda30c65504e18082bb0af6c3cb595,1,Impala Public Jenkins,2021-05-20 19:19:50+00:00,['71ccad2f415aa2e3f1cac35514c2d6b9c6db3ebc'],48,2883,2931,17079655,21,0.672727273,0.818181818,0.209090909,7049
e11237e29ed3a41dd361dd7a541f9702d0d0b16b,0,Impala Public Jenkins,2021-05-24 11:38:42+00:00,['ced7b7d221cda30c65504e18082bb0af6c3cb595'],8,368,376,17080031,13,0.512820513,0,0.307692308,7051
b50d60a6c5b6fdd182dfc851841edae5cd1b3943,0,Impala Public Jenkins,2021-05-25 14:02:27+00:00,['e11237e29ed3a41dd361dd7a541f9702d0d0b16b'],298,985,1283,17081314,17,0.271468144,0.343490305,0.28531856,7051
8087c75f62504f177b0a1c9f02eecc4eb81e00fc,0,Vihang Karajgaonkar,2021-05-25 17:00:15+00:00,['b50d60a6c5b6fdd182dfc851841edae5cd1b3943'],2,9,11,17081325,1,0.5,0,0,7051
954eb5c85d329af7690698cdc4d0f409260e6d18,0,Aman Sinha,2021-05-25 22:33:51+00:00,['8087c75f62504f177b0a1c9f02eecc4eb81e00fc'],3174,3544,6718,17088043,15,0.35483871,0.806451613,0.247311828,7051
67de4a48b08208b3ebe907b05b303c91b68a20d7,0,Gabor Kaszab,2021-05-26 06:42:02+00:00,['954eb5c85d329af7690698cdc4d0f409260e6d18'],0,59,59,17088102,4,1,1,1,7051
4c07aff664beddf0d0f8e93a45e936176700a31b,0,Impala Public Jenkins,2021-05-26 09:59:34+00:00,['67de4a48b08208b3ebe907b05b303c91b68a20d7'],182,11,193,17088295,2,,,,7051
822e8373d1f1737865899b80862c2be7b07cc950,0,Joe McDonnell,2021-05-26 23:51:13+00:00,['4c07aff664beddf0d0f8e93a45e936176700a31b'],2,2,4,17088299,1,,,,7051
e24bdd2175062c30cc9a6bcf0eb2910e8f1f7cae,0,Impala Public Jenkins,2021-05-28 04:02:10+00:00,['822e8373d1f1737865899b80862c2be7b07cc950'],26,293,319,17088618,8,0.054054054,0.486486486,0.891891892,7051
b8343c1f8b8c31b39c6ac62e6ee136011c97d2fc,1,Impala Public Jenkins,2021-05-31 22:26:50+00:00,['e24bdd2175062c30cc9a6bcf0eb2910e8f1f7cae'],6,92,98,17088716,5,0.412698413,0.793650794,0.73015873,7051
20bdf9c96eb930d26ef6de06da06751959405b1f,0,Vihang Karajgaonkar,2021-06-02 16:33:24+00:00,['b8343c1f8b8c31b39c6ac62e6ee136011c97d2fc'],13,14,27,17088743,2,,,,7051
1a84a1420c5d517f43e4c7e90ee204db30f27d57,0,Joe McDonnell,2021-06-02 19:34:15+00:00,['20bdf9c96eb930d26ef6de06da06751959405b1f'],355,157,512,17089255,25,,,,7051
5574c8f7e6a0284d2e050361684cd616a0dd0140,0,Vihang Karajgaonkar,2021-06-02 19:55:27+00:00,['1a84a1420c5d517f43e4c7e90ee204db30f27d57'],0,67,67,17089322,2,,,,7052
817ca5920d93442b591a00bb8b280bd4e05f470c,0,Csaba Ringhofer,2021-06-03 06:32:45+00:00,['5574c8f7e6a0284d2e050361684cd616a0dd0140'],125,7310,7435,17096757,36,0.41171651,0.761982794,0.495288816,7065
700246fad9d207786a87aca6e833d49560596da6,0,Impala Public Jenkins,2021-06-03 16:14:20+00:00,['817ca5920d93442b591a00bb8b280bd4e05f470c'],244,609,853,17097610,7,0.952702703,1,0.554054054,7067
bb3062197b134f33e2796fac603e3367ab8bef1a,0,Quanlong Huang,2021-06-05 00:01:44+00:00,['700246fad9d207786a87aca6e833d49560596da6'],140,288,428,17098038,19,0,0.769230769,0.659340659,7067
ce21fe74b806757a1c9e52c614db95a76283c78c,0,Impala Public Jenkins,2021-06-07 12:53:23+00:00,['bb3062197b134f33e2796fac603e3367ab8bef1a'],1,140,141,17098179,6,1,1,0,7067
0c89a9cf0f2b642ca214e4fa68eeea9bc32ef3af,0,Impala Public Jenkins,2021-06-08 07:55:13+00:00,['ce21fe74b806757a1c9e52c614db95a76283c78c'],36,107,143,17098322,4,0.017857143,0.982142857,0.982142857,7067
9e70c61399f97469e8fc7180ccf6636046ee1a67,0,Impala Public Jenkins,2021-06-09 15:41:49+00:00,['0c89a9cf0f2b642ca214e4fa68eeea9bc32ef3af'],16,42,58,17098380,3,1,1,0.666666667,7067
975047f43c39225ac397e22192a5999f5a270c70,1,Vihang Karajgaonkar,2021-06-09 17:41:24+00:00,['9e70c61399f97469e8fc7180ccf6636046ee1a67'],46,713,759,17099139,6,0.248962656,0.394190871,0.325726141,7067
a4373983df279eebd519cfb78896ccef0ae4e81c,1,Impala Public Jenkins,2021-06-10 15:46:56+00:00,['975047f43c39225ac397e22192a5999f5a270c70'],2,521,523,17099662,12,0.382653061,0.642857143,0.520408163,7068
8e7a6227a49790950a8b1abced881d27b7b7bba4,0,Impala Public Jenkins,2021-06-10 22:24:16+00:00,['a4373983df279eebd519cfb78896ccef0ae4e81c'],0,44,44,17099706,5,1,1,1,7068
ebd3d444117e94226611a7aca0cf11639a7e65f4,0,Impala Public Jenkins,2021-06-11 02:37:38+00:00,['8e7a6227a49790950a8b1abced881d27b7b7bba4'],6,169,175,17099881,5,0.612903226,0.290322581,1,7069
a6d327f670ef0c7440f7ca467fb67adc6e6580d9,1,Impala Public Jenkins,2021-06-11 14:17:11+00:00,['ebd3d444117e94226611a7aca0cf11639a7e65f4'],4,26,30,17099911,2,1,1,1,7069
4290c5e2971b056f5249716655ef2f704465f383,0,Impala Public Jenkins,2021-06-14 17:13:25+00:00,['a6d327f670ef0c7440f7ca467fb67adc6e6580d9'],1,7,8,17099919,1,,,,7069
40c3074e79f4e35ef8af9bfe1f73aa34511425cf,1,Impala Public Jenkins,2021-06-15 18:33:43+00:00,['4290c5e2971b056f5249716655ef2f704465f383'],130,1061,1191,17101110,24,0.237556561,0.563348416,0.574660633,7070
45b1e2d93c00dfaff6eb2c6d1d06f52b65ec1738,0,Csaba Ringhofer,2021-06-16 08:41:11+00:00,['40c3074e79f4e35ef8af9bfe1f73aa34511425cf'],6,8,14,17101124,2,,,,7070
3076f8a7a92bed21872b3597d24e7ce9b7beedbb,0,Joe McDonnell,2021-06-16 15:32:57+00:00,['45b1e2d93c00dfaff6eb2c6d1d06f52b65ec1738'],12,82,94,17101218,5,0.368421053,0,0.368421053,7070
c591b846c7956ec8eb0b1479237ac251a9d8ffed,1,Zoltan Borok-Nagy,2021-06-22 10:41:07+00:00,['3076f8a7a92bed21872b3597d24e7ce9b7beedbb'],36,154,190,17101408,5,0,0,0.181818182,7070
078e1fddb08a84a76374592f4ae518e2ff68e56f,0,Aman Sinha,2021-06-22 17:43:30+00:00,['c591b846c7956ec8eb0b1479237ac251a9d8ffed'],0,4,4,17101412,2,1,1,1,7070
d99caa1f3a049fc5e20855f8e8bf846fd81f65c5,1,Impala Public Jenkins,2021-06-23 00:20:31+00:00,['078e1fddb08a84a76374592f4ae518e2ff68e56f'],2,4,6,17101418,1,,,,7070
1d8146869abed84aaee4055ef336c034b6a54f61,0,Impala Public Jenkins,2021-06-23 10:11:15+00:00,['d99caa1f3a049fc5e20855f8e8bf846fd81f65c5'],3,126,129,17101547,4,0,1,1,7070
2aa199cc0dbb7c3b59016c855e24f0842d6b261b,1,Zoltan Borok-Nagy,2021-06-23 14:05:07+00:00,['1d8146869abed84aaee4055ef336c034b6a54f61'],100,110,210,17101757,13,0,0,1,7070
d01269052d6b08f743c47d886cc9d30c58a333a5,0,Joe McDonnell,2021-06-23 15:26:08+00:00,['2aa199cc0dbb7c3b59016c855e24f0842d6b261b'],7,7,14,17101771,1,,,,7070
89131e70ff649545c7192f760ac7f8d2abcb6e37,0,Aman Sinha,2021-06-24 01:34:30+00:00,['d01269052d6b08f743c47d886cc9d30c58a333a5'],5,205,210,17101981,4,0.8,0.8,0.8,7071
9b7507390dd7259be5b2319a022899989036df41,0,Impala Public Jenkins,2021-06-24 15:18:02+00:00,['89131e70ff649545c7192f760ac7f8d2abcb6e37'],1,2,3,17101984,1,0,0,1,7071
8b8cc9fb90ba76b7ac61a3e60843b61ad4cce4a0,0,Impala Public Jenkins,2021-06-24 15:57:19+00:00,['9b7507390dd7259be5b2319a022899989036df41'],1,1,2,17101986,1,,,,7071
6cc357a54c2dd3f98f88c7517e821c037da9f292,1,Impala Public Jenkins,2021-06-24 17:39:43+00:00,['8b8cc9fb90ba76b7ac61a3e60843b61ad4cce4a0'],6,36,42,17102028,2,0,1,1,7071
09454cea7900df72a4285b3fd7ac78444587d951,0,Csaba Ringhofer,2021-06-24 17:45:27+00:00,['6cc357a54c2dd3f98f88c7517e821c037da9f292'],23,38,61,17102089,2,0,1,0.2,7071
fcaea30b151d89f412816a8e49d5feeef6964a0f,1,Impala Public Jenkins,2021-06-24 20:34:45+00:00,['09454cea7900df72a4285b3fd7ac78444587d951'],66,793,859,17102948,29,0.39295393,0.742547425,0.501355014,7072
97bfd2f65408a45b0eb1cabe544e82ee14fcde1a,0,Impala Public Jenkins,2021-06-25 23:36:01+00:00,['fcaea30b151d89f412816a8e49d5feeef6964a0f'],6,9,15,17102963,1,0,1,1,7072
b77f48efc5da9da040e67d98b90f9ed0dcb4d7fa,0,Impala Public Jenkins,2021-07-05 18:45:01+00:00,['97bfd2f65408a45b0eb1cabe544e82ee14fcde1a'],2,2,4,17102967,1,,,,7072
46ae99a36b38f59eef6b0de6d27eb6d9be926e7f,0,Vihang Karajgaonkar,2021-07-06 18:35:30+00:00,['b77f48efc5da9da040e67d98b90f9ed0dcb4d7fa'],105,97,202,17103169,7,1,1,0.923076923,7072
59d32853ee42886ae683aac95a8be7f9c89b8eb7,0,Impala Public Jenkins,2021-07-07 13:04:54+00:00,['46ae99a36b38f59eef6b0de6d27eb6d9be926e7f'],0,45,45,17103214,2,0,0.285714286,1,7072
025500ccb5fed088e58da7bb7a8021088a9bba98,0,Impala Public Jenkins,2021-07-08 23:10:32+00:00,['59d32853ee42886ae683aac95a8be7f9c89b8eb7'],26,2464,2490,17105704,25,0.148205928,0.716848674,0.897815913,7080
84d784351c7a3606ec86abf6ea757aef72687b55,1,Impala Public Jenkins,2021-07-09 13:40:40+00:00,['025500ccb5fed088e58da7bb7a8021088a9bba98'],95,251,346,17106050,23,0.872727273,0.872727273,0.6,7081
4d0f3d000a1b157f81d23de090170c42c4748ede,1,Quanlong Huang,2021-07-12 01:54:36+00:00,['84d784351c7a3606ec86abf6ea757aef72687b55'],1,1,2,17106052,1,,,,7081
5aa47bf9010278b82f000f0892a6aad0b1383281,0,Impala Public Jenkins,2021-07-12 12:25:49+00:00,['4d0f3d000a1b157f81d23de090170c42c4748ede'],3,6,9,17106061,1,,,,7081
4d01d8eb517770628f77406d83f484f02d4d21db,0,Quanlong Huang,2021-07-12 13:36:54+00:00,['5aa47bf9010278b82f000f0892a6aad0b1383281'],2,41,43,17106104,4,,,,7081
2b815cbd51f55c6000dcde81cb1ee399bb1a545c,0,Impala Public Jenkins,2021-07-13 00:07:11+00:00,['4d01d8eb517770628f77406d83f484f02d4d21db'],69,148,217,17106321,7,0.142857143,0,0.904761905,7081
00c8e157ddcaec3f12a09ef410d8716b3dac03a4,0,Quanlong Huang,2021-07-13 00:34:34+00:00,['2b815cbd51f55c6000dcde81cb1ee399bb1a545c'],4,573,577,17106898,4,0.313513514,0.540540541,1,7084
7f7a631e92c69a6dafc1f25ceb407f7b79db10e9,1,Vihang Karajgaonkar,2021-07-13 18:10:25+00:00,['00c8e157ddcaec3f12a09ef410d8716b3dac03a4'],1183,2651,3834,17110732,29,0.160592255,0.345102506,0.129840547,7088
4c5fa0591706ec1399a6b92ab10e7028ad159aef,0,Impala Public Jenkins,2021-07-13 19:37:33+00:00,['7f7a631e92c69a6dafc1f25ceb407f7b79db10e9'],1186,1203,2389,17113121,32,0.153846154,0.153846154,1,7088
77283d87d8ed4747aa8d2f5caa9f2d4cf751e3ce,0,Impala Public Jenkins,2021-07-13 20:45:38+00:00,['4c5fa0591706ec1399a6b92ab10e7028ad159aef'],23,53,76,17113197,2,0,0.772727273,0.045454545,7088
85ebfe220aa6fe654b860d5f3fe1d8902940de0f,0,Impala Public Jenkins,2021-07-14 02:20:44+00:00,['77283d87d8ed4747aa8d2f5caa9f2d4cf751e3ce'],3,26,29,17113226,2,0,0.842105263,0.210526316,7088
a5de2acc47723fdaee4ebe6d904d16be505b7cfb,1,Csaba Ringhofer,2021-07-14 12:24:33+00:00,['85ebfe220aa6fe654b860d5f3fe1d8902940de0f'],82,997,1079,17114305,23,0.349557522,0.818584071,0.553097345,7090
9d46255739f94c53d686f670ee7b5981db59c148,1,Zoltan Borok-Nagy,2021-07-14 12:51:09+00:00,['a5de2acc47723fdaee4ebe6d904d16be505b7cfb'],155,718,873,17115178,16,0.215909091,0.602272727,0.886363636,7094
d0749d59de7c81a2f138986626fef12ea44e6a2c,0,Impala Public Jenkins,2021-07-15 15:15:07+00:00,['9d46255739f94c53d686f670ee7b5981db59c148'],180,181,361,17115539,20,0.652173913,1,1,7094
474e022fda5f591bcd68da5212c0ca8ed17a18d1,1,Impala Public Jenkins,2021-07-15 16:47:35+00:00,['d0749d59de7c81a2f138986626fef12ea44e6a2c'],49,490,539,17116078,16,0.813432836,0.805970149,0.179104478,7096
36d8e6766e3f1ce133a86b3edc5fee34e5e71cc7,0,Impala Public Jenkins,2021-07-15 19:07:25+00:00,['474e022fda5f591bcd68da5212c0ca8ed17a18d1'],28,146,174,17116252,4,0,0,1,7096
de8397ec171ffd9bb911fbbc5967858edf75e4c0,0,Impala Public Jenkins,2021-07-15 22:37:52+00:00,['36d8e6766e3f1ce133a86b3edc5fee34e5e71cc7'],16,701,717,17116969,3,0.123893805,0.663716814,0.914454277,7096
795dc8e985660c56bfdaf0142c0ff3fba61d0ca1,0,Quanlong Huang,2021-07-17 01:35:28+00:00,['de8397ec171ffd9bb911fbbc5967858edf75e4c0'],0,65,65,17117034,1,,,,7096
62028d00e657c65cd23e16794dff18149f1dbe0e,0,Impala Public Jenkins,2021-07-19 22:16:18+00:00,['795dc8e985660c56bfdaf0142c0ff3fba61d0ca1'],7,7,14,17117048,2,,,,7096
602eec3b6e712c54cb2e78f534991aced74b7d33,0,Impala Public Jenkins,2021-07-20 02:31:03+00:00,['62028d00e657c65cd23e16794dff18149f1dbe0e'],0,9,9,17117057,1,,,,7096
bd9b7459d0ab453fa185ba6728e5c571835ffa3e,0,Impala Public Jenkins,2021-07-20 08:22:34+00:00,['602eec3b6e712c54cb2e78f534991aced74b7d33'],2,9,11,17117068,2,0,0,1,7096
4df03a31ec77b54138aba2805ff5e376463c8e23,1,Impala Public Jenkins,2021-07-20 13:28:30+00:00,['bd9b7459d0ab453fa185ba6728e5c571835ffa3e'],27,410,437,17117505,8,0.106666667,0.848888889,0.822222222,7096
565d0bfa1d12df583ab6d2725ac6ecf2644cd50d,1,Zoltan Borok-Nagy,2021-07-20 13:34:24+00:00,['4df03a31ec77b54138aba2805ff5e376463c8e23'],31,53,84,17117589,4,0,0,0.045454545,7096
147b4b9e583098f9611fe28fc9ff1f8451f63e4b,0,Impala Public Jenkins,2021-07-20 22:56:48+00:00,['565d0bfa1d12df583ab6d2725ac6ecf2644cd50d'],2,2,4,17117593,1,,,,7096
fabe994d1fb011afb88d1f0f5bf078113775c9db,1,Impala Public Jenkins,2021-07-20 23:58:06+00:00,['147b4b9e583098f9611fe28fc9ff1f8451f63e4b'],115,1147,1262,17118855,20,0.307017544,0.707602339,0.707602339,7096
b0d364cc5a62fcfb7ad26d52d3f492239151a3c1,1,Impala Public Jenkins,2021-07-21 05:26:15+00:00,['fabe994d1fb011afb88d1f0f5bf078113775c9db'],2,4,6,17118861,1,0,0,0,7096
90906ec68c93795b39a82f339c299a6fb363808d,1,Impala Public Jenkins,2021-07-21 19:18:16+00:00,['b0d364cc5a62fcfb7ad26d52d3f492239151a3c1'],3,80,83,17118944,3,0,0,1,7096
a7a1cb7106699c1d7f852c4d5782e16a7fdba169,0,Impala Public Jenkins,2021-07-22 16:36:23+00:00,['90906ec68c93795b39a82f339c299a6fb363808d'],89,150,239,17119183,5,0.80952381,0.80952381,0.5,7096
7b2bb13ecc6f951efefee9ef8ea53f29712dfa9f,0,Impala Public Jenkins,2021-07-22 23:05:34+00:00,['a7a1cb7106699c1d7f852c4d5782e16a7fdba169'],9,10,19,17119202,7,,,,7096
80b1cd9e226242926553e0242858512dceff497a,0,Impala Public Jenkins,2021-07-23 18:02:09+00:00,['7b2bb13ecc6f951efefee9ef8ea53f29712dfa9f'],1,1,2,17119204,1,,,,7096
0061bd3433db5b72b6c6bf2f6646255272976cda,0,Impala Public Jenkins,2021-07-23 18:43:44+00:00,['80b1cd9e226242926553e0242858512dceff497a'],10,12,22,17119226,2,,,,7096
b3c4ac9054aabcfbf04304b315d1b3103c952228,1,Impala Public Jenkins,2021-07-25 09:20:50+00:00,['0061bd3433db5b72b6c6bf2f6646255272976cda'],0,10,10,17119236,1,0,0,0,7096
f863611497b29eefb551cee8645fa5d86749924f,0,Impala Public Jenkins,2021-07-26 15:54:30+00:00,['b3c4ac9054aabcfbf04304b315d1b3103c952228'],0,39,39,17119275,1,,,,7096
46f13437db2d64d9ee431c2c5cf424be3b8d6377,0,Impala Public Jenkins,2021-07-26 22:22:58+00:00,['f863611497b29eefb551cee8645fa5d86749924f'],2,2,4,17119279,1,,,,7096
d59a79b1a23bca298dcf036e8fd45f5113241100,0,Impala Public Jenkins,2021-07-27 19:02:49+00:00,['46f13437db2d64d9ee431c2c5cf424be3b8d6377'],2,15,17,17119296,2,1,1,1,7096
06c9016a37edc1e5514378dbe17a679e294a0942,0,Impala Public Jenkins,2021-07-28 05:33:16+00:00,['d59a79b1a23bca298dcf036e8fd45f5113241100'],86,261,347,17119643,9,0.308943089,0.105691057,0.682926829,7096
8a2758f1e88500867d8d2fbaffb62493fca2215a,0,Impala Public Jenkins,2021-07-28 13:18:56+00:00,['06c9016a37edc1e5514378dbe17a679e294a0942'],7,96,103,17119746,6,0.314814815,0.944444444,0.851851852,7096
780a892f5700719e59cc49bafcc46460361673de,0,Vihang Karajgaonkar,2021-07-28 19:51:03+00:00,['8a2758f1e88500867d8d2fbaffb62493fca2215a'],9,51,60,17119806,2,0.148148148,0.148148148,0.111111111,7096
4fc42c379e767842e74e1664cc3a4aacb80da846,1,Impala Public Jenkins,2021-08-03 16:27:07+00:00,['780a892f5700719e59cc49bafcc46460361673de'],3,306,309,17120115,10,0.384615385,0.923076923,0.923076923,7097
33467a7b2e7ac2dd63ff65700a5528651c9e642b,0,Vihang Karajgaonkar,2021-08-03 17:25:40+00:00,['4fc42c379e767842e74e1664cc3a4aacb80da846'],15,26,41,17120156,4,1,1,1,7097
37758f0c0c50e0bf343b923fe7bc357375ed89c2,0,Vihang Karajgaonkar,2021-08-04 19:35:36+00:00,['33467a7b2e7ac2dd63ff65700a5528651c9e642b'],135,200,335,17120491,2,0,0.666666667,0.516666667,7097
599c84b4dd18c591df59f515245305636b2bc5ec,1,Impala Public Jenkins,2021-08-05 07:55:26+00:00,['37758f0c0c50e0bf343b923fe7bc357375ed89c2'],3,144,147,17120638,8,,,,7098
a1d5891c57ce64c3dea6688186549080d3ddea3f,1,Impala Public Jenkins,2021-08-05 15:45:24+00:00,['599c84b4dd18c591df59f515245305636b2bc5ec'],71,16,87,17120725,2,0,0,1,7098
b03d18863b31f0f3e66e9fa1f84cc9d625ecce29,0,Impala Public Jenkins,2021-08-05 18:08:30+00:00,['a1d5891c57ce64c3dea6688186549080d3ddea3f'],5,7,12,17120737,1,0,0,1,7098
5a9dcd108d8a1c6f3ea0062d8de750b6e41fb635,0,Vihang Karajgaonkar,2021-08-09 17:22:31+00:00,['b03d18863b31f0f3e66e9fa1f84cc9d625ecce29'],1202,1308,2510,17123247,18,0,0,0,7101
494588b601d52e18acecc2b97128a2dc5bab6bc1,0,Vihang Karajgaonkar,2021-08-10 21:05:57+00:00,['5a9dcd108d8a1c6f3ea0062d8de750b6e41fb635'],29,369,398,17123645,6,0.133640553,0.548387097,0.571428571,7102
fcbb15a5ea902e66ac9c09c9b114f9ba9c7c109e,1,Vihang Karajgaonkar,2021-08-11 18:11:56+00:00,['494588b601d52e18acecc2b97128a2dc5bab6bc1'],48,326,374,17124019,6,0,0.596273292,0.664596273,7102
11dfde63ef557599171ac9ea806da857831cae7d,0,Impala Public Jenkins,2021-08-12 00:23:47+00:00,['fcbb15a5ea902e66ac9c09c9b114f9ba9c7c109e'],1,0,1,17124020,1,1,0,1,7102
3d365276ea00f349df3629944b731eb4408d2c4f,0,Impala Public Jenkins,2021-08-12 06:36:27+00:00,['11dfde63ef557599171ac9ea806da857831cae7d'],31,291,322,17124342,8,0.215384615,0.715384615,0.707692308,7102
5cc01ed8b2881fae2cd499b613d39427b8b7c811,0,Impala Public Jenkins,2021-08-12 07:38:40+00:00,['3d365276ea00f349df3629944b731eb4408d2c4f'],3,36,39,17124381,2,0.631578947,0.631578947,0.631578947,7102
b1ca0894462e4b9c040fda41622f8b97b1ec15e1,0,Impala Public Jenkins,2021-08-13 16:04:19+00:00,['5cc01ed8b2881fae2cd499b613d39427b8b7c811'],28,118,146,17124527,14,0.631578947,0.684210526,1,7102
0bde6b443cb1f1eea9fb9cb2fd3dc98acb92cd62,0,Impala Public Jenkins,2021-08-15 20:40:39+00:00,['b1ca0894462e4b9c040fda41622f8b97b1ec15e1'],68,160,228,17124755,4,0.647058824,1,1,7102
1a3ff11d82c92cda1296a7cc5062bd035553dff2,1,Impala Public Jenkins,2021-08-17 01:10:36+00:00,['0bde6b443cb1f1eea9fb9cb2fd3dc98acb92cd62'],130,274,404,17125159,6,0.168316832,0.673267327,0.316831683,7102
05ea14b0611d7eaa51ccc04358f93793829a0d27,0,Impala Public Jenkins,2021-08-17 07:13:46+00:00,['1a3ff11d82c92cda1296a7cc5062bd035553dff2'],2,39,41,17125200,5,0,1,0.6875,7102
a9c8166694b285188df945707469fce2c83d24ee,0,Impala Public Jenkins,2021-08-17 13:41:26+00:00,['05ea14b0611d7eaa51ccc04358f93793829a0d27'],6,8,14,17125214,1,1,1,0.5,7102
caea9d3e14bfe4140221cc22721fb0b038345e9d,1,Qifan Chen,2021-08-18 13:33:15+00:00,['a9c8166694b285188df945707469fce2c83d24ee'],4,74,78,17125292,4,0.8,0.828571429,1,7103
481443844baa9b4190b88a3078de0d7139935a71,0,Vihang Karajgaonkar,2021-08-18 16:06:03+00:00,['caea9d3e14bfe4140221cc22721fb0b038345e9d'],8,87,95,17125387,4,0.137931034,0.655172414,0.655172414,7103
a873289508dc4e80256718c9921be1e337d263d6,1,Impala Public Jenkins,2021-08-19 03:21:40+00:00,['481443844baa9b4190b88a3078de0d7139935a71'],0,2,2,17125389,1,,,,7103
27179b691c07493f3adc33e26ad5c5abf2fb0ad1,0,Impala Public Jenkins,2021-08-20 17:09:08+00:00,['a873289508dc4e80256718c9921be1e337d263d6'],13,150,163,17125552,2,0.191011236,0.752808989,1,7103
cd902d8c22d22ea8ebdb85e31ddc143ee0d0bf69,0,Impala Public Jenkins,2021-08-21 14:46:51+00:00,['27179b691c07493f3adc33e26ad5c5abf2fb0ad1'],163,1583,1746,17127298,38,0.544704264,0.843191197,0.799174691,7103
2ea8e64eb8745e39aa85b06978e51df701b9072c,0,Impala Public Jenkins,2021-08-24 01:42:06+00:00,['cd902d8c22d22ea8ebdb85e31ddc143ee0d0bf69'],24,33,57,17127355,3,0,0.5,1,7103
b54d0c35ffd354ee1ac9bc781a8ff36a64125676,0,Impala Public Jenkins,2021-08-25 05:31:42+00:00,['2ea8e64eb8745e39aa85b06978e51df701b9072c'],1,63,64,17127419,2,0,0,0,7103
237ed5e8738ec565bc8d3ce813d9b70c12ad4ce7,0,Impala Public Jenkins,2021-08-25 05:52:35+00:00,['b54d0c35ffd354ee1ac9bc781a8ff36a64125676'],13,112,125,17127544,3,0,1,0.657142857,7103
2040b2621f73de4dfaba80dd938221758952183f,0,Impala Public Jenkins,2021-08-25 20:05:47+00:00,['237ed5e8738ec565bc8d3ce813d9b70c12ad4ce7'],1049,1976,3025,17130569,81,0.39516129,0.554435484,0.600806452,7106
e977014fa7685b17b7a618b725521c22031764ec,0,Qifan Chen,2021-08-26 19:12:57+00:00,['2040b2621f73de4dfaba80dd938221758952183f'],4,6,10,17130579,2,0,0,1,7106
bb9fb663ce1010d667a53b2d16da88d3579d922a,1,Csaba Ringhofer,2021-08-27 09:45:59+00:00,['e977014fa7685b17b7a618b725521c22031764ec'],83,336,419,17130998,13,0.398148148,0.574074074,0.833333333,7106
ce47a9c9cccb621ead33c3810555be94280eecf4,1,Impala Public Jenkins,2021-08-27 21:37:01+00:00,['bb9fb663ce1010d667a53b2d16da88d3579d922a'],35,60,95,17131093,6,0,1,1,7106
50914f20abbe136dc9a9971f3fe1a8017e8179d9,0,Impala Public Jenkins,2021-08-28 02:22:56+00:00,['ce47a9c9cccb621ead33c3810555be94280eecf4'],577,577,1154,17132247,3,,,,7106
beb8019f5300bb163424e7fdfec50b8e4b796e26,0,Impala Public Jenkins,2021-08-28 05:05:38+00:00,['50914f20abbe136dc9a9971f3fe1a8017e8179d9'],0,42,42,17132289,4,0.647058824,1,1,7106
4f9f8c33cade430cec07974e00dc1d9031e9609f,1,Impala Public Jenkins,2021-08-30 23:09:42+00:00,['beb8019f5300bb163424e7fdfec50b8e4b796e26'],64,576,640,17132929,19,0.332236842,0.845394737,0.697368421,7108
731bb8029e9511db609206aaa5c3693f26caf8e4,0,Impala Public Jenkins,2021-08-31 04:58:31+00:00,['4f9f8c33cade430cec07974e00dc1d9031e9609f'],2,5,7,17132936,1,,,,7108
8a6439715f3d7780a408fe97b5f80a7a9a0c57c8,0,Impala Public Jenkins,2021-08-31 05:05:13+00:00,['731bb8029e9511db609206aaa5c3693f26caf8e4'],24,176,200,17133136,5,0,0,0,7108
45d3eddc056bc28ee43efa6307cd673062936a41,0,Impala Public Jenkins,2021-08-31 06:58:34+00:00,['8a6439715f3d7780a408fe97b5f80a7a9a0c57c8'],21,66,87,17133223,1,,,,7108
c8aa5796d93510723342055cc70cf8d00abae754,1,Attila Jeges,2021-09-02 21:34:41+00:00,['45d3eddc056bc28ee43efa6307cd673062936a41'],33,1025,1058,17134281,19,0.245487365,0.880866426,0.288808664,7110
108cf8d07c82a179ede6d0b3385ddc4a6709822c,0,Impala Public Jenkins,2021-09-08 06:38:39+00:00,['c8aa5796d93510723342055cc70cf8d00abae754'],1,139,140,17134421,2,0,0.217821782,0.782178218,7110
6b4693ddbfd8111344dc88443d76bd3b034f361e,0,Impala Public Jenkins,2021-09-08 18:38:37+00:00,['108cf8d07c82a179ede6d0b3385ddc4a6709822c'],0,193,193,17134614,3,1,1,0,7112
6f6c600f90b2d468f3fd7412f08aec009d018027,0,Impala Public Jenkins,2021-09-08 21:05:08+00:00,['6b4693ddbfd8111344dc88443d76bd3b034f361e'],1,8,9,17134623,1,1,1,1,7112
8086c4457e02a5bc542d183b82b733891df4eddf,0,Impala Public Jenkins,2021-09-10 14:18:34+00:00,['6f6c600f90b2d468f3fd7412f08aec009d018027'],84,94,178,17134801,2,0.666666667,1,0.333333333,7112
6d47927668e6e9accc3efd0d5bcd26ee9926cb39,0,Impala Public Jenkins,2021-09-10 22:29:21+00:00,['8086c4457e02a5bc542d183b82b733891df4eddf'],0,172,172,17134973,2,,,,7114
1e21aa6b9641941fe75eb05fb519d2a4d56e5daf,1,Impala Public Jenkins,2021-09-14 21:21:47+00:00,['6d47927668e6e9accc3efd0d5bcd26ee9926cb39'],352,2152,2504,17137477,63,0.415789474,0.61754386,0.664912281,7122
3850d49711b88091101cfc3d89da28c76a17b04d,0,Impala Public Jenkins,2021-09-15 05:04:07+00:00,['1e21aa6b9641941fe75eb05fb519d2a4d56e5daf'],54,364,418,17137895,6,0.345794393,0.345794393,0.336448598,7122
c925807b1a3eacf1ca3d0e78f6a0fa043b350174,1,Impala Public Jenkins,2021-09-15 13:58:23+00:00,['3850d49711b88091101cfc3d89da28c76a17b04d'],374,258,632,17138527,8,0.936170213,0,0.553191489,7122
35b21083b1866b7056e3810ae5a8daf7bc77ddda,1,Impala Public Jenkins,2021-09-17 00:44:15+00:00,['c925807b1a3eacf1ca3d0e78f6a0fa043b350174'],22,915,937,17139464,13,0.0625,0,0.604166667,7124
851fe2f6c0059de72526677b238866f201de6658,0,Impala Public Jenkins,2021-09-22 20:36:51+00:00,['35b21083b1866b7056e3810ae5a8daf7bc77ddda'],1,2,3,17139467,1,0,0,0,7124
39cc4b6bf45a172c3fdcd6a9cc42eaadfcf3ae71,0,Qifan Chen,2021-09-22 20:42:10+00:00,['851fe2f6c0059de72526677b238866f201de6658'],29,147,176,17139643,19,0.416666667,0,0.883333333,7124
0eea0820ad6c37916b30d8e0a3949599a9c7cbf3,0,Impala Public Jenkins,2021-09-23 18:48:36+00:00,['39cc4b6bf45a172c3fdcd6a9cc42eaadfcf3ae71'],19,244,263,17139906,3,0.380952381,0.380952381,0.156462585,7124
20e07f8645b402f08af91e6b078d1fdd2a0d06f6,0,Impala Public Jenkins,2021-09-24 00:38:25+00:00,['0eea0820ad6c37916b30d8e0a3949599a9c7cbf3'],50,153,203,17140109,3,0.488372093,0.488372093,0.325581395,7124
1306c58f29dee4f8f4c0ab18327bc19557a9156e,0,Impala Public Jenkins,2021-09-27 12:07:40+00:00,['20e07f8645b402f08af91e6b078d1fdd2a0d06f6'],12,89,101,17140210,3,0,0.84,0.24,7124
d7068ace15b5c7affe0812155f037789905ef74d,0,Impala Public Jenkins,2021-09-27 20:03:34+00:00,['1306c58f29dee4f8f4c0ab18327bc19557a9156e'],17,5,22,17140232,1,1,1,0,7124
03a7a59f5dfd5c663b51b195c7070bbbabd53024,1,Impala Public Jenkins,2021-09-28 04:45:23+00:00,['d7068ace15b5c7affe0812155f037789905ef74d'],140,604,744,17140976,17,0.305418719,0.63546798,0.743842365,7126
9e76a8f7c3aac1a2905c05a82b22be9c2942767c,1,Impala Public Jenkins,2021-09-28 04:55:57+00:00,['03a7a59f5dfd5c663b51b195c7070bbbabd53024'],8359,13502,21861,17162837,49,0.694241171,0.828189628,0.864778874,7147
444fedbfda6a8527d2136f4afe1a839cf278e2b5,0,Qifan Chen,2021-09-28 18:34:33+00:00,['9e76a8f7c3aac1a2905c05a82b22be9c2942767c'],0,2,2,17162839,1,,,,7147
b45cd1bf0234de8ce7ac17565eca6c1503d1aad8,0,Impala Public Jenkins,2021-09-28 22:53:59+00:00,['444fedbfda6a8527d2136f4afe1a839cf278e2b5'],2,11,13,17162852,1,,,,7147
1a61a8025c87c37921a1bba4c49f754d8bd10bcc,0,Impala Public Jenkins,2021-09-30 05:41:14+00:00,['b45cd1bf0234de8ce7ac17565eca6c1503d1aad8'],3,3,6,17162858,1,,,,7147
6a6e17ffec7fa223d5335f13abff08129b0b9aaf,0,Impala Public Jenkins,2021-10-01 04:35:39+00:00,['1a61a8025c87c37921a1bba4c49f754d8bd10bcc'],12,29,41,17162899,3,1,1,1,7147
4b8bb041b95529a8147981e7ca2c392e07611b2f,0,Joe McDonnell,2021-10-01 22:55:18+00:00,['6a6e17ffec7fa223d5335f13abff08129b0b9aaf'],12,40,52,17162951,3,0.875,0.875,1,7147
d2f866f9a17c2d71fb3e3e731a2dfcce68d336d9,1,Impala Public Jenkins,2021-10-02 03:15:17+00:00,['4b8bb041b95529a8147981e7ca2c392e07611b2f'],25,87,112,17163063,9,0,0,1,7147
d8d44f3f147ce0f98bdd9e0387ae080010f55965,1,Vihang Karajgaonkar,2021-10-04 17:13:42+00:00,['d2f866f9a17c2d71fb3e3e731a2dfcce68d336d9'],216,941,1157,17164220,11,0.082802548,0.414012739,0.93418259,7147
61964882d152edd0d369c9a912a52d5c982f3523,1,Qifan Chen,2021-10-04 17:34:56+00:00,['d8d44f3f147ce0f98bdd9e0387ae080010f55965'],140,432,572,17164792,21,0.272727273,0.818181818,0.393939394,7147
5e3d4391906b09adb97ba6d036811aaf81f5a403,1,Impala Public Jenkins,2021-10-05 01:19:24+00:00,['61964882d152edd0d369c9a912a52d5c982f3523'],328,487,815,17165607,4,1,1,1,7147
cee2b42781658f42dc08a41cf88bb2ed2803aaf1,0,Impala Public Jenkins,2021-10-06 00:27:31+00:00,['5e3d4391906b09adb97ba6d036811aaf81f5a403'],6,6,12,17165619,4,,,,7147
45fd3320ad4f68ca86998dff0c9504aa896a278a,0,Impala Public Jenkins,2021-10-07 17:11:31+00:00,['cee2b42781658f42dc08a41cf88bb2ed2803aaf1'],91,98,189,17165808,2,0,1,1,7147
1e92c097d97dd4c688b8994e3ea63e8de80e35ec,0,Impala Public Jenkins,2021-10-09 02:23:34+00:00,['45fd3320ad4f68ca86998dff0c9504aa896a278a'],313,632,945,17166753,1,0.193548387,1,0.774193548,7147
dc313b3e4cae3dd57c55cc40e9c2b824082918a7,0,Zoltan Borok-Nagy,2021-10-15 10:50:28+00:00,['1e92c097d97dd4c688b8994e3ea63e8de80e35ec'],0,297,297,17167050,1,0.477272727,0.727272727,0.732954545,7148
3e75a177302924c15e496b0611cd05ba61d74fb9,1,Impala Public Jenkins,2021-10-18 19:32:29+00:00,['dc313b3e4cae3dd57c55cc40e9c2b824082918a7'],85,86,171,17167221,3,1,1,0,7149
dc8f375986321f2d7c1ed750e5c02c2e6f8cb4e8,0,Vihang Karajgaonkar,2021-10-18 21:45:04+00:00,['3e75a177302924c15e496b0611cd05ba61d74fb9'],10,26,36,17167257,1,0.25,0,1,7149
cae36149aace90c256131fc4ba30f1cc5dae561e,0,Vihang Karajgaonkar,2021-10-19 00:41:36+00:00,['dc8f375986321f2d7c1ed750e5c02c2e6f8cb4e8'],22,15,37,17167294,3,0.833333333,0.833333333,0,7149
7bf39968bb95ac3aa66ff50b03495d4bdb97293b,0,Bikramjeet Vig,2021-10-19 19:59:55+00:00,['cae36149aace90c256131fc4ba30f1cc5dae561e'],14,17,31,17167325,2,1,0,0,7149
9aeae0d2f840e10ae8a6d02a43c0f8d102f957b5,0,Impala Public Jenkins,2021-10-20 14:45:41+00:00,['7bf39968bb95ac3aa66ff50b03495d4bdb97293b'],2,3,5,17167330,1,0,1,0,7149
c127b6b1a72d83778378dc181d9328b4cb7dea9e,0,Qifan Chen,2021-10-21 15:45:39+00:00,['9aeae0d2f840e10ae8a6d02a43c0f8d102f957b5'],209,694,903,17168233,12,0.326923077,0.701923077,0.221153846,7149
be80b1c442b56ff12c504c210a7a97076cb3672c,0,Vihang Karajgaonkar,2021-10-21 16:56:53+00:00,['c127b6b1a72d83778378dc181d9328b4cb7dea9e'],31,36,67,17168300,1,0.333333333,0.333333333,0.333333333,7149
57982efc21746f6994c11b623fc3cdd1dbbac8a2,0,Joe McDonnell,2021-10-21 17:09:55+00:00,['be80b1c442b56ff12c504c210a7a97076cb3672c'],14,16,30,17168330,1,1,1,0,7149
975883c47035843398ee99a21fa132f67a0d4954,0,Joe McDonnell,2021-10-23 00:08:14+00:00,['57982efc21746f6994c11b623fc3cdd1dbbac8a2'],26,386,412,17168742,9,0.274111675,0.583756345,0.340101523,7150
78ce235db6d5b720f3e3319ff571a2da054a2602,1,Impala Public Jenkins,2021-10-27 19:01:56+00:00,['975883c47035843398ee99a21fa132f67a0d4954'],31,192,223,17168965,7,0.224719101,0.741573034,0.449438202,7150
9d2ef8564786d858db7786ad338b7daa5386eb20,0,Joe McDonnell,2021-10-27 21:26:04+00:00,['78ce235db6d5b720f3e3319ff571a2da054a2602'],3,19,22,17168987,3,0.6,0.6,1,7150
cceeb082442a042e666a77ceb239e66cf4f63459,0,Impala Public Jenkins,2021-10-28 19:00:33+00:00,['9d2ef8564786d858db7786ad338b7daa5386eb20'],2,33,35,17169022,1,,,,7150
cd64271a0c4df6906d036a5a831001fdc8000285,1,Qifan Chen,2021-10-28 20:09:46+00:00,['cceeb082442a042e666a77ceb239e66cf4f63459'],52,1070,1122,17170144,22,0.202020202,0.395622896,0.762626263,7153
217d821e94cc8571c7f21e8a4d55a3d3f900c116,0,Zoltan Borok-Nagy,2021-10-29 13:11:31+00:00,['cd64271a0c4df6906d036a5a831001fdc8000285'],2,146,148,17170292,4,0.129032258,1,0.983870968,7154
9ed4b3689784670532e840c5cb0389bdd9d5c0e8,0,Impala Public Jenkins,2021-11-03 03:26:27+00:00,['217d821e94cc8571c7f21e8a4d55a3d3f900c116'],22,89,111,17170403,9,0.833333333,0.266666667,1,7154
ef2a8f6f57c8feb11197d2e632e18e65e05cc4ab,0,Impala Public Jenkins,2021-11-03 15:27:06+00:00,['9ed4b3689784670532e840c5cb0389bdd9d5c0e8'],2,1,3,17170406,2,1,1,1,7154
b02c003138388cb2546938682c53dbda19118fb8,1,Zoltan Borok-Nagy,2021-11-04 17:55:21+00:00,['ef2a8f6f57c8feb11197d2e632e18e65e05cc4ab'],11,433,444,17170850,19,1,1,1,7167
84fb1d82c36e34ede213f6621b1d0d1aab318940,0,Aman Sinha,2021-11-08 00:52:36+00:00,['b02c003138388cb2546938682c53dbda19118fb8'],12,12,24,17170874,1,,,,7167
efcf29fb82b19a538ded724282b94bd3a63f05ee,0,Impala Public Jenkins,2021-11-08 23:59:47+00:00,['84fb1d82c36e34ede213f6621b1d0d1aab318940'],1,20,21,17170895,2,0.722222222,0.888888889,0.666666667,7167
df42225f5c8f65a66192b47612d17259d1b2dc6c,0,Csaba Ringhofer,2021-11-09 16:13:32+00:00,['efcf29fb82b19a538ded724282b94bd3a63f05ee'],159,261,420,17171315,20,1,0.62295082,0.573770492,7167
4d97895c6c22c4802cf97187bd4fe1e69ebc1c12,0,Impala Public Jenkins,2021-11-10 02:53:19+00:00,['df42225f5c8f65a66192b47612d17259d1b2dc6c'],7,86,93,17171408,1,0,1,0.93877551,7167
e344457f0108f2874759283bd292eac4a7970ab2,0,Impala Public Jenkins,2021-11-10 14:11:52+00:00,['4d97895c6c22c4802cf97187bd4fe1e69ebc1c12'],188,407,595,17172003,12,0.921568627,0.960784314,0.784313725,7167
cb0018e679f4b48e98d20590679bcd157ef36ee2,0,Impala Public Jenkins,2021-11-10 21:11:30+00:00,['e344457f0108f2874759283bd292eac4a7970ab2'],1,24,25,17172028,2,1,1,1,7167
b3dfc8ff8cff89cd0af049a889a31b6fe010195e,0,Wenzhe Zhou,2021-11-11 17:59:18+00:00,['cb0018e679f4b48e98d20590679bcd157ef36ee2'],2,2,4,17172032,1,,,,7167
bf728516fe8b6f85b557db1aea7fa215f609a08f,0,Wenzhe Zhou,2021-11-12 15:28:31+00:00,['b3dfc8ff8cff89cd0af049a889a31b6fe010195e'],37,28,65,17172097,10,1,1,0,7167
b692a92fa2a2277a185fb5823592609b4603c0d8,1,Joe McDonnell,2021-11-12 19:54:29+00:00,['bf728516fe8b6f85b557db1aea7fa215f609a08f'],32,251,283,17172380,6,0.346938776,0.897959184,0.843537415,7167
0cd5bb012856c364c2e7ec8962c01e488b718a8b,0,Impala Public Jenkins,2021-11-12 20:32:23+00:00,['b692a92fa2a2277a185fb5823592609b4603c0d8'],2,12,14,17172394,1,0,0,1,7167
a690b746271c55408ce8a3f0dd0251a8f3ff8cfc,0,Impala Public Jenkins,2021-11-17 07:10:15+00:00,['0cd5bb012856c364c2e7ec8962c01e488b718a8b'],15,29,44,17172438,1,0.1,0,1,7167
097b10104f23e0927d5b21b43a79f6cc10425f59,1,Vihang Karajgaonkar,2021-11-19 03:04:50+00:00,['a690b746271c55408ce8a3f0dd0251a8f3ff8cfc'],84,1216,1300,17173738,17,0.241335045,0.481386393,0.458279846,7169
c3f2ecc95f217ca9b1c475c44f524bb2fbab5545,0,Impala Public Jenkins,2021-11-21 02:35:29+00:00,['097b10104f23e0927d5b21b43a79f6cc10425f59'],10,11,21,17173759,7,0,0,1,7169
ee03727971f379fe8fb3161387783ce00a9f6b9d,0,Impala Public Jenkins,2021-11-23 03:24:08+00:00,['c3f2ecc95f217ca9b1c475c44f524bb2fbab5545'],4,7,11,17173770,4,0.666666667,0.666666667,0.333333333,7169
df528fe2b108600c9c39c345bad52d0de076a4f5,0,Gabor Kaszab,2021-11-23 07:03:10+00:00,['ee03727971f379fe8fb3161387783ce00a9f6b9d'],138,1480,1618,17175388,31,0.375634518,0.64213198,0.906091371,7175
cc6f6d5c91ba1db3fca83c65f7d2f87c98077025,0,Impala Public Jenkins,2021-11-23 07:45:47+00:00,['df528fe2b108600c9c39c345bad52d0de076a4f5'],39,111,150,17175538,8,0.518518519,0,0.518518519,7176
b13a17b9cff1f93c44a3a9143e1ba0769ee125f7,0,Impala Public Jenkins,2021-11-24 06:03:50+00:00,['cc6f6d5c91ba1db3fca83c65f7d2f87c98077025'],1,51,52,17175590,2,0.058823529,1,0.058823529,7176
b2c51a0cefb00eccad98d020f5b16cf18a56c979,0,Amogh Margoor,2021-11-24 12:16:27+00:00,['b13a17b9cff1f93c44a3a9143e1ba0769ee125f7'],2,18,20,17175610,6,0.666666667,1,1,7176
8082d85273702c4abda22c3a2771726221f61c2c,0,Aman Sinha,2021-11-24 19:44:56+00:00,['b2c51a0cefb00eccad98d020f5b16cf18a56c979'],3,4,7,17175617,1,0,0,1,7176
da53428abc84ee351367258ff26d20fecd4c37c9,1,Zoltan Borok-Nagy,2021-11-25 09:41:48+00:00,['8082d85273702c4abda22c3a2771726221f61c2c'],14,123,137,17175754,8,0.2,1,0.666666667,7176
f566e7dee7b64dcf309bfd497b0296f8e547dfb7,0,Impala Public Jenkins,2021-11-26 08:17:10+00:00,['da53428abc84ee351367258ff26d20fecd4c37c9'],1,2,3,17175757,1,0,0,1,7176
6f80a1f16015b628a31548bdbecd61a554fc0d85,0,Impala Public Jenkins,2021-11-30 00:23:59+00:00,['f566e7dee7b64dcf309bfd497b0296f8e547dfb7'],1,51,52,17175809,2,0.21875,1,1,7176
b0b6e11f53ce4a43423bdd14297cc6624d344760,0,Bikramjeet Vig,2021-11-30 20:13:18+00:00,['6f80a1f16015b628a31548bdbecd61a554fc0d85'],2,129,131,17175940,3,1,1,1,7176
4077bc849ae14bb92a463aeeb6c8f5c1fca658c9,1,Impala Public Jenkins,2021-12-01 12:51:08+00:00,['b0b6e11f53ce4a43423bdd14297cc6624d344760'],14,356,370,17176310,12,0.516393443,0.594262295,0.614754098,7176
d467a2f96d0ca03c77aae1b30b2bcacfff20a8e1,0,Impala Public Jenkins,2021-12-01 15:12:10+00:00,['4077bc849ae14bb92a463aeeb6c8f5c1fca658c9'],2,2,4,17176314,1,,,,7176
9d61bc450eddee46fb9a4e6d9acef992c753988b,0,Impala Public Jenkins,2021-12-02 22:50:10+00:00,['d467a2f96d0ca03c77aae1b30b2bcacfff20a8e1'],1,71,72,17176386,2,0,0.033898305,0.966101695,7176
6e2134ebdf0771fff74e89bfd223ae24937cfadf,0,Vihang Karajgaonkar,2021-12-04 04:15:39+00:00,['9d61bc450eddee46fb9a4e6d9acef992c753988b'],9,10,19,17176405,2,1,1,0,7176
32c224f03d6909f31fd9cb58e31734f74899c15b,0,Impala Public Jenkins,2021-12-07 23:34:36+00:00,['6e2134ebdf0771fff74e89bfd223ae24937cfadf'],5,78,83,17176488,5,0.243902439,0.268292683,0.975609756,7176
157086cb80cb54c6565da25cc327621f6b2b8513,0,Joe McDonnell,2021-12-08 16:32:02+00:00,['32c224f03d6909f31fd9cb58e31734f74899c15b'],55,275,330,17176818,60,0,0.058823529,0.882352941,7176
ad29ce70b3f4cfab4105be52ef664129060fa04e,0,Impala Public Jenkins,2021-12-09 23:17:20+00:00,['157086cb80cb54c6565da25cc327621f6b2b8513'],20,129,149,17176967,2,0,0,0,7176
8d92ba15a56c20a685d96a45602e6a5f23d04e0b,0,Impala Public Jenkins,2021-12-11 00:19:17+00:00,['ad29ce70b3f4cfab4105be52ef664129060fa04e'],2,0,2,17176969,1,1,1,1,7176
151dce86ca8810252c0331cb321b6e77e09327cb,0,Impala Public Jenkins,2021-12-11 17:56:37+00:00,['8d92ba15a56c20a685d96a45602e6a5f23d04e0b'],195,273,468,17177437,1,0,1,0.734939759,7176
b25e250d321f329b98e017c648df75d052497963,1,Impala Public Jenkins,2021-12-14 02:18:29+00:00,['151dce86ca8810252c0331cb321b6e77e09327cb'],314,3674,3988,17181425,26,0.106677524,0.637214984,0.567996743,7178
b0c37b66004090e59a895849feabe2bb35097d91,0,Impala Public Jenkins,2021-12-16 00:12:29+00:00,['b25e250d321f329b98e017c648df75d052497963'],67,180,247,17181672,5,1,0,0.44,7179
4b33107d15c32ffe7dfe6be99755830299ff8d61,0,Impala Public Jenkins,2021-12-16 05:02:19+00:00,['b0c37b66004090e59a895849feabe2bb35097d91'],7,22,29,17181701,2,0,1,1,7179
763acffb74ec2770a9402ba23c145ea928021f8d,1,Impala Public Jenkins,2021-12-16 05:51:27+00:00,['4b33107d15c32ffe7dfe6be99755830299ff8d61'],25,173,198,17181899,13,0,0.275862069,0.689655172,7180
1ed48a542beeadc544193fbd4e74c2d1ac68daf5,0,Impala Public Jenkins,2021-12-16 11:49:15+00:00,['763acffb74ec2770a9402ba23c145ea928021f8d'],6,7,13,17181912,2,,,,7180
7131ee34d25b2609c4eb0cc596bc1d99d6232acd,0,Aman Sinha,2022-01-05 03:32:11+00:00,['1ed48a542beeadc544193fbd4e74c2d1ac68daf5'],2,32,34,17181946,8,0.5,0.571428571,0.857142857,7180
351e0374727be7ccef6843cf1036fd6168220d3e,0,Aman Sinha,2022-01-05 03:32:11+00:00,['7131ee34d25b2609c4eb0cc596bc1d99d6232acd'],6,360,366,17182312,8,1,1,0.80952381,7186
7b490eed5b4e18be1ab19e190ec9ad14c2a804d1,1,Joe McDonnell,2022-01-07 01:44:58+00:00,['351e0374727be7ccef6843cf1036fd6168220d3e'],6,91,97,17182409,7,0,0.5,0.5,7187
65c3b784a27e6b74cc2fb9a9e47dcd05c55fe752,0,Impala Public Jenkins,2022-01-08 09:26:37+00:00,['7b490eed5b4e18be1ab19e190ec9ad14c2a804d1'],65,448,513,17182922,12,0,0.720754717,0.720754717,7187
6894085e4e280d728957e8b9fe175be23bfc6ec0,0,Aman Sinha,2022-01-09 15:39:35+00:00,['65c3b784a27e6b74cc2fb9a9e47dcd05c55fe752'],1,68,69,17182991,3,0,0,1,7187
8ab219aa3acd6e1fa3455c94b2aa17bac30c2381,1,Zoltan Borok-Nagy,2022-01-11 11:15:38+00:00,['6894085e4e280d728957e8b9fe175be23bfc6ec0'],0,531,531,17183522,3,,,,7188
79f4c0576c857c3814bee52b1763c3db855c521b,0,Impala Public Jenkins,2022-01-12 08:39:17+00:00,['8ab219aa3acd6e1fa3455c94b2aa17bac30c2381'],48,86,134,17183656,11,0,1,0.571428571,7188
577fc2ee21a8cb6fc49f9df8367d63ebccc13e61,0,Impala Public Jenkins,2022-01-13 18:45:08+00:00,['79f4c0576c857c3814bee52b1763c3db855c521b'],1,1,2,17183658,1,,,,7188
3f51a6a761bcb93675088afc155ccc3d2a380401,1,Impala Public Jenkins,2022-01-17 15:42:26+00:00,['577fc2ee21a8cb6fc49f9df8367d63ebccc13e61'],11,155,166,17183824,8,0,0,0.5,7188
402c12b5d3394df4381bfe1604c28272dd247581,0,Vihang Karajgaonkar,2022-01-20 01:03:09+00:00,['3f51a6a761bcb93675088afc155ccc3d2a380401'],8,1,9,17183833,1,0,0,0,7188
0aedf6021fa0e6ab4f93313c9dc7eae3b4860a46,0,Impala Public Jenkins,2022-01-20 09:46:32+00:00,['402c12b5d3394df4381bfe1604c28272dd247581'],30,173,203,17184036,4,0.282051282,0.461538462,0.858974359,7188
12118664d84599f4164494058d35a882ba2dd193,0,Impala Public Jenkins,2022-01-23 20:55:00+00:00,['0aedf6021fa0e6ab4f93313c9dc7eae3b4860a46'],20,375,395,17184431,9,0.292307692,0.123076923,0.584615385,7190
2e916968992321bf013bc229c89b070d47bb33fa,0,Aman Sinha,2022-01-25 22:35:34+00:00,['12118664d84599f4164494058d35a882ba2dd193'],0,2,2,17184433,1,0,1,1,7190
b96439f6806731d2b3cac84d0252f2b4c73aca7f,1,Impala Public Jenkins,2022-01-25 22:52:50+00:00,['2e916968992321bf013bc229c89b070d47bb33fa'],24,86,110,17184543,8,0.995540691,0.86845039,0.84057971,7191
5cd2b2b35527e3d13c0f5dab8f526245f6b6ff15,0,Vihang Karajgaonkar,2022-01-26 23:50:14+00:00,['b96439f6806731d2b3cac84d0252f2b4c73aca7f'],3,4,7,17184550,1,,,,7191
504e0d00121bb11b54bbd754d52c1f3f66d29d20,0,Aman Sinha,2022-01-27 23:06:36+00:00,['5cd2b2b35527e3d13c0f5dab8f526245f6b6ff15'],5,36,41,17184591,8,0.2,0,0.466666667,7191
5fd859ee0caefc9c9321cbdd669d9ed8ab89d43b,1,Impala Public Jenkins,2022-01-28 22:46:01+00:00,['504e0d00121bb11b54bbd754d52c1f3f66d29d20'],10,29,39,17184630,1,0,1,1,7191
27a1b4c1203fd1fc7929d23659eed0861703e9e1,0,Aman Sinha,2022-02-01 21:01:42+00:00,['5fd859ee0caefc9c9321cbdd669d9ed8ab89d43b'],1,1,2,17184632,1,,,,7191
bb4903aeb002efcad8c65e93c0ccfd5cddbb29cd,0,Impala Public Jenkins,2022-02-03 03:13:41+00:00,['27a1b4c1203fd1fc7929d23659eed0861703e9e1'],36,4,40,17184672,10,0.642857143,0.571428571,0,7191
4734a681f3780a947dfe998f78f8b358e2f422ca,1,Csaba Ringhofer,2022-02-03 09:13:21+00:00,['bb4903aeb002efcad8c65e93c0ccfd5cddbb29cd'],816,1652,2468,17187140,24,0.771523179,1,0.867549669,7202
d59ec73990d89bfa4d4fa3d8fe598d53eb2918b7,0,Joe McDonnell,2022-02-03 21:21:16+00:00,['4734a681f3780a947dfe998f78f8b358e2f422ca'],2,1,3,17187143,2,,,,7202
5cfdff03f78fb06a50669fa31acf55e5f8a3d0d6,0,Csaba Ringhofer,2022-02-04 07:42:52+00:00,['d59ec73990d89bfa4d4fa3d8fe598d53eb2918b7'],8,14,22,17187165,3,0.5,0,0.25,7202
a0e6b6b618ba9996bc2bc9bd644a340c2cad8b79,0,Zoltan Borok-Nagy,2022-02-04 17:55:47+00:00,['5cfdff03f78fb06a50669fa31acf55e5f8a3d0d6'],15,31,46,17187211,3,0.833333333,1,1,7202
63bd6a5aec8d712210abf261f2fd98b7a60ce885,0,Impala Public Jenkins,2022-02-04 21:23:55+00:00,['a0e6b6b618ba9996bc2bc9bd644a340c2cad8b79'],15,28,43,17187254,3,1,0,1,7202
6143aac691b8b24f2c77a394fe01f5991540b543,0,Impala Public Jenkins,2022-02-04 21:26:14+00:00,['63bd6a5aec8d712210abf261f2fd98b7a60ce885'],5,22,27,17187281,3,1,1,1,7202
6c845eb24b952972975126e07a36cd1565ada629,0,Joe McDonnell,2022-02-05 02:01:01+00:00,['6143aac691b8b24f2c77a394fe01f5991540b543'],5,6,11,17187292,1,,,,7202
d34039ced95f48497482a02c329da1a7c504055e,1,Csaba Ringhofer,2022-02-07 11:37:44+00:00,['6c845eb24b952972975126e07a36cd1565ada629'],10,53,63,17187355,3,0.25,0.5625,0.71875,7202
5090c44eff956b2a4705d9441bb3f29a0ea93b59,0,Joe McDonnell,2022-02-07 18:37:49+00:00,['d34039ced95f48497482a02c329da1a7c504055e'],3,3,6,17187361,1,,,,7202
85c13b3e6fd9f3e6195de05b3a84c6c38bbb37b8,1,Csaba Ringhofer,2022-02-07 22:39:14+00:00,['5090c44eff956b2a4705d9441bb3f29a0ea93b59'],28,313,341,17187702,5,0.133757962,0.815286624,0.796178344,7203
4bcc29f256acf751d168aacc0c3b14bcbfed5c10,0,Csaba Ringhofer,2022-02-09 10:22:56+00:00,['85c13b3e6fd9f3e6195de05b3a84c6c38bbb37b8'],14,23,37,17187739,2,0,0,1,7203
8ddac48f3428c86f2cbd037ced89cfb903298b12,0,Joe McDonnell,2022-02-09 18:58:12+00:00,['4bcc29f256acf751d168aacc0c3b14bcbfed5c10'],2,6,8,17187747,1,0,0,1,7203
97dda2b27da99367f4d07699aa046b16cda16dd4,1,Impala Public Jenkins,2022-02-09 21:20:23+00:00,['8ddac48f3428c86f2cbd037ced89cfb903298b12'],280,721,1001,17188748,19,0.248175182,0.434306569,0.51459854,7203
677d4f91a30e6f12d99b2422514c50d0bb7c799f,0,Csaba Ringhofer,2022-02-10 15:53:37+00:00,['97dda2b27da99367f4d07699aa046b16cda16dd4'],5,3,8,17188756,1,1,1,1,7203
bde995483a1b6e91dc5d089dfc07225a93d7c8ca,0,Impala Public Jenkins,2022-02-11 07:01:58+00:00,['677d4f91a30e6f12d99b2422514c50d0bb7c799f'],0,29,29,17188785,5,1,1,1,7203
b02dba74d8f072c206c3da2eca1b492c7b44a839,0,Impala Public Jenkins,2022-02-11 14:05:16+00:00,['bde995483a1b6e91dc5d089dfc07225a93d7c8ca'],2,2,4,17188789,2,,,,7203
bb23b4376239674117f2ebd5893b2c1ec8f321da,0,Impala Public Jenkins,2022-02-11 16:57:59+00:00,['b02dba74d8f072c206c3da2eca1b492c7b44a839'],21,39,60,17188849,7,0.2,0.2,0.6,7203
c36ff0cdd7d03b0a511c78d941a32d4e78718654,0,Impala Public Jenkins,2022-02-12 06:09:59+00:00,['bb23b4376239674117f2ebd5893b2c1ec8f321da'],1,29,30,17188879,4,0,0,1,7203
0a6509543d6fc55310f01307db65ffd551938e1e,0,Impala Public Jenkins,2022-02-13 07:19:19+00:00,['c36ff0cdd7d03b0a511c78d941a32d4e78718654'],1,1,2,17188881,1,,,,7203
182617ee87aaf23abe46dd0cc5b82133e4d41803,0,Zoltan Borok-Nagy,2022-02-15 15:20:56+00:00,['0a6509543d6fc55310f01307db65ffd551938e1e'],6,18,24,17188905,3,0,0,0.375,7203
35375b3287859e2f047ce546178bd14645e0d965,0,Impala Public Jenkins,2022-02-15 18:40:59+00:00,['182617ee87aaf23abe46dd0cc5b82133e4d41803'],1,249,250,17189155,8,0.408759124,0.751824818,0.532846715,7203
345ba685e74aa002fc5934b104183f141d9cb367,0,Impala Public Jenkins,2022-02-16 13:28:27+00:00,['35375b3287859e2f047ce546178bd14645e0d965'],0,62,62,17189217,2,1,0,1,7203
e36f2b55716c7d6246988ee125668542778becd3,0,Wenzhe Zhou,2022-02-16 17:09:36+00:00,['345ba685e74aa002fc5934b104183f141d9cb367'],4589,14010,18599,17207816,281,0.410067397,0.775273799,0.823083404,7209
92ce6fe48e75d7780efe9a275122554e59aac916,0,Wenzhe Zhou,2022-02-16 17:09:36+00:00,['e36f2b55716c7d6246988ee125668542778becd3'],77,217,294,17208110,22,0.142857143,0.571428571,1,7210
d3da875684598f0d734fb78a83751b72c00e9a02,1,Impala Public Jenkins,2022-02-17 18:51:06+00:00,['92ce6fe48e75d7780efe9a275122554e59aac916'],254,1158,1412,17209522,56,0.106741573,0.328651685,0.480337079,7211
1697af02d6c96b82f19cc75235719afcb864ebe2,0,Impala Public Jenkins,2022-02-17 20:28:51+00:00,['d3da875684598f0d734fb78a83751b72c00e9a02'],0,14,14,17209536,2,,,,7211
76ec254e9b8f1a1f6d2a59be3dc71ae319836ac6,0,Wenzhe Zhou,2022-02-18 17:49:01+00:00,['1697af02d6c96b82f19cc75235719afcb864ebe2'],1,1,2,17209538,1,,,,7211
e2ee736f9a4cf9900bfb7c67dc359bbff6a6c000,1,Impala Public Jenkins,2022-02-19 00:15:57+00:00,['76ec254e9b8f1a1f6d2a59be3dc71ae319836ac6'],2,2,4,17209542,1,,,,7211
fe04c500d7c32606c9024259a972f6843fab678e,0,Csaba Ringhofer,2022-02-19 18:57:45+00:00,['e2ee736f9a4cf9900bfb7c67dc359bbff6a6c000'],50,189,239,17209781,4,0.104651163,0.197674419,0.058139535,7211
f0d4afaff1e8ed93834f5198046d137bcd03a843,0,Csaba Ringhofer,2022-02-22 20:49:50+00:00,['fe04c500d7c32606c9024259a972f6843fab678e'],2,2,4,17209785,1,,,,7211
b60ccabd5b6f09842284c657b910bb65d2f30fe8,0,Impala Public Jenkins,2022-02-23 03:45:22+00:00,['f0d4afaff1e8ed93834f5198046d137bcd03a843'],4,28,32,17209817,6,0.571428571,0.642857143,0.214285714,7212
8e5a42fff432e7a81f0b403301f6f1cc789cd1a2,1,Impala Public Jenkins,2022-02-23 07:15:47+00:00,['b60ccabd5b6f09842284c657b910bb65d2f30fe8'],1,2,3,17209820,1,0,0,1,7212
331ff4647db9611dc64365be6e2a8a18c4307815,0,Impala Public Jenkins,2022-02-23 20:09:10+00:00,['8e5a42fff432e7a81f0b403301f6f1cc789cd1a2'],38,36,74,17209894,4,,,,7212
7cfc73c2fd94335d7a19b6767b016f62ec4bde84,0,Csaba Ringhofer,2022-02-23 22:54:50+00:00,['331ff4647db9611dc64365be6e2a8a18c4307815'],263,0,263,17210157,1,,,,7212
8217c230acf5a34278794937b69eff97f2755301,0,Impala Public Jenkins,2022-02-24 04:24:08+00:00,['7cfc73c2fd94335d7a19b6767b016f62ec4bde84'],0,35,35,17210192,4,0,0.761904762,0.238095238,7213
5d516c2e0d05c059873a0ce361cd2dcf82ec3477,0,Impala Public Jenkins,2022-02-24 06:24:07+00:00,['8217c230acf5a34278794937b69eff97f2755301'],4,6,10,17210202,1,0,0,1,7213
873fe2e5241c5714dfd94a186d524edc1cbad0ad,0,Impala Public Jenkins,2022-02-24 07:06:50+00:00,['5d516c2e0d05c059873a0ce361cd2dcf82ec3477'],1,3,4,17210206,1,,,,7213
b99534e073833c8db336096f49565e0ddcd8aa52,0,Impala Public Jenkins,2022-02-25 21:20:08+00:00,['873fe2e5241c5714dfd94a186d524edc1cbad0ad'],1,1,2,17210208,1,,,,7213
4186727fe6cc35a10a0565214d1c593b9006d862,1,Impala Public Jenkins,2022-02-27 06:36:19+00:00,['b99534e073833c8db336096f49565e0ddcd8aa52'],1029,2513,3542,17213750,27,0.431711146,0.591836735,0.755102041,7219
7942a8ca2316357296fe351a40b6a87b9de769c8,1,Impala Public Jenkins,2022-02-27 06:38:32+00:00,['4186727fe6cc35a10a0565214d1c593b9006d862'],3,22,25,17213775,3,1,1,1,7219
719d3688950e9c22811ca2bb619b616f89679593,0,Impala Public Jenkins,2022-02-28 23:07:16+00:00,['7942a8ca2316357296fe351a40b6a87b9de769c8'],1,2,3,17213778,1,1,1,0,7219
b2e4b29f06141ad34eef2cbadfda259124792ac2,0,Impala Public Jenkins,2022-03-01 13:09:59+00:00,['719d3688950e9c22811ca2bb619b616f89679593'],1,9,10,17213788,1,0,0,0,7219
374783c55ebdb07fbf669c2c5d80c4b01eb39d2b,0,Impala Public Jenkins,2022-03-03 00:21:06+00:00,['b2e4b29f06141ad34eef2cbadfda259124792ac2'],214,1429,1643,17215431,44,0.222222222,0.013071895,0.776143791,7223
cd10acdbb15c74eae21fa630bcb174104283560a,0,Zoltan Borok-Nagy,2022-03-04 15:24:23+00:00,['374783c55ebdb07fbf669c2c5d80c4b01eb39d2b'],175,230,405,17215836,17,0,0.87804878,1,7224
71c904e5c234087b32a908b9e13c30aa3f878a5d,1,Impala Public Jenkins,2022-03-04 16:49:22+00:00,['cd10acdbb15c74eae21fa630bcb174104283560a'],48,126,174,17216010,10,1,1,1,7226
7a28295905e97e41503670bbdd92e64ea47f0078,0,Impala Public Jenkins,2022-03-04 16:57:01+00:00,['71c904e5c234087b32a908b9e13c30aa3f878a5d'],270,1171,1441,17217451,9,0.527536232,1,1,7229
8eeb000c3515aa2c7dd671d7abe2269d4deffd08,1,Impala Public Jenkins,2022-03-05 03:39:08+00:00,['7a28295905e97e41503670bbdd92e64ea47f0078'],49,139,188,17217639,5,0,0,0.388888889,7229
7450c96a76d81e21b2758d0bc5dcb673a6198d65,0,Quanlong Huang,2022-03-05 06:53:01+00:00,['8eeb000c3515aa2c7dd671d7abe2269d4deffd08'],1,2,3,17217642,1,0,0,1,7229
c10e951bcbc57e8e16d2427a7a6a4532f30f904a,1,Impala Public Jenkins,2022-03-07 20:00:42+00:00,['7450c96a76d81e21b2758d0bc5dcb673a6198d65'],26,1780,1806,17219448,54,0.204633205,0.359073359,0.783783784,7257
2d6300ac59918d6e8a45a5d4669e252f177d6fcc,0,Impala Public Jenkins,2022-03-08 04:48:06+00:00,['c10e951bcbc57e8e16d2427a7a6a4532f30f904a'],9,14,23,17219471,1,,,,7257
7f1ce039be30d5b36a490e8b07728f82f5d4c3de,0,Wenzhe Zhou,2022-03-08 18:35:04+00:00,['2d6300ac59918d6e8a45a5d4669e252f177d6fcc'],1,8,9,17219480,1,,,,7257
aef30d0442f8272e5d8639ebce61ccd28db2a5e9,1,Tamas Mate,2022-03-10 15:30:59+00:00,['7f1ce039be30d5b36a490e8b07728f82f5d4c3de'],234,182,416,17219896,18,1,0,0,7257
80307d39976c27a7ada11e7cd776a30b09a3abdc,0,Impala Public Jenkins,2022-03-11 08:19:27+00:00,['aef30d0442f8272e5d8639ebce61ccd28db2a5e9'],19,25,44,17219940,1,1,1,1,7257
2fffac3bad3b86d8aa6d6c1c31400578373de505,1,Zoltan Borok-Nagy,2022-03-11 13:23:30+00:00,['80307d39976c27a7ada11e7cd776a30b09a3abdc'],32,112,144,17220084,6,0.125,0.75,0.125,7257
4aeffe71355a003de8c1d625c1443a79dba431e5,0,Impala Public Jenkins,2022-03-12 04:12:27+00:00,['2fffac3bad3b86d8aa6d6c1c31400578373de505'],1,3,4,17220088,1,,,,7257
ca48b940ec6281d492ad525418f234308a82eedf,1,Aman Sinha,2022-03-14 19:47:19+00:00,['4aeffe71355a003de8c1d625c1443a79dba431e5'],24,24,48,17220136,3,,,,7257
c2dda6ee3b05fbae5d0ad3510e711409ee1baa7f,1,Impala Public Jenkins,2022-03-15 03:55:12+00:00,['ca48b940ec6281d492ad525418f234308a82eedf'],2,2,4,17220140,1,,,,7257
9149345f1ffc216e134f68461ea4a646ccdf5fb4,1,Impala Public Jenkins,2022-03-16 19:35:14+00:00,['c2dda6ee3b05fbae5d0ad3510e711409ee1baa7f'],3,118,121,17220261,4,0.307692308,1,0.923076923,7258
87f3dc294f160823af999fd004babb967ecb1fe5,0,Impala Public Jenkins,2022-03-18 00:39:40+00:00,['9149345f1ffc216e134f68461ea4a646ccdf5fb4'],10,28,38,17220299,4,0,1,1,7258
21ce4fb130b9f47c55ca4769f4c41ab8eb258b56,0,Impala Public Jenkins,2022-03-18 14:17:54+00:00,['87f3dc294f160823af999fd004babb967ecb1fe5'],51,28,79,17220378,1,1,0.794871795,0,7258
4d32ab7122557ca3336354301a3a467a206913a9,0,Impala Public Jenkins,2022-03-18 19:26:12+00:00,['21ce4fb130b9f47c55ca4769f4c41ab8eb258b56'],5,2,7,17220385,1,1,1,0,7258
1739edf2d97009062cb339a3c276f01dbd4d33bd,0,Impala Public Jenkins,2022-03-18 20:16:59+00:00,['4d32ab7122557ca3336354301a3a467a206913a9'],1,1,2,17220387,1,,,,7258
a5a9b1e3f9310f42785fb2d0459b80571e9fbb80,0,Joe McDonnell,2022-03-21 16:22:31+00:00,['1739edf2d97009062cb339a3c276f01dbd4d33bd'],5,28,33,17220420,2,,,,7258
07a3e6e0df8ed05577a52d896d0ccfbbf6dd8e28,1,Qifan Chen,2022-03-21 20:17:28+00:00,['a5a9b1e3f9310f42785fb2d0459b80571e9fbb80'],65,641,706,17221126,24,0.252525253,0.195286195,0.656565657,7260
e90cf9c8113ddedd924a807f938d156915fa05d0,0,Quanlong Huang,2022-03-22 06:45:54+00:00,['07a3e6e0df8ed05577a52d896d0ccfbbf6dd8e28'],0,37,37,17221163,1,,,,7260
7273c9f8a9698609816b680a79f21f9389bb265f,0,Impala Public Jenkins,2022-03-22 11:10:06+00:00,['e90cf9c8113ddedd924a807f938d156915fa05d0'],1,1,2,17221165,1,,,,7260
f9dfd1f954f3b3123082fa483adf4dc806f0c31a,0,Impala Public Jenkins,2022-03-23 01:37:49+00:00,['7273c9f8a9698609816b680a79f21f9389bb265f'],0,3,3,17221168,1,,,,7260
aa404b856f182e381f1d40b55dc568d87828d2ec,0,Joe McDonnell,2022-03-24 15:49:47+00:00,['f9dfd1f954f3b3123082fa483adf4dc806f0c31a'],5,7,12,17221180,1,,,,7260
b694901414b05d4f7696b424507e253f07d0a182,0,Joe McDonnell,2022-03-24 15:49:47+00:00,['aa404b856f182e381f1d40b55dc568d87828d2ec'],0,6,6,17221186,1,,,,7260
dff5171b9879d3b7455c2deb41d9baf3207c716a,0,Impala Public Jenkins,2022-03-25 05:16:28+00:00,['b694901414b05d4f7696b424507e253f07d0a182'],0,33,33,17221219,2,0,0.72,1,7260
72f074539c4bb2fe663d748f97cd62df88337f27,1,Tamas Mate,2022-03-25 11:54:39+00:00,['dff5171b9879d3b7455c2deb41d9baf3207c716a'],25,287,312,17221531,8,0.222891566,0.777108434,0.698795181,7260
0dce419dbd073257d2352e556642f6239a76bb9b,0,Impala Public Jenkins,2022-03-25 13:02:36+00:00,['72f074539c4bb2fe663d748f97cd62df88337f27'],0,21,21,17221552,1,0.5,0.5,0.5,7260
1fe4d2ce57afa294c2b12c06f85c69d34b461344,0,Impala Public Jenkins,2022-03-26 13:53:54+00:00,['0dce419dbd073257d2352e556642f6239a76bb9b'],0,2,2,17221554,1,,,,7260
ff21728838acd79d451959149f9adb8fdbf2798d,0,Impala Public Jenkins,2022-03-27 15:30:53+00:00,['1fe4d2ce57afa294c2b12c06f85c69d34b461344'],2,2,4,17221558,1,,,,7260
b1c1be12f3cceed48e93eddae8b9512737e3e0d2,0,Impala Public Jenkins,2022-03-28 22:32:44+00:00,['ff21728838acd79d451959149f9adb8fdbf2798d'],27,19,46,17221604,1,1,0.833333333,0.833333333,7260
38062b4ec0cfdf28474c84d136718510fe712437,0,Impala Public Jenkins,2022-03-30 22:07:52+00:00,['b1c1be12f3cceed48e93eddae8b9512737e3e0d2'],14,15,29,17221633,2,1,1,1,7260
38efbee29d1d225d0a68eb5a6216325e12e81acd,0,Impala Public Jenkins,2022-03-31 05:50:03+00:00,['38062b4ec0cfdf28474c84d136718510fe712437'],25,31,56,17221689,3,1,1,0,7260
952f2af0ca5afd48bac828b66db467502da76ff2,0,Impala Public Jenkins,2022-03-31 11:53:13+00:00,['38efbee29d1d225d0a68eb5a6216325e12e81acd'],2,272,274,17221963,8,,,,7262
4d5530e762ca52763c7eb5acff62517507126925,1,Zoltan Borok-Nagy,2022-03-31 21:40:39+00:00,['952f2af0ca5afd48bac828b66db467502da76ff2'],11,35,46,17222009,4,0,0.857142857,0,7262
8e755e757101a85788f8c9dc8f292b471ba0752d,1,Wenzhe Zhou,2022-04-01 16:31:19+00:00,['4d5530e762ca52763c7eb5acff62517507126925'],9,70,79,17222088,6,0.047619048,0.595238095,0.880952381,7262
84d67f09b4864f292ca56dc05464e7a6a16bc0f4,0,Impala Public Jenkins,2022-04-01 23:46:55+00:00,['8e755e757101a85788f8c9dc8f292b471ba0752d'],2,2,4,17222092,1,,,,7262
0fb14962d7db7be8efcf0559b1781872b3e36e6e,0,Impala Public Jenkins,2022-04-02 03:26:28+00:00,['84d67f09b4864f292ca56dc05464e7a6a16bc0f4'],30,97,127,17222219,7,0,1,0,7262
72817181212372999b7920d7eadaca93dda8731a,0,Impala Public Jenkins,2022-04-02 11:00:44+00:00,['0fb14962d7db7be8efcf0559b1781872b3e36e6e'],9,15,24,17222243,1,1,1,1,7262
c1f99d13699d1c63e7d74308a25c46798ea410d7,0,Wenzhe Zhou,2022-04-02 20:30:35+00:00,['72817181212372999b7920d7eadaca93dda8731a'],1,19,20,17222263,2,1,1,0.642857143,7262
abfa5a72b6a6046037f27ad02d19b31f7b31c4e5,0,Impala Public Jenkins,2022-04-04 05:54:58+00:00,['c1f99d13699d1c63e7d74308a25c46798ea410d7'],1,356,357,17222620,3,0,0,0.25,7262
6bf56c95c7a8791cdfddd4d075afff0cf26f471c,0,Impala Public Jenkins,2022-04-04 20:28:07+00:00,['abfa5a72b6a6046037f27ad02d19b31f7b31c4e5'],23,17,40,17222660,4,0,0,0,7262
efba58f5f05da5dc1f1f5bb3c6fd812bf7f679b9,1,Impala Public Jenkins,2022-04-04 23:52:33+00:00,['6bf56c95c7a8791cdfddd4d075afff0cf26f471c'],254,269,523,17223183,18,0.6,1,1,7263
32e2ace38df03b6a760d636154c0ca78304568de,1,Gabor Kaszab,2022-04-05 07:56:39+00:00,['efba58f5f05da5dc1f1f5bb3c6fd812bf7f679b9'],49,945,994,17224177,19,0.450331126,0.622516556,0.993377483,7264
85ddd27b640bf42a61d8af238938e16618db537e,0,Impala Public Jenkins,2022-04-05 08:38:53+00:00,['32e2ace38df03b6a760d636154c0ca78304568de'],4,95,99,17224276,2,0,0.23880597,0.611940299,7264
f932d78ad0a30e322d59fc39072f710f889d2135,1,Impala Public Jenkins,2022-04-05 13:27:10+00:00,['85ddd27b640bf42a61d8af238938e16618db537e'],256,1046,1302,17225578,31,1,1,1,7266
abf728906028b275cf09ed8a1adb3f52f58b7397,0,Impala Public Jenkins,2022-04-06 04:55:24+00:00,['f932d78ad0a30e322d59fc39072f710f889d2135'],2,2,4,17225582,1,,,,7266
503e58174eaf5f0d6c052753ad0fabafefcc93f2,0,Impala Public Jenkins,2022-04-06 10:42:38+00:00,['abf728906028b275cf09ed8a1adb3f52f58b7397'],6,121,127,17225709,3,0.982142857,0.982142857,0.767857143,7267
a0922079f5b0ba201025b0b657371f26bc2a7d16,1,Impala Public Jenkins,2022-04-06 16:46:46+00:00,['503e58174eaf5f0d6c052753ad0fabafefcc93f2'],58,182,240,17225949,13,0,0.391304348,0,7267
7b235eebd5dda9074e2b7724e6b290f49c1bb8ce,0,Joe McDonnell,2022-04-07 16:07:56+00:00,['a0922079f5b0ba201025b0b657371f26bc2a7d16'],0,14,14,17225963,1,,,,7267
6358db7587cc2218e4523dae16ac5e362edf37ef,0,Impala Public Jenkins,2022-04-11 04:32:30+00:00,['7b235eebd5dda9074e2b7724e6b290f49c1bb8ce'],15,13,28,17225991,1,1,0,1,7267
26398855bfcd7017e9c44d0358f0d6bc3ba5b1e9,0,Joe McDonnell,2022-04-11 16:06:46+00:00,['6358db7587cc2218e4523dae16ac5e362edf37ef'],14,14,28,17226019,14,,,,7267
9cd4823aa9b940c6e57abbb0c116fb4582cce80a,0,Zoltan Borok-Nagy,2022-04-11 19:37:04+00:00,['26398855bfcd7017e9c44d0358f0d6bc3ba5b1e9'],9,217,226,17226245,17,0,0,0.5,7276
953705b8d2ed336e18c6a45e36f4fbc0deb1da7a,0,Impala Public Jenkins,2022-04-13 06:22:14+00:00,['9cd4823aa9b940c6e57abbb0c116fb4582cce80a'],1,0,1,17226246,1,,,,7276
e530f6a9ced62613c067a9ae30bac7438bffd3fc,0,Quanlong Huang,2022-04-13 08:08:24+00:00,['953705b8d2ed336e18c6a45e36f4fbc0deb1da7a'],1,1,2,17226248,1,,,,7276
011bef6249bd9b0313f3602105f58fa6d239d5bb,0,Csaba Ringhofer,2022-04-13 09:20:24+00:00,['e530f6a9ced62613c067a9ae30bac7438bffd3fc'],0,3,3,17226251,1,,,,7276
3843f7ff46204a5cf1c8c9ed26b9acd9ab28c183,0,Impala Public Jenkins,2022-04-13 12:31:36+00:00,['011bef6249bd9b0313f3602105f58fa6d239d5bb'],9,44,53,17226304,5,0,0,0,7276
3627b027fea9ba25f204f4166bce90d76e995724,0,Joe McDonnell,2022-04-13 15:12:25+00:00,['3843f7ff46204a5cf1c8c9ed26b9acd9ab28c183'],4,3,7,17226311,1,,,,7276
c190966db932cf7b24881ce2213fd6f7d9192099,0,Impala Public Jenkins,2022-04-13 20:37:45+00:00,['3627b027fea9ba25f204f4166bce90d76e995724'],6,5,11,17226322,1,,,,7276
e644c99724dabcd12b2112bf19d1bcd417afe0e4,1,Quanlong Huang,2022-04-14 11:56:20+00:00,['c190966db932cf7b24881ce2213fd6f7d9192099'],11,351,362,17226684,16,0.573033708,0.730337079,0.640449438,7277
8910f62ba3200657186c35eb516ac9bb41a684e1,0,Impala Public Jenkins,2022-04-14 16:00:29+00:00,['e644c99724dabcd12b2112bf19d1bcd417afe0e4'],2,6,8,17226692,2,,,,7277
31bd2a47036e7be3a0a32f873b60d2f70dcd8c9f,0,Impala Public Jenkins,2022-04-14 23:07:08+00:00,['8910f62ba3200657186c35eb516ac9bb41a684e1'],7,11,18,17226710,2,0,0,0,7277
dfc2f175bdd10106e6984fc150ede9891a03eeb0,0,Quanlong Huang,2022-04-15 01:36:59+00:00,['31bd2a47036e7be3a0a32f873b60d2f70dcd8c9f'],2,37,39,17226749,3,0.461538462,0.884615385,0.923076923,7277
8645ac6db39b30ba6b012b379c2295094e1b427b,0,Aman Sinha,2022-04-17 22:36:57+00:00,['dfc2f175bdd10106e6984fc150ede9891a03eeb0'],58,12,70,17226819,4,,,,7277
1358700740dbeff799f6a6a95f95b1d9fe7281d2,0,Wenzhe Zhou,2022-04-19 21:45:42+00:00,['8645ac6db39b30ba6b012b379c2295094e1b427b'],0,1,1,17226820,1,1,1,0,7277
e91c7810f088245e9c21d591f63c56781e261572,0,Zoltan Borok-Nagy,2022-04-21 12:49:31+00:00,['1358700740dbeff799f6a6a95f95b1d9fe7281d2'],6,961,967,17227787,27,0,0,1,7298
c802be42b66cf69a362f7d2c89175932bbe226cf,0,Impala Public Jenkins,2022-04-21 13:59:17+00:00,['e91c7810f088245e9c21d591f63c56781e261572'],9,42,51,17227838,4,0,0,0,7298
e8e637873c0527a60d1de0f63c3f268328a9c84c,0,Quanlong Huang,2022-04-21 22:24:49+00:00,['c802be42b66cf69a362f7d2c89175932bbe226cf'],3,163,166,17228004,4,,,,7300
eef6eb077574b50c81510f303b90a3f69890db3c,0,Impala Public Jenkins,2022-04-23 01:04:41+00:00,['e8e637873c0527a60d1de0f63c3f268328a9c84c'],1,3,4,17228008,1,1,1,1,7300
6380a3187c2d0efeadfa7c8a4ff5746b0e16e6ab,0,Impala Public Jenkins,2022-04-27 03:30:41+00:00,['eef6eb077574b50c81510f303b90a3f69890db3c'],234,614,848,17228856,11,0.875,1,0.591666667,7301
78609dca32d8ce996247c9552ba676a853c74686,1,Impala Public Jenkins,2022-04-28 17:48:23+00:00,['6380a3187c2d0efeadfa7c8a4ff5746b0e16e6ab'],57,76,133,17228989,8,0.823529412,1,1,7301
38f68a31edcd2ff4ef52c47f33b8999082750645,0,Impala Public Jenkins,2022-04-30 03:23:11+00:00,['78609dca32d8ce996247c9552ba676a853c74686'],91,149,240,17229229,3,0.545454545,0.545454545,1,7301
9baf790606073d88c3a2fd431110812140df0cb7,0,Daniel Becker,2022-05-02 07:21:37+00:00,['38f68a31edcd2ff4ef52c47f33b8999082750645'],106,917,1023,17230252,16,0.481586402,0.651558074,0.917847025,7301
5a73401f3e3d27423109ad0478320efca7a459af,0,Impala Public Jenkins,2022-05-03 12:13:32+00:00,['9baf790606073d88c3a2fd431110812140df0cb7'],4,4,8,17230260,1,,,,7301
519ae0d3eb87296677c3a6c4be15abd7baa3255f,0,Impala Public Jenkins,2022-05-04 05:08:04+00:00,['5a73401f3e3d27423109ad0478320efca7a459af'],3,3,6,17230266,1,,,,7301
93fe446b851ff96f7f3d229c355d83daa5e8f89e,0,Impala Public Jenkins,2022-05-04 16:50:05+00:00,['519ae0d3eb87296677c3a6c4be15abd7baa3255f'],100,749,849,17231115,3,1,1,0,7302
1f20b7aa51b5c93dea03515423def2d800f43554,0,Impala Public Jenkins,2022-05-05 15:22:48+00:00,['93fe446b851ff96f7f3d229c355d83daa5e8f89e'],12,12,24,17231139,1,,,,7302
51b537a3cd4e7d5f3448f0bb8ffce7d69711f512,0,Joe McDonnell,2022-05-10 00:19:18+00:00,['1f20b7aa51b5c93dea03515423def2d800f43554'],8,1,9,17231148,1,,,,7302
4118522b9cd4d27dbabde6ead3d5647d72f8369d,0,Joe McDonnell,2022-05-10 00:19:18+00:00,['51b537a3cd4e7d5f3448f0bb8ffce7d69711f512'],4,94,98,17231246,6,,,,7303
e6ed98c22bbbbbadb06a041af27afc441701a432,0,Joe McDonnell,2022-05-10 03:06:59+00:00,['4118522b9cd4d27dbabde6ead3d5647d72f8369d'],12,27,39,17231285,6,,,,7304
397d1d15a274b843aad9b4da8eaa1ab7dc468099,0,Impala Public Jenkins,2022-05-10 03:22:41+00:00,['e6ed98c22bbbbbadb06a041af27afc441701a432'],83,185,268,17231553,6,0.776119403,0.776119403,0.552238806,7304
2abcf31949ecdda95bf60e0ef463bdc168b53bf1,0,Impala Public Jenkins,2022-05-10 16:59:20+00:00,['397d1d15a274b843aad9b4da8eaa1ab7dc468099'],24,24,48,17231601,1,,,,7304
ca5ea4aeab57fb3e8ea16a7ea3e2fb6d188c74cb,1,Csaba Ringhofer,2022-05-11 15:10:28+00:00,['2abcf31949ecdda95bf60e0ef463bdc168b53bf1'],4,1621,1625,17233226,15,0.307121662,0.876854599,0.93768546,7313
7c40b95a04601c04527770bb42bbfdd37d9109c0,1,Impala Public Jenkins,2022-05-12 12:37:23+00:00,['ca5ea4aeab57fb3e8ea16a7ea3e2fb6d188c74cb'],0,21,21,17233247,2,0,0,1,7313
e711461a5ce500b803f0b0ac49ae8d09c6daab4f,0,Zoltan Borok-Nagy,2022-05-12 16:23:17+00:00,['7c40b95a04601c04527770bb42bbfdd37d9109c0'],13,35,48,17233295,9,0.105263158,0.947368421,0,7313
0d55a4a54c44dbbebd27beea57475a59598b27d3,0,Impala Public Jenkins,2022-05-13 05:08:22+00:00,['e711461a5ce500b803f0b0ac49ae8d09c6daab4f'],120,179,299,17233594,3,0.041666667,1,1,7313
f4b2ef5a00ac414017f26e038b17740f3807a337,1,Impala Public Jenkins,2022-05-13 21:09:57+00:00,['0d55a4a54c44dbbebd27beea57475a59598b27d3'],17,190,207,17233801,7,0.320754717,1,0.971698113,7314
7a7934ffba70a1448be081b288cfc37e0c846d93,0,Impala Public Jenkins,2022-05-13 23:10:17+00:00,['f4b2ef5a00ac414017f26e038b17740f3807a337'],0,427,427,17234228,3,1,1,0.8125,7315
b867f4c4f1794b434c90f7bd702b277a570b6303,1,Impala Public Jenkins,2022-05-15 21:46:06+00:00,['7a7934ffba70a1448be081b288cfc37e0c846d93'],0,3603,3603,17237831,20,0.032258065,0.207258065,0.578225806,7334
d4cb3afe69e9131ef8784938d231af9b864fbd81,0,Impala Public Jenkins,2022-05-16 08:19:33+00:00,['b867f4c4f1794b434c90f7bd702b277a570b6303'],1,1,2,17237833,1,,,,7334
298d064d23b9fc1eb10637406e92809f3f994e92,0,Impala Public Jenkins,2022-05-17 00:11:56+00:00,['d4cb3afe69e9131ef8784938d231af9b864fbd81'],1,1,2,17237835,1,,,,7334
9f2447b1b382538404057fa9572a693f2215378c,0,Impala Public Jenkins,2022-05-17 06:38:50+00:00,['298d064d23b9fc1eb10637406e92809f3f994e92'],10,22,32,17237867,2,0.555555556,1,1,7334
22272fb5d723b3d1b8a6e20a313c0f4be0129160,0,Impala Public Jenkins,2022-05-17 20:59:08+00:00,['9f2447b1b382538404057fa9572a693f2215378c'],3,3,6,17237873,1,,,,7334
1f89627b9e2e92e05a7d504cdd141054de42eb2a,0,Tamas Mate,2022-05-18 12:04:54+00:00,['22272fb5d723b3d1b8a6e20a313c0f4be0129160'],4,4,8,17237881,1,,,,7334
6ea15409b879a1286e72848defdda8d5d8568c19,0,Impala Public Jenkins,2022-05-18 23:59:58+00:00,['1f89627b9e2e92e05a7d504cdd141054de42eb2a'],19,73,92,17237973,25,,,,7334
67b335c0c34b8b57d4ed1ea3385eb1b01147abf8,0,Impala Public Jenkins,2022-05-20 14:01:27+00:00,['6ea15409b879a1286e72848defdda8d5d8568c19'],1,12,13,17237986,2,0.5,1,1,7334
09a297a2703a077d6349684153192d3f5cb60b7d,1,Joe McDonnell,2022-05-22 19:58:15+00:00,['67b335c0c34b8b57d4ed1ea3385eb1b01147abf8'],1,4,5,17237991,1,,,,7334
38b402fc81593f10003955efc6e84adb4266066c,0,Impala Public Jenkins,2022-05-23 05:12:02+00:00,['09a297a2703a077d6349684153192d3f5cb60b7d'],0,1,1,17237992,1,,,,7334
fed0c6b321e835f768d947e0abb9f8051486fb84,0,Impala Public Jenkins,2022-05-23 06:24:15+00:00,['38b402fc81593f10003955efc6e84adb4266066c'],9,29,38,17238030,3,,,,7334
33724d623f29132721eef81fa296de01bc516e94,0,Impala Public Jenkins,2022-05-23 17:14:46+00:00,['fed0c6b321e835f768d947e0abb9f8051486fb84'],1,3,4,17238034,2,,,,7334
cf5eaae17634edd99f40bd40e83ea1f1248e4bf1,0,Impala Public Jenkins,2022-05-23 18:44:33+00:00,['33724d623f29132721eef81fa296de01bc516e94'],1,1,2,17238036,1,,,,7334
861d63f74823b8165cd87028875f4429e59dedaf,0,Impala Public Jenkins,2022-05-23 19:04:24+00:00,['cf5eaae17634edd99f40bd40e83ea1f1248e4bf1'],4,13,17,17238053,2,0.25,1,1,7334
882b6daf24a5be32706a2c1b8c069254d2f14033,0,Impala Public Jenkins,2022-05-24 02:53:33+00:00,['861d63f74823b8165cd87028875f4429e59dedaf'],4,14,18,17238071,1,0,0,1,7334
d00d3463cd4d539bcaa42917402da2927ae6e552,0,Impala Public Jenkins,2022-05-24 09:15:20+00:00,['882b6daf24a5be32706a2c1b8c069254d2f14033'],2,0,2,17238073,1,,,,7334
b58966b98391209a073cda61f538d84056343b75,0,Impala Public Jenkins,2022-05-24 13:16:21+00:00,['d00d3463cd4d539bcaa42917402da2927ae6e552'],55,593,648,17238721,4,0.188405797,0.391304348,0.956521739,7335
ad915ca58eaa004925d545057e9ebdba5d62131b,0,Impala Public Jenkins,2022-05-24 14:24:17+00:00,['b58966b98391209a073cda61f538d84056343b75'],0,12,12,17238733,2,,,,7335
d0cfdd139fe81a52f420c7878b5e90c6e30ea6fe,0,Joe McDonnell,2022-05-24 20:42:04+00:00,['ad915ca58eaa004925d545057e9ebdba5d62131b'],7,7,14,17238747,3,,,,7335
a11450db86e69b25345baf74c52a1592a27c42df,0,Impala Public Jenkins,2022-05-24 21:09:27+00:00,['d0cfdd139fe81a52f420c7878b5e90c6e30ea6fe'],3,6,9,17238756,2,1,1,1,7335
2243f331cb73670f6745b2b5d1268668de2e8e90,0,Impala Public Jenkins,2022-05-25 05:37:17+00:00,['a11450db86e69b25345baf74c52a1592a27c42df'],3,279,282,17239038,14,0.67,0.96,1,7335
eda2aa55530b9dfd0888790081e0df3335bc1a82,0,Impala Public Jenkins,2022-05-25 06:27:24+00:00,['2243f331cb73670f6745b2b5d1268668de2e8e90'],161,597,758,17239796,39,0.3507109,0.488151659,0.71563981,7336
0ee5f8084f1bb34fc261c729f736ac093ba59c41,0,Impala Public Jenkins,2022-05-25 22:47:40+00:00,['eda2aa55530b9dfd0888790081e0df3335bc1a82'],5,13,18,17239814,3,0.375,1,1,7336
f77f57707417379635880efa1caa1ec40f2314b2,0,Impala Public Jenkins,2022-05-26 03:31:38+00:00,['0ee5f8084f1bb34fc261c729f736ac093ba59c41'],1,1,2,17239816,1,,,,7336
6a199be8544f5d76e00829f7493fcaac2f9c274c,0,Impala Public Jenkins,2022-05-26 03:42:51+00:00,['f77f57707417379635880efa1caa1ec40f2314b2'],15,58,73,17239889,7,0.928571429,1,0.821428571,7336
4236c307b971881a3b1d85068db5b053a9c34cfa,0,Impala Public Jenkins,2022-05-26 08:47:24+00:00,['6a199be8544f5d76e00829f7493fcaac2f9c274c'],36,380,416,17240305,4,0.507575758,0.848484848,0.28030303,7336
62683e0ebb78902e142975971c93b8fa011fb632,0,Impala Public Jenkins,2022-05-28 00:32:52+00:00,['4236c307b971881a3b1d85068db5b053a9c34cfa'],4,7,11,17240316,1,1,1,1,7336
b3dec99ea1942069a67b971719d095567758dc9b,0,Joe McDonnell,2022-06-01 06:00:11+00:00,['62683e0ebb78902e142975971c93b8fa011fb632'],5,0,5,17240321,1,,,,7336
ed0d9341d3229b5857c8583d1817172d61b0f68c,0,Joe McDonnell,2022-06-02 01:53:09+00:00,['b3dec99ea1942069a67b971719d095567758dc9b'],1,26,27,17240348,2,0,1,0.214285714,7336
c41e6941cafad453819b57e78b2083a3e64496e0,1,Quanlong Huang,2022-06-02 09:36:50+00:00,['ed0d9341d3229b5857c8583d1817172d61b0f68c'],1,18,19,17240367,2,0.625,0.625,1,7336
decb46aa0dee43b735ca8b193bd1728dc42d702c,1,Impala Public Jenkins,2022-06-02 17:06:05+00:00,['c41e6941cafad453819b57e78b2083a3e64496e0'],245,378,623,17240990,11,0.203703704,0.37037037,0.314814815,7336
d84ce571b1f8e99e0448c6be9e32cb0438bd5555,0,Wenzhe Zhou,2022-06-03 20:38:05+00:00,['decb46aa0dee43b735ca8b193bd1728dc42d702c'],2,2,4,17240994,1,,,,7336
a57c9e0b9aa1ba624245d515b95aff11a22165e1,0,Impala Public Jenkins,2022-06-03 23:14:04+00:00,['d84ce571b1f8e99e0448c6be9e32cb0438bd5555'],4,4,8,17241002,2,,,,7336
13bbff4e4e5fc5d459cc6f7a5512f84ceba897cd,0,Aman Sinha,2022-06-04 03:36:11+00:00,['a57c9e0b9aa1ba624245d515b95aff11a22165e1'],13,61,74,17241076,3,0.583333333,0.583333333,0.583333333,7336
97d3b25be3d32c5b3b10e5785cfb32351c4065b0,0,Impala Public Jenkins,2022-06-07 22:50:50+00:00,['13bbff4e4e5fc5d459cc6f7a5512f84ceba897cd'],15,15,30,17241106,15,,,,7336
7273cfdfb901b9ef564c2737cf00c7a8abb57f07,0,Impala Public Jenkins,2022-06-08 05:46:42+00:00,['97d3b25be3d32c5b3b10e5785cfb32351c4065b0'],12,109,121,17241227,4,0.315789474,0.236842105,0.815789474,7337
23d09638de35dcec6419a5e30df08fd5d8b27e7d,0,Impala Public Jenkins,2022-06-08 13:02:52+00:00,['7273cfdfb901b9ef564c2737cf00c7a8abb57f07'],64,882,946,17242173,35,0.472340426,0.646808511,0.821276596,7341
1a1536bd1d0162a168877a6f33dd75f9544a82f3,0,Impala Public Jenkins,2022-06-10 13:01:28+00:00,['23d09638de35dcec6419a5e30df08fd5d8b27e7d'],1,142,143,17242316,3,0,0,0,7341
b1bada1f4212c7e359ded9fa14d99993d3d63465,0,Csaba Ringhofer,2022-06-10 16:13:14+00:00,['1a1536bd1d0162a168877a6f33dd75f9544a82f3'],2,2,4,17242320,1,,,,7341
4b5b0a693244db9c3d2a10d56de165befdd8532f,1,Impala Public Jenkins,2022-06-10 18:05:31+00:00,['b1bada1f4212c7e359ded9fa14d99993d3d63465'],23,199,222,17242542,9,0.382352941,0.911764706,1,7341
cee086f685e1b641da14513cc24ad11c56dee7fd,0,Impala Public Jenkins,2022-06-13 12:59:10+00:00,['4b5b0a693244db9c3d2a10d56de165befdd8532f'],11,44,55,17242597,3,0.142857143,0.095238095,1,7341
c7784bde55d86a25388f5a61e64cda47a3ccaeee,1,Impala Public Jenkins,2022-06-13 15:41:07+00:00,['cee086f685e1b641da14513cc24ad11c56dee7fd'],13,82,95,17242692,7,0.069767442,0.534883721,0.976744186,7341
5263d13112bc35ae69e2c2c09adc823a96fc8c13,0,Joe McDonnell,2022-06-13 17:13:42+00:00,['c7784bde55d86a25388f5a61e64cda47a3ccaeee'],110,140,250,17242942,9,1,0.916666667,0.75,7343
181fd9406887d33eb97b8cfc6441f61d8defc8a9,0,Joe McDonnell,2022-06-13 17:13:42+00:00,['5263d13112bc35ae69e2c2c09adc823a96fc8c13'],9,21,30,17242972,7,1,1,1,7343
1285fc95ad237f18ff46f5c1d259e004058bbd6e,0,Joe McDonnell,2022-06-13 17:13:42+00:00,['181fd9406887d33eb97b8cfc6441f61d8defc8a9'],0,4,4,17242976,1,1,1,1,7343
2744f46fbd921dafe9b63f4a0011b2237ee07c5f,1,Impala Public Jenkins,2022-06-14 15:37:54+00:00,['1285fc95ad237f18ff46f5c1d259e004058bbd6e'],6,131,137,17243113,7,0.5,0.5,0.5,7343
2a3addc3d89f89ba5a7c08de0a8cf689d3007e57,0,Joe McDonnell,2022-06-14 23:15:00+00:00,['2744f46fbd921dafe9b63f4a0011b2237ee07c5f'],2,10,12,17243125,2,1,1,1,7343
7eb200abf18a79f0ab127324d1e7108732c60f25,0,Impala Public Jenkins,2022-06-15 05:28:05+00:00,['2a3addc3d89f89ba5a7c08de0a8cf689d3007e57'],10,54,64,17243189,4,0.962962963,0.814814815,0.111111111,7343
f1291528c6a505453ab878920dc473bc35f14d7f,0,Impala Public Jenkins,2022-06-18 03:35:21+00:00,['7eb200abf18a79f0ab127324d1e7108732c60f25'],3,3,6,17243195,3,,,,7343
256f37f17f62c21927e3aebee57d512758a42f81,0,Impala Public Jenkins,2022-06-19 04:35:04+00:00,['f1291528c6a505453ab878920dc473bc35f14d7f'],0,1074,1074,17244269,4,0.605015674,0.752351097,0.429467085,7343
acea6853d0341c5d17a51b65b0b13359c1b54229,0,Tamas Mate,2022-06-20 13:52:26+00:00,['256f37f17f62c21927e3aebee57d512758a42f81'],12,12,24,17244293,1,,,,7343
d12d4c9b077392f58701af2e343dd927fe516846,0,Tamas Mate,2022-06-20 13:52:37+00:00,['acea6853d0341c5d17a51b65b0b13359c1b54229'],5,63,68,17244361,1,,,,7343
75ccdc6aecdee3918fa36cae507e4fc74c6078b5,0,Impala Public Jenkins,2022-06-20 14:06:56+00:00,['d12d4c9b077392f58701af2e343dd927fe516846'],2,23,25,17244386,2,1,1,1,7343
29e91220a2a1fcda0b35cddfa11492312b338743,0,Impala Public Jenkins,2022-06-20 17:15:13+00:00,['75ccdc6aecdee3918fa36cae507e4fc74c6078b5'],0,1,1,17244387,1,,,,7343
70568c80b3bb19e1945896d0a9492b8bc8f37164,0,Laszlo Gaal (Cloudera),2022-06-20 18:44:24+00:00,['29e91220a2a1fcda0b35cddfa11492312b338743'],1,4,5,17244392,1,,,,7343
8965059c2c29dc2426339c1989159ec69bf6289e,0,Impala Public Jenkins,2022-06-20 19:38:33+00:00,['70568c80b3bb19e1945896d0a9492b8bc8f37164'],14,12,26,17244418,3,0,0,0,7343
15e28b48a4bf41ef6bdccdec0639d979c4023a1e,0,Impala Public Jenkins,2022-06-20 21:32:22+00:00,['8965059c2c29dc2426339c1989159ec69bf6289e'],1,1,2,17244420,1,,,,7343
06b1db4675b509b9461f7489d81a2c74930aa413,0,Impala Public Jenkins,2022-06-21 02:40:59+00:00,['15e28b48a4bf41ef6bdccdec0639d979c4023a1e'],139,314,453,17244873,15,0.666666667,1,0.476190476,7346
66cde5ba8f707e61b1b46dabe114819de8b4f75d,0,Impala Public Jenkins,2022-06-21 06:51:38+00:00,['06b1db4675b509b9461f7489d81a2c74930aa413'],1,11,12,17244885,1,,,,7346
da14fdcf35da28d2ff86c6ca9413a95cc3f8f346,0,Impala Public Jenkins,2022-06-21 17:55:18+00:00,['66cde5ba8f707e61b1b46dabe114819de8b4f75d'],1,34,35,17244920,2,1,1,1,7346
5d021ce5a72060d243ae4c56ad803c2fc686a5ce,0,Impala Public Jenkins,2022-06-22 17:55:07+00:00,['da14fdcf35da28d2ff86c6ca9413a95cc3f8f346'],207,605,812,17245732,21,0.653061224,0.741496599,0.557823129,7350
7a26ff4b97603e60c91f5211e6e139affd213752,0,Impala Public Jenkins,2022-06-22 23:58:44+00:00,['5d021ce5a72060d243ae4c56ad803c2fc686a5ce'],158,31,189,17245921,8,0,1,1,7350
f19f21def9ddca71d774467f5ad0ef6562df20c7,0,Impala Public Jenkins,2022-06-23 05:04:56+00:00,['7a26ff4b97603e60c91f5211e6e139affd213752'],4,6,10,17245931,1,,,,7350
f5fc08573352d0a1943296209791a4db17268086,0,Impala Public Jenkins,2022-06-23 05:59:02+00:00,['f19f21def9ddca71d774467f5ad0ef6562df20c7'],17,132,149,17246080,12,0.381818182,0.781818182,0.981818182,7350
425195178df81fb8ae3ae5402c82852211de763d,0,Wenzhe Zhou,2022-06-23 16:49:36+00:00,['f5fc08573352d0a1943296209791a4db17268086'],2702,6,2708,17248788,4,0.371833085,0.357675112,0.380029806,7350
ae00781983e94bfe7e41f65f50fde502d2039f7d,0,Impala Public Jenkins,2022-06-24 04:25:13+00:00,['425195178df81fb8ae3ae5402c82852211de763d'],2,4,6,17248794,1,1,1,0,7350
d74cc7319f21a49d9bba952722b3a622db905836,1,Impala Public Jenkins,2022-06-24 04:27:49+00:00,['ae00781983e94bfe7e41f65f50fde502d2039f7d'],202,569,771,17249565,34,0.422459893,0.700534759,0.689839572,7351
f561daa247d6e6bd2f898e9b637830bcd51b6cc5,0,Impala Public Jenkins,2022-06-24 12:20:17+00:00,['d74cc7319f21a49d9bba952722b3a622db905836'],15,29,44,17249609,3,1,1,0,7351
1bcb35ec7930db1b96a8c018fc4fcf7dbe3a75c7,1,Joe McDonnell,2022-06-24 23:01:22+00:00,['f561daa247d6e6bd2f898e9b637830bcd51b6cc5'],60,38,98,17249707,15,0.333333333,0.333333333,0.666666667,7351
df0a014e364854111368cf5756c4a01b3fb423d6,0,Impala Public Jenkins,2022-06-27 10:54:38+00:00,['1bcb35ec7930db1b96a8c018fc4fcf7dbe3a75c7'],6,5,11,17249718,1,,,,7351
f38c53235f1797f91ff9a65bb734d3f38f1aadc9,0,Impala Public Jenkins,2022-06-27 15:29:11+00:00,['df0a014e364854111368cf5756c4a01b3fb423d6'],15,496,511,17250229,12,0.449275362,0.608695652,0.724637681,7353
a625a95dbd347d5a5e64566c77bcb27e991ce352,0,Impala Public Jenkins,2022-06-28 02:18:04+00:00,['f38c53235f1797f91ff9a65bb734d3f38f1aadc9'],1,118,119,17250348,6,0.65,0.675,0.4,7354
e20bb5582f2a3638c4b66db0bf594c09b7f928fb,0,Impala Public Jenkins,2022-06-29 14:31:50+00:00,['a625a95dbd347d5a5e64566c77bcb27e991ce352'],2,7,9,17250357,1,1,1,0,7354
bb610dee09a8069bb993b4c668f7e481c1774b70,1,Impala Public Jenkins,2022-06-29 15:34:38+00:00,['e20bb5582f2a3638c4b66db0bf594c09b7f928fb'],1,1,2,17250359,1,,,,7354
8b1002aa6a3307e355164002ea442e0a533df565,0,Impala Public Jenkins,2022-06-30 09:29:41+00:00,['bb610dee09a8069bb993b4c668f7e481c1774b70'],11,19,30,17250389,2,,,,7354
9c96855146071688f9ab2386839720d6180de011,0,Impala Public Jenkins,2022-06-30 18:31:18+00:00,['8b1002aa6a3307e355164002ea442e0a533df565'],4,88,92,17250481,4,0.509803922,0.392156863,1,7354
00db9a27dfad0ea2b708ea1874d8906524ab1aaf,0,Impala Public Jenkins,2022-07-01 04:10:13+00:00,['9c96855146071688f9ab2386839720d6180de011'],0,13,13,17250494,2,,,,7354
63c0ce0c99227e4b2bef75ff8eb31919b88405f5,0,Impala Public Jenkins,2022-07-01 05:59:00+00:00,['00db9a27dfad0ea2b708ea1874d8906524ab1aaf'],21,43,64,17250558,2,0,0,0.538461538,7354
ffd226cfeefcf8be15571f279fff90a860beeeac,0,Impala Public Jenkins,2022-07-01 12:54:11+00:00,['63c0ce0c99227e4b2bef75ff8eb31919b88405f5'],5,61,66,17250624,6,0.058823529,0.970588235,0.147058824,7354
fefb9f24be1f99ac0077a8d6ef00834d8e90ef45,0,Impala Public Jenkins,2022-07-01 17:42:40+00:00,['ffd226cfeefcf8be15571f279fff90a860beeeac'],1,1,2,17250626,1,,,,7354
a7eeb5b318c1f5d2bcaf6d379b676f676fef1618,0,Impala Public Jenkins,2022-07-05 17:10:35+00:00,['fefb9f24be1f99ac0077a8d6ef00834d8e90ef45'],3,2,5,17250631,1,1,1,1,7354
4174ff5ea6a1b413a6218d26bbb7cf20809623cd,0,Impala Public Jenkins,2022-07-05 20:32:17+00:00,['a7eeb5b318c1f5d2bcaf6d379b676f676fef1618'],105,269,374,17251005,11,0.448979592,1,0.959183673,7354
42863ee34ad9a842d616387a3f41a0c680fe674f,1,Impala Public Jenkins,2022-07-06 14:02:35+00:00,['4174ff5ea6a1b413a6218d26bbb7cf20809623cd'],0,1,1,17251006,1,,,,7354
5f2e8ddd9d162023665bfd7ff1429bd91dfcbd50,0,Impala Public Jenkins,2022-07-07 07:05:29+00:00,['42863ee34ad9a842d616387a3f41a0c680fe674f'],22,61,83,17251089,2,0,1,1,7354
5a57050d1740f90a3eef5f43c578521c05f8b033,0,Impala Public Jenkins,2022-07-07 14:13:31+00:00,['5f2e8ddd9d162023665bfd7ff1429bd91dfcbd50'],1,21,22,17251111,2,1,1,1,7354
607dc1f170fb8cc013d8ec33fccee59ac4352fe4,0,Quanlong Huang,2022-07-07 23:00:41+00:00,['5a57050d1740f90a3eef5f43c578521c05f8b033'],128,187,315,17251426,11,0,1,0.848101266,7354
78e45a7ceaa7c080678d11d11c1112ca8fa933ac,0,Zoltan Borok-Nagy,2022-07-08 13:52:26+00:00,['607dc1f170fb8cc013d8ec33fccee59ac4352fe4'],44,645,689,17252115,7,0.170731707,0.170731707,0.097560976,7355
995887ae4e0f41b58e2d0fa4fea3e06f9518c5fe,0,Zoltan Borok-Nagy,2022-07-11 14:56:47+00:00,['78e45a7ceaa7c080678d11d11c1112ca8fa933ac'],0,22,22,17252137,1,,,,7355
35dada465664a58dff85803ee7351ff1f5d84da6,0,Impala Public Jenkins,2022-07-11 18:40:51+00:00,['995887ae4e0f41b58e2d0fa4fea3e06f9518c5fe'],12,40,52,17252189,3,,,,7356
26438d8e3e2cecfdab82643fcee7553df50198ca,0,Impala Public Jenkins,2022-07-11 19:25:02+00:00,['35dada465664a58dff85803ee7351ff1f5d84da6'],8,46,54,17252243,6,0.6,0.6,0,7357
8d034a2f7cd2f68714e83b28335b3baf18823d7c,0,Impala Public Jenkins,2022-07-14 13:06:04+00:00,['26438d8e3e2cecfdab82643fcee7553df50198ca'],21,1874,1895,17254138,32,0.131868132,0.945054945,0.648351648,7382
f24296aed58b75a8e1d8851c5a94c6d362515bc8,0,Impala Public Jenkins,2022-07-14 21:03:43+00:00,['8d034a2f7cd2f68714e83b28335b3baf18823d7c'],78,202,280,17254418,10,0.467532468,0.87012987,0.87012987,7382
64b324ac40c09c2358a96e848ac123db2790d211,0,Joe McDonnell,2022-07-14 23:52:04+00:00,['f24296aed58b75a8e1d8851c5a94c6d362515bc8'],42,10658,10700,17265118,71,0.6022209,0.730914138,0.809637121,7441
5e4696799a46f4ae8af23eb6a899993845902668,0,Impala Public Jenkins,2022-07-15 13:00:23+00:00,['64b324ac40c09c2358a96e848ac123db2790d211'],0,1,1,17265119,1,,,,7441
7764830216d2d2d9a85ec7a6a7deb4badecb13a8,0,Joe McDonnell,2022-07-16 06:06:46+00:00,['5e4696799a46f4ae8af23eb6a899993845902668'],37,308,345,17265464,16,0.261904762,0,0.678571429,7441
e1fea843ea2654d3acfef152e1a073dbef91aa9c,0,Zoltan Borok-Nagy,2022-07-16 17:11:24+00:00,['7764830216d2d2d9a85ec7a6a7deb4badecb13a8'],7,21,28,17265492,2,0,0,1,7441
d029ae53676c8637bc4f56b80b331920c8289108,0,Impala Public Jenkins,2022-07-17 13:46:33+00:00,['e1fea843ea2654d3acfef152e1a073dbef91aa9c'],2,2,4,17265496,1,,,,7441
733c950dafd91460e06122b231dc4a4371e0fe85,0,Impala Public Jenkins,2022-07-18 10:35:27+00:00,['d029ae53676c8637bc4f56b80b331920c8289108'],3,8,11,17265507,2,0.75,0.75,0.75,7441
107ebc096ff715833b0c03e83a168b2ffd98193b,0,Csaba Ringhofer,2022-07-18 14:14:19+00:00,['733c950dafd91460e06122b231dc4a4371e0fe85'],3,10,13,17265520,1,0,0,1,7441
06e8e7bba7a2423f986d3f371e0f64a50b1dd027,0,Impala Public Jenkins,2022-07-18 19:02:34+00:00,['107ebc096ff715833b0c03e83a168b2ffd98193b'],30,155,185,17265705,10,0.424242424,0.545454545,0.939393939,7443
1d16367afb1e520bae5992c1e6c92b4fb41d2655,0,Impala Public Jenkins,2022-07-19 10:12:59+00:00,['06e8e7bba7a2423f986d3f371e0f64a50b1dd027'],2,381,383,17266088,11,0.913043478,0.913043478,0.608695652,7445
112f887ea5219e5835d3ca0403faa0ba9ec49115,0,Impala Public Jenkins,2022-07-20 19:58:15+00:00,['1d16367afb1e520bae5992c1e6c92b4fb41d2655'],21,87,108,17266196,7,0.777777778,1,1,7447
50cbbdb6b255e0f2510a6de8192f3621b8287331,0,Impala Public Jenkins,2022-07-21 04:30:56+00:00,['112f887ea5219e5835d3ca0403faa0ba9ec49115'],2,4,6,17266202,1,,,,7447
ee9238a864cb849db7f166b7cb82292aa17c6dcd,0,Impala Public Jenkins,2022-07-21 16:44:41+00:00,['50cbbdb6b255e0f2510a6de8192f3621b8287331'],1,1,2,17266204,1,,,,7447
7e65e0095a1adbd8e717262909d2bb16c407de63,0,Impala Public Jenkins,2022-07-21 18:35:36+00:00,['ee9238a864cb849db7f166b7cb82292aa17c6dcd'],25,49,74,17266278,2,0.8125,0.625,0.125,7447
02043744beee8c57ee876cb8d94eba28660927cb,0,Impala Public Jenkins,2022-07-22 04:23:30+00:00,['7e65e0095a1adbd8e717262909d2bb16c407de63'],2,187,189,17266467,4,0.837209302,0.837209302,0.372093023,7449
5cae265e31e9d1121de77b8c8a3b096c3aaa67b4,0,Impala Public Jenkins,2022-07-22 17:45:26+00:00,['02043744beee8c57ee876cb8d94eba28660927cb'],2,41,43,17266510,3,1,1,1,7449
efc303b71a35580069f59ab627c3ad9ae292945a,0,Impala Public Jenkins,2022-07-22 22:59:19+00:00,['5cae265e31e9d1121de77b8c8a3b096c3aaa67b4'],26,65,91,17266601,10,0,1,0,7449
b157f1a01a6540f5410376d7bc082523474470d9,0,Impala Public Jenkins,2022-07-25 22:30:04+00:00,['efc303b71a35580069f59ab627c3ad9ae292945a'],2,3,5,17266606,1,,,,7449
614dc54dcc14687a11bb64495d4b6d4356ef55fc,0,Impala Public Jenkins,2022-07-26 18:11:25+00:00,['b157f1a01a6540f5410376d7bc082523474470d9'],6,34,40,17266646,2,0,0,1,7449
cbd3fab8c48a965dbda9d23bbe75a665ef0da2e7,0,Impala Public Jenkins,2022-07-26 18:21:48+00:00,['614dc54dcc14687a11bb64495d4b6d4356ef55fc'],0,52,52,17266698,5,0,0.583333333,1,7449
e00a2cbd818dea45a7c6f2fac579af4389d42759,0,Joe McDonnell,2022-07-27 04:23:41+00:00,['cbd3fab8c48a965dbda9d23bbe75a665ef0da2e7'],2,12,14,17266712,2,0.5,0.5,1,7449
74fcacc17bc8aefd824babc45eb8093d3ae2698e,0,Impala Public Jenkins,2022-07-28 12:56:02+00:00,['e00a2cbd818dea45a7c6f2fac579af4389d42759'],1,5,6,17266718,1,0,1,0,7449
bf4320e55d7e697098e36513e9c06d947d866b37,0,Joe McDonnell,2022-07-28 15:27:04+00:00,['74fcacc17bc8aefd824babc45eb8093d3ae2698e'],2,7,9,17266727,1,,,,7449
7da39c58e755376bf88d0dcd9148253918cef908,0,Joe McDonnell,2022-07-28 15:46:26+00:00,['bf4320e55d7e697098e36513e9c06d947d866b37'],8,1,9,17266736,1,,,,7449
89c3e1f821ccd335c3c5507496bb53b80c1cc07a,0,Joe McDonnell,2022-07-29 20:14:50+00:00,['7da39c58e755376bf88d0dcd9148253918cef908'],20,151,171,17266907,5,0.270588235,0.941176471,1,7449
